id,files,locs added,locs removed,locs total,hunks,commit time,author time
4b825dc642cb6eb9a060e54bf8d69288fbee4904...c9c176a53b1632ca2b1c6ed27382ab72ac21d45d,60,14559,0,14559,55,2010-01-06 00:36:58,2010-01-06 00:36:58
c9c176a53b1632ca2b1c6ed27382ab72ac21d45d...fac0e698a85ade9cb6a18fd400bcbdf118d5e4eb,1,22,2,24,1,2010-01-06 00:57:36,2010-01-06 00:57:36
4b825dc642cb6eb9a060e54bf8d69288fbee4904...866346e1ada583daeb649c253516c8f8a879c387,2,25,0,25,2,1970-01-01 00:00:01,1970-01-01 00:00:01
fac0e698a85ade9cb6a18fd400bcbdf118d5e4eb...19bbee030ba012b8fc4835c1d17e039804b2b94b,2,4,3,7,4,2010-01-12 17:34:27,2010-01-12 17:34:27
fac0e698a85ade9cb6a18fd400bcbdf118d5e4eb...214c142d9de60a7f53d8c7ada2812ffff4837e0f,19,181,176,357,36,2010-01-09 00:04:35,2010-01-09 00:04:35
214c142d9de60a7f53d8c7ada2812ffff4837e0f...eb9e66f4804cf417ce142e5515b039db73d31144,5,173,2,175,6,2010-01-09 21:21:24,2010-01-09 21:21:24
eb9e66f4804cf417ce142e5515b039db73d31144...88eca572fdc7f68a7f384b612052c49de00df433,3,5,12,17,4,2010-01-09 21:43:16,2010-01-09 21:43:16
88eca572fdc7f68a7f384b612052c49de00df433...9b9a0dadcce82ae42ac09ad396d647739af20a06,45,5514,1911,7425,686,2010-01-09 23:02:43,2010-01-09 23:02:43
9b9a0dadcce82ae42ac09ad396d647739af20a06...1aba6b53b88c70b61a0cc991b1371739305d117b,16,343,903,1246,117,2010-01-10 16:58:57,2010-01-10 16:58:57
1aba6b53b88c70b61a0cc991b1371739305d117b...1a42a3fab99ca02af0476f5a87175c53104aa2e3,17,1368,1343,2711,184,2010-01-12 00:15:12,2010-01-12 00:15:12
1a42a3fab99ca02af0476f5a87175c53104aa2e3...6d5471c9bea9671dec7900a7bc548aea8ddd5a3e,18,4268,4154,8422,372,2010-01-12 01:32:33,2010-01-12 01:32:33
6d5471c9bea9671dec7900a7bc548aea8ddd5a3e...13dee60685216a1da9e3bce4d5130693f6f5c624,2,12,7,19,6,2010-01-12 16:40:10,2010-01-12 16:40:10
13dee60685216a1da9e3bce4d5130693f6f5c624...cae222ec7af7e1ab09bc2c0181efddc2d3d1aca2,1,30,3,33,2,2010-01-12 18:25:55,2010-01-12 18:25:55
cae222ec7af7e1ab09bc2c0181efddc2d3d1aca2...0f690e3c08ecff9bb4daef58a24cbb7efeb561b2,2,136,108,244,8,2010-01-12 18:28:53,2010-01-12 18:28:53
0f690e3c08ecff9bb4daef58a24cbb7efeb561b2...e2a48aa2322801bd67cecd9ec516c07977500a52,3,103,104,207,8,2010-01-12 18:38:00,2010-01-12 18:38:00
e2a48aa2322801bd67cecd9ec516c07977500a52...209faf5581d0874ad82d863934f6e97af2897f98,7,234,0,234,2,2010-01-12 21:59:54,2010-01-12 21:59:54
209faf5581d0874ad82d863934f6e97af2897f98...27709c3f69384a7630aa336a1e73e730ea5f9790,4,103,106,209,11,2010-01-12 22:19:19,2010-01-12 22:19:19
0b630972b15676b1c1b6c59edd564e4ee331ec70...ba9eef40cfbb6cd969d566b43fd9129642d01351,1,1,1,2,1,2010-01-26 04:30:22,2010-01-26 04:30:22
ba9eef40cfbb6cd969d566b43fd9129642d01351...a2540fd581f35e8f79240d827d2252da5798c3a2,7,9,7,16,8,2010-01-26 07:49:52,2010-01-26 07:49:52
a2540fd581f35e8f79240d827d2252da5798c3a2...88384854c209f87507c273218fea85009f3801d6,5,273,261,534,125,2010-01-26 19:27:50,2010-01-26 19:27:50
88384854c209f87507c273218fea85009f3801d6...f5055c6530ffdb94436b52afe8c52ab6c2f2f14a,1,1,1,2,1,2010-01-26 23:59:46,2010-01-26 23:59:46
f5055c6530ffdb94436b52afe8c52ab6c2f2f14a...4ea337f0c93b0b140dd9cf326c134f716875b65e,2,30,30,60,16,2010-01-27 00:25:53,2010-01-27 00:25:53
27709c3f69384a7630aa336a1e73e730ea5f9790...595b4ea097bcb512173b6d4a12924ea1a3d70ecd,14,2376,156,2532,23,2010-01-18 18:47:03,2010-01-18 18:47:03
27709c3f69384a7630aa336a1e73e730ea5f9790...86dd83fbd4118acfb01d9a1043f35af170843e8a,1,50,0,50,1,2010-01-18 18:43:45,2010-01-18 18:43:45
dd9d8bf030688f589af6d47064a0d0eafea41bfa...a9c182764b5feeb2466c4bb32f7572762f7fab6d,9,84,34,118,32,2010-01-29 06:11:01,2010-01-29 06:10:49
a9c182764b5feeb2466c4bb32f7572762f7fab6d...a6f2d56b2899299fefa6f8c4a4b4177d1fe48c9c,2,138,116,254,24,2010-01-29 06:15:51,2010-01-29 06:15:51
a6f2d56b2899299fefa6f8c4a4b4177d1fe48c9c...2880411713bf051b0d30b0a1f3531a34272f3b25,4,90,12,102,15,2010-01-29 18:15:15,2010-01-29 18:15:15
2880411713bf051b0d30b0a1f3531a34272f3b25...88b415a3dccefe80f52a05909e13b266a43939b4,2,46,45,91,21,2010-01-29 18:20:22,2010-01-29 18:20:22
88b415a3dccefe80f52a05909e13b266a43939b4...302472f4fa50f995085ebf36b8990bedf3806973,5,8,7,15,7,2010-02-04 19:12:34,2010-02-04 19:12:34
302472f4fa50f995085ebf36b8990bedf3806973...5dd43b85e73ca1708e7fd85094b533b02266a79a,5,58,48,106,20,2010-02-04 19:45:38,2010-02-04 19:45:38
5dd43b85e73ca1708e7fd85094b533b02266a79a...1da18e73a4d09b2a1ace92a4094eeba014eb7dc4,9,109,66,175,38,2010-02-04 21:27:56,2010-02-04 21:27:56
1da18e73a4d09b2a1ace92a4094eeba014eb7dc4...9f919c42f0885e39870195fab8ce2a22621119b7,6,96,87,183,20,2010-02-04 22:02:20,2010-02-04 22:02:20
9f919c42f0885e39870195fab8ce2a22621119b7...251fab40291183c8e50ea0fabd23c30341cc72d3,5,59,54,113,19,2010-02-04 23:04:28,2010-02-04 23:04:28
251fab40291183c8e50ea0fabd23c30341cc72d3...5eb440c22bb87b1d69c14193954620b9f1cec023,3,6,6,12,8,2010-02-04 23:12:34,2010-02-04 23:12:34
5eb440c22bb87b1d69c14193954620b9f1cec023...6d75afe6d2ea26bb412becd1e8f7cab8031eaab4,4,95,91,186,24,2010-02-05 22:13:19,2010-02-05 22:13:19
6d75afe6d2ea26bb412becd1e8f7cab8031eaab4...9d566a0cd0225685efb192c195280b6857628d32,5,34,8,42,7,2010-02-05 22:41:54,2010-02-05 22:41:45
9d566a0cd0225685efb192c195280b6857628d32...799d72931a5a01de74bba69d8a6638cd57cec315,5,74,71,145,29,2010-02-09 21:13:18,2010-02-09 21:13:18
799d72931a5a01de74bba69d8a6638cd57cec315...9d566fe98c3fa0091efef4adb0178f063da74f7c,1,10,0,10,1,2010-02-09 22:59:24,2010-02-09 22:59:24
9d566fe98c3fa0091efef4adb0178f063da74f7c...b2a8a089b6c31c8ff176c2483f659caae4f71afb,4,4,4,8,4,2010-02-11 17:57:42,2010-02-11 17:57:42
b2a8a089b6c31c8ff176c2483f659caae4f71afb...6cc946413622f1cef97997849e73a06a00f876fd,10,180,167,347,52,2010-02-12 22:17:44,2010-02-12 22:16:33
6cc946413622f1cef97997849e73a06a00f876fd...7c8a2ccb8d7b595419dfbe9151928cd2533550e3,2,12,0,12,1,2010-02-12 22:25:10,2010-02-12 22:25:10
7c8a2ccb8d7b595419dfbe9151928cd2533550e3...3f9a2ab9bdfcd12cb7df74b0d38cecf2ee4ac94a,7,217,91,308,23,2010-02-13 03:39:01,2010-02-13 03:39:01
7b558b5382c864b00392f50fa5095e53f7b486d0...0e566fe6cb41de388df6793b350fb81aaa4a8476,12,369,198,567,30,2010-01-19 01:56:08,2010-01-19 01:56:08
0e566fe6cb41de388df6793b350fb81aaa4a8476...910ddbe34eb6268e9049ca91211d43663d629879,1,1,1,2,1,2010-01-19 01:58:43,2010-01-19 01:58:43
910ddbe34eb6268e9049ca91211d43663d629879...db2031c5a1df205e6db40ca6aba80930375069c0,4,40,15,55,16,2010-01-20 01:53:20,2010-01-20 01:53:20
db2031c5a1df205e6db40ca6aba80930375069c0...dc0db57b36bb6cd47dfea835a315f61b34ed8e1b,6,143,129,272,35,2010-01-20 14:52:50,2010-01-20 14:52:50
dc0db57b36bb6cd47dfea835a315f61b34ed8e1b...4950b86da536ba19890726ae518193b149e63417,3,16,6,22,6,2010-01-20 15:08:57,2010-01-20 15:08:57
4950b86da536ba19890726ae518193b149e63417...a12b81773fd7ec2ca5c6453a1a7957c18c3c4671,4,6152,2,6154,4,2010-01-20 15:24:30,2010-01-20 15:24:30
a12b81773fd7ec2ca5c6453a1a7957c18c3c4671...e41ee88ef85986dcd0fea23fefcc57d89cee5c0b,5,33,33,66,22,2010-01-22 19:21:22,2010-01-22 19:21:22
e41ee88ef85986dcd0fea23fefcc57d89cee5c0b...4460328bc1173f5d97fb4ff54edc041968486fce,18,572,635,1207,115,2010-01-23 23:54:58,2010-01-23 23:54:58
4460328bc1173f5d97fb4ff54edc041968486fce...b8ee8b8912ef4fa2f9ff55dc4f7ed27780da34bd,1,5,5,10,1,2010-01-23 23:58:12,2010-01-23 23:58:12
b8ee8b8912ef4fa2f9ff55dc4f7ed27780da34bd...c7719c24121b500f0bc2ac7c652d8ec0de418a37,2,2,3,5,3,2010-01-24 20:10:26,2010-01-24 20:10:26
c7719c24121b500f0bc2ac7c652d8ec0de418a37...efad9ec5be8da442af5fb3dffc08510f7a71e10f,17,347,351,698,185,2010-01-25 01:10:58,2010-01-25 01:10:58
efad9ec5be8da442af5fb3dffc08510f7a71e10f...a5c446441fee005975a82885771e8d931e7a4e7a,6,45,44,89,29,2010-01-25 03:12:01,2010-01-25 03:12:01
a5c446441fee005975a82885771e8d931e7a4e7a...0f42fa2930f5827ac9f1eac2ce09ea3bf9533563,3,6,8,14,6,2010-01-25 03:33:04,2010-01-25 03:33:04
0f42fa2930f5827ac9f1eac2ce09ea3bf9533563...473e57e22532f9b85fc9dcc1bcc53e12a10154c2,3,28,26,54,20,2010-01-25 04:44:17,2010-01-25 04:44:17
1500e91defa4020bfe9608749b25e585cd1d8e3d...8f9bf37bcf38165e89f37c147f9315cb8e72fc1f,1,0,5,5,1,2010-06-23 00:11:57,2010-06-23 00:11:57
8f9bf37bcf38165e89f37c147f9315cb8e72fc1f...4034a2d1e2efb6c76020273c96c3da5ae146f5ca,3,25,8,33,8,2010-07-13 21:09:53,2010-07-13 21:09:53
4034a2d1e2efb6c76020273c96c3da5ae146f5ca...ac3c2736c786abe996acc3d01d857dd5f0b3328a,1,1,1,2,1,2010-07-13 21:15:01,2010-07-13 21:15:01
3f9a2ab9bdfcd12cb7df74b0d38cecf2ee4ac94a...7e14dff90516a41ff1903cc44fe3389710f15556,4,18,15,33,10,2010-02-18 00:05:26,2010-02-18 00:05:26
3f9a2ab9bdfcd12cb7df74b0d38cecf2ee4ac94a...b561f6a0cc3e2e03c05925fbed3e06723f91b4b5,2,9,2,11,3,2010-02-17 05:30:15,2010-02-17 05:30:15
473e57e22532f9b85fc9dcc1bcc53e12a10154c2...3d99e0f6dee6569ca9471d419bda79aec95b9ebc,5,15,2,17,5,2010-01-29 04:44:34,2010-01-29 04:44:34
32361d03a147213747762e17d279639666ed85fb...0a57273f0000421639c926d4d180680e3a64c0f7,2,8,1,9,2,2010-07-14 23:40:27,2010-07-14 19:08:55
0a57273f0000421639c926d4d180680e3a64c0f7...e3e9ac86750b20fb8ad6765011e06d569899612d,3,42,13,55,5,2010-07-15 00:07:23,2010-07-15 00:07:23
e3e9ac86750b20fb8ad6765011e06d569899612d...17d2ced9cc7e45d1d7272a1217861e598e5522dd,5,18,15,33,10,2010-07-15 00:48:09,2010-07-15 00:48:09
17d2ced9cc7e45d1d7272a1217861e598e5522dd...09e2295975b5bb8dfc067303fee86a9f2ebb433d,1,5,4,9,1,2010-07-15 16:41:25,2010-07-15 16:41:25
09e2295975b5bb8dfc067303fee86a9f2ebb433d...9abd10e7b8a34b9dcd1a6af5ff37f57bd27cf920,4,63,34,97,9,2010-07-15 20:13:21,2010-07-15 20:13:21
9abd10e7b8a34b9dcd1a6af5ff37f57bd27cf920...1de82283dbf1bed2fc04700584dc1123b1e159fe,2,9,6,15,5,2010-07-15 20:35:00,2010-07-15 20:35:00
1de82283dbf1bed2fc04700584dc1123b1e159fe...7cef4358aea6f3cfa18dcfb8145d7bc0560bf157,4,20,9,29,6,2010-07-15 21:16:04,2010-07-15 21:16:04
7cef4358aea6f3cfa18dcfb8145d7bc0560bf157...cc097867f49673005d47a7f8f0cbe25f7d5c2163,1,4,0,4,1,2010-07-15 21:35:04,2010-07-15 21:35:04
cc097867f49673005d47a7f8f0cbe25f7d5c2163...7e96af0fdd9af8c479992363f68578305df0337e,5,72,10,82,8,2010-07-19 19:29:24,2010-07-19 19:29:24
7e96af0fdd9af8c479992363f68578305df0337e...bebfbeac0a3f25b3d0df00ada5c919adef9dd701,9,31,32,63,18,2010-07-20 23:55:32,2010-07-20 23:55:32
bebfbeac0a3f25b3d0df00ada5c919adef9dd701...0f4b068bd66cde63b222b114dbc1c5fec257a890,1,21,17,38,5,2010-07-21 00:03:34,2010-07-21 00:03:34
0f4b068bd66cde63b222b114dbc1c5fec257a890...719f6e15a052d50f30dcecc722193804a3d5eaed,2,1,34,35,4,2010-07-21 00:13:31,2010-07-21 00:13:31
719f6e15a052d50f30dcecc722193804a3d5eaed...b5bbfaeb80c3f89c65d14c72cff6f0e1c8aa497a,1,1,17,18,3,2010-07-21 20:28:14,2010-07-21 20:28:14
b5bbfaeb80c3f89c65d14c72cff6f0e1c8aa497a...849a05b5a578f19ddc3d24dc9fbd304e0e07612a,9,125,21,146,14,2010-07-22 18:18:32,2010-07-22 18:18:32
849a05b5a578f19ddc3d24dc9fbd304e0e07612a...2987f7f705baffad8081fc4a3a95eab79b0d9695,7,96,29,125,13,2010-07-22 22:32:57,2010-07-22 22:32:57
2987f7f705baffad8081fc4a3a95eab79b0d9695...8015e09e383bcd3ebf85d44cd68c67dd85db5771,4,86,23,109,26,2010-07-23 17:48:18,2010-07-23 17:48:18
8015e09e383bcd3ebf85d44cd68c67dd85db5771...748e91ba92af4a85de3579be504914092381c7e1,4,9,11,20,10,2010-07-23 18:38:52,2010-07-23 18:38:52
748e91ba92af4a85de3579be504914092381c7e1...1a730a9996f6a1ec420e23e5dae0b863b9c7ba12,2,1,2,3,2,2010-07-23 18:46:04,2010-07-23 18:46:04
1a730a9996f6a1ec420e23e5dae0b863b9c7ba12...2ac66b78f0d2068166c617e6e82d038ac4d46f0a,1,1,1,2,2,2010-07-23 19:01:59,2010-07-23 19:01:59
2ac66b78f0d2068166c617e6e82d038ac4d46f0a...3b41979891f5dc6a68e05cd5ed9c355c34774193,1,20,19,39,2,2010-07-23 20:36:08,2010-07-23 20:36:08
3b41979891f5dc6a68e05cd5ed9c355c34774193...b2b170099f957e6575e309c35fed42915e95dd47,2,7,0,7,3,2010-07-23 20:54:12,2010-07-23 20:54:12
b2b170099f957e6575e309c35fed42915e95dd47...b288cb08b450cd28423595de82693631cc6d6dda,4,23,16,39,12,2010-07-26 22:32:08,2010-07-26 22:32:08
b288cb08b450cd28423595de82693631cc6d6dda...94759f4c2cab91d35a18159a00fbdaec0af79aa9,19,0,3537,3537,19,2010-07-26 22:35:02,2010-07-26 22:35:02
94759f4c2cab91d35a18159a00fbdaec0af79aa9...a161a99ff8adfdf91202768950c6cddc93bf3101,1,13,7,20,5,2010-07-26 22:54:50,2010-07-26 22:54:50
a161a99ff8adfdf91202768950c6cddc93bf3101...8ddee9bb25ade2bbe7d57db6353b29867606c184,2,15,0,15,2,2010-07-26 23:11:25,2010-07-26 23:11:25
32361d03a147213747762e17d279639666ed85fb...9998b8dcbb2674ac680fd6598aea0840e69c0e1b,2,8,1,9,2,2010-07-14 19:08:55,2010-07-14 19:08:55
060c18c796f59703193efcf61818684187091663...2f99af1cce0e7bd440f937d2557dbd583d8a6129,3,134,126,260,45,2010-02-18 04:50:13,2010-02-18 04:50:13
2f99af1cce0e7bd440f937d2557dbd583d8a6129...97c02c9def42655e28ec86fed288ca363b152f9e,4,19,12,31,9,2010-02-20 22:56:06,2010-02-20 22:56:06
97c02c9def42655e28ec86fed288ca363b152f9e...b628de9758c313b106d22468f4b49bd223698fd5,4,158,139,297,86,2010-02-21 01:27:21,2010-02-21 01:27:21
b628de9758c313b106d22468f4b49bd223698fd5...6431efef8cb6d0c77bf107b09b64b6f013b75965,2,25,9,34,10,2010-02-26 21:08:28,2010-02-26 21:08:28
6431efef8cb6d0c77bf107b09b64b6f013b75965...bf838aab5d65a1019a4867b496e971c488589512,2,74,75,149,34,2010-02-26 21:12:23,2010-02-26 21:12:23
bf838aab5d65a1019a4867b496e971c488589512...cc71b745c3c821f5e012a363ae3267252a81fddb,12,451,4253,4704,62,2010-03-15 21:36:50,2010-03-15 21:36:50
cc71b745c3c821f5e012a363ae3267252a81fddb...9b178d52385ac283b1af7f6ea32dcba4b0eedc49,1,10,1,11,1,2010-03-15 21:41:28,2010-03-15 21:41:28
9b178d52385ac283b1af7f6ea32dcba4b0eedc49...e3565dfea6bc097a79d14cc6ab92ecd3bd8e63cc,3,11,3,14,3,2010-03-15 21:47:28,2010-03-15 21:47:28
e3565dfea6bc097a79d14cc6ab92ecd3bd8e63cc...f9f181a33e10bb698ff437bb3939f544ca92e39f,2,5,1,6,1,2010-03-15 22:02:52,2010-03-15 22:02:52
f9f181a33e10bb698ff437bb3939f544ca92e39f...79b743e52feb2c57ba0ae42d6d2742bc2189b22f,2,26,6,32,8,2010-03-15 22:57:12,2010-03-15 22:57:12
8ddee9bb25ade2bbe7d57db6353b29867606c184...2a30a02f015dd54846bb62d1f05e82b3cf76ef9f,6,27,26,53,13,2010-07-27 22:54:50,2010-07-27 22:54:50
2a30a02f015dd54846bb62d1f05e82b3cf76ef9f...6bd8006edcbfe1dc1be8cb865fbcfe25157fe117,3,20,16,36,3,2010-07-27 23:53:23,2010-07-27 23:53:23
6bd8006edcbfe1dc1be8cb865fbcfe25157fe117...1b768b84439e725010acc943ebfda462e49d3704,8,165,65,230,23,2010-07-29 19:54:13,2010-07-29 19:50:14
1b768b84439e725010acc943ebfda462e49d3704...03aac8b0ab17a9e8a41c5794f1e838315875051a,6,31,17,48,18,2010-07-29 22:26:10,2010-07-29 22:26:10
03aac8b0ab17a9e8a41c5794f1e838315875051a...af1eb6914e6e4b72e6baabb075138b7716184ff7,1,1,1,2,1,2010-07-29 22:38:14,2010-07-29 22:38:14
af1eb6914e6e4b72e6baabb075138b7716184ff7...cdda664f8990351453baa26fc3dcd53329e72e68,4,18,6,24,7,2010-07-30 17:56:36,2010-07-30 17:56:36
cdda664f8990351453baa26fc3dcd53329e72e68...1e1c8c82f98f4a6d6ed77e7bf34ac5177fe33d4f,1,18,17,35,3,2010-07-30 18:45:52,2010-07-30 18:45:52
1e1c8c82f98f4a6d6ed77e7bf34ac5177fe33d4f...059703495dc703354056f1d16a73591959852370,3,9,9,18,8,2010-07-30 22:19:43,2010-07-30 22:19:43
059703495dc703354056f1d16a73591959852370...89245f3a527415a80d46b37054b558454c314532,2,25,70,95,4,2010-08-03 23:53:27,2010-08-03 23:53:27
f09415d0de5d383efc9e2cb35d1323a5aac2371d...1087270c95f6bbafd3715c9a5eecdafac79c9daa,4,51,19,70,9,2010-08-18 23:04:40,2010-08-18 23:04:40
1087270c95f6bbafd3715c9a5eecdafac79c9daa...5ddd8d958686c5075b6c58b700f19b4bdea90e1d,23,155,257,412,108,2010-08-19 00:26:33,2010-08-18 23:23:12
5ddd8d958686c5075b6c58b700f19b4bdea90e1d...9632c99b0a2b7e685381042cff8a78c059473f7f,1,4,5,9,5,2010-08-19 00:34:14,2010-08-19 00:34:14
9632c99b0a2b7e685381042cff8a78c059473f7f...625f32b7eb71647dfe12ec1b3fe9b9ae4736e8b3,2,124,154,278,42,2010-08-19 00:50:21,2010-08-19 00:50:21
625f32b7eb71647dfe12ec1b3fe9b9ae4736e8b3...9878355df7af29a621403f9303691f0f4d547624,1,2,2,4,2,2010-08-19 01:15:19,2010-08-19 01:15:19
9878355df7af29a621403f9303691f0f4d547624...07699b1a70f2a979ecd600c826ba89e79279925c,1,0,1,1,1,2010-09-06 14:46:28,2010-09-06 14:46:28
07699b1a70f2a979ecd600c826ba89e79279925c...e3f760fbadedc977d9f5f461feafbaecab5a9046,6,438,4,442,17,2010-09-14 20:51:01,2010-09-14 20:51:01
e3f760fbadedc977d9f5f461feafbaecab5a9046...894ffadc8c35da6c7daf3e16a9f4931b24f3b231,10,33,37,70,26,2010-09-14 21:22:15,2010-09-14 21:22:15
79b743e52feb2c57ba0ae42d6d2742bc2189b22f...923289112e34c2d426f6b2e687e93601894fb088,1,121,0,121,1,2010-03-16 17:30:26,2010-03-16 17:30:26
79b743e52feb2c57ba0ae42d6d2742bc2189b22f...39c6c5975bedf6e1610f7328a088acda9ab3406a,12,236,30,266,26,2010-03-16 00:02:54,2010-03-16 00:02:54
39c6c5975bedf6e1610f7328a088acda9ab3406a...8e9b7c671ddf31c50dd0191a765a787780be97ed,6,52,0,52,6,2010-03-16 00:03:24,2010-03-16 00:03:24
8e9b7c671ddf31c50dd0191a765a787780be97ed...9e1f085ba6e224893abc04be181f8748939bfe77,2,7,2,9,2,2010-03-16 00:05:45,2010-03-16 00:05:45
89245f3a527415a80d46b37054b558454c314532...49e08f5d2c328d095b5a53413474307001240ac8,1,3,4,7,3,2010-08-05 21:01:46,2010-08-05 21:01:46
49e08f5d2c328d095b5a53413474307001240ac8...4aac29da18ea4680a928edccc28dd8edad93e593,2,8,1,9,2,2010-08-10 18:17:08,2010-08-10 18:17:08
4aac29da18ea4680a928edccc28dd8edad93e593...9b392eca3597fdc9dab81d88df75bef75f6e678f,2,19,8,27,11,2010-08-10 18:23:23,2010-08-10 18:23:23
9b392eca3597fdc9dab81d88df75bef75f6e678f...7673b2a2b291a4fc627e1cbdb8201f116a97b016,2,9,0,9,2,2010-08-10 18:46:12,2010-08-10 18:46:12
b42072733c3afd03a49457d88ffed28ebe55655e...da95010350882d9e13b5e461fb4a1e05bc7d065c,7,154,139,293,35,2010-07-27 22:43:14,2010-07-27 22:43:14
da95010350882d9e13b5e461fb4a1e05bc7d065c...32c4aee1cdb601550e948b52a3fa7b4824cfbf1f,4,64,86,150,4,2010-07-27 22:53:55,2010-07-27 22:53:55
32c4aee1cdb601550e948b52a3fa7b4824cfbf1f...e8b477f5b1f6fcca99ea54731e7c4f09ef17b0f7,2,21,38,59,3,2010-07-27 23:02:51,2010-07-27 23:02:51
e8b477f5b1f6fcca99ea54731e7c4f09ef17b0f7...ef88eb9a71ee7666029c4fb5eb731ce2e986cecc,5,18,16,34,14,2010-07-28 00:04:37,2010-07-28 00:04:37
2a3a449c6d55cf41a9ceb76608438c0488cbe3c0...2acce6a3346129b0b7a0954e9007531ca8f2b4fa,1,0,2,2,1,2010-09-15 22:20:35,2010-09-15 04:53:19
2acce6a3346129b0b7a0954e9007531ca8f2b4fa...21e78c443fc5ced77f1ae7e3fc1647f7d9a22115,1,6,5,11,4,2010-09-15 22:20:35,2010-09-15 16:12:04
21e78c443fc5ced77f1ae7e3fc1647f7d9a22115...b798ee80c29d877aa8c9934382a140a080fa13bc,1,2,2,4,2,2010-09-15 22:22:55,2010-09-15 17:19:11
b798ee80c29d877aa8c9934382a140a080fa13bc...293f34cd64886a1dddae9c295fafde5c47029a3b,2,34,22,56,4,2010-09-15 22:23:22,2010-09-15 17:27:58
293f34cd64886a1dddae9c295fafde5c47029a3b...9627c4b50e1f8964fc59b0c2fd4914bd67514041,2,16,1,17,3,2010-09-20 09:57:50,2010-09-17 17:44:23
9627c4b50e1f8964fc59b0c2fd4914bd67514041...558f22138c2094d2328b9ed357f1c9fe83f9faf7,2,101,5,106,7,2010-09-21 08:05:11,2010-09-20 14:23:20
558f22138c2094d2328b9ed357f1c9fe83f9faf7...9dfdac2be2e75b2f58eac2bca157b49a0baef4f6,1,0,0,0,0,2010-09-21 08:06:49,2010-09-20 15:21:03
9dfdac2be2e75b2f58eac2bca157b49a0baef4f6...0d717310fd307cfc192b87f5d825c2963db25fa1,1,3,1,4,1,2010-09-21 08:37:12,2010-09-21 08:28:26
0d717310fd307cfc192b87f5d825c2963db25fa1...125d725e7dcd76b838925ac997b35afad4266752,2,13,6,19,2,2010-09-21 14:27:47,2010-09-21 14:19:07
125d725e7dcd76b838925ac997b35afad4266752...006fd2ca252400e87a419b929e00ea0277ff86ad,8,106,18,124,21,2010-09-21 17:20:34,2010-09-21 17:20:34
006fd2ca252400e87a419b929e00ea0277ff86ad...eefb920d0e0345485a8eb120aeecc3b1aa9f6719,1,4,8,12,3,2010-09-22 07:14:50,2010-09-22 07:11:36
eefb920d0e0345485a8eb120aeecc3b1aa9f6719...0649009624e8e7bd6fb39537f62c6f00facbfb16,11,206,259,465,41,2010-09-22 14:17:44,2010-09-22 11:24:40
0649009624e8e7bd6fb39537f62c6f00facbfb16...7cb7fb91c673c006612c38a2ef07d850f642c8df,1,15,0,15,1,2010-09-23 09:19:26,2010-09-21 16:55:09
7cb7fb91c673c006612c38a2ef07d850f642c8df...a8931c9021fa15190927b913a66fb34deedf9e20,2,11,40,51,8,2010-09-23 09:23:43,2010-09-21 17:13:51
a8931c9021fa15190927b913a66fb34deedf9e20...acbcfbaf30f73f25df1c45da41132091e7022240,6,147,37,184,40,2010-09-23 09:23:52,2010-09-22 21:37:17
acbcfbaf30f73f25df1c45da41132091e7022240...29f995fc7897d0ee0e82c77153b1b318a993c99b,3,2,769,771,3,2010-09-23 10:21:27,2010-09-23 10:13:55
29f995fc7897d0ee0e82c77153b1b318a993c99b...af030b888e10c978dc68032758b18e36de7b4cf1,12,0,1640,1640,12,2010-09-23 10:38:28,2010-09-23 10:38:28
af030b888e10c978dc68032758b18e36de7b4cf1...db42221828994a6b3056a96924f4a302e72409d4,1,1,1,2,1,2010-09-23 11:28:33,2010-09-23 11:28:33
db42221828994a6b3056a96924f4a302e72409d4...0d5407bc1e976f1f9908d01cfdf848b6c212d135,2,21,7,28,2,2010-09-23 11:50:10,2010-09-23 11:48:17
0d5407bc1e976f1f9908d01cfdf848b6c212d135...27868f17ded5e668aad17739cecd228dc3c87219,2,2,13,15,5,2010-09-23 11:53:38,2010-09-23 11:53:38
27868f17ded5e668aad17739cecd228dc3c87219...9171a2b2b50d0a8217c98e0017a7d2a0a1a37380,3,231,205,436,4,2010-09-26 17:43:39,2010-09-26 17:43:39
9171a2b2b50d0a8217c98e0017a7d2a0a1a37380...3eec8c1a517f8b93a5afd15b7f83b33c5df7e54b,5,65,30,95,27,2010-09-27 06:54:31,2010-09-25 22:29:48
3eec8c1a517f8b93a5afd15b7f83b33c5df7e54b...984acdc6270df1dee5796ed44efebfb9ff6706c7,5,101,35,136,29,2010-09-27 22:10:05,2010-09-27 06:45:05
984acdc6270df1dee5796ed44efebfb9ff6706c7...eb8d46d380a2005dbec3973d40e1dbc27991fdb7,3,26,8,34,8,2010-09-29 16:52:03,2010-09-27 23:00:05
eb8d46d380a2005dbec3973d40e1dbc27991fdb7...0af763dcec8b9f6b17208ac58607cd1124382f63,1,8,4,12,3,2010-09-30 23:44:45,2010-09-30 23:33:34
0af763dcec8b9f6b17208ac58607cd1124382f63...8248e77a7b910bcbc71ca25c06bef44dd6712990,4,80,1,81,5,2010-09-30 23:44:46,2010-09-30 15:07:36
8248e77a7b910bcbc71ca25c06bef44dd6712990...87f9a4c5660903893ccceca15987cf00d1495758,1,40,4,44,4,2010-10-01 23:06:32,2010-10-01 23:06:32
87f9a4c5660903893ccceca15987cf00d1495758...328ff6c9265a16ae51cb01a8779445819f4118a1,1,24,1,25,2,2010-10-04 15:53:24,2010-10-04 15:53:24
328ff6c9265a16ae51cb01a8779445819f4118a1...81052d4a6269b25885bb3d9642fdf399cc1684e6,3,3,3,6,3,2010-10-04 16:00:09,2010-10-04 16:00:09
81052d4a6269b25885bb3d9642fdf399cc1684e6...8e40e7070d44d11332adc1426b7076c2be570b2b,3,6,2,8,3,2010-10-04 23:12:13,2010-10-04 23:08:18
8e40e7070d44d11332adc1426b7076c2be570b2b...a930e782a56eca047130e5a32f1ce97a0da05927,2,4,26,30,3,2010-10-06 17:05:51,2010-10-05 06:42:21
a930e782a56eca047130e5a32f1ce97a0da05927...c30807d1413ea9942bcb065a02997082bf4291aa,1,4,1,5,1,2010-10-07 16:34:22,2010-10-07 16:31:19
c30807d1413ea9942bcb065a02997082bf4291aa...772e32c220193f026c6f4b4674b44ab915e6f0f0,3,56,23,79,16,2010-10-08 23:23:26,2010-10-07 00:01:41
772e32c220193f026c6f4b4674b44ab915e6f0f0...e3ea980c819f62b8c2021f813e3534e4e5731d7d,1,3,3,6,3,2010-10-08 23:25:12,2010-10-08 23:25:12
e3ea980c819f62b8c2021f813e3534e4e5731d7d...8490bb921bd03239f5856cd44b7e21ef6db23eca,2,52,1,53,4,2010-10-09 03:41:19,2010-10-09 00:11:45
8490bb921bd03239f5856cd44b7e21ef6db23eca...3bd4abba6bb4c1f8312e25a3d87fbfefcd218e0d,3,14,14,28,6,2010-10-10 06:04:09,2010-10-07 20:49:43
3bd4abba6bb4c1f8312e25a3d87fbfefcd218e0d...7e47a2d016676f37287203f26689cce1ee1eaa0c,2,5,1,6,2,2010-10-12 20:37:45,2010-10-11 21:31:32
7e47a2d016676f37287203f26689cce1ee1eaa0c...70ff7a2639fc55936854ad04a6242a700ae71a02,6,60,28,88,32,2010-10-12 20:37:46,2010-10-11 21:36:38
70ff7a2639fc55936854ad04a6242a700ae71a02...451a711343f0d902e0a652a98c54d9aa94451b9b,1,1,1,2,1,2010-10-12 20:37:46,2010-10-12 06:14:39
451a711343f0d902e0a652a98c54d9aa94451b9b...7ed2191b07f2a89ff17ee906848bd9432216ee96,1,1,1,2,1,2010-10-12 21:48:59,2010-10-12 21:48:59
7ed2191b07f2a89ff17ee906848bd9432216ee96...fbfd160316de1b99e7afa4102c7fae2ee5b9c1f5,1,17,4,21,3,2010-10-12 23:28:46,2010-10-12 23:28:46
fbfd160316de1b99e7afa4102c7fae2ee5b9c1f5...d9abfe8a7e488be8725f56077527b16f7c79546a,17,347,213,560,121,2010-10-12 23:33:06,2010-10-09 00:30:13
d9abfe8a7e488be8725f56077527b16f7c79546a...2cb9497d02afdcfc19ea52fddcd6d1f04d81ffdb,4,59,16,75,6,2010-10-13 04:52:04,2010-10-13 04:52:04
2cb9497d02afdcfc19ea52fddcd6d1f04d81ffdb...3ab49538a414a36c97ed3735c2473eefcf7be073,3,45,3,48,5,2010-10-13 17:51:16,2010-10-13 17:51:16
3ab49538a414a36c97ed3735c2473eefcf7be073...805753dba47f7ef5b34af9579c1d0486f5f4ea68,4,44,4,48,9,2010-10-13 19:47:10,2010-10-13 19:47:10
805753dba47f7ef5b34af9579c1d0486f5f4ea68...075bdf231689b0ccc9b1b03862ab06992bc90e6e,2,24,0,24,1,2010-10-14 00:32:45,2010-10-13 17:55:02
075bdf231689b0ccc9b1b03862ab06992bc90e6e...818b507d3cdff0d32f12917def213734be06e3b0,1,8,2,10,2,2010-10-14 00:42:49,2010-10-12 23:52:33
818b507d3cdff0d32f12917def213734be06e3b0...80c64b48f319735b5fe4930aa253ffb8587d9233,1,1,0,1,1,2010-10-14 00:42:55,2010-10-13 19:23:25
80c64b48f319735b5fe4930aa253ffb8587d9233...1cc85a77cf609c5fc8475ab3b6281b165d284099,1,2,2,4,1,2010-10-14 00:42:55,2010-10-13 22:23:11
1cc85a77cf609c5fc8475ab3b6281b165d284099...0f104317dff5628765e26cc68df7dd1175b2aa5e,3,154,75,229,4,2010-10-14 06:15:40,2010-10-14 06:09:26
0f104317dff5628765e26cc68df7dd1175b2aa5e...03df6cbddbb80186caf571e29957370b2ef9881c,32,1979,900,2879,117,2010-10-14 16:47:39,2010-10-08 23:43:40
03df6cbddbb80186caf571e29957370b2ef9881c...692333f2f5ce8330c3b8a5a88b027587436ac2ea,1,5,0,5,1,2010-10-14 19:36:29,2010-10-14 19:36:29
692333f2f5ce8330c3b8a5a88b027587436ac2ea...d9c8284ea5c56e703c0fa7877c1f2a38d7b7d4d7,1,0,1,1,1,2010-10-14 21:52:12,2010-10-14 21:52:12
d9c8284ea5c56e703c0fa7877c1f2a38d7b7d4d7...a7da160c1d5f1614a7fa66ca9c31edb6edc7e0d8,1,1,1,2,1,2010-10-14 22:44:14,2010-10-14 22:44:14
a7da160c1d5f1614a7fa66ca9c31edb6edc7e0d8...7903f4d9407b0ffe478341f9f88779f34efb218e,1,12,15,27,4,2010-10-15 04:49:59,2010-10-15 04:01:25
7903f4d9407b0ffe478341f9f88779f34efb218e...de66a319b451cc0beb3e9da7657f6cc8f9733de0,1,0,1,1,1,2010-10-15 17:55:58,2010-10-15 17:55:58
de66a319b451cc0beb3e9da7657f6cc8f9733de0...d320e3d2c3b72896603a3df3abd26adc0bfa3c10,3,174,174,348,3,2010-10-15 18:58:55,2010-10-15 18:58:55
d320e3d2c3b72896603a3df3abd26adc0bfa3c10...a36964799be3d21163ba6350d862fced2bbd3437,12,575,571,1146,67,2010-10-15 20:44:53,2010-10-15 20:44:53
a36964799be3d21163ba6350d862fced2bbd3437...ff52f47537c9bf5c6acc636f25ae5f7f70d20f3b,2,12,7,19,4,2010-10-15 21:06:30,2010-10-15 21:06:30
ff52f47537c9bf5c6acc636f25ae5f7f70d20f3b...312f93574e0d028e13933a342b726382479b421e,1,4,0,4,2,2010-10-17 04:29:30,2010-10-16 21:52:45
312f93574e0d028e13933a342b726382479b421e...f8865459d554ef372cf732da26014dbe74275da8,1,1,0,1,1,2010-10-17 04:31:23,2010-10-17 04:14:46
f8865459d554ef372cf732da26014dbe74275da8...b96f7369516bbc4f20c82f709a0ae623659905bb,2,48,23,71,9,2010-10-17 04:43:28,2010-10-17 04:36:49
b96f7369516bbc4f20c82f709a0ae623659905bb...ce49c361d71d1c5f8dc5b773298945957dba0175,1,4,4,8,3,2010-10-17 05:08:58,2010-10-17 05:08:58
ce49c361d71d1c5f8dc5b773298945957dba0175...732bcd8a368d50995c796373e37be5a4d3b2bc8c,1,11,0,11,1,2010-10-17 05:10:01,2010-10-16 15:13:53
732bcd8a368d50995c796373e37be5a4d3b2bc8c...46c6406b259556c7bdf82b6d8d0f3adfbf4bf686,1,4,0,4,1,2010-10-17 05:10:01,2010-10-16 15:15:08
46c6406b259556c7bdf82b6d8d0f3adfbf4bf686...b08e2be64c749da433d6c8a4e764f3c80c6f1e86,1,2,2,4,1,2010-10-17 05:10:01,2010-10-16 15:18:41
b08e2be64c749da433d6c8a4e764f3c80c6f1e86...54090d776613f9e7bac6a77a037412b285222d58,1,1,0,1,1,2010-10-17 05:10:01,2010-10-05 17:50:16
54090d776613f9e7bac6a77a037412b285222d58...f24ec0c8f74c85edb3991a8ca6f35056cd084fae,1,2,1,3,1,2010-10-17 05:10:01,2010-10-06 01:22:19
f24ec0c8f74c85edb3991a8ca6f35056cd084fae...352dbfa38fca660a80d6fae2c6e810f820247791,4,450,360,810,92,2010-10-18 04:13:28,2010-10-18 04:12:51
352dbfa38fca660a80d6fae2c6e810f820247791...9e9bdbdc405b6afecd2e536e375c9d8fe40f110b,11,384,345,729,128,2010-10-18 15:50:36,2010-10-15 22:28:58
9e9bdbdc405b6afecd2e536e375c9d8fe40f110b...341b2b3a9b1257e376a7d319f131008162f584ae,2,298,89,387,29,2010-10-18 16:58:37,2010-10-16 14:22:36
341b2b3a9b1257e376a7d319f131008162f584ae...1cad16c6f9144113e2b458ce91af8fcb0211c173,1,39,40,79,39,2010-10-18 17:04:15,2010-10-16 14:22:36
1cad16c6f9144113e2b458ce91af8fcb0211c173...d0e55bf4465bdfe6660f75d26882bc1d9da9b924,2,1,24,25,3,2010-10-18 21:13:48,2010-10-18 18:19:49
d0e55bf4465bdfe6660f75d26882bc1d9da9b924...7059579c7499337c7946f3877ce77dd9a04ea22a,14,182,150,332,45,2010-10-18 23:24:43,2010-10-16 04:38:41
7059579c7499337c7946f3877ce77dd9a04ea22a...4bef371e5aff7e7ceda2945c96d3e9a0614e0e14,2,4,4,8,4,2010-10-18 23:24:43,2010-10-18 05:53:08
4bef371e5aff7e7ceda2945c96d3e9a0614e0e14...ffb968b08b68351e9e2e19fd7992d55ddcdedb84,1,1,21,22,3,2010-10-18 23:24:44,2010-10-18 18:15:44
ffb968b08b68351e9e2e19fd7992d55ddcdedb84...a1fa23397f12e0b52838530a993f14491ad50869,1,21,16,37,10,2010-10-19 05:24:44,2010-10-19 05:24:44
a1fa23397f12e0b52838530a993f14491ad50869...e7e894a2e36e042be6d62af56b0f3126f4e4fc77,13,648,256,904,64,2010-10-19 07:45:38,2010-10-18 21:02:18
e7e894a2e36e042be6d62af56b0f3126f4e4fc77...01c7abab35dbdee711c54875424b388f8631a3c0,16,119,152,271,77,2010-10-19 22:56:53,2010-10-19 22:34:58
01c7abab35dbdee711c54875424b388f8631a3c0...977cb7e03e8cc81d2a1d05a723b51aa08999e10b,1,0,0,0,0,2010-10-19 23:02:41,2010-10-19 23:02:41
977cb7e03e8cc81d2a1d05a723b51aa08999e10b...406373b5db841bada476d290542c9c49515f18fe,5,30,29,59,28,2010-10-19 23:14:16,2010-10-19 23:14:16
406373b5db841bada476d290542c9c49515f18fe...a0ac6725ede819a726d484ebafa72be76a6dd2b8,1,2,2,4,2,2010-10-19 23:25:23,2010-10-19 23:25:23
a0ac6725ede819a726d484ebafa72be76a6dd2b8...c5cfe2b3936f3175a97c7ac3f4b5f47632f197f4,2,7,1,8,2,2010-10-20 03:38:49,2010-10-20 03:38:49
c5cfe2b3936f3175a97c7ac3f4b5f47632f197f4...286d1fe434687a1c0e3ddc6cf7214896704d97b3,1,1,1,2,2,2010-10-20 04:03:34,2010-10-20 04:03:34
286d1fe434687a1c0e3ddc6cf7214896704d97b3...a27198d52e61adb9cedde04e51bbec74e66089da,2,53,23,76,5,2010-10-20 04:58:01,2010-10-18 19:35:31
a27198d52e61adb9cedde04e51bbec74e66089da...9c8b1800b90e14b643bab6ada8e96f8f850e84a6,2,6,2,8,3,2010-10-20 14:22:15,2010-10-20 14:22:15
9c8b1800b90e14b643bab6ada8e96f8f850e84a6...2115db69035c5993533fe7a3825e64cf6e9068ad,15,429,138,567,120,2010-10-20 21:38:00,2010-10-19 20:17:49
2115db69035c5993533fe7a3825e64cf6e9068ad...644c8514c54518e350b0c2a0e17a9af09ed340f9,2,72,4,76,4,2010-10-20 21:48:35,2010-10-20 00:07:20
644c8514c54518e350b0c2a0e17a9af09ed340f9...7530eea7035e26a0bcc358c8ef94c79debabddf4,1,36,0,36,1,2010-10-20 21:48:35,2010-10-20 00:08:00
7530eea7035e26a0bcc358c8ef94c79debabddf4...2e687ee56fb81e96c0f45b2655a1a723331e2d20,3,44,35,79,13,2010-10-20 21:48:35,2010-10-20 04:19:28
2e687ee56fb81e96c0f45b2655a1a723331e2d20...6f3a757a37cf26f358220c52ff7db2ae56f31642,2,28,3,31,4,2010-10-20 21:48:35,2010-10-20 04:53:16
6f3a757a37cf26f358220c52ff7db2ae56f31642...2a9579a0ea72be0d03296eca08d481acbc9d55c5,1,2,2,4,1,2010-10-20 22:51:36,2010-10-20 21:49:55
2a9579a0ea72be0d03296eca08d481acbc9d55c5...c53a37ed9149c1437b8a6da3047c3154371823ec,1,2,2,4,1,2010-10-20 22:52:55,2010-10-20 22:41:32
c53a37ed9149c1437b8a6da3047c3154371823ec...68f074c29968ea8b43a987757fa5defee2ffcefc,1,29,0,29,1,2010-10-21 00:00:36,2010-10-21 00:00:36
68f074c29968ea8b43a987757fa5defee2ffcefc...c6107fe8acbc2c7631c728044bb57b608c3aeef1,1,10,7,17,6,2010-10-21 00:14:31,2010-10-21 00:14:31
c6107fe8acbc2c7631c728044bb57b608c3aeef1...05d4971abb5b8e21c5d33a71771a961c7932206b,5,17,11,28,12,2010-10-21 06:17:59,2010-10-21 06:17:59
05d4971abb5b8e21c5d33a71771a961c7932206b...aaabeb8c5e8657b6382463822aad0b4e163e544b,1,30,30,60,29,2010-10-21 06:51:49,2010-10-21 06:51:49
aaabeb8c5e8657b6382463822aad0b4e163e544b...b41bc98c54502cea070a8ca11b5d267e02f30701,1,167,17,184,4,2010-10-21 16:26:05,2010-10-21 03:26:34
b41bc98c54502cea070a8ca11b5d267e02f30701...a6cfa43c19e6a5940e5c5a79d0bdc93c89781aa0,1,15,9,24,2,2010-10-22 21:26:18,2010-10-22 21:26:18
a6cfa43c19e6a5940e5c5a79d0bdc93c89781aa0...1efef67b5fc8e4b6789d9c78f5bd635bca2a1951,1,3,3,6,3,2010-10-22 21:27:03,2010-10-22 21:27:03
1efef67b5fc8e4b6789d9c78f5bd635bca2a1951...68217d427cbbb4d8a83d6a3b820c0c42401b4504,1,8,1,9,2,2010-10-22 23:40:04,2010-10-22 23:40:04
68217d427cbbb4d8a83d6a3b820c0c42401b4504...8a867cee229b78f5bfde6a05fdbe0d7d3d608e11,13,498,15,513,12,2010-10-23 05:46:51,2010-10-23 05:46:51
8a867cee229b78f5bfde6a05fdbe0d7d3d608e11...6ddcf918610c1dd094a964fc03e129a67f17dfaa,9,52,50,102,41,2010-10-23 20:12:45,2010-10-23 20:10:42
6ddcf918610c1dd094a964fc03e129a67f17dfaa...d74ef497defa77c92873b09b7b6f4e19ae175779,5,30,2,32,6,2010-10-23 20:42:11,2010-10-23 20:42:11
d74ef497defa77c92873b09b7b6f4e19ae175779...833e0ae343651a35ccce0940b048e0b5022adc7b,3,12,4,16,5,2010-10-23 21:22:30,2010-10-22 18:09:43
833e0ae343651a35ccce0940b048e0b5022adc7b...64063b5d41c5ebac2835a83d9da40974da4d4820,2,99,42,141,23,2010-10-23 21:22:54,2010-10-22 02:24:03
64063b5d41c5ebac2835a83d9da40974da4d4820...bbd87c9425ae984f632783b1f33f415ec1747ca6,2,7,7,14,5,2010-10-23 21:22:54,2010-10-22 23:45:56
bbd87c9425ae984f632783b1f33f415ec1747ca6...04a4d8b061d98f46dc97fb550d388d248845b369,2,33,0,33,2,2010-10-23 21:22:54,2010-10-22 23:44:14
04a4d8b061d98f46dc97fb550d388d248845b369...1391f19fb49275af59230afef51b472c58d7818c,2,11,3,14,3,2010-10-23 21:38:08,2010-10-23 21:37:44
1391f19fb49275af59230afef51b472c58d7818c...5b40e87ac687fc52ba86f39daf62975b169acf41,4,212,0,212,5,2010-10-23 21:38:08,2010-10-23 05:13:14
5b40e87ac687fc52ba86f39daf62975b169acf41...4fc21414581be1825a7ffb5cfda98eda501652d0,2,20,4,24,4,2010-10-23 23:25:53,2010-10-23 23:25:53
4fc21414581be1825a7ffb5cfda98eda501652d0...4e9a2aa10ec6e84377aebd37fd3ae44af3d9423a,2,3,11,14,3,2010-10-24 01:26:47,2010-10-24 01:26:47
4e9a2aa10ec6e84377aebd37fd3ae44af3d9423a...841013a4c4d25acf6fc9ff40e449c3d0a4b82ec3,2,17,5,22,6,2010-10-25 17:44:03,2010-10-24 01:44:32
841013a4c4d25acf6fc9ff40e449c3d0a4b82ec3...4fdab3765919e9fffc6d2f84e74754b1012997be,12,835,37,872,26,2010-10-26 20:41:07,2010-10-19 04:20:47
4fdab3765919e9fffc6d2f84e74754b1012997be...4c61fc01f9c251c39f540316cc82332bc8b3f370,2,113,17,130,7,2010-10-26 20:47:50,2010-10-26 05:05:38
4c61fc01f9c251c39f540316cc82332bc8b3f370...42855e436327eb75050f98e2c1791b5448a49e9d,1,8,9,17,2,2010-10-26 20:47:50,2010-10-26 05:17:51
42855e436327eb75050f98e2c1791b5448a49e9d...3eb0c8bc67644412f34e55945f4b538f87bbb003,1,1,1,2,1,2010-10-26 20:47:50,2010-10-26 05:08:30
3eb0c8bc67644412f34e55945f4b538f87bbb003...1d52349440d40de527b5d7f3849070f525c1b79b,4,16,3,19,5,2010-10-26 21:25:01,2010-10-26 21:25:01
1d52349440d40de527b5d7f3849070f525c1b79b...40d7e66f408eaaa66efd8d7934ab2eb3324236a1,37,1362,648,2010,182,2010-10-26 22:17:57,2010-10-24 21:14:45
40d7e66f408eaaa66efd8d7934ab2eb3324236a1...9c0225512c63ebfc37e6408cc155d9da1fe682c9,14,131,86,217,53,2010-10-26 23:33:59,2010-10-26 22:35:58
9c0225512c63ebfc37e6408cc155d9da1fe682c9...72b7a1c531963de8715fab567f75a90ba9d56ce6,1,99,0,99,1,2010-10-26 23:44:59,2010-10-26 23:44:59
72b7a1c531963de8715fab567f75a90ba9d56ce6...943377a091bd7521d33e680dcd2141f7f9fa10c4,1,2,2,4,2,2010-10-27 04:06:24,2010-10-27 04:06:24
943377a091bd7521d33e680dcd2141f7f9fa10c4...01c52e92b120eea498e0352a42a489d55e7d9979,5,122,12,134,10,2010-10-27 04:58:00,2010-10-24 04:40:27
01c52e92b120eea498e0352a42a489d55e7d9979...ec885489a2c86ec39a2465a27ae0257ebd72bfaf,1,19,1,20,1,2010-10-27 05:17:37,2010-10-27 05:17:37
ec885489a2c86ec39a2465a27ae0257ebd72bfaf...0ffb47bdb6ea9c17e8adb6740aa70cc5299ea235,1,1,1,2,1,2010-10-27 05:18:25,2010-10-27 05:18:25
0ffb47bdb6ea9c17e8adb6740aa70cc5299ea235...9c6794a044cb1513fc32dbd27401dc9d103318df,1,3,0,3,1,2010-10-27 05:48:34,2010-10-27 05:48:34
9c6794a044cb1513fc32dbd27401dc9d103318df...ee8465bf1008f6c65398a1283aac9129c25a2f1f,1,2,2,4,1,2010-10-27 14:38:18,2010-10-27 14:38:18
ee8465bf1008f6c65398a1283aac9129c25a2f1f...2da1de5a6da0cedf490c54509487c27ba018585a,1,1,6,7,2,2010-10-27 20:41:31,2010-10-27 20:41:31
2da1de5a6da0cedf490c54509487c27ba018585a...c67af8a03819004c4aaa775805badd1e631af738,2,1,1,2,1,2010-10-27 22:32:30,2010-10-27 22:20:05
c67af8a03819004c4aaa775805badd1e631af738...62c0e5c46091d8b98a20c31ab26e715bad574bae,10,88,21,109,23,2010-10-27 22:42:46,2010-10-27 05:02:24
62c0e5c46091d8b98a20c31ab26e715bad574bae...92e31b556fcaeea7e7078c63729287dbdfcf09ff,2,17,5,22,4,2010-10-28 00:56:44,2010-10-28 00:56:44
92e31b556fcaeea7e7078c63729287dbdfcf09ff...34909520ae4b20ddf455adf72de8473e43cac1c6,3,70,35,105,28,2010-10-28 22:21:02,2010-10-27 18:29:51
34909520ae4b20ddf455adf72de8473e43cac1c6...602369c6a27923111aa5c3ecce8ac7316cd18ddd,2,4,0,4,2,2010-10-29 17:47:06,2010-10-29 17:00:45
602369c6a27923111aa5c3ecce8ac7316cd18ddd...d4839bac3288bbf97116bd0adf9d59637889dd9e,1,9,0,9,1,2010-10-29 17:47:51,2010-10-29 17:02:12
d4839bac3288bbf97116bd0adf9d59637889dd9e...5524d2b0fb9b87ef0d1beec092337f836a1043a8,5,181,30,211,24,2010-10-29 18:40:56,2010-10-28 02:06:40
5524d2b0fb9b87ef0d1beec092337f836a1043a8...9a532002cf490a3e26a827e2eab9c1c3d834e2b8,2,28,10,38,4,2010-10-29 19:19:22,2010-10-29 19:19:22
9a532002cf490a3e26a827e2eab9c1c3d834e2b8...ba5f8ee27f03b3215835bc1e643eb25b8f2e217f,2,6,6,12,2,2010-10-31 22:04:30,2010-10-31 18:24:20
ba5f8ee27f03b3215835bc1e643eb25b8f2e217f...99f25050a34a0f0e2b0bdc63a55f38097f7098db,2,25,8,33,6,2010-11-01 04:37:33,2010-10-31 00:11:50
99f25050a34a0f0e2b0bdc63a55f38097f7098db...2d61040fb085f5d3a226d39726e105c1e6bd7006,1,11,6,17,4,2010-11-01 04:37:54,2010-10-31 00:14:55
2d61040fb085f5d3a226d39726e105c1e6bd7006...6bb2cd6ee2a35768ac4422395596daf1438e62ff,5,164,47,211,12,2010-11-01 22:21:37,2010-10-29 23:02:57
6bb2cd6ee2a35768ac4422395596daf1438e62ff...faa7d81b679346623c9f023042ddc40dee808e6f,3,23,2,25,4,2010-11-02 00:24:24,2010-11-02 00:24:24
faa7d81b679346623c9f023042ddc40dee808e6f...56a3d52f45ceae7973999ab8351a090f3ffddbba,3,34,24,58,19,2010-11-02 18:20:41,2010-11-01 23:51:15
56a3d52f45ceae7973999ab8351a090f3ffddbba...dcf76e681624dca350d00a4a2e5f5d63deffcb17,4,48,26,74,30,2010-11-02 18:27:54,2010-11-02 01:03:52
dcf76e681624dca350d00a4a2e5f5d63deffcb17...0bd4a473a717d5ed9b9c07fbdbc5c336beeef4e5,3,16,4,20,5,2010-11-03 16:44:54,2010-11-02 23:23:12
0bd4a473a717d5ed9b9c07fbdbc5c336beeef4e5...5c887ddb66bdd0daa4f4a98af0c6e76d4aec0d70,3,42,0,42,4,2010-11-03 16:47:21,2010-11-02 23:25:43
5c887ddb66bdd0daa4f4a98af0c6e76d4aec0d70...aec3c8478c2eb937e24306087c5bc1ef49722036,2,24,1,25,2,2010-11-03 16:47:21,2010-11-02 23:26:59
aec3c8478c2eb937e24306087c5bc1ef49722036...1fe7e3a1302e948a31ab80d02ede6975c3bddd58,2,277,10,287,21,2010-11-03 16:47:21,2010-11-01 20:44:39
1fe7e3a1302e948a31ab80d02ede6975c3bddd58...659af29adbd041fbbbaf041ead53266210a61f4e,36,2791,88,2879,60,2010-11-03 16:47:22,2010-10-27 22:31:10
659af29adbd041fbbbaf041ead53266210a61f4e...1ba8c2a33a2855b5c56aaaa79f402aa5196cc018,3,175,30,205,13,2010-11-03 16:47:22,2010-11-01 23:57:55
1ba8c2a33a2855b5c56aaaa79f402aa5196cc018...5159eb76350a4da587bab3d73e212ed134cde789,9,234,34,268,35,2010-11-03 16:47:22,2010-11-03 01:39:30
5159eb76350a4da587bab3d73e212ed134cde789...96abeb1074ec59ddb727ea8164aa770d972c4a9a,1,8,0,8,1,2010-11-03 16:47:22,2010-11-02 16:27:16
96abeb1074ec59ddb727ea8164aa770d972c4a9a...a8efd43d256e67b954a38eb20438714815442f29,2,6,6,12,4,2010-11-03 16:47:23,2010-11-03 16:40:26
a8efd43d256e67b954a38eb20438714815442f29...dfa8baf59a1dafe6cc4c4e46da123cb85e85e0a4,1,7,3,10,2,2010-11-03 17:02:20,2010-11-03 17:02:20
dfa8baf59a1dafe6cc4c4e46da123cb85e85e0a4...91c835dc0eb5b03e968ad890c41323de80bf45da,1,1,1,2,1,2010-11-03 17:41:37,2010-11-03 17:41:37
91c835dc0eb5b03e968ad890c41323de80bf45da...690dfe000bf11fa6b39235d9a177dc79948841d4,2,7,0,7,2,2010-11-03 18:10:51,2010-11-03 17:13:03
690dfe000bf11fa6b39235d9a177dc79948841d4...ee5e881b9ecf87f3fffd43fa00e20fb4233afb4b,1,2,2,4,2,2010-11-03 18:47:06,2010-11-03 18:47:06
ee5e881b9ecf87f3fffd43fa00e20fb4233afb4b...bbb19a4d160eaeecabb061fc47ff61aee8faff77,1,2,2,4,2,2010-11-03 19:55:17,2010-11-03 19:55:17
bbb19a4d160eaeecabb061fc47ff61aee8faff77...bb460d635577d0108e2cb70f25db7bce3605ed0c,1,20,3,23,4,2010-11-03 20:05:12,2010-11-03 20:05:12
bb460d635577d0108e2cb70f25db7bce3605ed0c...04624220891bab17e5a873e1a8535ad4e061d9d9,1,1,1,2,1,2010-11-03 20:06:45,2010-11-03 20:06:45
04624220891bab17e5a873e1a8535ad4e061d9d9...3b04b48b7cc8f19f3e3ee1720188ea58ebb5d204,2,5,2,7,2,2010-11-03 20:09:52,2010-11-03 20:09:52
3b04b48b7cc8f19f3e3ee1720188ea58ebb5d204...b246d6e2ab203f12cfc2ca239bc11393bae087a2,1,0,0,0,0,2010-11-04 18:02:45,2010-11-04 18:02:45
b246d6e2ab203f12cfc2ca239bc11393bae087a2...c0d30aedfca89fee2e1fc3b0b2fc1e7bfcb008b1,3,68,500,568,3,2010-11-04 18:07:49,2010-11-03 15:52:17
c0d30aedfca89fee2e1fc3b0b2fc1e7bfcb008b1...47066e70e1621ff74bd2cd6b5853ca3c5841aba6,12,374,31,405,33,2010-11-04 21:24:31,2010-11-04 21:24:31
47066e70e1621ff74bd2cd6b5853ca3c5841aba6...8767e766d13b7d3a1e3b6b06f3030c843d3b19ba,3,6,6,12,5,2010-11-04 21:25:11,2010-11-04 21:25:11
8767e766d13b7d3a1e3b6b06f3030c843d3b19ba...3d6a099d6e40f1e12f6349843218987d472d0f3c,14,1496,1473,2969,29,2010-11-05 20:32:37,2010-11-05 00:41:14
3d6a099d6e40f1e12f6349843218987d472d0f3c...dc66687149078876f3964a5ab0b9aa0434f46cdc,5,49,8,57,12,2010-11-05 22:05:24,2010-11-05 22:05:24
dc66687149078876f3964a5ab0b9aa0434f46cdc...d5e9f38f3de317a74f2711e93c7a5df0c89099c7,2,12,5,17,6,2010-11-05 23:41:36,2010-11-05 23:41:36
d5e9f38f3de317a74f2711e93c7a5df0c89099c7...c780030c6e0b75de17b43ce56e7868f50984ac1d,1,52,54,106,24,2010-11-06 04:39:00,2010-10-26 22:59:10
c780030c6e0b75de17b43ce56e7868f50984ac1d...fe8353bc5e1cf8712655e8bb959165ee660bce26,2,7,14,21,4,2010-11-06 04:39:00,2010-11-05 22:37:55
fe8353bc5e1cf8712655e8bb959165ee660bce26...b7027b9d8755604799781313e9bbd8eee72fc4f4,2,20,2,22,2,2010-11-06 04:39:00,2010-11-05 23:04:13
b7027b9d8755604799781313e9bbd8eee72fc4f4...5be325a0c1a660268d29541bc668d9cb7d641fcb,2,11,11,22,11,2010-11-06 04:39:00,2010-11-05 23:14:44
5be325a0c1a660268d29541bc668d9cb7d641fcb...91b6c5f7ffaa19f967547ae3916641fed9e0f04c,7,350,42,392,19,2010-11-07 21:06:55,2010-11-07 21:04:48
91b6c5f7ffaa19f967547ae3916641fed9e0f04c...00ca67e4befffed00ecee81bd1ce903fe01f542a,2,27,0,27,3,2010-11-07 22:42:03,2010-10-30 18:57:13
00ca67e4befffed00ecee81bd1ce903fe01f542a...7779630989e6819e59a5d0122787ed7468fb006e,1,28,0,28,1,2010-11-07 22:42:03,2010-11-07 13:18:00
7779630989e6819e59a5d0122787ed7468fb006e...f3ac2cd434fd6ba142a5d7b31f9fba575e498579,1,12,12,24,4,2010-11-07 22:42:04,2010-11-07 13:46:10
f3ac2cd434fd6ba142a5d7b31f9fba575e498579...f077649f48b2ad6f6dde42a2e425cf0d6066a820,2,55,4,59,5,2010-11-09 06:46:41,2010-11-07 06:39:56
f077649f48b2ad6f6dde42a2e425cf0d6066a820...a3976455379cef41345a04bc91cfcf6d848aa609,3,17,3,20,4,2010-11-09 06:46:41,2010-11-07 06:40:44
a3976455379cef41345a04bc91cfcf6d848aa609...1c305dc67a73b8096132c709ee1a2f83879aab98,1,1,1,2,1,2010-11-09 06:46:41,2010-11-07 06:41:22
1c305dc67a73b8096132c709ee1a2f83879aab98...1a43f36e2395c77005fd14fafd43808548b111f2,5,20,4,24,6,2010-11-09 06:49:29,2010-11-07 06:50:04
1a43f36e2395c77005fd14fafd43808548b111f2...e5c135ac50bfb463895c71a9b83267e9ca836c7b,8,36,27,63,18,2010-11-09 06:49:30,2010-11-08 17:05:48
e5c135ac50bfb463895c71a9b83267e9ca836c7b...da17c614441c28907047442997bd4d99cdc6eaa1,1,11,8,19,1,2010-11-09 06:49:30,2010-11-08 17:52:09
da17c614441c28907047442997bd4d99cdc6eaa1...fc9ce9ec075aa21cdf6a79987e4aa152991f6a44,3,22,3,25,6,2010-11-09 06:49:30,2010-11-08 18:51:28
fc9ce9ec075aa21cdf6a79987e4aa152991f6a44...d458f3171122f6a5cd138d9cd2752c9a5a1c5cc8,1,65,57,122,15,2010-11-09 15:38:03,2010-11-08 03:36:42
d458f3171122f6a5cd138d9cd2752c9a5a1c5cc8...5062d32621de7bb255901222df349d4dfc5a4a13,1,226,266,492,101,2010-11-09 15:38:03,2010-11-08 22:29:41
5062d32621de7bb255901222df349d4dfc5a4a13...96e37a08666f4000cbba6f77a4b362a3480c934b,2,38,14,52,6,2010-11-09 16:02:49,2010-11-09 06:40:57
96e37a08666f4000cbba6f77a4b362a3480c934b...c048f0d8e8385e96e9fff0b4ff733cecfa726d93,4,276,2,278,10,2010-11-09 17:15:29,2010-11-09 04:34:18
c048f0d8e8385e96e9fff0b4ff733cecfa726d93...257e97a65f7dd794faa5d8c0d72bbd5a894cb471,4,40,38,78,9,2010-11-09 21:39:12,2010-11-09 07:26:36
257e97a65f7dd794faa5d8c0d72bbd5a894cb471...264f960800426ce61ad26dcdb60b099fd3e8e1c4,1,14,0,14,1,2010-11-10 03:58:42,2010-11-09 23:10:45
264f960800426ce61ad26dcdb60b099fd3e8e1c4...effcd340e9d41a2ab8368e4de06a1a83a206ac32,1,1,1,2,1,2010-11-10 05:44:51,2010-11-06 04:12:17
effcd340e9d41a2ab8368e4de06a1a83a206ac32...324694a58b6d0ed33e05b511be4767573d9187dd,15,189,161,350,43,2010-11-10 06:27:31,2010-11-06 04:12:37
324694a58b6d0ed33e05b511be4767573d9187dd...a7e8a503fd088f5b01e8b14de61dfc60c1f13451,3,55,8,63,9,2010-11-10 06:27:37,2010-11-09 19:22:52
a7e8a503fd088f5b01e8b14de61dfc60c1f13451...6d53808475c9e7d952a9d5e13049433f8cba6912,3,66,40,106,14,2010-11-10 06:33:27,2010-11-09 23:56:27
6d53808475c9e7d952a9d5e13049433f8cba6912...c57df3dc776f8a35aaad35fc399960f0d7fee06d,7,126,29,155,17,2010-11-10 19:01:30,2010-11-10 18:09:48
c57df3dc776f8a35aaad35fc399960f0d7fee06d...6b8ed42670039f53d2b20dc1079f742840f62ae9,8,655,27,682,39,2010-11-10 20:02:49,2010-11-10 20:02:49
6b8ed42670039f53d2b20dc1079f742840f62ae9...43a4ff4cdf4100ded15b90d49a514648a88b87b4,1,36,10,46,8,2010-11-11 05:01:05,2010-11-10 23:31:15
43a4ff4cdf4100ded15b90d49a514648a88b87b4...0499c4727036446f5c8a5722bbd9c4018dae146f,7,66,27,93,24,2010-11-11 05:01:17,2010-11-11 00:08:54
0499c4727036446f5c8a5722bbd9c4018dae146f...c5b2bf083c7044aaf9269ad2cd6469fd14653917,2,88,29,117,10,2010-11-11 05:04:44,2010-11-11 00:14:47
c5b2bf083c7044aaf9269ad2cd6469fd14653917...ae5f6f48b4e708527f4300c06d589eafd15fbd4e,1,1,1,2,1,2010-11-11 05:04:44,2010-11-11 04:37:14
ae5f6f48b4e708527f4300c06d589eafd15fbd4e...7411b24812eb370e65dd6bd2ba3a33a20f90ba26,1,13,1,14,3,2010-11-11 06:14:16,2010-11-11 06:14:16
7411b24812eb370e65dd6bd2ba3a33a20f90ba26...5f0af2cd0e76e641927e06b5a2a80fdc6cfdf365,1,1,1,2,1,2010-11-11 06:15:16,2010-11-11 06:15:16
5f0af2cd0e76e641927e06b5a2a80fdc6cfdf365...ba554eeb1bb6a6fc12307d33a5becd8b8ecd6cd7,2,5,2,7,2,2010-11-12 00:38:23,2010-11-12 00:38:23
ba554eeb1bb6a6fc12307d33a5becd8b8ecd6cd7...0a8b3161b19c115ac3854217801e56ae766ab399,2,57,5,62,7,2010-11-12 00:39:01,2010-11-12 00:21:51
0a8b3161b19c115ac3854217801e56ae766ab399...c51273b1fbae1d7cf1de105dca09d3db7fd84bec,5,42,0,42,3,2010-11-13 00:13:53,2010-11-05 17:11:37
c51273b1fbae1d7cf1de105dca09d3db7fd84bec...625cc7609cfd1a0a4fcecfd55875e548518a72a8,1,1,1,2,1,2010-11-13 00:18:11,2010-11-13 00:18:11
625cc7609cfd1a0a4fcecfd55875e548518a72a8...7e6f9992216157a10a64a86fe526f61f9f57e43f,15,519,46,565,46,2010-11-15 18:04:17,2010-11-12 23:16:33
7e6f9992216157a10a64a86fe526f61f9f57e43f...a1652057a5e1fce1911b118a5d43629abe772ab6,3,7,6,13,5,2010-11-15 18:04:17,2010-11-15 18:02:22
a1652057a5e1fce1911b118a5d43629abe772ab6...b467a50bc75b7f4c0d9bcee521387eda460337bf,7,225,190,415,18,2010-11-15 20:28:08,2010-11-15 20:15:27
b467a50bc75b7f4c0d9bcee521387eda460337bf...cc749760fd59418433de5a055d1ca401f7500444,9,838,65,903,68,2010-11-16 05:55:37,2010-11-15 01:10:16
cc749760fd59418433de5a055d1ca401f7500444...a130bb899d790dc11393276b34d59b2ddd5cc680,2,19,2,21,5,2010-11-16 19:35:43,2010-11-16 19:31:41
a130bb899d790dc11393276b34d59b2ddd5cc680...4af32de84a264e05eebfa6dbc09ce10fac1e1417,8,8,17,25,9,2010-11-16 21:45:45,2010-11-16 21:39:50
4af32de84a264e05eebfa6dbc09ce10fac1e1417...b2d63ac48bdc61b5a4afdd10b8485c0c1ab8cdca,14,144,102,246,58,2010-11-16 22:19:55,2010-11-16 21:57:41
b2d63ac48bdc61b5a4afdd10b8485c0c1ab8cdca...beeb5ff908b2f30465263fb36c58ddb217dc2a0c,1,2,1,3,1,2010-11-16 22:44:35,2010-11-16 06:44:05
beeb5ff908b2f30465263fb36c58ddb217dc2a0c...7d6f5f986e374964d1467b6408f5ac8faa2985ba,1,31,0,31,1,2010-11-18 10:34:30,2010-11-16 07:07:56
7d6f5f986e374964d1467b6408f5ac8faa2985ba...c7052f098d47f60228c5d60ad16fcac8ce2b22c8,11,86,8,94,13,2010-11-18 10:34:31,2010-11-16 06:51:16
c7052f098d47f60228c5d60ad16fcac8ce2b22c8...fc78738cc6e1e9c7a3b381348348b48fe1ce8fb4,2,64,9,73,8,2010-11-18 10:34:52,2010-11-16 07:06:47
fc78738cc6e1e9c7a3b381348348b48fe1ce8fb4...71c2f24fc64e8d38089ac9476d05e01baf448879,2,15,3,18,3,2010-11-18 10:34:52,2010-11-17 01:02:04
71c2f24fc64e8d38089ac9476d05e01baf448879...c2c60ab49af22381e77641d61151563785e97a97,1,0,1,1,1,2010-11-18 10:34:53,2010-11-17 05:58:59
c2c60ab49af22381e77641d61151563785e97a97...51a22cf435b39f933e5a20aabb59d6c78353c9d3,3,34,5,39,5,2010-11-18 10:34:53,2010-11-17 19:33:30
51a22cf435b39f933e5a20aabb59d6c78353c9d3...ff7c738c21075f834b5f610085d195cfa1eb5110,1,3,11,14,4,2010-11-18 10:34:53,2010-11-17 19:34:23
ff7c738c21075f834b5f610085d195cfa1eb5110...4c69d694d75f01cffbc75be331b5636068a41048,4,13,23,36,9,2010-11-18 10:34:53,2010-11-17 20:13:04
4c69d694d75f01cffbc75be331b5636068a41048...dd687e2bf565c48d00e47f9af666cee4a2b9abd9,2,6,1,7,2,2010-11-18 10:34:53,2010-11-17 20:52:45
dd687e2bf565c48d00e47f9af666cee4a2b9abd9...d4bcee07998d0f6a613821c52001b9f6b37b42f3,1,23,0,23,2,2010-11-18 10:34:54,2010-11-17 20:54:14
d4bcee07998d0f6a613821c52001b9f6b37b42f3...9d36368ff9cb84a38ba0ab08c0d54361bd836389,1,2,2,4,1,2010-11-18 10:34:54,2010-11-17 21:06:09
9d36368ff9cb84a38ba0ab08c0d54361bd836389...ee0e9a44521218a1d13bc502350414d30ca03cf9,2,6,3,9,4,2010-11-18 10:34:54,2010-11-17 21:07:59
ee0e9a44521218a1d13bc502350414d30ca03cf9...e509ec37f5684a0061d14759b6bcea3e0d88d5bc,1,4,4,8,4,2010-11-18 10:34:54,2010-11-17 21:09:21
e509ec37f5684a0061d14759b6bcea3e0d88d5bc...916dadd8ec4c7e3a9710941faa3d5ea80f615ac0,1,12,0,12,1,2010-11-18 10:34:54,2010-11-17 21:24:33
916dadd8ec4c7e3a9710941faa3d5ea80f615ac0...28e72cbe6bfb874fa6a7f15769e5c83d66fb617f,6,40,9,49,21,2010-11-18 10:34:55,2010-11-17 21:24:45
28e72cbe6bfb874fa6a7f15769e5c83d66fb617f...a6978b201bbc1756b661dd968b3fb1b0d97f5033,3,21,19,40,10,2010-11-18 10:35:28,2010-11-17 22:46:49
a6978b201bbc1756b661dd968b3fb1b0d97f5033...4491bbdede825df78302301d4689dd73bcf9c256,1,1,1,2,1,2010-11-18 10:35:28,2010-11-17 23:09:19
4491bbdede825df78302301d4689dd73bcf9c256...65989c6f0d13b8f205ab929999a4b9f66c8c1c93,2,28,6,34,7,2010-11-18 10:35:29,2010-11-18 01:26:25
65989c6f0d13b8f205ab929999a4b9f66c8c1c93...d54f09ef29356d4c8ba71d3b37bbebd379627648,1,6,0,6,1,2010-11-18 10:35:29,2010-11-18 02:01:14
d54f09ef29356d4c8ba71d3b37bbebd379627648...9cb57772a4030925318475fe93bc19e2916b37bf,1,128,99,227,20,2010-11-18 10:35:29,2010-11-18 05:23:23
9cb57772a4030925318475fe93bc19e2916b37bf...522ec1a9ec10e1fece3e5e855c1d7ef9770a8efc,5,249,234,483,9,2010-11-18 10:35:29,2010-11-18 06:32:35
522ec1a9ec10e1fece3e5e855c1d7ef9770a8efc...c635b69f5cfccfd12bdee6cb089ec38faa19c7e8,1,43,27,70,14,2010-11-18 10:35:30,2010-11-18 07:12:38
c635b69f5cfccfd12bdee6cb089ec38faa19c7e8...63380bbbdab1c160b81d8e78d79962fb8fd974cb,1,1,1,2,1,2010-11-18 10:35:30,2010-11-18 07:18:24
63380bbbdab1c160b81d8e78d79962fb8fd974cb...72a5f007d8aae1d97942ff94eee802792268f8cb,1,309,52,361,14,2010-11-18 10:35:30,2010-11-18 10:27:27
72a5f007d8aae1d97942ff94eee802792268f8cb...7f339a17822aea25655b3bf14c7465f6c8bf103f,1,1,1,2,1,2010-11-18 19:33:09,2010-11-18 19:33:09
7f339a17822aea25655b3bf14c7465f6c8bf103f...3c7874b07bfb811c3f7b7853628595b4698d6aa4,1,1,1,2,1,2010-11-18 19:56:10,2010-11-18 19:56:10
3c7874b07bfb811c3f7b7853628595b4698d6aa4...fc7f11d03b4380866033c38eb7649cdc5be93d9a,24,198,0,198,121,2010-11-19 00:28:42,2010-11-19 00:28:42
fc7f11d03b4380866033c38eb7649cdc5be93d9a...7ee102eecf927c5a481c6d16b5ff08bfe9563bdc,3,15,1,16,4,2010-11-19 00:53:11,2010-11-19 00:53:11
7ee102eecf927c5a481c6d16b5ff08bfe9563bdc...1719b0aca5f02a9d70482c10ecb7643a9422b2f5,3,16,16,32,12,2010-11-19 01:03:43,2010-11-19 01:03:43
1719b0aca5f02a9d70482c10ecb7643a9422b2f5...66c0bfaa8e84cadf2823c85fbc2adab8fe7e1ccd,1,3,1,4,1,2010-11-19 04:51:31,2010-11-19 04:51:31
66c0bfaa8e84cadf2823c85fbc2adab8fe7e1ccd...50ef1f8e35d23020b2b5dfde8002f2430049fb47,1,1,1,2,1,2010-11-19 06:40:00,2010-11-19 06:39:25
50ef1f8e35d23020b2b5dfde8002f2430049fb47...3fbfa357caf81a0a31615bd5d8dc4be322166cdc,1,14,1,15,1,2010-11-19 06:40:00,2010-11-19 05:17:18
3fbfa357caf81a0a31615bd5d8dc4be322166cdc...9b53b25f15d8c1e28b7bda6331d4a26b54025ccd,1,1,1,2,1,2010-11-19 06:40:01,2010-11-19 05:18:01
9b53b25f15d8c1e28b7bda6331d4a26b54025ccd...1f59de35c94448e32ac72c0a9b8541ad4f8696ab,2,5,2,7,2,2010-11-19 07:42:57,2010-11-19 07:42:57
1f59de35c94448e32ac72c0a9b8541ad4f8696ab...efec0c358d3cb840275037d5f86347130bb86573,2,86,0,86,4,2010-11-22 18:57:32,2010-11-22 18:23:45
efec0c358d3cb840275037d5f86347130bb86573...3e5a4ef86c1f1221053eacb1a3a2eeb3da7d018d,1,48,0,48,6,2010-11-22 18:57:44,2010-11-22 18:26:47
3e5a4ef86c1f1221053eacb1a3a2eeb3da7d018d...b94600d71e90a9f93e507b2cac0ffc2c55e7857a,1,60,0,60,1,2010-11-23 19:05:28,2010-11-23 19:05:28
b94600d71e90a9f93e507b2cac0ffc2c55e7857a...0d1f8a053214e0aa98ffa4a9630eb2ddd0daff6e,1,38,0,38,1,2010-11-23 22:10:10,2010-11-23 22:10:10
0d1f8a053214e0aa98ffa4a9630eb2ddd0daff6e...870547d185ce755d695cc75d908c1deb78d89f49,2,77,1,78,3,2010-11-23 23:44:14,2010-11-23 23:44:14
870547d185ce755d695cc75d908c1deb78d89f49...a0e8c45880c71838fc92a9251b278d507b30dec9,1,38,0,38,1,2010-11-24 00:10:14,2010-11-24 00:10:14
a0e8c45880c71838fc92a9251b278d507b30dec9...303a68308157b507daaf6506d4c91cca8618cbc5,1,31,0,31,2,2010-11-24 00:28:24,2010-11-24 00:28:24
303a68308157b507daaf6506d4c91cca8618cbc5...c3d99d68da512f8dbd8310cde348ceda68ebed95,1,68,0,68,1,2010-11-24 01:14:04,2010-11-24 01:14:04
c3d99d68da512f8dbd8310cde348ceda68ebed95...95d1768c7742e383bc8e9dda2279efd74b0b4131,1,55,0,55,1,2010-11-25 00:28:17,2010-11-25 00:28:17
95d1768c7742e383bc8e9dda2279efd74b0b4131...97b1371199e4c514a23edad4546536616e0f9004,1,9,0,9,3,2010-11-25 00:32:03,2010-11-25 00:32:03
97b1371199e4c514a23edad4546536616e0f9004...7c82c4f83756b8b62231b46f864fb1107db0f989,2,53,0,53,2,2010-11-25 00:55:44,2010-11-25 00:55:44
7c82c4f83756b8b62231b46f864fb1107db0f989...162f41a1abd6ec041ff6cfead605321a554063b1,1,24,0,24,2,2010-11-25 01:21:37,2010-11-25 01:21:37
162f41a1abd6ec041ff6cfead605321a554063b1...73194009a9ecc64d7243c1bf5dd6248408fe32c6,1,31,10,41,4,2010-11-25 01:32:04,2010-11-25 01:32:04
73194009a9ecc64d7243c1bf5dd6248408fe32c6...9c9a89f7ff6fa964bad6437d30cb0651f8366e8f,1,51,0,51,2,2010-11-25 02:07:11,2010-11-25 02:07:11
9c9a89f7ff6fa964bad6437d30cb0651f8366e8f...480f2f33c1ed739757f6b5fd02b177604b8c1c1c,1,34,0,34,2,2010-11-25 02:23:21,2010-11-25 02:23:21
480f2f33c1ed739757f6b5fd02b177604b8c1c1c...39d3ae80d9310cd50457970efd05ed2a9bf78053,1,50,0,50,4,2010-11-25 03:03:06,2010-11-25 02:55:34
39d3ae80d9310cd50457970efd05ed2a9bf78053...4fc3ee80407828ba1fe983a45385a41bca32131c,1,23,2,25,2,2010-11-25 03:14:34,2010-11-25 03:14:34
4fc3ee80407828ba1fe983a45385a41bca32131c...17eee57c522516ba139c05091fac200dfc353d36,2,11,2,13,2,2010-11-25 03:29:45,2010-11-25 03:29:45
17eee57c522516ba139c05091fac200dfc353d36...921f7ce49e63c80bbae4d59e65c0d85bb5256370,1,14,0,14,2,2010-11-25 05:03:56,2010-11-25 05:03:56
921f7ce49e63c80bbae4d59e65c0d85bb5256370...6b3b00e0953176598df2981191bb8264c435ab50,1,26,0,26,1,2010-11-25 05:13:58,2010-11-25 05:12:52
6b3b00e0953176598df2981191bb8264c435ab50...b7aff92354a718c140c149945c5a78a98d61baa6,1,18,1,19,2,2010-11-25 06:33:40,2010-11-25 06:33:40
b7aff92354a718c140c149945c5a78a98d61baa6...6515adc1185e7684fc562e74eb1182b1703bca32,1,16,5,21,1,2010-11-25 06:50:34,2010-11-25 06:50:34
6515adc1185e7684fc562e74eb1182b1703bca32...99eb123d791395d2fe88a6171e125cb0bd567ddf,1,115,0,115,9,2010-11-25 16:19:14,2010-11-25 16:19:14
99eb123d791395d2fe88a6171e125cb0bd567ddf...47f159cdf319bb9b7ce25228aa50cbb87fbf242f,2,125,11,136,8,2010-11-25 16:51:26,2010-11-17 00:31:40
47f159cdf319bb9b7ce25228aa50cbb87fbf242f...9f1b9849d864da17a7a3dd42a81abcd92d451471,1,3,2,5,2,2010-11-25 16:51:32,2010-11-17 21:34:34
9f1b9849d864da17a7a3dd42a81abcd92d451471...bd14a90610fa90802c7f61310fa8f18d4d868de0,1,5,0,5,1,2010-11-25 16:51:32,2010-11-22 22:38:49
bd14a90610fa90802c7f61310fa8f18d4d868de0...aa21c521ebf71850f5c3196b5697d371e4096a3e,1,84,3,87,3,2010-11-25 17:50:07,2010-11-25 17:50:07
aa21c521ebf71850f5c3196b5697d371e4096a3e...d07e9f77f18481cec43a7957b9804766976376ec,1,7,1,8,1,2010-11-25 18:10:54,2010-11-25 18:10:54
d07e9f77f18481cec43a7957b9804766976376ec...5bde02a8ca3f0a97fe4d4102bd1b03e9cc331bf7,1,1,1,2,1,2010-11-25 18:11:26,2010-11-25 18:11:26
5bde02a8ca3f0a97fe4d4102bd1b03e9cc331bf7...1aa46fac624c5784696ee17198bd6df265a44d29,2,5,2,7,2,2010-11-29 16:58:20,2010-11-29 16:58:20
1aa46fac624c5784696ee17198bd6df265a44d29...1cc2ad2443e228477e22ffbb1a3021a459fa00ab,1,2,0,2,1,2010-11-29 16:59:35,2010-11-29 16:59:35
1cc2ad2443e228477e22ffbb1a3021a459fa00ab...fde2ccb3f563104f5db7df6d330cf8d4b4aa8077,2,56,35,91,15,2010-11-29 19:25:38,2010-11-29 19:13:08
fde2ccb3f563104f5db7df6d330cf8d4b4aa8077...46091f811b8ec5bfe8ee53c15ef4589cf30dee01,2,56,11,67,10,2010-11-30 00:47:13,2010-11-29 21:19:18
46091f811b8ec5bfe8ee53c15ef4589cf30dee01...41c233ada1f21edcb168e94106dfd7e4b9679bbf,2,11,16,27,2,2010-11-30 00:47:19,2010-11-29 21:23:30
41c233ada1f21edcb168e94106dfd7e4b9679bbf...cc315ef4cc2a24e9ae8bcdc560918a6e65eb4def,2,11,11,22,11,2010-11-30 00:47:20,2010-11-29 21:25:34
cc315ef4cc2a24e9ae8bcdc560918a6e65eb4def...95adf3a4d81eeddec0ba07e7f7c39b50b576340f,2,27,15,42,8,2010-11-30 00:47:20,2010-11-30 00:43:35
95adf3a4d81eeddec0ba07e7f7c39b50b576340f...5480d2a80b7a6bafe7541d99eb53fd35fdd8faac,1,1,1,2,1,2010-11-30 00:47:21,2010-11-30 00:45:02
5480d2a80b7a6bafe7541d99eb53fd35fdd8faac...41d5938883a3d06ffe8a88a51efd8d1896f7d747,2,90,74,164,29,2010-11-30 05:55:32,2010-11-24 04:10:05
41d5938883a3d06ffe8a88a51efd8d1896f7d747...5a8ad8fe329fc09898ff43a060710265d38393be,19,328,229,557,68,2010-12-03 06:45:57,2010-12-02 04:29:54
5a8ad8fe329fc09898ff43a060710265d38393be...2bbced212e2ee93948c45360fee00b2e3f960392,4,86,25,111,21,2010-12-03 23:42:42,2010-12-03 23:42:11
2bbced212e2ee93948c45360fee00b2e3f960392...58d0e8945d772eddbfecbe6a645b2f1c4dd38bf2,11,646,615,1261,31,2010-12-06 23:48:40,2010-11-22 20:05:01
58d0e8945d772eddbfecbe6a645b2f1c4dd38bf2...011fa39c2a0b5da843395b538fc4e52e5ade8287,8,205,28,233,33,2010-12-07 00:45:59,2010-12-05 07:49:26
011fa39c2a0b5da843395b538fc4e52e5ade8287...c8f34e7f6bcc6899e418d5574be494535d5ece40,3,3,3,6,3,2010-12-07 00:45:59,2010-12-06 17:56:49
c8f34e7f6bcc6899e418d5574be494535d5ece40...eea7113abe93b0c615899c03281896e638c4666c,1,27,1,28,1,2010-12-07 04:23:06,2010-12-07 04:23:06
eea7113abe93b0c615899c03281896e638c4666c...f60b6b09380f218a86fc1ffd07485bc282a930e5,1,2,2,4,2,2010-12-07 04:32:37,2010-12-07 04:32:37
f60b6b09380f218a86fc1ffd07485bc282a930e5...8aed2047f025cf1a2e5e47e5ca08ca2b1b9bc393,2,2,2,4,2,2010-12-07 04:48:47,2010-12-07 04:48:47
8aed2047f025cf1a2e5e47e5ca08ca2b1b9bc393...6326e2028b503db662a0679c747e59831ae66ff5,1,2,2,4,1,2010-12-07 05:10:38,2010-12-07 05:10:38
6326e2028b503db662a0679c747e59831ae66ff5...e4d33917e39b1c77492aca1fcddfa0e3a7b0f514,1,1,1,2,1,2010-12-07 05:11:10,2010-12-07 05:11:10
e4d33917e39b1c77492aca1fcddfa0e3a7b0f514...d503dfe99bc4e7fa93d64c9d0ca7a6decb36c2cc,2,6,2,8,2,2010-12-07 05:24:49,2010-12-07 05:24:49
d503dfe99bc4e7fa93d64c9d0ca7a6decb36c2cc...824eab9029ea2fe36b167523c58d455a009d5064,2,30,16,46,4,2010-12-08 00:06:31,2010-12-08 00:06:31
824eab9029ea2fe36b167523c58d455a009d5064...809ca94e1cca45fbf40a2bfd84e8770536e3624b,2,7,1,8,2,2010-12-08 00:07:14,2010-12-08 00:07:14
809ca94e1cca45fbf40a2bfd84e8770536e3624b...81d10e819eac778d231b6ba06521c9562d0146cf,1,1,1,2,1,2010-12-08 04:43:10,2010-12-08 04:43:10
81d10e819eac778d231b6ba06521c9562d0146cf...fa722447f89e0215463cb39dfd1532189057fea8,5,51,23,74,14,2010-12-08 22:20:26,2010-12-07 19:39:59
fa722447f89e0215463cb39dfd1532189057fea8...e5e69d9b90850eb653883f52c76e28dd870ee067,6,13,60,73,9,2010-12-08 22:36:51,2010-12-07 19:47:24
e5e69d9b90850eb653883f52c76e28dd870ee067...23fc73081feb640164615930b36ef185c23a3526,2,56,103,159,14,2010-12-08 22:39:22,2010-12-07 19:42:34
23fc73081feb640164615930b36ef185c23a3526...b370fac4fc7e4c4da3b7968ed44cf3745c2ad7a4,3,56,4,60,7,2010-12-10 21:22:44,2010-12-10 19:39:32
b370fac4fc7e4c4da3b7968ed44cf3745c2ad7a4...74120eaa0f2ebec579dc5330fcc3121017c4aab3,1,10,3,13,3,2010-12-10 21:49:03,2010-12-10 21:49:03
74120eaa0f2ebec579dc5330fcc3121017c4aab3...f8151afd903d82f0de62e87e56a480ea7386736e,1,7,8,15,7,2010-12-11 01:04:56,2010-12-11 01:04:56
f8151afd903d82f0de62e87e56a480ea7386736e...5c36f466e129c5dccad75bbe11eabd50f919bee2,1,1,1,2,1,2010-12-11 01:08:10,2010-12-11 01:08:10
5c36f466e129c5dccad75bbe11eabd50f919bee2...7989c7d24ad9862f3138a45f81b9fcb59e055ef7,1,1,1,2,1,2010-12-11 01:08:52,2010-12-11 01:08:52
7989c7d24ad9862f3138a45f81b9fcb59e055ef7...e84d3334b0604de26821451158a2ea8c3360431f,2,5,2,7,2,2010-12-11 06:16:10,2010-12-11 06:16:10
e84d3334b0604de26821451158a2ea8c3360431f...b225083a21844bdc710b02337dfa1bef5883baf3,2,18,6,24,4,2010-12-11 16:27:52,2010-12-09 00:14:18
b225083a21844bdc710b02337dfa1bef5883baf3...ec4d446f898e7860c12a337200c31c3b75f663cc,3,51,37,88,8,2010-12-11 16:28:11,2010-12-10 06:09:46
ec4d446f898e7860c12a337200c31c3b75f663cc...a5df1fc41fcd5c9a72e3db7c861966fb68622e48,2,18,1,19,3,2010-12-11 18:07:10,2010-12-11 18:07:10
a5df1fc41fcd5c9a72e3db7c861966fb68622e48...d11088eb430ef7f0b444888517868ba880610f6b,2,103,56,159,14,2010-12-22 22:16:36,2010-12-22 01:38:04
d11088eb430ef7f0b444888517868ba880610f6b...e3ddc2bcc48ba6160455c4ffe35df87715c05693,7,161,1,162,7,2010-12-22 22:16:36,2010-12-22 01:13:07
e3ddc2bcc48ba6160455c4ffe35df87715c05693...e7a0fb250f6cc69c93daffe0d043d073fd488c03,6,77,45,122,14,2010-12-22 22:16:36,2010-12-22 21:19:26
e7a0fb250f6cc69c93daffe0d043d073fd488c03...5a534235b61f5415023ca933a50ea800f8ec9219,1,3,3,6,3,2010-12-23 17:03:34,2010-12-23 17:03:34
5a534235b61f5415023ca933a50ea800f8ec9219...56eeba0f3c5acc8667147b4534e3c17b8ffe06b5,1,9,1,10,2,2010-12-24 06:41:05,2010-12-24 06:41:05
56eeba0f3c5acc8667147b4534e3c17b8ffe06b5...38f462d57267d1493d7478500bbd35289e769155,1,1,1,2,1,2010-12-24 06:42:11,2010-12-24 06:42:11
38f462d57267d1493d7478500bbd35289e769155...5b9967518e89c1600a55046bf51cc6c63fbf7dd9,2,6,2,8,2,2010-12-24 06:43:42,2010-12-24 06:43:42
5b9967518e89c1600a55046bf51cc6c63fbf7dd9...cf891428bf3049b769d09946ec45b99cd1939d7c,2,0,0,0,0,2010-12-29 01:32:20,2010-12-29 01:32:20
cf891428bf3049b769d09946ec45b99cd1939d7c...5f080193cbc0d84676cf267adcdc6307fb601610,1,27,8,35,8,2011-01-04 21:25:49,2011-01-04 21:23:39
5f080193cbc0d84676cf267adcdc6307fb601610...d0270d92568e1b7c762b42a0ee0712b65d9acc5c,7,28,8,36,14,2011-01-05 00:40:40,2010-12-09 00:52:08
d0270d92568e1b7c762b42a0ee0712b65d9acc5c...3ea5941f0e51c57f55071a85f2033c23c99847c0,9,83,61,144,37,2011-01-05 00:40:41,2011-01-04 08:46:25
3ea5941f0e51c57f55071a85f2033c23c99847c0...1430c6d6b1f4edf11b1bd877e8907ac8ab0be923,4,13,11,24,8,2011-01-05 02:03:55,2011-01-04 18:40:34
1430c6d6b1f4edf11b1bd877e8907ac8ab0be923...b2631f61709ae71bb29ec6f1353f2a3c1ad33cd3,14,146,133,279,79,2011-01-05 02:04:00,2011-01-04 19:53:23
b2631f61709ae71bb29ec6f1353f2a3c1ad33cd3...67d064820c0a7993fdb3d15d6ee0b07a31c19f08,2,4,5,9,4,2011-01-05 02:04:01,2011-01-05 00:39:05
67d064820c0a7993fdb3d15d6ee0b07a31c19f08...da1d50fbe9b211fcca351dff681211c08e804856,1,4,4,8,4,2011-01-05 02:04:01,2011-01-05 01:36:51
da1d50fbe9b211fcca351dff681211c08e804856...247c99a8a45ff3f5c098b709b378c45aee36f072,1,151,97,248,11,2011-01-06 22:22:45,2011-01-06 20:25:18
247c99a8a45ff3f5c098b709b378c45aee36f072...454626ad39bc19f03390363f3033ee88c3efd417,6,848,867,1715,15,2011-01-06 22:34:21,2011-01-06 22:34:21
454626ad39bc19f03390363f3033ee88c3efd417...807d8c92b39d703256838fa027c99cdbe9744e5a,2,0,22,22,2,2011-01-06 22:51:44,2011-01-06 22:51:44
807d8c92b39d703256838fa027c99cdbe9744e5a...ad9537cdf689480749808aaf5515e723cfd5043c,1,0,77,77,1,2011-01-07 20:02:45,2011-01-06 04:38:39
ad9537cdf689480749808aaf5515e723cfd5043c...bdc251c5a59fe01e43020b8a8f298790ec404353,1,99,37,136,7,2011-01-07 20:02:45,2011-01-06 05:33:35
bdc251c5a59fe01e43020b8a8f298790ec404353...bd5ec7c32a59317840121432dcd9700fefde1ffd,4,7,7,14,7,2011-01-07 20:02:45,2011-01-06 07:56:57
bd5ec7c32a59317840121432dcd9700fefde1ffd...142a985f33e72ab8c86916dcb6fe6996671b1b5a,2,7,32,39,5,2011-01-07 20:02:45,2011-01-06 19:50:24
142a985f33e72ab8c86916dcb6fe6996671b1b5a...b28dee7fd540a6c46087e66fb2f6ca2307cf17c6,1,1,1,2,1,2011-01-07 20:02:46,2011-01-07 01:06:01
b28dee7fd540a6c46087e66fb2f6ca2307cf17c6...9db2170dcfbac5d584bbb7b4cf2c620ebf468b7b,1,2,0,2,2,2011-01-07 20:02:46,2011-01-07 07:16:23
9db2170dcfbac5d584bbb7b4cf2c620ebf468b7b...c0a26b18531482d493d544cf1a207586e8aacaf4,1,13,2,15,2,2011-01-07 20:02:46,2011-01-07 19:58:08
c0a26b18531482d493d544cf1a207586e8aacaf4...16086aa37c5c0c98f5c4a42d2a15136bb6d18605,9,187,49,236,28,2011-01-07 22:39:41,2011-01-05 01:54:37
16086aa37c5c0c98f5c4a42d2a15136bb6d18605...47c454a315b6c0260c8f65e70ae9b30f924650df,18,204,51,255,55,2011-01-07 22:39:46,2010-12-10 21:55:18
47c454a315b6c0260c8f65e70ae9b30f924650df...4c71824a69cc5edb7c466f06bd48da5f76c5fda4,1,7,3,10,3,2011-01-10 18:22:24,2011-01-10 18:22:24
4c71824a69cc5edb7c466f06bd48da5f76c5fda4...0ad39dde4f4dd4c50e08ccfdc086fad3fe576ff2,1,6,1,7,1,2011-01-10 18:24:12,2011-01-10 06:54:16
0ad39dde4f4dd4c50e08ccfdc086fad3fe576ff2...e99974004480d968d3fe37ee57540e72bbc96098,1,6,6,12,1,2011-01-10 18:24:12,2011-01-10 07:18:53
e99974004480d968d3fe37ee57540e72bbc96098...84dedb81e79a56b4c81fe413a41e7247d8fa0572,2,12,1,13,2,2011-01-10 18:24:12,2011-01-10 07:21:48
84dedb81e79a56b4c81fe413a41e7247d8fa0572...c79aba92f6b058742c9ae20a9382f6abc68afcea,6,58,14,72,10,2011-01-10 18:24:12,2011-01-09 08:57:24
c79aba92f6b058742c9ae20a9382f6abc68afcea...0a6cf70debc6440685af3f9ea96a66450e4f4ed7,32,101,96,197,95,2011-01-10 18:26:55,2011-01-08 06:02:23
0a6cf70debc6440685af3f9ea96a66450e4f4ed7...aab3df7aeaf79908e8b6212288b283adb42b1ce6,2,13,3,16,3,2011-01-10 18:37:37,2011-01-09 13:41:55
aab3df7aeaf79908e8b6212288b283adb42b1ce6...4f22d6866c052fb5b770ce4f377cecacacd9e6d8,33,1271,1071,2342,29,2011-01-10 19:50:11,2010-12-22 23:44:27
4f22d6866c052fb5b770ce4f377cecacacd9e6d8...c3e32f1a51d91cbb89b575995dc782a114196db1,1,9,5,14,2,2011-01-10 21:55:08,2011-01-10 21:55:08
c3e32f1a51d91cbb89b575995dc782a114196db1...f534def0c63a8dddd5ce7ddc92363a26b66bac54,3,1,451,452,3,2011-01-10 22:48:13,2011-01-10 22:48:13
f534def0c63a8dddd5ce7ddc92363a26b66bac54...4f5d5029c278fdecd7a80b217bfc21461e30abe8,9,497,7,504,11,2011-01-11 05:03:50,2011-01-11 05:03:50
4f5d5029c278fdecd7a80b217bfc21461e30abe8...ab040254f084d3b6d6f51d0503c750c118eef0c1,1,4,3,7,3,2011-01-11 05:23:22,2011-01-11 05:23:22
ab040254f084d3b6d6f51d0503c750c118eef0c1...99004b0aedeac77663db08873975d4273eef19bf,1,3,3,6,3,2011-01-11 07:28:47,2011-01-11 07:28:47
99004b0aedeac77663db08873975d4273eef19bf...9ccd2f0412ff97cdcb5c37fa3b75fea027d4e925,1,1,0,1,1,2011-01-12 01:48:30,2011-01-12 01:48:30
9ccd2f0412ff97cdcb5c37fa3b75fea027d4e925...b0be87f663e8684c1369e1bff740c1750ba17080,2,23,0,23,2,2011-01-13 15:55:31,2011-01-13 15:55:31
b0be87f663e8684c1369e1bff740c1750ba17080...23875cb330945788f2d290fd2063eb3d5c20e260,5,150,108,258,42,2011-01-14 00:58:35,2011-01-13 23:32:13
23875cb330945788f2d290fd2063eb3d5c20e260...527d0a1600147fff7f9f7bd8e443cb84e231a528,1,54,39,93,9,2011-01-14 06:06:28,2011-01-14 06:04:24
527d0a1600147fff7f9f7bd8e443cb84e231a528...d3d2a3a37436ef752a4dc5b5a71cbe6d472169c2,1,1,1,2,1,2011-01-14 06:08:27,2011-01-14 06:08:27
d3d2a3a37436ef752a4dc5b5a71cbe6d472169c2...934f44f69e94a77a3ea6c19dc5c6f82ade2cc669,2,6,2,8,2,2011-01-14 18:22:10,2011-01-14 18:22:10
934f44f69e94a77a3ea6c19dc5c6f82ade2cc669...347be5ae9aa6829427e1e8e1b1e58afdf2a36c0a,13,433,171,604,93,2011-01-14 18:30:00,2011-01-13 18:35:26
347be5ae9aa6829427e1e8e1b1e58afdf2a36c0a...1d7b9d5626d10c1a866e1842fbd6da2014424331,2,3,1,4,3,2011-01-14 18:30:05,2011-01-13 18:50:33
1d7b9d5626d10c1a866e1842fbd6da2014424331...1c55123f9c735dbaed5a974a8f4c45f233c6c85d,1,48,41,89,6,2011-01-18 06:16:15,2011-01-18 06:16:15
1c55123f9c735dbaed5a974a8f4c45f233c6c85d...d3f7bd699e2e0edf93887ddf5302b27254a1ec81,1,39,25,64,25,2011-01-18 19:15:36,2011-01-18 19:15:36
d3f7bd699e2e0edf93887ddf5302b27254a1ec81...ad3b811b8beb51193a28fc1f34ea711df347cb9f,2,46,22,68,18,2011-01-18 22:42:18,2011-01-18 21:50:52
ad3b811b8beb51193a28fc1f34ea711df347cb9f...d73635d573e6ca5a1c837f2a8245738c16605522,1,1,1,2,1,2011-01-18 22:42:22,2011-01-18 21:56:04
d73635d573e6ca5a1c837f2a8245738c16605522...3bd96609e91ee4ed41585a046b578a240527cdc6,1,1,2,3,1,2011-01-18 22:42:23,2011-01-18 21:59:55
3bd96609e91ee4ed41585a046b578a240527cdc6...72e554ffebc7a1d4aa83e699f8f776e8089ffc22,1,1,1,2,1,2011-01-18 22:42:23,2011-01-18 22:15:53
72e554ffebc7a1d4aa83e699f8f776e8089ffc22...459a01e582de91d95375d1438e49a35df6f64293,1,14,3,17,3,2011-01-18 23:02:51,2011-01-18 22:57:25
459a01e582de91d95375d1438e49a35df6f64293...5be92f7b9c76e8a7f3778a93cbf6fb28b8524308,1,1,1,2,1,2011-01-18 23:02:51,2011-01-18 23:00:16
5be92f7b9c76e8a7f3778a93cbf6fb28b8524308...da4b8a74c3c84aeccf2ecb8b5d74d22a579f2438,1,1,1,2,1,2011-01-18 23:15:33,2011-01-18 23:15:33
da4b8a74c3c84aeccf2ecb8b5d74d22a579f2438...050e5d773fa7eca46d72afd26cbd5d5bf1af3ff6,1,48,41,89,37,2011-01-18 23:32:46,2011-01-18 23:32:46
050e5d773fa7eca46d72afd26cbd5d5bf1af3ff6...63690d189214135f22171ad8795ccfe15103a8e6,1,7,7,14,6,2011-01-19 23:52:27,2011-01-19 08:04:05
63690d189214135f22171ad8795ccfe15103a8e6...a5eb3ed107034cce5b7de3ec3f8a43ff3a379fa1,3,2,13,15,4,2011-01-19 23:52:27,2011-01-19 08:10:39
a5eb3ed107034cce5b7de3ec3f8a43ff3a379fa1...2c0f7ffe3af2b2c7c84cea49456728d1ac9b3bfe,2,8,6,14,3,2011-01-19 23:53:58,2011-01-19 21:02:50
2c0f7ffe3af2b2c7c84cea49456728d1ac9b3bfe...964e39455526358c5e4bfc94c9d6595687a95865,1,5,5,10,4,2011-01-19 23:53:59,2011-01-19 21:05:48
964e39455526358c5e4bfc94c9d6595687a95865...10646c9f6f62dd5130606d07ffe69770b3973f47,3,138,1,139,3,2011-01-19 23:53:59,2011-01-19 22:50:29
10646c9f6f62dd5130606d07ffe69770b3973f47...17ee0f031ac4a37bf9a1dc8c87ffac4bd164d1cc,2,24,2,26,2,2011-01-20 05:47:14,2011-01-20 05:47:14
17ee0f031ac4a37bf9a1dc8c87ffac4bd164d1cc...4a569560d8b667e625f8d9c9aea2e02945af058c,2,7,1,8,2,2011-01-20 20:55:03,2011-01-20 20:55:03
4a569560d8b667e625f8d9c9aea2e02945af058c...c8bb044be13f33ef4c661ac9dbf7033b50a45d03,1,7,3,10,3,2011-01-24 22:03:17,2011-01-20 22:45:53
c8bb044be13f33ef4c661ac9dbf7033b50a45d03...94737cd01747e5c7b9b204590f812e4769add0e8,2,16,17,33,10,2011-01-24 22:03:41,2011-01-21 05:28:27
94737cd01747e5c7b9b204590f812e4769add0e8...746e7a9768f56315094c00ab86fd56addfc7aec3,1,17,31,48,5,2011-01-24 22:03:42,2011-01-20 21:38:14
746e7a9768f56315094c00ab86fd56addfc7aec3...8d91ec4173a652da9fe984d12a50d6b1b4ef935f,1,3,2,5,2,2011-01-24 22:03:42,2011-01-21 06:05:14
8d91ec4173a652da9fe984d12a50d6b1b4ef935f...5340d1e0b1c29103e187a1cdc33bbee48d98a74d,2,20,1,21,2,2011-01-24 22:03:42,2011-01-23 23:55:11
5340d1e0b1c29103e187a1cdc33bbee48d98a74d...567f33823b34969fa1b340c9d6c04e2c5a60d281,2,2,24,26,2,2011-01-24 22:03:42,2011-01-24 06:22:42
567f33823b34969fa1b340c9d6c04e2c5a60d281...8d507df8c9664cc35467577971532cc20be2912f,3,13,2,15,4,2011-01-24 22:03:42,2011-01-24 06:24:53
8d507df8c9664cc35467577971532cc20be2912f...a5990050d489e7c06b30b3ccab46b78c517662e2,2,44,16,60,16,2011-01-24 22:03:43,2011-01-24 21:27:28
a5990050d489e7c06b30b3ccab46b78c517662e2...190498efd741ad0f5df0c59d9ff9ae9dedfcf598,1,2,2,4,2,2011-01-24 22:23:50,2011-01-20 17:44:06
190498efd741ad0f5df0c59d9ff9ae9dedfcf598...22c5b7059b3239bb7fe36454d66ea4356a3c6666,1,24,3,27,4,2011-01-24 22:23:50,2011-01-19 20:15:25
22c5b7059b3239bb7fe36454d66ea4356a3c6666...70c74a9c4e3f1c3fdeb285e765a03bc878d14422,4,133,96,229,81,2011-01-24 22:23:51,2011-01-19 20:16:21
70c74a9c4e3f1c3fdeb285e765a03bc878d14422...5d0d34ae72a9ca47f1b2dabda60711ad16ee9313,1,11,11,22,10,2011-01-24 22:23:51,2011-01-19 20:16:38
5d0d34ae72a9ca47f1b2dabda60711ad16ee9313...c2f2587a79aeb77aad66f081cf924a79348a698e,46,512,477,989,415,2011-01-24 22:23:51,2011-01-19 23:42:11
c2f2587a79aeb77aad66f081cf924a79348a698e...bf03eb007c31bec4ea9f2ca8a947f9833bb348c9,3,58,1,59,4,2011-01-24 22:23:51,2011-01-24 21:33:47
bf03eb007c31bec4ea9f2ca8a947f9833bb348c9...b036c0bc58e186e4180df48be923e3c9b96af57d,1,1,1,2,1,2011-01-24 22:23:51,2011-01-24 21:41:02
b036c0bc58e186e4180df48be923e3c9b96af57d...d8acfe738906c2cb9755f7a872ea7ff22f8cdd51,3,22,4,26,4,2011-01-24 22:23:51,2011-01-19 20:16:21
d8acfe738906c2cb9755f7a872ea7ff22f8cdd51...a6a4c18ecd9df54f554bca1fd596905acd83585a,1,16,0,16,1,2011-01-24 22:23:51,2011-01-24 18:44:16
a6a4c18ecd9df54f554bca1fd596905acd83585a...9368ea38141b8fda1524fdc34c38ecee16ee2afe,2,16,12,28,8,2011-01-26 04:49:25,2011-01-24 23:30:28
9368ea38141b8fda1524fdc34c38ecee16ee2afe...9e0fa5b7c829fcc58a21ab9c3f0cf6492cf793af,2,18,0,18,2,2011-01-26 04:49:25,2011-01-26 01:51:01
9e0fa5b7c829fcc58a21ab9c3f0cf6492cf793af...6512a736acc8fe092ef81254e5aa744d6392d1ea,1,1,0,1,1,2011-01-26 23:37:22,2011-01-26 05:03:37
6512a736acc8fe092ef81254e5aa744d6392d1ea...7a48ee6aa949e8d4338033de8a0c6a079ceb17a3,1,1,1,2,1,2011-01-26 23:37:22,2011-01-26 06:54:02
7a48ee6aa949e8d4338033de8a0c6a079ceb17a3...f5d08963b0c836b10133a94d03a81254242661eb,11,193,40,233,46,2011-01-26 23:46:05,2011-01-26 04:44:44
f5d08963b0c836b10133a94d03a81254242661eb...3f0a37f380e262fa86689f06c0801ae54d8a0983,1,67,0,67,1,2011-01-27 04:12:23,2011-01-27 04:12:23
3f0a37f380e262fa86689f06c0801ae54d8a0983...8682befc7284a3c0b35cd5d85d4f42b1484ec71a,2,9,9,18,3,2011-01-27 06:30:09,2011-01-27 06:29:58
8682befc7284a3c0b35cd5d85d4f42b1484ec71a...bd33f60276a0fa37acffbad7a0cdcff92db594c8,18,861,127,988,88,2011-01-27 07:31:15,2011-01-26 05:55:11
bd33f60276a0fa37acffbad7a0cdcff92db594c8...9f73b1f290375672f02cb673992749f0a5dafbe4,1,19,2,21,2,2011-01-27 07:36:41,2011-01-27 07:35:04
9f73b1f290375672f02cb673992749f0a5dafbe4...75de7395bb9558485005a55f9ade7411507bcf94,1,1,1,2,1,2011-01-27 07:44:21,2011-01-27 07:44:21
75de7395bb9558485005a55f9ade7411507bcf94...9f947e5b8b7a6a792176615be9a91fa520052b44,1,1,1,2,1,2011-01-27 07:51:06,2011-01-27 07:51:06
9f947e5b8b7a6a792176615be9a91fa520052b44...e5a3acacad66400d4c73c8a42c6be4897ca662e3,2,4,4,8,3,2011-01-27 17:53:20,2011-01-27 17:49:36
e5a3acacad66400d4c73c8a42c6be4897ca662e3...b612826158974161463f1c2e5d062be6769bfd0d,2,6,2,8,2,2011-01-30 22:40:48,2011-01-30 22:40:48
b612826158974161463f1c2e5d062be6769bfd0d...0144fa1ca9c46e9bea17be5d9ffabf816bfa7a09,1,1,1,2,1,2011-01-30 22:43:03,2011-01-30 22:43:03
0144fa1ca9c46e9bea17be5d9ffabf816bfa7a09...f0fb4a3928971fb885f87bb5f25bb5a5c064e927,1,3,2,5,1,2011-01-30 22:43:53,2011-01-30 22:43:53
f0fb4a3928971fb885f87bb5f25bb5a5c064e927...7eea26323bf832bfd53a9636e64096b44cbd9487,2,0,0,0,0,2011-01-31 20:46:31,2011-01-31 20:46:31
7eea26323bf832bfd53a9636e64096b44cbd9487...df1d222dd0b4ed00e241a4b0709d2d5c0397b063,1,13,10,23,2,2011-02-01 17:33:58,2011-01-30 23:47:42
df1d222dd0b4ed00e241a4b0709d2d5c0397b063...21ad1762460487b813463008747f65fd5f3216da,1,9,8,17,7,2011-02-01 17:33:58,2011-01-30 23:48:40
21ad1762460487b813463008747f65fd5f3216da...7db3b54c1f777327a1213d7f7b761d238cdf9652,1,19,0,19,1,2011-02-01 17:33:59,2011-01-30 23:49:01
7db3b54c1f777327a1213d7f7b761d238cdf9652...ce7ab3d1ee0e496c4b9838950b56fc1555b5bcf0,2,62,0,62,6,2011-02-01 17:33:59,2011-01-31 00:57:57
ce7ab3d1ee0e496c4b9838950b56fc1555b5bcf0...2389c71238041bb6625915fbff195a6a1f4b82c8,1,4,6,10,2,2011-02-01 17:33:59,2011-01-31 20:49:07
2389c71238041bb6625915fbff195a6a1f4b82c8...5690627766e33a0d713826b2f85bb3686de41feb,2,0,0,0,0,2011-02-01 17:35:18,2011-01-31 23:42:26
5690627766e33a0d713826b2f85bb3686de41feb...c4497d60bca23bd5d9176b3d09819d9e16d22862,1,4,4,8,3,2011-02-01 17:35:18,2011-02-01 06:06:13
c4497d60bca23bd5d9176b3d09819d9e16d22862...9462c78fbf0896f0939c1bf3eb44a3f4f503f0a6,3,7,0,7,3,2011-02-01 17:35:18,2011-02-01 07:22:12
9462c78fbf0896f0939c1bf3eb44a3f4f503f0a6...c648fee5c2c46cbd2ea8b5bd4cec8005f182db1c,2,22,3,25,5,2011-02-01 17:35:18,2011-02-01 07:25:42
c648fee5c2c46cbd2ea8b5bd4cec8005f182db1c...6c0cf17404e8e6de0c398fff8e71497f39090408,2,75,17,92,5,2011-02-01 17:35:19,2011-02-01 07:26:10
6c0cf17404e8e6de0c398fff8e71497f39090408...d7686a429c43fd031a0d39788973f726d74bdb33,2,39,0,39,2,2011-02-01 17:35:19,2011-02-01 07:48:04
d7686a429c43fd031a0d39788973f726d74bdb33...9fd3dfe49d283c136e29bf60c0da6d4fe2aaed3d,2,39,0,39,2,2011-02-01 17:35:19,2011-02-01 15:43:09
9fd3dfe49d283c136e29bf60c0da6d4fe2aaed3d...ed768ebc53ef6746ca83d81892c22d2e9c3afeef,10,349,10,359,17,2011-02-01 17:58:37,2011-01-31 19:55:44
ed768ebc53ef6746ca83d81892c22d2e9c3afeef...ba6b68b6ae2bb2400a75ca2834fee47bfd60f1c6,20,1885,1697,3582,174,2011-02-01 18:00:09,2011-02-01 00:21:29
ba6b68b6ae2bb2400a75ca2834fee47bfd60f1c6...aaaad298ac6447497b1b86edac5b0d9b092625a2,1,1,1,2,1,2011-02-03 20:25:43,2011-02-03 20:25:43
aaaad298ac6447497b1b86edac5b0d9b092625a2...b6a01bd27dbcd2f9c9df917ecc96b8a2bd88413d,5,96,11,107,5,2011-02-03 21:25:01,2011-02-03 20:25:51
b6a01bd27dbcd2f9c9df917ecc96b8a2bd88413d...245b60d69af7cde614e52f3899846327c211c9f2,16,426,24,450,16,2011-02-03 21:26:48,2011-02-01 18:01:02
245b60d69af7cde614e52f3899846327c211c9f2...2a9f7b7287d622c17fd030eb5dfc9787cf5e6087,1,2,2,4,2,2011-02-03 21:26:48,2011-02-03 20:55:48
2a9f7b7287d622c17fd030eb5dfc9787cf5e6087...d35c1ac8b0bcd5df7a978fa2baee40be7ee317f3,2,11,7,18,11,2011-02-04 04:03:32,2011-02-03 20:55:23
d35c1ac8b0bcd5df7a978fa2baee40be7ee317f3...0d4def68ae0d95dd106d2731d60b6d6b635b5afc,6,333,10,343,12,2011-02-04 04:03:38,2011-02-03 01:46:01
0d4def68ae0d95dd106d2731d60b6d6b635b5afc...882f412d578e4f01394847fa5fde21b6b4096de2,13,180,74,254,48,2011-02-04 04:03:38,2011-02-03 23:21:34
882f412d578e4f01394847fa5fde21b6b4096de2...46d690ff0188836688811dda9af1b99c44750c48,7,63,42,105,24,2011-02-04 21:44:22,2011-02-04 00:35:51
46d690ff0188836688811dda9af1b99c44750c48...568574b915086bcb1f08e3f8903ef79497c97435,2,4,1,5,2,2011-02-04 22:11:52,2011-02-04 21:00:46
568574b915086bcb1f08e3f8903ef79497c97435...bf7c9d9900ba78a2c881caacc4be9ab43469663e,2,13,1,14,3,2011-02-04 22:11:52,2011-02-04 21:29:24
bf7c9d9900ba78a2c881caacc4be9ab43469663e...fbc7f1b4545f7ed9376ef3abe9b5fbb3cb43dc43,2,21,1,22,2,2011-02-04 22:11:53,2011-02-04 21:29:45
fbc7f1b4545f7ed9376ef3abe9b5fbb3cb43dc43...94bf24e3b65ba0e3a8a59b35e6c2b24e298c26d3,1,3,2,5,3,2011-02-04 22:11:53,2011-02-04 22:09:17
94bf24e3b65ba0e3a8a59b35e6c2b24e298c26d3...9798f5e35fd150c319004c953ed627b5b28dad71,2,51,6,57,4,2011-02-04 22:18:28,2011-02-04 01:32:55
9798f5e35fd150c319004c953ed627b5b28dad71...d6db4b174940782867d1cf42e1e0152046fe05c1,1,1,1,2,1,2011-02-04 22:23:51,2011-02-04 22:23:51
d6db4b174940782867d1cf42e1e0152046fe05c1...ea9ca651d2dd40ec057a166c6f324ea4fb881428,3,14,14,28,10,2011-02-06 17:35:14,2011-02-06 17:35:14
ea9ca651d2dd40ec057a166c6f324ea4fb881428...9f6c5db2a6ed10d3152fcb4aed8733043833362b,1,1,1,2,1,2011-02-08 07:55:02,2011-02-06 23:37:39
9f6c5db2a6ed10d3152fcb4aed8733043833362b...ae20f0c1b3f8ab30d3ede613cfe4ad32e3175ee9,3,83,0,83,4,2011-02-08 07:55:02,2011-02-07 00:32:37
ae20f0c1b3f8ab30d3ede613cfe4ad32e3175ee9...f00b1578415ff45e5ce21de79e7bec00ab4dea51,2,12,12,24,9,2011-02-08 07:55:02,2011-02-07 04:44:55
f00b1578415ff45e5ce21de79e7bec00ab4dea51...f3a39a6418543ac91bfce030275c205783e91e4b,1,16,0,16,2,2011-02-08 07:55:02,2011-02-07 05:17:58
f3a39a6418543ac91bfce030275c205783e91e4b...2fab1a2da9249ca5449eaa3a98ce233d913ad037,1,97,1,98,9,2011-02-08 07:55:03,2011-02-07 05:18:55
2fab1a2da9249ca5449eaa3a98ce233d913ad037...e626f95469299ce172a7b86753b10c41dcb91e48,1,89,41,130,4,2011-02-08 07:55:42,2011-02-07 06:26:09
e626f95469299ce172a7b86753b10c41dcb91e48...a6c45c3e66fc0ea3baaa908c90720bcf22c193d7,1,6,0,6,1,2011-02-08 07:55:46,2011-02-07 06:51:33
a6c45c3e66fc0ea3baaa908c90720bcf22c193d7...bf8013ad57ce30639bb37e7c0b8cf99cab8be650,2,9,2,11,2,2011-02-08 07:56:32,2011-02-04 17:11:18
bf8013ad57ce30639bb37e7c0b8cf99cab8be650...8724e97b7e6638797d3607a45682ef0b76311aae,2,37,32,69,14,2011-02-08 07:56:33,2011-02-02 04:16:30
8724e97b7e6638797d3607a45682ef0b76311aae...86321d1f5722e0aefcdbe8f3e5a14bd15d4caecb,2,75,27,102,12,2011-02-08 07:56:33,2011-02-07 22:32:28
86321d1f5722e0aefcdbe8f3e5a14bd15d4caecb...d600c608e3bf01be444a9fe25119670d55f7f757,2,70,20,90,15,2011-02-08 07:56:51,2011-02-07 23:55:23
d600c608e3bf01be444a9fe25119670d55f7f757...1cdc050ce7b5ae37e27df064849384cf55938679,1,34,0,34,14,2011-02-09 01:42:03,2011-02-09 01:35:20
1cdc050ce7b5ae37e27df064849384cf55938679...e1cfb99ae92d322257a38cbef8c969329eec63f6,2,2,2,4,2,2011-02-09 01:47:31,2011-02-09 01:47:31
e1cfb99ae92d322257a38cbef8c969329eec63f6...e6a6e32c7222393d5a8828f41719a7954e719e1b,2,6,2,8,2,2011-02-09 03:25:15,2011-02-09 01:50:36
e6a6e32c7222393d5a8828f41719a7954e719e1b...f943180e3456bd37cf88b699b261c7f14df16944,1,0,0,0,0,2011-02-09 04:42:32,2011-02-09 04:42:32
f943180e3456bd37cf88b699b261c7f14df16944...a26f192e01dcab6be253d9ca70b7a7019861a57b,8,8840,0,8840,1,2011-02-09 18:30:35,2011-02-09 18:26:25
a26f192e01dcab6be253d9ca70b7a7019861a57b...b07cc0e392ee1a856ee6f4d88cb6888cdfacdc93,1,91,67,158,35,2011-02-09 19:01:54,2011-02-04 22:35:54
b07cc0e392ee1a856ee6f4d88cb6888cdfacdc93...c1caf2560a39d3e9bb249877c8fd58464ad91f99,3,448,24,472,9,2011-02-09 19:19:30,2011-02-08 22:36:18
c1caf2560a39d3e9bb249877c8fd58464ad91f99...0f19cd3625ca0fddb7ecb20f4f4c6fda7d01e2e4,1,5,1,6,2,2011-02-10 04:11:34,2011-02-10 04:11:34
0f19cd3625ca0fddb7ecb20f4f4c6fda7d01e2e4...4f6fe1d479e91842d0e679d46b6acfff85459af4,1,33,0,33,1,2011-02-10 23:40:38,2011-02-10 23:40:38
4f6fe1d479e91842d0e679d46b6acfff85459af4...e9ce22592aaf36ce57c4eaa6202842d9f383d172,2,10,2,12,3,2011-02-11 01:57:42,2011-02-11 01:57:42
e9ce22592aaf36ce57c4eaa6202842d9f383d172...d2089a16335276eecb8d81eb17332c2dff2cf1a2,1,25,26,51,14,2011-02-14 16:42:58,2011-02-14 16:42:58
d2089a16335276eecb8d81eb17332c2dff2cf1a2...1777110958f76ee4be5760e36c96702223385918,46,2842,2642,5484,52,2011-02-15 16:01:53,2011-02-15 06:12:45
1777110958f76ee4be5760e36c96702223385918...7cf70c587e436014b2148eb4f12ecda307d25957,7,20,20,40,18,2011-02-16 05:04:15,2011-02-14 18:17:04
7cf70c587e436014b2148eb4f12ecda307d25957...c37bb2dc2880ac066c0a465eb6390bf870c84a29,1,2,1,3,1,2011-02-16 05:10:47,2011-02-16 05:10:47
c37bb2dc2880ac066c0a465eb6390bf870c84a29...037f30a0c9f819aedf47f0da782e8d1fec0d6489,1,1,1,2,1,2011-02-16 05:48:21,2011-02-05 00:41:19
037f30a0c9f819aedf47f0da782e8d1fec0d6489...a004d487c4bb48b2bec19b60bc5ddc5244029be5,6,21,7,28,10,2011-02-16 05:48:22,2011-02-05 00:42:21
a004d487c4bb48b2bec19b60bc5ddc5244029be5...0a5c00abf8664fdbdc5d16b13adb1989b4531cdf,8,61,38,99,11,2011-02-16 05:48:22,2011-02-07 21:28:42
0a5c00abf8664fdbdc5d16b13adb1989b4531cdf...e2154cbc0b9265bea04ce328879d4e9bf1c67c51,4,7,7,14,5,2011-02-16 05:48:22,2011-02-07 23:15:14
e2154cbc0b9265bea04ce328879d4e9bf1c67c51...23b255a8b7481ff5c06004b3558c07f981c42276,12,95,108,203,61,2011-02-16 05:49:15,2011-02-07 23:29:56
23b255a8b7481ff5c06004b3558c07f981c42276...496e6bf9016d33a7cf2f4730d06a8655f01ca5cb,4,26,10,36,9,2011-02-16 05:49:16,2011-02-12 18:12:10
496e6bf9016d33a7cf2f4730d06a8655f01ca5cb...ef4bb28be13e99f96c9ace5936cf26a174a0e5f0,15,524,461,985,102,2011-02-16 06:03:12,2011-02-12 18:13:28
ef4bb28be13e99f96c9ace5936cf26a174a0e5f0...00cc9eb32a9387040d0175fcfd21cf9dcab6514f,7,601,199,800,42,2011-02-16 13:59:42,2011-02-10 19:20:49
00cc9eb32a9387040d0175fcfd21cf9dcab6514f...cdc093a463e8f8a925cbb9f2b55bedf0a1d8e7e8,8,57,48,105,14,2011-02-16 13:59:57,2011-02-12 16:58:11
cdc093a463e8f8a925cbb9f2b55bedf0a1d8e7e8...c90abf057b0370cf5beb62aa960f1df008c802ef,10,57,44,101,30,2011-02-16 13:59:57,2011-02-14 00:13:21
c90abf057b0370cf5beb62aa960f1df008c802ef...a070ff5ad08450a1eb6375790fc90693d624e283,7,6,8,14,7,2011-02-18 06:58:59,2011-02-17 01:15:06
a070ff5ad08450a1eb6375790fc90693d624e283...9e30baad3feafc82fb2f2011fd3f21909f4ba29e,4,58,7,65,7,2011-02-18 07:06:53,2011-02-17 00:48:21
9e30baad3feafc82fb2f2011fd3f21909f4ba29e...65243b7d60328fab970aa2000786ab415b92b99e,2,11,3,14,3,2011-02-18 19:52:57,2011-02-18 18:24:30
65243b7d60328fab970aa2000786ab415b92b99e...7a54d2791ff4de5808970f3862114f84121115b5,1,199,0,199,1,2011-02-18 19:52:57,2011-02-17 23:39:29
7a54d2791ff4de5808970f3862114f84121115b5...7d4aee31bb202e9b050fc15c56cfc33c46b9eaf5,4,110,23,133,12,2011-02-18 21:14:07,2011-02-17 00:18:35
7d4aee31bb202e9b050fc15c56cfc33c46b9eaf5...fd6e5e3f31f374de7be7c80acaa766a14cb753db,3,11,2,13,4,2011-02-18 22:02:21,2011-02-18 21:19:59
fd6e5e3f31f374de7be7c80acaa766a14cb753db...87cbf9f59180d015da78c4286d692afafece5036,4,1,78,79,5,2011-02-18 22:22:51,2011-02-16 17:00:06
87cbf9f59180d015da78c4286d692afafece5036...6f8940c5d04bdedbb1d5415ea30f058fffa41010,2,4,0,4,2,2011-02-19 07:02:13,2011-02-19 07:02:13
6f8940c5d04bdedbb1d5415ea30f058fffa41010...e160944bfa1fd89f99571522040ca9b41280215d,1,1,1,2,1,2011-02-20 04:37:17,2011-02-20 04:33:54
e160944bfa1fd89f99571522040ca9b41280215d...5a3c9190dc0ed037ffca73db61404ff0f3ef2675,2,30,1,31,2,2011-02-20 04:39:46,2011-02-20 04:13:50
5a3c9190dc0ed037ffca73db61404ff0f3ef2675...55ce859998ad1f34ae84175cbb322fd8ce498970,3,10,10,20,9,2011-02-22 22:48:53,2011-02-22 22:48:53
55ce859998ad1f34ae84175cbb322fd8ce498970...fe743e31f8114aa17aedddeea9753fb5afeb6251,5,442,273,715,147,2011-02-22 23:09:44,2011-02-09 19:07:42
fe743e31f8114aa17aedddeea9753fb5afeb6251...08e3b1edbb2923ad18c840c55eb95a14ab308daf,1,1,0,1,1,2011-02-22 23:09:44,2011-02-22 23:09:33
08e3b1edbb2923ad18c840c55eb95a14ab308daf...c7998f5f992e9653b0c430316aadcbd7ecd47cb5,2,9,1,10,4,2011-02-22 23:23:08,2011-02-22 23:19:22
c7998f5f992e9653b0c430316aadcbd7ecd47cb5...d15165f207f77f691794a4f6d07ecc63d922070f,1,1,1,2,1,2011-02-22 23:49:46,2011-02-22 23:49:46
d15165f207f77f691794a4f6d07ecc63d922070f...eea0de6db4eb660be15bad4c1a74d371b8719d38,1,226,22,248,3,2011-02-23 01:42:00,2011-02-11 19:12:59
eea0de6db4eb660be15bad4c1a74d371b8719d38...a7ee4a88848887aa5ea0807380f4ba759444a7ec,1,1,0,1,1,2011-02-23 01:42:05,2011-02-23 01:41:40
a7ee4a88848887aa5ea0807380f4ba759444a7ec...5fc2b96b97a99286fb5734abef86dde16aeb3e55,1,1,1,2,1,2011-02-23 23:52:29,2011-02-23 23:52:29
5fc2b96b97a99286fb5734abef86dde16aeb3e55...9e67da420b60a417204ab53e8a16aa291f2b1ca0,3,16,1,17,3,2011-02-25 17:23:30,2011-02-16 16:53:11
9e67da420b60a417204ab53e8a16aa291f2b1ca0...edbe9d8ca8f7963969464eca4e7bb18426f137e5,4,13,3,16,6,2011-02-25 19:30:22,2011-02-25 19:18:42
edbe9d8ca8f7963969464eca4e7bb18426f137e5...65585a2d3c4f73a17d20310de30546116a9a6827,1,5,2,7,3,2011-02-27 23:54:06,2011-02-27 23:54:06
65585a2d3c4f73a17d20310de30546116a9a6827...a709dc19b8b3c3e71970fde6f274cba202e57775,2,27,1,28,2,2011-02-28 00:19:21,2011-02-28 00:19:21
a709dc19b8b3c3e71970fde6f274cba202e57775...128feb267409ee45ee5225a34aab038ddf3518fa,1,1,1,2,1,2011-03-01 02:02:57,2011-03-01 02:02:57
128feb267409ee45ee5225a34aab038ddf3518fa...945056b1667a69ecc4d557cc0f03894597250ced,14,362,336,698,166,2011-03-02 01:09:25,2011-02-25 22:03:02
945056b1667a69ecc4d557cc0f03894597250ced...95a29d7bde93189117c92b599d91731400a4f34f,1,34,26,60,12,2011-03-02 03:08:30,2011-03-02 03:08:30
95a29d7bde93189117c92b599d91731400a4f34f...887da5684b7cc3c8e42ea303c81107dffe6cbf80,1,22,7,29,6,2011-03-02 06:36:48,2011-03-02 06:32:37
887da5684b7cc3c8e42ea303c81107dffe6cbf80...10a7521f0b4f86b800d43f6276ee6f0c1c396129,1,1,1,2,1,2011-03-03 01:40:48,2011-03-03 01:40:48
10a7521f0b4f86b800d43f6276ee6f0c1c396129...cd139f57678b98c82387d5b0034f653043b7165a,2,44,2,46,2,2011-03-03 06:56:14,2011-03-03 01:29:38
cd139f57678b98c82387d5b0034f653043b7165a...dea72be0ccea6434c68529287e4db0c574b941a1,4,70,459,529,4,2011-03-03 07:14:13,2011-03-03 07:14:13
dea72be0ccea6434c68529287e4db0c574b941a1...28800a48ad1f309bebf953203ea41bf88003561a,1,1,1,2,1,2011-03-03 07:19:59,2011-03-03 07:19:08
28800a48ad1f309bebf953203ea41bf88003561a...a01d888eece2ecb6a682af29972381c4f299f6f1,1,304,0,304,1,2011-03-03 08:16:20,2011-03-03 08:16:20
a01d888eece2ecb6a682af29972381c4f299f6f1...a01aa7055c94ad510b580f45222a48a8b9b24105,1,63,15,78,5,2011-03-03 08:45:20,2011-03-03 08:17:21
a01aa7055c94ad510b580f45222a48a8b9b24105...5bf7ff5a3e7498cb43f1e18a6da32633162ff787,7,59,59,118,46,2011-03-03 21:50:12,2011-03-03 17:52:35
5bf7ff5a3e7498cb43f1e18a6da32633162ff787...02aa7978d300a166ae65a5cd1b0facc0f9a1f7a3,1,2,0,2,1,2011-03-04 06:59:11,2011-03-03 22:22:08
02aa7978d300a166ae65a5cd1b0facc0f9a1f7a3...8b2753eee29e54b33bbfd4c759ba162c7d3faf89,1,1,1,2,1,2011-03-04 07:14:43,2011-03-04 07:14:10
8b2753eee29e54b33bbfd4c759ba162c7d3faf89...e80a64883df704b766f873ee20a7e7e05a399a76,1,1,1,2,1,2011-03-04 07:14:43,2011-03-04 06:58:02
e80a64883df704b766f873ee20a7e7e05a399a76...fd409bd2dfd1434d937476b49ace706560113711,1,1,1,2,1,2011-03-04 07:14:43,2011-03-03 08:47:35
fd409bd2dfd1434d937476b49ace706560113711...749b3e87637227f65c17080ea447a0c5eec4fd7e,2,10,2,12,2,2011-03-04 07:14:43,2011-03-03 22:51:37
749b3e87637227f65c17080ea447a0c5eec4fd7e...4c762bfe5c6421560af9d4388ddc6506421b9c45,1,3,2,5,2,2011-03-06 06:54:41,2011-03-06 06:52:37
4c762bfe5c6421560af9d4388ddc6506421b9c45...73ee5fc00836ea2e35746e4451bdcd53a19a6c42,3,6,3,9,2,2011-03-07 08:07:01,2011-02-18 23:59:32
73ee5fc00836ea2e35746e4451bdcd53a19a6c42...627eba2b7cb2518d5e883e128d06ba25a80f9e9a,1,5,5,10,2,2011-03-07 08:07:02,2011-03-07 08:04:30
627eba2b7cb2518d5e883e128d06ba25a80f9e9a...f7a9ea6a418f6201638556b0925388e67a8b1b12,2,9,5,14,3,2011-03-09 04:23:19,2011-03-09 04:20:49
f7a9ea6a418f6201638556b0925388e67a8b1b12...194b2c1ea0a58c2aa86d96cb36714ab90944c736,1,1,1,2,1,2011-03-09 21:40:47,2011-03-09 21:40:47
194b2c1ea0a58c2aa86d96cb36714ab90944c736...5432dd289a38a43fc5db35a30b68c2a5b0dd169e,1,1,1,2,1,2011-03-09 21:41:16,2011-03-09 21:41:16
5432dd289a38a43fc5db35a30b68c2a5b0dd169e...7414e7b53302863911c734c8586b76767d2ded6b,2,34,4,38,6,2011-03-11 16:45:16,2011-03-07 07:42:25
7414e7b53302863911c734c8586b76767d2ded6b...9d5c53379180a110e427a01a1446eada3f0fc3d6,4,75,28,103,8,2011-03-11 16:45:43,2011-03-10 22:26:22
9d5c53379180a110e427a01a1446eada3f0fc3d6...d304b0c3df41b3b1e67c2b9d56c02dc95194512d,1,3,0,3,1,2011-03-11 17:30:53,2011-03-11 17:30:53
d304b0c3df41b3b1e67c2b9d56c02dc95194512d...26bad2bf878e54fa78ff26518d1275a7e0b5b39c,3,12,10,22,5,2011-03-11 22:16:52,2011-03-10 05:03:11
26bad2bf878e54fa78ff26518d1275a7e0b5b39c...5343deb3da0e667599fe66d8efa3566b4e337a24,3,24,5,29,5,2011-03-11 22:16:52,2011-03-10 05:12:40
5343deb3da0e667599fe66d8efa3566b4e337a24...d19c0ac6d32319200f0d94df9b07f63a39aecf70,3,7,8,15,5,2011-03-11 22:16:52,2011-03-10 05:19:19
d19c0ac6d32319200f0d94df9b07f63a39aecf70...5b05c0de036f77db0cc493082e21b1451c6b9a5f,2,24,17,41,11,2011-03-11 22:16:52,2011-03-10 21:39:59
5b05c0de036f77db0cc493082e21b1451c6b9a5f...c578f8c3ed0ca23b03ccde146cb13cfaf24f17cd,6,160,32,192,22,2011-03-11 22:16:53,2011-03-10 21:50:00
c578f8c3ed0ca23b03ccde146cb13cfaf24f17cd...0084cb5ca4bc9acda54d304147b0b0fe8e1980f3,3,11,7,18,5,2011-03-11 22:16:53,2011-03-10 22:46:07
0084cb5ca4bc9acda54d304147b0b0fe8e1980f3...3224862a9c0dd938b818a014048b5616b6146344,1,1,1,2,1,2011-03-11 22:16:53,2011-03-11 21:57:08
3224862a9c0dd938b818a014048b5616b6146344...1094b3471e0c6f21d7dbc91f14d8e5a6d5bd7bcc,1,18,8,26,5,2011-03-14 00:34:01,2011-03-14 00:34:01
1094b3471e0c6f21d7dbc91f14d8e5a6d5bd7bcc...69e6379d1998aaa21b07ddf7d43664a4e01a8c68,1,1,1,2,1,2011-03-14 05:48:26,2011-03-14 05:48:26
69e6379d1998aaa21b07ddf7d43664a4e01a8c68...a0af13f672a3cf5410178d5afc462903ba13726e,2,9,2,11,2,2011-03-14 06:15:36,2011-03-14 06:15:36
a0af13f672a3cf5410178d5afc462903ba13726e...dfba8fb2e7f3d3fb78fffa6a11f6fd93a7845391,1,1,1,2,1,2011-03-15 23:13:11,2011-03-15 23:13:11
dfba8fb2e7f3d3fb78fffa6a11f6fd93a7845391...cf0513dc6f888981e4e3df9a5388646b8d89ce24,1,1,0,1,1,2011-03-22 17:03:27,2011-03-21 21:13:29
cf0513dc6f888981e4e3df9a5388646b8d89ce24...ff4480be6501e0be077201a4f25c3abaae2cebb5,1,1,1,2,1,2011-03-22 17:10:55,2011-03-20 13:49:49
ff4480be6501e0be077201a4f25c3abaae2cebb5...b4d680a921fd946c8390eb906bb5ce13fbcd8067,2,7,4,11,3,2011-03-22 17:18:07,2011-03-20 16:47:12
b4d680a921fd946c8390eb906bb5ce13fbcd8067...d95a6925cdb5e8009b11fe3ce6dcc8d579bb4234,2,2,2,4,2,2011-03-23 22:25:05,2011-03-23 22:25:05
d95a6925cdb5e8009b11fe3ce6dcc8d579bb4234...1e59822df7366094dbf38b0c4ce0cc979258ad19,22,52,54,106,51,2011-03-27 06:19:04,2011-03-26 23:06:38
1e59822df7366094dbf38b0c4ce0cc979258ad19...510b5f3d908f8d8b7610589e54023e8d91769633,4,1,1,2,1,2011-03-27 06:21:59,2011-03-27 05:48:54
510b5f3d908f8d8b7610589e54023e8d91769633...faf29dd047d282c74a7383dc42299ab4e38cdefe,3,24,34,58,14,2011-03-27 06:22:00,2011-03-27 05:50:27
faf29dd047d282c74a7383dc42299ab4e38cdefe...9312bed4728e9f550fea131040cae199b3ab0c22,5,9,9,18,6,2011-03-29 06:04:48,2011-03-25 16:28:42
9312bed4728e9f550fea131040cae199b3ab0c22...885c3ad5ddc5016d6ef1b87d050f2c9bc23136b2,7,15,14,29,14,2011-03-29 06:15:28,2011-03-29 06:15:28
885c3ad5ddc5016d6ef1b87d050f2c9bc23136b2...e1d122a4b7ba837997cd258939daf82310adc223,2,8,2,10,3,2011-03-29 06:33:46,2011-03-18 17:31:28
e1d122a4b7ba837997cd258939daf82310adc223...4da65d0e8c6a3bfbe5b2c4ad5708a39e750f739a,1,6,6,12,5,2011-03-29 06:40:56,2011-03-21 04:49:06
4da65d0e8c6a3bfbe5b2c4ad5708a39e750f739a...94514a91f8e352e97c5eb44cdace29643e57f9d6,2,23,7,30,2,2011-03-29 07:25:22,2011-03-22 17:51:48
94514a91f8e352e97c5eb44cdace29643e57f9d6...9985104dc0a2f96b1b318a8b662c0806a96f312b,1,1,1,2,1,2011-03-30 22:22:14,2011-03-30 22:22:14
9985104dc0a2f96b1b318a8b662c0806a96f312b...c06c5a36b108c6ad20776923d75eb6f32ace591b,4,29,10,39,12,2011-03-30 22:22:22,2011-03-30 16:35:59
c06c5a36b108c6ad20776923d75eb6f32ace591b...89c25fe7136e49faa88a4b2a1922c822a5470313,1,1,1,2,2,2011-03-30 22:24:03,2011-03-26 22:23:41
89c25fe7136e49faa88a4b2a1922c822a5470313...96a1df192a167e6e34988af687693506f4efd1d1,3,34,14,48,7,2011-03-30 22:24:03,2011-03-27 22:58:24
96a1df192a167e6e34988af687693506f4efd1d1...a4863d52448170a8b94fa1fd2df79af1b66b6ad1,2,14,8,22,4,2011-03-30 22:24:03,2011-03-27 23:19:03
a4863d52448170a8b94fa1fd2df79af1b66b6ad1...15ec78f5eff3f8fa74714fe10986be094915c800,2,19,5,24,5,2011-03-30 22:24:03,2011-03-29 00:51:51
15ec78f5eff3f8fa74714fe10986be094915c800...56c00800c78d3d896fa6cb97ab97b974805152c4,2,21,2,23,3,2011-03-31 08:17:34,2011-03-31 08:17:34
56c00800c78d3d896fa6cb97ab97b974805152c4...a2c42711281d6ec61b73190b47743f79143c5bb1,2,7,1,8,2,2011-03-31 08:19:07,2011-03-31 08:19:07
a2c42711281d6ec61b73190b47743f79143c5bb1...2d9dd1c17270d8300b909fcb2f36964662000acf,1,19,0,19,2,2011-03-31 08:20:20,2011-03-31 08:20:20
2d9dd1c17270d8300b909fcb2f36964662000acf...eccd9bfbb3d63731814941789089e1c799005fb4,1,58,3,61,39,2011-03-31 08:42:42,2011-03-31 08:34:24
eccd9bfbb3d63731814941789089e1c799005fb4...78a0f41058a3c8094cf3b8979baa212a3b88b2a6,4,65,12,77,11,2011-04-01 04:45:28,2011-04-01 04:45:28
78a0f41058a3c8094cf3b8979baa212a3b88b2a6...cf1d365f577a99e11c0a619ab621564f258df299,1,10,1,11,4,2011-04-01 04:48:52,2011-04-01 04:48:52
cf1d365f577a99e11c0a619ab621564f258df299...ac3dbae37056ee9dbf53e4b027ae7b4ac645948e,4,3,0,3,2,2011-04-01 16:59:42,2011-03-23 22:22:25
ac3dbae37056ee9dbf53e4b027ae7b4ac645948e...f1096043157a4e80c78b2bfa692c9f5680e82e7c,1,19,1,20,4,2011-04-01 19:26:00,2011-04-01 17:44:02
f1096043157a4e80c78b2bfa692c9f5680e82e7c...0b8cf8539ddaced216a7350fe5824e9e2bc7106e,1,1,1,2,1,2011-04-01 19:26:04,2011-04-01 17:45:02
0b8cf8539ddaced216a7350fe5824e9e2bc7106e...38ec6519a37c1404c02cf7eb6487dc3d18d3e74f,2,8,2,10,2,2011-04-04 21:49:48,2011-04-04 21:49:48
38ec6519a37c1404c02cf7eb6487dc3d18d3e74f...9bd2c3967ba210cd349299a7546854eccc619e96,1,3,2,5,2,2011-04-04 22:35:28,2011-04-04 22:28:21
9bd2c3967ba210cd349299a7546854eccc619e96...754d2541c41080ba8d2a20cbe04ce16b1742296f,2,10,3,13,3,2011-04-04 23:04:37,2011-04-04 23:04:37
754d2541c41080ba8d2a20cbe04ce16b1742296f...e5419db6c75b7dd3b00f5a72ea17be71f4815ceb,1,1,1,2,1,2011-04-07 19:34:34,2011-04-07 19:34:34
e5419db6c75b7dd3b00f5a72ea17be71f4815ceb...d517bcad5b4db5a1a60159df537e69b70702a381,1,2,1,3,1,2011-04-07 19:48:14,2011-04-07 19:48:14
d517bcad5b4db5a1a60159df537e69b70702a381...0d2d7025e60095afc3497c6cd4a4af9e0cd9b90e,2,22,1,23,2,2011-04-07 21:56:57,2011-04-07 21:36:41
0d2d7025e60095afc3497c6cd4a4af9e0cd9b90e...72ad726efa44ba8d5dc68d971390b6912da10e2e,1,3,3,6,3,2011-04-08 16:51:08,2011-04-08 16:51:03
72ad726efa44ba8d5dc68d971390b6912da10e2e...1d7adac7a5546603fd42c1e581c696cb88324b8f,1,68,46,114,14,2011-04-08 17:03:06,2011-04-08 16:54:29
1d7adac7a5546603fd42c1e581c696cb88324b8f...8e6ecd98ae5ef24a7398aee19c006b9dda5385ff,1,10,4,14,1,2011-04-08 17:16:56,2011-04-08 17:16:56
8e6ecd98ae5ef24a7398aee19c006b9dda5385ff...9462b556a31efbe1560c5086326c80a6e9e39f87,4,6,3,9,4,2011-04-09 07:16:44,2011-04-09 07:16:40
9462b556a31efbe1560c5086326c80a6e9e39f87...81063a748c666594f4b0f06715d3acc6fd2e07cf,1,1,1,2,1,2011-04-10 21:16:08,2011-04-10 21:16:08
81063a748c666594f4b0f06715d3acc6fd2e07cf...3d787ab6f4fecf9168159e460fcd148120aa4c43,4,87,68,155,33,2011-04-11 14:20:30,2011-04-08 23:03:39
3d787ab6f4fecf9168159e460fcd148120aa4c43...3d388498e5c8920ca3c88d3ee1eccefcfcf99626,1,39,0,39,1,2011-04-11 15:04:16,2011-04-11 15:04:16
3d388498e5c8920ca3c88d3ee1eccefcfcf99626...ce0fbc6a7763982abf6e3f2183e1fd49e3f548fb,1,1,1,2,1,2011-04-11 17:20:42,2011-04-11 17:20:42
ce0fbc6a7763982abf6e3f2183e1fd49e3f548fb...8bb9f12961a931edc15801383c05c917c6ba09fb,1,4,4,8,1,2011-04-11 21:23:26,2011-04-11 21:22:31
8bb9f12961a931edc15801383c05c917c6ba09fb...97573c39305a4d91c14703f1064bdfdd7153b080,1,14,1,15,2,2011-04-11 21:23:26,2011-04-11 17:21:23
97573c39305a4d91c14703f1064bdfdd7153b080...cfc18efd2837ccfd6932ea29d6e80e04243df129,1,1,1,2,1,2011-04-11 21:23:26,2011-04-11 17:22:38
cfc18efd2837ccfd6932ea29d6e80e04243df129...498ad0a3be151a375675daa3453ea141d16e826e,2,8,2,10,2,2011-04-12 20:58:19,2011-04-12 20:58:19
498ad0a3be151a375675daa3453ea141d16e826e...b2dc2ce0b5913c6aa2baf5f5e305a57dd326e6fc,1,32,25,57,17,2011-04-12 21:02:21,2011-03-29 18:47:43
b2dc2ce0b5913c6aa2baf5f5e305a57dd326e6fc...e7c22e8153aaed4257d5b86cb74783b68a7af6f6,1,1,1,2,1,2011-04-15 20:01:47,2011-04-15 20:01:47
e7c22e8153aaed4257d5b86cb74783b68a7af6f6...64938a2e819c6cf58dd750fd04c6346c5aea3333,1,4,0,4,1,2011-04-16 21:36:47,2011-04-16 19:20:30
64938a2e819c6cf58dd750fd04c6346c5aea3333...97bdf979a165d9709476766a6a81f46a3e591ae6,1,1,1,2,1,2011-04-20 22:14:45,2011-04-20 22:14:45
97bdf979a165d9709476766a6a81f46a3e591ae6...35bb19856cc8f3d8923305869c0d4ffa4a03aa8f,1,1,1,2,1,2011-04-23 06:10:07,2011-04-23 06:10:07
35bb19856cc8f3d8923305869c0d4ffa4a03aa8f...f85c82acd623e63f23a4f3ebba239280f14e380b,7,10,11,21,10,2011-04-25 15:17:17,2011-04-19 22:24:20
f85c82acd623e63f23a4f3ebba239280f14e380b...9272a1a47279bfe5946dc3f23730d5e3b6259552,1,1,1,2,1,2011-04-27 05:51:13,2011-04-27 05:51:13
9272a1a47279bfe5946dc3f23730d5e3b6259552...cc5dfaf0ab4c0ce580a292e54ae64508ef7ee114,1,1,1,2,1,2011-05-03 04:20:36,2011-05-03 04:20:36
cc5dfaf0ab4c0ce580a292e54ae64508ef7ee114...b85e95709d1a7c9a100a96e4994711204a8f651c,1,1,1,2,1,2011-05-13 14:15:59,2011-05-13 14:15:59
b85e95709d1a7c9a100a96e4994711204a8f651c...c5f0342ad87ba91d43e8b99bfc82039cdbf998a2,2,9,118,127,6,2011-05-19 16:43:56,2011-04-29 21:38:08
c5f0342ad87ba91d43e8b99bfc82039cdbf998a2...9f56af9c15e1096033c91c2619f7f7f0115d0032,2,31,9,40,9,2011-05-19 16:43:56,2011-05-03 07:40:39
9f56af9c15e1096033c91c2619f7f7f0115d0032...1abdc097b235366759a889bdcc68359653a9b8a3,35,1034,121,1155,97,2011-05-19 16:43:56,2011-05-19 15:33:25
1abdc097b235366759a889bdcc68359653a9b8a3...805e083c243655bfaed3c5431dc0f402cb27fcb4,4,11,11,22,10,2011-05-19 16:43:56,2011-05-19 15:38:23
805e083c243655bfaed3c5431dc0f402cb27fcb4...b2f5299e0e3d6e4892b7fcc37686012147bf0afa,2,16,1,17,2,2011-05-31 08:23:30,2011-05-31 08:23:30
b2f5299e0e3d6e4892b7fcc37686012147bf0afa...2e5199997c77cb2febed4ff21bc12a5d5fbad4ce,10,36,36,72,36,2011-05-31 08:32:54,2011-05-31 08:32:54
2e5199997c77cb2febed4ff21bc12a5d5fbad4ce...aa64d37a23d743d325b9d95cd4725042cca430db,3,5,4,9,4,2011-06-02 15:55:10,2011-05-31 19:28:42
aa64d37a23d743d325b9d95cd4725042cca430db...50076b571da522cf6d2cb92c28519694727e9c31,3,46,3,49,5,2011-06-02 17:50:39,2011-05-31 20:52:44
50076b571da522cf6d2cb92c28519694727e9c31...dad26037521ff681f9a3c3d4a9bebf14fb8e38cc,3,29,9,38,10,2011-06-02 17:50:43,2011-06-01 15:38:25
dad26037521ff681f9a3c3d4a9bebf14fb8e38cc...4b0f2dfe0cbd4b5348af8cfb5af2e40904c73a47,3,75,1,76,3,2011-06-02 18:15:41,2011-05-31 12:51:47
4b0f2dfe0cbd4b5348af8cfb5af2e40904c73a47...b6db58c6472002cd81821a106816398942d4d0a4,1,2,1,3,1,2011-06-02 19:51:12,2011-06-02 16:39:44
b6db58c6472002cd81821a106816398942d4d0a4...9a6967755116f14b6f27fc00b5976b58f0bc6fcd,3,15,15,30,10,2011-06-02 19:51:12,2011-06-02 18:15:43
9a6967755116f14b6f27fc00b5976b58f0bc6fcd...9250fce19c39203c702f22fde43724e1a7a19544,1,7,5,12,1,2011-06-03 16:44:21,2011-06-03 16:15:32
9250fce19c39203c702f22fde43724e1a7a19544...1eebb771e3940ddd6640ddc064d5fa6e539c536d,5,21,21,42,17,2011-06-05 19:00:45,2011-06-03 22:22:43
1eebb771e3940ddd6640ddc064d5fa6e539c536d...9fdb09ebf86f4bc85ded08371fbafbab75aba8bf,2,16,1,17,4,2011-06-06 19:49:46,2011-06-05 18:44:28
9fdb09ebf86f4bc85ded08371fbafbab75aba8bf...4738d49e1c76b1762c05a21735d5eecd923aee13,1,668,0,668,1,2011-06-07 05:28:36,2011-04-25 23:23:56
4738d49e1c76b1762c05a21735d5eecd923aee13...0a604bdb90e9dff9399bae0fb4941fe46cc7e9f9,13,1475,0,1475,13,2011-06-07 05:28:37,2011-04-26 16:54:08
0a604bdb90e9dff9399bae0fb4941fe46cc7e9f9...bd7e68f12f238a9d14e422b94f35d7db91a8db5a,1,7,5,12,3,2011-06-07 05:28:37,2011-04-29 17:33:16
bd7e68f12f238a9d14e422b94f35d7db91a8db5a...e205bd7137fd793d223dbe3e020a628f8e7d98f3,14,688,435,1123,110,2011-06-07 05:28:37,2011-04-29 17:04:40
e205bd7137fd793d223dbe3e020a628f8e7d98f3...ea6b87c24ba70d2554c0f9a3e80b245dc3780234,13,42,40,82,41,2011-06-07 05:28:37,2011-04-29 18:04:18
ea6b87c24ba70d2554c0f9a3e80b245dc3780234...b6bc6c2ddf1ae1523ec7e4cb92db209cd6501181,2,10,5,15,5,2011-06-07 05:28:37,2011-04-29 21:43:43
b6bc6c2ddf1ae1523ec7e4cb92db209cd6501181...11e9572b952e49b01035e956c412d6095533031a,53,218,190,408,116,2011-06-07 05:28:38,2011-04-29 22:18:27
11e9572b952e49b01035e956c412d6095533031a...6181ca600d3deced0a054551ff6c704bc17d6b7d,13,1900,1588,3488,47,2011-06-07 05:28:38,2011-05-02 17:16:50
6181ca600d3deced0a054551ff6c704bc17d6b7d...fd112877f8814405d005761097c2d2fcb2ca6310,1,1,1,2,1,2011-06-07 05:28:38,2011-05-02 17:17:10
fd112877f8814405d005761097c2d2fcb2ca6310...525e444a0faf41ae58499c5d3ab0ae32a05895b5,1,20,1,21,1,2011-06-07 05:28:38,2011-05-02 17:18:04
525e444a0faf41ae58499c5d3ab0ae32a05895b5...9d9117384f7879be56e5b905f3533b89983efa4b,13,379,202,581,129,2011-06-07 05:28:38,2011-05-02 23:40:31
9d9117384f7879be56e5b905f3533b89983efa4b...4ac234833a9b5fb0cfc311277b6e27c38bb87ed9,1,21,0,21,1,2011-06-07 05:28:39,2011-05-02 23:51:41
4ac234833a9b5fb0cfc311277b6e27c38bb87ed9...a1f3725c0f04bfd6ff1d869a75019c3caaf08e1a,1,1,0,1,1,2011-06-07 05:28:39,2011-05-03 04:15:38
a1f3725c0f04bfd6ff1d869a75019c3caaf08e1a...9701f0735b31661cc58f4a9ae8077bf6de17302e,1,1,0,1,1,2011-06-07 05:28:39,2011-05-09 20:38:50
9701f0735b31661cc58f4a9ae8077bf6de17302e...2094bc8f61486a978d8fe6daf2d03e18c55f35d3,1,10,2,12,2,2011-06-07 05:28:39,2011-05-10 06:46:35
2094bc8f61486a978d8fe6daf2d03e18c55f35d3...91f9efed49a64f626251feac952fac470f6fe13c,1,5,6,11,4,2011-06-07 05:28:39,2011-05-10 06:47:44
91f9efed49a64f626251feac952fac470f6fe13c...8fa598fa0076c2a0013302ccdbddb5b4bb28fc45,1,0,1,1,1,2011-06-07 05:28:40,2011-05-10 06:48:25
8fa598fa0076c2a0013302ccdbddb5b4bb28fc45...0fb37b08e778c348199a8a4909fad5ed9d920cdd,3,34,18,52,7,2011-06-07 05:51:58,2011-05-10 18:16:00
0fb37b08e778c348199a8a4909fad5ed9d920cdd...c1debfb81d33090c9e721349dd4a2f57a4acf464,1,1,1,2,1,2011-06-07 05:51:58,2011-05-10 18:16:14
c1debfb81d33090c9e721349dd4a2f57a4acf464...3776e08db08232d38b6d5e561092ef78795ec356,6,768,211,979,79,2011-06-07 05:51:58,2011-05-11 00:01:01
3776e08db08232d38b6d5e561092ef78795ec356...3751f172b3986604853700a1475a7ad81b42a9b1,22,1082,359,1441,507,2011-06-07 05:51:58,2011-05-11 00:45:42
3751f172b3986604853700a1475a7ad81b42a9b1...8920381b44442e4bd7b0a026ea571603eed657dd,1,9,13,22,3,2011-06-07 05:51:58,2011-05-11 08:20:18
8920381b44442e4bd7b0a026ea571603eed657dd...14407921c755a3537fe19dc6ebe36996a086da94,1,3,3,6,2,2011-06-07 05:51:58,2011-05-11 08:20:35
14407921c755a3537fe19dc6ebe36996a086da94...0c75a96917aadb845979b4b16c60c8a8df809b17,1,0,0,0,0,2011-06-07 05:51:59,2011-05-12 16:02:48
0c75a96917aadb845979b4b16c60c8a8df809b17...22f9354c211b032c3da3c8e1320a3fa1106e3ffd,1,1,1,2,1,2011-06-07 05:51:59,2011-05-17 09:42:45
22f9354c211b032c3da3c8e1320a3fa1106e3ffd...2e0e732cadd86846b57b7b02b3303a2e0e3b842a,2,58,5,63,9,2011-06-07 05:51:59,2011-05-17 20:12:23
2e0e732cadd86846b57b7b02b3303a2e0e3b842a...8cb84eac6821f6c14f68936df1d7a6765ae96af5,2,18,19,37,9,2011-06-07 05:51:59,2011-05-18 09:13:46
8cb84eac6821f6c14f68936df1d7a6765ae96af5...d62b8407cf11cbcedfcef10001aa71af4ee4751e,1,6,6,12,6,2011-06-07 05:51:59,2011-05-18 09:48:24
d62b8407cf11cbcedfcef10001aa71af4ee4751e...864da8b553f04d772ef359ed721c7c2daf849653,1,2,0,2,2,2011-06-07 05:51:59,2011-05-18 11:03:46
864da8b553f04d772ef359ed721c7c2daf849653...7fe46e8d7e35c21167932c57b4ed53171164d1e2,2,22,25,47,7,2011-06-07 05:51:59,2011-05-18 11:31:26
7fe46e8d7e35c21167932c57b4ed53171164d1e2...e21a868524758f1fd53ea4e6f6344910874dc0eb,4,8,8,16,8,2011-06-07 05:52:00,2011-05-18 12:16:09
e21a868524758f1fd53ea4e6f6344910874dc0eb...76df0db598730eeaab19599f9ee441c421423660,3,3,2,5,3,2011-06-07 05:52:00,2011-05-18 12:28:37
76df0db598730eeaab19599f9ee441c421423660...3616716615c058756a3ead9808275ce9d72b1707,1,16,0,16,1,2011-06-07 05:52:00,2011-05-18 12:55:53
3616716615c058756a3ead9808275ce9d72b1707...924ffafc51cf53ddf97f13ad748bbbf6d80caf13,13,15,18,33,14,2011-06-07 05:52:00,2011-05-18 19:17:16
924ffafc51cf53ddf97f13ad748bbbf6d80caf13...fd357b4cd2c6abc8176829aec37ad8c6f5eaf645,1,4,2,6,2,2011-06-07 05:52:00,2011-05-18 15:40:21
fd357b4cd2c6abc8176829aec37ad8c6f5eaf645...e389911a35a4838ddba4f22f962c484c42f1017f,1,1,1,2,1,2011-06-07 05:52:00,2011-05-19 14:22:13
e389911a35a4838ddba4f22f962c484c42f1017f...43b2cd45f0b42efb67497a6471f3a1b26d792bd9,2,42,36,78,9,2011-06-07 05:52:01,2011-05-19 14:48:05
43b2cd45f0b42efb67497a6471f3a1b26d792bd9...297c9b5b89a6e20d83631170e3c2f71448046bbd,2,15,15,30,15,2011-06-07 05:52:01,2011-05-19 17:22:25
297c9b5b89a6e20d83631170e3c2f71448046bbd...238094310694f0755e6089bf92c36d0ff55fe626,2,4,2,6,3,2011-06-07 05:52:01,2011-05-19 19:14:41
238094310694f0755e6089bf92c36d0ff55fe626...bc2ca384b1c44488c6e27c24f10111cc06113df9,5,0,0,0,0,2011-06-07 05:52:01,2011-05-20 01:04:12
bc2ca384b1c44488c6e27c24f10111cc06113df9...22dee3e27884f357654a470ce2afea08bedcb138,1,3,0,3,1,2011-06-07 05:52:01,2011-05-20 01:05:15
22dee3e27884f357654a470ce2afea08bedcb138...d05e83992023c0aa8c663ac187529abf45dfe533,2,7,5,12,7,2011-06-07 05:52:01,2011-05-24 11:57:52
d05e83992023c0aa8c663ac187529abf45dfe533...2da07127e45312ce22d894aa771b8797e9a301a1,5,197,8,205,11,2011-06-07 05:52:01,2011-05-23 22:49:33
2da07127e45312ce22d894aa771b8797e9a301a1...350ee3110748eed64565bdfe8afd5dc6cbe3641d,2,15,1,16,3,2011-06-07 05:52:02,2011-05-25 12:00:12
350ee3110748eed64565bdfe8afd5dc6cbe3641d...16d0354f934c4f2e185ea9692c9d4039474d0b19,1,1,9,10,2,2011-06-07 05:52:02,2011-05-26 20:00:45
16d0354f934c4f2e185ea9692c9d4039474d0b19...5533e48dead5cff3107e72ee80bf0f19df77c1e9,3,173,779,952,58,2011-06-07 05:52:02,2011-06-02 15:40:26
5533e48dead5cff3107e72ee80bf0f19df77c1e9...7f1e2e48467f80cc083d24b44f088620e4e7bcb6,76,5372,940,6312,499,2011-06-07 05:52:02,2011-06-06 15:50:35
7f1e2e48467f80cc083d24b44f088620e4e7bcb6...f8417b48beaa3080e4e80784c11e8fa68afdec96,5,133,38,171,30,2011-06-07 05:52:02,2011-06-06 15:52:02
f8417b48beaa3080e4e80784c11e8fa68afdec96...c6dbdde6dc875c96a0b89bcdef669eb9171259e0,5,18,16,34,10,2011-06-07 06:10:27,2011-06-06 17:15:17
c6dbdde6dc875c96a0b89bcdef669eb9171259e0...2ba3c3ee57f711cbe555e907458d119c199f255a,1,5,10,15,2,2011-06-07 06:10:27,2011-06-06 17:15:37
2ba3c3ee57f711cbe555e907458d119c199f255a...e89ef35d058d5909e55c870d5686e8912ce820a9,1,1,0,1,1,2011-06-07 06:10:27,2011-06-06 17:16:09
e89ef35d058d5909e55c870d5686e8912ce820a9...af710c3ac181267f1bb6ca9a9ce7174319c293f4,3,6,7,13,5,2011-06-07 06:10:27,2011-06-06 17:45:22
af710c3ac181267f1bb6ca9a9ce7174319c293f4...c4989d8979f4b76460ab585296b3f89ae5a6bd16,1,38,17,55,14,2011-06-07 06:10:28,2011-06-06 18:05:18
c4989d8979f4b76460ab585296b3f89ae5a6bd16...759e6ea8ed798abfd3ad188ee5ba4e688c508535,1,2,2,4,2,2011-06-07 06:10:28,2011-06-06 18:29:47
759e6ea8ed798abfd3ad188ee5ba4e688c508535...bd9a7b9fd71147113a08d8e5736024a8cd6f1979,52,70752,0,70752,19,2011-06-07 06:10:28,2011-05-17 18:32:24
bd9a7b9fd71147113a08d8e5736024a8cd6f1979...3069566073ef07700dc29714f74dd6f2069caf90,13,379,500,879,27,2011-06-07 06:10:28,2011-06-06 21:44:49
3069566073ef07700dc29714f74dd6f2069caf90...c7dbe4d98bba7c6152a23e1d60b8c5a427250919,1,4161,4246,8407,47,2011-06-07 06:10:29,2011-06-06 21:45:05
c7dbe4d98bba7c6152a23e1d60b8c5a427250919...6e4a50112751a68e8fa9489b6c19fe6927a05447,2,36,140,176,8,2011-06-07 06:10:29,2011-06-06 22:00:54
6e4a50112751a68e8fa9489b6c19fe6927a05447...dd44e00dddbdf1938a6241f76a0926b3cb630756,1,3,1,4,2,2011-06-07 06:10:29,2011-06-06 22:11:58
dd44e00dddbdf1938a6241f76a0926b3cb630756...6319ba2ed0d483f083c901905980509f9df1b7ef,1,0,7320,7320,1,2011-06-07 06:10:29,2011-06-01 00:09:04
6319ba2ed0d483f083c901905980509f9df1b7ef...4224e8e37119377abf87d554dc0e48d92c614ac9,5,0,0,0,0,2011-06-07 06:10:29,2011-06-01 00:15:13
4224e8e37119377abf87d554dc0e48d92c614ac9...805bb5bb6e5842a5760976a446074d553609f5b6,2,3,3,6,3,2011-06-07 06:10:30,2011-06-07 00:21:45
805bb5bb6e5842a5760976a446074d553609f5b6...c35b0a7907de1535269876668c345ce944681804,48,284,1860,2144,92,2011-06-07 06:10:30,2011-06-07 05:02:30
c35b0a7907de1535269876668c345ce944681804...48e69ed4d1e672ec849344e9bf3ad1dbdd68f21a,1,2,1,3,1,2011-06-07 06:10:30,2011-06-07 00:22:05
48e69ed4d1e672ec849344e9bf3ad1dbdd68f21a...4cdce2d30b0f78c9bae4f9fd8751583c6ccca610,2,27,4,31,5,2011-06-07 06:10:30,2011-06-06 21:03:04
4cdce2d30b0f78c9bae4f9fd8751583c6ccca610...6e0ff5fa969f79526aa4a848d0fc733e750f6c9c,1,10,2,12,2,2011-06-07 14:44:49,2011-06-07 14:44:49
6e0ff5fa969f79526aa4a848d0fc733e750f6c9c...80ea329d5fc121abbb162bb99a958a3cda815fde,1,10,0,10,1,2011-06-07 14:44:59,2011-06-07 14:44:59
80ea329d5fc121abbb162bb99a958a3cda815fde...f21b9214e657d41e20fb761948b05fc2c7c7f5a3,1,12,22,34,3,2011-06-07 17:39:57,2011-06-07 17:39:57
f21b9214e657d41e20fb761948b05fc2c7c7f5a3...25b3438fd78184cbbc420e2e051888f4f192a68a,5,52,2,54,7,2011-06-07 21:56:01,2011-06-07 19:53:40
25b3438fd78184cbbc420e2e051888f4f192a68a...bb7228e2d906602608a878092158c8004a190809,1,6,6,12,6,2011-06-07 21:56:01,2011-06-07 20:10:00
bb7228e2d906602608a878092158c8004a190809...88ae9278574f2253742f443403da9cace494b997,1,47,26,73,9,2011-06-07 21:56:01,2011-06-07 21:55:45
88ae9278574f2253742f443403da9cace494b997...517ada2662019aae99af4bffb0e7fc673bbe9ebd,2,7,7,14,6,2011-06-07 21:56:56,2011-06-07 20:53:05
517ada2662019aae99af4bffb0e7fc673bbe9ebd...e670a812fa85dd6a63b0d128815f9c0682ffd177,2,1,26,27,2,2011-06-07 21:56:56,2011-06-07 20:21:01
e670a812fa85dd6a63b0d128815f9c0682ffd177...e0ee3a0726f43972244e400863a6dcf567f00a0e,8,129,141,270,29,2011-06-07 23:11:00,2011-06-07 21:13:44
e0ee3a0726f43972244e400863a6dcf567f00a0e...d6e4636618b6f1dfb65d9cff9e5083950ad4acd9,1,3,3,6,3,2011-06-07 23:11:01,2011-06-07 21:56:43
d6e4636618b6f1dfb65d9cff9e5083950ad4acd9...a4dd9ca769c62cf5f65fadc8da0d23d865116046,1,3,0,3,1,2011-06-07 23:11:01,2011-06-07 22:29:34
a4dd9ca769c62cf5f65fadc8da0d23d865116046...66f3317befaffac6857c86892a2f82b56605b555,2,7,2,9,2,2011-06-08 18:24:55,2011-06-08 18:24:55
66f3317befaffac6857c86892a2f82b56605b555...a23d15ad3ad8f0eb52ffc4b0ac86ec358ae3dfa8,1,0,1,1,1,2011-06-08 18:52:12,2011-05-27 22:20:25
a23d15ad3ad8f0eb52ffc4b0ac86ec358ae3dfa8...4295b3dded510affe75f7fe6b56f4747385b864c,6,12,25,37,10,2011-06-08 20:46:39,2011-04-21 22:12:53
4295b3dded510affe75f7fe6b56f4747385b864c...d6eba8f39ff78061a4f9bfaefa1bb1f592f7e0ef,3,45,18,63,9,2011-06-08 20:49:09,2011-03-19 04:18:52
d6eba8f39ff78061a4f9bfaefa1bb1f592f7e0ef...fab4ada3c849becede839530d812748064654bd6,8,103,43,146,13,2011-06-08 20:49:10,2011-03-19 04:27:18
fab4ada3c849becede839530d812748064654bd6...ec6d106d4af0885d9df3498183bbbbcc7971d55a,2,15,7,22,3,2011-06-08 20:49:11,2011-03-23 16:29:20
ec6d106d4af0885d9df3498183bbbbcc7971d55a...73e3f4c10c5aaefc8d8f3792fec7d1c2e2326359,2,11,5,16,2,2011-06-08 20:49:11,2011-03-24 21:47:06
73e3f4c10c5aaefc8d8f3792fec7d1c2e2326359...f57536ddb693f4d610952ed34bad2650f5b1b75c,1,6,6,12,5,2011-06-08 20:49:11,2011-03-24 22:23:13
f57536ddb693f4d610952ed34bad2650f5b1b75c...26e651996a9cd7fa1acf6380fad8b335b769554d,2,6,5,11,3,2011-06-08 20:49:11,2011-03-30 23:28:28
26e651996a9cd7fa1acf6380fad8b335b769554d...f243c6aeda4c7dc87dac495dfb8942f4c8ba675e,1,2,2,4,3,2011-06-08 20:49:11,2011-04-12 22:18:08
f243c6aeda4c7dc87dac495dfb8942f4c8ba675e...cc9f1fdf38bb179166212382b33e78255e669e73,4,39,13,52,7,2011-06-08 20:49:11,2011-04-21 23:32:05
cc9f1fdf38bb179166212382b33e78255e669e73...20ce797906bf20cfb1682a6bd1bb23c02aedc369,1,13,9,22,1,2011-06-08 20:49:11,2011-03-23 16:30:08
20ce797906bf20cfb1682a6bd1bb23c02aedc369...2a12f7dcaa078e1d6c3b5092e62dd5f404b8c3e4,2,47,0,47,3,2011-06-08 22:01:32,2011-04-12 20:40:23
2a12f7dcaa078e1d6c3b5092e62dd5f404b8c3e4...bb67ee8d28f2cddb4b503dc8909649994a4d67e1,2,50,0,50,3,2011-06-08 22:01:32,2011-04-12 23:15:05
bb67ee8d28f2cddb4b503dc8909649994a4d67e1...0e17ade959cc77369dc102d180e43be2af68505a,7,31,54,85,20,2011-06-08 22:01:32,2011-04-05 18:00:26
0e17ade959cc77369dc102d180e43be2af68505a...8cad231bd219eddd518de8b8bd040d3f12f08d17,11,182,113,295,50,2011-06-08 22:21:31,2011-04-18 23:33:30
8cad231bd219eddd518de8b8bd040d3f12f08d17...f9f95879f08073ce1170a471a925541324a0ff23,2,25,0,25,2,2011-06-08 22:21:33,2011-04-20 20:44:34
f9f95879f08073ce1170a471a925541324a0ff23...04a62e83bcd4067749fa5e2eb0181bc43500169c,4,17,3,20,4,2011-06-08 22:21:33,2011-05-06 20:29:51
04a62e83bcd4067749fa5e2eb0181bc43500169c...c1abc03cf3317058be76b0f554d0fdea13293d96,1,201,157,358,6,2011-06-08 22:21:33,2011-05-17 18:42:41
c1abc03cf3317058be76b0f554d0fdea13293d96...4f2f3c9cbf345301ca8feac308878b7ac0d0a597,2,28,4,32,4,2011-06-08 22:21:33,2011-05-17 20:13:16
4f2f3c9cbf345301ca8feac308878b7ac0d0a597...89e001b18a4f6d18caea1e9a3d015639feb4f1ee,3,36,0,36,3,2011-06-08 22:21:33,2011-06-08 21:50:27
89e001b18a4f6d18caea1e9a3d015639feb4f1ee...af285dd370aa1b6779bf67ac3bdc19da512aaac5,9,498,159,657,31,2011-06-08 22:21:33,2011-04-19 23:34:49
af285dd370aa1b6779bf67ac3bdc19da512aaac5...91a34a7027caf0a3f0f4bdaf6649fb6cf479bba8,5,9,110,119,5,2011-06-08 22:21:33,2011-04-19 20:50:15
91a34a7027caf0a3f0f4bdaf6649fb6cf479bba8...e4a00626d85de82cf7825111bbce89784ea4cbc8,2,8,8,16,8,2011-06-08 22:54:57,2011-06-08 18:18:41
e4a00626d85de82cf7825111bbce89784ea4cbc8...5dbf0cc8a28fe5ab5503c45129444cbc59b6bd1f,1,3,3,6,3,2011-06-08 22:58:00,2011-06-08 15:29:36
5dbf0cc8a28fe5ab5503c45129444cbc59b6bd1f...f370be85cb680a7cac7a23999a865b9c9e731238,1,2,2,4,2,2011-06-10 16:30:55,2011-06-10 16:30:55
f370be85cb680a7cac7a23999a865b9c9e731238...e83465c362c53ac7451183a775456f3112262f6e,4,9,4,13,4,2011-06-14 23:14:22,2011-05-23 21:17:55
e83465c362c53ac7451183a775456f3112262f6e...f8529672f6fc4610b8ea005383812c597b829187,1,13,14,27,8,2011-06-14 23:33:56,2011-06-09 22:28:25
f8529672f6fc4610b8ea005383812c597b829187...d428c9910e66246c2af46602499acaeaf187d75b,1,4,0,4,1,2011-06-15 16:20:22,2011-06-15 00:06:50
d428c9910e66246c2af46602499acaeaf187d75b...b842642b574a2b95c53b791308ed1bf8ff9d304d,75,3,1723,1726,1475,2011-06-16 05:31:40,2011-06-16 05:31:40
b842642b574a2b95c53b791308ed1bf8ff9d304d...3c87611188fc1612fe5d07e245a992b25146f2bf,3,29,55,84,24,2011-06-16 05:32:24,2011-06-16 05:32:24
3c87611188fc1612fe5d07e245a992b25146f2bf...7460a7ef618a274607ea99aecae99fb158115c36,2,7,6,13,4,2011-06-16 05:58:57,2011-06-15 20:58:32
7460a7ef618a274607ea99aecae99fb158115c36...c8ee00cb2bfffcc25fdfc14c56b5b82cf71284d5,2,2,2,4,2,2011-06-16 14:27:46,2011-06-16 14:27:46
c8ee00cb2bfffcc25fdfc14c56b5b82cf71284d5...e6ee9947645c5cca9cf6efd902cae1a4a31ea13c,4,216,1,217,5,2011-06-17 04:17:46,2011-06-06 19:13:07
e6ee9947645c5cca9cf6efd902cae1a4a31ea13c...92ebf11b2aaaa357b7d3d91c297b747ae4b8fdf0,12,4,163,167,13,2011-06-17 17:13:49,2011-06-17 17:06:27
92ebf11b2aaaa357b7d3d91c297b747ae4b8fdf0...f9f0905f4ad7b1d0bb9b606a6d25fb1f88354a78,1,1,1,2,1,2011-06-17 17:48:49,2011-06-17 17:43:53
f9f0905f4ad7b1d0bb9b606a6d25fb1f88354a78...d0edc117045eb1252116e64a1df5c094ab6c2c54,2,7,2,9,2,2011-06-17 20:48:22,2011-06-17 20:48:22
d0edc117045eb1252116e64a1df5c094ab6c2c54...fee3717892498c63c24821104e99efab7c9ac177,1,21,18,39,2,2011-06-21 14:23:48,2011-06-21 14:23:48
fee3717892498c63c24821104e99efab7c9ac177...65b6e4874275986607efaf66c3814f3b3a559399,1,18,0,18,1,2011-06-23 14:56:58,2011-06-22 17:14:56
65b6e4874275986607efaf66c3814f3b3a559399...bad62d87a1785f11b0df72ad597b9064517997cf,2,8,1,9,2,2011-06-23 15:06:24,2011-06-22 18:15:42
bad62d87a1785f11b0df72ad597b9064517997cf...b74163dc1d321b878222a751f23adb0a9f6beda5,3,37,37,74,17,2011-06-23 15:12:01,2011-06-20 20:50:46
b74163dc1d321b878222a751f23adb0a9f6beda5...8e880fcb77bdcca2fd4a25f1333acc45dca75d8b,1,215,197,412,55,2011-06-23 15:12:01,2011-06-21 19:29:18
8e880fcb77bdcca2fd4a25f1333acc45dca75d8b...9ec45ad5c45791c81d4d1909ea1abceedc5ed3e9,3,9,1,10,3,2011-06-23 15:12:01,2011-06-22 21:30:56
9ec45ad5c45791c81d4d1909ea1abceedc5ed3e9...b5a510a343270f499cbb8b8a9ac3a3309e9b7ce2,3,52,17,69,8,2011-06-23 19:06:46,2011-06-22 19:33:31
b5a510a343270f499cbb8b8a9ac3a3309e9b7ce2...f3323ec18eaf849fd50e8a81849721581ae6de5c,1,1,1,2,1,2011-06-23 22:13:15,2011-06-23 22:13:15
f3323ec18eaf849fd50e8a81849721581ae6de5c...8e6e09a4bc461ec8b2e9aeb73cf4d0a3b81e05a0,1,1,1,2,1,2011-06-25 15:00:43,2011-06-24 22:45:12
8e6e09a4bc461ec8b2e9aeb73cf4d0a3b81e05a0...8e915f5545102d5c7bfa1bbb24f9b59a36bb5449,1,2,2,4,3,2011-06-27 17:04:40,2011-06-27 17:01:09
8e915f5545102d5c7bfa1bbb24f9b59a36bb5449...ce4f27aa7bb6d75b561e947d44e42d4d43d763c5,1,4,4,8,6,2011-06-27 22:05:38,2011-06-27 22:05:24
ce4f27aa7bb6d75b561e947d44e42d4d43d763c5...2043fd43faef995479f535af77ffb33fe266ab8f,1,22,9,31,6,2011-06-27 23:46:01,2011-06-27 23:46:01
2043fd43faef995479f535af77ffb33fe266ab8f...6aee2938a71c99fdd35639725c6900347999f658,1,0,1,1,1,2011-06-27 23:46:29,2011-06-27 23:46:21
6aee2938a71c99fdd35639725c6900347999f658...75bc59ee4bd4528849b2c64c9854f7dbe25b29df,1,30,6,36,2,2011-06-28 05:31:29,2011-06-27 23:41:08
75bc59ee4bd4528849b2c64c9854f7dbe25b29df...d3fb5b411e979d0a4815c663c3489652fc5350f9,1,4,4,8,2,2011-06-28 05:41:49,2011-06-28 05:41:44
d3fb5b411e979d0a4815c663c3489652fc5350f9...c5f3a413bc00acf9ac1046fb15b454096a8890c6,5,184,54,238,13,2011-06-30 07:34:50,2011-06-29 07:25:13
c5f3a413bc00acf9ac1046fb15b454096a8890c6...1e8448b9e50878cc23d736be66116b49c90bd7f9,2,14,26,40,4,2011-06-30 07:49:44,2011-06-30 07:49:44
1e8448b9e50878cc23d736be66116b49c90bd7f9...c02ef92630308cda6148de74e5561aeecff5f24d,1,3,3,6,3,2011-06-30 08:07:08,2011-06-30 08:07:08
c02ef92630308cda6148de74e5561aeecff5f24d...b3d5d2caa9bef5a0a310c1cdb85edf0d1dd74a7d,1,4,0,4,1,2011-06-30 16:09:05,2011-06-30 16:09:05
b3d5d2caa9bef5a0a310c1cdb85edf0d1dd74a7d...d7e0915e625c5e424d75a8b6e2521158b9ea1c2d,1,1,1,2,1,2011-06-30 16:10:59,2011-06-30 16:10:59
d7e0915e625c5e424d75a8b6e2521158b9ea1c2d...68ab0f9b02372d11d31412edce86080eaa43625b,1,1,1,2,1,2011-06-30 17:54:24,2011-06-30 17:54:24
68ab0f9b02372d11d31412edce86080eaa43625b...6dc22fe57529387b1a66b42193670bf6d6685675,1,3,0,3,1,2011-06-30 17:58:14,2011-06-30 17:58:09
6dc22fe57529387b1a66b42193670bf6d6685675...86ff9dee237672885bd6bc1c902403a448c03354,1,3,2,5,2,2011-06-30 18:33:36,2011-06-30 18:16:56
86ff9dee237672885bd6bc1c902403a448c03354...b49035a8c50f695d6de436213d0a0c8eeb8cd7f8,1,6,0,6,1,2011-06-30 21:29:28,2011-06-30 21:29:28
b49035a8c50f695d6de436213d0a0c8eeb8cd7f8...f606ffed4bc02737f57bec18db0875102dde0ea8,1,1,1,2,1,2011-07-01 03:24:17,2011-07-01 03:24:17
f606ffed4bc02737f57bec18db0875102dde0ea8...75721223b56f8fa02958690dcc9c2f2445271b98,2,11,10,21,3,2011-07-02 00:03:50,2011-07-02 00:03:50
75721223b56f8fa02958690dcc9c2f2445271b98...25a77c58c13e4df37c29245bec0f7716e20f3c15,4,128,8,136,4,2011-07-02 01:17:42,2011-07-02 00:34:12
25a77c58c13e4df37c29245bec0f7716e20f3c15...30bd04feaa057c77fef031697b82721a7feb2c74,2,11,2,13,2,2011-07-02 01:17:54,2011-07-02 00:37:01
30bd04feaa057c77fef031697b82721a7feb2c74...35f9f527d3c95fcababd84f925d9f3cfaac2fbed,1,2,2,4,2,2011-07-02 15:44:50,2011-07-02 15:44:50
35f9f527d3c95fcababd84f925d9f3cfaac2fbed...952225f0208c96ce05f851e77db7db1603c06f89,1,1,1,2,1,2011-07-02 17:37:04,2011-07-02 17:37:04
952225f0208c96ce05f851e77db7db1603c06f89...77ba539f630c57b17d71dbf1e9c5667a7eb603b7,1,1,1,2,1,2011-07-06 23:06:54,2011-07-06 13:59:28
77ba539f630c57b17d71dbf1e9c5667a7eb603b7...41250e9cf9f5c58150a0c0052f5f6e01ea870e0d,1,2,2,4,1,2011-07-08 15:23:30,2011-07-08 15:23:30
41250e9cf9f5c58150a0c0052f5f6e01ea870e0d...28e84ca1671c5d0588d9e9a1f38547805f6cd8b5,1,5,1,6,2,2011-07-08 15:24:09,2011-07-06 21:03:19
28e84ca1671c5d0588d9e9a1f38547805f6cd8b5...7b32c7138647a45138a10dbb5ff314d1e18220fd,2,12,2,14,3,2011-07-08 15:24:09,2011-07-06 21:04:08
7b32c7138647a45138a10dbb5ff314d1e18220fd...76a500179d9327eb4735fe137671ded230246857,1,3,3,6,3,2011-07-08 15:24:09,2011-07-06 21:10:58
76a500179d9327eb4735fe137671ded230246857...1e890863e55d3aa407a8853a9782ae917feaf302,1,8,8,16,5,2011-07-10 17:29:46,2011-07-10 17:29:46
1e890863e55d3aa407a8853a9782ae917feaf302...e09a78438f9c4a43aec6fefed9efd58a0b4060de,1,5,2,7,1,2011-07-11 19:19:42,2011-07-07 20:45:53
e09a78438f9c4a43aec6fefed9efd58a0b4060de...bb39d34279fe1e221d35f5d2a274aaf039ea62d4,1,10,0,10,2,2011-07-13 05:49:12,2011-07-13 05:49:12
bb39d34279fe1e221d35f5d2a274aaf039ea62d4...9ee9ca13da3883d06733637f9048a83d94e6f1f8,2,19,3,22,3,2011-07-13 06:04:46,2011-07-07 23:55:47
9ee9ca13da3883d06733637f9048a83d94e6f1f8...10da625ed93511dbf5d4e61ca4e42f6f2d478959,2,7,1,8,2,2011-07-13 06:04:46,2011-07-08 10:18:26
10da625ed93511dbf5d4e61ca4e42f6f2d478959...ce80576e0b8ac9ed5a5b1f1a4dbc2446434a0002,2,12,0,12,2,2011-07-13 06:04:46,2011-07-08 11:16:51
ce80576e0b8ac9ed5a5b1f1a4dbc2446434a0002...7e2e7b07b6a79a64891f3f2408fb6c325a499e51,5,30,21,51,7,2011-07-13 09:49:16,2011-07-01 23:38:03
7e2e7b07b6a79a64891f3f2408fb6c325a499e51...330d1a870dd81f8665b415f4acc104087156b989,2,6,4,10,3,2011-07-13 23:21:07,2011-07-08 02:43:37
330d1a870dd81f8665b415f4acc104087156b989...106674ac1e06a6d23b5ece3a05f5eefd0bdc2842,1,6,4,10,2,2011-07-13 23:21:07,2011-07-11 21:32:18
106674ac1e06a6d23b5ece3a05f5eefd0bdc2842...4ab359629548b777a69cfdb989a0249806696163,1,1,1,2,1,2011-07-13 23:21:07,2011-07-11 21:33:11
4ab359629548b777a69cfdb989a0249806696163...c52e749a6eaec80a1229c59d7f938ec729f5ec8c,2,2,2,4,2,2011-07-13 23:21:08,2011-07-12 04:52:27
c52e749a6eaec80a1229c59d7f938ec729f5ec8c...47efe44a1d8c9a40526a610b5ee31c44288adee0,2,41,7,48,3,2011-07-13 23:21:08,2011-07-12 07:44:18
47efe44a1d8c9a40526a610b5ee31c44288adee0...8a8a2cf4623708b69dba3816e22b01407e338b73,2,9,11,20,8,2011-07-13 23:21:08,2011-07-12 07:47:07
8a8a2cf4623708b69dba3816e22b01407e338b73...2428907259fa80ec3b1b4bfd85ea20028a9f4fa5,2,56,10,66,5,2011-07-13 23:42:38,2011-07-07 18:42:02
2428907259fa80ec3b1b4bfd85ea20028a9f4fa5...8f3276bbcd444f2bd21c8d8620be92fd6b5d6f33,2,4,1,5,2,2011-07-14 08:59:25,2011-07-09 09:04:00
8f3276bbcd444f2bd21c8d8620be92fd6b5d6f33...86a6cc7152d3743f8c071f7706905c8874963d4f,3,4,2,6,5,2011-07-14 08:59:30,2011-07-13 10:05:22
86a6cc7152d3743f8c071f7706905c8874963d4f...c863514660fed43058c93b288cdf68d476a9cabc,1,121,2,123,9,2011-07-16 08:12:28,2011-06-28 01:38:02
c863514660fed43058c93b288cdf68d476a9cabc...975aef2ad2fcb6e276244822b11ddaf39b13857c,2,3,3,6,2,2011-07-16 08:12:28,2011-07-15 16:23:27
975aef2ad2fcb6e276244822b11ddaf39b13857c...345c01c81b35409c907bee7f70335b3c6f55bcb8,1,2,2,4,1,2011-07-16 08:12:29,2011-07-16 00:05:15
345c01c81b35409c907bee7f70335b3c6f55bcb8...9e37ebe635a37a12535922ac9902ebd492d7cba9,1,20,0,20,1,2011-07-16 08:12:29,2011-07-16 00:18:38
9e37ebe635a37a12535922ac9902ebd492d7cba9...6289d18e61034c4105a1b5bcaa9f12b5d3a32b94,1,1,1,2,1,2011-07-16 08:12:29,2011-07-16 00:19:57
6289d18e61034c4105a1b5bcaa9f12b5d3a32b94...57ea8156a1bcc5d5e65327408ed23143bea031d4,1,3,0,3,1,2011-07-16 08:12:29,2011-07-16 00:20:54
57ea8156a1bcc5d5e65327408ed23143bea031d4...a8f4d87be5c1f6ef8d529d83001a9afe57d7ea3a,1,8,0,8,1,2011-07-16 08:12:29,2011-07-16 00:21:37
a8f4d87be5c1f6ef8d529d83001a9afe57d7ea3a...a0b35161a6b9143ee89853e5c924d7855a488c25,2,1,2,3,2,2011-07-16 08:15:37,2011-07-16 08:15:37
a0b35161a6b9143ee89853e5c924d7855a488c25...da464683aa7a76bd58deb889398e148e25cd2f7f,3,12,8,20,6,2011-07-17 05:01:19,2011-07-17 05:01:19
da464683aa7a76bd58deb889398e148e25cd2f7f...b4f18fc295fe9cdbabf9e6e8d7587e5d76ff6878,1,1,1,2,1,2011-07-18 04:47:39,2011-07-18 04:47:39
b4f18fc295fe9cdbabf9e6e8d7587e5d76ff6878...7a3fdda9650a06792d9278a8cef06d544d49300f,3,106,2,108,7,2011-07-18 05:19:08,2011-07-15 00:50:06
7a3fdda9650a06792d9278a8cef06d544d49300f...83ac1193f2322f71f314e7e160af46142b01a290,1,3,3,6,3,2011-07-18 05:19:08,2011-07-15 01:00:11
83ac1193f2322f71f314e7e160af46142b01a290...f9b4c9da648f81aef1fbee41d24822e420eb56f9,6,45,31,76,17,2011-07-18 05:19:08,2011-07-15 01:28:15
f9b4c9da648f81aef1fbee41d24822e420eb56f9...7974e7eb5f3821b77691819683f9aa37f3c37473,5,43,59,102,22,2011-07-18 07:04:14,2011-06-24 19:26:44
7974e7eb5f3821b77691819683f9aa37f3c37473...ef7cf60ebd74e0a787471ac2b9fa738f636aeae3,2,3,2,5,2,2011-07-18 07:04:38,2011-07-18 06:55:39
ef7cf60ebd74e0a787471ac2b9fa738f636aeae3...b7cf7f2a79f05ccfa0329c1e9e0b50306edc7aed,1,3,2,5,1,2011-07-18 19:12:54,2011-07-17 09:03:44
b7cf7f2a79f05ccfa0329c1e9e0b50306edc7aed...c43ce91b2534fe36994fd74cf8d159e54909d8ca,2,1,1,2,1,2011-07-18 19:12:54,2011-07-17 07:32:23
c43ce91b2534fe36994fd74cf8d159e54909d8ca...4c6d26a38f977f61d4deaacfd6b6c71f331e8065,8,24,27,51,24,2011-07-18 19:12:54,2011-07-17 07:47:11
4c6d26a38f977f61d4deaacfd6b6c71f331e8065...b98c23274b4dd51205d5020a254ac53966c9ae9a,2,5,1,6,3,2011-07-18 19:12:55,2011-05-19 07:19:21
b98c23274b4dd51205d5020a254ac53966c9ae9a...fe5240732d0a80b8717be77b31d51dc3c4d737fd,108,216,0,216,108,2011-07-18 19:12:55,2011-07-17 08:05:43
fe5240732d0a80b8717be77b31d51dc3c4d737fd...120701b9d9ebdd9352c7fca2b8a381597a808362,1,8,4,12,4,2011-07-18 21:14:19,2011-05-28 03:49:57
120701b9d9ebdd9352c7fca2b8a381597a808362...2b2df4754d8ee212741a78c068ba320d962556ba,3,86,11,97,16,2011-07-18 21:14:19,2011-05-28 08:48:14
2b2df4754d8ee212741a78c068ba320d962556ba...96361603322787117846e45573220c3cebdedb14,1,3,3,6,1,2011-07-19 21:04:50,2011-07-19 21:04:50
96361603322787117846e45573220c3cebdedb14...3ea2416f8083a21bf2f47f3381a66bf97e7f59e2,2,10,56,66,5,2011-07-19 23:07:25,2011-07-19 23:07:25
3ea2416f8083a21bf2f47f3381a66bf97e7f59e2...ad3b8d7bcf89454e5567378f3d2771de8c9dc027,2,58,0,58,2,2011-07-19 23:58:40,2011-07-19 23:58:40
ad3b8d7bcf89454e5567378f3d2771de8c9dc027...0fbaa2f12ab96328fe2e7b4b9f3ec0c8d7f30e37,2,23,1,24,4,2011-07-20 23:50:44,2011-07-18 22:31:14
0fbaa2f12ab96328fe2e7b4b9f3ec0c8d7f30e37...3af1e7ca2ee8c2acd69e5bcbb3ffc1bf51239285,4,133,27,160,22,2011-07-21 00:06:56,2011-07-14 19:02:01
3af1e7ca2ee8c2acd69e5bcbb3ffc1bf51239285...e90b741c9492a65e159c842afe49383f1868308e,2,56,6,62,5,2011-07-21 00:09:40,2011-06-25 01:09:59
e90b741c9492a65e159c842afe49383f1868308e...8fa066190af2b2267a5e8111a41beb6e8af5c340,8,305,344,649,40,2011-07-21 00:33:18,2011-07-10 01:15:40
8fa066190af2b2267a5e8111a41beb6e8af5c340...0782422d1f319593ffe3f0d7b2372ba995ad362c,4,68,18,86,18,2011-07-22 22:34:55,2011-07-12 00:31:29
0782422d1f319593ffe3f0d7b2372ba995ad362c...fdd5d9471f3b330e3b941681c5b11e16e948da75,6,17,107,124,7,2011-07-22 22:49:10,2011-07-22 22:49:07
fdd5d9471f3b330e3b941681c5b11e16e948da75...0cf55353330e652e1bbb60f1eefee2b59cc9e8f6,1,19,4,23,3,2011-07-26 16:40:29,2011-07-18 17:42:42
0cf55353330e652e1bbb60f1eefee2b59cc9e8f6...ae75c3574618245ff8fe148b6e289ff47f033609,1,0,17,17,1,2011-07-26 16:40:29,2011-07-15 23:15:15
ae75c3574618245ff8fe148b6e289ff47f033609...66fec10dc309730ff6aa78a42c94f6c2a2b33b2a,1,4,4,8,2,2011-07-26 16:40:29,2011-07-19 16:49:44
66fec10dc309730ff6aa78a42c94f6c2a2b33b2a...ee04141a5a17f375018e20f0919e7afc03b4875f,2,3,3,6,3,2011-07-26 16:40:29,2011-07-19 16:50:51
ee04141a5a17f375018e20f0919e7afc03b4875f...f3456dc2826e9570cf2969fab3c314255d16188f,3,92,41,133,21,2011-07-26 16:41:41,2011-07-07 20:56:13
f3456dc2826e9570cf2969fab3c314255d16188f...c348f2cad6e2db0c3a37108eb34c8d62f2b7c718,3,23,1,24,4,2011-07-26 16:41:42,2011-07-11 19:55:29
c348f2cad6e2db0c3a37108eb34c8d62f2b7c718...7802c90e139a36d37b9d3c8cd6b6fcfee042dd71,3,93,20,113,15,2011-07-26 16:41:43,2011-07-14 20:27:39
7802c90e139a36d37b9d3c8cd6b6fcfee042dd71...3237f8b9950ab0dbf3c80f6bef40217ea7cf96ae,3,27,1,28,4,2011-07-26 16:41:44,2011-07-14 20:54:34
3237f8b9950ab0dbf3c80f6bef40217ea7cf96ae...f768954f38a7077abfd291eaafc0500d2d1e8007,3,214,100,314,48,2011-07-26 17:11:06,2011-07-15 23:17:05
f768954f38a7077abfd291eaafc0500d2d1e8007...17251372b1dedb42d27b01375125cee4f5edcce7,2,127,108,235,32,2011-07-26 17:11:40,2011-07-25 20:26:45
17251372b1dedb42d27b01375125cee4f5edcce7...31b59efa961e8729a0153d7d6ea5e300d7db17f2,2,102,44,146,31,2011-07-26 21:16:57,2011-07-24 00:05:20
31b59efa961e8729a0153d7d6ea5e300d7db17f2...00ea08e0ab2a0154e168e63f2505d885bbca9096,1,3,2,5,1,2011-07-26 21:20:24,2011-07-26 21:16:39
00ea08e0ab2a0154e168e63f2505d885bbca9096...f3e04fbd6a3ce9d84dec5052233a0712c2273859,3,34,17,51,5,2011-07-26 21:21:13,2011-07-19 18:45:34
f3e04fbd6a3ce9d84dec5052233a0712c2273859...bee78a84922da51de647af96fe86f75b1322d3d9,3,24,3,27,5,2011-07-26 21:21:13,2011-07-21 02:27:59
bee78a84922da51de647af96fe86f75b1322d3d9...9dea9de44917b0b72a786122e619d451ccb8b0dc,7,163,68,231,21,2011-07-26 23:35:42,2011-07-21 02:29:54
9dea9de44917b0b72a786122e619d451ccb8b0dc...72e46548b869335705735d30dd3d2709a1ea3b93,1,1,1,2,1,2011-07-27 20:18:51,2011-07-27 20:18:51
72e46548b869335705735d30dd3d2709a1ea3b93...f39420e7d7aca2a97eaa01853991facf65dcbd6e,6,8,8,16,8,2011-07-27 20:24:07,2011-07-27 20:24:07
f39420e7d7aca2a97eaa01853991facf65dcbd6e...b5594a773a6f07dcba914aa385f92d3305285b24,10,291,124,415,68,2011-07-27 22:21:31,2011-07-22 19:56:45
b5594a773a6f07dcba914aa385f92d3305285b24...4b90f65614af2b8da1e5904b2b0f2fce7c4e08e3,1,1,1,2,1,2011-07-29 18:43:17,2011-07-29 18:43:12
4b90f65614af2b8da1e5904b2b0f2fce7c4e08e3...3e54a1b18ab698d55e1642a120f95ea3adf6af1b,13,196,183,379,84,2011-07-29 19:40:27,2011-07-29 19:40:14
3e54a1b18ab698d55e1642a120f95ea3adf6af1b...a79231dea6cd13849c1a72d447f367e8c5053537,7,43,53,96,18,2011-07-29 19:46:54,2011-07-29 19:45:10
a79231dea6cd13849c1a72d447f367e8c5053537...bdef462cccd4e6b5be770929c30a941e314ffc36,1,16,13,29,11,2011-07-29 19:56:50,2011-07-29 19:56:50
bdef462cccd4e6b5be770929c30a941e314ffc36...f4df421b44eb2ee0926b569f646c863324988c23,1,1,1,2,2,2011-07-29 20:43:51,2011-07-29 20:43:51
f4df421b44eb2ee0926b569f646c863324988c23...c1a681d6f45b7ff8af20aa9e6dcd3c20e61e1494,1,3,3,6,2,2011-07-29 20:44:55,2011-07-29 20:44:45
c1a681d6f45b7ff8af20aa9e6dcd3c20e61e1494...a45d383da20ebee912ce8b062964c91b05c32c67,1,9,0,9,1,2011-07-29 20:59:36,2011-07-29 20:59:36
a45d383da20ebee912ce8b062964c91b05c32c67...908f59a5dfd6e4378be1055918b04a8f40e9310d,1,12,12,24,7,2011-07-29 22:00:00,2011-07-29 22:00:00
908f59a5dfd6e4378be1055918b04a8f40e9310d...8d6479371767b74ef44529a5632811a287a40210,1,68,8,76,6,2011-07-29 22:27:15,2011-07-29 22:00:31
8d6479371767b74ef44529a5632811a287a40210...aacd5b672e8836b30c5921fb77b167de827f48b0,1,1,1,2,1,2011-07-29 23:30:24,2011-07-29 23:30:24
aacd5b672e8836b30c5921fb77b167de827f48b0...761997e082b3b7201bc82e6c340fd952b8ab0d4a,1,2,3,5,2,2011-07-30 02:34:22,2011-07-30 02:34:11
761997e082b3b7201bc82e6c340fd952b8ab0d4a...eb758bc60578cbc720917156238c07157ee736d7,1,9,0,9,1,2011-07-30 02:35:27,2011-07-30 02:35:27
eb758bc60578cbc720917156238c07157ee736d7...2d8d5aef2918ca0d2503290f86a42701fc98d330,2,9,3,12,3,2011-07-30 03:06:32,2011-07-30 03:01:19
2d8d5aef2918ca0d2503290f86a42701fc98d330...1f4b417184ce53af15474de065400f8a686430c5,14,45,38,83,37,2011-07-30 14:41:42,2011-07-30 01:42:16
1f4b417184ce53af15474de065400f8a686430c5...8f0dcbab804180828d6859b1340c86cf161209fb,60,2524,1706,4230,630,2011-08-01 23:00:03,2011-03-23 16:33:29
8f0dcbab804180828d6859b1340c86cf161209fb...67a3315e1de1ca4ea469fc9443e97080513c909e,2,4,4,8,4,2011-08-02 14:11:47,2011-08-02 05:15:33
67a3315e1de1ca4ea469fc9443e97080513c909e...15efbbdc1fe42f914e6442b32ffc032a4cc8e792,2,2,1,3,2,2011-08-02 17:01:36,2011-08-02 07:59:51
15efbbdc1fe42f914e6442b32ffc032a4cc8e792...4f6e947e494c2c574b02cfb87b9b9bba29148737,2,3,3,6,3,2011-08-03 23:50:25,2011-08-01 15:42:32
4f6e947e494c2c574b02cfb87b9b9bba29148737...4dc9e6416a465eb7e8ffaa34997500fec6324aa2,1,6,6,12,6,2011-08-04 17:48:17,2011-08-04 17:48:17
4dc9e6416a465eb7e8ffaa34997500fec6324aa2...6f8904e027651504107a6311ddc6b5f78df02d7a,2,93,23,116,7,2011-08-06 08:54:05,2011-08-02 23:44:25
6f8904e027651504107a6311ddc6b5f78df02d7a...862d78c1d96a22ae215ec272e6f0d07b374421bf,1,37,9,46,5,2011-08-06 08:54:05,2011-08-05 21:22:23
862d78c1d96a22ae215ec272e6f0d07b374421bf...142cffcf64d2dce93089e9a73257bddf50e96990,2,1,18,19,4,2011-08-06 08:54:05,2011-08-05 22:01:58
142cffcf64d2dce93089e9a73257bddf50e96990...06835a462afc7105532e13abdd5217314b3ae71e,9,18,19,37,13,2011-08-06 08:54:06,2011-08-05 23:24:12
06835a462afc7105532e13abdd5217314b3ae71e...40ad543d27fac2201746a58211465204af250269,1,4,6,10,2,2011-08-10 09:50:15,2011-08-10 09:50:15
40ad543d27fac2201746a58211465204af250269...842741ee9958ce3895f709c3faf47bfac762ef64,1,1,9,10,1,2011-08-10 09:51:24,2011-08-10 09:51:24
842741ee9958ce3895f709c3faf47bfac762ef64...8bc7beacd80814102a6b08b83283ccf8614e44d4,1,1,1,2,1,2011-08-12 17:19:28,2011-08-12 15:47:18
8bc7beacd80814102a6b08b83283ccf8614e44d4...1c9fc1e1dec67c8c05f02da1e0853439238c4d8e,2,16,6,22,7,2011-08-12 22:47:44,2011-08-11 22:02:08
1c9fc1e1dec67c8c05f02da1e0853439238c4d8e...42062dab34192d2cb9ed66a720c0f791408c61c0,35,265,987,1252,261,2011-08-12 22:47:47,2011-08-10 20:15:43
42062dab34192d2cb9ed66a720c0f791408c61c0...13e7df68a65b0dd2eb4eed673f7b8e3e702d72a9,3,12,13,25,7,2011-08-12 22:48:12,2011-08-12 15:57:21
13e7df68a65b0dd2eb4eed673f7b8e3e702d72a9...3f99cdbdc30e85c2100acd7cbe67052befd08776,3,77,0,77,7,2011-08-12 23:18:41,2011-08-11 22:19:26
3f99cdbdc30e85c2100acd7cbe67052befd08776...530dc412c4d4700268e52920e6114f7941171706,1,9,24,33,3,2011-08-15 04:32:13,2011-08-12 19:03:27
530dc412c4d4700268e52920e6114f7941171706...34f174066f1aa70dba0f97942580082169348200,2,49,42,91,10,2011-08-15 04:32:15,2011-08-12 21:32:25
34f174066f1aa70dba0f97942580082169348200...7ec8a89362f7010f2b0f5fb73a644dab789ce010,2,47,0,47,3,2011-08-15 05:46:51,2011-08-10 01:24:56
7ec8a89362f7010f2b0f5fb73a644dab789ce010...6802a760078d9f8e305e41cc208383ca6415436f,8,111,0,111,8,2011-08-15 06:44:20,2011-07-29 20:47:16
6802a760078d9f8e305e41cc208383ca6415436f...8534b7c7c0aa352eb0f17dbe8b22ba34f995654d,2,151,100,251,60,2011-08-15 06:44:20,2011-07-29 20:50:22
8534b7c7c0aa352eb0f17dbe8b22ba34f995654d...966cbd4cf8d795b1706ff400f604c6002d7e81f9,22,7384,0,7384,23,2011-08-15 06:44:20,2011-07-29 21:22:37
966cbd4cf8d795b1706ff400f604c6002d7e81f9...37b5c5cfe9df70fa2a2c6c681a903b7c356aec74,5,13,65,78,22,2011-08-15 06:44:21,2011-08-12 09:28:45
37b5c5cfe9df70fa2a2c6c681a903b7c356aec74...6c30601ad8db0629fa4e7e4a22fd9448d33513f9,155,465,0,465,155,2011-08-15 06:44:21,2011-08-12 10:25:41
6c30601ad8db0629fa4e7e4a22fd9448d33513f9...ef01362e441db50758dde41bcdcc20823b55a213,9,0,206,206,9,2011-08-15 07:15:07,2011-08-14 08:20:47
ef01362e441db50758dde41bcdcc20823b55a213...9d808239b3120b0120f164834ce3012f779c8939,8,18,18,36,18,2011-08-15 07:20:48,2011-08-14 08:26:56
9d808239b3120b0120f164834ce3012f779c8939...035ad727267877cb1be58dacb24ddf97cc7b5512,1,4,4,8,4,2011-08-15 07:21:02,2011-08-14 08:41:49
035ad727267877cb1be58dacb24ddf97cc7b5512...2bbef363e4a97b3af6a6900f9a2021a0d191ca40,8,11,11,22,11,2011-08-15 07:21:02,2011-08-14 08:47:05
2bbef363e4a97b3af6a6900f9a2021a0d191ca40...1d45e65f4a026eb0461429f2557a5f0400b7f88e,1,2,1,3,1,2011-08-15 07:21:02,2011-08-14 09:50:59
1d45e65f4a026eb0461429f2557a5f0400b7f88e...793ecb48176ad6d8866ce38f4242971c81ceda31,6,2,95,97,9,2011-08-15 19:51:41,2011-08-14 10:24:09
793ecb48176ad6d8866ce38f4242971c81ceda31...de34ca0b649b609fcb8d2cab569239bed42e5af8,1,2,2,4,2,2011-08-15 19:52:09,2011-08-15 07:19:14
de34ca0b649b609fcb8d2cab569239bed42e5af8...431b748cac1aa530d68e9bb80e7ceabddf18fcd7,6,78,6,84,9,2011-08-16 22:15:06,2011-08-11 03:53:56
431b748cac1aa530d68e9bb80e7ceabddf18fcd7...b99b0a80723ad3a9b43e9ef36869f521eaec19ec,1,22,0,22,1,2011-08-18 15:41:23,2011-06-23 14:52:47
b99b0a80723ad3a9b43e9ef36869f521eaec19ec...6114c8f504e99fecb0d62cce4beb3a8f39f301ec,2,24,4,28,7,2011-08-18 19:07:04,2011-08-18 19:07:04
6114c8f504e99fecb0d62cce4beb3a8f39f301ec...dc0b0c77c7ba3e419442ec639356ab5d3ba7efbe,2,165,6,171,9,2011-08-19 10:55:47,2011-08-15 15:34:11
dc0b0c77c7ba3e419442ec639356ab5d3ba7efbe...774db0aecb85f9ae79895046b62ea4c45bad8bff,3,14,4,18,3,2011-08-19 22:27:21,2011-08-19 19:06:59
774db0aecb85f9ae79895046b62ea4c45bad8bff...db04241beb152a4614534ac8c987a3146c8f2992,1,2,1,3,1,2011-08-21 07:46:46,2011-08-21 06:52:58
db04241beb152a4614534ac8c987a3146c8f2992...607de75fa42bdf4221698ddce8ce0a2bbc7ec99d,2,2,7,9,3,2011-08-21 07:46:58,2011-08-21 07:24:22
607de75fa42bdf4221698ddce8ce0a2bbc7ec99d...38e6d1e313a6ee8994821e675e25b5263d818bc7,2,30,25,55,10,2011-08-21 07:50:58,2011-08-21 07:50:58
38e6d1e313a6ee8994821e675e25b5263d818bc7...94e3b28d2497a680ecce81bef5fa84ef0ad39fc0,2,7,2,9,2,2011-08-21 07:52:26,2011-08-21 07:52:26
94e3b28d2497a680ecce81bef5fa84ef0ad39fc0...ee389180593ab21167a3d36b73c8e31315eac6bd,1,2,0,2,1,2011-08-21 08:31:54,2011-08-21 08:27:00
ee389180593ab21167a3d36b73c8e31315eac6bd...15e610577900c247a7df8462aecae74e42d91be3,1,0,2,2,2,2011-08-21 16:40:53,2011-08-21 15:34:18
15e610577900c247a7df8462aecae74e42d91be3...0f6e199d98caadbb35e3ac66e02236bee06060c5,1,18,0,18,1,2011-08-23 15:17:46,2011-08-19 22:46:25
0f6e199d98caadbb35e3ac66e02236bee06060c5...e3fad0feb35f02191ace77638a102c79daad63ac,2,12,1,13,2,2011-08-23 17:27:51,2011-08-19 23:10:21
e3fad0feb35f02191ace77638a102c79daad63ac...446f6b233fa8bd5bbdf2d6d9c980e3e23df52cd9,3,221,179,400,84,2011-08-24 09:06:55,2011-08-19 00:41:57
446f6b233fa8bd5bbdf2d6d9c980e3e23df52cd9...dbf8afcba0cfc0e341e3ebd2dadeba627c083f0a,1,4,2,6,2,2011-08-24 15:00:33,2011-08-24 14:58:07
dbf8afcba0cfc0e341e3ebd2dadeba627c083f0a...30753cb1310893841fdb0b17c075b6a72e8c8d8a,5,95,2,97,6,2011-08-24 22:01:49,2011-08-20 07:24:24
30753cb1310893841fdb0b17c075b6a72e8c8d8a...08a33e7bb377a4d47917dbf5fabbe59b562f1e04,2,451,77,528,64,2011-08-24 22:01:50,2011-08-02 23:33:20
08a33e7bb377a4d47917dbf5fabbe59b562f1e04...19401280aed9d4767faddcf58fab91ec13c556a9,4,66,12,78,6,2011-08-24 22:03:09,2011-08-20 15:51:00
19401280aed9d4767faddcf58fab91ec13c556a9...452607fc64b2b0ba5ee9a8745746e652ae21b6db,2,5,4,9,3,2011-08-25 01:36:38,2011-08-25 01:36:35
452607fc64b2b0ba5ee9a8745746e652ae21b6db...5927b23ef35736ec075e226c32d46decb5d42e34,2,9,1,10,2,2011-08-25 23:34:18,2011-08-25 23:31:00
5927b23ef35736ec075e226c32d46decb5d42e34...3ba90003b415542501a0732e09e1271bbd830eff,1,3,3,6,3,2011-08-29 21:38:28,2011-08-26 17:54:38
3ba90003b415542501a0732e09e1271bbd830eff...0da4902e9db4f6f494b8be74c41f21d5e5520b79,2,15,0,15,2,2011-08-30 09:11:08,2011-08-24 18:00:18
0da4902e9db4f6f494b8be74c41f21d5e5520b79...e068addadb14b44374ebb5353b860700731c866f,2,318,0,318,2,2011-08-30 09:11:09,2011-08-16 23:00:16
e068addadb14b44374ebb5353b860700731c866f...545b31aa2ef20ad241be0a3d87ae328fdbf2404a,3,770,7,777,9,2011-08-30 09:11:09,2011-08-17 21:43:38
545b31aa2ef20ad241be0a3d87ae328fdbf2404a...bceadd8e30c6ca7ab20268c39bc405e169a9774f,155,310,155,465,155,2011-08-30 09:11:10,2011-08-17 21:43:02
bceadd8e30c6ca7ab20268c39bc405e169a9774f...4a9ccc0abcbad65842e1933818ad302e9f3a7a65,7,168,16,184,22,2011-08-30 09:11:10,2011-08-18 00:27:15
4a9ccc0abcbad65842e1933818ad302e9f3a7a65...c9e7fb894beccfb3680af54a6b1469831a3b999d,1,9,9,18,3,2011-08-31 05:05:13,2011-08-24 05:27:59
c9e7fb894beccfb3680af54a6b1469831a3b999d...456c7f62c5b437aef7d23af5af9c05c30531a594,1,6,5,11,5,2011-08-31 21:29:37,2011-08-25 20:29:20
456c7f62c5b437aef7d23af5af9c05c30531a594...08d09ecbaa07564bf3cf6a62e0be4c41b355d23b,2,22,2,24,6,2011-08-31 21:30:21,2011-08-26 05:23:10
08d09ecbaa07564bf3cf6a62e0be4c41b355d23b...ad3cc16eef0a13844e6e05abcb18c46a370f0814,10,286,132,418,68,2011-08-31 21:31:23,2011-08-24 05:30:14
ad3cc16eef0a13844e6e05abcb18c46a370f0814...3c80cf3df607464ea95acc6595c521d8fd32de2c,3,16,8,24,7,2011-08-31 21:34:56,2011-08-31 19:21:27
3c80cf3df607464ea95acc6595c521d8fd32de2c...e5da0c956b5bc6f2da835f4307b2322de0785a9b,2,2,2,4,2,2011-08-31 21:34:56,2011-08-31 18:49:17
e5da0c956b5bc6f2da835f4307b2322de0785a9b...c763b009ac16cefba28a4bfa84cd6c98e9d6a620,1,31,10,41,3,2011-08-31 21:34:56,2011-08-31 17:01:40
c763b009ac16cefba28a4bfa84cd6c98e9d6a620...93f96a16f6a4744ece493135552f694a925f2802,2,81,59,140,31,2011-08-31 21:34:56,2011-08-31 00:36:39
93f96a16f6a4744ece493135552f694a925f2802...825cbadf80a7eef3fbba04454086470b6ee6a4d7,1,0,13,13,1,2011-09-01 05:32:27,2011-09-01 05:32:27
825cbadf80a7eef3fbba04454086470b6ee6a4d7...ff2cb86d5db4150cded494728b64095d05be4a71,1,2,2,4,2,2011-09-01 06:03:58,2011-09-01 05:59:47
ff2cb86d5db4150cded494728b64095d05be4a71...a5607e3061f5b0aa7988446025dba8f89413fd9d,6,104,124,228,74,2011-09-01 07:19:35,2011-09-01 07:06:09
a5607e3061f5b0aa7988446025dba8f89413fd9d...31b86241215bb37cc6bb81f98a47942738d710c2,2,94,45,139,11,2011-09-01 22:00:22,2011-09-01 21:19:22
31b86241215bb37cc6bb81f98a47942738d710c2...986608fe763482c79dfd0338e5041e5e673fec9f,2,16,1,17,2,2011-09-01 23:37:06,2011-09-01 09:37:32
986608fe763482c79dfd0338e5041e5e673fec9f...db78aa1ce1c6e6a3f1ab0b569c78f160da239d4c,1,13,0,13,1,2011-09-01 23:37:07,2011-09-01 10:11:00
db78aa1ce1c6e6a3f1ab0b569c78f160da239d4c...622c3ec97409c67ff316c317771b47880fa5c1e8,2,16,2,18,2,2011-09-01 23:37:07,2011-09-01 22:13:42
622c3ec97409c67ff316c317771b47880fa5c1e8...2a8fe56997fddbad673748ce02abf649a709c4ca,5,167,37,204,19,2011-09-01 23:37:08,2011-09-01 08:57:49
2a8fe56997fddbad673748ce02abf649a709c4ca...8d11db0757263ef1467ff1cbaf1f1e978ba3ac60,1,1,1,2,1,2011-09-01 23:37:08,2011-09-01 09:38:01
8d11db0757263ef1467ff1cbaf1f1e978ba3ac60...bc6e0cc9545e04ded113c1b894a9c55cbd1774b1,10,209,74,283,38,2011-09-02 17:44:19,2011-09-01 22:33:48
bc6e0cc9545e04ded113c1b894a9c55cbd1774b1...30e5f6274a7148c139aeafdb8098f63cbdbd5d33,1,67,1,68,5,2011-09-02 17:53:41,2011-09-02 06:04:34
30e5f6274a7148c139aeafdb8098f63cbdbd5d33...8bae2a5ecbb2ed554fad4fcea9bfe80a4655fe08,1,1,1,2,1,2011-09-02 18:32:29,2011-09-02 18:32:29
8bae2a5ecbb2ed554fad4fcea9bfe80a4655fe08...fc7f1ef6a04f92fb79f5aa65829986b75ad1f45c,2,6,2,8,2,2011-09-02 22:41:41,2011-09-02 22:41:41
fc7f1ef6a04f92fb79f5aa65829986b75ad1f45c...7f0b97e02c61183a30d39f7ce81d11220ac64cca,2,6,6,12,4,2011-09-02 23:17:05,2011-09-02 22:53:26
7f0b97e02c61183a30d39f7ce81d11220ac64cca...b0eb831bce7d0ea066fd0758124793ed3db6d692,1,1,1,2,1,2011-09-05 21:53:53,2011-08-08 18:51:57
b0eb831bce7d0ea066fd0758124793ed3db6d692...79f2512ba762cc87966c1d78b31bb0cca4765f5a,1,0,1,1,1,2011-09-06 15:36:53,2011-09-06 15:36:53
79f2512ba762cc87966c1d78b31bb0cca4765f5a...e54909f5efa37cd4013d7f21a77817ea459cde64,1,6,1,7,2,2011-09-06 21:57:37,2011-09-06 20:59:27
e54909f5efa37cd4013d7f21a77817ea459cde64...06534413d3a33193853c39d0f9081709aac3908f,2,12,6,18,9,2011-09-08 06:37:37,2011-09-03 05:59:59
06534413d3a33193853c39d0f9081709aac3908f...4b1913c5ecac75e60e7a0de831100b6961d5d294,2,20,6,26,7,2011-09-08 15:59:45,2011-09-07 07:17:10
4b1913c5ecac75e60e7a0de831100b6961d5d294...fc2f188d4d8f06aab31979b293d95580e19cbdf1,2,12,9,21,8,2011-09-08 15:59:52,2011-09-07 07:19:53
fc2f188d4d8f06aab31979b293d95580e19cbdf1...988ed451b508b9d7ea4690b150993ec62d8a3743,8,261,143,404,61,2011-09-08 18:36:33,2011-06-22 17:57:22
988ed451b508b9d7ea4690b150993ec62d8a3743...cbedf556416522a0a4b08abd3101e856e59c6a6a,1,70,67,137,26,2011-09-08 18:36:33,2011-06-23 15:21:47
cbedf556416522a0a4b08abd3101e856e59c6a6a...d0f459c56fdb3dae692c359a2915acb2fd063c79,9,71,4,75,12,2011-09-08 18:37:28,2011-06-23 18:01:25
d0f459c56fdb3dae692c359a2915acb2fd063c79...91ccb4ba6e203f1b80a1aa7187d8773434948fc2,3,52,0,52,3,2011-09-08 18:37:28,2011-07-19 13:52:27
91ccb4ba6e203f1b80a1aa7187d8773434948fc2...f37f0ea16edd4b487ef8812ff69a78d9a287fa60,2,26,0,26,2,2011-09-08 18:37:28,2011-07-19 23:32:29
f37f0ea16edd4b487ef8812ff69a78d9a287fa60...5ba227c7cd3ddfcd3bffc3fd15daf8d6ec9b8713,2,975,393,1368,110,2011-09-08 21:00:49,2011-06-29 16:30:39
5ba227c7cd3ddfcd3bffc3fd15daf8d6ec9b8713...22cb600280cecabf719ba1878719c907aa01ba18,6,131,187,318,86,2011-09-08 21:00:59,2011-07-12 00:18:17
22cb600280cecabf719ba1878719c907aa01ba18...4421f3d43525437bd939f647604480c1ed126e5e,5,34,26,60,18,2011-09-08 21:00:59,2011-07-12 00:18:46
4421f3d43525437bd939f647604480c1ed126e5e...909415d5ed817ea3dc2ddcfded00f808df4b5849,1,3,2,5,3,2011-09-08 21:00:59,2011-07-19 18:02:50
909415d5ed817ea3dc2ddcfded00f808df4b5849...8fa79066e2cea470086769aa59e7cc9d3aa30d81,4,3186,0,3186,3,2011-09-08 21:00:59,2011-07-22 12:58:53
8fa79066e2cea470086769aa59e7cc9d3aa30d81...66dec7755573a1c07a1fe8e0dd9bc5fc51dbaac9,3,24,4,28,4,2011-09-08 21:00:59,2011-08-30 11:14:55
66dec7755573a1c07a1fe8e0dd9bc5fc51dbaac9...292d5d1421108c239d3270c22c49a9ccd1eea571,1,5,7,12,7,2011-09-08 21:00:59,2011-09-01 14:04:18
292d5d1421108c239d3270c22c49a9ccd1eea571...4b4292edb86d34067a2babb9f572a3641dd1d2a7,7,52,51,103,48,2011-09-08 21:00:59,2011-09-01 14:16:01
4b4292edb86d34067a2babb9f572a3641dd1d2a7...aac68bf2ba2dcdf0b22fa4f15ea49672cb06328d,1,12,2,14,2,2011-09-08 21:00:59,2011-09-02 12:13:33
aac68bf2ba2dcdf0b22fa4f15ea49672cb06328d...7e1f364177111ba6cceac82f6c6bcc254448292b,2,4,4,8,3,2011-09-08 21:00:59,2011-09-02 20:28:52
7e1f364177111ba6cceac82f6c6bcc254448292b...1856f62cb1a37314a2cbd41feacd4e12128df6b5,1,47,6,53,7,2011-09-09 08:01:05,2011-09-09 08:01:05
1856f62cb1a37314a2cbd41feacd4e12128df6b5...17d1aef66afebc074db95dbe05937a98710dfb1d,1,1,1,2,1,2011-09-09 08:01:46,2011-09-09 08:01:46
17d1aef66afebc074db95dbe05937a98710dfb1d...8017340cd106156e84508fa8061bd98004eff487,2,8,2,10,2,2011-09-12 17:23:37,2011-09-12 17:23:37
8017340cd106156e84508fa8061bd98004eff487...a13653c81431bf51fed2a958514ebfb9aeb2dc14,11,197,359,556,15,2011-09-12 23:02:22,2011-08-15 23:17:12
a13653c81431bf51fed2a958514ebfb9aeb2dc14...e14ac2c3b0c08df381618e92145eadd125aad03f,1,3,3,6,3,2011-09-12 23:02:23,2011-08-15 23:19:19
e14ac2c3b0c08df381618e92145eadd125aad03f...8336f3f0ba89b529057027711ab4babd6c2cb649,1,1,1,2,1,2011-09-15 23:39:03,2011-09-15 23:39:03
8336f3f0ba89b529057027711ab4babd6c2cb649...a2a830e2273f2cb114d1889d6dece171621b046c,15,9062,6405,15467,16,2011-09-16 00:44:27,2011-09-12 16:56:02
a2a830e2273f2cb114d1889d6dece171621b046c...0d7fe97aff0d69fa9c72c6eb08d0dffc70359dae,3,6,21,27,7,2011-09-16 00:44:28,2011-09-14 22:35:09
0d7fe97aff0d69fa9c72c6eb08d0dffc70359dae...ab407de54d04133e2089086d6c574592c8a19ffc,1,23,22,45,4,2011-09-16 00:44:28,2011-09-14 22:50:00
ab407de54d04133e2089086d6c574592c8a19ffc...8259f101389afc1b5b1f044b2b07bf6f8f44fc83,1,8,2,10,2,2011-09-16 00:44:28,2011-09-15 19:11:45
8259f101389afc1b5b1f044b2b07bf6f8f44fc83...6b7ddf414de82720bbf547b2fa661bf5fcec7bb6,2,117,1,118,4,2011-09-16 00:44:29,2011-09-15 19:20:38
6b7ddf414de82720bbf547b2fa661bf5fcec7bb6...009059dd1bc7817dbb55fc1b61424fd66a914bc3,1,11,1,12,1,2011-09-16 00:44:29,2011-09-15 20:03:00
009059dd1bc7817dbb55fc1b61424fd66a914bc3...3800d177030d20c5c3d04e3601f892c46e723dc2,2,41,0,41,3,2011-09-16 00:44:30,2011-09-15 22:56:19
3800d177030d20c5c3d04e3601f892c46e723dc2...555f4152909e1c0bd5400737a62dc5d63ecd32d3,1,12,4,16,5,2011-09-16 00:44:30,2011-09-14 02:32:16
555f4152909e1c0bd5400737a62dc5d63ecd32d3...f9b6b614683c14a0b636a21bafb6932ab4a8aca4,1,12,10,22,4,2011-09-16 00:44:31,2011-09-14 22:42:17
f9b6b614683c14a0b636a21bafb6932ab4a8aca4...4e8f0d6e9ff1b852de9de9da72d0fac138bcd1a7,1,6,0,6,1,2011-09-16 00:44:31,2011-09-14 22:44:10
4e8f0d6e9ff1b852de9de9da72d0fac138bcd1a7...0e5a24c584d88b17297010676b8e0005b3545efd,3,17,17,34,13,2011-09-16 00:44:32,2011-09-14 22:47:15
0e5a24c584d88b17297010676b8e0005b3545efd...2170c06924b3a0dc1fef3b383d6a236e670dceea,4,17,2,19,4,2011-09-16 00:44:33,2011-09-15 02:54:00
2170c06924b3a0dc1fef3b383d6a236e670dceea...7ae536d0532b7ad7859f9cf7e47b406f63383f29,4,24,7,31,6,2011-09-16 00:44:33,2011-09-15 03:36:00
7ae536d0532b7ad7859f9cf7e47b406f63383f29...6883e8c7a0c121319ced63596718d34e3ab650a8,2,13,1,14,2,2011-09-16 00:44:34,2011-09-15 22:05:13
6883e8c7a0c121319ced63596718d34e3ab650a8...9acf45127e96051e23f28af7650778fe444d8c86,1,1,1,2,1,2011-09-16 00:44:35,2011-09-15 22:06:19
9acf45127e96051e23f28af7650778fe444d8c86...3ace81b92ad00da73c89e7536ac7aa7c6681e30a,8,63,61,124,57,2011-09-16 00:44:35,2011-09-15 22:09:33
3ace81b92ad00da73c89e7536ac7aa7c6681e30a...62ae7fccbc524ff498779564294ed6e1a7a3f51c,1,1,1,2,1,2011-09-16 12:18:45,2011-09-16 12:18:45
62ae7fccbc524ff498779564294ed6e1a7a3f51c...2bc39bb0b4f81b77597bb52f8572d231cf4f83e2,2,25,2,27,3,2011-09-21 11:47:17,2011-09-21 11:47:17
2bc39bb0b4f81b77597bb52f8572d231cf4f83e2...13f92de6246a0af8450fde84b209211a56397fda,12,150,80,230,52,2011-09-26 21:51:53,2011-08-30 09:47:24
13f92de6246a0af8450fde84b209211a56397fda...2eb49147d69fe930714578dd7aa13f8d5e3a6d49,1,2,12,14,2,2011-09-26 21:51:54,2011-09-21 12:11:15
2eb49147d69fe930714578dd7aa13f8d5e3a6d49...ea3228e311a22d5f917ca7135ee4d68738a6dfb4,2,23,2,25,3,2011-09-26 21:51:54,2011-09-21 12:10:34
ea3228e311a22d5f917ca7135ee4d68738a6dfb4...2e9fed7b6c5f8c738406c4e9e65300e5d69a113a,3,28,2,30,5,2011-09-26 21:51:55,2011-09-21 00:47:12
2e9fed7b6c5f8c738406c4e9e65300e5d69a113a...bf5e5f7bc9ebc7dc6cf8fdf3c4923498b22a8654,2,10,1,11,2,2011-09-26 22:44:10,2011-09-02 13:50:10
bf5e5f7bc9ebc7dc6cf8fdf3c4923498b22a8654...084b83ffa909a2221008acd64fe59b326d30bc87,1,5,0,5,1,2011-09-27 19:48:47,2011-09-27 18:59:18
084b83ffa909a2221008acd64fe59b326d30bc87...ca1e45beafd060b698933886f6425faf365bd31d,2,61,2,63,6,2011-09-28 21:57:00,2011-09-27 14:56:54
ca1e45beafd060b698933886f6425faf365bd31d...21b2a5bd212e600cbbf9212982ff556bbdb18e5f,1,2,0,2,1,2011-09-28 21:57:01,2011-09-27 14:59:23
21b2a5bd212e600cbbf9212982ff556bbdb18e5f...b7a7fc7065a7bd6031b82a748105cf0415cb68e4,1,14,7,21,1,2011-09-29 01:21:24,2011-09-29 01:20:31
b7a7fc7065a7bd6031b82a748105cf0415cb68e4...c115fa99240a55e32e1fa39f037056df429be741,2,38,2,40,4,2011-10-05 18:01:32,2011-09-23 18:36:09
c115fa99240a55e32e1fa39f037056df429be741...091c173632f91c04734b1cc3d1e0441c2e3e506e,1,1,1,2,1,2011-10-05 20:47:43,2011-10-01 04:35:42
091c173632f91c04734b1cc3d1e0441c2e3e506e...29d36e94e101c76da58421cab6828146b041b108,1,36,28,64,9,2011-10-05 21:19:33,2011-10-05 19:14:59
29d36e94e101c76da58421cab6828146b041b108...e1ecc34edd19b95d51fbcb1351b04b9876c974c1,2,38,22,60,8,2011-10-07 23:01:09,2011-09-30 23:55:01
e1ecc34edd19b95d51fbcb1351b04b9876c974c1...7aeb6a24f73bd1206640f358fd2630c81a807d44,1,0,1,1,1,2011-10-08 01:20:20,2011-10-07 21:32:05
7aeb6a24f73bd1206640f358fd2630c81a807d44...7e6ff401b8e6353b0612be6133719818dc9046d3,1,46,2,48,3,2011-10-08 16:15:10,2011-10-08 16:01:34
7e6ff401b8e6353b0612be6133719818dc9046d3...f6a8ad87eee69c5cee45e30ac6a5b5aa081f1f1b,1,1,1,2,1,2011-10-08 16:18:19,2011-10-08 16:18:19
f6a8ad87eee69c5cee45e30ac6a5b5aa081f1f1b...8ee32a75f07da96ec1cc4a8474a9a53e5c2aca98,2,8,2,10,2,2011-10-10 18:23:08,2011-10-10 17:15:19
8ee32a75f07da96ec1cc4a8474a9a53e5c2aca98...e134a8335f5ee7d2e81034ed93f3e465cb14573f,4,6,9,15,5,2011-10-11 17:53:03,2011-08-17 19:21:43
e134a8335f5ee7d2e81034ed93f3e465cb14573f...75f11f1fc46c35a28c0905f7316ea6779145e2fb,7,384,227,611,160,2011-10-11 17:53:04,2011-08-17 06:08:13
75f11f1fc46c35a28c0905f7316ea6779145e2fb...97e3ec4d1b58a253d61c15239002265b33c30a13,1,1,0,1,1,2011-10-11 17:53:04,2011-07-26 22:14:14
97e3ec4d1b58a253d61c15239002265b33c30a13...25a62b58db31c212c330d1bd7ce58bdd031e114a,5,27,16,43,15,2011-10-11 17:53:04,2011-08-02 20:29:12
25a62b58db31c212c330d1bd7ce58bdd031e114a...ca08c004c893310ed9b3b4a5d2a4d16314eaa677,1,1,1,2,1,2011-10-11 17:53:05,2011-08-04 23:07:35
ca08c004c893310ed9b3b4a5d2a4d16314eaa677...bda2bba2be7a52bf39fb1b257b6363edc7b71173,3,89,9,98,7,2011-10-11 17:53:05,2011-07-26 19:06:14
bda2bba2be7a52bf39fb1b257b6363edc7b71173...b96e978178a6acbf048aa6db466ed845e1395445,2,8,2,10,3,2011-10-11 17:53:06,2011-08-17 19:19:43
b96e978178a6acbf048aa6db466ed845e1395445...1942861472a4cd8d2d72f2ed54ee2b63be5d68b8,7,0,164,164,7,2011-10-11 17:53:06,2011-08-25 04:28:55
1942861472a4cd8d2d72f2ed54ee2b63be5d68b8...e86c435349fd68ece54c5e31b834a3848387c933,4,25,98,123,14,2011-10-11 17:53:07,2011-08-25 04:50:12
e86c435349fd68ece54c5e31b834a3848387c933...ccda436f94945f617461e5925c451737156bd337,1,1,0,1,1,2011-10-11 17:53:07,2011-09-06 19:03:48
ccda436f94945f617461e5925c451737156bd337...df6d2ba3266de405ad6c2f270f24569355706e76,6,0,170,170,6,2011-10-11 17:53:07,2011-09-06 19:04:47
df6d2ba3266de405ad6c2f270f24569355706e76...4f78fd692c0ec51241476e6be9a4df06cd62fdd6,104,7051,3970,11021,357,2011-10-11 18:01:45,2011-09-08 20:56:29
4f78fd692c0ec51241476e6be9a4df06cd62fdd6...fd822bdaf9d04e522aaa5400b673f333190abe98,107,942,941,1883,807,2011-10-11 18:01:46,2011-10-07 18:27:49
fd822bdaf9d04e522aaa5400b673f333190abe98...de4e06ed7354020d0edcd0314174fbaf15164801,1,10,0,10,1,2011-10-12 18:11:10,2011-10-12 18:11:10
de4e06ed7354020d0edcd0314174fbaf15164801...a4b45397e006c86000af55e389084418f88b65c3,3,21,5,26,12,2011-10-12 18:49:42,2011-10-12 18:49:42
a4b45397e006c86000af55e389084418f88b65c3...2bc7afd3bac5d8b22a876391ba8590568abc179e,1,2,2,4,1,2011-10-13 06:04:47,2011-10-12 05:52:30
2bc7afd3bac5d8b22a876391ba8590568abc179e...f0f5ffa9aa279cafc5db2c060102b653d6f728dd,1,1,0,1,1,2011-10-13 06:04:47,2011-10-12 07:03:57
f0f5ffa9aa279cafc5db2c060102b653d6f728dd...66fdb36ecbe0ec58ba3367a585b506e11ca1c8ad,1,2,11,13,2,2011-10-13 06:04:47,2011-10-12 07:08:23
66fdb36ecbe0ec58ba3367a585b506e11ca1c8ad...8f46a3c9ac075c6300e974efaecd0d10d986a515,2,38,7,45,10,2011-10-13 06:04:47,2011-10-12 07:10:20
8f46a3c9ac075c6300e974efaecd0d10d986a515...8611ebe6a0d61092c1e66eb636e817c1445fd73f,3,42,5,47,8,2011-10-13 06:04:48,2011-10-07 21:11:32
8611ebe6a0d61092c1e66eb636e817c1445fd73f...4af4378b11c971f99205b7e712c13e8ef3467749,2,15,6,21,4,2011-10-13 06:04:48,2011-10-12 17:58:08
4af4378b11c971f99205b7e712c13e8ef3467749...b3c4cb7cff8bab6e0e3d7e68870ed6316bbd5241,75,0,137,137,136,2011-10-13 06:04:48,2011-10-12 19:19:39
b3c4cb7cff8bab6e0e3d7e68870ed6316bbd5241...28ccc76aa17f6107bea692ad4782cfb209e7a10f,2,2,2,4,2,2011-10-13 06:04:48,2011-10-13 05:50:35
28ccc76aa17f6107bea692ad4782cfb209e7a10f...26e8ab3693eb0ad388247ae5c35cd52eaa709b0c,1,15,4,19,5,2011-10-13 18:10:19,2011-10-12 20:57:09
26e8ab3693eb0ad388247ae5c35cd52eaa709b0c...afc81b554ede0818e64a6971d4f409bdc2c42272,2,42,15,57,14,2011-10-13 18:10:19,2011-10-12 20:58:08
afc81b554ede0818e64a6971d4f409bdc2c42272...02332107e51a4b00b313c3457b8fa8959c7cb517,1,9,1,10,1,2011-10-13 18:10:20,2011-10-13 01:23:20
02332107e51a4b00b313c3457b8fa8959c7cb517...8e32f3fd351fcdbc30822f1996d567fcbcc42c02,1,1,1,2,1,2011-10-13 18:10:20,2011-10-13 01:25:42
8e32f3fd351fcdbc30822f1996d567fcbcc42c02...ec8bb675b4d85c53f3e8f258ea0c1a975caa4af6,1,2,2,4,1,2011-10-13 18:10:20,2011-10-13 01:26:18
ec8bb675b4d85c53f3e8f258ea0c1a975caa4af6...718741acab907a88682387f587d5342e3fcd40d2,1,0,0,0,0,2011-10-13 20:44:38,2011-10-13 20:44:38
718741acab907a88682387f587d5342e3fcd40d2...7a19eb84aa3df39f42e42a4e4ac0b169862119be,2,10,10,20,9,2011-10-13 21:07:48,2011-10-13 21:07:35
7a19eb84aa3df39f42e42a4e4ac0b169862119be...9ed1126adb56cbeebd23f3589decff2ac6bc36b3,1,16,7,23,2,2011-10-13 21:37:37,2011-10-13 21:36:42
9ed1126adb56cbeebd23f3589decff2ac6bc36b3...ad5e42cf8229a40d8dfd3f3e178207b2af1cdb14,2,11,11,22,10,2011-10-13 21:42:49,2011-10-13 21:42:41
ad5e42cf8229a40d8dfd3f3e178207b2af1cdb14...d0425de29e16018f670d03e2f3a27aec82430b17,1,73,29,102,28,2011-10-13 23:54:30,2011-10-13 22:32:05
d0425de29e16018f670d03e2f3a27aec82430b17...d83a92c12138ab53d1a6c6eae7d0cf9300514e8c,2,10,10,20,8,2011-10-14 00:35:00,2011-10-13 23:58:44
d83a92c12138ab53d1a6c6eae7d0cf9300514e8c...ab5df20dfa54d1d05f10d0aa7de5227e68cc37a8,12,296,417,713,56,2011-10-14 00:36:11,2011-10-13 18:37:21
ab5df20dfa54d1d05f10d0aa7de5227e68cc37a8...9810dc0993bbb6509b3b7f77abaf8fcfef1f45bf,1,1,1,2,1,2011-10-14 15:29:33,2011-10-14 15:29:33
9810dc0993bbb6509b3b7f77abaf8fcfef1f45bf...b0c3f28e8f541ccf6c25e3fdd3f3cae8c727e067,1,4,4,8,4,2011-10-14 15:30:02,2011-10-14 15:30:02
b0c3f28e8f541ccf6c25e3fdd3f3cae8c727e067...669b53ede21d74a7efd05592e7697e473b37e2a0,1,3,3,6,2,2011-10-14 15:31:00,2011-10-14 15:31:00
669b53ede21d74a7efd05592e7697e473b37e2a0...fe65dd926cd500ff182395c01a627fd20b81f0e5,1,1,1,2,1,2011-10-14 15:31:39,2011-10-14 15:31:39
fe65dd926cd500ff182395c01a627fd20b81f0e5...74379df6c425030d8e3d52d3b1e37b2f45d21d2a,2,8,2,10,2,2011-10-14 22:29:17,2011-10-14 22:29:17
74379df6c425030d8e3d52d3b1e37b2f45d21d2a...ee6af9a97807e1f166da0f7b005f2133a86344d5,2,16,3,19,4,2011-10-18 21:02:54,2011-10-12 23:42:21
ee6af9a97807e1f166da0f7b005f2133a86344d5...e801faba2e1c28641166a61448df60a68ade3841,2,191,181,372,5,2011-10-18 23:21:52,2011-10-18 23:21:02
e801faba2e1c28641166a61448df60a68ade3841...07926ff1ef2912a6fb8f361ae9b3c98bc3da1dc8,1,1,1,2,1,2011-10-19 00:25:10,2011-10-19 00:25:10
07926ff1ef2912a6fb8f361ae9b3c98bc3da1dc8...833eb3c84445110dc1dad238120573f08ed8d102,2,23,1,24,2,2011-10-19 00:27:43,2011-10-18 23:46:27
833eb3c84445110dc1dad238120573f08ed8d102...8978e066b5f7fd0fac273b470b90fe4f9bef48c2,10,17,23,40,10,2011-10-19 05:23:52,2011-10-17 22:26:10
8978e066b5f7fd0fac273b470b90fe4f9bef48c2...e82e64d57b65d9f3c4f2e8831f30b615a069b7f6,2,9,1,10,2,2011-10-19 17:36:36,2011-10-17 23:18:27
e82e64d57b65d9f3c4f2e8831f30b615a069b7f6...78f394fd17be581c84ecd526bb786ed1681d35cb,2,102,18,120,15,2011-10-19 23:49:20,2011-10-17 23:18:00
78f394fd17be581c84ecd526bb786ed1681d35cb...3217a249e18c12fb1ade59073773e2ab67a67792,1,10,8,18,13,2011-10-19 23:49:34,2011-10-19 23:42:32
3217a249e18c12fb1ade59073773e2ab67a67792...a46f2a0db37c88465072d0eec22b0439bf003ff7,1,26,1,27,2,2011-10-19 23:49:34,2011-10-19 23:43:16
a46f2a0db37c88465072d0eec22b0439bf003ff7...5d43439dbe764a4c7227f51b34a81b044f13901b,2,3,3,6,3,2011-10-20 04:52:20,2011-10-20 04:52:20
5d43439dbe764a4c7227f51b34a81b044f13901b...36928858104ba793dfc7372dbaa28048123d6e63,3,107,15,122,6,2011-10-20 05:52:14,2011-10-11 22:37:00
36928858104ba793dfc7372dbaa28048123d6e63...c17c731fdc9c5d00cc606df19c9b36d51e41a8d7,1,7,8,15,2,2011-10-20 05:52:14,2011-10-20 05:51:13
c17c731fdc9c5d00cc606df19c9b36d51e41a8d7...fabc9f77a3fae10c2b8d9a9ad1541e827cc0390d,1,31,17,48,5,2011-10-20 16:44:52,2011-10-20 16:43:00
fabc9f77a3fae10c2b8d9a9ad1541e827cc0390d...7fc18b263dc74f52bb677e446f23e35d64948841,3,36,16,52,11,2011-10-20 18:30:40,2011-10-20 18:06:06
7fc18b263dc74f52bb677e446f23e35d64948841...f38010d3a2f457a53798212ef72418637dabe189,4,13,17,30,10,2011-10-20 22:51:14,2011-10-20 22:37:37
f38010d3a2f457a53798212ef72418637dabe189...e175db37c6f52bba4080efeec22a7120a896099e,2,27,25,52,8,2011-10-20 23:51:28,2011-10-19 06:42:36
e175db37c6f52bba4080efeec22a7120a896099e...c6c3949b14f4003ecab291243edfca61262f2c3d,2,7,7,14,5,2011-10-20 23:51:28,2011-10-20 23:50:49
c6c3949b14f4003ecab291243edfca61262f2c3d...9b85757102fbd44e88d0a3909fdf8b90f191b593,2,20,6,26,6,2011-10-22 22:35:18,2011-10-20 15:46:09
9b85757102fbd44e88d0a3909fdf8b90f191b593...6eb117950540dd0dce2ea71164f8cbc28d803b92,1,28,29,57,17,2011-10-23 04:32:47,2011-10-21 14:56:03
6eb117950540dd0dce2ea71164f8cbc28d803b92...90ac8d57b0d5ef68cb70486edf0590fff225a284,1,5,1,6,3,2011-10-23 04:32:47,2011-10-21 14:56:44
90ac8d57b0d5ef68cb70486edf0590fff225a284...ce73ed091b13aeef03b2061623512b87307cd251,3,30,0,30,5,2011-10-23 04:32:47,2011-10-22 04:48:13
ce73ed091b13aeef03b2061623512b87307cd251...e28171d5e493e0878d5276a44d4aa3db4ebd74f2,1,3,2,5,1,2011-10-23 04:32:48,2011-10-22 05:53:25
e28171d5e493e0878d5276a44d4aa3db4ebd74f2...ad90c3574f8365ee4a1a973d5e43c64fe9fcda2c,4,69,4,73,10,2011-10-23 04:32:48,2011-10-22 06:33:24
ad90c3574f8365ee4a1a973d5e43c64fe9fcda2c...bacc31bea968a505b52889630e4bf578b18ff996,4,7,3,10,5,2011-10-23 04:32:48,2011-10-23 04:32:16
bacc31bea968a505b52889630e4bf578b18ff996...b4add97c17b9a84381bbb72cfc704a8dcf14e878,1,48,2,50,2,2011-10-23 04:39:39,2011-10-22 22:13:12
b4add97c17b9a84381bbb72cfc704a8dcf14e878...eabedba34d4df74f764dd3fd9c72e2f985bdb82f,1,1,1,2,1,2011-10-23 04:39:39,2011-10-22 22:26:11
eabedba34d4df74f764dd3fd9c72e2f985bdb82f...836e4c14283754309a9e4dac7de57f1c80d0030b,2,9,2,11,2,2011-10-24 16:16:33,2011-10-24 16:16:33
836e4c14283754309a9e4dac7de57f1c80d0030b...7da70af1aefe8a147053a6a8b0890ede4245b68a,1,1,1,2,1,2011-10-24 21:03:50,2011-10-24 20:06:58
7da70af1aefe8a147053a6a8b0890ede4245b68a...163c799effd5cfadc57990f4d4127651bae3fbdb,2,41,1,42,3,2011-10-25 06:28:36,2011-10-22 00:53:37
163c799effd5cfadc57990f4d4127651bae3fbdb...bb948176aaf6748c0d27772797b4c1490612b917,1,5,11,16,10,2011-10-26 19:02:30,2011-10-26 18:38:04
bb948176aaf6748c0d27772797b4c1490612b917...d5ccabce600efb10092fdf0ae033c009026bf4cb,2,26,3,29,3,2011-10-26 19:15:07,2011-10-26 19:15:07
d5ccabce600efb10092fdf0ae033c009026bf4cb...3945f884c5777e629b57c9ab0e93b9d02b9840d0,2,76,44,120,10,2011-10-26 19:54:00,2011-10-24 16:18:44
3945f884c5777e629b57c9ab0e93b9d02b9840d0...25d1822bd8596cd7972298aab2ab2366e217b663,1,1,1,2,1,2011-10-26 19:54:00,2011-10-25 05:49:30
25d1822bd8596cd7972298aab2ab2366e217b663...af7c51ee1d010a650e4f524467d5ee7c82cc24b5,1,18,18,36,16,2011-10-26 19:57:14,2011-10-25 16:09:32
af7c51ee1d010a650e4f524467d5ee7c82cc24b5...578e38e0af7ff49b2ba942301752f0b16c14875a,1,8,7,15,4,2011-10-26 19:57:14,2011-10-26 07:16:21
578e38e0af7ff49b2ba942301752f0b16c14875a...950d02b4d4b1d574dfbb9bbdd56b8dc430db0a93,1,2,2,4,1,2011-10-26 19:57:14,2011-10-25 19:02:20
950d02b4d4b1d574dfbb9bbdd56b8dc430db0a93...d7ba5bc83ba9a8937384ea677331c5156ed6772d,5,78,167,245,29,2011-10-26 19:57:15,2011-10-25 15:47:02
d7ba5bc83ba9a8937384ea677331c5156ed6772d...dc8ffa51b7ebe5fb9bc1c89087c8b3c9e65d1006,3,82,46,128,20,2011-10-26 22:58:59,2011-10-24 22:22:34
dc8ffa51b7ebe5fb9bc1c89087c8b3c9e65d1006...bf729d550b9589aa498957d219816e334222858b,5,184,10,194,4,2011-10-26 22:58:59,2011-10-25 20:23:49
bf729d550b9589aa498957d219816e334222858b...445680f601c55397e8cf9e8528675a2053d8f807,1,1,1,2,1,2011-10-27 15:44:14,2011-10-27 15:44:14
445680f601c55397e8cf9e8528675a2053d8f807...02dc81bae0011b7ae4190363be5fdd5db420aca9,1,4,0,4,1,2011-10-31 05:26:32,2011-10-29 05:01:21
02dc81bae0011b7ae4190363be5fdd5db420aca9...28ed5ba46595a371bd734b92a6e4bb40d1013741,3,40,7,47,9,2011-10-31 05:27:25,2011-09-20 03:11:32
28ed5ba46595a371bd734b92a6e4bb40d1013741...4ae671ac88fc1fd74af988a188525e8eaa1c3a4a,1,6,7,13,3,2011-10-31 05:27:25,2011-10-26 23:59:02
4ae671ac88fc1fd74af988a188525e8eaa1c3a4a...21602b5cd6573d0d9e9077df416b0bf42c15694d,1,1,1,2,1,2011-10-31 05:27:25,2011-10-27 00:20:53
21602b5cd6573d0d9e9077df416b0bf42c15694d...6cbe096dbf9bde91972a9d5e60ade616ffe3888f,3,0,17,17,3,2011-10-31 05:27:25,2011-10-27 00:23:45
6cbe096dbf9bde91972a9d5e60ade616ffe3888f...7d0c256ecd0fc22126090c4aeb18fd2c9fff2baa,1,9,1,10,7,2011-10-31 05:31:03,2011-10-28 07:43:04
7d0c256ecd0fc22126090c4aeb18fd2c9fff2baa...615841a5d3cb6dae8329411c27fd938e9b413f4c,1,1,1,2,1,2011-10-31 14:19:33,2011-10-31 14:19:33
615841a5d3cb6dae8329411c27fd938e9b413f4c...ef875ad0cf4349144cb4674e050dd160564f6dd9,2,38,7,45,6,2011-10-31 18:34:25,2011-10-30 22:11:25
ef875ad0cf4349144cb4674e050dd160564f6dd9...95fdb1231f21254f9cf6e68dcee689fb9e3a2b52,2,3,5,8,3,2011-10-31 18:34:25,2011-10-30 22:13:22
95fdb1231f21254f9cf6e68dcee689fb9e3a2b52...84873e7f4eacae7d71605b2368ee746fe30a25e3,2,12,5,17,6,2011-10-31 18:34:25,2011-10-31 05:15:59
84873e7f4eacae7d71605b2368ee746fe30a25e3...c0b557a96c72dc5be0a698efe01654d0295e1e49,1,5,8,13,2,2011-10-31 19:46:12,2011-10-31 19:46:00
c0b557a96c72dc5be0a698efe01654d0295e1e49...2636105c5e363f14cda890f19ac9c3bc57556dd2,3,92,85,177,7,2011-11-01 01:22:21,2011-11-01 00:54:09
2636105c5e363f14cda890f19ac9c3bc57556dd2...ddf6f1143f140d81b22d21ff33de062a35999801,3,15,0,15,3,2011-11-01 01:22:38,2011-11-01 00:56:55
ddf6f1143f140d81b22d21ff33de062a35999801...1d966f8a65a968d6549f70ff59ac280f50b4ce24,1,2,2,4,2,2011-11-01 21:14:52,2011-11-01 01:12:26
1d966f8a65a968d6549f70ff59ac280f50b4ce24...66fc268aeb772aeb72d3301339fa7b5194c14561,1,2,2,4,2,2011-11-06 05:30:50,2011-11-06 05:30:01
66fc268aeb772aeb72d3301339fa7b5194c14561...9f9ed4c5fff7a88e750131fed34dfd135c0922d2,1,18,4,22,7,2011-11-08 10:23:51,2011-11-08 06:48:52
9f9ed4c5fff7a88e750131fed34dfd135c0922d2...e2663f62b0fbb8b9ce2e706b821a135e0bc7e885,2,68,31,99,5,2011-11-08 10:25:22,2011-11-05 00:13:56
e2663f62b0fbb8b9ce2e706b821a135e0bc7e885...e60601be4f0cfa7493ecef12608323e6ccf11326,1,35,2,37,7,2011-11-08 12:29:07,2011-11-08 10:51:40
e60601be4f0cfa7493ecef12608323e6ccf11326...f5ef3724cef5a998eeb9c607b73bd4a409319c99,1,1,1,2,1,2011-11-08 12:29:07,2011-11-08 12:19:12
f5ef3724cef5a998eeb9c607b73bd4a409319c99...aaa01797585b0876f67cd1c24d94106871618074,2,8,2,10,3,2011-11-09 00:39:19,2011-11-09 00:39:19
aaa01797585b0876f67cd1c24d94106871618074...1e00db8daa5c09e7f8f9134f5c94b9a18c7dc425,4,44,2,46,5,2011-11-09 05:44:46,2011-11-09 01:19:54
1e00db8daa5c09e7f8f9134f5c94b9a18c7dc425...e4303a1f3a4e7c0f8a286c91b0ab177fba0c6dca,1,0,130,130,1,2011-11-09 16:54:04,2011-10-25 17:52:17
e4303a1f3a4e7c0f8a286c91b0ab177fba0c6dca...fc7834f9acc8463c6cae146d973d3f224b49696e,1,1,2,3,1,2011-11-11 21:04:26,2011-11-03 20:10:15
fc7834f9acc8463c6cae146d973d3f224b49696e...eb01fe593de3f8f2328f54ad4044cd8da679cfc8,3,1586,1332,2918,432,2011-11-14 00:30:21,2011-11-11 23:28:00
eb01fe593de3f8f2328f54ad4044cd8da679cfc8...4afad1da299cadf6761604d42ceb069158201170,2,11,3,14,2,2011-11-14 00:40:31,2011-11-12 00:40:43
4afad1da299cadf6761604d42ceb069158201170...260725efcd15e960941af6bc1f468e3fb1ac45c5,1,11,2,13,4,2011-11-14 00:40:31,2011-11-12 00:50:19
260725efcd15e960941af6bc1f468e3fb1ac45c5...5e663c3dc7aa2908b3396ec41426572a2a105a3c,2,14,21,35,6,2011-11-14 00:40:31,2011-11-12 01:08:25
5e663c3dc7aa2908b3396ec41426572a2a105a3c...5c70ff72e2d733e1f5deb72d296f118555b0019d,2,24,22,46,16,2011-11-14 00:40:31,2011-11-12 01:15:22
5c70ff72e2d733e1f5deb72d296f118555b0019d...93b777c916ccff243c5a6080bf5f39860ac7bf39,3,1,1,2,2,2011-11-15 00:39:31,2011-10-25 17:30:27
93b777c916ccff243c5a6080bf5f39860ac7bf39...48697a2b86dbb12ea8de64cc5fece7caf68b321e,51,3114,3199,6313,1162,2011-11-15 00:39:31,2011-10-17 23:56:56
48697a2b86dbb12ea8de64cc5fece7caf68b321e...03dd8c4f4c462cb5a5a08faf3cca6946dd3815f2,2,18,9,27,7,2011-11-15 00:39:32,2011-10-26 04:28:48
03dd8c4f4c462cb5a5a08faf3cca6946dd3815f2...d9b58f23f6b3fe5635c3ec5259e6a0002cff78b7,3,1,1,2,2,2011-11-15 00:39:32,2011-10-25 21:14:18
d9b58f23f6b3fe5635c3ec5259e6a0002cff78b7...d12df0d360fe0dabdca3591654327834bee2803b,16,687,678,1365,281,2011-11-15 00:39:32,2011-10-26 05:21:21
d12df0d360fe0dabdca3591654327834bee2803b...411c1ae77eaeef1686274e9e4995641a8f83e765,2,49,13,62,3,2011-11-15 00:39:32,2011-10-27 03:54:45
411c1ae77eaeef1686274e9e4995641a8f83e765...9062996a0e6b449467f5b8ec06824086ca87f9cf,2,23,11,34,6,2011-11-15 00:39:32,2011-10-27 04:36:19
9062996a0e6b449467f5b8ec06824086ca87f9cf...4c10d33eb4340d6df30e298d63f4d37c25aab65f,3,31,54,85,6,2011-11-15 00:39:32,2011-11-01 21:27:22
4c10d33eb4340d6df30e298d63f4d37c25aab65f...c925f8a6578e05c8136c206f2fd98eeaaf1c0f16,6,412,16,428,17,2011-11-15 00:39:32,2011-10-31 22:33:52
c925f8a6578e05c8136c206f2fd98eeaaf1c0f16...ed36b9da3be338fe9eb36f3eeea901d6f51cd768,30,239,333,572,116,2011-11-15 00:39:32,2011-11-02 04:09:54
ed36b9da3be338fe9eb36f3eeea901d6f51cd768...bd04316a89a0909e7a4e483839d573ce857f7622,43,2206,2176,4382,275,2011-11-15 00:39:33,2011-11-02 23:32:46
bd04316a89a0909e7a4e483839d573ce857f7622...f684f20c9982768b6c6d2c0e0797a626c0627773,1,0,5,5,1,2011-11-15 00:39:33,2011-11-03 04:08:24
f684f20c9982768b6c6d2c0e0797a626c0627773...16597e8b52bdfe34b2239a5ab86a839fa8e980d6,9,92,69,161,65,2011-11-15 00:39:33,2011-11-03 04:37:06
16597e8b52bdfe34b2239a5ab86a839fa8e980d6...bee6060e4b2499b385465e20f7a0dc2d11f003c0,3,1,1,2,2,2011-11-15 00:39:33,2011-11-03 04:43:56
bee6060e4b2499b385465e20f7a0dc2d11f003c0...c6d2549a5255822290853aae8d922848b81bed62,2,14,12,26,6,2011-11-15 00:39:33,2011-11-03 17:28:28
c6d2549a5255822290853aae8d922848b81bed62...7c11531902986405e9443c30dd0c654f86c31ca3,9,52,45,97,19,2011-11-15 00:39:33,2011-11-03 20:53:37
7c11531902986405e9443c30dd0c654f86c31ca3...6022f3df399a5d98830dfe7904f0ad2baaa308c7,3,3,1,4,3,2011-11-15 00:39:34,2011-11-03 21:36:22
6022f3df399a5d98830dfe7904f0ad2baaa308c7...cb6f832f38b11499a6d1dd2caf14d15e68211635,9,179,178,357,64,2011-11-15 04:31:09,2011-11-03 22:59:18
cb6f832f38b11499a6d1dd2caf14d15e68211635...3972d2a89bfcfe177b12bb225302fc2937a1dbab,7,117,113,230,15,2011-11-15 04:31:13,2011-11-04 03:26:13
3972d2a89bfcfe177b12bb225302fc2937a1dbab...dd9151e522220b438074e55c72f47ed2a8da9933,11,555,527,1082,18,2011-11-15 04:31:13,2011-11-04 03:53:33
dd9151e522220b438074e55c72f47ed2a8da9933...c27aba4354c69c4a67fab587a59a8079cc9edc91,11,35,596,631,25,2011-11-15 04:31:14,2011-11-04 04:14:04
c27aba4354c69c4a67fab587a59a8079cc9edc91...a87f2fb9e4d65ac5d260e914b5e31aa0e0f47b2c,11,219,139,358,29,2011-11-15 04:31:14,2011-11-04 19:33:01
a87f2fb9e4d65ac5d260e914b5e31aa0e0f47b2c...923da410bd57481be67d3d5039245929498e94ac,157,790,473,1263,313,2011-11-15 04:31:14,2011-11-08 05:49:50
923da410bd57481be67d3d5039245929498e94ac...78c7066422a9c800e7d527a4ed588a138a326551,4,58,50,108,34,2011-11-15 04:31:14,2011-11-08 05:54:01
78c7066422a9c800e7d527a4ed588a138a326551...7cb03c5ab9376c5ce5d689f2bf1c18dc141237a1,2,4,14,18,8,2011-11-15 04:31:14,2011-11-08 05:54:40
7cb03c5ab9376c5ce5d689f2bf1c18dc141237a1...4b35a59c6afd5093ed5ce7d68b75ccadd4c53696,3,12,6,18,3,2011-11-15 04:31:14,2011-11-08 05:55:41
4b35a59c6afd5093ed5ce7d68b75ccadd4c53696...085e3c611fd0cd48757702c50c67b551a00a0d38,7,57,26,83,16,2011-11-15 04:31:15,2011-11-09 01:40:03
085e3c611fd0cd48757702c50c67b551a00a0d38...9c0639437607a4fcea379bbaf610600d05d8a9b7,19,156,225,381,70,2011-11-15 04:31:15,2011-11-09 01:40:52
9c0639437607a4fcea379bbaf610600d05d8a9b7...b3c17f3fdcf37403c5fb71f9916983a10e17c783,1,1,4,5,1,2011-11-15 04:31:15,2011-11-09 04:31:22
b3c17f3fdcf37403c5fb71f9916983a10e17c783...c283bf6035566aa8ff3178676a133de6878b5d1b,5,38,34,72,13,2011-11-15 04:31:15,2011-11-09 04:42:16
c283bf6035566aa8ff3178676a133de6878b5d1b...f0fa5e63762e80fd4ee60ff6d365fca5f886292a,28,626,205,831,139,2011-11-15 04:31:16,2011-11-10 05:18:34
f0fa5e63762e80fd4ee60ff6d365fca5f886292a...74fac45f48acd5b2fc57befd7dd7739805e330c3,10,115,64,179,28,2011-11-15 04:31:16,2011-11-10 06:02:39
74fac45f48acd5b2fc57befd7dd7739805e330c3...57c37a21d1d876dd638bca1de21d59a9e639843e,17,116,114,230,66,2011-11-15 04:31:16,2011-11-10 06:23:36
57c37a21d1d876dd638bca1de21d59a9e639843e...ea18f4548d1c5e3ce2b94525bc9da00321fb940e,1,25,18,43,14,2011-11-15 04:31:16,2011-11-10 17:54:21
ea18f4548d1c5e3ce2b94525bc9da00321fb940e...e45b013143e553c97bb89a89564c15514672e7ae,1,2,2,4,1,2011-11-15 04:31:16,2011-11-10 17:59:38
e45b013143e553c97bb89a89564c15514672e7ae...a8aa193c6b3111fa3b22c087b2adc9f66ec45386,1,77,51,128,44,2011-11-15 04:31:17,2011-11-10 19:59:54
a8aa193c6b3111fa3b22c087b2adc9f66ec45386...1cc6bee4ce5d574b84b4e0c2ded3686de7ab71ef,3,23,51,74,17,2011-11-15 04:31:17,2011-11-10 20:12:02
1cc6bee4ce5d574b84b4e0c2ded3686de7ab71ef...8fe77b69e8008c6a432f9ef226586a09deb48c6c,5,104,39,143,14,2011-11-15 04:31:17,2011-11-10 21:07:50
8fe77b69e8008c6a432f9ef226586a09deb48c6c...5279de0e70e4f7c9c9607691c34b79d8c675695a,2,30,2,32,2,2011-11-15 04:31:17,2011-11-10 19:11:43
5279de0e70e4f7c9c9607691c34b79d8c675695a...f6d98f1472338a77b2f146087bcb8560f472e5d1,2,1,4,5,4,2011-11-15 04:31:17,2011-11-10 21:31:36
f6d98f1472338a77b2f146087bcb8560f472e5d1...b09595a3c12ba761772084b94767b635c5bbfaf2,61,270,253,523,207,2011-11-15 04:31:18,2011-11-11 02:47:47
b09595a3c12ba761772084b94767b635c5bbfaf2...186a840cd34d3ffed7b351a1827e7736cd8d54c3,3,37,10,47,7,2011-11-15 04:31:18,2011-11-11 04:04:15
186a840cd34d3ffed7b351a1827e7736cd8d54c3...035c7510763a9742294d51ba55aea0b6dd08ea58,13,101,109,210,30,2011-11-15 04:31:18,2011-11-11 05:03:39
035c7510763a9742294d51ba55aea0b6dd08ea58...acbd7cdf320f0570fcc1952c8680d4c78bc8fa2c,103,569,573,1142,450,2011-11-15 04:31:19,2011-11-12 01:15:22
acbd7cdf320f0570fcc1952c8680d4c78bc8fa2c...8d6dc0b9a7b3dbff5f8edb3217b60b0cc5b66be4,7,37,94,131,15,2011-11-15 04:31:19,2011-11-12 22:57:43
8d6dc0b9a7b3dbff5f8edb3217b60b0cc5b66be4...e88dfb734a64aad4dbd402642816781b0e1725ec,16,181,178,359,68,2011-11-15 04:31:19,2011-11-12 23:23:30
e88dfb734a64aad4dbd402642816781b0e1725ec...ac73e8877e557e191f09e2f86cd3a118cc8a5d8e,1,5,0,5,1,2011-11-15 04:31:19,2011-11-14 22:32:36
ac73e8877e557e191f09e2f86cd3a118cc8a5d8e...94e1a07b28629c19c51ed41fc8181b985741ffa1,157,312,312,624,312,2011-11-15 04:31:20,2011-11-14 22:59:24
94e1a07b28629c19c51ed41fc8181b985741ffa1...955551141de88f15760e3e6e8cb8503ee34b6f6e,5,100,101,201,10,2011-11-15 04:31:21,2011-11-14 23:08:21
955551141de88f15760e3e6e8cb8503ee34b6f6e...8adae2fdf272f3fa428cc9fe43c860c02b2d85fd,7,46,70,116,22,2011-11-15 04:31:21,2011-11-14 23:58:40
8adae2fdf272f3fa428cc9fe43c860c02b2d85fd...5857c44e0cc52309251c932f9c530958dfdb616c,2,17,0,17,2,2011-11-15 19:44:36,2011-11-15 19:03:03
5857c44e0cc52309251c932f9c530958dfdb616c...aba9bb2a241f832d1b09d75e05973a985b817cc1,2,15,3,18,2,2011-11-15 19:47:23,2011-11-15 19:19:37
aba9bb2a241f832d1b09d75e05973a985b817cc1...3e1a6688c37057014707b4b90551d5444ccc3f78,2,0,0,0,0,2011-11-18 20:05:55,2011-10-28 15:32:32
3e1a6688c37057014707b4b90551d5444ccc3f78...8d1944851d5bbecd9277ede8c4a354c2d43796ee,1,1,0,1,1,2011-11-19 23:42:17,2011-11-19 23:41:21
8d1944851d5bbecd9277ede8c4a354c2d43796ee...29f9e2665d8b771a6226870fc8fd2c4c94d7a2c0,5,61,7,68,12,2011-11-21 23:43:12,2011-11-16 00:45:36
29f9e2665d8b771a6226870fc8fd2c4c94d7a2c0...3548fe31398c1287817e486577a08902cf916a61,7,251,5,256,12,2011-11-22 01:49:49,2011-11-15 19:56:13
3548fe31398c1287817e486577a08902cf916a61...a035e8839730ee19dfdabbb9c85d39ea16566f09,1,7,6,13,3,2011-11-28 23:04:01,2011-11-28 23:04:01
a035e8839730ee19dfdabbb9c85d39ea16566f09...0c8b35681e2ea9ce3ee6a188476f89be1336f1cb,3,10,0,10,5,2011-11-30 16:03:41,2011-08-03 11:53:59
0c8b35681e2ea9ce3ee6a188476f89be1336f1cb...45f47ff6cd264dcd347e6df92c9ef39b0ae8aaba,5,14,14,28,12,2011-11-30 16:03:41,2011-08-10 13:59:55
45f47ff6cd264dcd347e6df92c9ef39b0ae8aaba...e9b57f9df8eb4aaa2c1657d303c78dc68828091b,3,4,4,8,4,2011-11-30 16:03:42,2011-08-10 14:03:26
e9b57f9df8eb4aaa2c1657d303c78dc68828091b...3ae3ccf3dab95793c868d626a4560aacf3cae796,2,49,7,56,4,2011-11-30 16:03:42,2011-08-18 21:43:25
3ae3ccf3dab95793c868d626a4560aacf3cae796...5487bdb3d1c905fb9453644f7e290c75dcee14c1,2,30,3,33,7,2011-11-30 16:03:42,2011-08-18 21:48:01
5487bdb3d1c905fb9453644f7e290c75dcee14c1...497839f583ca3dd75583fb996bb764cbd6d7c4ac,4,471,0,471,4,2011-11-30 16:03:42,2011-02-17 01:04:39
497839f583ca3dd75583fb996bb764cbd6d7c4ac...59adadca086853c5de6867ae853f6f27a3af4bbe,17,1574,1093,2667,41,2011-11-30 16:12:14,2011-08-04 23:24:41
59adadca086853c5de6867ae853f6f27a3af4bbe...cd28a2e952efbc2f76ff86b6b7d21fd5e41cec65,8,944,444,1388,205,2011-11-30 16:12:14,2011-08-16 19:24:53
cd28a2e952efbc2f76ff86b6b7d21fd5e41cec65...4d2d70e7fb7875f7e8dcaade59d7447725c61ceb,3,17,14,31,10,2011-11-30 16:17:21,2011-10-18 23:35:32
4d2d70e7fb7875f7e8dcaade59d7447725c61ceb...540701a8d8d843c61192f1105b210d870099cea8,2,33,0,33,2,2011-11-30 16:17:22,2011-08-23 20:17:38
540701a8d8d843c61192f1105b210d870099cea8...5ad0c7d0e4a2aff071d3afb181fa618c982ce991,5,288,456,744,20,2011-11-30 16:17:22,2011-08-23 20:19:36
5ad0c7d0e4a2aff071d3afb181fa618c982ce991...fdcc2dbfd37d14ca5f3c830b589c091611ab54bd,2,34,37,71,25,2011-11-30 16:17:22,2011-10-18 05:52:21
fdcc2dbfd37d14ca5f3c830b589c091611ab54bd...fe633dd0cf3d52f84ce73f486bcbd4e1d3058857,2,12,1,13,2,2011-11-30 16:17:22,2011-10-19 00:03:48
fe633dd0cf3d52f84ce73f486bcbd4e1d3058857...feacf608eefa8cc64845a643f7270c9c3a16d1b8,3,141,146,287,68,2011-11-30 16:17:22,2011-10-19 17:47:17
feacf608eefa8cc64845a643f7270c9c3a16d1b8...972c3e9be0a7dc90097a0bf55c2d11a4f65ae991,2,25,47,72,13,2011-11-30 16:17:22,2011-10-27 04:16:01
972c3e9be0a7dc90097a0bf55c2d11a4f65ae991...e3e2e4436e27f69da080a5aaf06e1eb7909880cb,1,4,1,5,2,2011-11-30 16:17:22,2011-10-31 18:34:28
e3e2e4436e27f69da080a5aaf06e1eb7909880cb...a4c8ac7126aab33ac0d8296a7495475363a0ea9b,2,47,26,73,17,2011-11-30 16:17:23,2011-10-31 18:36:31
a4c8ac7126aab33ac0d8296a7495475363a0ea9b...7b705df2b77bbd5e112b976a7a9630327aa77aca,2,11,0,11,2,2011-11-30 16:17:23,2011-10-31 19:03:09
7b705df2b77bbd5e112b976a7a9630327aa77aca...afbe073121f13a23dc33a1d958c0a964029dc6ee,4,28,10,38,11,2011-11-30 16:17:23,2011-11-01 03:34:03
afbe073121f13a23dc33a1d958c0a964029dc6ee...e9f81b66316854bdd3a8548f028a64e86fc3e73c,3,11,9,20,4,2011-11-30 16:17:23,2011-11-01 20:21:00
e9f81b66316854bdd3a8548f028a64e86fc3e73c...6290bd4587d9752c3b9eabacd20c90010cc330e3,4,43,43,86,36,2011-11-30 16:17:24,2011-11-01 20:27:42
6290bd4587d9752c3b9eabacd20c90010cc330e3...4aaa2f7f6b37f0ad8255e6a320e9136a89e329de,3,14,5,19,9,2011-11-30 16:17:24,2011-11-01 20:40:51
4aaa2f7f6b37f0ad8255e6a320e9136a89e329de...9b4efa73f9eef7c22895ca269760eb11ecb54b30,2,6,4,10,3,2011-11-30 16:17:24,2011-11-03 22:17:32
9b4efa73f9eef7c22895ca269760eb11ecb54b30...caeb1bf899bfcc10b5860ad1b6632a3fe7b0b85f,2,72,8,80,5,2011-11-30 16:17:24,2011-11-04 00:14:03
caeb1bf899bfcc10b5860ad1b6632a3fe7b0b85f...5bbd64ac65a89f43ce30a948fc0e0f5442cacb1e,2,98,25,123,21,2011-11-30 16:17:25,2011-11-04 23:34:47
5bbd64ac65a89f43ce30a948fc0e0f5442cacb1e...b9707d910e8dd354a2f684588c1e7d83c5f88b8a,5,38,34,72,17,2011-11-30 16:17:25,2011-11-05 00:15:03
b9707d910e8dd354a2f684588c1e7d83c5f88b8a...92995bbce9877673f2642addd22fdf08d47bd39e,2,11,1,12,2,2011-11-30 16:17:25,2011-11-05 01:02:47
92995bbce9877673f2642addd22fdf08d47bd39e...16363d8000a484b428a16eb07d8bd0f19c4b4337,2,63,62,125,30,2011-11-30 19:49:03,2011-11-05 01:33:12
16363d8000a484b428a16eb07d8bd0f19c4b4337...1cdfa3b9601c199ec0b45096b38e26350eca744f,7,1072,3,1075,8,2011-11-30 19:49:03,2011-11-08 09:56:42
1cdfa3b9601c199ec0b45096b38e26350eca744f...b656552d68c7116ee5f7b7c217de6ce116fb3448,1,2,0,2,1,2011-11-30 19:49:35,2011-11-23 23:49:10
b656552d68c7116ee5f7b7c217de6ce116fb3448...78b6e8a446c0e38075c14b724f3cdf345c01fa06,2,189,5,194,5,2011-11-30 19:49:35,2011-11-23 23:53:06
78b6e8a446c0e38075c14b724f3cdf345c01fa06...bf8e0540f8195edbaaa3d0138bd6a26e79e1ab58,1,31,16,47,6,2011-11-30 19:49:35,2011-11-24 11:40:27
bf8e0540f8195edbaaa3d0138bd6a26e79e1ab58...dbd880cc0a9521bd5b9c96ca3f052450c3def336,7,229,417,646,80,2011-11-30 19:49:35,2011-11-24 11:53:04
dbd880cc0a9521bd5b9c96ca3f052450c3def336...188bdf7768c9594a01a18abae3fa9a3114802508,2,51,0,51,3,2011-11-30 19:49:35,2011-11-30 08:58:34
188bdf7768c9594a01a18abae3fa9a3114802508...b00da987a9e0e4378d8252add8e15ad2e508901d,2,14,8,22,3,2011-11-30 19:49:35,2011-11-29 21:54:25
b00da987a9e0e4378d8252add8e15ad2e508901d...3d0ce0ebe9ce26f54ce0527ece7a7950bc2e8368,1,1,1,2,1,2011-11-30 19:49:36,2011-11-30 00:36:43
3d0ce0ebe9ce26f54ce0527ece7a7950bc2e8368...0e1fa2aefe34fe9ba5c957efde9ae4a82df54e11,6,105,67,172,6,2011-11-30 19:49:36,2011-11-17 20:49:15
0e1fa2aefe34fe9ba5c957efde9ae4a82df54e11...f43c226c67ab64ee056615567e51f976c7637127,2,33,2,35,6,2011-11-30 19:49:36,2011-11-30 19:06:04
f43c226c67ab64ee056615567e51f976c7637127...baa7af0df099fd4bfabe1e90d275822d2558d69c,1,4,1,5,1,2011-11-30 19:49:36,2011-11-30 19:13:15
baa7af0df099fd4bfabe1e90d275822d2558d69c...1d14760c6d3eefb676f5670bc323b2a7cadcdbfa,2,54,31,85,14,2011-11-30 19:49:36,2011-11-30 19:47:28
1d14760c6d3eefb676f5670bc323b2a7cadcdbfa...44b2f44f93afe226196cb11acb03eb2fa2de04c1,3,30,17,47,16,2011-12-01 21:20:08,2011-12-01 21:20:08
44b2f44f93afe226196cb11acb03eb2fa2de04c1...bb2e7488fa7defea53e7dc3f5ab58fb4f837d2b6,2,37,1,38,2,2011-12-01 23:21:45,2011-12-01 23:21:45
bb2e7488fa7defea53e7dc3f5ab58fb4f837d2b6...2986a09c0d9385f1bc1c74255e8b66f6d71ff5dd,1,4,4,8,2,2011-12-05 22:12:00,2011-11-29 03:07:33
2986a09c0d9385f1bc1c74255e8b66f6d71ff5dd...163e05ed36deecb341092296186ef6c5cd00f426,2,530,491,1021,167,2011-12-06 07:53:26,2011-12-01 23:54:46
163e05ed36deecb341092296186ef6c5cd00f426...c9f2b1eec5e8a9eaf10faae8a8accf0b771096e0,3,19,4,23,4,2011-12-06 21:07:26,2011-11-25 03:28:09
c9f2b1eec5e8a9eaf10faae8a8accf0b771096e0...2090136dd8bf13022898e63a89a1b84245392d18,1,12,3,15,3,2011-12-06 21:07:27,2011-11-25 05:25:04
2090136dd8bf13022898e63a89a1b84245392d18...d1e7a5394ad74e0dc024a50f77fa32b46eac1be2,1,29,0,29,1,2011-12-06 21:32:49,2011-12-06 21:29:09
d1e7a5394ad74e0dc024a50f77fa32b46eac1be2...b9001e914740ea0e3bba357a33ddaf13610c874f,2,38,0,38,2,2011-12-06 21:35:05,2011-12-01 04:12:42
b9001e914740ea0e3bba357a33ddaf13610c874f...fd38655e6c8e58e7c7325b2a5937b26174ebdefa,4,17,20,37,13,2011-12-07 15:54:09,2011-12-07 15:53:57
fd38655e6c8e58e7c7325b2a5937b26174ebdefa...5e4d59adf0ba4eb7f993f66b868759c24ae94f4c,1,23,14,37,20,2011-12-07 17:41:07,2011-12-02 23:39:31
5e4d59adf0ba4eb7f993f66b868759c24ae94f4c...4e3c05b99e32dad4084637299b3a696f9579957f,2,155,1,156,3,2011-12-07 17:41:08,2011-12-03 00:38:39
4e3c05b99e32dad4084637299b3a696f9579957f...b97c6e5f7431e5aaf3a37fb70c6fb984166ff276,1,55,53,108,41,2011-12-07 17:41:09,2011-12-04 01:14:58
b97c6e5f7431e5aaf3a37fb70c6fb984166ff276...c28662d28dec613876bebacb2df994722c09f3fb,4,8,8,16,7,2011-12-07 21:07:19,2011-12-06 20:20:35
c28662d28dec613876bebacb2df994722c09f3fb...0c534644bc1908fad4e8df5754d3ec224bc7ed7e,2,9,2,11,3,2011-12-07 21:07:20,2011-11-18 19:10:04
0c534644bc1908fad4e8df5754d3ec224bc7ed7e...871252ab4c1fcb04e2da4d6c1171aee6fcb1cc84,2,2,2,4,2,2011-12-08 00:59:06,2011-12-08 00:59:06
871252ab4c1fcb04e2da4d6c1171aee6fcb1cc84...212a6ff29a2e047413a85dfe2a4ea4b71e0f0d68,1,1,1,2,1,2012-01-03 22:57:38,2011-12-28 21:02:09
212a6ff29a2e047413a85dfe2a4ea4b71e0f0d68...50eb7f15b8b9bfbf7b1aed193ce72ec9b586dc14,1,1,1,2,1,2012-01-03 23:01:34,2011-12-16 03:49:47
50eb7f15b8b9bfbf7b1aed193ce72ec9b586dc14...c594f75b4c59a5341741f012a4f2942a920bac8c,5,182,179,361,79,2012-01-03 23:09:00,2012-01-03 04:50:17
c594f75b4c59a5341741f012a4f2942a920bac8c...6f91ffeb914e3a3670d675397cbdbff5cf590edd,2,80,80,160,50,2012-01-03 23:09:00,2012-01-03 22:49:41
6f91ffeb914e3a3670d675397cbdbff5cf590edd...174952e443bc98e9df6afcdc3e0cec81412e5fd1,1,171,4,175,6,2012-01-04 01:31:23,2011-12-09 17:18:12
174952e443bc98e9df6afcdc3e0cec81412e5fd1...bb3be87606d2b390324765896624c37fa33fe63f,1,137,123,260,7,2012-01-04 01:48:09,2011-12-12 16:07:39
bb3be87606d2b390324765896624c37fa33fe63f...9632f5c1c73c2628121d49aa2d6868fc5d8aef1a,3,1,1,2,2,2012-01-04 01:48:09,2011-12-12 16:08:38
9632f5c1c73c2628121d49aa2d6868fc5d8aef1a...1dccaaaaa27a4db91d5271438688bc96e199e561,1,11,4,15,2,2012-01-06 03:54:42,2012-01-06 03:54:42
1dccaaaaa27a4db91d5271438688bc96e199e561...cd9a7b9608707c34bec2316ee8c789a617d22a7b,3,34,3,37,5,2012-01-06 20:19:39,2012-01-06 07:03:45
cd9a7b9608707c34bec2316ee8c789a617d22a7b...acb4338b7050a08a1cd1538a24108aa5a85ec6d4,1,42,17,59,41,2012-01-06 20:19:39,2012-01-06 07:11:19
acb4338b7050a08a1cd1538a24108aa5a85ec6d4...0bf611087b2773fd36cf95c938d1cda8e65ffb2b,2,87,22,109,19,2012-01-06 20:19:39,2012-01-04 20:02:39
0bf611087b2773fd36cf95c938d1cda8e65ffb2b...08029c7b72a857ffe52f302ed79ae12db9efcc08,2,9,0,9,2,2012-01-06 20:19:39,2011-12-19 02:33:25
08029c7b72a857ffe52f302ed79ae12db9efcc08...f2119c752425661e0ef4c772f14a3b6755b44525,1,1,1,2,1,2012-01-07 03:20:29,2012-01-06 04:37:20
f2119c752425661e0ef4c772f14a3b6755b44525...5c197660638b8f4f603ed087bedf88cb1c980832,2,80,4,84,6,2012-01-07 08:18:22,2012-01-07 03:19:31
5c197660638b8f4f603ed087bedf88cb1c980832...d47ec772c3d6b418121c81bbaf2dcb8a24742125,1,1,1,2,1,2012-01-08 23:06:12,2012-01-08 23:06:12
d47ec772c3d6b418121c81bbaf2dcb8a24742125...63cca9afbcf7a772086eb4582d2f409c39e0ed12,3,7,1,8,3,2012-01-09 21:17:48,2011-12-27 23:52:57
63cca9afbcf7a772086eb4582d2f409c39e0ed12...a13b5ed3bc337a493029815c595b89c39eb95af6,7,533,617,1150,150,2012-01-09 21:17:48,2011-12-28 17:26:22
a13b5ed3bc337a493029815c595b89c39eb95af6...b911e303ecad8b7b54589e26f3c551395bf47405,2,30,0,30,4,2012-01-09 21:17:48,2011-12-28 18:27:38
b911e303ecad8b7b54589e26f3c551395bf47405...23f8da7cbb59c8f53f0f5c1e48102faeb4b7fd85,2,60,17,77,16,2012-01-09 21:17:48,2012-01-04 17:21:05
23f8da7cbb59c8f53f0f5c1e48102faeb4b7fd85...67338ce06140f60fe08bf59f7eb6c9814743e907,2,166,115,281,33,2012-01-09 21:17:48,2012-01-07 02:39:03
67338ce06140f60fe08bf59f7eb6c9814743e907...b8960c3710f20a3c56ecc27f382b2500f6dc1e05,3,11,10,21,7,2012-01-09 21:17:48,2012-01-07 03:17:31
b8960c3710f20a3c56ecc27f382b2500f6dc1e05...c76a120bfea6f78d6530fa63a8129dfc40af7d86,2,4,0,4,1,2012-01-09 21:17:49,2011-12-28 18:28:37
c76a120bfea6f78d6530fa63a8129dfc40af7d86...11cb9423a7a68ea65fee09241179fa04a5cb2eec,1,2,1,3,1,2012-01-09 21:17:49,2011-12-28 22:51:35
11cb9423a7a68ea65fee09241179fa04a5cb2eec...7146f7063602b82383211533d98e78f7eb2c03db,5,14,13,27,12,2012-01-09 22:38:32,2012-01-09 18:36:51
7146f7063602b82383211533d98e78f7eb2c03db...614fd3d55a0d141067c7cd744a29787b1f93b008,1,8,0,8,1,2012-01-11 06:21:53,2012-01-06 07:03:45
614fd3d55a0d141067c7cd744a29787b1f93b008...e0b4b107ee3256847f842721c34a19fa0ba3665e,1,1,1,2,1,2012-01-11 06:21:54,2012-01-07 02:09:57
e0b4b107ee3256847f842721c34a19fa0ba3665e...3c3e6980b3584b0a63f03afaaf956dba3b8d93e0,1,0,1,1,1,2012-01-11 06:21:54,2012-01-10 17:29:13
3c3e6980b3584b0a63f03afaaf956dba3b8d93e0...afd25446d23f24872eb20ac79c8fbd2cff203ef0,4,21,10,31,10,2012-01-11 06:21:54,2012-01-10 21:46:49
afd25446d23f24872eb20ac79c8fbd2cff203ef0...5143e7bf065a3cbdf8400cf095b653d51bc83b8f,211,1051,1242,2293,531,2012-01-11 06:27:00,2012-01-07 02:10:47
5143e7bf065a3cbdf8400cf095b653d51bc83b8f...c6ea1be0536b9d4564f028554fd1762feba58994,2,17,2,19,2,2012-01-11 19:48:03,2012-01-11 07:08:30
c6ea1be0536b9d4564f028554fd1762feba58994...28114de8dcf86c69f533b924ce205533bc265786,2,108,68,176,14,2012-01-12 06:11:01,2012-01-11 19:15:00
28114de8dcf86c69f533b924ce205533bc265786...9a8dbfef5151e8e92dc010a597b670e7687ebe9b,1,26,25,51,21,2012-01-12 06:11:06,2012-01-11 22:35:02
9a8dbfef5151e8e92dc010a597b670e7687ebe9b...d648d709f3edcac56132e9e2a84a0fc65f5b48ac,34,929,667,1596,198,2012-01-12 21:40:07,2012-01-12 19:06:10
d648d709f3edcac56132e9e2a84a0fc65f5b48ac...e1e0ddb910590a0c67482f60c0bbb2abfcd5a82e,1,72,46,118,3,2012-01-13 01:10:48,2012-01-13 01:10:48
e1e0ddb910590a0c67482f60c0bbb2abfcd5a82e...5164ae545b10723b4e9ec454f436f6698dc93e24,1,0,1,1,1,2012-01-13 08:37:16,2012-01-13 01:03:51
5164ae545b10723b4e9ec454f436f6698dc93e24...249c89c0911254873c68cd753d903ea5606344ac,3,10,15,25,5,2012-01-13 09:01:26,2012-01-12 10:29:26
249c89c0911254873c68cd753d903ea5606344ac...985d3d75586a16020d78564753f9b46ec9091929,1,9,8,17,7,2012-01-13 09:05:24,2012-01-12 10:31:15
985d3d75586a16020d78564753f9b46ec9091929...15fd735793cffe89fdf9662275409cdcdb3e801a,6,41,49,90,27,2012-01-13 09:07:12,2012-01-12 11:00:34
15fd735793cffe89fdf9662275409cdcdb3e801a...e7a23e4b6585d497112935a7d00cb6906d8c8417,1,1,1,2,1,2012-01-13 09:07:17,2012-01-13 08:46:03
e7a23e4b6585d497112935a7d00cb6906d8c8417...46691c2721735c27426b721d780e8816d502b9f2,4,12,18,30,6,2012-01-13 21:53:07,2012-01-10 18:17:05
46691c2721735c27426b721d780e8816d502b9f2...d2ba4c5170f604f2610aaef1d205137e2848a791,1,3,0,3,1,2012-01-13 21:53:07,2012-01-11 03:14:22
d2ba4c5170f604f2610aaef1d205137e2848a791...939c8e8fac0487da12e56291d69c5199a8ed9a30,4,869,35,904,21,2012-01-13 22:28:20,2012-01-11 03:16:33
939c8e8fac0487da12e56291d69c5199a8ed9a30...b7f4d8c3c3c537f895d3cd7369f5b23ec94820e0,2,12,6,18,2,2012-01-13 22:28:20,2012-01-13 00:50:31
b7f4d8c3c3c537f895d3cd7369f5b23ec94820e0...16a40c626fc3da688596928afa028a596204a683,2,2,3,5,3,2012-01-13 22:28:21,2012-01-13 00:51:06
16a40c626fc3da688596928afa028a596204a683...5cdfe45aa3e50fabad44009c1b8511253c6e4915,5,67,21,88,23,2012-01-13 22:28:43,2012-01-13 22:19:10
5cdfe45aa3e50fabad44009c1b8511253c6e4915...c49b8a2db5d916a9213547125af996d6c853230c,2,41,2,43,2,2012-01-14 19:23:12,2012-01-14 00:38:08
c49b8a2db5d916a9213547125af996d6c853230c...b587091b6e6a30a2c53d577956866a1e3d1c77ea,3,20,0,20,4,2012-01-16 10:17:27,2012-01-16 07:26:06
b587091b6e6a30a2c53d577956866a1e3d1c77ea...54581d36df74ac128a078aafb3e4b66e0b1599f3,1,7,7,14,6,2012-01-17 07:26:44,2012-01-16 10:57:35
54581d36df74ac128a078aafb3e4b66e0b1599f3...92af30ce6e99676c71c85bd08962b68629564908,34,203,2399,2602,72,2012-01-17 17:49:37,2012-01-16 07:28:10
92af30ce6e99676c71c85bd08962b68629564908...897d0f1424e743b318713e2d6ee613dfaea17c5e,3,4634,4395,9029,177,2012-01-17 17:49:38,2012-01-15 09:17:45
897d0f1424e743b318713e2d6ee613dfaea17c5e...0d4def452e24b75714afcf4beb182c921e7ecd8f,1,7,0,7,1,2012-01-17 17:49:39,2012-01-17 07:40:13
0d4def452e24b75714afcf4beb182c921e7ecd8f...0356c90af83202f11015b4162fab3faa6a016458,1,1,1,2,1,2012-01-17 17:49:39,2012-01-17 07:40:46
0356c90af83202f11015b4162fab3faa6a016458...f9502d2ad3dae4eee15207b558dcdce2b2497b22,1,3,0,3,1,2012-01-17 17:49:39,2012-01-17 11:10:33
f9502d2ad3dae4eee15207b558dcdce2b2497b22...3da441b5809deec3a87f349816b7b222d6db5979,1,99,9,108,6,2012-01-17 17:49:40,2012-01-15 07:36:15
3da441b5809deec3a87f349816b7b222d6db5979...039041e3ae77afe51c0f8d9eab0ea12c9412d6f2,1,11,8,19,1,2012-01-17 19:00:25,2012-01-17 19:00:25
039041e3ae77afe51c0f8d9eab0ea12c9412d6f2...e1e7aca9a6036bfc0a4fbc7f63d0aafb533c3348,1,2,2,4,2,2012-01-17 19:21:20,2012-01-17 15:04:58
e1e7aca9a6036bfc0a4fbc7f63d0aafb533c3348...fcf95a47d102583913dca2217af6228c92c11dcf,2,2,2,4,2,2012-01-17 19:23:56,2012-01-17 19:23:56
fcf95a47d102583913dca2217af6228c92c11dcf...22309c312fbfbcc383a9daedb20d34d34d299503,2,3,1,4,3,2012-01-17 20:13:29,2012-01-17 20:13:29
22309c312fbfbcc383a9daedb20d34d34d299503...3f98d6ac990fd514065bfff04711ac97a5a2ae4d,2,15,10,25,10,2012-01-17 20:19:26,2012-01-17 20:13:48
3f98d6ac990fd514065bfff04711ac97a5a2ae4d...b00262fffe61f642ce29739387e38b0a356eb4ca,1,1,1,2,1,2012-01-17 21:54:18,2012-01-17 21:54:18
b00262fffe61f642ce29739387e38b0a356eb4ca...0ce139c42d50ea2366cbf6980629d56a42e03f9b,2,7,3,10,3,2012-01-19 01:12:21,2012-01-19 01:12:21
0ce139c42d50ea2366cbf6980629d56a42e03f9b...a507fb7bb331b5eb480ec21dae56170baf541ed1,1,1,1,2,1,2012-01-19 01:16:27,2012-01-18 05:20:30
a507fb7bb331b5eb480ec21dae56170baf541ed1...afc241bd286f4e25852de3b0a54462ef85874263,1,1,1,2,1,2012-01-19 08:27:32,2012-01-19 08:27:32
afc241bd286f4e25852de3b0a54462ef85874263...7046d6053de5e409042f45cda7b121da3513f4e6,3,1,1,2,1,2012-01-19 18:38:26,2011-12-17 08:59:24
7046d6053de5e409042f45cda7b121da3513f4e6...efe33a5e2196efb45596fb64daaec16dfe1da613,1,26,18,44,10,2012-01-19 20:39:05,2012-01-19 20:39:05
efe33a5e2196efb45596fb64daaec16dfe1da613...0470ff04b4e04d2ed26c8f1a6984bbb98cc50739,1,2,1,3,1,2012-01-19 23:47:55,2012-01-19 23:47:36
0470ff04b4e04d2ed26c8f1a6984bbb98cc50739...f5343c9fd3c7cd0fefdb4d71d2b579dbae998d6a,1,1,1,2,1,2012-01-22 08:30:39,2012-01-22 00:32:30
f5343c9fd3c7cd0fefdb4d71d2b579dbae998d6a...992c790f0786fa45c1cc3710f29bf49c7c322ba7,34,477,516,993,196,2012-01-23 19:05:36,2011-11-30 05:51:59
992c790f0786fa45c1cc3710f29bf49c7c322ba7...0196411dbe179afe24f4faa6d6503ff3f69472da,14,61,47,108,40,2012-01-23 19:11:27,2011-11-30 20:23:58
0196411dbe179afe24f4faa6d6503ff3f69472da...dbffbefb7cd7af2ac063c95378a035aa9fbbd2ff,7,74,8,82,10,2012-01-23 21:11:12,2012-01-20 22:04:53
dbffbefb7cd7af2ac063c95378a035aa9fbbd2ff...ed78f0d830b22eb8f280e841cde6287b678fc914,2,41,0,41,2,2012-01-24 06:33:28,2011-12-15 09:10:09
ed78f0d830b22eb8f280e841cde6287b678fc914...7da2bdb82a72dffc8c72c1becf6f62aae52d32ce,2,37,18,55,6,2012-01-24 06:33:28,2012-01-21 08:01:44
7da2bdb82a72dffc8c72c1becf6f62aae52d32ce...b2052d08a151e81ed01b76a3b73add6e799c8133,1,1,1,2,1,2012-01-24 06:33:28,2012-01-21 08:02:22
b2052d08a151e81ed01b76a3b73add6e799c8133...56bcc04c54ed24c19204f68de52b8c30c00e08f0,2,28,1,29,4,2012-01-24 18:28:29,2012-01-20 03:39:32
56bcc04c54ed24c19204f68de52b8c30c00e08f0...135471836506c23eb6a3d8bd0ff09ae9d0a6cead,1,1,1,2,1,2012-01-25 19:46:34,2012-01-18 21:49:38
135471836506c23eb6a3d8bd0ff09ae9d0a6cead...517811764d3a37806f3e5c4f0c6ca6527e2c189c,1,1,1,2,1,2012-01-25 19:46:34,2011-12-14 09:37:12
517811764d3a37806f3e5c4f0c6ca6527e2c189c...84823b2eff21060c0883f6b4da5573380381c1a2,4,34,14,48,9,2012-01-25 19:46:34,2011-12-14 08:28:16
84823b2eff21060c0883f6b4da5573380381c1a2...97dae0d0a0226ee527771578bfad1342d51bf4dd,2,15,0,15,3,2012-01-25 19:46:35,2011-12-14 08:28:35
97dae0d0a0226ee527771578bfad1342d51bf4dd...1e96d0af8cd235db94c937acd849cd6061df3e87,2,15,11,26,5,2012-01-25 19:46:35,2011-12-16 20:45:20
1e96d0af8cd235db94c937acd849cd6061df3e87...81a6601e05a67fda9082d7d63a4031bb31c8deca,1,4,4,8,1,2012-01-25 19:46:35,2011-12-23 21:23:44
81a6601e05a67fda9082d7d63a4031bb31c8deca...1e258d11d08a5fd185c5299a0e3d5ff9ba0634f0,1,4,0,4,1,2012-01-25 19:46:35,2011-12-20 08:58:26
1e258d11d08a5fd185c5299a0e3d5ff9ba0634f0...0f6b2ef9823953533dd98849fc29c08e6a05c4a4,2,97,1,98,3,2012-01-25 19:46:35,2011-11-21 22:09:52
0f6b2ef9823953533dd98849fc29c08e6a05c4a4...5001c1a1217772d2bffe108bafd475b24badf559,3,226,157,383,12,2012-01-25 19:46:36,2011-12-08 05:01:19
5001c1a1217772d2bffe108bafd475b24badf559...8af4fde18246ac1587b471a549e70d5d858bf0ee,10,2001,554,2555,80,2012-01-25 19:46:36,2011-11-29 20:11:32
8af4fde18246ac1587b471a549e70d5d858bf0ee...9ee2cdff44e7d496774b340de816344126c457b3,36,1558,1734,3292,443,2012-01-25 19:50:37,2011-11-23 05:28:39
9ee2cdff44e7d496774b340de816344126c457b3...e2b1d9e994e50bcd01d237302a3357bc7ebb6fa5,3,31,0,31,3,2012-01-25 19:50:37,2012-01-25 06:42:33
e2b1d9e994e50bcd01d237302a3357bc7ebb6fa5...4804c83b7db5770d5d02eea9eea4cc012b4aa524,50,866,792,1658,149,2012-01-25 19:53:59,2011-12-14 01:55:31
4804c83b7db5770d5d02eea9eea4cc012b4aa524...1268fc1a44e1359f670a586e6cbc6774736f0a2d,2,2,3,5,2,2012-01-25 19:54:00,2012-01-24 22:54:27
1268fc1a44e1359f670a586e6cbc6774736f0a2d...39b3297fc34b6b15bb3487f619ad1e93c4480741,5,72,17,89,20,2012-01-26 00:17:43,2012-01-24 10:33:35
39b3297fc34b6b15bb3487f619ad1e93c4480741...18a1e860a3d50b04d7c0836ba7c6c0a0b96335be,1,2,19,21,4,2012-01-26 00:17:44,2012-01-24 10:40:25
18a1e860a3d50b04d7c0836ba7c6c0a0b96335be...8b32900d72313fd0e5b81068103d0a853f033d2a,1,2,13,15,3,2012-01-26 00:52:39,2012-01-24 10:42:20
8b32900d72313fd0e5b81068103d0a853f033d2a...b6f61a89cf36a41198fecebbfb617c47217e9a64,1,2,2,4,2,2012-01-26 17:13:08,2012-01-26 17:13:08
b6f61a89cf36a41198fecebbfb617c47217e9a64...58d6da556a89d4d576a40164765dc42dbbfa4aad,1,1,3,4,1,2012-01-30 05:59:35,2012-01-30 05:59:35
58d6da556a89d4d576a40164765dc42dbbfa4aad...6c4f1391bc10ebfd76bb39d3cb7f7b3b3bff4dd5,1,2,2,4,2,2012-01-30 19:44:19,2012-01-30 19:44:19
6c4f1391bc10ebfd76bb39d3cb7f7b3b3bff4dd5...3173d8603db4ae1c2373e13a7a490988126bb1e7,1,7,0,7,1,2012-02-05 08:09:02,2012-02-05 08:09:02
3173d8603db4ae1c2373e13a7a490988126bb1e7...776739299b698a965ef818eeda75d4eddd10c491,2,32,6,38,4,2012-02-09 00:12:11,2012-02-09 00:12:11
776739299b698a965ef818eeda75d4eddd10c491...eb92735c9ea3e5ddc747b66d8e895b6187a5f9e0,2,10,1,11,2,2012-02-16 22:32:52,2012-02-16 22:32:52
eb92735c9ea3e5ddc747b66d8e895b6187a5f9e0...6e635012fb30905e5fe659a024864e275f1c14b5,2,28,3,31,7,2012-02-21 18:58:48,2012-02-17 06:22:06
6e635012fb30905e5fe659a024864e275f1c14b5...292a5dae072ecd4edf3f01def71dd83b88dfe2d4,2,20,1,21,2,2012-02-22 06:45:58,2012-02-09 19:12:39
292a5dae072ecd4edf3f01def71dd83b88dfe2d4...22c1db17444e09bcf13b0f24f4f805a65d8a3be0,2,28,10,38,4,2012-02-22 06:45:58,2012-02-14 05:59:10
22c1db17444e09bcf13b0f24f4f805a65d8a3be0...13b21aaf5ac7267288fd94a50ece9a1f1ec2e379,1,6,6,12,6,2012-02-22 06:45:59,2012-02-03 17:51:29
13b21aaf5ac7267288fd94a50ece9a1f1ec2e379...85b2084f578652cc0dcba46c689683fc550554fe,2,25,3,28,6,2012-02-22 06:45:59,2012-02-03 18:34:16
85b2084f578652cc0dcba46c689683fc550554fe...cae9ad4ba9c31dfa9e1aa2acc945dfc8242d1c72,1,20,0,20,1,2012-02-22 06:45:59,2012-02-14 01:03:19
cae9ad4ba9c31dfa9e1aa2acc945dfc8242d1c72...c8ee631c1999fc87c0002bb27bd411fb953a726f,2,116,40,156,8,2012-02-22 06:45:59,2012-02-11 05:16:50
c8ee631c1999fc87c0002bb27bd411fb953a726f...761b2ed85ad9685c35f85513e17363abf17ce6b3,2,88,65,153,32,2012-02-22 06:45:59,2012-02-07 05:56:05
761b2ed85ad9685c35f85513e17363abf17ce6b3...6216dc046510204bafd159dba17ce0cc22db6c08,1,13,13,26,8,2012-02-22 06:45:59,2012-02-22 05:59:16
6216dc046510204bafd159dba17ce0cc22db6c08...1752c8c44a7058e974ef208e583683eac8817789,3,22,47,69,14,2012-02-22 06:46:00,2012-02-07 05:56:35
1752c8c44a7058e974ef208e583683eac8817789...4a051efb89cf33e30d56f1227d1f6084ead4cd42,4,45,0,45,4,2012-02-22 06:46:00,2012-02-04 00:20:24
4a051efb89cf33e30d56f1227d1f6084ead4cd42...cb10ccc44fa78b82c80afa1cb5dac2c34fdf24b7,3,11,7,18,11,2012-02-22 06:46:00,2012-02-11 05:35:02
cb10ccc44fa78b82c80afa1cb5dac2c34fdf24b7...78656fe0dfc99c341ce02d71e7006e9c05b1fe3f,13,838,107,945,83,2012-02-22 06:46:00,2012-01-28 00:18:16
78656fe0dfc99c341ce02d71e7006e9c05b1fe3f...3773323e464bf45eed8cc70082ab369507d4e14d,1,223,38,261,29,2012-02-22 06:46:01,2012-02-09 17:55:07
3773323e464bf45eed8cc70082ab369507d4e14d...7bd69d0f5b1dd9aa04ac19393991566785ec81c2,3,54,59,113,12,2012-02-22 06:46:01,2012-02-09 22:39:44
7bd69d0f5b1dd9aa04ac19393991566785ec81c2...3df7b8e57f125160738a811e97ca7819a78c48ff,3,124,128,252,27,2012-02-22 06:46:01,2012-02-10 00:35:23
3df7b8e57f125160738a811e97ca7819a78c48ff...6d0ca95fa05ea6c7bcaef5c1d5a03fa67a6b6d0c,2,129,33,162,10,2012-02-22 06:46:01,2012-02-15 19:34:56
6d0ca95fa05ea6c7bcaef5c1d5a03fa67a6b6d0c...656a495e503bc0a5a8e1b2da0169e6d2bf0f31f1,1,6,6,12,4,2012-02-22 06:46:01,2012-02-22 01:05:43
656a495e503bc0a5a8e1b2da0169e6d2bf0f31f1...dd321c5f4d0d238717a2bab50a28eeed83b22d5f,1,3,0,3,3,2012-02-22 18:24:40,2012-02-22 18:24:40
dd321c5f4d0d238717a2bab50a28eeed83b22d5f...fa69d10122458fb92b311ca5e30a5804c03c0778,2,3,2,5,2,2012-02-22 19:09:33,2012-02-22 19:09:33
fa69d10122458fb92b311ca5e30a5804c03c0778...fbcb7fdd141c277d326dc3ed34545210c4d5628f,2,27,1,28,4,2012-02-22 19:32:09,2012-02-22 19:31:49
fbcb7fdd141c277d326dc3ed34545210c4d5628f...c27a56f4da9bf89e471ac6597c135e2f19814f17,5,45,3,48,12,2012-02-22 20:59:23,2012-02-22 20:59:23
c27a56f4da9bf89e471ac6597c135e2f19814f17...80edcadb1dd418dcf5adf85704c6693940c8bb28,4,63,4,67,11,2012-02-22 21:28:42,2012-02-22 21:28:42
80edcadb1dd418dcf5adf85704c6693940c8bb28...5d8528cc2e1092cdd9533f8c9f0d716200e88b7e,1,258,0,258,1,2012-02-23 17:53:14,2012-02-23 17:53:14
5d8528cc2e1092cdd9533f8c9f0d716200e88b7e...ffa84418862a9f768ce5b9b681916438f14a0d79,2,9,0,9,2,2012-02-23 21:57:28,2012-02-23 21:57:28
ffa84418862a9f768ce5b9b681916438f14a0d79...d6e3e1baabc3acc930e4fda387b62cbd03e64577,3,46,26,72,15,2012-02-23 23:01:08,2012-02-23 23:01:08
d6e3e1baabc3acc930e4fda387b62cbd03e64577...3171f215910255938c179d8243480fbaeebc77cf,2,12,0,12,2,2012-02-24 06:50:02,2012-02-24 06:50:02
3171f215910255938c179d8243480fbaeebc77cf...230f29d0a78a04a6963514da8b1e34cc03e553d0,1,13,4,17,3,2012-02-24 07:41:41,2012-02-24 07:41:41
230f29d0a78a04a6963514da8b1e34cc03e553d0...5b0d0683584e304db30462f3448d9f090120c444,3,25,1,26,3,2012-02-26 02:49:54,2012-02-26 02:49:54
5b0d0683584e304db30462f3448d9f090120c444...d1558d7924dec1156784f3b4576880f72213f671,1,1,1,2,1,2012-02-28 22:15:39,2012-02-28 19:48:18
d1558d7924dec1156784f3b4576880f72213f671...4c1c50fd9bfafaa89cdc66dfde818a3f8f4b0c6b,2,19,0,19,2,2012-02-28 22:15:44,2012-02-28 19:51:14
4c1c50fd9bfafaa89cdc66dfde818a3f8f4b0c6b...b37e8a2b141761d3211b52b8b6802c49c92d44f8,1,26,0,26,1,2012-02-28 22:15:44,2012-02-28 20:00:32
b37e8a2b141761d3211b52b8b6802c49c92d44f8...d656d11489a0dbce0f549b20006052b215c4b500,3,31,0,31,3,2012-02-29 01:41:30,2012-02-28 22:43:37
d656d11489a0dbce0f549b20006052b215c4b500...e23fa768aaf6d1d966c335979fe8316330c2fe28,1,1,1,2,1,2012-02-29 01:41:37,2012-02-29 01:41:37
e23fa768aaf6d1d966c335979fe8316330c2fe28...21c725f1a12d1de758cab6e4c4fafc5c420eb565,18,2233,2109,4342,379,2012-02-29 01:46:58,2012-02-16 01:16:02
21c725f1a12d1de758cab6e4c4fafc5c420eb565...f6fb31e8ada50b32719fcb120ca2e1fcbac8d992,1,26,31,57,6,2012-02-29 01:46:58,2012-02-15 22:32:10
f6fb31e8ada50b32719fcb120ca2e1fcbac8d992...ef7346ff70c745178d5c615e6ae5e559a4549f32,1,1,0,1,1,2012-02-29 01:46:58,2012-02-16 05:04:49
ef7346ff70c745178d5c615e6ae5e559a4549f32...f16bd2f747ed94547eabdc4c337775a22a365255,4,592,498,1090,138,2012-02-29 01:46:58,2012-02-15 23:45:07
f16bd2f747ed94547eabdc4c337775a22a365255...e31d1c287d972d633bdaf9c385d3012192f64918,6,67,45,112,19,2012-02-29 01:46:58,2012-02-16 05:49:07
e31d1c287d972d633bdaf9c385d3012192f64918...9486590e1be7282bb0e87586a35ca0bee6c64ee0,4,267,205,472,57,2012-02-29 01:46:58,2012-02-19 20:31:11
9486590e1be7282bb0e87586a35ca0bee6c64ee0...60743fc52aea9eabee58258a31f4ba465013cb4e,5,49,5,54,9,2012-02-29 01:48:07,2012-02-19 20:59:10
60743fc52aea9eabee58258a31f4ba465013cb4e...139e1b09a94f60b351cc961d8bfd882c0b8ba594,10,780,607,1387,59,2012-02-29 02:22:35,2012-02-24 03:47:58
139e1b09a94f60b351cc961d8bfd882c0b8ba594...c4c60c25b494afe282dd1a86a030fbc2c63639aa,4,9,9,18,9,2012-02-29 02:22:41,2012-02-24 19:45:34
c4c60c25b494afe282dd1a86a030fbc2c63639aa...e7d610681114d278b2127757c1d1a65981bc4dc1,2,11,1,12,2,2012-02-29 02:22:41,2012-02-26 06:38:18
e7d610681114d278b2127757c1d1a65981bc4dc1...4e83399570391fe4a41ce4dc27c8a191f761d26d,2,19,11,30,5,2012-02-29 02:22:41,2012-02-27 22:49:36
4e83399570391fe4a41ce4dc27c8a191f761d26d...4370d756e4e758f0e95e83390f7555cb9f48e6fe,6,52,51,103,49,2012-02-29 02:22:41,2012-02-28 00:28:12
4370d756e4e758f0e95e83390f7555cb9f48e6fe...25d207c48c648bcf09ebdf09f39277850017c228,1,4,4,8,4,2012-02-29 23:46:55,2012-02-13 11:18:03
25d207c48c648bcf09ebdf09f39277850017c228...e68c02c5372a7234cff4113b17ba9b0d30d9321a,1,5,5,10,2,2012-02-29 23:48:37,2012-02-13 11:19:10
e68c02c5372a7234cff4113b17ba9b0d30d9321a...e86bafecd212789cde61050073a69c1e49ffd011,1,1,1,2,1,2012-02-29 23:53:51,2012-02-06 03:07:09
e86bafecd212789cde61050073a69c1e49ffd011...bbd3a3fd76a3b1f410e0304d5455fc22864796b4,1,4,4,8,3,2012-03-05 17:59:29,2012-03-05 17:59:29
bbd3a3fd76a3b1f410e0304d5455fc22864796b4...4f797fe5f38cab06d1bb9c946cd39ce31aaa2483,1,1,1,2,1,2012-03-05 18:41:51,2012-03-04 08:53:02
4f797fe5f38cab06d1bb9c946cd39ce31aaa2483...c2989f6cc6ea8be34101b9ab9bc25d14a2468e20,2,56,40,96,7,2012-03-05 18:41:59,2012-03-04 08:53:45
c2989f6cc6ea8be34101b9ab9bc25d14a2468e20...1084ccf7ef8d087e77f2d7197222ab7904fd3fb7,1,6,1,7,1,2012-03-06 03:09:43,2012-02-29 22:55:38
1084ccf7ef8d087e77f2d7197222ab7904fd3fb7...b49ddf9848952a95032e9962796ec3a6e50857de,2,182,129,311,15,2012-03-06 03:15:18,2012-02-29 22:56:29
b49ddf9848952a95032e9962796ec3a6e50857de...64912069caeb5a05da449b6ee04c965477f3ae25,1,15,14,29,7,2012-03-06 03:28:03,2012-03-06 03:28:03
64912069caeb5a05da449b6ee04c965477f3ae25...6aa3cfc31b14bfe74d89030fb6c2d615e44f2845,1,21,1,22,2,2012-03-07 22:04:14,2012-03-07 22:04:14
6aa3cfc31b14bfe74d89030fb6c2d615e44f2845...6a98c52c847ecc620118f3ccfdd66c3956c0fb01,13,308,240,548,108,2012-03-08 18:07:49,2012-03-08 06:47:01
6a98c52c847ecc620118f3ccfdd66c3956c0fb01...e0ace15cd325b28f5c9a2a6f8e040dfd2701b1f4,2,26,2,28,3,2012-03-08 19:01:22,2012-03-05 22:52:34
e0ace15cd325b28f5c9a2a6f8e040dfd2701b1f4...2acd60df4dcc1550b5756559d98a8b03815973d6,1,2,0,2,1,2012-03-08 19:06:14,2012-03-06 22:14:21
2acd60df4dcc1550b5756559d98a8b03815973d6...08ad4b6a46b714008ff779728a73a168b62510ce,1,1,0,1,1,2012-03-08 19:06:14,2012-03-06 22:14:59
08ad4b6a46b714008ff779728a73a168b62510ce...af21233820ea48a093deb6f3e17fc4971701a741,1,2,1,3,1,2012-03-08 19:06:14,2012-03-06 22:15:41
af21233820ea48a093deb6f3e17fc4971701a741...1b4289ce769e1c32cde6e5b246c1a176b9ecf491,1,6,1,7,1,2012-03-08 19:06:14,2012-03-06 22:16:17
1b4289ce769e1c32cde6e5b246c1a176b9ecf491...7f6c1093f5691bee2fbddca63879d1660620bf2e,1,9,3,12,2,2012-03-08 19:06:14,2012-03-06 22:26:43
7f6c1093f5691bee2fbddca63879d1660620bf2e...772ddb983b06058ecfae46700641927183820a36,5,56,26,82,23,2012-03-08 19:06:14,2012-03-08 00:17:23
772ddb983b06058ecfae46700641927183820a36...ee7209fe2676f836ef39ff77e3aa5c46572e817b,1,4,3,7,3,2012-03-08 19:06:15,2012-03-08 00:18:41
ee7209fe2676f836ef39ff77e3aa5c46572e817b...512db03cc003c590a9dcd2b1ee1f3fb2cbad1b78,1,2,11,13,3,2012-03-08 19:06:15,2012-03-08 00:54:12
512db03cc003c590a9dcd2b1ee1f3fb2cbad1b78...b348347dadfa0abe3442ff0bdbc52d8077621e95,2,5,13,18,3,2012-03-08 19:38:14,2012-03-07 20:17:48
b348347dadfa0abe3442ff0bdbc52d8077621e95...b3750103cc2c696b4ecadd7eebc55a76fd528bce,2,35,20,55,6,2012-03-08 19:39:03,2012-03-08 01:07:25
b3750103cc2c696b4ecadd7eebc55a76fd528bce...dd7b0f56fcd9785f7fccae8c4f088a8f3e7b125e,2,17,2,19,3,2012-03-09 00:30:39,2012-03-09 00:11:32
dd7b0f56fcd9785f7fccae8c4f088a8f3e7b125e...f54db2ccda399f2677e4ca7588018cb31545a2b4,51,3951,3818,7769,60,2012-03-09 06:29:34,2012-03-08 23:00:38
f54db2ccda399f2677e4ca7588018cb31545a2b4...5d09a1efd3ff98fc2fbba2f8f64230704f4a5e96,5,34,23,57,14,2012-03-09 06:29:35,2012-03-08 23:42:35
5d09a1efd3ff98fc2fbba2f8f64230704f4a5e96...8fb34f008eca4d1e15e6fa63902aaa36d199c4af,2,8,26,34,9,2012-03-09 06:29:35,2012-03-09 00:19:56
8fb34f008eca4d1e15e6fa63902aaa36d199c4af...fae84463e45f18eabdabc4c1c7378e23ad35842c,1,0,1,1,1,2012-03-09 06:29:35,2012-03-09 01:06:38
fae84463e45f18eabdabc4c1c7378e23ad35842c...e0c9551fd7c716d9d71ed6f4f1d2f5911f53032c,3,21,34,55,12,2012-03-09 18:10:28,2012-03-08 23:03:24
e0c9551fd7c716d9d71ed6f4f1d2f5911f53032c...00d4427388eeec81d434f9ee96bb7ccc70190923,9,31,31,62,28,2012-03-09 18:10:28,2012-03-08 23:59:32
00d4427388eeec81d434f9ee96bb7ccc70190923...0bfaa579c04d1b7cd21fbe16bfbc47a684f223b3,4,69,3,72,10,2012-03-09 18:10:29,2012-03-09 00:53:15
0bfaa579c04d1b7cd21fbe16bfbc47a684f223b3...f4d338d393dabb49182d40b4fe90c4d1b51621c0,65,766,764,1530,593,2012-03-10 00:14:26,2012-03-09 08:00:05
f4d338d393dabb49182d40b4fe90c4d1b51621c0...53aacb35fa469496c88a04a70ffab875e8b35d86,1,0,16,16,1,2012-03-10 00:14:26,2012-03-09 22:48:42
53aacb35fa469496c88a04a70ffab875e8b35d86...4a94bb9b345946a9efd51adaeedc0f907af4df49,2,3,2,5,2,2012-03-10 00:27:12,2012-03-09 22:49:40
4a94bb9b345946a9efd51adaeedc0f907af4df49...e0cc84ad7b7cdeb22cc56a75ab0775b90791da06,8,26,26,52,24,2012-03-10 00:27:12,2012-03-09 23:18:57
e0cc84ad7b7cdeb22cc56a75ab0775b90791da06...83314913e717f18cdb9a817e67c24651930ebe7e,3,13,13,26,13,2012-03-10 01:33:22,2012-03-10 00:58:48
83314913e717f18cdb9a817e67c24651930ebe7e...716dd5f3f90f853713706aa3b404822fef18ef93,4,32,77,109,12,2012-03-10 01:33:22,2012-03-10 01:19:48
716dd5f3f90f853713706aa3b404822fef18ef93...488a03631eb69794fd158f3f0df34d936084aec4,2,24,6,30,7,2012-03-12 04:31:34,2012-03-09 23:19:24
488a03631eb69794fd158f3f0df34d936084aec4...3e5377f4f3b1d0f06af50e21026835bee0556b4a,12,249,60,309,29,2012-03-12 04:31:35,2012-03-09 23:12:48
3e5377f4f3b1d0f06af50e21026835bee0556b4a...cce31d4c93978a9b2ed3bddb5f16e22fa0d07f5b,2,3,3,6,3,2012-03-12 05:36:29,2012-03-12 05:36:29
cce31d4c93978a9b2ed3bddb5f16e22fa0d07f5b...1b9277bf6f16f714bba418dd5a7bf719206fe4d6,2,30,7,37,8,2012-03-12 08:40:12,2012-03-12 08:24:43
1b9277bf6f16f714bba418dd5a7bf719206fe4d6...317adb36a480c60f41b6f69bc67d66fe1b08bdae,2,290,550,840,42,2012-03-12 08:40:12,2012-03-12 08:25:05
317adb36a480c60f41b6f69bc67d66fe1b08bdae...48096048cf92bcada9b8c4f54d7002fbcf239416,2,31,10,41,9,2012-03-13 04:59:50,2012-03-12 23:49:28
48096048cf92bcada9b8c4f54d7002fbcf239416...a9ed5745a0e83fb8ac11636d5272fc6e632e6247,1,16,7,23,5,2012-03-13 06:04:10,2012-03-12 15:11:40
a9ed5745a0e83fb8ac11636d5272fc6e632e6247...5e3db61b1de79aae9cdec41173d930eb93c410dd,1,278,3,281,2,2012-03-13 06:04:11,2012-03-11 22:32:51
5e3db61b1de79aae9cdec41173d930eb93c410dd...4e6b065a2f24745ff9691914363ff49a94abb92f,1,15,2,17,2,2012-03-13 06:04:11,2012-03-12 16:38:49
4e6b065a2f24745ff9691914363ff49a94abb92f...9134f5ce5a402bb76ba9bc5627ade282552898fe,1,6,6,12,6,2012-03-13 06:04:11,2012-03-12 16:39:21
9134f5ce5a402bb76ba9bc5627ade282552898fe...5e6ba2520174218d26defbe9488a1073da882072,4,192,119,311,80,2012-03-13 06:04:11,2012-03-12 22:54:48
5e6ba2520174218d26defbe9488a1073da882072...f59e4b11f11261c234a821db67088f0de88a2852,8,345,345,690,211,2012-03-13 06:04:11,2012-03-13 04:12:15
f59e4b11f11261c234a821db67088f0de88a2852...afe617a647211bbb2173bb0dd4c4c6d44c11a407,8,31,38,69,28,2012-03-13 06:04:12,2012-03-13 04:30:03
afe617a647211bbb2173bb0dd4c4c6d44c11a407...a29c2cf70cb19f9fb4be2b62e7acd4054751ac51,1,72,82,154,30,2012-03-13 20:36:28,2012-03-13 01:23:35
a29c2cf70cb19f9fb4be2b62e7acd4054751ac51...63be222326f3badbb76371f82d49fed5ab9e3e65,8,70,70,140,35,2012-03-13 20:52:57,2012-03-13 20:52:57
63be222326f3badbb76371f82d49fed5ab9e3e65...ac5151a469667b1cc1b5e2f96d330b71631efd0b,5,14,19,33,9,2012-03-13 21:13:53,2012-03-13 06:40:19
ac5151a469667b1cc1b5e2f96d330b71631efd0b...9277d12fc0052efacbeed7cf9aaeea608e5f6108,5,107,107,214,89,2012-03-13 21:13:53,2012-03-13 07:29:10
9277d12fc0052efacbeed7cf9aaeea608e5f6108...b6ae6e52f99c0c3c45ad787328a2e800ff07ca2c,2,4,9,13,3,2012-03-13 21:13:53,2012-03-13 17:02:56
b6ae6e52f99c0c3c45ad787328a2e800ff07ca2c...089c0f8b0e64f00e2629de07f35af03f01c34686,2,119,83,202,13,2012-03-13 23:05:52,2012-03-13 21:09:31
089c0f8b0e64f00e2629de07f35af03f01c34686...4806d28a29ae5c3f83d8f97c11e692ca2313c9ab,3,39,35,74,24,2012-03-13 23:05:52,2012-03-13 21:56:52
4806d28a29ae5c3f83d8f97c11e692ca2313c9ab...66e6c1ce2c4669076916872c3142159ae46e0a9a,1,10,9,19,7,2012-03-13 23:18:14,2012-03-13 22:55:22
66e6c1ce2c4669076916872c3142159ae46e0a9a...027801a00accbacefcb8fed059d09340ac5403ec,1,5,6,11,6,2012-03-13 23:32:15,2012-03-13 20:14:37
027801a00accbacefcb8fed059d09340ac5403ec...d34f3bc7a61056a1f4aebb49d2475414fa16d5e4,4,116,60,176,47,2012-03-13 23:57:36,2012-03-13 20:17:39
d34f3bc7a61056a1f4aebb49d2475414fa16d5e4...31cd5803102ba93f8b93cd5304aea4ade50f96ab,2,5,3,8,5,2012-03-13 23:58:36,2012-03-13 20:49:05
31cd5803102ba93f8b93cd5304aea4ade50f96ab...de9464c1431906883bdf180fb00615e6fa371577,4,39,30,69,13,2012-03-13 23:59:03,2012-03-13 21:42:26
de9464c1431906883bdf180fb00615e6fa371577...e9e3ee012b50f868f4cd68f3571560680998a19b,3,34,31,65,7,2012-03-13 23:59:10,2012-03-13 23:14:58
e9e3ee012b50f868f4cd68f3571560680998a19b...7b52586f7c139ea5dfe694f9667bad673d7ca5f1,1,51,12,63,7,2012-03-14 00:14:50,2012-03-13 21:23:38
7b52586f7c139ea5dfe694f9667bad673d7ca5f1...13f31602f396bc269076ab4d389cfd8ca94b20ba,2,29,2,31,4,2012-03-14 00:51:05,2012-03-13 05:56:36
13f31602f396bc269076ab4d389cfd8ca94b20ba...ce4b630524fe15185ea248ed2344549632c446ff,1,1,1,2,2,2012-03-14 00:51:05,2012-03-14 00:50:38
ce4b630524fe15185ea248ed2344549632c446ff...8b8fdddc0b13f90dcc081b7d29a79f1452f2dd7b,26,127,138,265,89,2012-03-14 02:36:09,2012-03-14 02:36:09
8b8fdddc0b13f90dcc081b7d29a79f1452f2dd7b...716b5fd3e24e11986ded2cc381b9fbb77971a1e2,10,34,32,66,18,2012-03-14 06:17:43,2012-03-14 06:00:30
716b5fd3e24e11986ded2cc381b9fbb77971a1e2...c70ead0aa151c2b769edd51415262e8843d642aa,1,1,1,2,1,2012-03-14 06:24:17,2012-03-14 06:24:17
c70ead0aa151c2b769edd51415262e8843d642aa...25cd774abf4e704fc697efda61666dcc9e3dd8dd,2,2,5,7,3,2012-03-14 08:00:46,2012-03-14 06:25:17
25cd774abf4e704fc697efda61666dcc9e3dd8dd...02091b2c1ec68cfc5b4b88295575cfdfce71fad5,1,2,2,4,2,2012-03-14 17:13:03,2012-03-14 10:28:59
02091b2c1ec68cfc5b4b88295575cfdfce71fad5...8fd1b748721a6312c9d4340744a012143e4d5ef2,1,2,2,4,1,2012-03-14 20:45:44,2012-03-14 20:43:59
8fd1b748721a6312c9d4340744a012143e4d5ef2...2315d9b3610994b36c44e4a97fb1427d59471ce8,2,36,4,40,6,2012-03-14 21:33:20,2012-03-14 20:03:53
2315d9b3610994b36c44e4a97fb1427d59471ce8...6abafcb4248f0a4374b3df0b67bf82b3c32194f3,1,2,2,4,2,2012-03-15 17:19:44,2012-03-15 17:19:44
6abafcb4248f0a4374b3df0b67bf82b3c32194f3...252d4548f981e18f496877f0f1a30a6c05c8600f,1,1,1,2,1,2012-03-15 22:23:49,2012-03-15 22:23:49
252d4548f981e18f496877f0f1a30a6c05c8600f...9b1aff905b638aa274a5fc8f88662df446d374bd,2,14,1,15,4,2012-03-16 16:41:05,2012-03-16 16:41:00
9b1aff905b638aa274a5fc8f88662df446d374bd...bca96e7c7cc723a091241fddd6845d6de262a3c9,1,2,10,12,2,2012-03-16 17:52:40,2012-03-16 17:52:20
bca96e7c7cc723a091241fddd6845d6de262a3c9...f13dd3393dfb7a33565c9360342c193bc0bddcb6,3,105,2,107,4,2012-03-16 17:52:40,2012-03-16 17:48:59
f13dd3393dfb7a33565c9360342c193bc0bddcb6...08bfea183a850b29da270eac47f80b598cbe600f,2,15,7,22,6,2012-03-16 19:06:29,2012-03-16 00:17:23
08bfea183a850b29da270eac47f80b598cbe600f...1faafa31582c4e9413f48dc7d12f5b681f9fe9fd,1,0,4,4,1,2012-03-16 19:06:29,2012-03-16 07:55:42
1faafa31582c4e9413f48dc7d12f5b681f9fe9fd...53b6f522a56eea314cbd084816e08f24b2c7879f,1,1,1,2,1,2012-03-16 22:32:14,2012-03-16 22:31:42
53b6f522a56eea314cbd084816e08f24b2c7879f...78a6291666d55c8b1415e8090c7e6a35ae95df8b,1,19,4,23,4,2012-03-16 22:32:14,2012-03-16 22:32:03
78a6291666d55c8b1415e8090c7e6a35ae95df8b...935c1018da05dbf3124b2dd33619c4a3c82d7a2a,2,11,4,15,5,2012-03-17 22:57:55,2012-03-17 22:57:55
935c1018da05dbf3124b2dd33619c4a3c82d7a2a...192ff61f5d61899e667c6dbce4d3e6e399429d8b,2,15,3,18,4,2012-03-19 06:46:30,2012-03-19 06:46:30
192ff61f5d61899e667c6dbce4d3e6e399429d8b...6c5a05ad49a1e083570c3dfe331403398f899dbe,3,49,15,64,10,2012-03-19 18:35:09,2012-03-15 20:40:00
6c5a05ad49a1e083570c3dfe331403398f899dbe...21e74c2d2e8e985b23711785287feb59965cbd90,2,31,1,32,2,2012-03-19 18:35:09,2012-03-15 20:41:06
21e74c2d2e8e985b23711785287feb59965cbd90...823adb231995e917bc060bfa49453e2a96bac2b6,2,54,26,80,16,2012-03-19 18:35:09,2012-03-15 21:08:49
823adb231995e917bc060bfa49453e2a96bac2b6...6ecac8e71a84792a434d21db2c245b3648c55f18,2,19,1,20,3,2012-03-19 18:35:10,2012-03-15 21:19:20
6ecac8e71a84792a434d21db2c245b3648c55f18...9918b748be01266eb10db39d51b4d3098d54ab66,7,41,15,56,10,2012-03-19 18:35:10,2012-03-16 05:18:06
9918b748be01266eb10db39d51b4d3098d54ab66...5ac14f633a69f49973b5512780c6ec7752405967,3,45,35,80,14,2012-03-19 18:41:10,2012-03-16 18:28:32
5ac14f633a69f49973b5512780c6ec7752405967...d4ae7988dad88af608db9cf34992c9c748eda6aa,6,10,9,19,8,2012-03-19 18:41:23,2012-03-16 19:55:54
d4ae7988dad88af608db9cf34992c9c748eda6aa...1cc0e4173de01d6c4103910d231a24b2834f4d91,4,42,11,53,7,2012-03-19 22:49:42,2012-03-19 19:20:57
1cc0e4173de01d6c4103910d231a24b2834f4d91...f701ce08f9d63be05fc3b92f57ad473e1e749b2d,1,1,1,2,1,2012-03-20 00:26:29,2012-03-20 00:26:01
f701ce08f9d63be05fc3b92f57ad473e1e749b2d...f49eaf8bf2df5f4e0e82d6c89e849a4f82c8d414,2,43,1,44,4,2012-03-20 17:39:43,2012-03-20 00:26:05
f49eaf8bf2df5f4e0e82d6c89e849a4f82c8d414...64fb1f262028679b7eb1760bb38f9b1e4003d8e7,3,19,19,38,13,2012-03-20 18:07:35,2012-03-19 16:37:32
64fb1f262028679b7eb1760bb38f9b1e4003d8e7...9171c76bb4951b5ad6449ff9d0b658f2d390f784,1,3,2,5,1,2012-03-20 18:07:35,2012-03-19 16:44:05
9171c76bb4951b5ad6449ff9d0b658f2d390f784...15213ec212769837cb2b7e781ffc5bfd598d27ca,2,39,12,51,7,2012-03-20 18:07:36,2012-03-19 18:15:09
15213ec212769837cb2b7e781ffc5bfd598d27ca...9cb2195e61a78e99020ec19d687a221ca88b5900,1,17,12,29,5,2012-03-20 18:07:36,2012-03-20 07:00:09
9cb2195e61a78e99020ec19d687a221ca88b5900...ee5a5352fd4b94cedee6ef20d4bf2d43ce77e00b,1,1,1,2,1,2012-03-20 18:07:37,2012-03-20 07:20:12
ee5a5352fd4b94cedee6ef20d4bf2d43ce77e00b...a4fe51da3ba0dc297ecd389e230d6664f250c9a6,2,44,1,45,3,2012-03-20 18:07:37,2012-03-20 07:38:08
a4fe51da3ba0dc297ecd389e230d6664f250c9a6...6d6f875345e01f2c6c63ef95164f6f39e923da15,2,9,3,12,4,2012-03-20 18:07:37,2011-12-12 21:38:50
6d6f875345e01f2c6c63ef95164f6f39e923da15...83155e8fbeebca3a7bc1804cccead7c72581ba47,1,100,79,179,60,2012-03-20 18:07:37,2011-12-12 22:08:24
83155e8fbeebca3a7bc1804cccead7c72581ba47...1a5bebd927ecd22f9c34617642fdf58fe3f62efb,2,21,8,29,10,2012-03-20 18:07:38,2012-02-28 20:11:03
1a5bebd927ecd22f9c34617642fdf58fe3f62efb...6a8749e65a7efb69a65be87605cd7d4a2df2fbb0,5,484,491,975,6,2012-03-20 18:07:38,2012-02-29 01:33:54
6a8749e65a7efb69a65be87605cd7d4a2df2fbb0...3436c027f217fe0583b23d48c101299b1872d333,1,4,4,8,2,2012-03-20 18:30:21,2012-03-20 18:30:21
3436c027f217fe0583b23d48c101299b1872d333...9eafd10fcdf8846194bbc325fe23fd3d6d9da155,1,20,22,42,6,2012-03-20 19:05:57,2012-03-20 19:05:57
9eafd10fcdf8846194bbc325fe23fd3d6d9da155...ade6c452753145c84884d17027a7865bf4b34b0c,2,19,5,24,4,2012-03-20 21:39:23,2012-03-20 20:05:42
ade6c452753145c84884d17027a7865bf4b34b0c...e7cd0bcc5a0ab8c35df05f85bd2a1e29c12d4f0b,1,39,17,56,8,2012-03-20 22:23:58,2012-03-14 18:34:51
e7cd0bcc5a0ab8c35df05f85bd2a1e29c12d4f0b...69f0aa899d0681a784f77e345b00a057b9242ac5,1,50,0,50,1,2012-03-20 22:25:31,2012-03-20 22:04:26
69f0aa899d0681a784f77e345b00a057b9242ac5...c5f8edfe03c8c9d2273a852f06dfc3fe02069113,1,1,1,2,1,2012-03-20 22:38:57,2012-03-20 22:38:49
c5f8edfe03c8c9d2273a852f06dfc3fe02069113...52c59cf0ce6b9aec1f591af17f358058f881e7ac,1,2,2,4,1,2012-03-20 23:02:49,2012-03-20 23:02:49
52c59cf0ce6b9aec1f591af17f358058f881e7ac...263524d381b8fb28a3bdcdbdb290bd078a7f124e,1,1,1,2,1,2012-03-21 00:21:41,2012-03-21 00:21:41
263524d381b8fb28a3bdcdbdb290bd078a7f124e...0a45bff4723002838a52fc7ed63ae46348eb5c47,1,1,1,2,1,2012-03-21 20:46:35,2012-03-21 20:46:35
0a45bff4723002838a52fc7ed63ae46348eb5c47...98e18a64aa6b4d7323b684f4d65ba2db30828762,1,11,11,22,6,2012-03-21 20:52:11,2012-03-21 20:52:11
98e18a64aa6b4d7323b684f4d65ba2db30828762...541bedd1a9692208deae0cd2a93171e87fb7d1ba,1,2,2,4,2,2012-03-22 23:29:31,2012-03-22 23:29:31
541bedd1a9692208deae0cd2a93171e87fb7d1ba...5fdab52dd7c269f99839f4fa6b5854d9548269fa,2,54,0,54,4,2012-03-22 23:39:36,2012-03-21 22:16:41
5fdab52dd7c269f99839f4fa6b5854d9548269fa...8d7e6948496ff26ef1da8854ba02fcb8eebfed61,2,24,2,26,2,2012-03-22 23:39:36,2012-03-21 22:42:35
8d7e6948496ff26ef1da8854ba02fcb8eebfed61...5390fb37d2c01937922613fc57df4986af521787,2,15,6,21,5,2012-03-23 18:46:54,2012-03-23 18:46:54
5390fb37d2c01937922613fc57df4986af521787...ac75079e2113949d5d64adbcf23d56f3cf295d41,2,21,9,30,3,2012-03-23 21:21:43,2012-03-23 20:31:20
ac75079e2113949d5d64adbcf23d56f3cf295d41...73c8593077155a9f2e8ef42efd4c497eba0bef4f,2,46,6,52,10,2012-03-23 21:21:43,2012-03-23 20:41:48
73c8593077155a9f2e8ef42efd4c497eba0bef4f...cb2ad9abf24e6f855cc749efe3155bd7987ece9d,1,1,1,2,1,2012-03-23 22:41:37,2012-03-23 22:00:22
cb2ad9abf24e6f855cc749efe3155bd7987ece9d...2be8847ef6cdddcb98be9b57a2ca150065904fa1,1,7,0,7,3,2012-03-23 23:31:33,2012-01-31 20:18:05
2be8847ef6cdddcb98be9b57a2ca150065904fa1...4581b79bbda74de7f4abc136187fe5574892b39c,1,8,9,17,4,2012-03-23 23:54:48,2012-03-23 23:54:48
4581b79bbda74de7f4abc136187fe5574892b39c...74c84501ed72782b2e46492d1ded30f51ab31176,1,1,1,2,1,2012-03-23 23:57:24,2012-03-23 23:57:24
74c84501ed72782b2e46492d1ded30f51ab31176...4b8d926062eb4d4483555bdbdec4656f585ab40b,1,5,1,6,1,2012-03-26 19:21:42,2012-03-26 19:21:42
4b8d926062eb4d4483555bdbdec4656f585ab40b...d54dfecb00fba41455536c5ddd55310592fdaf84,5,114,12,126,13,2012-03-26 22:23:29,2012-03-26 20:01:24
d54dfecb00fba41455536c5ddd55310592fdaf84...aaedefb92e6bec6626e173e5155072c91471596a,2,2,8,10,3,2012-03-26 22:43:59,2012-03-26 22:43:56
aaedefb92e6bec6626e173e5155072c91471596a...f04142ea281c16182132ca4f307f24e97a19cfdc,1,5,5,10,3,2012-03-26 23:06:16,2012-03-22 19:38:03
f04142ea281c16182132ca4f307f24e97a19cfdc...5c5b1183c82a28841b3e1e246ee341262e91d743,1,2,2,4,2,2012-03-26 23:06:46,2012-03-22 19:38:49
5c5b1183c82a28841b3e1e246ee341262e91d743...09e175f02cca0f4a295fd0c9b980cd8f432e722b,5,86,10,96,11,2012-03-27 04:14:09,2012-03-23 20:04:52
09e175f02cca0f4a295fd0c9b980cd8f432e722b...55027132f3d57e5dcf94683e6e6bd7b0aae0087d,4,0,166,166,5,2012-03-27 04:14:09,2012-03-23 22:48:51
55027132f3d57e5dcf94683e6e6bd7b0aae0087d...a08cbc02e78e789a66e9af771c410e8ad1646e25,7,105,106,211,41,2012-03-27 04:14:09,2012-03-23 22:53:04
a08cbc02e78e789a66e9af771c410e8ad1646e25...2ce0485e6f21c77e84fd4fc07a9b15adc90a7fd8,1,20,15,35,9,2012-03-27 15:28:34,2012-03-27 15:27:42
2ce0485e6f21c77e84fd4fc07a9b15adc90a7fd8...944098a4e0f753f06b40c73ca3e79991cec6c2e2,1,20,17,37,4,2012-03-28 01:06:00,2012-03-28 01:06:00
944098a4e0f753f06b40c73ca3e79991cec6c2e2...2430f52bb97fa9d682e5f028c977c5bf94c5ec38,305,114,105,219,20,2012-03-28 18:16:35,2012-03-23 21:03:24
2430f52bb97fa9d682e5f028c977c5bf94c5ec38...8218c4b60b82927234cf545253266f288fa936c2,12,172,121,293,46,2012-03-28 18:16:36,2012-03-27 04:18:01
8218c4b60b82927234cf545253266f288fa936c2...798bca62c6f64775b85deda3713e7b6bcc7a4b4d,5,17,5,22,13,2012-03-28 18:16:36,2012-03-27 04:45:38
798bca62c6f64775b85deda3713e7b6bcc7a4b4d...7b22d59b4a16d5c50c2eee054178ba17f8038880,11,207,195,402,19,2012-03-28 18:16:36,2012-03-26 23:22:06
7b22d59b4a16d5c50c2eee054178ba17f8038880...8b93541522161e16ddd606770732d176c4bf0eec,1,17,14,31,9,2012-03-28 18:16:36,2012-03-28 17:50:10
8b93541522161e16ddd606770732d176c4bf0eec...ba59ef495007d192724b352c68e7d2edc53f8b63,6,59,57,116,29,2012-03-28 18:24:47,2012-03-28 17:50:46
ba59ef495007d192724b352c68e7d2edc53f8b63...bb2fa6f63f0a4a08d4a3a5439d1ab6d9ddfd917e,7,84,84,168,54,2012-03-28 18:24:47,2012-03-28 18:16:10
bb2fa6f63f0a4a08d4a3a5439d1ab6d9ddfd917e...ac4318a2fa5c6d306dbc19466246292a81767fca,5,201,216,417,34,2012-03-28 23:30:30,2012-03-27 06:38:20
ac4318a2fa5c6d306dbc19466246292a81767fca...da9f4dfcf4f3d0c21821d8474ac0bb19a3c51415,2,38,1,39,4,2012-03-28 23:30:31,2012-03-27 15:05:07
da9f4dfcf4f3d0c21821d8474ac0bb19a3c51415...13a95ae499661b70a9c24691ded709fbf1e90293,1,0,1,1,1,2012-03-28 23:30:31,2012-03-27 15:10:43
13a95ae499661b70a9c24691ded709fbf1e90293...a8a750ab05bdff73ba3af0b98f3f284ff8d1e743,1,4,4,8,4,2012-03-28 23:30:38,2012-03-27 15:53:44
a8a750ab05bdff73ba3af0b98f3f284ff8d1e743...87f5c6e5b716100e203ec59c5874c3e927f83fa0,4,16,119,135,8,2012-03-28 23:30:38,2012-03-27 17:21:49
87f5c6e5b716100e203ec59c5874c3e927f83fa0...35125d25137ac2da13ed1ca3e652ec8f2c945053,5,51,247,298,25,2012-03-28 23:57:22,2012-03-27 19:44:37
35125d25137ac2da13ed1ca3e652ec8f2c945053...af0ad6561c0d75c4f155b07e9cfc36a983af55bd,5,103,108,211,5,2012-03-28 23:57:34,2012-03-28 19:21:07
af0ad6561c0d75c4f155b07e9cfc36a983af55bd...4557881cf84f168855fc8615e174f24d6c2dd6ce,6,430,0,430,6,2012-03-29 14:22:13,2012-03-17 10:10:03
4557881cf84f168855fc8615e174f24d6c2dd6ce...f2106692b1ebf00aa5f8b2accd75f014b6cd4faa,3,40,2,42,8,2012-03-29 14:30:32,2012-03-28 20:47:57
f2106692b1ebf00aa5f8b2accd75f014b6cd4faa...6da355c3e1571b9a104fca2796df77a4194a28a2,6,102,91,193,19,2012-03-29 14:30:32,2012-03-28 23:03:59
6da355c3e1571b9a104fca2796df77a4194a28a2...2f2fd465a40f675c969effd2324611533929fb73,1,65,1,66,2,2012-03-29 15:10:28,2012-03-29 15:02:54
2f2fd465a40f675c969effd2324611533929fb73...2cb907a8366e3273890f5ef6174b2e3970cd1720,2,8,1,9,2,2012-03-29 18:21:04,2012-03-29 00:20:12
2cb907a8366e3273890f5ef6174b2e3970cd1720...95c5df5958f6d42d08846fa40c10cb279ce76ee9,2,20,3,23,2,2012-03-29 21:05:19,2012-03-29 20:50:27
95c5df5958f6d42d08846fa40c10cb279ce76ee9...423242017e56c103b07b7f576dbd52a5a38c331a,1,1,1,2,1,2012-03-29 23:10:40,2012-03-29 22:38:04
423242017e56c103b07b7f576dbd52a5a38c331a...ae1aee2b6c5755e303c62943abba03bda3a6971e,1,2,1,3,1,2012-03-29 23:10:40,2012-03-29 22:38:51
ae1aee2b6c5755e303c62943abba03bda3a6971e...fc52b81d5288897b351397cd5a21aa98a54cca70,1,1,1,2,1,2012-03-29 23:10:40,2012-03-29 23:10:04
fc52b81d5288897b351397cd5a21aa98a54cca70...20687aa5f632f99aa94f5e6f7a5803beae94f6b4,1,1,1,2,1,2012-03-29 23:10:40,2012-03-29 21:13:03
20687aa5f632f99aa94f5e6f7a5803beae94f6b4...a1f7f5d4d06cc3cea97cf0ab134f14966b9b010a,1,2,2,4,1,2012-03-30 20:23:36,2012-03-30 20:23:36
a1f7f5d4d06cc3cea97cf0ab134f14966b9b010a...59fa40ec0e851759d35fb0ea5fd01019d1403049,2,14,1,15,2,2012-04-02 15:35:30,2012-03-29 20:16:10
59fa40ec0e851759d35fb0ea5fd01019d1403049...c0b78478a0e64942a69aba7c1bfa4eb01c0e9a5e,2,9,1,10,2,2012-04-02 17:14:04,2012-04-02 17:10:46
c0b78478a0e64942a69aba7c1bfa4eb01c0e9a5e...59ae8adb3cfa635076b5cf64cc48b13a34bc04ad,1,10,10,20,7,2012-04-02 23:10:15,2012-04-01 16:08:44
59ae8adb3cfa635076b5cf64cc48b13a34bc04ad...28ff7c3a66fbd770515273c7ca2fcb9cd936b50e,2,14,13,27,8,2012-04-03 14:07:49,2012-04-03 14:07:41
28ff7c3a66fbd770515273c7ca2fcb9cd936b50e...a22e0699bef61a7083b0b628fb6043531c0ca1c0,2,52,3,55,3,2012-04-03 17:10:44,2012-04-02 19:26:57
a22e0699bef61a7083b0b628fb6043531c0ca1c0...06d0955074f79de553cc34fbf945045dc458e064,8,76,149,225,33,2012-04-03 17:10:44,2012-03-30 19:07:19
06d0955074f79de553cc34fbf945045dc458e064...5f70d615a5f7e102424c6adc15d7a6f697870b6e,2,56,70,126,17,2012-04-03 17:10:44,2012-03-30 20:40:19
5f70d615a5f7e102424c6adc15d7a6f697870b6e...199ac269869a57bb63d60c9b3f510d546bf0c9b2,2,4,3,7,3,2012-04-03 17:10:44,2012-03-30 20:54:43
199ac269869a57bb63d60c9b3f510d546bf0c9b2...428f2b563663315df4f235ca19cef4bdcf82e2ab,1,3,2,5,2,2012-04-03 17:10:44,2012-03-30 20:55:33
428f2b563663315df4f235ca19cef4bdcf82e2ab...15c1fe392942b70e456f10afbdfd9c3329249a43,2,37,39,76,16,2012-04-03 17:10:44,2012-03-30 22:03:20
15c1fe392942b70e456f10afbdfd9c3329249a43...7e86eacf301934335c22908ec6dbd1a083d88fab,2,34,15,49,3,2012-04-03 23:02:20,2012-04-03 21:15:42
7e86eacf301934335c22908ec6dbd1a083d88fab...2f5dba488e855bcdbb9304aa809efcb9de7b43e9,2,20,5,25,4,2012-04-03 23:02:20,2012-04-03 22:03:27
2f5dba488e855bcdbb9304aa809efcb9de7b43e9...21b77ad5c231ab0e05eb89f22005f7ed8d40a6c1,2,66,38,104,9,2012-04-04 06:28:05,2012-04-04 05:05:13
21b77ad5c231ab0e05eb89f22005f7ed8d40a6c1...dcb8e0767fbf0a7a55f3b0045fd01b2532ea5441,2,13,1,14,2,2012-04-04 15:26:28,2012-04-04 15:12:39
dcb8e0767fbf0a7a55f3b0045fd01b2532ea5441...8fe4295a064caa699edd902711d396164cf092f4,1,4,4,8,4,2012-04-04 21:58:07,2012-04-04 02:01:57
8fe4295a064caa699edd902711d396164cf092f4...02cf958a076b140690ab9ea4ed00c490f52cbf91,3,1,1,2,1,2012-04-04 21:58:27,2012-04-04 00:26:09
02cf958a076b140690ab9ea4ed00c490f52cbf91...85776c0d37316c5aaecd84eedec275bac2cd0298,1,23,35,58,6,2012-04-04 22:01:27,2012-04-04 22:01:27
85776c0d37316c5aaecd84eedec275bac2cd0298...fdf17d729fa7651e88dc5f27c40b8de875a34a55,8,18,18,36,13,2012-04-04 22:56:15,2012-04-04 22:56:12
fdf17d729fa7651e88dc5f27c40b8de875a34a55...6336b6e89e3a80aec3c4367ab4c2737fd365c030,14,2212,0,2212,14,2012-04-04 22:59:18,2012-03-30 21:02:26
6336b6e89e3a80aec3c4367ab4c2737fd365c030...53b2254ea70019937463d8e079e1991b3d3d1d8b,30,1293,2119,3412,208,2012-04-04 22:59:18,2012-04-02 15:32:30
53b2254ea70019937463d8e079e1991b3d3d1d8b...15ecc6f3668885ebc5c7130dd34e00059ddf79ae,3,26,8,34,8,2012-04-04 23:10:44,2012-04-03 22:28:09
15ecc6f3668885ebc5c7130dd34e00059ddf79ae...86182a9415b9209662b16c25c180b958ba7e6cf9,4,38,5,43,8,2012-04-04 23:13:02,2012-04-03 18:00:52
86182a9415b9209662b16c25c180b958ba7e6cf9...637817e3ba48d149e7a9628533d21e81c650d988,2,14,4,18,4,2012-04-05 17:22:27,2012-04-05 06:10:50
637817e3ba48d149e7a9628533d21e81c650d988...1bbc67ef6cba16952ed0ef23d9d62ec8ef960295,1,44,83,127,10,2012-04-05 17:22:27,2012-04-05 16:52:09
1bbc67ef6cba16952ed0ef23d9d62ec8ef960295...0f2de12273c50729e918c3103d92fdec6b5b3cad,3,3,1,4,3,2012-04-05 18:33:42,2012-04-05 16:53:36
0f2de12273c50729e918c3103d92fdec6b5b3cad...1c8c08340420b981a0964dc960029d55b3b77f49,1,8,8,16,5,2012-04-05 18:33:42,2012-04-05 17:37:02
1c8c08340420b981a0964dc960029d55b3b77f49...94fca76a0851abe28eb2d54fa87c5028c8e06ca8,1,65,4,69,5,2012-04-05 18:45:34,2012-04-05 17:55:30
94fca76a0851abe28eb2d54fa87c5028c8e06ca8...bd4a4d390c9f2c9d015c5e72e53c2b9cafea9f2c,1,1,1,2,1,2012-04-05 18:46:36,2012-04-05 18:46:36
bd4a4d390c9f2c9d015c5e72e53c2b9cafea9f2c...7468bcb80b997e323bb0808d19ee215cc5f7ae84,1,2,2,4,1,2012-04-09 15:59:31,2012-04-09 15:59:31
7468bcb80b997e323bb0808d19ee215cc5f7ae84...82d90a409692e97a79c3bf4708ee80796c7de2d6,54,349,332,681,274,2012-04-09 16:52:27,2012-04-06 23:35:17
82d90a409692e97a79c3bf4708ee80796c7de2d6...dc7b764d4da500682799234b32b6bd44e73c5d41,1,31,14,45,6,2012-04-09 16:52:28,2012-04-08 09:40:28
dc7b764d4da500682799234b32b6bd44e73c5d41...10daefc6f466a21d9418437666461c80cf24fcfe,2,18,4,22,3,2012-04-09 16:52:28,2012-04-08 09:49:03
10daefc6f466a21d9418437666461c80cf24fcfe...0f89383d981d0144c6db92b163edcc545d6b5222,22,58,58,116,58,2012-04-09 18:48:54,2012-04-09 18:20:55
0f89383d981d0144c6db92b163edcc545d6b5222...b5406d276d73bcb0319eb451fa1cf2aec1e67946,1,0,7,7,1,2012-04-09 18:49:51,2012-04-09 18:49:43
b5406d276d73bcb0319eb451fa1cf2aec1e67946...13d5528a5f5a2f0feee5c742788a914d2371841e,1,0,17,17,1,2012-04-09 22:21:46,2012-04-09 18:53:56
13d5528a5f5a2f0feee5c742788a914d2371841e...fbaa1968b7c596ccb63ea8b4be1d3bd92eda50d8,6,80,99,179,21,2012-04-10 00:59:47,2012-04-09 21:27:14
fbaa1968b7c596ccb63ea8b4be1d3bd92eda50d8...ac2f0cece62c51fbf77e9b9f40ac40d8fcf9af17,2,2,2,4,2,2012-04-10 13:04:13,2012-04-10 13:04:13
ac2f0cece62c51fbf77e9b9f40ac40d8fcf9af17...5c0ec9d06dfd5bcd7d1fb010f5efef649e05f3c3,1,2,2,4,1,2012-04-10 20:21:29,2012-04-10 20:21:29
5c0ec9d06dfd5bcd7d1fb010f5efef649e05f3c3...fcc556df3745d4c7768e235cb5f1caf70eb34639,1,2,2,4,2,2012-04-10 20:42:17,2012-04-10 20:39:43
fcc556df3745d4c7768e235cb5f1caf70eb34639...52ee1ab5eb0f3197453b26c60a70239ac3fffea7,23,50,130,180,53,2012-04-10 23:52:12,2012-04-10 21:29:49
52ee1ab5eb0f3197453b26c60a70239ac3fffea7...e1743cc837a51e3146f2e73e3083eee7f4a8f549,1,1,1,2,1,2012-04-11 18:23:48,2012-04-11 18:23:48
e1743cc837a51e3146f2e73e3083eee7f4a8f549...5bcd7198664dca2bf85ddf8b3a89f417cd4e4796,20,301,244,545,56,2012-04-11 22:50:47,2012-04-10 23:50:31
5bcd7198664dca2bf85ddf8b3a89f417cd4e4796...93d62860e988a09fb64e594f50f6cd55a1fc5748,2,51,5,56,3,2012-04-11 22:50:52,2012-04-10 20:41:51
93d62860e988a09fb64e594f50f6cd55a1fc5748...7c430c5ed039d7eed8d71bd107708224c1db5c74,1,2,2,4,3,2012-04-11 23:12:58,2012-04-11 23:11:03
7c430c5ed039d7eed8d71bd107708224c1db5c74...0a5050eb3c1f1ed84134f23a44b97a7261114060,2,85,0,85,2,2012-04-12 00:27:32,2012-04-04 14:41:50
0a5050eb3c1f1ed84134f23a44b97a7261114060...dceafd32ee140c8af5c7a0ca6cb808395fffeed3,2,32,0,32,3,2012-04-12 00:29:16,2012-04-11 06:20:53
dceafd32ee140c8af5c7a0ca6cb808395fffeed3...7d074a377542028f1c2c184c51971f16ca0e6238,1,3,3,6,3,2012-04-12 00:29:16,2012-04-11 06:30:22
7d074a377542028f1c2c184c51971f16ca0e6238...0c49bbdc38d228c7612bbda0420e4f17ba501528,2,10,10,20,2,2012-04-12 04:27:55,2012-04-12 04:12:48
0c49bbdc38d228c7612bbda0420e4f17ba501528...c4f6ccb0658cb723c6e9704cf7fcf1bc72b2ae99,1,1,1,2,1,2012-04-12 06:48:53,2012-04-12 04:12:29
c4f6ccb0658cb723c6e9704cf7fcf1bc72b2ae99...df72852f3496d7640bb4f70837338e464b7ed69f,3,13,23,36,6,2012-04-12 09:36:03,2012-04-12 09:15:36
df72852f3496d7640bb4f70837338e464b7ed69f...6d7e7fdea6c3d6551ff40c150aa42e1375d2cb5f,5,45,53,98,22,2012-04-12 09:36:03,2012-04-12 06:46:23
6d7e7fdea6c3d6551ff40c150aa42e1375d2cb5f...b2d0a386f693d768cd82a3a0c54c43a926b4f339,1,2,2,4,2,2012-04-12 09:36:03,2012-04-12 09:18:25
b2d0a386f693d768cd82a3a0c54c43a926b4f339...2037facc998b4da2bbb2b62690faf4d970470c12,10,366,3152,3518,163,2012-04-12 09:45:12,2012-04-12 00:00:26
2037facc998b4da2bbb2b62690faf4d970470c12...e9ccec76a6694e2da4af3efbdad93aa6f01113f2,2,71,9,80,5,2012-04-12 10:26:10,2012-04-12 10:17:59
e9ccec76a6694e2da4af3efbdad93aa6f01113f2...9260b4937d501d7fcab8c3e38bd9bdf15e6696c2,1,1,1,2,1,2012-04-12 10:56:28,2012-04-12 10:56:28
9260b4937d501d7fcab8c3e38bd9bdf15e6696c2...c322735f83a4ea3b04e741431174a60dad49eea2,1,2,2,4,1,2012-04-12 10:57:14,2012-04-12 10:57:14
c322735f83a4ea3b04e741431174a60dad49eea2...b94fb5c8c1a96dae771fa36814ed7e2d54c73b8a,1,15,15,30,3,2012-04-15 16:42:54,2012-04-15 16:42:54
b94fb5c8c1a96dae771fa36814ed7e2d54c73b8a...0c7252f929c7b7d0c718c4683a712331c6b95776,1,1,1,2,1,2012-04-20 17:43:41,2012-04-12 22:23:34
0c7252f929c7b7d0c718c4683a712331c6b95776...0bd0ef7813ec2765eaf02f888f2f57a32292f406,1,1,1,2,1,2012-04-20 17:43:58,2012-04-17 21:35:00
0bd0ef7813ec2765eaf02f888f2f57a32292f406...5cc245dd80f973bf812e430fc31700a27699c9ad,1,1,1,2,1,2012-04-20 17:44:18,2012-04-18 00:41:44
5cc245dd80f973bf812e430fc31700a27699c9ad...908785960d0977db29e83b6f549d82be57bd54d7,1,1,1,2,1,2012-04-20 17:49:44,2012-04-16 21:30:04
908785960d0977db29e83b6f549d82be57bd54d7...666f326c5da82d34a99e5d61e68f2b1dc08edca9,1,18,22,40,7,2012-04-20 17:57:26,2012-04-10 16:27:16
666f326c5da82d34a99e5d61e68f2b1dc08edca9...eafe15f54c686d5c83f777fd319f4c568e209432,1,0,3,3,1,2012-04-20 18:29:33,2012-04-13 21:49:50
eafe15f54c686d5c83f777fd319f4c568e209432...dc32ea627e38b34ecdb709fce0cf34134d12193e,5,0,0,0,0,2012-04-20 18:29:33,2012-04-13 21:46:50
dc32ea627e38b34ecdb709fce0cf34134d12193e...94dd68570952f6f31abfa351b1159afcd3588a57,2,11,13,24,5,2012-04-20 18:29:34,2012-04-17 20:55:10
94dd68570952f6f31abfa351b1159afcd3588a57...46bb08a9d0780fafef6dc5c1140c71912462887a,1,10,5,15,2,2012-04-20 18:29:34,2012-04-17 20:58:25
46bb08a9d0780fafef6dc5c1140c71912462887a...ce15a3e0491f7acafcdf0ff07f75d0c2c9819164,8,8,8,16,8,2012-04-20 18:29:34,2012-04-17 22:17:04
ce15a3e0491f7acafcdf0ff07f75d0c2c9819164...e61fd1b43a55496c11c63da7ca2fc05b88d44043,4,50,5,55,9,2012-04-20 19:32:33,2012-04-20 08:31:25
e61fd1b43a55496c11c63da7ca2fc05b88d44043...8ebe5ccd9ace7807bedc7317d605370fe82b773d,3,897,793,1690,323,2012-04-20 21:29:36,2012-04-18 22:51:45
8ebe5ccd9ace7807bedc7317d605370fe82b773d...c65c34ebfe0f70c83a45f283654c8558802752cf,1,40,40,80,10,2012-04-20 21:29:36,2012-04-17 22:12:09
c65c34ebfe0f70c83a45f283654c8558802752cf...904b69c745ea4afc1d6ecd2a5f3138c6f947b157,2,425,74,499,26,2012-04-20 21:29:37,2012-04-18 07:48:25
904b69c745ea4afc1d6ecd2a5f3138c6f947b157...983c3095428d3055fa2f99e8df7d9532c3ca0517,1,27,0,27,1,2012-04-20 22:06:05,2012-04-20 22:06:05
983c3095428d3055fa2f99e8df7d9532c3ca0517...1d26acb8746533433d247f986128a142e627c320,1,1,1,2,1,2012-04-20 22:06:39,2012-04-20 22:06:39
1d26acb8746533433d247f986128a142e627c320...43d15f830f9d419c41c41f0682e47e86839e3917,2,4,6,10,4,2012-04-21 00:04:21,2012-04-20 18:27:35
43d15f830f9d419c41c41f0682e47e86839e3917...b806b308614668c2590996a72b26b3529e909ebd,1,61,58,119,11,2012-04-21 00:04:21,2012-04-20 20:28:58
b806b308614668c2590996a72b26b3529e909ebd...a18926f986166048a21097636f03ab29f107b154,1,2,2,4,1,2012-04-21 00:04:21,2012-04-20 21:47:50
a18926f986166048a21097636f03ab29f107b154...1214084e9d036c4968adb2b15c4cbedd763c215d,1,8,8,16,2,2012-04-21 19:08:30,2012-04-21 19:08:30
1214084e9d036c4968adb2b15c4cbedd763c215d...dbb92efd13cd0171da369645f8780fde9987a78f,1,2,2,4,1,2012-04-23 18:42:26,2012-04-21 00:05:28
dbb92efd13cd0171da369645f8780fde9987a78f...73caf76225b1a1ab41bca00340950985633f9ef9,1,5,0,5,1,2012-04-23 18:42:27,2012-03-16 23:09:41
73caf76225b1a1ab41bca00340950985633f9ef9...2b1b2570344cfb55ba93b6f184bd3ee6db324419,1,3,0,3,1,2012-04-28 05:04:16,2012-04-27 22:20:34
2b1b2570344cfb55ba93b6f184bd3ee6db324419...2b87c814ab70eaaff6359ce1a118f348c8bd2197,7,544,397,941,102,2012-04-28 06:04:24,2012-04-27 22:20:54
2b87c814ab70eaaff6359ce1a118f348c8bd2197...075c089b5cbe72e95ec96638f8925aeb44824f7c,12,473,356,829,175,2012-04-30 08:08:15,2012-04-27 22:18:54
075c089b5cbe72e95ec96638f8925aeb44824f7c...006fb4fbeb768e4b50659838f7587bae9847371d,2,5,5,10,4,2012-04-30 08:09:55,2012-04-30 08:09:55
006fb4fbeb768e4b50659838f7587bae9847371d...96758c1c5277ca9041e82c4c1d2e2c473cd477b0,1,7,6,13,3,2012-04-30 22:37:12,2012-04-30 22:37:12
96758c1c5277ca9041e82c4c1d2e2c473cd477b0...f3c77858be536238884d5dd44855328b3a521e5e,1,27,0,27,1,2012-04-30 22:53:05,2012-04-30 22:41:37
f3c77858be536238884d5dd44855328b3a521e5e...76afa406b1be0105149290d4716b735457518a47,1,1,1,2,1,2012-04-30 23:32:45,2012-04-30 23:32:45
76afa406b1be0105149290d4716b735457518a47...c7f11015205835e83d935417e3342a18fe23c3fa,1,2,2,4,1,2012-05-02 21:21:30,2012-05-02 21:21:30
c7f11015205835e83d935417e3342a18fe23c3fa...3bd3cc571dcd721f9d71f971aefee23115a5e458,2,29,5,34,6,2012-05-02 21:24:43,2012-05-02 07:33:00
3bd3cc571dcd721f9d71f971aefee23115a5e458...beea3a4beda0aaed5fc54af1a992b1c161db7752,3,1,1,2,1,2012-05-02 23:37:48,2012-05-02 21:32:27
beea3a4beda0aaed5fc54af1a992b1c161db7752...843f762c573e38a044f920c5575c6feb46bc7226,2,41,1,42,3,2012-05-03 07:15:26,2012-05-02 23:04:11
843f762c573e38a044f920c5575c6feb46bc7226...bd530e225750e9b30b6300fc3d7447a5f1071667,2,32,30,62,23,2012-05-03 07:15:26,2012-05-02 23:34:54
bd530e225750e9b30b6300fc3d7447a5f1071667...705f4bbf115d2408e33b25f56edbf1f383aabb82,2,66,1,67,4,2012-05-03 07:15:26,2012-05-03 04:08:02
705f4bbf115d2408e33b25f56edbf1f383aabb82...9cba23a58847b8a856785a026aa95980cc690115,1,4,0,4,1,2012-05-03 17:07:30,2012-05-03 04:59:55
9cba23a58847b8a856785a026aa95980cc690115...fff31d8d612430caf10a61a85e81e8c6c3629138,2,190,161,351,100,2012-05-04 06:31:28,2012-05-03 07:15:07
fff31d8d612430caf10a61a85e81e8c6c3629138...5df7e6fae5c1045b8d988a6fa06fef674a4527da,1,12,4,16,5,2012-05-04 06:31:28,2012-05-04 04:41:40
5df7e6fae5c1045b8d988a6fa06fef674a4527da...ee579a071a91cbade729d3cb97e097568e71f8fc,2,73,15,88,4,2012-05-04 06:31:28,2012-05-04 04:42:51
ee579a071a91cbade729d3cb97e097568e71f8fc...a44d3dcd6a31f21de957855c732a28c881372549,1,1,1,2,1,2012-05-04 06:31:28,2012-05-04 04:43:55
a44d3dcd6a31f21de957855c732a28c881372549...b431ee38509724ba9098a7be7a8d6c5dcded4fe9,2,7,13,20,6,2012-05-04 06:40:43,2012-05-04 04:49:06
b431ee38509724ba9098a7be7a8d6c5dcded4fe9...1564b82b49d996503fe782a1c1baa0a08608cf6a,1,5,5,10,5,2012-05-04 06:40:43,2012-05-04 04:50:55
1564b82b49d996503fe782a1c1baa0a08608cf6a...9c0418cf1abd609bf0ffbe71fbdfa75905cf8e0f,2,91,18,109,10,2012-05-04 20:01:55,2012-05-04 08:24:46
9c0418cf1abd609bf0ffbe71fbdfa75905cf8e0f...e40f8d829f10de3d73aa1026591fe014fe54eca9,1,112,3,115,4,2012-05-04 22:50:37,2012-04-29 05:18:53
e40f8d829f10de3d73aa1026591fe014fe54eca9...fbb499e0a82ba9b816916f275d786775aa6cf467,2,2,2,4,2,2012-05-04 22:50:37,2012-04-29 05:19:23
fbb499e0a82ba9b816916f275d786775aa6cf467...cef3535c16d5b7825f797adc6705d61dad759796,2,25,3,28,3,2012-05-04 22:50:37,2012-04-29 05:23:38
cef3535c16d5b7825f797adc6705d61dad759796...c4fa48725039c30349af725583f147e7f4fb69c7,8,6230,0,6230,8,2012-05-04 22:50:37,2012-04-29 05:25:05
c4fa48725039c30349af725583f147e7f4fb69c7...7f0eb1516165fcb73f1c9953018b7c9b70acfae1,2,26,2,28,5,2012-05-04 22:50:39,2012-05-03 23:30:36
7f0eb1516165fcb73f1c9953018b7c9b70acfae1...d0159454dfa2e1cee4dd4ab7a41c2fcf9e121a64,2,65,48,113,28,2012-05-04 22:50:39,2012-05-03 21:52:26
d0159454dfa2e1cee4dd4ab7a41c2fcf9e121a64...8e2675029f5ca404a7c649cc161df3ea642d941f,82,2753,2724,5477,278,2012-05-04 23:12:17,2012-04-29 05:45:28
8e2675029f5ca404a7c649cc161df3ea642d941f...499a76a08cc7a7604dab5e1dd9cca675b8e29333,2,402,384,786,101,2012-05-05 01:30:19,2012-04-14 17:39:24
499a76a08cc7a7604dab5e1dd9cca675b8e29333...5bcb749abb91dba0847cb9bc900777a67fd55aa8,2,11,5,16,6,2012-05-05 01:30:28,2012-04-14 17:39:24
5bcb749abb91dba0847cb9bc900777a67fd55aa8...49dfdf8f0238ef8c473fcb44694f6b5696ecde70,4,22,8,30,7,2012-05-07 06:01:33,2012-05-06 16:27:10
49dfdf8f0238ef8c473fcb44694f6b5696ecde70...b24cc63bcbd45741d21757653f05d54db09e0f20,2,29,1,30,4,2012-05-07 06:01:33,2012-05-06 23:30:24
b24cc63bcbd45741d21757653f05d54db09e0f20...4d2dd46483da93d6e7165602630cbedaeecee7f3,1,45,1,46,2,2012-05-07 07:08:43,2012-05-07 07:08:43
4d2dd46483da93d6e7165602630cbedaeecee7f3...8ba1fd87e1ccba6953a6ec34c9af515749200f13,1,1,1,2,1,2012-05-07 07:09:20,2012-05-07 07:09:11
8ba1fd87e1ccba6953a6ec34c9af515749200f13...f76474823a8eeca31b72d9eadce55ceefb68f014,1,2,2,4,1,2012-05-07 07:11:50,2012-05-07 07:11:50
f76474823a8eeca31b72d9eadce55ceefb68f014...b99f65f64d1e54315b3210d78a9a9adbcf34c96c,1,8,3,11,3,2012-05-07 22:43:09,2012-05-07 18:51:39
b99f65f64d1e54315b3210d78a9a9adbcf34c96c...aa02534865c8e43dcef9e218b12c8c717c837205,4,32,13,45,14,2012-05-07 22:43:09,2012-05-07 22:19:26
aa02534865c8e43dcef9e218b12c8c717c837205...4e65635f85f83f3e92e279563bb4f26eb05eb02e,1,1,1,2,1,2012-05-09 00:00:25,2012-05-08 23:59:46
4e65635f85f83f3e92e279563bb4f26eb05eb02e...679cb8a74a684454fe38fa9e1ddad396bb598c52,2,8,1,9,2,2012-05-14 04:53:19,2012-05-14 04:53:19
679cb8a74a684454fe38fa9e1ddad396bb598c52...c1533ef5762199bea18d3bf3bcba7fcf89272931,2,12,1,13,2,2012-05-14 21:45:56,2012-05-12 06:56:37
c1533ef5762199bea18d3bf3bcba7fcf89272931...7b739c97028be2a5d5aef679ef1f8064cd10d386,4,11,4,15,5,2012-05-14 22:12:51,2012-05-14 21:14:52
7b739c97028be2a5d5aef679ef1f8064cd10d386...24e7da4f1954dbe2e89f82950ed00292678534fd,1,6,0,6,1,2012-05-15 04:56:22,2012-05-09 23:10:05
24e7da4f1954dbe2e89f82950ed00292678534fd...ec1c5dfaee32f9638cedd28bb96bbbecce9d0cf0,5,135,51,186,31,2012-05-15 04:56:22,2012-05-09 23:27:15
ec1c5dfaee32f9638cedd28bb96bbbecce9d0cf0...8ad02bb5a8b20d5158f1ca4ac86d09b57f1465b4,1,23,0,23,1,2012-05-15 05:00:18,2012-05-14 22:53:26
8ad02bb5a8b20d5158f1ca4ac86d09b57f1465b4...d70223e53e46d2860d5c836036df37847cc04e35,1,1,1,2,1,2012-05-15 05:13:15,2012-05-15 05:13:15
d70223e53e46d2860d5c836036df37847cc04e35...301d8f233b363b27c5e8ded009ee5fd875c174fc,1,2,2,4,1,2012-05-15 07:09:08,2012-05-15 07:09:08
301d8f233b363b27c5e8ded009ee5fd875c174fc...acf095d1783e30e750d046ef24e81b5a0a31fbd4,3,89,43,132,23,2012-05-17 17:36:45,2012-05-09 23:27:15
acf095d1783e30e750d046ef24e81b5a0a31fbd4...91db99208e197a73584a88a8d835eeb55c466335,2,6,18,24,7,2012-05-17 22:47:52,2012-04-27 11:14:46
91db99208e197a73584a88a8d835eeb55c466335...84542d2431d20de42d6ec27c9d3435dd72dbe2ee,2,27,3,30,4,2012-05-17 22:47:53,2012-04-27 15:31:11
84542d2431d20de42d6ec27c9d3435dd72dbe2ee...1d388676e3b97b6171fc498e82545bd437ee6fd1,2,34,18,52,12,2012-05-22 21:18:15,2012-05-02 16:51:31
1d388676e3b97b6171fc498e82545bd437ee6fd1...15b8f205bb4e9797608ce440075e5149db6e6d45,1,2,2,4,2,2012-05-22 21:27:26,2012-04-24 09:39:05
15b8f205bb4e9797608ce440075e5149db6e6d45...4511d39cc748288df70bdc258f98a8f36652e683,8,284,1,285,10,2012-05-23 22:00:56,2012-05-23 06:05:26
4511d39cc748288df70bdc258f98a8f36652e683...5214c1d0cbd8473e1f5dd3894f1fcbecd89bc8af,2,10,1,11,2,2012-05-23 22:00:56,2012-05-23 06:39:07
5214c1d0cbd8473e1f5dd3894f1fcbecd89bc8af...989446eceee697b15ecb5df1f491dfbcff352256,2,45,12,57,13,2012-05-23 23:01:20,2012-05-23 21:49:01
989446eceee697b15ecb5df1f491dfbcff352256...bf6a0b7289e183784ac14c9652a6e038fde1fda4,1,50,0,50,1,2012-05-23 23:37:37,2012-05-23 22:46:28
bf6a0b7289e183784ac14c9652a6e038fde1fda4...5fdf42ce3949ccf5a2e1f2beee50b6b57279f53e,1,1,1,2,1,2012-05-24 04:05:21,2012-05-24 04:05:21
5fdf42ce3949ccf5a2e1f2beee50b6b57279f53e...b5fb18ae354831736bf56e9e6dccf6213ea24f16,1,0,0,0,0,2012-05-24 20:48:31,2012-05-12 14:59:12
b5fb18ae354831736bf56e9e6dccf6213ea24f16...3fdb29242b0db75a103dc65b34e14d6dac7890af,1,1,1,2,2,2012-05-24 20:48:38,2012-05-23 05:22:14
3fdb29242b0db75a103dc65b34e14d6dac7890af...4235ee9ad6edb56e49a852204a721715fa429e94,1,0,313,313,1,2012-05-24 20:48:40,2012-05-23 05:22:37
4235ee9ad6edb56e49a852204a721715fa429e94...7e70463da129dc7a668f234403bc530f562b9999,1,0,212,212,1,2012-05-24 20:48:42,2012-05-17 17:33:19
7e70463da129dc7a668f234403bc530f562b9999...bbaf9a287022a9aa6675e4aab9894fe5bd041ad7,4,13,13,26,13,2012-05-24 20:48:42,2012-05-17 05:20:35
bbaf9a287022a9aa6675e4aab9894fe5bd041ad7...416a7830403a579cc57cf3a0198193790dcd0bc6,2,1,5,6,1,2012-05-24 20:48:44,2012-05-18 21:39:09
416a7830403a579cc57cf3a0198193790dcd0bc6...4361efb03b79e71bf0cea92b94ff377ed718bad4,2,131,38,169,16,2012-06-01 17:57:51,2012-05-17 05:21:08
4361efb03b79e71bf0cea92b94ff377ed718bad4...885fb0dd0743859a8985c23e4d0c1855a2be711e,4,367,79,446,27,2012-06-01 23:56:31,2012-05-23 04:12:19
885fb0dd0743859a8985c23e4d0c1855a2be711e...7c2428218893f59c6a4499667488009ca67f3385,5,39,34,73,28,2012-06-01 23:57:49,2012-06-01 18:31:10
7c2428218893f59c6a4499667488009ca67f3385...0a6e464a93d9a1e76a624b356054ce9ca4015f55,7,113,86,199,66,2012-06-02 00:01:10,2012-05-17 23:36:18
0a6e464a93d9a1e76a624b356054ce9ca4015f55...85632cb44c95617d73c369f3a03fb476a4d5c8a2,5,47,3,50,8,2012-06-02 21:50:58,2012-05-18 21:53:11
85632cb44c95617d73c369f3a03fb476a4d5c8a2...8aa18f0ad036fd4f2dc26f54d80754c70232b4f7,3,19,15,34,12,2012-06-02 21:51:03,2012-05-18 22:26:09
8aa18f0ad036fd4f2dc26f54d80754c70232b4f7...92a2e1807657c69e1372106b0727675a30f4cbd7,5,246,62,308,30,2012-06-02 22:44:58,2012-05-22 23:45:56
92a2e1807657c69e1372106b0727675a30f4cbd7...275e5335dcecb1d5af014267b61c0b75173f5b68,1,1,1,2,1,2012-06-02 22:44:58,2012-05-23 19:05:05
275e5335dcecb1d5af014267b61c0b75173f5b68...2356c216509defef8d78c4cbaa1306622f771b3c,1,2,2,4,2,2012-06-02 23:02:04,2012-05-25 20:56:13
2356c216509defef8d78c4cbaa1306622f771b3c...f5afcca99dcf49f3382a5e69d97030f63113af6e,3,227,236,463,3,2012-06-02 23:02:04,2012-02-24 23:12:15
f5afcca99dcf49f3382a5e69d97030f63113af6e...6933fb7924cd1ef01e9259c53bf76023a87d61aa,10,114,177,291,10,2012-06-02 23:02:05,2012-02-25 00:14:44
6933fb7924cd1ef01e9259c53bf76023a87d61aa...581f93ae56ebb0086d0c0989df69a28656395006,1,164,0,164,1,2012-06-02 23:02:05,2012-02-25 00:20:35
581f93ae56ebb0086d0c0989df69a28656395006...2e90cdc3d4dff966faed97d3a566e9d9c00c9794,12,244,290,534,13,2012-06-02 23:02:05,2012-02-27 20:14:48
2e90cdc3d4dff966faed97d3a566e9d9c00c9794...dd38ce6585b0e7ffa755f4c65d78ed90204729d1,11,348,358,706,22,2012-06-02 23:02:07,2012-02-28 20:14:47
dd38ce6585b0e7ffa755f4c65d78ed90204729d1...41d26db32c1c013dd33faa03df85e38681a9ebb1,2,69,94,163,14,2012-06-02 23:02:08,2012-02-28 22:29:58
41d26db32c1c013dd33faa03df85e38681a9ebb1...321a4a6b1f74d09c02f1b78cf368ea9f9ae1c776,1,0,0,0,0,2012-06-02 23:02:08,2012-02-28 22:58:50
321a4a6b1f74d09c02f1b78cf368ea9f9ae1c776...0f5259c5a2c3aa390866ad4f18dd500e9e7e1e4f,1,11,11,22,3,2012-06-02 23:02:08,2012-02-28 22:59:53
0f5259c5a2c3aa390866ad4f18dd500e9e7e1e4f...a3a37c2063a9098539a59444b8e4a52959f3ee24,4,143,74,217,4,2012-06-02 23:02:08,2012-02-29 19:29:46
a3a37c2063a9098539a59444b8e4a52959f3ee24...f0be543614d5c2c3f492e1ed73ec964bd8a3d381,5,58,23,81,11,2012-06-02 23:02:08,2012-03-01 19:28:50
f0be543614d5c2c3f492e1ed73ec964bd8a3d381...0532aabcf97a08badd6ed67ad40453d37da89556,24,53,53,106,49,2012-06-02 23:02:08,2012-05-24 21:49:47
0532aabcf97a08badd6ed67ad40453d37da89556...7019f142ab79940eb4fc5b26fdcfdf2caf1d2b73,1,1,1,2,1,2012-06-02 23:02:09,2012-05-25 22:14:56
7019f142ab79940eb4fc5b26fdcfdf2caf1d2b73...073e76f8353ca3f743ea61ff21f7de7b1e5a7701,3,94,94,188,14,2012-06-02 23:02:09,2012-05-24 22:29:51
073e76f8353ca3f743ea61ff21f7de7b1e5a7701...8024a5742c46a42ef204988ff7362a4fc14b7a2d,3,107,10,117,14,2012-06-02 23:02:09,2012-05-25 17:29:54
8024a5742c46a42ef204988ff7362a4fc14b7a2d...676d6e0040c14589f19f36dc4e9ccaa9410f2312,1,0,164,164,1,2012-06-02 23:02:09,2012-05-25 22:52:29
676d6e0040c14589f19f36dc4e9ccaa9410f2312...ddefb424455912e2b5f2d92bbf2d61ddf55470c4,1,1,1,2,1,2012-06-02 23:02:09,2012-05-25 22:52:44
ddefb424455912e2b5f2d92bbf2d61ddf55470c4...22143381d80482f5145e984a498a9549ad7f4e53,1,2,2,4,1,2012-06-04 17:03:59,2012-06-04 17:03:37
22143381d80482f5145e984a498a9549ad7f4e53...1904596e0c2330299e92f092bd7a6ceca8e97c30,2,7,2,9,3,2012-06-05 00:43:14,2012-06-01 21:50:01
1904596e0c2330299e92f092bd7a6ceca8e97c30...a57141fd1d24962982e512c65e0e16d9b5edefe4,3,9,9,18,9,2012-06-05 01:46:09,2012-04-25 17:33:04
a57141fd1d24962982e512c65e0e16d9b5edefe4...bcc3a021ebbdc33f826cc668e40de360ee6a6b23,2,8,4,12,3,2012-06-08 22:27:02,2012-06-05 04:11:35
bcc3a021ebbdc33f826cc668e40de360ee6a6b23...2491319575f26fa8247b247247e223d5822ee61c,1,123,122,245,84,2012-06-08 22:27:02,2012-06-04 19:08:27
2491319575f26fa8247b247247e223d5822ee61c...9be82d942fc6ab2772197c84a35a4c374c604cbc,4,39,44,83,20,2012-06-08 22:27:03,2012-06-04 22:06:02
9be82d942fc6ab2772197c84a35a4c374c604cbc...5c95b8cccc0d72f7ca3afb1162b9528c1222eb3c,3,11,11,22,7,2012-06-08 22:27:04,2012-06-08 18:53:17
5c95b8cccc0d72f7ca3afb1162b9528c1222eb3c...c3a41ff9fefe894663c4d4f40a83794521deb14f,5,293,218,511,30,2012-06-08 22:50:13,2012-06-06 20:58:10
c3a41ff9fefe894663c4d4f40a83794521deb14f...10f80d7d2918f98262090b425ecc294d9518aa7e,2,4,4,8,3,2012-06-08 23:07:15,2012-06-08 00:10:39
10f80d7d2918f98262090b425ecc294d9518aa7e...fb99b539b4d851773b43f1564f7032adb157c0db,2,19,0,19,5,2012-06-08 23:07:15,2012-06-06 14:23:07
fb99b539b4d851773b43f1564f7032adb157c0db...b5bba65a9353ca9dc03b8d0c3c9b06d9c4cdacdf,1,5,2,7,1,2012-06-09 13:57:55,2012-06-09 13:57:55
b5bba65a9353ca9dc03b8d0c3c9b06d9c4cdacdf...5d70e4a89cd9b3d430bb81f438cf03e956d9a9d2,7,31,36,67,18,2012-06-10 16:01:42,2012-06-10 16:01:42
5d70e4a89cd9b3d430bb81f438cf03e956d9a9d2...d37d595b67ccb673e37187c050005ee1462cf243,1,4,4,8,4,2012-06-11 00:42:44,2012-06-11 00:42:44
d37d595b67ccb673e37187c050005ee1462cf243...2d48733723d87439775412247ce1558ed444eb33,1,89,0,89,1,2012-06-11 07:03:01,2012-06-11 06:57:13
2d48733723d87439775412247ce1558ed444eb33...068f2f9d43cb88bee1b7637f13ff6847f143bbdf,1,1,1,2,1,2012-06-11 07:03:01,2012-06-11 06:57:45
068f2f9d43cb88bee1b7637f13ff6847f143bbdf...f3f090da8a3729f817fd62ea3a6ecee84614c43f,1,2,2,4,1,2012-06-11 21:10:02,2012-06-11 21:09:34
f3f090da8a3729f817fd62ea3a6ecee84614c43f...fc0b2b5715655a05cbb4c8e79969c95d7e7ce8b7,30,3360,24,3384,4,2012-06-11 21:13:18,2012-06-11 21:13:18
fc0b2b5715655a05cbb4c8e79969c95d7e7ce8b7...f16150d5f1b20b3d633b4402095ea89baa4be042,106,803,799,1602,579,2012-06-12 07:10:18,2012-06-12 06:49:24
f16150d5f1b20b3d633b4402095ea89baa4be042...d9ff5fd432314d2b5f5e6766240c918f10d3b83d,1,5,3,8,3,2012-06-12 07:11:04,2012-06-12 07:11:04
d9ff5fd432314d2b5f5e6766240c918f10d3b83d...ee6014a3aa90232ed263fe9c9e0860c777b37a30,1,4,3,7,4,2012-06-12 07:27:24,2012-06-12 07:18:54
ee6014a3aa90232ed263fe9c9e0860c777b37a30...74fa65ecb7c4e2df966a179952b35700912e065f,2,44,8,52,8,2012-06-12 07:27:25,2012-06-12 04:24:23
74fa65ecb7c4e2df966a179952b35700912e065f...9af7a9198e2d30608ea6c40eedde03e44a6ef569,9,6,176,182,11,2012-06-12 08:09:07,2012-06-12 07:35:28
9af7a9198e2d30608ea6c40eedde03e44a6ef569...f158d81d21c5c6d8fe2331abf8e527e8fc45d4a9,2,4,11,15,10,2012-06-12 08:14:45,2012-06-12 08:14:45
f158d81d21c5c6d8fe2331abf8e527e8fc45d4a9...da94b03af7acab041be37a3d8ccddb340a16ee92,1,19,0,19,1,2012-06-12 08:45:26,2012-06-12 08:45:26
da94b03af7acab041be37a3d8ccddb340a16ee92...7fa1995e08a4b34302f1084af4f5f38190e3fe20,1,2,2,4,1,2012-06-12 08:46:02,2012-06-12 08:46:02
7fa1995e08a4b34302f1084af4f5f38190e3fe20...f6b09b913968d578010ca757e9d0d9ceed67027a,1,2,2,4,1,2012-06-13 17:46:22,2012-06-13 17:46:22
f6b09b913968d578010ca757e9d0d9ceed67027a...0f44964e5e0f7e37d7fa3216bb10fd61fbf52ae2,2,31,1,32,2,2012-06-13 17:49:05,2012-06-12 20:33:57
0f44964e5e0f7e37d7fa3216bb10fd61fbf52ae2...6593a3e0823f3c08079f05010f9628fc4503cd43,3,126,34,160,23,2012-06-14 17:48:56,2012-06-13 22:37:52
6593a3e0823f3c08079f05010f9628fc4503cd43...6dfe5be1556dc0c770cea8af78d1e0829ed24848,1,16,1,17,1,2012-06-14 17:50:22,2012-06-13 17:58:59
6dfe5be1556dc0c770cea8af78d1e0829ed24848...519bef4f3d1cdac497c782f77457fd2f67184601,1,1,1,2,1,2012-06-14 17:50:22,2012-06-14 14:21:29
519bef4f3d1cdac497c782f77457fd2f67184601...ad5d2f2991ecfe1ec6152be71982b8980236c988,8,417,1,418,5,2012-06-15 17:40:25,2012-06-15 17:25:16
ad5d2f2991ecfe1ec6152be71982b8980236c988...3da4194f98fa0c1ad1e5ab159719e4b25799e6d4,2,17,2,19,2,2012-06-20 19:18:48,2012-06-16 20:04:40
3da4194f98fa0c1ad1e5ab159719e4b25799e6d4...1e6d4d5f5441947571d939920b7dd2fce4059040,14,158,157,315,35,2012-06-21 20:58:24,2012-06-18 18:42:44
1e6d4d5f5441947571d939920b7dd2fce4059040...869143ec7d332bdc2f81fae58cfcbd08305a5790,6,270,270,540,62,2012-06-21 20:58:24,2012-06-21 20:42:14
869143ec7d332bdc2f81fae58cfcbd08305a5790...0d57f1373f783bddee3f5fdcf1d6702e62bba13e,1,1,1,2,1,2012-06-21 20:59:53,2012-06-21 20:59:53
0d57f1373f783bddee3f5fdcf1d6702e62bba13e...ffb270130a4aaf3ddc2eb9d6211b46e1da136184,2,9,0,9,2,2012-06-22 17:21:31,2012-06-22 17:21:31
ffb270130a4aaf3ddc2eb9d6211b46e1da136184...3f14a45aa5894e5a30e946a1418e7c9f18f00691,1,17,0,17,1,2012-06-25 16:30:57,2012-06-25 15:18:50
3f14a45aa5894e5a30e946a1418e7c9f18f00691...9bef436b22f0cd57c294f1db1958f46e64fcfed1,1,2,2,4,1,2012-06-25 16:30:57,2012-06-25 14:59:35
9bef436b22f0cd57c294f1db1958f46e64fcfed1...35706ba4821af4779d1c759c5cba752f55229367,1,2,2,4,1,2012-06-25 19:52:32,2012-06-25 19:52:17
35706ba4821af4779d1c759c5cba752f55229367...212f685e0634a60687cae0d0824dea64accb0b26,1,1,1,2,1,2012-06-26 03:36:41,2012-06-26 03:36:41
212f685e0634a60687cae0d0824dea64accb0b26...6d9313a68d82654d389c0b2c3e4af148382f14be,1,4,4,8,4,2012-07-02 15:21:19,2012-06-26 21:49:57
6d9313a68d82654d389c0b2c3e4af148382f14be...f0a090ddf256d0c144e705c0cdf4216d824140f9,2,2,2,4,2,2012-07-02 15:21:19,2012-06-26 21:50:19
f0a090ddf256d0c144e705c0cdf4216d824140f9...a8b04004e3200b988543b0f2842d9071988d10c9,1,12,2,14,3,2012-07-02 15:21:19,2012-07-02 15:19:14
a8b04004e3200b988543b0f2842d9071988d10c9...5026315d6f4495d636d86ae2a022fb55cc0ca211,1,1,1,2,1,2012-07-16 18:40:21,2012-06-22 21:13:11
5026315d6f4495d636d86ae2a022fb55cc0ca211...1f2d50000e82630bfce6eb9cf0a8da752fd1e826,1,23,23,46,18,2012-07-16 19:10:33,2012-07-12 02:17:56
1f2d50000e82630bfce6eb9cf0a8da752fd1e826...2473412ba55f7c47f2ca24311312ce95ee11949e,1,10,12,22,7,2012-07-16 19:10:42,2012-07-11 19:26:53
2473412ba55f7c47f2ca24311312ce95ee11949e...c076fe08cf47e8af4b5e8845aed917ebb7dbd593,1,6,6,12,6,2012-07-16 19:10:43,2012-07-12 02:27:13
c076fe08cf47e8af4b5e8845aed917ebb7dbd593...4c5850195699b1d982963f25399d24bf8b815f81,1,1,1,2,1,2012-07-16 19:33:19,2012-07-02 09:06:12
4c5850195699b1d982963f25399d24bf8b815f81...92a3d2821856c75eb95f8ec6ccf26d6a9b37fdd9,1,1,1,2,1,2012-07-18 18:52:57,2012-07-18 18:31:53
92a3d2821856c75eb95f8ec6ccf26d6a9b37fdd9...161362164532af3578c9e3e8b52cd80b15345add,1,1,1,2,1,2012-07-18 19:16:14,2012-07-18 19:00:45
161362164532af3578c9e3e8b52cd80b15345add...01e726b2fa3fb0d2584c9bb8df116ff3a9f05879,1,1,1,2,1,2012-07-18 22:15:09,2012-07-18 20:23:20
01e726b2fa3fb0d2584c9bb8df116ff3a9f05879...d56d69cc8319f69135a17a9bb5ae394123b33c51,1,2,2,4,2,2012-07-18 22:20:38,2012-07-18 19:23:52
d56d69cc8319f69135a17a9bb5ae394123b33c51...1fd2b3d402f36e395a1fe9ea7e3f91a1b2833426,1,1,1,2,1,2012-07-18 22:42:29,2012-07-18 20:36:24
1fd2b3d402f36e395a1fe9ea7e3f91a1b2833426...7f6e1326f3a7a6a2ba2dbd48dd6571ebe929a7c1,1,1,1,2,1,2012-07-18 22:48:08,2012-07-18 20:30:36
7f6e1326f3a7a6a2ba2dbd48dd6571ebe929a7c1...64a9cd8f4fac1c518869a1c955fe60bd6ef76439,1,1,1,2,1,2012-07-19 16:02:04,2012-07-18 19:38:39
64a9cd8f4fac1c518869a1c955fe60bd6ef76439...79f2d843a8458bfdc23fe9f179a1416fe21f7533,1,1,1,2,1,2012-07-19 16:04:59,2012-07-19 15:44:06
79f2d843a8458bfdc23fe9f179a1416fe21f7533...b6b92bd866e1d6d066f1c9bf1937496cd3e28664,1,1,1,2,1,2012-07-19 16:09:52,2012-07-19 15:10:38
b6b92bd866e1d6d066f1c9bf1937496cd3e28664...206371b7372c242db234ca8da12d1c7a8a322d54,1,3,3,6,3,2012-07-19 16:26:34,2012-07-19 16:08:21
206371b7372c242db234ca8da12d1c7a8a322d54...fbfda241f616bcfe8273f501dd49120a3cb35fab,1,1,1,2,1,2012-07-19 16:35:43,2012-07-19 14:12:40
fbfda241f616bcfe8273f501dd49120a3cb35fab...ab6937e2518bfd77d9fe42e3d2e11fe4a7a16814,1,4,4,8,3,2012-07-19 16:49:44,2012-07-19 15:05:00
ab6937e2518bfd77d9fe42e3d2e11fe4a7a16814...31c825607dd524241c811ca3e401b119c810e977,1,2,2,4,1,2012-07-19 16:54:53,2012-07-19 14:21:06
31c825607dd524241c811ca3e401b119c810e977...6f9a5721bcf501974bae748b94ed3e2d3893135c,1,1,1,2,1,2012-07-19 16:57:58,2012-07-18 19:26:09
6f9a5721bcf501974bae748b94ed3e2d3893135c...17209d5b4a579edf8425715b5cdf25bc5cd96711,1,2,2,4,2,2012-07-19 17:01:50,2012-06-19 15:48:04
17209d5b4a579edf8425715b5cdf25bc5cd96711...13b5fd1b9d60f1a9187da8a89db9272284ccdac4,1,7,7,14,5,2012-07-19 17:04:22,2012-06-19 19:38:02
13b5fd1b9d60f1a9187da8a89db9272284ccdac4...6553fe68d17d42ec25e0c592ceaa1077cc0ec4f6,1,2,2,4,2,2012-07-19 18:05:38,2012-07-19 17:51:23
6553fe68d17d42ec25e0c592ceaa1077cc0ec4f6...bde931afd5cf2483df236e06992666a0a4182794,1,1,1,2,1,2012-07-19 18:28:19,2012-07-19 18:19:25
bde931afd5cf2483df236e06992666a0a4182794...8c81a0f3728b9308854ceb9bf392ec467b95d8eb,1,2,2,4,2,2012-07-19 22:04:29,2012-07-19 20:00:17
8c81a0f3728b9308854ceb9bf392ec467b95d8eb...5ef9ed87d82b109715a87e9aa1b1d5b63f515d3a,1,5,5,10,3,2012-07-19 22:23:21,2012-07-19 18:22:49
5ef9ed87d82b109715a87e9aa1b1d5b63f515d3a...d3952b79c7d3fe024ba2cf886dc9225d3107d342,1,2,2,4,1,2012-07-20 04:48:45,2012-07-02 15:19:14
d3952b79c7d3fe024ba2cf886dc9225d3107d342...6e2d9711e8210f7fca216024fbe074eca302c98f,1,2,2,4,1,2012-07-20 04:48:58,2012-07-12 23:08:32
6e2d9711e8210f7fca216024fbe074eca302c98f...e3e8813e3c586093c79cffe2b17418c0c1797d4a,2,20,14,34,12,2012-07-20 04:56:22,2012-06-13 20:37:19
e3e8813e3c586093c79cffe2b17418c0c1797d4a...a1107e81ebf2254caf75718de2e3ec773cce0c56,1,1,1,2,1,2012-07-21 03:54:42,2012-07-20 13:10:33
a1107e81ebf2254caf75718de2e3ec773cce0c56...b84eaffd3953f8941d6d788d1724dd0e3f918874,1,6,0,6,1,2012-07-31 04:20:28,2012-07-31 04:20:28
b84eaffd3953f8941d6d788d1724dd0e3f918874...33ad2b4126aa8006c1160da1819612a593be5040,1,1,3,4,2,2012-07-31 04:21:34,2012-07-31 04:21:34
33ad2b4126aa8006c1160da1819612a593be5040...77e6d833f6818cbf3eecbe8e7cf640453af36ee1,1,4,1,5,1,2012-08-04 19:09:28,2012-08-04 19:09:28
77e6d833f6818cbf3eecbe8e7cf640453af36ee1...eee9a51faddc167479ed7533ea5488fe1504f4c1,1,5,0,5,1,2012-08-06 23:54:18,2012-08-06 23:54:18
eee9a51faddc167479ed7533ea5488fe1504f4c1...54e4a6ffbf9de21d33bc9f770db93677590d148a,1,50,33,83,21,2012-08-07 17:15:54,2012-08-07 17:15:54
54e4a6ffbf9de21d33bc9f770db93677590d148a...c25cb7d48872fbb37b68f57c9c493ed8bb86a140,1,33,30,63,2,2012-08-08 00:23:16,2012-08-08 00:23:16
c25cb7d48872fbb37b68f57c9c493ed8bb86a140...5cec32492c52209ce11b38b8180f9bdb909d041b,1,14,6,20,4,2012-08-08 05:07:49,2012-08-08 05:03:02
5cec32492c52209ce11b38b8180f9bdb909d041b...054d40f338f9000cddcf7f0513af37328b88ef41,2,146,33,179,13,2012-08-10 20:03:55,2012-08-08 05:08:03
054d40f338f9000cddcf7f0513af37328b88ef41...c0d638a94b914edc76c5532c08a47ec4e60308d4,1,16,1,17,3,2012-08-10 20:04:39,2012-08-10 17:24:28
c0d638a94b914edc76c5532c08a47ec4e60308d4...4ccd9eb88321f8554ee4dc41b7f8068ce2306765,1,2,2,4,1,2012-08-10 21:50:22,2012-08-09 10:47:57
4ccd9eb88321f8554ee4dc41b7f8068ce2306765...167aa0c29c998be33c49d33302e099b36d1ce0be,3,32,13,45,14,2012-08-10 21:53:53,2012-08-09 17:20:39
167aa0c29c998be33c49d33302e099b36d1ce0be...9767f7bdd3e1ce6f65bdea992d67369ead13d813,2,21,4,25,4,2012-08-10 23:14:30,2012-08-10 22:38:05
9767f7bdd3e1ce6f65bdea992d67369ead13d813...e0a54f6b206dc2b6595f2bc3a17c5932e7477545,4,34,7,41,10,2012-08-10 23:17:59,2012-08-04 19:11:00
e0a54f6b206dc2b6595f2bc3a17c5932e7477545...536de148214290f0b4a0595fa16c00da5e527e79,1,6,2,8,2,2012-08-10 23:27:44,2012-07-19 17:50:36
536de148214290f0b4a0595fa16c00da5e527e79...2e3651686c2bd84cf464ecc236c8ad77e61179df,1,8,8,16,5,2012-08-10 23:27:44,2012-08-07 23:58:11
2e3651686c2bd84cf464ecc236c8ad77e61179df...e05a97c6f5bcef1ae300c7d4181fcf2a34f0aab1,1,10,6,16,1,2012-08-10 23:33:13,2012-07-19 20:51:29
e05a97c6f5bcef1ae300c7d4181fcf2a34f0aab1...f00b6cca024a9418f353651f29c984f934575bd9,1,3,0,3,1,2012-08-10 23:33:25,2012-07-19 20:52:20
f00b6cca024a9418f353651f29c984f934575bd9...00683a8bbbd14272ed994b96330c4c0306251741,5,10,10,20,10,2012-08-12 17:44:29,2012-08-12 17:36:09
00683a8bbbd14272ed994b96330c4c0306251741...9be169365ce54a810c6e51a36f758b0eb195b290,1,3,16,19,4,2012-08-12 17:45:14,2012-08-12 17:45:14
9be169365ce54a810c6e51a36f758b0eb195b290...15d283b1140ec8f1ec3098c1ad684b02889b085e,1,1,1,2,1,2012-08-13 16:48:21,2012-08-11 05:01:26
15d283b1140ec8f1ec3098c1ad684b02889b085e...20348717640c0ef405c9fdcc8fec5b566efc48b3,2,43,13,56,3,2012-08-13 16:48:21,2012-08-11 05:02:13
20348717640c0ef405c9fdcc8fec5b566efc48b3...cf6023ef2215ef9f7be970413763abb72253f179,1,5,3,8,3,2012-08-13 16:48:22,2012-08-11 05:23:36
cf6023ef2215ef9f7be970413763abb72253f179...58f121a5c293ed57043e22ed526fdf99642fca81,2,48,2,50,4,2012-08-13 16:48:22,2012-08-11 05:24:42
58f121a5c293ed57043e22ed526fdf99642fca81...44345c74decfd2e303ada9c958af8e9a07bb8336,1,61,61,122,20,2012-08-13 16:48:22,2012-08-11 00:37:06
44345c74decfd2e303ada9c958af8e9a07bb8336...e85774f709b9f681b0ff8d829b07568b0f844a62,2,42,2,44,3,2012-08-13 16:48:23,2012-07-19 08:10:12
e85774f709b9f681b0ff8d829b07568b0f844a62...0f37194fb7ce67c3719626d9e21d95a66538a0e4,2,7,6,13,5,2012-08-13 16:48:23,2012-08-11 06:46:42
0f37194fb7ce67c3719626d9e21d95a66538a0e4...dfe99836cd98c2a1b0f9bde6216bd44088de275a,2,53,0,53,4,2012-08-13 21:33:56,2012-08-11 07:13:10
dfe99836cd98c2a1b0f9bde6216bd44088de275a...cab5e1d9b363eac6fd31b15c5b86f30993e2f147,1,6,6,12,3,2012-08-16 18:26:36,2012-08-16 18:26:36
cab5e1d9b363eac6fd31b15c5b86f30993e2f147...f7b4296c389c57a03a411dfc89776f21d66569fd,1,1,1,2,1,2012-08-23 08:02:28,2012-08-23 08:02:28
f7b4296c389c57a03a411dfc89776f21d66569fd...32137cab820d144bf327849a26116e6ee8160797,1,1,1,2,1,2012-08-23 19:11:07,2012-08-23 19:02:31
32137cab820d144bf327849a26116e6ee8160797...3e12bc481d7a6b089c32e79b45991294d046872f,1,6,1,7,1,2012-08-24 21:54:34,2012-08-20 15:32:01
3e12bc481d7a6b089c32e79b45991294d046872f...4a4b28dbf3af9a1871f00dfeded6da9eda557412,9,157,6,163,13,2012-08-24 21:54:35,2012-08-20 15:28:04
4a4b28dbf3af9a1871f00dfeded6da9eda557412...f7ac8ef97a12282e66eb540a542c09b9d14b2874,3,21,3,24,4,2012-08-25 09:30:55,2012-08-25 09:30:55
f7ac8ef97a12282e66eb540a542c09b9d14b2874...fa6c8c313111d0a0b4f6e3eb2abd65f4f77cfc04,1,13,9,22,3,2012-08-27 19:26:04,2012-08-27 19:25:40
fa6c8c313111d0a0b4f6e3eb2abd65f4f77cfc04...d05a2809a12ef84166e3fb5dcf3eddf887903654,1,0,30,30,1,2012-08-27 21:59:17,2012-05-25 23:17:36
d05a2809a12ef84166e3fb5dcf3eddf887903654...bf8ed8a5324183577f0465038272fc9673bb3e72,1,24,129,153,11,2012-08-27 21:59:18,2012-05-30 17:40:59
bf8ed8a5324183577f0465038272fc9673bb3e72...fa62ea810f6c701e898dd07c6c9228f13d5b5e02,1,1,1,2,1,2012-08-27 21:59:18,2012-06-01 21:58:51
fa62ea810f6c701e898dd07c6c9228f13d5b5e02...c269eb3d261dffd95e2827df9f7c5f55d6fdc8c7,1,1,1,2,1,2012-08-27 21:59:19,2012-06-02 23:25:52
c269eb3d261dffd95e2827df9f7c5f55d6fdc8c7...7e18724dfafa82146b4424ae82c3f18245b67814,1,4,4,8,4,2012-08-27 22:01:50,2012-06-02 07:04:15
7e18724dfafa82146b4424ae82c3f18245b67814...96697f464fdce21480f52b4cf6d74a267058f63d,1,2,2,4,2,2012-08-27 22:44:38,2012-06-12 18:06:06
96697f464fdce21480f52b4cf6d74a267058f63d...7a5f25f6671eb5f51b06615d74a05855ab79f31e,15,7961,2,7963,6,2012-08-27 22:44:38,2012-05-29 23:25:21
7a5f25f6671eb5f51b06615d74a05855ab79f31e...e8ded01cf5a79aa2aa598670cd3ed88641c2c362,1,19,21,40,1,2012-08-27 22:44:38,2012-06-12 17:01:43
e8ded01cf5a79aa2aa598670cd3ed88641c2c362...b08d4b22d2f70acfcbc52369dc7032397137d037,1,42,84,126,13,2012-08-28 19:38:34,2012-08-28 19:38:34
b08d4b22d2f70acfcbc52369dc7032397137d037...d6706efe7f6316ce1a6ffe33f7bc3e161553b94d,3,53,46,99,19,2012-08-28 23:06:50,2012-08-28 19:53:30
d6706efe7f6316ce1a6ffe33f7bc3e161553b94d...1702e49548e1857f4cc2db34125e71e98c6f6b1c,1,0,1,1,1,2012-08-29 21:58:10,2012-08-29 08:22:00
1702e49548e1857f4cc2db34125e71e98c6f6b1c...e0184d4aef70429c52eede6b13ab77a29d26951b,1,1,1,2,1,2012-08-29 23:56:48,2012-08-29 23:56:48
e0184d4aef70429c52eede6b13ab77a29d26951b...8693eac417ff1f8c21a8dedb45c290ee0b408da1,2,13,7,20,3,2012-08-30 09:26:35,2012-08-29 08:59:54
8693eac417ff1f8c21a8dedb45c290ee0b408da1...d3fa7a2e9e93c9dae13d852b28c878f7d6b7c420,2,2,2,4,2,2012-08-30 17:53:23,2012-08-29 11:01:13
d3fa7a2e9e93c9dae13d852b28c878f7d6b7c420...d804bbcd51ec83bee1f4a3ccd42c3bd7eb38a988,3,40,11,51,7,2012-08-30 21:50:22,2012-07-19 21:07:00
d804bbcd51ec83bee1f4a3ccd42c3bd7eb38a988...9398040a41d0041f949d5b5219eaaf1074cd5699,1,14,3,17,5,2012-08-30 22:15:11,2012-07-27 18:01:06
9398040a41d0041f949d5b5219eaaf1074cd5699...8114d55a153b1e27ca0bd53aa97a175c925b7c1f,1,40,20,60,12,2012-08-30 22:15:11,2012-07-27 18:29:48
8114d55a153b1e27ca0bd53aa97a175c925b7c1f...1a8642aac2de40dccdab464e58dc164006c300bb,1,25,3,28,7,2012-08-30 22:18:09,2012-08-30 21:42:46
1a8642aac2de40dccdab464e58dc164006c300bb...0a71753ce3f4fe241e15fa489617b82710be4648,4,156,1,157,10,2012-08-30 22:20:40,2012-05-08 21:00:38
0a71753ce3f4fe241e15fa489617b82710be4648...aff68a9ddff0600b3fc02879c1b0d2b4070e64ca,1,1,1,2,1,2012-08-30 22:22:08,2012-08-27 19:21:36
aff68a9ddff0600b3fc02879c1b0d2b4070e64ca...dbefd671e41c3bda481850bb7e566349e275d759,1,4,3,7,3,2012-08-30 22:25:20,2012-08-26 02:56:51
dbefd671e41c3bda481850bb7e566349e275d759...847d2da0f8d1e265eda7b4dd3e7eb52ac86d784e,1,24,24,48,16,2012-08-30 22:25:21,2012-08-26 03:21:32
847d2da0f8d1e265eda7b4dd3e7eb52ac86d784e...351deb555fc854d21670ff664054033f3a1caa0f,1,1,2,3,1,2012-08-30 22:28:15,2012-08-25 13:40:48
351deb555fc854d21670ff664054033f3a1caa0f...14c8f6a7ca72f4f2aac3bd396a2df7dacd6205fa,1,1,1,2,1,2012-08-30 22:31:29,2012-08-16 07:48:13
14c8f6a7ca72f4f2aac3bd396a2df7dacd6205fa...5318588d6e8ee9a31f4002affd6858d25305aabf,3,3,0,3,3,2012-08-30 22:36:42,2012-08-15 22:04:51
5318588d6e8ee9a31f4002affd6858d25305aabf...c023c850c33701aa2d935b4bd0cea72602982e68,11,30,19,49,16,2012-08-30 22:43:58,2012-08-08 14:12:54
c023c850c33701aa2d935b4bd0cea72602982e68...f5f1200f2539fd6dadc250dc8a4a3ab49e6167a5,1,1,1,2,1,2012-08-30 22:49:11,2012-08-06 08:44:48
f5f1200f2539fd6dadc250dc8a4a3ab49e6167a5...0f05516d14329a5e080969c174fb7535b3a43cbe,1,4,0,4,1,2012-08-30 22:58:55,2012-08-30 22:58:36
0f05516d14329a5e080969c174fb7535b3a43cbe...5cb7297a08649107d5155a22477c8c3511372034,9,20,20,40,18,2012-08-30 23:02:24,2012-08-05 19:16:37
5cb7297a08649107d5155a22477c8c3511372034...62cfedbe0cae33d3d52830df2aa56958e0486b8b,1,3,3,6,3,2012-08-30 23:10:39,2012-08-01 20:43:11
62cfedbe0cae33d3d52830df2aa56958e0486b8b...a62c7b8b4eaba2979e19c3b0438d67fcdc5f9e1a,1,4,2,6,2,2012-08-30 23:25:23,2012-08-30 23:25:02
a62c7b8b4eaba2979e19c3b0438d67fcdc5f9e1a...1b34c6d558ab2c138d9e432553f4aebfdeeb5084,2,6,5,11,2,2012-08-31 05:09:16,2012-07-18 18:55:52
1b34c6d558ab2c138d9e432553f4aebfdeeb5084...9a710c788d880785d2b02a9c5411eb15e9c278bf,1,3,2,5,1,2012-08-31 05:13:20,2012-07-18 19:21:03
9a710c788d880785d2b02a9c5411eb15e9c278bf...acb499f820977df620fd5314c7dea9dd6bd51a10,11,51,34,85,31,2012-08-31 05:19:34,2012-07-15 16:18:42
acb499f820977df620fd5314c7dea9dd6bd51a10...b12d1b68131dd538b34a9cd72011f37722b90b28,1,19,3,22,1,2012-08-31 05:33:30,2012-08-27 18:10:28
b12d1b68131dd538b34a9cd72011f37722b90b28...db861db1f239bdb2c13f157e2632cb2bc76f0432,1,96,0,96,1,2012-08-31 20:59:03,2012-08-31 20:04:12
db861db1f239bdb2c13f157e2632cb2bc76f0432...5e9041818bca770c9261a3963e05dbb3c7ca2f06,4,1,156,157,10,2012-08-31 20:59:03,2012-08-31 20:41:10
5e9041818bca770c9261a3963e05dbb3c7ca2f06...b22308152f0befb90defa8e88f96171841791063,1,1,1,2,1,2012-08-31 20:59:03,2012-08-31 20:49:49
b22308152f0befb90defa8e88f96171841791063...b8fac353f07c00c21a16926740aaec4b1c8cb487,2,1,5,6,2,2012-09-04 18:11:09,2012-08-31 23:29:49
b8fac353f07c00c21a16926740aaec4b1c8cb487...d0c0eadeddf6382cc8d8996fc9ac1f5cddf4d97a,1,1,1,2,1,2012-09-04 18:11:09,2012-08-31 20:31:04
d0c0eadeddf6382cc8d8996fc9ac1f5cddf4d97a...b1f50307b32283e8800062290ce56562177499bc,1,1,1,2,1,2012-09-04 23:31:57,2012-09-04 23:30:33
b1f50307b32283e8800062290ce56562177499bc...f353fea042b33066009af38d19054774aa52562d,1,7,1,8,2,2012-09-04 23:38:01,2012-09-04 23:38:01
f353fea042b33066009af38d19054774aa52562d...99a000bac2ecb4c4fb48499c55422ab0a6e84d51,1,1,1,2,1,2012-09-05 01:15:00,2012-09-05 01:15:00
99a000bac2ecb4c4fb48499c55422ab0a6e84d51...9b08bfa251f0b632476edab74d8acffb1f19e879,1,2,2,4,1,2012-09-06 17:41:23,2012-09-06 17:41:23
9b08bfa251f0b632476edab74d8acffb1f19e879...05c88b866bdcd426d09fdb070cc67af718a41557,1,2,2,4,2,2012-09-06 22:03:35,2012-09-06 22:03:35
05c88b866bdcd426d09fdb070cc67af718a41557...f299fd512248321b426a5ab924a329aa1b691280,2,14,1,15,2,2012-09-06 23:06:19,2012-05-25 12:49:40
f299fd512248321b426a5ab924a329aa1b691280...42c38b29f7dcb3327fe58e630b8e2973676989e0,2,35,1,36,3,2012-09-06 23:06:21,2012-05-25 20:58:34
42c38b29f7dcb3327fe58e630b8e2973676989e0...f2b7fffdc0b0ad80cebb24f5fea743e9e4a439d5,4,156,1,157,10,2012-09-06 23:06:21,2012-05-08 21:00:38
f2b7fffdc0b0ad80cebb24f5fea743e9e4a439d5...fbdab513dd48f667ad857030cf4b3481ecdd9097,2,22,4,26,7,2012-09-06 23:06:21,2012-05-17 15:11:25
fbdab513dd48f667ad857030cf4b3481ecdd9097...cebd015f78c5e21bd37d4bc055dbcdc21dac2ef2,2,50,9,59,3,2012-09-06 23:06:21,2012-06-07 15:25:35
cebd015f78c5e21bd37d4bc055dbcdc21dac2ef2...6c67719dfa6ff3f2a15a8e1e7660cf2e6e9155b0,1,44,0,44,1,2012-09-06 23:06:22,2012-08-14 19:45:01
6c67719dfa6ff3f2a15a8e1e7660cf2e6e9155b0...10e1c759f4602d993a76b0eacf6a2d04c8880017,2,35,6,41,8,2012-09-06 23:06:22,2012-05-11 20:14:59
10e1c759f4602d993a76b0eacf6a2d04c8880017...7079ff5eb6c22e8755c11385979d9feaad8c7b9d,1,1,1,2,1,2012-09-06 23:06:22,2012-09-04 05:57:41
7079ff5eb6c22e8755c11385979d9feaad8c7b9d...4909d1d39d61d6945a0820a5a7276c1e657ba262,2,16,7,23,3,2012-09-06 23:06:22,2012-08-20 22:47:26
4909d1d39d61d6945a0820a5a7276c1e657ba262...d519953a4b219035587e3fcb2e9cc52e02b408ca,2,26,3,29,6,2012-09-06 23:06:23,2012-08-31 23:20:01
d519953a4b219035587e3fcb2e9cc52e02b408ca...92558fe4119fb1ee793d781de1888abef181c7f6,1,18,18,36,10,2012-09-06 23:06:23,2012-08-10 19:54:03
92558fe4119fb1ee793d781de1888abef181c7f6...0472c5f07ec08b81b6cd0dee3743cc33cbe606b3,5,5,5,10,5,2012-09-06 23:06:23,2012-09-05 14:28:42
0472c5f07ec08b81b6cd0dee3743cc33cbe606b3...eb5fd400d34ea9c6e5ce1e76dffd9b40f412763a,1,25,25,50,21,2012-09-06 23:06:23,2012-09-05 20:31:14
eb5fd400d34ea9c6e5ce1e76dffd9b40f412763a...9473780e77a960ba27644ca76c2413924cc8972e,2,4,1,5,2,2012-09-06 23:06:23,2012-08-30 04:39:52
9473780e77a960ba27644ca76c2413924cc8972e...8cb9c99ec064fd95567118d29bfa4a19b8613ab3,2,48,0,48,2,2012-09-06 23:06:24,2012-08-29 13:39:34
8cb9c99ec064fd95567118d29bfa4a19b8613ab3...d9eff86ef77dd76208cef21e882239d4db0eac1e,2,2,2,4,2,2012-09-06 23:06:24,2012-09-05 21:46:17
d9eff86ef77dd76208cef21e882239d4db0eac1e...b6e4a71166c7f00f4140fd7ea8f0cd81b4487a3f,2,20,0,20,2,2012-09-06 23:06:24,2012-07-14 09:40:24
b6e4a71166c7f00f4140fd7ea8f0cd81b4487a3f...ca30fce28ca13284bfa1c926e810ed75cdcde499,17,31,30,61,28,2012-09-06 23:06:25,2012-07-06 09:53:40
ca30fce28ca13284bfa1c926e810ed75cdcde499...a9be003fce4b42077448481b3b067c5f81c063f6,1,2,3,5,2,2012-09-06 23:06:25,2012-06-19 21:51:07
a9be003fce4b42077448481b3b067c5f81c063f6...04329151d2df833f803629cefa781aa6409fe6a5,2,4,0,4,2,2012-09-06 23:06:26,2012-06-07 03:23:43
04329151d2df833f803629cefa781aa6409fe6a5...c81d8176cc55cd15acae05259ead73f90a01f0b7,1,1,0,1,1,2012-09-06 23:06:27,2012-07-26 21:26:46
c81d8176cc55cd15acae05259ead73f90a01f0b7...2a4a8226d1c7dc9d6a86a3429144c065c8f01c89,1,1,1,2,1,2012-09-10 21:49:22,2012-09-10 20:40:32
2a4a8226d1c7dc9d6a86a3429144c065c8f01c89...03042c52b9b5490645501e36f9ba27177d173737,1,1,1,2,1,2012-09-11 22:08:55,2012-09-10 06:48:47
03042c52b9b5490645501e36f9ba27177d173737...83fbdd1097e27cc50c7c7aed6463d69e66fcf8e7,1,1,1,2,1,2012-09-11 22:11:01,2012-09-02 17:59:33
83fbdd1097e27cc50c7c7aed6463d69e66fcf8e7...c0b9e94dec21a89784febd96fbd2036abb31b14f,1,1,1,2,1,2012-09-11 22:11:01,2012-09-02 22:42:34
c0b9e94dec21a89784febd96fbd2036abb31b14f...b01c28c9004a693f6990ed0b44738ddd0c8fc241,1,3,3,6,1,2012-09-11 22:11:01,2012-09-02 23:11:52
b01c28c9004a693f6990ed0b44738ddd0c8fc241...7fa391c9790bc4e73c2295c6a7a9084db78e18a7,1,4,4,8,1,2012-09-11 22:11:01,2012-09-06 13:45:24
7fa391c9790bc4e73c2295c6a7a9084db78e18a7...053247e412a29c9524f3c0164ab0082c976e5a30,1,7,7,14,1,2012-09-11 22:11:02,2012-09-08 20:34:11
053247e412a29c9524f3c0164ab0082c976e5a30...b8eb843b25e3f4c6695840fda7fc5deaaf1605cc,1,2,2,4,2,2012-09-11 22:11:02,2012-09-08 20:36:36
b8eb843b25e3f4c6695840fda7fc5deaaf1605cc...62bb728d0741bff98bd97d390a8236dbdfb000c6,1,1,1,2,1,2012-09-11 22:11:02,2012-09-10 02:29:00
62bb728d0741bff98bd97d390a8236dbdfb000c6...03ebecd5eb419da79cb3bcef270cac424c4743de,1,4,4,8,4,2012-09-11 22:11:02,2012-09-10 02:34:15
03ebecd5eb419da79cb3bcef270cac424c4743de...79941d2527c0d9f06f9a6a4ab05fb341076a4276,1,1,1,2,1,2012-09-11 22:11:02,2012-09-10 03:04:18
79941d2527c0d9f06f9a6a4ab05fb341076a4276...84c13d96ff6e993b2ee9ff6bf49614fc1d514b04,1,5,4,9,4,2012-09-11 23:12:40,2012-09-08 04:46:24
84c13d96ff6e993b2ee9ff6bf49614fc1d514b04...5dbd942bac8b8d045162d29467640107db14263b,2,177,0,177,2,2012-09-11 23:12:40,2012-09-02 02:31:06
5dbd942bac8b8d045162d29467640107db14263b...95276a7e1047c7a3ac6613d8612c62f544388fc9,1,3,0,3,1,2012-09-11 23:12:41,2012-09-07 05:14:46
95276a7e1047c7a3ac6613d8612c62f544388fc9...f2ebfa16b0849a1ea26f73ae63dcb0e56f066646,1,1,1,2,1,2012-09-11 23:12:41,2012-09-07 04:16:23
f2ebfa16b0849a1ea26f73ae63dcb0e56f066646...331cd5a8cb5efdafe8ad7eb386aed4033cfc1bb3,2,12,12,24,6,2012-09-11 23:12:41,2012-09-07 18:14:48
331cd5a8cb5efdafe8ad7eb386aed4033cfc1bb3...2e1539356a7ace9512110acea9808d497ed0789f,1,32,0,32,1,2012-09-12 00:27:57,2012-09-07 19:24:19
2e1539356a7ace9512110acea9808d497ed0789f...209b67df6a49fe1646ce63c5e7d11ed26e8abbc1,2,34,7,41,7,2012-09-12 04:59:31,2012-07-30 00:52:19
209b67df6a49fe1646ce63c5e7d11ed26e8abbc1...b0a05a7531ed7235aa6d2c4e3ea11373e1fc73f1,2,5,5,10,4,2012-09-12 05:10:26,2012-09-12 05:10:26
b0a05a7531ed7235aa6d2c4e3ea11373e1fc73f1...5418564f0462a7f9b9458b170271a9a267dc4f79,1,5,5,10,2,2012-09-13 18:31:06,2012-09-13 18:31:06
5418564f0462a7f9b9458b170271a9a267dc4f79...9d168f058f9c6d7eeae0daa7cb72ea4e02a0003a,6,119,40,159,13,2012-09-13 23:23:18,2012-08-30 08:10:28
9d168f058f9c6d7eeae0daa7cb72ea4e02a0003a...89dd5662772dcdf46a4e8c19beba46ca9d87a0d6,2,71,51,122,43,2012-09-15 15:11:53,2012-09-15 15:11:32
89dd5662772dcdf46a4e8c19beba46ca9d87a0d6...4a04c2ec0c935dd47b124ea488d68e8c87618386,5,0,166,166,4,2012-09-16 17:39:43,2012-09-16 17:39:43
4a04c2ec0c935dd47b124ea488d68e8c87618386...20c116d9d576c751865f3906773abd3d2e482318,1,7,8,15,4,2012-09-16 17:40:44,2012-09-16 17:40:44
20c116d9d576c751865f3906773abd3d2e482318...6a5f8c048371afebbeb29be223ab5c51f1c179be,1,1,1,2,1,2012-09-17 21:50:51,2012-09-17 17:31:44
6a5f8c048371afebbeb29be223ab5c51f1c179be...6fc4fdb4383b42002071bdf74a93ee0ac1bb8b90,1,21,5,26,6,2012-09-17 21:51:21,2012-09-17 21:50:07
6fc4fdb4383b42002071bdf74a93ee0ac1bb8b90...bcaa3bb3739c3b964750c49b216bf34bb0d8f3f6,2,5,3,8,4,2012-09-18 01:08:16,2012-09-17 23:55:48
bcaa3bb3739c3b964750c49b216bf34bb0d8f3f6...8db47ca7d4303e3e45a838219a1f6e9be8770ed4,2,20,1,21,3,2012-09-21 01:32:01,2012-09-13 09:40:00
8db47ca7d4303e3e45a838219a1f6e9be8770ed4...8b2532cec7f79c7b633122eead3ef42536ec8b5b,1,13,0,13,1,2012-09-25 06:39:33,2012-09-25 05:58:01
8b2532cec7f79c7b633122eead3ef42536ec8b5b...b440ad36f3bfecf0916a85fec89e6737ead30572,1,16,14,30,8,2012-10-05 10:13:51,2012-10-05 10:13:51
b440ad36f3bfecf0916a85fec89e6737ead30572...c96dc605942875f7a9c1c5fc54dae3b5cae60da2,1,1,0,1,1,2012-10-05 23:43:01,2012-10-05 23:43:01
c96dc605942875f7a9c1c5fc54dae3b5cae60da2...43ac783d35400fe0467b6c3a1bb3c5cb1d648a89,1,1,1,2,1,2012-10-17 19:45:10,2012-10-17 19:43:40
43ac783d35400fe0467b6c3a1bb3c5cb1d648a89...0ae0591f42691586d29c9366bdb257eeec8f002b,1,1,1,2,1,2012-10-17 19:48:08,2012-09-20 08:12:53
0ae0591f42691586d29c9366bdb257eeec8f002b...a5d434d857f9059fe277e348fe9876d62ca38a18,4,23,3,26,4,2012-10-17 20:17:16,2012-09-20 04:57:03
a5d434d857f9059fe277e348fe9876d62ca38a18...c959fa4fe80d251ed5fc326943416c8ab369bd0b,1,3,1,4,2,2012-10-17 21:38:15,2012-10-17 21:38:11
c959fa4fe80d251ed5fc326943416c8ab369bd0b...3bd95dbb1a502575ae8250f49190f153442054eb,1,4,1,5,1,2012-10-17 22:36:51,2012-10-17 22:36:48
3bd95dbb1a502575ae8250f49190f153442054eb...4f5902258277a801ae651b6ccb82c7da476f8c41,1,1,0,1,1,2012-10-17 22:44:18,2012-10-17 22:44:18
4f5902258277a801ae651b6ccb82c7da476f8c41...ca96ec32f996b1130f06ad070ee29c5810c40e57,14,73,192,265,35,2012-10-18 09:33:45,2012-10-18 09:33:45
ca96ec32f996b1130f06ad070ee29c5810c40e57...8d69f4b93aea66a417f5c881b2e6381d19d86b35,18,0,116,116,16,2012-10-18 10:13:04,2012-10-18 10:13:04
8d69f4b93aea66a417f5c881b2e6381d19d86b35...d938983c06896306a7629ca15162e565ee98001c,8,0,3052,3052,7,2012-10-18 10:14:27,2012-10-18 10:14:27
d938983c06896306a7629ca15162e565ee98001c...175e727f05fc72690c8c9ca592618285c4a74ab3,2,3,1,4,2,2012-10-18 10:26:08,2012-10-18 10:26:08
175e727f05fc72690c8c9ca592618285c4a74ab3...f43cf3b816301ec258bfbb3268f9d13582d82648,4,1,205,206,5,2012-10-18 10:26:51,2012-10-18 10:26:51
f43cf3b816301ec258bfbb3268f9d13582d82648...5c9eb75867af20949ff43f77adde0dd9ae988ff9,1,3,1,4,1,2012-10-19 16:02:06,2012-10-19 16:02:06
5c9eb75867af20949ff43f77adde0dd9ae988ff9...cf78fb5661218b453fb81e1f6ca01a2cba277893,1,16,7,23,7,2012-10-19 16:14:05,2012-10-19 16:14:05
cf78fb5661218b453fb81e1f6ca01a2cba277893...be50e0769a0d7a972b927674de2ceab7c46834fb,1,1,1,2,1,2012-10-22 19:39:37,2012-10-22 19:39:37
be50e0769a0d7a972b927674de2ceab7c46834fb...f54edbbdd4a293d85000abde7b3ba8e4e776f175,1,9,9,18,9,2012-10-26 15:49:44,2012-10-19 16:17:01
f54edbbdd4a293d85000abde7b3ba8e4e776f175...f4517b500c0d2357d89e8c889f32f1466e5c1612,1,99,0,99,2,2012-10-26 15:49:44,2012-10-19 16:19:45
f4517b500c0d2357d89e8c889f32f1466e5c1612...bca1604c12262b66ce3b8004994fb4841fb8b87d,2,18,2,20,3,2012-10-26 15:51:28,2012-10-19 18:29:37
bca1604c12262b66ce3b8004994fb4841fb8b87d...fc115bfd0d18017f4bcef1e39fb22d97a98f8ab1,2,34,1,35,2,2012-10-30 00:46:44,2012-10-25 07:33:36
fc115bfd0d18017f4bcef1e39fb22d97a98f8ab1...b936236fbc0a786e4ae9d33dd0f3debdf42a17c8,1,4,4,8,4,2012-10-30 00:46:44,2012-10-25 07:47:47
b936236fbc0a786e4ae9d33dd0f3debdf42a17c8...524c5c8b5d84ccec0edf1ded304b79f44968ca09,1,24,23,47,18,2012-10-30 00:46:44,2012-10-25 07:56:34
524c5c8b5d84ccec0edf1ded304b79f44968ca09...008a782bc8ed8a7ebcb63d563d1420fd1b312452,1,1,1,2,1,2012-10-30 00:49:36,2012-10-25 07:58:50
008a782bc8ed8a7ebcb63d563d1420fd1b312452...54b3875ba5cb6ce8ddac61ace33c1b2f600875ff,1,1,1,2,1,2012-10-30 00:49:56,2012-10-25 08:00:21
54b3875ba5cb6ce8ddac61ace33c1b2f600875ff...3c9b39ff528ec8cb554f055323b7be52a3e2bcf7,1,1,1,2,1,2012-10-31 17:24:12,2012-10-25 12:05:47
3c9b39ff528ec8cb554f055323b7be52a3e2bcf7...7c67b2fb6afbc18f3593c64a5f339f04f9003f3c,1,54,4,58,5,2012-10-31 19:54:52,2012-10-25 15:27:15
7c67b2fb6afbc18f3593c64a5f339f04f9003f3c...090e5426ac3ed48470dea07df9950bdac4c03384,1,2,1,3,1,2012-10-31 20:03:50,2012-10-31 19:56:55
090e5426ac3ed48470dea07df9950bdac4c03384...fdf85bfd86175fb513c214141b82f30fbaa9be4f,1,1,1,2,1,2012-10-31 20:12:49,2012-10-24 11:37:53
fdf85bfd86175fb513c214141b82f30fbaa9be4f...249a1d84e7ac3b8528d317b8b0a80acb5dd9a271,3,41,2,43,4,2012-10-31 20:58:13,2012-10-30 01:54:26
249a1d84e7ac3b8528d317b8b0a80acb5dd9a271...271d2bed3afacc780b40af8b692c40a031d79f9d,1,1,1,2,1,2012-10-31 21:19:05,2012-10-26 03:41:47
271d2bed3afacc780b40af8b692c40a031d79f9d...b32adb7deaaa31fae97afacbeec224fdd86616f6,1,1,1,2,1,2012-10-31 21:21:28,2012-10-31 20:48:53
b32adb7deaaa31fae97afacbeec224fdd86616f6...3a624a7ff5ac0f02ab4957af76c2f98c1596e232,1,71,67,138,9,2012-10-31 21:47:53,2012-10-21 19:56:55
3a624a7ff5ac0f02ab4957af76c2f98c1596e232...7b52a976e1fdcccf05a90b6fdc66f41a65c78f3d,2,2,1,3,2,2012-10-31 21:47:59,2012-10-31 21:46:11
7b52a976e1fdcccf05a90b6fdc66f41a65c78f3d...b3cae4f457f1688346bbd0b08cccc9c504f83406,2,20,2,22,4,2012-10-31 22:03:13,2012-10-21 07:27:27
b3cae4f457f1688346bbd0b08cccc9c504f83406...b429f538a3e92af69e51bf10d6ee83dd322fea72,3,2,7,9,3,2012-10-31 23:47:28,2012-10-21 06:20:16
b429f538a3e92af69e51bf10d6ee83dd322fea72...c6b4ab3548cd728bc0ec909abf66e31183dd2ea4,1,1,1,2,1,2012-11-06 03:34:20,2012-11-06 03:34:20
c6b4ab3548cd728bc0ec909abf66e31183dd2ea4...e034fa08a8e92241fa9c46bed735b977b5c29290,4,0,102,102,5,2012-11-11 09:31:27,2012-11-08 21:15:06
e034fa08a8e92241fa9c46bed735b977b5c29290...8650843603be6f6f17aa3f90fb9991420669cb53,1,3,4,7,2,2012-11-11 09:31:27,2012-11-08 21:15:27
8650843603be6f6f17aa3f90fb9991420669cb53...04450c48dfea065e1c9e4ab8adad94993ed1b037,2,4,3,7,4,2012-11-11 09:31:27,2012-11-10 20:37:17
04450c48dfea065e1c9e4ab8adad94993ed1b037...f3e053cb6fec8279e09330481ba8906e185f94c6,1,3,3,6,2,2012-11-11 09:36:28,2012-11-09 13:44:00
f3e053cb6fec8279e09330481ba8906e185f94c6...e9253a88b912ef5e43b43a3ceb7fca266223affb,1,11,9,20,3,2012-11-11 10:20:24,2012-11-07 09:23:20
e9253a88b912ef5e43b43a3ceb7fca266223affb...a758799c7ff2d8fe21f6680589f2e9e4b7f34329,1,1,1,2,1,2012-11-11 10:22:43,2012-11-05 20:40:36
a758799c7ff2d8fe21f6680589f2e9e4b7f34329...ffa6c5195fdc1c9a7d27e2cd20ac3f2e0ef46f74,1,1,1,2,1,2012-11-11 10:24:59,2012-11-05 20:42:54
ffa6c5195fdc1c9a7d27e2cd20ac3f2e0ef46f74...5c5193946d196dda489d36ae1de865e72844e6f0,1,1,1,2,1,2012-11-11 10:31:51,2012-10-14 08:57:21
5c5193946d196dda489d36ae1de865e72844e6f0...88917578913172f26e9fa045eaf54d122abb6729,1,1,1,2,1,2012-11-11 10:34:06,2012-10-14 15:17:01
88917578913172f26e9fa045eaf54d122abb6729...cd8b78ebfd088cf51847e04b85b8817b5dc0d10c,1,2,3,5,1,2012-11-11 10:34:06,2012-10-14 15:57:18
cd8b78ebfd088cf51847e04b85b8817b5dc0d10c...19a324ce116b6f5a728f5f78f5c19a364a779e22,1,2,2,4,1,2012-11-11 10:40:18,2012-10-18 08:03:14
19a324ce116b6f5a728f5f78f5c19a364a779e22...bd524fc4e5fc0feffe85632a7a6560da6bd9b762,1,5,0,5,1,2012-11-14 18:56:28,2012-11-14 18:53:29
bd524fc4e5fc0feffe85632a7a6560da6bd9b762...af7e0bd0a7c286667c526cb7e0c733d3ee5f17fd,2,4,4,8,4,2012-11-15 00:46:58,2012-11-14 23:49:19
af7e0bd0a7c286667c526cb7e0c733d3ee5f17fd...8a7f752a802bc68ad01869e500c54cc2566b04e3,1,1,1,2,1,2012-11-17 22:45:08,2012-09-12 16:05:26
8a7f752a802bc68ad01869e500c54cc2566b04e3...e362a510e3cce04e5cd833bb03925d41609fed51,1,1,1,2,1,2012-11-17 22:49:19,2012-09-27 20:40:46
e362a510e3cce04e5cd833bb03925d41609fed51...f28f283fcff83b7227e4fc9e94e1e522e0db2e5d,1,4,4,8,4,2012-11-17 22:55:32,2012-09-19 10:37:53
f28f283fcff83b7227e4fc9e94e1e522e0db2e5d...b21f4a376d2ead526bcde47f0bb1d5580e1c3efa,3,4,4,8,4,2012-11-21 22:06:59,2012-10-26 14:00:02
b21f4a376d2ead526bcde47f0bb1d5580e1c3efa...94e1c0391c351b6f691fad8abed2828fa20548b2,2,13,2,15,2,2012-11-24 20:27:24,2012-09-22 23:53:08
94e1c0391c351b6f691fad8abed2828fa20548b2...55d15806fb14b1d98b5ca2770bbbb59e11548c62,2,7,0,7,2,2012-11-24 20:56:28,2012-11-13 12:33:26
55d15806fb14b1d98b5ca2770bbbb59e11548c62...610927d77b77700c5c61accd503a2af0fa51cfe6,2,30,2,32,8,2012-11-24 21:21:50,2012-10-09 18:04:58
610927d77b77700c5c61accd503a2af0fa51cfe6...79af2badcb087881e3fd600f6ae5bf3f86a2daf8,2,15,4,19,2,2012-11-24 21:26:23,2012-09-14 21:42:39
79af2badcb087881e3fd600f6ae5bf3f86a2daf8...168db33985aa025eb48bc21087717ab70da0bd72,2,9,1,10,3,2012-11-24 23:01:34,2012-11-15 23:18:28
168db33985aa025eb48bc21087717ab70da0bd72...c8fd7fd0e2c77cc3d22382367ed5a1537383bee6,2,20,1,21,7,2012-11-25 00:18:10,2012-11-09 00:15:50
c8fd7fd0e2c77cc3d22382367ed5a1537383bee6...682418f029cb9710a77eb377dd2a8390eaac4516,1,1,1,2,1,2012-11-25 00:21:52,2012-10-10 03:57:58
682418f029cb9710a77eb377dd2a8390eaac4516...e6966e05f508d1d2633b9ff327fea912b12555ac,2,91,5,96,7,2012-11-25 10:39:54,2012-09-25 08:09:26
e6966e05f508d1d2633b9ff327fea912b12555ac...ca3e0e7374734af10141bbabc682958dea7d9852,1,32,0,32,1,2012-11-25 20:00:14,2012-09-20 14:46:15
ca3e0e7374734af10141bbabc682958dea7d9852...e249502880974cd7bc34a065d23f4d0bfdec6353,3,3578,3544,7122,872,2012-11-26 14:45:04,2012-10-31 20:46:33
e249502880974cd7bc34a065d23f4d0bfdec6353...650fd933df614ac733cd43fe31d81d622a2ce2bc,2,37,1,38,3,2012-11-26 14:45:04,2012-11-24 00:47:52
650fd933df614ac733cd43fe31d81d622a2ce2bc...b9a9f91fbf99b71cfde434b6277f4c7d2533556f,2,2,10,12,2,2012-11-26 14:45:04,2012-11-24 00:51:19
b9a9f91fbf99b71cfde434b6277f4c7d2533556f...96ed9ff59a454486c88bdf92ad9d28ab8864b85e,2,8,2,10,4,2012-11-26 14:45:04,2012-11-24 00:34:01
96ed9ff59a454486c88bdf92ad9d28ab8864b85e...733a97adf87bf8f7ec6be22b37c4676cf7b5fc2b,4,165,2,167,8,2012-11-26 15:44:34,2012-07-07 17:02:04
733a97adf87bf8f7ec6be22b37c4676cf7b5fc2b...e7d37ee45ac48b0ff2a3d43f7236d316be6c241e,1,38,26,64,11,2012-11-26 19:17:11,2012-11-26 19:17:11
e7d37ee45ac48b0ff2a3d43f7236d316be6c241e...d644dcfa52cba0cee3c6fa8d03e1654cdb654e53,2,11,27,38,7,2012-11-26 19:31:54,2012-11-26 19:25:38
d644dcfa52cba0cee3c6fa8d03e1654cdb654e53...c8e9105fe685e95340336b57cb85faebbc7955cc,1,175,172,347,83,2012-11-26 19:36:52,2012-11-23 15:08:47
c8e9105fe685e95340336b57cb85faebbc7955cc...e6d9bea4f3b2eb28851298d3dc3a30d46062d58a,1,15,12,27,5,2012-11-26 19:36:53,2012-11-23 21:40:01
e6d9bea4f3b2eb28851298d3dc3a30d46062d58a...1b17dfa693c36607ea86c7129a8612f7771c2f22,2,19,8,27,2,2012-11-26 19:36:53,2012-11-23 21:43:30
1b17dfa693c36607ea86c7129a8612f7771c2f22...d3b32a7c9452e80b372c1b49f2c060ea5225b13e,1,6,6,12,2,2012-11-26 19:36:53,2012-11-23 21:45:46
d3b32a7c9452e80b372c1b49f2c060ea5225b13e...d859dcecea654d1d858cd756c6efb8435a453197,1,43,13,56,2,2012-11-26 19:36:53,2012-11-23 21:46:58
d859dcecea654d1d858cd756c6efb8435a453197...cfe13b5dac3d1260400bb55194f2bc27169fd360,2,3,1,4,2,2012-11-26 20:05:38,2012-11-11 11:06:05
cfe13b5dac3d1260400bb55194f2bc27169fd360...a32bc40fd75ca46e3581ad7a6e3a24a31df6e266,3,30,11,41,6,2012-11-26 22:21:02,2012-09-22 01:57:22
a32bc40fd75ca46e3581ad7a6e3a24a31df6e266...3a75b1124d062f64093a90b26630938558909e8d,2,3,10,13,7,2012-11-26 22:36:40,2012-10-12 19:41:05
3a75b1124d062f64093a90b26630938558909e8d...fce100a46c5681562253c3a856d67bbd35fbc2f2,2,73,2,75,5,2012-11-26 22:58:59,2012-09-28 22:43:01
fce100a46c5681562253c3a856d67bbd35fbc2f2...9b18644f301c2d2cffbbb6f7d321581d6c7d18c0,1,200,3,203,3,2012-11-27 00:43:05,2012-11-26 20:51:03
9b18644f301c2d2cffbbb6f7d321581d6c7d18c0...2ee0f56c546fcc018c264e7c00df4d06f369b42e,1,1,1,2,1,2012-11-27 00:45:35,2012-11-27 00:45:35
2ee0f56c546fcc018c264e7c00df4d06f369b42e...3c7bfa77aad5e3f8c71bc63a7cd91c2586d8560a,1,3,3,6,1,2012-11-28 13:21:33,2012-11-28 13:21:33
3c7bfa77aad5e3f8c71bc63a7cd91c2586d8560a...cc42c99bec6a03d6c41b8e1d29ba2b1f5c16b87d,2,36,3,39,5,2012-11-28 15:01:57,2012-07-04 08:07:09
cc42c99bec6a03d6c41b8e1d29ba2b1f5c16b87d...d1e48fcbf39166d4d6cb5b06957f9a8a93260d57,1,2,2,4,2,2012-11-28 22:56:09,2012-11-28 22:55:56
d1e48fcbf39166d4d6cb5b06957f9a8a93260d57...cf4ed8a14588e99f8871a1593f2825128e641c77,1,2,1,3,1,2012-11-29 18:40:30,2012-11-21 08:45:43
cf4ed8a14588e99f8871a1593f2825128e641c77...5f7054bf5d1189c9a7842bc6e6f97c003514fcd5,1,5,5,10,1,2012-11-29 18:40:33,2012-11-07 10:37:46
5f7054bf5d1189c9a7842bc6e6f97c003514fcd5...d6da505f4e044f8a487ac27a3ec707c11853ee0a,2,20,1,21,4,2012-11-30 12:10:00,2012-11-30 00:16:08
d6da505f4e044f8a487ac27a3ec707c11853ee0a...ec801ac13782f3f488915d682d6d2a73e2d76efd,1,46,46,92,4,2012-11-30 21:35:57,2012-11-25 15:10:37
ec801ac13782f3f488915d682d6d2a73e2d76efd...8991680d8ab632dda60cd70c780868c803c74509,2,2,1,3,2,2012-11-30 21:58:11,2012-11-27 06:24:35
8991680d8ab632dda60cd70c780868c803c74509...2c405f417125c80c387a51baece8bf6e1e0c0a81,2,15,1,16,2,2012-12-01 17:41:59,2012-11-26 19:17:37
2c405f417125c80c387a51baece8bf6e1e0c0a81...15183f3e1fbee031c9595206163962788f98b298,2,13,0,13,2,2012-12-01 19:05:42,2012-11-14 04:33:54
15183f3e1fbee031c9595206163962788f98b298...26adeb119bc4fafa6286de484626b8de4170abc9,2,23,2,25,3,2012-12-05 01:20:11,2012-11-29 16:46:51
26adeb119bc4fafa6286de484626b8de4170abc9...c9d937082cc3a074eb82db97790d68a6f55c6731,1,4,4,8,1,2012-12-05 01:55:43,2012-12-05 01:55:19
c9d937082cc3a074eb82db97790d68a6f55c6731...d43cc3f89334ef8e75d264f3918e33d8163f409e,1,1,1,2,1,2012-12-06 20:13:51,2012-12-05 18:31:51
d43cc3f89334ef8e75d264f3918e33d8163f409e...bcc7089b3c65392743a2d5d683c6e23f0fe4b109,1,2,3,5,2,2012-12-06 20:18:49,2012-12-04 22:38:45
bcc7089b3c65392743a2d5d683c6e23f0fe4b109...f8b755982a3f110e1badb2326c0268f5adf767ad,1,1,1,2,1,2012-12-06 20:25:47,2012-12-04 19:56:16
f8b755982a3f110e1badb2326c0268f5adf767ad...c52bfd37eea6edc94c9d15e01a097fcfdf39144e,1,1,1,2,1,2012-12-07 10:03:58,2012-12-07 09:01:59
c52bfd37eea6edc94c9d15e01a097fcfdf39144e...ff11061a8f50ca497668b149fa7e10cab741f775,1,1,1,2,1,2012-12-07 19:45:33,2012-12-07 01:19:39
ff11061a8f50ca497668b149fa7e10cab741f775...d93533812b64f633868d2dc5bdd14056d54af99c,1,1,1,2,1,2012-12-08 10:33:07,2012-12-07 23:11:51
d93533812b64f633868d2dc5bdd14056d54af99c...c398d7d3709333c4a228d955b5ee8cbcf4386468,1,5,3,8,3,2012-12-09 16:13:29,2012-12-07 18:09:42
c398d7d3709333c4a228d955b5ee8cbcf4386468...a66c968df286f90ef39f04f7bef2d82557469268,1,3,3,6,2,2012-12-10 22:19:20,2012-12-06 00:35:37
a66c968df286f90ef39f04f7bef2d82557469268...37cced6296f0433d61434dad5878bb7036e6a493,1,3,3,6,2,2012-12-11 18:20:30,2012-12-11 09:57:41
37cced6296f0433d61434dad5878bb7036e6a493...25e1ad9a9443de6b7ebb40409af72021cc4e7b20,1,3,1,4,1,2012-12-11 19:04:46,2012-12-11 16:42:00
25e1ad9a9443de6b7ebb40409af72021cc4e7b20...30a9da5dc159dd1e19b677914356925c7ebdf632,2,16,4,20,3,2012-12-14 00:15:15,2012-12-11 10:41:53
30a9da5dc159dd1e19b677914356925c7ebdf632...039b138042de23852d8b2fdc4ca52ad178c96772,1,24,0,24,1,2012-12-14 13:49:22,2012-12-14 13:49:22
039b138042de23852d8b2fdc4ca52ad178c96772...f2d526190a4fb38d1192803dccc9b60492e9ab76,1,1,1,2,1,2012-12-17 22:18:12,2012-12-17 22:18:12
f2d526190a4fb38d1192803dccc9b60492e9ab76...e03182f018f5069acd5e883ce2e9349b83f2d03f,2,62,1,63,3,2012-12-18 21:57:58,2012-11-28 23:27:51
e03182f018f5069acd5e883ce2e9349b83f2d03f...1e13544da8c8ca8c630fd14feca25ab1b40bd3fd,1,4,4,8,1,2012-12-19 04:38:43,2012-12-19 04:38:43
1e13544da8c8ca8c630fd14feca25ab1b40bd3fd...9e96d983451899ef0cef3e68395c8f6c1ef83bbe,2,74,38,112,21,2012-12-19 19:13:36,2012-12-05 12:41:11
9e96d983451899ef0cef3e68395c8f6c1ef83bbe...6aac69039ea43f8c501c9c64031a6bd989832b0f,1,5,5,10,3,2012-12-19 19:35:31,2012-12-18 17:47:35
6aac69039ea43f8c501c9c64031a6bd989832b0f...59d9b89852805ad08e8e3bc2f80625b9697dc768,1,1,1,2,1,2012-12-19 20:01:41,2012-11-30 00:56:02
59d9b89852805ad08e8e3bc2f80625b9697dc768...f0c6ebc07653f6267acec898ccef5677884e3081,2,59,17,76,5,2012-12-20 19:39:40,2012-09-15 16:02:10
f0c6ebc07653f6267acec898ccef5677884e3081...8d42ce85632b87bb75f89fa4b072ce798fb5a850,1,2,2,4,2,2012-12-31 11:49:51,2012-12-31 05:36:21
8d42ce85632b87bb75f89fa4b072ce798fb5a850...74db36ee94addab519a7198bd987b44228309d59,1,5,2,7,2,2013-01-03 19:49:43,2012-12-31 12:03:49
74db36ee94addab519a7198bd987b44228309d59...36089931a578e6ffe204a1ed17f1773cb9a90dd0,1,5,5,10,5,2013-01-04 08:28:35,2012-12-16 21:32:19
36089931a578e6ffe204a1ed17f1773cb9a90dd0...a3a9d4af05f0e571b2daa17b56824dda5d120b6f,1,24,0,24,1,2013-01-04 17:59:11,2013-01-04 01:22:54
a3a9d4af05f0e571b2daa17b56824dda5d120b6f...1122dc7a5b34e87135af7edeb6d1f939f934cc21,1,2,2,4,1,2013-01-05 21:47:36,2013-01-05 21:47:36
1122dc7a5b34e87135af7edeb6d1f939f934cc21...2b0978b07cf4fc1b2c5d728f60de5c0caeeb726b,1,5,5,10,5,2013-01-07 20:01:01,2013-01-02 19:58:27
2b0978b07cf4fc1b2c5d728f60de5c0caeeb726b...14948cf5d97fbe0be6fc7f884af65fd73c50e572,1,0,1,1,1,2013-01-08 19:47:22,2013-01-08 19:47:22
14948cf5d97fbe0be6fc7f884af65fd73c50e572...5b5f35d5e41a5930f7a685a02d0d20b8585a1420,2,5,31,36,3,2013-01-08 22:23:50,2013-01-08 22:23:50
5b5f35d5e41a5930f7a685a02d0d20b8585a1420...b6b7c5a1d66073937709158da8c2d688cb45c9f6,1,1,1,2,1,2013-01-08 22:36:03,2013-01-08 22:36:03
b6b7c5a1d66073937709158da8c2d688cb45c9f6...76a6047af690781b8238ba7924279470ba76d081,2,18,2,20,3,2013-01-08 22:54:15,2012-12-19 23:48:47
76a6047af690781b8238ba7924279470ba76d081...febb4c1c35cf767ae31fc9fef1f4b4f026ac9de0,3,10,9,19,6,2013-01-09 09:22:35,2012-12-20 17:27:57
febb4c1c35cf767ae31fc9fef1f4b4f026ac9de0...037aefae479ba44510a084c86a60a41e4261a078,1,4,5,9,3,2013-01-09 09:49:44,2013-01-09 00:08:24
037aefae479ba44510a084c86a60a41e4261a078...cc821502bca64d15e1c576bf20a62b28b3d9a88a,2,27,18,45,11,2013-01-09 17:50:43,2013-01-09 17:47:40
cc821502bca64d15e1c576bf20a62b28b3d9a88a...c909f491125d4c846782cf4d5d98bb366aec8c3f,1,60,60,120,2,2013-01-10 00:54:29,2013-01-10 00:54:29
c909f491125d4c846782cf4d5d98bb366aec8c3f...cdf6fb19c85560b30607e71dc2b19fde54760faa,2,28,3,31,3,2013-01-10 04:06:22,2013-01-08 19:11:51
cdf6fb19c85560b30607e71dc2b19fde54760faa...7dff7bb69695f89046272bf31b2b60f0431f1f30,29,0,498,498,29,2013-01-10 05:28:53,2013-01-10 00:07:34
7dff7bb69695f89046272bf31b2b60f0431f1f30...c0cb9f8c14def36cc894fad4146b599531163f61,1,9,6,15,6,2013-01-13 10:08:19,2013-01-13 07:08:43
c0cb9f8c14def36cc894fad4146b599531163f61...74dd2f7980ea8ec434a6e0565d857c910653ed9b,2,11,1,12,2,2013-01-15 05:57:23,2013-01-10 06:07:33
74dd2f7980ea8ec434a6e0565d857c910653ed9b...c6392616ea5245bd0d2f77dded0b948d9e2637c8,3,67,24,91,17,2013-01-16 17:41:02,2013-01-14 19:01:51
c6392616ea5245bd0d2f77dded0b948d9e2637c8...c97c53dbd43072c12bf0560730bed654e382e265,1,1,1,2,1,2013-01-16 20:55:06,2013-01-11 21:20:00
c97c53dbd43072c12bf0560730bed654e382e265...8b9e6c3501746edb2c9e2d585e8e0eaeb8ba8327,2,19,9,28,4,2013-01-17 07:26:36,2013-01-16 18:51:24
8b9e6c3501746edb2c9e2d585e8e0eaeb8ba8327...a69674b36da0f51c80d881b5d5ff6005653dfd55,1,7,1,8,2,2013-01-17 07:41:45,2013-01-15 17:13:28
a69674b36da0f51c80d881b5d5ff6005653dfd55...8c269883fd4353414ea5b6cf77c80bfa54a4ae2f,1,0,1,1,1,2013-01-17 07:45:09,2013-01-15 17:16:11
8c269883fd4353414ea5b6cf77c80bfa54a4ae2f...7e746015ea7dec3e9eb81bc4678fa9b6a83bc47c,2,25,5,30,6,2013-01-17 08:25:30,2013-01-11 12:47:38
7e746015ea7dec3e9eb81bc4678fa9b6a83bc47c...49f9e4cef13e68ff85b3c160cf8fac6e7cd042a3,2,14,1,15,2,2013-01-17 08:28:44,2013-01-09 22:23:50
49f9e4cef13e68ff85b3c160cf8fac6e7cd042a3...78699c62eae3874c5d7f8ab6ac6f67cd38aabc27,1,1,1,2,1,2013-01-17 08:51:56,2013-01-10 20:33:57
78699c62eae3874c5d7f8ab6ac6f67cd38aabc27...3c8583e5dd10ff356ac473f53e920fb10eb41571,1,10,2,12,2,2013-01-17 09:34:01,2012-12-16 08:48:22
3c8583e5dd10ff356ac473f53e920fb10eb41571...93070f14885801de7e264b04fdf4cb54b7dc7d9b,32,201,177,378,150,2013-01-18 00:10:46,2012-09-26 13:30:55
93070f14885801de7e264b04fdf4cb54b7dc7d9b...9e991ddb1de13adf520eda459950be5b90b5b6d9,2,89,8,97,14,2013-01-18 00:47:39,2012-11-29 05:40:27
9e991ddb1de13adf520eda459950be5b90b5b6d9...8b4432481472f13e995df6dc437d55d87b38b709,1,10,7,17,4,2013-01-18 00:52:05,2012-09-14 22:37:05
8b4432481472f13e995df6dc437d55d87b38b709...5ae63fd385295d5a7bbdc79466f59727dcab1c85,2,20,5,25,5,2013-01-18 01:48:51,2013-01-18 00:53:30
5ae63fd385295d5a7bbdc79466f59727dcab1c85...d521619c58ccd5c5a58776d19b247061ed3956c6,1,2,2,4,2,2013-01-18 04:43:13,2013-01-08 22:18:47
d521619c58ccd5c5a58776d19b247061ed3956c6...69e4d40a76d9a600d03edfd18f7707bfe47596bb,1,4,4,8,4,2013-01-18 04:43:13,2013-01-14 00:21:04
69e4d40a76d9a600d03edfd18f7707bfe47596bb...dddb1221faa31b4942131ec6e8adfefb9af470d3,1,1,1,2,1,2013-01-18 05:13:39,2012-12-27 22:40:45
dddb1221faa31b4942131ec6e8adfefb9af470d3...75487ec933fb82702eeb0c65bd5f13ad9f07fbaf,1,5,6,11,3,2013-01-18 05:49:41,2013-01-14 19:34:00
75487ec933fb82702eeb0c65bd5f13ad9f07fbaf...4f5583465a03ad032416b655be4450138d852d4c,1,5,5,10,2,2013-01-18 05:49:41,2013-01-14 19:35:31
4f5583465a03ad032416b655be4450138d852d4c...610a5a0c14a71be6cd147c665f80478515bfb576,1,3,3,6,3,2013-01-18 07:08:38,2013-01-15 16:49:42
610a5a0c14a71be6cd147c665f80478515bfb576...a179a9a96eda5c566bda8a70ac8a75822c936a68,2,26,8,34,9,2013-01-18 07:08:38,2012-11-27 16:00:46
a179a9a96eda5c566bda8a70ac8a75822c936a68...224d7d6e9023395e9bf3f7217984c04fd550f4e7,2,26,1,27,3,2013-01-18 07:08:39,2013-01-17 02:01:03
224d7d6e9023395e9bf3f7217984c04fd550f4e7...af89daf4641f57b92be6c1f3635f5a3237f20c71,2,60,17,77,7,2013-01-18 07:08:39,2013-01-18 06:01:50
af89daf4641f57b92be6c1f3635f5a3237f20c71...61315211da5d85d73c24169d78e060fb256670e3,2,4,3,7,4,2013-01-18 07:52:46,2013-01-18 06:56:42
61315211da5d85d73c24169d78e060fb256670e3...a26234f7183013e2fcc9b35377e181ad96dc9917,2,46,30,76,8,2013-01-18 08:03:28,2013-01-11 17:21:13
a26234f7183013e2fcc9b35377e181ad96dc9917...b2f46251aca76c8568ee7d4bab54edbc9d7a186a,2,33,1,34,2,2013-01-19 04:52:57,2013-01-08 22:19:40
b2f46251aca76c8568ee7d4bab54edbc9d7a186a...b8bd4d5460d9952e9a3bb14992636b17859bd457,3,43,2,45,4,2013-01-19 05:16:16,2013-01-18 04:08:27
b8bd4d5460d9952e9a3bb14992636b17859bd457...faf02f0c4db7962f863b0da2a82c8cafab2c706f,2,75,7,82,5,2013-01-19 05:20:49,2012-11-03 20:11:07
faf02f0c4db7962f863b0da2a82c8cafab2c706f...2f437e89781cb2b449abb685e36b26ca1cf0fff5,2,29,0,29,3,2013-01-19 05:24:57,2013-01-19 05:24:07
2f437e89781cb2b449abb685e36b26ca1cf0fff5...06ed8ef0127bf80610eba17b5021d1f483d0b0bf,2,7,1,8,2,2013-01-19 05:28:15,2012-09-21 11:39:45
06ed8ef0127bf80610eba17b5021d1f483d0b0bf...d30845a7575154f004bef75f38cfde10960f2dc5,1,5,1,6,1,2013-01-19 05:33:10,2013-01-18 20:57:59
d30845a7575154f004bef75f38cfde10960f2dc5...7e8d3c17362e52d6198ae0a85bdf50ded669d9c0,1,1,1,2,1,2013-01-20 17:39:21,2013-01-20 16:52:17
7e8d3c17362e52d6198ae0a85bdf50ded669d9c0...cdf7781878dc43de85e7a72fcfce0105d93db621,1,5,1,6,1,2013-01-21 15:50:16,2013-01-21 15:43:41
cdf7781878dc43de85e7a72fcfce0105d93db621...3c2e1c5e4d12529b1d69a6173c38097527dccc4f,2,10,15,25,6,2013-01-22 15:35:21,2013-01-22 06:00:15
3c2e1c5e4d12529b1d69a6173c38097527dccc4f...ffe5e01584ec1c10930a9a01ce4cec2ec888966b,2,1,7,8,2,2013-01-23 00:32:02,2013-01-23 00:30:35
ffe5e01584ec1c10930a9a01ce4cec2ec888966b...07a58dd7669431d33b61f8c3213c31eff744d02a,2,30,25,55,18,2013-01-23 06:49:00,2013-01-23 06:49:00
07a58dd7669431d33b61f8c3213c31eff744d02a...b62327ec2de6d78b85e0662bb55b3d5b54a50f34,1,1,1,2,1,2013-01-23 06:58:55,2013-01-23 06:58:20
b62327ec2de6d78b85e0662bb55b3d5b54a50f34...0551aa95f0376c52568a027296e225d828cede38,1,119,0,119,1,2013-01-23 06:58:55,2013-01-23 06:53:51
0551aa95f0376c52568a027296e225d828cede38...574573499128f18dabc29dbd2cbd54a59f5a4f0e,1,1,1,2,1,2013-01-23 18:54:35,2013-01-23 18:54:35
574573499128f18dabc29dbd2cbd54a59f5a4f0e...4df45b20d460239a0f5001fb0dd59f95e2d0e80d,1,1,1,2,1,2013-01-23 20:06:40,2013-01-23 20:06:40
4df45b20d460239a0f5001fb0dd59f95e2d0e80d...f3bff27460afb3be208a05959d5b84233d34b7eb,2,68,4,72,9,2013-01-24 04:57:26,2013-01-17 22:21:35
f3bff27460afb3be208a05959d5b84233d34b7eb...d2177ae3120ad88489d1f073d7659bff177ee654,1,1,1,2,1,2013-01-24 05:15:32,2013-01-24 04:01:15
d2177ae3120ad88489d1f073d7659bff177ee654...0539611bac30c0ada7d0eea4bc2bf4b5ee6e831b,1,2,2,4,2,2013-01-24 17:50:27,2013-01-24 17:50:27
0539611bac30c0ada7d0eea4bc2bf4b5ee6e831b...deac80a6e8024de7bc9b485fd083e20da934fccd,1,2,1,3,1,2013-01-24 18:51:03,2013-01-24 18:51:03
deac80a6e8024de7bc9b485fd083e20da934fccd...69be39fccfceae13c4850e1dcf097fcd7d9ce395,1,4,4,8,1,2013-01-24 19:36:03,2013-01-24 18:46:49
69be39fccfceae13c4850e1dcf097fcd7d9ce395...e34519e93bacfa02e220a663aba671403cdbcada,1,1,1,2,1,2013-01-26 21:52:16,2013-01-26 02:02:07
e34519e93bacfa02e220a663aba671403cdbcada...87ba8221ec55ad3e781a1726e85275ae50c1571e,1,2,2,4,1,2013-01-29 21:20:43,2013-01-29 21:20:43
87ba8221ec55ad3e781a1726e85275ae50c1571e...e4cfb9d938c1d9cd08942d3192c281e16d2c200d,1,1,2,3,1,2013-01-29 21:24:33,2013-01-29 19:30:12
e4cfb9d938c1d9cd08942d3192c281e16d2c200d...3b317c5dcb93e1907fe6fae8f1e9b83c35a7a81f,1,5,2,7,3,2013-01-29 21:26:06,2013-01-29 19:34:14
3b317c5dcb93e1907fe6fae8f1e9b83c35a7a81f...250aec71f37ce526aef79e4dd5a56e0feb593484,1,1,1,2,1,2013-01-29 23:38:19,2013-01-28 22:55:49
250aec71f37ce526aef79e4dd5a56e0feb593484...5d0f9ce4c7135014b01970eb6d5e9a254a23b4d0,1,1,1,2,1,2013-01-29 23:46:32,2013-01-27 22:35:33
5d0f9ce4c7135014b01970eb6d5e9a254a23b4d0...17fc6a70feb0476512429e8359cd8c9e175e5aca,1,1,1,2,1,2013-01-29 23:49:10,2013-01-27 22:55:55
17fc6a70feb0476512429e8359cd8c9e175e5aca...e0295cfec4e54246f64e9daecb764454e6e6b071,1,12,0,12,1,2013-01-30 00:16:17,2013-01-25 10:24:50
e0295cfec4e54246f64e9daecb764454e6e6b071...649b892205615a144dafff9984c0e6ab10ed341d,3,42,0,42,5,2013-01-30 15:42:56,2013-01-23 05:01:13
649b892205615a144dafff9984c0e6ab10ed341d...6518369f25ba72abf3e0fe6ef34a3ae1034e0088,1,1,1,2,1,2013-02-04 10:36:29,2013-02-04 07:01:18
6518369f25ba72abf3e0fe6ef34a3ae1034e0088...d8e242418de0f9d51545a03e966b86231f6e092c,1,2,1,3,1,2013-02-04 17:38:01,2013-02-04 17:37:43
d8e242418de0f9d51545a03e966b86231f6e092c...7cc4063303e9fd4fe7b026990d444b5e5abc1f42,1,1,1,2,1,2013-02-05 20:29:11,2013-02-02 19:05:00
7cc4063303e9fd4fe7b026990d444b5e5abc1f42...a83eced974b0ea1bedc12d02d684cf95b3c08b1c,1,3,3,6,1,2013-02-06 19:40:06,2013-02-06 02:14:12
a83eced974b0ea1bedc12d02d684cf95b3c08b1c...6fb1054ce6ae320795963e129cd9bf4c380cd960,1,1,1,2,1,2013-02-06 20:51:42,2013-01-30 21:22:36
6fb1054ce6ae320795963e129cd9bf4c380cd960...bec4435945d9a18eb6650caaca022da00fd7a1d4,1,1,3,4,1,2013-02-06 22:14:49,2013-02-06 22:14:49
bec4435945d9a18eb6650caaca022da00fd7a1d4...b001c8ece5472626bf49cf82753e8ac1aafd2513,2,28,8,36,8,2013-02-07 09:32:04,2013-01-30 09:50:34
b001c8ece5472626bf49cf82753e8ac1aafd2513...8155c3a29ea0eb14806913b8ac08ba7727e1969c,2,28,9,37,11,2013-02-07 09:48:01,2013-02-05 12:37:36
8155c3a29ea0eb14806913b8ac08ba7727e1969c...df744f3af46fc227a934f16cb63c7a6038e7133b,4,30,4,34,11,2013-02-07 10:28:33,2013-02-01 05:41:28
df744f3af46fc227a934f16cb63c7a6038e7133b...7090924515214752b919b0c5630b3ea5e7c77223,2,15,3,18,4,2013-02-07 10:36:25,2013-02-06 09:30:40
7090924515214752b919b0c5630b3ea5e7c77223...92ca7efaa4bc4f37da3008b234e19343a1fa4207,2,20,1,21,2,2013-02-07 10:49:12,2013-02-04 19:38:52
92ca7efaa4bc4f37da3008b234e19343a1fa4207...d46fe3c23fa269dcc10249148f2af14f3db6b066,2,15,2,17,3,2013-02-07 12:09:52,2012-10-09 18:13:26
d46fe3c23fa269dcc10249148f2af14f3db6b066...23dd78f8a463e03df77e505f445923d1946c9ecf,1,6,6,12,6,2013-02-07 12:16:16,2013-02-06 22:16:56
23dd78f8a463e03df77e505f445923d1946c9ecf...ec54712ff3dab1ade44f94fa82d67edeffa79a1d,2,97,2,99,4,2013-02-11 20:29:55,2013-02-11 20:25:34
ec54712ff3dab1ade44f94fa82d67edeffa79a1d...28273b7f1ef52e46d5bc23c41bc7a1492cf23014,1,2,1,3,1,2013-02-11 22:07:03,2013-02-04 16:56:51
28273b7f1ef52e46d5bc23c41bc7a1492cf23014...6b19e7d527dc67113e39bff0060238d78bed9447,1,1,3,4,1,2013-02-11 22:07:49,2013-02-08 11:55:34
6b19e7d527dc67113e39bff0060238d78bed9447...42a5033c563fcb3a3f0ddd89ab62ec36d0e73996,2,79,46,125,19,2013-02-11 22:08:16,2013-02-06 23:25:28
42a5033c563fcb3a3f0ddd89ab62ec36d0e73996...9e57ce0c7af742d15223b9d2aa1f9aed5792d007,1,1,2,3,1,2013-02-12 05:58:00,2013-02-12 05:58:00
9e57ce0c7af742d15223b9d2aa1f9aed5792d007...035e0130f35c4ae1636ffc2822be4762c7b2cc4b,1,21,2,23,4,2013-02-12 06:11:07,2013-02-12 06:10:58
035e0130f35c4ae1636ffc2822be4762c7b2cc4b...c0a0781425625f45e47f3523f115616aa9447f21,1,6,6,12,4,2013-02-12 06:13:15,2013-02-12 05:24:49
c0a0781425625f45e47f3523f115616aa9447f21...dba6bc73e802fdae685a9f351d3e23c7efa8568a,2,238,64,302,15,2013-02-12 06:24:21,2013-02-12 05:43:30
dba6bc73e802fdae685a9f351d3e23c7efa8568a...e47f8d2b9660527d7a62eb3e56a3e4f7f1c272f1,1,3,3,6,1,2013-02-14 19:57:33,2013-02-10 19:40:23
e47f8d2b9660527d7a62eb3e56a3e4f7f1c272f1...a8a3efb5f0b010ec1d4853a3c4f7cbdaf58af1c5,1,1,5,6,1,2013-02-14 20:46:19,2013-02-12 06:46:38
a8a3efb5f0b010ec1d4853a3c4f7cbdaf58af1c5...f3231b944707f5984fc87a3ff34854b3f7630977,1,3,3,6,3,2013-02-14 21:05:25,2013-02-12 02:32:07
f3231b944707f5984fc87a3ff34854b3f7630977...f5835963d5982003a713dd354eefd376ed39ac02,2,12,1,13,2,2013-02-14 21:15:50,2013-02-11 21:21:15
f5835963d5982003a713dd354eefd376ed39ac02...ace54ff08c4593195b49eadb04d258e6409d969e,2,116,17,133,17,2013-02-14 22:43:55,2013-01-24 00:18:18
ace54ff08c4593195b49eadb04d258e6409d969e...6d70ff5c8d1e032ca7d29c48ca55882a64ca1487,3,8,8,16,4,2013-02-14 22:43:55,2013-02-13 03:23:23
6d70ff5c8d1e032ca7d29c48ca55882a64ca1487...755beb2b66ce9f9f9a218f2355bbaf96d94fbc15,2,19,3,22,2,2013-02-14 22:43:55,2013-01-19 04:51:17
755beb2b66ce9f9f9a218f2355bbaf96d94fbc15...b7e1fb0515798e1b4f3f2426f6b050951bee2617,2,13,1,14,2,2013-02-14 22:43:55,2013-01-23 09:53:49
b7e1fb0515798e1b4f3f2426f6b050951bee2617...12ba6cec4fb79521101744e02a7e09f9fbb591c4,3,45,1,46,4,2013-02-14 22:43:55,2012-11-06 22:35:47
12ba6cec4fb79521101744e02a7e09f9fbb591c4...ef268196b9eb322c0e449e454be9d001c371e37e,2,3,3,6,3,2013-02-14 22:43:56,2012-11-04 21:26:58
ef268196b9eb322c0e449e454be9d001c371e37e...3b14092135ab02a4b08c0ba21d40726684acf83e,1,4,3,7,1,2013-02-14 22:43:56,2012-11-04 22:36:35
3b14092135ab02a4b08c0ba21d40726684acf83e...1ed638582d2f2c7f89384d9712f4cfac52cc5b70,2,108,11,119,16,2013-02-14 22:43:56,2012-11-04 13:05:58
1ed638582d2f2c7f89384d9712f4cfac52cc5b70...1d7a95df565192fc02a18b0b297b39dd615eaeb5,2,21,1,22,5,2013-02-14 22:43:56,2012-11-04 21:11:24
1d7a95df565192fc02a18b0b297b39dd615eaeb5...2a2123441c2b749b8f316a24c3ca3f77a9132a01,2,27,17,44,10,2013-02-14 22:52:46,2013-01-30 15:41:39
2a2123441c2b749b8f316a24c3ca3f77a9132a01...288b69a314e9bd14458b6647532eb62aad5c5cdf,3,15,6,21,4,2013-02-14 22:52:46,2013-02-14 22:39:55
288b69a314e9bd14458b6647532eb62aad5c5cdf...7c6b1e06e83585c174a94b0cdf09921c092861b6,1,1,1,2,1,2013-02-14 23:11:04,2013-02-14 21:00:53
7c6b1e06e83585c174a94b0cdf09921c092861b6...5548328b67e99cdacc0292481fc9c1e3cbc52fca,1,3,3,6,3,2013-02-14 23:18:58,2013-02-12 00:05:29
5548328b67e99cdacc0292481fc9c1e3cbc52fca...9b7c1d0f7ce442d4ad2ec587e66d2d335e64fa4e,1,3,2,5,2,2013-02-14 23:36:03,2013-02-08 20:00:05
9b7c1d0f7ce442d4ad2ec587e66d2d335e64fa4e...027f20be1fe426e39a0404e74b17bc654273391c,1,4,4,8,2,2013-02-14 23:47:16,2013-02-11 22:56:59
027f20be1fe426e39a0404e74b17bc654273391c...37bdcc984a0240cf0ac125613acee12f1cee389d,1,3,3,6,1,2013-02-14 23:47:16,2013-02-10 19:42:55
37bdcc984a0240cf0ac125613acee12f1cee389d...3c2aee01b0b299995eb92f4255159585b0f53c10,2,2,2,4,2,2013-02-15 00:37:00,2013-02-15 00:37:00
3c2aee01b0b299995eb92f4255159585b0f53c10...1ace5eb39632ae189fdabee176c6e918960d0578,1,3,3,6,3,2013-02-15 00:38:43,2013-02-15 00:38:43
1ace5eb39632ae189fdabee176c6e918960d0578...37e8b12265291918396bfee65d444a8f63697b73,3,34,9,43,5,2013-02-15 00:42:58,2013-02-14 23:13:50
37e8b12265291918396bfee65d444a8f63697b73...e19b04c9ec985821edf1269c628cfa261f81d631,2,26,1,27,3,2013-02-15 00:45:30,2013-01-18 22:09:19
e19b04c9ec985821edf1269c628cfa261f81d631...0af172040e03811c59d01682968241e3df226774,2,72,16,88,9,2013-02-15 03:55:05,2013-02-06 13:08:40
0af172040e03811c59d01682968241e3df226774...2ed53087d7dd06d728e333a449265f7685275548,2,11,13,24,6,2013-02-15 05:36:59,2012-10-24 10:06:36
2ed53087d7dd06d728e333a449265f7685275548...bb8448c011127306df08c7479b66e5afe7a0fa94,2,4,3,7,3,2013-02-15 05:36:59,2012-11-19 10:01:53
bb8448c011127306df08c7479b66e5afe7a0fa94...7eafbb98c64c0dc079d7d3ec589f1270b7f6fea5,2,80,7,87,5,2013-02-15 05:36:59,2012-11-12 21:09:53
7eafbb98c64c0dc079d7d3ec589f1270b7f6fea5...791804bdbfa6da7a39283623bd05628a01cd8720,4,75,4,79,7,2013-02-18 12:05:16,2013-02-18 12:05:16
791804bdbfa6da7a39283623bd05628a01cd8720...5f5d4feadbfa9d8ecc8150041dfd2bca2b2e9fea,2,14,1,15,4,2013-02-19 04:25:43,2013-02-15 23:32:38
5f5d4feadbfa9d8ecc8150041dfd2bca2b2e9fea...9532234bf1c408af9a6fd2c4743fdb585b920531,3,197,9,206,14,2013-02-20 08:06:26,2013-02-19 17:55:05
9532234bf1c408af9a6fd2c4743fdb585b920531...776dfc678b0e726fa9cfbe9fe1c2760b48002296,1,120,0,120,1,2013-02-20 19:16:19,2013-02-20 19:11:11
776dfc678b0e726fa9cfbe9fe1c2760b48002296...de6d4ca1da2920f41017899149e064b7e849a7a4,1,1,1,2,1,2013-02-20 20:54:44,2013-02-20 20:54:44
de6d4ca1da2920f41017899149e064b7e849a7a4...2508b47c1a34dfc834f8fde858574f81af4d287e,1,2,2,4,2,2013-02-20 23:44:19,2013-02-20 23:44:09
2508b47c1a34dfc834f8fde858574f81af4d287e...d44ca19da7f4bd601d28822fb52d30fc006625f3,1,3,3,6,1,2013-02-24 05:11:51,2013-02-24 05:08:32
d44ca19da7f4bd601d28822fb52d30fc006625f3...509ec745fdbb54b54672fbf8595a4958c16f2b53,1,6,2,8,1,2013-02-24 06:16:41,2013-02-24 06:16:35
509ec745fdbb54b54672fbf8595a4958c16f2b53...bec614fd90c48c3921a4b659912008574e553b40,2,23,1,24,2,2013-02-24 07:22:14,2013-02-24 06:54:35
bec614fd90c48c3921a4b659912008574e553b40...c36933d38fcdba5d2c8da0e1804a54ed4efdf95d,1,1,1,2,1,2013-02-24 07:44:40,2013-02-19 18:19:52
c36933d38fcdba5d2c8da0e1804a54ed4efdf95d...7b236b29aa3a6f6dfe722815e0a2667d9b7f0899,2,5,1,6,2,2013-02-25 18:02:28,2013-02-25 18:02:28
7b236b29aa3a6f6dfe722815e0a2667d9b7f0899...e27bb6eb132a68665c8fca3f5a216b19b1129ba6,2,85,18,103,5,2013-02-25 18:58:05,2013-02-23 14:54:55
e27bb6eb132a68665c8fca3f5a216b19b1129ba6...7d18d0ae262915e449bde97ad9dda3154d6d2d06,1,6,14,20,5,2013-02-25 18:58:10,2013-02-24 08:11:25
7d18d0ae262915e449bde97ad9dda3154d6d2d06...30162b769cccb1965a4ad85a4eedd805d3764853,1,1,1,2,1,2013-02-25 21:51:13,2013-02-25 20:12:59
30162b769cccb1965a4ad85a4eedd805d3764853...ac899d0da59157fa1c6429510791b6c3103d9401,3,39,3,42,6,2013-02-25 22:30:54,2013-01-26 19:15:06
ac899d0da59157fa1c6429510791b6c3103d9401...6a612df7de0162449d937d40b20b34a306ec9a75,1,3,2,5,2,2013-02-25 22:51:52,2013-01-27 02:39:42
6a612df7de0162449d937d40b20b34a306ec9a75...753fc9e58d5e554d4930548558efecc283557eeb,2,12,8,20,2,2013-02-25 23:32:14,2013-02-06 11:15:18
753fc9e58d5e554d4930548558efecc283557eeb...7ddbde8c1c00e08a63de9701e29bf5e8bed051b8,2,19,11,30,7,2013-02-26 05:38:29,2013-02-26 04:43:27
7ddbde8c1c00e08a63de9701e29bf5e8bed051b8...398691beb3fc40a481afa258d181de06ec0d153c,2,32,3,35,5,2013-02-26 05:44:00,2013-01-22 15:59:09
398691beb3fc40a481afa258d181de06ec0d153c...639786083151ff93d70d31332bad143483140de0,1,1,1,2,1,2013-02-26 07:52:12,2013-02-26 07:20:41
639786083151ff93d70d31332bad143483140de0...d4fe383b7bc2314369199023f121064aec9cc167,1,0,2,2,2,2013-02-26 07:54:29,2013-02-26 07:27:20
d4fe383b7bc2314369199023f121064aec9cc167...c38c1c503074af1b0aae7498b9381cb90cd63958,1,1,1,2,1,2013-02-26 07:54:44,2013-02-26 07:29:41
c38c1c503074af1b0aae7498b9381cb90cd63958...86d191ed4aea9015adc71b852223475c5c762c34,4,20,6,26,8,2013-02-27 01:25:15,2013-02-26 05:25:18
86d191ed4aea9015adc71b852223475c5c762c34...cf17c6af475eace31cf52944afd8e10d3afcf6c0,3,71,3,74,6,2013-02-27 08:55:40,2013-02-25 23:00:47
cf17c6af475eace31cf52944afd8e10d3afcf6c0...60f1f099fc7e5197808cd6acb7407cdc40f50a3f,2,79,13,92,10,2013-02-27 18:52:30,2013-02-22 02:49:26
60f1f099fc7e5197808cd6acb7407cdc40f50a3f...5e18a15fb01d2e81adda68503754289fa9655082,2,77,4,81,8,2013-02-27 20:45:30,2013-02-23 20:45:48
5e18a15fb01d2e81adda68503754289fa9655082...eb53423a41136fcda0c5e711f2d104952080354b,3,76,3,79,8,2013-02-28 01:57:59,2013-02-21 20:56:40
eb53423a41136fcda0c5e711f2d104952080354b...fe8d893b839e9b14e3e55a3a0523cc1e6355bdd5,2,22,6,28,4,2013-03-01 01:27:27,2013-02-26 10:14:27
fe8d893b839e9b14e3e55a3a0523cc1e6355bdd5...79b51d5b578927bd510123c81953e7cc8c72f211,18,468,682,1150,38,2013-03-06 07:00:33,2012-10-21 06:37:59
79b51d5b578927bd510123c81953e7cc8c72f211...49128cc1005f0bea6074107c1098b6866eed74f5,1,8,4,12,1,2013-03-06 19:20:30,2013-03-06 19:20:30
49128cc1005f0bea6074107c1098b6866eed74f5...8a96393179d81c57a4ea0ea459aa7f77d63ae5d5,1,3,2,5,2,2013-03-06 22:51:16,2013-03-06 20:43:56
8a96393179d81c57a4ea0ea459aa7f77d63ae5d5...d38d8448e85e114e6bee39f54919f8522bdea013,1,1,1,2,1,2013-03-06 22:51:21,2013-03-06 22:23:05
d38d8448e85e114e6bee39f54919f8522bdea013...485f1040990508441cebf4cddab83a126e65355f,1,4,0,4,1,2013-03-06 22:54:35,2013-03-06 19:05:19
485f1040990508441cebf4cddab83a126e65355f...603fe0d19608ffe1915d8bc23bf412912e7ee1ac,2,106,18,124,4,2013-03-07 00:19:35,2013-02-21 19:55:16
603fe0d19608ffe1915d8bc23bf412912e7ee1ac...99f3b70b2d316f5bb39e21249e752c29f49c90ab,2,78,2,80,3,2013-03-08 18:19:18,2013-02-28 05:25:21
99f3b70b2d316f5bb39e21249e752c29f49c90ab...cb5ce981fb824970cc5bdd68ecb685e9aba3c268,1,9,0,9,1,2013-03-08 19:04:32,2013-03-05 03:04:18
cb5ce981fb824970cc5bdd68ecb685e9aba3c268...6f71e809141bf89501e55c378921d6e7ec9512bc,1,2,2,4,2,2013-03-08 20:00:34,2013-03-08 19:43:37
6f71e809141bf89501e55c378921d6e7ec9512bc...65e57a7c3d53fad536797301fe59b5912ed4db16,1,88,33,121,9,2013-03-08 20:00:34,2013-03-08 19:59:41
65e57a7c3d53fad536797301fe59b5912ed4db16...f20646bce5f0c914992a78fc2556bda136c27ac9,2,26,1,27,3,2013-03-08 20:56:32,2013-03-05 17:43:06
f20646bce5f0c914992a78fc2556bda136c27ac9...69ef17cce9e94eabbe67eabfbacbe14137b599c9,1,1,1,2,1,2013-03-08 22:26:41,2013-03-07 03:32:43
69ef17cce9e94eabbe67eabfbacbe14137b599c9...a248d5a32d0ec40de599add92eb5ecfbae66391b,1,1,1,2,1,2013-03-08 22:44:44,2013-03-07 22:17:34
a248d5a32d0ec40de599add92eb5ecfbae66391b...96b13bbee17819fb28c9a4e1e22e426b1b07a554,169,1453,883,2336,597,2013-03-08 23:46:59,2013-03-08 23:42:03
96b13bbee17819fb28c9a4e1e22e426b1b07a554...90ba9aadc6693e01487e6e14e7d1065658572e0f,1,1,1,2,1,2013-03-09 01:23:04,2013-03-08 17:52:46
90ba9aadc6693e01487e6e14e7d1065658572e0f...e88d6179c3a6a137e75fa09de906fc83c6515db2,2,71,5,76,8,2013-03-11 18:31:04,2013-03-04 01:23:29
e88d6179c3a6a137e75fa09de906fc83c6515db2...9befe37014141fbfdf0cded318d28322fc058c13,2,17,5,22,6,2013-03-11 22:26:38,2013-03-08 13:53:54
9befe37014141fbfdf0cded318d28322fc058c13...5fd39e050b047fb5f4359eb3ebfde76f257b5ecf,1,1,1,2,1,2013-03-11 22:26:50,2013-03-11 22:07:51
5fd39e050b047fb5f4359eb3ebfde76f257b5ecf...d1b49e25f1c8e303d57f44d1d3417dbefb194a5c,1,3,3,6,3,2013-03-12 20:00:03,2013-03-12 05:31:23
d1b49e25f1c8e303d57f44d1d3417dbefb194a5c...707c65d5a228b44ab3aea2fad95516fe6c57169a,6,578,4,582,13,2013-03-14 05:59:06,2013-02-08 18:39:23
707c65d5a228b44ab3aea2fad95516fe6c57169a...9428338e97da954b471e96a8d8ceedb7e4a65ab0,1,1,0,1,1,2013-03-14 06:01:16,2013-03-13 05:51:47
9428338e97da954b471e96a8d8ceedb7e4a65ab0...79049b9fee5690b8370c51e0fbb82d7a16b787fc,1,2,2,4,1,2013-03-15 05:03:37,2013-03-14 16:42:38
79049b9fee5690b8370c51e0fbb82d7a16b787fc...1c1cd4fdf6b6d7511c7b8dc61b8042011dc54830,2,10,1,11,3,2013-03-15 05:16:54,2013-03-14 11:49:13
1c1cd4fdf6b6d7511c7b8dc61b8042011dc54830...f197e391c1148398825bfd1af8d000d351821c97,3,7,2,9,4,2013-03-16 03:56:13,2013-03-15 16:47:08
f197e391c1148398825bfd1af8d000d351821c97...df9bff13b2bf8376428cd28fce472aeee07c4bbe,1,2,1,3,2,2013-03-16 04:02:21,2013-03-15 09:24:52
df9bff13b2bf8376428cd28fce472aeee07c4bbe...3a81dd8bddbade81c4c9f734813458d0d969a4bf,2,14,1,15,2,2013-03-16 04:19:31,2013-03-07 12:36:38
3a81dd8bddbade81c4c9f734813458d0d969a4bf...fe4f0ea262da180268c2cfe42d328447e9fe3d99,1,5,5,10,1,2013-03-19 17:53:46,2013-03-19 04:02:03
fe4f0ea262da180268c2cfe42d328447e9fe3d99...564963dc27c7d1da681cbda22cf9b219ad51e967,1,1,1,2,1,2013-03-19 17:56:48,2013-03-18 14:40:17
564963dc27c7d1da681cbda22cf9b219ad51e967...ef76afdf8096bca3eb4e3e3180a7f34de7f193f9,1,2,4,6,3,2013-03-19 18:00:42,2013-03-18 18:18:30
ef76afdf8096bca3eb4e3e3180a7f34de7f193f9...821d2fddb734330a49b3a96c2519d3e43a8c4a6e,1,1,1,2,1,2013-03-20 18:44:17,2013-03-18 08:25:36
821d2fddb734330a49b3a96c2519d3e43a8c4a6e...4efda14b499fa1dbc115f17bb3bf42385a00e239,1,3,3,6,3,2013-03-20 21:16:41,2013-03-19 15:10:04
4efda14b499fa1dbc115f17bb3bf42385a00e239...fec2909f3a5e97bfabbb65d957e0d20d1a588e40,1,4,4,8,2,2013-03-20 21:21:26,2013-03-20 20:38:59
fec2909f3a5e97bfabbb65d957e0d20d1a588e40...0c72708a2bb123d2772f5c6b8cb6adc61f197a72,280,43042,169,43211,280,2013-03-20 22:50:07,2013-03-18 22:54:18
0c72708a2bb123d2772f5c6b8cb6adc61f197a72...23abb990f10270f7992429ef83f86b83c91f75ea,8,501,108,609,28,2013-03-20 23:19:46,2013-03-08 23:37:56
23abb990f10270f7992429ef83f86b83c91f75ea...364e597499d48bc49eb8890404da67f18e84df16,1,1,1,2,1,2013-03-25 06:11:36,2013-03-25 06:11:36
364e597499d48bc49eb8890404da67f18e84df16...5c735eb4ab07144a62949472ed388cb185099201,1,1,1,2,1,2013-03-27 15:56:06,2013-03-09 06:06:38
5c735eb4ab07144a62949472ed388cb185099201...4ae46814ff4e7c0bbcdbbefc0a97277283a84065,6,480,82,562,44,2013-03-27 20:13:59,2013-02-26 09:22:12
4ae46814ff4e7c0bbcdbbefc0a97277283a84065...9480136d9f062ec4b8df0a35914b48c0d61e0002,21,34,34,68,33,2013-03-29 22:14:55,2013-03-21 19:09:47
9480136d9f062ec4b8df0a35914b48c0d61e0002...06ada222c26f717552fad88fb9534abf09824c61,1,1,1,2,1,2013-03-29 22:18:01,2013-03-22 09:45:08
06ada222c26f717552fad88fb9534abf09824c61...53abd3fba779c63e096af04663b898767bce36f3,1,1,1,2,1,2013-03-29 22:22:02,2013-03-22 19:25:29
53abd3fba779c63e096af04663b898767bce36f3...8dca0561e82b16564d70c5d798c0d3ab3fe49144,1,3,3,6,3,2013-03-29 22:24:12,2013-03-23 17:48:25
8dca0561e82b16564d70c5d798c0d3ab3fe49144...7d4a3210f017bcdffcbe04586f16398c0054e222,1,1,1,2,1,2013-03-29 22:25:58,2013-03-26 03:41:31
7d4a3210f017bcdffcbe04586f16398c0054e222...04cc1d2890fc6bf9c4e82a4c7cacd5a652ccbdc9,1,3,2,5,1,2013-03-29 22:30:37,2013-03-27 03:55:58
04cc1d2890fc6bf9c4e82a4c7cacd5a652ccbdc9...5eb968553a1130461ab8704535691e00eb154ac2,2,300,0,300,2,2013-03-30 05:00:25,2013-03-15 19:42:00
5eb968553a1130461ab8704535691e00eb154ac2...61f2767ce65562257599649d9eaf9da08f321655,5,346,352,698,56,2013-03-30 06:01:52,2013-03-20 05:27:27
61f2767ce65562257599649d9eaf9da08f321655...c2e215fab6ba73e195f8c32701cfb6e88e8e1ebd,9,14,14,28,9,2013-04-01 19:24:27,2013-03-21 01:57:13
c2e215fab6ba73e195f8c32701cfb6e88e8e1ebd...85c31e068821f412128d98265ed439a725400528,1,4,3,7,2,2013-04-02 04:33:31,2013-04-02 04:33:18
85c31e068821f412128d98265ed439a725400528...4bfb66ce0be46d3a0e9da2f80f3e1d0c2b559828,2,6,6,12,6,2013-04-02 20:36:12,2013-04-02 16:02:02
4bfb66ce0be46d3a0e9da2f80f3e1d0c2b559828...0b6f1ce5f89f47f9302ff1e8cd8f4b92f837c413,25,1611,84,1695,70,2013-04-02 21:05:06,2013-03-20 23:24:23
0b6f1ce5f89f47f9302ff1e8cd8f4b92f837c413...2845dd159087fc59eb29845a578f32c7c462e8e6,3,64,19,83,6,2013-04-02 22:52:32,2013-04-02 22:20:33
2845dd159087fc59eb29845a578f32c7c462e8e6...556f9cc35ef1a4fb3551bd98b2efa9c63c77bb3b,1,2,3,5,3,2013-04-03 09:15:03,2013-04-03 08:17:32
556f9cc35ef1a4fb3551bd98b2efa9c63c77bb3b...6bca9483238df5df81c492c8700d8914c76dc76e,1,3,3,6,3,2013-04-03 21:35:09,2013-04-03 21:35:09
6bca9483238df5df81c492c8700d8914c76dc76e...820253f6708731388a47bc65124e2a457f0536d8,1,0,1,1,1,2013-04-03 21:54:16,2013-04-03 21:54:16
820253f6708731388a47bc65124e2a457f0536d8...ecdf119a76476f2a57105a3170be4075e43765c3,2,4,4,8,4,2013-04-03 22:20:53,2013-04-03 21:55:03
ecdf119a76476f2a57105a3170be4075e43765c3...fec4ef38815340e8e5a6b65fd6c08f5c74e701d8,3,37,7,44,11,2013-04-04 00:40:15,2013-04-03 21:36:57
fec4ef38815340e8e5a6b65fd6c08f5c74e701d8...303df9dafee4314e5cfbc805f3321f4f4297a41a,1,1,1,2,1,2013-04-04 00:40:15,2013-04-03 22:35:43
303df9dafee4314e5cfbc805f3321f4f4297a41a...19f1801379104bc1f74fbb9d288f71034ba829c9,10,496,97,593,33,2013-04-04 00:40:15,2013-04-02 23:41:16
19f1801379104bc1f74fbb9d288f71034ba829c9...308a59bf445759b32c20e9057a6dcc241042bdca,2,22,1,23,3,2013-04-04 01:42:17,2013-04-04 00:34:47
308a59bf445759b32c20e9057a6dcc241042bdca...5e3ee0a99b590cf8d9786df29a94ad8833183cd0,1,1,1,2,1,2013-04-04 01:54:52,2013-04-04 01:54:52
5e3ee0a99b590cf8d9786df29a94ad8833183cd0...2ce74e547a3912736910f1b654e383f112a9bae0,1,4,2,6,2,2013-04-04 15:57:25,2013-04-04 15:57:14
2ce74e547a3912736910f1b654e383f112a9bae0...7729b58edaee80503cb6ed704f51780436f6072b,1,134,0,134,1,2013-04-04 19:15:37,2013-04-04 17:41:13
7729b58edaee80503cb6ed704f51780436f6072b...cc042c42bce0817d9b9bbf6b3b3f7a2235cf27fb,1,1,1,2,1,2013-04-04 22:24:15,2013-04-04 22:24:15
cc042c42bce0817d9b9bbf6b3b3f7a2235cf27fb...d90a79632d699efcb63484e20d2bf756ebe94688,1,2,2,4,2,2013-04-06 20:56:54,2013-03-29 01:01:09
d90a79632d699efcb63484e20d2bf756ebe94688...be08c075bd71cd26086378768bd1d57f99ff213e,2,50,1,51,2,2013-04-09 04:26:19,2013-04-04 03:35:18
be08c075bd71cd26086378768bd1d57f99ff213e...f9b63f86570386e0e186f0c9a5a7f36bb4ed44d5,1,1,1,2,1,2013-04-11 19:15:25,2013-04-04 10:44:26
f9b63f86570386e0e186f0c9a5a7f36bb4ed44d5...725028b07dbd60d0f40b94be3fe191d4e8c93cc9,1,1,1,2,1,2013-04-11 19:39:00,2013-04-11 15:35:53
725028b07dbd60d0f40b94be3fe191d4e8c93cc9...a752e5763e52d3a220b70f3268a1f55134f53134,1,3,3,6,1,2013-04-11 19:51:47,2013-04-11 19:51:47
a752e5763e52d3a220b70f3268a1f55134f53134...f24cf4b58f3c2e56df188738356b21e6c898ff0c,2,49,24,73,4,2013-04-11 20:00:10,2013-04-11 00:46:57
f24cf4b58f3c2e56df188738356b21e6c898ff0c...5e0f876c39099adb6a0300c429b8df1f6b544846,6,295,9,304,10,2013-04-11 20:01:24,2013-03-08 14:38:29
5e0f876c39099adb6a0300c429b8df1f6b544846...48308913bb1b6f2eaa8c1a59348a76e99c14d320,1,2,2,4,2,2013-04-11 20:05:27,2013-04-02 21:38:23
48308913bb1b6f2eaa8c1a59348a76e99c14d320...16bfb7eea0dfd3ef11dc5ee04872cce108275bf0,1,1,1,2,1,2013-04-11 20:48:04,2013-04-07 20:15:22
16bfb7eea0dfd3ef11dc5ee04872cce108275bf0...e142687bcb2dad9cd361e0e7239ca5f77b2bfcf9,1,2,2,4,2,2013-04-11 20:51:40,2013-04-09 05:25:59
e142687bcb2dad9cd361e0e7239ca5f77b2bfcf9...59eb96b9e4aec9268b1b59d045a4fce8f3deea92,1,4,0,4,1,2013-04-11 20:55:03,2013-04-08 23:04:23
59eb96b9e4aec9268b1b59d045a4fce8f3deea92...63ce1f62657eed15849172161efe012e6500cd9f,1,14,8,22,4,2013-04-11 21:00:09,2013-04-08 23:50:32
63ce1f62657eed15849172161efe012e6500cd9f...3ec7b874838c928213bcd519b3647da5b9e6ef11,1,2,2,4,2,2013-04-11 21:03:52,2013-04-07 20:08:12
3ec7b874838c928213bcd519b3647da5b9e6ef11...941633a911c28323b765ca5d675b242c0126e572,1,2,2,4,1,2013-04-11 21:07:31,2013-04-07 19:23:36
941633a911c28323b765ca5d675b242c0126e572...38dffe7e918872c35ea65efc2757d18820b4904a,1,1,1,2,1,2013-04-11 21:08:43,2013-04-07 18:59:01
38dffe7e918872c35ea65efc2757d18820b4904a...d9d53472ecf87941dd9864d417cde31975d47854,1,44,44,88,37,2013-04-11 21:10:57,2013-03-29 23:36:33
d9d53472ecf87941dd9864d417cde31975d47854...5476cb6e9b6d7a16e3a86585bc2db5e63b16cd4d,2,141,38,179,15,2013-04-11 21:15:20,2013-04-09 00:37:57
5476cb6e9b6d7a16e3a86585bc2db5e63b16cd4d...1351ba2632b5011ad6eaddf004a7f0411bea8453,8,241,60,301,64,2013-04-11 21:15:20,2013-04-09 22:33:16
1351ba2632b5011ad6eaddf004a7f0411bea8453...63c25fd875d4516b9e55e629496b7e3791d08afc,1,1,1,2,1,2013-04-11 21:25:50,2013-03-30 12:51:28
63c25fd875d4516b9e55e629496b7e3791d08afc...db547e63eef473f1d3a926b08656deac253ef995,1,2,2,4,1,2013-04-11 21:32:44,2013-03-24 02:53:31
db547e63eef473f1d3a926b08656deac253ef995...719d844a94f304606ad1832bd76d478b96acb2bf,1,1,1,2,1,2013-04-11 21:53:40,2013-04-07 12:10:12
719d844a94f304606ad1832bd76d478b96acb2bf...ebf7cf9ed3bb1555c157c52e442cd2d4b9ca3b94,1,1,1,2,1,2013-04-11 21:56:30,2013-04-07 07:17:24
ebf7cf9ed3bb1555c157c52e442cd2d4b9ca3b94...d521ad3ff6e3800a32464d4f0739a3b6ab9cf0b1,1,1,1,2,1,2013-04-11 21:58:39,2013-04-06 21:29:16
d521ad3ff6e3800a32464d4f0739a3b6ab9cf0b1...a92bb2e02564e9e6cec4ec6c15c3e058a8f37de5,2,3,3,6,3,2013-04-11 22:03:59,2013-04-11 21:14:20
a92bb2e02564e9e6cec4ec6c15c3e058a8f37de5...15d80af53c3eac09eab2154b3e7a7084f9f8d181,1,6,6,12,4,2013-04-11 22:11:28,2013-04-03 08:29:04
15d80af53c3eac09eab2154b3e7a7084f9f8d181...aa3acc5229b40b14322849894d6ccda3a9459e8b,1,3,3,6,2,2013-04-11 22:14:46,2013-04-05 18:39:28
aa3acc5229b40b14322849894d6ccda3a9459e8b...b86815fb5bc108a0479a69f2dfb2d528543ae341,1,1,1,2,1,2013-04-11 22:21:33,2013-03-26 15:47:39
b86815fb5bc108a0479a69f2dfb2d528543ae341...6b63afe2f7d51bf62819887f37976dfe2a26761e,1,1,1,2,1,2013-04-11 22:27:46,2013-03-27 18:18:34
6b63afe2f7d51bf62819887f37976dfe2a26761e...c3a87c684953f4ec34363e46bb1da297c08058f4,1,7,1,8,1,2013-04-11 22:32:19,2013-03-27 07:12:45
c3a87c684953f4ec34363e46bb1da297c08058f4...fe1696f68885aa2b6fd8959972d3533442a99cc6,1,1,1,2,1,2013-04-11 22:32:20,2013-03-29 06:23:02
fe1696f68885aa2b6fd8959972d3533442a99cc6...a491ea3791eb56e9932e12ded1395e0e5e99355a,1,1,1,2,1,2013-04-11 23:28:10,2013-03-27 05:34:13
a491ea3791eb56e9932e12ded1395e0e5e99355a...a0bc71e27107c58282e71415c4e8d89e916ae99c,3,33,10,43,10,2013-04-12 06:06:07,2013-04-11 23:28:42
a0bc71e27107c58282e71415c4e8d89e916ae99c...3c3247fe174ce408459bd018c9d83e84490789f5,3,41,28,69,23,2013-04-12 06:06:07,2013-04-04 12:49:04
3c3247fe174ce408459bd018c9d83e84490789f5...570463a465fae02efc33e5a1fa963437cdc275dd,8,262,228,490,55,2013-04-12 06:06:07,2013-04-12 05:39:15
570463a465fae02efc33e5a1fa963437cdc275dd...b7b08eed027b9e02bbd8757d426c124a002b27b5,1,2,1,3,1,2013-04-12 22:58:29,2013-04-12 17:00:02
b7b08eed027b9e02bbd8757d426c124a002b27b5...ab755a25f9ca3f3f000623071d8de3ddc4b1d78e,1,3,2,5,2,2013-04-13 07:42:51,2013-04-13 06:24:45
ab755a25f9ca3f3f000623071d8de3ddc4b1d78e...0d8a95af6f89462603756c0d6904b18aac224d44,1,1,1,2,1,2013-04-13 15:19:11,2013-04-13 07:15:12
0d8a95af6f89462603756c0d6904b18aac224d44...c746d65857e135c546da84a486f8aa31425a0568,1,1,2,3,1,2013-04-13 16:24:40,2013-04-12 23:39:04
c746d65857e135c546da84a486f8aa31425a0568...5d1f37b535d2a4c3e5e58cc61fece40c6277c798,1,1,1,2,1,2013-04-15 10:20:46,2013-04-15 10:20:46
5d1f37b535d2a4c3e5e58cc61fece40c6277c798...cc1e4225b77532dd823635ee42aba188038fe26f,1,1,1,2,1,2013-04-15 10:42:34,2013-04-13 17:29:16
cc1e4225b77532dd823635ee42aba188038fe26f...c25343f8beb2d9483a82a21c9dcfd0a7e61a40a2,1,8,8,16,7,2013-04-15 10:42:57,2013-04-14 07:27:53
c25343f8beb2d9483a82a21c9dcfd0a7e61a40a2...a748410f52642a642d5ce47bbffd0d0f8616e4ad,1,1,1,2,1,2013-04-15 10:44:49,2013-04-15 10:44:49
a748410f52642a642d5ce47bbffd0d0f8616e4ad...59bfe8e5a9edf7ba000d258b9ac1ef8355c9aca7,10,27,26,53,24,2013-04-15 11:28:31,2013-04-15 11:28:31
59bfe8e5a9edf7ba000d258b9ac1ef8355c9aca7...58ef32308f45141c8f7f7cc32a6156cd328ba692,4,186,206,392,77,2013-04-15 19:05:27,2012-06-13 22:37:52
58ef32308f45141c8f7f7cc32a6156cd328ba692...465238613b5b849bf833bdc71d3b42f15dc0e19b,1,3,3,6,3,2013-04-16 11:13:55,2013-04-16 11:13:55
465238613b5b849bf833bdc71d3b42f15dc0e19b...0ac969a5ee1687cfd4517821943f34fe948bb3fc,2,18,4,22,5,2013-04-16 12:15:49,2013-04-16 11:29:56
0ac969a5ee1687cfd4517821943f34fe948bb3fc...b8f0b432fd320f42da7c0c927ea7b9ccf87db210,1,1,4,5,1,2013-04-16 12:37:07,2013-04-15 15:27:36
b8f0b432fd320f42da7c0c927ea7b9ccf87db210...a91405889f0d0d5c3ed41f2a77c9305a404ded7f,1,1,1,2,1,2013-04-16 20:04:09,2013-04-16 15:19:04
a91405889f0d0d5c3ed41f2a77c9305a404ded7f...12b6deb1ce99df64e2fc91a06bf05cd7f4a3a475,2,17,3,20,3,2013-04-16 21:49:17,2013-03-30 04:45:53
12b6deb1ce99df64e2fc91a06bf05cd7f4a3a475...9f2aaca65b72412dd12af49385602a7bfec62d51,1,1,1,2,1,2013-04-17 13:46:13,2013-04-16 23:35:17
9f2aaca65b72412dd12af49385602a7bfec62d51...fd91d86f0c10e875912d14469892ac673b6d5165,1,1,1,2,1,2013-04-17 13:50:19,2013-04-16 23:54:35
fd91d86f0c10e875912d14469892ac673b6d5165...c4d5631f1a3d66340f82a0cd6a50d53057110c1a,1,1,1,2,1,2013-04-17 13:51:41,2013-04-17 00:22:49
c4d5631f1a3d66340f82a0cd6a50d53057110c1a...363e4cbf649de4c5206f1904ee76f89301ceaab0,2,47,8,55,6,2013-04-17 20:20:08,2013-03-21 07:07:49
363e4cbf649de4c5206f1904ee76f89301ceaab0...695c54c17b3299cd6170c45878b41cb46a577cd2,250,4601,4585,9186,1710,2013-04-17 21:13:49,2013-04-17 21:13:49
695c54c17b3299cd6170c45878b41cb46a577cd2...5da6b125a7447b4bbabb88b2d82b5634b55c3aea,4,166,117,283,19,2013-04-18 21:34:53,2013-04-18 19:50:49
5da6b125a7447b4bbabb88b2d82b5634b55c3aea...4c7baf970faa90efe9cbd19933f5648353b02f43,1,1,1,2,1,2013-04-19 10:55:16,2013-04-18 09:41:03
4c7baf970faa90efe9cbd19933f5648353b02f43...f77b906d670b27acf4fb0deedb5580493fa212e9,1,2,1,3,1,2013-04-19 12:36:22,2013-04-19 06:44:10
f77b906d670b27acf4fb0deedb5580493fa212e9...120b9190ea7b89eb0bcf2c0a63c08e8d75b0f657,1,2,2,4,1,2013-04-19 12:43:09,2013-04-18 16:20:26
120b9190ea7b89eb0bcf2c0a63c08e8d75b0f657...1d3e79e24e4abbc93f80653405c60e758f5c2163,1,2,2,4,2,2013-04-19 13:39:58,2013-04-17 21:26:49
1d3e79e24e4abbc93f80653405c60e758f5c2163...8a2bfd7a78fbed2fcf2fd0a0301979b02b89cab2,1,1,1,2,1,2013-04-19 13:44:14,2013-04-17 21:24:35
8a2bfd7a78fbed2fcf2fd0a0301979b02b89cab2...2f96fbd17577685bc013a4f7ced06664af253944,4,276,0,276,4,2013-04-19 20:45:38,2013-04-05 01:17:58
2f96fbd17577685bc013a4f7ced06664af253944...59c29e320a2c764e59f990e2064689b0b4fc33c7,1,1,1,2,1,2013-04-19 20:56:39,2013-04-19 15:26:51
59c29e320a2c764e59f990e2064689b0b4fc33c7...2c34596b32e4ec72c680bc7cf1eaff183d870b7a,1,1,1,2,1,2013-04-21 17:53:52,2013-04-21 12:01:00
2c34596b32e4ec72c680bc7cf1eaff183d870b7a...af9c20c07dee8635a04f7ee0532d9d41553811bc,1,1,1,2,1,2013-04-22 11:34:38,2013-04-22 02:31:10
af9c20c07dee8635a04f7ee0532d9d41553811bc...2d66ccd593c1ee240dddef333ad304a68842c065,1,2,2,4,2,2013-04-22 11:38:26,2013-04-21 23:58:45
2d66ccd593c1ee240dddef333ad304a68842c065...8c75b5f55aa80e03c455e1efcdba216f1e51bd05,1,1,1,2,2,2013-04-22 11:52:08,2013-04-21 23:37:53
8c75b5f55aa80e03c455e1efcdba216f1e51bd05...de296f1b52cdf4a50b2095cc4657adb49f75f333,1,2,0,2,1,2013-04-22 12:38:18,2013-04-22 12:38:18
de296f1b52cdf4a50b2095cc4657adb49f75f333...021bdf3922b6525bd117e59fb4945b30a5a55341,3,20,26,46,10,2013-04-23 06:13:26,2013-04-16 16:53:35
021bdf3922b6525bd117e59fb4945b30a5a55341...cd38cbf975b501d846e6149d1d993972a1af0053,7,181,34,215,24,2013-04-23 06:28:41,2012-06-06 22:54:40
cd38cbf975b501d846e6149d1d993972a1af0053...2d5297e665c17ba09381667ff41bcead4babd772,1,56,1,57,1,2013-04-23 13:00:14,2013-04-23 12:00:05
2d5297e665c17ba09381667ff41bcead4babd772...b1157aafd7e06f3acea9fccc4fe1183c3610bdea,1,16,13,29,14,2013-04-24 18:52:25,2013-04-24 03:49:12
b1157aafd7e06f3acea9fccc4fe1183c3610bdea...6605adf6d96cee2ef53dfad24e99d325df732cab,2,173,0,173,4,2013-04-24 19:56:18,2013-04-17 06:15:27
6605adf6d96cee2ef53dfad24e99d325df732cab...5a8ae94f9c4a204253f01464a60577ba7daab866,1,1,1,2,1,2013-04-24 20:55:58,2013-04-24 20:22:19
5a8ae94f9c4a204253f01464a60577ba7daab866...0fbf584643bc52a11b50f6b1b563cc1b55a268c1,1,9,0,9,1,2013-04-25 18:08:41,2013-04-23 10:12:16
0fbf584643bc52a11b50f6b1b563cc1b55a268c1...77ff1085554675f1a8375642996e5b1e51f9ed2d,1,3,2,5,3,2013-04-25 18:08:41,2013-04-23 10:18:50
77ff1085554675f1a8375642996e5b1e51f9ed2d...32719c7976426a0d7d998ab9c6cfcee814f27e07,1,1,1,2,1,2013-04-26 12:16:19,2013-04-26 11:20:12
32719c7976426a0d7d998ab9c6cfcee814f27e07...8a59d8668c5328b47847931580caf302bfa086e8,1,4,0,4,1,2013-04-28 17:37:24,2013-04-26 20:09:01
8a59d8668c5328b47847931580caf302bfa086e8...61c0adedc3fb936e268588d8cfc77df0962453c7,1,1,1,2,1,2013-04-28 17:44:07,2013-04-26 14:54:19
61c0adedc3fb936e268588d8cfc77df0962453c7...cb62a57d438f94dff32218ba095a6a63b1db958f,1,3,3,6,1,2013-04-29 09:19:07,2013-04-28 18:05:44
cb62a57d438f94dff32218ba095a6a63b1db958f...0985a37376314616ac2b777bddd8bc07e1be7af7,2,4,4,8,2,2013-04-29 15:56:35,2013-04-23 04:00:15
0985a37376314616ac2b777bddd8bc07e1be7af7...06f2b2a8cf7e8216ad9ef05f73426271c2d97faa,2,71,26,97,11,2013-04-29 17:26:32,2013-04-29 17:14:40
06f2b2a8cf7e8216ad9ef05f73426271c2d97faa...da8c320bdedff51db87c632e16c7d0b56fd6cd8b,1,106,0,106,1,2013-04-29 18:12:19,2013-04-29 18:07:05
da8c320bdedff51db87c632e16c7d0b56fd6cd8b...7812ae75d578314c1a285e9644fc75812940eb1d,1,10,10,20,7,2013-04-29 18:16:21,2013-04-25 15:54:28
7812ae75d578314c1a285e9644fc75812940eb1d...400f9360bb2f7553c5bd3b1f256a5f3db175b7bc,3,7,7,14,5,2013-04-29 18:28:54,2013-04-29 18:27:45
400f9360bb2f7553c5bd3b1f256a5f3db175b7bc...b3a62b2e19b1743df52034d4d7a0405e6a65f925,6,19,1311,1330,7,2013-04-29 21:43:14,2013-04-29 19:20:10
b3a62b2e19b1743df52034d4d7a0405e6a65f925...ef7ba7b212b0ce49fed28ffb305948c323985b1f,1,3,5,8,3,2013-04-30 09:16:24,2013-04-29 17:44:08
ef7ba7b212b0ce49fed28ffb305948c323985b1f...d6984db4d5da236cc48c832a1d6a00706c7267e9,1,2,0,2,1,2013-04-30 09:39:33,2013-04-29 22:02:58
d6984db4d5da236cc48c832a1d6a00706c7267e9...fc25a443f8595ec8761675595af58ec873452896,1,7,0,7,2,2013-04-30 09:47:14,2013-04-29 23:01:58
fc25a443f8595ec8761675595af58ec873452896...cda7b71146f6748116ad5bbc9050ee7e79a9ce2b,2,66,11,77,15,2013-04-30 19:42:34,2013-04-24 17:33:08
cda7b71146f6748116ad5bbc9050ee7e79a9ce2b...de2cdb0658b8b8cff5a59e26c5ec1c9b470efb9b,2,21,7,28,4,2013-04-30 21:38:14,2013-04-30 18:47:23
de2cdb0658b8b8cff5a59e26c5ec1c9b470efb9b...e295eeefaa26b203cefb8b1148417e4c4f85e037,1,12,0,12,1,2013-04-30 21:38:14,2013-04-30 18:48:59
e295eeefaa26b203cefb8b1148417e4c4f85e037...52a55ec61895951999cb0d74e706725b965e9c9f,2,47,6,53,11,2013-04-30 23:56:24,2013-04-12 18:03:36
52a55ec61895951999cb0d74e706725b965e9c9f...89c0b5d096686aa0478dc5ca543acbf64223b688,1,1,1,2,1,2013-05-01 12:14:54,2013-04-30 20:39:41
89c0b5d096686aa0478dc5ca543acbf64223b688...660605bdb834bbbb31529b86f5b870c5861ff497,3,115,118,233,35,2013-05-01 12:57:44,2013-04-23 11:34:53
660605bdb834bbbb31529b86f5b870c5861ff497...dc9a580617a838b63cbf5feae362b6f9cf5ed986,2,7,1,8,3,2013-05-01 13:42:10,2013-03-22 09:35:50
dc9a580617a838b63cbf5feae362b6f9cf5ed986...6452707d4098235bdbde34e790aee05a1b091218,2,18,1,19,2,2013-05-02 14:12:37,2013-05-02 11:05:22
6452707d4098235bdbde34e790aee05a1b091218...1d8e11ddfbd6b08ff02df4331f6df125f49da3dc,2,21,1,22,2,2013-05-02 14:12:37,2013-04-30 23:19:44
1d8e11ddfbd6b08ff02df4331f6df125f49da3dc...9956baedd73d5e8d0edd04c9eed368bd3988444b,3,56,10,66,7,2013-05-02 19:22:16,2013-05-02 00:01:27
9956baedd73d5e8d0edd04c9eed368bd3988444b...80341cb9badd952fdc80094df4123629313b4cc4,3,16,8,24,3,2013-05-02 19:22:16,2013-05-02 00:55:25
80341cb9badd952fdc80094df4123629313b4cc4...fd21c7502f0a25364a810c26ebeecb678e5783c5,2,71,56,127,10,2013-05-02 19:22:16,2013-05-02 14:47:30
fd21c7502f0a25364a810c26ebeecb678e5783c5...4bd7bedf48c0c1ebb62f6bd8c85e8ea00f94502b,2,20,5,25,3,2013-05-02 19:22:17,2013-05-02 18:12:48
4bd7bedf48c0c1ebb62f6bd8c85e8ea00f94502b...a348e90aa141921b914f87ec930cd6ebf481a446,2,67,5,72,5,2013-05-02 22:22:03,2013-05-02 22:22:03
a348e90aa141921b914f87ec930cd6ebf481a446...af0eaa304748f330739a4b0aadb13201126c5407,2,27,0,27,3,2013-05-03 18:55:47,2013-05-02 19:12:00
af0eaa304748f330739a4b0aadb13201126c5407...c575a56fc5c6abcb8442398b53ddd7ea2433b785,1,12,0,12,1,2013-05-07 04:52:53,2013-05-06 21:52:58
c575a56fc5c6abcb8442398b53ddd7ea2433b785...2c69a6735e8af5d1b9b73fd221274d374e8efdea,3,9,2,11,4,2013-05-07 04:52:53,2013-05-06 21:53:45
2c69a6735e8af5d1b9b73fd221274d374e8efdea...52c1498e25992f93ada72ea0621755ff2242b97f,1,1,1,2,1,2013-05-07 08:48:40,2013-05-07 00:57:00
52c1498e25992f93ada72ea0621755ff2242b97f...f046f6f73c910998a94f30a4cb4ed087b6325485,1,1,0,1,1,2013-05-07 10:43:25,2013-05-07 10:43:25
f046f6f73c910998a94f30a4cb4ed087b6325485...4622af3f075204e2d5ab33d5bd002074f2d940c9,2,38,8,46,5,2013-05-07 20:27:42,2013-03-19 10:22:06
4622af3f075204e2d5ab33d5bd002074f2d940c9...4f2e36068502f18814fee0abd26951124881f951,2,25,17,42,9,2013-05-07 21:59:46,2013-05-07 21:58:05
4f2e36068502f18814fee0abd26951124881f951...cf4729faa3e6e0a5178e2064a6f3cfd345686554,2,13,1,14,2,2013-05-08 09:04:07,2013-04-20 20:33:40
cf4729faa3e6e0a5178e2064a6f3cfd345686554...6d0b325f7f5b9c1f3cfac9b73c6cd5fc3d1e2af0,2,77,0,77,6,2013-05-08 11:45:32,2013-04-17 00:09:43
6d0b325f7f5b9c1f3cfac9b73c6cd5fc3d1e2af0...202087f03da20741b8e4b248e53994a6ff1cce3e,1,6,6,12,5,2013-05-08 14:57:33,2012-12-03 19:03:24
202087f03da20741b8e4b248e53994a6ff1cce3e...86b33eb3f1360a4cefb5ebf522b6649f9c55db55,2,15,10,25,12,2013-05-08 14:57:34,2012-12-04 17:24:15
86b33eb3f1360a4cefb5ebf522b6649f9c55db55...35adade6ac0b4e485b75fe49e0af6338ff816213,1,11,5,16,3,2013-05-08 14:57:34,2012-12-04 23:02:29
35adade6ac0b4e485b75fe49e0af6338ff816213...5137a15417314a9c379909d7325feafb40243c34,1,1,1,2,1,2013-05-08 14:57:34,2013-01-10 20:33:57
5137a15417314a9c379909d7325feafb40243c34...ee2689051bb40794eeb81baf80dc0717fd9edd2a,1,4,4,8,3,2013-05-08 22:08:49,2013-05-08 22:08:49
ee2689051bb40794eeb81baf80dc0717fd9edd2a...404c9a653a1e28de1c6dda996875d6616812313a,2,101,23,124,7,2013-05-08 22:25:56,2013-05-07 15:02:17
404c9a653a1e28de1c6dda996875d6616812313a...0cb04e2e9171ca60d4779cb9e0b4fe73f0926ace,2,33,6,39,2,2013-05-08 22:34:35,2013-05-07 19:19:06
0cb04e2e9171ca60d4779cb9e0b4fe73f0926ace...88c3480aff79e1ff5b1ed8bd7f1e05df8ea1e068,11,101,40,141,42,2013-05-08 22:40:37,2013-05-07 14:29:29
88c3480aff79e1ff5b1ed8bd7f1e05df8ea1e068...14757874a7cea7961f31211b245c417bd4b20512,2,265,43,308,21,2013-05-08 22:56:53,2013-05-07 14:33:08
14757874a7cea7961f31211b245c417bd4b20512...11f712bc3e310302eb2e8691cf6d110bdcde1810,14,127,128,255,102,2013-05-08 23:03:31,2013-05-07 21:11:39
11f712bc3e310302eb2e8691cf6d110bdcde1810...29efd39745ac14c89ef8bc79993b51450fd0a8b9,2,2,1,3,2,2013-05-08 23:40:35,2013-05-08 23:40:00
29efd39745ac14c89ef8bc79993b51450fd0a8b9...02ad012e7fee59f989f688a7171a2158371dcf11,1,15,2,17,2,2013-05-09 11:47:41,2013-05-09 11:42:19
02ad012e7fee59f989f688a7171a2158371dcf11...40c36ee7feeb29c2024c37b7f88c7ad639bdda2f,1,3,0,3,1,2013-05-09 12:56:36,2013-05-09 12:56:36
40c36ee7feeb29c2024c37b7f88c7ad639bdda2f...4ae4f1edd230affcf4a6675fd748f86665ce2f8b,6,13,14,27,13,2013-05-09 14:01:22,2013-05-07 04:56:51
4ae4f1edd230affcf4a6675fd748f86665ce2f8b...04d4c738b505574525ec30061017c1adac1ff85e,1,21,24,45,2,2013-05-09 21:04:13,2013-05-06 07:41:43
04d4c738b505574525ec30061017c1adac1ff85e...f6caab598f91eaeb0f06395620e38816154faa70,1,1,1,2,1,2013-05-10 13:58:00,2013-05-04 09:43:11
f6caab598f91eaeb0f06395620e38816154faa70...67a4a25b890fada0043c1ff98e5437d793f44d0c,2,16,1,17,2,2013-05-10 19:03:24,2013-05-07 12:14:57
67a4a25b890fada0043c1ff98e5437d793f44d0c...ac8ba104d4f8a20d107d184d81be83b2eaefec91,1,1,1,2,1,2013-05-10 19:52:18,2013-05-10 11:41:58
ac8ba104d4f8a20d107d184d81be83b2eaefec91...bffe6fa8a60d2b42685c56442a02e0881f00d810,1,1,1,2,1,2013-05-10 20:24:08,2013-05-10 20:02:09
bffe6fa8a60d2b42685c56442a02e0881f00d810...3952d35abe334a0e6afd1f6e34a74d984d1e9d24,2,14,1,15,2,2013-05-11 16:28:14,2013-05-11 02:17:56
3952d35abe334a0e6afd1f6e34a74d984d1e9d24...3e4d43b42c37b589eb75c740998b671de8a5f263,3,11,12,23,9,2013-05-13 13:09:03,2013-05-13 13:06:50
3e4d43b42c37b589eb75c740998b671de8a5f263...0930d9dfe7fe63dcf21a9773823372ba8c222ad6,1,6,6,12,6,2013-05-13 22:12:25,2013-05-13 22:12:25
0930d9dfe7fe63dcf21a9773823372ba8c222ad6...b6e5972eb371412d99fc50def000f3afab5bec79,6,800,390,1190,15,2013-05-13 23:55:14,2013-05-09 20:22:12
b6e5972eb371412d99fc50def000f3afab5bec79...c8197b44eb0b4d49acda142f4179876732e1c751,3,64,3,67,5,2013-05-13 23:55:14,2013-05-09 19:58:34
c8197b44eb0b4d49acda142f4179876732e1c751...4acc28a310d006c62afe0de8ec82fed21c98c2d6,2,121,8,129,12,2013-05-14 04:09:43,2013-05-13 19:08:59
4acc28a310d006c62afe0de8ec82fed21c98c2d6...c32a859bdb93699cc080f9affed4bcff63005a64,2,80,13,93,13,2013-05-14 18:58:05,2013-05-14 18:56:11
c32a859bdb93699cc080f9affed4bcff63005a64...53061363c7aa1ab9085273d269c6f04ac2162336,2,169,13,182,5,2013-05-14 19:01:15,2013-05-13 13:16:03
53061363c7aa1ab9085273d269c6f04ac2162336...908821e20af311be905e24639dce273f2ea58434,1,5,5,10,5,2013-05-14 19:47:39,2013-05-14 18:35:03
908821e20af311be905e24639dce273f2ea58434...629fb37351ce5778a40a8bc8cd7c1385b382ce75,3,59,1,60,4,2013-05-14 19:50:36,2013-05-06 08:20:15
629fb37351ce5778a40a8bc8cd7c1385b382ce75...d551d72924f7c43a043e4760ff05d7389e310f99,3,60,3,63,5,2013-05-14 20:29:21,2013-05-07 16:45:28
d551d72924f7c43a043e4760ff05d7389e310f99...99cd86a96ee2e076f96f5f5d26646b8f7b782a5e,1,2,6,8,2,2013-05-15 20:32:15,2013-05-15 18:10:49
99cd86a96ee2e076f96f5f5d26646b8f7b782a5e...a380fc46247a5b61a71199a01670c751396881f5,1,24,8,32,2,2013-05-16 20:22:07,2013-05-16 06:17:30
a380fc46247a5b61a71199a01670c751396881f5...1f99c3a521e84902e3021166d8024c8f419e53d2,2,6,1,7,2,2013-05-16 21:02:16,2013-05-16 15:11:37
1f99c3a521e84902e3021166d8024c8f419e53d2...f9b897de4b5cc438515cbb54519fbdf6242f5858,2,17,6,23,5,2013-05-16 21:05:05,2013-05-11 16:23:33
f9b897de4b5cc438515cbb54519fbdf6242f5858...cefbcd470d4c9020cc3487b2326d45058ef831e2,2,11,1,12,2,2013-05-16 21:26:08,2013-04-03 15:40:16
cefbcd470d4c9020cc3487b2326d45058ef831e2...6798fec4390a72b7943a49505f8a245b6016c84b,2,83,3,86,7,2013-05-16 21:30:37,2013-04-23 00:42:34
6798fec4390a72b7943a49505f8a245b6016c84b...0401a7f598ef9a36ffe1f217e1a98961046fa551,2,19,3,22,5,2013-05-16 23:15:31,2013-04-15 22:52:56
0401a7f598ef9a36ffe1f217e1a98961046fa551...3a49b7eec4836ec9dc1588e6cedda942755dc7bf,5,2428,3,2431,8,2013-05-16 23:17:46,2013-05-10 01:53:07
3a49b7eec4836ec9dc1588e6cedda942755dc7bf...24ed61cf5c56f236a31069e60fbfdd3b578fbef3,1,44,12,56,14,2013-05-16 23:17:46,2013-05-16 03:10:05
24ed61cf5c56f236a31069e60fbfdd3b578fbef3...c53d4c94300c97dd005f9a0cbdbfa387294b9026,2,84,0,84,3,2013-05-16 23:17:46,2013-05-13 21:37:52
c53d4c94300c97dd005f9a0cbdbfa387294b9026...8f69ffce473f3294623d01a2c0d00ab135821396,1,1,0,1,1,2013-05-16 23:39:13,2013-05-16 23:39:13
8f69ffce473f3294623d01a2c0d00ab135821396...2a7043fa2327ecb681f306612a96dbf29ec499e7,1,29,11,40,4,2013-05-17 05:46:09,2013-05-12 20:12:37
2a7043fa2327ecb681f306612a96dbf29ec499e7...a7ba27b92c4363a88a4f8706a72d6c3e4ff8ce01,1,19,15,34,1,2013-05-17 18:16:55,2013-05-17 14:55:22
a7ba27b92c4363a88a4f8706a72d6c3e4ff8ce01...1c7741329f0439a93c55933636db0b0b524e0e94,1,1,1,2,1,2013-05-18 19:29:17,2013-05-17 19:53:38
1c7741329f0439a93c55933636db0b0b524e0e94...2ab4fde8172ab4a98bbaa69baf55358dedb050b9,1,39,1,40,2,2013-05-18 20:00:45,2013-05-17 21:08:08
2ab4fde8172ab4a98bbaa69baf55358dedb050b9...782a82d461bd10a8afe11aa7c37f166628b99839,1,1,1,2,1,2013-05-18 20:17:51,2013-05-18 13:47:55
782a82d461bd10a8afe11aa7c37f166628b99839...3b69eaebcd73f6da3170aa0c1c9fc4fe73bf358b,1,28,4,32,4,2013-05-18 21:13:58,2013-05-18 15:23:06
3b69eaebcd73f6da3170aa0c1c9fc4fe73bf358b...be993528a38ecf6ca3096198317b8df8b360bb82,2,2,2,4,2,2013-05-18 21:17:15,2013-05-18 21:17:15
be993528a38ecf6ca3096198317b8df8b360bb82...5c203240d484c9803e19ce537adcb70fd9010a30,1,1,1,2,1,2013-05-20 09:19:18,2013-05-19 23:23:37
5c203240d484c9803e19ce537adcb70fd9010a30...518a92651faeee4f026bd3189f146e5ea9dd6921,1,1,1,2,1,2013-05-20 09:24:12,2013-05-19 17:50:49
518a92651faeee4f026bd3189f146e5ea9dd6921...27a8824b50aa78e9a082b4377ca09250382a8655,1,1,1,2,1,2013-05-20 14:36:10,2013-05-20 12:38:32
27a8824b50aa78e9a082b4377ca09250382a8655...9f4f5937112655a9881d3281da8e72035bc8b180,7,127,23,150,16,2013-05-20 21:15:04,2013-04-27 15:22:03
9f4f5937112655a9881d3281da8e72035bc8b180...2f571a9c830df814902fbdda1e9240b36bb64e3e,11,13,12,25,8,2013-05-20 21:27:34,2013-05-16 18:55:56
2f571a9c830df814902fbdda1e9240b36bb64e3e...5f92d4144ea3c8c8fc33e163b3973401b527a4bd,2,58,4,62,4,2013-05-20 21:33:11,2013-05-16 20:05:21
5f92d4144ea3c8c8fc33e163b3973401b527a4bd...5a34464198f1ca108ddd085181a832d3aa181c31,5,33,13,46,14,2013-05-20 21:39:02,2013-05-20 21:02:03
5a34464198f1ca108ddd085181a832d3aa181c31...eb21eb5a06814e061983570e7e5b67322dc9e9ed,1,1,1,2,1,2013-05-21 10:39:36,2013-05-18 15:41:27
eb21eb5a06814e061983570e7e5b67322dc9e9ed...d458d7350b8a26752e649bd2b8d061137d0247de,5,13,17,30,11,2013-05-21 10:39:36,2013-05-20 23:37:28
d458d7350b8a26752e649bd2b8d061137d0247de...0f7949c62ad346bc00906ea4f7dd811669448413,1,0,67,67,1,2013-05-21 10:42:57,2013-05-21 10:42:57
0f7949c62ad346bc00906ea4f7dd811669448413...907d2f521e859491180518620538122ed138dfbf,1,0,3,3,1,2013-05-21 12:12:41,2013-05-20 16:36:17
907d2f521e859491180518620538122ed138dfbf...7f597a75090167cd1fad9df9fe67165d0da9fa11,1,2,2,4,1,2013-05-21 12:17:51,2013-05-20 16:31:39
7f597a75090167cd1fad9df9fe67165d0da9fa11...cdf75b302f573bb0e8b85d679ba66dd914276aa5,1,85,1,86,1,2013-05-21 12:36:17,2013-05-20 18:30:17
cdf75b302f573bb0e8b85d679ba66dd914276aa5...5bc2836a0db7960621023ab3c9704222cc288317,3,133,117,250,10,2013-05-21 13:02:19,2013-05-20 21:16:23
5bc2836a0db7960621023ab3c9704222cc288317...59eb50204a046599e02a7af0bc31d83a95b81f15,1,1,0,1,1,2013-05-21 20:33:32,2013-05-21 17:33:13
59eb50204a046599e02a7af0bc31d83a95b81f15...5cc9837d931dfb2d374bef24688888e0c52c75d1,1,208,0,208,1,2013-05-22 08:02:59,2013-05-22 07:45:28
5cc9837d931dfb2d374bef24688888e0c52c75d1...9a7035e8154fa7d39a42eb14eaa05a36439f34ac,1,1,1,2,1,2013-05-22 08:05:11,2013-05-22 08:05:11
9a7035e8154fa7d39a42eb14eaa05a36439f34ac...eef8f3438dfa2c279e92f30d0cd70e73ee9b6742,1,2,2,4,2,2013-05-22 08:12:01,2013-05-22 08:12:01
eef8f3438dfa2c279e92f30d0cd70e73ee9b6742...9d19b512e0aefa15dc832f08512b6ed38d23750f,1,3,2,5,1,2013-05-22 20:09:20,2013-05-22 20:07:17
9d19b512e0aefa15dc832f08512b6ed38d23750f...18f14117dec12271229e16fe6fba8d032fe934e8,1,13,13,26,12,2013-05-22 21:51:16,2013-05-21 21:52:38
18f14117dec12271229e16fe6fba8d032fe934e8...8b7b62c974e8c4264b8858c42b0ca612ec46c761,1,12,2,14,3,2013-05-23 03:31:53,2013-05-23 03:26:41
8b7b62c974e8c4264b8858c42b0ca612ec46c761...0272240400d7896224f34b9f10b492994e29c655,1,35,37,72,5,2013-05-23 04:46:17,2013-05-23 04:39:40
0272240400d7896224f34b9f10b492994e29c655...041f118b01933fa07098f1333be8e2cf1a28f248,1,2,0,2,1,2013-05-23 18:44:55,2013-05-23 04:27:41
041f118b01933fa07098f1333be8e2cf1a28f248...da5f537ccdb0a7b4155f13f7a70ca7981ad6f689,3,71,23,94,8,2013-05-23 19:05:55,2013-04-30 09:29:07
da5f537ccdb0a7b4155f13f7a70ca7981ad6f689...05772e15fbecfdc63d4977e2e8839d8b95d6a92d,2,227,101,328,58,2013-05-23 21:18:29,2013-04-16 22:08:04
05772e15fbecfdc63d4977e2e8839d8b95d6a92d...f4c6b2c7894cb2d82ac69a1500a27785360b81c3,5,437,79,516,15,2013-05-23 23:07:44,2013-04-23 17:53:27
f4c6b2c7894cb2d82ac69a1500a27785360b81c3...4179f62cc270b9614075095e1e4931736cff30a7,1,7,19,26,6,2013-05-24 04:55:44,2013-05-22 18:47:17
4179f62cc270b9614075095e1e4931736cff30a7...88eaea8e7bf025a7805a5d20f5d47472e4f26f6f,1,35,0,35,1,2013-05-24 23:57:15,2013-05-24 22:55:11
88eaea8e7bf025a7805a5d20f5d47472e4f26f6f...b8ea7f6aba2e675b85826b0bee1f21ddd7b866a5,35,315,160,475,126,2013-05-25 00:03:21,2013-05-24 18:00:14
b8ea7f6aba2e675b85826b0bee1f21ddd7b866a5...e46100f7097d9a8f174bdb9e15d4c6098395c3f2,6,276,51,327,34,2013-05-29 05:28:32,2013-05-24 19:41:38
e46100f7097d9a8f174bdb9e15d4c6098395c3f2...21c70729d9269de85df3434c431c2f18995b0f7b,3,15,4,19,3,2013-05-31 04:42:41,2013-05-21 01:00:12
21c70729d9269de85df3434c431c2f18995b0f7b...a2f9e78a56944b3c5024133770a4b436b4b06149,1,2,1,3,1,2013-05-31 04:58:36,2013-05-23 06:02:52
a2f9e78a56944b3c5024133770a4b436b4b06149...a4b9a6aca9a0d4b1e3be2238cf549083776284ba,2,46,18,64,6,2013-05-31 05:01:42,2013-05-27 00:28:47
a4b9a6aca9a0d4b1e3be2238cf549083776284ba...e1a050e6b26aca4d0e6e7125d3f6c1c8fc1d92cb,3,47,1,48,6,2013-05-31 06:43:27,2013-05-29 20:44:59
e1a050e6b26aca4d0e6e7125d3f6c1c8fc1d92cb...c38073667d81bdd3b6cdb24a11ff9bcd261d0441,1,1,0,1,1,2013-05-31 06:43:27,2013-05-25 01:43:09
c38073667d81bdd3b6cdb24a11ff9bcd261d0441...b6a0777b2406d639f3cb1e9aa38f65f1f6008995,1,23,26,49,17,2013-05-31 13:35:44,2013-05-23 02:37:42
b6a0777b2406d639f3cb1e9aa38f65f1f6008995...c6fa3b06b189a6b0c6e77a3482fdf4f6adff1a3d,1,14,14,28,8,2013-06-04 18:59:42,2013-05-23 17:33:10
c6fa3b06b189a6b0c6e77a3482fdf4f6adff1a3d...a95bfbeac084a1aad9e296d24e0c78c353368235,1,11,7,18,3,2013-06-04 19:06:33,2013-05-21 21:40:48
a95bfbeac084a1aad9e296d24e0c78c353368235...303c7f916628ced3e09355f8f8504c16eadc10e1,1,5,1,6,2,2013-06-04 19:16:07,2013-06-04 19:12:31
303c7f916628ced3e09355f8f8504c16eadc10e1...6a33aa63cd3f0497baa5587b0335a793ffd02864,1,1,1,2,1,2013-06-04 19:23:51,2013-05-23 07:26:51
6a33aa63cd3f0497baa5587b0335a793ffd02864...ffcfe7a86eb9763ee91a3d80b28e8178ba40feb2,1,3,3,6,3,2013-06-04 19:30:43,2013-05-23 11:11:03
ffcfe7a86eb9763ee91a3d80b28e8178ba40feb2...40acd186bc43feeeb8b93e02761565b74e00013e,1,11,12,23,6,2013-06-04 19:38:02,2013-05-23 20:48:00
40acd186bc43feeeb8b93e02761565b74e00013e...d3d7b9e3eda9a4fbed7bf6edc7723f378d6f0cf0,1,1,1,2,1,2013-06-04 19:50:09,2013-05-24 22:36:38
d3d7b9e3eda9a4fbed7bf6edc7723f378d6f0cf0...4fd057e7c74548d418fad801f29fcaa611d7e0a0,1,1,1,2,1,2013-06-04 19:53:39,2013-05-24 22:54:41
4fd057e7c74548d418fad801f29fcaa611d7e0a0...8eb8c4a32fa6f61a84ee476ac0755d9263f84050,1,3,1,4,1,2013-06-04 20:01:26,2013-05-28 00:34:12
8eb8c4a32fa6f61a84ee476ac0755d9263f84050...ef5c874415109a85263ab0f89ba0f56dede8d41c,1,3,3,6,1,2013-06-04 20:08:29,2013-05-22 14:36:08
ef5c874415109a85263ab0f89ba0f56dede8d41c...76cb53f8376a210b13c47dba88f99bbf9170233e,1,19,0,19,1,2013-06-04 20:48:39,2013-05-29 13:44:36
76cb53f8376a210b13c47dba88f99bbf9170233e...0921bd0816f1a146703ba3573e0c1ed2d76823e3,1,1,1,2,1,2013-06-04 20:53:43,2013-05-30 01:27:54
0921bd0816f1a146703ba3573e0c1ed2d76823e3...dc238ce123d6f4357878d0e6e58c8e2343337e26,1,5,1,6,2,2013-06-04 21:01:11,2013-05-31 05:42:57
dc238ce123d6f4357878d0e6e58c8e2343337e26...c785b2edff50e9d9b1874d03d2399509d1aa062e,1,5,4,9,1,2013-06-04 21:10:04,2013-06-04 21:10:04
c785b2edff50e9d9b1874d03d2399509d1aa062e...e1810c5cd3520338f7cf77cbb913be675d636cab,1,1,2,3,1,2013-06-04 21:13:58,2013-06-01 11:51:50
e1810c5cd3520338f7cf77cbb913be675d636cab...8400852f4e9ed54bda55bafff7c1ff193c86190e,1,1,0,1,1,2013-06-04 21:25:10,2013-06-04 21:24:49
8400852f4e9ed54bda55bafff7c1ff193c86190e...7a5cfb593f27c28cee545974736632bf8da62fe8,1,1,1,2,1,2013-06-04 21:28:43,2013-06-03 17:05:17
7a5cfb593f27c28cee545974736632bf8da62fe8...5599b55b04788c2e327d7551a4a699d75516dd21,25,157,123,280,92,2013-06-07 00:07:12,2013-06-05 22:30:31
5599b55b04788c2e327d7551a4a699d75516dd21...63c1e5beff858abae464b5dead80d51d5f2c0ca2,1,2,1,3,1,2013-06-07 00:08:50,2013-06-06 21:07:32
63c1e5beff858abae464b5dead80d51d5f2c0ca2...65f5e856a161e7c91b9ebde1360242dc704d0510,1,3,3,6,3,2013-06-07 00:08:50,2013-06-06 21:12:28
65f5e856a161e7c91b9ebde1360242dc704d0510...9faabd1ba0b1929785bcf166dc0ff60008e7c442,3,1,42,43,3,2013-06-07 05:06:50,2013-06-05 22:12:00
9faabd1ba0b1929785bcf166dc0ff60008e7c442...b36504577c538b745e6270e77d86af90285e2ae6,1,45,0,45,1,2013-06-07 05:09:05,2013-06-05 23:05:38
b36504577c538b745e6270e77d86af90285e2ae6...4949586a76e0dd2baf47f519219011bd36dc52fa,1,1,1,2,1,2013-06-07 05:13:43,2013-06-04 22:24:01
4949586a76e0dd2baf47f519219011bd36dc52fa...079bf5f27566b446c11678c0cd03bb8dacfe83fc,6,2,482,484,5,2013-06-07 05:14:55,2013-06-04 20:44:40
079bf5f27566b446c11678c0cd03bb8dacfe83fc...f56125d94efba462869f09064dfa39aa780b8016,30,122,18112,18234,40,2013-06-07 05:58:55,2013-06-04 23:05:50
f56125d94efba462869f09064dfa39aa780b8016...77c4fc6847156080903a6801b04b139e77377478,3,37,2,39,4,2013-06-07 05:58:56,2013-06-05 18:31:32
77c4fc6847156080903a6801b04b139e77377478...0317fd1651536cd0d7a0a5850c31db1ddaa87c0e,3,4,0,4,3,2013-06-07 05:58:56,2013-06-05 18:41:50
0317fd1651536cd0d7a0a5850c31db1ddaa87c0e...73534b354655db40a42931134c86f019e2f00990,3,3,3,6,3,2013-06-07 06:10:09,2013-06-07 05:35:43
73534b354655db40a42931134c86f019e2f00990...a4300efef99751c7f7c0ee27b7e74dae19a713cd,1,1,1,2,1,2013-06-07 06:10:28,2013-06-07 06:10:28
a4300efef99751c7f7c0ee27b7e74dae19a713cd...8011b97bfa46aa55f0d6d6161fabde8bef512220,1,1,1,2,1,2013-06-07 19:24:26,2013-06-07 19:24:26
8011b97bfa46aa55f0d6d6161fabde8bef512220...4eaaf9f83c44641b1cbc5976f1968dc9ee4c642b,1,3,5,8,2,2013-06-08 06:03:13,2013-06-08 05:57:31
4eaaf9f83c44641b1cbc5976f1968dc9ee4c642b...b700aa9291409a94dbc01c6c945ab18391dd9afb,1,7,5,12,5,2013-06-10 18:39:01,2013-06-10 18:39:01
b700aa9291409a94dbc01c6c945ab18391dd9afb...6c663154943e4c0c33c19026a7b500302bda29d4,1,12,3,15,4,2013-06-10 20:14:26,2013-06-10 19:54:41
6c663154943e4c0c33c19026a7b500302bda29d4...ba3ca0be415c85679f5582e36a8f6dbd2e457cc9,1,1,2,3,1,2013-06-10 22:16:57,2013-06-10 22:16:05
ba3ca0be415c85679f5582e36a8f6dbd2e457cc9...6b12432729848d3b34689f62a6bcd1766fd29720,1,1,0,1,1,2013-06-11 01:55:26,2013-06-10 22:23:56
6b12432729848d3b34689f62a6bcd1766fd29720...b28f96949ac477b1fe43c81df7cedc21c7ab184c,2,17,2,19,2,2013-06-11 20:14:34,2013-06-11 20:08:21
b28f96949ac477b1fe43c81df7cedc21c7ab184c...4953b49761a791d9ea74bcbe78769fec15d91083,2,38,17,55,14,2013-06-11 20:14:34,2013-06-11 20:14:17
4953b49761a791d9ea74bcbe78769fec15d91083...b6ff8d751f6d76d8a03d01562279d47886c98c66,1,2,1,3,1,2013-06-11 20:29:58,2013-06-11 18:51:07
b6ff8d751f6d76d8a03d01562279d47886c98c66...c9c3f718e2564a6cc13f958a777ebb4ba9ce5de5,2,9,3,12,4,2013-06-11 21:15:54,2013-06-11 21:15:54
c9c3f718e2564a6cc13f958a777ebb4ba9ce5de5...86f3e41dfe78e20d48cd78ddbac0da343ce164b4,1,28,24,52,18,2013-06-12 19:02:45,2013-06-11 19:57:01
86f3e41dfe78e20d48cd78ddbac0da343ce164b4...a4c3b068079fc7a8518260850b210a5b27a93f7f,1,13,11,24,8,2013-06-12 19:40:07,2013-06-12 19:40:07
a4c3b068079fc7a8518260850b210a5b27a93f7f...6ca5272f94f095b864682f438e4cd916aae073ad,1,2,2,4,1,2013-06-12 19:47:32,2013-06-09 06:36:09
6ca5272f94f095b864682f438e4cd916aae073ad...0cb87f91ae8660016f9a79a62166ae03d0e7070d,1,14,5,19,2,2013-06-12 20:17:42,2013-06-12 20:17:29
0cb87f91ae8660016f9a79a62166ae03d0e7070d...83f445336f80a41f20a83f5b933fccd529cdc9a7,1,42,1,43,5,2013-06-12 20:46:31,2013-06-11 02:14:20
83f445336f80a41f20a83f5b933fccd529cdc9a7...5ec188f697a96200f2c46457068fd40b954ccf51,1,1,1,2,1,2013-06-13 20:14:06,2013-06-12 08:38:41
5ec188f697a96200f2c46457068fd40b954ccf51...14285568caa4e1875b3fc6f8551de243e5c6ea3f,1,1,1,2,1,2013-06-13 20:17:52,2013-06-12 10:15:51
14285568caa4e1875b3fc6f8551de243e5c6ea3f...a2d4b5c5d88777597d396cf4845e0a73bf2396d4,1,2,2,4,2,2013-06-13 21:37:19,2013-06-13 01:32:15
a2d4b5c5d88777597d396cf4845e0a73bf2396d4...9e2fd89021bd299c3681d88af9f9917b96992ab4,1,6,6,12,4,2013-06-13 21:42:10,2013-06-13 08:18:29
9e2fd89021bd299c3681d88af9f9917b96992ab4...45ee8844f9678bad46e0f81eda18db888a42e264,1,2,2,4,1,2013-06-13 21:47:47,2013-06-13 08:52:33
45ee8844f9678bad46e0f81eda18db888a42e264...cd3dd134255eb40bae0b6c3fef622d3bc9c3f9b9,1,8,8,16,8,2013-06-13 21:50:57,2013-06-13 10:12:51
cd3dd134255eb40bae0b6c3fef622d3bc9c3f9b9...908071afbf32c46fe9110e4a67e104bbd4b3a56b,1,21,4,25,5,2013-06-15 04:51:25,2013-06-07 17:25:07
908071afbf32c46fe9110e4a67e104bbd4b3a56b...003861d2fdb37b83e1d0939d49b70fbc67766997,35,198,177,375,129,2013-06-17 20:29:30,2013-06-08 01:24:30
003861d2fdb37b83e1d0939d49b70fbc67766997...68227091911a2a6d55b255aa9a33bb142628fd2d,1,1,1,2,1,2013-06-18 04:23:22,2013-06-14 02:01:14
68227091911a2a6d55b255aa9a33bb142628fd2d...0cac8729fb3824ebb07cee84ef78b43900c7e75d,1,6,3,9,3,2013-06-18 04:23:22,2013-06-14 02:28:36
0cac8729fb3824ebb07cee84ef78b43900c7e75d...cec4ce28b93793caba75c7bab009d30bc97b6146,2,23,2,25,2,2013-06-18 04:23:22,2013-06-14 02:30:11
cec4ce28b93793caba75c7bab009d30bc97b6146...07ef1667db632d0fd75472f30343255edcebf43b,1,1,0,1,1,2013-06-18 04:23:22,2013-06-06 05:09:58
07ef1667db632d0fd75472f30343255edcebf43b...ef22968810d555f78d3bbf7b5428757690c8cc70,13,636,6,642,18,2013-06-18 05:00:54,2013-06-06 05:28:50
ef22968810d555f78d3bbf7b5428757690c8cc70...46dfb92afd185c93f60ca90a72653f33d7cb18e8,10,292,67,359,30,2013-06-18 05:17:44,2013-06-14 02:37:13
46dfb92afd185c93f60ca90a72653f33d7cb18e8...f6be59c1b9253ad8438ec65ab959e294686c65ab,4,199,87,286,14,2013-06-18 13:37:29,2013-06-18 13:37:29
f6be59c1b9253ad8438ec65ab959e294686c65ab...bf7ec4bbb10714fca3432ffa52569725f70da4c4,1,1,1,2,1,2013-06-18 13:40:13,2013-06-18 13:40:13
bf7ec4bbb10714fca3432ffa52569725f70da4c4...6295a0d9bd7f57b1c23d83bf6a74d1242c3e19b4,1,2,2,4,1,2013-06-18 20:21:20,2013-06-18 20:20:19
6295a0d9bd7f57b1c23d83bf6a74d1242c3e19b4...8b81cf202ba181ce76d21b4f073a9dc0c0bd9e3e,1,1,1,2,1,2013-06-18 20:56:53,2013-06-15 12:42:08
8b81cf202ba181ce76d21b4f073a9dc0c0bd9e3e...db8d8f9a4389c0de122d75ab42f0d75a1e558493,3,8,7,15,7,2013-06-18 21:05:28,2013-06-14 18:40:56
db8d8f9a4389c0de122d75ab42f0d75a1e558493...0bfa29377d7a77b360ecd3209d56eeb4f68a5043,1,1,1,2,1,2013-06-19 10:50:47,2013-06-17 17:12:58
0bfa29377d7a77b360ecd3209d56eeb4f68a5043...f1b94b4b599ab701bc75b55bbbbb73c5ef329a93,30,154,119,273,108,2013-06-19 19:53:24,2013-06-19 19:52:50
f1b94b4b599ab701bc75b55bbbbb73c5ef329a93...53359d549e364759d5b382c229f7d326799bf418,2,50,7,57,7,2013-06-19 20:30:59,2013-06-19 20:30:28
53359d549e364759d5b382c229f7d326799bf418...a7908134cb22c8c1efb21f780d4a6efdfde2b78c,1,1,1,2,1,2013-06-20 10:07:13,2013-06-19 14:56:34
a7908134cb22c8c1efb21f780d4a6efdfde2b78c...8264d08085adc2ab57f6598b9fc9f6e263c8b4f3,2,28,3,31,4,2013-06-20 13:13:16,2013-06-20 12:59:46
8264d08085adc2ab57f6598b9fc9f6e263c8b4f3...3621896e9d7dfdba14ae0e554037868d7cbca3c8,1,2,2,4,2,2013-06-20 13:39:16,2013-06-20 13:25:11
3621896e9d7dfdba14ae0e554037868d7cbca3c8...097947fd3bd280fcf621e36154a9d4f82896ff01,1,3,3,6,3,2013-06-20 14:22:35,2013-06-20 14:22:35
097947fd3bd280fcf621e36154a9d4f82896ff01...99e85fc9b5b71a1bf3e54126b9c080b3c355c336,1,2,1,3,2,2013-06-21 19:28:34,2013-06-19 22:14:45
99e85fc9b5b71a1bf3e54126b9c080b3c355c336...1adf29af13890d61286840177607edd552a9df97,2,162,9,171,5,2013-06-22 00:26:42,2013-06-21 19:33:03
1adf29af13890d61286840177607edd552a9df97...39841f2ec9b17b3b2920fd1eb548d444251f4f56,2,40,0,40,3,2013-06-22 00:37:44,2013-06-21 20:03:56
39841f2ec9b17b3b2920fd1eb548d444251f4f56...38deedd6e3d806eb8262bb43f26d47245f6c2739,4,82,6,88,13,2013-06-24 21:17:18,2013-06-22 02:00:45
38deedd6e3d806eb8262bb43f26d47245f6c2739...cefdaf131dd373cf06907e241a88339452c51313,2,27,27,54,2,2013-06-25 03:46:32,2013-06-25 03:45:31
cefdaf131dd373cf06907e241a88339452c51313...0960cd0613d0b3501ad724885492dddc7fc4c42a,1,3,3,6,3,2013-06-25 04:02:01,2013-06-25 01:37:51
0960cd0613d0b3501ad724885492dddc7fc4c42a...aef098006302689d2d75673be828e31903ee7c3c,2,16,3,19,4,2013-06-25 05:32:55,2013-06-14 05:25:00
aef098006302689d2d75673be828e31903ee7c3c...00d890c07abe538fb414b7eba496f924c3526fe0,1,2,2,4,1,2013-06-25 20:13:32,2013-06-24 18:34:54
00d890c07abe538fb414b7eba496f924c3526fe0...71bc1b761d9721805caab9479287b34169c0121e,2,8,1,9,4,2013-06-25 20:17:09,2013-06-23 21:27:18
71bc1b761d9721805caab9479287b34169c0121e...73f811203200ec96b7a396151327089c39fe37a3,2,39,3,42,6,2013-06-25 20:17:36,2013-06-25 20:17:36
73f811203200ec96b7a396151327089c39fe37a3...f8109406002840ecb306966941ee240433b99223,1,1,1,2,1,2013-06-25 22:54:17,2013-06-25 20:28:08
f8109406002840ecb306966941ee240433b99223...d57613cd6dd09a8b2ec08d5eab41c58fcfb671a5,1,2,0,2,1,2013-06-27 18:36:26,2013-06-26 18:34:32
d57613cd6dd09a8b2ec08d5eab41c58fcfb671a5...fdab3082785e79938329534feb3581711554e754,1,81,56,137,13,2013-06-27 19:37:59,2013-06-27 19:37:35
fdab3082785e79938329534feb3581711554e754...bad9d1b71fbbb32cccfe62959a7319221810a8d5,1,4,4,8,4,2013-06-27 19:45:53,2013-06-26 23:19:50
bad9d1b71fbbb32cccfe62959a7319221810a8d5...9d27b0af4c434e4b2f68b2e858b82ae02350d525,1,4,5,9,3,2013-06-27 20:15:19,2013-06-26 06:40:18
9d27b0af4c434e4b2f68b2e858b82ae02350d525...2adad3ab81a037f26220d72400487802dff737e0,1,8,8,16,2,2013-06-27 20:20:37,2013-06-26 06:19:50
2adad3ab81a037f26220d72400487802dff737e0...344e195c60731f18529dacd35b478afb9dbeddf1,2,2,2,4,2,2013-06-27 21:55:47,2013-06-27 21:55:47
344e195c60731f18529dacd35b478afb9dbeddf1...15e1a29cd08993b599f390e83a249ec17f753972,3,112,13,125,15,2013-06-28 04:30:24,2013-03-13 23:29:26
15e1a29cd08993b599f390e83a249ec17f753972...bd5c9a03713e38418a16a3074b7e4381adfe5b3a,1,10,10,20,10,2013-06-28 07:28:06,2013-06-28 07:28:06
bd5c9a03713e38418a16a3074b7e4381adfe5b3a...e1ec5c7963a3f19700f951104959cffd2ed41caa,1,1,1,2,1,2013-06-28 16:33:08,2013-06-28 16:33:02
e1ec5c7963a3f19700f951104959cffd2ed41caa...b6b504b04c4fdcdb7f728acd864da4106efdbc9c,1,0,7,7,1,2013-06-28 18:27:32,2013-06-28 18:27:32
b6b504b04c4fdcdb7f728acd864da4106efdbc9c...89efb12ed852070a93777c5ff0ed3f9bc822bdf0,2,0,335,335,9,2013-06-28 18:43:38,2013-06-25 18:24:02
89efb12ed852070a93777c5ff0ed3f9bc822bdf0...29f96c852c355d0e283a64111d4923d1bcde8f5f,7,98,74,172,27,2013-06-28 18:43:38,2013-06-25 18:48:10
29f96c852c355d0e283a64111d4923d1bcde8f5f...976edc1fc4d4c373bcecddd0389fe94dd528eb4e,4,24,45,69,12,2013-06-28 18:43:38,2013-06-28 08:47:35
976edc1fc4d4c373bcecddd0389fe94dd528eb4e...33223e26a0c6e73bddbc112829f35f373f97b10d,10,75,4,79,13,2013-06-28 18:43:38,2013-06-25 20:50:45
33223e26a0c6e73bddbc112829f35f373f97b10d...ac04b878519bd9163727fca5827cf8d12b093a20,1,2,2,4,1,2013-06-28 18:43:38,2013-06-28 18:26:45
ac04b878519bd9163727fca5827cf8d12b093a20...0e254cc88c9ece7e4d4343aee00cd49efcba40ef,1,1,0,1,1,2013-06-28 20:04:31,2013-05-31 00:06:32
0e254cc88c9ece7e4d4343aee00cd49efcba40ef...a22596c925a41c6f9b78cb21e18894987bbbc84b,1,8,8,16,8,2013-06-29 00:38:11,2013-06-28 19:43:18
a22596c925a41c6f9b78cb21e18894987bbbc84b...1532ec1dfe6a200481ba94601b9e49c92879dc2d,1,2,1,3,1,2013-07-01 10:35:16,2013-06-29 03:00:31
1532ec1dfe6a200481ba94601b9e49c92879dc2d...06a9972228e2fa6740824e7a3470de69bf5ee332,1,35,1,36,3,2013-07-01 11:01:07,2013-06-30 18:27:42
06a9972228e2fa6740824e7a3470de69bf5ee332...a258817310e83ae58a0ce95226e77a9f151d7197,1,1,0,1,1,2013-07-01 17:15:08,2013-07-01 17:15:08
a258817310e83ae58a0ce95226e77a9f151d7197...807394095b991357225a03d5fed81fea5c9a1abe,4,58,4,62,9,2013-07-01 18:32:12,2013-04-26 21:31:56
807394095b991357225a03d5fed81fea5c9a1abe...0c6fb665a4e2e1e7ceb11372153963658d4b53b1,1,2,2,4,2,2013-07-01 21:30:43,2013-07-01 21:29:37
0c6fb665a4e2e1e7ceb11372153963658d4b53b1...c8fcf3b369dbe866815e18e0fa4d71f3e679bc5f,4,52,3,55,7,2013-07-01 22:42:14,2013-06-28 23:47:10
c8fcf3b369dbe866815e18e0fa4d71f3e679bc5f...52c538c26932816a1ea4805490dc2673f82bf901,1,5,5,10,4,2013-07-01 23:04:08,2013-07-01 23:04:08
52c538c26932816a1ea4805490dc2673f82bf901...48eb297c1130fd08b22ba2bae032d3a5339c8615,1,2,2,4,2,2013-07-02 09:01:02,2013-07-02 02:44:52
48eb297c1130fd08b22ba2bae032d3a5339c8615...4f0f2437712a5ae3e79780e2d6fa32b70abe1a52,4,44,35,79,18,2013-07-02 18:05:30,2013-07-02 00:23:24
4f0f2437712a5ae3e79780e2d6fa32b70abe1a52...c46c5924c4a7c6131086429c6e0ccae8151137be,1,2,2,4,2,2013-07-02 18:07:59,2013-07-02 18:06:01
c46c5924c4a7c6131086429c6e0ccae8151137be...726e0c246bfbece82fcf606493e64b97d3e6e711,1,19,15,34,1,2013-07-02 18:11:52,2013-07-02 18:11:52
726e0c246bfbece82fcf606493e64b97d3e6e711...6e1b64176f91ef6049cd03dc666554b7e04a9000,1,3,2,5,2,2013-07-02 19:58:37,2013-07-02 19:33:48
6e1b64176f91ef6049cd03dc666554b7e04a9000...2c2adbcab54d3504f1ae9c91b761c2a18a5d8468,5,61,6,67,10,2013-07-02 20:58:52,2013-07-01 23:21:56
2c2adbcab54d3504f1ae9c91b761c2a18a5d8468...91e139e52a0a9d2d47337c46c8bd9e04e7466358,1,1,1,2,1,2013-07-02 21:35:06,2013-07-02 21:19:48
91e139e52a0a9d2d47337c46c8bd9e04e7466358...cbbe3bfe91526af0523c0b014895f78df6a983ed,2,10,11,21,11,2013-07-03 05:35:39,2013-07-03 00:15:24
cbbe3bfe91526af0523c0b014895f78df6a983ed...69f42b76548d00f52b231ec91150e4f0b008c730,2,84,18,102,21,2013-07-03 05:35:39,2013-07-03 00:23:51
69f42b76548d00f52b231ec91150e4f0b008c730...695797140520a391a99205af8119c152ef06fabc,1,1,1,2,1,2013-07-03 05:36:22,2013-07-02 23:21:53
695797140520a391a99205af8119c152ef06fabc...c21ab0a68abebab541fcaf322a87f3817a98d095,1,1,2,3,1,2013-07-03 05:49:54,2013-06-25 20:58:31
c21ab0a68abebab541fcaf322a87f3817a98d095...3ffddad100e993403d13137387d0685466b46b2b,2,2,2,4,2,2013-07-03 05:57:34,2013-06-26 03:37:56
3ffddad100e993403d13137387d0685466b46b2b...fd87eb0ca5e14f213d8b31280d444dbc29c20c50,2,13,6,19,2,2013-07-03 06:24:51,2013-06-28 03:53:17
fd87eb0ca5e14f213d8b31280d444dbc29c20c50...5349b20097dc5cdff0216ee219ac5f6e6ef8c219,2,216,29,245,29,2013-07-03 07:03:56,2013-06-24 21:14:54
5349b20097dc5cdff0216ee219ac5f6e6ef8c219...22b9b4757610918456e3486deb514bcc60a08852,1,14,3,17,1,2013-07-03 08:42:41,2013-04-20 17:35:11
22b9b4757610918456e3486deb514bcc60a08852...ef5bc6c7c3336a64bae64fe9739cb1789907c906,2,49,0,49,3,2013-07-03 21:16:31,2013-06-28 10:06:36
ef5bc6c7c3336a64bae64fe9739cb1789907c906...b3d7a038d774d823ef861b76fb8bfa22e60a3df5,247,13236,13231,26467,982,2013-07-03 21:51:31,2013-05-05 00:44:14
b3d7a038d774d823ef861b76fb8bfa22e60a3df5...a59a5f386a96f6b208acea78ab8233cb88180ce7,1,1,0,1,1,2013-07-03 21:52:53,2013-05-09 22:35:51
a59a5f386a96f6b208acea78ab8233cb88180ce7...fc8c9baa399c33956133cdb6892fc7007430d299,1,1,1,2,1,2013-07-03 22:51:41,2013-05-06 20:18:42
fc8c9baa399c33956133cdb6892fc7007430d299...0e9e0af9755232ef3ac4858379cc155444a9ba5c,1,2,1,3,1,2013-07-03 23:28:54,2013-07-03 15:51:56
0e9e0af9755232ef3ac4858379cc155444a9ba5c...861e0c75bd60706d1fd4076d6a7b205c18bb63c9,1,4,0,4,1,2013-07-03 23:35:34,2013-07-03 10:50:06
861e0c75bd60706d1fd4076d6a7b205c18bb63c9...f59b9c6fbdfa134dcf682a5092e8835cc56abb54,1,1,1,2,1,2013-07-07 19:31:15,2013-07-07 19:30:37
f59b9c6fbdfa134dcf682a5092e8835cc56abb54...d88dc4a64f0cc1e83d0dd85ffffd254e72d23ca9,2,5,3,8,2,2013-07-08 09:56:25,2013-07-07 20:33:07
d88dc4a64f0cc1e83d0dd85ffffd254e72d23ca9...7829c50f9e89e779980f6d60a397aedfc7eaec61,2,19,1,20,3,2013-07-08 10:05:08,2013-07-08 10:00:59
7829c50f9e89e779980f6d60a397aedfc7eaec61...96298f9179ebe366e83ad0abd02888c87438634d,1,3,1,4,1,2013-07-08 10:23:15,2013-07-08 10:23:15
96298f9179ebe366e83ad0abd02888c87438634d...0d124e190b24e737405b467d4fc11f10047b3d9c,1,8,1,9,2,2013-07-08 13:52:31,2013-07-08 13:52:31
0d124e190b24e737405b467d4fc11f10047b3d9c...a7150f1256f2a97a931b3c0d16eab70f45e81cae,2,44,1,45,4,2013-07-08 15:55:20,2013-07-03 07:51:05
a7150f1256f2a97a931b3c0d16eab70f45e81cae...f89ba38dcd495b9e5f835b3af489e7b92e72ccf6,1,1,1,2,1,2013-07-09 13:31:21,2013-07-09 06:26:27
f89ba38dcd495b9e5f835b3af489e7b92e72ccf6...ead9cb7fb4460a33c084506d4a4ed993916ededc,1,1,1,2,1,2013-07-09 13:35:55,2013-07-09 09:43:24
ead9cb7fb4460a33c084506d4a4ed993916ededc...8a3e3f9eb309b99f1a78765d45bc0dd2ce6844c0,1,1,1,2,1,2013-07-10 18:30:34,2013-07-04 20:03:13
8a3e3f9eb309b99f1a78765d45bc0dd2ce6844c0...87aeb78c0ef7540f8a86957b57de66ef7b24698e,1,5,5,10,4,2013-07-10 19:54:49,2013-07-10 19:42:50
87aeb78c0ef7540f8a86957b57de66ef7b24698e...899f5d14574c4b79508bc8432fab74523c076a70,1,1,1,2,1,2013-07-10 20:09:15,2013-07-08 14:51:34
899f5d14574c4b79508bc8432fab74523c076a70...220f0dbcf11ef8bba8917e9a7f5877b49bedb4e9,1,7,11,18,7,2013-07-10 20:18:44,2013-07-05 04:34:55
220f0dbcf11ef8bba8917e9a7f5877b49bedb4e9...ded42c7431014dc212481c83338c23261eee87a3,1,1,1,2,1,2013-07-10 20:26:49,2013-07-09 15:52:14
ded42c7431014dc212481c83338c23261eee87a3...13469e83fc8062202c92e3e9ec44ab60ef96d819,1,1,1,2,1,2013-07-10 20:53:26,2013-07-10 14:28:01
13469e83fc8062202c92e3e9ec44ab60ef96d819...cd11cc108300f7d9c3e3b90168c8b3c4ce14f535,1,1,0,1,1,2013-07-10 20:57:26,2013-07-10 14:42:34
cd11cc108300f7d9c3e3b90168c8b3c4ce14f535...de4b048b4914c8c5b8d4f68a6a06f713fdf1c22d,1,4,1,5,4,2013-07-11 16:23:40,2013-07-10 19:52:28
de4b048b4914c8c5b8d4f68a6a06f713fdf1c22d...03216760ec858f3257e4e009a40f7f9a62b41510,1,0,8,8,1,2013-07-11 18:11:35,2013-07-11 18:11:35
03216760ec858f3257e4e009a40f7f9a62b41510...31631b2b2879f49b4458461b1ec1fb79d32dfb42,3,23,2,25,5,2013-07-11 18:38:34,2013-07-03 18:10:23
31631b2b2879f49b4458461b1ec1fb79d32dfb42...e82d780c2e489aa136700e975ecc0592ad8ee9b1,2,6,2,8,2,2013-07-11 19:16:02,2013-07-11 19:15:58
e82d780c2e489aa136700e975ecc0592ad8ee9b1...a83ed0e6c373695f02ecd126f400a0ca1840b7d2,1,0,6,6,1,2013-07-11 20:01:29,2013-06-13 01:31:10
a83ed0e6c373695f02ecd126f400a0ca1840b7d2...4e96334b5c2a18204cd82fa121e2290906277b39,1,3,3,6,2,2013-07-11 20:48:45,2013-07-10 22:11:54
4e96334b5c2a18204cd82fa121e2290906277b39...8bd6619b7efa485b020fec96c76047e480469871,2,25,1,26,2,2013-07-11 21:04:00,2013-06-10 02:16:26
8bd6619b7efa485b020fec96c76047e480469871...52d6a5990225439ac9141398d83e0d4e6134b576,3,42,3,45,5,2013-07-11 21:07:08,2013-05-10 21:06:18
52d6a5990225439ac9141398d83e0d4e6134b576...09a1e7af129880cab89a2f709f22a7286f52371e,2,13,1,14,2,2013-07-11 21:58:35,2013-05-14 17:14:06
09a1e7af129880cab89a2f709f22a7286f52371e...3371fc254a9698eae35bb6f8f1ee9c434ae761e2,3,19,8,27,5,2013-07-12 00:24:30,2013-05-23 15:22:55
3371fc254a9698eae35bb6f8f1ee9c434ae761e2...7fef06fef9b6af4436f9fed10bd29d0a63707614,2,6,1,7,6,2013-07-12 08:29:21,2013-07-12 08:29:06
7fef06fef9b6af4436f9fed10bd29d0a63707614...22a9b1ac07f98d07e1e5d71ce961411b5fa9b42d,2,22,5,27,6,2013-07-12 09:05:23,2013-06-03 08:09:36
22a9b1ac07f98d07e1e5d71ce961411b5fa9b42d...b94ca12fa0b027d8592f5717e038b7b116c59384,2,9,3,12,3,2013-07-12 09:47:46,2013-05-14 05:41:01
b94ca12fa0b027d8592f5717e038b7b116c59384...ccda0f35090b1a6b3d5cd2288987ba77fcd1d4d7,3,3,3,6,3,2013-07-12 17:41:48,2013-07-10 11:31:04
ccda0f35090b1a6b3d5cd2288987ba77fcd1d4d7...5a294c8646452d6e49339d145faeae4f31dcd0fc,2,6,1,7,3,2013-07-12 18:32:40,2013-06-23 19:04:59
5a294c8646452d6e49339d145faeae4f31dcd0fc...77c715d7caedf9dd56b07b451dc47480cac5aaff,5,184,151,335,35,2013-07-12 21:43:24,2013-07-09 22:08:23
77c715d7caedf9dd56b07b451dc47480cac5aaff...514dc0eb16a8fe3fa7c44094d743714f73754321,2,23,1,24,3,2013-07-13 00:42:37,2013-07-13 00:42:37
514dc0eb16a8fe3fa7c44094d743714f73754321...32f8a04c8f3eb480b3f405ac6b1324c96025b2fc,1,1,1,2,1,2013-07-14 00:20:56,2013-07-14 00:20:56
32f8a04c8f3eb480b3f405ac6b1324c96025b2fc...724819e3cfd8aeda1f724fb527db2b57494be9b7,2,49,4,53,7,2013-07-14 05:22:28,2013-05-20 17:10:04
724819e3cfd8aeda1f724fb527db2b57494be9b7...b53c945bf55946a60be6ce0fcd21175a25f078a3,1,4,1,5,3,2013-07-14 06:41:47,2013-07-14 06:41:47
b53c945bf55946a60be6ce0fcd21175a25f078a3...d7fde5fcb12ba0bcb8061ad349e22f3513cd6ec6,1,2,2,4,2,2013-07-14 14:03:57,2013-07-13 22:50:29
d7fde5fcb12ba0bcb8061ad349e22f3513cd6ec6...1e649c5a813d81ec83a0e0eda35dc7477ac98784,1,6,4,10,4,2013-07-14 14:14:28,2013-07-12 21:32:05
1e649c5a813d81ec83a0e0eda35dc7477ac98784...a170fc1a749effa98bfd1c2e1b30297ed47b451b,2,70,6,76,38,2013-07-14 14:36:15,2013-07-12 20:20:40
a170fc1a749effa98bfd1c2e1b30297ed47b451b...d884eb80a10a336f6765d5fe20554933eda23545,1,221,151,372,132,2013-07-15 06:11:46,2013-07-14 07:43:52
d884eb80a10a336f6765d5fe20554933eda23545...2a5c3555829da51f55abd810a828c73b420316d3,2,345,20,365,31,2013-07-15 06:11:46,2013-03-25 01:18:10
2a5c3555829da51f55abd810a828c73b420316d3...760a233703f445dfa3981f685602df7423348eba,1,1,1,2,1,2013-07-15 13:55:12,2013-07-15 00:41:51
760a233703f445dfa3981f685602df7423348eba...14626d0bc57cf55e8bde4a329b896308b6c09880,1,1,0,1,1,2013-07-15 16:26:19,2013-07-15 00:46:17
14626d0bc57cf55e8bde4a329b896308b6c09880...031da1f96b3e0074e682e35ac909256c37c91864,7,62,33,95,25,2013-07-15 16:30:54,2013-06-18 02:40:01
031da1f96b3e0074e682e35ac909256c37c91864...7ec926ff56fca50bf55191c7f056746fa77d8aa2,1,20,19,39,3,2013-07-16 18:13:36,2013-07-15 21:15:02
7ec926ff56fca50bf55191c7f056746fa77d8aa2...711a493709addc841c5dba34e483043467dacc2f,1,6,0,6,1,2013-07-16 18:18:04,2013-07-16 17:15:44
711a493709addc841c5dba34e483043467dacc2f...c8b54ad16754a3ea7deae787ffbb8b3e447124b0,1,3,3,6,3,2013-07-17 10:22:10,2013-07-16 23:09:31
c8b54ad16754a3ea7deae787ffbb8b3e447124b0...1a8d83d6608f7c29116e4dc9dd565df21a4ae045,1,38,2,40,1,2013-07-17 15:40:51,2013-07-17 14:45:53
1a8d83d6608f7c29116e4dc9dd565df21a4ae045...2bb27d4998805fd89db25192f53d26d259ae615f,2,49,1,50,3,2013-07-18 17:24:42,2013-07-16 21:36:38
2bb27d4998805fd89db25192f53d26d259ae615f...e449c6df06d92136f9fab95caa29ac2e74b5e58b,1,5,0,5,1,2013-07-18 17:53:20,2013-07-18 01:18:57
e449c6df06d92136f9fab95caa29ac2e74b5e58b...3e39ac7e1b10d4812a44dad2f959a93361cd823b,2,76,27,103,16,2013-07-18 18:29:50,2013-07-16 19:48:29
3e39ac7e1b10d4812a44dad2f959a93361cd823b...52123ae85bc131d070ce9e7102b3c5fbbb872fba,2,15,2,17,5,2013-07-18 18:57:13,2013-07-18 18:39:18
52123ae85bc131d070ce9e7102b3c5fbbb872fba...aad29cbbf0b101bc5e793a66df7e368c7968cad8,1,4,2,6,2,2013-07-18 21:02:36,2013-07-08 10:42:31
aad29cbbf0b101bc5e793a66df7e368c7968cad8...cd36cd86fcbb8fec873a1fe3e513965d4dc0b557,1,3,1,4,2,2013-07-18 21:02:36,2013-07-08 12:23:45
cd36cd86fcbb8fec873a1fe3e513965d4dc0b557...ef4458a798b6736050436bb63e5a5c90ce958790,3,3,2,5,3,2013-07-18 21:02:36,2013-07-08 13:42:18
ef4458a798b6736050436bb63e5a5c90ce958790...715d97d5c87c9250f8ac8b5801b8c7f3b197e815,1,48,0,48,1,2013-07-18 23:10:38,2013-07-18 21:22:04
715d97d5c87c9250f8ac8b5801b8c7f3b197e815...b99d064b6ddbcc9f59ea45004279833e9ea82928,7,160,75,235,14,2013-07-19 08:44:57,2013-07-15 19:26:46
b99d064b6ddbcc9f59ea45004279833e9ea82928...bb8c3ec1a51f73a7d38b696c3355f3dbea7d98a8,1,7,3,10,4,2013-07-21 15:14:17,2013-07-19 01:44:23
bb8c3ec1a51f73a7d38b696c3355f3dbea7d98a8...fd45d590ef924c25903832086a63172f98ea189c,1,4,2,6,1,2013-07-21 18:24:33,2013-07-21 17:25:23
fd45d590ef924c25903832086a63172f98ea189c...e14e21904aa61c293cfcb4bd447fabcd192601e4,1,2,2,4,2,2013-07-21 19:06:40,2013-07-19 17:13:36
e14e21904aa61c293cfcb4bd447fabcd192601e4...3967f5f7d6c8aa7b41a5352b12f457e2fbaa251a,2,15,0,15,2,2013-07-22 18:27:53,2013-07-22 15:59:20
3967f5f7d6c8aa7b41a5352b12f457e2fbaa251a...45f9f62367221b2aa097ba1d87d744e50140ddc7,2,97,3,100,2,2013-07-22 18:27:53,2013-07-18 18:30:32
45f9f62367221b2aa097ba1d87d744e50140ddc7...717f24feb43cb71538a7c07e4aa013c916640006,2,2,23,25,4,2013-07-22 20:59:27,2013-07-22 20:59:21
717f24feb43cb71538a7c07e4aa013c916640006...865314495376adfcad3c81a2917a13e80dff6bce,1,5,0,5,1,2013-07-23 18:00:58,2013-07-23 18:00:42
865314495376adfcad3c81a2917a13e80dff6bce...db73a940fcc20b3f8b339cce6657cf076d6cf116,1,1,0,1,1,2013-07-23 19:09:44,2013-07-22 11:43:06
db73a940fcc20b3f8b339cce6657cf076d6cf116...6476aed7626fa7b4adefa99c5cb4a86ed371835c,1,1,1,2,1,2013-07-23 19:16:23,2013-07-22 16:08:05
6476aed7626fa7b4adefa99c5cb4a86ed371835c...dfa83475a5c8d5156b09a009b690e8677fb97e0a,2,7,0,7,2,2013-07-23 19:33:01,2013-07-23 17:42:34
dfa83475a5c8d5156b09a009b690e8677fb97e0a...7e49d37a982bea6d0e323c1f7655a54d5956311a,1,7,2,9,2,2013-07-23 22:08:42,2013-07-23 18:02:33
7e49d37a982bea6d0e323c1f7655a54d5956311a...0a3ec5f8bbc1b51c9188f661df1697cc6a32c6a5,1,9,7,16,1,2013-07-24 00:19:56,2013-07-24 00:19:56
0a3ec5f8bbc1b51c9188f661df1697cc6a32c6a5...dca23173e25a32cb740245ca7f7b01a84805f43f,1,13,5,18,3,2013-07-24 17:38:13,2013-05-24 16:23:55
dca23173e25a32cb740245ca7f7b01a84805f43f...4a7b6a4555a76b19dd217171fc0ddce6707bca95,52,470,74,544,88,2013-07-24 17:42:20,2013-07-13 00:42:27
4a7b6a4555a76b19dd217171fc0ddce6707bca95...1dcafd18afed4465ee13db91cedc8fecc3aa2c96,2,7,1,8,3,2013-07-24 17:58:56,2013-06-02 06:29:18
1dcafd18afed4465ee13db91cedc8fecc3aa2c96...454bcfa43848c5b816858faec512de54a974896a,1,32,39,71,14,2013-07-24 18:34:22,2013-06-05 23:27:18
454bcfa43848c5b816858faec512de54a974896a...a13c01a8e48ea4a0d59394eb94f1b12c50cfef61,2,23,3,26,2,2013-07-24 19:05:41,2013-06-09 20:20:40
a13c01a8e48ea4a0d59394eb94f1b12c50cfef61...47a2a9829f0a847bbee61cd142c43000d73ea98b,2,16,2,18,6,2013-07-24 21:16:26,2013-05-27 17:59:19
47a2a9829f0a847bbee61cd142c43000d73ea98b...0fcd1e3b1fa6244d02f08631d9ef81bf79996fab,2,14,3,17,4,2013-07-24 21:22:05,2013-07-18 18:44:27
0fcd1e3b1fa6244d02f08631d9ef81bf79996fab...52b8211fd0154b9d6b771a83573a161f5580d92c,2,65,1,66,6,2013-07-24 22:37:10,2013-07-19 15:02:17
52b8211fd0154b9d6b771a83573a161f5580d92c...e03402433d2524fd3a74bbfce984f843794996ce,2,53,4,57,2,2013-07-24 23:58:12,2013-07-05 00:07:12
e03402433d2524fd3a74bbfce984f843794996ce...d87fa0042375b025b98c40bff05e5f42c00af114,3,32,46,78,5,2013-07-25 01:53:09,2013-07-24 23:42:52
d87fa0042375b025b98c40bff05e5f42c00af114...fb7d891dacdcb9f799061d5fbb96cdd2dd912196,2,23,6,29,3,2013-07-25 02:02:06,2013-07-24 23:34:30
fb7d891dacdcb9f799061d5fbb96cdd2dd912196...bea9422ebfc8e80ee28ad81afc62d2e432c85cbb,28,1853,110,1963,89,2013-07-25 20:00:35,2013-05-14 21:51:39
bea9422ebfc8e80ee28ad81afc62d2e432c85cbb...dae694739b9581bea5dbc53522ec00d87b26ae55,9,134,149,283,45,2013-07-25 21:29:56,2013-07-19 23:04:51
dae694739b9581bea5dbc53522ec00d87b26ae55...27041e63a629c67bfa9a87ccd9b50fd08a23ce82,1,0,2,2,1,2013-07-25 22:05:27,2013-07-25 09:21:00
27041e63a629c67bfa9a87ccd9b50fd08a23ce82...09fa0656b49321681f28453abef566d0cbe0eb22,1,2,1,3,2,2013-07-25 22:45:35,2013-07-25 21:35:53
09fa0656b49321681f28453abef566d0cbe0eb22...f9ea69f6567c22ff328fd1f7b07847883757bfa6,1,1,1,2,1,2013-07-25 22:49:57,2013-07-25 20:24:58
f9ea69f6567c22ff328fd1f7b07847883757bfa6...ab189142988043d0513bb796c3b54ca7d07f242d,2,36,3,39,4,2013-07-25 23:36:11,2013-07-25 22:23:10
ab189142988043d0513bb796c3b54ca7d07f242d...258cae83dc1a03b6b878a7b4236c499288cd2624,10,62,54,116,43,2013-07-26 15:51:38,2013-07-09 01:58:14
258cae83dc1a03b6b878a7b4236c499288cd2624...b7fdabc4bf2a9dd11a57f98c5229d834c4589bab,2,18,2,20,3,2013-07-26 15:56:41,2013-07-24 03:45:21
b7fdabc4bf2a9dd11a57f98c5229d834c4589bab...462ed033d512ae94cb188efc9453de84ace4e17e,2,45,0,45,3,2013-07-26 15:57:25,2013-07-25 03:22:09
462ed033d512ae94cb188efc9453de84ace4e17e...6031f1db515d9c8fd0f8a64e01a38c47792f50b8,1,0,1,1,1,2013-07-26 17:14:45,2013-07-26 15:49:18
6031f1db515d9c8fd0f8a64e01a38c47792f50b8...fbad068aeb229fd3dd2a3004879584c728fed735,1,1,1,2,1,2013-07-26 17:30:09,2013-07-25 05:55:13
fbad068aeb229fd3dd2a3004879584c728fed735...11521a4cde689c2bd6aaa227b1f45cb3fb53725b,2,5,1,6,2,2013-07-26 22:58:40,2013-07-26 22:53:45
11521a4cde689c2bd6aaa227b1f45cb3fb53725b...81923f1e41560327f7de6e8fddfda0d2612658f3,40,2961,2191,5152,277,2013-07-27 06:49:54,2013-06-18 17:59:57
81923f1e41560327f7de6e8fddfda0d2612658f3...8ed0d5b6aa2e29ebc8d2026cb04380ed3343baef,8,52,138,190,59,2013-07-27 06:49:54,2013-07-24 03:02:15
8ed0d5b6aa2e29ebc8d2026cb04380ed3343baef...aa2133ad818d2e5c27cbd3933061797096356c8a,4,105,70,175,53,2013-07-27 06:49:54,2013-07-06 04:48:54
aa2133ad818d2e5c27cbd3933061797096356c8a...7d69d52acff8578e0f7d6fe57a6c45561a05b182,2,207,183,390,50,2013-07-27 06:49:54,2013-07-12 00:58:23
7d69d52acff8578e0f7d6fe57a6c45561a05b182...15389b0e377e2a84b85178e993e4940d8098d0ed,5,423,429,852,272,2013-07-27 06:49:54,2013-07-22 19:37:45
15389b0e377e2a84b85178e993e4940d8098d0ed...e31104fa6c9e5efd93ac69cd70c70cffaf200843,3,13,19,32,16,2013-07-27 06:49:54,2013-07-26 01:19:20
e31104fa6c9e5efd93ac69cd70c70cffaf200843...658bcf96b9ab19286ad1bc18f4d5268287dbbcd6,2,6,2,8,4,2013-07-27 06:49:54,2013-07-26 18:53:05
658bcf96b9ab19286ad1bc18f4d5268287dbbcd6...b322cbf3351387b7a506ae4c5a7bcb6b007f9bae,1,1,0,1,1,2013-07-27 06:49:54,2013-07-25 17:20:42
b322cbf3351387b7a506ae4c5a7bcb6b007f9bae...f5b8092a1c74f81a52fd0a6b008de10b3d813204,1,4,4,8,1,2013-07-27 14:52:20,2013-07-24 13:52:39
f5b8092a1c74f81a52fd0a6b008de10b3d813204...9fcb5c0891512ec276836a4084a8aea48df2f115,1,1,1,2,1,2013-07-27 15:07:38,2013-07-24 14:31:45
9fcb5c0891512ec276836a4084a8aea48df2f115...bc8c5257e80d27f2d9a545c34d6776e4e63589cc,1,28,27,55,11,2013-07-27 15:53:11,2013-07-27 15:53:11
bc8c5257e80d27f2d9a545c34d6776e4e63589cc...3f943e72466c13dabcb866761867e284a6fa2ced,1,1,1,2,1,2013-07-27 16:13:53,2013-07-24 20:57:11
3f943e72466c13dabcb866761867e284a6fa2ced...3c6821b9ad10331a37a995b87a92b1cb7594a70c,1,1,1,2,1,2013-07-27 16:17:50,2013-07-27 16:17:50
3c6821b9ad10331a37a995b87a92b1cb7594a70c...36ab132b8288a515d2e75cbb445dac5a93643f15,1,32,0,32,1,2013-07-27 16:21:04,2013-07-25 13:38:02
36ab132b8288a515d2e75cbb445dac5a93643f15...3570005067b9dbac732b78c0013efb5c0e2a7b87,1,6,0,6,2,2013-07-27 16:54:56,2013-07-26 18:10:45
3570005067b9dbac732b78c0013efb5c0e2a7b87...1bc99eca08bef4aceb49d4fee7ef9e291f60ff3b,1,0,14,14,1,2013-07-27 17:24:27,2013-07-27 17:24:27
1bc99eca08bef4aceb49d4fee7ef9e291f60ff3b...258e9862840f9d45709664e0e5b2a18540d8828d,13,20,19,39,17,2013-07-27 18:53:41,2013-07-22 15:01:00
258e9862840f9d45709664e0e5b2a18540d8828d...f6663b4314e4e8312ec54fb3265fc25754a22f8c,1,1,1,2,1,2013-07-28 19:30:30,2013-07-28 16:40:16
f6663b4314e4e8312ec54fb3265fc25754a22f8c...d2901bcf7dfc033f57d91d41fbe63a57570a51f2,1,1,1,2,1,2013-07-29 21:43:48,2013-07-29 17:37:57
d2901bcf7dfc033f57d91d41fbe63a57570a51f2...e1a8b42400a842cbc19a09262efce8e05795db0e,2,2,1,3,2,2013-07-29 23:16:36,2013-07-29 17:54:18
e1a8b42400a842cbc19a09262efce8e05795db0e...576269b1b719715e3aec587edf4004ccc3d18f5b,6,18,18,36,10,2013-07-30 00:26:01,2013-07-29 23:58:55
576269b1b719715e3aec587edf4004ccc3d18f5b...8d6bd510948cc8598e7cfbb9ebb545fb97795661,1,86,23,109,13,2013-07-30 04:22:05,2013-07-26 22:41:39
8d6bd510948cc8598e7cfbb9ebb545fb97795661...419ed040b6004909a22e96bfe1bc95c5aa0f38db,3,52,8,60,10,2013-07-30 04:22:05,2013-07-28 18:02:05
419ed040b6004909a22e96bfe1bc95c5aa0f38db...33d45d8fafb5abf99e6fd811cad1dd57daab918b,2,51,2,53,3,2013-07-30 04:22:05,2013-07-29 20:24:05
33d45d8fafb5abf99e6fd811cad1dd57daab918b...e1fe2ac2691e319473ed2bbca501fc6b641024e5,9,104,88,192,45,2013-07-30 04:22:05,2013-07-29 23:45:59
e1fe2ac2691e319473ed2bbca501fc6b641024e5...58c0415a53a038376500bd78e4bda77cb9d16294,1,1,1,2,1,2013-07-30 21:12:26,2013-07-30 20:21:51
58c0415a53a038376500bd78e4bda77cb9d16294...a7ae292e39713cb351431b5a430f7fa721019e32,1,3,2,5,1,2013-07-31 00:29:35,2013-07-31 00:29:35
a7ae292e39713cb351431b5a430f7fa721019e32...aa5a16224bb4e19f44fafebaf04ece7665d5ad5b,5,36,24,60,10,2013-07-31 00:31:35,2013-07-30 22:25:54
aa5a16224bb4e19f44fafebaf04ece7665d5ad5b...b3777f275c6bd2bd4a88963fd03828eb7cf3aca8,3,64,2,66,5,2013-07-31 17:30:58,2013-05-25 00:18:51
b3777f275c6bd2bd4a88963fd03828eb7cf3aca8...000012f3196776bb1d4b5df802c6763e514c0fb9,1,1,1,2,1,2013-07-31 17:31:42,2013-05-25 00:18:51
000012f3196776bb1d4b5df802c6763e514c0fb9...fad626f3047cd4ff31fe7a4181ca63f275adbae6,2,30,10,40,6,2013-07-31 18:08:56,2013-07-26 03:15:57
fad626f3047cd4ff31fe7a4181ca63f275adbae6...24a4450f2b4bcc5b616fae34b6815252896d1756,3,60,4,64,5,2013-07-31 18:48:13,2013-07-15 23:00:51
24a4450f2b4bcc5b616fae34b6815252896d1756...a644ca7b4e6ba84a467bcabed8f99386eda7fb14,3,57,1,58,4,2013-07-31 20:17:37,2013-07-30 21:48:56
a644ca7b4e6ba84a467bcabed8f99386eda7fb14...664526d69c927370c93a06745ca38de7cd03a7be,2,52,3,55,7,2013-07-31 20:17:38,2013-07-31 09:09:23
664526d69c927370c93a06745ca38de7cd03a7be...f274c0a66b28711d3b9cc7b0775e97755dd971e8,3,158,87,245,24,2013-07-31 20:38:24,2013-07-31 18:53:02
f274c0a66b28711d3b9cc7b0775e97755dd971e8...bdd4e982b7fee9811b40b545c21a74711686875c,2,59,6,65,3,2013-07-31 21:23:35,2013-07-17 15:36:09
bdd4e982b7fee9811b40b545c21a74711686875c...14b1297b512f71ee7c6a4fcd5b1397b4d70d52ee,1,0,1,1,1,2013-07-31 22:22:18,2013-07-31 22:22:18
14b1297b512f71ee7c6a4fcd5b1397b4d70d52ee...ca3e0c8ce5e1d6fa18346800023d3864c1d83a81,1,6,1,7,2,2013-07-31 22:31:53,2013-07-31 22:31:53
ca3e0c8ce5e1d6fa18346800023d3864c1d83a81...3fdbe81a337c39027929c415e719493755cd8583,2,17,0,17,2,2013-07-31 22:50:12,2013-07-24 19:20:39
3fdbe81a337c39027929c415e719493755cd8583...0bbd20f255b2954b5c41617fe718cf6eca36a972,2,6,0,6,3,2013-07-31 23:08:00,2013-06-17 14:58:13
0bbd20f255b2954b5c41617fe718cf6eca36a972...61906d3517428b6d52d3284b8d26d1a46e01dad7,2,91,0,91,2,2013-07-31 23:22:24,2013-06-03 03:04:12
61906d3517428b6d52d3284b8d26d1a46e01dad7...705c9d95bc3157547ac6008d2f0a6a0c0e0ca60a,3,51,11,62,3,2013-07-31 23:55:06,2013-07-31 23:54:21
705c9d95bc3157547ac6008d2f0a6a0c0e0ca60a...3c0c7165e26ec53bc408a6cca367e11f0433682a,2,13,5,18,6,2013-08-01 22:32:46,2013-08-01 22:19:06
3c0c7165e26ec53bc408a6cca367e11f0433682a...3079a6f4e097a777414b8c3a8a87b8e1e20b55b5,2,4,4,8,4,2013-08-01 23:07:33,2013-07-31 12:50:56
3079a6f4e097a777414b8c3a8a87b8e1e20b55b5...52a7c351c9ee7fe35b1ddf2ccd37b472b01519f7,1,18,0,18,1,2013-08-03 06:52:21,2013-08-01 22:09:35
52a7c351c9ee7fe35b1ddf2ccd37b472b01519f7...85d705ab69a89cc5b0c8d2636dede4827d0d8141,8,49,49,98,44,2013-08-03 06:52:37,2013-07-31 19:38:19
85d705ab69a89cc5b0c8d2636dede4827d0d8141...85f0d4af97b48f069290ce57888639e5744bdad2,1,1,1,2,1,2013-08-03 06:52:48,2013-07-31 19:39:27
85f0d4af97b48f069290ce57888639e5744bdad2...246c1439b502b06823650505cbe4a3848b6fa5a3,2,139,21,160,7,2013-08-03 06:55:53,2013-07-30 00:32:55
246c1439b502b06823650505cbe4a3848b6fa5a3...4ed5fc90b984bb704da8cb66dffab43cf78abefa,1,5,2,7,2,2013-08-03 06:56:04,2013-07-31 21:24:56
4ed5fc90b984bb704da8cb66dffab43cf78abefa...6e8bd786ba853613472f3864e48048a425c46823,4,45,32,77,12,2013-08-03 07:46:17,2013-08-02 02:17:10
6e8bd786ba853613472f3864e48048a425c46823...2e72239133ae1090ca94c7c5a53e1124a0e49dc4,1,4,3,7,3,2013-08-03 07:46:17,2013-08-03 07:29:36
2e72239133ae1090ca94c7c5a53e1124a0e49dc4...9f3935baffa9faaec0cac9b6b41cd845fa41d6fc,1,85,0,85,6,2013-08-03 07:46:18,2013-07-31 21:17:27
9f3935baffa9faaec0cac9b6b41cd845fa41d6fc...d45ac7707eb336d47116558e49893f910fdaf1fb,1,64,53,117,12,2013-08-03 07:46:18,2013-08-02 03:08:43
d45ac7707eb336d47116558e49893f910fdaf1fb...f2dfa8916f8ed855d55187f5400c4c2566ce9a1b,3,156,50,206,18,2013-08-03 07:46:18,2013-08-02 00:13:36
f2dfa8916f8ed855d55187f5400c4c2566ce9a1b...fda5eb7ebc4d8ba9e3c0d2488d89f6ec9220a83d,1,2,3,5,2,2013-08-03 21:05:33,2013-08-02 13:49:07
fda5eb7ebc4d8ba9e3c0d2488d89f6ec9220a83d...285f6b4ec643e1c6304cd685d26dabb8cdc0e5c6,1,2,0,2,1,2013-08-05 23:41:49,2013-08-05 23:41:49
285f6b4ec643e1c6304cd685d26dabb8cdc0e5c6...ac5105b198282139f184eb30a9850e9e212e0acf,1,1,1,2,1,2013-08-06 15:30:55,2013-08-05 09:00:45
ac5105b198282139f184eb30a9850e9e212e0acf...08daa7797bce5207916251d4a0ab3d5c93e5529a,2,28,7,35,9,2013-08-06 15:54:50,2013-08-06 15:53:46
08daa7797bce5207916251d4a0ab3d5c93e5529a...63b6c5b3f275747bcf6f22ec2491596ff4569696,2,22,1,23,3,2013-08-07 15:49:56,2013-08-01 22:38:29
63b6c5b3f275747bcf6f22ec2491596ff4569696...446ee4ea1949aa220c3ceeeab4a9c91b9ccea034,1,21,0,21,1,2013-08-07 16:05:12,2013-08-02 00:35:38
446ee4ea1949aa220c3ceeeab4a9c91b9ccea034...fe187674b5bace9d738b18a2b6a994d7e253b9ce,1,8,0,8,1,2013-08-07 16:11:15,2013-08-02 00:28:05
fe187674b5bace9d738b18a2b6a994d7e253b9ce...3b89e4eef13be0ea25758f021de5eb38152cd0bf,1,19,1,20,2,2013-08-07 16:22:21,2013-08-02 00:21:54
3b89e4eef13be0ea25758f021de5eb38152cd0bf...68d79d560e2286078cc1f7984602733a5abc0208,1,5,0,5,1,2013-08-07 16:26:04,2013-08-01 23:40:09
68d79d560e2286078cc1f7984602733a5abc0208...03475194d82ae481c72895a7dff4e0d5e89e304e,1,5,0,5,1,2013-08-07 16:28:24,2013-08-01 23:34:46
03475194d82ae481c72895a7dff4e0d5e89e304e...e21f252aa7cf588dee31ea16fdebc047a2d8e456,1,6,0,6,1,2013-08-07 16:30:04,2013-08-01 23:19:10
e21f252aa7cf588dee31ea16fdebc047a2d8e456...e38bf59aab871321182f454a6bad73c991df4228,1,2,3,5,2,2013-08-07 16:32:23,2013-08-07 16:32:23
e38bf59aab871321182f454a6bad73c991df4228...88037ad6889081112c594c284d072d0c984a6af1,1,8,1,9,2,2013-08-07 16:43:14,2013-08-02 00:34:42
88037ad6889081112c594c284d072d0c984a6af1...e4530d11fbb2c6864c6b91d00fcd229940986a88,1,9,0,9,1,2013-08-07 16:47:13,2013-08-01 21:27:49
e4530d11fbb2c6864c6b91d00fcd229940986a88...ad2b8c5bd45173bb64c476934510f0a5f1b510ee,1,3,0,3,1,2013-08-07 16:50:38,2013-08-01 21:45:18
ad2b8c5bd45173bb64c476934510f0a5f1b510ee...ab59cc6c44705b1244a77eba999d736f9eb3c6ae,2,7,1,8,2,2013-08-07 16:52:47,2013-08-03 15:57:37
ab59cc6c44705b1244a77eba999d736f9eb3c6ae...a02aaf17098006f3bf088e2b6a39b96b8b0736a9,1,8,1,9,2,2013-08-07 17:45:11,2013-08-01 22:21:23
a02aaf17098006f3bf088e2b6a39b96b8b0736a9...af731354b0b600f87f15e1573e64a7f7acc70f3d,2,2,1,3,2,2013-08-07 18:02:44,2013-08-02 13:57:58
af731354b0b600f87f15e1573e64a7f7acc70f3d...d1cdd4d026968993db9d0130390bb5138b942224,3,6,3,9,4,2013-08-07 18:21:34,2013-08-07 18:20:51
d1cdd4d026968993db9d0130390bb5138b942224...6d7ee1ad3b548fa0e3ebf13e008d7024b664813f,1,1,1,2,1,2013-08-07 19:59:01,2013-07-30 16:20:42
6d7ee1ad3b548fa0e3ebf13e008d7024b664813f...be621934edca1efef80cb24752fad4e1e915739f,1,1,1,2,1,2013-08-07 20:02:46,2013-08-07 04:51:48
be621934edca1efef80cb24752fad4e1e915739f...8ea802a1d23ad8ecacab892a3a451a308d9c39d7,2,29,4,33,5,2013-08-07 20:50:18,2013-07-02 19:14:24
8ea802a1d23ad8ecacab892a3a451a308d9c39d7...ca09a0db2f57ead5583fdf7968f525a6dcf86a9f,1,4,0,4,1,2013-08-07 21:11:23,2013-08-07 20:49:52
ca09a0db2f57ead5583fdf7968f525a6dcf86a9f...7f14cdeeb531d140b25b10f5eb7d6643cd950210,1,10,0,10,1,2013-08-07 22:26:27,2013-08-07 22:22:21
7f14cdeeb531d140b25b10f5eb7d6643cd950210...66007a4150a84980ae3578a1a6e542880bb7f408,1,60,1,61,1,2013-08-07 22:36:02,2013-06-27 23:18:00
66007a4150a84980ae3578a1a6e542880bb7f408...4be7612079f34c8b95c82f24b822e2ae06c82270,1,4,2,6,2,2013-08-07 23:35:37,2013-08-07 04:53:51
4be7612079f34c8b95c82f24b822e2ae06c82270...306a613440175c7fd61d1d6eb249d1e53a46322e,2,29,0,29,2,2013-08-08 04:33:37,2013-06-26 13:49:21
306a613440175c7fd61d1d6eb249d1e53a46322e...e4b6a1eaa4a432b0082c7abbff8f4bb169cf846e,18,181,6,187,18,2013-08-08 04:36:59,2013-08-01 22:11:10
e4b6a1eaa4a432b0082c7abbff8f4bb169cf846e...5d3744ad9b9d3c452e9aeaf9a5ef94dff0aadb67,1,45,0,45,1,2013-08-08 17:11:56,2013-08-01 21:23:10
5d3744ad9b9d3c452e9aeaf9a5ef94dff0aadb67...a53e466b80162b6b7b70956f08ef3ca4cf1043f0,1,2,1,3,1,2013-08-08 17:12:13,2013-08-08 17:12:13
a53e466b80162b6b7b70956f08ef3ca4cf1043f0...3ab579a2a6a9b21d3b43014f08f6c60bbad265a2,1,5,3,8,2,2013-08-08 17:21:26,2013-08-08 17:21:26
3ab579a2a6a9b21d3b43014f08f6c60bbad265a2...0bf0570505e41be266beaa1ccd0266aaed0c3cfb,7,18,18,36,18,2013-08-08 17:22:32,2013-08-08 17:22:32
0bf0570505e41be266beaa1ccd0266aaed0c3cfb...934e569ccab7bd5ec5e3e1bcc534a855583b6e5f,1,7,11,18,6,2013-08-08 17:32:55,2013-08-08 17:32:55
934e569ccab7bd5ec5e3e1bcc534a855583b6e5f...caa71c2772284c3d108c41ac120491b7137fabf7,1,31,1,32,2,2013-08-08 17:56:55,2013-08-08 17:30:10
caa71c2772284c3d108c41ac120491b7137fabf7...e27fb4ddd69126834ced3f200da959b19d5b2160,3,6,6,12,6,2013-08-08 18:02:30,2013-08-08 17:59:48
e27fb4ddd69126834ced3f200da959b19d5b2160...def7e961b4af13a8be95a9d9f58255ccbc09b1cb,1,7,0,7,1,2013-08-08 18:08:03,2013-08-08 17:44:19
def7e961b4af13a8be95a9d9f58255ccbc09b1cb...3cde777514357eab54e39c126a29f1f7dcbb81af,1,7,0,7,1,2013-08-08 18:11:17,2013-08-01 21:52:48
3cde777514357eab54e39c126a29f1f7dcbb81af...40d351712ed8bd211fb1eae9211440b280b2f2c0,1,5,0,5,1,2013-08-08 18:19:25,2013-08-08 17:59:46
40d351712ed8bd211fb1eae9211440b280b2f2c0...c7953ffb7fff1965c9a8d1651c451368e1474496,1,10,11,21,4,2013-08-08 18:23:17,2013-08-08 18:23:17
c7953ffb7fff1965c9a8d1651c451368e1474496...69058bf2c4a94fb7a9ac0ded3d061ebdac22ede3,1,4,2,6,1,2013-08-08 18:24:34,2013-08-08 18:24:34
69058bf2c4a94fb7a9ac0ded3d061ebdac22ede3...465a2937cc9e612608abcbb26a02f53cf5718e36,1,7,5,12,4,2013-08-08 18:26:56,2013-08-08 18:26:56
465a2937cc9e612608abcbb26a02f53cf5718e36...74d50f7c16026da91053b72e589f6b8cc2ca318c,1,70,0,70,1,2013-08-08 19:04:34,2013-08-08 19:04:34
74d50f7c16026da91053b72e589f6b8cc2ca318c...3fb80b4ea195aa498fe9336b7823955b207e49d8,1,17,0,17,1,2013-08-08 19:13:34,2013-08-08 19:13:34
3fb80b4ea195aa498fe9336b7823955b207e49d8...4e76d0469ec4be3d704e8b2c3a98748357e93232,1,12,0,12,1,2013-08-08 21:14:33,2013-08-01 22:28:18
4e76d0469ec4be3d704e8b2c3a98748357e93232...78a445fa375400a2ced5383b485f26fc0ae363d2,4,39,7,46,5,2013-08-08 21:33:16,2013-08-01 22:39:22
78a445fa375400a2ced5383b485f26fc0ae363d2...fa3985764c1636fb408f18516dc47933ca0def44,1,16,0,16,1,2013-08-08 21:45:04,2013-08-01 22:46:36
fa3985764c1636fb408f18516dc47933ca0def44...dbd703a9fb864b787bc90c45fd4eb5ded7422f24,3,18,2,20,3,2013-08-09 00:16:46,2013-08-01 22:53:59
dbd703a9fb864b787bc90c45fd4eb5ded7422f24...4175377aaff9401f8b6c6f62ece71706ecb7f4ce,1,26,0,26,1,2013-08-09 01:58:08,2013-08-01 23:01:41
4175377aaff9401f8b6c6f62ece71706ecb7f4ce...5c560117425e7b3f7270389274476e843d6f69ec,2,72,8,80,4,2013-08-09 04:53:44,2013-08-08 23:04:11
5c560117425e7b3f7270389274476e843d6f69ec...4f5dfbc362d9683177708ebcc00c98cf594d1287,2,14,3,17,3,2013-08-09 05:40:04,2013-08-08 04:55:44
4f5dfbc362d9683177708ebcc00c98cf594d1287...af2cda3687314e13bc25b558d3fbf9c40ec46f0d,1,4,0,4,1,2013-08-09 05:42:25,2013-08-08 22:46:33
af2cda3687314e13bc25b558d3fbf9c40ec46f0d...43997c15406d0401525f3d2d72914b28850905e1,1,4,2,6,1,2013-08-09 06:08:40,2013-08-09 06:07:46
43997c15406d0401525f3d2d72914b28850905e1...f80730f497cb1ecb78a814f01df79b69223ad633,2,25,0,25,2,2013-08-09 06:29:59,2013-08-06 01:25:44
f80730f497cb1ecb78a814f01df79b69223ad633...05b41eedce679a65cf7beac8b19d891721f93323,2,16,10,26,7,2013-08-09 06:50:28,2013-08-01 20:14:52
05b41eedce679a65cf7beac8b19d891721f93323...953fa4cd1631e77cd8ddf321b968fcbd9e3a10f2,2,8,8,16,2,2013-08-09 06:53:09,2013-08-04 15:40:24
953fa4cd1631e77cd8ddf321b968fcbd9e3a10f2...3824e40011df1c0fdf5964d78776f1a12a29c144,1,4,4,8,2,2013-08-09 07:12:19,2013-08-09 07:12:19
3824e40011df1c0fdf5964d78776f1a12a29c144...b3087421f20241f9bcb9b1f00ee9a30efc8b0899,4,9,9,18,9,2013-08-09 07:39:31,2013-08-09 07:16:27
b3087421f20241f9bcb9b1f00ee9a30efc8b0899...a207665dad69248139b150cd3fe8ba13059bffb4,2,29,10,39,14,2013-08-09 16:02:58,2013-08-06 09:48:32
a207665dad69248139b150cd3fe8ba13059bffb4...0c399bc546b9d62b96cfe30678c464aa69426a5d,1,0,5,5,1,2013-08-09 16:54:17,2013-08-09 16:54:17
0c399bc546b9d62b96cfe30678c464aa69426a5d...61cb4085d421060edfb98d7eae0a43b615542843,1,12,8,20,4,2013-08-09 17:08:36,2013-08-09 10:36:37
61cb4085d421060edfb98d7eae0a43b615542843...0b114fd3e1ce4cc120663222f2dfb34ee5dbda4c,4,17,2,19,4,2013-08-09 17:19:41,2013-08-02 16:21:33
0b114fd3e1ce4cc120663222f2dfb34ee5dbda4c...890e939fcc0e059b66a4868853d82e23fbc68ac3,1,5,3,8,3,2013-08-09 17:21:32,2013-08-09 16:52:27
890e939fcc0e059b66a4868853d82e23fbc68ac3...0d17838a0881376be3c226a68242b5d74dac208b,1,1,1,2,1,2013-08-09 17:32:27,2013-07-30 08:36:40
0d17838a0881376be3c226a68242b5d74dac208b...94ec84e7b9c89358dc00e4039009af9e287bbd05,11,33,33,66,24,2013-08-09 18:54:35,2013-08-09 17:02:48
94ec84e7b9c89358dc00e4039009af9e287bbd05...3ee744cc63a24b127d6a5f632934bb6ed2de275a,3,61,0,61,3,2013-08-09 20:14:12,2013-07-24 17:17:24
3ee744cc63a24b127d6a5f632934bb6ed2de275a...f078762d48d0d5d9796dcdf2cb0241198677582c,2,39,37,76,35,2013-08-09 21:08:57,2013-08-09 16:45:35
f078762d48d0d5d9796dcdf2cb0241198677582c...45dc9ee7b4a1e004f9fb7edde41d4805d1402ffa,6,11,11,22,10,2013-08-09 21:12:04,2013-08-09 18:14:37
45dc9ee7b4a1e004f9fb7edde41d4805d1402ffa...1b5bee4fa12b1f14e117f7ca222c2e2b64cc8558,2,44,16,60,9,2013-08-09 21:39:57,2013-08-02 21:51:43
1b5bee4fa12b1f14e117f7ca222c2e2b64cc8558...87405e25ae935eefd673e70ffd6144a5f455b662,1,42,38,80,8,2013-08-09 21:39:58,2013-08-04 15:20:48
87405e25ae935eefd673e70ffd6144a5f455b662...f61ff695192df2123ea086ddd5fe65e27e9b4e18,1,4,11,15,5,2013-08-09 21:39:58,2013-08-06 18:19:33
f61ff695192df2123ea086ddd5fe65e27e9b4e18...2430347ece2f7a74a35d3ab0095ecc895884670e,2,137,104,241,25,2013-08-09 21:39:58,2013-08-06 18:15:01
2430347ece2f7a74a35d3ab0095ecc895884670e...c173ca412878d537b18df01f39e400ea48a4b398,2,67,11,78,5,2013-08-12 17:36:25,2013-08-10 02:56:10
c173ca412878d537b18df01f39e400ea48a4b398...04cebcc133c8b433a3ac5f72ed19f3631778142b,3,151,51,202,19,2013-08-12 18:04:37,2012-12-27 05:45:11
04cebcc133c8b433a3ac5f72ed19f3631778142b...d4d34aba6efbd98050235f5b264899bb788117df,2,47,8,55,11,2013-08-12 21:09:08,2013-08-12 17:34:01
d4d34aba6efbd98050235f5b264899bb788117df...544d2616b429e5059a1ff117c483102b7495b992,3,0,14,14,3,2013-08-12 21:09:08,2013-08-12 17:56:36
544d2616b429e5059a1ff117c483102b7495b992...72dc48ea4d7e97c9dd3a9f469698ed77bcbdedbe,4,19,6,25,4,2013-08-12 21:09:08,2013-08-12 19:04:03
72dc48ea4d7e97c9dd3a9f469698ed77bcbdedbe...2c64f3dc176843f4b0d31ba026736ce6f6617f59,4,12,7,19,5,2013-08-12 21:09:09,2013-08-12 20:27:46
2c64f3dc176843f4b0d31ba026736ce6f6617f59...ca92b6528af776e6543f14aac7e5cd7e7aa652fc,3,9,5,14,3,2013-08-12 21:09:09,2013-08-12 21:08:22
ca92b6528af776e6543f14aac7e5cd7e7aa652fc...d69cd7d9ca124baea2c116b7db28468f60ad7fea,1,2,2,4,2,2013-08-12 21:43:24,2013-08-12 21:43:16
d69cd7d9ca124baea2c116b7db28468f60ad7fea...1429a71474a3b70a16cba0b82bf23c4f73b63efc,1,1,1,2,1,2013-08-12 23:16:39,2013-08-12 21:53:43
1429a71474a3b70a16cba0b82bf23c4f73b63efc...e3e57fb9cddc4f74ed0d24e436a63e94a4f7f591,1,1,1,2,1,2013-08-13 17:00:14,2013-08-13 00:18:43
e3e57fb9cddc4f74ed0d24e436a63e94a4f7f591...0dd062231a4d495133fd907eeae95c566380c6e1,1,0,54,54,1,2013-08-13 17:48:54,2013-08-13 16:58:29
0dd062231a4d495133fd907eeae95c566380c6e1...f310bcc4d75da14c91eeb7a1580c9a7b566e305c,1,554,0,554,1,2013-08-13 17:49:02,2013-08-13 05:55:08
f310bcc4d75da14c91eeb7a1580c9a7b566e305c...ef3569e772fdb19c86c6fcb81fbceca808a62b51,1,1,1,2,1,2013-08-13 17:59:21,2013-08-13 17:59:21
ef3569e772fdb19c86c6fcb81fbceca808a62b51...e16c9362e7e24dbed2c45cb40bc501754b4c75ff,1,1,1,2,1,2013-08-13 18:50:32,2013-08-13 17:59:58
e16c9362e7e24dbed2c45cb40bc501754b4c75ff...3ad2e44cc3ac1f6f9c018033268875424abdcbac,1,14,12,26,12,2013-08-13 19:55:31,2013-08-13 19:54:19
3ad2e44cc3ac1f6f9c018033268875424abdcbac...f6435044dcf816b9596330b69a0a9568724d6c7c,1,3,3,6,1,2013-08-13 21:16:47,2013-08-13 21:16:47
f6435044dcf816b9596330b69a0a9568724d6c7c...bd03a556c0804c2d40f2fc61b910ca968b27c202,1,0,1,1,1,2013-08-13 21:17:18,2013-08-13 21:17:18
bd03a556c0804c2d40f2fc61b910ca968b27c202...d8c010ac1ee26cc15dc53daa1df54d55937fc87d,1,4,4,8,3,2013-08-13 21:17:37,2013-08-13 21:16:21
d8c010ac1ee26cc15dc53daa1df54d55937fc87d...79a88ecfa692a53ab2d109af537f0f675491902b,1,1,1,2,1,2013-08-13 22:15:50,2013-08-13 22:14:42
79a88ecfa692a53ab2d109af537f0f675491902b...c6ca827150fd98ffba3245e93f1245bdc07887b1,1,12,3,15,2,2013-08-14 06:02:21,2013-08-13 04:29:20
c6ca827150fd98ffba3245e93f1245bdc07887b1...5f3d69a52b5f3accfdc9934887cdd88f08d854ec,1,8,8,16,1,2013-08-14 06:02:21,2013-08-13 04:34:54
5f3d69a52b5f3accfdc9934887cdd88f08d854ec...23a59aebada7656d1a1223cf6ac494cddb98412b,1,1,1,2,1,2013-08-14 06:02:21,2013-08-13 04:50:06
23a59aebada7656d1a1223cf6ac494cddb98412b...c63fbbbcd1147c7e55c3e1d4118bd3a5f6059810,1,3,1,4,1,2013-08-14 06:02:21,2013-08-13 22:14:55
c63fbbbcd1147c7e55c3e1d4118bd3a5f6059810...405f3267b8cdc4f332c6bff82661cbb5401ed733,1,0,16,16,2,2013-08-14 17:24:02,2013-08-14 06:49:02
405f3267b8cdc4f332c6bff82661cbb5401ed733...b73c46c2fd530e6a5c483bbd39031a99f8ab1b39,1,6,1,7,2,2013-08-14 17:24:17,2013-08-13 04:41:20
b73c46c2fd530e6a5c483bbd39031a99f8ab1b39...670ca75c8ab3072af289ad6b136208c6ac2e0aa7,3,32,3,35,4,2013-08-14 17:24:17,2013-08-14 06:58:53
670ca75c8ab3072af289ad6b136208c6ac2e0aa7...90979061e837c21e23350dbaaf3060f54ab8fcec,1,1,0,1,1,2013-08-14 17:24:17,2013-08-14 17:23:10
90979061e837c21e23350dbaaf3060f54ab8fcec...7215afa21c91c33c924a5aba7f3a704983642897,3,7,9,16,8,2013-08-14 19:02:44,2013-08-13 23:57:52
7215afa21c91c33c924a5aba7f3a704983642897...96bbf729ddb246f46e5fde7bb105a28e0cfde54b,2,3,8,11,6,2013-08-14 19:03:48,2013-08-14 19:02:28
96bbf729ddb246f46e5fde7bb105a28e0cfde54b...f757f86b6c6fdc132dbd0000705641e6e46c9dce,1,1,0,1,1,2013-08-14 21:15:57,2013-08-14 18:25:01
f757f86b6c6fdc132dbd0000705641e6e46c9dce...920a3804136d49cdaf7bc2712f5832bc50409dc9,2,55,5,60,7,2013-08-14 21:34:06,2013-08-13 11:55:06
920a3804136d49cdaf7bc2712f5832bc50409dc9...60af2ec9a43a48660ceef3e624556fe3724f9ee5,1,2,2,4,1,2013-08-14 22:45:15,2013-08-14 04:39:31
60af2ec9a43a48660ceef3e624556fe3724f9ee5...5e45fd4ac6ff7c00d34deb099fca12301cafd7b0,1,4,2,6,1,2013-08-14 23:40:36,2013-08-14 21:57:48
5e45fd4ac6ff7c00d34deb099fca12301cafd7b0...680b8174ac7bcb0fa3c6587dff3b03d92d6b156f,1,17,8,25,6,2013-08-15 15:27:41,2013-08-14 21:29:11
680b8174ac7bcb0fa3c6587dff3b03d92d6b156f...380854fd2ce4541aec7970066a0e93ccfb5943cb,1,11,0,11,1,2013-08-15 17:24:27,2013-08-15 16:58:50
380854fd2ce4541aec7970066a0e93ccfb5943cb...dba5e16269c1db9f69e385b5828cab72c8ac53ba,1,12,1,13,1,2013-08-15 17:34:23,2013-08-14 12:18:28
dba5e16269c1db9f69e385b5828cab72c8ac53ba...8a000a586dd22b3d522ae060a4716184006d7d9e,1,8,9,17,6,2013-08-15 17:40:49,2013-08-13 16:49:29
8a000a586dd22b3d522ae060a4716184006d7d9e...031f8a093f3266c9e17750a018ee9b5a5782d836,1,1,1,2,1,2013-08-15 18:49:58,2013-08-13 00:30:26
031f8a093f3266c9e17750a018ee9b5a5782d836...3b6ec782d81e18b257fc84bfb4c4c71d55ffa70c,1,1,1,2,1,2013-08-15 18:50:43,2013-08-15 18:50:43
3b6ec782d81e18b257fc84bfb4c4c71d55ffa70c...02d42fda6dd56c8c1cd4af8c9c848fcc5210a370,1,0,0,0,0,2013-08-15 18:51:37,2013-08-13 23:14:34
02d42fda6dd56c8c1cd4af8c9c848fcc5210a370...fe267e30b95e8f48ddc670b97d485f18fb64d39e,1,3,1,4,1,2013-08-15 19:41:14,2013-08-13 20:17:09
fe267e30b95e8f48ddc670b97d485f18fb64d39e...37123cd2858b4e318ed8109af745312df4848577,24,286,217,503,142,2013-08-15 20:23:18,2013-08-13 22:30:52
37123cd2858b4e318ed8109af745312df4848577...3a65822023119b71deab5e298c7ef2de204caa13,2,25,1,26,3,2013-08-15 22:15:27,2013-08-15 12:14:54
3a65822023119b71deab5e298c7ef2de204caa13...3bc4e7fd20372c0cad8298bff019b32681b16026,2,12,1,13,2,2013-08-15 22:50:34,2013-08-15 00:03:32
3bc4e7fd20372c0cad8298bff019b32681b16026...00f784cda8e128d2ee31a84e71b04941bdd48d79,2,14,2,16,4,2013-08-16 17:59:25,2013-08-16 17:49:37
00f784cda8e128d2ee31a84e71b04941bdd48d79...705404ff8e3187dcc23b1fbafd60a67eaca26c7d,2,7,2,9,3,2013-08-16 18:01:16,2013-08-16 17:53:18
705404ff8e3187dcc23b1fbafd60a67eaca26c7d...35d4993c3dc9f0068b77bb09b7ae2ec979bdeaad,1,7,5,12,1,2013-08-16 18:01:50,2013-08-16 17:56:04
35d4993c3dc9f0068b77bb09b7ae2ec979bdeaad...44b6b72e5e9d193ec878ac7a4f25a00815f68cca,1,8,6,14,2,2013-08-16 18:01:51,2013-08-16 13:21:26
44b6b72e5e9d193ec878ac7a4f25a00815f68cca...f009962256595ff59817eb056d1133e926224dc8,1,0,1,1,1,2013-08-17 01:07:12,2013-08-16 17:47:50
f009962256595ff59817eb056d1133e926224dc8...b43c09c372a2aaf74e7c15bd44095b279a2f4632,1,1,1,2,1,2013-08-17 02:48:04,2013-08-16 12:12:28
b43c09c372a2aaf74e7c15bd44095b279a2f4632...d307242e1011576392df1bd4ede355aade9084b7,1,41,41,82,1,2013-08-17 03:05:54,2013-08-16 10:09:06
d307242e1011576392df1bd4ede355aade9084b7...63e9ea18f8da6bdd9c5f91ca75ae08f662f2228d,1,1,1,2,1,2013-08-19 18:06:45,2013-08-19 18:06:27
63e9ea18f8da6bdd9c5f91ca75ae08f662f2228d...6749fef227a5a633b4858c9a2d6f630078493dbe,2,16,44,60,9,2013-08-19 21:55:19,2013-08-17 15:39:28
6749fef227a5a633b4858c9a2d6f630078493dbe...b7a54497b51061d0f5d9ae74b74f5dd7c8eae51d,1,38,42,80,8,2013-08-19 21:55:19,2013-08-17 15:48:48
b7a54497b51061d0f5d9ae74b74f5dd7c8eae51d...b1a43cd04e8727df5bef3197f5fda3b98ecab740,2,38,0,38,3,2013-08-19 22:51:28,2013-08-19 21:48:40
b1a43cd04e8727df5bef3197f5fda3b98ecab740...ffe1665d026af836e23fc27451392daf1b1e711f,2,3,3,6,3,2013-08-20 18:35:01,2013-08-20 18:35:01
ffe1665d026af836e23fc27451392daf1b1e711f...5c4ffb36deee18743beb149ceae4d63d5b1ae8d9,2,4,3,7,4,2013-08-21 06:26:55,2013-08-20 16:12:31
5c4ffb36deee18743beb149ceae4d63d5b1ae8d9...bf79bd4194eca2118ae1c492c08dbd217f5ae810,2,69,10,79,4,2013-08-21 06:31:38,2013-08-20 23:08:24
bf79bd4194eca2118ae1c492c08dbd217f5ae810...eed299a31b5a6dd0363133c5f9271bf33d090c94,2,24,3,27,5,2013-08-21 06:31:38,2013-08-20 23:31:09
eed299a31b5a6dd0363133c5f9271bf33d090c94...00af067d828e5655712d2a212ef222f0082fa151,1,4,0,4,1,2013-08-21 06:39:24,2013-08-20 14:49:43
00af067d828e5655712d2a212ef222f0082fa151...ad77d67cb7e1bc473899b99251108991f2c76f7f,1,1,1,2,1,2013-08-21 06:43:05,2013-08-20 02:42:26
ad77d67cb7e1bc473899b99251108991f2c76f7f...637c9b1611c5a75a42048ee1c591521c7031751a,2,10,2,12,3,2013-08-21 08:38:39,2013-08-18 18:01:34
637c9b1611c5a75a42048ee1c591521c7031751a...d40884d1b0ce3a393054307a4857689e16016217,1,1,1,2,1,2013-08-21 09:09:19,2013-08-18 13:21:08
d40884d1b0ce3a393054307a4857689e16016217...2c7df1550cb6c60b5b5459797d250402a3358ff3,1,2,2,4,1,2013-08-21 09:15:35,2013-08-20 16:23:42
2c7df1550cb6c60b5b5459797d250402a3358ff3...c61bb52c95013fdb2e4073c7ad8c28ee29bca34f,1,8,15,23,4,2013-08-21 09:17:52,2013-08-21 09:17:52
c61bb52c95013fdb2e4073c7ad8c28ee29bca34f...411c84bf2cb52a0dbac75dcade2f82d7768d163d,1,5,2,7,2,2013-08-21 09:20:56,2013-08-19 23:57:30
411c84bf2cb52a0dbac75dcade2f82d7768d163d...4bd8b81bb005b2fe46c86c81592df8fae57d0351,1,5,3,8,1,2013-08-21 09:26:03,2013-08-12 14:51:55
4bd8b81bb005b2fe46c86c81592df8fae57d0351...834b76b8c360a8bfa1024a7da926e7fea772958f,1,20,20,40,3,2013-08-21 10:51:58,2013-08-21 09:56:21
834b76b8c360a8bfa1024a7da926e7fea772958f...8ee9a3e902e523577f9ea331af56c7bad6b4eea9,1,1,1,2,1,2013-08-21 23:43:03,2013-08-19 19:33:18
8ee9a3e902e523577f9ea331af56c7bad6b4eea9...7d188d630c63fde05d8765d0ad2d75a5baa8e5d3,2,41,9,50,10,2013-08-21 23:58:40,2013-08-21 23:40:20
7d188d630c63fde05d8765d0ad2d75a5baa8e5d3...a3aa41888c2a1fddd1e570dab7f39ac17eb4cd5f,1,2,2,4,1,2013-08-22 16:11:33,2013-08-13 23:38:19
a3aa41888c2a1fddd1e570dab7f39ac17eb4cd5f...ce669edfa14dc7eb7c389d2f82c9c98399a9009b,1,18,0,18,1,2013-08-22 17:32:52,2013-08-11 23:03:17
ce669edfa14dc7eb7c389d2f82c9c98399a9009b...99175f429417318e2087a92dd21bc8d5351c97a3,1,99,0,99,1,2013-08-22 18:06:03,2013-08-22 17:43:27
99175f429417318e2087a92dd21bc8d5351c97a3...57c43dd3762ea665125bff7e4727bce06a225b32,14,117,73,190,38,2013-08-22 23:55:54,2013-08-22 19:32:42
57c43dd3762ea665125bff7e4727bce06a225b32...a671b0423c9ce49e483ec306ff44148e0a37c265,1,5,5,10,3,2013-08-23 00:39:49,2013-08-23 00:39:49
a671b0423c9ce49e483ec306ff44148e0a37c265...699f86c535cbc01589d60ea1dc48114a93cd4f19,2,2,10,12,3,2013-08-23 01:42:21,2013-08-22 23:31:40
699f86c535cbc01589d60ea1dc48114a93cd4f19...74ae3edf8614ea8a97580033db0fd145d5260b62,4,103,157,260,7,2013-08-23 14:37:51,2013-08-15 05:09:06
74ae3edf8614ea8a97580033db0fd145d5260b62...eefcdad013b56d5d3a05c0b2137a5860091b2575,2,34,4,38,5,2013-08-23 18:57:55,2013-08-21 12:54:54
eefcdad013b56d5d3a05c0b2137a5860091b2575...b89a4e49b922894f93d5cc69e00016f157dee625,8,16,85,101,22,2013-08-23 19:43:42,2013-08-20 21:41:27
b89a4e49b922894f93d5cc69e00016f157dee625...040aa11ceb510d8f8ec8349a3ca99d9db874daf0,4,15,1,16,6,2013-08-23 19:43:42,2013-08-21 00:19:29
040aa11ceb510d8f8ec8349a3ca99d9db874daf0...fb3a7db0809b959d50be4cb93a65a91200071dd5,4,74,5,79,5,2013-08-23 21:04:35,2013-08-22 01:29:40
fb3a7db0809b959d50be4cb93a65a91200071dd5...ee2f3d21da6c9fccfe1e6a4ea8a65627519c8bf2,3,364,331,695,163,2013-08-23 21:04:35,2013-08-21 19:03:41
ee2f3d21da6c9fccfe1e6a4ea8a65627519c8bf2...7c605ddf1c57c9f162827713ca5b0fbb12de5fa5,4,92,52,144,20,2013-08-23 21:04:35,2013-08-22 13:30:11
7c605ddf1c57c9f162827713ca5b0fbb12de5fa5...1d06a943857719ef533ca374c05aa5e02089a4d9,5,2,5,7,3,2013-08-23 22:46:11,2013-08-23 22:41:47
1d06a943857719ef533ca374c05aa5e02089a4d9...7909ebedc2a098f041dd2d3835e7297392bfdb7d,5,47,16,63,8,2013-08-23 23:49:10,2013-08-20 21:43:15
7909ebedc2a098f041dd2d3835e7297392bfdb7d...c64a9853074a392ba83a0f790b28b3be96c1144a,1,7,0,7,1,2013-08-23 23:49:10,2013-08-21 07:59:45
c64a9853074a392ba83a0f790b28b3be96c1144a...80d0f98263786ef302ca7551c4515560a7c07195,9,49,25,74,22,2013-08-23 23:49:10,2013-08-21 10:16:57
80d0f98263786ef302ca7551c4515560a7c07195...5d9f42050a11015adbd5dc4dde73818919e93a99,2,25,2,27,4,2013-08-24 19:49:46,2013-08-22 05:57:48
5d9f42050a11015adbd5dc4dde73818919e93a99...e848099d1bc0aacc6e940b1c14bf63eac97a66fb,4,42,4,46,10,2013-08-24 19:49:57,2013-08-21 23:17:07
e848099d1bc0aacc6e940b1c14bf63eac97a66fb...9b94169aaa44721e033b6808f8b9c0bf669cb0d6,1,16,16,32,14,2013-08-25 21:46:54,2013-08-25 21:44:05
9b94169aaa44721e033b6808f8b9c0bf669cb0d6...92700509c8eb0015d864efdc8a46b421a6256d03,2,107,101,208,3,2013-08-25 21:46:54,2013-08-24 21:02:55
92700509c8eb0015d864efdc8a46b421a6256d03...cbf06a5d64aba537f0e2679a194d3998d8365493,3,64,35,99,19,2013-08-25 21:46:54,2013-08-24 21:18:47
cbf06a5d64aba537f0e2679a194d3998d8365493...42af8eada2803a54a98b4f792e60feb480d68a0c,2,22,4,26,7,2013-08-25 21:46:55,2013-08-25 21:36:10
42af8eada2803a54a98b4f792e60feb480d68a0c...6b91aa0a18098100e5f50ea911ee135b50680d67,3,70,6,76,6,2013-08-26 16:06:25,2013-08-22 09:08:41
6b91aa0a18098100e5f50ea911ee135b50680d67...6382e21fb28541a2484ac1a241d41cf9fbbe9d2c,42,0,3364,3364,42,2013-08-27 22:55:37,2013-08-27 22:55:37
6382e21fb28541a2484ac1a241d41cf9fbbe9d2c...52ec83a0ed19ead8b4c944397f99b43ff2b010df,1,1,1,2,1,2013-08-27 22:56:38,2013-08-27 22:56:38
52ec83a0ed19ead8b4c944397f99b43ff2b010df...0f56cfdd13b86c1d98a08a90715850b34bb46fde,1,1,1,2,1,2013-08-27 22:57:01,2013-08-27 22:57:01
0f56cfdd13b86c1d98a08a90715850b34bb46fde...70b44ad32a79e0746e19a74bde35f49c79f89942,2,4,22,26,7,2013-08-28 00:21:11,2013-08-28 00:20:04
70b44ad32a79e0746e19a74bde35f49c79f89942...4114f9c21bec5a396e59954dfc42d2c96527ac3d,3,35,64,99,19,2013-08-28 00:23:36,2013-08-28 00:20:30
4114f9c21bec5a396e59954dfc42d2c96527ac3d...e86de0db56e156d6c603584c440026effaf19b82,1,2,3,5,1,2013-08-28 05:36:23,2013-08-28 05:36:23
e86de0db56e156d6c603584c440026effaf19b82...c7b0d8494d2809f142e4276b541f23a11f93c6f1,1,2,0,2,1,2013-08-28 20:41:12,2013-08-12 20:27:15
c7b0d8494d2809f142e4276b541f23a11f93c6f1...a30a3cf31ccc46024ed4b83a56d79e744c8ac7c4,1,2,2,4,2,2013-08-28 22:00:33,2013-08-27 04:49:27
a30a3cf31ccc46024ed4b83a56d79e744c8ac7c4...df17a2c7495cea22f803d1e2e22329712a7fd25a,1,3,4,7,3,2013-08-28 22:46:19,2013-08-28 18:55:14
df17a2c7495cea22f803d1e2e22329712a7fd25a...03f597328a13aef3c38cf3be451803895fcd72e5,1,1,1,2,1,2013-08-28 22:46:19,2013-08-28 19:08:59
03f597328a13aef3c38cf3be451803895fcd72e5...4138a80611bb7c74d0ac002d7220f99d03a08a59,3,7,5,12,4,2013-08-28 22:46:19,2013-08-28 19:09:13
4138a80611bb7c74d0ac002d7220f99d03a08a59...475eddf678fcf347f90b0addfb743c5954a0dfd0,1,2,1,3,1,2013-08-28 22:46:19,2013-08-28 20:17:10
475eddf678fcf347f90b0addfb743c5954a0dfd0...3379eebe4bca22316327b7f1ca92c2240b29187c,2,4,1,5,2,2013-08-29 00:48:46,2013-08-29 00:48:46
3379eebe4bca22316327b7f1ca92c2240b29187c...d6fdd31fdc70e74a22e357220729869d5611e67f,1,1,1,2,1,2013-08-29 17:40:50,2013-08-29 17:40:50
d6fdd31fdc70e74a22e357220729869d5611e67f...d9dbc6a844f4e3dd85d22563863472934c0652a2,1,0,4,4,1,2013-08-29 18:40:56,2013-08-27 06:19:26
d9dbc6a844f4e3dd85d22563863472934c0652a2...c65fcc003db7530281b69d1b864f183d5b89809f,1,15,5,20,6,2013-08-29 18:50:52,2013-08-26 20:39:50
c65fcc003db7530281b69d1b864f183d5b89809f...baaa73ee1ef25fa506ff7aaab3159d710acdafdb,1,1,1,2,1,2013-08-29 19:06:30,2013-08-29 03:30:32
baaa73ee1ef25fa506ff7aaab3159d710acdafdb...068d8615d245a70bfde9007606b08a54c6e1cfec,1,2,2,4,1,2013-08-29 19:47:51,2013-08-29 19:47:51
068d8615d245a70bfde9007606b08a54c6e1cfec...366c0e084b16c51dc1d1e5a47ac71d2770fdcc40,1,1,1,2,1,2013-08-29 21:04:16,2013-08-24 16:50:13
366c0e084b16c51dc1d1e5a47ac71d2770fdcc40...427ee93f11d0ef64b8844f9b43b2a0f21f2be2cb,5,31,6,37,8,2013-08-29 23:07:49,2013-08-27 00:26:08
59401b80ee36d56f7ede551669633abbc6dd1e24...0df7329a6a15947503f891fdfa933770a70559df,2,17,0,17,2,2010-08-16 23:47:39,2010-08-16 23:47:39
0df7329a6a15947503f891fdfa933770a70559df...d8e86291c4a92395988f50d883200cdab12f726e,1,2,0,2,1,2010-08-17 05:56:12,2010-08-17 05:56:12
34d48489d5fb3afbd10b9993fe80d753e0cf48bd...b6060d88eb9a1f8ffd549aebd482eff0c12c1115,1,1,0,1,1,2010-03-16 17:38:06,2010-03-16 17:38:06
b6060d88eb9a1f8ffd549aebd482eff0c12c1115...5119c8a86fa2b8ce9d0f0c343b57dd96aa88ce8c,2,87,0,87,2,2010-03-16 20:50:47,2010-03-16 20:50:47
9e1f085ba6e224893abc04be181f8748939bfe77...2df072e3f89e8998b06b5a9e5ffb10fa32155136,6,21,20,41,8,2010-03-16 21:38:56,2010-03-16 21:38:56
2df072e3f89e8998b06b5a9e5ffb10fa32155136...c9aba8b442adce496f0600c88764f7ffcc166879,5,12,7,19,7,2010-03-16 21:48:11,2010-03-16 21:48:11
ec12285c9d213a50b86b2ff8d968686acd6d1693...26ed747588d2e7bceddcb4ccd9bacd5f51b9fec8,2,8,3,11,3,2010-08-04 18:47:10,2010-08-04 18:47:10
26ed747588d2e7bceddcb4ccd9bacd5f51b9fec8...6d0eeda1e231d0fbe515ce4cea8bf6245e1b72d3,2,30,1,31,2,2010-08-04 19:36:53,2010-08-04 19:36:53
6d0eeda1e231d0fbe515ce4cea8bf6245e1b72d3...643b43ffe5bd481b129484828fb35e2ab71a7d4c,2,6,8,14,6,2010-08-05 22:44:54,2010-08-05 22:44:54
643b43ffe5bd481b129484828fb35e2ab71a7d4c...989cffb43502744ab05baa741420c2082f137d69,1,4,4,8,4,2010-08-05 23:03:47,2010-08-05 23:03:47
989cffb43502744ab05baa741420c2082f137d69...de8d0984c85ae3078fd72a9c7f010b0fd4397150,2,50,5,55,4,2010-08-07 00:28:47,2010-08-07 00:28:47
de8d0984c85ae3078fd72a9c7f010b0fd4397150...21d2b43e6c81b7b6b55599f0274495d25411b4f0,2,56,2,58,4,2010-08-10 00:55:01,2010-08-10 00:55:01
21d2b43e6c81b7b6b55599f0274495d25411b4f0...86c2ef87d5069f0836079e171c0f33efcf2b5d24,5,29,25,54,20,2010-08-10 17:48:31,2010-08-10 17:48:31
427ee93f11d0ef64b8844f9b43b2a0f21f2be2cb...d73d2abe85b8b6f88584b1915a321aa95b805bc8,1,2,2,4,2,2013-08-31 00:53:01,2013-08-30 20:33:13
427ee93f11d0ef64b8844f9b43b2a0f21f2be2cb...d81d2b41abc5484fcaeb1c61289ad1796e6f0898,1,43,0,43,1,2013-08-30 21:20:30,2013-08-30 21:20:30
f1b50b92ac69f5c58984f5e88015507552d29df2...7634a3ed5227f8bc2a2ba83752d0e2c78adb6051,6,224,27,251,32,2010-03-18 19:20:06,2010-03-18 19:20:06
7634a3ed5227f8bc2a2ba83752d0e2c78adb6051...df607da0d1b9726bce6584238fe3ad7e9b65a966,4,82,36,118,23,2010-03-18 21:43:49,2010-03-18 21:43:49
df607da0d1b9726bce6584238fe3ad7e9b65a966...509b0320899c019a60b8f397a0f1d3a8ea7dd032,1,36,10,46,10,2010-03-18 22:50:14,2010-03-18 22:50:14
509b0320899c019a60b8f397a0f1d3a8ea7dd032...79f868cbca4a14030447e321ba59348cf1eb8a02,1,0,123,123,1,2010-03-18 23:20:02,2010-03-18 23:20:02
79f868cbca4a14030447e321ba59348cf1eb8a02...be3c7a66709952ffd21e4e59268ba6370e09d7ed,1,20,10,30,7,2010-03-19 00:12:38,2010-03-19 00:12:38
be3c7a66709952ffd21e4e59268ba6370e09d7ed...c3eac13aa7106d099e8f09c39518051ccf939060,2,194,8,202,6,2010-03-19 23:41:22,2010-03-19 23:41:02
d4ba33d075fea5e86963a9ff4982e433fc8c7968...6f8276a8e3735396999bd158005ca86bb1bb0978,3,27,11,38,4,2010-03-22 23:07:42,2010-03-22 23:07:42
6f8276a8e3735396999bd158005ca86bb1bb0978...7c87c17d08dbba318af1a149c0bbedb696b03458,8,179,10544,10723,10,2010-03-23 01:20:49,2010-03-23 01:20:49
7c87c17d08dbba318af1a149c0bbedb696b03458...a8227086748e37c31c1bb71dec50c96d63c45eef,4,111,11,122,12,2010-03-23 03:20:05,2010-03-23 03:20:05
a8227086748e37c31c1bb71dec50c96d63c45eef...6ff550cfa9524bbb124d10caf1fc13c911ab3b4b,5,121,45,166,30,2010-03-23 04:29:57,2010-03-23 04:29:57
6ff550cfa9524bbb124d10caf1fc13c911ab3b4b...bb98ae14f2aef74efbd8345e93f62ac67f460f7f,11,503,289,792,64,2010-03-23 21:57:11,2010-03-23 21:57:11
bb98ae14f2aef74efbd8345e93f62ac67f460f7f...1b976dc27d022c681d764d51a70a1af6a7e35dd6,4,48,14,62,11,2010-03-23 22:18:32,2010-03-23 22:16:44
1b976dc27d022c681d764d51a70a1af6a7e35dd6...fd72031e9626b574a4459747c2e0261f69102364,1,3,3,6,3,2010-03-24 19:08:09,2010-03-24 19:08:09
49ffab3318e3ac8cebe34d4d55a04c9fe12d62c3...412f05977c41fbda46278b637c4d1a84996d48d1,5,97,376,473,17,2010-08-11 18:21:03,2010-08-11 18:17:55
49ffab3318e3ac8cebe34d4d55a04c9fe12d62c3...27784b6dec5ab81213288947c9741561d53ac2e2,2,67,35,102,11,2010-08-11 17:09:04,2010-08-11 02:10:43
27784b6dec5ab81213288947c9741561d53ac2e2...04e92a875344fb675f27355a8bae7a22d0a6ae63,2,25,23,48,5,2010-08-11 17:57:36,2010-08-11 17:54:11
86c2ef87d5069f0836079e171c0f33efcf2b5d24...c4c96c5c69846fb8eccc278c1eb20f94d69a2b99,2,7,7,14,6,2010-08-10 20:42:50,2010-08-10 20:42:50
44ad61e56c04f445d059048838d8de3adbc63090...8e48c4ff6abf7083a04cf20312d2b106f4ba5b2c,2,16,2,18,3,2013-09-02 09:47:51,2013-08-30 01:52:30
8e48c4ff6abf7083a04cf20312d2b106f4ba5b2c...f737c97df02918eb5b19bf5c8248fa3e20f9b361,2,49,3,52,4,2013-09-03 21:22:12,2013-08-26 05:45:58
f737c97df02918eb5b19bf5c8248fa3e20f9b361...d11a34a35127ee2b29a000ba48ec07200f2a5e34,1,0,1,1,1,2013-09-04 00:06:49,2013-08-29 22:01:02
d11a34a35127ee2b29a000ba48ec07200f2a5e34...4382df03fa1962aed027742c1b463406c40653c9,5,38,169,207,123,2013-09-04 00:06:49,2013-08-28 23:18:33
4382df03fa1962aed027742c1b463406c40653c9...4e15c4fb47e93c1f6619a09125bc9a350e39b113,2,90,0,90,8,2013-09-04 00:06:49,2013-08-14 00:51:03
4e15c4fb47e93c1f6619a09125bc9a350e39b113...36ad40b18cfdd0690411a5169aa94e222946b5cf,4,147,37,184,37,2013-09-04 00:06:49,2013-08-28 23:32:20
36ad40b18cfdd0690411a5169aa94e222946b5cf...40c0220c47c620070b30aec6ec4552c68a8689eb,2,41,0,41,2,2013-09-04 00:06:49,2013-08-30 13:39:08
40c0220c47c620070b30aec6ec4552c68a8689eb...9a7adb545543fe725bb13919ab15c9ddeb3e5d9d,2,95,2,97,3,2013-09-04 12:50:33,2013-09-04 11:46:37
9a7adb545543fe725bb13919ab15c9ddeb3e5d9d...7b203fcff6dd01da0bebb43130a0e861c05c4e9c,1,8,4,12,2,2013-09-04 12:50:39,2013-09-04 12:28:14
7b203fcff6dd01da0bebb43130a0e861c05c4e9c...c0ad2efb24e4fffff6cb503ca821fe7e0bd4618b,1,1,1,2,1,2013-09-04 12:50:39,2013-09-04 12:28:37
c0ad2efb24e4fffff6cb503ca821fe7e0bd4618b...80ea36256f8ffc6ad59ea5964c919c36327a909d,1,1,1,2,1,2013-09-04 20:56:11,2013-09-04 20:56:11
80ea36256f8ffc6ad59ea5964c919c36327a909d...4ed47c4b12de6c0f17edd3fafe0f19a6f0afff66,1,1,1,2,1,2013-09-04 23:00:17,2013-09-04 23:00:17
4ed47c4b12de6c0f17edd3fafe0f19a6f0afff66...b6312af19f10c72039901fcf930883ad6808161e,1,3,3,6,2,2013-09-04 23:02:20,2013-09-04 23:02:20
b6312af19f10c72039901fcf930883ad6808161e...81b0b6ea7b297ea649a781d2fc0eb2ea20c692c7,1,3,3,6,1,2013-09-04 23:06:30,2013-09-04 23:06:30
81b0b6ea7b297ea649a781d2fc0eb2ea20c692c7...cf0e6f360962abe62f1f49b0226b234e54adcff1,2,166,1,167,2,2013-09-04 23:15:36,2013-08-10 00:26:07
cf0e6f360962abe62f1f49b0226b234e54adcff1...9d6d3969f17f0c21f43e24d12dc8aa85a53cc9da,1,6,0,6,1,2013-09-04 23:31:34,2013-09-04 23:31:34
9d6d3969f17f0c21f43e24d12dc8aa85a53cc9da...7ed5599a4bc2f380f8252a760119cb7e7115b414,1,29,1,30,2,2013-09-05 07:32:52,2013-09-05 07:31:58
7ed5599a4bc2f380f8252a760119cb7e7115b414...21b1d22563d044eb10681d6d0ba180d197e76303,1,1,1,2,1,2013-09-05 09:01:50,2013-09-05 09:01:50
21b1d22563d044eb10681d6d0ba180d197e76303...d72fc304e093165a73a3ae5dd37bc0b289aa1c63,1,4,4,8,2,2013-09-05 09:03:46,2013-08-24 01:50:08
d72fc304e093165a73a3ae5dd37bc0b289aa1c63...327a78604a2a3eed5af7477266e226a458417590,1,3,1,4,1,2013-09-05 11:18:56,2013-09-05 11:18:56
327a78604a2a3eed5af7477266e226a458417590...62ea5c3a9149a066364692b653f0560c70e00074,1,9,1,10,2,2013-09-05 12:04:49,2013-09-05 12:03:45
62ea5c3a9149a066364692b653f0560c70e00074...ae70ec7946a75fc1760158f954b27fb59342d568,1,10,5,15,5,2013-09-05 12:16:40,2013-09-05 12:16:16
ae70ec7946a75fc1760158f954b27fb59342d568...c66ec5413cc3335aa31123595fab6e9a34cf20b7,1,6,3,9,2,2013-09-05 12:58:21,2013-09-05 12:58:21
c66ec5413cc3335aa31123595fab6e9a34cf20b7...2dd99c3f115906b8f2331b1f5d871a854004d1c1,1,1,1,2,1,2013-09-05 13:08:33,2013-08-22 21:47:06
2dd99c3f115906b8f2331b1f5d871a854004d1c1...42a5f1e99a3771e20a2f1a2d5e3f7ecfc00c3167,1,1,1,2,1,2013-09-05 13:11:21,2013-08-22 21:42:27
42a5f1e99a3771e20a2f1a2d5e3f7ecfc00c3167...e12e584ca8db306dce8e0f4d3a212d77fbae966c,1,34,2,36,3,2013-09-05 13:34:40,2013-08-16 10:04:55
e12e584ca8db306dce8e0f4d3a212d77fbae966c...32ad2926116e5f52ed04d788220bd389f8d0a4ac,2,80,68,148,62,2013-09-05 21:20:28,2013-09-03 17:29:37
32ad2926116e5f52ed04d788220bd389f8d0a4ac...28f56a383e9d1ff378e3568a3039e941c7ffb1d8,4,471,99,570,59,2013-09-06 21:00:37,2013-09-06 20:06:37
28f56a383e9d1ff378e3568a3039e941c7ffb1d8...d50ed6bfb8c4982401923ff535fe932ef4f387a2,2,40,40,80,36,2013-09-06 21:19:53,2013-09-06 20:09:18
d50ed6bfb8c4982401923ff535fe932ef4f387a2...4def730de706170995cfb9f62da6397b7cc18285,1,14,4,18,2,2013-09-07 06:30:57,2013-09-07 06:19:25
4def730de706170995cfb9f62da6397b7cc18285...01a7ec086604aba82d1c59727cd25a4a8fe172c4,1,1,1,2,1,2013-09-09 07:44:12,2013-09-09 07:44:12
01a7ec086604aba82d1c59727cd25a4a8fe172c4...79dc95cca6f79551d9d95617d2325aa43df3d6f2,1,1,0,1,1,2013-09-09 11:26:22,2013-09-09 09:00:19
79dc95cca6f79551d9d95617d2325aa43df3d6f2...e4415d21d37dfdba4f93a63735413caf05ee5862,1,2,2,4,2,2013-09-09 16:31:36,2013-09-09 00:13:16
e4415d21d37dfdba4f93a63735413caf05ee5862...ce351e69b15c3f55287a976e027e0e75b94aa89f,1,2,1,3,1,2013-09-10 21:03:08,2013-09-10 11:37:51
ce351e69b15c3f55287a976e027e0e75b94aa89f...d63a50c3c306377b3b1afd3e36ff821b6e23bfeb,1,2,2,4,1,2013-09-10 21:06:04,2013-09-10 07:57:45
d63a50c3c306377b3b1afd3e36ff821b6e23bfeb...26685782b36b7d7c5eed88df76ddd39405202b43,1,11,2,13,3,2013-09-11 11:11:38,2013-09-11 01:13:15
26685782b36b7d7c5eed88df76ddd39405202b43...15674406654733f24af63c65c60ce13be64fe0db,1,1,1,2,1,2013-09-11 12:28:17,2013-09-08 18:20:03
15674406654733f24af63c65c60ce13be64fe0db...d8987c170f98650baecae66ccc272bdbca352f64,8,10,1,11,11,2013-09-11 12:28:17,2013-09-08 21:22:54
d8987c170f98650baecae66ccc272bdbca352f64...573d41b73cf67b59b2c9f84ace7f9491793fa179,1,2,1,3,2,2013-09-11 12:28:17,2013-09-08 21:24:13
573d41b73cf67b59b2c9f84ace7f9491793fa179...c0db11c607dc770f5c7e4dc6e20b44570271c7b0,1,2,2,4,2,2013-09-11 12:28:17,2013-09-08 21:25:36
c0db11c607dc770f5c7e4dc6e20b44570271c7b0...f86395aadfec515899dbc49b77c2e7da61271d36,1,27,28,55,21,2013-09-11 12:56:56,2013-09-07 19:29:49
f86395aadfec515899dbc49b77c2e7da61271d36...c0886be148be0fda0cb39eab410c7f3ef9a150b1,1,0,16,16,7,2013-09-11 19:37:34,2013-09-11 19:16:17
c0886be148be0fda0cb39eab410c7f3ef9a150b1...4a0f0522429b1ad8ba6a356ccbed1b917d60e0d9,1,4,0,4,1,2013-09-11 19:41:47,2013-09-11 17:51:20
4a0f0522429b1ad8ba6a356ccbed1b917d60e0d9...bf512bb8ee696f7644879cf0ba33e01cbf9e2153,1,1,1,2,1,2013-09-11 19:45:24,2013-09-11 17:11:10
bf512bb8ee696f7644879cf0ba33e01cbf9e2153...21e9e8cf68ef007136da6cc212d2f1f252fb668a,2,36,3,39,5,2013-09-11 20:40:09,2013-08-17 23:09:28
21e9e8cf68ef007136da6cc212d2f1f252fb668a...64e7b7774e3d0cb2e36efe00d550c7e53ec7efa5,1,1,1,2,1,2013-09-11 21:19:24,2013-09-04 15:01:43
64e7b7774e3d0cb2e36efe00d550c7e53ec7efa5...f115751d541596e78f1c2e755ea7e1ad7e1a1f8a,1,2,2,4,2,2013-09-13 11:34:01,2013-09-12 05:54:04
f115751d541596e78f1c2e755ea7e1ad7e1a1f8a...aa3c54c73f7470999535294899a1c33cd193f455,2,27,2,29,3,2013-09-13 11:48:19,2013-09-13 11:41:51
aa3c54c73f7470999535294899a1c33cd193f455...b15686cb79c3ccfe44faf2581d8dd787dd8e8961,1,4,0,4,1,2013-09-13 12:41:32,2013-09-13 10:36:27
b15686cb79c3ccfe44faf2581d8dd787dd8e8961...2bb0e1a6041a079b4c456eb6bae4ec5a206582eb,1,26,3,29,1,2013-09-13 13:17:47,2013-09-13 13:17:47
2bb0e1a6041a079b4c456eb6bae4ec5a206582eb...a53d197db3a69b60d946525f3508b32276e215dc,1,8,7,15,3,2013-09-13 13:23:32,2013-09-13 12:38:59
a53d197db3a69b60d946525f3508b32276e215dc...1b5217b1d6618d95b104dbfb402bd734cf9a68c4,1,5,1,6,2,2013-09-13 20:37:14,2013-09-13 18:53:25
1b5217b1d6618d95b104dbfb402bd734cf9a68c4...da3dc5c5fe4d7ea3c174f0df98f2aaa282eefef2,1,1,1,2,1,2013-09-13 20:56:53,2013-09-13 03:19:01
da3dc5c5fe4d7ea3c174f0df98f2aaa282eefef2...3b5fd53e2db3dafedd0f0e65ab272379aff81139,1,1,0,1,1,2013-09-14 20:34:16,2013-09-12 17:02:59
3b5fd53e2db3dafedd0f0e65ab272379aff81139...83f93889e1f5e957c20946e4060f4f6e3199ae0e,1,1,1,2,1,2013-09-14 20:35:57,2013-09-12 16:55:06
83f93889e1f5e957c20946e4060f4f6e3199ae0e...3328d33ed0b9a99649b682aad3c7b234d4f1d8ca,1,1,1,2,1,2013-09-14 20:48:11,2013-09-03 05:26:57
3328d33ed0b9a99649b682aad3c7b234d4f1d8ca...d241438d49c860e97ff34ce2c08f750462132fc2,1,15,0,15,1,2013-09-15 20:51:50,2013-09-15 20:51:50
d241438d49c860e97ff34ce2c08f750462132fc2...bd478db770f36597b7bea8382c5b5f2d5a001ac8,1,2,2,4,1,2013-09-16 15:24:25,2013-09-16 04:05:19
bd478db770f36597b7bea8382c5b5f2d5a001ac8...d206f3d2ad95179c9944792789fb9052977dbf08,1,3,3,6,2,2013-09-16 15:36:05,2013-09-16 04:15:09
d206f3d2ad95179c9944792789fb9052977dbf08...62e6b4eeb6c4434a25f4c7a4cc2883232d502820,1,1,1,2,1,2013-09-16 21:29:12,2013-09-01 23:08:14
62e6b4eeb6c4434a25f4c7a4cc2883232d502820...777ba71ffe1319ed76d14431c938baa9ebfb4a92,1,1,1,2,1,2013-09-16 21:31:59,2013-09-01 20:40:15
777ba71ffe1319ed76d14431c938baa9ebfb4a92...4aa9d2aa1eabcf716e0c9b701b230a9f63b7d424,1,3,0,3,1,2013-09-17 10:43:53,2013-09-02 16:57:13
4aa9d2aa1eabcf716e0c9b701b230a9f63b7d424...265f0b52253ffe63715e69b5ba0b0092a8b1fb0f,1,2,1,3,2,2013-09-17 12:38:52,2013-09-17 12:38:52
265f0b52253ffe63715e69b5ba0b0092a8b1fb0f...4b71bbc9886f6cf8e939d257c755bf7c4a94396e,1,10,5,15,4,2013-09-17 23:13:25,2013-09-17 23:09:29
4b71bbc9886f6cf8e939d257c755bf7c4a94396e...be0b4856699334ff51bacf2d1fd3394663d6bd28,4,181,93,274,9,2013-09-18 01:15:49,2013-08-09 21:47:13
be0b4856699334ff51bacf2d1fd3394663d6bd28...3589f17824376e9db4e8d002caeb4483943eeb18,1,4,6,10,3,2013-09-18 11:16:42,2013-09-18 11:14:56
3589f17824376e9db4e8d002caeb4483943eeb18...47dff0f3db1ddbdec5408dad8f9f007b3f027239,1,3,0,3,1,2013-09-18 11:43:58,2013-09-17 23:42:34
47dff0f3db1ddbdec5408dad8f9f007b3f027239...bda87f606f41acbccb5f55fc4095c7d44337a713,1,8,0,8,1,2013-09-18 13:34:04,2013-08-13 07:08:09
bda87f606f41acbccb5f55fc4095c7d44337a713...2dcbec6c06f42de516769b77e385e61796673355,1,1,1,2,1,2013-09-18 13:37:36,2013-08-29 23:26:06
2dcbec6c06f42de516769b77e385e61796673355...2fb36cbd50acfa580454fd520c966c1e231d8c49,1,1,1,2,1,2013-09-18 13:40:22,2013-09-01 20:11:27
2fb36cbd50acfa580454fd520c966c1e231d8c49...04c9cae5d9c69ebc488e5079b614f0cca1fd09f1,1,2,1,3,2,2013-09-18 15:11:40,2013-09-18 15:11:40
04c9cae5d9c69ebc488e5079b614f0cca1fd09f1...a1c4f6fbb70d8cbc99d23928a03e554807e9ee22,1,14,9,23,5,2013-09-19 09:28:34,2013-09-19 00:06:29
a1c4f6fbb70d8cbc99d23928a03e554807e9ee22...80ab7eaf150294558405ee124c4aa9c384578b2a,1,4,4,8,4,2013-09-19 10:06:59,2013-09-19 08:09:30
80ab7eaf150294558405ee124c4aa9c384578b2a...910788ed9c5d3132f68e04dadee4b59b3a3a550a,1,8,1,9,2,2013-09-19 11:17:28,2013-09-19 10:38:31
910788ed9c5d3132f68e04dadee4b59b3a3a550a...3b8b0eb1fb17114eed67b4543b18149b6efe6fec,1,38,21,59,7,2013-09-19 11:48:06,2013-09-19 11:48:06
3b8b0eb1fb17114eed67b4543b18149b6efe6fec...c20b569dbed686f743a092e286796266814f54c1,1,3,0,3,1,2013-09-19 13:11:37,2013-09-19 13:11:37
c20b569dbed686f743a092e286796266814f54c1...666705c0a4d128fdaa0a53929c194232a4e34087,1,15,1,16,2,2013-09-19 13:51:38,2013-08-30 16:47:55
666705c0a4d128fdaa0a53929c194232a4e34087...2468974a53e9a5c05081a89d6ec127a9e7623198,1,1,1,2,1,2013-09-19 19:17:26,2013-09-19 16:23:27
2468974a53e9a5c05081a89d6ec127a9e7623198...72ad746b85e3dcfefd794d7dc376e7ade798ff49,1,5,5,10,2,2013-09-19 19:27:59,2013-09-19 14:01:33
72ad746b85e3dcfefd794d7dc376e7ade798ff49...f12c61e984e2fa7f6b225f3567d497f4ad36436d,1,34,4,38,3,2013-09-19 20:08:37,2013-09-19 20:08:37
f12c61e984e2fa7f6b225f3567d497f4ad36436d...602e226d36e04ccd1fa69e2cb5e3f23a48a2cf40,1,11,10,21,5,2013-09-20 19:45:19,2013-09-20 18:55:38
602e226d36e04ccd1fa69e2cb5e3f23a48a2cf40...88317a2888b742894c7942896dc038159f8e1afb,1,6,6,12,4,2013-09-20 19:47:13,2013-09-20 05:20:51
88317a2888b742894c7942896dc038159f8e1afb...255e8c13cf0fd78f1c4d7c279be7bf47c2402956,2,7,4,11,4,2013-09-20 20:55:16,2013-09-20 17:50:10
255e8c13cf0fd78f1c4d7c279be7bf47c2402956...5eb1fb6cb2c5a1c036e50ea791fd74ddf9016be0,2,27,0,27,2,2013-09-20 21:11:12,2013-09-20 18:04:37
5eb1fb6cb2c5a1c036e50ea791fd74ddf9016be0...3ed094d14259f6bb1eb8c7614e988b770c002613,1,0,6,6,1,2013-09-20 22:41:57,2013-09-20 22:41:57
3ed094d14259f6bb1eb8c7614e988b770c002613...e2068ad426075ac34c06c12e2fac5f594cc81969,2,19,3,22,3,2013-09-20 23:30:20,2013-09-20 23:30:20
e2068ad426075ac34c06c12e2fac5f594cc81969...e2751292dac5f7f4813bd2a3f0e8bbe3dcf4d6d9,1,21,3,24,2,2013-09-21 06:55:23,2013-09-21 01:03:29
e2751292dac5f7f4813bd2a3f0e8bbe3dcf4d6d9...6c59e770084912d2345e7f83f983092a2d305ae3,1,1,1,2,1,2013-09-23 10:16:16,2013-09-21 08:38:09
6c59e770084912d2345e7f83f983092a2d305ae3...f8f8f754b02459bb789247476cc0da63d2d7370f,1,5,4,9,3,2013-09-25 08:46:32,2013-09-25 08:46:32
f8f8f754b02459bb789247476cc0da63d2d7370f...31c56f540045b5270f5b8e235873da855caf3486,2,26,6,32,7,2013-09-25 16:42:01,2013-09-24 20:51:28
31c56f540045b5270f5b8e235873da855caf3486...50194147ac1fdd4f83476ae4012d1f57ed457d9e,1,13,13,26,4,2013-09-25 21:16:11,2013-09-22 00:22:22
50194147ac1fdd4f83476ae4012d1f57ed457d9e...8c0d5b6e80950f6c05e6c101e9cc905ca5b3226f,1,1,1,2,1,2013-09-25 21:17:25,2013-09-22 09:28:16
8c0d5b6e80950f6c05e6c101e9cc905ca5b3226f...01fdf683cf089931d2ccb223eb374d0c52b3d235,1,1,1,2,1,2013-09-25 21:23:16,2013-09-22 12:34:01
01fdf683cf089931d2ccb223eb374d0c52b3d235...94c8378f1800951726dd9468915e5dd0d13445ce,1,4,4,8,1,2013-09-25 21:26:13,2013-09-22 15:35:17
94c8378f1800951726dd9468915e5dd0d13445ce...ba279f9464cd74466702a51d881d1d53e7fb35b7,1,2,0,2,1,2013-09-25 21:30:03,2013-09-22 15:56:25
ba279f9464cd74466702a51d881d1d53e7fb35b7...eb5b422842fa09f58aa1c3eab020415cf93042f0,1,1,1,2,1,2013-09-25 21:31:04,2013-09-22 16:23:59
eb5b422842fa09f58aa1c3eab020415cf93042f0...12ae60052f2850d8e325d1090e3b06c6620cdd36,1,9,6,15,3,2013-09-25 21:33:07,2013-09-22 20:03:05
12ae60052f2850d8e325d1090e3b06c6620cdd36...4beb98131a424781af807b903bab98ade5fae127,1,2,2,4,2,2013-09-25 21:34:10,2013-09-23 09:53:05
4beb98131a424781af807b903bab98ade5fae127...418d7a36ff1969a4155813863c4d2363ff2f651f,1,1,0,1,1,2013-09-25 21:39:28,2013-09-23 10:17:16
418d7a36ff1969a4155813863c4d2363ff2f651f...e0c134b8bfa282379daec6a7137512d58f956443,2,18,4,22,4,2013-09-26 00:25:00,2013-09-25 19:30:51
e0c134b8bfa282379daec6a7137512d58f956443...3b3e89d5d6e7878bd8163631536e761f84255015,1,1,1,2,1,2013-09-26 11:52:43,2013-09-26 11:52:43
3b3e89d5d6e7878bd8163631536e761f84255015...acc2fb84869ac1097434485d56bdc0265120fe34,1,7,2,9,3,2013-09-26 18:19:43,2013-09-25 04:20:18
acc2fb84869ac1097434485d56bdc0265120fe34...0a63adce687d28ada90ea930d5e69883cc11cba5,2,95,45,140,41,2013-09-26 18:19:43,2013-09-25 04:20:25
0a63adce687d28ada90ea930d5e69883cc11cba5...147c6929a264a7b077a5f2cfc5aa9a0b9513acd7,1,46,1,47,2,2013-09-26 21:09:34,2013-09-26 18:29:40
147c6929a264a7b077a5f2cfc5aa9a0b9513acd7...eea76a0ebe247685fef3b2111b941c8ddfff766c,1,5,2,7,1,2013-09-26 21:13:02,2013-09-26 20:59:37
eea76a0ebe247685fef3b2111b941c8ddfff766c...6cadabf910d86d72888b00db84989ba6d756ec88,1,4,0,4,1,2013-09-26 21:13:02,2013-09-26 21:12:07
6cadabf910d86d72888b00db84989ba6d756ec88...6a8edc1d43aca7c5a92f86309b1bb1d5f9968442,2,39,3,42,5,2013-09-26 22:01:35,2013-09-25 22:35:50
6a8edc1d43aca7c5a92f86309b1bb1d5f9968442...6aaae062171bfc8e5046c3eae99bc9d63037120a,2,90,3,93,5,2013-09-27 18:50:21,2013-08-22 20:56:42
6aaae062171bfc8e5046c3eae99bc9d63037120a...c785267eb8780d8b7658ef93ebb5ebddd566294d,5,52,9,61,11,2013-09-27 19:38:27,2013-09-24 00:29:51
c785267eb8780d8b7658ef93ebb5ebddd566294d...7c38b292f8ad7057b62f7ee4a2c651d0213d5e5f,1,0,1,1,1,2013-09-27 19:51:45,2013-09-27 19:51:45
7c38b292f8ad7057b62f7ee4a2c651d0213d5e5f...2361572012ef8689004935da4cecd45337378d3b,1,3,3,6,1,2013-09-27 20:01:35,2013-09-21 16:27:03
2361572012ef8689004935da4cecd45337378d3b...b891c708cf1a19dc0744649547d6499f9d217e01,1,2,2,4,2,2013-09-27 20:04:42,2013-09-20 22:54:14
b891c708cf1a19dc0744649547d6499f9d217e01...15fa29fb4b5c53dd679602d8bdc392e4874d8917,1,3,3,6,2,2013-09-27 20:13:34,2013-09-20 22:12:30
15fa29fb4b5c53dd679602d8bdc392e4874d8917...4998d3ee79195eab779482e0a51fee9f5f90b216,1,3,3,6,2,2013-09-27 20:20:40,2013-09-20 21:08:19
4998d3ee79195eab779482e0a51fee9f5f90b216...f2160a4c647a543802f4ac7e5470e6a9e0b74235,1,3,3,6,2,2013-09-27 22:12:39,2013-09-27 22:12:19
f2160a4c647a543802f4ac7e5470e6a9e0b74235...45028e58041567d654528884673905dfc484fb3b,1,1,1,2,1,2013-09-27 22:43:46,2013-09-24 01:17:35
45028e58041567d654528884673905dfc484fb3b...e5eeb2e825873977fe3a850f16a658b3783300a2,1,12,12,24,6,2013-09-27 22:49:05,2013-09-25 23:13:16
e5eeb2e825873977fe3a850f16a658b3783300a2...5bb9ba2c54b341aa9d6a26934831f5b72f24ddac,3,11,7,18,4,2013-09-27 23:10:43,2013-09-24 01:45:48
5bb9ba2c54b341aa9d6a26934831f5b72f24ddac...21527db747ed24ba352b04aa6386550fae3c5fab,1,2,2,4,2,2013-09-27 23:23:08,2013-08-01 10:38:45
21527db747ed24ba352b04aa6386550fae3c5fab...4ff1a65031e985bf930f6761c1ecf46e4db98d6e,2,42,20,62,8,2013-09-27 23:44:21,2013-09-21 00:33:16
4ff1a65031e985bf930f6761c1ecf46e4db98d6e...4f845437a85aa8ab417aff8212feac216955cc93,1,1,1,2,1,2013-09-28 14:04:57,2013-09-28 13:16:36
4f845437a85aa8ab417aff8212feac216955cc93...e2efa230153a416953eebff4b63d86fcbb28d063,1,88,0,88,1,2013-09-28 14:24:35,2013-09-27 15:28:41
e2efa230153a416953eebff4b63d86fcbb28d063...1618adfab1bfc3478786798fa55e8a767f52043f,1,1,1,2,1,2013-09-28 19:23:18,2013-09-27 19:37:40
1618adfab1bfc3478786798fa55e8a767f52043f...448bd14445e7f8a8aabaa555d43bbf7dff50d58d,1,9,3,12,4,2013-09-30 16:05:33,2013-09-10 16:06:18
448bd14445e7f8a8aabaa555d43bbf7dff50d58d...2df3c9f58def9584455f7c4bfdabbd12aab58bf9,2,38,4,42,3,2013-09-30 17:59:28,2013-09-26 18:29:18
2df3c9f58def9584455f7c4bfdabbd12aab58bf9...8727fce31290de3067639f7ac4f16cfb2141ae18,1,4,0,4,1,2013-09-30 18:34:49,2013-09-30 18:34:49
8727fce31290de3067639f7ac4f16cfb2141ae18...2ebf93163027abc55ba27f673be3b8dc1281c068,1,3,0,3,1,2013-09-30 20:02:40,2013-09-30 19:00:50
2ebf93163027abc55ba27f673be3b8dc1281c068...d79822e73ae7f4612c45be2c1d8c9968fdbccf43,1,1,1,2,1,2013-09-30 20:28:19,2013-09-25 12:39:40
d79822e73ae7f4612c45be2c1d8c9968fdbccf43...0868a076e066334403cab92216cbc4cbac26c45e,1,5,4,9,3,2013-09-30 20:44:35,2013-09-28 03:53:36
0868a076e066334403cab92216cbc4cbac26c45e...06a611c4b4cd58f8270f2cd3320f6499ac28629c,1,2,2,4,1,2013-09-30 21:04:59,2013-09-06 18:16:00
06a611c4b4cd58f8270f2cd3320f6499ac28629c...fc05f5e701f77012d54f87facb5a83d56996c7f1,1,36,0,36,1,2013-09-30 21:15:57,2013-09-27 13:07:54
fc05f5e701f77012d54f87facb5a83d56996c7f1...106ee8f85006f25858470a84b89146f54fa02b15,1,5,2,7,1,2013-09-30 21:51:01,2013-09-26 11:23:49
106ee8f85006f25858470a84b89146f54fa02b15...df9426dbc6b3bf9268f136e3a61e8291775c24a8,1,4,4,8,4,2013-09-30 21:52:20,2013-09-24 17:43:25
df9426dbc6b3bf9268f136e3a61e8291775c24a8...742271ffa3a518d9e8ef2cb97c24b45b44e3378d,2,74,32,106,22,2013-09-30 22:30:29,2013-09-08 17:05:25
742271ffa3a518d9e8ef2cb97c24b45b44e3378d...5a1a6b86a8dbcd8aa4fe9c59fad8d005eead686c,3,37,1,38,3,2013-09-30 23:44:19,2013-09-25 23:37:59
5a1a6b86a8dbcd8aa4fe9c59fad8d005eead686c...ba38de2212261ed6484625d364a99d803d57f535,1,2,1,3,1,2013-10-01 00:26:00,2013-09-30 22:56:41
ba38de2212261ed6484625d364a99d803d57f535...1f686c489d2ef72a5e2ada8d9467e8b907ee8d98,1,2,1,3,1,2013-10-01 00:52:28,2013-09-05 20:44:37
1f686c489d2ef72a5e2ada8d9467e8b907ee8d98...93ce5923e92f6d2db831d8715ec62734821c70ce,4,300,49,349,23,2013-10-01 07:41:07,2013-09-25 01:47:45
93ce5923e92f6d2db831d8715ec62734821c70ce...587e8e2ba5feb275f14d259afb72ae6b77dfef18,1,2,2,4,1,2013-10-01 09:06:15,2013-09-06 09:00:26
587e8e2ba5feb275f14d259afb72ae6b77dfef18...4033cf28142664c52aa7b4bc95340ac913397ac8,2,66,2,68,4,2013-10-01 09:26:36,2013-09-21 04:24:39
4033cf28142664c52aa7b4bc95340ac913397ac8...f316c314ca260ada1427a3b40c16a8fb44e7b48d,1,42,38,80,15,2013-10-01 14:00:35,2013-09-06 12:48:18
f316c314ca260ada1427a3b40c16a8fb44e7b48d...ac2d06b19d8118cf482075f39088f41dfa318acf,1,147,158,305,67,2013-10-01 14:00:43,2013-09-06 14:41:45
ac2d06b19d8118cf482075f39088f41dfa318acf...025c92190376414c15f15fd20a75b41489a4e70a,2,5,1,6,2,2013-10-01 17:18:03,2013-08-23 10:48:32
025c92190376414c15f15fd20a75b41489a4e70a...0ca5426184f6900048588f3d2c2a4a65f9abe248,2,0,23,23,2,2013-10-01 17:26:08,2013-08-24 07:42:14
0ca5426184f6900048588f3d2c2a4a65f9abe248...0d0330adc24a68cd6891a030a56d3ce3bbced03c,2,7,1,8,2,2013-10-01 18:28:21,2013-09-17 04:24:35
0d0330adc24a68cd6891a030a56d3ce3bbced03c...2a63dfa6cc7889888f4296fff2944e74ff30b3af,2,1,3,4,3,2013-10-01 19:00:16,2013-10-01 18:12:19
2a63dfa6cc7889888f4296fff2944e74ff30b3af...936101041a9a1f1cf9fecf6b5fcfae206cd15424,1,1,3,4,1,2013-10-01 19:30:50,2013-09-24 17:52:20
936101041a9a1f1cf9fecf6b5fcfae206cd15424...e9a222418a029d830698444cf95bf13f8ad75805,2,20,1,21,3,2013-10-01 21:02:00,2013-09-03 21:19:38
e9a222418a029d830698444cf95bf13f8ad75805...6972596ce99f2a11ae07e65ebcb554cef1dd3240,1,1,0,1,1,2013-10-01 21:36:54,2013-09-23 18:55:41
6972596ce99f2a11ae07e65ebcb554cef1dd3240...8e1276c011b33b90af47494dc5e76baf86468a5a,2,13,1,14,2,2013-10-01 22:08:23,2013-08-31 09:48:11
8e1276c011b33b90af47494dc5e76baf86468a5a...e773029717f11d727af609a139b173a135c79eab,1,1,1,2,1,2013-10-01 23:17:07,2013-09-10 11:47:23
e773029717f11d727af609a139b173a135c79eab...6231a7cf6a9e2d07fcfa2f722bef684bd3ea1e1f,1,10,10,20,2,2013-10-02 06:47:01,2013-10-02 06:38:22
6231a7cf6a9e2d07fcfa2f722bef684bd3ea1e1f...29770677269279b8150b0a98c6dd7491685cd047,1,2,2,4,2,2013-10-02 13:12:35,2013-10-02 13:12:35
29770677269279b8150b0a98c6dd7491685cd047...ac72bee40085ea79759eec3543be8175236103ef,1,7,7,14,7,2013-10-02 13:15:09,2013-10-02 13:15:09
ac72bee40085ea79759eec3543be8175236103ef...8e6e3ebad991eaf57a7885549ea3b91932d495c9,3,32,2,34,4,2013-10-02 17:52:31,2013-09-18 14:00:34
8e6e3ebad991eaf57a7885549ea3b91932d495c9...40414827f42c8fb86abb835f7387d5b02923d532,1,5,3,8,1,2013-10-02 17:54:16,2013-09-25 02:59:47
40414827f42c8fb86abb835f7387d5b02923d532...10cc1a42c925749f88433546d41d35ba07a88e6f,2,19,4,23,5,2013-10-02 18:10:29,2013-08-12 13:53:31
10cc1a42c925749f88433546d41d35ba07a88e6f...78a5889bc691d95e5b037c99de3607f02a69a188,1,14,17,31,3,2013-10-02 19:06:27,2013-10-02 18:10:04
78a5889bc691d95e5b037c99de3607f02a69a188...d70711481e6311c9cd283d650f07ca0cca72ecc2,2,31,8,39,10,2013-10-02 22:33:31,2013-08-09 14:29:22
d70711481e6311c9cd283d650f07ca0cca72ecc2...fc8034b352121f8f057dbd5e3837eeb17e1df580,3,10,26,36,5,2013-10-02 22:59:49,2013-09-05 19:01:31
fc8034b352121f8f057dbd5e3837eeb17e1df580...5b8c78843e8d62a7a67cead8bf04c76aa8ee411d,2,12,6,18,5,2013-10-02 23:57:26,2013-08-22 19:44:24
5b8c78843e8d62a7a67cead8bf04c76aa8ee411d...e36e28ebd4a6c144e47d11fba8e211d8d5a9d03e,2,41,4,45,5,2013-10-03 00:03:53,2013-08-30 23:19:40
e36e28ebd4a6c144e47d11fba8e211d8d5a9d03e...e66c23fe55f8571a014b0686c8dbca128e7a8240,2,17,1,18,6,2013-10-03 07:42:15,2013-10-02 19:49:20
e66c23fe55f8571a014b0686c8dbca128e7a8240...d3fcacedd6e6fe14892fa110ebe20babd886d4bb,1,8,8,16,5,2013-10-03 09:06:02,2013-10-03 06:11:02
d3fcacedd6e6fe14892fa110ebe20babd886d4bb...575f63ac508a988e0c0ecbf93f62ea6f4bab13c0,6,24,28,52,16,2013-10-03 09:19:19,2013-10-03 09:16:44
575f63ac508a988e0c0ecbf93f62ea6f4bab13c0...0f7237d764f37ab9916fc9b8ecb7d8cd5b6adf98,8,96,54,150,39,2013-10-03 10:58:47,2013-10-03 10:58:47
0f7237d764f37ab9916fc9b8ecb7d8cd5b6adf98...3a231d4cbef0f778c34389520535f0446fd1e059,1,4,4,8,1,2013-10-03 20:06:44,2013-09-28 04:10:50
3a231d4cbef0f778c34389520535f0446fd1e059...171feb8fc6e2b845582ae301980892a169805abd,1,19,19,38,13,2013-10-03 20:10:47,2013-10-01 11:17:26
171feb8fc6e2b845582ae301980892a169805abd...b5214aa20a8a8bc611b0fc399dbd729bdc42b396,1,1,1,2,1,2013-10-03 20:29:59,2013-10-02 03:50:16
b5214aa20a8a8bc611b0fc399dbd729bdc42b396...a005797afa9bdb290d90ee0d3dd394c6551c3321,1,13,14,27,1,2013-10-03 20:44:16,2013-10-02 05:00:30
a005797afa9bdb290d90ee0d3dd394c6551c3321...2e5680a4e3178803c02ac56e1f0388766b32466c,1,4,2,6,3,2013-10-03 22:05:56,2013-10-03 22:05:56
2e5680a4e3178803c02ac56e1f0388766b32466c...2c00476baeecc55fbfb4df167858c9ac3b0ed314,1,4,2,6,1,2013-10-03 22:14:55,2013-10-02 16:05:11
2c00476baeecc55fbfb4df167858c9ac3b0ed314...7fec4bae804934ea17f62e190081ea66de450b31,1,3,3,6,1,2013-10-03 22:20:58,2013-10-02 16:08:50
7fec4bae804934ea17f62e190081ea66de450b31...1691c4e9a3a87268e00e48d04afb79a926742ea4,1,2,1,3,1,2013-10-03 22:37:09,2013-10-02 22:52:33
1691c4e9a3a87268e00e48d04afb79a926742ea4...333e3375e0205a087fd2f8178d4a58a1ff296cc3,1,3,3,6,2,2013-10-03 22:40:00,2013-10-02 23:20:19
333e3375e0205a087fd2f8178d4a58a1ff296cc3...a27b4cf5fd81a6cb6b990017dbe77d3090b0e22d,1,5,5,10,5,2013-10-03 22:44:42,2013-10-02 19:09:44
a27b4cf5fd81a6cb6b990017dbe77d3090b0e22d...fe2145016cb057c92f9f01b32c58b4d7259eb6ee,2,27,2,29,4,2013-10-04 05:19:46,2013-10-03 23:24:24
fe2145016cb057c92f9f01b32c58b4d7259eb6ee...31f190d4d53921d32253ba80d9ebe57d6c1de82b,3,123,30,153,31,2013-10-04 05:23:37,2013-10-01 14:55:47
31f190d4d53921d32253ba80d9ebe57d6c1de82b...0ff86c323359fba1a60bacab178e3c68528f8e1f,2,47,1,48,2,2013-10-04 15:45:47,2013-08-06 15:35:48
0ff86c323359fba1a60bacab178e3c68528f8e1f...1c18c93be138c59b5c1b73cae99cc52383272146,1,1,1,2,1,2013-10-04 16:12:48,2013-10-04 16:12:48
1c18c93be138c59b5c1b73cae99cc52383272146...948e8ca3250f2e806e6c822fbaee64f8e54c2a53,1,5,2,7,2,2013-10-04 17:43:11,2013-10-04 17:43:11
948e8ca3250f2e806e6c822fbaee64f8e54c2a53...49e06eace58d871972f0cf3ec92aa28e19c4b02b,2,500,429,929,138,2013-10-04 21:15:56,2013-08-21 00:19:49
49e06eace58d871972f0cf3ec92aa28e19c4b02b...8336b3a286f8469d4cd7c412c41ca8c1a31fecf0,2,11,1,12,2,2013-10-04 23:50:08,2013-10-04 19:02:18
8336b3a286f8469d4cd7c412c41ca8c1a31fecf0...e8a139c6d42eff05f5303ac1529bd2b41e14ba3e,1,1,1,2,1,2013-10-05 16:51:21,2013-10-05 11:14:18
e8a139c6d42eff05f5303ac1529bd2b41e14ba3e...55422b88d83491c8660ee61f023568e182b349e1,1,2,2,4,2,2013-10-05 20:03:19,2013-10-04 22:01:41
55422b88d83491c8660ee61f023568e182b349e1...7645e05e4d7143316cb169b221030e74498f0a1a,1,1,1,2,1,2013-10-05 20:44:14,2013-10-04 01:11:07
7645e05e4d7143316cb169b221030e74498f0a1a...78eead6775427bf02d9ad92e5c0d54a674794b9e,1,2,1,3,1,2013-10-05 20:49:16,2013-10-03 03:42:01
78eead6775427bf02d9ad92e5c0d54a674794b9e...9089468092ba1c38ee1468871b723cab39e84c21,1,1,1,2,1,2013-10-05 20:56:37,2013-10-01 19:40:13
9089468092ba1c38ee1468871b723cab39e84c21...47f7bd706efc5f2944d182e46c1b1d324298ff36,2,11,1,12,4,2013-10-05 21:45:43,2013-10-05 21:45:43
47f7bd706efc5f2944d182e46c1b1d324298ff36...28fe4464d8f40409dc05a290224cc06883aed2f6,1,1,1,2,1,2013-10-06 21:26:33,2013-10-06 20:18:26
28fe4464d8f40409dc05a290224cc06883aed2f6...805efb4c47f457004a5b35f532712b9b62105a99,1,52,3,55,3,2013-10-07 13:29:07,2013-10-03 20:28:44
805efb4c47f457004a5b35f532712b9b62105a99...281feba4caffd14ffbd6dedfb95ad6415cff8483,1,3,2,5,2,2013-10-07 13:31:14,2013-10-05 10:13:24
281feba4caffd14ffbd6dedfb95ad6415cff8483...4d6a7781d790fb5e2bdd847ffb0fb21652b57138,1,9,9,18,2,2013-10-07 13:37:28,2013-10-05 22:00:50
4d6a7781d790fb5e2bdd847ffb0fb21652b57138...d3fce9e82c1e248231d46bf3ff6ed61b20914088,1,1,1,2,1,2013-10-07 15:45:25,2013-10-05 09:32:12
d3fce9e82c1e248231d46bf3ff6ed61b20914088...9af8f4e5855133857d185babace73cd1f9b4d680,1,27,13,40,9,2013-10-07 15:45:25,2013-10-05 09:36:28
9af8f4e5855133857d185babace73cd1f9b4d680...fb99f542060d3959d273634c90889788861b5c05,1,9,9,18,9,2013-10-07 15:45:25,2013-10-05 09:43:11
fb99f542060d3959d273634c90889788861b5c05...7a586e5c19f3d1ecc3fefef084ce992072ee7f60,24,196,17,213,40,2013-10-07 16:01:13,2013-10-05 09:49:09
7a586e5c19f3d1ecc3fefef084ce992072ee7f60...670cd9c165815c511c71046c89241446c1bd55d5,1,2,2,4,2,2013-10-07 18:10:24,2013-10-07 18:10:24
670cd9c165815c511c71046c89241446c1bd55d5...a80e96cea184b392505f0a292785a5c66d45e165,1,1,1,2,1,2013-10-07 18:44:03,2013-10-07 18:29:10
a80e96cea184b392505f0a292785a5c66d45e165...2b5ce84fca7b41fca24707e163ec6af84bc12e83,7,725,0,725,8,2013-10-07 20:45:40,2013-09-13 19:47:05
2b5ce84fca7b41fca24707e163ec6af84bc12e83...b56b21a898b3c77589a48a290271f9dc181dafe8,3,102,21,123,23,2013-10-07 23:47:51,2013-09-25 11:49:55
b56b21a898b3c77589a48a290271f9dc181dafe8...bed08c9c6661d6da5ed6337f194402ea02a8d14c,1,1,1,2,1,2013-10-08 11:32:20,2013-10-08 09:42:51
bed08c9c6661d6da5ed6337f194402ea02a8d14c...507d8021b1c91cc0cefc0418e61b04597ad1030b,3,26,10,36,10,2013-10-08 11:55:16,2013-10-08 03:49:56
507d8021b1c91cc0cefc0418e61b04597ad1030b...f7fc00841bf5e3ffa2d9c2b1d316ed4dcdcde756,1,3,8,11,2,2013-10-08 11:59:46,2013-10-08 03:09:06
f7fc00841bf5e3ffa2d9c2b1d316ed4dcdcde756...9fd92cc3c93a6378e8887fd46fd4ad182a375544,3,21,6,27,7,2013-10-08 16:14:33,2013-09-04 16:20:33
9fd92cc3c93a6378e8887fd46fd4ad182a375544...80d2c85e3c04964631e822b57ff1fd1996240074,2,2,2,4,2,2013-10-08 17:14:03,2013-10-08 17:03:22
80d2c85e3c04964631e822b57ff1fd1996240074...ad5256452bb8f1d481d78e7ae15a59d288f0d8e9,2,420,1,421,2,2013-10-08 17:49:33,2013-10-08 17:43:01
ad5256452bb8f1d481d78e7ae15a59d288f0d8e9...d769b8b8f0fba81b35e441249e31e7e209d40580,1,44,44,88,7,2013-10-08 17:49:33,2013-10-08 17:44:09
d769b8b8f0fba81b35e441249e31e7e209d40580...556e8eece69b93b89c6ae1cc4cb86d08994a0dfc,5,58,53,111,17,2013-10-08 17:49:33,2013-10-08 17:45:00
556e8eece69b93b89c6ae1cc4cb86d08994a0dfc...f031430a6ff054e3ea4d25a19ccbccef50642cff,1,289,0,289,1,2013-10-08 17:53:51,2013-10-08 17:47:20
f031430a6ff054e3ea4d25a19ccbccef50642cff...fe65932404f518ff41e98a0fd5158c8c26a666f3,1,1,1,2,1,2013-10-09 10:30:22,2013-10-08 19:10:42
fe65932404f518ff41e98a0fd5158c8c26a666f3...1366556ace3e71f9e4abe63554050ddf9c0dabb6,1,4,1,5,1,2013-10-09 17:18:51,2013-10-08 21:40:44
1366556ace3e71f9e4abe63554050ddf9c0dabb6...9bbd62f4543ad8760deec08170c674cc028772cc,1,2,2,4,2,2013-10-09 19:12:26,2013-10-09 15:31:51
9bbd62f4543ad8760deec08170c674cc028772cc...5fc6eb0b5d8598190dc625254a609a1a4e5ae897,1,4,1,5,2,2013-10-09 20:10:38,2013-10-09 13:55:11
5fc6eb0b5d8598190dc625254a609a1a4e5ae897...2fe5a2def026ac1aa63a98be7135b93784677129,1,6,1,7,2,2013-10-09 20:14:57,2013-09-06 02:10:45
2fe5a2def026ac1aa63a98be7135b93784677129...5dc35b527b3c99f6544b8cb52e93c6510d3ac577,2,484,211,695,46,2013-10-09 22:15:43,2013-10-07 16:58:37
5dc35b527b3c99f6544b8cb52e93c6510d3ac577...b6a37d112b3e1478f4d14a5f82faabf700443748,2,0,22,22,2,2013-10-09 22:15:43,2013-10-09 16:54:10
b6a37d112b3e1478f4d14a5f82faabf700443748...64fd2c421ed582c16812d164a8a6f031b8e66287,2,13,2,15,4,2013-10-09 22:19:10,2013-10-09 20:51:59
64fd2c421ed582c16812d164a8a6f031b8e66287...9efa46ae640cde17487c341daa9a75c0bd79da02,5,212,31,243,45,2013-10-09 22:19:10,2013-09-23 18:24:42
9efa46ae640cde17487c341daa9a75c0bd79da02...cbd69db29240b3bf2bf3ebfa15ff1c01104a4ffb,1,1,0,1,1,2013-10-10 08:16:11,2013-10-07 17:20:24
cbd69db29240b3bf2bf3ebfa15ff1c01104a4ffb...3eb2fbf74533639a376c572d4aad767e80d2c209,1,64,26,90,9,2013-10-10 15:43:12,2013-10-06 22:01:03
3eb2fbf74533639a376c572d4aad767e80d2c209...74ef7f14a49662ebf389a515b86e6dd68e746811,1,204,89,293,15,2013-10-10 15:46:59,2013-10-10 15:46:59
74ef7f14a49662ebf389a515b86e6dd68e746811...b019a48bb1176f3c9ce29b628a321b6ffe873393,10,152,246,398,45,2013-10-10 18:41:07,2013-07-25 17:53:43
b019a48bb1176f3c9ce29b628a321b6ffe873393...07272608d8ae39a5dd220cdb5637b1439342d5c3,8,55,68,123,44,2013-10-10 18:58:15,2013-10-10 08:11:21
07272608d8ae39a5dd220cdb5637b1439342d5c3...e819d21fa02f28a64fa8176c132800da2395427e,1,27,8,35,3,2013-10-10 20:53:50,2013-10-10 18:35:30
e819d21fa02f28a64fa8176c132800da2395427e...7ef9dbb3df485f0525d6835cc4219ce2cbf8f611,1,7,8,15,3,2013-10-11 00:35:36,2013-10-03 14:52:38
7ef9dbb3df485f0525d6835cc4219ce2cbf8f611...079dd93991ac79b5f9af6efb7fe2b3600195f10c,2,69,61,130,49,2013-10-11 00:35:36,2013-10-03 19:06:42
079dd93991ac79b5f9af6efb7fe2b3600195f10c...3f31a7c7691993893f0724076816f6558643bd91,2,110,12,122,11,2013-10-11 00:35:36,2013-10-10 13:16:19
3f31a7c7691993893f0724076816f6558643bd91...23c698821f41e7c7e46a5898e29ac0515041bedc,2,98,20,118,57,2013-10-11 00:35:36,2013-10-07 18:35:24
23c698821f41e7c7e46a5898e29ac0515041bedc...cc5846073e57ef190182026d7e5a8e2770d9b770,2,223,22,245,24,2013-10-11 00:35:36,2013-10-09 03:40:46
cc5846073e57ef190182026d7e5a8e2770d9b770...1438f1b62600ab8c4092486a1b4e5e4505565a00,2,28,16,44,16,2013-10-11 00:35:36,2013-10-08 17:13:10
1438f1b62600ab8c4092486a1b4e5e4505565a00...b1e604e38ceec1714174fb54cc91590a7fe99a92,2,114,44,158,20,2013-10-11 00:35:36,2013-10-09 05:12:03
b1e604e38ceec1714174fb54cc91590a7fe99a92...e86aaa992f349db18cae8338d8bc700441ee2eda,1,41,34,75,6,2013-10-11 10:38:13,2013-10-10 21:49:55
e86aaa992f349db18cae8338d8bc700441ee2eda...10bae7b62a345fd5b6628c1bf06eaa693dfe7ed5,1,203,156,359,44,2013-10-11 10:46:59,2013-10-11 10:46:59
10bae7b62a345fd5b6628c1bf06eaa693dfe7ed5...c73801bfed9c3fbf34f6d73c16b89f4d1b1dcec6,1,1,1,2,1,2013-10-11 12:30:57,2013-10-11 00:55:53
c73801bfed9c3fbf34f6d73c16b89f4d1b1dcec6...3205166d80da268ac66768496f0bc1d956aa0f77,1,3,3,6,2,2013-10-11 12:34:00,2013-10-11 00:23:08
3205166d80da268ac66768496f0bc1d956aa0f77...dd7cb15bcf4767e20f4f620b33cb1fd35d8857d7,2,2,2,4,2,2013-10-11 12:44:39,2013-10-11 12:38:20
dd7cb15bcf4767e20f4f620b33cb1fd35d8857d7...c317a7b51ac5b9cf76f399427e7e71fe4f793818,1,3,3,6,2,2013-10-11 13:56:15,2013-10-11 13:56:15
c317a7b51ac5b9cf76f399427e7e71fe4f793818...989ca61a615851fe60b5793d1bf0d03698560c3e,1,1,1,2,1,2013-10-11 23:15:35,2013-10-11 22:55:53
989ca61a615851fe60b5793d1bf0d03698560c3e...08ba91364d26bcf3f2f7905096142d4029429e69,1,35,12,47,10,2013-10-11 23:15:36,2013-10-11 22:57:42
08ba91364d26bcf3f2f7905096142d4029429e69...01cbe2f3982bd91fdae9fcbbde833a5306b2042d,1,44,14,58,11,2013-10-11 23:15:36,2013-10-11 23:02:18
01cbe2f3982bd91fdae9fcbbde833a5306b2042d...a61d7999a4857871c2e2f73760d85ca6ab747858,1,8,6,14,1,2013-10-11 23:15:36,2013-10-11 23:04:20
a61d7999a4857871c2e2f73760d85ca6ab747858...8ec7668131b4de727400088bf2603457d57eb581,1,13,11,24,3,2013-10-11 23:15:36,2013-10-11 23:05:27
8ec7668131b4de727400088bf2603457d57eb581...c40b977d94c9364387c9feae7846ff3b885e1534,1,10,8,18,2,2013-10-11 23:15:36,2013-10-11 23:07:43
c40b977d94c9364387c9feae7846ff3b885e1534...55998a6371af21ec439e62d590337c64443016e3,1,2,2,4,1,2013-10-11 23:15:36,2013-10-11 23:08:40
55998a6371af21ec439e62d590337c64443016e3...6df2b8a968a61c3d2f22047dd1ac99091ef0c7ec,1,5,0,5,1,2013-10-11 23:34:02,2013-10-11 23:34:02
6df2b8a968a61c3d2f22047dd1ac99091ef0c7ec...b103fae8c7dd77ce4b680a8822c5ccd6cb27d814,1,1,2,3,1,2013-10-11 23:34:37,2013-10-11 23:34:37
b103fae8c7dd77ce4b680a8822c5ccd6cb27d814...9f4d99f4eaa53ea4b186a2954b23ce4c86643947,1,1,2,3,1,2013-10-12 00:12:23,2013-10-10 22:45:41
9f4d99f4eaa53ea4b186a2954b23ce4c86643947...83fbaa54f13ff94d193115de0eaa3799739af3a5,2,3,3,6,3,2013-10-12 00:12:24,2013-10-11 19:21:34
83fbaa54f13ff94d193115de0eaa3799739af3a5...4357da857587d3c28790e7dc654664bec5808768,1,6,2,8,3,2013-10-12 00:12:24,2013-10-11 23:46:32
4357da857587d3c28790e7dc654664bec5808768...b7af76b4c5aa77648cc1bfd49935b48583419023,4,5,5,10,5,2013-10-12 00:12:24,2013-10-11 19:58:57
b7af76b4c5aa77648cc1bfd49935b48583419023...63c5334c84b7269428c710226764d1f08a36e0d4,3,142,29,171,26,2013-10-12 00:12:24,2013-10-11 04:35:54
63c5334c84b7269428c710226764d1f08a36e0d4...cd216c4c30adfebb3ef633f18fab2d98e8c52ebc,1,6,6,12,3,2013-10-12 23:52:47,2013-10-12 16:35:34
cd216c4c30adfebb3ef633f18fab2d98e8c52ebc...b76ed0b28cf77a46e8b0e76bf365462adc21d9b2,1,6,6,12,6,2013-10-14 04:47:06,2013-10-14 03:13:39
b76ed0b28cf77a46e8b0e76bf365462adc21d9b2...4696af79ec8f7b7dd76d34623c72dbdaaec17889,1,6,3,9,3,2013-10-14 05:25:20,2013-10-13 23:59:25
4696af79ec8f7b7dd76d34623c72dbdaaec17889...27519e9a3376939452a410fdb82975a3159b565b,1,1,1,2,1,2013-10-14 05:28:05,2013-10-13 23:50:57
27519e9a3376939452a410fdb82975a3159b565b...e79a20e1ca2e725100acedc0ba5ac014fea0f412,1,20,20,40,5,2013-10-14 06:12:20,2013-10-13 00:33:45
e79a20e1ca2e725100acedc0ba5ac014fea0f412...977b482b0b9ee41fee7feb8d1016f3d86f54abc7,1,6,4,10,2,2013-10-14 06:20:31,2013-10-12 22:38:27
977b482b0b9ee41fee7feb8d1016f3d86f54abc7...0f16b1d32e36d5c6b6551201b5421bd22cdeeaef,1,1,1,2,1,2013-10-14 06:34:17,2013-10-12 22:05:49
0f16b1d32e36d5c6b6551201b5421bd22cdeeaef...0dd987bb919b3761c28f8e5b85eb22f9b9bf5a57,1,1,1,2,1,2013-10-14 06:35:38,2013-10-14 06:25:37
0dd987bb919b3761c28f8e5b85eb22f9b9bf5a57...c106b80c8dc145797dd1325a765d0e467894cb85,1,79,82,161,46,2013-10-14 06:39:26,2013-10-12 16:14:32
c106b80c8dc145797dd1325a765d0e467894cb85...a780df877935f350990826bc5e577afa2b460006,1,1,1,2,1,2013-10-14 06:40:57,2013-10-11 22:59:08
a780df877935f350990826bc5e577afa2b460006...7566215f479980be79f18b58c6c14c57dd8736b5,1,1,1,2,1,2013-10-14 06:48:02,2013-10-14 06:44:57
7566215f479980be79f18b58c6c14c57dd8736b5...08cdd77c28e95cb2d01d568f31873124c97ec33a,4,4,0,4,4,2013-10-14 16:53:32,2013-10-14 16:53:32
08cdd77c28e95cb2d01d568f31873124c97ec33a...0d63ad5ccf11637eb7737d4d0a7c9edaaece6845,1,1,1,2,1,2013-10-14 17:36:23,2013-10-14 17:36:23
0d63ad5ccf11637eb7737d4d0a7c9edaaece6845...ff923a5d45ec0d672717d9ff2cc016d3663ca6a6,1,276,0,276,1,2013-10-15 13:12:43,2013-10-15 00:09:01
ff923a5d45ec0d672717d9ff2cc016d3663ca6a6...3aefd3a4f0c9f6eba54b2e4f7a13c5621436df7d,1,3,3,6,1,2013-10-15 13:24:37,2013-10-15 13:24:37
3aefd3a4f0c9f6eba54b2e4f7a13c5621436df7d...6d324c76f0d3ad7dae69ce01b14e0564938fb15e,2,15,0,15,2,2013-10-15 13:43:19,2013-10-14 23:05:53
6d324c76f0d3ad7dae69ce01b14e0564938fb15e...dba566a96d3c660e12249dcb6445dad19854da97,2,11,4,15,4,2013-10-15 18:28:47,2013-10-15 18:28:47
dba566a96d3c660e12249dcb6445dad19854da97...c22adbf160f32c1839fbb35382b7a8c6bcec2927,2,11,1,12,2,2013-10-18 22:26:51,2013-10-16 19:14:44
c22adbf160f32c1839fbb35382b7a8c6bcec2927...e8cc85f733a49ca53e8cda5a96bbaacc9a20ac7e,5,193,62,255,30,2013-10-18 22:35:41,2013-10-17 21:16:32
e8cc85f733a49ca53e8cda5a96bbaacc9a20ac7e...14438058da39c3e523f420549074934ca5881b09,39,209,208,417,167,2013-10-18 22:35:41,2013-10-18 02:25:08
14438058da39c3e523f420549074934ca5881b09...08f376f2ea3d3bb384f10e3c01f7d48ed21ce351,8,64,40,104,18,2013-10-19 00:33:53,2013-10-15 22:00:22
08f376f2ea3d3bb384f10e3c01f7d48ed21ce351...3661bab202605bdd0e1669899a09072ef141b0c4,1,1,1,2,1,2013-10-21 15:26:05,2013-09-10 15:59:42
3661bab202605bdd0e1669899a09072ef141b0c4...280e33d22a744b494395abdca639fa54eb6bb779,1,1,1,2,1,2013-10-22 00:39:05,2013-10-22 00:39:05
280e33d22a744b494395abdca639fa54eb6bb779...b9557b0a86206d938a738ea470736d011dff7e1a,1,8,3,11,3,2013-10-22 19:09:52,2013-10-21 16:50:48
b9557b0a86206d938a738ea470736d011dff7e1a...a86cf20e67202d614bbcaf038c5e04db94483256,5,41,10,51,14,2013-10-22 22:21:23,2013-10-14 19:06:26
a86cf20e67202d614bbcaf038c5e04db94483256...2d8d6dd192322a60a3dbad7485d1395a161b3130,1,1,0,1,1,2013-10-22 22:21:24,2013-10-22 22:05:40
2d8d6dd192322a60a3dbad7485d1395a161b3130...934a95d3ef3f72dfc37b0b564624cb4a1286d4f4,13,482,38,520,24,2013-10-22 22:32:40,2013-10-21 08:06:53
934a95d3ef3f72dfc37b0b564624cb4a1286d4f4...f2fab498303e00d199cb3d19a008670e214d5c10,304,1951,1187,3138,821,2013-10-22 22:32:41,2013-10-22 21:41:21
f2fab498303e00d199cb3d19a008670e214d5c10...06557aab44860baf3f121f3db424c5ede0764bf4,1,1,1,2,1,2013-10-22 22:32:41,2013-10-22 22:00:09
06557aab44860baf3f121f3db424c5ede0764bf4...6c20ec193f11aa647be1b2ad2ac5b3e7c2894bd7,4,31,126,157,36,2013-10-23 01:23:59,2013-10-22 04:14:39
6c20ec193f11aa647be1b2ad2ac5b3e7c2894bd7...74912802c644ca929e39a7583cb7a9a05f12e91f,2,16,6,22,5,2013-10-23 01:23:59,2013-10-22 04:34:56
74912802c644ca929e39a7583cb7a9a05f12e91f...f5289fe84ffc1f2368dae7bd14c420abbe76749e,2,104,22,126,18,2013-10-23 11:08:03,2013-10-18 02:37:17
f5289fe84ffc1f2368dae7bd14c420abbe76749e...2623de1426219dc799f63a3d155911f93fc03461,2,129,12,141,10,2013-10-23 11:26:41,2013-10-22 05:53:40
2623de1426219dc799f63a3d155911f93fc03461...3f568b22f9bec09192588e3cae937db5c2e757f9,2,8,9,17,7,2013-10-23 17:30:45,2013-10-17 18:29:06
3f568b22f9bec09192588e3cae937db5c2e757f9...a7e12b7959212f2fa88fe17d5a045cc9d8b22922,13,400,18,418,21,2013-10-23 21:00:12,2013-10-17 02:48:32
a7e12b7959212f2fa88fe17d5a045cc9d8b22922...32ab648c79b4783f1cc2491919b659d17004356c,1,3,3,6,1,2013-10-23 21:06:14,2013-10-23 21:04:46
32ab648c79b4783f1cc2491919b659d17004356c...e69c2872939cda30f13a1a8390bbc61662c12d9a,6,1391,672,2063,110,2013-10-23 21:17:27,2013-10-23 21:04:47
e69c2872939cda30f13a1a8390bbc61662c12d9a...269bc7e51f0ae4e4230308e43db934a9fff48756,2,4,2,6,2,2013-10-23 21:44:37,2013-10-23 21:44:37
269bc7e51f0ae4e4230308e43db934a9fff48756...4b653aeac1aca7ac551738870a2446b6810ca0df,2,32,2,34,6,2013-10-24 13:19:55,2013-10-21 03:07:50
4b653aeac1aca7ac551738870a2446b6810ca0df...261057db9bdded43e10c2b778dff14d2acbe8416,1,2,0,2,1,2013-10-24 13:27:45,2013-10-24 13:26:53
261057db9bdded43e10c2b778dff14d2acbe8416...bf29cbc53f585c4dd2455b57ebfa18063dc17f6a,1,4,1,5,1,2013-10-24 19:42:02,2013-10-14 16:47:19
bf29cbc53f585c4dd2455b57ebfa18063dc17f6a...1c621bdf232941dcc008fd08aeefda3f09e0ab91,1,1,1,2,1,2013-10-24 19:43:32,2013-10-14 18:57:08
1c621bdf232941dcc008fd08aeefda3f09e0ab91...d3930fdfd9e8ef6a53432eafbcbf88f592e5d406,1,1,1,2,1,2013-10-24 19:51:32,2013-10-15 00:29:42
d3930fdfd9e8ef6a53432eafbcbf88f592e5d406...e690eaae532e4f8670e05e53a968693c8f33ebda,1,1,1,2,1,2013-10-24 19:54:26,2013-10-24 19:54:26
e690eaae532e4f8670e05e53a968693c8f33ebda...e57d5b89caac88a11696e88ccdd5404f77663447,1,1,1,2,1,2013-10-24 20:08:42,2013-10-15 04:21:00
e57d5b89caac88a11696e88ccdd5404f77663447...faf5b980da09da2b4c28f1feab33f87269f9f0ba,2,64,8,72,11,2013-10-24 20:54:15,2013-10-22 00:38:43
faf5b980da09da2b4c28f1feab33f87269f9f0ba...93132b96bf149bcd53c9ae86b8115a522afc4119,1,23,0,23,1,2013-10-24 21:11:56,2013-10-15 07:48:32
93132b96bf149bcd53c9ae86b8115a522afc4119...88e35fa8d64cf28db9c84df67549b2a0ee1960cf,1,1,2,3,1,2013-10-24 21:11:56,2013-10-15 11:28:40
88e35fa8d64cf28db9c84df67549b2a0ee1960cf...3c05e36e79365c9dd6996934ed4538fa7f3f220e,1,1,1,2,1,2013-10-24 21:12:51,2013-10-15 15:17:49
3c05e36e79365c9dd6996934ed4538fa7f3f220e...3b046c9eaafce846ed7973446f376e810c8cc4e1,1,6,3,9,1,2013-10-24 21:17:50,2013-10-15 23:56:09
3b046c9eaafce846ed7973446f376e810c8cc4e1...db9c6a3528e3307b1e320fd15b1341eb9b39e1b7,1,2,1,3,1,2013-10-24 21:21:27,2013-10-16 01:06:00
db9c6a3528e3307b1e320fd15b1341eb9b39e1b7...46d396df72aab0678eddc3d4aac02c4ba95ceef4,1,7,6,13,4,2013-10-24 21:26:39,2013-10-16 01:13:54
46d396df72aab0678eddc3d4aac02c4ba95ceef4...76b628bcb3511210d312ed667e5c14d908a9fed1,2,51,1,52,8,2013-10-24 21:35:57,2013-10-23 19:14:27
76b628bcb3511210d312ed667e5c14d908a9fed1...82dec9b81e8e66d3fb63c3e7690b4bf5318dc65e,1,8,6,14,1,2013-10-24 21:36:40,2013-10-24 21:36:05
82dec9b81e8e66d3fb63c3e7690b4bf5318dc65e...1ae34aac811629df201c3d41d7976559cf7aaf5d,3,4,11,15,5,2013-10-24 22:09:30,2013-10-24 21:55:17
1ae34aac811629df201c3d41d7976559cf7aaf5d...459e85bfea421f46b978790924180b9a95e4ae78,1,32,0,32,2,2013-10-24 22:13:30,2013-10-16 04:04:36
459e85bfea421f46b978790924180b9a95e4ae78...e8a3569be6bccd989b3f66e647ade77def5b5330,1,1,1,2,1,2013-10-24 22:22:36,2013-10-16 21:09:43
e8a3569be6bccd989b3f66e647ade77def5b5330...3e79c9b09850899038f8609649de60ec326b8d10,1,1,1,2,1,2013-10-24 22:26:37,2013-10-24 21:48:22
3e79c9b09850899038f8609649de60ec326b8d10...e7177d3159c5aa5616899196ce28f9b4f154b3c6,1,1,1,2,1,2013-10-25 20:46:31,2013-10-16 21:19:24
e7177d3159c5aa5616899196ce28f9b4f154b3c6...bb1395b45255ea4b6be33c66683d33a219d19df7,1,0,5,5,1,2013-10-25 20:46:32,2013-10-16 21:19:24
bb1395b45255ea4b6be33c66683d33a219d19df7...c47a366bc444e94f50fc0032a8e74a903415a2ba,1,162,6,168,3,2013-10-25 20:47:29,2013-10-16 20:37:06
c47a366bc444e94f50fc0032a8e74a903415a2ba...4645c95702b85a256d32e4d95d6de9558f4f9fa7,1,1,1,2,1,2013-10-25 20:51:23,2013-10-16 23:59:51
4645c95702b85a256d32e4d95d6de9558f4f9fa7...280354c3f948b77a116225d9b5099dadaeaf75b3,1,1,1,2,1,2013-10-25 20:52:46,2013-10-17 06:59:18
280354c3f948b77a116225d9b5099dadaeaf75b3...c1e6afca11061c5c5d7570a04825f98ce1994a88,1,8,3,11,3,2013-10-25 21:03:10,2013-10-17 14:05:28
c1e6afca11061c5c5d7570a04825f98ce1994a88...924abdae9f48b5265d8cc5d1eae94e32741ecaf4,1,1,1,2,1,2013-10-25 21:06:37,2013-10-18 12:06:03
924abdae9f48b5265d8cc5d1eae94e32741ecaf4...34b1ceb42e0a75a07740654b0c3b6d8dd87ad211,1,1,0,1,1,2013-10-25 21:09:38,2013-10-20 22:02:11
34b1ceb42e0a75a07740654b0c3b6d8dd87ad211...28bf357553aeeea695c8eefd0fa133bb945a853f,1,2,2,4,2,2013-10-25 21:11:08,2013-10-22 10:21:38
28bf357553aeeea695c8eefd0fa133bb945a853f...9bf9c236cf5364ed7bfe01b770444eb9c3ef5450,1,1,1,2,1,2013-10-25 21:16:35,2013-10-22 21:58:59
9bf9c236cf5364ed7bfe01b770444eb9c3ef5450...79223eae5022838893342c42dacad5eca83fabe8,2,76,32,108,9,2013-10-25 21:19:58,2013-10-24 19:09:41
79223eae5022838893342c42dacad5eca83fabe8...0a8473977648413cf9154e22521701ce266f7659,1,2,1,3,1,2013-10-26 03:53:15,2013-10-24 00:02:30
0a8473977648413cf9154e22521701ce266f7659...ab3a3bf07a549a80e9230849d08535eca058dbec,1,17,8,25,5,2013-10-26 17:10:44,2013-10-23 18:18:29
ab3a3bf07a549a80e9230849d08535eca058dbec...e73bd40e857d88349011ae9d0272a7c5aa2f03ab,1,1,1,2,1,2013-10-26 17:17:54,2013-10-23 19:11:04
e73bd40e857d88349011ae9d0272a7c5aa2f03ab...31ebeeef7d1429dc1a4792f4678dd22c31d473b4,1,1,1,2,1,2013-10-26 17:18:53,2013-10-26 17:18:53
31ebeeef7d1429dc1a4792f4678dd22c31d473b4...a1806bb460403c5e6b8079fac7c3d604db139a55,1,1,1,2,1,2013-10-26 17:51:44,2013-10-24 00:22:16
a1806bb460403c5e6b8079fac7c3d604db139a55...af34a4a2c081abd68ad568149561c91d58f746c8,1,1,0,1,1,2013-10-26 17:53:41,2013-10-24 12:57:44
af34a4a2c081abd68ad568149561c91d58f746c8...9f0d4085e750c96cd65a34259f2160c4aa6a3794,1,2,1,3,1,2013-10-26 17:57:59,2013-10-24 11:48:38
9f0d4085e750c96cd65a34259f2160c4aa6a3794...fca7bcaf43af3a4501ea0727d48f606c58d76bcd,1,14,12,26,5,2013-10-26 18:24:03,2013-10-26 18:24:03
fca7bcaf43af3a4501ea0727d48f606c58d76bcd...28ab4b600a604319804d63620b4ff7cda4ff42ff,1,0,2,2,1,2013-10-26 18:29:27,2013-10-24 16:53:26
28ab4b600a604319804d63620b4ff7cda4ff42ff...05bc53d34d8843f97dc9f561ce23829989299554,1,1,1,2,1,2013-10-26 18:33:16,2013-10-24 18:08:56
05bc53d34d8843f97dc9f561ce23829989299554...3cfe9575e94b73165272a7c5a8f351419f625170,1,8,8,16,6,2013-10-26 18:36:53,2013-10-24 18:19:28
3cfe9575e94b73165272a7c5a8f351419f625170...d1a285e5d3ee8bbcc5876944ea05367825438905,1,8,8,16,6,2013-10-26 18:43:35,2013-10-25 04:56:02
d1a285e5d3ee8bbcc5876944ea05367825438905...a4d3146ee9ef61e8b8ca73c8aab7a07a4c76a663,1,1,1,2,1,2013-10-26 18:47:43,2013-10-25 13:58:43
a4d3146ee9ef61e8b8ca73c8aab7a07a4c76a663...96da4c14a79b5d053a079ed0e2486ed29d0e9e43,1,1,1,2,1,2013-10-26 18:49:14,2013-10-25 14:49:26
96da4c14a79b5d053a079ed0e2486ed29d0e9e43...8b7473856867a8507ac5e833410d316fdf1b3177,1,4,0,4,1,2013-10-26 18:50:43,2013-10-25 11:40:02
8b7473856867a8507ac5e833410d316fdf1b3177...9453c610935b2e872215f0c6a223b24ba8b4ea7f,1,1,1,2,1,2013-10-26 18:58:05,2013-10-26 16:57:28
9453c610935b2e872215f0c6a223b24ba8b4ea7f...256fcb68842bfde2e4f1deef9eaa262753558732,1,4,3,7,1,2013-10-26 19:07:00,2013-10-26 19:07:00
256fcb68842bfde2e4f1deef9eaa262753558732...9f2c8e935a28fce0e898a2739c389e3f8cbc08a5,1,3,1,4,1,2013-10-26 19:09:09,2013-10-18 00:06:48
9f2c8e935a28fce0e898a2739c389e3f8cbc08a5...81d5bc860dde93be0f6be3193c23458a2ae9ff5c,1,3,3,6,1,2013-10-26 19:14:08,2013-10-19 13:02:33
81d5bc860dde93be0f6be3193c23458a2ae9ff5c...0bbb9e6258bd60a2676a475acc92b13b2c3425dc,1,12,5,17,5,2013-10-26 19:14:08,2013-10-26 19:13:27
0bbb9e6258bd60a2676a475acc92b13b2c3425dc...2cdb588b8660940bdb73c6a909a12d9c594e4b91,1,1,1,2,1,2013-10-26 19:15:50,2013-10-23 09:51:36
2cdb588b8660940bdb73c6a909a12d9c594e4b91...dfccdd5b86a2061c8a21533eae201408fdda73f1,1,29,0,29,1,2013-10-26 19:20:42,2013-10-15 22:48:35
dfccdd5b86a2061c8a21533eae201408fdda73f1...8e5e641c0ebb986020458eb68cabda5a457d8a5f,1,1,1,2,1,2013-10-27 21:27:49,2013-10-21 23:42:13
8e5e641c0ebb986020458eb68cabda5a457d8a5f...7c5e2511fda62e26b6dd3fd7db37e8be6b60600f,1,1,1,2,1,2013-10-27 21:30:54,2013-10-24 20:55:35
7c5e2511fda62e26b6dd3fd7db37e8be6b60600f...0429f6c7f5a9a273095049815f0bc00fe28ea0c4,1,1,1,2,1,2013-10-27 21:42:23,2013-10-27 08:14:11
0429f6c7f5a9a273095049815f0bc00fe28ea0c4...c36e73de038bca9212d92d9a47777b44cf48912b,1,5,0,5,1,2013-10-27 21:48:50,2013-10-26 03:04:45
c36e73de038bca9212d92d9a47777b44cf48912b...c9a1df3ae92183fc5074b02389fff524c508b731,1,1,1,2,1,2013-10-27 21:51:53,2013-10-27 05:46:32
c9a1df3ae92183fc5074b02389fff524c508b731...f3e3a65e29b1c64c723cfc55833c8c2f8f64d0b0,1,2,2,4,2,2013-10-27 21:54:51,2013-10-27 21:54:51
f3e3a65e29b1c64c723cfc55833c8c2f8f64d0b0...797c99eabee98fedcf01cdad4432569a9ebe8a17,1,359,353,712,53,2013-10-28 08:11:17,2013-10-26 03:56:51
797c99eabee98fedcf01cdad4432569a9ebe8a17...18ae985c3a3147b589c22f6ec21bacad2f578e2b,2,48,3,51,2,2013-10-28 08:11:18,2013-10-26 02:10:50
18ae985c3a3147b589c22f6ec21bacad2f578e2b...6d23591c31f2b41097ceaa380af09998e4a62f09,1,4,4,8,4,2013-10-28 19:45:00,2013-10-16 00:16:01
6d23591c31f2b41097ceaa380af09998e4a62f09...29e40c1f1c530f045e541e308ac5138ee749655a,1,1,1,2,1,2013-10-28 20:30:06,2013-10-28 01:53:33
29e40c1f1c530f045e541e308ac5138ee749655a...74848307443c00ab07552336c56ddfa1e9ef6eff,2,217,6,223,16,2013-10-28 21:00:47,2013-10-25 18:20:35
74848307443c00ab07552336c56ddfa1e9ef6eff...6818542c694aec6c811fb2fe2f86f7d16544c39b,2,45,2,47,4,2013-10-28 21:26:07,2013-10-28 16:43:41
6818542c694aec6c811fb2fe2f86f7d16544c39b...cf54510b2ca232e99d14104b88593843217df624,1,1,1,2,1,2013-10-28 21:27:28,2013-10-28 20:57:43
cf54510b2ca232e99d14104b88593843217df624...32b3494aa1b2343d078961c4e6a9ce139e0a4675,1,1,1,2,1,2013-10-28 21:27:29,2013-10-28 20:57:43
32b3494aa1b2343d078961c4e6a9ce139e0a4675...d3b38dda0644e200310a52b00ae0c3cbbcbf2cc1,1,21,9,30,1,2013-10-28 21:27:30,2013-10-28 20:57:43
d3b38dda0644e200310a52b00ae0c3cbbcbf2cc1...3d4c80cc3e8b1c3f673507ef252e872c374ba431,1,4,4,8,2,2013-10-28 22:01:15,2013-10-28 19:15:40
3d4c80cc3e8b1c3f673507ef252e872c374ba431...7f0767acaba1ec3c8849244a604b0d1c8c376446,2,42,6,48,6,2013-10-29 04:26:35,2013-10-28 16:43:41
7f0767acaba1ec3c8849244a604b0d1c8c376446...d434eabec3955f8d56c859c93befe711bfa1de27,2,6,1,7,2,2013-10-29 05:47:47,2013-10-29 04:44:06
d434eabec3955f8d56c859c93befe711bfa1de27...8a3aba73585c310725b79d422586ca1f423e8f1d,1,1,1,2,1,2013-10-30 20:52:18,2013-10-29 06:56:45
8a3aba73585c310725b79d422586ca1f423e8f1d...a1c9a416394174668b61468ea20b6e527e57c4a5,1,142,20,162,11,2013-10-30 20:53:34,2013-10-28 22:48:47
a1c9a416394174668b61468ea20b6e527e57c4a5...d355b6c48e227835006ae33825a0524cb7363805,1,1,1,2,1,2013-10-30 20:55:43,2013-10-28 22:34:26
d355b6c48e227835006ae33825a0524cb7363805...6e77f808279ef246db33d2a3cd6f6acd58e84610,1,1,1,2,1,2013-10-30 20:56:38,2013-10-29 18:41:34
6e77f808279ef246db33d2a3cd6f6acd58e84610...217feda041c62d55ee13a0fad3563f36863fddc0,1,2,2,4,2,2013-10-30 20:58:10,2013-10-29 20:53:44
217feda041c62d55ee13a0fad3563f36863fddc0...e53e2c2d58dc8ae2cb644e4dea86c2fef4dfa41c,1,13,10,23,3,2013-10-30 21:00:11,2013-10-29 21:57:59
e53e2c2d58dc8ae2cb644e4dea86c2fef4dfa41c...627f9ba09136e5b9ba359d2b67f8cfcda834586f,1,3,1,4,1,2013-10-30 21:03:10,2013-10-30 21:03:10
627f9ba09136e5b9ba359d2b67f8cfcda834586f...89a67ca77ce21a37e6560a487193e33ad68d5335,1,8,8,16,1,2013-10-30 21:08:33,2013-10-30 14:15:41
89a67ca77ce21a37e6560a487193e33ad68d5335...2ae29b1ce393632a6012b273127a089298d4f9b9,1,3,3,6,1,2013-10-30 21:16:38,2013-10-29 22:40:15
2ae29b1ce393632a6012b273127a089298d4f9b9...117de8e6e26495959fd20831a39cce49a4cf2d51,1,2,2,4,2,2013-10-30 21:24:20,2013-10-30 21:24:20
117de8e6e26495959fd20831a39cce49a4cf2d51...9d0a69772c39bfc751ca2000c3b4b3381e51fe93,2,1929,0,1929,2,2013-10-30 22:15:03,2013-10-30 22:15:03
9d0a69772c39bfc751ca2000c3b4b3381e51fe93...e19067c9bbac3c3bb450c80f73eb5518bd0db1a1,3,65,9,74,7,2013-10-30 23:21:02,2013-10-30 21:51:02
e19067c9bbac3c3bb450c80f73eb5518bd0db1a1...6578bd0c82b5cbb0cd6f6fea0787fb7ce820d4e7,4,25,36,61,5,2013-10-30 23:21:02,2013-10-30 21:51:52
6578bd0c82b5cbb0cd6f6fea0787fb7ce820d4e7...5b620653f61ae3d9f1de8346de271752fa12f26f,3,6,3,9,3,2013-10-30 23:21:02,2013-10-30 22:02:25
5b620653f61ae3d9f1de8346de271752fa12f26f...3d6a89e8888b14ae5cb5640464e12b7811853c7e,3,140,11,151,12,2013-10-31 00:01:51,2013-10-18 02:44:36
3d6a89e8888b14ae5cb5640464e12b7811853c7e...9a828738cd2e959bc2a198989e96c8e416d28b71,1,11,7,18,1,2013-10-31 19:56:49,2013-10-31 18:13:56
9a828738cd2e959bc2a198989e96c8e416d28b71...8d4e3fdd31eabadd87db38aa0590253e14791956,1,7,6,13,4,2013-11-03 04:40:15,2013-11-01 13:10:52
8d4e3fdd31eabadd87db38aa0590253e14791956...84166029ec503d174c57e47cfcc963331125385e,1,1,1,2,1,2013-11-04 17:59:31,2013-11-02 20:54:27
84166029ec503d174c57e47cfcc963331125385e...de2cced192405f352c0cefccd3e7726aef56dae0,2,133,202,335,48,2013-11-04 18:35:21,2013-10-31 20:09:35
de2cced192405f352c0cefccd3e7726aef56dae0...c6923d2df466c80ef3b6a4699da53ff0dcf8fd7a,1,1,1,2,1,2013-11-04 18:35:51,2013-11-04 18:27:25
c6923d2df466c80ef3b6a4699da53ff0dcf8fd7a...9483373c331343648e079420b3eb1f564d410ff2,2,40,12,52,7,2013-11-04 18:35:51,2013-11-04 18:28:30
9483373c331343648e079420b3eb1f564d410ff2...8f989d652f70fd147f66a18411070c7b939e242e,3,94,18,112,11,2013-11-04 18:35:51,2013-11-04 18:32:23
8f989d652f70fd147f66a18411070c7b939e242e...a92b419551450573a8f71c562618159af68ad8e8,1,55,3,58,3,2013-11-04 19:43:41,2013-11-04 19:31:27
a92b419551450573a8f71c562618159af68ad8e8...c82058ad57dfdab0e8e2505b6f44d7e33398ffb2,1,1,1,2,1,2013-11-04 22:21:49,2013-11-02 15:00:57
c82058ad57dfdab0e8e2505b6f44d7e33398ffb2...5b1c972723df52cce089e743a92a3c45e82b592e,1,4,1,5,1,2013-11-04 22:23:02,2013-11-01 22:59:49
5b1c972723df52cce089e743a92a3c45e82b592e...159a63f538a2880f1977f78f0223b47d6666be81,1,1,1,2,1,2013-11-04 22:24:18,2013-11-01 18:41:54
159a63f538a2880f1977f78f0223b47d6666be81...8cfaeb0e82257891940124e5dd4395953277628c,1,3,2,5,1,2013-11-04 22:28:34,2013-11-01 14:59:33
8cfaeb0e82257891940124e5dd4395953277628c...6dcdb4e306bf0ecf78ef125c514dc38fde359a42,1,1,2,3,1,2013-11-04 22:31:51,2013-10-31 13:11:50
6dcdb4e306bf0ecf78ef125c514dc38fde359a42...727b232fb2e2440b762c9ed1b9b8ae32e7a54f7d,1,1,1,2,1,2013-11-04 22:34:11,2013-11-01 14:09:29
727b232fb2e2440b762c9ed1b9b8ae32e7a54f7d...e196413df67dd56f05090fd853c1b00fd6002ef1,1,5,1,6,3,2013-11-05 13:38:09,2013-11-04 14:24:18
e196413df67dd56f05090fd853c1b00fd6002ef1...4c8fa353245b9c32261860caff18f002d294e19f,1,1,0,1,1,2013-11-05 21:16:52,2013-11-05 21:16:52
4c8fa353245b9c32261860caff18f002d294e19f...d4493fda2c4c2ff1fdfc264bfb479741abc781c7,1,2,11,13,1,2013-11-05 21:20:46,2013-11-05 21:20:46
d4493fda2c4c2ff1fdfc264bfb479741abc781c7...0fca288224b4521679fc3f2ecdeb1166cd0a4156,1,1,1,2,1,2013-11-05 21:22:04,2013-11-05 21:22:04
0fca288224b4521679fc3f2ecdeb1166cd0a4156...952fea69fbfbd7a72e335de9bc2cb96699055476,1,43,43,86,39,2013-11-06 02:42:42,2013-11-04 20:55:01
952fea69fbfbd7a72e335de9bc2cb96699055476...974b6d4a5b402c9911aef8adf2f3d30aae1ba8ed,2,6,1,7,2,2013-11-06 02:43:31,2013-11-02 17:25:38
974b6d4a5b402c9911aef8adf2f3d30aae1ba8ed...e53ff431e1472c0b2d5405d267d4e403ca31087e,2,28,0,28,2,2013-11-06 02:44:02,2013-11-02 18:14:13
e53ff431e1472c0b2d5405d267d4e403ca31087e...41a2d5b30f4feb90651eb577cf44852a6d2be72c,2,151,12,163,14,2013-11-06 02:44:25,2013-10-31 18:49:06
41a2d5b30f4feb90651eb577cf44852a6d2be72c...b89584db10b63f346cbfd03f67fb92504e5bf362,3,103,17,120,19,2013-11-06 02:45:36,2013-10-31 21:09:49
b89584db10b63f346cbfd03f67fb92504e5bf362...7d2d2575a24e099cb0ebd9c3b44f75fe37f24298,1,25,25,50,24,2013-11-06 02:46:07,2013-11-05 00:00:03
7d2d2575a24e099cb0ebd9c3b44f75fe37f24298...9d69a0a7c75c937c0a49bb705d31252326b052df,2,501,285,786,156,2013-11-06 05:15:59,2013-11-04 21:23:56
9d69a0a7c75c937c0a49bb705d31252326b052df...b1d4d580e5021d5890d684847b205701be15d292,1,83,83,166,30,2013-11-06 05:21:17,2013-11-06 01:58:52
b1d4d580e5021d5890d684847b205701be15d292...aba0fe683040f753f60a0f8030777d94aa9f58bf,7,71,118,189,55,2013-11-06 05:21:18,2013-11-06 01:19:45
aba0fe683040f753f60a0f8030777d94aa9f58bf...9470080762aecca5285d0f5cac4ae01540bbad4c,3,56,4,60,8,2013-11-06 07:01:19,2013-11-06 06:57:34
9470080762aecca5285d0f5cac4ae01540bbad4c...d378f5500ab2eef0779338336c6a95656505ebb8,2,92,30,122,11,2013-11-06 08:14:11,2013-11-02 09:22:26
d378f5500ab2eef0779338336c6a95656505ebb8...6fb191570ee72f087e8bb6b1d8f5eea0f585886c,1,9,4,13,4,2013-11-06 08:14:11,2013-11-06 07:30:48
6fb191570ee72f087e8bb6b1d8f5eea0f585886c...da344daa4023556f8abbef6d8ad87a16362b5861,2,109,4,113,4,2013-11-06 08:14:11,2013-11-06 07:53:00
da344daa4023556f8abbef6d8ad87a16362b5861...5614fd283a22d130cf5e09dade67be3f3c3a97c2,4,437,1,438,4,2013-11-06 16:47:06,2013-11-06 16:26:45
5614fd283a22d130cf5e09dade67be3f3c3a97c2...c1260716de634f0cc25ae884ffc481ed6b7d520a,1,3,0,3,1,2013-11-06 17:32:09,2013-11-06 17:32:09
c1260716de634f0cc25ae884ffc481ed6b7d520a...56d09177997c4571bdd7209898599670f3cfac9a,1,1,0,1,1,2013-11-06 17:50:56,2013-11-06 17:50:56
56d09177997c4571bdd7209898599670f3cfac9a...eb51b024c9b77527420014cdf7dbb292b5b9dd6b,1,20,18,38,8,2013-11-06 18:24:22,2013-11-06 18:19:36
eb51b024c9b77527420014cdf7dbb292b5b9dd6b...947a44d1ee6b253a5f31bb28616e0fa0303bd4aa,1,4,4,8,1,2013-11-06 23:11:59,2013-11-06 22:59:48
947a44d1ee6b253a5f31bb28616e0fa0303bd4aa...fc060dfc08f048511fe78e9df04ce4616171da34,31,4109,4373,8482,622,2013-11-07 01:11:44,2013-11-06 06:16:11
fc060dfc08f048511fe78e9df04ce4616171da34...8a5daaed42b5b3496fa482a6d7f4a680a4d68680,1,1,0,1,1,2013-11-07 01:29:03,2013-11-07 01:27:42
8a5daaed42b5b3496fa482a6d7f4a680a4d68680...ed8640b96463df8a8f9e4503095bd89916a120c5,1,0,6,6,1,2013-11-07 04:51:39,2013-11-07 04:51:39
ed8640b96463df8a8f9e4503095bd89916a120c5...36621402015485613888158dc7ba29f4ff92a7e2,18,138,193,331,26,2013-11-07 22:14:57,2013-11-07 22:14:57
36621402015485613888158dc7ba29f4ff92a7e2...909cabd36d779598763cc358979ecd85bb40d4d7,3,114,29,143,31,2013-11-08 06:03:19,2013-11-05 20:31:20
909cabd36d779598763cc358979ecd85bb40d4d7...d0efd5eefcc0aaf167c766513e152b74dd31bafe,2,65,4,69,4,2013-11-08 06:08:04,2013-11-05 20:27:56
d0efd5eefcc0aaf167c766513e152b74dd31bafe...97c7a4e3791d7cb05c3317cc5f0c49ab93810bf6,2,98,14,112,7,2013-11-08 06:08:05,2013-11-05 23:50:53
97c7a4e3791d7cb05c3317cc5f0c49ab93810bf6...3fe4491a6bf57ddeb312b8a30cf1706f6f1d2355,2,25,1,26,2,2013-11-08 06:08:05,2013-11-07 08:24:07
3fe4491a6bf57ddeb312b8a30cf1706f6f1d2355...b5af198f0d5b0f2b3ddb31ea12f700f3e0616271,2,48,4,52,6,2013-11-08 06:08:05,2013-11-08 00:18:06
b5af198f0d5b0f2b3ddb31ea12f700f3e0616271...27e9340b3c25b512e45213b39811098d07e12e3b,5,178,6,184,14,2013-11-08 06:08:22,2013-11-08 00:19:03
27e9340b3c25b512e45213b39811098d07e12e3b...1df3da361d62726bf1dafe629a7fca845b6a8733,1,7,1,8,3,2013-11-08 09:03:17,2013-11-06 23:00:10
1df3da361d62726bf1dafe629a7fca845b6a8733...5cfacec499e77e464a81c7ebe4b6f240da1e8748,1,2,0,2,1,2013-11-08 09:03:17,2013-11-06 23:01:01
5cfacec499e77e464a81c7ebe4b6f240da1e8748...98adc9e0383dc05efad168f30a0725cb67f5eda8,2,6,2,8,3,2013-11-08 09:03:17,2013-11-06 23:00:46
98adc9e0383dc05efad168f30a0725cb67f5eda8...9d0045856351e9db48ddf66f66e210d9cc53d24a,1,3,8,11,2,2013-11-08 09:03:17,2013-11-07 11:54:09
9d0045856351e9db48ddf66f66e210d9cc53d24a...ffa9d0a6db137cba4090e569b8ed4e25a711314e,1,2,2,4,1,2013-11-08 09:03:17,2013-11-07 18:43:42
ffa9d0a6db137cba4090e569b8ed4e25a711314e...aea76f0d5c43dc17f1319d0a45d2ce50fddf72e4,1,4,13,17,4,2013-11-08 09:03:18,2013-11-07 18:44:27
aea76f0d5c43dc17f1319d0a45d2ce50fddf72e4...907f71597affff552a4b79a1d913404fad68df11,1,2,2,4,2,2013-11-08 17:40:09,2013-11-08 17:40:09
907f71597affff552a4b79a1d913404fad68df11...e4181182ddd7100c844595ba138b63a72a593187,1,1,1,2,1,2013-11-08 19:32:51,2013-11-08 19:32:51
e4181182ddd7100c844595ba138b63a72a593187...6a0aff84c4176535d1141bb47f3c74996227100c,1,243,0,243,1,2013-11-08 20:02:37,2013-11-08 19:37:11
6a0aff84c4176535d1141bb47f3c74996227100c...ae2cdeb2de418bfc59e70cc1885c818864088c57,1,651,0,651,1,2013-11-08 20:21:34,2013-11-07 18:16:50
ae2cdeb2de418bfc59e70cc1885c818864088c57...95102a5afef6a6f36aefd3d3590e305cc972881d,1,1,1,2,1,2013-11-08 20:22:21,2013-11-08 20:22:21
95102a5afef6a6f36aefd3d3590e305cc972881d...44fe7b6dbb06b70aa9dd635897626b8f5db6615f,1,1,1,2,1,2013-11-08 20:54:06,2013-11-08 20:54:06
44fe7b6dbb06b70aa9dd635897626b8f5db6615f...9a8179d311c33a61082e12b4a4ef68c77ca7462b,1,25,25,50,1,2013-11-08 21:25:48,2013-11-08 21:17:13
9a8179d311c33a61082e12b4a4ef68c77ca7462b...dcdbcaf2b59243f1d4cda38ced20198896180dd1,1,1,1,2,1,2013-11-08 21:26:49,2013-11-08 21:26:49
dcdbcaf2b59243f1d4cda38ced20198896180dd1...2734b9f560dc34a23c127a4b31019ab8cc386996,1,1,1,2,1,2013-11-09 23:16:11,2013-11-07 17:08:32
2734b9f560dc34a23c127a4b31019ab8cc386996...c5c75386e47481eb455df704ef554d4eebc52dd4,1,1,1,2,1,2013-11-10 00:09:25,2013-11-10 00:09:25
c5c75386e47481eb455df704ef554d4eebc52dd4...fb483d56a7d8070f587c1d8b464f70c597c2f514,1,2,2,4,2,2013-11-10 23:27:13,2013-11-10 22:34:12
fb483d56a7d8070f587c1d8b464f70c597c2f514...a61b65d01b468502fe53d68818949d3fcc9f20f6,1,1,1,2,1,2013-11-11 00:09:15,2013-11-11 00:09:15
a61b65d01b468502fe53d68818949d3fcc9f20f6...9577702e8d2519c1a60f5ac4058e63bd7b919815,3,108,6,114,7,2013-11-12 00:17:34,2013-11-09 04:44:32
9577702e8d2519c1a60f5ac4058e63bd7b919815...4612705ec297bc6ba714cb7a98f1be6aff77c4b8,2,27,11,38,3,2013-11-12 01:05:43,2013-11-11 23:54:24
4612705ec297bc6ba714cb7a98f1be6aff77c4b8...fa82a31fa6c7ded00c8b7b0a62ba05d409fcbf00,1,1,1,2,1,2013-11-12 21:05:27,2013-11-09 15:19:30
fa82a31fa6c7ded00c8b7b0a62ba05d409fcbf00...e1254b266dfa2d4e3756e4317152dbdbcabe44be,2,19,1,20,4,2013-11-13 00:51:16,2013-11-12 23:53:06
e1254b266dfa2d4e3756e4317152dbdbcabe44be...f925e8caa6c51a7d45ca9ead30601ec2e9d4464c,2,78,5,83,8,2013-11-13 06:41:06,2013-11-10 01:25:33
f925e8caa6c51a7d45ca9ead30601ec2e9d4464c...dfe6400537f562f99ac0b4252c256f43bd90746c,1,2,11,13,3,2013-11-13 07:28:27,2013-11-12 12:22:12
dfe6400537f562f99ac0b4252c256f43bd90746c...8c18ef67cf19cb1956f31311487737abe9981135,1,1,0,1,1,2013-11-13 19:50:25,2013-11-05 21:01:03
8c18ef67cf19cb1956f31311487737abe9981135...37ac4724ba50ddbf2cd7da377579dad9bb07969b,1,2,0,2,1,2013-11-13 19:52:36,2013-11-05 21:02:23
37ac4724ba50ddbf2cd7da377579dad9bb07969b...717a6705e2f308befd4948ae2815c85dd10791c7,1,11,5,16,3,2013-11-13 20:20:59,2013-11-06 10:32:39
717a6705e2f308befd4948ae2815c85dd10791c7...96ad0c75947671396de88b0ecc86309a51be6947,1,10,4,14,1,2013-11-13 20:43:32,2013-11-13 20:42:36
96ad0c75947671396de88b0ecc86309a51be6947...5bf81bc111a866ec65ef86c01336911e577df5df,1,1,1,2,1,2013-11-13 20:51:29,2013-11-06 22:02:09
5bf81bc111a866ec65ef86c01336911e577df5df...40d1e10520a9914b57a8aafb7cef33a5f9625415,1,1,1,2,1,2013-11-13 20:55:25,2013-11-07 16:52:30
40d1e10520a9914b57a8aafb7cef33a5f9625415...a59976be18585033b29a9f323477f1194b53d3d7,1,1,1,2,1,2013-11-13 21:06:37,2013-11-07 21:57:00
a59976be18585033b29a9f323477f1194b53d3d7...f69ee170ed1eb2ba3fdde5d91760d2b139b41a4c,1,1,1,2,1,2013-11-13 21:21:50,2013-11-08 00:47:20
f69ee170ed1eb2ba3fdde5d91760d2b139b41a4c...afbed10febc4d54e2083d0d0a0eb241b079aa392,1,2,2,4,1,2013-11-13 21:24:08,2013-11-08 03:13:12
afbed10febc4d54e2083d0d0a0eb241b079aa392...bcdbfdfeae5ef16b603eece99aea73b94b5cc0db,1,4,4,8,5,2013-11-13 21:45:07,2013-11-13 21:44:28
bcdbfdfeae5ef16b603eece99aea73b94b5cc0db...bee56a82b0375e10ade4cbca375489f7ebf59b0c,1,4,3,7,4,2013-11-13 21:48:30,2013-11-08 18:43:40
bee56a82b0375e10ade4cbca375489f7ebf59b0c...b2137c9fdfd807e1c295e54b0aa6221c8dddb506,1,3,2,5,1,2013-11-13 21:58:04,2013-11-08 22:08:03
b2137c9fdfd807e1c295e54b0aa6221c8dddb506...bcc6e8d4f64a18039e0ed2eee0b54c17471b43e3,1,1,1,2,1,2013-11-13 22:43:34,2013-11-13 22:43:34
bcc6e8d4f64a18039e0ed2eee0b54c17471b43e3...89f435de847635e3ec339726e6f83cf3f0ee9091,3,38,19,57,14,2013-11-13 23:53:20,2013-11-13 20:56:54
89f435de847635e3ec339726e6f83cf3f0ee9091...4ab16aaaf762e9038803da1f967ac8cb6650727d,3,11,140,151,12,2013-11-14 07:25:09,2013-11-14 07:25:09
4ab16aaaf762e9038803da1f967ac8cb6650727d...d7ed885984d58d344350ae267f51e8096bb6bea6,1,21,15,36,4,2013-11-14 12:28:53,2013-11-14 12:07:01
d7ed885984d58d344350ae267f51e8096bb6bea6...ed9e570a12e01ea128a9348b1ed927d2c7ae56ae,1,17,6,23,7,2013-11-14 13:03:03,2013-11-08 23:34:50
ed9e570a12e01ea128a9348b1ed927d2c7ae56ae...5d632af92647161b862d071f8411f33855276ef9,1,6,6,12,1,2013-11-14 13:07:32,2013-11-08 23:59:31
5d632af92647161b862d071f8411f33855276ef9...dbc6696b68532adfbeca6b4c333dec33bacdd022,1,1,1,2,1,2013-11-14 13:10:29,2013-11-09 21:04:04
dbc6696b68532adfbeca6b4c333dec33bacdd022...938b2e1217b1075aaeea3b54dc5693cffc077c83,1,1,1,2,1,2013-11-14 13:12:36,2013-11-10 17:43:15
938b2e1217b1075aaeea3b54dc5693cffc077c83...f6fa7c9c9542839de4a6b5bb92bb53b14dcef11f,1,5,4,9,1,2013-11-14 13:16:47,2013-11-10 22:48:04
f6fa7c9c9542839de4a6b5bb92bb53b14dcef11f...089bf5f0e3810ec75e0e6aafd263377cddd7a38c,1,84,67,151,32,2013-11-14 13:22:39,2013-11-14 13:22:39
089bf5f0e3810ec75e0e6aafd263377cddd7a38c...b122194425108aa9daab4ec48efc812f300cdb54,1,1,1,2,1,2013-11-14 13:24:26,2013-11-09 10:49:13
b122194425108aa9daab4ec48efc812f300cdb54...b1366c32d4742acd66ebc6ed1e3cb3954c50b558,1,1,1,2,1,2013-11-14 13:27:11,2013-11-12 01:19:32
b1366c32d4742acd66ebc6ed1e3cb3954c50b558...cb8061c75cdbcacd34b2570223e0cc2cbd8edb61,1,2,2,4,1,2013-11-14 13:36:40,2013-11-12 03:26:24
cb8061c75cdbcacd34b2570223e0cc2cbd8edb61...8f283fe4738b607e3b82924007eeb30fad522137,1,10,5,15,3,2013-11-14 13:48:22,2013-11-12 10:23:36
8f283fe4738b607e3b82924007eeb30fad522137...fd7bca22e16b0ecbe1feaf49bab39d9a44b8df01,1,7,7,14,2,2013-11-14 14:00:06,2013-11-14 14:00:06
fd7bca22e16b0ecbe1feaf49bab39d9a44b8df01...c07f1e1c9f7e859b393457fec19b6a7756c51245,1,1,1,2,1,2013-11-14 14:04:09,2013-11-12 15:38:17
c07f1e1c9f7e859b393457fec19b6a7756c51245...9e5cd92fa90c9f0932b69d8df2ee3dfaec4c2cd7,1,1,1,2,1,2013-11-14 14:06:01,2013-11-12 18:48:03
9e5cd92fa90c9f0932b69d8df2ee3dfaec4c2cd7...f3d4fe62094467ec786efecf25296da81c6fa61c,1,1,1,2,1,2013-11-14 14:09:09,2013-11-13 12:27:58
f3d4fe62094467ec786efecf25296da81c6fa61c...4184ff8ff78e1fc42e5e32b88536b079ac4fa9cf,1,5,0,5,1,2013-11-14 14:13:22,2013-11-14 06:46:01
4184ff8ff78e1fc42e5e32b88536b079ac4fa9cf...977e2f55de7075b7dbfbab37e40a632bbaf0252f,1,2,2,4,2,2013-11-14 14:20:31,2013-11-14 14:20:31
977e2f55de7075b7dbfbab37e40a632bbaf0252f...c6016a6a85780ae68f71bbdd0eea391977225b7e,4,6,6,12,6,2013-11-14 14:47:01,2013-10-14 21:25:00
c6016a6a85780ae68f71bbdd0eea391977225b7e...04492ef2279e2be18162bef89b0a75992a400cae,1,1,16,17,2,2013-11-14 16:07:36,2013-11-12 01:25:57
04492ef2279e2be18162bef89b0a75992a400cae...94764ee08910726db1db7a1101c3001500306dea,2,8,8,16,8,2013-11-14 23:00:53,2013-11-14 22:18:55
94764ee08910726db1db7a1101c3001500306dea...8425e9fe383c17f6a5589c778658c5fc0570ae8f,4,11,2,13,5,2013-11-14 23:05:39,2013-11-14 22:37:53
8425e9fe383c17f6a5589c778658c5fc0570ae8f...c785918cbd245cc8ecf9a38e373b121c4e68a55b,1,11,9,20,2,2013-11-15 04:53:30,2013-11-15 01:09:05
c785918cbd245cc8ecf9a38e373b121c4e68a55b...90f87072e83234ae366cfeb3c281503c31dad738,11,434,73,507,61,2013-11-15 04:59:50,2013-11-14 21:50:36
90f87072e83234ae366cfeb3c281503c31dad738...40e34a924b629280eb572e957cc8a2cf4f88394c,1,0,52,52,1,2013-11-15 05:22:11,2013-11-15 05:13:39
40e34a924b629280eb572e957cc8a2cf4f88394c...f4fcaa875766dbe11b82e38839f6ef196bcac6ad,1,14,2,16,2,2013-11-15 05:38:53,2013-11-15 05:33:31
f4fcaa875766dbe11b82e38839f6ef196bcac6ad...a3eb6baf58f779c0ac9780eb8949d11fba40e483,2,44,2,46,3,2013-11-15 06:33:20,2013-11-15 06:33:20
a3eb6baf58f779c0ac9780eb8949d11fba40e483...88ce00a3cf7362d93f583679e5d59889da6b32d9,1,2,2,4,1,2013-11-15 08:03:03,2013-11-15 08:03:03
88ce00a3cf7362d93f583679e5d59889da6b32d9...61943276f026e632dccae6405a05f79d486ed898,1,0,0,0,0,2013-11-15 21:46:13,2013-11-14 23:23:24
61943276f026e632dccae6405a05f79d486ed898...de2919cb9aa7491657cdeb32fa4fffe88255129a,1,1,1,2,1,2013-11-18 11:55:30,2013-11-18 11:55:30
de2919cb9aa7491657cdeb32fa4fffe88255129a...ac56d1c9d90e0fc3996198a386f7599deeae65c6,1,6,5,11,1,2013-11-18 12:49:19,2013-11-17 03:56:23
ac56d1c9d90e0fc3996198a386f7599deeae65c6...8f1e3606ddff6991a93d42e6580d9e1e0f99112e,1,3,3,6,1,2013-11-18 12:58:53,2013-11-18 12:58:53
8f1e3606ddff6991a93d42e6580d9e1e0f99112e...23ba28789790febf1f5ec7b46a8d3306cdf5ce72,1,21,18,39,14,2013-11-18 15:03:35,2013-11-07 19:29:44
23ba28789790febf1f5ec7b46a8d3306cdf5ce72...29274e1d8d8b3c6a9100758da4a3c78222e77af1,1,28,16,44,5,2013-11-18 16:21:59,2013-11-18 16:21:59
29274e1d8d8b3c6a9100758da4a3c78222e77af1...751f058f3095e5c9487925a92ee7cbdd15d043ba,1,1,1,2,1,2013-11-19 00:14:09,2013-11-19 00:14:09
751f058f3095e5c9487925a92ee7cbdd15d043ba...b9fa5c5a6781f4e1ec337f27d55c69db491a6555,1,1,0,1,1,2013-11-19 22:50:24,2013-11-19 22:45:11
b9fa5c5a6781f4e1ec337f27d55c69db491a6555...aa0b11d79407b67e8d485d20b6abd82c0a0e9614,1,2,2,4,2,2013-11-20 11:00:01,2013-11-15 06:16:31
aa0b11d79407b67e8d485d20b6abd82c0a0e9614...f2453eabb35b05fc3ba83b49b2e236e3c4c092fb,1,1,1,2,1,2013-11-20 11:02:30,2013-11-15 10:36:36
f2453eabb35b05fc3ba83b49b2e236e3c4c092fb...cad5a367c3ea38c249211e56bfb4779a19b31d38,1,8,1,9,3,2013-11-20 11:18:21,2013-11-20 11:18:21
cad5a367c3ea38c249211e56bfb4779a19b31d38...c0e10683a6ecbf6682920cd2c2e173ab148dabee,1,3,3,6,3,2013-11-20 11:21:09,2013-11-17 08:38:49
c0e10683a6ecbf6682920cd2c2e173ab148dabee...8a9816e06ba1c8d60c3b5f5e0cb98cf2ec1112d5,1,1,1,2,1,2013-11-20 11:25:20,2013-11-18 13:12:50
8a9816e06ba1c8d60c3b5f5e0cb98cf2ec1112d5...b4cf8483d75c6648ff21d25c38b1942cea360579,1,1,1,2,1,2013-11-20 11:26:57,2013-11-18 16:19:06
b4cf8483d75c6648ff21d25c38b1942cea360579...5f9121ad560d45ee638ad19f95d256ea45b064be,1,1,1,2,1,2013-11-20 11:30:45,2013-11-18 16:52:48
5f9121ad560d45ee638ad19f95d256ea45b064be...999fa446169461ed3a7d68dfd4084ad7d8c9335e,1,1,1,2,1,2013-11-20 11:31:56,2013-11-18 16:56:57
999fa446169461ed3a7d68dfd4084ad7d8c9335e...3ceb6ab47797d98ea5fb423835923338d90caaca,1,1,1,2,1,2013-11-20 11:37:00,2013-11-19 06:09:48
3ceb6ab47797d98ea5fb423835923338d90caaca...043500fb27ed572f197e81b044518bd159c303e1,1,1,1,2,1,2013-11-20 11:38:29,2013-11-19 14:08:51
043500fb27ed572f197e81b044518bd159c303e1...dc027f22e55c5a41837341403f90cd5bdbdb7c80,1,1,1,2,1,2013-11-20 14:10:23,2013-11-19 14:11:00
dc027f22e55c5a41837341403f90cd5bdbdb7c80...c77dd040b44d92135e68b7d4a3c1a778abd2bc62,1,2,2,4,1,2013-11-20 14:21:49,2013-11-19 14:43:27
c77dd040b44d92135e68b7d4a3c1a778abd2bc62...b95fd53c6ee4c25d123f9e86f4bf5fbc378d181d,1,22,5,27,10,2013-11-20 14:30:37,2013-11-19 17:34:19
b95fd53c6ee4c25d123f9e86f4bf5fbc378d181d...334303e48523fd43efe9b37023d16aa73234e487,1,2,2,4,2,2013-11-20 14:32:30,2013-11-20 07:25:27
334303e48523fd43efe9b37023d16aa73234e487...68d71bbc01d4fc1a1124039322ce5ec946f4d26f,1,1,1,2,1,2013-11-20 21:02:02,2013-11-14 10:46:37
68d71bbc01d4fc1a1124039322ce5ec946f4d26f...c47abd0dd7490576f4b84ee51ebaca385c1036da,2,33,7,40,2,2013-11-20 21:58:54,2013-11-20 19:04:38
c47abd0dd7490576f4b84ee51ebaca385c1036da...7067a8fb0b18d5b5489006e1960cee721a88b4d2,2,48,4,52,7,2013-11-20 22:08:03,2013-11-14 20:36:07
7067a8fb0b18d5b5489006e1960cee721a88b4d2...6b8bbe4d90640542eed5607a8c91f6b977b1d6c0,5,87,26,113,14,2013-11-20 22:15:56,2013-11-15 04:45:22
6b8bbe4d90640542eed5607a8c91f6b977b1d6c0...ec3c4f94c79e23c29abcde6e1d2f6eaf05e0664c,4,30,34,64,9,2013-11-20 23:12:39,2013-11-20 04:42:38
ec3c4f94c79e23c29abcde6e1d2f6eaf05e0664c...1d50663b38ba042e8d748ffa6d48cfb5e93cfd7e,3,6,6,12,4,2013-11-21 01:54:07,2013-11-15 05:09:37
1d50663b38ba042e8d748ffa6d48cfb5e93cfd7e...7874a4d007f6e664f9d26e36ad4ab6e151b51ed7,1,4,4,8,4,2013-11-21 15:29:18,2013-11-21 15:29:18
7874a4d007f6e664f9d26e36ad4ab6e151b51ed7...a4e6d962d78b26f5112d48c4f88c1e6234d0cae7,2,27,0,27,3,2013-11-21 17:46:33,2013-10-28 16:42:47
a4e6d962d78b26f5112d48c4f88c1e6234d0cae7...f6ecf9a3c9090593faf5fa50586c99a56b51c776,2,14,2,16,3,2013-11-21 17:51:02,2013-11-21 00:45:39
f6ecf9a3c9090593faf5fa50586c99a56b51c776...6288cf5ca471b0615a026fdb4db3ba242c9d8f88,2,57,1,58,2,2013-11-21 17:52:34,2013-10-16 18:35:42
6288cf5ca471b0615a026fdb4db3ba242c9d8f88...6b5772bbbdbf908cd8b9ec2dc65d4404b836d248,1,11,0,11,1,2013-11-21 20:25:41,2013-11-21 14:26:50
6b5772bbbdbf908cd8b9ec2dc65d4404b836d248...e3ceb50b73d74bc8fb67072c3b10414d930ee177,1,1,1,2,1,2013-11-21 20:27:27,2013-11-20 22:17:11
e3ceb50b73d74bc8fb67072c3b10414d930ee177...e33c3651440b81b8a1b2050e380c55732140d575,1,49,50,99,29,2013-11-21 20:37:57,2013-11-20 18:11:51
e33c3651440b81b8a1b2050e380c55732140d575...0a3481e23affe690295fc0bb26cb6597ed56155d,1,1,1,2,1,2013-11-21 20:41:48,2013-11-21 20:12:23
0a3481e23affe690295fc0bb26cb6597ed56155d...ba1b47f85b771f8221db58a46b58429375b0ee6e,2,3,3,6,2,2013-11-21 20:41:57,2013-11-21 20:41:34
ba1b47f85b771f8221db58a46b58429375b0ee6e...0cd7e8f22721f62b62440bb059ae764ebbe7b42a,7,93,102,195,22,2013-11-22 01:47:44,2013-11-19 03:13:28
0cd7e8f22721f62b62440bb059ae764ebbe7b42a...76e4db6f3d15199ac1fbe85f9cfa6079a1c4fa56,2,57,4,61,6,2013-11-22 01:47:55,2013-11-16 05:43:08
76e4db6f3d15199ac1fbe85f9cfa6079a1c4fa56...062fbed8fc3f7bc55433f8c6915c27520e6f63c5,2,54,5,59,7,2013-11-22 01:48:07,2013-11-18 21:20:22
062fbed8fc3f7bc55433f8c6915c27520e6f63c5...6760d7a315d7ea5cbd4f8ab74b200f754a2041f4,2,37,0,37,5,2013-11-22 01:48:15,2013-11-19 05:21:48
6760d7a315d7ea5cbd4f8ab74b200f754a2041f4...3fbb25e25cc9bd1ddad8efab9f43749735e53454,1,2,2,4,2,2013-11-22 01:48:21,2013-11-22 01:26:05
3fbb25e25cc9bd1ddad8efab9f43749735e53454...c42d0a041890b39fc98afd357ec1307a3a36208d,2,60,15,75,10,2013-11-22 04:37:01,2013-11-10 21:36:47
c42d0a041890b39fc98afd357ec1307a3a36208d...579242346c4202ea58fc2cae6df232289cbea0bb,3,9,9,18,6,2013-11-22 05:53:09,2013-11-21 22:30:50
579242346c4202ea58fc2cae6df232289cbea0bb...0a7cbb33b06778833a4d99b1868cc07690a827a7,2,53,16,69,6,2013-11-22 06:20:11,2013-11-22 05:54:42
0a7cbb33b06778833a4d99b1868cc07690a827a7...e6521e7491242504250b57dd0ee66af49e653c33,2,72,34,106,9,2013-11-22 06:20:11,2013-11-22 05:54:59
e6521e7491242504250b57dd0ee66af49e653c33...9e89a31b129e40c805178535c244899ffafb77d8,2,10,1,11,2,2013-11-22 06:51:26,2013-11-20 10:35:27
9e89a31b129e40c805178535c244899ffafb77d8...4d16472b918a3482942d76f1e273a5aa01f65e83,2,50,1,51,3,2013-11-22 06:57:15,2013-11-14 14:42:35
4d16472b918a3482942d76f1e273a5aa01f65e83...6f1050df4fa885bd59ce85adbef7350ea93911a3,2,30,3,33,5,2013-11-22 07:09:46,2013-11-13 20:24:15
6f1050df4fa885bd59ce85adbef7350ea93911a3...0421cb4200e672818ed10996e92311404c150c3a,2,77,2,79,3,2013-11-22 07:15:15,2013-11-12 23:32:52
0421cb4200e672818ed10996e92311404c150c3a...40647b179c473f3f470bb1b3237d6f006269582f,2,673,662,1335,93,2013-11-22 08:19:08,2013-10-30 19:14:00
40647b179c473f3f470bb1b3237d6f006269582f...84c408ce63859e81fb4e900683edcc0cb8188890,1,1,1,2,1,2013-11-22 08:52:57,2013-11-22 08:52:57
84c408ce63859e81fb4e900683edcc0cb8188890...a3172a285fd74b5aa6c8d68a4988c767c06f549c,2,43,6,49,8,2013-11-22 13:45:55,2013-11-22 13:22:41
a3172a285fd74b5aa6c8d68a4988c767c06f549c...0f7c4ca671ac807c53510372bb24d5cfec0bc7f5,1,1,1,2,1,2013-11-22 15:03:12,2013-11-22 13:57:13
0f7c4ca671ac807c53510372bb24d5cfec0bc7f5...16febf8357c985ab4380ad2f55f3fc966e842f5c,1,83,0,83,1,2013-11-22 17:03:40,2013-11-22 17:03:40
16febf8357c985ab4380ad2f55f3fc966e842f5c...3efdeebcb7ef112e17dc9bf2b7e8994eae41c4da,1,2,2,4,2,2013-11-22 17:05:42,2013-11-22 17:05:42
3efdeebcb7ef112e17dc9bf2b7e8994eae41c4da...1ca98b2c091d2eb9064cc015d640f66a1fe5bfb4,1,3,3,6,1,2013-11-22 20:43:52,2013-11-22 20:43:52
1ca98b2c091d2eb9064cc015d640f66a1fe5bfb4...bcf12e70e5350595124034c75f6a04e0725205c8,4,4,4,8,4,2013-11-22 21:16:23,2013-11-22 21:16:23
bcf12e70e5350595124034c75f6a04e0725205c8...84e0eea1645521f6a990a4dabeb53407db86eda2,2,2,27,29,3,2013-11-23 00:27:05,2013-11-21 19:31:24
84e0eea1645521f6a990a4dabeb53407db86eda2...a090400f09d7993d102f527609879cdc74abae60,2,29,3,32,3,2013-11-23 01:02:21,2013-11-23 00:34:33
a090400f09d7993d102f527609879cdc74abae60...2efe82309ac8ff4f67df8b6e40a539ea31e15804,2,50,3,53,6,2013-11-24 03:05:04,2013-11-24 02:44:14
2efe82309ac8ff4f67df8b6e40a539ea31e15804...66b0fcd3c00075dade7c090f425e80eae2e30d43,1,56,56,112,6,2013-11-25 14:15:24,2013-11-25 14:15:24
66b0fcd3c00075dade7c090f425e80eae2e30d43...b837a31afac0b7357759df383aadb266903f9269,1,18,8,26,3,2013-11-25 14:33:51,2013-11-25 14:33:51
b837a31afac0b7357759df383aadb266903f9269...a2809dacc44c14513e5a7737865ce682964ffe7e,1,1,1,2,1,2013-11-25 15:55:24,2013-11-25 15:55:24
a2809dacc44c14513e5a7737865ce682964ffe7e...eed2333298412fbad04eda97ded3487c845b9eb9,3,2230,2180,4410,561,2013-11-25 20:00:50,2013-11-25 18:40:52
eed2333298412fbad04eda97ded3487c845b9eb9...8383ecfcdfae662e0f3269d333538a55540d9270,1,30,10,40,5,2013-11-25 20:18:36,2013-11-25 20:16:30
8383ecfcdfae662e0f3269d333538a55540d9270...3fcd228441a70bd69090aa6d5c01ad194a4dd10c,4,139,0,139,4,2013-11-25 21:09:50,2013-11-23 00:41:17
3fcd228441a70bd69090aa6d5c01ad194a4dd10c...ffd075b44010102e628ce3ade9a54bfde80fdd76,6,108,8,116,9,2013-11-25 23:19:28,2013-11-20 00:50:23
ffd075b44010102e628ce3ade9a54bfde80fdd76...b08427dde9307bb442e3632f24d7b7054a50350e,1,4,1,5,1,2013-11-26 02:04:35,2013-11-26 02:04:35
b08427dde9307bb442e3632f24d7b7054a50350e...c2e45c769ef7a45f2bd14870236fd8e8bed38246,1,1,1,2,1,2013-11-26 06:45:47,2013-10-14 07:03:11
c2e45c769ef7a45f2bd14870236fd8e8bed38246...c6bd58eb587a825bddee06a91ecd4e747a750c8c,1,1,1,2,1,2013-11-26 06:45:48,2013-11-11 15:04:02
c6bd58eb587a825bddee06a91ecd4e747a750c8c...7a91d7fa7e9e5156c728288e6ec66512fb70a693,1,2,2,4,2,2013-11-26 06:46:39,2013-11-25 22:57:02
7a91d7fa7e9e5156c728288e6ec66512fb70a693...e8d8c7a8d773ec662c3d005bc434f356f96fd807,1,1,1,2,1,2013-11-26 06:56:38,2013-11-25 22:44:34
e8d8c7a8d773ec662c3d005bc434f356f96fd807...b3f2a208322c84886a19dcf2faa8c6ecc5e7f1bb,1,0,80,80,1,2013-11-26 09:36:13,2013-11-26 09:36:13
b3f2a208322c84886a19dcf2faa8c6ecc5e7f1bb...5bd6596856c9f88c0ce3d96ff1ed4daa082cbe29,2,179,189,368,37,2013-11-26 13:22:29,2013-11-22 00:50:23
5bd6596856c9f88c0ce3d96ff1ed4daa082cbe29...68ceb17272bdd2ebc838565070973d93704f4427,2,56,9,65,7,2013-11-26 20:36:41,2013-10-18 12:42:55
68ceb17272bdd2ebc838565070973d93704f4427...333523483f3ce6dd3177b697a5e5a7177ca364c8,9,550,339,889,71,2013-11-26 22:29:38,2013-11-25 23:40:18
333523483f3ce6dd3177b697a5e5a7177ca364c8...947562220d7d1c851f138a816f7530738b97e7b6,1,1,1,2,1,2013-11-27 01:38:23,2013-11-27 01:37:49
947562220d7d1c851f138a816f7530738b97e7b6...736c8fbbae57a209f4ba570e38cc3bd0745a9569,4,53,47,100,12,2013-11-27 02:31:27,2013-11-26 19:36:36
736c8fbbae57a209f4ba570e38cc3bd0745a9569...bcca80548dde85ffe3838c943ba8e5c2deb1c721,1,9,0,9,3,2013-11-27 02:34:11,2013-11-27 00:58:59
bcca80548dde85ffe3838c943ba8e5c2deb1c721...7ab5098c14ee4f195dbfe2681e402fe2dfeacd78,1,33,0,33,1,2013-11-27 09:58:59,2013-11-27 09:58:59
7ab5098c14ee4f195dbfe2681e402fe2dfeacd78...38fb542838324dc0e66b2f5eced70a4b5e682abc,1,1,1,2,1,2013-11-27 10:04:59,2013-11-27 10:04:59
38fb542838324dc0e66b2f5eced70a4b5e682abc...450b3a546044a6fe31400c1411fcd24dbd4ed0b3,1,3,3,6,1,2013-11-27 20:21:06,2013-11-27 20:21:06
450b3a546044a6fe31400c1411fcd24dbd4ed0b3...7ab73190b79da069be2fa02f8c1bb29e40c9bae9,1,4,0,4,1,2013-11-27 22:35:09,2013-11-21 23:54:39
7ab73190b79da069be2fa02f8c1bb29e40c9bae9...e41e445b513f97b4c42b51f3bf67835f28d65b48,1,5,1,6,2,2013-11-27 22:41:10,2013-11-22 05:57:53
e41e445b513f97b4c42b51f3bf67835f28d65b48...1497c6c1fb9783855802d2a81b6e3ec9b9b6bb66,1,1,1,2,1,2013-11-27 22:41:53,2013-11-23 19:45:26
1497c6c1fb9783855802d2a81b6e3ec9b9b6bb66...cda061f723a78789c33988790d06561b14f55e89,1,1,1,2,1,2013-11-27 22:48:02,2013-11-23 23:18:54
cda061f723a78789c33988790d06561b14f55e89...1014e523493f9b8c8bf62c0ad104fdfcfde60ae2,1,1,1,2,1,2013-11-27 22:52:10,2013-11-27 22:52:10
1014e523493f9b8c8bf62c0ad104fdfcfde60ae2...3abfb4ef510ea68b9821edbd63c94d5e513f11db,1,4,2,6,3,2013-11-27 22:54:45,2013-11-24 23:25:35
3abfb4ef510ea68b9821edbd63c94d5e513f11db...68dd621082b6ccd347cf61e6b9f89025f4fe92dc,1,1,1,2,1,2013-11-27 22:59:13,2013-11-25 11:08:30
68dd621082b6ccd347cf61e6b9f89025f4fe92dc...6f40c88f47c08eddba1e44b15fae2e844d15852b,1,15,2,17,2,2013-11-27 23:06:19,2013-11-25 15:13:41
6f40c88f47c08eddba1e44b15fae2e844d15852b...28d00945ba90ebe6a82bf5eba93d2b3bda805af0,1,2,2,4,2,2013-11-27 23:17:28,2013-11-26 11:35:40
28d00945ba90ebe6a82bf5eba93d2b3bda805af0...7f33e1ca89c4127c4171510413c1ed8c7270a418,1,1,1,2,1,2013-11-27 23:19:02,2013-11-26 15:34:07
7f33e1ca89c4127c4171510413c1ed8c7270a418...1a15c01b649d868adfd655ec0790c2b2b4a5107d,1,1,1,2,1,2013-11-27 23:20:09,2013-11-27 08:15:46
1a15c01b649d868adfd655ec0790c2b2b4a5107d...753687e5c2d601823e08791288ab65ee6b86770d,1,1,1,2,1,2013-11-27 23:21:46,2013-11-27 16:30:28
753687e5c2d601823e08791288ab65ee6b86770d...1a8d3c8b3a0d662fb3b8f2765102e50f7cd1c0a4,2,16,1,17,2,2013-11-28 12:16:07,2013-11-28 12:11:57
1a8d3c8b3a0d662fb3b8f2765102e50f7cd1c0a4...d0f8bd30a6c53f00c1206021f68330cb5e8eda37,1,4,4,8,3,2013-12-02 19:55:34,2013-12-02 09:44:27
d0f8bd30a6c53f00c1206021f68330cb5e8eda37...05ef1bd8532bd093ca49e9ccea070b1c2bfa0880,2,4,11,15,12,2013-12-02 21:20:07,2013-11-26 21:26:10
05ef1bd8532bd093ca49e9ccea070b1c2bfa0880...ddff347b91df7f13b6d1118410cfa15bf99b456d,1,3,0,3,1,2013-12-02 22:19:46,2013-11-29 20:45:27
ddff347b91df7f13b6d1118410cfa15bf99b456d...4ee0687f3fe6d7063ccdd1023a5ecd6424f77c76,1,1,0,1,1,2013-12-02 22:19:56,2013-12-02 03:56:03
4ee0687f3fe6d7063ccdd1023a5ecd6424f77c76...97fc84c151893c4e66477334dc3d25821cc22280,1,1,1,2,1,2013-12-02 22:20:06,2013-12-02 18:50:06
97fc84c151893c4e66477334dc3d25821cc22280...55c30e1be6d7b5c182bd56e508d10e56360e5517,1,1,1,2,1,2013-12-02 22:20:14,2013-12-02 19:26:20
55c30e1be6d7b5c182bd56e508d10e56360e5517...04d5a5072fe45d5aa8ec9c027bae9d29ee56c2d1,1,1,1,2,1,2013-12-02 22:43:44,2013-12-02 22:43:44
04d5a5072fe45d5aa8ec9c027bae9d29ee56c2d1...5a8d9acacbb8a2b9175da196cbaf8ff93bac28c8,1,12,0,12,1,2013-12-03 00:23:59,2013-12-03 00:23:59
5a8d9acacbb8a2b9175da196cbaf8ff93bac28c8...09271a8ab945df19ec3aacf43f60c458fafd82fd,1,40,2,42,3,2013-12-03 06:51:15,2013-12-02 21:51:09
09271a8ab945df19ec3aacf43f60c458fafd82fd...fd4b99936e6ef14e9ff04e10a95410d31f063d71,1,2,1,3,1,2013-12-03 06:51:15,2013-12-03 05:39:33
fd4b99936e6ef14e9ff04e10a95410d31f063d71...81b81856ee43d2876927c4e1f774affa87e99707,1,12,10,22,6,2013-12-03 13:35:09,2013-12-03 10:39:09
81b81856ee43d2876927c4e1f774affa87e99707...1169b5445691e1495354d235a3badf05240e3904,2,11,1,12,2,2013-12-03 17:45:06,2013-10-25 19:52:49
1169b5445691e1495354d235a3badf05240e3904...689dfb167924a61aef444ce7587fb987d8080990,1,17,16,33,2,2013-12-03 19:10:48,2013-12-02 23:20:50
689dfb167924a61aef444ce7587fb987d8080990...bf1972dc1e8ffbeaddfa53df1d49bc5a2177f09c,2,58,1,59,2,2013-12-03 22:45:30,2013-11-24 20:13:51
bf1972dc1e8ffbeaddfa53df1d49bc5a2177f09c...bb36bc7edf4f87a41d4269b619fc88ba662ef4df,1,1,1,2,1,2013-12-03 23:44:13,2013-12-03 23:38:05
bb36bc7edf4f87a41d4269b619fc88ba662ef4df...7401c70718318a59f88580558dadd0eddc77024a,1,4,4,8,3,2013-12-03 23:44:13,2013-12-03 23:39:20
7401c70718318a59f88580558dadd0eddc77024a...4a401bbcf3c3e47fec94d33607032ce931d25fdb,1,3,3,6,3,2013-12-03 23:44:13,2013-12-03 23:39:36
4a401bbcf3c3e47fec94d33607032ce931d25fdb...023765c5939cc52e5866186ef897ad0274068460,1,4,3,7,3,2013-12-03 23:44:56,2013-12-03 23:44:56
023765c5939cc52e5866186ef897ad0274068460...5d6482bb3b1e640a24fea7ffa5bd7667ce02f8ad,1,3,1,4,2,2013-12-03 23:49:18,2013-12-03 17:34:50
5d6482bb3b1e640a24fea7ffa5bd7667ce02f8ad...84187b6d94179edf04512038f68c14f34a8e6219,2,21,3,24,4,2013-12-03 23:49:18,2013-12-03 17:58:30
84187b6d94179edf04512038f68c14f34a8e6219...267fcc999c43bf2b6a50bc531e5f7c2f356fcb96,1,1,2,3,2,2013-12-03 23:49:18,2013-12-03 18:58:54
267fcc999c43bf2b6a50bc531e5f7c2f356fcb96...fd2371cfc23dc4039f179dd32d31812fea4a4340,1,1,1,2,1,2013-12-03 23:49:19,2013-12-03 19:22:16
fd2371cfc23dc4039f179dd32d31812fea4a4340...041057232206e07164ed0aa4ecb9abe0f3fc23f4,1,6,0,6,1,2013-12-03 23:49:19,2013-12-03 20:14:26
041057232206e07164ed0aa4ecb9abe0f3fc23f4...6127528b5008a507966c7f1a1030db27ca2fbc0b,4,8,4,12,4,2013-12-03 23:49:19,2013-12-03 20:15:36
6127528b5008a507966c7f1a1030db27ca2fbc0b...d0192b31a3e87b9d14dd2738b0529494449174b9,1,1,1,2,1,2013-12-03 23:49:19,2013-12-03 21:48:39
d0192b31a3e87b9d14dd2738b0529494449174b9...338f949259dddfaec74a982ca98a0f07559ee64e,1,4,1,5,2,2013-12-03 23:49:19,2013-12-03 22:10:53
338f949259dddfaec74a982ca98a0f07559ee64e...7615723547d156be1c0419b7f5a4639f6c1fa137,1,9,6,15,8,2013-12-04 00:07:13,2013-12-04 00:07:13
7615723547d156be1c0419b7f5a4639f6c1fa137...9481d69d1cd4c5431a60bcb2c0cfa5e01dcbb34f,1,1,1,2,1,2013-12-04 03:32:32,2013-12-04 01:22:00
9481d69d1cd4c5431a60bcb2c0cfa5e01dcbb34f...9a81b8668a9ee13cdea305d85325efa3efdfc01e,2,4,1,5,2,2013-12-04 03:32:32,2013-12-04 01:55:52
9a81b8668a9ee13cdea305d85325efa3efdfc01e...2d0f6ccba896fe34141d6d4f59eef6fba580c5c2,2,21,3,24,4,2013-12-04 17:45:20,2013-11-28 06:01:22
2d0f6ccba896fe34141d6d4f59eef6fba580c5c2...d3c486dd6dfa8d5dca32a3e28aa685fb7260c878,2,11,0,11,3,2013-12-04 18:11:29,2013-11-06 14:01:10
d3c486dd6dfa8d5dca32a3e28aa685fb7260c878...4ac6424e8764442915d6aefff7331974c5f2f723,1,1,1,2,1,2013-12-04 19:28:32,2013-12-03 01:32:24
4ac6424e8764442915d6aefff7331974c5f2f723...f01087f802839637843115cbcf99702e09d866f6,1,11,0,11,2,2013-12-04 22:01:34,2013-12-04 11:00:42
f01087f802839637843115cbcf99702e09d866f6...fbc5cf514bea49f12c1ff1ff331c7cf54e92b670,1,5,5,10,3,2013-12-04 22:36:40,2013-11-26 21:54:38
fbc5cf514bea49f12c1ff1ff331c7cf54e92b670...280b5ce3c069dc55d2c101a533390a1cdaddf493,1,3,2,5,2,2013-12-04 22:36:41,2013-11-27 16:58:20
280b5ce3c069dc55d2c101a533390a1cdaddf493...1e7675ad4c6dd472755be65fb21c1788afec5856,1,0,33,33,1,2013-12-04 22:36:41,2013-11-27 23:38:47
1e7675ad4c6dd472755be65fb21c1788afec5856...b38a2287f239f6b31a7476e6767bc66dafb2a693,1,1,1,2,1,2013-12-04 22:36:42,2013-11-28 09:24:41
b38a2287f239f6b31a7476e6767bc66dafb2a693...e8f4305e9d1587512dbef44733fd162caa1cef59,1,2,2,4,1,2013-12-04 22:36:42,2013-11-28 10:14:51
e8f4305e9d1587512dbef44733fd162caa1cef59...d802ed1b3680cfc1751777fac465b92ee29944dc,2,7,2,9,4,2013-12-04 23:29:19,2013-12-04 22:33:58
d802ed1b3680cfc1751777fac465b92ee29944dc...93901bdde4bb9f0ba114ebb33b8885808e1823e1,2,28,1,29,4,2013-12-05 00:26:40,2013-11-28 04:18:51
93901bdde4bb9f0ba114ebb33b8885808e1823e1...b6d5439343b9801f7f2a009d0de09cba9aa21a1d,2,26,1,27,3,2013-12-05 06:49:11,2013-12-05 00:25:49
b6d5439343b9801f7f2a009d0de09cba9aa21a1d...21e48abbc1e75ace1b6b99c7b19f538d4e792068,1,1,1,2,2,2013-12-05 06:53:54,2013-12-05 06:53:28
21e48abbc1e75ace1b6b99c7b19f538d4e792068...0e50810c53428f4c1f5bfdba9599df54cb7a6c6e,2,29,0,29,3,2013-12-05 07:26:56,2013-11-30 02:02:00
0e50810c53428f4c1f5bfdba9599df54cb7a6c6e...958d3d56b1899a2cfc7b18c0292e5a1d8c64d0a5,2,95,19,114,19,2013-12-05 15:54:19,2013-12-04 17:49:02
958d3d56b1899a2cfc7b18c0292e5a1d8c64d0a5...04a570d31cf05731e44a8bd9bde0fcc9c0fbff86,1,55,0,55,1,2013-12-05 17:36:14,2013-12-05 01:52:17
04a570d31cf05731e44a8bd9bde0fcc9c0fbff86...39c5ffb2a61c607810beed8cbb0f8dc19745045f,1,5,1,6,1,2013-12-05 22:06:28,2013-12-05 22:06:28
39c5ffb2a61c607810beed8cbb0f8dc19745045f...2adbcf189b692bfcfa9f99760f2ba9a84eee1e0f,1,2,2,4,1,2013-12-05 22:06:38,2013-12-05 22:06:38
2adbcf189b692bfcfa9f99760f2ba9a84eee1e0f...09648e4888896948b733febb9c8652a36f8a22dd,1,1,1,2,1,2013-12-05 22:17:07,2013-11-29 11:40:43
09648e4888896948b733febb9c8652a36f8a22dd...d070450cd2b3b3a3aa34b69d3fa1f4cc3be025dd,2,112,17,129,10,2013-12-05 23:37:37,2013-12-04 00:16:08
d070450cd2b3b3a3aa34b69d3fa1f4cc3be025dd...a55c1e79cf8894c2d348d4cf911b28dcc8a6995e,1,22,3,25,4,2013-12-06 00:13:04,2013-12-05 23:56:52
a55c1e79cf8894c2d348d4cf911b28dcc8a6995e...785a5fd7c182f39f4ae80d603c0098bc63ce41a4,1,12,12,24,12,2013-12-06 00:43:11,2013-12-04 21:02:28
785a5fd7c182f39f4ae80d603c0098bc63ce41a4...2dbb6f9a54eb5ff5847eed11c85ac4cf119eb41c,2,15,2,17,3,2013-12-06 01:14:05,2013-10-19 19:41:06
2dbb6f9a54eb5ff5847eed11c85ac4cf119eb41c...b0972a2e75909e41dbac6e4413ada7df2d51df3a,7,138,23,161,25,2013-12-06 06:16:25,2013-11-27 03:55:02
b0972a2e75909e41dbac6e4413ada7df2d51df3a...c98ef94706f3a1d04831a6f6874893f01c445226,1,63,0,63,1,2013-12-06 17:46:01,2013-12-06 17:19:07
c98ef94706f3a1d04831a6f6874893f01c445226...acaac21fd175254b23d0f8a3b736c18a92873564,1,1,1,2,1,2013-12-06 17:46:25,2013-12-06 17:24:21
acaac21fd175254b23d0f8a3b736c18a92873564...3602c9785b70707edbfcb15eaee4bc4d1258ab89,1,3,22,25,4,2013-12-06 18:13:48,2013-12-06 18:08:46
3602c9785b70707edbfcb15eaee4bc4d1258ab89...dbf8c3c745dc6a91bb3fa678d7ce7602e8753141,1,12,12,24,12,2013-12-06 18:14:08,2013-12-06 18:11:33
dbf8c3c745dc6a91bb3fa678d7ce7602e8753141...78ba429e6a3269594afbffcca2980e76281c43e0,1,0,6,6,1,2013-12-06 18:14:56,2013-12-06 18:12:43
78ba429e6a3269594afbffcca2980e76281c43e0...ca116c35a63e06e62337ce9713a55d28ad9ebce8,1,3,3,6,1,2013-12-06 19:51:45,2013-12-06 18:58:34
ca116c35a63e06e62337ce9713a55d28ad9ebce8...b4d44e12987131bfd23399947fe9b2f860cc5729,1,22,0,22,1,2013-12-09 16:32:09,2013-11-28 13:33:03
b4d44e12987131bfd23399947fe9b2f860cc5729...a14266e46466d02871bc3edc2a9229dcfa5acc89,3,5,1,6,5,2013-12-09 16:52:28,2013-12-06 17:54:20
a14266e46466d02871bc3edc2a9229dcfa5acc89...c3d6ca97e1618fa7b770d60fdc37b12ff51c65ab,1,8,3,11,1,2013-12-09 20:14:45,2013-11-29 14:28:03
c3d6ca97e1618fa7b770d60fdc37b12ff51c65ab...d3491083a54b6d653687a4d96720cd8fc3efaac5,1,4,4,8,1,2013-12-09 20:24:54,2013-11-30 03:54:01
d3491083a54b6d653687a4d96720cd8fc3efaac5...082fe180ecfbe9d4612fb8b3ccc5c2ac203e5c6c,1,1,1,2,1,2013-12-09 20:27:08,2013-11-30 21:04:33
082fe180ecfbe9d4612fb8b3ccc5c2ac203e5c6c...d653607162488839b440de7b00b3c00d360bca3a,1,1,1,2,1,2013-12-09 20:46:21,2013-12-02 13:04:52
d653607162488839b440de7b00b3c00d360bca3a...fe84f7bef8b7c63158cf1699f3a62793b555fce8,1,3,3,6,3,2013-12-09 20:48:50,2013-12-03 08:55:09
fe84f7bef8b7c63158cf1699f3a62793b555fce8...f8c6ee3df53754cc86b19b357ab37952c0f27c71,1,0,1,1,1,2013-12-09 20:52:00,2013-12-04 07:21:00
f8c6ee3df53754cc86b19b357ab37952c0f27c71...ecbee8147bd8f363a3d9e8f079ef32e66908e3b6,1,2,2,4,1,2013-12-09 22:57:49,2013-12-09 22:57:49
ecbee8147bd8f363a3d9e8f079ef32e66908e3b6...8ec2743ca13af58b7339d1e1e18eec2e8b0e8b6f,2,27,46,73,46,2013-12-10 00:32:10,2013-12-03 00:11:26
8ec2743ca13af58b7339d1e1e18eec2e8b0e8b6f...f4d850e16803dfd2ea4ffc7399b41cede688bba6,1,7,2,9,2,2013-12-10 01:30:43,2013-12-10 01:30:43
f4d850e16803dfd2ea4ffc7399b41cede688bba6...043190f3973bebcb93f458857fca1e42c737ab16,1,1,1,2,1,2013-12-10 01:54:08,2013-12-10 01:54:08
043190f3973bebcb93f458857fca1e42c737ab16...dc4df931778a374f1fb3c8af7545733c09b9c098,2,14,4,18,4,2013-12-11 18:02:14,2013-12-11 09:02:56
dc4df931778a374f1fb3c8af7545733c09b9c098...8864e54f1f94883f3e22d7ce7ed87a699467a217,5,7,8,15,7,2013-12-11 18:12:18,2013-12-11 17:56:06
8864e54f1f94883f3e22d7ce7ed87a699467a217...f1a8d419d529ced136441d0eae5f4dd474a8c8ff,1,7,4,11,4,2013-12-11 22:35:23,2013-12-11 22:27:23
f1a8d419d529ced136441d0eae5f4dd474a8c8ff...f69dc16241c8b631123ad0b09674f0a5e0ff32fe,2,31,4,35,5,2013-12-11 23:18:45,2013-12-06 19:35:34
f69dc16241c8b631123ad0b09674f0a5e0ff32fe...4ac21ac039c3aa274904e8fcaab6622f8a1ccf84,1,2,2,4,2,2013-12-12 11:15:31,2013-12-04 10:17:15
4ac21ac039c3aa274904e8fcaab6622f8a1ccf84...9e538e7c311f42b71753920e1d3e903c69eb6e01,1,32,32,64,27,2013-12-12 11:19:16,2013-12-04 11:41:00
9e538e7c311f42b71753920e1d3e903c69eb6e01...cf2a7614a411e34b54742fd1394b22f8a52104d7,1,2,2,4,2,2013-12-12 11:22:31,2013-12-04 16:24:50
cf2a7614a411e34b54742fd1394b22f8a52104d7...82e97cf53e93b2e0032e9220022be1245552fd10,1,1,1,2,1,2013-12-12 11:25:41,2013-12-04 23:15:11
82e97cf53e93b2e0032e9220022be1245552fd10...9396d55414ef41ec3a109eefcf6c65dc00b446c4,1,13,5,18,5,2013-12-12 11:42:49,2013-12-12 11:42:49
9396d55414ef41ec3a109eefcf6c65dc00b446c4...43072e3812e32b89b97ad03144577cba50d4b776,2,65,5,70,6,2013-12-13 00:30:31,2013-12-12 23:36:16
43072e3812e32b89b97ad03144577cba50d4b776...f8944efe70b81e02704df9b53ea2546c80c73d3b,2,87,27,114,8,2013-12-13 01:18:44,2013-12-11 00:45:54
f8944efe70b81e02704df9b53ea2546c80c73d3b...30a8b7d0b5d4882c2bf3b20eb696a02f5b667726,3,71,7,78,10,2013-12-13 01:18:44,2013-12-11 00:46:29
30a8b7d0b5d4882c2bf3b20eb696a02f5b667726...05e4fd3488b89e670c36869f18defe26deac2efa,1,3,18,21,1,2013-12-13 07:49:03,2013-12-13 00:32:36
05e4fd3488b89e670c36869f18defe26deac2efa...a0ed3713899f0ec5f3e1b76ef48fc3acedabe1a5,1,5,5,10,5,2013-12-13 07:51:45,2013-12-13 07:51:03
a0ed3713899f0ec5f3e1b76ef48fc3acedabe1a5...1d5e18b062c3e33b2a8d96aa58d905ed2cd48649,1,33,0,33,3,2013-12-13 08:14:31,2013-12-06 03:30:21
1d5e18b062c3e33b2a8d96aa58d905ed2cd48649...62dbe85798c19246fb2fb121bb4278248e564486,1,12,12,24,12,2013-12-13 08:22:47,2013-12-04 21:02:28
62dbe85798c19246fb2fb121bb4278248e564486...fcd2a8131a3cb3e59a616bf31e61510b5c3a97d3,1,22,3,25,4,2013-12-13 08:24:37,2013-12-05 23:56:52
fcd2a8131a3cb3e59a616bf31e61510b5c3a97d3...f3de5b6eac90baf649506072162f36dbc6d2f028,2,36,8,44,2,2013-12-13 08:31:25,2013-12-09 20:36:15
f3de5b6eac90baf649506072162f36dbc6d2f028...3410f65e790a81d457b4f4601a1e760a6f8ede5e,17,64,30,94,33,2013-12-13 10:07:11,2013-10-16 13:15:21
3410f65e790a81d457b4f4601a1e760a6f8ede5e...e455e7d878600c1cf8fe0756fe6c7bf523ef9e3d,1,1,0,1,1,2013-12-13 16:53:33,2013-12-13 16:53:33
e455e7d878600c1cf8fe0756fe6c7bf523ef9e3d...e9c79cad437605171894e2d1aad842e662b8579c,1,43,0,43,1,2013-12-13 18:44:40,2013-12-13 18:33:34
e9c79cad437605171894e2d1aad842e662b8579c...3468ad1b61d7440a1727048d7e7c2a7795e1656b,1,1,1,2,1,2013-12-13 18:52:13,2013-12-13 18:52:13
3468ad1b61d7440a1727048d7e7c2a7795e1656b...cfde6f507cc24854f843d3963743f15dad34ef59,1,3,3,6,1,2013-12-13 19:53:09,2013-12-13 19:53:09
cfde6f507cc24854f843d3963743f15dad34ef59...ed4a1fddce0c7e2f756b07e8be348320ae29de6b,1,4,1,5,1,2013-12-13 20:23:53,2013-12-13 06:36:39
ed4a1fddce0c7e2f756b07e8be348320ae29de6b...18e0768a2b94f10d188125997c96bc733ddcef1e,5,9,9,18,6,2013-12-13 20:23:53,2013-12-13 19:59:23
18e0768a2b94f10d188125997c96bc733ddcef1e...03088d60109582fa5e966ad8425b3de9d9152b6a,1,1,1,2,1,2013-12-13 20:28:02,2013-12-13 20:28:02
03088d60109582fa5e966ad8425b3de9d9152b6a...8c10db384727643265b1550543011d3193dfe557,11,163,62,225,31,2013-12-13 20:51:13,2013-12-13 20:49:42
8c10db384727643265b1550543011d3193dfe557...109ffac97550596ffee66af15510f5f445ddc8dc,2,0,0,0,0,2013-12-13 21:18:22,2013-12-13 21:18:22
109ffac97550596ffee66af15510f5f445ddc8dc...6d01384a55a2e0550eb8a0844b500c3bf0fdc588,1,20,8,28,7,2013-12-13 22:13:23,2013-12-13 22:13:23
6d01384a55a2e0550eb8a0844b500c3bf0fdc588...da8ab2f928c8bf60f29c43ff4c9189518b24e7ef,1,1,2,3,1,2013-12-13 22:33:43,2013-12-13 22:33:43
da8ab2f928c8bf60f29c43ff4c9189518b24e7ef...11fff8fa0d370e2f20284510ad0e52cdf3bcb2a3,1,1,1,2,1,2013-12-13 22:36:24,2013-12-13 22:36:24
11fff8fa0d370e2f20284510ad0e52cdf3bcb2a3...9a4c9e6487e0f51275a7820d0c162aceeadbf561,7,125,53,178,44,2013-12-14 05:49:05,2013-12-14 04:02:15
9a4c9e6487e0f51275a7820d0c162aceeadbf561...b0474cb984ed960e4d40f51402d21c0f455c0b0b,2,0,39,39,2,2013-12-14 05:49:22,2013-12-14 05:32:05
b0474cb984ed960e4d40f51402d21c0f455c0b0b...6144df52af35efdfc59941b2542523f744b4f16d,2,7,18,25,5,2013-12-16 17:47:23,2013-12-16 17:47:23
6144df52af35efdfc59941b2542523f744b4f16d...45af02de0457881f269b52d6c3f0ed58da53cfac,4,9,13,22,4,2013-12-16 17:49:48,2013-12-16 17:47:51
45af02de0457881f269b52d6c3f0ed58da53cfac...cbb3ce2c309052b951d0cc87e4c6daa9c48a3dd8,2,17,1,18,2,2013-12-16 18:37:18,2013-11-18 15:02:55
cbb3ce2c309052b951d0cc87e4c6daa9c48a3dd8...d5c5e2b5848dcb312390549a92c94c76822a5f4f,2,3,2,5,3,2013-12-16 21:37:09,2013-12-16 21:37:09
d5c5e2b5848dcb312390549a92c94c76822a5f4f...2f91cfd0d2986899c38641100c1851b2f9d3888a,2,24,1,25,2,2013-12-17 00:39:13,2013-11-24 22:40:46
2f91cfd0d2986899c38641100c1851b2f9d3888a...4f724333923c7eb46dbef595b2fd9ccf86b8db39,1,0,3,3,1,2013-12-17 11:59:29,2013-12-17 11:59:29
4f724333923c7eb46dbef595b2fd9ccf86b8db39...f8d319c11a12efb96f822a8b4d0fd35af19934a6,1,4,0,4,1,2013-12-17 12:09:08,2013-12-05 04:32:55
f8d319c11a12efb96f822a8b4d0fd35af19934a6...c432999572c3564dd6d2456161fc6a942bc8d866,1,4,1,5,1,2013-12-17 12:12:14,2013-12-05 08:29:18
c432999572c3564dd6d2456161fc6a942bc8d866...3c62e4244e6d3b8597e1fd9693d0eef2e6ddca7d,1,1,1,2,1,2013-12-17 12:15:52,2013-12-05 12:16:48
3c62e4244e6d3b8597e1fd9693d0eef2e6ddca7d...3174f7333672c96613825976c883f79ad4d41016,1,30,1,31,2,2013-12-17 12:20:25,2013-12-06 03:41:58
3174f7333672c96613825976c883f79ad4d41016...6ac773f350a3eacb5f4b3ab83bc06e3568ac8005,1,26,25,51,1,2013-12-17 12:29:22,2013-12-17 12:29:22
6ac773f350a3eacb5f4b3ab83bc06e3568ac8005...b2e472e7a2e3389456278d8e6a18384a1d797f89,1,1,1,2,1,2013-12-17 12:30:59,2013-12-06 10:07:40
b2e472e7a2e3389456278d8e6a18384a1d797f89...5c97731a22ed87d64712e673efea0e8a05eae65f,2,27,11,38,3,2013-12-17 13:10:40,2013-12-07 23:22:04
5c97731a22ed87d64712e673efea0e8a05eae65f...cb29632a5802e930262919b3db64ca4806c5cfc7,2,2,2,4,2,2013-12-17 19:43:57,2013-12-17 19:22:04
cb29632a5802e930262919b3db64ca4806c5cfc7...73c66715c9a13b0fdacf98a9e9f237063a97ebc3,6,99,119,218,14,2013-12-17 22:53:28,2013-12-17 22:53:28
73c66715c9a13b0fdacf98a9e9f237063a97ebc3...57d50582aa7213acf77b2936f70f4c2122d206d6,2,16,0,16,2,2013-12-18 19:49:39,2013-12-18 08:33:43
57d50582aa7213acf77b2936f70f4c2122d206d6...3dc18037e8db8766641a4d39f0fee96077db1fcb,2,40,20,60,4,2013-12-18 20:28:07,2013-12-18 08:28:35
3dc18037e8db8766641a4d39f0fee96077db1fcb...30252a05049c557cf3c05cdf4a8d36fa9e4ab395,1,4,4,8,4,2013-12-18 21:14:09,2013-12-06 16:00:04
30252a05049c557cf3c05cdf4a8d36fa9e4ab395...41534816a4873b71913c936e17692931a07e3a85,1,1,1,2,1,2013-12-18 21:14:10,2013-12-06 18:56:20
41534816a4873b71913c936e17692931a07e3a85...6e2359caa0a805365fb006927e1b02300e011705,1,2,0,2,1,2013-12-18 21:14:11,2013-12-07 19:13:12
6e2359caa0a805365fb006927e1b02300e011705...74b4ab88677469386d0ea1e162554c6af372b898,1,1,1,2,1,2013-12-18 21:14:11,2013-12-08 01:11:43
74b4ab88677469386d0ea1e162554c6af372b898...bf816d3ade9e72629521f78a81e5843bce876987,2,10,2,12,3,2013-12-18 21:14:12,2013-12-18 21:13:17
bf816d3ade9e72629521f78a81e5843bce876987...040e743b393f53aad11ce200de21590b4fcb0b8b,1,1,1,2,1,2013-12-18 21:14:46,2013-12-10 01:16:54
040e743b393f53aad11ce200de21590b4fcb0b8b...a13c4ba770146c2d85e2853a3a1eaa9f6ed3115e,1,1,1,2,1,2013-12-18 21:15:38,2013-12-10 07:59:10
a13c4ba770146c2d85e2853a3a1eaa9f6ed3115e...09f8962df2131cad446b207a6ab0551c8acd31d0,1,1,2,3,2,2013-12-18 21:22:21,2013-12-10 12:37:28
09f8962df2131cad446b207a6ab0551c8acd31d0...f3a796e522afdbd3b640d14426edb2fbfab463c5,1,20,15,35,11,2013-12-18 23:31:49,2013-12-18 20:45:56
f3a796e522afdbd3b640d14426edb2fbfab463c5...864b2596b246470cca9d4e223eaed720f4462319,2,44,17,61,17,2013-12-18 23:44:15,2013-12-05 23:08:52
864b2596b246470cca9d4e223eaed720f4462319...8f329ffb829410e1fd8f86a766929134e736e3e5,1,10,1,11,2,2013-12-19 00:35:54,2013-12-18 23:27:39
8f329ffb829410e1fd8f86a766929134e736e3e5...bc3ff2cecd0861766a9e8606f3cc2c582d9875df,2,32,0,32,2,2013-12-19 01:16:39,2013-12-18 22:12:02
bc3ff2cecd0861766a9e8606f3cc2c582d9875df...f0e3dfd008b1fa5550298aba7f913d6ce0395bde,1,1,1,2,1,2013-12-19 04:57:20,2013-12-16 23:10:06
f0e3dfd008b1fa5550298aba7f913d6ce0395bde...274a6734ef1fff543cc50388a0958d1988baeb57,2,18,1,19,2,2013-12-19 05:44:00,2013-12-19 02:51:56
274a6734ef1fff543cc50388a0958d1988baeb57...4f5758e6669222369889c9e789601d25ff885530,1,9,2,11,2,2013-12-19 05:44:00,2013-12-19 02:52:36
4f5758e6669222369889c9e789601d25ff885530...26d43cacdc106765bd928d41600352198f887aef,2,61,13,74,13,2013-12-19 08:59:22,2013-12-19 04:52:31
26d43cacdc106765bd928d41600352198f887aef...c7a1d1ab0b663edffc1ac7b54deea847e372468d,2,8,4,12,2,2013-12-19 12:22:58,2013-12-19 12:21:14
c7a1d1ab0b663edffc1ac7b54deea847e372468d...3d156a76e3501ea29fe7d208dc89f0ae89e76fc3,1,92,13,105,13,2013-12-19 12:57:33,2013-12-09 20:53:35
3d156a76e3501ea29fe7d208dc89f0ae89e76fc3...14d3e559d45e606a1e96860ebb28d65656ff334a,1,3,3,6,2,2013-12-19 13:05:15,2013-12-10 14:50:31
14d3e559d45e606a1e96860ebb28d65656ff334a...a965984733d4215c20edfbb2e3576971b5be75ff,1,1,1,2,1,2013-12-19 13:24:19,2013-12-10 16:32:59
a965984733d4215c20edfbb2e3576971b5be75ff...efba4731e4b22481f1c0b1c417ea24c00182095a,1,9,3,12,11,2013-12-19 13:29:19,2013-12-10 21:35:12
efba4731e4b22481f1c0b1c417ea24c00182095a...9865a7c0ad678fa6a3daa2719e37d94aeb62f67b,1,1,1,2,1,2013-12-19 13:32:19,2013-12-12 03:49:52
9865a7c0ad678fa6a3daa2719e37d94aeb62f67b...277a5ea05d50fb27243b98570c3ca9394b31e935,1,18,3,21,4,2013-12-19 13:46:30,2013-12-12 06:39:40
277a5ea05d50fb27243b98570c3ca9394b31e935...54637a335f885110efaa702a3bab29c77644b36c,3,128,171,299,35,2013-12-19 17:01:12,2013-12-14 05:30:48
54637a335f885110efaa702a3bab29c77644b36c...3fc8017119497207c8e300e4014b4b2f62585bec,1,95,0,95,94,2013-12-19 17:02:00,2013-12-19 16:56:26
3fc8017119497207c8e300e4014b4b2f62585bec...937caab6475e53a7ea0206e992f8a52449232e78,2,71,0,71,3,2013-12-19 19:39:04,2013-11-28 06:10:28
937caab6475e53a7ea0206e992f8a52449232e78...cef084ade9072090259d8c679751cac3ffeaed51,3,86,4,90,6,2013-12-19 21:37:29,2013-12-16 20:45:57
cef084ade9072090259d8c679751cac3ffeaed51...fe7decd1b0339c35360cdd8c21a58278c8df2508,1,58,0,58,1,2013-12-19 21:55:10,2013-12-19 21:50:01
fe7decd1b0339c35360cdd8c21a58278c8df2508...94b5f2dadbcb9f0aba72300826dae062cf75a131,2,8,4,12,4,2013-12-19 23:47:26,2013-12-19 23:47:16
94b5f2dadbcb9f0aba72300826dae062cf75a131...98ee3719f98959cddf669586ce6339f20f08ce57,1,1,1,2,1,2013-12-19 23:50:07,2013-12-19 23:50:07
98ee3719f98959cddf669586ce6339f20f08ce57...af7203e0b81e641947569bdeb9b266fd09b12996,1,1,1,2,1,2013-12-20 00:02:57,2013-12-20 00:02:57
af7203e0b81e641947569bdeb9b266fd09b12996...83451d552e467ea507c01770fbd7e7b529cb9d91,1,1,1,2,1,2013-12-20 00:11:36,2013-12-20 00:11:36
83451d552e467ea507c01770fbd7e7b529cb9d91...df2b88e2303756f2a68b62e9b0395f6e96d43cff,1,1,1,2,1,2013-12-20 00:12:24,2013-12-19 15:33:01
df2b88e2303756f2a68b62e9b0395f6e96d43cff...c31df32ca07a3d24ee79487588bf48982e922cf6,1,1,1,2,1,2013-12-20 18:29:03,2013-12-20 18:29:03
c31df32ca07a3d24ee79487588bf48982e922cf6...870232bd05f86fc534a47c2c17b0fbf999a9d087,1,5,4,9,4,2013-12-21 00:23:06,2013-12-20 21:21:13
870232bd05f86fc534a47c2c17b0fbf999a9d087...98473835a27c359234592a752f32f74c095b9c55,1,2,2,4,2,2013-12-21 05:21:18,2013-12-21 04:11:02
98473835a27c359234592a752f32f74c095b9c55...d1c4766d143d474ae255079684a02b63d219b35b,1,1,1,2,1,2013-12-21 05:22:15,2013-12-21 04:41:00
d1c4766d143d474ae255079684a02b63d219b35b...7d6e5a2d0151a288264837ff592e31ea02542c58,1,2,2,4,2,2013-12-24 01:54:05,2013-12-24 01:54:05
7d6e5a2d0151a288264837ff592e31ea02542c58...056c8493521988dbb330c6636135b505737da918,1,1,1,2,1,2013-12-28 00:22:35,2013-12-23 20:13:41
056c8493521988dbb330c6636135b505737da918...498365f219f65d6c29bdf2f03610a4d3646009bb,2,24,1,25,2,2013-12-28 06:45:46,2013-12-28 01:25:51
498365f219f65d6c29bdf2f03610a4d3646009bb...80e7a4558490f7ffd33d142844b9153a5ed00e86,2,136,23,159,16,2013-12-28 07:31:00,2013-12-10 22:50:30
80e7a4558490f7ffd33d142844b9153a5ed00e86...bddd46c8ecf49cfe6c999cd6b4a69b7d7e1f9a33,1,2,1,3,2,2013-12-30 22:58:04,2013-12-16 08:08:00
bddd46c8ecf49cfe6c999cd6b4a69b7d7e1f9a33...1147f21999edf9a434cd8d24865a6455e744d858,3,30,4,34,5,2013-12-30 23:09:49,2013-12-05 13:59:13
1147f21999edf9a434cd8d24865a6455e744d858...d158dd131e3291e0da04863c3c9ed2ac5bdd19c1,1,4,2,6,1,2013-12-31 00:58:28,2013-12-31 00:57:53
d158dd131e3291e0da04863c3c9ed2ac5bdd19c1...a80049fd0ac858eeeb645a4209cb2a661d0b4c33,1,2,6,8,2,2013-12-31 08:41:15,2013-12-31 08:40:53
a80049fd0ac858eeeb645a4209cb2a661d0b4c33...186a5912288acfff0ee59dae29af83c37c987921,1,5,0,5,1,2013-12-31 09:17:43,2013-12-31 00:02:32
186a5912288acfff0ee59dae29af83c37c987921...07084e1c8bd4efa28b3f02aea353640af0cf37d6,1,11,0,11,1,2013-12-31 09:24:41,2013-12-31 09:24:41
07084e1c8bd4efa28b3f02aea353640af0cf37d6...e415e916e85040fe62c801092be698ab06c1d11c,1,8,3,11,3,2013-12-31 09:39:19,2013-12-31 09:36:01
e415e916e85040fe62c801092be698ab06c1d11c...e9ee492d3556f3febaf7ca47d100e9a29e2d20e4,1,3,0,3,1,2014-01-02 04:41:55,2014-01-02 04:41:55
e9ee492d3556f3febaf7ca47d100e9a29e2d20e4...eff52ad877c60d85cca5331f317d34eff7f9f43c,4,9,0,9,4,2014-01-02 04:51:45,2014-01-02 04:51:45
eff52ad877c60d85cca5331f317d34eff7f9f43c...50bf029625d603fc652f0f413e709f43803743db,2,2,1,3,2,2014-01-02 16:00:31,2014-01-02 11:26:43
50bf029625d603fc652f0f413e709f43803743db...4f57236614415eea919221ea5f99c4d8689b3267,2,17,0,17,2,2014-01-02 22:37:48,2014-01-02 22:37:48
4f57236614415eea919221ea5f99c4d8689b3267...010413f90a9352a5aab1e7517a58eab5f30f2b06,1,42,36,78,3,2014-01-02 23:28:56,2014-01-02 21:28:30
010413f90a9352a5aab1e7517a58eab5f30f2b06...884ef0dbcdfe614cedc824d079361b53e675d033,2,48,0,48,2,2014-01-02 23:28:56,2014-01-02 22:39:24
884ef0dbcdfe614cedc824d079361b53e675d033...53ec33f07fd75d76fc5109c0b24c86aa25219058,1,1,1,2,1,2014-01-03 00:08:51,2014-01-02 16:59:48
53ec33f07fd75d76fc5109c0b24c86aa25219058...c9705b755645a4bfe066243f2ba15a733c3787e1,2,34,18,52,4,2014-01-03 00:14:16,2014-01-02 16:22:10
c9705b755645a4bfe066243f2ba15a733c3787e1...760f2fb73178e56c37397b3c5876f7dac96f0455,2,6,1,7,2,2014-01-03 00:36:31,2014-01-03 00:12:31
760f2fb73178e56c37397b3c5876f7dac96f0455...7dfedb732dad5ba1f1f21ff611a82ecf8327916c,1,4,4,8,4,2014-01-03 05:30:00,2014-01-03 05:29:28
7dfedb732dad5ba1f1f21ff611a82ecf8327916c...cf686285c22d528440e173fdb65ad1052d96df3c,2,35,6,41,4,2014-01-03 05:30:25,2013-11-22 13:33:19
cf686285c22d528440e173fdb65ad1052d96df3c...6a6f71f238d2603cbc286ba29ec7503ad45f7f20,1,1,1,2,1,2014-01-03 05:34:34,2014-01-03 05:18:02
6a6f71f238d2603cbc286ba29ec7503ad45f7f20...6c17d02bc4cc02f478775d62e1f9f77da9da82ad,4,21,24,45,13,2014-01-03 06:04:32,2013-12-13 09:49:37
6c17d02bc4cc02f478775d62e1f9f77da9da82ad...fd9a03e147aac7e952c6dda1f381fd4662276ba2,1,3,1,4,1,2014-01-03 06:47:39,2014-01-03 06:47:39
fd9a03e147aac7e952c6dda1f381fd4662276ba2...01c5be4681e34cdc5f5c461b7a618fefe8038919,2,13,1,14,2,2014-01-03 06:59:43,2014-01-02 22:48:03
01c5be4681e34cdc5f5c461b7a618fefe8038919...131e4014b831ac81b7979c4523da81ebc5861c70,2,8,1,9,2,2014-01-03 07:07:27,2013-12-20 15:15:46
131e4014b831ac81b7979c4523da81ebc5861c70...5fea3471e80e22db0bb79b67956a0143d31dace1,1,1,1,2,1,2014-01-03 07:10:38,2013-12-26 21:30:41
5fea3471e80e22db0bb79b67956a0143d31dace1...05596527edb055b094dd6b42ca118b411aa27eb2,1,4,4,8,4,2014-01-03 10:43:22,2014-01-03 08:31:07
05596527edb055b094dd6b42ca118b411aa27eb2...162144202caa1bf42a576783f39d9145fa9b20ea,1,1,1,2,1,2014-01-03 16:22:17,2014-01-03 16:22:17
162144202caa1bf42a576783f39d9145fa9b20ea...bc492c0fc17257ddf2bc5964e205379aa766b3d8,2,27,1,28,3,2014-01-03 17:14:15,2014-01-02 17:01:46
bc492c0fc17257ddf2bc5964e205379aa766b3d8...3d38fff8b4ea2fd60fadef2028ea4dcddfccb1a4,2,12,10,22,3,2014-01-03 17:51:05,2014-01-03 17:23:51
3d38fff8b4ea2fd60fadef2028ea4dcddfccb1a4...e31560cf6b85ddbb340cb0af421c1d0f5586e142,1,68,0,68,1,2014-01-03 18:19:38,2014-01-03 18:03:28
e31560cf6b85ddbb340cb0af421c1d0f5586e142...c6d04b3a3d06c94f0a3479b9dd750f3b224920fd,1,1,1,2,1,2014-01-03 18:28:30,2014-01-03 18:28:30
c6d04b3a3d06c94f0a3479b9dd750f3b224920fd...0ef76dde41e2ef3653c635b3277e8232b89ff064,1,1,1,2,1,2014-01-03 18:40:31,2014-01-03 18:40:31
0ef76dde41e2ef3653c635b3277e8232b89ff064...1b7a6c66f8c9964a5248ee1430506636dbb0a582,1,1,1,2,1,2014-01-03 19:17:43,2014-01-03 19:17:43
1b7a6c66f8c9964a5248ee1430506636dbb0a582...86151b0cea1b21bad3be5f889ee8f1b299030bf9,1,1,1,2,1,2014-01-03 20:02:29,2014-01-03 20:02:29
86151b0cea1b21bad3be5f889ee8f1b299030bf9...0f61316b24fc321dfa45bd71ace9ceb276604ad8,1,1,1,2,1,2014-01-03 21:09:26,2014-01-03 21:09:26
0f61316b24fc321dfa45bd71ace9ceb276604ad8...9569778f2f5d155ddc9188537e9fb36faaf9dbf1,1,1,1,2,1,2014-01-03 21:16:39,2014-01-03 21:16:39
9569778f2f5d155ddc9188537e9fb36faaf9dbf1...3b1a4fe0c83c7898ecd7261ab4213998ee7be0ec,2,74,13,87,20,2014-01-03 22:33:54,2014-01-02 05:42:59
3b1a4fe0c83c7898ecd7261ab4213998ee7be0ec...32cc6cbb6f06f25aaa7f054a91ac9eb6468f49fc,1,1,1,2,1,2014-01-04 00:04:50,2014-01-03 21:19:37
32cc6cbb6f06f25aaa7f054a91ac9eb6468f49fc...2e9d7cc6cb9665fa00d7796b2a51fb9a2c41af1a,1,2,0,2,1,2014-01-04 00:07:26,2014-01-03 20:22:39
2e9d7cc6cb9665fa00d7796b2a51fb9a2c41af1a...00cac6ed101cf78a7d12a0ca8a5030337b65239d,1,14,3,17,3,2014-01-04 06:35:14,2014-01-04 05:57:43
00cac6ed101cf78a7d12a0ca8a5030337b65239d...d9ed9c5ac1fdf677781cbf7c15c35912fb7d2a18,1,2,2,4,1,2014-01-04 08:14:38,2014-01-04 08:14:38
d9ed9c5ac1fdf677781cbf7c15c35912fb7d2a18...1bb33cccbe12bda4c397ddabab35ba1df85d5137,1,1,1,2,1,2014-01-05 04:51:58,2014-01-04 16:44:26
1bb33cccbe12bda4c397ddabab35ba1df85d5137...caeb7402651702cd13df2f1594e9827439a8b760,1,6,0,6,1,2014-01-05 08:27:38,2013-11-02 05:49:43
caeb7402651702cd13df2f1594e9827439a8b760...e0ce9ed36d9b8c1858e4f928b61d21d7d4c023b8,2,17,17,34,2,2014-01-05 08:36:04,2014-01-05 07:51:04
e0ce9ed36d9b8c1858e4f928b61d21d7d4c023b8...a7aa4cc0a97abaa1c4e8796f2b5ed5e216eff0e4,1,0,6,6,1,2014-01-05 09:19:35,2014-01-05 09:19:35
a7aa4cc0a97abaa1c4e8796f2b5ed5e216eff0e4...821ed310a75719765448e8b15e3a56f0389107a5,1,0,2,2,1,2014-01-06 05:07:44,2013-12-30 11:12:46
821ed310a75719765448e8b15e3a56f0389107a5...6f6cb5c8d83e2c05ac56eacb1802d91406b3d0c1,1,5,0,5,1,2014-01-06 15:22:16,2014-01-06 15:22:16
6f6cb5c8d83e2c05ac56eacb1802d91406b3d0c1...4c21355940a98c7236a33d1b5e86d6cd3cf562cb,1,9,9,18,2,2014-01-06 19:27:19,2014-01-06 19:27:19
4c21355940a98c7236a33d1b5e86d6cd3cf562cb...5dc27959d5c0e45cc0cc6133a9ef676cc15d44bd,12,582,267,849,19,2014-01-06 20:27:54,2014-01-06 20:19:51
5dc27959d5c0e45cc0cc6133a9ef676cc15d44bd...dc89db33df8a0515fba0f25d3cdf82fa994f3a4b,4,13,14,27,13,2014-01-06 22:11:44,2014-01-06 22:01:39
dc89db33df8a0515fba0f25d3cdf82fa994f3a4b...d4d58f287f49023dda41def14968da5a7752c699,1,0,1,1,1,2014-01-06 22:48:50,2014-01-06 22:47:57
d4d58f287f49023dda41def14968da5a7752c699...efbc2428754dc803122198b523dc7071ddc6f3cd,2,4,10,14,3,2014-01-06 23:48:30,2014-01-06 23:48:30
efbc2428754dc803122198b523dc7071ddc6f3cd...99d5defb1a20bd487d3dbc93adcbcfaad1d4006c,1,1,1,2,1,2014-01-07 00:11:53,2014-01-06 19:02:05
99d5defb1a20bd487d3dbc93adcbcfaad1d4006c...28cfd96fdc58bbf166e2908126598f20bbed5eda,1,1,1,2,1,2014-01-07 00:34:49,2014-01-06 08:37:48
28cfd96fdc58bbf166e2908126598f20bbed5eda...eb90672aae0fae1fdcd8b05b14b04f1e6818662b,1,2,2,4,2,2014-01-07 00:37:47,2014-01-06 04:01:33
eb90672aae0fae1fdcd8b05b14b04f1e6818662b...53fd24ffcb87d34cd7a171074509e94ffee88bbf,1,4,4,8,1,2014-01-07 00:44:52,2014-01-06 01:04:02
53fd24ffcb87d34cd7a171074509e94ffee88bbf...1b0718bf89aff5a9686cd89cad91a7a11825e9f0,1,1,2,3,1,2014-01-07 01:06:27,2013-12-28 06:35:01
1b0718bf89aff5a9686cd89cad91a7a11825e9f0...c894470d4122913168dd75f829f1d19c4af696ed,1,1,1,2,1,2014-01-07 01:35:13,2014-01-05 15:51:52
c894470d4122913168dd75f829f1d19c4af696ed...cdc4d485a6daa0c74e5d07d8def2a3ee68d93d13,1,18,62,80,12,2014-01-07 01:35:13,2014-01-06 03:49:51
cdc4d485a6daa0c74e5d07d8def2a3ee68d93d13...7e916455b36dc9ca4d4afc1e44cade90006d00e3,2,34,1,35,3,2014-01-07 01:47:06,2013-11-20 06:53:33
7e916455b36dc9ca4d4afc1e44cade90006d00e3...affcbad501ad5e17b8cb30ad8a2c0d1de6686722,1,17,9,26,6,2014-01-07 03:08:05,2014-01-07 03:08:05
affcbad501ad5e17b8cb30ad8a2c0d1de6686722...162485d3032dc95551509d44ed5949ecd3f9a9bf,1,2,1,3,1,2014-01-07 19:53:17,2014-01-07 19:53:17
162485d3032dc95551509d44ed5949ecd3f9a9bf...9693a426e3814c0c2d83802015ae6cd8cfec8e3e,1,2,2,4,1,2014-01-07 19:53:50,2014-01-07 19:53:50
9693a426e3814c0c2d83802015ae6cd8cfec8e3e...e89150ca0f462c8673e03bc29bce0d2dd51c6e03,4,123,5,128,6,2014-01-07 23:49:03,2014-01-07 22:47:03
e89150ca0f462c8673e03bc29bce0d2dd51c6e03...e115342fce6094db3d07e0bdd0b19e29cc0dd9c3,1,1,1,2,1,2014-01-08 00:51:47,2014-01-07 08:34:06
e115342fce6094db3d07e0bdd0b19e29cc0dd9c3...5df7e73adf56ff4b776232fdb631e0f7d004864f,2,7,11,18,2,2014-01-08 00:54:35,2014-01-07 13:25:46
5df7e73adf56ff4b776232fdb631e0f7d004864f...ace13b94e6b2d7e97f21ead630f4565be40d31f2,1,1,1,2,1,2014-01-08 01:00:53,2014-01-08 01:00:53
ace13b94e6b2d7e97f21ead630f4565be40d31f2...f4fe28bd92b35cbb558502697dfdd72bee435fee,1,1,2,3,1,2014-01-08 01:06:22,2014-01-08 01:06:05
f4fe28bd92b35cbb558502697dfdd72bee435fee...75345e3487642fbc608c3673e64cd7c5d65cb386,1,1,1,2,1,2014-01-08 01:07:48,2014-01-08 01:07:48
75345e3487642fbc608c3673e64cd7c5d65cb386...95e1b2d6121b4e26cf87dcf6746a7b8cb4c25e7f,2,8,3,11,5,2014-01-08 08:35:19,2014-01-03 15:22:55
95e1b2d6121b4e26cf87dcf6746a7b8cb4c25e7f...1c045f1b463cf8c2d0c470fc6e44170997e85d89,1,7,3,10,2,2014-01-08 08:49:29,2014-01-08 00:10:50
1c045f1b463cf8c2d0c470fc6e44170997e85d89...b6c42d5e8155edc9013bd531f553c278ce37c3c8,4,49,10,59,19,2014-01-08 21:07:58,2014-01-06 23:13:57
b6c42d5e8155edc9013bd531f553c278ce37c3c8...28fc80bba0107075ab371fd0a7634a38891626b2,2,9,9,18,7,2014-01-09 18:10:11,2013-12-27 11:55:02
28fc80bba0107075ab371fd0a7634a38891626b2...9ddef840b665bd94a49102a4e3dbc433f7b29b9a,5,125,1,126,5,2014-01-09 22:59:55,2014-01-09 22:39:48
9ddef840b665bd94a49102a4e3dbc433f7b29b9a...b1d676b7f75441e28f68d00b5c3f89659dea252c,1,11,9,20,5,2014-01-09 23:29:02,2014-01-09 23:22:50
b1d676b7f75441e28f68d00b5c3f89659dea252c...cb9c0f200af43bdd42e9c0d208031beb60fc3885,1,2,2,4,2,2014-01-10 00:34:16,2014-01-09 22:00:25
cb9c0f200af43bdd42e9c0d208031beb60fc3885...ac05276a510285d1c58f5f143259c4e136728fee,1,1,1,2,1,2014-01-10 00:48:15,2014-01-09 11:52:43
ac05276a510285d1c58f5f143259c4e136728fee...1d2a388830d95ae1a1f9b577fd0891a2e1f31bcd,1,1,1,2,1,2014-01-10 00:51:47,2014-01-09 07:13:24
1d2a388830d95ae1a1f9b577fd0891a2e1f31bcd...2ed4ad55022f6e5519617a3797649fe1e68f3734,7,73,1,74,9,2014-01-10 01:21:46,2014-01-07 19:51:32
2ed4ad55022f6e5519617a3797649fe1e68f3734...69452fa94f32c0e535d035988204e28eeda048a1,1,6,2,8,2,2014-01-10 01:24:10,2014-01-10 01:23:35
69452fa94f32c0e535d035988204e28eeda048a1...63cd873fef3207deef30c7a7ed66f4b8f647dc12,2,14,0,14,2,2014-01-10 01:35:25,2014-01-09 19:19:41
63cd873fef3207deef30c7a7ed66f4b8f647dc12...5a9cb8be3fae06cc0fcefc3d4340d3847bb6b925,1,2,3,5,2,2014-01-10 01:37:27,2014-01-10 00:05:46
5a9cb8be3fae06cc0fcefc3d4340d3847bb6b925...039b990d8dc73e59418114b49c36797e44127c76,2,41,0,41,2,2014-01-10 06:41:52,2014-01-09 19:21:54
039b990d8dc73e59418114b49c36797e44127c76...5a4145fe16bb61720843ae938b789e32dbbfdb7d,2,0,14,14,2,2014-01-10 07:47:35,2014-01-10 07:16:06
5a4145fe16bb61720843ae938b789e32dbbfdb7d...c77b2bcca36cf199478b8fb651972a1f650f646b,1,1,1,2,1,2014-01-10 08:58:40,2014-01-10 01:46:55
c77b2bcca36cf199478b8fb651972a1f650f646b...9f566db33c29f2b5ff6affeebd624340f618884e,1,1,1,2,1,2014-01-10 09:10:19,2014-01-10 01:48:26
9f566db33c29f2b5ff6affeebd624340f618884e...36c9e42de2d78af39600c588b06f2a52199ee8b6,2,30,1,31,3,2014-01-10 10:22:27,2014-01-05 17:00:17
36c9e42de2d78af39600c588b06f2a52199ee8b6...a9cccbe14f1bd9048f5dab4443f58c804d4259a1,2,38,13,51,7,2014-01-10 10:25:36,2014-01-05 07:42:44
a9cccbe14f1bd9048f5dab4443f58c804d4259a1...43a2f3d0bf435e3626cd679caff4281cfb3415bd,2,26,1,27,2,2014-01-10 17:50:28,2014-01-04 03:15:21
43a2f3d0bf435e3626cd679caff4281cfb3415bd...8ace8073fd1ad2fab8291246fe262d11b8c0f211,1,1,1,2,1,2014-01-10 17:50:28,2014-01-04 07:17:21
8ace8073fd1ad2fab8291246fe262d11b8c0f211...ece7854972a15564065c37fc2208671c8445f408,1,35,0,35,1,2014-01-10 19:49:06,2014-01-10 19:49:06
ece7854972a15564065c37fc2208671c8445f408...0f9a1c21e6d7c57dc02842efa9612a1a70993146,1,1,1,2,1,2014-01-10 20:37:49,2014-01-10 20:37:49
0f9a1c21e6d7c57dc02842efa9612a1a70993146...5f937e54df019c6165557f4265f6d76de641c0f9,1,2,2,4,2,2014-01-10 20:51:00,2014-01-10 20:51:00
5f937e54df019c6165557f4265f6d76de641c0f9...0d421f093d973315bd9584bbe36b55c7521ed695,1,1,1,2,1,2014-01-10 22:33:27,2014-01-10 22:33:27
0d421f093d973315bd9584bbe36b55c7521ed695...a0d759c61301ebc87a3365ff692438bb13c144ba,1,1,1,2,1,2014-01-11 00:54:20,2014-01-11 00:54:20
a0d759c61301ebc87a3365ff692438bb13c144ba...f9656dab2dcb9b5871935c58688033537dc229a4,1,2,2,4,1,2014-01-11 01:11:39,2014-01-11 01:11:39
f9656dab2dcb9b5871935c58688033537dc229a4...cde840fdf839e593108a33e0f3d56a052762f28d,1,1,1,2,1,2014-01-11 04:15:18,2014-01-11 04:15:18
cde840fdf839e593108a33e0f3d56a052762f28d...2b344dbd20777fb1283b3a5bcf35a6ae8d09469d,2,5,4,9,5,2014-01-11 07:42:36,2014-01-08 08:58:09
2b344dbd20777fb1283b3a5bcf35a6ae8d09469d...b2c84ccde37d0d9b1f2cd33e0cc23080d11820e2,1,1,1,2,1,2014-01-11 07:42:36,2014-01-11 01:00:57
b2c84ccde37d0d9b1f2cd33e0cc23080d11820e2...f4a4f42abb29ca0ab2d6dc427599db09eb4d54bb,1,1,1,2,1,2014-01-11 07:43:32,2014-01-11 06:42:22
f4a4f42abb29ca0ab2d6dc427599db09eb4d54bb...c3ab915d2ef8606c298cb4ae2f5cc8a30d3b250a,1,3,0,3,1,2014-01-11 22:09:52,2014-01-11 17:33:22
c3ab915d2ef8606c298cb4ae2f5cc8a30d3b250a...de065f196129766f7e774ccf0a24916db2e0f06d,1,8,0,8,1,2014-01-11 22:18:07,2014-01-11 09:42:25
de065f196129766f7e774ccf0a24916db2e0f06d...c7a46d4b8aa4d8b265bf6b55d588d75625a121a5,1,2,1,3,1,2014-01-11 22:29:05,2014-01-11 22:22:32
c7a46d4b8aa4d8b265bf6b55d588d75625a121a5...34fee06ca7db16549764f53c0382f2b6e2482201,1,2,2,4,1,2014-01-12 04:15:50,2014-01-12 01:18:56
34fee06ca7db16549764f53c0382f2b6e2482201...2cd09c9f0e7766bcd191662841b7b1ffc3b6dc3f,2,26,1,27,2,2014-01-13 17:53:38,2013-12-31 01:10:23
2cd09c9f0e7766bcd191662841b7b1ffc3b6dc3f...308598795af75c33a966ecb3124f4a640d72458d,2,4,5,9,5,2014-01-13 23:12:17,2014-01-13 23:12:17
308598795af75c33a966ecb3124f4a640d72458d...b3acddea37aca9f8e3f881100b5af657194d262a,1,1,2,3,2,2014-01-14 00:18:14,2014-01-13 22:31:56
b3acddea37aca9f8e3f881100b5af657194d262a...465212835f1bbd81a2872015a543cbb1bc585e2e,1,1,1,2,1,2014-01-14 00:24:56,2014-01-13 20:05:09
465212835f1bbd81a2872015a543cbb1bc585e2e...c61be8d0e6bb1bf7aed249bd2f653c0e0483683e,1,3,0,3,1,2014-01-14 00:31:42,2014-01-13 23:19:12
c61be8d0e6bb1bf7aed249bd2f653c0e0483683e...834d316829afdd0cc6a680f47d4c9b691edcc989,1,0,2,2,1,2014-01-14 00:31:43,2014-01-14 00:31:26
834d316829afdd0cc6a680f47d4c9b691edcc989...2a3586381fd5016bc51ad9d97fde1a5c7e3990d8,1,1,1,2,1,2014-01-14 00:40:56,2014-01-13 17:41:07
2a3586381fd5016bc51ad9d97fde1a5c7e3990d8...e1cfb1957feaf89408bccf48fae6f529e57a82fe,2,10,4,14,3,2014-01-14 00:50:15,2014-01-11 23:20:54
e1cfb1957feaf89408bccf48fae6f529e57a82fe...e324c149077d99cb722ab3b9e05759cb4dfa07a9,1,16,11,27,4,2014-01-14 04:03:36,2014-01-09 02:54:39
e324c149077d99cb722ab3b9e05759cb4dfa07a9...02a45826f12842a5eec07989264abbe42b381a7c,1,13,5,18,6,2014-01-14 06:39:44,2014-01-13 20:32:20
02a45826f12842a5eec07989264abbe42b381a7c...524650a40ed20f01571e5466475749874ee67288,2,36,4,40,5,2014-01-14 18:18:50,2014-01-02 19:52:49
524650a40ed20f01571e5466475749874ee67288...7d5d62dafe11620082c79da35958f8014eeb008c,2,102,8,110,9,2014-01-14 18:19:09,2014-01-02 22:27:13
7d5d62dafe11620082c79da35958f8014eeb008c...4aa9df7a7ae533531dfae1e3eb9646245d6b5ff4,2,70,5,75,10,2014-01-14 18:20:10,2014-01-06 04:47:18
4aa9df7a7ae533531dfae1e3eb9646245d6b5ff4...6df598d9f5a52085b90085b41631ef34f3edc386,1,0,35,35,1,2014-01-14 18:20:27,2014-01-14 01:51:10
6df598d9f5a52085b90085b41631ef34f3edc386...ed53100a0dbc9119d5dfc8b7248845d4f6989df2,2,56,10,66,10,2014-01-14 18:20:50,2014-01-12 04:44:43
ed53100a0dbc9119d5dfc8b7248845d4f6989df2...4ae3184c5915aac9aa00889aa2153c8e84c14966,4,142,82,224,88,2014-01-14 18:21:19,2014-01-12 20:49:52
4ae3184c5915aac9aa00889aa2153c8e84c14966...dde1b2949727c297e214c99960141bfad438d7a4,2,100,3,103,11,2014-01-14 18:21:28,2014-01-14 02:51:08
dde1b2949727c297e214c99960141bfad438d7a4...7d09bd30f9fc2c265588323817b541fd26b9abe0,1,0,2,2,2,2014-01-15 08:29:20,2014-01-15 08:29:20
7d09bd30f9fc2c265588323817b541fd26b9abe0...1413328e6aec87338bf1fce002dfaf519d9ca1b5,1,29,19,48,1,2014-01-15 08:43:52,2014-01-15 08:43:52
1413328e6aec87338bf1fce002dfaf519d9ca1b5...9f5d0cf79ff14cc67897b0f7869ba137afd426b2,1,36,0,36,1,2014-01-15 17:24:18,2014-01-15 17:24:18
9f5d0cf79ff14cc67897b0f7869ba137afd426b2...07ee29c5639dbabfba97c1c9096aa5f04d0b43d7,1,1,1,2,1,2014-01-15 18:02:10,2014-01-15 18:02:10
07ee29c5639dbabfba97c1c9096aa5f04d0b43d7...8ea8da4f1119cdce19df5b714e3d8bec0c3e74d9,1,2,2,4,2,2014-01-15 18:15:55,2014-01-15 18:15:55
8ea8da4f1119cdce19df5b714e3d8bec0c3e74d9...61eb426ab412f4a4c9756727c34509b0dfdc03e5,1,1,1,2,1,2014-01-15 21:39:34,2014-01-15 21:39:34
61eb426ab412f4a4c9756727c34509b0dfdc03e5...51a7f9dc4ae4cb52be3599a172d0c1d9c44bfc8e,1,4,4,8,3,2014-01-15 22:41:17,2014-01-14 07:44:31
51a7f9dc4ae4cb52be3599a172d0c1d9c44bfc8e...cd0af8a771d748ca183cab6f1a2a5f9584ec5693,1,1,1,2,1,2014-01-15 22:46:12,2014-01-15 04:00:38
cd0af8a771d748ca183cab6f1a2a5f9584ec5693...e591ddcb30a2cfd9dedcc7cfbd38db29725c4780,1,10,0,10,2,2014-01-15 22:59:01,2014-01-13 13:19:37
e591ddcb30a2cfd9dedcc7cfbd38db29725c4780...6a9ccacd626229b75629f652d13221fd37996432,1,2,2,4,1,2014-01-16 00:31:06,2013-12-29 14:24:32
6a9ccacd626229b75629f652d13221fd37996432...0e4d7cacad9d51be171fcf3222ce48dbdfc92ffa,1,3,3,6,2,2014-01-17 00:13:53,2014-01-16 22:57:10
0e4d7cacad9d51be171fcf3222ce48dbdfc92ffa...1cdcddb5cca1cfce7d5718b997d75e654b7ec3ef,1,7,7,14,5,2014-01-17 02:49:01,2014-01-17 02:43:34
1cdcddb5cca1cfce7d5718b997d75e654b7ec3ef...fced1c0c1663738885033a3aa00a02dc89bf000b,1,1,1,2,1,2014-01-17 04:11:52,2014-01-17 04:05:03
fced1c0c1663738885033a3aa00a02dc89bf000b...cd74f7446822189929270643ce7c4dc9eb7fa36a,1,1,1,2,1,2014-01-17 20:34:33,2014-01-16 06:22:35
cd74f7446822189929270643ce7c4dc9eb7fa36a...2262ca66978cb055013703e2c2b8f0f5cf20ac05,1,10,0,10,1,2014-01-17 20:51:29,2014-01-15 04:14:35
2262ca66978cb055013703e2c2b8f0f5cf20ac05...5adea0ba64b758f8f5700da73f6faca8ae1983be,1,4,1,5,1,2014-01-17 21:40:10,2014-01-05 15:58:32
5adea0ba64b758f8f5700da73f6faca8ae1983be...7ba30fd2e748f1878c085d7f76a8c59215d4694b,1,7,7,14,5,2014-01-17 22:12:53,2013-12-28 01:57:14
7ba30fd2e748f1878c085d7f76a8c59215d4694b...8dd4f14a04afdf1cc1d1ab8448a0ec533799dfaf,1,11,4,15,7,2014-01-17 23:15:25,2014-01-06 23:47:41
8dd4f14a04afdf1cc1d1ab8448a0ec533799dfaf...c3e1a41d6fba9946a8e051517b9ce154f15466aa,1,2,2,4,1,2014-01-18 00:19:27,2014-01-17 23:44:28
c3e1a41d6fba9946a8e051517b9ce154f15466aa...756c52d6c165d89ee5a2ab1aa65582ccfce8964e,1,3,3,6,1,2014-01-18 03:36:05,2013-12-23 03:37:12
756c52d6c165d89ee5a2ab1aa65582ccfce8964e...1028cfaa305550d3ea414cf68515e7b4bb05af93,1,1,1,2,1,2014-01-18 20:26:18,2014-01-18 16:13:44
1028cfaa305550d3ea414cf68515e7b4bb05af93...42ec95ebae716c81087684b55ed8fa8c13888abc,1,7,0,7,1,2014-01-18 20:35:33,2014-01-18 15:01:20
42ec95ebae716c81087684b55ed8fa8c13888abc...928d000db75e898ed860ecc07c0b0dce56e57533,1,1,1,2,1,2014-01-18 22:10:46,2014-01-18 21:49:57
928d000db75e898ed860ecc07c0b0dce56e57533...90e60d2d54ddadf29e5b7c52ac16b3c0f52b4650,1,3,3,6,1,2014-01-18 22:36:58,2014-01-18 20:02:33
90e60d2d54ddadf29e5b7c52ac16b3c0f52b4650...99c5027bf26fa1e14611eb38b8ad9d0197784897,1,3,5,8,1,2014-01-19 03:09:56,2013-12-17 04:22:43
99c5027bf26fa1e14611eb38b8ad9d0197784897...6c9131ef10377e096c178d378666bc7fc2919f09,1,4,21,25,3,2014-01-19 03:52:58,2013-12-19 19:48:43
6c9131ef10377e096c178d378666bc7fc2919f09...8b395ff3258526d9f395b828874eac7a4b5f46e5,1,16,0,16,16,2014-01-20 04:29:39,2014-01-17 06:42:34
8b395ff3258526d9f395b828874eac7a4b5f46e5...f09b6aa5b58c090e3b8f8811fb7735e38d4b7623,2,11,2,13,4,2014-01-22 00:27:04,2014-01-17 17:59:49
f09b6aa5b58c090e3b8f8811fb7735e38d4b7623...5b9ff6cf48d15eaf1a93748271e80bd7051889eb,1,1,1,2,1,2014-01-22 00:28:30,2014-01-21 12:05:48
5b9ff6cf48d15eaf1a93748271e80bd7051889eb...d7e6f1b192419195c288eed206d6b81c96847cc4,1,1,1,2,1,2014-01-22 00:43:52,2014-01-21 11:46:17
d7e6f1b192419195c288eed206d6b81c96847cc4...6d525f06c0c78f2f06b4e9968478053673e1832d,1,1,1,2,1,2014-01-22 00:45:27,2014-01-21 20:19:54
6d525f06c0c78f2f06b4e9968478053673e1832d...fd6bac7de56f728a89782dc80c78f7d5c21bbc65,1,1,1,2,1,2014-01-22 00:56:57,2014-01-21 23:15:05
fd6bac7de56f728a89782dc80c78f7d5c21bbc65...3c12d36e730dfbf8e2dbba773df5879437276d7a,1,5,0,5,1,2014-01-22 00:58:41,2014-01-15 18:00:48
3c12d36e730dfbf8e2dbba773df5879437276d7a...60e80509a8f69a7fa750c3399b84bd0d4cc53855,1,4,2,6,3,2014-01-22 01:02:50,2014-01-22 01:02:50
60e80509a8f69a7fa750c3399b84bd0d4cc53855...12d1f5700d6dd150065002f65398e51447e6dddc,1,4,0,4,1,2014-01-22 01:04:49,2014-01-20 21:04:25
12d1f5700d6dd150065002f65398e51447e6dddc...0fc64ad8a111bd376de98035ec118fad6aafcb61,1,1,1,2,1,2014-01-22 01:12:34,2014-01-22 01:12:34
0fc64ad8a111bd376de98035ec118fad6aafcb61...310f129c1d5d54f68074000d7b12ec0258e6fc4f,1,2,1,3,1,2014-01-22 01:14:00,2014-01-22 01:13:56
310f129c1d5d54f68074000d7b12ec0258e6fc4f...030a9b8d33767d0b27104b6208797ab837f4b892,1,0,3,3,1,2014-01-22 01:17:14,2014-01-17 21:26:59
030a9b8d33767d0b27104b6208797ab837f4b892...7cf5544a9f5bea443ccac2143765154760ceaff9,1,50,37,87,2,2014-01-22 01:23:05,2014-01-22 01:19:00
7cf5544a9f5bea443ccac2143765154760ceaff9...79e519fedaec54390a8bdacfb1926bfce57a1eb6,2,3,2,5,2,2014-01-22 02:40:55,2014-01-22 02:19:31
79e519fedaec54390a8bdacfb1926bfce57a1eb6...ec59be67bc1ffd8a75d7b18bf5891a49450a5763,1,1,1,2,1,2014-01-22 16:34:56,2014-01-22 14:48:10
ec59be67bc1ffd8a75d7b18bf5891a49450a5763...82213efff23a71ca37e1a99c11ef6bc49b1af1eb,1,11,0,11,1,2014-01-22 17:41:35,2014-01-13 23:20:44
82213efff23a71ca37e1a99c11ef6bc49b1af1eb...7f444a205e87bff66c924040a102e5442bbc61c6,1,3,3,6,2,2014-01-22 19:14:59,2014-01-22 19:13:36
7f444a205e87bff66c924040a102e5442bbc61c6...c3b5e16d8441ad0b417eceaf7fc6e64703f05882,1,1,1,2,1,2014-01-22 19:26:33,2014-01-22 17:43:55
c3b5e16d8441ad0b417eceaf7fc6e64703f05882...b07afa0465b73c00e7f6d7a9479011360eb29b82,3,23,1992,2015,3,2014-01-22 19:38:14,2014-01-21 10:07:47
b07afa0465b73c00e7f6d7a9479011360eb29b82...e0209169bf1463465ad07484421620748a4d3908,2,72,2,74,4,2014-01-22 19:51:47,2014-01-20 16:21:50
e0209169bf1463465ad07484421620748a4d3908...5e9835b4f245346b3c79f5e4927c9accfb57a50d,2,9,1,10,2,2014-01-23 17:27:30,2014-01-23 17:26:23
5e9835b4f245346b3c79f5e4927c9accfb57a50d...40dc806e03b81cf8bdbb24d67c8e8e3c8af42324,1,3,0,3,1,2014-01-23 21:43:31,2014-01-23 21:41:43
40dc806e03b81cf8bdbb24d67c8e8e3c8af42324...ca6b7d0fa2e355ebd764230260758cee9a4ebe1e,2,18,2,20,3,2014-01-24 17:21:29,2014-01-22 17:38:26
ca6b7d0fa2e355ebd764230260758cee9a4ebe1e...131410b61bfca0c21714c1a9e1b3fdc514e21d3a,1,13,5,18,1,2014-01-24 18:02:50,2014-01-24 17:29:20
131410b61bfca0c21714c1a9e1b3fdc514e21d3a...4f827f587b340ff7563ca01fe68c244a6cd0d5c4,1,27,0,27,1,2014-01-24 18:34:45,2014-01-24 18:33:00
4f827f587b340ff7563ca01fe68c244a6cd0d5c4...451bde124497a4fdae19a4f7e89c42cd3715ac09,1,1,1,2,1,2014-01-24 23:28:28,2014-01-24 23:28:28
451bde124497a4fdae19a4f7e89c42cd3715ac09...88a14b4e25c50bed58a3b5d5a0e04ecb73fdfad9,1,2,2,4,2,2014-01-24 23:42:49,2014-01-24 23:42:49
88a14b4e25c50bed58a3b5d5a0e04ecb73fdfad9...319dd1a449f952c9204addab536d41cc5ba54290,1,1,1,2,1,2014-01-25 03:27:18,2014-01-25 03:27:18
319dd1a449f952c9204addab536d41cc5ba54290...4f735b060563463d40711180beda6527722482b3,1,1,1,2,1,2014-01-26 20:42:27,2014-01-26 19:34:39
4f735b060563463d40711180beda6527722482b3...766b3d5c874a9c53fe6bfcf17e498e1dcf42c3a9,1,1,1,2,1,2014-01-26 20:45:04,2014-01-26 20:28:06
766b3d5c874a9c53fe6bfcf17e498e1dcf42c3a9...f54f0f98a095a2d4666273cd2068e56c66b2d44d,1,0,4,4,1,2014-01-27 19:46:18,2014-01-27 19:46:18
f54f0f98a095a2d4666273cd2068e56c66b2d44d...849a1489c7d676c921e7a1eaf6011cf49494dd3a,1,2,2,4,2,2014-01-27 20:06:17,2014-01-27 20:04:32
849a1489c7d676c921e7a1eaf6011cf49494dd3a...8a0be355a9685d9fbdb4989513c4374c2b5470d7,1,1,1,2,1,2014-01-28 05:17:53,2014-01-27 20:05:18
8a0be355a9685d9fbdb4989513c4374c2b5470d7...95f0bf9b526fda8964527c6d4aef1ad50a47f1f3,1,1,1,2,1,2014-01-28 06:26:18,2014-01-07 12:33:39
95f0bf9b526fda8964527c6d4aef1ad50a47f1f3...ce37ae28687167f7b4274ba547f013980126a219,12,6,694,700,18,2014-01-28 19:12:52,2014-01-23 23:14:02
ce37ae28687167f7b4274ba547f013980126a219...7aef2d54e0a48fae18a289813f699962d8310565,39,724,605,1329,256,2014-01-28 19:14:20,2014-01-12 00:59:15
7aef2d54e0a48fae18a289813f699962d8310565...7a78aed1603ca7f60f2f70ba27f0102e08862550,1,1,1,2,1,2014-01-29 13:51:02,2014-01-29 06:33:15
7a78aed1603ca7f60f2f70ba27f0102e08862550...e2173f9101545b60367fd95524232fb8cf2eabca,1,9,10,19,2,2014-01-29 14:10:01,2014-01-28 00:53:25
e2173f9101545b60367fd95524232fb8cf2eabca...6dcfccb32c79019f16a2c97ad50cbcc81f61095c,1,3,3,6,4,2014-01-30 18:51:20,2014-01-29 22:21:26
6dcfccb32c79019f16a2c97ad50cbcc81f61095c...7f4edaff6e50bdfc524e7dc70ed96663fd7dcea2,4,37,3,40,7,2014-01-30 19:39:53,2014-01-30 18:51:10
7f4edaff6e50bdfc524e7dc70ed96663fd7dcea2...caed2dfe4feeac5d19ecea2dbb1456b7fde21e6d,1,2,2,4,2,2014-01-31 00:50:08,2014-01-29 18:16:54
caed2dfe4feeac5d19ecea2dbb1456b7fde21e6d...29432ffe3795477d8f6174cee1976683ded89d67,1,7,7,14,4,2014-01-31 00:52:06,2014-01-28 04:36:27
29432ffe3795477d8f6174cee1976683ded89d67...339a1658cd9bfa5e322a01c45aa0a1df67e3a842,2,11,1,12,2,2014-01-31 11:16:46,2014-01-28 01:35:27
339a1658cd9bfa5e322a01c45aa0a1df67e3a842...c22ab5d2e28605462ba77f6c02e99efdd24338a3,1,0,2,2,1,2014-01-31 15:48:36,2014-01-31 15:48:36
c22ab5d2e28605462ba77f6c02e99efdd24338a3...5ed721b9b5e95ae08450e1ae9d5202e7f3f79295,2,24,0,24,3,2014-01-31 17:45:35,2014-01-03 16:50:53
5ed721b9b5e95ae08450e1ae9d5202e7f3f79295...074b0675a1f97dce07f520f1ae6198ed3c604000,2,14,1,15,3,2014-01-31 19:38:06,2014-01-31 18:22:36
074b0675a1f97dce07f520f1ae6198ed3c604000...fd61e222c337380af09ff08dc3fe73f17e9a7a8e,1,1,1,2,1,2014-02-01 00:31:06,2014-01-23 09:37:57
fd61e222c337380af09ff08dc3fe73f17e9a7a8e...ef210e5e119db4f5bfc9d2428b19f9b335c4f976,2,21,6,27,3,2014-02-01 00:52:42,2014-01-08 01:23:33
ef210e5e119db4f5bfc9d2428b19f9b335c4f976...6609e3da76dd898cfe85f75f23ab2e39fee65fe5,1,1,1,2,1,2014-02-01 01:03:30,2014-02-01 01:03:30
6609e3da76dd898cfe85f75f23ab2e39fee65fe5...8205158e477f1ea235feba3087143e0d3e5e52ec,1,1,1,2,1,2014-02-03 14:14:45,2014-02-03 09:46:16
8205158e477f1ea235feba3087143e0d3e5e52ec...ce1f1f97f0ebf77941b2bdaf5e8352d33786524d,2,5,1,6,3,2014-02-03 16:12:07,2014-01-27 19:04:45
ce1f1f97f0ebf77941b2bdaf5e8352d33786524d...c0c0b2b67461b2c6521ae290fb1a7ea19ff075e8,1,24,0,24,1,2014-02-03 17:28:45,2014-02-03 17:28:45
c0c0b2b67461b2c6521ae290fb1a7ea19ff075e8...d5eedf38db6e6b49fb646cd7443556790c67207d,1,1,1,2,1,2014-02-03 17:40:03,2014-02-03 17:40:03
d5eedf38db6e6b49fb646cd7443556790c67207d...106af49258ddbf4bc0686896a2cb4dab9feac294,1,2,2,4,2,2014-02-03 17:41:17,2014-02-03 17:41:17
106af49258ddbf4bc0686896a2cb4dab9feac294...bc5ceee2758798c074f2b271ca81492b40bfe5c3,1,1,1,2,1,2014-02-03 18:03:06,2014-02-03 18:03:06
bc5ceee2758798c074f2b271ca81492b40bfe5c3...19ba6510d02317311fd1af3a173bc9eb970615bc,1,0,1,1,1,2014-02-03 19:43:14,2014-02-03 19:43:14
19ba6510d02317311fd1af3a173bc9eb970615bc...37781ed14587f96a97e5cbb6e29a66399f84a6fd,1,1,1,2,1,2014-02-04 00:19:29,2014-02-03 09:51:40
37781ed14587f96a97e5cbb6e29a66399f84a6fd...e7ac7aa43b88932a08140c2dabb8000e285f06d7,2,14,24,38,9,2014-02-04 00:25:47,2014-02-02 07:14:07
e7ac7aa43b88932a08140c2dabb8000e285f06d7...3bf43903397c703aa2e9ba1e1a48dbc9e8286ee2,2,20,1,21,2,2014-02-04 06:25:30,2014-02-04 00:53:52
3bf43903397c703aa2e9ba1e1a48dbc9e8286ee2...64d58a5b5292046adf8b28928950858ab3895fcc,1,3,4,7,2,2014-02-04 06:41:18,2014-02-04 06:41:18
64d58a5b5292046adf8b28928950858ab3895fcc...cc60ba1f357e13145222011ba97e6b0694937f82,1,1,1,2,1,2014-02-04 08:00:31,2014-02-01 21:25:38
cc60ba1f357e13145222011ba97e6b0694937f82...0da6cc91186a04b089994293c0dfcda11851dd2d,1,1,1,2,1,2014-02-04 13:45:48,2014-02-04 12:41:47
0da6cc91186a04b089994293c0dfcda11851dd2d...d2e4e499862aeca157dbe7a7422c465e7c79205e,4,67,3,70,5,2014-02-04 15:51:24,2014-01-07 15:09:37
d2e4e499862aeca157dbe7a7422c465e7c79205e...5850e61c82b203bd2cccf92d17e58a4ab6f0b134,1,24,0,24,1,2014-02-04 15:59:44,2014-01-28 16:49:16
5850e61c82b203bd2cccf92d17e58a4ab6f0b134...431bad01835f0294eb159d5b08101d5904828147,1,15,2,17,1,2014-02-04 23:46:54,2014-02-04 23:34:23
431bad01835f0294eb159d5b08101d5904828147...058842ad04009c306f9ac1403f3b8e354af523bd,1,2,15,17,1,2014-02-05 00:09:53,2014-02-05 00:09:53
058842ad04009c306f9ac1403f3b8e354af523bd...8761ddc0e382f48fa0317c88bd6426997d24037f,7,150,118,268,23,2014-02-05 00:20:22,2014-02-04 18:25:10
8761ddc0e382f48fa0317c88bd6426997d24037f...aa6a0e3fc6e98e362b5705ea730ab9c2fcf7a7e6,1,1,1,2,1,2014-02-05 00:26:36,2014-02-04 15:16:49
aa6a0e3fc6e98e362b5705ea730ab9c2fcf7a7e6...24699ee8f04c1f1459be1d36207e654421d58ff0,1,14,1,15,1,2014-02-05 00:34:31,2014-02-04 23:34:23
24699ee8f04c1f1459be1d36207e654421d58ff0...36d37c0e3880c774d20c014ade60d2331beefa15,2,14,0,14,2,2014-02-05 00:39:52,2014-02-04 16:37:09
36d37c0e3880c774d20c014ade60d2331beefa15...dd24c78373b5d24ecb3b9d19e61e1b3b6c74d155,2,6,0,6,2,2014-02-05 00:41:25,2014-02-04 01:04:46
dd24c78373b5d24ecb3b9d19e61e1b3b6c74d155...c5f69e3f64514223917d74caf14d21b899474b42,1,2,2,4,2,2014-02-05 00:43:39,2014-02-02 01:00:26
c5f69e3f64514223917d74caf14d21b899474b42...95522cc11f01528b569f88a089def9acded938b4,1,1,1,2,1,2014-02-05 14:58:26,2014-02-05 09:39:03
95522cc11f01528b569f88a089def9acded938b4...a29bff1c98161495fb304d0195c4d2916b357686,1,1,1,2,1,2014-02-05 23:34:56,2014-02-05 23:33:35
a29bff1c98161495fb304d0195c4d2916b357686...e7face4728d3aed6dc089966d489d0c93b65913d,4,13,8,21,6,2014-02-05 23:39:46,2014-01-28 21:56:33
e7face4728d3aed6dc089966d489d0c93b65913d...0e85ca9ddb5f259908400463764fd6141977b341,12,99,19,118,23,2014-02-05 23:39:59,2014-01-31 02:49:58
0e85ca9ddb5f259908400463764fd6141977b341...84467d869730c6821c07496f510355ab73e7c10b,6,15,14,29,10,2014-02-05 23:40:16,2014-01-31 06:09:09
84467d869730c6821c07496f510355ab73e7c10b...8829a2a86d19c2286a51587333ff10f0f3b4d3d3,1,1,1,2,1,2014-02-06 00:13:06,2014-02-05 23:51:00
8829a2a86d19c2286a51587333ff10f0f3b4d3d3...a8c1d9c97804f7df98150456c2702fd39e3a22f0,1,1,1,2,1,2014-02-06 00:25:03,2014-02-05 16:29:30
a8c1d9c97804f7df98150456c2702fd39e3a22f0...906fdad0f95465842e336e057ea97d0633712189,9,205,182,387,89,2014-02-06 06:21:41,2014-01-23 00:21:05
906fdad0f95465842e336e057ea97d0633712189...4224cd5182bc93e4a210f75e0a4e4de7f3c544e8,10,26,39,65,18,2014-02-06 06:22:14,2014-01-23 00:28:42
4224cd5182bc93e4a210f75e0a4e4de7f3c544e8...e609239fab46d7f8af195a69756c91b4f66c8463,2,1,4,5,2,2014-02-06 10:31:23,2014-02-06 10:31:23
e609239fab46d7f8af195a69756c91b4f66c8463...95d119ebb21ce94df63043ee600f6b4dba4cfcdf,1,1,1,2,1,2014-02-06 15:44:31,2014-02-06 07:00:32
95d119ebb21ce94df63043ee600f6b4dba4cfcdf...bf4b0dbd46c67553b2e35a0f5d3ac1626d105418,1,1,1,2,1,2014-02-06 16:15:13,2014-02-06 16:02:32
bf4b0dbd46c67553b2e35a0f5d3ac1626d105418...95be253fe55d35336d425d3d600a36158fc3519d,2,4,4,8,4,2014-02-07 00:11:29,2014-02-06 23:41:45
95be253fe55d35336d425d3d600a36158fc3519d...16301bed2838276b1d5f315bde621edb32f82c6c,1,8,1,9,1,2014-02-07 01:03:39,2014-02-06 20:45:43
16301bed2838276b1d5f315bde621edb32f82c6c...fcf4393680191584677872c686f26bfff01e4f37,5,43,21,64,12,2014-02-07 01:53:37,2014-02-07 01:49:14
fcf4393680191584677872c686f26bfff01e4f37...84fd3a18a3a7f181d1b8c0a7c02b703cc4b8ec3a,1,4,0,4,2,2014-02-07 19:16:17,2014-02-07 19:15:00
84fd3a18a3a7f181d1b8c0a7c02b703cc4b8ec3a...d5c7ef0f7886afdfeb6d78b7e320ba2bfe5c77ba,1,4,3,7,2,2014-02-07 20:14:32,2014-02-07 20:14:32
d5c7ef0f7886afdfeb6d78b7e320ba2bfe5c77ba...5cc5cc13b9beb996e0173e97db5c0e04d0204dfb,1,61,0,61,1,2014-02-07 22:00:28,2014-02-07 21:49:41
5cc5cc13b9beb996e0173e97db5c0e04d0204dfb...5218c7bbdcc758b8a7b8bd83bb1e189c71784461,1,1,1,2,1,2014-02-07 22:38:15,2014-02-07 22:38:15
5218c7bbdcc758b8a7b8bd83bb1e189c71784461...600e6218fedd03bffabf78a9f7d0d9b68515b9a3,1,0,2,2,1,2014-02-08 04:23:26,2014-02-08 01:49:47
600e6218fedd03bffabf78a9f7d0d9b68515b9a3...ad275b226551e45b68dace46af5fcd8178e31a60,2,9,17,26,6,2014-02-08 04:41:11,2014-02-06 19:03:17
ad275b226551e45b68dace46af5fcd8178e31a60...e645f7cae14618bd8fc7d6b3eadf9307f5a1aeb7,5,49,8,57,8,2014-02-08 04:41:39,2014-02-06 19:29:24
e645f7cae14618bd8fc7d6b3eadf9307f5a1aeb7...27613fd50020e6c9fe36b7622eb881fb34ce7dc6,1,1,1,2,1,2014-02-10 23:09:03,2014-02-10 14:16:46
27613fd50020e6c9fe36b7622eb881fb34ce7dc6...2dfbc083c518ce591610ec619127bc8441615df9,1,3,3,6,3,2014-02-10 23:15:30,2014-02-10 20:57:27
2dfbc083c518ce591610ec619127bc8441615df9...e7338d3f27e8824196136a18e1c3e0fcf51a0e28,2,60,3,63,4,2014-02-10 23:41:28,2014-01-28 16:34:01
e7338d3f27e8824196136a18e1c3e0fcf51a0e28...f99fe799e29f691783ebdd604debfbbd0da80f6b,1,1,1,2,1,2014-02-10 23:58:34,2014-02-10 10:00:54
f99fe799e29f691783ebdd604debfbbd0da80f6b...ec900cabfc9d49e502b474e85f387737396e70b8,1,19,17,36,7,2014-02-11 00:19:10,2014-02-10 21:01:29
ec900cabfc9d49e502b474e85f387737396e70b8...945fc1a4bca1a0856fc909f1d1b8d60d4a5e59bb,1,5,5,10,4,2014-02-11 00:19:10,2014-02-11 00:18:47
945fc1a4bca1a0856fc909f1d1b8d60d4a5e59bb...a68624444afcb9e3796b1a751cf3817cafd20240,1,2,2,4,1,2014-02-11 00:35:22,2014-02-10 08:17:08
a68624444afcb9e3796b1a751cf3817cafd20240...71f974b4592ae3662d2285d74948b328edea1d3a,1,2,0,2,2,2014-02-11 01:09:34,2014-02-09 15:16:16
71f974b4592ae3662d2285d74948b328edea1d3a...b6ab826c4bf3717a3b9466a6a1e0db9388cf351d,1,1,1,2,1,2014-02-11 01:09:35,2014-02-11 01:07:43
b6ab826c4bf3717a3b9466a6a1e0db9388cf351d...ef4bf8c77cf0c1cd1276b6cee2fd48317d3902b5,1,1,1,2,1,2014-02-11 16:46:36,2014-02-11 16:36:50
ef4bf8c77cf0c1cd1276b6cee2fd48317d3902b5...08793a690abe3eda40deae10f8a0a117779bdbd9,1,7,14,21,3,2014-02-11 19:57:56,2013-12-13 23:20:31
08793a690abe3eda40deae10f8a0a117779bdbd9...b4eed8ad94ce9719540462c1ee969dfd3c6b2355,3,22,1,23,4,2014-02-11 22:08:41,2014-02-11 14:57:04
b4eed8ad94ce9719540462c1ee969dfd3c6b2355...56cc7bcc983d05237705390935b7b808215a0b47,1,2,2,4,2,2014-02-11 23:23:25,2014-02-07 10:40:54
56cc7bcc983d05237705390935b7b808215a0b47...686b13bf60e5b2d3d904fde5c076e50faaf9bcb7,1,1,0,1,1,2014-02-11 23:42:16,2014-01-31 03:10:08
686b13bf60e5b2d3d904fde5c076e50faaf9bcb7...760f49de1004adb3943e73cfa8135717a96a6273,1,1,1,2,1,2014-02-11 23:54:38,2014-02-06 22:06:03
760f49de1004adb3943e73cfa8135717a96a6273...72894f0dd28ca8f059b79bff667ed11b7ea304bb,1,1,1,2,1,2014-02-12 02:29:47,2014-02-11 05:09:30
72894f0dd28ca8f059b79bff667ed11b7ea304bb...46cba2e05dff2ca34a1d5c85e6d68abc9c06d9fe,1,3,0,3,1,2014-02-12 13:19:24,2014-02-12 09:53:52
46cba2e05dff2ca34a1d5c85e6d68abc9c06d9fe...e7ab857ddbaf807859494eeeacc248e00c4a2fc5,1,1,1,2,1,2014-02-12 13:26:21,2014-02-12 10:14:25
e7ab857ddbaf807859494eeeacc248e00c4a2fc5...98b2f8ef18cd3024e566252d4537075cb3e4a24b,1,2,1,3,1,2014-02-12 15:05:35,2014-02-12 14:39:51
98b2f8ef18cd3024e566252d4537075cb3e4a24b...d119e3630246da3169e6b89e98a48d7731fd837e,1,1,1,2,1,2014-02-12 19:39:41,2014-01-14 18:41:50
d119e3630246da3169e6b89e98a48d7731fd837e...1079105443145a85a47496591b5d249a223710f2,1,1,1,2,1,2014-02-12 19:41:37,2014-01-14 19:40:32
1079105443145a85a47496591b5d249a223710f2...2b7302713674506fdbcdc396c38f18dcb90dee8c,2,12,0,12,2,2014-02-13 01:28:13,2013-12-16 18:06:16
c3eac13aa7106d099e8f09c39518051ccf939060...03ddc4570b786a7b945e1b40a16f29d2349c68b8,3,72,61,133,62,2010-03-24 17:35:01,2010-03-24 17:35:01
03ddc4570b786a7b945e1b40a16f29d2349c68b8...563a98e4bd0fd9f2277befcfe45ff2d0476878d8,1,1,1,2,1,2010-03-24 17:50:02,2010-03-24 17:50:02
c3eac13aa7106d099e8f09c39518051ccf939060...f6664ed7f6f6dd1f4f9756f57611a316089149cb,3,35,24,59,22,2010-03-20 05:18:39,2010-03-20 05:18:39
f6664ed7f6f6dd1f4f9756f57611a316089149cb...84552f7f8ac3f39c4dbd7d946ae2938d63302840,10,391,232,623,132,2010-03-22 20:58:04,2010-03-22 20:58:04
84552f7f8ac3f39c4dbd7d946ae2938d63302840...b4561ff951ff452e55e820f6f8344dc2668cfd90,4,77,18,95,14,2010-03-22 22:46:34,2010-03-22 22:46:34
3d3694240034b6841c9fdf2e38a2a7955cb592c7...0c42eb9909d554807549cd3394e0ea0c715cc2d1,7,187,57,244,37,2010-03-24 23:13:42,2010-03-24 23:13:42
0c42eb9909d554807549cd3394e0ea0c715cc2d1...f29f6a47c4d81c5b8e365a3dae307159f1b12968,4,49,18,67,15,2010-03-24 23:47:11,2010-03-24 23:47:11
f29f6a47c4d81c5b8e365a3dae307159f1b12968...b814c79b58deeeeaa12b03261399ef80c0d6cc9f,7,142,133,275,26,2010-03-25 20:01:08,2010-03-25 20:01:08
b814c79b58deeeeaa12b03261399ef80c0d6cc9f...4fa166866b97d4f4dbd21514dbd674347da0a109,7,93,58,151,23,2010-03-25 21:43:05,2010-03-25 21:43:05
4fa166866b97d4f4dbd21514dbd674347da0a109...0cc9b0732003451537a5bfc444fb6590f4ed103a,2,36,6,42,6,2010-03-25 21:51:42,2010-03-25 21:51:42
0cc9b0732003451537a5bfc444fb6590f4ed103a...d934054cfc22325d817eb0643dc061f9d212804d,8,347,214,561,91,2010-03-26 05:03:11,2010-03-26 05:03:11
d934054cfc22325d817eb0643dc061f9d212804d...1990cbbf2817e04657ccd616da1d9d6b78cc2949,3,98,4,102,5,2010-03-26 05:07:36,2010-03-26 05:07:36
1990cbbf2817e04657ccd616da1d9d6b78cc2949...258ca5f16581f0e8befa493644225a02ae2fc002,32,1637,1522,3159,84,2010-03-26 23:27:18,2010-03-26 23:27:18
258ca5f16581f0e8befa493644225a02ae2fc002...c655b884e268c8c9b6853d440143953f51b7e7de,5,17,19,36,10,2010-03-29 17:40:57,2010-03-29 17:40:57
c655b884e268c8c9b6853d440143953f51b7e7de...e55c97debaa0ef8487ece219b6eadbc147ece1f9,26,820,850,1670,373,2010-03-30 03:25:42,2010-03-30 03:25:42
e55c97debaa0ef8487ece219b6eadbc147ece1f9...cc6def854f2c77d0a7fea177df0dca858b8cd943,6,50,31,81,11,2010-03-30 04:36:34,2010-03-30 04:36:34
cc6def854f2c77d0a7fea177df0dca858b8cd943...d2d356918bd1c0c76673d22ff85c617fbd85d40e,3,70,92,162,71,2010-03-30 04:49:12,2010-03-30 04:49:12
d2d356918bd1c0c76673d22ff85c617fbd85d40e...a7d62dcb5533ceb9a7ae47ee27e2054400a0196b,11,194,152,346,87,2010-03-30 21:55:04,2010-03-30 21:55:04
a7d62dcb5533ceb9a7ae47ee27e2054400a0196b...b5b8f63e1ebc75d09c6faf8dbad6497880deed47,5,17,23,40,12,2010-03-30 22:39:51,2010-03-30 22:39:51
b5b8f63e1ebc75d09c6faf8dbad6497880deed47...35a91085004e31f786df1e0011bc26ed0142ab4d,13,142,156,298,94,2010-03-31 20:57:25,2010-03-31 20:57:25
ab2213e80e09c763782bebc5e0ff7509056e828a...3d5719cd44868f89352ebbedd0e1b1f2575520cb,3,9,155,164,10,2010-08-11 18:44:12,2010-08-11 18:44:12
3d5719cd44868f89352ebbedd0e1b1f2575520cb...044ecb91c10753c14e1521f95b5f0cd52ff5bf87,6,44,56,100,13,2010-08-11 19:04:02,2010-08-11 19:04:02
04e92a875344fb675f27355a8bae7a22d0a6ae63...cf331050112ee973b9e8186dc4741028ca22f024,4,19,8,27,12,2010-08-11 18:45:22,2010-08-11 18:42:04
c4c96c5c69846fb8eccc278c1eb20f94d69a2b99...e7b90956552bc129935e7b8dec947eb3e30f3c29,2,67,35,102,11,2010-08-11 02:10:43,2010-08-11 02:10:43
e7b90956552bc129935e7b8dec947eb3e30f3c29...567341c10fc7f74d5333f27514bb2201f1dbee42,2,25,23,48,5,2010-08-11 17:54:11,2010-08-11 17:54:11
567341c10fc7f74d5333f27514bb2201f1dbee42...b27fb8a6448b7c8d59b533fe2df9497170fbaa70,4,19,8,27,12,2010-08-11 18:42:04,2010-08-11 18:42:04
b27fb8a6448b7c8d59b533fe2df9497170fbaa70...946b5284cdcfde587bedf059e9beadee7da9f91b,1,1,1,2,2,2010-08-11 20:33:21,2010-08-11 20:33:21
946b5284cdcfde587bedf059e9beadee7da9f91b...577ddaa5392dfad3b984515de0ad9262764a8721,2,81,14,95,11,2010-08-13 16:31:06,2010-08-13 16:31:06
577ddaa5392dfad3b984515de0ad9262764a8721...2767d7773f2e480552e9968eded31bd2b08bec71,2,12,30,42,3,2010-08-13 16:45:56,2010-08-13 16:45:56
2767d7773f2e480552e9968eded31bd2b08bec71...275f036c1f146d37c088027c79338d0d5209c03a,1,2,2,4,2,2010-08-13 17:11:11,2010-08-13 17:11:11
275f036c1f146d37c088027c79338d0d5209c03a...675978f41fbd05a7ed3481a79b772877a59a1c15,2,42,23,65,6,2010-08-13 19:05:50,2010-08-13 19:05:50
675978f41fbd05a7ed3481a79b772877a59a1c15...aa656253b9d4495264f14a76b6a80aa9a1d9a854,1,2,2,4,2,2010-08-14 01:23:39,2010-08-14 01:23:39
2b7302713674506fdbcdc396c38f18dcb90dee8c...1953b0bed9dbcc536bc82e2a03e404b649c00c5e,1,0,0,0,0,2014-02-13 17:51:11,2014-02-13 17:21:29
35a91085004e31f786df1e0011bc26ed0142ab4d...11a6431f8926c557f3c58408dacc98466e76cde1,11,290,167,457,28,2010-04-01 01:18:10,2010-04-01 00:56:16
11a6431f8926c557f3c58408dacc98466e76cde1...85f13d602e31424b2e2d18172872f14a24c31135,8,68,54,122,22,2010-04-01 21:10:28,2010-04-01 21:10:28
85f13d602e31424b2e2d18172872f14a24c31135...d717020911a350a5ea3c0a985c57d56c8fcad607,7,134,49,183,28,2010-04-02 18:10:36,2010-04-02 18:10:36
35a91085004e31f786df1e0011bc26ed0142ab4d...861bac1d2808b15abb867e761ded8144bf5f7e94,11,251,132,383,33,2010-04-01 00:56:16,2010-04-01 00:56:16
cf331050112ee973b9e8186dc4741028ca22f024...84b3a1774edb1e12ba0076e32fe8928ba54a48e3,1,1,1,2,2,2010-08-11 20:34:13,2010-08-11 20:33:21
a3846ab8372717c07f0346cb73eda8455a80c717...a9fcb0d0fc6456f80501b8820d02b04d7c15b6d6,1,2,1,3,1,2014-02-13 21:43:18,2014-02-13 18:27:42
a9fcb0d0fc6456f80501b8820d02b04d7c15b6d6...31c450bcee53d0a3827b7e0a611e9013b2496506,2,123,5,128,8,2014-02-14 19:42:55,2013-12-02 20:05:21
31c450bcee53d0a3827b7e0a611e9013b2496506...b7e4e92014a5fe7a2d8c896703498090d88793ce,2,25,0,25,2,2014-02-14 23:49:08,2014-02-14 05:25:10
b7e4e92014a5fe7a2d8c896703498090d88793ce...f288b8f010468237d238acf51ea3d8108138207a,2,59,20,79,19,2014-02-15 00:28:34,2014-02-13 19:59:25
f288b8f010468237d238acf51ea3d8108138207a...cf5e463abd2c23f62e9c2e6361e6c53048c8910e,2,35,14,49,6,2014-02-15 00:28:56,2014-02-14 05:53:49
cf5e463abd2c23f62e9c2e6361e6c53048c8910e...4f84f6b3e4210ae1eb14728a46d43dd961700a0c,9,344,280,624,98,2014-02-15 00:30:48,2014-02-14 09:02:46
4f84f6b3e4210ae1eb14728a46d43dd961700a0c...fab2d3c92fb4f813f0cf6f3e576d2d01ee8ade4b,2,22,22,44,22,2014-02-15 00:31:57,2014-02-14 23:53:57
fab2d3c92fb4f813f0cf6f3e576d2d01ee8ade4b...c086f831fbcb4e658993c2d7136d52eed04e486c,1,55,0,55,1,2014-02-15 00:41:02,2014-02-14 21:29:51
c086f831fbcb4e658993c2d7136d52eed04e486c...3018ff7130a42a87c1a2d84ee532edede6bf1d1d,1,1,1,2,1,2014-02-15 01:30:52,2014-02-15 01:30:52
3018ff7130a42a87c1a2d84ee532edede6bf1d1d...cceb455fb167571e26341ded6b595dafd4d92bc6,2,6,1,7,2,2014-02-15 18:48:52,2014-02-14 11:54:41
cceb455fb167571e26341ded6b595dafd4d92bc6...6483dea08c6fae937e62ce242212152d7ef27d91,4,39,0,39,39,2014-02-16 19:03:40,2014-02-06 13:33:42
6483dea08c6fae937e62ce242212152d7ef27d91...c7e815f63b6c22f5bbc798f34386c01fa72cab7d,32,181,223,404,105,2014-02-16 19:03:40,2014-02-06 13:33:42
c7e815f63b6c22f5bbc798f34386c01fa72cab7d...bd4ffaba53b3800200ba034c30ea91bc143c4392,15,43,30,73,15,2014-02-16 19:03:40,2014-02-06 13:33:42
bd4ffaba53b3800200ba034c30ea91bc143c4392...1ca22a3dc8a469dc81718e5f0ae28225a2b7f7b2,2,14,11,25,2,2014-02-16 19:03:40,2014-02-06 13:33:42
1ca22a3dc8a469dc81718e5f0ae28225a2b7f7b2...2e641ac49f121a6e2cc70bd3879930b44a8a7710,67,500,679,1179,386,2014-02-16 19:03:40,2014-02-06 13:33:42
2e641ac49f121a6e2cc70bd3879930b44a8a7710...f7d28cd377f06224247b950680517a187a7b6749,54,594,516,1110,500,2014-02-16 19:03:40,2014-02-06 14:02:18
f7d28cd377f06224247b950680517a187a7b6749...f7c8bcb329eb77b153cd91fcf35c5874a6f9a4b3,1,1,1,2,1,2014-02-16 19:03:40,2014-02-06 14:10:56
f7c8bcb329eb77b153cd91fcf35c5874a6f9a4b3...1192ae44f1d7f944719520f235e9f2ec895bdfd5,27,326,326,652,162,2014-02-16 19:03:40,2014-02-07 20:34:04
1192ae44f1d7f944719520f235e9f2ec895bdfd5...2f7c57233ad2d578952dbba5c63ae8d50c1b487a,12,36,38,74,20,2014-02-16 19:03:41,2014-02-07 20:40:35
2f7c57233ad2d578952dbba5c63ae8d50c1b487a...655da39c018ab2247d15bd05bb68e3203aa16d38,1,3,3,6,3,2014-02-16 19:03:41,2014-02-07 20:53:56
655da39c018ab2247d15bd05bb68e3203aa16d38...9f828a07dc63ed13bda991cc7cf21cae89b64948,1,2,1,3,1,2014-02-16 19:03:41,2014-02-07 20:58:56
9f828a07dc63ed13bda991cc7cf21cae89b64948...06f2ba899fac8ad004bf65dce39a3b05e2387c0f,21,41,41,82,41,2014-02-16 19:03:41,2014-02-12 22:47:42
06f2ba899fac8ad004bf65dce39a3b05e2387c0f...a564160511bf1bbed5a4fe5d2981fae1bb664eca,79,261,261,522,214,2014-02-16 19:03:41,2014-02-12 22:47:42
a564160511bf1bbed5a4fe5d2981fae1bb664eca...389d4879da4aa620ee95d789b19ff9be44eb730a,109,8410,6316,14726,85,2014-02-16 19:03:41,2014-02-12 22:47:42
389d4879da4aa620ee95d789b19ff9be44eb730a...9b6fc8a4cf64e5a968401e356a2c86eaa77da860,1,2,1,3,2,2014-02-16 19:03:42,2014-02-12 22:47:42
9b6fc8a4cf64e5a968401e356a2c86eaa77da860...0f77bd6d0a5c7c4529f5330ece032eea32eca278,1,3,0,3,1,2014-02-16 19:03:42,2014-02-12 22:47:42
0f77bd6d0a5c7c4529f5330ece032eea32eca278...cd508678cd9baffd2bc0c9e11ae724a7b2ff70bb,4,54,1,55,4,2014-02-16 19:03:42,2014-02-12 22:47:42
cd508678cd9baffd2bc0c9e11ae724a7b2ff70bb...9565cca15b6d30aefb78bcec411dea4f7b305019,16,46,48,94,38,2014-02-16 19:03:42,2014-02-12 23:07:08
9565cca15b6d30aefb78bcec411dea4f7b305019...b2dc0789437bfdb4dbbb1c4282d650f4cfe75c31,1,1,1,2,1,2014-02-16 19:03:42,2014-02-13 12:15:07
b2dc0789437bfdb4dbbb1c4282d650f4cfe75c31...69a687e04e5983e7ebbd8169afa0f4f16251b3a9,1,1,0,1,1,2014-02-16 19:03:42,2014-02-13 12:21:05
69a687e04e5983e7ebbd8169afa0f4f16251b3a9...6a5a8970a0e034dc10738c0e6a11492611db21a1,1,20,0,20,1,2014-02-16 19:03:42,2014-02-13 17:04:56
6a5a8970a0e034dc10738c0e6a11492611db21a1...4a938213dfc0ef1828ab795ba726c490b267db69,1,1,1,2,1,2014-02-16 19:03:42,2014-02-13 18:01:22
4a938213dfc0ef1828ab795ba726c490b267db69...0b35521d8ffe9ff851c49801900381ec043962f0,4,22,19,41,8,2014-02-16 19:03:42,2014-02-13 21:50:13
0b35521d8ffe9ff851c49801900381ec043962f0...24a87d90f2152758d2c96ef3dd2a27a577932705,1,1,0,1,1,2014-02-16 19:03:42,2014-02-13 22:26:22
24a87d90f2152758d2c96ef3dd2a27a577932705...8c121b94e7cfe9fd3e0f0acfb238a23156ea4093,1,1,1,2,1,2014-02-16 19:03:42,2014-02-13 22:26:57
8c121b94e7cfe9fd3e0f0acfb238a23156ea4093...457cf0a702d0af897e80c7bc6c196431c73fad8a,10,14,14,28,14,2014-02-16 19:03:43,2014-02-13 23:22:02
457cf0a702d0af897e80c7bc6c196431c73fad8a...102f9865553bb3a41c5a74a5392893c5b5400d66,1,14,8,22,8,2014-02-16 19:03:43,2014-02-14 11:44:41
102f9865553bb3a41c5a74a5392893c5b5400d66...8849d70af89bccb1a327ffee43867175d84b1c15,1,1,1,2,1,2014-02-16 19:03:43,2014-02-14 11:44:41
8849d70af89bccb1a327ffee43867175d84b1c15...9878fee2992a845dff1e3e083f487013ebde8064,2,19,16,35,17,2014-02-16 19:03:43,2014-02-14 11:44:41
9878fee2992a845dff1e3e083f487013ebde8064...64403ff36f587d9158afcf1f611215ffc603eb21,1,1,1,2,1,2014-02-16 19:03:43,2014-02-14 12:16:36
64403ff36f587d9158afcf1f611215ffc603eb21...5c6f9f8e8192030b0cb4d820f97de08f278c6075,1,1,1,2,1,2014-02-16 19:03:43,2014-02-14 12:17:03
5c6f9f8e8192030b0cb4d820f97de08f278c6075...6f0503514fd42e5ef950972946e0bf04044c0d13,2,5,3,8,3,2014-02-16 19:03:43,2014-02-14 13:38:39
6f0503514fd42e5ef950972946e0bf04044c0d13...7c7477ce4561c8664a2270c19fd85b7bf9b04f29,1,8,1,9,1,2014-02-16 19:03:43,2014-02-14 13:42:06
7c7477ce4561c8664a2270c19fd85b7bf9b04f29...daa83f2864cbcdce9fa650bba363334824ff5859,1,3,3,6,3,2014-02-16 19:03:43,2014-02-14 14:11:46
daa83f2864cbcdce9fa650bba363334824ff5859...d85505d0194e6aa2cfe24aea51afe12a09ba73d2,16,29,36,65,25,2014-02-16 19:03:43,2014-02-14 14:12:13
d85505d0194e6aa2cfe24aea51afe12a09ba73d2...f5575782c4e8085e6f71f69ec2e368d1b4bdc795,1,40,0,40,1,2014-02-16 19:03:44,2014-02-14 14:32:31
f5575782c4e8085e6f71f69ec2e368d1b4bdc795...cb1efd818be0b8622d1ffe4340241d85b9690b8e,1,1,1,2,1,2014-02-16 19:03:44,2014-02-14 15:46:54
cb1efd818be0b8622d1ffe4340241d85b9690b8e...2123772a653eeb969ef6f8c21d1daee878098fe1,3,20,19,39,7,2014-02-16 19:03:44,2014-02-14 15:52:17
2123772a653eeb969ef6f8c21d1daee878098fe1...ec3ba47c4cdd47ff248ff312d866e8d906406e00,1,1,1,2,1,2014-02-16 19:03:44,2014-02-14 15:55:51
ec3ba47c4cdd47ff248ff312d866e8d906406e00...3655d3ffbe36c5c8e82b566106cb623c1d63b3c6,1,1,1,2,1,2014-02-16 19:03:44,2014-02-14 20:59:18
3655d3ffbe36c5c8e82b566106cb623c1d63b3c6...4ee35287f0f405bff03d766539f8dfea28ae38c7,1,4,1,5,1,2014-02-16 19:03:44,2014-02-14 23:12:15
4ee35287f0f405bff03d766539f8dfea28ae38c7...6fcf544528da04ba2b081ae9f1cbb723600bcac6,1,27,19,46,13,2014-02-16 19:03:44,2014-02-15 16:05:45
6fcf544528da04ba2b081ae9f1cbb723600bcac6...a8f21d4c48681c6f1ad64f8fa4577353b4405e29,1,1,1,2,1,2014-02-16 19:03:44,2014-02-15 16:07:14
a8f21d4c48681c6f1ad64f8fa4577353b4405e29...af9e897ecd8559841a728075058b66ebcae25d1e,20,20,20,40,20,2014-02-16 19:03:44,2014-02-15 16:09:27
af9e897ecd8559841a728075058b66ebcae25d1e...c663b39826b942292b09bc48b11da146a65c3792,1,1,1,2,1,2014-02-16 19:03:44,2014-02-15 20:02:55
c663b39826b942292b09bc48b11da146a65c3792...c6f406f03b53cb6948afdd4720e54b134e463650,2,14,3,17,4,2014-02-16 19:03:44,2014-02-15 20:46:30
c6f406f03b53cb6948afdd4720e54b134e463650...ecdb9a5688df3dc9c7c436574d5ec135354d11de,8,13,13,26,12,2014-02-16 19:03:45,2014-02-15 20:46:50
ecdb9a5688df3dc9c7c436574d5ec135354d11de...84d9a574169e40013f605549074fbf8057466ad5,1,2,2,4,1,2014-02-16 19:03:45,2014-02-15 20:57:09
84d9a574169e40013f605549074fbf8057466ad5...0b28de1e550d4811cd7206d2883fde157e500e83,4,74,2,76,5,2014-02-16 19:03:45,2014-02-15 20:57:38
0b28de1e550d4811cd7206d2883fde157e500e83...896e34689dfe0d66c09627179940a7b3eaac41bc,1,14,15,29,3,2014-02-16 19:03:45,2014-02-15 21:58:31
896e34689dfe0d66c09627179940a7b3eaac41bc...f7fad29fd99cabdbb17fa02dc214de2354f93cdf,7,591,587,1178,38,2014-02-16 19:03:45,2014-02-16 01:19:10
f7fad29fd99cabdbb17fa02dc214de2354f93cdf...a48a99377cb9050f913d36cd4b112f4107f13a58,1,5,5,10,1,2014-02-16 19:03:45,2014-02-16 18:16:11
a48a99377cb9050f913d36cd4b112f4107f13a58...49f90e559ed412402ad7444bc2db2bc1c182ddf5,1,4,4,8,1,2014-02-16 19:03:45,2014-02-16 18:23:38
49f90e559ed412402ad7444bc2db2bc1c182ddf5...33e1bdc543bcb7875dcc004d487333393670ed2d,45,0,0,0,0,2014-02-16 22:02:41,2014-02-16 22:02:31
33e1bdc543bcb7875dcc004d487333393670ed2d...713c8e629da3f7323ee8ca9abe72ba825afe9fa4,5,245,72,317,34,2014-02-17 00:20:26,2014-02-16 23:54:52
713c8e629da3f7323ee8ca9abe72ba825afe9fa4...7c8a1bfbac8ef5aca7c9999745be6d014afabca2,2,183,165,348,14,2014-02-17 00:44:44,2014-02-17 00:33:54
7c8a1bfbac8ef5aca7c9999745be6d014afabca2...1de7411c8bff2bf2c3d8dab40c4d6a5ad247084b,1,0,1,1,1,2014-02-17 01:04:22,2014-02-17 01:04:22
1de7411c8bff2bf2c3d8dab40c4d6a5ad247084b...f8b50cd410bbd68daecf26e697dcd577e2f15cf6,10,4,6072,6076,9,2014-02-17 01:25:27,2014-02-17 01:25:27
f8b50cd410bbd68daecf26e697dcd577e2f15cf6...1fb47e08a0eed4d4ec4638367edb08dfbcce465b,1,5,5,10,2,2014-02-17 01:27:13,2014-02-17 01:27:13
1fb47e08a0eed4d4ec4638367edb08dfbcce465b...47ec6f5d7f098f7bf73baca0599e6344871168e9,1,36,1,37,3,2014-02-17 07:43:58,2014-02-17 07:43:58
47ec6f5d7f098f7bf73baca0599e6344871168e9...4c02d0bea5ff7ce295d2a2f7ed005eac2c82706c,2,42,24,66,13,2014-02-17 14:01:30,2014-02-17 14:01:30
4c02d0bea5ff7ce295d2a2f7ed005eac2c82706c...f8b11f358498c1c1056be3e98a732f297ab2d56f,2,2,0,2,2,2014-02-17 14:04:26,2014-02-17 12:25:50
f8b11f358498c1c1056be3e98a732f297ab2d56f...e23a6a320ed7dfc229a3adf849513e2cbd293c17,1,2,3,5,1,2014-02-17 14:05:51,2014-02-17 13:02:29
e23a6a320ed7dfc229a3adf849513e2cbd293c17...846ebb4073ed56ab7d56539bb778fb82db80c35d,1,1,1,2,1,2014-02-17 14:15:25,2014-02-15 22:29:01
846ebb4073ed56ab7d56539bb778fb82db80c35d...666137d6359c9474c9912fc81ebc4d8f478cc1b5,1,6,6,12,5,2014-02-17 21:36:22,2014-02-17 21:36:22
666137d6359c9474c9912fc81ebc4d8f478cc1b5...2407891ddf2d99b08106ceeaed7ae4f16ee0d760,1,4,2,6,3,2014-02-18 05:47:04,2014-02-15 21:22:15
2407891ddf2d99b08106ceeaed7ae4f16ee0d760...ad6767949c65e788c071759591b9eabac51b5cf7,1,18,3,21,2,2014-02-18 06:26:24,2014-02-18 06:26:09
ad6767949c65e788c071759591b9eabac51b5cf7...774b2adb89d0d4334ce707ddd456fe96e8546e97,1,1,1,2,1,2014-02-18 06:26:24,2014-02-18 06:26:09
774b2adb89d0d4334ce707ddd456fe96e8546e97...b6f3d4007a9acc3da182c2f8877ceaa7500f23ab,1,0,4,4,1,2014-02-18 06:36:34,2014-02-17 23:45:30
b6f3d4007a9acc3da182c2f8877ceaa7500f23ab...4f937bda18bd577febcb29e3969fe72b400d1a61,1,18,0,18,1,2014-02-18 06:36:34,2014-02-18 06:35:44
4f937bda18bd577febcb29e3969fe72b400d1a61...12e4d3ac4da3e7ea8d9be49764dbbc091a345bf7,1,12,4,16,8,2014-02-18 17:25:08,2014-02-18 17:25:08
12e4d3ac4da3e7ea8d9be49764dbbc091a345bf7...481508d0e7ae9e4984ea380b9a43e589551c7a5b,29,67,67,134,66,2014-02-18 18:44:48,2014-02-18 11:04:42
481508d0e7ae9e4984ea380b9a43e589551c7a5b...21dac2a3daae528471d5e767072b10e1491f2106,1,12,0,12,1,2014-02-18 23:08:30,2014-02-18 20:44:51
21dac2a3daae528471d5e767072b10e1491f2106...05fbed5710b702c111c1425a9e241c40d13b0a54,5,49,3,52,5,2014-02-18 23:43:59,2014-02-18 20:16:38
05fbed5710b702c111c1425a9e241c40d13b0a54...868a2c401fd75fd95c50dc25d531734d6443657e,1,1,1,2,1,2014-02-18 23:52:09,2014-02-18 23:52:09
868a2c401fd75fd95c50dc25d531734d6443657e...a3f70172ef23585399f24011f72948f894e31e6f,1,4,0,4,1,2014-02-19 00:15:50,2014-02-19 00:05:27
a3f70172ef23585399f24011f72948f894e31e6f...1523fc7e6d778b87d89458411013801fd00a5b9f,1,1,1,2,1,2014-02-19 03:39:41,2014-02-19 03:31:19
1523fc7e6d778b87d89458411013801fd00a5b9f...cafde93a407ea0a3c6d712b9373bb2c9bb800234,1,0,1,1,1,2014-02-19 03:50:46,2014-02-19 03:50:46
cafde93a407ea0a3c6d712b9373bb2c9bb800234...cbcfaa2c8db02f7b529e6de0a6f8957ad03efdb5,1,0,8,8,1,2014-02-19 03:52:10,2014-02-19 03:52:10
cbcfaa2c8db02f7b529e6de0a6f8957ad03efdb5...696928dbc6d2add97a9a283545a461bf86d23a28,1,5,5,10,4,2014-02-19 16:03:20,2014-02-19 14:57:46
696928dbc6d2add97a9a283545a461bf86d23a28...b488bbf4bfd6c73f2c0c22acda51322d0e69cc37,1,0,1,1,1,2014-02-19 16:07:56,2014-02-19 15:46:03
b488bbf4bfd6c73f2c0c22acda51322d0e69cc37...3fbc25718eae6b7fc67f822755f68f8f53b1ef8a,1,11,0,11,2,2014-02-19 16:21:20,2014-02-19 16:21:20
3fbc25718eae6b7fc67f822755f68f8f53b1ef8a...1b74e5ed0ad80b5198d75f2013b219787a1cad8e,1,0,1,1,1,2014-02-19 18:17:41,2014-02-12 01:05:05
1b74e5ed0ad80b5198d75f2013b219787a1cad8e...9ca685bfbdbb63794c8e203936cdd383ff8745a5,1,2,0,2,1,2014-02-19 18:32:38,2014-02-19 18:32:38
9ca685bfbdbb63794c8e203936cdd383ff8745a5...cc1f7539d414038212b83dca86cf04f71731f24b,7,0,7,7,7,2014-02-19 21:22:27,2014-02-19 21:22:27
cc1f7539d414038212b83dca86cf04f71731f24b...0b6ba9c94072bd677e57f477810016351ef72ddc,2,171,58,229,9,2014-02-19 22:22:54,2014-02-19 20:50:30
0b6ba9c94072bd677e57f477810016351ef72ddc...e6c35e1b6b22acbf45abb883bf254b7191a42a38,1,2,2,4,1,2014-02-20 11:01:51,2014-02-20 11:00:29
e6c35e1b6b22acbf45abb883bf254b7191a42a38...d7a73e41eddf3b8f06b87535c5ba6cc3196cbffd,4,39,1,40,9,2014-02-20 14:41:32,2014-02-20 10:57:40
d7a73e41eddf3b8f06b87535c5ba6cc3196cbffd...39bae62f53f4fab72f5f40d3e9f8e14ad5e998c9,1,4,1,5,2,2014-02-20 15:37:03,2014-02-20 15:37:03
39bae62f53f4fab72f5f40d3e9f8e14ad5e998c9...6082e2ad16d941a070fda16212d7a24e3dbb80ad,1,11,1,12,1,2014-02-20 15:43:05,2014-02-20 14:03:32
6082e2ad16d941a070fda16212d7a24e3dbb80ad...3193a3a5af731a4773feadc23d91c5ab63ef9fda,1,1,1,2,1,2014-02-20 19:52:25,2014-02-19 20:13:24
3193a3a5af731a4773feadc23d91c5ab63ef9fda...0478bb4a6034e3072684201b9384f7ddfe109073,1,3,0,3,1,2014-02-20 19:55:18,2014-02-19 00:48:15
0478bb4a6034e3072684201b9384f7ddfe109073...45304a9d683128261791461f4dc47a180444b5b0,1,8,3,11,1,2014-02-20 20:18:47,2014-02-14 03:55:35
45304a9d683128261791461f4dc47a180444b5b0...2a37690f709391d5bcd4186809046676100bd98f,1,3,3,6,1,2014-02-20 22:12:52,2014-02-20 22:06:52
2a37690f709391d5bcd4186809046676100bd98f...84ad0a037c3316d9dbe1f893628c77fcbd19ec1b,1,1,1,2,1,2014-02-20 22:16:48,2014-02-12 12:36:01
84ad0a037c3316d9dbe1f893628c77fcbd19ec1b...58b01fac1ec80b34f2deb2fe87321a9de19ea6d7,1,1,1,2,1,2014-02-21 06:19:26,2014-02-21 00:50:03
58b01fac1ec80b34f2deb2fe87321a9de19ea6d7...4d7e1cef370586c6644e226c55db1fcd234346ad,4,64,12,76,10,2014-02-21 09:59:12,2014-02-19 19:53:02
4d7e1cef370586c6644e226c55db1fcd234346ad...f827d64c2eaab634df933dc28fa7b4dc5b75145b,1,1,1,2,1,2014-02-21 13:00:26,2014-02-21 08:55:27
f827d64c2eaab634df933dc28fa7b4dc5b75145b...48b86a4eaee77c636b9b53d161a829ea2a35e5bb,1,20,20,40,16,2014-02-21 13:26:08,2014-02-21 09:31:27
48b86a4eaee77c636b9b53d161a829ea2a35e5bb...fa5ca115ac0f73413f59bf49f911bf5363ba263e,1,2,2,4,2,2014-02-21 13:32:16,2014-02-21 10:51:58
fa5ca115ac0f73413f59bf49f911bf5363ba263e...7cd79b6f8f153d77f910cf5bdf73037223687aa2,1,4,5,9,3,2014-02-21 13:48:01,2014-02-21 11:21:54
7cd79b6f8f153d77f910cf5bdf73037223687aa2...dacdcc6d96ff0abb10cb491d3f8e3549b6b6aecc,1,2,2,4,2,2014-02-21 13:49:13,2014-02-21 11:30:12
dacdcc6d96ff0abb10cb491d3f8e3549b6b6aecc...a5859aaf631745fcc8b9c36dd2f68380000f05fc,1,1,1,2,1,2014-02-21 13:49:59,2014-02-21 11:33:16
a5859aaf631745fcc8b9c36dd2f68380000f05fc...1a98b4fe0283c887462f7941c7e1c8b3a554b309,1,1,1,2,1,2014-02-21 13:52:00,2014-02-21 11:36:04
1a98b4fe0283c887462f7941c7e1c8b3a554b309...d7d3ef12a6d13db3f8283cfd3d7bf8ce3e0698a6,1,1,1,2,1,2014-02-21 13:52:16,2014-02-21 11:37:32
d7d3ef12a6d13db3f8283cfd3d7bf8ce3e0698a6...a9cc6efb3caf833eb85dfce0025ca75d68d23ce0,1,2,2,4,2,2014-02-21 13:52:30,2014-02-21 11:39:17
a9cc6efb3caf833eb85dfce0025ca75d68d23ce0...0c9abc32c088bf88ef3d390ac080b5eade40f07c,1,1,1,2,1,2014-02-21 13:57:18,2014-02-21 13:57:18
0c9abc32c088bf88ef3d390ac080b5eade40f07c...4a6a3ba7fb08ce99007893ef75365a3e8aff938a,29,181,181,362,150,2014-02-21 19:37:37,2014-02-21 19:37:37
4a6a3ba7fb08ce99007893ef75365a3e8aff938a...2f4513339337bb8aa6c9dfe1191d169b4fc57999,16,0,812,812,16,2014-02-21 19:52:12,2014-02-21 19:31:23
2f4513339337bb8aa6c9dfe1191d169b4fc57999...267b217376ed466e9f260ecfdfa15a8227c103ff,2,15,0,15,3,2014-02-21 22:42:03,2014-02-21 21:24:27
267b217376ed466e9f260ecfdfa15a8227c103ff...c8e03e34b27a8449d8e1bfe0e3801d6a67ae2c49,3,10,2,12,3,2014-02-21 22:51:10,2014-02-19 11:14:14
c8e03e34b27a8449d8e1bfe0e3801d6a67ae2c49...2bce71e9dc10c8588f9eb599a0cd2e831440fc48,2,36,2,38,4,2014-02-21 22:56:48,2014-01-21 01:59:21
2bce71e9dc10c8588f9eb599a0cd2e831440fc48...5fe1f39f027c6f2c6a530975dd5389d788d3c0eb,2,23,1,24,2,2014-02-21 22:58:48,2014-01-07 21:41:54
5fe1f39f027c6f2c6a530975dd5389d788d3c0eb...75515852ea9742d3d84a0f463c2a2c61ef2b7323,2,21,1,22,2,2014-02-21 22:59:01,2014-01-08 01:27:45
75515852ea9742d3d84a0f463c2a2c61ef2b7323...c2d447e378dd72d1b955f476bd5bf249625b4dab,1,27,1,28,4,2014-02-21 23:03:24,2014-01-23 03:30:20
c2d447e378dd72d1b955f476bd5bf249625b4dab...cad717b1171affc3d540cea372576c70b0cb2295,2,35,2,37,4,2014-02-21 23:31:13,2014-01-24 21:25:40
cad717b1171affc3d540cea372576c70b0cb2295...1293cc88cd3d2e72c55fa8b8d268fab246e79fed,1,0,5,5,2,2014-02-21 23:37:12,2014-02-21 23:07:33
1293cc88cd3d2e72c55fa8b8d268fab246e79fed...39c82f3fb7a8459304d5e07dc87bd0623ad1efd0,9,77,74,151,18,2014-02-22 00:57:04,2014-02-20 05:01:54
39c82f3fb7a8459304d5e07dc87bd0623ad1efd0...a4078fcae4a33295675d769a1cd067837029da2f,1,18,11,29,9,2014-02-22 06:29:46,2014-02-12 10:33:50
a4078fcae4a33295675d769a1cd067837029da2f...3b5480e9fc66fb13dc4723c0c836564a6d1aaaf3,3,59,24,83,4,2014-02-22 10:07:31,2014-02-21 21:35:12
3b5480e9fc66fb13dc4723c0c836564a6d1aaaf3...b72ea59019b7c61973f3d4443d7b9c4cb94633a9,5,11,57,68,14,2014-02-22 10:07:31,2014-02-21 21:36:22
b72ea59019b7c61973f3d4443d7b9c4cb94633a9...f4a121f6c2fab44d63e64824bbb31253b9f66bbf,1,1,1,2,1,2014-02-22 12:19:49,2014-02-22 12:03:00
f4a121f6c2fab44d63e64824bbb31253b9f66bbf...f296e2ee12bb60f9ff988d2be4fbe9ec7c5dc42f,2,20,20,40,15,2014-02-22 13:07:19,2014-02-22 13:07:19
f296e2ee12bb60f9ff988d2be4fbe9ec7c5dc42f...61b2515c0d7106e3413387e4b1f0d6cf335ba6c7,1,1,1,2,1,2014-02-22 20:29:14,2014-02-22 16:38:39
61b2515c0d7106e3413387e4b1f0d6cf335ba6c7...ffe5115355baa6ee2136b6fb5e4828e4e2fa58f8,3,3,3,6,3,2014-02-22 21:41:51,2014-02-13 09:40:29
ffe5115355baa6ee2136b6fb5e4828e4e2fa58f8...832be4123d1c68cee6c4ad766cd5d47d388d2bfb,1,1,1,2,1,2014-02-22 22:23:20,2014-01-25 05:37:09
832be4123d1c68cee6c4ad766cd5d47d388d2bfb...24fe1632b05e38986b48e472f9022c8039596b4d,1,2,2,4,2,2014-02-23 16:49:54,2014-02-22 17:21:37
24fe1632b05e38986b48e472f9022c8039596b4d...348a77145d5c82094885b95536476a1acb54c4f4,1,2,2,4,2,2014-02-23 20:26:51,2014-01-13 03:55:32
348a77145d5c82094885b95536476a1acb54c4f4...2cd87dbb93497e38ffad016c1f5766c2bb56e604,1,5,5,10,1,2014-02-24 18:48:01,2014-02-23 21:18:48
2cd87dbb93497e38ffad016c1f5766c2bb56e604...04d7317cdd95ba00783389f89f6e9a7e1fc418f8,5,103,1,104,7,2014-02-25 02:23:05,2014-02-24 23:14:29
04d7317cdd95ba00783389f89f6e9a7e1fc418f8...62761428eff3a53e69367449eb81869e59e75e39,5,63,2,65,7,2014-02-25 02:23:10,2014-02-25 00:21:20
62761428eff3a53e69367449eb81869e59e75e39...4c4537e65e6cf911c9659b562d89e3330ce3ffae,7,143,126,269,91,2014-02-25 02:23:18,2014-02-25 00:43:57
4c4537e65e6cf911c9659b562d89e3330ce3ffae...1b1413a9d48cc2c2593822eef0394fbff3671fd4,1,1,1,2,1,2014-02-25 04:18:44,2014-02-25 04:05:52
1b1413a9d48cc2c2593822eef0394fbff3671fd4...c99dd224a518ac8c976fe9b22587e4dd2eda78c9,1,5,1,6,2,2014-02-25 23:11:45,2014-02-25 23:11:45
c99dd224a518ac8c976fe9b22587e4dd2eda78c9...6b049c74ccc9ee19688bb9bbe504c300e61776dc,2,13,0,13,4,2014-02-25 23:38:37,2013-08-21 09:25:04
6b049c74ccc9ee19688bb9bbe504c300e61776dc...3d6dff44f33b192a7fa007bfda5e44574fadc6e1,2,2,35,37,4,2014-02-26 06:59:31,2014-02-26 06:59:31
3d6dff44f33b192a7fa007bfda5e44574fadc6e1...30c8207e0f2e10a6f02a0c2ba16825ad27092108,2,28,1,29,2,2014-02-26 11:47:22,2014-02-26 11:46:02
30c8207e0f2e10a6f02a0c2ba16825ad27092108...332e935048d161764046b43fe6599e1db2afc3b6,15,123,123,246,35,2014-02-26 11:47:22,2014-02-26 11:46:02
332e935048d161764046b43fe6599e1db2afc3b6...99720fb5ab7259af37f708bc4eeda7cbbe790a69,2,52,4,56,3,2014-02-26 19:23:47,2014-02-24 19:47:12
99720fb5ab7259af37f708bc4eeda7cbbe790a69...c9245cf759108add2a10ffca4d41b1c68c1e8c76,1,9,1,10,1,2014-02-26 19:23:56,2014-02-24 20:12:38
c9245cf759108add2a10ffca4d41b1c68c1e8c76...e9881991ca0a5019d3a4215477738ed247898ba0,10,269,13,282,17,2014-02-26 19:53:57,2014-02-21 08:43:50
e9881991ca0a5019d3a4215477738ed247898ba0...c914cd99b3aaf932e3c0e2a585eead7b76621f1b,2,31,10,41,2,2014-02-26 20:39:54,2014-02-14 11:11:58
c914cd99b3aaf932e3c0e2a585eead7b76621f1b...e71e7b6cae57f25c5837dda98551c8e0a5cb720d,2,60,6,66,7,2014-02-26 22:08:51,2014-02-26 18:49:18
e71e7b6cae57f25c5837dda98551c8e0a5cb720d...73daa79e911260fc177727238c3e780e8043244e,1,8,0,8,1,2014-02-26 22:12:07,2014-02-26 22:11:39
73daa79e911260fc177727238c3e780e8043244e...f4f1f43d5140385bbf070510975f72b65196e08a,2,22,2,24,2,2014-02-26 22:17:41,2014-02-26 21:07:36
f4f1f43d5140385bbf070510975f72b65196e08a...794e5e6098110d675d08058eacd35978b91887e9,1,20,10,30,10,2014-02-26 23:36:26,2014-02-26 00:16:17
794e5e6098110d675d08058eacd35978b91887e9...713f9758e212179c360ed8c4a460f6e66028c0a8,1,6,2,8,2,2014-02-26 23:50:43,2014-01-13 09:13:13
713f9758e212179c360ed8c4a460f6e66028c0a8...fd09586b08cf40cedd59fe4de944000a3ebf6a59,1,24,0,24,1,2014-02-27 00:33:59,2014-02-26 22:27:17
fd09586b08cf40cedd59fe4de944000a3ebf6a59...4aac37e7bebdfa597711501adba2588ff5f90604,1,1,1,2,1,2014-02-27 00:39:55,2014-02-25 10:45:05
4aac37e7bebdfa597711501adba2588ff5f90604...b3750e52017554d77024c3e38d17e1640fb7b78c,1,3,2,5,1,2014-02-27 00:49:56,2014-01-26 15:02:26
b3750e52017554d77024c3e38d17e1640fb7b78c...214c65d33409784e592cccf176711fada3dfdef2,1,1,1,2,1,2014-02-27 01:14:08,2014-02-27 00:55:36
214c65d33409784e592cccf176711fada3dfdef2...1300c74b321785f2bb1fe2a633f7c509b2cea977,1,5,5,10,5,2014-02-27 09:41:12,2014-02-27 09:26:37
1300c74b321785f2bb1fe2a633f7c509b2cea977...5020d2e8f75eb1f8ff18f190410516572cacde00,1,1,1,2,1,2014-02-27 09:41:40,2014-02-27 09:26:38
5020d2e8f75eb1f8ff18f190410516572cacde00...2586e3a2acf83f8992f810b34a720cad9972f8d8,1,1,1,2,1,2014-02-27 09:42:30,2014-02-27 09:26:38
2586e3a2acf83f8992f810b34a720cad9972f8d8...8ae296823bacb26ab983a16395a4160f1c254276,1,2,2,4,2,2014-02-27 09:43:26,2014-02-27 09:26:38
8ae296823bacb26ab983a16395a4160f1c254276...c34602007cc53211697ba7cda0b6a60a558c0bd9,1,1,1,2,1,2014-02-27 09:44:25,2014-02-27 09:26:38
c34602007cc53211697ba7cda0b6a60a558c0bd9...d59678a08041f9826c514c295aa2cb92774cae5e,1,1,1,2,1,2014-02-27 09:51:45,2014-02-27 09:26:38
d59678a08041f9826c514c295aa2cb92774cae5e...a20e76ea80cf6e395a39aa58c2d59ab223e530b3,1,1,1,2,1,2014-02-27 09:52:21,2014-02-27 09:26:38
a20e76ea80cf6e395a39aa58c2d59ab223e530b3...074ad03072623fbc97eeb9e2725fa82f6e8d6f15,1,1,1,2,1,2014-02-27 09:52:51,2014-02-27 09:26:38
074ad03072623fbc97eeb9e2725fa82f6e8d6f15...0df6e20e6ac222d3b2be4e2d738e7baed71a2826,1,1,1,2,1,2014-02-27 09:53:13,2014-02-27 09:26:38
0df6e20e6ac222d3b2be4e2d738e7baed71a2826...4f48898728a752bbb7d2a8fff7149af2a0a86a32,1,1,1,2,1,2014-02-27 09:53:35,2014-02-27 09:26:38
4f48898728a752bbb7d2a8fff7149af2a0a86a32...27873acbf0003031be52c719d068e46e4f7ef31f,1,4,4,8,4,2014-02-27 09:54:06,2014-02-27 09:26:38
27873acbf0003031be52c719d068e46e4f7ef31f...4e73c80b17bd237a8491782bcf9e19f1889e12ed,2,59,3,62,3,2014-02-27 18:44:57,2014-02-25 18:55:34
4e73c80b17bd237a8491782bcf9e19f1889e12ed...5d9d6a59d29da9921fb98dd721cccad4418e2d55,1,1,1,2,1,2014-02-27 22:29:47,2013-12-18 08:50:09
5d9d6a59d29da9921fb98dd721cccad4418e2d55...41e648a47f70c8e82cfbb11012c83255d051d528,1,113,41,154,15,2014-02-27 23:56:47,2014-02-19 01:20:15
41e648a47f70c8e82cfbb11012c83255d051d528...8794a173f9c175df2343245e71ee9a137f5bc66a,1,1,1,2,1,2014-02-28 00:13:52,2014-02-27 15:54:05
8794a173f9c175df2343245e71ee9a137f5bc66a...33443966c8e8cac85a863bb181d4a4aff00baab4,5,298,17,315,18,2014-02-28 06:01:34,2013-12-10 20:49:31
33443966c8e8cac85a863bb181d4a4aff00baab4...18c41af065006a804a3d38eecca7ae184103ece9,2,279,169,448,27,2014-02-28 06:34:57,2014-02-27 03:37:03
18c41af065006a804a3d38eecca7ae184103ece9...9aab5bfc03bfb9f39b5c18b878e14c9a60a2681a,1,1,1,2,1,2014-02-28 16:37:57,2014-01-15 00:26:12
9aab5bfc03bfb9f39b5c18b878e14c9a60a2681a...6b5baaddb0ec9369a55bf9c608fda9adcccc8e92,1,1,1,2,1,2014-02-28 18:10:01,2013-12-18 01:23:05
6b5baaddb0ec9369a55bf9c608fda9adcccc8e92...0c8a88ba092a251ba8d79092c590f45a6cd27de9,1,3,2,5,1,2014-02-28 19:09:30,2014-01-09 16:30:31
0c8a88ba092a251ba8d79092c590f45a6cd27de9...0d034a98ec4ef1e0c3c1727e23d1ccd971ae74e6,2,7,6,13,2,2014-02-28 19:59:12,2014-02-28 19:59:12
0d034a98ec4ef1e0c3c1727e23d1ccd971ae74e6...d3fbc25be21719e76907cacfcb0291788c79adc2,4,4,4,8,4,2014-03-01 00:47:21,2014-03-01 00:43:23
d3fbc25be21719e76907cacfcb0291788c79adc2...9e16aaf3a912b0ab189b9a3a097e68602ddd2740,1,1,1,2,1,2014-03-01 11:58:20,2014-01-13 09:37:09
9e16aaf3a912b0ab189b9a3a097e68602ddd2740...729fb13c9ef4181cce0a2d96529ec3a8479601be,1,77,3,80,4,2014-03-01 17:51:19,2014-03-01 17:51:19
729fb13c9ef4181cce0a2d96529ec3a8479601be...3a8bbb721dc72b016c4fc4e58b25ea15a4512955,1,1,1,2,1,2014-03-01 18:43:16,2014-03-01 18:43:16
3a8bbb721dc72b016c4fc4e58b25ea15a4512955...3248233f5eaa43d6c431abe6598a8a48a76bf1ff,1,6,7,13,1,2014-03-02 12:55:51,2013-11-11 16:30:32
3248233f5eaa43d6c431abe6598a8a48a76bf1ff...bf01ab2a139eaf08fa7e1242c42ccdefb303d851,1,1,1,2,1,2014-03-02 13:18:42,2013-12-13 14:34:03
bf01ab2a139eaf08fa7e1242c42ccdefb303d851...26169075c84d89c13b22d225f415841e85ed1036,1,6,6,12,3,2014-03-02 14:03:11,2013-12-17 04:44:24
26169075c84d89c13b22d225f415841e85ed1036...e89139dc9dd4a9c104d71167bea4987b766767df,5,5,6,11,6,2014-03-02 15:02:29,2014-02-27 21:54:26
e89139dc9dd4a9c104d71167bea4987b766767df...d7ecab775ceefcd55a23780d005ce1c39cd8651b,1,2,2,4,1,2014-03-02 15:02:29,2014-02-28 13:01:52
d7ecab775ceefcd55a23780d005ce1c39cd8651b...27b7fa3914d5375721d2e575297f0b0c35770c3f,2,3,2,5,3,2014-03-02 15:38:04,2014-03-02 15:37:09
27b7fa3914d5375721d2e575297f0b0c35770c3f...6b18a564dd327f598249760a8200dd1fa657d9e5,1,26,3,29,4,2014-03-02 15:56:13,2014-03-01 03:53:06
6b18a564dd327f598249760a8200dd1fa657d9e5...9bffccd935db50c005befdc800275cf6a4c37ec1,2,2,2,4,2,2014-03-02 16:07:44,2014-02-27 21:33:25
9bffccd935db50c005befdc800275cf6a4c37ec1...d5f208488376a4a2821dce0a24a4923aca8ff9d0,1,10,10,20,8,2014-03-02 21:37:29,2014-01-15 10:02:30
d5f208488376a4a2821dce0a24a4923aca8ff9d0...bf82c8a7089f36d740336079a2ec7f7498b902c9,1,1,1,2,1,2014-03-03 00:25:19,2014-03-02 23:46:43
bf82c8a7089f36d740336079a2ec7f7498b902c9...7c34e1f1a7a19faade45345ace22cf458bdd1142,1,29,26,55,14,2014-03-03 06:31:34,2014-03-03 06:29:11
7c34e1f1a7a19faade45345ace22cf458bdd1142...8d6eed21d219e459331a9f08fd46f8c67a9553da,1,21,26,47,6,2014-03-03 07:22:26,2014-03-03 07:22:26
8d6eed21d219e459331a9f08fd46f8c67a9553da...220e7bf2d448fd80d98d5c2f3cfac3902433df8f,8,299,486,785,9,2014-03-03 20:30:33,2014-03-03 20:30:33
220e7bf2d448fd80d98d5c2f3cfac3902433df8f...c7e42223a24d5f1d283bfb86378191a4b588e50e,1,7,7,14,6,2014-03-03 20:31:51,2014-03-03 20:31:51
c7e42223a24d5f1d283bfb86378191a4b588e50e...7a19a80af205840b259957f5b233a9acec143137,1,1,1,2,1,2014-03-03 20:32:51,2014-03-03 20:32:51
7a19a80af205840b259957f5b233a9acec143137...c29d21f4cdc969991771d1e75c3a799eca7bf41a,1,2,2,4,2,2014-03-03 20:33:56,2014-03-03 20:33:56
c29d21f4cdc969991771d1e75c3a799eca7bf41a...fde61423cf13cb57be02a6f79581cb96c34335f9,1,6,6,12,4,2014-03-03 20:35:00,2014-03-03 20:35:00
fde61423cf13cb57be02a6f79581cb96c34335f9...d224f03ef4aebe80628d5195cf64db5c71627a24,1,3,3,6,2,2014-03-03 20:35:49,2014-03-03 20:35:49
d224f03ef4aebe80628d5195cf64db5c71627a24...66c14ce84a149be7b288a854764d72f92865493a,1,2,2,4,2,2014-03-03 20:36:30,2014-03-03 20:36:30
66c14ce84a149be7b288a854764d72f92865493a...4cb5113546d19174cd4d37166e76f90180f24a64,1,39,41,80,19,2014-03-03 20:38:26,2014-03-03 20:38:26
4cb5113546d19174cd4d37166e76f90180f24a64...989f6f20565aa9be169871933e72e3edd9dd3521,1,7,8,15,3,2014-03-03 20:43:41,2014-03-03 20:43:41
989f6f20565aa9be169871933e72e3edd9dd3521...2206b9935922b5451f13d60830490a4b9bef8548,1,90,88,178,18,2014-03-03 20:50:41,2014-03-03 20:50:41
2206b9935922b5451f13d60830490a4b9bef8548...d07101dec08a698932ef0aa2fc36316d6f7c4851,1,71,64,135,23,2014-03-03 20:52:03,2014-03-03 20:51:56
d07101dec08a698932ef0aa2fc36316d6f7c4851...2036fb1e71b7da7f16f78e602d95a5cc1e3771b0,1,3,3,6,3,2014-03-05 20:08:43,2014-03-04 12:23:05
2036fb1e71b7da7f16f78e602d95a5cc1e3771b0...7c73bc916e45e795e63667443edfaf8b40fbfd53,1,36,27,63,16,2014-03-05 20:22:53,2013-12-09 21:39:28
7c73bc916e45e795e63667443edfaf8b40fbfd53...02075dcf130c192593dfb71bcd5801d47074e7da,1,1,1,2,1,2014-03-05 20:48:22,2014-03-04 12:03:19
02075dcf130c192593dfb71bcd5801d47074e7da...7d604975a7ec7f62f7699af45a95bad9af3b0b5f,1,1,1,2,1,2014-03-05 21:10:57,2014-03-05 20:51:43
7d604975a7ec7f62f7699af45a95bad9af3b0b5f...8e2e9adb466eb7910926ebaea71403c5490f9a2e,1,5,5,10,4,2014-03-05 21:29:24,2014-03-05 21:16:02
8e2e9adb466eb7910926ebaea71403c5490f9a2e...66fdc03642b3af6e200587fab20bbfda389816a7,1,2,2,4,2,2014-03-05 21:49:06,2014-01-26 16:21:07
66fdc03642b3af6e200587fab20bbfda389816a7...de2ecb8a969aa4c96da59e94c0aa9fa84ab232e0,1,1,1,2,1,2014-03-06 00:15:52,2014-03-05 17:06:32
de2ecb8a969aa4c96da59e94c0aa9fa84ab232e0...933537860247de35c21db060ae9ae1f87bb30d53,8,10,10,20,8,2014-03-06 00:30:51,2014-03-04 19:39:10
933537860247de35c21db060ae9ae1f87bb30d53...3cf2da0e384e23602a9fea597500d637867c1eb9,1,26,8,34,4,2014-03-06 05:49:28,2014-03-05 19:20:38
3cf2da0e384e23602a9fea597500d637867c1eb9...eaa1d00b24008f590b95ad099241b4003688cdda,3,4,17,21,5,2014-03-06 09:53:17,2014-03-06 00:45:04
eaa1d00b24008f590b95ad099241b4003688cdda...7682e5747a889d7818f5ce9ebb2bdb8bf3897c34,1,1,1,2,1,2014-03-06 10:15:24,2014-03-06 10:15:24
7682e5747a889d7818f5ce9ebb2bdb8bf3897c34...0609453e1f9ae074f8d786df903096a6eadb6aa0,2,56,4,60,3,2014-03-06 10:19:30,2014-02-28 11:39:10
0609453e1f9ae074f8d786df903096a6eadb6aa0...46bd6dc88de252886d75426efc2ce8107a5134e9,5,1287,6,1293,15,2014-03-06 20:21:15,2013-12-04 04:27:01
46bd6dc88de252886d75426efc2ce8107a5134e9...186a68f8ff7356871d23110b27c7c2d597d37d72,1,2,2,4,2,2014-03-06 23:38:59,2014-03-06 04:06:55
186a68f8ff7356871d23110b27c7c2d597d37d72...c5f2f583ab24f359041b3babf2655f98e40b6c5b,1,1,1,2,1,2014-03-07 07:40:32,2014-03-07 03:50:01
c5f2f583ab24f359041b3babf2655f98e40b6c5b...486f1b4e5117584824ed67ebea7572cf13f09d72,3,10,7,17,4,2014-03-07 10:41:48,2014-03-07 05:33:21
486f1b4e5117584824ed67ebea7572cf13f09d72...02cc2b2014f790a482f8f35c7d3045538cb08955,1,6,0,6,1,2014-03-07 10:41:48,2014-03-07 05:34:13
02cc2b2014f790a482f8f35c7d3045538cb08955...0e066693f21a333cbafe6c3f2877a52843605a1b,1,97,96,193,1,2014-03-07 11:19:17,2014-03-07 11:18:55
0e066693f21a333cbafe6c3f2877a52843605a1b...0b4a41af58fbc75122e18146a890a0a7c8dbd947,2,16,0,16,2,2014-03-07 11:19:17,2014-03-07 11:18:55
0b4a41af58fbc75122e18146a890a0a7c8dbd947...5af8d2963b429f5737b054048c9b639e2e56f79e,1,1,0,1,1,2014-03-07 11:19:17,2014-03-07 11:18:55
5af8d2963b429f5737b054048c9b639e2e56f79e...235731d32b6cf58a9b868379aab2700d7be55054,1,4,3,7,2,2014-03-07 11:19:17,2014-03-07 11:18:55
235731d32b6cf58a9b868379aab2700d7be55054...53ec5e13e5955830b6751019eef232bd2125c0b6,2,56,9,65,12,2014-03-07 18:06:12,2014-02-17 12:02:58
53ec5e13e5955830b6751019eef232bd2125c0b6...853999de10b8fd0116f9da80af2c192a4a5fd39b,4,19,2,21,4,2014-03-07 20:05:58,2014-03-07 19:57:39
853999de10b8fd0116f9da80af2c192a4a5fd39b...dc57fe97e1be245fa08f25143302ee9dd850c5c9,7,3,11,14,11,2014-03-07 20:05:59,2014-03-07 19:58:19
dc57fe97e1be245fa08f25143302ee9dd850c5c9...7a753563885c38d6592d891724b600bd3347f43a,1,1,1,2,1,2014-03-07 21:15:54,2014-03-07 21:06:55
7a753563885c38d6592d891724b600bd3347f43a...ad309b13324750ff17ae4fb6d5dcfa416d0766b9,1,4,4,8,4,2014-03-07 21:30:40,2014-03-07 21:26:26
ad309b13324750ff17ae4fb6d5dcfa416d0766b9...21243d62a26d3cc68d852e0b735ecb7afe9f13c1,1,1,1,2,1,2014-03-07 21:51:42,2014-03-07 21:51:42
21243d62a26d3cc68d852e0b735ecb7afe9f13c1...9c353b4f17ce4892cac482ae46f76d3bef648e2c,1,1,1,2,1,2014-03-07 22:55:10,2014-03-07 22:13:03
9c353b4f17ce4892cac482ae46f76d3bef648e2c...b12c6b485da4cd84e58ed74c3c7cd8d62e2133e2,1,1,1,2,1,2014-03-07 23:06:53,2014-03-07 23:06:35
b12c6b485da4cd84e58ed74c3c7cd8d62e2133e2...4bab3d8227653eaf18c8556dd25287f57f19a861,1,1,1,2,1,2014-03-07 23:12:40,2014-03-07 22:56:07
4bab3d8227653eaf18c8556dd25287f57f19a861...ca4ddfadbae0a8a432b87254b5bd6c25b616ba42,1,30,0,30,1,2014-03-07 23:27:39,2014-03-07 23:27:39
ca4ddfadbae0a8a432b87254b5bd6c25b616ba42...f08bf6f1f77079dbd3bc28fcae207086f887434f,1,1,1,2,1,2014-03-08 00:23:14,2014-03-08 00:23:14
f08bf6f1f77079dbd3bc28fcae207086f887434f...11aceac273dca110172fa0624c8498d1142e0ce8,1,1,1,2,1,2014-03-08 01:03:12,2014-03-08 01:03:12
11aceac273dca110172fa0624c8498d1142e0ce8...4f90c9b5316b7b7a6eaa269f70e7321810c49d52,1,5,7,12,2,2014-03-08 06:34:47,2014-03-08 06:34:39
4f90c9b5316b7b7a6eaa269f70e7321810c49d52...44d160e3cebdf424c63a2e89e727b6ef70cc02ae,1,2,2,4,2,2014-03-08 07:06:20,2014-03-08 07:06:20
44d160e3cebdf424c63a2e89e727b6ef70cc02ae...1b9395ea8fd638d8999019229c3e39bf2fa8e4dd,1,1,1,2,1,2014-03-08 17:32:32,2014-03-08 01:51:03
1b9395ea8fd638d8999019229c3e39bf2fa8e4dd...b700282ffdc33813d4533293338dcdab5fadffd8,1,1,1,2,1,2014-03-09 17:25:29,2014-03-09 16:39:01
b700282ffdc33813d4533293338dcdab5fadffd8...47ab8df455df1f1391b760e1fbcc5c21645512b8,2,13,9,22,4,2014-03-10 08:39:15,2014-03-10 08:39:15
47ab8df455df1f1391b760e1fbcc5c21645512b8...7833ce0a6e9af904979f24828a4ad5990813d089,1,18,20,38,1,2014-03-10 09:14:50,2014-03-03 21:25:53
7833ce0a6e9af904979f24828a4ad5990813d089...0d8de2d3ea44a8bb1f0702ccf7a4542200452f16,1,1,1,2,1,2014-03-10 09:19:57,2014-03-05 17:23:22
0d8de2d3ea44a8bb1f0702ccf7a4542200452f16...0f13f24ad2ce03bef65c357fc8351d80344c645b,1,9,6,15,3,2014-03-10 19:09:25,2014-03-10 19:07:29
0f13f24ad2ce03bef65c357fc8351d80344c645b...55848a913952b7753bf5aab43bfd6c91c0a80d50,1,5,3,8,1,2014-03-10 22:34:16,2014-03-10 20:55:57
55848a913952b7753bf5aab43bfd6c91c0a80d50...d6419d0aff4194675ed816f74eb688070ba45285,1,2,2,4,2,2014-03-10 22:37:44,2014-03-10 20:56:48
d6419d0aff4194675ed816f74eb688070ba45285...11c5bb7f3de13722a84c5503129097393056061e,4,164,7,171,6,2014-03-11 06:35:19,2014-03-11 06:34:09
11c5bb7f3de13722a84c5503129097393056061e...d1214af13245b8570a335a6cbc1d81ae3c366eb0,2,7,175,182,8,2014-03-11 06:35:19,2014-03-11 06:34:09
d1214af13245b8570a335a6cbc1d81ae3c366eb0...78165c224d75418bd7721badb8082827e00c4539,1,4,4,8,1,2014-03-11 10:19:42,2014-03-11 09:27:00
78165c224d75418bd7721badb8082827e00c4539...247ec19c82bf6cd27099e013db8ea577083111ee,1,1,1,2,1,2014-03-11 19:10:34,2014-03-11 19:10:34
247ec19c82bf6cd27099e013db8ea577083111ee...d7717d93e4e3686acd488784a37141b070db9929,1,4,4,8,4,2014-03-11 20:24:34,2014-03-11 20:20:37
d7717d93e4e3686acd488784a37141b070db9929...f684cb09a56d44c0814eda7e1613ecf4d2c5da15,1,4325,0,4325,1,2014-03-12 05:44:37,2014-03-11 23:31:50
f684cb09a56d44c0814eda7e1613ecf4d2c5da15...edad4e63dff0ca0b19a264fc17e8b6a5315dfb04,1,6,0,6,1,2014-03-12 19:22:32,2014-03-12 19:22:32
edad4e63dff0ca0b19a264fc17e8b6a5315dfb04...fe0e434a87be433bce69b46031b3ef2c379ce353,2,19,6,25,5,2014-03-12 22:19:48,2014-03-12 22:19:48
fe0e434a87be433bce69b46031b3ef2c379ce353...4f823f902d02125191f452067e9b3ea3c14fac08,1,140,137,277,139,2014-03-13 18:33:10,2014-03-13 14:15:52
4f823f902d02125191f452067e9b3ea3c14fac08...5412372e93558c73eb44123ffd5c3b51aaa51f41,1,15,29,44,14,2014-03-13 18:33:10,2014-03-13 14:17:28
5412372e93558c73eb44123ffd5c3b51aaa51f41...e8c6b9bf25835685f666cbfb3022e66cf7e2308e,1,3,0,3,1,2014-03-13 23:03:20,2014-03-13 23:02:02
e8c6b9bf25835685f666cbfb3022e66cf7e2308e...cea44b3e861e070a857f7a962ed600ace3678798,1,4,2,6,2,2014-03-13 23:31:11,2014-03-04 16:22:02
cea44b3e861e070a857f7a962ed600ace3678798...91ef3a31a0080de2b5a3db8f2a20dba00dcd2ae1,1,11,1,12,2,2014-03-13 23:33:38,2014-01-28 03:59:10
91ef3a31a0080de2b5a3db8f2a20dba00dcd2ae1...24a67f951558262b68c1811a0d654592d25a0093,1,1,1,2,1,2014-03-13 23:37:33,2014-03-13 15:42:48
24a67f951558262b68c1811a0d654592d25a0093...a9a38d84b93f5c3c595d9e2b16eab1b400023919,1,1,1,2,1,2014-03-13 23:39:23,2014-03-13 12:47:13
a9a38d84b93f5c3c595d9e2b16eab1b400023919...79592ce9e2204e09559d9b67fd460fcaec1b2fea,1,2,2,4,1,2014-03-13 23:52:59,2014-03-13 23:41:19
79592ce9e2204e09559d9b67fd460fcaec1b2fea...3cc02e7f03787a9f41e493f3ca539190946933b0,1,3,3,6,3,2014-03-14 11:09:36,2014-03-14 11:03:23
3cc02e7f03787a9f41e493f3ca539190946933b0...129e2e021ab1d773874428cd1fb329eae72797c4,2,45,2,47,3,2014-03-14 16:40:40,2014-03-04 15:29:11
129e2e021ab1d773874428cd1fb329eae72797c4...7b5e019981f352add88be2984de68e553d1bfa93,2,48,8,56,4,2014-03-14 16:42:07,2014-03-14 16:01:45
7b5e019981f352add88be2984de68e553d1bfa93...53e4da8eab7c3e61d489452d3aeb81bb13f4a958,1,1,1,2,1,2014-03-14 18:24:24,2014-03-14 18:24:24
53e4da8eab7c3e61d489452d3aeb81bb13f4a958...d7be9588a096aa1806620f584f9d00b74d6ac52c,1,1,1,2,1,2014-03-14 18:26:30,2014-03-14 18:26:30
d7be9588a096aa1806620f584f9d00b74d6ac52c...bfb6af7053f3f3949e97eb074c11d907d1534a89,1,5,2,7,2,2014-03-14 18:43:15,2014-03-14 18:43:15
bfb6af7053f3f3949e97eb074c11d907d1534a89...56e73ea355c851fdfd574d6d2a9e2fcb75677945,2,29,9,38,8,2014-03-14 20:44:56,2014-03-01 11:49:47
56e73ea355c851fdfd574d6d2a9e2fcb75677945...44b940e88ddc6483baf1907496510d1d7fba8530,1,25,0,25,1,2014-03-14 21:02:35,2014-03-14 21:02:35
44b940e88ddc6483baf1907496510d1d7fba8530...6d6ebf7c61d8ae18175f5b08395ed25e731f03d7,1,1,1,2,1,2014-03-14 21:24:21,2014-03-14 21:24:21
6d6ebf7c61d8ae18175f5b08395ed25e731f03d7...d5294ebfa0e762d4a891a17869b7a14f99113d5a,1,2,2,4,1,2014-03-14 21:24:43,2014-03-14 21:24:43
d5294ebfa0e762d4a891a17869b7a14f99113d5a...e888dde3c569ca117380ed63c0d3d7c7ffd7071c,1,2,2,4,1,2014-03-14 21:48:56,2014-03-14 21:48:56
e888dde3c569ca117380ed63c0d3d7c7ffd7071c...2b741dc8b8568bab1a687ac14eefbae126654e97,1,6,5,11,3,2014-03-14 22:59:23,2014-03-14 22:59:23
2b741dc8b8568bab1a687ac14eefbae126654e97...9bfbb16e235767aeb8f50855b38626159fa35278,1,1,1,2,1,2014-03-14 23:26:40,2014-03-14 23:26:40
9bfbb16e235767aeb8f50855b38626159fa35278...a15d9cb4b646de1b531c62a3eb0543c55c95e53e,1,1,1,2,1,2014-03-15 00:40:25,2014-03-15 00:40:25
a15d9cb4b646de1b531c62a3eb0543c55c95e53e...e5dd832b20d92970837c9f9e75c19a3ce818d065,1,504,2012,2516,763,2014-03-15 06:01:53,2014-03-14 20:26:12
e5dd832b20d92970837c9f9e75c19a3ce818d065...dd3587a8c1977a1453063f42bb0dc511e67487a4,3,50,1,51,3,2014-03-15 06:01:54,2014-03-13 18:30:17
dd3587a8c1977a1453063f42bb0dc511e67487a4...511422adb08beb6bc33e048a31cb5aaa01408b84,2,5,8,13,6,2014-03-15 06:06:04,2014-03-15 06:06:04
511422adb08beb6bc33e048a31cb5aaa01408b84...b8cc71d476f76ff51e719fb76fb2348027c858ce,4,18,1,19,5,2014-03-15 18:41:07,2013-11-18 23:30:36
b8cc71d476f76ff51e719fb76fb2348027c858ce...91e6d1d22f0c56bf201e6eb4792b59cfc1f2ae79,4,10,10,20,10,2014-03-15 19:30:25,2014-03-14 09:57:21
91e6d1d22f0c56bf201e6eb4792b59cfc1f2ae79...df5624147f8cc6c4f4d277254ff4f5539e0dc827,1,1,1,2,1,2014-03-16 17:35:21,2014-03-16 13:19:51
df5624147f8cc6c4f4d277254ff4f5539e0dc827...f55278fa8a8d229a8c1bd680feeb5ab194e381c5,1,6,6,12,1,2014-03-17 04:21:28,2014-03-17 04:03:20
f55278fa8a8d229a8c1bd680feeb5ab194e381c5...849e4472e178474b5b2be3d3a12d059a7c9b66dc,1,3,1,4,1,2014-03-17 10:01:44,2014-03-17 10:00:36
849e4472e178474b5b2be3d3a12d059a7c9b66dc...d09056d2872c81b86f49cc8a8a666e776eeb2254,2,29,0,29,2,2014-03-17 12:43:10,2014-03-17 12:43:10
d09056d2872c81b86f49cc8a8a666e776eeb2254...d0781eb1a3ee68d08a3f80d0102e99e6d7fde5f6,1,1,1,2,1,2014-03-17 16:20:22,2014-03-17 16:14:55
d0781eb1a3ee68d08a3f80d0102e99e6d7fde5f6...e1484cdf65d8548508174fa71d3a4fa86b536e9e,1,1,1,2,1,2014-03-17 16:44:16,2014-03-17 10:37:57
e1484cdf65d8548508174fa71d3a4fa86b536e9e...2daaf3ea19149f471850d8c3aa3d0989f0a0d23b,1,3,3,6,1,2014-03-17 17:35:21,2014-03-17 17:35:21
2daaf3ea19149f471850d8c3aa3d0989f0a0d23b...55a0bc453c3cf5196c2b1f55e293b0eb19781b44,1,26,23,49,10,2014-03-17 19:50:14,2014-03-09 01:23:31
55a0bc453c3cf5196c2b1f55e293b0eb19781b44...cd49876e34a9281f141526437c68f733b465d0cf,1,2,3,5,1,2014-03-17 20:07:15,2014-03-14 01:50:42
cd49876e34a9281f141526437c68f733b465d0cf...d3aa14bc11ef26587f88d3e3abf52fae3bad964a,1,1,1,2,1,2014-03-17 20:20:06,2014-03-08 19:15:37
d3aa14bc11ef26587f88d3e3abf52fae3bad964a...8a96f317e594a5096d4fa56ceae4c685eec8ac8b,2,19,2,21,3,2014-03-17 20:52:48,2014-03-10 23:32:09
8a96f317e594a5096d4fa56ceae4c685eec8ac8b...c995b09b77696ebb4b7806f681ad616705fb4a49,1,0,2,2,1,2014-03-17 21:05:57,2014-03-17 20:44:53
c995b09b77696ebb4b7806f681ad616705fb4a49...bdcc657c7e9addcbf8888914f546b57250bf6f1e,1,19,9,28,7,2014-03-17 21:09:45,2014-03-14 14:35:58
bdcc657c7e9addcbf8888914f546b57250bf6f1e...7fb88698dcc1fd16767f098c633a0ef0cc9e5316,1,7,5,12,3,2014-03-17 21:11:58,2014-01-26 15:14:09
7fb88698dcc1fd16767f098c633a0ef0cc9e5316...9202767f415c86b837b6e4c97f8e99316ebcfc7d,1,1,1,2,1,2014-03-17 21:19:40,2014-03-08 21:04:58
9202767f415c86b837b6e4c97f8e99316ebcfc7d...e118a8be341a1e7d354ac36ddc04842f11a63e00,1,4,0,4,1,2014-03-17 21:38:51,2014-03-15 17:55:02
e118a8be341a1e7d354ac36ddc04842f11a63e00...68e84acec9ebd29daafb35ae7e9435e2ba285530,1,32,31,63,2,2014-03-17 21:55:00,2014-03-08 18:04:06
68e84acec9ebd29daafb35ae7e9435e2ba285530...e381c4dd09c3c9a2c864303f6258ca5366ac988c,6,18,18,36,17,2014-03-17 21:57:29,2014-03-07 17:01:06
e381c4dd09c3c9a2c864303f6258ca5366ac988c...63ec18f5c9931c71addde56acbfd448c71db6cc0,1,37,0,37,2,2014-03-17 22:06:53,2014-03-01 02:04:44
63ec18f5c9931c71addde56acbfd448c71db6cc0...ee07b502a2e751d1796c2567f1a6731a45a1eeca,1,6,4,10,1,2014-03-17 22:08:53,2014-03-07 00:57:29
ee07b502a2e751d1796c2567f1a6731a45a1eeca...ed22869e08c85fb7ab792f7869c503876f8e652e,1,3,2,5,1,2014-03-17 22:15:51,2014-03-10 06:50:21
ed22869e08c85fb7ab792f7869c503876f8e652e...df6d34c52b1070d41cd0930d688a450c991c3fab,1,4,0,4,1,2014-03-17 23:05:40,2014-03-07 18:08:20
df6d34c52b1070d41cd0930d688a450c991c3fab...c9fbb472b7b798853a8ea48dae6f85dfbc51b8c4,1,3,0,3,1,2014-03-17 23:13:34,2014-03-17 23:02:15
c9fbb472b7b798853a8ea48dae6f85dfbc51b8c4...a4b70cfd7165a0bdad4834b773057ed051de757b,1,3,2,5,1,2014-03-17 23:29:10,2014-03-16 23:53:00
a4b70cfd7165a0bdad4834b773057ed051de757b...547871e779f7a1e340c03296405735415764a0e8,1,2,2,4,2,2014-03-17 23:38:10,2014-02-15 02:55:22
547871e779f7a1e340c03296405735415764a0e8...2ca6d650e8a13cee28f11c38622cab231787325f,1,5,9,14,3,2014-03-18 00:12:00,2014-01-31 03:21:57
2ca6d650e8a13cee28f11c38622cab231787325f...f8f97f8b61fb3f4e831e8aae12509bd173f86b59,1,2,2,4,2,2014-03-18 01:47:25,2014-03-18 01:47:25
f8f97f8b61fb3f4e831e8aae12509bd173f86b59...959297c38aa4d263479735efeff56572038f2ffe,2,2,2,4,2,2014-03-18 07:07:45,2014-03-18 07:07:02
959297c38aa4d263479735efeff56572038f2ffe...f7b36844e604008d7ba32ce956ea6bca59b06dcf,1,8,8,16,8,2014-03-18 07:07:45,2014-03-18 07:07:36
f7b36844e604008d7ba32ce956ea6bca59b06dcf...4cc00e7aed83b3060154aa1c10e55a33a106b6f0,1,2,0,2,1,2014-03-18 07:11:59,2014-03-18 07:11:59
4cc00e7aed83b3060154aa1c10e55a33a106b6f0...ed4cd6c3c6a30ddfead1cbcf48f2ac6adf60a802,1,2,2,4,2,2014-03-18 10:43:17,2014-03-18 10:43:17
ed4cd6c3c6a30ddfead1cbcf48f2ac6adf60a802...748a6c8d9d8d61c3ee18eec462abe8ff245d6a98,2,41,0,41,2,2014-03-18 12:02:19,2014-01-17 18:17:22
748a6c8d9d8d61c3ee18eec462abe8ff245d6a98...c5e41a0325d0476f8e0f02fce3b0712050e2571b,1,10,4,14,4,2014-03-18 19:00:50,2014-03-17 22:50:24
c5e41a0325d0476f8e0f02fce3b0712050e2571b...78057a945ef84cbb05f9417fe884cb8c28e67b44,2,119,46,165,43,2014-03-18 19:00:50,2014-03-17 22:48:09
78057a945ef84cbb05f9417fe884cb8c28e67b44...299b220f5e05e1d4e26bfd58d0b2fd7329ca76b1,2,19,5,24,5,2014-03-18 20:44:16,2014-01-03 04:02:12
299b220f5e05e1d4e26bfd58d0b2fd7329ca76b1...d6cfcacee101f2738e0a224a3377232ff85f78a4,2,58,23,81,25,2014-03-18 22:19:26,2013-10-22 13:41:51
d6cfcacee101f2738e0a224a3377232ff85f78a4...2b84f43a6d6f05b0ed328e8bd39c83db5989ea40,1,23,23,46,23,2014-03-18 22:54:17,2014-03-18 22:54:17
2b84f43a6d6f05b0ed328e8bd39c83db5989ea40...4cf2adfeda3d2726a426be7089f71c0533a20515,1,0,1,1,1,2014-03-18 23:10:38,2014-03-18 21:19:31
4cf2adfeda3d2726a426be7089f71c0533a20515...f7ce415c676dc0d458c9f0508dde01f92cf6f00a,1,1,1,2,1,2014-03-19 00:24:34,2014-03-18 21:22:20
f7ce415c676dc0d458c9f0508dde01f92cf6f00a...c839f78b8f2d8d910bc2bfc9e41b3e3b67090ec1,2,29,6,35,3,2014-03-19 01:37:04,2014-03-04 17:54:08
c839f78b8f2d8d910bc2bfc9e41b3e3b67090ec1...6680b7b97c0326a80bdccaf0a35031e4af641e0e,2,35,95,130,12,2014-03-19 01:49:35,2014-03-18 15:11:39
6680b7b97c0326a80bdccaf0a35031e4af641e0e...bc42950b514b60f319812eeb87aae2915e394237,2,98,24,122,12,2014-03-19 02:30:23,2014-02-18 00:10:36
bc42950b514b60f319812eeb87aae2915e394237...3652831084c3788f786046b907a7361d2e89c520,2,18,10,28,4,2014-03-19 02:50:17,2014-03-18 17:13:08
3652831084c3788f786046b907a7361d2e89c520...37bc5ef4d87f19da47d3ab454c43d1e532c4f924,2,18,0,18,2,2014-03-19 02:54:46,2014-02-06 04:50:58
37bc5ef4d87f19da47d3ab454c43d1e532c4f924...f40f54c6da4a5399fe18a89d068634bb491e9f1a,2,28,1,29,3,2014-03-19 03:18:42,2014-01-26 21:17:36
f40f54c6da4a5399fe18a89d068634bb491e9f1a...0c65f1ae3e86cd3eed078df4e691402d591cc757,1,9,6,15,3,2014-03-19 04:30:29,2014-03-18 04:36:00
0c65f1ae3e86cd3eed078df4e691402d591cc757...fb6062fb9d83545730b993e94ac7482ffd43a62c,2,7,1,8,2,2014-03-19 18:34:15,2014-02-09 16:58:11
fb6062fb9d83545730b993e94ac7482ffd43a62c...58f5da86645990ef984353418cd1ed83213b111e,1,1,1,2,1,2014-03-19 19:39:32,2014-02-18 09:52:13
58f5da86645990ef984353418cd1ed83213b111e...4d4da556eb2a401ad92323e04c803ff2e77924b0,1,16,0,16,1,2014-03-20 03:42:21,2014-03-20 01:06:50
4d4da556eb2a401ad92323e04c803ff2e77924b0...2f61b2f04539df5a6879a7f0c2db3fe80b91c0d8,1,1,1,2,1,2014-03-20 16:27:01,2014-03-20 11:57:41
2f61b2f04539df5a6879a7f0c2db3fe80b91c0d8...0c930a1a86b3e8c14a1ed87c91f074b434895f93,1,4,2,6,3,2014-03-20 20:55:12,2014-03-14 00:42:43
0c930a1a86b3e8c14a1ed87c91f074b434895f93...b26fc23b068b5de603b535e0ef63cb5deacf0789,1,4,5,9,3,2014-03-20 21:28:01,2014-03-20 21:28:01
b26fc23b068b5de603b535e0ef63cb5deacf0789...6011145cfe83ffec4c0e1616cc9892b3b35a9bb4,1,3,1,4,1,2014-03-20 21:53:03,2014-03-20 03:48:47
6011145cfe83ffec4c0e1616cc9892b3b35a9bb4...3f2d7565322a0c8bf72a1ed9da90885a8707161c,1,104,15,119,7,2014-03-21 18:16:35,2014-03-21 18:16:35
3f2d7565322a0c8bf72a1ed9da90885a8707161c...408d9583b865124aa885b04f81745c650dfc115e,1,1,1,2,1,2014-03-21 21:22:33,2014-03-21 21:22:33
408d9583b865124aa885b04f81745c650dfc115e...c7a49b34c653adbb51fd7f1f54b748b5215f7656,1,1,1,2,1,2014-03-22 20:04:45,2014-03-22 19:52:51
c7a49b34c653adbb51fd7f1f54b748b5215f7656...635cdaaa9a6586b6c48665821dad26c201c5ec05,1,1,1,2,1,2014-03-22 20:12:26,2014-03-22 16:24:07
635cdaaa9a6586b6c48665821dad26c201c5ec05...34a10c6ace32526505cdc8a59a1e9096bf87c0a1,1,1,1,2,1,2014-03-22 22:35:22,2014-03-22 22:34:47
34a10c6ace32526505cdc8a59a1e9096bf87c0a1...8339c2ebffd513a22578ee549b0ecf08c2ff6eb8,1,1,1,2,1,2014-03-23 20:39:40,2014-03-20 19:17:02
8339c2ebffd513a22578ee549b0ecf08c2ff6eb8...b472d0275f2900beba3b1f2fcee821369f8c15c1,1,0,1,1,1,2014-03-24 14:54:09,2014-03-23 02:39:47
b472d0275f2900beba3b1f2fcee821369f8c15c1...4a6d4de53ed1472c0cb2323292127495619d7ed9,1,1,0,1,1,2014-03-24 22:13:36,2014-03-24 19:44:08
4a6d4de53ed1472c0cb2323292127495619d7ed9...76dbb6e395040742e7ca7be4b6d6d397bf5a7006,1,1,1,2,1,2014-03-24 22:52:51,2014-02-13 09:38:10
76dbb6e395040742e7ca7be4b6d6d397bf5a7006...3f609f99527d1a9ddfc371a9eb872ded1664f614,1,1,1,2,1,2014-03-24 23:05:23,2013-12-20 00:25:48
3f609f99527d1a9ddfc371a9eb872ded1664f614...ccba305ee542c210992da5fa2d27ce12650f9e9b,1,2,2,4,2,2014-03-25 06:55:03,2014-03-25 03:10:36
ccba305ee542c210992da5fa2d27ce12650f9e9b...3982d9bcb1dc95ceddcd456d56eac2fc8decbdaf,1,1,0,1,1,2014-03-25 18:03:03,2014-01-14 14:03:32
3982d9bcb1dc95ceddcd456d56eac2fc8decbdaf...a2acd794b369b9b7775b79dab15f9b1c17395299,1,14,9,23,4,2014-03-25 18:45:52,2014-03-25 18:45:52
a2acd794b369b9b7775b79dab15f9b1c17395299...6e34da67cdf7ffe5122593d1fd9e9811460ee9c4,1,73,59,132,28,2014-03-25 19:24:05,2014-03-25 19:24:05
6e34da67cdf7ffe5122593d1fd9e9811460ee9c4...eeda289f0e4a2c378682cd676e7d4dc70c12c973,1,4,4,8,4,2014-03-25 19:28:21,2014-03-25 19:28:13
eeda289f0e4a2c378682cd676e7d4dc70c12c973...0b02e53ca5d7b07dd2ddf1a84381ed9426bf5b97,1,58,50,108,42,2014-03-25 19:38:49,2014-03-25 19:38:49
0b02e53ca5d7b07dd2ddf1a84381ed9426bf5b97...0779b6bfc0535a8e3539f2282a0a5ed6ae141cde,1,12,12,24,6,2014-03-25 19:46:04,2014-03-25 19:46:04
0779b6bfc0535a8e3539f2282a0a5ed6ae141cde...e307e2ab89a8e667e801942c53b479ab3814e895,1,1,0,1,1,2014-03-25 19:52:52,2014-03-25 19:52:52
e307e2ab89a8e667e801942c53b479ab3814e895...b93ca855c0f99fbf6bd95d576c5667eb5615e102,1,1,1,2,1,2014-03-25 20:00:22,2014-03-20 23:46:31
b93ca855c0f99fbf6bd95d576c5667eb5615e102...726ffdc50ff3133c0cbaf5f3e0e23f77a68180d2,1,1,0,1,1,2014-03-25 20:08:11,2014-03-20 03:54:58
726ffdc50ff3133c0cbaf5f3e0e23f77a68180d2...e14d1a79880248150687dc68b4870ff175f31a63,1,1,0,1,1,2014-03-25 20:11:55,2014-03-24 19:57:40
e14d1a79880248150687dc68b4870ff175f31a63...080ac5a2626446769f1330c7d6112da71a282ee1,1,40,0,40,1,2014-03-25 20:26:34,2014-03-06 01:39:13
080ac5a2626446769f1330c7d6112da71a282ee1...562334f5f16c802f13247059a55c2a2236a7a41e,1,31,25,56,15,2014-03-25 20:30:28,2014-03-17 23:52:45
562334f5f16c802f13247059a55c2a2236a7a41e...ae342b5ce766ec872905bcf13a2e67272bd36904,1,113,2,115,8,2014-03-25 20:32:57,2014-01-14 21:31:30
ae342b5ce766ec872905bcf13a2e67272bd36904...008fbe53d1a59185db611a446964de985de0157f,1,15,8,23,6,2014-03-25 21:11:40,2014-03-25 21:11:40
008fbe53d1a59185db611a446964de985de0157f...fa844f64cb631d5b70c747b70b09cfea9f1683f9,1,4,0,4,1,2014-03-25 21:27:40,2014-03-25 15:54:27
fa844f64cb631d5b70c747b70b09cfea9f1683f9...074648ef579582198cb8b48732c6b43c1bbfe064,1,1,1,2,1,2014-03-25 21:27:40,2014-03-25 21:26:54
074648ef579582198cb8b48732c6b43c1bbfe064...abd6889dcaaa74e5d2c2b8264e9d5395e9158636,1,45,2,47,3,2014-03-25 22:53:27,2014-03-25 22:53:27
abd6889dcaaa74e5d2c2b8264e9d5395e9158636...664e680948f2cfe7d6ac57a77b9c1257ae856686,1,16,14,30,14,2014-03-25 22:54:40,2014-03-25 22:54:40
664e680948f2cfe7d6ac57a77b9c1257ae856686...9d077962274f4b88b2340989e2d59b6a4bad7adf,1,1,1,2,1,2014-03-25 22:57:10,2014-03-25 22:47:07
9d077962274f4b88b2340989e2d59b6a4bad7adf...d6bcbc773c276027d19a8c6d918227b38330efc9,1,2,1,3,1,2014-03-25 23:15:53,2014-02-08 14:23:57
d6bcbc773c276027d19a8c6d918227b38330efc9...f6877ed2d9d1bb8bc3ace0aa136890b411e78344,1,22,22,44,18,2014-03-26 00:07:47,2014-03-26 00:07:47
f6877ed2d9d1bb8bc3ace0aa136890b411e78344...ca1d126005a9b9791c86a2702295174f6c069bb2,1,2,2,4,2,2014-03-26 00:10:51,2014-03-26 00:10:51
ca1d126005a9b9791c86a2702295174f6c069bb2...af042b60dbb35da8341f217aa2c50411950bfe89,1,46,45,91,42,2014-03-26 00:33:05,2014-03-26 00:33:05
af042b60dbb35da8341f217aa2c50411950bfe89...98d5885237b1bfb97012513459d67e43842a9254,1,8,9,17,4,2014-03-26 00:35:44,2014-03-26 00:35:44
98d5885237b1bfb97012513459d67e43842a9254...273e34e3de531020f0f42180116a8256392272ff,1,6,0,6,1,2014-03-26 00:52:58,2014-01-29 18:02:56
273e34e3de531020f0f42180116a8256392272ff...6bf3a12eec6fb218eff3ac6d1849be10d4e821de,1,0,1,1,1,2014-03-26 01:05:13,2014-03-26 01:05:13
6bf3a12eec6fb218eff3ac6d1849be10d4e821de...372e31ae843233ab4cbaefb714f5d099a0a8e27b,1,45,7,52,6,2014-03-26 10:28:42,2014-03-19 19:28:17
372e31ae843233ab4cbaefb714f5d099a0a8e27b...3bf8d6c612da650ab9907661d756e062a798b54e,1,1,1,2,1,2014-03-26 10:50:31,2014-03-26 10:50:31
3bf8d6c612da650ab9907661d756e062a798b54e...2317af68510fe3b67526282dad697ad4dc621a19,2,36,2,38,3,2014-03-26 16:11:25,2014-03-21 23:07:58
2317af68510fe3b67526282dad697ad4dc621a19...1bebe36aa938890d61188762ed618b1b5e193634,4,344,240,584,86,2014-03-26 16:48:53,2014-03-25 15:57:31
1bebe36aa938890d61188762ed618b1b5e193634...47ba60146032c0bfadeaa9f3816644b31fc33315,1,1,1,2,1,2014-03-26 18:44:14,2014-02-26 08:10:30
47ba60146032c0bfadeaa9f3816644b31fc33315...d6d7fe4b07da493d73d9d934e1fe3b459ac8ea46,3,1,101,102,4,2014-03-26 22:55:08,2014-03-26 22:47:20
d6d7fe4b07da493d73d9d934e1fe3b459ac8ea46...aa249ae4a27aeb9f2d290958c2344dfbd52aee7b,5,27,34,61,7,2014-03-26 22:55:09,2014-03-26 22:51:11
aa249ae4a27aeb9f2d290958c2344dfbd52aee7b...33e6e0519c2fdc9b308259bd0f41e5dc47716d57,2,0,97,97,2,2014-03-26 22:55:09,2014-03-26 22:52:21
33e6e0519c2fdc9b308259bd0f41e5dc47716d57...489d0d46d7b6d44d7e5edc01bdfa835a8e8b52a6,2,0,12,12,2,2014-03-26 22:55:09,2014-03-26 22:54:30
489d0d46d7b6d44d7e5edc01bdfa835a8e8b52a6...15859cf2c493e251618e38d320cb397f1dfd5c88,1,1,1,2,1,2014-03-26 23:35:18,2013-10-07 03:28:19
15859cf2c493e251618e38d320cb397f1dfd5c88...7a7e9f4047812bf3317203c7fd618a8859a886a4,1,10,0,10,1,2014-03-26 23:42:39,2014-03-26 23:02:56
7a7e9f4047812bf3317203c7fd618a8859a886a4...5d9eccc2d4749c4a71d373613ca1a43a531d7978,1,2,0,2,1,2014-03-27 00:21:04,2014-03-26 02:43:58
5d9eccc2d4749c4a71d373613ca1a43a531d7978...e584111335058bb526ddff7501b04e76499e8071,1,7,0,7,1,2014-03-27 00:21:32,2014-03-26 02:46:19
e584111335058bb526ddff7501b04e76499e8071...545c62ab18659468fc32c9bd4f64b752b55d14c0,1,2,0,2,1,2014-03-27 00:21:53,2014-03-26 02:44:53
545c62ab18659468fc32c9bd4f64b752b55d14c0...0619e6f27817e09f9a12dab43317c521bf7761cf,2,6,6,12,6,2014-03-27 12:12:13,2014-03-26 02:22:25
0619e6f27817e09f9a12dab43317c521bf7761cf...a2aa667777e9cd9a2948d84356dec92da713dc77,1,3,3,6,2,2014-03-27 18:31:14,2014-03-27 18:11:20
a2aa667777e9cd9a2948d84356dec92da713dc77...3f9f1ad502089954484e5a3c1bba8b9171d8298a,1,1,1,2,1,2014-03-27 18:38:25,2014-03-27 13:43:08
3f9f1ad502089954484e5a3c1bba8b9171d8298a...08354ae1f749903383a7343bd105630956d8cab0,1,3,0,3,1,2014-03-27 20:31:52,2014-03-19 18:37:50
08354ae1f749903383a7343bd105630956d8cab0...9f62d9d20b904fc48f7aee37381178743a14739f,1,1,1,2,1,2014-03-27 20:51:41,2014-03-27 20:28:33
9f62d9d20b904fc48f7aee37381178743a14739f...1d2414ca93a0340840ea1e80c48edb51ec55cd48,6,100,42,142,30,2014-03-27 21:08:23,2013-07-17 16:08:38
1d2414ca93a0340840ea1e80c48edb51ec55cd48...b1d1cb6b7ab53b69e42c0571d4d1cac80fa0858d,1,1,0,1,1,2014-03-27 21:29:16,2014-01-14 14:21:52
b1d1cb6b7ab53b69e42c0571d4d1cac80fa0858d...d0df8c89464b62b23b525a7027d69053198d4ae6,1,5,5,10,2,2014-03-27 22:36:25,2014-02-13 22:03:25
d0df8c89464b62b23b525a7027d69053198d4ae6...ec8e3957d2adcb208f5213fba290d2ddaa79c542,1,1,1,2,1,2014-03-28 00:27:50,2014-03-28 00:15:22
ec8e3957d2adcb208f5213fba290d2ddaa79c542...f552f25171390e726ad7246ed18b994970bcf764,1,15,4,19,2,2014-03-28 04:04:25,2014-03-26 06:04:21
f552f25171390e726ad7246ed18b994970bcf764...ff5cf736e5b8073c8121295743873ccd04cc7d6b,2,29,8,37,8,2014-03-28 16:25:50,2014-03-21 20:32:53
ff5cf736e5b8073c8121295743873ccd04cc7d6b...908ab52b8dced67186e9f2d17a00362b28c13a86,1,10,6,16,2,2014-03-28 18:13:35,2014-03-28 17:20:47
908ab52b8dced67186e9f2d17a00362b28c13a86...876df046069eea93fc744e84d531a3f2f47cdd3b,1,74,0,74,1,2014-03-28 21:43:17,2014-03-28 21:43:17
876df046069eea93fc744e84d531a3f2f47cdd3b...50eb3b2bd69a6f86652391e67884452dd09a6b61,1,4,3,7,3,2014-03-31 23:18:11,2014-03-30 06:57:17
50eb3b2bd69a6f86652391e67884452dd09a6b61...47384bc61b3cadfb9e1456b62c3f431ee4bb27f2,1,27,13,40,6,2014-03-31 23:57:49,2014-03-31 13:04:35
47384bc61b3cadfb9e1456b62c3f431ee4bb27f2...2a4f92ee99179513efba98d564a8795917c77ddf,1,1,1,2,1,2014-04-01 10:52:23,2014-04-01 10:52:23
2a4f92ee99179513efba98d564a8795917c77ddf...14a2142484f1fa99fd01a0fe3e876e714f0f908f,1,2,1,3,2,2014-04-01 11:00:37,2014-04-01 11:00:37
14a2142484f1fa99fd01a0fe3e876e714f0f908f...789328de9b52a8fd596a561e7bb96683bbeac325,1,143,84,227,11,2014-04-01 17:21:47,2014-04-01 08:40:44
789328de9b52a8fd596a561e7bb96683bbeac325...6621adb6bbae369d1fd374348a19015f859162c2,1,4,15,19,2,2014-04-01 23:39:51,2014-04-01 23:39:51
6621adb6bbae369d1fd374348a19015f859162c2...0ed0207dfbb789022bc65ab267f8c3c6ac00b201,1,1,2,3,1,2014-04-02 12:08:00,2014-04-02 01:02:49
0ed0207dfbb789022bc65ab267f8c3c6ac00b201...10110bc3f7fb3226d0d4c9404d946b6813a0f8f4,7,78,70,148,33,2014-04-02 12:30:52,2014-04-01 18:13:22
10110bc3f7fb3226d0d4c9404d946b6813a0f8f4...7914d3463b5ec560c616a0c9fd008bc0e3f7c786,2,6,1,7,2,2014-04-02 14:05:45,2014-04-01 03:53:35
7914d3463b5ec560c616a0c9fd008bc0e3f7c786...ccfa72dfa1f18882b080aa03a94395f3e0b2fa77,1,1,1,2,1,2014-04-02 23:07:58,2014-03-29 14:15:22
ccfa72dfa1f18882b080aa03a94395f3e0b2fa77...ddb8081982e26cef2d8a4e87a743df6de35332d2,4,118,33,151,8,2014-04-02 23:40:16,2014-04-02 16:05:22
ddb8081982e26cef2d8a4e87a743df6de35332d2...2e3a972b3284540d9dd87c14345370fa36fa7b24,1,48,0,48,4,2014-04-02 23:40:16,2014-04-01 19:45:44
2e3a972b3284540d9dd87c14345370fa36fa7b24...549166740b944b2af45632bd04d7f360a24b2784,1,4,0,4,1,2014-04-03 00:23:13,2014-04-03 00:23:13
549166740b944b2af45632bd04d7f360a24b2784...6cd6ec62fd7ed84bee3b94bfa332eec1e7819a08,1,0,1,1,1,2014-04-03 03:55:18,2014-04-03 03:50:13
6cd6ec62fd7ed84bee3b94bfa332eec1e7819a08...862e587b46fc14fd0cfd99c33a5b0f40c071c6b4,1,1,1,2,1,2014-04-03 03:59:25,2014-04-02 23:26:45
862e587b46fc14fd0cfd99c33a5b0f40c071c6b4...f9eb324716972bd5d43a83186977f278983c8ec9,1,1,1,2,1,2014-04-03 04:24:40,2014-04-03 04:24:25
f9eb324716972bd5d43a83186977f278983c8ec9...ba48797bb00c0ca754041e387b51a50c02d42c3c,1,2,2,4,1,2014-04-03 05:01:39,2014-04-03 04:51:31
ba48797bb00c0ca754041e387b51a50c02d42c3c...d64d41ed992430a4fc89cd415c03acf8d56022e6,2,54,5,59,7,2014-04-03 07:25:01,2014-04-03 00:24:15
d64d41ed992430a4fc89cd415c03acf8d56022e6...83e36db85d471597c16a9b5cd378fd9b434e6a67,1,2,2,4,2,2014-04-03 16:37:23,2014-03-28 12:48:45
83e36db85d471597c16a9b5cd378fd9b434e6a67...c9677920d462046710fc72ca422ab7400f551d2e,2,92,25,117,11,2014-04-03 18:55:54,2014-04-02 22:54:25
c9677920d462046710fc72ca422ab7400f551d2e...71c11e96c64d5d4eb71f48c1eb778c2ba5c63377,2,19,8,27,2,2014-04-03 19:40:22,2014-04-03 19:34:36
71c11e96c64d5d4eb71f48c1eb778c2ba5c63377...c67bd69c58812da82b1a3a31d430df7aad8a50a8,2,39,2,41,3,2014-04-03 19:47:16,2014-04-03 04:56:53
c67bd69c58812da82b1a3a31d430df7aad8a50a8...1cb8584e8490ecdb1b410a8846c4478c6c2c0e53,2,19,10,29,3,2014-04-03 21:07:43,2014-03-12 19:24:22
1cb8584e8490ecdb1b410a8846c4478c6c2c0e53...7227f1a47930a6af6b9e9fb37ee919257514bcd0,1,84,0,84,1,2014-04-03 21:39:12,2014-04-03 21:35:14
7227f1a47930a6af6b9e9fb37ee919257514bcd0...cb6b976851b2114382cbd0d0ce1894eb4c49472f,1,5,0,5,2,2014-04-03 21:43:41,2014-04-03 21:43:41
cb6b976851b2114382cbd0d0ce1894eb4c49472f...8e2c62ae9dedc9aef1d2926068de8f63a62a578c,1,53,0,53,1,2014-04-03 21:46:15,2014-04-03 21:46:15
8e2c62ae9dedc9aef1d2926068de8f63a62a578c...c3695638182e027e8c6f7c817b85e24fb1006bd8,1,3,3,6,3,2014-04-03 23:01:49,2014-04-02 16:51:28
c3695638182e027e8c6f7c817b85e24fb1006bd8...b63fd11800762acdbb1ba5946f247ffdbe6bd07d,1,6,6,12,3,2014-04-03 23:09:10,2014-03-30 21:57:05
b63fd11800762acdbb1ba5946f247ffdbe6bd07d...a526ae8f777532fbdde96689cb62e05c16dd6b52,2,40,91,131,8,2014-04-04 07:30:06,2014-04-02 20:07:54
a526ae8f777532fbdde96689cb62e05c16dd6b52...7b0c5b937cabb7be656bc06a4e3b40a7c7a8932b,1,111,68,179,44,2014-04-04 09:22:33,2014-04-04 09:22:33
7b0c5b937cabb7be656bc06a4e3b40a7c7a8932b...6b7a1b82bc26bbf4640506a9a3cf37ebf254d3d2,1,10,8,18,3,2014-04-04 11:06:40,2014-04-04 11:06:40
6b7a1b82bc26bbf4640506a9a3cf37ebf254d3d2...28453015fca2b7ae000ba2f9b6eda9e43f6bebf0,12,356,283,639,94,2014-04-04 13:05:24,2014-04-04 13:05:24
28453015fca2b7ae000ba2f9b6eda9e43f6bebf0...e55c8bcbcab22b0f2b115cbacf90b4245821b5c6,1,5,1,6,1,2014-04-04 13:12:57,2014-03-31 22:47:51
e55c8bcbcab22b0f2b115cbacf90b4245821b5c6...dbe381f29fc72490f8e3a5328d5c487b185fe652,4,568,63,631,36,2014-04-04 13:48:53,2014-04-03 20:01:34
dbe381f29fc72490f8e3a5328d5c487b185fe652...708f2ba9843b665e417b93c7df907194565db991,2,43,0,43,2,2014-04-04 15:39:08,2014-04-03 03:57:28
708f2ba9843b665e417b93c7df907194565db991...20b22f1f7e7c95467c25b1b02eaa1867f1c35f11,1,1,1,2,1,2014-04-04 20:37:00,2014-04-03 23:50:01
20b22f1f7e7c95467c25b1b02eaa1867f1c35f11...8b0b7ca65a9da5f58ac1f37b6beed7bf814f7a26,1,1,1,2,1,2014-04-04 22:09:32,2014-04-03 23:18:33
8b0b7ca65a9da5f58ac1f37b6beed7bf814f7a26...ef64169db32ffdf5e0e3ae2154ac434c6a55378b,1,2,2,4,2,2014-04-05 12:58:16,2014-04-05 12:58:16
ef64169db32ffdf5e0e3ae2154ac434c6a55378b...461d6990cf9462906518ef905ecb8f8565c4fcd6,1,2,1,3,1,2014-04-05 13:34:37,2014-04-05 07:03:17
461d6990cf9462906518ef905ecb8f8565c4fcd6...d845d8a742a99bd94150a1b0dbe27e37a6aac5c2,1,1,1,2,1,2014-04-05 13:44:16,2014-04-05 05:27:16
d845d8a742a99bd94150a1b0dbe27e37a6aac5c2...4ae5f7a4777596f0ac6154bcb179e609393d2fe3,1,1,1,2,1,2014-04-05 13:48:30,2014-03-28 16:49:36
4ae5f7a4777596f0ac6154bcb179e609393d2fe3...3d31a15cc8c9971edc99b4d6985697a8a60599f8,1,3,0,3,1,2014-04-05 17:52:02,2014-04-05 17:32:01
3d31a15cc8c9971edc99b4d6985697a8a60599f8...e101c127af0b499d03b93c07460f28cfbffa2cc2,1,38,36,74,10,2014-04-05 20:01:33,2014-04-04 15:50:31
e101c127af0b499d03b93c07460f28cfbffa2cc2...f7cf680d2374b93fc2ba331957a097b7bc92fd8a,1,45,26,71,11,2014-04-06 13:56:45,2014-04-06 13:56:45
f7cf680d2374b93fc2ba331957a097b7bc92fd8a...4f38ba9898f668efb19fa2a1878bc6d50c9229f1,1,18,16,34,7,2014-04-06 14:22:21,2014-04-05 00:55:57
4f38ba9898f668efb19fa2a1878bc6d50c9229f1...abddefd0571e74aef560b1d53024274a992cdcd5,1,137,84,221,38,2014-04-06 16:22:24,2014-04-06 16:22:24
abddefd0571e74aef560b1d53024274a992cdcd5...b517f49a802a721ce903c751fa293b26f915c3b0,1,0,4,4,1,2014-04-06 16:27:53,2014-04-06 16:27:53
b517f49a802a721ce903c751fa293b26f915c3b0...6c7fdd845be63834e6c7290eb5dd4f6e6d22e057,1,2,2,4,1,2014-04-06 16:34:36,2014-04-05 05:33:07
6c7fdd845be63834e6c7290eb5dd4f6e6d22e057...64d404612f15dbebf99ee920ea4fcee85e9b3d65,1,1,1,2,1,2014-04-06 17:58:01,2014-04-06 17:58:01
64d404612f15dbebf99ee920ea4fcee85e9b3d65...28613f0eae62ff4114f71ffe54dc47bd4b60e3b0,1,1,1,2,1,2014-04-07 02:05:34,2014-04-07 01:50:50
28613f0eae62ff4114f71ffe54dc47bd4b60e3b0...091eb833018ad100df005cdaff73b1cc80042026,1,1,1,2,1,2014-04-07 11:39:54,2014-04-07 11:35:28
091eb833018ad100df005cdaff73b1cc80042026...a8d42800e7153a46365a08e7ef64bfd68aef0521,1,1,2,3,1,2014-04-07 11:46:20,2014-04-07 07:24:31
a8d42800e7153a46365a08e7ef64bfd68aef0521...f45241649bdfe6b3be524695bc1b099ed152b41b,1,1,1,2,1,2014-04-07 20:33:20,2014-04-07 20:28:24
f45241649bdfe6b3be524695bc1b099ed152b41b...1d9ac65d37e1fed193f9998e699cb9484dda6b88,1,19,29,48,3,2014-04-07 22:44:10,2014-04-07 22:44:10
1d9ac65d37e1fed193f9998e699cb9484dda6b88...b389cfc49efdad50a8d5ac7d693767cae719f41a,1,28,6,34,4,2014-04-07 23:10:34,2014-04-07 23:09:04
b389cfc49efdad50a8d5ac7d693767cae719f41a...940fcb4090e96824a4abc50252aa36aaf239e937,2,56,26,82,15,2014-04-08 14:19:42,2014-04-06 06:16:29
940fcb4090e96824a4abc50252aa36aaf239e937...2354924a46c00a4056f53173cb4123f391888320,1,20,20,40,12,2014-04-08 14:19:42,2014-04-07 10:36:39
2354924a46c00a4056f53173cb4123f391888320...66a132847dcad00a661836ebc84c99d4d2f45312,1,47,15,62,8,2014-04-08 14:19:42,2014-04-07 21:47:43
66a132847dcad00a661836ebc84c99d4d2f45312...faec99794dfdda542a010040f686d868615c39af,1,53,12,65,3,2014-04-08 14:19:42,2014-04-08 13:23:00
faec99794dfdda542a010040f686d868615c39af...879b0bc9f9daef3e77de336dd5d23eb185e5aaf7,1,1,1,2,1,2014-04-08 22:46:18,2014-04-08 22:44:12
879b0bc9f9daef3e77de336dd5d23eb185e5aaf7...acfcbdf906f0e969dd2678413342db6d98190ba4,1,49,285,334,20,2014-04-09 18:05:43,2014-04-08 00:30:21
acfcbdf906f0e969dd2678413342db6d98190ba4...3878be52f6d95fca4c386d4a5523f3c8fcb04270,2,320,235,555,44,2014-04-09 22:09:22,2013-12-29 00:50:09
3878be52f6d95fca4c386d4a5523f3c8fcb04270...2ad7bb9ca9c58ca61d2198c1e9040b0ae5d72d38,1,1,1,2,1,2014-04-09 23:49:59,2014-04-09 23:27:13
2ad7bb9ca9c58ca61d2198c1e9040b0ae5d72d38...6743ccf788ee6183e9576e2b4df7841c71401316,1,1,1,2,1,2014-04-10 10:46:05,2014-04-09 18:20:45
6743ccf788ee6183e9576e2b4df7841c71401316...66091756b8dc2149e38bd87ea9599115f2e20695,1,2,2,4,2,2014-04-10 12:24:16,2014-04-10 12:17:18
66091756b8dc2149e38bd87ea9599115f2e20695...61a8e198bddbdf133f63a879642a0b30af4b3967,1,1,1,2,1,2014-04-10 14:59:02,2014-04-10 12:53:00
61a8e198bddbdf133f63a879642a0b30af4b3967...24a045c3b282edb8b84c81f63aaba7e6ca39b859,2,3,3,6,3,2014-04-10 18:26:12,2014-04-10 18:23:44
24a045c3b282edb8b84c81f63aaba7e6ca39b859...4b1695ec61aac8de7fcac1dfe8b4b420f9842c38,8,337,33,370,44,2014-04-10 21:51:15,2014-03-17 20:36:49
4b1695ec61aac8de7fcac1dfe8b4b420f9842c38...613a5cc5db77fab8c23e7f43e452c2cd2d1ac8cd,1,1,1,2,1,2014-04-11 18:26:25,2014-04-10 12:44:22
613a5cc5db77fab8c23e7f43e452c2cd2d1ac8cd...ede9984b3658de426e762246124d91904b27804a,1,1,1,2,1,2014-04-13 00:46:41,2014-04-13 00:10:29
ede9984b3658de426e762246124d91904b27804a...b10a4371a6592ea1c54b5b9eb401842af7f63c90,2,12,3,15,6,2014-04-14 09:38:14,2014-04-10 19:25:15
b10a4371a6592ea1c54b5b9eb401842af7f63c90...5dee9e4a33ab2a0be6d8a8099297be3028771e0b,2,19,1,20,2,2014-04-15 21:14:37,2014-03-20 15:13:05
5dee9e4a33ab2a0be6d8a8099297be3028771e0b...1192531e9b48cd90cbb601b0c0fdeb12340c1885,2,27,4,31,7,2014-04-15 21:16:59,2014-04-10 00:44:59
1192531e9b48cd90cbb601b0c0fdeb12340c1885...d5a2069cd5e89f1421d86803e0dcb8f8dff480a9,1,1,1,2,1,2014-04-16 20:24:14,2014-04-16 20:20:13
d5a2069cd5e89f1421d86803e0dcb8f8dff480a9...b2e48e61c75c1b25ed8d320697c84b6edab11be3,1,1,1,2,1,2014-04-17 16:43:01,2014-04-13 09:40:33
b2e48e61c75c1b25ed8d320697c84b6edab11be3...3f047704c70a957596371fec554d3e1fb066a29d,1,42,0,42,2,2014-04-17 21:42:20,2014-02-23 22:44:52
3f047704c70a957596371fec554d3e1fb066a29d...49e7c32bb45ce3984df6768ba7b2f6a723a4ebe7,2,68,15,83,11,2014-04-17 21:42:34,2014-03-28 18:13:25
49e7c32bb45ce3984df6768ba7b2f6a723a4ebe7...f0407d2aa029dd870a730089706f2106cd6c6a09,1,1,1,2,1,2014-04-18 19:41:26,2014-04-11 07:16:54
f0407d2aa029dd870a730089706f2106cd6c6a09...a990078173efd40a40e884af62a6f4b999fd0513,1,1,1,2,1,2014-04-18 20:42:27,2014-04-06 04:44:55
a990078173efd40a40e884af62a6f4b999fd0513...ff428e72837c85b9540ee9e5a3daa2c9477c90bb,2,27,0,27,3,2014-04-18 21:47:25,2014-01-23 19:25:14
ff428e72837c85b9540ee9e5a3daa2c9477c90bb...64a3f42f14d9bc43b7ddb1f91a8800372aca41e6,1,1,1,2,1,2014-04-18 22:13:53,2014-04-18 22:13:53
64a3f42f14d9bc43b7ddb1f91a8800372aca41e6...02fcac5e043be050d36379bc75e358835b39b555,1,1,1,2,1,2014-04-18 22:38:37,2014-03-26 20:02:06
02fcac5e043be050d36379bc75e358835b39b555...45c356586bfdda4087d3c1af08720b714fb13128,1,1,1,2,1,2014-04-18 23:32:07,2014-04-07 23:07:14
45c356586bfdda4087d3c1af08720b714fb13128...8d0cb30688c05bd7c269dbfdb02f13c281fe5f7c,1,184,0,184,1,2014-04-18 23:33:03,2014-04-18 22:39:19
8d0cb30688c05bd7c269dbfdb02f13c281fe5f7c...21f93163384f36fc4ae0934387339380e3dc3e9c,2,122,1,123,3,2014-04-21 18:12:35,2014-02-25 17:27:20
21f93163384f36fc4ae0934387339380e3dc3e9c...88c2193c71954b9e7e7e4bdf636a2b168d36300d,3,118,80,198,27,2014-04-21 18:12:35,2014-03-06 20:57:24
88c2193c71954b9e7e7e4bdf636a2b168d36300d...0ebfa0d112c8ba42242cb8353db91e93eb42b463,1,4,4,8,4,2014-04-21 18:12:35,2014-03-06 21:00:27
0ebfa0d112c8ba42242cb8353db91e93eb42b463...1db3b8cfb7370db1fd3abbd482a51ed5af9694ac,9,172,186,358,49,2014-04-21 18:47:23,2014-04-18 22:35:37
1db3b8cfb7370db1fd3abbd482a51ed5af9694ac...546cb429d9cea25a9bdadbb87dfd401366b0b908,4,115,95,210,44,2014-04-21 18:48:38,2014-04-18 23:20:02
546cb429d9cea25a9bdadbb87dfd401366b0b908...9178c318e1a9aa010529e20481f343c8f4a5c182,1,2,2,4,2,2014-04-21 21:53:04,2014-04-21 21:53:04
9178c318e1a9aa010529e20481f343c8f4a5c182...857058569202e32c995a34a0f2a5091456878bcb,1,1,1,2,1,2014-04-21 22:01:55,2014-04-21 20:29:17
857058569202e32c995a34a0f2a5091456878bcb...b1559be5cf86fd15b76987d3c4af4d27bb22bd67,1,2,2,4,2,2014-04-21 22:09:04,2014-04-20 12:11:22
b1559be5cf86fd15b76987d3c4af4d27bb22bd67...5ce17efbbd8e4cb9bbd67a0733682f810f4d158f,1,3,3,6,2,2014-04-21 22:22:58,2014-04-21 02:34:20
5ce17efbbd8e4cb9bbd67a0733682f810f4d158f...2da94a701b8f5c51b80ac69586b80cb915b31800,1,2,2,4,2,2014-04-21 22:32:23,2014-04-20 16:47:58
2da94a701b8f5c51b80ac69586b80cb915b31800...7bcaf39437968dc5721fc81927463fdaf746cad3,1,71,0,71,1,2014-04-21 22:57:08,2014-04-21 22:52:45
7bcaf39437968dc5721fc81927463fdaf746cad3...6ab7adda3c51dd260ebcab0ea9b4a062ec93e02e,1,2,2,4,1,2014-04-21 23:04:39,2014-04-21 22:46:53
6ab7adda3c51dd260ebcab0ea9b4a062ec93e02e...219648fada2bf734544095eb058585495b679adb,1,1,1,2,1,2014-04-21 23:20:22,2014-04-20 14:17:59
219648fada2bf734544095eb058585495b679adb...92e8289c12e32a9eccaee204ff5f4683205fe1cf,9,20,20,40,15,2014-04-22 14:03:22,2014-04-22 13:31:22
92e8289c12e32a9eccaee204ff5f4683205fe1cf...8681276590822c37094c8c6fc7a4ac2f4e6d5d25,1,6,1,7,1,2014-04-22 23:26:19,2014-04-22 16:10:36
8681276590822c37094c8c6fc7a4ac2f4e6d5d25...e0375a61d03b489901b16d375b98a7f65db94af2,1,0,2,2,1,2014-04-22 23:32:18,2014-04-22 05:05:34
e0375a61d03b489901b16d375b98a7f65db94af2...950c9724ba90d321e299d383579c9ed03f1e75b3,1,1,1,2,1,2014-04-23 10:57:14,2014-04-23 10:57:14
950c9724ba90d321e299d383579c9ed03f1e75b3...f0da1a3615bc1abca0fd588aca90efd2102268b4,1,58,25,83,21,2014-04-23 11:38:58,2014-04-23 10:59:18
f0da1a3615bc1abca0fd588aca90efd2102268b4...bdec35cebc89e0d80a04eeffbd71ad999fc7e61a,4,62,248,310,18,2014-04-23 11:43:40,2014-04-22 11:35:07
bdec35cebc89e0d80a04eeffbd71ad999fc7e61a...828ad89e8aa194a1b8a10bec9e03ebc8506b0cb2,1,3,0,3,2,2014-04-23 18:32:41,2014-04-23 18:32:41
828ad89e8aa194a1b8a10bec9e03ebc8506b0cb2...8377e81827a840b9eb64f119de4bcbaba0ceb3be,1,14,9,23,3,2014-04-23 20:46:34,2014-04-20 15:24:01
8377e81827a840b9eb64f119de4bcbaba0ceb3be...eda00ce23f7841d3f2df3ca9eb541d170e079da1,4,58,30,88,16,2014-04-24 09:59:04,2014-04-24 09:59:04
eda00ce23f7841d3f2df3ca9eb541d170e079da1...06d0f1aea6ffa0767aae7c9c99585b7197dcdbd6,1,0,3,3,2,2014-04-24 10:42:01,2014-04-23 16:25:57
06d0f1aea6ffa0767aae7c9c99585b7197dcdbd6...e19dbc7793c285ec25d471751403f8b14f43efa8,1,3,1,4,1,2014-04-24 13:41:54,2014-03-19 07:46:56
e19dbc7793c285ec25d471751403f8b14f43efa8...737ef25df13ef195ebb7637602386c90810f276f,1,1,1,2,1,2014-04-24 17:27:53,2014-04-24 17:25:22
737ef25df13ef195ebb7637602386c90810f276f...39335d96d36d8c3d76dffdb434858ddaefbbac31,1,1,1,2,1,2014-04-24 23:18:25,2014-04-22 09:40:57
39335d96d36d8c3d76dffdb434858ddaefbbac31...6ac6621661533eb5126a86459d3690abf5ceeeb9,1,1,1,2,1,2014-04-24 23:47:40,2014-04-22 09:36:05
6ac6621661533eb5126a86459d3690abf5ceeeb9...498835a1c4d0dc6397df4dd667796b09565fedf4,2,12,5,17,3,2014-04-25 06:36:28,2014-04-24 20:48:45
498835a1c4d0dc6397df4dd667796b09565fedf4...ff03d7b3234a2ed027366a85a6ad7b14aac47feb,1,17,0,17,1,2014-04-25 22:00:17,2014-04-25 22:00:17
ff03d7b3234a2ed027366a85a6ad7b14aac47feb...305696c660afd063834608427107b5f62532b2f6,1,67,27,94,7,2014-04-27 08:10:10,2014-04-27 08:09:59
305696c660afd063834608427107b5f62532b2f6...e16c6aa31d1bf17d528b491451e1400f670e7e64,1,32,34,66,18,2014-04-27 09:13:44,2014-04-27 09:13:22
e16c6aa31d1bf17d528b491451e1400f670e7e64...accd35b7471bbf58cd5b569a004824fa60fa640a,69,1365,1212,2577,688,2014-04-27 20:20:31,2014-04-26 20:07:28
accd35b7471bbf58cd5b569a004824fa60fa640a...7d1719e21917aaa13c6ae3cf2eb596e3e93082da,1,9,14,23,2,2014-04-28 11:55:47,2014-04-28 09:38:32
7d1719e21917aaa13c6ae3cf2eb596e3e93082da...7a543c985e3d0cd028e49948fe496800f900ae96,1,13,0,13,1,2014-04-28 12:18:51,2014-04-28 09:12:26
7a543c985e3d0cd028e49948fe496800f900ae96...af72f40a5512daa97c1f175a59b547c33cff1dc0,1,1,1,2,1,2014-04-28 12:36:04,2014-04-21 12:12:38
af72f40a5512daa97c1f175a59b547c33cff1dc0...e37e67eadbd5c8b5342499f8a4f27d644106b3f2,1,14,14,28,8,2014-04-28 12:54:03,2014-04-23 09:51:31
e37e67eadbd5c8b5342499f8a4f27d644106b3f2...2022fd768e274276436bb13e4f05f5ef786a5b9e,1,4,4,8,4,2014-04-28 13:39:54,2013-12-14 23:18:44
2022fd768e274276436bb13e4f05f5ef786a5b9e...0d691a6febaa0fe24cd64ea19b1389a4003bfc92,1,3,1,4,1,2014-04-28 13:53:34,2013-12-16 19:18:45
0d691a6febaa0fe24cd64ea19b1389a4003bfc92...e3814b12662dac500f96f4ce1bb5f35c24195497,1,2,0,2,1,2014-04-28 14:05:40,2014-02-15 02:52:26
e3814b12662dac500f96f4ce1bb5f35c24195497...fcc3a7a423ea8027c319adad8e28499960ff58a6,1,1,1,2,1,2014-04-28 19:04:06,2014-01-14 14:28:54
fcc3a7a423ea8027c319adad8e28499960ff58a6...d90f83cda809b139dcfea587fcde073a05ca2b81,1,1,1,2,1,2014-04-28 21:18:55,2014-04-28 21:18:46
d90f83cda809b139dcfea587fcde073a05ca2b81...7570e9f07d5ad053362fdde81abe68a998fa9388,1,1,1,2,1,2014-04-29 06:53:37,2014-04-29 06:53:37
7570e9f07d5ad053362fdde81abe68a998fa9388...8e404c4dc1c986557f2c828630ebf24b3dc079ad,2,1,5,6,2,2014-04-29 11:33:20,2014-04-29 11:33:20
8e404c4dc1c986557f2c828630ebf24b3dc079ad...8d38ec38921bf887189eb31b07855ca987beff47,1,2,0,2,2,2014-04-29 12:29:01,2014-04-29 12:10:40
8d38ec38921bf887189eb31b07855ca987beff47...28ef2637c111d2940d2062c3cc8be29e7984f35a,1,2,1,3,1,2014-04-29 13:56:37,2014-04-29 11:24:22
28ef2637c111d2940d2062c3cc8be29e7984f35a...f0e12ea7fea853192e4eead00b40d6041c5f914a,2,139,3,142,7,2014-04-29 18:48:50,2014-04-26 23:35:01
f0e12ea7fea853192e4eead00b40d6041c5f914a...60b2851df7e8a9c6ecaea9e13685c339262c5bcf,1,4,0,4,1,2014-04-29 22:25:00,2014-04-29 20:13:08
60b2851df7e8a9c6ecaea9e13685c339262c5bcf...8b8992b1457458b92ef928892c107ba58b659872,1,0,2,2,2,2014-04-30 10:01:02,2014-04-30 09:59:07
8b8992b1457458b92ef928892c107ba58b659872...82751f5960c8ae8a00ac58785dcfa69b6b02d6c0,1,1,1,2,1,2014-04-30 10:16:21,2014-04-30 10:16:21
82751f5960c8ae8a00ac58785dcfa69b6b02d6c0...81147a8bfd87a30e6a8682e61214c7610a9c079b,1,1,0,1,1,2014-04-30 13:21:48,2014-04-30 13:21:48
81147a8bfd87a30e6a8682e61214c7610a9c079b...ad4336f9359a073e272930f8f9bcd36587a8648f,2,1,193,194,6,2014-04-30 21:00:52,2014-04-27 02:22:16
ad4336f9359a073e272930f8f9bcd36587a8648f...e0d4c42148f163b2b7357070b508331897423085,1,2,1,3,1,2014-04-30 21:02:58,2014-04-30 21:01:36
e0d4c42148f163b2b7357070b508331897423085...3fb2d2ac3b2ac56dfbb70b9b383d26acc00f8f77,1,1,1,2,1,2014-04-30 21:49:28,2014-04-30 19:31:49
3fb2d2ac3b2ac56dfbb70b9b383d26acc00f8f77...e1d6178457045e721872022f71227b277cb88726,2,9,1,10,2,2014-04-30 22:51:20,2014-04-30 21:36:30
e1d6178457045e721872022f71227b277cb88726...b426424e6329d416abd0e1890c61b3f2b18f598c,1,7,7,14,6,2014-05-01 21:39:55,2014-04-29 14:44:14
b426424e6329d416abd0e1890c61b3f2b18f598c...69d96e8b71a9d6f9ed1b96608bfe0feaa11ceb31,1,5,5,10,4,2014-05-01 22:35:58,2014-04-24 23:53:11
69d96e8b71a9d6f9ed1b96608bfe0feaa11ceb31...cbc7496c1f7c6b5b875dcb073d6226d02f390e4e,12,155,112,267,36,2014-05-02 13:48:45,2014-05-02 13:45:37
cbc7496c1f7c6b5b875dcb073d6226d02f390e4e...924ee6db06a2518224caada86769efedd21c0710,2,7,2,9,3,2014-05-02 17:58:13,2014-04-24 18:12:37
924ee6db06a2518224caada86769efedd21c0710...c0b4e2db9cbc8bc3164cedc4646145d3ab72536e,4,47,12,59,11,2014-05-02 18:12:22,2014-04-17 14:11:28
c0b4e2db9cbc8bc3164cedc4646145d3ab72536e...0f4016c84a47e01a0fb993867dfd0a64828c089c,5,879,0,879,8,2014-05-02 20:31:34,2014-04-22 06:15:01
0f4016c84a47e01a0fb993867dfd0a64828c089c...2b6c2c5fbd74fca14eb454b6f12f3e3e45be733c,1,2,0,2,2,2014-05-02 20:49:15,2014-05-02 20:49:10
2b6c2c5fbd74fca14eb454b6f12f3e3e45be733c...c2362e3f45e732a9defdb0ea59ce4ec5236fcd3a,2,42,5,47,8,2014-05-02 21:06:57,2014-04-28 23:26:56
c2362e3f45e732a9defdb0ea59ce4ec5236fcd3a...8d180383014cbe38d58ff3eab083f51cfcfb8dde,3,6,4,10,4,2014-05-02 21:06:57,2014-04-30 22:43:03
8d180383014cbe38d58ff3eab083f51cfcfb8dde...627b0354ec35bef5c6dbfab6469168c2fadcbee5,2,11,0,11,3,2014-05-02 21:48:57,2014-03-29 21:45:36
627b0354ec35bef5c6dbfab6469168c2fadcbee5...e395170eefd21237ffc838aa7aa8381135261e5c,1,1,1,2,1,2014-05-04 17:59:12,2014-05-02 16:27:13
e395170eefd21237ffc838aa7aa8381135261e5c...fbf5ab8f17d28efeadb492c5a252f0778643f072,2,25,12,37,6,2014-05-04 19:07:07,2014-04-28 21:07:01
fbf5ab8f17d28efeadb492c5a252f0778643f072...8c08fcfb1b993f05ecbec94b0c44dd3757066b51,1,1,0,1,1,2014-05-04 19:07:07,2014-05-04 18:39:44
8c08fcfb1b993f05ecbec94b0c44dd3757066b51...c56e32a7fa44e2edd2c70f663906720c7c9ad898,2,33,3,36,2,2014-05-04 19:18:27,2014-04-22 21:20:39
c56e32a7fa44e2edd2c70f663906720c7c9ad898...1c0241e5b210c14ea09ed9626072ead33bb183a9,1,1,1,2,1,2014-05-04 19:37:34,2014-05-04 19:02:34
1c0241e5b210c14ea09ed9626072ead33bb183a9...8b91aa64b70f3c94d7d1ecb133f4d5a36ed49ed6,2,39,1,40,2,2014-05-04 19:46:38,2014-05-04 03:11:46
8b91aa64b70f3c94d7d1ecb133f4d5a36ed49ed6...3f540e3d8a0220b51cec046e457c7e2111da1631,1,1,1,2,1,2014-05-04 19:52:59,2014-04-30 15:27:53
3f540e3d8a0220b51cec046e457c7e2111da1631...e0e9ccdb79dd6e65919146de5def460d68d8f567,6,12,11,23,10,2014-05-05 19:54:07,2014-05-05 19:54:07
e0e9ccdb79dd6e65919146de5def460d68d8f567...2972de8a447adcb5af9cc83935e0c44769310c1f,1,2,1,3,1,2014-05-06 22:56:44,2014-05-06 21:50:35
2972de8a447adcb5af9cc83935e0c44769310c1f...e16e7df68927470e95e1b1491fa5738a151e9286,1,1,1,2,1,2014-05-07 01:26:31,2014-05-06 15:59:51
e16e7df68927470e95e1b1491fa5738a151e9286...6f9bcd33072d2ba9790e2c731149e4b77eaae9cc,1,1,1,2,1,2014-05-07 01:29:30,2014-05-06 15:26:19
6f9bcd33072d2ba9790e2c731149e4b77eaae9cc...2faa4781c5bb5a09ae02ac9fdef806e86156d0c7,1,2,4,6,4,2014-05-07 04:52:25,2014-05-07 04:51:24
2faa4781c5bb5a09ae02ac9fdef806e86156d0c7...055b738d4e7fa033d8e8c15ebc635362b306cada,1,1,1,2,1,2014-05-07 11:59:18,2014-05-07 11:27:37
055b738d4e7fa033d8e8c15ebc635362b306cada...72d63dbcc09ecfcb2e12cc3ecfbcff94648fbbfc,1,1,1,2,1,2014-05-08 08:23:03,2014-05-07 22:33:18
72d63dbcc09ecfcb2e12cc3ecfbcff94648fbbfc...88335fdfcfa9b91a8fb77e978f4ba7590385e3db,1,1,1,2,1,2014-05-08 08:29:28,2014-05-08 03:23:34
88335fdfcfa9b91a8fb77e978f4ba7590385e3db...28af74a9019d1205e0d9c7cc190bf81c3bef7fd4,1,1,1,2,1,2014-05-08 08:53:34,2014-05-05 14:06:52
28af74a9019d1205e0d9c7cc190bf81c3bef7fd4...4899e781ffabb011a4c6fa290ef00b0b8403ba55,1,1,1,2,1,2014-05-08 09:12:58,2014-05-05 09:09:40
4899e781ffabb011a4c6fa290ef00b0b8403ba55...7700024ef56132b939e0a7dcc138e88591706c8c,1,1,1,2,1,2014-05-08 09:26:44,2014-04-28 22:59:28
7700024ef56132b939e0a7dcc138e88591706c8c...6593d836264bccc67015c78476e00012e4db2732,1,2,1,3,2,2014-05-08 16:05:52,2014-04-27 22:52:46
6593d836264bccc67015c78476e00012e4db2732...ac37915ef64c60ec8f8d4e49e4d61d7baeb96ba0,2,40,25,65,5,2014-05-08 21:08:04,2014-05-07 02:57:31
ac37915ef64c60ec8f8d4e49e4d61d7baeb96ba0...0ef17276e9aa0aefe5f9aa6f04da5b35dd0f9466,1,2,36,38,37,2014-05-09 08:56:27,2014-04-14 15:43:07
0ef17276e9aa0aefe5f9aa6f04da5b35dd0f9466...adfc322b04a58158fb9697e5b99aab9ca63c80bb,2,155,91,246,46,2014-05-09 10:41:38,2014-05-08 23:20:19
adfc322b04a58158fb9697e5b99aab9ca63c80bb...a0ae07bd4ee8d98654df4eb261d16ca55884e374,2,79,3,82,6,2014-05-09 10:50:00,2014-05-08 23:52:37
a0ae07bd4ee8d98654df4eb261d16ca55884e374...562c4e424b0ed5f8d4bffba0cd18e66db2059043,2,55,1,56,6,2014-05-09 13:42:26,2014-04-01 20:40:10
562c4e424b0ed5f8d4bffba0cd18e66db2059043...14f5734dbd178172ae286ea545d89290692823fc,1,1,0,1,1,2014-05-09 21:37:41,2014-05-09 21:37:41
14f5734dbd178172ae286ea545d89290692823fc...be7c02c316dd1fbb8277851405e78a4cb1c283f1,1,188,0,188,1,2014-05-09 22:07:24,2014-05-02 22:37:27
be7c02c316dd1fbb8277851405e78a4cb1c283f1...d71dbb1ae50f174680533492ce4c7db3ff74df00,3,15,58,73,7,2014-05-10 21:32:29,2014-04-28 20:23:10
d71dbb1ae50f174680533492ce4c7db3ff74df00...7f5e0f0bd064594ad122ea29cc2758be563bb201,1,3,0,3,1,2014-05-11 10:52:28,2014-05-11 10:50:54
7f5e0f0bd064594ad122ea29cc2758be563bb201...e9bc51cb0964ea682c1654919174dacebd09fcf6,1,3,3,6,1,2014-05-12 00:58:08,2014-02-20 23:49:27
e9bc51cb0964ea682c1654919174dacebd09fcf6...5a568b4f960cc5381b3911e3a6423aff2ff7f7f9,4,431,382,813,27,2014-05-14 21:17:19,2014-03-09 23:42:03
5a568b4f960cc5381b3911e3a6423aff2ff7f7f9...0282ca971df7923c8f3dba0eb0df544e244e5b93,1,2,2,4,2,2014-05-15 15:03:42,2014-05-15 14:35:27
0282ca971df7923c8f3dba0eb0df544e244e5b93...7a3cbb3c79ab429370fad6a8572569ae939b8c8a,1,1,1,2,1,2014-05-15 15:14:15,2014-05-15 15:09:14
7a3cbb3c79ab429370fad6a8572569ae939b8c8a...a84344adb6bb11d66acae9779dc9677b4f8abcf5,1,4,4,8,4,2014-05-15 19:56:54,2014-05-15 19:18:22
a84344adb6bb11d66acae9779dc9677b4f8abcf5...81d427b5f0d3502f65e8db5beaa5ad837c9ede17,2,6,2,8,2,2014-05-15 20:18:59,2014-05-15 17:20:47
81d427b5f0d3502f65e8db5beaa5ad837c9ede17...35a6646a81ec0d753cc13882d314728596c3b36e,1,8,2,10,1,2014-05-16 11:33:05,2014-05-16 11:13:19
35a6646a81ec0d753cc13882d314728596c3b36e...d5a92d22502dac617351dd2bc1726025973c439a,1,2,2,4,1,2014-05-16 11:45:22,2014-03-24 22:08:26
d5a92d22502dac617351dd2bc1726025973c439a...5aaf98d44f00106a7a991cc01e58157078134290,2,25,20,45,6,2014-05-16 11:59:14,2014-02-22 17:43:56
5aaf98d44f00106a7a991cc01e58157078134290...c2c9d524b95277431bb56738d5254ab850b57943,1,9,0,9,1,2014-05-16 12:09:21,2014-02-27 11:33:51
c2c9d524b95277431bb56738d5254ab850b57943...d85c5e949a0f28dba10f07ce7244007845f2d5d7,1,4,4,8,3,2014-05-16 12:16:34,2014-02-27 16:32:10
d85c5e949a0f28dba10f07ce7244007845f2d5d7...6712ca5a6cdc11ac4c088e3be0a1cd65fd9892d6,1,1,1,2,1,2014-05-16 13:23:35,2014-05-16 13:23:35
6712ca5a6cdc11ac4c088e3be0a1cd65fd9892d6...52cae5b59b7106f3d111f7405f8d657cd94c4c2a,1,1,1,2,1,2014-05-16 13:33:09,2014-05-16 13:33:09
52cae5b59b7106f3d111f7405f8d657cd94c4c2a...a4ec1187d69e962c17545f07f2271936b4e62f11,1,1,1,2,1,2014-05-16 13:52:24,2013-12-16 23:42:55
a4ec1187d69e962c17545f07f2271936b4e62f11...d1f1a1abddb4f95d436eeaedbd98f8534a3b674a,1,2,2,4,1,2014-05-16 18:22:01,2014-05-16 09:38:45
d1f1a1abddb4f95d436eeaedbd98f8534a3b674a...d16102fa4152c87222ef255b47c5afe9db6e3238,1,1,0,1,1,2014-05-16 18:33:02,2014-05-16 18:33:02
d16102fa4152c87222ef255b47c5afe9db6e3238...4f03dc5a9650f3f22f78b438474322b4b8871dec,2,86,9,95,5,2014-05-16 20:08:10,2014-05-14 12:25:54
4f03dc5a9650f3f22f78b438474322b4b8871dec...63f284a55ccde38f0d2b8d83af1979db233f33fb,1,2,2,4,1,2014-05-16 20:15:03,2014-04-11 20:09:28
63f284a55ccde38f0d2b8d83af1979db233f33fb...5fbd618c2ff0dbaa4e19d0fd0e55921ce7d89478,2,23,1,24,2,2014-05-16 21:02:41,2014-04-26 14:17:50
5fbd618c2ff0dbaa4e19d0fd0e55921ce7d89478...819dd5df92ad73b48e370c00d6e8cea10bf08e63,1,35,0,35,1,2014-05-16 22:14:12,2014-05-16 22:14:12
819dd5df92ad73b48e370c00d6e8cea10bf08e63...96fa70511d0177270369b00471d4020617a45537,1,4,4,8,4,2014-05-17 01:18:26,2014-05-17 01:18:26
96fa70511d0177270369b00471d4020617a45537...facd904a613e716151a13ab7460b5e6206e0442b,2,15,2,17,4,2014-05-18 07:35:21,2014-05-17 11:01:35
facd904a613e716151a13ab7460b5e6206e0442b...d8bc44b7e9275f2f0a4bd0345715f8300f2f18d1,1,2,0,2,1,2014-05-19 00:46:54,2014-05-19 00:42:30
d8bc44b7e9275f2f0a4bd0345715f8300f2f18d1...0dfbf8ad678babbf4d34817f037dc3826a6fe716,1,14,28,42,3,2014-05-19 13:05:46,2014-04-25 00:17:17
0dfbf8ad678babbf4d34817f037dc3826a6fe716...e927193de06500f01a2f893934250911cf1905e6,1,13,4,17,2,2014-05-19 13:29:07,2014-05-17 23:04:37
e927193de06500f01a2f893934250911cf1905e6...35e53ca649c60a27272cac38e4e9d686fb0c74f2,1,1,1,2,1,2014-05-19 18:27:58,2014-05-16 07:43:31
35e53ca649c60a27272cac38e4e9d686fb0c74f2...63e13a4df742f16c66e4a2cc9b3bc19e3f583eb4,1,5,4,9,4,2014-05-20 06:46:26,2014-05-08 07:44:09
63e13a4df742f16c66e4a2cc9b3bc19e3f583eb4...6898ac59858a4748c08804e0cb0444e4834e6d00,1,1,1,2,1,2014-05-20 06:46:26,2014-05-19 15:39:45
6898ac59858a4748c08804e0cb0444e4834e6d00...6708feffdbe055e8b89737ea51f5c23376899e91,1,2,1,3,1,2014-05-20 06:46:26,2014-05-19 15:44:13
6708feffdbe055e8b89737ea51f5c23376899e91...95cdb53e83994d14d6f30716d47ba0f8c33e491c,1,1,0,1,1,2014-05-20 06:46:26,2014-05-19 21:43:40
95cdb53e83994d14d6f30716d47ba0f8c33e491c...f34de0ba35d6ba115db05f474943e315537f69d4,1,1,1,2,1,2014-05-20 16:16:27,2014-05-18 17:44:32
f34de0ba35d6ba115db05f474943e315537f69d4...e994259739821094e77a3d2c1f30c28713b7ab3a,2,9,86,95,5,2014-05-20 18:00:26,2014-05-19 21:57:03
e994259739821094e77a3d2c1f30c28713b7ab3a...e3f78c17d3b5d3a714402d7314094aabe7f6512a,2,109,1,110,4,2014-05-20 19:41:20,2014-05-20 08:11:34
e3f78c17d3b5d3a714402d7314094aabe7f6512a...6b5284807a70fe4932403230a8e85769a9c3550b,1,1,1,2,1,2014-05-20 20:04:21,2014-05-20 20:04:21
6b5284807a70fe4932403230a8e85769a9c3550b...def5b57de872058874c05e214cc4007ae48aca0f,3,5,5,10,5,2014-05-20 21:45:08,2014-05-20 21:36:00
def5b57de872058874c05e214cc4007ae48aca0f...82f45aee5bd84d1cc53fb2e8f645d2263cdaacbc,2,46,5,51,10,2014-05-21 07:20:20,2014-05-20 21:23:02
82f45aee5bd84d1cc53fb2e8f645d2263cdaacbc...ad0d3e0f1be9790d20fef901cda4be5c279e1a46,1,1,1,2,1,2014-05-21 11:48:37,2014-05-07 20:01:19
ad0d3e0f1be9790d20fef901cda4be5c279e1a46...9332439d1d212da83cb54056b69f8fcdb0c48444,1,0,0,0,0,2014-05-21 11:51:13,2014-05-21 00:46:18
9332439d1d212da83cb54056b69f8fcdb0c48444...16a7d54351020d9b197b1f9480aa398c70c2886d,4,1,1,2,1,2014-05-21 12:58:36,2014-05-21 12:58:36
16a7d54351020d9b197b1f9480aa398c70c2886d...826450da204504258489fcc13cb1c478ca1a6feb,1,1,5,6,1,2014-05-21 13:27:06,2014-05-21 13:27:06
826450da204504258489fcc13cb1c478ca1a6feb...e3375ae37efd1414a996869097acb7cb850e5c0a,1,4,3,7,1,2014-05-21 13:46:05,2014-05-21 13:46:05
e3375ae37efd1414a996869097acb7cb850e5c0a...6cb35adfe869c63cb3df84941d78406fab18ec3f,1,1,1,2,1,2014-05-21 14:41:47,2014-05-21 13:50:38
6cb35adfe869c63cb3df84941d78406fab18ec3f...ef13820cad7d8761b43d15d95fd8a6ba70688596,1,7,0,7,1,2014-05-21 15:20:20,2014-05-20 19:56:39
ef13820cad7d8761b43d15d95fd8a6ba70688596...92f588cd15b8f20f8c7f87f1384a6957c4cf136f,1,1,1,2,1,2014-05-21 15:28:17,2014-05-20 14:04:43
92f588cd15b8f20f8c7f87f1384a6957c4cf136f...d8c55864d051edb5dd2d6ba6a60e710bba29f4ba,1,7,5,12,4,2014-05-21 15:58:52,2014-05-21 15:58:52
d8c55864d051edb5dd2d6ba6a60e710bba29f4ba...21a3cea657560b76f1be7981248e81be727e62ab,1,8,8,16,1,2014-05-21 16:09:37,2014-03-12 12:46:10
21a3cea657560b76f1be7981248e81be727e62ab...7e4598663abd88245022dc5a5af0885ab63fb1a5,1,1,1,2,1,2014-05-21 17:27:37,2014-05-12 19:15:26
7e4598663abd88245022dc5a5af0885ab63fb1a5...20221f9582ef41c07567f7c00a8bea8a73332abb,1,1,1,2,1,2014-05-21 17:29:13,2014-05-16 18:44:27
20221f9582ef41c07567f7c00a8bea8a73332abb...9fb0e167190d4dabe25e9211cb80db8cb3b26db4,1,3,3,6,3,2014-05-21 17:33:11,2014-05-16 09:15:49
9fb0e167190d4dabe25e9211cb80db8cb3b26db4...854bf5b74d0395f4d2e30382102d3f5d1614ea11,2,3,5,8,3,2014-05-21 17:43:32,2014-05-16 19:18:19
854bf5b74d0395f4d2e30382102d3f5d1614ea11...f9264eec0725ea93fe2d9674fabe61c6a192901f,1,1,1,2,1,2014-05-21 17:47:09,2014-05-21 17:47:09
f9264eec0725ea93fe2d9674fabe61c6a192901f...bdfbceb3d34e2c0c56781d21a4bbc4a0cb5bb3ff,1,1,1,2,1,2014-05-21 17:47:21,2014-05-15 04:59:29
bdfbceb3d34e2c0c56781d21a4bbc4a0cb5bb3ff...326fd809c8b1818e36014fa308b99d01f6f1e34e,1,1,1,2,1,2014-05-21 18:23:38,2014-05-21 18:23:38
326fd809c8b1818e36014fa308b99d01f6f1e34e...d606e66f7ab893f8799991883fd02b0e66e3225e,1,10,5,15,4,2014-05-21 18:36:34,2014-05-21 18:35:59
d606e66f7ab893f8799991883fd02b0e66e3225e...84402b11c8c5503b11a531b596b39da80abdb755,1,1,1,2,1,2014-05-21 18:41:57,2014-05-14 08:00:47
84402b11c8c5503b11a531b596b39da80abdb755...f5f1fd1963b63299eeea3573034c64f9e2be7728,1,1,1,2,1,2014-05-21 19:31:26,2014-05-08 15:28:16
f5f1fd1963b63299eeea3573034c64f9e2be7728...d02fa32f36a6932b7fcee59ce7b829a82288b0ff,1,12,6,18,4,2014-05-21 20:07:13,2014-05-21 18:44:35
d02fa32f36a6932b7fcee59ce7b829a82288b0ff...ff16d224ca81c07f3ef744e7a461b344af98ecf4,1,2,0,2,2,2014-05-21 20:23:30,2014-04-27 18:34:15
ff16d224ca81c07f3ef744e7a461b344af98ecf4...636b3799b323d223bff900b2d0e8d255b58f7c8e,1,18,1,19,1,2014-05-21 20:26:20,2014-03-27 01:08:45
636b3799b323d223bff900b2d0e8d255b58f7c8e...0a3268f106086b1a7810da6aa011dc83e5a748b6,1,1,1,2,1,2014-05-21 20:29:57,2014-05-13 07:26:28
0a3268f106086b1a7810da6aa011dc83e5a748b6...b64c709808860b1ef48a8902c79fe196170a9add,1,3,0,3,1,2014-05-21 20:33:56,2014-03-27 19:40:07
b64c709808860b1ef48a8902c79fe196170a9add...d3163ff1cff417c240c36b37ff2f8067398dee1a,1,2,2,4,2,2014-05-21 20:37:47,2014-05-10 15:09:52
d3163ff1cff417c240c36b37ff2f8067398dee1a...510c328d7458ab199a0cf8176253d85710a0164c,1,7,7,14,3,2014-05-21 20:57:25,2014-04-28 11:53:44
510c328d7458ab199a0cf8176253d85710a0164c...6c3a0519fadeb0e2a175a0406875745a588d66df,1,4,3,7,2,2014-05-21 21:26:43,2014-04-06 19:28:56
6c3a0519fadeb0e2a175a0406875745a588d66df...b5fb2d4becb321ac634c0b08c874fd44a51f52e4,1,1,1,2,1,2014-05-21 21:32:04,2014-04-01 21:08:16
b5fb2d4becb321ac634c0b08c874fd44a51f52e4...b696822c1c6c6fb5d2ab22d4fe07672617bb8b64,1,2,2,4,2,2014-05-21 21:33:43,2014-05-21 21:33:25
b696822c1c6c6fb5d2ab22d4fe07672617bb8b64...f2f5a1dd393a0c73bfeb9b3d575553157f7f04f6,1,2,2,4,2,2014-05-21 22:26:29,2014-05-12 21:17:43
f2f5a1dd393a0c73bfeb9b3d575553157f7f04f6...1fe0d9990edbf9dcc05df763aef510e3f632d274,1,7,7,14,4,2014-05-21 22:35:55,2014-05-14 11:25:08
1fe0d9990edbf9dcc05df763aef510e3f632d274...40b8721ba387d87e820e2420cbc4275befdf932d,1,1,1,2,1,2014-05-21 22:49:24,2014-05-05 20:56:33
40b8721ba387d87e820e2420cbc4275befdf932d...1ab6e908b15470d59b52eb0ead20c755c66ec3b8,2,20,1,21,3,2014-05-21 22:51:19,2014-05-14 14:18:17
1ab6e908b15470d59b52eb0ead20c755c66ec3b8...eec6394a342fb92fba5270eee11c83f1d895e9fb,1,1,2,3,2,2014-05-21 23:08:02,2014-05-21 23:02:34
eec6394a342fb92fba5270eee11c83f1d895e9fb...144513086983804d8fa35c920bc36cab40821ca2,1,1,1,2,1,2014-05-21 23:28:07,2014-04-15 23:44:38
144513086983804d8fa35c920bc36cab40821ca2...6e2ab81937d9cef2630e13dfe00ac684a902fc3b,1,3,3,6,2,2014-05-22 00:10:30,2014-05-12 12:41:51
6e2ab81937d9cef2630e13dfe00ac684a902fc3b...f694951b3f1fe0b261bea638842ccbeee0452809,1,11,11,22,11,2014-05-22 15:50:26,2014-05-22 02:54:55
f694951b3f1fe0b261bea638842ccbeee0452809...f37a2dab7fa0131fbb699c60b9d34a5be05672f8,1,2,2,4,2,2014-05-22 20:19:40,2014-05-05 20:49:41
f37a2dab7fa0131fbb699c60b9d34a5be05672f8...1d37239eaf18d46d76f510eec22fade8c250550e,1,15,47,62,16,2014-05-22 22:18:37,2014-05-22 07:18:44
1d37239eaf18d46d76f510eec22fade8c250550e...abaf9466acd56bd1c86023f06acebaab9f99491f,2,98,11,109,12,2014-05-23 00:49:31,2014-05-23 00:16:54
abaf9466acd56bd1c86023f06acebaab9f99491f...7e1950e9f19886dc4bae1556ea03528b96114b36,1,1,1,2,1,2014-05-23 01:00:46,2014-05-23 00:42:37
7e1950e9f19886dc4bae1556ea03528b96114b36...e9fad96c7c3c351d0e53bb7bff2244bc5ce2c5f3,1,4,1,5,2,2014-05-23 01:08:07,2014-05-23 01:08:07
e9fad96c7c3c351d0e53bb7bff2244bc5ce2c5f3...3f365f5238a7f57a6088619b4dbc44b1b9a9fde0,1,1,1,2,1,2014-05-23 05:31:46,2014-05-23 05:17:32
3f365f5238a7f57a6088619b4dbc44b1b9a9fde0...fa6e411da26824a5bae55f37ce7dbb859653276d,2,781,1373,2154,157,2014-05-23 05:50:34,2014-05-22 15:43:24
fa6e411da26824a5bae55f37ce7dbb859653276d...701ed5fdf6ccb2b0997b7b8a2594d297b315c65f,1,2,2,4,1,2014-05-23 18:28:53,2014-05-23 17:41:32
701ed5fdf6ccb2b0997b7b8a2594d297b315c65f...cee429f0aaebf32ef1c9aedd8447a48f163dd0a4,13,503,18,521,34,2014-05-23 21:40:51,2014-05-15 01:56:12
cee429f0aaebf32ef1c9aedd8447a48f163dd0a4...98b9d68ea3ecfb521e9279c9cbfe93f8ba7d626e,2,20,1,21,2,2014-05-23 21:45:20,2014-05-23 04:33:53
98b9d68ea3ecfb521e9279c9cbfe93f8ba7d626e...a96b6597708a6a66c76e398871c11b2dd654325d,1,66,0,66,1,2014-05-23 21:57:10,2014-05-23 21:55:50
a96b6597708a6a66c76e398871c11b2dd654325d...3ec4af941390800bd317579bd0ae34d3fc309569,1,4,0,4,1,2014-05-23 22:08:36,2014-05-23 22:07:25
3ec4af941390800bd317579bd0ae34d3fc309569...3fc95e06e78b3c0e3e124bc48963c9876f33a91f,1,0,1,1,1,2014-05-24 20:41:37,2014-05-24 19:19:16
3fc95e06e78b3c0e3e124bc48963c9876f33a91f...462eefc1e45236bf451fce851ec58169915b71cd,1,11,5,16,1,2014-05-27 21:06:17,2014-05-25 17:38:55
462eefc1e45236bf451fce851ec58169915b71cd...2859fc408e402213877a18c79e8d2c69b2bfc049,1,177,162,339,1,2014-05-27 21:43:37,2014-05-27 21:43:37
2859fc408e402213877a18c79e8d2c69b2bfc049...4eb9522f902f31a73b762ba0222cf3ad5d6c0b32,1,1,1,2,1,2014-05-28 06:46:05,2014-05-26 12:52:42
4eb9522f902f31a73b762ba0222cf3ad5d6c0b32...279f00b05b76e0aafe0774fe136c218b0c97418c,1,2,2,4,2,2014-05-28 21:04:22,2014-05-28 21:03:59
279f00b05b76e0aafe0774fe136c218b0c97418c...0dbec22bc7ab8eab5d84d0e0814344b7e1c0d690,1,1,1,2,1,2014-05-29 00:29:33,2014-05-29 00:19:17
0dbec22bc7ab8eab5d84d0e0814344b7e1c0d690...7a9d24551fb67d60503be7f31489c76f9d54ce95,1,14,6,20,8,2014-05-29 00:38:09,2014-05-25 07:53:28
7a9d24551fb67d60503be7f31489c76f9d54ce95...84218af4750d2dd5d50ec983970e2eb4fa44222a,1,3,3,6,1,2014-05-29 01:02:50,2014-05-29 00:54:21
84218af4750d2dd5d50ec983970e2eb4fa44222a...c4b04cec74a7b8a9f707ea532453da214b51e4d3,1,2,2,4,1,2014-05-29 19:51:48,2014-05-29 19:51:48
c4b04cec74a7b8a9f707ea532453da214b51e4d3...bea77e4b15dc415ac2961bdadbf3f1d40de0b7eb,1,2,2,4,2,2014-05-29 19:52:11,2014-05-23 10:51:19
bea77e4b15dc415ac2961bdadbf3f1d40de0b7eb...1fef5fe8230e8dc53f2c9f3f510a35cf18eeab43,2,124,8,132,6,2014-05-29 19:52:11,2014-05-23 11:01:44
1fef5fe8230e8dc53f2c9f3f510a35cf18eeab43...ad0c5107ba0d7dd90354607458a1fdc32ace6c79,1,5,5,10,4,2014-05-29 19:52:11,2014-05-23 11:09:15
ad0c5107ba0d7dd90354607458a1fdc32ace6c79...d414b787173643362c0c513a1929d8e715ca340e,2,81,4,85,5,2014-05-29 19:52:11,2014-05-23 11:11:28
d414b787173643362c0c513a1929d8e715ca340e...6e1546226797cf46ab4bcbe76a1fb7f4ccbc7f74,1,1,1,2,1,2014-05-29 19:52:12,2014-05-23 10:44:45
6e1546226797cf46ab4bcbe76a1fb7f4ccbc7f74...19af0397456eb8fc06dea47145fdee0e38e62f81,2,50,8,58,8,2014-05-29 19:52:12,2014-05-23 11:13:27
19af0397456eb8fc06dea47145fdee0e38e62f81...d71df9f83cd3882295ca01b1bb8ad7fb024165b6,2,21,2,23,2,2014-05-29 19:52:12,2014-05-23 10:45:03
d71df9f83cd3882295ca01b1bb8ad7fb024165b6...b87e5fc0920915991122ba5dac87b619847b3568,2,34,19,53,7,2014-05-29 19:52:12,2014-05-23 10:45:03
b87e5fc0920915991122ba5dac87b619847b3568...e3003d53421325b9de08e79f45608fdd174cdd83,1,6,6,12,3,2014-05-29 19:52:12,2014-05-23 10:45:03
e3003d53421325b9de08e79f45608fdd174cdd83...2ee29c5da81ffacdc1cabb438f5d125d5e116cb9,2,37,1,38,2,2014-05-29 19:52:12,2014-05-26 21:21:20
2ee29c5da81ffacdc1cabb438f5d125d5e116cb9...0c8a2cd2da3a4a9f5d2ee9c25ea8ed56d74a93ab,2,17,1,18,4,2014-05-29 19:53:06,2014-05-27 22:02:54
0c8a2cd2da3a4a9f5d2ee9c25ea8ed56d74a93ab...56c60218d1e70e3a47e37193a4a48714eeda7d44,2,9,13,22,9,2014-05-29 19:54:03,2014-05-27 22:11:45
56c60218d1e70e3a47e37193a4a48714eeda7d44...440be33d48e776beed9ec76c6d400450a61ceb1e,1,29,0,29,1,2014-05-29 19:54:44,2014-05-29 18:40:12
440be33d48e776beed9ec76c6d400450a61ceb1e...9f5c4370489043ed953c102340ce203a822c8b42,2,37,1,38,2,2014-05-30 05:04:07,2014-05-23 14:23:37
9f5c4370489043ed953c102340ce203a822c8b42...6341224d609f3819c6fb0b12282200c0e82e6906,1,10,3,13,2,2014-05-30 13:57:05,2014-05-20 18:29:58
6341224d609f3819c6fb0b12282200c0e82e6906...11170aee424699bd79bd85ee2b90facde35fce06,1,8,4,12,1,2014-05-30 17:32:29,2014-05-29 11:42:10
11170aee424699bd79bd85ee2b90facde35fce06...a87135bb43223391ee9ed88dd0c8f6b774b9770f,6,40,15,55,10,2014-05-30 18:45:47,2014-05-28 19:02:37
a87135bb43223391ee9ed88dd0c8f6b774b9770f...083f496d46415c01fec6dfa012da63235d0996e4,4,45,7,52,10,2014-05-30 18:45:57,2014-05-28 19:14:08
083f496d46415c01fec6dfa012da63235d0996e4...7eaaca8ef2b3db76b7c87e98d264d4b16d90a392,2,18,1,19,2,2014-05-30 18:53:50,2014-04-16 20:59:31
7eaaca8ef2b3db76b7c87e98d264d4b16d90a392...a594fa523f8dfa11f1be14130cf5761d4d6464dc,1,11,11,22,4,2014-05-30 19:13:05,2014-05-30 19:13:05
a594fa523f8dfa11f1be14130cf5761d4d6464dc...3252a50165e6b62506a2511cbe85805ec345d3dd,1,1,1,2,1,2014-05-30 20:06:14,2014-05-30 12:09:43
3252a50165e6b62506a2511cbe85805ec345d3dd...dd7b5083268ab845cb706a28a815e57fd3ca7566,1,7,2,9,1,2014-05-30 23:18:24,2014-05-28 18:02:52
dd7b5083268ab845cb706a28a815e57fd3ca7566...10406de450fb5f25e40a6d94b0442799ab2dca02,1,1,1,2,1,2014-05-31 00:27:42,2014-05-27 20:06:12
10406de450fb5f25e40a6d94b0442799ab2dca02...55818331a8f4c640974061b8e583e05a4a2c860d,1,1,1,2,1,2014-05-31 17:19:59,2014-05-31 17:13:41
55818331a8f4c640974061b8e583e05a4a2c860d...42a367df81e3f9280413f82d9b29b1b0a3a8e702,1,17,2,19,3,2014-05-31 21:33:03,2014-05-31 16:28:09
42a367df81e3f9280413f82d9b29b1b0a3a8e702...16aa3aff519e12ecbfcb685ca9524909ac269700,1,2,1,3,2,2014-05-31 21:37:54,2014-05-31 21:37:54
16aa3aff519e12ecbfcb685ca9524909ac269700...4a57b1501e9f6d89e9b4d5a3fb328d7bd3193a54,1,45,0,45,1,2014-05-31 22:24:56,2014-05-27 19:03:43
4a57b1501e9f6d89e9b4d5a3fb328d7bd3193a54...0dc35efd7ca212c3bdd1f2a3a0f3b68e1b4d2955,10,12,12,24,12,2014-05-31 22:43:26,2014-05-24 12:41:39
0dc35efd7ca212c3bdd1f2a3a0f3b68e1b4d2955...36a0e59decffea3b5f175ee19a0934fcd1c2f80f,1,7,5,12,2,2014-06-02 20:19:58,2014-06-02 17:07:22
36a0e59decffea3b5f175ee19a0934fcd1c2f80f...cbab51cac5d6460938e4dfe0035d624df2208d6c,1,58,10,68,3,2014-06-02 20:20:05,2014-06-02 18:17:51
cbab51cac5d6460938e4dfe0035d624df2208d6c...0eb2c2af82d09f8494e44952a0a385ce7584fb4c,448,42319,10132,52451,5829,2014-06-02 20:20:05,2014-06-02 17:08:30
0eb2c2af82d09f8494e44952a0a385ce7584fb4c...24c844df3b6d80103b01e4847b2d55b082757feb,2,18,0,18,2,2014-06-02 20:23:21,2014-05-30 14:03:21
24c844df3b6d80103b01e4847b2d55b082757feb...222d47370e585d9de9fa842310734ba1dd895fab,2,170,2,172,15,2014-06-02 20:40:12,2014-05-02 04:33:11
222d47370e585d9de9fa842310734ba1dd895fab...f165e08b1696973a24b0ea57a197dbd0861b95dd,1,2,2,4,1,2014-06-02 21:42:11,2014-05-31 10:10:07
f165e08b1696973a24b0ea57a197dbd0861b95dd...cc495e136df4fbc0d2ec4e083c010864f7dc58b4,1,1,1,2,1,2014-06-03 21:32:33,2014-06-03 13:50:16
cc495e136df4fbc0d2ec4e083c010864f7dc58b4...575b197c27f0010eaf0be3e411e39566018f91cf,1,1,1,2,1,2014-06-03 22:39:49,2014-06-03 13:45:10
575b197c27f0010eaf0be3e411e39566018f91cf...847b9705cbed7b2bd9511d584238b8fc3bc7a159,1,1,1,2,1,2014-06-03 22:58:35,2014-06-03 09:45:49
847b9705cbed7b2bd9511d584238b8fc3bc7a159...011914121c27b5d8f973db6caac0b202e3719614,1,6,4,10,2,2014-06-03 23:20:59,2014-06-03 11:07:51
011914121c27b5d8f973db6caac0b202e3719614...b12bd05057942b8feb8794e16dc0507fc64fb2c5,1,1,1,2,1,2014-06-03 23:25:14,2014-06-01 12:21:55
b12bd05057942b8feb8794e16dc0507fc64fb2c5...46a53b22d0e0368ba1ab4f67d023c02022bb4121,1,1,1,2,1,2014-06-03 23:27:56,2014-05-31 21:55:33
46a53b22d0e0368ba1ab4f67d023c02022bb4121...b5d2a2a8135bf6c31a3faebfb422d28c177da9da,1,1,1,2,1,2014-06-03 23:30:11,2014-05-26 13:35:09
b5d2a2a8135bf6c31a3faebfb422d28c177da9da...8c02a49bb412d76d89f8657fb2be27f1cd18533f,1,1,1,2,1,2014-06-03 23:37:52,2014-05-23 18:29:16
8c02a49bb412d76d89f8657fb2be27f1cd18533f...c054288c9722875e3595e6e6162193e0fb67a251,2,9,4,13,3,2014-06-04 00:15:58,2014-02-15 06:04:40
c054288c9722875e3595e6e6162193e0fb67a251...d3c50c845671f0f8bcc3f7842df9e2fb1d1b1c40,2,21,0,21,2,2014-06-04 00:16:18,2014-02-15 06:04:13
d3c50c845671f0f8bcc3f7842df9e2fb1d1b1c40...45fed49abfb5144e51ecbe44b2c471ec19d7e0af,1,2,0,2,1,2014-06-04 00:40:33,2014-06-01 21:19:54
45fed49abfb5144e51ecbe44b2c471ec19d7e0af...36b2bba05f6147ca71d1f8d2059682dde1bd0a6d,1,5,0,5,1,2014-06-04 00:56:37,2014-05-24 22:02:17
36b2bba05f6147ca71d1f8d2059682dde1bd0a6d...7c011e79d8b3d805755181ace472883800234bf4,2,6,20,26,7,2014-06-04 18:45:17,2014-05-30 05:16:26
7c011e79d8b3d805755181ace472883800234bf4...5044238561204896be7f0546763a16a0c9f2955a,1,31,20,51,11,2014-06-04 19:19:34,2014-06-04 19:14:44
5044238561204896be7f0546763a16a0c9f2955a...aa268560064e5875bd471da3f7d1ebc2f9e6b3b7,21,89,89,178,89,2014-06-04 19:22:10,2014-05-22 07:55:10
aa268560064e5875bd471da3f7d1ebc2f9e6b3b7...a5df219031e4fb0a41e8fc0eaeaba9f8511d1a9c,1,2,1,3,1,2014-06-04 21:31:43,2014-06-03 21:25:18
a5df219031e4fb0a41e8fc0eaeaba9f8511d1a9c...f7a0a386ee6e7f473bb61ae15ba8b974340f40d5,1,5,9,14,8,2014-06-04 22:47:52,2014-05-23 06:57:44
f7a0a386ee6e7f473bb61ae15ba8b974340f40d5...6fb121e64c6509e968e0c2aa7fce8a507fe1d5db,1,10,14,24,2,2014-06-04 22:47:52,2014-05-22 00:37:59
6fb121e64c6509e968e0c2aa7fce8a507fe1d5db...ff0369883e73fa0f937d2bbb3c86e9267103d7f6,1,8,18,26,12,2014-06-04 22:47:52,2014-05-23 19:11:36
ff0369883e73fa0f937d2bbb3c86e9267103d7f6...1d90744f4095ee202616a30f5d6f060fc8e74b20,1,1,7,8,2,2014-06-05 18:35:28,2014-06-05 14:09:47
1d90744f4095ee202616a30f5d6f060fc8e74b20...1ec6d551bd80784f22691c6989aac1722b98cd20,1,1,1,2,1,2014-06-05 20:47:32,2014-06-05 00:28:59
1ec6d551bd80784f22691c6989aac1722b98cd20...ee8fae8c0f1680428b0eb84d1306b55bebf44074,2,2,2,4,2,2014-06-05 21:14:48,2014-06-05 21:14:48
ee8fae8c0f1680428b0eb84d1306b55bebf44074...c97c5cec2ff566d775c0f4996fa6647711c6fbab,1,2,2,4,1,2014-06-05 21:45:26,2014-06-05 21:45:26
c97c5cec2ff566d775c0f4996fa6647711c6fbab...ff791c9330128863caca404e0bf7753ba48878f8,1,14,0,14,1,2014-06-06 00:12:26,2014-06-04 01:30:48
ff791c9330128863caca404e0bf7753ba48878f8...808dab83e577c632a2c7be3951372480d3707352,1,1,1,2,1,2014-06-06 15:12:33,2014-06-06 14:43:17
808dab83e577c632a2c7be3951372480d3707352...ebf59b4206afd801e3effd440e8d930063f1f8f3,1,172,0,172,1,2014-06-06 19:22:50,2014-06-06 19:22:50
ebf59b4206afd801e3effd440e8d930063f1f8f3...560f00860dc229e6286b9fa40417162df4df4232,1,4,1,5,2,2014-06-06 20:27:23,2014-06-06 09:43:02
560f00860dc229e6286b9fa40417162df4df4232...751ebc17f7fc7be26613db0a3cdee05fc401318b,1,8,4,12,1,2014-06-07 00:06:38,2014-06-06 19:37:28
751ebc17f7fc7be26613db0a3cdee05fc401318b...4124a653d96836d467e893bb15dd368d042c1d63,1,273,35,308,23,2014-06-08 18:33:57,2014-06-08 18:29:31
4124a653d96836d467e893bb15dd368d042c1d63...1064686599c99291b1d03f55bb57b5dc19e5d612,1,2,2,4,2,2014-06-09 02:12:42,2014-06-09 02:01:06
1064686599c99291b1d03f55bb57b5dc19e5d612...3df2ccae0f59da4ef7ff7ab03c086a69acb66555,1,0,3,3,1,2014-06-09 04:00:18,2014-06-08 06:05:35
3df2ccae0f59da4ef7ff7ab03c086a69acb66555...63b306080819e84a1e4b952492010dddfe1b5599,1,1,1,2,1,2014-06-09 20:39:55,2014-03-30 21:23:57
63b306080819e84a1e4b952492010dddfe1b5599...e2f339e0448c97c5d0073601b35da2ea42be085b,1,1,1,2,1,2014-06-09 21:01:13,2014-01-14 14:42:26
e2f339e0448c97c5d0073601b35da2ea42be085b...a958bd88a453bd960b7aa615304a8889cdb51664,1,1,0,1,1,2014-06-09 21:30:36,2014-01-14 14:38:45
a958bd88a453bd960b7aa615304a8889cdb51664...8fddaa23c8a450345bf212525416ad7470ddeca6,1,1,0,1,1,2014-06-09 22:50:18,2014-06-05 07:13:40
8fddaa23c8a450345bf212525416ad7470ddeca6...d9b90d7c10a8e1bacbee0aeb7e86093cca9e8ed2,9,128,32,160,24,2014-06-10 01:48:07,2014-06-09 18:51:35
d9b90d7c10a8e1bacbee0aeb7e86093cca9e8ed2...63ea0c1aac00be994e961caef06dddef8e5fb5f9,1,1,0,1,1,2014-06-10 02:53:05,2014-04-10 00:58:42
63ea0c1aac00be994e961caef06dddef8e5fb5f9...e4419daf705d6d2d116ced573f72c24b5c53be1f,2,37,1,38,3,2014-06-10 04:20:01,2014-01-15 21:57:50
e4419daf705d6d2d116ced573f72c24b5c53be1f...c6088da00fa572af76eed585e5fb5eca3d407a41,1,3,0,3,1,2014-06-10 04:44:48,2014-06-10 03:41:50
c6088da00fa572af76eed585e5fb5eca3d407a41...56084b8718bd0c591634de89e1542db97c962331,1,1,0,1,1,2014-06-10 07:36:42,2014-02-13 22:04:44
56084b8718bd0c591634de89e1542db97c962331...650f14eb283f32cba93e8be14b2b0313550a4531,1,14,0,14,1,2014-06-10 07:52:15,2014-06-04 00:36:04
650f14eb283f32cba93e8be14b2b0313550a4531...ac3f0d0b5873fbf755d530930e632bbada0b4559,1,3,3,6,3,2014-06-10 07:57:21,2014-05-24 06:56:17
ac3f0d0b5873fbf755d530930e632bbada0b4559...b6cb045627e4145bd153811ec2839d90d13f5d07,1,1,1,2,1,2014-06-10 08:07:19,2014-06-04 21:55:29
b6cb045627e4145bd153811ec2839d90d13f5d07...b21122002a2b8aeeecf112add51910a3e7cf6bbb,1,2,1,3,1,2014-06-10 08:34:41,2014-06-10 08:34:41
b21122002a2b8aeeecf112add51910a3e7cf6bbb...0675938931bee8621a18b2fc4c36ef0bb873db58,1,1,1,2,1,2014-06-10 08:36:46,2014-06-10 08:36:46
0675938931bee8621a18b2fc4c36ef0bb873db58...73e3e8551c2ab7e5b4a3b71cbaad9f10267df61b,1,0,1,1,1,2014-06-10 08:46:12,2014-04-15 16:39:02
73e3e8551c2ab7e5b4a3b71cbaad9f10267df61b...2cde927e58c8d1588569d94a797e43cdfbcedaf9,2,30,3,33,6,2014-06-10 11:08:55,2013-10-15 03:34:16
2cde927e58c8d1588569d94a797e43cdfbcedaf9...d8e4093b5a75de2aa8d0ffb0aa5b2cdc252b8d2f,1,1,1,2,1,2014-06-10 18:47:56,2014-06-10 13:40:25
d8e4093b5a75de2aa8d0ffb0aa5b2cdc252b8d2f...94bcc03f3e26c850d83870de551a1719052dc99f,1,1,1,2,1,2014-06-10 20:10:21,2014-06-10 20:06:48
94bcc03f3e26c850d83870de551a1719052dc99f...adcc5a00bf582d2b291c18e99093bb0854f7217c,3,115,4,119,15,2014-06-11 03:06:31,2014-06-03 04:58:04
adcc5a00bf582d2b291c18e99093bb0854f7217c...2d5a84963e0e63e0b8c2195f1fc144eee89b0eb4,1,1,1,2,1,2014-06-11 21:51:37,2014-06-11 18:47:39
2d5a84963e0e63e0b8c2195f1fc144eee89b0eb4...b32d0f864928a04cf9d3cd0bb0ba3336d7da2bb6,1,1,1,2,1,2014-06-12 04:09:56,2014-06-12 02:26:08
b32d0f864928a04cf9d3cd0bb0ba3336d7da2bb6...dd1d189ee785a37fe1d9bddf3818152db6aa210a,2,29,9,38,4,2014-06-12 17:28:17,2014-06-09 13:54:09
dd1d189ee785a37fe1d9bddf3818152db6aa210a...abf31ae6247d9e698eedd2ae2fdc8baf1d2445d0,1,1,1,2,1,2014-06-12 18:24:03,2014-06-12 18:05:40
abf31ae6247d9e698eedd2ae2fdc8baf1d2445d0...3de07aa2eb719a4316ddebc090602a6c74824d95,1,1,1,2,1,2014-06-12 21:38:52,2014-06-12 21:38:12
3de07aa2eb719a4316ddebc090602a6c74824d95...545d22b47006c1efa420ba551d4850affdba8016,2,4,3,7,3,2014-06-13 00:23:09,2014-05-17 16:44:50
545d22b47006c1efa420ba551d4850affdba8016...a8c7cb81c9e67b52d5c649bf3d8cec06c5976852,2,200,15,215,17,2014-06-13 01:16:02,2014-05-07 05:03:28
a8c7cb81c9e67b52d5c649bf3d8cec06c5976852...e53554a0e238cba7a150fd7ccf61e5e4cc0c0426,2,5,13,18,5,2014-06-13 01:16:16,2014-05-01 00:56:50
e53554a0e238cba7a150fd7ccf61e5e4cc0c0426...e63d4253d06ed7d344358e2c0b03311c548bc978,1,2,5,7,2,2014-06-13 01:16:36,2014-05-01 01:01:47
e63d4253d06ed7d344358e2c0b03311c548bc978...5b8e7ecfeb722cfc7a5d92f05b57950a2aa6158b,2,10,16,26,10,2014-06-13 01:17:03,2014-05-01 01:13:39
5b8e7ecfeb722cfc7a5d92f05b57950a2aa6158b...26d91b653ac224d9d4166fea855346f5e4c4a7b4,3,81,16,97,6,2014-06-13 01:18:24,2014-05-07 06:23:15
26d91b653ac224d9d4166fea855346f5e4c4a7b4...1be9bb9d3527e0758350c4f7417a4228d8571440,3,85,29,114,10,2014-06-13 01:18:36,2014-05-27 19:52:38
1be9bb9d3527e0758350c4f7417a4228d8571440...0ebab08e66f953397b044be9533d764961fbc9ea,2,12,5,17,5,2014-06-13 01:46:39,2014-06-13 01:46:39
0ebab08e66f953397b044be9533d764961fbc9ea...398053c56352487751d14ea41b3b892960397019,2,57,3,60,5,2014-06-13 13:28:47,2014-06-13 08:24:25
398053c56352487751d14ea41b3b892960397019...600a41a7b65f2dd139664fca6331c40451db75be,2,12,1,13,4,2014-06-13 16:05:19,2014-06-11 14:11:48
600a41a7b65f2dd139664fca6331c40451db75be...9971fbb3e06b450873ad0cb1cb8e24cb4d39d4b0,1,1,1,2,1,2014-06-13 17:56:01,2014-06-13 17:50:19
9971fbb3e06b450873ad0cb1cb8e24cb4d39d4b0...8c6a8171f9bdaa5cdabc0cc3f7d3ce10af7b434d,5,34,50,84,24,2014-06-13 18:35:26,2014-06-04 13:38:31
8c6a8171f9bdaa5cdabc0cc3f7d3ce10af7b434d...55991e33af6fece07ea347a059da061b76fc95f5,1,4,2,6,4,2014-06-13 18:35:26,2014-06-04 14:16:15
55991e33af6fece07ea347a059da061b76fc95f5...04468db44185e3d7968abdb23d77bf623cb5021b,1,8,3,11,3,2014-06-13 18:35:26,2014-06-04 14:20:19
04468db44185e3d7968abdb23d77bf623cb5021b...ea9a130a43d165f4f4389d01ac409dd3047efcb4,1,6,5,11,6,2014-06-13 18:35:26,2014-06-04 15:16:04
ea9a130a43d165f4f4389d01ac409dd3047efcb4...a196c8bca82a28c08896d31f1863cf4ecd11401c,1,4,1,5,1,2014-06-13 18:35:26,2014-06-04 16:07:43
a196c8bca82a28c08896d31f1863cf4ecd11401c...e35abc9d2fac0471cbe8089dc0e33a72b8029ada,1,4,2,6,1,2014-06-13 18:35:27,2014-06-04 15:23:37
e35abc9d2fac0471cbe8089dc0e33a72b8029ada...31faeaa7293716251ed437fa54432bb89d9d48de,2,21,5,26,5,2014-06-13 18:35:27,2014-06-05 12:52:09
31faeaa7293716251ed437fa54432bb89d9d48de...b68ac4cb4c172447ba0022fe6e7ce0ca4cb9407e,1,1,1,2,1,2014-06-13 18:35:27,2014-06-05 12:53:34
b68ac4cb4c172447ba0022fe6e7ce0ca4cb9407e...ea230ea91df215de8431667dae22da95a60b6120,1,1,1,2,1,2014-06-13 18:35:27,2014-06-05 12:55:38
ea230ea91df215de8431667dae22da95a60b6120...92489886dcce3bca00fe827aeb0817297b8a175c,1,3,11,14,4,2014-06-13 18:35:27,2014-06-05 13:10:24
92489886dcce3bca00fe827aeb0817297b8a175c...3cbc8e5563d0f272838a65636989544519873492,1,6,0,6,1,2014-06-13 18:35:27,2014-06-05 13:10:46
3cbc8e5563d0f272838a65636989544519873492...41d2eba5f8322903247280000bfc5e5e8a1c1a3e,1,5,3,8,5,2014-06-13 18:35:27,2014-06-05 13:15:17
41d2eba5f8322903247280000bfc5e5e8a1c1a3e...fd5f3896764107635310ae52df1d80a6e08fba31,1,13,8,21,1,2014-06-13 18:35:27,2014-06-05 13:36:20
fd5f3896764107635310ae52df1d80a6e08fba31...35358fddc10652ef78c72cba7b7c2d5a810631d5,1,20,12,32,1,2014-06-13 18:35:27,2014-06-05 18:51:15
35358fddc10652ef78c72cba7b7c2d5a810631d5...65a44dd49cf594008ce4d21de4b57abeab7fe52c,1,16,0,16,1,2014-06-13 18:35:27,2014-06-12 23:53:33
65a44dd49cf594008ce4d21de4b57abeab7fe52c...16dfcb61aed28cdef3bfbed540e2deea6d9e9632,2,29,1,30,2,2014-06-13 20:41:18,2014-06-07 18:04:04
16dfcb61aed28cdef3bfbed540e2deea6d9e9632...993ac8a59b76af7f3e594b2bff72713d3602ca5c,1,184,0,184,1,2014-06-13 22:04:44,2014-06-13 22:04:44
993ac8a59b76af7f3e594b2bff72713d3602ca5c...20c3c9e25f6417773333727549ed2ca2d3505b44,1,5,5,10,5,2014-06-13 23:23:42,2014-06-13 23:23:42
20c3c9e25f6417773333727549ed2ca2d3505b44...d7bfda61bff49754f3b826a540a1235ceb9650cc,1,1,1,2,1,2014-06-14 16:25:54,2013-09-23 17:53:28
d7bfda61bff49754f3b826a540a1235ceb9650cc...68dcb35ff92a144a96556827622272d77c794dce,1,1,1,2,1,2014-06-16 15:45:29,2014-06-16 15:43:32
68dcb35ff92a144a96556827622272d77c794dce...1e4f5ccd3cc7be0beb10144d31501bf047ad8e9e,1,14,0,14,1,2014-06-16 17:45:21,2014-06-16 17:45:21
1e4f5ccd3cc7be0beb10144d31501bf047ad8e9e...6addac397d82119bd9caaf35c762f908c6a71dce,1,0,3,3,1,2014-06-16 17:47:09,2014-06-16 17:47:09
6addac397d82119bd9caaf35c762f908c6a71dce...d50829bcf74318a02bbfdbd3172a2bfb95b9283d,1,26,38,64,2,2014-06-16 20:26:12,2014-05-25 01:34:26
d50829bcf74318a02bbfdbd3172a2bfb95b9283d...928c7ecf39e9c40c8fa587ef5e4deb6bcb2df7ce,1,1,1,2,1,2014-06-16 20:44:07,2014-06-13 08:24:04
928c7ecf39e9c40c8fa587ef5e4deb6bcb2df7ce...8b0258d878cac20cd25c0958fd6e136a08b97df6,2,86,5,91,5,2014-06-16 23:15:36,2014-06-07 07:44:46
8b0258d878cac20cd25c0958fd6e136a08b97df6...2f0a4488731fdb0e8217325dbb52a576defd09bd,6,90,8,98,12,2014-06-17 00:43:16,2014-06-08 18:31:17
2f0a4488731fdb0e8217325dbb52a576defd09bd...307e72efab294401d8a7a05d2ef05cb2ad53dd5c,1,1,1,2,1,2014-06-17 21:42:34,2014-06-17 21:40:48
307e72efab294401d8a7a05d2ef05cb2ad53dd5c...28e6500a5932062208f18831ee2e5f576dbb9363,1,1,1,2,1,2014-06-20 13:35:57,2014-06-20 12:30:21
28e6500a5932062208f18831ee2e5f576dbb9363...ebff4c1fd23eaf5b784f842535c0ff508e58091b,1,1,1,2,1,2014-06-20 13:57:24,2014-06-20 11:17:36
ebff4c1fd23eaf5b784f842535c0ff508e58091b...dafb8a3cd12e7c3247838f536c25eb796331658d,9,25,24,49,18,2014-06-20 13:58:02,2013-11-13 00:46:11
dafb8a3cd12e7c3247838f536c25eb796331658d...e57ad6a109c4e3a084eb40d026d84aa753dc4025,1,1,1,2,1,2014-06-20 16:00:59,2014-06-20 16:00:59
e57ad6a109c4e3a084eb40d026d84aa753dc4025...b775e2bca1093e9df62a269b5bda968555ea0ded,1,1,1,2,1,2014-06-23 01:28:22,2014-06-22 22:34:31
b775e2bca1093e9df62a269b5bda968555ea0ded...0885446b82de7f56501268e121bc5995304e5115,1,1,1,2,1,2014-06-23 20:13:53,2014-06-23 12:53:48
0885446b82de7f56501268e121bc5995304e5115...05ec6cc5c9cc754cd5eaf932ee536d4192be27a1,1,1,1,2,1,2014-06-23 20:23:52,2014-06-22 13:37:02
05ec6cc5c9cc754cd5eaf932ee536d4192be27a1...ea820b53e16fac1490ec337523a85b2afe650514,1,2,2,4,2,2014-06-23 20:35:03,2014-06-16 21:07:30
ea820b53e16fac1490ec337523a85b2afe650514...e8e07502776e48bf48b83a836f7422d164cbb1d7,1,2,2,4,2,2014-06-23 21:38:15,2014-06-23 21:38:15
e8e07502776e48bf48b83a836f7422d164cbb1d7...43ff573bc8143bdf6dc7ecc89d910663226b55e1,1,1,1,2,1,2014-06-23 22:19:17,2014-06-23 22:19:17
43ff573bc8143bdf6dc7ecc89d910663226b55e1...b1a6baac2de84a1ecdc000085e8bbd016eb5c100,1,1,2,3,1,2014-06-24 00:19:41,2014-06-24 00:19:41
b1a6baac2de84a1ecdc000085e8bbd016eb5c100...ceaea861ebec957c99bbca6fd88ed33fbc15afbf,1,4,0,4,1,2014-06-24 04:58:38,2014-06-24 04:58:38
ceaea861ebec957c99bbca6fd88ed33fbc15afbf...189cd064feeb710fe54ee2ca83449b3eaf82b403,2,11,2,13,4,2014-06-24 06:49:56,2014-06-24 06:23:56
189cd064feeb710fe54ee2ca83449b3eaf82b403...3ee65730639fc61d76e1055a6ca74e35eb48b838,1,3,5,8,2,2014-06-24 07:46:30,2014-06-19 02:55:15
3ee65730639fc61d76e1055a6ca74e35eb48b838...6737924210570e8369ab72415e3098c6df4d3f6b,1,3,5,8,2,2014-06-24 07:46:30,2014-06-19 02:57:25
6737924210570e8369ab72415e3098c6df4d3f6b...deb008d638ae0bd5b79978c4988f36aec924b754,1,11,0,11,2,2014-06-24 07:58:05,2014-06-17 12:49:53
deb008d638ae0bd5b79978c4988f36aec924b754...1f6a5a1a9255a2db19a1ea4c04cdbcdbb2850b6c,5,82,22,104,27,2014-06-24 12:35:00,2014-06-22 19:37:41
1f6a5a1a9255a2db19a1ea4c04cdbcdbb2850b6c...cb43711f8fed04d011ac8c2fd2f86800e5930fda,1,29,0,29,1,2014-06-25 21:32:46,2014-06-24 10:47:11
cb43711f8fed04d011ac8c2fd2f86800e5930fda...7f63e811ac66ea3e880a170c9b20db4b8c9f9291,1,60,0,60,1,2014-06-25 21:32:46,2014-06-24 11:08:45
7f63e811ac66ea3e880a170c9b20db4b8c9f9291...462dbb2016a218d84760b6da171f1b15c9e416c3,2,22,1,23,4,2014-06-25 21:34:04,2014-06-24 10:47:11
462dbb2016a218d84760b6da171f1b15c9e416c3...768a1912cf82990bef6b66770749d8be8789dbf5,1,180,8,188,5,2014-06-25 21:34:04,2014-06-24 12:58:49
768a1912cf82990bef6b66770749d8be8789dbf5...91754a76e0ef9a7456a5b9819d1c5807c0a575bb,2,36,20,56,6,2014-06-25 21:36:44,2014-06-24 11:25:25
91754a76e0ef9a7456a5b9819d1c5807c0a575bb...d9763f1bd355190b9d4e5723e4632cbc232f0543,2,11,6,17,3,2014-06-25 21:38:18,2014-06-24 16:33:51
d9763f1bd355190b9d4e5723e4632cbc232f0543...85f8b65442a51c24e8ccac54da37f3fc949f3737,1,2,2,4,2,2014-06-25 21:49:00,2014-06-20 09:15:14
85f8b65442a51c24e8ccac54da37f3fc949f3737...1296e7a72e3ff984dccf23e8de527daf7b3633f1,1,1,1,2,1,2014-06-26 19:07:33,2014-06-26 17:20:19
1296e7a72e3ff984dccf23e8de527daf7b3633f1...1054dce4a9eaf4ad2ca3364179b75a465db3ec26,1,1,1,2,1,2014-06-26 19:19:01,2014-06-26 15:11:52
1054dce4a9eaf4ad2ca3364179b75a465db3ec26...c4b654b03c9f3b0d2fb5625b96539145a6fd2cdd,1,1,1,2,1,2014-06-26 19:20:57,2014-06-24 10:06:22
c4b654b03c9f3b0d2fb5625b96539145a6fd2cdd...a1c19c457b11cd1727ca5cd56d0c403d4246d444,1,1,1,2,1,2014-06-26 19:32:01,2014-06-26 19:31:02
a1c19c457b11cd1727ca5cd56d0c403d4246d444...e970df8554877f0d7aa87a8ee5cdd647f6f4b771,1,7,11,18,1,2014-06-26 19:36:39,2014-06-26 05:21:44
e970df8554877f0d7aa87a8ee5cdd647f6f4b771...bdfc9c02d021e08babfbc966a007c71b4946d69d,10,121,62,183,35,2014-06-26 19:52:04,2014-06-23 22:07:30
bdfc9c02d021e08babfbc966a007c71b4946d69d...26c20b75c6214f5e5090ae2f849c20662232e318,1,38,26,64,2,2014-06-26 20:48:10,2014-06-26 20:48:10
26c20b75c6214f5e5090ae2f849c20662232e318...b28b5caab1529b3970f10f0a4de43c0c975e3886,2,24,1,25,2,2014-06-27 13:23:42,2014-01-20 13:21:31
b28b5caab1529b3970f10f0a4de43c0c975e3886...19b6b3433ae9f8523cbc72ae97dbcf0c06960148,6,51,9,60,11,2014-06-27 16:11:11,2014-06-26 15:38:04
19b6b3433ae9f8523cbc72ae97dbcf0c06960148...02354201963dc455c6435446cdd321b7517732a8,6,6,6,12,6,2014-06-27 23:53:13,2014-06-27 21:24:04
02354201963dc455c6435446cdd321b7517732a8...7e71acd1781ed44a7306d94338388c90f4420a24,2,20,1,21,2,2014-06-28 00:10:10,2014-06-27 20:43:53
7e71acd1781ed44a7306d94338388c90f4420a24...d3c191ea637cc3ad56cd393ba1897f9d260709e9,1,1,1,2,1,2014-06-28 22:14:45,2014-06-28 16:52:31
d3c191ea637cc3ad56cd393ba1897f9d260709e9...a4904c0f83838222b98a875c56779a7f1a4a650a,1,1,1,2,1,2014-06-29 00:32:32,2014-04-04 08:36:24
a4904c0f83838222b98a875c56779a7f1a4a650a...bc595509ddfc6ab20165456bca24a9d8f006a25a,1,21,0,21,1,2014-06-29 00:32:32,2014-06-28 20:52:21
bc595509ddfc6ab20165456bca24a9d8f006a25a...a87ffe37bfbbe22b67a6f8a4dfaa3211b9340d51,1,1,1,2,1,2014-06-29 02:41:32,2014-06-28 12:47:48
a87ffe37bfbbe22b67a6f8a4dfaa3211b9340d51...384c24808fe465fd5867ee89a91bab2dbbd05ba7,1,1,1,2,1,2014-06-29 03:04:05,2014-06-28 09:51:53
384c24808fe465fd5867ee89a91bab2dbbd05ba7...075ba901f62da43a0e87a95945e4e91e9f721e81,1,1,1,2,1,2014-06-29 04:59:16,2014-06-29 04:59:16
075ba901f62da43a0e87a95945e4e91e9f721e81...ffdde26981739f28eb50f55bce4c85d71f72956c,1,1,1,2,1,2014-06-29 16:42:14,2014-06-29 10:31:29
ffdde26981739f28eb50f55bce4c85d71f72956c...b59b04f98a0b59eead53f6a53391ce1bbcbe9b57,2,19,6,25,4,2014-06-30 09:41:43,2013-11-21 08:20:54
b59b04f98a0b59eead53f6a53391ce1bbcbe9b57...31ae3e71647eadbbe1df40f9dedb55e1e0715f98,2,28,2,30,4,2014-06-30 15:09:01,2014-06-27 11:51:42
31ae3e71647eadbbe1df40f9dedb55e1e0715f98...36625de0d3ebc1fc091af474d942c6ce16b0a1c0,1,3,3,6,2,2014-06-30 15:48:25,2014-06-30 15:48:25
36625de0d3ebc1fc091af474d942c6ce16b0a1c0...2df721965bccdfbbaeed5d5624892accf698e768,1,1,1,2,1,2014-06-30 15:57:08,2014-06-30 15:57:08
2df721965bccdfbbaeed5d5624892accf698e768...528be29d1662122a34e204dd607e1c0bd9c16bbc,2,32,0,32,2,2014-06-30 16:25:23,2014-06-08 17:15:25
528be29d1662122a34e204dd607e1c0bd9c16bbc...48fa3aadd546036c7e69f71046f659ab1de244c6,2,83,0,83,3,2014-06-30 16:25:23,2014-06-08 21:36:52
48fa3aadd546036c7e69f71046f659ab1de244c6...6081f20769e64a800ee8075c168412b21f026d99,2,22,0,22,3,2014-06-30 16:25:23,2014-06-08 22:03:50
6081f20769e64a800ee8075c168412b21f026d99...db713a1c1b2cf1a9f5f9b52a0e2481be3b0cf1be,4,146,204,350,58,2014-06-30 16:25:23,2014-06-26 22:24:10
db713a1c1b2cf1a9f5f9b52a0e2481be3b0cf1be...77ada4c82d6b8fc6d977c26f3cdb48c2f5fbe5a5,3,75,0,75,4,2014-06-30 16:25:24,2014-06-26 22:25:11
77ada4c82d6b8fc6d977c26f3cdb48c2f5fbe5a5...2e6144670d5bba6ac8ad000056c6c4cf349ec151,1,74,44,118,35,2014-06-30 16:52:32,2014-06-30 16:52:32
2e6144670d5bba6ac8ad000056c6c4cf349ec151...c7c363cf8d4533f94c5534c83dd1c7135633ddd8,2,17,1,18,2,2014-06-30 23:06:12,2014-06-25 18:34:55
c7c363cf8d4533f94c5534c83dd1c7135633ddd8...b3b5015cb7919708ce179dc3d6f0d7d7f43ef621,1,232,0,232,1,2014-06-30 23:59:25,2014-06-30 23:32:36
b3b5015cb7919708ce179dc3d6f0d7d7f43ef621...2c7d0857ccbdb3a0967acc20e4346a7e1a6be792,2,14,0,14,2,2014-07-01 15:40:46,2014-03-06 11:33:07
2c7d0857ccbdb3a0967acc20e4346a7e1a6be792...8252b8be946367f1759065adf528adc908da00a2,2,178,19,197,17,2014-07-01 21:21:57,2014-06-19 02:25:20
8252b8be946367f1759065adf528adc908da00a2...ca752790d95480b7ad1125a7ddb52b726b987a24,5,151,20,171,30,2014-07-01 22:03:06,2014-06-05 22:56:24
ca752790d95480b7ad1125a7ddb52b726b987a24...e18db78d7793b1e94d9b19ac15b89d39f21a5729,2,45,3,48,4,2014-07-01 22:28:22,2014-06-11 07:11:26
e18db78d7793b1e94d9b19ac15b89d39f21a5729...d2963ad265a1d9023a08f68305c3d7f6dd066358,1,2,11,13,5,2014-07-01 22:41:13,2014-06-24 14:52:51
d2963ad265a1d9023a08f68305c3d7f6dd066358...85b77314ed8e4b45d7365a24a47349ed94672aeb,2,53,0,53,2,2014-07-01 22:52:49,2014-05-26 08:09:46
85b77314ed8e4b45d7365a24a47349ed94672aeb...b0ca5195e88a42611e933c49d7d2768b181b2d1b,1,1,8,9,1,2014-07-01 22:55:34,2014-06-15 06:46:31
b0ca5195e88a42611e933c49d7d2768b181b2d1b...f07af61f050fcdcece15c13ee8c6a6d32f86d3a1,2,33,4,37,6,2014-07-01 23:32:27,2014-06-10 05:00:34
f07af61f050fcdcece15c13ee8c6a6d32f86d3a1...894c7da2f3c88969404bd7178daec827093e2f90,1,5,2,7,2,2014-07-02 20:54:12,2014-07-02 17:31:01
894c7da2f3c88969404bd7178daec827093e2f90...81214498ab061c3909fd3204e100f28f4ef82baf,1,0,7,7,1,2014-07-02 21:59:16,2014-06-25 01:57:06
81214498ab061c3909fd3204e100f28f4ef82baf...c90cefe16142d973a123e945fc9058e8a874c357,3,66,13,79,10,2014-07-02 22:07:37,2014-07-02 00:24:58
c90cefe16142d973a123e945fc9058e8a874c357...63e89524f06c6fa90af8d3fa9c84f87efbfe32e0,10,55,38,93,37,2014-07-02 22:44:12,2014-07-02 21:09:10
63e89524f06c6fa90af8d3fa9c84f87efbfe32e0...39915836e0604723c5edb7d915d3f41c0abda65e,1,94,93,187,5,2014-07-03 06:05:07,2014-07-03 06:01:53
39915836e0604723c5edb7d915d3f41c0abda65e...2f34950176f6e43ed95ce850fad0fcd2fd686e9e,1,1,1,2,1,2014-07-03 08:45:03,2014-07-03 08:45:03
2f34950176f6e43ed95ce850fad0fcd2fd686e9e...543cf1803b2a9a89b55115ad1b665bbc38feb1db,1,1,1,2,1,2014-07-03 08:50:41,2014-07-02 14:49:36
543cf1803b2a9a89b55115ad1b665bbc38feb1db...f66d6541b71740980867342cea1d95cacb8a94cd,1,3,1,4,1,2014-07-03 09:12:56,2014-06-28 15:05:06
f66d6541b71740980867342cea1d95cacb8a94cd...7e77521a7802176f5564be86ad5bab7bd1be26d8,1,13,8,21,3,2014-07-03 09:13:21,2014-07-03 09:13:21
7e77521a7802176f5564be86ad5bab7bd1be26d8...be41adc99fd2d4a889a8055f568d09ae59bd440f,1,10,16,26,8,2014-07-03 11:01:20,2014-06-28 01:18:07
be41adc99fd2d4a889a8055f568d09ae59bd440f...c0e652722680d188252619e95c439a8fb71c8b4d,1,13,14,27,4,2014-07-03 11:13:12,2014-07-03 11:13:12
c0e652722680d188252619e95c439a8fb71c8b4d...b7c315558d0e988d674e675cb8a15bd87fe1b577,1,11,6,17,1,2014-07-03 11:22:32,2014-04-12 13:34:22
b7c315558d0e988d674e675cb8a15bd87fe1b577...ae0de07a1b5b0a86f1516c09b923ae48a279a1e8,1,4,2,6,1,2014-07-03 11:49:22,2014-07-03 11:49:22
ae0de07a1b5b0a86f1516c09b923ae48a279a1e8...1fcbb69f505fd856f5f2233afa32abe3929e7227,1,4,0,4,1,2014-07-03 11:50:57,2014-07-03 11:50:57
1fcbb69f505fd856f5f2233afa32abe3929e7227...6775972461ad157a787aeab2c18a6670af6e7603,1,27,2,29,4,2014-07-03 12:25:25,2014-06-11 06:44:14
6775972461ad157a787aeab2c18a6670af6e7603...1a9cb0a258de2b5ce58aa12d958b68adeff3a5e0,1,3,1,4,3,2014-07-03 12:29:03,2014-07-03 12:29:03
1a9cb0a258de2b5ce58aa12d958b68adeff3a5e0...f3cb2741161353f387d02725637ce4ba062a9bc0,2,102,31,133,11,2014-07-03 21:07:37,2014-06-14 13:04:37
f3cb2741161353f387d02725637ce4ba062a9bc0...920c369f3d7ca906ce69f43371e65c5bd5732c43,1,69,205,274,69,2014-07-03 21:07:37,2014-07-03 21:04:18
920c369f3d7ca906ce69f43371e65c5bd5732c43...095848915ba83cef5e6047af7f43089f9765fb03,1,1,1,2,1,2014-07-03 21:32:30,2014-07-03 21:24:15
095848915ba83cef5e6047af7f43089f9765fb03...cb42766a14f8123aa288b6e20f879141970fb84d,2,8,1,9,2,2014-07-04 00:44:36,2014-07-03 21:22:16
cb42766a14f8123aa288b6e20f879141970fb84d...0a51a05d4eaa398c8341f241a3d2f36eaac4a939,1,1,1,2,1,2014-07-06 06:43:21,2014-07-06 03:46:14
0a51a05d4eaa398c8341f241a3d2f36eaac4a939...af6f943a22f26cf2968f0ae3a1fab2fd09b52a2b,2,5,1,6,2,2014-07-07 17:48:42,2014-01-28 21:16:59
af6f943a22f26cf2968f0ae3a1fab2fd09b52a2b...9b3961ce09dc15ccdd57b94732092cb3da69501e,1,2,2,4,2,2014-07-07 18:21:07,2014-07-07 17:28:12
9b3961ce09dc15ccdd57b94732092cb3da69501e...a88c215f17829c1cfdec36bc1ef40bae10c41dff,1,1,1,2,1,2014-07-07 20:26:00,2014-07-07 20:21:23
a88c215f17829c1cfdec36bc1ef40bae10c41dff...59c090127f3f41ccf4ad902abcc543f0dcef0a18,1,13,11,24,4,2014-07-08 09:00:11,2014-07-07 20:47:37
59c090127f3f41ccf4ad902abcc543f0dcef0a18...e1f3c0cce84f597af6920a5e32be4a1673c91fab,1,7,8,15,5,2014-07-08 09:00:16,2014-07-07 20:53:14
e1f3c0cce84f597af6920a5e32be4a1673c91fab...b9faec0673ce8b26bfb1ba6073a7d8379b57a9eb,1,6,5,11,3,2014-07-08 09:00:17,2014-07-07 21:16:47
b9faec0673ce8b26bfb1ba6073a7d8379b57a9eb...86889b3b3cd850ef983a75acdfb9cabea4af8c4b,1,87,74,161,42,2014-07-08 09:00:17,2014-07-07 21:22:46
86889b3b3cd850ef983a75acdfb9cabea4af8c4b...e293975b1aac9ea08d4c811d92fae43700dd20ff,1,9,8,17,3,2014-07-08 09:00:17,2014-07-07 21:23:02
e293975b1aac9ea08d4c811d92fae43700dd20ff...7ccab812fde33f40f7fa30a48d4d6082257fd1d4,1,7,6,13,3,2014-07-08 09:00:17,2014-07-08 06:03:59
7ccab812fde33f40f7fa30a48d4d6082257fd1d4...28310583a9f746f920f47d04e289d1819edf12d0,1,28,26,54,3,2014-07-08 09:00:17,2014-07-08 06:05:28
28310583a9f746f920f47d04e289d1819edf12d0...1bce5bb3bb119447b4d4882c4b59613eb8e13886,1,21,19,40,9,2014-07-08 09:00:17,2014-07-08 06:06:11
1bce5bb3bb119447b4d4882c4b59613eb8e13886...84dc989cf029b2a5940a04fb99ad3ff9e0728e19,1,13,12,25,3,2014-07-08 09:00:17,2014-07-08 06:07:04
84dc989cf029b2a5940a04fb99ad3ff9e0728e19...f3567b257cb8709ee08250d28981e257bb6672bf,1,8,7,15,4,2014-07-08 09:00:17,2014-07-08 06:10:03
f3567b257cb8709ee08250d28981e257bb6672bf...0cddc5c7b4f726448a660d8fa63b2502d6c28484,1,8,2,10,4,2014-07-08 09:00:18,2014-07-08 06:12:39
0cddc5c7b4f726448a660d8fa63b2502d6c28484...74014f57edd45e1628db501ab7a44b8dcb741b1b,1,12,10,22,6,2014-07-08 09:00:18,2014-07-08 06:15:17
74014f57edd45e1628db501ab7a44b8dcb741b1b...d35f50ee11af5d20518a62c750753da9c7c7a8dc,1,40,39,79,11,2014-07-08 09:00:18,2014-07-08 06:18:52
d35f50ee11af5d20518a62c750753da9c7c7a8dc...d28a0bf49e81037fd73d52449c04d571218fc787,1,9,8,17,3,2014-07-08 09:00:18,2014-07-08 06:19:52
d28a0bf49e81037fd73d52449c04d571218fc787...39c7c909fb3a6ec5f79d66227ea84b075159b888,1,6,5,11,3,2014-07-08 09:00:18,2014-07-08 06:28:44
39c7c909fb3a6ec5f79d66227ea84b075159b888...0a1042535e4085f074854aa32501703d24953a87,1,7,6,13,3,2014-07-08 09:00:18,2014-07-08 06:30:02
0a1042535e4085f074854aa32501703d24953a87...1534529f8ce746140bcd66725c748ae70bfb4fdb,1,17,15,32,7,2014-07-08 09:00:18,2014-07-08 06:31:00
1534529f8ce746140bcd66725c748ae70bfb4fdb...aecdd9d630aad424d487c91ff90463bd8e026660,1,6,5,11,3,2014-07-08 09:00:18,2014-07-08 06:32:54
aecdd9d630aad424d487c91ff90463bd8e026660...474251928ecba842610ea0aee3b0f51f317e0dc9,1,7,6,13,3,2014-07-08 09:00:19,2014-07-08 06:33:23
474251928ecba842610ea0aee3b0f51f317e0dc9...e83c5ba68e9a154a28c7045042502af180623a00,1,8,7,15,3,2014-07-08 09:00:19,2014-07-08 06:38:00
e83c5ba68e9a154a28c7045042502af180623a00...95c2738244172ab3aff215e622a610dbb30631d6,1,7,6,13,3,2014-07-08 09:00:19,2014-07-08 06:38:21
95c2738244172ab3aff215e622a610dbb30631d6...ba2f606143d2041d0cbbc9b641b95719319c4b0d,1,8,9,17,4,2014-07-08 09:00:19,2014-07-08 06:38:49
ba2f606143d2041d0cbbc9b641b95719319c4b0d...e89916cf0ade8c999d73990f076c0a5ece8eba2a,1,9,8,17,3,2014-07-08 09:00:19,2014-07-08 06:39:52
e89916cf0ade8c999d73990f076c0a5ece8eba2a...b3da9467af82afd9519dfb251561205a5bfb25ea,1,28,27,55,5,2014-07-08 09:00:19,2014-07-08 06:40:47
b3da9467af82afd9519dfb251561205a5bfb25ea...dba8b7e95895cd1991fa057b8c85e8d4012b7beb,1,12,12,24,2,2014-07-08 09:00:19,2014-07-08 06:48:11
dba8b7e95895cd1991fa057b8c85e8d4012b7beb...c0360890c58858e2d3a7ee25e0eeae3c5d32e96c,1,16,14,30,2,2014-07-08 09:00:19,2014-07-08 06:49:10
c0360890c58858e2d3a7ee25e0eeae3c5d32e96c...9caff0df97c931d172a0828b4158accfe438093f,1,12,11,23,2,2014-07-08 09:00:20,2014-07-08 06:50:12
9caff0df97c931d172a0828b4158accfe438093f...470ad11b2aa08067bca5d220a46d9436818fb970,1,54,49,103,25,2014-07-08 09:00:20,2014-07-08 06:51:38
470ad11b2aa08067bca5d220a46d9436818fb970...7adcbb06c2e834375fb0394b3c0a123ef5466e81,1,28,26,54,8,2014-07-08 09:00:20,2014-07-08 06:53:58
7adcbb06c2e834375fb0394b3c0a123ef5466e81...72794528981396670735b9dca513aab96c8d53ae,1,12,11,23,3,2014-07-08 09:00:20,2014-07-08 06:55:38
72794528981396670735b9dca513aab96c8d53ae...282ed94cf99ebf12af19ac63004ffeceabcbfe4d,1,18,17,35,3,2014-07-08 09:00:20,2014-07-08 06:56:26
282ed94cf99ebf12af19ac63004ffeceabcbfe4d...a5f6a92c8c29115eb85b6987e64fe5987fe2694a,1,12,11,23,3,2014-07-08 09:00:20,2014-07-08 06:58:23
a5f6a92c8c29115eb85b6987e64fe5987fe2694a...f9d88198615ead0f0fcbc70018f8cba3305bec4c,1,24,22,46,6,2014-07-08 09:00:20,2014-07-08 08:12:10
f9d88198615ead0f0fcbc70018f8cba3305bec4c...d5305d565285ed805278ad7ad71b3b34b3e761c6,1,13,12,25,3,2014-07-08 09:00:21,2014-07-08 08:21:24
d5305d565285ed805278ad7ad71b3b34b3e761c6...3f2232b5a181512fac23775b1df4a6ebda67d018,3,44,16,60,16,2014-07-08 09:00:21,2014-07-01 17:56:55
3f2232b5a181512fac23775b1df4a6ebda67d018...b9fcf017316d37e91959949f56692644ce09d54a,2,133,1,134,6,2014-07-08 09:54:08,2014-06-25 23:50:00
b9fcf017316d37e91959949f56692644ce09d54a...621f678b2d468555a858bc6fd8c9d2939ce397a2,1,1,1,2,1,2014-07-08 10:34:27,2014-07-03 13:46:23
621f678b2d468555a858bc6fd8c9d2939ce397a2...5963b5c69f5dc145c9535f734c43ee6027ae24bd,1,8,14,22,3,2014-07-08 11:36:26,2014-07-08 11:36:26
5963b5c69f5dc145c9535f734c43ee6027ae24bd...7d4f0d79bd2dba8450edf01b63e58317a84dd116,2,57,9,66,11,2014-07-08 13:49:18,2014-07-08 13:49:18
7d4f0d79bd2dba8450edf01b63e58317a84dd116...36831eccd1da37c089f2141a2c073a6db69f3e1d,41,368,439,807,88,2014-07-08 13:49:25,2014-06-23 21:17:31
36831eccd1da37c089f2141a2c073a6db69f3e1d...b8ae73e17c19d9aebf572a75c05a7d981dcac807,1,9,3,12,4,2014-07-08 22:44:59,2014-07-08 22:44:59
b8ae73e17c19d9aebf572a75c05a7d981dcac807...88a325771b80ba3ab9616a53958c89595687b314,2,2,2,4,2,2014-07-08 23:22:04,2014-07-08 20:17:20
88a325771b80ba3ab9616a53958c89595687b314...93510eb51bccb51b75b0edcd74f9b4190a8638c8,1,1,1,2,1,2014-07-08 23:26:47,2014-07-02 23:09:52
93510eb51bccb51b75b0edcd74f9b4190a8638c8...cf4f85f62b28fa18db32deef66814e88d86eda5f,1,3,3,6,1,2014-07-09 05:38:49,2014-07-07 20:58:02
cf4f85f62b28fa18db32deef66814e88d86eda5f...9630d716e18442698fb3c0e49213bb21013f96e7,1,4,0,4,1,2014-07-09 10:41:46,2014-07-09 10:41:46
9630d716e18442698fb3c0e49213bb21013f96e7...c4c8fbddd07be9c1f927bc165228532198897fda,1,1,1,2,1,2014-07-09 13:37:10,2014-07-09 13:37:10
c4c8fbddd07be9c1f927bc165228532198897fda...ada9852af8beda379343df2f471c1e050b163470,1,7,3,10,2,2014-07-09 13:54:42,2014-07-08 20:10:15
ada9852af8beda379343df2f471c1e050b163470...2e84cf92745d006c54bb22042bed1845dbc78710,1,31,11,42,3,2014-07-09 13:54:42,2014-07-09 13:54:09
2e84cf92745d006c54bb22042bed1845dbc78710...38bdb4067512373f6f46199c353bf91db73ee087,1,1,1,2,1,2014-07-10 16:51:11,2014-07-10 16:51:11
38bdb4067512373f6f46199c353bf91db73ee087...9c5b407fd1e296dd525c129743f2b2b47da4dc0d,2,1,3,4,2,2014-07-10 17:38:24,2014-07-10 17:38:24
9c5b407fd1e296dd525c129743f2b2b47da4dc0d...012ab1f8745c8985d3f132c2dfa8fd84e7dc7041,1,12,12,24,3,2014-07-10 18:19:24,2014-07-10 18:19:18
012ab1f8745c8985d3f132c2dfa8fd84e7dc7041...c61626f10dc0b7913d7af59dcb0612f168327e60,1,12,0,12,1,2014-07-10 18:29:56,2014-07-04 07:17:15
c61626f10dc0b7913d7af59dcb0612f168327e60...81cd83613701244e8f92c012677c70bfc3eb81b9,2,3,3,6,2,2014-07-10 21:14:30,2014-07-09 09:12:56
81cd83613701244e8f92c012677c70bfc3eb81b9...34dcc0f1099bf13b6e860d2495f607385763f8f7,2,14,4,18,3,2014-07-10 21:37:28,2014-01-14 06:34:22
34dcc0f1099bf13b6e860d2495f607385763f8f7...20b0c2420bc80fbe4f11a8b27a9ee4a4ad154d9d,1,383,9,392,3,2014-07-10 21:44:34,2014-07-10 21:44:34
20b0c2420bc80fbe4f11a8b27a9ee4a4ad154d9d...5f6b378e39a5f05ecf4a093ea31e437ac5efb01f,1,1,26,27,3,2014-07-10 22:16:41,2014-07-07 19:00:01
5f6b378e39a5f05ecf4a093ea31e437ac5efb01f...363fb4fc79a098da30a6431aab3c0191aba1d377,1,1,2,3,1,2014-07-11 04:43:28,2014-07-11 04:26:21
363fb4fc79a098da30a6431aab3c0191aba1d377...d15cea48c3b795d7eb65bc5b4f9689effaab5737,1,162,0,162,1,2014-07-11 18:15:42,2014-07-11 18:10:20
d15cea48c3b795d7eb65bc5b4f9689effaab5737...af20a8aac62867b241f98389f03e3c38323b6c85,1,31,0,31,1,2014-07-13 03:23:37,2014-07-13 03:23:32
af20a8aac62867b241f98389f03e3c38323b6c85...a2c7cf9fb26637b89633cb7f33f97a9da76cfdb9,1,1,2,3,1,2014-07-13 04:03:17,2014-07-13 03:53:05
a2c7cf9fb26637b89633cb7f33f97a9da76cfdb9...071cbdb2727005e6d39918ad5c661f230b18c2e9,1,2,2,4,2,2014-07-14 15:27:02,2014-07-11 17:05:45
071cbdb2727005e6d39918ad5c661f230b18c2e9...3dafcba9c1738b85f3adceaac90b747a1b595ea8,1,3,2,5,3,2014-07-14 17:41:30,2014-07-11 00:10:49
3dafcba9c1738b85f3adceaac90b747a1b595ea8...02c0ed27bc375d5352fefdd7e34aad9758621283,3,8,6,14,5,2014-07-14 18:49:23,2014-07-14 16:46:56
02c0ed27bc375d5352fefdd7e34aad9758621283...0113f2257415422729d5c2a9bdba76c1d0a17a13,3,43,15,58,10,2014-07-15 00:18:39,2014-07-14 17:30:32
0113f2257415422729d5c2a9bdba76c1d0a17a13...db464d3bccbae21a594fe3c9b378bd90cf50bfc7,1,1,1,2,1,2014-07-15 00:25:02,2014-07-10 17:44:55
db464d3bccbae21a594fe3c9b378bd90cf50bfc7...42d497d1da807895f61f935c88dbc5b5539fdcd9,1,1,0,1,1,2014-07-15 00:40:20,2014-07-15 00:31:00
42d497d1da807895f61f935c88dbc5b5539fdcd9...6f776102b23f413f7f2443efe62beaac2be91add,1,1,1,2,1,2014-07-15 00:40:20,2014-07-15 00:34:53
6f776102b23f413f7f2443efe62beaac2be91add...1453fb72ffc1c013a1483886fd4926c789ae42b0,2,79,0,79,2,2014-07-15 11:39:36,2014-07-14 21:40:47
1453fb72ffc1c013a1483886fd4926c789ae42b0...78d2620576386df9f037e87ef4b09c60e8694a77,1,3,5,8,1,2014-07-15 11:45:23,2013-11-21 21:31:27
78d2620576386df9f037e87ef4b09c60e8694a77...8c5cbcba20dfccbd01c246984d985378dcc197b5,1,1,5,6,1,2014-07-15 11:45:31,2013-11-21 21:34:50
8c5cbcba20dfccbd01c246984d985378dcc197b5...64b177377c2aa8ae97c6f8752b69424d70a4fb4e,1,1,5,6,1,2014-07-15 11:45:38,2013-11-21 21:35:47
64b177377c2aa8ae97c6f8752b69424d70a4fb4e...345ed5d1c73f38a6032c4c2b869742502da807ea,1,1,5,6,1,2014-07-15 11:45:45,2013-11-21 21:37:35
345ed5d1c73f38a6032c4c2b869742502da807ea...528f56a690295650f54eeb2238609446635c5db0,2,4,6,10,4,2014-07-15 12:17:36,2014-02-18 23:26:00
528f56a690295650f54eeb2238609446635c5db0...92bceb5c5b6e4a5a8fee01e1e0dfcf4674858cf2,2,34,0,34,2,2014-07-15 12:40:18,2014-03-19 11:30:23
92bceb5c5b6e4a5a8fee01e1e0dfcf4674858cf2...4f45bf1a41cd69a01e76f81438877461a755872a,1,1,1,2,1,2014-07-15 13:00:48,2014-07-15 13:00:48
4f45bf1a41cd69a01e76f81438877461a755872a...db9f2570c18d77d0e51d5a7afa139d25d0bdc470,2,13,3,16,4,2014-07-15 16:44:12,2014-06-21 16:17:25
db9f2570c18d77d0e51d5a7afa139d25d0bdc470...d7f730228d58d3a409846e64ba5d0120356691cc,1,6,0,6,1,2014-07-15 16:46:55,2014-07-11 20:27:55
d7f730228d58d3a409846e64ba5d0120356691cc...840e889e5353156e6187f808bcf92ffe876235a0,1,1,1,2,1,2014-07-15 16:50:01,2014-07-10 14:20:01
840e889e5353156e6187f808bcf92ffe876235a0...bcf72cacb5afcbeb6d2deb856b7f6e2f19285a24,13,15,541,556,34,2014-07-15 20:28:17,2014-06-02 17:17:36
bcf72cacb5afcbeb6d2deb856b7f6e2f19285a24...86d55c1ded21a5be6091344493d70c6dc4194e43,13,745,94,839,52,2014-07-15 20:29:38,2014-06-04 20:49:23
86d55c1ded21a5be6091344493d70c6dc4194e43...7e6e0d6a39cbbb37d4961ba8df594c3062bbf70d,1,14,0,14,1,2014-07-15 20:57:23,2014-07-15 20:57:23
7e6e0d6a39cbbb37d4961ba8df594c3062bbf70d...8881606cd93cc42cb8295c0d63dac7b81e6cc8cc,2,11,2,13,2,2014-07-16 00:09:28,2014-07-15 18:53:27
8881606cd93cc42cb8295c0d63dac7b81e6cc8cc...9dce42b3c26eb02621723172a68725980369b849,2,10,1,11,2,2014-07-16 00:18:12,2014-07-11 16:34:52
9dce42b3c26eb02621723172a68725980369b849...666a3835d231b3f77f907276be18b3c0086e5d12,3,25,81,106,16,2014-07-16 00:20:26,2014-07-11 12:01:24
666a3835d231b3f77f907276be18b3c0086e5d12...048a5f14ec68f13a7d84a0a3ddb20ee19179b0c7,1,5,5,10,4,2014-07-16 00:22:33,2014-06-29 18:09:40
048a5f14ec68f13a7d84a0a3ddb20ee19179b0c7...e8066c4b4ce11496b0d8f39e41b4d753048bca2d,7,169,27,196,17,2014-07-16 04:20:42,2013-12-11 20:54:37
e8066c4b4ce11496b0d8f39e41b4d753048bca2d...4adc44a3d17f4a06668eaba7f7cead7d799944e5,1,1,1,2,1,2014-07-16 10:14:24,2014-07-15 15:28:06
4adc44a3d17f4a06668eaba7f7cead7d799944e5...d2f348b04ccaa87d9626a3e093c96c68be1c4152,1,1,1,2,1,2014-07-16 15:30:16,2014-07-16 15:14:01
d2f348b04ccaa87d9626a3e093c96c68be1c4152...1f23980590263fbd513f276c208dfb053682c330,2,2,11,13,2,2014-07-16 15:33:32,2014-07-16 15:33:32
1f23980590263fbd513f276c208dfb053682c330...d6876f2906a9a1870cb1754089e652b813952202,1,1,0,1,1,2014-07-16 18:09:03,2014-07-16 16:06:48
d6876f2906a9a1870cb1754089e652b813952202...1c9ab40d286ffdb1b41d30ca8d861b53175bfc24,2,10,6,16,7,2014-07-16 19:54:56,2014-07-08 16:18:38
1c9ab40d286ffdb1b41d30ca8d861b53175bfc24...d25975438ae085a526bde9ed2cecd52939f8a787,1,15,10,25,5,2014-07-16 20:42:38,2014-07-03 16:24:49
d25975438ae085a526bde9ed2cecd52939f8a787...f6681d41a493efa6566f8a8a0b6ec39547e572ef,2,56,15,71,17,2014-07-16 20:53:44,2014-07-05 05:03:52
f6681d41a493efa6566f8a8a0b6ec39547e572ef...3c7f0f7a367eb5e333843a120f29fbf44f017687,1,2,2,4,2,2014-07-16 21:04:09,2014-06-27 09:37:03
3c7f0f7a367eb5e333843a120f29fbf44f017687...d7b3aa9ae6d03bc04734b0bf1440144ee40269b5,4,32,46,78,5,2014-07-16 21:45:33,2014-07-11 19:53:54
d7b3aa9ae6d03bc04734b0bf1440144ee40269b5...8cefb0b628553f6db1d3b626f10ead2c27c76a9d,1,2,2,4,2,2014-07-17 00:42:02,2014-07-17 00:32:07
8cefb0b628553f6db1d3b626f10ead2c27c76a9d...2474173e18ba4ba0835ebed0d2259e84a7d2934b,3,5,2,7,3,2014-07-17 06:09:22,2014-07-17 05:51:27
2474173e18ba4ba0835ebed0d2259e84a7d2934b...eb2bab40ccbcf9ad73f8527cda478bb4142f3265,2,9,9,18,8,2014-07-17 11:54:54,2014-07-17 11:54:45
eb2bab40ccbcf9ad73f8527cda478bb4142f3265...7c3122007c1a3b0dee69a5caf805cf0bfd1afc17,1,2,2,4,2,2014-07-17 19:31:56,2014-07-17 19:31:24
7c3122007c1a3b0dee69a5caf805cf0bfd1afc17...c6c9d26e3487ce24ece390c26994123964f805b0,2,13,14,27,9,2014-07-17 21:04:07,2013-10-09 09:42:54
c6c9d26e3487ce24ece390c26994123964f805b0...8d18d20e316ed9d420f09f46f90027aef2940930,2,128,62,190,13,2014-07-17 21:04:07,2014-07-16 13:13:06
8d18d20e316ed9d420f09f46f90027aef2940930...d18172625af3f8e02673b9e8bf6349052685681d,1,8,0,8,1,2014-07-17 21:04:07,2014-07-17 19:48:06
d18172625af3f8e02673b9e8bf6349052685681d...a160f76ffa9544cd2ed99f24ba65b5994108f9f5,1,8,10,18,10,2014-07-18 00:14:13,2014-06-15 19:38:40
a160f76ffa9544cd2ed99f24ba65b5994108f9f5...e4ba89436aa0b96f126ce2c23d0c7f7c785573fe,3,37,11,48,11,2014-07-18 00:14:13,2014-06-24 07:18:55
e4ba89436aa0b96f126ce2c23d0c7f7c785573fe...3ba98186b8a50f4ee2c778cef5edfa95aa8c115c,1,3,1,4,1,2014-07-18 01:54:17,2014-07-18 01:54:03
3ba98186b8a50f4ee2c778cef5edfa95aa8c115c...222edd80319142f7f0439bb8ced382520c0a4e8d,1,4,6,10,3,2014-07-18 09:51:11,2014-07-17 23:26:49
222edd80319142f7f0439bb8ced382520c0a4e8d...9987a609d0ed5531a26f88bd6cba63800959ae58,1,13,9,22,4,2014-07-18 10:05:24,2014-07-18 10:05:24
9987a609d0ed5531a26f88bd6cba63800959ae58...81d9193ed79de469584376dd084cdc2f087d8c50,1,14,1,15,3,2014-07-18 10:05:39,2014-07-18 10:05:39
81d9193ed79de469584376dd084cdc2f087d8c50...4f32e3eef152bcaab7f7ab151fc824e71a591473,2,27,6,33,5,2014-07-18 10:18:18,2014-07-17 19:07:46
4f32e3eef152bcaab7f7ab151fc824e71a591473...c20d438ac9b9757331d096969a73c782c38e098a,2,23,18,41,6,2014-07-18 10:24:54,2014-07-17 21:10:50
c20d438ac9b9757331d096969a73c782c38e098a...3f4ee1513901f55d6007e3fc3948458adf4ac656,2,13,1,14,2,2014-07-18 15:36:16,2014-07-17 21:47:14
3f4ee1513901f55d6007e3fc3948458adf4ac656...903e7352c9943e4d3757dd1cff58178d4c5375d6,2,23,10,33,4,2014-07-18 18:29:07,2014-07-18 18:12:54
903e7352c9943e4d3757dd1cff58178d4c5375d6...20f4f63786276ffe95d021976e5dcd5747f5ea96,1,1,1,2,1,2014-07-18 18:38:07,2014-07-18 18:38:01
20f4f63786276ffe95d021976e5dcd5747f5ea96...bd2fb3d9c0012c7d47bfebbfb554350f99b557ce,1,182,0,182,1,2014-07-18 19:18:26,2014-07-18 19:02:06
bd2fb3d9c0012c7d47bfebbfb554350f99b557ce...aa7dbf0cf74f80665cbe1d95bb3ebc3bcd3e3811,2,19,3,22,5,2014-07-18 20:49:43,2014-07-18 20:49:43
aa7dbf0cf74f80665cbe1d95bb3ebc3bcd3e3811...3d0dcf68c1734b470cfed248b7f04a9bbef70f98,2,11,2,13,2,2014-07-18 22:34:30,2014-07-15 18:53:27
3d0dcf68c1734b470cfed248b7f04a9bbef70f98...c94329a891a1c082567c490ccf58ba8592b464ad,1,1,1,2,1,2014-07-18 22:53:43,2014-06-11 13:27:08
c94329a891a1c082567c490ccf58ba8592b464ad...55c6ee39e3650a05f0fe35bd3005c5f3712a0f39,2,2,2,4,2,2014-07-21 20:02:22,2014-07-21 20:01:01
55c6ee39e3650a05f0fe35bd3005c5f3712a0f39...2ad1b4cb9c6cbb5fd523a050511a24a085f7b580,1,2,0,2,2,2014-07-21 20:02:22,2014-07-21 20:02:12
2ad1b4cb9c6cbb5fd523a050511a24a085f7b580...0209b2e3b2496e865f188c222735612cd7104283,1,22,24,46,2,2014-07-21 21:42:09,2014-07-18 22:44:08
0209b2e3b2496e865f188c222735612cd7104283...f6f469e9090ee6cee2a4079b6573d38836661f70,1,21,0,21,1,2014-07-21 21:42:36,2014-07-21 08:07:19
f6f469e9090ee6cee2a4079b6573d38836661f70...b5f0721e3dc76eb3fb507d93389dc75531821300,1,1,1,2,1,2014-07-21 21:44:11,2014-07-15 11:12:44
b5f0721e3dc76eb3fb507d93389dc75531821300...a54d4600b3a7b25bc99c7d3167d3d295c2ad4a4d,42,63,63,126,56,2014-07-21 21:52:41,2014-07-21 07:45:27
a54d4600b3a7b25bc99c7d3167d3d295c2ad4a4d...f309c4ceba3ae68b0391c8cd1d93a439eaa17a51,1,1,1,2,1,2014-07-21 21:54:51,2014-07-19 22:34:58
f309c4ceba3ae68b0391c8cd1d93a439eaa17a51...3b158aab224242d36f3fa0db41303610a80a91f9,1,2,2,4,2,2014-07-21 22:29:34,2014-07-13 04:27:12
3b158aab224242d36f3fa0db41303610a80a91f9...dfd228497bd78e758b4068fb6b8738851d2e14d0,1,1,1,2,1,2014-07-21 23:09:03,2014-07-13 10:38:51
dfd228497bd78e758b4068fb6b8738851d2e14d0...92a10d843e4d1d1a623c91af8e7f56c014ff9271,1,1,1,2,1,2014-07-21 23:53:07,2014-07-09 15:51:49
92a10d843e4d1d1a623c91af8e7f56c014ff9271...eff00ea98cf6aebc73fa95c01384ba7c4ee6cb2b,1,1,1,2,1,2014-07-22 00:16:45,2014-07-10 20:56:06
eff00ea98cf6aebc73fa95c01384ba7c4ee6cb2b...e0adb9c452e172295209f785b62472688225fffb,2,71,4,75,7,2014-07-22 02:16:45,2014-07-02 10:36:35
e0adb9c452e172295209f785b62472688225fffb...df58874747ddaf37810e0068c5ea7e59a625b7d6,1,287,94,381,17,2014-07-22 16:54:53,2014-07-18 11:23:56
df58874747ddaf37810e0068c5ea7e59a625b7d6...38ad144c33cfce58af25619a878cda617e85bb3f,1,102,105,207,40,2014-07-22 16:54:53,2014-07-22 16:53:35
38ad144c33cfce58af25619a878cda617e85bb3f...c4c83ef75606cb06af53b6415fceb1f486e4c43e,1,2,2,4,2,2014-07-22 17:31:15,2014-07-22 11:09:38
c4c83ef75606cb06af53b6415fceb1f486e4c43e...289b6b4dacbe8904a05f604cabbfad34c9158997,1,2,3,5,3,2014-07-22 17:33:24,2014-07-22 13:49:42
289b6b4dacbe8904a05f604cabbfad34c9158997...4d875faa22f9f4e6e434ee14afa2d8dea2cd8692,2,5,5,10,5,2014-07-22 19:04:51,2014-07-22 19:04:51
4d875faa22f9f4e6e434ee14afa2d8dea2cd8692...d1df21e45e61f79936208486fd6b03250daa691e,6,12,4,16,8,2014-07-22 23:31:24,2014-07-22 22:15:59
d1df21e45e61f79936208486fd6b03250daa691e...88765d581dbadc2b3c945e0dd26abf8e6696df5a,1,4,3,7,3,2014-07-23 16:19:58,2014-07-23 13:42:53
88765d581dbadc2b3c945e0dd26abf8e6696df5a...d0de0ce557c7f871ddc73f41dba0157b86048438,1,1,1,2,1,2014-07-23 17:32:11,2014-07-23 05:52:05
d0de0ce557c7f871ddc73f41dba0157b86048438...1a2ed705d47250e4242a864d1d6dd3e30de2c978,1,4,7,11,3,2014-07-23 18:30:13,2014-04-25 00:04:05
1a2ed705d47250e4242a864d1d6dd3e30de2c978...469ea3384ad48ca4765af807c0f41201edb527f9,2,23,2,25,2,2014-07-23 19:37:47,2014-04-03 23:26:17
469ea3384ad48ca4765af807c0f41201edb527f9...99a2f0aba7d4c9a100e929d2150b0d933f79f7f2,1,2,2,4,1,2014-07-23 22:01:43,2014-04-15 02:14:30
99a2f0aba7d4c9a100e929d2150b0d933f79f7f2...c54228fbe9d42d8a3a159bf84dd1d2e99b259ece,1,1,1,2,1,2014-07-24 14:40:23,2014-07-24 14:40:05
c54228fbe9d42d8a3a159bf84dd1d2e99b259ece...f3a763fd2edd8a37b80c79a5aaa1444460cd2df7,2,676,6,682,6,2014-07-24 20:42:28,2014-07-03 18:09:31
f3a763fd2edd8a37b80c79a5aaa1444460cd2df7...8a27abae896de3c4d94c407e8bb381e099d2d7f7,2,24,2,26,3,2014-07-24 20:47:28,2014-01-25 19:43:16
8a27abae896de3c4d94c407e8bb381e099d2d7f7...925b2080a0341d9348feeb4f492957a2e2c80082,1,6,1,7,1,2014-07-24 21:20:31,2014-07-24 21:20:31
925b2080a0341d9348feeb4f492957a2e2c80082...11f5aeeee952a395edaf54e3277674f211a82fc7,10,63,20,83,25,2014-07-24 22:02:41,2014-07-24 15:20:21
11f5aeeee952a395edaf54e3277674f211a82fc7...37117ab53ad23b62e5edfc8780a5efec4f3af361,1,3,1,4,1,2014-07-25 12:30:17,2014-04-17 00:59:46
37117ab53ad23b62e5edfc8780a5efec4f3af361...fefb7eda40c0f0b5208eef317303d84eeacc7831,1,5,0,5,1,2014-07-25 13:35:36,2014-07-25 13:35:36
fefb7eda40c0f0b5208eef317303d84eeacc7831...683d722233ea567816e58d7dd01ed39a3fbe3b72,1,5,6,11,2,2014-07-25 13:47:12,2014-07-24 15:46:44
683d722233ea567816e58d7dd01ed39a3fbe3b72...c03b9e5ec4153078923347d53cbd0d7dfc4e2212,1,1,1,2,1,2014-07-25 14:08:03,2014-07-25 09:20:24
c03b9e5ec4153078923347d53cbd0d7dfc4e2212...86340a59bf9eb7bdfc4f99000cecf628cd10d9c8,2,16,1,17,2,2014-07-25 15:37:53,2014-07-25 12:31:56
86340a59bf9eb7bdfc4f99000cecf628cd10d9c8...f684c211453411f831d8daf97f560cdb07e34783,1,122,0,122,1,2014-07-25 17:16:13,2014-07-25 17:11:55
f684c211453411f831d8daf97f560cdb07e34783...0daaab0341ec20ddaed44e430847197bdc906668,1,1,1,2,1,2014-07-25 21:11:15,2014-07-25 18:53:15
0daaab0341ec20ddaed44e430847197bdc906668...46f755a0bcf435e2df915f9ae041c4f9d38837fe,1,31,8,39,2,2014-07-25 21:26:04,2014-06-12 20:45:20
46f755a0bcf435e2df915f9ae041c4f9d38837fe...1f533ad4856e8500da1a621ac1cb4ba06798e114,1,2,2,4,2,2014-07-25 21:51:47,2014-07-25 21:51:47
1f533ad4856e8500da1a621ac1cb4ba06798e114...2e0a4e385ced10eff8b914dedb59ad4b8a5f3a5a,1,3,4,7,4,2014-07-26 07:41:34,2014-07-20 12:54:39
2e0a4e385ced10eff8b914dedb59ad4b8a5f3a5a...4152155c25c3e6e4c748de99e6131639bf2fbcd7,1,3,1,4,1,2014-07-26 09:59:05,2014-06-17 08:13:56
4152155c25c3e6e4c748de99e6131639bf2fbcd7...583f37df5e9c2a31af5bcc7eafb6ac315be35dae,1,9,3,12,1,2014-07-26 09:59:14,2014-07-26 09:58:25
583f37df5e9c2a31af5bcc7eafb6ac315be35dae...ccc3255fea11cbdee0d45d301a2fc13fa899228e,1,5,0,5,1,2014-07-26 19:39:55,2014-07-26 15:21:38
ccc3255fea11cbdee0d45d301a2fc13fa899228e...c03ad249033e701f3ad7aa358102e1cb87f5025c,2,23,4,27,4,2014-07-27 06:24:34,2014-07-08 21:54:44
c03ad249033e701f3ad7aa358102e1cb87f5025c...90251138bd471022a49d9faeb9b737ed24e2b7c9,1,3,3,6,2,2014-07-27 13:06:30,2014-07-27 07:57:13
90251138bd471022a49d9faeb9b737ed24e2b7c9...3607c9822f57b4d01b3f09a6ae4efc7168bec6c5,2,14,1,15,2,2014-07-29 08:40:18,2014-07-26 20:29:59
3607c9822f57b4d01b3f09a6ae4efc7168bec6c5...e5c6b7017b17c947eb4dbf235065fc22f4d52b43,1,1,1,2,1,2014-07-29 15:40:59,2014-07-29 15:31:14
e5c6b7017b17c947eb4dbf235065fc22f4d52b43...38678cb65a0aa3fdc435b8817563ef7d8d5967fe,1,5,0,5,1,2014-07-29 16:40:16,2014-07-29 07:07:34
38678cb65a0aa3fdc435b8817563ef7d8d5967fe...ca0f59e677170d5af9652dfcca25738a05b24820,1,1,1,2,1,2014-07-29 16:49:21,2014-07-29 11:33:30
ca0f59e677170d5af9652dfcca25738a05b24820...3625803349de04f175f87a22cbb608738003811a,3,48,5,53,6,2014-07-29 18:03:21,2014-07-28 16:57:11
3625803349de04f175f87a22cbb608738003811a...34781f18cb75ded9ae29f4b78f5bacd079f76709,2,17,0,17,2,2014-07-30 17:33:25,2014-07-30 15:30:52
34781f18cb75ded9ae29f4b78f5bacd079f76709...a00c9bca401abe5b5b0a217be82333056422c811,2,11,1,12,2,2014-07-30 18:13:36,2014-07-27 05:55:36
a00c9bca401abe5b5b0a217be82333056422c811...c306d251f49ea7de42f6616571cddbaf0db890bc,2,1,28,29,3,2014-07-30 22:08:26,2014-07-16 18:30:19
c306d251f49ea7de42f6616571cddbaf0db890bc...6e8bec6c831caceaa613c2c8d4eb8d8bffc60c8e,1,21,0,21,1,2014-07-30 22:08:26,2014-07-28 16:29:42
6e8bec6c831caceaa613c2c8d4eb8d8bffc60c8e...f92f52e29dd066605293da6639a42ca74685c235,1,40,0,40,1,2014-07-30 22:08:26,2014-07-16 18:43:47
f92f52e29dd066605293da6639a42ca74685c235...48568b49dc74038fb74b951bb7fe698875366b15,1,26,0,26,2,2014-07-30 22:08:26,2014-07-16 22:11:52
48568b49dc74038fb74b951bb7fe698875366b15...7fdd26e6f3cb265e0e05ef70e1a5796629a14605,1,7,0,7,2,2014-07-30 22:08:26,2014-07-28 08:18:54
7fdd26e6f3cb265e0e05ef70e1a5796629a14605...cdc7db3f35368a9175ed96c63f4bf56593fe1876,1,25,14,39,4,2014-07-30 22:13:23,2014-07-30 21:48:37
cdc7db3f35368a9175ed96c63f4bf56593fe1876...e329243df1bc850265ac52a1915e92f60329694c,1,1,1,2,1,2014-07-30 22:59:55,2014-07-30 19:38:17
e329243df1bc850265ac52a1915e92f60329694c...28540c804a1b2e4dd3328b3caca1391c696da1ca,4,37,35,72,27,2014-07-31 00:20:58,2014-07-29 17:46:00
28540c804a1b2e4dd3328b3caca1391c696da1ca...d2f8f25af2c078c971c7223a8894a01e0595cd20,4,8,41,49,11,2014-07-31 00:21:28,2014-07-30 18:39:37
d2f8f25af2c078c971c7223a8894a01e0595cd20...9a2f8e17782c6d3b983a063e005118a45aafbd80,1,1,1,2,1,2014-07-31 06:14:04,2014-07-31 06:13:55
9a2f8e17782c6d3b983a063e005118a45aafbd80...97f230a983631501c183017662de8daa85634718,2,31,0,31,3,2014-07-31 11:30:52,2014-07-30 03:12:55
97f230a983631501c183017662de8daa85634718...9836a2d6969afa9e3a913f73ec0e936fca1107e6,1,1,1,2,1,2014-07-31 12:40:33,2014-07-30 13:43:51
9836a2d6969afa9e3a913f73ec0e936fca1107e6...1571950fe39c9e5e86a01233af1ad27dec0cf80b,1,1,0,1,1,2014-07-31 12:43:19,2014-07-30 23:41:15
1571950fe39c9e5e86a01233af1ad27dec0cf80b...41cb5885148b1088c940ae2cacf38caf82093646,1,1,1,2,1,2014-07-31 18:32:12,2014-07-31 18:31:33
41cb5885148b1088c940ae2cacf38caf82093646...38db2d4ceccbe9834c48756cde7f1242b5842637,1,30,0,30,1,2014-07-31 19:48:20,2014-07-30 17:52:16
38db2d4ceccbe9834c48756cde7f1242b5842637...9e7cb3c37543008e6236bb5a2c4536df2e1e43a9,13,102,38,140,22,2014-07-31 20:20:31,2014-04-30 10:13:48
9e7cb3c37543008e6236bb5a2c4536df2e1e43a9...0107bfcab6e8b76e394229e3ff357c4d2d6d0eec,1,7,0,7,1,2014-07-31 20:26:43,2014-07-31 20:26:27
0107bfcab6e8b76e394229e3ff357c4d2d6d0eec...e98258184ab14b5a762f8815859e1edc6c12498b,1,1,1,2,1,2014-08-01 14:13:21,2014-08-01 09:42:22
e98258184ab14b5a762f8815859e1edc6c12498b...52b77b6b89d6818dbde4d406febe9ec451808ea2,5,323,1,324,5,2014-08-01 19:11:12,2014-07-31 13:26:10
52b77b6b89d6818dbde4d406febe9ec451808ea2...108a69be17df5884d026c57b2be3235c576250fe,2,58,10,68,14,2014-08-01 23:54:07,2013-12-30 14:52:25
108a69be17df5884d026c57b2be3235c576250fe...c024f28217cf8eedd695dd4b933ecf2ba4243c15,2,88,2,90,3,2014-08-02 01:03:16,2014-06-05 00:15:18
c024f28217cf8eedd695dd4b933ecf2ba4243c15...7884c25643bc6c051436a25ce3680f80094b629c,2,2,2,4,2,2014-08-02 02:11:53,2014-08-02 02:02:06
7884c25643bc6c051436a25ce3680f80094b629c...dd2a803f4f03ab629a51623c026d3e3f9dc9e91f,2,19,0,19,2,2014-08-02 15:49:38,2014-08-01 16:53:43
dd2a803f4f03ab629a51623c026d3e3f9dc9e91f...25a476ea096b200fb4f422aaa9cd7215e2596ad3,2,42,0,42,2,2014-08-03 15:35:41,2014-07-31 08:31:14
25a476ea096b200fb4f422aaa9cd7215e2596ad3...477626d846b4de65d1d5c7071e6a94361395ff42,2,136,33,169,37,2014-08-03 16:08:48,2014-07-26 13:56:15
477626d846b4de65d1d5c7071e6a94361395ff42...48b34ddb79d8e65cbdd0aa0ef15189a904887220,1,4,2,6,1,2014-08-03 16:14:53,2014-08-02 08:52:18
48b34ddb79d8e65cbdd0aa0ef15189a904887220...23bc92b17df882a907fb326320f0622717fefe7b,1,128,121,249,22,2014-08-04 05:53:09,2014-07-30 23:08:20
23bc92b17df882a907fb326320f0622717fefe7b...fc732564640231fb59dcd7e432093c3336083653,1,2,3,5,1,2014-08-04 10:37:16,2014-08-03 17:31:38
fc732564640231fb59dcd7e432093c3336083653...91d5640a2cb6119207f634ecada795cea1672d84,1,1,1,2,1,2014-08-04 10:42:52,2014-08-04 10:42:52
91d5640a2cb6119207f634ecada795cea1672d84...947532828e50b5ed0539a6d713374eaaf5a2191d,1,10,4,14,1,2014-08-04 11:01:36,2014-08-03 14:42:17
947532828e50b5ed0539a6d713374eaaf5a2191d...acf38b382bae92312dcbdf6125f2a1a3842e5201,1,30,0,30,1,2014-08-04 21:28:18,2014-08-04 21:22:50
acf38b382bae92312dcbdf6125f2a1a3842e5201...7085b2bcac4a15149e2a94cf058d13f323921fd6,1,1,1,2,1,2014-08-04 22:47:59,2014-08-04 22:39:49
7085b2bcac4a15149e2a94cf058d13f323921fd6...60c13a17a776e79c4b8ebf2d15dc0a4aef15d9a9,1,1,0,1,1,2014-08-05 06:14:04,2014-08-05 06:14:04
60c13a17a776e79c4b8ebf2d15dc0a4aef15d9a9...1bb4e87dd6a0b3a3a66b72faf5056d3f47caf52b,1,1,1,2,1,2014-08-06 14:11:54,2014-08-06 13:19:00
1bb4e87dd6a0b3a3a66b72faf5056d3f47caf52b...833e60a203263a81a24d773c82c3563c3fb2c97c,1,2,2,4,2,2014-08-06 14:38:48,2014-08-05 14:48:13
833e60a203263a81a24d773c82c3563c3fb2c97c...a390612d15951e5f392a49535d7e7c271aea2027,1,1,1,2,1,2014-08-06 14:43:46,2014-08-04 15:28:03
a390612d15951e5f392a49535d7e7c271aea2027...fcd76d27e5459d5cf42d04cd60c78e78bd323bd9,1,8,8,16,8,2014-08-06 20:03:58,2014-08-05 21:18:57
fcd76d27e5459d5cf42d04cd60c78e78bd323bd9...7df7d1a9bc9362fea657fbeb95bc9ff53740062d,1,24,0,24,1,2014-08-07 14:12:49,2014-08-07 13:19:01
7df7d1a9bc9362fea657fbeb95bc9ff53740062d...07d528396e8196ddb6049fa0ea2b1849f6f38b2a,1,4,2,6,2,2014-08-08 01:03:31,2014-08-07 03:52:12
07d528396e8196ddb6049fa0ea2b1849f6f38b2a...acad09efa615d093da4922c181207ef814ee3ad4,1,1,1,2,1,2014-08-08 19:29:26,2014-06-16 22:03:42
acad09efa615d093da4922c181207ef814ee3ad4...8c98d6a63713856309c61e30f47d6237eb5b1604,1,1,1,2,1,2014-08-08 19:31:50,2014-08-08 19:31:50
8c98d6a63713856309c61e30f47d6237eb5b1604...1b6a107a54477053c4fef2b081260f6aa5f22a16,1,44,0,44,1,2014-08-08 19:37:27,2014-08-08 04:31:45
1b6a107a54477053c4fef2b081260f6aa5f22a16...ce378f2582d3b73571b3db3eabfe89f596d48bea,4,41,8,49,11,2014-08-08 22:11:30,2014-08-08 21:25:26
ce378f2582d3b73571b3db3eabfe89f596d48bea...b3047b9dc95d6844368455d89cc59d0631ebad36,4,35,37,72,27,2014-08-08 22:11:38,2014-08-08 21:45:14
b3047b9dc95d6844368455d89cc59d0631ebad36...a001a417d5c12bad0fa09c88e045622b95239e2f,1,1,1,2,1,2014-08-08 22:11:38,2014-08-08 21:52:40
a001a417d5c12bad0fa09c88e045622b95239e2f...e4e7e940f6bc69de40a37cf07bae6eedd13c1308,1,1,1,2,1,2014-08-09 18:00:11,2014-08-09 14:33:49
e4e7e940f6bc69de40a37cf07bae6eedd13c1308...5038bf79c6c8251d7449d887b44a4321e619c534,2,23,1,24,2,2014-08-10 07:18:11,2014-08-10 06:58:09
5038bf79c6c8251d7449d887b44a4321e619c534...d09e3e923e0c2d0fba799c09fe7d4ac7622dfbc3,2,2,2,4,2,2014-08-10 16:42:06,2014-08-10 16:42:06
d09e3e923e0c2d0fba799c09fe7d4ac7622dfbc3...33a815d557f9090d14f97d633d7037040934d17f,1,1,1,2,1,2014-08-10 19:04:57,2014-08-10 19:04:57
33a815d557f9090d14f97d633d7037040934d17f...37ba3b94936ed7381ec2fbe56b3382e7c607938e,1,7,0,7,1,2014-08-10 19:06:50,2014-08-10 19:06:50
37ba3b94936ed7381ec2fbe56b3382e7c607938e...01d81cdab3dbbcb8b4204769eb5272096eb0837f,2,52,21,73,4,2014-08-10 19:26:32,2014-08-08 13:10:03
01d81cdab3dbbcb8b4204769eb5272096eb0837f...2d678f1d0a3714fdd49e582b92787312af129947,2,13,2,15,3,2014-08-11 15:54:40,2013-12-16 18:02:25
2d678f1d0a3714fdd49e582b92787312af129947...b33716f42a7d0e6d104fd5552dff6e5795174895,1,111,0,111,1,2014-08-12 17:16:32,2014-08-12 16:57:09
b33716f42a7d0e6d104fd5552dff6e5795174895...f30e2d093b54287297f753d417d4f341204a1c83,1,2,2,4,1,2014-08-12 20:51:40,2014-08-12 20:51:40
f30e2d093b54287297f753d417d4f341204a1c83...76e57a764f8284c0aacda6a6ee6351f5ed51e394,4,13,3,16,4,2014-08-13 10:24:19,2014-08-12 15:47:17
76e57a764f8284c0aacda6a6ee6351f5ed51e394...56bd0378bf06f49bb5980fb882d2af37bdbefbc1,1,1,1,2,1,2014-08-13 17:20:27,2014-08-13 13:32:39
56bd0378bf06f49bb5980fb882d2af37bdbefbc1...77a1acc7fcad7a8a7d0376b33d38a8977372cfe2,2,134,2,136,4,2014-08-13 21:11:58,2014-07-26 23:34:02
77a1acc7fcad7a8a7d0376b33d38a8977372cfe2...1229334fbd8c778e95785d6a5e5589099ce655f7,5,252,1,253,5,2014-08-14 06:28:13,2014-08-13 00:47:47
1229334fbd8c778e95785d6a5e5589099ce655f7...bfd311174d8a841c6896120af873c7db116afd6d,1,6,0,6,1,2014-08-14 06:28:13,2014-08-13 23:42:27
bfd311174d8a841c6896120af873c7db116afd6d...6bdaa4bc213805a58f51e9f5285dfe03bb06ddc3,3,10,4,14,4,2014-08-14 06:28:13,2014-08-14 06:00:00
6bdaa4bc213805a58f51e9f5285dfe03bb06ddc3...b9389b26ba2cf6aa70372fa32a7b28c62d174bf5,5,79,27,106,16,2014-08-14 19:09:13,2014-08-05 12:43:06
b9389b26ba2cf6aa70372fa32a7b28c62d174bf5...1a05daf5dc67813528afdb88086766dc22b6c0df,2,36,5,41,6,2014-08-14 19:19:44,2013-12-18 04:22:53
1a05daf5dc67813528afdb88086766dc22b6c0df...3f0e642eefcbbb315839c4456ba6ac029a7b8a20,4,37,35,72,27,2014-08-15 22:53:51,2014-07-29 17:46:00
3f0e642eefcbbb315839c4456ba6ac029a7b8a20...0554c1aae49a81691154a77e70b602b0f24dca81,4,9,42,51,12,2014-08-15 22:53:51,2014-07-30 18:39:37
0554c1aae49a81691154a77e70b602b0f24dca81...bf0e83732aa02c7aa08d0ccdf122116235fcfa11,2,48,16,64,15,2014-08-15 22:53:51,2014-08-14 18:33:58
bf0e83732aa02c7aa08d0ccdf122116235fcfa11...a353ed834ce529c3b4ccb8d1ea4e5b32c6415ff4,8,206,322,528,8,2014-08-15 23:03:59,2014-08-15 18:25:05
a353ed834ce529c3b4ccb8d1ea4e5b32c6415ff4...a19131494c7661d8dee04aa9a422c1f171f249e0,1,1,1,2,1,2014-08-16 00:17:55,2014-08-15 23:57:15
a19131494c7661d8dee04aa9a422c1f171f249e0...d1536e7c8bf60549096138d08953a43190c7b1a6,1,25,23,48,3,2014-08-16 21:22:56,2014-08-05 03:05:55
d1536e7c8bf60549096138d08953a43190c7b1a6...6c4d601ff610cb02943cd06a9696e41424b4eee5,1,1,24,25,2,2014-08-16 21:31:24,2014-08-05 03:07:48
6c4d601ff610cb02943cd06a9696e41424b4eee5...2a5dbbdc52c56bb738d846a63b29098783e5b389,1,2,2,4,3,2014-08-16 21:31:28,2014-08-05 03:13:15
2a5dbbdc52c56bb738d846a63b29098783e5b389...01b10d7a24b371e667dfd5b081e98a690b0fc426,1,2,3,5,3,2014-08-16 21:31:28,2014-08-05 03:14:15
01b10d7a24b371e667dfd5b081e98a690b0fc426...960a8410515b2d7d461d7c95e8a2ca3d75129087,1,10,5,15,3,2014-08-16 21:31:28,2014-08-05 03:16:06
960a8410515b2d7d461d7c95e8a2ca3d75129087...e9cd6dc055cb7bd80ae9232d8985b2bc3999135e,1,3,3,6,1,2014-08-16 21:31:29,2014-08-05 04:01:41
e9cd6dc055cb7bd80ae9232d8985b2bc3999135e...274e9c4ddfd64138d39fcf84047aabc3ccde2f0b,1,10,3,13,1,2014-08-16 21:31:29,2014-08-05 04:02:55
274e9c4ddfd64138d39fcf84047aabc3ccde2f0b...566f1015d27118d259e0886910d6b73b3cb0eb10,1,7,3,10,3,2014-08-16 21:31:29,2014-08-05 04:39:17
566f1015d27118d259e0886910d6b73b3cb0eb10...8f10dca300c7bcc55ff1613326b84b9c460ca7c2,1,21,90,111,15,2014-08-16 22:05:22,2014-08-05 05:23:55
8f10dca300c7bcc55ff1613326b84b9c460ca7c2...6251751ad7bc2f3621db538edb5a9d7313a4ce6d,1,6,2,8,2,2014-08-16 22:05:22,2014-08-05 06:32:03
6251751ad7bc2f3621db538edb5a9d7313a4ce6d...8d933bf99520fe3936e33d3ee28fd37e574b99de,1,17,9,26,4,2014-08-16 22:31:10,2014-08-05 08:07:42
8d933bf99520fe3936e33d3ee28fd37e574b99de...35134a0e237d193cd7d3995dacfdc6bf3e92635e,1,25,14,39,3,2014-08-16 22:32:24,2014-08-05 08:09:37
35134a0e237d193cd7d3995dacfdc6bf3e92635e...b493c62f6b3e4288f5dee7c8b5952e088c2e3329,1,2,1,3,1,2014-08-16 22:32:32,2014-08-08 05:15:17
b493c62f6b3e4288f5dee7c8b5952e088c2e3329...c7393093ffd55bc86c33f8b3a2fc51c6ce44c6a8,1,1,1,2,1,2014-08-16 22:32:43,2014-08-08 05:36:01
c7393093ffd55bc86c33f8b3a2fc51c6ce44c6a8...edc586f911b0b5bd1c6471b417add4d2e1820758,1,6,6,12,5,2014-08-16 22:36:32,2014-08-08 05:43:04
edc586f911b0b5bd1c6471b417add4d2e1820758...6b7b40af74d9ac19260b692a59d35b7f13a1206e,1,3,2,5,2,2014-08-16 22:38:50,2014-08-08 05:47:02
6b7b40af74d9ac19260b692a59d35b7f13a1206e...441ab5235ce394b93ff3e5f36f392f3ff21dbe58,5,18,21,39,10,2014-08-17 04:01:11,2014-08-08 18:06:59
441ab5235ce394b93ff3e5f36f392f3ff21dbe58...e6a9f9e1302c1bb8ac75b2e2b5fa9fc617862f7f,1,3,13,16,1,2014-08-17 04:01:12,2014-08-08 18:08:07
e6a9f9e1302c1bb8ac75b2e2b5fa9fc617862f7f...443b521e22f9ec7009b913a2fe78caee0a515e87,1,6,2,8,4,2014-08-17 04:01:12,2014-08-08 18:09:14
443b521e22f9ec7009b913a2fe78caee0a515e87...550965f11142ceb46c0daa7a836a54fc18d3ea18,1,3,1,4,1,2014-08-17 04:01:13,2014-08-08 18:25:48
550965f11142ceb46c0daa7a836a54fc18d3ea18...b678f314f10508da534418d69d02729e29e9975f,1,1,1,2,1,2014-08-17 04:01:13,2014-08-08 18:27:24
b678f314f10508da534418d69d02729e29e9975f...bda673f8e785f299407c8c45887f37448a0f0192,1,2,1,3,1,2014-08-17 04:01:13,2014-08-08 18:28:17
bda673f8e785f299407c8c45887f37448a0f0192...fafbd494907a8c068d79415b7ba8f42f283be521,1,3,1,4,1,2014-08-17 04:01:13,2014-08-08 18:46:21
fafbd494907a8c068d79415b7ba8f42f283be521...fb00210cb615d5ae92ff5e0f2403c2f30065eb82,1,4,2,6,3,2014-08-17 04:01:13,2014-08-08 19:04:56
fb00210cb615d5ae92ff5e0f2403c2f30065eb82...54fa16e45d8769ce6708a28388326db0eea53c7e,3,23,27,50,8,2014-08-17 04:29:51,2014-08-08 19:58:52
54fa16e45d8769ce6708a28388326db0eea53c7e...13112710e62209861886b96ffc2052fc249f65ff,2,2,3,5,2,2014-08-17 04:30:07,2014-08-08 20:06:13
13112710e62209861886b96ffc2052fc249f65ff...31ed0af74b0081906415dcefe5610e1217cc0c48,1,2,1,3,2,2014-08-17 04:30:20,2014-08-08 20:24:36
31ed0af74b0081906415dcefe5610e1217cc0c48...33ab57948c1ac86225392447afe5778af84b1617,1,24,24,48,1,2014-08-17 04:30:27,2014-08-08 20:27:55
33ab57948c1ac86225392447afe5778af84b1617...6acea1152f72a4026583897c67bea2839bc9e89e,1,1,1,2,1,2014-08-17 04:30:32,2014-08-08 20:29:55
6acea1152f72a4026583897c67bea2839bc9e89e...99d70af11cbca257561e461b795ebbf3a86fa293,1,2,2,4,2,2014-08-17 04:30:38,2014-08-08 20:30:43
99d70af11cbca257561e461b795ebbf3a86fa293...a1341223c084c8188671bb8d6ea1608490b66f9f,1,3,2,5,2,2014-08-17 04:30:44,2014-08-08 20:32:41
a1341223c084c8188671bb8d6ea1608490b66f9f...b9b1aa7797df4a36c902c44e165d6cbcdcaea1c5,1,11,13,24,1,2014-08-17 04:30:49,2014-08-08 20:33:34
b9b1aa7797df4a36c902c44e165d6cbcdcaea1c5...50e16a67bb08202dacbc7df8e6414d9dd48a0f3d,1,5,5,10,4,2014-08-17 04:31:17,2014-08-08 20:38:41
50e16a67bb08202dacbc7df8e6414d9dd48a0f3d...8b77161702601e0029a3a29f491f8dbd5946ffb8,1,1,6,7,2,2014-08-17 04:31:20,2014-08-08 20:39:53
8b77161702601e0029a3a29f491f8dbd5946ffb8...bf2e238418af8e79b492661b9e348622e47bf105,1,3,3,6,2,2014-08-17 04:31:35,2014-08-08 21:17:00
bf2e238418af8e79b492661b9e348622e47bf105...503dcb0281e3cd03a1506214459dc743fe6dd928,1,2,2,4,2,2014-08-17 04:31:41,2014-08-10 01:30:11
503dcb0281e3cd03a1506214459dc743fe6dd928...1e8698b33e61b1a196f05f42856a2da4590a10e1,1,29,29,58,13,2014-08-17 04:50:27,2014-08-10 01:47:38
1e8698b33e61b1a196f05f42856a2da4590a10e1...3e0a2e1f3367a5b4ae7d8de6cff559f522aacfba,1,17,6,23,5,2014-08-17 04:51:06,2014-08-10 07:55:03
3e0a2e1f3367a5b4ae7d8de6cff559f522aacfba...abb17cce8b459e4646d1c2a2428b691c3d95fb4c,1,2,7,9,2,2014-08-17 04:51:17,2014-08-10 08:06:26
abb17cce8b459e4646d1c2a2428b691c3d95fb4c...fbd48845e0e88e9935f82fe4c9f686ad78b5d924,1,4,1,5,2,2014-08-17 04:51:27,2014-08-10 11:17:36
fbd48845e0e88e9935f82fe4c9f686ad78b5d924...e58d65a520cfbc630cbfbc248479416777ca16b2,1,17,14,31,4,2014-08-17 04:51:33,2014-08-10 12:01:44
e58d65a520cfbc630cbfbc248479416777ca16b2...bdd853cb83839eef9901af164293611eaa23ee2c,1,38,31,69,9,2014-08-17 04:51:40,2014-08-10 12:21:04
bdd853cb83839eef9901af164293611eaa23ee2c...215d9545dc512644342275ed970cfe0075335163,1,16,14,30,8,2014-08-17 04:51:49,2014-08-10 12:27:25
215d9545dc512644342275ed970cfe0075335163...13d113c522f124b91a1fd8606c22bbd399abf121,3,33,26,59,9,2014-08-17 04:51:56,2014-08-10 13:14:16
13d113c522f124b91a1fd8606c22bbd399abf121...36e35b2cb17c5ff7c43746d9ac0a259f77ff494e,1,8,4,12,2,2014-08-17 04:52:04,2014-08-10 13:29:17
36e35b2cb17c5ff7c43746d9ac0a259f77ff494e...a09fa356416c033a52666f3becf00524ecff3a03,1,5,2,7,1,2014-08-17 04:52:10,2014-08-10 14:08:57
a09fa356416c033a52666f3becf00524ecff3a03...d302ea0cfade2787d7cc500398b7dcd3e4eff945,5,21,29,50,14,2014-08-17 04:59:38,2014-08-10 14:46:27
d302ea0cfade2787d7cc500398b7dcd3e4eff945...de3f238764ced90f4d5dccd1c0715e5fb8f8c307,1,1,1,2,1,2014-08-17 05:00:10,2014-08-17 05:00:10
de3f238764ced90f4d5dccd1c0715e5fb8f8c307...d208ba254442649d35f96c76bcd9e47326ec59f3,1,4,1,5,1,2014-08-17 05:06:14,2014-08-11 18:26:53
d208ba254442649d35f96c76bcd9e47326ec59f3...0a738ce1760f38efe45e79aa133442be09b56803,1,3,1,4,2,2014-08-17 05:08:59,2014-08-12 01:05:45
0a738ce1760f38efe45e79aa133442be09b56803...7d96ab0d132d923ec3e3a212aaf9d79f1d4a02de,1,7,5,12,3,2014-08-17 05:09:21,2014-08-12 01:24:42
7d96ab0d132d923ec3e3a212aaf9d79f1d4a02de...301463a2e249011d7cb696c6cf34254f8317a706,1,3,1,4,1,2014-08-17 05:09:29,2014-08-12 01:53:08
301463a2e249011d7cb696c6cf34254f8317a706...e822e9061c2a605649d91abbd641f757e2829275,1,9,7,16,4,2014-08-17 05:09:38,2014-08-12 02:08:55
e822e9061c2a605649d91abbd641f757e2829275...645625cf349a4be57691a7bf418b2386b4c1a53d,1,2,7,9,1,2014-08-17 05:09:48,2014-08-12 04:06:52
645625cf349a4be57691a7bf418b2386b4c1a53d...0605e612e13fa94b073d1ddb96f70209af293e44,1,1,1,2,1,2014-08-17 05:09:56,2014-08-12 16:25:10
0605e612e13fa94b073d1ddb96f70209af293e44...c1cb341c8770c7b1a1dbdc4ce19b8115b1182298,1,1,1,2,1,2014-08-17 05:10:04,2014-08-12 18:43:50
c1cb341c8770c7b1a1dbdc4ce19b8115b1182298...e3f26b5a6b3f181c9608214172bcd341ddad9254,1,1,2,3,2,2014-08-17 05:29:00,2014-08-17 05:29:00
e3f26b5a6b3f181c9608214172bcd341ddad9254...b24e38142787541d9f4670d1c618aa405b76cfc9,1,2,5,7,3,2014-08-17 05:32:35,2014-08-17 05:32:35
b24e38142787541d9f4670d1c618aa405b76cfc9...187b1b8ef45babd86afa853dc9321cd23160096e,1,1,1,2,1,2014-08-17 21:49:42,2014-08-17 20:41:18
187b1b8ef45babd86afa853dc9321cd23160096e...6133c6321428c1c71b37ce5b543b4abf0080ab3b,2,9,5,14,6,2014-08-18 01:13:30,2014-07-13 02:06:33
6133c6321428c1c71b37ce5b543b4abf0080ab3b...65ec0ab70a506b4b52fadecf444a7146d8d425e8,1,1,1,2,1,2014-08-18 17:34:07,2014-08-18 16:19:42
65ec0ab70a506b4b52fadecf444a7146d8d425e8...22bece731148443d423f71a2fa8364012073866d,3,11,2,13,4,2014-08-18 18:00:23,2014-08-18 17:51:21
22bece731148443d423f71a2fa8364012073866d...5feb9ab0f8033118ef23cc1f5a4bfa6dea6d4f65,1,1,1,2,1,2014-08-18 20:12:11,2014-08-17 03:51:38
5feb9ab0f8033118ef23cc1f5a4bfa6dea6d4f65...e1c85d1f98e63f3a029cca71e8001b7d4ecb4c3e,1,2,2,4,1,2014-08-18 20:23:09,2014-08-15 12:42:22
e1c85d1f98e63f3a029cca71e8001b7d4ecb4c3e...c093c43b1f16faa9402b1d325d5a34d8c7ccc12c,1,7,3,10,1,2014-08-18 20:32:09,2014-08-15 12:25:26
c093c43b1f16faa9402b1d325d5a34d8c7ccc12c...b0571517c5db009084f93fc70927a16b4ba01d20,1,1,8,9,1,2014-08-19 04:20:09,2014-08-17 05:59:12
b0571517c5db009084f93fc70927a16b4ba01d20...d05f27e274c41c33eebf4fe8035715d3f6596069,1,10,3,13,3,2014-08-19 04:20:09,2014-08-12 19:34:21
d05f27e274c41c33eebf4fe8035715d3f6596069...b5f7970be5950580bde4de0002a578daf3ae3aac,2,9,6,15,6,2014-08-19 04:20:10,2014-08-13 00:00:50
b5f7970be5950580bde4de0002a578daf3ae3aac...f8f7a1df34560222cb5d2e18d4be996f5553815a,1,2,4,6,1,2014-08-19 04:20:10,2014-08-13 04:37:50
f8f7a1df34560222cb5d2e18d4be996f5553815a...2ef25887ef64445585f76e52af692ecf3c0e2974,1,9,5,14,2,2014-08-19 04:20:10,2014-08-18 14:58:52
2ef25887ef64445585f76e52af692ecf3c0e2974...08eb05583bf39c63fef43b4faf29c61360699c81,1,8,8,16,7,2014-08-19 04:20:10,2014-08-13 05:12:53
08eb05583bf39c63fef43b4faf29c61360699c81...5cec4612c49dc729df2b82f5f8c0d60b6e9f60d5,1,1,1,2,1,2014-08-19 04:20:10,2014-08-13 05:16:50
5cec4612c49dc729df2b82f5f8c0d60b6e9f60d5...27d4a4f0cad3abdff4a1df9c7314b4adb7eeb2c9,1,5,1,6,3,2014-08-19 04:20:10,2014-08-13 06:43:59
27d4a4f0cad3abdff4a1df9c7314b4adb7eeb2c9...b5714ce1dfca743733e84431161fc888fdcad24a,1,3,3,6,3,2014-08-19 04:20:11,2014-08-13 06:46:25
b5714ce1dfca743733e84431161fc888fdcad24a...0d608d041f37a659d8d8ba7a9b688e132587035d,5,12,10,22,9,2014-08-19 04:20:11,2014-08-13 07:16:33
0d608d041f37a659d8d8ba7a9b688e132587035d...6f5fc557ad47184571942a7f0753af1b8f30c739,1,2,4,6,2,2014-08-19 04:20:11,2014-08-13 23:02:21
6f5fc557ad47184571942a7f0753af1b8f30c739...fecfc5b09feb7e4079364013b0beb6bf204ade2a,1,6,3,9,4,2014-08-19 04:20:11,2014-08-01 22:48:41
fecfc5b09feb7e4079364013b0beb6bf204ade2a...cc16340e88b3fccf604fcfa3809d27c7cb98ef88,1,9,10,19,6,2014-08-19 04:20:11,2014-08-01 22:55:15
cc16340e88b3fccf604fcfa3809d27c7cb98ef88...a17578ad3db5d1375aec1d601055ab718eeafd10,1,7,5,12,2,2014-08-19 04:20:11,2014-08-01 23:10:09
a17578ad3db5d1375aec1d601055ab718eeafd10...472019fb321f9273f5c347458adc370745397801,1,6,5,11,4,2014-08-19 04:20:11,2014-08-02 06:44:37
472019fb321f9273f5c347458adc370745397801...f7fde04160c977ccaf89ebe4ef6bc66900616a87,1,6,6,12,6,2014-08-19 04:20:12,2014-08-03 00:46:54
f7fde04160c977ccaf89ebe4ef6bc66900616a87...ece6ef479c741f17fc217d743cad64c516dbed27,1,22,10,32,4,2014-08-19 04:20:12,2014-08-03 23:00:25
ece6ef479c741f17fc217d743cad64c516dbed27...bf1a57ad4822bb152fdd4d2fb54c0689e466481b,2,0,11,11,3,2014-08-19 04:20:12,2014-08-11 15:50:08
bf1a57ad4822bb152fdd4d2fb54c0689e466481b...1bdca93d708ce9441b26d00e564210755395edf7,1,16,3,19,3,2014-08-19 04:20:12,2014-08-18 17:39:33
1bdca93d708ce9441b26d00e564210755395edf7...77d3e7544642396d868aa49b85f0c027e8057bd7,2,9,1,10,2,2014-08-19 04:50:44,2013-09-29 20:19:07
77d3e7544642396d868aa49b85f0c027e8057bd7...28b54bbfbf958f3a0249f41d8643f4bcf8e3cab5,1,10,0,10,1,2014-08-19 04:50:54,2014-08-19 04:49:54
28b54bbfbf958f3a0249f41d8643f4bcf8e3cab5...63249a0aaf2673596e2b8b6fa7d670891c0a0178,1,0,1,1,1,2014-08-19 16:38:31,2014-08-19 13:06:48
63249a0aaf2673596e2b8b6fa7d670891c0a0178...e3a2ecf0dbd05c797b4fa8003ef851669c19692c,5,10,12,22,9,2014-08-19 17:57:50,2014-08-19 17:56:27
e3a2ecf0dbd05c797b4fa8003ef851669c19692c...b8e54ef57267e0c4a82eec5abe39370b9fad10d4,2,7,4,11,4,2014-08-19 18:24:48,2014-08-16 09:25:09
b8e54ef57267e0c4a82eec5abe39370b9fad10d4...d250dd43a3402a82a2ddc009f39d5696e890d65d,1,3,3,6,1,2014-08-19 18:30:11,2014-08-15 11:35:47
d250dd43a3402a82a2ddc009f39d5696e890d65d...6fdaa3d5a6030eec006eabc9fca7c1875014945c,1,5,5,10,5,2014-08-19 20:50:48,2014-08-19 20:34:22
6fdaa3d5a6030eec006eabc9fca7c1875014945c...b7e82a33eee03fc683f982c6ee13d15d88b07f67,2,6,1,7,2,2014-08-19 21:10:54,2014-08-19 20:44:48
b7e82a33eee03fc683f982c6ee13d15d88b07f67...5b77e30c1ac49be7b079b82527a5631f68bac904,2,27,7,34,4,2014-08-19 23:16:02,2014-08-19 22:49:35
5b77e30c1ac49be7b079b82527a5631f68bac904...94b5c9f00edff7fa631d09316ceb9c7fd4c6426a,2,23,47,70,26,2014-08-19 23:57:31,2014-08-18 11:02:38
94b5c9f00edff7fa631d09316ceb9c7fd4c6426a...7eae29e5ab478ccb7e02fee8311f8b99ea1d165d,1,1,1,2,1,2014-08-19 23:57:31,2014-08-18 11:04:31
7eae29e5ab478ccb7e02fee8311f8b99ea1d165d...f02f7d9c15deea9c5d83212301e2a5e18223bbe5,2,32,0,32,2,2014-08-20 00:24:34,2014-07-18 03:30:28
f02f7d9c15deea9c5d83212301e2a5e18223bbe5...d18b2819768e467897dee7bc223876ca23ea71b1,2,15,0,15,2,2014-08-20 01:31:02,2014-08-20 01:17:48
d18b2819768e467897dee7bc223876ca23ea71b1...8863b9d04c722b278fa93c5d66ad1e578ad6eb1f,1,2,2,4,2,2014-08-20 03:56:57,2014-08-03 23:05:41
8863b9d04c722b278fa93c5d66ad1e578ad6eb1f...39f6e229c229db9fbd107d98f453b6daeb6c9f9d,1,1,1,2,1,2014-08-20 13:31:17,2014-08-20 13:28:58
39f6e229c229db9fbd107d98f453b6daeb6c9f9d...00d5fde49ca50eb777ac61541bdd9cc68fd52f20,1,4,2,6,1,2014-08-20 14:48:29,2014-07-16 11:05:54
00d5fde49ca50eb777ac61541bdd9cc68fd52f20...05791c0133a8422f0a95c240488b99d6c81110de,1,2,0,2,2,2014-08-20 17:43:14,2014-08-20 16:27:07
05791c0133a8422f0a95c240488b99d6c81110de...a9d227120dc2d433372da415a450e56b783b57a0,2,3,1,4,2,2014-08-20 20:37:45,2014-08-19 23:07:13
a9d227120dc2d433372da415a450e56b783b57a0...14b3db369edd0bb6ac6f318d66f3b422a07757f9,1,1,1,2,1,2014-08-20 22:44:23,2014-08-19 09:23:34
14b3db369edd0bb6ac6f318d66f3b422a07757f9...36230194be8aa417b0af33d618060829a75c4c5f,2,14,1,15,3,2014-08-20 23:27:49,2014-08-07 14:13:01
36230194be8aa417b0af33d618060829a75c4c5f...0872388a1b88b8637fdb0fb1ebbee269bead0508,2,6,2,8,2,2014-08-21 00:26:50,2014-08-20 23:23:13
0872388a1b88b8637fdb0fb1ebbee269bead0508...a603e202cc7e048c2ab6f12dee1cc8f277cf6f4f,2,13,3,16,2,2014-08-21 01:49:54,2014-08-21 01:22:19
a603e202cc7e048c2ab6f12dee1cc8f277cf6f4f...1339c11e36d9b9d23b26b98e90b523ab99901cfe,5,125,183,308,51,2014-08-21 17:52:08,2014-08-02 02:39:40
1339c11e36d9b9d23b26b98e90b523ab99901cfe...dfbe69c45a391b52d7c539243d92fdbb128c17fd,1,1,1,2,1,2014-08-21 19:29:02,2014-08-21 19:19:59
dfbe69c45a391b52d7c539243d92fdbb128c17fd...787c5a76dcb035277d008584ee8f908c83f213f0,3,194,52,246,25,2014-08-21 22:41:19,2014-08-21 22:34:02
787c5a76dcb035277d008584ee8f908c83f213f0...b674003f41d3a4f2727737574ea429a280e7b89a,2,6,2,8,4,2014-08-21 22:54:44,2014-08-19 20:11:42
b674003f41d3a4f2727737574ea429a280e7b89a...09b298705f74255aff55bb7e4ba200c4200d712d,3,91,0,91,3,2014-08-21 22:58:54,2014-08-01 01:34:47
09b298705f74255aff55bb7e4ba200c4200d712d...a7fb357fa122e0a056ce1de838a2dfaf1ebc2953,2,37,3,40,7,2014-08-21 23:11:57,2014-07-18 01:44:48
a7fb357fa122e0a056ce1de838a2dfaf1ebc2953...09de7b5db466498becb295ecf5c1d0a698b1512c,3,17,4,21,5,2014-08-21 23:31:50,2014-07-29 18:36:13
09de7b5db466498becb295ecf5c1d0a698b1512c...fdeaa74c6c5567a0cbf209eb4cb8adb4d8938d33,1,492,0,492,1,2014-08-21 23:49:01,2014-08-21 00:24:08
fdeaa74c6c5567a0cbf209eb4cb8adb4d8938d33...693e846add5089d0e516604ae4a109e445fd3664,2,7,1,8,2,2014-08-22 01:17:21,2014-08-21 23:40:36
693e846add5089d0e516604ae4a109e445fd3664...b8b8411b1518edd7493678a3d90a991ab64123a5,1,5,3,8,2,2014-08-22 02:28:15,2014-08-19 15:26:53
b8b8411b1518edd7493678a3d90a991ab64123a5...9352bdfdafd78d976472f853f9e1173745d31730,1,1,1,2,1,2014-08-22 03:33:21,2014-08-22 03:05:57
9352bdfdafd78d976472f853f9e1173745d31730...066c049957a8af2fe449040eca2f1cb499655e32,1,1,1,2,1,2014-08-22 07:35:35,2014-08-22 07:35:35
066c049957a8af2fe449040eca2f1cb499655e32...d713ad1b6607389649fbb8d12ac103565b02a1d4,2,31,1,32,2,2014-08-22 13:50:22,2014-08-22 13:26:41
d713ad1b6607389649fbb8d12ac103565b02a1d4...0c4997f7d87e85f838a0827b54930cd377c8dcc6,1,1,1,2,1,2014-08-22 18:46:45,2014-08-22 18:46:45
0c4997f7d87e85f838a0827b54930cd377c8dcc6...252e8b5733c1dc40fa0249dfc7a8f1ab8f1fb96b,3,52,194,246,24,2014-08-22 18:48:29,2014-08-22 18:47:13
252e8b5733c1dc40fa0249dfc7a8f1ab8f1fb96b...642af96c488aca5b348aab4d373978f267f8128a,1,1,1,2,1,2014-08-22 20:52:06,2014-08-22 01:41:00
642af96c488aca5b348aab4d373978f267f8128a...75c4cbf81fcd6d49656d3cb044e59e5fd24e0479,2,111,95,206,24,2014-08-22 21:00:58,2014-08-22 18:43:58
75c4cbf81fcd6d49656d3cb044e59e5fd24e0479...ffbd276d6def6ff35bfdb30553346e985f4a0de6,5,255,15,270,17,2014-08-22 21:02:13,2014-08-22 18:44:36
ffbd276d6def6ff35bfdb30553346e985f4a0de6...1a2caad922fe6162e7f329bc2e632e6b5246f032,6,39,142,181,33,2014-08-22 22:30:34,2014-08-14 22:13:50
1a2caad922fe6162e7f329bc2e632e6b5246f032...b93601e691e6f5e042b1d26e04bd330fab9e1120,1,260,0,260,1,2014-08-22 22:57:26,2014-08-22 22:45:54
b93601e691e6f5e042b1d26e04bd330fab9e1120...fc8d6d75ab899870499d7ff740c717c3ce643423,1,52,0,52,1,2014-08-22 22:57:26,2014-08-22 22:52:26
fc8d6d75ab899870499d7ff740c717c3ce643423...525a8f851ee5c7a138493c6da7cf09df35c37fcd,1,2,2,4,2,2014-08-23 06:07:38,2014-08-23 06:06:33
525a8f851ee5c7a138493c6da7cf09df35c37fcd...8ac90357a66ae0c62dbfe6db2c6eaf1d600ecc65,2,39,0,39,3,2014-08-23 09:38:24,2014-08-09 20:55:21
8ac90357a66ae0c62dbfe6db2c6eaf1d600ecc65...a9371a1875962e09900a183bc88e4d634e2d37ef,1,1,1,2,1,2014-08-23 20:37:07,2014-08-23 20:11:18
a9371a1875962e09900a183bc88e4d634e2d37ef...addfc567fd9b5c32913db18c8031fdd1b0bb3f71,1,1,1,2,1,2014-08-24 17:14:20,2014-08-24 16:11:06
addfc567fd9b5c32913db18c8031fdd1b0bb3f71...fdf9989f7cf1ed81982a788b75a338ac33334571,1,12,9,21,4,2014-08-25 18:02:48,2014-08-23 03:50:53
fdf9989f7cf1ed81982a788b75a338ac33334571...2e3a7fd3e95e07ba0b9ab215a8b882cb7bb160bf,1,1,1,2,1,2014-08-25 19:28:33,2014-07-18 14:43:28
2e3a7fd3e95e07ba0b9ab215a8b882cb7bb160bf...b728030be0dbdd0639bd49091b774d4665eecb27,1,2,2,4,1,2014-08-26 02:53:08,2014-08-26 02:41:05
b728030be0dbdd0639bd49091b774d4665eecb27...42f28751e0dea552457da3f32b4d107ec6fc8818,1,6,2,8,3,2014-08-26 03:16:21,2014-08-26 02:56:50
42f28751e0dea552457da3f32b4d107ec6fc8818...5e15b11509888f42b5929086cfc45ac0246d1fdf,1,2,2,4,2,2014-08-26 05:37:44,2014-08-26 05:00:53
5e15b11509888f42b5929086cfc45ac0246d1fdf...7ef2921caee2be24102e153f22ea79d679f582cb,1,1,1,2,1,2014-08-26 07:58:54,2014-08-26 07:45:10
7ef2921caee2be24102e153f22ea79d679f582cb...d0b41890bf1c60c3abf242fc2bd30d530650b765,1,75,75,150,70,2014-08-26 14:29:47,2014-08-26 14:29:47
d0b41890bf1c60c3abf242fc2bd30d530650b765...2f4437b3a149eafb899f25933bd6c713b167d10e,8,400,69,469,149,2014-08-26 15:43:18,2014-08-16 01:16:43
2f4437b3a149eafb899f25933bd6c713b167d10e...bf0f5502b1bbfddc5cdd2f138efd9188b8c652a9,16,312,268,580,188,2014-08-26 15:44:25,2014-08-16 03:45:29
bf0f5502b1bbfddc5cdd2f138efd9188b8c652a9...23da614043fe5dcf0be132b86466eecb11c766a2,2,200,124,324,50,2014-08-26 15:45:00,2014-08-16 15:21:56
23da614043fe5dcf0be132b86466eecb11c766a2...a6bd4bc866a18f860c7548fa1b3f6d4c2a953416,3,19,3,22,5,2014-08-26 19:09:26,2014-08-21 19:23:24
a6bd4bc866a18f860c7548fa1b3f6d4c2a953416...1b331f3729364d6cd6a547d60698cdeb24635138,2,19,2,21,3,2014-08-26 19:09:26,2014-08-21 18:31:31
1b331f3729364d6cd6a547d60698cdeb24635138...0462b688f92fc2bc566aaf4d84fc7fd9fd0da7ee,3,48,3,51,4,2014-08-26 19:33:51,2014-08-21 23:02:04
0462b688f92fc2bc566aaf4d84fc7fd9fd0da7ee...9da8d63ef43d5b8e90a3b390c6449878fa2f92ea,1,15,11,26,5,2014-08-26 21:11:37,2014-08-26 20:55:15
9da8d63ef43d5b8e90a3b390c6449878fa2f92ea...feed7d694441419b99e876188c36aeff1ae05090,1,1,1,2,1,2014-08-26 21:19:25,2014-08-26 20:47:34
feed7d694441419b99e876188c36aeff1ae05090...4739b1d9daebfd094b6181c5f2cb52ff71e31c61,2,12,1,13,4,2014-08-26 21:20:49,2014-08-25 18:09:58
4739b1d9daebfd094b6181c5f2cb52ff71e31c61...29f0b568debab7810752969d363d337099e96cdc,2,7,7,14,7,2014-08-26 21:20:55,2014-08-26 17:38:28
29f0b568debab7810752969d363d337099e96cdc...cc6fc199f5abaacdf781aa03634337d776eb0fc9,2,85,2,87,14,2014-08-26 21:21:02,2014-08-25 18:10:59
cc6fc199f5abaacdf781aa03634337d776eb0fc9...5f90340abb78aa08dde4876328bcc00e46232e46,2,109,72,181,67,2014-08-26 21:21:05,2014-08-26 20:15:28
5f90340abb78aa08dde4876328bcc00e46232e46...4ebbd7e210a45619a953b5e4b0ceba0e2ece59e2,1,2,12,14,1,2014-08-26 22:00:34,2014-08-26 16:54:16
4ebbd7e210a45619a953b5e4b0ceba0e2ece59e2...5a1a0c96220101b5e040f0755e5eb401e2c73f65,1,1,1,2,1,2014-08-26 22:00:35,2014-08-26 16:55:48
5a1a0c96220101b5e040f0755e5eb401e2c73f65...0e44ac2de01fc66e970133d98962b62ef8be6fbd,1,11,9,20,6,2014-08-26 22:00:35,2014-08-26 20:40:44
0e44ac2de01fc66e970133d98962b62ef8be6fbd...db044c408a7f8082758b96ab739348810c36e15a,3,264,104,368,48,2014-08-26 22:30:53,2014-08-19 04:04:59
db044c408a7f8082758b96ab739348810c36e15a...2ae4f40be1803d999ca2a8cc30ec17ff19ea6d86,4,483,31,514,36,2014-08-26 22:31:01,2014-07-19 15:21:31
2ae4f40be1803d999ca2a8cc30ec17ff19ea6d86...e94d454b840f6cc55a440741382b407836ad245b,2,141,0,141,6,2014-08-27 01:33:44,2014-08-22 20:38:21
e94d454b840f6cc55a440741382b407836ad245b...ea6fc6e69c2a2aa213c71ed4e917a0d54d064e4c,3,121,8,129,7,2014-08-27 01:42:47,2014-08-22 22:17:55
ea6fc6e69c2a2aa213c71ed4e917a0d54d064e4c...fe697527b4a09cdba3e741ce2be6b47a8a426aec,1,1,1,2,1,2014-08-27 12:38:35,2014-08-27 12:35:31
fe697527b4a09cdba3e741ce2be6b47a8a426aec...a4520a745d917c77f1d12cdbce48272c643f7255,1,0,2,2,2,2014-08-27 20:56:13,2014-08-27 18:15:39
a4520a745d917c77f1d12cdbce48272c643f7255...d8a02f998708684bef6559f308046d418e615dc7,1,1,1,2,1,2014-08-27 20:57:36,2014-08-27 20:57:36
d8a02f998708684bef6559f308046d418e615dc7...2efe1c2e7b7886f3c0afc91f835247428d9c27d7,1,1,1,2,1,2014-08-27 21:14:44,2014-08-27 21:07:18
2efe1c2e7b7886f3c0afc91f835247428d9c27d7...3be00df495f6eed3b3d9587ebab1fdd633e94e08,4,43,4,47,8,2014-08-27 23:36:53,2014-08-26 22:23:47
3be00df495f6eed3b3d9587ebab1fdd633e94e08...a70e2833ea276107b11aafea96ef4a6724ad4d83,11,187,42,229,29,2014-08-28 03:19:19,2014-08-12 16:40:17
a70e2833ea276107b11aafea96ef4a6724ad4d83...4bca4c44b95a7435722605a750804043f2960160,3,82,17,99,7,2014-08-28 03:19:29,2014-08-28 00:31:07
4bca4c44b95a7435722605a750804043f2960160...3660fd0912d3ccf6def8c9f02d8d4c0621c8d91f,5,84,50,134,16,2014-08-28 03:45:58,2014-08-23 06:37:34
3660fd0912d3ccf6def8c9f02d8d4c0621c8d91f...a1e5cd5fe3906ebee8c400247a1f793d3e2239fb,2,71,33,104,14,2014-08-28 03:45:58,2014-08-23 06:37:34
a1e5cd5fe3906ebee8c400247a1f793d3e2239fb...d4dd5dfa1824b9b2412946cace025b8cab8a064d,1,2,0,2,1,2014-08-28 03:45:58,2014-08-27 00:55:04
d4dd5dfa1824b9b2412946cace025b8cab8a064d...fce8915f397b1f0ffdc99d7a63a72fee740e03a8,1,18,11,29,13,2014-08-28 03:45:58,2014-08-27 00:55:46
fce8915f397b1f0ffdc99d7a63a72fee740e03a8...41c1b8858f02c7310bfabdd545ebb28e90eb4258,4,63,1,64,7,2014-08-28 03:45:58,2014-08-23 06:37:34
41c1b8858f02c7310bfabdd545ebb28e90eb4258...be8ef25a5a68fc08a75e9129f6af06ab9c2946dc,1,0,3,3,1,2014-08-28 03:45:58,2014-08-23 19:45:44
be8ef25a5a68fc08a75e9129f6af06ab9c2946dc...ac68ee49c1d1582e2e152c919032394900c7feb3,1,5,2,7,3,2014-08-28 03:45:58,2014-08-26 21:39:22
ac68ee49c1d1582e2e152c919032394900c7feb3...2ab0d5d370fb0ae4e7037eb4ed85d96b71303556,6,49,49,98,18,2014-08-28 03:45:58,2014-08-25 07:28:51
2ab0d5d370fb0ae4e7037eb4ed85d96b71303556...b3ec730c423bac12dda90a647bce139660b9c631,2,11,3,14,4,2014-08-28 03:45:58,2014-08-26 17:59:39
b3ec730c423bac12dda90a647bce139660b9c631...36a547b852a7d254535e2d203cffe10f2e5c5617,2,2,22,24,3,2014-08-28 03:45:59,2014-08-26 19:15:50
36a547b852a7d254535e2d203cffe10f2e5c5617...cec9ecf951d9adbe6afc65b8ed28fc835b60b7a7,1,3,3,6,3,2014-08-28 03:45:59,2014-08-27 00:21:05
cec9ecf951d9adbe6afc65b8ed28fc835b60b7a7...2218e6f8cd505322d79f350375cc7b17dc62f6fc,1,7,7,14,4,2014-08-28 03:45:59,2014-08-27 00:22:26
2218e6f8cd505322d79f350375cc7b17dc62f6fc...e0489abd8d9e4971ae23cc38805a92d227d1f3a1,2,37,11,48,12,2014-08-28 03:45:59,2014-08-27 21:06:27
e0489abd8d9e4971ae23cc38805a92d227d1f3a1...563be7e8798a0963cd1fa5ff3b4d92f1d2bf066b,1,7,7,14,7,2014-08-28 03:45:59,2014-08-27 21:37:54
563be7e8798a0963cd1fa5ff3b4d92f1d2bf066b...c6bde520067ec66e7360a58feba5cc4fa18718da,4,48,13,61,5,2014-08-28 03:45:59,2014-08-27 20:16:39
c6bde520067ec66e7360a58feba5cc4fa18718da...97a1b399b727ebb7f5c4b3ae690c4641731943df,2,8,1,9,2,2014-08-28 15:31:21,2014-08-28 15:25:15
97a1b399b727ebb7f5c4b3ae690c4641731943df...474a0337bd1c995fd31f53936a8a5a6ed4d10989,1,6,0,6,1,2014-08-28 16:31:02,2014-08-28 16:30:29
474a0337bd1c995fd31f53936a8a5a6ed4d10989...ab878a6c038f47b95f3a7e85a4fdb599e0c73e63,2,23,31,54,5,2014-08-28 18:25:03,2014-08-22 01:18:06
ab878a6c038f47b95f3a7e85a4fdb599e0c73e63...2137542e0975212bea893bb94e1ef87e56b8db07,1,1,1,2,1,2014-08-28 18:36:22,2014-08-28 03:37:02
2137542e0975212bea893bb94e1ef87e56b8db07...719c747cd892ee933e7e414a7dc97e657b88317d,3,86,21,107,7,2014-08-28 18:49:31,2014-08-27 22:29:39
719c747cd892ee933e7e414a7dc97e657b88317d...3b5d75c021e21fa6ec4dc6c47b8eafa55680ea63,2,22,1,23,3,2014-08-28 18:58:31,2014-06-12 19:01:29
3b5d75c021e21fa6ec4dc6c47b8eafa55680ea63...46343c603db6192daf5303b92eb664749326c7e6,2,16,6,22,5,2014-08-28 19:34:42,2013-09-21 19:42:12
46343c603db6192daf5303b92eb664749326c7e6...85880a64900fa22a61feb926bf52de0965332ca5,15,327,16,343,24,2014-08-28 21:25:50,2014-06-10 05:20:47
85880a64900fa22a61feb926bf52de0965332ca5...49455a75dc01b6b57304f14fafd476de6c2b29be,1,3,1,4,1,2014-08-28 21:55:53,2014-07-08 09:17:48
49455a75dc01b6b57304f14fafd476de6c2b29be...cb73a37c7cae5cdebadf7b3ddd44c5a452495e4e,2,46,11,57,8,2014-08-29 00:34:11,2014-08-28 18:47:41
cb73a37c7cae5cdebadf7b3ddd44c5a452495e4e...5f3f25a1a6f9d4f2a66e2700df3b9c5606f1c255,3,194,50,244,24,2014-08-29 03:46:52,2014-08-21 22:34:02
5f3f25a1a6f9d4f2a66e2700df3b9c5606f1c255...cd21602d5b1650d8be373618cb7320d697e32c4d,2,12,4,16,3,2014-08-29 05:24:46,2014-08-28 23:25:36
cd21602d5b1650d8be373618cb7320d697e32c4d...7a36d4953316a1833bcd787c5763d0cc78eb0b1e,1,7,7,14,4,2014-08-29 11:04:05,2014-08-26 19:55:07
7a36d4953316a1833bcd787c5763d0cc78eb0b1e...c5f1ca3d917cb89c2da19a946734685d2ea2b07b,1,1,1,2,1,2014-08-29 15:59:07,2014-08-27 21:22:01
c5f1ca3d917cb89c2da19a946734685d2ea2b07b...77ce5b89f97aa83c3eb1fe2e19375ef00a822015,2,95,4,99,3,2014-08-29 17:20:03,2014-06-24 13:13:59
77ce5b89f97aa83c3eb1fe2e19375ef00a822015...1eda18365a348c9597aafba9d195d345e4f13d1e,2,78,4,82,8,2014-08-29 17:29:47,2014-08-28 20:31:33
1eda18365a348c9597aafba9d195d345e4f13d1e...c09f619318e936820ac5e85c667ea41603343900,1,8,8,16,7,2014-08-29 18:00:50,2014-08-26 19:32:18
c09f619318e936820ac5e85c667ea41603343900...9057ed21ac8dcff6a69671ab8944957bd84f5d3c,1,1,0,1,1,2014-08-29 18:35:22,2014-08-22 18:51:46
9057ed21ac8dcff6a69671ab8944957bd84f5d3c...4f9ac078d561b45deb1ca44dfb04fb58f97c7f27,1,2,3,5,1,2014-08-29 18:38:08,2014-08-29 17:48:58
4f9ac078d561b45deb1ca44dfb04fb58f97c7f27...6f7018d52fa4f9f9c7fa8e3035317d1239efb20f,1,15,2,17,4,2014-08-29 19:24:49,2014-08-29 03:42:07
6f7018d52fa4f9f9c7fa8e3035317d1239efb20f...c2aaddbe4b21348aab8c13a78cdd6aaee846ae4e,2,11,3,14,4,2014-08-29 19:32:51,2014-08-29 17:57:12
c2aaddbe4b21348aab8c13a78cdd6aaee846ae4e...2ae10f67fcde3e172f695956301ef796b68a50c2,2,12,4,16,4,2014-08-29 19:33:43,2014-08-29 17:59:12
2ae10f67fcde3e172f695956301ef796b68a50c2...c9b0bfecc99837af1c97792b3ca3408ba182b0bb,2,116,112,228,14,2014-08-29 19:58:13,2014-08-29 18:05:14
c9b0bfecc99837af1c97792b3ca3408ba182b0bb...92576743eec0cef5ffdd701b83f72a61e6489c3b,2,22,22,44,6,2014-08-29 20:17:32,2014-08-29 18:23:25
92576743eec0cef5ffdd701b83f72a61e6489c3b...0604bb7b7a6156e33679396e805e327662d9a178,2,7,4,11,3,2014-08-29 20:46:37,2014-08-23 17:57:31
0604bb7b7a6156e33679396e805e327662d9a178...b9007df59093e266c501b32ed7f99d9561026713,1,62,60,122,51,2014-08-29 22:05:50,2014-08-29 17:14:32
b9007df59093e266c501b32ed7f99d9561026713...22948807e324eb0b182b15b31045dc306a9f3231,5,204,134,338,52,2014-08-29 22:19:51,2014-08-29 21:37:05
22948807e324eb0b182b15b31045dc306a9f3231...550ba01b325fc29460030fc9c24fa00269dec2a9,2,25,1,26,3,2014-08-29 23:13:11,2014-08-29 23:12:38
550ba01b325fc29460030fc9c24fa00269dec2a9...271572c20eda84554e647d66bedd3437482ede82,1,8,3,11,2,2014-08-30 00:57:23,2014-08-29 23:58:53
271572c20eda84554e647d66bedd3437482ede82...202aed77700b44777516d453ca88196b1b916191,1,321,0,321,1,2014-08-30 01:22:46,2014-08-30 01:12:48
202aed77700b44777516d453ca88196b1b916191...b2902446eb41591f5d868846d3c5bad3a888bcba,2,1,3,4,3,2014-08-30 04:54:32,2014-08-30 04:54:32
b2902446eb41591f5d868846d3c5bad3a888bcba...2e0982c1ec714df4eb9668de968b20bb0db3852b,1,1,1,2,1,2014-08-31 18:03:59,2014-08-31 18:03:59
2e0982c1ec714df4eb9668de968b20bb0db3852b...c5b32f14d577384c3a4c01d1af16628cdfacc808,1,43,0,43,2,2014-09-01 22:15:57,2014-09-01 21:55:18
c5b32f14d577384c3a4c01d1af16628cdfacc808...e0d49a31098522573dd57d230a17db084123148b,1,1,1,2,1,2014-09-02 07:04:00,2014-09-02 06:33:27
e0d49a31098522573dd57d230a17db084123148b...9525d0ad1d417c481b315059f36cc041c9b415d0,1,19,4,23,2,2014-09-02 14:37:29,2014-09-02 14:37:29
9525d0ad1d417c481b315059f36cc041c9b415d0...fc706d13d80bb40eb3dade58ea4b92dca33ce4e7,3,1,10,11,4,2014-09-02 16:54:46,2014-09-02 16:10:43
fc706d13d80bb40eb3dade58ea4b92dca33ce4e7...995a8d39afd4636c2616015e00d3d7878bba23b7,1,1,1,2,1,2014-09-02 17:21:41,2014-09-02 17:21:41
995a8d39afd4636c2616015e00d3d7878bba23b7...bf59d7274f4a667c5b19e6d4ba5ed2730ca2fe42,2,22,11,33,5,2014-09-02 17:41:32,2014-08-29 20:32:21
bf59d7274f4a667c5b19e6d4ba5ed2730ca2fe42...203ea10f9ea49d7e29569a4232d3b2a666307cd8,2,46,22,68,8,2014-09-02 17:42:01,2014-08-29 20:31:37
203ea10f9ea49d7e29569a4232d3b2a666307cd8...d5686ffc48317e8456da289d19c51fdea3f39747,1,68,68,136,24,2014-09-02 19:10:23,2014-09-02 19:10:23
d5686ffc48317e8456da289d19c51fdea3f39747...29714a34ab14a5d80b135e1b83eda5c566af603a,1,17,18,35,15,2014-09-02 19:43:28,2014-08-31 00:52:24
29714a34ab14a5d80b135e1b83eda5c566af603a...63fb60de86bd743791c590b27d9ab2f704cb8a57,1,1,1,2,1,2014-09-02 20:01:41,2014-08-30 14:22:07
63fb60de86bd743791c590b27d9ab2f704cb8a57...d2d8117edd7322073f6ae3d44bf6c3a9839eae28,1,18,2,20,2,2014-09-02 20:35:17,2014-08-16 09:14:26
d2d8117edd7322073f6ae3d44bf6c3a9839eae28...ce25ac83b404ad57f553040bb9e1374e571be47c,1,2,0,2,1,2014-09-02 20:46:01,2014-08-24 18:56:47
ce25ac83b404ad57f553040bb9e1374e571be47c...44cf2e1904e45ec35b4358c8a04b42f1881820a7,1,20,20,40,5,2014-09-02 21:51:16,2014-09-02 21:49:59
44cf2e1904e45ec35b4358c8a04b42f1881820a7...d9cdb105fc37040be82c8b59d117084857df0369,3,140,0,140,3,2014-09-02 22:21:36,2014-08-28 02:50:17
d9cdb105fc37040be82c8b59d117084857df0369...ac535549c94ec1f6d12bba6b7fb70ce781541471,2,2,2,4,2,2014-09-03 10:38:44,2014-09-03 10:38:44
ac535549c94ec1f6d12bba6b7fb70ce781541471...0f806d9659b5b89a4bd9493364bc36398677e939,2,0,14,14,2,2014-09-03 11:38:11,2014-08-30 05:03:13
0f806d9659b5b89a4bd9493364bc36398677e939...c3064f728c5def99a424eb970fb041cd3ca9729d,1,17,15,32,11,2014-09-03 12:20:16,2014-08-30 01:07:14
c3064f728c5def99a424eb970fb041cd3ca9729d...953ee22f76f8c1137949ed07f36fafc5bbfeb7fe,2,29,2,31,2,2014-09-03 12:30:33,2014-08-30 11:24:30
953ee22f76f8c1137949ed07f36fafc5bbfeb7fe...5b2a386b1f8d276d0bc74080e60ab4927bbf0eda,4,0,4,4,4,2014-09-03 12:32:15,2014-08-28 14:14:44
5b2a386b1f8d276d0bc74080e60ab4927bbf0eda...300bffc4fe1ef664576abb39d2f6671b11813986,12,12,36,48,17,2014-09-03 12:37:03,2014-08-29 19:22:43
300bffc4fe1ef664576abb39d2f6671b11813986...821da26e18ab4dca7d5676525c35baf1ffc40776,1,2,2,4,2,2014-09-03 13:56:49,2014-09-03 13:56:49
821da26e18ab4dca7d5676525c35baf1ffc40776...5dd9f138c7789fa7844a939a69a44367461503a5,2,8,4,12,4,2014-09-03 14:37:46,2014-09-03 14:37:46
5dd9f138c7789fa7844a939a69a44367461503a5...f211419be6ff2181f01a66a12fbb1e55664ea898,1,8,6,14,3,2014-09-03 16:21:07,2014-09-03 16:00:53
f211419be6ff2181f01a66a12fbb1e55664ea898...007e3208355d3ea50d070392294fb81efe2ce622,1,66,421,487,37,2014-09-03 16:22:13,2014-09-03 04:53:32
007e3208355d3ea50d070392294fb81efe2ce622...b474c36e4112402f9d39b743d704d761d8135cc4,1,7,0,7,1,2014-09-03 17:13:25,2014-09-03 16:28:36
b474c36e4112402f9d39b743d704d761d8135cc4...1b4a2c8feec3379af2a118a996d08f3861a559c5,1,1,1,2,1,2014-09-03 19:00:35,2014-09-03 11:21:54
1b4a2c8feec3379af2a118a996d08f3861a559c5...095627ad17c7f85f723a74c38ce96674140592ea,1,3,0,3,1,2014-09-03 20:04:50,2014-08-29 15:33:10
095627ad17c7f85f723a74c38ce96674140592ea...e96be5bfb866b8197d18a2f4bb47175a868925d3,1,2,2,4,2,2014-09-03 20:17:46,2014-08-28 18:40:51
e96be5bfb866b8197d18a2f4bb47175a868925d3...9a09f1d96dd55424b2d82456ec5624ee0e0b34d6,1,1,1,2,1,2014-09-03 20:24:06,2014-08-10 10:16:00
9a09f1d96dd55424b2d82456ec5624ee0e0b34d6...7f87988e415a56745e01538ddef33bd4b9b79a4d,1,2,2,4,2,2014-09-03 20:24:56,2014-08-28 18:57:52
7f87988e415a56745e01538ddef33bd4b9b79a4d...0ee0ce18c1a2d80064363c033403607ed31a6a37,1,2,2,4,1,2014-09-03 20:31:06,2014-08-06 21:34:16
0ee0ce18c1a2d80064363c033403607ed31a6a37...73157b0a0b9369481d22c7222359cce6fbff267e,1,6,4,10,3,2014-09-03 20:57:49,2014-08-11 09:13:25
73157b0a0b9369481d22c7222359cce6fbff267e...ae952fbf0be925a48743d1c925ffe4e31a42c280,2,10,1,11,3,2014-09-03 21:59:53,2014-08-23 15:10:21
ae952fbf0be925a48743d1c925ffe4e31a42c280...86c6be82e5508762912eb08e228410f5c1ed4d91,1,60,25,85,17,2014-09-04 11:28:18,2014-09-04 11:28:18
86c6be82e5508762912eb08e228410f5c1ed4d91...6d1e7cdc51c074139639e870b66997fb0df4523f,2,35,0,35,2,2014-09-04 11:30:09,2014-09-04 09:57:42
6d1e7cdc51c074139639e870b66997fb0df4523f...712299c2a24390e74cd5c20f51cb1d78f0233b6f,1,5,4,9,2,2014-09-04 11:49:14,2014-09-04 11:41:47
712299c2a24390e74cd5c20f51cb1d78f0233b6f...02bada130e5e0aa51bf9a00d9c5421f2bbbd4405,1,5,5,10,2,2014-09-04 12:17:21,2014-09-04 12:00:05
02bada130e5e0aa51bf9a00d9c5421f2bbbd4405...3952408cf141fdaa884e99845ec2f4077cea74d4,2,18,4,22,10,2014-09-04 13:23:04,2014-09-04 13:23:04
3952408cf141fdaa884e99845ec2f4077cea74d4...7b273a2c978d5f5ef374f5335afab0ca7d8cfd4d,2,54,14,68,11,2014-09-04 15:45:36,2014-09-03 19:02:46
7b273a2c978d5f5ef374f5335afab0ca7d8cfd4d...25541c1f876a16c892d71faae11727bec7bba98c,3,86,2,88,5,2014-09-04 15:45:46,2014-09-03 19:12:47
25541c1f876a16c892d71faae11727bec7bba98c...b3502835039178296b730b7526e5666b66ba9156,2,155,39,194,25,2014-09-04 15:45:53,2014-09-03 19:42:44
b3502835039178296b730b7526e5666b66ba9156...088545c1856ce1c3ec3416965dff65077a6e0523,2,83,22,105,14,2014-09-04 15:45:59,2014-09-04 14:21:17
088545c1856ce1c3ec3416965dff65077a6e0523...976da56d506bb70c6168f3de759aaa00a880c8c9,1,98,0,98,3,2014-09-04 15:46:05,2014-09-04 14:48:49
976da56d506bb70c6168f3de759aaa00a880c8c9...43e0dc2dfe703676f12e6750c338ee0af3cc3696,3,22,8,30,3,2014-09-04 15:49:25,2014-09-04 15:48:35
43e0dc2dfe703676f12e6750c338ee0af3cc3696...b01a03c1b9c574f44a855dd4252af7d748539b63,25,25,1,26,26,2014-09-04 15:49:25,2014-09-04 15:49:16
b01a03c1b9c574f44a855dd4252af7d748539b63...adb5c6d6cc76b928436743707727ab0974d6810b,2,29,4,33,9,2014-09-04 16:55:03,2014-04-19 08:50:54
adb5c6d6cc76b928436743707727ab0974d6810b...48e66cff4017ddf94bd0d5c17d10da319ea56ffd,1,1,1,2,1,2014-09-04 21:49:52,2014-08-26 09:17:01
48e66cff4017ddf94bd0d5c17d10da319ea56ffd...99d95f1639b64c39231448d77209676b54e6f0be,1,2,3,5,3,2014-09-04 22:09:18,2014-08-28 20:45:21
99d95f1639b64c39231448d77209676b54e6f0be...c3a58a9f34919f121587540e03ecbd51b25198d4,2,17,2,19,4,2014-09-05 00:16:11,2014-09-05 00:16:11
c3a58a9f34919f121587540e03ecbd51b25198d4...3471fedfbc7a30a061bed4b512d9ef8dd5620f36,1,0,7,7,1,2014-09-05 09:23:52,2014-09-04 21:25:36
3471fedfbc7a30a061bed4b512d9ef8dd5620f36...cbdaabfb59bf3348588d5b581f2754e0f9f034a4,2,14,1,15,2,2014-09-05 10:56:09,2014-09-05 09:48:49
cbdaabfb59bf3348588d5b581f2754e0f9f034a4...8b5d33dab89ce36647ed6203d76d9e0a65c52332,2,2,2,4,2,2014-09-05 17:49:18,2014-09-05 17:02:57
8b5d33dab89ce36647ed6203d76d9e0a65c52332...b3b672130d4d1c6f13bdf7e58be76b2aafea2497,3,15,2,17,3,2014-09-05 17:51:17,2014-09-02 22:04:19
b3b672130d4d1c6f13bdf7e58be76b2aafea2497...e322cd9b3b8b47b95c9de3edf631bb46f919c492,2,27,19,46,8,2014-09-05 19:15:34,2014-08-29 21:02:16
e322cd9b3b8b47b95c9de3edf631bb46f919c492...0f3adece3bb19f0350ab23fc740b96cd3ace8f2c,1,1,1,2,1,2014-09-06 00:21:00,2014-09-05 17:48:38
0f3adece3bb19f0350ab23fc740b96cd3ace8f2c...b95dabb881292e2f24aa4d1e139ad7194db68167,1,2,5,7,1,2014-09-07 20:42:05,2014-08-31 06:48:33
b95dabb881292e2f24aa4d1e139ad7194db68167...432aa9e4e4e799d15271b8b82bb55cab6793f37f,1,4,4,8,4,2014-09-07 20:52:00,2014-08-31 20:55:04
432aa9e4e4e799d15271b8b82bb55cab6793f37f...907b8c1675865ac38dd055f3f304272e68b233d0,1,2,2,4,2,2014-09-07 20:53:16,2014-08-31 20:59:55
907b8c1675865ac38dd055f3f304272e68b233d0...1cfd49ddf0f126baa79cbc3022d11cf4ba3d59d6,1,6,12,18,4,2014-09-07 20:55:33,2014-09-02 02:48:57
1cfd49ddf0f126baa79cbc3022d11cf4ba3d59d6...43c67ccd167aecc3549e1b7f7d100956204e3ed4,1,11,11,22,11,2014-09-07 21:02:31,2014-09-02 03:42:35
43c67ccd167aecc3549e1b7f7d100956204e3ed4...f6aa1c55616b34215f562e0445e436210860ef04,1,5,1,6,2,2014-09-07 21:56:11,2014-08-30 06:11:04
f6aa1c55616b34215f562e0445e436210860ef04...40308e5935a3ad55542f6eea23b8a7e4fab3aadd,2,1468,586,2054,310,2014-09-08 11:05:11,2014-09-08 08:50:47
40308e5935a3ad55542f6eea23b8a7e4fab3aadd...be3b62cd09e770861bf446edc0ed5932ba50f160,8,205,16,221,15,2014-09-08 11:05:11,2014-09-08 09:14:17
be3b62cd09e770861bf446edc0ed5932ba50f160...cddd48fe207257080ed23837dd334e1bf7aceaea,1,2,3,5,2,2014-09-08 11:05:11,2014-09-08 09:14:17
cddd48fe207257080ed23837dd334e1bf7aceaea...0f3ea45d738ca6d09c4ceedf2e06fdf344054b5a,1,1,11,12,2,2014-09-08 11:05:11,2014-09-08 09:14:17
0f3ea45d738ca6d09c4ceedf2e06fdf344054b5a...41cec4d68056268a5977399976738cecc343a653,1,13,13,26,3,2014-09-08 14:58:47,2014-09-08 14:58:47
41cec4d68056268a5977399976738cecc343a653...df9e60c8e7453cdca2cb5a4fa48f3981ecc23a7d,2,77,8,85,7,2014-09-08 15:06:16,2014-06-15 20:09:59
df9e60c8e7453cdca2cb5a4fa48f3981ecc23a7d...9bedeb3353969fba631ad9164edea3c38059fbda,1,11,7,18,3,2014-09-08 15:15:02,2014-09-03 06:15:09
9bedeb3353969fba631ad9164edea3c38059fbda...2a5af502c566650234a1ca627445af7240bd3932,1,11,11,22,5,2014-09-08 17:40:20,2014-09-03 16:28:04
2a5af502c566650234a1ca627445af7240bd3932...6046e14bd22491168116e61ffdf5fd3fed5f135c,4,369,340,709,87,2014-09-08 22:10:02,2014-09-05 00:50:26
6046e14bd22491168116e61ffdf5fd3fed5f135c...fee8f1c07bcd657de52a104860ead370385b1059,1,20,39,59,21,2014-09-09 09:14:15,2014-09-09 09:01:37
fee8f1c07bcd657de52a104860ead370385b1059...66103c8277d8f9559ba87c2a2ee3432e9cce3398,1,3,2,5,2,2014-09-09 09:21:11,2014-09-09 09:21:11
66103c8277d8f9559ba87c2a2ee3432e9cce3398...732d72d991cb3213cb89cb98764b06326c14fd13,1,22,21,43,2,2014-09-09 14:19:46,2014-09-09 00:16:45
732d72d991cb3213cb89cb98764b06326c14fd13...01ef12884b92dc481776e27f8da972c3bf62eeee,1,79,81,160,77,2014-09-09 14:19:46,2014-09-09 10:30:42
01ef12884b92dc481776e27f8da972c3bf62eeee...f33a938545b39c24d0ba4782f80516839706dd22,1,6,3,9,3,2014-09-09 14:19:47,2014-09-09 10:42:27
f33a938545b39c24d0ba4782f80516839706dd22...ed6373300028deda9a0878b3975699d183c1f75c,2,39,3,42,4,2014-09-09 14:19:47,2014-09-09 00:52:36
ed6373300028deda9a0878b3975699d183c1f75c...73916108f8a7b78ce3e146a6b66d5099bb1c0ca9,1,1,0,1,1,2014-09-09 15:43:49,2014-09-08 22:58:02
73916108f8a7b78ce3e146a6b66d5099bb1c0ca9...719f42e949040a03dfbfc22170976322daf99f2c,1,1,0,1,1,2014-09-09 15:43:49,2014-09-08 23:02:36
719f42e949040a03dfbfc22170976322daf99f2c...6639ca9d6bc00a6e3a31e54c50474361ae3561c6,2,52,0,52,2,2014-09-09 16:45:15,2014-09-08 18:39:41
6639ca9d6bc00a6e3a31e54c50474361ae3561c6...bd8ad0fbe81f6c280baa26a596d78e58fc7842e6,2,40,3,43,5,2014-09-09 17:39:39,2014-09-08 23:27:26
bd8ad0fbe81f6c280baa26a596d78e58fc7842e6...06fa2868deee5c26788b336f987bd9eb9e2a56a8,2,0,35,35,2,2014-09-09 18:05:34,2014-09-09 18:05:34
06fa2868deee5c26788b336f987bd9eb9e2a56a8...7235329ff81f3be9cfd92ca568b2bc232a28566d,1,12,3,15,4,2014-09-09 19:38:43,2014-09-09 19:38:18
7235329ff81f3be9cfd92ca568b2bc232a28566d...456dcb020b899c9c36044751cf1ec8379804fbae,3,290,0,290,3,2014-09-09 20:15:23,2014-09-05 05:11:30
456dcb020b899c9c36044751cf1ec8379804fbae...b3b476db7d34bc2f8b099ab5b993b1e899b9cffd,2,43,29,72,11,2014-09-09 20:15:23,2014-09-03 05:13:51
b3b476db7d34bc2f8b099ab5b993b1e899b9cffd...90cd1e0a1b243702a25f91c6507382fa581a5f1e,3,5,0,5,3,2014-09-09 20:36:35,2014-09-09 20:36:35
90cd1e0a1b243702a25f91c6507382fa581a5f1e...9ad7d745ab5f6f8f43b51cacd7a238df9562246f,2,86,42,128,20,2014-09-09 20:46:24,2014-09-09 17:56:42
9ad7d745ab5f6f8f43b51cacd7a238df9562246f...f94d551529b7c970c38b29e3073cec4e7f6b0e00,2,30,6,36,2,2014-09-09 20:46:28,2014-09-09 19:01:15
f94d551529b7c970c38b29e3073cec4e7f6b0e00...64c3b745fba0792166f30e057f9251f263d80dac,2,38,0,38,2,2014-09-09 20:46:28,2014-09-09 19:03:27
64c3b745fba0792166f30e057f9251f263d80dac...3c538c1d21c43422c7b4cd9b69cb67981bce2b87,2,88,2,90,5,2014-09-09 20:48:17,2014-07-24 00:04:51
3c538c1d21c43422c7b4cd9b69cb67981bce2b87...c54990ca6e1edfa02a6d1e08819ec8c3ef8fc11e,1,210,0,210,1,2014-09-09 22:45:51,2014-09-09 22:14:15
c54990ca6e1edfa02a6d1e08819ec8c3ef8fc11e...d1318f7dc7045ad0fa23c7e2e5a31e653b4b24b4,1,1,4,5,2,2014-09-09 23:21:44,2014-09-09 23:20:20
d1318f7dc7045ad0fa23c7e2e5a31e653b4b24b4...fb39e322ea49f31fab7f42e5dba9883fc68aa3ae,1,18,0,18,1,2014-09-09 23:21:52,2014-09-09 23:21:16
fb39e322ea49f31fab7f42e5dba9883fc68aa3ae...f0d3722e07d711b887e2c5c7136d1ac25794d4fd,1,2,2,4,2,2014-09-10 13:43:05,2014-09-10 13:30:28
f0d3722e07d711b887e2c5c7136d1ac25794d4fd...d307e77ff3a3c4170011fe88dbf562a69a31ccd2,1,2,1,3,1,2014-09-10 14:02:38,2014-09-10 14:02:38
d307e77ff3a3c4170011fe88dbf562a69a31ccd2...14183833f9106a3ab4c7621bcf964fc2b5cc96e6,1,0,1,1,1,2014-09-10 17:53:15,2014-09-10 17:53:15
14183833f9106a3ab4c7621bcf964fc2b5cc96e6...9314719d1eb5f480b877f5513f6e0e474edcb67d,3,71,17,88,17,2014-09-10 18:16:42,2014-09-10 17:25:35
9314719d1eb5f480b877f5513f6e0e474edcb67d...56f09f0b44048b62f964d29db4d3d2630662f6ea,3,53,22,75,7,2014-09-10 18:29:17,2014-08-15 04:11:33
56f09f0b44048b62f964d29db4d3d2630662f6ea...1d36cff22e5bf7464805c8761289b14d7e301da3,1,6,0,6,2,2014-09-10 18:39:57,2014-08-22 13:18:39
1d36cff22e5bf7464805c8761289b14d7e301da3...a0d6e648893d212aec922c3b80d26d568d76b0e3,1,3,2,5,3,2014-09-10 18:44:08,2014-08-21 20:46:32
a0d6e648893d212aec922c3b80d26d568d76b0e3...3e51b84bc19f7e6acc61cb536ddcdbfed307c831,2,20,12,32,10,2014-09-10 18:45:36,2014-09-10 18:00:50
3e51b84bc19f7e6acc61cb536ddcdbfed307c831...1a1ef62903c8fdf4ceb81277d966a8eff67f0a96,2,113,6,119,11,2014-09-10 21:19:28,2014-08-29 20:44:08
1a1ef62903c8fdf4ceb81277d966a8eff67f0a96...9cd272ac60eeac305e208a0712d9c03a666ec076,2,16,2,18,4,2014-09-10 21:52:39,2014-09-10 21:52:32
9cd272ac60eeac305e208a0712d9c03a666ec076...1c8a7459c90efc77b1a0987f976e3bddab4565fe,2,28,5,33,20,2014-09-10 22:19:30,2014-09-05 12:32:54
1c8a7459c90efc77b1a0987f976e3bddab4565fe...eb4afd45f77d7d67744e01ce63a831c13c2b22e8,1,1,1,2,1,2014-09-10 22:29:56,2014-09-05 22:53:22
eb4afd45f77d7d67744e01ce63a831c13c2b22e8...a3962f0df3f9b8382b47952f9e4fcb48a4cc098b,2,4,5,9,3,2014-09-10 22:31:08,2014-09-10 11:20:31
a3962f0df3f9b8382b47952f9e4fcb48a4cc098b...bd8a9127749def7933e2df2005e5620288c8089b,1,9,1,10,1,2014-09-10 23:04:46,2014-09-10 20:39:35
bd8a9127749def7933e2df2005e5620288c8089b...871f321f5029cbad57f1f89cc3b7c87639e483b1,7,12314,15,12329,16,2014-09-11 00:15:22,2014-09-09 19:12:22
871f321f5029cbad57f1f89cc3b7c87639e483b1...6a96a8200aff4749bc84c44a1e8018b09d9ebdb4,724,32728,1218,33946,1410,2014-09-11 00:15:22,2014-09-11 00:13:57
6a96a8200aff4749bc84c44a1e8018b09d9ebdb4...0eadee5c24ebc856f773a75184a82fd315f6915b,1,1,1,2,1,2014-09-11 19:10:24,2014-09-10 13:37:33
0eadee5c24ebc856f773a75184a82fd315f6915b...58adaa66346eeaf54cab5d7de9936e17aadb0d4c,1,2,2,4,1,2014-09-11 19:38:49,2014-09-11 19:12:27
58adaa66346eeaf54cab5d7de9936e17aadb0d4c...5cf1d89692b58f652b3186dc2a09c7affe443e75,1,2,3,5,2,2014-09-11 19:57:16,2014-09-11 13:33:29
5cf1d89692b58f652b3186dc2a09c7affe443e75...67919c808771a9b185a9d552cd32a90748d36666,1,10,7,17,6,2014-09-12 13:17:26,2014-09-10 04:42:36
67919c808771a9b185a9d552cd32a90748d36666...6af2ff2c7d6dfef07f477ab2649ab610ea82b2aa,1,6,7,13,4,2014-09-12 14:06:12,2014-09-12 14:06:12
6af2ff2c7d6dfef07f477ab2649ab610ea82b2aa...c1f2c3ea83f578dd65005e235aa58799de8e7646,1,0,1,1,1,2014-09-12 14:08:24,2014-09-12 14:08:24
c1f2c3ea83f578dd65005e235aa58799de8e7646...d13b4bd1f5f2abaad00f5d1bf81f79549a8d0e46,2,10,17,27,4,2014-09-12 18:47:58,2014-09-12 12:25:41
d13b4bd1f5f2abaad00f5d1bf81f79549a8d0e46...3d367eb7b906ec1e9bee2c97d8e79a31301be62b,25,860,926,1786,115,2014-09-12 22:05:37,2014-09-12 22:04:35
3d367eb7b906ec1e9bee2c97d8e79a31301be62b...63761fdac1980f0eb8fc1599bfc1d358ff199200,7,100,28,128,9,2014-09-12 22:05:37,2014-09-12 22:04:35
63761fdac1980f0eb8fc1599bfc1d358ff199200...19871d28cfcd587dec6594c008ca742db8cb56a5,4,34,7,41,3,2014-09-12 22:05:37,2014-09-12 22:04:35
19871d28cfcd587dec6594c008ca742db8cb56a5...30354c58fe2bd371df364f7a3f55b270692a4051,2,110,6,116,10,2014-09-13 20:11:49,2013-11-08 02:38:04
30354c58fe2bd371df364f7a3f55b270692a4051...7ffe52417154a66f7b81159cb0609d728abb6ec4,1,7,1,8,3,2014-09-13 20:11:54,2014-07-21 03:30:01
7ffe52417154a66f7b81159cb0609d728abb6ec4...e7ac08a0619d2bdc91c125d341772b4fbc0d5a78,2,27,1,28,2,2014-09-14 16:12:15,2014-09-14 14:04:26
e7ac08a0619d2bdc91c125d341772b4fbc0d5a78...ea94e63e35a9313a5d918dc37394d2bad6c4204c,1,17,17,34,12,2014-09-15 00:27:39,2014-09-14 19:43:42
ea94e63e35a9313a5d918dc37394d2bad6c4204c...fb7e05cc38e5030edf32cf673acdd879f69eed28,3,3,3,6,3,2014-09-15 13:57:18,2014-09-15 13:55:18
fb7e05cc38e5030edf32cf673acdd879f69eed28...55244390c805ce95c967fa75759a971c2cd0ce09,2,3,3,6,3,2014-09-15 13:57:18,2014-09-15 13:55:42
55244390c805ce95c967fa75759a971c2cd0ce09...8173382c4ba1adb3646be52923b0839b4cf7c1f4,2,15,38,53,6,2014-09-15 13:57:18,2014-09-15 13:57:07
8173382c4ba1adb3646be52923b0839b4cf7c1f4...06280a14b4edaf730966e1169639a22e7428a152,1,0,1,1,1,2014-09-15 16:09:37,2014-09-15 16:09:37
06280a14b4edaf730966e1169639a22e7428a152...cfdd16157eaac0e29d83d7ce38ec7adcb172621b,1,2,0,2,1,2014-09-15 19:27:31,2014-09-15 18:25:29
cfdd16157eaac0e29d83d7ce38ec7adcb172621b...fd2d6c02f9654e753d3655a3377a9534f7a54de3,2,15,6,21,9,2014-09-16 11:25:33,2014-08-19 15:00:17
fd2d6c02f9654e753d3655a3377a9534f7a54de3...ec9c0d76fe7af2561fb0f5c4396a7d3edad2f2ce,1,1,1,2,1,2014-09-16 12:12:58,2014-09-14 21:00:42
ec9c0d76fe7af2561fb0f5c4396a7d3edad2f2ce...fca6be71274e537c7df86ae9e27a3bd1597e9ffa,6,386,24,410,29,2014-09-16 12:12:58,2014-09-10 05:03:10
fca6be71274e537c7df86ae9e27a3bd1597e9ffa...8900390add1400ad49173416247d7312628f3013,1,3,3,6,3,2014-09-16 12:12:59,2014-09-15 20:40:16
8900390add1400ad49173416247d7312628f3013...76741a9393160b2f247c14a1e592badd12d4e061,1,10,11,21,4,2014-09-16 12:12:59,2014-09-14 20:40:53
76741a9393160b2f247c14a1e592badd12d4e061...7c6026437afe2ea4bdf824cbe022d4849264bb70,1,49,4,53,6,2014-09-16 12:12:59,2014-09-16 12:12:24
7c6026437afe2ea4bdf824cbe022d4849264bb70...46274102454038ee7fd4543a32166e9bbbc98904,2,32,0,32,2,2014-09-16 19:36:05,2014-09-11 22:32:45
46274102454038ee7fd4543a32166e9bbbc98904...798ed3be213275d22d014b3b57c6c6aff5430c13,1,79,11,90,6,2014-09-16 21:31:04,2014-09-16 21:28:54
798ed3be213275d22d014b3b57c6c6aff5430c13...14a92a5982bc516ab7fffe3e170bc33c6efc7308,1,16,0,16,1,2014-09-16 21:52:25,2014-09-16 21:52:06
14a92a5982bc516ab7fffe3e170bc33c6efc7308...8428a0adeff0d23feea6446e4bd284b5daa14a12,1,2,2,4,2,2014-09-17 17:56:21,2014-09-16 12:54:46
8428a0adeff0d23feea6446e4bd284b5daa14a12...f7a4a70c28daa19239a4350eac3092cab73aa666,1,1,1,2,1,2014-09-17 18:11:24,2014-09-17 18:11:08
f7a4a70c28daa19239a4350eac3092cab73aa666...f3884df0a90c35945e9137562e39506b290f5be2,1,1,0,1,1,2014-09-18 15:43:17,2014-09-13 21:06:06
f3884df0a90c35945e9137562e39506b290f5be2...4f9dc44f88d61609837b30696ecb286aa43af0a9,1,2,2,4,2,2014-09-18 20:04:47,2014-09-18 18:19:15
4f9dc44f88d61609837b30696ecb286aa43af0a9...0ba864184b5b6b6c81621b2b270239bb32b8c02a,1,1,1,2,1,2014-09-18 21:59:54,2014-09-18 21:54:58
0ba864184b5b6b6c81621b2b270239bb32b8c02a...3c53b28cc20689271f6a97a4a23af2c7b2d95330,1,3,1,4,1,2014-09-18 22:51:07,2014-09-17 17:46:17
3c53b28cc20689271f6a97a4a23af2c7b2d95330...38e0ab9bd884812a6e37474cd4dadf7b75e77cb1,1,1,1,2,1,2014-09-18 22:53:56,2014-09-16 19:47:09
38e0ab9bd884812a6e37474cd4dadf7b75e77cb1...efbb365533346837a7950ea016429560bd83b6d3,1,5,5,10,4,2014-09-18 22:55:51,2014-09-18 17:14:43
efbb365533346837a7950ea016429560bd83b6d3...80b0909927f3e8ef3c0c183c8f3ccdeb23074ffb,1,2,2,4,1,2014-09-18 23:00:25,2014-09-17 01:07:06
80b0909927f3e8ef3c0c183c8f3ccdeb23074ffb...ffc32b4e42754906e5dd29ec3841df3f8406956c,1,1,1,2,1,2014-09-18 23:02:26,2014-09-18 07:37:23
ffc32b4e42754906e5dd29ec3841df3f8406956c...27b3ea4d3240962a7e85fd93f378bba4784f338d,1,1,1,2,1,2014-09-18 23:08:27,2014-09-18 18:57:39
27b3ea4d3240962a7e85fd93f378bba4784f338d...25082b3439580071e8c593af621bf202b3691f9e,1,1,1,2,1,2014-09-18 23:09:56,2014-09-16 07:39:34
25082b3439580071e8c593af621bf202b3691f9e...8b8f6f512446abbd986cb5a0da3adbc494988115,1,1,1,2,1,2014-09-18 23:12:00,2014-09-15 11:45:31
8b8f6f512446abbd986cb5a0da3adbc494988115...d1434c999a66c6bb915ee1a8b091e497d288d940,4,791,4,795,9,2014-09-18 23:17:14,2014-07-25 17:15:19
d1434c999a66c6bb915ee1a8b091e497d288d940...4c5c762378c77a56978815570211d28389dcd098,1,1,1,2,2,2014-09-19 18:26:06,2014-09-04 07:54:00
4c5c762378c77a56978815570211d28389dcd098...373d7c95d9042123204c07c74be5815b2fc09318,1,1,1,2,1,2014-09-19 18:36:43,2014-09-13 20:33:15
373d7c95d9042123204c07c74be5815b2fc09318...bd41bd594cb9646c5090c54de0bbb144ac3e46b5,1,2,2,4,2,2014-09-19 20:24:04,2014-09-09 10:41:25
bd41bd594cb9646c5090c54de0bbb144ac3e46b5...25d0eff3e6bbed32aa772f126fbd8392eb2faa50,1,2,2,4,2,2014-09-19 20:36:08,2014-09-09 15:35:04
25d0eff3e6bbed32aa772f126fbd8392eb2faa50...02169d49577c9435793a2ad7c5caa7ebcfffb20f,1,1,1,2,1,2014-09-19 20:55:31,2014-09-10 08:24:33
02169d49577c9435793a2ad7c5caa7ebcfffb20f...f0ee3353112fd84a48cf3214174536ab19e5823d,1,4,0,4,1,2014-09-19 21:24:48,2014-09-10 17:56:18
f0ee3353112fd84a48cf3214174536ab19e5823d...0702aef7eedf2d86a00ffc11a1f02c21a8968e30,1,10,0,10,1,2014-09-19 21:24:48,2014-09-11 17:11:24
0702aef7eedf2d86a00ffc11a1f02c21a8968e30...deafb5e5459fce863d9254bfe621df18dd457648,1,2,1,3,1,2014-09-19 21:35:51,2014-09-19 21:35:51
deafb5e5459fce863d9254bfe621df18dd457648...bf2c55ea297cc55786593dd4100468b7103df0ca,1,12,1,13,2,2014-09-19 21:40:05,2014-09-19 21:36:15
bf2c55ea297cc55786593dd4100468b7103df0ca...729129b461f5175c7650599d528f4f58a5544aec,1,13,13,26,3,2014-09-19 21:42:48,2014-09-19 21:42:48
729129b461f5175c7650599d528f4f58a5544aec...f0c94ea292d214c873eaa82a901ca5c2abc26f66,1,2,2,4,2,2014-09-19 21:45:14,2014-09-19 21:45:14
f0c94ea292d214c873eaa82a901ca5c2abc26f66...8f9c4daca5e40bf91492c1c897bad4f8804ddeb1,1,1,1,2,1,2014-09-19 21:53:48,2014-09-19 21:53:48
8f9c4daca5e40bf91492c1c897bad4f8804ddeb1...ad28baaa6ccf152930d9a4a7c85056e607d6242d,2,118,151,269,24,2014-09-19 22:31:48,2014-09-19 17:13:44
ad28baaa6ccf152930d9a4a7c85056e607d6242d...3686f45398ddd45e7a155f825821664cabaf9e16,1,7,6,13,1,2014-09-20 00:19:57,2014-09-19 23:42:43
3686f45398ddd45e7a155f825821664cabaf9e16...6e7fbe77c9812e395c9039774084cf5cf8a05281,1,0,3,3,1,2014-09-22 00:59:20,2014-09-22 00:48:04
6e7fbe77c9812e395c9039774084cf5cf8a05281...df8d9507aaf8882b87117c9117b17119e6a9d738,1,0,3,3,1,2014-09-22 17:27:43,2014-09-21 11:55:40
df8d9507aaf8882b87117c9117b17119e6a9d738...17ecf84b90d4ba0a7f0f9343bfce9cd130c5bd10,1,1,1,2,1,2014-09-22 18:35:10,2014-09-20 04:56:04
17ecf84b90d4ba0a7f0f9343bfce9cd130c5bd10...c59bee5d21a6c409ea9583f92abeb2c3fa825661,1,5,4,9,1,2014-09-22 18:40:30,2014-09-19 04:10:21
c59bee5d21a6c409ea9583f92abeb2c3fa825661...f1a75a445c500ac25980b8cfd51d9f9c81e613b1,1,2,2,4,2,2014-09-22 20:07:19,2014-09-19 19:32:17
f1a75a445c500ac25980b8cfd51d9f9c81e613b1...728832ec857a8caa1e47adc9880c883cb74612e4,1,1,1,2,1,2014-09-22 20:12:27,2014-09-22 11:52:07
728832ec857a8caa1e47adc9880c883cb74612e4...6b05105c085e59a8963dcdb1166c9193315725f8,1,0,3,3,3,2014-09-22 20:14:49,2014-09-19 04:53:51
6b05105c085e59a8963dcdb1166c9193315725f8...a591e8b8d302efefd67bf0d5c4bad300a5f3aded,6,5,16,21,8,2014-09-22 21:09:48,2014-09-04 21:51:02
a591e8b8d302efefd67bf0d5c4bad300a5f3aded...4b83f6ca2c15bd65fe2b3894a02c04f9967fbff4,2,51,23,74,21,2014-09-22 21:50:08,2014-09-01 19:25:43
4b83f6ca2c15bd65fe2b3894a02c04f9967fbff4...f5bb34ab4ab4b531076704333a64616723cb6f49,1,1,1,2,1,2014-09-22 21:52:20,2014-07-03 21:00:34
f5bb34ab4ab4b531076704333a64616723cb6f49...d8c8b2ebb727b81eef44d8845ca9393ea3099ee1,1,1,0,1,1,2014-09-22 22:27:00,2014-09-22 22:27:00
d8c8b2ebb727b81eef44d8845ca9393ea3099ee1...fd8997551f9ed4431f5e99d61f637139485076b9,2,51,0,51,2,2014-09-23 17:48:39,2014-09-12 12:17:32
fd8997551f9ed4431f5e99d61f637139485076b9...ace40d552603d2d44582bf794a76fc44f515713f,19,260,213,473,59,2014-09-23 17:58:45,2014-09-23 17:43:08
ace40d552603d2d44582bf794a76fc44f515713f...dc3de7fb7a14c38b5c3dc7decfafb0b51d422dd1,4,155,15,170,9,2014-09-23 18:34:24,2014-09-22 18:52:01
dc3de7fb7a14c38b5c3dc7decfafb0b51d422dd1...729c238e19ab27deff01448d79342ea53721bfed,5,154,10,164,16,2014-09-23 20:03:53,2014-09-23 14:30:03
729c238e19ab27deff01448d79342ea53721bfed...de38899f747f3883eccc79c167a1124670fe3201,1,53,0,53,1,2014-09-24 01:47:24,2014-09-24 01:47:24
de38899f747f3883eccc79c167a1124670fe3201...e81ae1464dd1d12080c89ed6c7567395ed712f9a,2,6,14,20,6,2014-09-24 06:32:04,2014-09-23 18:26:04
e81ae1464dd1d12080c89ed6c7567395ed712f9a...92f05e5a5900713301e64373d7b7daa45a88278b,2,19,8,27,2,2014-09-24 22:00:20,2014-09-24 21:20:50
92f05e5a5900713301e64373d7b7daa45a88278b...b9e899c8b2dd3720f5d333cebcbcd29a0152e793,1,1,1,2,1,2014-09-24 22:04:37,2014-09-24 22:04:03
b9e899c8b2dd3720f5d333cebcbcd29a0152e793...8ab673d430c5895702ca9fdf99dba5327e65d04f,3,4,6,10,5,2014-09-25 04:31:14,2014-09-24 08:51:10
8ab673d430c5895702ca9fdf99dba5327e65d04f...7ffc247d0fdd80ca4a01c75a257b038e38a28926,7,840,379,1219,136,2014-09-25 04:32:12,2014-09-24 14:01:20
7ffc247d0fdd80ca4a01c75a257b038e38a28926...27300072d179339bcd1a0bbb1cd2bcdcf9f8dec4,2,4,4,8,4,2014-09-25 04:32:12,2014-09-24 14:01:20
27300072d179339bcd1a0bbb1cd2bcdcf9f8dec4...5dbc2d65f381bc7be5c671e1e73862b2deafc7e8,1,1,1,2,1,2014-09-25 04:32:12,2014-09-24 14:01:38
5dbc2d65f381bc7be5c671e1e73862b2deafc7e8...e522c25fd4927e32d1d304d8ac4f77f4b03ab77c,7,16,306,322,11,2014-09-25 04:43:20,2014-09-24 16:22:11
e522c25fd4927e32d1d304d8ac4f77f4b03ab77c...a8fe2cc345c4e28043a0cd0e332028698f6dfe0b,1,11,0,11,1,2014-09-25 13:53:45,2014-09-20 18:41:34
a8fe2cc345c4e28043a0cd0e332028698f6dfe0b...a192c41ddc457050b7ec17775c9965cffa40507e,1,1,0,1,1,2014-09-26 16:27:52,2014-09-26 07:56:18
a192c41ddc457050b7ec17775c9965cffa40507e...2c8b4648526acf5c2645de8408a6d9ace2144b5f,1,21,10,31,2,2014-09-26 17:04:29,2014-09-13 22:39:16
2c8b4648526acf5c2645de8408a6d9ace2144b5f...8202c4dcea6dca46471eb33c732d436be3c0cc7a,3,1,10,11,3,2014-09-26 18:32:11,2014-08-13 09:56:32
8202c4dcea6dca46471eb33c732d436be3c0cc7a...b5bb4a986a45f139f0130a7a4f5a3e3a397d92cf,1,40,0,40,1,2014-09-26 19:02:02,2014-09-19 00:08:28
b5bb4a986a45f139f0130a7a4f5a3e3a397d92cf...b9df1216557ec3355ef6afc6c343d29e4c630d49,2,3,1,4,3,2014-09-26 19:51:55,2014-09-26 19:51:55
b9df1216557ec3355ef6afc6c343d29e4c630d49...07e3abc7dda872adc3fb25cb3e133f86f494b35d,2,61,8,69,8,2014-09-26 20:32:26,2013-10-20 07:28:25
07e3abc7dda872adc3fb25cb3e133f86f494b35d...6417a3e9eb7ab0011cefada8db855aa929a64ff8,2,24,7,31,6,2014-09-26 20:38:02,2014-09-25 20:06:07
6417a3e9eb7ab0011cefada8db855aa929a64ff8...fb0c77f0b66ed757a56af13f81b943419fdcbd7f,2,182,62,244,13,2014-09-26 20:38:17,2014-09-25 21:27:16
fb0c77f0b66ed757a56af13f81b943419fdcbd7f...27d12340d9054342b5f705085940d0aaf4d3e867,1,1,1,2,1,2014-09-27 00:04:40,2014-09-26 21:37:07
27d12340d9054342b5f705085940d0aaf4d3e867...4a6c7cf8cee28864531b75dfa8d651259be16f99,1,2,2,4,1,2014-09-27 00:16:23,2014-09-26 16:51:58
4a6c7cf8cee28864531b75dfa8d651259be16f99...5572b40b15ed06969c8e0e92866c5afd088484b4,3,25,4,29,4,2014-09-27 15:13:14,2014-09-13 18:51:30
5572b40b15ed06969c8e0e92866c5afd088484b4...b119251827cea670051198e1b48af7ee0c9f2a1b,3,47,28,75,18,2014-09-27 15:19:15,2014-09-13 20:40:31
b119251827cea670051198e1b48af7ee0c9f2a1b...eb935e6be0650ace948c3e51b1acea243629660d,1,1,1,2,1,2014-09-29 00:33:05,2014-09-28 23:04:10
eb935e6be0650ace948c3e51b1acea243629660d...86d33c5f9d77f1e8a97b4c423e5497198fbc23cd,1,1,1,2,1,2014-09-29 09:50:49,2014-09-29 09:50:49
86d33c5f9d77f1e8a97b4c423e5497198fbc23cd...cd2cfafcab0e24386a5cb9e5cc6f7a6e8d79b31b,3,42,10,52,6,2014-09-29 11:41:36,2014-09-14 16:47:37
cd2cfafcab0e24386a5cb9e5cc6f7a6e8d79b31b...6303c3dcf64685458fc84aa12289f5c9d57f4e47,3,67,1,68,5,2014-09-29 11:47:21,2014-09-22 11:08:25
6303c3dcf64685458fc84aa12289f5c9d57f4e47...76b755f3cb8e7d0d453d5f2ca3eaf2f2cdf82d1f,2,25,4,29,4,2014-09-29 17:15:49,2014-09-26 20:20:24
76b755f3cb8e7d0d453d5f2ca3eaf2f2cdf82d1f...b0033a44bdc674aba6795f0e0454e07e594d90c2,1,1,1,2,1,2014-09-29 20:56:22,2014-09-29 20:56:22
b0033a44bdc674aba6795f0e0454e07e594d90c2...2bcd02dc1a6b28b357d47c83be3bed5c9a38417c,2,70,1,71,4,2014-09-29 20:58:03,2014-09-24 22:33:35
2bcd02dc1a6b28b357d47c83be3bed5c9a38417c...a1648a76c0fa744b2c3f29e6d8e519454bf025b9,1,1,1,2,1,2014-09-29 21:16:11,2014-09-29 21:14:56
a1648a76c0fa744b2c3f29e6d8e519454bf025b9...a27d827c22b0b6b3ba6b7495cf4fc338c6934b37,2,30,1,31,2,2014-09-30 17:05:09,2014-09-30 14:22:16
a27d827c22b0b6b3ba6b7495cf4fc338c6934b37...b186709003954cb53d25d3371fed85480a0d5e2f,1,1,1,2,1,2014-09-30 18:40:48,2014-09-29 23:55:34
b186709003954cb53d25d3371fed85480a0d5e2f...66bb5aa41c45eab94848d421775ba6704b0bd500,1,3,1,4,1,2014-09-30 19:29:18,2014-09-30 07:32:19
66bb5aa41c45eab94848d421775ba6704b0bd500...8b54524c0704b33409ff6827e5f8830e046c4204,1,1,2,3,2,2014-09-30 19:33:01,2014-09-30 00:10:16
8b54524c0704b33409ff6827e5f8830e046c4204...6593c2371ec3afa2a153aab092b027b40b1d42b1,1,3,3,6,3,2014-09-30 19:35:44,2014-09-24 02:55:37
6593c2371ec3afa2a153aab092b027b40b1d42b1...769a00dc867679d6e206d6fa74809efcd7e6ba34,1,2,2,4,1,2014-09-30 19:56:45,2014-09-29 01:02:38
769a00dc867679d6e206d6fa74809efcd7e6ba34...b9479ee73b6e7a93b2947ab43ad095557db46247,3,129,7,136,5,2014-09-30 21:10:19,2014-09-17 17:43:49
b9479ee73b6e7a93b2947ab43ad095557db46247...313d7956e47cb514c720544e15353f30d3f1ff9f,1,15,1,16,1,2014-09-30 21:36:08,2014-09-30 17:38:10
313d7956e47cb514c720544e15353f30d3f1ff9f...8199f4dbde65b5a0db78fa48327129625363c2a6,1,1,0,1,1,2014-09-30 21:46:22,2014-06-15 15:35:55
8199f4dbde65b5a0db78fa48327129625363c2a6...ab80cd90661396dbb1c94c5f4dd2d11ee8f6b6af,4,135,8,143,8,2014-09-30 23:32:58,2014-09-08 09:03:28
ab80cd90661396dbb1c94c5f4dd2d11ee8f6b6af...b1ee5386d584f208bce6d3b613afdb3bae9df76a,2,40,39,79,15,2014-10-01 04:45:41,2014-07-19 21:22:23
b1ee5386d584f208bce6d3b613afdb3bae9df76a...3624e3800fb3ccd2e9ea361a763e20131fd42c29,2,12,21,33,7,2014-10-01 22:19:29,2014-10-01 21:57:32
3624e3800fb3ccd2e9ea361a763e20131fd42c29...a0bfdd0d60882125f614a91c321f12f730735e7b,3,60,28,88,13,2014-10-01 23:12:05,2014-10-01 22:24:44
a0bfdd0d60882125f614a91c321f12f730735e7b...10644432ca9d5da69ce790a8d9e691640f333711,2,84,9,93,7,2014-10-02 00:37:40,2014-10-01 00:27:14
10644432ca9d5da69ce790a8d9e691640f333711...59cb9e8a77629fcebbc959628c569179e389134f,1,14,0,14,1,2014-10-02 04:09:48,2014-09-23 18:26:04
59cb9e8a77629fcebbc959628c569179e389134f...84912134d5253be72079396099ab4322eb6b8f9a,1,112,1,113,3,2014-10-02 04:24:01,2014-10-02 04:05:48
84912134d5253be72079396099ab4322eb6b8f9a...dc5130c6110480da3c9fac48062877c472ea2bd5,1,3,3,6,2,2014-10-02 06:05:36,2014-10-02 06:05:36
dc5130c6110480da3c9fac48062877c472ea2bd5...11c76369aade59f22cb9901977e6e771d63a01c7,1,1,0,1,1,2014-10-02 12:13:32,2014-10-02 12:13:32
11c76369aade59f22cb9901977e6e771d63a01c7...391d8c04da85347128bfd0a7d19f384d71f294e4,1,120,17,137,4,2014-10-02 14:03:30,2014-10-02 14:03:30
391d8c04da85347128bfd0a7d19f384d71f294e4...f7b2d85a2cd8f63be720e8c448046403183c5cb6,1,19,0,19,1,2014-10-02 15:51:43,2014-10-02 15:40:45
f7b2d85a2cd8f63be720e8c448046403183c5cb6...8da08a1ebd92468cb999b4842b53a4fb187e2403,1,1,1,2,1,2014-10-02 16:45:36,2014-10-02 16:45:36
8da08a1ebd92468cb999b4842b53a4fb187e2403...86c7d1221c706993044583d51a0c61423fee5bcf,2,12,3,15,5,2014-10-02 17:28:16,2013-08-28 14:01:58
86c7d1221c706993044583d51a0c61423fee5bcf...074a146d8b1ee7c93bf6d5892448a5c2a0143a28,1,4,5,9,4,2014-10-02 18:38:40,2014-10-01 15:18:20
074a146d8b1ee7c93bf6d5892448a5c2a0143a28...b8c5b87119a06edb8e8d1cefad81ee8d1f64f070,2,12,2,14,4,2014-10-02 20:09:25,2014-09-12 18:16:33
b8c5b87119a06edb8e8d1cefad81ee8d1f64f070...f2942447c1ce88106951040a116f84006dccd987,4,180,0,180,4,2014-10-02 22:08:20,2014-10-02 17:09:45
f2942447c1ce88106951040a116f84006dccd987...607f016a0ba705ce40df0164360fb96a9d7f5912,2,24,6,30,7,2014-10-03 08:11:18,2014-10-02 21:27:52
607f016a0ba705ce40df0164360fb96a9d7f5912...e7cf04bad33bd86ce5508069abff7023bff40097,1,1,1,2,1,2014-10-03 10:57:56,2014-05-27 09:47:27
e7cf04bad33bd86ce5508069abff7023bff40097...d277641eec6a9074aaf248e2e434cbfce5f45bf3,1,21,2,23,2,2014-10-03 21:05:10,2014-10-03 20:33:04
d277641eec6a9074aaf248e2e434cbfce5f45bf3...404b95fe30a1bcd1313adafbd0018578d5b21d3d,2,28,1,29,3,2014-10-03 22:33:09,2014-09-24 01:00:37
404b95fe30a1bcd1313adafbd0018578d5b21d3d...f3539f3cb5d9477f50f065c6a0ac7d6ca0a31092,2,15,14,29,5,2014-10-03 22:58:06,2014-10-03 16:46:42
f3539f3cb5d9477f50f065c6a0ac7d6ca0a31092...0656484d3e709c5162570b0dd6473b0b6140e5b2,3,31,1,32,5,2014-10-03 23:04:51,2014-10-03 00:55:32
0656484d3e709c5162570b0dd6473b0b6140e5b2...f7174169f4f710d605f6a67f39f90a67a07d4cab,2,134,10,144,8,2014-10-03 23:12:52,2014-09-04 20:07:39
f7174169f4f710d605f6a67f39f90a67a07d4cab...858360b680a2bb5c19429c1be1c9506700cda476,1,1,0,1,1,2014-10-03 23:23:25,2014-10-03 23:23:09
858360b680a2bb5c19429c1be1c9506700cda476...7b6c1d08aceba6704a40302f373400aed9ed0e0b,2,62,3,65,5,2014-10-03 23:25:11,2014-10-02 20:46:22
7b6c1d08aceba6704a40302f373400aed9ed0e0b...feba0174db0f8f929273beb8b90691734a9292e2,4,58,2,60,8,2014-10-04 01:41:13,2014-09-22 17:14:31
feba0174db0f8f929273beb8b90691734a9292e2...7cb01a80beec669d8f6aae1dc211d2f0b7d4eac4,1,3,0,3,1,2014-10-04 04:47:05,2014-10-04 04:22:59
7cb01a80beec669d8f6aae1dc211d2f0b7d4eac4...409ad62042a6340307aa335839ac43c69144203f,1,1,3,4,1,2014-10-06 15:38:01,2014-10-06 15:38:01
409ad62042a6340307aa335839ac43c69144203f...43d4fffdbe7ad2aa5430c5e6219a039aacd41ab7,2,44,4,48,6,2014-10-06 15:55:52,2014-10-06 15:55:42
43d4fffdbe7ad2aa5430c5e6219a039aacd41ab7...a21d49c900c3a9c5af8eb243f08e4f78ebaa78a9,1,14,0,14,2,2014-10-06 18:39:03,2014-10-01 23:01:32
a21d49c900c3a9c5af8eb243f08e4f78ebaa78a9...806ef998be1e89683a9ce9c1803fe002389533bf,1,1,1,2,1,2014-10-06 19:10:08,2014-10-04 21:22:31
806ef998be1e89683a9ce9c1803fe002389533bf...687981913c8500fe5dc718303fd6be7ffe4035b0,1,0,1,1,1,2014-10-06 19:19:15,2014-10-06 16:38:54
687981913c8500fe5dc718303fd6be7ffe4035b0...8ef69d2d7a541dd4550427188bcd182063c19a2f,1,0,1,1,1,2014-10-06 19:21:12,2014-10-06 17:42:21
8ef69d2d7a541dd4550427188bcd182063c19a2f...2cb0b309cbade898e2da351fb8500c4c154c132e,1,2,2,4,2,2014-10-06 20:05:41,2014-10-06 20:03:01
2cb0b309cbade898e2da351fb8500c4c154c132e...7911c3cfe77b014196549c81abc38a805d361af1,1,2,2,4,1,2014-10-06 20:10:12,2014-10-05 20:28:58
7911c3cfe77b014196549c81abc38a805d361af1...3ad774b01c2f446b7189d9d51ce259dedf24f549,1,1,1,2,1,2014-10-06 20:31:11,2014-10-03 18:46:54
3ad774b01c2f446b7189d9d51ce259dedf24f549...da366f7e926042b11cca7d86dddd84aa9acae8bf,1,4,1,5,1,2014-10-06 20:47:32,2014-10-02 20:07:43
da366f7e926042b11cca7d86dddd84aa9acae8bf...c6d76d1e2e8768db6b367c95b3b3fa2972243aa7,1,2,2,4,1,2014-10-06 20:52:39,2014-10-06 20:47:49
c6d76d1e2e8768db6b367c95b3b3fa2972243aa7...0e4390c9230708ba85569b754b674884b63ae9b9,1,2,2,4,2,2014-10-06 22:19:23,2014-10-06 22:15:05
0e4390c9230708ba85569b754b674884b63ae9b9...46db47bb37d6bf123efe79785896e28bb89383f7,1,1,1,2,1,2014-10-06 22:52:40,2014-10-02 00:56:17
46db47bb37d6bf123efe79785896e28bb89383f7...d9457aa288eb1536b9592cccc3aacd3c0955b130,1,1,1,2,1,2014-10-06 23:01:49,2014-09-28 01:14:24
d9457aa288eb1536b9592cccc3aacd3c0955b130...f52203ce718a982d4b7adc3794f4dead9bceaa05,2,3,23,26,3,2014-10-06 23:33:19,2014-09-26 14:01:54
f52203ce718a982d4b7adc3794f4dead9bceaa05...40d8da80ce773dd82166428f481e33df51883340,2,39,131,170,21,2014-10-07 00:01:42,2014-09-27 17:42:48
40d8da80ce773dd82166428f481e33df51883340...e843ae7a4cfb746760e1d8c3578d9ec613c3e2ee,17,186,344,530,56,2014-10-07 00:04:09,2014-08-29 15:02:18
e843ae7a4cfb746760e1d8c3578d9ec613c3e2ee...a75546afdf41adab786eda30c258190cd4c5f1ae,2,23,0,23,2,2014-10-07 05:22:49,2014-09-24 06:05:57
a75546afdf41adab786eda30c258190cd4c5f1ae...cb85cbcec1c876db6062a0dc0bad80f842782194,2,72,0,72,6,2014-10-07 06:32:29,2014-10-02 10:41:36
cb85cbcec1c876db6062a0dc0bad80f842782194...613d0a3212de8dc01c817ca8526e09c57978a621,2,105,1,106,3,2014-10-07 08:03:16,2014-09-05 19:48:58
613d0a3212de8dc01c817ca8526e09c57978a621...ab240196bf5cdbe85a18bfd7e7a6a287bf5c22f7,1,1,1,2,1,2014-10-07 17:39:09,2014-10-07 17:03:36
ab240196bf5cdbe85a18bfd7e7a6a287bf5c22f7...8ee1ba4b94d6fccff06d8781f7ed256c6ce664ff,2,178,31,209,20,2014-10-07 18:20:33,2014-10-07 01:04:22
8ee1ba4b94d6fccff06d8781f7ed256c6ce664ff...6fd36deed954b338e48390862971d465148dc1f2,8,466,62,528,61,2014-10-07 22:48:10,2013-07-18 16:59:31
6fd36deed954b338e48390862971d465148dc1f2...a84480affb1d2714ebd4a03dd656a4bc516b8ceb,2,8,7,15,3,2014-10-07 23:09:50,2014-10-02 19:22:43
a84480affb1d2714ebd4a03dd656a4bc516b8ceb...c93924ed275a62683b85c82f1c6c2e19d5662c9a,2,93,27,120,12,2014-10-07 23:21:56,2014-10-07 08:25:46
c93924ed275a62683b85c82f1c6c2e19d5662c9a...74a214c043ad8c38bb58d0daebc31b31b28ced32,1,1,1,2,1,2014-10-08 02:54:44,2014-10-08 02:52:19
74a214c043ad8c38bb58d0daebc31b31b28ced32...1beebee9681b24ad2af958d6e937f259b392d46e,5,7,77,84,13,2014-10-08 15:36:44,2014-10-08 15:36:44
1beebee9681b24ad2af958d6e937f259b392d46e...6b786dcb578e0d12e9ea6c0498a9487ba1437a98,1,1,1,2,1,2014-10-08 17:42:41,2014-10-08 00:29:52
6b786dcb578e0d12e9ea6c0498a9487ba1437a98...e63f670ff2df331b1e7f3d2b0001034223719175,6,24,24,48,12,2014-10-08 17:59:54,2014-07-31 20:35:38
e63f670ff2df331b1e7f3d2b0001034223719175...323862ff63d22a18b5d195fec1fabe4a28e00078,1,2,1,3,1,2014-10-08 18:27:45,2014-10-07 22:34:44
323862ff63d22a18b5d195fec1fabe4a28e00078...35049be9d9e1f6e6db56130dc71f395da459cb0d,1,7,3,10,1,2014-10-08 18:56:49,2014-09-30 17:42:51
35049be9d9e1f6e6db56130dc71f395da459cb0d...667183a8c79d6ffce571a2be78c05dc76503b222,6,571,11,582,27,2014-10-08 18:56:49,2014-09-25 02:04:06
667183a8c79d6ffce571a2be78c05dc76503b222...cae01f49414868db8bd00e77a1c88dd8e075df81,5,40,36,76,25,2014-10-08 18:56:49,2014-10-08 02:42:59
cae01f49414868db8bd00e77a1c88dd8e075df81...9e4701a5ab9bbbf446e50e6e94e2c0f0ab5cdf39,2,5,0,5,2,2014-10-08 18:56:49,2014-10-08 18:18:22
9e4701a5ab9bbbf446e50e6e94e2c0f0ab5cdf39...003c44eceee54c3398b0d2971fd97a512d7f7cec,1,1,1,2,1,2014-10-08 18:56:49,2014-10-08 18:22:48
003c44eceee54c3398b0d2971fd97a512d7f7cec...22358cf9c703d67f3cf9eb4899404b09578a5fad,2,13,2,15,4,2014-10-08 18:56:49,2014-10-08 18:34:26
22358cf9c703d67f3cf9eb4899404b09578a5fad...208114c2b2d5140f704325f9d4997d49f8a2b3fe,1,1,2,3,1,2014-10-08 18:56:50,2014-10-08 18:35:55
208114c2b2d5140f704325f9d4997d49f8a2b3fe...ab354cf04ef8277a87d1ea1e79f9d63876fa97c8,2,447,55,502,17,2014-10-08 19:27:15,2014-10-03 20:12:54
ab354cf04ef8277a87d1ea1e79f9d63876fa97c8...aad60953ce1c68433b6ae74b6a62a55f80a45e6e,2,130,131,261,35,2014-10-08 19:27:15,2014-10-07 23:42:39
aad60953ce1c68433b6ae74b6a62a55f80a45e6e...30996f82afa03cd11771b3267e9367ecf9af6e6d,3,56,171,227,14,2014-10-08 19:46:26,2014-10-08 18:36:15
30996f82afa03cd11771b3267e9367ecf9af6e6d...0c2378de7928d07d545c6b10910799eb5997fae2,1,1,1,2,1,2014-10-08 20:05:13,2014-10-08 20:05:13
0c2378de7928d07d545c6b10910799eb5997fae2...b3e09be58960b913fee3869bf36e7de3305bbe00,2,54,37,91,13,2014-10-08 20:11:52,2013-12-19 23:16:53
b3e09be58960b913fee3869bf36e7de3305bbe00...d9ff4e42ce1f59ea5af41a1300c4a433071d6e48,1,122,0,122,1,2014-10-08 20:37:01,2014-10-06 22:43:54
d9ff4e42ce1f59ea5af41a1300c4a433071d6e48...df1a00b11ac2722f4da441837795985f12682030,2,56,1,57,2,2014-10-08 20:37:54,2014-10-08 09:35:37
df1a00b11ac2722f4da441837795985f12682030...d5445c601fafd6ecd38befeaa4c9ec7bb044127c,2,21,1,22,7,2014-10-08 20:40:46,2014-10-02 16:41:47
d5445c601fafd6ecd38befeaa4c9ec7bb044127c...035ffb82c48b5ce2fbeda112f2eb8787d0626538,3,119,15,134,21,2014-10-08 20:48:12,2014-10-08 11:29:57
035ffb82c48b5ce2fbeda112f2eb8787d0626538...39d0b36826a077f7549a70d0cf3edebe90a10aaa,3,55,3,58,6,2014-10-08 20:48:25,2014-10-08 11:36:33
39d0b36826a077f7549a70d0cf3edebe90a10aaa...0d3b69a5f27b41745b504c7ffd8d72653bac1f85,3,65,8,73,5,2014-10-08 20:49:38,2014-09-22 16:20:34
0d3b69a5f27b41745b504c7ffd8d72653bac1f85...f4ff11b01e6a5f9a9eb25a38d327dfaadbd7c80c,3,121,38,159,22,2014-10-08 22:35:04,2014-10-08 22:05:54
f4ff11b01e6a5f9a9eb25a38d327dfaadbd7c80c...0563a0a636b1b586e3f31e2741cb27f9c4959b5b,1,1,3,4,2,2014-10-08 22:35:55,2014-09-11 22:59:34
0563a0a636b1b586e3f31e2741cb27f9c4959b5b...e6ece7d993c846889bf58cb384d759235e345450,1,39,2,41,5,2014-10-08 22:51:30,2014-10-08 22:51:30
e6ece7d993c846889bf58cb384d759235e345450...daf37375d38bfa80c12d5e8b5b885c3b038e5622,1,14,17,31,2,2014-10-08 23:39:23,2014-10-08 22:32:00
daf37375d38bfa80c12d5e8b5b885c3b038e5622...e15d2fd4728aea470de84b66a3956b1816e219e2,1,8,6,14,2,2014-10-09 06:24:20,2014-10-09 06:24:20
e15d2fd4728aea470de84b66a3956b1816e219e2...c7a9009e143299f0e45a85d715ff22fc676d3f93,2,11,0,11,2,2014-10-09 09:32:42,2014-10-06 14:23:25
c7a9009e143299f0e45a85d715ff22fc676d3f93...7b102323e910ff4bf7938fb4781650f3b103602f,1,11,11,22,7,2014-10-09 11:10:43,2014-09-30 17:30:30
7b102323e910ff4bf7938fb4781650f3b103602f...372fa6993b2b1b4848aa4be3c3e11f69244fca6f,2,18,1,19,2,2014-10-09 12:04:18,2014-10-09 11:49:49
372fa6993b2b1b4848aa4be3c3e11f69244fca6f...944408edf8fa9fb7ea49f97a976770e13e1aa7b7,1,1,1,2,2,2014-10-09 12:40:25,2014-10-09 12:40:25
944408edf8fa9fb7ea49f97a976770e13e1aa7b7...2435e2b8f84fde9495b8e9440a2b4f865b1ff541,2,100,17,117,23,2014-10-09 16:40:56,2014-10-03 23:13:52
2435e2b8f84fde9495b8e9440a2b4f865b1ff541...64241a57e2b6271c771ab700261caaca680feabd,6,18,34,52,16,2014-10-09 17:56:15,2014-10-08 15:09:00
64241a57e2b6271c771ab700261caaca680feabd...58e8c02c14dbb18cc59743c0fb884da020009023,1,1,1,2,1,2014-10-09 18:49:16,2014-10-09 15:28:10
58e8c02c14dbb18cc59743c0fb884da020009023...aa1c23a2bfc50a22528fcf02abd6332f1e1a8dbc,1,1,1,2,1,2014-10-09 18:52:45,2014-09-12 08:41:36
aa1c23a2bfc50a22528fcf02abd6332f1e1a8dbc...a4db4e618779609003abe3957749732d02782561,1,2,2,4,1,2014-10-09 18:59:45,2014-10-09 15:02:11
a4db4e618779609003abe3957749732d02782561...d1eec47cb8847adea19f48154a5da2d8be80b06f,1,2,2,4,2,2014-10-09 18:59:45,2014-10-09 15:03:20
d1eec47cb8847adea19f48154a5da2d8be80b06f...1f650bae4b07b074c0a732f029ccaafb622ffa32,1,15,0,15,2,2014-10-09 19:00:33,2014-09-12 08:50:09
1f650bae4b07b074c0a732f029ccaafb622ffa32...e07ebded23b2308175119214ed754cd563f0967a,1,2,2,4,2,2014-10-09 19:00:34,2014-10-09 19:00:20
e07ebded23b2308175119214ed754cd563f0967a...4568bc037d3a71fcad00692d7f91f7aa89dbbc33,1,3,0,3,1,2014-10-09 19:11:16,2014-09-15 09:03:35
4568bc037d3a71fcad00692d7f91f7aa89dbbc33...da072d49a07b1d8e1f4dc54f24f9f34873ce4ad8,1,3,1,4,1,2014-10-09 19:19:40,2014-09-15 21:36:58
da072d49a07b1d8e1f4dc54f24f9f34873ce4ad8...ec8801794412dd5eacb923c72a823fda4c14bccd,1,1,0,1,1,2014-10-09 19:25:26,2014-10-09 16:10:21
ec8801794412dd5eacb923c72a823fda4c14bccd...2691668876135d37e0749d714f6bab71672c5c0f,1,0,1,1,1,2014-10-09 19:28:00,2014-10-09 14:35:48
2691668876135d37e0749d714f6bab71672c5c0f...9c9959059eb84f0f1d748b70b50ec47b7d23d065,2,19,5,24,7,2014-10-09 19:34:50,2014-09-23 07:38:45
9c9959059eb84f0f1d748b70b50ec47b7d23d065...40d4bb58633f08d5e0d01819db7da765a9ea2f36,1,7,7,14,2,2014-10-09 19:40:31,2014-09-23 08:32:48
40d4bb58633f08d5e0d01819db7da765a9ea2f36...b0307a33ebb338405590345f281885cb6e17404d,1,0,4,4,4,2014-10-09 19:59:10,2014-10-08 06:58:02
b0307a33ebb338405590345f281885cb6e17404d...a3f44ed1f09275a5765537da67105c6d2491e48a,2,12,11,23,10,2014-10-09 20:00:45,2014-10-07 16:02:20
a3f44ed1f09275a5765537da67105c6d2491e48a...7b9fddfe771f854d3f527685796ce1286255d100,1,2,1,3,1,2014-10-09 20:42:06,2014-09-25 08:06:14
7b9fddfe771f854d3f527685796ce1286255d100...12ca1e38f9bbaf05801e171ea9d0b0cc3933b2bd,1,3,1,4,2,2014-10-09 20:52:20,2014-10-01 19:30:18
12ca1e38f9bbaf05801e171ea9d0b0cc3933b2bd...3f6b380bdec983700e31b6327db2a91185cfc58d,1,1,1,2,1,2014-10-09 20:56:20,2014-10-03 23:00:30
3f6b380bdec983700e31b6327db2a91185cfc58d...5030707e760f2cba47ecad2ff72a9742cb413177,1,1,1,2,1,2014-10-09 20:57:00,2014-10-09 20:54:07
5030707e760f2cba47ecad2ff72a9742cb413177...c4e21efcb794711514ae029a54cfb0098c581067,1,2,2,4,2,2014-10-09 21:08:09,2014-09-24 20:30:01
c4e21efcb794711514ae029a54cfb0098c581067...9f2ad53084e08f477477b6d6b4e482c2cc87dd68,1,11,12,23,9,2014-10-09 21:09:31,2014-09-27 12:32:27
9f2ad53084e08f477477b6d6b4e482c2cc87dd68...01f50e1a7b2bff7070616494774ec493f8133204,2,27,9,36,2,2014-10-09 21:13:27,2014-09-28 08:02:50
01f50e1a7b2bff7070616494774ec493f8133204...2230fb4c1098b8c034cd43bdaa49f8f5747759c8,1,96,0,96,1,2014-10-09 21:17:35,2014-09-28 10:42:44
2230fb4c1098b8c034cd43bdaa49f8f5747759c8...257a3f35dc3f1ec9bf6d819081b0e1dfa2b1a717,1,8,0,8,1,2014-10-09 21:19:16,2014-09-28 14:48:27
257a3f35dc3f1ec9bf6d819081b0e1dfa2b1a717...aa99df9e53dfee1d5cee488a3afb318b9f93ac0b,31,87,87,174,64,2014-10-09 21:21:38,2014-10-01 11:56:48
aa99df9e53dfee1d5cee488a3afb318b9f93ac0b...bb390ef525b76be037d7a52c9acc186cc7b08b11,1,1,1,2,1,2014-10-09 21:21:38,2014-10-09 21:21:23
bb390ef525b76be037d7a52c9acc186cc7b08b11...e499433f601463c55f9edfe9f70b7c4b464a0007,1,21,18,39,3,2014-10-09 21:24:16,2014-09-30 18:13:36
e499433f601463c55f9edfe9f70b7c4b464a0007...9e0ab14826994f1880b343034c081e040f1b9b59,1,11,0,11,1,2014-10-09 21:24:56,2014-09-28 22:56:42
9e0ab14826994f1880b343034c081e040f1b9b59...b90f5e59cfb2a49814fc9caa241447e051d4a640,1,1,1,2,1,2014-10-09 21:33:34,2014-10-09 21:33:34
b90f5e59cfb2a49814fc9caa241447e051d4a640...9db70d3959f8ff062a9e65029695f55c9c01de29,1,1,1,2,1,2014-10-10 07:14:52,2014-10-10 05:01:32
9db70d3959f8ff062a9e65029695f55c9c01de29...6e4955a3086555d8ca30c29955faa213b39c6f27,2,29,3,32,3,2014-10-10 16:54:18,2014-10-09 18:43:36
6e4955a3086555d8ca30c29955faa213b39c6f27...addfff3c46311f59bdcd100351260006d457316f,3,176,21,197,12,2014-10-10 17:07:18,2014-10-09 23:48:56
addfff3c46311f59bdcd100351260006d457316f...d71fb6f2713f1a636f6e9c25479870ee9941ad18,2,98,6,104,4,2014-10-10 17:22:10,2014-10-10 05:00:26
d71fb6f2713f1a636f6e9c25479870ee9941ad18...ea1897606f15442ee0d734dcdf4848130b6bbd4e,1,4,4,8,4,2014-10-10 17:24:25,2014-10-10 17:24:14
ea1897606f15442ee0d734dcdf4848130b6bbd4e...86a33613534715547ac5e2a5aec490e8b4fa3d55,1,1,11,12,1,2014-10-10 17:33:20,2014-10-10 05:16:16
86a33613534715547ac5e2a5aec490e8b4fa3d55...e83fab9568d6f91fdeb36619eaf6a4ad34527f2e,1,1,3,4,1,2014-10-10 17:37:15,2014-10-10 05:49:21
e83fab9568d6f91fdeb36619eaf6a4ad34527f2e...9a2b6efd11b50a08bca3e475887369b654626cea,1,4,0,4,1,2014-10-10 17:46:28,2014-10-10 16:53:48
9a2b6efd11b50a08bca3e475887369b654626cea...44746332fa89829cbaa28fcca806f99c8d81f5e8,1,2,1,3,2,2014-10-10 18:06:55,2014-10-10 12:49:36
44746332fa89829cbaa28fcca806f99c8d81f5e8...9ba24c54d60e643b1450cc5cfa8f990bd524c130,2,11,1,12,2,2014-10-10 20:16:28,2014-10-10 19:10:20
9ba24c54d60e643b1450cc5cfa8f990bd524c130...20685ffe11036d4d604d13f0d792ca46497af4a1,2,15,3,18,7,2014-10-11 05:46:25,2014-06-20 17:34:54
20685ffe11036d4d604d13f0d792ca46497af4a1...b6f4d4b8d4b37b2f98bd1ff5e00a549462dea6d3,1,1,1,2,1,2014-10-11 16:04:09,2014-06-12 19:42:31
b6f4d4b8d4b37b2f98bd1ff5e00a549462dea6d3...0dd316efea209e5e5de3e456b4e6562f011a1294,4,61,0,61,4,2014-10-12 16:52:44,2014-10-12 16:52:44
0dd316efea209e5e5de3e456b4e6562f011a1294...09c39d2ce687cdf0ac35dbb34a91f0d198c9d83a,2,661,163,824,60,2014-10-12 16:55:43,2014-10-12 16:55:37
09c39d2ce687cdf0ac35dbb34a91f0d198c9d83a...353de4f531ad05baab0dcd5b1de78b953f11cf6a,3,7,3,10,4,2014-10-12 16:55:43,2014-10-12 16:55:37
353de4f531ad05baab0dcd5b1de78b953f11cf6a...a708632c9f0c7018e9739d90e7da0991b445721f,1,2,2,4,1,2014-10-13 03:02:23,2014-10-11 22:19:07
a708632c9f0c7018e9739d90e7da0991b445721f...57f804a4ed769a302d7a78490dc0592c8f74a825,1,3,6,9,4,2014-10-13 06:49:34,2014-10-09 21:06:24
57f804a4ed769a302d7a78490dc0592c8f74a825...874cac825bf29a936cb1b35f9af239687bc5e036,2,25,2,27,4,2014-10-13 08:51:30,2014-10-12 10:34:14
874cac825bf29a936cb1b35f9af239687bc5e036...393c1c7c20db5f50c70777027d144293f46a896e,2,1,11,12,3,2014-10-13 14:44:22,2014-10-13 14:44:22
393c1c7c20db5f50c70777027d144293f46a896e...1efaf3dc136f822703a9cda55afac7895a923ccb,3,243,81,324,43,2014-10-13 16:00:54,2014-10-13 11:12:49
1efaf3dc136f822703a9cda55afac7895a923ccb...c44fc6d811e3b6fd4deae90c2a02bed19210190c,2,18,17,35,7,2014-10-13 16:51:44,2014-10-11 00:43:47
c44fc6d811e3b6fd4deae90c2a02bed19210190c...b747d3bf4b35cd46aca31f62bfbdae43850a2dff,2,2,5,7,3,2014-10-13 16:51:49,2014-10-11 00:47:35
b747d3bf4b35cd46aca31f62bfbdae43850a2dff...28133cbd2a2b969def7184cab345689c351fb68a,1,1,1,2,1,2014-10-13 17:07:40,2014-10-13 12:46:34
28133cbd2a2b969def7184cab345689c351fb68a...4a855121749e862ef61710886a132e66abaf0b56,2,29,14,43,13,2014-10-13 17:46:09,2014-10-13 17:04:00
4a855121749e862ef61710886a132e66abaf0b56...520db0ca7e73a01e34dddab8079f41b243947345,1,1,1,2,1,2014-10-13 18:47:10,2014-10-13 11:02:34
520db0ca7e73a01e34dddab8079f41b243947345...8b568d7c38f9c99b2270671c0ce81cc1b823371e,1,6,6,12,3,2014-10-13 18:48:17,2014-10-13 14:27:45
8b568d7c38f9c99b2270671c0ce81cc1b823371e...3345bf8bc73d798145ebbe9011d7ee31d55ee209,1,1,1,2,1,2014-10-13 18:49:22,2014-10-13 13:51:35
3345bf8bc73d798145ebbe9011d7ee31d55ee209...0f6aa104136eda84eebc682c3875fc0a9bb3fde0,1,8,0,8,2,2014-10-13 18:53:56,2014-10-10 19:38:50
0f6aa104136eda84eebc682c3875fc0a9bb3fde0...63ef085b9a891f9d28123f44ddfe9efc89965cf4,1,4,4,8,4,2014-10-13 19:05:30,2014-10-13 18:59:23
63ef085b9a891f9d28123f44ddfe9efc89965cf4...e5f4d7b10ae5e6a17ab349995451c33b7d294245,6,597,81,678,97,2014-10-13 19:11:52,2014-09-08 04:19:22
e5f4d7b10ae5e6a17ab349995451c33b7d294245...02be700bda191b454de393f2805916f374a1d764,5,116,6,122,11,2014-10-13 19:11:52,2014-10-11 01:46:42
02be700bda191b454de393f2805916f374a1d764...f277c568375aaedf52d397b76cb5c9ea688fa62c,1,40,0,40,1,2014-10-13 21:55:17,2014-10-12 22:32:49
f277c568375aaedf52d397b76cb5c9ea688fa62c...399a7afafefb8818f255d5b9e6a42b2b57aabf97,1,72,0,72,1,2014-10-13 22:27:20,2014-10-13 22:27:20
399a7afafefb8818f255d5b9e6a42b2b57aabf97...7f4d24c6fa06b387cc4f3c9502cd58babde6b16b,3,842,308,1150,103,2014-10-13 22:55:20,2014-10-11 19:58:38
7f4d24c6fa06b387cc4f3c9502cd58babde6b16b...28661d1a8cc3a8454bad7ae531e027b1256476c9,2,35,3,38,5,2014-10-14 03:09:19,2014-10-10 22:57:47
28661d1a8cc3a8454bad7ae531e027b1256476c9...b8b63df664a72569d2199e3825fbf598b772e818,1,1,1,2,1,2014-10-14 08:45:37,2014-10-14 07:46:42
b8b63df664a72569d2199e3825fbf598b772e818...fd375c5d4612b8638fed99929d8ef8ca9312df18,1,1,1,2,1,2014-10-14 08:48:14,2014-10-14 08:01:57
fd375c5d4612b8638fed99929d8ef8ca9312df18...69bf2f02d0ccda6e775e7a45cc64d3d222e8d899,1,1,1,2,1,2014-10-14 09:12:25,2014-10-14 02:46:23
69bf2f02d0ccda6e775e7a45cc64d3d222e8d899...02aa4f4b85ee15922a1f2de8ba78f562c18518d0,5,37,10,47,6,2014-10-14 09:42:13,2014-10-13 19:34:36
02aa4f4b85ee15922a1f2de8ba78f562c18518d0...6502ab09774e1ac310da90c9e1c49fb0cd652d66,1,5,0,5,1,2014-10-14 14:55:31,2014-09-18 03:50:15
6502ab09774e1ac310da90c9e1c49fb0cd652d66...ed85ec4d706926b7d30b80bb35cdbd2f4e744e4b,1,1,0,1,1,2014-10-15 16:18:49,2014-10-15 16:18:49
ed85ec4d706926b7d30b80bb35cdbd2f4e744e4b...49d03a5b2ec59f8466cb4babf78336f005e66f50,1,1,1,2,1,2014-10-15 22:05:02,2014-10-15 09:43:39
49d03a5b2ec59f8466cb4babf78336f005e66f50...fc70a98be4fd2eba585cd97316ad9a61771e9362,1,3,3,6,2,2014-10-16 04:27:11,2014-10-15 17:46:07
fc70a98be4fd2eba585cd97316ad9a61771e9362...22407a9296bfd4d2c5578474873288b3e6ceb950,1,0,1,1,1,2014-10-16 10:36:45,2014-10-16 10:36:45
22407a9296bfd4d2c5578474873288b3e6ceb950...22da294cbb951b27ce09d10fd41f49f67629bdbb,1,1,1,2,1,2014-10-16 18:06:04,2014-10-16 06:08:07
22da294cbb951b27ce09d10fd41f49f67629bdbb...47e15aa2b4c657210c3c36813915b6c1c40f3f33,1,2,4,6,1,2014-10-16 20:44:22,2014-10-16 02:12:35
47e15aa2b4c657210c3c36813915b6c1c40f3f33...fb1b202f38092fd7dbc2feda8085c9cb19dbfed5,1,13,9,22,6,2014-10-16 22:17:32,2014-10-16 22:17:28
fb1b202f38092fd7dbc2feda8085c9cb19dbfed5...8b2f1a47b584ceb98689f48538a2af73cd65dfd8,1,1,1,2,1,2014-10-17 07:28:48,2014-10-15 08:05:33
8b2f1a47b584ceb98689f48538a2af73cd65dfd8...c2fb4b6986c13e6484f646ad732c1470d2c353db,1,3,1,4,2,2014-10-17 07:30:37,2014-10-15 07:35:21
c2fb4b6986c13e6484f646ad732c1470d2c353db...fddf4bd5fe19ee020520e369ef393955aa394cb2,1,1,1,2,1,2014-10-17 07:39:06,2014-10-16 20:22:10
fddf4bd5fe19ee020520e369ef393955aa394cb2...d7f84e2d7fb29353b723554e2cd4fcb772f44ba2,3,42,153,195,33,2014-10-17 07:54:00,2014-10-14 21:07:55
d7f84e2d7fb29353b723554e2cd4fcb772f44ba2...5b982998c335c8889111b75b5ef933d22a204728,1,2,2,4,1,2014-10-17 07:54:19,2014-10-14 22:16:52
5b982998c335c8889111b75b5ef933d22a204728...c2edef86c5b6756a730b53dc86ab24a1fd9d9c16,1,1,1,2,1,2014-10-17 08:01:04,2014-10-14 17:26:46
c2edef86c5b6756a730b53dc86ab24a1fd9d9c16...45252c3a545336a0bac93be6ee28cde6afaa3cb4,3,18,4,22,5,2014-10-17 19:35:31,2014-10-17 12:52:00
45252c3a545336a0bac93be6ee28cde6afaa3cb4...6e5e76e4b13d013852a4474c9c6175429e72bcfc,1,0,15,15,1,2014-10-17 19:50:53,2014-10-17 19:40:10
6e5e76e4b13d013852a4474c9c6175429e72bcfc...6cba9c5e7c22dcedb585c16719f081d5fddeccaf,1,0,6,6,1,2014-10-17 20:06:55,2014-10-17 20:06:55
6cba9c5e7c22dcedb585c16719f081d5fddeccaf...502bb648ff8e8250d29c65c9690500c6a3b40e92,1,1,1,2,1,2014-10-17 21:05:16,2013-12-09 23:39:55
502bb648ff8e8250d29c65c9690500c6a3b40e92...4aaf47534e62b9c54121fbc98bb898c7fd3e1ae8,1,16,14,30,5,2014-10-17 21:23:36,2014-09-04 21:17:26
4aaf47534e62b9c54121fbc98bb898c7fd3e1ae8...c06e12276b2e5d08aaf7e5eb8edd912fb4708e00,2,18,10,28,2,2014-10-17 21:23:37,2014-10-13 19:51:51
c06e12276b2e5d08aaf7e5eb8edd912fb4708e00...036871df5ea9777b15dc6f7ddb03bdafa9c1f122,1,37,13,50,12,2014-10-17 21:23:39,2014-10-13 20:13:46
036871df5ea9777b15dc6f7ddb03bdafa9c1f122...d5457bb83b1bb948416e99bf2d62bf97bce257d4,1,73,55,128,12,2014-10-17 21:23:41,2014-10-13 21:29:23
d5457bb83b1bb948416e99bf2d62bf97bce257d4...e9dcec0c5d4c4f636815dc87c5f7890334045017,2,56,0,56,3,2014-10-17 21:23:44,2014-10-13 20:48:15
e9dcec0c5d4c4f636815dc87c5f7890334045017...9078a6ae37d9938af4b92a387f9b3833ea3e281b,1,26,18,44,9,2014-10-17 21:23:45,2014-10-15 18:54:42
9078a6ae37d9938af4b92a387f9b3833ea3e281b...1bd473eb4587900086e0b6b308dcf1dcfe9760d9,4,88,19,107,6,2014-10-17 22:07:35,2014-10-14 18:51:29
1bd473eb4587900086e0b6b308dcf1dcfe9760d9...fe58238e354e972db2ecebb2e7ace0e2fd923d54,1,1,1,2,1,2014-10-17 22:27:26,2014-10-17 22:27:26
fe58238e354e972db2ecebb2e7ace0e2fd923d54...1785251eab2e2f5719054777eeacca4becd5f76f,1,2,2,4,1,2014-10-17 23:48:37,2014-10-17 23:07:49
1785251eab2e2f5719054777eeacca4becd5f76f...accb22d64455bc73f5a417f56a12d35e9207fde0,52,271,271,542,263,2014-10-18 14:15:40,2014-10-17 23:45:20
accb22d64455bc73f5a417f56a12d35e9207fde0...24d00cce4f471e5c841bbb8ab21f4ef73f5e79b7,1,1,1,2,1,2014-10-18 19:38:55,2014-10-18 01:45:36
24d00cce4f471e5c841bbb8ab21f4ef73f5e79b7...e5c53b393bddba1d716193634f705b60d3e20663,1,1,1,2,1,2014-10-19 08:30:19,2014-10-17 19:39:14
e5c53b393bddba1d716193634f705b60d3e20663...7fa66348cb6bdda942d76d4a65e93dd974a2d112,1,1,0,1,1,2014-10-19 09:54:32,2014-10-18 01:19:24
7fa66348cb6bdda942d76d4a65e93dd974a2d112...b64b9ea02c51c78a74ea43ff0047498a37acc804,1,7,7,14,3,2014-10-19 10:02:02,2014-10-19 09:58:32
b64b9ea02c51c78a74ea43ff0047498a37acc804...ed3f799b5c43f36cd162f3cdcdbdb43c33abde07,33,359,355,714,217,2014-10-19 10:09:16,2014-10-18 23:48:33
ed3f799b5c43f36cd162f3cdcdbdb43c33abde07...bf9e7bfb5a26f5f463f145e8a0fcce7835ce6877,2,30,2,32,2,2014-10-19 10:21:56,2014-10-17 13:31:59
bf9e7bfb5a26f5f463f145e8a0fcce7835ce6877...146440c5b2f7cd5e7a92a8c1516a297789ce6999,1,1,1,2,1,2014-10-19 10:25:35,2014-10-17 13:31:59
146440c5b2f7cd5e7a92a8c1516a297789ce6999...35e2a068ad830d214f9f150a2d38154d85d19c98,3,4,0,4,2,2014-10-19 10:25:35,2014-10-17 13:31:59
35e2a068ad830d214f9f150a2d38154d85d19c98...998c61cbe0f8bde4f54563a927b6ade3610b11f4,37,2,43,45,2,2014-10-19 10:56:58,2014-10-19 10:51:09
998c61cbe0f8bde4f54563a927b6ade3610b11f4...ba9d0738cd2e4501919021ee0f7b28734f5ffe36,4,0,74,74,9,2014-10-20 09:21:57,2014-10-19 22:40:31
ba9d0738cd2e4501919021ee0f7b28734f5ffe36...e1c0a8e642eac80380d3332b5fbd68007e8edeec,1,1,1,2,1,2014-10-20 09:32:06,2014-10-20 09:32:06
e1c0a8e642eac80380d3332b5fbd68007e8edeec...e4ce0ddda58e7d7cc4738f1a9a7bb9c9211a2f7c,1,2,2,4,2,2014-10-20 09:39:15,2014-10-19 22:00:05
e4ce0ddda58e7d7cc4738f1a9a7bb9c9211a2f7c...8b921617e932632ac3cc10c661436f417febc032,8,18,17,35,18,2014-10-20 09:39:32,2014-10-19 22:24:01
8b921617e932632ac3cc10c661436f417febc032...31ec9f14ef68027cb9c5d12c16465af909af2d2d,8,28,27,55,18,2014-10-20 09:39:37,2014-10-20 00:24:53
31ec9f14ef68027cb9c5d12c16465af909af2d2d...483ce91da28cc623926308f32c4816589ded26bc,28,101,100,201,83,2014-10-20 09:39:46,2014-10-20 01:12:23
483ce91da28cc623926308f32c4816589ded26bc...b8f3ad4b21eb657f0785773a47eae51b89e6626f,1,1,1,2,1,2014-10-20 10:43:58,2014-10-20 09:08:46
b8f3ad4b21eb657f0785773a47eae51b89e6626f...a7f886e6c81554823c44cf08e918d475bb9b8fb7,1,1,1,2,1,2014-10-20 11:11:03,2014-10-20 09:26:45
a7f886e6c81554823c44cf08e918d475bb9b8fb7...1025f6ebf4e5933a12920889be00cd8ac8a106fa,2,9,1,10,2,2014-10-20 12:06:44,2013-11-25 17:00:21
1025f6ebf4e5933a12920889be00cd8ac8a106fa...303610c7439c05f9d75235de89d3b11cef78788a,1,1,1,2,1,2014-10-20 12:20:05,2014-10-20 11:50:26
303610c7439c05f9d75235de89d3b11cef78788a...d97b427656aee08e38541e65e7750783fdfb399a,1,16,0,16,2,2014-10-20 13:20:46,2014-10-20 13:20:46
d97b427656aee08e38541e65e7750783fdfb399a...762713e660439e0b32dae386fad6d2c5d7297161,3,4,2,6,3,2014-10-20 14:42:25,2014-10-19 09:28:03
762713e660439e0b32dae386fad6d2c5d7297161...22b817ec11f7ab1a81342a4b60acd644a3f2a8c3,4,15,15,30,15,2014-10-20 14:42:34,2014-10-19 09:28:52
22b817ec11f7ab1a81342a4b60acd644a3f2a8c3...fc56c9b3cc9c4c9cda602dd23d87a50af59f5235,1,2,1,3,1,2014-10-20 15:24:35,2014-10-15 17:54:45
fc56c9b3cc9c4c9cda602dd23d87a50af59f5235...2240c113f5657171e4dd2ea792221298924608a7,16,278,1,279,20,2014-10-20 15:26:09,2014-10-15 17:58:24
2240c113f5657171e4dd2ea792221298924608a7...89c57a8761820b8e7ab363e1bebe794417fe8ea7,1,1,1,2,1,2014-10-20 20:34:04,2014-10-20 17:41:38
89c57a8761820b8e7ab363e1bebe794417fe8ea7...38d12de661c80467f78b9b7ab4060d3667ae107e,6,2,24,26,9,2014-10-21 12:22:24,2014-10-21 06:22:19
38d12de661c80467f78b9b7ab4060d3667ae107e...52ceec2229dc132b76da4e022c91474344f2d906,4,7,11,18,8,2014-10-21 13:31:25,2014-10-21 09:41:19
52ceec2229dc132b76da4e022c91474344f2d906...0a380b42641880c3c0ed1c7e74b381258f1960d1,1,1,1,2,1,2014-10-22 04:44:53,2014-10-22 04:41:26
0a380b42641880c3c0ed1c7e74b381258f1960d1...5d7763ebf999abd95eaedc83b081ff023008261b,1,2,1,3,1,2014-10-22 14:01:58,2014-10-22 11:28:54
5d7763ebf999abd95eaedc83b081ff023008261b...e9c5be58abdffe1904639ba04a70cf616e5ec7b6,1,5,0,5,1,2014-10-22 14:26:24,2014-10-22 12:16:36
e9c5be58abdffe1904639ba04a70cf616e5ec7b6...3635721ce4f8c226901bc4d32bed62e9430c140a,1,3,3,6,1,2014-10-22 14:49:18,2014-10-22 02:36:44
3635721ce4f8c226901bc4d32bed62e9430c140a...d488a894668839f35cc0635abdc8ff24cdd93963,1,11,2,13,2,2014-10-22 15:25:22,2014-10-21 14:29:46
d488a894668839f35cc0635abdc8ff24cdd93963...531a8de72c439d8ddd064874bf364c00cedabb11,2,19,1,20,2,2014-10-22 17:45:37,2014-10-21 11:57:48
531a8de72c439d8ddd064874bf364c00cedabb11...37790e920d20f8eda68ca3c999d693169bc69673,1,1,7,8,1,2014-10-22 18:00:54,2014-10-20 19:22:05
37790e920d20f8eda68ca3c999d693169bc69673...acbd302efbaaf0fb4d1d714e21955aa597dcbe3e,1,2,1,3,2,2014-10-22 18:16:21,2014-10-22 18:05:12
acbd302efbaaf0fb4d1d714e21955aa597dcbe3e...031d4cd2a95a6a1827ef4b3d16d173c314de8567,3,4,6,10,4,2014-10-22 19:38:36,2014-09-29 18:49:47
031d4cd2a95a6a1827ef4b3d16d173c314de8567...cfe7b0e9efbcbc4d6dafef568895be265842c071,1,2,2,4,2,2014-10-23 10:05:05,2014-10-23 10:02:54
cfe7b0e9efbcbc4d6dafef568895be265842c071...9ad6c77568a6d4bdf761de1b741edc5ee081f87d,1,25,1,26,3,2014-10-23 16:31:14,2014-10-21 14:53:15
9ad6c77568a6d4bdf761de1b741edc5ee081f87d...40bbc9817845bf75581daee5d0ec30980affb0f5,2,63,6,69,6,2014-10-23 18:08:55,2014-10-21 15:33:12
40bbc9817845bf75581daee5d0ec30980affb0f5...655fccce3ad52fd85fd3a5624e187f6ac6675664,2,4,1,5,2,2014-10-23 19:59:24,2014-10-21 01:00:22
655fccce3ad52fd85fd3a5624e187f6ac6675664...922162853b40bd1170a56352ee99f61963607ab9,7,13,8,21,11,2014-10-23 19:59:25,2014-10-21 01:16:44
922162853b40bd1170a56352ee99f61963607ab9...7f65f97919be5b8dcb18176df814eb30db28ea05,72,324,321,645,290,2014-10-23 19:59:25,2014-10-21 01:59:40
7f65f97919be5b8dcb18176df814eb30db28ea05...94f5a285bfcf04d800afc462a7a37a3469d77f1a,1,0,0,0,0,2014-10-23 19:59:25,2014-10-22 02:09:20
94f5a285bfcf04d800afc462a7a37a3469d77f1a...d3b1f502e3099d91042a1827a006ad112ea67d36,798,1139,1529,2668,1113,2014-10-23 19:59:26,2014-10-22 21:31:27
d3b1f502e3099d91042a1827a006ad112ea67d36...36666f6fade5bebc8ca5f77a928e01078313d78b,1,3,3,6,2,2014-10-23 20:29:52,2014-10-23 20:29:52
36666f6fade5bebc8ca5f77a928e01078313d78b...a54b25d77999a85701dfc5396fef78e586a99667,2,50,9,59,8,2014-10-23 20:40:34,2014-10-22 19:42:16
a54b25d77999a85701dfc5396fef78e586a99667...4cccf0f2a89b002d63cb443e1e7b15f76dcef425,1,1,1,2,1,2014-10-24 01:03:18,2014-10-24 00:19:08
4cccf0f2a89b002d63cb443e1e7b15f76dcef425...e780eeee27f468bed0a339cf6fbb74cadf7a76fe,1,9,0,9,1,2014-10-24 01:13:07,2014-10-24 00:35:34
e780eeee27f468bed0a339cf6fbb74cadf7a76fe...3b3d9218e81cd1349e8f15c59231002a1e89873e,1,1,1,2,1,2014-10-24 15:17:47,2014-10-24 13:33:51
3b3d9218e81cd1349e8f15c59231002a1e89873e...7574dd25d93c082a500478a23dfec16174d4b43f,1,16,11,27,17,2014-10-24 18:51:34,2014-10-21 11:58:06
7574dd25d93c082a500478a23dfec16174d4b43f...42f7c80bb66f5b365313def598cf24d593f9e4bc,1,0,23,23,1,2014-10-24 19:08:43,2014-10-20 21:51:50
42f7c80bb66f5b365313def598cf24d593f9e4bc...4d12812bb4b8ffd04e6587f075b5c5036b612ac6,1,19,23,42,3,2014-10-24 19:08:56,2014-10-20 22:02:10
4d12812bb4b8ffd04e6587f075b5c5036b612ac6...3df9de2e31661edae6f547827339e4ae156442e0,1,66,0,66,1,2014-10-24 19:09:00,2014-10-20 22:07:39
3df9de2e31661edae6f547827339e4ae156442e0...d0226ebbbf0f3007c75a5489a5ce3a45045f5636,1,11,11,22,11,2014-10-24 19:09:03,2014-10-21 05:01:23
d0226ebbbf0f3007c75a5489a5ce3a45045f5636...4bf254c155b5f5cfead7fd0bae439466f5f5a5bc,1,36,0,36,1,2014-10-24 19:14:20,2014-10-02 16:30:23
4bf254c155b5f5cfead7fd0bae439466f5f5a5bc...2cd5b4ec4409a818ccd33a6fbdeb99a3443a1809,2,7,7,14,7,2014-10-24 19:14:31,2014-10-02 22:42:53
2cd5b4ec4409a818ccd33a6fbdeb99a3443a1809...54ddca537ea26d6256eaf96e01e1416e44baf69e,1,8,4,12,1,2014-10-25 07:39:24,2014-10-25 07:39:01
54ddca537ea26d6256eaf96e01e1416e44baf69e...f34c1ff53f4f161b0d50ea19ff57ea4e712ffec4,1,1,1,2,1,2014-10-25 11:53:26,2014-10-24 14:35:09
f34c1ff53f4f161b0d50ea19ff57ea4e712ffec4...875f8f6557e2835e8a3aa8dc249e0eb65008ecb0,1,13,11,24,5,2014-10-25 12:03:26,2014-10-25 07:37:38
875f8f6557e2835e8a3aa8dc249e0eb65008ecb0...29d727210de72b1a136546530790aa054139ca0f,1,2,2,4,1,2014-10-27 09:24:07,2014-10-27 09:24:07
29d727210de72b1a136546530790aa054139ca0f...c3fcbbd7500c35cfb2764f6430bb841db1fc80c0,1,2,2,4,2,2014-10-27 09:51:02,2014-10-27 09:51:02
c3fcbbd7500c35cfb2764f6430bb841db1fc80c0...d1ccf176351cda2b49599374c7d4ba594796012f,3,245,263,508,11,2014-10-27 11:26:43,2014-10-27 11:26:43
d1ccf176351cda2b49599374c7d4ba594796012f...99ec8d66c554ca0120c5c6a5edf66e65704144f9,1,2,2,4,1,2014-10-27 16:23:04,2014-10-27 12:37:51
99ec8d66c554ca0120c5c6a5edf66e65704144f9...df3d7396544ddaf3a5c7cf08b81e08301a072141,2,8,9,17,6,2014-10-27 16:32:30,2014-10-27 13:49:06
df3d7396544ddaf3a5c7cf08b81e08301a072141...b4db713cde8539d118c9bbae91c4ded1979b0ebf,1,1,1,2,1,2014-10-28 20:19:25,2014-10-28 19:06:11
b4db713cde8539d118c9bbae91c4ded1979b0ebf...43b1a3739a3cb36bf9731d3bbd444c13f0480d42,1,1,1,2,1,2014-10-29 15:02:04,2014-10-29 13:59:33
43b1a3739a3cb36bf9731d3bbd444c13f0480d42...c3b3b90bc9c6b59305227709d5eee085b267e569,1,1,1,2,1,2014-10-29 17:50:57,2014-10-29 07:35:55
c3b3b90bc9c6b59305227709d5eee085b267e569...4b4098bfcae64f69c70a22393de1f3d9a0d3dc46,2,70,25,95,29,2014-10-29 18:37:48,2014-10-21 14:08:21
4b4098bfcae64f69c70a22393de1f3d9a0d3dc46...d7a78e420adad0869cf811ea14a6d801695dbfa0,1,18,15,33,6,2014-10-29 19:15:39,2014-10-14 18:10:52
d7a78e420adad0869cf811ea14a6d801695dbfa0...ce20dd06fe196bdcc0d1b0c9d2d271f90aea21fc,1,3,3,6,1,2014-10-29 19:40:48,2014-07-15 11:44:23
ce20dd06fe196bdcc0d1b0c9d2d271f90aea21fc...2a0254e1816b64c1235e3d71af1eefe5466d1fe3,1,1,0,1,1,2014-10-30 15:12:54,2014-10-30 15:04:41
2a0254e1816b64c1235e3d71af1eefe5466d1fe3...030101a43a5af69679b438969cccd0121e1576ae,736,757,752,1509,748,2014-10-31 15:27:16,2014-10-24 23:42:48
030101a43a5af69679b438969cccd0121e1576ae...c77f5d1a29a2d459247294bebd8e370da98e8a5b,1,1,1,2,2,2014-10-31 15:27:34,2014-10-26 01:48:15
c77f5d1a29a2d459247294bebd8e370da98e8a5b...018991f8c829e3454c0cc2a08d9aefb38f0f7974,1,1,0,1,1,2014-10-31 15:27:35,2014-10-26 02:05:25
018991f8c829e3454c0cc2a08d9aefb38f0f7974...3831e45a7d414cfa44297856689bd9added929f5,1,0,3,3,1,2014-10-31 15:27:35,2014-10-27 01:34:18
3831e45a7d414cfa44297856689bd9added929f5...7b7b082125f12d4681b81d9b4772d15346d2073e,1,1,1,2,1,2014-10-31 16:24:07,2014-10-31 16:14:47
7b7b082125f12d4681b81d9b4772d15346d2073e...ed6e91b31824b57a084b33b4fc7f869c8d5909be,1,1,1,2,1,2014-10-31 16:28:58,2014-10-31 12:22:29
ed6e91b31824b57a084b33b4fc7f869c8d5909be...e4eb382f2d8fa14ea757207f4b153ff338fea725,1,56,0,56,1,2014-10-31 17:39:14,2014-10-31 17:39:04
e4eb382f2d8fa14ea757207f4b153ff338fea725...2a2fd14c0881789680c8760a3586a03f4fbd9422,1,3,0,3,1,2014-10-31 22:08:22,2014-10-31 21:45:31
2a2fd14c0881789680c8760a3586a03f4fbd9422...b4770582f84f26c8ff7f2320a36a6b0ceff6e6cc,2,23,4,27,4,2014-11-01 22:08:24,2014-10-21 14:33:47
b4770582f84f26c8ff7f2320a36a6b0ceff6e6cc...e69c1806a8c03b3db39bc13f0219a909997a3c95,1,1,1,2,1,2014-11-01 22:11:51,2014-11-01 22:11:51
e69c1806a8c03b3db39bc13f0219a909997a3c95...ba731ab850e1d9587572ce367cec124c207adf8d,1,0,3,3,1,2014-11-02 17:43:52,2014-10-31 19:24:40
ba731ab850e1d9587572ce367cec124c207adf8d...e0198c1cda768e8711fc182b4f42643ba11cad04,1,1,0,1,1,2014-11-02 17:43:52,2014-10-31 19:25:33
e0198c1cda768e8711fc182b4f42643ba11cad04...0b16d10d2d6c7e0f04e0551998ffd306a7adc7dd,1,9,4,13,2,2014-11-02 18:47:09,2014-10-31 19:10:09
0b16d10d2d6c7e0f04e0551998ffd306a7adc7dd...d906ed3100c1c834425bd88872f02d6a63fec48f,1,2,2,4,2,2014-11-02 18:58:32,2014-11-01 13:23:46
d906ed3100c1c834425bd88872f02d6a63fec48f...9a26ab587011055cf95857f399c5bfa6a92f509d,1,1,1,2,1,2014-11-03 19:58:46,2014-11-03 19:50:09
9a26ab587011055cf95857f399c5bfa6a92f509d...0f7bcfdf93f041f741e094bb2e269368730d971f,2,12,0,12,1,2014-11-03 20:44:16,2014-10-24 17:09:24
0f7bcfdf93f041f741e094bb2e269368730d971f...0c19482d033f592fb9f341187c0a5d2e313e79cc,1,1,0,1,1,2014-11-04 17:46:31,2013-12-04 19:29:53
0c19482d033f592fb9f341187c0a5d2e313e79cc...b7e2b01bb5f427e4477edb03d9972216bb2799b2,2,7,7,14,7,2014-11-05 01:16:19,2014-11-04 19:43:16
b7e2b01bb5f427e4477edb03d9972216bb2799b2...0ccc4fcd891c7a18f0c4be544ef92bb4f4f0dd57,1,3,1,4,1,2014-11-05 13:36:37,2014-11-05 07:23:24
0ccc4fcd891c7a18f0c4be544ef92bb4f4f0dd57...56138bdd63fb192062bd494858ee9eb05d31ca3c,1,2,2,4,1,2014-11-05 14:08:56,2014-11-05 13:15:09
56138bdd63fb192062bd494858ee9eb05d31ca3c...dc4b06559fcaf64a431176bc644ecc0a4496fd87,1,2,1,3,1,2014-11-05 17:13:57,2014-11-05 16:13:37
dc4b06559fcaf64a431176bc644ecc0a4496fd87...74981c9f208b3617cbf00beafd61138d25c5d546,3,259,0,259,4,2014-11-05 18:23:19,2014-10-28 19:54:32
74981c9f208b3617cbf00beafd61138d25c5d546...da960544f1ab14ca6620f1f9eb6d52efd1bda04a,1,32,0,32,1,2014-11-05 19:43:13,2014-11-04 19:36:18
da960544f1ab14ca6620f1f9eb6d52efd1bda04a...841c0907556f525dbc4223609d808319fe0dd7e2,3,161,23,184,12,2014-11-05 20:41:51,2014-10-14 16:52:04
841c0907556f525dbc4223609d808319fe0dd7e2...91834bcf378744c7115bf1fbd769773ee0e3c59f,1,24,30,54,25,2014-11-05 20:41:51,2014-11-05 19:59:52
91834bcf378744c7115bf1fbd769773ee0e3c59f...187e43185dfb1bce6a318d95958c73cfb789d33c,2,21,0,21,2,2014-11-05 22:50:18,2014-10-29 21:32:26
187e43185dfb1bce6a318d95958c73cfb789d33c...c6909ed144cb67d638aecb7e045df35478758471,2,139,29,168,14,2014-11-06 15:17:37,2014-11-05 22:06:34
c6909ed144cb67d638aecb7e045df35478758471...6550198003c3f54cc635facb9340e2d6c16406c6,3,4,4,8,3,2014-11-06 18:57:50,2014-11-06 18:42:59
6550198003c3f54cc635facb9340e2d6c16406c6...7a4df50480ce6cfc02170d3f7b87940632220c97,1,6,6,12,6,2014-11-06 19:16:16,2014-11-03 23:14:45
7a4df50480ce6cfc02170d3f7b87940632220c97...288b5316262edd373a218f45cb5a6e6434d1bb7e,1,2,0,2,1,2014-11-06 20:27:44,2014-11-06 20:24:11
288b5316262edd373a218f45cb5a6e6434d1bb7e...e676d642f5feb8d3ba88944634afb479ba525c36,4,73,11,84,17,2014-11-07 03:30:48,2014-11-04 03:14:58
e676d642f5feb8d3ba88944634afb479ba525c36...e057a9aa398ead209bd6bbf76e22d2d5562904fb,4,78,24,102,20,2014-11-07 03:30:48,2014-11-07 00:41:18
e057a9aa398ead209bd6bbf76e22d2d5562904fb...ed99821e4dc621864f7e2d9a6b5305fca27fb7fa,3,29,1,30,3,2014-11-07 18:17:32,2014-10-29 15:08:16
ed99821e4dc621864f7e2d9a6b5305fca27fb7fa...9e305948e4965fb86b0c79985dc6e8c59a9c66af,2,15,1,16,2,2014-11-07 18:22:01,2014-11-06 21:29:53
9e305948e4965fb86b0c79985dc6e8c59a9c66af...e5939394117917ec7b25758e0ee368b08696af80,1,60,0,60,1,2014-11-07 18:32:10,2014-10-30 20:48:59
e5939394117917ec7b25758e0ee368b08696af80...4f5a60bcca60d04b5c68510f381cda755cc12610,1,4,2,6,3,2014-11-07 18:32:10,2014-10-30 21:04:47
4f5a60bcca60d04b5c68510f381cda755cc12610...6dfd938bbce37312b45fc68fc270c2cac5a73bc2,1,1,1,2,1,2014-11-07 18:32:10,2014-10-30 21:08:41
6dfd938bbce37312b45fc68fc270c2cac5a73bc2...0918f146e4f917b2305d73a2a7be363532799b62,1,36,0,36,1,2014-11-07 19:09:32,2014-11-07 19:09:32
0918f146e4f917b2305d73a2a7be363532799b62...1db9e617cef49fe4f72aa2d9b1bf7b4eea9ab05c,1,2,2,4,1,2014-11-07 19:11:10,2014-11-07 19:11:10
1db9e617cef49fe4f72aa2d9b1bf7b4eea9ab05c...b6fd184a93937765a7a5d13de8e676880ea75fa5,1,10,0,10,1,2014-11-08 01:09:44,2014-11-08 01:09:44
b6fd184a93937765a7a5d13de8e676880ea75fa5...b84e62bd28d3b1d7f5c8c03829a88b9eb9e48c9c,1,2,2,4,1,2014-11-08 13:11:51,2014-11-08 06:46:13
b84e62bd28d3b1d7f5c8c03829a88b9eb9e48c9c...50e72fcae143ffa9f519a435278a1319e2cdb5c0,1,1,1,2,1,2014-11-08 13:56:39,2014-11-06 10:40:06
50e72fcae143ffa9f519a435278a1319e2cdb5c0...06016bb12c5bed0da3a941d7e0859d6a0dc9ab38,46,253,253,506,146,2014-11-09 14:51:01,2014-11-08 16:26:29
06016bb12c5bed0da3a941d7e0859d6a0dc9ab38...e21b6ff3ff75f054a09e314d5b2762e9b31b6349,7,56,50,106,13,2014-11-09 14:51:01,2014-11-08 16:33:04
e21b6ff3ff75f054a09e314d5b2762e9b31b6349...77d8ae1d458ce526f77d059bae05100299d10f67,3,12,12,24,11,2014-11-09 15:18:00,2014-10-07 23:58:05
77d8ae1d458ce526f77d059bae05100299d10f67...f157d02793f7a3d1fc9a72c17d24844f1e2edc6b,1,11,6,17,1,2014-11-09 22:31:27,2014-11-09 22:31:24
f157d02793f7a3d1fc9a72c17d24844f1e2edc6b...2abea7514a6a4c79a1ed72398ac9e550934c401b,1,1,1,2,1,2014-11-10 17:05:46,2014-11-10 17:00:05
2abea7514a6a4c79a1ed72398ac9e550934c401b...52545e5a748e5b79f5502e7155949d2c211a9cb8,1,1,2,3,1,2014-11-10 18:07:15,2014-10-28 09:38:54
52545e5a748e5b79f5502e7155949d2c211a9cb8...41b36e689c39700ba90a3aed9da4603ed3739699,1,1,1,2,1,2014-11-10 18:19:05,2014-10-29 23:30:42
41b36e689c39700ba90a3aed9da4603ed3739699...ee1fc1dc1335f2b31e28b4afc659761f71126610,1,1,1,2,1,2014-11-10 18:42:20,2014-11-01 12:52:17
ee1fc1dc1335f2b31e28b4afc659761f71126610...9cc6835819667351352bfbbf02b72bf075cabb1b,1,1,1,2,1,2014-11-10 19:41:04,2014-11-03 23:00:55
9cc6835819667351352bfbbf02b72bf075cabb1b...0462ee6659bd464227bc71e9507cb75f243bd9cb,1,1,1,2,1,2014-11-11 09:20:32,2014-11-05 20:20:59
0462ee6659bd464227bc71e9507cb75f243bd9cb...830846f664187eb748a75f7eb874632678f93ec7,1,1,1,2,1,2014-11-11 11:24:30,2014-11-11 11:19:14
830846f664187eb748a75f7eb874632678f93ec7...ebc3b7b1c361b6b9e9f8bff5579614e2019fa222,1,1,1,2,1,2014-11-11 11:35:19,2014-11-11 11:19:36
ebc3b7b1c361b6b9e9f8bff5579614e2019fa222...804e75045c0e2b2b8876a1cb28b22311f2895ce6,1,1,1,2,1,2014-11-11 18:59:17,2014-11-03 20:09:39
804e75045c0e2b2b8876a1cb28b22311f2895ce6...5e78af769e68f7f4079b2ff0a81c2b4db508cc0f,1,1,0,1,1,2014-11-11 19:13:28,2014-11-08 13:44:01
5e78af769e68f7f4079b2ff0a81c2b4db508cc0f...0db573b7493f76abd94ff65ce660017d617e865b,2,37,0,37,3,2014-11-11 19:20:16,2014-11-01 19:12:05
0db573b7493f76abd94ff65ce660017d617e865b...8582088b36dacc4901695847b6693061c22e3296,1,0,4,4,1,2014-11-11 20:03:51,2014-11-11 19:40:57
8582088b36dacc4901695847b6693061c22e3296...b7afd11d26d65b9f3a09cc60dd47216a8b2b0986,2,12,3,15,4,2014-11-12 01:29:36,2014-11-07 21:13:31
b7afd11d26d65b9f3a09cc60dd47216a8b2b0986...7e233eb58a19b12f460423fd2718079ac3b6b0ea,1,1,1,2,1,2014-11-12 08:04:56,2014-11-11 22:26:20
7e233eb58a19b12f460423fd2718079ac3b6b0ea...fa0d8c47c3050a5732291bcaa77e086bb3ad8569,1,4,0,4,1,2014-11-12 08:13:43,2014-11-11 22:45:28
fa0d8c47c3050a5732291bcaa77e086bb3ad8569...381b185117c9bcf549e0297037f9dcffbb96c896,1,1,1,2,1,2014-11-12 18:50:09,2014-11-12 10:22:06
381b185117c9bcf549e0297037f9dcffbb96c896...0bbc6ee4812a8587b73c9c0f9c858c66badb29f6,1,4,2,6,2,2014-11-12 20:02:24,2014-11-12 19:39:33
0bbc6ee4812a8587b73c9c0f9c858c66badb29f6...8b775a0d58f0131a4488ee225204c11b345ce311,1,6,0,6,1,2014-11-12 21:50:21,2014-11-12 19:58:59
8b775a0d58f0131a4488ee225204c11b345ce311...fbad2805703569058a4a860747b0e2d8aee36bdf,3,174,160,334,65,2014-11-12 22:36:23,2014-10-05 00:09:22
fbad2805703569058a4a860747b0e2d8aee36bdf...14ff529fbbff46413c0cb451a2f0abbd16b05d5e,1,1,1,2,1,2014-11-13 13:33:24,2013-09-30 15:57:34
14ff529fbbff46413c0cb451a2f0abbd16b05d5e...8eabc5463c795d87f37e5a9eacbbb14435024061,1,1,3,4,1,2014-11-14 14:34:16,2014-11-06 14:07:21
8eabc5463c795d87f37e5a9eacbbb14435024061...be6920b356ce9fe4bd02e34691b575f72962db10,1,202,88,290,6,2014-11-14 15:02:23,2014-11-14 14:53:41
be6920b356ce9fe4bd02e34691b575f72962db10...7f857e44a20c4a5dfcd6cae6d0d74e63ea91f424,1,1,1,2,1,2014-11-14 16:03:24,2014-11-12 10:24:48
7f857e44a20c4a5dfcd6cae6d0d74e63ea91f424...22ecbc50f49e731f398bcca4965227defa898b17,1,5,1,6,1,2014-11-14 16:09:37,2014-11-14 04:58:40
22ecbc50f49e731f398bcca4965227defa898b17...eca14d98a43896be7f010fa6cf0f7ca31529a5a2,1,4,4,8,1,2014-11-14 16:11:39,2014-11-14 16:11:39
eca14d98a43896be7f010fa6cf0f7ca31529a5a2...d81ff8885b77f70c6417d7be3124d86d07447375,2,16,8,24,6,2014-11-14 16:42:24,2014-11-13 00:49:20
d81ff8885b77f70c6417d7be3124d86d07447375...85eb9660ef67c24d5104a6a1921bedad0bd1b57e,2,80,13,93,6,2014-11-14 20:18:57,2014-11-03 19:37:20
85eb9660ef67c24d5104a6a1921bedad0bd1b57e...195deca6e21faf870f6e69b867264a206d8a6649,1,49,29,78,16,2014-11-14 21:16:42,2014-11-13 14:51:56
195deca6e21faf870f6e69b867264a206d8a6649...6604c2361427fba8c43a39dc2e92197390dfbdbe,2,19,0,19,3,2014-11-14 21:17:28,2014-11-13 14:51:56
6604c2361427fba8c43a39dc2e92197390dfbdbe...9d1e87a3f1bb57faf85729d4340be840bf336d71,1,11,4,15,3,2014-11-14 23:06:59,2014-11-10 22:44:02
9d1e87a3f1bb57faf85729d4340be840bf336d71...5b23bc9b07f8a4363c9c549a248f690b1a31b7be,3,317,48,365,21,2014-11-14 23:08:42,2014-11-12 19:56:26
5b23bc9b07f8a4363c9c549a248f690b1a31b7be...f30163e63a9efe2254e435aa643d2cf69f9e8182,2,5,0,5,2,2014-11-15 10:30:23,2014-11-08 21:54:36
f30163e63a9efe2254e435aa643d2cf69f9e8182...6f19a6fd33ab72d3908e3418fba47ee8e1598fa6,2,12,1,13,2,2014-11-15 11:43:24,2014-11-04 19:22:52
6f19a6fd33ab72d3908e3418fba47ee8e1598fa6...a9352c19ce33f0393d6581547c7ea8dfc2a8b78f,3,199,5,204,7,2014-11-15 23:25:21,2014-10-18 20:40:41
a9352c19ce33f0393d6581547c7ea8dfc2a8b78f...cf43ccdf9b8665a2fd5d6aa52f80cb2d7c9bb7e2,7,58,20,78,10,2014-11-17 13:37:52,2014-11-17 07:07:43
cf43ccdf9b8665a2fd5d6aa52f80cb2d7c9bb7e2...fa12c3c86af7965d1b9d9a5dd3434755e9e04635,1,1,1,2,1,2014-11-17 13:37:58,2014-11-17 07:07:43
fa12c3c86af7965d1b9d9a5dd3434755e9e04635...e80053d91fd7c722e092a23d326384de2e552eb6,2,11,11,22,3,2014-11-17 13:38:04,2014-11-17 07:14:32
e80053d91fd7c722e092a23d326384de2e552eb6...2901c53f4291e81eb21b890987f338102b71e04a,1,1,1,2,1,2014-11-17 13:47:47,2014-11-16 14:02:38
2901c53f4291e81eb21b890987f338102b71e04a...eec2020518d4e988d962a2da545e880783f99f7d,1,2,2,4,1,2014-11-17 14:33:50,2014-11-16 15:19:59
eec2020518d4e988d962a2da545e880783f99f7d...4d885cbd626caf42922ff5917fbd81afc3cc2086,1,1,1,2,1,2014-11-17 14:44:23,2014-11-17 09:59:47
4d885cbd626caf42922ff5917fbd81afc3cc2086...4d4e6036a9bdb1a119959f3227fb330fd337d78c,1,0,0,0,0,2014-11-17 17:32:21,2014-11-17 17:31:08
4d4e6036a9bdb1a119959f3227fb330fd337d78c...c9899c53ac189874eb766c903cca9fd3407480e5,1,51,48,99,17,2014-11-17 19:26:17,2014-11-15 22:27:12
c9899c53ac189874eb766c903cca9fd3407480e5...e3764e30a301ec6136c8e6b5493d39feb3cd1ecc,2,173,4,177,10,2014-11-17 19:26:27,2014-11-12 20:08:39
e3764e30a301ec6136c8e6b5493d39feb3cd1ecc...4f4ff5f31b82c6f7be409ea4edbad4c2913ac1f1,1,1,1,2,1,2014-11-18 07:08:47,2014-11-17 23:46:36
4f4ff5f31b82c6f7be409ea4edbad4c2913ac1f1...d5968c785389d0d516075979f953d855398eb301,1,47,0,47,1,2014-11-18 08:23:38,2014-11-18 08:22:58
d5968c785389d0d516075979f953d855398eb301...5f552896ab75ea22746030cc90de8bf95e71691b,1,7,7,14,7,2014-11-18 14:24:22,2014-11-18 14:24:22
5f552896ab75ea22746030cc90de8bf95e71691b...f7fde935d51e9141ef968a2646407c9b0dcf7eae,1,3,3,6,3,2014-11-18 18:05:45,2014-11-18 09:49:21
f7fde935d51e9141ef968a2646407c9b0dcf7eae...637c020f828a7ceeaacf83bb1a54ed3092e6c273,2,17,2,19,3,2014-11-18 21:37:38,2014-11-17 09:29:22
637c020f828a7ceeaacf83bb1a54ed3092e6c273...2b41a5868aee79e3872ad92db66e30959207d98e,2,103,19,122,9,2014-11-18 22:49:24,2014-11-12 11:38:01
2b41a5868aee79e3872ad92db66e30959207d98e...bb16759f0bfe50f9b72ed3f2b5e0bf43c3a63080,1,3,1,4,2,2014-11-19 18:54:15,2014-11-19 14:59:40
bb16759f0bfe50f9b72ed3f2b5e0bf43c3a63080...e8941c0fe5217d2e705bad8253dc0162aff4c709,2,37,5,42,3,2014-11-19 19:07:07,2014-11-13 21:44:17
e8941c0fe5217d2e705bad8253dc0162aff4c709...dc9775da964e205ab2af495495f9163cb50e063b,1,3,1,4,1,2014-11-19 21:31:56,2014-11-19 21:31:50
dc9775da964e205ab2af495495f9163cb50e063b...5c611e898a1a62f1a7b1e0da7bb5a5b08d7f00f6,1,51,0,51,1,2014-11-20 18:28:02,2014-11-20 18:28:02
5c611e898a1a62f1a7b1e0da7bb5a5b08d7f00f6...8ac369e829e0ee6b3e266194f242ef112aa74c37,1,17,15,32,4,2014-11-20 21:19:02,2014-11-19 19:17:07
8ac369e829e0ee6b3e266194f242ef112aa74c37...637d3b47d191eb9353531abfdc9f5460e0eff5ba,1,6,0,6,2,2014-11-20 21:25:38,2014-11-20 21:25:28
637d3b47d191eb9353531abfdc9f5460e0eff5ba...eab271876cb87c1f5f6c6f29e814fb8fecad87ff,2,33,5,38,4,2014-11-20 22:01:43,2014-10-27 23:50:15
eab271876cb87c1f5f6c6f29e814fb8fecad87ff...158241e2129b822c3ae2aa4681028dc90cb323e7,1,8,2,10,1,2014-11-20 22:31:58,2014-11-20 22:26:03
158241e2129b822c3ae2aa4681028dc90cb323e7...1c68d00fbf208f25b46cba932ef1e995d7877df9,1,1,1,2,1,2014-11-20 22:34:37,2014-11-20 22:31:40
1c68d00fbf208f25b46cba932ef1e995d7877df9...1b275fb00e1606fec1adac7e951d30f84336a747,1,1,1,2,1,2014-11-20 23:02:34,2014-11-20 23:02:13
1b275fb00e1606fec1adac7e951d30f84336a747...5388ca5710b6ea1ff984c44ff75ac384036ad440,1,15,0,15,1,2014-11-21 05:26:17,2014-11-20 15:14:25
5388ca5710b6ea1ff984c44ff75ac384036ad440...95e03bce7e030b5e14fe3bf171be864f36a43876,1,3,3,6,2,2014-11-21 05:26:39,2014-11-21 05:26:00
95e03bce7e030b5e14fe3bf171be864f36a43876...d3fb8dd77614a1512d1d83e64e4afd10580f9cc1,2,10,0,10,3,2014-11-21 11:04:24,2014-11-19 18:35:57
d3fb8dd77614a1512d1d83e64e4afd10580f9cc1...16c8f29ef6498991c31671d0dc0072543d156b41,1,39,39,78,14,2014-11-21 11:08:22,2014-11-21 11:08:22
16c8f29ef6498991c31671d0dc0072543d156b41...dc5bba861582d32e7db67be4ec383a14aff9f88d,1,5,6,11,1,2014-11-21 13:29:16,2014-11-19 16:37:21
dc5bba861582d32e7db67be4ec383a14aff9f88d...95f8a8bab0cff27025a795cb00bd1e59b28aaded,1,4,4,8,1,2014-11-21 13:51:04,2014-11-21 13:51:04
95f8a8bab0cff27025a795cb00bd1e59b28aaded...7dd94b959579c62de9c491928e97a0b8250161bb,1,12,12,24,7,2014-11-21 13:57:35,2014-11-19 15:04:26
7dd94b959579c62de9c491928e97a0b8250161bb...5c43b94fc49c8febab89d78c1c8dd744afcaa89e,261,6324,4150,10474,1719,2014-11-21 14:42:44,2014-11-21 14:42:44
5c43b94fc49c8febab89d78c1c8dd744afcaa89e...b5fbd6a2f6ab7be10210c528696ac8e0403979d5,1,0,0,0,0,2014-11-22 10:54:28,2014-11-22 10:54:28
b5fbd6a2f6ab7be10210c528696ac8e0403979d5...93552fed1c6cd2e13f53d45a0a0031a333858d75,1,2,2,4,2,2014-11-22 14:34:16,2014-10-29 16:16:24
93552fed1c6cd2e13f53d45a0a0031a333858d75...891acf4c201823fd2c925ee321c70d06737d5944,2,24,1,25,2,2014-11-22 14:34:16,2014-10-29 16:48:04
891acf4c201823fd2c925ee321c70d06737d5944...5c1fdff691b9367d73f72f6a0298cb6a6e259f35,2,11,1,12,2,2014-11-22 15:00:43,2014-11-11 09:20:39
5c1fdff691b9367d73f72f6a0298cb6a6e259f35...92f87b114242b01876e1dc5c6fddd061352ecb2c,2,34,2,36,4,2014-11-22 15:00:44,2014-11-11 09:37:53
92f87b114242b01876e1dc5c6fddd061352ecb2c...00b623e86b1b5dcff750c79e3e88b49412184849,1,12,6,18,6,2014-11-22 15:00:44,2014-11-14 22:15:37
00b623e86b1b5dcff750c79e3e88b49412184849...7812dfcee8ab98cbf38261f9948d9541656bf554,2,10,2,12,2,2014-11-22 15:30:41,2014-11-14 20:34:34
7812dfcee8ab98cbf38261f9948d9541656bf554...764fa869dd8809d494924c23f30ddaa4cac84249,2,7,1,8,2,2014-11-22 15:48:54,2014-11-20 23:57:57
764fa869dd8809d494924c23f30ddaa4cac84249...6dbd606ad7b708d5886c0e7ffee20ae8f8719711,2,8,3,11,3,2014-11-22 20:29:06,2014-11-22 18:50:54
6dbd606ad7b708d5886c0e7ffee20ae8f8719711...bb4d3b73a1ccf3dee55b0c25baf031bae5cbb676,2,61,25,86,9,2014-11-22 20:36:12,2014-11-20 00:57:27
bb4d3b73a1ccf3dee55b0c25baf031bae5cbb676...aa01be8b2c5af1eacc06b245c8108d57184618fe,1,4,0,4,1,2014-11-22 21:11:59,2014-11-22 16:43:41
aa01be8b2c5af1eacc06b245c8108d57184618fe...31093426794b75a271a24459eca361f676d76349,1,206,213,419,42,2014-11-22 21:47:41,2014-11-22 19:30:16
31093426794b75a271a24459eca361f676d76349...920b595080752e2a88b4e607547aa5946c0d00c6,2,12,5,17,6,2014-11-22 22:01:37,2014-11-22 19:04:02
920b595080752e2a88b4e607547aa5946c0d00c6...a3d79775e1562a7de200b4518f822ade4ad4c6a6,1,1,3,4,1,2014-11-22 22:13:12,2014-11-22 19:12:47
a3d79775e1562a7de200b4518f822ade4ad4c6a6...3be6835e0f0ae4c0e8a191b146662cfe7c762670,1,50,2,52,9,2014-11-22 22:16:57,2014-11-22 21:13:55
3be6835e0f0ae4c0e8a191b146662cfe7c762670...7a374691b9d3a249ecf8f2f878e1370c579e0364,1,2,2,4,1,2014-11-22 22:48:02,2014-11-22 22:26:40
7a374691b9d3a249ecf8f2f878e1370c579e0364...e9b9421cdb6086a35faa99fc5377171eb66d1fa4,3,20,0,20,3,2014-11-22 23:34:55,2014-11-22 20:07:19
e9b9421cdb6086a35faa99fc5377171eb66d1fa4...7496e8e5b7113f8362f88d52d7731ed84f71e881,3,13,13,26,4,2014-11-23 08:38:36,2014-11-22 23:38:27
7496e8e5b7113f8362f88d52d7731ed84f71e881...addb4bdd575ff0e4620243471221e9292ab96fdd,2,4,13,17,6,2014-11-23 13:26:33,2014-11-14 01:13:31
addb4bdd575ff0e4620243471221e9292ab96fdd...4644c5840fc6ec84203ad854bde68f4883ff5aa3,1,10,8,18,7,2014-11-23 15:08:39,2014-11-21 19:47:01
4644c5840fc6ec84203ad854bde68f4883ff5aa3...40406e2f22713efbd37ef3eff408339727cb62d9,1,11,11,22,7,2014-11-23 15:08:39,2014-11-21 19:47:43
40406e2f22713efbd37ef3eff408339727cb62d9...8692f87a4689fa0dd3640f4dcab5c6b6f960489b,2,20,2,22,3,2014-11-23 15:08:39,2014-11-21 19:47:43
8692f87a4689fa0dd3640f4dcab5c6b6f960489b...42d09f1772aeb15b3838fd2f18ff8af674cd6777,1,4,3,7,3,2014-11-23 15:24:36,2014-11-23 15:24:36
42d09f1772aeb15b3838fd2f18ff8af674cd6777...8ee8ffeba0a5a133fa792745c1019d294ecfcef3,2,5,1,6,2,2014-11-23 21:58:18,2014-09-05 23:40:26
8ee8ffeba0a5a133fa792745c1019d294ecfcef3...bf6a79c3484f474c300b5442ae73483030ef5782,4,8,11,19,6,2014-11-23 22:37:08,2014-11-14 07:16:05
bf6a79c3484f474c300b5442ae73483030ef5782...09a9832358960c98392c9df1a9fd9592f59bc844,2,6,1,7,2,2014-11-24 22:11:00,2014-11-22 09:20:26
09a9832358960c98392c9df1a9fd9592f59bc844...9474ec120acc425103516f1018e63ae39d7d629b,1,86,0,86,1,2014-11-24 23:05:18,2014-11-24 23:05:18
9474ec120acc425103516f1018e63ae39d7d629b...266da340984f62bb280e5cb146d1d126d6ac77bd,1,9,38,47,9,2014-11-25 18:17:01,2014-11-18 10:57:31
266da340984f62bb280e5cb146d1d126d6ac77bd...719d5c5fa59ae1617691a0dca02da861fcf5f933,1,3,1,4,1,2014-11-25 18:17:57,2014-11-10 10:53:28
719d5c5fa59ae1617691a0dca02da861fcf5f933...5d36353bc9c4b4e6c96443e7dcb24d86b21ba40f,1,1,1,2,1,2014-11-25 18:51:33,2014-11-23 18:58:45
5d36353bc9c4b4e6c96443e7dcb24d86b21ba40f...0caa5ad83f415df5b31e4da308fbc84b6f678e1b,1,1,1,2,1,2014-11-26 18:04:24,2014-11-26 01:05:26
0caa5ad83f415df5b31e4da308fbc84b6f678e1b...41dc7d5ebddd62420a81d95dd794f877855bdd70,1,1,1,2,1,2014-11-26 18:05:53,2014-11-25 23:47:17
41dc7d5ebddd62420a81d95dd794f877855bdd70...08cd5c19c7a5116e7e74691391fc5e28bfae4521,2,19,12,31,3,2014-11-26 19:03:23,2014-07-19 22:32:27
08cd5c19c7a5116e7e74691391fc5e28bfae4521...2ec8d1ffc04e06a39cb1b74a8d675da38e0a1c6b,2,2,2,4,2,2014-11-26 20:35:11,2014-11-26 19:48:49
2ec8d1ffc04e06a39cb1b74a8d675da38e0a1c6b...8f05ca555285da6e58e50dfe751426d999b0f28e,3,3,9,12,3,2014-11-26 20:36:33,2014-11-26 20:09:49
8f05ca555285da6e58e50dfe751426d999b0f28e...1e6a5b29a61a8dd7b155d76e179ee71b30bf0154,1,7,2,9,1,2014-11-26 21:51:31,2014-11-26 20:09:49
1e6a5b29a61a8dd7b155d76e179ee71b30bf0154...9b3d9656a69a931f4fcd321cedf837661e1e5785,1,1,1,2,1,2014-11-27 07:52:13,2014-11-26 12:06:47
9b3d9656a69a931f4fcd321cedf837661e1e5785...e2b9eccde03d79c02354a91eadb524c527ea39bf,1,1,1,2,1,2014-11-27 07:53:05,2014-11-26 22:52:59
e2b9eccde03d79c02354a91eadb524c527ea39bf...e5a9b265ba7dacc92321dd83208d2ed6543b794b,1,1,1,2,1,2014-11-27 18:02:31,2014-11-27 17:15:28
e5a9b265ba7dacc92321dd83208d2ed6543b794b...655ac6474b3bbdfa6af9a8105213ecc6893b5504,1,1,1,2,1,2014-11-27 20:14:01,2014-11-27 19:43:52
655ac6474b3bbdfa6af9a8105213ecc6893b5504...30694c802763d46d6787f7298f47dfef53ed4229,2,195,8,203,7,2014-11-27 20:40:43,2014-11-22 00:33:26
30694c802763d46d6787f7298f47dfef53ed4229...b2b6d74ae5c9ed62ecd1a09a8631aeb90cec8d05,1,2,3,5,1,2014-11-29 04:09:18,2014-11-28 02:50:05
b2b6d74ae5c9ed62ecd1a09a8631aeb90cec8d05...d0351c4803c289b66468f693c93d33ab0b8d85ee,1,1,1,2,1,2014-11-29 04:28:39,2014-11-29 04:28:39
d0351c4803c289b66468f693c93d33ab0b8d85ee...e6a2527cdfa6a7ef22ecf6a456e7aa48ddec23ce,1,3,3,6,1,2014-11-29 22:19:32,2014-11-29 22:13:02
e6a2527cdfa6a7ef22ecf6a456e7aa48ddec23ce...dde613f18ef1e3f10e6678b957423afd3512ca04,1,4,2,6,2,2014-11-30 11:50:41,2014-11-30 01:23:55
dde613f18ef1e3f10e6678b957423afd3512ca04...814c9847e8489809b150d3b54e9da25c1fceb581,2,17,7,24,3,2014-12-01 01:35:14,2014-04-03 04:59:21
814c9847e8489809b150d3b54e9da25c1fceb581...b264be40bc3470caa52d4f1f845fd96367dd3fde,2,7,17,24,3,2014-12-01 12:42:18,2014-12-01 12:42:18
b264be40bc3470caa52d4f1f845fd96367dd3fde...446e5669a17a310b7ad12c923cf327861707699d,1,1,1,2,1,2014-12-01 13:38:47,2014-11-10 12:09:29
446e5669a17a310b7ad12c923cf327861707699d...3f07eb227d7b74bce5103fe7fc19be6ef235b117,1,1,1,2,1,2014-12-01 13:39:27,2014-11-10 12:32:42
3f07eb227d7b74bce5103fe7fc19be6ef235b117...9a83f9d2fabe0a259c283b7f7cd935e4b36e2b5d,1,2,2,4,2,2014-12-01 18:25:43,2014-11-30 10:00:57
9a83f9d2fabe0a259c283b7f7cd935e4b36e2b5d...ab2531143e3bdc85836902fb5b8de72478e3710e,1,3,8,11,1,2014-12-01 18:31:53,2014-11-29 10:17:52
ab2531143e3bdc85836902fb5b8de72478e3710e...f6458826ac974914597a10b0ffdeee3c5d2c62ef,2,16,2,18,3,2014-12-01 18:50:13,2014-11-29 11:29:54
f6458826ac974914597a10b0ffdeee3c5d2c62ef...9fa73cb4e7190b4d00b65f2f8f9f7d37607308ba,2,26,1,27,2,2014-12-01 18:54:14,2014-11-25 21:09:59
9fa73cb4e7190b4d00b65f2f8f9f7d37607308ba...240e0d5c8eee40130e22d99d92ad2626d4492955,1,31,0,31,1,2014-12-01 21:29:36,2014-12-01 19:54:09
240e0d5c8eee40130e22d99d92ad2626d4492955...c6b57f1ec6d8b541c3d6b2019a5ad0544745522a,1,8,8,16,3,2014-12-01 22:43:04,2014-12-01 12:59:09
c6b57f1ec6d8b541c3d6b2019a5ad0544745522a...5481e2cfcd4d136a1c7f45cd4ce0fa1a8a15074d,2,77,11,88,6,2014-12-02 00:15:57,2014-12-01 22:28:03
5481e2cfcd4d136a1c7f45cd4ce0fa1a8a15074d...e93710fe0e4fb05ceee59a04f290692a5bec5d20,2,19,2,21,4,2014-12-02 12:04:59,2014-11-05 13:49:01
e93710fe0e4fb05ceee59a04f290692a5bec5d20...7c6be43e83590798cffef63d076fb79d5296fba2,2,5,3,8,3,2014-12-02 12:11:35,2014-10-12 19:11:19
7c6be43e83590798cffef63d076fb79d5296fba2...013b522c9e690665aecb0e0f656e4557a673ec09,2,31,9,40,11,2014-12-02 17:19:15,2014-10-21 11:48:22
013b522c9e690665aecb0e0f656e4557a673ec09...8df47db72f7b0d3d4b491b3d3fc3a4cbd467fd3a,1,1,1,2,1,2014-12-02 18:21:02,2014-12-02 00:13:21
8df47db72f7b0d3d4b491b3d3fc3a4cbd467fd3a...915a891ad4cdcaa5e47e976db8f4d402d230be77,2,9,3,12,3,2014-12-02 18:25:54,2014-12-02 01:33:53
915a891ad4cdcaa5e47e976db8f4d402d230be77...96c61fe756d7d3db011818bf0925e3d86ffff8ce,2,13,10,23,8,2014-12-02 18:36:39,2014-11-29 22:18:58
96c61fe756d7d3db011818bf0925e3d86ffff8ce...f7cf846045b1e2fb39c62e304c61b44d5c805e31,2,136,87,223,12,2014-12-02 18:52:11,2014-10-23 09:59:22
f7cf846045b1e2fb39c62e304c61b44d5c805e31...a631a759d25e05d54db7c9d519cbcb48d95bdc75,2,21,1,22,2,2014-12-02 18:52:21,2014-11-11 11:29:19
a631a759d25e05d54db7c9d519cbcb48d95bdc75...5ced914cc8625008e6249d5ac5942d5822287cc0,2,174,31,205,17,2014-12-02 18:52:21,2014-11-18 15:26:15
5ced914cc8625008e6249d5ac5942d5822287cc0...a75537d461c92e3455e372ff5005bf0cad2d2e95,2,42,15,57,18,2014-12-02 18:52:21,2014-11-24 14:32:06
a75537d461c92e3455e372ff5005bf0cad2d2e95...429938da1f45b8a649b8c77762fb0ae59b6d0cea,2,10,3,13,3,2014-12-02 21:45:32,2014-12-02 09:46:09
429938da1f45b8a649b8c77762fb0ae59b6d0cea...c8c9bbc412f00624bd591f33348560ad49ec2038,1,5,0,5,1,2014-12-02 22:13:34,2014-12-02 21:41:01
c8c9bbc412f00624bd591f33348560ad49ec2038...1191edba4eaa15f675fa4ed047949a150843971b,3,16,6,22,7,2014-12-02 22:32:38,2014-10-24 03:28:30
1191edba4eaa15f675fa4ed047949a150843971b...7daf4e01253258fa3525b6a0f3ace9f2b4224619,1,9,3,12,3,2014-12-02 22:32:38,2014-12-02 20:39:08
7daf4e01253258fa3525b6a0f3ace9f2b4224619...9a616eade4386341e51f993fe8824840ea96a8e9,2,7,2,9,3,2014-12-02 22:32:39,2014-12-02 20:43:03
9a616eade4386341e51f993fe8824840ea96a8e9...9c113aa4afdca236a1d7e08f668085aebae6a025,1,3,3,6,2,2014-12-03 03:00:00,2014-12-02 22:15:00
9c113aa4afdca236a1d7e08f668085aebae6a025...32806caf1378aa609e1fb29bbbf35cfc5232dd96,1,5,5,10,3,2014-12-03 03:00:00,2014-12-02 22:22:44
32806caf1378aa609e1fb29bbbf35cfc5232dd96...1b640f9665d909cfb332ad6ad460cac6bd71b299,1,68,0,68,1,2014-12-03 18:15:08,2014-11-19 06:39:42
1b640f9665d909cfb332ad6ad460cac6bd71b299...cc0fbe37d4ff5215c2696bc0f0e583b98ddfa3bd,1,1,1,2,1,2014-12-03 18:21:38,2014-12-02 17:14:11
cc0fbe37d4ff5215c2696bc0f0e583b98ddfa3bd...015111fd79609eb64ed56032617060c4ed4289f6,1,1,1,2,1,2014-12-03 18:38:00,2014-12-02 20:51:31
015111fd79609eb64ed56032617060c4ed4289f6...8bfeddb5d671017f4a21b8b46334ac816710b143,2,44,5,49,4,2014-12-03 19:19:24,2014-12-03 17:59:41
8bfeddb5d671017f4a21b8b46334ac816710b143...3aa5752894419b4638d5c934879258fa6a1c0d07,2,25,5,30,5,2014-12-03 19:19:25,2014-12-03 18:34:49
3aa5752894419b4638d5c934879258fa6a1c0d07...ed1243ffc7c2cb4bd5b4dece597597db8eb08e34,2,12,6,18,6,2014-12-03 19:53:20,2014-11-23 13:06:45
ed1243ffc7c2cb4bd5b4dece597597db8eb08e34...acb066e84a10483e1025eed295352b66747dbb8a,2,18,4,22,5,2014-12-03 20:06:33,2014-11-23 13:27:19
acb066e84a10483e1025eed295352b66747dbb8a...228281eecc703d1535e2e9871249a4ec8e2d9843,1,1,1,2,1,2014-12-03 20:11:27,2014-12-02 21:02:34
228281eecc703d1535e2e9871249a4ec8e2d9843...b9e5eaf66936f53a9bd9455f42d11050bed73aaa,1,6,4,10,3,2014-12-03 20:31:43,2014-11-26 15:30:08
b9e5eaf66936f53a9bd9455f42d11050bed73aaa...579aa5932473f5b8d5dbe3c26e7b527fb253233b,1,1,1,2,1,2014-12-03 20:45:47,2014-12-03 20:45:47
579aa5932473f5b8d5dbe3c26e7b527fb253233b...55d9db56a6f7d29b16f8393612648080c6d535d6,5,164,23,187,10,2014-12-03 21:46:55,2014-09-24 07:13:10
55d9db56a6f7d29b16f8393612648080c6d535d6...d21dff21ed8beb015ad911f11d57cceb56fc439f,2,30,5,35,9,2014-12-03 21:47:35,2014-10-28 08:25:45
d21dff21ed8beb015ad911f11d57cceb56fc439f...10ac5948097e2c8eaead238603d29ee580dc8273,2,29,1,30,8,2014-12-04 12:49:31,2014-11-11 17:10:29
10ac5948097e2c8eaead238603d29ee580dc8273...2dc34a969956eea680be4c8d9f800556d110996a,2,36,13,49,3,2014-12-04 12:49:31,2014-12-03 10:43:21
2dc34a969956eea680be4c8d9f800556d110996a...96e7897fef2a9219d1b56b400074702eaad9c145,1,0,17,17,1,2014-12-04 12:52:43,2014-12-04 12:52:43
96e7897fef2a9219d1b56b400074702eaad9c145...8c3a42cd684245b08054d9c987db80a399837954,2,15,9,24,7,2014-12-04 20:24:06,2014-11-29 10:32:56
8c3a42cd684245b08054d9c987db80a399837954...cb192293f42f0be4d17598bba39ac1f95982e39b,1,100,100,200,11,2014-12-04 21:15:09,2014-12-04 20:51:15
cb192293f42f0be4d17598bba39ac1f95982e39b...40a537c25f70ad556a41bb2d00ea3e257410e9af,2,24,26,50,19,2014-12-04 23:05:00,2014-12-04 18:38:52
40a537c25f70ad556a41bb2d00ea3e257410e9af...f2e7f875e2ad4b271c4e72ebd3860f905132eed9,3,50,24,74,19,2014-12-04 23:05:07,2014-12-04 19:22:32
f2e7f875e2ad4b271c4e72ebd3860f905132eed9...7ad66527ba0222fba141460dd57dd06719251bf6,2,227,142,369,35,2014-12-05 11:32:25,2014-12-05 11:32:07
7ad66527ba0222fba141460dd57dd06719251bf6...0c4f9fa574729f066cab2ee4e3feba69bfa00f0c,1,5,184,189,4,2014-12-05 12:20:34,2014-12-04 20:43:58
0c4f9fa574729f066cab2ee4e3feba69bfa00f0c...2d6a0a1dc1e7125cab2e30244e35e97e11802843,2,55,1,56,3,2014-12-05 13:36:41,2014-12-02 20:27:11
2d6a0a1dc1e7125cab2e30244e35e97e11802843...a1c5f2b4f043fcbc0a5af3012b074e4cb02fc21a,1,42,31,73,13,2014-12-05 14:28:21,2014-11-14 22:22:56
a1c5f2b4f043fcbc0a5af3012b074e4cb02fc21a...fbbf6ac161a2087a64d50878b02ed7f618b182cc,1,15,7,22,2,2014-12-05 19:18:56,2014-12-05 16:34:15
fbbf6ac161a2087a64d50878b02ed7f618b182cc...ee42cfea04e619945b51e8cdcd9c9d5c6176cb77,1,9,16,25,10,2014-12-05 22:13:24,2014-12-05 12:51:35
ee42cfea04e619945b51e8cdcd9c9d5c6176cb77...2db0aabee340f1e5554c0d321d263177600aff81,8,118,41,159,20,2014-12-06 03:13:23,2014-12-04 00:00:55
2db0aabee340f1e5554c0d321d263177600aff81...f380cd220c52b225ee4aea56cb5cbeb4748163ca,4,8,5,13,5,2014-12-06 03:13:24,2014-12-04 21:54:02
f380cd220c52b225ee4aea56cb5cbeb4748163ca...e2d1969d68d935a760fb7ddd5616b2c5ae86da4d,3,1,52,53,4,2014-12-06 03:13:24,2014-12-04 22:19:09
e2d1969d68d935a760fb7ddd5616b2c5ae86da4d...facfec98412c0bb8678d578bade05ffef06a9e84,2,56,2,58,4,2014-12-06 09:16:28,2014-09-11 12:02:30
facfec98412c0bb8678d578bade05ffef06a9e84...41f03e4b02487f145ff5af7bd5762b489ccf2d51,1,0,1,1,1,2014-12-08 08:04:13,2014-12-08 05:49:01
41f03e4b02487f145ff5af7bd5762b489ccf2d51...ee29819dbaa32cfae78ce81b08bcecbfba73298e,1,1,1,2,1,2014-12-08 15:50:03,2014-12-06 20:45:09
ee29819dbaa32cfae78ce81b08bcecbfba73298e...924d3c6bfef7b0f1aedae46ce8c88844233f96f5,1,1,1,2,1,2014-12-08 16:05:49,2014-12-07 08:39:27
924d3c6bfef7b0f1aedae46ce8c88844233f96f5...c5cba6e9c15aa2d6cd065b4fba7166cc58d37c84,2,63,1,64,3,2014-12-08 18:04:15,2014-10-10 21:48:55
c5cba6e9c15aa2d6cd065b4fba7166cc58d37c84...6ad109e7457031463e1241db64d7f3075629f936,1,24,24,48,4,2014-12-08 21:29:39,2014-12-08 21:11:44
6ad109e7457031463e1241db64d7f3075629f936...02c9dc6e16704edbf9bf5207d09765d69027d7e3,1,101,0,101,1,2014-12-09 00:10:34,2014-12-09 00:07:42
02c9dc6e16704edbf9bf5207d09765d69027d7e3...ca4df475e11c45a6c3c7adae6f4b0ecac7a9ba1a,1,0,5,5,1,2014-12-09 00:12:15,2014-12-09 00:12:15
ca4df475e11c45a6c3c7adae6f4b0ecac7a9ba1a...d8e37078600089839f82f0e84022f1087e1fd3f2,3,49,3,52,7,2014-12-09 11:34:27,2014-11-23 03:21:59
d8e37078600089839f82f0e84022f1087e1fd3f2...a8089166f512e5accb7bdeb55524e56fa617fc1d,1,6,4,10,3,2014-12-09 17:10:08,2014-12-09 14:20:14
a8089166f512e5accb7bdeb55524e56fa617fc1d...e50002baedfef6aa2e6dace9e55c4e24abb6c1c3,1,1,1,2,1,2014-12-09 17:12:22,2014-12-09 10:14:32
e50002baedfef6aa2e6dace9e55c4e24abb6c1c3...3b5ba8779730c21897c2f18f5daaec9bc5550951,1,3,2,5,3,2014-12-09 17:50:17,2014-12-07 19:06:43
3b5ba8779730c21897c2f18f5daaec9bc5550951...b3dfb3835923c9a941f63aa8f709760fd087962a,1,8,9,17,3,2014-12-09 18:24:52,2014-12-07 19:50:08
b3dfb3835923c9a941f63aa8f709760fd087962a...a097aa95b7c78beab6d1b7d521c25f7d9d7843d9,2,59,19,78,5,2014-12-09 18:34:27,2014-12-09 15:42:09
a097aa95b7c78beab6d1b7d521c25f7d9d7843d9...63db09753ef6c46cc63e7c523ff41d9f959dfcdd,2,15,1,16,2,2014-12-09 19:48:38,2014-12-08 23:34:47
63db09753ef6c46cc63e7c523ff41d9f959dfcdd...7fd2dc11ca502105587e4bccd3267aa6cd08a648,1,2,0,2,2,2014-12-09 21:20:06,2014-12-09 02:03:48
7fd2dc11ca502105587e4bccd3267aa6cd08a648...5d28d196232468bb785fde453f3960e3732266bf,1,1,1,2,1,2014-12-10 18:01:42,2014-12-10 08:09:19
5d28d196232468bb785fde453f3960e3732266bf...c437d0a4707c84c521996bf49d543943a1eeae0d,1,11,9,20,7,2014-12-10 18:04:00,2014-12-10 00:01:28
c437d0a4707c84c521996bf49d543943a1eeae0d...40258838031604feecb862afdc6f1f503d80ce4a,4,17,1,18,5,2014-12-10 18:06:07,2014-12-08 22:25:45
40258838031604feecb862afdc6f1f503d80ce4a...d162f152b881068163e144a66fd5b9b7c916911d,1,18,17,35,2,2014-12-10 19:57:28,2014-12-07 18:46:39
d162f152b881068163e144a66fd5b9b7c916911d...aac3c4aa63cb040614028d315ff9375c3ddaa19e,1,1,3,4,2,2014-12-10 21:01:02,2014-10-09 21:18:17
aac3c4aa63cb040614028d315ff9375c3ddaa19e...8a907eb3ff58c1c782dfdc04e7dc29a6b4349c00,1,3,0,3,1,2014-12-11 17:52:00,2014-12-11 17:52:00
8a907eb3ff58c1c782dfdc04e7dc29a6b4349c00...6617b42bc7ea613620c7b005316bd61cd0165324,1,1,1,2,1,2014-12-11 20:19:32,2014-12-11 09:02:55
6617b42bc7ea613620c7b005316bd61cd0165324...b9bdbe615cc4070d2233ff06830a4c6fb1217cda,2,53,8,61,7,2014-12-12 17:46:00,2014-12-07 12:53:08
b9bdbe615cc4070d2233ff06830a4c6fb1217cda...1b740974f5eb373bed04071d51f908ced7c5a8e5,2,23,9,32,10,2014-12-12 18:51:34,2014-12-12 18:04:47
1b740974f5eb373bed04071d51f908ced7c5a8e5...79b3b8b68643b2e2b692f6fad06f7576a7252be8,1,3,3,6,2,2014-12-13 11:52:42,2014-12-05 05:54:46
79b3b8b68643b2e2b692f6fad06f7576a7252be8...9ae0c01c2bcaff2f3906eec574f9c6ed8abde14a,2,19,9,28,5,2014-12-13 11:56:39,2014-10-26 23:00:08
9ae0c01c2bcaff2f3906eec574f9c6ed8abde14a...e0663312fb6c50f7255cb43459dfb5aa2d1e9da7,1,0,1,1,1,2014-12-13 17:06:50,2014-12-12 20:26:14
e0663312fb6c50f7255cb43459dfb5aa2d1e9da7...6bd4292c24a0020f28bf7d21d3d6db19dd54bcca,1,2,2,4,2,2014-12-14 01:17:54,2014-12-14 01:09:16
6bd4292c24a0020f28bf7d21d3d6db19dd54bcca...99d1a438b6669817be42b63f89b50a664490ad47,1,2,2,4,2,2014-12-14 02:27:18,2014-12-14 02:14:48
99d1a438b6669817be42b63f89b50a664490ad47...081fef60b2407c5459b1d266c18d6fe2a34f1044,1,1,1,2,1,2014-12-14 08:50:28,2014-12-14 05:12:03
081fef60b2407c5459b1d266c18d6fe2a34f1044...ef640cbc2af5794c987e75472c12e63a59590044,2,11,1,12,2,2014-12-14 09:22:38,2014-03-25 12:24:06
ef640cbc2af5794c987e75472c12e63a59590044...ab41e4849370a0541e8c9c312c2516c1b97a422d,2,32,2,34,2,2014-12-14 10:28:46,2014-12-13 19:29:56
ab41e4849370a0541e8c9c312c2516c1b97a422d...8e28bb4c2f6d015dfe1cec7755f1ca9b0ecef1f8,2,18,1,19,2,2014-12-14 11:41:04,2014-12-14 00:24:24
8e28bb4c2f6d015dfe1cec7755f1ca9b0ecef1f8...69f69db1e0ebf0f1cb3a5dc369e6b3320a5b80c7,2,1,18,19,2,2014-12-14 12:32:55,2014-12-14 12:22:56
69f69db1e0ebf0f1cb3a5dc369e6b3320a5b80c7...c90ad96808be350526516626205c3a7d1da79024,2,21,7,28,7,2014-12-15 12:03:05,2014-12-06 06:00:11
c90ad96808be350526516626205c3a7d1da79024...9b96cea462676d123e1b2dd852aedbe3da8fa4a0,2,11,3,14,5,2014-12-15 13:45:12,2014-12-09 21:43:13
9b96cea462676d123e1b2dd852aedbe3da8fa4a0...0524e92d2eae89b52460ade4a884f9b404da6558,1,39,0,39,1,2014-12-15 13:46:21,2014-12-09 01:29:54
0524e92d2eae89b52460ade4a884f9b404da6558...0d9aafba3b28ccbdc66fb92148453f5e2e46221e,1,1,1,2,1,2014-12-15 18:03:06,2014-12-15 17:57:09
0d9aafba3b28ccbdc66fb92148453f5e2e46221e...f6644c720e990ef7cfd907ad675c2773deb8c182,1,2,2,4,2,2014-12-15 18:05:05,2014-12-15 15:38:37
f6644c720e990ef7cfd907ad675c2773deb8c182...6cb5fbf5ef276c2999319d49a7b26dde82d3ca89,1,1,1,2,1,2014-12-15 18:07:58,2014-12-15 09:23:31
6cb5fbf5ef276c2999319d49a7b26dde82d3ca89...fd1528a6c8920d032af65304e7659171c29106a0,1,30,2,32,3,2014-12-15 18:48:06,2014-12-11 12:48:35
fd1528a6c8920d032af65304e7659171c29106a0...32eec670230f1339675a6181ebbb81f66ee68900,1,56,0,56,1,2014-12-15 19:21:28,2014-12-15 19:21:28
32eec670230f1339675a6181ebbb81f66ee68900...8b56c08327054f978ee2c42106cb60e41bd8c13b,1,1,1,2,1,2014-12-15 20:24:53,2014-12-15 09:13:43
8b56c08327054f978ee2c42106cb60e41bd8c13b...337ce67612c4b59fbfc0195f4d6ef15cbb5ebfd8,1,1,1,2,1,2014-12-15 20:27:29,2014-12-14 18:23:11
337ce67612c4b59fbfc0195f4d6ef15cbb5ebfd8...f297aa5d0ad0dcf758760e02f13c409c55e48e78,1,22,0,22,1,2014-12-15 22:14:51,2014-12-15 22:14:51
f297aa5d0ad0dcf758760e02f13c409c55e48e78...924e68c7d522a1086969f3583d0ce87e59110bc5,2,36,12,48,4,2014-12-16 01:47:53,2014-12-12 21:20:52
924e68c7d522a1086969f3583d0ce87e59110bc5...85758ce3afc2b3acc4b56593a2136f5673a5c39f,1,0,7,7,1,2014-12-16 07:56:13,2014-12-16 07:55:57
85758ce3afc2b3acc4b56593a2136f5673a5c39f...d604f941e8a703bfa8c0ec498bcc9baad194a317,1,1,1,2,1,2014-12-16 11:44:07,2014-12-15 23:51:59
d604f941e8a703bfa8c0ec498bcc9baad194a317...d161cc6b255c33f44829e3df15022119df2d74cd,1,47,23,70,7,2014-12-16 14:18:51,2014-12-11 01:54:05
d161cc6b255c33f44829e3df15022119df2d74cd...24eb528b0584edcf12fccbe169767395217b6d7b,1,13,5,18,4,2014-12-16 14:21:01,2014-12-14 18:00:45
24eb528b0584edcf12fccbe169767395217b6d7b...25152bb218d3e9c7cb883dd138c11c56b1cf2ccb,1,3,3,6,2,2014-12-16 14:21:27,2014-12-15 00:06:10
25152bb218d3e9c7cb883dd138c11c56b1cf2ccb...a5f037d033316ea7fa3d451a04b48d9d3136006f,1,1,1,2,1,2014-12-16 14:25:18,2014-12-15 05:11:39
a5f037d033316ea7fa3d451a04b48d9d3136006f...e3bf1ed21745dad75866623a7b7a8828237b0527,1,2,0,2,1,2014-12-16 14:26:29,2014-12-15 05:37:06
e3bf1ed21745dad75866623a7b7a8828237b0527...4a18274670cd832933079fa281c0a694561c3bb1,1,4,4,8,4,2014-12-16 14:28:45,2014-12-15 08:19:08
4a18274670cd832933079fa281c0a694561c3bb1...b62c8584999b2c30681f765dca4584067ad52f3f,1,1,1,2,1,2014-12-16 14:29:53,2014-12-15 22:04:13
b62c8584999b2c30681f765dca4584067ad52f3f...e091bb7dbbeb4aa01360e900bf854e6369b38ab0,1,1,1,2,1,2014-12-16 14:31:24,2014-12-15 22:33:18
e091bb7dbbeb4aa01360e900bf854e6369b38ab0...0b4e150aa5d1e1e138565dceb488b33b7f877db3,1,1,1,2,1,2014-12-16 18:02:02,2014-12-16 06:10:17
0b4e150aa5d1e1e138565dceb488b33b7f877db3...bdbe4fd34aecdfdbace0541be58d05ea4cffba6b,1,1,1,2,1,2014-12-16 18:04:05,2014-12-16 06:20:03
bdbe4fd34aecdfdbace0541be58d05ea4cffba6b...fb2c58589758744c0eef8c2ead3dbcf27a5cf200,2,31,0,31,3,2014-12-16 21:40:34,2014-12-12 16:02:41
fb2c58589758744c0eef8c2ead3dbcf27a5cf200...83f88c1818623a1ba166eb09aa8cac5d604d08fe,1,1,3,4,1,2014-12-16 21:42:13,2014-12-15 23:36:25
83f88c1818623a1ba166eb09aa8cac5d604d08fe...cd77c089ba2f4b94ccc74f32f0ffa9fb70851c02,1,5,7,12,3,2014-12-16 21:43:46,2014-12-15 23:39:21
cd77c089ba2f4b94ccc74f32f0ffa9fb70851c02...bd28c74c1d91c477a86f10fe36576cba0249e6ef,2,44,21,65,11,2014-12-17 09:17:07,2014-12-11 00:44:36
bd28c74c1d91c477a86f10fe36576cba0249e6ef...9e6161e579943b2d0431fde6440492b59b54de73,1,14,14,28,14,2014-12-17 11:15:20,2014-12-17 09:55:15
9e6161e579943b2d0431fde6440492b59b54de73...7d70dcdab164cbbb72861ba0be4fdff17ce4b0b1,1,2,1,3,1,2014-12-17 20:14:22,2014-12-17 10:07:08
7d70dcdab164cbbb72861ba0be4fdff17ce4b0b1...56a7abd38f7e5f96598d3c310cee183b2c92ec5b,1,2,2,4,1,2014-12-18 17:43:30,2014-12-18 05:55:31
56a7abd38f7e5f96598d3c310cee183b2c92ec5b...661f6d9ecf1459ce3b2794c3cde373e17ae83972,2,14,4,18,3,2014-12-18 18:41:25,2014-12-18 18:16:24
661f6d9ecf1459ce3b2794c3cde373e17ae83972...ae637acdfb09a93945d1a6de86658631777125b7,1,1,1,2,1,2014-12-18 18:49:01,2014-12-18 18:42:25
ae637acdfb09a93945d1a6de86658631777125b7...6e80d0ad54e2f2d966c73111767af6332c63d00a,1,7,7,14,5,2014-12-18 23:01:51,2014-12-18 23:01:51
6e80d0ad54e2f2d966c73111767af6332c63d00a...3d78bf3fa8f7a6c7a3c9ab0e1c3ab7046bd83975,1,1,0,1,1,2014-12-19 04:58:21,2014-12-18 11:20:05
3d78bf3fa8f7a6c7a3c9ab0e1c3ab7046bd83975...47a55ca767688fb6e1c5383c1bb0287f3b92f8e9,1,28,0,28,1,2014-12-19 21:22:00,2014-12-19 21:21:32
47a55ca767688fb6e1c5383c1bb0287f3b92f8e9...eae848a712533483a223d49decd12be7ef4243bd,1,1,1,2,1,2014-12-20 13:21:54,2014-12-19 23:45:03
eae848a712533483a223d49decd12be7ef4243bd...2caec4463290d1c331c8a3f3bcaa20fc9873e5c2,1,4,27,31,3,2014-12-21 10:03:43,2014-12-20 16:04:28
2caec4463290d1c331c8a3f3bcaa20fc9873e5c2...a3c3bf3332e5685dc319c46faef882cb6ac246e1,2,29,22,51,6,2014-12-21 10:03:43,2014-12-21 10:03:26
a3c3bf3332e5685dc319c46faef882cb6ac246e1...c95e38c6038f9699ff52b46e638026b35aeb09fd,1,1,1,2,1,2014-12-22 00:12:45,2014-12-17 16:33:14
c95e38c6038f9699ff52b46e638026b35aeb09fd...5bb2636aacae04f7dc8841f5969012ebbe2343af,1,1,0,1,1,2014-12-22 00:30:02,2014-12-19 12:40:27
5bb2636aacae04f7dc8841f5969012ebbe2343af...8928d0234551a272992d0eccef73b3ad6cb8bfd1,1,2,2,4,2,2014-12-22 00:35:38,2014-12-20 01:11:25
8928d0234551a272992d0eccef73b3ad6cb8bfd1...e4f23c4d25af8ac881c96d55842c8ac2ffd93088,1,2,2,4,2,2014-12-22 01:07:46,2014-12-21 10:46:25
e4f23c4d25af8ac881c96d55842c8ac2ffd93088...25623b709f7bac2c400a1f52e6a78646144d3fab,1,1,1,2,1,2014-12-22 13:24:27,2014-12-22 07:03:21
25623b709f7bac2c400a1f52e6a78646144d3fab...7f5051bb2a9970876c9c32504110abf7372c7e8b,1,1,1,2,1,2014-12-22 13:33:10,2014-12-22 13:33:10
7f5051bb2a9970876c9c32504110abf7372c7e8b...521c12c265f30afcdf4a2a22dbf8d8c37d9d3752,2,7,7,14,6,2014-12-22 15:43:55,2014-12-22 12:12:18
521c12c265f30afcdf4a2a22dbf8d8c37d9d3752...b43fa3bb30e6bff507534468976cc6f163f6fe64,1,21,14,35,3,2014-12-23 16:28:08,2014-12-23 15:10:39
b43fa3bb30e6bff507534468976cc6f163f6fe64...deb3cb4daef0054457bd9fb8995829fff0e8f1e4,2,22,9,31,9,2014-12-23 18:16:51,2014-12-23 16:16:39
deb3cb4daef0054457bd9fb8995829fff0e8f1e4...3e42b22b0e9df95994624d45502e612398d2fc1d,8,3222,3190,6412,16,2014-12-24 13:07:07,2014-12-24 12:53:54
3e42b22b0e9df95994624d45502e612398d2fc1d...0f9fd2f642ee251e61f8fb80132500c94db5e47a,6,2520,2224,4744,736,2014-12-24 23:19:39,2014-12-24 23:17:05
0f9fd2f642ee251e61f8fb80132500c94db5e47a...0e2ac3cd705c02312e3a91786fc338fa0ab585dc,1,1,1,2,2,2014-12-28 15:59:57,2014-12-28 15:39:51
0e2ac3cd705c02312e3a91786fc338fa0ab585dc...4836dacae68106523ebc2295f515002780d4e0c3,1,1,1,2,1,2014-12-28 17:42:01,2014-12-24 21:55:10
4836dacae68106523ebc2295f515002780d4e0c3...1eb6036d29687f7b675ff5b28f6cbf105fcb611b,1,1,1,2,1,2014-12-28 17:48:40,2014-12-26 16:34:20
1eb6036d29687f7b675ff5b28f6cbf105fcb611b...2e721a7914b48a6287cbe78724dc26a7ae0bd06a,1,2,2,4,2,2014-12-28 17:50:13,2014-12-27 03:22:21
2e721a7914b48a6287cbe78724dc26a7ae0bd06a...e9bf93d510a6a0c105d8f5d036ec35c7ce08a588,11,28,28,56,19,2014-12-28 19:56:05,2014-12-28 19:33:31
e9bf93d510a6a0c105d8f5d036ec35c7ce08a588...d224fe817242c02ce24aec147dae4b75781737fa,1,1,1,2,1,2014-12-28 19:57:43,2014-12-28 19:57:43
d224fe817242c02ce24aec147dae4b75781737fa...3616b9b07ced8cccb755f0d156cf39f58d334b53,1,3,3,6,3,2014-12-29 20:15:53,2014-12-26 08:18:06
3616b9b07ced8cccb755f0d156cf39f58d334b53...6018f5da3fa3fcbf731bb28acdc9c2e342b869f2,1,6,6,12,5,2014-12-29 20:19:04,2014-12-29 10:47:49
6018f5da3fa3fcbf731bb28acdc9c2e342b869f2...1c76bf7e94f4b5ee9d623eee608f83d9891c117d,1,5,0,5,1,2014-12-30 17:53:50,2014-12-30 16:14:35
1c76bf7e94f4b5ee9d623eee608f83d9891c117d...1e5e527c84e2e5e9ed83ceb8e8c9c340c150b960,1,1,1,2,1,2014-12-30 18:01:20,2014-12-30 06:42:24
1e5e527c84e2e5e9ed83ceb8e8c9c340c150b960...2ff7edfdd1746739cb4af0100f94a17fbf03917b,1,1,1,2,1,2014-12-30 20:47:59,2014-12-29 12:58:56
2ff7edfdd1746739cb4af0100f94a17fbf03917b...349742b3f0ffb4ff771bcd8a8b0ae2abfe00c1e9,1,21,25,46,20,2014-12-31 13:50:30,2014-12-31 13:36:54
349742b3f0ffb4ff771bcd8a8b0ae2abfe00c1e9...66ceecc2956ae4550cb3c2493be760184bc18777,1,2,2,4,1,2014-12-31 14:09:16,2014-12-30 04:38:50
66ceecc2956ae4550cb3c2493be760184bc18777...c66b4b6a133f7215d50c23db516986cfc1f0a985,2,63,2,65,4,2015-01-02 11:53:02,2014-12-01 12:54:02
c66b4b6a133f7215d50c23db516986cfc1f0a985...a01ce6b81c197b0a4a1057981e8e9c1b74f37587,2,34,1,35,2,2015-01-02 18:14:23,2015-01-02 16:26:58
a01ce6b81c197b0a4a1057981e8e9c1b74f37587...e24d96827628285976526c7e8d91090a90e36322,1,1,1,2,2,2015-01-05 20:10:22,2015-01-04 06:08:05
e24d96827628285976526c7e8d91090a90e36322...d2a9a163fbf6c9e1274392167ba739364645eb00,1,1,1,2,1,2015-01-06 18:40:59,2014-01-14 14:35:41
d2a9a163fbf6c9e1274392167ba739364645eb00...1334b8c8326b93e0ca016c85516627900c7a9fd3,2,6,1,7,2,2015-01-06 22:18:32,2015-01-05 18:04:47
1334b8c8326b93e0ca016c85516627900c7a9fd3...647d93338ffa97454079483d89525afa5860ee38,3,116,0,116,3,2015-01-07 13:35:25,2015-01-07 13:15:50
647d93338ffa97454079483d89525afa5860ee38...1b704071c8ca142b6aaf841d4f605d49934c98bc,1,1,1,2,1,2015-01-07 18:53:11,2015-01-07 11:51:54
1b704071c8ca142b6aaf841d4f605d49934c98bc...ab4b632dbf37024783428c10b0b847d15bc1d75f,1,1,1,2,1,2015-01-07 18:56:00,2015-01-06 12:13:32
ab4b632dbf37024783428c10b0b847d15bc1d75f...e1132f53b03a5a71aa9b6eded24d64e3bc83929b,2,11,1,12,2,2015-01-07 19:36:46,2015-01-06 10:47:51
e1132f53b03a5a71aa9b6eded24d64e3bc83929b...e079111b33bf36be21c0941718b41cc9ca67bea0,2,34,6,40,5,2015-01-08 01:45:41,2015-01-07 05:23:23
e079111b33bf36be21c0941718b41cc9ca67bea0...51d6774286202b55ade402ca097e417e70fd546b,2,15,7,22,8,2015-01-08 11:14:48,2014-12-11 18:06:38
51d6774286202b55ade402ca097e417e70fd546b...9c9c6b3fe4edfe78ae275c413ee3eefb81f1ebf6,2,29,1,30,2,2015-01-08 11:36:54,2015-01-07 21:48:50
9c9c6b3fe4edfe78ae275c413ee3eefb81f1ebf6...ef1a9d2cda4a5e60248bf609938429e0dadff1ff,1,1,1,2,1,2015-01-08 19:02:28,2015-01-08 19:02:28
ef1a9d2cda4a5e60248bf609938429e0dadff1ff...f3b088a4e441d68e86e1247e0e4cead2f1304211,1,1,1,2,1,2015-01-08 20:12:00,2015-01-08 19:37:34
f3b088a4e441d68e86e1247e0e4cead2f1304211...f06f28e018a2f799596e7cd982fc916e211bb551,1,1,1,2,1,2015-01-09 13:24:05,2015-01-09 13:22:30
f06f28e018a2f799596e7cd982fc916e211bb551...40cb57c8f6205eb4062b150f829b066d72f9f59c,1,4,0,4,1,2015-01-09 18:23:31,2015-01-09 18:23:31
40cb57c8f6205eb4062b150f829b066d72f9f59c...3353afbb5965885e103b374f481d7d4a197c2122,2,3,0,3,3,2015-01-09 22:10:29,2015-01-09 20:53:04
3353afbb5965885e103b374f481d7d4a197c2122...b146cae02c6345d324b1c53845fb01b783226669,2,25,13,38,9,2015-01-10 16:25:58,2014-12-30 01:40:59
b146cae02c6345d324b1c53845fb01b783226669...5765061652eee9726c4e44d783b13af96b3880b4,1,1,1,2,1,2015-01-10 16:59:59,2015-01-08 18:30:22
5765061652eee9726c4e44d783b13af96b3880b4...b5e00cf615b3a1a33b3e57ea3a6bfab23d773306,1,5,5,10,5,2015-01-11 06:22:06,2015-01-11 04:37:55
b5e00cf615b3a1a33b3e57ea3a6bfab23d773306...371c1e19d8a73c4e5569669966da0ff69b32328d,6,6,6,12,6,2015-01-11 09:54:42,2015-01-11 08:59:25
371c1e19d8a73c4e5569669966da0ff69b32328d...e24f22bdb1740388938d58778aa24d307a79a796,2,4,3,7,3,2015-01-11 09:56:19,2015-01-03 19:33:47
e24f22bdb1740388938d58778aa24d307a79a796...034fade3e8b6448231b640948995960db75d8605,1,1,1,2,1,2015-01-11 19:27:12,2015-01-11 14:23:27
034fade3e8b6448231b640948995960db75d8605...5a60302389162c6ef45f311c1aaa65a00d538c66,2,39,5,44,10,2015-01-12 11:38:34,2014-10-21 13:02:07
5a60302389162c6ef45f311c1aaa65a00d538c66...aa798f123658cb78b5581513d26577016195cafe,2,35,1,36,2,2015-01-12 16:13:54,2014-12-11 11:47:46
aa798f123658cb78b5581513d26577016195cafe...eb6cb785df63bdd06c0bccee39ea437baa8f628e,2,21,21,42,12,2015-01-12 19:46:46,2015-01-08 22:48:26
eb6cb785df63bdd06c0bccee39ea437baa8f628e...7fda214c4f65a6a06b25cf5d5aff013a364e9cef,2,2217,1950,4167,502,2015-01-12 19:48:41,2015-01-04 19:52:38
7fda214c4f65a6a06b25cf5d5aff013a364e9cef...408f89d8e6b8092d4abdc0cf617487f5cbb06797,5,2325,2332,4657,6,2015-01-12 19:48:41,2015-01-10 21:28:32
408f89d8e6b8092d4abdc0cf617487f5cbb06797...9f5ac048d75b115148822425af694bd189aa96f6,1,30,0,30,1,2015-01-12 19:48:41,2015-01-10 22:00:02
9f5ac048d75b115148822425af694bd189aa96f6...02977c5bab87bceab5a0f8c51525bc21c102f3c8,1,21,0,21,1,2015-01-12 19:48:41,2015-01-10 22:13:22
02977c5bab87bceab5a0f8c51525bc21c102f3c8...cf9331ac662d5f4d4a4b8470277b42f3e51595b0,1,1,0,1,1,2015-01-12 19:48:41,2015-01-11 14:51:50
cf9331ac662d5f4d4a4b8470277b42f3e51595b0...933591d69cee2c5580da1d8522ba90a7d924da0e,2,91,2,93,7,2015-01-12 19:48:41,2015-01-11 15:59:56
933591d69cee2c5580da1d8522ba90a7d924da0e...b4bdec35cb40fb4878b0e7393c39f23e5308e971,1,43,40,83,15,2015-01-12 19:48:41,2015-01-11 15:59:56
b4bdec35cb40fb4878b0e7393c39f23e5308e971...fc21db8a15545fad53124fc941b3c911a8d57067,2,28,5,33,5,2015-01-12 19:48:41,2015-01-11 22:16:06
fc21db8a15545fad53124fc941b3c911a8d57067...ba90261b7586b519483883800ea876510faf5c21,2,39,4,43,4,2015-01-12 19:48:42,2015-01-12 10:39:13
ba90261b7586b519483883800ea876510faf5c21...babc20b43d38f33af0ea2a04d4af7f2df816b979,2,18,0,18,2,2015-01-13 00:08:45,2015-01-12 21:00:34
babc20b43d38f33af0ea2a04d4af7f2df816b979...f2e1a930aa5d98f1efe11e0641261762b47a4721,1,150,0,150,1,2015-01-13 00:58:55,2015-01-13 00:58:55
f2e1a930aa5d98f1efe11e0641261762b47a4721...593b18c66a43414b3caaa53f8a1e438e79d00e95,2,0,18,18,2,2015-01-13 19:25:59,2015-01-13 19:25:59
593b18c66a43414b3caaa53f8a1e438e79d00e95...4af7cdaf4d046ddd0f0bdef55e43f91548364db9,1,1,1,2,1,2015-01-14 14:41:49,2015-01-14 14:36:44
4af7cdaf4d046ddd0f0bdef55e43f91548364db9...54cae0f1d022d9ca51c9871ade49385619787431,1,1,1,2,1,2015-01-14 18:18:46,2015-01-14 18:18:29
54cae0f1d022d9ca51c9871ade49385619787431...299b3e7e016498813ca7b71a218ad0f29e790394,2,3,2,5,2,2015-01-14 20:36:17,2015-01-14 20:36:17
299b3e7e016498813ca7b71a218ad0f29e790394...1a7e9de8d8efcb1b2453b5553fa4aad36521750f,1,7,3,10,4,2015-01-14 20:44:32,2015-01-14 20:44:32
1a7e9de8d8efcb1b2453b5553fa4aad36521750f...3a1779909834cc0bde72098ec18eb6c24887aec3,1,3,3,6,3,2015-01-15 12:53:04,2014-12-22 23:31:11
3a1779909834cc0bde72098ec18eb6c24887aec3...5a9dde1c271858030fcfc2a1820b339562ed2035,1,14,4,18,6,2015-01-15 13:03:12,2014-12-24 02:33:03
5a9dde1c271858030fcfc2a1820b339562ed2035...9580bc2c2ea40a0f1cc637def8317d8beb57d5c6,1,6,6,12,6,2015-01-15 13:12:36,2014-12-27 19:30:43
9580bc2c2ea40a0f1cc637def8317d8beb57d5c6...08035545ed1908401a6ed9e0ed803ca50e6c2b05,1,3,0,3,1,2015-01-15 13:14:56,2015-01-01 10:14:26
08035545ed1908401a6ed9e0ed803ca50e6c2b05...3422cbac8086ec17bb952f15b945f410449ff94f,1,1,1,2,1,2015-01-15 13:43:25,2015-01-09 14:12:10
3422cbac8086ec17bb952f15b945f410449ff94f...40abdaf407457abb8cc42d0641c001e93a6be7b4,1,1,1,2,1,2015-01-15 13:51:58,2015-01-11 10:06:33
40abdaf407457abb8cc42d0641c001e93a6be7b4...3831de8a05727d5db9e444208738e709bb9a9af7,1,3,3,6,3,2015-01-15 13:54:25,2015-01-14 05:46:42
3831de8a05727d5db9e444208738e709bb9a9af7...0504395c147c9080b07fd4bffbe1d594163de2e0,1,3,3,6,2,2015-01-15 13:57:07,2015-01-12 11:11:43
0504395c147c9080b07fd4bffbe1d594163de2e0...23c8a90d22f7c7b41b5a756b89498ffac828980a,2,15,0,15,2,2015-01-15 18:58:57,2014-01-15 18:58:00
23c8a90d22f7c7b41b5a756b89498ffac828980a...2b64f6e3184d4e3f51e63739779b18a83dcaaf8a,1,1,1,2,1,2015-01-15 20:46:13,2015-01-15 20:39:42
2b64f6e3184d4e3f51e63739779b18a83dcaaf8a...3ae79c0105cbf58530dfb2d48865f25dcf2d3a2b,1,1,1,2,1,2015-01-16 20:09:17,2015-01-15 20:03:42
3ae79c0105cbf58530dfb2d48865f25dcf2d3a2b...b7117afa2f1aa03ab0e67f8eba09dd70a7511e3d,1,1,1,2,1,2015-01-16 20:11:57,2015-01-15 20:31:52
b7117afa2f1aa03ab0e67f8eba09dd70a7511e3d...1bf1a6203c275c4c92de47cba13aa7f071ac66b5,1,38,0,38,1,2015-01-16 20:25:39,2015-01-16 20:23:40
1bf1a6203c275c4c92de47cba13aa7f071ac66b5...2408f2ded5ead6e678c241e38ef474c1fadff92b,2,23,3,26,12,2015-01-16 20:43:53,2015-01-11 17:51:45
2408f2ded5ead6e678c241e38ef474c1fadff92b...ca5fcc6f7a842360bbe6286f900fb2e17f280eef,2,20,19,39,17,2015-01-16 20:43:53,2015-01-11 17:53:15
ca5fcc6f7a842360bbe6286f900fb2e17f280eef...833ea05abfb6375558f62b140dfd0fab2610512d,1,35,0,35,1,2015-01-16 20:43:53,2015-01-11 17:55:18
833ea05abfb6375558f62b140dfd0fab2610512d...1476810a2c2219a70f9ea55d58d74d2b4eb2996f,1,1,1,2,1,2015-01-17 17:10:02,2015-01-17 16:05:27
1476810a2c2219a70f9ea55d58d74d2b4eb2996f...8a433f3cc583220da32d5fd3032bfbb52ebde84d,1,1,1,2,1,2015-01-18 18:09:10,2015-01-18 15:37:29
8a433f3cc583220da32d5fd3032bfbb52ebde84d...37dd4194785ba1d2791151aee8722668ad458dae,1,1,0,1,1,2015-01-18 18:11:17,2015-01-18 10:47:31
37dd4194785ba1d2791151aee8722668ad458dae...b8e8c5587f0c28bf4efc12b9e3920ee70e4e354f,1,3,3,6,1,2015-01-18 18:25:34,2015-01-18 18:25:34
b8e8c5587f0c28bf4efc12b9e3920ee70e4e354f...2b8baf7e109ab0bbd35da82170f460644f0297d3,1,4,4,8,4,2015-01-18 18:53:24,2015-01-16 15:31:37
2b8baf7e109ab0bbd35da82170f460644f0297d3...bd9bc3f828d3003b92226cc61fe5530c9aceeb92,1,16,9,25,8,2015-01-19 08:19:20,2015-01-19 08:19:20
bd9bc3f828d3003b92226cc61fe5530c9aceeb92...e5ad6d6ecd22852c67720af946b86de52f5a0a10,1,6,6,12,5,2015-01-19 08:22:51,2015-01-19 08:19:40
e5ad6d6ecd22852c67720af946b86de52f5a0a10...c260e7386391877625eda086480de73e8a0ba921,2,47,23,70,13,2015-01-19 09:39:08,2014-12-20 16:09:47
c260e7386391877625eda086480de73e8a0ba921...0db5b21b1d09431535e0c0bf8ac63d4b5b24d349,2,20,1,21,2,2015-01-19 14:37:58,2015-01-16 01:51:47
0db5b21b1d09431535e0c0bf8ac63d4b5b24d349...d17fbc3862e0a2e646db1222f184dbe663da4a1f,4,23,2,25,5,2015-01-19 19:11:34,2015-01-17 18:32:47
d17fbc3862e0a2e646db1222f184dbe663da4a1f...c2031b1e9e52ecaa89da5d489941488e62643ff5,3,5,1,6,3,2015-01-20 15:39:55,2015-01-16 12:52:48
c2031b1e9e52ecaa89da5d489941488e62643ff5...d435464c51d3912f56cfc830d86bfc64a1578327,2,32,4,36,5,2015-01-20 18:42:59,2015-01-02 17:27:21
d435464c51d3912f56cfc830d86bfc64a1578327...7e3557e96b2a4ba646016f46e96d560b64a017cf,1,77,0,77,1,2015-01-20 19:43:54,2015-01-20 19:43:54
7e3557e96b2a4ba646016f46e96d560b64a017cf...331cac233f56dc7f63ab8ac48de0d40fc7256047,1,1,1,2,1,2015-01-20 20:34:43,2015-01-18 00:47:14
331cac233f56dc7f63ab8ac48de0d40fc7256047...f2e2b31ece4316930f3ef8610d3b48fe66734bb7,1,1,1,2,1,2015-01-21 19:18:42,2015-01-20 23:06:13
f2e2b31ece4316930f3ef8610d3b48fe66734bb7...301e7aae24a955ddb54244ff45ab31bf2c1ff649,5,3,27,30,8,2015-01-21 20:21:44,2015-01-14 23:08:06
301e7aae24a955ddb54244ff45ab31bf2c1ff649...31a5b8353ae5f1a5cb283322829880995e877833,4,21,5,26,4,2015-01-23 14:37:17,2015-01-12 17:34:24
31a5b8353ae5f1a5cb283322829880995e877833...b3a9bd3ae043e3042ea7ccfe08e3b36a84feb35e,2,3,1,4,3,2015-01-23 17:43:26,2015-01-05 18:46:58
b3a9bd3ae043e3042ea7ccfe08e3b36a84feb35e...cea8e75144e6910b806b63a6ec2a6d118316fddd,4,46,3,49,5,2015-01-23 19:21:58,2014-12-06 17:29:31
cea8e75144e6910b806b63a6ec2a6d118316fddd...b146af11271de8fa4c51c6db87df104269f41a33,2,59,0,59,4,2015-01-23 20:39:59,2015-01-23 20:08:03
b146af11271de8fa4c51c6db87df104269f41a33...d557875a8d91d5b5dd78efb3556a95b87c92f210,1,1,1,2,1,2015-01-23 21:32:35,2015-01-15 01:01:12
d557875a8d91d5b5dd78efb3556a95b87c92f210...dca5fa7b81f7c928c4c1ac46d750f6b05e4f1ccb,2,12,8,20,7,2015-01-23 21:47:19,2015-01-18 03:44:04
dca5fa7b81f7c928c4c1ac46d750f6b05e4f1ccb...301663e7343178e45a43470dcda4e2fffd196b53,1,1,1,2,1,2015-01-23 21:47:19,2015-01-23 21:43:57
301663e7343178e45a43470dcda4e2fffd196b53...d0ceeaa37ea65a1ba22083542471cb5687add09f,1,12,12,24,8,2015-01-24 10:57:37,2015-01-19 13:03:35
d0ceeaa37ea65a1ba22083542471cb5687add09f...6d173aeb5d3ff1289a076e1702550e2b525fbe76,1,46,46,92,23,2015-01-24 11:46:28,2015-01-24 08:10:58
6d173aeb5d3ff1289a076e1702550e2b525fbe76...3228d3b4991af681e57de5ab079c1e1c11cf35cb,2,96,42,138,15,2015-01-24 13:01:33,2015-01-22 23:12:28
3228d3b4991af681e57de5ab079c1e1c11cf35cb...36a14e65d10e42a6d5c3cbc097d0ca3774efb1ac,1,4,4,8,2,2015-01-24 18:20:16,2015-01-24 15:58:57
36a14e65d10e42a6d5c3cbc097d0ca3774efb1ac...e13224b2dff2cbaeee5cc5845d81b37d4a4839c1,1,12,10,22,5,2015-01-24 22:40:54,2015-01-24 01:00:59
e13224b2dff2cbaeee5cc5845d81b37d4a4839c1...d40749caabfbdaf867973bb6e8de75f64902f13a,1,74,54,128,49,2015-01-24 22:41:29,2015-01-24 22:41:29
d40749caabfbdaf867973bb6e8de75f64902f13a...8b33de6fd0ec0eb785fed697f062763b5c1d8d23,2,14,1,15,2,2015-01-25 00:34:35,2014-11-04 16:15:39
8b33de6fd0ec0eb785fed697f062763b5c1d8d23...2f32614378bb343607fa25b1d9b8aa4f9ca2106c,1,5,5,10,5,2015-01-25 00:35:22,2015-01-25 00:32:06
2f32614378bb343607fa25b1d9b8aa4f9ca2106c...9f7c5ceba74a5e22a706b38dc7f538b6199cb89b,1,2,2,4,2,2015-01-25 02:33:09,2014-11-22 22:04:08
9f7c5ceba74a5e22a706b38dc7f538b6199cb89b...2958cd308b5ebaf223a3e5df3fb5bf0f23408447,1,0,3,3,1,2015-01-26 04:39:54,2015-01-26 04:38:24
2958cd308b5ebaf223a3e5df3fb5bf0f23408447...f7114d0c1c16ac10c6a9df9c1d369ead828bebbb,1,6,6,12,6,2015-01-26 10:04:44,2015-01-26 04:55:00
f7114d0c1c16ac10c6a9df9c1d369ead828bebbb...440c122556a84576abc996e665b79decce796062,1,61,0,61,1,2015-01-26 21:11:54,2015-01-26 21:08:32
440c122556a84576abc996e665b79decce796062...76df11657410a8246466ade36361fdf2b81d8570,4,5,21,26,4,2015-01-26 22:50:48,2015-01-26 22:50:48
76df11657410a8246466ade36361fdf2b81d8570...6cf6a1b97586fe5205ecb8ae42a57d2f7099a4f5,1,0,6,6,2,2015-01-26 23:57:50,2015-01-26 23:57:50
6cf6a1b97586fe5205ecb8ae42a57d2f7099a4f5...c88b119ef50fdb56c7a79703717efde8b48d6ae3,3,15,23,38,5,2015-01-27 10:27:46,2015-01-27 10:27:42
c88b119ef50fdb56c7a79703717efde8b48d6ae3...1735d5e8d55466b1e010baba0e90742e0be5148c,4,30,30,60,10,2015-01-27 10:30:55,2015-01-27 10:27:42
1735d5e8d55466b1e010baba0e90742e0be5148c...560951e9881b5f772262804384b4da9f673b925e,1,22,22,44,3,2015-01-27 14:42:11,2014-10-25 21:54:07
560951e9881b5f772262804384b4da9f673b925e...7602cd5e7e53c4a85428176357492194de00400b,1,1,1,2,1,2015-01-27 20:25:21,2015-01-27 16:07:42
7602cd5e7e53c4a85428176357492194de00400b...2ece1c927b63315aebb0159e03d832bb82636b8d,1,45,2,47,2,2015-01-27 20:58:57,2015-01-26 14:54:00
2ece1c927b63315aebb0159e03d832bb82636b8d...0baa17a3b7ad2b242df2b277b81cebdf75b04287,4,54,3,57,8,2015-01-28 13:47:46,2014-11-30 14:40:53
0baa17a3b7ad2b242df2b277b81cebdf75b04287...d729fcf030be1d3ef37196d36ea3bf3249ee3318,3,2,28,30,4,2015-01-28 14:30:51,2015-01-27 13:50:00
d729fcf030be1d3ef37196d36ea3bf3249ee3318...8c46919199090a05634789774124b38983430c76,2,6,3,9,5,2015-01-28 23:18:22,2015-01-24 21:17:18
8c46919199090a05634789774124b38983430c76...c69caa7beee4e920f8f587eb3e943be99864a14f,4,152,11,163,10,2015-01-29 10:15:45,2015-01-28 15:12:14
c69caa7beee4e920f8f587eb3e943be99864a14f...27bf2ce40c5adfb1494d69c9d0ac9cf433834a12,2,26,7,33,3,2015-01-29 10:25:57,2015-01-08 21:40:19
27bf2ce40c5adfb1494d69c9d0ac9cf433834a12...400fbbf1d6828ba145a517ff6b782aaaebad175c,1,1,1,2,1,2015-01-29 14:38:16,2015-01-28 18:29:56
400fbbf1d6828ba145a517ff6b782aaaebad175c...e61eae1b1f2351c51bcfe4142749a4e68a2806ff,1,5,0,5,1,2015-01-29 14:44:42,2015-01-28 14:59:41
e61eae1b1f2351c51bcfe4142749a4e68a2806ff...aa0f64496a66d2a5d1a4d033f2eb075a8b084a78,3,199,0,199,5,2015-01-29 17:17:10,2015-01-14 08:33:56
aa0f64496a66d2a5d1a4d033f2eb075a8b084a78...dda65e992b72044c0fa0c8f5f33184028c0e3ad7,3,96,2,98,5,2015-01-29 17:52:25,2015-01-29 17:13:40
dda65e992b72044c0fa0c8f5f33184028c0e3ad7...a80d9449b77e624d14404933476c413caebaa42a,1,5,5,10,3,2015-01-29 18:59:32,2015-01-29 18:59:32
a80d9449b77e624d14404933476c413caebaa42a...630b80fc00e1a510d2708fe03684a1ed0a8ad88c,1,1,1,2,1,2015-01-29 21:26:54,2015-01-29 21:26:54
630b80fc00e1a510d2708fe03684a1ed0a8ad88c...35498d7045ba9138016464a344e2c145ce5264c1,5,416,90,506,19,2015-01-29 21:47:30,2014-12-15 17:30:19
35498d7045ba9138016464a344e2c145ce5264c1...62d514b06937cc7dd86e973ea11165c88343b42d,3,152,25,177,11,2015-01-29 21:48:06,2014-12-17 15:05:11
62d514b06937cc7dd86e973ea11165c88343b42d...bb1c379b36fbb40bfa922dbe13c648c6d96d7a29,4,96,75,171,14,2015-01-29 21:48:06,2015-01-19 18:27:20
bb1c379b36fbb40bfa922dbe13c648c6d96d7a29...b462f5dcf233a202c4e904c7587feec8401e5990,2,7,6,13,3,2015-01-29 21:48:06,2015-01-29 18:16:31
b462f5dcf233a202c4e904c7587feec8401e5990...bfcf9946e16d21b55dde50d4d21c71c898b10215,2,15,1,16,2,2015-01-29 22:06:23,2015-01-28 21:38:43
bfcf9946e16d21b55dde50d4d21c71c898b10215...8a6cbb3c94ab7530e6e2bf97e8c05cbd02b76cad,1,28,0,28,2,2015-01-29 22:06:24,2015-01-29 19:40:22
8a6cbb3c94ab7530e6e2bf97e8c05cbd02b76cad...2264413beb96e390ae20518bc79b35c51569acce,1,3,2,5,2,2015-01-29 22:13:35,2015-01-29 21:53:56
2264413beb96e390ae20518bc79b35c51569acce...54097f63d53b9988efc24f3a833318f4ba1a500c,1,1,1,2,1,2015-01-29 22:33:26,2015-01-29 16:19:32
54097f63d53b9988efc24f3a833318f4ba1a500c...4bc89bfe6dc50c2b6cb40c051cbc2240db1f1c87,1,21,21,42,21,2015-01-30 10:53:34,2015-01-30 10:53:34
4bc89bfe6dc50c2b6cb40c051cbc2240db1f1c87...c1500ea775c4cb130088b7d5bb5fb872bda50bae,4,81,5,86,14,2015-01-30 11:29:24,2014-09-14 16:15:52
c1500ea775c4cb130088b7d5bb5fb872bda50bae...29ad3b7f3609dd203ae4fa27f3d04da6868c69cd,8,69,45,114,34,2015-01-30 12:36:18,2015-01-30 12:05:11
29ad3b7f3609dd203ae4fa27f3d04da6868c69cd...d9498a173c61a37cef8d94ed20aea35d8e4ca92b,8,11,21,32,12,2015-01-30 12:36:18,2015-01-30 12:05:11
d9498a173c61a37cef8d94ed20aea35d8e4ca92b...1f3ab484a77d2a425f9c3ce340b09e26956604d1,6,20,28,48,20,2015-01-30 12:36:18,2015-01-30 12:05:11
1f3ab484a77d2a425f9c3ce340b09e26956604d1...ad68a41e8803fdaf66f95df7b963cf35ae846de4,2,2,1,3,2,2015-01-30 12:36:19,2015-01-30 12:05:11
ad68a41e8803fdaf66f95df7b963cf35ae846de4...ebde4681bd55683544611a5d358a9be916de1f21,1,5,0,5,1,2015-01-30 12:36:19,2015-01-30 12:05:11
ebde4681bd55683544611a5d358a9be916de1f21...30e5b52344cbaac3dfe64971299402b4e9cd701c,1,1,2,3,1,2015-01-30 12:46:55,2015-01-16 03:04:49
30e5b52344cbaac3dfe64971299402b4e9cd701c...6a38dbfd3c34c8f9efff503d17eb3cbeb666d422,3,43,2,45,5,2015-01-30 21:25:14,2014-09-22 17:52:32
6a38dbfd3c34c8f9efff503d17eb3cbeb666d422...3130a82b21691deaedbd7ee01ad3e970b386c0a6,1,12,16,28,13,2015-01-30 21:25:14,2015-01-30 21:24:50
3130a82b21691deaedbd7ee01ad3e970b386c0a6...2003fcf0deb0caae0e354382be9a07a087080ea6,1,1,1,2,1,2015-01-30 21:55:46,2015-01-30 21:55:46
2003fcf0deb0caae0e354382be9a07a087080ea6...0d424263ead16635afb582affab2b147f8e71626,3,2820,566,3386,124,2015-01-31 10:19:09,2014-11-23 22:08:33
0d424263ead16635afb582affab2b147f8e71626...6c6a4086b7398eaffcf3c2f5b3e7be414f514129,2,50,2,52,3,2015-02-02 11:49:14,2015-02-01 21:59:14
6c6a4086b7398eaffcf3c2f5b3e7be414f514129...2f3633d68f52464c36ea80a9572b03e2cd06bfc9,1,1,1,2,1,2015-02-02 14:03:03,2015-01-30 23:51:34
2f3633d68f52464c36ea80a9572b03e2cd06bfc9...8a2c80ce7ff3f4746123d6b5fdf1fb0e304c91d0,15,55,29,84,52,2015-02-02 14:48:55,2015-01-25 19:02:30
8a2c80ce7ff3f4746123d6b5fdf1fb0e304c91d0...c6d8512a1d7345516d1bd9a039d81821b9518bff,2,16,4,20,2,2015-02-02 14:57:42,2015-01-24 21:17:18
c6d8512a1d7345516d1bd9a039d81821b9518bff...452d1cd66e8109fd5d19189207ac4be16ad827b5,1,2,2,4,2,2015-02-02 19:56:27,2015-02-02 19:56:27
452d1cd66e8109fd5d19189207ac4be16ad827b5...5dfa6305558fe1109880911c928ca7af33804a52,1,91,0,91,1,2015-02-02 20:27:32,2015-02-02 20:25:20
5dfa6305558fe1109880911c928ca7af33804a52...2e5a7e52a0385575bbb55a801471b009afafeca3,2,27,6,33,7,2015-02-03 18:46:22,2015-02-03 17:22:42
2e5a7e52a0385575bbb55a801471b009afafeca3...c1cf053f379cc8d5295faf169f39d13772c5b9bd,1,10,2,12,4,2015-02-03 20:51:30,2015-02-03 20:51:30
c1cf053f379cc8d5295faf169f39d13772c5b9bd...09ee82d84dcbea4a6e8d85903af82dcd087a78a7,3,150,1,151,6,2015-02-04 10:01:14,2015-01-15 04:56:58
09ee82d84dcbea4a6e8d85903af82dcd087a78a7...a509e9aa149d0f88cc39f703d539f7ffd4cd6103,2,11,1,12,2,2015-02-04 12:48:55,2015-02-04 09:05:23
a509e9aa149d0f88cc39f703d539f7ffd4cd6103...9278ae67c6f8195042b673d397554af3ba6d461f,1,6,5,11,1,2015-02-04 13:16:53,2015-02-02 19:12:43
9278ae67c6f8195042b673d397554af3ba6d461f...7b7b56d36d68f0f9e0dbfd40c9d070269fdbbfe0,1,2,1,3,2,2015-02-04 13:37:18,2015-02-02 18:18:39
7b7b56d36d68f0f9e0dbfd40c9d070269fdbbfe0...cc8755cda6efda0b52954388e8a8d5306e4bfbca,2,9,1,10,3,2015-02-04 14:26:44,2015-02-03 23:26:20
cc8755cda6efda0b52954388e8a8d5306e4bfbca...28114faff4bb6b6ea2c02aa05a4c6918d85af160,1,2,2,4,2,2015-02-04 15:53:33,2015-02-04 15:46:19
28114faff4bb6b6ea2c02aa05a4c6918d85af160...966f6d831f9469a917601f9a10604612cd7bd792,2,22,4,26,5,2015-02-05 10:21:01,2015-02-04 23:14:39
966f6d831f9469a917601f9a10604612cd7bd792...898714df9ea38f9ef700015ced5ddea52f096b77,2,8,1,9,2,2015-02-06 01:32:42,2015-02-04 20:42:04
898714df9ea38f9ef700015ced5ddea52f096b77...030a42e79dec8a4bb73053762f7a54d797a058f6,1,2,1,3,1,2015-02-06 06:17:04,2015-02-05 10:38:42
030a42e79dec8a4bb73053762f7a54d797a058f6...9d53e5a38dd369dec82d82e13e078df3d6054c8a,3,43,12,55,12,2015-02-07 10:26:21,2014-12-19 22:59:52
9d53e5a38dd369dec82d82e13e078df3d6054c8a...06c39a033e0b8bbefd7e92dca9e1ce18c573562a,1,54,0,54,1,2015-02-09 10:39:40,2015-02-09 10:38:29
06c39a033e0b8bbefd7e92dca9e1ce18c573562a...c1199fb6b085733a2e078bac4e728e587b2c27ae,1,1,1,2,1,2015-02-09 11:16:39,2015-02-09 11:16:39
c1199fb6b085733a2e078bac4e728e587b2c27ae...d6eba21733c6e67e90e3a4763d8d41ad89a73a0c,2,57,3,60,7,2015-02-10 21:30:13,2015-01-23 19:35:20
d6eba21733c6e67e90e3a4763d8d41ad89a73a0c...c211e7a5ad5f1fb8748125f14912aa8715081925,2,26,6,32,14,2015-02-10 22:38:56,2014-12-06 13:04:55
c211e7a5ad5f1fb8748125f14912aa8715081925...732776f5f3faf638371c3b3e898fe34b548e609a,1,1,1,2,1,2015-02-12 11:59:15,2015-02-12 11:59:15
732776f5f3faf638371c3b3e898fe34b548e609a...c9a4421fc3c97448527eadef1f42eb2f487ec2e0,2,594,191,785,50,2015-02-12 16:04:10,2015-01-07 23:16:15
c9a4421fc3c97448527eadef1f42eb2f487ec2e0...cc744412b3e8d5c5698fe68910fad687dae526fa,1,2,2,4,2,2015-02-12 21:18:12,2015-02-12 01:28:57
cc744412b3e8d5c5698fe68910fad687dae526fa...3c6a0e568d1b3bfdfe8e3592895dda8f2d06adc2,1,3,0,3,1,2015-02-12 21:21:03,2015-02-12 01:08:39
3c6a0e568d1b3bfdfe8e3592895dda8f2d06adc2...51faaffdbcc734c55d52ff6c42b386d5c90207ea,1,6,2,8,2,2015-02-13 11:29:47,2015-02-13 11:09:32
51faaffdbcc734c55d52ff6c42b386d5c90207ea...2015ed2341921a4bdc4db765aadcb7ab7a8282c6,1,10,0,10,1,2015-02-13 11:49:34,2015-02-13 11:49:18
2015ed2341921a4bdc4db765aadcb7ab7a8282c6...27fcca9a27f9f02a730ebb0836b2b1ff0dda7412,2,5,53,58,5,2015-02-13 11:49:34,2015-02-13 11:49:18
27fcca9a27f9f02a730ebb0836b2b1ff0dda7412...056a31700803c0a6014b43cfcc36c5c500cc596e,2,104,15,119,15,2015-02-13 12:34:22,2015-02-12 08:28:13
056a31700803c0a6014b43cfcc36c5c500cc596e...bd6c04a1125f0d170b67426c245f97737e544319,1,1,0,1,1,2015-02-13 22:51:57,2015-02-13 22:49:33
bd6c04a1125f0d170b67426c245f97737e544319...fa0aa83937378cf8fc720c38bcc5c78fc923624e,1,24,31,55,8,2015-02-16 11:44:37,2015-02-14 06:49:45
fa0aa83937378cf8fc720c38bcc5c78fc923624e...75725b44f80542485bb5fb09f4227abb6b7a296e,1,4,10,14,8,2015-02-16 11:48:08,2014-10-23 07:27:20
75725b44f80542485bb5fb09f4227abb6b7a296e...f6272333127d908b19da23f9cd8a74052711795b,1,1,1,2,1,2015-02-17 18:20:20,2015-02-13 03:43:10
f6272333127d908b19da23f9cd8a74052711795b...49b54b0d774ce9c1c1397848bb5d2b4baa8a034b,1,5,0,5,1,2015-02-17 18:34:22,2015-02-17 10:42:43
49b54b0d774ce9c1c1397848bb5d2b4baa8a034b...aaae3cc4160417e6dad802ed9d9f6d5471821a87,2,81,2,83,7,2015-02-17 20:45:09,2014-03-09 22:02:59
aaae3cc4160417e6dad802ed9d9f6d5471821a87...5b5228675f67c8f5e04c7183c3ef5e71cb2bf08b,1,38,32,70,6,2015-02-17 22:32:22,2015-02-17 07:05:43
5b5228675f67c8f5e04c7183c3ef5e71cb2bf08b...da9eac8660343b1cd9fdcf9d2d1bda06067142d7,2,302,24,326,29,2015-02-18 09:54:54,2015-02-09 20:29:42
da9eac8660343b1cd9fdcf9d2d1bda06067142d7...30b48132e0fb92ea8dd25a9794b4c41a3a81a951,2,18,0,18,2,2015-02-18 13:18:30,2015-02-17 22:50:03
30b48132e0fb92ea8dd25a9794b4c41a3a81a951...ef894c87eaead76d90169113ab6acc9287654ea3,2,9,2,11,3,2015-02-18 13:32:00,2015-02-18 13:32:00
ef894c87eaead76d90169113ab6acc9287654ea3...507ee2d9bac77841681282dfcba9297dda576b41,1,7,1,8,3,2015-02-19 10:41:48,2015-02-19 07:17:14
507ee2d9bac77841681282dfcba9297dda576b41...7fe139af5a3289fdae9e7bde2261d9a02753118a,1,3,3,6,1,2015-02-20 18:54:48,2015-02-19 21:35:41
7fe139af5a3289fdae9e7bde2261d9a02753118a...910de493999c1f0ca8de08a43844227188d7ad72,1,0,1,1,1,2015-02-21 10:21:54,2015-02-06 01:33:13
910de493999c1f0ca8de08a43844227188d7ad72...5da1256fc2812d5b28fb0af0de81256054856369,2,27,10,37,5,2015-02-21 11:00:41,2015-02-20 18:01:44
5da1256fc2812d5b28fb0af0de81256054856369...7a52da6c637ab825df2b4c1d2bd90279358d5e80,1,1,1,2,1,2015-02-21 11:27:58,2015-02-06 23:02:31
7a52da6c637ab825df2b4c1d2bd90279358d5e80...3f09847b7335569f250ced85c6de3a4c5e35f9cc,1,15,15,30,11,2015-02-21 11:32:53,2015-02-10 04:15:26
3f09847b7335569f250ced85c6de3a4c5e35f9cc...0a8e113542080b65b9e12c2f2989adf0f56d8954,1,1,1,2,1,2015-02-21 11:43:01,2015-02-10 23:32:36
0a8e113542080b65b9e12c2f2989adf0f56d8954...a9e02de5e28c6789c6539358e90610ee8027e0da,1,12,0,12,1,2015-02-21 11:55:12,2015-02-11 02:09:16
a9e02de5e28c6789c6539358e90610ee8027e0da...16f12c86f62749762a6f758be744be83ab64d76e,1,2,2,4,2,2015-02-21 12:04:09,2015-02-11 16:20:13
16f12c86f62749762a6f758be744be83ab64d76e...b299e7313008161b395dc1c710d4e2bf124e5b62,1,1,1,2,1,2015-02-21 12:07:42,2015-02-17 04:59:52
b299e7313008161b395dc1c710d4e2bf124e5b62...5cdefba1b41a75cf256624ac844b676757c2bf28,1,1,1,2,1,2015-02-21 12:09:47,2015-02-18 05:47:34
5cdefba1b41a75cf256624ac844b676757c2bf28...cbedff06190a14183c29a666d96bb80e8803b951,1,1,1,2,1,2015-02-21 12:12:45,2015-02-19 23:28:21
cbedff06190a14183c29a666d96bb80e8803b951...c67f88b26c248066b52d996b1f7087bd46e253a7,1,3,1,4,1,2015-02-21 12:16:10,2015-02-06 22:31:32
c67f88b26c248066b52d996b1f7087bd46e253a7...46b80654cae9105642909cd55f73f7c26d2fbd80,2,11,3,14,4,2015-02-21 17:54:57,2015-02-06 03:48:50
46b80654cae9105642909cd55f73f7c26d2fbd80...ec27ce71984e04a5cd9fd78b640a0f1cf538b8f1,1,22,0,22,1,2015-02-21 18:05:16,2015-02-14 05:31:56
ec27ce71984e04a5cd9fd78b640a0f1cf538b8f1...efb74642a19cd73538e2ae90d5b9777e8c924b5d,2,5062,8,5070,3,2015-02-22 02:17:50,2015-02-20 05:17:39
efb74642a19cd73538e2ae90d5b9777e8c924b5d...750d06bc25c0cabc8ab39a6dcd63e79074b34fe9,2,6,0,6,2,2015-02-22 02:17:50,2015-02-20 06:30:25
750d06bc25c0cabc8ab39a6dcd63e79074b34fe9...367c7d90d4d999e3b9f46890c321cac5d07bd748,2,9048,2656,11704,1625,2015-02-22 02:17:50,2015-02-20 05:34:46
367c7d90d4d999e3b9f46890c321cac5d07bd748...76edec7f9b6dd35c9887d778c0f06085ba0f8c36,2,3,1,4,3,2015-02-22 02:17:50,2015-02-20 17:50:38
76edec7f9b6dd35c9887d778c0f06085ba0f8c36...f88178323ad8a21005f727ce642fc4b00d1bda34,2,2,3,5,3,2015-02-22 02:17:50,2015-02-20 17:50:38
f88178323ad8a21005f727ce642fc4b00d1bda34...05ae2815dcd223dbb27bc774132906466e0ed763,3,222,834,1056,147,2015-02-22 02:17:50,2015-02-20 18:37:35
05ae2815dcd223dbb27bc774132906466e0ed763...500d352901613a342f89b4afcbdf65d705f5eb8d,1,2,0,2,2,2015-02-22 02:17:50,2015-02-21 04:20:27
500d352901613a342f89b4afcbdf65d705f5eb8d...f497358df1ece0dfd1a93aca10ae8cfac182cb78,1,2,1,3,1,2015-02-22 02:17:50,2015-02-21 05:52:08
f497358df1ece0dfd1a93aca10ae8cfac182cb78...a773f89bc96a1aae1f0fecaa4e66476c8f982f20,2,4,0,4,3,2015-02-22 02:17:50,2015-02-21 20:08:45
a773f89bc96a1aae1f0fecaa4e66476c8f982f20...0356d72cd9006b53fa626b41a058ca1c19fb5bad,5,31,21,52,9,2015-02-22 02:17:53,2015-02-22 01:40:33
0356d72cd9006b53fa626b41a058ca1c19fb5bad...f6d0ac5bc83daf03fdcd2d8b2ea59b7c6c66414e,1,12,9,21,5,2015-02-22 19:14:01,2015-02-22 18:17:16
f6d0ac5bc83daf03fdcd2d8b2ea59b7c6c66414e...d8832d552732684894853c7f364af0440f7e5abe,1,55,6,61,2,2015-02-23 18:58:33,2014-10-21 09:26:25
d8832d552732684894853c7f364af0440f7e5abe...3bc429ad9f347139d09dceae6aeaaf7f16e08ddd,1,1,1,2,1,2015-02-23 19:49:37,2015-02-23 19:49:37
3bc429ad9f347139d09dceae6aeaaf7f16e08ddd...958bc1ab77860220f51c62006cbc817904291222,1,15,0,15,1,2015-02-24 17:22:13,2015-02-24 14:58:43
958bc1ab77860220f51c62006cbc817904291222...57aa00e5dce758cfd32121728dcb82f091aa694e,1,108,0,108,1,2015-02-24 17:51:15,2015-02-24 17:50:11
57aa00e5dce758cfd32121728dcb82f091aa694e...581ee9d0b6aacd76d9ede56ab6c735b2691f9193,3,2581,1714,4295,1666,2015-02-24 21:04:36,2015-02-24 17:22:39
581ee9d0b6aacd76d9ede56ab6c735b2691f9193...bfd7b227dbf826dcda351916881821ebceddc797,1,17,25,42,6,2015-02-25 11:03:53,2015-02-25 11:01:29
bfd7b227dbf826dcda351916881821ebceddc797...d7ec5f392e1550658ddf271a30627b1749eccb69,2,123,47,170,28,2015-02-27 04:52:56,2015-02-27 00:46:49
d7ec5f392e1550658ddf271a30627b1749eccb69...2c4ffd6af4eb012c4054fe7c096267bbc5510af0,2,28,2,30,2,2015-02-27 21:05:17,2015-02-25 12:08:06
2c4ffd6af4eb012c4054fe7c096267bbc5510af0...3d149c7f20ffabab5a635af9ddcfc7105112ab4a,2,4,0,4,2,2015-02-27 21:48:31,2015-01-30 22:07:58
3d149c7f20ffabab5a635af9ddcfc7105112ab4a...80f139b8607ce8ef066f0a23142cfb0aebbdc0c2,728,3640,0,3640,1456,2015-02-27 21:53:10,2015-02-27 21:53:09
80f139b8607ce8ef066f0a23142cfb0aebbdc0c2...f22e1fc9610ae111a3ea8746a3a57169c99ce142,2,15,3,18,5,2015-02-28 09:56:56,2015-02-27 15:13:51
f22e1fc9610ae111a3ea8746a3a57169c99ce142...7cfa79e98e54a7738722c0453432b70fbde1b6e7,1,2,2,4,2,2015-02-28 12:11:44,2015-02-10 11:27:45
7cfa79e98e54a7738722c0453432b70fbde1b6e7...9d071b2fc0471a0e9e72c8954b667ab8281e68bf,1,2,2,4,1,2015-02-28 17:02:37,2015-02-24 19:32:37
9d071b2fc0471a0e9e72c8954b667ab8281e68bf...410f7c682633c681be641cd2a321f9e51671d474,2,35,17,52,10,2015-02-28 17:09:31,2015-02-18 06:37:50
410f7c682633c681be641cd2a321f9e51671d474...29cdaee2b6e853bc3f8882a00661698d146ecd18,2,49,0,49,5,2015-03-02 10:40:22,2014-12-04 00:08:53
29cdaee2b6e853bc3f8882a00661698d146ecd18...0f50b01cc721ec682f0ded16eff0d73d3bceaa11,1,72,73,145,71,2015-03-02 10:41:09,2015-03-02 10:39:28
0f50b01cc721ec682f0ded16eff0d73d3bceaa11...bb365070a3ed7c2d26056d378ab6a8ef493b23cc,3,24,7,31,9,2015-03-02 13:48:18,2015-03-02 10:39:49
bb365070a3ed7c2d26056d378ab6a8ef493b23cc...2907a0288b20b3ed9ded39f4c7425dcc522bf8ab,1,5,1,6,1,2015-03-02 19:40:54,2014-12-08 23:45:54
2907a0288b20b3ed9ded39f4c7425dcc522bf8ab...3b8163b7b664f24499e75460ab50c066eaec0f78,1,9,1,10,2,2015-03-02 20:29:41,2014-12-08 14:15:39
3b8163b7b664f24499e75460ab50c066eaec0f78...c62fa6bd898e1048d4690d41034489dc60ba6ac2,2,10,1,11,2,2015-03-02 22:16:21,2014-12-11 18:10:58
c62fa6bd898e1048d4690d41034489dc60ba6ac2...76b1b2bec26d04730ef3c1d780abb359c3eb7de4,13,425,399,824,55,2015-03-02 22:19:59,2015-03-02 11:24:30
76b1b2bec26d04730ef3c1d780abb359c3eb7de4...997fdea1ee125b6ac1bc6b3ae319e83657c5eab9,5,135,133,268,5,2015-03-02 22:20:00,2015-03-02 11:42:21
997fdea1ee125b6ac1bc6b3ae319e83657c5eab9...38fbe3ee8370fc449b82d80df07b5c2ed2cd5fbe,4,145,191,336,32,2015-03-02 22:20:00,2015-03-02 18:52:58
38fbe3ee8370fc449b82d80df07b5c2ed2cd5fbe...92c366d205da36ec26502aded23db71a6473dad7,4,140,27,167,15,2015-03-02 22:20:00,2015-03-02 19:46:51
92c366d205da36ec26502aded23db71a6473dad7...53c663699126815eabc2a3bc1e3bafc8b3874268,2,125,40,165,11,2015-03-02 22:20:00,2015-03-02 20:08:04
53c663699126815eabc2a3bc1e3bafc8b3874268...9b35dfb658411ff12ded73be44e52072e43e0c1c,4,0,83,83,8,2015-03-02 22:21:11,2015-03-02 20:16:52
9b35dfb658411ff12ded73be44e52072e43e0c1c...4501da327d0d8fe5f6ca6c0322ff9f2d408ffb4c,3,4,4,8,4,2015-03-02 22:34:31,2015-03-02 22:34:31
4501da327d0d8fe5f6ca6c0322ff9f2d408ffb4c...f8c421617096a8d613f4eb6d0f5b098ee149c029,2,32,2,34,4,2015-03-03 14:09:23,2014-12-22 08:53:48
f8c421617096a8d613f4eb6d0f5b098ee149c029...f5917763130e2dedeb02ee4a09bc19323d1c1675,1,18,5,23,5,2015-03-03 14:13:13,2015-03-03 14:13:13
f5917763130e2dedeb02ee4a09bc19323d1c1675...c0498d45feb913c318224ea70b5adf7112df6bac,5,128,14,142,14,2015-03-03 14:39:11,2014-12-18 21:50:18
c0498d45feb913c318224ea70b5adf7112df6bac...0413bee8cc563a6555f8d42d5f183f6fbefc7350,3,103,7,110,9,2015-03-03 14:44:48,2015-02-07 15:18:18
0413bee8cc563a6555f8d42d5f183f6fbefc7350...ddc612056e4203eb7466f84e4fb0cce610eadb15,5,30,18,48,7,2015-03-03 14:57:03,2015-02-07 17:35:31
ddc612056e4203eb7466f84e4fb0cce610eadb15...82000111dc79e525aafa11debf2e241adba6add0,1,4,4,8,4,2015-03-04 00:51:12,2015-03-01 07:14:40
82000111dc79e525aafa11debf2e241adba6add0...e650c45894abe6314a806e6b3e32c908df5c00fd,4,222,13,235,4,2015-03-04 12:05:18,2015-01-25 23:17:12
e650c45894abe6314a806e6b3e32c908df5c00fd...87834537840b74744de8e136b027e4456080bb43,1,0,1,1,1,2015-03-04 12:07:51,2015-03-04 12:07:51
87834537840b74744de8e136b027e4456080bb43...2404b77e481bf60e0c836107ca4e07aa8e2ad6d3,1,13,2,15,1,2015-03-04 12:20:49,2015-03-04 12:20:49
2404b77e481bf60e0c836107ca4e07aa8e2ad6d3...0c541cfb2ae20721b6ed231e2c1a7ca17accd2d6,2,7,1,8,2,2015-03-04 12:24:04,2015-03-04 12:21:29
0c541cfb2ae20721b6ed231e2c1a7ca17accd2d6...caa0b9dab3945ed824543781b1ffb65d763581c9,1,2,2,4,2,2015-03-04 13:14:03,2015-03-04 13:13:34
caa0b9dab3945ed824543781b1ffb65d763581c9...4374f892c6fa4af6ba1f2ed47c5f888fdb5fadc5,2,5,3,8,3,2015-03-04 14:26:10,2014-11-18 03:18:24
4374f892c6fa4af6ba1f2ed47c5f888fdb5fadc5...2d0eda10e43f6b079b531c507282fad082ea0762,1,31,3,34,4,2015-03-04 21:25:01,2015-03-04 21:25:01
2d0eda10e43f6b079b531c507282fad082ea0762...d02d0585a086ecd2e1de628218b5a6d85c8fc7bd,2,94,0,94,3,2015-03-06 10:54:14,2015-03-04 17:14:40
d02d0585a086ecd2e1de628218b5a6d85c8fc7bd...7705edc0da2138734e3792572f6f25d1ef3876a9,1,6,0,6,1,2015-03-06 11:26:20,2015-03-06 11:26:20
7705edc0da2138734e3792572f6f25d1ef3876a9...44e9d2ca6ce97220d306139dd8cb54eba2af71af,1,1,1,2,1,2015-03-06 11:54:55,2015-03-06 11:54:55
44e9d2ca6ce97220d306139dd8cb54eba2af71af...342e5f3ce38d2fd10c5d5a98ca66f864286a7922,1,5,9,14,5,2015-03-06 13:51:39,2015-02-12 01:18:42
342e5f3ce38d2fd10c5d5a98ca66f864286a7922...17f02d5bb2f1a577cf41d9abef017c61a6eca6be,1,4,0,4,1,2015-03-06 13:51:40,2015-03-05 18:32:16
17f02d5bb2f1a577cf41d9abef017c61a6eca6be...3fd48742b0fecbc470c44b465ba90786bda87451,5,44,0,44,5,2015-03-06 13:51:40,2015-03-06 13:48:33
3fd48742b0fecbc470c44b465ba90786bda87451...248b036888fa104cb74a0e5eca5591ef40c4c54e,1,4,4,8,4,2015-03-08 12:55:56,2015-03-08 12:21:32
248b036888fa104cb74a0e5eca5591ef40c4c54e...abf87673e57029e2fed5dc8966707a0bacf06a3e,1,1,1,2,1,2015-03-08 12:56:02,2015-03-07 05:22:22
abf87673e57029e2fed5dc8966707a0bacf06a3e...212975af9647bfa76011d34df0fe7ee5b0b584d9,1,1,1,2,1,2015-03-08 12:56:03,2015-03-07 16:19:41
212975af9647bfa76011d34df0fe7ee5b0b584d9...f227f7a5af0934e7c4c93ac6f41b95c42d729a34,1,1,1,2,1,2015-03-08 12:56:04,2015-03-03 11:05:42
f227f7a5af0934e7c4c93ac6f41b95c42d729a34...f6b51fc0a226c23858bb561c7f8b815b02164259,1,1,0,1,1,2015-03-08 17:14:17,2015-02-26 16:04:48
f6b51fc0a226c23858bb561c7f8b815b02164259...770a4ddcc6b73d7de75237f8108cc61d43ec292c,1,37,0,37,1,2015-03-08 17:47:36,2015-02-23 01:27:30
770a4ddcc6b73d7de75237f8108cc61d43ec292c...41fdb3d5367a7e439822ebd7fc4a473b3a89feaa,1,2,1,3,1,2015-03-08 19:35:33,2015-02-27 16:01:03
41fdb3d5367a7e439822ebd7fc4a473b3a89feaa...3a4b6b83efdb8051e5c4803c0892c19ceb2cba50,2,61,12,73,13,2015-03-09 13:45:49,2015-01-22 18:48:14
3a4b6b83efdb8051e5c4803c0892c19ceb2cba50...4f1f9cfdb721cf308ca1162b2227836dc1d28388,3,39,4,43,7,2015-03-09 14:12:04,2015-01-22 18:46:00
4f1f9cfdb721cf308ca1162b2227836dc1d28388...fb7db4a07bd1b0b67824d3808fe315419b272689,1,20,15,35,5,2015-03-09 14:47:49,2015-03-04 23:28:07
fb7db4a07bd1b0b67824d3808fe315419b272689...1924cf221695f4abcf2e73e26b93c113571118ac,1,0,2,2,1,2015-03-10 12:26:41,2015-03-10 10:11:13
1924cf221695f4abcf2e73e26b93c113571118ac...bb5bf7f8162d11610a53428e630b47030bdc38e5,4,31,0,31,5,2015-03-10 17:43:39,2015-03-09 07:11:42
bb5bf7f8162d11610a53428e630b47030bdc38e5...4acb0af24c7fb3705a197ca96adc532de4766a7a,2,11,1,12,2,2015-03-11 12:01:33,2015-03-06 14:54:54
4acb0af24c7fb3705a197ca96adc532de4766a7a...68dbbfbf3289a0e16683031a47112c401443e656,729,5826,0,5826,729,2015-03-11 12:01:34,2015-03-06 14:54:54
68dbbfbf3289a0e16683031a47112c401443e656...2b4dfa9e2b63d7ebb78f3b0fd3439d18f932e1cd,2,28,2,30,5,2015-03-11 12:05:05,2015-03-11 11:58:01
2b4dfa9e2b63d7ebb78f3b0fd3439d18f932e1cd...9b2a4c6851b783bdf15507201c213ac5dc91cae1,4,26,71,97,18,2015-03-11 15:53:29,2015-03-05 00:40:08
9b2a4c6851b783bdf15507201c213ac5dc91cae1...1fc87e2b6adf2ce6d17bdc93956b8c998c6817cd,1,1,1,2,1,2015-03-11 17:53:45,2015-03-11 17:53:45
1fc87e2b6adf2ce6d17bdc93956b8c998c6817cd...c01b1f47c0c4651305bd5a7e7536df7d090003e7,1,1,1,2,1,2015-03-12 19:58:38,2015-03-12 19:58:38
c01b1f47c0c4651305bd5a7e7536df7d090003e7...68146cc09205c3f6eec91626edcd5724abb34b56,1,2,2,4,2,2015-03-12 20:44:59,2015-03-12 15:32:00
68146cc09205c3f6eec91626edcd5724abb34b56...67297de109503f684479324a6699ead0e1e51f3b,1,3,2,5,2,2015-03-12 20:45:08,2015-03-12 14:13:19
67297de109503f684479324a6699ead0e1e51f3b...891b364c1b61faaa43880bcaa86e002dbe48cf49,1,1,0,1,1,2015-03-12 20:45:09,2015-03-11 20:03:29
891b364c1b61faaa43880bcaa86e002dbe48cf49...1c3bbada27f2f628a431e1ce9e8f5024a29eba20,1,1,1,2,1,2015-03-12 21:14:43,2015-03-11 12:02:46
1c3bbada27f2f628a431e1ce9e8f5024a29eba20...1846572d6f78514bdb516aa28f85edcf7e65e2fb,1,4,0,4,2,2015-03-12 21:16:06,2014-07-09 10:12:32
1846572d6f78514bdb516aa28f85edcf7e65e2fb...210c18418469e9e74a16f1627a265d4f3d6b47cc,1,2,0,2,2,2015-03-13 11:43:49,2015-01-28 13:36:20
210c18418469e9e74a16f1627a265d4f3d6b47cc...6a03ca274314352052c3082163367a146bb11c2d,2,96,7,103,9,2015-03-13 11:55:01,2015-01-28 22:01:52
6a03ca274314352052c3082163367a146bb11c2d...3086fcd644eb9c91db71f516ae051325cab195f5,1,2,2,4,2,2015-03-13 16:35:17,2015-03-11 20:33:43
3086fcd644eb9c91db71f516ae051325cab195f5...2f4be3e2b9ec8f2fd2fc71aac83ef343521de3dd,2,8,0,8,3,2015-03-13 16:40:15,2015-03-03 07:14:30
2f4be3e2b9ec8f2fd2fc71aac83ef343521de3dd...4fdac4d22fc8eed23cf0a3f5a6a97d758cb10615,1,2,0,2,1,2015-03-13 17:35:11,2015-03-13 15:01:26
4fdac4d22fc8eed23cf0a3f5a6a97d758cb10615...e6688ec280e5e4ab1fcc6a2f7bf36b72dc9ae225,1,10,8,18,9,2015-03-13 17:35:25,2015-03-13 15:05:38
e6688ec280e5e4ab1fcc6a2f7bf36b72dc9ae225...4c613a2603c972f7b82826e5620c085b2eedeeed,1,6,6,12,6,2015-03-13 17:35:34,2015-03-13 16:00:08
4c613a2603c972f7b82826e5620c085b2eedeeed...2979bf38ddcf38b3c9ef45203a0f5f0256b03e68,1,1,1,2,1,2015-03-13 18:54:22,2015-03-11 11:48:49
2979bf38ddcf38b3c9ef45203a0f5f0256b03e68...3613a6007c8bebee6e9eb6da0fb668ad5e5fd245,1,0,1,1,1,2015-03-13 20:10:57,2015-03-11 22:58:26
3613a6007c8bebee6e9eb6da0fb668ad5e5fd245...9e8a687c370297688d59bcfa430d2142255302b6,5,55,0,55,5,2015-03-15 20:38:28,2015-03-10 20:26:27
9e8a687c370297688d59bcfa430d2142255302b6...67688d5ca00f6de4c7fe6084e2fa762a00d25610,2,28,19,47,3,2015-03-15 20:39:45,2015-03-10 21:27:10
67688d5ca00f6de4c7fe6084e2fa762a00d25610...d8492f43319f95c4b03123142697f5d6e1b2e358,1,2,2,4,2,2015-03-15 21:00:39,2015-03-14 10:12:23
d8492f43319f95c4b03123142697f5d6e1b2e358...db866f1f867752f5be082c348f7fcefffcfbd305,1,166,0,166,1,2015-03-17 12:06:22,2015-03-17 12:06:22
db866f1f867752f5be082c348f7fcefffcfbd305...9900610eea4ece87b063f2aa9d82c75c369927df,2,133,7,140,2,2015-03-17 12:18:10,2015-03-14 02:20:35
9900610eea4ece87b063f2aa9d82c75c369927df...8028315640bac6eae17297270d4ee1892abf6add,1,24,12,36,12,2015-03-17 12:18:10,2015-03-17 12:17:28
8028315640bac6eae17297270d4ee1892abf6add...9093efe062a9d60a35136e444e2130daa6161988,1,2,2,4,1,2015-03-17 12:54:02,2015-03-12 22:12:22
9093efe062a9d60a35136e444e2130daa6161988...e57138d7eff1210f99238c475fff57530bf0ab19,2,14,0,14,3,2015-03-17 12:59:29,2015-03-13 05:01:48
e57138d7eff1210f99238c475fff57530bf0ab19...170ff9a37dea8772dda7c89e84176ac1a8992878,3,27,0,27,5,2015-03-17 13:41:15,2015-03-09 18:12:25
170ff9a37dea8772dda7c89e84176ac1a8992878...1e58488ad65abf7031bab5813523bb9d86dbd28c,26,1916,12,1928,35,2015-03-17 16:17:56,2015-02-12 21:45:25
1e58488ad65abf7031bab5813523bb9d86dbd28c...1af563d43e74cb7be53e815b66fd91dd93986ed6,2,60,0,60,4,2015-03-17 19:13:37,2015-03-16 12:36:53
1af563d43e74cb7be53e815b66fd91dd93986ed6...4b7a46adadeecd0090b97c6371a5950a9fabcd2c,1,8,0,8,2,2015-03-17 20:40:03,2015-03-17 16:58:21
4b7a46adadeecd0090b97c6371a5950a9fabcd2c...44337f63fa94116795e83e3a764a6ba6782809c7,2,100,75,175,16,2015-03-17 20:53:55,2015-03-13 17:30:39
44337f63fa94116795e83e3a764a6ba6782809c7...ea9fd82ce1c7dc50b3f589da1dac2276663882f9,1,4,0,4,1,2015-03-17 23:57:55,2015-03-17 22:38:11
5bd23fde7ab94646190d18d2891532feafad6e2e...35ca4fcb9c49e505e28669e951e01ddedb01d7db,4,8,4,12,6,2010-04-02 18:49:48,2010-04-02 18:49:48
35ca4fcb9c49e505e28669e951e01ddedb01d7db...a80a61839a66d244c8bb14bbe2975746e02516c8,24,262,245,507,97,2010-04-04 00:04:36,2010-04-04 00:04:36
a80a61839a66d244c8bb14bbe2975746e02516c8...5dcf9bb4feb144b3a54a43524210dd7d0bb4213e,6,22,21,43,8,2010-04-04 03:23:16,2010-04-04 03:19:55
5dcf9bb4feb144b3a54a43524210dd7d0bb4213e...4bfa4e230d5ebdd582068effe7f4f1b60c43093a,1,0,0,0,0,2010-04-04 23:39:17,2010-04-04 23:39:17
4bfa4e230d5ebdd582068effe7f4f1b60c43093a...7a4b48020688060debe9cb0f9c17615d7585cbe7,22,198,190,388,50,2010-04-05 18:46:53,2010-04-05 18:46:53
7a4b48020688060debe9cb0f9c17615d7585cbe7...1c670b2a7c3f6153ea2e5047722f7151b9795b33,6,55,12,67,7,2010-04-05 21:09:25,2010-04-05 21:09:25
1c670b2a7c3f6153ea2e5047722f7151b9795b33...2107eafcde390eebbf59e829194626c488de9e29,9,102,25,127,18,2010-04-06 03:53:33,2010-04-06 03:53:33
2107eafcde390eebbf59e829194626c488de9e29...e6460685869e16b5016de975fd0ba15a7e436951,4,40,3,43,7,2010-04-06 04:26:52,2010-04-06 04:26:52
0bd7e4fe75bc02fa1cf67a0c66255db35bfbfe8f...5c14a35e6210fb8500456b3b4ca026cfeb889776,5,725,1,726,5,2010-08-13 16:50:03,2010-08-13 16:50:03
84b3a1774edb1e12ba0076e32fe8928ba54a48e3...7159b30752f63ad8a127101cbc10d7e672ae1620,2,8,1,9,2,2010-08-13 22:14:41,2010-08-13 22:14:41
84b3a1774edb1e12ba0076e32fe8928ba54a48e3...449d2ef7246b029eb927261526dc1b907ffa3734,2,81,14,95,11,2010-08-13 17:01:08,2010-08-13 16:31:06
449d2ef7246b029eb927261526dc1b907ffa3734...f6527bd53c1d80c7db549b22ecf3aa02e96cda1f,2,12,30,42,3,2010-08-13 17:01:16,2010-08-13 16:45:56
14fe8cff2dc8225217de6b5bc553f93308f9490b...26b5ae410970aab022452b5f0aa7f01a3963623a,1,5,5,10,1,2010-08-14 17:29:50,2010-08-14 17:29:50
26b5ae410970aab022452b5f0aa7f01a3963623a...91104f878debd0cd86ba62fed2f30be433200690,3,12,0,12,3,2010-08-14 18:03:36,2010-08-14 18:03:36
e6460685869e16b5016de975fd0ba15a7e436951...0df93fd49c1687b2eddaa79faa1c0adbef82bf72,15,3551,36,3587,36,2010-04-07 17:17:15,2010-04-07 17:17:15
e6460685869e16b5016de975fd0ba15a7e436951...ee327a1f4f75f57c2a2c6166520c092d4942ffe0,8,29,46,75,16,2010-04-06 21:04:08,2010-04-06 21:04:08
5c14a35e6210fb8500456b3b4ca026cfeb889776...669d8241b2ea61122aee3e45f67694e65596a2dd,2,81,14,95,11,2010-08-13 17:13:03,2010-08-13 16:31:06
669d8241b2ea61122aee3e45f67694e65596a2dd...1f230bf3f55fc8541423dfa9fc0bc91f50c000a3,2,12,30,42,3,2010-08-13 17:13:03,2010-08-13 16:45:56
7159b30752f63ad8a127101cbc10d7e672ae1620...9899959d695a97ddbb3e9a626a769efa714bffe7,1,9,12,21,2,2010-08-16 17:48:00,2010-08-16 17:48:00
f6ff0521ad3f298687f7105211ee9cc20a21707c...68900e2039e80f9279bbde9a56753aaa342a2eb7,1,1,0,1,1,2010-08-13 17:05:25,2010-08-13 17:05:25
68900e2039e80f9279bbde9a56753aaa342a2eb7...7cb5a0cca26a19d1f391a9ebf89c084849b98274,1,1,0,1,1,2010-08-13 17:05:59,2010-08-13 17:05:59
82cb18db28ea7381e5168489207bfa23c059af0c...29309e0e5a5f5eafd0f948100417d63127d3332d,2,3,0,3,2,2010-04-07 17:35:54,2010-04-07 17:35:54
ee327a1f4f75f57c2a2c6166520c092d4942ffe0...6ea1ac7b05a4079bcda0356e095703d36ccdf6b3,4,42,2,44,5,2010-04-07 21:13:10,2010-04-07 21:13:10
867826c3de256e1e23e81cdb362eff6e325130d7...9260f4867a6d1aaa51585a3efac9d315b74eae53,1,2,2,4,2,2010-08-13 17:16:27,2010-08-13 17:11:11
9260f4867a6d1aaa51585a3efac9d315b74eae53...60eeeb9f20be3220dbb891abef848fe3754437da,2,42,23,65,6,2010-08-13 19:24:09,2010-08-13 19:05:50
60eeeb9f20be3220dbb891abef848fe3754437da...550e5f8ce948f52a37286c91502bd49f44b73474,1,7,4,11,5,2010-08-14 17:09:52,2010-08-14 17:09:52
29309e0e5a5f5eafd0f948100417d63127d3332d...ab7b7dbf76d25401c4862171b3e54c9748b5098c,2,59,7,66,14,2010-04-07 21:14:25,2010-04-07 21:14:25
3d0b40fee2feeb49f46063b2012977c623f1ef6f...a8aa5af413c068608aa28ef0d48cef1d5ad66485,4,28,22,50,10,2010-04-07 23:36:33,2010-04-07 23:36:33
a8aa5af413c068608aa28ef0d48cef1d5ad66485...e0ad7dfcd47196d0aa9271e84b2c4ac26cfda3f4,9,36,37,73,30,2010-04-08 00:24:24,2010-04-08 00:24:24
e0ad7dfcd47196d0aa9271e84b2c4ac26cfda3f4...c4ef1f2fdd73bdaeda879e596d3d96e4e68cb6fd,20,171,269,440,60,2010-04-08 20:43:40,2010-04-08 20:43:40
c4ef1f2fdd73bdaeda879e596d3d96e4e68cb6fd...41a5c408c242269bf31bc0b774c7304fdf7c2f1c,7,804,34,838,22,2010-04-08 22:05:05,2010-04-08 22:05:05
41a5c408c242269bf31bc0b774c7304fdf7c2f1c...843bd355d25ebf2369aec79f98cb6704d38497e9,18,320,181,501,80,2010-04-09 23:20:15,2010-04-09 23:20:15
843bd355d25ebf2369aec79f98cb6704d38497e9...2637d4e90c8a43436d21a4b9e790b00ae461c438,9,192,177,369,68,2010-04-12 21:28:15,2010-04-12 21:28:15
2637d4e90c8a43436d21a4b9e790b00ae461c438...841640e540b5e054a97e650bdd7b560680e94840,1,2,2,4,2,2010-04-12 21:30:57,2010-04-12 21:30:57
841640e540b5e054a97e650bdd7b560680e94840...713307b6505a56ca7b5423b36e297070d756ff15,7,53,13,66,18,2010-04-12 23:24:28,2010-04-12 23:24:28
713307b6505a56ca7b5423b36e297070d756ff15...7c49b255483c0381c23de41d108800f93ebc1979,5,80,8,88,19,2010-04-13 02:05:39,2010-04-13 02:05:39
7c49b255483c0381c23de41d108800f93ebc1979...e8ac57caae624dca6509ce1619ae254ffd1fe0f4,1,6,10,16,1,2010-04-13 02:16:30,2010-04-13 02:16:30
e8ac57caae624dca6509ce1619ae254ffd1fe0f4...cd03fe92a5dbd2aba516b64fc8067c5fba1e4a81,4,26,7,33,11,2010-04-13 21:25:12,2010-04-13 21:25:12
cd03fe92a5dbd2aba516b64fc8067c5fba1e4a81...70e401ef100614295fc808e32f0142f07c315461,9,140,7,147,11,2010-04-15 21:17:33,2010-04-15 21:17:33
70e401ef100614295fc808e32f0142f07c315461...deb86fe357a901889bc4289087f0b9e69cb8a302,17,424,184,608,98,2010-04-16 21:01:29,2010-04-16 21:01:29
deb86fe357a901889bc4289087f0b9e69cb8a302...6470b48ce022885551e83c9f5fd8a90fbc6ff80e,5,30,11,41,12,2010-04-17 00:03:06,2010-04-17 00:03:06
6470b48ce022885551e83c9f5fd8a90fbc6ff80e...8394353b8580eadb9502abbcc963b594c9d9f53f,3,5,3693,3698,5,2010-04-17 03:10:09,2010-04-17 03:10:09
8394353b8580eadb9502abbcc963b594c9d9f53f...8e1b670d5b262f70fdbf4c4b01d3109d54a12ac5,5,32,60,92,13,2010-04-19 19:54:39,2010-04-19 19:54:39
8e1b670d5b262f70fdbf4c4b01d3109d54a12ac5...618a2b423d826ab8366a6907e71a4af0e76d6211,4,27,8,35,7,2010-04-19 21:36:41,2010-04-19 21:36:41
618a2b423d826ab8366a6907e71a4af0e76d6211...9f9bdcf3d16de651f85ccfe9e079cb57baca9eb7,6,13,13,26,10,2010-04-19 21:41:36,2010-04-19 21:41:36
9f9bdcf3d16de651f85ccfe9e079cb57baca9eb7...47ec2187776658ad9ee2a9c71a28ddb860bec43a,1,2,2,4,2,2010-04-19 21:53:18,2010-04-19 21:53:18
47ec2187776658ad9ee2a9c71a28ddb860bec43a...259c2bba4bf1fc4f0d4cf5bcda4ffef0fb5a615a,5,24,14,38,9,2010-04-20 00:02:46,2010-04-20 00:02:46
259c2bba4bf1fc4f0d4cf5bcda4ffef0fb5a615a...22d93e0a3bc2a6dc0f64c63c68bc8f8489ea9068,14,82,51,133,42,2010-04-21 01:14:13,2010-04-21 01:14:13
22d93e0a3bc2a6dc0f64c63c68bc8f8489ea9068...e78405f6ed82fcd2e9a1cdffb7f1103d52752623,11,298,264,562,71,2010-04-21 19:50:05,2010-04-21 19:50:05
e78405f6ed82fcd2e9a1cdffb7f1103d52752623...4aaec251dfebd01729c0726f07fc113b97679219,1,3,3,6,3,2010-04-21 20:29:49,2010-04-21 20:29:49
4aaec251dfebd01729c0726f07fc113b97679219...8b29156a2ddcc738f9b0cf8dfc48a8648474884d,7,31,27,58,17,2010-04-21 21:29:05,2010-04-21 21:29:05
8b29156a2ddcc738f9b0cf8dfc48a8648474884d...d7416c4c823b9e74d0c725cffb6f333be9432fba,1,5,5,10,3,2010-04-21 21:51:39,2010-04-21 21:51:39
d7416c4c823b9e74d0c725cffb6f333be9432fba...2a9669e1d853d4e18d2eb1f07e84ee5baec838c2,6,21,9,30,7,2010-04-22 22:50:20,2010-04-22 22:50:20
2a9669e1d853d4e18d2eb1f07e84ee5baec838c2...fe434307d15d697a5ffade51bad068f6443965b2,11,36,30,66,21,2010-04-23 00:11:56,2010-04-23 00:11:56
fe434307d15d697a5ffade51bad068f6443965b2...7ef5e055afec5ad7f279bcc4bd70b9f069d87a95,3,3,17,20,3,2010-04-23 04:04:20,2010-04-23 04:04:20
7ef5e055afec5ad7f279bcc4bd70b9f069d87a95...df364c39806b66d135c277949c0aae924d194f34,1,2,0,2,1,2010-04-23 04:11:24,2010-04-23 04:11:24
df364c39806b66d135c277949c0aae924d194f34...8b63c2c4e6924b062a318eebc6e862a4cef0b836,1,20,0,20,1,2010-04-23 04:15:58,2010-04-23 04:15:58
8b63c2c4e6924b062a318eebc6e862a4cef0b836...5fdb117b32b72a908a3938bee8f1bce9854a0004,6,27,33,60,12,2010-04-23 05:09:17,2010-04-23 05:09:17
5fdb117b32b72a908a3938bee8f1bce9854a0004...0396054b4a420972e16d0d9e965eb51ecd6f86a2,3,9,6,15,3,2010-04-23 05:44:48,2010-04-23 05:44:48
0396054b4a420972e16d0d9e965eb51ecd6f86a2...c29dc1a940950b558eae92ba976e2c2c5aceab58,1,2,2,4,2,2010-04-23 05:48:48,2010-04-23 05:48:48
c29dc1a940950b558eae92ba976e2c2c5aceab58...076f37a5ec26e88c5aeb2f37aa19ea7b2516d9f3,2,3,3,6,2,2010-04-23 14:34:02,2010-04-23 14:34:02
076f37a5ec26e88c5aeb2f37aa19ea7b2516d9f3...02fa10f93ce5a75dd925f13ec7456802a6e120e4,2,24,4,28,7,2010-04-26 18:57:33,2010-04-26 18:57:33
02fa10f93ce5a75dd925f13ec7456802a6e120e4...2a7cd9f39089af08ff42be6fb247116c35e2d345,3,21,12,33,5,2010-04-26 23:49:34,2010-04-26 23:49:34
2a7cd9f39089af08ff42be6fb247116c35e2d345...b275403465cdc581804bc74bf12e243edd642a42,2,3,3,6,2,2010-04-27 00:02:27,2010-04-27 00:02:27
b275403465cdc581804bc74bf12e243edd642a42...fce48eb60a47be87a3d95e0750e54c19c2a346d0,7,50,17,67,21,2010-04-27 18:18:08,2010-04-27 18:18:08
fce48eb60a47be87a3d95e0750e54c19c2a346d0...913729ee0120cc72e13b18d826c6da0fe2b98bf7,3,76,122,198,13,2010-04-29 17:55:22,2010-04-29 17:55:22
913729ee0120cc72e13b18d826c6da0fe2b98bf7...c7913a4b7a3f5ffb0ea6bb1e636ac9d4a0e75c32,8,197,11,208,13,2010-04-30 00:28:33,2010-04-30 00:28:33
c7913a4b7a3f5ffb0ea6bb1e636ac9d4a0e75c32...549ff73a9b66e718383c79ccd7c28e4f9b25632d,2,9,0,9,3,2010-04-30 17:27:41,2010-04-30 17:27:41
549ff73a9b66e718383c79ccd7c28e4f9b25632d...4542716370ac52f385795f509436104a2a3501d2,2,3,3,6,3,2010-05-10 17:36:02,2010-05-10 17:36:02
549ff73a9b66e718383c79ccd7c28e4f9b25632d...ac1d02d0658cb74ae3822e364f84809d78cda335,6,35,10,45,12,2010-04-30 19:22:07,2010-04-30 19:22:07
ac1d02d0658cb74ae3822e364f84809d78cda335...038a743e6f49c347a38edc0e54dcbb175905a475,13,112,48,160,39,2010-05-07 19:09:14,2010-05-07 19:09:14
038a743e6f49c347a38edc0e54dcbb175905a475...0305b6746e2c50960b042c5d687794e030930f8b,3,18,4,22,5,2010-05-07 20:43:54,2010-05-07 20:43:54
0305b6746e2c50960b042c5d687794e030930f8b...664f1c56876f00b885272c39f759641271eef1dc,1,1,1,2,1,2010-05-08 17:40:45,2010-05-08 17:40:45
f5027cc375cf29d8a78679297d9f6bdca9567eb7...5dda723185a9037b7e92828d32430c21838ee216,6,208,104,312,29,2010-05-11 03:24:20,2010-05-11 03:24:20
5dda723185a9037b7e92828d32430c21838ee216...81e99799a8c999d8038dd27bf86bb8ca6a3add11,1,3,3,6,3,2010-05-11 03:30:05,2010-05-11 03:30:05
81e99799a8c999d8038dd27bf86bb8ca6a3add11...271b535c8285cb90781bf1e8ee56d6e68210a6a9,1,5,4,9,5,2010-05-11 03:41:12,2010-05-11 03:41:12
271b535c8285cb90781bf1e8ee56d6e68210a6a9...4b9b9e98300b9554faf0c960674eb75750227404,3,13,4,17,4,2010-05-13 19:03:10,2010-05-13 19:03:10
271b535c8285cb90781bf1e8ee56d6e68210a6a9...d5ba889f63d3ce8abe49c24695f5f5c964b40264,3,39,6,45,7,2010-05-12 22:25:16,2010-05-12 22:25:16
d523ab61d4e5887bba9466a6ce1703befd1663e4...0a288d1db368ae0754482ad06fe2a78ce6a9de85,1,3,2,5,1,2010-05-13 20:39:20,2010-05-13 20:39:20
0a288d1db368ae0754482ad06fe2a78ce6a9de85...22d1464d7abc284dd56d6beaf47e8d85088e01c5,4,171,124,295,27,2010-05-13 20:57:39,2010-05-13 20:57:39
22d1464d7abc284dd56d6beaf47e8d85088e01c5...1bdcf72e456c74256b14f98b26e969b9de637614,2,65,22,87,5,2010-05-13 23:40:41,2010-05-13 23:40:41
1bdcf72e456c74256b14f98b26e969b9de637614...0f73084e9d21cea99f0535e6ca30a1341b7047dc,6,107,22,129,17,2010-05-19 18:51:17,2010-05-19 18:51:17
0f73084e9d21cea99f0535e6ca30a1341b7047dc...f2abbfd394691f87860d5c8dc28c2c1d0310c90f,1,7,13,20,8,2010-05-19 18:54:58,2010-05-19 18:54:58
f2abbfd394691f87860d5c8dc28c2c1d0310c90f...31b35b141f52e6f5d3805d6ca4f2702aee05d61d,2,23,10,33,11,2010-05-19 19:00:44,2010-05-19 19:00:44
31b35b141f52e6f5d3805d6ca4f2702aee05d61d...5215e2095cfd42a0363eb02eded34e03fa2b0cd3,13,284,273,557,35,2010-05-20 22:55:41,2010-05-20 22:55:41
5215e2095cfd42a0363eb02eded34e03fa2b0cd3...e3368e12a6207706d8a08b18f9958db3b86ca4e5,3,55,26,81,15,2010-05-20 23:55:47,2010-05-20 23:55:47
31b35b141f52e6f5d3805d6ca4f2702aee05d61d...80e12276f423a0dcb486b1191857db96a0ba0a93,2,39,3,42,4,2010-05-19 20:24:37,2010-05-19 20:24:20
80e12276f423a0dcb486b1191857db96a0ba0a93...80bd0c273b20b6fde25bb38c7639821cd205f69b,3,4,4,8,4,2010-05-19 23:00:20,2010-05-19 23:00:20
d485421e0e5d6c502e4f62de69d1b4b353f20bbd...f6c67e28c94033edf6a16eb6508de54679cb49db,9,75,24,99,22,2010-05-24 20:54:32,2010-05-24 20:54:32
f6c67e28c94033edf6a16eb6508de54679cb49db...3fab5d9879272b9f991a67c8135754f00c055834,10,67,27,94,18,2010-05-24 22:25:30,2010-05-24 22:25:30
3fab5d9879272b9f991a67c8135754f00c055834...55c0767f16e60e77e9d1b4d46698ddbf343ed8b1,2,52,2,54,4,2010-05-25 00:48:17,2010-05-25 00:48:17
55c0767f16e60e77e9d1b4d46698ddbf343ed8b1...4fec828cf6ce896452945c1dd8aa2db61e2bc746,1,4,1,5,3,2010-05-25 16:52:52,2010-05-25 16:52:52
4fec828cf6ce896452945c1dd8aa2db61e2bc746...2cce1ffc15ae6483da9cf354f7a5d2d26317427e,2,8,2,10,5,2010-05-25 20:05:23,2010-05-25 20:05:23
2cce1ffc15ae6483da9cf354f7a5d2d26317427e...5992e81b2e302c3b3375567e347227f6a9496585,8,93,12,105,20,2010-05-25 21:23:52,2010-05-25 21:23:52
5992e81b2e302c3b3375567e347227f6a9496585...0d41c86522ef912fe5bb7a02fd434080f9827c00,4,8,7,15,9,2010-05-26 22:17:28,2010-05-26 22:17:28
0d41c86522ef912fe5bb7a02fd434080f9827c00...aedf12f25e42877a302a99d906e6397bde01dcce,3,77,27,104,7,2010-05-26 22:21:58,2010-05-26 22:21:58
aedf12f25e42877a302a99d906e6397bde01dcce...177873df86b6b069892184f24518959e7cef33cd,1,3,1,4,1,2010-05-26 23:09:48,2010-05-26 23:09:48
177873df86b6b069892184f24518959e7cef33cd...cb5d21192787985bbff20b369e885639de253345,5,50,39,89,11,2010-05-27 18:26:23,2010-05-27 18:26:23
cb5d21192787985bbff20b369e885639de253345...fe03ea0d1f8814817bee5a35d745db16858eb490,3,29,14,43,4,2010-06-09 19:35:40,2010-06-09 19:35:40
fe03ea0d1f8814817bee5a35d745db16858eb490...f6a405c283ba1f2e0037e0bedb52e5cee618d4ff,2,2,2,4,2,2010-06-09 20:30:54,2010-06-09 20:30:54
f6a405c283ba1f2e0037e0bedb52e5cee618d4ff...85fac4d78c131771d7fdd46d6ccd44bae92419cd,2,52,3,55,7,2010-06-09 21:12:54,2010-06-09 21:12:54
85fac4d78c131771d7fdd46d6ccd44bae92419cd...d0a468153d98c892323cb135b509cb46f67e44fd,1,2,2,4,2,2010-06-09 22:38:56,2010-06-09 22:38:56
cb5d21192787985bbff20b369e885639de253345...fa0702bad1714965c1f236fb195b8a4f7ce7bbc6,2,2,2,4,4,2010-05-28 17:32:03,2010-05-28 17:32:03
fa0702bad1714965c1f236fb195b8a4f7ce7bbc6...0e88e35e5c76420c48a487718558d33e452ea1eb,3,37,4,41,5,2010-05-30 22:45:33,2010-05-30 22:45:33
0e88e35e5c76420c48a487718558d33e452ea1eb...0d87208553af7a9ad6c6c1c73bd3a4105062eafa,4,11,19,30,12,2010-05-30 23:11:00,2010-05-30 23:11:00
0d87208553af7a9ad6c6c1c73bd3a4105062eafa...c7d64f6d124f10c66309042c2d77896215ed43b8,5,14,16,30,7,2010-05-30 23:34:59,2010-05-30 23:34:59
c7d64f6d124f10c66309042c2d77896215ed43b8...ad18fe144263b966f8930edb672e08b9926e00a1,3,14,17,31,8,2010-05-30 23:45:35,2010-05-30 23:45:35
ad18fe144263b966f8930edb672e08b9926e00a1...1aa99c08e9ccd515a333478f00b361f40c622002,1,1,1,2,1,2010-05-30 23:50:28,2010-05-30 23:50:28
1aa99c08e9ccd515a333478f00b361f40c622002...2e33e89a77d115ff17f5841ec328b1c1e4228161,4,60,5,65,6,2010-05-31 02:42:21,2010-05-31 02:42:21
2e33e89a77d115ff17f5841ec328b1c1e4228161...81dac70e72430b7ab9a824ab923038c1e00e7003,2,9,8,17,4,2010-05-31 03:21:40,2010-05-31 03:21:40
81dac70e72430b7ab9a824ab923038c1e00e7003...6143b04384680d17f38c2d5894a9b9961ea33288,3,44,31,75,20,2010-05-31 07:58:29,2010-05-31 07:58:29
6143b04384680d17f38c2d5894a9b9961ea33288...a29c5e4c7fd5e708c28e70e974bf873621d5277c,3,31,44,75,20,2010-06-02 22:04:26,2010-06-02 22:04:26
a29c5e4c7fd5e708c28e70e974bf873621d5277c...39312d1fe3a27b248f98f6f26577fcd7e2c64f85,3,44,31,75,20,2010-06-02 22:05:34,2010-06-02 22:05:34
39312d1fe3a27b248f98f6f26577fcd7e2c64f85...3245209bdb9e656622756220c5bbeb80d3ae2eac,2,31,3,34,4,2010-06-03 00:13:10,2010-06-03 00:13:10
3245209bdb9e656622756220c5bbeb80d3ae2eac...36b58b235eeca4e9580162a697d8a96c41263ebc,2,10,7,17,5,2010-06-03 18:03:11,2010-06-03 18:03:11
bbb45a7eed5264a343c191f3abfbe6f6b5d51139...769b26b79eb26076c218cb5b57179ee98424bbd7,3,22,11,33,7,2010-06-16 17:32:56,2010-06-16 17:32:56
769b26b79eb26076c218cb5b57179ee98424bbd7...b129a1094e6b42ed82c3ccecc2f40daaa0a6cb6a,1,1,1,2,1,2010-06-16 17:36:48,2010-06-16 17:36:48
b129a1094e6b42ed82c3ccecc2f40daaa0a6cb6a...70c3dc81665191cd065a5303e5e26639a0023a73,2,44,4,48,13,2010-06-23 00:15:14,2010-06-23 00:15:14
70c3dc81665191cd065a5303e5e26639a0023a73...42257f22af643fc5e91162cc99adeef32916fd28,3,27,4,31,8,2010-06-23 20:07:31,2010-06-23 20:07:31
42257f22af643fc5e91162cc99adeef32916fd28...fdc0bb232a259faf791b901f583e09bba3213ba5,1,33,4,37,4,2010-06-29 18:15:41,2010-06-29 18:15:41
fdc0bb232a259faf791b901f583e09bba3213ba5...105e9443c4170870dd34f69073a6eafaabeaf567,2,3,2,5,3,2010-07-02 21:43:17,2010-07-02 21:43:17
fdc0bb232a259faf791b901f583e09bba3213ba5...e664186f93838ca1fb1b2e4277f7c18264f81d92,1,57,0,57,1,2010-06-29 22:43:02,2010-06-29 22:43:02
e664186f93838ca1fb1b2e4277f7c18264f81d92...9d8646b0d1bee2ca60bbb7b494b63ab83e243072,5,111,102,213,55,2010-06-30 16:51:54,2010-06-30 16:51:54
105e9443c4170870dd34f69073a6eafaabeaf567...1f0562150921ea2f05149b64ef0440937491def9,25,260,255,515,184,2010-07-02 22:39:57,2010-07-02 22:39:47
1f0562150921ea2f05149b64ef0440937491def9...b5195b8f67b143d6c38de9ae2295cb364fab0d95,2,3,3,6,2,2010-07-03 00:26:26,2010-07-03 00:26:26
b5195b8f67b143d6c38de9ae2295cb364fab0d95...ee82dae3186b7a4fc4d339fc97d5792b2b5e2648,2,11,6,17,4,2010-07-08 17:51:08,2010-07-08 17:40:54
ee82dae3186b7a4fc4d339fc97d5792b2b5e2648...00bb79039251ca6e4622df677fe4894552774bd5,3,4,4,8,3,2010-07-08 22:55:00,2010-07-08 22:55:00
00bb79039251ca6e4622df677fe4894552774bd5...228b54aa2ea9c5faf9280f39317fdf07b2d49580,3,9,4,13,7,2010-07-09 21:45:29,2010-07-09 21:45:29
228b54aa2ea9c5faf9280f39317fdf07b2d49580...87cfc27be331685043ea2a4414eba4fd8fbb4a2c,9,44,44,88,37,2010-07-13 18:20:11,2010-07-13 18:20:11
87cfc27be331685043ea2a4414eba4fd8fbb4a2c...10cd9751ea4c76f5f0ebcd0197054b6ac3be563c,2,11,11,22,7,2010-07-13 22:21:42,2010-07-13 22:21:42
10cd9751ea4c76f5f0ebcd0197054b6ac3be563c...f084fd37dbc80d9701f417a726b4ac3232039d93,1,0,35,35,1,2010-07-13 22:40:39,2010-07-13 22:40:39
