id,files,locs added,locs removed,locs total,hunks,commit time,author time
4b825dc642cb6eb9a060e54bf8d69288fbee4904...a27b4b8cb8e838d03a99b6d2b30f76bdaf2f9e5d,10,1146,0,1146,10,2013-01-19 00:13:39,2013-01-19 00:13:39
a27b4b8cb8e838d03a99b6d2b30f76bdaf2f9e5d...e5323e7c9ab02c64e57396807d5b29b42d1f3904,2,274,0,274,2,2013-01-20 00:07:19,2013-01-20 00:07:19
e5323e7c9ab02c64e57396807d5b29b42d1f3904...3dc240c7eedd8d47d91704cf378d76658856fe79,1,9,1,10,1,2013-01-20 01:41:59,2013-01-20 01:41:59
3dc240c7eedd8d47d91704cf378d76658856fe79...27c7ecb587c64ecf2057189f06b3d5ce365ed6e7,2,63,12,75,13,2013-01-20 01:43:42,2013-01-20 01:43:42
27c7ecb587c64ecf2057189f06b3d5ce365ed6e7...8a28efa65517d1b3602cb48a8b5e47643c4fff1f,1,1,0,1,1,2013-01-20 02:01:51,2013-01-20 02:01:51
8a28efa65517d1b3602cb48a8b5e47643c4fff1f...f90183e957436cbf540599e224616a8286f33803,1,13,1,14,2,2013-01-20 02:23:33,2013-01-20 02:23:33
f90183e957436cbf540599e224616a8286f33803...12599e1c55480f888128b78abb975dbee65b3623,1,11,0,11,2,2013-01-20 02:24:01,2013-01-20 02:24:01
12599e1c55480f888128b78abb975dbee65b3623...8aa2cb7d849546fef0c9a820231b3418621af742,1,25,16,41,1,2013-01-20 08:35:35,2013-01-20 08:35:35
8aa2cb7d849546fef0c9a820231b3418621af742...7012f489898116c3f3768e504abcbf5aed64a1f4,1,28,5,33,2,2013-01-20 08:37:52,2013-01-20 08:37:52
7012f489898116c3f3768e504abcbf5aed64a1f4...bf44a790718a374608a75fd5b76a85b518c5c182,1,155,37,192,20,2013-01-20 08:43:16,2013-01-20 08:43:16
bf44a790718a374608a75fd5b76a85b518c5c182...d62a759106f2aba2f2d74ec864e05b297eb573cc,1,4,6,10,4,2013-01-20 08:44:44,2013-01-20 08:44:44
d62a759106f2aba2f2d74ec864e05b297eb573cc...10ca2206e25d42f6594611fc6c2e0d432ca13c9c,1,8,1,9,2,2013-01-20 08:45:51,2013-01-20 08:45:51
10ca2206e25d42f6594611fc6c2e0d432ca13c9c...95c6443c4329d82b7abec0f9689aad92dafa0bc3,1,2,2,4,2,2013-01-20 08:46:46,2013-01-20 08:46:46
95c6443c4329d82b7abec0f9689aad92dafa0bc3...776705da57efce55c0062fec462700b75432a25a,1,12,6,18,7,2013-01-20 08:47:39,2013-01-20 08:47:39
776705da57efce55c0062fec462700b75432a25a...417e72b0dd07dc5c9829e4fd0f8e1d72261b1a10,1,1,1,2,1,2013-01-20 08:48:23,2013-01-20 08:48:23
417e72b0dd07dc5c9829e4fd0f8e1d72261b1a10...f154ebf744e974c356c833a95d3c79d5785eb393,1,3,4,7,4,2013-01-20 08:58:18,2013-01-20 08:58:18
f154ebf744e974c356c833a95d3c79d5785eb393...bf465935055d3fe94e68456366a81e9964b244dc,1,56,14,70,11,2013-01-20 22:13:25,2013-01-20 22:13:25
bf465935055d3fe94e68456366a81e9964b244dc...4c5eb22cb281359c7e2e70d773173121c8c9b47b,1,6,1,7,2,2013-01-20 23:54:21,2013-01-20 23:54:21
4c5eb22cb281359c7e2e70d773173121c8c9b47b...6d8420898c5863afac432926c53e70fed48e7cd9,2,233,0,233,5,2013-01-20 23:55:00,2013-01-20 23:55:00
6d8420898c5863afac432926c53e70fed48e7cd9...bdb66012a830e06103d0ed6913c38bbc69a09bca,1,73,9,82,9,2013-01-21 06:21:26,2013-01-21 06:21:26
bdb66012a830e06103d0ed6913c38bbc69a09bca...63081c6cc865a90cc13354c4d95c877c1c0489f2,1,13,4,17,1,2013-01-21 06:21:59,2013-01-21 06:21:59
63081c6cc865a90cc13354c4d95c877c1c0489f2...e74d0b2a569496ef47075ea80c0ca61501dc8da2,1,9,1,10,3,2013-01-21 06:22:51,2013-01-21 06:22:51
e74d0b2a569496ef47075ea80c0ca61501dc8da2...be3563cebb953b75d301b63988589987e4f9e6d9,1,2,1,3,2,2013-01-21 06:23:11,2013-01-21 06:23:11
be3563cebb953b75d301b63988589987e4f9e6d9...559e3200fa716b35ac87b401c982a0ec00b78fbc,1,73,19,92,12,2013-01-22 02:12:56,2013-01-22 02:12:56
be3563cebb953b75d301b63988589987e4f9e6d9...24dac22892cc3c8f34e90222f64b87d750b5025e,2,67,14,81,12,2013-01-22 02:03:23,2013-01-22 02:03:23
24dac22892cc3c8f34e90222f64b87d750b5025e...13cd4650fdc636862bee73e6de5374205f3e6dd1,1,0,0,0,0,2013-01-22 02:06:31,2013-01-22 02:06:31
72c0a091c0c1bd377ad11f547e0652a953d32184...aa31e7764dd6db063df281930248b641a83894d0,1,31,2,33,6,2013-01-22 02:31:12,2013-01-22 02:31:12
aa31e7764dd6db063df281930248b641a83894d0...3b69ff64411fabcbe07639821e45cab70866b1ad,1,65,32,97,10,2013-01-22 17:54:56,2013-01-22 17:54:56
13cd4650fdc636862bee73e6de5374205f3e6dd1...78c02daf474d798eea2da94286b30171d8deb98f,4,25,25,50,20,2013-01-22 02:39:52,2013-01-22 02:39:52
78c02daf474d798eea2da94286b30171d8deb98f...8e9bb02ce530839dcd35db0c21ff219360485a34,1,16,20,36,11,2013-01-22 19:13:22,2013-01-22 19:13:22
3b69ff64411fabcbe07639821e45cab70866b1ad...1a77a32a839070e60f187478ce2da382c98d19bf,1,138,208,346,55,2013-01-23 02:29:44,2013-01-23 02:29:44
005db1982d4e7548ef4fc4521f342b2e3f2701df...e035f3e92b07c7ce601ec2a7a71150e76b1eccfd,2,82,8,90,10,2013-01-22 20:12:16,2013-01-22 20:12:16
e035f3e92b07c7ce601ec2a7a71150e76b1eccfd...64fc86fba760dd5cb34cd6d9f3ddf13dc3dc4280,1,3,0,3,3,2013-01-22 23:03:27,2013-01-22 23:03:27
64fc86fba760dd5cb34cd6d9f3ddf13dc3dc4280...f0c08b57abb6e273b54b3f6d253acfe7b0107972,1,13,2,15,5,2013-01-22 23:03:40,2013-01-22 23:03:40
f0c08b57abb6e273b54b3f6d253acfe7b0107972...f958bdba8a7c1c62f2f6e3e7bc2ddf1599029ecf,2,75,15,90,8,2013-01-23 01:30:09,2013-01-23 01:30:09
f958bdba8a7c1c62f2f6e3e7bc2ddf1599029ecf...73d7265429261029b7e6345821e9efe4ec37b10a,1,3,3,6,1,2013-01-23 01:30:37,2013-01-23 01:30:37
98f090ead89f30ab9f5b8568e4343479325526a9...553ca56d7ed6f5808c97356b9bd4f6a5a3d20477,3,282,55,337,29,2013-01-24 07:14:46,2013-01-24 07:14:46
73d7265429261029b7e6345821e9efe4ec37b10a...06d8f7ce63d54d117a8245ccdbd84cfc90dfdd6b,1,8,13,21,5,2013-01-24 01:18:07,2013-01-24 01:18:07
553ca56d7ed6f5808c97356b9bd4f6a5a3d20477...f3ffba7afef9d5caf5eca47e23eda0a2974dd04d,7,343,254,597,44,2013-01-25 04:01:32,2013-01-25 04:01:32
4fc390ee39b5cafdb90376edcb5f718534afdf5f...09502e4faa76fddf6245db3c3281e9a70beda076,2,197,4,201,7,2013-01-25 19:05:11,2013-01-25 19:05:11
f3ffba7afef9d5caf5eca47e23eda0a2974dd04d...401dd3d8e02f720e5e3b2a0f337a57af41fa29c4,3,34,34,68,16,2013-01-25 19:23:18,2013-01-25 19:23:18
401dd3d8e02f720e5e3b2a0f337a57af41fa29c4...75529a202f65e7df5395e0eca7d58aaa7718489c,1,19,8,27,4,2013-01-25 19:26:18,2013-01-25 19:26:18
75529a202f65e7df5395e0eca7d58aaa7718489c...63fc3e5ab38893e1359f218a855908a4c0303ace,1,2,2,4,2,2013-01-25 19:27:47,2013-01-25 19:27:47
63fc3e5ab38893e1359f218a855908a4c0303ace...c885a05bdf337864f50443ae6dc5795ce55533ca,2,169,9,178,9,2013-01-25 19:32:37,2013-01-25 19:32:37
c885a05bdf337864f50443ae6dc5795ce55533ca...851812f1c657598007a35e1bb1dfc7047b91bd09,1,4,3,7,4,2013-01-25 19:33:18,2013-01-25 19:33:18
9b300272df3faed12033c5c55b75cc05c9bbb3f3...2193b0c954e2fc9ce92fefa4e3b5a6c82ae98a3f,3,34,2,36,4,2013-01-25 22:09:21,2013-01-25 22:09:21
1df9819b257e2947c99c88973cc4cb7917b5ff62...f4e25694c15583ed6ed290aff0c29116f7ed361e,1,12,30,42,7,2013-01-25 23:36:47,2013-01-25 23:36:47
1df9819b257e2947c99c88973cc4cb7917b5ff62...11b65a00c66422a11d114260057384c59f5be4e2,1,44,0,44,1,2013-01-25 22:39:02,2013-01-25 22:39:02
11b65a00c66422a11d114260057384c59f5be4e2...b397ce5dea4c0a34c73bc6d18fbcb76fa7c92ef0,2,220,184,404,55,2013-01-25 22:44:16,2013-01-25 22:44:16
f4e25694c15583ed6ed290aff0c29116f7ed361e...6513a1d94ed25a5f99b1e3d1670781f7597f9d35,2,28,8,36,7,2013-01-26 00:20:34,2013-01-26 00:20:34
6513a1d94ed25a5f99b1e3d1670781f7597f9d35...d8bc912238dfa75dff0902b9d97133e200807bea,1,20,0,20,5,2013-01-28 19:51:41,2013-01-28 19:51:41
d8bc912238dfa75dff0902b9d97133e200807bea...a2d7dd1a1908fc3dc6ac5648b5ea12eaecb19b1b,1,86,0,86,3,2013-01-28 19:51:51,2013-01-28 19:51:51
a2d7dd1a1908fc3dc6ac5648b5ea12eaecb19b1b...174f25909c525015cb84f1b82376091a1ac9c118,1,35,10,45,7,2013-01-28 19:58:47,2013-01-28 19:53:58
174f25909c525015cb84f1b82376091a1ac9c118...fb40a7880494afffe384ac955f5f4e3a4971c676,2,8,2,10,4,2013-01-28 20:00:20,2013-01-28 19:58:59
dbc7fb757541260b75ef5a77176b77bb3fd99944...5d6dd22fb2d689f98cadba6b7317658331307f3e,5,143,117,260,35,2013-01-26 23:56:42,2013-01-26 23:56:42
5d6dd22fb2d689f98cadba6b7317658331307f3e...b6fb5bb21b73c90ae1833e32867781824f66ffb7,1,6,0,6,2,2013-01-27 08:49:09,2013-01-27 08:49:09
b6fb5bb21b73c90ae1833e32867781824f66ffb7...37035363031db161732b5757485bec37ef429fb2,3,48,2,50,6,2013-01-27 08:59:49,2013-01-27 08:59:49
37035363031db161732b5757485bec37ef429fb2...e920cb9cd921053ebbc82ddccc35908d1def88bd,1,9,9,18,10,2013-01-27 09:04:33,2013-01-27 09:04:33
e920cb9cd921053ebbc82ddccc35908d1def88bd...fc19a00103f25e4d3bd1102803b32bea299d3fd6,1,1,1,2,1,2013-01-27 09:06:02,2013-01-27 09:06:02
fc19a00103f25e4d3bd1102803b32bea299d3fd6...55a7560436d380405c807b187e67a2cd3eaf5e51,1,1,1,2,1,2013-01-27 09:07:21,2013-01-27 09:07:21
55a7560436d380405c807b187e67a2cd3eaf5e51...6df37208be269540a6f291448491bf5de9f46c96,2,169,0,169,6,2013-01-27 09:08:34,2013-01-27 09:08:34
2cb444248db185a7d332434d53605e289962af0c...d802a31be538d7c90d3f33474595dfdb77b7e50e,1,0,4,4,1,2013-01-28 20:11:30,2013-01-28 20:11:30
6df37208be269540a6f291448491bf5de9f46c96...904b0ab52b065025acbdba6fdc056ef1dff04d44,5,573,260,833,87,2013-01-27 23:42:42,2013-01-27 23:42:42
904b0ab52b065025acbdba6fdc056ef1dff04d44...54532e2ab709a25943a9d0b470ecf5c155deee5f,1,1,0,1,1,2013-01-27 23:43:08,2013-01-27 23:43:08
192446e796f8bace607c82c2f5c43ed5826bf3a9...333abbf85a8db9578e34c340032e32de3c8fefe8,4,20,22,42,19,2013-01-28 22:30:05,2013-01-28 22:30:05
333abbf85a8db9578e34c340032e32de3c8fefe8...54a946e333077f59c8e6eb0663ab3e138a9e8320,1,3,0,3,1,2013-01-29 01:32:15,2013-01-29 01:32:15
333abbf85a8db9578e34c340032e32de3c8fefe8...08ac1d0b3543b9ab98b2cbeaea6bb9512d6a14b5,3,14,4,18,3,2013-01-29 01:06:46,2013-01-29 01:06:46
08ac1d0b3543b9ab98b2cbeaea6bb9512d6a14b5...c914aaf43e9eea2e67f42fc93667a40c36b6cd35,1,2,0,2,1,2013-01-29 01:07:38,2013-01-29 01:07:38
9906a9af8f2f66dfd630c219936e0a27b9754e56...7a50153c321ff96c16947b3bab9b8e385f2f2a5e,2,165,11,176,20,2013-01-29 01:50:12,2013-01-29 01:50:12
7a50153c321ff96c16947b3bab9b8e385f2f2a5e...c283ff667550d6e86a7bcc16259c796f4261be6e,1,2,2,4,1,2013-01-29 02:37:54,2013-01-29 02:37:54
c283ff667550d6e86a7bcc16259c796f4261be6e...903f091adc3878f9e08874dd4b748ae10853cbd3,1,7,4,11,5,2013-01-29 07:13:58,2013-01-29 07:13:58
903f091adc3878f9e08874dd4b748ae10853cbd3...2dadcf9b81f27113564260e668d5b734d7a9c63c,2,4,1,5,2,2013-01-29 07:15:02,2013-01-29 07:15:02
2dadcf9b81f27113564260e668d5b734d7a9c63c...d8a4910eee1f62dc8182c77d5caba9650494941d,1,1,22,23,4,2013-01-29 07:16:41,2013-01-29 07:16:41
d8a4910eee1f62dc8182c77d5caba9650494941d...49da84d7c4babd597dfbcba168a81a4434c28bf1,1,0,3,3,1,2013-01-29 07:17:47,2013-01-29 07:17:47
49da84d7c4babd597dfbcba168a81a4434c28bf1...1b898574cf8d814c453755d83065b22c211f6a29,1,18,13,31,3,2013-01-29 07:22:45,2013-01-29 07:22:45
1b898574cf8d814c453755d83065b22c211f6a29...d93070b2077dc805eee6c26340a371f4999447de,1,8,0,8,1,2013-01-29 07:34:17,2013-01-29 07:34:17
d93070b2077dc805eee6c26340a371f4999447de...279917e353fa888e5afd0904df80a225d462f30d,1,2,2,4,2,2013-01-29 11:14:16,2013-01-29 11:14:16
279917e353fa888e5afd0904df80a225d462f30d...bcfe2aa2a7834eb49790f400192422350ba32cdb,3,16,4,20,7,2013-01-29 11:18:07,2013-01-29 11:18:07
bcfe2aa2a7834eb49790f400192422350ba32cdb...4f3362b85a856f7ec5de0559f10386a8615cad60,1,10,3,13,7,2013-01-29 11:21:23,2013-01-29 11:21:23
4f3362b85a856f7ec5de0559f10386a8615cad60...c7a944caf28d85bd26f4031465e958006a764ac2,4,34,23,57,14,2013-01-29 11:24:31,2013-01-29 11:24:31
c7a944caf28d85bd26f4031465e958006a764ac2...dfd15fbee87cc954d85884b1ce99ffacf7721a74,1,1,1,2,1,2013-01-29 11:25:00,2013-01-29 11:25:00
dfd15fbee87cc954d85884b1ce99ffacf7721a74...f8f9285ccaeb35a2d5909a03f48f9d3b9d34aca2,3,50,31,81,15,2013-01-29 20:15:39,2013-01-29 20:15:39
f8f9285ccaeb35a2d5909a03f48f9d3b9d34aca2...8c142c612737f45fb97d9ad949b1c3bd42d38c71,1,2,2,4,2,2013-01-29 23:24:39,2013-01-29 23:24:39
f8f9285ccaeb35a2d5909a03f48f9d3b9d34aca2...94b1cf4be3606ff731b3ca012e5eddf021f4608f,2,7,9,16,7,2013-01-29 21:50:27,2013-01-29 21:50:27
0d9db395393c63dda9b33bdda8308d874a9eadb8...35f5cc239bea6931cf92459236a827762e040023,1,1,1,2,1,2013-01-29 23:30:32,2013-01-29 23:30:32
35f5cc239bea6931cf92459236a827762e040023...d5be77075a6e3dbc8ea167d4c5ab60663b0dbe68,1,3,2,5,2,2013-01-29 23:37:54,2013-01-29 23:37:54
d5be77075a6e3dbc8ea167d4c5ab60663b0dbe68...29410f43a0e576f3c7fe27456af2888cb8f9bc5f,1,14,4,18,2,2013-01-29 23:51:04,2013-01-29 23:51:04
94b1cf4be3606ff731b3ca012e5eddf021f4608f...ca40989e456cf81f26215059530b328d3be8c71c,1,72,3,75,3,2013-01-29 23:16:45,2013-01-29 23:16:45
ca40989e456cf81f26215059530b328d3be8c71c...caea45dd72835926a615ecb36a256172c19f2a36,1,71,58,129,5,2013-01-29 23:51:21,2013-01-29 23:17:20
5a3fe231a24cb75f9faf6b42434fa7ffd35a3f4e...bba4e368077cbc73db2a12c259c5fc2330dffe75,1,6,5,11,3,2013-01-30 00:51:03,2013-01-30 00:51:03
bba4e368077cbc73db2a12c259c5fc2330dffe75...cc3fece3f871a9bf51e9a802b98dfb2820db3c46,1,36,0,36,1,2013-02-01 02:58:05,2013-02-01 02:58:05
cc3fece3f871a9bf51e9a802b98dfb2820db3c46...81459a5afc0a6b103c2076481451f56b5b94210e,1,4,5,9,2,2013-02-01 03:01:18,2013-02-01 03:01:18
81459a5afc0a6b103c2076481451f56b5b94210e...de1c361a6eea95c867c43619fc1e7a7b8a147750,2,45,0,45,2,2013-02-01 08:08:45,2013-02-01 08:08:45
de1c361a6eea95c867c43619fc1e7a7b8a147750...0db56e6c519b19ec16c6fbd12e3cee7dfa6018c5,1,43,0,43,1,2013-02-01 20:57:02,2013-02-01 20:57:02
0db56e6c519b19ec16c6fbd12e3cee7dfa6018c5...63ce08107e0b2c5a880e0aa0af99191fdb89c37c,1,2,0,2,1,2013-02-01 21:00:41,2013-02-01 21:00:41
63ce08107e0b2c5a880e0aa0af99191fdb89c37c...edc996860496f63b8e4eb786890e8ba2bab7e875,1,5,0,5,2,2013-02-05 07:25:28,2013-02-05 07:25:28
edc996860496f63b8e4eb786890e8ba2bab7e875...a608f5e3b8455f21dee94a1e358daed420b5e3b7,1,9,0,9,2,2013-02-05 07:37:25,2013-02-05 07:37:25
63ce08107e0b2c5a880e0aa0af99191fdb89c37c...814bb505ca5c713941d710566d85294962605317,5,266,0,266,5,2013-02-04 06:02:41,2013-02-04 06:02:41
814bb505ca5c713941d710566d85294962605317...738ed60407f52b97d43d8bff31c305f5684abcdc,1,1,1,2,1,2013-02-04 06:04:07,2013-02-04 06:04:07
738ed60407f52b97d43d8bff31c305f5684abcdc...581a1f0edb9f69cf4a614a2164a78ec3347f2ab5,1,2,1,3,1,2013-02-04 06:04:38,2013-02-04 06:04:38
581a1f0edb9f69cf4a614a2164a78ec3347f2ab5...4355675d0c26b483f40295c0f335b528586adb96,1,1,2,3,2,2013-02-05 00:30:20,2013-02-05 00:30:20
a608f5e3b8455f21dee94a1e358daed420b5e3b7...2416edd4002f9c142c19126b93f89e45aabf8d63,1,9,8,17,3,2013-02-13 21:56:19,2013-02-13 21:56:19
2416edd4002f9c142c19126b93f89e45aabf8d63...e6adfa2bc68db8f1f1ccd9facea6fa8f8bed4a33,1,15,0,15,3,2013-02-13 21:58:28,2013-02-13 21:58:28
e6adfa2bc68db8f1f1ccd9facea6fa8f8bed4a33...0d4600626919ec072289c003051f6323db3ffb5f,1,37,44,81,30,2013-02-13 22:00:36,2013-02-13 22:00:36
0d4600626919ec072289c003051f6323db3ffb5f...58a22942602f9035a1ed44c65ae2c501420600a3,5,53,0,53,8,2013-02-13 22:01:44,2013-02-13 22:01:44
db6ba2b908ec5d25f381c14b30cc01816be45a7f...5926cfd0ec244f4d5013326ecfa2b9958ca9db88,1,54,54,108,34,2013-02-11 19:17:25,2013-02-11 19:17:25
5926cfd0ec244f4d5013326ecfa2b9958ca9db88...bded592a15403e92feb06dcbbed41eb385cabb84,1,19,0,19,2,2013-02-11 19:39:28,2013-02-11 19:39:28
bded592a15403e92feb06dcbbed41eb385cabb84...f330c2a2488b6c26973f0b0fb8da5115588b7f72,3,20,12,32,8,2013-02-12 16:37:12,2013-02-12 16:37:12
f330c2a2488b6c26973f0b0fb8da5115588b7f72...abb7b81b130ce9ddbb93a962b4ed84af6654e226,2,10,0,10,2,2013-02-12 16:42:15,2013-02-12 16:42:15
abb7b81b130ce9ddbb93a962b4ed84af6654e226...d0b6f7ef3bebc4dac8f93b3782f58af2e1a94407,1,88,1,89,6,2013-02-12 16:48:30,2013-02-12 16:48:30
d0b6f7ef3bebc4dac8f93b3782f58af2e1a94407...178e126a07d275105c5cf433bab165cdd8c66cff,1,4,1,5,2,2013-02-12 17:10:47,2013-02-12 17:10:47
178e126a07d275105c5cf433bab165cdd8c66cff...a6b7254a4e362fc6cc28088ba03f3d6cf497b9d5,1,1,1,2,1,2013-02-12 17:12:27,2013-02-12 17:12:27
a6b7254a4e362fc6cc28088ba03f3d6cf497b9d5...f20deac47f35520ace5ad1c1aadbd3f8c34ad571,2,2,1,3,2,2013-02-13 01:25:41,2013-02-13 01:25:41
f20deac47f35520ace5ad1c1aadbd3f8c34ad571...059837c92a6692feb5a6aad879e01e6380f82dca,3,47,8,55,8,2013-02-13 06:23:14,2013-02-13 06:23:14
059837c92a6692feb5a6aad879e01e6380f82dca...45c30b8eda828a65f509e774e93d54ec1af969a7,1,3,3,6,3,2013-02-13 06:24:15,2013-02-13 06:24:15
45c30b8eda828a65f509e774e93d54ec1af969a7...3cfac8f335df1902ecdc58d78041ec632b8701fb,1,17,2,19,3,2013-02-13 06:24:55,2013-02-13 06:24:55
ec21a2d364573fd65086e607d23178e7d6091a9b...6de3e8a22dfa736f88c0477392474d73f7bed3c5,4,174,14,188,15,2013-02-14 01:24:35,2013-02-14 01:24:35
3cfac8f335df1902ecdc58d78041ec632b8701fb...5e2cec7b4de5b797e3af3a981a4c40c92c1aeb09,1,103,12,115,9,2013-02-13 22:58:32,2013-02-13 22:58:32
cb6014d6fdfc0770523ea05ee257f00c3758874a...2f84bab8797329955e42c3089388c540d8009f04,1,40,47,87,31,2013-02-14 01:28:13,2013-02-14 01:28:13
2f84bab8797329955e42c3089388c540d8009f04...24ee1524815140b2299a1d98d4690d903a4abeb7,1,24,0,24,1,2013-02-14 01:40:10,2013-02-14 01:40:10
24ee1524815140b2299a1d98d4690d903a4abeb7...51c11868b0374d2551023ed38a2e929e2ae2717a,1,2,2,4,3,2013-02-14 01:40:57,2013-02-14 01:40:57
51c11868b0374d2551023ed38a2e929e2ae2717a...e871eadab16563b4e64ef229c5aeb3cff5b37026,1,4,3,7,4,2013-02-14 01:41:50,2013-02-14 01:41:50
e871eadab16563b4e64ef229c5aeb3cff5b37026...1793538a68c8fc2c7c85848d375f12f94c9012e5,1,9,9,18,4,2013-02-14 02:14:46,2013-02-14 02:14:46
1793538a68c8fc2c7c85848d375f12f94c9012e5...f2c2d953a871e847cc49b16573f4b1cdc483c4ab,1,34,0,34,1,2013-02-14 02:17:42,2013-02-14 02:17:42
f2c2d953a871e847cc49b16573f4b1cdc483c4ab...0da9ccc18e9c30347f394e4cc1231b4b6edca69e,2,54,0,54,2,2013-02-14 03:05:57,2013-02-14 03:05:57
2d5a1abf79e219547ef9caf502fdb6b86f93046c...0ea4f3cc765077559cd42f38dc24e71dfb330c29,1,8,8,16,7,2013-02-13 23:07:15,2013-02-13 23:07:15
0ea4f3cc765077559cd42f38dc24e71dfb330c29...23e55d27555c07584fcd737d3f9a7fbb8c71eabf,1,3,3,6,3,2013-02-13 23:10:39,2013-02-13 23:10:39
23e55d27555c07584fcd737d3f9a7fbb8c71eabf...ffc8d1e7b97bd9fce380f310e18dcd1402c7c9ac,1,2,0,2,1,2013-02-14 00:38:50,2013-02-14 00:38:50
ffc8d1e7b97bd9fce380f310e18dcd1402c7c9ac...e1b25e9b084a2375640b811a27b75b89d57666d9,10,1139,1100,2239,24,2013-02-14 01:10:00,2013-02-14 01:10:00
0da9ccc18e9c30347f394e4cc1231b4b6edca69e...dd84ba348532b5c50a6c46573803952ac662bc67,3,55,29,84,34,2013-02-14 23:37:45,2013-02-14 23:37:45
0da9ccc18e9c30347f394e4cc1231b4b6edca69e...d2885910bda77538eb31b86b10a3dd85ee2abadf,2,50,0,50,3,2013-02-14 21:49:05,2013-02-14 21:49:05
9155d1dd6d452755e07330a04fb3bc7c7af6671d...ac36c986e008e8e4e4f56fe510ba7ab0dab0c778,1,5,5,10,5,2013-02-15 20:17:58,2013-02-15 20:17:58
ac36c986e008e8e4e4f56fe510ba7ab0dab0c778...994ec4c8c399538102d47850fc50c7a481d49595,1,6,21,27,3,2013-02-15 20:18:36,2013-02-15 20:18:36
994ec4c8c399538102d47850fc50c7a481d49595...c696eb8d125528207522d1bbd06082aae9a8d494,1,2,2,4,1,2013-02-15 20:19:50,2013-02-15 20:19:50
c696eb8d125528207522d1bbd06082aae9a8d494...a7e9582a53663453d0885b1a0217941ad1fe595f,3,206,8,214,3,2013-02-18 17:56:20,2013-02-18 17:56:20
d2885910bda77538eb31b86b10a3dd85ee2abadf...902d660d2ff48727386718440162ed2a8399eaf0,2,373,0,373,2,2013-02-16 02:46:46,2013-02-16 02:46:46
902d660d2ff48727386718440162ed2a8399eaf0...07b6bc3fc738ab3a27e9760b0efc57c78d7f98af,1,2,8,10,1,2013-02-16 05:48:04,2013-02-16 05:48:04
07b6bc3fc738ab3a27e9760b0efc57c78d7f98af...aab32e1012bd6061ec1049adc2bbe60ed1918f54,1,1,0,1,1,2013-02-16 05:50:59,2013-02-16 05:50:59
aab32e1012bd6061ec1049adc2bbe60ed1918f54...1531848ca6ead7c46497a625feba1224825e9011,2,76,0,76,3,2013-02-16 05:51:36,2013-02-16 05:51:36
1531848ca6ead7c46497a625feba1224825e9011...6372a1a0d0b6506f25db7ba3dbba1e65fd6deb2d,3,103,7,110,12,2013-02-18 23:25:43,2013-02-18 23:25:43
a7e9582a53663453d0885b1a0217941ad1fe595f...5e2f0639c64dc8a7ee5da81e0801bc4a17787407,2,4,1,5,2,2013-02-19 21:03:58,2013-02-19 21:03:58
5e2f0639c64dc8a7ee5da81e0801bc4a17787407...dd9bb4e0d388788781af0c36dfca0d3792f07d6c,1,0,2,2,2,2013-02-19 21:04:19,2013-02-19 21:04:19
dd9bb4e0d388788781af0c36dfca0d3792f07d6c...004272e6f54c16e16f71ceddff44ae4d423da7c0,1,0,1,1,1,2013-02-19 21:07:25,2013-02-19 21:07:25
f3e06a784f01a6c2fc5917ee5ec8a20a2b1c59c6...48974cc28d72598f0a35a4a6483b7006a1c18f9f,1,1,1,2,1,2013-02-19 05:09:25,2013-02-19 05:09:25
48974cc28d72598f0a35a4a6483b7006a1c18f9f...8002af43fb54254ef786e4478ada7824e726baf7,3,95,15,110,20,2013-02-19 05:10:19,2013-02-19 05:10:19
8002af43fb54254ef786e4478ada7824e726baf7...04bcdf9030123a0d59a930e072429664a0e11194,2,0,0,0,0,2013-02-22 07:01:13,2013-02-22 07:01:13
04bcdf9030123a0d59a930e072429664a0e11194...b4ea31e1deb44dc28c75aaaf24ff99c87c7f595a,4,197,54,251,33,2013-02-22 07:01:30,2013-02-22 07:01:30
b4ea31e1deb44dc28c75aaaf24ff99c87c7f595a...8b61af189597579f1086a42fcdc824bfe737dce7,2,15,0,15,2,2013-02-22 07:07:10,2013-02-22 07:07:10
8b61af189597579f1086a42fcdc824bfe737dce7...2ebf3464a1ed5bf32e33eff45cfa8e8394b5cd43,11,143,515,658,69,2013-02-27 01:45:46,2013-02-27 01:45:46
004272e6f54c16e16f71ceddff44ae4d423da7c0...f0183fa0690caf804301b8acbd0ac527a33d1cbd,1,2,0,2,1,2013-02-20 03:55:26,2013-02-20 03:55:26
004272e6f54c16e16f71ceddff44ae4d423da7c0...7e5dfc51ade66d75c1429a05334b500d1cb8db20,1,2,0,2,1,2013-02-20 03:49:06,2013-02-20 03:49:06
ffbb9c8e4a1b7c98bbb602a8428376e4a41214d3...93ba6dd82bb62dbb9cac729cfa6626c469a87d00,5,297,144,441,38,2013-03-08 18:48:22,2013-03-08 18:48:22
302567df1da9bc9352d7518bac30c1c9525d8ff4...3a59336f82e73150059c93398f283b8e15fdb4e9,1,4,2,6,2,2013-02-20 12:19:22,2013-02-20 12:19:22
3a59336f82e73150059c93398f283b8e15fdb4e9...e8d48641de6c5e866dc18708e2e260b7578c1d50,1,3,3,6,2,2013-02-20 12:23:47,2013-02-20 12:23:47
e8d48641de6c5e866dc18708e2e260b7578c1d50...db4c75f3c1cdbc654595bb3dda5455a93c1b56b4,1,1,1,2,1,2013-02-20 22:45:43,2013-02-20 22:45:43
93ba6dd82bb62dbb9cac729cfa6626c469a87d00...c59fff422fdc61c1c994b44fd83e4173a2f0530a,21,283,313,596,117,2013-03-10 03:44:09,2013-03-10 03:44:09
c59fff422fdc61c1c994b44fd83e4173a2f0530a...4474cd5677751ee5acac0525953eea583f797a1b,3,14,7,21,8,2013-03-10 03:49:09,2013-03-10 03:49:09
4474cd5677751ee5acac0525953eea583f797a1b...b5b2f005eb679d0224db407ad1e9320be361640a,1,2,4,6,4,2013-03-10 03:56:33,2013-03-10 03:56:33
b5b2f005eb679d0224db407ad1e9320be361640a...dd0227b700503e03fce0e9e9ea3539c438e9c0cb,1,0,342,342,1,2013-03-10 04:17:31,2013-03-10 04:17:31
db4c75f3c1cdbc654595bb3dda5455a93c1b56b4...dd96b6fccbe539f78c6957bacbbfaa3f048fdea1,1,9,7,16,6,2013-02-22 00:33:58,2013-02-22 00:33:58
db4c75f3c1cdbc654595bb3dda5455a93c1b56b4...b9b66d0e1b70cd0475d6fbba33eba5632f852dde,1,14,0,14,3,2013-02-21 18:47:57,2013-02-21 01:45:46
b9b66d0e1b70cd0475d6fbba33eba5632f852dde...5cecd548cd48cec8967f7ad0b0b42b30fa3ec7a0,3,49,7,56,8,2013-02-21 18:47:57,2013-02-21 01:47:09
5cecd548cd48cec8967f7ad0b0b42b30fa3ec7a0...5039d4a2804561885e32f2a93cb2a51cbaa8e847,1,35,4,39,5,2013-02-21 18:47:57,2013-02-21 02:20:18
5039d4a2804561885e32f2a93cb2a51cbaa8e847...6124c5eb31ab8f9db4db288002388554d6181c86,1,6,3,9,3,2013-02-21 18:47:57,2013-02-21 03:18:01
6124c5eb31ab8f9db4db288002388554d6181c86...e0e49b9a2259d779b31055339e67b054c8dffc3b,1,62,5,67,4,2013-02-22 02:33:23,2013-02-22 02:33:23
e0e49b9a2259d779b31055339e67b054c8dffc3b...149badc22b45acb171c3e583f6e820a06e4ced87,1,101,0,101,1,2013-02-22 02:34:35,2013-02-22 02:34:35
149badc22b45acb171c3e583f6e820a06e4ced87...797bb6e75b8f33fe44932bf90145cf069f342e44,2,90,0,90,3,2013-02-25 18:45:23,2013-02-25 18:45:23
797bb6e75b8f33fe44932bf90145cf069f342e44...c08f5b2b8460f13f2094bae2a496bf308f7645bb,5,110,78,188,41,2013-02-25 22:06:22,2013-02-25 22:06:22
2441edf1a39ad75708292bcc2726184b16fb89b2...5d6199b9251261216cb096cd919e3cc5eb3efdd6,4,6,7,13,7,2013-03-11 14:39:06,2013-03-11 14:39:06
dd96b6fccbe539f78c6957bacbbfaa3f048fdea1...f437f5b8b4a706d56f9a7cfba1dbc6b21e9a33f3,10,190,90,280,24,2013-02-22 20:28:25,2013-02-22 20:28:25
5d6199b9251261216cb096cd919e3cc5eb3efdd6...63dd8f101816c1253ac8d05e10f4f8a4c80f296a,3,95,84,179,11,2013-03-12 11:24:26,2013-03-12 11:24:26
5d6199b9251261216cb096cd919e3cc5eb3efdd6...687d6f25eeb8f4bc505dc9c6c0d9ea305c824e2d,8,13,13,26,8,2013-03-11 09:59:52,2013-03-11 09:59:52
687d6f25eeb8f4bc505dc9c6c0d9ea305c824e2d...2548722dae1be15c61ee8db1a5eaa1d04ba7fcef,1,3,1,4,3,2013-03-12 00:05:01,2013-03-12 00:05:01
2548722dae1be15c61ee8db1a5eaa1d04ba7fcef...132ecb24822072c82718d47ac23da62a8ea774fc,1,33,45,78,8,2013-03-12 04:04:16,2013-03-12 04:04:16
f437f5b8b4a706d56f9a7cfba1dbc6b21e9a33f3...ac15003c05a844aa08e591ff7675ff6a406f188b,1,1,0,1,1,2013-02-23 20:59:06,2013-02-23 20:59:06
8158616d6133bbe71ad33b4a2be06664e038b8d0...de50c9c4e8d0276890cfb521e5b57da58cf470aa,2,21,1,22,2,2013-03-12 12:57:19,2013-03-12 12:57:19
132ecb24822072c82718d47ac23da62a8ea774fc...e0b09d4933a289da01508039995bd627ff1392df,7,28,5,33,25,2013-03-12 07:08:41,2013-03-12 07:08:41
e0b09d4933a289da01508039995bd627ff1392df...18f4e7e196eb894765094c1291e1a1f6599f4266,6,11,11,22,6,2013-03-12 12:17:51,2013-03-12 12:17:51
18f4e7e196eb894765094c1291e1a1f6599f4266...2664668388bd2b1d7012b863d4f8d426fda17daf,1,4,2,6,3,2013-03-12 12:23:13,2013-03-12 12:23:13
2664668388bd2b1d7012b863d4f8d426fda17daf...f2dc079c05c073d63b10a3c2a2bc784d1e94e82c,1,56,15,71,9,2013-03-12 12:35:47,2013-03-12 12:35:47
f2dc079c05c073d63b10a3c2a2bc784d1e94e82c...45a8bba15e95b789c12a371036aa1ad42357dc08,5,10,10,20,9,2013-03-12 12:36:37,2013-03-12 12:36:37
deb74ef674b332ade9e384985fb3a57a4d93577b...2c7a2cbaf4f3b47786eee3726de61b67182a8d44,1,34,0,34,1,2013-02-25 20:27:29,2013-02-25 20:27:29
2c7a2cbaf4f3b47786eee3726de61b67182a8d44...edf2e20e284a6a3bb28e178745d2069d63261235,1,1,1,2,1,2013-02-25 20:27:51,2013-02-25 20:27:51
edf2e20e284a6a3bb28e178745d2069d63261235...6d1054619d6d254ea3df0484cacb3c6778d58cd9,1,48,0,48,1,2013-02-26 17:46:29,2013-02-26 17:46:29
6d1054619d6d254ea3df0484cacb3c6778d58cd9...8fa07c0e060a25141204533a2a3823d1cb0fdf63,1,73,0,73,1,2013-02-26 18:03:06,2013-02-26 18:03:06
c7f4602b184ec2cab594dfeaf73bed09aa39a749...799ffa176399877e610ff2049dbf84610037a2be,2,232,52,284,33,2013-02-28 19:50:02,2013-02-28 19:50:02
799ffa176399877e610ff2049dbf84610037a2be...09eacdfadec36f79cec74f037484b10ddfae6791,2,49,36,85,15,2013-02-28 19:51:14,2013-02-28 19:51:14
09eacdfadec36f79cec74f037484b10ddfae6791...bd2f51290f4c34daec08474c0bd78952030be6ff,1,11,11,22,5,2013-02-28 19:52:07,2013-02-28 19:52:07
bd2f51290f4c34daec08474c0bd78952030be6ff...f857fa0dddbf48b959b0876582027ebc46dc5e9e,1,37,18,55,8,2013-02-28 19:52:22,2013-02-28 19:52:22
d24ce7dfd15b049560f5d06d57c2b7e2c6a5d61a...6908628b555a1583f079f04ed34f5d81ce917459,1,1,0,1,1,2013-03-12 15:06:22,2013-03-12 15:06:22
8fa07c0e060a25141204533a2a3823d1cb0fdf63...ebaa50c4c96a1ba69e480fab5612b5d6a97da145,2,25,1,26,4,2013-02-26 19:43:54,2013-02-26 19:43:54
ebaa50c4c96a1ba69e480fab5612b5d6a97da145...4004e86fa9ca87332c8f5fa0acbe29af86e06908,1,1,1,2,1,2013-02-26 22:47:20,2013-02-26 22:47:20
4004e86fa9ca87332c8f5fa0acbe29af86e06908...aa12da6f5076738955b30470639d439a0cbe40f9,12,154,170,324,73,2013-02-27 01:26:46,2013-02-27 01:26:46
aa12da6f5076738955b30470639d439a0cbe40f9...003ec21d360b08d50b61834795692542fff295e2,3,27,4,31,6,2013-02-27 01:28:24,2013-02-27 01:28:24
003ec21d360b08d50b61834795692542fff295e2...278aa5f045ad6dd8718933b4736c29567a17717a,1,2,2,4,1,2013-02-27 01:29:11,2013-02-27 01:29:11
f62344b75053fbfaf66246c2cb3e20577e317ce4...2192d3371ceb7431a6dacd170ddadd4ef26d5783,1,1,1,2,1,2013-02-28 19:57:57,2013-02-28 19:57:57
2192d3371ceb7431a6dacd170ddadd4ef26d5783...5675439b9100b40529b8eb87447231a2f5a01ad2,1,15,15,30,2,2013-03-01 00:30:31,2013-03-01 00:30:31
150a4fe7e5aaa5d733130e22eac09cb36ffadd82...d2cba75d5f1e8ceea7f301ef146c571806252fa0,2,2,91,93,6,2013-03-12 22:05:41,2013-03-12 22:05:41
150a4fe7e5aaa5d733130e22eac09cb36ffadd82...d91d0da45310a4ab8d6124b70a1f541352149bdc,1,18,4,22,5,2013-03-12 15:59:32,2013-03-12 15:59:32
278aa5f045ad6dd8718933b4736c29567a17717a...ed85cb6508854f6d12d43e8a88a8c728bc633c3c,1,1,1,2,1,2013-02-27 02:17:51,2013-02-27 02:17:51
76b66f73b3404aa5764ee2936033cefa886a0aae...53e2e8209fd882a3b4f073ce30dec444cc9c7cc0,1,2,1,3,1,2013-03-12 05:41:21,2013-03-12 02:03:22
53e2e8209fd882a3b4f073ce30dec444cc9c7cc0...af2aac8736d71fe79492f9abf3a16fba97857eb4,1,4,14,18,3,2013-03-12 06:07:16,2013-03-12 06:07:16
af2aac8736d71fe79492f9abf3a16fba97857eb4...fda456b82e51224fe4e7ae6c0bc2b0f0812729ac,1,2,2,4,1,2013-03-12 06:08:21,2013-03-12 06:08:21
fda456b82e51224fe4e7ae6c0bc2b0f0812729ac...c1fa4efad66a1ae8cbccd7c55bc195be03d94b2f,1,28,2,30,1,2013-03-12 06:20:28,2013-03-12 06:09:19
c1fa4efad66a1ae8cbccd7c55bc195be03d94b2f...f90f6a0b9248489c43188ca79b9e0dfc306fd8dc,1,2,2,4,2,2013-03-12 06:38:11,2013-03-12 06:13:08
f90f6a0b9248489c43188ca79b9e0dfc306fd8dc...b728c1a81fbb441442d635788e814d47436c613f,1,6,2,8,2,2013-03-12 06:40:21,2013-03-12 06:37:38
76b66f73b3404aa5764ee2936033cefa886a0aae...d372dacbc9f4caf9743fe6c67c84c1e273faa663,1,10,14,24,4,2013-03-02 01:21:26,2013-03-02 01:21:26
d372dacbc9f4caf9743fe6c67c84c1e273faa663...9f3b1a8ee05852fe41ddfba2b4765656d3e54805,1,1,1,2,1,2013-03-05 23:58:27,2013-03-05 23:58:27
9f3b1a8ee05852fe41ddfba2b4765656d3e54805...711e29fb9b56e9583f9a2730d4d5db21e9cd2105,1,88,85,173,3,2013-03-06 00:00:17,2013-03-06 00:00:17
711e29fb9b56e9583f9a2730d4d5db21e9cd2105...74c88fdbc0180c276f75322066e7da2e3cd38f6d,2,38,4,42,5,2013-03-06 06:39:43,2013-03-06 06:39:43
86854ffbc5423597d11932eb904cb6fe7dedcac9...745edc49cdcf0dc02fe714b0772f146fc8a66d23,9,92,94,186,13,2013-03-13 07:29:40,2013-03-13 07:29:40
745edc49cdcf0dc02fe714b0772f146fc8a66d23...baf6988d872be24130fc2923bef227f5365cbf1b,1,21,21,42,11,2013-03-13 18:46:09,2013-03-13 18:46:09
baf6988d872be24130fc2923bef227f5365cbf1b...d614e91b62339d1960cf171c2436404bb1fa8806,1,61,1,62,2,2013-03-13 18:58:15,2013-03-13 18:58:15
d614e91b62339d1960cf171c2436404bb1fa8806...8d5f683dc47795f6797eb14b498149c612398bd2,1,6,0,6,6,2013-03-13 19:00:13,2013-03-13 19:00:13
d91d0da45310a4ab8d6124b70a1f541352149bdc...c017c7baa41e6f9ce03c18228e1a950cf5bdba3a,1,23,0,23,1,2013-03-13 00:30:20,2013-03-13 00:25:11
d91d0da45310a4ab8d6124b70a1f541352149bdc...453d49573c91a1c49ffbc54d040145804e38d91e,13,18,20,38,24,2013-03-12 18:59:27,2013-03-12 18:59:27
74c88fdbc0180c276f75322066e7da2e3cd38f6d...791592731eccfae0072b20a80d15ec31e34dc88f,1,0,1,1,1,2013-03-06 08:37:00,2013-03-06 08:37:00
791592731eccfae0072b20a80d15ec31e34dc88f...410ebe379dbf60d8fd75ba695e4e8036fdba6b65,1,25,0,25,2,2013-03-06 08:39:03,2013-03-06 08:39:03
74c88fdbc0180c276f75322066e7da2e3cd38f6d...836e7b2881b9257ecb31fc3bbd696af84e17730d,1,0,81,81,1,2013-03-06 06:44:09,2013-03-06 06:44:09
89245360e89d725f7c7487dc8cf35836a12eabb8...f5f26a510f15d96a320b668e10516bc068905b11,2,18,3,21,3,2013-03-13 20:23:59,2013-03-13 20:23:59
3a6c2e48f90f685afceb3e885b39d5ee6ac694c3...e614690f0753853b5d8440dfdd415d581a92d263,1,1,1,2,1,2013-03-13 23:06:57,2013-03-13 23:06:57
070bc0bb6d316a2a023161a19cba667831a26698...d54ff35f022e5e11c5ca124237a1888c4a6161b9,1,1,1,2,1,2013-03-13 18:27:06,2013-03-13 18:27:06
070bc0bb6d316a2a023161a19cba667831a26698...c3622a963d326df8da8049302e0f2ea4875fc496,2,48,28,76,2,2013-03-13 18:14:37,2013-03-13 18:14:37
070bc0bb6d316a2a023161a19cba667831a26698...7cc512c7c065fe52125fe7d6f045d0248d16de80,1,42,13,55,15,2013-03-13 08:17:03,2013-03-13 08:17:03
007c57deba0d2ceb1fe6bcf90fd7621e79855651...2df0bc6bc0df53c7657404a92fb8f256b7109de0,1,42,13,55,10,2013-03-07 00:08:44,2013-03-07 00:08:44
2df0bc6bc0df53c7657404a92fb8f256b7109de0...fb350e0c7705850cc78e1dc1dc63b56aca06c3cc,2,58,0,58,4,2013-03-07 17:25:41,2013-03-07 17:25:41
f3d826447d511209746fc901e30ce0d906712598...ce20fbfff64e682f5ddbe4c3e02995f1eaa2be71,1,4,1,5,2,2013-03-13 20:48:00,2013-03-13 20:48:00
77272bea9c7326e53c625ea22b3676e44abfe271...804abddec155dedc42e99ad746f1cf1fdbfe0fed,1,2,0,2,1,2013-03-13 20:03:29,2013-03-13 20:03:29
e614690f0753853b5d8440dfdd415d581a92d263...3686feacccab68f130a0cf0bda2e800b9731d213,1,5,1,6,2,2013-03-14 01:37:47,2013-03-14 01:37:47
3686feacccab68f130a0cf0bda2e800b9731d213...06553a756b564ac31acd6a2f6116344cae27b032,1,7,5,12,3,2013-03-14 01:48:50,2013-03-14 01:48:50
e614690f0753853b5d8440dfdd415d581a92d263...d6c3d02205742e8772e1a6027ee35c4783c32e05,1,5,5,10,4,2013-03-14 01:37:00,2013-03-14 01:37:00
d6c3d02205742e8772e1a6027ee35c4783c32e05...c78cbbd002c0c69bb7be6bcf791348b776b17975,1,2,3,5,2,2013-03-14 01:37:53,2013-03-14 01:37:53
e614690f0753853b5d8440dfdd415d581a92d263...09d96656a05e7fe7f1056c23e9b9973f8972810a,10,303,19,322,14,2013-03-14 00:08:04,2013-03-14 00:08:04
09d96656a05e7fe7f1056c23e9b9973f8972810a...78ef1ba32f30b7a42fafeb6637fbaffdfe7a05e6,1,38,13,51,9,2013-03-14 04:11:05,2013-03-14 04:11:05
78ef1ba32f30b7a42fafeb6637fbaffdfe7a05e6...0b5e223b4e7d38a6511424d24c8cc12ec9c021de,12,16,1,17,5,2013-03-14 04:22:30,2013-03-14 04:22:30
41e0c74fd08afb5007320b60b9fe94958dc16155...895e145e615b407aa485189a8021fd8640700163,1,0,1,1,1,2013-03-13 18:28:52,2013-03-13 18:28:52
46dce5918aad5134305d6f1eb6357c822a59bbed...b2de17bf2cfdf90f347109452bcb8763138cff46,1,1,0,1,1,2013-03-12 19:12:40,2013-03-12 19:12:40
fb350e0c7705850cc78e1dc1dc63b56aca06c3cc...f6d64738d05d62596d94a5567916e3b3b5209b2c,1,13,2,15,5,2013-03-12 02:58:39,2013-03-12 02:58:39
f6d64738d05d62596d94a5567916e3b3b5209b2c...63edf8a4a1830a939432e369dd075ebade0e03a9,1,3,5,8,2,2013-03-12 03:18:34,2013-03-12 03:18:34
63edf8a4a1830a939432e369dd075ebade0e03a9...b8219b5275f5bbb049e97a1459b87d194878aebc,2,14,2,16,5,2013-03-12 04:31:49,2013-03-12 04:31:49
b8219b5275f5bbb049e97a1459b87d194878aebc...8e0986caec91f61e0496e1990a4bec745a9596fc,2,9,2,11,4,2013-03-12 05:49:57,2013-03-12 05:49:57
8e0986caec91f61e0496e1990a4bec745a9596fc...49554f47f60568c3df942f274ab45d92f451fbcc,1,20,0,20,3,2013-03-12 20:50:11,2013-03-12 20:50:11
49554f47f60568c3df942f274ab45d92f451fbcc...1bfd827701d80a40e65509d45abaa61cd5c748ec,2,41,18,59,11,2013-03-12 22:08:10,2013-03-12 22:08:10
1bfd827701d80a40e65509d45abaa61cd5c748ec...2feefb43758e2477b70044e73ed0d800453fe8de,1,4,1,5,1,2013-03-12 22:13:21,2013-03-12 22:13:21
2feefb43758e2477b70044e73ed0d800453fe8de...b5c1cd7991b3b7ea81665b06ad1dd4cb1c8d8b0f,2,18,14,32,7,2013-03-12 23:02:50,2013-03-12 23:02:50
b5c1cd7991b3b7ea81665b06ad1dd4cb1c8d8b0f...b0265e0a38a71fdbebf3b6ef53120249d399e293,1,0,20,20,2,2013-03-12 23:06:07,2013-03-12 23:06:07
fb350e0c7705850cc78e1dc1dc63b56aca06c3cc...43875a73a0c2ee51f8bcd36634bbf64d836df6f8,1,2,1,3,1,2013-03-12 00:47:28,2013-03-12 00:47:28
43875a73a0c2ee51f8bcd36634bbf64d836df6f8...d4da0a0ddbb3ec1979941bc3d2425aab3a6b3f19,1,12,5,17,6,2013-03-12 00:48:39,2013-03-12 00:48:39
fb350e0c7705850cc78e1dc1dc63b56aca06c3cc...06d420d2ead65cb5af760d7946d8844f568f4d65,1,5,3,8,4,2013-03-11 22:08:22,2013-03-11 22:08:22
06d420d2ead65cb5af760d7946d8844f568f4d65...a7cb3cb86a39f950a517b61e3a674e0cd080804f,1,0,11,11,11,2013-03-11 22:29:13,2013-03-11 22:29:13
a7cb3cb86a39f950a517b61e3a674e0cd080804f...52b811f50a0906904d688e5fae8f32e1ada90f1a,1,36,18,54,6,2013-03-11 23:11:46,2013-03-11 23:11:46
fb350e0c7705850cc78e1dc1dc63b56aca06c3cc...a3a946703ba93e7d937680897ed89eb99c52acef,1,1,0,1,1,2013-03-11 21:30:27,2013-03-11 21:28:11
a3a946703ba93e7d937680897ed89eb99c52acef...75d04a5a7561cabba0aaf2875ef4479381096f91,2,18,2,20,4,2013-03-12 00:40:54,2013-03-12 00:40:54
75d04a5a7561cabba0aaf2875ef4479381096f91...4e5ae883722ad814ef19e3f9d333f6218db752a5,4,67,19,86,23,2013-03-12 02:15:29,2013-03-12 02:15:29
4e5ae883722ad814ef19e3f9d333f6218db752a5...948961831ab6cfb0c94e1e80552f4438d1f434a7,3,26,26,52,12,2013-03-12 02:25:02,2013-03-12 02:25:02
948961831ab6cfb0c94e1e80552f4438d1f434a7...3684b67572605de492abba041695bd80ef42bcb5,1,13,3,16,4,2013-03-12 02:51:24,2013-03-12 02:51:24
3684b67572605de492abba041695bd80ef42bcb5...f8fee421819e3c272e1c20890da7c90b4da971ad,1,2,2,4,1,2013-03-12 02:55:14,2013-03-12 02:55:14
c78cbbd002c0c69bb7be6bcf791348b776b17975...be20f3c518cb1587a2c731a1d6d91bdedcbf1dc9,3,198,0,198,5,2013-03-15 00:43:59,2013-03-15 00:43:59
be20f3c518cb1587a2c731a1d6d91bdedcbf1dc9...5e79c4394a51300cde3fbbc39e2a40e10d512e66,1,3,3,6,3,2013-03-15 00:53:10,2013-03-15 00:53:10
c78cbbd002c0c69bb7be6bcf791348b776b17975...a216712f3c7bab6709fea60b003128079edd1d39,1,1,1,2,1,2013-03-14 02:09:19,2013-03-14 02:09:19
895e145e615b407aa485189a8021fd8640700163...d479efc01ead3da7b57c85a493f957e46c5fa0d1,3,29,2,31,3,2013-03-13 20:30:13,2013-03-13 20:30:13
d479efc01ead3da7b57c85a493f957e46c5fa0d1...fde01381d57d322a6112edfce7df21f13047290e,1,8,6,14,3,2013-03-13 20:31:23,2013-03-13 20:31:23
fde01381d57d322a6112edfce7df21f13047290e...f0a65207aba9bf52e169a7ed783fbd946d5a82c0,2,51,22,73,12,2013-03-13 20:35:34,2013-03-13 20:35:34
f0ef0e393bd24cfe9de7cd08aacd7cda45703e6a...e20a74d2477ea3feb7a9734c15b645d081dbebdf,1,8,1,9,3,2013-03-13 00:34:15,2013-03-13 00:34:15
d4da0a0ddbb3ec1979941bc3d2425aab3a6b3f19...94baf2c5b9b2eb49b554d933f9997da072905d88,2,12,3,15,4,2013-03-12 19:05:04,2013-03-12 19:05:04
68e173ad5095f6a67af7c27d2ad7d5cc535b4062...1b34630b8c84d50bd859ff8aea435ab26c5d7de6,1,2,23,25,3,2013-03-13 21:20:07,2013-03-13 21:20:07
1b34630b8c84d50bd859ff8aea435ab26c5d7de6...0f952a7dbb53c3c0f39d4762a340e12a30ac86de,3,0,174,174,3,2013-03-13 22:36:22,2013-03-13 22:36:22
a1712ea6d351b8ee95f78d61749144d073a99d30...a444327ab6c9b568e87ae9b3d4a1b0a0d050f5e2,1,1,1,2,1,2013-03-14 04:50:15,2013-03-14 04:50:15
18519f12ae15bee72126bc974ab41f3fb480655d...f1cf5074f568c4b853d6ac91c358babdbb12a544,1,13,9,22,5,2013-03-15 01:43:02,2013-03-15 01:43:02
f1cf5074f568c4b853d6ac91c358babdbb12a544...9b94d89b066d23d6fbadc10eebd52584e93309e4,1,4,4,8,5,2013-03-15 02:43:42,2013-03-15 02:43:42
9b94d89b066d23d6fbadc10eebd52584e93309e4...d94a5b7d05a66c6856d719fbdd8770f7b154503b,1,3,1,4,1,2013-03-15 03:21:03,2013-03-15 03:21:03
d94a5b7d05a66c6856d719fbdd8770f7b154503b...7ec6a311f81289dac6305d5c91be37a97b2499a5,1,3,3,6,3,2013-03-15 03:23:45,2013-03-15 03:23:45
7ec6a311f81289dac6305d5c91be37a97b2499a5...878ae25980c21b6678fa30ba09b426e7710e1b14,1,8,0,8,2,2013-03-15 14:49:27,2013-03-15 14:49:27
878ae25980c21b6678fa30ba09b426e7710e1b14...0a35db8fd061247b1db20fde92237f02a4e6882c,1,14,4,18,4,2013-03-15 21:41:55,2013-03-15 21:41:55
0a35db8fd061247b1db20fde92237f02a4e6882c...27ad71e025538b903a3eac8ac1e4eea654346b4d,1,1,0,1,1,2013-03-15 21:48:42,2013-03-15 21:48:42
27ad71e025538b903a3eac8ac1e4eea654346b4d...c4640689affc84c5a975059c5fca27a8b22bd1d0,1,1,1,2,1,2013-03-15 22:04:36,2013-03-15 22:04:36
a216712f3c7bab6709fea60b003128079edd1d39...e81d7132faf0e9e9e12b24733e1bdc452eb81525,1,2,2,4,2,2013-03-14 03:29:56,2013-03-14 03:26:50
a216712f3c7bab6709fea60b003128079edd1d39...c74408d7b8e70c67e411bc21a31b98cbf5480a47,2,44,0,44,2,2013-03-14 03:16:42,2013-03-14 03:16:42
a216712f3c7bab6709fea60b003128079edd1d39...71c997dc83d67bad9bdb45b3f4766c5bcc720511,2,44,0,44,2,2013-03-14 03:13:00,2013-03-14 03:13:00
71c997dc83d67bad9bdb45b3f4766c5bcc720511...acd51ecea8f5d3c02b00a08176171c59442df8b3,1,220,0,220,1,2013-03-20 03:35:14,2013-03-20 03:35:14
681e45283262306f0d20aaee780b7f902bf13c5b...cc18df61b9f23ff82e2e24e32690711b378c0118,1,1,1,2,1,2013-03-14 05:12:24,2013-03-14 05:12:24
cc18df61b9f23ff82e2e24e32690711b378c0118...b97f9e814814892bdd20d0d03b93af1ac2f09cf1,1,0,221,221,1,2013-03-14 05:13:38,2013-03-14 05:13:38
b55e461122693a000ce2e06ae5623c7acc607c4a...da47420af67aa4faab95f3f7e5de8378905ec429,1,0,1,1,1,2013-03-16 18:39:49,2013-03-16 18:39:49
a3174fd87454e3c2c66433505e3bc4c9f468fbdb...6d580247c27da7cddcc6a582b846b1e8bd5bc0d6,5,52,92,144,22,2013-03-20 14:49:38,2013-03-20 14:49:38
b97f9e814814892bdd20d0d03b93af1ac2f09cf1...fcc0af9f5b2751b2a7a281e9f691575df74ac05d,1,3,4,7,1,2013-03-14 11:06:57,2013-03-14 11:06:57
b97f9e814814892bdd20d0d03b93af1ac2f09cf1...e5e66716df901bcc40106497532b9c3bff0bb931,2,9,11,20,11,2013-03-14 09:43:16,2013-03-14 09:26:46
e5e66716df901bcc40106497532b9c3bff0bb931...de753d5a90282bec8dbefac1e5922fe6368a39f7,1,48,26,74,11,2013-03-14 09:43:16,2013-03-14 09:30:50
da47420af67aa4faab95f3f7e5de8378905ec429...e190c27d10034d4c4ee286839351876bb4ec8dc2,1,1,1,2,1,2013-03-16 19:19:58,2013-03-16 19:19:58
6d580247c27da7cddcc6a582b846b1e8bd5bc0d6...2048354c8b72feb35eaa53dcc29e78a111e69cfb,1,2,2,4,2,2013-03-20 20:17:46,2013-03-20 20:17:46
c65c1738b59cfe287a581c5cd7ab6e3dc116dfea...9ff6dd767a5849754c6e812ffba08f0d4ce3a38e,1,1,1,2,1,2013-03-15 09:37:02,2013-03-15 09:37:02
c65c1738b59cfe287a581c5cd7ab6e3dc116dfea...3b9c97a5d598a04da8247939e2a7f6f123350366,10,303,19,322,14,2013-03-15 06:13:31,2013-03-14 00:08:04
3b9c97a5d598a04da8247939e2a7f6f123350366...d615496c4caeea1b438ccd1e15c23c8fd7efa425,1,38,13,51,9,2013-03-15 06:13:31,2013-03-14 04:11:05
d615496c4caeea1b438ccd1e15c23c8fd7efa425...9598b289339b7e99bb8b86810f1bd69b812dc608,12,16,1,17,5,2013-03-15 06:13:31,2013-03-14 04:22:30
9598b289339b7e99bb8b86810f1bd69b812dc608...76bd475648bdcbd0b1ac4bb4e60763394dc7a52a,2,3,9,12,3,2013-03-15 06:13:31,2013-03-14 11:01:22
76bd475648bdcbd0b1ac4bb4e60763394dc7a52a...47a5a51d396552d140cbf27a13b7813719f1980b,5,11,10,21,10,2013-03-15 06:13:31,2013-03-15 02:44:32
47a5a51d396552d140cbf27a13b7813719f1980b...eab39dc3fa563476981a4221af40cd281cdf97f0,1,30,2,32,3,2013-03-15 06:13:31,2013-03-15 04:13:33
eab39dc3fa563476981a4221af40cd281cdf97f0...0e0d76b7acc8d75f518a91d026a57d6b8410d5f3,1,27,27,54,4,2013-03-15 06:13:31,2013-03-15 05:48:45
c65c1738b59cfe287a581c5cd7ab6e3dc116dfea...8c83484bf26c54273bdaf080ebaf0428b04ec003,3,110,22,132,15,2013-03-15 04:22:07,2013-03-15 04:22:07
8c83484bf26c54273bdaf080ebaf0428b04ec003...98a4d38eb4a478280b2fbc7aa01c795b814b0138,1,1,1,2,1,2013-03-15 04:26:59,2013-03-15 04:26:59
98a4d38eb4a478280b2fbc7aa01c795b814b0138...7cc0a07524cdc80a146a8f9ea74cfb59b1f6c414,1,1,1,2,1,2013-03-15 04:29:10,2013-03-15 04:29:10
c65c1738b59cfe287a581c5cd7ab6e3dc116dfea...3cd34f1039bc6de584e94f7ca74e0d9581f6a042,2,35,14,49,7,2013-03-14 16:27:06,2013-03-14 16:27:06
3cd34f1039bc6de584e94f7ca74e0d9581f6a042...c0b9afbf0109b25d8bd6159a1b9fbb00a0de42d6,2,138,0,138,4,2013-03-15 01:07:33,2013-03-15 01:07:33
c0b9afbf0109b25d8bd6159a1b9fbb00a0de42d6...cb7819cbc509a78d627584d18a65a4557875b516,1,1,1,2,1,2013-03-15 07:47:02,2013-03-15 07:47:02
cb7819cbc509a78d627584d18a65a4557875b516...4d80958b016b8055c166393cb5e0e69f7a30441e,1,2,0,2,1,2013-03-15 08:28:09,2013-03-15 08:28:09
4d80958b016b8055c166393cb5e0e69f7a30441e...82188b9c2cdbdb097e8ffb52e5604a116150c970,2,79,59,138,2,2013-03-15 09:01:48,2013-03-15 09:01:48
82188b9c2cdbdb097e8ffb52e5604a116150c970...2839a590187be2c7ac56f6582bcd897a2a2f1efb,1,7,0,7,2,2013-03-15 09:03:41,2013-03-15 09:03:41
2839a590187be2c7ac56f6582bcd897a2a2f1efb...030a33aa23ddeb3046fea50d889dd04933276294,2,98,8,106,9,2013-03-15 09:22:50,2013-03-15 09:22:50
030a33aa23ddeb3046fea50d889dd04933276294...137af244ee561bd350797c8ce6e159fbd46b6a02,1,38,3,41,2,2013-03-15 09:33:37,2013-03-15 09:33:37
137af244ee561bd350797c8ce6e159fbd46b6a02...b2cf5041cd9a491b40b0a15c152655264f854d6b,2,6,6,12,7,2013-03-15 10:58:43,2013-03-15 10:58:43
b400d78b19ee81752680fe0d5d41596bf527b110...16f132b156f7d6827fbd0b43364661f0dea7497a,1,1,1,2,1,2013-03-16 20:16:13,2013-03-16 20:16:13
33d2905cde5fe0745c5aef36e8ee52d35f04ae4b...fac32cda5af7adcf0400f1fd8763764a498149f3,1,1,1,2,1,2013-03-21 03:11:16,2013-03-21 03:11:16
fac32cda5af7adcf0400f1fd8763764a498149f3...ab99e9252d1d3872b2e04234338ce028b9eb091c,1,1,1,2,1,2013-03-20 13:02:25,2013-03-20 13:02:25
98542d44979495d69c98befc44e3ac0135193a66...31296cc3f72cd98cbab8c33b2b1d3ea2d46be725,1,0,96,96,6,2013-03-21 03:21:59,2013-03-21 03:21:59
31296cc3f72cd98cbab8c33b2b1d3ea2d46be725...c8db980add4cdc9546a7e38dba264f6862662f15,1,8,0,8,1,2013-03-21 05:12:38,2013-03-21 05:12:38
c8db980add4cdc9546a7e38dba264f6862662f15...9e8278134d73ffa0a4e72c2202aa1e5c2bcffc98,1,7,0,7,1,2013-03-21 05:13:28,2013-03-21 05:13:28
9e8278134d73ffa0a4e72c2202aa1e5c2bcffc98...240333277afb733af353e21dd3066c547da05b8a,1,4,21,25,3,2013-03-21 05:13:57,2013-03-21 05:13:57
240333277afb733af353e21dd3066c547da05b8a...ea258c44926e8a8d7a49cedd90922d29185df573,6,0,1356,1356,6,2013-03-21 05:15:09,2013-03-21 05:15:09
ea258c44926e8a8d7a49cedd90922d29185df573...6f6eaca861fec53a6d21d420b813041dc93e8b93,2,0,14,14,2,2013-03-21 05:16:02,2013-03-21 05:16:02
6f6eaca861fec53a6d21d420b813041dc93e8b93...75c866d6a3aa92d5d2a4e6948fff00f90b36e872,2,50,2,52,3,2013-03-21 05:41:03,2013-03-21 05:41:03
75c866d6a3aa92d5d2a4e6948fff00f90b36e872...4d9c324495babc175db278fdbe39d291eaf25726,1,0,1,1,1,2013-03-21 05:41:31,2013-03-21 05:41:31
4d9c324495babc175db278fdbe39d291eaf25726...3eff62394bf11f579552114ce6157675acbd6d25,1,25,6,31,7,2013-03-21 05:42:08,2013-03-21 05:42:08
3eff62394bf11f579552114ce6157675acbd6d25...9d82bab041370cd26e78fe85ee5435c8b2429b59,1,1,1,2,1,2013-03-21 05:42:50,2013-03-21 05:42:50
9d82bab041370cd26e78fe85ee5435c8b2429b59...34023558f5a37e441e39f003cdc4ad6736f38c5a,1,0,94,94,7,2013-03-21 05:48:52,2013-03-21 05:48:52
34023558f5a37e441e39f003cdc4ad6736f38c5a...89a140fb75b328b3c2869464a5d9880082966b55,1,0,134,134,1,2013-03-21 07:21:03,2013-03-21 07:21:03
89a140fb75b328b3c2869464a5d9880082966b55...84e8c4aa1df8f6f53d1c688a0e2bfc5b4d46adef,1,1,0,1,1,2013-03-21 07:21:32,2013-03-21 07:21:32
84e8c4aa1df8f6f53d1c688a0e2bfc5b4d46adef...7c57a4cfc086b4af68ed9ec7c1b03b934db61f0c,7,362,429,791,149,2013-03-21 07:25:00,2013-03-21 07:25:00
7c57a4cfc086b4af68ed9ec7c1b03b934db61f0c...b8547f31e4ba5d4381c572e7efa4bea3ccb80515,5,229,229,458,192,2013-03-21 07:41:15,2013-03-21 07:41:15
b8547f31e4ba5d4381c572e7efa4bea3ccb80515...299d0b2720ad5efee89c11b47d6de51094714164,4,30,27,57,8,2013-03-21 07:52:43,2013-03-21 07:52:43
299d0b2720ad5efee89c11b47d6de51094714164...d7c5d060c4b3c4a38a843e92f832bbf97483d16b,3,53,53,106,8,2013-03-21 07:54:54,2013-03-21 07:54:54
d7c5d060c4b3c4a38a843e92f832bbf97483d16b...0208b6accddd4f8c8ccfb380dd281ac208fe19d1,4,22,32,54,11,2013-03-21 08:07:07,2013-03-21 08:07:07
0208b6accddd4f8c8ccfb380dd281ac208fe19d1...deb603aaf41d6885e4b51c7ca06acfa940ad2a41,1,1,27,28,2,2013-03-21 08:10:44,2013-03-21 08:10:44
deb603aaf41d6885e4b51c7ca06acfa940ad2a41...623e91e2e3f3d0b408a43606df8d3c037a6b03be,4,15,18,33,9,2013-03-21 08:13:55,2013-03-21 08:13:55
623e91e2e3f3d0b408a43606df8d3c037a6b03be...e627a0da1ee3013d9f4b74e96636699401e5d720,1,4,7,11,4,2013-03-21 08:23:00,2013-03-21 08:23:00
e627a0da1ee3013d9f4b74e96636699401e5d720...2f781f21288d9e579cf18fcf08a0750ce7b0ac38,1,0,4,4,2,2013-03-21 08:24:12,2013-03-21 08:24:12
2f781f21288d9e579cf18fcf08a0750ce7b0ac38...377cebe36f4e4fc1cf927313df4a9c1cb6dc49cf,2,0,0,0,0,2013-03-21 08:24:54,2013-03-21 08:24:54
9ff6dd767a5849754c6e812ffba08f0d4ce3a38e...54b44e3705046a27402536ce9f9ab70d71cd403d,1,3,3,6,3,2013-03-15 10:07:33,2013-03-15 10:07:33
4015f8dd34ebf860560e94ec78930a1319bc128f...4a1c40364c9c93d1168a159fefad1566f31e02cd,1,0,10,10,1,2013-03-17 01:35:43,2013-03-17 01:35:43
4a1c40364c9c93d1168a159fefad1566f31e02cd...a030c1bd2465b636bb08e85d4f9911f44076612f,1,0,73,73,1,2013-03-17 01:36:52,2013-03-17 01:36:52
1ed13f65fe7aeca9e7b869c3efaa655774a02e4b...d65983f386e4a355c404e8b68a85ab301c37a59c,2,1,3,4,3,2013-03-21 08:43:03,2013-03-21 08:43:03
3f63e3426e900559e85f7517f1c72f745121cce7...3bb176d8ae7f43ab0d1ca8e03b59f2f137f07530,1,1,1,2,1,2013-03-21 05:53:42,2013-03-21 05:53:42
a030c1bd2465b636bb08e85d4f9911f44076612f...065eca9d4e4dd145b070786e4b497512bd659b58,1,3,3,6,2,2013-03-18 02:09:51,2013-03-18 02:09:51
065eca9d4e4dd145b070786e4b497512bd659b58...ac7fa37be3ac073f3ecb6df835c32c6dcbe53805,1,32,31,63,2,2013-03-18 02:10:47,2013-03-18 02:10:47
ac7fa37be3ac073f3ecb6df835c32c6dcbe53805...1480bff3a9149eb34b64e4f2d7d3a727298c640b,1,45,0,45,1,2013-03-18 02:32:06,2013-03-18 02:32:06
a030c1bd2465b636bb08e85d4f9911f44076612f...a3ca3e921802b1979c14174c352320e45b3251e6,1,2,3,5,2,2013-03-17 18:53:37,2013-03-17 18:53:37
a3ca3e921802b1979c14174c352320e45b3251e6...bb9ce6b2872b62b444306c53d0fa26d389d9a9d9,1,1,1,2,1,2013-03-17 18:54:05,2013-03-17 18:54:05
bb9ce6b2872b62b444306c53d0fa26d389d9a9d9...6316b995564f1ffcd614402489ed4b929ac26f74,1,1,1,2,1,2013-03-17 18:59:59,2013-03-17 18:59:59
3e9877a30fdc3ad7139ee0e8f01d74034b69dd56...f7837599283ff89493d4fcfb7d9a046a7f9dc13b,1,5,0,5,3,2013-03-21 09:04:10,2013-03-21 09:04:10
1480bff3a9149eb34b64e4f2d7d3a727298c640b...33c2f07fc7b2d132e1f7cd30a37717ed15c086bd,1,1,1,2,1,2013-03-18 07:35:48,2013-03-18 07:35:48
1480bff3a9149eb34b64e4f2d7d3a727298c640b...33f6a0aaf58734f39af564123ca2c0056a3f1bd4,8,643,4,647,9,2013-03-18 07:15:35,2013-03-18 07:15:35
33f6a0aaf58734f39af564123ca2c0056a3f1bd4...3c1db4ca43ecd741c50e884c2ea3aac43e3191e1,1,48,0,48,1,2013-03-19 00:57:18,2013-03-19 00:57:18
c5051ea0ea506e375a85f66ad5bd0666deabfcc6...8be58d3a7f6020fe34281dbe27375005e248f0f5,1,1,1,2,1,2013-03-19 23:03:17,2013-03-19 23:03:17
b6b5e5cec1fc58550286a7242db4a91bb43c05aa...680f40c37e0d7f2fc924a51bc40c0bfc37f60b9e,1,100,0,100,1,2013-03-21 19:18:47,2013-03-21 19:18:47
f7837599283ff89493d4fcfb7d9a046a7f9dc13b...3aefed2dc250bd41502bdaa11624f1f974ed80b6,1,2,1,3,1,2013-03-21 16:19:22,2013-03-21 16:19:22
f7837599283ff89493d4fcfb7d9a046a7f9dc13b...8ff60ddef488b8145c6afc2711656c44a11c11a0,1,9,9,18,9,2013-03-21 13:39:52,2013-03-21 13:39:52
b1acd0a7b0513b31253195fc94e5d8a92b10ebe6...2508b5cef9c5609d72ed9f2016d4cd3906429f20,1,3,0,3,2,2013-03-20 01:45:11,2013-03-20 01:45:11
680f40c37e0d7f2fc924a51bc40c0bfc37f60b9e...44faa07b6c472b888bed65b56126cde56658e91a,5,113,96,209,37,2013-03-22 00:35:49,2013-03-22 00:35:49
44faa07b6c472b888bed65b56126cde56658e91a...ef711962d5d70b4332908f0ca6460929e289c131,14,37,45,82,38,2013-03-22 00:47:23,2013-03-22 00:47:23
680f40c37e0d7f2fc924a51bc40c0bfc37f60b9e...3e8d1dfb69e74414b3466fee3195432f17445bbc,1,4,4,8,1,2013-03-21 10:52:58,2013-03-21 10:52:58
3e8d1dfb69e74414b3466fee3195432f17445bbc...edcfd687efb6c00aefc39c07019307b917bd1ec8,1,169,0,169,3,2013-03-21 10:53:27,2013-03-21 10:53:27
3aefed2dc250bd41502bdaa11624f1f974ed80b6...b00ff47963bb236d9f94fbcd759e4f3fba021d05,3,50,23,73,5,2013-03-22 11:24:03,2013-03-22 11:24:03
3aefed2dc250bd41502bdaa11624f1f974ed80b6...7566006d0de5d1da0ea7f0fa906483425391fbf8,1,39,39,78,19,2013-03-22 01:20:54,2013-03-22 01:18:34
ff2ae90764ccd562ba3c3943e35b9a66fa405c23...4389574aff5abc1dd49313ca5217f81210568ed9,1,22,1,23,3,2013-03-20 03:17:32,2013-03-20 03:17:32
ef711962d5d70b4332908f0ca6460929e289c131...4af8b711c0b86b38a851ec19b2a00e1317496924,1,2,1,3,2,2013-03-22 01:59:12,2013-03-22 01:59:12
4af8b711c0b86b38a851ec19b2a00e1317496924...d0c776528b50f884c970cf0563ef6b40d90efc44,1,7,1,8,2,2013-03-22 02:00:43,2013-03-22 02:00:43
d0c776528b50f884c970cf0563ef6b40d90efc44...379d449c4417e505a3ea95a121680b318b757c46,2,34,6,40,5,2013-03-22 02:01:55,2013-03-22 02:01:55
9fa3d891c6ef5b335468268df5ac4be7c569494b...3c6b8bb8882fcd2083d1c489df3cc40062b4896c,1,3,0,3,1,2013-03-22 16:28:15,2013-03-22 14:06:14
9fa3d891c6ef5b335468268df5ac4be7c569494b...9542876d2f22e73a52b4957d1a8ca6b17d5c83e7,1,1,1,2,1,2013-03-22 13:48:50,2013-03-22 13:48:50
9542876d2f22e73a52b4957d1a8ca6b17d5c83e7...cff01ec5ec3210f2faec3715bf1b07182bcc571c,1,1,1,2,1,2013-03-22 15:30:47,2013-03-22 13:49:28
41c664cacf3a295b2c0b72a4cc46225617c35893...95ad9e457388472e2c7f8175e0bf5444ba02a76a,3,54,15,69,12,2013-03-22 16:30:54,2013-03-22 15:28:51
41c664cacf3a295b2c0b72a4cc46225617c35893...13e597a5adf7e700757ee2b8ec40fe6712ebc99e,1,4,0,4,1,2013-03-22 04:47:14,2013-03-22 04:47:14
7566006d0de5d1da0ea7f0fa906483425391fbf8...d515e2b06c70a4132343da69a6a763ef626e7376,1,14,14,28,5,2013-03-22 04:46:00,2013-03-22 04:46:00
690cae0ef442301a97546f953dfdc8b661f3d9ef...301a8afff578a8467e98f1081aa96323c458e1f1,1,1,0,1,1,2013-03-23 05:31:20,2013-03-23 05:31:20
690cae0ef442301a97546f953dfdc8b661f3d9ef...371225520fc86fa58fadd182730b958a0f7ef9ab,1,3,0,3,1,2013-03-23 04:44:01,2013-03-23 04:43:31
379d449c4417e505a3ea95a121680b318b757c46...49a78929c61cbab0d25b49fdee43beac62fc9f66,1,8,0,8,3,2013-03-22 03:06:20,2013-03-22 03:06:20
49a78929c61cbab0d25b49fdee43beac62fc9f66...8396798ebae99791ce3f2f43c276af8e6b96d782,2,35,19,54,5,2013-03-22 03:07:37,2013-03-22 03:07:37
8396798ebae99791ce3f2f43c276af8e6b96d782...05ae69a6eb72e012ed35422a6842038a01a24b61,6,21,15,36,12,2013-03-22 04:13:27,2013-03-22 04:13:27
04ba4348de2927ace855a8343aad1b5cb68fc500...42cf74d56b0c989474ef00bf542bc4d2103001e6,1,61,24,85,23,2013-03-21 13:33:29,2013-03-21 13:33:29
bea7894166ad879a290650f8fa1ab06f9ca3cdb5...94b9ca988de6970406789759b5f75fee19fd5dbb,1,22,0,22,2,2013-03-24 10:49:16,2013-03-24 10:49:16
13e597a5adf7e700757ee2b8ec40fe6712ebc99e...6295a022750627d433c5c44872393ede4f1d8051,1,14,3,17,4,2013-03-22 05:16:52,2013-03-22 00:23:23
6295a022750627d433c5c44872393ede4f1d8051...45df6f7801554ccb24ba8ccf42ec5a847262b9ca,1,10,10,20,4,2013-03-22 05:26:18,2013-03-22 05:26:18
5130d3d6ec979ea2d1f9a0da9d5766028571dd9e...57e2126a02f8b96b0542df7f6a573233d8419bb1,1,1,1,2,1,2013-03-24 00:48:18,2013-03-24 00:48:18
57e2126a02f8b96b0542df7f6a573233d8419bb1...f7eaaa3adb08082089544c34439bb31b5a6f3246,1,18,0,18,3,2013-03-24 02:11:00,2013-03-24 02:11:00
f7eaaa3adb08082089544c34439bb31b5a6f3246...0d46ddf7b4940f7e9b1cecf00a9f608134cdbac8,2,4,3,7,4,2013-03-24 02:16:42,2013-03-24 02:16:42
51455b1ee0f120d20d511e3f76786b9d688ceeff...c61172f9c2e30ab70f512efdf699319da855f864,1,1,1,2,1,2013-03-24 23:36:59,2013-03-24 23:36:59
51455b1ee0f120d20d511e3f76786b9d688ceeff...87d4e16568f151cc7dc0f10b8c3f222024582489,1,7,1,8,2,2013-03-24 21:38:10,2013-03-24 21:38:10
87d4e16568f151cc7dc0f10b8c3f222024582489...938bf4c9019cf6b5f64ebcc6db782d858feac2fb,1,1,7,8,2,2013-03-24 21:53:00,2013-03-24 21:53:00
938bf4c9019cf6b5f64ebcc6db782d858feac2fb...0786d9ec22164afe17051e69dd462ebee6ddcbf9,1,2,2,4,1,2013-03-24 22:01:41,2013-03-24 22:01:41
51455b1ee0f120d20d511e3f76786b9d688ceeff...55c89087561e98eb2d4ce46b9d65c4e31f9297d8,1,1,1,2,1,2013-03-24 21:13:08,2013-03-24 21:13:08
51455b1ee0f120d20d511e3f76786b9d688ceeff...e09383bccfcefa3699aa959dedbd8364d505bf9c,1,1,1,2,1,2013-03-23 21:54:18,2013-03-23 21:54:18
7952e6befe36bafc15f2d2ddcf5ed2a22f5aa12d...12049f956aedc7366492c82002c843677af4e15d,2,28,4,32,5,2013-03-23 02:22:06,2013-03-23 02:22:06
05ae69a6eb72e012ed35422a6842038a01a24b61...1ad69ad415728cc462dd3e296295247449538b0b,1,22,0,22,2,2013-03-22 04:42:18,2013-03-22 04:42:18
0d46ddf7b4940f7e9b1cecf00a9f608134cdbac8...190e2fa50f62c0b2a497dac39a5154bd35e46b3a,1,1,1,2,1,2013-03-24 02:33:00,2013-03-24 02:33:00
190e2fa50f62c0b2a497dac39a5154bd35e46b3a...b32436cd2ea1f206cf5758170172f46dafb1f43c,1,3,0,3,1,2013-03-24 02:51:35,2013-03-24 02:51:35
0d46ddf7b4940f7e9b1cecf00a9f608134cdbac8...5c04d3488a0c02426ea08dcd9b1ead5884062836,1,9,1,10,1,2013-03-23 00:43:11,2013-03-23 00:41:48
22598ee572d08ed4bfae2242519acea31124c00c...6576b19a28a688f00dbe21318b4073826001cf3c,1,14,3,17,4,2013-03-25 08:29:01,2013-03-25 08:29:01
db8f2a1a9d2d027959952e259b8889562a41da0c...fc0eac37e47f220e83eacde51519de092b17e426,1,1,2,3,1,2013-03-22 11:37:18,2013-03-22 11:37:18
cdd62522b6a19da97a8626989f086a64cecc0cf4...f50dcbe404fd64dd0c69194bab3ea4aecb1d9f0d,1,2,2,4,1,2013-03-22 05:45:22,2013-03-22 05:45:22
f50dcbe404fd64dd0c69194bab3ea4aecb1d9f0d...da266e6c7b66eda9ec6211bbf48fa71c3732d705,3,219,189,408,17,2013-03-21 17:10:14,2013-03-21 17:10:14
da266e6c7b66eda9ec6211bbf48fa71c3732d705...f246cc9cdd9091baa5f956f7c8119a49e8379f91,1,2,1,3,2,2013-03-21 17:12:05,2013-03-21 17:12:05
f246cc9cdd9091baa5f956f7c8119a49e8379f91...d8fa52b7b5b6101538c15735500b3a01327ca96f,2,2,1,3,2,2013-03-21 17:31:02,2013-03-21 17:31:02
bd63ae72e611fcd3f14ff51fb62ab58aebdd810d...504663a6eeef0e2d7b87d5c205be7c81a048bfc1,1,3,2,5,2,2013-03-25 22:29:42,2013-03-25 22:29:00
5c04d3488a0c02426ea08dcd9b1ead5884062836...b370acd679622239849b1dfbe05d61804aeb7162,1,3,1,4,1,2013-03-23 00:58:00,2013-03-23 00:58:00
a61e68275a62c301917044b4cdc6e12d26c27dd4...c8ca50b48328448d70c3f227dc7bb8d65a980f6b,1,11,2,13,2,2013-03-25 14:17:11,2013-03-25 14:17:11
ab3a57d01bd056d6c442ce1b92f61584cf3a5d75...9b5f0fac81367b9a1b4d09b87b9a8bd0fc92635a,1,2,0,2,1,2013-03-23 02:47:32,2013-03-23 02:47:32
fc0eac37e47f220e83eacde51519de092b17e426...77549ad4f6238fbc203eca8c328131680ea56039,1,23,12,35,9,2013-03-22 11:44:07,2013-03-22 11:44:07
d8fa52b7b5b6101538c15735500b3a01327ca96f...640026ec59d26172d5beddf97f3894d4374ddd4d,3,53,27,80,9,2013-03-22 23:07:13,2013-03-22 23:07:13
d8fa52b7b5b6101538c15735500b3a01327ca96f...11c4294846b55914ec5c5b475012a2234be9a9ff,3,128,9,137,14,2013-03-22 08:25:27,2013-03-22 08:25:27
a71047572610c3c0960fc245d170fa32760383ea...7e4ac6c689a00760b38b32edd91f1885e2237cd5,2,2,2,4,2,2013-03-27 02:31:50,2013-03-27 02:31:35
a71047572610c3c0960fc245d170fa32760383ea...8513c179f30acc01ac9b2a5c3c9671f0a15277f0,5,5,2,7,4,2013-03-27 00:25:26,2013-03-26 19:00:46
8513c179f30acc01ac9b2a5c3c9671f0a15277f0...378dacdf1cc65c9b9742facaa75c73d807616643,1,0,0,0,0,2013-03-27 00:25:35,2013-03-26 21:53:07
504663a6eeef0e2d7b87d5c205be7c81a048bfc1...922a8648fc5724ad3ff38e2404d70442dc8f2264,2,51,18,69,4,2013-03-26 01:43:25,2013-03-26 01:43:25
504663a6eeef0e2d7b87d5c205be7c81a048bfc1...d01b5894c47f7b389e89efe14a5acc96a68e3b7d,1,3,2,5,3,2013-03-26 00:18:56,2013-03-26 00:18:56
d01b5894c47f7b389e89efe14a5acc96a68e3b7d...b31211cbe95c0a5e87fef878add42f2e9af8de72,2,10,16,26,15,2013-03-26 00:20:26,2013-03-26 00:20:26
b31211cbe95c0a5e87fef878add42f2e9af8de72...e4a69b1044793d3ee2bc30b9287e42b4cf864003,1,10,21,31,5,2013-03-26 00:20:55,2013-03-26 00:20:55
bd2a55cd2680b127c426c57204161bc0e2679f03...ffe5370e35d7eda627894a4510095dca26bdbbca,1,2,0,2,1,2013-03-23 01:37:53,2013-03-23 01:37:53
bd2a55cd2680b127c426c57204161bc0e2679f03...cb3c4af404e29e03e9971df62625cf9d90467ca6,1,4,5,9,5,2013-03-23 01:15:44,2013-03-23 01:15:44
cb3c4af404e29e03e9971df62625cf9d90467ca6...df19863b23665daa056f5882676e6416e5a65e9e,1,2,2,4,2,2013-03-23 01:17:49,2013-03-23 01:17:49
9b5f0fac81367b9a1b4d09b87b9a8bd0fc92635a...34fbaa5f6d0d8bd31504f43db56090be6dfa9af4,3,25,8,33,7,2013-03-23 03:36:34,2013-03-23 03:36:34
34fbaa5f6d0d8bd31504f43db56090be6dfa9af4...841c7ac0f98c43c2d55fdac4148650e4d0118187,2,7,8,15,8,2013-03-23 03:46:14,2013-03-23 03:46:14
841c7ac0f98c43c2d55fdac4148650e4d0118187...829eeb07f8ecd9d53c667a6fdfe513f5a7df54ac,1,5,17,22,2,2013-03-23 03:55:17,2013-03-23 03:55:17
9b5f0fac81367b9a1b4d09b87b9a8bd0fc92635a...e726bdcce2606acef136a4d5ba47e367d9e461df,2,10,1,11,2,2013-03-22 12:52:13,2013-03-22 12:52:13
e726bdcce2606acef136a4d5ba47e367d9e461df...1ed78ee1608fb34a5ab6d136c626170eb6e2ec6a,2,36,13,49,13,2013-03-22 13:38:54,2013-03-22 13:38:54
5e561a9d52d59beac4f9872eec3d9c7b50acfa04...09b27f9e8d762713ae64711cbdfb76aa52ec1bcf,1,8,7,15,2,2013-03-23 00:22:32,2013-03-23 00:22:32
5e561a9d52d59beac4f9872eec3d9c7b50acfa04...c72ff318d3fb6ab887af21cf4410e1bc8104663a,6,55,51,106,34,2013-03-22 09:19:39,2013-03-22 09:19:39
c72ff318d3fb6ab887af21cf4410e1bc8104663a...4307b7dd8ea8d2cdfdf749383f514e656ae8a408,2,52,22,74,23,2013-03-22 09:57:28,2013-03-22 09:57:28
2b090320beae64e1bf15102da5dfe96937a21a77...2b7284db4f4c5b311eadd0432577bf0c263c2cce,1,0,7,7,1,2013-03-27 01:20:45,2013-03-27 01:20:45
2b7284db4f4c5b311eadd0432577bf0c263c2cce...5bec4b8f040f366a5a1eed294d98e383d64b46e7,1,12,6,18,2,2013-03-27 01:41:06,2013-03-27 01:41:06
5bec4b8f040f366a5a1eed294d98e383d64b46e7...8461196a794d0ccd42b958fd93b833b7df9a8ca5,1,3,1,4,3,2013-03-27 01:41:47,2013-03-27 01:41:47
211ed0a7665b44fe8ed22a467b52593bd34d43a9...c85db1003be5d7cce4c5f94993980acc82db24d3,1,1,1,2,1,2013-03-26 02:20:18,2013-03-26 02:20:18
c85db1003be5d7cce4c5f94993980acc82db24d3...41a2954e4e3f00ef969b2b2ff8308ecc0d3bc673,1,4,8,12,6,2013-03-26 02:31:20,2013-03-26 02:31:20
e4a69b1044793d3ee2bc30b9287e42b4cf864003...69b09ccfc80b9411504604ace550ac2fea8cf45a,88,15826,223,16049,49,2013-03-26 02:52:52,2013-03-26 02:52:52
e4a69b1044793d3ee2bc30b9287e42b4cf864003...f70bc2c98ca743e61ffd5b4c7d6590c8fd6a31ae,2,22,24,46,19,2013-03-26 01:48:57,2013-03-26 01:48:57
f70bc2c98ca743e61ffd5b4c7d6590c8fd6a31ae...7943a02cb65dd40f7b3c3c4cb9a01a8caced231e,1,5,1,6,1,2013-03-26 01:50:02,2013-03-26 01:50:02
e4a69b1044793d3ee2bc30b9287e42b4cf864003...022a1f99576679cee2d436f1593b3a388e3021a6,1,8,187,195,21,2013-03-26 01:46:13,2013-03-26 01:46:13
e4a69b1044793d3ee2bc30b9287e42b4cf864003...50bee2f8114ce562d63b08665f7371aa5a568b2c,2,51,18,69,4,2013-03-26 01:44:05,2013-03-26 01:43:25
e4a69b1044793d3ee2bc30b9287e42b4cf864003...a9a439183da194b0039bae7f0f4d9531c4849f88,1,4,1,5,1,2013-03-26 01:33:56,2013-03-26 01:33:56
a9a439183da194b0039bae7f0f4d9531c4849f88...c9d93cd333b7f14782f3abbc53c7dd09fd5880dd,1,4,1,5,1,2013-03-26 01:35:31,2013-03-26 01:35:31
e55b8b2fd9e6e2a4d8db50cde01a462918c76a33...96010e3ca134acb4707bbbb1fd8649d7de671229,1,0,4,4,1,2013-03-23 01:46:47,2013-03-23 01:45:28
899613f7887f439560e91364fcaa40f4320fb628...c000a5ed75f8b238fd7d908118eea9d9e740f66d,2,8,13,21,5,2013-03-22 14:10:52,2013-03-22 14:10:52
c000a5ed75f8b238fd7d908118eea9d9e740f66d...d1c8eabc63a02c1791b18b7129a76c8710402666,2,21,14,35,11,2013-03-22 14:56:44,2013-03-22 14:56:44
d1c8eabc63a02c1791b18b7129a76c8710402666...0c4b639083e2660cc246a60b3f13f7fceca413ed,1,2,12,14,3,2013-03-22 15:04:53,2013-03-22 15:04:53
56752158af090b55a367591d2db5625db661bb4d...f8ebeaae104e742f3fc1a1fc2f72526b675d939c,1,0,22,22,1,2013-03-23 00:44:12,2013-03-23 00:44:12
4307b7dd8ea8d2cdfdf749383f514e656ae8a408...0eed4b43866a559c94097e4ffbfb49e674bda121,1,22,3,25,5,2013-03-22 10:10:09,2013-03-22 10:10:09
00b81936aa5c89fae625c833c1d6a51d4d55d99a...4a086dfc0859fb3053925f1651d39056ef7dbfd6,1,3,3,6,3,2013-03-27 03:28:46,2013-03-27 03:28:46
243eea36cac594a8997f10b14688ca10934bfa86...f37a693825180fc982ee26f507e4cdf7811980ad,1,30,15,45,8,2013-03-26 03:48:04,2013-03-26 03:48:04
f37a693825180fc982ee26f507e4cdf7811980ad...3150a789c15a5f1a8150007b83fe2072f8cb863e,2,1,2,3,2,2013-03-26 04:07:56,2013-03-26 04:07:56
3150a789c15a5f1a8150007b83fe2072f8cb863e...6f80674d66408cf2d3b225156d097cf624a6a48e,2,110,111,221,42,2013-03-26 04:16:33,2013-03-26 04:16:33
6f80674d66408cf2d3b225156d097cf624a6a48e...f7d69601c5bc6b27690b0be3de8eca1d6fbb4df9,4,18,8,26,7,2013-03-26 15:50:34,2013-03-26 15:50:34
7e540a083f0d229d611ae73afd8cddd1ee7f1c3e...3cce89d8edc9c3151bd982c6b5acfa8c20d5ae71,1,0,1,1,1,2013-03-26 14:10:31,2013-03-26 14:10:31
7e540a083f0d229d611ae73afd8cddd1ee7f1c3e...e53f45f621df0e8004fe3aa482a948eb32b709b6,2,17,2,19,5,2013-03-26 13:17:44,2013-03-26 13:17:44
96010e3ca134acb4707bbbb1fd8649d7de671229...eb95e4915089c90dba8939c05825d2b5f5eed8e4,1,7,2,9,1,2013-03-23 02:04:12,2013-03-23 02:04:12
5aba56e0e0799bfac69057f8fb47533c18cd41f1...fa89076673bd734cebff88717bf79461ecf8d505,1,3,0,3,1,2013-03-28 05:28:11,2013-03-28 05:28:11
0c4b639083e2660cc246a60b3f13f7fceca413ed...031f91df1a158d37f7f068ca1e17c25e1f112f29,5,147,184,331,44,2013-03-23 19:16:58,2013-03-23 19:16:58
031f91df1a158d37f7f068ca1e17c25e1f112f29...6ce64e8458b31aff150f2cae197d42e334018afa,5,88,62,150,43,2013-03-23 19:39:09,2013-03-23 19:39:09
0c4b639083e2660cc246a60b3f13f7fceca413ed...5e6355d1828441fe6d5ff4cd814825e05213b2c9,1,2,2,4,2,2013-03-22 17:22:22,2013-03-22 17:22:22
f8ebeaae104e742f3fc1a1fc2f72526b675d939c...542c66997fce7cea590ca647592cc53f1cec6fca,1,1,1,2,1,2013-03-23 00:52:19,2013-03-23 00:52:19
4a086dfc0859fb3053925f1651d39056ef7dbfd6...ff04ce3ddfc5bcd681c580b0b4e739e8c737e5b9,1,1,1,2,1,2013-03-27 13:02:11,2013-03-27 13:02:11
4a086dfc0859fb3053925f1651d39056ef7dbfd6...43213dfc4a441ca347cd97ceca219e8e021f08ef,1,1,1,2,1,2013-03-27 06:14:50,2013-03-27 06:14:50
6b54a439b2930ec93871c6b2e912ed0da71cfa48...3b71336edcd3798a11ea8a2f9c94b012357b32c3,35,22,290,312,14,2013-03-27 23:43:13,2013-03-27 23:43:13
3b71336edcd3798a11ea8a2f9c94b012357b32c3...90fb5dc962650567f9872ecd17bae380b0355f72,4,15,15,30,10,2013-03-28 00:01:50,2013-03-28 00:01:50
f7d69601c5bc6b27690b0be3de8eca1d6fbb4df9...1c5162c5a9e47a5e6f774f2bf31ef6f156d2e18b,23,17,1401,1418,5,2013-03-26 17:03:10,2013-03-26 17:03:10
3cce89d8edc9c3151bd982c6b5acfa8c20d5ae71...2333be46aae0473ec244176882bd6188d4c16ce2,2,10,5,15,6,2013-03-26 15:31:26,2013-03-26 15:31:26
3cce89d8edc9c3151bd982c6b5acfa8c20d5ae71...7009d6c6ddc2acc77e7caa227c08ecf29d747298,3,50,0,50,3,2013-03-26 15:19:54,2013-03-25 21:48:46
7009d6c6ddc2acc77e7caa227c08ecf29d747298...6b4bc971fd7ea03227f88b66168b884e2272aea6,1,4,1,5,2,2013-03-26 15:19:57,2013-03-25 22:15:37
6b4bc971fd7ea03227f88b66168b884e2272aea6...a57b37ed0e1531e7cc7b8c91ecf73a904c067891,2,2,2,4,2,2013-03-26 15:19:57,2013-03-26 00:23:36
a57b37ed0e1531e7cc7b8c91ecf73a904c067891...5a0010abe99869ffb4cb70917caa5ba35346e3e8,1,2,2,4,2,2013-03-26 15:19:58,2013-03-26 06:21:10
5a0010abe99869ffb4cb70917caa5ba35346e3e8...a26c58e27ef5ab1b017097fd8fc75d778d7c9eef,1,2,1,3,1,2013-03-26 15:19:58,2013-03-26 06:25:20
a26c58e27ef5ab1b017097fd8fc75d778d7c9eef...21f55419b73eaff72fe3383b4ee142b04e701372,2,14,2,16,4,2013-03-26 15:19:58,2013-03-26 06:28:35
21f55419b73eaff72fe3383b4ee142b04e701372...f961ec55e72ae068c6153f2d20da5295d8d0a4c1,1,3,1,4,2,2013-03-26 15:19:58,2013-03-26 14:30:01
3cce89d8edc9c3151bd982c6b5acfa8c20d5ae71...b2b6d519c5429eae59d634a9ad1ff690b35e56ee,1,0,0,0,0,2013-03-26 14:36:49,2013-03-26 14:36:49
e37ce11cfa6e715d4fdc09a707beb46a99529295...b3cbe87b62f00d0dcc207d4562c9dde99a708366,1,1,1,2,1,2013-03-28 07:55:28,2013-03-28 07:55:28
d9471bee3da16f7cef1f7bf5d7d1b202514a1f3d...f37c432bd5fc40ee45b5d31ea750c59c544f2df5,1,1,3,4,1,2013-03-23 21:18:35,2013-03-23 21:18:35
5e6355d1828441fe6d5ff4cd814825e05213b2c9...a2e5333a93f85ffb6beb8ad88c88e115f235886c,1,40,9,49,3,2013-03-22 17:42:13,2013-03-22 17:42:13
520af226c063e799d12750c339c78cd03060ae16...bf7602bc098888994eb28a2a6c9acd949a227448,4,25,5,30,7,2013-03-23 01:27:18,2013-03-23 01:27:18
520af226c063e799d12750c339c78cd03060ae16...3870ebee6db450efcebac81b829694a047583442,1,1,0,1,1,2013-03-22 10:22:36,2013-03-22 10:22:36
3870ebee6db450efcebac81b829694a047583442...e4f9a0dca0a3eb9fd762ef502d40a089ed16acd4,1,2,0,2,1,2013-03-22 10:24:37,2013-03-22 10:24:37
e4f9a0dca0a3eb9fd762ef502d40a089ed16acd4...e02f7912bcc07dbddd47bcf0106ca881fd768559,1,10,8,18,6,2013-03-22 10:43:57,2013-03-22 10:43:57
0d75c68e5ebe84c38bbdb2bf6b570618c8e61bee...165a7f36709ad21d2e03c938855acf75a5a0c60a,1,1,1,2,1,2013-03-27 13:43:05,2013-03-27 13:43:05
165a7f36709ad21d2e03c938855acf75a5a0c60a...212a044a55394f7b79f02344d5ea4ee72ed787d5,1,2,2,4,2,2013-03-27 13:44:20,2013-03-27 13:44:20
7e9975d00af96e7b02244fa350d41415a3e1eeaf...108acc0511fde98a8b5035d9ea7256d5449bb034,2,11,1,12,3,2013-03-28 06:54:53,2013-03-28 06:54:53
108acc0511fde98a8b5035d9ea7256d5449bb034...6a236184af6ae57e2f7475e9ab279b0684a869d4,1,6,6,12,5,2013-03-28 06:56:36,2013-03-28 06:56:36
7e9975d00af96e7b02244fa350d41415a3e1eeaf...a3ab89df2b3d9ba654ba85af5d71d063d401f23f,5,55,188,243,31,2013-03-28 01:55:25,2013-03-27 23:19:30
1c5162c5a9e47a5e6f774f2bf31ef6f156d2e18b...f87aa7e336ea4eba16042d17304cca146d75ebb7,5,5,2,7,4,2013-03-26 19:00:46,2013-03-26 19:00:46
53641e8b8df0373a1b53ec9b9d83e519344491e8...7db1890c9926191367697826c0de881644a05286,1,5,0,5,1,2013-03-26 18:27:36,2013-03-26 18:27:36
53641e8b8df0373a1b53ec9b9d83e519344491e8...5cebc226cc0d734936a3d63e10027d46f39e8025,1,2,2,4,1,2013-03-26 17:40:56,2013-03-26 17:40:56
5cebc226cc0d734936a3d63e10027d46f39e8025...afdf29e57fe2213698645298c2381cab27baadc0,2,31,15,46,11,2013-03-26 21:21:54,2013-03-26 21:21:54
53641e8b8df0373a1b53ec9b9d83e519344491e8...069918e1fd9192f4395c286c50fa3a8f50002ada,1,34,1,35,3,2013-03-26 10:33:47,2013-03-26 10:33:47
069918e1fd9192f4395c286c50fa3a8f50002ada...baea0a98f84f7827485505425b23ee0ac7ce2a23,1,8,0,8,1,2013-03-27 19:09:58,2013-03-27 19:09:58
53641e8b8df0373a1b53ec9b9d83e519344491e8...91d78a10c33d9e1c33120634fb3dad5e0d247d28,1,10,1,11,2,2013-03-26 10:05:10,2013-03-26 10:05:10
91d78a10c33d9e1c33120634fb3dad5e0d247d28...004a5310d93c5373d6db7683058fb392c8a3bd37,3,17,7,24,5,2013-03-26 12:28:17,2013-03-26 12:28:17
9528b8685f0a67bd52f2c4af59fdd01b93581727...5dc1e66366d3a40169eec67d823f2d6209ba5b99,2,2,3,5,3,2013-03-28 22:38:53,2013-03-28 22:38:53
b809dc4271ee0f9ea5d20fc92fcb6cc62c6fca8d...0146c80c40fa5b793fdda17ed2c96d49bd90e2ed,3,5,5,10,3,2013-03-23 21:48:16,2013-03-23 21:48:16
b809dc4271ee0f9ea5d20fc92fcb6cc62c6fca8d...89763bc8af81dcda3d9989cf6687c75101bbd9bc,2,9,4,13,4,2013-03-22 20:10:17,2013-03-22 20:10:17
c57727fd65aee632b762a2b3286004461ee02c7f...6e507b9460b81e830ef2f5d10035d08e3948fe4d,5,32,3,35,14,2013-03-22 18:44:12,2013-03-22 18:44:12
e02f7912bcc07dbddd47bcf0106ca881fd768559...08cb430281bb1aa003f21a983029dd934bd99a10,2,1,0,1,1,2013-03-22 11:34:46,2013-03-22 11:34:46
c937e237ad0625fc0ae8049e745bf599c27b0af8...f85e6548c79648b8bcff8ee83142983bbb15dacb,1,3,0,3,1,2013-03-29 20:18:59,2013-03-29 20:18:59
47e5d2f5e1af88f75faa7391fb29644b3254a8ae...5c639118d35c1c2048123e94fd4b9ff9b98c89dc,1,3,3,6,3,2013-03-28 18:51:10,2013-03-28 18:51:10
70594bdd166e41ffb26913749e83ba752f851ebd...172f746e4d80df0efd2b30ba6be540d7ec423db3,2,5,5,10,4,2013-03-28 18:44:33,2013-03-28 18:44:33
172f746e4d80df0efd2b30ba6be540d7ec423db3...9bc7e71f16365f21c1b54ad1c16188eda668296e,3,15,15,30,13,2013-03-28 18:50:00,2013-03-28 18:50:00
9bc7e71f16365f21c1b54ad1c16188eda668296e...32b58159cd0eedc9d6cd05e8d78b8519c5b690c7,1,1,1,2,1,2013-03-28 19:18:22,2013-03-28 19:18:22
32b58159cd0eedc9d6cd05e8d78b8519c5b690c7...da69df5f421ed49464254fb52dc222f98587345f,1,4,1,5,1,2013-03-28 19:27:37,2013-03-28 19:27:37
f87aa7e336ea4eba16042d17304cca146d75ebb7...84df72222d82fe5530da8f9c42156169519037d8,1,1,1,2,1,2013-03-26 21:31:45,2013-03-26 21:31:45
1a96ce552f1d6a4f07db48a1bd2f03edcaa3c26f...84cca8afc82114df1893802c06b2920029908e9d,1,10,2,12,2,2013-03-26 18:46:51,2013-03-26 18:46:51
8da1810975fcdaa1535debf4c024a2779ef3e574...846a9e8963ba58596b87024d5d108fea8d1c7399,1,2,0,2,2,2013-03-26 22:30:16,2013-03-26 22:30:16
8da1810975fcdaa1535debf4c024a2779ef3e574...08f1e3af4828c163a44ecd57b798954d12182983,6,6,6,12,6,2013-03-26 21:25:42,2013-03-26 21:25:42
6e35f283524a866c71aefee417fdd414182e6772...966cddf26bc5e86c47faab0ddc69b42e9bd8a9f2,2,15,14,29,15,2013-03-22 20:21:44,2013-03-22 20:21:44
fdae64d8d77dec092c8e5efc55c05057639b0170...6ede6bc8f2c1cd465fd48120d42aa39853b51111,1,3,0,3,3,2013-03-29 20:26:02,2013-03-29 20:26:02
6ede6bc8f2c1cd465fd48120d42aa39853b51111...f7b4f0c19329bcf13b0df5408e2bc9eac89e9f44,1,1,0,1,1,2013-03-29 20:37:52,2013-03-29 20:37:52
4825d3a5374cb177642c72389d6048f34535d9c9...d66de319bd1c66e04421c19e7fc25b825d94fe00,1,1,1,2,1,2013-03-29 00:09:36,2013-03-29 00:09:36
4825d3a5374cb177642c72389d6048f34535d9c9...a5054184a172da0b9abd2470946bb15ab5fb0516,1,21,3,24,2,2013-03-28 20:32:31,2013-03-28 20:32:31
a5054184a172da0b9abd2470946bb15ab5fb0516...760736b3f3f289c2dba013aaef385b1e7b555feb,1,69,0,69,1,2013-03-29 00:04:21,2013-03-29 00:04:21
760736b3f3f289c2dba013aaef385b1e7b555feb...bd3c6793a183b9b848e34312a0215cb9078f2240,1,1,22,23,3,2013-03-29 11:06:58,2013-03-29 11:06:58
4825d3a5374cb177642c72389d6048f34535d9c9...dfc3904f778996a449ef5199e36fce6cabfb803a,1,5,1,6,1,2013-03-28 19:02:50,2013-03-27 18:29:58
dfc3904f778996a449ef5199e36fce6cabfb803a...c66d2b6a532c657b554ffa3c80b2cf15e218ee8e,1,1,1,2,1,2013-03-28 19:30:56,2013-03-28 19:30:56
c66d2b6a532c657b554ffa3c80b2cf15e218ee8e...523803d633e3bf7e4076ad41e73daba491da5d40,1,3,3,6,3,2013-03-28 19:44:54,2013-03-28 19:44:54
261003ceb087e9ce8a13fd4420d866ac2ee537ea...8cfaf658ccae041400f142227d0813ceb0f263db,2,37,11,48,13,2013-03-27 01:21:52,2013-03-27 01:21:52
8cfaf658ccae041400f142227d0813ceb0f263db...502f772839859823639aef1add8d5463e5be11fc,1,1,1,2,1,2013-03-27 01:28:46,2013-03-27 01:28:46
261003ceb087e9ce8a13fd4420d866ac2ee537ea...709849e717da1f0c509d0cf62414141e62a09eb7,2,59,25,84,22,2013-03-26 23:29:21,2013-03-26 23:29:21
84cca8afc82114df1893802c06b2920029908e9d...19040035116edf70a42bc825785de6b3f637c120,1,4,2,6,2,2013-03-26 18:58:42,2013-03-26 18:58:42
84cca8afc82114df1893802c06b2920029908e9d...161526d99d6543341b8651ab5c7ac1e503abb79f,1,4,5,9,1,2013-03-26 11:12:08,2013-03-26 04:01:42
161526d99d6543341b8651ab5c7ac1e503abb79f...6ccd473127c334ee6dcd1694a1fddcf6cdc1fd32,1,17,2,19,4,2013-03-26 11:12:08,2013-03-26 11:11:13
2d71e2a44ca75ebbb0bd782053f8cc8463cd5474...cca59081de9dc243fefe2816ded509bd4e1caad9,1,3,2,5,1,2013-03-26 14:01:59,2013-03-26 14:01:59
48a208baf197c035c59ecd44d285fb3640107233...1d6929c8bc6cbc5ad63dce083869460b6bb377ad,1,0,1,1,1,2013-03-29 02:18:03,2013-03-29 02:18:03
966cddf26bc5e86c47faab0ddc69b42e9bd8a9f2...f43fbda2a464ba2ef26c88c25cdb933c144657f4,1,1,1,2,1,2013-03-23 23:17:01,2013-03-23 23:17:01
f43fbda2a464ba2ef26c88c25cdb933c144657f4...d301c7b98c46fa0d1bba66be852a7453d108f028,2,51,5,56,9,2013-03-24 00:03:30,2013-03-24 00:03:30
966cddf26bc5e86c47faab0ddc69b42e9bd8a9f2...dc2d930520cd528129330098e868c7fffe8349b9,1,0,2,2,1,2013-03-22 21:27:10,2013-03-22 21:27:10
09910785c80822fad71127db4ec30b3de8c27f08...61cf09b2e7491295575195b616207059e7107f01,1,11,11,22,7,2013-03-29 02:03:06,2013-03-29 02:03:06
0636c11f0b15f8fa0693be2d3560370f19f773cf...6bcc55f7d030d0cfd7bf130070805a9001951b06,2,52,14,66,2,2013-03-29 00:53:54,2013-03-29 00:52:49
0636c11f0b15f8fa0693be2d3560370f19f773cf...a6da7f138c0b260d560c63e234c87db0f5c72bb1,6,97,97,194,54,2013-03-29 00:12:23,2013-03-29 00:12:23
c9a13147fe98c8b5b55eb28deca8147f10906012...9b13d21fc980b5ac12e035d9c8cbe3ef2c36a079,1,3,0,3,1,2013-04-01 20:05:00,2013-04-01 20:05:00
c9a13147fe98c8b5b55eb28deca8147f10906012...7830cf91663f071315c3d0406bc3de0f8a58c2b6,2,5,3,8,5,2013-04-01 18:15:10,2013-03-30 07:20:40
7830cf91663f071315c3d0406bc3de0f8a58c2b6...15b30881570369564bde3f7d8faf4491b2ebfaab,2,4,4,8,4,2013-04-01 18:15:40,2013-03-30 07:22:56
15b30881570369564bde3f7d8faf4491b2ebfaab...c298a91f95dafb056cede9036f5e81f259b8f3e9,4,12,12,24,10,2013-04-01 19:17:00,2013-03-30 07:23:12
c298a91f95dafb056cede9036f5e81f259b8f3e9...13d2b086386196e9f4f03e4a18d508a65f6fc5ff,4,13,12,25,11,2013-04-01 19:56:50,2013-03-30 07:22:24
13d2b086386196e9f4f03e4a18d508a65f6fc5ff...887f509d1dd2a5e34fbfb19ccd2c4b1eb3127dbd,1,1,1,2,1,2013-04-01 19:56:59,2013-03-30 07:36:27
c9a13147fe98c8b5b55eb28deca8147f10906012...321d94b17e0b23754cb8c5858c11bef554ec8279,2,73,24,97,13,2013-04-01 16:35:04,2013-04-01 16:28:54
c9a13147fe98c8b5b55eb28deca8147f10906012...6b59cc8a1031d78530efb7582c936ba8221da847,1,13,6,19,8,2013-04-01 13:51:56,2013-04-01 13:49:51
c9a13147fe98c8b5b55eb28deca8147f10906012...cfeed391d76105e4131a021d2005966d01eb4e68,1,32,60,92,13,2013-04-01 03:52:35,2013-04-01 03:52:35
cfeed391d76105e4131a021d2005966d01eb4e68...ad1e8a9b0f0e57327d71827c1161c21f48910e42,1,66,0,66,1,2013-04-01 04:48:18,2013-04-01 04:48:18
70853785b6f04337168343d8889eba413a40ce54...ba33d67a1a0f3310bddab8176a9d570e5d5c00e2,1,13,0,13,2,2013-03-29 01:44:47,2013-03-29 01:44:47
19040035116edf70a42bc825785de6b3f637c120...7f79fabaeeb642ae344c7ce1796034bc0021bbc1,1,1,0,1,1,2013-03-26 19:52:11,2013-03-26 19:52:11
19040035116edf70a42bc825785de6b3f637c120...75a116bdaa6f1f734ec73e4fe4a1ef6f810d10ff,3,36,10,46,12,2013-03-26 19:14:58,2013-03-26 19:14:58
2ee3db6cd28b20adb03c3b5114b48030a2ab065e...141b5fc7d77fbe99fd42fb603688b842a5be34dd,1,7,16,23,4,2013-03-26 23:29:44,2013-03-26 20:46:27
141b5fc7d77fbe99fd42fb603688b842a5be34dd...9518503ebed1e4165d25e3c5b5164e61f457c14c,1,0,2,2,2,2013-03-26 23:29:53,2013-03-26 20:54:28
9518503ebed1e4165d25e3c5b5164e61f457c14c...a8ae0aafe36664ce3e28909045f5aff016370035,1,26,0,26,2,2013-03-26 23:54:13,2013-03-26 23:54:13
e260e808149d5ac4d0bfc4822d056a53fb277e66...5cec37de53d2ec207c2b1723bc694bcea9c57e7c,1,1,1,2,1,2013-03-26 22:24:26,2013-03-26 22:24:26
1d6929c8bc6cbc5ad63dce083869460b6bb377ad...37a78902db9e968d307d0c0325612e8bef20bc69,3,9,1,10,6,2013-04-01 18:52:45,2013-04-01 18:12:56
37a78902db9e968d307d0c0325612e8bef20bc69...e566b89a5f13f36fad2e2bb37faf9079e06e051e,1,1,1,2,1,2013-04-01 21:31:33,2013-04-01 21:31:33
e566b89a5f13f36fad2e2bb37faf9079e06e051e...5471f5b2ee4bd637147a1ea1dce716670b50796d,1,4,1,5,1,2013-04-02 14:58:19,2013-04-02 14:38:08
1d6929c8bc6cbc5ad63dce083869460b6bb377ad...9740102990b059d014fad5f8652306cf7ff62d94,1,55,3,58,6,2013-03-29 18:39:41,2013-03-28 19:11:47
1d6929c8bc6cbc5ad63dce083869460b6bb377ad...58befe3081726ef74ea09198cd9488fb42c51f51,2,23,5,28,6,2013-03-29 11:55:48,2013-03-29 11:42:17
1d6929c8bc6cbc5ad63dce083869460b6bb377ad...d52451bcf887790df5a6a7cbbc7305747535eb11,1,3,3,6,5,2013-03-29 10:00:50,2013-03-29 10:00:50
1d6929c8bc6cbc5ad63dce083869460b6bb377ad...6d72758f1268f710be635cb16ef8e001fc6516a5,1,2,2,4,2,2013-03-29 05:07:25,2013-03-29 05:07:25
f483b214bb3e1f2586e5caca61e3c8384f0ad2e4...64376481767a6a4a1d2b90b225a6ac5bf6bc16f9,13,335,17,352,28,2013-03-30 00:30:10,2013-03-30 00:30:10
64376481767a6a4a1d2b90b225a6ac5bf6bc16f9...e9d17b1f9155160d5601b756b6c9df3f60d02b00,1,0,3,3,1,2013-03-30 00:38:31,2013-03-30 00:38:31
f483b214bb3e1f2586e5caca61e3c8384f0ad2e4...e99541e63729343e908b7c2ab6c901504f1311a3,14,353,27,380,13,2013-03-29 21:57:31,2013-03-29 21:56:48
e99541e63729343e908b7c2ab6c901504f1311a3...8ea1e9126f3d64216e2d8a91ce6f8ad1f3d8587c,11,405,0,405,11,2013-04-11 04:00:39,2013-04-11 04:00:39
8ea1e9126f3d64216e2d8a91ce6f8ad1f3d8587c...b14164879b4461b77b630719e67d619acf1a7648,3,39,339,378,3,2013-04-12 00:39:47,2013-04-12 00:39:47
b14164879b4461b77b630719e67d619acf1a7648...f226842aa1f9148449558c90de7cdfb61105df28,1,16,0,16,1,2013-04-12 03:17:41,2013-04-12 03:17:41
f483b214bb3e1f2586e5caca61e3c8384f0ad2e4...68278b66c5294690d051d6a0fe157e2b965d7b1a,1,13,5,18,3,2013-03-29 21:36:36,2013-03-29 21:09:25
f483b214bb3e1f2586e5caca61e3c8384f0ad2e4...9442d6b349295818d9a0ddecc10ca19019ead935,1,12,19,31,5,2013-03-29 14:49:26,2013-03-29 14:49:26
f483b214bb3e1f2586e5caca61e3c8384f0ad2e4...232dbb186416df290fc698e92b3a120b92497559,1,98,30,128,34,2013-03-29 14:44:58,2013-03-29 14:44:58
ff26493fd5ac1205e5f9d23b976e759730a3229c...91b1f9eee9729fc9845eaecdad88a7a5050a33de,1,4,0,4,1,2013-04-01 05:42:10,2013-04-01 05:42:10
3478d6f7061e0d71c040fd8f7ba9b51bf00907c3...8fed600077d5b8d976adec27dfb822166ca7baa5,1,2,2,4,2,2013-04-02 10:00:21,2013-04-02 10:00:21
6bf4a10ed4c0f61fd9bd4b13370524eb5b0f47d6...54fa59c8ec0e20c709cc7b2049f19271750adaab,1,7,1,8,2,2013-03-26 20:14:44,2013-03-26 20:14:44
6bf4a10ed4c0f61fd9bd4b13370524eb5b0f47d6...2664139da48d0c9f5ff20e2049242ce159301ed8,1,11,0,11,1,2013-03-26 20:07:06,2013-03-26 20:07:06
75a116bdaa6f1f734ec73e4fe4a1ef6f810d10ff...3813fa8a16ae7e622375182127f764995faf3c53,1,1,1,2,1,2013-03-26 19:34:23,2013-03-26 19:34:23
f15889461d6aeebfb06835823ed67266a6d9042f...81874ad4425ed1a3520944bfcced271041e7b0f4,7,74,73,147,43,2013-04-02 02:11:09,2013-04-02 02:11:09
db08705e3c61eb44afe34d28409573b7cb70ea98...1ec6c223c9e3a22e9cf182d1d4d69f16a9d083f4,1,94,0,94,1,2013-04-14 22:13:32,2013-04-14 22:13:32
d1ed28cb941578b07420a507886ddebaed78deb8...0bdfcfaa33b4945fdfd6ff9ea82bf3c5aa63848d,2,33,1,34,9,2013-03-30 15:02:22,2013-03-30 13:37:06
0bdfcfaa33b4945fdfd6ff9ea82bf3c5aa63848d...75ba07cb3a7fcf5d6cc9f1120fd3468a9658be67,1,9,24,33,10,2013-03-30 15:04:19,2013-03-30 13:44:00
75ba07cb3a7fcf5d6cc9f1120fd3468a9658be67...a83d87abd442dda5f2d67a2701aae9c7b891e68a,3,6,6,12,6,2013-04-02 08:45:17,2013-04-02 08:45:17
b013d937869372a352387d3441f1c36428f958c3...99b36c2c326ccc11e726eee6ee78a0baf166ef96,1,26,0,26,16,2013-03-30 04:13:59,2013-03-30 04:13:59
b013d937869372a352387d3441f1c36428f958c3...0f7a4534c16cda07344a7231d6012268f4aa53aa,2,9,8,17,3,2013-03-29 15:46:06,2013-03-29 15:46:06
b013d937869372a352387d3441f1c36428f958c3...ccac5b138253ab87846089cb5af9b4b77a7fd9d5,2,29,3,32,13,2013-03-29 15:18:43,2013-03-29 15:18:43
ccac5b138253ab87846089cb5af9b4b77a7fd9d5...d17f78c373d5d8cd015626c7972e0e2365eab2a7,2,15,17,32,17,2013-03-29 15:19:42,2013-03-29 15:19:42
d17f78c373d5d8cd015626c7972e0e2365eab2a7...69c2250ec2fd23dc9d31372cb433b7c18a917d09,1,13,4,17,3,2013-03-29 15:29:59,2013-03-29 15:29:59
69c2250ec2fd23dc9d31372cb433b7c18a917d09...7a565a0479b6a797a0cdc9a4156e57ce811032b3,1,1,3,4,1,2013-03-29 15:41:48,2013-03-29 15:41:48
8edf0ca7f35c54ed0184ed0b7e086f1bd8ce5e63...c780ff5ae726bc8acd30b9ef476cd111c477ec35,2,14,4,18,7,2013-04-02 14:01:43,2013-04-02 14:01:43
c780ff5ae726bc8acd30b9ef476cd111c477ec35...02c211a0dca91bb3744b6c1301e372799189881f,1,12,12,24,9,2013-04-02 14:13:42,2013-04-02 14:13:42
02c211a0dca91bb3744b6c1301e372799189881f...791ca6fde47d26a96134b1715580303ea6cd17ed,3,12,4,16,5,2013-04-02 17:06:49,2013-04-02 17:06:49
791ca6fde47d26a96134b1715580303ea6cd17ed...7b74b9cab50ecd12ca2af51116279fce97edadd8,1,1,2,3,1,2013-04-03 12:37:45,2013-04-03 12:37:45
7b74b9cab50ecd12ca2af51116279fce97edadd8...d1767bbf672355b9063099d641106dd4ea5303b3,3,6,4,10,3,2013-04-03 12:39:39,2013-04-03 12:39:39
d1767bbf672355b9063099d641106dd4ea5303b3...ad0183e41978b3b156234f801750034912915223,2,4,5,9,3,2013-04-03 17:48:02,2013-04-03 17:48:02
927308cfd94832308bd409276e3f786972d3ef5a...76663079312bb501f545823d9650df9eeda2c882,2,4,2,6,2,2013-04-02 17:58:16,2013-04-02 17:58:16
47c4c2abd42d06d14d28f894b4ba980d61f94f5c...cc2558bf10817b086fcb9783474d47db24d2cb3a,1,2,3,5,1,2013-04-01 21:34:12,2013-04-01 21:34:12
1ec6c223c9e3a22e9cf182d1d4d69f16a9d083f4...2a47df020246cc08a0b72cf355c9d803404245b3,1,1,9,10,1,2013-04-15 18:44:11,2013-04-15 18:44:11
1ec6c223c9e3a22e9cf182d1d4d69f16a9d083f4...468fb901172f2534972cc44cd4459f14b3745a98,1,1,1,2,1,2013-04-15 15:49:48,2013-04-15 15:49:48
41555f67e077a2d8e91ba565fdc215020bd1700b...5252ab697c927d7b51109a1bb1a68d6a3dfc88b3,1,24,0,24,5,2013-03-30 16:05:53,2013-03-30 16:05:53
5252ab697c927d7b51109a1bb1a68d6a3dfc88b3...7efde5eb8350ad709608e619b01af4108cc9d567,1,2,1,3,1,2013-03-30 16:07:54,2013-03-30 16:07:54
7efde5eb8350ad709608e619b01af4108cc9d567...47607494027be3d37cbb01a07e026e99f9c5151b,1,5,0,5,1,2013-03-30 16:08:53,2013-03-30 16:08:53
47607494027be3d37cbb01a07e026e99f9c5151b...b336d928febc0f9212d56b28430bbdf37d2cfcda,1,20,8,28,4,2013-03-30 16:47:09,2013-03-30 16:47:09
b336d928febc0f9212d56b28430bbdf37d2cfcda...99f9b697165f1f081499b45b7789508dcf0c2553,2,16,0,16,3,2013-03-30 17:33:10,2013-03-30 17:33:10
d0d5d5ff094a5c03a6b13a18394108cda126eef2...0b2eee8b33448c27c4d2b29b995a56ce3a411963,1,2,0,2,2,2013-03-29 16:31:47,2013-03-29 16:31:47
6d001450766aa2067e0a2039c88bc359647b61a1...7ad2e022fb737286b5803066bde6919e2d544c4e,1,23,0,23,1,2013-04-01 23:02:02,2013-04-01 23:02:02
7ad2e022fb737286b5803066bde6919e2d544c4e...ff5cb8e864b87d3976b368ae544010f5736d1da2,1,5,1,6,1,2013-04-01 23:04:44,2013-04-01 23:04:44
6d001450766aa2067e0a2039c88bc359647b61a1...dcc9dfb27d49c7e7f58e04bf5656656f69e76fe1,1,3,1,4,4,2013-04-01 22:26:17,2013-03-28 05:50:33
dcc9dfb27d49c7e7f58e04bf5656656f69e76fe1...f65fc1e766cefed06131acf1ede6bb1f25f75fff,2,3,0,3,3,2013-04-01 22:26:17,2013-04-01 20:03:24
6d001450766aa2067e0a2039c88bc359647b61a1...650dff73bdd48058ec0186cbda90683ff2287df0,1,1,1,2,1,2013-04-01 21:50:25,2013-04-01 21:50:25
15c3096e8942ac31eb5611b41d08fcc31061be65...dce5a06aba8e79e8e5fe5724676961319def6001,1,1,1,2,1,2013-04-03 22:35:32,2013-04-03 22:35:32
15c3096e8942ac31eb5611b41d08fcc31061be65...3b65be9127865fd894edea4d0b7de0ab92421018,1,2,2,4,2,2013-04-03 22:32:46,2013-04-03 22:32:46
3b65be9127865fd894edea4d0b7de0ab92421018...32f58114766886fc38b66949bc3c0625dc225ade,1,2,2,4,2,2013-04-04 20:07:10,2013-04-04 19:56:37
15c3096e8942ac31eb5611b41d08fcc31061be65...4f36039e7b5c7054fdbf3eb328c242e7acb6d7f8,2,11,11,22,7,2013-04-03 14:06:35,2013-04-03 14:06:35
15c3096e8942ac31eb5611b41d08fcc31061be65...b74d1c92479bc6df61e7283f7639b02837bfb5f3,1,1,1,2,1,2013-04-03 13:37:56,2013-04-03 13:37:56
15c3096e8942ac31eb5611b41d08fcc31061be65...cf8b8c1969daa423a1308561f3c1b2b863c64655,26,275,303,578,27,2013-04-03 12:55:18,2013-04-02 01:52:44
15c3096e8942ac31eb5611b41d08fcc31061be65...3b8c2417fbeaf84c4fb35e30f4c1a32ffcb51a59,1,1,1,2,1,2013-04-03 09:04:33,2013-04-03 09:04:33
3b8c2417fbeaf84c4fb35e30f4c1a32ffcb51a59...5ecd940a594507075e6cee80aa70c258a9d850ca,1,2,3,5,2,2013-04-03 09:08:32,2013-04-03 09:08:32
5ecd940a594507075e6cee80aa70c258a9d850ca...1fc55c2bb9bce1451d6199e8aaa23ef8baa0e46c,1,3,3,6,2,2013-04-03 09:11:06,2013-04-03 09:10:50
1fc55c2bb9bce1451d6199e8aaa23ef8baa0e46c...cab31fd5128fbfcc2f1b44d3d643fe96a28c88fc,1,1,1,2,1,2013-04-03 09:11:34,2013-04-03 09:11:34
cab31fd5128fbfcc2f1b44d3d643fe96a28c88fc...22f1cc955dbf25132e69d126f8db0e5498bffbd2,3,3,3,6,3,2013-04-03 09:18:23,2013-04-03 09:18:23
22f1cc955dbf25132e69d126f8db0e5498bffbd2...14d3880daf9bdfe52248b5b0548a5522161baf2c,1,0,1,1,1,2013-04-03 09:19:48,2013-04-03 09:19:48
15c3096e8942ac31eb5611b41d08fcc31061be65...43484e8b502be1dbf2e587524ae8ef036181b186,1,56,0,56,1,2013-04-02 16:22:30,2013-04-02 16:22:30
43484e8b502be1dbf2e587524ae8ef036181b186...6882c78ce447b468262b53aef2ac0577151ea98c,3,39,16,55,11,2013-04-02 19:18:20,2013-04-02 19:18:20
6882c78ce447b468262b53aef2ac0577151ea98c...ad2bbe23be869e3a3287cedbf0408115e97a4a49,1,9,2,11,2,2013-04-02 19:19:01,2013-04-02 19:19:01
ad2bbe23be869e3a3287cedbf0408115e97a4a49...a19a9e3ca81880f030a7621a9e03ffb63c95b1f1,1,3,1,4,1,2013-04-02 19:21:35,2013-04-02 19:21:35
d6fb2a0836de056d79f4887eabfc2d79e8518988...b1fa26bb76501c53f68de466538da1eece57d94d,1,23,0,23,3,2013-04-03 02:00:05,2013-04-03 02:00:05
2a47df020246cc08a0b72cf355c9d803404245b3...1615bb08c7c3fc6c4b22db0a633edda516f97cf0,3,11,9,20,8,2013-04-17 09:56:30,2013-04-16 16:43:44
1615bb08c7c3fc6c4b22db0a633edda516f97cf0...90602ab62a4dddadff6671d80815465556a267ee,1,1,1,2,1,2013-04-18 14:03:50,2013-04-18 14:03:50
2a47df020246cc08a0b72cf355c9d803404245b3...fc72a809c1c60569fb1d70a95f5296feaa5220f8,1,1,1,2,1,2013-04-16 19:10:16,2013-04-16 19:10:16
2a47df020246cc08a0b72cf355c9d803404245b3...a11b31399b51a3d5bfd0696e13439196915bbbbb,3,68,0,68,4,2013-04-16 17:53:08,2013-04-11 02:48:21
5a2a044e2484bd0fa8f41a35d8773a99bdf89734...0b9a3c86a26b4b7eb463a6c73cb030bc851fdd64,5,175,7,182,17,2013-03-31 09:02:01,2013-03-31 09:02:01
0b9a3c86a26b4b7eb463a6c73cb030bc851fdd64...8293a0d53350b9ebb584988efe3096c313a13ad4,1,1,1,2,1,2013-03-31 09:18:04,2013-03-31 09:18:04
8293a0d53350b9ebb584988efe3096c313a13ad4...a6779bcae2df4805b8024c56f81ee3afac46ff93,1,1,0,1,1,2013-03-31 09:44:56,2013-03-31 09:44:56
0b2eee8b33448c27c4d2b29b995a56ce3a411963...0ebdca5e6144b0176a4b161cb1bd40efc0dc7efe,1,111,1,112,2,2013-03-29 17:56:49,2013-03-29 17:56:49
0b2eee8b33448c27c4d2b29b995a56ce3a411963...81eac415ad03d93596a0d8da92bdccd9ecd4ee63,1,0,1,1,1,2013-03-29 16:42:42,2013-03-29 16:42:42
81eac415ad03d93596a0d8da92bdccd9ecd4ee63...8cceafc8348f8e9de71b09274458848cd8e8de6d,1,128,0,128,1,2013-03-30 13:55:47,2013-03-30 13:55:47
0e1781af26c3d7770ee6b50955f9f947790baf6d...a05af3ebf32da594648352a30b9045c67ba9cbbb,1,2,3,5,3,2013-04-03 01:37:29,2013-04-03 01:37:29
ff5cb8e864b87d3976b368ae544010f5736d1da2...c808940c041ca8c7f9f9c5e0fa93e37ebfdd412a,2,98,93,191,10,2013-04-02 06:52:20,2013-04-02 06:52:20
c808940c041ca8c7f9f9c5e0fa93e37ebfdd412a...8f9e4542417421ee62ac952d1e04268520a75d8f,1,10,0,10,2,2013-04-02 18:00:14,2013-04-02 18:00:14
8f9e4542417421ee62ac952d1e04268520a75d8f...aea2675f7b2e4aa8bf63c8472af40bc059bd5d14,2,4,1,5,2,2013-04-02 18:02:19,2013-04-02 18:02:19
aea2675f7b2e4aa8bf63c8472af40bc059bd5d14...1cc1cb099ed8fb0e4fc47debe38a33d17e211a65,1,6,6,12,2,2013-04-02 18:06:42,2013-04-02 18:06:42
1cc1cb099ed8fb0e4fc47debe38a33d17e211a65...2db358146f8bc0f63d840c8e0227bcbe7a8e3063,1,9,5,14,1,2013-04-02 18:07:49,2013-04-02 18:07:49
2db358146f8bc0f63d840c8e0227bcbe7a8e3063...c77063afcd00f97c6922c41e509090dd4f8c2b95,1,58,0,58,3,2013-04-03 01:05:19,2013-04-03 01:05:19
c77063afcd00f97c6922c41e509090dd4f8c2b95...c04af2a330991fcd52bcce213bcb863cff95d378,2,87,40,127,9,2013-04-03 01:07:16,2013-04-03 01:07:16
ff5cb8e864b87d3976b368ae544010f5736d1da2...3c5d2e4661e76e83e35637561153578ddd87f249,1,3,0,3,2,2013-04-01 23:16:28,2013-04-01 23:16:28
3c5d2e4661e76e83e35637561153578ddd87f249...0ddc6867fb86d2539bb19034844ac8c2369060c1,1,2,2,4,2,2013-04-01 23:19:34,2013-04-01 23:19:34
e331f1ee0e3333c62f9e04e9deac060e8ea01953...90db9e751750e62ea701843491774323ef20ab06,1,2,2,4,2,2013-04-02 01:35:54,2013-04-02 01:26:00
dce5a06aba8e79e8e5fe5724676961319def6001...92186d7cf71acbf4027e390b33590570cf4ff290,4,8,4,12,4,2013-04-04 05:23:17,2013-04-04 05:21:57
dce5a06aba8e79e8e5fe5724676961319def6001...5d3c0767dab1679686933a9b4cf4ddde19bc0faf,1,6,48,54,5,2013-04-04 05:14:28,2013-04-04 05:14:28
c4d3da58710d0b84754ab9f9c27aee0771a45574...ebc837957fb45c4ba4768a2344ea7b551bbb86e5,1,3,0,3,1,2013-04-04 22:16:42,2013-04-04 22:16:42
fc72a809c1c60569fb1d70a95f5296feaa5220f8...c4cd224d901ece4d9a2f15d10a80998f2b970c07,1,7,5,12,6,2013-04-16 22:20:04,2013-04-16 22:20:04
c4cd224d901ece4d9a2f15d10a80998f2b970c07...ca6cd5b557279facb4831e8380be4eb40ac38362,1,2,11,13,4,2013-04-17 18:32:13,2013-04-17 18:32:13
fc72a809c1c60569fb1d70a95f5296feaa5220f8...7b0e96f1f4639f869703ed32f885cec9b666b127,2,19,16,35,7,2013-04-16 21:32:50,2013-04-16 07:25:55
92cd75607b1a223c084939067dc60b2773821b23...c0d5d5969bb9c0bfe79e7a11977697e50cc185ae,5,128,72,200,16,2013-04-18 01:13:43,2013-04-18 01:13:43
c0d5d5969bb9c0bfe79e7a11977697e50cc185ae...79e910580604339a74c1577061d8b207ae8c2ee1,4,273,56,329,22,2013-04-18 16:56:22,2013-04-18 16:56:22
79e910580604339a74c1577061d8b207ae8c2ee1...b295239de20f15620ee4149fcc7c13ce461cdaac,5,713,38,751,41,2013-04-19 13:24:37,2013-04-19 13:24:37
b295239de20f15620ee4149fcc7c13ce461cdaac...1aa7f1392de665a6c8f751f53e1f7bb7bb6bf4f3,3,438,969,1407,142,2013-04-22 16:17:47,2013-04-22 16:17:47
1aa7f1392de665a6c8f751f53e1f7bb7bb6bf4f3...6ce475dbdf97fd5e721a150c58d92d6819e5decb,4,50,11,61,11,2013-04-22 21:37:22,2013-04-22 21:37:22
6ce475dbdf97fd5e721a150c58d92d6819e5decb...cf19be44a8eb9b790ba3bef29f851dc65cb61c3c,5,327,254,581,121,2013-04-23 16:20:53,2013-04-23 16:20:53
cf19be44a8eb9b790ba3bef29f851dc65cb61c3c...1e357c69690f5325d92ae7c41e396711865382f0,3,135,58,193,34,2013-04-24 12:01:40,2013-04-24 12:01:40
1e357c69690f5325d92ae7c41e396711865382f0...79512b2a8025184d647de61cdd6a19ebadd17a49,3,53,11,64,10,2013-04-24 14:06:30,2013-04-24 14:06:03
79512b2a8025184d647de61cdd6a19ebadd17a49...c7bbe7ca797ad2f4eb0fff3d58e8eaaa72756036,2,60,19,79,9,2013-04-24 14:32:51,2013-04-24 14:32:51
c7bbe7ca797ad2f4eb0fff3d58e8eaaa72756036...75c0dc9526766719f6e528c48e63001596042071,1,3,19,22,4,2013-04-24 16:50:26,2013-04-24 16:50:26
0a3131554c7f7feeba08900ccbca1b27779dbc3a...13d9e26edd62228597cf8f060ed397f7ae00298a,2,28,1,29,3,2013-04-17 23:35:22,2013-04-17 23:35:22
13d9e26edd62228597cf8f060ed397f7ae00298a...e34e44e8e6097e0a54bc0a96581f79909f7d9a42,1,1,1,2,1,2013-04-18 00:12:08,2013-04-18 00:12:08
e34e44e8e6097e0a54bc0a96581f79909f7d9a42...4ef2d5c1e6e65b1e214071388618fc9fa4345be9,6,14,12,26,14,2013-04-18 02:58:17,2013-04-18 02:58:17
4ef2d5c1e6e65b1e214071388618fc9fa4345be9...227a8142a3c2ea2fd3b085214ef39989ebd57fe1,1,2,1,3,2,2013-04-18 03:13:11,2013-04-18 03:13:11
227a8142a3c2ea2fd3b085214ef39989ebd57fe1...ee82870ff78e6d9e0f0ce7674d6a065f9d02f67a,1,1,1,2,1,2013-04-18 03:18:35,2013-04-18 03:18:35
a6779bcae2df4805b8024c56f81ee3afac46ff93...3dcaf20d6bf912cbc3eb689302d41047f9cd0f82,1,19,1,20,4,2013-04-01 00:40:39,2013-04-01 00:40:39
3dcaf20d6bf912cbc3eb689302d41047f9cd0f82...8c36e6920a9e17171dc67a79ab20d39886404e73,1,37,4,41,2,2013-04-01 03:14:54,2013-04-01 03:14:54
a6779bcae2df4805b8024c56f81ee3afac46ff93...d949e2804a35497bc041537734dfeff150ea7e21,2,37,0,37,2,2013-03-31 21:15:10,2013-03-31 21:15:10
a6779bcae2df4805b8024c56f81ee3afac46ff93...b64dfdd8cd636c5138dbd700f60e41651bae3e15,1,1,1,2,1,2013-03-31 20:04:41,2013-03-31 20:04:41
b64dfdd8cd636c5138dbd700f60e41651bae3e15...1fc9405537a1c528a59356ec36189a61db146701,1,8,6,14,6,2013-03-31 20:53:47,2013-03-31 20:53:47
0ebdca5e6144b0176a4b161cb1bd40efc0dc7efe...2d4c5ddbdd3258dfd079e3e1f38253e4e6e5a16b,1,16,16,32,4,2013-03-30 06:58:30,2013-03-30 06:58:30
3de51b7bfe27bd744470ee1e80dec8eb0c49f6de...8bfbdd7afa504a1ddb09d026feb4d20eac4b4dd5,3,8,3,11,3,2013-04-05 01:38:43,2013-04-05 01:38:43
8bfbdd7afa504a1ddb09d026feb4d20eac4b4dd5...0424998f3885b715ad0fae074170a9be19c95680,1,1,1,2,1,2013-04-05 02:14:10,2013-04-05 02:14:10
a76c3a9c9580135d349e68a4b2494a0b26ebe01b...e49af5b6def4e69ae234549fbcd2dd2987949cab,1,1,26,27,3,2013-04-19 23:33:25,2013-04-19 23:33:25
e49af5b6def4e69ae234549fbcd2dd2987949cab...97535e5a6466dcad6ed9767960e869eadf68204f,1,76,0,76,1,2013-04-23 00:51:09,2013-04-23 00:51:09
a76c3a9c9580135d349e68a4b2494a0b26ebe01b...d8416539b3b068a6a1a17f6dba441913b648a774,1,3,0,3,1,2013-04-19 22:55:34,2013-04-19 22:55:34
75c0dc9526766719f6e528c48e63001596042071...30cb4b351f3513a6ebec89183def0647346b5708,2,78,46,124,25,2013-04-29 09:46:31,2013-04-26 13:08:33
75c0dc9526766719f6e528c48e63001596042071...a48eb4dff869631221854bb85380c15bf7b9d0eb,2,78,46,124,25,2013-04-26 13:08:33,2013-04-26 13:08:33
ee82870ff78e6d9e0f0ce7674d6a065f9d02f67a...deb55e416e068a9b51c5973dfeeb2bb2ce6fd1be,1,1,1,2,1,2013-04-18 21:46:17,2013-04-18 21:46:17
deb55e416e068a9b51c5973dfeeb2bb2ce6fd1be...3ae5c45d9a75befdd144d689a70c32180b0a16c6,2,25,21,46,6,2013-04-19 05:22:00,2013-04-19 05:22:00
3ae5c45d9a75befdd144d689a70c32180b0a16c6...79a78d37e7102f0aadfa49d89b84b095e86824d1,1,16,11,27,8,2013-04-19 05:24:29,2013-04-19 05:24:29
79a78d37e7102f0aadfa49d89b84b095e86824d1...3d2fd8a65024a503456fc8cd64d4d2565c73e304,1,1,1,2,1,2013-04-19 05:24:52,2013-04-19 05:24:52
3d2fd8a65024a503456fc8cd64d4d2565c73e304...e8a67f632ea2e83c24f32c243b72fd7653e94d4b,1,15,22,37,7,2013-04-19 05:37:45,2013-04-19 05:37:45
ee82870ff78e6d9e0f0ce7674d6a065f9d02f67a...84c13a3dcf8a0f884d3b95b8f3515e0040816691,1,25,0,25,1,2013-04-18 14:17:31,2013-04-18 14:17:31
84c13a3dcf8a0f884d3b95b8f3515e0040816691...7eda9c64b80ff43af5e90b37a3830615034fefee,1,22,6,28,6,2013-04-18 14:20:23,2013-04-18 14:17:57
ee82870ff78e6d9e0f0ce7674d6a065f9d02f67a...fd39af7f859b5bd1c202b4c0ddee53de9c82437d,8,0,0,0,0,2013-04-18 03:56:34,2013-04-12 18:42:35
fd39af7f859b5bd1c202b4c0ddee53de9c82437d...523cd8e29cb871271a8e2a55ab009aa980ae5572,10,408,288,696,20,2013-04-18 03:56:34,2013-04-16 01:01:54
523cd8e29cb871271a8e2a55ab009aa980ae5572...8e6ba343bfb93ed7782d50a3ac1b581ae0e1fb00,5,22,10,32,9,2013-04-18 04:10:53,2013-04-18 04:10:53
d949e2804a35497bc041537734dfeff150ea7e21...6f9a67a7c7cb717ad1a575df3e4c0fd2ec8bc651,4,200,113,313,37,2013-04-01 04:02:44,2013-03-30 22:32:10
0424998f3885b715ad0fae074170a9be19c95680...f344212b93cc1de672a6a09906b719c2e287d558,1,2,2,4,2,2013-04-05 02:49:32,2013-04-05 02:49:32
f344212b93cc1de672a6a09906b719c2e287d558...a5fb1d6c0105bb6d93c6b6890aa33bd99115973a,1,42,25,67,11,2013-04-05 05:56:12,2013-04-05 05:56:12
a5fb1d6c0105bb6d93c6b6890aa33bd99115973a...2aad4a34785a1b0d02d910a14dbb9b0d6d3edc17,2,50,17,67,12,2013-04-05 05:58:01,2013-04-05 05:58:01
2aad4a34785a1b0d02d910a14dbb9b0d6d3edc17...a4fc52305abfcbc3976fa203898a1c3c8409a292,1,1,1,2,1,2013-04-05 06:05:03,2013-04-05 06:05:03
a4fc52305abfcbc3976fa203898a1c3c8409a292...d32f184696519f909d1db56a060b39f0a08b41c5,1,1,4,5,2,2013-04-05 20:03:04,2013-04-05 20:03:04
d32f184696519f909d1db56a060b39f0a08b41c5...febaeebfb8848265267213b2f6a6fc3a40ad90f1,2,38,0,38,3,2013-04-05 20:03:24,2013-04-05 20:03:24
0424998f3885b715ad0fae074170a9be19c95680...f39af7e05da437d6ac95b19ccfa401598d1fb5d9,3,11,4,15,5,2013-04-03 23:15:43,2013-04-03 21:53:09
f39af7e05da437d6ac95b19ccfa401598d1fb5d9...90a6e310fe4c70b99f9fa5c8d8615e2382edba0b,2,48,0,48,2,2013-04-03 23:15:43,2013-04-03 21:53:54
90a6e310fe4c70b99f9fa5c8d8615e2382edba0b...d9a9bfc9c7bee2e4316debcd9f393b8f2fb1e45a,2,3,1,4,3,2013-04-03 23:15:44,2013-04-03 22:05:03
d9a9bfc9c7bee2e4316debcd9f393b8f2fb1e45a...aa4bf4284b4d18874544368349cb9575d8412de8,1,79,1,80,3,2013-04-03 23:17:03,2013-04-03 22:57:57
aa4bf4284b4d18874544368349cb9575d8412de8...1b370f9d8dbd1c476db766e8587617e795570d97,3,7,3,10,3,2013-04-04 12:33:28,2013-04-04 12:33:28
d8416539b3b068a6a1a17f6dba441913b648a774...3bfb70db243d35b969eba9781dec619b7c52be98,1,1,0,1,1,2013-04-20 01:06:13,2013-04-20 01:06:13
22f5e35579c5cc4bbe191b92517d67a3ae88c2a3...e5104a4cb4fe68ecd17b5a01ce295c64f8107b42,3,60,12,72,12,2013-04-29 13:12:18,2013-04-29 13:12:18
e5104a4cb4fe68ecd17b5a01ce295c64f8107b42...131c6ab3e6461eb1a985a8eb0a64b59e1b990810,2,73,44,117,13,2013-04-29 15:46:41,2013-04-29 15:46:41
131c6ab3e6461eb1a985a8eb0a64b59e1b990810...36b968bb09b72366b21b74439eeba463317d2320,3,99,54,153,23,2013-04-30 15:04:31,2013-04-30 15:04:31
36b968bb09b72366b21b74439eeba463317d2320...a4bcf7e1ac19dbf4c2e4f65af4addc1bfc47d567,3,215,245,460,63,2013-05-02 03:07:06,2013-05-02 03:07:06
e8a67f632ea2e83c24f32c243b72fd7653e94d4b...003622c8b6587814744a9903f3286dc1b07554c2,2,112,1,113,6,2013-04-19 03:47:24,2013-04-19 03:47:24
003622c8b6587814744a9903f3286dc1b07554c2...640efc2ed2244dc16e161cc954af59d20a5e6ed2,3,24,4,28,8,2013-04-19 03:55:41,2013-04-19 03:55:41
640efc2ed2244dc16e161cc954af59d20a5e6ed2...f68d107a1368b3d4f3342456a2b0675659688354,5,10,16,26,8,2013-04-19 04:08:20,2013-04-19 04:08:20
f68d107a1368b3d4f3342456a2b0675659688354...2d32ac8cffe08b9c5d562e6ea30c796ae32b8fe1,1,8,4,12,1,2013-04-19 04:08:33,2013-04-19 04:08:33
2d32ac8cffe08b9c5d562e6ea30c796ae32b8fe1...c42a4179fc6954a2363b181969978641553955c4,1,33,0,33,1,2013-04-19 04:34:34,2013-04-19 04:34:34
c42a4179fc6954a2363b181969978641553955c4...f3e89fae287778cb8b7056e228170e0073c9a046,2,26,3,29,4,2013-04-19 04:57:58,2013-04-19 04:57:58
bfb84b564c452e2b5cdb950c8c1b0c53b17f50c1...152a9f77b4475bcec95ac58229c5db0e24b42557,1,3,1,4,2,2013-04-19 19:39:40,2013-04-19 19:39:40
29b7ecb0177164c148498b1a2fd7b9124ae7741a...54443c092caf9c1e11c47ea30400084d009af6e9,1,1,1,2,1,2013-04-01 05:04:59,2013-04-01 05:04:59
54443c092caf9c1e11c47ea30400084d009af6e9...a52a28b60946463e8208b8cd5d737ba79f23a8b8,2,9,1,10,3,2013-04-01 05:05:14,2013-04-01 05:05:14
a52a28b60946463e8208b8cd5d737ba79f23a8b8...1632566ecb133fb0853aec6715c5c06a4a9e41da,6,61,19,80,18,2013-04-01 05:11:55,2013-04-01 05:11:55
793c1ad9909701a8b89ac6731ac266048e48ec46...22adb52c0aaf4ff53d37eb45566d6aeeb907ed09,1,1,1,2,1,2013-04-05 21:16:04,2013-04-05 21:16:04
22adb52c0aaf4ff53d37eb45566d6aeeb907ed09...8cf30395a1a338c7c34adda0ae59ba8b2f9370cd,1,1,1,2,1,2013-04-05 21:16:19,2013-04-05 21:16:19
0b0d958b88db5de966652de50033e4653afb5a7c...97badbd29e15296b2b4cb55b01246f658c5e9de6,1,1,1,2,1,2013-04-23 05:04:57,2013-04-23 05:04:57
97badbd29e15296b2b4cb55b01246f658c5e9de6...82b8f7a565ec1fdd82644ef715767ea93d95a0b0,3,43,0,43,3,2013-04-23 05:29:12,2013-04-23 05:29:12
0eb425426f47199fb5b343dcd6c5410af87f0446...cc5a044a8c140e32868bb0f312f3780161515f0b,1,2,5,7,1,2013-04-20 00:51:41,2013-04-20 00:51:41
cc5a044a8c140e32868bb0f312f3780161515f0b...931ca464a7db038fa78ee51a3f5c4cbe85db1e21,2,14,1,15,5,2013-04-20 02:29:13,2013-04-20 02:29:13
931ca464a7db038fa78ee51a3f5c4cbe85db1e21...61259ab4b4bfe3404e75dd811a2da7c88e7c7133,1,3,2,5,2,2013-04-20 02:32:32,2013-04-20 02:32:32
61259ab4b4bfe3404e75dd811a2da7c88e7c7133...930e9a7e430a3d78e09a95bb32d9fb6052e7dae1,1,46,0,46,4,2013-04-20 02:35:44,2013-04-20 02:35:44
930e9a7e430a3d78e09a95bb32d9fb6052e7dae1...7f1a32b9ff31bd931e9495acc1d5ccdef4bd51b6,1,7,1,8,4,2013-04-20 03:44:25,2013-04-20 03:44:25
7f1a32b9ff31bd931e9495acc1d5ccdef4bd51b6...911925b54a42fffa0fed8bac2a3eeba14bf3ec4b,1,43,0,43,3,2013-04-20 03:46:07,2013-04-20 03:46:07
911925b54a42fffa0fed8bac2a3eeba14bf3ec4b...c40f01319f741ef895090334ffa637f099c529b3,1,33,14,47,10,2013-04-21 00:26:50,2013-04-21 00:26:50
c40f01319f741ef895090334ffa637f099c529b3...70cf467fdf8c4809429089ceae0f3ac1b3a6f729,1,1,48,49,2,2013-04-21 00:29:12,2013-04-21 00:29:12
70cf467fdf8c4809429089ceae0f3ac1b3a6f729...28831a412fa51094124f17d242908f308a2a973a,1,1,0,1,1,2013-04-21 00:29:41,2013-04-21 00:29:41
28831a412fa51094124f17d242908f308a2a973a...4a9c3a92e1552fab5702eeddc0307f7f87f96496,1,2,3,5,1,2013-04-21 00:30:33,2013-04-21 00:30:33
4a9c3a92e1552fab5702eeddc0307f7f87f96496...1201c418cd6f02ca8c206cfdd4659b8ec2d2f856,1,14,13,27,11,2013-04-21 00:31:49,2013-04-21 00:31:49
1201c418cd6f02ca8c206cfdd4659b8ec2d2f856...d49a273071eaa579f59799b679a9f7b316e28fb8,1,16,17,33,2,2013-04-21 00:33:02,2013-04-21 00:33:02
4f0bda2dd5cfe382f7fd9cfb9f5522f42377673b...c6963da54e1aa550d58419a8275967060866bd6d,1,5,2,7,3,2013-05-03 15:51:11,2013-05-03 15:51:11
15c7e72e2a518cb24b1f5bf9bb75fbfcdaccafc4...52cedb8a05182c7d6f5e5918453cf356b1efafc8,1,3,3,6,2,2013-04-21 01:26:15,2013-04-21 01:26:15
52cedb8a05182c7d6f5e5918453cf356b1efafc8...baacae8345febd688579ac29832c200c41602ed2,4,77,13,90,10,2013-04-21 21:23:55,2013-04-21 21:23:55
baacae8345febd688579ac29832c200c41602ed2...965e8a02d24a35aa7a7f64f2baf2b652a04f5983,4,30,16,46,12,2013-04-21 22:29:26,2013-04-21 22:29:26
8cf30395a1a338c7c34adda0ae59ba8b2f9370cd...8f15c423e6049507908ec6e7b139f8bccbd6d3ba,2,63,0,63,2,2013-04-09 15:04:14,2013-04-09 15:04:14
8cf30395a1a338c7c34adda0ae59ba8b2f9370cd...72fdb4106997799df49faffb96de1d076e8ad755,1,17,0,17,2,2013-04-08 15:39:30,2013-04-08 15:39:30
8cf30395a1a338c7c34adda0ae59ba8b2f9370cd...81ebf4fcf6fe3521c606b5abcbe151176c51aca9,2,36,0,36,2,2013-04-07 14:21:08,2013-04-07 14:21:08
81ebf4fcf6fe3521c606b5abcbe151176c51aca9...6eb8a74ff9aee90fe488de151fab6ec234b61d2a,5,12,3,15,7,2013-04-07 14:23:00,2013-04-07 14:23:00
8cf30395a1a338c7c34adda0ae59ba8b2f9370cd...27feba459492bb381a037bf2f4766d51fdf53812,1,3,1,4,1,2013-04-07 07:41:24,2013-04-07 07:41:24
27feba459492bb381a037bf2f4766d51fdf53812...9875a9b1f1b59114356c129f42449e2d62427f65,1,2,1,3,1,2013-04-07 07:43:57,2013-04-07 07:43:57
8cf30395a1a338c7c34adda0ae59ba8b2f9370cd...cda9cf1539b4e3ce24ce77892b1e68ddb454f566,1,2,0,2,1,2013-04-05 03:30:24,2013-04-05 03:30:24
cda9cf1539b4e3ce24ce77892b1e68ddb454f566...bae6f9583060187116aa8a069d0e63abfede5de0,1,1,1,2,1,2013-04-05 03:32:44,2013-04-05 03:32:44
bae6f9583060187116aa8a069d0e63abfede5de0...b76b329ef05748e75224e8fd09c1c697ddfd2a50,1,1,0,1,1,2013-04-05 03:40:42,2013-04-05 03:40:42
b76b329ef05748e75224e8fd09c1c697ddfd2a50...20085794f023e2e5cf7d772a67f9c3b2e3afc93f,1,1,2,3,1,2013-04-05 09:01:38,2013-04-05 09:01:38
95e066d24fc4d9248e5e98f6d8ce018764834547...e413340723871ad2d7a03822ca06993ee3c0a4bc,1,1,1,2,1,2013-04-23 07:09:29,2013-04-23 07:09:29
d49a273071eaa579f59799b679a9f7b316e28fb8...3b6c540fe8313035de0f0b00de52d7197f8bc665,1,1,1,2,1,2013-04-21 00:35:00,2013-04-21 00:35:00
75418ec8492914cdb0010e94716dbf3b077edef1...04cd20fa627635d30ea315d0d4e281e10e8d293c,7,718,571,1289,133,2013-05-06 09:31:22,2013-05-06 09:31:22
965e8a02d24a35aa7a7f64f2baf2b652a04f5983...71b580661451c35f01ee3824506f572c52d86ac8,2,16,13,29,4,2013-04-22 04:44:57,2013-04-22 04:44:57
965e8a02d24a35aa7a7f64f2baf2b652a04f5983...1f65c6bf4c9dcfc513eeb9da34a7cac60c6bc4ff,2,23,31,54,11,2013-04-22 01:19:38,2013-04-22 01:19:38
4d728821e37a54629f47d7379a50ad27d5055af6...e81ddb2dc76ab2e502ad35363a436dd823289598,1,1,1,2,1,2013-04-19 19:55:17,2013-04-19 19:55:17
418ef43fbb59d62dca20905bbc0753892ecb6c27...4ab241c93080d8df6db4fd0c31b0c26008118422,1,44,25,69,16,2013-04-09 22:04:01,2013-04-09 21:50:12
b8f9803459bdc151593720cb6148d6eb14972bb4...4e5001b46a3281809db0c6402a3e077fd1bef9cd,1,0,38,38,1,2013-04-08 22:58:09,2013-04-03 19:07:22
4e5001b46a3281809db0c6402a3e077fd1bef9cd...7d0ab3858e51a2cea244da72bb842fe15a5a9ded,4,237,55,292,47,2013-04-08 22:58:09,2013-04-03 19:25:19
7d0ab3858e51a2cea244da72bb842fe15a5a9ded...b306a6073882e7995d74801d77d7baca4b12ec86,1,3,5,8,1,2013-04-08 22:58:09,2013-04-03 23:32:47
b306a6073882e7995d74801d77d7baca4b12ec86...246eed52de1038ccec462e500b942711735a7c24,2,44,63,107,9,2013-04-08 22:58:09,2013-04-05 01:36:34
246eed52de1038ccec462e500b942711735a7c24...e6e9c1cd62bf78e66623950a9f76ef76c6f0f792,1,10,6,16,5,2013-04-08 22:58:09,2013-04-05 01:52:03
e6e9c1cd62bf78e66623950a9f76ef76c6f0f792...80f6b4587b6ebaed30747d17b69af4d11d6389ab,2,73,71,144,9,2013-04-08 22:58:09,2013-04-05 02:00:14
80f6b4587b6ebaed30747d17b69af4d11d6389ab...b71b226cc1a69be5ce640f07b8de9c129e478360,1,6,9,15,5,2013-04-08 22:58:09,2013-04-05 02:21:36
b71b226cc1a69be5ce640f07b8de9c129e478360...bdf05d8368f2d158ba051dbefeb07bc717a93774,1,90,69,159,4,2013-04-08 22:58:09,2013-04-05 03:08:58
bdf05d8368f2d158ba051dbefeb07bc717a93774...d530d581f7362aab16e9dfeee1143dd5c824e6c7,1,24,24,48,24,2013-04-08 22:58:09,2013-04-05 03:19:06
d530d581f7362aab16e9dfeee1143dd5c824e6c7...dcf4572a6914e50ce8797503ff0c180027d28301,1,6,2,8,4,2013-04-08 23:07:12,2013-04-05 04:51:40
dcf4572a6914e50ce8797503ff0c180027d28301...f73401fb9a0993d12da9ef60f265cd0502bb3808,1,27,0,27,1,2013-04-08 23:07:12,2013-04-05 23:43:12
f73401fb9a0993d12da9ef60f265cd0502bb3808...e9a68801ba4c47581d7741989700a35521c389c4,1,1,1,2,1,2013-04-08 23:07:12,2013-04-08 23:06:55
0767916adedb01d61b01b91e7a0591ac7cb0f872...cb54e9c659c681fde5311aacefe0e5ea8c564e17,2,6,5,11,5,2013-04-09 16:59:30,2013-04-09 16:59:30
cb54e9c659c681fde5311aacefe0e5ea8c564e17...1eaaa6b744b8017e7d31bdf9dc7095663b4c930c,1,2,1,3,1,2013-04-09 17:02:57,2013-04-09 17:02:57
0767916adedb01d61b01b91e7a0591ac7cb0f872...64c1b6d9cd16b7d4cc8ebda2de82bc76e0c99f43,1,1,4,5,1,2013-04-09 15:18:16,2013-04-09 15:18:16
64c1b6d9cd16b7d4cc8ebda2de82bc76e0c99f43...d063d52cce9892c777722b30923d9fb1f1385fe8,1,7,9,16,1,2013-04-09 15:18:36,2013-04-09 15:18:36
0767916adedb01d61b01b91e7a0591ac7cb0f872...329f4449dc0f5722150a8160262b817e12be20fc,3,13,32,45,11,2013-04-09 14:57:59,2013-04-09 14:57:59
329f4449dc0f5722150a8160262b817e12be20fc...7c2b085d1a1394dc88b0cdf5c9df02ee1c1b2229,3,24,6,30,10,2013-04-09 16:09:54,2013-04-09 16:09:54
a7299a3f2617a797af0df3082590ca361b687bf4...2832ea0cfeb8eb69cf42db5ec0a115300e1383b9,6,98,18,116,17,2013-04-09 03:10:47,2013-04-09 03:10:47
cff26b3a6c56422b3f2a0275fa7ef1cdd187138b...cbc4eccd50ac80ff6e21caeb386328f8a5fcfaff,1,1,1,2,1,2013-04-23 08:52:55,2013-04-23 08:52:55
6f9b574f25e8fca5e4a28a35b71e4755a424bed8...f37399d22baaec0b04de42e4712d50f3edd80444,5,209,70,279,38,2013-05-06 11:34:31,2013-05-06 11:34:31
f37399d22baaec0b04de42e4712d50f3edd80444...5a2a5ccdaf70fba20c89912153fec19eba35e7e6,6,96,404,500,8,2013-05-06 14:59:33,2013-05-06 14:59:33
5a2a5ccdaf70fba20c89912153fec19eba35e7e6...0b6c79b303547e38c758c16da2db1a430296953e,6,977,49,1026,44,2013-05-07 15:19:41,2013-05-07 15:19:41
2ced94b41461a399bc848006901af5ab15d665c3...acb546cd1bf45a248f4bb51637c795ef63feb6cb,2,21,3,24,4,2013-04-22 18:16:32,2013-04-22 18:16:32
a1f54cad6cc66d0a84b0bf0cc427fe40ba6448d3...6de5ca1e64407582debe01f17377cdb7bb8d70c5,2,5,0,5,2,2013-04-18 23:00:18,2013-04-18 23:00:18
6de5ca1e64407582debe01f17377cdb7bb8d70c5...8ecde8f9a5dcad23afea013a62d373cef303fa84,6,172,16,188,11,2013-04-20 03:57:50,2013-04-20 03:57:50
8ecde8f9a5dcad23afea013a62d373cef303fa84...0731d1a582b44a18e9bfdf0764d232b46218346b,1,20,34,54,21,2013-04-20 03:59:43,2013-04-20 03:59:43
0731d1a582b44a18e9bfdf0764d232b46218346b...6c8dcd5cbbff2b33f878a32ae3b93abc0d7b9dae,4,25,32,57,17,2013-04-22 20:10:32,2013-04-22 20:10:32
6c8dcd5cbbff2b33f878a32ae3b93abc0d7b9dae...690e1186704eff65ff72404eb2a686b2b205ee7c,1,21,13,34,11,2013-04-22 20:36:00,2013-04-22 20:36:00
690e1186704eff65ff72404eb2a686b2b205ee7c...4031a01af1658225344af04be0dbd4225893c242,82,2519,603,3122,272,2013-04-23 01:38:42,2013-04-23 01:38:42
e9a68801ba4c47581d7741989700a35521c389c4...1601366cb6bfb9671ec28ced0bf88d11049264d3,1,3,1,4,2,2013-04-09 01:16:58,2013-04-09 01:16:58
e9a68801ba4c47581d7741989700a35521c389c4...847a8f45a45dccd0574396b888670004e32762e6,1,4,27,31,7,2013-04-06 00:40:55,2013-04-04 18:23:51
847a8f45a45dccd0574396b888670004e32762e6...33a5fe3bd4cb0bd31b01da89c8c4c3321701e7a1,1,1,1,2,1,2013-04-06 00:40:55,2013-04-04 18:24:22
33a5fe3bd4cb0bd31b01da89c8c4c3321701e7a1...7d8895545e2442ea095f83c90edff64835a0d0b5,1,12,27,39,8,2013-04-06 00:40:55,2013-04-04 19:12:22
7d8895545e2442ea095f83c90edff64835a0d0b5...99b5bec0692ea9ec8a397926df9dd545fb264ac9,2,51,0,51,2,2013-04-06 02:02:35,2013-04-06 02:02:35
99b5bec0692ea9ec8a397926df9dd545fb264ac9...7e1e7d14fa257692231bc7e13e796e07607879c2,1,5,0,5,3,2013-04-06 02:48:49,2013-04-06 02:48:49
7e1e7d14fa257692231bc7e13e796e07607879c2...c83393a541353ab34612d80cc6b9bb4e92c59597,3,9,1,10,4,2013-04-06 03:08:31,2013-04-06 03:08:31
50f5723f1d21c41fd25549567013a3ba06e888b4...73da7a12e7d6846a12571e6eac1f16502219c9d4,1,1,1,2,1,2013-04-23 17:12:46,2013-04-23 17:12:46
acb546cd1bf45a248f4bb51637c795ef63feb6cb...f079fbe3fa90d58d414341bed5246539c89b61b2,1,9,2,11,3,2013-04-22 22:57:31,2013-04-22 22:57:31
acb546cd1bf45a248f4bb51637c795ef63feb6cb...ffe16e32243da4f02d325dae1bf08f71181ed439,1,1,1,2,1,2013-04-22 22:37:06,2013-04-22 22:37:06
acb546cd1bf45a248f4bb51637c795ef63feb6cb...0b60829df795bc5178feb8f266b1f7e35a91f6da,1,32,0,32,1,2013-04-22 22:26:06,2013-04-22 21:41:30
0b60829df795bc5178feb8f266b1f7e35a91f6da...4f6cc5c7330a7389d558dece2e432f13249bd565,1,70,25,95,4,2013-04-23 07:30:18,2013-04-23 07:30:18
acb546cd1bf45a248f4bb51637c795ef63feb6cb...038e1d174bed0d73bcf4ba197f60651907aa1116,1,2,2,4,2,2013-04-22 20:27:23,2013-04-22 20:27:23
acb546cd1bf45a248f4bb51637c795ef63feb6cb...3514e47edc2d3cdaae2d92a78cc5c618d9549f13,1,7,8,15,1,2013-04-22 18:26:34,2013-04-22 18:26:34
3514e47edc2d3cdaae2d92a78cc5c618d9549f13...4ac3b803b9b7d0db1840a12f3332034938eb9550,1,26,17,43,7,2013-04-22 18:39:56,2013-04-22 18:39:56
4ac3b803b9b7d0db1840a12f3332034938eb9550...16aeb77d5155cf33d1637073b9ca56728d472b49,3,71,57,128,5,2013-04-22 19:08:59,2013-04-22 19:08:59
16aeb77d5155cf33d1637073b9ca56728d472b49...c05c91ca3bb69d2c9faa0a2b15bc23b7c2a7bd8a,2,8,0,8,3,2013-04-23 01:15:33,2013-04-22 20:19:50
9c3d2b6a4ed46eb3549416ceffd61683ad0a8efe...0d9e54367f7bf7da9670de723d533eaa920868c8,1,1,1,2,1,2013-04-09 19:06:01,2013-04-09 19:06:01
9c3d2b6a4ed46eb3549416ceffd61683ad0a8efe...3f63b8780765df735192ea0299e86e8cb7dbcb88,2,11,1,12,2,2013-04-09 18:06:17,2013-04-04 19:54:53
3f63b8780765df735192ea0299e86e8cb7dbcb88...1f70b1e15d0dea5f36395d325cbac2892e4f2e8a,2,51,1,52,2,2013-04-09 18:06:17,2013-04-04 19:55:24
1f70b1e15d0dea5f36395d325cbac2892e4f2e8a...faa88436504e4a4a63ddb4f3736b11e721b760cd,1,5,1,6,1,2013-04-09 19:55:17,2013-04-04 19:57:45
faa88436504e4a4a63ddb4f3736b11e721b760cd...8f41f1fa60587d77ad3ce2109fc03180488f49cc,1,0,9,9,1,2013-04-09 19:55:26,2013-04-05 01:12:54
8f41f1fa60587d77ad3ce2109fc03180488f49cc...626bfd87a7eadd64b16fb02d547f75d1a8f94aa7,1,4,2,6,2,2013-04-09 19:55:26,2013-04-05 01:13:43
626bfd87a7eadd64b16fb02d547f75d1a8f94aa7...72cef46e5e504355266b9c83bd3693d07a35d0ee,1,0,9,9,1,2013-04-09 19:55:26,2013-04-09 14:44:44
72cef46e5e504355266b9c83bd3693d07a35d0ee...2e6a5bc7ee932b3d723ca4b0a319477310b12c34,1,6,0,6,1,2013-04-09 19:55:26,2013-04-09 17:14:18
73da7a12e7d6846a12571e6eac1f16502219c9d4...5a02c9ba0a8e4dc19001a11d00049ec2c76511f0,1,11,1,12,2,2013-04-23 18:08:31,2013-04-23 17:28:40
5a02c9ba0a8e4dc19001a11d00049ec2c76511f0...a22c78523f20c44e90e7a3adbd01a5560ed4f6ae,1,1,0,1,1,2013-04-23 18:09:48,2013-04-23 18:09:48
a22c78523f20c44e90e7a3adbd01a5560ed4f6ae...c45beabcd54090bcb31eaa7a5af5878262b7b0e5,1,4,11,15,2,2013-04-23 18:22:30,2013-04-23 18:22:30
c45beabcd54090bcb31eaa7a5af5878262b7b0e5...6ebb2491314afb3be4b0b82d14ddba743ec460de,1,8,13,21,5,2013-04-23 18:25:16,2013-04-23 18:25:16
73da7a12e7d6846a12571e6eac1f16502219c9d4...0512cf9c839be2c5370830cb80bcbec400273eac,1,0,3,3,1,2013-04-23 17:49:58,2013-04-23 17:49:58
0512cf9c839be2c5370830cb80bcbec400273eac...7577f48dc441d14cb600b799498f29f9b4639ffe,1,6,5,11,3,2013-04-23 17:53:02,2013-04-23 17:53:02
7577f48dc441d14cb600b799498f29f9b4639ffe...2485bb2cd20a453c2c5f0fff3a6481ef539da591,1,6,5,11,4,2013-04-23 18:45:47,2013-04-23 18:45:47
2485bb2cd20a453c2c5f0fff3a6481ef539da591...e03b241fb18fa5dab4ec94c3d86eacb21601ac66,1,4,7,11,3,2013-04-23 19:07:54,2013-04-23 19:07:54
90d144b6120a7279b86382a74b6d2a9350a6b865...82848d415866d08121bb52857e7d7b1d2a952c0c,2,39,10,49,5,2013-04-23 00:52:38,2013-04-19 19:08:43
82848d415866d08121bb52857e7d7b1d2a952c0c...d440782e17d384d52c813f93cd53d2d8a15fd13a,1,4,1,5,2,2013-04-23 00:52:38,2013-04-19 19:12:30
d440782e17d384d52c813f93cd53d2d8a15fd13a...f926ed182f908aba20980202becfcdbe2d1e9c34,1,0,6,6,2,2013-04-23 00:53:32,2013-04-19 19:21:39
f926ed182f908aba20980202becfcdbe2d1e9c34...b76d63cb0c97aacec6d81c07108d2a573fb8af05,1,4,0,4,1,2013-04-23 00:53:32,2013-04-19 21:18:03
f507188ddc907f7e7b628145a89e455a5eeacc28...e41fd24542d96c503cd923a403c43aceaf9af965,1,71,0,71,1,2013-04-10 20:57:26,2013-04-10 20:57:26
f507188ddc907f7e7b628145a89e455a5eeacc28...8c3331dc978e3cbbe3255a436c8f18f01158eb27,1,10,2,12,4,2013-04-10 17:30:57,2013-04-10 17:30:57
8c3331dc978e3cbbe3255a436c8f18f01158eb27...8bd192fb16a5ac9836d4b1d3df037af65b61ffce,1,1,1,2,1,2013-04-10 19:09:21,2013-04-10 19:09:21
8bd192fb16a5ac9836d4b1d3df037af65b61ffce...17136d58f29fdd921d41ebd7c67c73bd4078b023,1,5,5,10,4,2013-04-11 11:09:40,2013-04-11 11:09:40
0d9e54367f7bf7da9670de723d533eaa920868c8...fb0b375be70e79eaa8349143dceef048db6e0e19,1,42,2,44,5,2013-04-11 19:41:08,2013-04-10 10:24:15
1b7115a33772806b36006f66b4425149f2fb3123...40ebe78bb1d9750505d594d10bc9eb6979ef63ea,1,1,1,2,1,2013-04-09 20:00:50,2013-04-09 20:00:50
e03b241fb18fa5dab4ec94c3d86eacb21601ac66...a8651a23b2cca4c9a9dcc3a6829e9496d68ddef5,1,20,1,21,4,2013-04-24 01:32:59,2013-04-24 01:32:59
a8651a23b2cca4c9a9dcc3a6829e9496d68ddef5...8b8c8bf7cb0ed782d727440a0f2c59d464971353,1,1,1,2,1,2013-04-24 01:50:53,2013-04-24 01:50:53
e03b241fb18fa5dab4ec94c3d86eacb21601ac66...f744cfd5a75e3b1565740c2f266dbfdf7be8727a,2,102,18,120,14,2013-04-23 20:51:03,2013-04-23 20:51:03
c7fd84b8a0bcfe70c3897e6611e6c59fd514d28f...90668a8a997c5db27ffdcc25c7921c63526b62f4,3,22,1,23,3,2013-04-24 06:15:09,2013-04-24 06:15:09
59a6316f5e0810009f5986d62f1707f8d0a6650e...40794113750a3d21e784e2521ae517f23a081135,4,29,33,62,11,2013-05-07 18:59:04,2013-05-07 18:59:04
e41fd24542d96c503cd923a403c43aceaf9af965...c105049f7ea5927ec9d7258624391f6a2b43a6a3,1,4,0,4,1,2013-04-11 14:27:01,2013-04-11 14:27:01
e41fd24542d96c503cd923a403c43aceaf9af965...38e2d00199db5dabe9972ff9c3153ac6b63266f2,3,68,0,68,4,2013-04-11 02:48:21,2013-04-11 02:48:21
e41fd24542d96c503cd923a403c43aceaf9af965...9d1fd2317d5e3edee845410f10969b37ba37c9d5,1,3,3,6,3,2013-04-11 02:08:46,2013-04-11 02:08:46
9d1fd2317d5e3edee845410f10969b37ba37c9d5...6dc4c74b5ab63e6de374fe839e05acf5998a6f72,1,10,10,20,10,2013-04-11 02:13:15,2013-04-11 02:13:15
e41fd24542d96c503cd923a403c43aceaf9af965...1f9f5eed5d004395886b8e93cec9389332d8fded,3,14,9,23,4,2013-04-11 01:23:34,2013-04-11 01:23:34
1f9f5eed5d004395886b8e93cec9389332d8fded...7673afc8438a9e46a1d11aff0f8c0f7eca169809,2,24,4,28,6,2013-04-12 17:43:13,2013-04-11 02:02:23
e41fd24542d96c503cd923a403c43aceaf9af965...5e1a975b48c1d4e6743f68ca770f8fe06fb32ce4,1,1,2,3,1,2013-04-11 00:40:28,2013-04-11 00:40:28
e41fd24542d96c503cd923a403c43aceaf9af965...97f48e59fcfa8ca0f0a20ed80cab7330af93ae6d,1,5,1,6,1,2013-04-11 00:23:42,2013-04-11 00:23:42
c1703c2b68da74680310ae58f5368d6c677a68ef...22893429ed29dbb7a01eed7a90a4d1fbecfd5d90,2,13,13,26,3,2013-04-12 14:37:24,2013-04-12 14:37:24
40ebe78bb1d9750505d594d10bc9eb6979ef63ea...9f83b9df2256c7b34453d5da85c17fae516ee3a4,1,11,0,11,2,2013-04-10 00:40:02,2013-04-10 00:40:02
40ebe78bb1d9750505d594d10bc9eb6979ef63ea...f731835e4577c414d37fa050aaec1f541511ff6b,1,3,3,6,2,2013-04-09 22:00:05,2013-04-09 22:00:05
40ebe78bb1d9750505d594d10bc9eb6979ef63ea...bbaa975ec8ea44f7df4f96a910360abc43b4d5f7,9,217,0,217,9,2013-04-09 21:37:37,2013-04-09 21:30:10
8f81e175af419e5669fd8b74958b0ea85d8cc248...5051c20833cd3310d27564fe20f856f7e77b92f3,1,1,1,2,1,2013-04-29 18:53:50,2013-04-29 18:53:50
8f81e175af419e5669fd8b74958b0ea85d8cc248...4b3354af3fa4cea59271ace7cc4d1d072312b688,1,18,2,20,3,2013-04-28 18:31:28,2013-04-28 18:31:28
4b3354af3fa4cea59271ace7cc4d1d072312b688...ab34115b42cbcb42cb91593601d6daff2c7f32ad,1,2,2,4,2,2013-04-28 19:38:26,2013-04-28 19:37:52
8f81e175af419e5669fd8b74958b0ea85d8cc248...9042535f5af607f2362fa3f995427e1c5aab664e,2,23,18,41,3,2013-04-26 21:32:55,2013-04-26 21:32:55
8b8c8bf7cb0ed782d727440a0f2c59d464971353...b3ab0b561ed6dd06a569fa800109d18070886149,1,7,2,9,6,2013-04-24 02:41:38,2013-04-24 02:41:38
b3ab0b561ed6dd06a569fa800109d18070886149...a0478f726d8751f37e4e20e3cc5e858bfc111180,2,51,17,68,6,2013-04-24 05:57:34,2013-04-24 05:57:34
90668a8a997c5db27ffdcc25c7921c63526b62f4...2726e3649a204d15dcf79d2709e6457b6ca50c14,5,20,207,227,9,2013-04-24 18:30:15,2013-04-23 16:44:09
32cbd72ebeedfd6be71cf840f8b56a19e2c0e64c...ac0e27699c0dd9306ae0edabeff5d462399c8e74,1,8,2,10,5,2013-05-07 19:36:24,2013-05-07 19:36:24
ac0e27699c0dd9306ae0edabeff5d462399c8e74...a5b765a769736171d05692aff3abdf3f02dfe5be,1,4,17,21,4,2013-05-07 20:52:58,2013-05-07 20:15:21
a5b765a769736171d05692aff3abdf3f02dfe5be...4d30a32c68c199a1e10e68729feb519b74da2961,1,6,10,16,2,2013-05-07 21:15:42,2013-05-07 21:15:42
4d30a32c68c199a1e10e68729feb519b74da2961...a0880edc6337054725abc9e8338550bc5258f4ab,2,2,8,10,2,2013-05-07 21:56:45,2013-05-07 21:56:45
a0880edc6337054725abc9e8338550bc5258f4ab...b56b2da5c5ac9c65c07d33844a4c2ceeb36bbf6a,3,668,555,1223,65,2013-05-07 23:33:12,2013-05-07 23:33:12
b56b2da5c5ac9c65c07d33844a4c2ceeb36bbf6a...279db68b4600551706dd1185ad1b05b374e9e05c,2,7,4,11,4,2013-05-07 23:36:49,2013-05-07 23:36:49
279db68b4600551706dd1185ad1b05b374e9e05c...ab96da8eb2c81a90e5c081da26ee49c3af2f1ca5,2,33,38,71,24,2013-05-07 23:47:43,2013-05-07 23:47:43
ab96da8eb2c81a90e5c081da26ee49c3af2f1ca5...891c5202ead662d9c8a3147f691e719106e0f20a,1,131,250,381,122,2013-05-08 00:27:09,2013-05-08 00:27:09
891c5202ead662d9c8a3147f691e719106e0f20a...755604a2bdcaa47ad1ef827be021c9997002d311,2,2,3,5,2,2013-05-08 00:35:33,2013-05-08 00:35:33
755604a2bdcaa47ad1ef827be021c9997002d311...57cfe72e8c27dc3f499b15a679d16dee85eb7a3e,2,81,126,207,65,2013-05-08 01:06:49,2013-05-08 01:06:49
57cfe72e8c27dc3f499b15a679d16dee85eb7a3e...2ac4e662f1f507d8c1d45141f7c8e128ba96ff9d,1,7,20,27,15,2013-05-08 01:16:24,2013-05-08 01:15:33
2ac4e662f1f507d8c1d45141f7c8e128ba96ff9d...cacc7e564acfcb7c28c2526e29714057fe793b2a,3,59,60,119,23,2013-05-08 06:32:17,2013-05-08 06:32:17
cacc7e564acfcb7c28c2526e29714057fe793b2a...60ddcaa15d61c75bec78edeb72999daa7077dd0e,5,396,62,458,54,2013-05-08 15:35:50,2013-05-08 15:35:50
60ddcaa15d61c75bec78edeb72999daa7077dd0e...075e1ebb0e835c3591059131bec6dedaf042e227,4,9,62,71,7,2013-05-08 16:06:43,2013-05-08 16:06:43
075e1ebb0e835c3591059131bec6dedaf042e227...bc3fa506e93c3e54078b9e62f5466bf4a1048704,4,33,6,39,10,2013-05-08 16:28:11,2013-05-08 16:28:11
bc3fa506e93c3e54078b9e62f5466bf4a1048704...4a1e0d321ec8ef622673971deff0d191d198cc31,2,7,8,15,8,2013-05-08 16:36:37,2013-05-08 16:36:37
4a1e0d321ec8ef622673971deff0d191d198cc31...954ecac388bbee5cf00d22260287ed01bf5d11a4,2,42,19,61,31,2013-05-08 16:52:01,2013-05-08 16:52:01
954ecac388bbee5cf00d22260287ed01bf5d11a4...bf605fcfc77aeb1ef5d8c00072b6c2c1f988ebcd,1,1,1,2,1,2013-05-08 17:21:52,2013-05-08 17:21:52
bf605fcfc77aeb1ef5d8c00072b6c2c1f988ebcd...1d42cbaa21826e1594911742b8ead439da11882e,1,0,7,7,7,2013-05-08 21:19:24,2013-05-08 21:19:24
1d42cbaa21826e1594911742b8ead439da11882e...24c785bc062c19488a47d9ed9ed2799a3c6783f8,2,3,3,6,5,2013-05-08 21:57:14,2013-05-08 21:57:14
c902c43766641eeba73aea2d9f96601394157d7d...2de953490d6a4ccba9668484fce1f028578c6f77,2,47,0,47,2,2013-04-11 18:30:35,2013-04-11 18:30:35
c902c43766641eeba73aea2d9f96601394157d7d...3ba44d2d5fac067f7fcd3d5abed83b08c8ddb24d,1,7,7,14,7,2013-04-11 16:46:47,2013-04-11 16:46:47
3ba44d2d5fac067f7fcd3d5abed83b08c8ddb24d...8987bd5832d8162805d34b89c567fcf2e933f746,1,24,17,41,17,2013-04-12 10:26:31,2013-04-12 10:26:31
c902c43766641eeba73aea2d9f96601394157d7d...313d13ea01f58c3e611fb85e435d36dd4907a6ac,3,16,0,16,5,2013-04-11 16:26:17,2013-04-11 16:26:17
c902c43766641eeba73aea2d9f96601394157d7d...e68c04b722b4c001c999abc2cd5b60b1f1b34457,1,14,2,16,2,2013-04-11 16:04:04,2013-04-11 16:02:34
e68c04b722b4c001c999abc2cd5b60b1f1b34457...bb22cd492efdc67855bbcf8ab4a669e45ea9ee8e,4,76,4,80,11,2013-04-11 23:21:19,2013-04-11 23:21:19
cdf90bb04b046058f6b1233846a1d5eb4fcf3810...c2c72bcfd796a43b9be33705ec695455c9823489,1,1,1,2,1,2013-04-13 22:03:24,2013-04-13 22:03:24
27be5aec74773100f3e59c432a737cb712c8b368...ac49a797b469bda89384dc1cd31d349761340693,1,15,1,16,3,2013-04-15 10:05:46,2013-04-15 10:05:46
54dfedc516918b9c0f343dbb09ce2e9cc17c4e61...79d934bfb0d2e5d30a89a42c1a106d9d3698775b,1,1,3,4,3,2013-04-11 19:11:41,2013-04-11 19:11:41
79d934bfb0d2e5d30a89a42c1a106d9d3698775b...048f9f4974ac74fac3b03af132c392daaa9f134e,3,183,0,183,3,2013-04-11 21:44:39,2013-04-11 21:44:39
22893429ed29dbb7a01eed7a90a4d1fbecfd5d90...343ed6b53f225e35bb5464efb556f555a31056a1,2,10,0,10,6,2013-04-12 14:44:50,2013-04-12 14:44:50
bbaa975ec8ea44f7df4f96a910360abc43b4d5f7...b7cda3288ed857e4e2155846090b17a2d8fccdbf,1,1,1,2,1,2013-04-10 02:07:50,2013-04-10 02:07:50
957c500ac9054067ace52530c282495cd56b3701...038ca5ee392b974b1ace08d0a6359b02006e6aac,2,11,8,19,11,2013-05-01 07:14:52,2013-05-01 07:14:52
038ca5ee392b974b1ace08d0a6359b02006e6aac...40ccf1d30039a7ee975ddb2fc8aa989b1fa680fc,1,12,1,13,2,2013-05-01 07:42:11,2013-05-01 07:42:11
40ccf1d30039a7ee975ddb2fc8aa989b1fa680fc...03b83b3210865a1981cec43dbc9fe5d24995c060,1,4,3,7,2,2013-05-01 07:44:36,2013-05-01 07:44:36
03b83b3210865a1981cec43dbc9fe5d24995c060...a3ce90b78bf5edcacdfd4312e8ec9e25b59d6abb,1,3,0,3,1,2013-05-01 07:49:28,2013-05-01 07:49:28
cb431f223f0fb383f99a1ea7ba0af11f1a2a0810...ebe157ebb567965e05cca45a1221cd36ec48a052,1,2,1,3,2,2013-04-28 08:27:56,2013-04-28 08:27:56
ebe157ebb567965e05cca45a1221cd36ec48a052...20c2a4f80f4171ffb59ea61bdcf57d8edc970fa8,1,20,0,20,5,2013-04-28 10:54:22,2013-04-28 10:54:22
20c2a4f80f4171ffb59ea61bdcf57d8edc970fa8...76a1a7cf5ba2d2db2c7e5873df529f3f956a2156,1,32,8,40,10,2013-04-28 13:23:02,2013-04-28 13:23:02
76a1a7cf5ba2d2db2c7e5873df529f3f956a2156...cdc2657ee9bdb1464a17d9daecc0659297d0ee83,1,30,24,54,6,2013-04-28 14:10:58,2013-04-28 14:10:58
e431dc26f115cee290b9bfcdf73a1ea4eebecfce...0d9475346f3548c525ecfbbd44c95a47a0013f0e,1,0,8,8,1,2013-05-02 01:49:31,2013-05-02 01:49:31
e431dc26f115cee290b9bfcdf73a1ea4eebecfce...58b95878f13c8de443529fbd47a67988b4735e1a,1,1,1,2,1,2013-05-02 01:16:23,2013-05-02 01:16:23
a0478f726d8751f37e4e20e3cc5e858bfc111180...874a40ed3a8a6cf5711ac377712c189e0761c706,1,3,0,3,1,2013-04-24 06:04:54,2013-04-24 06:04:54
03855b0027fa782070c30eb11a8ca7c36df4a66a...ee298d1420ea58cdafa788d63547dadab47ef76d,1,2,0,2,1,2013-04-25 00:43:41,2013-04-25 00:43:41
fc29f01528ef99b88734bee252cc0af05675885e...842cb8909e1194a4650db6c6c4d1891ac2fd5a88,1,8,1,9,1,2013-05-09 01:46:39,2013-05-09 01:46:39
842cb8909e1194a4650db6c6c4d1891ac2fd5a88...4576e11121581c92a436a53ad347bccbfc921a9b,31,2,347,349,32,2013-05-09 15:54:41,2013-05-09 15:54:41
4576e11121581c92a436a53ad347bccbfc921a9b...7c7619ecf86f84c2e8d0a7f9bdb6763683f67066,2,11,23,34,5,2013-05-09 18:24:49,2013-05-09 18:24:49
3527291b477510b1b9f904988599b6499211c3f3...b1fbebb4a3611d340176ad637a22d2250085a077,2,3,3,6,3,2013-04-12 17:39:08,2013-04-12 17:39:08
cb68662b9bea7dbd53296e9f0129cdac9131b688...d2c1850fb5a210d59b87dcb8504c8c24b60cca3c,1,1,1,2,1,2013-04-10 18:32:48,2013-04-10 18:23:56
a3ce90b78bf5edcacdfd4312e8ec9e25b59d6abb...904c2a0fc353ba08e93decf169baa4ea35fe35a8,5,480,0,480,3,2013-05-01 16:31:46,2013-05-01 16:31:46
cdc2657ee9bdb1464a17d9daecc0659297d0ee83...d97661aa715321a017190bd24870473ac6df34a3,1,15,36,51,6,2013-04-30 18:16:26,2013-04-30 18:16:26
cdc2657ee9bdb1464a17d9daecc0659297d0ee83...c6119da33925fccf6af3f232f7aa7c75de41493b,1,11,6,17,5,2013-04-30 17:37:43,2013-04-30 17:37:43
ff5e238de9d2d26afe84270777acd8a0d9986c4d...4bc8ef42d4f294bf6fec6d728ef27abbb638b98d,1,1,1,2,1,2013-05-02 19:44:41,2013-05-02 19:44:41
4bc8ef42d4f294bf6fec6d728ef27abbb638b98d...589d7c68dbfe0cf4a84b96b799871bfbff4a5970,1,1,1,2,1,2013-05-03 18:49:10,2013-05-03 18:49:10
ff5e238de9d2d26afe84270777acd8a0d9986c4d...b682a8ea9e9325278cdb08d5f3da821ee97c5feb,3,36,0,36,3,2013-05-02 18:32:38,2013-05-02 18:32:38
ff5e238de9d2d26afe84270777acd8a0d9986c4d...74cd7e822d4fbac96faab1173cf2fc4e95658901,1,1,1,2,1,2013-05-02 17:33:23,2013-04-30 12:54:22
ff5e238de9d2d26afe84270777acd8a0d9986c4d...528da23d6a5e0b6f37c1241c982bb49f301632cc,2,7,1,8,3,2013-05-02 12:27:37,2013-05-02 12:27:37
528da23d6a5e0b6f37c1241c982bb49f301632cc...6e486b638b6674694fe02d2661bd93f0ee08d425,1,3,0,3,1,2013-05-02 18:25:49,2013-05-02 18:25:49
6e486b638b6674694fe02d2661bd93f0ee08d425...b6a5e604ab2205a547ac5b4f743cf3c4b93ffccf,1,2,3,5,2,2013-05-02 18:32:55,2013-05-02 18:32:55
b6a5e604ab2205a547ac5b4f743cf3c4b93ffccf...c08d245539ef4d721b874392097016a1c8c8fb81,1,3,18,21,4,2013-05-03 01:11:54,2013-05-03 01:11:54
ee298d1420ea58cdafa788d63547dadab47ef76d...51d6228261cdc379aade581ee504b2c59a3e02a9,4,74,11,85,15,2013-04-25 23:48:31,2013-04-25 23:48:31
51d6228261cdc379aade581ee504b2c59a3e02a9...724e2d6b0aa5b1cbe95f39c5d22e733124cee9be,2,8,8,16,8,2013-04-26 00:02:38,2013-04-26 00:02:38
724e2d6b0aa5b1cbe95f39c5d22e733124cee9be...30d327d37ecca58a41f4a370b581ee638ed3ff04,1,78,0,78,1,2013-04-26 00:03:13,2013-04-26 00:03:13
30d327d37ecca58a41f4a370b581ee638ed3ff04...ae97477284fade20520b5991709d6b65d5fd4442,1,6,14,20,4,2013-04-26 17:48:33,2013-04-26 17:48:33
ae97477284fade20520b5991709d6b65d5fd4442...7ff65d40d557e0a128534c096f3cab0c10a79f7b,1,1,2,3,2,2013-05-01 18:22:06,2013-05-01 18:22:06
ee298d1420ea58cdafa788d63547dadab47ef76d...9d8743a7aed88083b1a7c24a1a684e7a79108c15,1,5,0,5,1,2013-04-25 11:59:31,2013-04-25 11:59:31
9d8743a7aed88083b1a7c24a1a684e7a79108c15...9c7293508dd849bf9086b5095b7412214d56b801,1,5,0,5,1,2013-04-25 12:09:04,2013-04-25 12:09:04
9c7293508dd849bf9086b5095b7412214d56b801...4db680fda47306586819a41b80a9a2f6a67f0eb9,1,1,3,4,1,2013-04-25 12:29:13,2013-04-25 12:29:13
ee298d1420ea58cdafa788d63547dadab47ef76d...50144aeb42283848db730b936d6b5b6332ec6565,4,50,32,82,19,2013-04-25 02:01:23,2013-04-25 02:01:23
b5831eda1e3c61567b63362b8bf09ea0a2c45ba6...0bcc5d3bee82d3cd7e51b88005c2105d3f399150,1,2,1,3,2,2013-05-09 18:36:08,2013-05-09 18:36:08
0bcc5d3bee82d3cd7e51b88005c2105d3f399150...0862183c867d5f738184afb80fc4d1f2356364c6,3,26,24,50,27,2013-05-09 19:42:29,2013-05-09 19:42:29
0862183c867d5f738184afb80fc4d1f2356364c6...0ecf5e245dac26a81fa51a189419df29ccefc79a,4,64,32,96,18,2013-05-09 21:10:26,2013-05-09 21:10:26
0ecf5e245dac26a81fa51a189419df29ccefc79a...93dc2c331e198a7988a672902967143f0ca7ad19,3,28,10,38,4,2013-05-09 21:28:03,2013-05-09 21:28:03
93dc2c331e198a7988a672902967143f0ca7ad19...c423a790d629b13c2eb1bc553beb3f61e30b3888,3,26,28,54,9,2013-05-09 21:52:12,2013-05-09 21:52:12
c423a790d629b13c2eb1bc553beb3f61e30b3888...b2b59ddb10ea0bc9d7f0f39cea5f1d8742d1e83e,1,213,171,384,37,2013-05-09 22:47:06,2013-05-09 22:47:06
b1fbebb4a3611d340176ad637a22d2250085a077...45809e9a055defd073bde794026aa611333b7023,2,44,0,44,2,2013-04-12 18:25:33,2013-04-12 18:20:03
b1fbebb4a3611d340176ad637a22d2250085a077...1967c8342aef1a81eb33a41d673bb8e702daa5df,5,32,3,35,9,2013-04-12 17:48:20,2013-04-11 19:58:23
f7aaa06606e0acf36d2979533f40e51ae7ef29c0...5c30faf6f7aba58c9b8be580acb043d56b64db1b,1,1,1,2,1,2013-05-01 19:45:45,2013-05-01 19:45:45
c34989f1c49fe7d652a48215fa5a6f869245c5e4...04f41ebdbca8969a97cd5366fbf55e1a5d521ead,1,2,2,4,1,2013-05-03 22:35:51,2013-05-03 22:35:51
d78b2d4ade8c1b831392d8629ffdad751652cb8c...09d4b9452d80b70bf4d510891cf3545b3350cdf2,5,37,13,50,9,2013-05-06 17:38:51,2013-05-06 17:38:51
19df5a79653c58b02edcd6e688cff27b21803720...a7c0e9a355216048063894a3d47aac2d81c42c3f,1,1,1,2,1,2013-05-03 19:58:44,2013-05-03 19:58:44
19df5a79653c58b02edcd6e688cff27b21803720...1df5f4094bf31edba6f2a2f07bfdada54340c1e4,3,31,0,31,8,2013-05-02 16:14:22,2013-04-06 01:00:10
1df5f4094bf31edba6f2a2f07bfdada54340c1e4...35d704c8a006263d1539994f02c7bfbe97202528,2,5,4,9,5,2013-05-02 16:14:22,2013-04-10 01:08:03
35d704c8a006263d1539994f02c7bfbe97202528...8d9aaee60bf03397e51e8c84232a73fcb3baf36c,2,22,1,23,3,2013-05-02 16:14:22,2013-04-10 01:19:55
8d9aaee60bf03397e51e8c84232a73fcb3baf36c...faf8daa7c68f2511dedfad15e1fd05f9eff077a2,2,4,4,8,4,2013-05-02 16:14:22,2013-04-10 23:09:34
faf8daa7c68f2511dedfad15e1fd05f9eff077a2...6fb495bf6ff545753518e9b9ed39c2676230c277,2,22,8,30,5,2013-05-02 16:14:22,2013-04-10 23:10:53
6fb495bf6ff545753518e9b9ed39c2676230c277...4099a31304863edf5b4d1b594b41c7ce1a33c5e1,1,20,0,20,4,2013-05-02 16:14:22,2013-04-10 23:23:30
4099a31304863edf5b4d1b594b41c7ce1a33c5e1...3edd14b8c2eb13f45834f5d9306a579b256f9348,2,28,2,30,5,2013-05-02 16:14:23,2013-04-12 16:23:57
3edd14b8c2eb13f45834f5d9306a579b256f9348...b0459adc271b20cde11da6a74cc5a71bab23f2ac,1,1,1,2,1,2013-05-02 16:14:23,2013-04-23 01:00:10
b0459adc271b20cde11da6a74cc5a71bab23f2ac...897cc573f051f1d88be0fde05946e66d0c86c43e,1,1,1,2,1,2013-05-02 16:23:29,2013-05-02 16:23:29
897cc573f051f1d88be0fde05946e66d0c86c43e...21b9dcd518871088086943f95bf39f068b30691f,1,2,0,2,1,2013-05-02 16:26:29,2013-05-02 16:26:29
c08d245539ef4d721b874392097016a1c8c8fb81...6cbe27b7a53e5818d1f5e193db00a58e3165557f,1,1,1,2,1,2013-05-03 03:37:08,2013-05-03 03:37:08
c08d245539ef4d721b874392097016a1c8c8fb81...a82b60b30dd9b07d6ea8cd96555a798900c17caa,1,2,2,4,3,2013-05-03 02:22:41,2013-05-03 02:22:41
03d82922aa742b465e4f21c9ddec79ef4266e6a6...86ad98e72aa764a236984b3cc4ab8d59071b876a,1,45,0,45,1,2013-04-26 14:54:29,2013-04-26 14:54:29
b2b59ddb10ea0bc9d7f0f39cea5f1d8742d1e83e...3115c5a2252c2c053774d91e0270076800de3305,1,220,67,287,9,2013-05-09 23:20:07,2013-05-09 23:20:07
b2b59ddb10ea0bc9d7f0f39cea5f1d8742d1e83e...7e8b413bcf9d61819e46dda2fd567dcd379ce663,1,73,32,105,9,2013-05-09 23:20:06,2013-05-09 23:20:06
5c30faf6f7aba58c9b8be580acb043d56b64db1b...c20e46587d3fb09257e6ce7d085467da403210ee,1,16,0,16,1,2013-05-01 22:43:02,2013-05-01 22:43:02
5c30faf6f7aba58c9b8be580acb043d56b64db1b...a75a1b3859e6c30f0a24b262bdfc524dcdc07c3b,2,7,1,8,3,2013-05-01 22:24:28,2013-05-01 22:19:55
5c30faf6f7aba58c9b8be580acb043d56b64db1b...08812096f580c820d8cd06e3cb2128871551f60f,1,13,2,15,3,2013-05-01 21:16:56,2013-05-01 21:16:56
e392b7ee9b9cf70ff212e947142a0cf89ca7b8b0...424cc678ebac93c69c288fcdbc2e1a4bd0493328,1,1,1,2,1,2013-05-05 04:20:41,2013-05-05 04:20:41
e392b7ee9b9cf70ff212e947142a0cf89ca7b8b0...156123226119f14070ce0e675466d231fe19189c,1,73,18,91,17,2013-05-05 02:47:57,2013-05-05 02:47:57
f6b5cd77ebfff7b18dbfcdb8bfddce0f93305e23...6c1bb39c09446a608d48334fdf2b06cf0fac8d1a,1,3,3,6,3,2013-05-03 22:40:32,2013-05-03 22:40:32
6c1bb39c09446a608d48334fdf2b06cf0fac8d1a...1617a18258ccc7e07f30aef02a9b085627eb388a,1,2,1,3,1,2013-05-02 19:11:57,2013-05-02 19:11:57
1617a18258ccc7e07f30aef02a9b085627eb388a...83784989514ca010bf6c292b01482e0baa14ff85,1,2,2,4,2,2013-05-02 19:32:10,2013-05-02 19:32:10
83784989514ca010bf6c292b01482e0baa14ff85...64d7bc442daa012683b38183c71674b9ecd660c2,1,1,1,2,1,2013-05-02 20:56:45,2013-05-02 20:56:45
a7c0e9a355216048063894a3d47aac2d81c42c3f...2421838b0ac6a496503bc896da0e60d195132576,2,36,34,70,30,2013-05-06 17:51:04,2013-04-15 10:28:54
2421838b0ac6a496503bc896da0e60d195132576...2f082510a70a19fa83a7214485e3838e15bde22f,2,144,35,179,26,2013-05-06 17:51:07,2013-04-15 18:17:03
2f082510a70a19fa83a7214485e3838e15bde22f...e639309a7a9c12fe713857a988806285889b580c,2,161,156,317,13,2013-05-06 17:51:10,2013-04-17 17:21:32
e639309a7a9c12fe713857a988806285889b580c...1cf8a2c26c8ae663dea9a613dfb236e6c2257550,2,31,71,102,15,2013-05-06 17:52:08,2013-04-18 15:16:58
1cf8a2c26c8ae663dea9a613dfb236e6c2257550...7c1a27e2add585f22a833020dd0551a892b3af69,2,7,7,14,6,2013-05-06 17:52:10,2013-04-18 15:34:43
7c1a27e2add585f22a833020dd0551a892b3af69...048fd671ef107aa14f02e6fe2db4a4100c23d37f,3,20,4,24,5,2013-05-06 17:52:42,2013-04-19 15:25:55
048fd671ef107aa14f02e6fe2db4a4100c23d37f...e179c66400eeafd732218e981c5aaccd5a0b72c4,2,113,51,164,23,2013-05-06 17:54:41,2013-04-23 16:52:46
e179c66400eeafd732218e981c5aaccd5a0b72c4...6644a3c78a91d2212cc6449f25499e59b42a4397,2,60,59,119,2,2013-05-06 17:54:45,2013-04-23 19:02:16
6644a3c78a91d2212cc6449f25499e59b42a4397...23953e7d67c83bad8514a262acec5ed20bbbfa94,1,7,15,22,9,2013-05-06 17:54:46,2013-04-24 16:11:29
23953e7d67c83bad8514a262acec5ed20bbbfa94...84be35dce10682266b9a35d4156997c84485c769,1,5,6,11,5,2013-05-06 17:54:48,2013-04-24 19:15:34
84be35dce10682266b9a35d4156997c84485c769...630d358384194489e834d86cb4ae2f6dcc6a0ee5,1,2,1,3,2,2013-05-06 17:54:50,2013-04-25 16:15:36
630d358384194489e834d86cb4ae2f6dcc6a0ee5...4cd9e4722c92f05438779d10bf18206f65417644,1,2,1,3,3,2013-05-06 17:54:52,2013-04-25 16:24:29
4cd9e4722c92f05438779d10bf18206f65417644...6e936c8fd32357e839cb9337e621b1e152b9fd8b,1,14,0,14,1,2013-05-06 17:54:53,2013-04-25 16:36:05
6e936c8fd32357e839cb9337e621b1e152b9fd8b...ea3374bcb0b7a78ccbaeb9cd927fbaf259a5cf29,1,1,1,2,1,2013-05-06 17:54:55,2013-04-25 17:10:47
ea3374bcb0b7a78ccbaeb9cd927fbaf259a5cf29...3c85e9390e2d5fac418e03bac376eb1618487f3c,1,5,1,6,5,2013-05-06 17:54:57,2013-04-25 17:12:41
3c85e9390e2d5fac418e03bac376eb1618487f3c...be7560890644759c0ddd229afed208c537f075d7,5,150,88,238,39,2013-05-06 17:56:10,2013-04-26 21:00:09
be7560890644759c0ddd229afed208c537f075d7...1c76f91fc47637efff99ab7e5c5be8f4f84facb0,1,16,35,51,14,2013-05-06 17:56:45,2013-04-29 13:56:33
1c76f91fc47637efff99ab7e5c5be8f4f84facb0...e81a53eea9d5a44c3fde8d3060845ca18e95b4c4,1,6,1,7,2,2013-05-06 17:56:47,2013-04-30 13:55:24
e81a53eea9d5a44c3fde8d3060845ca18e95b4c4...6e2ddf6f608aa3d73b26b22dc3ff27f11534cdee,4,59,36,95,23,2013-05-06 17:56:49,2013-04-30 17:01:19
6e2ddf6f608aa3d73b26b22dc3ff27f11534cdee...f10b0f75e02041db64176760a3be9639408ad923,1,9,5,14,5,2013-05-06 17:56:50,2013-04-30 21:05:33
f10b0f75e02041db64176760a3be9639408ad923...b5873806d0f155b0fc16d224427f90548bfa8afe,1,58,4,62,7,2013-05-06 17:56:52,2013-04-30 21:11:16
b5873806d0f155b0fc16d224427f90548bfa8afe...19045b530eeacc97941cc1b63c2626f92df10f67,1,1,4,5,1,2013-05-06 17:56:54,2013-05-01 12:08:27
19045b530eeacc97941cc1b63c2626f92df10f67...be791a223b65d5641e032ea78ad7289b6eb58979,1,2,3,5,3,2013-05-06 17:56:55,2013-05-01 12:11:06
be791a223b65d5641e032ea78ad7289b6eb58979...5690562fc855a7e813a7e3cfb3340f60bd626530,1,2,1,3,1,2013-05-06 17:56:57,2013-05-01 12:26:52
5690562fc855a7e813a7e3cfb3340f60bd626530...594827d41640eb6a6a878c29aca87f7a4ce6249c,1,1,2,3,1,2013-05-06 17:56:59,2013-05-01 16:06:17
594827d41640eb6a6a878c29aca87f7a4ce6249c...18796d55a66f2f072349c54085516fe038bd8283,1,6,2,8,3,2013-05-06 17:57:00,2013-05-01 20:41:58
18796d55a66f2f072349c54085516fe038bd8283...0f68042053ac652de13cd68086d0188ac0ecf9b6,1,14,2,16,5,2013-05-06 17:57:03,2013-05-01 23:36:01
0f68042053ac652de13cd68086d0188ac0ecf9b6...0c5e76958bbfd5c4d315d75262381cbae5c5f048,1,3,4,7,4,2013-05-06 17:57:06,2013-05-02 15:06:11
0c5e76958bbfd5c4d315d75262381cbae5c5f048...d985050aeb3f1411b94b21f6db35a24f9a1f93f2,3,19,19,38,13,2013-05-06 17:57:36,2013-05-02 15:18:33
d985050aeb3f1411b94b21f6db35a24f9a1f93f2...a372f982c1383a3b4d742ef4f4de1a645cd7434d,1,3,3,6,3,2013-05-06 17:57:38,2013-05-02 22:39:44
a372f982c1383a3b4d742ef4f4de1a645cd7434d...bcdf03037b5f11d3760b45c96b9180f7b8da4b40,1,6,1,7,2,2013-05-06 17:57:41,2013-05-03 01:52:23
bcdf03037b5f11d3760b45c96b9180f7b8da4b40...3febeb93f553be0dceec81591a6e0ba578b42a12,1,3,0,3,1,2013-05-06 17:57:43,2013-05-03 01:57:15
3febeb93f553be0dceec81591a6e0ba578b42a12...00266df8ac64bb3b7e19818ad2dfb852dc0d2e7f,1,2,1,3,2,2013-05-06 17:57:45,2013-05-03 22:37:28
00266df8ac64bb3b7e19818ad2dfb852dc0d2e7f...b0e076f374c8919ba29ec24a8cd27785a8e0827c,2,46,40,86,11,2013-05-06 17:57:46,2013-05-02 22:30:03
b0e076f374c8919ba29ec24a8cd27785a8e0827c...c9994ed0fb01c65304fa8bd2eaf80f8a5edd6e41,1,1,1,2,2,2013-05-06 17:57:48,2013-05-04 16:22:45
c9994ed0fb01c65304fa8bd2eaf80f8a5edd6e41...09f1cbabb9ebc46776a832e1e695af7ef32a3de3,2,1,1,2,2,2013-05-06 18:06:44,2013-05-06 18:06:44
18b8eeb48492c27588da2d8c6c36f5f080338d56...701132259d843087fafb30d7a1feb05d1b4f7a8e,2,54,0,54,2,2013-05-03 22:13:12,2013-05-03 22:13:12
701132259d843087fafb30d7a1feb05d1b4f7a8e...5ffd63070f9b4d7516d58a4b3691be36d5ae93c6,3,17,1,18,3,2013-05-03 22:19:20,2013-05-03 22:19:20
9af5d9c527192a4da02fb8331cea941a40f2e11a...add73641e6a84cabac82b7ee7a2d72d5d78f1cf4,1,18,17,35,2,2013-05-09 23:23:50,2013-05-09 23:23:50
add73641e6a84cabac82b7ee7a2d72d5d78f1cf4...ff67da9c867d82192020e3840bd588acc959bcd3,2,93,60,153,52,2013-05-09 23:28:47,2013-05-09 23:28:47
ff67da9c867d82192020e3840bd588acc959bcd3...152ebeea4327c3240e211b96b5858063f0ee468b,4,54,62,116,33,2013-05-10 00:50:56,2013-05-10 00:50:56
152ebeea4327c3240e211b96b5858063f0ee468b...ede0793d94e0bafcddc65b1fcb683169accffea3,1,79,63,142,1,2013-05-10 00:51:27,2013-05-10 00:51:27
ede0793d94e0bafcddc65b1fcb683169accffea3...2a303dab8594420b6b7908183a73c5d744b1e66b,3,168,55,223,46,2013-05-10 02:19:24,2013-05-10 02:19:24
2a303dab8594420b6b7908183a73c5d744b1e66b...0c6380cc3237ac9eb1947223479ee13253d04287,2,4,4,8,4,2013-05-10 02:19:55,2013-05-10 02:19:55
0c6380cc3237ac9eb1947223479ee13253d04287...24816a8b80cb9d5b97d876f99a8300924f6abf9c,2,284,142,426,68,2013-05-10 03:13:52,2013-05-10 03:13:52
24816a8b80cb9d5b97d876f99a8300924f6abf9c...eeaea4e873a4850a24e300461975e5d9636fef08,2,4,4,8,4,2013-05-10 03:19:21,2013-05-10 03:19:21
eeaea4e873a4850a24e300461975e5d9636fef08...483c9425208fbc649cd12d157892be5a7ea92924,2,21,21,42,16,2013-05-10 04:53:28,2013-05-10 04:53:28
483c9425208fbc649cd12d157892be5a7ea92924...28fd289b448164b77affd8103c0d96fd8110daf9,2,2,1,3,2,2013-05-10 04:53:59,2013-05-10 04:53:56
28fd289b448164b77affd8103c0d96fd8110daf9...310fec4819422ad7ee7a73543746bbd1977ef285,1,47,15,62,6,2013-05-10 04:54:43,2013-05-10 04:54:43
310fec4819422ad7ee7a73543746bbd1977ef285...15ae314cbb8ede09a2d2c9e70c6a0d7d87817b64,2,121,10,131,9,2013-05-10 04:55:08,2013-05-10 04:55:08
15ae314cbb8ede09a2d2c9e70c6a0d7d87817b64...1941c7919532b261984214ce4dc6a7927154d9e9,2,7,8,15,7,2013-05-10 05:28:52,2013-05-10 05:28:52
1941c7919532b261984214ce4dc6a7927154d9e9...9897e78e328152fa41f99bd53f7c3a6993c3f87a,1,8,9,17,9,2013-05-10 05:29:12,2013-05-10 05:29:12
ad86dde10c815135ead82ed3c97caa892f7e30ed...e7fb7f13d51b4026571e47981f0d432cc4b59f80,1,12,2,14,4,2013-05-01 23:43:37,2013-05-01 23:43:37
08812096f580c820d8cd06e3cb2128871551f60f...bb61678b570fabeb5d21c86fa3f7b5456111f7a2,10,134,9,143,9,2013-05-01 22:26:27,2013-05-01 18:20:10
bb61678b570fabeb5d21c86fa3f7b5456111f7a2...eeb03164cf1ea1b6a2abae2536cb1360c9ac8251,1,3,4,7,2,2013-05-01 22:26:27,2013-05-01 22:25:58
eeb03164cf1ea1b6a2abae2536cb1360c9ac8251...d172da58ceddd93c4a93132eae652e7996e1a2d2,2,27,20,47,2,2013-05-01 22:59:54,2013-05-01 22:59:54
6ac33eb64936e16769ea6e6efb57c0bd98bc7aeb...c718eb282b2d0d9479e566f1d8c3dd856eee8334,1,6,6,12,1,2013-05-07 13:57:26,2013-05-07 13:57:26
6ac33eb64936e16769ea6e6efb57c0bd98bc7aeb...0a13ce9befa57c45941b01cf71675e87d878fca4,1,2,2,4,2,2013-05-07 12:33:29,2013-05-07 12:33:29
6ac33eb64936e16769ea6e6efb57c0bd98bc7aeb...0a197f9b4fe5f63abf60a17b8d595dd72b7eb471,1,5,0,5,1,2013-05-07 11:54:58,2013-05-07 11:54:58
6ac33eb64936e16769ea6e6efb57c0bd98bc7aeb...d56c5406acb3f48ee338a8e4007be7c135074779,3,60,1,61,5,2013-05-07 10:49:08,2013-05-07 10:49:08
d56c5406acb3f48ee338a8e4007be7c135074779...3d25e09c3b572a7f060e4e7ad0f3b4a2f191e9de,1,1,1,2,1,2013-05-07 10:54:31,2013-05-07 10:54:31
3d25e09c3b572a7f060e4e7ad0f3b4a2f191e9de...4df26b9ee74c9d381447a10f9eae5db1ab1872c8,1,1,0,1,1,2013-05-07 17:29:49,2013-05-07 17:29:49
4df26b9ee74c9d381447a10f9eae5db1ab1872c8...82513815f1d2bee77ae729b4293e29d6377ab03d,1,10,0,10,1,2013-05-07 17:31:55,2013-05-07 17:31:55
6ac33eb64936e16769ea6e6efb57c0bd98bc7aeb...23c5c130148985e3e527fa799beb45326ac791a9,1,4,4,8,3,2013-05-07 04:31:59,2013-05-07 04:31:59
840bde43938d45b64865b1c812b17874e7fe90f5...2ac7298e4e4d8babcdd8ea0c9aeeb56c4857e035,1,2,0,2,1,2013-05-06 19:24:44,2013-05-06 19:24:44
64d7bc442daa012683b38183c71674b9ecd660c2...f4de9d919d7ad6cf677c8157eabf82cf65aa4396,1,105,64,169,11,2013-05-04 04:12:43,2013-05-01 05:39:48
f4de9d919d7ad6cf677c8157eabf82cf65aa4396...3dba4022adbd1f21a8b2ec4a6035cacfe143b380,2,72,1,73,2,2013-05-04 04:12:43,2013-05-03 16:47:52
3dba4022adbd1f21a8b2ec4a6035cacfe143b380...359ecf88de8b1ed4392ff82aac276353d5d664f0,2,10,0,10,1,2013-05-04 04:12:43,2013-05-04 03:44:10
64d7bc442daa012683b38183c71674b9ecd660c2...b9ec03c21b8fdbc54fdd7a3cb86f3c555e91f989,1,1,1,2,1,2013-05-03 03:50:28,2013-05-03 03:50:28
da01dd3d56a86f9a1256d3f80c0a4cac5d14bedb...4f202cd07f3d9281e186024bbf6770bf93537235,3,26,6,32,8,2013-05-05 14:46:25,2013-05-05 14:42:23
4f202cd07f3d9281e186024bbf6770bf93537235...bbad653b1aedb174500cf7b643ad945bea0d634a,1,3,2,5,2,2013-05-06 19:00:39,2013-05-06 19:00:39
09b1cd58c00d6b10496ab8f517137268a8bc54ab...71199f595de081a4f2e93142d9f5b98df16e9089,1,8,4,12,4,2013-05-02 01:32:38,2013-05-02 01:32:38
71199f595de081a4f2e93142d9f5b98df16e9089...6ca3b151b1fc0b838b55586adbc6c0990cfb2586,1,6,4,10,3,2013-05-02 05:05:36,2013-05-02 05:05:36
6ca3b151b1fc0b838b55586adbc6c0990cfb2586...e7271cdaae50db382d5b5728904063c07d5549e4,1,3,3,6,2,2013-05-02 05:56:51,2013-05-02 05:56:51
e7fb7f13d51b4026571e47981f0d432cc4b59f80...d42639e5c5623109acd302ddead237ce4d9c2617,3,26,1,27,3,2013-05-02 00:17:13,2013-05-02 00:17:13
f46ab22b7a15f2bd974029819e487577d9593141...d2eb2455a1fc379dbac94d651b0785b631b84add,1,5,1,6,1,2013-05-07 17:57:21,2013-05-07 17:57:21
a2b5196061bf7fd174c52fce2e245c85a1506c45...42b1ea4889cd61790f81001ada5deac9354be378,3,29,2,31,4,2013-05-07 18:18:13,2013-05-07 18:18:13
a2b5196061bf7fd174c52fce2e245c85a1506c45...efd9becb78c82ddef07efb7e76e0100d7a712281,7,19,2,21,11,2013-05-07 18:16:30,2013-05-07 18:16:30
efd9becb78c82ddef07efb7e76e0100d7a712281...e36752e03347bf46177d8ee810cdd5a019321dc9,2,2,2,4,2,2013-05-07 18:43:45,2013-05-07 18:43:45
e36752e03347bf46177d8ee810cdd5a019321dc9...af9f559f2ebd6438f37fef890f2a25eca590f252,1,1,1,2,1,2013-05-07 18:44:24,2013-05-07 18:44:24
af9f559f2ebd6438f37fef890f2a25eca590f252...eef8b0d406412ffe6622ed1f2c858540eb7f75f1,1,3,0,3,1,2013-05-07 18:44:38,2013-05-07 18:44:38
7b1ec9ff30a0b239466a47b576c1352069fe7688...0f4469c2b1164eab9bc6104913cf8dccacac214f,11,36,155,191,22,2013-05-09 00:05:46,2013-05-09 00:05:46
7b1ec9ff30a0b239466a47b576c1352069fe7688...070b1cd541cb8a60755a3c5244af00bca6ccaf51,2,9,0,9,2,2013-05-08 19:13:31,2013-05-08 19:13:31
7b1ec9ff30a0b239466a47b576c1352069fe7688...c4ebf870c8a9cef909e66fb517e607896ea8a518,1,4,6,10,3,2013-05-08 17:35:41,2013-05-08 17:35:41
c4ebf870c8a9cef909e66fb517e607896ea8a518...8ff1765674c93a169fe29483503709a008f30618,2,40,12,52,15,2013-05-08 19:01:12,2013-05-08 17:42:29
8ff1765674c93a169fe29483503709a008f30618...6cafed45afb74d07b13e8c00798e559da47822e7,1,10,5,15,4,2013-05-08 21:19:38,2013-05-08 21:19:38
6cafed45afb74d07b13e8c00798e559da47822e7...0e23b4e10ec7f7c49c5715cd115f859319adf476,3,48,10,58,8,2013-05-08 23:27:35,2013-05-08 23:22:12
2ac7298e4e4d8babcdd8ea0c9aeeb56c4857e035...8646f7f11cf9c59865fdf1a4800251e2010f1b5c,1,20,10,30,3,2013-05-06 21:11:38,2013-05-06 21:11:38
2ac7298e4e4d8babcdd8ea0c9aeeb56c4857e035...0fabd390a91ae34d85bb873d05ce7132266ce3a4,1,1,2,3,1,2013-05-06 20:11:08,2013-05-06 20:11:08
0fabd390a91ae34d85bb873d05ce7132266ce3a4...87cc8b6058c8cf185825a039d2320af578cb8f8a,3,9,9,18,7,2013-05-06 20:26:23,2013-05-06 20:26:23
8472a27e80849318161ed7d8f30a8b431b1571a8...e45aef0c82044be6a427502d4bbb0979074c2ba1,1,30,0,30,5,2013-05-07 01:39:56,2013-05-07 01:39:56
e45aef0c82044be6a427502d4bbb0979074c2ba1...4c7c177e4ea4a166e656306e1d845cdb9e2f37ce,1,10,1,11,1,2013-05-07 01:54:27,2013-05-07 01:54:27
eed64e6777812702e95541b69cac60cd74da59da...0410397704c4cd81da9ad45dab21d4432b4b1a13,1,1,1,2,1,2013-05-09 19:05:18,2013-05-09 19:05:18
eed64e6777812702e95541b69cac60cd74da59da...0a5d86d7beba53332e1c842e61a5751b95894601,1,1,1,2,1,2013-05-09 16:57:47,2013-05-09 16:57:47
eed64e6777812702e95541b69cac60cd74da59da...73321f27f4518fca83f6707da947e0811b39795a,1,30,13,43,6,2013-05-09 02:36:06,2013-05-09 02:36:06
eed64e6777812702e95541b69cac60cd74da59da...aaaf3f072601923594754e46c1f0152847d9c2d9,3,45,8,53,8,2013-05-09 02:08:11,2013-05-09 02:08:11
aaaf3f072601923594754e46c1f0152847d9c2d9...80f4b0df75c21736cec93730bee18761035f53aa,1,32,3,35,7,2013-05-09 02:36:12,2013-05-09 02:36:12
80f4b0df75c21736cec93730bee18761035f53aa...463658dc8fd9bbf0e15d5b13d9da3710144d1407,1,56,73,129,22,2013-05-09 05:06:23,2013-05-09 05:06:23
463658dc8fd9bbf0e15d5b13d9da3710144d1407...44b33b44aa1445bad0bcb5852c7a1606e30620f7,3,65,36,101,12,2013-05-09 05:37:33,2013-05-09 05:37:33
44b33b44aa1445bad0bcb5852c7a1606e30620f7...c7a7983fcbe28d67648b32e37029ac84482cffcf,1,18,1,19,3,2013-05-09 05:45:40,2013-05-09 05:45:40
c7a7983fcbe28d67648b32e37029ac84482cffcf...55cf05835b6f55e7ec83c63bc69a570876722df5,1,22,18,40,6,2013-05-09 06:29:02,2013-05-09 06:29:02
55cf05835b6f55e7ec83c63bc69a570876722df5...3cbf5670c5de9948dedf439defb0d772531e717d,1,8,26,34,6,2013-05-09 18:12:37,2013-05-09 18:12:37
3cbf5670c5de9948dedf439defb0d772531e717d...30f009150f303ff496307778722ed5c2c3ad80c8,1,1,1,2,1,2013-05-09 20:24:00,2013-05-09 20:24:00
45b5d3027ee0ebeff98559ad4fbb5b1085eb9c0a...c4ad6b077d87bb501ed651bfc87c3e332c7d38d7,1,1,1,2,1,2013-05-08 20:51:50,2013-05-08 20:50:26
c25597690939feb73094a557a49c6f7085b67cac...5098c4fc006c15788142a669a0d169b03de7be8b,1,2,1,3,2,2013-05-08 23:40:48,2013-05-08 23:40:48
5098c4fc006c15788142a669a0d169b03de7be8b...06767fb99d997fe939febb086e8fa12414419053,3,53,1,54,3,2013-05-08 23:52:47,2013-05-08 23:52:47
b38fc9fcdcf96e45dcf144daa3e9c1ed32e55411...0d929d13d360bbcbb2e524d44253a5f405cd041f,5,93,76,169,29,2013-05-07 00:41:51,2013-05-07 00:41:51
b38fc9fcdcf96e45dcf144daa3e9c1ed32e55411...27319da0d260b42acdbc3fd2a639ad3986d1ba64,2,139,0,139,4,2013-05-06 23:00:30,2013-04-24 18:03:01
27319da0d260b42acdbc3fd2a639ad3986d1ba64...b8f66c0d14780bd8cb3b8916acc0287fcaf8cafa,1,38,13,51,7,2013-05-06 23:00:30,2013-04-24 19:02:00
b8f66c0d14780bd8cb3b8916acc0287fcaf8cafa...97215ca384373bfa65c08dc05454c14cef493d30,1,3,3,6,3,2013-05-06 23:00:30,2013-04-24 19:31:20
97215ca384373bfa65c08dc05454c14cef493d30...7bccdc0d33d0589792b9b867b13c9e50dcf48358,1,5,1,6,2,2013-05-06 23:00:30,2013-04-24 20:35:57
7bccdc0d33d0589792b9b867b13c9e50dcf48358...97514831128a7bc7bc6a2f740275bf6336ede999,2,55,0,55,3,2013-05-06 23:00:30,2013-04-24 20:37:00
97514831128a7bc7bc6a2f740275bf6336ede999...9db4972a70c2fb0921f984d67f816b81ea687a11,3,8,3,11,3,2013-05-06 23:00:30,2013-04-24 20:51:28
9db4972a70c2fb0921f984d67f816b81ea687a11...0aebb254106be3086838cac145404c5d21c6bcd0,1,32,3,35,3,2013-05-06 23:00:30,2013-04-24 21:28:51
0aebb254106be3086838cac145404c5d21c6bcd0...6f2125386a07a01eccce3bb4602aeecb8be3458b,3,90,23,113,23,2013-05-06 23:00:30,2013-04-24 22:14:10
6f2125386a07a01eccce3bb4602aeecb8be3458b...f7c5e92a2e1ec30f50b0affe952a0496c62195f5,3,28,29,57,6,2013-05-06 23:00:30,2013-04-24 22:24:14
f7c5e92a2e1ec30f50b0affe952a0496c62195f5...ff95f2b0ecf54fdfeffa1aa008e22cb5c7ec59d6,3,53,37,90,40,2013-05-06 23:00:30,2013-04-24 22:35:28
ff95f2b0ecf54fdfeffa1aa008e22cb5c7ec59d6...74b9e851f6f407ede9d46ab4960e5e134ff666c7,1,4,0,4,1,2013-05-06 23:00:30,2013-04-25 15:08:05
74b9e851f6f407ede9d46ab4960e5e134ff666c7...dade95844feaa2446e472767e1e2763996241dee,3,33,21,54,22,2013-05-06 23:00:30,2013-04-25 18:20:45
dade95844feaa2446e472767e1e2763996241dee...e337949cb0ce8eda0673e005e670c12e997a3336,1,88,0,88,1,2013-05-06 23:00:30,2013-04-25 18:20:56
e337949cb0ce8eda0673e005e670c12e997a3336...4390a3182f9ea4fc1e215917c2c6494d6fc453ac,1,3,0,3,1,2013-05-06 23:00:30,2013-04-28 04:45:05
4390a3182f9ea4fc1e215917c2c6494d6fc453ac...034c7a7a5e3838efb1fd06f544ae9a8b21e1e1b9,1,3,20,23,3,2013-05-06 23:00:30,2013-05-01 01:03:15
034c7a7a5e3838efb1fd06f544ae9a8b21e1e1b9...bbb634a98068171b6b6f4bbb9c7160284ef252e4,5,117,1,118,6,2013-05-06 23:01:00,2013-05-01 20:37:32
bbb634a98068171b6b6f4bbb9c7160284ef252e4...6bfb652f5b1bce989868f8269c3d736f3faf259a,1,4,4,8,4,2013-05-06 23:01:00,2013-05-01 20:45:35
6bfb652f5b1bce989868f8269c3d736f3faf259a...4386edff0bc940543c61aa91d1f2144802ce1a08,1,16,12,28,11,2013-05-06 23:01:00,2013-05-01 20:45:50
4386edff0bc940543c61aa91d1f2144802ce1a08...6c168a8986261c95ae5e036f008375f77afbe78e,4,54,115,169,10,2013-05-06 23:01:00,2013-05-01 21:36:45
6c168a8986261c95ae5e036f008375f77afbe78e...15ea5a479a78d1011cda9bd55fd442d810234eb6,1,5,5,10,2,2013-05-06 23:01:01,2013-05-01 21:37:26
15ea5a479a78d1011cda9bd55fd442d810234eb6...4ebec08add53bd9b3e10c331168daa6579ebd6db,1,4,4,8,2,2013-05-06 23:01:01,2013-05-01 22:05:52
4ebec08add53bd9b3e10c331168daa6579ebd6db...924b61328cd63fc8b1da77d9cb4f1e6b85eb1592,1,20,1,21,2,2013-05-06 23:01:01,2013-05-01 22:06:23
924b61328cd63fc8b1da77d9cb4f1e6b85eb1592...6d6a03dfba37a8f1bd7304467db86ebe248ed2b5,1,1,1,2,1,2013-05-06 23:01:01,2013-05-01 22:06:40
6d6a03dfba37a8f1bd7304467db86ebe248ed2b5...92e98c66af7543f9a9d6c1a223333201b39aa6dc,1,8,3,11,5,2013-05-06 23:01:01,2013-05-01 23:26:26
92e98c66af7543f9a9d6c1a223333201b39aa6dc...ae1e655fb1d95b5828a2b0cd67d19d090d04ff74,1,29,0,29,1,2013-05-06 23:01:01,2013-05-01 23:26:46
ae1e655fb1d95b5828a2b0cd67d19d090d04ff74...2bc4ad940259bd46f0ff4d3c9462893004188416,1,0,1,1,1,2013-05-06 23:01:01,2013-05-05 13:27:15
2bc4ad940259bd46f0ff4d3c9462893004188416...62a1850c16180ac83418e044e315ba8776f6a651,1,11,9,20,2,2013-05-06 23:40:45,2013-05-06 23:40:45
b38fc9fcdcf96e45dcf144daa3e9c1ed32e55411...2f89315bf882f6b507f843a65fcf08ba2ae91959,1,8,14,22,5,2013-05-06 23:00:21,2013-05-06 23:00:21
b38fc9fcdcf96e45dcf144daa3e9c1ed32e55411...f20b5e1323a6da49b060ccb18af12899296706e6,2,3,1,4,3,2013-05-06 22:58:04,2013-05-06 22:58:04
b38fc9fcdcf96e45dcf144daa3e9c1ed32e55411...15b85d9d762106e03657ecde183303f6535ad90e,3,20,17,37,7,2013-05-06 22:56:50,2013-05-03 22:03:01
b38fc9fcdcf96e45dcf144daa3e9c1ed32e55411...627f7fdbfdfeb281e73e04623915d515e02cf697,1,29,0,29,1,2013-05-06 21:24:14,2013-05-06 21:24:14
627f7fdbfdfeb281e73e04623915d515e02cf697...f796b9c76eb29ae80ea47d290fba3403ab8e1b4c,1,2,2,4,2,2013-05-06 21:26:07,2013-05-06 21:26:07
f796b9c76eb29ae80ea47d290fba3403ab8e1b4c...b6af9d3d2eb4e1b409f022264192923a631cd85a,1,8,8,16,4,2013-05-06 21:26:58,2013-05-06 21:26:58
1c5e9f8a88a4323dfa18279d267055256234ea6e...53a8229ce7f8d4d1dfb7a85a31ed25613a9f9813,1,393,20,413,12,2013-05-10 14:49:47,2013-05-10 14:49:47
53a8229ce7f8d4d1dfb7a85a31ed25613a9f9813...17c1704f4a0be19c7a3e3c0d449aede2a6aae05b,1,1,1,2,1,2013-05-10 15:00:26,2013-05-10 15:00:26
1c5e9f8a88a4323dfa18279d267055256234ea6e...82313b1de9041896e33ddd8fab63924fb7bdebc3,1,6,1,7,1,2013-05-10 08:18:01,2013-05-10 08:18:01
edc7c092d926defa19d8b30dda7d3add38505ca0...be9dd7b85f889e31fbd93465535b9962ed585ced,1,1,1,2,1,2013-05-13 20:08:16,2013-05-13 20:08:16
8fb8a08ff29bc5ac903ba86b449b3c12eeb19af7...e289308dff229bf70852f7c549cc7aafeedd4ec9,3,19,1,20,4,2013-05-09 20:51:32,2013-05-09 20:51:32
e289308dff229bf70852f7c549cc7aafeedd4ec9...074a566164d7df97325a97bb1ec469dbce26b20f,1,4,4,8,4,2013-05-09 21:48:10,2013-05-09 21:48:10
3484781a6f4367c3b534cb5575c0d1516a5ffc14...d6c24092eb0e24f7aaa921110c62e99e81ae1f88,1,3,1,4,3,2013-05-08 22:35:35,2013-05-08 22:26:44
62a1850c16180ac83418e044e315ba8776f6a651...e2880950c5ea721be00a814d93ea256feb9f98bb,1,1,0,1,1,2013-05-06 23:42:53,2013-04-24 18:03:01
e2880950c5ea721be00a814d93ea256feb9f98bb...ebb59c1125d194716f26b8cc53863fa9910c4b3f,1,0,2,2,1,2013-05-06 23:42:54,2013-05-01 01:03:15
ebb59c1125d194716f26b8cc53863fa9910c4b3f...d92166cc7937afa39e2ed537c601555a0a5b84eb,1,1,0,1,1,2013-05-06 23:43:50,2013-05-05 03:58:45
d92166cc7937afa39e2ed537c601555a0a5b84eb...96069de4e0818f9d513f6ea495e03d8e67eb1e98,2,39,270,309,30,2013-05-06 23:44:37,2013-04-24 18:03:01
96069de4e0818f9d513f6ea495e03d8e67eb1e98...f911ccc27bcbcf281a0d690c5d7b05709c8947d4,1,125,18,143,12,2013-05-06 23:44:37,2013-04-24 22:14:10
f911ccc27bcbcf281a0d690c5d7b05709c8947d4...9959e2cd637d09e8c37891cebcb1764c825ef7d5,1,55,8,63,6,2013-05-06 23:44:37,2013-05-01 21:36:45
9959e2cd637d09e8c37891cebcb1764c825ef7d5...a46fc3a59e585e005ec67b05211ca9de02f0c4ff,2,115,7,122,5,2013-05-06 23:44:37,2013-05-02 07:49:23
a46fc3a59e585e005ec67b05211ca9de02f0c4ff...756df27e45f2e5d9033058f60afa9547239af1d6,1,2,2,4,2,2013-05-06 23:44:37,2013-05-02 08:18:48
756df27e45f2e5d9033058f60afa9547239af1d6...35c59f4e05fb8dc3a5939d6af8c9313ebda6a5dd,2,88,35,123,40,2013-05-06 23:58:09,2013-05-06 23:58:09
926c1d45aa3fbf86d63d20d4df5bf91b36bc2382...1dae7a25b919dc70798cbab8107809690212cd69,3,46,37,83,14,2013-05-31 22:53:57,2013-05-31 22:53:57
1dae7a25b919dc70798cbab8107809690212cd69...f41d2ec4d91f2fa1dc479d8bac32113fbb7e987e,1,7,6,13,4,2013-05-31 22:56:30,2013-05-31 22:56:30
17c1704f4a0be19c7a3e3c0d449aede2a6aae05b...5bec9275c01f646ba6a5afd19ea80a38c41604a7,2,199,173,372,22,2013-05-10 19:28:07,2013-05-10 19:28:07
5bec9275c01f646ba6a5afd19ea80a38c41604a7...ae80c37054835dc0cd55f81c9f97ca07ed80081c,1,2,3,5,2,2013-05-10 20:58:21,2013-05-10 20:58:21
17c1704f4a0be19c7a3e3c0d449aede2a6aae05b...7557af19d8cc3fba858b3ab67cef4875b6097c42,18,167,111,278,31,2013-05-10 19:00:12,2013-05-10 00:05:20
7557af19d8cc3fba858b3ab67cef4875b6097c42...8946b75a0b8bce77f630020f6c0fcdae3404b922,2,28,28,56,2,2013-05-10 19:25:02,2013-05-10 19:25:02
17c1704f4a0be19c7a3e3c0d449aede2a6aae05b...dbc899130cbe112046584f08a9733b688aa77003,1,154,131,285,127,2013-05-10 18:20:49,2013-05-10 18:20:49
dbc899130cbe112046584f08a9733b688aa77003...67cdfc0c834fcac7d288124611642df14aac075c,1,19,28,47,15,2013-05-10 19:11:59,2013-05-10 19:11:59
d270501de21c026f06cd133a84ce11d20dd64bd8...a98eafaf58ea250d6cd75d2f175f66d705d4a0eb,1,75,38,113,32,2013-05-10 21:49:42,2013-05-10 21:49:42
a98eafaf58ea250d6cd75d2f175f66d705d4a0eb...9416574569b3969f1844c83cf4e24bc50957aaf5,1,20,5,25,6,2013-05-11 17:34:26,2013-05-11 17:34:26
d270501de21c026f06cd133a84ce11d20dd64bd8...052a15ace9bd6391ef1e935f949f986ee9840d47,1,1,1,2,1,2013-05-10 21:25:45,2013-05-10 21:25:45
35c59f4e05fb8dc3a5939d6af8c9313ebda6a5dd...602786cd60746cd2baf7bb14fb6acb60f9554f50,1,7,0,7,2,2013-05-07 00:00:51,2013-04-24 22:14:10
602786cd60746cd2baf7bb14fb6acb60f9554f50...a64ebe5feb84d65adbc23ee9d2119f5eab836079,1,5,1,6,4,2013-05-07 00:01:59,2013-05-02 09:51:14
a64ebe5feb84d65adbc23ee9d2119f5eab836079...db4417b601feedb03cc70b79f64456e817ce0c05,1,30,1,31,3,2013-05-07 00:01:59,2013-05-02 10:00:56
db4417b601feedb03cc70b79f64456e817ce0c05...979db00d9af4741572ece9c67061526d5d4a6616,1,1,1,2,1,2013-05-07 00:01:59,2013-05-02 10:58:58
979db00d9af4741572ece9c67061526d5d4a6616...3439cd9cea8056cce62d46dd5cf59d6d5b50ef84,1,0,7,7,2,2013-05-07 00:07:56,2013-05-07 00:07:56
0443cc351d1202063c79a4de5497878f9a9e674e...8243f2510e0ff0af8df18bf0febab819529106d4,1,2,2,4,1,2013-06-03 13:44:00,2013-06-03 13:44:00
2cf29893b3b1e6fc526bdf45734f942317598611...e77263010ce882790f12dfcd0841ea784dab0738,1,11,50,61,6,2013-05-23 15:47:20,2013-05-23 15:47:20
e77263010ce882790f12dfcd0841ea784dab0738...dbb7b60cfc97dc1b7a1412775475048b6bf18e67,1,33,32,65,4,2013-05-23 15:49:53,2013-05-23 15:49:53
d7adeb8a4569d84d80af1a1bc15ffa4e23e1ffc3...7cc082347f4adf3188c9614a9e9a82c2d6ff5656,1,154,131,285,127,2013-05-10 22:10:15,2013-05-10 18:20:49
7cc082347f4adf3188c9614a9e9a82c2d6ff5656...f7beba3accf22f1549aef9ed70bbde2afbdc4af0,1,19,28,47,15,2013-05-10 22:10:15,2013-05-10 19:11:59
f7beba3accf22f1549aef9ed70bbde2afbdc4af0...b99446831f576d626f78be7baea09af8520d125b,1,71,121,192,61,2013-05-10 22:24:07,2013-05-10 22:24:07
097531d8532d778faacac29ce6ff6c5b2766c473...6390d2501088f74815adff5e1cb0ba5886ed057e,3,1,15,16,2,2013-05-13 18:21:28,2013-05-13 18:21:28
908e4797a66715ca1011867aa6e13b10ee22dae6...824ad4274a6de5bacb67bce892faaeb0094977b2,1,1,1,2,1,2013-05-13 17:45:50,2013-05-13 17:45:45
908e4797a66715ca1011867aa6e13b10ee22dae6...182842e3c3cb56e8b2012629d06822c8f395e826,1,1,1,2,1,2013-05-13 17:19:27,2013-05-13 17:19:27
908e4797a66715ca1011867aa6e13b10ee22dae6...a91b710961b74341543a81b9d16f66d65b1907f1,8,105,11,116,19,2013-05-13 13:14:20,2013-05-13 13:10:26
908e4797a66715ca1011867aa6e13b10ee22dae6...1990c49a6235530a3ddedc00db3aa38acf93a9c5,6,48,74,122,28,2013-05-13 10:18:55,2013-05-13 10:18:55
1990c49a6235530a3ddedc00db3aa38acf93a9c5...e82ff22fae096e64e9ec0f621a532eaa62b40deb,3,17,6,23,6,2013-05-13 10:26:18,2013-05-13 10:26:18
908e4797a66715ca1011867aa6e13b10ee22dae6...761731215f1a8b20447dec5bc3841137a5445c68,1,96,109,205,80,2013-05-13 09:48:27,2013-05-13 09:48:27
761731215f1a8b20447dec5bc3841137a5445c68...4fb89027e66b3e51c78a738290bd3dad89e0a77c,1,7,6,13,6,2013-05-13 18:34:09,2013-05-13 18:34:09
4fb89027e66b3e51c78a738290bd3dad89e0a77c...f27415540f7bc9d19f2b92e727c4487a57838b7f,1,40,37,77,38,2013-05-15 14:16:46,2013-05-15 14:16:46
908e4797a66715ca1011867aa6e13b10ee22dae6...8b31d30601f487bca5e4985c6a14b89e47ac83be,2,9,1,10,2,2013-05-13 09:39:24,2013-05-13 09:38:13
908e4797a66715ca1011867aa6e13b10ee22dae6...823bc74935b8f3713c7443c617402334dc5fbda4,2,206,0,206,2,2013-05-11 23:03:41,2013-05-11 23:03:41
823bc74935b8f3713c7443c617402334dc5fbda4...f074e983bd99a19509f96e235a2f35fbe1cab849,2,27,12,39,4,2013-05-12 17:12:44,2013-05-12 17:12:44
f074e983bd99a19509f96e235a2f35fbe1cab849...87038311fc0869d8dd9303d11ed79279238b0b6e,1,1,1,2,1,2013-05-13 01:46:35,2013-05-13 01:46:35
908e4797a66715ca1011867aa6e13b10ee22dae6...a47d8799b190ba44d7bea2a39e05f98f6019f952,1,8,8,16,1,2013-05-11 22:50:06,2013-05-11 22:50:06
3439cd9cea8056cce62d46dd5cf59d6d5b50ef84...dae2828957b6b962109a9f7ad061e9ddd90b8833,1,7,0,7,2,2013-05-07 00:09:58,2013-04-24 22:14:10
dae2828957b6b962109a9f7ad061e9ddd90b8833...49b05eb24a3281a8d57791b09f5b82f7dafc87f8,1,34,4,38,5,2013-05-07 00:10:42,2013-05-02 11:12:42
49b05eb24a3281a8d57791b09f5b82f7dafc87f8...7757be1f452c625d26d1b086384003ab6131e6d4,1,0,7,7,2,2013-05-07 00:12:56,2013-05-07 00:12:56
2b1b3c1270c41a1c4c71ba2be9f33af68ea22861...1ce4ba6c9f381f7931615644675b0cad33e74492,1,0,6,6,1,2013-06-03 15:33:29,2013-06-03 15:33:29
66f3a96983ab5c71e1c21e04acfd5a7d199b6840...e0e385ac696c339958cdb9b4094c25f120dae1ec,1,0,6,6,1,2013-05-23 17:12:54,2013-05-23 17:12:54
e0e385ac696c339958cdb9b4094c25f120dae1ec...d17c0b83681d45f4b4c57ca66cfc574246fd6618,2,39,28,67,4,2013-05-23 19:45:00,2013-05-23 19:42:58
d17c0b83681d45f4b4c57ca66cfc574246fd6618...822056094aa31c224e78cd568e02fe5458a0eecc,1,1,1,2,1,2013-05-23 19:46:14,2013-05-23 19:46:14
dfbea4ad9fc22a326485b4a51f3987a504ce6e52...9cfcfbae522eac5b771babf017d1d4b2ceb5d249,1,4,2,6,2,2013-05-11 17:27:42,2013-05-11 17:27:42
6fce89e60b71ee2306d66003697b6c746c456250...ed56b6a905d5e9f443cb0c5c949965f848abbe8d,1,1,1,2,1,2013-05-23 09:35:20,2013-05-23 09:35:20
ed56b6a905d5e9f443cb0c5c949965f848abbe8d...b45143da9b275b5003c23667b0988ad93f383b11,2,17,5,22,5,2013-05-23 10:29:09,2013-05-23 10:29:09
b45143da9b275b5003c23667b0988ad93f383b11...1c946ef0038a27d134f497ed72352136c0a4bb9e,1,1,1,2,2,2013-05-24 13:03:09,2013-05-24 13:03:09
ccc4fae30a31a1a84384fdb2013763a1782d2172...48fcde81935659971e849b52136be80f9c8cad4a,1,1,1,2,1,2013-05-13 22:10:24,2013-05-13 22:10:24
a373c770b63982674e24704789f80e0ce15bb55d...561ceac55d5821a00258934cf9dc215278e3ecfd,2,4,2,6,2,2013-06-01 05:25:48,2013-06-01 05:25:48
822056094aa31c224e78cd568e02fe5458a0eecc...83bc5b7435565d227a7745f4832bc9ce6be7a80d,1,2,2,4,2,2013-05-23 20:54:51,2013-05-23 20:48:50
d586662ce5d53cf731fcc94216e59d8381f109c4...ce35f5d89939a20c7e9a5466f837b1ac919609fc,8,189,235,424,84,2013-05-15 23:11:59,2013-05-15 23:11:59
ce35f5d89939a20c7e9a5466f837b1ac919609fc...2ebbd2d6367e9bf83f2ea3f28f7a0f462260913d,6,0,533,533,5,2013-05-15 23:13:20,2013-05-15 23:13:20
2ebbd2d6367e9bf83f2ea3f28f7a0f462260913d...b5c1b17b50cf7d0fdc9c8894d10bb285d2e755b4,1,3,1,4,2,2013-05-15 23:19:18,2013-05-15 23:19:18
b5c1b17b50cf7d0fdc9c8894d10bb285d2e755b4...8454a86e9733b3eddc6dcd5583bef58785a550d7,10,228,86,314,20,2013-05-16 03:00:20,2013-05-16 03:00:20
d586662ce5d53cf731fcc94216e59d8381f109c4...04748a77664c89340b789ef0a25d65b78477dce0,1,1,1,2,1,2013-05-15 19:51:04,2013-05-15 19:51:04
04748a77664c89340b789ef0a25d65b78477dce0...52ef89f9c20d02ca341c979e3d4cb8bd13aa0146,1,1,1,2,1,2013-05-15 19:52:19,2013-05-15 19:52:19
52ef89f9c20d02ca341c979e3d4cb8bd13aa0146...3a339b2bb3b06a110ccf93146cf020279705df84,2,18,1,19,13,2013-05-15 19:57:21,2013-05-15 19:56:53
3a339b2bb3b06a110ccf93146cf020279705df84...aa0d40747caa8cd9c5cee56046cac011bc3d1065,1,1,1,2,1,2013-05-15 20:02:24,2013-05-15 20:02:24
d586662ce5d53cf731fcc94216e59d8381f109c4...c80448c4d1836dd0e23953fa923f7a270d32df05,4,156,2,158,5,2013-05-15 13:51:50,2013-05-15 13:11:39
d586662ce5d53cf731fcc94216e59d8381f109c4...c75942c79da708a350c4a9cf32a5f06f8ca1ab7c,1,1,0,1,1,2013-05-15 00:41:19,2013-05-15 00:41:19
d586662ce5d53cf731fcc94216e59d8381f109c4...fc1d1d871b2f952ce83a6b7cedcdf4a86f0c953b,3,72,2,74,3,2013-05-14 22:00:24,2013-05-08 17:21:21
fc1d1d871b2f952ce83a6b7cedcdf4a86f0c953b...2b620efffd53fab63bc7b874c96da0693e604278,2,11,12,23,10,2013-05-14 22:00:24,2013-05-09 14:41:59
2b620efffd53fab63bc7b874c96da0693e604278...54871e36838f048a2ffd71ced481b50532396049,1,83,0,83,3,2013-05-14 22:00:24,2013-05-09 16:56:52
54871e36838f048a2ffd71ced481b50532396049...20a57f15b91ec9aae74fffb897035a7665a3dcf6,2,51,0,51,3,2013-05-14 22:00:24,2013-05-10 13:34:19
20a57f15b91ec9aae74fffb897035a7665a3dcf6...6c7dc1de86c349cdefdd445b928f29b41fa5fa16,1,3,3,6,2,2013-05-14 22:00:24,2013-05-10 15:51:13
6c7dc1de86c349cdefdd445b928f29b41fa5fa16...17ad00a35e3cafc7e9386eb4c6522630a886c29f,3,11,12,23,12,2013-05-14 22:00:24,2013-05-10 15:52:25
17ad00a35e3cafc7e9386eb4c6522630a886c29f...e6324ff400c208713061e8b517435da87855ce56,1,23,0,23,1,2013-05-14 22:00:24,2013-05-10 18:17:41
e6324ff400c208713061e8b517435da87855ce56...539c8767277eefc990feb03db15cc4c61a7e641f,1,8,5,13,8,2013-05-14 22:00:53,2013-05-13 18:54:38
d586662ce5d53cf731fcc94216e59d8381f109c4...341739d91676d2b136852313bf3b26373af328bb,11,1312,352,1664,41,2013-05-14 10:28:59,2013-05-14 10:28:59
d586662ce5d53cf731fcc94216e59d8381f109c4...085ee6fcc4cc861b715194e6f144a983350331f3,11,210,123,333,10,2013-05-14 06:10:00,2013-05-14 06:10:00
078a19d7255a7f9f50c4071a6b0811f4a996bd3e...5e6cd21f8b3bded9e9cba2e1b9a754df5a9c2bf2,1,1,1,2,1,2013-06-07 19:35:34,2013-06-07 19:32:27
078a19d7255a7f9f50c4071a6b0811f4a996bd3e...ca5ae266b762d34075524d869e27f0daaa79265c,1,1,1,2,1,2013-06-02 21:40:56,2013-06-02 21:40:56
078a19d7255a7f9f50c4071a6b0811f4a996bd3e...7f65bf508e5930df48e3e3de2ed9a5a62a66446c,1,1,1,2,1,2013-06-02 01:48:32,2013-06-02 01:48:32
078a19d7255a7f9f50c4071a6b0811f4a996bd3e...64f346779fbe4ba9587ec65eedd0e8373f7e29c0,2,17,41,58,8,2013-06-01 22:51:45,2013-06-01 22:51:45
64f346779fbe4ba9587ec65eedd0e8373f7e29c0...31eb01ae8aac22a4d768418d3cc4da6f903a8694,3,12,12,24,11,2013-06-01 22:55:05,2013-06-01 22:55:05
31eb01ae8aac22a4d768418d3cc4da6f903a8694...3cc0963ad16a5abd67aeba22cefac34a40ac70ef,1,0,88,88,1,2013-06-01 22:55:52,2013-06-01 22:55:52
3cc0963ad16a5abd67aeba22cefac34a40ac70ef...a70dd65964340b5c4ccedf497a2605b13e7ac8a8,3,37,15,52,8,2013-06-01 23:19:50,2013-06-01 23:19:50
070923b14f734fe14bec4f0a4cd406f0101671d3...854039b6ba9c707af07f9966b39150ce23150920,1,1,1,2,1,2013-06-03 17:25:51,2013-06-03 17:25:51
ecb64be6a8c3de7e34b60c266b43a88a9b2124e6...2cf92abf0eff49b21812d88e74813b8848f9b758,1,1,0,1,1,2013-05-24 18:41:30,2013-05-24 18:40:56
2cf92abf0eff49b21812d88e74813b8848f9b758...5f69a53dba4b0e550ab29c7f2bf4277222927097,1,1,0,1,1,2013-05-25 10:03:49,2013-05-24 18:42:09
ecb64be6a8c3de7e34b60c266b43a88a9b2124e6...1f23b4caae6cd60a2bc1911c17fcebcadc539497,3,12,7,19,5,2013-05-24 14:23:43,2013-05-24 14:23:43
ecb64be6a8c3de7e34b60c266b43a88a9b2124e6...70d2123efda0e92760b96b03ce27cb4f1fb61cb3,3,35,0,35,5,2013-05-24 02:33:28,2013-05-24 02:33:28
70d2123efda0e92760b96b03ce27cb4f1fb61cb3...deb9963e6e5871d53ab1d75c90bbf2da53ffcb36,1,17,2,19,4,2013-05-24 18:07:32,2013-05-24 18:07:32
deb9963e6e5871d53ab1d75c90bbf2da53ffcb36...88ef309a940bcbb6f85a750372b8fdbc6569c3a7,3,56,16,72,10,2013-05-24 21:44:16,2013-05-24 21:44:16
bf63cb904592e1ca73aa3990c08ea0b752fec14d...00cf2a1fa264c167dff0dd50e296c93d4c59908f,4,17,19,36,8,2013-06-14 10:05:01,2013-06-14 10:05:01
6677c7964a4e50f7db3e8e28edef99c864dfe410...1b0b962b43afe2f0e07b31fe03e64db4e7d97854,1,43,28,71,5,2013-05-17 13:23:12,2013-05-17 13:23:12
1b0b962b43afe2f0e07b31fe03e64db4e7d97854...4dab2fccd39858c0fb3b783a612fb95173d34f7b,1,5,6,11,5,2013-05-24 12:43:24,2013-05-24 12:43:24
6677c7964a4e50f7db3e8e28edef99c864dfe410...0c5443571dd1c081d57b6b2840c30d86bef0e82c,3,82,19,101,19,2013-05-16 13:45:29,2013-05-16 13:45:29
2ae8aaa10684da3b8ee3c0de5f49b57f21286978...db1e965b657e7e184b9f4e136e9c0860769d8f68,1,29,35,64,3,2013-05-16 18:27:50,2013-05-16 18:27:50
db1e965b657e7e184b9f4e136e9c0860769d8f68...f01990aad2200690618cd64d2378e7e610433a71,1,4,3,7,2,2013-05-17 17:57:44,2013-05-17 17:57:44
f01990aad2200690618cd64d2378e7e610433a71...d7673274d22140dc6dfa288351f1d4d2e2fa4b63,1,9,0,9,1,2013-05-18 14:29:32,2013-05-18 14:29:32
539c8767277eefc990feb03db15cc4c61a7e641f...2e69e1727b4d5698a90c24c5800eecd5401dc319,21,632,613,1245,135,2013-05-14 22:37:35,2013-05-14 22:37:35
2e69e1727b4d5698a90c24c5800eecd5401dc319...9bb3dc9843f4ef565eb8f298eb7f542b5e1ac0dd,8,850,810,1660,27,2013-05-15 01:41:39,2013-05-15 01:41:39
9bb3dc9843f4ef565eb8f298eb7f542b5e1ac0dd...e7077320ff6452984260c14394c271db080b5e9c,5,17,7,24,11,2013-05-15 01:52:09,2013-05-15 01:52:09
e7077320ff6452984260c14394c271db080b5e9c...828d1aa50769999ee50bbac893f4e9ef6d49f10c,2,353,333,686,4,2013-05-15 03:27:15,2013-05-15 03:27:15
828d1aa50769999ee50bbac893f4e9ef6d49f10c...49b61af1f8139f48c0f2ce6b8afa25c1716f7379,2,56,62,118,39,2013-05-15 18:30:40,2013-05-15 18:30:40
49b61af1f8139f48c0f2ce6b8afa25c1716f7379...398a6317a09679b65a59d529e78f5e7480e8de0b,2,16,17,33,15,2013-05-15 18:50:52,2013-05-15 18:50:52
398a6317a09679b65a59d529e78f5e7480e8de0b...2f4de3867d77f8f8841ba32517f2ca8b9e730113,1,19,20,39,1,2013-05-15 19:21:37,2013-05-15 19:21:37
2f4de3867d77f8f8841ba32517f2ca8b9e730113...97880a223e8d6e1ff4d6e40e46f6a006b24a66cc,2,25,52,77,37,2013-05-15 19:22:08,2013-05-15 19:22:08
97880a223e8d6e1ff4d6e40e46f6a006b24a66cc...dc9d6c1c1f52eefba95920059f0607d3d57b2d07,2,19,10,29,9,2013-05-15 20:22:57,2013-05-15 20:22:57
dc9d6c1c1f52eefba95920059f0607d3d57b2d07...bb85ce9aff118bed4e53e8ef70df4f1ec1cb903b,2,6,3,9,2,2013-05-15 20:39:24,2013-05-15 20:39:24
bb85ce9aff118bed4e53e8ef70df4f1ec1cb903b...95dd6d31a4c11618836f9a55fc3dbbde48450b09,6,26,58,84,16,2013-05-16 00:17:33,2013-05-16 00:17:33
95dd6d31a4c11618836f9a55fc3dbbde48450b09...10e19e4b97dba71b603d652d5a046ef792d9d704,4,11,7,18,8,2013-05-16 00:31:11,2013-05-16 00:31:11
10e19e4b97dba71b603d652d5a046ef792d9d704...f3bab52df4c6b54218ed36ac354ffc3573d31f3b,5,88,9,97,7,2013-05-16 00:40:47,2013-05-16 00:40:47
f3bab52df4c6b54218ed36ac354ffc3573d31f3b...822cf67dae6315e6cd46978247acbe432eadeb35,1,0,0,0,0,2013-05-16 00:44:37,2013-05-16 00:44:37
822cf67dae6315e6cd46978247acbe432eadeb35...10f5b6486c118d6be26bb4f8973629a6aaff1d52,1,3,3,6,3,2013-05-16 00:46:01,2013-05-16 00:46:01
10f5b6486c118d6be26bb4f8973629a6aaff1d52...1b04ccf62cbda927949708e530ec00a6470418fb,1,166,149,315,1,2013-05-16 00:57:53,2013-05-16 00:57:53
956491f8534692f7e31cd4678b688678d6256414...37c20fa64b7fc8156d51e08f9271fe3dafda5c19,1,1,1,2,1,2013-06-10 16:03:54,2013-06-10 16:03:54
956491f8534692f7e31cd4678b688678d6256414...ab0d0a28a8085255558b5ee7be978d667f44def9,1,13,4,17,4,2013-06-10 15:06:52,2013-06-10 15:06:52
956491f8534692f7e31cd4678b688678d6256414...95d66ebc6b068f2762d1a8bf3f78cd78d6ab4900,1,32,14,46,1,2013-06-10 13:56:43,2013-06-10 13:56:43
95d66ebc6b068f2762d1a8bf3f78cd78d6ab4900...0de3f1ca9a2135033ca482a8916123e51d82de09,1,26,0,26,1,2013-06-10 14:14:54,2013-06-10 14:14:54
7a4408f608a6500cc784801616eb8c034b052e04...a8ae398bf52e97148ee7bd0d5868de2e15bd297f,3,13,1,14,3,2013-06-03 17:59:48,2013-06-03 17:59:48
58ce66e553ce0938430c01a27ed8ad32c23b1f0f...4e576f047fc8a5a75fa88a66132bdade4f3a1e44,1,2,2,4,2,2013-05-24 15:55:32,2013-05-24 15:55:32
58ce66e553ce0938430c01a27ed8ad32c23b1f0f...8dc2ad2c06fabb6501f0adff80761898bed5bc6f,1,1,1,2,1,2013-05-24 15:44:02,2013-05-24 15:44:02
9ebfcc9a152b9e00b166a0d4fb385b61e8330607...a7d7a0665573b3db46963e4eb083f24470aad082,1,2,2,4,2,2013-05-24 12:23:28,2013-05-24 12:23:28
a7d7a0665573b3db46963e4eb083f24470aad082...92e4a51965ce862ad1b4682a68b33550f2fd613f,4,5,5,10,5,2013-05-24 16:49:18,2013-05-24 16:49:18
ffd9e06deb9d222ac5e1f63734211c0503213e06...b438565609917439cb4172717e5505c265c4e291,2,4,5,9,5,2013-05-24 21:48:13,2013-05-24 21:48:13
ddf5a1940fdbe2efa7136e7f5f26c2adc1a59b3e...e49f82b9e1a920c902c1cd813596dc1a78817e63,1,24,7,31,7,2013-06-14 10:10:26,2013-06-14 10:10:26
d8e60b797fadfd1f03d518d0e9869bae4595cd6a...c5f15dcd3de02a10452963a9c56cb2e587972f58,3,35,35,70,17,2013-05-24 21:42:00,2013-05-24 21:42:00
e86fe7e5af8fd765e9497a517b04acacddae8237...72360b2cdfcfb70e72295b8f8cf7618257ce8826,2,127,0,127,2,2013-05-18 01:57:56,2013-05-17 12:46:32
72360b2cdfcfb70e72295b8f8cf7618257ce8826...6301373c68990e8a92730de23a4da86b3442b4ef,1,23,0,23,1,2013-05-18 01:58:00,2013-05-17 17:20:30
e86fe7e5af8fd765e9497a517b04acacddae8237...f498dd2a2b5128eca47517923d7e84238db0483c,1,19,4,23,3,2013-05-16 19:29:16,2013-05-16 19:29:16
e86fe7e5af8fd765e9497a517b04acacddae8237...f29e5dc8a15d0ab8e9c6084e41ee373376051659,4,27,48,75,25,2013-05-16 19:09:06,2013-05-16 19:09:06
f29e5dc8a15d0ab8e9c6084e41ee373376051659...6145812444fb3eda2cc362795ed0b1addb8f4847,2,20,35,55,6,2013-05-16 21:33:10,2013-05-16 21:33:10
6145812444fb3eda2cc362795ed0b1addb8f4847...08121c8f6b435779027d837c1e7fc8046bc1e165,1,24,24,48,5,2013-05-16 21:33:29,2013-05-16 21:33:29
08121c8f6b435779027d837c1e7fc8046bc1e165...0143be42a13b9f8082ceddc64a5e523e45f54d88,2,30,21,51,22,2013-05-18 14:03:53,2013-05-18 14:03:53
0143be42a13b9f8082ceddc64a5e523e45f54d88...98b0fd173b7b59316d776534b84ecc9ab0a1da77,2,35,26,61,29,2013-05-20 17:22:50,2013-05-20 17:22:50
98b0fd173b7b59316d776534b84ecc9ab0a1da77...ae9d7a5167da58de9a1a4beac489cf1e6adcea11,2,25,12,37,11,2013-05-20 17:58:35,2013-05-20 17:58:35
6102552d61eb9059b9d958f80a6645d5328ca063...67b20f2c8cc8d85ab09de95970e4d28c80f0aeb6,7,37,12,49,16,2013-05-20 18:31:45,2013-05-20 18:31:45
2a6a1d439c28f5cc2f7ab472305b3fc0baaf8c0b...4e180107314a0a7768120ed66e615c8f668677bd,1,20,10,30,7,2013-06-10 18:28:26,2013-06-04 16:29:47
4e180107314a0a7768120ed66e615c8f668677bd...d227af1edd5366df91f96193ddff3ff43d54b4f4,1,2,2,4,2,2013-06-10 18:28:27,2013-06-05 15:54:33
2a6a1d439c28f5cc2f7ab472305b3fc0baaf8c0b...db3242e4bb1c31a7319e6273235a9ba6b29a61d4,2,9,4,13,5,2013-06-10 18:21:56,2013-06-10 18:21:56
cebfde9ea550677d596520448f43cde6de3605c0...e42eb7fa8c22e7451e06c28d9125fc7534239c89,1,2,0,2,1,2013-06-03 06:42:18,2013-06-03 06:42:18
a8ae398bf52e97148ee7bd0d5868de2e15bd297f...e61af8bc62c84a1bc70d0b323c1b6bf21dddb4b6,1,11,0,11,1,2013-06-04 14:40:44,2013-06-03 21:29:41
a8ae398bf52e97148ee7bd0d5868de2e15bd297f...d26a3b37a6a8d42b9e7cb7486b928170c43e052e,1,8,2,10,2,2013-06-03 20:00:15,2013-06-03 20:00:15
d26a3b37a6a8d42b9e7cb7486b928170c43e052e...45a8945746a205ea513efc17bb242c63362c79a9,3,51,2,53,3,2013-06-13 13:17:56,2013-06-13 13:17:56
a8ae398bf52e97148ee7bd0d5868de2e15bd297f...830c458fe761aca5ad2facec33b3d0798caab116,2,7,1,8,3,2013-06-03 19:14:57,2013-06-03 19:14:57
830c458fe761aca5ad2facec33b3d0798caab116...82dd963e08778f8c563e058f1b19ccc358965615,1,10,8,18,5,2013-06-03 19:20:52,2013-06-03 19:20:52
82dd963e08778f8c563e058f1b19ccc358965615...cff3b37a61b8da883437eec799b7b852d22538f0,1,7,1,8,2,2013-06-03 21:42:21,2013-06-03 21:42:21
a8ae398bf52e97148ee7bd0d5868de2e15bd297f...38f29f7d0c9cbdb4c458834d403fc128dcce3117,4,13,13,26,7,2013-06-03 18:45:19,2013-06-03 18:45:19
d7b01c049d7f965b972603bc038922342fc67d68...0146f65a448d2d42271300f1477ea9fa378d6360,1,1,1,2,1,2013-05-24 18:31:11,2013-05-24 18:31:11
0146f65a448d2d42271300f1477ea9fa378d6360...ae72c2f4d6c37a14fcd81658f6ae42d65f5c7169,1,2,2,4,1,2013-05-24 18:31:19,2013-05-24 18:31:19
ae72c2f4d6c37a14fcd81658f6ae42d65f5c7169...bfb65b733a2cfa0dac6a5760897f09d8e2557381,1,6,2,8,3,2013-05-24 18:31:36,2013-05-24 18:31:36
66e9f155c3e62bcb681ed302a21d758d09c81d51...ea7fdecd41a107d038503578324197780df002a8,1,1,1,2,1,2013-05-19 12:37:02,2013-05-19 12:37:02
66e9f155c3e62bcb681ed302a21d758d09c81d51...2b55874584f034b5113359ced6b05c143d31e03c,2,8,4,12,3,2013-05-19 03:02:42,2013-05-19 01:55:59
f498dd2a2b5128eca47517923d7e84238db0483c...3703a654056b4af7acbb09dc4d02bd184c7307c5,2,77,5,82,2,2013-05-17 17:09:09,2013-05-17 17:09:09
f498dd2a2b5128eca47517923d7e84238db0483c...55dd0afb5dd365bd306f698f9ccca1425e5c91a7,2,110,0,110,2,2013-05-17 16:08:37,2013-05-17 16:08:37
ea9095c5626077c198e3fdbb480d6205851f027b...2eb4e2a0b86f8d244f0b6cbeb0422f8499d834f8,5,16,22,38,10,2013-05-29 16:31:47,2013-05-29 16:31:47
2eb4e2a0b86f8d244f0b6cbeb0422f8499d834f8...94f0d478de6e50e8b26e9779da22dbd74cc5952f,1,8,12,20,2,2013-05-29 17:01:54,2013-05-29 17:01:54
94f0d478de6e50e8b26e9779da22dbd74cc5952f...7e92302c4fba259ac1128db548cf01dad9ad087c,1,17,5,22,1,2013-05-29 17:27:32,2013-05-29 17:27:32
7e92302c4fba259ac1128db548cf01dad9ad087c...c05e9f856d5f12a1244924b02bad66ba5bacb550,1,2,3,5,1,2013-05-29 18:11:19,2013-05-29 18:11:19
c05e9f856d5f12a1244924b02bad66ba5bacb550...054451fd190f195e06d8a8aa65e83882f60b1f14,1,82,24,106,6,2013-05-30 19:30:21,2013-05-30 19:30:21
054451fd190f195e06d8a8aa65e83882f60b1f14...5aa95b667c5986e3cea45b93bb2370cd46deeea3,2,58,70,128,17,2013-05-30 22:53:45,2013-05-30 22:53:45
5aa95b667c5986e3cea45b93bb2370cd46deeea3...9060b5c2f52d29dec1920eb89ee0d48341540e3b,8,102,32,134,35,2013-05-31 14:37:02,2013-05-31 14:37:02
17235eb0893fc7f8658ed36da0ec336b2d1fca5d...14265d9a18a4a2151bfd4e5c7e94de45377b6375,1,10,0,10,1,2013-06-14 22:11:34,2013-06-14 22:11:34
47d7486bbe9d87eeab94fb9f1d78ffdfdf0c66f8...b1ed75078ea04de8725ce5c39ae3b463f86faf4e,1,3,3,6,1,2013-06-10 19:07:57,2013-06-10 19:07:57
be15d5f2d916d1ea55a7c8d2288fb77a766afaec...d64f105b44d202aeb83a5f4edbdffdf2375992fa,1,5,0,5,1,2013-06-11 17:39:02,2013-06-11 17:39:02
092c761cec2e89f73c3810ff8f2f4ffb01db53b0...da54abaf2e86e530d0096e0f85b64b6cc17fcbe0,1,1,1,2,1,2013-06-12 12:54:37,2013-06-12 12:54:37
e42eb7fa8c22e7451e06c28d9125fc7534239c89...e16c93486d16ac4f3a05f720ee6478b5cef93f10,1,1,1,2,1,2013-06-03 10:19:20,2013-06-03 10:19:20
e16c93486d16ac4f3a05f720ee6478b5cef93f10...71b1657e8d22b6dfa0a426f6244c6a3101f66bc4,1,31,0,31,1,2013-06-03 17:02:57,2013-06-03 17:02:57
c906239220c7ba06b8615f001fab2f42fb063aeb...62551129263e339d7ca9c21afbd4eda16452c6da,4,3057,1017,4074,20,2013-06-05 11:19:57,2013-06-05 11:19:57
479ac9afa7159f2da7c9cb4dd33fef8a4cf85474...c000ef194c0259bfe631222b19a2bc204281f836,1,2,3,5,1,2013-06-04 20:01:38,2013-06-04 20:01:38
10ef4f7f39681ec538dbd535971dddb420666f27...3922691fb99a99cec0a5d239da522cc3d8778e6c,4,6,6,12,6,2013-06-04 16:09:08,2013-06-04 16:09:08
10ef4f7f39681ec538dbd535971dddb420666f27...06b585ce8a397fffcc9051e2faa6f968e51fccd5,1,1,0,1,1,2013-06-04 15:44:27,2013-06-04 15:44:27
10ef4f7f39681ec538dbd535971dddb420666f27...b515a5a9ec5792c67be5fe8476df96903f43df71,2,0,3,3,3,2013-06-04 13:24:58,2013-06-04 13:24:58
b515a5a9ec5792c67be5fe8476df96903f43df71...86ada2fa5d00820288df8a59eca3deef83f4aeb6,12,73,77,150,50,2013-06-04 13:51:12,2013-06-04 13:51:12
86ada2fa5d00820288df8a59eca3deef83f4aeb6...fd224ee590dc9f003f6507b529a9f47cceb02c44,26,451,451,902,405,2013-06-04 18:00:22,2013-06-04 18:00:22
10ef4f7f39681ec538dbd535971dddb420666f27...6d5bdff3942ce5e030b2cbd1510f418de25a1a53,5,56,6,62,12,2013-06-04 01:39:00,2013-06-04 01:39:00
6d5bdff3942ce5e030b2cbd1510f418de25a1a53...393e873d25093f579d1a293bc473007b04f3c239,1,4,3,7,3,2013-06-10 02:17:35,2013-06-10 02:17:35
393e873d25093f579d1a293bc473007b04f3c239...0a28628c02d486512dc7e62eb54ccfd27eaa0a27,2,58,8,66,9,2013-06-10 22:02:40,2013-06-10 22:02:40
0a28628c02d486512dc7e62eb54ccfd27eaa0a27...ac599d652846f6456366b8028b2c38da0565d8b1,2,3,2,5,3,2013-06-10 23:44:10,2013-06-10 23:44:10
ac599d652846f6456366b8028b2c38da0565d8b1...dd53c457d75a49e6e140c6d71642b237f3ee9056,1,14,8,22,4,2013-06-11 01:10:40,2013-06-11 01:10:40
10ef4f7f39681ec538dbd535971dddb420666f27...0ca88443985e7a944106ed4ceaf877a97f1ca2ec,1,23,0,23,3,2013-06-04 00:39:29,2013-06-04 00:39:29
0ca88443985e7a944106ed4ceaf877a97f1ca2ec...63e80384ea753c74046c2a4c3f64229c359f466f,1,12,10,22,8,2013-06-04 21:35:32,2013-06-04 21:35:32
63e80384ea753c74046c2a4c3f64229c359f466f...7169212683ba02e2da4c80792702c5210f1c16ea,1,1,1,2,1,2013-06-10 18:08:40,2013-06-10 18:08:40
d7a6485dfe5b5d8db9c1eba308bca88f086833ad...716892b95dd292c62d9bc7ca2951176e94657b00,5,145,52,197,32,2013-06-04 18:41:54,2013-06-04 18:33:39
9775f0bd145c607126ea22a17b291dea822be7b2...194f48774992644257bf7cf0878e47e9834d40e1,1,1,0,1,1,2013-05-25 01:31:47,2013-05-25 01:31:47
194f48774992644257bf7cf0878e47e9834d40e1...bb4b35a8920bcba8b60784297650ced5b2e01e47,1,3,1,4,2,2013-05-25 01:32:21,2013-05-25 01:32:21
bb4b35a8920bcba8b60784297650ced5b2e01e47...df23a1e675c7e3cbad617374d85c48103541ee14,1,6,1,7,2,2013-05-25 01:58:24,2013-05-25 01:58:24
522f399d689ebd7ae76ffce07507549ee5887238...24ddfe3f25f99db5a23f62d411c949b2236288a1,13,89,0,89,13,2013-05-29 02:39:09,2013-05-29 02:39:09
60fd7d686dea6645ab61c27d0132d38c07a89e80...76a568fc9717ff69999ab54fba9277a0d31c305d,1,1,13,14,2,2013-06-14 23:08:08,2013-06-14 23:08:08
f3cc1d985e91e19012c65c0c14c4ddc664438631...387eb5295a9ea75a099dd36adcae18229541f613,1,0,71,71,1,2013-05-28 21:13:20,2013-05-28 21:13:20
387eb5295a9ea75a099dd36adcae18229541f613...326faec6642896954ffbd407eeda7d19da193856,2,2,101,103,3,2013-05-28 21:57:36,2013-05-28 21:57:36
dce82bc85615ca09c999bc2186c2c9caf348dc33...a48799016a43e6badae72e855f9a90592b6cdd98,4,4,4,8,4,2013-05-28 20:46:52,2013-05-28 20:46:52
a48799016a43e6badae72e855f9a90592b6cdd98...582a9e0a67598672db35ef26a18027dd6fb222ca,1,1,1,2,1,2013-05-28 20:47:04,2013-05-28 20:47:04
582a9e0a67598672db35ef26a18027dd6fb222ca...cfb8cbe5214c58690ca99cd44b25bd202c4dbcf7,2,4,1,5,2,2013-05-28 20:51:21,2013-05-28 20:51:21
cfb8cbe5214c58690ca99cd44b25bd202c4dbcf7...fe0c0c208c0e816419b668a6fd6567520698c2d2,1,3,3,6,2,2013-05-28 22:21:06,2013-05-28 22:21:06
fe0c0c208c0e816419b668a6fd6567520698c2d2...2897cb04760d7e4e7e52ccc20e94c94e3743667e,2,24,7,31,6,2013-05-28 22:22:01,2013-05-28 22:22:01
2897cb04760d7e4e7e52ccc20e94c94e3743667e...2127f8d6ad091d699d3462715305a0f64340eca1,1,17,5,22,8,2013-05-28 22:22:34,2013-05-28 22:22:34
2127f8d6ad091d699d3462715305a0f64340eca1...5b33b2463a27aa3356a4b6200cf4b81dd83c26a0,2,72,1,73,2,2013-05-28 22:31:06,2013-05-28 22:31:06
5b33b2463a27aa3356a4b6200cf4b81dd83c26a0...54af0536232ca71d37f7c6440f1bb17b3ed112db,1,1,1,2,1,2013-05-28 22:40:22,2013-05-28 22:40:22
6471fd3825abdcf40a99f59d609a093ae82c523a...0b785487fe752cc4111a3f0005a2ae090b30c52b,1,5,5,10,5,2013-05-19 15:34:34,2013-05-19 15:34:34
6471fd3825abdcf40a99f59d609a093ae82c523a...8291f8b85ca653e13f17ffb126b57bb6b40c1cb5,1,1,1,2,1,2013-05-19 14:57:45,2013-05-19 14:57:45
2879ef46420316038e8048b17eb96b53283332a0...1b007828c93bc472af3306b8da1d72a84b484f12,1,1,1,2,1,2013-05-20 17:43:09,2013-05-20 17:43:09
ffb38ce0ad1b769a1da727adb47e114ef3ed440d...0f312113d3ce37d57fb28eb98c8abcdcbfcd39a3,7,426,414,840,24,2013-05-19 17:46:24,2013-05-19 17:46:24
0f312113d3ce37d57fb28eb98c8abcdcbfcd39a3...c2a14bb196d0d3046e185783ebacd4b83fa36dd4,3,73,99,172,18,2013-05-20 19:09:15,2013-05-20 19:09:15
c2a14bb196d0d3046e185783ebacd4b83fa36dd4...b51303cddce2cbb22fc3ee0de9d9125bec2f029a,1,4,0,4,1,2013-05-20 20:50:50,2013-05-20 20:50:50
b51303cddce2cbb22fc3ee0de9d9125bec2f029a...c6bc90d02daa2f7086a1c7469c7239911c2bc357,1,60,23,83,19,2013-05-20 22:02:32,2013-05-20 22:02:32
c6bc90d02daa2f7086a1c7469c7239911c2bc357...b06784b0dd2e86a7450fab30707468acfae5d7aa,1,20,14,34,13,2013-05-20 23:00:16,2013-05-20 23:00:16
b06784b0dd2e86a7450fab30707468acfae5d7aa...13e687e5790f05552f9be84bf1d60d37fca4c078,1,6,1,7,1,2013-05-20 23:00:51,2013-05-20 23:00:51
45c51805165132d7d8b5baffa6f2fc887124d747...537cce16f2776d076c58b80e9af7e9914e5dac74,6,26,15,41,9,2013-05-18 02:35:46,2013-05-18 02:35:46
bebbbf914b241448c6304c915c708f7cbc582c06...18cb5c9314dbc9a0aa857211b124a3feb85c5274,53,185,19,204,59,2013-05-23 00:52:48,2013-05-21 17:47:16
bebbbf914b241448c6304c915c708f7cbc582c06...d756ae4cb376e218ff4dd35a7b9a9fa346fbb04d,1,0,4,4,2,2013-05-20 22:19:05,2013-05-20 22:19:05
14265d9a18a4a2151bfd4e5c7e94de45377b6375...080f35fe65a7bb88ccf2abefa985c7a4ae88a47b,1,2,0,2,1,2013-06-15 16:16:35,2013-06-14 23:24:22
14265d9a18a4a2151bfd4e5c7e94de45377b6375...5799806414b266c14a8ea2802cfa0906d920c62d,1,2,0,2,1,2013-06-14 23:29:19,2013-06-14 23:29:19
5712e37437ffcfbb17d75f7f9c977bf1d4013042...eeea9ac9468a73bb9514a2d729060889b48384ee,3,29,5,34,6,2013-06-10 22:17:27,2013-06-10 22:17:27
b4565af25657aa28d1cc9c740c82700c5ec6ce8b...ecae342434aeccb05b3cffe30c34051d84afdb74,1,17,0,17,1,2013-06-12 17:50:47,2013-06-12 17:50:47
62c78696cda5660524dee596a07aac66d89437af...3dd1e4d58c9d676d49f41db450c3d42901526edc,3,101,16,117,20,2013-06-03 12:09:16,2013-06-03 12:09:16
3dd1e4d58c9d676d49f41db450c3d42901526edc...844a8db6c68fbd964d316c69964b29b2dc6f06b3,1,2,0,2,2,2013-06-03 12:21:22,2013-06-03 12:21:22
c1ee9bf8817980c4577f914c0bc7b532f4b3000c...7ef9833dbb299ebf796092a6921127ea77d38337,2,4,0,4,3,2013-06-04 21:26:40,2013-06-04 21:26:40
04050c4173b92b6f7b4d6a6da812dc8cb955c01f...e3cc625315ffdc47e6ea8d94812c7423853435b8,1,5,2,7,1,2013-06-05 13:19:49,2013-06-05 13:19:49
e3cc625315ffdc47e6ea8d94812c7423853435b8...a118ad90edbb232806345c4038f3e9e68098648c,1,22,1,23,1,2013-06-06 12:36:28,2013-06-06 12:36:28
04050c4173b92b6f7b4d6a6da812dc8cb955c01f...f67ea78cce83114998390c16305a6869c72f5100,1,2,0,2,1,2013-06-05 12:59:05,2013-06-05 12:59:05
20bf0e00e81fdff34c821fd880a92e822fb5ba15...3ea6a2c7c39695fbfe3dfe228db00335c9937c14,1,1,0,1,1,2013-06-11 10:17:39,2013-06-11 10:17:39
f1992eeea5d7945164f2732aea805ad3a06cc3b8...a799cdad3e25136ff313d692b9972cb725754055,1,18,13,31,6,2013-06-06 15:22:54,2013-06-06 15:22:54
a799cdad3e25136ff313d692b9972cb725754055...4107701062bc729d06e1729e2b4c8c92b3b8b4f2,1,12,8,20,8,2013-06-06 15:45:08,2013-06-06 15:45:08
f1992eeea5d7945164f2732aea805ad3a06cc3b8...0f23fb949dd894ff70641cc01ac116aa55083157,2,6,3,9,4,2013-06-06 01:06:51,2013-06-06 01:06:51
d3b9733507746b29e7f3da6f69bddf95f55d9582...7d6ff7be129d70f0ff5c50a47d70a32a1e6274bc,1,1,1,2,1,2013-05-28 13:27:12,2013-05-28 13:27:12
d3b9733507746b29e7f3da6f69bddf95f55d9582...fbcd8503b3a29bdbb7a52d6433b0ab79877bc4ce,1,4,6,10,1,2013-05-27 16:07:05,2013-05-27 16:07:05
d3b9733507746b29e7f3da6f69bddf95f55d9582...cb0bc4adc297baeea8e7b74269765c35457e04e7,3,12,1,13,4,2013-05-25 14:12:02,2013-05-25 14:12:02
cb0bc4adc297baeea8e7b74269765c35457e04e7...c8c7094b2e8088210e2182e582264e09222c6e3d,5,101,63,164,50,2013-05-25 15:09:46,2013-05-25 15:09:46
c8c7094b2e8088210e2182e582264e09222c6e3d...14212930e40439d0cfc635d56e084736867f9e30,3,23,10,33,8,2013-05-25 15:51:26,2013-05-25 15:51:26
14212930e40439d0cfc635d56e084736867f9e30...5a36efb61fae88a7fe71f67a6b1f8b9da6468014,4,41,38,79,37,2013-05-26 23:45:45,2013-05-26 23:45:45
5a36efb61fae88a7fe71f67a6b1f8b9da6468014...8699805756d25602e2412173aac7364fbe9627c7,1,50,7,57,7,2013-05-28 15:49:57,2013-05-28 15:49:57
3d1bc2660c626d755582929b2e6229bfa8b625aa...a3293ed854675074d7f5d5c2bca63ba9fa599deb,2,1,2,3,2,2013-05-24 18:56:21,2013-05-24 18:56:21
4a02c6dab1c3ba798370a64baa8bd94fa6f89c11...7958f1f694ac411dcfeb8fbf0d702a7c552306ae,1,28,1,29,2,2013-06-14 19:42:59,2013-06-14 19:42:59
ec3c89e57c3e91fabb9b084a2762faa20ca720ec...96988a37f52b65e8b703b6c2de138c34486215ad,1,4,0,4,2,2013-06-19 17:37:08,2013-06-19 17:37:08
96988a37f52b65e8b703b6c2de138c34486215ad...788d66f409ce3a7e464bbb68d909960648f2515c,1,3,0,3,1,2013-06-19 17:39:35,2013-06-19 17:39:35
ec3c89e57c3e91fabb9b084a2762faa20ca720ec...c88b763e80d6ad0253da060896da10d60f58f829,1,1,1,2,1,2013-06-19 16:38:58,2013-06-19 16:38:58
c7985808aea860d220ad8827cd21b042adef7934...7181edf4b2fe17791cc4f843271d9c7fce0f14f3,1,58,0,58,1,2013-05-29 03:44:41,2013-05-29 03:44:41
7181edf4b2fe17791cc4f843271d9c7fce0f14f3...aa42c6f2a284c1095ba65866aa8c28f3e5c31fcd,1,2,0,2,1,2013-05-29 03:45:12,2013-05-29 03:45:12
aa42c6f2a284c1095ba65866aa8c28f3e5c31fcd...286ce266b4415ae27d5d9cc177ad12db44845a84,1,3,0,3,1,2013-05-29 03:55:07,2013-05-29 03:55:07
0d2fb295375ce74764b8d4cb2b03c19cd4e01cb4...f35f084059e5c34940f74f55ad32ecfcd78ce61c,1,14,12,26,14,2013-05-20 23:35:28,2013-05-20 23:35:28
f35f084059e5c34940f74f55ad32ecfcd78ce61c...49505c599b3a65196b6b6f746f4bfad3a417dd7a,2,20,7,27,5,2013-05-21 00:30:33,2013-05-21 00:30:33
422edd513a5e1ea30ea65352af213af7856a661e...31c98bdaafd806d7c5e44f2ed25cf57e7ef20827,1,19,3,22,4,2013-05-23 16:32:39,2013-05-23 16:32:39
422edd513a5e1ea30ea65352af213af7856a661e...cf35e8ed81029a3c2717659eac7979017bb01890,4,35,19,54,15,2013-05-23 15:16:35,2013-05-23 15:16:35
422edd513a5e1ea30ea65352af213af7856a661e...9e0427081e80dbf6c7702c8428ec64e40f362804,1,1,1,2,1,2013-05-23 15:09:59,2013-05-23 15:09:59
d756ae4cb376e218ff4dd35a7b9a9fa346fbb04d...3a9ef5f9bbae19ae5ac4108dbbaed649e26d942e,1,2,1,3,1,2013-05-20 23:31:39,2013-05-20 23:29:57
30f604517a5ddc15b3e9f6e9d42f4c7569c1627f...6746c385bd7938e1bbcf588a27651de63a2de04a,1,18,12,30,1,2013-06-15 19:24:20,2013-06-15 19:09:10
30f604517a5ddc15b3e9f6e9d42f4c7569c1627f...cc7de8df755d9e4a845a8aa5800424b1546492d6,1,0,314,314,1,2013-06-15 16:30:52,2013-06-15 16:30:52
cc7de8df755d9e4a845a8aa5800424b1546492d6...38554fc2a722d1a77514f477a189b0dbd149691b,4,64,83,147,22,2013-06-15 16:38:18,2013-06-15 16:38:18
38554fc2a722d1a77514f477a189b0dbd149691b...061f8d12e04e494fdcbee949facaf598d201c2ec,2,88,66,154,15,2013-06-15 18:07:49,2013-06-15 18:07:49
061f8d12e04e494fdcbee949facaf598d201c2ec...f50e40008f39c77cab2b516ac2102f875bdef215,1,10,0,10,1,2013-06-15 18:35:56,2013-06-15 18:35:56
5799806414b266c14a8ea2802cfa0906d920c62d...5b8287617de65d4e14ed6affb0eb46867e9ee617,4,38,10,48,7,2013-06-14 23:43:39,2013-06-14 23:43:39
48897b5fa1e1cae157e484a465a696520f9106d3...04cca097ae9f7a8f64dbea1e12f3b871f6a67d65,1,4,1,5,1,2013-06-12 21:50:09,2013-06-12 21:50:09
04cca097ae9f7a8f64dbea1e12f3b871f6a67d65...81a11a3c30d01040451898f0e88a19363568edc3,1,6,1,7,1,2013-06-12 21:50:30,2013-06-12 21:50:30
81a11a3c30d01040451898f0e88a19363568edc3...f57175cbadbe7d8f48bfd5e3594116913de6e3ab,1,18,0,18,1,2013-06-12 22:28:59,2013-06-12 22:21:28
7ef9833dbb299ebf796092a6921127ea77d38337...7e6ede63794b54bcc0d67d86ea60e76b701d286f,1,3,3,6,2,2013-06-04 22:32:59,2013-06-04 22:24:25
34c8b24211c51b6f48109e2c9d23212153c6acaa...2ea29ce0ef5bd507497fe65d2507bc6ff52fd9fb,1,88,0,88,1,2013-06-05 15:26:26,2013-06-05 15:26:26
2ea29ce0ef5bd507497fe65d2507bc6ff52fd9fb...97d5f525f42cae0468239de0a924d6fda920b48a,1,15,0,15,1,2013-06-05 15:27:53,2013-06-05 15:27:53
3ea6a2c7c39695fbfe3dfe228db00335c9937c14...2e9403b047d926d39d5b299abc071f3c29627fc6,2,59,47,106,12,2013-06-11 14:39:06,2013-06-11 14:39:06
51a4b6510141ec3a0095a0ab9f3510eb47084457...42d1c36a5c775a37a0173cf315086fde1c1b7dd8,1,1,1,2,1,2013-06-13 17:25:43,2013-06-13 17:25:43
3d8da806111829170532cbdea6ab06002a7400fa...c00d1a6ebe8dd607b1876e505e1761c2a548aa53,1,65,28,93,13,2013-05-29 11:40:54,2013-05-29 11:40:54
3d8da806111829170532cbdea6ab06002a7400fa...525080100d2e2a7899c9a51a1ca57e28e32e8488,1,3,2,5,2,2013-05-28 16:54:32,2013-05-28 16:54:32
525080100d2e2a7899c9a51a1ca57e28e32e8488...444f7020cbc639fd781744be207c843aaf663077,1,2,2,4,1,2013-05-28 16:56:26,2013-05-28 16:56:26
3d8da806111829170532cbdea6ab06002a7400fa...e5fa4a4956393afc473539710e2a4b7297eb6ebf,1,4,0,4,1,2013-05-28 16:19:12,2013-05-28 16:19:12
3d8da806111829170532cbdea6ab06002a7400fa...4f9443927e8bc8a724b43afae6cf7a183cd9acd0,4,9,8,17,8,2013-05-28 16:08:05,2013-05-28 16:08:05
3d8da806111829170532cbdea6ab06002a7400fa...d9670f427522fc847313ad1b94b1e288dafe7690,1,2,2,4,2,2013-05-28 15:06:26,2013-05-28 15:06:26
a660cc0d012f54bbacb9f7364092a7223d0c1418...a7e14a3065ccd97fcd77b4038abdf30bee78a2b4,1,1,1,2,2,2013-06-19 18:08:19,2013-06-19 18:07:36
754609ab697df644b39c557607cff111e91ee495...88dcba3482df33f47a0b89c0811a96abf0609840,3,31,256,287,12,2013-06-19 23:32:51,2013-06-19 23:31:55
286ce266b4415ae27d5d9cc177ad12db44845a84...11550c60639af2af1e8cb2e76e27510722421863,1,0,2,2,2,2013-05-29 04:38:35,2013-05-29 04:38:35
286ce266b4415ae27d5d9cc177ad12db44845a84...3bac27f2405c746c068dbe31f8f205472d0f1b03,1,8,7,15,2,2013-05-29 04:26:42,2013-05-29 04:26:42
3bac27f2405c746c068dbe31f8f205472d0f1b03...dc1fa0745f779d8c9a513dea71021d263b89ca5f,1,4,4,8,1,2013-05-29 04:33:48,2013-05-29 04:33:48
d37dea318e5e3b6813f26ef04f635339f6821026...218812eb3cfeb5c5253ed6a54ed3e45c1107ffd1,1,4,3,7,3,2013-05-21 00:52:39,2013-05-21 00:52:39
218812eb3cfeb5c5253ed6a54ed3e45c1107ffd1...3f22842542a17d41f72b4943d19d244f2296b418,2,0,124,124,3,2013-05-21 00:54:54,2013-05-21 00:54:54
b4198de6bfb122ca2654a500a0b7bedb5e94badc...056698b67678d7dd687e08401386c35cd5cb9d77,1,1,1,2,1,2013-05-22 19:54:50,2013-05-22 19:54:50
5ecfe13be9f8f47e27e5134e60d14d195a1baeaa...78a76ad50eaf9d5a99336a47b2b78f547fa8a972,1,1,1,2,1,2013-06-13 05:59:41,2013-06-13 05:59:41
6746c385bd7938e1bbcf588a27651de63a2de04a...2626d88a21f639913f7f8e8b0719fd9e07cfbed4,1,1,1,2,1,2013-06-17 21:50:58,2013-06-17 21:50:58
fe88b5068d125a834fe586956a69ee36000cf879...0809f649d356b6b8d34a03bee8447049161ea09c,2,6,1,7,3,2013-06-18 01:49:16,2013-06-18 01:26:41
0809f649d356b6b8d34a03bee8447049161ea09c...90dde9beabcac3874a274f9f7952f25ba8c1c7a3,1,3,0,3,1,2013-06-19 21:59:28,2013-06-19 21:59:28
90dde9beabcac3874a274f9f7952f25ba8c1c7a3...55edbcd02fe5d519069677c3970ea90e9973a4eb,1,0,15,15,1,2013-06-19 21:59:42,2013-06-19 21:59:42
55edbcd02fe5d519069677c3970ea90e9973a4eb...d6ab71f450ac3673ffd4bc806de23e42a6d32c07,1,1038,0,1038,1,2013-06-19 22:03:33,2013-06-19 22:03:33
068076f775e88526bbfa19734fc1c34232e961b5...9e1cd37bbc2a1017612ea03e24a8002e6e81e1ea,5,1442,376,1818,116,2013-06-07 17:42:52,2013-06-07 17:42:52
068076f775e88526bbfa19734fc1c34232e961b5...31d2b258c15a28402c3fc5df6440c5b8644a6d76,1,50,22,72,7,2013-06-06 22:40:46,2013-06-06 22:40:46
31d2b258c15a28402c3fc5df6440c5b8644a6d76...eaa2183d77435bd5d65f36287e96a341696cb79c,1,2,0,2,2,2013-06-06 22:48:12,2013-06-06 22:48:12
eaa2183d77435bd5d65f36287e96a341696cb79c...f4a4cfd2cc748859d4f28b90274c81098afa8d5d,2,12,12,24,9,2013-06-06 22:50:09,2013-06-06 22:50:09
f4a4cfd2cc748859d4f28b90274c81098afa8d5d...01f446e908305efb86f9cbfbbe3302366a6ccd45,1,12,9,21,4,2013-06-06 22:56:09,2013-06-06 22:56:09
01f446e908305efb86f9cbfbbe3302366a6ccd45...a11e61677c7b368628975e2a0ead639b5bfcabb9,3,53,27,80,14,2013-06-06 23:09:46,2013-06-06 23:09:46
a11e61677c7b368628975e2a0ead639b5bfcabb9...12c9b9b3c94d595ab155fc90dfc426eeada8bc75,2,36,3,39,5,2013-06-06 23:41:41,2013-06-06 23:41:41
12c9b9b3c94d595ab155fc90dfc426eeada8bc75...2cc22de696d5a0847ecd7d07eaee1d7f385dd29c,3,6,1,7,4,2013-06-06 23:48:36,2013-06-06 23:48:36
2cc22de696d5a0847ecd7d07eaee1d7f385dd29c...b103ac70bfb9f9419d4487bf969b0f244b260014,1,5,5,10,3,2013-06-10 16:31:59,2013-06-10 16:31:59
b103ac70bfb9f9419d4487bf969b0f244b260014...8984aef8999509e5e6a1cb70286e44d0508f93e0,1,1,1,2,1,2013-06-10 16:32:31,2013-06-10 16:32:31
8984aef8999509e5e6a1cb70286e44d0508f93e0...b38c6929be500336de6f6a5f7a52d73cbf543fb6,1,1,1,2,1,2013-06-13 17:50:55,2013-06-13 17:50:55
b38c6929be500336de6f6a5f7a52d73cbf543fb6...d0084ce5f23453fbc008f5a2c5dd147b0df890e7,1,6,3,9,4,2013-06-13 21:57:50,2013-06-13 21:57:50
d0084ce5f23453fbc008f5a2c5dd147b0df890e7...f5fe3ce34e12f1660ee98cecdbe2c104567d88a6,1,12,10,22,8,2013-06-13 22:08:53,2013-06-13 22:08:38
068076f775e88526bbfa19734fc1c34232e961b5...84d68007cb36b68e1b5c574a0d23fcf583e0d75c,5,30,15,45,18,2013-06-05 21:20:54,2013-06-05 21:20:19
84d68007cb36b68e1b5c574a0d23fcf583e0d75c...a3f6054f974909458c9e820842310987e225b767,3,33,3,36,8,2013-06-06 18:01:09,2013-06-06 18:01:09
a3f6054f974909458c9e820842310987e225b767...afd325a8845ad7c4846747fb9561df12ebf9963a,1,8,8,16,4,2013-06-06 18:01:29,2013-06-06 18:01:29
3999465c8569938cf859b24ea2bdd763fe1f3ceb...0d6db333d6b4944a228848a9f451d6a647324b40,5,0,227,227,5,2013-06-06 17:05:21,2013-06-06 17:05:21
0d6db333d6b4944a228848a9f451d6a647324b40...42b63eb81884d6e6b1dc325397195cffd880f493,1,1,0,1,1,2013-06-06 17:06:54,2013-06-06 17:06:54
432e18990b1cfbae014ff41c5445658a8d410aeb...5918a5a3228442cdf55bed6591090c00ebb1357c,1,4,0,4,1,2013-06-11 16:27:36,2013-06-11 16:27:36
a5fe6f8af4ed2142ed546e402cbd003147966786...e33ba9b36daa5e72e33d65b316059cddc756e0e9,1,20,15,35,17,2013-05-29 14:14:51,2013-05-29 14:14:51
e84306ca6187da7ed3a15f585845eef19e9bd5eb...cd0de83917e775fcdcd3ce4e592b627b7eeeac64,3,46,33,79,32,2013-05-29 00:12:24,2013-05-29 00:12:24
cd0de83917e775fcdcd3ce4e592b627b7eeeac64...b76d6120ac66a853d177f7e53318ab1ee75dca92,4,34,19,53,18,2013-05-29 00:35:10,2013-05-29 00:35:10
250e47e2eb12015fd436a9b695c50cc2fbfb3fdc...7f118519eb007b2423fff428aceddabd6c1c301d,1,1,1,2,1,2013-06-14 21:46:08,2013-06-14 21:46:08
a7e14a3065ccd97fcd77b4038abdf30bee78a2b4...88279439af6b5196aaeb9bcb3d7a7154be04d4bc,1,3,8,11,3,2013-06-19 19:07:56,2013-06-19 19:07:56
a056f1deeceac20a9212570ea8448911e3f0d1ed...507ea757a5d72af47b37af0e384e83fcea613a7b,2,8,15,23,3,2013-06-19 21:26:11,2013-06-19 21:26:11
a056f1deeceac20a9212570ea8448911e3f0d1ed...0312bbc535de01cade67299dd41a69935c7241ba,2,15,6,21,7,2013-06-19 20:49:45,2013-06-19 20:48:49
7ff2e6b797b5e12b5ae55f50731a174343b9f6a3...49e656839fb3d846dc65fec544f2984a9c72a2cf,8,55,168,223,53,2013-05-30 15:39:43,2013-05-30 15:39:43
7ff2e6b797b5e12b5ae55f50731a174343b9f6a3...2c14d3949dcad3a98980929e0cb2d2326db7d8fe,1,30,30,60,2,2013-05-30 14:08:26,2013-05-30 14:08:26
7ff2e6b797b5e12b5ae55f50731a174343b9f6a3...2a53717e8ff01df7c58485f89845bad31e50f497,1,39,10,49,8,2013-05-30 13:45:39,2013-05-30 13:45:39
7ff2e6b797b5e12b5ae55f50731a174343b9f6a3...b2084a9c599d91fa1460116ef0c8d509d3353103,1,18,0,18,1,2013-05-30 04:56:08,2013-05-30 04:56:08
dc1fa0745f779d8c9a513dea71021d263b89ca5f...044bdc1b5fc748e98e7baaa7e95ce216cc667323,1,2,2,4,2,2013-05-29 13:42:20,2013-05-29 13:42:20
e6e13d6adeee73802243837c10f73dd8364b70df...0f135ad7f31df2952352feb9ef00863d61577467,4,157,24,181,25,2013-05-23 03:07:26,2013-05-23 03:07:26
0f135ad7f31df2952352feb9ef00863d61577467...d42c10aa094e39d8c1184b61c98777d8c59ae900,3,57,34,91,21,2013-05-24 01:32:56,2013-05-24 01:32:56
d42c10aa094e39d8c1184b61c98777d8c59ae900...e3f04298597195a95557c4224c05df752dc08695,1,311,0,311,1,2013-05-24 01:33:31,2013-05-24 01:33:31
e3f04298597195a95557c4224c05df752dc08695...2cd00a47a5a8f405eb6a7b3f34edaf38c89e9b1c,1,0,30,30,1,2013-05-24 01:34:38,2013-05-24 01:34:38
2cd00a47a5a8f405eb6a7b3f34edaf38c89e9b1c...54db18625aa7154c9dd230907444676fa3079b99,3,18,2,20,6,2013-05-28 20:37:49,2013-05-28 20:37:49
54db18625aa7154c9dd230907444676fa3079b99...6ae3800151025ff73a97c40af578ee714164003b,4,54,41,95,12,2013-05-28 20:38:26,2013-05-28 20:38:26
6ae3800151025ff73a97c40af578ee714164003b...90ffcda05547332020ec6f2b98179380f7d0e56f,1,10,6,16,6,2013-05-28 20:38:40,2013-05-28 20:38:40
e6e13d6adeee73802243837c10f73dd8364b70df...949a649cc2364f796daae14fa3b044432e25efdf,1,2,1,3,1,2013-05-22 13:49:12,2013-05-22 13:49:12
e6e13d6adeee73802243837c10f73dd8364b70df...5818813183bfb61180846f2b1b23a6fdcb2c9cdd,1,3,3,6,3,2013-05-22 03:45:27,2013-05-22 03:45:27
e6e13d6adeee73802243837c10f73dd8364b70df...4489005cb2f11fe6e2dcdb181b4834791de3b73f,1,5,0,5,2,2013-05-21 12:53:05,2013-05-21 12:53:05
4489005cb2f11fe6e2dcdb181b4834791de3b73f...a55a0d370dfca169e0220a01c292c7d41ad0b557,1,8,3,11,1,2013-06-03 14:23:57,2013-06-03 14:23:57
e6e13d6adeee73802243837c10f73dd8364b70df...a3ccec197e847a996e725d87177067dba98bcca6,2,8,6,14,6,2013-05-21 10:14:58,2013-05-21 10:14:58
a3ccec197e847a996e725d87177067dba98bcca6...800b401f0ba706f8f09b5beacd335caf4548e63c,3,17,2,19,3,2013-05-22 16:15:52,2013-05-22 16:15:52
800b401f0ba706f8f09b5beacd335caf4548e63c...13f1939a6316079c14bac5434ecc2c955af1d1fb,4,33,19,52,18,2013-05-23 16:09:28,2013-05-23 16:09:28
13f1939a6316079c14bac5434ecc2c955af1d1fb...59835135c572db08798dde7a5e211e7f4b453742,1,3,0,3,1,2013-05-23 16:15:36,2013-05-23 16:15:36
389db5f5987e927bf2f8f90ea536fec3a95ac1cb...3491d7d2f11246ba4067708a3c5336ba21da4767,11,82,190,272,18,2013-06-18 03:16:56,2013-06-18 03:16:56
389db5f5987e927bf2f8f90ea536fec3a95ac1cb...e8f001d45157f2f645e415543d7c3e7bf832c665,3,37,1,38,3,2013-06-17 19:15:21,2013-06-17 19:01:21
389db5f5987e927bf2f8f90ea536fec3a95ac1cb...13e03a691145921ffc17c56db24f06eacca99a77,1,11,5,16,6,2013-06-17 18:29:02,2013-06-17 18:29:02
13e03a691145921ffc17c56db24f06eacca99a77...6dccdd657f715c164f2fe6fc786c8274a2425f1b,1,0,6,6,2,2013-06-19 00:09:47,2013-06-19 00:09:47
389db5f5987e927bf2f8f90ea536fec3a95ac1cb...fde82f448f6b1508e03f419a3ce4c9b80311d466,2,18,15,33,9,2013-06-17 18:13:40,2013-06-17 18:13:40
79efcb545d76970843e02c48492a61450dba5564...cff2187a4ccf90a5be821c316b564e934d80998c,1,2,2,4,2,2013-06-20 19:30:02,2013-06-20 19:30:02
80857545076ade871eff7fc76c2fe83554219e3f...2eaa0a1dd7354e429c056d68515f903351e3eeb4,1,13,5,18,8,2013-06-13 19:57:35,2013-06-13 19:57:35
2eaa0a1dd7354e429c056d68515f903351e3eeb4...452128f0daf8117502fad2fe2f72b6f022223ddb,1,15,9,24,6,2013-06-13 22:18:15,2013-06-13 22:18:15
4b4918f2a78c129c4ca745147fd38f985d2635c2...f03ebc20aa33dbb9b468fe476ce26467eb328060,1,1,1,2,2,2013-06-14 01:42:27,2013-06-14 01:42:27
f03ebc20aa33dbb9b468fe476ce26467eb328060...2f14dae83f23f62085015243a74df4ffc415c6c4,1,38,3,41,7,2013-06-14 01:52:41,2013-06-14 01:52:41
42b63eb81884d6e6b1dc325397195cffd880f493...56473d4cce79b0f06e46d88d14c716c1858188e2,1,0,0,0,0,2013-06-06 20:52:55,2013-06-06 20:52:55
42b63eb81884d6e6b1dc325397195cffd880f493...da937bf214d781af9c3eb955e1b33e78359892e2,1,3,0,3,1,2013-06-06 17:09:11,2013-06-06 17:09:11
08e5f1295487f2c06639bc8ac97be35f30359534...c7af917d13c34c6a008df60fa45079fab32cea70,1,47,2,49,2,2013-05-29 18:29:30,2013-05-29 18:29:30
08e5f1295487f2c06639bc8ac97be35f30359534...75d2244023cd39af17976c56225da6b5158ff68f,1,14,16,30,6,2013-05-29 17:51:47,2013-05-29 17:51:47
75d2244023cd39af17976c56225da6b5158ff68f...6cbc7757b2b4d068a98287754da552028fd62212,1,1,0,1,1,2013-05-29 17:53:24,2013-05-29 17:53:24
6cbc7757b2b4d068a98287754da552028fd62212...33ea1483d5b89559e1fe9a9556e3ea757f673e16,1,23,12,35,9,2013-05-29 18:43:29,2013-05-29 18:43:29
33ea1483d5b89559e1fe9a9556e3ea757f673e16...d97fff60a9275324290bb01b921c9b6b0967a4fd,2,37,5,42,2,2013-05-29 18:50:49,2013-05-29 18:50:49
d97fff60a9275324290bb01b921c9b6b0967a4fd...92939569ab06d13cd179d6e998ef9576d3921bb6,1,3,3,6,1,2013-05-29 18:53:44,2013-05-29 18:53:44
92939569ab06d13cd179d6e998ef9576d3921bb6...ae0d555022411025607acce43ea1929bafd7174a,1,20,8,28,12,2013-05-29 21:37:03,2013-05-29 21:37:03
ae0d555022411025607acce43ea1929bafd7174a...b6165daa775bbf20451ecbe570ab0fb85ad35128,1,12,30,42,20,2013-05-29 22:03:00,2013-05-29 22:03:00
b6165daa775bbf20451ecbe570ab0fb85ad35128...560a74af1562de007ba487e102fd00a2f658e6a0,2,22,20,42,8,2013-05-29 23:11:04,2013-05-29 23:10:11
560a74af1562de007ba487e102fd00a2f658e6a0...881fdc59edf39ba8d87b44b05db7fcd95661d083,1,17,2,19,3,2013-05-30 00:04:46,2013-05-30 00:04:46
881fdc59edf39ba8d87b44b05db7fcd95661d083...faafbf211899bc28e7e21e76de051d87ef5b5cd2,1,7,3,10,3,2013-05-30 00:58:05,2013-05-30 00:58:05
faafbf211899bc28e7e21e76de051d87ef5b5cd2...dcab408f6a047d5a4ccac0d3999d8c896f0a63dc,2,4,4,8,4,2013-05-30 01:14:50,2013-05-30 01:14:50
dcab408f6a047d5a4ccac0d3999d8c896f0a63dc...fc864d2f0f2814be87984cefec66719c6d95d802,1,23,30,53,9,2013-05-30 01:18:57,2013-05-30 01:18:57
fc864d2f0f2814be87984cefec66719c6d95d802...9a394041270d2a8ba648f215dacc186473140552,1,7,4,11,3,2013-05-30 01:55:00,2013-05-30 01:55:00
9a394041270d2a8ba648f215dacc186473140552...97247c5c733db355f7261ddad5223a00c33c635e,1,0,39,39,1,2013-05-30 04:57:36,2013-05-30 04:57:36
97247c5c733db355f7261ddad5223a00c33c635e...56431d3130f8a48cfb708509cbe39682f7fe841c,2,14,2,16,6,2013-05-30 19:08:21,2013-05-30 19:08:21
56431d3130f8a48cfb708509cbe39682f7fe841c...a4e6025cc1103d1ad9c86fa5d75f832526d2a7b8,1,8,0,8,1,2013-05-30 19:10:54,2013-05-30 19:10:54
a4e6025cc1103d1ad9c86fa5d75f832526d2a7b8...6d2e3d2ec0dedc6c1429e87800e9f3d7e4ada095,1,10,2,12,2,2013-05-30 19:21:57,2013-05-30 19:21:57
6d2e3d2ec0dedc6c1429e87800e9f3d7e4ada095...28d5b2c15acc6e088a0abd2099a00ba1180beb3e,2,7,18,25,5,2013-05-30 19:35:19,2013-05-30 19:35:19
abf85b25085b52e19f774dc30bd87527b3295f2a...02c291d13be261f84cdfa1d51513bf4dba31ce72,1,5,5,10,4,2013-06-18 01:11:58,2013-06-18 01:11:58
1b19939742cf26ded8303e9a961f1a7bfe19b32c...da5bb4db96b369365c4b913d9009d8bb1d0f51f4,2,21,1,22,2,2013-06-20 19:23:14,2013-06-19 21:27:54
8a131dffb6531d64f7ed1fefea5a5110dba29a56...d8887f34888c1e6c1a846d54e3e8afc4791d88d0,1,9,7,16,3,2013-06-20 15:57:28,2013-06-20 15:57:28
8a131dffb6531d64f7ed1fefea5a5110dba29a56...1c841d4feed99ad568b7a5b04cedf8d65c3bb92c,1,3,0,3,1,2013-06-20 15:45:30,2013-06-20 15:45:30
8a131dffb6531d64f7ed1fefea5a5110dba29a56...bd04d7d475e6497070b3144e6526566b066674cf,3,26,8,34,9,2013-06-20 14:19:50,2013-06-20 14:19:50
bd04d7d475e6497070b3144e6526566b066674cf...da199846d2813467ab8bae629336f3989f285ce9,2,28,5,33,4,2013-06-20 14:34:58,2013-06-20 14:34:58
da199846d2813467ab8bae629336f3989f285ce9...5b3ad0023b95823f15fe72605fa9b2786ce5035b,1,3,2,5,2,2013-06-21 09:06:09,2013-06-21 09:06:09
5b3ad0023b95823f15fe72605fa9b2786ce5035b...1581ed52ba07a869b5902afbb7c7bb01bb1e4a63,1,3,3,6,3,2013-06-21 22:55:33,2013-06-21 22:55:33
7e065aaacd35f0db675c4699c846e01314b18765...5fc1329b2fac25c85621d819c82253e9481196d4,1,2,2,4,2,2013-06-19 21:45:03,2013-06-19 21:43:41
194fca8347f04bd9b2674d15bff1e3493ef32e3d...2ed1092dad9d2dec30945b06572befbba003ed1d,2,0,26,26,2,2013-05-30 18:26:47,2013-05-30 18:26:47
5324614410efc2e69d6f78a78763fde6bc3cba2d...43f369ea0ca5d07a1e3b6d04864ad204c3c65357,2,7,0,7,2,2013-05-30 19:28:24,2013-05-30 19:28:24
52113cc4431704b186727d917cda15411e671f50...faae7220c019882a2160aeea6bebc46c15d702be,3,75,63,138,63,2013-05-22 15:29:54,2013-05-22 15:29:54
1ccc7bdd9083f8970d73a66c86a520dca08b371c...f008d1107c1702a2c3337e4515c6f72db557013b,1,1,1,2,1,2013-05-22 23:04:33,2013-05-22 23:04:33
702c3538a4f9dd251c27364f3511be19851f7784...cb9d0fd3bc13a381f3017d06cd057da2cd3f1c15,1,12,5,17,10,2013-06-18 19:26:56,2013-06-18 19:26:56
cb9d0fd3bc13a381f3017d06cd057da2cd3f1c15...c0b82bd807000019674e1f939b9ee2f43e5ba518,1,11,3,14,2,2013-06-18 19:52:37,2013-06-18 19:50:56
c0b82bd807000019674e1f939b9ee2f43e5ba518...cdeaba2acfe8e5765aaf9fec195705eb841cb857,1,0,1,1,1,2013-06-18 20:02:12,2013-06-18 20:02:12
702c3538a4f9dd251c27364f3511be19851f7784...c2e95997d4c4dda9edbb4adaab8920f1b5982c25,4,7,3,10,5,2013-06-18 17:55:59,2013-06-18 17:55:59
c2e95997d4c4dda9edbb4adaab8920f1b5982c25...bc9b91e501369264966263fc28bb516e6048b7e5,2,3,3,6,3,2013-06-18 22:57:43,2013-06-18 22:57:43
7b6f50772cc7003fede23e74f70f8dc76b96a434...bd9bf9b646837dac5f935e43a4b950d42353676e,1,11,3,14,2,2013-06-17 21:08:50,2013-06-17 17:31:27
555552340dd07eb446e54011071a621430fd83a0...6e17cc45eabf6d094241fc3e017a90da8ba6f5d9,1,2,279,281,1,2013-06-18 19:33:06,2013-06-18 19:33:06
6e17cc45eabf6d094241fc3e017a90da8ba6f5d9...84ceeaa8708293de81765a0f854952a74d191024,2,13,2,15,5,2013-06-18 21:36:35,2013-06-18 21:36:35
452128f0daf8117502fad2fe2f72b6f022223ddb...36231345f17e6fdb08b0f756c4872294d4745048,2,24,0,24,2,2013-06-17 20:05:58,2013-06-17 20:05:58
36231345f17e6fdb08b0f756c4872294d4745048...862659875335c953bf6974af4cace397c7ec3902,1,8,6,14,6,2013-06-17 20:25:50,2013-06-17 20:25:50
862659875335c953bf6974af4cace397c7ec3902...cb58e63fc54fb3f1c620c8372269a8e308e43bee,1,1,1,2,1,2013-06-17 20:28:04,2013-06-17 20:28:04
452128f0daf8117502fad2fe2f72b6f022223ddb...2f67a62b5b48862948b1ce92aeffbb83c3707ee0,1,5,0,5,3,2013-06-14 18:38:15,2013-06-04 18:30:47
2f67a62b5b48862948b1ce92aeffbb83c3707ee0...e53721ef69b13365c18c9189145ae1fadb931f01,2,2,2,4,2,2013-06-14 18:38:15,2013-06-04 18:35:41
e53721ef69b13365c18c9189145ae1fadb931f01...fb7eaf67d1c01eea28fcbed61d6d8abd8117c965,1,1,1,2,1,2013-06-14 18:41:12,2013-06-14 12:07:43
fb7eaf67d1c01eea28fcbed61d6d8abd8117c965...f1d16ea0035ee45341e5d4a143cdce5798847cb5,1,1,1,2,1,2013-06-14 18:41:12,2013-06-14 12:09:07
f1d16ea0035ee45341e5d4a143cdce5798847cb5...822abab17e33a0f87ef1d785a9148d3ea11cbb60,1,1,1,2,1,2013-06-14 18:41:12,2013-06-14 12:13:27
452128f0daf8117502fad2fe2f72b6f022223ddb...9ee11161bf0c635a0b0164ae1dee806c6fcfe7b7,1,4,0,4,1,2013-06-14 16:52:44,2013-06-14 16:46:04
9ee11161bf0c635a0b0164ae1dee806c6fcfe7b7...d3f83a6592e3d79768d9d3805edec80642b69c4b,1,22,0,22,1,2013-06-14 19:55:00,2013-06-14 19:55:00
452128f0daf8117502fad2fe2f72b6f022223ddb...9cc72ff1a9632736adc7dd12f096e3233896fced,1,8,12,20,3,2013-06-14 09:53:48,2013-06-14 09:53:48
9cc72ff1a9632736adc7dd12f096e3233896fced...90f6bdd6e41ec352009ffbd073c1f45983abb74b,4,36,12,48,11,2013-06-14 13:38:51,2013-06-14 13:38:51
452128f0daf8117502fad2fe2f72b6f022223ddb...3384943cd3bc5bb9fd79ccbda9d32a582ada69b3,4,9,10,19,6,2013-06-14 05:14:43,2013-06-14 05:14:29
452128f0daf8117502fad2fe2f72b6f022223ddb...0425f65e6373dc38cd18a6d0f2a50671544ad4b2,1,45,3,48,5,2013-06-14 00:53:38,2013-06-14 00:53:38
0425f65e6373dc38cd18a6d0f2a50671544ad4b2...6f7de49aa8771ef4bc35548f9aa07fee660f1844,1,46,5,51,7,2013-06-14 17:47:49,2013-06-14 17:47:49
6f7de49aa8771ef4bc35548f9aa07fee660f1844...79fe864d9a117193b4dce8b7fe156a55bbadcce6,3,3,4,7,3,2013-06-14 17:58:16,2013-06-14 17:58:16
da937bf214d781af9c3eb955e1b33e78359892e2...302660e362ba36f9966b9a70b7d7284b94afb89d,1,15,0,15,2,2013-06-07 19:56:39,2013-06-07 19:56:39
da937bf214d781af9c3eb955e1b33e78359892e2...8d4282cd36e3516c08dfa624da352b445bedf204,2,6,4,10,2,2013-06-07 13:09:24,2013-06-07 13:09:24
da937bf214d781af9c3eb955e1b33e78359892e2...f355d33b5fe37ce7c0c25373255ea8afd931f4e7,2,21,15,36,16,2013-06-07 01:16:16,2013-06-07 01:16:16
f355d33b5fe37ce7c0c25373255ea8afd931f4e7...1e0738f63f55d489d3d96274f312c93cc5d69ffa,1,20,8,28,8,2013-06-07 01:42:52,2013-06-07 01:42:52
da937bf214d781af9c3eb955e1b33e78359892e2...efa7ea592c1819f006acf9480c10e50ec63b3001,1,6,2,8,2,2013-06-06 19:06:12,2013-06-06 19:06:12
efa7ea592c1819f006acf9480c10e50ec63b3001...4b3a381f39bc90b36877f4832fe5c53de65a1ec3,1,1,0,1,1,2013-06-06 21:39:43,2013-06-06 21:39:43
1c091657d44784a049b115892bd6ff812268688b...468e4c4b565d25b03c68ce2ab31f9a52f7b3398a,3,6,1,7,4,2013-05-31 15:34:23,2013-05-31 15:34:23
1c091657d44784a049b115892bd6ff812268688b...2baea2487936c3d385671d25ab3ef1b09f9007cc,1,1,0,1,1,2013-05-31 14:40:09,2013-05-31 14:40:09
1c091657d44784a049b115892bd6ff812268688b...1040225e36c6b235d5f82e44685b2f942be68965,3,16,10,26,11,2013-05-31 07:59:18,2013-05-31 07:59:18
4205b6bb1dfa06b70e969286ac911f744a88cb81...c903a6baf83b4aaa51d7198643e0eef9211c99ed,1,0,4,4,1,2013-05-30 22:52:09,2013-05-30 22:52:09
c903a6baf83b4aaa51d7198643e0eef9211c99ed...caaea2e08f85438b7a6bee006e803f1c4351c445,1,0,5,5,2,2013-05-30 23:24:26,2013-05-30 23:24:26
02c291d13be261f84cdfa1d51513bf4dba31ce72...42ce68894a33a7d966f8dd767aee46dea6dbc346,1,12,0,12,3,2013-06-19 00:22:32,2013-06-19 00:22:32
02c291d13be261f84cdfa1d51513bf4dba31ce72...6f511ac29b1c3cf1c2424b3c39ee14a32aecb5d7,3,3,3,6,3,2013-06-18 17:23:45,2013-06-18 17:23:45
a078d3c8728acbc2e104951037bc2f7ece57d1e9...e44f62a95cc8f3cab446205d66450ee37911e29c,3,8,7,15,7,2013-06-20 21:29:54,2013-06-20 21:29:54
a078d3c8728acbc2e104951037bc2f7ece57d1e9...dbfb3eb92391d90741be3238551a0fffcf2dbcdc,1,1,1,2,1,2013-06-20 21:29:34,2013-06-20 21:29:34
dbfb3eb92391d90741be3238551a0fffcf2dbcdc...02f0c1e46d1d73677aed899c1f0deaa69ab11ffc,2,4,1,5,2,2013-06-20 21:33:59,2013-06-20 21:33:59
02f0c1e46d1d73677aed899c1f0deaa69ab11ffc...08825fa611cf5067b99bed452ffe6320ed00003a,2,0,81,81,2,2013-06-20 23:31:11,2013-06-20 23:31:11
a078d3c8728acbc2e104951037bc2f7ece57d1e9...da063497232ebe7202b1c7a0c5ecdecaccb3681b,1,1,1,2,1,2013-06-20 21:15:38,2013-06-20 21:15:38
d8f56352da94fa70873bfb7fb27d59f46ebc743b...c5be64fec478f5081a06480951811d30753fc46a,2,3,3,6,3,2013-06-20 17:33:54,2013-06-03 20:18:44
c5be64fec478f5081a06480951811d30753fc46a...db60337598d264dc02d67e0dde93b300bf971903,2,2,2,4,2,2013-06-20 17:39:09,2013-06-15 00:43:12
4383d7b603c873d38e4637a34c92c927bda4e7aa...8e7d4cda078482b84836f51e3e7ce17aa0f65217,1,1,0,1,1,2013-06-21 09:13:13,2013-06-21 09:13:13
4383d7b603c873d38e4637a34c92c927bda4e7aa...66910a76027d3e37b6a96c0bd1106cfd5d27ba40,1,1,1,2,1,2013-06-21 08:06:41,2013-06-21 08:06:41
66910a76027d3e37b6a96c0bd1106cfd5d27ba40...6a1279fb90ad33fec05a48529981db7bb093b782,1,1,1,2,1,2013-06-21 08:07:14,2013-06-21 08:07:14
2ed1092dad9d2dec30945b06572befbba003ed1d...fc788956c5b1e3afb802d3fad1788377eea4e55a,1,1,0,1,1,2013-05-30 18:31:49,2013-05-30 18:31:49
edbd3da33a02068cd48d4a862071f429c0d05329...5be7b9af3ee9b884482220979735e2a8ea969ce3,3,117,10,127,11,2013-06-19 03:28:49,2013-06-19 03:28:49
86205540d8d28e4f070ece91712238212105ddf0...e2d034e48858d0afe9ee0f88f04e40cbf95ab8ba,1,1,5,6,2,2013-06-18 17:06:26,2013-06-18 17:06:26
bd9bf9b646837dac5f935e43a4b950d42353676e...8281a0fa1cea0199ab183c0925a41e79a18382dc,1,8,0,8,2,2013-06-18 05:19:14,2013-06-02 21:08:41
bd9bf9b646837dac5f935e43a4b950d42353676e...e664a46ff334ff9f7c8dfb438e15950e3cacf184,3,24,16,40,4,2013-06-18 02:50:31,2013-06-18 02:50:31
bd9bf9b646837dac5f935e43a4b950d42353676e...3bfc82257878e55141bb029390574130c3ac0530,3,16,1,17,4,2013-06-18 01:39:30,2013-06-18 01:39:30
3bfc82257878e55141bb029390574130c3ac0530...02a002d264faa7b8cdf5c68b7370c31d6794a44d,1,1,0,1,1,2013-06-18 01:41:13,2013-06-18 01:41:13
02a002d264faa7b8cdf5c68b7370c31d6794a44d...808faa6371c470fa0765f5d4e3aed7708d8f9ee6,4,12,11,23,7,2013-06-18 17:31:07,2013-06-18 17:31:07
bd9bf9b646837dac5f935e43a4b950d42353676e...b25bcf1a666ebef26e2acfa132fa2b72d47d0805,2,2,1,3,2,2013-06-17 23:32:48,2013-06-17 23:32:48
bd9bf9b646837dac5f935e43a4b950d42353676e...fe204e6f48eb47a1deb3553003eaf9863a66fd1a,2,62,6,68,9,2013-06-17 23:10:00,2013-06-17 23:10:00
bd9bf9b646837dac5f935e43a4b950d42353676e...c106ed32ea7613573a2081d47ad2498429ac86f2,2,4,3,7,2,2013-06-17 22:40:04,2013-06-17 22:40:04
c106ed32ea7613573a2081d47ad2498429ac86f2...2b6ca3872883dcb487d8a39a1a8530be6a62f947,1,6,27,33,5,2013-06-17 22:45:08,2013-06-17 22:45:08
bd9bf9b646837dac5f935e43a4b950d42353676e...3a0ffbc77267e395676860db265ee3476c45b3c2,1,7,21,28,4,2013-06-17 21:44:35,2013-06-17 21:44:35
3a0ffbc77267e395676860db265ee3476c45b3c2...3dc93e390ad3d310dede84948b726ce67e261375,1,1,6,7,2,2013-06-18 17:10:03,2013-06-18 17:10:03
8f2a80804ce6f3ab77057a25180a27e3b346778b...639833aaf53d741176e0b4f817cbbf5a5da24037,1,2,2,4,2,2013-06-21 09:20:57,2013-06-21 09:20:57
9eda9154a71996e3d2adccb38afb5c5fb0ce4ffe...fd0c501e6d65b665cba87f3449e02a722d90e6b1,1,1,1,2,1,2013-05-31 19:19:49,2013-05-31 19:19:49
fd0c501e6d65b665cba87f3449e02a722d90e6b1...766a2db0d94d0f7cd8bdb71762476893a4df4cc1,1,1,0,1,1,2013-05-31 19:19:57,2013-05-31 19:19:57
a148301a03acdf8d294ed23d67aa6c10d0769bbd...8d73740343778651c09160cde9661f5f387b36f4,4,33,1,34,4,2013-05-31 00:27:45,2013-05-31 00:27:45
862e223cecec203a96d3be4fd667bc9286703e82...a359e52f293439388684ee3853fe036892d18dbf,1,1,0,1,1,2013-08-28 23:50:37,2013-08-28 23:50:37
862e223cecec203a96d3be4fd667bc9286703e82...73afc6311daf6bce10d081352aa1efbfcb406d10,4,18,2,20,5,2013-06-25 22:31:22,2013-06-25 22:31:22
862e223cecec203a96d3be4fd667bc9286703e82...fb86dcfb17444089aea31cdf6c9b09c4421731c7,1,3,3,6,3,2013-06-25 14:52:10,2013-06-25 14:52:10
862e223cecec203a96d3be4fd667bc9286703e82...bccf06c748c8f62a617a94e8120ce33f2e53183b,1,3,3,6,2,2013-06-25 14:03:15,2013-06-25 14:03:15
08825fa611cf5067b99bed452ffe6320ed00003a...b419699ab8f79f4826ec94583c6f7a46f74eeaa2,3,15,7,22,14,2013-06-21 01:18:36,2013-06-21 01:18:36
5ccde4dffc836fb0c6ea967d5d61920edfb65bd0...3ac68f1966222d9a1c0ff867515e3f5c2f83e422,1,2,2,4,2,2013-06-21 15:19:27,2013-06-21 15:19:27
5ccde4dffc836fb0c6ea967d5d61920edfb65bd0...42bcfcc927499c63bbc3e3de80e6f52fd02fc9e8,2,44,23,67,8,2013-06-21 10:00:25,2013-06-21 10:00:25
42bcfcc927499c63bbc3e3de80e6f52fd02fc9e8...ec6b35240ed19aa68e4295c9211aa13a7e37efad,1,4,3,7,2,2013-06-22 00:37:02,2013-06-22 00:37:02
fc788956c5b1e3afb802d3fad1788377eea4e55a...531b30119ab5422f9f34ebf3be1a6b6578ded9f1,1,0,1,1,1,2013-05-30 18:37:58,2013-05-30 18:37:58
0ae778c8812fa7adfece0dd37ef82d7970431f06...5dcab2d361956e75d00d5bee18371395f17a663f,4,13,13,26,4,2013-06-19 14:50:58,2013-06-19 14:50:58
5dcab2d361956e75d00d5bee18371395f17a663f...2d6a49215c15e7649f8b041e5a04e75b4d360c94,1,3,0,3,1,2013-06-19 18:21:53,2013-06-19 18:21:46
0ae778c8812fa7adfece0dd37ef82d7970431f06...a780b7c6b53fc15ef884def8696ac29f961acb2c,8,1160,0,1160,4,2013-06-19 02:31:35,2013-06-19 01:29:17
a780b7c6b53fc15ef884def8696ac29f961acb2c...5183399f50e489204471393c4e89a0476f396b9b,5,870,569,1439,376,2013-06-19 02:31:35,2013-06-19 02:20:31
069a7c1e99df6458868c9585aeeb1aaf642160f2...3adf9ce04ef1632f82f7bd1585c135bb141aa450,5,109,45,154,28,2013-06-18 18:59:56,2013-06-18 18:59:56
3adf9ce04ef1632f82f7bd1585c135bb141aa450...dede1585ee00f957e153691c464aab293c2dc469,3,42,34,76,10,2013-06-19 12:31:54,2013-06-19 12:31:54
dede1585ee00f957e153691c464aab293c2dc469...9632bf228744dddfae2c303a0f2e8b962b6e0673,1,18,0,18,1,2013-06-19 12:40:01,2013-06-19 12:40:01
9632bf228744dddfae2c303a0f2e8b962b6e0673...063c838c927615e9507eca2a5c2f38a5fc4c35b2,3,21,5,26,5,2013-06-19 12:48:50,2013-06-19 12:48:50
766a2db0d94d0f7cd8bdb71762476893a4df4cc1...b4df0b17afef027e88f0536cbfc9518e04f62eec,2,5,1,6,4,2013-06-02 04:25:51,2013-06-02 04:25:51
b4df0b17afef027e88f0536cbfc9518e04f62eec...3ca9c11110ff5068fd453a3e8aa0b39ee26d363c,1,4,2,6,1,2013-06-02 04:26:18,2013-06-02 04:26:18
3ca9c11110ff5068fd453a3e8aa0b39ee26d363c...01ce63aacdd975130244f4be70bc90736e85d457,1,7,7,14,4,2013-06-02 04:26:58,2013-06-02 04:26:54
01ce63aacdd975130244f4be70bc90736e85d457...e3fd61ad74521b1a94502cf8dcc7c450f035c168,1,1,1,2,1,2013-06-02 04:27:27,2013-06-02 04:27:27
e3fd61ad74521b1a94502cf8dcc7c450f035c168...f6f345b1fe0ecc1adba449b0078d96388dd48892,1,2,2,4,1,2013-06-02 04:55:01,2013-06-02 04:55:01
f6f345b1fe0ecc1adba449b0078d96388dd48892...23452f1573e7887b638a4e69a4cf90d757921885,2,4,4,8,2,2013-06-02 05:02:24,2013-06-02 05:02:24
23452f1573e7887b638a4e69a4cf90d757921885...2935ca7ee2879723c786b86ee87cc1be26dad7b8,4,7,7,14,5,2013-06-02 05:03:12,2013-06-02 05:03:12
2935ca7ee2879723c786b86ee87cc1be26dad7b8...157547845acd8a0633df72e01d22bad9cbec578b,4,8,8,16,4,2013-06-02 05:03:28,2013-06-02 05:03:28
157547845acd8a0633df72e01d22bad9cbec578b...4fb9a6eafb981ed66fe547fe29c11525f40d0640,1,2,2,4,2,2013-06-02 05:03:41,2013-06-02 05:03:41
4fb9a6eafb981ed66fe547fe29c11525f40d0640...e9ffc1e49998d42f37b39cd23b56b73f7dc0e3da,2,227,1,228,3,2013-06-02 05:06:53,2013-06-02 04:53:22
e9ffc1e49998d42f37b39cd23b56b73f7dc0e3da...464765b940c8194c302b89891dc06b8fcc1b37ff,1,2,1,3,1,2013-06-02 05:16:26,2013-06-02 05:16:26
464765b940c8194c302b89891dc06b8fcc1b37ff...82dadc200593e39f0979159d46afccf64f1e7a83,1,10,0,10,2,2013-06-03 03:10:22,2013-06-03 03:10:22
ee5df765796cfbeade482652e4c5d928c82af6d1...1f8b679b18984eeecc98d6de79a77cbd405cd56d,1,1,1,2,1,2013-06-19 01:19:07,2013-06-19 01:19:07
e12a204bccfc65b31a484944beb3d61aabe2d362...54da339b2c3d1fe11a465aff69fc4e00ec3b40fd,2,6,6,12,6,2013-06-28 19:41:09,2013-06-28 19:41:09
5cdbd2ed7ab1a09245851443ec7d08d4a2dfd680...27d67773768222ffc57f124b38c767f36a575f96,1,28,0,28,6,2013-06-26 19:50:20,2013-06-26 19:50:20
27d67773768222ffc57f124b38c767f36a575f96...2a20e852032339b4c91a01748119701c7ada234d,1,2,2,4,2,2013-06-27 18:10:19,2013-06-27 18:10:19
5cdbd2ed7ab1a09245851443ec7d08d4a2dfd680...e5c0b3110703258e255305cd9feb114a02c33350,1,46,0,46,1,2013-06-26 19:35:14,2013-06-26 19:35:14
e68a23bdc1a92f5b9bb4d3fa3e495330068a7e9a...5ed4386bbf869caf6d39f619e27c5ee1310f879d,1,3,1,4,1,2013-06-27 14:51:17,2013-06-27 14:51:17
e68a23bdc1a92f5b9bb4d3fa3e495330068a7e9a...9d3ec7b39fcf178eaa9aa1482f0a85c257df4408,1,8,2,10,1,2013-06-27 12:57:19,2013-06-27 12:57:19
09dd7f14deea49d901c0446b3c2f3380bbeee64a...b0b690cf23871d36e1f981fcee6cb929158c4fee,2,25,1,26,18,2013-06-21 03:29:20,2013-06-21 03:23:49
09dd7f14deea49d901c0446b3c2f3380bbeee64a...50b70eeb6830040db73c8b2b389d881a3200de8d,4,0,8,8,6,2013-06-21 03:19:44,2013-06-21 03:19:44
09dd7f14deea49d901c0446b3c2f3380bbeee64a...cc0f59742f192ccbc178c59bdc7eb98d0f6dd943,1,6,42,48,4,2013-06-21 03:16:39,2013-06-21 03:16:39
cc0f59742f192ccbc178c59bdc7eb98d0f6dd943...36d610a38806feb4cb5d09c4705a6f1fff42ef04,5,79,39,118,14,2013-06-21 03:20:16,2013-06-21 03:20:16
352991bdf4c0a7702fcc791b961a516fb684f4c1...d9bce2defd56bbc47f47b263257b64016e48d607,1,5,2,7,2,2013-06-21 05:15:19,2013-06-21 05:15:19
d9bce2defd56bbc47f47b263257b64016e48d607...d0fa6927f8ad87e73a02f64ae9d6db6a820c1f4c,1,17,2,19,2,2013-06-21 20:51:48,2013-06-21 20:51:48
d0fa6927f8ad87e73a02f64ae9d6db6a820c1f4c...169ef21de768a45805f2afc56b3e5c6f21130b92,1,1,14,15,2,2013-06-21 21:12:52,2013-06-21 21:12:52
c792c0a6c9e110c082e61022cd53b725f150b410...5d61ec11e35f22f6e89f24b5186c7697cb187165,1,1,1,2,1,2013-06-22 00:57:45,2013-06-22 00:56:12
c792c0a6c9e110c082e61022cd53b725f150b410...41cdd9b27ff73035ed9be34e3cbdd670468ee643,1,1,1,2,1,2013-06-22 00:37:32,2013-06-22 00:37:20
d52af3f58f26c1bf1ea61af532385965434373eb...05796bed57d4e1de352e02fcd6b28aed14f1b670,1,8,4,12,2,2013-06-20 12:34:08,2013-06-20 12:31:48
33972627b7feb7bddce87e92d3789de6eb4611ef...74daeccec580c27c33c982cd246afc537f2804be,1,2,2,4,2,2013-09-13 19:21:43,2013-09-13 19:21:43
33972627b7feb7bddce87e92d3789de6eb4611ef...b3cbf424ec7dbce8a42f75b23f48083f3f62abaf,1,1,1,2,1,2013-09-13 19:09:05,2013-09-13 19:09:05
b3cbf424ec7dbce8a42f75b23f48083f3f62abaf...102522bcd1e87730394665c5a78f8e8bbcc50b7e,1,1,1,2,1,2013-09-13 19:10:05,2013-09-13 19:10:05
5e029f760000be547350e520302c5811d85fe525...8dcc6a0280720237008e36e893028032cd66aa2a,1,1,1,2,1,2013-07-01 13:28:58,2013-07-01 13:28:58
a11fc9f067d898e3dd6a43e9841e2ea85842af2b...af2a92f22b053d7c04a4416da87523d4296e103c,1,4,2,6,4,2013-06-28 16:23:25,2013-06-28 16:21:34
a11fc9f067d898e3dd6a43e9841e2ea85842af2b...de0a48bd6ff2acfb2ab546a1e718185872eea2c3,2,67,17,84,14,2013-06-28 16:19:58,2013-05-24 17:37:34
de0a48bd6ff2acfb2ab546a1e718185872eea2c3...1c817913eee7d87badc2a2748447729619d8aaf0,1,2,0,2,2,2013-06-28 16:19:58,2013-05-29 18:24:50
1c817913eee7d87badc2a2748447729619d8aaf0...2a1f8f6fda55a5fa2132dbad374043e9fbf6d9f6,1,8,7,15,2,2013-06-28 16:19:58,2013-05-29 18:25:49
2a1f8f6fda55a5fa2132dbad374043e9fbf6d9f6...50075106b658ab4dc82d5361e4786f7d28cc570a,1,0,1,1,1,2013-06-28 16:19:58,2013-05-29 18:39:31
50075106b658ab4dc82d5361e4786f7d28cc570a...57d751c3770194ff867ebace36eb1be7d72d2fe9,2,6,5,11,6,2013-06-28 16:19:58,2013-06-05 22:12:50
57d751c3770194ff867ebace36eb1be7d72d2fe9...67ecd2cb822894e4d35adea031e5b79d7ca8e91a,1,10,10,20,5,2013-06-28 16:19:58,2013-06-05 22:13:01
67ecd2cb822894e4d35adea031e5b79d7ca8e91a...c3dd6e1926f9359f840a9f7b0be9cfa7fe2cfea2,1,16,14,30,13,2013-06-28 16:19:58,2013-06-25 19:03:42
c3dd6e1926f9359f840a9f7b0be9cfa7fe2cfea2...e095a1572fb8a2ba17ea231abcb3704cf83a96e4,1,18,11,29,2,2013-06-28 16:19:58,2013-06-27 17:17:20
e095a1572fb8a2ba17ea231abcb3704cf83a96e4...ad2f826a825be2889057a773eff1a2bc605e8e80,1,8,9,17,5,2013-06-28 16:19:58,2013-06-28 16:16:19
ad2f826a825be2889057a773eff1a2bc605e8e80...72befeef24b3fb0c77f56e3ac2bbfdb4744cbd7a,1,3,0,3,1,2013-06-28 16:42:37,2013-06-28 16:42:37
a11fc9f067d898e3dd6a43e9841e2ea85842af2b...2e79719622964eb95eca70372ced0ad6e4dce4f5,5,90,1,91,9,2013-06-28 15:51:58,2013-06-28 15:51:58
2e79719622964eb95eca70372ced0ad6e4dce4f5...8589fd6db8d52f93ba64a0d72c6eebe8d50530f6,4,59,0,59,4,2013-06-28 16:05:41,2013-06-28 16:05:41
8589fd6db8d52f93ba64a0d72c6eebe8d50530f6...648c4f198b7215a35f31deb9cdf4d370049ef4b2,1,55,0,55,1,2013-06-28 16:27:00,2013-06-28 16:27:00
648c4f198b7215a35f31deb9cdf4d370049ef4b2...11e28842ac74ad0b706d24ec639952f78e9a147c,9,23,23,46,23,2013-07-01 15:19:42,2013-07-01 15:19:42
a11fc9f067d898e3dd6a43e9841e2ea85842af2b...9bfec5a5389207cba4cdbdd7eafc692c65278ce0,1,0,3,3,1,2013-06-28 13:22:01,2013-06-28 13:22:01
cd0f22ef72da22adaae68b93f4e4e65ed70edc2b...bd144a64f652895a41b67464a426839ef79d73dc,1,11,1,12,3,2013-06-27 19:48:25,2013-06-27 19:48:25
cd0f22ef72da22adaae68b93f4e4e65ed70edc2b...3d5633a0a0eb98bbd833e760279720a15ced8b58,3,12,12,24,12,2013-06-27 04:33:55,2013-06-27 04:33:55
3d5633a0a0eb98bbd833e760279720a15ced8b58...6cf493bea74e9caa05e1da9e970c47d1f24268d8,1,2,2,4,2,2013-06-27 04:40:13,2013-06-27 04:40:13
cd0f22ef72da22adaae68b93f4e4e65ed70edc2b...4fdf11b2e62bf7d785a958afd4fc5b8cfc32f621,14,273,58,331,64,2013-06-26 22:07:31,2013-05-13 23:39:54
4fdf11b2e62bf7d785a958afd4fc5b8cfc32f621...d4e62101abca637b5bc057ec13e73d9ce65d6161,4,195,216,411,38,2013-06-26 22:08:07,2013-06-25 06:30:48
d4e62101abca637b5bc057ec13e73d9ce65d6161...67239957c9e863f16a6d147d88dd2fae00c3770f,2,4,6,10,4,2013-06-26 22:10:38,2013-06-26 15:43:53
67239957c9e863f16a6d147d88dd2fae00c3770f...46a9f29baef77dbe212e1261f5cecbe1b53fadb9,2,7,5,12,8,2013-06-26 22:26:47,2013-06-26 19:04:55
70480ce7bc6991efd7fa917981940a0c1321eb17...fd97190ee752c8de38be38a03f3cfdd4b4ce1460,2,23,8,31,10,2013-07-08 17:20:13,2013-07-08 17:20:13
1a201d243327280e06e43ea538eb52a0c878cc57...aa8ea84d11ccac8f68fa1b0337633dd7d49a44fe,1,7,1,8,2,2013-06-28 01:01:10,2013-06-28 00:52:47
aa8ea84d11ccac8f68fa1b0337633dd7d49a44fe...fe014a8e6cfe4d2a338736e4c685bcf1b7685200,1,6,3,9,2,2013-06-28 01:01:20,2013-06-28 00:53:57
1a201d243327280e06e43ea538eb52a0c878cc57...3175e56ad03cbe0118c0982606c5eba9e34c1b07,3,14,6,20,7,2013-06-28 00:55:17,2013-06-28 00:55:17
1a201d243327280e06e43ea538eb52a0c878cc57...800d9006883228365a375800254871397cb1a011,2,4,3,7,4,2013-06-27 22:25:31,2013-06-27 22:25:31
de1a5a75cc5ae9d1084885d810d5715ee900f16d...f5d08fc49c48cda7fdce613a1cef57ed2b105abd,2,8,1,9,2,2013-06-22 00:01:01,2013-06-22 00:01:01
f5d08fc49c48cda7fdce613a1cef57ed2b105abd...d9d2540162a79e08d9bc84b16b6e9a91ea91d56e,1,2,2,4,1,2013-06-22 00:09:49,2013-06-22 00:09:49
b0f12bd5e8381e207bac148f161ced4a04218361...ecd1fff9b001a0379d06d0d115da5106c66056e7,1,1,1,2,1,2013-06-22 02:22:14,2013-06-22 02:22:14
145c622aba863ba64aa405c21cd21386189846b7...25d1bc2c09e3f6e7973d6b159e49ae7f8bd7670d,1,2,1,3,1,2013-06-25 01:27:57,2013-06-24 19:12:06
25d1bc2c09e3f6e7973d6b159e49ae7f8bd7670d...a749fb21309b147a1bb9da0838f591ba58f6d169,3,98,75,173,61,2013-06-25 01:27:57,2013-06-24 21:15:52
a749fb21309b147a1bb9da0838f591ba58f6d169...672d3a6c6cd0494a0b8eaa13674c3cb87cba029c,2,11,16,27,11,2013-06-25 01:27:57,2013-06-24 21:52:02
672d3a6c6cd0494a0b8eaa13674c3cb87cba029c...873a5aa8e72102a31f34c62603a3f5976471e94a,2,55,15,70,19,2013-06-25 01:29:08,2013-06-24 21:59:37
873a5aa8e72102a31f34c62603a3f5976471e94a...5190f7f33a9e36f1f5991a385f4db198e9f1b3a6,5,96,62,158,32,2013-06-25 01:36:04,2013-06-25 01:22:02
5190f7f33a9e36f1f5991a385f4db198e9f1b3a6...6127d757a7495df83b3d4cec53dc56b48c764023,1,10,10,20,10,2013-06-25 17:39:11,2013-06-25 17:39:11
145c622aba863ba64aa405c21cd21386189846b7...cc63c1b584a06a41482bf967908bab10853799f6,3,18,9,27,7,2013-06-24 22:01:51,2013-06-24 22:01:51
894eff64b499b2df5d7eadca55f2ea2feee7c380...cd289cc10ccefea72206a6f262e978c346c6679a,1,2,2,4,1,2013-09-14 00:22:53,2013-09-14 00:22:53
348c5c4838f552118afda29cbef159a63031ea6b...b6f288a1cedbbff7dd24362f2fc2bce0040bfe10,3,49,21,70,15,2013-07-01 18:45:45,2013-07-01 18:45:45
348c5c4838f552118afda29cbef159a63031ea6b...aa9bec96b1d3aedcb67e6985ae5754e728665407,1,3,0,3,1,2013-07-01 18:28:40,2013-07-01 18:28:40
348c5c4838f552118afda29cbef159a63031ea6b...b16ff9f8598d30823f687d100d351cad11823e77,8,90,4,94,15,2013-07-01 14:34:27,2013-06-25 02:20:05
9232d1ef62b6be8979052599625af8a71227662c...a8a6848ce0c3c54d00cfcd85727546e54a4dcf7e,1,4,4,8,2,2013-07-12 11:54:53,2013-07-12 11:54:53
79ee8b46f449aaa0770e16be6af5e1ea8b77a1cc...96a1d7c6455b5b4326469f9a51bee869883aac3c,2,6,1,7,2,2013-07-01 23:58:25,2013-07-01 23:57:58
96a1d7c6455b5b4326469f9a51bee869883aac3c...fe0378e9b36b89d5eb01b4c2bf8c160305a958a7,1,2,2,4,1,2013-07-02 00:05:49,2013-07-02 00:05:49
fd97190ee752c8de38be38a03f3cfdd4b4ce1460...08a87d4b3b3f76ac9d73309b1042aa75d6634ed9,2,17,10,27,6,2013-07-08 20:42:17,2013-07-08 20:30:03
fd97190ee752c8de38be38a03f3cfdd4b4ce1460...3a20e4e15d27ab0061e5ffb427baf7162de9add9,1,3,0,3,1,2013-07-08 18:19:12,2013-07-08 18:19:12
84f41954ae1b7aa5d21d2b27b119ad0b4b985627...b7226316c716daf7648b2dc4de829f866a4377b5,1,1,1,2,1,2013-06-29 02:43:55,2013-06-29 02:43:55
893c974b08b8859a4d6d3d7d38d9c21c9b6472c3...ac37fcf6f3f28f56b4ad58143891be9b1fe99dec,1,1,1,2,1,2013-06-28 19:36:59,2013-06-28 19:36:59
ada0e1fb0817d2e609b46c260ef6ab0cfa510379...91520838fc72f4004d65844b8e57df85473808a1,1,1,0,1,1,2013-07-09 17:48:33,2013-07-09 17:48:33
8e6c249e485a8cce37dbfb6b897730bca8bbdca8...a6e5a397bd6b7967a91f1d7cbe581e46211964da,1,2,2,4,2,2013-07-12 18:08:45,2013-07-12 18:08:45
a6e5a397bd6b7967a91f1d7cbe581e46211964da...bac5772312d1fe733511febd117e9f29ff19c698,2,5,5,10,5,2013-07-12 18:15:25,2013-07-12 18:15:25
8e6c249e485a8cce37dbfb6b897730bca8bbdca8...4174e7aa7a6600a2cfedd1c568000556cf1daf79,1,3,3,6,3,2013-07-12 17:55:26,2013-07-12 17:55:26
4174e7aa7a6600a2cfedd1c568000556cf1daf79...364f48d6c7386874ee3fa0696b7a466f76fcf698,1,2,2,4,2,2013-07-12 18:05:26,2013-07-12 18:05:26
364f48d6c7386874ee3fa0696b7a466f76fcf698...d0e8ca1257f7f969a035d3d78b55e08c067e8a20,1,6,6,12,5,2013-07-17 17:46:11,2013-07-17 17:46:11
8e6c249e485a8cce37dbfb6b897730bca8bbdca8...eb38750d99d4f9706cb2abcb861c84e1d309bd40,2,23,5,28,5,2013-07-12 17:49:47,2013-07-01 23:48:59
eb38750d99d4f9706cb2abcb861c84e1d309bd40...e41507bde2d87cb9bbb0c328e414a39354dae10e,2,20,0,20,2,2013-07-15 17:05:09,2013-07-02 00:08:42
8e6c249e485a8cce37dbfb6b897730bca8bbdca8...cd0fef633c5d871b192146e405ca7c5bebb2f3ba,1,3,1,4,1,2013-07-12 17:42:54,2013-07-12 17:42:54
ecd1fff9b001a0379d06d0d115da5106c66056e7...290b1973a90e39f2b7f751f038633b9e6e4a1694,2,8,4,12,2,2013-06-22 19:29:42,2013-06-22 19:29:42
290b1973a90e39f2b7f751f038633b9e6e4a1694...f9acd605dcd48037d61c4f5cd114bca41e147b9e,1,24,0,24,1,2013-06-22 20:33:43,2013-06-22 20:17:52
ecd1fff9b001a0379d06d0d115da5106c66056e7...d7d42ff4feab59ca6566addc20926a27aeaba8ef,1,2,2,4,2,2013-06-22 15:53:10,2013-06-22 15:53:10
ecd1fff9b001a0379d06d0d115da5106c66056e7...ce9e50f4eeed9ec9d715d805ae6706ed6f28da3b,1,3,5,8,3,2013-06-22 02:40:42,2013-06-22 02:40:42
1c5083315d1fbee703854bfa336f4aa1b42e5014...e5e47c98629f9e81ea24d2784e04863d614d34f5,1,0,3,3,1,2013-07-02 17:13:37,2013-07-02 17:13:37
ec1dfc521ce9aa78f7635932708c798f87aa9374...d03edf12e4ad67f0900434af5c8d36688b6cc2a4,1,2,0,2,1,2013-06-25 12:26:41,2013-06-25 12:26:41
ead9cefadbd19a4a855507bc482ef2464dd8c143...cb1fdb2f0380e43f38f3b37562edc83122c8349f,7,42,231,273,23,2013-07-01 23:37:13,2013-06-28 22:17:06
cb1fdb2f0380e43f38f3b37562edc83122c8349f...adf75d402ab428a16ac3d57d0154ddd02be2fb6b,7,284,0,284,5,2013-07-01 23:37:13,2013-06-28 22:30:22
adf75d402ab428a16ac3d57d0154ddd02be2fb6b...b47873c5accd33964c33f718ceeda955d1a9a3c8,12,491,287,778,61,2013-07-01 23:37:13,2013-07-01 23:32:58
ead9cefadbd19a4a855507bc482ef2464dd8c143...6dacbb451f1134ca1c215bd86b74006934468922,1,7,2,9,2,2013-07-01 22:06:08,2013-07-01 22:06:08
96bc9ea7c113127673e6e47a0366311e1edb8f1a...dd1b9e38e95dc719a7aeadbdee67a5f3a4873dec,2,15,15,30,15,2013-07-03 21:35:18,2013-07-02 21:47:43
dd1b9e38e95dc719a7aeadbdee67a5f3a4873dec...e93afcdd2bd9578f98508aaad11b695dae29726e,1,1,2,3,2,2013-07-03 21:35:18,2013-07-02 21:47:58
e93afcdd2bd9578f98508aaad11b695dae29726e...da3962266a4103f2dbf019180585d206fb9e25ff,1,1,1,2,1,2013-07-03 21:35:18,2013-07-02 21:48:11
da3962266a4103f2dbf019180585d206fb9e25ff...27ee261e6048c6fa0334bcce2116610dcd04aaed,1,2,3,5,2,2013-07-03 21:35:18,2013-07-02 21:55:20
27ee261e6048c6fa0334bcce2116610dcd04aaed...19121c16d9514b391ce8f15aeff3c47c1ea5a841,10,48,48,96,45,2013-07-03 21:36:04,2013-07-02 22:27:22
6f23e39e6b5dfa38b2263422371a5ed1cc8e4315...f03c1b8eeb367beefa91046e2fa114af9a816aaa,3,19,10,29,9,2013-07-02 00:24:21,2013-07-02 00:19:39
90f372af5c30fdefb7b579b5dc2f1ab743499909...3e8626c4a171653971aebcb778087c89c6c7ab67,2,17,17,34,4,2013-07-09 00:20:41,2013-07-09 00:20:41
3e8626c4a171653971aebcb778087c89c6c7ab67...e7d36c9590bfdc2e57cbbecce87729f51ac3b35f,1,0,3,3,1,2013-07-09 00:22:41,2013-07-09 00:22:41
e7d36c9590bfdc2e57cbbecce87729f51ac3b35f...31c66d5a00ee693a31902d1f75777dc9507c1416,1,34,39,73,29,2013-07-09 00:26:50,2013-07-09 00:26:50
31c66d5a00ee693a31902d1f75777dc9507c1416...3be7bc38e034c94da7cd6da5f2e5ecffd1832d6b,1,1,1,2,1,2013-07-09 00:42:18,2013-07-09 00:42:18
3be7bc38e034c94da7cd6da5f2e5ecffd1832d6b...019324015b0c64733ae4f39708aa49a08134cb48,3,16,16,32,4,2013-07-09 15:06:10,2013-07-09 15:06:10
019324015b0c64733ae4f39708aa49a08134cb48...33d97e81ebc4d25ecc7366aeef625e51aa69478c,1,0,3,3,1,2013-07-09 15:10:43,2013-07-09 15:10:43
33d97e81ebc4d25ecc7366aeef625e51aa69478c...f44eac49fae1b33e6ff4c6f42c5e7305caf22252,2,17,2,19,6,2013-07-09 18:30:12,2013-07-09 18:30:12
90f372af5c30fdefb7b579b5dc2f1ab743499909...e43ef364cb99585d3285f51f7ab308f8a77fe09e,3,14,80,94,7,2013-07-08 22:23:04,2013-07-08 22:23:04
b7226316c716daf7648b2dc4de829f866a4377b5...ca497a82abfe92f2dbe1a7e161dc7ff19eefeec4,2,13,1,14,2,2013-06-30 04:12:29,2013-06-29 00:51:14
ca497a82abfe92f2dbe1a7e161dc7ff19eefeec4...273e0d42b7bd56f263d4d2d95fb27a692b875377,1,6,5,11,6,2013-06-30 04:22:15,2013-06-30 04:22:15
2cbf2200ac7ba7e3ae79ed8a85a3cfcdf1026efd...c7a48e91d8d31a8b80b46f4cb17d866e36147ddc,1,3,0,3,1,2013-07-12 22:06:12,2013-07-12 22:06:02
9b57f9187b84c5cdb92cb50271988aa4c51e8b95...75a0052e64d0b9cc214cd58ba798863c69f6c5d3,1,18,4,22,5,2013-07-15 19:13:51,2013-07-15 19:13:20
9b57f9187b84c5cdb92cb50271988aa4c51e8b95...193a7e1dc1945bc9988b6205c63db9d2e0578c55,2,98,1,99,8,2013-07-15 13:12:33,2013-07-15 13:12:33
9b57f9187b84c5cdb92cb50271988aa4c51e8b95...24dd50490a027f01ea086eb90663d53348fa770e,1,1,3,4,1,2013-07-15 10:40:35,2013-07-15 10:36:05
24dd50490a027f01ea086eb90663d53348fa770e...0900d3b7a6e94bfa42e3d4ac6dc6f5542f65a9b0,1,3,2,5,1,2013-07-15 10:41:19,2013-07-15 10:41:19
9b57f9187b84c5cdb92cb50271988aa4c51e8b95...5ae8c7a98592f83a31f3f45fc22728e45e95626c,2,57,0,57,2,2013-07-15 03:23:20,2013-07-15 03:23:20
f310b875f8972870e87e4395b5dbd8613b66fa39...9cf2b41c053d557af6c563311b4953c4b9bab6d6,1,1,1,2,1,2013-07-17 19:24:54,2013-07-17 19:24:54
f9acd605dcd48037d61c4f5cd114bca41e147b9e...9fe8bfb2bc4b00a69db16e04e45c065090d1af2d,2,4,1,5,2,2013-06-22 20:36:45,2013-06-22 20:36:45
c9e1c65c640a1ad951586fe8e41f9f1658244f04...66a9d06d9fa7a382c6852cf047e1448e0d3e1782,6,150,177,327,66,2013-07-05 19:20:58,2013-07-05 19:20:58
c9e1c65c640a1ad951586fe8e41f9f1658244f04...1cf9c80e976fb60b4d5d489cd1c4c9959bcc4f7f,8,30,49,79,32,2013-07-02 22:53:08,2013-07-02 22:46:32
c9e1c65c640a1ad951586fe8e41f9f1658244f04...9632cf09bfd7b4a8513799bf19070ecabd55c446,2,2,2,4,2,2013-07-02 22:11:03,2013-07-02 22:07:02
c9e1c65c640a1ad951586fe8e41f9f1658244f04...ff964d327d030221b4e65661cee0ee0826bcdb32,21,863,501,1364,80,2013-07-02 22:03:29,2013-06-28 22:17:06
c9e1c65c640a1ad951586fe8e41f9f1658244f04...d399f720983d94706bdaae528a2637778ca5b5e0,7,42,231,273,23,2013-07-02 19:09:57,2013-06-28 22:17:06
d399f720983d94706bdaae528a2637778ca5b5e0...b461e4607de497096b0ec92bb05d5a88bfe0e48d,7,284,0,284,5,2013-07-02 19:09:57,2013-06-28 22:30:22
b461e4607de497096b0ec92bb05d5a88bfe0e48d...6058261a26b9e23926612fddfd8ad37bfcf1dd9c,12,491,287,778,61,2013-07-02 19:09:57,2013-07-01 23:32:58
6058261a26b9e23926612fddfd8ad37bfcf1dd9c...dd4c6f6a09c98f075fc5964242792d9e9f2c20d4,1,82,19,101,9,2013-07-02 19:09:57,2013-07-02 19:07:09
2f24b9e05c88941d4bcb41c67a7f4ca3ab02a839...5a01f7485c6df95f747e08d2cad3d4c934b811bc,1,2,0,2,2,2013-09-16 17:53:24,2013-09-16 17:53:24
2f24b9e05c88941d4bcb41c67a7f4ca3ab02a839...40eaa82fc617a474b1325ac22bd1299d3c0e3d48,1,2,2,4,2,2013-09-16 15:58:44,2013-09-16 15:58:44
2f24b9e05c88941d4bcb41c67a7f4ca3ab02a839...9946981c61c5eeafc1a15930e064bce8b7032a71,1,2,1,3,1,2013-09-16 04:50:53,2013-09-16 04:50:53
2f24b9e05c88941d4bcb41c67a7f4ca3ab02a839...d6cf41cbe62ffaf2ed5bedf107d8bc4f804d3658,2,4,1,5,3,2013-09-16 04:45:01,2013-09-16 04:45:01
2f24b9e05c88941d4bcb41c67a7f4ca3ab02a839...c6b40761255c881b8851ac096d5cc59b0c6be729,1,6,4,10,2,2013-09-16 01:40:29,2013-09-16 01:40:29
2f24b9e05c88941d4bcb41c67a7f4ca3ab02a839...b79bd4e864d53e927a9480374646d5e94d12141c,2,98,15,113,6,2013-09-14 20:09:15,2013-09-14 20:09:15
55b5889a0fa74db30e6a07f84b02e22ea41c3e19...4b8688f1e5a5998e10bdc1d7b39458a611a25eef,1,4,4,8,1,2013-07-02 21:10:06,2013-07-02 21:10:06
bcb5e36dd9ed3054c5efad0aa9a9904dcd497338...ab3893ff4d202549bf79e5671cc9e6f18376cbfd,1,11,12,23,7,2013-07-05 03:28:54,2013-07-05 03:28:54
bcb5e36dd9ed3054c5efad0aa9a9904dcd497338...1277dca3358874d0701685f7ebb52ce66be1b385,4,13,13,26,13,2013-07-04 21:33:17,2013-07-04 21:28:49
bcb5e36dd9ed3054c5efad0aa9a9904dcd497338...ba9aef6f2c529ccea571deacc46d2a61ca74a8bc,1,1,1,2,1,2013-07-04 19:40:14,2013-07-04 19:40:14
bcb5e36dd9ed3054c5efad0aa9a9904dcd497338...dd619d2bd6a3cf621106f2599fbf3bc903b5801a,1,1,1,2,1,2013-07-04 16:58:50,2013-07-04 16:58:50
bcb5e36dd9ed3054c5efad0aa9a9904dcd497338...1e2ef274cdaa76e79435df52cdc196739ba8b3b1,2,2,3,5,3,2013-07-04 08:50:37,2013-07-04 08:50:37
c9236d99d2c98c6b72fa97f25d958a90faf6873c...ebba0a60245b487e6d3d242f47c8999321ec5d29,3,11,8,19,7,2013-07-02 10:47:37,2013-07-02 10:47:37
837be914ca96c1f03d835a7b834693be16ce7043...59b785a2820e9ff07ce2a71c83eef8b6ccc467cc,1,3,1,4,1,2013-07-09 23:45:32,2013-07-09 23:45:32
59b785a2820e9ff07ce2a71c83eef8b6ccc467cc...e8db0311120d5e9a545fde5862f8a16b07760697,1,4,4,8,2,2013-07-09 23:46:25,2013-07-09 23:46:25
e8db0311120d5e9a545fde5862f8a16b07760697...316c8328aab8f9d518574b4bef9e537fed4185f6,1,7,1,8,2,2013-07-09 23:46:55,2013-07-09 23:46:55
e14dd4d33e2bbdb54f2bac31eb8eae155f9b656a...9f1fc40a64fd6863dec5298099041493fee87db5,1,30,0,30,1,2013-07-09 04:30:29,2013-06-22 02:42:17
0acdef45499a5e51dbc56b34090e395af8820fa7...a839b36e55da231874b312ee184c9d8164460bdc,1,29,30,59,18,2013-07-09 23:48:16,2013-07-09 23:48:16
0acdef45499a5e51dbc56b34090e395af8820fa7...1a1daca621233b4588c079e35851d0e542282124,1,2,2,4,2,2013-07-09 18:52:33,2013-06-12 23:39:49
1a1daca621233b4588c079e35851d0e542282124...fac0d87d00ada08309ea3b82cae69beeef637c89,6,784,149,933,49,2013-07-10 00:42:35,2013-06-11 22:46:23
d67d5dd96307f3c6f393b0d6acd73a30e48caa3c...b37f7d49d8af31e52e5105898dcd799c9eae4c98,1,119,0,119,1,2013-06-30 05:08:25,2013-06-30 05:08:25
608fb2a21e948018bd5c75e56f5555123fda9bc7...eefbadd230d2788b0bdf0daac38ada0d145e3861,4,39,20,59,20,2013-07-16 00:51:32,2013-07-16 00:18:11
eefbadd230d2788b0bdf0daac38ada0d145e3861...18e91d5f85a008ef48d724db964330ddaa1bbf10,1,1,2,3,2,2013-07-16 17:14:21,2013-07-16 17:14:21
608fb2a21e948018bd5c75e56f5555123fda9bc7...bc21b3ebf0dadc51e47d971217d132e5299831a0,2,12,1,13,2,2013-07-15 21:57:52,2013-07-15 21:55:51
bc21b3ebf0dadc51e47d971217d132e5299831a0...8af945f353379a96eb036d67fb24d489c5e16808,1,11,9,20,1,2013-07-17 18:39:38,2013-07-17 18:39:38
8af945f353379a96eb036d67fb24d489c5e16808...ac14c463d55494fdab88d36ea74a4ecef8ab48dc,1,1,1,2,1,2013-07-17 18:51:26,2013-07-17 18:51:26
ac14c463d55494fdab88d36ea74a4ecef8ab48dc...b083418257edbcb769dd1bf9a6a3dafd334d5969,1,2,2,4,1,2013-07-18 16:25:14,2013-07-18 16:24:12
5756ba9bc48ef428bd73b9b123807097c1519db0...599f85d4e4362f24dc2850c71a689671122c456b,4,40,44,84,18,2013-07-15 16:17:58,2013-07-15 16:17:58
599f85d4e4362f24dc2850c71a689671122c456b...a926cd4d880904258e01ea521ecd9e1b908f2b97,1,32,13,45,2,2013-07-18 13:25:47,2013-07-18 13:25:47
a926cd4d880904258e01ea521ecd9e1b908f2b97...1b0fd7ead33722d8782634d54cbd797f284aa085,2,2,4,6,2,2013-07-18 13:29:40,2013-07-18 13:29:40
f9e4ef5eb0f48da1c562865017c183b57737985c...1004d57b85fc3714b089da4c457228690f254504,1,9,6,15,3,2013-07-16 00:58:23,2013-07-16 00:56:18
7d68afb2d28b59757b953446c1c6a0df3c2174ec...9ba998312de5826f24f693c8518ecda700135b4b,1,2,2,4,2,2013-07-30 05:39:29,2013-07-30 05:39:29
c8efd0838430aeeaef15bfd5ef62aecee4cdc603...92cbb7cc80a63299b5670a9fcbb2d11789200696,2,70,24,94,5,2013-07-15 20:59:11,2013-07-15 00:26:57
de563a3ea372432acb39e711eeb0b43296754c39...e7f3f6fa5a10f890a1774a2320d31e236af56be9,1,79,21,100,7,2013-07-18 14:37:28,2013-07-09 02:06:06
193888a2b4ad1e57593c530fa8381c38e7f42742...e3dbe2f2ba56c2dc482f8fbdd0db0556bbc253c9,1,1,1,2,1,2013-06-23 02:58:33,2013-06-09 06:39:38
be49f0a1182164d0d279484ec35931c1e3ef6d3c...cfc7684b7de542cfed9d8b90b654fe59c8aa4098,1,8,8,16,5,2013-07-05 19:37:07,2013-07-05 19:37:07
cfc7684b7de542cfed9d8b90b654fe59c8aa4098...57a6c83547ba4671940c3134a3f68586db603048,1,19,15,34,7,2013-07-05 21:30:43,2013-07-05 21:30:43
57a6c83547ba4671940c3134a3f68586db603048...4c174e0bfb4c6e6333f39fff3c70058eaed37e3a,1,1,1,2,1,2013-07-05 21:55:48,2013-07-05 21:55:48
4c174e0bfb4c6e6333f39fff3c70058eaed37e3a...283ebf3ff92ef552ae9cdf23a17c1a375dac99bd,1,1,1,2,1,2013-07-05 21:56:56,2013-07-05 21:56:56
283ebf3ff92ef552ae9cdf23a17c1a375dac99bd...d3125d8570de0f9c09de94c657f7e35755accdef,1,3,7,10,1,2013-07-05 22:26:08,2013-07-05 22:26:08
6dbcdd3ed5ae87dcb175431a1ad3e6c989ada2a5...11998ae7d62ee17856ead81ce49409dc63643d62,2,10,5,15,4,2013-07-02 23:48:57,2013-07-02 23:48:57
5dcd11be16f732f68199b9ee96ce76190b64a9aa...64450ae3f89b8f9b5288224c5a7d109a166cf22a,2,31,0,31,2,2013-07-03 17:11:00,2013-07-03 17:11:00
85f3ec88a62e4fd4e486402abc23bfad4ccd3c17...593566438d16f3d666507218086d6c0aba78bb3e,1,1,1,2,1,2013-09-17 18:49:47,2013-09-17 18:49:47
986906cd7ba9dc1a66fff14287dca305d0a865a8...67453d6b481200ad487b87d5620ce93602939341,2,56,23,79,19,2013-09-18 02:01:11,2013-09-18 02:01:11
986906cd7ba9dc1a66fff14287dca305d0a865a8...2183644578c886e054a81c32b40720eafc2ce2b9,1,7,0,7,1,2013-09-16 23:44:54,2013-09-16 23:44:54
986906cd7ba9dc1a66fff14287dca305d0a865a8...e836b0064bc18300ca9213c749f464e52ca9d001,1,3,3,6,2,2013-09-16 23:18:25,2013-09-16 23:18:25
986906cd7ba9dc1a66fff14287dca305d0a865a8...796d7a49f04de73c349d2a09f57922bc30961283,1,28,12,40,1,2013-09-12 20:26:31,2013-09-12 20:26:31
a81393787f0c74426e48c358a8d295d7b87582c8...e37bb506286e7c3dfe29d7d237fa8b5c2304eabb,1,1,1,2,1,2013-09-21 03:22:51,2013-09-21 03:22:51
a81393787f0c74426e48c358a8d295d7b87582c8...5bd0437eedf8036b9648dd095b22d0772fa47e4d,3,10,5,15,5,2013-09-20 12:46:24,2013-09-20 12:46:24
5bd0437eedf8036b9648dd095b22d0772fa47e4d...1328be7c299417aa8c8740ac4901a978724afa9b,1,23,0,23,1,2013-10-03 15:21:14,2013-10-03 14:46:07
1328be7c299417aa8c8740ac4901a978724afa9b...f84dc1e90858924f9fafe89e81005842a6b4f166,1,4,1,5,1,2013-10-03 22:33:00,2013-10-03 22:33:00
a81393787f0c74426e48c358a8d295d7b87582c8...5867f9e7614e5761fdee1f5b6a607ef4f8311d7f,2,13,3,16,4,2013-09-20 03:25:00,2013-09-20 03:25:00
68074fce68ebd3f0e6e7c648ddf72dcc96960096...5c9213258a7537e9baf4eb343bdd03fe29e085f4,1,1,1,2,1,2013-09-19 19:14:39,2013-09-19 19:14:39
35e87ee5717fd042d9cd81ca113f2b27fcaf03f4...f7fed2ea5f811719bd8bd2e6111838ad50a53194,4,45,8,53,10,2013-07-05 04:43:46,2013-07-05 04:43:46
8a8109648a7b99acf6aff9336a39150f2c6e05a4...4e0cdc016a5eb7227d4b8d7daffba7335fcbe749,1,1,1,2,1,2013-07-05 17:47:00,2013-07-05 17:47:00
6940cf1ecd982e5087d614193e1e655383721c44...8eeff01939e3b9f09e5233f6cde60e1c10af0a63,1,67,0,67,6,2013-07-06 00:05:02,2013-07-05 17:55:15
8eeff01939e3b9f09e5233f6cde60e1c10af0a63...166eba3e28cc440e06e97ed1bda5b1c3881d46da,1,73,68,141,11,2013-07-13 15:00:40,2013-07-13 14:59:07
166eba3e28cc440e06e97ed1bda5b1c3881d46da...507cef8bcea5b56d25d34ca7073c46f608962f19,1,0,1,1,1,2013-07-13 15:03:04,2013-07-13 15:03:04
507cef8bcea5b56d25d34ca7073c46f608962f19...a3b1a9f01a1c08c63e6c37945414481176817ba6,1,0,8,8,1,2013-07-13 15:04:04,2013-07-13 15:04:04
a3b1a9f01a1c08c63e6c37945414481176817ba6...d639f61ec1c80f8d8d65386ec9331dbb6e218cb0,1,1,1,2,1,2013-07-13 17:19:38,2013-07-13 17:19:38
8f9dd861467613a081c4584eafadc60acbb7890f...7cc294e777f8151061efa4a9da5f59d2f992473b,1,6,1,7,2,2013-07-02 16:25:06,2013-07-02 16:25:06
8f9dd861467613a081c4584eafadc60acbb7890f...06b53e3fc7aca2b3dae32edab08c7662d3e9e7e8,2,33,1,34,6,2013-07-02 12:19:25,2013-07-02 12:19:25
06b53e3fc7aca2b3dae32edab08c7662d3e9e7e8...27a137ccab5990721298cf58aee588ca9b4200ff,1,1,1,2,1,2013-07-02 17:02:42,2013-07-02 17:02:42
27a137ccab5990721298cf58aee588ca9b4200ff...3042f11666a38ea6b1da206de372bf85463db945,2,5,10,15,6,2013-07-02 18:02:16,2013-07-02 18:02:16
e962e9edcf58609aa7f7b12640d27c76c3e43f10...d918c7d9de6a2949d4010ec08f08b0182d159fe7,1,5,5,10,3,2013-07-10 14:09:35,2013-07-10 14:09:35
7fba358ae2ba434bdd23da1bd46126ccdd23f749...05d7f85af9e5813ddb1c066e44c802dc33790547,2,2,2,4,2,2013-07-09 10:55:28,2013-07-09 10:55:28
3363cd5cd03ccc7d13517f5c3ec01017b26c0f5c...5a411fa38e49e5d79602f01fa9aaf058c12e5627,1,46,23,69,6,2013-07-11 01:25:53,2013-07-11 01:02:41
b37f7d49d8af31e52e5105898dcd799c9eae4c98...52cebe19e5323e03ef557102c3dc1fc734fcfd27,2,26,3,29,4,2013-07-01 08:15:56,2013-07-01 07:53:27
b37f7d49d8af31e52e5105898dcd799c9eae4c98...d8d33e8b8bee1f1d37c60b9618a9008058d7abe6,1,4,2,6,1,2013-06-30 17:46:09,2013-06-30 17:46:09
51f6c4a7372450d164c61e0054daf0223ddbd909...0089dd05e910852d5b821074c73287e730040630,1,1,1,2,1,2013-07-18 20:50:04,2013-07-18 20:50:04
0bd534adcf0933d19540506f790d00d8d1cb23d4...2e3b660dd0d49dc78f4c486e952ea6db9c007d6a,1,9,22,31,9,2013-07-19 13:56:36,2013-07-19 13:56:36
1004d57b85fc3714b089da4c457228690f254504...5a934fc923af316a6e82b9dd11169484b3b744f6,1,15,2,17,3,2013-07-17 15:48:53,2013-07-17 15:48:53
1004d57b85fc3714b089da4c457228690f254504...c766d064ac6c2183321cb2e47ea8c0b0b2d2d238,1,1,0,1,1,2013-07-17 08:05:11,2013-07-17 08:02:07
1004d57b85fc3714b089da4c457228690f254504...0356081c0ad2f1d95fb435f9a491f7a7a63cbf33,1,76,48,124,16,2013-07-17 00:04:41,2013-07-17 00:04:41
1004d57b85fc3714b089da4c457228690f254504...6e8bfc8d12ca062dc4c311d528784c1dec27079d,1,20,5,25,4,2013-07-16 20:45:43,2013-07-16 20:45:43
1004d57b85fc3714b089da4c457228690f254504...fb005a3da813ba855b6597c146b66842846df3d8,2,89,1,90,3,2013-07-16 14:38:18,2013-07-16 14:38:18
fb005a3da813ba855b6597c146b66842846df3d8...48a892bee5270feea3d0e7b64963acb38dbd634b,1,24,0,24,1,2013-07-16 15:58:23,2013-07-16 15:58:23
48a892bee5270feea3d0e7b64963acb38dbd634b...2db99441c85fdf1e7d468bc02b085d9e1b95704c,1,3,0,3,1,2013-07-17 20:39:36,2013-07-17 20:39:36
2db99441c85fdf1e7d468bc02b085d9e1b95704c...7c00201222e29989214b7e8a221b057daba0a27d,2,51,11,62,8,2013-07-17 20:51:25,2013-07-17 20:51:25
7c00201222e29989214b7e8a221b057daba0a27d...1a226f0e28e7da4eb3701b31dbe959142c42b752,2,12,4,16,3,2013-07-17 21:06:46,2013-07-17 21:06:46
d6fb313220c2275c4e76f6191905fb382e54a58d...64e74cefb746caa7f2a581149bbd523dd1ac9215,2,19,2,21,4,2013-07-19 13:03:45,2013-07-08 08:01:16
64e74cefb746caa7f2a581149bbd523dd1ac9215...221ee504aa06d06eb868898cca2fcc020a861e84,1,1,0,1,1,2013-07-19 13:03:45,2013-07-11 20:38:43
221ee504aa06d06eb868898cca2fcc020a861e84...2a3b91e3b66c48c6a26dbd673957a46c1afacbbe,1,10,0,10,1,2013-07-19 13:03:45,2013-07-11 21:50:03
2a3b91e3b66c48c6a26dbd673957a46c1afacbbe...25be79208a1473a65be883989ae49b7c71081a83,1,13,10,23,2,2013-07-19 13:03:45,2013-07-11 22:11:44
d6fb313220c2275c4e76f6191905fb382e54a58d...cfec1c3e1b88ceeca73144198df7a210ed3dc421,5,50,35,85,19,2013-07-19 10:06:32,2013-07-19 10:06:32
cfec1c3e1b88ceeca73144198df7a210ed3dc421...eb4a0271fbb7318a7d66911ccd388c048db0c2fa,3,1112,3,1115,6,2013-07-19 10:34:55,2013-07-19 10:34:55
d6fb313220c2275c4e76f6191905fb382e54a58d...a0eec14c7da5b213302c2675801aaf788e84efed,2,5,5,10,4,2013-07-19 02:47:35,2013-07-19 02:47:35
a0eec14c7da5b213302c2675801aaf788e84efed...2b5386f039b5c99cf0f64fb3091cc14e4446dc64,1,42,0,42,1,2013-07-19 03:01:39,2013-07-19 03:01:39
aee845682f2f1be0044c82ea25916a9ff6a67649...eca9f9c1a1e436167eb660ad700f3f9f5189bae4,1,2,2,4,1,2013-06-24 16:12:39,2013-06-24 16:12:39
07dc0a51205b5dcfa5525acf15e1d500f201fa12...e2b8ee2723a4cf6a37cdb455011ec447f23f8f49,1,1,1,2,1,2013-07-05 23:03:22,2013-07-05 23:03:22
c14450ae5ce936b9e6516001ffe90d03614692e6...28311f61be35bf92557542ae6ffb4aab11539720,1,16,9,25,8,2013-09-18 04:18:05,2013-09-17 09:29:13
28311f61be35bf92557542ae6ffb4aab11539720...5d364fda3cc4f947487d6782e585d1391782817b,1,21,6,27,6,2013-09-18 04:18:05,2013-09-17 11:02:57
5d364fda3cc4f947487d6782e585d1391782817b...76a07371c5ceda160f1491a4f6e060dda2f45242,1,1,1,2,1,2013-09-18 04:18:05,2013-09-17 11:05:55
76a07371c5ceda160f1491a4f6e060dda2f45242...4054f31471dbb97e3786120baaa863e3a05e7c1a,1,71,18,89,15,2013-09-18 04:18:05,2013-09-18 02:41:12
4054f31471dbb97e3786120baaa863e3a05e7c1a...b7e7104e9293c0fd35bdb03d7f0cd00e7a90d615,1,1,5,6,1,2013-09-19 23:49:20,2013-09-19 23:49:20
77ad95d3724cf4b2ae2371d34b7197af08c9ba8c...b45e280ee8161b38127b90e718945130bc1e935a,2,25,42,67,10,2013-09-20 03:35:05,2013-09-19 20:09:19
77ad95d3724cf4b2ae2371d34b7197af08c9ba8c...341addeccd2100611af27797b38421c5a0ab066f,1,7,7,14,4,2013-09-19 17:49:43,2013-09-19 17:49:43
77ad95d3724cf4b2ae2371d34b7197af08c9ba8c...a18c26392ff7f4a756f499bd5c3032f2256cd04e,1,1,1,2,1,2013-09-19 16:25:30,2013-09-18 04:53:27
a18c26392ff7f4a756f499bd5c3032f2256cd04e...47904290a563801b15eb204516f32c9517c11a47,9,124,125,249,89,2013-09-19 16:27:08,2013-09-18 06:20:05
2183644578c886e054a81c32b40720eafc2ce2b9...e594c788e4f42d4878c1b3d16139db0291ed830c,1,1,1,2,1,2013-10-03 22:42:35,2013-09-09 16:59:20
2183644578c886e054a81c32b40720eafc2ce2b9...a99a8386fdf71c5cc0f7757a5b4ef2747f0d1ea8,1,16,9,25,8,2013-09-17 09:29:13,2013-09-17 09:29:13
a99a8386fdf71c5cc0f7757a5b4ef2747f0d1ea8...089a60c2cfcd17287dc79c5c632eb4775003c3e4,1,21,6,27,6,2013-09-17 11:02:57,2013-09-17 11:02:57
089a60c2cfcd17287dc79c5c632eb4775003c3e4...5797e7e34e3366c9fe65e9d4743014a25910b197,1,1,1,2,1,2013-09-17 11:05:55,2013-09-17 11:05:55
5797e7e34e3366c9fe65e9d4743014a25910b197...70b731735c810d9e179837eb8761a44fbe98f391,1,71,18,89,15,2013-09-18 02:41:12,2013-09-18 02:41:12
2183644578c886e054a81c32b40720eafc2ce2b9...dfd0deefbb5325901608c85319dd357146d5370a,1,2,0,2,2,2013-09-17 06:00:54,2013-09-16 18:23:58
b2707dccc1e9dfe8cd8c27d962f9fb280f4f4705...ca5913ff3ec0648d6ad9887abc6cf986fddee1a2,2,20,1,21,2,2013-09-17 18:11:39,2013-09-17 18:11:39
d5f9160441eac56448dbf8418e2f178ea2bcdd06...823174de4d1acb93613c1b5ba53873906f43f62c,1,6,5,11,5,2013-10-09 13:47:49,2013-10-09 13:47:49
7e60a6b1ea946e942b6c592d0c4930fd01ae5bf4...2bd089dadb9a66829aa1835ad674d652244c5c97,3,129,9,138,13,2013-09-20 18:31:00,2013-09-20 18:31:00
2bd089dadb9a66829aa1835ad674d652244c5c97...e97364ecd73fac7abfbd82cc7e3ebaa6cda3c935,2,15,4,19,4,2013-09-20 20:36:19,2013-09-20 20:36:19
ab6379b3e0fb0a4de5e08a2f1dfd285c60452a51...dea29e7c999b7ef76a816867a2cb75c2da658fa2,2,15,5,20,5,2013-07-05 16:58:39,2013-07-05 16:58:39
43b346d93b7a2bba58628fafcc9391a3203cef91...eb9fef2c424178277cacd29d404cc8e774bb3891,4,40,0,40,4,2013-07-10 15:59:16,2013-07-04 02:33:30
eb9fef2c424178277cacd29d404cc8e774bb3891...1267e15b0f73f4c40b3a053f0bf02981881a2bdd,1,37,0,37,1,2013-07-10 15:59:16,2013-07-08 13:02:06
1267e15b0f73f4c40b3a053f0bf02981881a2bdd...40f1e4edbecc841bd02b3a63b303d522299562c0,1,2,3,5,3,2013-07-10 16:12:57,2013-07-10 16:03:07
8e49cb453f7ed8469d1a10c784f8f8250e049623...f83c31e18834d57ec56e1249b80174fbe0a0f8c9,1,4,1,5,2,2013-07-10 23:06:49,2013-07-10 23:00:35
8e49cb453f7ed8469d1a10c784f8f8250e049623...8f36467107d623e94638e2dd4c625e34f670384d,1,2,2,4,2,2013-07-10 23:05:14,2013-07-10 23:05:14
8e49cb453f7ed8469d1a10c784f8f8250e049623...1d01189f04f5187bd39e9212b7af3b3e83e86361,1,38,4,42,4,2013-07-10 22:49:01,2013-06-28 21:12:12
1d01189f04f5187bd39e9212b7af3b3e83e86361...1bb8f60d5ae3810b465dd3c79a7a572fb017d078,1,26,17,43,16,2013-07-10 22:49:01,2013-06-28 21:24:54
1bb8f60d5ae3810b465dd3c79a7a572fb017d078...65185a565b8e05a2dd58e10d1c1ad560f4a255cf,2,15,3,18,4,2013-07-10 22:53:38,2013-06-28 21:33:28
65185a565b8e05a2dd58e10d1c1ad560f4a255cf...5705a493080ba5571a7929d37e7926678a982cb4,2,30,15,45,5,2013-07-10 22:56:49,2013-06-28 21:42:04
5705a493080ba5571a7929d37e7926678a982cb4...d40efc4648af6bb5c60b37a789effd602af1f132,2,21,10,31,13,2013-07-10 22:56:49,2013-06-28 21:48:37
d40efc4648af6bb5c60b37a789effd602af1f132...26c8eae6fea53e9a78bd035614fff20086f00b17,1,1,3,4,1,2013-07-10 22:56:49,2013-06-28 22:45:45
26c8eae6fea53e9a78bd035614fff20086f00b17...e832b01349fec2acee6ec3219dc9bfb61ad38764,1,0,1,1,1,2013-07-10 22:56:49,2013-06-28 22:46:25
e832b01349fec2acee6ec3219dc9bfb61ad38764...34cf976866f66bc77b961f4e66a9dd8aad1ffb00,1,40,19,59,4,2013-07-10 22:59:43,2013-06-28 23:29:02
34cf976866f66bc77b961f4e66a9dd8aad1ffb00...73e79a3310f3976b61a295f45e12aead9af41962,1,5,3,8,1,2013-07-10 22:59:43,2013-07-01 21:57:56
73e79a3310f3976b61a295f45e12aead9af41962...cd209f406e889feaba50103e5ce50f7dcd23767a,2,17,0,17,4,2013-07-18 18:22:49,2013-07-18 18:22:49
cd209f406e889feaba50103e5ce50f7dcd23767a...ede1e6d4754f3cffeac72f5d760fe4d87c5ae570,3,25,25,50,18,2013-07-23 21:05:13,2013-07-23 21:05:13
ede1e6d4754f3cffeac72f5d760fe4d87c5ae570...1ae54707a0ee1f690a7dca17d83b5417e83704c3,1,4,4,8,4,2013-07-23 21:17:31,2013-07-23 21:17:31
8e49cb453f7ed8469d1a10c784f8f8250e049623...fc3a8e409d182ade45c697c244562e20beee9f9a,5,5,5,10,5,2013-07-10 22:44:31,2013-07-10 22:44:31
5a411fa38e49e5d79602f01fa9aaf058c12e5627...2ac11419806ce39c57d5caf6b41a66e5ddf45bc8,2,0,539,539,4,2013-07-12 00:58:45,2013-07-12 00:58:45
2ac11419806ce39c57d5caf6b41a66e5ddf45bc8...6bdb6f226b13d5fdd47f3665c9fb753207bf473b,7,67,163,230,41,2013-07-12 00:59:25,2013-07-12 00:59:25
5a411fa38e49e5d79602f01fa9aaf058c12e5627...affe7caf78288a638df3db37d5cebb4dc7f9ff72,1,4,2,6,1,2013-07-11 17:28:15,2013-07-11 17:27:19
affe7caf78288a638df3db37d5cebb4dc7f9ff72...976428f505b64a51efbd97f71acff5db2f4f5ed0,1,9,4,13,2,2013-07-11 19:04:23,2013-07-11 18:30:08
5a411fa38e49e5d79602f01fa9aaf058c12e5627...941e3e2ef09092306a7a287ce62b6fb518af9c56,3,53,23,76,17,2013-07-11 17:18:28,2013-07-11 17:18:28
5a411fa38e49e5d79602f01fa9aaf058c12e5627...b7937e268fcbc529a168164fc242edc56d51094c,1,9,8,17,8,2013-07-11 12:21:43,2013-07-11 12:21:43
f8dfd0aa5e03f3f8819dea6bb59800c90824008c...aa5671411b727d7142c289b5c1b473209aeaf630,1,94,66,160,30,2013-07-18 01:56:40,2013-07-18 01:56:40
f8dfd0aa5e03f3f8819dea6bb59800c90824008c...5d8efc107d2c7b7da61a6d22657190c6f13713d2,6,50,5,55,8,2013-07-18 00:13:34,2013-06-14 23:56:08
5d8efc107d2c7b7da61a6d22657190c6f13713d2...945033f1ccbc4896e1a784d00f1f2b465ed9e04b,1,1,1,2,1,2013-07-22 21:55:07,2013-07-22 21:55:07
0aa2470c768934875d9b0a765fc82813950b9ad4...54f9cdb0c30ef7d192c4ae59c669a7a5fd7d1003,10,73,30,103,25,2013-07-19 02:04:51,2013-07-19 02:04:51
066873ebd25728fe702fc4b13ed12b5c8be15b97...ced93bcabdc0dd0f6dcfa52174be552adf6c5bd1,1,4,1,5,1,2013-08-07 19:07:39,2013-08-07 19:07:39
c81662eae473e2b35e4e449be18cc6dfda07e4ec...513a5674831fd952fc8e7b8fbdbc4939393ecb5b,2,5,5,10,5,2013-07-26 10:04:46,2013-07-26 10:04:46
e39755666b2a3c0d9f9f20b727741bb78e903c1e...4714f102d72f03159acd0f7be71cde3d169c06b8,1,22,3,25,2,2013-07-22 19:06:24,2013-07-22 19:06:24
e2b8ee2723a4cf6a37cdb455011ec447f23f8f49...f64dbdbe3a147f58d04b6c39c6469fdd97427098,1,4,0,4,1,2013-07-08 23:04:39,2013-07-08 07:11:45
e2b8ee2723a4cf6a37cdb455011ec447f23f8f49...f3d29695608d9ea9a3f92bcf872c62e158106919,1,8,1,9,2,2013-07-08 07:11:45,2013-07-08 07:11:45
f3d29695608d9ea9a3f92bcf872c62e158106919...1d1d81b0bc52c6aff652f5515fd792f76e40f7c2,1,1,1,2,1,2013-07-08 07:18:47,2013-07-08 07:18:47
1d1d81b0bc52c6aff652f5515fd792f76e40f7c2...2b5553144a9249bbfed9be2a181b051a66350cb1,1,1,4,5,1,2013-07-08 23:03:18,2013-07-08 23:03:18
e2b8ee2723a4cf6a37cdb455011ec447f23f8f49...758ea61b77ab54403d2d3955b74b6c72cd96e2a5,1,9,9,18,7,2013-07-07 03:55:02,2013-07-07 03:55:02
e2b8ee2723a4cf6a37cdb455011ec447f23f8f49...4388bef996063b3b69e738082b6820d3a979921e,1,3,3,6,3,2013-07-05 23:49:55,2013-07-05 23:49:55
39ff542142e61dd9041925ad95fbac23be307414...0afed3eded0950b5899729714fb11d6a7322301e,1,1,1,2,1,2013-07-18 20:56:41,2013-07-18 20:56:41
f6a78f89ba489f062ef9425cb75dba29d2ce59fc...fee61895f2a2abc307839d7764d042604bd1e2d8,1,1,1,2,1,2013-09-18 19:06:29,2013-09-18 19:06:29
d70cbbf1fc33f2291a686537ba5b57913809e586...3cf4b2c7c1729635170dd92f83461c9662d126e4,1,0,7,7,2,2013-09-20 00:00:30,2013-09-20 00:00:30
8240e37b87b5af209053b5c95489378b9b78e4f6...181b9badddf3571da395509d152eb244d87b6883,3,15,22,37,6,2013-09-23 00:06:31,2013-09-23 00:06:31
081543c49a2326015334ac7bda200345a8f48e3f...c654075654840b8737dbf5e89ab4d7a303e893e5,1,88,19,107,18,2013-09-21 00:55:15,2013-09-20 01:00:23
c654075654840b8737dbf5e89ab4d7a303e893e5...b02a591f57f3b8944b0f7c6c004ba55a9938ddb8,1,1,1,2,1,2013-09-21 01:02:40,2013-09-19 20:41:51
b02a591f57f3b8944b0f7c6c004ba55a9938ddb8...a479f7659d0d9fb01fafdfb5f9e816ab1b522acd,1,7,7,14,4,2013-09-21 01:06:27,2013-09-19 20:41:29
081543c49a2326015334ac7bda200345a8f48e3f...cce6f00c0cc4439a943bad68498ddc4b6854b0d2,1,1,1,2,1,2013-09-20 23:31:57,2013-09-17 18:49:47
0ca533ca356872b29586e4f59b443c667709d7e8...fc659b68e4cd4f1a07a9fe37be4ebcb8e030a652,1,45,32,77,30,2013-10-16 18:35:45,2013-10-16 17:41:36
0ca533ca356872b29586e4f59b443c667709d7e8...f854529ae8c9e0139e9ca0466c597b133e3bf41e,1,7,0,7,1,2013-10-16 18:06:37,2013-10-16 18:06:37
0ca533ca356872b29586e4f59b443c667709d7e8...e32debcf5fb6bf056a871930a8a88d545653e96f,1,12,10,22,4,2013-10-16 17:58:53,2013-10-16 17:58:53
2fafe1efce32c7560151e036c43e0dddb7faaa14...cfbe76e5595b66e43447d6e1f3de40946af066f4,7,184,151,335,51,2013-09-23 16:59:04,2013-09-23 16:59:04
ad33e9f38866fa4f5c62d9974d96ee1b324ea5dc...a0f5fb7394e6d1bf96865b8ec20796e682b4505b,1,1,1,2,1,2013-07-08 12:45:50,2013-07-08 12:45:50
637eceb6a797df45b99f3ea929f7900e75e5fc97...71d2ff494694d7f18310c7994daa34dce33af98b,1,2,1,3,1,2013-07-12 00:31:07,2013-07-12 00:31:07
637eceb6a797df45b99f3ea929f7900e75e5fc97...474191dd7bca9eedaccb9de1771eecfce7dfebbb,5,26,3,29,10,2013-07-12 00:27:33,2013-07-12 00:12:25
474191dd7bca9eedaccb9de1771eecfce7dfebbb...49044a96089487b9df075fa972e83e4c05c7fae8,1,2,2,4,2,2013-07-12 00:37:26,2013-07-12 00:37:26
49044a96089487b9df075fa972e83e4c05c7fae8...1104d443cc49fd2a6b9c94a2c9724468f9860799,1,0,28,28,6,2013-07-12 00:52:08,2013-07-12 00:52:08
1104d443cc49fd2a6b9c94a2c9724468f9860799...d0c73c28df5627bc7158fd54860f6751b4dab0f9,1,1,0,1,1,2013-07-12 15:22:56,2013-07-12 15:22:56
5c49a6135370c0adc485409cda3b2147df6e6b3a...bf26ae03cfe38fc0fdd6f7dedd53041204df0767,1,1,0,1,1,2013-07-11 00:39:00,2013-07-11 00:39:00
f6e1055727877a255418513c4ffc3271bf214530...0e71e368a8a781f593b25fdd1318d3882e6d28e5,4,48,30,78,16,2013-07-24 15:41:34,2013-07-24 15:41:34
0e71e368a8a781f593b25fdd1318d3882e6d28e5...8742649aa7f3524bbfa99b68c8d87ffc5aba0af9,4,40,43,83,37,2013-07-24 17:10:59,2013-07-24 17:10:59
8742649aa7f3524bbfa99b68c8d87ffc5aba0af9...f1dd299227b15696872822f40a4ab9f1a54098a7,2,38,14,52,4,2013-07-25 14:16:36,2013-07-24 20:16:02
f1dd299227b15696872822f40a4ab9f1a54098a7...01e98bf0dd26a1de7fd280fd4b0f0a79aedd0cdd,2,5,3,8,4,2013-07-25 14:32:46,2013-07-25 14:32:46
6bdb6f226b13d5fdd47f3665c9fb753207bf473b...080243f0407a90cdacf128dc3b53a802549d7797,3,39,175,214,32,2013-07-13 00:56:55,2013-07-13 00:56:55
6e2e4cad735b24e913996f43b67c527713f98b67...921c6994b1ad41c940bdb08732225b8db74b68f2,3,15,4,19,4,2013-07-19 16:36:23,2013-07-19 16:36:23
6e2e4cad735b24e913996f43b67c527713f98b67...ea1258852493a83754553163db1db52a72ffb8fc,1,1,0,1,1,2013-07-19 15:56:00,2013-07-19 15:56:00
6e2e4cad735b24e913996f43b67c527713f98b67...e8ad82f9ba126414e1813fadfb17167a34afa8d4,1,1,1,2,1,2013-07-19 15:11:21,2013-07-19 15:11:21
23ea9b8968b5c79760e5dbe4e6e92e1e05fe7361...67f1e3f5ed4d3061e07e910e28ac866b7bb13e18,1,1,0,1,1,2013-07-19 17:22:16,2013-07-19 17:22:16
be77ee33bca2399b4eb6749253b9c3ab18915783...c804a5f827f31c5300f34ec4614a5067a0c17456,1,20,8,28,5,2013-08-08 14:56:37,2013-08-08 14:56:37
a7ace535c36905b85af3cc3f57beb910ed9efb32...7d0b8c726c0d178291063751ac735d6caebfb45a,1,34,0,34,2,2013-07-30 11:47:29,2013-07-30 11:47:29
16225c473f2c999ce3e9a13c4c8e02502a9a841c...3b89d13aaf76cd363d62955c050675ccd68a7296,2,20,1,21,2,2013-07-31 17:53:36,2013-07-31 17:53:36
e1fa989ec9a2355da2a87707f4909647b69831b3...46f59dd9333baa578b184eb25b386ac2f41caf04,6,24,15,39,13,2013-07-30 12:15:33,2013-07-30 12:09:07
5d1609f5a28745b112593ba18355b37285516b0c...ce43f4af1cf7c2692c4c6203bc5872053d089863,1,92,0,92,1,2013-07-23 01:32:55,2013-07-23 01:32:55
ce43f4af1cf7c2692c4c6203bc5872053d089863...5714f0a74ef6f6b0be521d7e1e21c1cab1a9ad73,1,1,2,3,1,2013-07-23 01:36:36,2013-07-23 01:36:36
5714f0a74ef6f6b0be521d7e1e21c1cab1a9ad73...6745bdd0b3a7944985614dae194538645eacb4e7,1,1,1,2,1,2013-07-23 01:39:58,2013-07-23 01:39:58
c21c5afe0077cc7a0ac52fb2e77a1c4aacc927ec...78c02d038f90b111f7f8ad306f9573c0f64b370c,1,211,92,303,39,2013-07-24 01:13:53,2013-07-24 01:13:53
99c27fa0ddf6db7eb8a1b9484ea6ad19c0b2e4f5...e4752c8c1a09fc3cc96dbb9be7183b271db3d6b7,1,3,0,3,1,2013-07-30 16:42:32,2013-07-30 16:39:35
c52c95f97fe3a596d3114be88d5593f6fb8dba34...3c5350ba922dd6611dab714db82cdd2d0210f5c5,1,1,1,2,1,2013-10-04 09:26:57,2013-10-04 09:26:57
c1bb33ea4d94d38b66f4e8582a584d12818d733a...aa3697520a916ce2de525e020d2afa0bbd102df2,1,2,0,2,1,2013-10-09 20:40:46,2013-10-09 20:40:46
2b92aa71f9f25a3e7d9d4bb0081d26e72af7a5f1...664acd29718ba367cdbad17ec7ee83d1fe01b7e4,1,234,222,456,45,2013-10-16 19:48:24,2013-10-16 19:01:55
664acd29718ba367cdbad17ec7ee83d1fe01b7e4...ed6ca109bf27fb2f1855332c47b7375fe4eaa8aa,1,209,213,422,44,2013-10-16 20:12:56,2013-10-16 20:12:56
ed6ca109bf27fb2f1855332c47b7375fe4eaa8aa...e40fd1e3e10198b9e2291b3383ed041743a73878,1,1,1,2,1,2013-10-16 21:39:03,2013-10-16 21:39:03
dc06496dc8449604e71b43cb2cd3b83daa2205d7...a4067b1b441fac478d2c745981c464390f73a357,1,1,0,1,1,2013-09-23 18:39:14,2013-09-23 18:39:14
dc06496dc8449604e71b43cb2cd3b83daa2205d7...b0a49a30c78e8cafecac455aa0a306ac1792a644,2,14,1,15,2,2013-09-23 18:29:11,2013-09-23 18:29:11
dc06496dc8449604e71b43cb2cd3b83daa2205d7...6097644e4b79fec180173d7278da884ac0484b8a,1,8,5,13,4,2013-09-23 18:29:08,2013-09-23 18:29:08
dc06496dc8449604e71b43cb2cd3b83daa2205d7...fd1c43f0e05133249ef441444a740b81db3b90ce,9,0,217,217,9,2013-09-23 18:26:03,2013-09-18 23:38:26
fd1c43f0e05133249ef441444a740b81db3b90ce...0ef5bcb17d77e575c808003856c7a6ed134b04f2,4,89,59,148,5,2013-09-23 18:26:04,2013-09-19 00:26:36
0ef5bcb17d77e575c808003856c7a6ed134b04f2...99377de7d2c48e25cb13928605c90ea40eab5b35,2,7,7,14,6,2013-09-23 18:26:04,2013-09-19 00:41:08
99377de7d2c48e25cb13928605c90ea40eab5b35...baff72bc82281b7fa545e0782722b9804240cf6e,1,1,1,2,1,2013-09-23 18:26:05,2013-09-19 00:43:12
baff72bc82281b7fa545e0782722b9804240cf6e...fa3837abf1fd796cf8142a62eaece8decfa2ec6b,1,12,0,12,2,2013-09-23 18:26:05,2013-09-19 00:45:56
fa3837abf1fd796cf8142a62eaece8decfa2ec6b...f6c64827c899b1fd737df0fcd018cc33dd9a91b9,1,2,1,3,1,2013-09-24 01:43:08,2013-09-24 01:43:08
fd5099c9fec49004f19d5a1200d0debfb9a365a7...f14db4934605235bd77e9d1dc22377ca710e4c7b,5,38,5,43,7,2013-08-13 23:18:32,2013-08-13 23:18:32
71d2ff494694d7f18310c7994daa34dce33af98b...44b3e8d51b655d68d0a253c48c027360ff8c3a97,1,4,4,8,2,2013-07-12 22:56:36,2013-06-28 16:06:00
71d2ff494694d7f18310c7994daa34dce33af98b...90483dc9123d6cb9eb1aa1bf4ba4e851d751784e,1,11,11,22,11,2013-07-12 01:41:19,2013-07-12 01:41:19
ca39f15fa3285e86660cc66d2c3e446e12c9ce86...6057e6ad70ba4550df358e89b9a7e1da61666604,4,11,1,12,5,2013-07-24 13:36:55,2013-07-24 13:35:38
e3be2e959bb4729d25e44cb25bf4e8bf733d8d89...6bbe66d2e6414a127f0f543c0138f1709bd3b8b4,1,3,0,3,3,2013-08-07 09:33:03,2013-08-07 09:33:03
6bbe66d2e6414a127f0f543c0138f1709bd3b8b4...416d0986886cd322ecae1114c13565bbc27b305c,1,3,3,6,3,2013-08-07 09:35:38,2013-08-07 09:35:38
e3be2e959bb4729d25e44cb25bf4e8bf733d8d89...8f6b6d57840410d1491321d7681ef2a946e90bc9,3,11,4,15,4,2013-07-25 07:36:32,2013-07-25 07:36:32
e3be2e959bb4729d25e44cb25bf4e8bf733d8d89...f236e62d9d288ac695129157d1753512f5cd2b0a,1,80,23,103,31,2013-07-22 06:32:01,2013-07-08 06:24:52
f236e62d9d288ac695129157d1753512f5cd2b0a...2b0ebf5d32c65276ce50fce168f32483ffb9c311,2,36,1,37,4,2013-07-22 06:32:06,2013-07-08 07:43:22
2b0ebf5d32c65276ce50fce168f32483ffb9c311...416fdaa3d5d7b84f7e36fdfcff7153e3a38262c9,1,12,12,24,12,2013-07-22 06:32:06,2013-07-08 08:14:01
416fdaa3d5d7b84f7e36fdfcff7153e3a38262c9...c383d598809daec6bccd60bd211c10f6a4ef60b0,1,8,0,8,1,2013-07-22 06:32:06,2013-07-08 08:29:13
e3be2e959bb4729d25e44cb25bf4e8bf733d8d89...3342bdb33184b83cac66921807c5403168d13f6b,4,93,37,130,10,2013-07-22 00:11:47,2013-07-22 00:11:47
3342bdb33184b83cac66921807c5403168d13f6b...49673fc45cc5cfc15219bf1eb6eaff7621696919,2,33,2,35,8,2013-07-22 00:49:09,2013-07-22 00:49:09
49673fc45cc5cfc15219bf1eb6eaff7621696919...964e826a9beb69a0246ed22c7935fd86df6712e1,1,1,1,2,1,2013-07-22 01:01:52,2013-07-22 01:01:52
964e826a9beb69a0246ed22c7935fd86df6712e1...bc172e5e5f1f231f878727a180a8da46e653c0a7,2,46,46,92,8,2013-07-23 02:00:35,2013-07-23 02:00:35
e3be2e959bb4729d25e44cb25bf4e8bf733d8d89...1d02a7ffb63915055f5fd9bda420bd08a8679da1,2,4,2,6,3,2013-07-21 23:00:18,2013-07-21 23:00:18
e3be2e959bb4729d25e44cb25bf4e8bf733d8d89...788935175e8500b451a844f6971ac62dd099bdfc,1,2,1,3,2,2013-07-21 22:30:51,2013-07-21 22:30:51
e3be2e959bb4729d25e44cb25bf4e8bf733d8d89...32663bf431b64d1169509bacba36e3c90e131b44,1,2,0,2,2,2013-07-21 01:27:55,2013-07-21 01:27:55
e3be2e959bb4729d25e44cb25bf4e8bf733d8d89...df86cb9a5c949530336b43100b303876f07c69ba,1,15,0,15,1,2013-07-20 10:47:13,2013-07-20 10:47:13
df86cb9a5c949530336b43100b303876f07c69ba...88cb9f3116e41b00b00fdccf6359a555e87061bd,1,0,1,1,1,2013-08-09 17:33:17,2013-08-09 17:33:17
88cb9f3116e41b00b00fdccf6359a555e87061bd...2ba5c915473ce6fe769fb059db4120e2a21fb42e,1,4,7,11,1,2013-08-09 20:23:27,2013-08-09 20:23:27
2ba5c915473ce6fe769fb059db4120e2a21fb42e...641ddaeb03f8b8eee5c1ca11e3024976378ceb6d,1,1,1,2,1,2013-08-09 20:27:34,2013-08-09 20:27:34
8ea9ccf3a7705020d939a186db43821bc4564992...5c1af383eb14121174b43fa706f524d4eedd5cad,1,1,0,1,1,2013-07-22 16:26:05,2013-07-22 16:26:05
c3027fa9ace7f607929af544dc1f59916f76f533...213365c2d27734bfbeeb1fc102fded7625550982,2,9,12,21,12,2013-08-08 22:51:39,2013-08-08 19:15:02
8a851af5e60ef5807aa5e6a984461b0e3cc6bd0e...f712e10cb21d0056593ea23152d347637396c810,2,52,0,52,2,2013-08-08 23:22:14,2013-08-06 16:58:52
f712e10cb21d0056593ea23152d347637396c810...5c56b597a9f6d910ee1f22da42f8b9e5d18c678a,1,2,2,4,1,2013-08-08 23:27:55,2013-08-07 00:24:10
5c56b597a9f6d910ee1f22da42f8b9e5d18c678a...df9712f1c8039f83497e3c647788dd697f034158,3,6,6,12,5,2013-08-09 00:16:43,2013-08-05 22:56:02
df9712f1c8039f83497e3c647788dd697f034158...e99a99eb6ee7257c0b11312bec33fe27cffdaaaa,2,6,1,7,2,2013-08-09 00:17:35,2013-08-09 00:17:35
bcd6ca368556c329063d58c32945753f783adc75...b14c251862021b2bc82aa8e0146e5e5e80f1c713,1,4,4,8,4,2013-07-30 13:13:18,2013-07-30 13:13:18
6745bdd0b3a7944985614dae194538645eacb4e7...58a1c5720a42fde72c27532ce1122609225bc3bb,6,16,21,37,13,2013-07-23 03:26:40,2013-07-23 03:26:40
cc0e091a6bf867d0eccd0c0de93ff759e465f657...b06f62713986681c7be5e9e0a59c3f717fe837cd,2,3,0,3,2,2013-07-24 21:48:16,2013-06-24 23:57:22
b06f62713986681c7be5e9e0a59c3f717fe837cd...a45490243b29f67f09854fdfe355a144d8c3346e,1,1,0,1,1,2013-07-24 21:48:16,2013-07-10 20:40:23
a45490243b29f67f09854fdfe355a144d8c3346e...844a9ab85e793517743beecdda651fa42d42a518,2,7,3,10,2,2013-07-24 21:48:16,2013-07-10 20:44:07
844a9ab85e793517743beecdda651fa42d42a518...c19fa83a8aa592d9716a883ac28ce1a20ce2bffb,1,2,2,4,1,2013-07-24 21:48:16,2013-07-12 16:28:06
c19fa83a8aa592d9716a883ac28ce1a20ce2bffb...0ac672fea6fc8e670be9dce18bd63d50689230ef,1,2,2,4,1,2013-07-24 21:48:16,2013-07-17 15:25:20
0ac672fea6fc8e670be9dce18bd63d50689230ef...d47df21a332db1c1d8efedfeb0e36934b09e7a88,8,264,0,264,8,2013-07-24 21:48:16,2013-07-18 17:22:07
d47df21a332db1c1d8efedfeb0e36934b09e7a88...3781a2cc4ba80373d1820c22555e82c42d92a787,2,5,2,7,2,2013-07-24 21:48:16,2013-07-19 17:52:23
3781a2cc4ba80373d1820c22555e82c42d92a787...7813f2a25e40018f9ad0a780df1c2e1d897666f5,1,4,4,8,1,2013-07-24 21:48:16,2013-07-19 18:05:17
7813f2a25e40018f9ad0a780df1c2e1d897666f5...362f1735e6b60b6fcc6d435b29586252029f15a8,3,22,15,37,11,2013-07-24 21:48:16,2013-07-24 14:47:50
362f1735e6b60b6fcc6d435b29586252029f15a8...77ff53769714d4b33555b8e412868aad2cc788f9,1,1,1,2,1,2013-07-24 21:48:16,2013-07-24 14:49:19
77ff53769714d4b33555b8e412868aad2cc788f9...94053b42252a1f70c16d2b72399904f79af0b688,2,57,2,59,10,2013-07-24 21:48:16,2013-07-24 21:47:44
94053b42252a1f70c16d2b72399904f79af0b688...12d575a6b1125d74168986ca39250c833ddbb033,2,8,5,13,4,2013-07-25 19:00:36,2013-07-25 19:00:36
12d575a6b1125d74168986ca39250c833ddbb033...65c8e9242cc73fd2f1ea949703cf7da34e8e9650,3,18,10,28,10,2013-08-06 19:08:27,2013-08-06 19:08:27
863eebe7bd7d5f9ac9f49619643078ea540154ff...b48fc9657976091ff3833d340877aa5b761e3969,1,6,6,12,2,2013-10-29 19:06:48,2013-10-29 19:06:48
863eebe7bd7d5f9ac9f49619643078ea540154ff...a665517151911866285e5a72164c5f2d2f31ba65,1,3,10,13,6,2013-10-06 19:55:26,2013-10-06 19:55:26
863eebe7bd7d5f9ac9f49619643078ea540154ff...821a82ac6ceffd7001b80769ba23b81a7e4a81ad,1,33,0,33,1,2013-10-04 21:27:26,2013-10-04 21:17:59
863eebe7bd7d5f9ac9f49619643078ea540154ff...0d3c899528f00f222080915e800388f5d2821861,1,103,0,103,1,2013-10-04 19:12:40,2013-10-04 19:12:40
648d759517b62ca751dc3506f7abce5e9fefc62d...74d54b9b2eec8f92d688b7d53e813ebe931e4114,1,8,5,13,4,2013-09-28 01:16:00,2013-09-23 18:29:08
414795856a623991927c14da14bfd49ef470c731...689bcd1dc3afdcae5bd45e32541b464fcf3ecbd0,37,634,777,1411,71,2013-10-18 00:57:01,2013-10-18 00:57:01
414795856a623991927c14da14bfd49ef470c731...8bce284496e60231ac2e82fc023ff1faadff6aa5,1,12,9,21,3,2013-10-17 23:40:43,2013-10-17 23:40:43
8bce284496e60231ac2e82fc023ff1faadff6aa5...01284cbf7350d1b4537e83ddd60274afccf32ecf,1,7,1,8,5,2013-10-22 22:39:51,2013-10-17 23:45:18
414795856a623991927c14da14bfd49ef470c731...83a2e92d47bc1d78a44b9508656725a043f08b6b,2,62,16,78,13,2013-10-17 22:49:35,2013-10-17 08:08:14
414795856a623991927c14da14bfd49ef470c731...47cc6c808161057f3a04f090dc01f32da2132b47,1,1,1,2,1,2013-10-17 18:26:17,2013-10-17 18:26:17
414795856a623991927c14da14bfd49ef470c731...c405d53b6e6658b1cbe9ad7ba52ea6dc9330f546,5,152,0,152,5,2013-10-17 18:03:49,2013-10-15 15:37:18
c405d53b6e6658b1cbe9ad7ba52ea6dc9330f546...2aaaf9032052af472aaf2eaa1a5b934c9bfeb0a8,1,29,27,56,11,2013-10-23 13:38:12,2013-10-15 15:38:02
414795856a623991927c14da14bfd49ef470c731...2110b3cca80da253d2fd7443480509a3b58a19e2,1,2,1,3,1,2013-10-17 07:31:35,2013-10-17 07:31:35
2110b3cca80da253d2fd7443480509a3b58a19e2...bc39ac71e66327aa73c44633b374ef75630909dc,1,2,1,3,1,2013-10-17 08:07:12,2013-10-17 08:07:12
f16e60665bbd62964a0bd216c4d118a28477a3c3...e8da76605f11c10d964c251a944ca5cbcdf1518a,2,79,1,80,2,2013-10-17 00:50:08,2013-10-17 00:50:08
34745ee0f4d487fd1eb6c6e1cdac1672deb26658...49c62879b8e3df0f0126b8ad844509bb79e016e5,1,8,0,8,2,2013-10-16 23:05:50,2013-10-16 23:05:50
30b759ffa979b9424a9b3db81f683db6b9a253c7...10362870dbdd5063e62dde919f4bab764145d3e2,1,17,6,23,4,2013-09-24 04:39:57,2013-09-13 23:58:16
30b759ffa979b9424a9b3db81f683db6b9a253c7...a7db1254807307b0ac4d9bb0dc784d12caa54237,1,3,3,6,3,2013-09-24 03:14:42,2013-09-24 03:14:42
03fe5632d0bba0ce1c7436fe9d94b595069efc6e...aa3de0b8499f8f42e0414099b2397179df35358b,2,12,21,33,11,2013-09-24 20:36:20,2013-09-23 18:19:28
f127c471a15050814f8d5b97b7a768f58756afff...6c87db97a629f3d7b7f6e276a515506bcca8dbb1,1,0,1,1,1,2013-08-13 23:28:24,2013-08-13 23:28:24
4e7f2b757e9b5c1a0960553938570bee2a54e0c6...74a2b13687787a33b0963f020f704d3cdde4b06d,1,3,0,3,1,2013-07-22 14:52:05,2013-07-22 14:52:05
8165e51eccd15b7eed3939ada6017ed12b9e81b3...7aba68cd548d69e10e710029ca143b32fd291585,2,7,6,13,2,2013-07-23 19:55:38,2013-07-23 19:55:38
a93a87f64a97f36121dbf3a58fff762f94e5dd73...bc823acc255a786b00a7b2759b67fd7b3256fce3,2,225,2,227,6,2013-07-24 00:27:49,2013-07-24 00:27:49
7f02bd3b7a814c6db77744ef668d4bbf9cc43946...1ce9b3ca9c2ca2b2060e39a217d2e496c9a31826,1,2,2,4,2,2013-08-09 00:02:59,2013-08-09 00:02:59
1643943402fdbce021db51b0f4f49edb0fa2e285...c015d26e96e1f6ebee2a577468c747bf3d2aeeb9,1,15,1,16,2,2013-08-12 23:33:42,2013-08-12 18:07:58
c015d26e96e1f6ebee2a577468c747bf3d2aeeb9...ef1d1aefa73f71296911b0f5593e46a81c1f5c55,1,3,1,4,1,2013-08-12 23:35:23,2013-08-10 03:06:08
ef1d1aefa73f71296911b0f5593e46a81c1f5c55...68934878f1e707b126ab754d48ff6c6eb858b37e,1,2,2,4,2,2013-08-12 23:43:53,2013-08-08 00:23:49
68934878f1e707b126ab754d48ff6c6eb858b37e...0ca133dd7681bb3af1d1de18a5ea6ed42142a11e,1,5,1,6,1,2013-08-12 23:46:26,2013-08-01 00:42:22
0ca133dd7681bb3af1d1de18a5ea6ed42142a11e...c3773740d982d62c5c478d3fb27aa4494383b11b,2,7,1,8,2,2013-08-12 23:55:42,2013-08-12 23:55:42
c3773740d982d62c5c478d3fb27aa4494383b11b...05219d6b52d8448fdad72f89b192d61480483aff,1,1,0,1,1,2013-08-13 17:30:21,2013-07-30 18:23:34
05219d6b52d8448fdad72f89b192d61480483aff...1a1c89556f3869baded68eb56ae20f8a7e90a708,1,1,0,1,1,2013-08-13 17:34:35,2013-08-02 22:58:10
1a1c89556f3869baded68eb56ae20f8a7e90a708...5d25f3232c38d6a7ed31860948058b8ec1d95656,1,1,0,1,1,2013-08-13 17:36:24,2013-08-13 17:36:24
d5a57a4b5ee7bb722371d92c173c95d10b6667c5...e0c24ccfc37b64eb919c5675d8a8f383201fa7cb,1,1,1,2,1,2013-07-31 19:17:42,2013-07-31 19:17:42
d5a57a4b5ee7bb722371d92c173c95d10b6667c5...9a604acc23d30d00ae907acdf756cbcdf0e4cf83,1,1,0,1,1,2013-07-31 14:50:53,2013-07-30 18:23:34
d5a57a4b5ee7bb722371d92c173c95d10b6667c5...3043c2641990d94298c6377b7ef14709263a4709,5,75,34,109,26,2013-07-30 23:24:31,2013-07-24 03:01:24
3043c2641990d94298c6377b7ef14709263a4709...dae585c6e4c19817b2dbd106171728a0bb564ccc,6,20,31,51,11,2013-08-03 00:27:58,2013-07-30 22:48:20
d5a57a4b5ee7bb722371d92c173c95d10b6667c5...e66e0289abc213164dca1e1eadfb0380b6e81904,1,1,1,2,2,2013-07-30 17:18:19,2013-07-30 17:18:19
9a15db21a6d6b49d4f9626f89f7dfdb276ce7618...b5da816487d68853a8ac46630cb3118646f71d2d,6,104,31,135,26,2013-07-23 15:41:19,2013-07-10 12:55:05
b5da816487d68853a8ac46630cb3118646f71d2d...b8d52ec2669332988a972bff3b5f5d2e9d526b33,2,7,2,9,5,2013-07-23 15:41:19,2013-07-12 15:09:20
b8d52ec2669332988a972bff3b5f5d2e9d526b33...2e4d4c9f60d0ad92ab0cc84c56c060678222c4db,3,68,26,94,18,2013-07-23 15:41:19,2013-07-12 16:29:23
2e4d4c9f60d0ad92ab0cc84c56c060678222c4db...ec559c02b8dd70692821b3dc7f497d6fccaa88ad,2,34,0,34,2,2013-07-23 15:42:34,2013-07-17 13:44:06
ec559c02b8dd70692821b3dc7f497d6fccaa88ad...8b3519c5f7540b99d19ed2c3163aabf9897dd5a4,1,10,8,18,8,2013-07-23 15:42:34,2013-07-17 13:56:09
8b3519c5f7540b99d19ed2c3163aabf9897dd5a4...040c3b50d0a56baf98bd1ec14ad7d59c55a4ab31,2,44,1,45,4,2013-07-23 15:42:34,2013-07-18 14:35:14
040c3b50d0a56baf98bd1ec14ad7d59c55a4ab31...ed7a4236b32f3f711c183dff8b70fbef17bae2d7,2,39,1,40,2,2013-07-23 15:42:34,2013-07-18 14:54:58
ed7a4236b32f3f711c183dff8b70fbef17bae2d7...a41384ad7312a21fd8fe429637c8d6b5c883fa2a,1,3,1,4,1,2013-07-23 15:42:34,2013-07-19 14:31:42
9a15db21a6d6b49d4f9626f89f7dfdb276ce7618...3bae188b8dc51911a44ea1c7b5681f9f07f9d3af,3,87,127,214,42,2013-07-23 15:07:18,2013-07-23 15:04:31
58a1c5720a42fde72c27532ce1122609225bc3bb...e701dce33978a0206627a02b258da6a0269c4b60,8,5,594,599,9,2013-07-23 20:05:06,2013-07-23 20:05:06
4bc3328e807802d77c1cdb1381d5dadf44daa6db...f4b41e1a6c2c5d531451bf2feeb3877e03eb8c1c,3,10,7,17,6,2013-07-24 12:28:22,2013-07-24 12:28:22
6ae3305040346083c4b17997e706e7b364c33910...9332c00ca562e97045490d3d45d8f805fae30330,1,10,5,15,3,2013-07-25 00:35:52,2013-07-25 00:35:52
9332c00ca562e97045490d3d45d8f805fae30330...0fc11699ab26121e4f89808ffacb2becf536ff5d,1,38,1,39,3,2013-07-25 03:25:16,2013-07-25 03:25:16
6ae3305040346083c4b17997e706e7b364c33910...fd9ad1a19469d07944ca9b417861d63ecec2ef42,4,33,14,47,14,2013-07-24 22:48:51,2013-07-24 22:48:18
29de2432eaf4fdb3d1545693d9c80af4538dbda3...07fee445593982ef9063a184c05ba93ecacd2e65,1,0,2,2,1,2013-08-02 22:18:02,2013-08-02 22:18:02
c18e849451a3f48cecb82a5747f131e310cb0433...a9eac7eab4c9867114c94cace52d1c889c249293,1,1,1,2,1,2013-10-07 16:29:54,2013-10-07 16:29:54
2d425af1b1675cfc6399d99a2b00f8efc219d7a9...7250f9487463ae50d73865a4d02caec611e613ad,1,8,2,10,1,2013-10-16 01:12:47,2013-10-15 12:19:07
2d425af1b1675cfc6399d99a2b00f8efc219d7a9...d91bf33df3d48ec9a1f2d460433ce719ede1a6f7,1,1,1,2,1,2013-10-10 22:47:32,2013-10-09 06:11:02
2d425af1b1675cfc6399d99a2b00f8efc219d7a9...dabac81824f8ab9ec0bd80f1fcaa026aa103b1e3,2,78,1,79,44,2013-10-09 03:51:38,2013-10-08 19:55:18
2d425af1b1675cfc6399d99a2b00f8efc219d7a9...f4c17a202b5f6021d48c3cb3342c37607b509630,15,238,95,333,49,2013-10-09 00:33:19,2013-10-09 00:33:19
2d425af1b1675cfc6399d99a2b00f8efc219d7a9...9a4b0b982393e0612fef70c37a04654ea46b4c1d,1,4,0,4,1,2013-10-08 22:48:19,2013-10-08 22:48:19
2d425af1b1675cfc6399d99a2b00f8efc219d7a9...9107565d0634ea3eed3290c6c4b6c0f006fdefe8,3,48,4,52,14,2013-10-08 22:42:02,2013-10-08 22:42:02
2d425af1b1675cfc6399d99a2b00f8efc219d7a9...7d95d300abd9d9cc811713e53fd41adec66f2e00,2,29,26,55,4,2013-10-08 21:29:22,2013-10-08 21:29:22
7d95d300abd9d9cc811713e53fd41adec66f2e00...c2912c82aa7398a10d39fe114eb6328abd636d82,1,1,3,4,3,2013-10-10 16:44:48,2013-10-10 16:44:48
2d425af1b1675cfc6399d99a2b00f8efc219d7a9...4fda3314d871a28e33b0d901d6ca3a6d987c8dfa,1,1,1,2,2,2013-10-08 21:15:58,2013-10-08 21:15:58
2d425af1b1675cfc6399d99a2b00f8efc219d7a9...e906485b07fbf32a2c38495651d907af6b229962,1,8,7,15,3,2013-10-08 19:35:00,2013-10-08 19:21:32
2d425af1b1675cfc6399d99a2b00f8efc219d7a9...1daf242c8bafa0447c099b0e49826667a8155c5c,2,42,0,42,3,2013-10-08 16:35:47,2013-10-08 16:35:47
2d425af1b1675cfc6399d99a2b00f8efc219d7a9...d03022b9ca5e658e551ab3b9907da946b11a0b4c,1,1,2,3,2,2013-10-08 03:24:20,2013-10-08 03:24:20
2d425af1b1675cfc6399d99a2b00f8efc219d7a9...6d67ac2a1b93d6c95881cb2f17250a7a8279def6,1,7,0,7,2,2013-10-08 00:51:07,2013-10-08 00:51:07
6d67ac2a1b93d6c95881cb2f17250a7a8279def6...6545e53803a3f0d908510d87b350ca9641f50df2,1,2,3,5,1,2013-10-09 19:22:14,2013-10-09 19:22:14
8f382aaecd223210099883bb66d4beb2e1288e10...36ab1836f973c62ff543456f1613dec8813d00df,1,1,1,2,1,2014-01-06 20:26:53,2014-01-06 20:26:53
36ab1836f973c62ff543456f1613dec8813d00df...6fe3da9924fc22bd02eba0803abb42b10fc28baf,1,1,1,2,1,2014-01-07 01:21:14,2014-01-07 01:21:14
1e704a4ddce4de000311a2be0b09045025a25c87...b64ce8e33cb0a63ede881da78580e37ea4f0d6a7,2,2,1,3,2,2013-10-25 16:41:03,2013-10-25 16:41:03
1e6370fd4b4547e278a352bfd37e8758f3375a1e...c9b916b2938654d4663b0b2bed1ac439129981bd,1,1,1,2,1,2013-09-25 02:54:13,2013-09-25 02:54:13
81866087fe6260eccfd9490f990ad01fec911b15...10e10c9573a0f20243212192fa782feb35651b18,2,15,7,22,7,2013-10-22 22:01:06,2013-10-22 22:01:06
81866087fe6260eccfd9490f990ad01fec911b15...d93023daa9db2b6d38f7eefc8611e8226d75bbaf,1,1,0,1,1,2013-10-22 18:56:48,2013-10-22 18:56:48
b0515a7016d9be58e989401f65645af756d904ef...bc8a1081b047f6ee4ebf0adb22695fe3c98425c6,1,6,2,8,4,2013-10-23 16:21:10,2013-10-23 08:59:20
b0515a7016d9be58e989401f65645af756d904ef...33ccd29ae7b6e9c8e5b463c7066426f825c74d0a,1,1,1,2,1,2013-10-23 15:19:12,2013-10-23 15:19:12
b0515a7016d9be58e989401f65645af756d904ef...99f16755661de79cac1ccda78e3e96552f6a4491,1,12,5,17,6,2013-10-23 10:29:35,2013-10-23 10:29:35
99f16755661de79cac1ccda78e3e96552f6a4491...e81da876df57fb8e0562cc64e7b57dc7eb32284a,3,19,12,31,13,2013-10-24 05:23:02,2013-10-24 05:23:02
b0515a7016d9be58e989401f65645af756d904ef...7e4d00840392a80c0946291848c4caa18a5ec108,1,0,2,2,2,2013-10-23 06:44:57,2013-10-23 06:44:57
83a2e92d47bc1d78a44b9508656725a043f08b6b...255b6aadfacfd346ef413a1ffd945360276cbcf6,1,25,0,25,1,2013-10-18 03:42:11,2013-10-18 03:32:23
255b6aadfacfd346ef413a1ffd945360276cbcf6...8c38c309851c2a44b9c12bac8f29bc011ea4040f,2,5,3,8,4,2013-10-18 06:19:36,2013-10-18 03:33:14
8c38c309851c2a44b9c12bac8f29bc011ea4040f...85956c70b5613439d9f239550c5c4ec360339cb6,1,2,2,4,3,2013-10-18 06:20:18,2013-10-18 03:33:34
47cc6c808161057f3a04f090dc01f32da2132b47...3db381bf086215ff9d29cf55cb55d7fa086f990d,1,2,0,2,1,2013-10-17 20:38:39,2013-10-17 20:38:39
ef5cf6c1ec88c71465075f272e58150ae26d25fa...0324e567ad60d66358075bf866299abeae5241b3,1,2,2,4,2,2013-10-23 21:48:30,2013-10-23 21:48:02
2f74b1c84bb892641643faf05615a80d555ad066...f248a8e13cbde9498a79a902c3d326bf2021e181,1,1,1,2,1,2013-10-17 18:27:44,2013-10-17 18:27:44
27fc01271ec3b9f86da415c024d96d79bc23e2fd...df697b4318f533556a2e9351d5995b2d1991ae5a,1,26,1,27,4,2013-10-16 19:23:47,2013-10-16 19:23:47
df697b4318f533556a2e9351d5995b2d1991ae5a...104a86936ab2611d6e8e54f5ef686f2e9d231bcf,1,2,0,2,1,2013-10-16 19:32:03,2013-10-16 19:32:03
104a86936ab2611d6e8e54f5ef686f2e9d231bcf...0e64a4d7e7d5dd7c68ecc1df9fe8234938f12026,1,1,1,2,1,2013-10-16 19:38:12,2013-10-16 19:38:12
0e64a4d7e7d5dd7c68ecc1df9fe8234938f12026...3acfc600285dedd2e10a3780e041af0cc39675a7,2,2,2,4,2,2013-10-16 19:45:10,2013-10-16 19:41:01
d6887b769cff4140915ea7f97a076aecec7a05f3...c1c74cb0b1e83c4836b51828888daff181f52742,1,3,1,4,2,2013-09-24 12:57:29,2013-09-24 12:57:29
d6887b769cff4140915ea7f97a076aecec7a05f3...15ad2915b95bd13067691ed3c7dcab67f529d37f,1,5,5,10,5,2013-09-24 07:12:24,2013-09-24 07:12:24
15ad2915b95bd13067691ed3c7dcab67f529d37f...17b7194d91ba91e044155edf7ae0a485c2dd9c0b,1,2,2,4,2,2013-09-24 07:25:16,2013-09-24 07:25:16
17b7194d91ba91e044155edf7ae0a485c2dd9c0b...c000e6a7fce11aaddae916853cc551d4801c1f8e,1,1,1,2,1,2013-09-24 20:51:21,2013-09-24 20:51:21
7447867edd3d778fe8963e91cd42e82cf38a96b2...22e7e107addc4703ee6ef36981dfafe985be695d,4,54,3,57,10,2013-09-27 14:43:12,2013-08-15 18:48:05
7447867edd3d778fe8963e91cd42e82cf38a96b2...5c190fa9264dba20b34fda4b68ece6c0a84d88be,1,35,5,40,4,2013-09-24 18:04:08,2013-09-24 18:04:08
5c190fa9264dba20b34fda4b68ece6c0a84d88be...0a35b1fb3681561a1f3f139d989c0bd133122123,2,5,0,5,2,2013-09-28 02:07:12,2013-09-28 02:07:12
7447867edd3d778fe8963e91cd42e82cf38a96b2...edde4f55e08c879e5a5fdb74abd6e5cc751e4dbb,1,83,7,90,5,2013-09-24 16:36:50,2013-09-24 16:26:17
a59a66528baef4eb7593827515016814fdf1ef3e...595210a3706ecad29c03b3c6753794440b18f992,1,5,8,13,2,2013-09-25 03:25:45,2013-09-25 03:25:45
4cb57a54389e25a3803dc6c4603e330b362c4ee9...49597f0f52d824967779ce26e720a5f3bab54d3e,1,5,2,7,2,2013-08-14 17:12:08,2013-08-14 17:12:08
4cb57a54389e25a3803dc6c4603e330b362c4ee9...c84d74df8c17f50c8ca7f5027ade4db8360f5ed3,1,3,3,6,2,2013-08-14 16:59:21,2013-08-14 16:59:21
4cb57a54389e25a3803dc6c4603e330b362c4ee9...3c9f9945c949e981a4c09da915ea28356b2c58ae,2,5,2,7,2,2013-08-14 10:26:18,2013-08-14 10:26:18
4cb57a54389e25a3803dc6c4603e330b362c4ee9...80ebff0fa49b7813205102431633baba789685fb,1,1,1,2,1,2013-08-14 05:28:41,2013-08-14 05:28:41
4cb57a54389e25a3803dc6c4603e330b362c4ee9...44eb1b3892cdcf3bda6478119d90cb69eafbc481,1,29,15,44,16,2013-08-14 01:45:03,2013-08-14 01:45:03
3e12349831903a11c67a9ca40a0d566e428aa876...a43bae4c0b6f3ec632636be544a6816f5f62dcb0,1,1,3,4,3,2013-08-10 17:48:24,2013-08-10 17:48:24
3e12349831903a11c67a9ca40a0d566e428aa876...e3acbff2edd04c8a7211ea078b24745749021efc,1,3,1,4,1,2013-08-10 03:06:08,2013-08-10 03:06:08
3e12349831903a11c67a9ca40a0d566e428aa876...d6e5c2c276de458f36034d46f7b7f0f8efd24491,1,434,0,434,1,2013-08-10 01:38:11,2013-08-10 01:38:11
d6e5c2c276de458f36034d46f7b7f0f8efd24491...91ae1358966211826818ed452f13e3e2e27ed6cc,1,19,0,19,1,2013-08-10 12:05:31,2013-08-10 12:05:31
91ae1358966211826818ed452f13e3e2e27ed6cc...d75282eb147218bb7c6f4032e75b95a1ddd299cf,1,1,1,2,1,2013-08-10 23:57:18,2013-08-10 23:57:18
d75282eb147218bb7c6f4032e75b95a1ddd299cf...ae1909b4823e500798f224a3ea70f7faf644a2bc,1,2,0,2,1,2013-08-11 00:08:47,2013-08-11 00:08:47
ae1909b4823e500798f224a3ea70f7faf644a2bc...e737856a7f2c92f6cb582a12cc6f0b9fb4720d5a,1,1,1,2,1,2013-08-11 00:29:22,2013-08-11 00:29:22
3e12349831903a11c67a9ca40a0d566e428aa876...4dc04d7690a4d634d9afd93821bb8e78620c5f9f,11,21,21,42,11,2013-08-10 01:16:44,2013-08-10 01:16:44
a37b42b57cd1f372c1583fa3b46b30120401e2ff...ce97a71adf879a228f352ee10b7fb62ff86bc4e6,1,4,4,8,4,2013-08-05 14:47:16,2013-08-05 14:47:16
a37b42b57cd1f372c1583fa3b46b30120401e2ff...0f249c85ea9acc7fba33994aa5d20a897463db2c,2,6,2,8,3,2013-08-05 14:07:03,2013-08-05 00:11:23
0f249c85ea9acc7fba33994aa5d20a897463db2c...d00fb4096700cd8feed06ca32c93f080fb6446b1,2,56,0,56,2,2013-08-05 14:30:27,2013-08-05 14:03:42
04cd0a392bcadf36356047fd722ba1ce6cacce5f...280901e5fbd0c2dabd14d7a9b69a073f6e8f87e4,4,56,1,57,10,2013-08-13 23:20:22,2013-08-09 22:53:02
04cd0a392bcadf36356047fd722ba1ce6cacce5f...68b09cbe3d0a13bd1dbcaa39a63788fe938d0ae7,1,1,1,2,1,2013-08-09 23:03:05,2013-08-09 23:03:05
b8f8f9d07e7142b56ddcb05d1b8c8322d1114436...6178dc7f1be0d3c90ed02e8ccbafa4d7e103508d,3,17,5,22,5,2013-08-09 14:40:28,2013-08-09 14:40:28
d1e1a8e78cf7a315bd3083d120220a96663fe5ff...2e72882216ce13169a578614202830a5b084bfb4,1,5,1,6,1,2013-08-01 00:42:22,2013-08-01 00:42:22
2e72882216ce13169a578614202830a5b084bfb4...2e7df5182cc94e3699ebc1031e89b1605f9d42f9,7,59,3,62,14,2013-08-02 00:48:17,2013-07-29 16:45:19
2e7df5182cc94e3699ebc1031e89b1605f9d42f9...f5a8e90d101cd2dbb4ce19543ed15fff48579877,2,39,11,50,6,2013-08-02 01:12:39,2013-08-02 01:12:39
4dcc0f316c6dbcad3932b483ad0946a4b7d526cc...7c50221de5ec1066f0f04d6db94ee9c2fef98efb,2,2,4,6,2,2013-08-10 00:42:20,2013-08-10 00:42:20
4dcc0f316c6dbcad3932b483ad0946a4b7d526cc...1408f08c40f73ccf0204334ceb44ac482c5641e9,2,5,1,6,5,2013-08-10 00:09:42,2013-08-10 00:09:42
4dcc0f316c6dbcad3932b483ad0946a4b7d526cc...3b23f02229fd3f4928934f317d41b8f497cec9a9,1,1,1,2,1,2013-08-09 23:52:05,2013-08-09 23:52:05
4dcc0f316c6dbcad3932b483ad0946a4b7d526cc...c22f2617ad8ed2450d4d9dbb6e6ec39da4e51f2f,1,2,1,3,1,2013-08-05 00:59:12,2013-08-05 00:59:12
4dcc0f316c6dbcad3932b483ad0946a4b7d526cc...c860945be25c7768ee456b5a71524631ec0dddbd,1,15,1,16,3,2013-08-05 00:42:24,2013-08-05 00:42:24
4dcc0f316c6dbcad3932b483ad0946a4b7d526cc...51d0c9238bb01088c08048e022b948a292f815ab,6,46,46,92,36,2013-08-04 22:34:32,2013-08-04 22:16:00
4dcc0f316c6dbcad3932b483ad0946a4b7d526cc...db0ccaac9b4e9e12d4e33e5d48e437771aaf8dcd,1,1,1,2,1,2013-08-04 03:11:59,2013-08-04 03:11:59
4dcc0f316c6dbcad3932b483ad0946a4b7d526cc...cd6aeaf97912a0c18994c978a4b58678e671d9ee,3,68,0,68,3,2013-08-03 22:35:36,2013-08-03 22:33:51
cd6aeaf97912a0c18994c978a4b58678e671d9ee...e6affb1b1ac0a172ce345d14162f6944ec68da4e,3,34,7,41,5,2013-08-18 05:11:34,2013-08-18 05:11:34
4dcc0f316c6dbcad3932b483ad0946a4b7d526cc...708cd3458696101a4aa78d4e8086a29158e133cf,1,3,3,6,2,2013-08-03 10:31:20,2013-08-03 10:31:20
e54e8fa9205409e741a64c7d7746e2e548c52fc0...c03561eea84f88d0eeddd84a7021876852c0a7c0,1,19,0,19,1,2013-08-05 21:32:54,2013-08-05 21:32:54
c03561eea84f88d0eeddd84a7021876852c0a7c0...590fc58de70bb281812371be6e44ccb7d73d3ec6,1,1,1,2,1,2013-08-05 21:49:37,2013-08-05 21:49:37
e54e8fa9205409e741a64c7d7746e2e548c52fc0...4179f25286dde9f9e83bffa07c303373844b5ed2,1,5,0,5,1,2013-08-05 21:25:29,2013-07-01 23:05:05
4179f25286dde9f9e83bffa07c303373844b5ed2...303490168fb53af2528375ca9ec818c7a179a044,3,28,24,52,3,2013-08-06 03:36:55,2013-07-22 18:42:31
303490168fb53af2528375ca9ec818c7a179a044...965de6ef50ceb479168c9e4f7156fe2b855e4245,1,1,0,1,1,2013-08-06 03:37:53,2013-07-22 20:09:11
422378cb85b1a158373ea8e5a2dc2de92076d225...2d85a20c71c9418301c3161c6853a07fca612676,1,1,1,2,1,2013-07-27 01:29:27,2013-07-27 01:29:27
422378cb85b1a158373ea8e5a2dc2de92076d225...e608296bc62ceeaf41ebf2bc80b21c0a1883d4f0,1,3,0,3,1,2013-07-26 09:19:26,2013-07-26 09:19:26
e608296bc62ceeaf41ebf2bc80b21c0a1883d4f0...e592f1b298c778d0b9adfd6751f5fe1843a7001d,2,87,1,88,3,2013-07-26 10:30:36,2013-07-26 10:01:41
422378cb85b1a158373ea8e5a2dc2de92076d225...4ebe2cf348915415c34503aca7a5663177e0002f,1,1,1,2,1,2013-07-26 08:10:42,2013-07-26 08:10:42
422378cb85b1a158373ea8e5a2dc2de92076d225...f4b63d9eeaddae6cb15775bea13ec4bca6e115da,3,8,7,15,6,2013-07-26 00:19:58,2013-07-26 00:19:58
f4b63d9eeaddae6cb15775bea13ec4bca6e115da...26229d78f2b77592ab6761a4ffce38ab7d859f3b,1,8,1,9,2,2013-07-31 20:44:10,2013-07-31 20:44:10
26229d78f2b77592ab6761a4ffce38ab7d859f3b...ad3b091d535cde5544ec3c11da4cf8d9b278a325,1,7,12,19,7,2013-07-31 20:59:56,2013-07-31 20:59:56
7df6c4b9adaa64d243312f37ed2a6dbe6c897282...d86898b0142f2f9a834aa0c727b10d62ef647262,3,103,15,118,11,2013-07-25 19:45:49,2013-07-09 07:01:45
7df6c4b9adaa64d243312f37ed2a6dbe6c897282...3425c1b84c3f58ac5bb2feb91c4901b61561c58c,1,13,9,22,7,2013-07-25 19:31:23,2013-07-23 18:37:13
7df6c4b9adaa64d243312f37ed2a6dbe6c897282...1c509f4350d943c6aa8b9bff8dcbed28ee803735,1,1,1,2,1,2013-07-25 15:45:15,2013-07-25 15:45:15
7df6c4b9adaa64d243312f37ed2a6dbe6c897282...f385f1860bdebe2434bb122bd5ac8fec85687970,1,4,0,4,1,2013-07-25 15:18:34,2013-07-25 15:18:34
f385f1860bdebe2434bb122bd5ac8fec85687970...48833c7b0784bc7055f29dd3448df3af93c462ec,2,24,4,28,4,2013-07-25 15:20:56,2013-07-25 15:20:56
594c818d853a18014711fb0b95c9ffd3954c56c7...c8ec36d1b9bfbe1e22acd0124409ecb5a109d406,1,4,7,11,2,2013-07-29 17:28:41,2013-07-29 17:28:41
c8ec36d1b9bfbe1e22acd0124409ecb5a109d406...10e37198aa14cb3192fd0bf29572a5dce58c348f,1,4,2,6,1,2013-07-29 18:13:59,2013-07-29 18:13:59
594c818d853a18014711fb0b95c9ffd3954c56c7...d4f70397930b15c8860a71df1abb9bc5ac9ab4ff,1,10,2,12,3,2013-07-27 17:00:36,2013-07-27 17:00:36
d4f70397930b15c8860a71df1abb9bc5ac9ab4ff...88b6ea993d76fb8891ee7a7fa8828b5c5753c7f5,1,3,3,6,3,2013-07-27 17:17:57,2013-07-27 17:17:57
594c818d853a18014711fb0b95c9ffd3954c56c7...01ce312c2d3e56a7993f7d644675513e1acca17c,1,8,0,8,1,2013-07-27 00:40:45,2013-07-27 00:40:45
01ce312c2d3e56a7993f7d644675513e1acca17c...7cc90f2bc552f5b3b49e65e19ac877089e3db137,1,4,5,9,2,2013-07-27 01:12:05,2013-07-27 01:12:05
7cc90f2bc552f5b3b49e65e19ac877089e3db137...bb06fe8dd9b84a196eae19e4c955bb2e5a09dba2,3,2,9,11,3,2013-07-27 16:14:38,2013-07-27 16:13:02
9e3d18e6068340f673bca79c3703517e0b538e83...dde8f74ceae83f26386ec29e42f615fdc7945e80,1,1,0,1,1,2013-08-02 22:58:10,2013-08-02 22:58:10
ead7eb619ed5a60a5ffab62827aa4a3c761504e8...3e9575e275c40acb04c505fa14c1ac63ba490b75,4,64,8,72,7,2013-08-02 22:23:36,2013-08-02 22:23:36
ead7eb619ed5a60a5ffab62827aa4a3c761504e8...b6bff0cbb15535b3d1bc991b975c3df35061aa83,1,7,3,10,3,2013-08-02 22:10:57,2013-08-02 22:10:57
640ca68e4f77ef46802ef70233b4f75ce2b3e52e...ae780fb5ea4520822ea3526e43113822ed13de5c,31,0,1959,1959,31,2013-10-10 10:54:10,2013-10-10 10:54:10
bb62c281f57f7f36480b4d2f971105cad7df9f88...37df1d92d8d2b167bb90bb82c086b947371d7497,1,1,3,4,1,2013-10-09 11:05:09,2013-10-09 11:05:09
6fe3da9924fc22bd02eba0803abb42b10fc28baf...7fb55f77250a9b52b0515a7e655ecc605ae452ca,1,0,1,1,1,2014-01-09 16:35:06,2014-01-09 16:35:06
7fb55f77250a9b52b0515a7e655ecc605ae452ca...40c90796e950307804745c5a852cc64d3e53a1a9,1,0,1,1,1,2014-01-09 16:35:47,2014-01-09 16:35:47
40c90796e950307804745c5a852cc64d3e53a1a9...11d61ec77feb743a3eedef7d85a7a751ed09736e,1,2,2,4,2,2014-01-09 16:47:03,2014-01-09 16:47:03
b64ce8e33cb0a63ede881da78580e37ea4f0d6a7...8145e57cee6390bb27d7fb07fe5f572affe5d0cd,1,10,0,10,2,2013-11-13 18:29:29,2013-11-13 18:29:29
c9b916b2938654d4663b0b2bed1ac439129981bd...d06116d2e8a70477b3d8b02cd9e57f7465edc0ce,1,24,38,62,5,2013-09-25 05:26:36,2013-09-25 05:17:52
4b7c071e9c1f2ec839e2d4f5be915850405a8686...4918769b1ac2d38f23087b766140e6a7f8979310,11,430,16,446,27,2013-10-18 23:16:29,2013-09-12 06:50:26
4918769b1ac2d38f23087b766140e6a7f8979310...7cf1877098edb7d4874509a338f663d550ef0ede,6,88,0,88,3,2013-10-18 23:16:29,2013-10-04 13:59:06
7cf1877098edb7d4874509a338f663d550ef0ede...333bc23f21e8423d3085632db99a6d1df227c5f1,9,121,87,208,55,2013-10-18 23:19:27,2013-10-08 19:15:29
333bc23f21e8423d3085632db99a6d1df227c5f1...3e014aa6624bdc3411bb6f5bc2c297e45a47ad68,6,106,55,161,30,2013-10-18 23:26:16,2013-10-09 01:42:53
3e014aa6624bdc3411bb6f5bc2c297e45a47ad68...8cf0f2dbe54e5ff5175a830af30ba428f8b1f526,1,96,39,135,21,2013-10-18 23:26:29,2013-10-09 19:31:40
8cf0f2dbe54e5ff5175a830af30ba428f8b1f526...e7269b98416e8228930dde9461bfcad38eeb2c56,1,16,7,23,7,2013-10-18 23:26:29,2013-10-09 21:38:52
e7269b98416e8228930dde9461bfcad38eeb2c56...9bceae244044435647e843ffdd040322507d182b,1,23,5,28,8,2013-10-18 23:26:29,2013-10-10 18:20:50
e9ee860c91b6e9cdcafc03cff9941affb6341a0d...bc1c5ddf2ebbb74dd2e2bc2d4a7a24c75edf6877,1,1,1,2,1,2013-10-22 09:13:24,2013-10-22 09:13:24
c2413889bb5d76a57ef239d789d189ca94d73d99...92384649cfd7d69a3e493231aadf616bf8704109,1,0,4,4,4,2013-10-24 07:25:55,2013-10-24 07:25:55
ac5bc867718b3ea8da1cb13831592094f3d21076...4870265a9f07b443fa06df07c50ddd6f13c9f13f,1,1,0,1,1,2013-10-18 18:18:13,2013-10-18 18:18:13
95ccb78aa79bb1d8704fe65b09803167b36cd074...f34a62ea19b477bbaa74a09c04d5e8faf67c44a2,1,11,9,20,3,2013-10-18 05:35:12,2013-10-18 05:34:29
95ccb78aa79bb1d8704fe65b09803167b36cd074...240d5b3fa1b66f099b71c20ff8dc4ed1ecffc1d3,4,37,17,54,13,2013-10-18 02:13:36,2013-10-16 20:10:20
240d5b3fa1b66f099b71c20ff8dc4ed1ecffc1d3...5c175357aaa7e011e3535eeb1ee162450f390b9e,2,5,2,7,5,2013-10-18 02:13:36,2013-10-16 20:44:15
5c175357aaa7e011e3535eeb1ee162450f390b9e...07d9e4353bc199db7abb52b4b4bba1c2feb75c1a,2,7,28,35,7,2013-10-18 07:20:39,2013-10-18 06:44:30
07d9e4353bc199db7abb52b4b4bba1c2feb75c1a...b629810fe08dc864674a6e64a7f1b418096bc448,1,28,4,32,6,2013-10-18 07:29:07,2013-10-18 06:47:08
6e48b739557d7a474fbdb867cd795717c221b248...655b16c712f1112949ab0f694a12c4b3c7924498,1,1,0,1,1,2013-10-16 21:47:20,2013-10-16 21:46:16
6e48b739557d7a474fbdb867cd795717c221b248...cc851dbb3f4725562729f12663e246690a61c620,2,20,2,22,3,2013-10-16 21:43:20,2013-10-16 20:40:52
6e48b739557d7a474fbdb867cd795717c221b248...a2ffa637ceb694b1e7a21972a9482a0c9c1676c8,3,303,0,303,3,2013-10-16 20:30:15,2013-10-16 20:26:39
1363de0934ce65bda21f831a6b55f28b3e0d13e7...0f829bf5cf6fd05c89a8f2aac47e5eec9143b150,1,1,1,2,1,2013-09-25 15:33:09,2013-09-25 15:33:09
23015fa14dd3f58e582d7ef3039262025b06f21c...534a991cff405a469754f6afc4fd8aa4be79e444,1,1,1,2,1,2013-09-30 23:54:04,2013-09-30 23:54:04
23015fa14dd3f58e582d7ef3039262025b06f21c...459bac712709db4d188022539f4d59524b4b3670,1,349,0,349,1,2013-09-30 23:34:58,2013-09-04 09:14:31
459bac712709db4d188022539f4d59524b4b3670...374a5e9913112c5bde590e532bc0ba5e4afeda49,1,895,0,895,1,2013-09-30 23:34:58,2013-09-04 09:18:23
374a5e9913112c5bde590e532bc0ba5e4afeda49...7fb3bfed03d4d2a88f0e76fd6b8425cc753f4547,1,62,0,62,1,2013-09-30 23:34:58,2013-09-04 09:25:32
7fb3bfed03d4d2a88f0e76fd6b8425cc753f4547...b8dc7b5f1a8111275e2b869dfb67a8689cecf9b9,1,16,0,16,1,2013-09-30 23:34:58,2013-09-10 18:15:23
b8dc7b5f1a8111275e2b869dfb67a8689cecf9b9...167601e85850aa58df96f9d0796f9c26ed2d6fa4,1,12,1,13,2,2013-09-30 23:34:58,2013-09-10 18:21:15
167601e85850aa58df96f9d0796f9c26ed2d6fa4...e368c8bb01b3c52c8e4c334c3a7f32556af9d632,3,6,3,9,4,2013-09-30 23:34:58,2013-09-04 09:41:38
e368c8bb01b3c52c8e4c334c3a7f32556af9d632...e6216793d91a9b003814b535b0373902326753dd,1,11,0,11,1,2013-09-30 23:34:58,2013-09-04 09:44:11
e6216793d91a9b003814b535b0373902326753dd...1d36b8c7b7b0c943ccb7d69b7181b3e33566d77c,2,3,2,5,3,2013-09-30 23:34:59,2013-09-04 10:03:45
1d36b8c7b7b0c943ccb7d69b7181b3e33566d77c...ca2f7f955e697091f2b7bee9a33c6c4e106cecd0,4,18,7,25,11,2013-09-30 23:34:59,2013-09-05 12:40:12
ca2f7f955e697091f2b7bee9a33c6c4e106cecd0...8f7361279c13660a617886a523c50ecbc6849129,1,48,0,48,3,2013-09-30 23:34:59,2013-09-10 20:15:18
8f7361279c13660a617886a523c50ecbc6849129...d2ba3e200576c2bcceb81d8d3d65b86fbf49313b,1,260,9,269,10,2013-09-30 23:34:59,2013-09-04 10:55:48
d2ba3e200576c2bcceb81d8d3d65b86fbf49313b...a9ec1dbc9bec91e1c0f1b751a06680570a04e915,2,30,1,31,2,2013-09-30 23:34:59,2013-09-04 12:21:53
a9ec1dbc9bec91e1c0f1b751a06680570a04e915...074f38d49377411cf0b805095c0d9909d4859f3c,1,18,0,18,4,2013-09-30 23:34:59,2013-09-04 13:44:01
074f38d49377411cf0b805095c0d9909d4859f3c...8e7cbbff504b1d5b0680d2a14821d1d7b0757ab0,1,22,10,32,10,2013-09-30 23:34:59,2013-09-05 13:32:57
8e7cbbff504b1d5b0680d2a14821d1d7b0757ab0...1c5dc26a7c0a0abb7bc59174768ec309f6c5fd4f,3,142,7,149,7,2013-09-30 23:34:59,2013-09-05 16:03:49
1c5dc26a7c0a0abb7bc59174768ec309f6c5fd4f...b86f67126c86a07aac155f38aefd6c1ef538e24d,1,2,1,3,2,2013-09-30 23:34:59,2013-09-05 18:11:18
b86f67126c86a07aac155f38aefd6c1ef538e24d...fda6ff9c2707efbd1c9d1f2bf151b9d1d082d0c6,3,77,11,88,12,2013-09-30 23:34:59,2013-09-05 20:10:29
fda6ff9c2707efbd1c9d1f2bf151b9d1d082d0c6...b0626f403b168b9020a802ec3bc4ad8c9bbc2486,2,40,1,41,2,2013-09-30 23:34:59,2013-09-05 20:14:19
b0626f403b168b9020a802ec3bc4ad8c9bbc2486...30890c7763e775d38c82d3eac5c1650e149137ae,1,5,0,5,1,2013-09-30 23:35:00,2013-09-06 10:03:21
30890c7763e775d38c82d3eac5c1650e149137ae...99393cf3cfd08de769f0c37f06b912fb3771a080,3,16,3,19,4,2013-09-30 23:35:00,2013-09-06 10:04:00
99393cf3cfd08de769f0c37f06b912fb3771a080...381ce94ef4fe2590b0afa16c5f35a508de12e7a3,1,49,0,49,1,2013-09-30 23:35:00,2013-09-06 12:37:04
381ce94ef4fe2590b0afa16c5f35a508de12e7a3...52294192b2a008b624862701cbf8491ad19b0798,2,3,3,6,3,2013-09-30 23:35:00,2013-09-06 12:38:47
52294192b2a008b624862701cbf8491ad19b0798...6094257b28f2e4b5e1a6616c77961b5cec0c9195,3,8,11,19,11,2013-09-30 23:35:00,2013-09-06 14:15:44
6094257b28f2e4b5e1a6616c77961b5cec0c9195...76a2ab6e34e6cdd66899815aeeaac2048e5bafce,1,14,9,23,2,2013-09-30 23:35:00,2013-09-10 19:04:25
76a2ab6e34e6cdd66899815aeeaac2048e5bafce...7fb60caa5d34f8fc0abeae2ce7841000665414b0,1,2,1,3,2,2013-09-30 23:35:01,2013-09-09 09:46:16
7fb60caa5d34f8fc0abeae2ce7841000665414b0...d951911b23b26cda087e823f203414a0ad184276,1,6,0,6,1,2013-09-30 23:35:01,2013-09-09 10:06:55
d951911b23b26cda087e823f203414a0ad184276...9e64ebb29549db19a84b8cb514bea60c26184779,3,24,8,32,8,2013-09-30 23:35:01,2013-09-09 10:39:42
9e64ebb29549db19a84b8cb514bea60c26184779...ed741f7b27b1b1cf5b6f8917551ce86bc39e9c78,4,63,5,68,12,2013-09-30 23:35:01,2013-09-09 11:47:29
ed741f7b27b1b1cf5b6f8917551ce86bc39e9c78...0d7ab8db03814bac19fe076a0d53b6d423616bc7,1,1,1,2,1,2013-09-30 23:35:01,2013-09-09 11:48:58
0d7ab8db03814bac19fe076a0d53b6d423616bc7...5f8e24f8428bc5fb7076ec757ded44f965c48888,1,1,1,2,1,2013-09-30 23:35:01,2013-09-09 12:18:20
5f8e24f8428bc5fb7076ec757ded44f965c48888...07227866006ea75a0c492814b808fdbb672431ee,1,9,1,10,2,2013-09-30 23:35:01,2013-09-09 12:44:19
07227866006ea75a0c492814b808fdbb672431ee...c1388010731cac1c8ff5159bd72b926545a64e58,1,7,2,9,4,2013-09-30 23:35:01,2013-09-09 13:56:59
c1388010731cac1c8ff5159bd72b926545a64e58...145024c6ccc7bff1eda632823702f91899667ed3,1,33,0,33,1,2013-09-30 23:35:01,2013-09-12 13:17:39
145024c6ccc7bff1eda632823702f91899667ed3...429587779a95a4d38ec9cd66202de9729c320ef8,2,31,1,32,4,2013-09-30 23:35:01,2013-09-12 13:18:11
429587779a95a4d38ec9cd66202de9729c320ef8...fdbc2695fe00d522c5c1a962f9be2f802bf53943,2,17,62,79,3,2013-09-30 23:35:01,2013-09-12 18:30:55
fdbc2695fe00d522c5c1a962f9be2f802bf53943...7d566b4f761e8942cf9679e96774b320b8496b2f,1,1,1,2,1,2013-09-30 23:35:01,2013-09-13 09:08:59
7d566b4f761e8942cf9679e96774b320b8496b2f...727e7fcccadf1d3e286f5a3c8d1aa388f6b4dab8,1,137,52,189,22,2013-09-30 23:35:01,2013-09-13 10:56:58
727e7fcccadf1d3e286f5a3c8d1aa388f6b4dab8...5d2ace3424516bd7cc8d4a57fcaddd00fa1c4b5d,1,43,12,55,8,2013-09-30 23:35:01,2013-09-13 13:45:58
5d2ace3424516bd7cc8d4a57fcaddd00fa1c4b5d...ad402763e160ded1924c9b154983d81614e90deb,1,13,6,19,2,2013-09-30 23:35:01,2013-09-13 13:49:57
ad402763e160ded1924c9b154983d81614e90deb...60f552cac3d165dbe4c8d65c1ab82d31700dcc5d,1,94,1,95,3,2013-09-30 23:35:01,2013-09-13 13:56:06
60f552cac3d165dbe4c8d65c1ab82d31700dcc5d...43a7d3d0e9e2fafcdc90cb84855e1bb3869d2729,3,71,5,76,12,2013-09-30 23:35:01,2013-09-13 13:58:14
43a7d3d0e9e2fafcdc90cb84855e1bb3869d2729...91c69fd3532eaa92cfc21c6331699a995fdbe2a6,1,0,1,1,1,2013-09-30 23:35:01,2013-09-13 14:04:07
91c69fd3532eaa92cfc21c6331699a995fdbe2a6...86421e8b5e84452d66e6b16b5cb1a5a438f8fa1f,1,43,0,43,5,2013-09-30 23:35:01,2013-09-13 14:35:56
86421e8b5e84452d66e6b16b5cb1a5a438f8fa1f...1a082ed245aaf55cc92e884c988865b195ea0cb7,1,6,2,8,4,2013-09-30 23:35:01,2013-09-13 14:36:32
1a082ed245aaf55cc92e884c988865b195ea0cb7...bbc72c85f7733fefda499cb0e96f1dda2ce90625,1,1,1,2,1,2013-09-30 23:35:01,2013-09-19 12:39:47
bbc72c85f7733fefda499cb0e96f1dda2ce90625...2c71710b74829787a0c78f7e02f45d31935a996f,1,14,4,18,2,2013-09-30 23:35:01,2013-09-19 12:57:22
2c71710b74829787a0c78f7e02f45d31935a996f...ecdbdfdaea5497c34a0299e7efd97b8a44bd7314,1,3,0,3,3,2013-09-30 23:35:01,2013-09-19 12:59:27
ecdbdfdaea5497c34a0299e7efd97b8a44bd7314...a7e876e3571965de64615d2012e63fae9c3ebbf8,1,2,2,4,2,2013-09-30 23:35:01,2013-09-19 13:44:43
a7e876e3571965de64615d2012e63fae9c3ebbf8...b0a9147fd5f0197931b73e18163a12b04ad8e826,2,13,0,13,2,2013-09-30 23:35:02,2013-09-19 17:20:05
b0a9147fd5f0197931b73e18163a12b04ad8e826...6f57e8025a0a03da8052edc30157f7677f65f208,1,1,0,1,1,2013-09-30 23:35:02,2013-09-19 17:22:23
6f57e8025a0a03da8052edc30157f7677f65f208...6ec5585501c6029ef10a474597503511d5074e10,2,22,0,22,3,2013-09-30 23:35:02,2013-09-19 18:38:06
6ec5585501c6029ef10a474597503511d5074e10...071cc18b58408eaa71575e0233a056475196b199,1,5,0,5,2,2013-09-30 23:35:02,2013-09-19 17:23:35
071cc18b58408eaa71575e0233a056475196b199...be6fef02544d9bc31321b2a21d039e261dc02bd8,2,46,0,46,4,2013-09-30 23:35:02,2013-09-19 18:32:11
be6fef02544d9bc31321b2a21d039e261dc02bd8...0484b2c3254238a6c534f7d417c12c10b694f0d0,1,1,1,2,1,2013-09-30 23:35:02,2013-09-24 12:16:11
0484b2c3254238a6c534f7d417c12c10b694f0d0...aeb89ffbbac8c5625ad4dbba66938e2ef3f5c638,4,19,10,29,11,2013-09-30 23:35:02,2013-09-24 17:20:58
aeb89ffbbac8c5625ad4dbba66938e2ef3f5c638...72a08a5458d5d8248dec431c82241a7b18b2657b,5,11,20,31,12,2013-09-30 23:35:02,2013-09-26 15:08:26
72a08a5458d5d8248dec431c82241a7b18b2657b...152302e379eaa5b2dfc27d901934da0a18b46beb,10,116,387,503,71,2013-09-30 23:35:02,2013-09-26 15:40:13
152302e379eaa5b2dfc27d901934da0a18b46beb...55e1782d6623b59af3f1aea1eb9646a36bbb5579,1,15,10,25,5,2013-09-30 23:35:02,2013-09-26 19:12:12
06c1f000e8791b9cc62eeb2e5edbeeb326a03de6...3f0d0075f8db4ca909db266611ce99023285c061,1,2,0,2,1,2013-09-26 20:30:26,2013-09-26 20:30:26
3f0d0075f8db4ca909db266611ce99023285c061...edd90d46c778d28e4cf2d68a504218698a1e1e61,1,40,13,53,13,2013-09-27 13:32:55,2013-09-27 13:32:55
06c1f000e8791b9cc62eeb2e5edbeeb326a03de6...f8c9f11f067ef94a35cbc35b8d15f67d57ce1aec,1,2,0,2,2,2013-09-26 19:52:43,2013-09-26 19:52:43
f8c9f11f067ef94a35cbc35b8d15f67d57ce1aec...c22e377a6d36816210803e34e4d73cf45a4aa828,1,2,2,4,2,2013-09-26 20:56:59,2013-09-26 20:56:59
06c1f000e8791b9cc62eeb2e5edbeeb326a03de6...80319add5542153146fdaecd46be5549b4397beb,1,1,1,2,1,2013-09-26 19:41:45,2013-09-26 19:41:45
06c1f000e8791b9cc62eeb2e5edbeeb326a03de6...739af0a17f6a5a9956bbc9fd1e81e4d40bff8167,1,349,0,349,1,2013-09-26 15:08:54,2013-09-04 09:14:31
739af0a17f6a5a9956bbc9fd1e81e4d40bff8167...0b12702c0c9753cbb18a942bac2600b036e4f80e,1,895,0,895,1,2013-09-26 15:08:54,2013-09-04 09:18:23
0b12702c0c9753cbb18a942bac2600b036e4f80e...2b1dc8a8a3b99e6edbdf2cc71bf5461d81b9c354,1,62,0,62,1,2013-09-26 15:08:54,2013-09-04 09:25:32
2b1dc8a8a3b99e6edbdf2cc71bf5461d81b9c354...250bc3f61547c6bcdc17ffe41e8a9a0307099cc3,1,16,0,16,1,2013-09-26 15:08:54,2013-09-10 18:15:23
250bc3f61547c6bcdc17ffe41e8a9a0307099cc3...0f5ccf934e01c75e467e6f35e883cf95bae74f2c,1,12,1,13,2,2013-09-26 15:08:54,2013-09-10 18:21:15
0f5ccf934e01c75e467e6f35e883cf95bae74f2c...8637ba710e8bd10ee36aa5c71f5ef54ab9037dfa,3,6,3,9,4,2013-09-26 15:08:54,2013-09-04 09:41:38
8637ba710e8bd10ee36aa5c71f5ef54ab9037dfa...ac194fc696fb95045ee5b634d04a9f7093f45685,1,11,0,11,1,2013-09-26 15:08:54,2013-09-04 09:44:11
ac194fc696fb95045ee5b634d04a9f7093f45685...87e248f52458eca2a40ed6e54e36de89228f6790,2,3,2,5,3,2013-09-26 15:08:54,2013-09-04 10:03:45
87e248f52458eca2a40ed6e54e36de89228f6790...f317a6b6fe31685445ac97a1475136c5ab7860b5,4,18,7,25,11,2013-09-26 15:08:54,2013-09-05 12:40:12
f317a6b6fe31685445ac97a1475136c5ab7860b5...53851474c0b8127442ce11ab38fa0ae8d5c694f0,1,48,0,48,3,2013-09-26 15:08:54,2013-09-10 20:15:18
53851474c0b8127442ce11ab38fa0ae8d5c694f0...fcd41fe51ae0418d583f3d33dfac7fc0879ca30e,1,260,9,269,10,2013-09-26 15:08:54,2013-09-04 10:55:48
fcd41fe51ae0418d583f3d33dfac7fc0879ca30e...a89a51128ecdf2db02a333a406752416de8a1db6,2,30,1,31,2,2013-09-26 15:08:54,2013-09-04 12:21:53
a89a51128ecdf2db02a333a406752416de8a1db6...b125f2334c7b68f624ee1eee06cb9d68922d0314,1,18,0,18,4,2013-09-26 15:08:55,2013-09-04 13:44:01
b125f2334c7b68f624ee1eee06cb9d68922d0314...8f343ea65a05b374ffa64940a1946abf28402689,1,22,10,32,10,2013-09-26 15:08:55,2013-09-05 13:32:57
8f343ea65a05b374ffa64940a1946abf28402689...8e8ef7cb5b208ac657af812ebc5ffa783664cf3b,3,142,7,149,7,2013-09-26 15:08:55,2013-09-05 16:03:49
8e8ef7cb5b208ac657af812ebc5ffa783664cf3b...8f23945f7f666e3151890de90ebb39db3c7f5ada,1,2,1,3,2,2013-09-26 15:08:55,2013-09-05 18:11:18
8f23945f7f666e3151890de90ebb39db3c7f5ada...223280f31967edb7b3eb325cce8a3b82939c0f2b,3,77,11,88,12,2013-09-26 15:08:55,2013-09-05 20:10:29
223280f31967edb7b3eb325cce8a3b82939c0f2b...94fa3c7bb5cadc31b64630b0fe8abfaeba0644aa,2,40,1,41,2,2013-09-26 15:08:55,2013-09-05 20:14:19
94fa3c7bb5cadc31b64630b0fe8abfaeba0644aa...19ba0b851bb00248b62a40695a60fc534d0df2cb,1,5,0,5,1,2013-09-26 15:08:55,2013-09-06 10:03:21
19ba0b851bb00248b62a40695a60fc534d0df2cb...3f3f5f0bbaafc67d3f77b920194f8d7bfb7bf6ee,3,16,3,19,4,2013-09-26 15:09:31,2013-09-06 10:04:00
3f3f5f0bbaafc67d3f77b920194f8d7bfb7bf6ee...0e686fa2f4d38eb6253e92ad701dd4c9caebfdce,1,49,0,49,1,2013-09-26 15:09:31,2013-09-06 12:37:04
0e686fa2f4d38eb6253e92ad701dd4c9caebfdce...d47c18c5fbe50a2ad6ec011704f86a3c27360ff9,2,3,3,6,3,2013-09-26 15:09:31,2013-09-06 12:38:47
d47c18c5fbe50a2ad6ec011704f86a3c27360ff9...bc7fa7b95773d638754eb72e7921ac328acb2ad6,3,8,11,19,11,2013-09-26 15:09:31,2013-09-06 14:15:44
bc7fa7b95773d638754eb72e7921ac328acb2ad6...6938a36c6985336205f1db247baec5e56fdac466,1,14,9,23,2,2013-09-26 15:09:31,2013-09-10 19:04:25
6938a36c6985336205f1db247baec5e56fdac466...a7fd1fce5d6fb29a8c627022da7cbbf0f4b740c7,1,2,1,3,2,2013-09-26 15:09:31,2013-09-09 09:46:16
a7fd1fce5d6fb29a8c627022da7cbbf0f4b740c7...261b0b01dffde42595d987b609d38c3b6d8368f7,1,6,0,6,1,2013-09-26 15:09:31,2013-09-09 10:06:55
261b0b01dffde42595d987b609d38c3b6d8368f7...251a7ed437c17ecb66d33782f0b42633033198dd,3,24,8,32,8,2013-09-26 15:09:31,2013-09-09 10:39:42
251a7ed437c17ecb66d33782f0b42633033198dd...c6e8813c979bbea8832f47dc6468e805a1a18c3e,4,63,5,68,12,2013-09-26 15:09:32,2013-09-09 11:47:29
c6e8813c979bbea8832f47dc6468e805a1a18c3e...3343b3f8f8520c2a1a841675609b4b2c54f3533d,1,1,1,2,1,2013-09-26 15:09:32,2013-09-09 11:48:58
3343b3f8f8520c2a1a841675609b4b2c54f3533d...e1c418cac3cf06d453c7ac10dd54b2b0f617f1f6,1,1,1,2,1,2013-09-26 15:09:32,2013-09-09 12:18:20
e1c418cac3cf06d453c7ac10dd54b2b0f617f1f6...2566e2604c2e079f9597749a1da11f22bb39eb51,1,9,1,10,2,2013-09-26 15:09:32,2013-09-09 12:44:19
2566e2604c2e079f9597749a1da11f22bb39eb51...20bac716b525e1cbd2a778122a4ce41c0c2768c2,1,7,2,9,4,2013-09-26 15:09:32,2013-09-09 13:56:59
20bac716b525e1cbd2a778122a4ce41c0c2768c2...d80be57c1538905a46f75c95d592acec49a498d6,1,33,0,33,1,2013-09-26 15:09:32,2013-09-12 13:17:39
d80be57c1538905a46f75c95d592acec49a498d6...e40f5c7cb90fbc719241ace45b05c2c61aced658,2,31,1,32,4,2013-09-26 15:09:32,2013-09-12 13:18:11
e40f5c7cb90fbc719241ace45b05c2c61aced658...c199ed228baf0e5d33b7739cc2442a32dece7020,2,17,62,79,3,2013-09-26 15:09:32,2013-09-12 18:30:55
c199ed228baf0e5d33b7739cc2442a32dece7020...d478a4bb5401d7d657a2a100f98ee892a96fef2a,1,1,1,2,1,2013-09-26 15:09:32,2013-09-13 09:08:59
d478a4bb5401d7d657a2a100f98ee892a96fef2a...02b5f1369ce09d597336e77df98e56d467b8d1ff,1,137,52,189,22,2013-09-26 15:09:32,2013-09-13 10:56:58
02b5f1369ce09d597336e77df98e56d467b8d1ff...99c7d129f422b488f478bc7887f37003dacc83e6,1,43,12,55,8,2013-09-26 15:09:32,2013-09-13 13:45:58
99c7d129f422b488f478bc7887f37003dacc83e6...36603e68e33dd5ab5c317c181e023f7ef7356434,1,13,6,19,2,2013-09-26 15:09:32,2013-09-13 13:49:57
36603e68e33dd5ab5c317c181e023f7ef7356434...ad0a6a03e3595aa04cf731cf17e90be87163389a,1,94,1,95,3,2013-09-26 15:09:32,2013-09-13 13:56:06
ad0a6a03e3595aa04cf731cf17e90be87163389a...adae6849871fad0d74945fa1731712ea784e9a88,3,71,5,76,12,2013-09-26 15:09:32,2013-09-13 13:58:14
adae6849871fad0d74945fa1731712ea784e9a88...5415804c9d7af6c75a147252ac17f71b9c3f0069,1,0,1,1,1,2013-09-26 15:09:32,2013-09-13 14:04:07
5415804c9d7af6c75a147252ac17f71b9c3f0069...cda87540135a85bd8d45d4eb4853d6962114ec55,1,43,0,43,5,2013-09-26 15:09:32,2013-09-13 14:35:56
cda87540135a85bd8d45d4eb4853d6962114ec55...062a2b32e9500107841a52d3a63b9232a1cfde70,1,6,2,8,4,2013-09-26 15:09:32,2013-09-13 14:36:32
062a2b32e9500107841a52d3a63b9232a1cfde70...cc28829429f5f11da287ecb75ee5b3e5f05d31ad,1,1,1,2,1,2013-09-26 15:09:32,2013-09-19 12:39:47
cc28829429f5f11da287ecb75ee5b3e5f05d31ad...ed658156133862b3f181c9d3061be24b91435095,1,14,4,18,2,2013-09-26 15:09:32,2013-09-19 12:57:22
ed658156133862b3f181c9d3061be24b91435095...009d0f9d81bbd5e130520986ce84e8f097d88a52,1,3,0,3,3,2013-09-26 15:09:32,2013-09-19 12:59:27
009d0f9d81bbd5e130520986ce84e8f097d88a52...f99f39abaa5a43e9abc19add5b9d1253a1d22485,1,2,2,4,2,2013-09-26 15:09:33,2013-09-19 13:44:43
f99f39abaa5a43e9abc19add5b9d1253a1d22485...67788723c99cda8b41e5a488b988e2a72732d684,2,13,0,13,2,2013-09-26 15:09:33,2013-09-19 17:20:05
67788723c99cda8b41e5a488b988e2a72732d684...41399ac005caa4de2dbb744e48f058f6a15e2d2b,1,1,0,1,1,2013-09-26 15:09:33,2013-09-19 17:22:23
41399ac005caa4de2dbb744e48f058f6a15e2d2b...395bce4c4174014cb3264c35a7c6f97a2cb0948f,2,22,0,22,3,2013-09-26 15:09:33,2013-09-19 18:38:06
395bce4c4174014cb3264c35a7c6f97a2cb0948f...6c7ae06435d6e288024691f1133d7a2a24fd8ef3,1,5,0,5,2,2013-09-26 15:09:33,2013-09-19 17:23:35
6c7ae06435d6e288024691f1133d7a2a24fd8ef3...03320f0d1c5a687ec46cbf6d836cc91576b3b225,2,46,0,46,4,2013-09-26 15:09:33,2013-09-19 18:32:11
03320f0d1c5a687ec46cbf6d836cc91576b3b225...d263aa6ca916ba9141f341447a2387e7a6316717,1,1,1,2,1,2013-09-26 15:09:33,2013-09-24 12:16:11
d263aa6ca916ba9141f341447a2387e7a6316717...c1e25d7273f7f520a0dbac675db4e7e26c8a4a9b,4,19,10,29,11,2013-09-26 15:10:01,2013-09-24 17:20:58
c1e25d7273f7f520a0dbac675db4e7e26c8a4a9b...5e1d540209342fa2d6e2ab7117062a897ccf8fe8,5,11,20,31,12,2013-09-26 15:14:03,2013-09-26 15:08:26
5e1d540209342fa2d6e2ab7117062a897ccf8fe8...ebfa24acb08504d8da3fcba8da897fed357f34b2,11,116,388,504,72,2013-09-26 15:40:13,2013-09-26 15:40:13
06c1f000e8791b9cc62eeb2e5edbeeb326a03de6...792403f2dc38cf880ae79d44093914f9b54eb031,1,48,0,48,13,2013-09-26 07:16:15,2013-09-26 07:16:15
792403f2dc38cf880ae79d44093914f9b54eb031...34e28ccc880d8b7919d029c0028d51cfd2f5f01a,2,89,92,181,21,2013-09-26 08:15:36,2013-09-26 08:15:36
34e28ccc880d8b7919d029c0028d51cfd2f5f01a...818ec10da3813dfd582450093739cc4619e99b6d,1,2,2,4,2,2013-09-26 08:19:49,2013-09-26 08:19:49
818ec10da3813dfd582450093739cc4619e99b6d...ce05083d4bd78a8c8272742095cf662fa86739ef,1,2,2,4,2,2013-09-26 21:57:02,2013-09-26 21:57:02
06c1f000e8791b9cc62eeb2e5edbeeb326a03de6...8f5c33dc1f923bb8478524be4f10581685e5d359,1,2,0,2,1,2013-09-25 20:57:04,2013-09-25 20:57:04
cd9886f0a873e2d5bfb0fe058b34e442a304bc3b...a2fb870ce30d87aa7a08cca4c2e45c4d021c99c4,1,1,1,2,1,2013-08-11 01:04:04,2013-08-11 01:04:04
bdc0e8f82507160d6b00feb00cc5bdb0af95c293...5f7abd5347fc28ff36b59a03a90dceee22e16606,1,321,0,321,1,2013-08-05 17:02:57,2013-07-25 00:44:55
5f7abd5347fc28ff36b59a03a90dceee22e16606...97d1d6f5d20c1475b7cdfcecdf4eeba08de888bd,1,10,4,14,7,2013-08-05 17:02:57,2013-07-25 02:22:36
97d1d6f5d20c1475b7cdfcecdf4eeba08de888bd...6926ba558f14da4e48ff5c409a5e78f1e9e0e991,1,19,6,25,10,2013-08-05 17:02:57,2013-07-25 19:57:09
6926ba558f14da4e48ff5c409a5e78f1e9e0e991...310ddec823cbeadf694c396b27b5610474f05bcc,1,1,1,2,1,2013-08-05 17:02:57,2013-07-27 00:28:17
310ddec823cbeadf694c396b27b5610474f05bcc...553ce165c1235542d3a5dd526c063c7a4b9904f4,1,7,2,9,3,2013-08-05 17:05:14,2013-07-31 17:03:14
553ce165c1235542d3a5dd526c063c7a4b9904f4...29f69211c957a62f13b10036a579191a920f62a7,1,15,0,15,5,2013-08-05 17:06:00,2013-07-31 17:05:06
29f69211c957a62f13b10036a579191a920f62a7...97b7b173b999c7422a3b045c3ceffa331a7239ca,1,209,166,375,1,2013-08-05 17:06:00,2013-07-31 17:07:31
97b7b173b999c7422a3b045c3ceffa331a7239ca...484ba4a8c5cd4c06330bdd5fb58f98f07619e2aa,1,11,10,21,10,2013-08-05 17:06:00,2013-07-31 17:12:40
484ba4a8c5cd4c06330bdd5fb58f98f07619e2aa...9159c819c3baf33844f0cc38a4baa0c6674e8b9a,1,2,2,4,3,2013-08-05 17:06:00,2013-08-05 14:22:46
9159c819c3baf33844f0cc38a4baa0c6674e8b9a...2c85b964e3be0f7ca3ff513b855f7bd26b936cc9,1,1,10,11,2,2013-08-05 17:07:23,2013-08-05 17:07:23
2c85b964e3be0f7ca3ff513b855f7bd26b936cc9...8aa9985ad07f71fa9bd3b31dde81c0da6d0dc655,1,7,21,28,5,2013-08-05 18:28:05,2013-08-05 18:28:05
15bc2240ac56a3f584bdc33865c896bac961c6a3...d4eab77f0c604e10f63519833dc25fbd5a3419bf,26,326,210,536,149,2013-08-14 23:21:36,2013-08-14 01:05:35
9662f9e56adeb92d3749c12bc1ce08928bbfc54b...1d8562b290d636c61aba13e8148963210c5f89aa,1,3,2,5,1,2013-08-14 21:27:46,2013-08-14 21:27:46
588f8e1ceceb100f6b58ed6c676897ec2a72d3fe...5a8c32dc8e3f7a8980b2b7feeed0a2ba5ec027c2,4,40,11,51,12,2013-08-23 22:16:03,2013-08-22 19:15:31
5a8c32dc8e3f7a8980b2b7feeed0a2ba5ec027c2...29be20f987a7a7bb8aeb89bd15ae31840b0b5df5,1,1,1,2,1,2013-08-23 22:16:11,2013-08-23 02:32:09
29be20f987a7a7bb8aeb89bd15ae31840b0b5df5...59281d6f805a7f569af6bdb509fe3257fef05156,1,1,1,2,1,2013-08-23 22:16:23,2013-08-23 16:13:30
59281d6f805a7f569af6bdb509fe3257fef05156...15d658d36bcc8bc9226be87a01a3ab7cc7e4ac6f,1,0,2,2,1,2013-08-23 22:16:49,2013-08-22 22:12:28
15d658d36bcc8bc9226be87a01a3ab7cc7e4ac6f...7b5c579b7744877af02777a82aa8c7b28cfc1172,1,3,1,4,1,2013-08-23 22:20:36,2013-08-23 20:01:08
7b5c579b7744877af02777a82aa8c7b28cfc1172...5105263dacc9372771d9bf478dcac6fceedb9a30,2,7,1,8,2,2013-08-23 22:23:30,2013-08-23 22:23:30
6178dc7f1be0d3c90ed02e8ccbafa4d7e103508d...4ff649a4eaf5c653176d2fecbfdb6571f0d0d174,1,4,3,7,2,2013-08-09 21:38:29,2013-08-09 19:56:37
4ff649a4eaf5c653176d2fecbfdb6571f0d0d174...722d4e916a727716f7f7b330c8fbea4bc089d62f,1,1,0,1,1,2013-08-09 21:39:03,2013-08-09 21:39:03
6178dc7f1be0d3c90ed02e8ccbafa4d7e103508d...db9d68c3e42a187a735082776b671d23651f4334,1,14,7,21,5,2013-08-09 17:50:58,2013-08-09 17:50:58
ea2486d6316b005eb55f8784acfdfd94ed7aba63...22df1249b582a80f0a1c57d647549d0b91f1cb30,1,11,1,12,1,2013-08-04 13:26:56,2013-08-04 13:26:56
ea2486d6316b005eb55f8784acfdfd94ed7aba63...3a123bc479457c4dfa14e39b7c42d9a9dccf8c32,6,44,26,70,14,2013-08-02 16:18:54,2013-08-02 16:18:54
3a123bc479457c4dfa14e39b7c42d9a9dccf8c32...b9f06959244e3f77eb212c7c234b06eb7b750999,1,83,19,102,12,2013-08-02 19:12:38,2013-08-02 19:12:38
ea2486d6316b005eb55f8784acfdfd94ed7aba63...793fd983ef937d2bea1edf5d8d855e2a452a4aa7,1,129,0,129,1,2013-08-02 06:47:58,2013-08-02 06:47:58
793fd983ef937d2bea1edf5d8d855e2a452a4aa7...7dac26ce69b442d55122caa2897572d3ac8255fa,1,15,86,101,24,2013-08-02 07:08:08,2013-08-02 07:08:08
7dac26ce69b442d55122caa2897572d3ac8255fa...6a56b7b391ac967540915c2ee8f82b23714ad84c,2,15,5,20,9,2013-08-02 07:23:46,2013-08-02 07:23:46
6a56b7b391ac967540915c2ee8f82b23714ad84c...4bd287e107eab1623a0e77aeaecda77fc26e7536,3,13,3,16,5,2013-08-02 07:30:45,2013-08-02 07:30:45
4bd287e107eab1623a0e77aeaecda77fc26e7536...5bc344ab73f73a1fb5bea0933a031ad0418cb8f8,1,3,6,9,4,2013-08-02 08:10:26,2013-08-02 08:10:26
5bc344ab73f73a1fb5bea0933a031ad0418cb8f8...7bade49d4c661c5037de586e6f69291999038ef9,1,3,3,6,3,2013-08-02 18:08:16,2013-08-02 18:08:16
ea2486d6316b005eb55f8784acfdfd94ed7aba63...2424480e2ce14d848c041c53cc041aab91308081,1,5,6,11,1,2013-08-02 05:24:38,2013-08-02 05:24:38
940d58806c3e3d4409a7eee4859335e98139d09f...def9598ed968eac934699db1b8717f852652b1ef,1,3,0,3,1,2013-08-12 04:22:33,2013-08-12 04:22:33
940d58806c3e3d4409a7eee4859335e98139d09f...529ee848da1f1dd4b628c3396289b4bcffdbd540,1,7,1,8,1,2013-08-12 00:27:47,2013-08-12 00:27:47
940d58806c3e3d4409a7eee4859335e98139d09f...64b817a5c12545252d0cbb3d4ce1f23996bb266b,1,5,5,10,2,2013-08-11 09:52:16,2013-08-11 09:52:16
940d58806c3e3d4409a7eee4859335e98139d09f...025c759e443cc4eb43fc20b1f7da5520956b3b30,1,2,2,4,2,2013-08-11 07:37:16,2013-08-11 07:37:16
025c759e443cc4eb43fc20b1f7da5520956b3b30...02b8d14bdd1837aad5b8fb667d1f4e7eace59687,1,39,0,39,1,2013-08-11 08:24:21,2013-08-11 08:24:21
940d58806c3e3d4409a7eee4859335e98139d09f...3bd73a96333e011738136f6a9eda23642cc204ab,2,90,29,119,5,2013-08-10 04:55:23,2013-08-10 04:55:23
3bd73a96333e011738136f6a9eda23642cc204ab...57b49efc98d2f4605c95d5579a6cd952dfd6f124,2,12,4,16,4,2013-08-10 06:37:57,2013-08-10 06:37:57
b6c4b325a446f9eb5829af3d6a7d0222cf0f22b6...754ed9043d6e1fed98160c7fb443bed0a9464acf,3,25,2,27,5,2013-08-06 15:57:13,2013-08-03 20:55:54
b6c4b325a446f9eb5829af3d6a7d0222cf0f22b6...ba17f4a06a75a66e11b6cf2ca2cdb5bee4f7bfa8,4,19,11,30,10,2013-08-06 14:31:51,2013-08-06 14:31:51
b6c4b325a446f9eb5829af3d6a7d0222cf0f22b6...b9149f45bf6bdef3b7025fe7c94a930696a4b4ab,1,8,8,16,4,2013-08-06 13:21:26,2013-08-06 13:21:26
58e0c68132ba59ac79f403e46b232a16cd5f0a8c...75ac50a9a0669b464a95e069e66da5d47df9182f,2,67,86,153,23,2013-08-03 23:43:20,2013-08-03 23:43:20
75ac50a9a0669b464a95e069e66da5d47df9182f...4089a20cf476d2241b051d9ba913b7adde90661d,2,8,7,15,7,2013-08-04 00:27:15,2013-08-04 00:27:15
4089a20cf476d2241b051d9ba913b7adde90661d...bdaa87ff2158781c0772e1cab26b52ae6ec07ce4,1,2,1,3,2,2013-08-04 04:30:07,2013-08-04 04:30:07
bdaa87ff2158781c0772e1cab26b52ae6ec07ce4...8a18999d2352d9c93e44935222e24874476c5018,2,2,2,4,2,2013-08-18 04:08:00,2013-08-18 04:08:00
8a18999d2352d9c93e44935222e24874476c5018...45543d012e98de5ed9b1e415c8ce417fe02d3c55,2,15,15,30,8,2013-08-18 04:29:37,2013-08-18 04:29:37
45543d012e98de5ed9b1e415c8ce417fe02d3c55...276d2bbf1d400415bec8d4652ac61e570b9206e3,1,0,2,2,1,2013-08-18 05:22:11,2013-08-18 05:22:11
276d2bbf1d400415bec8d4652ac61e570b9206e3...e69f7142190451eb1e0553e2dfab8e916dc9cead,1,1,1,2,1,2013-08-18 05:22:49,2013-08-18 05:22:24
e69f7142190451eb1e0553e2dfab8e916dc9cead...6aff117164a8e665aa9e417ab019581297336d2e,1,5,3,8,1,2013-08-18 05:28:05,2013-08-18 05:28:05
d49f141fb3dc79bc4a22bbf398410f8d712bcf36...1d654f615673aecb32011bd5a28c2ac43dbbc1fb,2,2,7,9,3,2013-08-06 18:40:16,2013-08-06 18:40:16
d49f141fb3dc79bc4a22bbf398410f8d712bcf36...ff6b6f2ce1f51c38b00d1a70376182645b4a0c85,7,53,50,103,37,2013-08-05 22:55:40,2013-08-05 22:55:40
65a4e308258f4cd85237adf4934c630e3b8f1039...10190be5d74bc4b13a885f2ba27c2299c868fd19,7,25,3,28,8,2013-08-07 22:28:39,2013-08-03 22:06:58
10190be5d74bc4b13a885f2ba27c2299c868fd19...ccffa6976616ddf5fc8c83f84d17e53ca8e0bca9,1,1,0,1,1,2013-08-07 22:28:39,2013-08-03 22:15:24
ccffa6976616ddf5fc8c83f84d17e53ca8e0bca9...3e491f8698860ed92b9f4cd6790eda82e083ae1e,1,1,1,2,1,2013-08-07 22:28:40,2013-08-05 22:26:06
4399f65fb88ffd1f98be4eb630cda242f84f4254...97a2dc96f23b25bc7980d2a4514b7065ff4edb9e,1,0,45,45,1,2013-07-28 19:57:09,2013-07-28 19:57:09
faf103e6ec8ee07637c002fd9e0b8d0caf11ec1d...a97d858b2a0d6bc4d044a241036b97fd78f93022,1,0,61,61,2,2013-07-26 17:21:17,2013-07-26 17:21:17
f35491190a91fb078cb1e5b3319434a6acfa024e...5dc86d7bca17c2996264a18cc26f06d30e532588,2,2,2,4,2,2013-07-29 21:17:15,2013-07-29 21:17:15
a438d505ba6107abf5490f74f15de3fdafb81b86...17ffb0ac84874656a61a477fa29048cb82b28748,7,59,3,62,14,2013-07-29 16:45:19,2013-07-29 16:45:19
a438d505ba6107abf5490f74f15de3fdafb81b86...b15cfd3530cc228dc065746c9323758c8abb0481,1,1,1,2,1,2013-07-26 21:57:16,2013-07-26 21:57:16
950d0312dccde9826ea1e4c26dafab0dc56a59bb...8ca7b0646e6c4346075656f46847f53c2e868a3d,6,226,247,473,37,2013-07-29 18:30:17,2013-07-17 19:13:22
8ca7b0646e6c4346075656f46847f53c2e868a3d...e3f68b22d8f0635a8c08ab56721e56dbe570a49a,3,17,9,26,11,2013-07-29 18:30:17,2013-07-22 21:50:32
e3f68b22d8f0635a8c08ab56721e56dbe570a49a...0badda9f1587c11a13dca17c68b30addd757237c,3,38,13,51,13,2013-07-29 18:30:17,2013-07-22 22:40:33
0badda9f1587c11a13dca17c68b30addd757237c...0f134b4bf81a4d0160932852854b190b7ee7e3b9,3,5,5,10,5,2013-07-29 18:30:17,2013-07-22 22:44:55
0f134b4bf81a4d0160932852854b190b7ee7e3b9...394941b6b0a30fecf8ae7b6de5880fa553141f93,2,5,5,10,4,2013-07-29 18:30:17,2013-07-22 23:16:31
394941b6b0a30fecf8ae7b6de5880fa553141f93...5b27652ac6eaf1bc4c2a16e51919ec4272a58fd6,2,25,11,36,12,2013-07-29 18:30:21,2013-07-22 23:44:34
950d0312dccde9826ea1e4c26dafab0dc56a59bb...f7542664e3efb35b6b153dc2b2cc9cdac181989a,2,2,2,4,2,2013-07-29 18:03:09,2013-07-29 18:03:09
7c9604e32beea824238c0f2ac055577feb307786...dcf9dfb12961fc8101624af0b925d026fde4cde1,1,1,1,2,1,2013-08-05 23:32:25,2013-08-05 23:32:25
93b258413f07861cc3b57917fb102313881f4630...53a07d547554adc61b82f3ff794c0c9c0686be73,1,14,12,26,5,2013-10-14 21:00:06,2013-10-14 21:00:01
0367032bd174b279eb24f53b277f352833601bf4...9041d6a47bef475aa58bb47b38f49ac408fb94bf,1,22,10,32,7,2013-10-10 16:23:24,2013-10-10 16:23:24
0367032bd174b279eb24f53b277f352833601bf4...8abd328f53a207bd7b560197927ca49f12d2c9c8,1,3,3,6,2,2013-10-10 11:14:18,2013-10-10 11:14:18
0367032bd174b279eb24f53b277f352833601bf4...152037f011de00cbe06069687024bc345c76b0c6,1,1,1,2,1,2013-10-10 08:10:33,2013-10-10 08:10:33
4c7d24bc8b4bf436ba72d98089767e72a8f3f960...84a3600ea82d1a3ea235f1193092206c1f0c011a,1,2,6,8,3,2013-11-11 21:54:17,2013-11-11 21:54:17
4b9e475a3d903564e17dba87ec54990967f7f66e...f2ea539467e34ef06455a3e0561bac1f5a482822,1,1,1,2,1,2014-01-07 20:51:17,2014-01-07 20:51:17
4b9e475a3d903564e17dba87ec54990967f7f66e...7c4e5fbd4608bb4b1509552fbe9d3c0bcd7c347a,2,10,1,11,2,2014-01-07 20:45:40,2014-01-07 19:51:51
4b9e475a3d903564e17dba87ec54990967f7f66e...97ef8a067c77cb8d15e6e336264c6eb21b25a0fb,1,6,5,11,4,2014-01-07 19:46:07,2014-01-07 19:46:07
ff567f87293bfea3f9750bf2b07d97d7f3d1d85c...13c521526ddc88e2502d9fe331faef51fe747cd2,1,11,3,14,9,2013-10-26 00:17:33,2013-10-26 00:17:33
ff567f87293bfea3f9750bf2b07d97d7f3d1d85c...1cbdaebaa1c2326e57945333420d25d6f77011d5,46,4241,742,4983,357,2013-10-25 22:13:24,2013-10-05 02:25:15
1cbdaebaa1c2326e57945333420d25d6f77011d5...515070d5138c205e65cd029443c84408ad593ef6,2,1,16,17,4,2013-10-25 22:13:24,2013-10-10 01:28:17
515070d5138c205e65cd029443c84408ad593ef6...4576d0f802f864db35bab2130180888abe207c8a,2,17,0,17,4,2013-10-25 22:13:24,2013-10-10 02:44:31
4576d0f802f864db35bab2130180888abe207c8a...f7a2f0b93746d33da42b892abc6d5e0a05741321,2,3,1,4,3,2013-10-25 22:13:24,2013-10-10 02:45:45
f7a2f0b93746d33da42b892abc6d5e0a05741321...ce965b8c43f91f0c32403cfaadfd4e279421090b,3,31,21,52,5,2013-10-25 22:13:24,2013-10-10 20:48:22
ce965b8c43f91f0c32403cfaadfd4e279421090b...bf61d41d6cc1c56967396b5609030732954baa2f,1,548,0,548,1,2013-10-25 22:13:24,2013-10-10 08:04:06
bf61d41d6cc1c56967396b5609030732954baa2f...607c1a520e6d39d0f0ee21f1d281931484206b57,1,10,1,11,3,2013-10-25 22:13:24,2013-09-17 13:02:12
607c1a520e6d39d0f0ee21f1d281931484206b57...494cd07f722d6bf5f2e69a6d2d729848882e1971,2,27,52,79,9,2013-10-25 22:13:24,2013-09-19 08:57:11
494cd07f722d6bf5f2e69a6d2d729848882e1971...249f5a65a55ac9f68c65d57a7e7b5ac486060b97,1,38,0,38,1,2013-10-25 22:13:24,2013-09-18 08:53:00
249f5a65a55ac9f68c65d57a7e7b5ac486060b97...d063c8d941d366e4815b91c4fa4fc91fc1e1eb23,6,23,23,46,13,2013-10-25 22:13:24,2013-10-10 08:49:18
d063c8d941d366e4815b91c4fa4fc91fc1e1eb23...db999667245926569b161747eed7e08b2ec1c34c,4,21,3,24,6,2013-10-25 22:13:24,2013-10-10 08:53:38
db999667245926569b161747eed7e08b2ec1c34c...0e24db3a68cabed1ff8cf8dd10854c5de201329f,3,5,27,32,7,2013-10-25 22:13:24,2013-10-17 00:08:14
0e24db3a68cabed1ff8cf8dd10854c5de201329f...99a9783abcf5db6ead15228fcf7bc962fff548f5,1,1,1,2,1,2013-10-25 22:13:24,2013-10-17 17:59:46
99a9783abcf5db6ead15228fcf7bc962fff548f5...387aeb78fb1f518a3c8982d73701f5b7faa1c59c,1,15,25,40,8,2013-10-25 22:13:24,2013-10-17 18:40:38
387aeb78fb1f518a3c8982d73701f5b7faa1c59c...c4923757f1f92c160a34d0a591f6e62d8d94dea3,3,7,4,11,5,2013-10-25 22:13:25,2013-10-17 19:43:25
c4923757f1f92c160a34d0a591f6e62d8d94dea3...256b7537e332c68d0fa35b60e06726c40ed66312,3,22,32,54,25,2013-10-25 22:13:25,2013-10-17 23:22:14
256b7537e332c68d0fa35b60e06726c40ed66312...89fb51f6063467124c8883399fc293faae8d8ef5,5,12,11,23,12,2013-10-25 22:13:25,2013-10-18 21:15:24
89fb51f6063467124c8883399fc293faae8d8ef5...6c863b49ef9de8f203c84f7e2e55f33deeb10bdb,3,3,39,42,4,2013-10-25 22:13:25,2013-10-18 23:02:08
6c863b49ef9de8f203c84f7e2e55f33deeb10bdb...dbe7d67c183d2fcea2748dd09751c79bc9810b88,1,2,6,8,3,2013-10-25 22:13:25,2013-10-21 22:42:27
dbe7d67c183d2fcea2748dd09751c79bc9810b88...fb8d488896bd147aa810c9736fce1186b8d769b5,4,6,9,15,9,2013-10-25 22:13:25,2013-10-18 05:36:28
fb8d488896bd147aa810c9736fce1186b8d769b5...d7897508516c05e7ffea5b96053ec80c7771d777,3,3,4,7,3,2013-10-25 22:13:25,2013-10-18 05:38:34
d7897508516c05e7ffea5b96053ec80c7771d777...cf86e2bb226c82a991eb392e426e707cf8193c03,4,3,3,6,3,2013-10-25 22:13:25,2013-10-18 05:39:57
cf86e2bb226c82a991eb392e426e707cf8193c03...21161dbd515fb97cf9052a5980de6fc6180a89dc,9,163,8,171,14,2013-10-25 22:13:25,2013-10-18 05:40:41
21161dbd515fb97cf9052a5980de6fc6180a89dc...7072d2aacab5cd85ed78298b1a0c3ca3b68ed30c,1,2,0,2,1,2013-10-25 22:13:25,2013-10-22 21:54:04
7072d2aacab5cd85ed78298b1a0c3ca3b68ed30c...7c08aeeba4ab94f77e221bfc01741cce0866d224,6,156,177,333,85,2013-10-25 22:13:25,2013-10-22 23:23:52
7c08aeeba4ab94f77e221bfc01741cce0866d224...0c9b319dd0c29621c76cf63d494c9781e3f4ea00,1,2,1,3,2,2013-10-25 22:13:25,2013-10-23 07:08:45
0c9b319dd0c29621c76cf63d494c9781e3f4ea00...7d440f70fd1ba10efa9ab239516dca461535da95,1,2,1,3,2,2013-10-25 22:13:25,2013-10-23 18:01:17
7d440f70fd1ba10efa9ab239516dca461535da95...7c882a800309f2a2870c57e85232ae8888bcef25,2,6,8,14,4,2013-10-25 22:13:25,2013-10-23 22:21:28
7c882a800309f2a2870c57e85232ae8888bcef25...66a159342bfa1b2bb8361f21a17279aa0417bb50,1,10,4,14,3,2013-10-25 22:13:25,2013-10-23 23:41:59
66a159342bfa1b2bb8361f21a17279aa0417bb50...640682d56c9694da092e084492e3f3e96bca5c76,2,2,2,4,2,2013-10-25 22:13:25,2013-10-24 00:27:41
640682d56c9694da092e084492e3f3e96bca5c76...da864a845b94db64de8dcee12f62c26c57008f71,1,1,1,2,1,2013-10-25 22:13:25,2013-10-24 00:32:40
da864a845b94db64de8dcee12f62c26c57008f71...e179a24ad5f86d27377007303a2991870d173ce0,1,2,2,4,1,2013-10-25 22:13:25,2013-10-24 15:57:40
e179a24ad5f86d27377007303a2991870d173ce0...94e5081baca9a3b3408d3a6ffa2926d1e262d6fe,2,22,10,32,3,2013-10-25 22:13:26,2013-10-24 16:08:50
94e5081baca9a3b3408d3a6ffa2926d1e262d6fe...2e6b241dc70c0f1ed6745af1f27b11bf77c84f3b,1,7,0,7,1,2013-10-25 22:13:26,2013-10-24 17:25:07
2e6b241dc70c0f1ed6745af1f27b11bf77c84f3b...356af1540f9a43337571e0f3ad6038789b38478e,5,46,31,77,21,2013-10-25 22:13:26,2013-10-24 23:49:28
356af1540f9a43337571e0f3ad6038789b38478e...516cf548433ca17098533110fffc1998c7114e2e,2,23,18,41,10,2013-10-25 23:49:49,2013-10-25 23:49:49
516cf548433ca17098533110fffc1998c7114e2e...d5c7e92a9a8ba65e1b2aad0f21393e8986d03d55,1,1,1,2,1,2013-10-26 00:36:23,2013-10-26 00:36:23
9bceae244044435647e843ffdd040322507d182b...f903feee03d4df4361c79a44b6f5d78d4718b350,1,7,1,8,2,2013-10-21 20:58:56,2013-10-21 09:30:18
9bceae244044435647e843ffdd040322507d182b...7e09c6332de11538e170b4d25ccd5bfa068ffd1e,1,1,1,2,2,2013-10-20 06:15:36,2013-10-20 06:15:36
9bceae244044435647e843ffdd040322507d182b...3b0cbc59ea4da94cd9013fe60e83919d1a5859aa,1,25,6,31,3,2013-10-20 05:56:14,2013-10-20 05:40:28
9bceae244044435647e843ffdd040322507d182b...95f3f77fc417bbc55f03e869136deec27e26bc51,5,78,34,112,24,2013-10-19 05:33:16,2013-10-19 05:33:16
9bceae244044435647e843ffdd040322507d182b...bba5fd455567f831270ff60bd6991481d5340958,2,8,3,11,2,2013-10-19 01:00:44,2013-10-19 01:00:44
aa6c99aff604faf3f483372c11e4e10f9d7fc80e...c9375d14fc6b7f2a0d3b40fc736b6aed20e010d3,1,23,15,38,2,2013-10-24 17:54:06,2013-10-24 17:54:06
489c370fcca781ae10faae19b69209745302de22...656b66e51b18ff9f5f2720c3ce9ff9ec2937f05f,1,6,5,11,2,2013-10-24 18:19:06,2013-10-24 18:19:06
7a116220e79b7ef8116c4726dced2a25ecc0873c...8e43db95f2299f9b63ab3d1728e73f2a5f6600b3,4,5,5,10,5,2013-10-23 20:08:16,2013-10-23 20:08:16
5eb472025ad37539e86305cec9b139f77ce8dff8...8227ea35cfc6a8e7e3da7baed5bfa8a62e304df5,2,10,8,18,3,2013-10-31 01:31:18,2013-10-31 01:26:01
5eb472025ad37539e86305cec9b139f77ce8dff8...1099d172a2f083c456c3564d403e666e965a9544,4,35,6,41,9,2013-10-31 00:41:20,2013-10-18 23:39:40
5eb472025ad37539e86305cec9b139f77ce8dff8...be7eb4bfcb09e17a2c45179bab268ba15050cb6a,4,49,20,69,14,2013-10-30 23:48:12,2013-08-13 22:40:23
be7eb4bfcb09e17a2c45179bab268ba15050cb6a...25c4c87c86aca2f17363dbcd9d7bc47640ff9c23,2,21,7,28,5,2013-10-31 00:19:09,2013-08-14 00:31:04
25c4c87c86aca2f17363dbcd9d7bc47640ff9c23...1c3a674444c6a6f08ea5ce3812046a00678e4a29,3,13,9,22,8,2013-10-31 00:19:32,2013-08-15 00:14:30
e661473bcd6ff39ce7364cbed0b7b6455eb25f51...865649d7ac7e5ebb5b3debf65b626e96a88836b5,1,29,20,49,10,2013-10-28 20:08:21,2013-10-23 22:03:04
e661473bcd6ff39ce7364cbed0b7b6455eb25f51...0e021ed470a1014bb924ad7067d85540f8f1e71a,1,2,2,4,2,2013-10-24 22:06:10,2013-10-24 22:06:10
0e021ed470a1014bb924ad7067d85540f8f1e71a...acc2aec988450b117c183f35a4e743b882a55113,3,2,9,11,6,2013-10-24 22:13:47,2013-10-24 22:09:01
acc2aec988450b117c183f35a4e743b882a55113...a675e249b133fe35eaf02fb0bdb807cfd4efe969,2,48,0,48,10,2013-10-24 23:57:35,2013-10-24 22:43:14
e661473bcd6ff39ce7364cbed0b7b6455eb25f51...b9eb5e04aeac870a9a45ae8961cfb3578af26787,1,4,2,6,2,2013-10-24 22:04:58,2013-10-24 20:00:51
e661473bcd6ff39ce7364cbed0b7b6455eb25f51...0e44864b666b5b0139cdf8ec5a001fee661bf212,1,4,7,11,5,2013-10-24 21:54:04,2013-10-24 21:54:04
4f6ce1ba9e304462354d29483b95bdef3f647b52...79bf2c2b0e898fdc93db66ddc1622bb79c0b83f8,2,12,5,17,5,2013-10-30 16:02:23,2013-10-30 15:15:12
79bf2c2b0e898fdc93db66ddc1622bb79c0b83f8...5fb6d6e47c41d7ca3eda71ef6fd9dab824b1daa1,3,28,15,43,7,2013-10-30 20:06:34,2013-10-30 18:13:10
5fb6d6e47c41d7ca3eda71ef6fd9dab824b1daa1...6a9fb81c5794166fc62e8fc5c638127d69f13eee,1,3,0,3,1,2013-10-30 20:06:39,2013-10-30 18:24:50
6a9fb81c5794166fc62e8fc5c638127d69f13eee...4fd389eee5675479e9f3414d79ac38f1ebcd0428,2,15,14,29,14,2013-10-30 20:06:43,2013-10-30 18:45:11
4fd389eee5675479e9f3414d79ac38f1ebcd0428...596facd1240036c91dd9579991aeb89f9f81f6eb,3,3,3,6,3,2013-10-30 20:06:47,2013-10-30 20:18:48
596facd1240036c91dd9579991aeb89f9f81f6eb...1edde0e8a38bfb50fc5d2ccc76a4659422a856c4,2,56,116,172,24,2013-10-30 20:11:02,2013-10-30 18:59:05
1edde0e8a38bfb50fc5d2ccc76a4659422a856c4...ec488fa1231a9a5240dc0cd38c99ca3241fcaf7c,1,18,9,27,4,2013-10-30 22:06:01,2013-10-30 21:36:38
ec488fa1231a9a5240dc0cd38c99ca3241fcaf7c...3ff845904daabc47ed8f40b2edf3711b364ef206,1,1,1,2,1,2013-10-30 22:06:28,2013-10-30 21:39:26
0174951195b6d02e226cb709040d3b3beb2312fd...da054148dc17c869c6b7958d48d3abc9fe1cdcf9,2,30,1,31,2,2013-10-29 21:42:20,2013-10-29 21:42:20
7df8ec2093729b460c88656cb8d3fa6118f0dc58...7b1c6ccabd1c1276c80abc1e818b45804a5d05ed,2,78,105,183,3,2013-10-17 00:11:21,2013-10-11 01:22:23
7b1c6ccabd1c1276c80abc1e818b45804a5d05ed...d401e9d3ace06d3291ddd96a8ab8aa690d5935dc,1,19,17,36,3,2013-10-17 21:11:10,2013-10-17 21:11:10
7df8ec2093729b460c88656cb8d3fa6118f0dc58...dab84f7e8bc1647f70782731e797fd827c7ce42a,15,95,238,333,49,2013-10-16 21:38:24,2013-10-16 21:38:24
b081a740b3073816e8a00bd6a2070690a475ade7...723de8768145cb47fdb6af399043f9313ad29cdb,2,9,7,16,5,2013-09-26 21:52:37,2013-09-26 21:52:37
534a991cff405a469754f6afc4fd8aa4be79e444...45bd52d472c3131c7ad5077cf8b20a241d82c555,1,1,1,2,1,2013-10-01 16:16:10,2013-10-01 16:16:10
deb05a36e8cb0361c7900b128e594cd6db06ba73...06d0843a61843e6b16a56d518e21032a5652098b,5,29,21,50,17,2013-10-03 16:32:47,2013-10-01 03:14:54
06d0843a61843e6b16a56d518e21032a5652098b...8b2f4aab232880cb0d7faa18ae12adb33f483b2c,10,299,343,642,193,2013-10-03 03:18:15,2013-10-03 03:18:15
8b2f4aab232880cb0d7faa18ae12adb33f483b2c...7b58e15b08349dba35bf3813f77a0b900c2e4df5,1,20,6,26,4,2013-10-03 17:54:14,2013-10-03 17:54:14
7b58e15b08349dba35bf3813f77a0b900c2e4df5...1a1be5a87c2169def7b0b0c29fc5cbac850a00a5,1,21,0,21,3,2013-10-03 19:00:16,2013-10-03 19:00:16
f435970695e896ae8532cd0850700ae56d0b0516...537149829accde869430924cf988f64cfbd16f99,1,10,14,24,2,2013-09-27 18:10:55,2013-09-24 00:53:02
f435970695e896ae8532cd0850700ae56d0b0516...f4855a7cf00cc96cfffc5cb704b3b2493fe3601e,1,27,0,27,1,2013-09-27 16:19:17,2013-09-27 14:36:20
ebfa24acb08504d8da3fcba8da897fed357f34b2...75e958bf48a83de5f3f80859aee96f3356d16d4b,1,15,10,25,5,2013-09-26 21:59:37,2013-09-26 19:12:12
72660a1a2f8a51fbfb8ccb283f110d84ed1b9939...7f9ba14b18e171589a82e8dd3bd084ece3405f83,2,6,6,12,5,2013-08-14 23:43:43,2013-08-14 23:43:43
13acf72a3e21fe1d1515deb6a421181817822086...999a8d72492c7937aa9f826406ae40158017f766,1,20,1,21,2,2013-08-12 22:16:49,2013-08-12 22:15:52
6249cc3373ccc18ae154a8861bb98e772639c0ce...ceb33818cdce434281889b75c278e43b85aec647,1,31,9,40,7,2013-08-08 18:51:31,2013-08-07 23:35:38
7c03bd1e7a8c62fcbcfeaf7d11809098fb347164...120a520a225725475348b718a81562c6d6c1da86,1,1,1,2,1,2013-08-06 02:58:48,2013-08-06 02:58:48
3f95d1b9bfca277995cfcc82b2bfe2f77a2648ea...9b2a5964fc2067014f24e26bd2f99873751ebdc3,25,47,47,94,41,2013-08-12 17:53:06,2013-08-12 17:53:06
3f95d1b9bfca277995cfcc82b2bfe2f77a2648ea...703905d7ece5b4a71ae1faf2743341ace98c4fbb,3,16,12,28,14,2013-08-12 11:50:03,2013-08-12 11:50:03
703905d7ece5b4a71ae1faf2743341ace98c4fbb...123c80467bb6e7bef22827b55640a4789e42558d,2,35,0,35,2,2013-08-12 11:55:23,2013-08-12 11:55:23
3f95d1b9bfca277995cfcc82b2bfe2f77a2648ea...d52c1490753cb924aa2aeeefc92fbe7a985f4cd3,2,151,1,152,3,2013-08-12 10:03:43,2013-08-12 10:03:43
d52c1490753cb924aa2aeeefc92fbe7a985f4cd3...3af60bf37565de35643c95eae9fd4ddc863c21fc,1,10,1,11,4,2013-08-12 13:30:52,2013-08-12 13:30:52
c5d8844d80e2c1ec3021662dd97e6a812a922258...d7979ef2d0044dc7def9238f0a1aed909f0590bb,3,2,3,5,4,2013-08-15 11:42:40,2013-08-15 11:42:40
0dbc51f4d237e7d029c2e37d76fae198b6e37af5...5b8cfbe15c29efd3e72ea97ba87867590aeeba25,10,202,1,203,13,2013-08-06 16:09:54,2013-07-17 04:07:41
5b8cfbe15c29efd3e72ea97ba87867590aeeba25...d94b1860806e11038086e91c693d86a009dcd3b0,4,22,7,29,8,2013-08-06 16:09:54,2013-07-17 14:25:49
d94b1860806e11038086e91c693d86a009dcd3b0...583f5868c989b9da574638ffdc532826e5070347,2,33,32,65,3,2013-08-06 16:09:54,2013-08-06 16:01:09
cc80bd41c43da818e464a35e572fa456fd4a8796...075d30dbced0e00843153a6975daa1291e90b339,1,1,1,2,1,2013-08-08 00:44:33,2013-07-05 23:16:58
075d30dbced0e00843153a6975daa1291e90b339...18fc707fdf06aeb50fa5250f59f0ef4597d7cf73,1,34,8,42,2,2013-08-08 18:25:02,2013-08-08 18:25:02
cc80bd41c43da818e464a35e572fa456fd4a8796...6a6a2ad8a4af85b543a24c5d22a2be5fdfc252d6,1,2,2,4,2,2013-08-08 00:23:49,2013-08-08 00:23:49
35fef275b3978a22d0e285cd7fa554b4447e6958...ce53e21ea6790cf7c2e96f8c5f0725bdf41a80f0,1,3,2,5,3,2013-09-01 23:12:07,2013-09-01 23:12:07
d627ff969735d44201fc88539d388ad87f102cda...467dbb75f10ae97e785a127a7547a5015cbb2a99,1,3,1,4,2,2013-08-21 15:28:13,2013-08-21 15:28:13
d627ff969735d44201fc88539d388ad87f102cda...2f6ce27fde04456284457ff686c8f78ab9bd6d71,2,38,4,42,5,2013-08-21 14:37:58,2013-08-21 14:37:58
2f6ce27fde04456284457ff686c8f78ab9bd6d71...cc18a9c650305a377150c67e5ed10f1e2f19b685,1,13,1,14,2,2013-08-27 19:14:21,2013-08-27 19:14:21
d627ff969735d44201fc88539d388ad87f102cda...62e84785b6ffec04a39cf611d7eaff21f2532195,2,29,3,32,5,2013-08-21 13:23:12,2013-08-21 13:23:12
62e84785b6ffec04a39cf611d7eaff21f2532195...c349b4d56c338bc43c81667bb927518b923998cb,1,10,10,20,7,2013-08-21 13:48:39,2013-08-21 13:48:39
d627ff969735d44201fc88539d388ad87f102cda...aa2ab5143b82cb63e061fe735b8c9ca9f84e0c55,3,0,79,79,3,2013-08-21 02:31:30,2013-08-07 03:46:50
aa2ab5143b82cb63e061fe735b8c9ca9f84e0c55...9087ef9a770789e6987cd1ca4396d6b20a446724,3,4,2,6,5,2013-08-21 02:32:37,2013-08-07 03:49:55
9087ef9a770789e6987cd1ca4396d6b20a446724...9fce6f662ae3e31832bbc45938e509824bea67d5,1,9,0,9,3,2013-08-21 02:32:37,2013-08-07 03:51:12
9fce6f662ae3e31832bbc45938e509824bea67d5...89ee5242291c50402973ffb73fe1dbbf5820e44c,3,111,105,216,6,2013-08-21 02:34:10,2013-08-07 04:00:50
89ee5242291c50402973ffb73fe1dbbf5820e44c...ccc3969536f875719fca446fa5ad8f69557dbe84,1,81,0,81,1,2013-08-21 02:34:10,2013-08-07 04:16:13
ccc3969536f875719fca446fa5ad8f69557dbe84...13201775dedcb4a544bba32e5d8366eb561093d7,1,1,1,2,1,2013-08-21 02:34:10,2013-08-07 04:16:51
13201775dedcb4a544bba32e5d8366eb561093d7...bdbac9f7a1dd31bd5d78f50eb9fa3b3793d1d13b,2,3,2,5,3,2013-08-21 02:35:30,2013-08-09 23:08:11
bdbac9f7a1dd31bd5d78f50eb9fa3b3793d1d13b...d750060f0c39db4b88f14aa413fc1f81706a4373,1,1,1,2,1,2013-08-21 02:35:30,2013-08-09 23:47:07
d750060f0c39db4b88f14aa413fc1f81706a4373...d9f769930be1c361ac69f9d8479774f37bb39d8c,2,40,23,63,17,2013-08-21 02:35:30,2013-08-10 00:38:48
d9f769930be1c361ac69f9d8479774f37bb39d8c...749a7d0e4f9da13f238062ae0417e68128c589fd,1,10,0,10,1,2013-08-21 02:35:30,2013-08-10 00:43:02
749a7d0e4f9da13f238062ae0417e68128c589fd...ff30eb96b67a0ab078553a769456bf6669a29214,2,25,7,32,3,2013-08-21 02:35:30,2013-08-10 01:08:06
ff30eb96b67a0ab078553a769456bf6669a29214...fbd5b20c388f189ffd59da78951bfc0c623de856,1,1,0,1,1,2013-08-21 02:35:30,2013-08-10 01:10:04
fbd5b20c388f189ffd59da78951bfc0c623de856...ab4fb9bbfaabccc99e30dd104352dd110f3fd6bd,1,6,1,7,2,2013-08-21 02:35:30,2013-08-10 01:18:33
ab4fb9bbfaabccc99e30dd104352dd110f3fd6bd...bfee2c726e75181df3250248a45f89d3c2b0a812,2,12,1,13,2,2013-08-21 02:35:30,2013-08-10 01:23:48
bfee2c726e75181df3250248a45f89d3c2b0a812...9694fb85d791376dc05849f607883f50a6c79f7d,1,2,0,2,2,2013-08-21 02:35:30,2013-08-13 03:16:08
9694fb85d791376dc05849f607883f50a6c79f7d...5b0eaef60264a8a5461d85272e00c6721a19d868,2,51,19,70,6,2013-08-21 02:35:30,2013-08-13 03:16:55
5b0eaef60264a8a5461d85272e00c6721a19d868...abfa7a204de9c21ee722a45de51ebae4c004e07e,1,1,1,2,1,2013-08-21 02:35:30,2013-08-14 00:25:12
abfa7a204de9c21ee722a45de51ebae4c004e07e...87872006ceda36adc9d1e51e34177f4ba716542f,2,4,3,7,4,2013-08-21 02:35:31,2013-08-14 17:41:23
87872006ceda36adc9d1e51e34177f4ba716542f...9c06420b1876a58d2cd6ea38e5c5139ca42061fe,3,50,6,56,10,2013-08-21 02:35:31,2013-08-15 00:02:55
9c06420b1876a58d2cd6ea38e5c5139ca42061fe...5b630d436dc94c26fb551269508f76f110c618bd,1,11,6,17,5,2013-08-21 02:35:31,2013-08-15 01:01:13
5b630d436dc94c26fb551269508f76f110c618bd...0469e47674f01d3f71e979d4597eb81371f124d9,3,32,16,48,8,2013-08-21 02:36:06,2013-08-15 01:35:17
0469e47674f01d3f71e979d4597eb81371f124d9...c8c69a1499c195cae1669e7cbd4cf96ad19181fc,1,1,1,2,1,2013-08-21 02:36:06,2013-08-16 18:59:20
c8c69a1499c195cae1669e7cbd4cf96ad19181fc...a8059059c6d6e83cac23fd84e552d4d98ccf3e57,2,17,3,20,5,2013-08-21 02:36:06,2013-08-16 22:30:50
a8059059c6d6e83cac23fd84e552d4d98ccf3e57...b5a48eaed34b81253334575fccf5cb6f1b01fc61,5,108,135,243,3,2013-08-21 02:36:06,2013-08-16 23:05:16
b5a48eaed34b81253334575fccf5cb6f1b01fc61...e06372d6f434ae64f3cbafddee5491d1e2570584,2,12,8,20,2,2013-08-21 02:36:06,2013-08-16 23:10:12
e06372d6f434ae64f3cbafddee5491d1e2570584...885afebe07c79f54df9c1c4a8c71fcb323f3c944,1,1,1,2,1,2013-08-21 02:36:42,2013-08-21 02:36:42
885afebe07c79f54df9c1c4a8c71fcb323f3c944...8a7c0495e0251c9b74db2c74d09397fb158ed512,2,0,2,2,2,2013-08-21 03:50:42,2013-08-21 03:49:16
d627ff969735d44201fc88539d388ad87f102cda...2c147dd721c5a92fa86af0ab4a6b9b9ebcd8d546,1,98,0,98,1,2013-08-20 22:08:15,2013-08-20 22:08:15
d627ff969735d44201fc88539d388ad87f102cda...30726c378572f8aa2256875b1b39b94144acff80,3,22,14,36,9,2013-08-20 19:18:29,2013-08-20 19:18:29
30726c378572f8aa2256875b1b39b94144acff80...ee64e099e06175ec9c7735b591f51cfcdfbdd6fe,3,188,0,188,6,2013-08-20 19:32:32,2013-08-20 19:32:32
ee64e099e06175ec9c7735b591f51cfcdfbdd6fe...5e3386473a4d4c37da348c4111164449deb6dc6b,1,15,0,15,1,2013-08-22 00:39:45,2013-08-22 00:39:45
d627ff969735d44201fc88539d388ad87f102cda...75f4fd978d234efbc3a5c5c55ea162a9a68246d9,2,134,10,144,7,2013-08-20 02:13:26,2013-08-20 02:13:26
d627ff969735d44201fc88539d388ad87f102cda...e9a1246527c229528286e6c9c41ec38cca9d2566,1,1,0,1,1,2013-08-19 18:54:51,2013-08-19 18:54:51
9130ee7513bda99a2e51fb3fbb512cd73cde810f...84790aafd8b3050e502a16f03ee288c1bb9c21b6,1,3,3,6,2,2013-08-07 01:31:05,2013-08-07 01:31:05
9130ee7513bda99a2e51fb3fbb512cd73cde810f...9f1c9686e0ee47289adeeedd6cf8d5296a058463,1,2,2,4,1,2013-08-07 00:24:10,2013-08-07 00:24:10
9130ee7513bda99a2e51fb3fbb512cd73cde810f...e0a6f27d1bbf053baf8a94c87fddd3f9ed30964c,1,9,2,11,2,2013-08-06 20:56:29,2013-08-06 20:56:29
97a2dc96f23b25bc7980d2a4514b7065ff4edb9e...b2aa877bf0a3f140516d1c17117369b2194f2b91,1,2,1,3,1,2013-07-29 16:40:35,2013-07-29 16:40:35
97a2dc96f23b25bc7980d2a4514b7065ff4edb9e...63876e7dbdd372745855345632af62b8cd976dfa,1,1,7,8,1,2013-07-29 12:15:27,2013-07-29 12:15:27
63876e7dbdd372745855345632af62b8cd976dfa...3852d0599097581d5dc0bcfcb7aa010d564beb9a,2,24,4,28,4,2013-07-29 12:16:01,2013-07-29 12:16:01
3852d0599097581d5dc0bcfcb7aa010d564beb9a...bb241c10e2f124406f00c8e40e00fca67934638a,1,2,2,4,2,2013-07-29 12:16:14,2013-07-29 12:16:14
bb241c10e2f124406f00c8e40e00fca67934638a...73c6d9f135493220f034d440d26fedc0242e133a,1,19,2,21,3,2013-07-31 07:56:53,2013-07-31 07:56:53
73c6d9f135493220f034d440d26fedc0242e133a...a7068510a5ee4af6776221ba00bc332266f97088,1,1,6,7,1,2013-07-31 08:01:20,2013-07-31 08:01:20
a97d858b2a0d6bc4d044a241036b97fd78f93022...5eb590e79d081ecfa82ba940ea856c4a2c0411ca,2,25,1,26,20,2013-07-26 19:48:01,2013-07-26 19:44:06
a97d858b2a0d6bc4d044a241036b97fd78f93022...bdc79ac8b2dfad302f9e144711067a566726cfa2,1,2,0,2,1,2013-07-26 19:45:00,2013-07-26 19:40:55
dcf9dfb12961fc8101624af0b925d026fde4cde1...fea2d5f2fe81d983efbdd803cef2fd1c70f98ebc,1,3,2,5,3,2013-08-07 00:44:39,2013-08-06 17:00:45
dcf9dfb12961fc8101624af0b925d026fde4cde1...049d28868e87df084748a91db5d1cfecb0de6d00,1,7,1,8,1,2013-08-06 01:11:13,2013-08-06 01:11:13
dcf9dfb12961fc8101624af0b925d026fde4cde1...8934f13615e95a0c9f4bc52eefb5c97360e114f3,3,6,6,12,5,2013-08-06 00:12:56,2013-08-05 22:56:02
f4a98b4598bfa46c0ae69c853d01c50adb9d4a8a...4967f9f19ca9ead375f7d0b3252f543082806c36,2,1,1,2,1,2013-10-15 08:26:10,2013-10-15 08:26:10
4967f9f19ca9ead375f7d0b3252f543082806c36...095aab9d975a149c33729a0b4981d5b2649167d2,1,198,52,250,7,2013-10-15 09:44:03,2013-10-15 08:26:52
f4a98b4598bfa46c0ae69c853d01c50adb9d4a8a...a0e5657cb6c795ddc7c124a9dadd10bac26a5ed3,1,0,1,1,1,2013-10-15 06:58:34,2013-10-15 06:57:17
97779ff7cfc2dbee34ad6741223534181079a6af...d62df6b2b587fce29eec769ab60efb81cf4062b5,1,2,0,2,1,2013-10-11 17:00:04,2013-10-11 17:00:04
60e426938e491a8b10b353bbeb67b2e3cbc3d439...310a1742604173ac88a052b04f0b117772ab63ff,1,11,0,11,1,2013-10-10 22:32:33,2013-10-10 20:25:59
60e426938e491a8b10b353bbeb67b2e3cbc3d439...2eb404ab14ef4b70e101cbb43c124651553de5d2,1,2,0,2,2,2013-10-10 18:47:25,2013-10-10 18:46:26
60e426938e491a8b10b353bbeb67b2e3cbc3d439...967010ae8c7eb2f6482a9245b42731b7ead61e4b,1,1,1,2,1,2013-10-08 04:46:29,2013-10-08 04:46:29
f9e14cc83884e246478c315964a2fcae03d5e8a8...3779291e9b2f939aa98b91b35552bd9b76c9f39a,1,1,1,2,1,2014-01-07 22:27:51,2014-01-07 22:25:38
110b944f45ed1e1b3d4a14e2eb785c70b62800fc...8f39f0b57da8d06386ff915511ee4d5dd55352f6,3,6,6,12,6,2013-10-26 00:50:40,2013-10-26 00:50:40
d5c7e92a9a8ba65e1b2aad0f21393e8986d03d55...971cf56d89ac9cc4959800bdfaadb69ba2cdd06a,2,58,0,58,2,2013-10-28 22:19:52,2013-10-28 21:23:33
d5c7e92a9a8ba65e1b2aad0f21393e8986d03d55...60b97576cfc2e43bfc5d09fa8ea2b71777d1f2b3,2,29,0,29,1,2013-10-26 21:14:50,2013-10-25 04:45:37
60b97576cfc2e43bfc5d09fa8ea2b71777d1f2b3...0d1a825137448e2f41e5aaa5ecae8094c8ab6817,6,260,60,320,20,2013-10-26 21:18:13,2013-10-21 16:04:42
0d1a825137448e2f41e5aaa5ecae8094c8ab6817...2a29bf624536c9daed25966dcaf80d840d0972c3,3,91,0,91,3,2013-10-26 21:18:28,2013-10-23 08:35:26
2a29bf624536c9daed25966dcaf80d840d0972c3...1b8eef4efbdd308f0dff0ae063ea49c0f4142888,3,21,11,32,4,2013-10-26 21:21:04,2013-10-23 06:53:40
1b8eef4efbdd308f0dff0ae063ea49c0f4142888...7e691e11b033f35fe823fbc6dcb40decd584696d,6,17,19,36,16,2013-10-26 21:24:13,2013-10-23 08:09:16
7e691e11b033f35fe823fbc6dcb40decd584696d...c542b2f873f181d7cb3127b4700a01bd62f43fbf,2,3,3,6,3,2013-10-26 21:24:25,2013-10-23 08:00:31
c542b2f873f181d7cb3127b4700a01bd62f43fbf...c1ae1a0e1cfae1aed681add5b1cb1c39e2c0e929,3,67,57,124,12,2013-10-26 21:26:07,2013-10-25 06:30:34
c1ae1a0e1cfae1aed681add5b1cb1c39e2c0e929...464ded79fcd46dbdf8859811912a244006626e86,1,1,0,1,1,2013-10-26 21:28:53,2013-10-26 21:28:53
464ded79fcd46dbdf8859811912a244006626e86...e8491ae54cad1e7d8aaffdae84f81d3c6c8e377a,1,13,5,18,5,2013-10-27 00:17:45,2013-10-27 00:17:45
e8491ae54cad1e7d8aaffdae84f81d3c6c8e377a...a13241d370bb9862acdefbc7dbb1e338d9552eaa,3,8,16,24,5,2013-10-27 00:49:16,2013-10-27 00:49:16
26adda6c31d53275444aaf97ac2c15ebd712a11c...a1fc8e17a79818977375d5e97a1afdc5f2d2fca8,1,2,4,6,2,2013-10-21 21:03:09,2013-10-21 21:03:09
e37a7d49818581a17303aacd06baf1db6835cfd6...652f07bb59e9c46d5f3e375c4a99d0b23771e0ad,2,7,0,7,5,2013-10-31 18:28:30,2013-10-31 18:10:25
36c7a7ae943220ffb1bea9cd47d2f586db00eab2...a5031d47d9ca283c1fd9db1e94cd19f9b9a73af9,1,102,0,102,2,2013-11-01 04:52:39,2013-11-01 04:52:39
a5031d47d9ca283c1fd9db1e94cd19f9b9a73af9...318dd33fb778282c3012ee06d892d6375e98cd6b,1,59,0,59,1,2013-11-01 05:06:35,2013-11-01 05:06:35
318dd33fb778282c3012ee06d892d6375e98cd6b...86dd2473c1351df87520111b1b1ba9953f9e5f09,1,72,0,72,1,2013-11-01 05:06:49,2013-11-01 05:06:49
86dd2473c1351df87520111b1b1ba9953f9e5f09...d64df7c7659560d520a7d8ad8987083e4d52cefc,2,89,10,99,13,2013-11-01 19:04:08,2013-11-01 19:04:08
d64df7c7659560d520a7d8ad8987083e4d52cefc...d2c2c2c1162498e6f7c2b9298795e3ef77b6523b,2,5,5,10,4,2013-11-01 19:30:30,2013-11-01 19:30:30
d2c2c2c1162498e6f7c2b9298795e3ef77b6523b...d23b9e87344bd7c153e05abdd05cc28840814a22,1,7,0,7,1,2013-11-02 21:25:06,2013-11-02 21:25:06
d23b9e87344bd7c153e05abdd05cc28840814a22...b77c5c59840a731c721bbce37765cd475c2cee23,1,18,18,36,15,2013-11-04 17:22:43,2013-11-04 17:22:43
b77c5c59840a731c721bbce37765cd475c2cee23...6c77f2c1894e906a28a64a4991b4fc2c89cd9ad6,2,0,0,0,0,2013-11-04 17:23:46,2013-11-04 17:23:46
429c3108daee9a9448ac7fa401fd1ad7525c3722...13ab83a8a5d5ebd97dc8490355c0b9064d8fe57c,1,622,403,1025,45,2013-10-31 02:30:32,2013-08-26 22:37:12
13ab83a8a5d5ebd97dc8490355c0b9064d8fe57c...ca2bbe716c22d90410d388a710642f76f06826df,1,23,8,31,10,2013-10-31 02:30:32,2013-10-31 02:29:08
31fd11860b871ef9504a3d9d4c339e872cfa1822...ee27444098aa91d69f8df6dd07139b9637719b1d,1,22,5,27,7,2013-10-07 19:41:10,2013-09-28 12:37:29
31fd11860b871ef9504a3d9d4c339e872cfa1822...d89ce09a76e7934338d4966d05f6b67618c8bfb0,2,19,2,21,3,2013-09-28 13:54:34,2013-09-28 13:54:34
31fd11860b871ef9504a3d9d4c339e872cfa1822...e3e041b6bf0066fa5e65625694517ff387fee3b1,29,1582,5683,7265,274,2013-09-28 02:54:52,2013-09-25 02:47:25
b4e1b8d2e25d5729a3fce258d89d3c9a67f56512...7c28683f08a485916e748713b0697ea3eb84a9e2,1,717,754,1471,221,2013-10-07 01:52:18,2013-10-07 01:39:31
b4e1b8d2e25d5729a3fce258d89d3c9a67f56512...0f830aa431b513d5ac2ee4f9e1239d860bbb4a01,1,2,2,4,2,2013-10-02 22:27:34,2013-10-01 22:51:33
b4e1b8d2e25d5729a3fce258d89d3c9a67f56512...cb21a4049052a012fd71dcaceef2bb57e1ed36f8,2,2,2,4,2,2013-10-02 01:48:50,2013-10-02 01:47:38
b4e1b8d2e25d5729a3fce258d89d3c9a67f56512...509e25cf04cf1984ae0c9112a8c380492d177be8,3,30,8,38,4,2013-10-01 23:26:14,2013-10-01 23:26:14
509e25cf04cf1984ae0c9112a8c380492d177be8...5025b4d09443019e1e8636288f3e6dbb085253cd,1,0,5,5,1,2013-10-01 23:32:56,2013-10-01 23:32:56
b4e1b8d2e25d5729a3fce258d89d3c9a67f56512...135c1fce90eeaee9f6aef5d0119028cd017a1a73,1,2,2,4,2,2013-10-01 22:59:52,2013-10-01 22:59:52
b4e1b8d2e25d5729a3fce258d89d3c9a67f56512...d517fd3d77cea103008e7f937f1629048cdba24a,1,1,4,5,2,2013-10-01 22:49:32,2013-10-01 22:49:32
1a1be5a87c2169def7b0b0c29fc5cbac850a00a5...f7e374fb3a51bd25e61ae6c4343838a0ca756fba,1,0,1,1,1,2013-10-04 13:36:30,2013-10-04 13:36:30
f7e374fb3a51bd25e61ae6c4343838a0ca756fba...9b65c7cf49feacad61cdcd11d2b002319a6b6bae,1,1,1,2,1,2013-10-04 13:38:47,2013-10-04 13:38:47
9b65c7cf49feacad61cdcd11d2b002319a6b6bae...aaf1f73bcc2c594f07254a98ff77de3cc6351e92,1,6,1,7,2,2013-10-04 13:47:43,2013-10-04 13:47:43
1a1be5a87c2169def7b0b0c29fc5cbac850a00a5...b8439987184df45ee9571f9eb9d607518d96aeb8,2,13,12,25,8,2013-10-04 01:04:14,2013-10-04 00:58:18
b8439987184df45ee9571f9eb9d607518d96aeb8...f29c500d8d480547874425ba98a9381fdc9df89e,4,172,129,301,41,2013-10-04 01:05:07,2013-10-04 01:00:24
bcce3cbdd1cb4d79272c0cbfa43ef0847be1b9d9...88f710f0e79eafe469e09a3ea990bdbe0c7d0a52,1,1,1,2,1,2013-09-30 12:44:09,2013-09-30 12:44:09
88f710f0e79eafe469e09a3ea990bdbe0c7d0a52...fb46d911c204ddda381325c5f1e43277b7b231c2,1,1,1,2,1,2013-09-30 23:33:12,2013-09-30 23:33:12
bcce3cbdd1cb4d79272c0cbfa43ef0847be1b9d9...649605915428e0ee81cf49d15e949d48da20110c,1,6,0,6,2,2013-09-30 11:07:32,2013-09-30 11:07:32
4778039dd2724accdba870cdaf1315d34bb67831...5f05cb481760d551dcc3607b3c4dd48897b59cbd,1,0,13,13,1,2013-10-02 22:06:22,2013-10-02 22:06:22
514886c73dd6626799564e6309177ea8045324bf...55189307d0ec6992f76572fae675bd371cc36cff,1,3,3,6,3,2013-10-03 15:47:38,2013-10-03 15:47:38
25d71fb01b1ffce2e6704e0c9c1bb2c80ca6053f...8b26e4ea3c92748a96b90fa245ccce7c7eebb81c,1,1,1,2,1,2013-08-14 21:31:18,2013-08-14 21:31:18
4caa6047934ad3046847d8802520615dec785e92...bca19a22c50d3ff085c8d7accf35d35e6dde4d6a,1,6,2,8,1,2013-08-15 17:26:07,2013-08-15 03:58:40
4caa6047934ad3046847d8802520615dec785e92...c7cda86e847d541efbc4fc8ce834d924b2b98bf1,2,19,13,32,9,2013-08-15 00:54:06,2013-08-13 20:30:08
90cb66f08d139079601dbbedf1fa9706d1bf5738...ec61c46bf73b8c727fe8de1982d86a1417a8a0c4,2,2,1,3,3,2013-08-12 22:42:29,2013-08-12 22:42:29
f6760fca88b35e879d308d88eeae15fa80aa7c98...e2409ad3376baeb36d1011732f7d7b1a239320ae,3,122,19,141,8,2013-08-13 20:45:07,2013-08-13 20:45:07
f6760fca88b35e879d308d88eeae15fa80aa7c98...e09863fedb1b2fec4672d2d1ebad29ecdb8eed1a,1,1,1,2,1,2013-08-13 16:48:30,2013-08-13 16:48:30
f6760fca88b35e879d308d88eeae15fa80aa7c98...6cb908bb823409661bfedab806da924d232bf200,1,1,1,2,1,2013-08-13 13:35:34,2013-08-13 13:35:34
6cb908bb823409661bfedab806da924d232bf200...2ba1300773857273585288c79aa65f011b045b4c,1,4,15,19,3,2013-08-13 14:02:49,2013-08-13 13:51:49
f6760fca88b35e879d308d88eeae15fa80aa7c98...5ee3c58d2549c25fa4464963831a28a99407b6cd,3,24,0,24,3,2013-08-13 12:02:17,2013-08-13 12:02:17
92a2b635a32153613f6f3592246b18539565ec7c...18962d0ff33cfa6ba2976aa459c766acfd23c1bf,2,22,11,33,11,2013-08-19 11:42:38,2013-08-16 14:29:40
92a2b635a32153613f6f3592246b18539565ec7c...0418702cfc69f3d748c7c8b00da467154944b540,1,7,16,23,9,2013-08-16 17:33:59,2013-07-03 15:24:43
92a2b635a32153613f6f3592246b18539565ec7c...2ec141da542ab7563c7104b3a950bc503e4959fb,1,15,0,15,1,2013-08-16 17:19:59,2013-08-16 17:19:59
2ec141da542ab7563c7104b3a950bc503e4959fb...674e5c850374fffa03fb205ae6b623ec069978d9,1,1,5,6,2,2013-08-16 17:30:54,2013-08-16 17:29:48
92a2b635a32153613f6f3592246b18539565ec7c...20b1e19641d94b5e71ecee7a9703eb392a81cf9a,1,11,1,12,4,2013-08-16 13:43:09,2013-08-16 13:31:50
92a2b635a32153613f6f3592246b18539565ec7c...f11fb706f6f54a0a06e80b7d4326a14ce50c1611,1,1,2,3,1,2013-08-16 11:07:37,2013-08-16 11:07:37
92a2b635a32153613f6f3592246b18539565ec7c...62b45f08278ef283b91cc91761a25f5ceca16136,1,9,0,9,3,2013-08-15 13:48:08,2013-08-15 13:44:11
4af24e11a4bcc9e907bd096b016717e87763f3dd...3104fc8d33ce4c26a446826639a7b2dba524264f,2,52,0,52,2,2013-08-07 16:05:30,2013-08-06 16:58:52
c2b273df5d69f3f0a95aacb4944a55856d40fb35...d593f579528d2555296b535aeae8383f5d2ee9b3,1,1,0,1,1,2013-08-27 19:09:26,2013-08-27 19:09:26
84431ec03c08f0d8ce8f9385aa1b709a28fef1f3...46c9c5c84317907153f06284dc5110b53a0fbf3c,2,11,2,13,3,2013-08-30 20:46:07,2013-08-30 19:45:01
84431ec03c08f0d8ce8f9385aa1b709a28fef1f3...6756e786ac36d4e5cda46541b5d6e0b2913b6997,2,6,6,12,7,2013-08-30 20:02:05,2013-08-30 00:49:11
6756e786ac36d4e5cda46541b5d6e0b2913b6997...7a9c71183212a40fdd10369d009a9f97b56fe359,2,81,6,87,9,2013-08-30 20:02:05,2013-08-30 00:29:35
348696f3fe88fbae1a1c15d34fe09398e73f6897...f5bd13721666366879e3a9681df8442181448ffc,1,1,0,1,1,2013-08-21 19:09:40,2013-08-21 19:09:40
0e6ee9632c9806a0c712ab140815103ebe6a66fa...52fe45249798991a35f5a5b5a4e1af26ea42221c,1,1,1,2,1,2013-09-04 00:10:03,2013-09-03 15:19:05
52fe45249798991a35f5a5b5a4e1af26ea42221c...91ee67954961e9f8e5b4827022c2a3aee7997253,1,1,1,2,1,2013-09-04 00:14:49,2013-09-04 00:14:49
0e6ee9632c9806a0c712ab140815103ebe6a66fa...846524115bb6d1ce850f9babba59467c1054fbdd,4,82,10,92,10,2013-09-03 22:38:06,2013-09-03 22:38:06
0e6ee9632c9806a0c712ab140815103ebe6a66fa...fac4cedcc105a7b5a6789917ddf9a5e9745bd2d3,2,152,0,152,2,2013-09-03 20:30:40,2013-09-03 20:29:07
0e6ee9632c9806a0c712ab140815103ebe6a66fa...fcee6056dc50de7698772a3049cdfa1eb0f2416f,7,199,39,238,46,2013-09-03 18:45:49,2013-09-03 18:45:49
fcee6056dc50de7698772a3049cdfa1eb0f2416f...da3bb9a7c6ad79f224ee91a2dd053c1e1b2ad053,2,22,6,28,7,2013-09-03 18:59:48,2013-08-23 07:38:33
da3bb9a7c6ad79f224ee91a2dd053c1e1b2ad053...ad322d7cca4857292d41e164058382f83a06cf98,1,19,0,19,1,2013-09-03 18:59:48,2013-08-23 12:02:24
ad322d7cca4857292d41e164058382f83a06cf98...a2603477ddd0a7eba794dd5fd917a4d88c5241da,1,0,1,1,1,2013-09-03 18:59:48,2013-08-24 19:23:14
a2603477ddd0a7eba794dd5fd917a4d88c5241da...d04beb7f4315c6b659958227954398437a69e5d6,2,34,24,58,17,2013-09-03 18:59:48,2013-08-30 19:46:19
d04beb7f4315c6b659958227954398437a69e5d6...dd4aab8411ec070baeb14ecc43f683d12b722746,2,13,9,22,6,2013-09-03 18:59:48,2013-08-30 20:49:37
dd4aab8411ec070baeb14ecc43f683d12b722746...ded973219e997f52634eb18d0cfe828472412dd8,1,6,2,8,2,2013-09-03 18:59:48,2013-08-30 21:15:07
0b9c8e286050bd7bc21e15085b34ed9779080ce6...551092f9c0da2244c60b75d893ef847f915ca604,7,109,6,115,19,2013-08-22 16:05:21,2013-08-15 23:35:03
0b9c8e286050bd7bc21e15085b34ed9779080ce6...3f802f4a13cc9d35118420f7c769a8b3531476c8,1,55,9,64,21,2013-08-22 11:23:43,2013-08-22 11:23:05
0b9c8e286050bd7bc21e15085b34ed9779080ce6...d6f53049c4ec4513a136bfd512dafe166c4ad901,1,5,2,7,3,2013-08-22 03:48:32,2013-08-22 03:48:32
d6f53049c4ec4513a136bfd512dafe166c4ad901...f352ec945fbc34eafdde04dff7ced995c9e3a409,1,4,5,9,4,2013-08-26 23:17:26,2013-08-26 21:55:21
3782e34e670c627a11a60ab96f3585d485ac8f6f...6115348dd9e302e8323b857ae8ab1061159e69cd,1,1,1,2,1,2013-08-07 11:57:31,2013-08-07 11:57:31
2409df9285f56514de6d675ecd3df678d9b5e5cc...4860df1689f2f98d65aece0f4768b8ae98301d1e,1,1,0,1,1,2013-08-07 21:24:41,2013-08-07 21:24:41
2409df9285f56514de6d675ecd3df678d9b5e5cc...0e21de9a25edfe56fa996055712d25b7a3345f0d,1,2,1,3,1,2013-08-07 16:38:49,2013-08-07 16:38:49
caa7cf14c009d8a8341423c981801512a74b9204...746ba127bfb3556d378ccd8b2c725b490d090334,2,12,5,17,5,2013-10-30 15:15:12,2013-10-30 15:15:12
caa7cf14c009d8a8341423c981801512a74b9204...86970d00bbb9c5e3184fe4e3e7442fd0865c80ec,1,0,2,2,2,2013-10-29 21:42:34,2013-10-29 21:42:34
fde157425c48a7d05e2cafb87c1ac0b168f46ee9...cbc49d7d76dfc9e259d5227a0077a83e5faf1202,1,1,1,2,1,2013-10-15 23:12:27,2013-10-15 23:12:27
fde157425c48a7d05e2cafb87c1ac0b168f46ee9...cd455ca6fa3a899153880a7b95b9d07762b4c97c,3,108,32,140,18,2013-10-15 22:52:21,2013-10-15 22:52:21
fde157425c48a7d05e2cafb87c1ac0b168f46ee9...ca56b35e5334d9f6a6741830951eb1535ca6f9b2,1,1,0,1,1,2013-10-15 09:44:56,2013-10-15 09:44:56
fde157425c48a7d05e2cafb87c1ac0b168f46ee9...ace059e409f0df056ace0191b02504d051b81d92,5,86,0,86,5,2013-10-15 09:35:13,2013-10-15 09:35:13
fde157425c48a7d05e2cafb87c1ac0b168f46ee9...e99ab1df9758bd7bd819e87bf231399ef8f031d6,1,0,0,0,0,2013-10-15 09:02:31,2013-10-15 09:02:31
e99ab1df9758bd7bd819e87bf231399ef8f031d6...9da2b3590e52d7f3409d70f183382cee6d6ff81f,1,242,0,242,1,2013-10-15 09:04:06,2013-10-15 09:04:06
a0e5657cb6c795ddc7c124a9dadd10bac26a5ed3...b7abe9dab56f79e410ef2821cbea6344a65b555b,1,6,1,7,2,2013-10-15 22:57:40,2013-10-15 21:54:52
ee256ce6bfc08fbd6d04f5abd4c69f796145abb2...94bf5b00112890ed84c38b9840802fa0142b507b,4,153,78,231,9,2013-10-11 06:53:15,2013-09-28 04:50:24
ee256ce6bfc08fbd6d04f5abd4c69f796145abb2...1dcdc3deb7cc41fe3c84c579df19c9578098a172,6,209,16,225,13,2013-10-11 01:29:10,2013-09-07 17:30:29
1dcdc3deb7cc41fe3c84c579df19c9578098a172...fac190959ffbacc95e34fc8615ff82879f8ffd18,8,73,80,153,30,2013-10-11 01:29:10,2013-09-19 23:09:12
fac190959ffbacc95e34fc8615ff82879f8ffd18...6e3068700fb32299cf733acd74785e29609b1974,4,12,8,20,5,2013-10-11 01:29:10,2013-09-21 19:14:40
6e3068700fb32299cf733acd74785e29609b1974...d542318d63b847e4494a2688b091baeb5dbde1e1,24,367,266,633,35,2013-10-11 01:29:10,2013-10-11 00:46:09
cb9e0aee485ea5b244cd1153644e7c558cd4b9a7...981560c43631e1b09b6f90945d2d5e58345cabd2,2,99,0,99,2,2013-11-12 01:38:54,2013-11-12 01:38:54
981560c43631e1b09b6f90945d2d5e58345cabd2...353243a7254705f92c3d775eec1f9cfe14fa4170,1,13,7,20,5,2013-11-12 18:11:52,2013-11-12 18:11:52
cb9e0aee485ea5b244cd1153644e7c558cd4b9a7...01dd7e74592b7b45c56d1187e7dcfaac39e67be1,2,10,34,44,5,2013-11-11 22:08:37,2013-11-11 22:08:37
eb131250aa7680812f8f7669b8fdfaaf7dbe8431...e4af8b2ddc7be8d984762ea3bf91729f85284eb9,1,22,10,32,1,2014-01-09 18:08:52,2014-01-09 18:06:48
eb131250aa7680812f8f7669b8fdfaaf7dbe8431...14acf6883db8069a10a727ed26f7ef801f460353,1,1,1,2,1,2014-01-09 17:58:40,2014-01-09 17:58:40
b942f24ba888ee7b9d579955e50b11d98d636f4f...fa14a1b9835a46bc9c48c1385b514a0f8d0b4eac,1,5,5,10,2,2014-01-07 21:56:26,2014-01-07 19:34:19
54d3b4dd28305e5a28e3339547ad465f257bad66...395a24ffd5a34f2fe1e5d7b7b5ee6c7825f51581,1,1,1,2,1,2013-10-28 06:35:09,2013-10-28 06:35:09
54d3b4dd28305e5a28e3339547ad465f257bad66...45d94944f3afe32d04eb31faa0cd9a129383f42c,1,1,1,2,1,2013-10-27 23:45:12,2013-10-27 23:45:12
c0662488c75096c94411be370010ae6a0230be8d...0d2924408bad7aa797bfaf0610e836d82928296f,23,258,307,565,151,2013-10-29 01:09:08,2013-10-28 23:58:59
e3c49843d70ea2856592a7af5e5d83e655898a70...c0e51a8f27defe3d4dde0b5805d3801cf25a6ce2,3,155,58,213,27,2013-11-01 16:18:04,2013-10-31 04:10:29
e3c49843d70ea2856592a7af5e5d83e655898a70...02b52024328996e2028d7d953ef6a9c1e2e50744,4,27,23,50,9,2013-11-01 02:14:11,2013-10-24 19:20:34
02b52024328996e2028d7d953ef6a9c1e2e50744...747967b4a4e2bfa429a76d20db77b990d23b1a0f,3,12,5,17,6,2013-11-01 02:25:55,2013-11-01 02:21:35
747967b4a4e2bfa429a76d20db77b990d23b1a0f...854cc5f55992b8bb200f470b11896a0b3cb68d4e,1,2,8,10,2,2013-11-04 23:34:51,2013-11-04 23:34:51
e3c49843d70ea2856592a7af5e5d83e655898a70...7f07ae9e42061f06886441994977a238013dd5ff,1,6,0,6,1,2013-11-01 02:00:14,2013-11-01 01:33:42
e3c49843d70ea2856592a7af5e5d83e655898a70...7848007c3ab41b3e1d733f9235a69ec59e04ead1,1,10,8,18,8,2013-11-01 01:42:44,2013-11-01 01:42:44
e3c49843d70ea2856592a7af5e5d83e655898a70...40ed10cc32fe6dbf18d13a43d42a1a9bed0df902,1,4,2,6,2,2013-11-01 01:39:44,2013-11-01 01:39:44
40ed10cc32fe6dbf18d13a43d42a1a9bed0df902...a89a98e59432109d99c08b43f670df7429145172,1,6,2,8,2,2013-11-01 01:50:58,2013-11-01 01:44:16
e3c49843d70ea2856592a7af5e5d83e655898a70...96d1e9bb5a269936afeb9748a894f6995b17e0a4,12,44,35,79,46,2013-10-31 23:57:45,2013-10-31 23:57:45
a1fc8e17a79818977375d5e97a1afdc5f2d2fca8...93810b289c6c8394061da41a59f7fa5c655be0d7,1,20,12,32,7,2013-10-22 00:03:32,2013-10-21 23:54:02
a1fc8e17a79818977375d5e97a1afdc5f2d2fca8...ea59ce60c5fc40e6708c22cf90d7cce08d12e294,1,2,0,2,1,2013-10-21 23:15:10,2013-10-21 23:15:10
65ba2868d7e0084f5edd2fc836d032f39ec39b9a...31638ab2ad2a5380d447780f05f7aa078c9421f5,16,197,184,381,129,2013-11-01 20:55:19,2013-10-31 21:58:43
31638ab2ad2a5380d447780f05f7aa078c9421f5...f9901ead069671c04a2f99c83c1e4d8a13597e7b,1,9,13,22,5,2013-11-01 20:55:19,2013-10-31 22:17:08
f9901ead069671c04a2f99c83c1e4d8a13597e7b...7ddd4fe66a00266507848e8ebc1ce3782532b51d,1,2,2,4,2,2013-11-01 21:01:32,2013-11-01 21:01:32
65ba2868d7e0084f5edd2fc836d032f39ec39b9a...9ebac49be00ad140f7a8ef156b9ae7850dd8c273,1,1,0,1,1,2013-11-01 17:31:50,2013-11-01 17:31:50
98c3693acf2db18c0d0c6211498bf6e1d8f068c6...752bfba2c5d6030d6fe3d615d0c2afd2696e7b20,5,82,19,101,21,2013-11-04 23:22:34,2013-11-04 23:22:34
98c3693acf2db18c0d0c6211498bf6e1d8f068c6...24dd838aeefcf4ea1f5a950a9fe0af075f00e2bf,1,5,5,10,5,2013-11-04 22:39:16,2013-11-04 22:39:16
24dd838aeefcf4ea1f5a950a9fe0af075f00e2bf...d11f75b5050944e373125008be1c9683797c72a9,1,9,0,9,1,2013-11-04 23:11:33,2013-11-04 23:11:33
ca2bbe716c22d90410d388a710642f76f06826df...df1621914b56b4ed20f684363247a9bb0c7acebf,1,1,1,2,1,2013-10-31 05:08:16,2013-10-31 05:08:16
ca2bbe716c22d90410d388a710642f76f06826df...f77bbfca56e45b4cb405ecb5f2c950c294375b59,1,1,1,2,1,2013-10-31 05:07:58,2013-10-31 05:07:58
ca2bbe716c22d90410d388a710642f76f06826df...87a250b71186547312dc7b5f6960aae485a465cd,1,1,1,2,1,2013-10-31 03:09:02,2013-10-31 03:09:02
ca2bbe716c22d90410d388a710642f76f06826df...ccc1a5dcfb78de8718df08db9e09ea17d9723a16,1,1,1,2,1,2013-10-31 02:52:47,2013-10-31 02:52:47
ccc1a5dcfb78de8718df08db9e09ea17d9723a16...7e7c931d2b6d667ed97957df37e26b49888933c1,1,1,1,2,1,2013-10-31 12:55:14,2013-10-31 12:55:14
ef00317a70dbc7b7cec8b475ffc36a9b7a525c78...26f4d6bf59bee7cd4290ea4e31a19da087a180f2,1,9,6,15,5,2013-10-30 23:50:58,2013-10-30 23:50:58
ff850319803a4c5910ec0a5a34134bf4af99d58e...ccefe47897bdcef8b56bf54d4bd324989855f3b5,3,28,18,46,12,2013-09-30 19:57:30,2013-09-30 19:57:30
c3acd9bece0aef08e035544122d2d9270f5d76c9...4f5c2cbccc2ef80f5372ebb4abb38d33343f2c86,1,1,0,1,1,2013-10-02 19:06:19,2013-10-02 19:06:19
1843a719117daff94b642e2e4a5b7a5db9e3fd6b...5325703c2758b394de3e12723dd8dc89b1df9b29,1,1,1,2,1,2013-08-18 04:54:10,2013-08-18 04:54:10
5325703c2758b394de3e12723dd8dc89b1df9b29...f409c119168b145157ff5329fd10ad0a8725d341,1,1,1,2,1,2013-08-18 05:10:06,2013-08-18 05:10:06
f409c119168b145157ff5329fd10ad0a8725d341...215094903a9574953af915f5b93c89858d626473,1,1,1,2,1,2013-08-21 09:08:32,2013-08-21 09:08:32
1843a719117daff94b642e2e4a5b7a5db9e3fd6b...07a887032af78e5014d635f7e1d669d49b50894d,2,14,1,15,2,2013-08-18 03:03:54,2013-08-18 03:03:54
f925edd12de4f56bf088175257b26e6234cd0c80...2191419f4cb5c452b02102a37d154fee6ca536e3,1,0,2,2,1,2013-08-22 22:12:28,2013-08-22 22:12:28
f925edd12de4f56bf088175257b26e6234cd0c80...f4a4f1ca875a1f68d5950e67b34b57542f504ecd,2,95,1,96,2,2013-08-22 21:09:50,2013-08-22 21:09:50
9cc3d7a18b7ab7d56ff0eca49c2b4db30dc1c5a6...e4f35dd4cf81a7f2d19a61cc8b1084c3adcc5253,1,1,0,1,1,2013-08-13 19:05:27,2013-08-13 19:02:20
9cc3d7a18b7ab7d56ff0eca49c2b4db30dc1c5a6...fb7c4214ced3b0533316e3eebd90ac07fe7b2933,2,26,3,29,7,2013-08-13 18:13:39,2013-08-12 17:45:12
fb7c4214ced3b0533316e3eebd90ac07fe7b2933...79fc90b6463d9b20391b4edd1540bc0a8e84da6f,1,9,0,9,1,2013-08-13 18:13:39,2013-08-12 17:52:09
79fc90b6463d9b20391b4edd1540bc0a8e84da6f...e5f1b6b9a4b934eab9c42d6534fe52672c018405,1,1,1,2,1,2013-08-13 18:13:39,2013-08-13 18:12:44
e5f1b6b9a4b934eab9c42d6534fe52672c018405...2cebe09924c9afea47bb1f2444ba1cd8fc423669,1,7,1,8,1,2013-08-13 18:28:15,2013-08-13 18:28:06
2cebe09924c9afea47bb1f2444ba1cd8fc423669...62c0f433fa794092fe2a795784f36fbac7b9feec,1,2,2,4,2,2013-08-14 03:05:44,2013-08-14 03:05:44
f1cdba29373cfd1a1da9133531b50a38d0f1ebe7...f753dfe6b3d3a8e4d770ae73e947e2fe339df536,1,13,23,36,7,2013-08-23 17:41:53,2013-08-23 17:41:53
820a3b962aa469fa3f655c7fb252548f11979c77...465d5313c50007460306a17be16f38dfd657b0a4,1,1,1,2,1,2013-08-24 17:26:54,2013-08-24 17:26:54
820a3b962aa469fa3f655c7fb252548f11979c77...02d1d238cdde7b865879de1fc3f47acacfea0e82,1,107,31,138,13,2013-08-24 17:04:40,2013-08-24 17:04:40
820a3b962aa469fa3f655c7fb252548f11979c77...1f85ed6825c07a9c2a86f995b2db484953ee1e6e,1,5,4,9,2,2013-08-24 15:49:55,2013-08-24 15:49:55
09a08e0a9f17864f5740970a715de836aff8babb...422d4afdd544656c847ecd4c62a6965d5974eba5,1,1,0,1,1,2013-08-16 21:47:39,2013-08-16 21:44:54
98f9d3e81c9b9da6cfc68799775b892b216fa8a7...f83d556bc0dec17af72bf3644fefdf0f232e206f,1,1,1,2,1,2013-08-25 00:16:52,2013-08-25 00:16:52
98f9d3e81c9b9da6cfc68799775b892b216fa8a7...3d9b4379a5b84e52a04b31129f87fd0eef3cf54d,1,3,1,4,1,2013-08-23 22:10:18,2013-08-23 20:01:08
f6653c3fa55dc4e0595fc8d3904bd5873f317441...83acd37161ed7149843546a779a95fdaf3e2458f,1,2,2,4,2,2013-08-19 13:20:25,2013-08-19 13:20:25
f6653c3fa55dc4e0595fc8d3904bd5873f317441...b21f89862076397b63eb3ac4a19b9125b6f6477a,4,8,8,16,5,2013-08-19 12:34:30,2013-08-19 12:34:30
f6653c3fa55dc4e0595fc8d3904bd5873f317441...646afab28d8ccadf81e1d18055335739b6b983d1,1,9,3,12,5,2013-08-19 12:07:49,2013-08-19 12:05:47
646afab28d8ccadf81e1d18055335739b6b983d1...41973d41e950249cd630f193a4d9250e3b3740e5,1,1,1,2,1,2013-08-20 11:52:37,2013-08-20 11:52:37
4a3b039c2ad101c884733d6313aa0a665a747e9a...98018df07856811536722df84b9558e0efdabdca,6,50,16,66,16,2013-08-27 22:20:35,2013-08-27 22:20:35
27ca0c225aebfe93c4edd2d39d188175f4b2f516...b7826f56664c85e44207ce5e1e685ed04016feb6,1,1,0,1,1,2013-09-10 16:55:27,2013-09-10 16:55:27
91ee67954961e9f8e5b4827022c2a3aee7997253...b3a70d767d913ec476bc1af53983c91a10d17f84,3,237,32,269,11,2013-09-04 00:21:40,2013-09-04 00:20:50
f2bc7ebf1ed7d907a2354a760a1eeccd5b65a668...03a28da5f78bd0f20eca3390a2dddca4ccb6ca81,2,45,0,45,3,2013-09-06 20:34:24,2013-09-06 20:34:24
f2bc7ebf1ed7d907a2354a760a1eeccd5b65a668...35bcba80116668864380319d9b6fe0249cefd114,1,4,2,6,1,2013-09-06 19:51:49,2013-09-06 19:51:49
35bcba80116668864380319d9b6fe0249cefd114...b44d11312054d1d7bc0f0bbc8eeaddc2d30c26cc,2,56,2,58,3,2013-09-06 20:16:10,2013-09-06 20:16:10
a3510c99f1ada9cd35412e27684e4bfc8459b6f8...093b85b72f7a0fcda292816716e795543b3a72eb,4,40,11,51,12,2013-08-22 19:15:31,2013-08-22 19:15:31
093b85b72f7a0fcda292816716e795543b3a72eb...1c6af604e824d8fa2896c4906f05a0a3729c8e52,1,1,1,2,1,2013-08-23 02:32:09,2013-08-23 02:32:09
5b84252c73ed0e6d3bf351099d73a4a69bacc60d...c627ff6e209ac1f660a49371d4f6bd710470aacb,17,78,203,281,35,2013-08-27 21:29:49,2013-08-27 21:29:49
5b84252c73ed0e6d3bf351099d73a4a69bacc60d...f861c493bf4d391f1721f536e86da4fa007fb7f0,4,26,0,26,2,2013-08-27 18:19:32,2013-08-27 18:19:32
5b84252c73ed0e6d3bf351099d73a4a69bacc60d...d80b50d4b4759665b93e713b99239aba9893416e,4,3,5,8,5,2013-08-27 08:05:25,2013-08-26 15:45:52
a0a5170991fa92f03f3a01477d69fcbb435b1ea2...368d0385e1d426a32da66135e7ff8d4f5a3c7a26,1,2,0,2,2,2013-09-04 11:21:44,2013-09-04 11:21:44
a0a5170991fa92f03f3a01477d69fcbb435b1ea2...58ffd03bf16f41b9c954e61ef948768f44871c28,1,2,1,3,1,2013-09-04 09:53:38,2013-09-04 09:53:38
a0a5170991fa92f03f3a01477d69fcbb435b1ea2...9ce1d02ef6b0593861809248307d058656f56304,2,99,0,99,2,2013-09-04 08:59:18,2013-09-04 08:45:54
a0a5170991fa92f03f3a01477d69fcbb435b1ea2...251d1261b0c2edfc8b014141cc03d32c30263226,1,3,3,6,2,2013-09-04 08:52:53,2013-09-04 08:52:53
bb662bc12cd7994cb7d23e49d6d2b6130613dda6...b2503a72f1f1db887fd11199036f05efe3d35992,3,28,15,43,7,2013-10-30 18:13:10,2013-10-30 18:13:10
b2503a72f1f1db887fd11199036f05efe3d35992...8fa6e2b103e436435ad0f0ae00e8cc9af4c58ad4,1,3,0,3,1,2013-10-30 18:24:50,2013-10-30 18:24:50
8fa6e2b103e436435ad0f0ae00e8cc9af4c58ad4...3362aaa4df4f1aaf4832514119f0ea25b11f1a57,2,15,14,29,14,2013-10-30 18:45:11,2013-10-30 18:45:11
3362aaa4df4f1aaf4832514119f0ea25b11f1a57...a4d97a4e80d569181835b7d55348dc755f48ce25,2,56,116,172,24,2013-10-30 18:59:05,2013-10-30 18:59:05
a4d97a4e80d569181835b7d55348dc755f48ce25...1c7ca51f3246baca6be75705ed932d26e20589e2,3,3,3,6,3,2013-10-30 20:18:48,2013-10-30 20:18:48
2a9c18af525863703f9f55e8bd4a52455791b97b...fb4672c52c050ce08c7432d2d149e37b0056e8f6,3,7,3,10,3,2013-10-30 02:03:41,2013-10-30 02:03:41
2a9c18af525863703f9f55e8bd4a52455791b97b...9420e8def7023b5247858518e43bd7ab4f2b5e48,1,23,17,40,11,2013-10-29 22:34:33,2013-10-29 22:28:12
2f4526d5c43eeba53f32a37c456cc9d761d95648...ee7d9b0bdec40d02ba5ef25f557cca9444a19669,1,1,1,2,1,2013-10-16 00:31:34,2013-10-16 00:31:34
f15cd71bb8a60473318a97564bd4b061d8b9cf6d...ad723bbfe7cda7839b3c7f82e63699bf2b9c4911,10,70,59,129,50,2013-10-11 13:04:40,2013-10-08 07:54:47
620bc5b9e1cdc04e61821fa0775656fd0227da59...d94a027da6fc75e856b31246de0b4a49206e942b,1,65,0,65,1,2013-10-16 02:26:15,2013-10-15 23:09:02
620bc5b9e1cdc04e61821fa0775656fd0227da59...1043055b10443c3b8d6b7c67c3e858a6b3ca9e00,2,4,1,5,2,2013-10-14 07:27:38,2013-10-14 07:27:38
1804fcba93368b4e115f607e060eb345b0594e62...c77697a45ca615f66351a7363e93c3903e92553f,5,345,306,651,53,2013-10-11 23:30:02,2013-10-07 12:06:24
c77697a45ca615f66351a7363e93c3903e92553f...b440ec0136793ebcfbf8d76e6cd16ccba0785382,3,57,0,57,6,2013-10-11 23:31:06,2013-10-10 13:24:39
5ca0fedffc6d4498364cf42a3812b85591fb86d9...c348c04fdfb00e013be9db15d37728e04fb94b76,2,29,1,30,2,2014-01-09 18:34:50,2014-01-09 18:34:50
45ecdf9c8e468bb93a96665fe92e526dabf2ee43...d003cfea25c276904dbe1e972c0cf71d5c25e689,2,2,3,5,3,2014-01-08 00:58:39,2014-01-07 22:54:42
3c0c75bbf9ddd335439d40139358f46fd9532fc7...91d721aaf485cd99b1fd491b6e153392882a4e72,1,87,0,87,1,2013-10-29 00:24:03,2013-10-29 00:24:03
91d721aaf485cd99b1fd491b6e153392882a4e72...3061e9f37434fa6bb0714861119ae01d8c4b35fb,2,1,14,15,2,2013-11-04 21:16:51,2013-11-04 21:16:51
3c0c75bbf9ddd335439d40139358f46fd9532fc7...50bb4a1636ea84d90700c2dce308670c9715d378,1,1,1,2,1,2013-10-28 19:48:18,2013-10-28 19:48:18
a52e23c5e42b535180f65c0b9b1d22b6b5912136...7e8b2c3836fffcd1e69edfbd8873c461bda419c7,3,34,13,47,9,2013-10-29 02:19:31,2013-10-29 02:19:31
4dc156252b952d2577834029fafce97d3db1c5f7...f2ebccb5aab6600094d92bdb6d4a8ab62bb519d2,1,4,8,12,4,2013-11-01 16:14:43,2013-11-01 16:14:43
4dc156252b952d2577834029fafce97d3db1c5f7...db2e2e831ba45f173591766160699ec0b0c77f0d,1,4,0,4,1,2013-11-01 13:59:25,2013-11-01 13:59:25
4dc156252b952d2577834029fafce97d3db1c5f7...9ee9d2f9959390d1cda56accbbd975df18d157ad,4,83,6,89,10,2013-11-01 12:00:17,2013-10-03 18:23:29
c5d4459a02ee98f629e65402551a871c451fb6ac...3560c922b193e0f6b06c715a7b920f90a5990859,4,101,2,103,7,2013-11-06 03:24:37,2013-08-18 03:49:33
c5d4459a02ee98f629e65402551a871c451fb6ac...2cac81393715e6a748b3a2316d5163604497b26c,1,1,1,2,1,2013-11-05 06:36:57,2013-11-05 06:36:57
c5d4459a02ee98f629e65402551a871c451fb6ac...fcc0ac61093d0cd0b49b11bb5f7f7501e070bd63,1,1,1,2,1,2013-11-05 04:12:18,2013-11-05 04:12:18
fc455351977157e7e833d1a5ad3ce48dbf545501...fbfb7595b141402ecb3efb2a2c9db2a2168bfbe5,1,22,25,47,4,2013-11-04 13:20:05,2013-11-04 13:20:05
fc455351977157e7e833d1a5ad3ce48dbf545501...b840b73b08a4f491d0eb8b5a05302342b8bc9242,1,3,3,6,3,2013-11-04 12:10:51,2013-10-22 12:22:24
fc455351977157e7e833d1a5ad3ce48dbf545501...1f3cdc11ee0c7088c8619f8b31bcd17ce8b79b79,2,39,16,55,13,2013-11-04 12:07:55,2013-10-30 06:26:13
fc455351977157e7e833d1a5ad3ce48dbf545501...a51fb4dd35b2324ff4f1f772202d45a944b9d5e1,1,2,2,4,1,2013-11-03 17:49:29,2013-11-03 17:49:29
fc455351977157e7e833d1a5ad3ce48dbf545501...4cbb6ce13bf93df2a9e251dfa87fbce9952ab8a6,1,26,0,26,1,2013-11-03 16:14:59,2013-10-26 13:51:56
4cbb6ce13bf93df2a9e251dfa87fbce9952ab8a6...95708dd35cd94a2c849e37efa05bb4e01ed36bb8,3,24,14,38,5,2013-11-03 19:13:18,2013-10-27 13:04:57
fc455351977157e7e833d1a5ad3ce48dbf545501...f3685333c0fdea58c8e6adbc93c95ebbc4a9fa47,1,1,1,2,1,2013-11-01 22:46:26,2013-11-01 22:46:26
33110ddc3fbb457d071fa9a53f9bb76e52dd724b...9a9d3239e10b55cc15bb38788a411d9a16c477fc,3,20,25,45,10,2013-11-15 19:38:03,2013-11-15 19:38:03
d5891f9fb08d8366dc213465e105ed2e3036b264...393562340c6f386a837eac9a616c456dc54faa4f,1,1,1,2,1,2013-10-31 21:41:49,2013-10-31 21:41:49
a93e40a158aad6f7364db5db69298e8ad7c38949...1e7c04fcfe0b1dbc93a8d70e7bf94e963aa764d8,1,11,8,19,4,2013-11-22 19:23:48,2013-11-22 19:23:48
a93e40a158aad6f7364db5db69298e8ad7c38949...8b0cd60019b33488f8819da5c7bdd28d1d3fc737,2,20,9,29,9,2013-11-22 06:05:55,2013-11-13 05:31:45
a93e40a158aad6f7364db5db69298e8ad7c38949...0198f8a879df8506189cf3024c4b64c9ea8f6aa6,2,42,2,44,4,2013-11-22 05:40:35,2013-11-19 23:27:01
a93e40a158aad6f7364db5db69298e8ad7c38949...3314e005f32f7440f1cc9009b0a453eed45ce9de,1,23,0,23,1,2013-11-22 05:34:54,2013-11-18 03:24:49
3314e005f32f7440f1cc9009b0a453eed45ce9de...b3f5973f41eeb0e445b16ec0813b7996fba2fde7,2,19,0,19,4,2013-11-22 05:34:54,2013-11-18 03:25:08
9dc59797e09a20869d99e72f9c849e4e0b2c59bc...53f1bf0f995d4c0e6af3eb14cd76a1b049c851a2,2,40,1,41,3,2013-11-22 02:03:41,2013-11-22 01:51:28
3885ee00c5da9083999e56f714f7c50c6e910662...687d27ab575778196ea646b6d3fa61b6c8e512b0,5,125,3,128,16,2013-08-18 17:34:01,2013-08-15 18:38:17
ccc2276469956fccfd65fd4d3b0d0d3d15af1d6d...d1ad0e278d67baad46168f6d04a56550a287d4a7,1,3,1,4,3,2013-08-23 17:14:06,2013-08-23 15:59:11
ccc2276469956fccfd65fd4d3b0d0d3d15af1d6d...72cfa3de3584d8cade530360e0e5997a06981e7a,1,1,1,2,1,2013-08-23 16:13:30,2013-08-23 16:13:30
ccc2276469956fccfd65fd4d3b0d0d3d15af1d6d...3396a183c61b66dd60458f67049a50b393e760f8,1,1,1,2,1,2013-08-23 08:28:58,2013-08-23 08:28:58
f753dfe6b3d3a8e4d770ae73e947e2fe339df536...091fb892948abee1ad5451ee6c9d7dd540d88780,3,8,1,9,4,2013-08-23 18:45:52,2013-08-23 18:45:52
091fb892948abee1ad5451ee6c9d7dd540d88780...ebb9b5e85be296fd73f4d64e61dfc87fe0c3ae72,1,6,0,6,2,2013-08-23 19:56:03,2013-08-23 19:56:03
c864647721d5b36d7784415b6fa32e97269dad11...331f983593a527f04046c2d6131847adcdf95e3e,1,1,1,2,1,2013-08-26 14:43:49,2013-08-26 14:43:49
331f983593a527f04046c2d6131847adcdf95e3e...3f141e1fd3a11507b049359ea59253b49395d494,2,2,2,4,2,2013-08-29 19:06:24,2013-08-29 19:06:24
c864647721d5b36d7784415b6fa32e97269dad11...1adbadde80a9ce657d29e1b2163509007c8c3554,1,1,1,2,1,2013-08-26 14:39:38,2013-08-26 14:39:38
c864647721d5b36d7784415b6fa32e97269dad11...843ef645d2c76275e484e3fd5262b947d5611d59,1,2,2,4,2,2013-08-26 09:54:15,2013-08-26 09:54:15
c864647721d5b36d7784415b6fa32e97269dad11...4440bde0ebffcb31025fd9f3db8e4275b77332b1,1,1,1,2,1,2013-08-26 09:45:15,2013-08-26 09:45:15
c864647721d5b36d7784415b6fa32e97269dad11...d8a18ea3ae96ab415885fc1554db168d94d64265,1,4,0,4,1,2013-08-24 23:28:36,2013-08-24 23:28:36
3528990c73e7457aad12093837c51a17fc99b82a...ea813d8593d30e430ce05597becb1e394cb72a25,1,1,1,2,1,2013-09-03 18:30:32,2013-09-03 18:30:32
3528990c73e7457aad12093837c51a17fc99b82a...6380b42edbf98dec3b04b3b74fcfbfd63dba4034,5,61,1,62,7,2013-09-03 14:35:22,2013-09-03 14:35:22
3528990c73e7457aad12093837c51a17fc99b82a...1fca99ad908c530fcd03158a56767b55500a8521,5,23,30,53,16,2013-09-01 03:44:42,2013-09-01 03:31:21
1fca99ad908c530fcd03158a56767b55500a8521...113bb396cdef5e07a19306dea767870b2775214d,1,5,5,10,5,2013-09-01 03:44:49,2013-09-01 03:34:51
3528990c73e7457aad12093837c51a17fc99b82a...e42d3a1bfaa555c68cb4a45a2272f8ebf5a3782b,1,3,0,3,1,2013-09-01 02:13:15,2013-09-01 02:13:15
e2594d162e8c2c60dc4741a0519ce09148a9e87c...ab882da03b57037885c4222f474fa8bd37a01956,1,1,1,2,1,2013-08-23 21:37:37,2013-08-23 21:37:37
ab882da03b57037885c4222f474fa8bd37a01956...f4432d50c388c242bba6b697f31b32f1fe21ff65,2,30,4,34,3,2013-08-24 07:24:40,2013-08-24 07:24:40
128893062b5b479d64dbcc62e16b66584f24b16b...dffb72ca898ce44e19f148112c3f9b43c96e01da,3,46,3,49,4,2013-08-28 01:49:43,2013-08-28 01:49:43
bf98fff925952924635bc539b23919079d89e11f...eee6d3dae96afbcb1456b4a84f05f1aac44e5598,2,11,1,12,2,2013-08-29 22:55:29,2013-08-19 13:47:38
eee6d3dae96afbcb1456b4a84f05f1aac44e5598...740a97f1a836be17ab39e8496b7372900782c20b,2,2,10,12,2,2013-08-29 22:55:29,2013-08-29 22:55:24
740a97f1a836be17ab39e8496b7372900782c20b...f159f4710b0c5dac8b71246dddbaee667dd6a702,1,3,3,6,3,2013-08-29 22:59:34,2013-08-29 22:59:34
bf98fff925952924635bc539b23919079d89e11f...57892365ef325d824ba6ce45a8e24e48cd117f0c,1,1,1,2,1,2013-08-29 16:35:37,2013-08-29 16:35:37
bf98fff925952924635bc539b23919079d89e11f...075253238dff72bdf03179fcb1d2b90ca097e7f0,1,9,9,18,1,2013-08-29 16:27:35,2013-08-29 16:27:35
bf98fff925952924635bc539b23919079d89e11f...f6b56e996d6b721cb95c1a19b1df061900fb8fd1,1,2,1,3,2,2013-08-29 16:14:14,2013-08-29 16:14:14
f6b56e996d6b721cb95c1a19b1df061900fb8fd1...dd49cc45c885de15133a6e547671846e63a0334a,1,38,100,138,19,2013-09-11 07:23:53,2013-09-11 07:23:53
bf98fff925952924635bc539b23919079d89e11f...37a236947eaa611a441328a0dfc015091402292b,1,1,0,1,1,2013-08-29 05:18:47,2013-08-29 05:18:47
bf98fff925952924635bc539b23919079d89e11f...b1eae313ad7d28142c7e0a8a60e3961bed0c84f0,11,166,94,260,59,2013-08-29 00:26:10,2013-08-29 00:26:10
b7826f56664c85e44207ce5e1e685ed04016feb6...44d0f941f287d5dcf6212216b7c0b72b085bdb1a,1,1,1,2,1,2013-09-10 17:16:59,2013-09-10 17:16:59
8a2fd914b2680de0ce246950c3fc46b5359da907...e5239b98598ece4287c1088e95a2eaed585d2da4,1,2,0,2,1,2013-09-06 04:05:23,2013-09-06 04:05:23
37186d9ef40b31730940409a7acb21e02688b707...b9ca311008a14910877c6283b1dc7fb4a14bef4c,1,16,76,92,20,2013-09-06 21:48:06,2013-09-06 21:48:06
b9ca311008a14910877c6283b1dc7fb4a14bef4c...bcb8d3fd86ac620dc4f35c805b4e0f8e8fcb7663,1,3,17,20,3,2013-09-06 21:52:14,2013-09-06 21:52:14
bcb8d3fd86ac620dc4f35c805b4e0f8e8fcb7663...70ab25a5dbc8f54dbe15e9375687b4669ed919df,1,2,2,4,1,2013-09-06 22:08:01,2013-09-06 22:08:01
70ab25a5dbc8f54dbe15e9375687b4669ed919df...6679f3b053344e6e99d5e490720c9ccb924a7d4c,1,9,95,104,6,2013-09-06 22:09:04,2013-09-06 22:09:04
6679f3b053344e6e99d5e490720c9ccb924a7d4c...eed00a4afd1e8e8e35f8ca640c94d9c9e9babaf7,1,0,136,136,1,2013-09-06 22:09:40,2013-09-06 22:09:40
843f9091f25eee67a8c858ddf9b61d630b17a11d...dd806b4ecd2c94356342da720e580ab13288df33,1,1,0,1,1,2013-09-09 22:19:28,2013-09-09 22:19:28
9b088ada7e1f7bf9021d6c319550ff11be1b0a22...3c90e96b6d9e16b3983cd7e387b06e81130f1e7c,1,0,2,2,1,2013-09-09 21:42:45,2013-09-09 21:42:45
9b088ada7e1f7bf9021d6c319550ff11be1b0a22...46a1cd69a99a9adc7bc366f1eb2c03b62f464d39,3,15,1,16,3,2013-09-09 21:26:35,2013-09-09 21:26:35
98a1314251cf5d0ffe0f9d44055e8e73ff368947...98edd0e7510183f561716307299be8834617917b,2,1199,2,1201,4,2013-09-04 20:58:58,2013-09-04 20:58:58
98edd0e7510183f561716307299be8834617917b...9ae5054c3477c6eb9afc64ad44ff41bb3f10a8ab,2,36,2,38,4,2013-09-04 21:41:44,2013-09-04 21:41:44
49d35cc0aed060288a1db8bbb6e23b3c6f7178fc...e3b58d302795fbbfa6c117774906a4c9efd536f4,1,7,4,11,3,2013-08-30 00:46:43,2013-08-30 00:46:43
597479494215180cadbc62b2ffa04a6759292557...34145f9840b62de85d385a65702f054962878cae,1,0,1,1,1,2013-09-04 17:05:54,2013-09-04 17:05:54
23b3747945f49cdb41645fbf8442a2bdd30b7a77...ee814055673ca1d5981a4e9e4788a4199fd2f456,1,18,9,27,4,2013-10-30 21:36:38,2013-10-30 21:36:38
ee814055673ca1d5981a4e9e4788a4199fd2f456...f7c40a87f3b20f00b073652fc7b4e97a4035ae92,1,1,1,2,1,2013-10-30 21:48:19,2013-10-30 21:39:26
b440ec0136793ebcfbf8d76e6cd16ccba0785382...7f429e0cebf9f7d0b203191646f2afa7b4bee35b,1,35,0,35,2,2013-10-14 16:47:01,2013-10-12 02:27:04
b440ec0136793ebcfbf8d76e6cd16ccba0785382...c3f1bb3287a10ed0d49f48630b92c69ff6ca4ff7,1,29,8,37,10,2013-10-12 03:37:11,2013-10-12 03:37:11
c3f1bb3287a10ed0d49f48630b92c69ff6ca4ff7...48070274ee93bf0d4cef7486a4ec19c4d97ac9ce,1,3,0,3,1,2013-10-12 22:06:53,2013-10-12 22:06:53
b440ec0136793ebcfbf8d76e6cd16ccba0785382...a263e07678c813af2a7b0859034cc76c9a888c7b,2,64,6,70,7,2013-10-11 23:54:08,2013-10-09 00:00:40
a263e07678c813af2a7b0859034cc76c9a888c7b...562e4f1e23a52cff05078f68e21199514ba58250,3,73,46,119,20,2013-10-12 00:11:18,2013-10-11 00:52:01
b440ec0136793ebcfbf8d76e6cd16ccba0785382...e7986da531568040e0185aafce03cdae2169baac,1,15,1,16,2,2013-10-11 23:42:11,2013-10-08 12:54:00
e7986da531568040e0185aafce03cdae2169baac...ea92dc2e8c42c4387eccf1ebb88e20ccc92c1853,1,38,31,69,14,2013-10-14 19:26:46,2013-10-14 19:26:46
61abc3f8ac89bd3b238a7ceaf26fa004c462848b...359a6f49b9ec704686d0cb0df7cb0d7c8d5f55a7,21,797,6,803,23,2013-11-14 18:50:00,2013-11-14 06:08:08
359a6f49b9ec704686d0cb0df7cb0d7c8d5f55a7...c001a5af67b7b811a8fc69011fcffc2656b8fd99,8,521,1113,1634,300,2013-11-14 18:50:43,2013-11-14 06:10:20
c001a5af67b7b811a8fc69011fcffc2656b8fd99...2a209afe5fe0f27296e3e06a199bb5305910e1cf,6,3,17,20,14,2013-11-14 18:50:43,2013-11-14 06:11:28
2a209afe5fe0f27296e3e06a199bb5305910e1cf...e9624bf715134294a7fac1ab8a43508139000253,1,0,46,46,1,2013-11-14 18:50:43,2013-11-14 06:14:23
e9624bf715134294a7fac1ab8a43508139000253...661a8a0e0ce95d9bcb222184c14373fb1dbb1aec,3,76,52,128,44,2013-11-14 22:46:13,2013-11-14 20:33:15
661a8a0e0ce95d9bcb222184c14373fb1dbb1aec...596810d8db17c246c9c5107e7ecc6eb781454f36,2,57,36,93,3,2013-11-14 23:17:31,2013-11-14 23:17:31
596810d8db17c246c9c5107e7ecc6eb781454f36...8d3e35cd8d92d184dc66041c235163cab4953842,2,63,49,112,4,2013-11-15 01:13:20,2013-11-15 01:13:20
8d3e35cd8d92d184dc66041c235163cab4953842...823674816e59e1e8c3f768a97585c69e1d86ead8,2,22,18,40,2,2013-11-15 01:15:39,2013-11-15 01:15:39
823674816e59e1e8c3f768a97585c69e1d86ead8...c06d903edd7b16588e68680a989b73e27d990871,2,102,89,191,2,2013-11-15 19:48:18,2013-11-15 19:09:29
c06d903edd7b16588e68680a989b73e27d990871...afe230718ead8cb1d1053a7132a034f0bd55b424,3,480,477,957,203,2013-11-16 02:12:14,2013-11-16 00:05:57
61abc3f8ac89bd3b238a7ceaf26fa004c462848b...e42144674fb6eeb76bcda822105b049f7fb6ab30,1,1,1,2,1,2013-11-14 04:53:55,2013-11-14 04:53:55
d589cc36227702e40038704ab048efff23bc71d9...af0b2e38c3b2688cd4c2e831847bf4601d8fc149,1,8,0,8,2,2013-11-13 12:55:55,2013-11-13 12:55:55
d589cc36227702e40038704ab048efff23bc71d9...5cdb3aec507d9df7bb98366f04c4303a2172cbd5,2,10,0,10,4,2013-11-12 18:23:06,2013-11-12 18:23:06
d589cc36227702e40038704ab048efff23bc71d9...1e5ba57de372bd13b0231e969dbb62a7fa8d7b52,1,1,1,2,1,2013-11-12 02:53:34,2013-11-12 02:53:34
1e5ba57de372bd13b0231e969dbb62a7fa8d7b52...879aa29cb09c641bbd510eed03647f8f85f0d559,1,3,3,6,2,2013-11-12 10:18:30,2013-11-12 10:18:30
d589cc36227702e40038704ab048efff23bc71d9...bc6d87284174c1a862603a2da574ff60bb03e0fa,1,3,4,7,2,2013-11-12 02:15:38,2013-11-12 02:15:38
c964494d315ea672e2a4987cbfd9c9e8852553b8...02884ee42971be141edde8964d72a2d2c7f63cfe,1,30,1,31,2,2013-11-13 18:34:34,2013-11-13 18:34:34
845b8166869ba320c1e753ed8ca560bbf9453767...ad6983624745cbb7c8f5bd7fd22c68f190b42004,1,5,0,5,1,2014-01-15 01:25:26,2014-01-11 12:46:11
ad6983624745cbb7c8f5bd7fd22c68f190b42004...42fed841d3735658d738aff34e135f8e461012dd,1,11,2,13,3,2014-01-15 01:25:35,2014-01-14 18:42:03
42fed841d3735658d738aff34e135f8e461012dd...8d19b2caa01535202c2fa82913ad99ec2594032a,3,54,3,57,4,2014-01-15 01:26:34,2014-01-14 22:28:19
8d19b2caa01535202c2fa82913ad99ec2594032a...734b4566df879c2c071a9785d69b2c9c51d76b06,1,1,1,2,1,2014-01-15 01:27:12,2014-01-13 20:28:30
734b4566df879c2c071a9785d69b2c9c51d76b06...75293b12b36b3eef6706cf85f291be96500a40da,1,1,0,1,1,2014-01-15 01:27:34,2014-01-10 20:03:59
75293b12b36b3eef6706cf85f291be96500a40da...07b50a90a8e7380b781d75dda3773eb23cafb131,1,2,0,2,1,2014-01-15 01:27:51,2014-01-10 17:20:31
07b50a90a8e7380b781d75dda3773eb23cafb131...d103b6f6df74a9fe54b6af747c497641f5b19937,1,1,1,2,1,2014-01-15 01:29:25,2014-01-08 07:27:50
d103b6f6df74a9fe54b6af747c497641f5b19937...bc3b2ec0622f50879ae96f042056b6bd2e0b4fba,2,17,1,18,2,2014-01-15 01:53:20,2014-01-15 01:53:20
bdcd1cfba5bdb2357260e566c7d3fdb9c9380362...bea6dd3888adefd070544241177860864f62fb25,5,1360,32,1392,23,2014-01-14 18:52:42,2014-01-14 00:50:10
bea6dd3888adefd070544241177860864f62fb25...7898dca8b3d1835d15812bd5249fcfb0de73257b,3,7,15,22,6,2014-01-15 19:06:00,2014-01-14 19:43:58
bdcd1cfba5bdb2357260e566c7d3fdb9c9380362...f700aa15705c418d6523b7ecb7c6e7413deaed13,1,3,0,3,1,2014-01-14 18:07:18,2014-01-14 18:03:45
7985125602e8ddf79b5ac0ef56c71ac8962455ac...fd78128870b78c282b65976cfff100c4101569b1,2,26,1,27,2,2014-01-11 11:00:52,2014-01-10 21:37:07
7985125602e8ddf79b5ac0ef56c71ac8962455ac...e5189b5dd2c044030e7e2ab7029eba0fe91c3b25,1,1,0,1,1,2014-01-10 20:06:53,2014-01-10 20:03:59
7985125602e8ddf79b5ac0ef56c71ac8962455ac...c2a59dfe48e55bc93e3bed5ecde021f372151b09,2,3,3,6,3,2014-01-10 19:45:00,2014-01-10 03:12:56
7985125602e8ddf79b5ac0ef56c71ac8962455ac...051e7a0befaddb6ddbd047abff5f524a7247af6c,1,2,0,2,1,2014-01-10 17:20:31,2014-01-10 17:20:31
7985125602e8ddf79b5ac0ef56c71ac8962455ac...d69cf2986eb864ffcad026bfbdd30beda5061175,1,2,2,4,2,2014-01-10 10:27:21,2014-01-09 20:43:33
d69cf2986eb864ffcad026bfbdd30beda5061175...2fd4c39c86a87660cedae19936d5fc5164edd859,2,4,4,8,4,2014-01-10 10:35:25,2014-01-10 10:35:01
1fcbd36cb2780175082a880f0ce85d91ecb81c87...c3c89abfd65cb3d0d8c7796b035dde314fb9a2c3,1,1,1,2,1,2014-01-09 19:36:30,2014-01-09 19:36:30
76afb6e73d70b98654018c51ab9f587336b056ec...e47f9984f8a2a250c980dd9325f6ac24a55093ed,3,23,2,25,6,2013-10-29 02:58:58,2013-10-29 00:39:44
76afb6e73d70b98654018c51ab9f587336b056ec...dd9f4524d1a829a394f5d96da0c1e6338c476019,1,1,0,1,1,2013-10-29 01:39:21,2013-10-28 01:17:10
dd9f4524d1a829a394f5d96da0c1e6338c476019...a963ff5d8df4e6d0e42dd669d3d60aafb8f880a7,2,12,5,17,4,2013-11-01 17:11:21,2013-11-01 17:11:21
b038b0cd44e152fa4158f2bfe145de6d774dd8d0...4947f61c2038ea3687d308782578bfdc9cec7c5c,1,2,3,5,2,2013-10-29 13:11:36,2013-10-29 13:11:36
b038b0cd44e152fa4158f2bfe145de6d774dd8d0...1de23f1b81956bc04ba047d066ff7d84d9162910,4,19,0,19,5,2013-10-29 06:02:28,2013-10-29 06:02:28
b038b0cd44e152fa4158f2bfe145de6d774dd8d0...b283900764eac4947dc3239ced56e1c74e98809d,1,6,5,11,4,2013-10-29 03:57:20,2013-10-29 03:57:20
b038b0cd44e152fa4158f2bfe145de6d774dd8d0...82f15148955124c20cb756502036c4f231e5a8aa,2,8,4,12,5,2013-10-29 03:37:43,2013-10-29 03:21:56
feef16bd88c249e8725da85a491c37d7bf2086e3...c33d26a8da0dc2dd33918bc5e21283dd62f6d755,2,26,20,46,15,2013-11-03 00:53:44,2013-11-03 00:41:35
b30dc8c3eaa9f393f44fb8544cd40eb9458e0dbe...1cb4557cc8e40f509898bded6684a45070fbb2a4,10,79,78,157,62,2013-11-03 01:26:52,2013-11-03 01:26:52
b30dc8c3eaa9f393f44fb8544cd40eb9458e0dbe...dcf4633e95c7f3784cb29b9c1f9510af28b882ed,1,1,1,2,1,2013-11-01 21:00:02,2013-11-01 21:00:02
c22ff0296e743443b3d79b0bd5f8b9bd97a77e13...70f44d5531a5c6dcb96b7e608a96beb52e93b506,1,10,7,17,6,2013-11-06 18:01:58,2013-11-06 18:00:24
dcaaecc8152febdbb339e5f2f289db6a8e133a54...f9cb6ae46a3478c19e85a2a159c4ac31223ec499,3,93,6,99,6,2013-11-05 17:58:51,2013-10-13 20:58:54
dcaaecc8152febdbb339e5f2f289db6a8e133a54...433c8e9c7da7cd3cd952c3dce3763db70fc450e5,3,21,20,41,11,2013-11-05 17:41:37,2013-10-27 00:19:35
433c8e9c7da7cd3cd952c3dce3763db70fc450e5...958b4a8757e83c3fada757b10dd1be4ab7bff5ee,9,184,58,242,45,2013-11-05 18:39:59,2013-10-27 02:24:01
958b4a8757e83c3fada757b10dd1be4ab7bff5ee...7b17d555992c65c6b10da21c8aa48062a1aba0d9,1,5,2,7,1,2013-11-05 18:39:59,2013-10-27 06:51:43
7b17d555992c65c6b10da21c8aa48062a1aba0d9...847411a1ee6e5ee5d051fc4729425215dc0c8561,2,23,3,26,5,2013-11-05 18:39:59,2013-10-27 06:54:51
847411a1ee6e5ee5d051fc4729425215dc0c8561...ca6f0aa107117d2125a63eb5e78d74095bf08a4c,1,2,2,4,2,2013-11-05 18:39:59,2013-10-27 06:57:29
ca6f0aa107117d2125a63eb5e78d74095bf08a4c...4e7cb37dcc18975010df630d8c9580a3a65e0e69,2,38,5,43,8,2013-11-05 18:39:59,2013-10-27 07:01:15
4e7cb37dcc18975010df630d8c9580a3a65e0e69...02ddaad5d985186eed94dea4105a57fa21ba24db,2,5,2,7,2,2013-11-05 18:39:59,2013-10-27 07:06:43
02ddaad5d985186eed94dea4105a57fa21ba24db...5a85456d481a5f88fc0efc02c41b3bff987c0ed1,4,84,68,152,26,2013-11-05 23:00:16,2013-10-27 07:13:45
5a85456d481a5f88fc0efc02c41b3bff987c0ed1...434f06d03dc2825cb4f348a88ddc6d1aa17ea19c,2,17,2,19,3,2013-11-05 23:00:20,2013-10-27 07:15:22
434f06d03dc2825cb4f348a88ddc6d1aa17ea19c...d3f074494a9594bc268bf4c639a7aea0934ec7c0,3,9,4,13,8,2013-11-05 23:00:20,2013-10-27 07:16:32
d3f074494a9594bc268bf4c639a7aea0934ec7c0...5c42b2b5122c1db08d229c258da26869b4d4d9cc,1,2,2,4,1,2013-11-05 23:00:20,2013-11-05 19:57:40
5c42b2b5122c1db08d229c258da26869b4d4d9cc...e5f8ab6160401fb541121da5b5cbc3af4fce28b7,8,259,138,397,81,2013-11-05 23:00:20,2013-10-28 02:20:00
e5f8ab6160401fb541121da5b5cbc3af4fce28b7...8d6df3a7e2080d4fad9743beb159f12caa0ff6f7,2,2,14,16,11,2013-11-05 23:00:20,2013-11-05 22:22:37
dcaaecc8152febdbb339e5f2f289db6a8e133a54...ff8a4ba0aa20dc3b382e2dcddcd89bb0bb168496,4,46,17,63,21,2013-11-05 16:33:13,2013-11-05 15:33:07
ff8a4ba0aa20dc3b382e2dcddcd89bb0bb168496...00f1398f7a8543e2448723635d93ea6ddf1eaadb,1,4,1,5,3,2013-11-06 15:37:43,2013-11-06 15:37:43
35690e76b4989eceb0355cdf2f3bf9727a684a41...957db15ef4cef2f3a6b2933260a7806d69ff68e0,2,52,2,54,9,2013-11-04 18:28:38,2013-11-04 18:28:38
35690e76b4989eceb0355cdf2f3bf9727a684a41...a9ed238bb76774c142107b3f06e8c9e9a1e59e65,3,59,7,66,10,2013-11-04 17:28:40,2013-11-04 17:28:40
342bd43b766e828753ffec35a6ae9b76e988c483...99141ea3ca3c0429ecdfc3bdb097a68957beab71,2,39,0,39,2,2013-11-04 21:20:14,2013-11-04 21:20:14
342bd43b766e828753ffec35a6ae9b76e988c483...1f44fd8624d1de3f7e1e55880352faef2e141fb1,1,11,1,12,2,2013-11-04 20:19:20,2013-11-01 00:58:15
1f44fd8624d1de3f7e1e55880352faef2e141fb1...177a2f5946623a4d4f90f5a227e57211eed6ade3,1,16,0,16,1,2013-11-04 20:23:35,2013-11-04 20:23:35
511a62a099ee086b6472816703a3e247d42f2127...8e5ab5bfca2a7077f4e85096808c8f309cf692df,4,154,5,159,7,2013-11-19 19:47:47,2013-11-19 01:05:05
8e5ab5bfca2a7077f4e85096808c8f309cf692df...66beafa9f3ee72c26773158c7102cb727613ac65,1,0,0,0,0,2013-11-19 20:41:29,2013-11-19 20:41:29
114e01cdc1457a2a6ceb2288f3d72cbd3614dc8f...5af87d147580555c72e6a1d448ab663f991cc737,3,98,0,98,3,2013-11-05 21:21:52,2013-11-05 21:21:25
114e01cdc1457a2a6ceb2288f3d72cbd3614dc8f...4b8c41c4a2591797f97ad079e4314b21498ba732,1,3,0,3,1,2013-11-05 20:52:54,2013-10-18 22:44:06
4b8c41c4a2591797f97ad079e4314b21498ba732...f1f39616eb052455a383de589bbc1eaa9ab5d96c,1,18,0,18,1,2013-11-05 20:54:24,2013-10-18 22:53:15
f1f39616eb052455a383de589bbc1eaa9ab5d96c...4d2ba779e1a0596c51cc6ed2ddb7c2139830f15c,1,19,0,19,1,2013-11-05 20:54:24,2013-10-18 22:56:52
4d2ba779e1a0596c51cc6ed2ddb7c2139830f15c...35430e89201972d877ba01405f966882a1d3888a,1,19,0,19,1,2013-11-05 20:54:24,2013-10-18 23:06:25
114e01cdc1457a2a6ceb2288f3d72cbd3614dc8f...4d5ecdbeb4e428d92c5a0089378f7bae9b3ca3d9,1,2,2,4,1,2013-11-05 19:08:56,2013-11-05 19:08:56
140da580d4f0efaf6c1bc470a16edc7c7f2477c7...484804abffda2692492e295d4691f90564d05eb2,1,2,2,4,2,2013-11-07 21:46:44,2013-11-07 21:46:44
140da580d4f0efaf6c1bc470a16edc7c7f2477c7...ed572b457d28101b6ef465e5a3e221ee1fc7d48a,3,92,61,153,11,2013-11-05 04:51:12,2013-11-05 04:51:12
3e7b9763aaffb87a82cbb4caacf3f681e0795ae4...699a1074fb9cdf323044f8c132d7130f6a2945bc,10,160,95,255,30,2013-11-01 01:07:54,2013-11-01 01:07:54
db28e839e0292a9d4c9c24b33c4267703baa6e5b...14d9f04e8971effcab45e76c5a69f6d997fb83dd,1,1,2,3,1,2013-11-26 07:28:48,2013-11-26 07:20:36
14d9f04e8971effcab45e76c5a69f6d997fb83dd...0d078b65817fc91eba916652b3f087a6c2eef851,1,4,3,7,3,2013-11-26 08:09:45,2013-11-26 08:05:46
67c9ce6dd1632097b1e6ee612dddecc80ac841df...b22c9731102abbaf42e8d7e37e179ef56b945ccd,1,2,0,2,1,2013-08-19 02:44:46,2013-08-19 02:44:46
67c9ce6dd1632097b1e6ee612dddecc80ac841df...319988336ceed4428de0e1e55685f8a0ed48a7bd,3,16,0,16,3,2013-08-18 18:30:19,2013-08-18 18:30:19
d4c734013182125f18bb831518f30bd0f2a87c4b...076434ef10ebf940bb822c423056fcc4417b4a28,1,0,23,23,1,2013-08-26 19:06:56,2013-08-26 19:06:56
f0620da74a5b4b63bf7b984899d10070da47c2db...66ef6c0f6ed887008ad73e317767e81551f76e72,1,1,1,2,1,2013-08-28 16:40:00,2013-08-28 16:40:00
f0620da74a5b4b63bf7b984899d10070da47c2db...20772f90fff54f95fc8cafe2b0c9be4c093cbf64,1,0,2,2,2,2013-08-28 16:38:06,2013-08-28 16:02:14
f0620da74a5b4b63bf7b984899d10070da47c2db...69a93b36d5a43c22402af5beea01d60b1b3be91f,1,1,1,2,1,2013-08-28 11:12:37,2013-08-28 11:12:37
69a93b36d5a43c22402af5beea01d60b1b3be91f...c1f6914e4374fcafa710c75eb23e8cffeeb45169,1,1,1,2,1,2013-08-29 03:01:18,2013-08-29 03:01:18
c1f6914e4374fcafa710c75eb23e8cffeeb45169...18d572abb4b633d766c9a28119a118761103f5f8,1,1,0,1,1,2013-08-29 05:28:31,2013-08-29 05:28:31
f0620da74a5b4b63bf7b984899d10070da47c2db...466a88b9a8331154730551c0009b67cded83ba58,1,2,0,2,2,2013-08-28 02:59:36,2013-08-28 02:59:36
c46d9933ecc90ee6560054a34afc9f8ee5920601...230dc07d372cccb1aa1198ae300d06e418c73af6,1,1,1,2,1,2013-08-29 18:24:59,2013-08-29 18:24:59
07324a37eb7cc6daf32e47a85aedaa03b07586b5...33e4d73629dd2a913e5b8e4c96faba09bcb1bcac,1,2,2,4,2,2013-09-11 08:07:05,2013-09-11 08:07:05
33e4d73629dd2a913e5b8e4c96faba09bcb1bcac...d48ea32186cfa069db80d6dd3b79a9d2e0c14c7f,1,1,8,9,1,2013-09-11 08:26:26,2013-09-11 08:26:26
d48ea32186cfa069db80d6dd3b79a9d2e0c14c7f...f4ba0d42675a4085dfe96543a9265d9caf6b5e85,1,1,1,2,1,2013-09-11 08:28:20,2013-09-11 08:28:20
f4ba0d42675a4085dfe96543a9265d9caf6b5e85...71d46eaf029fcc49edade5e7a967909d57e5c723,1,1,1,2,1,2013-09-11 08:39:55,2013-09-11 08:39:55
c4394decf85ab1428edab61edeb73e6cf65b61ce...c6702bebe116054a4c24487b5fb5d2c26e9fad4f,1,15,0,15,1,2013-08-30 00:13:32,2013-08-29 23:49:41
c4394decf85ab1428edab61edeb73e6cf65b61ce...4ff649ce852175f209c27d03992f31b5f14cae65,1,1,1,2,1,2013-08-29 23:25:11,2013-08-29 23:25:11
de75241b627730a24e4db59ddb5bc06ba27bffac...c75926be4f1a606251c6cdc926c5a37795d358b9,7,832,831,1663,589,2013-09-10 21:54:35,2013-09-10 21:54:35
c75926be4f1a606251c6cdc926c5a37795d358b9...21be3b76e99d0a6a9d9722d6221ee15ea971dbf4,1,79,22,101,12,2013-09-11 01:54:13,2013-09-11 01:54:13
eed00a4afd1e8e8e35f8ca640c94d9c9e9babaf7...c983023661deac0713eaa218c6bdfd20ec5eee45,1,56,0,56,1,2013-09-07 02:27:48,2013-09-07 02:02:59
c983023661deac0713eaa218c6bdfd20ec5eee45...3c80bd76cf6aa8f6918439f8082b0a8c34fd2c0e,1,10,10,20,2,2013-09-07 02:27:48,2013-09-07 02:03:29
3c80bd76cf6aa8f6918439f8082b0a8c34fd2c0e...34eab428330ce4a56c22b03f3067dd8eeee7ed41,2,11,1,12,5,2013-09-07 02:27:49,2013-09-07 02:19:03
34eab428330ce4a56c22b03f3067dd8eeee7ed41...fa806f26aff927eb0d98b41e79786ae98987da5b,1,20,0,20,1,2013-09-07 02:58:05,2013-09-07 02:58:05
fa806f26aff927eb0d98b41e79786ae98987da5b...47838051be695a4e74c80690ceef811dcd3ef62c,4,3,7,10,4,2013-09-07 03:14:03,2013-09-07 03:14:03
47838051be695a4e74c80690ceef811dcd3ef62c...d757bd0904b71346b6c83622ae5685bc0c0d4349,1,4,0,4,1,2013-09-07 03:16:13,2013-09-07 03:16:13
d757bd0904b71346b6c83622ae5685bc0c0d4349...20d24a450cbf22b6d5268bc1fe76022fa554d6be,3,32,7,39,5,2013-09-08 00:35:48,2013-08-26 22:51:22
20d24a450cbf22b6d5268bc1fe76022fa554d6be...19dc3b0792272c2f0fbcfb654349fe5e86bc8046,1,1,0,1,1,2013-09-08 00:35:49,2013-08-27 00:59:58
19dc3b0792272c2f0fbcfb654349fe5e86bc8046...055bbb79c10a829e054d6741d1937f0304dbb7fd,1,16,6,22,2,2013-09-08 00:48:52,2013-09-08 00:48:52
055bbb79c10a829e054d6741d1937f0304dbb7fd...4cd59b96ed93d8a4c35099a0a1171e17170071ab,1,0,26,26,3,2013-09-09 01:45:23,2013-09-09 01:45:23
4cd59b96ed93d8a4c35099a0a1171e17170071ab...e37dcd726fe415193eaed18729251d293a018909,1,1,2,3,2,2013-09-09 22:05:25,2013-09-09 22:05:25
e37dcd726fe415193eaed18729251d293a018909...b187cc40cda36fb1b4890d80fc7367b2df4fbd6e,1,32,1,33,5,2013-09-09 23:20:30,2013-09-09 23:20:30
b187cc40cda36fb1b4890d80fc7367b2df4fbd6e...59856a20bfbad6f59308071fda220a04c3b0df09,1,7,0,7,2,2013-09-09 23:30:24,2013-09-09 23:30:24
59856a20bfbad6f59308071fda220a04c3b0df09...3d39336a46a0d7f411467d29eb6328dc1ab3e900,5,174,121,295,13,2013-09-10 01:45:40,2013-09-10 01:45:40
3d39336a46a0d7f411467d29eb6328dc1ab3e900...14bbbcd57181f9d6e908b2e84474e731314d0d77,1,125,0,125,1,2013-09-10 06:39:55,2013-09-10 06:39:55
14bbbcd57181f9d6e908b2e84474e731314d0d77...5b361f31f7d4eb547cbf60fda2968537600772ca,1,12,0,12,1,2013-09-10 18:30:14,2013-09-10 18:30:14
5b361f31f7d4eb547cbf60fda2968537600772ca...d14058bc29512918ffd4e7413c6d5ae8524088ed,1,3,2,5,2,2013-09-10 18:33:26,2013-09-10 18:33:26
d14058bc29512918ffd4e7413c6d5ae8524088ed...228b7af516e023984a3d0ceba98c639cec9695d0,1,0,4,4,1,2013-09-10 18:33:37,2013-09-10 18:33:37
228b7af516e023984a3d0ceba98c639cec9695d0...03e36caeb12eb5b936de8cec29998c61fc02f037,1,2,2,4,2,2013-09-11 01:02:33,2013-09-11 01:02:33
03e36caeb12eb5b936de8cec29998c61fc02f037...ebee8f28ac45e7907a35331383f8b9b4ab338353,1,3,4,7,1,2013-09-11 01:08:02,2013-09-11 01:08:02
ebee8f28ac45e7907a35331383f8b9b4ab338353...45cedefadb444e8d7305defd246c63537fca04df,2,7,4,11,4,2013-09-12 01:38:09,2013-09-12 01:38:09
eed00a4afd1e8e8e35f8ca640c94d9c9e9babaf7...24e02043a2672320abebc3bd5fa6a592e2ebd082,8,191,237,428,73,2013-09-07 00:33:05,2013-09-07 00:33:05
24e02043a2672320abebc3bd5fa6a592e2ebd082...6a9f4ecf9bc4263baef8e9a1d86f1474f9c66d31,1,12,1,13,7,2013-09-07 00:43:34,2013-09-07 00:43:34
6a9f4ecf9bc4263baef8e9a1d86f1474f9c66d31...eca861a99d1a5abe91704b55d044eb8280adb8d1,1,1,0,1,1,2013-09-08 00:03:40,2013-09-08 00:03:40
eed00a4afd1e8e8e35f8ca640c94d9c9e9babaf7...b07314e2e066a1308040e1eb45a96a0e1056f28a,1,19,12,31,11,2013-09-06 23:00:21,2013-09-06 23:00:21
9b029a08549e2fef8f71115e5707c363368662e9...c0e95fa68a37166ce551a33332bbede6b6531b68,1,1,1,2,1,2013-08-30 01:05:18,2013-08-30 01:05:18
3a6868bc2fa1e1cd76ae8691c68cb96c857ff265...8374dac02141c1409b93bb3838f6dabbba4d5b14,2,49,1,50,2,2013-09-06 00:05:36,2013-09-05 12:28:02
3a6868bc2fa1e1cd76ae8691c68cb96c857ff265...3bc73fa21e4428cd7040df6c5a384bd0e4772236,1,23,7,30,6,2013-09-05 23:54:03,2013-09-05 23:54:03
3a6868bc2fa1e1cd76ae8691c68cb96c857ff265...396274fa6db88466fef0b1a5e314ba5b077cd3f2,1,1,1,2,1,2013-09-04 19:56:51,2013-09-04 19:56:51
3a6868bc2fa1e1cd76ae8691c68cb96c857ff265...28e75b23b39aa0aee951378bf1039886c00f7783,1,2,5,7,1,2013-09-04 18:21:24,2013-08-18 06:58:04
3a6868bc2fa1e1cd76ae8691c68cb96c857ff265...ad5796de9febb5724bd2bf0639ae617c2ff34ba5,1,7,1,8,2,2013-09-04 17:17:10,2013-09-04 17:17:10
48070274ee93bf0d4cef7486a4ec19c4d97ac9ce...bb42801cdcd0924ada0ff5ccb3a84aa9a1cbd916,1,0,19,19,1,2013-10-14 08:54:50,2013-10-14 08:54:31
48070274ee93bf0d4cef7486a4ec19c4d97ac9ce...8e4b3a33906785c3181151cc46bb323952f6eb2b,2,5,0,5,3,2013-10-14 08:53:12,2013-10-14 08:53:12
51576069ad7470d308402536306c35f47cf89edb...7e580aacec10d64c2fa0811e41a35159e47fcfa4,1,3,3,6,3,2013-11-17 00:20:21,2013-11-17 00:20:21
51576069ad7470d308402536306c35f47cf89edb...0e64b987e8cbbd6944bd0594f8173f959867f4fc,1,5,5,10,5,2013-11-16 16:05:38,2013-11-16 16:05:38
51576069ad7470d308402536306c35f47cf89edb...bc74f65068b6b80b657e07f4ab2d7b115aacae75,2,3,3,6,3,2013-11-16 11:11:34,2013-11-16 11:11:34
51576069ad7470d308402536306c35f47cf89edb...5c741ef11db8777bc7723d879624ae8281121c18,1,15,0,15,1,2013-11-16 10:53:45,2013-11-16 10:53:45
51576069ad7470d308402536306c35f47cf89edb...152459b7272daa30ab5207b512f5319fdc4ff491,2,40,6,46,7,2013-11-16 10:45:30,2013-11-16 10:45:30
51576069ad7470d308402536306c35f47cf89edb...f04142c1f765b4d1afb8eb388f3ca9466c22abf7,1,34,0,34,1,2013-11-16 10:36:33,2013-11-16 10:36:33
51576069ad7470d308402536306c35f47cf89edb...af05ab399e17c97bdea4b3ee893c47f29c0e22a5,1,26,2,28,2,2013-11-16 10:26:47,2013-11-16 10:26:47
51576069ad7470d308402536306c35f47cf89edb...27159ce6bac4308b5fba311258fab8e852667787,3,9,4,13,5,2013-11-16 10:15:04,2013-11-16 10:15:04
ad5d67555387608b0ee16be2821ac2967ff9e0b4...7e00ba03ecd4f1b30e49dbc07160b09929dd786c,2,1240,1240,2480,322,2014-01-15 19:12:05,2014-01-14 22:12:21
07f62f199fa81e9645114589ecaeb888a6084649...710d5a48fb751623fbf77a51b89f2dfbf0edac68,2,85,80,165,7,2014-01-14 10:21:07,2013-12-20 10:30:45
710d5a48fb751623fbf77a51b89f2dfbf0edac68...a4868e233c7ebce259fc02d3dbfb241c23471a4a,1,73,25,98,10,2014-01-14 10:21:29,2013-12-20 11:08:34
07f62f199fa81e9645114589ecaeb888a6084649...93e120e7d67313086d8bdecbcb57ea68958f91e4,5,49,0,49,6,2014-01-13 12:41:04,2013-12-17 08:12:44
07f62f199fa81e9645114589ecaeb888a6084649...d54ce8087aba23663856c81a3fb5475979bdf453,1,105,17,122,6,2014-01-13 12:36:11,2013-12-16 12:47:09
d54ce8087aba23663856c81a3fb5475979bdf453...ba52130873395a44d637fc57f98ed174f0ac87bb,1,4,4,8,2,2014-01-17 10:01:28,2014-01-15 09:07:47
07f62f199fa81e9645114589ecaeb888a6084649...f30ca8935d128bbd060a04b47cec2f26d682797b,1,25,3,28,1,2014-01-13 12:17:47,2014-01-10 05:33:19
bb76985d39112fc07e64334704702a90d0bea8f1...010d74ec2f3dfefea5cafa602bce5cdeac3a0c19,2,35,1,36,2,2014-01-08 02:06:20,2014-01-08 02:00:49
bb76985d39112fc07e64334704702a90d0bea8f1...a95712899e33f267a3061fa94d05189e7c371eaa,1,7,3,10,3,2014-01-08 01:38:07,2014-01-08 01:38:07
bb76985d39112fc07e64334704702a90d0bea8f1...b57051a7247c61fdd9dc06710cd61521dca91940,1,115,44,159,21,2014-01-08 01:28:07,2014-01-04 00:52:18
b3addb5fb8814c0e76e2115404caef8a4efb393c...1137ecf7d1301e7f743978e02d874093bd68dacb,2,35,12,47,4,2014-01-08 01:46:04,2014-01-08 01:46:04
b3addb5fb8814c0e76e2115404caef8a4efb393c...13ebc68636f922e799d71792748934b8883d2f1f,6,9,13,22,9,2014-01-08 01:07:04,2013-12-27 15:18:40
13ebc68636f922e799d71792748934b8883d2f1f...94c803e9f0e725e6a52f71ffaa88d05137b62771,1,5,1,6,1,2014-01-08 01:08:14,2014-01-05 14:50:57
b3addb5fb8814c0e76e2115404caef8a4efb393c...0eb5f233d68e9a6ec6e0643cc17355ac5ffdfe06,1,16,1,17,2,2014-01-08 00:19:44,2014-01-08 00:17:15
980eda4c25c2221127f93b7b5194e372a29be197...cdf0cf495d0e0f0bbfdd8021f9cd6e68a8234dd4,1,1,0,1,1,2013-11-05 23:41:54,2013-11-05 23:41:54
980eda4c25c2221127f93b7b5194e372a29be197...1dc34e2b965253a62d52f84a0f548334d4d6aa9d,1,23,1,24,6,2013-11-05 23:26:07,2013-11-05 23:26:07
1dc34e2b965253a62d52f84a0f548334d4d6aa9d...04aca7c9e3edddc57a1fbc11e57e6c62e6847126,1,13,13,26,7,2013-11-06 03:07:14,2013-11-06 03:07:14
04aca7c9e3edddc57a1fbc11e57e6c62e6847126...20881f1f787e093a6f3e9360624d8b436b9f7379,1,58,43,101,15,2013-11-06 05:18:45,2013-11-06 03:15:41
4947f61c2038ea3687d308782578bfdc9cec7c5c...70c976de03ae5b83952e7ddfadfc75e358c5bbef,1,7,2,9,2,2013-10-29 14:17:12,2013-10-29 14:17:12
70c976de03ae5b83952e7ddfadfc75e358c5bbef...4f5790d10407e143f9d42a75eb4800cfe3f49263,6,129,99,228,39,2013-10-29 17:57:42,2013-10-29 17:57:42
a6a274f31273c635d6201381456fbc190bf774cd...eb79e8c5dd71a70c3d8567a4f3d437a2cd0a5d9c,12,0,398,398,12,2013-10-29 19:14:15,2013-10-29 19:14:15
a6a274f31273c635d6201381456fbc190bf774cd...e0b59ab52b87b8fc15dd5534c3231fdd74843f9f,3,7,8,15,7,2013-10-29 18:18:34,2013-10-29 01:23:41
e0b59ab52b87b8fc15dd5534c3231fdd74843f9f...700a71e6b62a3786d11719ae30cacd0f90930525,2,19,4,23,6,2013-10-29 21:29:01,2013-10-29 18:59:08
05430c7170f0e0f7a9ad6905645b6f7c657b63c5...ff147707b2382cc3d9f09fc09b306d4c50a39dfd,1,3,2,5,2,2013-10-29 19:41:26,2013-10-29 19:41:26
19ad299600ff9acddc7baf1a97deab231c669f50...1182797c6d6bf4bb87e5edcddd75edb3f995dac0,1,61,42,103,17,2013-11-05 01:18:37,2013-11-05 01:18:37
1182797c6d6bf4bb87e5edcddd75edb3f995dac0...e88368b34cab8d4b7d5a1179cdd25fc9cd2b3d79,2,0,138,138,2,2013-11-05 20:28:57,2013-11-05 20:28:57
f6b4a1ec9545c230df52d56da807d93f32208730...4194617bfe1e29bae2c2515aefbed5f1f2a1ebc1,2,15,1,16,2,2013-11-01 22:15:06,2013-10-24 02:04:03
4194617bfe1e29bae2c2515aefbed5f1f2a1ebc1...5a9adfe9fb5bc988185ef41ca637fbeee73e947c,3,21,6,27,7,2013-11-01 23:06:46,2013-11-01 23:06:46
1d9139bb890667fcd437a7316d2ff1b9a41dc250...7cf7dda87d59981f8a1727725f6d914dcc4c1815,1,6,1,7,1,2013-11-11 18:13:16,2013-11-11 18:13:16
f417c4b09955e3b250bec19a0d4b13ff30ba4e80...5957dd909134fc3c3dc3e165b83559feb89d9f5b,3,14,20,34,12,2013-11-08 06:15:19,2013-09-20 08:55:17
5957dd909134fc3c3dc3e165b83559feb89d9f5b...bf8e0277bbd1c2df2310bc20ecc4003d1ed7a657,1,23,0,23,2,2013-11-08 06:16:45,2013-11-08 05:34:54
bf8e0277bbd1c2df2310bc20ecc4003d1ed7a657...8cc19765b48d1a429b840b731ed5fd5b81fbda3c,2,6,2,8,2,2013-11-10 06:06:55,2013-11-10 06:06:55
8cc19765b48d1a429b840b731ed5fd5b81fbda3c...62f873aa1f918fe4d303f6168f66d057e6776b18,1,1,1,2,1,2013-11-11 19:26:24,2013-11-11 19:26:24
f417c4b09955e3b250bec19a0d4b13ff30ba4e80...49d7b87cfc4385470a5ecf181f92c13b8391c002,1,5,1,6,1,2013-11-08 02:54:00,2013-11-08 02:54:00
b5c984f9b4899d577430134135379b0088d88b47...ec4657b28a3e97447921357d454df974e0979ac6,2,33,6,39,8,2013-11-07 22:23:39,2013-11-01 23:29:25
b5c984f9b4899d577430134135379b0088d88b47...304d39cc505ff51682dd7e1337f9f0ab7536eec3,4,14,4,18,6,2013-11-07 22:06:49,2013-11-07 22:06:49
304d39cc505ff51682dd7e1337f9f0ab7536eec3...eba3c36b386f389953eda6315948577200c9bf2c,2,7,2,9,2,2013-11-07 22:44:07,2013-11-07 22:44:07
b5c984f9b4899d577430134135379b0088d88b47...6998c3c387518ba8e06ceff00b10be583c95d6cd,13,70,74,144,39,2013-11-07 20:27:33,2013-11-07 20:19:24
b5c984f9b4899d577430134135379b0088d88b47...26f846bf779c97a69e85db356dff8c1fff76161c,1,2,3,5,3,2013-11-07 20:23:29,2013-11-07 20:23:29
b5c984f9b4899d577430134135379b0088d88b47...97c3de7e6b92b13efa30c5c840ce2fab07b8794e,2,4,2,6,3,2013-11-07 20:20:23,2013-11-07 20:20:23
0dd6c6645bd7148537c6e4b3b32abe1c852b992c...360a694c52a48e0305317a18c59dc5ddc44859ad,2,39,1,40,2,2013-11-06 19:43:02,2013-11-06 19:42:39
0dd6c6645bd7148537c6e4b3b32abe1c852b992c...c5bc7d515836cffee90ba5bb342272bba64d9f37,1,35,0,35,1,2013-11-06 19:39:09,2013-09-12 13:17:39
c5bc7d515836cffee90ba5bb342272bba64d9f37...157d99a72786c454dfaad8b0800914cc80879aa8,2,38,4,42,6,2013-11-06 19:43:06,2013-10-29 15:16:51
e12bba66ea784e0c7859b5679d6a55d639889508...d33ffe44a9f09b0e0aedf162ee17076571479003,3,279,2,281,4,2013-11-16 02:12:35,2013-11-16 02:12:35
e12bba66ea784e0c7859b5679d6a55d639889508...926169059374fb7a7a7035dde4e78f3418778a80,1,1,0,1,1,2013-11-16 00:23:55,2013-11-16 00:23:55
1de02a70dea3249413da4a06a205d7d9c98145aa...1cd9529ad350f70aaf6627368bdc8d007b90b3e4,2,2,2,4,2,2013-11-19 17:10:42,2013-11-19 17:10:42
1de02a70dea3249413da4a06a205d7d9c98145aa...3656db66d2f13d74e07574d229b32023bb11dc1f,2,3,3,6,3,2013-11-19 13:44:50,2013-11-19 13:44:50
1de02a70dea3249413da4a06a205d7d9c98145aa...2fe4467d73b1bfe4a64011ee9d6b6aaf8b244fa5,1,2,2,4,1,2013-11-19 02:39:02,2013-11-19 02:39:02
78ef0bd9985d899dda6fdfc8c35d9ab47f7f07d7...ddb27268c98941b9f8a131b7b5403eb4d44beebb,1,5,1,6,1,2013-11-09 00:11:57,2013-11-09 00:11:57
78ef0bd9985d899dda6fdfc8c35d9ab47f7f07d7...6669c86fdf1ae07b66a6e178e269d797f6397bca,1,4,1,5,1,2013-11-08 19:56:34,2013-11-08 19:56:34
6669c86fdf1ae07b66a6e178e269d797f6397bca...20f690f1762e369e9ad761e166f22ff57a17275a,1,11,2,13,3,2013-11-08 20:06:15,2013-11-08 20:06:15
20f690f1762e369e9ad761e166f22ff57a17275a...f512049c8f9e64848cd8b1be794619f01c5227f2,1,40,0,40,1,2013-11-08 20:25:17,2013-11-08 20:25:17
f512049c8f9e64848cd8b1be794619f01c5227f2...95147675870e9e84deb354f09f0f670a5cb2b1e1,5,9,11,20,7,2013-11-08 22:54:20,2013-11-08 22:54:20
95147675870e9e84deb354f09f0f670a5cb2b1e1...1eb00e1d5b375cb79d492f1c5cd95d7317bc543c,2,6,6,12,2,2013-11-08 23:32:50,2013-11-08 23:32:50
4d90e9124390a7b1da125f0973fee72b83e19e93...77ae9789d3e1cfb895de9eaf343866f984c92668,2,10,13,23,6,2013-11-07 20:30:56,2013-11-07 20:30:56
77ae9789d3e1cfb895de9eaf343866f984c92668...a63ff8da46e11c857cd3d743d72d211c96b637e4,1,4,0,4,1,2013-11-07 20:31:50,2013-11-07 20:31:50
a63ff8da46e11c857cd3d743d72d211c96b637e4...f2bab1557c3fef4a95b5b982fe7127fcb29c4f8f,7,162,158,320,66,2013-11-07 22:38:50,2013-11-07 20:34:01
f2bab1557c3fef4a95b5b982fe7127fcb29c4f8f...4a8a7d4edd53251c8de7ea087b092869e15621d5,4,71,79,150,15,2013-11-07 22:41:55,2013-11-07 22:37:33
699a1074fb9cdf323044f8c132d7130f6a2945bc...ff42748bc567745198b33baa697338dd697fb621,5,26,26,52,23,2013-11-04 01:54:51,2013-11-04 01:54:51
37dcff0c13c6e4ee71b22b7e4902c2e4b4b88132...2d1155407a6e24b595d2627af6fa9f9f702483d2,1,51,0,51,1,2013-11-07 02:07:55,2013-11-06 17:37:01
2d1155407a6e24b595d2627af6fa9f9f702483d2...9990db2f5a762fdbc198cbfc5e96370d859739bb,1,2,2,4,2,2013-11-07 02:07:55,2013-11-07 02:07:38
d4c8fb9ee27222e4d33b616bd63ea7863e0064ee...476559458d49b6d4eacfdbe9025ddf69947ae2b7,3,68,64,132,23,2013-11-22 19:58:02,2013-11-22 18:12:27
476559458d49b6d4eacfdbe9025ddf69947ae2b7...1f9223a7c2c0e5c04936c56a071830f8792c3dd7,2,9,2,11,4,2013-11-22 20:00:34,2013-11-22 18:36:49
1f9223a7c2c0e5c04936c56a071830f8792c3dd7...076c0eab704e5c4819611a42b1551f1d759fb376,1,57,54,111,25,2013-11-22 20:14:34,2013-11-22 20:14:34
5f2313aad396a7cf5750fd5c13236bc5b81b8026...e4aba11e80561d06e457453c58def970518b691c,1,3,1,4,1,2013-12-02 21:56:51,2013-12-02 17:43:56
233ad38802174cc5a3458a34bebaf78472a348d1...0bb2c0b1d0f651e23c949381762fe79a45c58aeb,1,1,2,3,1,2013-11-26 07:20:36,2013-11-26 07:20:36
b57d7dca9de306d9372dfde6cd736aef1c4416e1...82dd417ef6966b0f3d812122c18420feb64f49a7,1,37,10,47,10,2013-09-05 19:36:16,2013-09-05 19:36:16
82dd417ef6966b0f3d812122c18420feb64f49a7...d368c2dee99b35830392938a783137f344e5b89a,1,4,4,8,4,2013-09-05 19:36:56,2013-09-05 19:36:56
230dc07d372cccb1aa1198ae300d06e418c73af6...559724ac35134ac3cced1159cf776b7ab7bdacc6,1,1,1,2,1,2013-08-29 22:37:47,2013-08-29 22:37:47
230dc07d372cccb1aa1198ae300d06e418c73af6...f1d0625cf895abd1e6b22db3470216b9b9c5ef29,1,8,0,8,1,2013-08-29 18:45:03,2013-07-27 00:40:45
f1d0625cf895abd1e6b22db3470216b9b9c5ef29...c3154fdf4d15aed049a9c18a36cc8511ed7e82c1,1,4,5,9,2,2013-08-29 18:45:03,2013-07-27 01:12:05
c3154fdf4d15aed049a9c18a36cc8511ed7e82c1...23dc52f52804219bd57b34217d8778bda0444f13,3,2,9,11,3,2013-08-29 18:45:04,2013-07-27 16:13:02
23dc52f52804219bd57b34217d8778bda0444f13...2357fecc92c57e2fcd4a37c60d713508210358f7,2,67,88,155,23,2013-08-29 18:46:41,2013-08-03 23:43:20
2357fecc92c57e2fcd4a37c60d713508210358f7...6e4a818ee65008a043d3ba8e5053cc43babb2f66,2,8,7,15,7,2013-08-29 18:46:41,2013-08-04 00:27:15
6e4a818ee65008a043d3ba8e5053cc43babb2f66...f18889bf674e574a3ac1315ed7bbd56bf638e6c5,1,2,1,3,2,2013-08-29 18:46:41,2013-08-04 04:30:07
f18889bf674e574a3ac1315ed7bbd56bf638e6c5...b54ba5095bc8b9323a3649806df98345cbe1f3b0,2,2,2,4,2,2013-08-29 18:46:41,2013-08-18 04:08:00
b54ba5095bc8b9323a3649806df98345cbe1f3b0...b8a89628339dd63b5f2ff3d28715a5431412b65a,2,15,15,30,8,2013-08-29 18:46:42,2013-08-18 04:29:37
b8a89628339dd63b5f2ff3d28715a5431412b65a...e7ee2f443ad93803e8312bc224da618d555aebdc,1,0,2,2,1,2013-08-29 18:46:42,2013-08-18 05:22:11
e7ee2f443ad93803e8312bc224da618d555aebdc...78d995bbd6dc8022faef251835ae6001c4c3da49,1,1,1,2,1,2013-08-29 18:46:42,2013-08-18 05:22:24
78d995bbd6dc8022faef251835ae6001c4c3da49...9f8e5a93b4b7c6b190177c73085e7d2d2d93c64b,1,5,3,8,1,2013-08-29 18:46:42,2013-08-18 05:28:05
02037a9b535561c97b4c2f65bc920282f4f35c4d...c6dc90ccb9a77dab9f40c13be7465a759a25885b,1,3,1,4,1,2013-09-11 17:39:33,2013-09-11 17:39:33
557e3ec88e319e8547efda73ffe54773a7ed918d...b7a3fc687ec55b68ee0cadf78d7f1eff3e531fbd,6,23,11,34,16,2013-09-12 16:55:36,2013-09-10 18:39:47
b7a3fc687ec55b68ee0cadf78d7f1eff3e531fbd...1d935c630745248d5851440eb0907cd363cd88d0,1,1,1,2,1,2013-09-12 16:57:10,2013-09-12 16:57:10
557e3ec88e319e8547efda73ffe54773a7ed918d...718b1f9fe74f3a26881e462b3e9e91a93232568b,1,1,1,2,1,2013-09-12 07:55:05,2013-09-12 07:55:05
bd0e4fde9a2a1fb1f676e7ea19e111be46cb87c8...9cfbaecfe5b1ccb1ab21c66400f3a1ba1b33da1e,2,58,0,58,2,2013-09-11 01:17:42,2013-08-30 00:22:08
bd0e4fde9a2a1fb1f676e7ea19e111be46cb87c8...f482432a76a898e5d0252b6c5878a0e60290d0a4,2,3,3,6,3,2013-09-10 22:13:15,2013-09-10 22:13:15
45cedefadb444e8d7305defd246c63537fca04df...6c1c404501d72c5c0ba488689b331ee0e01d5753,43,5648,0,5648,36,2013-09-13 03:42:26,2013-09-13 03:42:26
6c1c404501d72c5c0ba488689b331ee0e01d5753...4a707a8800f95c2d7c8ba269da7dcdfaba6acbc6,193,63885,0,63885,191,2013-09-13 17:24:38,2013-09-13 17:24:38
c8f885a4d048e5adaa485e674999d79fb2d717db...630ae43e7d11fa34421a253c765edb6cef5a3371,1,2,2,4,1,2013-09-09 14:19:45,2013-09-09 14:19:45
630ae43e7d11fa34421a253c765edb6cef5a3371...9749d94fb0f3034247dbd969f6dad390f2605e1a,1,2,0,2,1,2013-09-09 14:30:06,2013-09-09 14:30:06
c8f885a4d048e5adaa485e674999d79fb2d717db...268928ab35a5402ff37413ab258200c4bed48790,1,2,0,2,1,2013-09-09 10:01:15,2013-09-09 10:01:15
e89396809fc3cc9a52e7787f829a8b96c7cee4a4...8ae5348a51ab6026db29009f109bb3724908f0aa,4,120,16,136,14,2013-09-11 21:48:22,2013-09-10 01:14:23
8ae5348a51ab6026db29009f109bb3724908f0aa...289350e63397bf918fbd75726a6e06f0fe49b81b,1,89,0,89,1,2013-09-11 21:48:22,2013-09-10 01:23:03
289350e63397bf918fbd75726a6e06f0fe49b81b...e854b7b2e6666d8b47f2c9714ac3bef2320fc40b,6,212,116,328,22,2013-09-11 21:49:33,2013-09-11 18:35:09
e854b7b2e6666d8b47f2c9714ac3bef2320fc40b...082d142024e69a817ed96772ee3057bbdeaa8d7d,4,1251,7,1258,7,2013-09-11 22:41:44,2013-09-11 22:14:33
082d142024e69a817ed96772ee3057bbdeaa8d7d...cb18a6e1b934b7f5c63f8931ee8fe51e2789c597,6,63,95,158,19,2013-09-27 00:36:21,2013-09-26 22:59:02
110d3b77949de024c5eb3263fd06f7d819a90682...1a8a540209c997f5e75a476b942365aad892ad35,1,7,0,7,2,2013-08-30 13:23:32,2013-08-30 13:23:32
110d3b77949de024c5eb3263fd06f7d819a90682...6c206f7d7835310c39ef20d3375e949b1fbfd7b9,1,3,5,8,2,2013-08-30 06:12:13,2013-08-21 04:44:58
2ea19238ff0565560a1a0aee62a26cd9e8d1fe72...d605e82badf64c3033f5f26199285aed414f63dd,1,3,1,4,2,2013-08-30 18:08:29,2013-08-30 18:08:29
ffc850244f4450990eb1c2e13dc1f35c2d4772b4...85a51396657945613141abb8a521e118db15afe3,4,83,0,83,4,2013-10-04 06:45:15,2013-09-13 11:02:44
8e3844cd343c5939d85603505ff94ca7e48eed8f...8878943ac9ab3b3344d398b45e68ebb7cea879f0,1,5,3,8,3,2013-09-04 21:41:09,2013-09-04 21:38:03
5892c8e46950268faa9cc02b611a71d0a182d47c...80bd64245f14d4d8a6fc8349cff8b441d770da42,3,31,7,38,9,2013-10-15 18:49:13,2013-10-15 18:49:13
5892c8e46950268faa9cc02b611a71d0a182d47c...4431e9edb7cf49ec7da8201da1221b5b03ea09ee,1,1,1,2,1,2013-10-15 18:30:06,2013-10-15 18:30:06
5892c8e46950268faa9cc02b611a71d0a182d47c...7093411a8dd36612ddc636c14395e33ecff47f7f,5,20,23,43,16,2013-10-15 03:53:48,2013-10-13 01:47:00
7093411a8dd36612ddc636c14395e33ecff47f7f...5ebaca7e55e006083e6e9c2782e4f8b421275579,1,16,0,16,4,2013-10-15 21:27:47,2013-10-15 21:27:47
5892c8e46950268faa9cc02b611a71d0a182d47c...5778ed7db2fee3b7005a53a06d010272504924e9,1,6,5,11,3,2013-10-15 01:36:18,2013-10-15 01:33:29
5892c8e46950268faa9cc02b611a71d0a182d47c...3455c1a0983ae74d22b05abc3c0552460c6a2710,1,28,2,30,3,2013-10-15 00:48:43,2013-10-15 00:48:43
5892c8e46950268faa9cc02b611a71d0a182d47c...5dd12ba20a962c0f67e5eefb7b0e00e5caccb1e1,1,5,1,6,2,2013-10-14 21:23:58,2013-10-14 21:23:58
3885ef585bf132a04e174f32e6bb7e86d7730c32...87b4bb9fcc41806da4ed3151e74511120c099115,1,1,1,2,1,2013-11-13 12:32:49,2013-11-13 12:32:49
3885ef585bf132a04e174f32e6bb7e86d7730c32...f5e6c2d060d5eb052929c4ab14bf3256b260afc4,1,1,1,2,1,2013-11-13 12:20:38,2013-11-13 12:20:38
3885ef585bf132a04e174f32e6bb7e86d7730c32...f0f8462d18cf2efc44ee48cfdd2706e8a4a800d6,1,28,13,41,2,2013-11-13 12:11:20,2013-11-13 12:09:44
3885ef585bf132a04e174f32e6bb7e86d7730c32...0013aa7d9f74eab1c6d02cf9f7b35a1b9364b17a,1,2,5,7,3,2013-11-13 09:29:00,2013-11-13 09:29:00
3885ef585bf132a04e174f32e6bb7e86d7730c32...6a693176d6b2dbf4afd36ebda2aeb9495fdf42bc,1,6,2,8,1,2013-11-13 06:58:24,2013-10-31 15:49:30
6a693176d6b2dbf4afd36ebda2aeb9495fdf42bc...1d7f22c0d4bb55cf797b303cc46b1944509e4085,1,17,6,23,2,2013-11-13 07:08:46,2013-11-13 06:59:24
3885ef585bf132a04e174f32e6bb7e86d7730c32...8523d5518c500903c19a53f73c653318e4db38f9,1,1,1,2,1,2013-11-13 04:51:12,2013-11-13 04:51:12
629c6e36492336f01fd4e25426a5c875f52628e2...693ff4d2ae5f0d723469340f67bb55f7aa3e824b,1,4,1,5,1,2013-11-14 23:54:28,2013-11-14 23:53:43
457375ea370a2da0df301d35b1aaa8f5964dabfe...3cbec951772b9849c0ba679a5988b54384d05ce1,1,10,17,27,5,2013-11-19 20:09:30,2013-11-08 14:40:46
457375ea370a2da0df301d35b1aaa8f5964dabfe...ed8f75d25ca0fb46d8c06bfe74bbc386bf4e8a8f,4,158,168,326,89,2013-11-18 19:25:13,2013-11-18 19:25:13
457375ea370a2da0df301d35b1aaa8f5964dabfe...3c67a2849337f3b9bd92dd389f0e02e48a36028b,3,15,1,16,3,2013-11-18 17:51:47,2013-11-10 21:50:34
457375ea370a2da0df301d35b1aaa8f5964dabfe...440422a96346072a0a9016c4db78ff7599a702aa,1,3,0,3,1,2013-11-18 17:45:29,2013-11-12 15:06:54
457375ea370a2da0df301d35b1aaa8f5964dabfe...fc2f5758cf22fe5d3d46be7e4642abc0735e2c8d,1,3,3,6,2,2013-11-18 17:42:30,2013-11-12 03:58:40
457375ea370a2da0df301d35b1aaa8f5964dabfe...30ea0bebce340dfc257b5b45835234cb921f3a48,1,2,2,4,2,2013-11-18 16:23:06,2013-11-06 01:29:55
30ea0bebce340dfc257b5b45835234cb921f3a48...baa687bed2f1f9ee6e44c70d95baad8757ac529c,1,1,1,2,1,2013-11-18 16:23:30,2013-11-12 03:57:29
baa687bed2f1f9ee6e44c70d95baad8757ac529c...72d02ecdde2ba6f39739a0a942f2c4a057b4d45f,1,5,0,5,1,2013-11-18 16:23:30,2013-11-06 15:57:43
72d02ecdde2ba6f39739a0a942f2c4a057b4d45f...fe302fbfd26fc7db5d751d4bec8a0bd4ce6030a4,1,1,1,2,1,2013-11-18 16:23:30,2013-11-12 20:16:51
fe302fbfd26fc7db5d751d4bec8a0bd4ce6030a4...fef41ef7bf83ed04c7df8e0247e60c0d495eefdc,1,8,0,8,2,2013-11-18 21:07:06,2013-11-12 16:21:02
fef41ef7bf83ed04c7df8e0247e60c0d495eefdc...4b80ec9aae2f43e831de64f3746c7838252e9203,1,2,2,4,2,2013-11-18 21:07:11,2013-11-08 17:08:18
457375ea370a2da0df301d35b1aaa8f5964dabfe...9e1da3ec9ce8e608c17d999446882ae096b8394f,1,1,1,2,1,2013-11-18 05:36:26,2013-11-18 05:36:26
457375ea370a2da0df301d35b1aaa8f5964dabfe...b76574f85512d3566bd056d516084e777788a82c,1,1,1,2,1,2013-11-18 05:10:06,2013-11-18 05:10:06
f78d45863cb285e45edd427a958962421d3832f2...aeb304b37c190e7fab60c0db946d1fd5d8e9e9f3,1,4,6,10,1,2013-11-19 17:50:38,2013-11-19 17:50:38
2bc35287a080cd9a9805e343595055dcbfb0db01...d7e2fc898284fe29ed43f7b28eae56e7e052e854,1,2,0,2,2,2013-11-21 13:06:02,2013-11-21 13:06:02
2bc35287a080cd9a9805e343595055dcbfb0db01...fd7ab143bf1ecfbf20df90edd876f73dc28c264d,3,107,79,186,21,2013-11-21 01:28:19,2013-11-21 01:28:19
8e71391572adeaa6e5d0f980e71168ba8ef98b46...b00d5f018541bf141dc4732ad6d71d23b8c28b43,8,68,70,138,30,2013-11-13 19:25:55,2013-11-13 19:25:55
0113c087b22c7ffe03c4745bc9d05a0523ecbe5c...7fbc315aa96f75322643c3e94b418fead6925144,3,19,15,34,11,2014-01-15 21:52:35,2014-01-15 21:52:35
7fbc315aa96f75322643c3e94b418fead6925144...a98e40fa73cdba36b7a7032917e58233ef31ea59,1,10,10,20,6,2014-01-15 22:47:35,2014-01-15 22:47:35
bfc256f6c99461d2051bebc611bb06287b58a867...f231539e995a70a49903e9a852535d2c8a8eca43,3,54,3,57,4,2014-01-14 23:20:21,2014-01-14 22:28:19
6652416f4c18bd59575c7788747335eab7b4d304...17a806c8a0b6add2aa773dfca272acefee9b638c,10,269,174,443,69,2014-01-13 23:49:33,2013-12-12 22:39:35
17a806c8a0b6add2aa773dfca272acefee9b638c...3a610f754f425ea6042c3f8b5452273656a06c90,7,112,99,211,54,2014-01-13 23:50:20,2013-12-13 18:26:00
3a610f754f425ea6042c3f8b5452273656a06c90...aca1270104802347f5aa3104959282924b631daa,4,26,75,101,8,2014-01-13 23:50:20,2014-01-13 19:20:33
aca1270104802347f5aa3104959282924b631daa...16ca6a1c12ffe9a02da4e823646bee6461ffbad5,6,58,44,102,15,2014-01-14 00:20:05,2014-01-13 22:55:31
6652416f4c18bd59575c7788747335eab7b4d304...1004c2d3d8ed826e6568f6640ac6aa3160f31a8d,1,1,0,1,1,2014-01-13 23:25:23,2014-01-13 23:25:23
6652416f4c18bd59575c7788747335eab7b4d304...89bed4337d2314c3ffaac231c141b635ecc65ac5,1,1,1,2,1,2014-01-13 20:37:29,2014-01-13 20:28:30
a60f0a07542b923f81adef2b56621a1eb712d008...b1953baba28362c928d962f0729325d3293c4753,14,14,14,28,14,2014-01-22 01:21:56,2014-01-22 01:21:56
a60f0a07542b923f81adef2b56621a1eb712d008...7379a22a8d1687fc004a129ec86fd6eb01c39ede,1,17,2,19,4,2014-01-20 07:38:54,2014-01-11 10:31:01
a60f0a07542b923f81adef2b56621a1eb712d008...c6e43154f186c9fac8501016473b459db3130222,1,260,119,379,64,2014-01-20 07:28:55,2014-01-11 08:00:03
c6e43154f186c9fac8501016473b459db3130222...fb981bdace66e5b34d41125beb16e450998fd1e7,3,5,5,10,5,2014-01-20 07:28:55,2014-01-13 20:16:12
a60f0a07542b923f81adef2b56621a1eb712d008...b8cca8138b9aa10fd087e6ebb62ca03d1e820f2f,1,4,1,5,1,2014-01-20 00:37:06,2014-01-15 04:59:55
a60f0a07542b923f81adef2b56621a1eb712d008...595b8f29869455432e14e58fcdd9c64bc74dd3fd,1,5,0,5,2,2014-01-20 00:27:43,2014-01-19 21:07:18
010d74ec2f3dfefea5cafa602bce5cdeac3a0c19...32565a4451c9c7f929a37d61ded70fc1de7fe993,2,3,3,6,4,2014-01-14 18:27:31,2014-01-08 17:38:59
322a42b8a2ec70721d3db72cc15342e63187aad9...5aa304f9696d8fcc2e39628ce68a39bfc932adb4,1,67,77,144,31,2014-01-08 10:13:14,2013-12-09 14:58:04
5aa304f9696d8fcc2e39628ce68a39bfc932adb4...6b48761ce92e5f9590fd8b2723176ab72d297e6c,2,0,172,172,2,2014-01-08 10:14:14,2013-12-09 15:05:46
6b48761ce92e5f9590fd8b2723176ab72d297e6c...df4ea946a653fa3864574fd8110c6c618dde41d8,1,14,28,42,11,2014-01-08 10:14:25,2013-12-09 17:01:32
df4ea946a653fa3864574fd8110c6c618dde41d8...145501bee3f37ccb022189e7b76f31abcbdbed3c,1,17,17,34,8,2014-01-08 10:14:30,2013-12-09 17:01:53
145501bee3f37ccb022189e7b76f31abcbdbed3c...c4535c833dfdaef275d765968a2ed5513ef09097,1,15,15,30,11,2014-01-08 10:37:22,2014-01-08 10:37:22
322a42b8a2ec70721d3db72cc15342e63187aad9...c9cebf3a73efa4827d051ddd69a8590b03419f8a,1,3,1,4,2,2014-01-08 09:58:55,2014-01-08 09:58:55
c9cebf3a73efa4827d051ddd69a8590b03419f8a...8298a200ce3bbab7d00ab73e8bac34643c7a1fc5,1,1,1,2,1,2014-01-08 17:45:06,2014-01-08 17:45:06
322a42b8a2ec70721d3db72cc15342e63187aad9...53a01aebd61e8db34c9106f5b2c5fdad6909caee,2,10,0,10,4,2014-01-08 08:17:20,2014-01-08 08:14:00
322a42b8a2ec70721d3db72cc15342e63187aad9...a3ee36b7474c70afdd12fa2210821cb080bc0a07,1,1,1,2,1,2014-01-08 08:11:06,2014-01-08 08:11:06
322a42b8a2ec70721d3db72cc15342e63187aad9...7626e9fd6448cbaa92632f2ce9cab70e9e142d8a,1,1,1,2,1,2014-01-08 07:27:50,2014-01-08 07:27:50
322a42b8a2ec70721d3db72cc15342e63187aad9...e525ad3f9be05bfab388896ae559411650429553,3,5,5,10,5,2014-01-08 05:15:53,2014-01-08 05:15:53
6113e1d62d429e7520a517ecbff331d58d51a0b7...74f853a2aeaf86ff675ecab5387bbd710a0138b7,1,12,1,13,2,2013-11-06 05:44:52,2013-11-06 05:44:52
6113e1d62d429e7520a517ecbff331d58d51a0b7...3108f0526ef25596c7f6f545b07c95d90e966a7d,1,2,2,4,2,2013-11-06 04:48:16,2013-11-06 04:48:16
6113e1d62d429e7520a517ecbff331d58d51a0b7...15867ff4308c5c1330a400be56410d404336100f,4,50,31,81,13,2013-11-06 03:58:15,2013-10-06 05:44:04
15867ff4308c5c1330a400be56410d404336100f...d7928b9a673e9b2aff36fa6961481312455c91f4,2,42,2,44,4,2013-11-06 03:58:15,2013-10-06 05:59:49
d7928b9a673e9b2aff36fa6961481312455c91f4...dcf0279a50e7a2eca97b205725df474a516b8f79,1,1,0,1,1,2013-11-06 03:58:15,2013-10-06 16:36:38
dcf0279a50e7a2eca97b205725df474a516b8f79...2a5998baf172f94a8d6866e46207a0d7d75e70e5,3,23,48,71,6,2013-11-06 03:58:15,2013-10-08 13:41:44
2a5998baf172f94a8d6866e46207a0d7d75e70e5...8f64759881b3d48e42927ed9bdf1c9162d3c8bb3,2,51,0,51,3,2013-11-06 03:58:15,2013-10-08 13:52:36
8f64759881b3d48e42927ed9bdf1c9162d3c8bb3...ec9a9a08b8b76079207ced5b55a7caade27fb3d3,1,88,0,88,3,2013-11-06 03:58:16,2013-10-09 14:38:39
ec9a9a08b8b76079207ced5b55a7caade27fb3d3...059bb7a262a7620d8c7c5fdd064af352ae242f65,3,37,44,81,18,2013-11-06 03:58:16,2013-10-13 13:42:01
059bb7a262a7620d8c7c5fdd064af352ae242f65...d9fe0647cb464ccd6f79ac33fb1d1ac56441f6b0,2,49,0,49,3,2013-11-06 04:04:24,2013-10-13 22:36:05
d9fe0647cb464ccd6f79ac33fb1d1ac56441f6b0...f1aeac361aadc90a35e1b839933afbf9ad27a1a1,1,78,0,78,3,2013-11-06 04:23:02,2013-10-27 23:13:00
f1aeac361aadc90a35e1b839933afbf9ad27a1a1...b7d1d35c278c57ad4732dc23e529cf771158ee96,2,5,4,9,5,2013-11-06 04:23:07,2013-10-27 23:42:09
b7d1d35c278c57ad4732dc23e529cf771158ee96...6d5b73c2a6d668b11d6b5c643a45170265bf73c0,3,1323,2,1325,5,2013-11-06 04:23:07,2013-10-28 04:02:24
6d5b73c2a6d668b11d6b5c643a45170265bf73c0...22ef38ee79c2f353578f3642918a44126b4cb48c,1,1,1,2,1,2013-11-06 04:23:07,2013-10-28 04:35:24
22ef38ee79c2f353578f3642918a44126b4cb48c...16eba6bbb514fb4082e6779e175a29698a6734ce,1,1,3,4,1,2013-11-06 19:30:04,2013-11-06 19:30:04
16eba6bbb514fb4082e6779e175a29698a6734ce...363738b8f21d02c2e4fac84bd2776c2d4a5e6755,1,3,1,4,2,2013-11-06 20:03:45,2013-11-06 20:03:45
310fbe7bb77c36a0d548c50dc6b5b7358a495a6a...45c2b5dc1a0d8f3658f012844f9d89fbb2290c42,1,20,0,20,1,2013-11-08 23:01:01,2013-11-08 23:01:01
4f5790d10407e143f9d42a75eb4800cfe3f49263...e7402ed9cc823045a75baef32a090607f7272078,2,36,36,72,26,2013-10-30 12:50:21,2013-10-30 12:50:21
e7402ed9cc823045a75baef32a090607f7272078...3a14d4c923109b93ba805e661fa1573c3b2f9db7,1,1,1,2,1,2013-10-31 12:46:16,2013-10-31 12:46:16
67b0b97a8f17c67e5599f4566c8a9e1a5bb401fe...b3974abe4f01d408850e245c9b52c77f3571e0b2,10,182,46,228,37,2013-11-09 02:16:49,2013-10-25 01:59:59
67b0b97a8f17c67e5599f4566c8a9e1a5bb401fe...e7fdcc15c5eb3812c71dd61f22a8d77d3ae72e36,1,1,1,2,1,2013-11-08 21:52:10,2013-11-08 21:52:10
cd4f7321c932efe2c95e221e2e685856c79ef30d...01fea3cf116b768720b542ab65cbd1c2695848d0,2,32,2,34,4,2013-11-07 23:32:13,2013-10-22 11:48:10
cd4f7321c932efe2c95e221e2e685856c79ef30d...49c4231f077cb0b4804768231396c596d070a22f,2,35,2,37,4,2013-11-07 22:31:25,2013-11-07 22:31:25
f946a486ea3cdb56c771a37da281ad223b5042f8...60cb5f1a34147250a46b623964f88823a40a0280,1,4,1,5,1,2013-11-20 14:36:38,2013-11-19 14:41:10
60cb5f1a34147250a46b623964f88823a40a0280...ef14aaf627377b24edb55fe2080e10f748c0e444,1,3,0,3,1,2013-11-22 19:28:49,2013-11-22 19:28:49
f946a486ea3cdb56c771a37da281ad223b5042f8...ac821f2446628a9151587038f1d377f57985a452,1,14,1,15,3,2013-11-19 11:37:54,2013-10-19 01:17:00
ac821f2446628a9151587038f1d377f57985a452...78c843c8eff64da5e12725bdb111b18e51d82606,1,30,4,34,6,2013-11-19 11:53:34,2013-11-18 22:13:09
f946a486ea3cdb56c771a37da281ad223b5042f8...5e941f1ca035bb1ec014c18d277aecaa41deba85,11,199,208,407,78,2013-11-19 00:24:11,2013-11-18 23:35:56
f946a486ea3cdb56c771a37da281ad223b5042f8...76ee860ece15f8a7738c503fdd73f124f0ef1f4b,1,4,15,19,3,2013-11-18 21:21:03,2013-11-18 21:21:03
76ee860ece15f8a7738c503fdd73f124f0ef1f4b...194d4b93768c49f0d76a5da8943446efbea879ca,1,1,1,2,1,2013-11-19 02:23:00,2013-11-19 02:23:00
194d4b93768c49f0d76a5da8943446efbea879ca...1da8c50deddde692c1f87aec86c20cd3c2c3fd11,1,1,1,2,1,2013-11-19 17:14:39,2013-11-19 17:14:39
f946a486ea3cdb56c771a37da281ad223b5042f8...2ae1f29dfe6fea26d2e0ac29faa2375a5db2c2d9,2,36,13,49,10,2013-11-18 21:09:13,2013-11-16 00:40:13
b4f7078a021489395bae4e43a33d457719d30ccc...b3bee7e0c43dd281c081cd59d7403148d3f8af88,3,2,4,6,3,2013-11-20 18:45:12,2013-11-20 18:45:12
18da26c62a2b4dc749a9c4074efcca32cc4b0573...145c2008ae3bbd8bca6e11bac93c6c0098a3ba42,1,8,10,18,5,2013-11-19 19:02:10,2013-11-19 19:02:10
1f35531f396dba279b289a515416351568b96c0a...948bb29d27dc7e367cd27003c059d83301b15c4f,1,3,12,15,1,2013-11-09 00:53:58,2013-11-09 00:53:58
165d1bdbc0c4236df9afe85d9cd8b1e65d625865...f1127b9308fbb4d4e21c3c5567ace9fdda82559d,7,27,30,57,27,2013-11-07 23:58:03,2013-11-07 23:58:03
f1127b9308fbb4d4e21c3c5567ace9fdda82559d...9ae4bcaaf8aa01da340341e47f99f83a59ce91dc,7,16,14,30,14,2013-11-08 00:45:07,2013-11-08 00:35:26
9990db2f5a762fdbc198cbfc5e96370d859739bb...50dd9791f75efef77a85bbe6556c85de0d845c0a,1,3,0,3,1,2013-11-07 03:13:58,2013-10-18 16:27:34
50dd9791f75efef77a85bbe6556c85de0d845c0a...17172276366fc3114ae52eb6c83aafbec004d5f3,11,113,87,200,29,2013-11-07 03:13:58,2013-10-27 19:13:03
17172276366fc3114ae52eb6c83aafbec004d5f3...0cbeda73910d6d1d3336da93c5f94df0bdd5fa44,1,5,0,5,1,2013-11-07 03:13:58,2013-10-28 23:51:31
0cbeda73910d6d1d3336da93c5f94df0bdd5fa44...efb4c800a7c8167cf2202466a720c0fad7001a5d,1,6,7,13,1,2013-11-07 03:13:58,2013-10-30 02:37:56
efb4c800a7c8167cf2202466a720c0fad7001a5d...e7df38dbd0c7bf2d27632809fc49cacb0cc7f869,2,68,56,124,17,2013-11-07 03:13:58,2013-10-30 05:14:28
e7df38dbd0c7bf2d27632809fc49cacb0cc7f869...249f76bebdb3c24ae0a59e3be7ae73fd1d88c065,12,33,36,69,24,2013-11-07 04:05:26,2013-11-07 04:05:26
944a48ec5a0bd1d27c66b56950316e2613641eb5...d55998be81973be5b083eed56b223c8ce98ce073,1,25,6,31,4,2013-11-22 22:09:37,2013-11-22 22:09:37
d55998be81973be5b083eed56b223c8ce98ce073...1c8ae47770b423b9c2f1125bd25cef0482a4600d,1,13,1,14,3,2013-11-22 22:33:25,2013-11-22 22:33:25
1c8ae47770b423b9c2f1125bd25cef0482a4600d...c67f9b671df024d06b0af0a0eaa02058e69ee9f5,2,11,34,45,9,2013-11-22 22:42:30,2013-11-22 22:42:30
bc9b239d74365d5b892c5a424f61065c7e7d84cc...e01732f85769ac434e2614652aa25cd0ace7a4df,1,0,1,1,1,2013-12-06 22:15:40,2013-12-06 02:03:47
e01732f85769ac434e2614652aa25cd0ace7a4df...95c0ade04bb8fe95029fed521126e3268a1eda7f,4,19,6,25,8,2013-12-06 22:15:40,2013-12-06 19:55:56
95c0ade04bb8fe95029fed521126e3268a1eda7f...0969be5ddb34ee8a6c09e882d13b1d655e028b23,1,2,2,4,1,2013-12-06 22:15:40,2013-12-06 20:02:21
0969be5ddb34ee8a6c09e882d13b1d655e028b23...f28445254f42fd112aba5f2b67ae6169fae29c2b,1,2,0,2,1,2013-12-06 22:15:40,2013-12-06 21:56:09
de090116ddf400d5ab8375ed43c9c8d22ec0053f...e39d35dedad1db952c30958303902b4c96e1f406,2,57,1,58,2,2013-12-06 00:49:39,2013-12-06 00:32:02
18d08d0d427f6350b5742264f200475792f40c9f...009024ad6439fad28ab3a9d8db6b6844bfbba8c9,1,4,3,7,3,2013-11-26 08:05:46,2013-11-26 08:05:46
908bb65dcf7f8a2d5e04de862e3908b46529d6a1...0d7044955a4b63c4df2a611095b87ae417a3cf9b,1,0,24,24,2,2013-09-05 23:00:52,2013-09-05 23:00:52
908bb65dcf7f8a2d5e04de862e3908b46529d6a1...5ec2fea6dd3360de326717ed01909b8fe9c39d0f,3,13,1,14,5,2013-09-05 22:31:17,2013-09-05 22:28:51
5ec2fea6dd3360de326717ed01909b8fe9c39d0f...20a763e51934f3b52e48b5a6ba37d63852fd9a0b,1,1,1,2,1,2013-09-05 22:33:04,2013-09-05 22:33:04
c66a827c98027ce5e3b4ebe83f8b2143e2a62d8b...6678a26d1c94e7838c055a3da3b91ae3de8c3e3c,5,9,10,19,11,2013-09-09 22:11:30,2013-09-09 22:11:30
6678a26d1c94e7838c055a3da3b91ae3de8c3e3c...672f1e068392e95966cd57b4bc49bd8d1b8859dd,1,15,0,15,1,2013-09-09 22:21:04,2013-09-09 22:21:04
672f1e068392e95966cd57b4bc49bd8d1b8859dd...6921ca4813a583948d3871a53d0349b834f31036,1,19,14,33,5,2013-09-09 23:42:04,2013-09-09 23:42:04
6921ca4813a583948d3871a53d0349b834f31036...ebb934c1b044f4bbffe312e9c88c00134c94ef7f,1,3,2,5,2,2013-09-10 00:02:45,2013-09-10 00:02:45
ebb934c1b044f4bbffe312e9c88c00134c94ef7f...4f3b8033f287051156e6b81aeff9da3c44f64cba,1,0,8,8,1,2013-09-10 00:17:09,2013-09-10 00:17:09
4f3b8033f287051156e6b81aeff9da3c44f64cba...c01f6df43e1280c398d921c2d5eff01db8c26f94,1,13,0,13,1,2013-09-10 01:23:17,2013-09-10 01:22:58
c01f6df43e1280c398d921c2d5eff01db8c26f94...6a4afb7f8eacde9cb81202347258983908a9f7c6,1,1,1,2,1,2013-09-10 01:23:57,2013-09-10 01:23:42
d5480fb78d9cd8d6d31276b8c882304e84748960...1e723bc95a61fb6c46af82557c128d1e95a33a99,1,1,1,2,1,2013-09-11 23:43:55,2013-09-11 23:43:55
d5480fb78d9cd8d6d31276b8c882304e84748960...dfe45e1ad5fe741c379c5549c9ea56ec440d2579,1,1,1,2,1,2013-09-11 19:35:05,2013-09-11 19:35:05
2d4ac06426454df87fc85f0cbb7d8a6553f052eb...fe99e51634f7068ce997e9866516f2b14a93bda9,5,131,127,258,9,2013-09-09 20:19:07,2013-09-09 20:19:07
2d4ac06426454df87fc85f0cbb7d8a6553f052eb...64bc08f1c4bee42ff5a17b2d6ababb288fd8f209,1,15,4,19,4,2013-09-09 19:02:37,2013-09-09 19:02:37
8878943ac9ab3b3344d398b45e68ebb7cea879f0...ad04cacd28da1557324b8ad6fb53b7284e8bf866,1,7,1,8,1,2013-09-05 00:47:18,2013-09-05 00:47:18
8878943ac9ab3b3344d398b45e68ebb7cea879f0...62823cfb97ec35e59833fd4723c392685d55827c,1,2,2,4,1,2013-09-04 22:06:41,2013-09-04 22:06:41
f0cdbaa6c8810954c1e41a07ba78e03305c1cfa2...fdf1fccd3eec7b534b8423fe3ea5b6e116b233fa,1,1,1,2,1,2013-09-05 08:40:11,2013-09-05 08:40:11
f0cdbaa6c8810954c1e41a07ba78e03305c1cfa2...bf6e241d977f36db57c66a5b8dd056b36c0d8695,1,1,0,1,1,2013-09-05 01:20:49,2013-09-05 01:20:42
fdba1aeed8c80b3c2f8cd14c3b393581e7ef99a8...cd61fb2e6f9d2a7bbd3c4db2ab9091674746126d,2,12,3,15,7,2013-10-15 23:56:04,2013-10-15 23:56:04
cd61fb2e6f9d2a7bbd3c4db2ab9091674746126d...1da335f784882292fb55b25bf255ec5f45072ea4,4,37,16,53,14,2013-10-16 20:10:20,2013-10-16 20:10:20
1da335f784882292fb55b25bf255ec5f45072ea4...3a246ac3d1368931998a082043c9b719dd3c10cd,2,16,35,51,8,2013-10-16 20:42:50,2013-10-16 20:42:50
3a246ac3d1368931998a082043c9b719dd3c10cd...acf58362cb957bf4d02af460935a9c5febd112f4,2,5,2,7,5,2013-10-16 20:44:15,2013-10-16 20:44:15
acf58362cb957bf4d02af460935a9c5febd112f4...11d695a2973d67906145e7f0972b6e693bdaa3f9,4,14,3,17,10,2013-10-16 20:45:59,2013-10-16 20:45:59
11d695a2973d67906145e7f0972b6e693bdaa3f9...1711de4b0996a6fd668f1d1ba07901d04f090810,1,36,0,36,4,2013-10-16 23:06:07,2013-10-16 23:06:07
1711de4b0996a6fd668f1d1ba07901d04f090810...153248b60f551d4cb92bce4f35b08084f554c62c,5,4,89,93,7,2013-10-16 23:23:35,2013-10-16 23:23:35
153248b60f551d4cb92bce4f35b08084f554c62c...ea04f3de72ab97c9f9e49e46e049bf0cde58ac55,1,55,7,62,7,2013-10-16 23:26:37,2013-10-16 23:26:37
ea04f3de72ab97c9f9e49e46e049bf0cde58ac55...f3e6d34df23adf84f520b058e4363f8b789d2ebf,1,1,0,1,1,2013-10-16 23:27:00,2013-10-16 23:27:00
f3e6d34df23adf84f520b058e4363f8b789d2ebf...c688e9b5a61c1979d497cfe9cba0a6099aad63e8,2,5,0,5,3,2013-10-16 23:27:33,2013-10-16 23:27:33
c688e9b5a61c1979d497cfe9cba0a6099aad63e8...ad968ef3ef54f3161e8e1012f0ef20b8757ac0aa,2,6,0,6,3,2013-10-17 01:42:05,2013-10-17 01:42:05
ad968ef3ef54f3161e8e1012f0ef20b8757ac0aa...f1d07e2dbe41a3a4f9b8ee1de544fc9c2de88c60,1,45,70,115,15,2013-10-17 01:46:28,2013-10-17 01:46:28
f1d07e2dbe41a3a4f9b8ee1de544fc9c2de88c60...7d3c7e2b297badc152213cae1e6a11f64a7691b4,1,6,0,6,3,2013-10-17 01:47:03,2013-10-17 01:47:03
7d3c7e2b297badc152213cae1e6a11f64a7691b4...e5d7472a0d0268957eebbc385005d6b69c442270,2,1,5,6,2,2013-10-17 01:49:27,2013-10-17 01:49:27
e5d7472a0d0268957eebbc385005d6b69c442270...ad2fbd9e873915d9d09685887eb0afe16b9559a4,1,3,1,4,1,2013-10-17 01:49:51,2013-10-17 01:49:51
54b0cd7cd1cbea8ca35716bd1b4a20a1900029f4...ec885d91806595add47c793e1e6bb8a4b9e8d100,1,6,1,7,2,2013-10-15 23:06:41,2013-10-15 21:54:52
ec885d91806595add47c793e1e6bb8a4b9e8d100...3997b8a923c3e95c14237657f0e2c9301fc5f66d,1,1,1,2,1,2013-10-15 23:07:26,2013-10-15 23:07:26
3cf23b93eaf0b51983204bb28182eb39c0791559...26533eb2c419155b93e3f403d081fb3c52d4dc45,1,14,0,14,1,2013-11-14 05:34:25,2013-11-14 05:34:25
26533eb2c419155b93e3f403d081fb3c52d4dc45...7267c4b746ad3b86d1174aeed4c06679476e8a27,1,4,4,8,3,2013-11-14 05:53:53,2013-11-14 05:53:53
7267c4b746ad3b86d1174aeed4c06679476e8a27...56ab9cb0d5169401616acc7a396e9f4af00ed670,1,9,5,14,5,2013-11-30 08:09:41,2013-11-30 08:07:53
3cf23b93eaf0b51983204bb28182eb39c0791559...059950b095a48c254a9f407f2bff13eaab7a7a1c,3,40,34,74,14,2013-11-14 01:45:22,2013-11-14 01:45:22
3cf23b93eaf0b51983204bb28182eb39c0791559...9ab85f4d1220d04a3b682d5612ff27db5983f5d3,1,2,1,3,1,2013-11-14 00:09:23,2013-11-14 00:09:23
234f5ac39f22b02cce62d789283a4ed80b728fe2...0169cf15dd272f0403909a9be64fd1b575396ffc,1,0,3,3,1,2013-11-20 02:28:50,2013-11-20 02:28:50
eaeb969138205349c08e485c0bc4d29dbe2567d7...cb70eedfdad40538983f9610322262ce84e284a0,1,0,2,2,2,2013-11-21 20:11:25,2013-11-21 20:11:25
eaeb969138205349c08e485c0bc4d29dbe2567d7...75a7f4d90cde0295bcfb7213004abce8d4779b75,2,252,249,501,40,2013-11-21 19:43:07,2013-11-21 01:41:25
049c7effe961f70c9489dac5250dd037cf95e7d6...a1598d1e1c157388f3b07415729de28f4d205e49,2,46,1,47,2,2014-02-18 20:36:05,2014-02-18 19:56:52
3a8fff964cd9d4dd2bff4cd44579b5646d3de3d4...5cb45544c63f3aa87c40ad13f4df77fe7aed1254,1,1,1,2,1,2014-02-05 17:54:34,2014-02-05 17:54:34
f213e2dd6cd6445f59f1e7262783a754a5352dc2...e2fa3f56df02818f007f929824293f9da6b2db75,2,26,9,35,9,2014-01-15 22:48:31,2014-01-10 00:37:56
152c95671947af5513be1148371b8ee0a7ca709a...221454f315a8993a6996ba9867f98bddbdb1eb16,1,1,1,2,1,2014-01-15 02:29:02,2014-01-15 02:29:02
152c95671947af5513be1148371b8ee0a7ca709a...eaa9c85511620aa82f1876e1503604f591f00d23,2,21,17,38,8,2014-01-15 02:23:30,2014-01-15 02:23:30
700db10c850f4721ab890c1d4f0fa22a2fbaa29d...bfc1043f36dcce7f6232be55148f52327e356933,1,10,4,14,3,2014-01-23 04:00:16,2014-01-23 04:00:16
700db10c850f4721ab890c1d4f0fa22a2fbaa29d...e7a9d236402363b402df43f25624a4e7e049f40f,3,16,14,30,7,2014-01-22 23:54:22,2014-01-22 23:54:22
e7a9d236402363b402df43f25624a4e7e049f40f...42e35ecff36fcb07e45c19f880af84f8532a3fac,1,10,10,20,5,2014-01-24 00:20:51,2014-01-24 00:20:51
700db10c850f4721ab890c1d4f0fa22a2fbaa29d...9e2e8a923c28833dd631a7206d3664a6a90cc24c,2,230,121,351,5,2014-01-22 23:52:39,2014-01-22 23:52:39
700db10c850f4721ab890c1d4f0fa22a2fbaa29d...e51af36a85126aca6bf6da5291eaf960fd82aa56,4,221,0,221,4,2014-01-22 20:44:09,2013-11-21 20:45:48
e51af36a85126aca6bf6da5291eaf960fd82aa56...a1851a6d3e69d67bfc4e6bfdec85ba58293351b9,1,2,0,2,1,2014-01-28 08:56:51,2014-01-28 08:56:51
6dde20c0c517833224689c0eff2d247910a7083b...5264914e574c20c8fefcd6e5d858f51f341dd9da,2,38,14,52,14,2014-01-10 23:54:44,2014-01-07 20:39:15
0f0e5824903ccaa543eb1126d5da655e5f6c878d...2553029959929184696e25ebdba4631ba7aeb8a6,9,6,6,12,9,2014-01-20 19:15:44,2014-01-20 19:15:44
9792df20804e9cd5736ab933c6ffcb29fd52040e...4087a643eaf6265f8d238caa2883348eeb5e908a,1,2,2,4,1,2014-01-14 01:22:23,2014-01-14 01:22:23
9792df20804e9cd5736ab933c6ffcb29fd52040e...a92699ab6c0f93ee155b44145790dfeaf54cf1c8,2,3,3,6,3,2014-01-14 01:12:53,2014-01-14 01:12:53
b68ddcec21d40323b3a7bf7dca5d9eb99cb5d4f5...e8ffc2eee00beaa8456d69853ad9ca3db29ea013,2,5,5,10,3,2014-01-14 17:54:19,2014-01-14 17:54:19
cfd3d027373557a3605fb9aaaa581adaca419a93...ff662446f774d573442baa526263544df2570ebf,2,3,4,7,4,2014-01-20 18:20:29,2014-01-20 18:20:29
cfd3d027373557a3605fb9aaaa581adaca419a93...9152aab653294f8f8b2f206a2ccc3c8603f33d0c,1,22,18,40,9,2014-01-20 08:26:01,2014-01-20 08:26:01
a37ffa4041cb8504741ab2805d16f8b268772793...fabf96b8ff5560523d60269d0052b65037394dcc,1,0,1,1,1,2014-01-21 13:22:51,2014-01-21 13:22:51
a37ffa4041cb8504741ab2805d16f8b268772793...bcaf6c2359d83acd5da54f499e21f4a148f491c5,10,96,14,110,30,2014-01-21 10:25:37,2013-12-05 21:18:02
bcaf6c2359d83acd5da54f499e21f4a148f491c5...191aa17d16c0935a7deda03b4c3bc879f7a316eb,4,10,16,26,11,2014-01-21 10:26:11,2013-12-06 11:15:14
191aa17d16c0935a7deda03b4c3bc879f7a316eb...886f650d9b2133fb61e7cc5b0bb7795246852026,1,38,3,41,9,2014-01-21 10:26:11,2013-12-05 21:22:55
886f650d9b2133fb61e7cc5b0bb7795246852026...5fe26ee426b9d748605c538829f30885462ad932,1,47,5,52,10,2014-01-21 10:26:11,2014-01-14 11:23:20
a37ffa4041cb8504741ab2805d16f8b268772793...08ab55419549374742bc879261f1d55b19af7265,1,3,3,6,2,2014-01-21 09:22:13,2014-01-21 09:19:12
a37ffa4041cb8504741ab2805d16f8b268772793...fc30346086a890687d145c33aa8fb3d0ad6a4b7e,1,1,0,1,1,2014-01-21 03:49:39,2014-01-21 02:59:31
fc30346086a890687d145c33aa8fb3d0ad6a4b7e...d2c9c1036b94b0c3e7fa3f591fa83f9c95f49406,2,20,44,64,12,2014-01-21 03:49:39,2014-01-21 03:20:33
d2c9c1036b94b0c3e7fa3f591fa83f9c95f49406...14b2b2b7c2db83ef1413a7469608f655cd15958e,1,1,1,2,1,2014-01-21 03:49:40,2014-01-21 03:21:25
14b2b2b7c2db83ef1413a7469608f655cd15958e...5b97e00438b094db608f350732f7e4d426c50999,1,10,16,26,4,2014-01-21 05:02:37,2014-01-21 05:02:37
5b97e00438b094db608f350732f7e4d426c50999...b78ae3b652d609a895cf36886e053124d2f8ae80,1,5,6,11,5,2014-01-21 05:26:23,2014-01-21 05:03:09
b78ae3b652d609a895cf36886e053124d2f8ae80...cce099aa34e9588abc778b5f106bf862d4a838b0,1,7,4,11,2,2014-01-21 17:56:53,2014-01-21 17:56:53
cce099aa34e9588abc778b5f106bf862d4a838b0...dea3c2655dc02c03cf7dc03d058068cf9f0d0970,1,2,0,2,1,2014-01-22 17:32:50,2014-01-22 17:32:50
69be8adb6830f8631f7fd35ebed6783963c79b28...4fb1db7f742fb34a7a06621d0698063de87a572c,4,11,79,90,19,2014-01-20 19:26:20,2014-01-17 10:09:39
4fb1db7f742fb34a7a06621d0698063de87a572c...5b77e51e0a15eddefcb40380673df8c0c24f95d1,2,68,61,129,4,2014-01-20 19:26:20,2014-01-17 10:21:36
5b77e51e0a15eddefcb40380673df8c0c24f95d1...bab8efbf050e1bc2d5c2ff64c6161ef4d323bc3f,1,21,37,58,6,2014-01-20 19:26:20,2014-01-20 10:48:47
bab8efbf050e1bc2d5c2ff64c6161ef4d323bc3f...5ea48aa7f8d3839877b869fdfcea2d5de0972fbf,2,69,21,90,9,2014-01-20 19:26:20,2014-01-20 11:07:34
5ea48aa7f8d3839877b869fdfcea2d5de0972fbf...8a4824d1ad2fafd158fbaad52a658c5fd3f7de30,1,0,1,1,1,2014-01-20 19:35:16,2014-01-20 19:35:16
8a4824d1ad2fafd158fbaad52a658c5fd3f7de30...bde2d3aef7715814920a07d2c5e08d14eabe3e53,1,1,1,2,1,2014-01-21 09:41:08,2014-01-21 09:39:50
bde2d3aef7715814920a07d2c5e08d14eabe3e53...f918fca3bf77ebe5845593281382f68e5b166ab3,1,4,0,4,1,2014-01-21 11:52:05,2014-01-21 11:52:05
dbf249e23925decac52c0176d716c0ce205d4326...37fcbfa1f4586e4437664239fc271dda31ac1837,1,7,0,7,4,2014-01-15 17:30:00,2014-01-15 17:29:46
90ea81433f7bfb5e9a21099b7238d439121b833e...c6350bcc2411dfc5039976239e143f6b9da64444,2,35,12,47,4,2014-01-08 22:21:13,2014-01-08 01:46:04
c6350bcc2411dfc5039976239e143f6b9da64444...93ff70a3e70e14762314f04e2b9f61c8710d5353,2,23,1,24,2,2014-01-08 22:22:24,2014-01-07 03:42:57
93ff70a3e70e14762314f04e2b9f61c8710d5353...e24e9c09f8533b662d1d829123431540bb95ea51,1,7,9,16,2,2014-01-08 22:22:49,2014-01-08 20:16:23
e24e9c09f8533b662d1d829123431540bb95ea51...762a0cc4723917b4e6ca3731356e43c5e9a13f5f,1,2,5,7,3,2014-01-08 22:22:49,2014-01-08 22:20:30
762a0cc4723917b4e6ca3731356e43c5e9a13f5f...0fd9c98de3fc2c8fb1da6dc3ef277b3325106b26,1,15,3,18,4,2014-01-08 22:22:49,2014-01-08 22:20:50
d4e61b48eb277828c4a87aee15c141d94149c799...d7f26c93d9f813317e88fb6565c6eb0ca835a480,1,1,1,2,1,2014-01-08 02:41:06,2014-01-08 02:41:06
03a25c0800691806534d96f108856097e9c18d6b...a2aab7757e236a895abf7b06836d8e3b84236429,2,25,3,28,7,2014-01-20 21:39:35,2014-01-20 21:39:35
9a6333466bd97ea7903cefaa1e2348f3053483b8...98193a397ef933a449f70c7661bff037bf98eb99,1,2,2,4,2,2014-01-09 00:02:15,2014-01-08 21:18:37
368e30897159b6908aec9cc5c5e8e763925bd7c4...5530cc29b257c404b0f76d4b0cf620b877b0fae2,1,4,4,8,4,2014-01-08 22:50:52,2014-01-08 22:50:52
f9dd0da182ee9ff7ac891884fa4720073130bed9...498b6031b12da56c442d7c2b501f500766652b2d,1,50,18,68,10,2013-11-09 00:23:37,2013-11-08 22:41:45
f9dd0da182ee9ff7ac891884fa4720073130bed9...b8e7ec1b74fdeaeab56a8ffab801dcd87b7361ca,1,1,1,2,1,2013-11-08 22:44:52,2013-11-08 22:44:52
b8e7ec1b74fdeaeab56a8ffab801dcd87b7361ca...f56945d71bcce6e7d18b3471bf4744ddd70b1783,1,15,4,19,6,2013-11-08 22:45:18,2013-11-08 22:45:18
f56945d71bcce6e7d18b3471bf4744ddd70b1783...7f1b179c67476efa7dbafda55541b515fbe0f346,1,1,1,2,1,2013-11-09 09:28:04,2013-11-09 09:28:04
f9dd0da182ee9ff7ac891884fa4720073130bed9...2448058ee23292e2a167bbd6a2e138ad99e8b3b8,1,1,0,1,1,2013-11-08 22:28:41,2013-11-08 22:28:41
f9dd0da182ee9ff7ac891884fa4720073130bed9...ca174ae84d37d89af726fa41e25a11bdaeca2067,1,0,1,1,1,2013-11-08 22:17:39,2013-11-08 22:17:39
5fe4c9a39a50f46842504234dd487a4c6c5d2d1e...88edba7e86efc8d7e118a9863ab701f0b5493d62,1,2,1,3,1,2013-11-11 18:57:25,2013-11-11 18:57:25
4f8b6c32830555d71fd1912610eeb82b66903821...ef57752bce5c333d0e2b8352a84d071f21cce132,1,29,6,35,4,2013-11-08 01:30:51,2013-11-08 01:30:51
f26da9638fc7daf0fac6c138ac3b9b040aef19fb...37abc07852874939aabe7ba9a346d4d893e40409,1,3,2,5,1,2013-11-14 04:24:31,2013-11-14 04:24:31
f26da9638fc7daf0fac6c138ac3b9b040aef19fb...bb76157d240ae871bc3d9b6a945a982abf0473c7,1,2,1,3,1,2013-11-11 18:10:19,2013-11-11 18:10:19
f26da9638fc7daf0fac6c138ac3b9b040aef19fb...402a58a75a5b9813c889bf6c030bb756f86e56d4,1,1,1,2,1,2013-11-11 17:05:38,2013-11-11 17:05:38
f26da9638fc7daf0fac6c138ac3b9b040aef19fb...9c7a8edddd447e64069f0cd108bee4d008049c49,1,18,2,20,2,2013-11-11 15:36:44,2013-11-11 15:36:44
f26da9638fc7daf0fac6c138ac3b9b040aef19fb...cf30b85eb1d3ecbf27c35ea344a5f68934c1bd2b,1,6,3,9,2,2013-11-11 10:51:34,2013-11-11 05:15:26
f26da9638fc7daf0fac6c138ac3b9b040aef19fb...ccbb5d34927dc1905984bead3ebb576c0ea20960,2,146,52,198,23,2013-11-11 07:39:26,2013-11-07 03:16:56
f26da9638fc7daf0fac6c138ac3b9b040aef19fb...5a1bfd9aa9a0983b5141dd8e393cc67a68fc6590,1,25,25,50,1,2013-11-10 17:14:45,2013-11-09 19:10:00
f26da9638fc7daf0fac6c138ac3b9b040aef19fb...8ba8783bcc0ec3a0c5391445d52e2b2a9d0a3f8a,1,8,1,9,2,2013-11-10 03:40:56,2013-11-10 03:31:08
f26da9638fc7daf0fac6c138ac3b9b040aef19fb...403f9fc357d64ccbdf82e1c4cbad2946eb1d1080,1,9,0,9,1,2013-11-09 00:47:42,2013-11-09 00:47:42
403f9fc357d64ccbdf82e1c4cbad2946eb1d1080...4ec0b515786ce266234d350fee872764974d2218,1,3,3,6,1,2013-11-09 19:08:43,2013-11-09 19:08:43
4eaba8de918c384a782f181122c333fa7bd14857...4f9f83d6c6e71f826489f04e497f4a384c49a2c1,2,92,27,119,27,2013-11-19 19:16:28,2013-11-16 00:11:05
2382a0f920f7473b2b2762d886470a417a5dbac7...5306053e21cb2a22884d2d281c2cc855cf22fc69,2,114,4,118,4,2013-11-20 23:41:37,2013-11-20 21:53:54
2382a0f920f7473b2b2762d886470a417a5dbac7...8fdbf46afbcad9e4eab79b2804261b084267b6e4,2,32,12,44,8,2013-11-20 22:51:04,2013-11-20 22:51:04
8fdbf46afbcad9e4eab79b2804261b084267b6e4...4e0c76b321cf42d36cdbedcf84103f4fcc123ecd,2,21,4,25,4,2013-11-20 23:37:26,2013-11-20 23:37:26
2382a0f920f7473b2b2762d886470a417a5dbac7...8a756f417ee4925bad6c8526fabda05ab8a6c041,2,39,47,86,28,2013-11-20 22:04:19,2013-11-20 21:51:05
2382a0f920f7473b2b2762d886470a417a5dbac7...92f94f06ae2fb4cddace5b817d6a6e326f3c9b33,4,25,10,35,11,2013-11-20 20:05:10,2013-11-20 20:05:10
92f94f06ae2fb4cddace5b817d6a6e326f3c9b33...5690139785fc2bfaa2f233ed41d5f927a8b28dbf,6,57,48,105,34,2013-11-20 20:49:01,2013-11-20 20:49:01
5690139785fc2bfaa2f233ed41d5f927a8b28dbf...a39bd656622c7dbea534fe34710ed6cb21dd5a90,6,52,44,96,44,2013-11-20 21:05:17,2013-11-20 21:05:17
a39bd656622c7dbea534fe34710ed6cb21dd5a90...d233894c25e2b1b7124d69bddece94c88fb44452,1,106,0,106,1,2013-11-20 22:09:46,2013-11-20 22:09:46
d233894c25e2b1b7124d69bddece94c88fb44452...023ff36704ef5ad8d6fc8d0c07f718fec2ec5ff0,2,2,2,4,2,2013-11-20 23:12:19,2013-11-20 23:12:19
023ff36704ef5ad8d6fc8d0c07f718fec2ec5ff0...da514223d1e441e2bab82bf3b30e1a1e0e222ac6,2,0,9,9,3,2013-11-20 23:25:27,2013-11-20 23:25:27
da514223d1e441e2bab82bf3b30e1a1e0e222ac6...e2390318bb4cc98886777bdad3fbb860942b8e65,2,76,14,90,8,2013-11-20 23:39:02,2013-11-20 23:27:52
e2390318bb4cc98886777bdad3fbb860942b8e65...2b7c63b1b5d62515cd876f189dea6e5a5257cd49,2,19,0,19,19,2013-11-21 02:12:51,2013-11-21 02:12:51
2b7c63b1b5d62515cd876f189dea6e5a5257cd49...60f728b170f550262b22b7905dfb280a405df4a7,2,7,3,10,5,2013-11-21 02:16:26,2013-11-21 02:16:26
60f728b170f550262b22b7905dfb280a405df4a7...df258f5861794057c303a33c000bf830bc543631,1,225,19,244,9,2013-11-21 02:17:03,2013-11-21 02:17:03
df258f5861794057c303a33c000bf830bc543631...bc82940a575944e4686db203356a8a3fb3a75217,3,316,24,340,21,2013-11-22 00:32:16,2013-11-22 00:32:16
948bb29d27dc7e367cd27003c059d83301b15c4f...6f3c32eb18f0a604ba2638b6a9f19f8824412fd1,1,5,0,5,1,2013-11-12 20:14:54,2013-11-11 16:39:19
948bb29d27dc7e367cd27003c059d83301b15c4f...e82f8c1661f3fa18e4dc6ca3aebe4dcc46e8961b,5,38,15,53,8,2013-11-11 16:46:07,2013-11-11 15:47:36
948bb29d27dc7e367cd27003c059d83301b15c4f...b6ef4bc9521346dc5066d71821c6cadfbeced9d3,1,130,58,188,23,2013-11-11 13:51:19,2013-11-11 13:35:29
948bb29d27dc7e367cd27003c059d83301b15c4f...b5795749d1688f99df422dd7068b189e5b25e5e9,2,13,57,70,16,2013-11-11 12:29:27,2013-10-24 19:04:49
9ae4bcaaf8aa01da340341e47f99f83a59ce91dc...01990b65a3cf3da5e04aa6612a17ead2a6cac2c9,1,0,2,2,2,2013-11-08 00:46:47,2013-11-08 00:35:26
01990b65a3cf3da5e04aa6612a17ead2a6cac2c9...b8b509e1c8c9b9def04850eaad8369b9ec6d9e0a,4,560,54,614,30,2013-11-08 00:46:47,2013-11-07 12:33:31
b8b509e1c8c9b9def04850eaad8369b9ec6d9e0a...12ffead71a06e5cf0ea4b1e6ce19231dceb265dc,2,5,3,8,5,2013-11-08 01:01:57,2013-11-08 01:01:57
ba6dd1d8d643f745fb412e1de50c9dbf0c63325e...abfdaca3f86d7951693697fbd849078d6b406478,3,23,6,29,8,2013-11-25 19:17:58,2013-11-25 18:58:17
ba6dd1d8d643f745fb412e1de50c9dbf0c63325e...f16c45f8b0447249074a0b41807a979a3ae326c5,1,20,12,32,10,2013-11-25 03:00:39,2013-11-25 03:00:39
f16c45f8b0447249074a0b41807a979a3ae326c5...b702edadb7d63feb1f40ebfae27a4d745d4b733e,1,3,3,6,1,2013-11-25 03:02:06,2013-11-25 03:02:06
b702edadb7d63feb1f40ebfae27a4d745d4b733e...1af6ffb9bb5a1dec665a56b1bdf621fd2e2b7377,1,18,0,18,1,2013-11-26 07:11:42,2013-11-26 07:07:59
ba6dd1d8d643f745fb412e1de50c9dbf0c63325e...0a89db04fe62958283c17baa11893c6ad868bf9d,1,2,2,4,2,2013-11-24 12:55:53,2013-11-23 12:16:28
ba6dd1d8d643f745fb412e1de50c9dbf0c63325e...1cce9f25b2866883b3f1c784ea642df4e69ca6bd,2,2,2,4,2,2013-11-23 21:21:27,2013-11-23 21:21:27
ba6dd1d8d643f745fb412e1de50c9dbf0c63325e...f1b3e278b964fca4884dca80ffbe79c0e82a85ca,1,6,5,11,1,2013-11-23 20:53:50,2013-11-23 20:53:50
ba6dd1d8d643f745fb412e1de50c9dbf0c63325e...e288e7763e20d1d8c7b8f5f9fffa00136577ed95,1,7,0,7,2,2013-11-23 02:48:34,2013-11-16 11:03:52
ba6dd1d8d643f745fb412e1de50c9dbf0c63325e...9696ec509a53afaaf9b761b00f60e517634f7e4e,2,8,2,10,2,2013-11-23 02:28:50,2013-11-16 10:33:17
ba6dd1d8d643f745fb412e1de50c9dbf0c63325e...96b5be9dd9606a9bfbf0fdbe98bcaf8b6e77e4b1,2,2,2,4,2,2013-11-23 02:23:31,2013-11-14 05:19:31
c67f9b671df024d06b0af0a0eaa02058e69ee9f5...5d6ef3177b57371c2dd9b9e4253fbc326d072554,1,34,3,37,2,2013-11-25 00:22:06,2013-11-24 04:41:26
5d6ef3177b57371c2dd9b9e4253fbc326d072554...a60647482533fcc76b80919b46aab60e4296b924,1,2,1,3,2,2013-11-25 00:22:06,2013-11-25 00:16:56
a60647482533fcc76b80919b46aab60e4296b924...07180f3aa75377b4c3227da006df00ec4f032589,1,21,0,21,1,2013-11-25 00:25:15,2013-11-25 00:25:15
e69bbd239ee8dc4bdc0963810448d9f34e4c30c4...d8f4b733f243a3da6cf5571f44b94b7109f326c4,2,33,1,34,2,2013-11-25 17:44:55,2013-11-22 22:46:07
e69bbd239ee8dc4bdc0963810448d9f34e4c30c4...b4eeb6be617d96132cbd5998a658e5ab88334940,1,1,1,2,1,2013-11-25 17:43:32,2013-11-22 22:17:24
e69bbd239ee8dc4bdc0963810448d9f34e4c30c4...ad23745456f9bb9c1c3da3796a2ab769f192bf36,1,1,1,2,1,2013-11-25 17:12:18,2013-11-25 17:12:18
e69bbd239ee8dc4bdc0963810448d9f34e4c30c4...cee0a292d0b9afe96a1b4a2c66910f2485af2482,2,5,5,10,5,2013-11-25 17:04:04,2013-11-22 22:58:19
c35cebaa06477133a454ab8b2e3765e320ef8503...b4e21ad1da616ab46669401dc7d62a6e19b05619,1,1,0,1,1,2013-12-05 01:50:33,2013-12-05 01:50:33
77f1362c6471bf60447a28c1d3c4abb45e5123c0...60809a4f72984881e8a8dc07bf585f07975baf7d,1,7,2,9,3,2013-11-26 05:55:48,2013-11-26 05:55:48
60809a4f72984881e8a8dc07bf585f07975baf7d...c38386d876aab1c1e3391de2180cb03f083f8955,1,1,1,2,1,2013-11-26 06:02:37,2013-11-26 06:02:37
77f1362c6471bf60447a28c1d3c4abb45e5123c0...65fcc81b426ced8f416da3260770705ac7c90580,1,4,12,16,2,2013-11-26 05:53:50,2013-11-26 05:53:50
77f1362c6471bf60447a28c1d3c4abb45e5123c0...6ad5b2bcf4d04a0314583b29f9280d8000c1ee5a,1,5,5,10,3,2013-11-26 05:47:15,2013-11-26 05:47:15
6ad5b2bcf4d04a0314583b29f9280d8000c1ee5a...c92dab0eb4db57fd880c7b0bbf84d7288d048fef,1,4,0,4,1,2013-11-26 05:48:51,2013-11-26 05:48:51
06d5e25224f8e24cbf8fd367437789ec32f592ca...ab3a83c617ec5bfafee117ea0b6e92ce78bd46e5,2,521,0,521,2,2013-11-26 16:13:02,2013-11-26 15:03:36
06d5e25224f8e24cbf8fd367437789ec32f592ca...76c71260f13af3005c2407e2a19a422741b97117,1,1,1,2,1,2013-11-26 15:13:39,2013-11-26 15:13:39
06d5e25224f8e24cbf8fd367437789ec32f592ca...82674372946b431f93add255e137f82822eecfc1,1,1,1,2,1,2013-11-26 14:54:46,2013-11-26 14:54:46
06d5e25224f8e24cbf8fd367437789ec32f592ca...9c15322894152095539e41623ef33ec0ebdc6c3f,1,1,1,2,1,2013-11-26 10:18:50,2013-11-26 10:18:50
49b5c44ee93f8d531400a24606d90a944e42a73c...0a436e03b8289510ad191a89fcbd5ec06fb8865d,2,23,7,30,13,2013-09-09 20:29:06,2013-08-29 22:21:32
0a436e03b8289510ad191a89fcbd5ec06fb8865d...4f2e59f94a771c4b60947726815d065ef0ea253a,4,33,8,41,8,2013-09-09 20:29:57,2013-09-09 18:57:25
4f2e59f94a771c4b60947726815d065ef0ea253a...446ca4b57b228a2d030f0c816e08948ff7da1d79,2,14,10,24,4,2013-09-09 20:29:57,2013-09-09 19:40:25
ad2fbd9e873915d9d09685887eb0afe16b9559a4...a14496ce891f1f09b10f0459550e8fe095b477b5,2,12,6,18,6,2013-10-17 14:14:53,2013-10-17 14:14:53
ad2fbd9e873915d9d09685887eb0afe16b9559a4...8abcc8e713fdf6229d65dec23e6e104f8040d704,1,1,1,2,1,2013-10-17 13:33:00,2013-10-17 13:33:00
ad2fbd9e873915d9d09685887eb0afe16b9559a4...d733cdcebbcb6bc8573e1869b11f0d9116a92892,4,88,24,112,7,2013-10-17 13:32:07,2013-10-17 09:16:50
ad2fbd9e873915d9d09685887eb0afe16b9559a4...0aee096fd73676e2548e3bf132770f1692ac47dd,1,11,1,12,4,2013-10-17 12:46:58,2013-10-17 12:46:58
ad2fbd9e873915d9d09685887eb0afe16b9559a4...e6a73e65a23163273fa63d54b8f12530f7eef104,1,3,3,6,3,2013-10-17 07:53:09,2013-10-17 07:53:09
c4548506c5be239b5dcb14291434bdaadef2d963...b04c6466cdc89a107879af7a22b0917006b38730,9,168,82,250,64,2013-12-02 16:52:37,2013-10-12 12:14:52
c4548506c5be239b5dcb14291434bdaadef2d963...b9ad0c9f742a3e48ad06770abb362048306c763e,1,8,2,10,3,2013-12-02 16:52:12,2013-12-02 16:52:12
25e443a3c7f55d5ccfb1f5a96c427bd50b978f4d...58f8503b7340ca34b229609a2dcb4b0fede1e638,1,2,1,3,2,2013-11-22 02:34:23,2013-11-22 02:17:11
58f8503b7340ca34b229609a2dcb4b0fede1e638...37e00831691567e30365c9e9ced5aa90a70f6221,1,20,12,32,10,2013-11-22 18:46:15,2013-11-22 18:39:40
25e443a3c7f55d5ccfb1f5a96c427bd50b978f4d...806abe90ba38741707f58e98ecdcdd4bc19f52e2,7,12,12,24,12,2013-11-22 00:43:36,2013-11-22 00:41:41
bed87ea1038321d4c58d379040acdbd824cb8b7c...492ce4c665b7d55d1496fb7e822a49ff0d44809d,1,4,4,8,4,2013-11-15 16:12:48,2013-11-15 16:12:48
bed87ea1038321d4c58d379040acdbd824cb8b7c...007964793dd619279bfb48c3fa84ada65aa599bd,1,1,1,2,1,2013-11-15 15:16:59,2013-11-15 15:16:59
b700ee006aee0811d55c79632d038d92a9aebfbc...7eaa59f626fa9e9b3bf61d3d7eff0fb70b3d011a,4,228,0,228,9,2013-11-20 03:52:33,2013-09-02 16:06:17
7eaa59f626fa9e9b3bf61d3d7eff0fb70b3d011a...61a8020e51ac6de9bc777098a04e05a185c2cd32,1,6,9,15,12,2013-11-20 03:52:33,2013-10-12 05:11:49
61a8020e51ac6de9bc777098a04e05a185c2cd32...bf504f2afab679922e92b8bb5fe28957f5f6bf02,1,1,0,1,1,2013-11-20 03:52:33,2013-11-02 08:18:55
bf504f2afab679922e92b8bb5fe28957f5f6bf02...6014db4a7e8d76580edf995bc974a55dace0c8ba,1,1,1,2,1,2013-11-20 03:52:33,2013-11-05 01:43:57
6014db4a7e8d76580edf995bc974a55dace0c8ba...844c13bce6429087e2763038136e6485da425741,1,3,3,6,3,2013-11-20 03:52:33,2013-11-13 23:41:42
844c13bce6429087e2763038136e6485da425741...1211065c8d81fcc480ddea5d377982cab871d472,1,3,0,3,1,2013-11-20 03:52:33,2013-11-14 01:05:37
1211065c8d81fcc480ddea5d377982cab871d472...383f95bba1fef213473725fdf6193be0de5b73fd,1,47,0,47,1,2013-11-20 03:52:33,2013-11-14 01:05:46
383f95bba1fef213473725fdf6193be0de5b73fd...0ef6fed5c7b7b1ab4084ecc99880ffc6a7c8eaca,1,66,34,100,25,2013-11-20 03:52:33,2013-11-18 19:48:55
0ef6fed5c7b7b1ab4084ecc99880ffc6a7c8eaca...9de45904980dba224e8ab133f12cfc53835e2dd4,1,3,2,5,3,2013-11-20 03:52:33,2013-11-18 20:34:34
b700ee006aee0811d55c79632d038d92a9aebfbc...2cccbbdadd8ee7e28824c244e48acebfca96d78a,1,2,3,5,2,2013-11-20 03:25:54,2013-11-20 03:25:54
a2c9d2da93e5106b82e8f3951947a90508a8f430...253214f07da1a58931e6a256c351105eb2eee8bc,1,1,1,2,1,2013-11-21 18:26:21,2013-11-21 18:26:21
c4ab4989204e41046f61f660946848d10a759a83...33e70864a2c4321bf6968d6d521c159a1b72b220,10,139,95,234,85,2013-11-22 00:34:58,2013-11-21 20:21:03
c4ab4989204e41046f61f660946848d10a759a83...efd0e13ca7e11e6422faf63986f443fe0df0cece,1,13,3,16,1,2013-11-21 22:11:17,2013-11-21 22:11:17
c4ab4989204e41046f61f660946848d10a759a83...362e9d6b3c7049d44c016ee72fe255b76ec80c5a,1,1,1,2,1,2013-11-21 20:45:01,2013-11-21 20:45:01
bcdeb37bb64eca25bee9b1736a53f8ef4684c9a0...f1e6dce047d091bc4b4ea9264a29401f39381fa6,2,55,21,76,4,2013-11-21 23:19:19,2013-11-21 23:19:19
bcdeb37bb64eca25bee9b1736a53f8ef4684c9a0...3f17844b6ec3edb981653ca237d085909d5be671,1,5,5,10,5,2013-11-21 22:29:03,2013-11-21 22:29:03
ccdf27e502f5b690023fef4145d859059e82c468...0ab7b6952a092eec2690967b2ab36e0e604150a4,2,79,1,80,2,2014-03-07 23:38:10,2014-03-07 23:38:10
0ab7b6952a092eec2690967b2ab36e0e604150a4...2b3fdf2344fee3affc44c93a034ce894af4d6193,4,123,76,199,27,2014-03-10 16:57:10,2014-03-10 05:16:42
961023b8731ffc7f01de751fbb6fd27752d701fe...97ed268a8281231cdab88b166e2fe3faf7ccb296,1,1,1,2,1,2014-02-19 00:01:04,2014-02-19 00:01:04
7fb8738839a1096e15679dddbff7c9e0e44f1c86...2222cba5acd3fe663d492d7bc3fd4787d4c9869f,2,135,0,135,2,2014-02-12 18:03:32,2014-02-05 20:35:44
7fb8738839a1096e15679dddbff7c9e0e44f1c86...e2eace9715253b5254d1596f3ee91e2f61127929,3,22,11,33,5,2014-02-06 00:49:43,2014-02-06 00:49:43
7fb8738839a1096e15679dddbff7c9e0e44f1c86...63d4b293e7c91b8e2ed8da56f338f1bd0a4e1464,2,5,5,10,5,2014-02-05 20:27:12,2014-02-04 16:13:00
63d4b293e7c91b8e2ed8da56f338f1bd0a4e1464...dca21dfac77de2bbd69dd5a52b8a2b7816a54367,1,16,11,27,4,2014-02-05 20:27:12,2014-02-04 15:06:54
dca21dfac77de2bbd69dd5a52b8a2b7816a54367...b95c560fdda4813319a2377e240592a3261e30ef,3,93,88,181,30,2014-02-06 12:14:42,2014-02-04 17:19:09
b95c560fdda4813319a2377e240592a3261e30ef...7e25cd5891f84c2fab656c364002290e4b87f934,1,1,1,2,1,2014-02-06 12:14:49,2014-02-04 15:08:45
7e25cd5891f84c2fab656c364002290e4b87f934...2c82fd93d8a01cc1f53fe861378e6d2dca0486c6,1,24,1,25,5,2014-02-06 12:14:49,2014-02-05 20:37:53
2c82fd93d8a01cc1f53fe861378e6d2dca0486c6...304e33a2fe2d006cc1063c8060c6e22c9ade3d59,1,3,0,3,1,2014-02-06 21:26:09,2014-02-06 21:26:09
304e33a2fe2d006cc1063c8060c6e22c9ade3d59...693d3f8c6ab4c9fed5fe4c5ac5fcb44568fe1638,1,3,0,3,1,2014-02-06 22:08:17,2014-02-06 22:08:17
7fb8738839a1096e15679dddbff7c9e0e44f1c86...347dc3942704742c1d24983a1e9cb10ae7ab8839,1,2,1,3,2,2014-02-05 19:20:59,2014-02-05 19:19:48
52ec95f3635b7c9ae4567a473bcc3ffbd657ea7d...0fb8a55753269603eb8f01f725675ceacae79c29,3,43,28,71,17,2014-01-15 22:52:58,2014-01-09 18:06:16
0fb8a55753269603eb8f01f725675ceacae79c29...a33bc3018bf091725b7faca9a6039a07b6fd0ca7,3,13,1,14,5,2014-01-15 22:52:58,2014-01-10 22:54:54
59fe36623bae670f2b973a8e558e57b69197b5d9...11ef2f0db46b8507007c740300fbf486934aa996,1,1,1,2,1,2014-01-17 02:31:21,2014-01-17 01:55:03
210db8e846cde8a56a5bcd6a3c5016017ecc86cd...4d4339c6deb44eb5aee7578a0efd185f349ef68e,1,4,4,8,3,2014-01-23 18:50:11,2014-01-23 18:50:11
210db8e846cde8a56a5bcd6a3c5016017ecc86cd...d419da7227826e84e9375ece4fd9d4978a42cbf7,3,101,1,102,4,2014-01-23 12:09:44,2014-01-17 13:46:11
d419da7227826e84e9375ece4fd9d4978a42cbf7...fd2403b8303f7ea9152dd08021d2c9c7070aefb4,1,1,1,2,1,2014-01-23 17:01:24,2014-01-23 17:01:21
9e2e8a923c28833dd631a7206d3664a6a90cc24c...d32777f6b1f3a5dff6df0e285b9cd68b2c0d00ad,1,42,63,105,18,2014-01-23 00:13:22,2014-01-23 00:13:22
9e2e8a923c28833dd631a7206d3664a6a90cc24c...63d18d875b8a136d59c98b7b571366b10b5d4f76,2,63,1,64,3,2014-01-23 00:00:53,2014-01-23 00:00:53
637a1dcab65c7335d979d42af190a53d9bbea9f7...98518bbcad85217ac36112f6a18a275816b38287,1,22,17,39,8,2014-01-31 00:03:13,2014-01-31 00:03:13
b61570b521346769908e678e96e510e6ae193f28...26726dc9ff3ac8ccc7f40f7672e6494d0e77611d,3,22,15,37,14,2014-01-17 19:09:50,2014-01-17 07:41:29
26726dc9ff3ac8ccc7f40f7672e6494d0e77611d...a886fbfa4a01f7d73c9c2d836da89ecf23a40a33,1,1,1,2,1,2014-01-17 19:09:53,2014-01-17 19:05:08
a886fbfa4a01f7d73c9c2d836da89ecf23a40a33...dadd54dba395f68c492a8ce5e2bf9488f9db0830,2,15,7,22,2,2014-01-17 22:04:11,2014-01-17 21:12:08
dadd54dba395f68c492a8ce5e2bf9488f9db0830...77d9fd262828c0c626b2093e8a62e05cc130905e,2,2,2,4,2,2014-01-18 00:55:42,2014-01-18 00:30:27
b61570b521346769908e678e96e510e6ae193f28...a02450d048d0a858aceda2343ef4d7633eca6ebb,1,2,3,5,2,2014-01-11 06:36:58,2014-01-10 20:08:28
fbd374f30b11a39ea24a7f3fddb6a50329e4ddd7...d8a71635d4eb6b3dbe0102ab6e177bff8ff5dbec,4,14,1,15,4,2014-01-20 23:11:30,2014-01-16 00:04:36
d8a71635d4eb6b3dbe0102ab6e177bff8ff5dbec...c56e3b8569caa8db6fb7372c7a5f5153eb5d63b7,2,7,9,16,4,2014-01-20 23:11:30,2014-01-16 00:13:00
c56e3b8569caa8db6fb7372c7a5f5153eb5d63b7...29e6868cc36356393730ff2a5ae4506ac2d162e1,1,2,2,4,1,2014-01-20 23:11:30,2014-01-16 00:14:28
29e6868cc36356393730ff2a5ae4506ac2d162e1...dd786eefbbf286ca57b52374a6905c1ac8b8bd60,4,47,74,121,5,2014-01-20 23:11:30,2014-01-16 00:17:23
dd786eefbbf286ca57b52374a6905c1ac8b8bd60...4e54dd245a5e20b86f305ccb8f493d7f17317c50,2,0,153,153,3,2014-01-20 23:11:30,2014-01-16 00:21:22
4e54dd245a5e20b86f305ccb8f493d7f17317c50...45e8d1f4c0366c5372229db20b95b70badc92119,2,21,8,29,4,2014-01-20 23:17:40,2014-01-20 23:17:40
fbd374f30b11a39ea24a7f3fddb6a50329e4ddd7...71c1646ba33da9b2567ad7a2f4cda0433c9718dd,5,31,34,65,13,2014-01-20 22:06:24,2014-01-20 21:23:02
fe6c9e8fd7cef9bae224dd66a59696dcb025db49...3a1ce011a02ee42441b895b1f636c9e7363e2625,3,75,0,75,3,2014-01-14 15:26:18,2014-01-14 11:04:37
fe6c9e8fd7cef9bae224dd66a59696dcb025db49...5a3fa3c901bfc226456f3caa13d26b77e5ca2f4d,1,22,6,28,4,2014-01-14 11:20:27,2014-01-14 11:19:42
fe6c9e8fd7cef9bae224dd66a59696dcb025db49...c7dcd19b28c069a396b3b9688886f9c88730e86d,1,1,1,2,1,2014-01-14 11:18:51,2014-01-14 11:18:31
fe6c9e8fd7cef9bae224dd66a59696dcb025db49...658f57fdfa488968cc63d866b9e3689345a3f199,1,0,1,1,1,2014-01-14 06:32:21,2014-01-14 06:32:21
3bd36157a10bbbe8fbdca14aefb03496a225e0be...fe02d589272e61f75c9e794afb82641e78dfe8a3,1,2,0,2,2,2014-01-20 18:24:38,2014-01-18 18:22:05
62c456398767b3e8155ec6d0df265cb5fb464438...fd38de2818d959a9f5591537515e923a3ac56632,1,12,3,15,1,2014-01-22 02:05:03,2014-01-22 02:05:03
62c456398767b3e8155ec6d0df265cb5fb464438...0376a69cb1cc839f7e1a147623b399147a5976c9,2,67,0,67,4,2014-01-22 00:49:24,2014-01-22 00:38:17
62c456398767b3e8155ec6d0df265cb5fb464438...80f128a6ea2b71e2ed6838c6a913086859ed50ff,1,5,3,8,2,2014-01-22 00:18:57,2014-01-22 00:18:57
62c456398767b3e8155ec6d0df265cb5fb464438...e3461bc8d694fa4b104a9cdd08e11de26a04d923,9,115,122,237,48,2014-01-21 23:06:23,2014-01-21 23:06:23
acf43b4da7c7f81f5774f341828b8b862f204c04...90b52b7e0623271ec0351ffb6dc7a7586bbe6e4d,1,2,1,3,2,2014-01-21 01:11:03,2014-01-21 01:11:03
189c40597fb7453ab7d37b4d3c2e08116c3b676c...0354c3a95cf1f95ac9564b8e2897295e8a8613fd,1,1,1,2,1,2014-01-09 00:57:56,2014-01-09 00:57:56
c2501942cfb5a169d40fd6e445e336ac3bc8c303...6e6ff85362dfa823c392392cb9e70d620e308911,6,47,9,56,16,2014-01-20 23:35:14,2014-01-03 20:13:32
402a58a75a5b9813c889bf6c030bb756f86e56d4...8149439d956489a551f9e197ca2adbae85e78ff0,1,6,3,9,3,2013-11-11 17:15:51,2013-11-11 17:15:51
8149439d956489a551f9e197ca2adbae85e78ff0...e2ac0e6b806c094fd8a3b706653623c0c2aee861,1,27,16,43,21,2013-11-11 22:47:23,2013-11-11 22:44:51
28d4cbbc59e419f00c1ad75991b106241933ca5d...12e993549df025d072add1a0bcb9bfcc7fe5bdb5,4,23,83,106,13,2013-11-19 23:24:14,2013-11-19 23:24:14
a9230af52e819add5055aa0336e225f77dc62d2a...1ab6b8bf4970b050575b008dd658471e185f2a2c,1,11,11,22,4,2013-11-21 19:30:17,2013-11-21 07:12:07
437bdeee5901daa9d73db393767b1c5030c15143...79e2b33ede415736f9124089a61f4512c16ddddd,3,33,41,74,11,2013-11-22 20:25:37,2013-11-20 19:39:15
6cf2c14c0065e0adb95c505fdc09c00826f4011a...12180948be8040a4cdf99a0e660098cd33e32832,4,5,5,10,5,2013-12-04 19:54:11,2013-12-04 19:54:11
12180948be8040a4cdf99a0e660098cd33e32832...be282b57d561bdb7e686ed8d4f7b6327e7a65b70,1,3,0,3,1,2013-12-04 19:55:42,2013-12-04 19:55:42
be282b57d561bdb7e686ed8d4f7b6327e7a65b70...4bc100b494022901d4d7f51cba303ae3562b1303,1,3,3,6,3,2013-12-04 19:57:18,2013-12-04 19:57:18
e87c3ea34243eb398364927d93ef27ee560e5601...ec6fe9f2007a0400a441b79c89bced5727589ba9,1,3,0,3,1,2013-11-11 18:56:21,2013-11-11 18:56:21
eace2dbe1d49ad6a990f5b42f092d3f4d77bf225...006e2a600ce689770ba2c49805bc4f634976f365,1,1,1,2,1,2013-11-14 21:56:18,2013-11-14 21:56:18
006e2a600ce689770ba2c49805bc4f634976f365...d69a6a20f0b6657821638ee591920d071a784b0e,2,9,26,35,4,2013-11-15 08:49:42,2013-11-14 21:57:33
d69a6a20f0b6657821638ee591920d071a784b0e...f7238f94e8b5b31e78360c342676ca84b5984806,1,297,0,297,1,2013-11-15 08:49:46,2013-11-14 21:59:04
46ab7d1e8a4256a39ee700ae217fedca20bc1ccf...80e73195583c5a9bf02c58ba92832a0bb2819361,1,2,5,7,2,2013-11-13 22:54:47,2013-11-13 22:54:47
80e73195583c5a9bf02c58ba92832a0bb2819361...6b3dd02bb8068fd9f1d35e75db95d0650a1d3123,2,264,6,270,11,2013-11-13 22:56:26,2013-11-13 22:56:26
46ab7d1e8a4256a39ee700ae217fedca20bc1ccf...1d188c8737f97a4882851ccd0150cd09c7f6c1e9,2,405,250,655,36,2013-11-13 22:36:31,2013-11-13 22:36:31
1d188c8737f97a4882851ccd0150cd09c7f6c1e9...4bebca848ea3546cd5813ab4c13b0248050454d8,3,232,7,239,8,2013-11-13 23:35:52,2013-11-13 23:35:52
46ab7d1e8a4256a39ee700ae217fedca20bc1ccf...a69d86e0b19d804819d37a2a9edc03803267f579,1,51,0,51,1,2013-11-13 19:03:56,2013-11-13 19:03:56
0a9df6bc1a8260fed2e038399106c8055689a9c8...81674fbbdf657de2c1d13b7c84a41c9edd3c8aa1,3,86,0,86,3,2013-11-08 01:52:56,2013-11-08 01:52:56
5da1ed32916feee87ed7d8ecec5cb04d5cbae682...ba2b36e192c571566fa4769b1031d120c26b8ae0,2,129,0,129,2,2013-11-25 19:05:01,2013-11-25 19:05:01
926f7b579e48dcd5bda26bcd7a0ef0e25aed94da...70b586702cb1715d4ff4dd7ffe356285df73b18e,2,23,0,23,2,2013-12-02 19:03:16,2013-11-29 06:54:41
926f7b579e48dcd5bda26bcd7a0ef0e25aed94da...ca98434a45a1c836aa69d67d8cc12b8e95e5722f,1,10,12,22,3,2013-11-29 19:06:35,2013-11-29 19:06:35
926f7b579e48dcd5bda26bcd7a0ef0e25aed94da...fe727e2a87fa086d728664c396fd44f4be6d6afd,1,2,0,2,1,2013-11-29 12:07:20,2013-11-29 10:02:53
b3959e69b5a7664daa59cd79b6e5ecae4cc835f1...750d2d8d07069c54c0fbddf4ccd2ba10e9ba9dc9,2,83,0,83,2,2013-11-26 03:06:18,2013-11-26 03:06:18
3a2fbcfdece8a9cc66a037705e16adab5e866b91...4e826e99b278ef3cc438553e958727397b4d9ee7,1,9,9,18,7,2013-11-27 17:55:15,2013-11-27 17:55:15
399c71de8331d8ff35e33c5b810a647f6ea92f1a...8b0b10b6f9fa152346e62b5dad1f4d430ae0e4d1,1,1,1,2,1,2013-11-25 18:28:17,2013-11-25 18:28:17
06cf8fee1b9b588e0096349e94a0cb95948c014e...a74b512540d24c89b64ca62933f4512c4804f3ed,1,36,32,68,19,2013-11-26 05:58:17,2013-11-26 05:58:17
28b162eeb48002e1824a1b43bbc864e93af8e26b...64136071c6128fc759f1040186b06fee61d6aab6,1,1,1,2,1,2013-12-16 23:43:46,2013-12-16 23:43:46
aeba4e64824b5530c0c5e2aa3d840ca5501028bf...3c1f3be032be4cd4a8c9235ed35e3a269e5f524e,1,1,1,2,1,2013-12-07 01:31:09,2013-12-07 01:31:09
6344e6f258c7aef7d805b6ede8a94bde4372d7df...e4ae44b844a38327ee4288361376299595b1917e,1,7,0,7,1,2013-11-27 18:41:20,2013-11-27 18:41:20
6344e6f258c7aef7d805b6ede8a94bde4372d7df...ae474e05f553c7abefc8674148e2a84a417bbf64,1,8,3,11,2,2013-11-27 12:18:01,2013-11-27 12:18:01
ae474e05f553c7abefc8674148e2a84a417bbf64...788feab3a7de44a4749e5a861e3b6f778aa4088b,1,9,5,14,1,2013-11-27 16:53:36,2013-11-27 16:53:36
6344e6f258c7aef7d805b6ede8a94bde4372d7df...0ff9bc1be3ae044107732c605986a0af20220134,1,34,24,58,2,2013-11-27 11:14:18,2013-11-27 08:10:44
6344e6f258c7aef7d805b6ede8a94bde4372d7df...7b95d410926bffa6d8f42095fa8b38e01a5ac67b,1,3,0,3,1,2013-11-27 03:19:06,2013-11-27 03:05:39
6344e6f258c7aef7d805b6ede8a94bde4372d7df...1cb7b9adc6b9a4e4c8f746c6886a7229b0efda91,1,2,1,3,1,2013-11-27 02:58:54,2013-11-27 02:58:54
6344e6f258c7aef7d805b6ede8a94bde4372d7df...d370a889c37b762a8ddf7e29a8e666fd7cedec3d,1,0,7,7,3,2013-11-27 02:00:13,2013-11-27 02:00:13
d370a889c37b762a8ddf7e29a8e666fd7cedec3d...b3e8ba19085732d9f633e4cbddb660f5f8dc5462,1,1,1,2,2,2013-11-27 04:07:56,2013-11-27 04:07:56
b3e8ba19085732d9f633e4cbddb660f5f8dc5462...682a188ead44e93ac3d5cc53c708808fa7d2fe4f,1,6,4,10,7,2013-11-27 16:25:30,2013-11-27 16:25:30
8b99e4ed374b8048a548556a6ff97d2f2598a5f5...74c8f7af756ed03131aee051b0ccb926b77e04db,4,162,163,325,32,2013-11-27 23:39:30,2013-11-27 07:16:34
74c8f7af756ed03131aee051b0ccb926b77e04db...eb528b959efc0a3924939991be45704047fd5aea,3,208,137,345,9,2013-11-28 01:12:57,2013-11-28 01:12:57
eb528b959efc0a3924939991be45704047fd5aea...1214b8897bba2a33a7ded8779bcdc966fe1cb176,4,99,113,212,14,2013-11-28 01:47:20,2013-11-28 01:44:54
1214b8897bba2a33a7ded8779bcdc966fe1cb176...8a5d927a5337b1c9a0c8478c4e522ce0ded09b85,2,7,5,12,2,2013-11-28 02:21:17,2013-11-28 02:21:17
8b99e4ed374b8048a548556a6ff97d2f2598a5f5...45b1e8c2362b3626ccc564496e3093386bb89cd9,1,16,14,30,9,2013-11-27 14:55:41,2013-11-26 21:11:08
8b99e4ed374b8048a548556a6ff97d2f2598a5f5...6d34c50e898507e461300ecf91ed661011bc15ab,4,113,20,133,11,2013-11-27 01:04:55,2013-11-26 18:50:53
8b99e4ed374b8048a548556a6ff97d2f2598a5f5...c707c587c1fbd8e68f1e9a3c64ee0aca764461eb,1,78,0,78,1,2013-11-26 20:16:16,2013-11-26 20:16:16
c707c587c1fbd8e68f1e9a3c64ee0aca764461eb...c7661f40b6c6a23e5fe2090a94bd9fa6521242d7,1,6,2,8,2,2013-11-26 23:00:44,2013-11-26 23:00:44
c7661f40b6c6a23e5fe2090a94bd9fa6521242d7...462e30dcbdc5010abe21b206bcd4be0c8bc71be6,1,79,0,79,1,2013-11-26 23:03:50,2013-11-26 23:03:50
8b99e4ed374b8048a548556a6ff97d2f2598a5f5...1ba11384bf82f824b0efbab31aaca439cfba1b4f,6,178,115,293,30,2013-11-26 17:46:06,2013-11-26 17:46:06
1ba11384bf82f824b0efbab31aaca439cfba1b4f...1beb5005d11b8fadd04e51c4a1341779d26a475d,1,16,15,31,3,2013-11-26 17:47:58,2013-11-26 17:47:58
1beb5005d11b8fadd04e51c4a1341779d26a475d...5e3f6e7023fbd0cfd1233a99c332801755340cfb,1,4,14,18,3,2013-11-26 18:31:59,2013-11-26 17:50:43
8b99e4ed374b8048a548556a6ff97d2f2598a5f5...8398abf0dcda8fa7818b69355af9b99ab4e8bdfc,1,2,2,4,1,2013-11-26 16:36:46,2013-11-26 16:36:46
bdb3b2a88c0379942e3e10f4e44b7d69a96b49d2...31b883b07641bfab721a05f0a68629c79b74a058,3,51,41,92,36,2013-10-17 22:04:14,2013-10-17 22:04:14
31b883b07641bfab721a05f0a68629c79b74a058...330062ef723f66ed8a640627f983e586f46df03a,2,0,7,7,2,2013-10-17 23:59:59,2013-10-17 23:59:59
330062ef723f66ed8a640627f983e586f46df03a...ed03dbfe82f4481ea3845071606ef25c7ea2ec3e,2,0,20,20,5,2013-10-18 00:07:46,2013-10-18 00:01:29
ed03dbfe82f4481ea3845071606ef25c7ea2ec3e...4bd6021806985b48b872aa9dbe2d0183675eac1d,6,42,42,84,42,2013-10-18 00:07:56,2013-10-18 00:07:34
4bd6021806985b48b872aa9dbe2d0183675eac1d...d034aafac7a9db601b8affd61a28c762be6b6c31,1,1,0,1,1,2013-10-18 00:58:20,2013-10-18 00:58:20
d034aafac7a9db601b8affd61a28c762be6b6c31...5cd7de5de8fddd5868c6b85ed1e4f46228c82672,1,22,0,22,2,2013-10-18 03:31:21,2013-10-18 02:32:13
d3505d836ac98a95b2129206844b6e4d6ad24927...85a36b3b53f39e13bba9d69a486758b68301d503,1,0,0,0,0,2013-10-18 05:19:22,2013-10-18 05:19:22
85a36b3b53f39e13bba9d69a486758b68301d503...07e09d57af29bf9b59945ab2f31c4dc5ab52bb5b,2,7,28,35,7,2013-10-18 06:44:30,2013-10-18 06:44:30
07e09d57af29bf9b59945ab2f31c4dc5ab52bb5b...5f58a1fbe4733c1415046d6e16afd17a41b595a8,1,23,3,26,6,2013-10-18 06:47:08,2013-10-18 06:47:08
5f58a1fbe4733c1415046d6e16afd17a41b595a8...cad913c57bbd1d9f9b3b2284ee9e2c262734047b,1,0,7,7,1,2013-10-18 06:48:20,2013-10-18 06:48:20
73545199a8e84ebc7e44bf2595c7f7b0e20f04a1...dfb77274cef85c0561d98de2eee8b2562c329d1f,1,1,2,3,1,2013-10-18 08:22:42,2013-10-18 08:22:42
dfb77274cef85c0561d98de2eee8b2562c329d1f...4756ad248a6b8c70a7f4d6cb1aacd6e60e27b1e6,1,5,1,6,1,2013-10-18 08:30:53,2013-10-18 08:30:53
4756ad248a6b8c70a7f4d6cb1aacd6e60e27b1e6...572b1fd9be69c20a98d885e18b327031ef4f4b51,1,9,1,10,2,2013-10-18 09:38:21,2013-10-18 09:38:21
572b1fd9be69c20a98d885e18b327031ef4f4b51...2812baf3957391bf8871bd56c00a58f4fbc0b715,1,1,1,2,1,2013-10-18 09:39:47,2013-10-18 09:39:47
2812baf3957391bf8871bd56c00a58f4fbc0b715...c2175ae736e6b77119ec92a832e325ec076a1e78,3,12,5,17,5,2013-10-18 19:29:16,2013-10-18 19:29:16
b04c6466cdc89a107879af7a22b0917006b38730...e4cb83c50e554bfd8ae3e0a1f2be4f0fb661861d,4,1277,9,1286,5,2013-12-02 18:27:28,2013-12-02 18:23:54
94d46a8d3a2278962c30c01e831754d6cefe9b2e...697707e4afe6f1e7e5e33c24ada2f1f2af279142,5,60,49,109,12,2013-12-05 22:03:23,2013-12-05 22:03:23
94d46a8d3a2278962c30c01e831754d6cefe9b2e...5a17c208cd4858a21d38b09e60ee8199880f02bb,1,1,1,2,1,2013-12-05 17:43:08,2013-12-05 17:43:08
94d46a8d3a2278962c30c01e831754d6cefe9b2e...e9bf971e69800f1189dd240d95972f5f0dcc3bec,1,23,8,31,8,2013-12-05 11:48:35,2013-12-05 11:48:35
94d46a8d3a2278962c30c01e831754d6cefe9b2e...04c32495f69a48c34b753b66d7cdc4f2c695f405,1,3,0,3,1,2013-12-05 04:20:16,2013-12-05 04:19:10
94d46a8d3a2278962c30c01e831754d6cefe9b2e...af020e2d67256d386e43741071dc4855735d92a3,1,29,23,52,22,2013-12-05 04:14:08,2013-12-05 04:14:08
0c38f86e5e799e71866a3ee2f876c170e71c68d0...10f23a94f6daaf03c684937daea67d10205b4b89,2,11,4,15,4,2013-11-15 10:30:28,2013-11-15 10:30:28
0c38f86e5e799e71866a3ee2f876c170e71c68d0...062810caedba973e76a3dd7eb9e45b56511eefc6,4,5,0,5,4,2013-11-15 09:24:48,2013-11-15 09:24:48
062810caedba973e76a3dd7eb9e45b56511eefc6...243843c0787ce2b56c8bbf72a2d4bd7604e84b2e,7,40,10,50,7,2013-11-15 10:04:02,2013-11-15 10:04:02
cd4c1ac35606bf2a245a76b6b3fd3ff1f2d67d03...171d681724443cf69f669dcaf4887f5d99894b25,1,9,6,15,5,2013-11-20 17:40:30,2013-11-20 17:27:43
e128a606e39fa63c6b4fd6e53a1d88cf00aad868...3d9cd1e5f102d5e59011ec4baca2662f3dacbad4,1,3,3,6,2,2014-04-09 17:13:54,2014-04-09 17:13:54
e128a606e39fa63c6b4fd6e53a1d88cf00aad868...e8aa24c71a53b27d68e2468aaa3be056596b88ed,1,1,1,2,1,2014-04-08 23:02:19,2014-04-08 23:02:15
71c65193e0d881acea37b2133e3f9ce31b4be938...d7646f934a268bf071a16439880ba2bba608426e,1,1,1,2,1,2014-03-10 21:08:26,2014-03-10 21:08:26
983edd40fa118a8fe79b83b8ec7238c16949c33e...d5d948a038933251fe39021883b71f3399ab116c,1,1,0,1,1,2014-02-06 17:28:30,2014-02-06 17:28:30
d0fc598ce2d4d4d4d2cc6b530ffaf74978d6d0d9...55b74bfe469115f25a52c6ad48b13eb9c7e6197c,1,6,0,6,1,2014-02-07 00:42:11,2014-02-07 00:42:11
2a1609d618fc89cd76affe163db4b8dab153ec40...bbe382bec4b24d8aee09570f2c3920cc1c9710ca,1,4,0,4,1,2014-02-06 11:18:12,2014-02-06 11:18:12
44b8d8addfbf9ec8e4e5ca9fa91ddf4a543489ae...2edcebc0275b726e87575830bb3e96dfb69d7665,1,1,1,2,1,2014-01-15 23:41:57,2014-01-15 23:41:57
d6b810c32e72c21a1c7fce5f3157c78457d7a8b2...89ff488b55c9ebb8d458508df035cac0c55ee01c,26,19,4,23,5,2014-01-17 20:29:32,2014-01-16 00:33:01
d6b810c32e72c21a1c7fce5f3157c78457d7a8b2...fdd8d4b7d9dbc32a76a708d0d51c201cf9c977f0,2,82,50,132,42,2014-01-17 18:51:29,2014-01-16 19:02:51
fdd8d4b7d9dbc32a76a708d0d51c201cf9c977f0...95df957f73f4e7bb7225111bd4a4b4ff337af529,1,25,11,36,10,2014-01-17 19:02:44,2014-01-17 19:02:44
d6b810c32e72c21a1c7fce5f3157c78457d7a8b2...2f6fb41dd149719ddbc7fd2bd891f03695a3769a,2,159,20,179,89,2014-01-17 03:13:51,2014-01-17 03:13:51
7687b3cec1b046453cba007678053489609f86b2...94566b748e69a57cf88ef4acbe18ecbe76bb2f54,1,11,7,18,8,2014-01-28 00:18:33,2014-01-27 22:34:46
7687b3cec1b046453cba007678053489609f86b2...415379e45dadb32385771ceae701d8b9f204f2b8,2,103,82,185,11,2014-01-24 00:08:05,2014-01-23 20:19:52
7687b3cec1b046453cba007678053489609f86b2...2f57eb04102c2ef08e478d3977fc3682672473af,1,2,2,4,2,2014-01-23 23:10:33,2014-01-23 21:41:18
7687b3cec1b046453cba007678053489609f86b2...f60eee4894cfa07e8a969425c72d291f80f3053a,2,7,17,24,2,2014-01-23 20:03:17,2014-01-23 20:00:23
95dff84728493ff8d5ac2805473686afb70323f3...5b82a1b726291d4aaaad797df5b29a74de28d318,1,24,0,24,1,2014-01-30 00:55:29,2014-01-30 00:45:55
5b82a1b726291d4aaaad797df5b29a74de28d318...187646127fa80a5ba39a53619b410eb2a13f0ffd,5,59,61,120,10,2014-01-30 00:56:42,2014-01-30 00:56:42
187646127fa80a5ba39a53619b410eb2a13f0ffd...9261511aa509423432f4e22f6235719deadc0969,3,46,41,87,14,2014-01-30 20:45:32,2014-01-30 20:45:32
641005777aa1b27ec0eb778fa810ed8aa53bae3b...6cae33ca0f78ce8b7f1250e1f85828cfb242b12f,1,2,1,3,1,2014-01-24 02:55:26,2014-01-24 02:55:26
9d44298c5e733e0e36973a765af77b28861d542d...9dcbdbc4b1addb67c0fdcadab1c8f98f30e58b4c,8,107,45,152,29,2014-01-24 22:46:31,2014-01-22 21:35:35
9dcbdbc4b1addb67c0fdcadab1c8f98f30e58b4c...90e9a2d85a6c981b137df0c22c31d6f32f4b6f66,2,13,1,14,2,2014-01-24 22:46:31,2014-01-23 00:15:23
90e9a2d85a6c981b137df0c22c31d6f32f4b6f66...35641f0ec7ecae16f88ba9affe0aeea0ae864874,3,6,20,26,9,2014-01-24 22:46:31,2014-01-24 00:00:07
63d18d875b8a136d59c98b7b571366b10b5d4f76...43bcbf06a663c5d8cac63f2af8fefef7edc5513a,1,10,0,10,1,2014-01-23 00:13:28,2014-01-23 00:13:28
cb314b9752352d9034466c3503058f22b79c345f...fb63cfa9a502e2410597422f8877cf16b0bbaad2,1,5,0,5,1,2014-01-11 12:46:11,2014-01-11 12:46:11
fb63cfa9a502e2410597422f8877cf16b0bbaad2...7a6255efbcb83458ca179b2148fda7a0160a4bd7,1,11,2,13,3,2014-01-14 18:42:03,2014-01-14 18:42:03
3155ef5cbc99862e9179a99e2a024701efb3aa80...812798a7d6659178300d00c470a19c7fe5e68d1c,2,43,23,66,13,2014-01-17 00:07:42,2014-01-16 22:58:20
812798a7d6659178300d00c470a19c7fe5e68d1c...8cbabf2c3e24b6fc0f676a8696133742622f7249,1,0,1,1,1,2014-01-17 00:07:42,2014-01-16 23:47:18
3cb5bc5ae524531e0285661aec5f1542d6d09d51...d247b7d42613e3435e332aa05351d22e1fbea82c,1,75,0,75,1,2014-01-23 03:53:19,2014-01-22 14:48:47
3cb5bc5ae524531e0285661aec5f1542d6d09d51...7c55cbd4c9da88ffb4b1a325ba2e5435e337a3af,5,15,60,75,9,2014-01-22 11:31:42,2014-01-10 02:56:05
3cb5bc5ae524531e0285661aec5f1542d6d09d51...0f5ad430c4a37f6efe7f27428ba54cf719936b68,1,11,3,14,4,2014-01-22 11:29:05,2014-01-22 04:12:01
3cb5bc5ae524531e0285661aec5f1542d6d09d51...f3cb808e9d7d870dc71510bdeecec15745bb44b5,1,4,4,8,3,2014-01-22 06:40:06,2014-01-22 06:08:11
f3cb808e9d7d870dc71510bdeecec15745bb44b5...1c06a9196451a595c71a47ba9fb4e9f4bc270746,1,9,9,18,7,2014-01-22 06:40:33,2014-01-22 06:24:04
3cb5bc5ae524531e0285661aec5f1542d6d09d51...1f75a0bf435fe9a0f118b027e0387ba41e201c66,4,132,19,151,14,2014-01-22 06:10:52,2014-01-22 04:42:36
4fb507d7568fa38f1e717f79ae2606a4f7ce6e9f...10fc518fba8bf0f4a32cb1824664abfbacf5d884,1,2,2,4,1,2014-01-20 18:29:07,2014-01-18 17:07:02
10fc518fba8bf0f4a32cb1824664abfbacf5d884...1c152f443df254e18d44790cd0dbfb6f6361e018,1,2,0,2,1,2014-01-20 18:29:07,2014-01-18 17:07:32
1c152f443df254e18d44790cd0dbfb6f6361e018...274863f221b55f2eb60fde7457e30998438a3f72,1,1,1,2,1,2014-01-20 18:29:24,2014-01-20 18:29:24
274863f221b55f2eb60fde7457e30998438a3f72...6ed9b06e072888d1e7bd60106f17371a89b668a4,2,4,4,8,2,2014-01-20 19:30:18,2014-01-20 19:29:55
b417f79c0032e8453df92656589e21f445d73043...3e96f46b30340f8468a7bac8c159b610a2309821,1,5,2,7,1,2014-01-22 00:05:29,2013-11-11 21:29:56
3e96f46b30340f8468a7bac8c159b610a2309821...47d1413d7a0850edc64c62f1473b4c4a3f417d7c,2,18,5,23,3,2014-01-22 00:05:30,2013-12-06 18:43:54
90b52b7e0623271ec0351ffb6dc7a7586bbe6e4d...fdf43f5de14e1ddf9e806e78f51e98721b920b5d,1,11,15,26,5,2014-01-21 07:33:26,2014-01-21 01:36:38
90b52b7e0623271ec0351ffb6dc7a7586bbe6e4d...2cfd696b9bacda67468a0a2ef93d61258781e8bc,4,89,39,128,41,2014-01-21 04:06:19,2014-01-21 04:06:19
2cfd696b9bacda67468a0a2ef93d61258781e8bc...d16691e3ad520675752ff319be054e688c50c475,1,7,7,14,1,2014-01-21 04:11:40,2014-01-21 04:11:40
90b52b7e0623271ec0351ffb6dc7a7586bbe6e4d...cf1781608326e9e3ce090383259bbc26d43c49d6,1,12,11,23,3,2014-01-21 03:43:16,2014-01-21 01:48:48
cf1781608326e9e3ce090383259bbc26d43c49d6...cf5504eed50f01797646079ab849260ec16cd5a2,3,62,40,102,5,2014-01-21 03:43:16,2014-01-21 02:10:32
cf5504eed50f01797646079ab849260ec16cd5a2...76eee50a67732ee18a678ebf54720b78370254df,1,11,15,26,7,2014-01-21 03:43:16,2014-01-21 02:58:04
76eee50a67732ee18a678ebf54720b78370254df...589e1a9bdce47d87870c64c5449002bca2b315a4,1,3,3,6,2,2014-01-21 03:43:16,2014-01-21 03:31:23
589e1a9bdce47d87870c64c5449002bca2b315a4...c24d128bb545e292ffb0790d8ad3652f56d62b44,3,1,1,2,2,2014-01-21 03:43:16,2014-01-21 03:39:33
c24d128bb545e292ffb0790d8ad3652f56d62b44...ae2af201f340420f70ca05d54d150764bd88e680,3,8,8,16,8,2014-01-21 07:27:55,2014-01-21 07:26:45
90b52b7e0623271ec0351ffb6dc7a7586bbe6e4d...230554695ad083048268cbf0fd1364cabdaddce8,1,0,1,1,1,2014-01-21 02:48:59,2014-01-16 18:23:30
230554695ad083048268cbf0fd1364cabdaddce8...1fe426641d30b5cde4adc826b3112468a4b10559,1,0,1,1,1,2014-01-21 02:49:13,2014-01-21 02:46:38
42df36b6fcbf2397a35d37a59fbb50d69e27129e...562a23576328c1586f1be968fa15cb075267138c,2,2,1,3,2,2014-01-09 18:23:19,2014-01-09 18:17:50
42df36b6fcbf2397a35d37a59fbb50d69e27129e...c3f259754688d7c20cac5b8f8b998a7608f034a8,1,1,1,2,1,2014-01-09 17:02:56,2014-01-09 17:02:56
42df36b6fcbf2397a35d37a59fbb50d69e27129e...a4f3cd62a3d221dcb55279cc9f0db41e7920c094,1,1,1,2,1,2014-01-09 16:52:17,2014-01-09 16:51:45
42df36b6fcbf2397a35d37a59fbb50d69e27129e...7a7c3d87d8040b41970b7fc89305bb18561386d3,1,1,1,2,1,2014-01-09 15:02:55,2014-01-09 15:02:55
ffe78e82c3e1288285266d9aeae387935b528777...497e7d651a21fb1fa0d78221c274871a757a1dc0,1,6,6,12,4,2014-01-21 00:09:07,2014-01-21 00:09:07
497e7d651a21fb1fa0d78221c274871a757a1dc0...f2f44b91a8ebbcea9c62f0c1b63e5aabaa3110b4,3,30,16,46,16,2014-01-21 19:28:45,2014-01-21 00:09:17
ffe78e82c3e1288285266d9aeae387935b528777...12468f2bc8a72a6bedfd681084863ea95b48713b,7,51,47,98,34,2014-01-21 00:05:07,2014-01-21 00:05:07
12468f2bc8a72a6bedfd681084863ea95b48713b...75e0357d691499b20dc903b702bc44c444f85005,3,52,50,102,7,2014-01-22 22:04:55,2014-01-21 02:07:18
75e0357d691499b20dc903b702bc44c444f85005...ba8ca598625215499713a9b65001164b672e69ab,3,6,6,12,4,2014-01-22 22:05:01,2014-01-21 02:27:36
ba8ca598625215499713a9b65001164b672e69ab...8723a8a89ec7d5b2a37e0536d7aadd78e5329773,2,3,2,5,2,2014-01-22 22:05:01,2014-01-21 02:43:54
a06edd77e5e6e8de1fd1e745bc462af6cbd11001...a4f14528c25c4a092c30334d05008fe44275a79e,2,5,3,8,4,2013-11-13 18:33:24,2013-11-13 18:33:24
ec6fe9f2007a0400a441b79c89bced5727589ba9...4d1a537433ede2bbc75b0a4817e8121f9e03fd86,6,30,57,87,12,2013-11-11 20:10:53,2013-11-11 20:09:26
4d1a537433ede2bbc75b0a4817e8121f9e03fd86...2c7f50a77dc281289387008b4a08656e7e5328be,4,54,38,92,16,2013-11-11 22:30:38,2013-11-11 22:30:38
2c7f50a77dc281289387008b4a08656e7e5328be...5d9723002bc764e2c768e5184994d7949f55fc49,15,158,52,210,31,2013-11-12 03:09:57,2013-11-12 01:17:38
81674fbbdf657de2c1d13b7c84a41c9edd3c8aa1...043a57617139dd4afefc2099e3bd85c8acaf0d68,1,22,1,23,4,2013-11-08 01:57:14,2013-11-08 01:57:14
43c7df946d56a9d9d0e0b7226042a0dd6a58a17b...aaefb8c07cc39735250b0304f73f8cb0e19662bc,2,8,21,29,7,2013-11-26 02:45:32,2013-11-26 02:45:32
aa48acc5ec6621a9fb720fa00772fb8eeaa2be7a...937f52aef98ac61bca75ef25c16b79b5fafa58ff,2,138,0,138,2,2013-11-25 22:24:23,2013-11-23 00:06:15
70b586702cb1715d4ff4dd7ffe356285df73b18e...d9b742419c48bfe57b16d7bf18915a9b31f3548d,1,1,1,2,1,2013-12-02 23:03:54,2013-12-02 23:03:54
0d3f4017cfa8cd77dd0122dfb23a6d192218c335...db7c55ba7f97358f3a6de2b83c8e3d1827667446,1,2,2,4,2,2013-11-29 22:13:00,2013-11-29 22:13:00
bb284ce59d661d9ec6e8dc9fd5b8fe21b588484b...ab35aef6b5b15c7c2d7aff4315025563b93ee379,1,37,0,37,1,2013-11-29 21:43:37,2013-11-29 21:43:37
750d2d8d07069c54c0fbddf4ccd2ba10e9ba9dc9...5242a49f3fe2c18ca38be4798869cdc7c306af22,1,4,71,75,2,2013-11-26 03:51:38,2013-11-26 03:14:33
377817db1b2fadf9c4294d8356aa7c75eb12e83a...597e0e69b4c8521f39691d0a07d1f31b7116a337,7,260,211,471,24,2013-11-28 20:16:57,2013-11-28 20:16:57
597e0e69b4c8521f39691d0a07d1f31b7116a337...ebc36b879d4197a9455b325b529da212539e180c,2,13,5,18,5,2013-11-28 22:33:18,2013-11-28 20:37:07
ebc36b879d4197a9455b325b529da212539e180c...b36dd3f9ccc61e42024cf1f2799c73f0efc77c75,1,5,1,6,1,2013-11-28 22:40:17,2013-11-28 22:40:17
b36dd3f9ccc61e42024cf1f2799c73f0efc77c75...d3cc558d140283a4ce051827705814cf4ca96f7a,1,24,0,24,1,2013-11-29 00:28:31,2013-11-29 00:28:31
d47d49a2f9bab4f6a68d61e0c1e52ef46f406e84...78d2e2dc373a30eed2bd9f9bb140aa1e153c00f0,1,7,2,9,3,2013-11-25 20:06:16,2013-11-25 20:06:16
b6dd67c70779d42dc36dd662becb247b79a7c083...5c5ee194cb383be42c0d0b9fc53114fa991de564,1,1,1,2,1,2013-11-26 06:06:22,2013-11-25 19:05:32
5c5ee194cb383be42c0d0b9fc53114fa991de564...de30ffb2c3b9aa86a5abd6a40b661cec247c6dbd,1,12,0,12,1,2013-11-26 06:06:22,2013-11-25 19:05:49
76910d16cc9e0d11bd60939d1855639fd2930362...32b9a429c5d36785a4a544d6e7236a95a4310983,1,1,1,2,1,2014-01-04 00:02:59,2014-01-04 00:02:59
64136071c6128fc759f1040186b06fee61d6aab6...20605eb310f0b57bd06eea80ec63c5022fc83bde,3,38,12,50,15,2013-12-17 00:30:23,2013-12-17 00:30:23
20605eb310f0b57bd06eea80ec63c5022fc83bde...69a31c33864abeaacbe9a07e50dd0cd8d406b15e,1,13,8,21,8,2013-12-17 00:35:56,2013-12-17 00:35:56
69a31c33864abeaacbe9a07e50dd0cd8d406b15e...379a7fab0717475353e3f6f4ac0ccbc13a55e86e,1,2,2,4,2,2013-12-17 15:55:36,2013-12-17 01:35:23
f4676f0ffa76576e5147994cead82ce19804158f...f379f667a22fd2916461654297169f70e3b39cf7,1,1,0,1,1,2013-12-08 22:39:06,2013-12-03 19:03:03
f4676f0ffa76576e5147994cead82ce19804158f...f832b76bdfafe3108af61d00171567da02482222,1,3,3,6,3,2013-12-08 10:06:02,2013-12-07 11:23:39
f4676f0ffa76576e5147994cead82ce19804158f...a80c059baeff0b7d563499e963059a183c7e1bd9,3,237,125,362,19,2013-12-08 06:06:05,2013-12-08 06:06:05
f4676f0ffa76576e5147994cead82ce19804158f...edace08327675967700a5ff8093ee3104a91772f,1,22,0,22,1,2013-12-08 01:47:03,2013-12-08 01:47:03
f4676f0ffa76576e5147994cead82ce19804158f...50f3a696bdfde5aed8f020fbac24af4c6c653ca9,1,0,1,1,1,2013-12-08 01:33:05,2013-12-08 01:33:05
50f3a696bdfde5aed8f020fbac24af4c6c653ca9...9656cdf0c248fda629fe9f13cf4ce4d3fabd35a4,2,24,11,35,9,2013-12-08 01:33:37,2013-12-08 01:33:37
39f21af6879bb69550084db4188985598beb3800...1fe1b216ad9b60f6b25a5dadda5fe26c3602b054,2,11,1,12,2,2013-11-28 23:25:50,2013-11-28 01:10:20
39f21af6879bb69550084db4188985598beb3800...438607ecc321a0256b7597cf278d4356632aac2f,1,8,1,9,2,2013-11-28 18:11:30,2013-11-27 23:49:40
39f21af6879bb69550084db4188985598beb3800...c226ab6d9edb6b74547348c309c633f207bd4aa4,1,31,0,31,1,2013-11-28 04:05:54,2013-10-23 16:19:15
39f21af6879bb69550084db4188985598beb3800...8b2a7e35c35f894dca0795a4fde9ec0cfe04ce43,4,27,3,30,4,2013-11-28 02:22:47,2013-11-28 02:22:47
39f21af6879bb69550084db4188985598beb3800...75e9cff98ce585ccd050a4014adb99d95509c9b7,1,1,3,4,2,2013-11-27 23:55:37,2013-11-27 23:55:37
39f21af6879bb69550084db4188985598beb3800...2c27da881807b6c63ef29e8033241a17c76f5ab7,1,11,10,21,4,2013-11-27 23:39:06,2013-11-27 23:39:06
7f9cdaa342a724dca42d3882e07c294ea972361c...d1a631cedb24c7c75affde7041d43217db64e5c0,1,6,1,7,2,2013-11-27 22:00:58,2013-11-27 22:00:58
a58fef9f134d5be5f3093502c0acf42f98a7d932...533067bba47acec0f65dc7e499944b9402bafb04,1,0,0,0,0,2013-11-28 18:37:03,2013-11-28 18:37:03
533067bba47acec0f65dc7e499944b9402bafb04...a990b3aeb9640d35e73f99030e03e58e71924ed5,2,3,5,8,3,2013-11-28 19:02:53,2013-11-28 19:02:53
a990b3aeb9640d35e73f99030e03e58e71924ed5...261bd0d187cbc8f650d77e5c93872332c290b164,2,69,62,131,23,2013-11-28 19:53:09,2013-11-28 19:53:09
a58fef9f134d5be5f3093502c0acf42f98a7d932...24c03b2d938d383dd7669dc8faad7e2110a11173,11,22,0,22,11,2013-11-28 03:12:51,2013-11-28 03:12:51
24c03b2d938d383dd7669dc8faad7e2110a11173...74ea136a49e78442c8ec14307bac8e171f5dc224,3,67,42,109,8,2013-11-28 03:23:48,2013-11-28 03:23:48
139644895e39fd452d0aa7b2835f4bdd0f2ec461...ba5268d382dec7b731717feec77b6e7d2e6cfdaf,2,3,2,5,2,2013-11-29 01:22:17,2013-11-16 10:49:42
139644895e39fd452d0aa7b2835f4bdd0f2ec461...8291d509c234779dff081ab579b6ff30358e7501,1,3,3,6,3,2013-11-29 01:19:26,2013-11-29 01:19:26
3d0486979e32c503625dbe96de625f7ebd29e2d6...ad43d88af5bda8dc5b3d06f64de380bb985191ba,4,13,13,26,13,2013-11-29 00:12:45,2013-11-29 00:12:45
ad43d88af5bda8dc5b3d06f64de380bb985191ba...77c94175bdc387e7f43876f7097b970f67116054,1,1,1,2,1,2013-11-29 00:57:51,2013-11-29 00:57:51
77c94175bdc387e7f43876f7097b970f67116054...e535f544c7bc9c32b23e5505110a5513ff36be5a,1,11,2,13,2,2013-11-29 15:39:51,2013-11-29 15:39:51
e535f544c7bc9c32b23e5505110a5513ff36be5a...fbebe20bc69648c046e3818ca744ae246092a782,1,15,0,15,2,2013-11-29 15:40:44,2013-11-29 15:40:44
fbebe20bc69648c046e3818ca744ae246092a782...67e9e0e11bb932ef9113ac91b2c1b0af6ee4db6d,1,12,0,12,2,2013-11-29 16:29:56,2013-11-29 15:42:26
67e9e0e11bb932ef9113ac91b2c1b0af6ee4db6d...63d6cbe3e4d6f29c2491b0f1f505ef79b7191d8e,2,11,5,16,4,2013-11-29 17:11:20,2013-11-29 17:11:20
63d6cbe3e4d6f29c2491b0f1f505ef79b7191d8e...aa68656cd3aefe2a64dc259e8d19c72010e4f85b,1,12,1,13,4,2013-11-29 17:52:44,2013-11-29 17:52:44
aa68656cd3aefe2a64dc259e8d19c72010e4f85b...c13821ad0bfa596a8bbc06a494500ee39a35e429,1,13,8,21,3,2013-11-29 17:55:15,2013-11-29 17:55:15
c13821ad0bfa596a8bbc06a494500ee39a35e429...697be6aaa009cd2bea5f07ae0b0780703e6565e1,1,44,22,66,3,2013-11-29 18:02:22,2013-11-29 17:57:59
697be6aaa009cd2bea5f07ae0b0780703e6565e1...2e6a958612d65a0665a9396372fe82706987d085,1,8,6,14,4,2013-11-29 18:03:36,2013-11-29 18:03:36
2e6a958612d65a0665a9396372fe82706987d085...2ec1146679598837cd8bab62dc672bcda2a9610c,1,1,19,20,2,2013-11-29 18:17:04,2013-11-29 18:17:04
2ec1146679598837cd8bab62dc672bcda2a9610c...86c00be180f1e6831ca426576a55f5106f156448,1,23,24,47,15,2013-11-29 18:17:25,2013-11-29 18:17:25
86c00be180f1e6831ca426576a55f5106f156448...34353e782e1cdbd6aae078b3e660875e703d35ff,2,3,3,6,3,2013-11-29 19:08:01,2013-11-29 18:32:52
0c758e93127d5575caa7042d01804f77b9f76b0c...2bbc90e92ff140c29891e92c9ce320ca7d19cd57,1,4,0,4,1,2013-11-28 20:24:04,2013-11-28 20:24:04
5e363072f54ec1cf0fdb7feb70cdce38622dcbe0...0ad35c67462ce3343b99d40ea78755d2ad92a754,1,10,20,30,10,2013-10-18 07:09:13,2013-10-18 07:09:13
a8e99d923507e245f933599c94a061bfdc375452...7a94cdf8edd917899a38a58917cd4439652047a1,1,25,2,27,4,2013-12-05 21:32:15,2013-12-02 17:03:21
a8e99d923507e245f933599c94a061bfdc375452...f95f2789f274f3d98ea77cd6c10b899aa3db2dc6,2,10,3,13,4,2013-12-05 18:12:22,2013-12-02 21:55:31
f9147effac69e9746b6aae5af9d37bf437aa6c2d...58b75f8f29b5fff388ec3d8d84249e122462c137,1,26,1,27,2,2013-12-06 02:08:56,2013-12-06 02:08:56
f9147effac69e9746b6aae5af9d37bf437aa6c2d...aea7418d8ac73f072a47affcaab04831c2f43bc2,1,0,1,1,1,2013-12-06 02:03:47,2013-12-06 02:03:47
ea0ed9a9159de98c444c6a83649ae2eb51da1c84...4bea68dfa6a9c68232ff7a5c36c85fc827dae938,2,7,4,11,3,2013-12-06 01:16:31,2013-12-06 01:16:31
2586c042ae676686eca41bedf5ea6f6d2530e908...110c4f20434af89d81580670f2cec25b1e82633a,2,45,7,52,8,2013-11-26 04:21:54,2013-11-25 22:42:22
2586c042ae676686eca41bedf5ea6f6d2530e908...0d1b5d767648ee6200a816786e51d23917bf0218,1,18,11,29,9,2013-11-26 03:58:14,2013-11-26 03:58:14
7cad77b1e2d0b8af5dcadce0599fc83cbe1970f4...4908d7f81db91f4a28be152ec0cacb0cf711b403,2,11,2,13,4,2013-11-15 06:53:59,2013-11-15 06:52:08
7cad77b1e2d0b8af5dcadce0599fc83cbe1970f4...29fa1b6666f28e7f42e92a10d195823fa84b7622,1,8,0,8,2,2013-11-15 05:23:23,2013-11-13 00:59:37
24586d7af522e8d13ea0363437b4062aeb77cf70...1b28cdc7f977f265d0d8de53e8ec1d773ed54db1,6,33,2,35,8,2013-11-20 18:31:51,2013-11-19 10:32:08
24586d7af522e8d13ea0363437b4062aeb77cf70...7192be47c5a787094c6450b904622159c85b70de,1,12,7,19,8,2013-11-20 13:42:32,2013-11-20 13:42:32
7192be47c5a787094c6450b904622159c85b70de...cfdc284abee59057d6c6f7bc751d5648d8f8688e,1,1,0,1,1,2013-11-20 13:52:06,2013-11-20 13:52:06
263d134fff83f90eed5b706d8ddb39e7e36efe32...15209c380c3f510e3f8d5ba1ff5fcc5cc8db3357,2,13,1,14,2,2014-05-07 16:59:55,2014-05-07 01:03:41
14e1a2345d606290ba9405a1b813e3f4bb9c2df1...e3e078ca2fc4ce76461a40533add9f33afcd1abe,1,25,0,25,2,2014-04-11 22:37:17,2014-04-11 21:42:53
e3e078ca2fc4ce76461a40533add9f33afcd1abe...0f724863468733847306f47835739f480a7fac63,1,9,0,9,1,2014-04-11 22:37:18,2014-04-10 22:47:53
14e1a2345d606290ba9405a1b813e3f4bb9c2df1...c5226d94fab4e261fe2407262d9b5177326d4062,2,10,1,11,2,2014-04-10 13:07:29,2014-04-10 13:07:29
14e1a2345d606290ba9405a1b813e3f4bb9c2df1...e625cee28dc62d7fbc5172e0e9c01708e2bd7fc4,1,48,12,60,15,2014-04-10 12:52:46,2014-04-07 07:00:01
14e1a2345d606290ba9405a1b813e3f4bb9c2df1...7931be5cba784b36a145af7ed0153ade6474dabd,1,3,3,6,3,2014-04-10 11:46:42,2014-04-10 11:43:25
b602d6ca40c21622bcdbea32656ad0b6030c179b...a43a600a2cb516813a045e3b90e8a9ae81d8a783,1,2,6,8,7,2014-04-09 02:17:30,2014-04-09 02:17:30
b602d6ca40c21622bcdbea32656ad0b6030c179b...1e6f21dc9e7b172b28d364741abb92540938c51a,1,57,69,126,17,2014-04-09 01:14:47,2014-04-09 01:08:20
e7f91a6456dd8c3bb48ac23165607057c193c49e...31dde3ea05e1cf4c1f45083c1b6129e8c2a362df,5,22,18,40,19,2014-02-13 11:54:37,2014-02-13 01:26:35
e7f91a6456dd8c3bb48ac23165607057c193c49e...a895c7238d3f32b22989c409a5a3b09aa3463054,1,5,2,7,1,2014-02-12 23:23:42,2014-02-12 23:23:42
1a12e9fbc665833a96a3b98bef2cf33d2cda4642...e634f2394085d5dc7e716553b330acb8694bf6d3,1,1,2,3,1,2014-02-06 18:12:57,2014-02-06 18:12:57
22aeae34c1d257956e6201697e30dd64028a1182...15711ed670e8ab59611030ea1191189ad495ea63,1,1,0,1,1,2014-02-06 20:04:35,2014-02-06 19:34:25
22aeae34c1d257956e6201697e30dd64028a1182...25d87553f678e247b3036db7804599624191dfd1,1,52,0,52,1,2014-02-06 19:59:29,2014-02-04 02:44:28
9dd92a9823d7021c20a8c3f596fe2c68129bf6a6...1f6000eaa0d571d34e2c9207692fb82c4a022061,1,6,2,8,2,2014-02-06 09:06:25,2014-02-06 09:06:25
9dd92a9823d7021c20a8c3f596fe2c68129bf6a6...f5d028c83868082049994ad544c99291a117797d,3,100,0,100,3,2014-02-06 00:37:33,2014-02-01 12:39:11
31a1a815c4f3a9a651c3c87bebaead252c147874...82863aecab824118e223b53fed905ed5fd9182bb,1,12,0,12,1,2014-02-11 04:58:42,2014-02-11 04:58:42
31a1a815c4f3a9a651c3c87bebaead252c147874...5051b8610d7802db2d479cfba14009552a95789f,1,12,0,12,1,2014-02-11 00:10:50,2014-02-11 00:10:50
31a1a815c4f3a9a651c3c87bebaead252c147874...f787bec4a6853b46b1ba755d4f8a2ee07d9cbd3e,1,6,1,7,2,2014-02-07 10:20:41,2014-02-07 05:21:33
31a1a815c4f3a9a651c3c87bebaead252c147874...f289b3a19e03b99a6618009320abaec2c0cf1ec1,3,16,0,16,1,2014-02-07 08:29:14,2014-02-07 08:22:10
f289b3a19e03b99a6618009320abaec2c0cf1ec1...ac06646b1fb7172937c52d5f1217dcac5a86f0f9,1,4,4,8,4,2014-02-07 08:30:11,2014-02-07 08:30:11
31a1a815c4f3a9a651c3c87bebaead252c147874...b2945f27767f35a273feb6e255945f3e1f6108d2,1,1,0,1,1,2014-02-07 07:10:47,2014-02-07 07:10:47
c4b0eedc9276fe8ee883fa28831ae234b92c7e16...e1d8543c7889c1bf456641fa1ee5f676820076b6,4,78,74,152,31,2014-01-16 01:11:44,2014-01-08 22:05:05
ebaa92b20879339e66bfd995a340a235cfb25046...e71dbf4ee5add5736f595948fc20bd01af56a744,14,1558,206,1764,98,2014-01-18 01:33:15,2013-12-23 19:43:54
ebaa92b20879339e66bfd995a340a235cfb25046...3ff5f2374cf7d68c0905840a571c521d79c7e091,1,29,91,120,1,2014-01-18 00:57:43,2014-01-18 00:57:43
dc359e07d3d48202c7fe6168bd6cf5ab5b2725e9...980e0bf52c15bdf179c58b2d4f1085e26f8a3e2a,2,7,2,9,3,2014-01-18 17:41:37,2014-01-18 17:37:27
dc359e07d3d48202c7fe6168bd6cf5ab5b2725e9...455495f7caf1bf2ff9ea1364bbf2362d9737b54c,1,29,45,74,18,2014-01-18 02:54:02,2014-01-18 02:54:02
4e08bb56299b6894f93557602a533ca95b58b81f...5d71ad8b192e4e4b41c58ff3eae10c0d8ccdec71,1,3,3,6,3,2014-01-23 20:55:58,2014-01-23 20:55:58
de8480f6567778516a371fa8405df0409181cc32...4dab34c2045b7bcc735227867126f0796cbb09c1,1,1,0,1,1,2014-01-30 01:42:32,2014-01-30 01:41:21
0c8ddd502e90d5e35c04179f98f29fc4550af5c9...8e619e13ca3906e849944a4b015b676b93c9f145,1,1,1,2,1,2014-01-30 21:53:32,2014-01-30 21:53:32
4a96c329c0f874908b64fe7ca18dfc24f78e2bd2...564e6bc7802b606d829a498eee0c2bb8ce4032e1,6,99,69,168,31,2014-01-24 22:55:11,2014-01-17 02:40:33
564e6bc7802b606d829a498eee0c2bb8ce4032e1...177f6588824de5a489f0b31a2cf053c3cdf0bb0e,3,11,30,41,8,2014-01-24 22:57:18,2014-01-20 22:10:23
177f6588824de5a489f0b31a2cf053c3cdf0bb0e...f41e0cf0485eac21d65c1af19a732b350292d200,4,30,42,72,23,2014-01-24 22:59:46,2014-01-22 01:56:09
4a96c329c0f874908b64fe7ca18dfc24f78e2bd2...ec73c232318a3dae803a27a6922f0af7117eec6e,5,299,456,755,39,2014-01-23 22:39:10,2014-01-23 22:39:10
43bcbf06a663c5d8cac63f2af8fefef7edc5513a...18df387bf8a4a1419b6d3267a4e0551ff72b0f88,1,16,1,17,3,2014-01-23 01:12:28,2014-01-23 01:12:28
43b7667dccc4a08cf12a17548df359e0ba118ae1...c8d1596902704076c8d85a30e80f90f8efb3e175,1,6,1,7,2,2014-01-30 19:27:45,2014-01-30 19:27:45
bbfc531b51cb17e97022ff0e904f91faac48713f...8458f99a387ae70cfaa1e43759919fe414c55505,1,1,1,2,1,2014-01-28 21:50:03,2014-01-27 20:16:45
bbfc531b51cb17e97022ff0e904f91faac48713f...abbae8f76481701ed8147aefdb6e2ce82e130f4c,1,12,6,18,2,2014-01-27 23:31:04,2014-01-27 20:51:31
f87a67a3a85189756ece90cd7ac5eef2c0ad51a8...2e094db6390dde57263c07665290b1477bb6df7e,13,4,4,8,4,2014-01-20 18:59:29,2014-01-20 18:52:26
5d9723002bc764e2c768e5184994d7949f55fc49...7301fbe035ca450e2aea86b8f2467cffd3fac18b,1,2,1,3,1,2013-11-12 19:48:35,2013-11-12 19:48:35
3aaef96e3677a08aa3ca175941afcc867c1aab7c...05d70cbcf4ebf30b11d54a177e47649e4e229403,3,113,82,195,27,2013-11-14 00:46:10,2013-11-14 00:46:10
9afe475edb190af53dc57e9db4522d73e7562ad5...1764cf1990791dd15636f6e906960ad43d5689ad,1,0,6,6,1,2013-11-08 02:13:11,2013-11-08 02:13:11
1764cf1990791dd15636f6e906960ad43d5689ad...99210c9c6efbe10df922faa66fa3232ab898ef7b,3,39,2,41,4,2013-11-08 02:48:52,2013-11-08 02:48:52
99210c9c6efbe10df922faa66fa3232ab898ef7b...1e5c61041f54de1146d8edb44e85b9419f4f6342,1,2,2,4,2,2013-11-08 02:49:08,2013-11-08 02:49:08
1e5c61041f54de1146d8edb44e85b9419f4f6342...8c21d2acd33c2bbaba224e19fbef30a3ba8788df,1,16,6,22,5,2013-11-08 02:49:32,2013-11-08 02:49:32
d9b742419c48bfe57b16d7bf18915a9b31f3548d...d526038503d59481965f6614c05ec6acb534b986,1,2,1,3,1,2013-12-15 14:17:16,2013-12-15 14:17:16
82cecb34b5363f7c9ee1ba3a40eb283d51b9b482...a6c9a332d040a98c5cf4325491fc8d9aa7e5475b,6,52,52,104,13,2013-11-30 00:53:20,2013-11-30 00:53:20
a6c9a332d040a98c5cf4325491fc8d9aa7e5475b...e8437e8fcffae3661b9decdc1c576083c0de5219,1,3,2,5,3,2013-11-30 03:02:09,2013-11-30 03:02:09
e8437e8fcffae3661b9decdc1c576083c0de5219...fea432bdf542a469ae9b5b114b6858a7bc56b323,1,2,2,4,2,2013-11-30 18:28:52,2013-11-30 18:28:52
82cecb34b5363f7c9ee1ba3a40eb283d51b9b482...65db62619c8ae61c9735cb2a433adac7731256a5,1,4,8,12,2,2013-11-30 00:45:20,2013-11-30 00:45:20
82cecb34b5363f7c9ee1ba3a40eb283d51b9b482...a4f8a2494b0fb755db52c68cf61ddc8ff52d2965,12,290,154,444,64,2013-11-30 00:25:46,2013-11-20 07:37:03
a4f8a2494b0fb755db52c68cf61ddc8ff52d2965...3553a803e3a474207296f5542182ecbc569ca1d8,3,379,0,379,4,2013-11-30 00:25:46,2013-11-20 07:38:59
3553a803e3a474207296f5542182ecbc569ca1d8...35d54c665575d48954db9422702c0324f00ebc62,2,23,1,24,3,2013-11-30 00:25:46,2013-11-22 02:28:56
82cecb34b5363f7c9ee1ba3a40eb283d51b9b482...fe72f15e4ab25cc6e96c76d2da2c379569756843,3,29,29,58,5,2013-11-30 00:20:59,2013-11-30 00:20:59
82cecb34b5363f7c9ee1ba3a40eb283d51b9b482...a37b155384401e8b2bed635251440b0feb6bcdbc,1,1,1,2,1,2013-11-29 23:14:36,2013-11-29 23:14:36
5ff74e268d7dfddfa928d00221763b05d2cbfd61...59f76bf1c707c01ea548c4f3f2fdfba74c764e63,4,19,20,39,12,2013-11-26 05:16:30,2013-11-26 05:16:30
4b35c1b6a6167a0dce11cd748c94598199dce942...9837ad8e9b96b118e8d004e773a05ff9dd208b48,1,40,10,50,9,2013-12-02 19:07:41,2013-11-27 23:07:15
9837ad8e9b96b118e8d004e773a05ff9dd208b48...1d503be4660667a27b42f7bf0c089404cabd2c9c,1,1,1,2,1,2013-12-02 19:07:41,2013-11-30 00:12:10
1d503be4660667a27b42f7bf0c089404cabd2c9c...4ad3dfb05f1932793cae5c8047a89660747b95b4,1,48,0,48,1,2013-12-02 19:07:41,2013-11-30 00:36:50
32b9a429c5d36785a4a544d6e7236a95a4310983...3069bf946047e42b4aa468617caffb45829317b6,1,1,1,2,1,2014-01-04 05:54:48,2014-01-04 05:54:48
1acefac97eafdb8e701763da8616b607be4f0510...1940015824f5dabf1e8ffbd0c2b7c09f11f8cdf0,1,1,1,2,1,2013-12-18 01:17:06,2013-12-17 02:15:51
1940015824f5dabf1e8ffbd0c2b7c09f11f8cdf0...3ec39ad01a5823acbb3c4ce49ce5c81258a60815,1,5,4,9,2,2013-12-18 01:17:50,2013-12-17 02:17:22
3ec39ad01a5823acbb3c4ce49ce5c81258a60815...c06ab5f9c237a647120b9b3cc433e094676fe75a,1,48,0,48,1,2013-12-18 01:19:23,2013-12-18 00:57:14
945a1f06f9666313b4e5cfd7579952f2c5074cfe...746ae155fb5a17c9f31873ad6d387b58574849ba,4,32,21,53,15,2013-12-17 02:36:35,2013-12-17 02:36:35
746ae155fb5a17c9f31873ad6d387b58574849ba...efc0610c0eec78850e0fc1e4f09bb294693a31e5,5,103,22,125,13,2013-12-17 18:39:22,2013-12-17 18:39:22
5875953d9be0bf3339185dd6b5c4b1e185eb85b6...d2d8a4a6c507bc8e7d591925276d79d89ce6beaf,1,6,4,10,4,2013-12-24 18:01:59,2013-12-24 18:01:59
5875953d9be0bf3339185dd6b5c4b1e185eb85b6...4100e9b7df5cbce855b47b3625d34c9667e40dc1,4,120,52,172,17,2013-12-24 06:55:06,2013-12-24 06:31:53
b7bc80cba90ecfe75cd621f3d437e63e3ec3fd5d...c9cedb4c0484c3e1879495ab5c02088ae738763e,1,14,12,26,10,2013-12-10 00:47:19,2013-12-10 00:47:19
a80c059baeff0b7d563499e963059a183c7e1bd9...a7a171b6c2916b7be3fa51c9465516acb68c3e32,2,47,0,47,2,2013-12-08 06:16:10,2013-12-08 06:16:10
0025e9bd719b1cd8314543019ed8e6f6bc5c57cd...be137350018608bf4a1fd01ce956f166c39988c4,1,15,4,19,3,2013-12-11 01:12:11,2013-12-11 01:12:11
0025e9bd719b1cd8314543019ed8e6f6bc5c57cd...27646c445951b47a728675764d7ef2b198436156,3,4,4,8,4,2013-12-11 00:14:56,2013-12-11 00:14:56
8cc524996a0d29a5b11a14ef17950193d45c1e05...de4429f70d51056c3ec32072f3f18898e36171b3,2,63,35,98,19,2013-12-02 19:43:41,2013-12-02 19:43:41
de4429f70d51056c3ec32072f3f18898e36171b3...6ea3b9651b3793e31a320926472ff23383a7b915,2,4,2,6,3,2013-12-02 19:47:13,2013-12-02 19:47:13
6ea3b9651b3793e31a320926472ff23383a7b915...5cd09dc1158c62754641dce9c59a735c41e59722,1,11,8,19,3,2013-12-02 19:49:11,2013-12-02 19:49:11
5cd09dc1158c62754641dce9c59a735c41e59722...98ed1dc433e423b93ae0619c5a2c474ccec1454d,1,3,3,6,3,2013-12-02 20:51:37,2013-12-02 20:51:37
597ca192e720821dfdf94b3b8d0bec74bee63ee7...9f46779d42c9b90a70c3c434d03a4502070e1b6d,1,14,1,15,3,2013-11-28 18:46:58,2013-11-19 19:25:17
597ca192e720821dfdf94b3b8d0bec74bee63ee7...d47507791e14908e78cf38d415a9863c9ef75c5e,1,1,8,9,2,2013-11-28 16:43:28,2013-11-28 16:42:29
597ca192e720821dfdf94b3b8d0bec74bee63ee7...bdfe8ed403591022ac46371798783c7bbe6134c9,1,2,2,4,2,2013-11-28 15:42:06,2013-11-28 04:14:34
597ca192e720821dfdf94b3b8d0bec74bee63ee7...f1e44e0b0c6eff011c596008c75f7fdff09dbf5e,1,0,2,2,1,2013-11-28 14:55:15,2013-11-28 14:55:15
d8ee08ba7b5885352641b8ec6a9b427fb9bef62f...5c5f6709017575b0b090cb5f76b75e7e733ffa2b,2,4,4,8,3,2013-12-01 22:11:10,2013-12-01 22:11:10
d8ee08ba7b5885352641b8ec6a9b427fb9bef62f...39aac21db47b3bcbf651008267ad1142f1213103,1,14,25,39,14,2013-11-30 15:58:52,2013-11-30 15:58:52
20899cdb34e6cd491e5c4c6830f1c53ddf64ad53...51e2c1794b50295607c6eddb29edf39d40816a88,5,72,60,132,20,2013-12-14 00:15:15,2013-12-11 18:35:21
51e2c1794b50295607c6eddb29edf39d40816a88...85b9338205da0c8f1d62f277db342cf4b9feaf13,5,34,23,57,12,2013-12-14 00:29:22,2013-12-12 21:35:50
066b961a0cf93c5edd0cd4084029e2027c1ab483...f49eb29497620de597f4690a29957f44341f3673,1,5,7,12,6,2013-12-05 20:03:17,2013-12-05 20:03:17
f49eb29497620de597f4690a29957f44341f3673...61fbf3d8e27541882ff7c446a7f0edfb4ed03d82,1,1,7,8,1,2013-12-05 20:21:03,2013-12-05 20:21:03
61fbf3d8e27541882ff7c446a7f0edfb4ed03d82...5d022f04453d3bac2e17b8622f013420778e8d5b,1,5,0,5,2,2013-12-05 22:08:08,2013-12-05 22:08:08
5d022f04453d3bac2e17b8622f013420778e8d5b...7ab4f37d6084c98e1f725be4cc88ea76bf952eb7,1,4,1,5,1,2013-12-05 22:11:33,2013-12-05 22:11:33
066b961a0cf93c5edd0cd4084029e2027c1ab483...03f8a3bbae5bfc0f43e1b3a2852d1557b21c5848,1,20,0,20,1,2013-12-05 18:46:15,2013-12-03 22:48:19
5f5949f6a695cd0e80275d95872580ededa46a81...a015f38f4a886518828fe3807ee7dc9ff8ab9585,1,8,1,9,2,2013-12-06 16:13:47,2013-12-06 16:13:07
5f5949f6a695cd0e80275d95872580ededa46a81...02ef8ec3ca1a9b16b905b671ade74cf24d11bb3a,1,21,12,33,6,2013-12-06 15:47:24,2013-12-06 15:47:24
5f5949f6a695cd0e80275d95872580ededa46a81...a69bb25820df8951151c8c6cb5952ba5496463db,1,37,0,37,1,2013-12-06 07:54:23,2013-12-06 07:43:54
4bea68dfa6a9c68232ff7a5c36c85fc827dae938...25d3db048e761ee2c61a2cc8d58196786616988b,2,12,3,15,6,2013-12-06 09:18:18,2013-12-06 00:22:49
09b7b55e2c29c2106633d11f887e55d087fc70c6...fb3d60f27adba32ab60022298702a4376c1f4d0d,4,292,308,600,11,2013-11-26 05:05:15,2013-11-26 04:04:57
fb3d60f27adba32ab60022298702a4376c1f4d0d...a93731374705188f1434001dd1deaf4af9c77fcd,1,3,0,3,1,2013-11-26 05:05:15,2013-11-26 04:48:03
a93731374705188f1434001dd1deaf4af9c77fcd...02cb7f45fa6f9a8899286431fa68bf1a9d0194d8,1,15,1,16,2,2013-11-26 05:05:15,2013-11-26 04:48:34
02cb7f45fa6f9a8899286431fa68bf1a9d0194d8...23022932440006aca0a954763bf8e3a5882f94d3,1,1,2,3,2,2013-11-26 05:28:00,2013-11-26 04:54:34
fb245f79038294a1a3ea51f47ce2e62ffad6b5d1...035c1442424ee502118cdbf2ee2dddafcc0f01cd,16,2,2,4,2,2013-11-15 23:48:24,2013-11-15 23:48:24
035c1442424ee502118cdbf2ee2dddafcc0f01cd...cbd1281ec998e017b579c13ee6262aa21c96c38a,8,14,14,28,14,2013-11-15 23:55:45,2013-11-15 23:55:45
6640f46f0ea718a173504018d79248d58f2d2dc1...fb99f992c081a1d433c97c99ffb46d12693eeb76,2,6,1,7,2,2014-05-08 00:29:56,2014-05-08 00:29:56
b68e0078c218ef1d8f993da668582e8ac0cb630b...1ed63f1d16669dc2ce7eb75f3d56ea8a5c27ab39,1,1,1,2,1,2014-05-07 18:38:02,2014-05-07 18:38:02
566d49c9cafd5e64024e67d2ff1ebbcad6332cbf...057d347eafaea9a0044b70e516ace504904a5ba4,1,24,0,24,2,2014-04-10 07:48:36,2014-04-09 09:27:04
566d49c9cafd5e64024e67d2ff1ebbcad6332cbf...59c1b2880be8fb9d9a632fa42a10097c1580591a,3,35,1,36,5,2014-04-09 13:44:18,2014-04-09 13:41:14
7c37cae17d675aa72a2146e881aaa7e30f8d291e...18bea2495d0bcc354a2538cb161081cb56e5c6f7,1,10,0,10,1,2014-04-09 22:13:41,2014-02-28 22:45:56
18bea2495d0bcc354a2538cb161081cb56e5c6f7...66baf56601f4fc1e8f5f2863d227283954b73a77,1,1,1,2,1,2014-04-09 22:13:41,2014-03-21 05:31:39
66baf56601f4fc1e8f5f2863d227283954b73a77...1c90a4dd9a83526ca3837ab9231ff6a9af07e072,3,89,1,90,3,2014-04-09 22:34:37,2014-03-20 15:52:00
7c37cae17d675aa72a2146e881aaa7e30f8d291e...b298960aed8155e7dbedb6602cdbb42eacee83f7,9,9,10,19,14,2014-04-09 18:11:06,2014-04-08 04:14:19
7c37cae17d675aa72a2146e881aaa7e30f8d291e...986cf931c38b8cdc51da44af0313502ca1156cfc,1,1,1,2,1,2014-04-09 10:53:32,2014-04-09 10:53:32
7c37cae17d675aa72a2146e881aaa7e30f8d291e...87f0d63fb2ede63d263d8e8285b83a7f7d12bbf3,3,10,5,15,6,2014-04-09 10:22:17,2014-04-09 10:22:17
3c7206b9910935dcc4225b89e27ddc68da684f83...6f70ed3a742162c4cf374a2c2bbd094eed3b043b,3,25,42,67,6,2014-03-10 22:14:37,2014-03-10 21:23:29
ba3cbeb86bafbb6d7553f8954b0bf8d1e2d3f97f...e2da84ee63b759173d4919481eeb0c3ddf58cfb5,1,3,3,6,3,2014-02-19 01:35:58,2014-02-19 01:35:58
989fee2490b0d4ed6fd76e668ace6769f7d908ee...ba650e05177bcc2597606b998a104a29698d5064,1,1,1,2,1,2014-02-13 02:13:46,2014-02-13 02:13:46
989fee2490b0d4ed6fd76e668ace6769f7d908ee...2a17bdce9e6e25e9be225fede7aac0b12729d82f,1,10,0,10,1,2014-02-13 02:11:01,2014-02-13 02:11:01
6f10f33387becb3a8470f9f65706d0df919b7e9b...4611a6bdd3270e4a404cae2d23c54dd94521c4ae,1,41,22,63,19,2014-02-13 19:21:27,2014-02-13 19:21:27
4611a6bdd3270e4a404cae2d23c54dd94521c4ae...0b403b35318a68d848bd9d7cddcf850d2fa7bfa7,1,2,0,2,2,2014-02-13 19:24:40,2014-02-13 19:24:40
8228e50581faadfb1626fa18b50cc7a6309d6b43...49b928c0b05852b58881ce8ebdb164db92befd3a,1,20,5,25,6,2014-02-11 23:26:12,2014-02-09 13:05:19
8228e50581faadfb1626fa18b50cc7a6309d6b43...eab270395e5b47b16a41c54ec6e1427f8144bffc,1,18,5,23,2,2014-02-11 11:47:59,2014-02-11 11:47:59
eab270395e5b47b16a41c54ec6e1427f8144bffc...6128dcea4a9bbe808baba4e18c9c4fee3a265532,1,12,28,40,8,2014-02-11 12:02:00,2014-02-11 11:55:40
8228e50581faadfb1626fa18b50cc7a6309d6b43...02fddffd51da782f912e2709ea814c330269515b,1,1,0,1,1,2014-02-11 10:17:34,2014-02-11 10:10:55
8228e50581faadfb1626fa18b50cc7a6309d6b43...eb4578daee98561b16d11d2978b5f5e297d903e8,1,8,1,9,3,2014-02-11 08:42:34,2014-02-11 08:42:34
8228e50581faadfb1626fa18b50cc7a6309d6b43...2343fe44533f19ebae5e6127f4a2a19d1d8773fa,1,11,1,12,2,2014-02-11 08:40:13,2014-02-11 08:40:13
8228e50581faadfb1626fa18b50cc7a6309d6b43...44821158409d59024173336188e087c605e1da1a,1,1,3,4,1,2014-02-10 19:04:24,2014-02-10 19:04:24
8228e50581faadfb1626fa18b50cc7a6309d6b43...d3d85d38fb5bdd0327fdc9fe8b637cb0f4e1dcf2,1,13,0,13,1,2014-02-10 01:21:01,2014-02-10 01:21:01
8228e50581faadfb1626fa18b50cc7a6309d6b43...95bcb8924ac2cbe0fb625a604d2c6d5a8e2fa06a,1,1,1,2,1,2014-02-09 21:36:04,2014-02-09 21:36:04
8228e50581faadfb1626fa18b50cc7a6309d6b43...0cba91e26447e14260f111bef6d3745d2dd55444,1,14,1,15,2,2014-02-09 09:43:46,2014-02-09 09:43:46
8228e50581faadfb1626fa18b50cc7a6309d6b43...695719b29a6311a56faae0c6ed3c985b7a75add0,1,1,1,2,1,2014-02-09 06:29:28,2014-02-09 06:25:34
8228e50581faadfb1626fa18b50cc7a6309d6b43...72c72f91c621d9dd2431eee01a28a4ca490588bc,4,52,60,112,9,2014-02-08 18:34:11,2014-02-08 18:34:11
8228e50581faadfb1626fa18b50cc7a6309d6b43...7c06d5e34e2ebf5006ce3a34438f18c071153e97,1,2,1,3,1,2014-02-08 03:09:52,2014-02-08 03:09:52
0b7d4c855d8fba3448be8a854257e37eb86c6276...1669b802cc3e7ce30f05e61630542c88696bbca1,4,62,27,89,17,2014-01-16 01:12:48,2014-01-15 22:43:12
a823d7967ff7d456954351b173736c65b9d75ef6...1ceb049118e16367c2f4015e61657f03d0eb8e29,2,190,0,190,2,2014-01-18 01:42:21,2014-01-09 02:47:57
1ceb049118e16367c2f4015e61657f03d0eb8e29...203b69c8c907b9cf57c887774b6f492d405a0621,2,222,60,282,32,2014-01-18 01:42:21,2014-01-09 23:04:45
203b69c8c907b9cf57c887774b6f492d405a0621...f2680e5a5b1fc2393dfe319fe4dd197672985411,4,78,135,213,36,2014-01-18 01:42:21,2014-01-10 00:03:22
f2680e5a5b1fc2393dfe319fe4dd197672985411...25a26977173632b5966838d910550a921ef5a853,3,16,51,67,11,2014-01-18 01:42:21,2014-01-10 02:48:34
25a26977173632b5966838d910550a921ef5a853...5573c744e4be16f39e1491188c4d4ff43f61d549,3,25,69,94,18,2014-01-18 01:42:21,2014-01-10 19:44:35
5573c744e4be16f39e1491188c4d4ff43f61d549...1c1cf54b0aa44553b714b82a1960b4f1199ac33a,2,1,1,2,2,2014-01-18 01:42:21,2014-01-10 19:58:34
1c1cf54b0aa44553b714b82a1960b4f1199ac33a...5a3d9bd432fdaa95f870d4d99fad1d6fafeaad92,4,57,50,107,32,2014-01-18 01:42:21,2014-01-10 22:26:29
5a3d9bd432fdaa95f870d4d99fad1d6fafeaad92...8e87835968a4c6233406061759e3dca03ab86989,4,29,54,83,22,2014-01-18 01:42:22,2014-01-10 23:06:16
8e87835968a4c6233406061759e3dca03ab86989...8b60273f76723897a9831ca125500ede85e05b5d,2,11,6,17,7,2014-01-18 01:42:22,2014-01-10 23:34:03
8b60273f76723897a9831ca125500ede85e05b5d...ad9710685ca3ae101c84a57c7d68a25cba4bede2,3,11,5,16,5,2014-01-18 01:42:22,2014-01-11 00:11:19
ad9710685ca3ae101c84a57c7d68a25cba4bede2...381d593d04fc46dac5b202d047981e15183c5ed1,1,17,12,29,2,2014-01-18 01:42:22,2014-01-11 00:18:15
381d593d04fc46dac5b202d047981e15183c5ed1...77936ba1a1ff404b75ae8a34c6d4e280c23d9144,2,6,3,9,5,2014-01-18 01:42:22,2014-01-11 01:25:32
77936ba1a1ff404b75ae8a34c6d4e280c23d9144...66782730b85db20600ce48fcab203a5eb43bcb02,1,1,1,2,1,2014-01-18 01:42:22,2014-01-11 01:41:12
66782730b85db20600ce48fcab203a5eb43bcb02...93ead2fe789a3a94a8433b12efcca782e0a7d7de,6,74,106,180,33,2014-01-18 01:42:22,2014-01-11 02:09:07
93ead2fe789a3a94a8433b12efcca782e0a7d7de...1d8455e6838f2630221eb3fcafeb382f9f7ce260,4,41,39,80,10,2014-01-18 01:42:22,2014-01-11 02:21:41
1d8455e6838f2630221eb3fcafeb382f9f7ce260...8e0741f5e40d107780a5be1f6ae0f4d30ba43d7d,6,116,42,158,10,2014-01-18 01:42:22,2014-01-11 04:22:39
8e0741f5e40d107780a5be1f6ae0f4d30ba43d7d...92e6db7beba8ad58e425119cc9885c355a5755e7,5,41,10,51,24,2014-01-18 01:42:22,2014-01-13 19:13:49
92e6db7beba8ad58e425119cc9885c355a5755e7...f846ecdc77bb9ab4d44b41a2e403bcf579d6b6e9,5,82,53,135,36,2014-01-18 01:42:22,2014-01-13 23:02:12
f846ecdc77bb9ab4d44b41a2e403bcf579d6b6e9...1e81387edcab600c9b8bc2a502988f7b3a2013e7,3,23,24,47,3,2014-01-18 01:42:22,2014-01-13 23:09:41
1e81387edcab600c9b8bc2a502988f7b3a2013e7...8a38ead21993dd500280ae427895363a2de8be8a,1,21,14,35,10,2014-01-18 01:42:22,2014-01-13 23:37:17
8a38ead21993dd500280ae427895363a2de8be8a...f3f2456b0451d93a539eac63dac93a748e01317f,4,17,23,40,13,2014-01-18 01:42:22,2014-01-14 00:10:23
f3f2456b0451d93a539eac63dac93a748e01317f...e765c67b477308643c8b1b4f84bee3572bf5ec98,2,28,28,56,11,2014-01-18 01:42:22,2014-01-14 00:18:46
e765c67b477308643c8b1b4f84bee3572bf5ec98...c2b602b2ac7b5b3a67dbb7945e97a9f48b1a625e,1,18,17,35,5,2014-01-18 01:42:22,2014-01-14 00:41:35
c2b602b2ac7b5b3a67dbb7945e97a9f48b1a625e...8c9f62d037a1bc82742ea316adaaf658af56b7c3,5,14,42,56,11,2014-01-18 01:42:22,2014-01-14 01:17:59
8c9f62d037a1bc82742ea316adaaf658af56b7c3...d3bae131d6fa10dd1c25077204bf2c3274a3b8cc,1,15,5,20,5,2014-01-18 01:42:22,2014-01-14 01:55:16
d3bae131d6fa10dd1c25077204bf2c3274a3b8cc...f7684ea7f61c0c69033c27605e9ad9a0a76e74cd,7,273,226,499,27,2014-01-18 01:42:22,2014-01-14 02:36:59
f7684ea7f61c0c69033c27605e9ad9a0a76e74cd...889b4b10ae3ec1d6e7879c30860aafd7674cb576,5,74,28,102,20,2014-01-18 01:42:22,2014-01-15 19:46:25
889b4b10ae3ec1d6e7879c30860aafd7674cb576...ca8dd73fbfa7aca0768278ff1ff9671f80c48138,5,24,23,47,21,2014-01-18 01:42:22,2014-01-15 21:57:07
ca8dd73fbfa7aca0768278ff1ff9671f80c48138...9e9f4b925b4b6a58a03bbff09150f1314d5fe3b2,7,85,74,159,32,2014-01-18 01:42:58,2014-01-15 22:36:13
9e9f4b925b4b6a58a03bbff09150f1314d5fe3b2...70a5cb95b31c7596886b7f94d292444654b9af8d,6,140,107,247,44,2014-01-18 01:42:58,2014-01-16 01:26:04
70a5cb95b31c7596886b7f94d292444654b9af8d...cdfebc2a20e76d4ea81eb154b748e0547a7e7ab5,4,8,11,19,8,2014-01-18 01:42:58,2014-01-16 19:59:46
cdfebc2a20e76d4ea81eb154b748e0547a7e7ab5...97c84507054a7379c8f8b461773b9c8d4972902b,4,5,3,8,4,2014-01-18 01:42:58,2014-01-16 23:09:00
97c84507054a7379c8f8b461773b9c8d4972902b...5c30c4379af20b3cbd2d20cc9f0ccb6f04ac63ab,1,2,1,3,2,2014-01-18 01:42:58,2014-01-18 00:46:39
5c30c4379af20b3cbd2d20cc9f0ccb6f04ac63ab...d5112ffce60625e470515578ccd446a191dd9e88,1,1,1,2,1,2014-01-18 01:42:58,2014-01-18 00:53:13
ed12818f99589b2b65a4f2510996f6bc6e828820...70c1781e073287a0b012ce94ea1b233fd6628dfa,1,1,1,2,1,2014-01-28 14:28:13,2014-01-28 14:28:13
ed12818f99589b2b65a4f2510996f6bc6e828820...cabe624c823348579ada234e3c029479683f624c,3,12,0,12,6,2014-01-28 04:35:05,2014-01-28 04:35:05
ed12818f99589b2b65a4f2510996f6bc6e828820...e996daeed08defbab8864be1e26cd1294b12af87,4,300,0,300,4,2014-01-28 01:17:07,2013-12-07 05:18:42
e996daeed08defbab8864be1e26cd1294b12af87...87fb2c973d8f9a8a1868ab0c2da504095d04715b,6,130,22,152,18,2014-01-28 01:17:07,2013-12-07 05:19:30
87fb2c973d8f9a8a1868ab0c2da504095d04715b...cfeb1f0f652e11b8b6a8b4e1cbed3835fc5d9546,2,4,2,6,3,2014-01-28 01:18:09,2014-01-21 20:47:27
cfeb1f0f652e11b8b6a8b4e1cbed3835fc5d9546...4a90f00ab7ec9e534c97611dbbdc412ed5966602,1,4,1,5,1,2014-01-28 01:18:09,2013-12-11 01:39:20
4a90f00ab7ec9e534c97611dbbdc412ed5966602...6acc99889d97638d632a2974e04cd91ed4036c4b,1,2,2,4,2,2014-01-28 01:18:09,2013-12-18 18:15:31
6acc99889d97638d632a2974e04cd91ed4036c4b...566fb31c889cfa05c617f44e6c99d44578d643a5,2,1,1,2,1,2014-01-28 01:18:09,2014-01-04 02:06:34
566fb31c889cfa05c617f44e6c99d44578d643a5...7f9d3268bf0e1d4a79d07c67e22eb14d3de96f6c,3,8,3,11,3,2014-01-28 01:18:09,2014-01-04 02:07:43
7f9d3268bf0e1d4a79d07c67e22eb14d3de96f6c...2fe7588af79bbc61e758ff066be1cf1c2d381f7b,1,2,2,4,2,2014-01-28 01:18:09,2014-01-08 00:10:32
2fe7588af79bbc61e758ff066be1cf1c2d381f7b...1f44921c51883e923ed82ed4e30eca6f79702cfb,1,0,1,1,1,2014-01-28 01:18:09,2014-01-14 18:06:08
1f44921c51883e923ed82ed4e30eca6f79702cfb...1603039a7150e0510853efc9a9733ef64508dbb0,2,4,4,8,5,2014-01-28 01:18:09,2014-01-15 04:07:39
1603039a7150e0510853efc9a9733ef64508dbb0...f82d1291cc850b39d872d022feac6b9eb7773d64,9,237,1,238,12,2014-01-28 01:18:09,2014-01-17 21:18:43
f82d1291cc850b39d872d022feac6b9eb7773d64...def09526066001eefe16dbc6475b93bc1a9af0a2,1,8,14,22,4,2014-01-28 01:18:09,2014-01-17 22:07:06
def09526066001eefe16dbc6475b93bc1a9af0a2...7839350dd582cc0f08b5e0de735d57baa08328ff,14,53,497,550,14,2014-01-28 01:18:09,2014-01-21 20:43:57
7839350dd582cc0f08b5e0de735d57baa08328ff...4e5859e8300e7c56f28ca07c47131d14f6cf8632,1,1,1,2,1,2014-01-28 01:18:09,2014-01-28 01:09:36
9481afa6172c8d50ffe6d5c9eff80d36361fa11e...630459f2b84c9664b436eb076cfac39d731f08bf,1,2,0,2,1,2014-01-31 02:30:16,2014-01-31 02:30:16
9481afa6172c8d50ffe6d5c9eff80d36361fa11e...4326e541f843e5c053221f15fef546b42ba29e25,1,4,1,5,2,2014-01-30 23:50:23,2014-01-30 23:50:23
9481afa6172c8d50ffe6d5c9eff80d36361fa11e...2655a108e1950534f0fa1d6034ab61444fe35ee5,1,1,1,2,1,2014-01-30 23:21:42,2014-01-30 23:21:42
9481afa6172c8d50ffe6d5c9eff80d36361fa11e...45dd051e8ee2e0e18d8ffec99f65878c20bd11e9,10,14,4,18,12,2014-01-30 23:10:56,2014-01-30 22:41:10
9481afa6172c8d50ffe6d5c9eff80d36361fa11e...720f64af1855235b6f518ad97dbb89eb61191222,1,3,1,4,1,2014-01-30 22:59:21,2014-01-30 22:59:21
22fb3e0f38fb9e89bdea20f19eedbfad801353c8...134435a79c06bd178aa6f687fcabeb2caced485a,3,70,21,91,12,2014-01-24 23:11:38,2014-01-16 01:09:05
134435a79c06bd178aa6f687fcabeb2caced485a...a7e9baaf89ae86dba4f93fb76a436e4c86249e4c,2,15,8,23,5,2014-01-24 23:11:38,2014-01-16 01:43:57
a7e9baaf89ae86dba4f93fb76a436e4c86249e4c...5fd8aa02bae6602bfe6bff541be1e1dc5c1e0fb8,2,50,70,120,11,2014-01-24 23:13:30,2014-01-20 23:15:00
eedaf08eb8dc7a9a6265cc3d9bd62f614e89a411...b1d26985d0dfcbecc8264124fa81ff843a6d574b,2,17,6,23,4,2014-01-25 01:18:48,2014-01-25 01:18:48
18df387bf8a4a1419b6d3267a4e0551ff72b0f88...3e3abdd770bdc23c409a9e49619a1897ffbf2354,1,10,9,19,9,2014-01-23 01:20:19,2014-01-23 01:20:19
c00cb1aca15c4dea4198c4e488a986fa6ad9636c...217ad5e5e673aa09471e95f4726ddab2422fe5d1,4,127,148,275,66,2014-01-29 18:52:54,2014-01-25 07:15:40
217ad5e5e673aa09471e95f4726ddab2422fe5d1...55d7aa1b49a49a27d77cd4011d921e340ec99f9f,2,156,306,462,154,2014-01-29 18:52:55,2014-01-28 00:27:02
55d7aa1b49a49a27d77cd4011d921e340ec99f9f...7b7f7e443637d8303f03316ee437012b71936c12,4,38,13,51,11,2014-01-29 18:53:43,2014-01-28 03:26:24
7b7f7e443637d8303f03316ee437012b71936c12...f556cd4186dfdb5e96b2e58b5caf9edbe7e2d7df,8,159,168,327,152,2014-01-29 19:26:54,2014-01-29 19:26:54
f556cd4186dfdb5e96b2e58b5caf9edbe7e2d7df...fc2f998822699c0c7e22e4fc791d10c3b1ea1e53,2,10,11,21,12,2014-01-31 03:34:50,2014-01-29 20:16:47
b7c2e8f54e6b76ec321c8c9c1f41dbc8b7c66a4e...68de32888b6bad84cd37ccd165b0e7bb013574af,1,1,1,2,1,2014-02-18 03:43:56,2014-02-18 03:43:56
b7c2e8f54e6b76ec321c8c9c1f41dbc8b7c66a4e...85b8025a35c29e0832fd13adc55177758ecbb309,1,1,1,2,1,2014-02-17 21:29:36,2014-02-17 21:09:09
fc697e3fd759b07f897ed2e61cf3a1916c7fb460...d41844ed2d946fc963f9977991233b5d9daf86fd,4,9,11,20,11,2014-01-29 00:20:51,2014-01-29 00:20:51
d41844ed2d946fc963f9977991233b5d9daf86fd...abd64a2b00a57dda2f24326fc49b7ca10e950dff,2,15,22,37,6,2014-01-29 01:17:55,2014-01-29 01:17:55
f95621fd054004e8cc438c1bb443c3df6823d45e...3ba279a3705b3417fea36e8d2eb7d54e95d60fad,1,2,2,4,2,2013-12-05 01:08:14,2013-12-05 01:08:14
f95621fd054004e8cc438c1bb443c3df6823d45e...0d1506adb30ecd56f5e413c3ff376a1acfbe3697,1,30,0,30,1,2013-12-05 00:31:09,2013-12-05 00:31:09
0dd92d8f1cb13a0e0d6a84bb591efae1da118c71...08623dc216227d6377cb4558caedd75cacf68755,2,12,11,23,5,2013-11-12 20:25:35,2013-11-12 20:25:35
7682ec04cd0a1b3a8244fe048ae20976404110f1...bbc9fc79072bc259371aa96958336baaf8b53638,1,1,0,1,1,2013-11-14 01:05:32,2013-11-14 01:05:32
8c21d2acd33c2bbaba224e19fbef30a3ba8788df...51c93c0f3318efa95a02d25677a1a4837f1af9f6,4,13,6,19,11,2013-11-08 03:02:15,2013-11-08 03:02:15
606cacdca0c364b8eead4cb41e0dc04fde6af0ab...62213ee314d0669a278fae1e3052329f4ca35f75,2,87,21,108,10,2013-12-16 21:29:43,2013-12-16 21:29:43
606cacdca0c364b8eead4cb41e0dc04fde6af0ab...67215250686687134788c4826f3d9eccb9981344,1,5,0,5,1,2013-12-16 17:04:29,2013-12-16 17:04:29
606cacdca0c364b8eead4cb41e0dc04fde6af0ab...4faba4fae78ab216f2cfd90b1ef23706d933b731,2,96,21,117,8,2013-12-16 12:30:35,2013-12-11 14:56:44
4faba4fae78ab216f2cfd90b1ef23706d933b731...5cfcb05486d9b45e347324d92350799ab05c65c8,1,5,6,11,4,2013-12-16 15:01:55,2013-12-16 12:29:06
606cacdca0c364b8eead4cb41e0dc04fde6af0ab...e1efd4cb8c6a5c645285b1f39d4508419e5626c9,1,4,4,8,4,2013-12-16 03:24:35,2013-12-16 03:24:35
650d4cc64438bd6b1ae12f77aa98a663eec1b4bc...1cb1e08644b450d3371bfd7d6e305be454d19719,2,139,52,191,46,2013-12-03 14:14:54,2013-11-21 16:26:07
7aec93c37094fa09631b13061553950088e9e6fa...0017c68f4a56f9250b53e4f8efdf3513b051c1a3,1,6,6,12,6,2013-12-02 21:52:27,2013-12-02 21:52:27
0017c68f4a56f9250b53e4f8efdf3513b051c1a3...829b118dd8fbfb9ce1585c15699cf6221c328802,1,12,1,13,4,2013-12-02 22:54:01,2013-12-02 21:52:48
258d707548619eae7517b39ff0bc9541ebec566c...3df5d120de4f42cc208283bf78b26ca5b21c6776,2,66,0,66,2,2013-12-04 20:25:22,2013-12-04 00:02:29
258d707548619eae7517b39ff0bc9541ebec566c...58c33360b01748f4900dd00dc57c3aec89a98e27,1,0,5,5,2,2013-12-04 00:39:23,2013-12-04 00:39:23
58c33360b01748f4900dd00dc57c3aec89a98e27...909da5d5249880b02bad5fb893d12fe2a3fdd942,1,1,0,1,1,2013-12-05 05:08:44,2013-12-05 05:08:44
fd7ff6411dcf792222b8d5a87333df1e42d22a2c...4049359beeb8a253f07e6dbac213391a7b39f362,1,12,10,22,3,2013-11-26 05:40:24,2013-11-26 05:30:47
7ba0f1f421fea08728675d9ec424b97ad51cd695...c4444ce48fac417847f95a11024667d48e715a52,1,2,2,4,2,2013-12-17 19:48:21,2013-12-17 19:48:21
124da338fd1c238c8b8e76b15db642104eac1b23...7d95145b76decc511bc78d887ec3843bd182e58a,1,21,0,21,3,2013-12-17 16:33:52,2013-12-17 16:33:52
7d95145b76decc511bc78d887ec3843bd182e58a...30b4a0f76a63f24f96ba588216990f0ae7cd60a2,2,12,0,12,4,2013-12-17 16:56:31,2013-12-17 16:56:31
30b4a0f76a63f24f96ba588216990f0ae7cd60a2...25be0b1e987934ca39085894730b54f4bbcd8ad2,1,7,7,14,6,2013-12-17 17:32:40,2013-12-17 17:32:40
124da338fd1c238c8b8e76b15db642104eac1b23...36e060299f2c3d73b26f556f73ba58a9738fd23e,1,4,0,4,2,2013-12-17 13:50:37,2013-12-17 13:50:37
124da338fd1c238c8b8e76b15db642104eac1b23...a96a26c62f6333e61134759256db43a7f5946631,2,36,0,36,3,2013-12-17 13:19:48,2013-12-17 13:19:48
a96a26c62f6333e61134759256db43a7f5946631...b8a4f570fb31091f43caeba5b824ae38a5bc69e8,1,11,3,14,5,2013-12-18 09:50:22,2013-12-18 09:50:22
124da338fd1c238c8b8e76b15db642104eac1b23...c3705e83e7eac1e67dbb9c6fc354063bbe43eae6,2,2,2,4,2,2013-12-17 12:34:25,2013-12-17 12:31:35
124da338fd1c238c8b8e76b15db642104eac1b23...5e9b4a23e6bde9e7d65ebc8b4bdfec4e1486df3a,2,3,4,7,3,2013-12-17 06:57:54,2013-12-17 06:57:54
124da338fd1c238c8b8e76b15db642104eac1b23...a1c5e276f4cfe4ab498b6e013e61bfc957ce6852,2,2,2,4,2,2013-12-17 06:50:03,2013-12-17 06:43:47
124da338fd1c238c8b8e76b15db642104eac1b23...eddda577a4dd7f8fb4fb67fd1600c2a7c5de40c7,1,4,1,5,1,2013-12-17 05:54:06,2013-12-17 05:54:06
124da338fd1c238c8b8e76b15db642104eac1b23...2035af44aae3664b217d6903cbf39c259f568490,2,24,6,30,10,2013-12-17 05:29:00,2013-12-05 09:10:41
2035af44aae3664b217d6903cbf39c259f568490...f02d766f9a93bf86c6473eb2772bc239ffaa1cd6,2,16,0,16,3,2013-12-17 05:29:05,2013-12-05 09:14:15
f02d766f9a93bf86c6473eb2772bc239ffaa1cd6...2ed1001c57646f6869016739a8e177bb52f32e2a,2,3,1,4,3,2013-12-17 05:29:08,2013-12-05 09:15:47
124da338fd1c238c8b8e76b15db642104eac1b23...7afd7a82bd672bf7b3976458197b8c56c17407de,1,32,22,54,3,2013-12-17 01:36:50,2013-12-12 05:33:15
7afd7a82bd672bf7b3976458197b8c56c17407de...3f9416b58da029b7d82a4908f6c066cee0695edf,1,144,35,179,10,2013-12-17 01:36:51,2013-12-12 05:33:15
3f9416b58da029b7d82a4908f6c066cee0695edf...15a68541196b9b9338923ece6c6b4a69929652d6,1,93,27,120,10,2013-12-17 01:36:51,2013-12-12 05:33:15
15a68541196b9b9338923ece6c6b4a69929652d6...670b326c1b88d66ef941de5f27867ba6132762a1,1,1,0,1,1,2013-12-17 01:36:51,2013-12-12 05:33:15
670b326c1b88d66ef941de5f27867ba6132762a1...a26801c73f535b2e57366b9d6de0453e7c732884,1,4,0,4,1,2013-12-17 01:38:16,2013-12-12 05:33:15
cb1fe939a88af2c254a5c13a4a11aafea2fd08dd...0fccf0f68655fd01973e4c00bbb063fad1bce56c,6,16,15,31,12,2013-12-25 00:40:14,2013-12-25 00:37:00
0b0b0ca0f915bcbe79923b313fb45be6253d8ade...9c1e9a5157b3ef7627f4b735c2b8b6d97f26dd53,11,108,93,201,41,2013-12-10 01:23:56,2013-12-06 23:26:57
d502f0cfac781f52ff64535d1b5e06949fa8ef1a...8ec96c9605b1e97fb36f3c2a2d85632f62fb047b,22,0,2304,2304,14,2013-12-08 22:02:13,2013-12-08 22:02:13
d502f0cfac781f52ff64535d1b5e06949fa8ef1a...c094807a1b8159bf237091ecc85fcbd6e2092a3e,1,35,0,35,1,2013-12-08 20:54:12,2013-12-07 04:35:26
d502f0cfac781f52ff64535d1b5e06949fa8ef1a...416b16e1e200420644072b354b9595ffa9474682,2,23,6,29,12,2013-12-08 19:57:11,2013-12-08 19:57:11
416b16e1e200420644072b354b9595ffa9474682...dcfc4ada4dcc8b1f878370976f29ca0485e690f8,3,27,28,55,6,2013-12-08 20:49:57,2013-12-08 20:49:57
dcfc4ada4dcc8b1f878370976f29ca0485e690f8...bac3a8e6f5eca31108787b98d5659523eefa6a30,2,8,6,14,2,2013-12-08 20:50:48,2013-12-08 20:50:48
bac3a8e6f5eca31108787b98d5659523eefa6a30...45cea94a827bfcb77ef53e2e5046df51dc7c113c,1,3,57,60,2,2013-12-08 22:34:08,2013-12-08 22:32:17
45cea94a827bfcb77ef53e2e5046df51dc7c113c...ca405786f468a18859684dc13d43a293d47b89bd,2,8,5,13,3,2013-12-09 01:40:05,2013-12-09 01:40:05
ca405786f468a18859684dc13d43a293d47b89bd...f0879a1e145f31569e9e4e61f429de858bb636ab,4,31,1,32,5,2013-12-09 01:43:24,2013-12-09 01:41:50
a7a171b6c2916b7be3fa51c9465516acb68c3e32...f80681815422865fbe0e9b637f38553fa965004a,1,40,0,40,1,2013-12-08 07:33:23,2013-12-08 07:33:23
f80681815422865fbe0e9b637f38553fa965004a...869a11bc93c4b5dc9dbd74d65e69045f367bdb36,2,40,22,62,3,2013-12-08 07:35:24,2013-12-08 07:35:24
869a11bc93c4b5dc9dbd74d65e69045f367bdb36...de35b346d17ef86ef091e1736575c60c41fc3771,5,25,32,57,12,2013-12-08 07:41:53,2013-12-08 07:41:53
fb9ddc5de5477a88c236963e5ac4dc6f054115ff...a68d7f3d70ab1638fd5b63a3026b211cb4e7a65e,4,30,12,42,10,2013-12-13 15:47:19,2013-12-13 15:47:19
fb9ddc5de5477a88c236963e5ac4dc6f054115ff...39cc8a32b1dcf6dcb9462fbc2768ae035e8095dc,1,1,1,2,1,2013-12-11 21:13:55,2013-12-11 21:13:55
fb9ddc5de5477a88c236963e5ac4dc6f054115ff...af21908493e570a1399bbd462803398ef34e56bc,1,1,1,2,1,2013-12-11 12:15:27,2013-12-11 12:15:27
fb9ddc5de5477a88c236963e5ac4dc6f054115ff...7edd1f6bad752dd89eeaa3690e219dfa748afa9c,1,32,0,32,1,2013-12-11 05:54:34,2013-12-11 05:54:34
fb9ddc5de5477a88c236963e5ac4dc6f054115ff...d878632b2548247fc9e4c2da1b2520e4c7b9420a,1,30,3,33,5,2013-12-11 02:07:07,2013-12-11 02:07:07
8afb0abbee0ff135a5314d7078285378b8f49c93...f50fe14e13160c7c823613710a6fa12c9fc13bcb,3,48,15,63,11,2013-12-03 22:21:33,2013-12-02 19:53:04
8afb0abbee0ff135a5314d7078285378b8f49c93...c81bb20f5b2b5d86059c6004e60ba23b03d30fe0,1,1,0,1,1,2013-12-02 23:02:54,2013-12-02 23:02:54
8afb0abbee0ff135a5314d7078285378b8f49c93...c9432cf51aea9351cc88791036b986e6662a49b8,1,17,10,27,3,2013-12-02 22:55:42,2013-11-23 20:30:29
c9432cf51aea9351cc88791036b986e6662a49b8...6c70d23e0d850b31fce0e658ad9ddd7a167bcdcb,1,19,9,28,6,2013-12-02 22:55:42,2013-11-23 20:36:09
8afb0abbee0ff135a5314d7078285378b8f49c93...3ac76cfeffafcfdc3688fda58cb29d9bb7f6149b,6,6,6,12,6,2013-12-02 22:48:39,2013-12-02 22:48:26
8afb0abbee0ff135a5314d7078285378b8f49c93...9d62dc1a0837e37ce5da01c278ab20f7d32c3774,3,115,18,133,3,2013-12-02 21:54:04,2013-10-23 17:22:41
8afb0abbee0ff135a5314d7078285378b8f49c93...3cd9b2aadfd16736032ee569ba263fce53286347,3,15,4,19,6,2013-12-02 21:22:39,2013-11-22 17:55:27
3cd9b2aadfd16736032ee569ba263fce53286347...5a9cf7e75442ce1c76876da717b8c2f321fc04ae,1,24,0,24,1,2013-12-02 22:33:33,2013-12-02 22:33:33
d9cdd45d2e76ce3f1dbb722780d1f5d59d9116cb...dbb47f63ab637a4766f72eac55f66493cf1c6f5b,1,3,0,3,1,2013-12-02 16:11:06,2013-12-02 05:13:05
d9cdd45d2e76ce3f1dbb722780d1f5d59d9116cb...26cf8b9aff1cffa7c3e3ae7e720c960ff545ee78,1,4,0,4,1,2013-12-02 05:55:08,2013-12-02 05:52:45
d9cdd45d2e76ce3f1dbb722780d1f5d59d9116cb...7f1a91121c3f77ca833f43693018f6cce32b96bf,1,28,28,56,11,2013-12-02 04:31:28,2013-12-02 04:31:28
d9cdd45d2e76ce3f1dbb722780d1f5d59d9116cb...c30e2dc28c53664a4ad241a682355332af3371d2,2,2,2,4,2,2013-12-02 04:20:35,2013-12-02 04:20:35
cc0466bb685ad9c393e282860734282659a4b409...a96bf7439774d905f72e835218c72a5b45da37c0,1,1,0,1,1,2013-12-05 22:34:10,2013-12-05 22:34:10
d1a4f83e5ec4b332c0d61ace7b03da5de2f6bebd...7bf3a07371bb0baed21b59d60835ed2f4877b571,1,18,4,22,3,2013-12-05 23:22:21,2013-12-05 23:22:21
d75fc6e529a4a7279829f4229c474adf29514b8b...13da09d22bcae553cb11b5f906d3c260db571b7d,1,8,7,15,4,2013-12-06 21:23:53,2013-12-06 02:52:32
35e80868addd9ac5a2c1e006e650ac3e71f52c6a...6720bfb24312a558a27453ce104beeb04c53ec68,1,7,10,17,4,2013-12-06 19:57:05,2013-12-05 23:10:44
427649eee12c253ad24ec694353aea148e24eb08...80aecc70141f3e7b3138752bf3f0c33b9a273714,3,176,38,214,25,2013-11-19 08:44:19,2013-11-18 10:33:07
80aecc70141f3e7b3138752bf3f0c33b9a273714...a0224e61b48e1dd1378cb955596fba1937e99068,4,228,20,248,10,2013-11-19 08:59:13,2013-11-18 11:12:04
a0224e61b48e1dd1378cb955596fba1937e99068...9415c2b1f08ecd168ab5a620a80a5bed34df8adb,1,0,0,0,0,2013-11-19 09:03:04,2013-11-19 09:03:04
427649eee12c253ad24ec694353aea148e24eb08...00401a30b73d897255b7b99996d7c6a53fe2d4af,1,22,2,24,3,2013-11-19 08:29:42,2013-11-18 16:10:47
427649eee12c253ad24ec694353aea148e24eb08...8ed4307f50b93d7c49eccf30357a4b9d3fbb1376,1,2,1,3,1,2013-11-18 13:31:34,2013-11-18 13:31:34
cbd1281ec998e017b579c13ee6262aa21c96c38a...a518b847511f034d9bfd4166e17f8f0eac61d021,3,49,4,53,7,2013-11-16 01:16:30,2013-11-16 01:16:30
a518b847511f034d9bfd4166e17f8f0eac61d021...94e854823f3549eeddaafa24835093966d9aaeeb,1,13,1,14,3,2013-11-18 21:16:28,2013-11-18 21:16:28
94e854823f3549eeddaafa24835093966d9aaeeb...f88b760809677109a723f25399f738d756f14c13,1,74,7,81,8,2013-11-19 00:17:43,2013-11-19 00:17:43
f88b760809677109a723f25399f738d756f14c13...29f07f854497571db570be79c8df878624f5b41c,3,85,28,113,16,2013-11-19 02:39:21,2013-11-19 01:20:03
29f07f854497571db570be79c8df878624f5b41c...5ee8e41e43892694f66b4d6d01ed95f4ca2e7cb6,2,45,28,73,14,2013-11-19 07:28:45,2013-11-19 07:28:45
c624caa949a19b9fe7802976c6f4bb98fa029da4...c95f77866c18fcd75507bf72df405bc61ba50bb0,1,1,1,2,1,2014-06-06 18:45:57,2014-06-06 18:45:57
093aacb740c81a5c96a2300e6b2afae442879915...0ed9bba1ee48ff925ade710658fecd2270f8a223,1,1,1,2,1,2014-05-08 01:48:38,2014-05-08 01:48:38
fb99f992c081a1d433c97c99ffb46d12693eeb76...752c57ae567813f354aca66ff51d8d64100ae01b,1,5,9,14,2,2014-05-10 22:05:02,2014-05-10 22:05:02
fb99f992c081a1d433c97c99ffb46d12693eeb76...fdccfaf72a614872aeeb79e9cee7f42abcaacf6d,3,225,133,358,4,2014-05-08 02:31:23,2014-05-01 20:09:39
93f5d539fed58a28853e3b4840a6de6ded236cf4...d3150e0927043976b0b88bd61e50dc1e456fa77b,1,2,2,4,2,2014-05-07 23:28:51,2014-05-07 23:28:51
93f5d539fed58a28853e3b4840a6de6ded236cf4...331e77f9ed938b3a8c7346ef46a9f6f5cd2dc794,3,6,4,10,6,2014-05-07 22:58:09,2014-05-07 22:58:09
331e77f9ed938b3a8c7346ef46a9f6f5cd2dc794...2aff119baa15cff37f9b2004755f144f16a87801,4,28,26,54,21,2014-05-07 22:59:13,2014-05-07 22:59:13
8d25eef5efe3f0aa383d44b1ff91f2b966e746a5...63c303eecdbaf4dc7967fd51b82cd447c778cecc,1,1,0,1,1,2014-04-09 11:55:08,2014-04-09 11:55:08
28e7e814795fce2a75e4767a6707a6e4d03fa8b6...69fbf8e31f0b74c61c7e7fe1bd34bbb1aaf813b6,1,2,2,4,2,2014-04-11 12:51:50,2014-04-11 12:51:50
28e7e814795fce2a75e4767a6707a6e4d03fa8b6...b9731bccf2b2cc8c06ef8bdb41f72ca4791e63db,4,26,28,54,21,2014-04-10 22:29:03,2014-04-10 22:29:03
b9731bccf2b2cc8c06ef8bdb41f72ca4791e63db...e9c3e397436221528312c0d3b291ae5a12862ed2,3,4,6,10,6,2014-04-14 17:15:22,2014-04-11 23:59:12
8bcb156694152d90698c3a0cb7b9cf539a838f8e...8d88ea0c15b7ce7fd2b0b695c498a7ffa0f2bc87,10,57,65,122,61,2014-03-11 00:16:58,2014-03-11 00:16:58
8bcb156694152d90698c3a0cb7b9cf539a838f8e...03211ecce07ab64f5263232e1aa3c6248530c5b4,1,6,6,12,6,2014-03-11 00:08:50,2014-03-10 23:50:29
d0f4bc7ccac7a7802c46b7be6ffd3bd3a2d45454...6073b450e83a67a27ffe8c11ebda36791a7923b4,1,2,2,4,2,2014-02-19 22:30:21,2014-02-19 13:53:31
d0f4bc7ccac7a7802c46b7be6ffd3bd3a2d45454...b3d5e9527a050a0c7252f0125a8a26a6fc5175f1,3,16,15,31,7,2014-02-19 16:59:51,2014-02-10 23:21:20
d0f4bc7ccac7a7802c46b7be6ffd3bd3a2d45454...8a289a8a54480b968a6924536e084d749e567cf0,1,1,1,2,1,2014-02-19 11:21:29,2014-02-19 10:50:11
d0f4bc7ccac7a7802c46b7be6ffd3bd3a2d45454...05c692d64ec9cabe6c16385300405406ebe63f40,1,50,13,63,8,2014-02-19 03:21:12,2014-02-19 03:21:12
05c692d64ec9cabe6c16385300405406ebe63f40...196702fbf9905426e590c0dbcb6101e72c62aac6,1,3,2,5,2,2014-02-19 18:32:43,2014-02-19 03:25:43
9997d0c9ed031465b7bc6e4df6f62bcac3758305...da3a52746b3ec43049dc3a8ca58b44d0188f043e,1,8,4,12,4,2014-02-13 20:01:55,2014-02-13 19:42:14
84285f7539f5825db62df3e3995d3de7b96b0a89...3dfc910d7774d57c533b067fbe59d6b24dd803cd,3,28,12,40,9,2014-02-09 12:23:57,2014-02-06 22:13:03
84285f7539f5825db62df3e3995d3de7b96b0a89...e8740685ceb3ad8637532e7ddffb84ea55d4fc27,3,27,11,38,8,2014-02-06 22:13:03,2014-02-06 22:13:03
e8740685ceb3ad8637532e7ddffb84ea55d4fc27...547ac421995860f99d1d0803c3c1e7ea51dc681e,2,109,0,109,2,2014-02-07 00:40:39,2014-02-07 00:44:14
105188be2e321bb462edccfdddbeda2a12a74bc9...a6c791e8a92f29a2ae2c6bc81e4ab873d3ceb41f,1,33,0,33,1,2014-02-08 17:53:04,2014-02-08 17:53:04
a6c791e8a92f29a2ae2c6bc81e4ab873d3ceb41f...e3762e8d6937741a5654b1443f95beb784f018f1,1,32,0,32,1,2014-02-08 18:03:16,2014-02-08 18:03:16
e3762e8d6937741a5654b1443f95beb784f018f1...ee39033073ece35e91c6c5a8cb66d23246511fb0,1,66,0,66,2,2014-02-09 04:44:04,2014-02-09 04:44:04
ee39033073ece35e91c6c5a8cb66d23246511fb0...524416560a4624d30023db32101c9fe5ebffc895,1,33,60,93,5,2014-02-09 13:54:13,2014-02-09 13:54:13
09702f4c31e2b3899192318659ff59512cb28d8d...6561d65438ed2e10143a5a8bac32bf62d5d8950d,1,24,0,24,1,2014-02-06 19:35:45,2014-02-06 19:35:45
6561d65438ed2e10143a5a8bac32bf62d5d8950d...e95bb0b4a9ef642d02f5549ba8375f9952eff0b3,1,0,23,23,1,2014-02-06 19:37:49,2014-02-06 19:37:49
e95bb0b4a9ef642d02f5549ba8375f9952eff0b3...647db3938d27d832d09f622b304c7bd23bc00d74,1,28,6,34,2,2014-02-06 19:38:20,2014-02-06 19:38:20
647db3938d27d832d09f622b304c7bd23bc00d74...3d86f07f8776fd97f1f75e99ad535a9b6543059a,1,10,3,13,3,2014-02-06 19:38:25,2014-02-06 19:38:25
3d86f07f8776fd97f1f75e99ad535a9b6543059a...888e8da2832871b10f60ba9d3058fc442812ca17,1,2,2,4,2,2014-02-06 19:48:15,2014-02-06 19:48:15
888e8da2832871b10f60ba9d3058fc442812ca17...f6c6f303f84773987afd5f83d9c1e2170fa140e3,1,17,0,17,1,2014-02-06 19:50:36,2014-02-06 19:50:36
7fe8b50e2ee9ba0b237827f95980dcf6e1a41fb4...2ed2ba4e8caa2d70d57d124a2f3509f400d8187e,2,115,105,220,29,2014-02-12 00:30:57,2014-02-06 23:37:10
e9e4b8dc15fcf01fb793cd65ebfa822420d56fe8...6fd8e5d976e872447447d8c25d20d525305f281d,1,1,1,2,1,2014-02-12 00:53:08,2014-02-12 00:53:08
3122b4b470168ead70a84ff2594aa32c0619e08c...c76a4e34896fd0785cf982372a3713c4ef70754b,1,1,1,2,1,2014-02-12 00:19:42,2014-02-12 00:19:42
47df7a360ad10660639af4bef32afaa29b16ee1c...3417dd4b3bef88d4da0deac520bbf150ba9c183b,10,20,20,40,20,2014-02-13 18:11:07,2014-02-13 13:34:04
20f36f088c86569d59c8cfe27a99742f31f4fbd3...4f53722dee6c8ea18a9c30bde2cc6fee24b03d32,1,7,1,8,1,2014-01-17 11:21:26,2014-01-17 07:44:18
20f36f088c86569d59c8cfe27a99742f31f4fbd3...40b40cffb13758c03eff2cf05b1e5b0aa47bdb9d,1,42,44,86,9,2014-01-16 05:20:51,2014-01-16 05:16:23
20f36f088c86569d59c8cfe27a99742f31f4fbd3...98111a4a94b8fdc0a44a1c7bfba2e83fbd0f9534,1,1,0,1,1,2014-01-16 05:12:32,2014-01-16 05:12:32
20f36f088c86569d59c8cfe27a99742f31f4fbd3...90ec5de430a79ab6b145899a9842c1db968341cf,5,77,25,102,14,2014-01-16 01:13:45,2014-01-15 00:51:59
4ab59179e76dc2311422c2ebdeafca279dc94b65...aeb2f479fa1c063867475a610ddbfe4f8883dfda,4,3,62,65,6,2014-01-28 19:29:27,2014-01-28 19:29:27
4ab59179e76dc2311422c2ebdeafca279dc94b65...ef6c0d53410c0be6f33d049e7998b54804497350,1,0,6,6,1,2014-01-28 19:27:56,2014-01-28 19:24:38
2723133a69a292abaa021afff98de127bda57b4e...99756ef11fc2a3ae821bb412607e7e9b322f278a,2,170,139,309,11,2014-01-28 23:42:46,2014-01-28 23:42:46
99756ef11fc2a3ae821bb412607e7e9b322f278a...b3b12f00593d96c6d0e93f9e333ee368278e871d,5,136,89,225,10,2014-01-29 01:10:13,2014-01-29 00:28:32
41c10fb25632ba5bc65a78e84c2f851e93f80ee4...b111fc364611d755ac791c5c51c82c5754fe545b,1,10,1,11,1,2014-01-30 19:22:22,2014-01-30 17:42:28
41c10fb25632ba5bc65a78e84c2f851e93f80ee4...cc382ec62848855f6fe7302fe7a37ac62af35a9c,1,1,1,2,1,2014-01-30 17:06:28,2014-01-30 17:03:25
41c10fb25632ba5bc65a78e84c2f851e93f80ee4...fc1169a220196b78b73d5c1874d3c7bdc38d9fe3,1,1,0,1,1,2014-01-30 15:41:45,2014-01-30 15:40:53
fc1169a220196b78b73d5c1874d3c7bdc38d9fe3...fab19d197c6cc362182f6cee4d0a6e65e799875f,4,69,49,118,22,2014-01-30 15:43:53,2014-01-30 15:43:53
41c10fb25632ba5bc65a78e84c2f851e93f80ee4...626a2e1112b6e802415f80ff7a3682296636f55a,1,9,0,9,1,2014-01-30 10:53:27,2014-01-30 10:53:27
7ced2043721cb35a07721e82be2daffae6a29119...28b5ae8cc4492f7b3cc2eb2b30b0f41713822b25,5,16,8,24,8,2014-01-31 02:06:08,2014-01-31 02:06:08
28b5ae8cc4492f7b3cc2eb2b30b0f41713822b25...1498cd4e0540c73546a4847948f7d6a75b596178,3,18,18,36,5,2014-01-31 02:21:59,2014-01-31 02:21:59
7ced2043721cb35a07721e82be2daffae6a29119...ce423cc9a8b9552ee8bb75f3aac81d291f85375c,1,13,3,16,3,2014-01-31 01:03:57,2013-12-08 15:45:12
45dd051e8ee2e0e18d8ffec99f65878c20bd11e9...065dd231dd7d7858df982a8decfade9df936cf63,31,51,23,74,31,2014-01-31 10:16:42,2014-01-31 10:16:42
59df776469eed793556d3668465e604870219985...5cc6312bfc4e511784693d02b9bb8e8d9d1c04b0,2,65,51,116,5,2014-01-24 23:28:17,2014-01-23 19:12:17
f9e9637a9f42794ace5833f778705061e50fc4ca...303ed3c8300183bab09a36b58e0c1db89d12424a,4,270,10,280,13,2014-01-26 22:01:38,2014-01-23 14:43:50
303ed3c8300183bab09a36b58e0c1db89d12424a...da30eb7c2038c8c554e1f44c80c061c7a827a429,1,10,3,13,3,2014-01-26 22:01:38,2014-01-24 01:35:39
da30eb7c2038c8c554e1f44c80c061c7a827a429...ac2a4e64106b28d7b05d1ee31716af365424ff83,2,73,21,94,15,2014-01-26 22:01:38,2014-01-23 15:46:42
ac2a4e64106b28d7b05d1ee31716af365424ff83...da61b99b392657343df4dc221ba5cd9ad6b1c9e1,5,185,297,482,45,2014-01-26 22:01:38,2014-01-23 20:17:28
da61b99b392657343df4dc221ba5cd9ad6b1c9e1...5e69b3837b26d1d1f7cd8b3c4f5b077ba642bd20,1,3,4,7,3,2014-01-26 22:07:43,2014-01-26 22:07:43
78b3d89f87bd6017416a48fcfd9118acd9910a51...6bc05899aa5023fdda0441b76a829d0e9a6f6dea,3,89,61,150,30,2014-01-23 02:05:20,2014-01-23 02:05:20
6bc05899aa5023fdda0441b76a829d0e9a6f6dea...79bb8212e05cc9c14b8edda2b8a924fef63ea2e0,3,178,26,204,18,2014-01-23 03:34:47,2014-01-23 03:34:47
79bb8212e05cc9c14b8edda2b8a924fef63ea2e0...648357ffdf6670810383be6437b8a5f8a38d4e42,3,0,0,0,0,2014-01-23 08:28:35,2014-01-23 08:28:24
648357ffdf6670810383be6437b8a5f8a38d4e42...fccca3542b91513dd0da73db21ffa3ced4dd9b7f,6,378,379,757,41,2014-01-23 09:31:38,2014-01-23 09:31:38
fccca3542b91513dd0da73db21ffa3ced4dd9b7f...9d11db0f8c2be614f18eec856f11edbff5da17fe,2,17,24,41,8,2014-01-23 10:22:13,2014-01-23 10:22:13
9d11db0f8c2be614f18eec856f11edbff5da17fe...ea5b3e193ba40b65c38c774e9abb85340c52e8c6,3,72,11,83,21,2014-01-23 13:22:32,2014-01-23 13:22:32
b881a6c3c2e73f2fd342975239331004f0b59e12...9eea7f28f0c64d43ef2a9987999a29774fa1476b,6,42,40,82,17,2014-01-31 23:06:00,2014-01-31 19:30:43
ef844adc3e2ba7ae702109c1bae54668a6a74aac...940c381dd5898df4dd863a2d76a122b6610f2940,6,69,17,86,15,2014-02-18 10:16:08,2013-12-18 11:12:49
940c381dd5898df4dd863a2d76a122b6610f2940...a049e93a4c164de25ce1fc1113f2929aa0aa0b5b,2,18,15,33,10,2014-02-18 10:16:09,2013-12-18 11:36:02
ef844adc3e2ba7ae702109c1bae54668a6a74aac...5ba24629610c27f08b54ff4c1f000ad6d787c156,1,8,3,11,4,2014-02-18 08:53:30,2014-02-18 08:53:30
c82a2d1adfb2b2a838a12e0c3baea1d42fe7f3ad...f09a78cd219b24d4308034c8dd13410cfe5fbec7,1,4,2,6,3,2014-01-29 16:06:23,2014-01-09 17:09:25
f09a78cd219b24d4308034c8dd13410cfe5fbec7...a9d0bbcfc6e45817f39f15a7c9b11305b4c04bad,1,0,2,2,1,2014-01-29 16:06:23,2014-01-29 16:05:11
c82a2d1adfb2b2a838a12e0c3baea1d42fe7f3ad...6cfe778c2cb6359b47cf646dc12824b58cc8d887,1,13,1,14,3,2014-01-29 07:10:39,2014-01-29 07:10:39
f6629bbbd53f8a296b3f29cd4958406b79e8b383...43899a77bf638d4baa42291c1988bcb2a75e8ef5,2,23,6,29,4,2013-11-20 01:12:37,2013-11-20 01:08:21
f6629bbbd53f8a296b3f29cd4958406b79e8b383...51a972f38d0b6e2e7a4b27509b58fc7a6e92679f,4,29,29,58,29,2013-11-19 11:27:59,2013-11-19 11:27:59
f6629bbbd53f8a296b3f29cd4958406b79e8b383...6dbeed89c061b85551ab638f93282d87de8ab929,4,13,4,17,8,2013-11-19 10:37:44,2013-11-15 07:02:09
6dbeed89c061b85551ab638f93282d87de8ab929...aea6001baf0cd0fb20a607e37e4379bf644b28fd,1,9,2,11,3,2013-11-19 11:13:22,2013-11-19 11:13:22
afbea3f13ffde3bdef33e05c735c3172715732d5...97088ebef7c638f8175d7c61934642eeb2c054c4,2,38,2,40,4,2013-12-05 01:50:20,2013-12-05 01:44:08
529c30261efeede3a101fc62a0f72cbf992b3b02...7b2d59b91e64e72e346747cf2e561be8afc87fa7,1,4,0,4,1,2013-11-14 17:42:12,2013-11-14 17:42:12
6d0b3f350e77b04f0270d0f719c2f40e8cd1bdda...52f31657cc03c0097e6fd0d5e1d2c10fb31d2b95,3,44,21,65,7,2013-11-08 18:17:51,2013-11-08 18:17:51
52f31657cc03c0097e6fd0d5e1d2c10fb31d2b95...ed1884461331d7c2d6561be30b09da9df6612d39,3,89,18,107,11,2013-11-08 19:10:33,2013-11-08 19:10:33
ed1884461331d7c2d6561be30b09da9df6612d39...08a276986c363c5b2e7435fb59935485c53aae59,3,11,11,22,11,2013-11-08 19:36:58,2013-11-08 19:36:58
47375ddf54bdc3eedd460e0385cfe03c468edcf0...e960152a1e9064d8c2ae57b9ab2a33d9b27276b9,2,39,1,40,2,2013-12-16 22:50:07,2013-12-16 22:50:07
fa48f17493d4f182294fe2228d7f5ecd53447ed5...fe956ad4495f0ed566bf20cb9cd10e0c54ccef6b,3,41,7,48,13,2013-12-16 22:37:56,2013-12-16 22:37:56
3ed0ff85f52b211746ffa10d968e43b9e3f93416...6ddea783ef8067b0c739785b6afd10d58255b4c9,2,183,0,183,2,2013-12-04 06:47:45,2013-12-04 06:47:45
3ed0ff85f52b211746ffa10d968e43b9e3f93416...0132547a385697f3fee1e6bf9fe3fa07c98f3fd0,1,1,0,1,1,2013-12-03 22:51:34,2013-12-03 22:51:34
3ed0ff85f52b211746ffa10d968e43b9e3f93416...45567f2209d3450142ae8042f674269902d58e3b,1,37,4,41,2,2013-12-03 21:55:55,2013-11-26 03:14:33
3ed0ff85f52b211746ffa10d968e43b9e3f93416...64439505c7801214d4e01941c2e92d64261ab137,1,8,0,8,1,2013-12-03 19:37:01,2013-12-03 19:17:59
3ed0ff85f52b211746ffa10d968e43b9e3f93416...d21563ced3a24ebfc8a9b53e5ec687543f7b2979,1,1,1,2,1,2013-12-03 19:49:10,2013-12-03 18:53:57
3ed0ff85f52b211746ffa10d968e43b9e3f93416...6a55169e2e0d039f7404b236b321fa7c76b99618,1,17,0,17,3,2013-12-03 18:04:18,2013-12-03 18:04:18
3ed0ff85f52b211746ffa10d968e43b9e3f93416...5976c26c1e7bc7b29489250b8100412ea3d27b60,2,45,0,45,2,2013-12-03 17:44:48,2013-12-03 17:20:14
3ed0ff85f52b211746ffa10d968e43b9e3f93416...b59dea67679fefcfe9716b855ef906b377d9993d,1,1,0,1,1,2013-12-03 16:04:53,2013-12-03 15:53:18
3ed0ff85f52b211746ffa10d968e43b9e3f93416...bbf9135adcaec9edc2e9d0ebce6a78ba3ade3689,1,22,0,22,3,2013-12-03 15:24:47,2013-10-22 18:48:29
bbf9135adcaec9edc2e9d0ebce6a78ba3ade3689...045989e3d824f577cd90a6386b66a5814e703766,3,70,44,114,37,2013-12-03 15:32:13,2013-10-22 18:49:13
045989e3d824f577cd90a6386b66a5814e703766...a02bc8a5dbca763a2a245cf0ca17ff5a21d5b52b,1,3,4,7,2,2013-12-03 15:32:13,2013-10-22 18:57:48
a02bc8a5dbca763a2a245cf0ca17ff5a21d5b52b...ec4863ae5582d8e7a9dccb57d7f5f3e21c2481ef,1,15,24,39,9,2013-12-03 15:32:13,2013-10-23 15:56:40
ec4863ae5582d8e7a9dccb57d7f5f3e21c2481ef...3b5010e90bd51ba3630f48091ed70111d26dd31a,1,2,4,6,2,2013-12-03 15:32:13,2013-10-23 16:00:40
3b5010e90bd51ba3630f48091ed70111d26dd31a...3f921639894d3eca72c9ae105d3ad4f386651caa,1,10,11,21,11,2013-12-03 15:32:13,2013-11-04 20:49:34
3f921639894d3eca72c9ae105d3ad4f386651caa...9be5db8704be5bda02484c374f4bd9b197d5701b,1,22,0,22,1,2013-12-03 15:32:13,2013-11-07 18:36:02
3ed0ff85f52b211746ffa10d968e43b9e3f93416...682cf48d1db0851789b593db732ed3801e765d56,1,65,0,65,1,2013-12-03 10:25:53,2013-12-03 10:20:29
3ed0ff85f52b211746ffa10d968e43b9e3f93416...48e1766527770da5ca4e7554f671705d721a5a04,2,20,2,22,4,2013-12-03 07:57:51,2013-12-03 07:57:51
3ed0ff85f52b211746ffa10d968e43b9e3f93416...62263967b91ca841c43b980aec0ebc74ab2d838d,1,10,1,11,2,2013-12-03 06:18:01,2013-12-03 06:18:01
62263967b91ca841c43b980aec0ebc74ab2d838d...3ddbb36a84d5530b1f6b496ff8d79ade6f539267,1,1,1,2,1,2013-12-03 07:17:07,2013-12-03 07:17:07
3ddbb36a84d5530b1f6b496ff8d79ade6f539267...b699aee91f90b8390dfa6e8ef58e983fc8c4f3e5,1,2,2,4,2,2013-12-03 20:35:22,2013-12-03 20:35:22
3ed0ff85f52b211746ffa10d968e43b9e3f93416...c4c90e9cec1b3f3cc5aa652e4e9155f6a2e687aa,2,8,1,9,2,2013-12-03 02:06:04,2013-11-30 01:24:30
c4c90e9cec1b3f3cc5aa652e4e9155f6a2e687aa...664174c7aa1300b9a856eafafc01a1d416a731ff,2,21,1,22,2,2013-12-03 19:09:10,2013-12-03 02:17:15
dfc2dc4d355cac57a7b119c6a1db49a1ca5c85fd...d6ca05f7cb6fd75a77967049c22eac7104d94633,1,4,9,13,4,2014-01-06 17:53:58,2014-01-06 17:53:58
4bdd4599f0aa539c3266e29917eef07ca38058b5...d215724ad6f70a783cb00b77f3c1a0cf9f69c83e,1,24,11,35,4,2013-12-19 19:51:46,2013-12-19 17:01:55
4bdd4599f0aa539c3266e29917eef07ca38058b5...8c52140059c83b9ef6f4f9336f162945cd360c4f,1,53,1,54,3,2013-12-19 19:27:47,2013-12-19 19:27:47
70c7220a990ba522a12baed8d8c7aa06af7f8547...fde909ffb8e09ae39310093b7389f61aa4ec29df,2,14,7,21,13,2013-12-18 18:57:21,2013-12-18 18:43:42
70c7220a990ba522a12baed8d8c7aa06af7f8547...fbac8125408c076317f3f51239394cd6b7351b49,3,3,7,10,4,2013-12-18 18:32:25,2013-12-18 18:25:08
70c7220a990ba522a12baed8d8c7aa06af7f8547...73a1ef7c22f5cde9db5e1292f1340885bf28e807,3,15,1,16,3,2013-12-18 18:16:48,2013-12-18 18:16:26
73a1ef7c22f5cde9db5e1292f1340885bf28e807...e481c82fa9521ecc719b29b314543a205c0b53ec,3,5,2,7,4,2013-12-18 18:18:49,2013-12-18 18:18:49
70c7220a990ba522a12baed8d8c7aa06af7f8547...c91c365f8860315d29a17368b78dcefb23674042,1,15,0,15,2,2013-12-18 18:15:09,2013-12-18 18:15:09
636dfc82b0c9aaddd5b0f5fb0f70797d5068c93e...566ff54d0ddffbeb3ba2e5f1e400db8528faf0a7,6,12,2,14,9,2013-12-20 17:12:03,2013-12-19 23:16:54
efaf2cac5c8d54a5098f7036e738e1f919f84452...484a75f3549239d0489cb0ad518d79ed6783584a,1,38,38,76,7,2013-12-30 06:27:01,2013-12-25 03:40:41
efaf2cac5c8d54a5098f7036e738e1f919f84452...360078d7613e1939c6d2f949ccac14c6ab9d568e,1,1,13,14,6,2013-12-26 23:39:06,2013-12-26 20:27:51
360078d7613e1939c6d2f949ccac14c6ab9d568e...1d4b7d8fa1af95ce83f263a49ed24e686fa7cb62,1,5,7,12,5,2013-12-26 23:43:27,2013-12-26 23:43:27
1d4b7d8fa1af95ce83f263a49ed24e686fa7cb62...fc9f4d8bad975ffe060eb741b38c5502dd9886a4,1,23,12,35,6,2013-12-27 00:01:36,2013-12-27 00:01:36
fc9f4d8bad975ffe060eb741b38c5502dd9886a4...894d4a23fba1a67087ae5bbe9c50c56e6dc09289,2,45,89,134,19,2013-12-27 00:16:26,2013-12-27 00:02:15
894d4a23fba1a67087ae5bbe9c50c56e6dc09289...cd735496da6d977748d5c3b19976f42d2cc1933e,1,6,2,8,3,2013-12-27 00:42:05,2013-12-27 00:42:05
efaf2cac5c8d54a5098f7036e738e1f919f84452...721bb410f6caa213b7d4eed9373be74287605ffc,2,2,0,2,2,2013-12-26 05:43:26,2013-12-26 05:43:26
efaf2cac5c8d54a5098f7036e738e1f919f84452...029625981d3872872f0de95c5a4ea68cb1fa93af,1,1,1,2,1,2013-12-25 20:49:58,2013-12-25 20:49:58
808f2d39bde6884f299d72097ed28604e27c9cbb...a1a4a99d7e80cadb97bf58963b76cd0c762888a6,1,4,0,4,1,2013-12-27 09:05:25,2013-12-27 09:05:25
808f2d39bde6884f299d72097ed28604e27c9cbb...4986958e7e61bb0439a59c46af000b157798b94a,1,5,1,6,3,2013-12-27 01:49:41,2013-12-27 01:49:41
8814c11b140fbcda266c5168340431044f59aa30...95f061b408eafbf981450d3fdb26ebc3188cba4a,2,7,10,17,8,2013-12-10 18:57:16,2013-12-10 18:57:16
8814c11b140fbcda266c5168340431044f59aa30...761184df5295b72c5d1ab4549dcddb54977da487,1,2,7,9,2,2013-12-10 18:49:53,2013-12-10 18:49:53
8814c11b140fbcda266c5168340431044f59aa30...78b85220be021bff022e40037693f42575e8ba8d,1,10,2,12,2,2013-12-10 17:59:32,2013-12-10 17:59:32
cdc07f7d5c00106d77d633c0df247c3b13f8b8d7...ac1093b83aee38243b0d6df3dd8aabc52062b9d2,1,57,48,105,17,2013-12-10 00:58:17,2013-12-09 18:43:58
ac1093b83aee38243b0d6df3dd8aabc52062b9d2...c618a906a4a50b4cc76e9230f971d737a59b8c27,2,3,3,6,3,2013-12-10 01:27:05,2013-12-10 00:59:42
cdc07f7d5c00106d77d633c0df247c3b13f8b8d7...776bb43c9e97824a2cb05353c68ef5645f3cc112,1,11,13,24,4,2013-12-09 20:46:21,2013-12-09 20:46:21
cdc07f7d5c00106d77d633c0df247c3b13f8b8d7...e2ee5c71fc665170db6a3a487aebb4d7f42eed0b,1,1,1,2,1,2013-12-09 17:25:20,2013-12-09 17:25:20
23ab0af2ff3083f475b67787cc5619ead5524948...1e85aabf710b2bc8d47027973fe19f4f10a5ba1e,1,9,0,9,1,2013-12-13 19:42:58,2013-12-13 19:42:58
23ab0af2ff3083f475b67787cc5619ead5524948...59dc2876a7d2ac0e231d7d97511e572a1d739136,3,39,1,40,6,2013-12-13 18:59:54,2013-12-09 03:20:55
4eda2a54de9d1033d5be4925ae4aa6fb3b4508d9...e8ec3dba7b1eb9254a04c852ffe7d98d10d0d476,1,5,4,9,4,2013-12-12 00:21:52,2013-12-12 00:21:52
e8ec3dba7b1eb9254a04c852ffe7d98d10d0d476...8874f2aef9ed12574160394fd7a6a254c0ef0526,1,2,2,4,2,2013-12-12 00:26:17,2013-12-12 00:26:17
5fd3c8204de3a8188097add6a75ca70536e1375a...81fc368a6d70ef369bd16a3c090c6910851faacf,1,2,2,4,2,2013-12-11 19:27:36,2013-12-11 19:27:36
a6928e70ace51793c15160e5f7206855abab89ff...58daccab26bb9bcdbf4b14c20cc6dd0b257aa6b3,1,1,1,2,1,2013-12-15 08:13:41,2013-12-15 08:13:41
a6928e70ace51793c15160e5f7206855abab89ff...12fb50826297c40dcfd047e8635f40c6824797ac,1,1,1,2,1,2013-12-14 14:00:52,2013-12-14 14:00:52
a6928e70ace51793c15160e5f7206855abab89ff...0a3eedd4c9d2bed208a85cd7aefae050a821eb6b,1,1,1,2,1,2013-12-14 05:29:08,2013-12-14 05:29:08
7fd64e0196fec3a3a30c6d3359989e1f83074207...3569d080afc721a1eb04ad4a65f1309b53da1238,3,26,10,36,8,2013-12-06 23:05:21,2013-11-25 01:05:59
7fd64e0196fec3a3a30c6d3359989e1f83074207...fdb3de7b11e4b85ec86f76aad51290730c037668,2,28,19,47,8,2013-12-06 23:02:27,2013-11-17 00:26:04
fdb3de7b11e4b85ec86f76aad51290730c037668...2546a2c645c59d094bc2c09dc9eb0d8eb5c36786,2,2,2,4,2,2013-12-06 23:02:27,2013-11-17 00:26:42
2546a2c645c59d094bc2c09dc9eb0d8eb5c36786...9b1930c5a07fe3f696ec54f5d429b8020cc9086f,1,1,1,2,2,2013-12-06 23:02:27,2013-11-18 20:17:51
9b1930c5a07fe3f696ec54f5d429b8020cc9086f...427bdb60e73ad059e813babd981168ea2464ea1f,2,15,9,24,9,2013-12-06 23:02:27,2013-11-22 03:41:17
427bdb60e73ad059e813babd981168ea2464ea1f...b98d51dddb081e4bf4f54cbc9c48ef123c2254d0,1,1,1,2,1,2013-12-10 23:37:03,2013-12-10 23:37:03
7fd64e0196fec3a3a30c6d3359989e1f83074207...228091c79ed043d1896afb04cd0573ee972c2607,4,25,3,28,9,2013-12-06 22:27:10,2013-12-06 22:27:10
228091c79ed043d1896afb04cd0573ee972c2607...8291f00a0e656cf3bb52fb1dcdff7c266305f4d5,2,14,12,26,4,2013-12-10 00:25:19,2013-12-10 00:25:19
7fd64e0196fec3a3a30c6d3359989e1f83074207...05f416d869777aa613a5a197ad287c18b77366d3,4,19,6,25,8,2013-12-06 22:09:27,2013-12-06 19:55:56
05f416d869777aa613a5a197ad287c18b77366d3...becb13dc26e8b40be4eec2da933705b2a378db35,1,2,2,4,1,2013-12-06 22:09:27,2013-12-06 20:02:21
becb13dc26e8b40be4eec2da933705b2a378db35...2c646b2d466b1401fccbfd453a68f0023dd5e300,1,2,0,2,1,2013-12-06 22:09:27,2013-12-06 21:56:09
5a4113140e4a9f00a2f3d97205fe7e146f955b4b...af753cbad8957f8c51852fdc26a25a8e43114938,2,33,0,33,3,2013-11-19 08:51:16,2013-11-19 08:51:16
e42b5745797a63608e63f9985cc2547c3b68ed69...0ed762f2d2ff613052b81d06509dac06b13fc0c9,1,15,0,15,2,2013-11-19 13:40:15,2013-11-19 13:40:15
e42b5745797a63608e63f9985cc2547c3b68ed69...242fd4b3ef32b5a20135d6031040bcf099b5df4e,1,10,2,12,4,2013-11-19 12:09:36,2013-11-19 12:09:36
e42b5745797a63608e63f9985cc2547c3b68ed69...5d76681c3d0cbb744205a397420603ce029ce754,6,35,18,53,9,2013-11-19 09:36:54,2013-11-19 09:36:54
9722c66dadace81be5db7326e2904e34591614bb...63fe64c471e7d76be96a625350468dfc65c06c31,2,6,1,7,2,2014-06-08 23:42:30,2014-06-08 23:42:30
5d07362a842a67c48158dfe0edd46aecfd6f66e0...0c611d9b15945fc6d94cc999684483421709a3df,1,1,0,1,1,2014-06-06 20:31:10,2014-06-06 20:31:10
5d07362a842a67c48158dfe0edd46aecfd6f66e0...e2119f3050b225ccaf25990e5d6714dae2de7afe,1,11,19,30,3,2014-06-06 20:11:21,2014-06-06 20:11:21
5d07362a842a67c48158dfe0edd46aecfd6f66e0...92f46d233e69a2134ddeaa4843d4b99be00de096,1,1,0,1,1,2014-06-06 19:13:25,2014-06-06 19:07:02
81041b3ba696250b9da719875d6c41312c4cc046...d60301edb88a4e182a10cd2becb3795b2dd13fab,1,3,2,5,2,2014-05-08 07:03:45,2014-05-08 07:03:45
a6b7e94696558134757fe3b7dcd912db37668f69...4c2b9d732446adb472667c2a7017ba3e8cc58c0d,3,9,9,18,7,2014-05-09 07:14:37,2014-05-09 07:09:33
931f0655606b14ef6fab1952d442691d1007f6ef...449f92f11ed34d4475fa24e2561b02cc263722bf,1,4,1,5,2,2014-04-13 12:06:15,2014-04-12 00:49:49
931f0655606b14ef6fab1952d442691d1007f6ef...0a0e49d406d10ce7c79952c78162768dd05ee875,1,7,2,9,2,2014-04-12 10:57:19,2014-04-12 10:57:19
931f0655606b14ef6fab1952d442691d1007f6ef...26845ef1ae97be3904b2fd85fa06f9a97ccee67c,1,9,0,9,1,2014-04-12 02:09:06,2014-04-12 02:09:06
931f0655606b14ef6fab1952d442691d1007f6ef...4f169c2db512d2ea9ed5729df375896a1ee90347,4,15,7,22,8,2014-04-11 20:39:58,2014-04-11 20:39:58
4f169c2db512d2ea9ed5729df375896a1ee90347...84a76f27962d4f4b3871abe925ca17024bdeea73,1,19,0,19,1,2014-04-14 02:36:15,2014-04-14 02:34:22
931f0655606b14ef6fab1952d442691d1007f6ef...031fcb31d3a81fbd5c5ab8d898d53fbd486413e6,2,45,19,64,11,2014-04-11 17:28:27,2014-04-09 11:43:19
031fcb31d3a81fbd5c5ab8d898d53fbd486413e6...505184d2dcb5d21834bcb2b108564fbdab733953,1,42,12,54,4,2014-04-11 17:28:27,2014-04-11 17:27:19
505184d2dcb5d21834bcb2b108564fbdab733953...4ddfffcab3edf3d05ee8319e87410fe747979a04,1,6,0,6,1,2014-04-11 17:29:40,2014-04-10 18:08:56
e5ad715e5964bc64e098070d1ca72b110c337d1a...720f3447046355329b5ba5d850caca84328182d5,3,40,10,50,10,2014-04-18 15:42:54,2014-04-14 18:32:47
e5ad715e5964bc64e098070d1ca72b110c337d1a...32d8b5da5080cf4ef9f27636d1ee52c8b79eb890,1,1,0,1,1,2014-04-15 21:33:14,2014-04-15 01:10:25
e5ad715e5964bc64e098070d1ca72b110c337d1a...d61fce9af770f0adaf4f178a5217dd46a02dd201,2,9,7,16,3,2014-04-14 23:15:38,2014-04-14 23:15:38
e5ad715e5964bc64e098070d1ca72b110c337d1a...a7e181c8576e0413da888bea95fb7155173714ea,1,18,0,18,1,2014-04-14 20:40:23,2014-03-22 03:02:30
a7e181c8576e0413da888bea95fb7155173714ea...ca7a0e6d6e31c02baf692315d2481ef35a7e9134,1,20,10,30,10,2014-04-14 20:40:23,2014-03-22 03:03:09
ca7a0e6d6e31c02baf692315d2481ef35a7e9134...3754fdd7caae423b606c6fb5160683534a830a1a,12,312,137,449,17,2014-04-15 14:16:51,2014-03-20 15:52:12
e5ad715e5964bc64e098070d1ca72b110c337d1a...7bb72fa080d13c3b90d624cb77530632c7705c56,2,8,1,9,2,2014-04-14 19:35:54,2014-04-14 19:35:54
e5ad715e5964bc64e098070d1ca72b110c337d1a...5f4bc4f916f433a4ba258980a6c2fbdbd76d64f3,2,21,35,56,16,2014-04-13 23:31:10,2014-04-13 14:20:04
5f4bc4f916f433a4ba258980a6c2fbdbd76d64f3...052cc5a6378ee4bbe1ef79e5632e2439d68ddbde,7,4,4,8,8,2014-04-13 23:33:25,2014-04-13 23:33:25
052cc5a6378ee4bbe1ef79e5632e2439d68ddbde...6c26a87901d12188dfd9986d9211f6077a286f9d,1,8,4,12,2,2014-04-14 00:03:35,2014-04-13 23:37:12
6c26a87901d12188dfd9986d9211f6077a286f9d...3061a6a2ab0395c626f9acaa2e5d9c17152b0475,2,107,46,153,7,2014-04-14 05:22:45,2014-04-14 05:22:45
3061a6a2ab0395c626f9acaa2e5d9c17152b0475...ac814ee3c76a3851d361e8dddfed7ac93ddf10e2,1,2,0,2,1,2014-04-21 17:28:04,2014-04-21 17:28:04
a5515d27e5da9c4442fa9800b8995236d4b5ef2f...060da572d20dfeee4fe02ce6b975a6cb33e50dbe,1,10,6,16,7,2014-02-21 07:07:44,2014-02-21 06:42:31
a5515d27e5da9c4442fa9800b8995236d4b5ef2f...e59485e148f5d1ab0cf5ec18ca3bb7c684e8cf7b,1,10,1,11,4,2014-02-21 03:51:08,2014-02-21 03:51:08
ea0cce6270471686a41a67b84c63edfd09f8adb8...937ea1d3805771b0e5763f336f9d64e5996c2c95,1,3,3,6,2,2014-02-20 17:18:27,2014-02-20 17:18:27
ea0cce6270471686a41a67b84c63edfd09f8adb8...42b97be441f5272ead365c3400b91fb756565b1a,1,20,0,20,1,2014-02-19 23:54:24,2014-02-19 23:53:15
d45538f2431ed385bedcf5e11a9104fdee096073...b829e96cde4f798bc21f05a763b2f6a623dfe1eb,3,60,0,60,4,2014-02-20 18:31:04,2014-02-20 15:16:45
d45538f2431ed385bedcf5e11a9104fdee096073...ef826621585a62d9b563e8ab2fd72f731b14817c,1,1,0,1,1,2014-02-20 13:51:39,2014-02-20 13:51:39
d45538f2431ed385bedcf5e11a9104fdee096073...d19e998e7a99d24122da3e98d9886e3b7b4b3501,2,61,0,61,2,2014-02-20 08:23:34,2014-02-14 13:24:37
d19e998e7a99d24122da3e98d9886e3b7b4b3501...c8428d77fdde41786aa5c0c4e64e0e762f873676,1,6,0,6,1,2014-02-20 08:23:34,2014-01-15 14:05:30
c8428d77fdde41786aa5c0c4e64e0e762f873676...87ca750cdc3114a340af1c5bc9394cc5f6242677,1,10,5,15,4,2014-02-20 08:23:34,2014-01-17 09:51:59
87ca750cdc3114a340af1c5bc9394cc5f6242677...3b9953903b12eaca76655311bd44533768f6f3da,1,7,0,7,1,2014-02-20 08:23:34,2014-01-20 11:26:08
d45538f2431ed385bedcf5e11a9104fdee096073...9f1c69ca7b1b2afd96b4d154431395ee48ada97d,1,21,2,23,2,2014-02-20 03:49:15,2014-02-20 03:49:15
f1167096ca053e44a478a0cfc760f9fdf951a2c1...4bfc8e97222b8908176d2420060bbeae613a571c,1,22,0,22,3,2014-02-22 16:25:52,2014-02-19 21:30:01
fb314c266b188de8aa0499c5314b01fd5d088475...15e52ccaadea996b409e2f62bcbdb1a088619e35,1,2,2,4,1,2014-03-11 17:11:05,2014-03-06 04:45:18
fb314c266b188de8aa0499c5314b01fd5d088475...46fdb6af8ecc804b204fc93ab6d8d4a5f7503860,1,0,1,1,1,2014-03-06 17:47:03,2014-03-06 16:01:18
fb314c266b188de8aa0499c5314b01fd5d088475...3e8a02a9399618917194b37435f5eed9ff86fe2f,1,38,1,39,12,2014-03-06 17:36:03,2014-03-06 17:14:56
3e8a02a9399618917194b37435f5eed9ff86fe2f...81f148be566ab2b17810ad4be61a5d8beac8330f,1,7,3,10,3,2014-03-06 17:36:08,2014-03-06 17:25:43
fb314c266b188de8aa0499c5314b01fd5d088475...1cdd775f5d95c4da2895da85b00ffa2917bbf9b0,1,7,0,7,1,2014-03-06 14:12:09,2014-03-06 14:12:09
fb314c266b188de8aa0499c5314b01fd5d088475...5c9b28db1853cccdf7a1037eeaad372d12cd68fa,4,8,9,17,11,2014-03-06 13:10:32,2014-03-06 13:10:32
19e01a63630737b43dd13cc3cac57b158ff25de1...0a0406450fb83f4ff7d08235cd3e94ea8fba752f,1,2,2,4,2,2014-02-10 20:48:43,2014-02-10 20:44:34
bb43761940848650c1eab3c097d826892bd5b140...c5632622391921160687f3e0155bdfe3d3cfc07d,5,97,14,111,16,2014-03-11 00:36:32,2014-03-10 20:38:17
c5632622391921160687f3e0155bdfe3d3cfc07d...10dc16dcd3aa82be256e5072a25dcf18af8e3844,5,121,150,271,7,2014-03-11 00:36:41,2014-03-10 20:50:16
10dc16dcd3aa82be256e5072a25dcf18af8e3844...157f24ca77a38f7c5c2b22322a2a353d5098a21e,7,66,81,147,15,2014-03-11 00:36:47,2014-03-10 21:22:27
bb43761940848650c1eab3c097d826892bd5b140...802407a099705a91017fbaa1b6820f145f580d86,3,85,0,85,4,2014-03-10 22:18:54,2014-03-10 20:21:30
802407a099705a91017fbaa1b6820f145f580d86...6ccfb7fb9af207a9999c60e57d1c9486ca949a5e,3,3,3,6,3,2014-03-10 22:19:08,2014-03-10 20:25:00
6ccfb7fb9af207a9999c60e57d1c9486ca949a5e...3c25302a0b9fae2c3fff9262b2ae9fa5f6f04db7,1,1,1,2,1,2014-03-10 22:34:38,2014-03-10 22:34:38
524416560a4624d30023db32101c9fe5ebffc895...3a7c144e9992591f32daf2d4f1b35b7b6520a07e,1,4,2,6,3,2014-02-10 01:14:17,2014-02-10 01:12:43
6da1e092dc222b17a296009de55d8216dfcfe612...e08a1c53aa5a19a17d40d41accbab040611c4411,3,10,11,21,5,2014-02-12 03:59:52,2014-02-12 01:48:50
e08a1c53aa5a19a17d40d41accbab040611c4411...e6e320acc757f22e113da755293583402c6c1e7c,5,29,15,44,11,2014-02-12 03:59:52,2014-02-12 02:46:55
a4d1da709eae456888a3bdc35cd7a04a06ead7cb...408ea0771a9cb3046b8e484dcfefe5233fcbb27a,3,7,0,7,3,2014-02-14 01:23:09,2014-02-14 01:23:09
f794fbc2306e633916b7f000d441d234e198fc24...cad7f7ee5002206511daee4a29f399e6665f5fab,1,26,10,36,2,2014-02-14 01:18:38,2014-02-14 01:18:38
f794fbc2306e633916b7f000d441d234e198fc24...c7840f522c37d2c964e442c5acac745f702b8801,1,12,1,13,2,2014-02-13 17:27:45,2014-02-13 17:07:53
da3e53913388ebc89066bb5de06bcebc2e6c5854...d35b03ef8db9d773937133277cc16364a551ab74,1,3,0,3,1,2014-02-11 23:09:06,2014-02-11 22:26:19
da3e53913388ebc89066bb5de06bcebc2e6c5854...35821ad78f4ad2b20cf839ecc5a73b44c568c5eb,2,3,2,5,3,2014-02-11 14:21:53,2014-02-11 14:21:33
6dd1bb9eb08dc144bc172b0052df7c3904896e56...9e3da87a3a6fea21194ceb9dbd30a39d043a48a4,3,1,22,23,5,2014-02-15 01:28:50,2014-02-15 01:28:50
6dd1bb9eb08dc144bc172b0052df7c3904896e56...bd54d40f68f78093d6a252e96f8d17f7021af7b5,2,339,301,640,10,2014-02-15 01:15:40,2014-02-15 01:15:40
6dd1bb9eb08dc144bc172b0052df7c3904896e56...8c39db8f96ac2a7ec479a679bc060410cee1a567,9,25,25,50,17,2014-02-14 23:48:05,2014-02-14 23:25:25
8c39db8f96ac2a7ec479a679bc060410cee1a567...055f1a1f8181d51d3386b4270f810efd59d51d30,2,7,17,24,13,2014-02-17 21:31:13,2014-02-17 21:31:13
6dd1bb9eb08dc144bc172b0052df7c3904896e56...055bfb699bb232c7e490c38d3a71c81870781c74,2,0,71,71,2,2014-02-14 23:32:39,2014-02-14 23:32:39
6dd1bb9eb08dc144bc172b0052df7c3904896e56...106079daca36e8c5595c3f05eb183c9919016e4e,1,0,6,6,5,2014-02-14 23:17:12,2014-02-14 23:17:12
d4ea6308fd0593a50c9f245a8dfd4db8cba8c297...db250f709ad5bcee313710d34e0b6ef02abdc326,1,17,0,17,1,2014-01-28 19:11:49,2014-01-25 04:22:53
53ee1daa699ab28fdd37d77b2cfbb0fc14dc0fdb...90494600d357d01310d8da1310b6ad02f56de22c,4,502,483,985,6,2014-01-31 20:04:44,2014-01-30 00:59:21
90494600d357d01310d8da1310b6ad02f56de22c...c712e74b45005e0f38297d254fb606aa18606d11,5,131,89,220,48,2014-01-31 20:04:44,2014-01-30 02:34:43
c712e74b45005e0f38297d254fb606aa18606d11...2d8709696c80e992a5b20ba7a00ca3268c57c11c,3,6,4,10,4,2014-01-31 20:04:44,2014-01-30 19:25:06
2d8709696c80e992a5b20ba7a00ca3268c57c11c...49b9813035b3abb445ef7238f034897fa03a9652,3,11,3,14,5,2014-01-31 20:04:44,2014-01-30 19:50:59
49b9813035b3abb445ef7238f034897fa03a9652...2df01661071e949faabf1fa9ba612c40710b686b,2,27,22,49,7,2014-01-31 20:04:44,2014-01-30 20:02:56
2df01661071e949faabf1fa9ba612c40710b686b...167403988dca37060edf37abbdd28360ee0d5d4a,3,80,48,128,12,2014-01-31 20:04:44,2014-01-30 20:43:49
167403988dca37060edf37abbdd28360ee0d5d4a...1d4de9ce1fe2c113cd7e9fcb6055b95c94c65b06,3,26,6,32,9,2014-01-31 20:04:44,2014-01-30 22:52:59
1d4de9ce1fe2c113cd7e9fcb6055b95c94c65b06...a11bee44d74235ec436c1b2272dc9f718497f88c,1,1,1,2,1,2014-01-31 20:04:44,2014-01-31 18:20:03
a11bee44d74235ec436c1b2272dc9f718497f88c...50fea8978257141bf85669b9d757bf184f886a1b,1,2,5,7,3,2014-01-31 20:07:51,2014-01-31 20:07:51
50fea8978257141bf85669b9d757bf184f886a1b...cb3bd91689b9beaaa4e287e126bc8150b5161c57,2,2,2,4,2,2014-01-31 20:18:45,2014-01-31 20:18:45
a0d82b17c7093ec6d98e4d8fce1057bcf403948d...7b2ec7fb2d13776ab02b63f32821519621b2c4e8,1,12,0,12,2,2014-01-31 13:57:18,2014-01-31 13:48:06
7b2ec7fb2d13776ab02b63f32821519621b2c4e8...ce74c8b4d2e68256d85063ee237c8d41174b27c3,1,4,0,4,1,2014-01-31 13:57:30,2014-01-31 13:50:07
a0d82b17c7093ec6d98e4d8fce1057bcf403948d...d86c1b064dad349737b4a423fe8d0c42db4ca45e,2,27,1,28,3,2014-01-31 07:10:19,2014-01-31 07:05:16
a0d82b17c7093ec6d98e4d8fce1057bcf403948d...2b52d6e801dd888e1f5759448da025e0ddcffedd,4,127,148,275,66,2014-01-31 03:59:14,2014-01-25 07:15:40
2b52d6e801dd888e1f5759448da025e0ddcffedd...24086fa75dff1ebb56dfb8fbf2c80fdfd5be0e8a,2,154,302,456,152,2014-01-31 04:01:46,2014-01-28 00:27:02
24086fa75dff1ebb56dfb8fbf2c80fdfd5be0e8a...8fbdb7b59eba078bf24546686e005cc86a60e493,4,38,13,51,11,2014-01-31 04:01:46,2014-01-28 03:26:24
4a708f9f5b394f7e669de49b80f832ceda5b6876...e8ee18fa2993bd47069ba582889b0c83a68f3d43,2,48,27,75,18,2014-01-24 23:34:08,2014-01-23 01:33:29
6a1ee89d2dcd5f2ab99e203862eed4dd8675b070...bf1f655fa2b5112301102f9191e0f0deb68975f1,1,0,46,46,1,2014-01-31 23:50:34,2014-01-31 23:50:34
6013cbdce85b18a963750195c53f8676c5979690...238dba831a74c89fe8f5aabc836e6b75da577c97,1,1,1,2,1,2014-01-30 18:51:25,2014-01-30 18:51:25
6013cbdce85b18a963750195c53f8676c5979690...7d95ce6ddda89a392b94c6dcfcb7774b2a19cf1a,1,1,1,2,1,2014-01-30 04:07:23,2014-01-30 04:07:23
6013cbdce85b18a963750195c53f8676c5979690...c914abaf15634d8039927176dfc5ff3c765f30d0,1,17,6,23,5,2014-01-30 01:18:11,2014-01-30 00:49:42
6013cbdce85b18a963750195c53f8676c5979690...54072dbbd6260a9d8a7249cae0bd17513f15c3fc,5,24,24,48,23,2014-01-29 20:31:49,2014-01-29 20:31:49
6013cbdce85b18a963750195c53f8676c5979690...94c5f51c4a38422489f0f629d43958b282600111,1,3,0,3,1,2014-01-29 20:13:32,2014-01-29 20:13:32
6af6b72023d68031e73aaf092bb7803ce38af95c...6d1c0a91f89887bd0d73b161b1ffe8b9cc10365e,1,2,0,2,1,2014-02-18 18:24:33,2014-02-18 18:24:33
6af6b72023d68031e73aaf092bb7803ce38af95c...6ccb30a0e5d1146dddaec340643d3950e6f992ef,2,2,2,4,2,2014-02-18 18:23:37,2014-02-18 18:23:37
57c4f7185d18db964f90b10c494eaf271f4d8aa9...349adf4d4df63cd35ecfd74aa21de01629964ea5,2,4,0,4,3,2014-02-18 20:08:09,2014-02-18 20:08:09
518670f3d82ad8f0a9568ef5231d5e4af26860b2...d55cc64c4eb66c4ee536514e35e2e2094aa3d911,1,1,3,4,1,2014-02-17 23:25:00,2014-02-17 23:25:00
d55cc64c4eb66c4ee536514e35e2e2094aa3d911...e23190b6b3ddd16b3a5f951a33e05fd75ebb8970,1,1,1,2,1,2014-02-17 23:29:52,2014-02-17 23:28:30
e3c3f3c324e37536cc582f91b8963ba10d337417...fb810b54ff404e81bd2486a944e24583a55fe8bf,1,8,2,10,1,2013-12-05 22:41:56,2013-12-05 22:41:56
7428e6a5f0edae5ff5f95a96dbb6eeb734ffb59c...3264c1c5eb41d4504a813d955fdd9d3a0da8c2dd,1,46,0,46,1,2013-12-24 03:01:10,2013-12-24 02:11:18
7428e6a5f0edae5ff5f95a96dbb6eeb734ffb59c...eac95671f50a65279f8c39341c4f3be680add98a,2,148,0,148,2,2013-12-05 22:40:33,2013-12-05 18:02:19
7428e6a5f0edae5ff5f95a96dbb6eeb734ffb59c...84f78d9cad4162ddfc1bccbe55402050123cb1c5,1,40,36,76,2,2013-12-03 22:35:54,2013-12-03 22:35:54
84f78d9cad4162ddfc1bccbe55402050123cb1c5...40fe9f581bd56bbcab9f231763cfac20e659d8c3,1,165,148,313,5,2013-12-03 23:58:31,2013-12-03 22:47:49
2fd76fc0b826524cd6d133fb8163cf6066b8ce03...00030ced4bf2d0242883fae0b4ece61149f1d437,1,18,10,28,6,2013-12-04 23:56:01,2013-12-03 22:51:43
1636ed9826440e11dbcc4cd89a02082368896f78...cd89fe5c4f342adae870a04f04729e3b50ae20ea,1,1,0,1,1,2013-12-19 20:42:35,2013-12-19 20:42:06
f21bd80e90af12745c7a8bf98d84ec50c3295987...85f9b778f54a823566dd5d81e0e0a9875a64569d,4,16,11,27,7,2013-12-21 00:55:41,2013-12-19 20:32:58
f21bd80e90af12745c7a8bf98d84ec50c3295987...0e6f0c4e02f4a29a1495f68f8aa52c5a10f587da,5,42,2,44,9,2013-12-19 19:51:44,2013-12-19 04:41:34
553b4dae453fccf3dee1e36099cc5bb67129f69f...536da93380f1cacb82c344ad09c2daaae29f8ac3,3,6,2,8,3,2013-12-18 21:57:49,2013-12-18 19:40:00
f768c6adb766bda5a74e9a5131698e6a75c47882...45d7dcfea276841cce782feced3a2eb3eab01208,4,209,33,242,16,2013-12-18 21:46:02,2013-12-17 22:04:37
45d7dcfea276841cce782feced3a2eb3eab01208...a6fdc5d208b6726a33d30bd25ab115131a298b90,4,148,44,192,20,2013-12-18 23:24:08,2013-12-18 02:40:20
a6fdc5d208b6726a33d30bd25ab115131a298b90...7bc96aec7bf978e87cb87935bd55f85e2cb1664a,12,243,227,470,25,2013-12-19 00:42:49,2013-12-19 00:42:49
aa619de748e2337f6bb7aac62c212811ac709c1e...f50b8b08b5742c8e55df2d610d428c39cf1f4947,2,19,2,21,2,2013-12-29 00:42:18,2013-12-21 00:30:41
aa619de748e2337f6bb7aac62c212811ac709c1e...7d2e851d8e921bf8f07f54c8afb8262580b36e8d,1,1,1,2,1,2013-12-21 01:54:54,2013-12-21 01:30:21
aa619de748e2337f6bb7aac62c212811ac709c1e...8dcca2125a2176924ea9d816214d88b8b6450bf2,1,22,20,42,9,2013-12-21 00:26:02,2013-12-21 00:26:02
aa619de748e2337f6bb7aac62c212811ac709c1e...c995c9bb91a2bf5b2038330d063a073d2e0c611c,1,63,0,63,1,2013-12-20 23:52:34,2013-12-20 23:52:34
efde305c05fe1969b6116f4ee777e5c37d30d139...8051b6c1a1f9c381d42f5c776020658700c63c57,2,467,11,478,7,2013-12-20 18:34:05,2013-12-20 18:34:05
efde305c05fe1969b6116f4ee777e5c37d30d139...e4561438f1156a96ee7fd2e25a8b9e6a3831fa83,3,13,9,22,6,2013-12-20 16:19:25,2013-12-20 16:11:35
e4561438f1156a96ee7fd2e25a8b9e6a3831fa83...f9359f59a88f109a7764406c33529a20098b0c7f,2,4,1,5,3,2013-12-20 16:20:08,2013-12-20 16:20:08
efde305c05fe1969b6116f4ee777e5c37d30d139...b8cd2bc94d58e9ca1c6f9a41979b857cfa4b698f,1,1,1,2,1,2013-12-20 15:19:21,2013-12-20 13:02:10
efde305c05fe1969b6116f4ee777e5c37d30d139...f7ba1c34bb7670b1a8d761b73eb9a775fa0f6bbe,2,16,0,16,4,2013-12-20 13:13:52,2013-12-20 12:26:11
efde305c05fe1969b6116f4ee777e5c37d30d139...df87919165e8874fe53d9405e3833bbaff4f0147,1,20,0,20,1,2013-12-20 10:06:07,2013-12-18 23:29:46
efde305c05fe1969b6116f4ee777e5c37d30d139...733bf5d3ddbfb6dba7c2c0996c4af47a765e4593,2,3,2,5,3,2013-12-20 05:41:22,2013-12-20 05:41:22
392b1e99b2ec9c368f81cca99093a406ae3697b9...fd240413ff835ee72741d839dccbee24e5cc410c,1,48,22,70,15,2013-12-30 23:09:57,2013-12-30 10:44:02
22162687df146f381d73bdea90b2f016f001ce91...fc197188d7f4098b6035d0e13031431871a2dc95,1,1,1,2,1,2013-12-30 15:38:43,2013-12-30 15:38:43
22162687df146f381d73bdea90b2f016f001ce91...c6dcee329dc9e720d70d9534c261fe9e9cf80512,1,30,0,30,2,2013-12-30 07:10:48,2013-12-30 07:10:48
22162687df146f381d73bdea90b2f016f001ce91...434cf6c8ca5d20306dc27e770155ba05a931adec,2,8,3,11,4,2013-12-30 03:22:52,2013-12-30 03:22:52
22162687df146f381d73bdea90b2f016f001ce91...83d631b6a455d3041b7cb31e1c7eb45a16715c43,1,1,1,2,1,2013-12-29 20:25:57,2013-12-29 20:25:57
22162687df146f381d73bdea90b2f016f001ce91...8b82b0dfe74684b5ea30b7487475f7ca4abcc58e,3,12,1,13,4,2013-12-29 19:36:46,2013-12-28 21:16:03
22162687df146f381d73bdea90b2f016f001ce91...e93b7b464733470a08a46b9937678fbfdff0abb0,1,5,0,5,1,2013-12-29 11:27:59,2013-12-29 11:27:59
22162687df146f381d73bdea90b2f016f001ce91...06a818616bfce86e90152aeaffaf9394a085c356,9,0,0,0,0,2013-12-29 08:46:00,2013-12-29 08:46:00
22162687df146f381d73bdea90b2f016f001ce91...cda146547e59ff875b3eb6202a87004a3f7ea96d,1,3,2,5,3,2013-12-28 13:35:00,2013-12-28 13:35:00
22162687df146f381d73bdea90b2f016f001ce91...a17fd7b294e1334788e1812f8cc1a99e5300724b,1,1,1,2,1,2013-12-28 10:22:46,2013-12-28 10:22:46
907d9ce13c6a7e621ff54fe9d81e4d411031ed33...c561212b837735213f146c2fac291f84dbcbc8c3,8,175,95,270,22,2014-01-02 22:54:57,2013-12-21 16:02:06
bd292759f03688cfa22f885572cae6e5cbfc4d77...f396c42cad2b23dae5e3296c18fd6190f210c022,6,148,15,163,14,2013-12-12 00:31:02,2013-12-12 00:31:02
f396c42cad2b23dae5e3296c18fd6190f210c022...8fd9633a6bb136af6666626a76056b1592fef0c7,5,51,40,91,26,2013-12-12 01:19:02,2013-12-12 01:12:53
bd292759f03688cfa22f885572cae6e5cbfc4d77...eec48f93a36873b8255c1c533b0d2bfbd742f9fa,1,8,14,22,8,2013-12-11 20:34:51,2013-12-11 20:34:51
eec48f93a36873b8255c1c533b0d2bfbd742f9fa...31961ccd94bc2d0941d3062591206a58b3b451a1,1,2,2,4,1,2013-12-11 20:36:12,2013-12-11 20:36:12
31961ccd94bc2d0941d3062591206a58b3b451a1...42c38bf34dff7a5af4c75646b7252d3ecbdd334a,1,3,1,4,1,2013-12-11 21:59:35,2013-12-11 21:59:35
42c38bf34dff7a5af4c75646b7252d3ecbdd334a...db3019d50b7a38dd52d8ad959017c63b04f11462,1,1,1,2,1,2013-12-11 22:00:46,2013-12-11 22:00:46
db3019d50b7a38dd52d8ad959017c63b04f11462...d534e1c3a1e00786d63e9dbeffceb6ab7f51c92b,1,16,7,23,6,2013-12-11 22:20:54,2013-12-11 22:20:54
d534e1c3a1e00786d63e9dbeffceb6ab7f51c92b...44984602c7c7460454531c22ee4dfab2a34fa334,1,3,3,6,2,2013-12-11 22:36:14,2013-12-11 22:36:14
bd292759f03688cfa22f885572cae6e5cbfc4d77...bef8de93194a442c21481f0b7e72f2fac781f799,2,3,4,7,4,2013-12-11 19:52:59,2013-11-20 07:37:03
bef8de93194a442c21481f0b7e72f2fac781f799...dbe1915fee1beb034459fb875928c96e27ecbfce,3,34,16,50,9,2013-12-11 19:52:59,2013-11-17 03:00:16
dbe1915fee1beb034459fb875928c96e27ecbfce...6ba456ff87cfe2687db7df896e2983636ca9fe1e,3,11,16,27,5,2013-12-11 23:36:50,2013-12-11 23:36:50
0ef1ff91cbcb48463a0cfdfb6fb040e7beadd045...a530b8d9818126e04207de619af8578a4ec4c590,1,5,1,6,1,2013-12-13 18:39:49,2013-12-13 18:39:49
b722f809e751dd33371c46e3fe63c63aea405724...e43ff2f6f2630f971c9494aed285f1d410e42df9,5,32,25,57,16,2013-12-12 19:52:11,2013-12-12 01:52:41
f0d6a91a1b1de6bf44df678ce16d694fe197eee0...81d112cb7fc19e4919f9916c08d8409c74aa117a,1,1,1,2,1,2013-12-17 17:38:55,2013-12-17 17:38:55
4c2624a277195c9a0d6fabca29cf3a769e1e6482...3edb4af663079ad79672bc98fcd20790f8fb2589,1,39,7,46,8,2013-11-19 08:35:03,2013-11-19 08:35:03
7030cdce59f5ae50220ea72c26a7f8b6a125c0ca...49376ec4483c241167f7623ccc0260486ce8d4a3,1,1,1,2,1,2014-06-20 01:06:48,2014-06-20 01:06:48
07e9ac9ffedc07b92ac446fc6a9e7ad1f21e3301...faf5ef6f80632db948e112fcb1e29a53562ad0c8,1,1,1,2,1,2014-06-09 14:14:51,2014-06-09 14:14:51
63fe64c471e7d76be96a625350468dfc65c06c31...e827c8ff61a0e71b77bfb7a73c2e45703c1f470a,3,71,1,72,3,2014-06-09 15:45:54,2014-05-02 19:16:46
0c611d9b15945fc6d94cc999684483421709a3df...a59e1949b5ad448814ed2a4de93beca13062e590,1,2,2,4,2,2014-06-07 14:43:40,2014-06-07 14:43:40
f7e4546af0daac44deaf59110529ebda483005fb...fa72eb3a58ebfec8ef1b27d8e7aa8cbdb41733a2,1,1,0,1,1,2014-06-07 22:18:18,2014-06-07 22:18:18
f7e4546af0daac44deaf59110529ebda483005fb...daa89c420caac0881b09e2a36feff977ec43d7cd,2,2,2,4,2,2014-06-07 21:17:56,2014-06-07 21:17:56
8f6162f17ba6684641312526b2bfd8b39607b714...3e4e8636c1b05626cae720b47ef99109077e1d3a,4,5,4,9,5,2014-06-17 00:06:21,2014-06-17 00:06:21
3e4e8636c1b05626cae720b47ef99109077e1d3a...614c57c52161c0440247a4e4e36808116214770e,1,10,2,12,2,2014-06-17 00:59:51,2014-06-17 00:59:51
614c57c52161c0440247a4e4e36808116214770e...6228761f67bb5f2af6c3105de556fa3fedb12069,1,56,4,60,2,2014-06-17 01:05:13,2014-06-17 01:01:38
6228761f67bb5f2af6c3105de556fa3fedb12069...d3bc787bca62edff384e06a12224be2d982353da,2,17,2,19,3,2014-06-20 18:38:17,2014-06-17 13:05:29
30a40de205c6c29ae8e2379c39d69186ef04bf6e...1d15c0b491afc6b32206d62ee3f50448b89b8d49,1,1,0,1,1,2014-05-12 20:51:45,2014-05-12 20:51:45
30a40de205c6c29ae8e2379c39d69186ef04bf6e...905795ece624675abe2ec2622b0bbafdb9d7f44c,3,3,0,3,3,2014-05-12 19:41:04,2014-05-07 13:08:52
ca49da41ee7a3ae61c1abf1b4dccec929522ead5...2cb184ade59ccb578d50f5ff535d1d02e7855563,4,49,9,58,9,2014-05-27 17:56:11,2014-05-27 17:56:11
2cb184ade59ccb578d50f5ff535d1d02e7855563...a14a88e53dc71b1013d7b629d23d3908d15d57f4,1,8,8,16,5,2014-05-27 18:05:48,2014-05-27 18:05:48
a14a88e53dc71b1013d7b629d23d3908d15d57f4...e471a87f1975a101cf7464c0c2cc48db3b79ec26,3,19,16,35,10,2014-05-31 21:44:17,2014-05-31 21:44:17
e471a87f1975a101cf7464c0c2cc48db3b79ec26...2858180a9a05dad999df0f4d9adc9750b0fb1c66,1,4,4,8,4,2014-06-01 23:16:14,2014-06-01 23:16:14
370b935b4987c79eec769b0cc3788726a3f8abc9...6a2bdc6eb769ffd1d8438f321953dde8b341b783,1,82,0,82,1,2014-04-15 07:59:42,2014-04-13 14:52:21
425b3156953191707f002fb36e5f14b0355e9a3c...bba1dd046dd39405877c9f0b53502e68dddf36b1,4,101,7,108,11,2014-04-28 17:38:58,2014-04-28 17:38:58
425b3156953191707f002fb36e5f14b0355e9a3c...abf3baf4ebfb8128ed4090165c65de0e3f4be278,1,1,1,2,1,2014-04-28 16:02:50,2014-04-28 16:02:50
425b3156953191707f002fb36e5f14b0355e9a3c...f334dbe82de06f9c71b850da4165076bb3cf8f4b,1,3,3,6,2,2014-04-28 15:58:15,2014-04-28 15:58:15
425b3156953191707f002fb36e5f14b0355e9a3c...442b70c65a48d4a0d0e543d95fb0d0085c97fd67,1,1,0,1,1,2014-04-28 15:36:40,2014-04-28 15:36:40
425b3156953191707f002fb36e5f14b0355e9a3c...b6699111dbf4417dc1871b8e9217e842bcd14295,1,0,6,6,1,2014-04-28 15:30:31,2014-04-28 15:30:31
9b6c40cf69e048a5a23fc9a20b0fe7224d60d8ea...ce7d251d520443228d5058f4fa9185b2f7e7b075,1,2,2,4,2,2014-04-16 04:43:52,2014-04-16 04:43:52
994b7eaeb736c745442cae84126e30fa079e3dfe...f00ca72baa6c43de35d622caa728587a752d6e5e,2,42,36,78,2,2014-04-14 06:15:31,2014-04-14 06:15:31
f00ca72baa6c43de35d622caa728587a752d6e5e...c99ba05c844d4099b85c653edc0c0f5122ccb522,2,190,154,344,16,2014-04-14 06:46:34,2014-04-14 06:40:49
c99ba05c844d4099b85c653edc0c0f5122ccb522...71b241cbfe5b0100ee2ee0fd0e651beccd965746,2,1,5,6,2,2014-04-14 06:54:40,2014-04-14 06:54:40
71b241cbfe5b0100ee2ee0fd0e651beccd965746...35a88f2c291c882e49f7c448c1581dfdd3e35a9c,1,1,1,2,1,2014-04-14 06:58:04,2014-04-14 06:58:04
35a88f2c291c882e49f7c448c1581dfdd3e35a9c...9bd7d09871d8495d06af94a8d866404569d75b8e,2,11,13,24,2,2014-04-14 07:08:54,2014-04-14 07:08:54
994b7eaeb736c745442cae84126e30fa079e3dfe...184728e7bcf9af3224f53e8d5d38d44b08de24ec,2,24,12,36,10,2014-04-14 00:07:48,2014-04-14 00:02:01
7dd9c208fdb4ea3083783437843ea27c7c8a077b...336199a877014143bac462e98cae7f59525a0556,1,8,0,8,3,2014-04-10 15:11:17,2014-04-08 18:07:02
336199a877014143bac462e98cae7f59525a0556...d4746d3ea0b8d4888b21b808237199ae22525b07,1,15,31,46,15,2014-04-10 15:26:48,2014-04-10 15:15:56
01dc79b3ea0dcca26acb3c3d6b949084fabd9074...2ca4e0ea60851ff8e9c0a05dc13fa23436c529b6,9,9,9,18,16,2014-02-27 16:43:44,2014-02-27 16:43:44
01dc79b3ea0dcca26acb3c3d6b949084fabd9074...1d82091756a7e5514619ecd676ceaa89acabedef,1,10,3,13,1,2014-02-27 03:34:42,2014-02-27 03:34:42
4f20538f73492211dad5050d6cbf280cb8ddb01f...67d55860a52bec8b1a1327355b4f27674ec912aa,8,37,511,548,31,2014-02-22 01:25:32,2014-02-21 16:07:51
4f20538f73492211dad5050d6cbf280cb8ddb01f...8c4160fe61151f38f471e93e7bf98dcbf5406a9e,2,2,2,4,2,2014-02-21 15:51:51,2014-02-21 15:51:51
8c4160fe61151f38f471e93e7bf98dcbf5406a9e...afb565e97c79b87d4563e8e728513ca5b50514c7,1,1,1,2,1,2014-02-21 18:43:50,2014-02-21 18:43:03
4f20538f73492211dad5050d6cbf280cb8ddb01f...0db53bd2ecba097c6ace1a1088e11458e139390a,1,1,0,1,1,2014-02-21 10:02:06,2014-02-21 10:02:06
4f20538f73492211dad5050d6cbf280cb8ddb01f...f83e553452db74b73e9de7fa770646e72e7af88f,1,4,3,7,3,2014-02-21 07:42:02,2014-02-21 07:42:02
70771ad2ed2c173ae0437bc2bdab1bfa909a67b3...90b0cce07b4f68d8099903f7e1470f79541f45d0,6,60,57,117,25,2014-02-20 23:32:33,2014-02-20 22:57:58
70771ad2ed2c173ae0437bc2bdab1bfa909a67b3...cae554b32e8c3341767e0efe7b9a8977a499d826,1,58,0,58,1,2014-02-20 17:53:05,2014-02-20 17:43:00
70771ad2ed2c173ae0437bc2bdab1bfa909a67b3...88d24df6687d64bf0e19c23973da32eed32fda28,1,1,1,2,1,2014-02-20 15:55:07,2014-02-20 15:55:07
a6909084e9692024c2859d46c123fb67a8f3d2ad...c3faab3955a6cfb5b36249889269dd8d272e9e8b,2,30,4,34,6,2014-02-21 18:25:49,2014-02-21 18:25:49
a6909084e9692024c2859d46c123fb67a8f3d2ad...7dcbae485cd46ad4b8af1ea758dd1d2c69f11fbe,1,2,0,2,1,2014-02-21 00:22:13,2014-02-21 00:22:13
ed8466c44c93a523176022df118760bc1a359801...511b57bee5bfc80cab26df044e1e821d01064192,1,2,0,2,1,2014-03-06 19:33:51,2014-03-05 18:06:20
ed8466c44c93a523176022df118760bc1a359801...0b4aeb79d9e920f5a713a8ae57e3fdde011689e6,3,8,11,19,8,2014-02-26 16:04:06,2014-02-23 16:32:12
ed8466c44c93a523176022df118760bc1a359801...757c7581c8334b6b527d1c922fe5007d5004eca2,1,2,3,5,1,2014-02-24 21:42:13,2014-02-24 19:08:20
ed8466c44c93a523176022df118760bc1a359801...cd94c9d66693253ce71d8c691cb937980dd96565,1,13,0,13,2,2014-02-24 19:55:04,2014-02-23 00:09:22
ed8466c44c93a523176022df118760bc1a359801...de848a14caf1636cc24e621a35d7073cebe5444d,2,4,4,8,5,2014-02-24 18:42:09,2014-02-24 18:42:09
de848a14caf1636cc24e621a35d7073cebe5444d...fabc478e7e33fd3b3c00c3bd74bad0d87a2c23e3,1,9,9,18,9,2014-02-24 20:28:45,2014-02-24 20:28:45
fabc478e7e33fd3b3c00c3bd74bad0d87a2c23e3...c35853191ccd9ca8fe91b666d598eac3e4e12c67,1,1,2,3,2,2014-02-25 15:07:06,2014-02-25 15:07:06
ed8466c44c93a523176022df118760bc1a359801...8d230cf89cfe3c6c5293d7807c1bffa1cf799d6b,3,44,12,56,14,2014-02-24 02:50:04,2014-02-24 02:33:46
8d230cf89cfe3c6c5293d7807c1bffa1cf799d6b...f420bb29793f0196024d21121d0ef89d2c678bdf,1,1,1,2,1,2014-02-24 17:04:27,2014-02-24 17:04:27
f420bb29793f0196024d21121d0ef89d2c678bdf...522c0765f11569feb1dbc7facfbb802e0f1fb84e,2,3,3,6,4,2014-02-24 20:40:33,2014-02-24 20:40:33
522c0765f11569feb1dbc7facfbb802e0f1fb84e...a0251223cdd7a52d6ae246d37363b9d78a4d8cc3,2,3,3,6,4,2014-02-26 00:06:04,2014-02-26 00:06:04
ed8466c44c93a523176022df118760bc1a359801...cfdfd46e49404ad9dfb28810bd7a83658f35c42b,1,1,1,2,1,2014-02-23 20:45:44,2014-02-23 20:45:44
ed8466c44c93a523176022df118760bc1a359801...2a7f7c86da00210cb90eafd77ee01354f98ec4fc,1,1,1,2,1,2014-02-23 19:42:54,2014-02-23 19:36:21
ed8466c44c93a523176022df118760bc1a359801...b3ffc1f8358a9aa89448b37ea630c5783f0672d8,3,5,3,8,4,2014-02-23 03:01:45,2014-02-23 03:01:45
16c2031137c5619a67130aa7d4a4f97289d8e808...73a277eb2fd66b815b11e9d2caff2c31c18a0854,3,4,4,8,4,2014-02-19 23:11:04,2014-02-19 23:11:04
7aff7cc4bbc0e78c72e77429a79c32a7e7cfc0dc...a6182dc62ea335c40961c7e528b38b85d2569d07,2,42,85,127,13,2014-02-14 03:27:58,2014-02-13 06:12:21
6af82bf4ca319c4881ede9a6cdf41e7dd7c901ef...644acec2f7e3b144a423d0f0a6c900701abdc511,4,42,14,56,10,2014-03-06 19:17:04,2014-01-25 00:18:02
6af82bf4ca319c4881ede9a6cdf41e7dd7c901ef...f0f833c6d795fc8b3fb4bb379f9916745f5c7ac9,2,11,12,23,7,2014-03-06 19:10:58,2014-03-06 19:10:58
f0f833c6d795fc8b3fb4bb379f9916745f5c7ac9...c89fa6645ef87e1863ef5812bd42176f5bd987ca,5,19,2,21,5,2014-03-06 20:05:03,2014-03-06 20:04:51
b5a544b02e2d6f5e880064f327bcb1d5d866e30e...b2cd89056f5c49746ee668946ce4e1771f3ce368,1,0,2,2,1,2014-03-11 14:14:58,2014-03-11 13:45:47
b5a544b02e2d6f5e880064f327bcb1d5d866e30e...b348ee0fd0e4f8d2cb453a08f2b0d174550a339d,1,2,0,2,1,2014-03-11 10:28:26,2014-03-11 10:28:26
b5a544b02e2d6f5e880064f327bcb1d5d866e30e...b21f8872cc684c95a2e30cec9f7c744a78a819f8,2,47,20,67,4,2014-03-11 07:39:06,2014-03-11 07:21:59
b21f8872cc684c95a2e30cec9f7c744a78a819f8...76dc670f413de64361a8bb3efa3381331e796b21,1,4,3,7,3,2014-03-11 07:40:31,2014-03-11 07:40:31
b5a544b02e2d6f5e880064f327bcb1d5d866e30e...18ea183ea0abd18cde0d17e57fc0fa9b19cfab08,1,1,1,2,1,2014-03-11 03:17:03,2014-03-11 02:51:19
b5a544b02e2d6f5e880064f327bcb1d5d866e30e...8301fc8e56503d5a0ea2316a0778faf4cf5f5f1e,3,33,11,44,7,2014-03-11 01:23:14,2014-02-26 23:20:58
8301fc8e56503d5a0ea2316a0778faf4cf5f5f1e...0d6275b298ebb9161c2f55d4b4ac0f87603a11cd,1,3,1,4,2,2014-03-11 01:23:14,2014-03-05 01:54:08
ccf2b96fbc1b19749bee730db5623b9bc882c147...27df18ff11dbfc22ca539462710abf07d507c0d9,1,20,23,43,10,2014-02-10 19:36:23,2014-02-10 19:36:23
27df18ff11dbfc22ca539462710abf07d507c0d9...38eabfa65c5be78a08a8287b600e230dbe0bfac5,1,41,2,43,4,2014-02-10 21:37:16,2014-02-10 21:37:16
38eabfa65c5be78a08a8287b600e230dbe0bfac5...4dec36d1ee8cfd8b396210daa5367d146bbb34bc,1,4,2,6,1,2014-02-11 00:41:16,2014-02-11 00:41:16
28e4de8bfacc610bfa3a0e15cc633e406ea9e9f5...e3140e1e69b24f32ffcc2dd94b7d82ad9305a7bc,1,1,6,7,1,2014-02-12 04:16:58,2014-02-12 04:16:58
3f1e6b63682b54bc245e805a0ee5d6422203fd45...4317011e21b4e4025a9c92c7dc255fbf62af573a,1,0,5,5,1,2014-02-13 18:11:38,2014-02-13 18:11:38
32535e0b826a68973f59c4529418614453819750...a7f1b74dd812fbc86beefea6fcd3ba4c4abaa7e2,1,4,3,7,2,2014-02-18 10:36:46,2014-02-14 13:23:10
a7f1b74dd812fbc86beefea6fcd3ba4c4abaa7e2...8a3cb0c65e7940e928e31d6e64cce5d81d9975a6,1,1,1,2,1,2014-02-18 10:38:23,2014-02-14 13:29:09
8a3cb0c65e7940e928e31d6e64cce5d81d9975a6...d73d3b03e4216bf6cf44b393108dd520acac9670,1,2,3,5,1,2014-02-18 11:36:14,2014-02-18 11:36:14
d73d3b03e4216bf6cf44b393108dd520acac9670...c1dfc63845cdf08d7609e1890f45d01f10326bda,1,2,1,3,1,2014-02-18 11:47:44,2014-02-18 11:47:44
c1dfc63845cdf08d7609e1890f45d01f10326bda...311cb5ca45c15c32408d54194470536e73ae016d,1,2,3,5,1,2014-02-18 15:04:47,2014-02-18 15:00:21
32535e0b826a68973f59c4529418614453819750...190504472b4598eff7d7f6f53df4f813975ff5bb,1,3,1,4,1,2014-02-14 19:56:52,2014-02-14 19:42:47
32535e0b826a68973f59c4529418614453819750...0d9213f859e00459e9efee2c5164417c94d66d2f,1,8,7,15,8,2014-02-14 11:56:55,2014-02-14 10:12:49
0d9213f859e00459e9efee2c5164417c94d66d2f...804690bd07dcc1da6d0707d081e40ec9a189a3b6,1,4,1,5,2,2014-02-14 11:56:55,2014-02-14 10:33:40
804690bd07dcc1da6d0707d081e40ec9a189a3b6...f198ee525ad6862dce3940e08c72e0a092380a7b,13,71,30,101,36,2014-02-14 12:46:17,2014-02-14 11:41:46
f198ee525ad6862dce3940e08c72e0a092380a7b...d8c888b3f85a99e9f94348bb71a852b59162464a,1,0,27,27,2,2014-02-14 12:46:21,2014-02-14 12:00:18
9176b6fd883158e3420777e6e2d463ddcf2005ab...ae3c7dec3b075a263da8d1e1cc510275b281e799,5,24,15,39,10,2014-02-12 00:10:51,2014-02-12 00:05:45
0bcabdbdc79472d7e6c56498c8ae06413730d270...3ecd8ff0c80c593e1874cbfa0cc2abf946eeaf66,12,212,187,399,52,2014-02-12 00:51:01,2014-02-12 00:48:44
2dcb48af0fa9bba2fb47b08dd2c9747acf09ea44...5d29749e9dba4d918fc5ed5d6049f397e98967cf,1,1,1,2,1,2014-02-10 23:52:15,2014-02-10 23:52:15
a7ecc3ea119857593186025ce7268db4c0cbb18c...9b56da78e0b1e4e1da9b2bacc44a22143745a2b0,4,76,41,117,10,2014-02-15 22:52:08,2014-02-12 23:10:41
a7ecc3ea119857593186025ce7268db4c0cbb18c...353cc8c2a5d9ae4c02dc94e14cd2ad6d3393992d,1,13,0,13,2,2014-02-15 22:39:51,2014-02-15 22:27:01
353cc8c2a5d9ae4c02dc94e14cd2ad6d3393992d...7286842a12e3620224e4de65730a3b40d17f1f3a,1,2,0,2,1,2014-02-15 22:40:07,2014-02-15 22:37:51
a7ecc3ea119857593186025ce7268db4c0cbb18c...fc952e0de94aa4283c677ce6c153b1a766db2fc0,3,25,50,75,12,2014-02-15 02:07:33,2014-02-15 02:07:33
fc952e0de94aa4283c677ce6c153b1a766db2fc0...147b09fae9527e760d74b5ef2f9558ee109f4009,3,6,5,11,6,2014-02-15 02:18:16,2014-02-15 02:18:16
a3bc3bb8c338f3fb40202681dd8bd933851a651b...98ce0cdb4f80550462675ee3bbb927451bb76585,1,11,7,18,7,2014-02-18 01:08:17,2014-02-18 01:08:17
a3bc3bb8c338f3fb40202681dd8bd933851a651b...5f84d7f3146db1ac15974f1e28f77834de3e63ff,4,16,1,17,7,2014-02-18 01:03:53,2014-02-17 21:54:36
5258f833bc2ed66f010a5296f86c6842b58a7969...65794a2c4960f9065ee439d6823ffe670610dbb6,3,29,5,34,5,2014-01-31 19:39:29,2014-01-31 19:33:48
35ef0d37c2f1e28d213e3e5e074c390cc8f42c60...17c124baf6a0f3725615b22aa52ca96ac5b95326,1,1,0,1,1,2014-02-03 21:14:15,2014-01-31 17:44:20
748a009cc41ca682377dc55ed287ed9c8bfd164c...5ea2986ce5cfce1b86fdc92610dbc6d670691168,8,240,144,384,54,2014-01-25 00:07:42,2014-01-16 22:00:18
23815414eaef5e943037b65303b1691b93942ad4...b0f4ad431d79869111cfbf506a783a275c274c68,3,24,13,37,4,2014-02-01 02:02:45,2014-02-01 02:02:45
b0f4ad431d79869111cfbf506a783a275c274c68...fca2f3e742d699688c9891ccf9dd8e58591aed08,1,1,1,2,1,2014-02-04 00:06:29,2014-02-04 00:06:29
23815414eaef5e943037b65303b1691b93942ad4...9b7054fd0bc707f7f8e5c9ed9ada5a1664a19a34,1,13,5,18,2,2014-02-01 01:37:13,2014-02-01 01:22:15
23815414eaef5e943037b65303b1691b93942ad4...e43236c78ae8a466a36c323aa679ea581b42cdc5,1,3,3,6,3,2014-02-01 01:24:39,2014-02-01 01:24:39
23815414eaef5e943037b65303b1691b93942ad4...d22a39db265dbf68cec4ddbc5903372e936094a9,1,2,3,5,3,2014-02-01 01:14:59,2014-02-01 01:14:59
a446b347199b3b19abf06e2ccf115d926917620f...f7f8e3c2b3818d351781f96ef68432eba0fc2fda,1,3,3,6,3,2014-02-03 16:12:18,2014-02-02 06:52:52
a446b347199b3b19abf06e2ccf115d926917620f...b61c1d0d42777023a6248c6e9de4bb4877a1857b,1,1,1,2,1,2014-02-03 13:59:09,2014-02-03 13:59:09
a446b347199b3b19abf06e2ccf115d926917620f...7ffd2b0785529b0b71bec90c8468dc3cb4b37525,1,32,7,39,3,2014-02-03 05:47:42,2014-02-03 05:40:58
a446b347199b3b19abf06e2ccf115d926917620f...6922f1be08111d889b0585b763b08f92d7a55e05,3,4,7,11,6,2014-02-02 06:23:33,2014-02-02 04:40:51
a446b347199b3b19abf06e2ccf115d926917620f...4d0a026c98721da874a03f5b6993045bae95842a,3,31,7,38,10,2014-02-01 11:46:37,2014-02-01 11:38:39
4d0a026c98721da874a03f5b6993045bae95842a...1b9c5edc6c7acbe894c4b2db3e3e4a1f1353ccc5,1,4,2,6,4,2014-02-03 22:27:59,2014-02-03 22:27:40
1b9c5edc6c7acbe894c4b2db3e3e4a1f1353ccc5...92e61f89aad35c3103e0db1c6dacecc0c588bd2e,3,7,6,13,5,2014-02-03 23:36:39,2014-02-03 23:36:39
92e61f89aad35c3103e0db1c6dacecc0c588bd2e...ab1482e9c25b3c27b48d97ac84e60efb39ae8af7,1,1,0,1,1,2014-02-04 00:01:38,2014-02-04 00:01:38
a446b347199b3b19abf06e2ccf115d926917620f...ee93f6185be3ae73c16cf41ae397bae3ce2f6c55,6,430,48,478,13,2014-02-01 03:15:24,2013-12-27 17:47:42
ee93f6185be3ae73c16cf41ae397bae3ce2f6c55...4ffc52385cec66cbd930bc6b5ab828ed65f43dbb,1,12,16,28,8,2014-02-01 03:15:24,2014-01-17 21:41:38
4ffc52385cec66cbd930bc6b5ab828ed65f43dbb...e8963748fca208e6015e3cb7981fc0bf07929e3e,1,19,40,59,15,2014-02-01 03:15:24,2014-01-28 06:14:30
349adf4d4df63cd35ecfd74aa21de01629964ea5...6dc2f5513648c42b2e71e55c4a4ea6cd3073ce55,1,29,3,32,3,2014-02-19 03:11:29,2014-02-19 02:45:48
77d4df1e0bc42105a1cd6dbe7fb98e26d0027510...c4e7b0e4d539c66f095d726856562c65f25eac0b,1,1,1,2,1,2014-01-27 23:29:56,2014-01-27 23:25:14
77d4df1e0bc42105a1cd6dbe7fb98e26d0027510...07c4eda46a6a1af82b4b519d9186b9bf7881d7cc,6,867,4,871,7,2014-01-27 22:44:24,2014-01-24 02:59:00
07c4eda46a6a1af82b4b519d9186b9bf7881d7cc...f3a032f27b80e8194cb7f14df848f063a56c5f26,2,170,110,280,55,2014-01-29 01:32:05,2014-01-29 01:32:05
81e596e27288c1dd9c48273fcd131742ef8e2d89...f560b87a863916d6ea5b0bd863db654563ffa14d,1,10,5,15,6,2014-01-03 00:01:04,2014-01-02 23:51:50
681b40c8014e8f9d14e7fa43a2d1b4a8d50f1f13...37ed178611622da42e3a4a0aed2288b00b4eb208,1,9,0,9,1,2013-12-21 00:06:28,2013-12-21 00:06:28
37ed178611622da42e3a4a0aed2288b00b4eb208...cdd14b1a31603e602ab36522582b4356264ccb60,1,5,6,11,4,2013-12-21 00:19:35,2013-12-21 00:19:35
681b40c8014e8f9d14e7fa43a2d1b4a8d50f1f13...94821a33534a25fe906f3f66e1c06b1f2c877aac,2,16,14,30,5,2013-12-19 06:39:12,2013-12-19 06:03:34
681b40c8014e8f9d14e7fa43a2d1b4a8d50f1f13...d14c162fd621da809baa48e8af007443c4f2ae0a,2,9,9,18,4,2013-12-19 06:30:21,2013-12-18 22:45:47
681b40c8014e8f9d14e7fa43a2d1b4a8d50f1f13...14d1c5a2c331f9abe4199b1064ff8f642981fa77,1,1,0,1,1,2013-12-19 05:29:48,2013-12-19 05:29:48
681b40c8014e8f9d14e7fa43a2d1b4a8d50f1f13...329d154209f8da83226e729222dafff4e214b25d,3,29,15,44,5,2013-12-19 05:14:16,2013-12-19 05:14:16
1bc3f6b7b5fd8d15df2238fc77f5aeb9624a6582...055b32e3f4adfd490449b41d0cd6bc6ad5b7466a,1,9,5,14,6,2013-12-31 11:34:23,2013-12-31 01:09:42
1bc3f6b7b5fd8d15df2238fc77f5aeb9624a6582...ad80da33895aa9f2200279282acc25e4b2bcbf27,1,1,1,2,1,2013-12-31 01:58:25,2013-12-31 01:58:25
1bc3f6b7b5fd8d15df2238fc77f5aeb9624a6582...1f80c2a652b03d84718c2e61b7761f939de3b07a,1,3,0,3,1,2013-12-31 01:50:58,2013-12-31 01:50:58
a2fcd3d8f0c57fae8d1c19db77093b44437c1318...158e3d60ec016778b2a2615885f6a880509644f3,1,80,0,80,1,2013-12-21 22:38:13,2013-12-21 22:38:13
158e3d60ec016778b2a2615885f6a880509644f3...3edbf416bfaed2c7bacc3c5ef572efb59b4e2082,2,6,5,11,6,2013-12-21 23:00:20,2013-12-21 23:00:20
3edbf416bfaed2c7bacc3c5ef572efb59b4e2082...d256f3049b36ae1a1dd596535b4a82d265ff9eee,1,1,1,2,1,2013-12-27 10:55:57,2013-12-27 10:55:57
a2fcd3d8f0c57fae8d1c19db77093b44437c1318...e4e579b40d79764781cbb0a63d12d307ca8a71dc,1,1,1,2,1,2013-12-21 16:41:41,2013-12-21 16:41:41
e4e579b40d79764781cbb0a63d12d307ca8a71dc...614bc5c1e1e4f134f9844844ef7d8171c7f0d598,5,5,5,10,5,2013-12-23 21:21:01,2013-12-23 21:21:01
a2fcd3d8f0c57fae8d1c19db77093b44437c1318...071528e1033623b4c2da7450b4492616101dd018,1,1,1,2,1,2013-12-21 08:23:13,2013-12-21 08:23:13
3ffc52bcf5a807e7cd2995443d94e89fab8dc2c6...369cde4ad7b2618e24294839761b743c5c25911b,1,1,1,2,1,2013-12-21 00:50:31,2013-12-21 00:50:31
3fe4d5477ac3b3e9761b80f808a6f5fee6cdbdf9...8e7db0432e21adb3a753188d5321ce1165fa8964,2,1,1,2,1,2013-12-23 23:07:01,2013-12-23 23:07:01
8e7db0432e21adb3a753188d5321ce1165fa8964...652c2c2a80cd119ffb8017c25e741ddad9399236,1,11,0,11,1,2013-12-23 23:12:19,2013-12-23 23:12:19
3fe4d5477ac3b3e9761b80f808a6f5fee6cdbdf9...b1a3a5580285b58d643ff0c09c263f78d1088f37,1,3,0,3,1,2013-12-23 22:50:24,2013-12-23 22:42:04
e0f07bc18614c5cc9065e75a3f43cdf4ca0ab605...82a47b0e82367aa5f1b6d15816c7e66abdffb06a,1,8,3,11,1,2014-01-03 00:17:52,2014-01-03 00:17:52
bb754fd34d380fd59f87f6d198361c9ba7239e10...7799ae27ca1dd85761f0595346a0dda15bbeda6c,6,5,4,9,5,2014-01-06 23:41:24,2013-12-23 23:36:58
a86a82cb7e6159fc48c40b6e07e63c911100801c...811341423bd9d3d65640cb4aa04d2840817182ca,2,68,10,78,10,2014-01-08 00:02:20,2014-01-07 00:25:48
811341423bd9d3d65640cb4aa04d2840817182ca...ef7e000a13eed5ebf761ab4ca83fa8f727170aa5,1,2,3,5,1,2014-01-08 00:02:41,2014-01-08 00:02:41
ef7e000a13eed5ebf761ab4ca83fa8f727170aa5...f3103e5c9157aed2a5ab0f4c70e328cd0aa69b59,2,26,8,34,4,2014-01-08 00:53:55,2014-01-08 00:53:55
4e414f62052fd0389d79122db5b0071ddab5d027...aa3339cf39b88e4a4b3d830d9b0831d4abff1dcb,3,50,31,81,21,2014-01-10 23:34:10,2013-12-11 23:23:38
237868e9c3f9d1cb5f5311ef2710f83e1b3b898a...0dfebf2d93e4990f12ba5d434e1750046008782f,1,20,20,40,10,2013-12-30 18:57:11,2013-12-30 18:57:11
237868e9c3f9d1cb5f5311ef2710f83e1b3b898a...a1dba16fe8562ed0545eaa3c6ed23bb1043dd102,1,81,76,157,49,2013-12-30 18:48:12,2013-12-30 18:36:52
5f557842246eb1d83b94732754760e87416386cb...9dd7ae4074ecfceb62c3c3eae1811c5bd018c38c,2,3,8,11,4,2014-01-01 23:06:50,2014-01-01 23:06:50
c23b15b9d84ed7d9421d8946c4e0a309e12cecf3...e45b87031c2b68ebbf98fdc02bace53ebe932148,1,1,1,2,1,2014-01-20 01:48:54,2014-01-20 01:48:54
c23b15b9d84ed7d9421d8946c4e0a309e12cecf3...323c4b5211ecef4cffcbe0a97811ddd93c469164,2,20,21,41,6,2014-01-06 18:15:14,2013-12-28 02:06:26
c23b15b9d84ed7d9421d8946c4e0a309e12cecf3...69db6ea867ca155ecf6c342e82df491cdcd6aa96,2,17,11,28,7,2014-01-03 00:27:59,2014-01-02 09:17:33
c23b15b9d84ed7d9421d8946c4e0a309e12cecf3...f3816ee024fe66a207381832bfc97ea123ec72ed,1,1,1,2,1,2014-01-01 20:52:07,2014-01-01 20:52:07
c23b15b9d84ed7d9421d8946c4e0a309e12cecf3...22269894105d8553fc3608fe3f749f5001a37ca0,1,2,0,2,1,2013-12-31 23:59:47,2013-12-31 23:59:47
22269894105d8553fc3608fe3f749f5001a37ca0...0b3e153588876fdc2bddde2e9064598e26276a09,1,1,1,2,1,2014-01-01 11:28:22,2014-01-01 11:28:22
621523a04155401888b08265fbc1f51e7f7aeb10...0db1c60542d3570558bad09eddd3b2b605e55e4e,1,0,1,1,1,2013-12-12 18:25:30,2013-12-12 18:24:00
621523a04155401888b08265fbc1f51e7f7aeb10...f216448c823d1aa3dd661935d60da390d463039d,1,3,2,5,2,2013-12-12 11:03:33,2013-12-12 11:03:33
621523a04155401888b08265fbc1f51e7f7aeb10...f26a9d456ca267b0346077b98fc447b99319d8b9,1,2,2,4,2,2013-12-12 09:23:16,2013-12-12 09:23:16
621523a04155401888b08265fbc1f51e7f7aeb10...bf5b949ffc005127399db51f8f49c3c8cc4736bc,1,1,1,2,1,2013-12-12 06:09:24,2013-12-12 06:09:24
aaa1c48d243e693b29bc52e382e3c37637c8bc3c...930ec9f52ceceabcb72589ac7f20e1e8bbccbed5,5,71,25,96,19,2013-12-13 22:19:56,2013-12-12 01:03:48
930ec9f52ceceabcb72589ac7f20e1e8bbccbed5...4b5ceb0f24285718620465bb4073269d6fb8097b,3,7,11,18,7,2013-12-13 22:29:27,2013-12-13 22:29:27
4b5ceb0f24285718620465bb4073269d6fb8097b...d5f5ecb658c7a6a0f04939061494c9d404d393ce,3,9,12,21,5,2013-12-14 00:02:19,2013-12-13 23:01:54
bf916365589aa907c6ce486d5cae66f7a4da1419...4975c1b54980517b5527278e637f3c05dd6a32db,1,1,1,2,1,2013-12-13 21:51:20,2013-12-13 21:51:20
847cf5b5994152b7cd0d9fb86cfe0757afe3473d...73e8a39ff219833ebb28c12dc318466e3551b5bd,2,28,13,41,6,2013-12-13 21:15:39,2013-12-12 02:25:30
8224e13bd25a41c3e3d8755edd3a754cd060adee...2e6dbe87ad6e9ba87cacf818e44dea6b58be05c5,1,2,2,4,2,2013-12-13 05:09:05,2013-12-13 05:09:05
8224e13bd25a41c3e3d8755edd3a754cd060adee...e8772943215fff3e17642ad410e4815e40e96b8b,2,3,1,4,2,2013-12-13 02:08:58,2013-11-08 22:15:11
8224e13bd25a41c3e3d8755edd3a754cd060adee...f7c7f7978cf0ca94da5cc68ec2634b5a22ae329c,3,22,9,31,6,2013-12-13 01:56:05,2013-10-29 18:31:00
f7c7f7978cf0ca94da5cc68ec2634b5a22ae329c...ecc51cd465da56b38190fe852cf9f31bdfbb0fdc,3,40,11,51,10,2013-12-13 01:57:11,2013-10-29 18:37:00
4c52272a2dbe642869d5e915435ebe16cc9045b8...44456ba065118231d02334f6b1faee7971a41d3a,2,6,12,18,8,2014-07-08 21:30:52,2014-07-08 19:23:08
44456ba065118231d02334f6b1faee7971a41d3a...94c27842d8d129bdacde98d81e2013ff13143ee8,2,4,71,75,7,2014-07-08 21:31:11,2014-07-08 19:26:59
94c27842d8d129bdacde98d81e2013ff13143ee8...699556e6619ce6806030e87ee1f3ea57bcdefd81,5,205,0,205,3,2014-07-08 21:32:18,2014-07-08 19:34:04
699556e6619ce6806030e87ee1f3ea57bcdefd81...dc62f3cdccfd744c7e1d345da7f167df98cf9686,2,6,1,7,2,2014-07-09 00:59:54,2014-07-08 21:35:22
fd32fc80625c8e608332f48d69c1801c23a6ffa4...a7b60b21deaf7dbc3b5741be036bfb2a6679f1c8,1,2,2,4,1,2014-06-10 14:02:00,2014-06-10 14:02:00
fd32fc80625c8e608332f48d69c1801c23a6ffa4...7ab1a90e59b34abda1d2ffa1dd6683302927d9ec,1,34,2,36,3,2014-06-10 01:31:46,2014-06-09 20:33:04
fd32fc80625c8e608332f48d69c1801c23a6ffa4...6158ccad97db51e756aafefb096d1163aa4d6439,30,23,23,46,22,2014-06-09 22:52:12,2014-06-09 22:52:12
6158ccad97db51e756aafefb096d1163aa4d6439...bae6a5a616cfc382f45a25af13633681875ddff0,9,11,11,22,21,2014-06-09 23:01:57,2014-06-09 22:59:41
fd32fc80625c8e608332f48d69c1801c23a6ffa4...cacb5c0ddeb75a26c7687d3c4887d3eb998b104e,2,1,1,2,1,2014-06-09 20:15:13,2014-06-09 16:10:05
94dc07c0445b57038fde8d79df06fe4401eca796...8baafacf404265c95753e63d2b7510731359c4b4,4,15,16,31,7,2014-06-07 23:48:25,2014-06-07 23:48:25
94dc07c0445b57038fde8d79df06fe4401eca796...39320f9393b27dd6239a2356086abc8439c1614b,1,33,0,33,1,2014-06-07 22:11:57,2014-06-07 22:11:57
a5f5d5e8d7e3e70c681059f399714f0e7610dff6...1bcc37caec07c01ab385f562ffa56d2b2bb0a7d8,1,1,1,2,1,2014-06-20 21:21:18,2014-06-20 21:18:37
1bcc37caec07c01ab385f562ffa56d2b2bb0a7d8...5266d6fa7bc367ac4c7472550b7220c4eb06731f,1,3,3,6,2,2014-06-20 21:36:31,2014-06-20 21:36:31
a5f5d5e8d7e3e70c681059f399714f0e7610dff6...6d14e9f1acc3d5927cbd4f4b3c7ea0c691dea7bc,2,8,8,16,7,2014-06-20 21:05:46,2014-06-19 08:29:40
3a1703a79f6702c67ce51ea58f359d1d63bb0c6f...ea049a2ebc072819920c42140221ce4ab7bab22e,1,4,5,9,1,2014-05-08 17:05:00,2014-05-08 17:05:00
8d3c5b7dcaf5fb0e7084adac969bfbe75f3bbaeb...170e4d2e19258c4e45b975177618640cb554c32b,1,2,2,4,2,2014-05-08 19:57:19,2014-05-08 19:57:19
8fac9a345bb8e44bbe7b7cdce47b00f744a68623...a8871b93b95d1220c860987ae1da4e49c943bfea,30,205,186,391,81,2014-04-28 20:08:55,2014-04-26 12:00:01
8fac9a345bb8e44bbe7b7cdce47b00f744a68623...78421b376897c589a3c7a80a5b94fc3dd74e2741,1,16,4,20,5,2014-04-28 19:02:04,2014-04-08 01:00:32
78421b376897c589a3c7a80a5b94fc3dd74e2741...68d8d9a62d6199d0e285f8ec07b1a3cbdada8ac8,1,15,14,29,3,2014-04-28 19:03:31,2014-04-28 19:03:31
53c35412f9d6aef954cb5babccd5feca942a0939...46492ee65a26c8b3a138f4b9f5eea0e648dc8b45,1,0,91,91,1,2014-04-29 04:25:26,2014-04-29 04:25:26
24c4c3e0e99ddb4d65200f2f7367883e47008898...4ba7b28006620962ae8a0f6cb5865a5e1a65b332,1,1,1,2,1,2014-04-16 22:43:07,2014-04-16 22:43:07
24c4c3e0e99ddb4d65200f2f7367883e47008898...1775ed8c75fabb3544402ca13afe7a4c35b27038,1,84,0,84,1,2014-04-16 21:50:11,2014-04-16 21:44:14
24c4c3e0e99ddb4d65200f2f7367883e47008898...882862b095fb0bf6b554c2b11123c608ff68025e,1,10,0,10,2,2014-04-16 16:38:08,2014-04-16 16:38:08
24c4c3e0e99ddb4d65200f2f7367883e47008898...e1e512e2da5f642ded2eba6baa851f52bae0b05c,1,1,1,2,1,2014-04-16 15:48:27,2014-04-16 15:16:07
e1e512e2da5f642ded2eba6baa851f52bae0b05c...92ea101bc4a498e952ede00bff53d0123f22f41c,3,10,2,12,3,2014-04-16 22:19:30,2014-04-16 15:41:19
24c4c3e0e99ddb4d65200f2f7367883e47008898...75d97a4d2f446b5357341ea16f95be8f3215eecd,2,11,22,33,2,2014-04-16 15:24:07,2014-04-16 15:11:28
24c4c3e0e99ddb4d65200f2f7367883e47008898...b74fa7587228361f2e13606c260f559b56aaf323,1,2,6,8,2,2014-04-16 15:20:29,2014-04-16 15:20:29
24c4c3e0e99ddb4d65200f2f7367883e47008898...39103e72a3ca4ff739a4986c4e4849339e08aaf3,2,34,4,38,4,2014-04-14 12:43:01,2014-04-14 12:43:01
80f6b011328ad81fdf68d073b4dc771ec21cba23...936a03bfddb24cd45f5f12c20a961bf2ae6ede93,87,34849,348,35197,101,2014-04-16 00:02:10,2014-04-15 06:01:25
80f6b011328ad81fdf68d073b4dc771ec21cba23...dceea17805258520b1218eb1a2bb394c8b9c0a03,2,2,2,4,2,2014-04-15 22:06:48,2014-04-15 21:35:36
2d6f537bb30d7d096dbde83cbf4df9fa7f6c5f57...3ac90aeed5a6bdfe22af48eca1519fb186dc66cb,1,20,4,24,4,2014-04-17 00:39:15,2014-04-17 00:38:08
184728e7bcf9af3224f53e8d5d38d44b08de24ec...a777ebcee6326bed2f7e99eedf6edbb922175e2d,87,34849,348,35197,101,2014-04-16 01:04:01,2014-04-15 06:01:25
a777ebcee6326bed2f7e99eedf6edbb922175e2d...ac999a9cb2b0976e021aeb8825bb051df6bd0976,76,14766,0,14766,76,2014-04-16 01:04:14,2014-04-16 00:53:12
31e08fdc96b0719122e57d69b5aeb203f6077b1a...e07920f680a829724f617819f0c5715ed9b5194a,2,21,1,22,3,2014-03-01 01:34:31,2014-02-28 16:08:01
31e08fdc96b0719122e57d69b5aeb203f6077b1a...5ec68197056fbb63abba847b61bf447fed955359,1,1,1,2,1,2014-02-28 23:39:24,2014-02-28 23:39:24
31e08fdc96b0719122e57d69b5aeb203f6077b1a...d78fcb32ffd4736462792407abe734b51b81367a,7,83,2,85,9,2014-02-28 04:31:36,2014-02-06 04:10:57
31e08fdc96b0719122e57d69b5aeb203f6077b1a...f67e725e6866f277f706820d4c21b1d0cb2acc80,1,4,4,8,4,2014-02-28 02:40:15,2014-02-28 02:40:15
31e08fdc96b0719122e57d69b5aeb203f6077b1a...6104f9f9495678549ef8fc5aa716a3cc893add8f,1,1,0,1,1,2014-02-28 01:20:10,2014-02-28 01:20:10
31e08fdc96b0719122e57d69b5aeb203f6077b1a...f30f823bf50de6581f547aee842286584c4b6990,1,14,5,19,1,2014-02-28 00:32:58,2014-02-28 00:32:58
22da8cdc7e862dbc54806dc935f4ef079be22654...4039fbb1b01365273e99a3cba28db33b38197237,1,7,5,12,2,2014-02-26 04:16:17,2014-02-26 04:16:17
81cd2054f6484837029dde93d40c0e44b684bf08...8c783c1c1336d8f2d1b08b9cbd8e2298d066750c,4,155,79,234,17,2014-02-21 19:47:53,2014-02-21 19:47:53
8c783c1c1336d8f2d1b08b9cbd8e2298d066750c...1e742876988546efb876f67f83de6737ee5e9cf6,7,159,161,320,15,2014-02-21 20:32:14,2014-02-21 20:32:14
1e742876988546efb876f67f83de6737ee5e9cf6...592c2f6f9a472bda227a03c819f73b8edc7c3320,3,33,37,70,16,2014-02-21 20:42:37,2014-02-21 20:42:37
592c2f6f9a472bda227a03c819f73b8edc7c3320...8e2284aaa2364a8e47a8058e65d60813f9cd5089,4,11,7,18,7,2014-02-21 20:52:18,2014-02-21 20:52:18
8e2284aaa2364a8e47a8058e65d60813f9cd5089...aac702727ea02b3974a2848748b0713ac583fc84,5,67,46,113,23,2014-02-21 21:27:34,2014-02-21 21:27:15
81cd2054f6484837029dde93d40c0e44b684bf08...41b1f93bf72e4c012a159a013697090efdcc183b,1,5,1,6,1,2014-02-21 18:26:04,2014-02-21 18:26:04
05e40303134a528b43ca1bf129814ba992a59604...1475dafd5204a6df2e69dec5214270020edf5e50,1,1,1,2,1,2014-02-27 00:38:51,2014-02-24 20:49:31
05e40303134a528b43ca1bf129814ba992a59604...24ff3a3dc30e455674d28f552a0efb6108a411db,1,1,1,2,1,2014-02-24 21:59:01,2014-02-24 21:59:01
05e40303134a528b43ca1bf129814ba992a59604...00bb76f35b4d21d0aaddb23f93d663ec02faea1a,5,544,0,544,4,2014-02-24 21:48:43,2014-02-24 21:28:49
00bb76f35b4d21d0aaddb23f93d663ec02faea1a...b6a5082bd1cfa297637b38aa6692239a679d97e8,3,26,6,32,6,2014-02-27 22:21:24,2014-02-26 20:37:28
05e40303134a528b43ca1bf129814ba992a59604...2ae8180de2d814e04834d41f20b2c96a06995678,2,10,3,13,4,2014-02-24 20:38:58,2014-02-24 20:38:58
05e40303134a528b43ca1bf129814ba992a59604...d985fd49843b31b227b46d5ed71914002e2e0de9,1,38,0,38,2,2014-02-24 20:31:39,2014-02-24 20:06:08
d985fd49843b31b227b46d5ed71914002e2e0de9...0469e7d0622add573f2f9c357564ff0076db9346,1,1,1,2,1,2014-02-24 20:31:39,2014-02-24 20:08:37
aed7fe1cda0332c6af29f427a0b6b03fba51a50a...2019a73f0387af273be3b6e085fdae0e5a67ba3b,3,54,0,54,4,2014-02-24 19:38:13,2014-02-15 23:05:28
aed7fe1cda0332c6af29f427a0b6b03fba51a50a...919665a20a41f8e1b105342b1864ec05eb50cc97,6,45,21,66,9,2014-02-24 19:24:29,2014-02-19 23:27:57
919665a20a41f8e1b105342b1864ec05eb50cc97...92c3927b5de73f81c490900b2718d218ec097bd3,3,29,88,117,13,2014-02-24 19:24:30,2014-02-24 19:22:48
83ffc2860bb4912828a8454291483ccf77888860...c000cb64712349141596318dea2a8de2462c8f81,19,812,50,862,63,2014-03-08 23:06:44,2014-02-27 12:47:59
83ffc2860bb4912828a8454291483ccf77888860...188dea9e0e8b968b28a288192c357343dcc5834c,1,1,1,2,1,2014-03-06 21:33:08,2014-03-06 21:33:08
7b79f597f6b8e4985f78e5a6b78e5d6d1e6779dc...95e5910ab23e3ef7b0154f64e1c6ae01bc647ab3,1,8,3,11,3,2014-03-12 00:51:29,2014-03-12 00:10:05
c89fa6645ef87e1863ef5812bd42176f5bd987ca...0b23393ba1901df3d08916fa977707db58699eca,8,16,8,24,9,2014-03-06 20:39:17,2014-03-06 20:39:17
037f942a0b37cc79f42fc26cfdd9f665f075f099...915d967f556bc7bb3faea34db8a06ea64fd5de92,9,10,8,18,9,2014-03-11 03:26:45,2014-03-11 03:26:45
e50a5fcb0d21716edfb997d2549b7c17a803bae7...07c35b41a5a93f31111d47afcb1e6d2926b492a0,2,26,17,43,4,2014-03-11 15:37:19,2014-03-05 09:40:55
e50a5fcb0d21716edfb997d2549b7c17a803bae7...2a2c694758d6a48125cc9adf446f2054b52db201,1,38,15,53,7,2014-03-11 14:08:44,2014-03-10 20:11:03
2a2c694758d6a48125cc9adf446f2054b52db201...2b855afaeedcab3117876815ec2f8d4450a742b5,1,40,38,78,12,2014-03-12 03:36:51,2014-03-12 03:36:51
2b855afaeedcab3117876815ec2f8d4450a742b5...7790a77b6afeda6f223202288a89f4b431f033a0,1,2,2,4,2,2014-04-26 00:01:25,2014-04-26 00:01:25
f544ebd55aee0944f0b0ca03b2edd90eac312e4a...708ecd7da2125a47abb9678ed382893c7b30f10f,2,12,0,12,2,2014-03-21 20:17:09,2014-03-12 07:58:53
f544ebd55aee0944f0b0ca03b2edd90eac312e4a...2cfcf42d50b469abfb0e13245726371d445b76e4,1,26,10,36,1,2014-03-12 12:05:43,2014-02-28 16:42:20
f544ebd55aee0944f0b0ca03b2edd90eac312e4a...e1c48fa56007e1db028f7f83bfbf79c3d05feccd,1,1,1,2,1,2014-03-12 07:17:38,2014-03-12 07:17:38
e1c48fa56007e1db028f7f83bfbf79c3d05feccd...99b6364790e59a70d57949792fa31014637c93ee,1,9,1,10,1,2014-03-12 07:18:12,2014-03-12 07:18:12
f544ebd55aee0944f0b0ca03b2edd90eac312e4a...b7ae9984fb541e8b53d09016e78ff352ce310c25,2,4,4,8,2,2014-03-12 04:50:03,2014-03-12 04:44:01
4dec36d1ee8cfd8b396210daa5367d146bbb34bc...2d2c237f50b7954993f6cd1db67c6f8c6d06f881,1,52,30,82,10,2014-02-12 12:09:56,2014-02-12 12:09:56
4dec36d1ee8cfd8b396210daa5367d146bbb34bc...f9cd1be6ffbda85f20cc7926274fab7484a19823,1,58,3,61,5,2014-02-11 06:32:07,2014-02-11 06:32:07
9a9690360c9b013f3962bee74c18397bd411cc6b...6393c38339e11b4a099a460ecf46bb5cafc4283b,23,731,674,1405,156,2014-02-12 04:18:46,2014-02-12 04:04:39
ae3c7dec3b075a263da8d1e1cc510275b281e799...da04f49b383c02ee28c32f948048b9e9a402bb4f,9,26,36,62,23,2014-02-12 00:26:54,2014-02-12 00:26:54
2975ba6f7315bc4f1e41f6523ab927572d3aafd0...0c71015dcf788c5342bb9422a447b7f9ad12d43d,1,0,8,8,1,2014-02-11 17:02:30,2014-02-11 17:02:30
2975ba6f7315bc4f1e41f6523ab927572d3aafd0...b2146cb0e7a23553d1520ed87837a1b5455c9130,2,13,0,13,2,2014-02-11 10:34:26,2014-02-11 09:53:45
2975ba6f7315bc4f1e41f6523ab927572d3aafd0...c4b9e1c9add2ab3c97cc89c8f6b12b83750cea1d,1,7,2,9,2,2014-02-11 03:16:54,2014-02-10 06:10:15
9b56da78e0b1e4e1da9b2bacc44a22143745a2b0...ee59ba969fdd1837fe0151638cc01637e18139c3,3,30,31,61,31,2014-02-15 22:55:51,2014-02-12 01:59:00
ee59ba969fdd1837fe0151638cc01637e18139c3...567a422a65f71a58c3000aa66a42853c7e005bb4,1,0,14,14,2,2014-02-15 22:55:57,2014-02-12 02:03:50
567a422a65f71a58c3000aa66a42853c7e005bb4...44e10433c7a3811d4d0897192418cb6b62996584,3,21,2,23,4,2014-02-15 23:24:51,2014-02-12 01:59:45
8f11a1a61f7e63eb15c505225d5ca15c4d545cf7...3036b5a196fdbb744f94299c82dc44078361bdae,2,55,52,107,25,2014-02-18 03:23:28,2014-02-14 11:02:54
3036b5a196fdbb744f94299c82dc44078361bdae...f535a58959809dbb613bf529019f26cc6ae0c6f9,1,14,16,30,13,2014-02-18 03:23:28,2014-02-14 11:27:57
f535a58959809dbb613bf529019f26cc6ae0c6f9...b05602a0fe6d9b9731cee0008fbac27250f361bd,2,54,30,84,19,2014-02-18 03:23:28,2014-02-14 12:41:59
b05602a0fe6d9b9731cee0008fbac27250f361bd...29f7e1bfcbe6654d962a55eb5006e248284b9e0c,1,10,11,21,8,2014-02-18 03:23:28,2014-02-18 03:23:18
c9addff4449d0d6671373b9a6376fbe94bb43fb4...b7a0f62f0f9079d0d628a284a77af0c474eb9375,1,1,1,2,1,2014-02-25 08:01:46,2014-02-25 08:01:46
c9f6e446eedce31c8fde15f8b198069546be3125...736bf3f7e6ae4a80cc85c846a4d5d074a325c9f4,1,1,0,1,1,2014-02-04 02:26:47,2014-02-02 13:50:54
e2003fea3a5ddf560cc4b9677045e459c196dd53...1f8b1bb84e65cfd84f938eb01e1a48c33fce5a27,4,28,12,40,8,2014-01-25 00:51:02,2014-01-25 00:39:41
686314514830547dafd7c736acee4a4a758b0ae9...f4a7c437769b5cf25d852d1aee6a6c50ee42fc85,2,2,2,4,2,2014-02-03 18:08:35,2014-02-03 18:08:35
e829d5b6d2865417d3161370782176b19550d9d7...62a81370fffb3cfdb15ef19702f0ea07ab2f4c36,5,36,2,38,8,2013-12-19 18:33:49,2013-12-19 06:06:14
1e5f9334e0746399856b8f1e0f7ebd28947bcee8...bf17383e35afa12f5d6cb145b26542f2dc4f95de,1,2,2,4,2,2013-12-23 14:08:28,2013-12-23 14:08:28
1e5f9334e0746399856b8f1e0f7ebd28947bcee8...83d81758b0ca7de9ca38f4ea3a7eaaa8a0c275ad,1,4,3,7,2,2013-12-23 13:46:52,2013-12-02 07:59:45
1e5f9334e0746399856b8f1e0f7ebd28947bcee8...e3b878ce983e5e01960ba5ec5c330749df7dcac4,1,3,3,6,1,2013-12-23 08:27:22,2013-12-23 08:27:22
3fc9de3d0396d15f7310910a86100257853cdd90...a009d4ae8d67b40c0109865f4d83e6e294931ce7,3,1,1,2,1,2013-12-23 23:45:18,2013-12-23 23:45:18
3fc9de3d0396d15f7310910a86100257853cdd90...7ce7516c12f58aa71cd055b7c0bef6585d3f2ab3,8,4,4,8,4,2013-12-23 23:42:37,2013-12-23 23:42:37
3fc9de3d0396d15f7310910a86100257853cdd90...f6b91262a77b2e70da8572850dd8b56d92384dfe,4,2,2,4,2,2013-12-23 23:39:39,2013-12-23 23:39:39
3fc9de3d0396d15f7310910a86100257853cdd90...d16d748132330ff58e142472a579d1f6c65e3eac,10,2,2,4,2,2013-12-23 23:33:06,2013-12-23 23:33:06
8f4a54734fac24b4e7ce3019c9a693d7ed72c577...5a9f45cb7ae44bb194b2643994c6a0d53b856645,1,4,4,8,3,2014-01-03 00:40:19,2014-01-03 00:40:19
2c395ce8fb29bb64a1d6ed6d893116bf8a255c41...1e551c7cc5badc043b1d6a651c3f036c996ef538,1,1,1,2,1,2014-01-07 00:18:00,2014-01-07 00:18:00
a0298c0bd070400b4acaad3c2d285037b5875552...561d1db074edd4e7e7d8b02401abd3fc11b9d51c,5,113,0,113,5,2014-01-07 15:25:54,2013-12-04 21:47:37
add97f7eb0de5264cabb4d3bfb59ef6a8e4870ba...589515c717616f3c2e0278ad787d21b4ab07b994,1,30,12,42,10,2014-01-02 16:51:42,2014-01-02 16:51:42
589515c717616f3c2e0278ad787d21b4ab07b994...5e8912e0e8537c526ee4f162bdade2656c2fa803,1,2,1,3,2,2014-01-06 20:04:44,2014-01-06 20:04:44
add97f7eb0de5264cabb4d3bfb59ef6a8e4870ba...523f726716fa017b14647b9a70176e2639a71837,2,2,2,4,2,2014-01-02 16:29:24,2014-01-02 16:29:24
add97f7eb0de5264cabb4d3bfb59ef6a8e4870ba...7fd6dcc831d28cc1ca1a5d56c9043354228f087d,2,15,5,20,4,2014-01-02 05:34:22,2014-01-02 05:34:22
add97f7eb0de5264cabb4d3bfb59ef6a8e4870ba...848f290012a06e84723cad5f9222697c367b0a61,1,4,4,8,3,2014-01-02 04:56:29,2014-01-02 04:56:29
e5b09523dcfabcd252113a8ebda5391c88e777e5...82531f71681c9b5bc5a6c871f81ef67f9e92d708,1,1,5,6,1,2014-01-06 19:11:04,2014-01-06 19:11:04
5a89c6f6dffdcaa4d24b331ca233afccebdf6cc4...f63cdf0260cf6287d28a589a79d3f947def6a569,1,10,1,11,4,2013-12-13 19:14:05,2013-12-12 21:34:26
5a89c6f6dffdcaa4d24b331ca233afccebdf6cc4...818c249bae8d29842834bf765299c86c09e6913e,3,160,60,220,20,2013-12-13 14:43:50,2013-12-13 14:43:50
818c249bae8d29842834bf765299c86c09e6913e...10cd902f900392a2f10a6f8763bba70607ea0d41,1,18,2,20,4,2013-12-13 14:46:41,2013-12-13 14:46:41
10cd902f900392a2f10a6f8763bba70607ea0d41...a8af12f80a4a1678988b4667e5211d4e576ce903,1,40,44,84,1,2013-12-13 14:50:25,2013-12-13 14:50:25
a8af12f80a4a1678988b4667e5211d4e576ce903...78c22c24b353d77fdab3e1616d9986a8ae95a7c2,1,17,0,17,1,2013-12-16 13:35:43,2013-12-16 13:35:43
2d1f61ef0ec93539fd55f27cbd6f08ef0f0f33d2...bd02d6e662fdf197665a92663854c629c4dda747,1,53,35,88,17,2013-12-12 19:47:23,2013-12-02 18:58:45
bd02d6e662fdf197665a92663854c629c4dda747...1572989201cc54dc87d961fe9c5d6850c61d47b9,1,40,21,61,20,2013-12-12 19:47:24,2013-12-02 22:21:29
1572989201cc54dc87d961fe9c5d6850c61d47b9...b8f1c7370516a4eec0d3168d594a7d7d92e7f8e9,11,1299,17,1316,17,2013-12-12 19:47:24,2013-10-31 03:24:47
ecd20a96df134a9d7bcea520c5bfd7ed42beee57...699bc47137ab78b7d88ec7623ad10e04f7b67f33,1,1,1,2,2,2014-07-23 00:18:41,2014-07-10 09:19:18
699bc47137ab78b7d88ec7623ad10e04f7b67f33...21341e9e134399feef88872f11fb4339401cf6f5,1,5,1,6,1,2014-07-23 00:19:24,2014-07-14 18:34:04
21341e9e134399feef88872f11fb4339401cf6f5...2c185e25c22b82614210908c445a32fa3dbe5ed1,1,9,9,18,4,2014-07-23 00:20:04,2014-07-22 02:59:44
2c185e25c22b82614210908c445a32fa3dbe5ed1...4e12484ea12d23fd70fd3bf636e786f4f741ab64,1,10,1,11,2,2014-07-23 00:20:11,2014-07-22 07:16:26
4e12484ea12d23fd70fd3bf636e786f4f741ab64...d84a070e476ce923dd03e28232564a87704613ab,2,10,1,11,2,2014-07-23 00:29:56,2014-07-23 00:29:56
b3191bf042d704a1e1d4aaeacd3e2bf257685558...d55cafb72e25e5ef9b400c1c010e9832ec8b5561,1,1,1,2,1,2014-07-03 18:01:36,2014-07-03 18:01:36
4e286a9094dc52a5dd709fd11787c8fb6b6fe38d...e4742dbb942b9db5f91dfbfb829525bdcac57ae1,3,19,4,23,3,2014-06-29 03:17:46,2014-06-20 11:39:28
4e286a9094dc52a5dd709fd11787c8fb6b6fe38d...cbdce9912d9f904b237e29dd2a1196367337628b,1,1,1,2,1,2014-06-20 11:14:56,2014-06-20 11:14:56
4e286a9094dc52a5dd709fd11787c8fb6b6fe38d...db9bf744ab93f1e688bf986794c852abc40b873e,1,1,1,2,1,2014-06-20 07:23:35,2014-06-20 07:23:35
4e286a9094dc52a5dd709fd11787c8fb6b6fe38d...4efe02b3df67af544d398e435fbe567502bf0dea,1,1,1,2,1,2014-06-20 05:01:10,2014-06-20 05:01:10
9ac293e1a8e1463f3fac1713213c9d250642ace8...f411f8bfc5d04aed6499dfc90e357c58713bc84d,1,2,2,4,2,2014-06-11 21:07:50,2014-06-11 20:54:40
f411f8bfc5d04aed6499dfc90e357c58713bc84d...6cb16f1c316c55e3b6108d178ffcde2e705cbe47,1,26,0,26,1,2014-06-11 21:15:48,2014-06-11 21:15:48
9ac293e1a8e1463f3fac1713213c9d250642ace8...37115ffb006fd89e6d3ca7ad8ff8e2ab1b9d38d7,1,1,0,1,1,2014-06-11 20:55:47,2014-06-11 20:53:10
9ac293e1a8e1463f3fac1713213c9d250642ace8...384b60b940e07d37c1ff544168a2407513114d80,33,0,3206,3206,32,2014-06-11 19:09:55,2014-06-11 19:09:55
fb2ac5bedb4e3e3d624dd8f4a4c595e066138a51...8a8b6d79649f666dd00f2efd60f773bb3eed898d,85,277,76,353,48,2014-06-11 02:49:57,2014-06-11 02:49:57
8a8b6d79649f666dd00f2efd60f773bb3eed898d...8194556337b65dda71a3d4d7f6ae9653ad5a19a0,18,30,30,60,30,2014-06-11 02:58:15,2014-06-11 02:58:15
8194556337b65dda71a3d4d7f6ae9653ad5a19a0...d1757c005f05c76b31615d1d4d27722faee8012e,1,1,1,2,1,2014-06-11 03:23:05,2014-06-11 03:23:05
fb2ac5bedb4e3e3d624dd8f4a4c595e066138a51...53802d54d6e2d322f4cd13e2cc6c294e73ef8b4e,1,2,4,6,2,2014-06-10 05:21:12,2014-06-10 05:21:12
f3db32c03515353697644fabf4f73e0dfb1d4fc0...381050b1eeb90e3e91c16021b82a6e09cd307c41,1,43,9,52,7,2014-06-18 23:09:03,2014-06-18 23:09:03
b3e80c6935b0565cb1fafee6311a0de9abf23212...2c5405f699c308eee0cfc87ec6dd8aa3bce1b2ef,1,8,0,8,1,2014-06-17 00:39:11,2014-06-11 21:29:42
2c5405f699c308eee0cfc87ec6dd8aa3bce1b2ef...7e9fbbba1ca4682d3645c410636dc7c78d38c769,1,4,2,6,2,2014-06-17 00:39:12,2014-06-17 00:38:53
ad19f1beb74cb06c46f4ba424a6a80594f0b6ed6...51d032737c812347c766bf7a3df43c18ec708b9e,1,1,0,1,1,2014-06-22 23:01:21,2014-06-22 22:59:47
ad19f1beb74cb06c46f4ba424a6a80594f0b6ed6...ba7245f07271d5ccba70ef659b3e88424cf36887,1,1,1,2,1,2014-06-21 21:14:23,2014-06-21 21:12:10
ad19f1beb74cb06c46f4ba424a6a80594f0b6ed6...00469957ad0e17adf60a486740f4132a503e7309,1,6,6,12,6,2014-06-21 08:32:39,2014-06-21 08:32:39
62b2b1bac3f44adb1281e134ecaa8ebcd09ffaf6...cf6834d797627208a9ec34326a85d594cdf1c918,1,1,1,2,1,2014-06-23 19:26:22,2014-06-23 19:26:22
f5309a2a090a1c8c0e22d9634f5c4d0cf92f03dc...e304e3a6624e740159e99e83d6d13f0a3cdfeb49,9,112,227,339,51,2014-05-09 18:09:59,2014-05-09 18:09:59
f5309a2a090a1c8c0e22d9634f5c4d0cf92f03dc...ca33d2589f69381719b456352fdaaaa3fe54d5ac,1,2,2,4,2,2014-05-09 05:57:04,2014-05-09 04:18:03
718154b3b6db33a77fb05829d29abcebb77beb86...bff0c4f3dc560109ed2d5dc6cae12453c9bc2747,1,0,3,3,2,2014-05-08 17:25:47,2014-05-08 17:25:47
718154b3b6db33a77fb05829d29abcebb77beb86...5d39175c22b01cb31ebabb0c52de913a5541cd8b,1,2,2,4,2,2014-05-08 16:49:50,2014-05-08 16:49:50
0f6fe22833213cc09ffc39f9584dcd3ce10ac9fa...670564d07096c190011bf7adf74afe4d61ef9720,1,15,11,26,4,2014-05-09 22:12:54,2014-05-09 18:48:55
bc77ec2b17b6822a5a930cc34ae0d8a32bffc253...d54dec4d8b6f36fa9211e7a3379f7e949c40b0ce,2,5,4,9,4,2014-05-12 22:26:23,2014-05-12 22:26:23
bc77ec2b17b6822a5a930cc34ae0d8a32bffc253...7894a70f8b2dcb329178978066d825dc41ec6239,2,28,21,49,9,2014-05-12 21:38:20,2014-05-12 21:38:20
a70bffd382e26342dfe26d6bb8ca39ee7f498f33...653328c6cef8bab89343587b134ba7676ee39867,1,1,1,2,1,2014-05-13 09:17:42,2014-05-13 09:17:42
2463849ecf2bc9812a4be4bbb10855c489ae9a65...46a47f0dcbce1a4240bc970388dd09d029f82f61,1,1,1,2,1,2014-05-10 01:38:12,2014-05-09 10:36:58
f65fadbda080647ccb7e07dc64a8cc020170c4c7...41f7cef2bd186d321fc4489691ba53ab41eb48e5,2,13,0,13,2,2014-06-03 01:23:47,2014-06-03 01:23:47
f65fadbda080647ccb7e07dc64a8cc020170c4c7...f41ced96af9dba56dd368e213e6e83fd02b85b03,1,54,48,102,28,2014-06-03 01:06:58,2014-06-02 21:16:30
f41ced96af9dba56dd368e213e6e83fd02b85b03...c024c9bd1ec13aade038f87266a03a1d1bc13441,1,32,0,32,2,2014-06-03 01:10:52,2014-06-02 21:46:28
6c4e5ee826e1ae08674ef6e517c77583796a844b...48dbee082403a57b4dbc344e12b6724016d64b72,2,23,13,36,11,2014-04-29 05:28:04,2014-04-29 04:52:01
6c4e5ee826e1ae08674ef6e517c77583796a844b...17fbe3de381c70ef852f8d1c50128299615d1ebe,1,0,2,2,2,2014-04-29 03:43:13,2014-04-28 08:45:03
6c4e5ee826e1ae08674ef6e517c77583796a844b...33f36177e9648b182415a7928d3b4b5dc9d0265e,1,2,0,2,1,2014-04-29 03:33:22,2014-04-29 03:33:22
5bb430197ef488644185a82b6d0abfe2155d6335...205bd91fcab30292ac5f246ce9bdbb045ad1023f,1,1,1,2,1,2014-05-03 00:11:00,2014-05-03 00:11:00
a96cac4d7d42db757f9387ff1352ebedfc7b557e...ebaff50bd2c94f2353f4bd738e077c7baef3e879,1,2,2,4,2,2014-04-30 00:12:21,2014-04-30 00:12:21
a96cac4d7d42db757f9387ff1352ebedfc7b557e...a39f3c9200d574c12b88fb91654f1242ec07b7b5,4,10,7,17,7,2014-04-29 23:26:27,2014-04-29 22:49:03
57cbe8b1060e28a365722341c52b1a8b69d368ba...baa4f395511c6fd0dd41c89c627215116abd9741,1,13,0,13,1,2014-04-17 22:42:23,2014-04-17 22:22:23
57cbe8b1060e28a365722341c52b1a8b69d368ba...05d7271f91fd29fb75202913fa8caab5f7790718,2,10,0,10,2,2014-04-17 21:53:39,2014-04-17 21:53:39
57cbe8b1060e28a365722341c52b1a8b69d368ba...359b7df5d2af5733b8a1ea6746d062053053b23e,91,827,827,1654,630,2014-04-17 21:43:01,2014-04-17 21:43:01
57cbe8b1060e28a365722341c52b1a8b69d368ba...cb6bcfd6bc1f71da324ca498dffda2c6c99e6090,4,140,128,268,7,2014-04-17 20:13:59,2014-04-17 20:13:59
57cbe8b1060e28a365722341c52b1a8b69d368ba...7f62f470f3dbe1ac67d3666681b7ce303af69995,3,54,21,75,22,2014-04-17 17:35:08,2014-04-17 17:35:08
57cbe8b1060e28a365722341c52b1a8b69d368ba...d072f316e300231b5d6dbfbaca348cdf65aad75d,1,2,2,4,2,2014-04-17 17:08:14,2014-04-17 17:08:14
57cbe8b1060e28a365722341c52b1a8b69d368ba...1ff66d27b5b35b9782d6d6cdd5fc5ec95bdda07d,8,16,16,32,14,2014-04-17 15:09:08,2014-04-17 15:09:08
57cbe8b1060e28a365722341c52b1a8b69d368ba...24a42b1370380179c48f88a3d2d81faddda9cbcc,9,0,463,463,9,2014-04-17 14:47:34,2014-04-17 14:47:34
57cbe8b1060e28a365722341c52b1a8b69d368ba...205e85da3211ed1600982ee1d189f1d070aa8b40,3,15,10,25,9,2014-04-17 12:48:03,2014-04-17 12:04:41
925dfdb18a3298834358d659221135a903749be9...65fb2e77eb8c5fdb419a94058f7b4630c00871af,1,11,10,21,6,2014-04-17 01:11:32,2014-04-17 01:11:32
925dfdb18a3298834358d659221135a903749be9...7de1557b2e5bc1ed86e19ffe080889ac74beea42,1,4,1,5,2,2014-04-17 00:56:02,2014-04-17 00:56:02
664ba0c0315770b6a6608ee308d46b4b8fb82e76...21e258d7328e56fd451e6ed0324cff094ec70798,1,1,1,2,1,2014-06-24 06:27:24,2014-06-24 06:27:24
664ba0c0315770b6a6608ee308d46b4b8fb82e76...87d522a5576125515274022d0b49e7bdc2942d18,1,1,0,1,1,2014-06-24 05:45:44,2014-06-24 05:45:44
664ba0c0315770b6a6608ee308d46b4b8fb82e76...c7a1bdf6c039c41877c007ab44902f084860ede0,1,1,1,2,1,2014-06-24 04:48:29,2014-06-24 04:48:29
664ba0c0315770b6a6608ee308d46b4b8fb82e76...42be6f2957c945e070079ec773e29b356a9f9452,50,7,1107,1114,15,2014-06-24 03:07:42,2014-06-24 03:07:42
664ba0c0315770b6a6608ee308d46b4b8fb82e76...f54823bf05af1d549aee4f0d1f56f9a8995eb268,8,38,15,53,14,2014-06-24 02:25:17,2014-04-26 10:22:05
f54823bf05af1d549aee4f0d1f56f9a8995eb268...cf513185b0803ac02bbd8cef05e3372e7fc3b269,4,1401,2,1403,6,2014-06-24 02:25:18,2014-06-23 00:09:54
b9f66049fa4d0dc2cdc0a430fe14029214456611...4d3e448a33f87ed18def8f4ee7a01ef66bc6549e,1,4,10,14,8,2014-04-16 02:15:13,2014-04-16 02:15:13
6d6ec5e0051ad081be3d71e20b39a25c711b4bc3...8d2226b7e5a5d5334f80d3ec03313fe2cd3210a3,1,5,0,5,1,2014-03-01 18:55:36,2014-03-01 04:43:08
6d6ec5e0051ad081be3d71e20b39a25c711b4bc3...bf6adf952b573d10d5e2eb1a08e382ea6182a5d0,1,257,0,257,1,2014-03-01 17:33:54,2014-03-01 17:33:54
6d6ec5e0051ad081be3d71e20b39a25c711b4bc3...b02b933c6292c539833c15c15299628ac3360572,3,41,4,45,3,2014-03-01 11:46:45,2014-03-01 07:29:00
b4146fbe4895387b39895a6620d5d425fd0e9619...0ca7df046bec20e86f3df3c7c4391b120c392b07,1,1,1,2,1,2014-02-28 19:06:36,2014-02-28 19:06:36
e388b6aba5e7d75fecf87223abcd3c1deffd27f0...476c290b079d94b1da02c6e72ed15b7f9bd7fce5,1,2,2,4,2,2014-03-06 22:51:44,2014-03-06 22:51:44
142213ade8b91af845489b66bfddb98951a8a3ab...b16f46635459b9e6f58a733e39ccb21c767d8e33,1,2,2,4,2,2014-02-28 19:12:21,2014-02-28 19:12:21
23ec7e637c13315ad7efdf5194c3f41e5d5bfa4d...cb3d27d01bbf696929b4d77d10e47eca2693e3fa,1,3,0,3,1,2014-03-03 19:17:28,2014-03-03 19:17:28
c63ce728cfa27cf84dff5484ef46c72dbfb1560a...551355c9adac6a8b36244e1962e7a104611ae4af,2,45,37,82,5,2014-02-24 19:54:50,2014-02-24 19:48:14
551355c9adac6a8b36244e1962e7a104611ae4af...4434b63ff44c6994366afebeceb9b570bb9ee26c,1,0,1,1,1,2014-02-24 23:10:45,2014-02-24 23:10:45
c63ce728cfa27cf84dff5484ef46c72dbfb1560a...8a1778301bffaf46abbce5cb76c1add47bd241a0,1,5,2,7,3,2014-02-24 19:53:56,2014-02-15 23:07:50
75e62a60a2eeeee44b50eb77d173567e72c66674...e8abaf217b887fcd6a157b4f905156bd245f8f0a,20,1531,0,1531,20,2014-02-21 22:56:15,2014-02-19 00:56:11
e8abaf217b887fcd6a157b4f905156bd245f8f0a...68b049aed4663eb5f6f53241390f7602c1b40c12,7,277,299,576,80,2014-02-21 22:56:15,2014-02-19 01:52:06
68b049aed4663eb5f6f53241390f7602c1b40c12...72e65b654b75d5087e50cc6366e78bd2f8318bae,3,50,50,100,19,2014-02-21 22:56:15,2014-02-19 02:15:41
72e65b654b75d5087e50cc6366e78bd2f8318bae...11429457691be3b009c6d9f4cc9fce9150d4e810,4,17,2,19,7,2014-02-21 22:56:15,2014-02-19 18:44:29
11429457691be3b009c6d9f4cc9fce9150d4e810...93d41e53ae64fd77340c31d3bc5531864ed28779,12,159,238,397,64,2014-02-21 22:56:15,2014-02-19 07:13:36
93d41e53ae64fd77340c31d3bc5531864ed28779...18f06b8d16c475568fd023e97eecc138ab052c2d,2,3,2,5,2,2014-02-21 22:56:15,2014-02-19 20:47:01
18f06b8d16c475568fd023e97eecc138ab052c2d...e25065a6b1df09771598d77cc698e4fcf1159bd4,7,81,118,199,47,2014-02-21 22:56:15,2014-02-19 22:33:25
e25065a6b1df09771598d77cc698e4fcf1159bd4...7bc3c012507edcfc5e8ab8523b240ac2bb03fe19,6,23,278,301,11,2014-02-21 22:56:15,2014-02-19 22:55:34
7bc3c012507edcfc5e8ab8523b240ac2bb03fe19...34671f20103fb975fed31a03705e04bc65aed239,6,63,67,130,20,2014-02-21 22:56:15,2014-02-19 23:33:44
34671f20103fb975fed31a03705e04bc65aed239...5428964400ece4cd79cc5d482307df5e8913469f,4,48,73,121,13,2014-02-21 22:56:16,2014-02-19 23:54:53
5428964400ece4cd79cc5d482307df5e8913469f...61a119220d88d20bb1cca111e9c8ba7cdb45d4f6,7,111,166,277,65,2014-02-21 22:56:16,2014-02-20 00:40:36
61a119220d88d20bb1cca111e9c8ba7cdb45d4f6...f3c48ec584707a9acaf9d79c2e161dadf1d2c99b,4,19,0,19,7,2014-02-21 22:56:16,2014-02-20 00:50:10
f3c48ec584707a9acaf9d79c2e161dadf1d2c99b...5d62916c48cb97320b37640592805d97badfd8ff,5,107,96,203,23,2014-02-21 22:56:16,2014-02-20 03:14:31
5d62916c48cb97320b37640592805d97badfd8ff...420b5eb211f877baac9622e7bedde2948c043619,4,133,1,134,4,2014-02-21 22:56:16,2014-02-20 03:53:25
420b5eb211f877baac9622e7bedde2948c043619...d84feb8fe5e40838c81321249189f1f0a02825bb,6,55,55,110,21,2014-02-21 22:56:16,2014-02-20 04:35:04
d84feb8fe5e40838c81321249189f1f0a02825bb...3a97fe27d8f5a9bbcf4992cc9efe33880e73f274,2,60,30,90,13,2014-02-21 22:56:16,2014-02-20 05:15:44
3a97fe27d8f5a9bbcf4992cc9efe33880e73f274...e0ff0f4dd6612e331459a2dec69adc728bc360fe,2,2,0,2,2,2014-02-21 22:56:16,2014-02-20 05:21:49
e0ff0f4dd6612e331459a2dec69adc728bc360fe...70593be139647cdedca0130250626ea6e0b8a277,10,97,45,142,39,2014-02-21 22:56:16,2014-02-20 06:43:40
70593be139647cdedca0130250626ea6e0b8a277...e133d895a6934e650f64f391f9f26b29b0379457,1,0,22,22,1,2014-02-21 22:56:16,2014-02-20 06:46:02
e133d895a6934e650f64f391f9f26b29b0379457...f0b4dd6e5883a65dc23121934b6eed7e70ac2515,1,32,0,32,2,2014-02-21 22:56:16,2014-02-20 20:00:54
f0b4dd6e5883a65dc23121934b6eed7e70ac2515...664fc54e65ebc14ca9dd5bfc55e3dfe1796e51c8,6,218,10,228,11,2014-02-21 22:56:16,2014-02-20 22:12:08
664fc54e65ebc14ca9dd5bfc55e3dfe1796e51c8...5f84738ef139f696e339afb8280eb74917f2167c,1,0,32,32,2,2014-02-21 22:56:16,2014-02-20 22:40:00
5f84738ef139f696e339afb8280eb74917f2167c...f00f37413826e31e9eb87096b67c609fdfa457b9,1,1,1,2,1,2014-02-21 22:56:16,2014-02-20 22:40:36
f00f37413826e31e9eb87096b67c609fdfa457b9...c44258630575f70231b11fb55bc4edc3fb677cab,4,123,103,226,32,2014-02-21 22:56:16,2014-02-20 23:48:48
c44258630575f70231b11fb55bc4edc3fb677cab...3cb698125da7b55a7d7ec43b33858f35844a6143,4,9,4,13,5,2014-02-21 22:56:16,2014-02-20 23:50:55
3cb698125da7b55a7d7ec43b33858f35844a6143...7020e208c70dfca5ebc97d699553e4bf1c6ab0bb,3,127,144,271,4,2014-02-21 22:56:16,2014-02-21 00:11:22
7020e208c70dfca5ebc97d699553e4bf1c6ab0bb...b519d3ea5a50ad7c15d576a89ec9846c4fc123fa,2,12,9,21,10,2014-02-21 22:56:16,2014-02-21 01:53:50
b519d3ea5a50ad7c15d576a89ec9846c4fc123fa...8dec4adcb3fd905eb05f07678fa7f5bb47d8242f,3,19,11,30,13,2014-02-21 22:56:16,2014-02-21 01:58:13
8dec4adcb3fd905eb05f07678fa7f5bb47d8242f...83dfdd1d9587a7335bbf3a4656572baefae4f28d,1,3,2,5,3,2014-02-21 22:56:17,2014-02-21 01:59:08
83dfdd1d9587a7335bbf3a4656572baefae4f28d...1a4fb0921919720ab379bc82b7508580057770ee,4,70,30,100,10,2014-02-21 22:56:17,2014-02-21 02:05:40
1a4fb0921919720ab379bc82b7508580057770ee...66baa0653b636180b8b5c57c58f4bbc805aca8c5,1,5,1,6,2,2014-02-21 22:56:17,2014-02-21 02:10:30
66baa0653b636180b8b5c57c58f4bbc805aca8c5...1316007e54e0c5a25f0d67675df7dec40286f5e8,7,20,12,32,14,2014-02-21 22:56:17,2014-02-21 02:27:42
1316007e54e0c5a25f0d67675df7dec40286f5e8...6b2e963ce0aef802e60eafe0e895f24abb294a07,3,20,19,39,16,2014-02-21 22:56:17,2014-02-21 02:38:28
6b2e963ce0aef802e60eafe0e895f24abb294a07...7f247e7006761ac8922a58651a76b194a4655ffa,5,11,12,23,14,2014-02-21 22:56:17,2014-02-21 21:53:11
7f247e7006761ac8922a58651a76b194a4655ffa...50c752fcb06497e9e597049a1007c53d77032d17,3,76,21,97,41,2014-02-21 22:56:17,2014-02-21 22:49:55
fbc00df7a0cc500314bd9dd5fca2fe54d011033f...046e6604e56ec93647550630fcf729c7e5ab3280,1,49,58,107,16,2014-03-05 20:27:49,2014-03-04 12:53:22
fbc00df7a0cc500314bd9dd5fca2fe54d011033f...5b5c884cc8266d0c2a56da0bc2df14cc9d5d85e8,1,18,4,22,4,2014-03-04 11:44:08,2014-03-04 11:44:08
ad88d0be83fa317010fbeabe09471948256b1207...9c4799b7e7627b21f2748458e46d697c3ee4981e,1,3,0,3,2,2014-02-24 23:07:40,2014-02-24 23:07:40
ad88d0be83fa317010fbeabe09471948256b1207...3839e3a0f63c8acc4cb11a87b862f159e5b2aedc,2,37,12,49,15,2014-02-24 22:53:00,2014-02-19 00:24:32
f14f4aa509c5ab3c7fcb7616583bcb9d8a91ddf4...62b21daded2ea9b703a6e5fa0479e007016b1edb,2,8,0,8,4,2014-02-24 20:29:39,2014-02-24 20:26:56
62b21daded2ea9b703a6e5fa0479e007016b1edb...cd846ecb60ad936d58d70762ed91cffa906cef93,2,37,0,37,5,2014-02-24 20:29:49,2014-02-15 23:06:21
b722aa21b7ddfd558c2a36c8301d61b011221197...772ef99d2816b629d084e11fe7fba5953687b620,7,43,168,211,19,2014-03-06 23:30:26,2014-03-06 22:14:25
d9f47c41c3a451efd18e59d7aedd383db849d56f...50082f792be22b97dcc79afe666289ecefbc3864,4,123,76,199,27,2014-03-10 09:27:46,2014-03-10 05:16:42
d9f47c41c3a451efd18e59d7aedd383db849d56f...12bd83182dff24a800eee6e7e93beeab30b480b7,3,11,9,20,10,2014-03-10 05:59:28,2014-03-07 23:22:23
12bd83182dff24a800eee6e7e93beeab30b480b7...82a5439835b0bff3ab3dfb169415948dae504d56,14,136,111,247,82,2014-03-10 05:59:29,2014-03-08 01:36:47
82a5439835b0bff3ab3dfb169415948dae504d56...01b6b2be73a6f40e0179e0217385eea6b41100a5,8,70,62,132,42,2014-03-10 05:59:29,2014-03-08 02:04:38
01b6b2be73a6f40e0179e0217385eea6b41100a5...36c3614fdde079fad178390f651945fba884668a,15,251,186,437,145,2014-03-10 06:03:40,2014-03-08 02:42:29
36c3614fdde079fad178390f651945fba884668a...47edf3e8bf759270c243711eaed1faa1d4d61f35,1,1,0,1,1,2014-03-10 06:16:15,2014-03-10 06:16:15
d9f47c41c3a451efd18e59d7aedd383db849d56f...df9b99aca0b8a65da866aa5696b9f45df3b92e50,1,9,23,32,10,2014-03-09 02:25:19,2014-03-09 01:49:36
f9fde52a073f7c5a8a283ee694939aabe01a81dd...f0eb227548427f6fc829f2b270ad83d22bd90c69,2,15,3,18,3,2014-03-12 00:51:46,2014-03-12 00:51:46
0a6d9035cf37e567e4573fce5ac4b192c21abf47...721562f29685ebf3f3698113cf0ce8000c02e606,2,9,0,9,3,2014-03-11 18:39:28,2014-03-11 18:39:28
721562f29685ebf3f3698113cf0ce8000c02e606...fd0737df2c8ec8f0a4b4d8f20b2ad6e4c96adbd3,1,1,1,2,1,2014-03-11 19:08:32,2014-03-11 19:08:32
8a5060dba47ef9d91470c16e8ec3a9db59e60695...44d54ba0c299540efbfa173bf484d541e857f4ac,1,7,2,9,3,2014-04-29 09:01:07,2014-04-29 09:01:07
be5c65c2a2df00df806c497cf9d5d70c635eb38f...792bb41e524615486ef8266b7bf4804b4fe178f1,1,21,0,21,3,2014-03-28 13:19:21,2014-03-27 20:38:27
be5c65c2a2df00df806c497cf9d5d70c635eb38f...7a3070a6000963d12be9dcd2698d911b848a33b6,11,104,51,155,28,2014-03-27 20:47:47,2014-03-13 16:03:09
7a3070a6000963d12be9dcd2698d911b848a33b6...7f7d8419a71d49b25e4d38196b36e93b568bb61d,3,205,171,376,11,2014-03-27 20:47:47,2014-03-14 09:47:49
7f7d8419a71d49b25e4d38196b36e93b568bb61d...9294d7f2af6ecb7c18be11fb5043fad4a61d8f09,1,1,1,2,1,2014-03-27 20:47:47,2014-03-14 10:45:29
9294d7f2af6ecb7c18be11fb5043fad4a61d8f09...d4725801b3401d04b3f35b5783bdc0fc362f7f00,74,8313,1,8314,74,2014-03-27 21:44:26,2014-02-21 09:34:06
d4725801b3401d04b3f35b5783bdc0fc362f7f00...cb43fd007133fc05b6bb2b0d3d58fef8b1e60537,3,1,93,94,3,2014-03-27 21:44:31,2014-03-18 17:40:00
cb43fd007133fc05b6bb2b0d3d58fef8b1e60537...1296d5ce9ad43d8d833f6e5661da45aef6d4c26b,1,15,0,15,1,2014-03-27 21:44:31,2014-02-21 09:48:02
1296d5ce9ad43d8d833f6e5661da45aef6d4c26b...6c7835050e53b733181ddfca6152c358fd625400,4,199,1,200,6,2014-03-27 21:44:31,2014-02-21 13:35:43
6ac6619a1ed52cbc1c0d8661c2cc40e9166fb989...ab26c16b32420011b0aee3de1a3bce5a0afd6f4d,4,19,5,24,7,2014-03-13 20:58:09,2014-03-13 20:58:09
ab26c16b32420011b0aee3de1a3bce5a0afd6f4d...7b89af2a08b65fac064603cb3b5eb8e091e2c076,1,14,2,16,4,2014-03-14 00:06:17,2014-03-13 21:03:03
6ac6619a1ed52cbc1c0d8661c2cc40e9166fb989...6fc83eefd9e8d78044a51250d2ad185513fddd27,1,21,5,26,5,2014-03-13 19:39:24,2014-03-13 18:15:52
c7564b5e4d58c38e2f1ec5c4ab20b714b8949d28...73596b00e053fedbf42f7abb87728e7176e5a95c,1,1,12,13,1,2014-03-13 06:39:36,2014-03-13 03:01:27
c7564b5e4d58c38e2f1ec5c4ab20b714b8949d28...471aa870f57e66128b08ec28e908fb1faacdfd40,1,0,1,1,1,2014-03-13 05:18:13,2014-03-12 05:52:39
471aa870f57e66128b08ec28e908fb1faacdfd40...841fcad0ba03ff71a27ad2892fab3fdc83d071d8,1,2,2,4,1,2014-03-13 06:19:42,2014-03-13 06:19:42
2ada6441db6ac42abd42ac6ac7ad7439da123d0e...edd8d2d3511b0b632149d1c1f2cfd2bad2df4679,3,11,6,17,6,2014-03-17 18:40:57,2014-03-14 01:02:28
edd8d2d3511b0b632149d1c1f2cfd2bad2df4679...afcaaffd0bb84d0c97f4a3ef54f4d35ba3942f65,2,2,0,2,2,2014-03-17 18:40:57,2014-03-14 01:04:35
afcaaffd0bb84d0c97f4a3ef54f4d35ba3942f65...a18d08177c1b11fd1e88c27d78a7256b5d498d64,1,1,0,1,1,2014-03-17 18:40:57,2014-03-14 17:13:11
a18d08177c1b11fd1e88c27d78a7256b5d498d64...326f6a4b4d942bf75ecb003e5c0d439bcb9d67cf,2,6,6,12,6,2014-03-17 19:17:40,2014-03-17 19:17:40
2ada6441db6ac42abd42ac6ac7ad7439da123d0e...2230c9b9a735d731cc2fee4137633eb98b9da9d5,13,9,9,18,5,2014-03-17 18:40:12,2014-03-14 21:03:23
2230c9b9a735d731cc2fee4137633eb98b9da9d5...af385151ceedde097eda8a5195b431e8076cf76b,21,18,18,36,12,2014-03-17 18:40:12,2014-03-14 21:07:32
af385151ceedde097eda8a5195b431e8076cf76b...96c4816cef592a98a235010924bb2417c8451079,31,19,19,38,14,2014-03-17 18:40:12,2014-03-14 21:11:43
96c4816cef592a98a235010924bb2417c8451079...2bddcd68b4b927d36ffadd80e098f6d4ae2cf5d6,14,20,20,40,30,2014-03-17 18:41:28,2014-03-14 22:07:52
dce7b6a69c42fb64a99f873a5f7568799228c1e5...38e5b4e70fb6b93aa2b86e4d625a0032b97b991a,2,79,62,141,27,2014-02-12 17:29:06,2014-02-12 17:29:06
f9cd1be6ffbda85f20cc7926274fab7484a19823...c626349f651a660302f64101055d65dc6e990307,1,2,0,2,1,2014-02-11 17:32:31,2014-02-10 22:11:17
f9cd1be6ffbda85f20cc7926274fab7484a19823...27ed9a9f98750ab666d6221553b6f4ea59d396b8,1,4,32,36,3,2014-02-11 11:32:35,2014-02-11 11:32:35
d3c084beeec1b89940f304b3d123f5f810fe5ff8...59347fa66dfdd059c270a5f72e24320b4d0203ea,1,22,9,31,10,2014-02-12 15:02:53,2014-02-12 15:02:53
d3c084beeec1b89940f304b3d123f5f810fe5ff8...85263cdee894d1f1e3bca21a8d18264ef530c4d5,1,1,1,2,1,2014-02-12 13:02:36,2014-02-12 13:02:36
d3c084beeec1b89940f304b3d123f5f810fe5ff8...d9f215eb2a48e6e836af9cc4015c73f17dc5be9e,1,13,3,16,3,2014-02-12 06:30:18,2014-02-12 06:30:18
619ad8421611e774a851b7be81ba8ae0a31963a2...7ea725fdc530e989516fae60f5dafecb139d75b8,1,1,1,2,1,2014-02-12 01:23:17,2014-02-12 01:23:17
72ed2537b31daf2cf3dbfa005da39dff531b1eb5...ab0f3f86c8d05aa69415e6909a88b621d5b37e81,1,7,0,7,1,2014-02-17 15:10:54,2014-02-17 15:10:54
72ed2537b31daf2cf3dbfa005da39dff531b1eb5...02d94dcf6ec2541c66b081d4dc251725f994747c,1,8,5,13,5,2014-02-17 14:04:47,2014-02-11 11:23:31
72ed2537b31daf2cf3dbfa005da39dff531b1eb5...6a5a1d44f5d6c1281a66d562b7a4310dd6c3b997,2,7,0,7,2,2014-02-17 02:24:19,2014-02-17 02:24:19
72ed2537b31daf2cf3dbfa005da39dff531b1eb5...4ab3c31b155997821d5f75689617235fa7386efa,1,71,0,71,1,2014-02-17 01:52:50,2014-02-17 01:44:25
72ed2537b31daf2cf3dbfa005da39dff531b1eb5...797b7d3446304be01c220c29f3dc6c4dcc2711be,2,2,2,4,2,2014-02-17 01:35:55,2014-02-13 04:48:55
72ed2537b31daf2cf3dbfa005da39dff531b1eb5...8871fd3a317240dbd6d5a9ae3309726281572bc1,1,4,4,8,1,2014-02-17 00:02:23,2014-02-17 00:02:23
72ed2537b31daf2cf3dbfa005da39dff531b1eb5...a51441278afbfde76ac1ec1e01c619fe5733b895,3,34,0,34,3,2014-02-16 15:49:36,2014-02-15 00:43:55
72ed2537b31daf2cf3dbfa005da39dff531b1eb5...cfb7711a74dc4b54d879f79bc2f6435ed71163b9,1,61,0,61,1,2014-02-16 04:18:47,2014-02-16 04:02:54
cfb7711a74dc4b54d879f79bc2f6435ed71163b9...64716a21e464ac63dd9b287c832ae3431e1418d0,1,22,3,25,9,2014-02-16 04:24:55,2014-02-16 04:24:55
64716a21e464ac63dd9b287c832ae3431e1418d0...778f1bf6639e52004608ca2289e04b8f7bddb14b,3,34,20,54,5,2014-02-16 04:49:50,2014-02-16 04:49:50
778f1bf6639e52004608ca2289e04b8f7bddb14b...d5e41c1cb67b7ccb86fbbd80079642afd5055c2a,2,5,5,10,5,2014-02-16 05:10:37,2014-02-16 05:10:37
d5e41c1cb67b7ccb86fbbd80079642afd5055c2a...e743021193e589b1358d0eef0521e9d8878dd66d,1,4,1,5,2,2014-02-17 23:10:51,2014-02-17 23:10:51
f3ff19049138afebe4e28e30be2ee60364204f50...513d86488046bfd898f5f1fdab39bfb302607535,1,3,0,3,1,2014-02-17 19:35:26,2014-02-17 19:35:26
f3ff19049138afebe4e28e30be2ee60364204f50...a75c6907b48f730fe79c6c9ebfe22eeea6389f4a,1,2,0,2,1,2014-02-17 19:17:05,2014-02-17 19:17:05
56584a92f43f7f05789b345970d672bcbbdd32b0...7bce5957a08ae31f4b83d1a13ad056e5b2af15e1,1,7,10,17,4,2014-02-25 20:07:19,2014-02-25 20:07:19
27a43692c2b114ed9b6418e75d16cbb2e6c7a993...d59c05a37c3e964cdeef818afc2e7c3a3e8d0cf1,6,16,14,30,10,2014-02-25 04:41:09,2014-02-25 04:41:09
d59c05a37c3e964cdeef818afc2e7c3a3e8d0cf1...f8453cd0499a51f5d3ffd2c2a6012972aef7f69f,12,95,130,225,64,2014-02-25 05:11:52,2014-02-25 05:11:52
f8453cd0499a51f5d3ffd2c2a6012972aef7f69f...8db740a38e333158e613bc5b3a7acc2605131581,3,55,59,114,18,2014-02-25 05:21:35,2014-02-25 05:21:35
8db740a38e333158e613bc5b3a7acc2605131581...431d510cae85bc1265c861028dd9751ae95088b2,5,40,38,78,6,2014-02-25 05:51:00,2014-02-25 05:51:00
431d510cae85bc1265c861028dd9751ae95088b2...a64ebabdfaca66709d664cb87a35d689e35cfd0d,1,0,23,23,4,2014-02-25 05:54:37,2014-02-25 05:54:37
cb0ac55b5b9fa3eed064eea5b954ccb16b2571e7...df4682907ddc41084bf193b863ff9da796b8e102,1,3,3,6,3,2014-02-04 05:32:19,2014-02-04 05:32:19
cb0ac55b5b9fa3eed064eea5b954ccb16b2571e7...64426c74f2599799bd39d04a28d43a05af7624a4,1,1,1,2,1,2014-02-04 05:29:47,2014-02-04 05:29:47
e6ae8f6d21f8d3a140e4c96a4fbe6786fe866ea9...b994c1315997945815e7b927b8493595b194d016,1,12,6,18,1,2014-01-26 20:24:03,2014-01-25 06:01:12
e6ae8f6d21f8d3a140e4c96a4fbe6786fe866ea9...31e59580092bd4f144bf512e2fd13dcba426b02a,1,1,1,2,1,2014-01-26 13:11:30,2014-01-26 01:22:59
e6ae8f6d21f8d3a140e4c96a4fbe6786fe866ea9...33ee78004f0f2a3cd760952f724c5ea0a9d24b37,1,1,1,2,1,2014-01-26 07:08:55,2014-01-26 06:30:27
e6ae8f6d21f8d3a140e4c96a4fbe6786fe866ea9...5c04f1bcc70e81fe3c93b1c246ce17a11304ad7f,2,23,34,57,3,2014-01-25 03:20:34,2014-01-24 22:57:04
88d66600b3b8d71300151008c5d9eb58a799d9c9...720c5774e9a9cd510320a142848832f7cd314da7,1,38,23,61,4,2014-02-03 21:18:10,2014-02-03 21:18:10
88d66600b3b8d71300151008c5d9eb58a799d9c9...0fa9199f781ecd27469ca192496ce7b8e24980b1,2,5,5,10,5,2014-02-03 19:38:34,2014-02-03 19:38:34
b5d6208ccf61e1503af3ca8b577b20392fede3d6...a51f5a287b7b393b23e27787f090575b30cbb68a,1,28,19,47,5,2014-02-04 01:23:01,2013-12-04 10:35:23
a51f5a287b7b393b23e27787f090575b30cbb68a...9f994c96468e2495a2dc118355b6565e7dac0f44,4,92,1,93,6,2014-02-04 01:31:19,2013-12-04 10:36:21
9f994c96468e2495a2dc118355b6565e7dac0f44...ded9e0d6dfbcfe0f2ccd448baf0acb4378365bac,2,7,7,14,4,2014-02-04 19:11:56,2014-02-04 18:41:37
ed93dab9a8d26efd2a6defe6dc60c9db045cb6c0...8072d3a4e009f404fbc31507887c3418ea7327fc,1,3,3,6,3,2013-12-19 19:55:19,2013-12-19 19:55:19
954158ce52075543b04cf012fe88dd08151d5b71...ea8a3438f769c85725f34c6e51d7c73ed1fff962,2,100,39,139,37,2013-12-23 16:45:51,2013-12-23 16:45:51
949fde88df5c11447cea7115ce3a2bcf7c73ed6d...58ec7855bc4f724a32f585f4455b5d954f335c3c,1,1,1,2,1,2014-01-03 00:46:50,2014-01-03 00:46:50
f43f3fa2187450aacbb72380903b109f45d3d0cd...15689b56c8e397d3207dad5b23937cb9b1e453cd,3,27,12,39,8,2014-01-10 23:51:48,2014-01-07 01:34:51
f43f3fa2187450aacbb72380903b109f45d3d0cd...444a087ac2ca34776b2b3e4433aa35c27cdfd57a,1,34,21,55,4,2014-01-07 01:44:22,2014-01-07 01:37:49
f43f3fa2187450aacbb72380903b109f45d3d0cd...e1c861cf331b416c45a5e79102de3b44b13bf1a0,1,2,2,4,2,2014-01-07 01:37:30,2014-01-07 01:37:30
3afb89da48ee7e6e917d852416d434de9e078306...b95fbe2d3fa7ec27a193dc260837f36581ea1771,1,1,1,2,1,2014-07-09 19:24:11,2014-07-09 19:24:11
700880ca16898bc9d007cc76323e661bc28034e1...6e4b37fffdfc324141aae9f86268db4e8ed7aeb0,1,1,1,2,1,2014-07-03 21:02:40,2014-07-03 21:02:40
700880ca16898bc9d007cc76323e661bc28034e1...5c246c931eec7ec31a90fc4ae1577eb54f938427,1,6,0,6,1,2014-07-03 20:24:24,2014-07-03 20:24:24
c60cde14990a4d3b502af19895e2c8bbabd0f9ba...66bccf3064effd910e47405dc738ba08a8d14b12,1,2,1,3,2,2014-06-20 11:49:22,2014-06-20 11:49:22
b2eb79b7dad44fcbfac31565bec3763bb7ec796c...f55fa8211b6faf08091dd99ed8e5e3f08ab9cf1f,1,1,0,1,1,2014-06-20 16:22:31,2014-06-20 16:22:31
b2eb79b7dad44fcbfac31565bec3763bb7ec796c...a206186f8427c74fbf9625e4140bf84461a67eec,2,65,18,83,18,2014-06-20 16:11:26,2014-06-20 16:04:48
c99ee556d4e9a028fa68b40816b75200be690534...207d7807af35a3f1ee98e6401bff83146d2450f8,2,4,4,8,4,2014-06-17 16:38:04,2014-06-13 01:24:09
c99ee556d4e9a028fa68b40816b75200be690534...9494643bf1fcd38974266555e59e1b2d2573c418,1,31,0,31,1,2014-06-12 19:11:51,2014-06-12 19:11:51
9494643bf1fcd38974266555e59e1b2d2573c418...f5979b9d0dd993a00e064114218ccdbfdaab9fe0,1,4,1,5,2,2014-06-12 19:20:57,2014-06-12 19:20:57
c99ee556d4e9a028fa68b40816b75200be690534...338e87f6b34f36dcbb68db3b2999ce2bce5b40da,1,2,0,2,1,2014-06-12 07:54:35,2014-06-11 21:35:16
c99ee556d4e9a028fa68b40816b75200be690534...cb47ddd968747091fd1b3d408dd36c4c2086e69f,2,2,2,4,2,2014-06-12 06:25:09,2014-06-11 19:25:30
c99ee556d4e9a028fa68b40816b75200be690534...4ccd91f0d8052ada203e2551b11121613d54f44a,2,7,8,15,3,2014-06-12 01:09:43,2014-06-12 01:03:34
c99ee556d4e9a028fa68b40816b75200be690534...a084f4bc61a81eb9076246d85d6cc5168b32a949,1,1,1,2,1,2014-06-12 00:09:19,2014-06-12 00:09:19
30313cacce8d1b5c2e373fb2c08b539bfd25007f...cf331cdd6ad35c6e0d291df51b49aef5909671f5,2,83,31,114,11,2014-06-19 07:34:04,2014-06-19 06:17:13
cf331cdd6ad35c6e0d291df51b49aef5909671f5...d31ae5aed80eeb40a461930776ad2b507804bf4e,5,64,124,188,10,2014-06-19 20:00:53,2014-06-19 18:07:57
d31ae5aed80eeb40a461930776ad2b507804bf4e...707ef9618b3b26a0534a0af732a22f159eccfaa5,2,9,7,16,5,2014-06-19 20:02:21,2014-06-19 18:57:09
30313cacce8d1b5c2e373fb2c08b539bfd25007f...f619243099a384a499fb92ed1065cb4cb87ce3ea,1,0,0,0,0,2014-06-19 04:59:20,2014-06-14 08:22:35
30313cacce8d1b5c2e373fb2c08b539bfd25007f...a84115206928efd8e506641d2f8f31d136a05041,1,1,1,2,1,2014-06-19 03:50:56,2014-06-19 03:50:56
9a7bd6d95b42d89db4c005e6fcbc0535f4031bfb...cb40e3302e41c62d17a4d7c1935dd28e64ee2748,2,2,2,4,2,2014-06-10 18:18:20,2014-06-10 18:07:04
7a0e5991421d423908504531bee7b5dc46443b3f...3e2a9f667fbfd2b526b5bab4f8983f8c44685e87,5,0,37,37,5,2014-06-18 23:13:54,2014-06-18 23:13:54
df217f537706ba89f17c40b54a8ddf40f41d4462...8646bf4a403aa5333d00d0cea27e2dabe242146f,1,27,28,55,18,2014-06-19 00:50:24,2014-06-19 00:50:24
259d714b9300f5b30f8da2380ae996d7b901e463...31e8993d5725421d5979ec7fa247e353aea122b6,1,1,1,2,1,2014-06-08 15:25:53,2014-06-08 15:25:53
5e8402568e9d3cc2c7c3bb6c9c10d6a1ec5bd0d8...21849f1a2149660005d465376d055924b6ab887a,1,1,1,2,1,2014-06-17 00:49:23,2014-06-17 00:49:23
e876067e3457b24fb16146723cd8c21062c34d1c...9559f57463f8cd4c1af726514ae744a646fdd462,1,38,0,38,1,2014-06-23 02:39:45,2014-06-17 11:52:52
e876067e3457b24fb16146723cd8c21062c34d1c...1e847bff7af8ae722318cc7d448f46be955496c3,1,1,5,6,2,2014-06-23 00:36:02,2014-06-23 00:34:04
c32036fa9be9c6be4adcb18f7457f9c034851f83...edf16383c60c8c05549a97a0fb909c2387f69bce,2,3,3,6,2,2014-06-23 18:35:15,2014-06-23 18:35:15
c32036fa9be9c6be4adcb18f7457f9c034851f83...8228d0e2bbd3a42755a84e11455b51a5caf61a94,1,4,10,14,3,2014-06-23 17:52:03,2014-06-23 17:52:03
3f600c831be720fac60ff8a78aa3e344a7423c4e...edcb41451aa388abe03d4f837ab5ee316a53a030,7,97,14,111,14,2014-06-23 20:34:09,2014-05-09 22:26:41
5b525feaed4b8452b55b71119a25d1e0914e4f8f...fe445a2447e701cc91ef77d7bcb0978a5d373940,1,3,0,3,1,2014-05-13 02:51:00,2014-05-13 02:50:31
29f1efc94040df21aaf6e932fc797a1113ab03cb...2899195540857f2ad7c50ea509847c3a598c5e81,1,5,0,5,2,2014-05-09 21:42:22,2014-05-09 21:41:18
0d78799db779d867eb8e8d264405a8be21df70ee...100a92146e563d39d5a401c11d48e7b4ef7fad6e,2,30,32,62,3,2014-05-13 00:54:46,2014-05-13 00:54:46
0d78799db779d867eb8e8d264405a8be21df70ee...d33b4655c4339dcbbf9f78948598e216ac3c06b4,11,165,140,305,29,2014-05-13 00:05:07,2014-05-12 23:40:19
0d78799db779d867eb8e8d264405a8be21df70ee...62bfef59f7ae6f9128bfc3e7ef2e6ed5e4441d2e,1,1,1,2,1,2014-05-11 13:23:53,2014-05-11 13:12:48
1d4caadfe2176f8d95bb1fdc032416eacf300e40...359f8aca29bf0e7fca757fa73e1d5565ed2d16f7,1,21,10,31,3,2014-05-14 21:03:33,2014-05-13 12:23:56
1d4caadfe2176f8d95bb1fdc032416eacf300e40...ae85dd54582e94d36b146ab1688844ed58cc8df3,1,0,3,3,1,2014-05-13 18:59:27,2014-05-13 18:59:27
1d4caadfe2176f8d95bb1fdc032416eacf300e40...b7c7b851dce28bb679e0289168da382d7cdad74b,1,7,0,7,2,2014-05-13 17:24:52,2014-05-13 13:42:21
b7c7b851dce28bb679e0289168da382d7cdad74b...dcf81f95fdfe3ac8e97602d2ef2fef03288c15b1,8,33,33,66,6,2014-05-13 17:35:57,2014-05-13 17:34:30
dcf81f95fdfe3ac8e97602d2ef2fef03288c15b1...ca040b1a377c467a9504ffa256ae77d9e3d29f0c,3,6,5,11,7,2014-05-13 17:54:08,2014-05-13 17:54:08
ca040b1a377c467a9504ffa256ae77d9e3d29f0c...ea7647099fcabd73077a403d461e9a0778dda12f,1,2,0,2,1,2014-05-13 18:27:24,2014-05-13 18:27:24
3fb08708788816a62f062305cb9244c1b2077ed4...3a77a73a856f50a5954f22c5a76395ca77e43d00,1,6,6,12,1,2014-06-03 05:40:22,2014-06-03 05:26:14
797a4151a04ae5b3ad8aae6ed09a376e5c68108f...6e05c420c9b7e4660b391643be21720d6f80e18d,2,7,2,9,3,2014-04-29 20:55:04,2014-04-29 20:03:33
3a1f0dedc71712403c591dd9e552f7a906c2e4ea...dca1c0073f42b0d75e914119eae863d6e6087cd6,1,1,1,2,1,2014-05-03 10:22:33,2014-05-03 10:22:33
3a1f0dedc71712403c591dd9e552f7a906c2e4ea...3d605683b3d272982399635a55ee81b2a7535e81,4,100,63,163,13,2014-05-03 00:37:06,2014-04-27 22:06:09
3d605683b3d272982399635a55ee81b2a7535e81...c4089ad80bcc1466535696ac0b11d388df529391,2,51,35,86,5,2014-05-03 00:37:32,2014-04-27 22:21:42
c4089ad80bcc1466535696ac0b11d388df529391...328d65dcff423b14e76f03ee65445032da31ed42,2,18,12,30,4,2014-05-03 00:54:52,2014-05-03 00:54:52
3a1f0dedc71712403c591dd9e552f7a906c2e4ea...4a3b0e8d5d2653cfecbfee370be2406265211253,1,2,2,4,2,2014-05-03 00:20:59,2014-05-03 00:20:59
20e9f61971a858baef1c8035f5f08ceefdc7c92d...9e2e26c69a52c0b55d31de477a652731f87b4558,1,2,2,4,2,2014-04-30 09:10:09,2014-04-30 00:12:21
9e2e26c69a52c0b55d31de477a652731f87b4558...494c789ac34d3f22d5f6275937155e0aa2647374,4,10,7,17,7,2014-04-30 09:10:09,2014-04-29 22:49:03
494c789ac34d3f22d5f6275937155e0aa2647374...e802b69146ac7a008d943a3a289fba56150b4f81,1,151,0,151,2,2014-04-30 09:10:09,2014-03-25 12:19:41
70b56529847cf0c1fa58e5060c2a471701801f98...a1a9baf926ff8ec2bd7ba0dd39cf3a9eb5fab1d3,1,2,9,11,1,2014-04-30 05:19:21,2014-04-30 05:19:21
6df19aa78ee71faeb41471667d59b5ae6281e150...d4a00c749440899c629a9f67b968295a4673c476,1,1,1,2,1,2014-04-18 06:34:53,2014-04-18 06:34:53
58595475ea1c96472cc1ada4dfaed203f5ec86f6...a75758fcf648ed22fe979cbb625c209a92c5d873,1,1,1,2,1,2014-04-17 22:43:06,2014-04-17 22:43:06
6934f0fa9eae0f976d47ec8f0366f3a907d44b05...f3bf61fad427f81ecfede2728163626a009e8333,1,3,3,6,1,2014-04-17 23:51:04,2014-04-17 23:51:04
6934f0fa9eae0f976d47ec8f0366f3a907d44b05...eceeebc22d9e4d75630e333759895a868ceba234,2,45,76,121,8,2014-04-17 23:49:59,2014-04-14 11:23:43
5b6b91aa2c1354e484a64479418e92031765d41e...7935850005b775e0cd1a99f9bab1b8cd53784c3a,42,377,436,813,77,2014-04-18 20:31:38,2014-04-18 20:21:55
ad8db1aa22c2ee791ffc612e6b8dbd2b780f6070...2f3cb370dfaca1f1c41bbd7af5f064f70ad8267b,20,88,128,216,44,2014-04-17 22:58:02,2014-04-17 22:55:24
f1ac8962f995d650ec10b04b055c8bbb0db4bec4...ed032ddfd68a8654671a13d676c0f7539e36a10b,6,214,202,416,12,2014-06-24 17:19:15,2014-06-24 17:19:15
ed032ddfd68a8654671a13d676c0f7539e36a10b...7eb425ccd167487b8424ff680e46216d99fa237a,1,147,8,155,5,2014-06-24 17:41:51,2014-06-24 17:41:51
f1ac8962f995d650ec10b04b055c8bbb0db4bec4...1c291ccbbe91b8d8ff3fefb439b20306fd0af2b7,3,72,47,119,4,2014-06-24 15:43:26,2014-06-05 10:32:19
f1ac8962f995d650ec10b04b055c8bbb0db4bec4...d420134fa2ea8ceedf2a9a64263d09b308263c2c,1,1,1,2,1,2014-06-24 15:23:13,2014-06-20 15:45:42
d420134fa2ea8ceedf2a9a64263d09b308263c2c...2470a5ed999d9dc8d4b9bd250727ac13964db5b3,3,11,6,17,8,2014-06-24 16:10:14,2014-06-23 19:36:08
2470a5ed999d9dc8d4b9bd250727ac13964db5b3...09ee269d998ad04733ef577739fa051df9d3f12e,3,24,6,30,11,2014-06-24 16:10:28,2014-06-20 15:53:18
09ee269d998ad04733ef577739fa051df9d3f12e...f9c078ef38106d00de7774374f3ac71bb0d562d3,1,1,1,2,1,2014-06-24 16:43:45,2014-06-24 16:43:45
f9c078ef38106d00de7774374f3ac71bb0d562d3...79f217e3501a43326bd532e8eb03182f7488f61c,1,2,1,3,1,2014-06-26 16:06:41,2014-06-26 16:06:41
79f217e3501a43326bd532e8eb03182f7488f61c...a2f3ce2294bbe998df24edd50f2b571d0b21bac8,1,1,0,1,1,2014-06-26 16:39:16,2014-06-26 16:39:16
f1ac8962f995d650ec10b04b055c8bbb0db4bec4...733711481ee665564f0f2a77d100353d5f9c82e2,1,18,1,19,3,2014-06-24 14:58:17,2014-06-21 09:50:52
f1ac8962f995d650ec10b04b055c8bbb0db4bec4...a51dc92379f6d647fa4c259c3d1d30d01852a580,1,4,4,8,4,2014-06-24 09:36:57,2014-06-24 09:24:45
f021cd64eda967f7e5a4b3a3f5c99fb7efe49c10...5d4986c755526ad5d249ba96eb6213ce089a9c25,1,8,2,10,1,2014-07-09 00:08:36,2014-07-04 02:47:28
5d4986c755526ad5d249ba96eb6213ce089a9c25...46747963b603a5573a0b26dcef407a96757926e7,1,15,0,15,2,2014-07-09 00:09:03,2014-07-04 05:12:21
46747963b603a5573a0b26dcef407a96757926e7...560eb07009d65fbcfb49b2fa8b04a2e3f4d647e8,1,1,1,2,1,2014-07-09 00:09:03,2014-07-08 23:35:08
e23e3a1600e1b9178771557a843ed6e0c979f78c...53b036032d783c0a05362ef5722e2c55af503bb1,4,30,3,33,9,2014-06-24 18:31:56,2014-06-24 18:31:56
53b036032d783c0a05362ef5722e2c55af503bb1...b18c72155530aef29028694d7a92d97440c04a78,1,28,9,37,4,2014-06-25 01:44:48,2014-06-25 01:44:48
e23e3a1600e1b9178771557a843ed6e0c979f78c...423a8f91d72f5def754ec3a8efe000aa70bc6f22,34,669,380,1049,106,2014-06-24 18:30:36,2014-06-24 18:30:36
423a8f91d72f5def754ec3a8efe000aa70bc6f22...cee6f4506c79c6fc21769d427ac4dd51c28450c3,5,45,45,90,38,2014-06-24 18:31:03,2014-06-23 23:43:43
cee6f4506c79c6fc21769d427ac4dd51c28450c3...1dc8e2ffab795f4999a122b4a576d54e03c7c61a,4,28,28,56,27,2014-06-24 18:31:03,2014-06-24 18:22:25
e23e3a1600e1b9178771557a843ed6e0c979f78c...01b424028ed0ab7d673c7ae2221457ae12304557,2,140,0,140,6,2014-06-24 17:48:16,2014-06-22 11:58:43
8e35bb256d07bfa7e6374759baf9c081fe6a46a8...2e78ab91ec0c99c52e4b61fe186f0ad8048de9e8,3,3,0,3,3,2014-04-16 03:55:48,2014-04-15 20:57:43
e828d911977474cf05d43a726c10d9b1e3f925fe...19e6614eeb31d6a986ef61486e15aeb09cc952b8,3,2,4,6,3,2014-04-22 01:17:13,2014-04-22 00:01:34
e828d911977474cf05d43a726c10d9b1e3f925fe...8bcbc9fe9937b20c9086e0d8c810a257face46a3,2,22,0,22,2,2014-04-22 00:51:41,2014-04-22 00:31:08
aac9542a68ee59c62c2cf15df69f77640113bb95...611acf7a7c1c3a6796e862fb94143890a9aa4573,5,127,20,147,9,2014-03-03 21:00:53,2014-02-24 21:10:06
10137a561c280cd9ba36ffb62bb7696989f4072c...3de1d25c11c592510cd1be3c8c2e7fa754305484,1,1,1,2,1,2014-03-02 20:32:48,2014-03-02 20:32:48
f83482c91885b8980031f44e30d73d6971042601...b187d7ae41a1f946d536b42108ec082541883d26,3,63,34,97,20,2014-03-02 16:43:18,2014-03-02 15:54:43
f83482c91885b8980031f44e30d73d6971042601...6d55a9d7ceec7f9c114839f9c380321a93291aa5,1,1,0,1,1,2014-03-02 14:50:16,2014-03-02 14:50:16
f83482c91885b8980031f44e30d73d6971042601...3ddfbf68802b7a62dcdefd46decb3f7f6faebabe,2,2,0,2,2,2014-03-02 01:43:53,2014-03-02 01:43:22
5f5880edb886c6a54867fbd699f3acb250880973...d3a6ee1e55a53ee54b91ffb6c53ba674768cf9de,1,1,1,2,1,2014-03-01 00:35:43,2014-03-01 00:35:43
5f5880edb886c6a54867fbd699f3acb250880973...3b969aad4af430372d5cac1e700f75dba8a38a13,3,110,19,129,17,2014-02-28 22:27:05,2014-01-30 19:00:18
ba2a042aea3d8bb03b3e09e7eb7c6357c754bea0...5fde31ba9cca63a6bdf0a11fffa64aa16229ef66,1,39,5,44,5,2014-02-28 22:44:01,2014-02-17 05:20:28
93f925c5336489e7c47f9471cfa89a8c6b7a850e...bb5ed452241c37ee9f2f3ebd02a2a5e1764334ad,1,5,0,5,1,2014-03-03 19:57:05,2014-03-03 19:57:05
50c752fcb06497e9e597049a1007c53d77032d17...ba025cb75cceaa8536d0d512889ea86f13349950,1,3,1,4,1,2014-02-21 23:32:50,2014-02-21 23:32:50
ba025cb75cceaa8536d0d512889ea86f13349950...a352ecb01a788eff3446fe12191ca0434fce1eed,2,9,2,11,3,2014-02-22 00:17:18,2014-02-22 00:17:18
a352ecb01a788eff3446fe12191ca0434fce1eed...c8fd81c27821576f339ccf4fd85c47375ba34042,2,10,8,18,6,2014-02-22 00:28:43,2014-02-22 00:28:43
c8fd81c27821576f339ccf4fd85c47375ba34042...332755b99d345a8ffbf4fb636ca8fed604a233c0,2,2,3,5,3,2014-02-22 00:40:32,2014-02-22 00:40:32
332755b99d345a8ffbf4fb636ca8fed604a233c0...2419e63d243255ef38f16799ffdc64084aa18fe4,7,422,4,426,8,2014-02-22 01:23:49,2014-02-22 01:11:57
2419e63d243255ef38f16799ffdc64084aa18fe4...9876e5b8901199bad2ab424593131d574b582bf9,1,16,14,30,13,2014-02-22 05:14:21,2014-02-22 05:14:21
9876e5b8901199bad2ab424593131d574b582bf9...5a4069f3aacd0dc30ee7c5dd97f0dc9a6e416f35,7,211,107,318,33,2014-02-22 06:26:07,2014-02-22 06:20:15
5a4069f3aacd0dc30ee7c5dd97f0dc9a6e416f35...dd59f7fb286f2abff6cee2699e62fff564425149,1,62,46,108,10,2014-02-22 06:37:09,2014-02-22 06:37:09
dd59f7fb286f2abff6cee2699e62fff564425149...2412656ef54cb4df36df2f8122e1fda24ec8e8a4,4,102,48,150,23,2014-02-22 06:58:30,2014-02-22 06:58:30
2412656ef54cb4df36df2f8122e1fda24ec8e8a4...ae423a036e6f884572491b1ff5ef8a626b1592aa,5,184,94,278,16,2014-02-22 08:29:21,2014-02-22 08:29:21
ae423a036e6f884572491b1ff5ef8a626b1592aa...fac41af25bd5f42269424a788783a4280dd7fc9c,4,110,236,346,39,2014-02-22 09:21:26,2014-02-22 09:21:26
fac41af25bd5f42269424a788783a4280dd7fc9c...172260a49be6c3516edc6869d58957e844f9c69b,1,6,1,7,2,2014-02-22 09:28:59,2014-02-22 09:28:59
172260a49be6c3516edc6869d58957e844f9c69b...a08e78a78c4b548919515fa7910db56990ef44dc,1,1,1,2,1,2014-02-24 18:46:20,2014-02-24 18:46:20
20ddd34d0533ca05e3d09c5d4a8414033d69cfba...7e52445f2f749ac66ee7734820d3558012833912,2,47,9,56,6,2014-03-04 16:55:12,2014-03-04 16:55:12
1695c77c436e65a9f553b365714b56f78891bef5...82f797f14096430c3edbace1cd30e04a483ec41f,1,4,18,22,4,2014-03-07 00:32:06,2014-03-07 00:32:06
82f797f14096430c3edbace1cd30e04a483ec41f...bd263f5b15b51747e3429179fef7fcb425ccbe4a,1,1,1,2,1,2014-03-07 00:41:03,2014-03-07 00:41:03
1695c77c436e65a9f553b365714b56f78891bef5...ea9bce8724303656c87c05e9049272258c9827b3,1,3,5,8,1,2014-03-07 00:30:56,2014-03-07 00:30:56
d373cb8c89f40a6d293cbb01b094c4e947057343...d29ee876ac7900730e1f48f4f30ed33210872238,1,1,1,2,1,2014-02-26 06:35:59,2014-02-26 06:35:59
d373cb8c89f40a6d293cbb01b094c4e947057343...3806ff61d1580ca22b3b72257789285aa9bd9486,1,13,11,24,3,2014-02-26 00:50:33,2014-02-26 00:50:33
d373cb8c89f40a6d293cbb01b094c4e947057343...2f468a498ab9e8ebc5c7a9316e0242f8d7c54f1a,2,2,2,4,3,2014-02-25 23:19:44,2014-02-25 23:13:43
3839e3a0f63c8acc4cb11a87b862f159e5b2aedc...cdec3297f7f06fb383c1be1aaec67417a2d4c7f9,2,7,3,10,2,2014-02-27 22:14:22,2014-02-27 22:07:46
211fc574a1f4fd3fefa0f814fc6cb5ede449c771...3e4d0857bf560296801e68b1b218654954c952e9,1,0,1,1,1,2014-03-10 19:55:26,2014-03-10 19:48:07
52c258c5cf6bf21074d1f27f6be583ae028cbf0a...d648708d02134c3dc6788ad21325224d849b3b8f,3,2,28,30,4,2014-03-10 21:06:27,2014-03-10 21:06:27
d648708d02134c3dc6788ad21325224d849b3b8f...fde5f573d39020476c08ed25fac0a6306f7b18cc,4,2,2,4,4,2014-03-10 21:10:23,2014-03-10 21:10:23
63dee4ebc4a5b5be6302f170cb7cb034914dfcf0...6a325f1c7a243689ecf01f257ac7afb95fea7ec2,1,6,0,6,2,2014-03-12 18:13:24,2014-03-12 18:13:24
9d4771760af5326a2fff2e0bc091743331753253...9651ff46bfc19b815e3f78bc5d6895a352db2d37,1,2,2,4,2,2014-04-29 19:18:26,2014-04-29 19:06:48
9d4771760af5326a2fff2e0bc091743331753253...f0e6e135a8d733af173bf0b8732c704c9ec716d7,21,148,131,279,130,2014-04-29 10:40:05,2014-04-17 23:47:27
f0e6e135a8d733af173bf0b8732c704c9ec716d7...b7942ec2ca7c7568df0c3b7eb554b05e2c3a3081,8,50,14,64,22,2014-04-29 10:40:05,2014-04-21 21:09:26
b7942ec2ca7c7568df0c3b7eb554b05e2c3a3081...12934ef3a40d814cb307dfea0cc86124ec997593,1,3,3,6,3,2014-04-29 10:40:05,2014-04-25 18:34:42
12934ef3a40d814cb307dfea0cc86124ec997593...ae006493054e524ed35c08863f1713986fe0a22c,1,4,3,7,3,2014-04-29 10:40:05,2014-04-28 21:17:31
ae006493054e524ed35c08863f1713986fe0a22c...46e05ed2d96efca9bdb466d20138fde1994769ba,4,37,35,72,17,2014-04-29 10:40:05,2014-04-28 21:36:04
46e05ed2d96efca9bdb466d20138fde1994769ba...64d0f7e39b395a3fc52f441a53f188a19bd53cf3,1,1,0,1,1,2014-04-29 10:40:06,2014-04-29 07:47:09
64d0f7e39b395a3fc52f441a53f188a19bd53cf3...1a5ffef6c6ea8c5cc31c298bbdf6f7a29c60fbb8,2,20,6,26,6,2014-04-29 10:40:06,2014-04-29 08:08:19
1a5ffef6c6ea8c5cc31c298bbdf6f7a29c60fbb8...0c7143b32386c62cccd529de69abf88df938757d,1,7,5,12,4,2014-04-29 10:41:44,2014-04-29 10:41:44
c705e4a80bd93fac7af38f5384ca61cb884bd22f...6db32fdefdae49843ed9535b3af1099e6bd2755d,22,1117,2,1119,24,2014-03-29 21:09:40,2014-02-25 16:17:48
6db32fdefdae49843ed9535b3af1099e6bd2755d...3fb1fc0b7b225295b3059cb9a2f5fd9af7a73f36,2,8,16,24,8,2014-03-29 21:09:45,2014-03-20 22:46:55
c705e4a80bd93fac7af38f5384ca61cb884bd22f...04f5c75239cba156db70523bcd90657e5c7b5ddb,1,1,1,2,1,2014-03-29 00:48:47,2014-03-29 00:48:47
2ad16c88e24ba87fea9f31209e663bfb9ada51a0...a56d1b93a1a16ac482b5e30773664f2538949c53,2,45,2,47,3,2014-03-12 17:36:19,2014-03-12 15:58:53
2ad16c88e24ba87fea9f31209e663bfb9ada51a0...2a5e1abaa93b0081446420cae9d6d7d3892b6d75,1,1,1,2,1,2014-03-12 14:42:10,2014-03-12 14:42:10
af5892384744b4d372e2865d7cd89e3981c15c1a...03f0ec35ae31420dd6a56883535056087b1a75dd,1,1,1,2,1,2014-03-13 22:26:42,2014-03-13 22:26:42
af5892384744b4d372e2865d7cd89e3981c15c1a...747275d30c4d4eb25ca798394cc04db00912adb2,1,6,6,12,2,2014-03-13 21:31:09,2014-03-13 21:31:09
51a46e6a4ff74d74307341593208285d61592608...636959e20ae368e470a5c2420aae4528245b2cf6,3,34,30,64,11,2014-03-13 19:01:29,2014-03-03 18:19:00
636959e20ae368e470a5c2420aae4528245b2cf6...6c266c4b42eeabe2d433a994753d86637fe52a0b,11,77,63,140,27,2014-03-13 19:01:29,2014-03-03 15:15:29
6c266c4b42eeabe2d433a994753d86637fe52a0b...bf1b27dfcc6c4e049706d7d104e1abc5c330815d,5,5,43,48,12,2014-03-13 19:08:29,2014-03-04 09:16:09
51a46e6a4ff74d74307341593208285d61592608...029aac96396f5a9d76adf5e4675d27321273dfbd,2,25,16,41,3,2014-03-13 18:11:02,2014-03-13 18:11:02
51a46e6a4ff74d74307341593208285d61592608...44fe8cbbd174b5d85d4a063ed270f6b9d2279b70,51,189,189,378,167,2014-03-13 17:46:02,2014-03-13 17:46:02
51a46e6a4ff74d74307341593208285d61592608...9a0d7fe0182da541cc99eab9a4930616792e95c3,3,11,4,15,4,2014-03-13 17:40:34,2014-03-13 17:40:34
59035d291f78c6b9a4af83a27bd45ac8983bf58e...1dfc44073399aadb226c1b4c1909fb15c033d44a,1,1,1,2,1,2014-03-17 19:33:40,2014-03-17 19:33:40
68dc1896804de92b8c39cfc6bd4f7c96d4abe09e...e27c635c06dcad61ce7185d95debef9ef7c9f7e0,1,2,0,2,1,2014-03-18 20:27:20,2014-03-18 20:26:21
68dc1896804de92b8c39cfc6bd4f7c96d4abe09e...670ce98c60dbac1d46a59bd69bd20b569f4794f1,6,67,8,75,8,2014-03-18 01:54:05,2014-03-14 18:23:54
670ce98c60dbac1d46a59bd69bd20b569f4794f1...448b64164df7795cdbd9be0d663269e6e4e4beeb,3,1,12,13,3,2014-03-18 01:54:43,2014-03-14 20:10:07
68dc1896804de92b8c39cfc6bd4f7c96d4abe09e...15a267b57d2394dd5cb697f9a80b6df4fc939a76,1,1,1,2,1,2014-03-18 01:34:43,2014-03-18 01:34:43
b609e28e5c7168475c09749e308c6025a715120f...0d871840b202fc31418990bbcbe0df1c4ad689fb,2,5,3,8,4,2014-02-12 02:10:23,2014-02-12 02:10:23
ab4901552350db7c6ad9329b0f7b6aaa0ab87894...b762d3a7391dd526826a0a1f1c983ea5e54852f5,31,2401,9,2410,29,2014-02-17 15:20:21,2014-02-13 22:11:39
382659e03a59d68007fee1b54192233f7484c035...b7db2d5f8022e24faff80d312977c49a4c0408f3,33,460,647,1107,71,2014-02-17 18:52:39,2014-02-15 04:50:16
59e88b09676691234bc9323a8aae1bf5c4ec4482...5006509131986093a9529a748e80e023e19548f3,1,1,1,2,1,2014-02-17 18:24:50,2014-02-17 18:23:07
59e88b09676691234bc9323a8aae1bf5c4ec4482...c9ae66ffe375156ddf39cb41664224d6e1a6f096,2,3,2,5,2,2014-02-17 18:08:23,2014-01-06 18:06:05
581ee7e584ae9946796f6c4e918873e8e94ce83a...6889cd9f9cfa3a6439b7702d73f27ab3fac3d3ef,2,42,2,44,6,2014-02-17 19:46:32,2014-02-17 12:41:52
79089720c4d4f5f2a0e1afd567babd2d3c55941f...386e7c80c0dad778f873bcd6eadfa94ecb1ac840,1,1,1,2,1,2014-02-25 22:49:19,2014-02-25 22:49:19
79089720c4d4f5f2a0e1afd567babd2d3c55941f...795ed6b1e511fa6713fbc9ea4e8569aab15b98ff,6,58,110,168,26,2014-02-25 21:08:07,2014-02-11 02:44:17
795ed6b1e511fa6713fbc9ea4e8569aab15b98ff...e7cc88c39f302c020f70a00bca54bddeecb608a4,7,1405,75,1480,67,2014-02-25 21:08:07,2014-02-14 22:53:53
e7cc88c39f302c020f70a00bca54bddeecb608a4...c7f825c0f08e8b6e3cd9dcebc81c21002afcf133,3,11,8,19,6,2014-02-25 21:08:08,2014-02-15 00:10:57
c7f825c0f08e8b6e3cd9dcebc81c21002afcf133...964d82d00506c3005d102b9a1f94848182c5989d,3,4,3,7,4,2014-02-25 21:08:08,2014-02-18 01:44:53
964d82d00506c3005d102b9a1f94848182c5989d...626cee87f779dff2840b1a31cbe6912545758a9f,1,11,5,16,3,2014-02-25 21:08:08,2014-02-18 03:03:19
626cee87f779dff2840b1a31cbe6912545758a9f...21f56c04e4f4df4e171985896b54b243c6ef0fcb,2,5,5,10,3,2014-02-25 21:08:08,2014-02-19 01:21:32
21f56c04e4f4df4e171985896b54b243c6ef0fcb...3f6324f0e8e1b4d117a5d22f752e1d5980eea939,1,4,0,4,1,2014-02-25 21:08:08,2014-02-19 01:34:37
3f6324f0e8e1b4d117a5d22f752e1d5980eea939...10faefac3b88069f22283f3f2e018d100a66f2b9,1,2,0,2,1,2014-02-25 21:08:08,2014-02-20 00:13:37
10faefac3b88069f22283f3f2e018d100a66f2b9...8dad771daa6572ca15949d3e53e825f4837c0af9,6,140,105,245,64,2014-02-25 21:08:38,2014-02-21 23:15:28
a64ebabdfaca66709d664cb87a35d689e35cfd0d...de083400b8d7c2074d71a30a92e4f3c8bcd8bad8,5,26,17,43,11,2014-02-25 18:54:41,2014-02-25 18:54:41
a64ebabdfaca66709d664cb87a35d689e35cfd0d...91bf120c51dec3bae98a1974929e2ae8107340c0,5,141,108,249,16,2014-02-25 05:52:29,2014-02-25 05:52:29
3fda1819ee26857e4b30d0d033fd546eab77d6b6...ea63ade772445591e78b42a36fa0dcfffa4a9f1a,1,2,2,4,1,2014-02-04 17:32:50,2014-02-04 13:08:31
3fda1819ee26857e4b30d0d033fd546eab77d6b6...297001f51560b1172b529a79480b02534fc53ba0,1,10,2,12,5,2014-02-04 10:26:14,2014-01-10 20:21:57
ffdc2d265713fc64516cffbcf6f2f80609d1cbdf...9ad70528b723810d98e77368458408e85eebdfee,3,21,12,33,5,2014-01-28 18:20:35,2014-01-28 10:16:02
ffdc2d265713fc64516cffbcf6f2f80609d1cbdf...335bc39c9a5abfdbd07914ae1b8667a9d8590a6e,5,51,49,100,11,2014-01-28 15:21:49,2014-01-28 15:17:51
ffdc2d265713fc64516cffbcf6f2f80609d1cbdf...6f3d8d39085e7dc31f757c0221eca7ab5f220224,1,7,10,17,4,2014-01-27 21:34:11,2014-01-27 18:07:30
6f3d8d39085e7dc31f757c0221eca7ab5f220224...c4c558d138c43c6e2a48fd3060c4b8c81ace989b,1,1,0,1,1,2014-01-27 22:21:58,2014-01-27 21:47:49
ffdc2d265713fc64516cffbcf6f2f80609d1cbdf...32753c3d241c9238b2a34f61fd44399453d7b455,1,3,3,6,1,2014-01-27 17:31:25,2014-01-27 17:19:38
ffdc2d265713fc64516cffbcf6f2f80609d1cbdf...77a34920b24901da82f9e22138ef21ffc665d678,1,2,0,2,1,2014-01-27 15:22:59,2014-01-27 15:22:59
ffdc2d265713fc64516cffbcf6f2f80609d1cbdf...03d9984f177ec1d093011bcf3693338dabecc19e,1,9,8,17,4,2014-01-27 12:13:17,2014-01-27 12:13:17
03d9984f177ec1d093011bcf3693338dabecc19e...551e1a766c8aaec190972e3542fd8a1c7452b6b2,1,5,5,10,4,2014-01-27 15:21:48,2014-01-27 15:21:48
ffdc2d265713fc64516cffbcf6f2f80609d1cbdf...1ee1dc2340ef030fc3ed132ff51d196536b46600,1,114,0,114,1,2014-01-26 23:14:50,2014-01-26 23:10:34
ffdc2d265713fc64516cffbcf6f2f80609d1cbdf...2ba2a8ae40b83ac1cc0c4a60724073fa8255b257,1,1,1,2,1,2014-01-26 19:53:22,2014-01-26 19:35:45
4e9164ff5f84fd9228faca5e6bbe4729b6946b14...d277a4c0f811e86179770f5098b30adf065567c8,1,1,1,2,1,2014-02-04 00:14:02,2014-02-03 23:36:06
d277a4c0f811e86179770f5098b30adf065567c8...02fdc194fc726ef2ce1fa4303e121abd277f8d32,1,7,3,10,2,2014-02-04 00:14:16,2014-02-03 23:56:58
4e9164ff5f84fd9228faca5e6bbe4729b6946b14...d8718e435dfab7052bfd04a1494b1ad34c33cc17,1,16,4,20,5,2014-02-04 00:07:52,2013-12-12 02:16:33
81b2940c896269fe1da9079852a5ff13ff8bbb96...bac7e741bfd1d77ebb742bc1ed3fec6c6f300be3,1,8,0,8,1,2014-02-04 20:34:24,2014-02-04 20:32:53
81b2940c896269fe1da9079852a5ff13ff8bbb96...a9b325e5b00095a44617aa4b146e51f048e213ba,1,115,54,169,36,2014-02-04 20:26:06,2014-02-04 20:23:09
58ec7855bc4f724a32f585f4455b5d954f335c3c...2a1181f404387f6d530a86a6196b40a6dd541c20,1,1,1,2,1,2014-01-05 04:15:15,2014-01-05 04:15:15
58ec7855bc4f724a32f585f4455b5d954f335c3c...42c7dc448f550c954aeba14cd20d1dff12845c73,1,2,7,9,3,2014-01-03 14:49:39,2014-01-03 14:47:22
58ec7855bc4f724a32f585f4455b5d954f335c3c...8502ad4ba7b5410eb55f3517a801b33f61b1f625,2,71,14,85,15,2014-01-03 04:19:19,2014-01-03 02:21:24
fca83b4cfb41dbb5dcd933e4944453bac8cea0d3...10b794b3328a8b8d8bcc094710cc3b59df500253,1,7,5,12,5,2014-01-08 08:14:31,2014-01-07 08:15:04
10b794b3328a8b8d8bcc094710cc3b59df500253...46c8b11f245204e9f6e1ae764b52911c327be1a9,1,5,2,7,3,2014-01-08 08:15:45,2014-01-01 16:38:25
fca83b4cfb41dbb5dcd933e4944453bac8cea0d3...2b93f1822322e957e7652db2645462ef2ec256bd,1,1,1,2,1,2014-01-07 14:20:38,2014-01-07 14:20:38
fca83b4cfb41dbb5dcd933e4944453bac8cea0d3...8f3b8f383519452001cc05bf6505e9c301ebe954,6,8,9,17,10,2014-01-07 05:14:35,2014-01-07 05:14:35
380129d0d7e9b2dbec27aef7186ce5eddd3a3076...fa7b24f2c3948d1eb52453c609417a6bc7eba5dd,2,20,1,21,2,2014-08-20 21:11:18,2014-08-20 20:20:14
31f0cc04ec0585f8fb996edadc8959eeb4e0397c...a1ddf57216e510c5cabe40cac6a00ac57a92b8d7,4,6,6,12,6,2014-07-09 21:13:26,2014-07-09 21:13:26
31f0cc04ec0585f8fb996edadc8959eeb4e0397c...457166295c57e982c470110cde653135385cbca5,1,1,1,2,1,2014-07-09 21:05:51,2014-07-09 21:05:51
323e6a3cf29677459a7bc658a0b5221e5675bc46...f1e072c8d5266b9c4b320458bffcd87254b36c55,1,12,12,24,4,2014-07-22 15:39:40,2014-07-07 14:28:03
323e6a3cf29677459a7bc658a0b5221e5675bc46...e895817ad72c681b265bc647d18f201ceced90c5,1,12,3,15,3,2014-07-07 14:36:31,2014-07-07 14:32:09
323e6a3cf29677459a7bc658a0b5221e5675bc46...3589f5b9c2d9e5cb6d057713aa8d591295c5f523,1,3,0,3,1,2014-07-07 14:09:25,2014-07-07 14:09:25
323e6a3cf29677459a7bc658a0b5221e5675bc46...963ee6ce795ae6608ee9acce4bc6298356d7f02f,1,1,1,2,1,2014-07-07 13:52:18,2014-07-07 13:52:18
323e6a3cf29677459a7bc658a0b5221e5675bc46...2f13d3a8e541b918135ea0bf0153f56927dd0511,1,6,0,6,1,2014-07-07 13:14:41,2014-07-07 13:14:41
bc33ce0d8f8b3c3b3e80fbd4084f8a8e74130c0c...f387cc1205b79ffbe30b28f5df13da034d8221fd,1,58,70,128,20,2014-07-01 17:59:11,2014-07-01 17:59:11
bc33ce0d8f8b3c3b3e80fbd4084f8a8e74130c0c...ae1ff4dea311f8c6ff025b4835dc5d751f1b6261,1,38,0,38,1,2014-07-01 14:47:59,2014-07-01 14:47:59
bc33ce0d8f8b3c3b3e80fbd4084f8a8e74130c0c...b611198d286d2f4ebd7526c623dff8e523691698,3,5,3,8,6,2014-06-03 10:13:54,2014-06-03 07:46:01
b611198d286d2f4ebd7526c623dff8e523691698...b3b6e05f261cadc2ac4a6eb12090920c32043915,1,2,2,4,2,2014-07-15 11:56:19,2014-07-15 11:52:50
dbee7dd69eeee8d740de4ded34c3cf4c422329ca...fbf7815b2591adce4d9584feb75592c6facb92e1,1,4,7,11,2,2014-06-12 16:26:55,2014-06-12 16:26:55
dbee7dd69eeee8d740de4ded34c3cf4c422329ca...784a008346e9d0e3829bd08b6fc07cdcfc09bd82,1,0,4,4,1,2014-06-12 13:21:20,2014-06-12 13:21:20
dbee7dd69eeee8d740de4ded34c3cf4c422329ca...0bdadfe4e7547f58c7c32582c61912dfe1fc7302,1,1,0,1,1,2014-06-12 09:15:14,2014-06-12 09:15:14
874698cb4aaf10d7c1efe91bc15982e4d8c30c20...bf69b773ec4c817dcc276e4471fc85f762f18f9f,1,29,32,61,9,2014-06-19 21:13:20,2014-06-19 17:07:39
874698cb4aaf10d7c1efe91bc15982e4d8c30c20...b4857dffa8ba0a7b2fe779a0b2264ce1b0b2e7ff,1,5,0,5,1,2014-06-19 19:24:22,2014-06-19 19:24:22
4cf40c968f072d51272217b30ef2b8f5cba55ffe...cac97b6bd86fb3b741ff3ce75cf422ef378854b9,1,1,1,2,1,2014-06-17 08:49:34,2014-06-17 08:49:34
4cf40c968f072d51272217b30ef2b8f5cba55ffe...0b3fe5544266b6f9657ecd87989b85b535cc63e1,1,2,0,2,2,2014-06-11 11:23:33,2014-06-05 06:49:40
0b3fe5544266b6f9657ecd87989b85b535cc63e1...fa7c8d523e8d899ade547fcaacc34a739ab5044f,1,6,1,7,3,2014-06-11 11:23:33,2014-06-05 07:17:09
fa7c8d523e8d899ade547fcaacc34a739ab5044f...a1b7a35c90f05b113b7c3aa474b74d1d2afbf7b6,1,2,0,2,2,2014-06-11 11:23:33,2014-06-05 09:35:24
4cf40c968f072d51272217b30ef2b8f5cba55ffe...db00e224c2ae76096490c29357ef041ded7fadfc,1,1,1,2,1,2014-06-11 11:16:53,2014-06-11 11:16:53
4cf40c968f072d51272217b30ef2b8f5cba55ffe...b1bae925341f45736fcafaeaf8c75274e9ad4305,1,5,4,9,2,2014-06-11 11:13:31,2014-06-09 12:28:32
4cf40c968f072d51272217b30ef2b8f5cba55ffe...a247af9c97be92f91242db51f4a9545db1bda702,1,4,2,6,1,2014-06-11 10:44:30,2014-06-11 10:44:30
b1c114c3a779ab1d2655169b83f5a165483602bc...d7e5fdfb58d5829344486b7a6171f7e866f0378b,1,1,1,2,1,2014-06-19 12:49:52,2014-06-19 07:11:26
b1c114c3a779ab1d2655169b83f5a165483602bc...40966fa0966b3acd1893852a5297526374b690f2,2,3,3,6,3,2014-06-19 11:00:45,2014-06-19 11:00:45
b1c114c3a779ab1d2655169b83f5a165483602bc...7303467c771cc98f0efcdf8cbb2e0538ad496b72,1,6,2,8,2,2014-06-19 10:33:17,2014-06-16 14:08:02
7303467c771cc98f0efcdf8cbb2e0538ad496b72...a57298791c882a2a065989b3386b5b14084e8639,1,63,0,63,2,2014-06-19 10:33:17,2014-06-17 06:04:25
b1c114c3a779ab1d2655169b83f5a165483602bc...7b1f34d6269b7076dda86e0288b906f553f19bd1,1,1,1,2,1,2014-06-19 09:45:31,2014-06-19 09:45:31
b1c114c3a779ab1d2655169b83f5a165483602bc...80bc06f1cf0833479d59078dc2a73c40711f3980,1,2,2,4,2,2014-06-19 09:25:14,2014-06-19 09:25:14
1151f9ef9ec801fa25d2dcd8393d3aeea571ecc7...5f9a673025bc5025fd4550a4c18591a66d2fd815,1,1,1,2,1,2014-06-08 18:15:31,2014-06-08 18:15:31
1151f9ef9ec801fa25d2dcd8393d3aeea571ecc7...4a3b36f44309ff8e650be2cff74f3ec436353298,1,3,3,6,3,2014-06-08 18:04:06,2014-06-08 18:01:07
da327c8fa361affa2c453bf1c103b8120f4ba059...e278082c213d887322270eefb96fda6d76a082c0,1,2,2,4,2,2014-06-17 07:40:59,2014-06-17 07:40:46
da327c8fa361affa2c453bf1c103b8120f4ba059...2ed8b220998c11a0580adb10dc8647864748522a,1,1,1,2,1,2014-06-17 07:24:56,2014-06-17 07:24:56
da327c8fa361affa2c453bf1c103b8120f4ba059...c5b82f5e8dd5c519330e02502e5b9f9031a6509a,2,37,31,68,2,2014-06-17 06:16:36,2014-06-17 06:08:14
c5b82f5e8dd5c519330e02502e5b9f9031a6509a...686786f107582c27c69a6f40655c8fc52a8e4d00,2,25,48,73,2,2014-06-17 06:38:45,2014-06-17 06:26:42
686786f107582c27c69a6f40655c8fc52a8e4d00...62d97afaf8d328b42c028323f10c3f4782f03561,2,20,46,66,2,2014-06-17 07:05:36,2014-06-17 06:35:29
62d97afaf8d328b42c028323f10c3f4782f03561...f1d7ed35bd17c5e8e8f4d1882b5e98ae5419e9f1,2,41,36,77,3,2014-06-17 07:05:45,2014-06-17 06:50:51
f1d7ed35bd17c5e8e8f4d1882b5e98ae5419e9f1...d3023f25f5c9e1173fe1cf1dbb449a926dc85cfd,2,17,20,37,2,2014-06-17 07:06:40,2014-06-17 06:57:32
d3023f25f5c9e1173fe1cf1dbb449a926dc85cfd...08a10f936b4b5a69d3be6d320499c025a399fddb,2,14,8,22,2,2014-06-17 07:06:44,2014-06-17 07:04:07
08a10f936b4b5a69d3be6d320499c025a399fddb...2629e2ec236a377973e7be296013e366b4074d44,2,20,16,36,2,2014-06-17 07:14:45,2014-06-17 07:14:45
2629e2ec236a377973e7be296013e366b4074d44...1e0e86360f8fefbeb3d70642aa0402bcb0c97a1a,2,17,14,31,2,2014-06-17 07:24:47,2014-06-17 07:24:47
1e0e86360f8fefbeb3d70642aa0402bcb0c97a1a...1c8ec01c551b3cfac8548d7fd22a50b3c236e362,2,17,14,31,2,2014-06-17 07:36:45,2014-06-17 07:36:45
1c8ec01c551b3cfac8548d7fd22a50b3c236e362...690711b5840be388fb13fb72856de337bdf645c7,2,17,14,31,2,2014-06-17 07:39:47,2014-06-17 07:39:47
690711b5840be388fb13fb72856de337bdf645c7...cc42eeac21caa962bed94878fe2eab00735cd00d,2,23,18,41,2,2014-06-17 19:44:30,2014-06-17 07:49:07
2d195fb6f87d68e716c7fa590796e83252418b15...431a6736d27fa6eced36793099f579d940fc1e94,4,0,816,816,4,2014-06-23 22:52:03,2014-06-23 22:52:03
8887e0063014228dbf3ff85083019adca4537ec0...239d1ef301eb8d9b2b1e8469489b25ff3708f47f,1,10,0,10,1,2014-05-15 09:32:01,2014-05-15 08:56:23
8887e0063014228dbf3ff85083019adca4537ec0...002aa8fc207d803349777cde61426603976ca8ee,1,13,0,13,2,2014-05-15 08:17:44,2014-05-14 09:48:10
002aa8fc207d803349777cde61426603976ca8ee...00e1adfeada87100e5e88707309bcdcd674082d6,1,41,0,41,3,2014-05-16 11:48:41,2014-05-14 09:49:06
00e1adfeada87100e5e88707309bcdcd674082d6...6a1d76bc7bc589b53530c03720022f0095b65d55,1,1,0,1,1,2014-05-16 11:48:41,2014-05-14 09:50:15
5ac3c6c4ed64ad4eddc10e3a73f7a52f1fc5d8dc...f664e9a7d9a584220c28486f8e40cb1a1023e7f6,1,4,1,5,1,2014-05-14 20:43:54,2014-05-13 04:49:23
da0686481c552bc45c44f8f980b629824243722e...0aeff69e5900a15e3872494ac0009600f6c1c372,5,43,12,55,10,2014-05-09 22:39:55,2014-05-09 22:39:55
0aeff69e5900a15e3872494ac0009600f6c1c372...dfdc03b061d5bd5a7557f077b500304d4da26d2e,2,74,1,75,2,2014-05-09 22:49:44,2014-05-04 00:21:53
dfdc03b061d5bd5a7557f077b500304d4da26d2e...bf25951837440286fb185f97f7c9cfda11962cab,1,42,22,64,5,2014-05-09 22:49:44,2014-05-04 03:01:46
4af465fccf35d0c9e529f02f6cc9c8be9fc81c68...8699f53e6a033a7b5b55a2b6356da7c6e220d01f,2,5,1,6,2,2014-05-14 20:35:04,2014-05-14 20:24:11
4af465fccf35d0c9e529f02f6cc9c8be9fc81c68...2d622df835f8c80b213a68bbceef21fb003a9a6a,1,1,1,2,1,2014-05-14 20:24:08,2014-05-14 20:24:08
4af465fccf35d0c9e529f02f6cc9c8be9fc81c68...137f4b326ad1669cd562fa59d809f39d21b653fe,1,1,1,2,1,2014-05-14 20:22:38,2014-05-14 20:22:38
4af465fccf35d0c9e529f02f6cc9c8be9fc81c68...a4a023580bc89fb34e5f80ca472fc70267546eaf,1,6,0,6,1,2014-05-11 08:03:31,2014-05-02 18:13:50
a0f799b6d407785cb926dde25fdf20e347d58c33...f3736265fdddef9e9a9ab588906eeb7abe8a0cf6,2,7,1,8,3,2014-05-13 01:51:41,2014-05-01 23:07:11
f3736265fdddef9e9a9ab588906eeb7abe8a0cf6...937f8f2d813f58480e4bb2c0060353be31b04e10,3,8,7,15,4,2014-05-13 01:53:38,2014-05-03 00:11:20
3f6ec6ebbad58745cf550b1a914e86b216b6afef...b9c2d57d890c0f6a798baf74f7b56793fdf1fd61,1,3,3,6,2,2014-05-13 00:36:19,2014-05-13 00:36:19
f637eaca5daad914dfb42dadd535502ad82eb264...ed703fc8be652eee65319a774ffbe95a07a03242,1,9,1,10,2,2014-05-14 23:41:05,2014-05-13 03:38:11
f637eaca5daad914dfb42dadd535502ad82eb264...219b7ae8b526bb5e6d0e27176308db71438a002f,1,22,3,25,3,2014-05-14 14:57:59,2014-05-14 14:55:06
219b7ae8b526bb5e6d0e27176308db71438a002f...5d5c89398c39e2f38459aae42189c9ca1125c1d3,1,19,5,24,7,2014-05-14 14:58:37,2014-05-14 14:58:37
f637eaca5daad914dfb42dadd535502ad82eb264...e963179c790ec49b28fae0d7ebc0d9d2b3ac0b72,2,4,0,4,2,2014-05-14 12:02:02,2014-05-14 11:17:58
f637eaca5daad914dfb42dadd535502ad82eb264...bfc3a4192ae5723e401470688cdae59b95bd61f1,2,6,0,6,4,2014-05-14 01:14:59,2014-05-10 06:38:47
bfc3a4192ae5723e401470688cdae59b95bd61f1...79ca77f3e80d983cf72aa131c1b59c77c60270b0,1,208,0,208,1,2014-05-14 01:14:59,2014-05-10 12:51:45
79ca77f3e80d983cf72aa131c1b59c77c60270b0...0fb507dc2328c5c364a2cd1701a155efb1767a1a,2,24,16,40,15,2014-05-14 01:15:50,2014-05-11 20:49:46
f637eaca5daad914dfb42dadd535502ad82eb264...3de15bda7e1d3ab193094e6e07a5b2e42ea828bd,2,89,9,98,8,2014-05-14 01:01:31,2014-05-13 20:34:31
f637eaca5daad914dfb42dadd535502ad82eb264...195f3a3f42ac8894ade9e3dbf8f02945781b6ace,1,50,50,100,15,2014-05-14 00:22:55,2014-05-14 00:22:55
f637eaca5daad914dfb42dadd535502ad82eb264...af891a67516149c4db490018430114c137cba9db,1,3,3,6,1,2014-05-13 21:43:41,2014-05-13 21:43:41
f637eaca5daad914dfb42dadd535502ad82eb264...461f801f832b1ecbe527999e05dc0bede6ca6c71,3,60,0,60,2,2014-05-13 18:57:31,2014-05-13 18:55:46
461f801f832b1ecbe527999e05dc0bede6ca6c71...efa369a6ee89722ace2e85aad91c69ddf37985c5,3,5,0,5,2,2014-05-13 19:08:48,2014-05-13 19:08:48
efa369a6ee89722ace2e85aad91c69ddf37985c5...cfd1227e91d54cca533a73cb7d12c124c7c934af,1,2,2,4,2,2014-05-13 19:14:32,2014-05-13 19:14:32
cfd1227e91d54cca533a73cb7d12c124c7c934af...d153740d9c7d672b9433f173b9a098a5d3c14c53,1,165,4,169,8,2014-05-14 15:48:17,2014-05-14 15:48:17
79dc316a86402882faffd88128ee56633e3eccc9...b5a37127aadbefea937346846116cb93966798dd,1,3,2,5,1,2014-05-09 14:37:55,2014-05-09 12:42:27
79dc316a86402882faffd88128ee56633e3eccc9...47c79870ea529099cca635f53da870e0cea5652a,1,46,6,52,10,2014-05-09 12:48:38,2014-04-30 09:16:06
47c79870ea529099cca635f53da870e0cea5652a...84f19a09ac1bb6221aeafd858306b097203aa974,1,1,1,2,1,2014-05-09 12:48:38,2014-04-30 09:59:26
84f19a09ac1bb6221aeafd858306b097203aa974...27744062aa96f5f16d615ed829bc0d06b7df381d,4,304,0,304,5,2014-05-09 12:48:39,2014-04-30 12:43:51
27744062aa96f5f16d615ed829bc0d06b7df381d...4bdb8c03fc9ac4c7c49fd9838d7eccdfd66e1c5b,4,18,10,28,10,2014-05-09 12:48:39,2014-03-27 16:41:06
4bdb8c03fc9ac4c7c49fd9838d7eccdfd66e1c5b...55cd7dd7f90d19332464ac946727297de1969483,1,4,1,5,2,2014-05-09 12:48:39,2014-05-06 12:44:42
d8332f433f667971e84d5ecfb30348797f50e83c...ff7b52abd3f26d9650c2e674400d58fbe8157ad8,2,42,16,58,4,2014-04-28 20:57:28,2014-04-10 01:50:46
d8332f433f667971e84d5ecfb30348797f50e83c...e9a42a45bfe296850a72ba6ee5e7c0c04534ea34,3,62,5,67,6,2014-04-28 20:18:12,2014-04-25 01:22:22
54e20b8f7b27fa28bf60f78900d812ce5f0bf8b9...dcae8c157b4e754917a1ea5901ba02dc226a6d4b,1,5,0,5,1,2014-05-04 12:25:03,2014-05-04 12:25:03
54e20b8f7b27fa28bf60f78900d812ce5f0bf8b9...8d7ed2cae49918c9f31e9fd068b28c8e114e939b,5,29,3,32,7,2014-05-04 02:34:21,2014-05-04 02:34:21
54e20b8f7b27fa28bf60f78900d812ce5f0bf8b9...bfac0b24ed66277c66807466e9d429624b1179e6,1,3,3,6,3,2014-05-04 01:16:21,2014-05-04 01:16:21
0c5375146a6881d3a093523c2422b29679387743...5f00372af2e0aa0ec540830ba575fe83ae16017f,1,4,0,4,1,2014-04-30 17:28:26,2014-04-30 17:23:51
0c5375146a6881d3a093523c2422b29679387743...defecac2799ca0c72532b7e6ed6005cc54ee2e25,7,6,7,13,7,2014-04-30 17:22:11,2014-04-30 17:22:11
0c5375146a6881d3a093523c2422b29679387743...4fac4d2149856f0740a98e87ef0e0e6bd04d1b53,1,4,0,4,1,2014-04-30 11:13:39,2014-04-30 11:13:39
3eea3e071478e51c984ca30a8235a331f9f6a91b...fcbc717f9aa11dae75d7418482f51cb61c0bf001,2,39,181,220,3,2014-04-18 17:40:12,2014-04-18 17:40:12
b84de10b85e5912a06cad66c4ba53b9c2bb0324b...76a19bb3a95ef788cd889b36b0af3b79327ff431,2,24,22,46,3,2014-04-18 01:58:20,2014-04-18 01:58:20
76a19bb3a95ef788cd889b36b0af3b79327ff431...72f49e554f4d4345238b983d0c820e1e3320f9e5,2,51,95,146,2,2014-04-18 02:14:00,2014-04-18 02:14:00
72f49e554f4d4345238b983d0c820e1e3320f9e5...6beb858fb0290137c787c9728d84436461c352a0,2,30,196,226,3,2014-04-18 02:24:19,2014-04-18 02:24:19
6beb858fb0290137c787c9728d84436461c352a0...03993eb5340f1d520e23eac3dfe01d604fe7297f,2,28,183,211,4,2014-04-18 02:34:10,2014-04-18 02:34:10
03993eb5340f1d520e23eac3dfe01d604fe7297f...e2ed4b9077a46adbe3e4388166bb41969f7fb425,2,79,184,263,3,2014-04-18 02:47:39,2014-04-18 02:46:03
e2ed4b9077a46adbe3e4388166bb41969f7fb425...47510bd6eb83c43450ba53cb3db13aa340e8226c,2,45,54,99,4,2014-04-18 02:53:08,2014-04-18 02:53:08
47510bd6eb83c43450ba53cb3db13aa340e8226c...caad45d0edd9c1e48eac6e0ae0889039ca6844fc,2,43,100,143,2,2014-04-18 03:12:27,2014-04-18 03:12:27
caad45d0edd9c1e48eac6e0ae0889039ca6844fc...296fcf331f2886d2aba3cfb929887dfbb603643d,2,62,75,137,6,2014-04-18 03:20:17,2014-04-18 03:20:17
296fcf331f2886d2aba3cfb929887dfbb603643d...58e011595e4c518a38ec27716585177faa969f72,1,0,22,22,1,2014-04-18 03:22:53,2014-04-18 03:22:53
87014c0328a95b9eade3a207cef77b71d8700565...97daf9864d835ae0883b3c03382ac5dca11b4cc9,1,13,13,26,4,2014-04-19 16:35:00,2014-04-19 01:26:14
87014c0328a95b9eade3a207cef77b71d8700565...42fb2973c690fe4e4f65da235ce4dfa4c388e8a3,3,75,70,145,5,2014-04-19 04:14:58,2014-04-19 04:14:58
42fb2973c690fe4e4f65da235ce4dfa4c388e8a3...ec43ec50b44cff3f043c78cad97466c68e2ba8cd,5,46,50,96,18,2014-04-19 04:30:08,2014-04-19 04:30:08
ec43ec50b44cff3f043c78cad97466c68e2ba8cd...06db0604e5e5438dc14e13a069ebddcab7bb4bc6,3,26,24,50,25,2014-04-19 04:34:26,2014-04-19 04:34:26
06db0604e5e5438dc14e13a069ebddcab7bb4bc6...e92f2fd3950644a6e5eb38259cee9036648090cb,9,247,172,419,18,2014-04-19 05:10:30,2014-04-19 04:55:06
e92f2fd3950644a6e5eb38259cee9036648090cb...7fdeda87173ee6722ef1cbe7b21a13ac8b173365,9,45,18,63,11,2014-04-19 05:17:31,2014-04-19 05:17:31
7fdeda87173ee6722ef1cbe7b21a13ac8b173365...86e34ce59fb7f6e6e284a33f2538bafdc9114c89,4,155,0,155,8,2014-04-20 18:34:28,2014-04-20 18:34:28
86e34ce59fb7f6e6e284a33f2538bafdc9114c89...9b65f1635515fa35ed38f8a76b6d8f73ab3a1d02,10,81,54,135,40,2014-04-20 19:02:39,2014-04-20 19:02:39
9b65f1635515fa35ed38f8a76b6d8f73ab3a1d02...7f12260fd13329f3bafe4b42ad4193ff963bb1e2,3,70,10,80,4,2014-04-21 00:36:20,2014-04-21 00:36:20
7f12260fd13329f3bafe4b42ad4193ff963bb1e2...37248039e186f57768bb5c4fad23b1bca65448f7,2,44,10,54,9,2014-04-21 01:18:17,2014-04-21 01:18:17
37248039e186f57768bb5c4fad23b1bca65448f7...3bfe13de2c38fda5b57e2499f474da701495c5ba,1,3,1,4,1,2014-04-21 01:20:44,2014-04-21 01:20:44
3bfe13de2c38fda5b57e2499f474da701495c5ba...bce49dff0d46dec620e755ed859efa791054a843,1,39,1,40,3,2014-04-21 01:35:33,2014-04-21 01:35:33
87014c0328a95b9eade3a207cef77b71d8700565...a96106b5f159791768174a6d74a1344b203de685,1,13,13,26,5,2014-04-19 01:13:52,2014-04-19 01:13:52
87014c0328a95b9eade3a207cef77b71d8700565...2d6324e06a1e2ea8bb2236472a99c3dc4b5f66d1,7,18,18,36,16,2014-04-19 00:35:45,2014-04-19 00:35:45
f6d11c8d50387472fd7e34eea66b79237238c321...dd258553b1cbe58d0cb4f8d505aea6f3b1ae6543,1,4,4,8,3,2014-06-24 21:16:34,2014-06-24 21:16:34
d3fde633bdc675a7a4cac8d0519e4cd96b69a03a...5f6a7253321ffafdf84f53ea0253dd703b105c6b,4,32,8,40,12,2014-06-25 23:23:33,2014-06-23 03:10:00
a613ac19074dcafa54d254c7ce70ec65de9702bc...2112c5e948d1ef3d3efb34875a97f01fde809143,1,11,11,22,7,2014-07-09 00:23:12,2014-07-09 00:23:12
917b7436aff96796de5b92653f62135017957790...5e256799ddd6a297e22756363fc5eb079af0f07e,1,12,1,13,3,2014-06-26 04:12:25,2014-06-26 04:12:25
917b7436aff96796de5b92653f62135017957790...c42b5575e5dff5b3a117462e32eda0095528e3b2,1,7,3,10,2,2014-06-26 01:07:39,2014-06-26 01:07:39
917b7436aff96796de5b92653f62135017957790...3fcb0d880aad65690cac304c30f72d0688a801d2,1,1,1,2,1,2014-06-26 01:06:45,2014-06-09 18:33:55
3fcb0d880aad65690cac304c30f72d0688a801d2...389916bf9ae62ded0e497512da22faba75d0cf2d,1,1,1,2,1,2014-06-26 01:06:45,2014-06-25 23:50:35
4f5e91e3b4fdbd29947ac9543f0352545b457e02...901a47daff63a4a7f22cbe556741081334c76572,2,82,2,84,4,2014-06-24 22:41:57,2014-06-24 22:17:52
4f5e91e3b4fdbd29947ac9543f0352545b457e02...7b1dd54d5d29b5d15e2081cc21b836a1907162cf,1,0,1,1,1,2014-06-24 22:16:40,2014-06-24 22:16:40
408963ed4d4ea5ffca99c08b3e22bf720eb19b88...05f293e65eeb7d1c86ba5644ed8d682aaeddd53d,1,4,0,4,1,2014-06-24 22:49:35,2014-06-24 18:57:35
1059e166fd4fbe88a05f182139b6fc5fc95ab6b3...1c8d3106df0bd2aba304c7b3863949ca11c2b133,2,71,4,75,7,2014-06-25 13:35:26,2014-06-25 01:58:03
231f53fd9b52229ba3aa1d27bdebf775ab7397b5...b87cb76976da57a6765acd9a85494c68a4e6b948,1,3,0,3,3,2014-04-20 17:32:00,2014-04-20 17:27:00
231f53fd9b52229ba3aa1d27bdebf775ab7397b5...b26821e5c01bc0176357c41cdb7ff9a7cf3fb9df,1,1,0,1,1,2014-04-20 12:56:22,2014-04-20 12:56:22
231f53fd9b52229ba3aa1d27bdebf775ab7397b5...611a1d711bc382fb0dafafbdea5a5091383de972,1,1,1,2,1,2014-04-20 06:25:48,2014-04-20 06:25:48
e630d9ea245be9c706d904edb56aebed1d5d0581...4353f25e10d19f414bdd5b20488824fb2b834d6e,1,7,0,7,1,2014-04-22 23:51:06,2014-04-22 23:51:06
fca4cf6f0aa50f8bac307fa72faca9f137cbb4b5...b39d02b611f1cc0af283f417b73bf0d36f26277a,1,0,1,1,1,2014-03-04 04:53:57,2014-03-04 04:53:57
fca4cf6f0aa50f8bac307fa72faca9f137cbb4b5...b9cb95c0a07e421c8cbf83fa79aaedead809c802,1,3,3,6,3,2014-03-03 23:32:25,2014-03-03 23:26:46
37893c3db08eb563af89939ca5f545ddd038f69f...2aeccdd3bb98760ab10e834c6c134bb76f664910,1,1,1,2,1,2014-03-04 05:15:52,2014-03-04 03:45:14
37893c3db08eb563af89939ca5f545ddd038f69f...e8af7fcf6da03da65a379c12c90e6626c31846ae,2,17,1,18,3,2014-03-03 14:10:52,2014-02-18 10:41:11
e8af7fcf6da03da65a379c12c90e6626c31846ae...9e28c3e3f86664ef8f219f11ef19c74a414346a9,2,22,15,37,7,2014-03-03 14:11:49,2014-02-18 10:58:38
37893c3db08eb563af89939ca5f545ddd038f69f...4a688d6864e0a42b5300754a077f7c0fd45a0929,1,1,1,2,1,2014-03-03 13:09:54,2014-03-03 13:09:54
e070db75fed525efdbfe0a056c9e38f3d46604cb...e23b4e5d15da3e04692ac44370b1945a875206f0,1,1,1,2,1,2014-03-03 22:07:42,2014-03-03 22:07:42
89dbdb1f7196f72bae3adcc4ebf6abcce178ddcc...8f20058307cb30c9697b8dbee1c7bf2b1e0ba766,4,35,6,41,8,2014-02-24 20:21:13,2014-02-24 20:21:13
8f20058307cb30c9697b8dbee1c7bf2b1e0ba766...01f9815b55742654b2f35d13c3aba6a9e48634c7,5,30,5,35,11,2014-02-24 21:40:17,2014-02-24 21:40:17
01f9815b55742654b2f35d13c3aba6a9e48634c7...1c79b747bb10a389249aba90ad217ca0128afb74,2,33,9,42,3,2014-02-24 21:52:56,2014-02-24 21:52:56
1c79b747bb10a389249aba90ad217ca0128afb74...cfd188e9251f5047e4fd677fe8f2921ae28b8bcc,3,24,5,29,5,2014-02-24 22:11:09,2014-02-24 22:11:09
cfd188e9251f5047e4fd677fe8f2921ae28b8bcc...a6e5e1851197ccc262c61190d5904dd410293466,1,2,2,4,2,2014-02-24 22:35:27,2014-02-24 22:35:27
a6e5e1851197ccc262c61190d5904dd410293466...a76407ac61dd57429a1350f840c323f45a97b27f,3,40,11,51,13,2014-02-24 23:47:23,2014-02-24 23:47:23
a76407ac61dd57429a1350f840c323f45a97b27f...9bf6cb2692a9b14cac559b4b9c9403e7f6f13ecd,2,3,4,7,4,2014-02-25 00:26:06,2014-02-25 00:26:06
9bf6cb2692a9b14cac559b4b9c9403e7f6f13ecd...9f03fd76b578f2d9d00b0a1bd76b776e20a7d681,1,18,1,19,1,2014-02-25 00:35:11,2014-02-25 00:35:11
9f03fd76b578f2d9d00b0a1bd76b776e20a7d681...77f68f74c7e6fc977fb2681c7ee60ac652be983e,4,5,5,10,6,2014-02-25 00:42:30,2014-02-25 00:42:30
77f68f74c7e6fc977fb2681c7ee60ac652be983e...e84e344b1f887f06852953bc75912fc24a64d08a,1,1,1,2,1,2014-02-25 01:02:46,2014-02-25 01:02:46
e84e344b1f887f06852953bc75912fc24a64d08a...9cb4573d33607bc32e7db19981b3e9d5eaf449a0,7,78,46,124,40,2014-02-25 02:38:36,2014-02-25 02:38:24
9cb4573d33607bc32e7db19981b3e9d5eaf449a0...ca537a63a8a21eb4d5d31144c934ca18846bb856,2,0,102,102,2,2014-02-25 02:52:48,2014-02-25 02:52:48
ce08083f9cd23e8f5e44228b0b73884bcf2f3562...70820b69ec2b82ab150af9b8829e37843f67f75a,8,55,55,110,22,2014-02-26 22:20:41,2014-02-26 22:19:39
70820b69ec2b82ab150af9b8829e37843f67f75a...7cd224594733e5fa0560cb912e3cf2dcef168370,1,45,6,51,6,2014-02-27 01:21:09,2014-02-27 01:21:09
7cd224594733e5fa0560cb912e3cf2dcef168370...fb08b8b221a9a722910d63db678ffb5a8f91b517,6,13,13,26,8,2014-02-27 03:21:46,2014-02-27 03:19:14
fb08b8b221a9a722910d63db678ffb5a8f91b517...a115ce797b80a14d268fcd96521cf05d1e1074c1,1,4,6,10,3,2014-02-27 16:28:55,2014-02-27 16:28:02
a115ce797b80a14d268fcd96521cf05d1e1074c1...fdeea90fc806d8d2cccdc76a6ecb214dd03093ec,2,21,8,29,4,2014-02-27 17:33:36,2014-02-27 17:28:26
fdeea90fc806d8d2cccdc76a6ecb214dd03093ec...44c3b7133218a66f44cb51b7563b7c0016583eda,1,3,1,4,2,2014-02-27 19:40:25,2014-02-27 19:40:25
44c3b7133218a66f44cb51b7563b7c0016583eda...2f35f8e2a88a378d7ff8eacf5346f9711a59489a,1,1,1,2,1,2014-03-03 19:31:37,2014-03-03 19:31:37
2f35f8e2a88a378d7ff8eacf5346f9711a59489a...5465fdf00f3ece165cbd3bb680dcc571e81510dd,2,21,13,34,4,2014-03-03 20:15:47,2014-03-03 20:15:47
17577a6dce6508f0c6908a678dee35eb17a5f7e3...291d5e642e83ca84bd4f9b470eac8f840fecf48c,2,4,0,4,2,2014-03-05 03:29:51,2014-03-04 17:54:53
b63709c1f1292c362dbc3d482520fb7e117605f9...0cdf10263844db0cb4d051ac9f79051104abe77f,1,1,1,2,1,2014-03-04 19:46:05,2014-03-04 19:46:05
78dc1ede5202c8867e011582af8752810f817e9f...29079f03cfb0653316b07c58d24f4d547b3de1cc,1,1,1,2,1,2014-03-07 10:19:18,2014-03-07 10:19:18
78dc1ede5202c8867e011582af8752810f817e9f...661cf32e4f996385ec7791e93ea8edea80fd2e37,1,15,0,15,1,2014-03-07 06:29:08,2014-03-07 06:26:18
78dc1ede5202c8867e011582af8752810f817e9f...0a819380c52cbfcc9d674475913267a33b249e00,1,13,9,22,4,2014-03-07 06:16:26,2014-03-07 06:16:26
78dc1ede5202c8867e011582af8752810f817e9f...aceb10b1e51d1d9016b25fa5275e5a4f02772c57,1,38,25,63,2,2014-03-07 05:32:58,2014-03-07 05:26:47
78dc1ede5202c8867e011582af8752810f817e9f...be344cf0d8e4f9881724f49398603a6e3109bc89,8,44,11,55,12,2014-03-07 02:55:22,2014-03-07 02:55:22
be344cf0d8e4f9881724f49398603a6e3109bc89...a40bb2aabc1c0aba8b4de82dc353fae322b8831d,2,35,24,59,4,2014-03-07 04:22:25,2014-03-07 04:22:25
78dc1ede5202c8867e011582af8752810f817e9f...3729ece2ea1c4aad286b7535a7c137045a9da107,1,17,2,19,3,2014-03-07 02:20:59,2014-03-07 02:20:59
3729ece2ea1c4aad286b7535a7c137045a9da107...7da37fec13a0097284ffbbe05514de477cd98677,1,1,1,2,1,2014-03-07 23:40:45,2014-03-07 23:39:03
78dc1ede5202c8867e011582af8752810f817e9f...557e4fef4418a251dd3a6817b97e5c1be055cbf3,1,1,1,2,1,2014-03-07 01:19:47,2014-03-07 01:19:47
557e4fef4418a251dd3a6817b97e5c1be055cbf3...c38635020accaffa6868f19f308042be051132a0,1,18,4,22,4,2014-03-07 01:19:59,2014-03-07 01:19:59
c38635020accaffa6868f19f308042be051132a0...36dd124b16a76704a88142fa96bb4bb6260dd821,4,53,20,73,11,2014-03-07 03:30:52,2014-03-07 03:30:52
b5ba89596e6f731cf3f561a07276920401d43edf...62b88cd61943bdc025a989bc3e113434d9c44880,1,1,1,2,1,2014-03-02 12:50:34,2014-03-02 12:50:34
f2b01f5fa1fbb54d2dd78e323b936834635a06c0...a8cc6ebb181abf58b12ed6ee037711f0b2f1eff2,3,10,9,19,4,2014-03-19 23:59:54,2014-03-19 23:59:54
2b1244fc0d6d078fe2deae1271909530d8f20548...0ebf5d0ab3a3999a7e2efe619ef194ff3817e3a3,2,154,160,314,3,2014-03-10 20:24:15,2014-03-10 20:24:15
192917a1cbfd325cd4d141d76703a3ccfd6e60e7...6411ee6d24d256e15909ea68b845b354dc51c4ed,1,4,3,7,4,2014-03-13 23:28:16,2014-03-13 23:19:28
1bc0f82406692655cfeb6467ebf24328e2d17603...83a5f2a192f4c8bb87e9cbd80df42a0496615a1a,1,1,1,2,1,2014-04-29 20:49:36,2014-04-29 20:49:36
2a711d16e05b69328f2636f88f8eac035477f7e4...5f6fda8cfd05dec002894d3e2214a04a58b62bed,2,15,4,19,4,2014-04-30 23:07:12,2014-04-30 23:07:12
2a711d16e05b69328f2636f88f8eac035477f7e4...162dafbcd5c4d57c7f436e11d90423ee6d7c3ce1,6,20,79,99,40,2014-04-30 22:24:18,2014-04-30 22:24:18
162dafbcd5c4d57c7f436e11d90423ee6d7c3ce1...cd8cec854be33a74179618864cd528acf5129cd9,1,5,4,9,3,2014-04-30 22:27:59,2014-04-30 22:27:59
cd8cec854be33a74179618864cd528acf5129cd9...f1104014372e71e1f8ae7a63d17e18de5e2fa93a,6,56,82,138,24,2014-04-30 22:52:40,2014-04-30 22:52:40
7727c817fb5288f0b9d45ca0a4a37afa2e5329e2...2543912e7b5593722a6a22b9ceb6a23f6268e397,1,1,0,1,1,2014-03-31 17:55:55,2014-03-31 17:55:55
7727c817fb5288f0b9d45ca0a4a37afa2e5329e2...e4aaacc2351d2e1dd4b69afeeee2aeab9c625efe,1,3,2,5,2,2014-03-31 17:54:06,2014-03-31 17:49:48
e4aaacc2351d2e1dd4b69afeeee2aeab9c625efe...5fb28eab3e670f225019174987424be31a0d0527,1,76,0,76,1,2014-03-31 20:12:22,2014-03-31 18:40:39
7727c817fb5288f0b9d45ca0a4a37afa2e5329e2...7808886744595af509b7b144890900674ea5ccfd,1,28,1,29,15,2014-03-31 17:44:57,2014-03-31 11:14:56
7727c817fb5288f0b9d45ca0a4a37afa2e5329e2...a57900e35f2c30026a070fdfdbdb0ce99b35e1ff,1,29,19,48,3,2014-03-31 17:27:38,2014-03-18 22:28:40
a57900e35f2c30026a070fdfdbdb0ce99b35e1ff...28015f8e579e7bbe396f65b3343188ca03b06cbd,1,18,0,18,1,2014-03-31 17:42:34,2014-03-31 17:41:40
45b43d85ecbffb7aa626c47ef086f09463d8f8f6...097aef2ca938012a5b42e0032b30267e27a92265,1,9,5,14,2,2014-03-27 04:24:31,2014-03-27 04:24:31
5c6d54073f045d70c961245aee26455deac86177...39037a91f85a4a072e5aa7e585d8c2f6b211df8a,2,5,3,8,2,2014-03-14 22:42:05,2014-03-14 18:42:01
5c6d54073f045d70c961245aee26455deac86177...123ebf905367f1da0d9480153d08912d58b721fc,1,21,9,30,3,2014-03-14 18:16:14,2014-03-14 18:16:14
5c6d54073f045d70c961245aee26455deac86177...a41f6d936754f66d1786fa5b840278443da8d93c,2,14,1,15,3,2014-03-14 17:35:41,2014-03-14 17:35:41
5c6d54073f045d70c961245aee26455deac86177...7294392c729de4c5884eb967f192b34a1d8857a7,7,74,21,95,38,2014-03-14 16:55:05,2014-03-13 17:35:16
7294392c729de4c5884eb967f192b34a1d8857a7...0e863a584a6edfa1c3ec383c586b646663b66bc7,4,19,8,27,9,2014-03-14 16:55:05,2014-03-13 17:43:15
5c6d54073f045d70c961245aee26455deac86177...5239aa1f11c32f3befc25fb2fa8a0ecf75ec4bf6,5,36,35,71,11,2014-03-14 16:37:08,2014-03-11 17:40:06
5239aa1f11c32f3befc25fb2fa8a0ecf75ec4bf6...8cf0b80a7843633018b66a35d9a55f30814a56b6,3,12,12,24,14,2014-03-14 16:46:56,2014-03-11 17:44:23
28994f86eef11074f613433893ef345321afef91...cbd2a30cd6185d1469f82f8b6693d6158c93d54a,2,72,55,127,5,2014-03-13 22:18:08,2014-03-13 22:18:08
28994f86eef11074f613433893ef345321afef91...3fa99b35b05d9159d6f7f4c7465dec747da2c4e1,1,4,10,14,4,2014-03-13 22:04:23,2014-03-13 01:04:14
dd040c98706cd8ee3022061a63dc064b31fff890...53c5b1856d91093fed1c2d3f038d227f5fdef4b8,1,47,22,69,2,2014-03-17 21:01:24,2014-03-15 22:04:36
53c5b1856d91093fed1c2d3f038d227f5fdef4b8...353df19ab7009f6555dee506841ae0b690a08768,5,56,18,74,7,2014-03-17 21:01:24,2014-03-16 00:01:31
353df19ab7009f6555dee506841ae0b690a08768...659b719aa66e7ed0c3104d3704fa61035050ad82,6,35,21,56,19,2014-03-17 21:53:48,2014-03-16 19:52:27
119839dfd7b8b77eb22ccd45116f45a4bc17a1a6...4fd82db4beba03a126dfc557c86d5d52e9066dae,5,6,6,12,6,2014-03-19 09:20:10,2014-03-18 23:00:48
119839dfd7b8b77eb22ccd45116f45a4bc17a1a6...3b1d590269466217ddf203edcef295f6cec9fcee,1,2,5,7,1,2014-03-18 23:48:14,2014-03-18 23:12:39
3782900405c20e812d80f339c63844c0228cb74a...ae1dd52b19d075c2f4ba75cf0549c644725834e8,1,1,1,2,1,2014-03-18 16:10:22,2014-03-18 16:10:22
3782900405c20e812d80f339c63844c0228cb74a...a70beda1ecfb049a3f80ad5b159ba51d653fd067,1,5,3,8,3,2014-03-18 14:54:40,2014-03-18 14:52:00
3782900405c20e812d80f339c63844c0228cb74a...e5cbb5c906d37b14dbf0180d253f58f8995de571,1,9,1,10,2,2014-03-18 12:29:11,2014-03-18 12:29:11
f14c0866ecb5ee38be8d6859ced730d431610743...85a62d9b779bfb351e159f38c2fc95900a0532cd,2,7,1,8,2,2014-03-18 17:44:22,2014-03-13 19:10:35
85a62d9b779bfb351e159f38c2fc95900a0532cd...5cfea26bcfc218ca72eac7115fa257833f28b9f2,1,1,1,2,1,2014-03-18 17:44:23,2014-03-13 21:38:54
5cfea26bcfc218ca72eac7115fa257833f28b9f2...29c45e7f4fc616290e416f1b541e1739820af60c,1,10,2,12,3,2014-03-18 17:45:36,2014-03-13 21:39:25
29c45e7f4fc616290e416f1b541e1739820af60c...c76def2dd23cf90fdc80224f08530205b6dcba73,1,1,1,2,1,2014-03-18 17:46:38,2014-03-14 04:19:05
f14c0866ecb5ee38be8d6859ced730d431610743...f7b6fbbd7664634481c8519e58844d572423f3e1,2,32,7,39,8,2014-03-18 17:30:21,2014-03-12 21:22:57
f7b6fbbd7664634481c8519e58844d572423f3e1...7a1db291fcedd50ce99649e95109187c76da255c,1,1,1,2,1,2014-03-18 17:30:21,2014-03-12 21:26:17
7a1db291fcedd50ce99649e95109187c76da255c...73c416a20db8fe48302a6cf0db4c1c0585ed0739,1,3,2,5,1,2014-03-18 17:30:21,2014-03-13 17:30:07
73c416a20db8fe48302a6cf0db4c1c0585ed0739...555416fd02b9e062385dcdaf0c4b9f5de61df388,1,9,0,9,3,2014-03-18 17:30:21,2014-03-18 17:29:24
3a7f69a3d87e2d35d1416e0ea4fe7e1e1a85f8f8...17719cab91e175a7bd11f9852e27638df1202b8b,1,35,7,42,8,2014-02-14 20:12:35,2014-02-14 20:12:35
ca42758368b7bd8e6b102411531c2c89356407ad...96e33a7646b3669632f48ed1071aeb61b8016be1,8,41,25,66,31,2014-02-25 20:41:31,2014-02-25 20:41:31
96e33a7646b3669632f48ed1071aeb61b8016be1...93ed15075c43d521f05f4b8f96264efb7fe174e4,13,117,56,173,34,2014-02-25 23:19:13,2014-02-25 23:19:13
93ed15075c43d521f05f4b8f96264efb7fe174e4...5c67d2e6346d493e2b8b0469d453a64d41c22cb2,1,6,0,6,2,2014-02-26 00:27:07,2014-02-26 00:27:07
5c67d2e6346d493e2b8b0469d453a64d41c22cb2...bfdf07ac98e1a425892b787cf224109d5925a798,1,14,0,14,2,2014-02-26 01:13:00,2014-02-26 01:13:00
bfdf07ac98e1a425892b787cf224109d5925a798...6016126c71272f7943458bbb8392dfd1f5877269,1,4,2,6,1,2014-02-26 03:45:57,2014-02-26 03:45:57
3455c6f47085cfdc519db1b8fbd0955528c2e630...bd85631ca56d0aaa5293e27048b20b6bfa45e679,2,27,5,32,23,2014-02-04 20:40:56,2014-02-04 20:18:12
a9b325e5b00095a44617aa4b146e51f048e213ba...aed37e70b9ca2cff1749fb2de639a11b9c346d67,1,3,3,6,2,2014-02-04 22:44:55,2014-02-04 22:29:07
af50b2f17c66b789de079861fb3f5e5678cb8d30...fc559d999256a8171015f18fd67e51c39ea5aa32,1,2,2,4,2,2014-01-06 17:29:56,2014-01-06 17:29:56
af50b2f17c66b789de079861fb3f5e5678cb8d30...ea762c1a51a7dfbb08294c2b6fa105095dd193b3,1,2,1,3,1,2014-01-06 17:29:33,2014-01-06 17:29:33
ea762c1a51a7dfbb08294c2b6fa105095dd193b3...b308e33106832cd4452f473ff0a54c2031070e0a,1,1,1,2,1,2014-01-06 18:35:51,2014-01-06 18:30:02
af50b2f17c66b789de079861fb3f5e5678cb8d30...599009191a6d9aa157de10c296909829b93bc00e,1,1,1,2,1,2014-01-05 09:07:16,2014-01-05 09:07:16
2a1181f404387f6d530a86a6196b40a6dd541c20...c138c335a5d867d81231fdca6f418a9cc11ca244,1,5,5,10,3,2014-01-21 13:21:43,2014-01-06 12:08:55
c138c335a5d867d81231fdca6f418a9cc11ca244...a4e6e9bd41ee0f80e7e9bce05156ddd7d63554aa,1,1,1,2,1,2014-01-21 13:22:26,2014-01-06 12:10:16
a4e6e9bd41ee0f80e7e9bce05156ddd7d63554aa...c6535d272c0d1a07ea51639be66e1959a0fc996f,1,16,16,32,2,2014-01-21 13:22:33,2014-01-06 12:11:16
c6535d272c0d1a07ea51639be66e1959a0fc996f...da4ba80733ff4826ea17d253677a58fdedf4cc00,1,2,5,7,2,2014-01-21 13:22:39,2014-01-06 12:13:19
da4ba80733ff4826ea17d253677a58fdedf4cc00...787ff55283067ef3d8da3238e65ca204bc63b3f9,1,2,4,6,2,2014-01-21 13:22:47,2014-01-06 12:36:04
787ff55283067ef3d8da3238e65ca204bc63b3f9...4137a0ea327ea1775c1b57892fd684da2c738f3e,2,93,1,94,2,2014-01-21 13:22:56,2014-01-06 13:25:36
87bd2da5d8030a3a1909784e4f2ab1f258e8278a...c78088fe3d1b90640c637d8c3457de3caa0c7a24,2,15,1,16,2,2014-10-15 19:15:24,2014-10-15 19:15:24
380aef2dc1d99ccb070f46d5fc57841ab5e17714...61b309f0d280b3b05909f294a30d73317a9d6a4d,1,1,1,2,1,2014-08-21 19:55:00,2014-08-21 19:55:00
519319b989b7434435d95033f6a7ea9f32d141ec...899e9e74165b567c157756d56c47d33fac82c05a,3,19,15,34,8,2014-07-09 21:48:02,2014-06-13 12:02:12
899e9e74165b567c157756d56c47d33fac82c05a...0abdea90947de867719c622a51f0382bcdf592ee,1,1,1,2,1,2014-07-09 21:48:02,2014-07-09 00:25:21
0abdea90947de867719c622a51f0382bcdf592ee...b68111713ddab28485122f149055c865ac4dadaa,4,16,15,31,10,2014-07-09 21:48:02,2014-07-09 21:47:55
9319b7aef119c83f97dfd028cd557d4cb143d04b...eae5cf1e20e8d93cc13ea8e1db3cd787250fa76d,1,10,3,13,4,2014-07-11 19:31:03,2014-07-11 17:49:24
9319b7aef119c83f97dfd028cd557d4cb143d04b...1df4049e17e4a3edf4487b072f2085bc2dd2ee0b,8,17,17,34,17,2014-07-10 04:14:06,2014-07-10 04:14:06
475131cd4a5ef8178e36bf40721baf14ce2b6e26...3a177ccd3afdfe481a7248fccb2efe0f2cbdfcca,5,46,42,88,14,2014-07-29 18:35:02,2014-07-29 05:22:58
cafb1bfd76b902437d06b713dc400b9076030ccb...e1ec91fc582f10d57025e39f0f7e7d6695f7454e,2,31,1,32,6,2014-07-08 19:27:44,2014-07-07 15:47:06
51b188c5102e86ad453c933077bcaf9594070c28...c44c98edec6822edf17cc969038e21be6ccdbd93,2,37,32,69,3,2014-06-17 05:56:57,2014-06-11 15:54:43
51b188c5102e86ad453c933077bcaf9594070c28...52e88d92f0cceb9caa13160febcfe046732e0b86,1,1,1,2,1,2014-06-13 13:53:42,2014-06-13 13:53:42
51b188c5102e86ad453c933077bcaf9594070c28...05243104fc0a0ef9537766cf5bd920824665eb78,4,271,52,323,33,2014-06-13 09:13:18,2013-12-04 14:03:51
3993f9d5818f344199c3b13ae8aa9e6bee22479e...fd66e7746519ab32bf3f6f336052a4ff763e213b,1,31,18,49,8,2014-07-07 23:02:15,2014-07-07 20:44:22
c40602b25483d7bf6e58b715717ade0ad9541b11...be9dcbbef5961357117448976411be155daac019,1,5,5,10,4,2014-06-14 23:18:11,2014-06-14 22:55:24
c40602b25483d7bf6e58b715717ade0ad9541b11...e9f1f760f220cbd0f3df68b09ab8c10b27dfa0e9,1,1,1,2,1,2014-06-14 13:54:27,2014-06-14 13:54:27
c40602b25483d7bf6e58b715717ade0ad9541b11...e02cf69789d12e8d44c8168e1515f43f39be6461,1,2,2,4,1,2014-06-14 07:59:52,2014-06-14 07:59:52
c40602b25483d7bf6e58b715717ade0ad9541b11...cb92c4714460aff9fc5c06c2daa3fd1474d77ef5,3,6,6,12,6,2014-06-14 07:49:51,2014-06-14 07:49:51
c40602b25483d7bf6e58b715717ade0ad9541b11...d561fe6d2d47b2655d8532264ea9ae20e8d20f04,1,1,1,2,1,2014-06-14 07:44:55,2014-06-14 07:44:55
50d49d0db887453b6c5483c9086cbdb68ad466d2...8df0b12d821d5a57051e9a92bc8687ac893deb3f,1,1,1,2,1,2014-06-16 07:52:23,2014-06-16 07:52:23
98ea12ac3864239127ae3a9d2aa2d93a72aa5e61...c70fbae3ed44090fffc9e5b81d2a6410e6008fcc,1,63,73,136,30,2014-06-21 00:10:20,2014-06-21 00:10:20
c70fbae3ed44090fffc9e5b81d2a6410e6008fcc...ab0fc77ebe73e0dededad1d47dc3788191cb966c,1,1,1,2,1,2014-06-21 00:52:30,2014-06-21 00:52:30
98ea12ac3864239127ae3a9d2aa2d93a72aa5e61...8d06bfc12ec62b8276b2db22e049d40dde016c9f,11,279,142,421,31,2014-06-19 22:23:19,2014-06-19 22:23:19
0ba7f934ee0fb3bf0953b1456792443e7faf0921...06cd125e64c30886f66e6490a1cd4e7a7ba23655,1,1,1,2,1,2014-06-18 14:51:44,2014-06-18 14:51:44
96c03d6d920c87305bdb8abfd188de71aaaf8bb5...d4ec4d6e9b273bfc6a1f0e88edcddcd9e742bbab,1,3,4,7,2,2014-06-17 17:36:59,2014-06-11 15:57:12
346a350df4a9f8b6dac25d2b341fcc84139a46ad...ff1ea0064b49bd1d72cafe5d02be9eab4d54b683,1,1,0,1,1,2014-06-20 13:40:29,2014-06-20 13:40:29
346a350df4a9f8b6dac25d2b341fcc84139a46ad...d17c92965937bbc3181b73bb8a4e21ecee217e5f,1,17,11,28,7,2014-06-19 17:42:55,2014-06-19 17:42:55
fa8f89c5212f10932ebc5650853b356670b6f41a...386d1ecc6e2489401aac685eb11da15d21c4b0a7,2,42,56,98,3,2014-06-23 18:19:52,2014-06-23 18:19:52
fa8f89c5212f10932ebc5650853b356670b6f41a...3ce5fde7ab86bb5307129b77fa09225ca07b1128,1,1,1,2,1,2014-06-23 15:08:34,2014-06-23 15:08:34
7992fb5911ecbf7e18afdd64f4ead73c0362e927...752c3e9208fc44ca25d9698170d41d28a3005cee,1,1,1,2,1,2014-06-08 18:31:10,2014-06-08 18:31:10
bf9482987f55d60c50fdf70525d20fd8ddd10e5e...698ded75b9aa076f4278398e56fa95e90e900d2b,16,506,24,530,37,2014-06-17 20:09:36,2014-06-17 18:25:04
b49cfaffa8d9f3dfdece90983e930b333d0cb561...c5f1cb11217af9ffcb794f681ef9ab8ae8e2714e,1,2,3,5,2,2014-06-23 23:07:10,2014-06-16 16:13:23
5dfe7c43d47276fd0b63993058fbcc424370329a...311614952ea64315075d827c880debbdfb503640,1,9,5,14,3,2014-05-16 19:44:42,2014-05-16 19:44:42
5dfe7c43d47276fd0b63993058fbcc424370329a...81ffd6530aced5237c01bd13e80686da68de6637,3,11,10,21,10,2014-05-15 23:27:36,2014-05-15 23:27:36
5dfe7c43d47276fd0b63993058fbcc424370329a...094926206bc98718f2eac95849e57439155d7c6c,8,782,25,807,28,2014-05-15 22:40:26,2014-05-15 15:18:56
094926206bc98718f2eac95849e57439155d7c6c...aedcb76adc2b2468565b311b67f4079a128b37cd,2,29,0,29,1,2014-05-15 22:45:40,2014-05-15 22:45:40
5dfe7c43d47276fd0b63993058fbcc424370329a...8ec01f9dc1d18c532f60f1bfb6c0ab5eea378b3c,1,1,1,2,1,2014-05-15 22:21:17,2014-05-15 22:21:17
5dfe7c43d47276fd0b63993058fbcc424370329a...77c2b76e44f77eee2ca89ff551ac64f8c6b8bd23,1,16,22,38,9,2014-05-15 18:41:07,2014-05-09 22:49:02
5dfe7c43d47276fd0b63993058fbcc424370329a...10a320818e875547c83fecea32cd73231248acf8,1,2,2,4,2,2014-05-15 14:50:59,2014-05-15 14:50:59
f37339c2db413c1d3758bc98f14b209ec943d29e...accea18920e856fc1099d85a3fced06dc7b53799,1,29,5,34,3,2014-05-21 08:45:41,2014-05-21 08:29:24
a7e61a21c0af9547b765edf14da6ea6036a631e7...d61190169de27bc58f1fe4a8f49b37bd2294d489,3,45,7,52,6,2014-05-09 23:12:21,2014-05-04 03:29:55
17a1f470ae3e6f1d7a7c4545983e37bfcfe981ab...4bf03a0fac48a06298afa149d4339245736810b6,2,6,1,7,2,2014-05-17 07:51:02,2014-05-17 07:51:02
17a1f470ae3e6f1d7a7c4545983e37bfcfe981ab...2bc34036b9106318f8564ee36b696ad070b02573,1,31,0,31,2,2014-05-14 20:59:13,2014-05-12 12:41:07
00ce30bc7473b389579a44e55a01c818ebae84e1...92614928cecd48b241011e614fa856c4fdbac1f6,9,75,80,155,21,2014-05-17 00:44:10,2014-05-17 00:44:10
92614928cecd48b241011e614fa856c4fdbac1f6...a0070f0c17b4f65bdfc5368b93d0fa8636eda03d,1,1,0,1,1,2014-05-17 01:16:07,2014-05-17 01:16:07
00ce30bc7473b389579a44e55a01c818ebae84e1...366f084eb0864db6dcf5cc47e434b3c6f43500d7,1,24,0,24,1,2014-05-16 22:23:32,2014-03-27 19:11:23
366f084eb0864db6dcf5cc47e434b3c6f43500d7...2c8b63cb754128a64083426e5c3e6016118e78df,3,28,39,67,5,2014-05-16 22:31:16,2014-03-27 19:16:03
00ce30bc7473b389579a44e55a01c818ebae84e1...a42e451e10bc7383c82933eb4073e70aaf5aaa8f,1,0,2,2,1,2014-05-16 21:26:14,2014-05-16 21:23:37
b561f0398a28b3c648310eb8349b1f65c2fb28d5...9d6875d19d3926faf6287487234ad0b2f1310e9d,3,29,17,46,9,2014-05-16 00:57:58,2014-05-14 18:29:08
4de6810be951541617686887b9ca07e822034b62...5128feb690e8fd0244d1fecef5f3f5f77598bbfa,2,111,41,152,17,2014-05-14 02:04:12,2014-05-13 17:16:06
5128feb690e8fd0244d1fecef5f3f5f77598bbfa...80fca061e7661549a05b2696488db3fea008e2dd,2,124,43,167,21,2014-05-14 02:43:10,2014-05-13 19:04:45
4de6810be951541617686887b9ca07e822034b62...adbe3096e8c8572925dbae5f19ac2ce2dc84fb1c,8,28,6,34,10,2014-05-14 01:17:12,2014-05-13 00:44:57
d9b1c1976ff7343a04c030399ef879430e78226b...a50a46048b8853ddfdac6f000ece86f95229dfea,1,4,4,8,4,2014-05-14 18:14:06,2014-05-14 18:12:42
cb0f2a2823be749a19780b3b818f22fd61adeacd...2269472f3ad09de59ba15185b9558b91f1ecb0b5,10,266,265,531,94,2014-05-14 23:26:36,2014-05-14 17:22:49
cb0f2a2823be749a19780b3b818f22fd61adeacd...830c2d7fa3f19a2fba50464273ae19cd2113e689,1,31,1,32,3,2014-05-14 09:01:02,2014-05-14 08:56:55
d4c774de9759a174a3b77664663f9fd4ee43016d...5dfe0945c34402760475bbf51001d0ae0fb69ccb,1,1,1,2,1,2014-05-09 17:56:20,2014-05-09 17:56:20
5dfe0945c34402760475bbf51001d0ae0fb69ccb...c1108f5d605c30a42bb494920b50d486c6e404a4,2,2,2,4,2,2014-05-12 04:50:41,2014-05-12 04:50:41
08a7bcf5dbb093900ddfd1f300a8bbd97bced507...d787f2731e4242f244e88f047032ad9650f1f8d7,1,3,0,3,1,2014-05-16 18:55:34,2014-05-16 04:36:15
08a7bcf5dbb093900ddfd1f300a8bbd97bced507...8b31824ad6118ed505b43443816c1492e3d81c8c,1,2,2,4,2,2014-05-16 17:50:02,2014-05-16 10:31:16
08a7bcf5dbb093900ddfd1f300a8bbd97bced507...ba0c8292917560b45f840f187c2a8f452550705d,1,1,1,2,1,2014-05-16 16:12:59,2014-05-16 12:04:19
08a7bcf5dbb093900ddfd1f300a8bbd97bced507...bd6fd25dfb4cf7aae0e5e382e3bf10c9b2caa5fb,2,18,1207,1225,8,2014-05-16 10:46:28,2014-05-16 10:46:28
bd6fd25dfb4cf7aae0e5e382e3bf10c9b2caa5fb...39d244a593aad63be58d8b2e452715e25135f255,7,74,121,195,65,2014-05-16 12:12:56,2014-05-16 12:10:02
08a7bcf5dbb093900ddfd1f300a8bbd97bced507...1b4915c1a8ba4724edd4e7864e85ff4fb795d04f,1,1,0,1,1,2014-05-16 09:08:05,2014-05-16 09:08:05
08a7bcf5dbb093900ddfd1f300a8bbd97bced507...ddb99054bc9c04cce4ca761f9f0d822d67d614c4,1,4,4,8,2,2014-05-16 02:33:28,2014-05-16 02:23:03
dccf3362041b4c8f450428f34ec7b4d365b2feaa...6b8f0e394b3960bba1db982c62c002221419f3f5,1,33,7,40,3,2014-06-03 09:34:14,2014-06-03 09:29:27
2f514fb8917ccd3e3e2a389e70d571f8a5982b3b...534521301c81bcc536446351cf4018f02d477d2a,1,8,6,14,4,2014-06-03 22:24:30,2014-06-03 22:15:11
2f514fb8917ccd3e3e2a389e70d571f8a5982b3b...d96eb47dee10a059436b4d4cf285db1d70468e26,1,4,0,4,1,2014-06-03 21:10:59,2014-06-03 21:10:59
d96eb47dee10a059436b4d4cf285db1d70468e26...d08c965e2c6ed223e10773ac77f95b7b6e273e0a,1,3,0,3,1,2014-06-05 19:08:54,2014-06-05 19:08:54
2f514fb8917ccd3e3e2a389e70d571f8a5982b3b...5febba93babcf8c4b01862e88b6f6e11a1532bc8,24,45,45,90,42,2014-06-03 20:54:19,2014-06-03 19:44:20
2f514fb8917ccd3e3e2a389e70d571f8a5982b3b...9fc8028c987ac560ceb3b29eb609d77a82abdacc,12,36,31,67,26,2014-06-03 19:55:30,2014-06-02 18:48:58
af72ca199d2ff85316f6f519ea45e63329263439...659305085f551e39143636b1cfb8351a63cbab6f,1,1,1,2,1,2014-04-29 05:17:36,2014-04-29 05:14:23
af72ca199d2ff85316f6f519ea45e63329263439...b1fe1797f3a808f38cec3d0b9a22556646163441,1,34,26,60,11,2014-04-29 05:16:40,2014-04-29 05:13:25
af72ca199d2ff85316f6f519ea45e63329263439...e4114e6b946dfc0f433fa0f6a9de42f80656ce08,1,5,5,10,5,2014-04-29 04:22:31,2014-04-29 04:22:31
af72ca199d2ff85316f6f519ea45e63329263439...61f156d5215b2c9d38e26bbd732c6e9cb9a3208e,2,64,3,67,3,2014-04-29 00:18:18,2014-04-29 00:18:18
61f156d5215b2c9d38e26bbd732c6e9cb9a3208e...d724242297bf2981ad9c7745e5b130ab7fa8f067,1,17,0,17,1,2014-04-29 00:32:05,2014-04-29 00:32:05
af72ca199d2ff85316f6f519ea45e63329263439...314818e7ba4c675b63caaaabadcfd12d10c4f3a6,1,1,1,2,1,2014-04-28 23:08:03,2014-04-28 23:08:03
af72ca199d2ff85316f6f519ea45e63329263439...76f95294a316c1b545abe1fd17536da74779490b,1,123,0,123,1,2014-04-28 22:58:25,2014-04-25 00:37:58
af72ca199d2ff85316f6f519ea45e63329263439...d98069030dc842741fdff16e1818f2a34ec0167f,1,12,25,37,1,2014-04-28 22:46:03,2014-04-28 22:46:03
9488832c6dd19a740f95c160d6dd42b30a3d8396...6799d14cb8cb9986d4a38473cddd009b96e717c8,1,1,1,2,1,2014-05-04 16:52:48,2014-05-04 16:52:48
e8f8f1c72963e1c9511ea6aedcd8a1f53c5da277...0037dc8d60bc22e34838e15efaa1041ea2826c2c,2,0,24,24,2,2014-04-30 17:56:14,2014-04-30 17:56:14
b372c19b389340962ea86e598df1faea694a4aa6...fd5672349490f9cd18933a2508e1890c9e026af5,3,158,59,217,31,2014-05-09 08:09:52,2014-05-05 17:17:58
b372c19b389340962ea86e598df1faea694a4aa6...877ad96d89093af8b16112c3534f4ceceaf1b7b3,1,1,1,2,1,2014-05-02 14:53:59,2014-05-02 14:53:59
bce49dff0d46dec620e755ed859efa791054a843...2f24b5a9dcc9ca5da07563fb0dd381e49ed844cc,1,66,36,102,17,2014-04-21 04:07:05,2014-04-21 03:27:05
4c720d4de73e53fa189083903e7ff825d0889021...e6b794e5424dd108003063f70e2fb2973dba643e,1,1,0,1,1,2014-04-19 08:04:35,2014-04-19 07:57:17
0757a5663a704c5ffd1181b438703d9113dc4c8c...8c765ae68a4a9aceb9886f4d92f2ded7af144e22,2,154,153,307,44,2014-06-30 02:25:12,2014-06-30 02:25:12
363b49948ab565d1496d2d0832c06fc54be6eb8f...111ab125b954c8d28503e1922e742eb271cc5d04,4,73,28,101,17,2014-06-26 22:49:08,2014-02-14 00:05:36
111ab125b954c8d28503e1922e742eb271cc5d04...9189db3aff3e9d72b215b5e204cfac018b2acc5d,4,101,1,102,6,2014-06-26 22:49:08,2014-02-15 18:38:48
9189db3aff3e9d72b215b5e204cfac018b2acc5d...42ca8a064b0e315c983997dbdb2560c40397eb0e,1,1,0,1,1,2014-06-26 22:49:08,2014-06-20 23:08:27
42ca8a064b0e315c983997dbdb2560c40397eb0e...0098360726e3df99e8f76dce9221a85dd89c2065,2,5,4,9,3,2014-06-26 22:49:08,2014-06-26 02:12:18
0098360726e3df99e8f76dce9221a85dd89c2065...8162dc031246c55e34530d2b35ff7087f143d1c2,1,1,1,2,1,2014-06-26 22:51:47,2014-06-26 22:51:47
9aa840c50dde3d61e620bc8d43861ed0101ac990...e39b8eade1f42503b6b7217e72eff4c8fdc13cb6,3,14,11,25,4,2014-06-26 17:50:18,2014-06-26 17:50:18
e39b8eade1f42503b6b7217e72eff4c8fdc13cb6...af025f2a95090974eaaf3d8792d5f467d0a637be,1,0,36,36,1,2014-06-26 22:39:45,2014-06-26 22:39:45
e8997002545c2dcce476f296cf2693c98539a828...1d3d1c5d2b762a32fbee348702af96f9c00fff83,2,58,4,62,4,2014-06-24 23:39:26,2014-06-07 10:05:23
01d4fd76dd60a24b24adbb8bb85623738c7636a9...4361366783bbb4c9e4bd87e1c16da5a0988ed0bd,1,4,2,6,1,2014-06-27 14:07:50,2014-06-25 15:25:54
01d4fd76dd60a24b24adbb8bb85623738c7636a9...fa3ac2d37032583a7c1171c24d71fbf93e330acc,3,7,7,14,5,2014-06-26 19:51:26,2014-06-25 16:04:59
01d4fd76dd60a24b24adbb8bb85623738c7636a9...7606412d53b522774b2b7cea93fa2618b784e886,1,2,290,292,8,2014-06-26 16:57:12,2014-06-26 13:54:12
01d4fd76dd60a24b24adbb8bb85623738c7636a9...714c1bd8ca49c6fc5e7939d6a7abf6a54d56b06a,5,5,5,10,5,2014-06-26 07:41:58,2014-06-23 05:15:26
01d4fd76dd60a24b24adbb8bb85623738c7636a9...f87afda12344b726c1bfb49b2dc8b5995f86f4ab,1,5,2,7,1,2014-06-25 21:06:24,2014-06-25 08:15:08
01d4fd76dd60a24b24adbb8bb85623738c7636a9...03c5c1930d884f0052b4940643fa5b4fc57bdea7,2,25,1,26,2,2014-06-25 20:39:47,2014-06-25 06:54:53
01d4fd76dd60a24b24adbb8bb85623738c7636a9...f3ea94a79775b30b7338a3fc99923978b260af28,1,6,0,6,1,2014-06-25 19:57:54,2014-06-25 13:36:14
f3ea94a79775b30b7338a3fc99923978b260af28...24bf8faa99ef7c80aca3ee3a6eac485f74e521ef,1,2,2,4,2,2014-06-30 01:46:09,2014-06-30 01:46:09
01d4fd76dd60a24b24adbb8bb85623738c7636a9...0b2b3221e21c8c6947585481ad476d57653ade28,1,2,0,2,2,2014-06-25 19:53:45,2014-06-25 11:46:36
01d4fd76dd60a24b24adbb8bb85623738c7636a9...385c9b1a08aeaf7e08363007e5bb79bf30225b7e,2,8,3,11,4,2014-06-25 15:02:59,2014-06-24 16:50:44
385c9b1a08aeaf7e08363007e5bb79bf30225b7e...baacc7006b35badb2e9ba807451ab158936d7832,2,16,3,19,3,2014-06-25 15:02:59,2014-06-24 16:53:53
01d4fd76dd60a24b24adbb8bb85623738c7636a9...be4f4599a6d2a517e615dc1f64527a3f2ad2f683,5,8,8,16,6,2014-06-25 13:08:02,2014-06-19 12:57:01
01d4fd76dd60a24b24adbb8bb85623738c7636a9...6b2901954107c438d8e92dc6f595ec9bcd179777,1,3,1,4,3,2014-06-25 09:18:16,2014-06-25 07:59:10
01d4fd76dd60a24b24adbb8bb85623738c7636a9...9026888b109e6dd1042259ffd9e707d9e5f76d34,1,1,1,2,1,2014-06-25 05:53:59,2014-06-25 05:53:59
01d4fd76dd60a24b24adbb8bb85623738c7636a9...7c8445826fdce3e46253a6e194a33407ed9bd154,1,69,0,69,1,2014-06-25 05:37:39,2014-06-25 05:37:39
7c8445826fdce3e46253a6e194a33407ed9bd154...04a9fe1e62345d282985724b9eb0cd7446c08449,1,75,0,75,1,2014-06-25 18:49:38,2014-06-25 18:49:38
94370add0523352c94b4665d622b5dfe319b29ba...55691e5fdc78b5c3015c7a481371e482878c14d2,1,10,0,10,3,2014-06-26 20:51:38,2014-06-25 22:24:14
55691e5fdc78b5c3015c7a481371e482878c14d2...250b0d070c7d8fce3d75bafc02c31ab3e356ba2e,2,6,1,7,2,2014-06-26 23:36:29,2014-06-26 23:36:29
94370add0523352c94b4665d622b5dfe319b29ba...f6e6cf9071b098f3e38b42597d94cd0768b17219,1,15,2,17,4,2014-06-25 22:48:58,2014-06-25 22:46:41
d4ca1658275f5dc01dfc0f5af64b2e680e922cf2...0a0dd1163294bfa92f37c41289e697f0ee4d9747,35,1984,0,1984,35,2014-04-21 17:42:46,2014-04-16 18:07:55
0a0dd1163294bfa92f37c41289e697f0ee4d9747...67a73917c10bfaa265698f3bb054f9af43c61d5d,1,1,1,2,1,2014-04-21 17:42:46,2014-04-16 19:34:12
67a73917c10bfaa265698f3bb054f9af43c61d5d...e55ed741c24fe9e974d08f4893c79752fb279dc4,14,19,1061,1080,14,2014-04-21 17:42:46,2014-04-16 20:15:57
e55ed741c24fe9e974d08f4893c79752fb279dc4...1b2b783b52d76c7dae2958e6c53dcc3e665cd2fb,30,319,281,600,140,2014-04-21 17:42:46,2014-04-17 15:36:58
1b2b783b52d76c7dae2958e6c53dcc3e665cd2fb...95c311c8b4c63d81792c8683da677b790edf4000,1,10,36,46,4,2014-04-21 17:42:46,2014-04-17 19:36:22
95c311c8b4c63d81792c8683da677b790edf4000...7922e67870a393417c88c2d27f0e8fac47e4596e,1,1,1,2,1,2014-04-21 17:42:46,2014-04-17 19:52:13
7922e67870a393417c88c2d27f0e8fac47e4596e...bbde4298a5c8e12afb6a7bc81c3634b97c2a3c7d,13,1109,7,1116,14,2014-04-21 17:55:06,2014-04-21 17:55:06
bbde4298a5c8e12afb6a7bc81c3634b97c2a3c7d...73257a72ea15cbe67f40cf516129695fae65be33,5,16,12,28,8,2014-04-21 20:28:25,2014-04-21 20:28:25
73257a72ea15cbe67f40cf516129695fae65be33...ac8c705c952b7151cc0bf075742146cac3b93cac,1,1,1,2,1,2014-04-21 20:37:08,2014-04-21 20:37:08
ba11de9efaf6e493726c32cafc3010d594b8fdbd...b3ddc31b9581665eb15dedd0aa45bd37c1eb6815,1,6,3,9,1,2014-04-23 15:06:59,2014-04-22 20:56:18
ba11de9efaf6e493726c32cafc3010d594b8fdbd...e0af429a2acd7681f423ca29ff88b60d9bf2450f,1,3,3,6,3,2014-04-23 01:59:16,2014-04-23 01:56:01
ba11de9efaf6e493726c32cafc3010d594b8fdbd...5957e6b385065cfa7e1ada851b1811a0900ef836,2,150,0,150,2,2014-04-22 22:50:14,2014-03-11 23:45:58
5957e6b385065cfa7e1ada851b1811a0900ef836...3960da04c87e8830378699c5b2b47a50944359b6,2,90,2,92,4,2014-04-22 22:50:14,2014-03-12 00:15:26
3960da04c87e8830378699c5b2b47a50944359b6...188c2ef806f50312139484c7d34bd9a3e42773ec,1,10,5,15,3,2014-04-22 22:50:14,2014-03-19 00:05:44
188c2ef806f50312139484c7d34bd9a3e42773ec...b637e5f04af010bd1fc6bef93b8512d587d90c46,2,13,8,21,5,2014-04-22 22:50:14,2014-03-19 00:06:31
b637e5f04af010bd1fc6bef93b8512d587d90c46...c401c43cae4d646a2a7f87850518a1d6ca6ada57,1,8,0,8,3,2014-04-22 22:50:15,2014-03-19 00:09:09
c401c43cae4d646a2a7f87850518a1d6ca6ada57...59853c188d6f7a3b1d73af7451d2b92d9d37ab21,1,21,0,21,1,2014-04-22 22:50:15,2014-03-19 00:11:03
59853c188d6f7a3b1d73af7451d2b92d9d37ab21...0e42c7d889232ea90192ec368637c3f05c6347c8,1,86,0,86,1,2014-04-22 22:50:15,2014-03-19 00:21:32
0e42c7d889232ea90192ec368637c3f05c6347c8...be470f2497eb478b81e46134e5ce13fb41c4ec1c,1,91,0,91,1,2014-04-22 22:50:15,2014-03-22 00:30:15
be470f2497eb478b81e46134e5ce13fb41c4ec1c...cd8ddacdc7ced235dafda9b8ff0177cf2c5827f3,2,675,1,676,2,2014-04-22 22:50:15,2014-03-22 00:31:07
cd8ddacdc7ced235dafda9b8ff0177cf2c5827f3...fd890136a9fc5770b0e2acf5fbb966bbb377a1f3,2,24,3,27,4,2014-04-22 22:50:15,2014-03-22 00:40:11
fd890136a9fc5770b0e2acf5fbb966bbb377a1f3...7f00a3b6652c9601986e9b7020ceb78cfd3f7740,1,25,5,30,8,2014-04-22 22:50:15,2014-03-22 01:11:24
7f00a3b6652c9601986e9b7020ceb78cfd3f7740...11f2531da631f25437216a051be7699ff2d4663a,4,112,97,209,6,2014-04-22 22:50:15,2014-03-22 01:18:42
11f2531da631f25437216a051be7699ff2d4663a...f94a18677a8c832d386ea96714c7e58874bb31f9,1,1,1,2,1,2014-04-22 22:50:15,2014-03-22 02:20:26
f94a18677a8c832d386ea96714c7e58874bb31f9...5c14c3ada569f9c6a84b4fbbdbd5ed2b82fda4d8,1,1,1,2,1,2014-04-22 22:50:15,2014-03-22 02:21:53
5c14c3ada569f9c6a84b4fbbdbd5ed2b82fda4d8...f0933a91b045932e84c47e1e6e9209065924f740,1,2,5,7,7,2014-04-22 22:50:16,2014-03-22 02:22:25
f0933a91b045932e84c47e1e6e9209065924f740...d00a6b76480e4c05ffdc6b30434d2b5b11a54ab9,1,113,5,118,5,2014-04-22 22:50:16,2014-03-22 02:23:13
d00a6b76480e4c05ffdc6b30434d2b5b11a54ab9...f586dcf307a612d464c6281fac86c291f6bf70b2,1,66,26,92,11,2014-04-22 22:50:16,2014-03-22 03:54:05
f586dcf307a612d464c6281fac86c291f6bf70b2...8875cdf56191a91adb20a86186c7d402cd65a4e3,1,25,1,26,4,2014-04-22 22:50:16,2014-03-24 03:41:28
8875cdf56191a91adb20a86186c7d402cd65a4e3...07c03944ffc5010ae0300bfd794c79f44e1637d4,1,1,1,2,1,2014-04-22 22:50:16,2014-03-24 03:42:29
07c03944ffc5010ae0300bfd794c79f44e1637d4...4481e80636f282b1164b6e4ef0f4cdec246daed5,1,1,1,2,1,2014-04-22 22:50:16,2014-03-24 03:43:14
4481e80636f282b1164b6e4ef0f4cdec246daed5...851c1b05d07e5e96450d702f5997560fa657740d,2,4,1,5,4,2014-04-22 22:50:16,2014-03-24 03:45:44
851c1b05d07e5e96450d702f5997560fa657740d...771e493457914722dc31a232ce7f01bc1504fd56,1,91,25,116,18,2014-04-22 22:50:16,2014-03-24 03:46:31
771e493457914722dc31a232ce7f01bc1504fd56...97a2c0ebe66a03593bd184b226f54f38063adf0d,3,295,0,295,3,2014-04-22 22:50:16,2014-03-24 06:25:59
97a2c0ebe66a03593bd184b226f54f38063adf0d...cb66e8c1366ed5aae9df1bf59b71aed5a83590f4,1,21,15,36,15,2014-04-22 22:50:17,2014-03-24 23:21:55
cb66e8c1366ed5aae9df1bf59b71aed5a83590f4...916372c76ffaa3e49bb3c76cf904e675c2b23710,1,0,2,2,2,2014-04-22 22:50:17,2014-03-24 23:22:09
916372c76ffaa3e49bb3c76cf904e675c2b23710...276fb1918deb19ee90495e8c88cb5c6774ec31df,2,100,0,100,2,2014-04-22 22:50:17,2014-03-25 00:24:48
276fb1918deb19ee90495e8c88cb5c6774ec31df...99dda11d4525c5153a10c4c95c5f46ca3512fc69,2,40,2,42,4,2014-04-22 22:50:17,2014-03-25 00:25:07
99dda11d4525c5153a10c4c95c5f46ca3512fc69...5bcf2a736ce154aa9cd6c664db639a35f888fd18,1,4,0,4,1,2014-04-22 22:50:17,2014-03-25 00:31:30
5bcf2a736ce154aa9cd6c664db639a35f888fd18...460c98d92d6195f7833c19a5a955576842871638,1,10,8,18,7,2014-04-22 22:50:17,2014-03-25 00:32:26
460c98d92d6195f7833c19a5a955576842871638...488fe61354d772e5a4c13e4b893d976cc2361863,1,12,0,12,1,2014-04-22 22:50:17,2014-03-25 01:16:27
488fe61354d772e5a4c13e4b893d976cc2361863...8697490740ca3b3ae87c30e71a8baf49dddb7789,1,4,1,5,1,2014-04-22 22:50:17,2014-03-25 01:17:16
8697490740ca3b3ae87c30e71a8baf49dddb7789...6072dec9e774f1012faa73713c404603f4a09a14,1,33,0,33,3,2014-04-22 22:50:17,2014-03-25 01:18:00
6072dec9e774f1012faa73713c404603f4a09a14...1737063904dbcc311bee64b4c48548549006e62e,1,24,3,27,5,2014-04-22 22:50:17,2014-03-25 17:00:23
1737063904dbcc311bee64b4c48548549006e62e...bcd31405cffba0334c2a71c2be908aa8299400ae,1,4,4,8,4,2014-04-22 22:50:18,2014-03-25 17:00:51
bcd31405cffba0334c2a71c2be908aa8299400ae...5689792171bc6cd5f6d5c2e574d6b976c5f3557c,1,82,14,96,7,2014-04-22 22:50:18,2014-03-25 17:14:27
5689792171bc6cd5f6d5c2e574d6b976c5f3557c...ab2010cfd32b50bb2ff0e4ef9449c0464253b83b,1,33,0,33,3,2014-04-22 22:50:18,2014-03-25 17:14:52
ab2010cfd32b50bb2ff0e4ef9449c0464253b83b...ec288895e53da11dc28a87d70fc1dd19c63433b8,1,2,5,7,5,2014-04-22 22:50:18,2014-03-25 21:10:30
ec288895e53da11dc28a87d70fc1dd19c63433b8...d4920b3fffb5458e8d5368f50cedea8e45b21cee,1,161,256,417,26,2014-04-22 22:50:18,2014-03-26 01:11:06
d4920b3fffb5458e8d5368f50cedea8e45b21cee...eca6fecb590b1a3107beb910f8df5aef0da457e6,1,14,0,14,2,2014-04-22 22:50:18,2014-03-26 01:19:20
eca6fecb590b1a3107beb910f8df5aef0da457e6...d7a2ae8e13f2d830688091c072878c145ac07f17,1,8,3,11,3,2014-04-22 22:50:18,2014-03-26 01:19:35
d7a2ae8e13f2d830688091c072878c145ac07f17...c9b8e0fcac0674ec1a1387c40281a905ce351300,1,1,1,2,1,2014-04-22 22:50:18,2014-03-26 01:36:11
c9b8e0fcac0674ec1a1387c40281a905ce351300...3686d50429db11a709bb480e29b769e808c207e7,1,1,1,2,1,2014-04-22 22:50:18,2014-03-26 01:36:22
3686d50429db11a709bb480e29b769e808c207e7...dff98543054fbccf8b6cd2b9999bdddeace951d9,1,93,9,102,8,2014-04-22 22:50:19,2014-03-26 02:50:44
dff98543054fbccf8b6cd2b9999bdddeace951d9...74b90c25d99217a2f8214960d5856a060038b58b,1,49,0,49,1,2014-04-22 22:50:19,2014-03-26 19:24:12
74b90c25d99217a2f8214960d5856a060038b58b...fb1af1f0bc87712a41a47829e12a2f273b2c8a55,1,13,8,21,3,2014-04-22 22:50:19,2014-03-26 19:24:28
fb1af1f0bc87712a41a47829e12a2f273b2c8a55...a5bc75d4060b3537661e02a8406ab9a270727efc,1,2,0,2,1,2014-04-22 22:50:19,2014-03-26 22:45:06
a5bc75d4060b3537661e02a8406ab9a270727efc...34c5724b899ad8ceca4963ad527f246f06cb65b9,1,12,6,18,7,2014-04-22 22:50:19,2014-03-26 22:46:02
34c5724b899ad8ceca4963ad527f246f06cb65b9...e512fef42505b3d276936a563a3ea4a44a52b19c,1,1,2,3,2,2014-04-22 22:50:19,2014-03-26 22:47:05
e512fef42505b3d276936a563a3ea4a44a52b19c...5ddf67385164f76a2dbe1ed30442dd99c7911827,1,2,0,2,1,2014-04-22 22:50:19,2014-03-26 22:47:36
5ddf67385164f76a2dbe1ed30442dd99c7911827...6d5c75a2242d14fda250759371fdedbcd519654a,1,60,0,60,1,2014-04-22 22:50:19,2014-03-26 22:48:12
6d5c75a2242d14fda250759371fdedbcd519654a...371f6fc63d864711ee546220116f31ddb151fcce,1,21,1,22,1,2014-04-22 22:50:19,2014-03-27 18:00:18
371f6fc63d864711ee546220116f31ddb151fcce...222fc87ade3ed83623a3dae867f50d193b48b2a9,2,186,46,232,8,2014-04-22 22:50:20,2014-03-27 21:54:53
222fc87ade3ed83623a3dae867f50d193b48b2a9...e1c8dbba97212381874c297ba07270436ea595cc,2,49,21,70,6,2014-04-22 22:50:20,2014-03-27 22:54:18
e1c8dbba97212381874c297ba07270436ea595cc...ffe19414b1cc02daeb0cad4b7310ab1e96976ecf,1,19,5,24,6,2014-04-22 22:50:20,2014-03-27 22:54:54
ffe19414b1cc02daeb0cad4b7310ab1e96976ecf...08686f1d2108bbe93d02e870abe8b944b1fe022b,1,16,0,16,1,2014-04-22 22:50:20,2014-03-28 01:25:49
08686f1d2108bbe93d02e870abe8b944b1fe022b...6e0a156d9086300a34b0e1f441dd5150dde57be1,2,16,3,19,5,2014-04-22 22:50:20,2014-03-28 01:26:42
6e0a156d9086300a34b0e1f441dd5150dde57be1...2b81fb8424eb4ba8c815c856075509d686c383a0,1,1,1,2,1,2014-04-22 22:50:20,2014-03-28 01:27:32
2b81fb8424eb4ba8c815c856075509d686c383a0...6d9cdbf24f1f99dd42788afcadc300128175f42f,1,1,22,23,2,2014-04-22 22:50:20,2014-03-28 01:27:58
6d9cdbf24f1f99dd42788afcadc300128175f42f...cd85af06fe693d849766348e505607f3bd4ff3fc,1,66,1,67,2,2014-04-22 22:50:20,2014-03-28 06:58:06
cd85af06fe693d849766348e505607f3bd4ff3fc...4ebe7aab91b67048ea0d2bbec13bfb1d79787f11,1,39,14,53,8,2014-04-22 22:50:20,2014-03-28 07:01:35
4ebe7aab91b67048ea0d2bbec13bfb1d79787f11...4f5b94d3690e3ccdcc23b68d9635dfa37b6dd0e4,1,58,3,61,7,2014-04-22 22:50:20,2014-03-28 17:15:20
4f5b94d3690e3ccdcc23b68d9635dfa37b6dd0e4...7534f7a34b2f0d5eac5e59c1a686adc6f4410d26,1,73,1,74,1,2014-04-22 22:50:21,2014-03-28 22:36:29
7534f7a34b2f0d5eac5e59c1a686adc6f4410d26...3a2b31a30b49f02f6043be5790fd2a123c2c5eae,1,2,2,4,1,2014-04-22 22:50:21,2014-03-28 22:37:21
3a2b31a30b49f02f6043be5790fd2a123c2c5eae...1dc449e11dfaf9b376b953322b4bab19e88f7d94,1,221,237,458,10,2014-04-22 22:50:21,2014-03-28 22:42:57
1dc449e11dfaf9b376b953322b4bab19e88f7d94...29ddf2be1e9b9349865e3d0f34b1d4fc0b960ee3,1,8,16,24,8,2014-04-22 22:50:21,2014-03-28 22:50:14
29ddf2be1e9b9349865e3d0f34b1d4fc0b960ee3...207e604bad1bf5d69c139cb17568cfc473a391ba,3,20,2,22,3,2014-04-22 22:50:21,2014-03-28 22:53:03
207e604bad1bf5d69c139cb17568cfc473a391ba...b0228d94beeeb331f6ac58b289eba4982a42c5d4,1,12,0,12,2,2014-04-22 22:50:21,2014-03-24 14:33:22
b0228d94beeeb331f6ac58b289eba4982a42c5d4...70d32621615506b6622380ed6021f63be67e6e23,5,207,176,383,85,2014-04-22 22:50:21,2014-03-28 23:57:48
70d32621615506b6622380ed6021f63be67e6e23...5833e7888725dcb7d0bfd3f23087deed73a75328,1,9,0,9,1,2014-04-22 22:50:21,2014-03-29 00:06:34
5833e7888725dcb7d0bfd3f23087deed73a75328...4f92ffb50036f313a51020e1bfdcad7b10db65fb,2,12,12,24,12,2014-04-22 22:50:21,2014-03-31 18:58:29
4f92ffb50036f313a51020e1bfdcad7b10db65fb...2f4b8b7e8dbdc1861ee83b63d92ab0921045861f,1,1,1,2,1,2014-04-22 22:50:22,2014-03-31 19:01:06
2f4b8b7e8dbdc1861ee83b63d92ab0921045861f...ed62ca5b2f673fde54c2ffc5edaf0e5bcbd1b721,1,115,53,168,15,2014-04-22 22:50:22,2014-03-31 19:04:39
ed62ca5b2f673fde54c2ffc5edaf0e5bcbd1b721...a2b88b4915acf7b1c1a165dd9193f416e5b99e3c,1,33,0,33,1,2014-04-22 22:50:22,2014-03-31 19:45:12
a2b88b4915acf7b1c1a165dd9193f416e5b99e3c...b97375fc29a88f896e14f45a34c263a4948c9ad9,1,1,1,2,1,2014-04-22 22:50:22,2014-03-31 19:45:39
b97375fc29a88f896e14f45a34c263a4948c9ad9...d0ca66dded29c3e5e2f78d99e9cc9205484c3b5f,1,14,4,18,3,2014-04-22 22:50:22,2014-03-31 19:46:46
d0ca66dded29c3e5e2f78d99e9cc9205484c3b5f...06df94d55b6a1ec10faf4672ebe7fcaf7fb62ab7,8,53,0,53,8,2014-04-22 22:50:22,2014-03-31 19:47:09
06df94d55b6a1ec10faf4672ebe7fcaf7fb62ab7...a88d8d678b4f168885a65f8bb13720f282725355,1,39,0,39,1,2014-04-22 22:50:22,2014-03-31 19:54:50
a88d8d678b4f168885a65f8bb13720f282725355...1fb0bf1b3b7ba2f5188bb58ef8d6991173e6b0f2,1,9,6,15,3,2014-04-22 22:50:22,2014-03-25 12:32:44
1fb0bf1b3b7ba2f5188bb58ef8d6991173e6b0f2...40b4f86eab7b5bf7ca7d85eb8cc7b715fd03feab,12,0,0,0,0,2014-04-22 22:50:22,2014-04-01 22:49:29
40b4f86eab7b5bf7ca7d85eb8cc7b715fd03feab...8f5435e80c3dbaa27429bbb7cadf2c735caa76de,4,246,6,252,6,2014-04-22 22:50:23,2014-04-02 23:38:36
8f5435e80c3dbaa27429bbb7cadf2c735caa76de...9206b18818db988621f60cbf869eb20acd1a49e9,1,17,38,55,1,2014-04-22 22:50:23,2014-04-02 23:41:33
9206b18818db988621f60cbf869eb20acd1a49e9...63fd2ec0f7ec091912435cedc081b132e66ae658,1,14,29,43,10,2014-04-22 22:50:23,2014-04-03 00:40:21
63fd2ec0f7ec091912435cedc081b132e66ae658...0822d67b2dc05dc2500e3b898dc3604be47fcd84,1,31,76,107,25,2014-04-22 22:50:23,2014-04-03 02:01:34
0822d67b2dc05dc2500e3b898dc3604be47fcd84...d3df4b5baf0d3707dd8bbf700c5836dfdfac8752,2,402,349,751,21,2014-04-22 22:50:23,2014-04-03 02:18:00
d3df4b5baf0d3707dd8bbf700c5836dfdfac8752...30424f4e3a40ec21ac25e5c3f9ef45c3109c9f06,1,7,17,24,1,2014-04-22 22:50:23,2014-04-03 03:03:17
30424f4e3a40ec21ac25e5c3f9ef45c3109c9f06...0d08d36bf576babd74f21b83ccde019acde4d9c7,1,35,0,35,1,2014-04-22 22:50:23,2014-04-03 03:04:33
0d08d36bf576babd74f21b83ccde019acde4d9c7...271ba1804349217d8cc22cfdd412a1741dbbcfea,2,18,18,36,3,2014-04-22 22:50:23,2014-04-03 03:05:00
271ba1804349217d8cc22cfdd412a1741dbbcfea...6ce4d2c8424e029237b4ad0c615a4ff6204a1064,4,154,14,168,24,2014-04-22 22:50:24,2014-04-03 04:58:47
6ce4d2c8424e029237b4ad0c615a4ff6204a1064...bc6303f15d9ac4f2f281bbf4e4d76f7517e10117,2,6,0,6,2,2014-04-22 22:50:24,2014-04-05 00:30:03
bc6303f15d9ac4f2f281bbf4e4d76f7517e10117...0bf2109121c3b6e12f781acc14016af451c5cd3d,1,1,0,1,1,2014-04-22 22:50:24,2014-04-22 22:48:39
0bf2109121c3b6e12f781acc14016af451c5cd3d...bf51f36d8f07d0c53f7b7b3c21ae372f7ca3be33,11,56,71,127,60,2014-04-22 23:16:29,2014-04-22 23:09:42
ba11de9efaf6e493726c32cafc3010d594b8fdbd...f763075c74aeb8a829cb310164f36015fb4bc806,33,10,4,14,1,2014-04-22 12:43:08,2014-04-22 12:43:08
ba11de9efaf6e493726c32cafc3010d594b8fdbd...2c4cebe916299c7485e929e49ebc6d263e3769cf,1,8,6,14,2,2014-04-22 12:26:44,2014-04-22 12:26:44
ba11de9efaf6e493726c32cafc3010d594b8fdbd...cf997aa905c5c6f5a29fa3658d904ffc81a1a4a1,2,24,51,75,10,2014-04-22 07:49:53,2014-04-18 03:42:57
b1267cb6ada5494b5fc720c08fc27844cd5c6d0e...43feb84203d5c0ca3b2cb110a96b3dd0ec3a93df,1,1,1,2,1,2014-03-04 00:08:40,2014-03-03 07:48:35
5465fdf00f3ece165cbd3bb680dcc571e81510dd...2e71adac9f2935abaf17741a440497e7e31388e2,1,5,5,10,4,2014-03-04 00:12:12,2014-02-28 07:36:19
6f2564350fc454b6fce19a384c4fd6272f7766b7...47f1609f5c491557237fd998840311cb53d95573,1,1,1,2,1,2014-03-05 17:33:18,2014-03-05 17:33:18
6f2564350fc454b6fce19a384c4fd6272f7766b7...35054601d868a82841c220ff474ad47c5d52e871,1,8,8,16,7,2014-03-05 14:43:03,2014-03-05 14:43:03
6f2564350fc454b6fce19a384c4fd6272f7766b7...d6114c0da0e844199e3d23c60a04434566fb5392,9,90,69,159,16,2014-03-05 13:05:32,2014-02-21 09:12:25
6f2564350fc454b6fce19a384c4fd6272f7766b7...5e32c40795e527cc2e916fe5b8970b37e9485266,1,1,1,2,1,2014-03-05 12:16:41,2014-03-05 12:16:41
6f2564350fc454b6fce19a384c4fd6272f7766b7...757b5775725fb90262cee1fa6068fa9dcbbff59f,1,1,1,2,1,2014-03-05 08:40:54,2014-03-05 08:40:54
6f2564350fc454b6fce19a384c4fd6272f7766b7...a7f265223aec54a53c938f119275cb5fcebca4b6,1,23,7,30,7,2014-03-05 04:25:00,2014-03-05 04:25:00
a7f265223aec54a53c938f119275cb5fcebca4b6...9a677e6a68c9a07df8591d87ba82d77934600426,1,86,65,151,32,2014-03-05 04:40:42,2014-03-05 04:40:12
9a677e6a68c9a07df8591d87ba82d77934600426...d9ec3a034719ac933a791bdf064afe8afb63b1f9,1,5,0,5,1,2014-03-05 04:41:59,2014-03-05 04:41:59
d9ec3a034719ac933a791bdf064afe8afb63b1f9...615667b8831e49474ad7d255d62343c2427514ec,1,131,72,203,42,2014-03-05 05:51:34,2014-03-05 05:51:34
615667b8831e49474ad7d255d62343c2427514ec...b69f63283088e1ac744aafeb08189cb593b30787,1,1,2,3,2,2014-03-05 05:52:39,2014-03-05 05:52:39
b69f63283088e1ac744aafeb08189cb593b30787...4293a1ceb476ce4a8621ac1500a3623328fb5b97,1,1,4,5,3,2014-03-05 05:54:58,2014-03-05 05:54:58
4293a1ceb476ce4a8621ac1500a3623328fb5b97...5317ad476d9e2c39cf6379fef4ec7f8ba0bcc23a,1,1,0,1,1,2014-03-05 05:59:46,2014-03-05 05:59:46
5317ad476d9e2c39cf6379fef4ec7f8ba0bcc23a...c41e51ce3df05553b7a4ce6960df68973a4e17ee,1,11,5,16,3,2014-03-05 15:20:42,2014-03-05 15:20:42
a0c465a333b8bcd1642e8720b325eca4dd6bf2e7...39d58129c38e8bb868a6fd9a5620837484f6d742,1,5,22,27,4,2014-03-04 20:30:52,2014-03-04 20:30:52
39d58129c38e8bb868a6fd9a5620837484f6d742...c74a8b28cd723d6f12a54da16ff91a853958da5c,1,0,1,1,1,2014-03-04 20:32:17,2014-03-04 20:32:17
c74a8b28cd723d6f12a54da16ff91a853958da5c...57a47f5bbfe6c82f3cce32aba96fb641f7188eee,1,0,1,1,1,2014-03-04 21:21:22,2014-03-04 21:21:22
3e5102c11e272fd7adf79e6de4d378ff0429c9bd...b24be254fa042e62e1a08af9105ac92da13a6336,1,16,16,32,11,2014-03-09 10:08:11,2014-03-07 14:51:52
3e5102c11e272fd7adf79e6de4d378ff0429c9bd...b3e7df48dfbf3d2300877d1e524132624e9493c3,1,1,1,2,1,2014-03-07 17:20:25,2014-03-07 17:20:25
3e5102c11e272fd7adf79e6de4d378ff0429c9bd...d61938d2b879fe0ccbf46b4a7ca8dd2eb537eee9,1,1,1,2,1,2014-03-07 16:41:11,2014-03-07 16:41:11
3e5102c11e272fd7adf79e6de4d378ff0429c9bd...6d9a7d6bc3edb8294e05a9903d5fa97239ed12e2,1,1,1,2,1,2014-03-07 13:45:08,2014-03-07 13:45:08
9c21a73f7449e412e101ba688459a26137f2c50d...f6efcf20943e656ca977f1fd0ae5197f5757dff4,2,4,4,8,4,2014-03-14 04:35:09,2014-03-14 04:35:09
f6efcf20943e656ca977f1fd0ae5197f5757dff4...ae47f709ca6a6c29b769191ceabb10e59a0408b1,1,1,1,2,1,2014-03-14 04:35:31,2014-03-14 04:35:31
9c21a73f7449e412e101ba688459a26137f2c50d...c349c9d14a1c4bf04f35f3f5c62b0bb92614bc81,2,3,4,7,2,2014-03-14 00:47:13,2014-03-14 00:47:13
26ac05c8bce47fd37c35e43b98cdbcfb65a5c9bb...8ae53ef167d684ed41fd9bd1a04f7a70a1ad20b6,1,2,2,4,2,2014-05-01 02:41:57,2014-05-01 02:41:57
26ac05c8bce47fd37c35e43b98cdbcfb65a5c9bb...93f8e277de63b4bcf6dc82b8c4b7abf81d614355,1,1,1,2,1,2014-05-01 01:51:03,2014-05-01 01:51:03
26ac05c8bce47fd37c35e43b98cdbcfb65a5c9bb...b06ad88ca0a94c63f0c45d00e3478e5e7fd808fa,1,2,4,6,1,2014-05-01 01:15:07,2014-04-25 10:41:48
26ac05c8bce47fd37c35e43b98cdbcfb65a5c9bb...a3e96abb5aacaa763f3f9205316dd0aef1977f16,1,10,1,11,3,2014-05-01 00:02:45,2014-05-01 00:02:45
a3e96abb5aacaa763f3f9205316dd0aef1977f16...aecb9c39ab0eb5f09ebab40001fe0ff639ef617b,3,104,89,193,4,2014-05-01 00:04:24,2014-05-01 00:04:09
aecb9c39ab0eb5f09ebab40001fe0ff639ef617b...b6b0dfdba7bda13d630217830423580c3152899d,5,26,22,48,12,2014-05-01 00:18:07,2014-05-01 00:18:07
b6b0dfdba7bda13d630217830423580c3152899d...176c49d7a9e5a81b6c80e18dea84864148360597,7,94,126,220,36,2014-05-01 00:55:15,2014-05-01 00:55:15
176c49d7a9e5a81b6c80e18dea84864148360597...60e4276f5af360dd3292e22993c0c132a86edc2e,5,142,65,207,24,2014-05-01 01:20:01,2014-05-01 01:20:01
60e4276f5af360dd3292e22993c0c132a86edc2e...aa9705f832d847d6e6ce76e19f3c952c194c167e,1,7,1,8,2,2014-05-01 01:24:47,2014-05-01 01:24:47
aa9705f832d847d6e6ce76e19f3c952c194c167e...da0d6dbd7b5b429b79ae4ea22957e8a14b4ca1ec,5,46,94,140,12,2014-05-01 01:49:24,2014-05-01 01:49:24
da0d6dbd7b5b429b79ae4ea22957e8a14b4ca1ec...d0bee7939482b982462c5848f24b2e5e9ad897ea,1,1,150,151,2,2014-05-01 01:52:15,2014-05-01 01:52:15
c8ae307bab1d0acb109fcbd4aea220a9ba3e03ca...f16372022875a6dfe9d53489bde635789dd865a6,1,2,2,4,2,2014-03-31 18:48:57,2014-03-31 17:39:02
c8ae307bab1d0acb109fcbd4aea220a9ba3e03ca...a2487aa683dc84938eb94c1ae29f8160d09441ea,1,6,6,12,6,2014-03-31 16:07:56,2014-03-31 16:07:56
b936f4f5e1df450cf220f9e14f610a38ebfd6de0...a7365a6237c45ed05d96ab11f36fde35d675b462,5,45,37,82,29,2014-03-31 18:10:02,2014-03-28 22:59:29
a7365a6237c45ed05d96ab11f36fde35d675b462...ae9ed84fdab4db5cec663bbd2d4ba8bcad897dcc,3,502,463,965,13,2014-03-31 18:11:53,2014-03-28 23:21:55
ae9ed84fdab4db5cec663bbd2d4ba8bcad897dcc...185b040e49aa9ab74f8d9254c7ff86b2891e3708,5,127,119,246,69,2014-03-31 18:11:53,2014-03-28 23:36:33
185b040e49aa9ab74f8d9254c7ff86b2891e3708...7697aad7b0537dade1d598cca5b7b1b420fa47c9,1,6,6,12,6,2014-03-31 18:11:53,2014-03-31 18:08:46
25f7b3fbb7cba2ac047db0318a99896173fef0ec...9709c31d1b500fb7cfdb02aaf62c7d8c187874cf,1,5,7,12,3,2014-03-31 19:21:57,2014-03-31 19:21:57
9709c31d1b500fb7cfdb02aaf62c7d8c187874cf...b430f4f45be27b9565027b5c89b2506577027e88,1,20,0,20,1,2014-03-31 19:31:21,2014-03-31 19:31:21
8ff02d58d99c547d59daa9e7bb3a8d4a1fe85121...b246fc33ae4f05b5084fed8fc9f1034e36d87d78,3,17,1,18,5,2014-04-02 00:30:19,2014-04-02 00:30:02
b246fc33ae4f05b5084fed8fc9f1034e36d87d78...d7ec39a4cfbee7b68e0c7973fb629da6f54d873c,1,1,1,2,1,2014-04-02 01:19:26,2014-04-02 01:19:26
f9090567af360c37b5d3f3811834a8de3ac0e06d...8b5cf51d600dc4f3611cf063c52cf3448e7b01e5,4,10,18,28,9,2014-03-17 19:15:44,2014-03-15 02:33:41
f9090567af360c37b5d3f3811834a8de3ac0e06d...a62c7215c6c4675a4f99b63871d89198b211c260,1,4,4,8,2,2014-03-17 18:18:11,2014-03-15 18:48:32
f9090567af360c37b5d3f3811834a8de3ac0e06d...054b85a7b25e46935c0d91f544aac69dc3497468,2,25,1,26,2,2014-03-15 20:03:16,2014-03-15 20:00:35
054b85a7b25e46935c0d91f544aac69dc3497468...c1f492755b8774005b3627da8ee001ee0b2df4eb,1,7,5,12,3,2014-03-18 01:42:13,2014-03-18 01:26:08
c1f492755b8774005b3627da8ee001ee0b2df4eb...69299f041f78f8a86bf810142e740bbd72fe4b1b,1,10,1,11,1,2014-03-18 01:42:27,2014-03-18 01:26:39
f9090567af360c37b5d3f3811834a8de3ac0e06d...853c5e258fc9a3d8420e62aaed4817179073610a,1,1,1,2,1,2014-03-15 17:07:22,2014-03-15 17:07:22
f9090567af360c37b5d3f3811834a8de3ac0e06d...5583774e29911bbd42181e8db2ece08761677cf3,1,1,1,2,1,2014-03-15 15:38:31,2014-03-15 15:34:49
2c10fcc432f8a541aac2c7feb1a453cfc16e4d0b...50b12708e35c300d93e8f8e8d21f79101fc185d3,7,6,67,73,7,2014-03-14 21:37:09,2014-03-14 21:37:09
50b12708e35c300d93e8f8e8d21f79101fc185d3...8c2cbfa0963e953cf75fe09ec688a6125689cc6d,2,61,5,66,7,2014-03-14 21:48:13,2014-03-14 21:48:13
75738b8527f7578f8a18696bc6b49961790414cd...2ba0861ad359477ad81346a81f1bac09cb5e2eb2,1,2,0,2,1,2014-03-14 23:20:22,2014-03-14 23:20:22
555c1ef670c7f0dd9e1bd195ac6391e06e657f67...5921b186d17b172f205f3b0b6bda1f3a4e650d3f,2,13,1,14,2,2014-03-17 18:36:15,2014-03-17 18:36:15
555c1ef670c7f0dd9e1bd195ac6391e06e657f67...90b283c39a36f34ac97f9eb0d66da3a0a9992caa,1,1,1,2,1,2014-03-17 17:56:21,2014-03-17 17:56:21
d3c5891486a263d96db5b1f8e0f0e0f698ad168d...fbfac21ed4de550ce72d993810dc07a2c4877a88,13,229,29,258,48,2014-03-19 14:49:25,2014-02-07 16:48:14
fbfac21ed4de550ce72d993810dc07a2c4877a88...698ca9f38d7ccee2c36b98821c74114b95db631b,1,1,1,2,1,2014-03-19 20:44:09,2014-03-19 19:20:36
698ca9f38d7ccee2c36b98821c74114b95db631b...c657603c612650117b4def976ff40d98ba7c3a21,1,1,1,2,1,2014-03-19 20:44:11,2014-03-19 20:00:46
0bb1e3d9a708d8b60e2efe3888fe9edef0574ac5...92194f613e37aeb8a387920c3bee42480da0d2ac,1,6,5,11,1,2014-03-19 04:12:47,2014-03-19 04:12:47
92194f613e37aeb8a387920c3bee42480da0d2ac...53dc2d67fb65037d9891e2fa0f6559d5e4e2ddcc,1,3,0,3,1,2014-03-19 04:24:49,2014-03-19 04:24:49
53dc2d67fb65037d9891e2fa0f6559d5e4e2ddcc...04d1e686398fff0784a47cb85c37db629d40f5b5,1,1,1,2,1,2014-03-31 01:05:21,2014-03-31 01:05:21
22c18de7bed169792213843476d06dedbd1ba387...f52b2fdcbb29258c5b492fdb2479d473fcb42ca0,2,44,0,44,3,2014-03-18 23:17:28,2014-03-03 22:41:38
f52b2fdcbb29258c5b492fdb2479d473fcb42ca0...b10b950b110c93db34a399753706dc79c71b94d3,1,6,5,11,4,2014-03-18 23:18:04,2014-03-04 05:46:49
b10b950b110c93db34a399753706dc79c71b94d3...f58757a699cf47c3b8770e13f371e1bbf493b5b1,2,10,5,15,4,2014-03-18 23:18:34,2014-03-04 05:47:03
f58757a699cf47c3b8770e13f371e1bbf493b5b1...5dbfe310fe624c66714f8c5017692f528af4c87f,1,0,3,3,1,2014-03-18 23:25:26,2014-03-18 23:25:26
06d87fd54009aa6a0d420e45bb8df11a7dea31c3...041ae08a2c8f6f345ac0d7f5fea4b79655e28dc5,1,8,29,37,1,2014-03-18 23:24:45,2014-03-18 23:24:45
bfbf338f51f90a67e2866358a33e22d576755439...e38e977a0410b754b6f318ff973dc15e6d756023,1,5,0,5,1,2014-03-19 23:45:29,2014-03-18 20:18:36
e38e977a0410b754b6f318ff973dc15e6d756023...43c3ee3ba154e2480191ed3743391810f23f29af,2,27,3,30,5,2014-03-20 23:40:58,2014-03-20 23:40:58
bfbf338f51f90a67e2866358a33e22d576755439...c1f2abd89958a8731211ceb2885eed238a3bea8d,5,29,15,44,10,2014-03-18 19:30:21,2014-03-18 17:38:56
9fbb134d87c9c0c045db6237f79f177280f5efc5...18b896e0f032b6ec71fc7c5e56b2acd470c0fe50,2,3,2,5,3,2014-02-04 22:16:27,2014-02-04 22:16:27
aed37e70b9ca2cff1749fb2de639a11b9c346d67...10d57b648fe77fe34642d0af6c5c010ff1180c85,11,16,16,32,12,2014-02-10 21:34:56,2014-02-09 12:40:31
86292adbd982fa782e64289295df9efd4dc18e67...09c38a8d43cb7fcb128861d0a7f32acaee92115c,1,1,1,2,1,2014-11-07 14:18:53,2014-11-05 08:12:57
09c38a8d43cb7fcb128861d0a7f32acaee92115c...fd9c2ae27dc08114ae1170503217da8d2cb778d6,2,79,1,80,2,2014-11-07 14:35:50,2014-11-03 18:50:16
fd9c2ae27dc08114ae1170503217da8d2cb778d6...1d1b813d255512002b382b2d2db48984d9b03957,1,1,2,3,2,2014-11-10 15:57:01,2014-10-26 05:55:29
1d1b813d255512002b382b2d2db48984d9b03957...662ca4114de579e53e670296615ceb49b8c32d75,3,179,34,213,9,2014-11-10 15:57:54,2014-10-28 21:18:45
662ca4114de579e53e670296615ceb49b8c32d75...c9379eb3fbbc484c056f5a5e49d8d0b755a29c45,6,12,10,22,13,2014-11-10 19:04:01,2014-11-03 22:57:18
c9379eb3fbbc484c056f5a5e49d8d0b755a29c45...0573b17b24b66c26e8311d55dff4d81923030f75,1,1,0,1,1,2014-11-10 19:04:17,2014-11-03 23:00:49
0573b17b24b66c26e8311d55dff4d81923030f75...d51a02091ca5485ed42b336d3df8c6c4ab2d9a6b,10,8,7,15,8,2014-11-11 21:19:34,2014-10-30 12:48:30
d51a02091ca5485ed42b336d3df8c6c4ab2d9a6b...3ab5251f5620e7b8b052ee331f9ac1fbdbb725b1,1,2,16,18,3,2014-11-11 21:19:43,2014-10-27 18:38:22
3ab5251f5620e7b8b052ee331f9ac1fbdbb725b1...1d4a82365bfa215767fc4a4cc7e4d5d10dbcd0e4,1,46,25,71,11,2014-11-11 21:19:54,2014-11-06 18:01:37
1d4a82365bfa215767fc4a4cc7e4d5d10dbcd0e4...0357b26c1b5ecc3a4d0d1b2e7cf63ea8e5f70eba,11,176,13,189,21,2014-11-11 21:20:02,2014-10-29 19:06:51
0357b26c1b5ecc3a4d0d1b2e7cf63ea8e5f70eba...3ac6394b8082d4700483d52fbfe54914be537d9e,5,58,4,62,10,2014-11-11 21:20:09,2014-11-08 15:38:42
3ac6394b8082d4700483d52fbfe54914be537d9e...8d90b0faf8e289edc2b4c13c6f312995745f161b,5,30,5,35,10,2014-11-11 21:20:16,2014-11-11 11:02:14
8d90b0faf8e289edc2b4c13c6f312995745f161b...967f80f3cceb96f85a4795d42eeb7b84ae0ce24a,2,36,2,38,7,2014-11-11 22:14:04,2014-10-23 12:50:06
967f80f3cceb96f85a4795d42eeb7b84ae0ce24a...ea361c0476d03f44051289d8e3c128d699c76acc,4,553,1,554,6,2014-11-14 21:44:20,2014-10-20 19:35:48
ea361c0476d03f44051289d8e3c128d699c76acc...a111eea20cad697bb58ebfbf455ee1670c7cf82c,2,24,2,26,9,2014-11-14 21:45:29,2014-10-20 19:36:28
a111eea20cad697bb58ebfbf455ee1670c7cf82c...04175d07634600f2a5cf43dd197eb2a926aba8b9,1,8,0,8,2,2014-11-14 21:45:37,2014-10-31 17:18:39
04175d07634600f2a5cf43dd197eb2a926aba8b9...1527979e87d361539c2791d4e89602aea3cce174,6,84,24,108,12,2014-11-14 22:05:31,2014-11-11 22:37:44
1527979e87d361539c2791d4e89602aea3cce174...6152460c1e4c058676476314320b17e54de0c621,2,13,7,20,6,2014-11-14 22:20:19,2014-11-12 01:08:59
6152460c1e4c058676476314320b17e54de0c621...eb3738347ade64c2b14995c30b400bc6aa48b84e,4,18,9,27,12,2014-11-14 22:20:19,2014-11-13 14:56:36
eb3738347ade64c2b14995c30b400bc6aa48b84e...5e2d02ab73c06aec4ddeca6965dee3ef3cf6a04e,5,103,15,118,18,2014-11-14 22:20:19,2014-11-11 21:31:15
5e2d02ab73c06aec4ddeca6965dee3ef3cf6a04e...c650d17a266f3fec3c48d7e3c79afe13a6ec139a,1,33,13,46,3,2014-11-14 22:20:19,2014-11-14 19:04:47
c650d17a266f3fec3c48d7e3c79afe13a6ec139a...87f59e3802a44aecdb8febfd34a9661e136ffcf4,1,1,1,2,1,2014-11-14 23:30:58,2014-10-23 22:26:52
87f59e3802a44aecdb8febfd34a9661e136ffcf4...409f65bfd1bde5e45c68e2e1ecf68016ed91426b,1,8,0,8,4,2014-11-24 16:51:37,2014-11-18 21:33:13
409f65bfd1bde5e45c68e2e1ecf68016ed91426b...b256616589700f895845e3c5aa72e9b4511cd67d,3,23,10,33,5,2014-11-24 16:51:37,2014-11-19 16:27:34
b256616589700f895845e3c5aa72e9b4511cd67d...324953d74adf6803efd8796274a80ae0b0cbdbf8,1,29,0,29,1,2014-11-24 17:38:01,2014-11-24 16:33:38
324953d74adf6803efd8796274a80ae0b0cbdbf8...39fa2faad2f3d6fa5133de4eb740677202f53ef4,2,17,1,18,2,2014-11-24 17:38:01,2014-11-14 22:47:37
30806ebc0fbd91725eaf19d22903571f955d6a1b...db21b556ceb365895b84628a2e75c61672d3adef,1,1,1,2,1,2014-10-16 17:22:42,2014-10-16 17:22:42
c78088fe3d1b90640c637d8c3457de3caa0c7a24...f9b4bfa59ba954c8e2d1a0f8cd42f0e75e4d46f3,8,74,16,90,11,2014-10-20 20:51:05,2014-08-16 10:27:04
f9b4bfa59ba954c8e2d1a0f8cd42f0e75e4d46f3...c0598aced053f7a7e06aebd57329348dbc7dfc10,4,24,29,53,16,2014-10-20 20:51:05,2014-08-19 18:54:42
c0598aced053f7a7e06aebd57329348dbc7dfc10...c66196a9dc0cd7d19eb3535c52fdbccfa2ee628e,1,11,1,12,2,2014-10-20 20:51:05,2014-08-19 19:27:23
c66196a9dc0cd7d19eb3535c52fdbccfa2ee628e...f43e77fc125840f40af52da01cd2a62bca49765e,3,20,13,33,12,2014-10-20 20:51:05,2014-08-20 15:31:24
f43e77fc125840f40af52da01cd2a62bca49765e...e134f1f74a9d1f9ec55fcd8af8c2dce8e9558618,8,111,110,221,32,2014-10-20 20:51:06,2014-10-11 03:22:12
e134f1f74a9d1f9ec55fcd8af8c2dce8e9558618...ada9ac7b1300d2c647a17f5f5f274195ef5620b6,2,11,1,12,2,2014-10-20 20:51:06,2014-10-16 18:39:22
ada9ac7b1300d2c647a17f5f5f274195ef5620b6...7d9ccc2636af30e45950b27d3f69cacb0ad43f40,1,3,3,6,2,2014-10-20 20:51:06,2014-10-16 16:14:26
7d9ccc2636af30e45950b27d3f69cacb0ad43f40...8caacb18f8019dfda30d79c327397e5f5783c068,3,9,1,10,3,2014-10-20 20:51:06,2014-10-16 02:39:51
8caacb18f8019dfda30d79c327397e5f5783c068...cf23053eb1d88ce7b3ba2ca06f42c408021c93b5,2,68,1,69,3,2014-10-20 20:53:37,2014-10-17 19:15:07
cf23053eb1d88ce7b3ba2ca06f42c408021c93b5...ff325bcb2feb501c2287ecb305644b003784f726,2,23,2,25,5,2014-10-20 21:35:43,2014-10-17 18:06:05
ff325bcb2feb501c2287ecb305644b003784f726...66fba7c46ed3507166774ec8000ca478907e80a7,5,70,4,74,8,2014-10-20 23:11:44,2014-10-20 19:27:26
66fba7c46ed3507166774ec8000ca478907e80a7...21ab75afe0f7e92ffe942e30c77651a01b6db223,2,37,1,38,3,2014-10-21 21:08:05,2014-10-21 19:26:20
21ab75afe0f7e92ffe942e30c77651a01b6db223...3d287811d78c373a4fd3ef069a9c13cd83b80169,6,334,62,396,26,2014-10-28 14:42:30,2014-10-22 12:30:48
3d287811d78c373a4fd3ef069a9c13cd83b80169...7f8cdeb18ba14502845efa7e7e90e913d2df23d2,5,56,9,65,9,2014-10-30 13:17:11,2014-10-24 00:23:25
7f8cdeb18ba14502845efa7e7e90e913d2df23d2...2dac82eb82b469f94ef26a153d2679663b048ad3,2,88,1,89,3,2014-10-30 13:17:11,2014-10-25 17:58:57
2dac82eb82b469f94ef26a153d2679663b048ad3...463297ffe9d0b671d3b26e13905855ab3ff85d57,2,201,3,204,7,2014-10-30 13:17:11,2014-10-25 18:29:18
463297ffe9d0b671d3b26e13905855ab3ff85d57...9fc8b7f4e1f88d8573118b7300b18379072418d1,2,35,1,36,2,2014-10-30 13:17:11,2014-10-27 21:15:28
9fc8b7f4e1f88d8573118b7300b18379072418d1...e6efbd659606386db4d0b83b98f9e189cf42595c,1,3,1,4,2,2014-10-30 13:17:11,2014-10-29 01:20:30
e6efbd659606386db4d0b83b98f9e189cf42595c...4e9bbfa90054cd730e81b53b2de67a74306afc95,2,19,1,20,2,2014-10-30 13:44:46,2014-10-20 23:17:32
44d737707c513dd987933642680c36ef586b1b0e...6ad5fe86590f757eca754d5bb4a599faec63ae30,1,1,1,2,1,2014-07-04 14:07:49,2014-07-04 11:05:50
44d737707c513dd987933642680c36ef586b1b0e...eceacb8334250b9f241b263f28372d5f35ada71d,1,1,0,1,1,2014-07-04 11:23:36,2014-07-04 05:56:23
44d737707c513dd987933642680c36ef586b1b0e...649b50c0b71a21f8ea6b88c63008a0f909fe4113,1,2,2,4,2,2014-07-04 09:21:13,2014-07-04 09:21:13
44d737707c513dd987933642680c36ef586b1b0e...3f5ab612c8d0c1775a864e4414846b301e6498e9,1,1,1,2,1,2014-07-04 08:59:26,2014-07-04 08:59:26
44d737707c513dd987933642680c36ef586b1b0e...804b00cd7d1f084a872211e5043d255c454c8e51,7,158,11,169,13,2014-07-04 08:33:53,2014-06-26 11:03:23
f0aba1aad4d86c5f4989b40bd27be96d72eab6a2...27c34f3eb93ee58d585f8b792659dc2c0464bd0d,1,60,55,115,33,2014-07-09 00:01:41,2014-07-01 01:28:25
f0aba1aad4d86c5f4989b40bd27be96d72eab6a2...751c7e0f003e27d7c862ff91ca85f300bfcbf2cc,1,13,0,13,2,2014-07-08 23:25:26,2014-07-08 23:09:22
e2c575c5a618c51f08d457fc227276dcb340e0f0...9f61e233c6da72f692190f1f5eb672341253f3e7,10,17,14,31,17,2014-07-07 16:35:38,2014-07-07 16:35:38
e2c575c5a618c51f08d457fc227276dcb340e0f0...3e2ad6ffee68be7f3462fd1311408c7880cd8d88,1,6,1,7,1,2014-07-07 16:04:23,2014-07-07 16:04:23
e2c575c5a618c51f08d457fc227276dcb340e0f0...bbbf64242726dee184f82b3bb355327c9c85b274,1,1,1,2,1,2014-07-07 15:57:50,2014-07-07 15:57:50
903c2af04e99dbfc4030cc875c470c972895f392...a52441b11417bfbcb8aa57fddae79c4f17d5499a,1,1,1,2,1,2014-07-09 04:54:49,2014-06-05 01:41:45
903c2af04e99dbfc4030cc875c470c972895f392...91769117365207ad3218ee7bea6c472583b3ba2b,1,1,1,2,1,2014-07-09 02:26:23,2014-07-09 02:26:23
4195fc04941d4f780187bdcc65c0a9d240216cd6...586e72218ceeb90d31900af198d5c865e4b3e6e4,1,57,45,102,27,2014-06-18 20:45:15,2014-06-06 21:12:39
4195fc04941d4f780187bdcc65c0a9d240216cd6...98041d26bbe68458ca1c2ac7074ef600e832753e,1,1,1,2,1,2014-06-18 20:09:28,2014-06-18 14:32:00
7b366b1f01b2b410fb7587c7f01755be09239510...947405a90951e4715a8399410b67f4f644415d59,1,3,1,4,2,2014-06-14 17:08:23,2014-06-14 17:08:23
7b366b1f01b2b410fb7587c7f01755be09239510...65567e125d9bd4d4ede25dd03bda11ebf1ef7321,1,7,0,7,1,2014-06-13 18:49:57,2014-06-13 18:38:32
7b366b1f01b2b410fb7587c7f01755be09239510...27b2d7ff7245ad57dcaa7f9ce8eeeee743373a85,1,7,1,8,2,2014-06-13 18:20:31,2014-06-13 18:19:59
7b366b1f01b2b410fb7587c7f01755be09239510...eb97163348d88954dbacbcbc7eed71efd666dddc,1,10,8,18,3,2014-06-13 17:40:30,2014-06-13 17:32:25
c7bc929e0151b01e723feca1213a1adb9ffc7d9b...b82778b293e35a147d66001e6406843dc937a233,1,0,14,14,1,2014-07-19 01:45:20,2014-07-19 01:44:41
6cd1061a5b5accf989e6633714f3a0f1f4dc21ac...ade6d780d6222681e16b04ff1439240afc880a4f,1,0,90,90,1,2014-07-17 02:04:52,2014-07-17 02:04:52
6cd1061a5b5accf989e6633714f3a0f1f4dc21ac...6ae07e24104af6eb245339dae3a878fb983d112e,4,12,10,22,9,2014-07-17 01:54:35,2014-07-15 04:02:12
6cd1061a5b5accf989e6633714f3a0f1f4dc21ac...9fc6058aa110d5b59c5068a289b6e3a30fc86f72,29,422,253,675,108,2014-07-16 23:57:19,2014-07-16 22:15:29
9fc6058aa110d5b59c5068a289b6e3a30fc86f72...1501c342d815e3a128dac393b69e23f6ec39c2d7,4,22,86,108,24,2014-07-16 23:57:19,2014-07-16 01:31:46
1501c342d815e3a128dac393b69e23f6ec39c2d7...0d67b420b59c953cf331f735e49e7acad742a41f,3,153,84,237,15,2014-07-16 23:57:49,2014-07-16 22:37:10
0d67b420b59c953cf331f735e49e7acad742a41f...7a8ea91392e0cc97caf2a6edc3b262b33a5b446d,7,41,6,47,9,2014-07-16 23:57:49,2014-07-16 23:39:15
93bf556f1344e7842532b2bfdb8ec6209c5b391b...c0c58b6b46626c0ae5cc9c0b37519c505f5a8484,8,10,10,20,10,2014-06-14 21:16:30,2014-06-14 21:13:55
a6ce867e48cdfaafdca7344bd2df9c29cdd20cbe...8ae966de75fade55da5e34bd65b83c8ceb27346b,2,9,1,10,2,2014-06-16 20:51:56,2014-06-16 20:51:56
a6ce867e48cdfaafdca7344bd2df9c29cdd20cbe...7a7bb43db5ecea4dd08af016a2528d0722bf79ac,1,5,0,5,1,2014-06-16 20:29:20,2014-06-16 20:24:18
7085ec875fbfe927e555d1bdc485654682d698ab...41d437117d13d445192b92a93955dec5c012512c,7,1,7,8,7,2014-06-16 13:22:15,2014-06-16 13:22:15
ad19e5e1330f6c0155b3cf35313c4c1529f0fb45...4d7e28a7d701c3c3ee331f2d6f4fce62fdd20d93,1,5,5,10,5,2014-06-23 04:50:11,2014-06-23 04:50:11
41d405fa5387b0c0a84aea0a41a5ce84e1dd5231...990021ac2b4a4c8e6ae66dd331c372f70eec3b7a,2,24,1,25,2,2014-06-19 23:11:34,2014-06-19 22:46:00
52edbe6a23f3c052d19aedccc5efb6571bfc24f8...661a1e90263cc348c17620cf0b250bf552dd4056,1,3,0,3,1,2014-06-17 20:45:57,2014-06-17 20:45:57
52edbe6a23f3c052d19aedccc5efb6571bfc24f8...3807f8b708b60588526f555190d14a37db408450,1,1,1,2,1,2014-06-17 20:40:34,2014-06-17 20:26:03
52edbe6a23f3c052d19aedccc5efb6571bfc24f8...9e2cc4fcd9c28f80877d930cb5cc6076428e8ef8,1,4,0,4,1,2014-06-17 20:26:26,2014-06-17 20:26:26
9e2cc4fcd9c28f80877d930cb5cc6076428e8ef8...d9d08c5ef5ad395cceea0a1c54c6a4df744e6ee1,1,3,1,4,1,2014-06-18 17:15:51,2014-06-18 17:15:51
52edbe6a23f3c052d19aedccc5efb6571bfc24f8...4902f047d3c6c37138a51bee05a3a48552619884,2,5,5,10,5,2014-06-17 20:07:34,2014-06-17 20:07:34
52edbe6a23f3c052d19aedccc5efb6571bfc24f8...d0c4e448632f49b73bf63862a4b20b142ff7f2c9,4,176,73,249,19,2014-06-17 19:56:22,2014-06-04 18:47:09
2d34a08c48b734c17a29c0db2c2aae12ff4f8227...ebc05cbbea55d6a77f1ba159b7df4c4a9c6468f3,1,1,0,1,1,2014-07-21 23:50:32,2014-07-21 23:26:14
2d34a08c48b734c17a29c0db2c2aae12ff4f8227...1a1ee73e38eb54f9b5a3fd03f98c4bb80dde1bbb,1,4,0,4,1,2014-07-12 09:38:33,2014-07-12 09:38:33
2d34a08c48b734c17a29c0db2c2aae12ff4f8227...fc2631b499ba27350f20e7466f54cb06b5c65079,1,4,2,6,3,2014-07-09 09:41:57,2014-07-09 09:39:38
2eac1c4bc5e3b77a99d94811cc481bc27b648ee0...986a151b8afe59b33097235a5964f78fc1a55521,2,3,3,6,3,2014-06-19 21:06:34,2014-06-19 21:05:42
2eac1c4bc5e3b77a99d94811cc481bc27b648ee0...3f7909e9967ded9740fdf951c6f7e95f4aa9c963,1,1,0,1,1,2014-06-19 20:35:30,2014-06-19 20:35:30
5b85dc3584b0f4ff02874c78e8fb475f26889288...d6c494671fbc916aec11f0290fb359dbb4e74c30,1,1,1,2,1,2014-06-08 18:37:58,2014-06-08 18:37:58
924aa984cf9ded2b49ccc9079ce69c96b3d64041...d35330bb7aa8473b92f6f45718aa6c38863cccc7,1,177,170,347,64,2014-05-16 00:00:20,2014-05-15 23:30:46
e5a5808f51e5e6fbd11aec2242ee7bd5991c201f...8b77a5b7aedb1168707f486ed540edf3e5de8819,2,14,0,14,2,2014-05-15 22:47:20,2014-05-15 21:52:36
8b77a5b7aedb1168707f486ed540edf3e5de8819...b51c366bfc963687b8cc14df614a2fc10bad6306,1,10,0,10,4,2014-05-15 22:47:20,2014-05-15 22:25:38
b51c366bfc963687b8cc14df614a2fc10bad6306...ad35d522dbfac124225e27f58bf07c61a34d78b5,2,3,3,6,3,2014-05-15 23:03:11,2014-04-25 03:54:20
a94a87778cf21440ff8f9bc8866d12903d590e88...f0489ce3a9a4023265bbbd5e9cb333e95f950088,1,60,119,179,33,2014-05-21 16:14:53,2014-05-20 22:05:57
f0489ce3a9a4023265bbbd5e9cb333e95f950088...91ba3379312a74132e2578d167c9e36eeb889525,1,31,15,46,6,2014-05-21 16:14:53,2014-05-21 04:19:55
a94a87778cf21440ff8f9bc8866d12903d590e88...7e42505083cca90d445eb8a9d7d4a4bf9ffb35a4,5,317,0,317,5,2014-05-21 15:47:36,2014-05-01 21:38:44
7e42505083cca90d445eb8a9d7d4a4bf9ffb35a4...51f707cf9dfb2dbe31cfd0cd92b922ca5d98e842,3,12,0,12,3,2014-05-21 15:58:11,2014-05-21 15:58:11
a94a87778cf21440ff8f9bc8866d12903d590e88...6d9e64b27bbee9bb699ebc0f0ff98bb7f56961b3,8,29,29,58,29,2014-05-21 13:35:22,2014-05-21 13:35:22
cc84dd09676623961ef8dd2d7a415e10323ef9c3...e1c7abe8905d4cc034f1ed49e9d102846e412424,1,17,0,17,1,2014-05-19 16:43:31,2014-05-17 02:03:26
cc84dd09676623961ef8dd2d7a415e10323ef9c3...ab6027324d1b31d3f8fb880a014091435b68dd07,1,1,0,1,1,2014-05-17 02:03:08,2014-05-17 02:03:08
9dc66f8822ed5679f4caab71d65406deaa04b54d...ff4ef504708bfaa51d4d361455689a21a031cc35,2,134,1,135,3,2014-05-10 02:15:26,2014-04-28 06:59:46
9dc66f8822ed5679f4caab71d65406deaa04b54d...b4ccd7cbfb5f2c7c4b6c963c4c12e41500e7ad55,1,6,0,6,1,2014-05-10 01:09:26,2014-05-10 01:05:54
9dc66f8822ed5679f4caab71d65406deaa04b54d...2af030ab57d1d84ac9a1d22552dc9d83b16951c4,2,18,0,18,2,2014-05-10 00:01:27,2014-05-10 00:01:27
2af030ab57d1d84ac9a1d22552dc9d83b16951c4...c7978c98097b92b659e2ea1763cd134b0695407e,2,44,0,44,2,2014-05-10 00:06:32,2014-05-10 00:06:32
c7978c98097b92b659e2ea1763cd134b0695407e...a1754c7e46b321c2a079fc5186984a847aa50218,2,52,2,54,4,2014-05-10 00:10:33,2014-05-10 00:10:33
76f09c2ecf06d81b885124bcb3d605096f75f562...3b7a19def609c8fbadc6559e7f47f8a5a7769a5b,28,18,16,34,20,2014-05-14 22:21:44,2014-05-14 22:21:44
3b7a19def609c8fbadc6559e7f47f8a5a7769a5b...b22d10e3c541c46cebe7da44fd2f521c4bc653f4,1,0,3,3,1,2014-05-14 23:01:45,2014-05-14 23:01:45
58b49e60bbd3d9d978ecf3e96f53b47fdcca8cce...3118952e0a63b42b830fc846a56b891d14902976,1,1,15,16,2,2014-05-16 23:25:56,2014-05-16 19:15:21
3118952e0a63b42b830fc846a56b891d14902976...67ce59a806007cd28d96fd11208c4a113d1b92e0,1,4,0,4,1,2014-05-16 23:25:56,2014-05-16 19:47:50
67ce59a806007cd28d96fd11208c4a113d1b92e0...4a3aefbb5232433098c9d27423a10031eb17ff93,1,1,0,1,1,2014-05-16 23:26:28,2014-05-16 23:26:28
838d6a9e9b2206ac8952f8693a7c2be8596bee4a...c4990ab999d49e261c5079925f0b13ef735a729f,2,44,24,68,22,2014-05-30 09:36:14,2014-05-29 12:22:13
c4990ab999d49e261c5079925f0b13ef735a729f...ce9e9ff4a101eec5632704003fae772e8762eb15,1,7,6,13,6,2014-05-30 10:15:46,2014-05-29 12:26:52
ce9e9ff4a101eec5632704003fae772e8762eb15...4e5f6951f2af836c3d9163c8a150298ee87468d4,1,24,5,29,7,2014-05-30 10:16:00,2014-05-29 12:28:06
4e5f6951f2af836c3d9163c8a150298ee87468d4...64bd6a6a5342c87db7096f60365d270d0d69e9d2,2,12,0,12,12,2014-05-30 10:16:00,2014-05-29 12:40:42
64bd6a6a5342c87db7096f60365d270d0d69e9d2...af17b01ad7ba0c4d243e2e234710e44a14b6dad4,1,42,29,71,11,2014-05-30 12:08:06,2014-05-30 08:55:25
af17b01ad7ba0c4d243e2e234710e44a14b6dad4...adb639117b5c61479d65dbf8398c0fbeda1d6cad,1,3,7,10,4,2014-05-30 12:08:29,2014-05-30 09:12:02
c4fc591fbe5cdc7a3b02fe1cfa293d57ce020565...a598dba1346c9f2e878e8250a9d641a2206cb4e5,1,5,0,5,1,2014-05-16 13:08:59,2014-05-16 13:08:59
a598dba1346c9f2e878e8250a9d641a2206cb4e5...1ee423bd5dd7abf6f5f4662132b77fdebf14529a,1,5,3,8,4,2014-05-16 13:36:54,2014-05-16 13:36:54
c4fc591fbe5cdc7a3b02fe1cfa293d57ce020565...b8e338144e90a6bb76110ab04cc216966640a3f4,1,4,0,4,1,2014-05-16 12:23:47,2014-05-16 12:23:47
c4fc591fbe5cdc7a3b02fe1cfa293d57ce020565...408f050d648da0b64d353146a1be59827d76bf70,1,1,1,2,1,2014-05-16 11:45:20,2014-05-16 11:45:20
5aeb77296a974e512a533f9014376ce837f05b50...1ef3ca83d8624aaaaed05cfce1f71282d70d84dd,2,4,37,41,5,2014-06-03 21:56:35,2014-06-03 18:49:34
ae93939414de00878df1d0030ecbdaa124b75b07...613f74c1fbbdc5e476d28974d1dbe3727033d083,5,111,61,172,22,2014-06-03 17:46:53,2014-05-30 22:09:07
2c27e6e9abb01d5a1c8c5d1c16aef6daf82b6b99...dc21dd2634791d272b8e39493815bb81eaba5605,3,33,1,34,6,2014-06-04 02:21:10,2014-06-04 00:25:07
2c27e6e9abb01d5a1c8c5d1c16aef6daf82b6b99...c11fadb282ea7e96eef2280a5e422fd2c94e8c45,1,8,4,12,6,2014-06-03 23:57:32,2014-06-03 23:28:06
a2ec8fa1db6e2e77d29f58623f35c2b2ded8e3b7...8d63b610c39eb34b06f275b507c482460015531e,4,39,20,59,17,2014-06-04 21:20:21,2014-06-04 06:41:03
a2ec8fa1db6e2e77d29f58623f35c2b2ded8e3b7...7a60b9063c109892f60165adb71682988d39d3d8,1,1,1,2,1,2014-06-03 23:46:55,2014-06-03 23:46:55
b3ff1c55e34d7b92843ca05bbac70e357e7ae8d0...e625bad3d7e5eb08568cbd09d9d574b8c63fd203,1,4,1,5,2,2014-05-05 12:41:21,2014-05-02 20:47:29
e4114e6b946dfc0f433fa0f6a9de42f80656ce08...d5d62ff95574a48816890d8d6e0785a79f559c3c,7,80,18,98,9,2014-04-29 22:45:28,2014-04-29 05:22:54
e4114e6b946dfc0f433fa0f6a9de42f80656ce08...c8381d672226dd17f2e17f9cf9378f06d533911c,3,32,7,39,3,2014-04-29 04:26:25,2014-04-29 04:23:22
c44c51e3ce1680ec2a74fc62f246490f61d7590c...070747a21365959d3179d8df627d3e614318e202,1,1,0,1,1,2014-04-29 18:59:20,2014-04-29 18:59:20
3230889d24d0193697eeb3da5669cb8fc68d4846...56d71ae79bbbdd0d1eb97408c6132687a33ec113,1,29,36,65,10,2014-05-05 12:52:12,2014-05-05 12:52:12
3230889d24d0193697eeb3da5669cb8fc68d4846...46755dfc1aa30a418a11dc8e352c600ef365b969,1,28,27,55,8,2014-05-05 12:18:12,2014-05-05 00:38:44
3230889d24d0193697eeb3da5669cb8fc68d4846...a304dcef00d639b2f5dbf8d7561f1f8de7124573,1,1,1,2,1,2014-05-05 10:54:10,2014-05-05 10:54:10
70fef1460a9d253bdf164d70d7057ec4ee497e08...01fec73ba4cff45ac08c0330ea0d67aff70ebf8e,1,1,1,2,1,2014-05-05 20:56:18,2014-05-05 20:54:37
f5e5777e6359378261b176708dfe4f1853f93814...1fd919bbf41e68cd38a4794e1f8e3d585650a231,1,1,0,1,1,2014-04-30 19:20:52,2014-04-30 19:20:52
f5e5777e6359378261b176708dfe4f1853f93814...6203d8b462ee9dbc42b651ac8b6b2d83b9eef963,1,2,0,2,1,2014-04-30 19:01:06,2014-04-30 19:01:06
1c5a3123cc6ac396656b1027504748bd8dcd65e9...9f152aacf8427cbd20a70d52d633f8a6d624aff5,1,4,3,7,2,2014-05-02 19:27:17,2014-05-02 19:27:17
1c5a3123cc6ac396656b1027504748bd8dcd65e9...59fe77bfa638001cbe9af386f350d6e0dbb23398,3,3,9,12,5,2014-05-02 18:14:24,2014-05-02 18:14:24
e3d6898da1c1691b8c4ad215d0123e9d87879bcd...5b094530c09bca403819c06635c2f7fbaf98b937,4,153,13,166,16,2014-05-05 18:06:44,2014-04-23 09:00:12
e3d6898da1c1691b8c4ad215d0123e9d87879bcd...f2d7c77c638040f64af6f968044f12e44653859d,2,2,0,2,2,2014-05-05 17:47:55,2014-05-05 17:47:55
9cd6a6d6142f3a2623a74187a90487b5a4dae6c8...f59be989dc92503f29aa94ebf9ea4097ec28b8c9,1,23,15,38,13,2014-04-21 03:45:08,2014-04-21 03:45:08
f59be989dc92503f29aa94ebf9ea4097ec28b8c9...004cf556e86a03d8961416b3e8a0a476a424b10f,4,33,2,35,5,2014-04-21 17:26:22,2014-04-21 17:26:03
b4df555d27603621eacbcabb19d1db52bc370c86...da853e98c94c9ce8001d3d1516ba0fd2614db3b0,1,20,6,26,8,2014-06-30 06:52:11,2014-06-30 06:52:11
b4df555d27603621eacbcabb19d1db52bc370c86...26332fe339d4d939d91fe00a0df849d564026005,1,1,0,1,1,2014-06-30 04:19:16,2014-06-30 04:19:16
87c5ecdd690dbdb40df793d4635051ce7848986d...e0dad305791a7406cf819a27fa5a079a46a62acc,14,1794,57,1851,34,2014-06-26 13:57:54,2014-06-24 22:24:02
87c5ecdd690dbdb40df793d4635051ce7848986d...6bb6e422b5cd9e9ee97c5855a94b5776323a5626,1,3,3,6,1,2014-06-26 06:19:30,2014-06-26 06:14:18
510f1ba4382dfeafaede4cc4ffd6111e9a60bd7d...08182da5d829762366b9bff9cb27b25a010ad1dd,2,36,1,37,4,2014-06-27 18:44:13,2014-06-27 08:26:02
510f1ba4382dfeafaede4cc4ffd6111e9a60bd7d...dafddf461eeabd792d9ced6caced75ad6961c1d7,4,225,63,288,36,2014-06-27 17:51:25,2014-06-19 21:33:51
dafddf461eeabd792d9ced6caced75ad6961c1d7...ffd68badc0a3d70fbd063903702355a387621b10,5,60,43,103,19,2014-06-27 17:51:25,2014-06-25 20:17:20
ffd68badc0a3d70fbd063903702355a387621b10...e77729c2e081c5ce55aa1d4f316b7c7703e5de96,3,47,39,86,20,2014-06-27 17:51:26,2014-06-26 07:09:19
e77729c2e081c5ce55aa1d4f316b7c7703e5de96...2cdcfc0c57e375955d3ed7c8e1487f9d4751b255,1,38,0,38,2,2014-06-27 22:57:31,2014-06-27 22:57:20
510f1ba4382dfeafaede4cc4ffd6111e9a60bd7d...a1b6f350e806c43225b724530e563d6ff66e6b8a,1,1,1,2,1,2014-06-27 16:49:40,2014-06-27 16:49:40
a1b6f350e806c43225b724530e563d6ff66e6b8a...38b005ec69e62d93453ac4013fe6bfa2fccebc5d,1,12,0,12,1,2014-06-27 16:51:24,2014-06-27 16:51:24
e35a9a7def6113ffff2c624142ef194abfa7e916...e817681581f433b37a8ab214a73edf5fb2a35473,1,2,2,4,1,2014-06-27 01:10:20,2014-06-27 01:10:20
ac8c705c952b7151cc0bf075742146cac3b93cac...a5b4a907485c76088d02226df62b0a27bd76117f,1,1,1,2,1,2014-04-23 04:17:33,2014-04-23 04:17:33
0ade0af27ee5de5ac7e1e469dcc23ad408dd3b39...e62efb266fd878453b8562e60b06a3e579fe571a,2,5,3,8,5,2014-04-24 01:11:51,2014-02-14 12:16:26
e62efb266fd878453b8562e60b06a3e579fe571a...b2c87fe08b71523eb20fed63e5da3bef30b756ec,3,8,6,14,7,2014-04-24 01:24:58,2014-04-24 01:09:27
96588fb85dce874b39bc7b6fdb9f797734c1c4dc...9d38fd0eefb2df0bf087a67fad2ad852f28e2e96,2,28,0,28,2,2014-04-23 11:07:11,2014-04-17 21:20:18
9d38fd0eefb2df0bf087a67fad2ad852f28e2e96...dc982d3053bf46e03ad27c29d4662a9d5ba5e819,4,16,3,19,6,2014-04-23 11:07:12,2014-04-23 06:28:06
96588fb85dce874b39bc7b6fdb9f797734c1c4dc...086b3208ea0f152f5c9501805fd0d8d1c95c7aad,1,1,1,2,1,2014-04-23 07:17:57,2014-04-23 07:17:57
817494d00923d00991311c1ba0a17acaf2dd1a7a...672edfe807c597a1c245bce996a150dfdf273a3c,8,38,100,138,28,2014-04-23 02:04:03,2014-03-14 23:53:43
672edfe807c597a1c245bce996a150dfdf273a3c...87e8d7754e218d93b480b94537d07793f6680515,3,6,16,22,8,2014-04-23 02:24:47,2014-04-23 02:24:47
87e8d7754e218d93b480b94537d07793f6680515...7100ace42bda2660d1eaecb2ec096ba6753688ea,7,21,42,63,21,2014-04-23 18:54:35,2014-04-23 18:54:35
6b0f0af0e9a755d4d8e503f4e27ad8b0d24208c5...f90029611fec082a41b5629e43a88a39f0674fe2,1,4,0,4,1,2014-04-23 20:47:56,2014-04-23 20:47:56
6b0f0af0e9a755d4d8e503f4e27ad8b0d24208c5...6e6b8b69cdac5154afa823255252bca5c4890c6e,1,1,1,2,1,2014-04-23 19:32:54,2014-04-23 19:32:54
6e6b8b69cdac5154afa823255252bca5c4890c6e...81477a204f910fb5ce518a62c64047a0aa9ce017,1,1,1,2,1,2014-04-23 20:29:52,2014-04-23 20:29:52
a24a802193dc9599c2d074a3629539412d8716ca...cb4189a292dc181e26e0506a3a0dc67936c5401b,4,61,10,71,11,2014-03-05 21:08:24,2014-03-05 19:59:31
d03be9d7cf95bffff024a4be54f6c928f76adea9...69e3d30bb6c5082aff2a7d5eafaf562e59246a49,5,106,17,123,13,2014-03-06 02:02:19,2014-03-06 01:57:27
19b898ad56e238661e336a19380c710ca963f838...b07708c8de5561a43060653d4d532ee0bcd6fd96,1,1,1,2,1,2014-03-04 22:18:40,2014-03-04 22:18:40
27eae50224a8ce68e0379aca0c6d85081c6374a3...bc086a9cd61b2d15fbef9db3cb53c7f3650fda48,1,5,1,6,1,2014-03-07 20:07:17,2014-03-07 20:07:17
27eae50224a8ce68e0379aca0c6d85081c6374a3...b845ff355a3342ee3fee99196d22194706763182,2,33,15,48,5,2014-03-07 19:51:28,2014-03-07 19:51:28
267ca39921c35826ccbdb84fbbc0690bfef385d7...576278102e0fa9166711f8cf23ec972fcccc085e,1,1,1,2,1,2014-03-25 18:33:16,2014-03-25 04:21:37
267ca39921c35826ccbdb84fbbc0690bfef385d7...a5ccb5b28d7e24a379f77ab7619f296aa500c8dd,1,4,1,5,1,2014-03-25 03:45:11,2014-03-25 03:45:11
a5ccb5b28d7e24a379f77ab7619f296aa500c8dd...d6c2188cae85549a40193273cb9893acefadf863,1,3,3,6,1,2014-03-27 19:31:04,2014-03-27 19:31:04
372b7282cbbd09383ae0844eed9d09161dc20b42...6b46a09186b6a53959d567014b8d0e1cff761bc8,5,100,59,159,25,2014-03-20 04:25:09,2014-03-20 01:58:39
9da75eb4df082ce0be68cab55b862f817c73166b...adf04681b4bd7293675b77b2397d87a5361b383b,117,7,47555,47562,102,2014-05-01 05:31:58,2014-05-01 05:31:58
fe4a25546a434eb0299bdc7f61a3cfcc3752fb33...cac0cea03f85191b3d92cdaeae827fdd93fb1b29,4,8,0,8,4,2014-05-01 18:43:55,2014-04-30 06:20:22
24e8b1b834f8e1dc4d963ec76d4f927cb41bbc2b...75633a0451a98bf0c803e742625c4de27dbcc2e8,1,2,0,2,1,2014-04-03 08:43:21,2014-04-03 06:33:34
24e8b1b834f8e1dc4d963ec76d4f927cb41bbc2b...8c4617e0ae3b9c7e5167883ca171ad8e23fc06b4,1,1,1,2,1,2014-04-03 08:40:28,2014-04-03 08:40:28
6899b05236fd06082fb630eb16fb9a3658fa8a97...32ad78b0430079dcc53c245826a244afa2d9b6b6,1,7,5,12,3,2014-04-03 13:32:29,2014-04-01 13:24:24
32ad78b0430079dcc53c245826a244afa2d9b6b6...d76ac4d429e474a7c79f7aab396e318f4e176025,3,9,0,9,3,2014-04-03 13:32:29,2014-04-01 14:03:29
d76ac4d429e474a7c79f7aab396e318f4e176025...ca4224762b5fe9a319b6c1724ee16d1552403269,2,4,5,9,5,2014-04-03 13:45:40,2014-04-02 17:56:30
6899b05236fd06082fb630eb16fb9a3658fa8a97...f9b8161c60f58d383ca0eaf5a99865b83e4a41b8,1,6,4,10,3,2014-04-01 17:29:54,2014-04-01 13:24:24
f9b8161c60f58d383ca0eaf5a99865b83e4a41b8...2224e0d65adfbd08e53430a1d7c750491f788257,3,9,0,9,3,2014-04-01 17:30:10,2014-04-01 14:03:29
1805ef1cccabd3c1beccf88cec98d6a06a1c9188...904bf049c1626567ee28a21bde4b68ab82c5ce77,2,19,0,19,2,2014-03-31 19:10:19,2014-03-31 19:10:19
1805ef1cccabd3c1beccf88cec98d6a06a1c9188...cd51ac92bdf1ce0a1245f5b4565995631512ba64,3,69,1,70,6,2014-03-31 18:44:32,2014-02-17 00:24:22
cd51ac92bdf1ce0a1245f5b4565995631512ba64...bfaa917a966fab1e2c92e70617320957a8d8b43b,1,2,0,2,1,2014-03-31 18:44:32,2014-02-18 19:22:46
bfaa917a966fab1e2c92e70617320957a8d8b43b...586e6c5eb9cd21a95d4bbba051249c4b05b2011e,2,2,2,4,2,2014-03-31 18:44:32,2014-02-18 20:41:28
586e6c5eb9cd21a95d4bbba051249c4b05b2011e...4e0014f582617960bad513518d292b64da866f73,1,1,1,2,1,2014-03-31 18:44:32,2014-02-20 20:34:45
4e0014f582617960bad513518d292b64da866f73...bcba5246f993a74eece36aa4b25df5b5e486e15b,1,2,2,4,2,2014-03-31 18:44:32,2014-02-26 21:05:25
bcba5246f993a74eece36aa4b25df5b5e486e15b...acf5289dddfbbd69e19714f53575eb5088c618f7,1,8,5,13,5,2014-03-31 18:45:13,2014-03-06 17:55:47
acf5289dddfbbd69e19714f53575eb5088c618f7...33dde1f7288781a3a36951309f963e6040a1a0f5,3,59,32,91,7,2014-03-31 18:45:13,2014-03-06 22:49:47
33dde1f7288781a3a36951309f963e6040a1a0f5...d9c257732e435cecdcc1ec8452f35e7614e4713f,1,1,1,2,1,2014-03-31 18:45:13,2014-03-07 21:18:42
d9c257732e435cecdcc1ec8452f35e7614e4713f...ff4ac7441ba582c8c339b25b400c6756d9646ff1,2,20,20,40,9,2014-03-31 18:45:13,2014-03-11 20:22:58
ff4ac7441ba582c8c339b25b400c6756d9646ff1...500c8ba4b66c35cf2c29aeb81a9392cc406835a4,1,21,2,23,3,2014-03-31 18:45:13,2014-03-17 21:11:27
1805ef1cccabd3c1beccf88cec98d6a06a1c9188...51d9a04f17d1c8c6c1a069227c1417b20283dda2,2,35,1,36,3,2014-03-31 18:33:14,2014-03-31 18:21:07
f6f059d99af2d4ff7f6049221608b4fe9b82bf6a...a03f83e3370f3859ebff172d504cc29817863b17,1,1,1,2,1,2014-04-01 17:26:53,2014-03-30 05:12:34
a03f83e3370f3859ebff172d504cc29817863b17...cff5f0357ea35245ac906a0326863ac1f8c47c61,2,14,8,22,3,2014-04-01 17:27:05,2014-03-30 05:12:43
cff5f0357ea35245ac906a0326863ac1f8c47c61...7a50f03fa69fb81c27d361333fadbc9cccdd8948,1,2,2,4,2,2014-04-01 17:27:10,2014-03-30 23:00:04
f6f059d99af2d4ff7f6049221608b4fe9b82bf6a...4cb602afa0a905ceb0cccf49fe142c1c7b62087b,2,11,2,13,2,2014-04-01 17:01:07,2014-04-01 02:22:28
f6f059d99af2d4ff7f6049221608b4fe9b82bf6a...739d1244807bc3522a0af4dc3490305d6f037601,2,10,6,16,6,2014-04-01 05:21:52,2014-04-01 05:21:52
f6f059d99af2d4ff7f6049221608b4fe9b82bf6a...e648a186d68dcb3ee0d6123b041c5aa66438cc89,3,31,12,43,17,2014-04-01 01:50:10,2014-04-01 01:50:10
e648a186d68dcb3ee0d6123b041c5aa66438cc89...b8d660d946c5f0be3a4f01867b11f26a4f303293,1,2,4,6,3,2014-04-01 18:17:54,2014-04-01 18:17:54
f6f059d99af2d4ff7f6049221608b4fe9b82bf6a...3f0886c8c3084341e9ef454bf41445cfc22efca2,1,3,3,6,2,2014-04-01 00:56:25,2014-04-01 00:56:25
3f0886c8c3084341e9ef454bf41445cfc22efca2...de9fba71721f71f86d53cf94504b10dcea80a5bd,1,3,1,4,2,2014-04-01 01:31:15,2014-04-01 01:31:15
f6f059d99af2d4ff7f6049221608b4fe9b82bf6a...d52d24dd801f3ffe1b894226b8dba613de59bd87,1,0,27,27,2,2014-04-01 00:28:44,2014-04-01 00:28:44
d52d24dd801f3ffe1b894226b8dba613de59bd87...dcf2b72f5b6732a4b9b1897cb2b3f7019e3d547e,1,25,0,25,1,2014-04-01 21:07:40,2014-04-01 21:07:40
f6f059d99af2d4ff7f6049221608b4fe9b82bf6a...289377b409b321a5a624af3517032c396df6c22f,1,4,4,8,4,2014-03-31 22:34:43,2014-03-31 22:32:57
7a7126faf641aec413add78f5e15e5febb280302...ec3257921da9da0d37df76e26a842f8f4775def0,1,1,0,1,1,2014-03-19 18:01:49,2014-03-16 20:35:01
7a7126faf641aec413add78f5e15e5febb280302...9e69a042c50a3706c847addd68469dfe3eb698a0,1,5,0,5,2,2014-03-16 17:48:46,2014-03-16 17:48:46
7a7126faf641aec413add78f5e15e5febb280302...e32965dbb13973f61ba1c0496c8136cc8c9273a2,1,2,0,2,1,2014-03-16 16:28:44,2014-03-16 16:28:13
7a7126faf641aec413add78f5e15e5febb280302...65051f4215e493928a211c411f775ee1cc7a763f,1,2,2,4,2,2014-03-16 14:36:15,2014-03-16 14:35:13
47470d299da4ade08bad4338c4dba4ceffacdce7...07b60d626acaddffb6a0b118bfc3f19631411d72,1,5,0,5,2,2014-03-31 21:15:03,2014-03-19 18:52:38
47470d299da4ade08bad4338c4dba4ceffacdce7...48cb2f03177732823b4091fd3ddd44b2bef2c58e,2,10,3,13,2,2014-03-19 19:20:30,2014-03-19 17:01:20
47470d299da4ade08bad4338c4dba4ceffacdce7...367a679b9270dd9ec6bd647998b6ffe594cfa6ab,2,12,2,14,4,2014-03-19 18:34:12,2014-03-19 18:34:12
47470d299da4ade08bad4338c4dba4ceffacdce7...5127732c7911988c81eda7bb31ac77fc1dd36ac2,1,11,1,12,3,2014-03-19 18:31:22,2014-03-19 18:30:13
5127732c7911988c81eda7bb31ac77fc1dd36ac2...e93a16ab48f75311aab155548f32776cbd21dfe6,2,21,4,25,3,2014-03-19 18:47:20,2014-03-19 18:47:20
e93a16ab48f75311aab155548f32776cbd21dfe6...78a0105eaf80ed85e2ee236632a2cc16998228f9,1,4,2,6,1,2014-03-19 21:09:12,2014-03-19 21:09:12
fb503da34e2eae1aab3a54eed4c5a2374fa35c7d...4b1513f9c394fbfdf21998db4318251b4e8b6bc0,1,6,4,10,1,2014-03-18 01:52:56,2014-03-18 00:42:16
9bbc11b2aeb0652cf44f0bc583430b37356bef7c...179e2c92d8d02d029d8aa54d53edb82b3fbcea2b,2,84,46,130,15,2014-03-19 23:19:47,2014-03-16 21:10:59
179e2c92d8d02d029d8aa54d53edb82b3fbcea2b...43febdd432eb8e7dc5988c72710b3d78a5913360,2,1,3,4,3,2014-03-19 23:35:58,2014-03-19 23:35:58
9bbc11b2aeb0652cf44f0bc583430b37356bef7c...f3765f96cfb37f6ea9f925f0d3174fe18c4152be,3,5,2,7,3,2014-03-19 23:08:52,2014-03-19 23:08:52
9e1306f78f3d3856126955c1945a32eaf190d705...7822b053cbd2288b6c8d9c51a8f495368bc77f35,1,3,3,6,2,2014-03-19 00:24:06,2014-03-19 00:24:06
9e1306f78f3d3856126955c1945a32eaf190d705...38a3fc3e0e9b56400b2c7d2fce3bfc7b15395d14,1,1,0,1,1,2014-03-19 00:07:45,2014-03-19 00:07:45
5506e4b62dfad9d79fbeed91b9696fb51c736631...64dd77fa0eb73ec4f395848982ccb60bb3bf8fc5,1,2,2,4,2,2014-03-27 23:02:44,2014-03-27 23:02:44
5506e4b62dfad9d79fbeed91b9696fb51c736631...4c4356692580afb3971094e322aea64abe0e2500,26,700,72,772,103,2014-03-26 19:30:40,2014-03-18 20:49:16
5506e4b62dfad9d79fbeed91b9696fb51c736631...e7f3234c1e4926c966f4c9e4cf08d9aae60d21bb,1,5,5,10,5,2014-03-26 16:05:21,2014-03-26 16:05:21
5506e4b62dfad9d79fbeed91b9696fb51c736631...61f7d967ed635098abaf42fc411866bb198b97c5,1,1,1,2,1,2014-03-26 14:24:16,2014-03-26 14:24:16
61f7d967ed635098abaf42fc411866bb198b97c5...72dc19fd7d339321a347dce4ea39d59fd503a4cc,1,1,0,1,1,2014-03-26 14:30:57,2014-03-26 14:30:57
72dc19fd7d339321a347dce4ea39d59fd503a4cc...7d750180e49159ead712843a9cc1c0c58fd5c53c,1,0,1,1,1,2014-03-28 20:15:54,2014-03-28 20:15:54
5506e4b62dfad9d79fbeed91b9696fb51c736631...d36176652ef8f0220a1cff5dc00933400c69a562,2,41,1,42,2,2014-03-25 22:18:19,2014-03-24 17:43:40
d36176652ef8f0220a1cff5dc00933400c69a562...b2721e05ce4d6026855718ad9b01eb7dec797cd2,1,1,1,2,1,2014-03-25 22:18:45,2014-03-25 22:18:45
4585d2da3e62a8c41c212f32cd77b510a2f123b0...bb034c6b42c347ffdfae834960bf2386429e1980,2,96,0,96,2,2014-03-25 01:39:15,2014-03-25 01:38:57
bb034c6b42c347ffdfae834960bf2386429e1980...c84ff187c62060f20b7039a5005a44012898df7b,1,1,1,2,1,2014-03-25 02:29:54,2014-03-25 02:29:54
501d0499f89f3d775d39552141e002ad139222d2...a17d7d9a73a23dc1fb2269b34418f2c7a645598b,1,5,3,8,2,2014-02-05 03:26:49,2014-02-05 03:24:17
501d0499f89f3d775d39552141e002ad139222d2...650200239b1bd5182524b9a0edf7f9981ab053b2,1,1,10,11,2,2014-02-05 01:19:05,2014-02-05 01:19:05
501d0499f89f3d775d39552141e002ad139222d2...d43c85961f3378607ace3e05dbab43ab2481699c,1,1,1,2,1,2014-02-05 00:15:22,2014-02-05 00:15:22
501d0499f89f3d775d39552141e002ad139222d2...cc3a8c8d8ec57e15b7b7316797132d770408ab1a,2,21,1,22,2,2014-02-05 00:08:57,2014-02-05 00:08:57
6f514d28c0270860a6d508113499b90ea60dcc48...cd745d5c6e012ff603f25e1314cfb4c0b09e906c,6,335,79,414,20,2014-12-09 19:56:16,2014-12-05 21:58:46
cd745d5c6e012ff603f25e1314cfb4c0b09e906c...18193ae0a3a1fb506e7855c5e2e02c2c2d4c1a3e,8,131,169,300,36,2014-12-09 19:56:16,2014-11-30 16:39:28
18193ae0a3a1fb506e7855c5e2e02c2c2d4c1a3e...1ebafeb635eead4d3eedf4b5bbaf7e1e2d760086,1,64,20,84,17,2014-12-09 19:56:16,2014-12-05 20:33:11
1ebafeb635eead4d3eedf4b5bbaf7e1e2d760086...566146bc13efb6f8b1e6d4a41382f80546ac1782,1,139,0,139,1,2014-12-09 19:56:16,2014-12-05 21:40:53
566146bc13efb6f8b1e6d4a41382f80546ac1782...1cd89729d59948a4bdc9d6c8a4ab01cedaeb193f,1,54,0,54,1,2014-12-09 19:56:16,2014-12-03 19:04:51
1cd89729d59948a4bdc9d6c8a4ab01cedaeb193f...134f8e6b474d07e12712e0f2d55b901246e6482e,1,75,0,75,1,2014-12-09 19:56:16,2014-11-27 20:14:15
134f8e6b474d07e12712e0f2d55b901246e6482e...e629e255d89759ade9b46fecf413c2ba6765f7dd,1,52,0,52,1,2014-12-09 19:56:16,2014-11-27 20:39:43
e629e255d89759ade9b46fecf413c2ba6765f7dd...aef842e7dfb534aba22c3c911de525ce9ac12b72,2,246,0,246,2,2014-12-09 19:56:16,2014-12-08 20:40:27
aef842e7dfb534aba22c3c911de525ce9ac12b72...62d83404b5f4c9ecdc21e8cab2306a933ce0cdbc,3,56,28,84,15,2014-12-09 19:56:16,2014-12-08 21:14:56
62d83404b5f4c9ecdc21e8cab2306a933ce0cdbc...313a1b7620910e47d888f8b0a6a5eb06ad9c1ff2,2,41,39,80,10,2014-12-09 19:56:16,2014-12-08 21:19:24
313a1b7620910e47d888f8b0a6a5eb06ad9c1ff2...0e9a7bc3cea20db258176b6f923c2b9cd009334f,1,29,0,29,1,2014-12-09 19:56:16,2014-12-08 22:33:46
0e9a7bc3cea20db258176b6f923c2b9cd009334f...acf1720b3f6035f0ab2c9658371ae8302851ffa3,4,15,8,23,7,2014-12-09 19:56:16,2014-11-27 21:55:03
acf1720b3f6035f0ab2c9658371ae8302851ffa3...f2008c535943669a4db89e3b9927a75121effbd5,2,46,0,46,5,2014-12-09 19:56:16,2014-12-06 02:30:03
f2008c535943669a4db89e3b9927a75121effbd5...c8fc8768b672b06bd0cf38d65da8ba03016b85b2,4,27,4,31,6,2014-12-09 19:56:17,2014-12-08 23:04:34
c8fc8768b672b06bd0cf38d65da8ba03016b85b2...0de96a81636e27a6b7cf3a34a62419545d030234,1,98,7,105,5,2014-12-09 19:56:17,2014-12-02 01:57:53
0de96a81636e27a6b7cf3a34a62419545d030234...994e4a1c69c5f48eeba679437fdd7b7ed7ab0fc5,3,51,8,59,5,2014-12-09 21:16:03,2014-11-27 07:00:13
994e4a1c69c5f48eeba679437fdd7b7ed7ab0fc5...ee8504bc5ace8d3352166f1f2dce91b56fd9ad91,1,34,0,34,1,2014-12-10 23:19:10,2014-12-10 23:19:04
ee8504bc5ace8d3352166f1f2dce91b56fd9ad91...496c2748cfef82fea3f5e1be5fbf845b478420aa,3,3,3,6,3,2014-12-11 15:37:17,2014-11-14 05:16:41
496c2748cfef82fea3f5e1be5fbf845b478420aa...d3446258471733fe667f0abdf015ee3ebd2f3485,2,15,1,16,2,2014-12-11 15:37:17,2014-12-01 11:00:44
840ed5ace28381e61b6b34063f9afb71d63fb6a9...e8762bfe39531309327138d93c0b586f8b9cea99,1,1,0,1,1,2014-07-11 00:30:56,2014-07-11 00:30:56
840ed5ace28381e61b6b34063f9afb71d63fb6a9...e855c4b92170534864b920ec1e267b3a815764f9,5,98,2,100,13,2014-07-10 17:35:53,2014-05-31 04:00:47
02ef9437d3b55301ded005806b1649238afdbdad...680e27d6ec7662462594fd5264a00c09bcb14da4,4,1435,4,1439,6,2014-07-10 01:24:01,2014-07-08 18:37:08
680e27d6ec7662462594fd5264a00c09bcb14da4...cdfdbe9bc61b157b0390bce26c4d6e41673ad495,2,16,16,32,12,2014-07-11 22:39:43,2014-07-11 22:39:43
02ef9437d3b55301ded005806b1649238afdbdad...ea583fda97617a349ef026dd2d99a0d5e4b0980d,1,2,2,4,2,2014-07-07 19:45:36,2014-07-06 10:38:30
02ef9437d3b55301ded005806b1649238afdbdad...95870ef3349920efc981a703d52f5832b79ee18e,1,2,2,4,2,2014-07-06 12:47:37,2014-07-06 12:47:37
02ef9437d3b55301ded005806b1649238afdbdad...1d4862b7a2d0c3b0641ce6d539eabecee686c794,3,167,542,709,5,2014-07-06 11:36:34,2014-07-06 11:36:34
02ef9437d3b55301ded005806b1649238afdbdad...29a20672c216e2f8aa90af765ac5c47e3350b3d9,1,5,5,10,3,2014-07-05 20:58:09,2014-07-04 05:40:02
02ef9437d3b55301ded005806b1649238afdbdad...ac392bc0d775455f71da3c71956f9f6ae7a87f6d,1,29,6,35,5,2014-07-05 20:52:23,2014-07-05 20:20:14
ac392bc0d775455f71da3c71956f9f6ae7a87f6d...600f65b24786d15a382877da4c3ae77d88e252bb,1,57,0,57,1,2014-07-07 18:58:27,2014-07-07 18:58:27
02ef9437d3b55301ded005806b1649238afdbdad...cfbe062eb2ba6f1d24ab3b6f9b965a65931d5b07,1,15,0,15,1,2014-07-04 17:52:10,2014-07-04 17:52:10
cfbe062eb2ba6f1d24ab3b6f9b965a65931d5b07...87df57810d39bdd50167338e5ff8d0e6bc6e23e2,1,4,5,9,2,2014-07-05 02:46:41,2014-07-05 02:46:41
87df57810d39bdd50167338e5ff8d0e6bc6e23e2...ebbfdf0a0f99aac67b8ad5d789d8a400be346c30,1,10,6,16,3,2014-07-07 11:01:04,2014-07-07 11:01:04
ebbfdf0a0f99aac67b8ad5d789d8a400be346c30...a247b63aa18a31cc2aeb8e32c06b040a47764d0b,1,1,1,2,1,2014-07-08 09:01:26,2014-07-08 09:01:26
a247b63aa18a31cc2aeb8e32c06b040a47764d0b...e479cae7cf86a2929e0439a61565ed7d9100f445,1,4,4,8,3,2014-07-09 07:21:31,2014-07-09 07:21:31
42a28f79dcbbf7b89069b016496359dc8d2ef62d...6a9c6d3bf12982ca31e0b38cd323073b44c98456,1,7,2,9,2,2014-07-08 01:09:55,2014-07-07 00:28:53
170609e36957fc044723789bc66918bd7d189702...714b63d1be55f468f0cb6b06c88924a941110175,2,26,17,43,13,2014-07-07 23:09:42,2014-07-07 23:09:42
335e82f3f7abfcf783bead6e38b7a3aefe0c768a...4398108433121ce2ac9942e607da20fa1680871a,28,400,363,763,64,2014-07-29 20:09:10,2014-07-29 00:23:38
27c34f3eb93ee58d585f8b792659dc2c0464bd0d...ce9d48e896060d05a78563dce30abfcd5a99c478,5,30,28,58,15,2014-07-09 23:43:39,2014-07-09 23:43:39
751c7e0f003e27d7c862ff91ca85f300bfcbf2cc...e1166861d28121b0e389c913de9d0f4faf8f33d8,1,5,4,9,4,2014-07-09 01:53:08,2014-07-09 01:53:08
781a47e3f37f952630d2bdf4936388aaf52f3707...f9760144109435e12de526251275a9a3e1b7c8fd,1,0,0,0,0,2014-07-15 03:50:12,2014-07-05 06:39:44
de07654c60d74efac10f14ff01039dd757a7dbd8...c2653b0a9ed4b371342fc2019c56d9433197171e,1,2,1,3,1,2014-07-07 16:54:03,2014-07-07 16:50:48
7c4f7780a17db76f29e46a7cdc73538f23c6adda...848e837698922fed0fa67930aa0b56a96b1b832d,3,24,7,31,5,2014-07-12 12:25:05,2014-07-11 18:22:01
7c4f7780a17db76f29e46a7cdc73538f23c6adda...c3d91263a867aa4ac4da6c2cad52f0505a6eccf0,1,32,11,43,8,2014-07-11 18:35:01,2014-07-07 19:35:05
331ae9c0f8a57b34b91b460350d0a354822d0091...10eae16fa70ac04191401bf2872ffa6688f79b82,2,2,2,4,2,2014-06-19 12:44:41,2014-06-19 12:44:41
331ae9c0f8a57b34b91b460350d0a354822d0091...216b4c9cf6cbdc9cd620de4edfbcd754a2184559,2,113,13,126,7,2014-06-18 19:34:46,2014-06-18 19:11:04
77b09a6a19e870164dae4edcbcce43284a79fba4...073382a9c61fb73b8d1915bf53fa6e8c5bd8fbb8,2,4,0,4,2,2014-06-13 22:38:45,2014-06-13 22:38:45
f39e0567b6af773db20ac43f1be418de494679f7...3cff015169f5ca215a42f81650edc9f31095dd6f,1,3,1,4,2,2014-07-19 18:12:27,2014-07-19 18:04:27
cdc62c778f86070d2d62de5055d6288b916136ee...0a3abe33f0bd9b7dfc36021b6f10d0857a432d40,1,0,99,99,3,2014-07-03 21:35:03,2014-07-01 20:51:30
cdc62c778f86070d2d62de5055d6288b916136ee...1dc0caf9c0170ab8e7f5a2f77f2dbdacff322eff,8,316,31,347,19,2014-07-01 19:44:12,2014-06-03 11:09:33
1dc0caf9c0170ab8e7f5a2f77f2dbdacff322eff...e06d533cc20c6aab10bf28a610445e7de6a8ef42,2,4,4,8,3,2014-07-01 21:59:08,2014-07-01 21:33:33
cdc62c778f86070d2d62de5055d6288b916136ee...c21c55e0b6d0f9582e4ee168fbd518b57dacc8fb,2,35,3,38,3,2014-07-01 19:11:18,2014-07-01 19:03:07
07f9d486964f797b46edcbe3c6991e2d0eddc3c1...f565862abcceaf74c2266ba40f34c1b24c6f40c3,3,49,3,52,4,2014-07-17 05:54:26,2014-07-17 05:54:26
07f9d486964f797b46edcbe3c6991e2d0eddc3c1...ff08357c9be7fce37b4be2f08d85e801d07af2f0,1,1,1,2,1,2014-07-17 05:03:32,2014-07-17 05:03:32
ae37f2b88f7d53b783974c28fef9cf9a478ef36c...52db7b8cb7d3408753156e8e33766c049bcc3cfe,1,32,0,32,1,2014-07-31 19:18:31,2014-07-17 19:01:46
ae37f2b88f7d53b783974c28fef9cf9a478ef36c...c92e13f6789ceda5b5fa78c691173e5c0bd840c4,4,9,10,19,6,2014-07-17 23:41:50,2014-07-17 23:41:50
ae37f2b88f7d53b783974c28fef9cf9a478ef36c...81307680142d5ddd8e80c70c5da8afc799318556,1,1,0,1,1,2014-07-17 18:57:16,2014-07-17 18:57:16
c4327f714614b399b2f39c95e31458747b4c0127...962e1186f9a0a43344e19dcf70bac159f0eafb4e,1,1,19,20,2,2014-06-18 17:25:51,2014-06-18 17:23:39
c4327f714614b399b2f39c95e31458747b4c0127...520163a00ee22ddb3d689f7304db2af2784d3bdb,1,1,1,2,1,2014-06-15 18:16:51,2014-06-15 18:16:51
c4327f714614b399b2f39c95e31458747b4c0127...0b97725340504b57b0abfa112746a16ba6a0d631,1,1,1,2,1,2014-06-15 16:26:52,2014-06-15 16:26:52
c4327f714614b399b2f39c95e31458747b4c0127...4adab34dfa9d3e128d022522adfc95c0a47dd8e0,1,49,35,84,32,2014-06-15 16:15:59,2014-06-15 16:15:59
f83c873d8b0d4327e7f8909ba6a096acf2769c17...ed5054389aa7cd0456bfdf1d940d3cdad0313f8f,3,7,2,9,3,2014-06-16 20:40:07,2014-06-16 13:41:09
f0ec9018194e9fddecfde29050aed1169c1fe94c...3303789b4f8dd2a38a908f654f557f4906c2d141,1,3,2,5,2,2014-06-18 19:30:52,2014-06-18 11:08:33
f0ec9018194e9fddecfde29050aed1169c1fe94c...f08cd445b0d2e44a4977a3bd0dca0a1cd4e76d2f,12,27,25,52,27,2014-06-18 17:39:57,2014-06-12 05:15:53
f0ec9018194e9fddecfde29050aed1169c1fe94c...438d26b4052307c29354edc9cd01e35d2e05137a,1,1,1,2,1,2014-06-18 06:01:29,2014-06-18 06:01:29
f0ec9018194e9fddecfde29050aed1169c1fe94c...42fe9327b9bb15354c5a7bdfee25f42e122fd994,1,12,3,15,1,2014-06-18 05:39:30,2014-06-18 05:39:30
f0ec9018194e9fddecfde29050aed1169c1fe94c...6b352d1cfe33cb3f5f64a3c18bb9931e9225adf8,2,41,8,49,5,2014-06-18 02:38:45,2014-06-18 02:38:45
d0fe1147ea6bb98e87a573f078e1572f6061e04b...04bfa8e91f5a934079dd449d1a344bf731917a6b,3,13,5,18,3,2014-06-17 23:19:42,2014-06-17 23:19:42
04bfa8e91f5a934079dd449d1a344bf731917a6b...b132e7b36d30a116fa50eb5035c85cc895cc3d5b,1,2,2,4,2,2014-06-18 23:42:22,2014-06-18 23:42:22
1583e7af416d5c1ff4b99c59f92a953d1ed0ac25...352909dd54e864186d6050f4601d2fb78d889810,1,5,1,6,3,2014-07-16 21:45:08,2014-07-16 18:47:50
352909dd54e864186d6050f4601d2fb78d889810...b0e9d370c28ebe6d783f0008c3c0d513c8c030e8,1,0,3,3,1,2014-07-16 22:22:21,2014-07-16 22:21:55
1583e7af416d5c1ff4b99c59f92a953d1ed0ac25...47917135daa38b40a1a3ee11f31153b031ea7963,3,18,6,24,7,2014-07-16 19:14:26,2014-07-16 19:14:26
47917135daa38b40a1a3ee11f31153b031ea7963...50b580cfecc8e438223250f058fb7b61c7477a59,2,4,4,8,4,2014-07-16 20:40:10,2014-07-16 20:40:10
1583e7af416d5c1ff4b99c59f92a953d1ed0ac25...7c19499c635358719c5a9c9fb1cb66a5fcf12718,2,17,2,19,3,2014-07-16 18:47:55,2014-07-16 18:47:55
65a5dde38b1584a117762698be863b8af1217d5d...de5f3020d92f14e7ff544d92440c5bf9e012d460,1,19,1,20,2,2014-07-09 23:58:15,2014-07-09 15:08:17
de5f3020d92f14e7ff544d92440c5bf9e012d460...e72f8161b91e3cdb8a9bc4369ff5f9673a549e2c,1,17,16,33,3,2014-07-10 00:09:50,2014-07-09 15:38:13
65a5dde38b1584a117762698be863b8af1217d5d...aa0eca03e6662c5f6b4f0f47190a45f49b61e357,5,20,16,36,11,2014-07-09 15:59:06,2014-05-10 16:51:16
aec8d904622e1b0f9e5e5be0d54a3328846eedd7...d715803d45d41bfbbd5faf1f4a8239c08d6d8c90,2,3,3,6,3,2014-07-09 20:47:30,2014-07-09 20:20:01
1ecb170352fc77e1e7ec9cfdf200b1cb163f6a11...2337f529995956546ba0fff2a952df978a40e953,1,1,1,2,1,2014-06-08 18:58:13,2014-06-08 18:58:13
cab7894808d5b43590ec230c2391108536c34108...012091a28f8c2a96ad937f8c84992687e804ab71,1,1,1,2,1,2014-06-27 00:09:41,2014-06-27 00:09:41
cab7894808d5b43590ec230c2391108536c34108...41e75232914df5f5075d5d04cc2891fee9417067,31,1026,166,1192,95,2014-06-26 23:56:39,2014-06-26 22:18:50
41e75232914df5f5075d5d04cc2891fee9417067...c9fdb08bdafb90b76cfa804b079d2e446a3503e4,4,10,10,20,8,2014-06-26 23:56:39,2014-06-26 19:23:53
6f651ec62bdb7b00dc286414c1807a4ae4216058...42734394b0ec238c88bc3ef09454df411b8f3776,1,9,17,26,8,2014-05-17 00:15:04,2014-05-16 23:46:22
6f651ec62bdb7b00dc286414c1807a4ae4216058...46578a2359714e32d61af4efaeea86b7ff770359,1,11,0,11,3,2014-05-16 23:38:28,2014-05-13 18:39:59
46578a2359714e32d61af4efaeea86b7ff770359...1dedcd0d376f57abae5cadd38116c1aca2821330,1,37,0,37,1,2014-05-16 23:38:28,2014-05-10 07:58:45
1dedcd0d376f57abae5cadd38116c1aca2821330...33d5b38d62f48edcadbe239595e242300f3ecd27,1,3,0,3,1,2014-05-16 23:38:29,2014-05-10 08:03:53
33d5b38d62f48edcadbe239595e242300f3ecd27...f5b1afae74a62ba9a4c89f3372dd6e5e5cb89dbf,7,97,0,97,9,2014-05-16 23:38:29,2014-05-13 18:49:12
ccf29f0b94274e7052c24a2fc0e0ffc2263a743b...620c8c72535670e8358cebc65a2fb424be58a93c,3,11,5,16,8,2014-05-19 20:09:39,2014-05-19 19:07:31
b7f9e683c3edd5c48062d00cfe3ea279e8037106...b1464b2daa58057bc0aaa59adc9d5ae3b0671654,1,2,0,2,2,2014-05-21 22:48:31,2014-05-21 22:48:31
b7f9e683c3edd5c48062d00cfe3ea279e8037106...df5585b273686324e9fd8269a6492409698623ee,9,207,35,242,32,2014-05-21 22:31:04,2014-05-21 22:30:10
b7f9e683c3edd5c48062d00cfe3ea279e8037106...26b4a4920adca614f6be17a96f254f331271faf0,1,1,1,2,1,2014-05-21 21:37:40,2014-05-21 21:11:57
8006f6583d38dbb87e9d525089c0e4d2f933f918...4a33a757d540acd059ac957542527d641548e2cf,15,72,78,150,48,2014-05-22 20:53:36,2014-05-22 20:50:51
29a192ca4d7b1d42c805241ecc4106f2ebf3e887...811d93326bc2d9451eb444e2343bb3063611de7a,7,118,49,167,28,2014-05-21 21:14:07,2014-05-21 20:48:06
29a192ca4d7b1d42c805241ecc4106f2ebf3e887...56a53c72d285b3f9fa6b34dcb81c9720a1974bde,6,22,6,28,6,2014-05-21 18:35:08,2014-05-20 20:39:46
56a53c72d285b3f9fa6b34dcb81c9720a1974bde...bb431a719008ae183179d9d71090bd1224d61480,3,19,5,24,3,2014-05-21 18:35:12,2014-05-21 18:29:11
5877ae24624ccca38b5d54a187db6951cce10d78...70ef53f25e177e42046170ef59bb29ebd77a3016,1,31,0,31,2,2014-05-12 07:57:15,2014-05-08 17:58:33
70ef53f25e177e42046170ef59bb29ebd77a3016...cc678a7078b417a330e8d4e3604b74f9e5d4cda4,1,1,1,2,1,2014-05-12 19:24:30,2014-05-12 19:24:30
5877ae24624ccca38b5d54a187db6951cce10d78...1dec8fd03c4f9c99491d3019f56772cccaf100fd,1,1,1,2,1,2014-05-12 01:31:44,2014-05-12 01:31:44
5877ae24624ccca38b5d54a187db6951cce10d78...0d59cc080a8dc115bdb727d376e3965e58109718,3,12,9,21,4,2014-05-12 00:31:27,2014-05-12 00:31:27
5877ae24624ccca38b5d54a187db6951cce10d78...7cc27b2075d6293ab2f54a7255fcb1b1e062fd91,2,36,0,36,3,2014-05-11 20:33:01,2014-05-10 17:27:24
9e58a77e2613ffc3b070f0621c7b4a305c82e0c4...e70a5ab0149562609d3a16105aada365ed940cb5,1,1,1,2,1,2014-05-30 19:08:21,2014-05-30 19:08:21
9e58a77e2613ffc3b070f0621c7b4a305c82e0c4...0fd0deb75d6e38973f154c5b41c7d4e22a9c4fef,1,12,12,24,7,2014-05-30 18:20:27,2014-05-30 18:03:56
808d28033b981188a3856098e9e3d6b96a9b9a53...2e0d47e5c4c63323623c38cf0ca8d63efab8b493,1,15,5,20,5,2014-05-16 19:06:34,2014-05-16 18:31:43
e5422e212f7929207b5df891b3358995755b0e80...0abad3ae2290a2b051b8fdaceab17a1ee41ecfb9,1,5,4,9,3,2014-05-19 16:52:39,2014-05-19 16:45:52
e5422e212f7929207b5df891b3358995755b0e80...702442b58696b1a77d9274c92000f6e0c0c983bb,1,1,0,1,1,2014-05-19 14:07:57,2014-05-19 14:07:57
9405a58e99636f7d21e1442b90d3b4a9fdcac5bb...0056884090726f736af2594b09aaa44e373a84d1,6,466,852,1318,100,2014-05-21 21:11:43,2014-05-18 16:52:41
9405a58e99636f7d21e1442b90d3b4a9fdcac5bb...6854e2997ee2b17a2078c4411c6e2f8d001983f5,1,3,0,3,1,2014-05-20 09:04:46,2014-05-17 18:06:29
9405a58e99636f7d21e1442b90d3b4a9fdcac5bb...7cd1e482309e944522d3506f8e15eeb3ab7fb796,3,6,4,10,6,2014-05-19 04:26:05,2014-05-18 11:17:31
9405a58e99636f7d21e1442b90d3b4a9fdcac5bb...88afc8992f2ebd2fd95d87dfff720ff946183975,3,80,1,81,4,2014-05-18 22:55:36,2014-05-17 20:28:39
88afc8992f2ebd2fd95d87dfff720ff946183975...f8974b5cfc87f7775019e3df2d09ad68f2119772,1,13,16,29,3,2014-05-18 22:55:58,2014-05-18 22:55:58
9405a58e99636f7d21e1442b90d3b4a9fdcac5bb...21e36ab36cd0beb192ce95469639f659b4877641,1,1,1,2,1,2014-05-18 05:04:41,2014-05-18 05:04:41
9405a58e99636f7d21e1442b90d3b4a9fdcac5bb...82712ed67ef9c189ccc8837ef8469272c91f6fcf,2,2,2,4,4,2014-05-18 00:49:58,2014-05-18 00:49:58
82712ed67ef9c189ccc8837ef8469272c91f6fcf...3cec63d56f9de6332aa3f33502695283d4feb054,3,0,25,25,3,2014-05-18 01:22:22,2014-05-18 01:00:53
9405a58e99636f7d21e1442b90d3b4a9fdcac5bb...a52db7d8802f3cfd8a88e1bcf0a25f59458f7558,1,2,2,4,1,2014-05-17 20:18:08,2014-05-17 20:18:08
9405a58e99636f7d21e1442b90d3b4a9fdcac5bb...f9728de7a3a5bca5db800edf17d8bc3b39358b77,1,4,0,4,1,2014-05-17 18:12:44,2014-05-17 18:12:44
9405a58e99636f7d21e1442b90d3b4a9fdcac5bb...8dfd4b677b60bc2b5de0214bb3cef1a04da12bed,1,3,0,3,1,2014-05-17 18:01:47,2014-05-17 18:01:47
9405a58e99636f7d21e1442b90d3b4a9fdcac5bb...b175b4dd434f6b16c0966d9c62be3d63cc8238bd,1,10,0,10,1,2014-05-17 17:56:02,2014-05-17 17:56:02
9405a58e99636f7d21e1442b90d3b4a9fdcac5bb...28fc387cf0c933128d0adad6d633c8f4a719d8ee,1,3,0,3,1,2014-05-17 17:48:07,2014-05-17 17:48:07
9405a58e99636f7d21e1442b90d3b4a9fdcac5bb...3e2b97ef26467228f6018e19f517ed535e107026,1,5,0,5,1,2014-05-17 17:37:05,2014-05-17 17:37:05
9405a58e99636f7d21e1442b90d3b4a9fdcac5bb...58c11ee0a8be74562b0e6f88ee000afdf9ddf025,2,61,60,121,2,2014-05-17 14:25:56,2014-05-17 14:25:56
1f5b3232082d80a32b52ffa3618e36eb70a8bb98...91757eaeb3523679b30afee61c1dede33c8664c9,3,73,70,143,37,2014-06-04 22:37:49,2014-06-04 22:11:11
1f5b3232082d80a32b52ffa3618e36eb70a8bb98...b054569cde788b2111ddbc4080b215dcda89f06e,10,248,0,248,19,2014-06-04 19:33:44,2014-05-21 21:06:18
b054569cde788b2111ddbc4080b215dcda89f06e...26246ebd5379a83b2ed656668bd985c652e98167,5,30,51,81,19,2014-06-04 19:33:44,2014-06-03 15:44:21
d103f0186a041749bbddc19439f852acdb0b7a1e...7da186c3e58c83605f0389d1214909b1cbbead39,1,1,0,1,1,2014-05-05 17:29:20,2014-05-05 17:29:20
d103f0186a041749bbddc19439f852acdb0b7a1e...a60159f3b102244fc5470642bd32eb99d5ac329c,5,84,29,113,16,2014-05-05 17:08:59,2014-04-30 22:46:56
a60159f3b102244fc5470642bd32eb99d5ac329c...7118416aeeb779373685d192c26a329e9acdef89,2,41,9,50,6,2014-05-05 17:08:59,2014-05-02 08:47:12
7118416aeeb779373685d192c26a329e9acdef89...2c2cc051d831f54d1bb070642edcd876ff669e78,4,54,53,107,20,2014-05-05 17:08:59,2014-05-02 21:06:05
2c2cc051d831f54d1bb070642edcd876ff669e78...a785882b29b9f0b24ace8249576c5d8d7f8c1d94,6,20,10,30,10,2014-05-05 17:08:59,2014-05-02 21:17:31
a785882b29b9f0b24ace8249576c5d8d7f8c1d94...5ca6532011436eee85ccb555a0832a82450454ea,2,37,36,73,10,2014-05-05 17:08:59,2014-05-02 21:45:39
5ca6532011436eee85ccb555a0832a82450454ea...c1c6b3ccd915084bc9472992afa16f677a074785,1,44,2,46,2,2014-05-05 17:08:59,2014-05-02 22:32:26
c1c6b3ccd915084bc9472992afa16f677a074785...0b187b909be1dac60194250bc6e9ff292a0bd5c9,3,56,18,74,18,2014-05-05 17:08:59,2014-05-02 23:59:28
e88ef454b7a8705570623e6d26f51731b8300e0f...986c647d5ac9bda0633cdeb927bb782d8df02269,1,6,2,8,1,2014-04-30 19:36:16,2014-04-29 00:04:56
56d71ae79bbbdd0d1eb97408c6132687a33ec113...c34bb099e51300f4355f949cc514bab8370c82c1,1,90,75,165,41,2014-05-05 15:02:03,2014-05-05 14:42:23
e9fd8e285e20ec3523a67fd635a263e66a6119db...10766e1fb46770a407b2b17ade313dd5ae85054e,1,1,1,2,1,2014-05-05 14:28:52,2014-05-05 14:28:52
222605b5fb9b9985a546807534777fbd2fc49c3b...02f95a089cd4f9ff7d8e5ba9c7780607dac78d14,1,14,0,14,1,2014-05-06 08:53:19,2014-05-06 08:53:19
222605b5fb9b9985a546807534777fbd2fc49c3b...a1a029f6d7f980960135c1346a1e9f7830692fac,4,114,19,133,9,2014-05-05 22:43:38,2014-05-05 22:05:14
a1a029f6d7f980960135c1346a1e9f7830692fac...3744452ecf46351758478e99795e20b186a1bee4,7,237,180,417,19,2014-05-05 22:55:32,2014-05-05 22:51:32
222605b5fb9b9985a546807534777fbd2fc49c3b...4994b0fe5459996691dde18155a7b712762e8e53,3,20,44,64,11,2014-05-05 21:45:14,2014-05-05 21:45:14
4d521f479b4596ffa4719c1d15eb7b3f990fa2d1...e318af6fb097ce5157b6766d8dfe921403858756,1,2,2,4,2,2014-05-02 21:58:05,2014-05-02 20:59:43
4d521f479b4596ffa4719c1d15eb7b3f990fa2d1...8913ec4912e529be44b7cc2aaf465b0d9b03ffc9,1,0,25,25,1,2014-05-02 21:16:05,2014-05-02 21:15:54
4d521f479b4596ffa4719c1d15eb7b3f990fa2d1...4706a1ad76ed9bc6c0555499d0bd8b8eea3b3604,1,1,1,2,1,2014-05-02 21:13:28,2014-05-02 21:13:28
4d521f479b4596ffa4719c1d15eb7b3f990fa2d1...12a4b376fd42931d959cd925983243e94c981de4,1,1,1,2,1,2014-05-02 20:56:35,2014-05-02 20:56:35
4d521f479b4596ffa4719c1d15eb7b3f990fa2d1...a7ccbfd5f143af8a7accc69803b1588e568328ac,1,1,1,2,1,2014-05-02 20:55:45,2014-05-02 20:55:45
103d02813238c2bb8c91625401427716f5bf988f...de75af9fe2d91df7297e498d320b496addfb52f4,1,5,6,11,2,2014-05-02 22:25:32,2014-05-01 23:10:20
de75af9fe2d91df7297e498d320b496addfb52f4...3b73c26194836c1e2b737146a5b0c840226c65d2,2,18,1,19,2,2014-05-02 22:25:33,2014-05-02 01:39:46
34e09afa24503e03d74f93f110ce752c38f39071...b25208ee3e4d652d8b1f86ffac343b718118b745,1,1,1,2,1,2014-05-05 19:43:11,2014-05-05 19:43:11
34e09afa24503e03d74f93f110ce752c38f39071...db5f6b4aa0b34adbc9ba189a042e77e7bcdee681,13,171,264,435,43,2014-05-05 19:34:21,2014-05-05 19:34:21
0b15944cb047e6467f399ebf5c3f93262fe4c06f...543e60eb60fed2734c10953216003325beddd536,1,15,3,18,5,2014-05-06 16:56:39,2014-05-05 23:56:53
0b15944cb047e6467f399ebf5c3f93262fe4c06f...69d43b2674aa8ed69c641556cae68d405505a45b,1,1,5,6,1,2014-05-06 15:53:38,2014-05-06 15:53:38
fef1e0a7089820b06fdc2de3d536fe0e5e41f0cb...eb1e8e884d92a7086af96663d0c658d838315490,1,9,0,9,1,2014-06-30 19:22:29,2014-06-30 19:22:29
eb1e8e884d92a7086af96663d0c658d838315490...63e28cc363c5f13288335e811f075e2423375b05,1,1,1,2,1,2014-06-30 19:25:50,2014-06-30 19:25:50
63e28cc363c5f13288335e811f075e2423375b05...dad476803719ae2e86c703981caef0462e25260c,2,19,15,34,5,2014-07-02 15:45:11,2014-06-30 19:42:09
67f6b0fd43a7f4c5c1b07373f73568c0444145a5...d14cfc8d435dbef0d70b6444b275a025e60ac171,1,9,15,24,4,2014-06-27 01:46:59,2014-05-16 23:40:27
5cabfd1526f51c67836c4b4910518e4389fb23ac...748aaf3530b943449d61952e06eb9aeab4a455ac,2,3,8,11,3,2014-06-27 01:43:29,2014-06-26 10:49:29
ade6bd77853a7fd2cabfef1f307823dff284d4b1...5a3d774e5651da772a065282a1fb1a31e19e911c,2,12,6,18,8,2014-06-27 21:03:51,2014-06-27 18:53:35
3a50675a688bbe022f1870c38aadb5352e7869e6...a0b229071394e6534808f16c4570ed8fd9ff3a1c,1,4,9,13,3,2014-06-27 23:09:41,2014-06-27 20:22:18
3a50675a688bbe022f1870c38aadb5352e7869e6...0acec443745a917fb8e97d50609ff01b03888512,1,2,2,4,2,2014-06-27 19:45:55,2014-06-27 19:45:55
bc8d618cde2adb6286d0c88ea1f402e62e6fecd4...0bfa14a70aa7dda06d769c5dd55354b13b417c94,1,1,1,2,1,2014-06-27 06:34:47,2014-06-27 06:34:47
425ab3da5e07ff7fd205e7d46e385d4bef281488...15ea1ca1f0d5190645b2ec0c0971daa3cdee30df,1,2,2,4,1,2014-06-27 02:39:58,2014-06-27 02:39:58
687653e59980e35e07521aff7a5cd87b4b0d3be6...a6fd2c237ecca330554ec8bdaf7b2acfe68de1ce,1,2,2,4,1,2014-04-23 04:35:59,2014-04-23 04:35:59
83b388c979b3d24c6e9f1604eaa46f5f1ce10ecb...264dc8a46bb7f7679439d0a2c41c79a09642acab,2,12,0,12,2,2014-04-24 14:43:02,2014-04-24 14:43:02
83b388c979b3d24c6e9f1604eaa46f5f1ce10ecb...c932667cd26f00bb64ddf0c1a7c7de3ac95aa4be,87,4424,4207,8631,1864,2014-04-24 12:19:32,2014-04-23 20:48:28
c932667cd26f00bb64ddf0c1a7c7de3ac95aa4be...ada86fc5b736d8b3209429c584384fd9974a148a,42,95,94,189,86,2014-04-24 12:20:04,2014-04-24 12:12:21
83b388c979b3d24c6e9f1604eaa46f5f1ce10ecb...d9f9021e9b8bc46481b4c2bb28786fd3f0b88b9c,1,3,0,3,1,2014-04-24 10:33:00,2014-04-24 00:31:02
baf6cf90561a1582683c92dd209e36f78a39288e...9422451ac3f541a17daba0d5f6dc8b40a6edc9e9,1,7,0,7,1,2014-04-26 00:23:16,2014-04-22 23:51:06
9422451ac3f541a17daba0d5f6dc8b40a6edc9e9...68d3e757503fab422fc96a00d511336a3fdfd619,1,12,3,15,3,2014-04-26 00:23:16,2014-04-24 07:36:21
68d3e757503fab422fc96a00d511336a3fdfd619...3c1d5ca33ecbd644d4e8d864ff59b389f4a4a555,2,112,0,112,2,2014-04-26 00:23:47,2014-04-24 07:46:32
3c1d5ca33ecbd644d4e8d864ff59b389f4a4a555...b63b98ee2766321e2ca6f3b159c2bfb303870105,1,11,0,11,2,2014-04-26 00:23:47,2014-04-25 23:47:03
b63b98ee2766321e2ca6f3b159c2bfb303870105...7e3624a498b8b96a4e8a0f1d59fc2c50bf48efb3,1,43,0,43,1,2014-04-26 00:23:47,2014-04-25 23:48:16
f436c744da8b3ab4da94d385e16eeb672b31dcd7...73d9ede12c9328c44e38699dbe3a04479d3926e6,3,30,89,119,24,2014-04-23 11:50:53,2014-04-23 11:50:53
69c69059fc3933531e19c05a9d2e831fb713881c...2275c83358986c9f612ebb1915c5d3392319f1f8,1,1,1,2,1,2014-03-04 00:45:26,2014-03-03 07:35:40
69c69059fc3933531e19c05a9d2e831fb713881c...4f29836f7158521f31e42ea6dfde6c19cd069715,1,4,1,5,1,2014-03-04 00:40:36,2014-03-04 00:32:39
cb4189a292dc181e26e0506a3a0dc67936c5401b...37f137c8221be07943babeb9b107e5aee9a736d5,2,9,26,35,11,2014-03-05 21:50:49,2014-03-05 20:27:31
c05e095baaa2de865e2e8712cbb7a37654bd41aa...c987901f8d64ab2390409018074b2f93c1718e89,1,1,0,1,1,2014-03-05 20:26:48,2014-03-05 20:26:48
e7055830ab37998fbed61cc4e1aaab2387227b89...28a545d294cac3b2e1f4266f5099bd2c5ddb342f,3,120,0,120,3,2014-03-05 03:12:25,2014-02-14 06:56:21
28a545d294cac3b2e1f4266f5099bd2c5ddb342f...cadd94f44c6f6e276a5b028a2935b5e352408d3b,1,12,12,24,4,2014-03-05 03:12:29,2014-02-18 02:55:14
cadd94f44c6f6e276a5b028a2935b5e352408d3b...8bf63d532622e22070b92ee71dcb972ace4b9b40,2,9,11,20,9,2014-03-12 12:02:24,2014-03-12 12:02:24
e7055830ab37998fbed61cc4e1aaab2387227b89...83de8bb842b97094651207202a5474b8fec5259f,1,1,1,2,1,2014-03-05 02:41:14,2014-02-28 21:56:22
e7055830ab37998fbed61cc4e1aaab2387227b89...9cbf22dee26e363bbe3738bbbcd1d70773d80d0d,1,12,12,24,12,2014-03-05 01:52:48,2014-03-05 01:52:48
e7055830ab37998fbed61cc4e1aaab2387227b89...41bf38e44d8ef53468e76870182fa05c515a1cf5,1,8,8,16,4,2014-03-05 01:22:51,2014-03-05 01:22:51
41bf38e44d8ef53468e76870182fa05c515a1cf5...725c7cd08af5b895becce19e59fe98cebdc67cf2,1,8,8,16,4,2014-03-05 01:45:22,2014-03-05 01:45:22
e7055830ab37998fbed61cc4e1aaab2387227b89...3acbd758d84294e3434609ae3ecf52cd5ed9ee4b,1,11,9,20,5,2014-03-05 00:57:08,2014-03-03 21:39:10
a5c6e08bd61948e973da1d6ffd7b8f55ad44bd22...d04f4d836c6b2a9266350a1b0e284949dcc6510a,1,1,0,1,1,2014-03-08 16:41:50,2014-03-08 15:36:18
2678af4ea8576816c5635f9c8e0d927f8faf4de1...ab0c9b385c47d818a2105c2114573f5beedbd3ba,1,0,5,5,1,2014-03-20 20:59:40,2014-03-20 20:59:40
51a39563fa31ddde9742b9e8a9b847b7c0307c73...d1297feef8b124e69efc99a58294f498ecb8c022,10,386,38,424,31,2014-05-01 16:40:36,2014-04-02 19:26:06
51a39563fa31ddde9742b9e8a9b847b7c0307c73...f87a97f7df838742a602f1984f4552b803e3f92d,45,308,310,618,248,2014-05-01 14:52:01,2014-05-01 14:13:34
b204b97c9adbaddd5b8cef3dc53cbee2a392b936...456ba11d89b52f946d293489b52508a2e270f1a7,1,24,31,55,10,2014-05-29 01:36:28,2014-05-27 22:51:05
b204b97c9adbaddd5b8cef3dc53cbee2a392b936...a0505edc9a890b3d4cdf5cf1850273c250c3dc41,14,18,18,36,18,2014-05-29 01:20:41,2014-05-08 13:11:17
b204b97c9adbaddd5b8cef3dc53cbee2a392b936...5d04b9deafc5ce173364a24881f8e950c9430be0,1,17,10,27,6,2014-05-29 01:10:50,2014-05-29 01:09:05
be882d989a4d1d23f05916a525cf7f8e5cf3da4b...bd94f84ded944ab69c18cf9d23c35deee3b15963,2,24,1,25,3,2014-04-03 17:33:20,2014-04-03 14:27:07
be882d989a4d1d23f05916a525cf7f8e5cf3da4b...cea43f8a2da49dc9de35979829ff1876d48aea2c,1,7,0,7,1,2014-04-03 14:54:54,2014-04-03 14:54:54
6e7a93628b924d176a9caa1164db7a1526dbe573...94233a204f82f857536c16f36f94d3a8ff0069dd,3,17,28,45,10,2014-04-02 16:52:49,2014-04-02 16:52:49
9687c087ab09feb106b040628423e70b320a51e2...3b3f4bf052e442543ec5772875ce7fbc77924596,1,10,5,15,1,2014-04-02 12:56:11,2014-04-02 12:56:11
3b3f4bf052e442543ec5772875ce7fbc77924596...cd910cb6858541b432e20b650fad262772c9ef18,1,22,8,30,2,2014-04-03 17:07:42,2014-04-03 01:00:13
b45c1061bf447358826f4551ebff79af25444139...f7ae3a1381fdc53042bebec085bb3f108bc05da3,1,4,0,4,1,2014-03-31 19:07:23,2014-03-31 18:48:30
7ab66fa694c4be384588cfc2e6c975d325977024...4bf70317ed3c2467f444eac9b7865b170da6366c,1,2,6,8,1,2014-04-01 19:33:46,2014-04-01 19:33:46
7462cc6479c3a5c2f572bf9fe2bfc60a4f1e2506...026aebdebbaa05eab25134949ed5d5bda655ba67,1,26,2,28,9,2014-04-01 21:17:31,2014-04-01 21:17:31
7462cc6479c3a5c2f572bf9fe2bfc60a4f1e2506...6b7cfc9e95af8510abc801a02cda7879e4f82518,1,13,0,13,1,2014-04-01 07:27:34,2014-04-01 07:27:34
8cc8b1dd9989ede140c59ed40582c93552a5cd87...9c0c4aeda47fcebc4470f7ba786749af2999ec78,1,102,0,102,1,2014-04-01 23:42:54,2014-04-01 23:42:54
93bb20816418f68d8a47f8252e664856f7b554b1...aec989bd0801657efeeb81bafb2c6c61f60de6d4,1,75,36,111,16,2014-04-02 08:44:12,2014-04-02 08:44:12
aec989bd0801657efeeb81bafb2c6c61f60de6d4...9712f8127a9ac47a3679e20faea08fb971ee1ecc,1,7,2,9,2,2014-04-03 17:46:24,2014-04-03 17:46:24
9712f8127a9ac47a3679e20faea08fb971ee1ecc...fee16d42163822bb23a51c5ebcb1115efc761947,1,1,1,2,1,2014-04-03 17:52:19,2014-04-03 17:52:19
93bb20816418f68d8a47f8252e664856f7b554b1...e5394e35c7a8f730ac76d24dee74d769049a0428,1,6,10,16,5,2014-04-02 07:05:00,2014-04-01 08:21:53
e5394e35c7a8f730ac76d24dee74d769049a0428...8e39b35c7cd02bbb644b7faf2a434de0098e6dea,1,3,8,11,3,2014-04-02 07:05:00,2014-04-01 08:24:26
8e39b35c7cd02bbb644b7faf2a434de0098e6dea...5955846774c9b43291d6de0584fa8c3f62414c43,1,14,19,33,9,2014-04-02 07:05:00,2014-04-01 08:31:34
5955846774c9b43291d6de0584fa8c3f62414c43...74edcaf1e84aa8bf35e496b2bead833172a79fca,1,2,7,9,2,2014-04-02 07:05:00,2014-04-01 08:34:44
74edcaf1e84aa8bf35e496b2bead833172a79fca...e01b71cebeb96755641a18762dea5b843f107bee,1,32,23,55,13,2014-04-02 07:05:00,2014-04-01 08:45:40
e01b71cebeb96755641a18762dea5b843f107bee...70826e8b3fee27b971852aad89053507c6866d3e,1,26,1,27,16,2014-04-02 07:05:00,2014-04-01 09:05:30
70826e8b3fee27b971852aad89053507c6866d3e...2ffef1b7eb618162673c6ffabccb9ca57c7dfce3,1,35,23,58,20,2014-04-02 07:05:00,2014-04-01 09:28:21
93bb20816418f68d8a47f8252e664856f7b554b1...2b64453adbfdf715542b0b4274ed13e6f2a444da,2,7,0,7,3,2014-04-02 06:52:07,2014-04-02 06:52:07
93bb20816418f68d8a47f8252e664856f7b554b1...b51fe1783347c1bf679870925a271531a925b7e9,1,11,8,19,6,2014-04-02 04:43:38,2014-04-02 04:43:38
5b9c8607d90c20282eb65b75112f09634bcba277...66c5e19f9bd057644fab475499ea45bb428ba2b2,1,4,0,4,1,2014-03-28 14:58:14,2014-03-28 14:58:14
2ea3fa9af5884cbf024f381e2a089c4e32b8494d...782eb5f03a9dde970172895da37be8c656fef3bd,2,28,0,28,2,2014-03-17 22:19:47,2014-03-17 22:11:46
782eb5f03a9dde970172895da37be8c656fef3bd...8b159fca8a4bc8692c77db3536f7098a583270ad,1,2,4,6,2,2014-03-17 22:39:35,2014-03-17 22:39:02
2ea3fa9af5884cbf024f381e2a089c4e32b8494d...25218f9b239784e6f38550a6e320bce56aaca3e1,2,8,24,32,8,2014-03-17 22:12:02,2014-03-17 08:40:36
2ea3fa9af5884cbf024f381e2a089c4e32b8494d...128381e0f0372f10f88a847087aa91a972770c4b,5,21,21,42,8,2014-03-17 18:07:12,2014-03-17 17:16:34
128381e0f0372f10f88a847087aa91a972770c4b...ad7e7d612390d09d3a54fd82dda9687deb3b0cbe,1,1,1,2,1,2014-03-17 18:07:29,2014-03-17 18:07:29
2ea3fa9af5884cbf024f381e2a089c4e32b8494d...681d1d2f61b7c76da6612a5d24d41d5bd98e4df5,1,32,0,32,2,2014-03-17 14:36:46,2014-03-17 14:36:46
5294bf7e67a67b2f0643c61fb126814d82a1979d...8e434c314ef74618001cc95466c2b567fa0283e2,2,2,2,4,2,2014-03-25 10:26:45,2014-03-25 10:26:45
5294bf7e67a67b2f0643c61fb126814d82a1979d...293157b8b38dd5ea5fa49d90501cc3c86717da40,2,46,14,60,5,2014-03-25 09:47:08,2014-03-23 15:55:20
5294bf7e67a67b2f0643c61fb126814d82a1979d...69087f2d2397b18d6dd2d7b994e24ea9814e4bcd,1,2,0,2,1,2014-03-25 09:42:59,2014-03-22 14:12:15
5294bf7e67a67b2f0643c61fb126814d82a1979d...c7540b3e94d7712b6b91ba80de0155f20156f3f3,1,4,0,4,1,2014-03-24 18:31:32,2014-03-24 18:31:05
5294bf7e67a67b2f0643c61fb126814d82a1979d...f41135bc11b9a4da896e5054a73afa112b2e835f,27,0,1148,1148,27,2014-03-24 12:39:56,2014-03-24 12:39:56
5294bf7e67a67b2f0643c61fb126814d82a1979d...f1bd79ec97c125148c690d66ebd3ac5ab3f388b2,1,3,2,5,2,2014-03-24 12:03:41,2014-03-24 12:03:41
f1bd79ec97c125148c690d66ebd3ac5ab3f388b2...d503714285143013d9fa6932ee5775fd155d26d2,4,18,10,28,9,2014-03-24 12:03:56,2014-03-24 12:03:56
6b5ba1b06621ead46deb0e1ef52608e5e4724690...4434dcee89f7d0d0239f6b492b24e940cdbafb21,1,2,3,5,2,2014-03-19 21:23:45,2014-03-19 21:23:45
902f88ea156179d2d8095b34556738258792ca45...ea2fba5ce04d3eb2a8959b8f5116604faae1e88a,2,11,11,22,7,2014-04-07 21:41:25,2014-02-15 22:11:15
902f88ea156179d2d8095b34556738258792ca45...30f22ee9e3ea1012ca663a0383c8c9c2330c52cc,4,49,59,108,5,2014-04-07 20:34:21,2014-04-04 00:57:41
43febdd432eb8e7dc5988c72710b3d78a5913360...62eb23aed50c9c820836c4b3f515cba2660b5c20,1,3,3,6,2,2014-03-20 00:18:08,2014-03-20 00:18:08
3b5b2f8953387077e4dabe53936bc5867e145ea0...67af7b3fb0b5e40a435b434c57291cb2989275ce,2,29,6,35,5,2014-03-27 02:41:08,2014-03-19 00:50:40
1bedae9107108156d6d272494f1ff27d8b4be590...be5538d8a8820ac1192c7a5660e0d950927b42d0,3,35,17,52,12,2014-03-21 00:48:17,2014-03-21 00:48:17
be5538d8a8820ac1192c7a5660e0d950927b42d0...7c726669cbcc0cfde12c6a9f03974bb672839271,8,207,130,337,13,2014-03-21 08:10:07,2014-03-21 08:10:07
7c726669cbcc0cfde12c6a9f03974bb672839271...c9d7f858fd1c6e2d1287e28ee12952333b327c75,5,38,10,48,12,2014-03-21 11:53:15,2014-03-21 11:53:15
c9d7f858fd1c6e2d1287e28ee12952333b327c75...146a212f71fe129f9d349c5c3e80ba4197e35850,6,87,124,211,11,2014-03-21 12:38:50,2014-03-21 12:38:50
146a212f71fe129f9d349c5c3e80ba4197e35850...83618c2b81c561cd77fd70eca90b2b251f61fcc1,1,74,6,80,3,2014-03-21 14:07:16,2014-03-21 14:07:16
83618c2b81c561cd77fd70eca90b2b251f61fcc1...2c58a1e2886433a4266615b1f492f829e7a6f53f,1,6,5,11,2,2014-03-21 14:17:17,2014-03-21 14:17:17
2c58a1e2886433a4266615b1f492f829e7a6f53f...9a7be1b015a1ba79e5480d0ddddfa5954b994507,2,57,10,67,12,2014-03-24 05:33:11,2014-03-21 14:53:47
9a7be1b015a1ba79e5480d0ddddfa5954b994507...10fdbc0467d1be6c7c731d3f35590d87ee42f96f,8,265,47,312,23,2014-03-24 07:16:40,2014-03-24 07:16:40
79e8ef28e43817e14d3df0779711fc4ca00b36d1...73ee4879afd557a3ddd0740b0a281024060f2436,1,1,1,2,1,2014-03-27 17:44:33,2014-03-27 17:44:33
ab00619c56738c0704374c68fb43f4dd90b8887e...ad3e71d5c7e01dca229d4077cf8b019d8085c33a,1,1,1,2,1,2014-03-27 17:06:32,2014-03-27 17:06:32
ab00619c56738c0704374c68fb43f4dd90b8887e...0fb01fd8fe376a3518b1050ab62f2b3370d62535,2,27,0,27,3,2014-03-27 02:07:35,2014-03-26 13:55:45
ab00619c56738c0704374c68fb43f4dd90b8887e...baba9cde9542b480162d11bd30ca3a522fa6b4d0,1,6,0,6,1,2014-03-26 11:51:27,2014-03-26 11:51:27
94538fe022b8f905e2cc6a132242375f7f120fb5...4af79a36e283e94cb48442499534f996e27e0f29,2,12,0,12,2,2014-03-27 20:44:30,2014-03-12 07:58:53
94538fe022b8f905e2cc6a132242375f7f120fb5...9d2a77805139598b272ca6e5f55e3542e1221f26,1,18,14,32,14,2014-03-27 19:45:47,2014-03-27 19:13:27
058cc8818a44fab83f5274397de223f36e6910db...36dfa0c4ec90404f76a6ec73c89d199e279ee96c,1,1,1,2,1,2014-03-28 22:02:17,2014-03-28 22:02:17
880dc34c0e353c5749c87666f27f2e4794dd3270...3841e8862596637b904acf7f64b657bf3c9b49b1,1,1,1,2,1,2014-02-05 20:46:41,2014-02-05 19:04:19
cc3a8c8d8ec57e15b7b7316797132d770408ab1a...55e5e37c4f085c0216a3d99dc7e3c3f12c2c7a88,1,1,1,2,1,2014-02-06 02:09:55,2014-02-06 02:09:55
40a6461d16f9fc4111e9c9a844447d0a7170ce41...b8b9930a8ab95cfe32731e014a57690f154d01fa,1,1,1,2,1,2014-10-16 19:57:38,2014-10-16 19:57:38
651f521e1772e64f267e448bf88f0be246248cc8...fe845c4da88ef15baf45fa600a077a75f3634c40,1,2,2,4,2,2014-08-22 16:48:26,2014-08-22 16:48:26
d53db040c867403e76915459eafbb5d7fd1d2887...78100706303efdf9a3deee0239a7dbb3a93837ec,3,29,7,36,9,2014-07-11 23:26:08,2014-07-06 20:43:24
78100706303efdf9a3deee0239a7dbb3a93837ec...d689a5e1e2633b5fd0db4ccccfb4969e03ae256b,3,90,38,128,6,2014-07-11 23:26:08,2014-07-06 20:44:56
d689a5e1e2633b5fd0db4ccccfb4969e03ae256b...5ba11e6890e51fd01f674160473af3ac432622c5,3,31,4,35,5,2014-07-11 23:26:08,2014-07-08 18:31:20
5ba11e6890e51fd01f674160473af3ac432622c5...fe5ab5b058e33d2d8577f1803448078e8eb92345,1,9,8,17,2,2014-07-11 23:27:23,2014-07-11 23:27:23
52c58b9ea09655fdcd143f94d733a91229dd557c...a6f19955506bd51ae5f6de57ff3ce7976fa7db27,1,2,2,4,2,2014-07-07 23:14:31,2014-07-07 23:14:31
bade039bda0ddff19b14db516ecb210f343243a2...627805f5f8895c3a3887c312f7b8f49a89e51732,2,157,119,276,16,2014-07-07 19:55:26,2014-07-02 08:01:19
55915b8e002f4be52bfbf18ec7ea0a45f0c663b0...14ffde2d8c67065a24930e0ac0844099cbc2cfa8,1,1,1,2,1,2014-07-08 05:50:57,2014-07-08 05:50:57
403df1765abfd3ac62b7f6b8bd709fb0d691d8c8...711fb3e19d4caf7f084d8d1eaca85cfbaef6e978,1,20,20,40,7,2014-07-30 15:09:58,2014-07-30 14:58:24
403df1765abfd3ac62b7f6b8bd709fb0d691d8c8...b0fb0055d279bc25aa2f91c112929ea8eb92c1db,6,193,19,212,11,2014-07-30 14:37:52,2014-07-24 15:42:38
403df1765abfd3ac62b7f6b8bd709fb0d691d8c8...1219e458d105461fd7de23fa4b04a1233f61f8a4,4,13,9,22,12,2014-07-30 13:42:12,2014-07-30 13:42:12
1219e458d105461fd7de23fa4b04a1233f61f8a4...4184cccb0f291b329292da1a31108407cb1a4750,4,0,0,0,0,2014-07-30 13:52:24,2014-07-30 13:52:24
4184cccb0f291b329292da1a31108407cb1a4750...ff02bea88302dcd21345f7e4258400b58b9c142b,1,3,3,6,4,2014-07-30 15:42:53,2014-07-30 15:42:53
403df1765abfd3ac62b7f6b8bd709fb0d691d8c8...fae72c83be211c4331e1982a3d548c6101240501,1,3,3,6,1,2014-07-30 13:23:56,2014-07-19 06:26:08
fae72c83be211c4331e1982a3d548c6101240501...7df54930716d3674f97d4a7e071a52f3769791ba,1,69,38,107,11,2014-08-12 11:49:08,2014-07-20 10:57:36
ce9d48e896060d05a78563dce30abfcd5a99c478...e80d075633d3c642d6640bf2178fedb8891cb97e,4,45,5,50,6,2014-07-10 23:51:16,2014-07-10 23:51:16
e80d075633d3c642d6640bf2178fedb8891cb97e...358758e99fcfd40508b77b06bb8b53ecdde71a4c,1,6,6,12,3,2014-07-11 18:42:29,2014-07-11 18:42:29
47de2e32698e7adbc3b1292186ce9dcddc15cf41...8273cb4b9bd22ddfdd899682f08ac8327e912a28,1,1,1,2,1,2014-07-18 17:22:15,2014-07-15 13:32:44
47de2e32698e7adbc3b1292186ce9dcddc15cf41...01d16150019c9ffb12779d88bdfe3bc146d44408,1,6,0,6,1,2014-07-15 23:32:12,2014-07-11 23:01:23
01d16150019c9ffb12779d88bdfe3bc146d44408...ed8b017ee085c26dadd6a976a89d63322a02738b,1,3,2,5,1,2014-07-16 01:02:44,2014-07-16 01:02:44
47de2e32698e7adbc3b1292186ce9dcddc15cf41...88c601764415416e291d492b137f09e9fa175106,1,0,1,1,1,2014-07-15 12:18:28,2014-07-15 12:18:28
821d3aab65a8f9774e88ed0497f0e6e78a1548fc...1a441d9aeaf929abb89958675018ebc5e0868844,1,4,4,8,4,2014-06-14 00:08:53,2014-06-14 00:08:53
e60543400da0c5de3f6167288f7181eea8a9049d...8a4b79ca5016ae8de0f530ae394064dc5142e5a6,2,26,6,32,5,2014-07-21 02:39:48,2014-06-25 01:59:43
8a4b79ca5016ae8de0f530ae394064dc5142e5a6...c550ad59006c6a0c99b88581bb4378accea63043,1,7,8,15,3,2014-07-21 02:39:48,2014-07-16 04:48:12
c550ad59006c6a0c99b88581bb4378accea63043...5cd0f0824d04a73fb798207231b47157a51604d5,3,24,13,37,10,2014-07-21 05:51:14,2014-07-21 05:51:14
5cd0f0824d04a73fb798207231b47157a51604d5...3853a9c612e3d19dadea26153c9cebaec8cd67a4,1,3,0,3,1,2014-07-22 07:21:03,2014-07-22 07:21:03
3853a9c612e3d19dadea26153c9cebaec8cd67a4...3472c006c4246977eb4fd8c9d55ab416eb5c3d50,1,15,3,18,4,2014-07-22 08:04:48,2014-07-22 08:04:48
3472c006c4246977eb4fd8c9d55ab416eb5c3d50...4d109f6158c7607ee4cd9907b17ddba5f4d29d04,5,15,6,21,9,2014-07-22 09:05:18,2014-07-22 09:05:18
e60543400da0c5de3f6167288f7181eea8a9049d...4ac6375790fe0c7bc9c1bb9c3fdc67db233ff8cb,1,3,2,5,2,2014-07-21 00:05:37,2014-07-21 00:05:37
ed92c3f964698c15f613eb04a4d5cdb535563a42...a377844998f6a866d59bf356790f76d0d25bf01f,4,28,8,36,14,2014-07-21 20:20:21,2014-07-14 16:31:19
a377844998f6a866d59bf356790f76d0d25bf01f...76429cc11f6e2bd731e9ee77a2a538f15ef80eea,1,39,0,39,1,2014-07-21 20:20:32,2014-07-16 18:50:02
ccbaf4bc6ea1af015ee49f6fec1fffb75ff5e4ae...a781de0c10d33f9af92ba8270193f218a3dafdf5,1,1,0,1,1,2014-07-19 04:38:11,2014-07-19 04:38:11
ccbaf4bc6ea1af015ee49f6fec1fffb75ff5e4ae...7aed2130f95c22e1eb6249ffb84c1cee070cb284,1,1,1,2,1,2014-07-19 04:12:16,2014-07-19 04:12:16
1822bf730eb7b32726647086dbfbd686efe39b02...3091d9a31e81be9b8a99aaae8f7d5c2e64043286,3,12,12,24,11,2014-07-01 22:07:48,2014-07-01 01:56:35
3091d9a31e81be9b8a99aaae8f7d5c2e64043286...a09f99b8b0e157e3bb72ad0c9dad8d83896c5182,5,19,19,38,17,2014-07-01 22:07:48,2014-07-01 22:07:05
1822bf730eb7b32726647086dbfbd686efe39b02...fc4c0d9de45da5ff5664fb9c914b68e176c626cd,1,1,1,2,1,2014-07-01 22:00:34,2014-06-30 08:16:49
fc4c0d9de45da5ff5664fb9c914b68e176c626cd...84990731f79e4e94229a7ff2039f812e8b036643,1,3,2,5,1,2014-07-01 22:00:34,2014-07-01 02:02:39
84990731f79e4e94229a7ff2039f812e8b036643...91c4fbb7bfe8851130f746911e34b9d190bb4572,3,4,4,8,4,2014-07-01 22:00:34,2014-07-01 21:59:28
4ae27be2cd1cbedea9cba0f796bc9f040dde7007...f9b3147e2c3463207392d0f7a8ce533b42632815,1,1,1,2,1,2014-07-17 12:44:18,2014-07-17 12:44:18
1f2d75774ad1ab67555699fd25c0734061f36a9b...4c282b979b717a28dd7699ad5b124d82b6a99a29,1,6,2,8,2,2014-07-31 22:05:29,2014-07-31 19:48:39
c11660169a9b1a18f1917d835db3893ff163065c...32bc8658793b278c793cb8755b94df3b210bea5d,1,10,13,23,6,2014-07-25 15:00:41,2014-07-18 14:57:32
c11660169a9b1a18f1917d835db3893ff163065c...31351d08a35b2c903a2b6407bea09ccf1449e79c,5,7,7,14,6,2014-07-18 16:32:04,2014-07-18 16:32:04
c11660169a9b1a18f1917d835db3893ff163065c...261dc5e2f60d8c47c36e719db0ecebd77258847e,2,201,115,316,3,2014-07-18 08:43:40,2014-07-17 08:29:52
c11660169a9b1a18f1917d835db3893ff163065c...204e080932db1cab17de2e19c826663b8b1449a6,1,27,7,34,3,2014-07-18 06:08:27,2014-06-20 12:10:49
c11660169a9b1a18f1917d835db3893ff163065c...7d97a5f4760da388c22a5a29ed95888b89a23d57,2,27,0,27,2,2014-07-18 05:35:54,2014-07-18 05:35:54
6dd8eb9520ce63fce34bbd91e7ff625e25aaaef8...30519330c723374526e7dbfc14807cc8da86c2c0,6,20,33,53,5,2014-07-21 18:56:49,2014-07-21 18:55:43
30519330c723374526e7dbfc14807cc8da86c2c0...24c00c8508b33de4229280f0be2e7b5761d6ed0e,2,45,5,50,3,2014-07-21 20:03:00,2014-07-21 19:10:47
24c00c8508b33de4229280f0be2e7b5761d6ed0e...5d8e80ba8da808fb70d529711359e2d826db2407,2,16,26,42,5,2014-07-21 22:02:31,2014-07-21 22:02:31
4e20407d8260657bc823d6d02120972d718222b3...06248d745a6a69b14595a699e0e5b3e883d8ea3a,6,6,3,9,6,2014-06-16 22:20:07,2014-06-05 18:05:49
4e20407d8260657bc823d6d02120972d718222b3...aab9078ff976c1ee7413a6cfc1b9d6424c3581fd,1,17,3,20,5,2014-06-16 19:13:47,2014-06-09 14:59:49
aab9078ff976c1ee7413a6cfc1b9d6424c3581fd...03ae463c8d77dd8d10e9fd9e37d984896ef9247e,1,11,3,14,3,2014-06-16 19:58:05,2014-06-09 15:27:08
0c5d9626b82e97ef34b3c13bb581f0aadc0bffe2...cc96d312526dac5eff3e0521b921e08301715ce5,1,4,4,8,2,2014-06-18 12:31:26,2014-06-13 04:51:54
ac3eecf3db5f81a553b71267f2e18ca7b7d95fea...d82bb603afab96a83ff58090ff807af5d55adc48,2,19,2,21,5,2014-07-30 02:23:24,2014-07-24 21:59:55
d82bb603afab96a83ff58090ff807af5d55adc48...3e1c1567eac59c7b808d37aa45f82ce67227e59c,2,40,17,57,6,2014-07-30 02:23:24,2014-07-30 02:22:50
ac3eecf3db5f81a553b71267f2e18ca7b7d95fea...5931669343f568114cb209dabf8913be44cd63e8,1,5,0,5,3,2014-07-29 06:46:14,2014-07-29 06:46:14
ac3eecf3db5f81a553b71267f2e18ca7b7d95fea...fc637b5275c2fe23c9857a34316a783042d906b8,19,187,105,292,44,2014-07-28 23:41:59,2014-07-07 18:06:34
dae6af1d1c6692d983151674fb6778006ef0a87a...be8cea98560f4e63ff367a632539bf9f6bf929a4,2,23,4,27,3,2014-07-16 21:32:24,2014-07-16 21:09:30
dae6af1d1c6692d983151674fb6778006ef0a87a...2e61e8267ea6a668d728fe72406619075330a26a,1,15,0,15,1,2014-07-16 20:58:02,2014-07-16 20:58:02
8ac4261263c9ed8dcd11d55b1937b5c24600dfb7...862d3eb284f32a6d9318bb5f981133790314328a,1,1,1,2,1,2014-06-08 19:12:00,2014-06-08 19:12:00
5fee3774d4c68fa6ec1e330575b1f6edfb71dc6f...599cb12bb8aa13aa2f1be940dd8de4c9d3a06959,2,5,5,10,4,2014-05-19 20:55:28,2014-05-19 20:55:28
a22622b0223c922a75e2a6ec58c490de31623c2c...ef94ac7d2fd42a09c99567b0393fb48b9d782a9e,2,60,71,131,20,2014-05-27 18:56:26,2014-05-20 14:26:10
718e522c7124789cce120b77c96a420de971722c...62468a3eba4d115c16388fb4f67d6adfe4bbb0fc,2,114,31,145,19,2014-05-21 22:35:10,2014-05-21 22:35:10
db1a3551a34e054ee687545ab4922114d13d29d0...0abb52c7a97940dc17c45ac45226af8156d0e712,2,30,16,46,9,2014-05-22 22:29:13,2014-05-22 19:14:10
0abb52c7a97940dc17c45ac45226af8156d0e712...b6c65df093111072bb44d42d650b591adb1bbbe0,1,6,6,12,1,2014-05-22 22:50:41,2014-05-22 22:50:41
55d41c3e21e1593b944c06196ffb2ac57ab7f653...bf7f360dcac38037d5c4f9e2e90d01adc240ed2b,9,165,31,196,31,2014-05-28 17:42:02,2014-05-17 07:06:29
4c065069942fd17cf074ffd312677dae5ba43fc2...fee1bbd79ef8767ed149c1b1af4a39ad35e07772,1,1,1,2,1,2014-05-12 19:01:36,2014-05-09 19:01:29
4c065069942fd17cf074ffd312677dae5ba43fc2...79f234e049c72e0cac97bbd93815f33a919eaf1b,1,2,2,4,1,2014-05-12 18:51:40,2014-05-12 18:51:40
4c065069942fd17cf074ffd312677dae5ba43fc2...3e636446c3a9de24b5b990988e0bd4890277df61,1,10,10,20,10,2014-05-12 18:48:03,2014-05-12 18:48:03
4c065069942fd17cf074ffd312677dae5ba43fc2...feb42d3f97f3a4de9317f17297c6277fcb0cc2af,1,2,3,5,1,2014-05-12 18:35:18,2014-05-12 18:35:18
30bd2bbc83b746a1d4527a5c57363bcb9bab34d6...c12dd770908acc06ab402840ad7736e0c056b567,1,4,4,8,2,2014-05-19 21:22:33,2014-05-19 21:22:33
30bd2bbc83b746a1d4527a5c57363bcb9bab34d6...a87bcefb8bf0cee47bf114a46fc33708ce843208,2,23,6,29,12,2014-05-19 20:46:59,2014-05-19 20:46:59
30bd2bbc83b746a1d4527a5c57363bcb9bab34d6...e39299ca1d50df90b085e6a2e3e3f4b6897e5a59,2,2,0,2,2,2014-05-19 19:46:19,2014-05-19 14:51:47
e39299ca1d50df90b085e6a2e3e3f4b6897e5a59...667e2bd4ea5fbc8698c34565f955cb92cff92890,9,1400,10,1410,19,2014-05-19 20:10:49,2014-05-16 11:47:33
667e2bd4ea5fbc8698c34565f955cb92cff92890...77f54252606e6a094b5f722680d43f625bb0d0a8,1,26,0,26,2,2014-05-19 20:10:54,2014-05-19 16:47:35
77f54252606e6a094b5f722680d43f625bb0d0a8...69dcf767fd6b4c54c219c20f87b2fdbb173b7f1c,2,30,0,30,2,2014-05-19 20:10:54,2014-05-19 16:46:25
69dcf767fd6b4c54c219c20f87b2fdbb173b7f1c...b60d6471721bc914dca179a4372303d41913cc4c,3,6,1,7,4,2014-05-19 20:10:54,2014-05-19 18:01:55
b60d6471721bc914dca179a4372303d41913cc4c...a691fcb2774deb07fe602d654bd7ba0908fdc09f,3,90,0,90,3,2014-05-19 20:10:54,2014-05-19 18:21:25
251de0887b573d6ec4764f322415e2a494256de9...5708aa62f36eadca5ada235ca05fddeb1510c1c6,1,1,1,2,1,2014-05-30 19:39:42,2014-05-30 19:39:42
7c52ab7f83a7e37f283d4c237111adc18bdf22b4...bdf4b74b52cb313a869a0b15d1eb315a79e1cd52,1,2,4,6,2,2014-06-19 16:11:32,2014-06-19 16:11:32
7c52ab7f83a7e37f283d4c237111adc18bdf22b4...c4c92e66cdb9fa4c141b4fa4872af37037e1bbe2,1,30,0,30,1,2014-06-18 19:50:39,2014-05-27 21:49:43
c4c92e66cdb9fa4c141b4fa4872af37037e1bbe2...def86d0cf4d80e037f2ecabdff68bab6652cb741,2,11,14,25,9,2014-06-18 19:51:27,2014-05-27 21:54:38
def86d0cf4d80e037f2ecabdff68bab6652cb741...65d4047cb60ec77a4009d25c91b29f95375c8fe5,2,7,3,10,2,2014-06-18 19:51:27,2014-05-28 00:10:00
65d4047cb60ec77a4009d25c91b29f95375c8fe5...5c069940db2042d83bd4ef462a8a50d565aaf874,2,107,32,139,33,2014-06-18 19:51:28,2014-05-28 02:15:42
5c069940db2042d83bd4ef462a8a50d565aaf874...48907d57ede696c68e210cb93cb405124a49cbd3,1,2,16,18,2,2014-06-18 19:51:28,2014-05-28 23:12:29
05c3325a02bf2ffee660dcfd36e8d34cb7192b51...4052a81830e57c9f1d7d567ba9e53813945c9810,1,2,2,4,1,2014-05-20 01:00:31,2014-05-20 00:40:44
3b96078856b935bf634eab0c4c449dce34cfdf7e...68493e2f7f9cb8303302e1098e3293b521ace243,2,21,2,23,3,2014-05-19 18:46:05,2014-05-19 07:51:20
3b96078856b935bf634eab0c4c449dce34cfdf7e...ca9c35cdf772ddb121447b3877dbcf8caa4c5cdb,1,669,105,774,28,2014-05-19 01:58:39,2014-05-18 03:30:24
f65db7c565ed736e26fc9daa30b1bc526351e70b...89c4748b8351eaf070ce722fdb7fe0c0dcec2819,2,148,24,172,98,2014-05-18 19:26:13,2014-05-18 19:26:13
f65db7c565ed736e26fc9daa30b1bc526351e70b...7f9178c6d15417ed8b32976b7ca075422c8160da,1,2,2,4,2,2014-05-18 17:02:39,2014-05-18 06:16:23
f65db7c565ed736e26fc9daa30b1bc526351e70b...72d1e40c4a3b190319cfa5cb44b5e6f1694100fc,3,62,0,62,5,2014-05-18 16:49:08,2014-05-17 18:43:31
aa05170a82a857aa6f1257d4554828c08c2015f6...2819677c215bd409b4ce4da51f0ddfb303760796,40,208,202,410,129,2014-06-04 23:48:49,2014-06-01 20:48:04
048833c246e793f8ce5256cc9db17aad758432e3...8aff01c0b447fa4d68f053c44e8baf7b24247164,12,26,26,52,24,2014-06-04 22:47:57,2014-06-04 22:47:57
3704996089822f3df82c4b5441624418b7e3341d...2e14f0f70af2ce152b531f02c4fce363b6605e37,1,1,1,2,1,2014-06-04 07:08:44,2014-06-04 07:08:44
9329c0d2e08671e3d152c11595f398ff01e5fa18...762c52850177d0eb9148e5f3a0df90c79043246b,1,2,2,4,2,2014-06-05 23:55:32,2014-06-05 23:55:32
9329c0d2e08671e3d152c11595f398ff01e5fa18...3609b051b88565c0fe0615fd47ddb48eed549d27,5,51,29,80,18,2014-06-05 23:02:25,2014-06-05 19:50:53
20bcb80f40db3fa18f285cccb89096829c426dda...fa1e390cad4fd36683e9667795967c711a4867e3,1,1,0,1,1,2014-05-01 20:51:16,2014-05-01 20:51:16
27a39bfd1a45e94e3935f9b57db2c072db27ce2c...3f8ffb461ab66535b3c3a96a564c06db12a27281,1,0,42,42,1,2014-05-11 08:03:12,2014-05-11 08:03:12
0736eb6d164a58388acb9f6f3993250d76b8665b...55f3e72d7f6b996c0874d402c95f4b8c9a7d80d9,1,7,7,14,6,2014-05-05 23:23:14,2014-05-05 23:23:14
ac7b2b888da4c9775c47c0f3139cdc2f643098a2...015a2abafa92ecc61fe5828a285a1e6dcfa07693,1,2,2,4,2,2014-05-02 22:52:48,2014-05-02 21:27:39
ac7b2b888da4c9775c47c0f3139cdc2f643098a2...cf0076b92dd11b3bda9ac7982e374d4531925ff9,1,8,1,9,4,2014-05-02 21:43:51,2014-05-02 21:43:51
cf0076b92dd11b3bda9ac7982e374d4531925ff9...3c422fe5bf45391a509fd3c7f33033baefb0a234,2,25,0,25,2,2014-05-02 21:51:20,2014-05-02 21:51:20
3c422fe5bf45391a509fd3c7f33033baefb0a234...c65de2c0207ac67e5023ada8709490ef4627bd01,2,3,2,5,2,2014-05-02 22:03:59,2014-05-02 22:03:59
cefb0d12775c92ed0ae439b126008bcedd7b2ce0...f37ce76bf68d4935accd1018c904e80e42066f9f,1,6,0,6,2,2014-05-02 23:03:37,2014-05-01 23:08:39
b4ac4228f518ce3af125752fd46ae667dcff8042...41cfaa738c2d8583ecca50948c9df5eda3dfd7f1,4,162,153,315,7,2014-05-05 23:48:56,2014-05-05 23:48:56
95d81dada6f3e3bf63b73d0f99165f9635a0a7e4...9eeff6d099a951c3a3e45d63ce2f8cb158aaeb6c,3,20,20,40,11,2014-05-06 10:26:44,2014-05-06 10:26:44
36c78c917240312e5521eccb195ccce31b29d0f8...5c344dca4be275fc4e85c5e2dfd35133aff5cb23,2,118,0,118,2,2014-07-01 21:32:55,2014-06-30 19:35:30
36c78c917240312e5521eccb195ccce31b29d0f8...262d45e0fe483dbc6d27bc6af51590a8be42d55f,2,5,12,17,6,2014-06-30 22:27:15,2014-06-30 22:27:15
4a9dc8d73d3f871f978c9cf19b5d8d646bdc44d5...5c0819a0464624eba12b6a37462d549d7fed3be4,1,7,1,8,2,2014-06-29 03:21:40,2014-06-28 05:38:54
4a9dc8d73d3f871f978c9cf19b5d8d646bdc44d5...0d2656ce6e8536fcdb6d68b5899febe867f59c70,1,1,1,2,1,2014-06-28 16:26:36,2014-06-28 16:26:36
4a9dc8d73d3f871f978c9cf19b5d8d646bdc44d5...4a5f09387e17860ba748d94028cb2a307c9e0b11,1,1,1,2,1,2014-06-28 16:01:16,2014-06-28 16:01:16
4a9dc8d73d3f871f978c9cf19b5d8d646bdc44d5...ea464ea212aa584dd0aa50820c78f7f60a77450d,2,16,7,23,8,2014-06-28 08:38:29,2014-06-28 08:38:29
4a9dc8d73d3f871f978c9cf19b5d8d646bdc44d5...2edfb1e696d8f46ea4276b3952078b1553ea42eb,4,16,18,34,5,2014-06-28 08:20:31,2014-06-28 08:20:31
2edfb1e696d8f46ea4276b3952078b1553ea42eb...095cb7a81800512b99474aec7245bddddd1b2278,1,6,0,6,1,2014-06-28 08:27:44,2014-06-28 08:27:44
a7722d752dce8c3b365394c396d4c0a9bee220b2...2fcbfb5a66249739ef04d414307be01371190bef,1,5,0,5,2,2014-06-27 13:55:20,2014-06-27 13:55:20
a7722d752dce8c3b365394c396d4c0a9bee220b2...287e604a8f53e569d355b1b6c75f6736f4927281,8,11,11,22,8,2014-06-27 12:43:12,2014-06-27 12:43:12
a7722d752dce8c3b365394c396d4c0a9bee220b2...47065b904559f36e83b924007c375f2de0f31af0,2,194,23,217,13,2014-06-27 11:05:48,2014-06-06 11:28:12
47065b904559f36e83b924007c375f2de0f31af0...57d86a5619adae5e08e0e28fba99f6a7c2f5ee54,9,51,79,130,50,2014-06-27 11:07:40,2014-06-06 11:30:04
4ed165210fd81ab7ee41cb7b67667b17949b084e...f188b9f623e23ee624aca8654bf00f49ee3bae29,6,54,15,69,10,2014-04-24 18:09:38,2014-04-24 05:11:43
4ed165210fd81ab7ee41cb7b67667b17949b084e...d26ea78e42ebf18219b88e01c6252f30aa764aa2,1,1,0,1,1,2014-04-24 17:35:19,2014-04-10 21:41:31
d26ea78e42ebf18219b88e01c6252f30aa764aa2...60a90970bc4add3547064004f08c19ab5027141b,5,96,29,125,17,2014-04-24 17:35:19,2014-04-10 23:03:52
60a90970bc4add3547064004f08c19ab5027141b...0779a8c3287fbf7ff1938df10897b551b839cbee,2,29,14,43,7,2014-04-24 17:35:20,2014-04-10 23:27:27
0779a8c3287fbf7ff1938df10897b551b839cbee...81e5026a6afb282589704fd5f6bcac9ed50108ea,5,66,289,355,18,2014-04-24 17:35:20,2014-04-11 11:45:39
81e5026a6afb282589704fd5f6bcac9ed50108ea...5ba1242bdc309352c2b0b9a1ef9e07fe835e4857,2,15,5,20,5,2014-04-24 17:35:20,2014-04-11 14:30:09
5ba1242bdc309352c2b0b9a1ef9e07fe835e4857...de3d51b0a824e31d7e245aed958d53f436456699,2,50,37,87,5,2014-04-24 17:35:20,2014-04-11 14:42:53
de3d51b0a824e31d7e245aed958d53f436456699...05b611574f85c7ff7d479e04e01ac2b57b233591,9,191,138,329,22,2014-04-24 17:35:20,2014-04-11 15:06:56
05b611574f85c7ff7d479e04e01ac2b57b233591...a949d39f195e7b87288b10b0ef31843e6a3d8eb0,2,22,26,48,7,2014-04-24 17:35:20,2014-04-11 15:15:28
a949d39f195e7b87288b10b0ef31843e6a3d8eb0...156987c118f6f4067794e09e90aabeee0002d05c,3,25,26,51,5,2014-04-24 17:35:20,2014-04-11 15:26:23
156987c118f6f4067794e09e90aabeee0002d05c...7a0b3610664c2269fd5932f294adae72e6e54020,2,1,1,2,2,2014-04-24 17:35:20,2014-04-11 15:28:56
7a0b3610664c2269fd5932f294adae72e6e54020...2d6c3674349c09318e8d1fb3ce43dbabc15c97da,1,1,1,2,1,2014-04-24 17:35:20,2014-04-11 15:31:45
2d6c3674349c09318e8d1fb3ce43dbabc15c97da...2d31aeb911fc94baa88f975110c5ccd45d041acb,2,271,102,373,11,2014-04-24 17:35:20,2014-04-11 15:44:11
2d31aeb911fc94baa88f975110c5ccd45d041acb...90678b31331de54598c7a6665c3e7a78bfe6ed63,1,277,0,277,1,2014-04-24 17:35:20,2014-04-18 21:35:16
90678b31331de54598c7a6665c3e7a78bfe6ed63...fa5cabf9fe9e257d64638043ca2fd08a7bf96cb3,1,0,1,1,1,2014-04-24 17:35:20,2014-04-21 19:07:07
fa5cabf9fe9e257d64638043ca2fd08a7bf96cb3...d5c9f61ecc1c8167322a8cc3b41f29a35c80b9b8,1,6,1,7,3,2014-04-24 17:35:20,2014-04-24 01:12:07
df20a0e7a356c719b67166931e1ab44ad6dff4e1...5e5230cb190b6d78cf27706da447d179b79b29b6,1,0,1,1,1,2014-04-24 13:29:12,2014-04-24 13:29:12
df20a0e7a356c719b67166931e1ab44ad6dff4e1...da8f6ffdeb54a2d99a70deb4ffc58fdff76d5880,1,25,4,29,3,2014-04-24 12:59:59,2014-04-23 11:03:03
b3bea07d561d4efcdb5a47087eaf3ec1cd906fdc...c7bd1f4e648c6615eafebbfcaeb1c30020fc0aba,1,77,77,154,1,2014-04-25 10:36:31,2014-04-25 10:36:31
b3bea07d561d4efcdb5a47087eaf3ec1cd906fdc...14b2a9de874ab80aaaa942b7b8a226bb56dfcd7f,3,102,41,143,6,2014-04-25 00:17:45,2014-04-25 00:17:45
14b2a9de874ab80aaaa942b7b8a226bb56dfcd7f...0aacca3ae6fa7d46a3e2c4e60e71f67c9a4c64e5,2,3,3,6,3,2014-04-25 00:20:14,2014-04-25 00:20:14
0aacca3ae6fa7d46a3e2c4e60e71f67c9a4c64e5...569b23413502713342b605abaf917f664d206a4b,2,141,40,181,4,2014-04-25 01:10:11,2014-04-25 01:10:11
569b23413502713342b605abaf917f664d206a4b...580c2620e7b92d9aee7c1cd033ca987dda161cf1,1,59,40,99,20,2014-04-25 01:23:48,2014-04-25 01:23:48
580c2620e7b92d9aee7c1cd033ca987dda161cf1...24f978094dc5c9eae0ca60001b65256b2b30f2c8,3,39,30,69,29,2014-04-25 06:02:30,2014-04-25 06:02:30
24f978094dc5c9eae0ca60001b65256b2b30f2c8...8cdb720d26197e448587a21894069ee8a20e8aa0,1,33,15,48,10,2014-04-25 21:10:23,2014-04-25 21:10:23
44140f7909ac65206d300fa9a39ae06cc27d1847...df018bc8012ad4181ac16e1329c970fe213f1f87,1,2,2,4,2,2014-04-26 13:48:07,2014-04-26 13:48:07
44140f7909ac65206d300fa9a39ae06cc27d1847...7744f63159cee9cfa5d9e9307e5c29a4f589837f,1,37,41,78,8,2014-04-26 12:10:19,2014-04-26 12:10:19
44140f7909ac65206d300fa9a39ae06cc27d1847...f4055ee2a467458d4848ad6f8e79fc0162d377f9,2,244,0,244,2,2014-04-26 07:29:13,2014-04-25 17:44:40
62f4c884439044475eeaf7a18cd8a260df08a880...9b23178f585f65b9dc9558694d6de4207c479801,2,35,0,35,2,2014-04-28 07:37:42,2014-04-28 06:57:41
62f4c884439044475eeaf7a18cd8a260df08a880...9236e088eb5a9a6d662b08ef7983dbecf01e6ef0,1,2,2,4,2,2014-04-27 21:11:45,2014-04-27 01:24:39
9236e088eb5a9a6d662b08ef7983dbecf01e6ef0...b4b83ef8ae788cb7e016fbf90f0c1b890af7b23d,2,180,0,180,2,2014-04-27 21:11:46,2014-04-27 01:47:20
52d212aa6eb004de410a14df5f6c49f9c3a93f61...0f96a749ab812d76389c4a48c71ff9a01e48488e,1,3,1,4,2,2014-03-04 01:43:08,2014-03-04 01:43:08
4b700dbe85aa22a6272d5adb533b642ba8c905e0...920a6ca54ce98673d0c9a6a9502a469c1c225c75,3,103,1,104,4,2014-03-05 23:02:11,2014-03-05 22:57:20
910168616183e815845afc7a64b05eec7737b580...089bf5e11e4284a6ed07dc165098bb269dfddf46,2,4,1,5,2,2014-03-05 19:27:39,2014-03-05 19:27:39
089bf5e11e4284a6ed07dc165098bb269dfddf46...069dc7f8c7bc3eaf61ddd926636aacce5f1ed1ee,2,4,4,8,4,2014-03-05 19:45:57,2014-03-05 19:45:57
68217729a3d08ac30ad81ce1cd14c69e96e6b983...59acb8c83d3f21ae82c540774653ccd0a46f1a1f,1,6,0,6,2,2014-03-08 22:32:00,2014-03-08 22:32:00
59acb8c83d3f21ae82c540774653ccd0a46f1a1f...694c8e7dfca16fabf63e6fdcdce4151c8440a7a3,1,2,0,2,1,2014-03-08 23:23:06,2014-03-08 23:23:06
694c8e7dfca16fabf63e6fdcdce4151c8440a7a3...baa70e975186bb0ee8a4b16b9374cb6e794f8975,1,5,0,5,4,2014-03-12 00:51:30,2014-03-08 22:32:00
baa70e975186bb0ee8a4b16b9374cb6e794f8975...7178b285a334ae202c9b6022a4917fd51733f1d1,1,2,0,2,2,2014-03-12 00:54:48,2014-03-09 00:07:19
7178b285a334ae202c9b6022a4917fd51733f1d1...fbf74eb079f6a96e006e703cb36c434206757fe6,1,0,2,2,2,2014-03-12 01:00:16,2014-03-12 01:00:16
d9c11163035d3bd3d3b4a6eea46f5f57e5428b56...4746c761566d5d5d4754daf62d20c83cba0efee8,1,8,0,8,1,2014-03-26 15:23:26,2014-03-25 20:29:58
a4b4448009587e79a7a2ddef0178860fd3c01de7...87ea27e80b131ca11d74c89446d4992af0f6c5b9,3,10,3,13,4,2014-04-07 08:37:52,2014-04-07 07:18:45
a4b4448009587e79a7a2ddef0178860fd3c01de7...e35c23311fce853fab318527789f11cc8c150ea2,1,1,0,1,1,2014-04-07 06:19:38,2014-04-07 06:02:11
e35c23311fce853fab318527789f11cc8c150ea2...320b3e0d211d389addda02998a0f47839827b2af,1,1,0,1,1,2014-04-07 06:47:43,2014-04-07 06:47:43
320b3e0d211d389addda02998a0f47839827b2af...726206f2aa45b8a537ae6d6c819f21befc2e0aca,1,1,6,7,2,2014-04-07 07:04:27,2014-04-07 07:04:27
56c156190ad61765086f30367d3c362a7673ad5c...f7b3e879fc3047ed93ac6b43cd9bf47a25f3d0fc,7,46,23,69,18,2014-03-20 22:58:02,2014-03-20 22:58:02
f7b3e879fc3047ed93ac6b43cd9bf47a25f3d0fc...c5f9c4bd6933c806490e4f7cb52557cee154dbed,2,28,61,89,7,2014-03-20 23:09:01,2014-03-20 23:09:01
c5f9c4bd6933c806490e4f7cb52557cee154dbed...443a75d5f66e986e9d7740d3f2aaef080aef8ea0,4,57,31,88,11,2014-03-21 00:10:24,2014-03-21 00:10:24
443a75d5f66e986e9d7740d3f2aaef080aef8ea0...70f3b9f4ce67ee54ec226814cdd26db01f69378d,3,25,6,31,8,2014-03-21 00:23:34,2014-03-21 00:23:34
56c156190ad61765086f30367d3c362a7673ad5c...8944fb2e9b07d5a764f8d48065b9afd73364f640,3,5,6,11,5,2014-03-20 21:51:28,2014-03-20 21:51:28
56c156190ad61765086f30367d3c362a7673ad5c...fbd6fee4ab9b98f477f365307a641b879badd282,3,4,4,8,4,2014-03-20 18:14:54,2014-03-20 17:09:34
56c156190ad61765086f30367d3c362a7673ad5c...a9fa1a13c3b0a654a96be01ff7ec19e8009b2094,1,17,19,36,8,2014-03-20 16:38:35,2014-03-20 16:32:59
c42db412b69be4f81319561e20923cf786c84a5d...24f9187a0467ca66c30e26c3d9e3ee58daeb720f,1,134,28,162,19,2014-05-01 18:06:01,2014-03-31 09:06:39
edab1bd5e5b3b179ea91e675cff6199de109558b...314bd02d2ccd7ab59b67d02a53669028695dd3bc,1,17,31,48,7,2014-05-02 00:25:10,2014-05-02 00:25:10
314bd02d2ccd7ab59b67d02a53669028695dd3bc...8c9192cd76ad46bda3d0ec5ba7eb4a30669afb40,2,134,133,267,10,2014-05-02 17:45:58,2014-05-02 00:40:13
8c9192cd76ad46bda3d0ec5ba7eb4a30669afb40...45be6f6dff1a8be328e5ade008aae8f9062f5cef,3,17,6,23,12,2014-05-02 19:49:12,2014-05-02 19:49:12
edab1bd5e5b3b179ea91e675cff6199de109558b...de49e7c0a640aada97ace458a4e5d63f5f52d4eb,11,72,45,117,46,2014-05-01 23:47:33,2014-05-01 04:39:43
8622641b585d18476f1bc26e1bb5d4298cecf78f...ba1c0f4c817e958693cfcef30f1de9991765d5db,2,3,3,6,2,2014-05-30 17:55:13,2014-05-30 17:55:13
8622641b585d18476f1bc26e1bb5d4298cecf78f...75754e69f6cce80c34ebc72817ada0a807fd635a,3,11,6,17,6,2014-05-29 15:09:55,2014-05-29 13:50:52
8622641b585d18476f1bc26e1bb5d4298cecf78f...5e3b643ce6f43d02fc7fe88eba41d583044a2efd,1,5,0,5,1,2014-05-29 13:57:29,2014-05-29 13:57:29
5844920185b11f3c1f88486774d9a129fa44c0da...6cf137860102b8df5db75dd68924375a7b74c1c3,1,1,1,2,1,2014-04-03 22:57:43,2014-04-03 18:47:49
5844920185b11f3c1f88486774d9a129fa44c0da...c94111b61988ad32d87f99d4421cbcde018c3fb4,5,12,6,18,7,2014-04-03 18:44:13,2013-12-01 23:27:24
c94111b61988ad32d87f99d4421cbcde018c3fb4...e21607341cd8dc575098bd09a3c992da166f7884,1,1,0,1,1,2014-04-03 18:44:13,2013-12-01 23:33:44
5864a3ff77f90ada7174dc047ecbde0ffe32f72c...18ef3cc24a933cbf403c2aaf8b374cfc84a722a4,1,0,15,15,2,2014-04-02 13:12:52,2014-04-02 13:12:52
5864a3ff77f90ada7174dc047ecbde0ffe32f72c...f80fd5da09013d7cd25a0f246ffffd7b6c064073,1,4,1,5,3,2014-04-02 13:07:11,2014-04-02 13:07:11
bce2464e5e0a8e3efdc28aead5e2229c88d0ccc2...4cdcea20474a9f42291fe6b6c6dee348343a7c05,3,61,24,85,9,2014-03-31 22:56:23,2014-03-31 21:02:42
65eeb0fce076f580ce5b428ed5ad68a345e0fb2d...da8231a26bc4532ded49f93a82e731694ee6587c,10,1053,0,1053,10,2014-04-08 01:15:28,2014-04-04 17:57:58
506055d973ec3a393fa5f8438b41b2318e95b21c...63c7941172376e81c5e17206f39d7c78c0e95b69,1,29,0,29,1,2014-04-02 13:23:01,2014-04-02 13:00:12
755cd482588c0e07c4e6c4d123fc82a62bf64a01...bd24eb07b6c3a9448d8b4a8b3ab0d9cd60995aaa,1,6,1,7,1,2014-04-01 16:01:27,2014-03-29 01:40:16
eab56ac007b263708b5526609c8be2bc19881467...2d270c4f06dbc2ee1293e3f81f6922df248ef8eb,7,43,75,118,19,2014-03-27 08:25:01,2014-03-27 08:25:01
2d270c4f06dbc2ee1293e3f81f6922df248ef8eb...bfa2141765c2a3866ca0f5237fc951f4c2db8b98,2,25,9,34,7,2014-03-27 08:57:01,2014-03-27 08:57:01
bfa2141765c2a3866ca0f5237fc951f4c2db8b98...6c9a47f01c583e9c22b831eb426192148d29d792,1,17,0,17,3,2014-03-27 09:04:54,2014-03-27 09:04:54
6c9a47f01c583e9c22b831eb426192148d29d792...7a7f59210d5eb7a38a5fac8889010bd54576ea01,1,2,0,2,1,2014-03-31 23:12:08,2014-03-31 23:12:08
7a7f59210d5eb7a38a5fac8889010bd54576ea01...40c6d00c97c737d9d3827f159518007803affcc7,2,4,2,6,4,2014-04-01 07:07:42,2014-04-01 07:07:42
e1035535ec878c8c837bd1fdd433169dd9b5da42...84e1fdf35d9d6493d389a8e8be3ab41190004b30,2,25,4,29,4,2014-03-25 01:43:26,2014-03-25 01:43:26
84e1fdf35d9d6493d389a8e8be3ab41190004b30...c6c7c03cddc852c42b9f047fbd5c2fb6cecf39eb,1,2,2,4,2,2014-03-25 03:36:07,2014-03-25 03:31:59
c6c7c03cddc852c42b9f047fbd5c2fb6cecf39eb...2517370088ad11765f99d75c16b58e93fe18f85a,1,14,1,15,2,2014-03-25 12:30:59,2014-03-25 12:30:59
e1035535ec878c8c837bd1fdd433169dd9b5da42...68dd722e3c54995e609b2524bad501ab1d4d15d6,1,1,2,3,2,2014-03-24 14:15:04,2014-03-24 14:15:04
d8fc3eecf56cbb41b6ea5a438ffeb7be53d31923...ffebcb660f666e3a2a7be6b838ebd55f524d5b5d,3,2,16,18,8,2014-04-07 21:44:52,2014-04-07 19:40:41
ffebcb660f666e3a2a7be6b838ebd55f524d5b5d...b1e98e06dc62b0d25f98ea9a2fd94e41cc1d20e2,1,1,1,2,1,2014-04-07 21:44:52,2014-04-07 20:29:24
b1e98e06dc62b0d25f98ea9a2fd94e41cc1d20e2...aaf018017c88a707b35115a9411e4069d9356748,2,21,17,38,6,2014-04-07 21:44:53,2014-04-07 21:09:46
aaf018017c88a707b35115a9411e4069d9356748...82f37b874ea17c5e0040f3e41dc761c88d576e33,6,21,14,35,11,2014-04-07 21:44:53,2014-04-07 21:43:50
82f37b874ea17c5e0040f3e41dc761c88d576e33...028d44d12683b170704537c3435361ae8a4e74d8,2,9,18,27,10,2014-04-07 21:59:44,2014-04-07 21:59:44
0e4e200071379f4a4bef638bba90ff72539a5e62...eac27ad46d7df4f11a28b84130ff484224f8b63d,1,34,0,34,1,2014-12-15 23:53:55,2014-12-12 19:15:31
eac27ad46d7df4f11a28b84130ff484224f8b63d...a83dadbeafd7933bbe541b99732978b508f1c768,3,150,12,162,9,2014-12-15 23:54:06,2014-12-12 16:01:05
a83dadbeafd7933bbe541b99732978b508f1c768...5bc2ff8a36e9a768e8b479de4fe3ea9c9daf4121,2,6,1,7,2,2014-12-15 23:57:00,2014-12-15 23:55:12
0e4e200071379f4a4bef638bba90ff72539a5e62...c509835475f4f222400e6a4d2211c59e41329817,1,1,1,2,1,2014-12-12 01:00:43,2014-12-12 01:00:43
c509835475f4f222400e6a4d2211c59e41329817...fd831b4c5e50a3f1de8eb506016ffe89d5cac8d4,2,67,4,71,2,2014-12-12 01:14:53,2014-12-12 01:14:53
debf60b4665dc2bc7f11cad5a996a5fa05fe2112...4595d4fb03093acf87b905bebc5ba4964d7c0707,2,15,1,16,2,2014-12-11 23:00:44,2014-12-11 23:00:44
04932e38afa78441e60ba6b86021a61a70e4692c...0fdf7839a21390f5813589195639caf594a3ddc2,1,105,2,107,8,2014-10-24 12:58:31,2014-09-26 15:55:23
04932e38afa78441e60ba6b86021a61a70e4692c...6f09d064bd438ab4425d6105f40887f02bb9e97e,2,27,15,42,4,2014-10-17 20:20:02,2014-10-06 16:41:22
6f09d064bd438ab4425d6105f40887f02bb9e97e...2db1caee4f23e81107b2647c06b4c677f6ecd7a1,2,3,9,12,3,2014-10-17 20:20:02,2014-10-06 18:57:18
04932e38afa78441e60ba6b86021a61a70e4692c...e45c92153d0c21308fe5983aa76182cc03ef398e,6,32,22,54,4,2014-10-17 18:54:29,2014-10-02 18:33:12
e45c92153d0c21308fe5983aa76182cc03ef398e...83c5dced10c4e2a40990e927ccc15a1e0428529c,2,16,27,43,4,2014-10-17 18:55:04,2014-10-14 17:07:04
83c5dced10c4e2a40990e927ccc15a1e0428529c...d41cba6aed1ffdda9c3e3441d720dab9afc3eb66,2,18,20,38,4,2014-10-17 18:55:34,2014-10-14 17:12:11
d41cba6aed1ffdda9c3e3441d720dab9afc3eb66...2248109ff8607264ba40d4a4ac24bad66462d105,3,20,16,36,3,2014-10-17 18:56:01,2014-10-14 17:15:45
2248109ff8607264ba40d4a4ac24bad66462d105...24d83afd5203f93a22a3d95a212e9ec295aadc8b,3,19,15,34,3,2014-10-17 18:56:28,2014-10-14 17:19:45
24d83afd5203f93a22a3d95a212e9ec295aadc8b...832618afc6e6a8c489afb40f94340f158f9680c7,3,18,14,32,3,2014-10-17 18:56:49,2014-10-14 17:22:06
832618afc6e6a8c489afb40f94340f158f9680c7...4a029259ff41c37eb72a6f221f9725f66491139f,3,20,16,36,3,2014-10-17 18:57:07,2014-10-14 17:26:20
4a029259ff41c37eb72a6f221f9725f66491139f...6582ea574cfcd6cc8e3b1abebe7bfcc7aee05ece,2,17,32,49,5,2014-10-17 18:57:30,2014-10-14 17:29:22
6582ea574cfcd6cc8e3b1abebe7bfcc7aee05ece...c8a5d56fd789b50b78ad58c07a535aaf01af77f7,2,12,7,19,3,2014-10-17 18:57:48,2014-10-14 17:32:00
c8a5d56fd789b50b78ad58c07a535aaf01af77f7...98e7608b4cec04463781ccb314259873bbb56a16,2,7,9,16,3,2014-10-17 18:58:12,2014-10-14 17:37:05
98e7608b4cec04463781ccb314259873bbb56a16...93d3c8e71d0ca8f33d905c455c0520c423fd7eb9,4,0,7,7,1,2014-10-17 18:58:12,2014-10-14 17:40:07
6bc773b2c1cbce828dde3a5bee7d7d4dd893ec3b...d229821501d75fdb86424c3817aa6b7af8459afe,1,4,0,4,1,2014-09-06 02:32:39,2014-09-06 02:32:39
6bc773b2c1cbce828dde3a5bee7d7d4dd893ec3b...d2ffcd986f5e371fe39dc8d6b8c7390cfc4f305d,1,5,3,8,3,2014-08-27 18:24:49,2014-08-18 15:06:07
6bc773b2c1cbce828dde3a5bee7d7d4dd893ec3b...45a2923874a9b1f70674e627d0d112851d5982a8,1,20,31,51,7,2014-08-26 08:28:40,2014-08-25 16:50:18
6bc773b2c1cbce828dde3a5bee7d7d4dd893ec3b...79cf8395277002011b7632e5a040d4f4a7a25d1f,1,2,1,3,1,2014-08-26 07:51:22,2014-08-26 06:04:57
79cf8395277002011b7632e5a040d4f4a7a25d1f...7e72ed70f9cac871b845bebef0f96178c0f1a25c,1,2,2,4,2,2014-08-26 07:51:22,2014-08-26 07:03:38
6bc773b2c1cbce828dde3a5bee7d7d4dd893ec3b...17b95ecb08f1705bd74d6c94c8bcfd4c87ccfca6,2,16,2,18,4,2014-08-24 10:09:30,2014-08-24 10:09:30
6bc773b2c1cbce828dde3a5bee7d7d4dd893ec3b...df38eb4d43b03728253593622fe4285e99d0784f,1,0,46,46,1,2014-08-24 00:01:41,2014-08-24 00:01:41
6bc773b2c1cbce828dde3a5bee7d7d4dd893ec3b...ef9a5926e9af408d68b3c68638a69727e42079fa,1,1,1,2,1,2014-08-22 19:56:43,2014-08-22 19:56:43
7ebd49c49a9f70c87b6dbcff250035d3fd349a20...3b4a1c54d834a21a2b2a22b359495939db3b77f1,50,920,350,1270,147,2014-07-14 19:30:19,2014-07-14 19:30:19
3b4a1c54d834a21a2b2a22b359495939db3b77f1...f00e64357672ea3a130b2570ce34ea48ad51bbb5,4,25,1,26,9,2014-07-14 19:49:50,2014-07-14 19:49:50
7ebd49c49a9f70c87b6dbcff250035d3fd349a20...4f0fbb885eb6b561fd6e4ba26b35cb30dd8d9121,1,5,1,6,1,2014-07-14 18:34:04,2014-07-14 18:34:04
319f5516146bd5c9c93907ef612e96d3c3d88711...88326e9b91435d2183f943a2905fa516d0b5d78e,1,4,2,6,1,2014-07-12 04:33:43,2014-07-12 04:33:43
319f5516146bd5c9c93907ef612e96d3c3d88711...b2ba1a9ce5709ee6f143b79bd543f95a4aa03c14,1,29,23,52,9,2014-07-12 02:12:59,2014-07-11 23:50:25
319f5516146bd5c9c93907ef612e96d3c3d88711...94e6dc978134b61a2b30aa9118f98f6fadd10535,6,42,0,42,10,2014-07-11 23:43:21,2014-07-10 18:41:11
94e6dc978134b61a2b30aa9118f98f6fadd10535...21059af3ac0136607dbb57c796f625cfbd045177,4,33,3,36,10,2014-07-11 23:43:21,2014-07-10 19:31:01
21059af3ac0136607dbb57c796f625cfbd045177...8344b6d7368b90c567f43e0c17d4495e2e7b12f5,2,36,0,36,2,2014-07-11 23:43:21,2014-07-10 21:51:15
8344b6d7368b90c567f43e0c17d4495e2e7b12f5...f3ff323fb364495617de3e43f2d09a145a4f2ee3,3,21,28,49,5,2014-07-11 23:43:21,2014-07-10 22:11:35
f3ff323fb364495617de3e43f2d09a145a4f2ee3...222a6f44016451dcbd2da0003e64521c06e88ba9,3,48,7,55,7,2014-07-11 23:43:21,2014-07-10 22:31:01
222a6f44016451dcbd2da0003e64521c06e88ba9...064b5f870db39e33f18d6dd405f2bdab98255ef7,2,36,2,38,4,2014-07-11 23:43:21,2014-07-10 23:02:39
064b5f870db39e33f18d6dd405f2bdab98255ef7...c04230c42b7a953ffe50bc37d351f86e80a442e6,4,67,12,79,15,2014-07-11 23:43:21,2014-07-10 23:38:11
c04230c42b7a953ffe50bc37d351f86e80a442e6...e7d9854414ed77765db49af136533871ba443f3c,2,16,4,20,5,2014-07-11 23:43:21,2014-07-10 23:50:45
e7d9854414ed77765db49af136533871ba443f3c...6bb27f18d19201d8c0b3c509151935308c001c22,3,13,3,16,4,2014-07-12 01:03:12,2014-07-11 23:24:44
f014236791fa0078574d6c437b2c13749cf58e90...10d066c9cbc074a72ef3bb4f06a39b691a155082,2,6,12,18,8,2014-07-08 19:23:08,2014-07-08 19:23:08
10d066c9cbc074a72ef3bb4f06a39b691a155082...4b1a464ac106b413fc773869adea9c89a08aee3a,2,4,71,75,7,2014-07-08 19:26:59,2014-07-08 19:26:59
c18b38f912d08105177630718a78562186ae7324...ef6b78f7db890a79b40484fd892ff486017ff2e9,2,3,26,29,4,2014-07-30 18:23:43,2014-07-30 16:28:42
c18b38f912d08105177630718a78562186ae7324...ba57d3d9e63445f43e4d53da44e8dec27baa288d,1,0,0,0,0,2014-07-30 15:15:18,2014-07-30 15:15:18
17112704b99405aa642df37d5c8b7e369dd0b4ab...1480168e9f6178e4015aa4dcc035a6963c59f431,1,5,3,8,2,2014-08-14 17:50:56,2014-08-14 07:01:39
1480168e9f6178e4015aa4dcc035a6963c59f431...93d6adf8a19855edf118d27d0239222f572d8292,1,13,1,14,3,2014-08-14 17:51:06,2014-08-14 11:51:31
93d6adf8a19855edf118d27d0239222f572d8292...f1975cbc7c5b551e5a206c15f32aef3d51904408,1,11,0,11,2,2014-08-14 17:51:15,2014-08-14 15:38:06
f1975cbc7c5b551e5a206c15f32aef3d51904408...0d4d7e4a2851c60f768f71a79a78c068fd9dffe8,1,2,2,4,1,2014-08-14 17:51:25,2014-08-14 17:50:22
b93787e6e002dc02d7fef2610b5ed905399f3899...66ccd55ed4676b0b306829aa01ffdd4067c9960e,1,8,8,16,7,2014-07-14 17:11:48,2014-07-14 17:11:48
b93787e6e002dc02d7fef2610b5ed905399f3899...1a99f36580fc814778170ae68f5ea53694aa5c12,4,4,4,8,4,2014-07-11 12:28:11,2014-07-11 11:15:41
324010ad66f4fa393f53cbfa2fa68d21dabb5941...c47ab1425f0cf08168af7e5561e39ff2e39625e0,2,62,13,75,3,2014-07-22 16:56:58,2014-07-22 07:37:38
37309f37fabe54dd489b0a80206951486dc828c1...4fc8edd0df742a559fe6a4961223a644ab088fa7,1,0,87,87,1,2014-07-15 20:40:43,2014-07-15 20:40:43
37309f37fabe54dd489b0a80206951486dc828c1...fb51a330bb1bfb442f2e220a39a991ea0c69c69b,1,2,2,4,1,2014-07-15 20:24:08,2014-07-15 20:24:08
37309f37fabe54dd489b0a80206951486dc828c1...d91d381856b7c91fa992c3cd1943f27c269219f2,1,7,0,7,1,2014-07-15 19:58:01,2014-07-07 21:17:54
d91d381856b7c91fa992c3cd1943f27c269219f2...2a230729dae91a54cfe617843b1dd7141ad51948,1,3,5,8,1,2014-07-15 19:58:01,2014-07-15 19:48:08
8365abb200028a844ba91303f110832b06d8bab3...f033ce3ee9ee055612acacde537687e41865e14f,1,4,0,4,1,2014-07-21 16:54:25,2014-06-27 12:04:28
f033ce3ee9ee055612acacde537687e41865e14f...c47ebe7a351bc639028cd48aed9d2fa2310a2a65,1,20,30,50,6,2014-07-21 17:21:18,2014-06-27 12:10:30
8365abb200028a844ba91303f110832b06d8bab3...9ff7bbe0ac4172ea15242218e9ac4668eddc1e7f,1,1,1,2,1,2014-07-21 08:34:54,2014-07-21 08:34:54
ac6ec9df1da4467304e4b48bcc7f77385e36a515...9a7c5be7d1d71d339b857ec20ca03cc09d4bbfa2,2,29,60,89,2,2014-07-19 08:42:27,2014-07-16 19:40:04
9a7c5be7d1d71d339b857ec20ca03cc09d4bbfa2...e88487b321fba4d1a6d9dcd080ec5b9ae024865e,2,24,34,58,2,2014-07-19 08:42:27,2014-07-17 17:36:45
5ff18b8155b4cd6274b63ea227ff3d686464dc14...7abe70c0b1018729006fd5d614ada2dc67edb9b2,1,3,0,3,1,2014-07-02 15:36:57,2014-07-02 15:36:57
7abe70c0b1018729006fd5d614ada2dc67edb9b2...bae79c3e7285c170f97a0f7f331a48fb47f0f40e,1,3,0,3,1,2014-07-02 15:38:19,2014-07-02 15:38:19
5ff18b8155b4cd6274b63ea227ff3d686464dc14...cccb64e8633eee309e6ce33c3bb41614edd70d81,2,20,5,25,4,2014-07-02 00:19:05,2014-07-01 23:14:22
cccb64e8633eee309e6ce33c3bb41614edd70d81...d403936818b8785b65ff55ebab0d266b4a871ef6,1,2,2,4,2,2014-07-02 00:54:08,2014-07-02 00:54:08
dca52c47a4aaa41fc21883ab60c9303a8e9f3dfa...e5e8669c7289959a2634bd3f66f89eef1bd4ef01,2,33,0,33,4,2014-07-17 20:11:40,2014-07-08 20:25:22
e5e8669c7289959a2634bd3f66f89eef1bd4ef01...68bb56a4a5a5905a7f5eb0781782e1db5cfc7a89,2,35,9,44,8,2014-07-17 20:11:45,2014-07-08 20:27:58
dca52c47a4aaa41fc21883ab60c9303a8e9f3dfa...67e3f7482f792ced05b6fb659d0d4cb8c9899a32,1,234,61,295,50,2014-07-17 17:50:50,2014-07-17 17:50:50
9b3c0e65daa855b2ec2528553d40c2821cd9e970...1b9b11db4f43c8b55d48e0aae5e05155997fe314,16,80,27,107,31,2014-07-18 22:31:25,2014-07-18 21:55:04
9b3c0e65daa855b2ec2528553d40c2821cd9e970...95caf8c4856ad477dbc835c6f9af5af5668389c0,1,1,1,2,1,2014-07-18 21:16:19,2014-07-18 21:16:19
5395cecc48d278af26c2a8982c776af9a8dd96ac...e4a09cd79d0ee3fbb6a33552a21c53491d9f3953,1,27,1,28,1,2014-08-12 20:29:45,2014-07-31 23:47:19
5395cecc48d278af26c2a8982c776af9a8dd96ac...631ea726e425713415e7a991f9a813d02b3f6d75,1,87,84,171,40,2014-08-01 01:09:00,2014-07-25 23:22:41
19c8e74fd3deeae7a22eb4c502acd2b9f3072ab0...5ebe86ccf9bedf439b2c90e26dee0f27c0c116f9,2,9,3,12,4,2014-07-31 01:06:19,2014-04-28 15:04:28
5ebe86ccf9bedf439b2c90e26dee0f27c0c116f9...6bc483fa59adc0be65ea9c804c69d861a02435bd,1,1,1,2,1,2014-07-31 01:06:48,2014-07-31 01:05:57
19c8e74fd3deeae7a22eb4c502acd2b9f3072ab0...3a14eb066cef537e52f96c6ad76adab2efe02e05,6,15,13,28,12,2014-07-30 23:02:04,2014-07-30 23:02:04
19c8e74fd3deeae7a22eb4c502acd2b9f3072ab0...e13b1fc05f5caaa324678b7da2fc917943557185,1,9,9,18,1,2014-07-30 22:32:14,2014-07-30 22:32:14
36608696e1b062a1d319f205e6d5b0c56a85f33c...4162309d116fe5cb171d7d212842fe5406c544df,1,66,0,66,1,2014-07-18 17:51:55,2014-07-17 06:15:23
36608696e1b062a1d319f205e6d5b0c56a85f33c...06bc4e07529a93abede35ea8fcc2906c5963f2a3,4,67,0,67,5,2014-07-18 17:42:49,2014-06-27 06:52:36
06bc4e07529a93abede35ea8fcc2906c5963f2a3...4b5b3b43212c0a1883c56321aedbffc605be31f9,3,12,13,25,10,2014-07-18 17:45:25,2014-06-29 17:10:20
4b5b3b43212c0a1883c56321aedbffc605be31f9...56a39ca5d3010785e3b4be849c6b13c69a23721d,1,6,10,16,3,2014-07-18 17:52:24,2014-07-18 17:52:24
b752e7402aa635b858c8559ae17080f66816bf92...319a8a241e0b9182ea309b886e2d23e2f4d73c6c,1,21,23,44,12,2014-07-21 19:18:59,2014-07-21 19:18:59
5d2a62d8de5422b29daa12eef9bd475e2a9b1cb4...8652830661f648d585a61479a88ada01010b7fc8,4,62,52,114,6,2014-08-01 18:16:05,2014-07-31 20:24:54
8652830661f648d585a61479a88ada01010b7fc8...8031c23b0f492b6f62dfc226dbf9b3d051d9546a,4,33,24,57,4,2014-08-01 18:16:41,2014-07-31 20:29:38
8031c23b0f492b6f62dfc226dbf9b3d051d9546a...80f3272ee9957c537271462a688a7de88aaa92c0,4,89,81,170,7,2014-08-01 18:16:50,2014-07-31 20:36:42
80f3272ee9957c537271462a688a7de88aaa92c0...03c07617cce5167ac854ff84637be9cccef39328,4,33,26,59,4,2014-08-01 18:16:59,2014-07-31 20:40:15
03c07617cce5167ac854ff84637be9cccef39328...4180b87514b98ed72498073382cbaeeb5e90191a,4,71,60,131,4,2014-08-01 18:17:04,2014-07-31 20:46:18
4180b87514b98ed72498073382cbaeeb5e90191a...bd54a73c42760cc94f90df253ecf0818a3006277,4,30,23,53,4,2014-08-01 18:17:11,2014-07-31 20:48:23
bd54a73c42760cc94f90df253ecf0818a3006277...c4ce396f461a75ab887f3e1a2dcc54b10fc20423,4,23,14,37,4,2014-08-01 18:17:16,2014-07-31 20:50:46
c4ce396f461a75ab887f3e1a2dcc54b10fc20423...e0fd96f850a65cfa6b386fb6b91ee8ced58f5fc2,4,32,23,55,4,2014-08-01 18:17:20,2014-07-31 20:53:22
e0fd96f850a65cfa6b386fb6b91ee8ced58f5fc2...fdad41f5b921dfa06eec613b86147a22aeea5835,4,87,79,166,6,2014-08-01 18:17:24,2014-07-31 20:57:21
fdad41f5b921dfa06eec613b86147a22aeea5835...066330fc9687edd3f8a5066fd4201ea14af15f93,4,136,123,259,7,2014-08-01 18:17:29,2014-07-31 21:03:21
066330fc9687edd3f8a5066fd4201ea14af15f93...cc39d579f50b67617388117e5afbb47351b59337,7,208,193,401,11,2014-08-01 18:24:28,2014-07-31 21:12:12
cc39d579f50b67617388117e5afbb47351b59337...06229a4b76aa221d08cfb1888b919da31c49194f,4,53,45,98,5,2014-08-01 18:24:41,2014-07-31 21:15:28
06229a4b76aa221d08cfb1888b919da31c49194f...49e61f62ced4e111071cf9439e3264f06b008c6c,5,36,29,65,5,2014-08-01 18:24:46,2014-07-31 21:17:50
49e61f62ced4e111071cf9439e3264f06b008c6c...aa49632feff937287cd6f6413d665ec74f49779c,4,82,73,155,5,2014-08-01 18:24:52,2014-07-31 21:21:38
aa49632feff937287cd6f6413d665ec74f49779c...d0370076585f506d2f81af3fb3dab56119bdc0e9,3,19,21,40,14,2014-08-01 18:24:58,2014-07-31 21:26:25
d0370076585f506d2f81af3fb3dab56119bdc0e9...f46de04af65968f704f08681e4cf6c35e20b0697,1,24,56,80,2,2014-08-01 18:25:02,2014-07-31 21:37:30
3369b4f6f03f400d7c6d3dbf1a86401d983503be...74212a15658a3f1c68a381a593488d7fda830272,1,18,18,36,13,2014-08-04 20:37:01,2014-07-29 17:31:15
3369b4f6f03f400d7c6d3dbf1a86401d983503be...38bce179040c80512c39c42ebbf776e58ac3dfcf,1,4,1,5,2,2014-07-29 19:07:59,2014-07-29 19:07:59
503d124677f5a0221e1bf8c8ed7320a15c5e01db...4cb2cfed9ffd8a10e5a47b41b26313dd94a86dc1,1,35,0,35,1,2014-08-01 18:11:34,2014-08-01 18:11:34
503d124677f5a0221e1bf8c8ed7320a15c5e01db...e6a084f4f8af3f7a5bc7c2c5ed375eaed61e8b8c,1,32,21,53,4,2014-08-01 08:41:16,2014-07-31 14:11:51
503d124677f5a0221e1bf8c8ed7320a15c5e01db...58588009c00d1c7dd279b95d33759f61499c2848,1,1,1,2,1,2014-08-01 05:37:38,2014-08-01 05:37:38
f84bcc6bd05e44de379b2faaf08b96e3ea843ea8...41d6ab6318cc2c8905a174ed28a78dfcad06cef5,3,20,13,33,6,2014-07-16 23:39:44,2014-07-16 23:39:44
82675ee359f65a972252e541996bd990eb127e22...e1bb99d925895f4eaec54e7b8254f5250dfeb7dd,1,2,1,3,1,2014-07-21 17:55:12,2014-07-19 00:15:47
faeede02003c4ea4bec67b74fad8f74ab77029b8...8e851aaa27ef20a8a0c33b568e45c4c8c45db787,1,0,1,1,1,2014-06-08 20:21:07,2014-06-08 20:21:07
faeede02003c4ea4bec67b74fad8f74ab77029b8...fa7946a510f75a118aaf0d419c0d6c2f6d3b8d73,2,7,0,7,2,2014-06-08 20:11:50,2014-06-08 20:11:50
b466672a4c29a242f681f6adb8297c8409d62250...bc081a03d85a88cc2160ade9256d96d7b84c4caa,1,3,0,3,1,2014-05-20 18:04:27,2014-05-19 21:18:53
b466672a4c29a242f681f6adb8297c8409d62250...e454be7567e144dc836ff283d4f4e059db307a91,5,133,109,242,31,2014-05-19 22:04:51,2014-05-19 22:04:51
e454be7567e144dc836ff283d4f4e059db307a91...d535d9810012b18ca83f86aa416ff4a08bb49804,2,43,26,69,9,2014-05-19 22:18:37,2014-05-19 22:18:37
d535d9810012b18ca83f86aa416ff4a08bb49804...d31c37fceb6c09a48b5dd9d6c33a95d734e02704,1,25,0,25,1,2014-05-19 22:57:29,2014-05-19 22:57:29
d31c37fceb6c09a48b5dd9d6c33a95d734e02704...e2d79bec3ab76357625ca57d83299012f584c024,1,5,16,21,9,2014-05-20 21:11:33,2014-05-20 21:11:33
bdb5aa4c27b375cc8cd59fd6fa26ec10c23e58f9...249524ec49a18c8389ed7b1a4cd2300250fadbc4,1,1,0,1,1,2014-05-27 20:45:17,2014-05-27 19:37:59
bdb5aa4c27b375cc8cd59fd6fa26ec10c23e58f9...8b77e0183eaa7b3a87921f9655e2799d300bf775,1,2,0,2,1,2014-05-27 19:28:31,2014-05-27 19:04:20
bdb5aa4c27b375cc8cd59fd6fa26ec10c23e58f9...92e41a02ce40c7d3446b8ca7ec5c5671ac3d8917,4,10,1,11,8,2014-05-27 19:26:56,2014-05-22 22:56:10
92e41a02ce40c7d3446b8ca7ec5c5671ac3d8917...b01c3283fafa01228a566e128dbf4b016c308d04,2,2,2,4,4,2014-05-27 19:26:56,2014-05-27 19:25:27
3d78c49aab0829e6c3bcf63b2d7b2d162d11a11e...b315c380f4acd65cc0428009702f99a266f96c59,1,1,1,2,1,2014-05-23 01:24:58,2014-05-23 01:24:58
3d78c49aab0829e6c3bcf63b2d7b2d162d11a11e...1ce5457d57d783d6c61557681970bf0977621e78,2,39,0,39,3,2014-05-23 00:28:04,2014-05-22 22:12:41
3d78c49aab0829e6c3bcf63b2d7b2d162d11a11e...c8ada301baf66360af6a3445b7c2abd629da3fd1,1,49,48,97,13,2014-05-23 00:26:38,2014-05-23 00:03:00
7470ebf30b8b8bce03ae536cebbae71bfbe474f9...f92d68a6cedd069c138ac83961ad54ceb937ebd0,1,24,2,26,6,2014-05-22 18:54:49,2014-05-22 10:39:00
7470ebf30b8b8bce03ae536cebbae71bfbe474f9...42708181b1976a768428568e664c566717ade8c4,1,2,2,4,2,2014-05-22 07:23:52,2014-05-22 07:23:52
8ac516094e5b90351cbb436477f06730b1b5e38d...68fb7f4b744bf71206898d32fe203556a6261e5d,6,77,26,103,18,2014-05-31 01:22:07,2014-05-31 01:13:37
68fb7f4b744bf71206898d32fe203556a6261e5d...1dd02ff4a09218eab47533032d1222008d6419b8,2,15,6,21,3,2014-05-31 01:28:08,2014-05-31 01:28:08
8ac516094e5b90351cbb436477f06730b1b5e38d...b0ea389c694484c0e4907e12a9cf8ff10f80c164,1,11,2,13,5,2014-05-31 00:44:00,2014-05-31 00:44:00
8ac516094e5b90351cbb436477f06730b1b5e38d...b64209f7b6818337a90d2f04627664b5964a29ce,1,4,3,7,2,2014-05-31 00:03:51,2014-05-31 00:03:51
e5202de9186a2548c54af54739a6cb09046afd61...e7babb28ccb2d451baec9a8cb83e627390cbcdd4,1,2,2,4,1,2014-05-22 00:07:04,2014-05-20 19:53:46
e5202de9186a2548c54af54739a6cb09046afd61...94f01184beb731b8c28dd43cf259621ba14f76ff,2,2,5,7,3,2014-05-20 20:45:22,2014-05-20 19:05:57
e5202de9186a2548c54af54739a6cb09046afd61...603e00a3a7644caf118d3efd0932500b4dfc4de3,9,137,125,262,42,2014-05-20 19:36:15,2014-05-20 19:36:15
e5202de9186a2548c54af54739a6cb09046afd61...24c73ce2d3d572313fe56bad08819e0ca8b74d26,1,12,3,15,4,2014-05-20 19:22:06,2014-05-20 17:02:55
e5202de9186a2548c54af54739a6cb09046afd61...0f278940947d74f2b7889ada18808779312f9608,1,3,1,4,1,2014-05-20 19:10:23,2014-05-20 19:10:23
bfe72c6189e92d9ee6f2d2f26a5553b4eb863a44...fcf2e9a9107c6c9aebaf63ce044f636333e7eed8,1,3,0,3,1,2014-05-20 09:31:39,2014-05-20 07:58:30
bfe72c6189e92d9ee6f2d2f26a5553b4eb863a44...602950435056baa939f428223b6d3ff26ca5403d,1,15,6,21,2,2014-05-20 07:29:32,2014-05-20 07:28:44
bfe72c6189e92d9ee6f2d2f26a5553b4eb863a44...000a37fe9d13a173ab46fcd5b8e693950a438f98,2,14,3,17,4,2014-05-20 05:32:51,2014-05-16 22:01:25
000a37fe9d13a173ab46fcd5b8e693950a438f98...5579bec47be6279569e69c72cccf87864af481de,1,36,0,36,3,2014-05-21 22:20:29,2014-05-21 22:07:40
5579bec47be6279569e69c72cccf87864af481de...61ac745d7a7dd192948e0c1cfbdff87af7715c92,1,1,1,2,1,2014-05-21 22:20:29,2014-05-21 22:08:40
a8ef66d84a33aa719bc2af8c4f07230913112e40...0a725ea28259f8a0f9a1de5730fd99675b942dde,3,223,96,319,27,2014-06-05 00:44:13,2014-05-24 01:06:14
a8ef66d84a33aa719bc2af8c4f07230913112e40...7a145b022a3b50b0d04cb0471d517f7c6c5efc67,6,3,161,164,8,2014-06-05 00:35:15,2014-05-05 22:44:16
6fa3acc96c2d39c75193f140c5ed2e654cc77208...fad14eda3af8b4ffa59f74dc5c6583d22bcc9471,40,202,208,410,129,2014-06-05 21:52:06,2014-06-05 21:52:06
9f14ff83b2e8cba9a1396c02aa3934373d58b274...eb3e2f4f4736eaaab260804ff8543fb77243a254,1,2,2,4,2,2014-06-04 09:54:06,2014-06-04 09:54:06
8296125b32bf594fa0e16f9eed101ddf27dfcf5f...ae686c0486cf6e2c0c394c5eb7a26e7d59cf1472,1,0,1,1,1,2014-05-01 21:49:53,2014-05-01 21:49:53
ae686c0486cf6e2c0c394c5eb7a26e7d59cf1472...de191e86321f7d3136ff42ff75826b8107399497,2,4,1,5,2,2014-05-01 22:22:08,2014-05-01 21:52:29
d7166536e7f71ca87a8c37d2eb1c06184c9f3bd6...9e64a4d862e38ead4c2708ce61663f176844406b,1,1,1,2,1,2014-05-07 07:26:24,2014-05-06 23:30:17
d7166536e7f71ca87a8c37d2eb1c06184c9f3bd6...62e8ddb5791b9ee62c3f4361084dda4a5d7760e1,1,1,0,1,1,2014-05-07 00:04:04,2014-05-07 00:04:04
d7166536e7f71ca87a8c37d2eb1c06184c9f3bd6...77098d5b5bf8840a1179380b34aedb26139b9d65,2,22,8,30,10,2014-05-06 21:31:21,2014-05-06 17:43:46
77098d5b5bf8840a1179380b34aedb26139b9d65...b622da3cfe211d31df69e72a93ed4fae872aca65,2,6,6,12,6,2014-05-06 21:32:12,2014-05-06 17:51:20
818648ff9f9e506e2d296fb73ef55dc8f87648fb...8d07c2d1aeb3326f1f62854e6adfd26f0d8e0342,1,1,1,2,1,2014-05-06 18:39:11,2014-05-06 18:39:11
818648ff9f9e506e2d296fb73ef55dc8f87648fb...6f327278446b958b32b02a3baefda26e6c8d219f,1,1,0,1,1,2014-05-06 18:31:47,2014-05-06 18:31:47
affacfab08281e7d9bbd7c0d83bc0a842cb764aa...2b0f88383afba28fe7b0bba989d115c2f5e2cc87,1,1,1,2,1,2014-05-06 00:08:35,2014-05-06 00:08:35
41cfaa738c2d8583ecca50948c9df5eda3dfd7f1...cd818950919f0da868b36e32033607d5e6c98466,2,2,0,2,2,2014-05-06 02:40:27,2014-05-05 17:47:55
cd818950919f0da868b36e32033607d5e6c98466...53f38a14cd6b61a6b5df68cc3694dcba2b0c1eb7,5,106,3,109,7,2014-05-06 02:40:27,2014-04-07 18:34:07
53f38a14cd6b61a6b5df68cc3694dcba2b0c1eb7...dc605c8be76760951d0d12e67409602c7b4b7973,1,6,21,27,3,2014-05-06 02:51:47,2014-05-06 02:51:03
ba6a732357ce9e2fa3292ce8b46d17dadfe22468...924979259ec4c9ef6beab0468325f1cb04deaacb,1,4,4,8,2,2014-05-06 15:05:15,2014-05-06 15:05:15
ba6a732357ce9e2fa3292ce8b46d17dadfe22468...14f65ab83b4f72ea56b3e98023e941474d4e9dd8,1,3,3,6,3,2014-05-06 14:42:22,2014-05-06 14:42:22
8ea35892871f75cd0197a5c443054bf570ed6744...b59754bcb32fe5b8f416f407f71d2b50bb148c8a,1,29,29,58,25,2014-07-03 00:22:09,2014-06-28 16:31:29
b59754bcb32fe5b8f416f407f71d2b50bb148c8a...b07f193822d00e40580cd11320ed7e01b629f9d7,40,683,327,1010,219,2014-07-03 00:22:20,2014-07-01 02:58:04
8ea35892871f75cd0197a5c443054bf570ed6744...f337a52a6ec01684c326a827adbe3d0b8b5f1f53,3,59,25,84,4,2014-07-02 23:39:08,2014-07-02 01:52:59
8ea35892871f75cd0197a5c443054bf570ed6744...d946cae36436a270b14d53585624e5567e590db2,1,65,25,90,14,2014-07-02 23:33:13,2014-07-02 23:33:13
d946cae36436a270b14d53585624e5567e590db2...c3f4972f6d036520df589676c7ebeef397d327c2,1,1,1,2,1,2014-07-03 00:41:52,2014-07-03 00:41:52
8ea35892871f75cd0197a5c443054bf570ed6744...9da6c80533f80060575840e1e2fd80cc11826f7b,2,122,75,197,3,2014-07-02 20:56:19,2014-06-27 15:47:32
8ea35892871f75cd0197a5c443054bf570ed6744...a4a80b64a7f6366f7fb94cb8cca042a6324a0e99,1,27,19,46,3,2014-07-02 20:32:28,2014-03-17 16:03:22
a4a80b64a7f6366f7fb94cb8cca042a6324a0e99...2b3959c414ffe9403e53617ed1a160c1daabeeaa,1,37,29,66,3,2014-07-02 20:33:14,2014-07-02 20:33:14
8ea35892871f75cd0197a5c443054bf570ed6744...9d4e80222144c0aef3e78202ecb4904b3ce5ed9b,6,209,194,403,13,2014-07-02 19:31:06,2014-07-02 14:48:37
9d4e80222144c0aef3e78202ecb4904b3ce5ed9b...a8d95b7c573dedad26395372dd0d4ff8882f6cb6,1,36,0,36,1,2014-07-03 06:06:58,2014-07-02 15:15:56
a8d95b7c573dedad26395372dd0d4ff8882f6cb6...7bdd23bfeec1968a3061e63e24af049837baf4c4,3,21,21,42,17,2014-07-03 06:12:53,2014-07-02 19:28:08
8ea35892871f75cd0197a5c443054bf570ed6744...170ba7f8feea9b284d20ed85e9ea9c947be2941c,2,2,2,4,3,2014-07-02 18:54:14,2014-07-02 18:53:35
2075ef029e37d54466a223f68c8837c7b67782c5...9a2771eac22950fce43702896052f5187944de6d,3,45,25,70,4,2014-06-29 23:31:16,2014-06-29 23:31:16
9a2771eac22950fce43702896052f5187944de6d...c2699d8d896d592dc02276d76dfdf544fd26d0dd,1,3,0,3,1,2014-06-30 09:36:46,2014-06-30 09:36:46
2075ef029e37d54466a223f68c8837c7b67782c5...3be683a0bbf25f41e9f4b1652f8f0784cafbd05b,1,1,1,2,1,2014-06-29 22:45:08,2014-06-29 22:45:08
7362a09cd9e3efa3e0e065e5b8d69a9dfd614cf2...dda0ce645995d6dd2b6eb5848c30d305a3d220d2,1,2,0,2,1,2014-06-29 08:11:30,2014-06-29 07:50:53
7362a09cd9e3efa3e0e065e5b8d69a9dfd614cf2...86f06b6deb6e5b9ddb30f781e81cc5b6241e20ae,1,34,3,37,6,2014-06-29 05:17:51,2014-06-29 05:09:23
e6d9c097b29a4737973b54dbcb1611c3068608b5...b44e13ae023816ed9d36b6dc6d74f089fc402cab,17,62,62,124,49,2014-06-30 23:54:20,2014-06-27 11:32:01
b44e13ae023816ed9d36b6dc6d74f089fc402cab...fde10cf87b9f0df6d8aa8683721a6f9d71dda516,32,57,57,114,54,2014-06-30 23:55:19,2014-06-30 01:31:15
9b9d6980816f40f1401e1b35fad01fcd3b69c26e...815279c240e27478aa7ddde349761546a5c474fc,1,1,1,2,1,2014-06-27 15:09:09,2014-06-27 15:09:09
a368c0dd50163fbdc2c9dc72abe2160c9111e64f...8caef610b2548273d48ace696d3a90ba0b510d66,1,1,0,1,1,2014-04-30 17:08:57,2014-04-25 09:23:05
8caef610b2548273d48ace696d3a90ba0b510d66...99284a24e76bf52582e5b70ad28b6371bd4f4b42,2,2,2,4,2,2014-04-30 17:57:10,2014-04-25 09:11:32
a368c0dd50163fbdc2c9dc72abe2160c9111e64f...8116b86e050b23a6b897d90a0d2f8d409e7ec04c,2,2,2,4,2,2014-04-25 12:26:27,2014-04-24 20:01:20
8116b86e050b23a6b897d90a0d2f8d409e7ec04c...586a511cb5e47127a8fd173159fcd43e1b823fe7,3,20,9,29,11,2014-04-25 12:26:27,2014-04-24 20:17:04
586a511cb5e47127a8fd173159fcd43e1b823fe7...f26203cf544db07ae64dffaa495e4217976c0786,3,73,52,125,24,2014-04-25 12:26:27,2014-04-24 20:36:45
f26203cf544db07ae64dffaa495e4217976c0786...6d631968fa095734da5e3483c5d7c43fd5b87146,2,107,83,190,30,2014-04-25 13:21:56,2014-04-24 21:49:44
a368c0dd50163fbdc2c9dc72abe2160c9111e64f...ad924959a9879af7477fa23c19d570882c1f378f,3,98,3,101,8,2014-04-25 02:51:28,2014-04-24 22:59:37
3b279d02184266eace66777b5e48be740c24d035...723d314f097fe7b1e15f27c1d6f05794b6c5f411,1,27,29,56,16,2014-04-26 14:12:09,2014-04-26 13:53:17
41558744432f1399f7c2dd77178bc29ff6747705...6893689336e3cc325d1e6bcc6d61955418186936,1,1,1,2,2,2014-04-28 22:27:32,2014-04-28 16:30:43
8cfbc4466151666417a1245422ce0cb773d6d260...168f8aba74d9c2996acec6fe1b93a2301523e305,3,8,100,108,6,2014-04-08 19:10:47,2014-04-08 16:49:48
8cfbc4466151666417a1245422ce0cb773d6d260...0a6d42e2085b9cd1d057779a5b0a80cd49292c37,1,4,4,8,4,2014-04-08 16:39:25,2014-04-08 16:39:25
8cfbc4466151666417a1245422ce0cb773d6d260...8b2bcd9a4bddf1b99ca201d81ac0a67c2b09fbe0,1,3,0,3,1,2014-04-08 15:07:29,2014-04-08 14:53:16
8cfbc4466151666417a1245422ce0cb773d6d260...a67f3504425a6c3f210aa8117025518d4a2109f1,1,2,0,2,1,2014-04-08 09:47:15,2014-03-24 17:08:14
8329cd55e138fb4c1d18675e2a1c7d8afde61c84...79c11b19ecd506bd76db391b896cec0d4263183d,1,2,0,2,1,2014-03-21 02:13:06,2014-03-21 02:13:06
ccbc4f24d6dfaf9bc265d05ce60257af62170bdb...5a8ffe7ef1c33996b9032fec2cf7cb2bf64793f0,3,10,40,50,6,2014-05-02 00:08:25,2014-05-01 06:03:45
189c600b3ba36934c074eb6769e23989ef22fda7...e8a87120d459dfeffee5474c3253e787d38b2ac0,2,27,9,36,7,2014-05-29 23:32:27,2014-05-29 19:55:59
189c600b3ba36934c074eb6769e23989ef22fda7...72e6e5ff7edc9c054e154897a4c547d89c082293,16,323,225,548,114,2014-05-29 20:16:49,2014-05-28 00:01:08
a278656330271647b9001ca54bc6ee1447a28715...66dd4ea4e280e4acc133872401bf8a79c80510f3,7,1350,28,1378,18,2014-04-10 17:43:21,2014-03-23 23:14:40
a278656330271647b9001ca54bc6ee1447a28715...c8f437aee0d90d4955a6aaa35f8e0b74e7ac99a3,2,61,37,98,5,2014-04-03 23:53:39,2014-04-03 23:14:51
c8f437aee0d90d4955a6aaa35f8e0b74e7ac99a3...76057addb255e6f14dd03c276317abc759a15a80,2,19,19,38,2,2014-04-03 23:53:42,2014-04-03 23:15:56
76057addb255e6f14dd03c276317abc759a15a80...2cb560988b111ee736c4ab22588d2091cb04075e,2,67,41,108,2,2014-04-04 00:02:44,2014-04-04 00:02:44
a278656330271647b9001ca54bc6ee1447a28715...615ac8feb27b2b3db0c06b37ecd87b710eabffef,5,7,29,36,9,2014-04-03 23:52:09,2014-04-03 23:47:58
95d07b52b3b578e514987c06bc71ed027f5b9215...dc7fefc16bfcc4e6d0ccb30233e50b0ab3d172f1,2,18,2,20,3,2014-04-07 18:32:12,2014-04-03 20:50:19
95d07b52b3b578e514987c06bc71ed027f5b9215...32d6041cc30a636de2f8da89f778c4b6c7d4df19,1,1,1,2,1,2014-04-03 20:05:50,2014-04-03 20:05:50
95d07b52b3b578e514987c06bc71ed027f5b9215...3c36f82f181c4ce3b65dd15c4b6cb5699ea75075,1,1,1,2,1,2014-04-03 19:54:57,2014-04-03 19:54:57
95d07b52b3b578e514987c06bc71ed027f5b9215...a9d6eef2386a3d08840e2a30bd8d6f2ae3679688,1,0,34,34,1,2014-04-02 13:22:51,2014-04-02 13:22:51
b4b87413d8d3fd20073975bcc84603fa7853d316...3ee37f547f4685ab88bfc39517cc18c1911451e5,4,13,12,25,11,2014-04-01 22:46:52,2014-04-01 22:46:52
b4b87413d8d3fd20073975bcc84603fa7853d316...f067e263677fc86f9610ca61fbe42f63efad91f2,1,23,0,23,2,2014-04-01 07:11:41,2014-03-25 23:21:07
f067e263677fc86f9610ca61fbe42f63efad91f2...5b9069bd990dca0a35d8e490c6f6b56d27163bb8,1,14,2,16,3,2014-04-01 07:11:41,2014-03-26 00:04:55
5b9069bd990dca0a35d8e490c6f6b56d27163bb8...5bb82f6313d7f789783ffac854be85a44a56617e,7,83,9,92,13,2014-04-01 07:11:41,2014-03-26 06:48:16
5bb82f6313d7f789783ffac854be85a44a56617e...283daced0c919be760947d44d7e46c80e1054d64,1,0,5,5,1,2014-04-01 07:12:50,2014-03-26 06:55:46
283daced0c919be760947d44d7e46c80e1054d64...e36d89b0f9c8ba5b071374310ca632f6b2fdb7a1,1,3,0,3,1,2014-04-01 07:12:50,2014-03-26 06:59:41
e36d89b0f9c8ba5b071374310ca632f6b2fdb7a1...93779cc7fee4ee0690d9dd28eed478a418e79577,2,8,4,12,3,2014-04-01 07:12:50,2014-04-01 00:11:17
93779cc7fee4ee0690d9dd28eed478a418e79577...ac9b06ae95f1da8407934036ab1e4019a96a6b21,1,1,1,2,1,2014-04-01 08:18:52,2014-04-01 08:18:52
be3a5a2e375a3103883529c7da5563d94df036e3...4c3eb7db675c7f8f15ef0d55e99a6699908f930c,1,27,22,49,2,2014-04-08 05:10:40,2014-04-08 05:10:40
be3a5a2e375a3103883529c7da5563d94df036e3...5737c2eb9878e36ee9476e0fd105bcd494252d12,1,10,5,15,3,2014-04-08 04:53:42,2014-04-08 04:53:42
be3a5a2e375a3103883529c7da5563d94df036e3...886eb85dec7f4e9e193151befa7e6b4213ea67a0,1,6,2,8,2,2014-04-08 04:22:03,2014-04-08 04:22:03
be3a5a2e375a3103883529c7da5563d94df036e3...7908725e3f8b3c8a69fc6533f28c6789e4669eb0,8,39,39,78,39,2014-04-08 03:38:30,2014-04-08 03:38:09
be3a5a2e375a3103883529c7da5563d94df036e3...ab248675aa9f32c269e0ecbaf78af29583481379,1,12,0,12,1,2014-04-08 03:32:17,2014-04-08 03:32:17
be3a5a2e375a3103883529c7da5563d94df036e3...603088be928564be2d863a897fbc1729adc74814,1,2,6,8,1,2014-04-08 03:20:03,2014-04-08 03:20:03
02c5a87b402cb1b575d84a86c118a1efcb6abd7f...e6a64af966698d8b9dfe8721ca4404fc06331d69,1,29,33,62,17,2014-04-08 04:25:57,2014-04-08 04:25:57
02c5a87b402cb1b575d84a86c118a1efcb6abd7f...919dbbe44df0722ca35538223a9c89e71856ec88,9,79,142,221,26,2014-04-08 02:12:22,2014-04-08 02:12:22
8c3eb900deb8c244e599b194270c3645c20e0809...b6042f252dd8a0c7a75da481b667f89c2e4ab071,2,20,2,22,4,2014-04-08 01:23:22,2014-04-08 01:23:22
a10a86d437148fe93c0ad128a233f42b17b22700...31c0039022234972c79947a6299c0fa382436487,2,31,4,35,3,2014-09-15 13:01:23,2014-09-15 13:01:23
835800fcd5ac4b2f9a23f3e10b1fae76fb3d1cf8...2e489073d94a7e2a5df115704a484c34f0b59f29,38,68,335,403,163,2014-08-27 18:59:13,2014-08-27 18:59:13
1385b2d2935c0d20e6406a80c62615a8c4cdbcc9...7458a82e0bbf4353729cfac3e1d7159b9d466161,1,68,0,68,1,2014-08-27 18:16:51,2014-08-27 18:16:51
1385b2d2935c0d20e6406a80c62615a8c4cdbcc9...bd049b3800b967bba06d03fd23ab135c51467ae3,1,7,7,14,4,2014-08-27 16:24:27,2014-08-27 16:24:27
bef33cf88a761592d27d554828451f131a53d601...7495fbc0e3f23c932562cb02ea6e7df204d29dfa,3,122,98,220,25,2014-08-27 00:52:58,2014-08-21 21:57:46
bef33cf88a761592d27d554828451f131a53d601...e81b68692408ef717c2228986cc74102cae55772,1,3,0,3,3,2014-08-25 17:29:38,2014-08-25 17:29:38
b5a69da5b67d6b8a9867de974d31cf89329689cf...b1677f9d09d3a66ddf5c22346f0ea2a22cb2560d,1,4,4,8,4,2014-07-13 09:15:52,2014-07-12 22:28:55
b5a69da5b67d6b8a9867de974d31cf89329689cf...56fa079906f19434ddc809cd1dba9dad177187fd,1,1,1,2,1,2014-07-12 19:15:42,2014-07-12 19:15:42
b5a69da5b67d6b8a9867de974d31cf89329689cf...07d93c6e34fb3524add4424f7753253d2501a598,1,76,76,152,42,2014-07-12 15:30:51,2014-07-12 02:28:36
4b1a464ac106b413fc773869adea9c89a08aee3a...cfa4999d695d98f30d942460576d5f9c03a64d92,5,38,0,38,3,2014-07-08 19:34:04,2014-07-08 19:34:04
c3045f563d68217a4f8887c762adb2939378b657...74fdadc86cf8ecb90604f0e2feb087dc82227cb0,5,2451,2401,4852,15,2014-07-30 18:50:33,2014-07-30 02:04:39
5a1e4a1092fca71d886c74ac8d6c59c56f1efaec...2a39635d30a5ecbf3f8020dcb272cd8ae939fe06,3,22,19,41,5,2014-08-15 00:43:12,2014-08-15 00:43:12
8a4f1ad837620ffa4a4d5cc677a3f75a70a3243e...97a38079010bddfe6316c4087c13825fd8df64b7,1,2,2,4,2,2014-07-14 17:16:27,2014-07-10 09:19:18
8a4f1ad837620ffa4a4d5cc677a3f75a70a3243e...32740543daf889388662a963d8a61b1096e75693,1,2,1,3,1,2014-07-14 17:13:46,2014-07-14 16:28:02
d736754a47311025994e748b0fe1ec6c92d59973...c6197058a87e18ba7c7568fbc7d3fb29db79766d,1,1,1,2,1,2014-07-16 00:41:59,2014-07-16 00:41:59
d736754a47311025994e748b0fe1ec6c92d59973...b45e8fa945f9c8ba1fa5ef5ae15a9c2e51a3c926,1,6,1,7,1,2014-07-16 00:17:41,2014-07-15 21:56:48
d736754a47311025994e748b0fe1ec6c92d59973...5b8a6eb05f8c69670814e400f7f85ae221c8bae4,1,12,0,12,2,2014-07-15 23:42:46,2014-06-22 23:33:19
5b8a6eb05f8c69670814e400f7f85ae221c8bae4...3957d72f9cd613fa8a0eeb03517e4f78f9cc58f1,1,9,2,11,2,2014-07-15 23:42:46,2014-07-09 01:47:55
3957d72f9cd613fa8a0eeb03517e4f78f9cc58f1...58955a30ffffb8e9dafb8593f4513d6dae53abfd,3,38,7,45,5,2014-07-15 23:42:46,2014-07-15 00:02:29
9c8b59c1b02dd2d2138fd48aaa27a62b0d09b371...c0471ee35aa58a99b423ad914301194e8f3663c1,2,14,5,19,5,2014-07-15 22:47:00,2014-07-09 17:05:16
683038bf57ce56c2f8eb433eb9bd00b2c17cae92...140337296353b2dd37678b0e30cbf0ebe2cfd9e7,1,11,13,24,11,2014-07-23 20:49:07,2014-07-23 20:49:07
9dc82e6102f25b9d0da1410616a4af830e4349f4...d613f1121751dd76939b9089d60729e6ed6140a6,1,2,2,4,2,2014-08-10 16:47:46,2014-08-10 16:47:46
9dc82e6102f25b9d0da1410616a4af830e4349f4...a1c5f268e5465e0b3cdb4e2a47c0ade3de7988c0,1,3,0,3,1,2014-07-22 17:41:58,2014-07-22 17:41:58
9dc82e6102f25b9d0da1410616a4af830e4349f4...75ba7a9b32bc5904ef1b2751deff94283fce34a5,1,17,0,17,1,2014-07-22 16:34:28,2014-07-22 16:08:41
9dc82e6102f25b9d0da1410616a4af830e4349f4...29f1ed833cc4cb06dc3f65f440736915111152a0,1,1,0,1,1,2014-07-22 10:25:21,2014-07-22 10:25:21
9dc82e6102f25b9d0da1410616a4af830e4349f4...1b31a80eb78789834b8a7d4daff583f0b9a938ed,1,8,7,15,4,2014-07-22 04:00:26,2014-07-22 04:00:26
9dc82e6102f25b9d0da1410616a4af830e4349f4...a091d949acd35d93c4f66af7bfad93a79b591990,1,9,9,18,4,2014-07-22 02:59:44,2014-07-22 02:59:44
a091d949acd35d93c4f66af7bfad93a79b591990...ddb2086ca9e0991ca12e0771a0e581e782c57f50,1,10,1,11,2,2014-07-22 07:16:26,2014-07-22 07:16:26
bb6217c0556709c7e911faa8e968c3f72a38464d...03697f0a93b04122a5039db915afddf60ccec448,1,11,9,20,9,2014-07-24 03:38:36,2014-07-22 07:38:47
03697f0a93b04122a5039db915afddf60ccec448...0fd37bd7ac0f92eda0a55cf2bedf77f1996b8472,2,7,1,8,4,2014-07-24 06:37:06,2014-07-22 06:49:52
0fd37bd7ac0f92eda0a55cf2bedf77f1996b8472...a4d57d8a851bf288804215b39c9d56a51550a228,1,11,12,23,3,2014-07-24 06:45:03,2014-07-22 06:50:27
a4d57d8a851bf288804215b39c9d56a51550a228...d512294382c9013dee2820745db02ab63dc2ecdd,1,2,3,5,2,2014-07-24 07:03:40,2014-07-24 06:53:16
d512294382c9013dee2820745db02ab63dc2ecdd...e4ab996b9d0d97089b076cfef32405f5f3fedc7c,1,3,2,5,3,2014-07-24 07:03:59,2014-07-24 06:55:48
e4ab996b9d0d97089b076cfef32405f5f3fedc7c...386d300a6e07c99380a0814497cf0bc672df1e63,1,23,38,61,13,2014-07-24 07:03:59,2014-07-22 21:23:52
386d300a6e07c99380a0814497cf0bc672df1e63...c765134ac954f54f8b6aca6df25cf5e28911b563,1,1,4,5,1,2014-07-24 20:19:20,2014-07-24 19:34:11
c765134ac954f54f8b6aca6df25cf5e28911b563...2fb63aba0bf991873d56888f244d6aeee0c5fc57,1,35,26,61,11,2014-07-25 16:33:04,2014-07-25 16:33:04
2fb63aba0bf991873d56888f244d6aeee0c5fc57...c7a2e86b5186acb58999d7b2b3a85a9bb4421b1f,1,12,14,26,5,2014-07-27 03:00:08,2014-07-27 02:44:23
c7a2e86b5186acb58999d7b2b3a85a9bb4421b1f...81c7d28b842844778a652b7353f52332f4276afb,2,72,73,145,10,2014-07-27 03:00:18,2014-07-27 02:48:02
3de3719290d63e1827ad61c84256e5cc219dea91...bcfd6a653b5038679246b023d83476be073d4c91,1,1,1,2,1,2014-08-12 23:37:33,2014-08-12 23:37:33
0fc304ce3252f9489c227f711755625058aee1f3...103ae23504b9fdc52e4f7d4a50798553af09bfe5,1,3,3,6,2,2014-08-01 01:15:16,2014-07-03 09:58:13
103ae23504b9fdc52e4f7d4a50798553af09bfe5...63a4ba229cd3da6ce7bc52e6b9f78d9cd631398d,1,1,1,2,1,2014-08-01 01:19:30,2014-08-01 01:19:30
bbca4867f8f5ecda47c7e34ddc3544aff8f2e3bd...294f33b37a2d029164728534e781bc118d6689c2,1,1,1,2,1,2014-07-31 05:50:05,2014-07-31 05:47:49
bbca4867f8f5ecda47c7e34ddc3544aff8f2e3bd...419b9fe16425c301855aab781e1386f7a227a09d,2,6,7,13,2,2014-07-30 09:26:51,2014-07-30 06:37:12
419b9fe16425c301855aab781e1386f7a227a09d...a7d8c732b1760fcb3d5fb99c035a34123809e9cd,2,7,7,14,2,2014-07-30 09:26:51,2014-07-30 06:44:34
a7d8c732b1760fcb3d5fb99c035a34123809e9cd...e92a9e0b53d296f6e0caa925a56ebbd76b20acaa,2,12,12,24,3,2014-07-30 09:26:51,2014-07-30 06:51:03
e92a9e0b53d296f6e0caa925a56ebbd76b20acaa...4949e070fbcac1ef9fbeabe59e3f39cdb830e5fd,2,30,32,62,8,2014-07-30 09:26:51,2014-07-30 06:51:43
b5ef212ec17932dc159a44f2a77c6e9d4cf4ee9d...f4db3985d9b6ce481437c9524bb33640d602a2cb,15,503,42,545,39,2014-07-31 18:46:35,2014-07-29 19:35:49
f4db3985d9b6ce481437c9524bb33640d602a2cb...57b9467f45571c1bd98ebe4b73c6cf3d97ff051c,4,7,4,11,6,2014-07-31 18:46:36,2014-02-23 03:06:37
57b9467f45571c1bd98ebe4b73c6cf3d97ff051c...f34d0e55f3a1f15abf28680d84ab48d40ffafbc1,4,1,352,353,5,2014-07-31 18:46:39,2014-07-29 17:08:10
f34d0e55f3a1f15abf28680d84ab48d40ffafbc1...8ea72422502d65421bc36dda48d384588f519a77,1,1,1,2,1,2014-07-31 18:46:41,2014-07-31 18:45:32
615f211084d21a2c7ef930b59813651943afcc41...4002b4623c91d94d93f8575c4a554392202aa44d,3,42,23,65,16,2014-07-22 20:14:42,2014-07-21 20:53:58
da40d9b7a50704b0ff28f885dc4e87ffb77cd01b...77237be0e23dfaba4d4d97a525c3ecc7fb819042,1,6,1,7,1,2014-07-28 16:01:43,2014-07-28 16:01:43
77237be0e23dfaba4d4d97a525c3ecc7fb819042...704b97d1c4cc6eaa6ecf9630eed2dffd5abaffb9,1,13,4,17,4,2014-07-28 18:43:28,2014-07-28 18:43:28
69aa07af1ef72f08b16f04010704ade669db28df...78ac75fe00669f8d24ecab3273d47e805963e4d3,1,6,4,10,1,2014-08-01 22:26:30,2014-08-01 22:26:30
78ac75fe00669f8d24ecab3273d47e805963e4d3...8266c381d62a0790c489e27cc93ed8f4618d03c7,1,3,2,5,3,2014-08-01 22:59:19,2014-08-01 22:59:19
ca602cd1e5b98c4fc82a50d3a03bcf6e22d9f67b...a5c5dc121c794daa199a813a95c0affd766a18f4,15,50,65,115,20,2014-08-01 22:58:01,2014-08-01 02:26:32
f72a31ae31acae3af54f48c936e72536cc10c4c7...55d645246aa61f74cf5cdc9c5dbb16828371cdd9,3,28,29,57,11,2014-06-08 20:57:34,2014-06-08 20:55:41
f72a31ae31acae3af54f48c936e72536cc10c4c7...90251a488d87614770ce7c10265e0b3c8d7f2f9b,2,4,2,6,2,2014-06-08 20:51:13,2014-06-08 01:03:47
c9f216d2faa0b5eade0f9d0e1a8bd8cbe886de3b...ef364f7e1faedddab502cf91c0551154c6c48176,40,205,198,403,129,2014-06-08 21:54:32,2014-06-01 20:48:04
a60537992710edce4095b987f6e19ad0aea34ffa...f2baa364a13ea3e22719e3637bf6f5f42e5dc677,1,1,1,2,1,2014-05-27 21:03:12,2014-05-27 21:03:12
a60537992710edce4095b987f6e19ad0aea34ffa...b9de22e82860a7e389f356d349ccb61b7d530c54,2,4,6,10,4,2014-05-27 20:38:24,2014-05-27 20:38:24
b9de22e82860a7e389f356d349ccb61b7d530c54...5310e8575f5a251000bbecd6d998eb11cb95fe04,1,3,1,4,3,2014-05-27 20:52:05,2014-05-27 20:52:05
2330be2adc1efe35b0f09af69287a5bd58ee7456...35d08bdd01e3c63414d7998efc0813803e2ba5d9,1,3,0,3,1,2014-05-28 19:07:27,2014-05-28 18:27:03
35d08bdd01e3c63414d7998efc0813803e2ba5d9...7f5cd76824b500418ed168dfcfeb73de8badcb51,1,12,15,27,4,2014-05-28 19:07:40,2014-05-28 18:44:24
05cf3498a69c271345313ccd38b2de2ae325406f...0658868c7f81dd225df8678f31f7ef70274d8d94,1,1,1,2,1,2014-05-31 20:55:59,2014-05-31 20:55:59
05cf3498a69c271345313ccd38b2de2ae325406f...f9705477d023c63fb316a30204761aa1e3cb3e6d,1,2,0,2,2,2014-05-31 17:42:48,2014-05-31 17:20:07
05cf3498a69c271345313ccd38b2de2ae325406f...05e9574cf34b4615030d23a0f816cc309aa2e949,2,81,0,81,2,2014-05-31 11:37:56,2014-05-31 10:58:58
05e9574cf34b4615030d23a0f816cc309aa2e949...d9885abdc4a7e028092fc18715b69075bb7c2f8d,2,2,20,22,2,2014-06-03 10:41:32,2014-06-03 10:41:32
a6577708abc9370cfe7603a543eb68ad0e37d7e3...955bfda99a991e71af3352d18a007d39970cc508,1,6,6,12,3,2014-05-24 14:20:59,2014-05-23 08:29:50
a6577708abc9370cfe7603a543eb68ad0e37d7e3...328d2cba116067a2ad0f161b9ee098ed024825b3,1,9,1,10,3,2014-05-24 01:01:19,2014-05-23 07:48:01
328d2cba116067a2ad0f161b9ee098ed024825b3...ff24a328765335d9bff1babaac4fac6cf4180af6,1,128,0,128,1,2014-05-24 01:01:20,2014-05-23 12:42:46
a6577708abc9370cfe7603a543eb68ad0e37d7e3...1e74cd0e01009bfa8afb6058f748f282da5200d0,1,1,1,2,1,2014-05-23 16:36:27,2014-05-20 21:38:41
a6577708abc9370cfe7603a543eb68ad0e37d7e3...0c0ffb777354ab0d65fdb92fac47272584b2d217,1,1,1,2,1,2014-05-23 16:27:09,2014-05-23 16:27:09
a6577708abc9370cfe7603a543eb68ad0e37d7e3...2a35e41a9c825b6891440015ae95633fb84b9604,2,90,0,90,2,2014-05-23 15:46:01,2014-05-23 13:53:11
2a35e41a9c825b6891440015ae95633fb84b9604...1cb2570a276020749a0b87444b17f4e6ce78b92d,1,8,7,15,7,2014-05-24 13:33:41,2014-05-24 13:33:41
1cb2570a276020749a0b87444b17f4e6ce78b92d...b7e88250f421d34d25f89737c65954150248ee28,1,3,4,7,3,2014-05-27 13:59:30,2014-05-27 13:59:30
a6577708abc9370cfe7603a543eb68ad0e37d7e3...a3ff8a98f770ae35103e3ce3c4221c00b4efcb7f,1,4,0,4,1,2014-05-23 15:43:46,2014-05-23 15:43:46
a6577708abc9370cfe7603a543eb68ad0e37d7e3...c0529e5fc1a50f6fff47646bcc2461aeef20f906,1,26,42,68,13,2014-05-23 15:18:00,2014-05-23 15:18:00
a16cb394fa4ea2c1d4241f184d23380d5b2c9fa0...9810da853bd890b6c963017555c3555ef9e0d842,1,3,0,3,1,2014-05-20 21:31:28,2014-05-19 21:24:33
9810da853bd890b6c963017555c3555ef9e0d842...bcfe2ceffb1c4c7006570d4ba21ed2068bb448a1,1,9,2,11,4,2014-05-20 21:31:28,2014-05-17 21:09:05
bcfe2ceffb1c4c7006570d4ba21ed2068bb448a1...03a109e446351ba40ea5d74e8eb6733b2a9a5045,3,35,0,35,3,2014-05-20 21:31:28,2014-05-20 21:29:19
a16cb394fa4ea2c1d4241f184d23380d5b2c9fa0...d98af1236c9aeef6f9eef34970e13cbe0ea06ff8,30,659,136,795,89,2014-05-20 21:23:50,2014-05-20 21:18:52
83e9dc720039cfa8685b8dc59f76ca2f1e9489d2...8e967fe8028d8362fe3dfb293a8e07a959a4dd7f,3,0,3,3,3,2014-05-21 20:28:19,2014-05-21 20:28:19
83e9dc720039cfa8685b8dc59f76ca2f1e9489d2...cfe7211a2241b5e898af11445a2470032b0ab242,1,2,2,4,1,2014-05-21 11:00:38,2014-05-21 03:39:57
83e9dc720039cfa8685b8dc59f76ca2f1e9489d2...789a8f26161ca86a721fe6b7295e3eaf9051b3a2,1,1,1,2,1,2014-05-21 04:33:40,2014-05-21 00:20:26
83e9dc720039cfa8685b8dc59f76ca2f1e9489d2...34c05c58c8d41ee2bb02cd8059e9928ee2f061ea,8,83,34,117,22,2014-05-20 22:51:24,2014-05-20 00:13:00
34c05c58c8d41ee2bb02cd8059e9928ee2f061ea...ed5892ed4efa995950e2fdeb5fd718b3bb1aa1c2,1,77,23,100,4,2014-05-20 23:34:46,2014-05-20 23:34:46
ed5892ed4efa995950e2fdeb5fd718b3bb1aa1c2...f042c3c15759fce5cc139f2b3362b791ac7d4829,6,25,30,55,9,2014-05-21 00:40:41,2014-05-21 00:36:50
894814f708a324af97370cf576d1d09a53d87480...0d1906feea511cbfd1695adbb0b39dfdfae2caeb,1,3,3,6,2,2014-06-05 01:30:10,2014-06-05 01:30:10
0a725ea28259f8a0f9a1de5730fd99675b942dde...8497d1274b046804999699ccb66b11a3249906a1,1,7,8,15,4,2014-06-05 00:54:00,2014-06-05 00:54:00
8497d1274b046804999699ccb66b11a3249906a1...7eb508633db93213404292bd4fd21b6855f45bea,1,2,1,3,2,2014-06-05 01:03:17,2014-06-05 01:03:17
6be75947abd788773ae02ffd9e2a4dd7dcd3e871...09b19752e028f91644e3e2801f0fd616c4adc683,1,36,41,77,16,2014-06-05 21:58:04,2014-06-04 20:17:21
09b19752e028f91644e3e2801f0fd616c4adc683...abcb724ed90a1e68234bd9c1c0d9263557b67026,1,12,6,18,4,2014-06-05 21:58:05,2014-06-05 21:50:04
c06f32a7b9cb1cd40265a1cd42d52ed246cbe1e7...8f99875d030cb282090d41fbbf8669169fbc9e2f,1,3,3,6,2,2014-06-08 04:15:37,2014-06-05 01:25:55
c06f32a7b9cb1cd40265a1cd42d52ed246cbe1e7...14680bf724161785d164fd99de36e3eb03a823ef,2,13,1,14,2,2014-06-06 00:59:19,2014-06-06 00:59:19
acb9f156fdf7f992d73a70c2697b62e3eb17bfc9...34bd2d622910444ae0d30bd0ac32005e224074c1,1,21,10,31,9,2014-06-06 00:31:58,2014-06-06 00:31:58
34bd2d622910444ae0d30bd0ac32005e224074c1...30ba7546cb5a1ff7e4915c5a25dd8d72b3bf735b,1,1,0,1,1,2014-06-06 00:32:14,2014-06-06 00:32:14
acb9f156fdf7f992d73a70c2697b62e3eb17bfc9...3986bc659be9ff83d521f82e3353b1f73b896cbc,1,1,0,1,1,2014-06-06 00:03:32,2014-06-06 00:03:32
559dc9a66a513b827cb0e4d1e3917cf1da7d8e7f...412324cfbe9b5e256d9af31b21e6ae142d39612c,1,4,2,6,1,2014-05-05 18:12:25,2014-05-05 18:12:25
559dc9a66a513b827cb0e4d1e3917cf1da7d8e7f...71e3757174c3c1617d636ddd7462c39617ba5a77,1,2,0,2,1,2014-05-01 22:51:38,2014-05-01 22:51:38
559dc9a66a513b827cb0e4d1e3917cf1da7d8e7f...1c4202a6142d238d41f10deff1f0548f7591350b,7,112,66,178,30,2014-05-01 22:26:58,2014-05-01 01:00:42
1c4202a6142d238d41f10deff1f0548f7591350b...83982e8b1d0cd825e1762b5540db8ae77c34f065,3,11,1,12,3,2014-05-01 22:26:58,2014-05-01 02:09:25
83982e8b1d0cd825e1762b5540db8ae77c34f065...f5139233b930e436707a65cc032aa2952edd6e4a,8,54,107,161,35,2014-05-01 22:26:58,2014-05-01 17:08:18
f5139233b930e436707a65cc032aa2952edd6e4a...3f74bdd93f08b3001f11a137210ee67a6d23c084,1,4,7,11,2,2014-05-01 22:26:58,2014-05-01 18:11:29
3f74bdd93f08b3001f11a137210ee67a6d23c084...24e0df8136c238cb3e231b939a82058950e6eb02,1,1,2,3,1,2014-05-01 22:26:58,2014-05-01 20:55:23
24e0df8136c238cb3e231b939a82058950e6eb02...76fa7d588adfe644824d9a00dafce2d2991a7013,5,12,37,49,9,2014-05-02 02:09:12,2014-05-02 02:09:12
de191e86321f7d3136ff42ff75826b8107399497...91b5fe85029cfab2b7f8c55859e0fae999e9f968,1,2,0,2,1,2014-05-01 22:48:16,2014-05-01 22:48:16
ddd0470ed1487f1b12286f3213e1d8e98021509d...91b7d8ebd31dba64b551de85e70786c568cb402a,15,185,6,191,12,2014-05-07 16:40:22,2014-04-09 14:21:22
b622da3cfe211d31df69e72a93ed4fae872aca65...cfb232cff27da2dd46ec04a5bf6699ab1d1df91c,2,38,27,65,2,2014-05-06 23:40:49,2014-05-06 23:40:49
2c32c195d972045422b6e2618cc9ef48b275f89a...fa29b1f062d25c1a8ca62f02b9cc7533df4c7449,58,126,71,197,93,2014-07-03 00:31:56,2014-07-02 00:30:25
9fe95f1c5bae60bad72f056b109e4b1b694d7dc0...f8d9ecfb2ceda0cc2aed3d8fd3fbcbf625a8fcdd,13,13,70,83,26,2014-07-03 01:07:42,2014-07-03 01:07:42
3f18afc94c8b8700884c052c869026ae26c45bb3...17d870bed5ef997c30da1e8b9843f4e84202f8d4,10,58,9,67,14,2014-07-01 00:30:21,2014-06-08 06:37:31
17d870bed5ef997c30da1e8b9843f4e84202f8d4...957c510d729ac3dcbe892b145fb2d9ed766be2ca,4,11,3,14,5,2014-07-01 17:10:00,2014-07-01 00:39:38
40882cc0b676d00b52e43b9a42d67381f587f80d...e83fc70d362bf0035811bbcc5566020c6cc9893f,2,27,0,27,2,2014-04-27 01:55:39,2014-04-25 20:21:28
1bcb9ce69e62476a8ff80d210aad85d86a72dd7b...4f828d67f00449182eaada50dfba37e00f8f01ef,2,37,7,44,7,2014-04-08 18:09:31,2014-04-08 17:10:51
29fd62f396c0f526138fe68792cdebde423c4790...fa5223dab5b9f5cef2a0a341ee5065fec9c6d663,1,27,0,27,2,2014-04-08 19:07:16,2014-04-08 18:59:02
fa5223dab5b9f5cef2a0a341ee5065fec9c6d663...a2aa902ec194169431fea6784c4a7cdab25aaf24,1,7,7,14,7,2014-04-08 19:07:27,2014-04-08 18:59:36
14502f0f1cea7ccb7433374484e90efb5551187d...4002eac8b8b4007de03e78dbd57232fac583d05b,1,3,0,3,1,2014-03-21 06:28:02,2014-03-19 03:05:54
148e081ded30425d4e9dbafe93191722b314ad93...41db1756268376465fd92038dfba1cca7f219595,1,11,1,12,2,2014-05-02 00:46:41,2014-05-02 00:46:41
107cd5dd5f0280064c00f3e6368ac7e3b6d0261c...23dd221e5250398d4120a1f3d1bcb591923f4892,2,52,0,52,2,2014-05-30 01:16:38,2014-05-28 04:42:19
dbd1e304f57c40d0cac925727832d588d453c414...b2b9334f27e1a773b77241efa214af2e87439d3b,1,1,1,2,1,2014-04-04 00:08:51,2014-04-04 00:08:51
09aa28eca049320f53300f9d7ba9bc28c1033d3b...e09274476f889c08416a819dfb28f2c425868c6b,10,17,17,34,14,2014-04-04 00:22:32,2014-04-04 00:22:32
9e29d65aad429978cfcfde7f447cabec3c6acc0b...887eeb2b022a4c6d3de8c9bfc586ee82855d3cb9,1,2,0,2,2,2014-04-03 21:55:33,2014-04-03 21:55:33
031e2880756155c26a2eac0e81275b7e0330db39...95e6fd819bbef09032bf680e0f7dadd7fbf44559,2,19,19,38,2,2014-04-04 18:29:56,2014-04-04 18:29:56
95e6fd819bbef09032bf680e0f7dadd7fbf44559...4c6cf9e27fd0ee6c09e836f03722d1c679b6bd29,1,1,1,2,1,2014-04-04 18:37:08,2014-04-04 18:35:07
4c6cf9e27fd0ee6c09e836f03722d1c679b6bd29...07887f65de7f909e56bf965b3875a1dd46bd3619,1,1,1,2,1,2014-04-04 18:38:03,2014-04-04 18:38:03
031e2880756155c26a2eac0e81275b7e0330db39...62b08f557db91cc5cd12ea9ceb0a4d8cf3d6e0f1,2,5,2,7,3,2014-04-04 16:03:07,2014-04-04 16:03:07
62b08f557db91cc5cd12ea9ceb0a4d8cf3d6e0f1...22152ccc47e641050da85b80cebf2912b42fd122,1,1,1,2,1,2014-04-04 16:06:55,2014-04-04 16:06:55
031e2880756155c26a2eac0e81275b7e0330db39...bea71245c8165e0dfdc6b2485c548c04f4d3edd3,1,2,2,4,2,2014-04-04 12:12:17,2014-04-04 12:12:17
bea71245c8165e0dfdc6b2485c548c04f4d3edd3...9c4d10b9a91b9f11794ceb094331496c733410bb,1,3,3,6,3,2014-04-08 02:09:15,2014-04-08 02:09:15
031e2880756155c26a2eac0e81275b7e0330db39...81370b5b0fc6788bbde32fd9f39c6eee1bcb0c2e,5,118,10,128,9,2014-04-04 06:41:33,2014-04-04 06:37:50
81370b5b0fc6788bbde32fd9f39c6eee1bcb0c2e...919fe7a3a19d79dcbc92050325f46d7a7eb50ebc,4,0,108,108,4,2014-04-04 06:46:47,2014-04-04 06:46:47
a9d6eef2386a3d08840e2a30bd8d6f2ae3679688...7c3b955b907c33238c1c155ae8860b2cec929c8b,2,7,44,51,7,2014-04-03 22:03:23,2014-04-03 22:02:03
795d6b8b150db03c62403ab5fbefa5ca7488c2bf...9260c06f7a7cb172205dc45af96870ec0d02ebcd,1,0,1,1,1,2014-04-08 20:58:19,2014-04-08 20:58:19
795d6b8b150db03c62403ab5fbefa5ca7488c2bf...77a04357a1b66b9e5b2bae2efc0192b927f926fe,1,0,28,28,1,2014-04-08 20:56:30,2014-04-08 20:56:30
75fd1b614dfd5acd36975357b51341585f89003c...c980fe09b77700fcaf47459e91a149876b7abef9,1,19,0,19,1,2014-10-17 22:52:48,2014-10-08 21:55:02
88a786d3c4475e7aa14c35e4ef02cf52e37b43df...ada883b198aa5e7a42d344174dcec04933c6fb2a,2,19,1,20,2,2014-09-15 21:13:54,2014-09-15 21:13:54
88a786d3c4475e7aa14c35e4ef02cf52e37b43df...448c8ecb0fb453bb29fcada5e7486355ccfadbe9,4,18,0,18,3,2014-09-15 19:05:01,2014-05-21 21:13:53
448c8ecb0fb453bb29fcada5e7486355ccfadbe9...0ecafb8a6909f5d342246aefb9ac97350cef6558,2,20,11,31,4,2014-09-15 20:08:05,2014-09-15 20:08:05
88a786d3c4475e7aa14c35e4ef02cf52e37b43df...788e4acaa3883bc7369f9462f107266b41c59746,2,2,1,3,2,2014-09-15 17:45:06,2014-09-13 23:03:35
88a786d3c4475e7aa14c35e4ef02cf52e37b43df...f3c767d798f945192d32441cf624bdd54e746b74,6,135,13,148,21,2014-09-15 16:57:52,2014-09-04 05:29:19
f3c767d798f945192d32441cf624bdd54e746b74...5130fe5d38837302e72bdc5e4bd1f5fa1df72c7f,7,278,21,299,21,2014-09-15 16:57:52,2014-09-09 04:19:32
5130fe5d38837302e72bdc5e4bd1f5fa1df72c7f...985d57958675ee11e23070e009605c8968d547cf,6,156,9,165,16,2014-09-15 16:59:03,2014-09-09 05:51:53
985d57958675ee11e23070e009605c8968d547cf...e1cf95b593a57e0c8f15d50bb3e5e8ccfb55defa,4,13,15,28,8,2014-09-15 16:59:05,2014-09-09 17:36:13
e1cf95b593a57e0c8f15d50bb3e5e8ccfb55defa...d130c10ab78417ebf64284c2a399304767446c88,2,36,7,43,6,2014-09-15 16:59:05,2014-09-10 07:20:05
d130c10ab78417ebf64284c2a399304767446c88...e1818d2a69e691acc9fa8d05ee87c07b2e474a0c,1,30,0,30,1,2014-09-15 16:59:05,2014-09-10 07:39:20
e1818d2a69e691acc9fa8d05ee87c07b2e474a0c...d980589de6e086d1b4c62cc7495bd952c394890b,1,75,0,75,1,2014-09-15 16:59:59,2014-09-10 23:49:18
d980589de6e086d1b4c62cc7495bd952c394890b...669561c2aa8966f9327eca4304a06168bcf5bc49,8,18,21,39,17,2014-09-15 17:00:00,2014-09-11 00:06:59
669561c2aa8966f9327eca4304a06168bcf5bc49...0029180f7feb59fd0e4fede0bb839e2aa4968811,3,0,134,134,3,2014-09-15 17:06:07,2014-09-15 17:06:07
0029180f7feb59fd0e4fede0bb839e2aa4968811...bfebdfde78753f85d53d62634654de0b80f6872d,5,219,44,263,37,2014-09-15 22:56:47,2014-09-15 22:56:47
bfebdfde78753f85d53d62634654de0b80f6872d...39030382c4809029cc3897e59f97948b00d57ad1,1,15,3,18,5,2014-09-15 23:14:04,2014-09-15 23:14:04
39030382c4809029cc3897e59f97948b00d57ad1...c786a8ee5e9db8f5f609cf8721bd1e1513fb0043,9,208,35,243,29,2014-09-16 19:24:25,2014-09-16 06:43:43
e0db426ff635f09df2f603caa7791e763bdb076d...9a2d4e92730a576a05e40f7575a6c90512896e87,1,1,1,2,1,2014-09-02 19:10:47,2014-08-27 19:21:56
e0db426ff635f09df2f603caa7791e763bdb076d...3304d4e98479e54eb9580ce1c42adfb085cfa374,2,2,1,3,1,2014-08-27 21:16:29,2014-08-27 21:16:29
0cb672e6a9ef1a0825f395db203fa675045f7844...8c6c4a12b7bd53c01998988593789aa16a6d9ac8,5,73,23,96,25,2014-08-27 22:50:50,2014-08-25 01:53:31
9d6f295d5d019cf95bec3e607e1bd6cb0b42e310...5105981431def23a7424a0c0c09095d815243ea9,1,1,0,1,1,2014-07-14 22:38:23,2014-07-14 21:54:55
5105981431def23a7424a0c0c09095d815243ea9...076ac1d7d212c3a81a401a2fba8b9965bc26df16,3,1,14,15,2,2014-07-14 22:41:07,2014-07-14 22:39:42
076ac1d7d212c3a81a401a2fba8b9965bc26df16...0bde827c3f01fc5ae99eb0b93170e75c99cd5d77,1,1,0,1,1,2014-07-14 23:08:38,2014-07-14 23:07:40
e20a95f24c4de02747a3f94b7196863a046951bf...6e0f072e36d7b367bde7b5c34fda9c47f36af2da,1,5,0,5,1,2014-08-07 07:06:09,2014-08-07 06:39:14
5631ffbdfd252c369d393e41ee86008ab2d7eb7c...6fdaa66652d65558d8225d58f3ac48904ebac1de,1,6,1,7,1,2014-11-05 00:46:41,2014-10-01 20:17:29
5631ffbdfd252c369d393e41ee86008ab2d7eb7c...bc62a35ffb2eeacb3ae79bc65076a01744d78a5d,1,16,15,31,4,2014-10-31 01:28:37,2014-10-26 19:42:51
5631ffbdfd252c369d393e41ee86008ab2d7eb7c...6e208b7f1c8130735018940ff95bf8b3662cab72,1,1,1,2,1,2014-10-27 02:57:52,2014-10-27 02:57:52
5631ffbdfd252c369d393e41ee86008ab2d7eb7c...ce407ccff4fb4245384e50d86870d2e247cd43ec,1,1,2,3,2,2014-10-26 05:55:29,2014-10-26 05:55:29
8162c6eeddccb6e74c1982206f40f72129dcca82...a7134132933d899f30ab775ac9604ff4e87d7c8d,1,6,3,9,2,2014-07-30 19:36:16,2014-07-30 14:20:52
101c749b6533ab309eccea6b6c6173a0c25f787d...57564d91a4128f7ee2952e7bdbda54463deac03b,1,0,2,2,1,2014-08-15 17:52:44,2014-08-15 17:52:44
c838a4be2921f76bfaab2ef2641b8c2562c7b2dd...4fbc47e801531ae1738bb8d4cec0ee2450ccfcb9,1,1,1,2,1,2014-07-24 23:07:40,2014-07-22 20:05:39
c838a4be2921f76bfaab2ef2641b8c2562c7b2dd...d0cbc54f234b01585670e19b49a8c931b2719472,1,18,3,21,4,2014-07-22 22:15:29,2014-07-22 22:13:52
c838a4be2921f76bfaab2ef2641b8c2562c7b2dd...7407664c6621782101f73162b7f0ad76a53fa46b,1,1,0,1,1,2014-07-22 20:08:28,2014-07-22 20:08:28
c838a4be2921f76bfaab2ef2641b8c2562c7b2dd...588090c49bf2ec077626d89196515e6bef1f7a69,1,1,1,2,1,2014-07-22 19:16:50,2014-07-22 19:16:50
4eaacb6b88a2cf0ebeb8b4eebe4659e1451d1cec...fa5bce2859e0b0fc3eeade3a97777d371fceca3a,1,0,1,1,1,2014-07-16 01:46:18,2014-07-16 01:46:18
3b3f0fa085c9a5208587c1ac2e69c2e9f8d727ed...1476f295aca20e1c35383c133219d54a5373183f,2,49,1,50,2,2014-07-17 17:47:33,2014-07-16 17:47:12
3b3f0fa085c9a5208587c1ac2e69c2e9f8d727ed...ffe885ec0e8a06c1614949bf383f6d1532f02c1d,1,2,3,5,2,2014-07-17 11:27:29,2014-07-16 14:09:17
3b3f0fa085c9a5208587c1ac2e69c2e9f8d727ed...f861bfd9ff57e87805252d27da3a9cb18f60974b,1,1,0,1,1,2014-07-16 10:23:25,2014-07-16 10:22:13
3b3f0fa085c9a5208587c1ac2e69c2e9f8d727ed...c5f55a233de09f8aa4ce7f061e8da2d435017fef,1,1,1,2,1,2014-07-16 09:18:08,2014-07-16 09:12:14
a491d204a0e38f8e42d1f2edfd6e08bc0cd61a50...ea7b8ea03f5c2222060afe435e907c1ab855a44b,1,11,11,22,4,2014-07-22 22:39:59,2014-07-22 06:58:59
9380e8cbe71f18f20293408246f3652e1c5c9b33...be326b0ece345e7f28d663ac06c8614d58070326,1,3,3,6,2,2014-07-24 15:06:20,2014-07-24 13:48:20
9380e8cbe71f18f20293408246f3652e1c5c9b33...2819d9b4062914daa5b6bd4d08676807859eae3f,1,1,1,2,1,2014-07-24 12:48:23,2014-07-23 12:44:17
9380e8cbe71f18f20293408246f3652e1c5c9b33...5b0d4cf29629eabb8855400159c097cbd7502922,2,120,0,120,3,2014-07-24 07:19:16,2014-07-24 07:19:16
885cda1ae252b2ca6d256410cc0bb8c0dc7e8823...7365225957046cf6364b30c56f3585d9c29098e5,1,61,0,61,1,2014-07-24 18:04:58,2014-07-23 03:44:35
885cda1ae252b2ca6d256410cc0bb8c0dc7e8823...455e837e207a01153947fc81e3a22d6bb37d2c89,1,7,5,12,6,2014-07-23 14:21:16,2014-07-23 11:11:14
885cda1ae252b2ca6d256410cc0bb8c0dc7e8823...0a4b39b6a4e9faeea5d8c679e7b03e317a7b02f9,1,2,2,4,1,2014-07-23 08:23:14,2014-07-23 08:23:14
885cda1ae252b2ca6d256410cc0bb8c0dc7e8823...29ecc95c31ecfe15e3b3d8db94cea1c555e526a3,1,1,0,1,1,2014-07-23 05:57:41,2014-07-23 05:57:41
885cda1ae252b2ca6d256410cc0bb8c0dc7e8823...5743cc3423b48a0a3c78c7640bb10d840c911604,8,74,45,119,47,2014-07-23 02:40:10,2014-07-23 02:40:10
136631df46aea853d968f6f8c284381c2ee91604...b06311a72e7979653f09ba8175e10733e7116985,3,17,25,42,7,2014-08-13 00:03:56,2014-07-29 07:14:10
4949e070fbcac1ef9fbeabe59e3f39cdb830e5fd...c2496d97cc58e0720988acf4e989689945bb3a54,5,123,101,224,8,2014-07-30 11:20:31,2014-07-30 08:16:23
c2496d97cc58e0720988acf4e989689945bb3a54...0af7b5f83d7f66a013e9bd66a9b4066a1de4eae8,2,11,0,11,2,2014-07-30 11:20:33,2014-07-30 09:12:38
0af7b5f83d7f66a013e9bd66a9b4066a1de4eae8...42a77de3d3867e2f34b455fc343e293eed994dcd,4,24,18,42,5,2014-07-30 14:01:40,2014-07-30 09:13:53
42a77de3d3867e2f34b455fc343e293eed994dcd...63bd4ad9d6d0c55691ff33cbfd24684ef91649e4,4,19,17,36,4,2014-07-30 14:01:43,2014-07-30 09:35:39
a0dad3dfb22a5d09d01bb886caece26950d17b61...331200cbaae75a2876bac037c8df2e609bab9658,1,1,1,2,1,2014-07-28 20:39:17,2014-07-28 20:39:17
3c1212ca3009dd5e8c89bfe6ab5bf42756c05da9...047ce47d92c94a5c406d12238004e6f35d92fdd3,1,64,0,64,1,2014-08-05 18:36:39,2014-08-05 18:07:56
3c1212ca3009dd5e8c89bfe6ab5bf42756c05da9...a49de2c46713149053b0ee25313c6f7a39273c25,2,9,9,18,6,2014-08-05 00:36:53,2014-08-05 00:17:23
e9b4cafd8dc2429124b08c2694f20d196f42f533...4909a702045e621f236f5ec5470c8a9ec7fd7022,2,2,12,14,2,2014-08-01 23:30:34,2014-08-01 19:22:04
4909a702045e621f236f5ec5470c8a9ec7fd7022...6b04d597ee759ec72f95f9bde58716eda8495519,1,6,8,14,3,2014-08-01 23:30:58,2014-08-01 19:23:09
8f4b477c3263bc11c1ecc837d5a3f9aa663eff1c...b4813f2841638be28208b7b1602f12750a46ece9,4,37,5,42,6,2014-08-05 20:43:42,2014-08-05 20:43:33
d87fdaa1e39049199a2a3b30cbb1069576a9959c...b0a46d1cb981418f6447b7bc43db907367b77829,2,73,73,146,65,2014-06-08 23:34:47,2014-06-08 23:34:47
d87fdaa1e39049199a2a3b30cbb1069576a9959c...78426304803bc651fec3ae9b42cf5983d6e03370,2,0,12,12,2,2014-06-08 22:35:32,2014-06-08 22:35:32
cfded04ac2878f0252c6c0e865151c34fb9ee372...efa79a09a92b41b07d0aee3c728d98eec5120730,1,1,1,2,1,2014-05-23 20:32:43,2014-05-23 20:28:32
efa79a09a92b41b07d0aee3c728d98eec5120730...886d3c939687672c6589120229c05435273b7d59,1,2,3,5,1,2014-05-23 20:32:43,2014-05-23 20:29:31
0874b856271a4d5c05cfcbaa1efac482e7a91bc3...321b457044f287435780274bef0b4a65231892bc,1,59,0,59,1,2014-05-23 20:42:43,2014-05-23 19:45:53
0874b856271a4d5c05cfcbaa1efac482e7a91bc3...9429fe6f49a4396cdd0ab2f0b88240ff0239a070,1,1,1,2,1,2014-05-23 19:15:44,2014-05-23 19:15:44
b51802a47ce666e20e6638955d383763d99a04d7...953abf6ae7b31a3563fa57a9898305018add0571,1,22,6,28,4,2014-05-31 22:31:33,2014-05-20 05:54:10
4edcbfdeb7d056f47f2eba13c6e005324381ff9e...1ae37cef9189976c7d3838ba0899e874a0758379,2,68,10,78,8,2014-06-02 17:43:07,2014-06-02 10:41:47
4edcbfdeb7d056f47f2eba13c6e005324381ff9e...3723d6341effa7698ccbb05ab708b0c25ee1af02,3,25,2,27,5,2014-06-02 06:56:15,2014-06-02 06:56:15
4edcbfdeb7d056f47f2eba13c6e005324381ff9e...f7b82be0dd1dc0d9b0fa6c9c194dc2c90af3d133,2,48,0,48,6,2014-06-02 06:37:22,2014-05-30 00:23:18
4edcbfdeb7d056f47f2eba13c6e005324381ff9e...0e9c40eb8243fa437bc6c3e93aaff64a10cb856e,1,34,1,35,3,2014-06-02 05:25:33,2014-06-02 02:13:34
0e9c40eb8243fa437bc6c3e93aaff64a10cb856e...e4497feaba31dd33bad790f77f783afc0c695020,1,30,0,30,3,2014-06-02 05:25:38,2014-06-02 05:02:16
4edcbfdeb7d056f47f2eba13c6e005324381ff9e...ca231b3de52f718d96c0ff6e7af40c7c0fade623,4,28,15,43,6,2014-06-01 23:23:31,2014-05-10 04:11:24
ca231b3de52f718d96c0ff6e7af40c7c0fade623...1a93d3b054751f6783064e5adb91f196687400b2,1,1,0,1,1,2014-06-02 07:01:17,2014-06-02 07:01:17
1a93d3b054751f6783064e5adb91f196687400b2...0a06e9bd91faff2c129fd5a7b30b85351c96601f,2,2,2,4,2,2014-06-02 07:05:06,2014-06-02 07:05:06
4edcbfdeb7d056f47f2eba13c6e005324381ff9e...a7b2c4804b2d98c2b5622db40d3d70b88529d7fe,73,1959,1708,3667,188,2014-06-01 21:34:07,2014-05-21 21:05:19
55230b3332f8a24b5100bfa54df5beedf078cd51...b8932abcd3f3932b6b56aa859b4c0762a95f7179,1,1,1,2,1,2014-06-02 19:54:17,2014-06-02 19:54:17
b8932abcd3f3932b6b56aa859b4c0762a95f7179...730d9ba17421e82012664c44aef7f64600b756cb,1,2,2,4,2,2014-06-02 19:57:20,2014-06-02 19:54:33
0ef637722f69cff931b25c75d421e231ab75af75...69989b7c06b0ca6737e83ddf8fcfa2dfccc57a7c,9,245,228,473,31,2014-05-31 01:39:11,2014-05-31 01:30:27
7393eafde79f67459755ef98d1718c25497783e3...6e74754a504e80378ed56ec765d62b762f80fcb4,2,31,1,32,2,2014-06-24 07:04:02,2014-05-26 07:40:24
7393eafde79f67459755ef98d1718c25497783e3...41a913b3906348f6ec3f1929e6d33926c84c1bf1,1,41,0,41,1,2014-05-26 05:57:20,2014-05-18 17:21:31
7393eafde79f67459755ef98d1718c25497783e3...dd3319636d749bac3d57fbcd1c3cf4d31fded8b7,1,1,1,2,1,2014-05-26 03:59:43,2014-05-26 03:59:43
7393eafde79f67459755ef98d1718c25497783e3...c52889db27a2af09ed7f6c92f2d6c6fd9737bf63,1,1,1,2,1,2014-05-24 18:03:11,2014-05-24 15:04:57
973fae9d75e1c354dc6631172d041740a2f543bc...581e8e891886e6db387ed27aabda7dd8f1d14174,1,5,5,10,5,2014-05-23 18:31:01,2014-05-23 18:31:01
581e8e891886e6db387ed27aabda7dd8f1d14174...24872379375dd66518f09b8063698c2d1fb08df9,1,17,6,23,3,2014-05-23 20:22:01,2014-05-23 20:22:01
1f219672fad7421d5c72ec4990ce2446e9155457...5eef0a28cb70881d8f1e34519e9c0df6cb1da071,2,39,0,39,3,2014-05-21 00:10:07,2014-05-20 23:34:48
5eef0a28cb70881d8f1e34519e9c0df6cb1da071...9e51b7abaea3fb30dc994a1d004cd79f2e100c1a,4,12,10,22,12,2014-05-21 00:23:17,2014-05-21 00:10:35
f00c2e5007cb7843c2bcea53e4a86835d3d5a958...608702b98064a4dfd70b5ff0bd6fb45d2429f45b,19,466,214,680,48,2014-05-30 19:21:29,2014-02-17 23:14:30
f00c2e5007cb7843c2bcea53e4a86835d3d5a958...180c2a678510a93a442f1bcdb6a47287ec88ccd6,16,301,13,314,25,2014-05-28 21:07:52,2014-05-28 17:53:16
bd9b27fe18e92f4fb9123d2f254b16818911f11a...36d913078b7ea0138dbc5d561703d068e7e31934,1,2,0,2,1,2014-05-07 15:46:41,2014-05-07 15:46:41
bd9b27fe18e92f4fb9123d2f254b16818911f11a...7549199cc5e1de910f5dbd539831095739524ea6,1,1,1,2,1,2014-05-07 07:21:02,2014-05-07 07:21:02
6eda9f3207b349b0d2759c70174185bf0d0c09a1...b885f61a61df1e8d8f71914e17c2a2861167f96e,3,16,11,27,5,2014-07-03 05:28:39,2014-07-03 05:28:39
6eda9f3207b349b0d2759c70174185bf0d0c09a1...873241790f802351d36c490046435215b33e4551,2,3,6,9,3,2014-07-03 04:19:48,2014-07-03 04:19:48
6eda9f3207b349b0d2759c70174185bf0d0c09a1...d013b76e10262624c9f8ee05b9877e26eb58b516,1,39,33,72,18,2014-07-03 02:52:56,2014-06-29 22:01:11
6eda9f3207b349b0d2759c70174185bf0d0c09a1...79812e36468c6e9be19b7c028e37787d5ae6288b,2,25,1,26,2,2014-07-03 01:15:11,2014-07-03 01:15:11
e83fc70d362bf0035811bbcc5566020c6cc9893f...21b42dfcfd15ee6757bcba57acb511d5ce60a3ba,3,32,10,42,4,2014-04-29 00:08:33,2014-04-28 23:31:58
e83fc70d362bf0035811bbcc5566020c6cc9893f...c6060a3b25b94ae4738ac27bbf62cbb914af7ced,3,5,74,79,4,2014-04-27 18:17:48,2014-04-27 18:17:48
e83fc70d362bf0035811bbcc5566020c6cc9893f...91deb591c8a52a974612b4c6885d989251f819bd,8,20,0,20,8,2014-04-27 17:10:30,2014-03-11 09:30:51
36af2936af2e55216456dbe62e7fcbeff9b630d5...cf655ca98d9c230d02454a39e815fc6b11ac5aed,1,4,1,5,1,2014-04-08 15:42:47,2014-04-08 15:42:47
36af2936af2e55216456dbe62e7fcbeff9b630d5...794b5de749fceea906222917e90bbc19e131ecc3,1,4,4,8,4,2014-04-05 01:30:37,2014-04-05 01:29:40
36af2936af2e55216456dbe62e7fcbeff9b630d5...da8aa712d28cb7177b0fe5b4cc9d7de33ea1da60,1,0,21,21,1,2014-04-05 01:09:04,2014-04-05 01:09:04
36af2936af2e55216456dbe62e7fcbeff9b630d5...e2779e11db113c5551094dba8079d44d8a210e41,2,2,14,16,8,2014-04-03 04:40:38,2014-04-03 04:40:38
e2779e11db113c5551094dba8079d44d8a210e41...8b450a93b8bb3b1cd0c32754dd499ec0c9b66537,1,5,7,12,6,2014-04-03 06:34:57,2014-04-03 06:34:57
a10c17ad11dbe7da389d9bb2185e26ed56cd2204...af9746412b6070063f105ae97eba1f8fbd56bd22,9,92,302,394,20,2014-04-08 21:45:06,2014-04-08 09:26:09
af9746412b6070063f105ae97eba1f8fbd56bd22...b4f2821e6d4ba6f6073365a244681df21f5d4472,3,8,6,14,6,2014-04-08 21:45:06,2014-04-08 10:02:17
80d35c7fd0ca3a3c8d4dd4b4cd575048a9fbc092...26184de8ab1dfe812094c55c9becd8ebb60ed7be,7,23,29,52,16,2014-11-04 01:39:21,2014-10-27 18:00:29
80d35c7fd0ca3a3c8d4dd4b4cd575048a9fbc092...e377716b377ccc4854f810bbfc3e65a7858163ed,1,41,0,41,1,2014-10-27 23:37:27,2014-10-27 20:05:29
80d35c7fd0ca3a3c8d4dd4b4cd575048a9fbc092...0a37f836adef969e9e5aa9ce7b2c465f9441c1a5,4,7,4,11,8,2014-10-27 18:59:02,2014-10-27 17:45:38
80d35c7fd0ca3a3c8d4dd4b4cd575048a9fbc092...b6db23cffe942b8d94c80d1e9b3f1f6fca87d139,1,2,16,18,3,2014-10-27 18:38:22,2014-10-27 18:38:22
80d35c7fd0ca3a3c8d4dd4b4cd575048a9fbc092...be49867cab663b5bdcf7804f3d2504f056db9db1,2,88,1,89,3,2014-10-27 17:38:24,2014-10-25 17:58:57
be49867cab663b5bdcf7804f3d2504f056db9db1...4e74cd498b66e494b3336118a19c02000b282251,2,201,3,204,7,2014-10-27 17:38:25,2014-10-25 18:29:18
005029cbddfba813e8565ff7da4fd356b242a0c8...ab03e898ff22e1bdb2452cfc2d9aad1313c97fc9,1,3,1,4,2,2014-10-24 07:15:15,2014-10-18 10:58:20
005029cbddfba813e8565ff7da4fd356b242a0c8...18141652ba4654458e0cd78dbabe6fc6cc1729ee,1,1,1,2,1,2014-10-19 17:16:30,2014-10-19 17:06:58
005029cbddfba813e8565ff7da4fd356b242a0c8...91502ba66bfc2a3edafb2ddf7f27393250bfa459,1,1,0,1,1,2014-10-17 23:58:07,2014-10-17 23:58:07
005029cbddfba813e8565ff7da4fd356b242a0c8...dbe24a048bc557d34925e5ca9f7dd99f57d1d9e1,1,15,5,20,2,2014-10-17 23:19:28,2014-08-04 19:32:12
dbe24a048bc557d34925e5ca9f7dd99f57d1d9e1...b7249317c1a703df8a4d7b113cfc839ebbc56a29,1,8,7,15,7,2014-10-17 23:51:36,2014-10-17 23:21:09
09982d0f975cfc302fb12f22905673546ef40cd7...985fae256f3fcaea5cf67581ae3d83a46bc52d9e,1,2,2,4,2,2014-09-15 22:17:50,2014-09-15 22:17:50
00fd008170e463426001ec4c56fc4c39450fd8d0...c9c004d700af23c238adef40a1e579d21c6c5765,2,23,3,26,6,2014-09-16 20:01:10,2014-09-16 18:46:24
7c27c7a09657ff482d3330ad74e92e4e36e5af21...1c3b732f8a6ed6f1d01a6ecacc6753899842c2f0,1,63,1,64,1,2014-08-28 01:34:19,2014-08-28 01:34:19
1c3b732f8a6ed6f1d01a6ecacc6753899842c2f0...810c231b912c0a12acb8eb82a3756276e47fa632,1,14,13,27,9,2014-08-29 00:29:09,2014-08-29 00:29:09
7c27c7a09657ff482d3330ad74e92e4e36e5af21...eb9379c5d05848c525f7c3d75b66a4b356227d57,2,28,58,86,2,2014-08-27 23:34:37,2014-08-27 23:34:37
eb9379c5d05848c525f7c3d75b66a4b356227d57...5b27fbc0e27358b794946fe9e84a83a6c4497be4,3,96,91,187,8,2014-08-28 00:25:10,2014-08-28 00:25:10
5b27fbc0e27358b794946fe9e84a83a6c4497be4...2b538bd555b001e69346321485cd07a5c5c11d67,1,0,75,75,1,2014-08-28 00:28:54,2014-08-28 00:28:54
1a2a4f61abb3a5b40de70b10f39c90d7593679a5...068b9ac4d2f236905bb9deb024189082876a3c3f,1,10,1,11,3,2014-09-04 23:20:02,2014-01-08 05:28:15
0ca010695cc504c1a27cfb939e2580e0515caec1...94715e8e643f0bc9aa57841b346f5196f75f0dc0,4,75,69,144,7,2014-08-08 03:01:55,2014-08-08 03:01:55
b79211f4ae0f08975d02c5d51bb482f965d60a88...ef7415258ba5195af7a890d1d52214b3a181a379,3,74,0,74,6,2014-11-06 20:12:41,2014-10-22 13:48:02
107898a773d7345119917cf8f879a2c71f0a940c...5a73be8e9fbe5defc9fc71c6839bea1d888d6a95,1,1,1,2,1,2014-10-31 18:56:07,2014-10-31 18:41:46
107898a773d7345119917cf8f879a2c71f0a940c...f95d73dfd48ad4a3211f2f5e89e8195e2066c939,1,1,0,1,1,2014-10-31 18:28:10,2014-10-31 18:28:10
107898a773d7345119917cf8f879a2c71f0a940c...06bd66a1f8079c9135acc34bcb9d46c439b429f1,5,65,1,66,12,2014-10-31 17:29:35,2014-10-31 14:18:41
06bd66a1f8079c9135acc34bcb9d46c439b429f1...7a3a93871218e5bc50a368f00f043c84004e5986,1,331,0,331,1,2014-10-31 19:31:34,2014-10-31 17:12:31
107898a773d7345119917cf8f879a2c71f0a940c...906985123aa6b7874c3c0e21f0fb5603928ff6dd,1,2,2,4,1,2014-10-31 13:00:59,2014-10-31 13:00:59
107898a773d7345119917cf8f879a2c71f0a940c...29965246a735acbdbd9cbb4e54f1d2d9efb120f3,1,1,1,2,1,2014-10-31 07:31:20,2014-10-31 07:31:20
107898a773d7345119917cf8f879a2c71f0a940c...ad5b307d0fb00ff0a63b3f97e529fa67bfce50b3,1,6,1,7,1,2014-10-31 04:20:26,2014-10-31 04:20:26
107898a773d7345119917cf8f879a2c71f0a940c...8453cf0671879aef04f96ffce52bf3fbcb75ca13,1,0,6,6,1,2014-10-31 03:58:14,2014-10-31 03:58:14
107898a773d7345119917cf8f879a2c71f0a940c...b16f3736edf2427761cbc1c8fc5c4892299b2232,1,2,2,4,2,2014-10-31 03:22:51,2014-10-31 02:50:02
7d538542ca53488f32db377984b7917480d60917...ed5e776a2235dd185423749acb9b306bb6067945,1,6,9,15,3,2014-10-29 09:36:38,2014-10-29 09:36:38
7afb98ad5d50c9c8e606826684663df1b158cb02...0bd1c05e5c36799e0740a155092be0c9c417f175,2,13,0,13,4,2014-08-27 17:46:10,2014-08-18 00:50:15
7afb98ad5d50c9c8e606826684663df1b158cb02...d4a53a7bce0205ba0cb693b43091b78f6ce8702a,1,30,4,34,2,2014-08-25 02:00:11,2014-08-17 14:14:05
7afb98ad5d50c9c8e606826684663df1b158cb02...075e1bc1c35b5f130f6ae7961782ff9af79817bc,4,34,33,67,9,2014-08-18 10:13:43,2014-08-18 10:13:43
7afb98ad5d50c9c8e606826684663df1b158cb02...018e75a6e4ef955cd802267818b6a6c81a600c9a,3,15,6,21,11,2014-08-17 23:31:58,2014-08-17 23:31:58
7afb98ad5d50c9c8e606826684663df1b158cb02...3231033a80451adff73b53554e27fbabfebb4a4f,1,8,0,8,1,2014-08-16 12:24:32,2014-08-09 07:16:54
3231033a80451adff73b53554e27fbabfebb4a4f...676308b853a43bb7be4838e937ab4effff670b1a,1,1,1,2,1,2014-08-16 12:25:46,2014-08-10 09:48:34
7afb98ad5d50c9c8e606826684663df1b158cb02...a67d06fd4343024ed25c3faf40e58c9a1935c28a,31,468,294,762,124,2014-08-15 22:41:05,2014-08-15 22:41:05
92cba0845c046c0dac2af74b5d717bc799c91984...9fbae5924471b63e4f33fbd87f797183ab68be92,1,0,254,254,1,2014-07-23 18:55:56,2014-07-23 18:55:56
604a975303230cec2684bfede67cedbd9bc50d4d...56bb7ce780dc5fc2c5134291fbbea28169a479b1,2,10,1,11,2,2014-07-23 18:09:02,2014-07-23 18:09:02
2481e08e416d3cda0ed5ac73e6cbae99eea18414...771ed2391536ad722e32be519039454cc98668e8,3,152,6,158,95,2014-07-24 22:49:39,2014-07-24 22:49:39
2481e08e416d3cda0ed5ac73e6cbae99eea18414...b3ee9ac74e171e00f14027e39278013629e681b8,200,828,515,1343,296,2014-07-24 22:19:50,2014-07-24 22:19:50
b3ee9ac74e171e00f14027e39278013629e681b8...5a0ef08c940b9a17c400389bca8e7f54935ceba9,15,24,24,48,30,2014-07-24 22:25:29,2014-07-24 22:25:29
5a0ef08c940b9a17c400389bca8e7f54935ceba9...10822462624d9eb3e1801577540613d74b1bb225,1,2,2,4,2,2014-07-24 22:30:05,2014-07-24 22:30:05
ff28b0b9194ffdad15ea459e123e2f5b674dc7e6...2d84b877bdce5e26aac164e14815e1c4fa8648b7,15,80,72,152,19,2014-07-26 11:03:04,2014-07-26 11:03:04
ff28b0b9194ffdad15ea459e123e2f5b674dc7e6...3fb913ab7712634f1f311a9aab47c5eaa9f8fe9d,1,1,0,1,1,2014-07-25 14:14:52,2014-07-25 14:14:52
ff28b0b9194ffdad15ea459e123e2f5b674dc7e6...9503afbc9116b06585cf42715a7ae0bcd0fb7881,1,1,1,2,1,2014-07-25 07:06:38,2014-07-25 07:06:38
042b642d407fd9f76c7282fb71e1508bd033bfa1...231e07ded4debc69422696cacc069a47a77e3175,1,4,7,11,2,2014-08-06 17:09:11,2014-08-06 15:54:13
042b642d407fd9f76c7282fb71e1508bd033bfa1...bd30746e07e18942cea4f2d15a45fd357c957e4f,1,5,1,6,1,2014-08-06 02:28:07,2014-08-06 02:28:07
042b642d407fd9f76c7282fb71e1508bd033bfa1...6215422286f59530e598b3317c9ea789f8c1d0c7,114,12461,346,12807,146,2014-08-06 01:13:43,2014-08-06 01:13:43
042b642d407fd9f76c7282fb71e1508bd033bfa1...07099b62563f3201877995181825d4cd4822ed89,1,6,6,12,5,2014-08-06 01:11:32,2014-08-06 01:11:32
64579f51fcb439c36377c0068ccc9a007b368b5a...6cbb8e070d6c3a66bf48fbe5cbf689557eee23db,1,1,0,1,1,2014-08-13 13:18:37,2014-08-13 13:18:37
64579f51fcb439c36377c0068ccc9a007b368b5a...da63a93e89f2ea8f35f22a082f4a406456fc6a09,1,1,0,1,1,2014-08-13 07:50:40,2014-08-13 07:50:40
da63a93e89f2ea8f35f22a082f4a406456fc6a09...7d1b2ebde8a0d1484f486b5ea01b1a77014b958b,1,1,0,1,1,2014-08-13 08:13:51,2014-08-13 08:13:51
64579f51fcb439c36377c0068ccc9a007b368b5a...391c35c82252633eb415fdade08103a8a0818fde,8,24,13,37,13,2014-08-13 07:37:30,2014-08-13 07:37:30
64579f51fcb439c36377c0068ccc9a007b368b5a...c6595b3ee83d5cf8348739949e74720e62f7dd50,2,2,2,4,2,2014-08-13 06:49:03,2014-08-13 06:41:24
64579f51fcb439c36377c0068ccc9a007b368b5a...99423e7e1ef7d833e333389b15a372179734c03f,1,1,1,2,1,2014-08-13 04:30:04,2014-08-13 04:30:04
64579f51fcb439c36377c0068ccc9a007b368b5a...491deae9b8866b5b0774bbc92ee82f7cd7b565eb,4,90,111,201,13,2014-08-13 03:12:33,2014-08-08 08:00:16
491deae9b8866b5b0774bbc92ee82f7cd7b565eb...63503cafe4addb7d275244fbcce0e10d67225cc9,11,63,197,260,25,2014-08-13 06:56:45,2014-08-08 09:12:39
54b287bbc81216a2663b776f536ad40193a87bf1...27cca4c70cc7f0cccfda693ca7bbb2422eec3e13,7,86,38,124,13,2014-07-31 22:10:56,2014-07-07 12:23:07
27cca4c70cc7f0cccfda693ca7bbb2422eec3e13...8891e912b44c4ff597f7a45658c4d3030d730c98,1,2,1,3,2,2014-07-31 22:11:15,2014-07-31 22:11:15
5ef1126669ee6fac50679e4d65d1eb822a59fbec...2519872d77da8cb6a9c5f55e44cfaeb9cd603978,1,5,5,10,3,2014-07-28 18:43:24,2014-07-28 18:43:24
2519872d77da8cb6a9c5f55e44cfaeb9cd603978...bfacdfdccf5e93301842309a0048990ef0ebb549,1,6,6,12,4,2014-07-31 06:54:22,2014-07-31 06:54:22
bec676e2dea2b982a05b44f69844f55a4d543866...5514afcd88d40a7a9321a966292e9f724eeafc36,1,4,1,5,1,2014-08-03 08:28:25,2014-08-03 08:28:25
bec676e2dea2b982a05b44f69844f55a4d543866...60341f80d7b7918d1c1eff7c38cbc55c9bdec4d9,10,7,398,405,15,2014-08-02 07:35:04,2014-08-02 07:35:04
66c8f87e89ba0dd824cf640a159210fbbb8019ec...5e20b0027c19efdd83228cbbb9995847cb5cb8ed,1,6,8,14,4,2014-08-06 18:24:00,2014-08-06 18:24:00
5e20b0027c19efdd83228cbbb9995847cb5cb8ed...872db07119e702424dc27cd6e3396b3f2109c468,1,2,0,2,2,2014-08-06 19:55:50,2014-08-06 19:55:50
d48492a12efa6e31bfcac6adb90f3afae0989fea...22f373aeda63cffb06efca4fae067395191e02e9,6,7,5,12,7,2014-08-04 19:34:11,2014-08-04 18:19:12
22f373aeda63cffb06efca4fae067395191e02e9...cd6b9038255be10d827972ea66c8878cf1d228dc,1,5,0,5,2,2014-08-04 19:34:27,2014-08-04 18:41:59
d48492a12efa6e31bfcac6adb90f3afae0989fea...bafad8cdc444744069ef005f83bb328c6f8e3b16,3,28,0,28,1,2014-08-04 18:12:01,2014-08-04 18:12:01
bafad8cdc444744069ef005f83bb328c6f8e3b16...4d0527856ca4bd0037313f02a3487845af97330e,1,2,2,4,2,2014-08-06 02:06:52,2014-08-06 02:06:52
d48492a12efa6e31bfcac6adb90f3afae0989fea...825ca10dfdaedfef17d92d898208c6f7e6dcb8e5,1,1,0,1,1,2014-08-04 17:27:28,2014-08-04 17:27:28
d48492a12efa6e31bfcac6adb90f3afae0989fea...7dba5024e8cf152f8a597dd177485dbf9001ae58,1,7,7,14,7,2014-08-04 16:48:09,2014-07-08 17:10:28
7dba5024e8cf152f8a597dd177485dbf9001ae58...1b6546b8407ce0fa41340efefc081beadf26d41c,2,43,2,45,5,2014-08-04 16:48:36,2014-07-08 17:37:20
1b6546b8407ce0fa41340efefc081beadf26d41c...aa2d6dbc0c64efb515646dd2d339ff857c94c3b7,3,32,5,37,5,2014-08-04 17:17:37,2014-07-10 05:46:11
a43cebf08897c841ad2948ab53568bf89d5e6fee...871299de0d08242aa6afd9f7ffd4d96e81905331,8,121,41,162,23,2014-06-09 01:01:44,2014-06-09 00:26:36
a43cebf08897c841ad2948ab53568bf89d5e6fee...11fee48c2daa254a724836cad59cced7dc96e267,5,26,26,52,17,2014-06-09 00:59:22,2014-06-09 00:59:22
4dc5315e3b226c043ee65f9738c5cb2223af4809...bb7baf183557fd963f4d1b36ac6a0253a3a0e717,2,32,50,82,25,2014-06-08 22:53:20,2014-06-08 22:53:20
7e38d6a358ff2869e25dc8c6954b4b1b0d1b46a0...034babf1753741184c1155a7346ecec86fc51e2c,1,13,1,14,5,2014-05-23 21:18:50,2014-05-23 21:18:50
7e38d6a358ff2869e25dc8c6954b4b1b0d1b46a0...0be44d1a0a2dfd70c35367d7ee8383feeab8d3b9,1,4,18,22,6,2014-05-23 21:03:52,2014-05-23 20:51:06
2404ce3d261cd54596646f2008e0664a5e1be2cf...4ac216d8d3441b8546798711320cb5679d33984d,1,1,1,2,1,2014-06-02 17:41:53,2014-06-02 14:36:21
f1a217be0ff4ad04c40fd9630fac024fd2c0a581...30fdac2cb1bd5461972cef6efa3d67270db23491,1,2,2,4,1,2014-06-02 18:54:23,2014-06-02 18:54:23
aa61cc759b3b204cf71689c361d50de756bd9cf5...68476e277f953d1076c8e966691769d5a35e65b6,3,14,8,22,5,2014-06-03 01:56:47,2014-06-03 01:26:41
afb2d5de3de56ff54e1a25f402e369b5f4eb45d0...af6ab357e8db8888429a28014f629af19a2250b8,1,2,2,4,2,2014-06-02 20:47:07,2014-06-02 20:47:07
afb2d5de3de56ff54e1a25f402e369b5f4eb45d0...5f3812ec97f9a951bceb482fdcd355b6cbc1b113,6,1678,20,1698,20,2014-06-02 20:33:50,2014-02-26 22:04:11
5f3812ec97f9a951bceb482fdcd355b6cbc1b113...caf9b19b0c444467aff493781afb66df923250ff,1,0,53,53,1,2014-06-02 20:33:50,2014-03-26 18:48:56
caf9b19b0c444467aff493781afb66df923250ff...55d95185edd4a646cd2a05b9397be6b8667d60d0,1,20,6,26,7,2014-06-02 20:33:51,2014-03-26 18:58:33
55d95185edd4a646cd2a05b9397be6b8667d60d0...babd5720157898bb33d806bda920d9f9f2df73f0,2,3,19,22,3,2014-06-02 20:33:51,2014-03-26 19:14:26
babd5720157898bb33d806bda920d9f9f2df73f0...cb7857de5d2595632b76e4e17acede85a519001a,2,1,5,6,3,2014-06-02 20:33:51,2014-04-07 17:38:53
cb7857de5d2595632b76e4e17acede85a519001a...3391aac2b27ac95f58a20a2eb4046ad1f00b8be6,2,41,1512,1553,3,2014-06-02 20:33:51,2014-05-18 19:23:09
3391aac2b27ac95f58a20a2eb4046ad1f00b8be6...f1cc7ce5d728d6bdb1b3ab668e36fb1fc66515ff,5,101,29,130,15,2014-06-02 20:33:51,2014-05-19 20:31:15
f1cc7ce5d728d6bdb1b3ab668e36fb1fc66515ff...f322168563dee9d0361524d15c6a5069772b44f8,1,0,3,3,2,2014-06-02 20:33:52,2014-05-21 21:53:58
f322168563dee9d0361524d15c6a5069772b44f8...3ecfaa8f2da60bb4e6ce6c9ae0428bc7b647e34b,3,6,6,12,6,2014-06-02 20:33:52,2014-05-21 22:44:31
3ecfaa8f2da60bb4e6ce6c9ae0428bc7b647e34b...89a15fa235f0aab6dd326a3737260c983f0fc22b,3,29,7,36,11,2014-06-02 20:33:52,2014-05-30 18:59:03
89a15fa235f0aab6dd326a3737260c983f0fc22b...3a4e3ca3277fef8f1d88858fa5a3e149a897f8ae,2,31,14,45,6,2014-06-02 20:33:52,2014-05-30 19:55:40
3a4e3ca3277fef8f1d88858fa5a3e149a897f8ae...02255ddaa4948fd94450fd5d9d2ee9b147e88352,3,26,13,39,5,2014-06-03 16:19:26,2014-05-30 20:42:37
afb2d5de3de56ff54e1a25f402e369b5f4eb45d0...2e85568816315a6544ce1c379a5b2b714fb16524,1,122,0,122,3,2014-06-02 19:40:13,2014-05-31 12:42:49
2e85568816315a6544ce1c379a5b2b714fb16524...bf4d907092a81bf8c6bd8a6a2ce2105aa3c8c11d,1,139,103,242,12,2014-06-02 19:40:13,2014-05-31 12:43:32
bf4d907092a81bf8c6bd8a6a2ce2105aa3c8c11d...ae128437cefa93bba082a0231e2cd05d33991c81,2,335,222,557,4,2014-06-02 19:40:14,2014-05-31 20:49:50
4a2ca56ea0b5bff797c3d1150c18f5797e58c839...2bbf87504bc9eb6ee9a4694ce4d1d98287bccbc9,1,180,15,195,9,2014-05-27 17:32:52,2014-05-26 16:25:39
4a2ca56ea0b5bff797c3d1150c18f5797e58c839...b26bebac318803d9dbcd908ccc3be4f2fb9a88b8,1,1,1,2,1,2014-05-26 11:29:27,2014-05-26 11:29:27
7e96f8de1c65d414dd2c5039bf5953ae10cf236f...04620e01547d6526023b49494919f3eb3fcf900a,2,5,7,12,7,2014-06-05 18:10:52,2014-06-05 18:10:52
7e96f8de1c65d414dd2c5039bf5953ae10cf236f...8c646ebf16bd0e2618cbca430bc129ee7416a21c,3,7,6,13,6,2014-06-05 13:50:27,2014-06-05 13:50:27
7e96f8de1c65d414dd2c5039bf5953ae10cf236f...13f07b636f014331a5d5dc0eac40d6ac9e5c9263,2,71,0,71,2,2014-06-05 08:02:37,2014-03-31 07:30:20
13f07b636f014331a5d5dc0eac40d6ac9e5c9263...948e54ac455f88c79524dcf117df80f2d4c3f96c,3,55,17,72,7,2014-06-05 08:42:27,2014-03-27 16:45:02
948e54ac455f88c79524dcf117df80f2d4c3f96c...822ea97ffcf10645720bb93108a60f8b9ce9931d,13,26,17,43,23,2014-06-05 08:42:27,2014-06-05 08:34:20
822ea97ffcf10645720bb93108a60f8b9ce9931d...7f5ba068f438ee159bfca7396de4987bcae45809,3,121,8,129,10,2014-06-05 08:50:07,2014-03-27 16:48:32
7f5ba068f438ee159bfca7396de4987bcae45809...10083f414017636065aa50610f07784738df8e7a,2,54,2,56,5,2014-06-05 09:03:19,2014-03-18 11:26:42
10083f414017636065aa50610f07784738df8e7a...807bc2cd049d97f31eab54ce3d5719d63240e3e7,3,78,7,85,9,2014-06-05 09:25:06,2014-03-18 13:23:43
807bc2cd049d97f31eab54ce3d5719d63240e3e7...a226168a8b877d632cb87c95dd0288f6092b9d8f,2,97,29,126,11,2014-06-05 09:45:55,2014-03-28 14:36:55
a226168a8b877d632cb87c95dd0288f6092b9d8f...0434a2ce64c0ce07e97e9a516cef226be67d5f5b,2,38,6,44,7,2014-06-05 09:45:59,2014-04-01 13:41:25
0434a2ce64c0ce07e97e9a516cef226be67d5f5b...b1ac791d8426cd7b6fb5a19f5e918b26c83d83f6,2,3,22,25,24,2014-06-05 22:13:43,2014-06-05 22:13:43
e11a714f7adf0dd0e9c08ad5a443ba04d948475a...20a77aeeb8855ca0189fe9e3292d92b165b08905,1,7,3,10,2,2014-07-04 15:40:23,2014-07-03 11:55:21
e11a714f7adf0dd0e9c08ad5a443ba04d948475a...4318802f645cdd4fa63a894160f153a69a97af59,4,8,3,11,4,2014-07-03 12:11:18,2014-06-04 20:38:06
2fde8dfb832b9041364e3f87b8d145256f3f0891...c987aa09d81a6916e3893c41b7ec2880570b5c65,2,30,27,57,4,2014-04-07 18:01:35,2014-04-07 18:01:35
c987aa09d81a6916e3893c41b7ec2880570b5c65...1277885420b069abd7468fe3e69deb4fb0a3f4fc,1,103,53,156,45,2014-04-07 19:20:23,2014-04-07 19:20:23
5fbc47f2536a76677c98e0393bdcecc49a61a1c0...dc9c28f51d669d6b09e81c2381f800f1a33bb659,2,138,1,139,2,2014-04-08 21:49:33,2014-04-08 21:49:33
ad8096a1c2b4786ade4a79275683aecd31a090fd...5d6eca6642c5749099513f1f66bb44e004aa0938,3,46,1,47,3,2014-12-17 21:48:45,2014-12-15 19:44:15
5d6eca6642c5749099513f1f66bb44e004aa0938...100267de81985bbf3b976bfde850def89487dc11,7,51,56,107,16,2014-12-19 17:47:01,2014-12-19 07:20:59
ad8096a1c2b4786ade4a79275683aecd31a090fd...8123c1e9fef0eb0d6b4e89dce4089276b751906c,3,16,17,33,9,2014-12-17 00:23:19,2014-11-16 13:25:10
ad8096a1c2b4786ade4a79275683aecd31a090fd...af72f2128e7c4ebd12a9fef7e7381ef42a52ed0c,1,0,12,12,1,2014-12-17 00:02:36,2014-11-06 20:03:13
af72f2128e7c4ebd12a9fef7e7381ef42a52ed0c...3d8f40b35b7f035bbcd7b7f99064838b24afa1f6,1,1,3,4,2,2014-12-17 00:02:36,2014-11-06 20:26:16
3d8f40b35b7f035bbcd7b7f99064838b24afa1f6...56e3f49d1900f86b429a5a69839cc4f95af4dedc,1,17,0,17,1,2014-12-17 00:02:36,2014-11-11 06:15:17
c60e60a184cd8b07ea29f073585cb214408cdd7e...e7d086c2be41dfedfa5f2fb0c437eb5bbf6f2f5d,6,17,17,34,17,2014-12-12 18:44:59,2014-12-12 18:38:48
e7d086c2be41dfedfa5f2fb0c437eb5bbf6f2f5d...2540765ddc8889e2757f9ccfbfe852074b61601c,1,4,4,8,4,2014-12-12 18:46:09,2014-12-12 18:46:09
2540765ddc8889e2757f9ccfbfe852074b61601c...a7ae7fed7311551975d2bccb7417c328be3ea478,6,6,6,12,6,2014-12-12 18:58:56,2014-12-12 18:58:56
a7ae7fed7311551975d2bccb7417c328be3ea478...c7ff6bf69149bc5892633d95ebfacaf3ad36a008,1,10,10,20,4,2014-12-12 19:01:46,2014-12-12 19:01:46
c60e60a184cd8b07ea29f073585cb214408cdd7e...bb25f54a9953ce4d87cddad880befb016aa276d7,1,11,4,15,5,2014-12-12 16:57:23,2014-12-12 16:57:23
c60e60a184cd8b07ea29f073585cb214408cdd7e...a65396b079c1b05255553af8cde3a94d7796e752,1,70,0,70,1,2014-12-12 03:00:34,2014-12-12 03:00:34
c60e60a184cd8b07ea29f073585cb214408cdd7e...473a443d84084e0393be2a1606d3fa49a26f4dbd,1,2,2,4,3,2014-12-12 02:47:47,2014-12-12 02:47:47
5b03a21963931f917297e52cb17a62680f1c2a6e...4c978322979f00408c72b50931a8cdea2d5cdefc,4,79,2,81,4,2014-11-04 05:46:53,2014-10-22 07:12:03
5b03a21963931f917297e52cb17a62680f1c2a6e...95a400e6e1a3b5da68431e64f9902a3fac218360,1,11,1,12,2,2014-11-04 04:09:08,2014-06-30 22:39:58
5b03a21963931f917297e52cb17a62680f1c2a6e...91b4ac320fd91a6b776713b3c35a51da96024b32,2,12,7,19,5,2014-11-04 03:05:04,2014-11-04 03:05:04
91b4ac320fd91a6b776713b3c35a51da96024b32...83d7db3e505f2d080ac78ca7777937c812588003,1,29,0,29,1,2014-11-17 21:17:06,2014-11-17 21:17:06
d42bcc065ad637dc41f348c37e50167aebb5b54a...7597f27276b1c47da05ad1ae0bbcca21e080d9a7,3,6,2,8,3,2014-10-28 18:52:49,2014-10-27 20:44:42
039f2257680f31834aca655dca4ec93a25c2451c...0d97e082c3b849a6901992e653b8963e8ef10f54,2,4,1,5,2,2014-10-28 17:14:05,2014-10-28 00:23:50
339173dd5be7ec8807448f83622aa88561c445a6...b65eb8d215576516b1d4bbb537968f08bbc8ff0e,1,3,15,18,5,2014-10-27 19:04:36,2014-10-27 19:04:36
e590aa2c7adb1d221619fd3d11079a307827d463...24545c18c35620c211003561dc482d66ee6d0306,2,35,1,36,2,2014-10-27 21:50:22,2014-10-27 21:15:28
70e3cdcdd9dba29fcbed71c772749655d5907be6...912b0f0f73346bf93c4feb32c84c62c18ee62dbc,1,4,1,5,1,2014-11-13 19:25:11,2014-11-13 19:06:50
8b18a2da54119bb0586bcb9fd2715c9cf6a1ee58...1b0b1ec65729a2e018df1334b70b851714995e9e,3,6,2,8,3,2014-09-16 17:51:02,2014-09-15 23:35:07
8b18a2da54119bb0586bcb9fd2715c9cf6a1ee58...9e5592d6a10ce02fb77244c7de3fff38958e0b89,3,39,1,40,5,2014-09-15 22:54:21,2014-09-12 17:10:42
23bb6513a05fd8968e192a74dd2b654761e18d1e...67c254a60a77c1f80804be7ab97353530987c846,2,2,3,5,2,2014-09-16 17:37:50,2014-09-16 17:37:50
67c254a60a77c1f80804be7ab97353530987c846...23b2c39a40186ce9b6deb4ae9201d5c20cc75abe,1,6,7,13,7,2014-09-16 17:42:59,2014-09-16 17:42:59
345e3811fe3a23d05b715098c2a1a2b20c3a1428...450740c891c60dda15b7abe29f35b8e142c2c40e,8,149,5,154,13,2014-08-28 01:23:41,2014-07-14 23:19:37
450740c891c60dda15b7abe29f35b8e142c2c40e...925a3254e757407c5bfea5575df3b807f6596e70,1,79,1,80,2,2014-08-28 01:23:41,2014-08-26 05:19:00
925a3254e757407c5bfea5575df3b807f6596e70...9f09ef18a44d6e14da3d8a60d923de9e38ffc33e,1,34,0,34,1,2014-08-28 01:23:41,2014-08-26 05:23:56
9f09ef18a44d6e14da3d8a60d923de9e38ffc33e...f6a2fc4c3370983043a4284be5d8a09c3ff3bb6e,1,4,4,8,1,2014-08-28 01:23:41,2014-08-26 17:59:22
38186084b3ade82049d03f4f83640a0d47c3040c...f49c3f287b0d26dc705940effa0ec03e1de7bb99,3,86,3,89,3,2014-09-08 16:30:33,2014-09-05 21:35:55
38186084b3ade82049d03f4f83640a0d47c3040c...b9e889c30988f3babbc059a883d7f3096611ad60,1,1,1,2,1,2014-09-08 01:52:27,2014-09-04 15:35:52
b9e889c30988f3babbc059a883d7f3096611ad60...77fa306d63f0c0e48f49f6679beeb1ea55673f2a,15,42,42,84,42,2014-09-08 01:54:21,2014-09-08 01:51:57
38186084b3ade82049d03f4f83640a0d47c3040c...f3a68ffa390fb851115c77783fa4031f1d3b2995,1,21,3,24,3,2014-09-07 22:12:19,2014-07-10 04:22:01
38186084b3ade82049d03f4f83640a0d47c3040c...7ef34407509fa76e3ead12a20c8b731f434e1971,1,19,6,25,4,2014-09-06 14:39:43,2014-09-06 12:29:19
334dca15b0800cbbac99dc784d977ae0e094c716...3c984a6d1578947c5adfe13993cb28d88a674bbf,5,12,0,12,6,2014-08-28 05:25:57,2014-08-28 05:25:57
334dca15b0800cbbac99dc784d977ae0e094c716...22c46af4b358cf3ec4f7af47c701064c00cf7de4,41,1481,0,1481,41,2014-08-28 01:52:29,2014-08-05 20:17:40
22c46af4b358cf3ec4f7af47c701064c00cf7de4...bb36902db60d5d4e3b18bc018212e40df2d412e8,1,2,1,3,1,2014-08-28 01:52:29,2014-08-05 21:03:49
bb36902db60d5d4e3b18bc018212e40df2d412e8...d6c0bbc3cbf9204c506fedf4d0c5a477c7559a1d,11,668,127,795,64,2014-08-28 01:52:30,2014-08-05 22:41:09
d6c0bbc3cbf9204c506fedf4d0c5a477c7559a1d...3f5f6b038f56bc89d39a74fbb9c765daf98ae4d8,6,182,50,232,34,2014-08-28 01:52:30,2014-08-07 05:56:44
3f5f6b038f56bc89d39a74fbb9c765daf98ae4d8...4122a981ae12851f71bbf6ec46e03bba288e4143,3,36,3,39,8,2014-08-28 01:52:30,2014-08-07 07:42:10
4122a981ae12851f71bbf6ec46e03bba288e4143...21b15ac920d5e51f636d7febf07a4a52f5e61bff,12,15,3,18,14,2014-08-28 01:52:30,2014-08-08 20:44:57
21b15ac920d5e51f636d7febf07a4a52f5e61bff...135f54ccbfb6f638b4ab0be67a215adbad246ecb,2,10,15,25,11,2014-08-28 01:52:30,2014-08-10 11:01:10
135f54ccbfb6f638b4ab0be67a215adbad246ecb...248f4c4f751b76f330278b04d2297bfcf97eec48,1,1,4,5,2,2014-08-28 01:52:30,2014-08-10 11:05:34
248f4c4f751b76f330278b04d2297bfcf97eec48...3dfe5ddfb98a36ddcf2480720255a3a00f5fbc1d,2,0,4,4,2,2014-08-28 01:52:30,2014-08-10 11:07:28
3dfe5ddfb98a36ddcf2480720255a3a00f5fbc1d...1ae4c00a19edb7d3b41c050489e56339833d8e01,9,309,1184,1493,116,2014-08-28 01:52:30,2014-08-11 15:44:31
1ae4c00a19edb7d3b41c050489e56339833d8e01...cb51681a6db4b7c62d91998ba3b1d3b98c09c61c,9,127,109,236,84,2014-08-28 01:52:30,2014-08-13 10:07:41
cb51681a6db4b7c62d91998ba3b1d3b98c09c61c...a1522ec01c21807e657e840760a8186f482f2271,6,11,13,24,10,2014-08-28 01:52:30,2014-08-15 16:29:35
a1522ec01c21807e657e840760a8186f482f2271...305f73508022d0a3af65faa327aa798610969875,6,19,34,53,16,2014-08-28 01:52:30,2014-08-19 11:14:21
305f73508022d0a3af65faa327aa798610969875...2ef1dec7e8d405f237b68ca104d457d78b8caed1,6,105,114,219,76,2014-08-28 01:52:30,2014-08-26 19:25:44
34438efffefdf4a2d93e5b2192dff4645828d745...cd776cdd77239353d8bd17d3e05d66665f381157,1,1,1,2,1,2014-08-25 21:25:31,2014-08-18 23:28:44
33d6b20c133348fed0d803fbe350b5a663974345...a34dd216119bd343eb4a1f68ad209816d7a3f4c9,3,32,3,35,9,2014-08-08 11:30:38,2014-07-31 07:33:59
7dbab337dd9f555a8c2653a8a3690496d70eb982...e350df5b2c95be74c5808c28cac5dee763b11d8b,1,107,105,212,38,2014-08-13 19:55:59,2014-08-08 15:00:18
0d513b5a845f274c4ff06f6e7bc772e49167cda3...c81337d5dbcc6a670d24f2faf9b181730fe547e4,5,7,7,14,7,2014-11-05 05:50:59,2014-11-05 04:26:17
0f9f5f3fdfd45ef7759d6b163860aac4436bf9b7...75e3b35bf15dd01363f8b422d6b8a4a62b1054c6,1,20,0,20,1,2014-11-11 19:02:32,2014-11-11 19:01:49
0f9f5f3fdfd45ef7759d6b163860aac4436bf9b7...64e7a1722daa6508f38287c6b8eee72850f22a86,1,13,0,13,2,2014-11-07 18:37:23,2014-10-31 20:28:20
0f9f5f3fdfd45ef7759d6b163860aac4436bf9b7...fd774a818c7d8942922b4f74eabd2a4e14094e1a,11,171,55,226,32,2014-10-31 23:06:30,2014-09-17 01:08:30
4d4a7b81bf82e243bca07af815cb1fe03193b135...ebeccee968e5edba5043920581a5b6976aa504c0,4,90,1,91,5,2014-11-04 23:28:38,2014-11-04 23:28:38
4d4a7b81bf82e243bca07af815cb1fe03193b135...0e217c4a9e123551843ceeecdefe5d66b408cdf3,1,2,0,2,1,2014-11-03 19:01:50,2014-11-03 19:01:50
4d4a7b81bf82e243bca07af815cb1fe03193b135...03ea2166b66632ee7cdd824d7acd87b15c9bccb2,2,79,1,80,2,2014-11-03 18:51:03,2014-11-03 18:50:16
4d4a7b81bf82e243bca07af815cb1fe03193b135...693b9d335cc1fe688a7fffb62e5da97a5d5a3b13,1,1,1,2,1,2014-11-03 17:12:05,2014-11-03 17:12:05
4d4a7b81bf82e243bca07af815cb1fe03193b135...ef004ec03fe5aad33da7d53f196f16382c750d07,1,2,2,4,2,2014-11-03 16:46:01,2014-11-03 16:46:01
4d4a7b81bf82e243bca07af815cb1fe03193b135...4437573c96cdc52e98f44356be5c96dff4ce5907,11,11,11,22,11,2014-11-03 10:52:50,2014-11-03 10:52:50
4d4a7b81bf82e243bca07af815cb1fe03193b135...795533ede700395add26746b50f3d34aa3c1a3eb,1,1,2,3,1,2014-11-02 14:55:36,2014-11-02 14:55:36
4d4a7b81bf82e243bca07af815cb1fe03193b135...d22d32d61fc024d2c81e75f870d802f7a2cd28fd,1,1,1,2,1,2014-11-01 21:22:43,2014-11-01 21:22:43
4d4a7b81bf82e243bca07af815cb1fe03193b135...de9bf24750e0a9774a475eae74cbd2c241224e10,1,2,1,3,1,2014-11-01 21:04:51,2014-11-01 20:58:18
4d4a7b81bf82e243bca07af815cb1fe03193b135...e5ecfd3b178bbc399de344635606d82e147276ff,1,2,9,11,3,2014-11-01 16:23:08,2014-11-01 16:23:08
4d4a7b81bf82e243bca07af815cb1fe03193b135...f12b7b4bc21ff6a64505909a9ba49107877d2ca4,2,3,3,6,2,2014-11-01 16:22:28,2014-11-01 16:22:28
4d4a7b81bf82e243bca07af815cb1fe03193b135...f2df38050e019c0db265e7c3e38ee0de8948ca77,11,87,9,96,19,2014-11-01 14:35:09,2014-10-03 21:02:17
f2df38050e019c0db265e7c3e38ee0de8948ca77...971fc2253af77ae4a22a3741fff51d84cd9bc697,6,14,14,28,12,2014-11-03 10:43:27,2014-11-03 10:43:11
971fc2253af77ae4a22a3741fff51d84cd9bc697...28605bc4d55bcfc7a5562e4de3e01b1d5cd9bdcd,2,2,2,4,2,2014-11-04 14:19:47,2014-11-04 14:19:47
4d4a7b81bf82e243bca07af815cb1fe03193b135...9d6391a9ebca6c7bd4b262ebb5a4baf9d2c222f9,1,1,1,2,1,2014-11-01 01:10:48,2014-10-23 22:26:52
a61c4dc959bd9370f6c6240efbeff2bf73433676...6cbe1fa726fb88a1743c3a3da5e699c9bb3ae55a,2,35,21,56,12,2014-11-06 19:36:00,2014-11-05 20:24:15
6cbe1fa726fb88a1743c3a3da5e699c9bb3ae55a...048d0c4e84aa850f28f9f12735d274a887c79509,1,26,0,26,1,2014-11-06 19:36:09,2014-11-06 19:36:09
a61c4dc959bd9370f6c6240efbeff2bf73433676...e2f8fbfbcc450432536e387777b1ff080c94a948,7,87,82,169,83,2014-11-05 23:10:38,2014-11-05 23:10:38
a61c4dc959bd9370f6c6240efbeff2bf73433676...18d9f1978b311ff9cadce9f0237313db14502f9f,9,15,15,30,15,2014-11-05 16:26:22,2014-11-05 16:26:22
a61c4dc959bd9370f6c6240efbeff2bf73433676...aeeb0d59d3ed40c3b0d9cecd3c19a52f005dd140,1,2,2,4,2,2014-11-05 15:44:31,2014-09-24 07:26:53
a61c4dc959bd9370f6c6240efbeff2bf73433676...e86223e7b3ea7766164d809d2fbd463870e0614a,3,211,42,253,19,2014-11-05 14:38:44,2014-10-21 18:44:06
a61c4dc959bd9370f6c6240efbeff2bf73433676...67fbd34d8379a1b8232aea5d126a389f64bdc59a,1,16,6,22,3,2014-11-05 14:25:02,2014-11-05 14:25:02
67fbd34d8379a1b8232aea5d126a389f64bdc59a...8e9a18039be6ade0b8db65f7f298959055d86192,1,5,5,10,5,2014-11-05 14:25:02,2014-11-05 14:25:02
8e9a18039be6ade0b8db65f7f298959055d86192...8c9e5e5e05f8ddfcf8cd5218edb83d9fe8238d81,1,55,17,72,6,2014-11-05 14:25:02,2014-11-05 14:25:02
8c9e5e5e05f8ddfcf8cd5218edb83d9fe8238d81...ff56531de47c08157b2a37e6c6b6189a5006dba2,1,17,17,34,2,2014-11-05 19:39:54,2014-11-05 19:39:54
ff56531de47c08157b2a37e6c6b6189a5006dba2...0f57c902450b1d4f7a676dc693689debca002e98,1,15,15,30,2,2014-11-06 20:59:25,2014-11-06 20:59:25
0f57c902450b1d4f7a676dc693689debca002e98...15c74bebc1ea2d51612b5809b4477551547a8b3d,1,15,17,32,8,2014-11-12 14:36:32,2014-11-07 21:53:34
f10fefe408d2b6b40191d802c5244ea6379954f9...460036cdefb3e452fd5e8d77724d0df55be31da5,1,4,3,7,2,2014-11-13 00:01:25,2014-11-12 10:31:49
f10fefe408d2b6b40191d802c5244ea6379954f9...165624062e1ac105b6e45beba51cec6439918f11,2,43,1,44,3,2014-11-05 23:12:24,2014-11-05 23:12:24
f10fefe408d2b6b40191d802c5244ea6379954f9...d453d8b3210310f12a66a64a57b2946ce93653b8,1,17,0,17,1,2014-11-05 21:48:17,2014-11-04 18:34:15
fd19e473fc81c8b58d82b1b77cd992c43faa64a8...4da25724248d988771c2a546aa065505ceb24038,1,1,1,2,2,2014-10-29 16:31:35,2014-10-29 16:31:35
d1fc32e265c57d78dcbfd1ddf2d272c1ebd27c8b...55533693be0f268d7d7a2d339369ce8617398542,1,7,1,8,2,2014-08-17 11:45:11,2014-08-17 11:29:46
d1fc32e265c57d78dcbfd1ddf2d272c1ebd27c8b...3a70ca3c671053f599d4f3b226c2a787b369e752,1,0,125,125,1,2014-08-15 17:28:58,2014-08-15 17:28:58
37db53bf7a14613d7502a2e38b5806d90a766c1a...7cb68713552d2b153ed18bc6dcdcee5b69ef0a5f,1,3,0,3,1,2014-08-18 23:08:47,2014-08-18 23:08:47
37db53bf7a14613d7502a2e38b5806d90a766c1a...99082de9ada13a5898e769c176a88488d310b1a4,1,1,1,2,1,2014-08-18 19:31:37,2014-08-18 19:31:37
d4c2d0c57f18a7b09be95ba62d7476f3c3c81ede...a327d9b91edf6d36ee5b286ebe968bcca6658f5b,1,6,5,11,3,2014-08-21 15:33:44,2014-08-20 02:33:46
d4c2d0c57f18a7b09be95ba62d7476f3c3c81ede...27f44b9bb162dce988913b981f1f21eb149d875f,1,9,0,9,2,2014-08-21 03:23:34,2014-08-19 23:04:18
27f44b9bb162dce988913b981f1f21eb149d875f...93d574298da0f420c19db52b75ebf31ed3cb2ec9,1,1,1,2,1,2014-08-26 00:15:12,2014-08-26 00:15:12
d4c2d0c57f18a7b09be95ba62d7476f3c3c81ede...4d0b88c52f896fe159fe2b1dfd7bdb8116c31da3,1,15,15,30,9,2014-08-20 08:31:04,2014-08-20 07:56:50
d4c2d0c57f18a7b09be95ba62d7476f3c3c81ede...8c7915fcded75128dab9724782baebb17fbcd9f4,1,1,1,2,1,2014-08-19 22:39:37,2014-08-19 22:39:37
d4c2d0c57f18a7b09be95ba62d7476f3c3c81ede...05a09675c31c7de7f8f21bdd13ad7adb548804de,1,1,1,2,1,2014-08-19 22:03:51,2014-08-19 22:03:51
97283fa985623ca59183026a13951e7e9e6ce144...2b9d8248d6136645d3801693370e23d752f748f2,1,0,1,1,1,2014-07-29 20:56:19,2014-07-29 20:56:19
228c6a374bf5fa47b0e19751ddc9148052bb7bbc...5b293f15967c3358b84fabd72723d4bb6571bae0,1,5,1,6,1,2014-07-25 01:08:04,2014-07-25 01:08:04
c028bb239ffcd76a3812c82f75bcfc8083e7632c...7a5db6df995a131579020fd2cbacd49cb82e0aea,1,70,20,90,18,2014-07-25 19:49:33,2014-07-25 18:28:36
140e6abb17a85a569416236352a4fb07ce508480...95f86da641dfec9b3db88e0f0a8457685361a871,9,18,104,122,20,2014-08-07 22:20:43,2014-08-07 18:50:59
6215422286f59530e598b3317c9ea789f8c1d0c7...5101173e1fa5616768cb7a1b07f6c911f0f63658,1,4,4,8,3,2014-08-06 19:18:24,2014-08-06 19:07:07
5101173e1fa5616768cb7a1b07f6c911f0f63658...fba37a038d6053c272671ebc958b88f023bd221a,98,0,12045,12045,98,2014-08-06 19:19:41,2014-08-06 19:07:57
bc684fae642dbf585215b9518f469634a52a5524...5ab09f2f7129225220fc9c0b76b2e2aec6823ee1,4,2,2,4,4,2014-08-06 23:37:01,2014-07-30 15:16:10
5ab09f2f7129225220fc9c0b76b2e2aec6823ee1...5cdb9c8acab75df74d20cd937e4091dacb355160,3,50,42,92,9,2014-08-06 23:39:01,2014-07-30 15:39:03
5cdb9c8acab75df74d20cd937e4091dacb355160...bd373712d069f5f1f8d65bc25808a068a9afdd13,2,6,4,10,6,2014-08-06 23:45:04,2014-08-06 23:45:04
bc684fae642dbf585215b9518f469634a52a5524...89ec17d11319ae39bff19985ac59fc878fe1fe1e,21,16,26,42,21,2014-08-06 23:20:21,2014-08-02 07:46:15
1c5a4e09006b5b91f1bf5b3f020625a539fd165f...283ee108862da1db55a7cf944f20a245c096c388,1,15,0,15,2,2014-08-13 18:14:33,2014-08-12 21:57:09
283ee108862da1db55a7cf944f20a245c096c388...b4e2f5ed962f8ef81dbc2cbb1ff2a06bb64f8211,5,161,57,218,20,2014-08-13 18:54:47,2014-08-12 22:04:00
57f6b3e1ecafa706bffed5d44f69c8dfddcff06f...752dd707ac09cdcd88307b28aa9e39ac7c763b44,8,710,692,1402,31,2014-08-13 13:27:43,2014-08-07 14:43:06
8c38a3d7321b75b2344dbf3efaf1e93437f9bac0...d939fe758affe15f5054216f6e594eae386adca3,1,26,10,36,6,2014-08-14 00:06:53,2014-08-13 14:53:48
0af135e9065562e14a77439e13a29b4f1eb627a0...1b95590d06b20b79041f6d23b9bc35612b82cb51,6,247,183,430,31,2014-08-04 21:05:12,2014-08-01 17:34:06
1b95590d06b20b79041f6d23b9bc35612b82cb51...ba663eac3a2deba4d89803453b07a09d8628f5f9,1,10,1,11,2,2014-08-04 21:05:12,2014-08-01 22:57:28
c9ca37dfe9c6050a290e52cad107bb8d4fd575bf...f34679d0a999eaf370f3544cd1c21b90b8876795,1,31,25,56,5,2014-08-06 21:22:40,2014-08-06 19:27:58
c9ca37dfe9c6050a290e52cad107bb8d4fd575bf...6e28d11d1fde757cf5b9418a2e752717d854f3f3,4,148,133,281,4,2014-08-06 21:18:50,2014-08-05 04:08:25
6e28d11d1fde757cf5b9418a2e752717d854f3f3...55235e121eb2924488508f70b8f30e0e9905d85e,4,47,38,85,4,2014-08-06 21:18:50,2014-08-05 04:50:25
55235e121eb2924488508f70b8f30e0e9905d85e...51dd68d65949b4b542d65e4de2f1b18550c9cff1,4,104,94,198,6,2014-08-06 21:18:50,2014-08-05 05:02:51
51dd68d65949b4b542d65e4de2f1b18550c9cff1...77781440f13b07caa19c835523cbc6591dc1ffa8,4,39,31,70,4,2014-08-06 21:18:50,2014-08-05 05:11:02
77781440f13b07caa19c835523cbc6591dc1ffa8...f2029f7be19c75ccc291608d1bd07bc0de220276,4,119,106,225,5,2014-08-06 21:18:50,2014-08-05 05:19:23
f2029f7be19c75ccc291608d1bd07bc0de220276...fa27580cff5f22bcf2a4860b5582c67d275a0e11,4,62,52,114,5,2014-08-06 21:18:50,2014-08-05 05:29:14
fa27580cff5f22bcf2a4860b5582c67d275a0e11...7a5e3df1625df24d52e2c863706076c59803cff8,4,165,151,316,6,2014-08-06 21:18:50,2014-08-05 06:41:30
7a5e3df1625df24d52e2c863706076c59803cff8...d7879379571e778b30973874df22fed3266cbb8f,4,45,39,84,6,2014-08-06 21:18:51,2014-08-05 06:49:10
d7879379571e778b30973874df22fed3266cbb8f...69f9d488dc915d8b02827658ccc5a7c48136dc03,3,64,121,185,5,2014-08-06 21:18:51,2014-08-05 23:11:09
69f9d488dc915d8b02827658ccc5a7c48136dc03...af0781974df54f2c4959ea1d90c3f43b9ae37799,1,19,12,31,2,2014-08-06 21:19:01,2014-08-06 20:09:29
af0781974df54f2c4959ea1d90c3f43b9ae37799...8d056423f8c433927089bd7eb6bc97abbc1ed502,20,374,339,713,29,2014-08-06 10:08:19,2014-07-31 11:50:59
8d056423f8c433927089bd7eb6bc97abbc1ed502...1c11d7f93e2070c94ad22dfec3336eb1cd548280,4,5,5,10,5,2014-08-06 10:08:23,2014-08-06 09:28:30
2dc21af70b764cb7f3984b576fdfa049cad87c6c...55dc4f2b94f68e9e1b4e73b1f21cf5151f86e8f8,1,5,0,5,1,2014-08-09 12:11:59,2014-08-08 19:26:22
2dc21af70b764cb7f3984b576fdfa049cad87c6c...c74e8b544defeca8fb215a2295066e10f91bedda,12,204,111,315,63,2014-08-08 23:12:35,2014-08-08 23:12:35
2dc21af70b764cb7f3984b576fdfa049cad87c6c...3c49cb17fb6014519925a069ad81c30ff41b3d7f,1,5,0,5,3,2014-08-08 22:01:10,2014-08-07 21:23:28
3c49cb17fb6014519925a069ad81c30ff41b3d7f...99a864431d7eb29840edb7aed78cb361eea7d6ac,2,193,0,193,2,2014-08-08 22:01:12,2014-08-08 21:18:35
e2fce7d61284c2b3a472bdb25eab082b66f82c54...052ad32a7b0dc93dafe7a27034b6911d6a71e849,1,2,2,4,2,2014-06-09 21:30:34,2014-06-09 04:03:20
e2fce7d61284c2b3a472bdb25eab082b66f82c54...875d0b776d0ec4ba68491f82143e6f099a03944a,1,2,2,4,1,2014-06-09 09:23:54,2014-06-09 09:23:54
23bdb3b3a6d5a1a5219a6b82ac6f22ec011b3e81...744d39a46683909b95ac5a769ae5f839a992d59a,1,7,10,17,5,2014-06-08 23:10:41,2014-06-08 23:02:57
23bdb3b3a6d5a1a5219a6b82ac6f22ec011b3e81...e975687b9a877dc46b465b6ce8b811ce6fa02cda,1,1,1,2,1,2014-06-08 23:06:47,2014-06-08 23:06:47
23bdb3b3a6d5a1a5219a6b82ac6f22ec011b3e81...c37b4828dd1062a2e031344a536bf54147481a95,1,3,10,13,1,2014-06-08 23:05:07,2014-06-08 23:03:46
f3bd86376ef46b9e72affa1e3a0058c6af4112b7...6ec86cb6e517bfb5ded818244b9db9510a2ed0b9,4,62,79,141,27,2014-05-24 00:51:16,2014-05-24 00:51:16
baed5d74339407fcc04277d264aa31a995719c75...e89cb9a5e0105afbb0c1ba1176bda07d110295bc,1,2,1,3,1,2014-05-24 00:20:15,2014-05-24 00:16:56
d3ff00948fe28e40cd876159b92a3026c15d1f2c...2a1b7f222a5eff596cabb5ebd88a481a83b24402,4,132,6,138,8,2014-06-02 18:41:22,2014-03-26 00:33:17
d3ff00948fe28e40cd876159b92a3026c15d1f2c...cac24bbfaf59570863a75e34a21b70ce1cc5c51f,1,1,1,2,1,2014-06-02 18:30:32,2014-06-02 18:30:32
58a0e8af8af0989139a3d3c6c3cae1fc30ae24de...147ad3480da6c9e966b1db0d9d607dc6b1483327,1,2,7,9,1,2014-05-28 01:11:47,2014-05-28 00:56:37
58a0e8af8af0989139a3d3c6c3cae1fc30ae24de...1de52caedca11c083e92039e2ecd8671944dfc47,1,14,14,28,2,2014-05-28 00:18:51,2014-05-28 00:17:11
e5ba9f6443a2fabd7b15eb83fd9ef5159046fe05...5f5d66ade63f8040dd14114f2c7161b16a806c5c,5,86,209,295,38,2014-05-27 21:56:15,2014-05-26 01:52:57
e5ba9f6443a2fabd7b15eb83fd9ef5159046fe05...250229605f895226fa868120f1a0ea7f4928bf8c,2,2,0,2,2,2014-05-27 12:17:01,2014-05-27 12:17:01
e5ba9f6443a2fabd7b15eb83fd9ef5159046fe05...11f7f0bf9b510e09a853a9fd2030a95b72462164,2,33,20,53,3,2014-05-27 04:00:34,2014-05-22 19:16:27
11f7f0bf9b510e09a853a9fd2030a95b72462164...3dd4c5f49977bb9538ae1c39605895fde69c86ee,2,14,14,28,2,2014-05-27 04:00:34,2014-05-25 18:26:50
3dd4c5f49977bb9538ae1c39605895fde69c86ee...360fb3d4ea192e28a4d2579589cd16954bb959c1,2,16,14,30,2,2014-05-27 04:00:34,2014-05-25 18:28:14
360fb3d4ea192e28a4d2579589cd16954bb959c1...40630ce4b65755683e496bb7dbf3779b96ec5393,2,20,19,39,2,2014-05-27 04:00:35,2014-05-25 18:41:47
40630ce4b65755683e496bb7dbf3779b96ec5393...b05be686ec490ba68de82434f1ecaff01a84fcfa,2,15,22,37,2,2014-05-27 04:00:35,2014-05-26 19:09:33
b05be686ec490ba68de82434f1ecaff01a84fcfa...c58991f31a6a2ceaee7a3a327bfbc697b059ff51,2,14,20,34,2,2014-05-27 04:00:35,2014-05-26 19:15:40
c58991f31a6a2ceaee7a3a327bfbc697b059ff51...81d16411398c20a7ddc0bbe3e5e1ce0bd95d6519,2,15,15,30,2,2014-05-27 04:00:35,2014-05-26 19:23:46
81d16411398c20a7ddc0bbe3e5e1ce0bd95d6519...b25a9b7138e44950bee646c1bcb691a3dd273ea1,2,14,16,30,2,2014-05-27 04:36:38,2014-05-27 04:36:00
734d108ed244b34a1111d864dc9b53046e3dc0ec...38daa47ee24d88ae15600a5c0f6ebe9ef3f8f1c9,136,27987,6836,34823,1218,2014-06-08 18:18:24,2014-06-05 23:19:32
734d108ed244b34a1111d864dc9b53046e3dc0ec...1a3d43c23ec7bbb1aa206581acd0497c47e29a2f,6,270,196,466,21,2014-06-05 21:13:02,2014-06-04 23:46:30
1a3d43c23ec7bbb1aa206581acd0497c47e29a2f...f3621531579495e7de911004d47e077d421fcfb8,7,85,27,112,23,2014-06-05 21:31:16,2014-06-05 21:28:09
734d108ed244b34a1111d864dc9b53046e3dc0ec...a12453186323372f4d4e23980d3f1caa2de91e5a,2,98,2,100,5,2014-06-05 19:47:33,2014-06-05 18:37:37
0874f9ab77a7957633cd835241a76ee4406196d8...aa9c9569c29e3696c9427d2d66341c95fe076e4f,1,2,2,4,1,2014-12-22 08:59:08,2014-12-22 08:59:08
0874f9ab77a7957633cd835241a76ee4406196d8...800a8e896e810019b625ad0161c4fc4a04c26845,3,1794,25,1819,11,2014-12-22 08:01:33,2014-12-19 08:20:00
0874f9ab77a7957633cd835241a76ee4406196d8...62e8a93c3496791e8bfb2204f68b2a1cdf61fec9,1,1,1,2,1,2014-12-21 11:49:45,2014-12-11 18:53:16
62e8a93c3496791e8bfb2204f68b2a1cdf61fec9...6ac802ecd8e097f49c4b026fd7b5febfc683866c,1,3,0,3,1,2014-12-21 11:49:45,2014-12-18 17:06:04
6ac802ecd8e097f49c4b026fd7b5febfc683866c...a31c14cadca4052a0a141347b322d825f56b814b,1,1,1,2,1,2014-12-21 11:49:45,2014-12-21 04:09:35
0874f9ab77a7957633cd835241a76ee4406196d8...cc89b30d35edc02fc598a0b26fe7a1ed002238e4,4,109,32,141,18,2014-12-21 02:57:32,2014-06-27 07:29:55
cc89b30d35edc02fc598a0b26fe7a1ed002238e4...2865373894f1532fa725481e8f04db4a5d7a0aa8,2,90,75,165,32,2014-12-21 02:57:32,2014-07-16 12:03:01
2865373894f1532fa725481e8f04db4a5d7a0aa8...0da92633b4161ed1f8babe5ec4a9fe98257d34b5,6,272,25,297,21,2014-12-21 02:57:32,2014-11-15 01:36:38
0da92633b4161ed1f8babe5ec4a9fe98257d34b5...137ceae9138e535f8b3f4e76bda18f6db954c231,1,44,23,67,11,2014-12-21 02:57:32,2014-12-01 01:28:25
137ceae9138e535f8b3f4e76bda18f6db954c231...38a595aec561b8a7b4325b6c1c4efd1b0b8e89c0,1,1,5,6,4,2014-12-21 03:42:02,2014-12-21 03:42:02
0874f9ab77a7957633cd835241a76ee4406196d8...f3ed42286e7df3a35ca41a4d19fab2a53a08b382,10,281,232,513,21,2014-12-21 00:40:40,2014-11-20 05:19:16
0874f9ab77a7957633cd835241a76ee4406196d8...b74ccf2a1b9d146fef0bca89a2f6a40eb4c3e486,1,1,1,2,1,2014-12-19 22:48:31,2014-12-19 22:48:31
0874f9ab77a7957633cd835241a76ee4406196d8...585202650cdf0307fcc77ba3c165c5dc8338432c,1,6,5,11,4,2014-12-19 22:36:22,2014-12-19 22:28:12
0874f9ab77a7957633cd835241a76ee4406196d8...9a50dd5f37d001d7c453ea8749454b4c8bf728f1,2,3,2,5,2,2014-12-19 21:46:29,2014-12-19 21:40:28
4988cde7b95437173be224cf1783bf5d7ef34074...f21f9f856e9d5af23521f131799028c2e67c04ed,6,85,20,105,9,2014-12-18 13:13:04,2014-12-12 18:32:11
d06f496e4a41762ffa7adf5fac59de00d27d1196...6afe5bf9ede46b81fb63283c55488dbbc50d5a07,2,8,0,8,2,2014-12-17 01:40:02,2014-12-17 01:40:02
a9ecd2116bded0087a4128623269144cfc09ad52...bf05f78d700532bb7504a2e1fd388f81c48aa2e6,4,7,2,9,2,2014-12-12 18:34:15,2014-12-12 18:34:15
a9ecd2116bded0087a4128623269144cfc09ad52...8f8d24cb1c762e74833bbb9b6e2b58438b42d36b,1,1,0,1,1,2014-12-12 17:40:11,2014-12-11 23:09:48
24a81829284c9c9966f3dbc239dff9adca09d5ef...d942c59b696d16def85f6b65ae65c176f66a5562,8,45,23,68,20,2014-12-15 13:10:49,2014-12-11 12:56:21
b68d7d39bcd96744eec883bb305e907c10fe6aa6...4bc28f4e6bb38ec70fb98a4deea723a2d0812d98,1,6,2,8,3,2014-11-04 14:14:47,2014-11-04 13:43:58
4bc28f4e6bb38ec70fb98a4deea723a2d0812d98...4dbbe4f51a22a9ec335fbf2f6e3981132f868312,1,7,3,10,4,2014-11-04 14:15:00,2014-11-04 13:45:46
4dbbe4f51a22a9ec335fbf2f6e3981132f868312...f665be55fe832086202e54449402c1513cf4f195,1,5,2,7,3,2014-11-04 14:15:07,2014-11-04 13:46:45
34cb92e2d49e2c141a67cd5df73a54c1655b2842...9a85f60c75f2017b14ed5e7f2bae5dc4961cb74c,6,46,0,46,12,2014-11-17 19:23:41,2014-11-17 19:23:41
9a85f60c75f2017b14ed5e7f2bae5dc4961cb74c...8545155c41b1ccc22056733539660b1afa6790ef,3,7,2,9,3,2014-11-17 19:26:43,2014-11-17 19:26:39
8545155c41b1ccc22056733539660b1afa6790ef...6e92dfdfd843aec909572a405337efb25beb6f58,11,68,37,105,20,2014-11-20 17:39:54,2014-11-17 19:39:55
6e92dfdfd843aec909572a405337efb25beb6f58...227f4bbdb3a1e9ff0011d1ebaed39b3cb19d9e75,5,6,7,13,5,2014-11-20 17:40:08,2014-11-17 21:54:11
227f4bbdb3a1e9ff0011d1ebaed39b3cb19d9e75...8ef36dcfe75752a5705813e2d9fa9359a8162b18,2,2,2,4,2,2014-11-20 17:40:08,2014-11-17 22:06:03
34cb92e2d49e2c141a67cd5df73a54c1655b2842...91fb9b2f5a07232cecfcde38a98c3ec6410239b7,4,6,28,34,7,2014-11-17 18:38:08,2014-10-24 04:27:09
34cb92e2d49e2c141a67cd5df73a54c1655b2842...d5098fde9a64fdec2098c7a0c6bd777f88f7d4c9,1,0,1,1,1,2014-11-17 14:27:03,2014-11-17 14:27:03
0f21d9aea75ee48001fee1ce764514f943581254...271f54aea375158b808aa50db58711e7c1d3eef5,1,6,0,6,2,2014-11-10 17:25:17,2014-11-10 17:24:52
29ebb53b522436b9f405b36616a1eeec8b087d2b...9542ea72188614d5b14f9e7fc31c80e6425738c4,1,34,18,52,9,2014-10-30 18:39:45,2014-10-28 15:06:04
29ebb53b522436b9f405b36616a1eeec8b087d2b...453552c8384929d8ae04dcf1c6954435c0111da0,5,563,0,563,5,2014-10-28 10:31:30,2014-08-19 09:23:55
528c15afeda9ef4d4b354d7aaf1be109b14d4110...16346253537267b42bbf35e81c0139b4d0aee43c,3,92,7,99,7,2014-10-20 18:33:20,2014-10-13 06:12:44
528c15afeda9ef4d4b354d7aaf1be109b14d4110...69fe3e1a3493e53acb2da7220764bd3807415ea2,2,5,2,7,2,2014-10-20 17:20:48,2014-10-14 13:19:45
528c15afeda9ef4d4b354d7aaf1be109b14d4110...ed7934fd63ed52ad0086aaac62203e58e304bcb7,1,79,69,148,35,2014-10-20 13:33:17,2014-10-20 13:33:17
528c15afeda9ef4d4b354d7aaf1be109b14d4110...3d10d50c6d85e2d20e10bb925f3a3fc3212d52ea,1,1,1,2,1,2014-10-20 06:17:33,2014-10-20 06:17:33
528c15afeda9ef4d4b354d7aaf1be109b14d4110...65edb07065e9e8a08090a4ac88cf449b7faaff09,2,44,3,47,6,2014-10-19 03:00:20,2014-10-19 02:47:48
b0d219eef0311450306ff5a48ecb0ecee1ce49cc...6aba75db4e7b0151aeb48f450bb43e659ce0ec82,5,98,25,123,19,2014-11-14 20:31:11,2014-11-11 21:31:15
6aba75db4e7b0151aeb48f450bb43e659ce0ec82...5937663a08d9e7ddc9347c4fc33a506d3d596ccd,1,33,13,46,3,2014-11-14 20:32:56,2014-11-14 19:04:47
b0d219eef0311450306ff5a48ecb0ecee1ce49cc...cbf2879349bd6cc3b43f89733a9b81f55bd0c495,1,1,1,2,1,2014-11-13 22:26:49,2014-11-13 22:26:49
0954fb32a4a39735a5fc6e402b1659ee3ba0d1cb...bc956c6b79dbe9cc7a1ab198f92b6843d072eb28,2,80,0,80,4,2014-09-16 16:34:21,2014-09-16 06:52:06
51b26853ef2f124ea837364c02585cbf96999d6a...0a3211f131b63b0646be4a19c3ea5147bd557844,2,59,5,64,6,2014-09-16 21:51:06,2014-09-16 00:51:06
51b26853ef2f124ea837364c02585cbf96999d6a...d758da386a12598533f2388f2887091465c2efd8,2,18,2,20,4,2014-09-16 21:40:56,2014-09-16 21:40:56
b0cff06c9743f1f4edeea38c13a8b657eef446e4...080ca8619172b020c7da29b46f2fe4c939bb47ca,2,7,2,9,3,2014-09-09 20:46:43,2014-09-05 06:43:44
b0cff06c9743f1f4edeea38c13a8b657eef446e4...3e6c69e5a1dbb428c4a62656f96cfe77c19986f9,1,13,7,20,4,2014-09-05 11:40:06,2014-09-03 13:21:06
b0cff06c9743f1f4edeea38c13a8b657eef446e4...5fe94f0d914a20846142a365655dad7a99527b44,2,7,1,8,2,2014-09-05 01:48:34,2014-09-05 01:48:34
68e07f3fa09811468a81fb22575650bee69066e6...d2f75a3040e72562ffa825d5c3efa7004af2640a,3,64,0,64,3,2014-09-08 16:41:26,2014-09-04 19:02:52
4b3ee6c10642a5813b89d5b2e32c01dcede4c871...cde53c51b575d0cdeb01fc3428877ab63165e8b0,1,6,0,6,1,2014-09-08 06:29:04,2014-09-08 06:28:12
4b3ee6c10642a5813b89d5b2e32c01dcede4c871...9e34c42d20ef95225bb6c36235d22935365cbef9,1,8,1,9,3,2014-09-08 03:17:14,2014-09-08 02:49:46
4b3ee6c10642a5813b89d5b2e32c01dcede4c871...1ce3e22efc699d90f69b29f68fedf059ec4379a7,1,1,1,2,1,2014-09-08 02:39:37,2014-09-08 02:39:37
d9f8d3ea9f5b700e8e2f8eb37bcc0ca6f8b8360c...517ba44e3742c39c4c3fc249b8c40e9b7ddd845f,4,47,50,97,41,2014-08-29 08:56:04,2014-08-28 11:39:27
3afe9dbd246982dd82f2c53b647be29ea89a6485...dacae746b70f50dd1f3ea9d40834386b96b6c200,1,127,72,199,29,2014-11-10 21:20:35,2014-11-07 20:21:19
3afe9dbd246982dd82f2c53b647be29ea89a6485...ef150d023a4a2ea57dd2a8ebcb262a98c08feedf,1,2,1,3,1,2014-11-08 14:36:41,2014-11-07 15:20:16
3afe9dbd246982dd82f2c53b647be29ea89a6485...c30ccc62e447ed570ca283feedd872eb359d457b,1,11,5,16,2,2014-11-07 16:16:42,2014-11-07 16:10:36
e08d1f6af2de6f0a402bd0e5c26fb5093fda378e...bc45428220e4a8d05d9a0cbc701a729f7fe2aa8d,1,1,1,2,1,2014-11-11 22:18:40,2014-11-11 22:17:53
349f67632f47a399a6a97a4a4c684b64ba8c6940...6f8e42ac748e0c7597aeedf31adf81451adcda94,1,1,0,1,1,2014-11-08 14:27:25,2014-11-08 14:27:25
349f67632f47a399a6a97a4a4c684b64ba8c6940...f96e04ffc7973e290653044cc86dbc1efb18276d,8,120,55,175,41,2014-11-08 00:14:08,2014-10-08 17:03:57
f96e04ffc7973e290653044cc86dbc1efb18276d...46f29449777b9fb67a02e13fe0f12fc10c99ab4b,6,34,47,81,29,2014-11-08 00:14:08,2014-10-30 23:06:54
349f67632f47a399a6a97a4a4c684b64ba8c6940...a10cca257f678e5e3c866b3c35f77877fe4789d2,10,824,66,890,57,2014-11-07 22:57:20,2014-11-07 22:57:20
a10cca257f678e5e3c866b3c35f77877fe4789d2...3ac4aa0d6ba6cb10b9a46df40f18b81dba137840,1,5,1,6,1,2014-11-07 23:03:12,2014-11-07 22:58:39
349f67632f47a399a6a97a4a4c684b64ba8c6940...480b5e9c62819da3c6bff47faaec16acb42a0185,1,0,1,1,1,2014-11-07 21:13:01,2014-11-07 21:13:01
025363848b53bf6e2f3726e39fd7ee296d55d2b0...a12d89739412dc9fa9f961e0e4a310ec5a53bd74,10,181,69,250,46,2014-11-03 19:57:30,2014-11-03 19:31:37
a34f31b488dce94314e3218e3d52c38747cabc2f...762ffda95d9ddd4f75fa94971ac85c52389648c1,1,1,1,2,1,2014-11-04 16:49:39,2014-11-04 16:49:39
42861f3b45733268da674b82bceb6deef67b5513...c9a76622086cf6019b3ec71ae53fc71c0396a1ef,1,18,26,44,6,2014-11-14 03:43:03,2014-11-13 22:20:24
c9a76622086cf6019b3ec71ae53fc71c0396a1ef...cef27e1d6c0bd302e1c58e9478a0fba99fd3a2d0,1,4,4,8,5,2014-11-14 20:17:33,2014-11-14 19:18:35
42861f3b45733268da674b82bceb6deef67b5513...e71f241c4b8006f097e4c63f7b3ea28d4591ddee,7,10,10,20,10,2014-11-13 09:50:06,2014-11-13 09:40:45
e71f241c4b8006f097e4c63f7b3ea28d4591ddee...1cd12efb5d0065990334de4f97fa85b317f97f11,1,2,2,4,2,2014-11-19 08:09:42,2014-11-19 08:08:39
42861f3b45733268da674b82bceb6deef67b5513...3c3968692d3024fde90637dbdfe56f08de100cdd,1,2,2,4,2,2014-11-13 08:21:34,2014-11-13 08:21:34
42861f3b45733268da674b82bceb6deef67b5513...4455f517605f1fd7279bbe9547915f15c037997d,6,16,20,36,12,2014-11-13 02:34:03,2014-11-11 22:37:44
4455f517605f1fd7279bbe9547915f15c037997d...78e859f3c35d1f31e7d6f3ded9a414dc0fbb8eaa,2,10,4,14,4,2014-11-13 02:34:03,2014-11-12 01:08:59
78e859f3c35d1f31e7d6f3ded9a414dc0fbb8eaa...fbe10c83d81843412fd3485a8d6bb75849de97d4,4,18,9,27,12,2014-11-13 15:02:24,2014-11-13 14:56:36
42861f3b45733268da674b82bceb6deef67b5513...ad6467f9e17205fa76a3b916efe51ba5c1b37506,2,8,1,9,2,2014-11-13 02:03:04,2014-10-31 00:26:39
ad6467f9e17205fa76a3b916efe51ba5c1b37506...2b10749cdd0939e4b9e6e18e160984129d733663,2,49,7,56,9,2014-11-13 02:03:04,2014-10-24 23:25:24
2b10749cdd0939e4b9e6e18e160984129d733663...e49567ba729001c31fe71e4b715eed8f50d7ded9,1,1,1,2,1,2014-11-13 18:37:47,2014-11-13 18:37:47
e49567ba729001c31fe71e4b715eed8f50d7ded9...553b50bd37ade60bfafe5d5cc10f984251741f44,1,1,2,3,2,2014-11-22 02:36:23,2014-11-22 02:36:23
553b50bd37ade60bfafe5d5cc10f984251741f44...b9f1b0a7514c6e40e7048fb9206001259eb7c33c,1,10,9,19,2,2014-11-25 01:06:41,2014-11-22 03:26:09
56261daf32a1c5490ce0b5b500bf4245b6ac63bd...6dc11cc992531a2cf75666e417af7730a7f0764b,4,4,4,8,4,2014-11-07 01:56:56,2014-11-06 03:39:42
56261daf32a1c5490ce0b5b500bf4245b6ac63bd...69a5b827dcf01a6de5949a161606058017014cdc,3,37,0,37,5,2014-11-06 02:23:42,2014-11-06 02:23:42
56261daf32a1c5490ce0b5b500bf4245b6ac63bd...7f5ebdcaac51a3a0cf3805397748154d3743469c,33,474,348,822,87,2014-11-06 01:12:41,2014-11-06 01:12:41
7f5ebdcaac51a3a0cf3805397748154d3743469c...ed556fb38f4d1cba1460650f703cc8147a7b8f32,2,3,15,18,7,2014-11-06 01:14:13,2014-11-06 01:14:13
9670871e0166658c5b6982d3ccf79a82afb9442c...4f5be9da86ffed40b810bb1840c19526a9156ab3,1,40,20,60,8,2014-11-14 02:50:34,2014-11-13 01:32:38
9670871e0166658c5b6982d3ccf79a82afb9442c...6d97339ca23ada27812572016ad4ff9ccffa8b09,2,62,31,93,8,2014-11-13 18:13:13,2014-11-13 17:57:28
d32d9300edc62ebc7c5268544a77b01ebcb40961...543127e211ce60b53d554199fdbbd3fe7b85c1c6,1,12,4,16,3,2014-11-09 21:41:08,2014-11-09 15:16:19
543127e211ce60b53d554199fdbbd3fe7b85c1c6...2d688b0a787d6f38de244ed1294b0ed91c3533ba,1,4,0,4,1,2014-11-09 21:41:12,2014-11-09 15:17:23
2d688b0a787d6f38de244ed1294b0ed91c3533ba...4cf0aa711edf3692291766c1d84ec550431b79b2,1,0,0,0,0,2014-11-09 21:41:13,2014-11-09 15:33:19
6fcc9141d71796822ac87e2c54d253c7abd27726...2e482c86bc14ddd4cfa45281dcf8f9ca141c9f14,3,81,3,84,6,2014-11-07 21:58:05,2014-10-22 18:16:42
6fcc9141d71796822ac87e2c54d253c7abd27726...2fbfa29318f66aac131bdddd9b32f28b7b7e508a,1,1,0,1,1,2014-11-06 19:06:52,2014-11-06 19:06:52
6fcc9141d71796822ac87e2c54d253c7abd27726...5bd5ef5a0accf24d4fd8f810e167a7717c9aa7ae,1,1,1,2,1,2014-11-06 17:40:13,2014-11-06 17:40:13
5bd5ef5a0accf24d4fd8f810e167a7717c9aa7ae...dad58737aea8ef4c6389cb118566fc06402fd635,1,20,18,38,3,2014-11-07 07:54:25,2014-11-07 07:54:25
6fcc9141d71796822ac87e2c54d253c7abd27726...2329354dc3e874b6e93b7b9feafa9c67172840fc,1,6,5,11,8,2014-11-06 17:43:59,2014-11-06 17:17:02
6fcc9141d71796822ac87e2c54d253c7abd27726...b36bf9817482e97448f11a2f3eaf15b3a795d2f7,2,109,5,114,8,2014-11-06 02:14:03,2014-11-04 16:40:59
006d2334d1e5eb7d29d16290b20ae376d8b1beb8...f9f80443638fc2d703ee6205c8ef3db8e38db9a3,4,160,20,180,18,2014-10-29 18:52:52,2014-09-15 18:45:53
f9f80443638fc2d703ee6205c8ef3db8e38db9a3...f710a8d7746df5f54e2cbe7b90885e4eb75920b4,1,97,0,97,1,2014-10-29 18:52:59,2014-10-28 20:59:27
f710a8d7746df5f54e2cbe7b90885e4eb75920b4...f14a9ed011d9b73104631310a13eab447d53be3a,2,6,3,9,5,2014-10-29 18:52:59,2014-10-28 21:01:10
006d2334d1e5eb7d29d16290b20ae376d8b1beb8...d98b117962a7178154e775b8b283744841a10e3b,1,95,0,95,1,2014-10-29 17:59:20,2014-09-30 19:18:26
d98b117962a7178154e775b8b283744841a10e3b...e171eda9989cb5d10e7fe14b258f239edb124541,2,4,2,6,2,2014-10-29 17:59:20,2014-10-16 23:54:55
c0499494df9a104f161ff9de93f2c186a3f8cce0...3aae63f4528ab1d7e1e12cc4e2e7bacd97991d43,1,20,3,23,4,2014-11-12 05:04:45,2014-11-11 19:37:47
3aae63f4528ab1d7e1e12cc4e2e7bacd97991d43...a2a50aa35ab58f52b68a65acfe668c26b765608f,1,3,3,6,1,2014-11-12 05:04:45,2014-11-11 20:15:00
a2a50aa35ab58f52b68a65acfe668c26b765608f...1e7ba09b60aa0bc527dc7e0159071a6d47796de4,1,23,0,23,1,2014-11-12 14:14:35,2014-11-12 14:13:47
1e7ba09b60aa0bc527dc7e0159071a6d47796de4...87d0562c61b80aba05f4c3b4f49f5527afb55989,1,10,2,12,5,2014-11-12 14:14:35,2014-11-12 08:22:08
87d0562c61b80aba05f4c3b4f49f5527afb55989...29be7b439ec4d0c8a54852ccbbe7b6bcf040e13f,1,59,0,59,4,2014-11-13 18:08:52,2014-11-13 03:14:15
487af281bf39417f95d51c70557e9e5ca3e90f8d...b63c10558e6fe187d9cee25a4d8bad4bffd7f79b,1,13,0,13,1,2014-08-19 20:39:50,2014-08-19 20:39:50
b63c10558e6fe187d9cee25a4d8bad4bffd7f79b...98dd982586ed9fd99853001d4a27503180e432c4,1,3,3,6,2,2014-08-20 00:22:11,2014-08-20 00:22:11
849086d3d965cea7d7e04b3559edc9c903e30ba6...fcad8ee83a2cf9192ba4f9ec7d5c1d0b03a6aa47,2,121,0,121,2,2014-08-26 01:10:09,2014-08-26 00:28:41
366fe67946c553c89c696b46307dd6e15e8c6c40...badf8247afa378d04835ec19243ede2fb89a7b31,1,1,1,2,1,2014-08-19 18:23:02,2014-08-19 12:04:02
badf8247afa378d04835ec19243ede2fb89a7b31...f04ef96e076b811eca1f7f230b126572369ccc44,1,32,0,32,1,2014-08-20 16:02:56,2014-08-20 16:02:56
366fe67946c553c89c696b46307dd6e15e8c6c40...f3b2c93b9f01ac909de4f93753a21eacb02bcd9f,2,9,20,29,9,2014-08-19 17:06:17,2014-04-09 23:17:39
f3b2c93b9f01ac909de4f93753a21eacb02bcd9f...fc39f9c78d89332d2364c4781010f5fb4b500fe4,1,81,0,81,1,2014-08-19 17:06:17,2014-07-22 18:16:15
fc39f9c78d89332d2364c4781010f5fb4b500fe4...26feb09fac7cfcafef36cc71df1176301c70eb53,1,11,0,11,1,2014-08-19 17:06:17,2014-08-14 00:26:44
366fe67946c553c89c696b46307dd6e15e8c6c40...dad2fcb1993d9cd7c513db10965aa37d7f9a542d,1,1,1,2,1,2014-08-19 16:52:46,2014-08-19 16:52:46
366fe67946c553c89c696b46307dd6e15e8c6c40...0800f8cc19732a41d8f04aaf42427399557afa54,1,11,0,11,1,2014-08-19 11:59:13,2014-08-19 11:42:56
997336fd95270a35b0dc8cc17aa969fd8c2e6f81...624b944896d47031f9df166b4275037664a3cb23,10,76,49,125,36,2014-08-20 18:19:55,2014-08-20 18:19:55
2eb26991f4ef47225a7312e65660debf1d8f6b48...cd71f92a7fda7a8bdf328a91c37a759463862aeb,1,1,0,1,1,2014-08-20 18:19:46,2014-08-20 18:10:42
2eb26991f4ef47225a7312e65660debf1d8f6b48...ce3c1f376c21810fd6ec062af810d18682fa2d78,1,1,0,1,1,2014-08-20 13:37:39,2014-08-19 11:48:55
9fa4bea03b13923c399e9244808a83d007f93662...17ab516fdeb53fe59fbca1b832429d846d8f571b,1,32,0,32,1,2014-08-11 06:42:55,2014-08-11 05:54:59
17ab516fdeb53fe59fbca1b832429d846d8f571b...44842ea3d86268dbe5279b2d5bd47b6c6a4a1b44,1,35,0,35,1,2014-08-11 07:39:47,2014-08-11 07:39:47
7dde97640f9935c35104de6aa09dfcf33ba20ffc...d082381a93810e6c386382f24da93518880e9250,2,2,4,6,2,2014-07-25 22:29:47,2014-07-25 22:29:47
d082381a93810e6c386382f24da93518880e9250...caa57699283fd0fa47cac59c80adcacaa5c9950e,1,1,1,2,1,2014-07-25 23:26:27,2014-07-25 22:31:06
487a417d9fd074d0e78876072c7d1ebfd398ea7a...c0517857f64d1148d02809e3ba3dd39bf8322ed3,3,6,3,9,6,2014-07-29 13:30:45,2014-07-28 15:01:21
487a417d9fd074d0e78876072c7d1ebfd398ea7a...f60c8e9e6154629de8eaa19bfa0f52b2be4791e5,1,14,0,14,3,2014-07-29 12:56:41,2014-07-22 22:54:56
f60c8e9e6154629de8eaa19bfa0f52b2be4791e5...372f9bb58b820b85ed1975ea713958b684c17e94,1,77,110,187,30,2014-07-29 13:01:56,2014-07-29 13:01:56
487a417d9fd074d0e78876072c7d1ebfd398ea7a...2095e22121833e5d38890c321a7a67ead405e3ec,1,1,1,2,1,2014-07-28 13:39:55,2014-07-28 13:39:55
487a417d9fd074d0e78876072c7d1ebfd398ea7a...fe68df36fc9c85ae30af9bf53a13e8af0534e613,1,1,1,2,1,2014-07-27 22:17:40,2014-07-26 14:41:50
fe68df36fc9c85ae30af9bf53a13e8af0534e613...0f26195a8ddd0bde95865816576d827a9ed0727c,1,1,1,2,1,2014-07-27 22:18:14,2014-07-26 14:42:24
0f26195a8ddd0bde95865816576d827a9ed0727c...533916fa6bb0b19fb887b5b0b2b704b224154b41,1,0,1,1,1,2014-07-28 09:50:24,2014-07-26 14:43:28
487a417d9fd074d0e78876072c7d1ebfd398ea7a...d0a0e91f1f8c3a43f04e7a58e37498124b283594,3,3,3,6,3,2014-07-26 18:33:31,2014-06-19 02:04:08
487a417d9fd074d0e78876072c7d1ebfd398ea7a...158e3068bda22ee09b00d37b3e4b33e42ecced1b,2,67,23,90,8,2014-07-26 15:46:36,2014-06-27 19:55:36
158e3068bda22ee09b00d37b3e4b33e42ecced1b...3a1385702cdd69a0b85b726dac6e749eb0e97fc1,1,4,4,8,4,2014-07-26 15:46:36,2014-07-03 18:29:07
3a1385702cdd69a0b85b726dac6e749eb0e97fc1...a6085fd430e8f155e4a0738de752df3c77bc132f,2,22,13,35,12,2014-07-26 15:46:36,2014-07-03 21:11:32
a6085fd430e8f155e4a0738de752df3c77bc132f...81e78db507c7523696b4115b5675170925a417e9,1,1,0,1,1,2014-07-26 15:46:52,2014-07-09 21:21:39
81e78db507c7523696b4115b5675170925a417e9...0a7cd70924178304d1919ae5ea2cc86620f2be54,1,1,1,2,1,2014-07-26 15:46:52,2014-07-09 22:43:57
0a7cd70924178304d1919ae5ea2cc86620f2be54...4cfe806db2a41a97079a4881d4a0099a7b5b8149,2,2,1,3,2,2014-07-26 17:45:35,2014-07-26 17:45:35
487a417d9fd074d0e78876072c7d1ebfd398ea7a...96f1a990346b7702e6f3efee42389b2736dbb204,1,14,0,14,2,2014-07-26 00:45:49,2014-07-10 19:24:41
7e12911f62080a5bf2f8da8583eebe95c648da68...90e97960fa2282189f16b44a8699b3c6ec12e520,1,16,2,18,2,2014-08-08 10:36:20,2014-08-07 13:41:23
7e12911f62080a5bf2f8da8583eebe95c648da68...3f136dc0e0feb826eb67c2c2d600ee681a16bb02,4,26,19,45,13,2014-08-07 11:06:39,2014-08-05 00:59:37
7e12911f62080a5bf2f8da8583eebe95c648da68...8891bb52def06aa4fe21af544c6a3a50ecfa9a5b,1,1,0,1,1,2014-08-07 06:23:00,2014-08-07 06:23:00
ab3e34e1874872854e93c290990e081e1b202b65...7d78dc33b15c9c5fd4cc2c0c5526cdfd5505ee4f,1,11,1,12,10,2014-08-07 21:32:11,2014-07-30 13:13:13
7d78dc33b15c9c5fd4cc2c0c5526cdfd5505ee4f...d687c5b3393a22e0db6473f0572a332f211c7102,2,2,1,3,2,2014-08-07 21:32:11,2014-07-30 13:13:43
d687c5b3393a22e0db6473f0572a332f211c7102...f8f36ff320d5b14a5fb61ab3fec0b1e7ef1e8aa6,2,3,3,6,4,2014-08-07 21:32:11,2014-07-30 13:22:15
f8f36ff320d5b14a5fb61ab3fec0b1e7ef1e8aa6...7a34f1343372b0712155087a9a5f447b59b60084,1,1,1,2,1,2014-08-07 21:32:11,2014-08-07 21:30:10
ab3e34e1874872854e93c290990e081e1b202b65...b87daf6d697655ca092bf54717a64b07504a13c1,3,2,0,2,1,2014-08-07 21:25:21,2014-07-30 13:35:42
b87daf6d697655ca092bf54717a64b07504a13c1...b386bce1f1bc92584282cc3f6656878c05d75272,2,0,0,0,0,2014-08-07 21:33:09,2014-08-07 21:24:37
c9c271858a652583ba548cb2ea75df68b51a9dd3...6aecdb4f8e73031f0deeac88a88ffc3fad9d5377,1,11,4,15,1,2014-08-13 21:40:25,2014-08-13 21:32:20
c9c271858a652583ba548cb2ea75df68b51a9dd3...7bfc78b03813fd35b0098b1e778180138976c40d,1,0,24,24,1,2014-08-13 19:49:12,2014-08-13 19:49:12
c9c271858a652583ba548cb2ea75df68b51a9dd3...cdf8a55670793a135a53549c5e1877c33a66be0c,1,1,0,1,1,2014-08-13 19:18:23,2014-08-13 19:18:23
c9c271858a652583ba548cb2ea75df68b51a9dd3...a4befff533cf786df7a4da29798984ebb2268d8c,5,20,20,40,19,2014-08-13 19:09:51,2014-08-09 22:30:27
a4befff533cf786df7a4da29798984ebb2268d8c...6d59a566759da5729d7eb89a8e1888fc612f03cf,1,28,0,28,1,2014-08-13 19:09:51,2014-08-10 01:12:52
6d59a566759da5729d7eb89a8e1888fc612f03cf...6200002669874f3314856527fecd0c004060913c,5,54,20,74,18,2014-08-13 19:25:47,2014-08-10 01:13:44
6200002669874f3314856527fecd0c004060913c...353b7c8ec77b30fa83dac5ec0778193f6de8b437,6,70,80,150,23,2014-08-13 19:25:51,2014-08-10 01:18:32
353b7c8ec77b30fa83dac5ec0778193f6de8b437...ca11b77471bd3a99b4dbc44b716675ba8174306c,2,5,8,13,3,2014-08-13 19:25:51,2014-08-10 03:50:46
ca11b77471bd3a99b4dbc44b716675ba8174306c...1eba59eb249b14a0499a52495be2c27b5afc4749,2,7,9,16,2,2014-08-13 19:25:51,2014-08-10 03:58:19
1eba59eb249b14a0499a52495be2c27b5afc4749...1d10c55aec891df609d36c90ee6c30adb24c16c4,10,11,20,31,17,2014-08-13 19:25:51,2014-08-11 22:30:01
1d10c55aec891df609d36c90ee6c30adb24c16c4...a30fd7a962f8486df0d0dbd3334c7621d22c1aec,1,1,1,2,1,2014-08-13 19:25:51,2014-08-13 06:45:40
8733cd7c0bc1224f9b50e3f9c0c1d86dac3f1add...5240e5f71380b68792abcd3cf54283385ec7a4f0,2,10,0,10,2,2014-08-06 10:29:15,2014-08-06 10:25:14
dc296903f072b8e710954954acecad4ccd4e04b6...c58c70b8bdfc4d13faefaab31d2d1539d5478223,1,10,0,10,1,2014-08-12 17:35:14,2014-08-07 18:13:42
93da07a8dc2b33e161d279fef35e2470e8beafaf...d745067487fe2a750cfa2625ed7f652a56abc17c,2,83,8,91,4,2014-08-06 17:56:11,2014-08-05 10:00:05
d745067487fe2a750cfa2625ed7f652a56abc17c...d55e3fea72efb2ae24e4fe1781bbe9002846f4d3,2,58,37,95,4,2014-08-06 17:56:11,2014-08-05 16:32:24
d55e3fea72efb2ae24e4fe1781bbe9002846f4d3...c9f3fd3fc7a4beb97de40ef8da7330b23397d9d3,4,40,55,95,13,2014-08-06 17:56:11,2014-08-06 08:12:22
c9f3fd3fc7a4beb97de40ef8da7330b23397d9d3...b4efcd53e0a62a8ce1080e94e28358ac1a2d6ae2,3,0,25,25,5,2014-08-06 17:56:11,2014-08-05 07:21:05
b4efcd53e0a62a8ce1080e94e28358ac1a2d6ae2...78f0a914ee982126793534286682e6c6e4270e97,4,4,23,27,7,2014-08-06 17:56:11,2014-08-05 07:56:29
78f0a914ee982126793534286682e6c6e4270e97...61eab759397a0915a0dd69de399d49d2a0ed0ba6,1,80,0,80,1,2014-08-06 17:56:12,2014-08-06 12:08:05
61eab759397a0915a0dd69de399d49d2a0ed0ba6...20b0841c1bd07c6add812597e0d656d7584e48ac,4,1,14,15,5,2014-08-06 17:56:12,2014-08-06 12:31:09
20b0841c1bd07c6add812597e0d656d7584e48ac...92105ea0fa774607ea4c7f487aedfd22eb5598bc,1,0,1,1,1,2014-08-06 17:56:12,2014-08-07 20:10:49
92105ea0fa774607ea4c7f487aedfd22eb5598bc...eb79dc14fe45f3805d83e5e5e64b335da6389d6a,1,13,4,17,3,2014-08-06 17:56:12,2014-08-06 15:52:11
875d0b776d0ec4ba68491f82143e6f099a03944a...1c05ddd645c50102321274ec7595c8b62dd71335,1,7,0,7,1,2014-06-16 13:39:48,2014-06-09 13:43:26
c740c760173ccf09afadd4dce6c6e07e23b29692...4fd9cc9980d9ef5a788a9163287fb50e13669cdb,1,200,244,444,41,2014-06-08 23:46:31,2014-06-07 22:20:43
b292928cd5414e3fc3452d409e490460adbd5e51...996133b9babbe4c4dfb42ee0d5aea9566568af14,1,1,0,1,1,2014-06-03 00:05:54,2014-06-03 00:05:54
b292928cd5414e3fc3452d409e490460adbd5e51...0633b12b286d763521124f6d144deade89a89bfc,1,14,1,15,4,2014-06-02 23:03:10,2014-06-02 23:03:10
d53eb2f67cbdd632d6e4cad8de9d8f654baa96a3...69640123826cf73d3d83182cb81e5de4ad0cc3a7,1,27,27,54,27,2014-05-28 02:03:57,2014-05-28 02:03:57
d53eb2f67cbdd632d6e4cad8de9d8f654baa96a3...b64535166f4e930121bf9cb624bf2d044c97e472,1,4,4,8,3,2014-05-28 01:57:25,2014-05-28 01:57:25
cf47b46036b22d6515f8715eab3b86cead026fb7...838e69e11e15dcf6cc1bc73f26602f814ce3698c,16,18,162,180,30,2014-05-27 17:08:19,2014-05-27 17:08:19
d09421a74fa268274c50308f2655e654949f505b...c1e04fbb150d71c243d505b79136108cb2f31f5c,1,0,10,10,3,2014-12-22 23:36:20,2014-12-22 23:05:41
043e33c2c150507915b12ed9f657895a7900605b...7fdbd90f8805736aa78156faf7e6f8fdd2384af7,2,17,0,17,2,2014-12-23 20:49:45,2014-12-23 19:16:23
043e33c2c150507915b12ed9f657895a7900605b...50905a6d6ce2fdd1ab0c33ec0b7a26895e0cbeea,43,515,360,875,112,2014-12-23 20:10:03,2014-12-23 20:10:03
ed49db89845d1fd43ad5fecf268bfbb3e47f7e50...4fd2a9156cafba7d0747d7a049eda12aac86daf8,1,1,1,2,1,2014-12-23 19:01:27,2014-12-23 19:01:19
364720b5e7e725cdc466171de873eefdb8609a33...8936789919c5c8004f346f44a3452d1521818b60,17,70,42,112,41,2014-12-18 22:03:38,2014-10-28 21:06:23
f0f4e42375353dc04101bb7d0f263500f4d2d046...2524c0c5555f9127b4cd3d326430617f72979bab,6,36,50,86,8,2014-12-17 21:23:24,2014-12-17 21:23:24
f0f4e42375353dc04101bb7d0f263500f4d2d046...bc1507dfce956846ba1515ccbfcd202c06aa995b,1,0,1,1,1,2014-12-17 18:06:13,2014-12-17 18:04:30
323c3c1381804f967ff41412be0a7cdf5fa98f11...f42c0a53a38a2a141bec8768d0836a3726de4a83,1,17,0,17,1,2014-12-16 21:25:01,2014-11-22 08:25:57
506a8c24d7b08f99f53b064f3d83308af127e2e4...1b104ce7c3b18ad4bd38a819525a0d5ad78d3c85,1,4,0,4,1,2014-12-13 00:26:44,2014-12-12 20:14:26
d7d981bf3a0ef4fba563cde0d372f2a1373a70e9...4856ec075422a7926b62762749a7fbcc869efa99,1,34,0,34,1,2014-12-12 19:15:31,2014-12-12 19:15:31
d7d981bf3a0ef4fba563cde0d372f2a1373a70e9...6b340e391cff68e6fc2c816cf15ffd67feddf029,1,3,2,5,2,2014-12-12 18:51:12,2014-12-12 18:51:12
7da0f2ee1991786f0a62a989ea2276c37d409b2c...37bdb05615763f94f7877cce3426752d43b48ff7,3,3,0,3,3,2014-12-15 15:50:56,2014-12-13 12:58:21
37bdb05615763f94f7877cce3426752d43b48ff7...51da97628a0ffb2a1c4be2c4d1bbcb09537d6c8d,5,23,9,32,9,2014-12-15 15:51:29,2014-12-15 15:28:42
2f9ffe5b6ac1c547d1b5c228637007b05af48a3f...3182ee5c9bc13f67858c3676a560427d4882f12c,1,26,16,42,13,2014-10-16 22:05:00,2014-10-14 18:26:53
3182ee5c9bc13f67858c3676a560427d4882f12c...88d65cbdf4881c0e56556d9c8efbf60410f0645f,1,36,14,50,12,2014-10-16 22:05:00,2014-10-14 19:23:10
88d65cbdf4881c0e56556d9c8efbf60410f0645f...b645df1d39f942919a117bdf9f9528e38681dc0b,1,9,5,14,3,2014-10-16 22:05:00,2014-10-14 19:25:46
b645df1d39f942919a117bdf9f9528e38681dc0b...475235ba7e5ad5a8c1f3bbbad6566bb646eac0f9,1,9,5,14,3,2014-10-16 22:05:00,2014-10-14 19:28:56
475235ba7e5ad5a8c1f3bbbad6566bb646eac0f9...6b858b59ed6e1f594e5552e3f5e8f46351466d78,1,22,11,33,9,2014-10-16 22:05:00,2014-10-14 19:34:02
6b858b59ed6e1f594e5552e3f5e8f46351466d78...17842840ec0fc7a0b66050b97692250b74d91372,1,13,5,18,4,2014-10-16 22:05:00,2014-10-14 19:38:00
17842840ec0fc7a0b66050b97692250b74d91372...0faf87598f19bd3520704ed18209afbbe6a6ee90,1,24,13,37,9,2014-10-16 22:05:00,2014-10-14 19:44:29
0faf87598f19bd3520704ed18209afbbe6a6ee90...b59d5a9dd2e0e474f04ce4eb31de41a1484d97bf,1,1,4,5,3,2014-10-16 22:05:00,2014-10-14 19:46:26
b59d5a9dd2e0e474f04ce4eb31de41a1484d97bf...f7b3a6b292a1f8dc7cfffe2e93622ea2c3419623,1,1,2,3,2,2014-10-16 22:05:00,2014-10-14 19:47:35
f7b3a6b292a1f8dc7cfffe2e93622ea2c3419623...7d38ae7041357e58edee5c26f721e39be9ff1fbd,1,7,4,11,4,2014-10-16 22:05:00,2014-10-14 19:50:35
7d38ae7041357e58edee5c26f721e39be9ff1fbd...ac62c5439ac6197c3afca66db4489f96296097b6,1,28,16,44,9,2014-10-16 22:05:00,2014-10-14 19:56:13
ac62c5439ac6197c3afca66db4489f96296097b6...73eadbc6a1af80dfb1e933644a9a2927004e6d0f,1,3,1,4,1,2014-10-16 22:06:16,2014-10-14 19:59:54
73eadbc6a1af80dfb1e933644a9a2927004e6d0f...ef787eb824896471485522d343c62a6edb5c947f,1,1,4,5,3,2014-10-16 22:06:19,2014-10-14 20:01:08
ef787eb824896471485522d343c62a6edb5c947f...d33f2bdb114a9fd3c1413dbd4667440153df9431,1,84,30,114,28,2014-10-16 22:06:19,2014-10-14 20:04:37
d33f2bdb114a9fd3c1413dbd4667440153df9431...ac24cabd9d05fe8843a382bb55fe5f2dcd4b9da2,2,6,4,10,6,2014-10-16 22:06:19,2014-10-14 20:06:06
ac24cabd9d05fe8843a382bb55fe5f2dcd4b9da2...0e3744ec8958faf88026338dcb096198399059e8,1,3,2,5,2,2014-10-16 22:06:20,2014-10-14 20:09:19
0e3744ec8958faf88026338dcb096198399059e8...0c87424007aa1220842acca26cbadc7c1a05bef9,1,78,46,124,27,2014-10-16 22:06:20,2014-10-14 20:22:06
0c87424007aa1220842acca26cbadc7c1a05bef9...b1e3c9e9cd49591f8efcbcd00d45bcd98fbe2831,1,79,91,170,33,2014-10-16 22:06:20,2014-10-14 20:51:12
b1e3c9e9cd49591f8efcbcd00d45bcd98fbe2831...764030ec92f8cf8b47079c26d7c1393bd963fbf4,1,39,22,61,16,2014-10-16 22:06:20,2014-10-14 20:59:44
764030ec92f8cf8b47079c26d7c1393bd963fbf4...f013506aad8b7c09b3c2d3307dadfa4b2d365d40,1,7,14,21,4,2014-10-16 22:06:20,2014-10-14 21:02:15
f013506aad8b7c09b3c2d3307dadfa4b2d365d40...50c3e7537c055a73a71999cb3ae9f2c6aa57efce,1,3,6,9,2,2014-10-16 22:06:20,2014-10-14 21:05:37
50c3e7537c055a73a71999cb3ae9f2c6aa57efce...dd248dee3c889fe376a89adcc9f9d19cafb9bf69,1,6,3,9,3,2014-10-16 22:06:20,2014-10-14 21:07:30
dd248dee3c889fe376a89adcc9f9d19cafb9bf69...eeb009729430f0858f56be37011325f3f9486386,1,4,10,14,3,2014-10-16 22:06:20,2014-10-14 21:09:40
eeb009729430f0858f56be37011325f3f9486386...6f1c8ff4c4fd1f001917c3af89907731561642a6,1,19,11,30,6,2014-10-16 22:06:20,2014-10-14 21:13:07
6f1c8ff4c4fd1f001917c3af89907731561642a6...9f52d8e6e786e62aa63b06d26782120fd25daf31,1,45,19,64,15,2014-10-16 22:06:20,2014-10-14 21:18:55
9f52d8e6e786e62aa63b06d26782120fd25daf31...842d4b6b0afb0380afeea6d1638edb8913ae70bd,1,51,17,68,17,2014-10-16 22:06:20,2014-10-14 21:22:49
842d4b6b0afb0380afeea6d1638edb8913ae70bd...66ac7420a90c832bacd0cb1832bf934b5420a311,1,28,22,50,11,2014-10-16 22:06:20,2014-10-14 21:40:28
66ac7420a90c832bacd0cb1832bf934b5420a311...5af7facf18565100d52fa198a695ab98a9669825,1,0,13,13,2,2014-10-16 22:06:20,2014-10-14 22:11:21
2f9ffe5b6ac1c547d1b5c228637007b05af48a3f...9edf96782470deb15deec3be07e3988164454148,1,22,0,22,1,2014-10-16 21:40:55,2014-10-09 03:34:20
ecaba0eb4abd5ad26eb07f7ac89a16b8914347fa...975fa5487ca531374fed421b52de1adf133c9810,16,67,444,511,44,2014-11-17 20:16:37,2014-11-17 20:16:37
ecaba0eb4abd5ad26eb07f7ac89a16b8914347fa...a3068a109cc2c472966d5a080f81ca344232f26c,1,1,1,2,1,2014-11-17 20:03:00,2014-11-17 20:03:00
998b591a71094b3f0112dac9b0c35a93745ac28f...7ff3b81054b028a4399c86340489fe3937049abe,6,179,24,203,27,2014-11-20 19:46:48,2014-11-20 19:46:48
7ff3b81054b028a4399c86340489fe3937049abe...284cbda9ceb368d4bb67c0c75739984622570d92,1,4,4,8,4,2014-11-20 19:54:03,2014-11-20 19:54:03
284cbda9ceb368d4bb67c0c75739984622570d92...f0f0e316aab2c8cc6e2f0124c7bde7661a15461c,1,5,6,11,5,2014-11-26 00:00:56,2014-11-25 17:07:04
998b591a71094b3f0112dac9b0c35a93745ac28f...2fe36baa0a39840e64f1dc585af41b5ee0ed6df5,8,34,4,38,12,2014-11-20 19:23:58,2014-11-20 18:36:05
2fe36baa0a39840e64f1dc585af41b5ee0ed6df5...62a7d75512d939a86cbc58986278548df3302902,3,3,3,6,3,2014-11-21 19:15:22,2014-11-21 19:15:22
d5098fde9a64fdec2098c7a0c6bd777f88f7d4c9...a0605107d713f7f8a25277b06369134d17781077,1,20,0,20,1,2014-11-17 23:12:55,2014-11-17 20:49:29
a0605107d713f7f8a25277b06369134d17781077...ac40e7cbb3cf01568b3763abe04af814d89a6f36,1,3,0,3,1,2014-11-18 01:04:10,2014-11-17 21:16:33
3c5155ac16bbf4d02d88ad5f2c4bfef7844dad4e...67ca7415e71a3e6389b883f746a1a15580deb892,1,3,3,6,2,2014-11-10 19:33:16,2014-11-10 19:33:16
67ca7415e71a3e6389b883f746a1a15580deb892...ca0885729df52698264dd10ba403eb8ab88d9642,1,2,1,3,1,2014-11-11 01:50:12,2014-11-11 01:50:12
c3762c3abf0c217f5d84729cf15d00f9befc4815...79a77a396e003d0f5827c48d1b179f87c1542311,1,19,1,20,3,2014-10-30 23:13:31,2014-10-30 23:10:35
eb1b785e67784ccc9b521566fbc1737d6177d9ad...622e1005530eada61675e533d3993d7df6c21186,14,428,46,474,33,2014-10-28 22:19:01,2014-10-28 22:19:01
2f65ed0968a5a3630872b4e94ed0f347945b4a8f...4352ea7b0a746f00c29fb1170e893242cb8612ef,9,9,9,18,9,2014-09-16 05:27:44,2014-09-16 05:25:52
2f65ed0968a5a3630872b4e94ed0f347945b4a8f...fc9a3b1c1b835c170a4916362855e127a0e366e1,17,81,81,162,77,2014-09-16 01:49:05,2014-09-16 01:49:05
2f65ed0968a5a3630872b4e94ed0f347945b4a8f...a3f51da98adf27d1f312edac04f0f9863019a8e8,2,8,0,8,2,2014-09-16 00:18:50,2014-09-15 04:12:05
eb21197c6b4981db3cc2ad95694f92d723d34e2f...3a90004f3c2d86ec849f4674c8046693ea061ed1,6,247,78,325,33,2014-09-16 22:40:24,2014-03-10 13:11:23
3a90004f3c2d86ec849f4674c8046693ea061ed1...b0cb37fd3bd65b27a63954b36507a9782088cfc4,2,118,2,120,3,2014-09-16 22:40:24,2014-05-09 10:32:19
b0cb37fd3bd65b27a63954b36507a9782088cfc4...7c85cf5f390a8fe5088d2e275abfd2404aa19048,2,15,15,30,9,2014-09-16 22:40:24,2014-07-19 00:38:27
7c85cf5f390a8fe5088d2e275abfd2404aa19048...1ec283c3eb37d514be3778537c7ef9d727337f52,3,124,1,125,5,2014-09-16 22:40:25,2014-08-11 17:12:09
1ec283c3eb37d514be3778537c7ef9d727337f52...22eb3a3a50a1fc3762cf4b294c167397591cfd58,2,134,1,135,3,2014-09-16 22:40:25,2014-08-20 01:10:42
22eb3a3a50a1fc3762cf4b294c167397591cfd58...e49c70109228d657790190007c8f9d7c55a25be2,2,16,17,33,7,2014-09-16 22:40:25,2014-09-11 03:24:16
eb21197c6b4981db3cc2ad95694f92d723d34e2f...fccb02622183ee93036d4f5068817830f3297ab5,1,1,0,1,1,2014-09-16 22:13:43,2014-09-16 22:13:43
eb21197c6b4981db3cc2ad95694f92d723d34e2f...dee6b481fe0da1d845261ffff2e610fb05898d3c,12,263,191,454,44,2014-09-16 22:10:32,2014-09-11 03:30:52
dee6b481fe0da1d845261ffff2e610fb05898d3c...09ad65ebd5b50fdd7621f42136278102586a7ea8,5,35,31,66,17,2014-09-16 22:10:32,2014-09-16 19:13:50
b03f506303036e32b4a1058da69ee4385cb7979f...b7259dc6d45d5bfcb1c45a852bc63addb22e4bc2,1,2,2,4,2,2014-09-17 07:03:58,2014-09-17 07:03:13
f74b901da61fdd535e22f322b5cf1cc3f74e0935...4e40d09a2b13c1f7886783fa66b9fdfeb5369375,1,2,1,3,2,2014-09-03 00:17:08,2014-09-03 00:17:08
2360d4a4405e8f81ec2263ca64e2dc3d65357dd6...05a76477e6a70975b1c60637c3f8e2d7a507c490,1,1,1,2,1,2014-09-08 17:46:45,2014-09-08 17:32:56
2360d4a4405e8f81ec2263ca64e2dc3d65357dd6...b5184d3c2417c743b3fec34312270d243e4d980c,2,4,2,6,2,2014-09-06 05:06:18,2014-09-06 04:16:24
8f0034c3eed45c474137cd68ea03627db826f6f4...691bbf6a2971bd6d57892cbf7efe188f431919a2,1,19,0,19,5,2014-09-08 16:11:48,2014-07-12 22:28:04
691bbf6a2971bd6d57892cbf7efe188f431919a2...cc5fb986b03ce28075a9f3aee248d401f3be0c96,2,85,0,85,5,2014-09-08 17:02:40,2014-09-06 11:49:40
bb8ea1fdc1c5c3e1b90c15b451ab22334c86e70c...f36dfbdcaf54ed01721f0871c26fe041c7c6bac0,20,4458,4438,8896,3047,2014-09-09 06:17:38,2014-09-09 05:00:23
bb8ea1fdc1c5c3e1b90c15b451ab22334c86e70c...1f25bfea2ddbfa5c41ab3f0cd0716229833ebac1,2,16,19,35,4,2014-09-09 01:44:51,2014-09-09 01:44:51
bb8ea1fdc1c5c3e1b90c15b451ab22334c86e70c...e4d2a8231a53794c2b5b28ccf63125a85749e648,4,4,4,8,4,2014-09-09 01:16:02,2014-09-09 01:16:02
72e901559177a4a49f82779dbaa108487dce086d...acea488eb6ed40e6e5894e1b259ad861c9a98042,2,6,4,10,4,2014-09-19 16:07:53,2014-09-15 09:04:05
72e901559177a4a49f82779dbaa108487dce086d...05b8a1eb363ce03a9dfa3315fbac59c42af2df54,14,252,76,328,43,2014-09-19 03:12:13,2014-09-16 16:58:20
280b64bc7baf3cff48eb2f07330d693eebfaaee7...d93c95a332b65948cf37a87a84900323657571f0,1,1,1,2,1,2014-08-31 14:35:38,2014-08-31 14:35:38
280b64bc7baf3cff48eb2f07330d693eebfaaee7...82c536aacd30baf110c074de1f83ae3ab2f9588c,1,1,1,2,1,2014-08-31 14:21:53,2014-08-31 13:40:23
280b64bc7baf3cff48eb2f07330d693eebfaaee7...a0255ba502d7a60a297aa67604eae75a9e1fbed3,2,9,0,9,3,2014-08-31 12:39:36,2014-08-31 12:39:36
280b64bc7baf3cff48eb2f07330d693eebfaaee7...394a6d3154fe810565ddc5619447c8a82e7ce38c,1,1,1,2,1,2014-08-31 08:18:15,2014-08-31 08:18:15
394a6d3154fe810565ddc5619447c8a82e7ce38c...d7dd35bbd6250fcf42f8fe6521a55813e670f805,1,19,0,19,1,2014-08-31 12:53:05,2014-08-31 12:53:05
280b64bc7baf3cff48eb2f07330d693eebfaaee7...16e850fe3ea42f5103c9a11f3db17d11dc4f6ada,3,5,5,10,5,2014-08-30 17:43:48,2014-08-30 17:43:48
280b64bc7baf3cff48eb2f07330d693eebfaaee7...2d1ec162be15d6d1107d4775d75744c9d23f8478,1,1,2,3,1,2014-08-30 07:02:47,2014-08-30 07:02:47
22b585e0fcd5e844b1c35e9b5d98757920afc1dd...35df24c8e6195ebac6ea28ed4dda5b53b1021f38,6,14,16,30,11,2014-08-28 11:06:07,2014-08-28 10:57:54
4fe6115fb125d5acddec328e2dcfb23b6fe61ffa...9cd77818bbf07ac5278f30f302d82af01243a5c9,1,1,1,2,1,2014-08-26 23:59:21,2014-08-26 23:59:21
e546c8cc1d4980c44e97700a04c352fc86c2f34f...4b4ad26b977bba0b52f6ea15d08750a7453304a4,1,7,4,11,3,2014-11-12 00:37:58,2014-10-08 18:18:42
4b4ad26b977bba0b52f6ea15d08750a7453304a4...6ca144ef3d62e358327249546bf83ce1e347be5c,1,2,2,4,1,2014-11-12 00:37:58,2014-11-12 00:37:54
6ca144ef3d62e358327249546bf83ce1e347be5c...5fbfec333a90b86add1dcf6bd8d5fcb728d34cdf,1,3,2,5,3,2014-11-13 03:21:18,2014-11-13 03:21:18
5fbfec333a90b86add1dcf6bd8d5fcb728d34cdf...454f56e37eefd072e350739a6c5a06743ff913ef,1,1,1,2,1,2014-11-14 19:31:52,2014-11-14 19:31:52
e546c8cc1d4980c44e97700a04c352fc86c2f34f...64a335ceac77dfd9eacc42e9d1f6fb2505e26e45,1,1,1,2,1,2014-11-11 23:01:08,2014-11-11 23:01:08
e546c8cc1d4980c44e97700a04c352fc86c2f34f...adb07b53e083784e4f09935b8e3bdcf123db284e,1,9,2,11,2,2014-11-11 09:10:15,2014-11-11 08:52:41
6ad1cd5d0f3a27abb3fdb89cc4104328f1b04b49...a01f1e707eb682ec60d489a4171d2c82de79ee57,1,2,2,4,2,2014-11-13 15:19:56,2014-11-12 21:55:34
6ad1cd5d0f3a27abb3fdb89cc4104328f1b04b49...28ee373e19bbfdf47c747f6fd9385a8a75f0a483,2,32,1,33,3,2014-11-12 17:12:42,2014-10-31 20:00:49
28ee373e19bbfdf47c747f6fd9385a8a75f0a483...11380a109e53bc5f388b6212c12794609c0241eb,2,19,25,44,9,2014-11-12 20:14:43,2014-11-12 17:08:45
6ad1cd5d0f3a27abb3fdb89cc4104328f1b04b49...497fc8876ede9924f61c0eee4dfadd71e5d9f537,9,298,4,302,25,2014-11-12 16:29:58,2014-11-10 21:14:17
b18efeeb7affdd5b920f7aecef8eb83dd1c83d50...d94de133f4900509821cafb5208d91443119f809,1,19,17,36,19,2014-11-11 01:43:37,2014-11-09 22:27:59
b18efeeb7affdd5b920f7aecef8eb83dd1c83d50...b95f9c10ff2bd05fc2d30b30bebb8174883c683a,1,1,1,2,1,2014-11-10 00:00:05,2014-11-10 00:00:05
b18efeeb7affdd5b920f7aecef8eb83dd1c83d50...932cc230814ba642c493c77d05932f63c0ef3e7f,1,1,1,2,1,2014-11-09 20:23:45,2014-11-09 20:23:45
b18efeeb7affdd5b920f7aecef8eb83dd1c83d50...22afaa628f319c852c536824cdd18444ddf87665,1,5,1,6,1,2014-11-09 15:28:45,2014-11-09 15:16:47
22afaa628f319c852c536824cdd18444ddf87665...3600bcb53127c7d9f67d639c1f4e61c460b1d605,1,2,1,3,1,2014-11-10 00:54:00,2014-11-10 00:52:38
3600bcb53127c7d9f67d639c1f4e61c460b1d605...cf19df4683f416e4d536e772dc1ff02334794264,1,1,1,2,1,2014-11-10 23:05:02,2014-11-10 23:04:23
cf19df4683f416e4d536e772dc1ff02334794264...48424df68539965fec3056f4c349383948890896,1,5,3,8,2,2014-11-11 01:06:22,2014-11-11 01:05:35
b18efeeb7affdd5b920f7aecef8eb83dd1c83d50...6c79ee7d1e38f7b2f408105db9af7fcf9942f7ca,1,0,4,4,1,2014-11-09 15:07:44,2014-11-09 14:12:54
662efd95c7a30e5593ca9fdc672ad3f1d6f9703c...03f67aa46a07024a98dd9677a3b3e73ea5da80c3,1,1,1,2,1,2014-11-05 08:12:57,2014-11-05 08:12:57
8f763a09d339ae733b833a000fb4f73ce9dd5180...3ec623ee2fc503a6236a7b0edde5dd6abb967e49,2,2,1,3,2,2014-11-14 16:12:23,2014-11-14 14:20:37
882db5f8858f36e213feabda459e6b5e639c5c85...f9cdad32721808b6beeab544de26cca9ff68e1f0,11,12,12,24,12,2014-11-18 19:32:51,2014-11-18 19:32:23
882db5f8858f36e213feabda459e6b5e639c5c85...e6fd57b90bcdd3b0105fa5c7d17a64332f829ded,2,39,1,40,2,2014-11-18 03:41:27,2014-11-18 03:25:06
68a25a5b74af10dd7d0af5f05556128540f9cedc...b83fc07d88175c32bb46368a07a9c9e277b22392,2,21,1,22,2,2014-11-06 23:30:23,2014-11-06 23:25:14
68a25a5b74af10dd7d0af5f05556128540f9cedc...318b11f62fe0f16a190e85e3cfe5d01432bf92a9,3,32,1,33,3,2014-11-06 21:17:10,2014-11-06 20:04:10
318b11f62fe0f16a190e85e3cfe5d01432bf92a9...25154682a5cd57aa4fc3ef88baeee3ce1f204060,4,36,4,40,6,2014-11-13 21:43:53,2014-11-06 20:56:13
25154682a5cd57aa4fc3ef88baeee3ce1f204060...d7c37b5a28de6e7c0a9270815c092a45d8d7fef7,1,1,1,2,1,2014-11-13 21:44:00,2014-11-13 21:25:10
967354d48818eebf9ce706bbd4914a20a0375de8...b4336803f35591c8e4d94b023c9d5e9525795520,3,3,3,6,3,2014-11-14 05:16:41,2014-11-14 05:16:41
8682bac309cc46ca31fa35d93a8045061aba5b0f...2facc0467336a80f48c765dbdbd803055a431aa9,10,107,14,121,21,2014-11-15 17:00:48,2014-10-01 13:07:24
8682bac309cc46ca31fa35d93a8045061aba5b0f...edc6df256d21eb1d1aa36b241dcc6d4b83d58d75,1,4,6,10,6,2014-11-15 14:41:27,2014-11-14 23:15:56
8682bac309cc46ca31fa35d93a8045061aba5b0f...975b6e598d44408c865993bbb650cc7117133ffc,3,178,0,178,3,2014-11-15 02:20:53,2014-10-23 23:44:57
975b6e598d44408c865993bbb650cc7117133ffc...91a86670aac52d916c81a818aff3dfcf445da83e,4,28,5,33,8,2014-11-15 02:20:53,2014-11-13 18:40:22
91a86670aac52d916c81a818aff3dfcf445da83e...376ae7780bf04d89ad1532f1c2a752535fa7ac7d,2,8,22,30,4,2014-11-15 02:20:53,2014-11-13 18:48:19
376ae7780bf04d89ad1532f1c2a752535fa7ac7d...b64c9b521ab4e4082ed874a23a493f4a266304d5,3,41,31,72,4,2014-11-15 02:20:53,2014-11-13 18:50:57
b64c9b521ab4e4082ed874a23a493f4a266304d5...3d2fae353f6ddc819d3a3c4db80887a40ac6f5f0,9,89,9,98,11,2014-11-15 02:20:54,2014-11-13 20:00:04
3d2fae353f6ddc819d3a3c4db80887a40ac6f5f0...2180aa4f6f2ad4d8f284d63ee29e93547263976e,13,209,65,274,27,2014-11-15 02:20:54,2014-11-13 20:36:05
2180aa4f6f2ad4d8f284d63ee29e93547263976e...e45b0f92711ff190cff4b61b2ea80cdd53203a16,8,28,41,69,33,2014-11-15 02:20:54,2014-10-30 16:35:49
e45b0f92711ff190cff4b61b2ea80cdd53203a16...d4dbb708320e59efa91b077303c87f9e9513cd91,1,9,1,10,3,2014-11-15 02:20:54,2014-10-21 23:15:26
d4dbb708320e59efa91b077303c87f9e9513cd91...5a38680bd2283c87848d2e7f62a14f0261291c7c,1,4,4,8,4,2014-11-15 02:20:54,2014-10-29 22:46:45
5a38680bd2283c87848d2e7f62a14f0261291c7c...b7703a992e14255a5972bf157d0c2cfc0da3d53f,3,11,5,16,6,2014-11-15 02:20:54,2014-10-28 05:05:57
10c0e72de8c16269cff6b8b0d5a81c5510bac731...32e61b8f5c3f855f5e204064be1aea6a877dda43,37,1,0,1,1,2014-11-09 21:50:28,2014-11-09 21:29:30
7b7af6dbaeadb86c018a877af15c662786bc90c1...b37fdc5dd1db196209ebb860c88a37d67bb2cf98,2,73,25,98,5,2014-11-14 13:41:35,2014-11-11 09:18:22
a05d8d4f4ffd67be34738c80b862ef949dddef65...12ff89a3901cd2debf13e7ccc3a1a780380e4dd9,1,7,18,25,13,2014-08-26 16:57:12,2014-08-26 15:53:43
a05d8d4f4ffd67be34738c80b862ef949dddef65...660cc4a2675d34695406b2506344a2a18f2a59e9,1,2,1,3,1,2014-08-26 16:32:10,2014-08-26 16:32:10
a05d8d4f4ffd67be34738c80b862ef949dddef65...e261618b24b6837c820dccd8fa734eafc8b7f399,4,1424,4,1428,6,2014-08-26 09:08:50,2014-08-26 09:08:50
a05d8d4f4ffd67be34738c80b862ef949dddef65...1ba15b8acaf8625db23ccd7d0ba7d3acf7d2f69e,2,5,5,10,5,2014-08-26 05:27:07,2014-08-20 12:09:54
1ba15b8acaf8625db23ccd7d0ba7d3acf7d2f69e...698392cb512ba0c85e69a669f115d67c1d50cb98,2,12,13,25,7,2014-08-26 05:28:54,2014-08-20 13:03:05
a05d8d4f4ffd67be34738c80b862ef949dddef65...216ab880f96125566f2816510ba9d396dcf103f0,1,1,1,2,1,2014-08-26 01:36:25,2014-08-24 19:21:43
216ab880f96125566f2816510ba9d396dcf103f0...b0edced87f2a9bd2e85b0a59f6a6c83aff36e445,8,8,8,16,8,2014-08-26 01:36:25,2014-08-26 01:35:58
b1d20c483ae91870d2525fa2a302d4461cbe8129...c87d9a1de62678743436887edecdbde2e5a67a1a,1,2,2,4,2,2014-08-21 18:04:25,2014-08-21 18:04:25
b1d20c483ae91870d2525fa2a302d4461cbe8129...239e932485c3e0f72a4f88ce1301ebe269eb2e27,5,5,8,13,6,2014-08-21 10:58:26,2014-08-21 10:40:47
b1d20c483ae91870d2525fa2a302d4461cbe8129...78c68825671eb1bd102d76d671ace9de5a37aa19,1,8,5,13,1,2014-08-20 20:17:11,2014-08-20 20:17:11
860ab469cc267097e243c634fdb59f7444eefea1...478fdaf93353c70a26c0043dadb650fd2f101c40,1,2,3,5,3,2014-08-07 22:45:22,2014-08-07 22:45:22
13eb477b62b51d906fa88f508d2c560a2b4946aa...a02f67be5b17da63d475e6f35956c1e72c3b2e7b,44,465,346,811,344,2014-08-13 22:18:15,2014-07-24 20:37:44
a02f67be5b17da63d475e6f35956c1e72c3b2e7b...ac63d925d2618e700d117c5d9e402ccc0c5cecc8,4,43,41,84,38,2014-08-13 22:32:41,2014-08-13 22:13:21
18a0eba72dfec57b02a799ae064a60a88d6988c9...88306539773fcd07a5bccf1c402139283a5a8db4,1,1,1,2,1,2014-08-12 20:24:42,2014-08-12 20:24:42
88306539773fcd07a5bccf1c402139283a5a8db4...10ec205b77b117cc63e9dc8fe8aedf400c933dcd,1,67,47,114,82,2014-08-12 23:19:10,2014-08-12 23:19:10
2c90fde982c0919e60b0a63303b108089a5cdc1a...2e5d35c1f1bf0b565b288fa9146059d9f3af61b7,1,32,0,32,1,2014-08-11 21:12:47,2014-08-10 18:09:46
2c90fde982c0919e60b0a63303b108089a5cdc1a...e9aa6489a640c6fb2d51bd07e481b9d6ab704290,1,1,1,2,1,2014-08-10 09:30:22,2014-08-10 09:29:04
2c90fde982c0919e60b0a63303b108089a5cdc1a...5e9b3727b8f5d101b7b1f859d4f95fdf8e91ed19,1,13,13,26,2,2014-08-10 04:31:59,2014-08-10 04:31:59
5e9b3727b8f5d101b7b1f859d4f95fdf8e91ed19...a110ce2f284d09df3e047b1999a1535770433d5f,2,3,2,5,2,2014-08-10 04:33:19,2014-08-10 04:33:19
2c90fde982c0919e60b0a63303b108089a5cdc1a...93f6cf035156d3b17cbf61f1a61926c068bd8e92,1,3,0,3,1,2014-08-09 18:10:44,2014-08-09 18:10:44
2c90fde982c0919e60b0a63303b108089a5cdc1a...6ba1949e6aed4b8a6d81b9ad4a43a4743f39ac32,1,3,0,3,1,2014-08-09 18:00:29,2014-08-09 18:00:29
2c90fde982c0919e60b0a63303b108089a5cdc1a...7afc49b40bd3a2c86a807a5ab4c722b12932d856,1,1,1,2,1,2014-08-09 14:45:38,2014-08-09 14:44:53
2c90fde982c0919e60b0a63303b108089a5cdc1a...8b3f2381d0a842bc39c34c39647722fc783d968c,1,74,63,137,28,2014-08-09 11:55:47,2014-08-09 11:55:47
2c90fde982c0919e60b0a63303b108089a5cdc1a...cc3e94b9babc21e3505511fa6d02725dfc199be4,1,5,1,6,1,2014-08-09 07:16:54,2014-08-09 07:16:54
cc3e94b9babc21e3505511fa6d02725dfc199be4...ea59aa8cb5c4cde39259112123c47b69ccd9b53d,1,4,0,4,1,2014-08-10 09:48:34,2014-08-10 09:48:34
eb79dc14fe45f3805d83e5e5e64b335da6389d6a...6856a6b110caa463a06cae456fc53e93c6adf9d1,9,646,621,1267,17,2014-08-08 07:25:09,2014-08-08 06:58:58
4fd9cc9980d9ef5a788a9163287fb50e13669cdb...9bc75d008e66eb15b85ac32134e654e07ae9bb7e,1,20,24,44,12,2014-06-09 00:35:49,2014-06-09 00:35:49
9bc75d008e66eb15b85ac32134e654e07ae9bb7e...9e2e8188ae8e2c566b3e10c1b23ae3fff8f9d64a,1,17,15,32,9,2014-06-09 00:36:49,2014-06-09 00:36:49
98d7b720c2abf72c3f58f45680fcf60df45a3664...4e7254840bc60f31e501c52e25990c540015e83b,1,12,5,17,3,2014-06-03 00:46:06,2014-06-03 00:46:06
77ae37a3836997d215ed3f1750533a9815205695...50417f6abc6d6de7cf32e956d538fd9103c5f9b4,5,6,6,12,6,2014-05-28 16:59:29,2014-05-28 16:59:29
77ae37a3836997d215ed3f1750533a9815205695...fd58524f81031eec112b5e9bd52bfaa186fc9c20,1,16,0,16,1,2014-05-28 14:40:36,2014-05-28 14:40:36
fd58524f81031eec112b5e9bd52bfaa186fc9c20...0563453b918b47c1f9d1e05b8650d2c8bf7ac3af,2,40,3,43,4,2014-05-28 14:41:48,2014-05-28 14:41:48
77ae37a3836997d215ed3f1750533a9815205695...31f0a61a3dfabe363d08d4ff55e8a1efb29d84eb,2,0,166,166,2,2014-05-28 09:59:45,2014-05-28 09:55:10
77ae37a3836997d215ed3f1750533a9815205695...02f4ae6c56474b1f4e747916812b38134d503349,3,70,11,81,6,2014-05-28 05:50:04,2014-05-23 06:58:56
9f6feaa3c3c957b1981456eb85ba61e19bc86cbd...948f33263e95997a9c6596d695c92ab03c630899,1,8,0,8,1,2014-12-23 01:06:44,2014-12-05 20:08:23
948f33263e95997a9c6596d695c92ab03c630899...db165f7d2c3e05bbd7bac8c1188145370c7b1171,1,12,6,18,3,2014-12-23 01:06:45,2014-12-19 06:43:34
305c898cd7fa8e7152f3f01cfdc2f5c14b4d35f0...98d5720594d275071f43fbf90daf5fcd1166df8b,1,12,0,12,1,2014-12-26 18:22:14,2014-12-22 22:54:55
305c898cd7fa8e7152f3f01cfdc2f5c14b4d35f0...6c7204393be3cd66c0bc0779d304323e8f8ac6c3,1,8,8,16,2,2014-12-24 06:01:04,2014-12-24 05:57:14
8412e3c226d870c6c156a6ba7a1773e025b29560...44cab4a4ff05cb1e499fba19394aadb20fc887b8,3,8,2,10,4,2014-12-23 23:22:31,2014-11-19 19:50:16
8412e3c226d870c6c156a6ba7a1773e025b29560...edbf1ed68085171649dd0118e2f6755e7037894c,16,2947,0,2947,16,2014-12-23 23:17:39,2014-12-11 21:52:52
edbf1ed68085171649dd0118e2f6755e7037894c...63a7ccdd2372d87f56f7a86da07c72ea51332c2a,8,426,51,477,20,2015-01-08 19:15:13,2014-12-10 05:55:09
8412e3c226d870c6c156a6ba7a1773e025b29560...4b43a6df7acd98228b8b287eedf38ba87dc8a388,2,19,3,22,6,2014-12-23 22:03:20,2014-12-23 22:03:20
4b43a6df7acd98228b8b287eedf38ba87dc8a388...bbb92e1436b5a288d07ef8ea0fad80f2c4715faa,3,9,1,10,3,2014-12-24 00:12:35,2014-12-24 00:03:24
bbb92e1436b5a288d07ef8ea0fad80f2c4715faa...c0bb1c77ee2461f8bceb03202f60f5673815c026,1,35,0,35,1,2014-12-29 23:00:17,2014-12-27 02:38:46
8412e3c226d870c6c156a6ba7a1773e025b29560...8dc86c0e36da3d3206220fffc75004759dd5d2cb,1,18,5,23,5,2014-12-23 21:15:19,2014-12-23 21:15:19
610842f906a942e9784bc16c201860dc89ba19ba...e9f37a011872fa89669dc105df27e1c6e16124b6,1,36,42,78,24,2014-12-19 11:57:21,2014-12-19 11:57:21
610842f906a942e9784bc16c201860dc89ba19ba...29ed8a2289c932217c47b99cef3d91cbfc0d965e,1,1,1,2,1,2014-12-19 02:09:41,2014-12-19 02:09:41
e850568bf6f67b5fadd9767544b1cf7bc6fcc317...e7c0587d541cd9f224df622b2f97c918e68cfb05,1,0,4,4,3,2014-12-18 21:38:26,2014-12-18 20:58:14
27b07bc39e45dd52562c2590b9e914282923e136...de2a91970dfd1f6078179ffffd63ec1842c95bd9,2,3,2,5,2,2014-12-17 23:05:27,2014-12-17 23:05:27
27b07bc39e45dd52562c2590b9e914282923e136...c16e41245ebaf426a5ad27ebe82597647c7743a3,1,3,3,6,1,2014-12-17 22:44:55,2014-12-17 22:33:50
8ca28a35c75b85404f2d2fc1ca2c35221ac33fc0...228404860ca12ea5fb09098bc2a1a16cc96c7e10,1,11,9,20,4,2014-12-14 04:17:17,2014-12-13 22:18:46
228404860ca12ea5fb09098bc2a1a16cc96c7e10...46748f1302c236457f0b646a746a9c945200ed12,1,1,1,2,1,2014-12-16 18:14:03,2014-12-16 18:14:03
46748f1302c236457f0b646a746a9c945200ed12...078ac9ca456af1ecfc283a43aa60328ac800b205,1,1,1,2,1,2014-12-16 18:16:20,2014-12-16 18:16:20
078ac9ca456af1ecfc283a43aa60328ac800b205...801fd1af256134b749ee3dd29ea5ed41d2594482,1,3,2,5,1,2014-12-18 17:10:08,2014-12-18 17:10:08
8ca28a35c75b85404f2d2fc1ca2c35221ac33fc0...be27d97118764db994fbaf3632225a691c7418fb,2,15,4,19,5,2014-12-13 17:43:05,2014-11-03 00:25:44
8ca28a35c75b85404f2d2fc1ca2c35221ac33fc0...9256578f62ffe885befa3ef2dbdd9ec0bea1d7e8,2,4,2,6,3,2014-12-13 13:24:51,2014-12-13 12:00:59
9256578f62ffe885befa3ef2dbdd9ec0bea1d7e8...c230f7041302351aed6d5c4ac82b98262d9562ef,1,11,2,13,2,2014-12-15 20:05:59,2014-12-15 18:57:39
c230f7041302351aed6d5c4ac82b98262d9562ef...afb06a3ce2e769951a89a889f11b9ab5eea54dff,1,22,5,27,7,2014-12-16 23:22:06,2014-12-16 23:22:06
d727e3bea6cb0b833f415f6ba2207ee2f82c1453...afc262cc3ab68129104e3d799f8a2694f61aa68f,1,8,359,367,7,2014-12-13 01:18:21,2014-12-13 01:18:21
d727e3bea6cb0b833f415f6ba2207ee2f82c1453...54229fad933c91f5d890e14be389651e98f62e02,1,2,3,5,1,2014-12-12 21:44:41,2014-12-12 21:44:41
92d24e3b7cfca1a18ee8412c1bf6650758096355...17f8e3dee2d0df54b848cbb13af1986abe07db9f,1,8,2,10,3,2014-12-16 10:05:18,2014-12-16 10:05:12
17f8e3dee2d0df54b848cbb13af1986abe07db9f...ed7aa47dea9553a89e39c16397752ef0e791aab3,1,1,1,2,1,2014-12-17 03:55:29,2014-12-17 03:55:20
6ac9768eaf0d7f4ebe9dcf8205903f5a4cf1a518...df0e0c76831bed08cf5e08ac9a1abebf6739da23,2,68,1,69,3,2014-10-17 21:47:35,2014-10-17 19:15:07
6ac9768eaf0d7f4ebe9dcf8205903f5a4cf1a518...ad136e1ae3175bd30c87ccbde8e31f0e422ff5ec,2,23,2,25,5,2014-10-17 18:08:53,2014-10-17 18:06:05
c8926bb5792ebea6e7b16935fa7fce577446574a...1314e1586f8cd6201c16161eb960a743c727946b,8,256,19,275,16,2014-11-20 17:54:28,2014-09-26 02:28:24
c8926bb5792ebea6e7b16935fa7fce577446574a...6705477673be7c303369778f6f288ee600ce3893,4,4,4,8,4,2014-11-19 21:59:02,2014-11-19 21:24:16
c8926bb5792ebea6e7b16935fa7fce577446574a...da3d3b97ebe1e6fe1254367521c725ca12a5e61d,7,124,43,167,80,2014-11-19 21:41:46,2014-11-17 16:05:49
da3d3b97ebe1e6fe1254367521c725ca12a5e61d...bbb245defe670f4fd9b9159b154e0ba5aa93ec87,1,4,1,5,1,2014-11-19 21:42:16,2014-11-17 16:06:48
c8926bb5792ebea6e7b16935fa7fce577446574a...6a74f071afb4a69a1360ff1e84945745e578c349,1,4,12,16,3,2014-11-19 20:46:03,2014-11-19 20:46:03
6a74f071afb4a69a1360ff1e84945745e578c349...e257863a9a2bff19c66355230483a8b6fa9de209,1,11,0,11,1,2014-11-19 20:55:21,2014-11-19 20:15:20
c8926bb5792ebea6e7b16935fa7fce577446574a...967a42f116d23051c862a3b4983925de2016f83c,1,3,3,6,1,2014-11-19 06:06:49,2014-11-19 06:06:49
967a42f116d23051c862a3b4983925de2016f83c...36560a76d71f1222122c9e6c82f76a609da564e9,1,3,3,6,1,2014-11-25 07:48:09,2014-11-25 07:48:09
36560a76d71f1222122c9e6c82f76a609da564e9...82a5cd0d3701fc559fb92290ed6bc2974a9d8b6d,4,13,13,26,10,2014-11-25 09:12:22,2014-11-25 08:02:47
c8926bb5792ebea6e7b16935fa7fce577446574a...6c11d07759bcb6e697d2aea37ce7e88b5e0c0260,1,39,0,39,1,2014-11-19 05:29:04,2014-10-29 15:52:11
6c11d07759bcb6e697d2aea37ce7e88b5e0c0260...ea5a2c1fd74af1a806c8f4ef7858afe6435d90fa,1,105,0,105,1,2014-11-19 17:32:45,2014-11-13 16:25:17
c78bf8d86a912adafa0c2514e9224431a887b197...f8509e7940d73ecc0071faf15a865acb1f8dad52,2,44,0,44,3,2014-11-22 00:20:35,2014-11-14 03:33:41
660eadae3d56195e05da170593af50f0d7752706...71209f75791fdc1a2124682f50cd00a413ddb143,1,34,0,34,1,2014-11-20 01:43:04,2014-11-18 23:10:07
660eadae3d56195e05da170593af50f0d7752706...ce86d5ae6826b0ec3dcf3188f8a6bd37b0afd3b2,2,17,6,23,7,2014-11-19 21:41:57,2014-11-18 22:44:05
660eadae3d56195e05da170593af50f0d7752706...3287ca1e45f74a2eac214070ccb937c7c7030a06,1,1,0,1,1,2014-11-19 03:53:04,2014-11-18 20:07:48
3287ca1e45f74a2eac214070ccb937c7c7030a06...cb57c388480d03770378e6e1842c2c1c6a46d8fd,1,4,1,5,2,2014-11-20 00:36:05,2014-11-19 04:22:32
660eadae3d56195e05da170593af50f0d7752706...33e0de15d77ef57b5c4615c6bd535775d54d8c9b,1,4,1,5,2,2014-11-18 22:13:35,2014-11-18 22:13:35
660eadae3d56195e05da170593af50f0d7752706...54a6e6d1229adb1169809493af89600c5ccc70ae,1,5,1,6,3,2014-11-18 19:20:49,2014-11-18 19:20:49
660eadae3d56195e05da170593af50f0d7752706...7fe8d0aeeb373a0fef92758819d8054fbd744ea5,2,6,6,12,6,2014-11-18 18:49:01,2014-11-18 18:49:01
28af4a1efb25f5dff7a57b81cb51bf6fcf43d085...380c8320a78dc16da65d9d13004422ac5a0cca53,8,74,16,90,11,2014-10-30 23:41:55,2014-08-16 10:27:04
380c8320a78dc16da65d9d13004422ac5a0cca53...f29b2e48ebfb171f58375b6e355910fc2192aceb,4,24,29,53,16,2014-10-30 23:41:55,2014-08-19 18:54:42
f29b2e48ebfb171f58375b6e355910fc2192aceb...48f7384d6365c59b4b61d527630aaf88af24f6dd,1,11,1,12,2,2014-10-30 23:41:55,2014-08-19 19:27:23
48f7384d6365c59b4b61d527630aaf88af24f6dd...afade4236d3f15704653132c364d6e7ccc975f8b,3,20,13,33,12,2014-10-30 23:41:55,2014-08-20 15:31:24
afade4236d3f15704653132c364d6e7ccc975f8b...6a1ff022b0744213ed588d9c16dbb13ce055eda6,9,114,113,227,34,2014-10-30 23:44:09,2014-10-11 03:22:12
6a1ff022b0744213ed588d9c16dbb13ce055eda6...e43d9f713e96daed521034995c00375544f62827,6,334,85,419,26,2014-10-30 23:44:42,2014-10-22 12:30:48
e43d9f713e96daed521034995c00375544f62827...05c18a2434ab7bd68a86c87fe866bc7107ac1941,1,3,1,4,2,2014-10-30 23:44:44,2014-10-29 01:20:30
05c18a2434ab7bd68a86c87fe866bc7107ac1941...4a17e6eeddee1fe13c7aa5ad7f6a789490add0fe,2,19,1,20,2,2014-10-30 23:44:54,2014-10-20 23:17:32
4a17e6eeddee1fe13c7aa5ad7f6a789490add0fe...b9fcdb81917f2258b295a14398054b40bb6919b8,1,1,1,2,1,2014-10-30 23:45:07,2014-10-30 23:45:07
d176d1bfb4b59c5f1dcdebd42a8e22887ea1b80f...17e0a15386c2a2ff01417d66e37683bd9a2a79c8,4,2,44,46,6,2014-10-28 23:25:50,2014-10-28 23:25:50
17e0a15386c2a2ff01417d66e37683bd9a2a79c8...ec1420cc2b228116d4aa9c812bd98fa8acdc1b98,1,5,1,6,1,2014-10-28 23:27:23,2014-10-28 23:27:23
ec1420cc2b228116d4aa9c812bd98fa8acdc1b98...7041eb00be7d6224aeedf7db317667b1d121b54d,2,6,18,24,2,2014-10-28 23:29:01,2014-10-28 23:29:01
af52f8edcf7a4a1b9eaf39d11165e5d3d9457df4...ef98fe0763024abd90bd5a573fec816895ee92e4,5,176,2,178,15,2014-10-21 00:23:01,2014-09-24 13:07:11
af52f8edcf7a4a1b9eaf39d11165e5d3d9457df4...fdd2abe7b34f15fbe5ec64309e9d700ba2e66e65,1,6,2,8,2,2014-10-20 23:59:11,2014-10-20 23:45:45
af52f8edcf7a4a1b9eaf39d11165e5d3d9457df4...964f9965c75b89f95060c62ba512ed6ceb525992,5,70,4,74,8,2014-10-20 23:07:56,2014-10-20 19:27:26
ca39a3e36b8b76539bc30f0f4e2761222c50919f...be924087eb5a2ab0ad79c069782e82805dd31d58,2,86,7,93,9,2014-09-17 17:05:33,2014-09-17 16:34:45
ca39a3e36b8b76539bc30f0f4e2761222c50919f...9619ce9dd14d31cbf52c53741a1f35842bbe99a6,1,12,0,12,1,2014-09-17 09:13:31,2014-09-17 09:13:31
9c3eedae89cb0db26b4ef1ae0b9c5b8e573e7ef8...68e48b65a64df10fc797cbaa89d6caa2188eadc9,8,63,0,63,13,2014-09-16 23:38:23,2014-09-13 04:35:59
41e625eb7cf1dd4fe747c9e63d25c73e99f98eb9...9ae3134dc9f0652ef48ec1fd445f42d8fe26de35,7,34,16,50,12,2014-09-17 11:30:08,2014-09-15 18:44:58
9ae3134dc9f0652ef48ec1fd445f42d8fe26de35...9851e8c4c18a89327ec2c1f04e36c9932c4231c1,2,189,5,194,8,2014-09-17 14:03:54,2014-09-15 16:35:51
41e625eb7cf1dd4fe747c9e63d25c73e99f98eb9...ad65930d0bda1026a02efd18e9f6c70dfdae4fb6,1,68,68,136,22,2014-09-17 07:42:57,2014-09-17 07:42:57
426fbee81001cadd1231903fb7219121616fe814...76212635b594d4472dd8d5b2e071fac416addbe7,12,164,141,305,33,2014-09-03 08:36:21,2014-08-12 16:10:43
76212635b594d4472dd8d5b2e071fac416addbe7...7b6f34057cee94bf22e4e58cd164731e6b0e8851,1,16,0,16,1,2014-09-03 08:36:21,2014-08-12 16:20:59
7b6f34057cee94bf22e4e58cd164731e6b0e8851...c93b9e81c03168ca69def94ba231d2ecc6672ce9,1,21,9,30,5,2014-09-03 08:36:21,2014-08-19 16:58:07
c93b9e81c03168ca69def94ba231d2ecc6672ce9...bd130e72a06dc3e8de521ce365bf4933f36b2417,1,20,0,20,1,2014-09-03 08:36:21,2014-08-20 20:50:42
bd130e72a06dc3e8de521ce365bf4933f36b2417...2d2016b81b1f313cda2c8f145844b162352ba234,2,184,0,184,2,2014-09-03 08:36:39,2014-08-12 16:27:19
2d2016b81b1f313cda2c8f145844b162352ba234...84d76e556bb96fbddcac20fb5dbce82223987bf8,4,38,20,58,20,2014-09-03 08:37:03,2014-08-12 16:29:46
6eaac7d5710016d9717cb79b48c1bfe5f3ac92af...cc84ec3f6182a7af9ef881939305cf1ac13a383a,1,1,2,3,1,2014-09-03 00:37:14,2014-08-29 15:48:43
6eaac7d5710016d9717cb79b48c1bfe5f3ac92af...42dd48315fcf6a3a536e0e698396e404246b9f3f,3,58,71,129,35,2014-08-29 12:20:49,2014-05-28 18:10:09
42dd48315fcf6a3a536e0e698396e404246b9f3f...b101022dbe6daa36ebf11df53ad01a399a655963,6,125,5,130,11,2014-08-29 12:21:07,2014-05-28 20:06:23
b101022dbe6daa36ebf11df53ad01a399a655963...3bb12d390a8a965e4dc680db7ecdab8c76f23990,4,23,7,30,6,2014-09-18 04:48:24,2014-07-21 19:30:21
6eaac7d5710016d9717cb79b48c1bfe5f3ac92af...114838cbda38f4808d3a7a0d40b33d2ee445d158,6,23,26,49,19,2014-08-29 11:21:28,2014-08-29 11:21:28
6eaac7d5710016d9717cb79b48c1bfe5f3ac92af...4e340cedeccabcae8875dd35f8c984246d6c3bc1,4,191,25,216,12,2014-08-29 08:31:51,2014-06-24 02:03:08
6eaac7d5710016d9717cb79b48c1bfe5f3ac92af...f1934e59790c9af6466075d3d050386627ad1a9a,2,56,4,60,6,2014-08-29 05:38:03,2014-08-29 04:55:49
25f7840993b9f4ae47b900fcbde67fcd86d537ee...cd7a5f5c0998f288f71d307076e661ed54f1a5f1,6,20,7,27,10,2014-09-16 17:28:37,2014-09-10 19:36:01
25f7840993b9f4ae47b900fcbde67fcd86d537ee...46eb4140c915e05a893080b34b42e25b6a75de7b,2,26,10,36,9,2014-09-11 21:52:36,2014-09-11 14:32:44
25f7840993b9f4ae47b900fcbde67fcd86d537ee...747f89cd327db9d50251b17797c4d825162226d0,8,206,32,238,20,2014-09-10 19:41:52,2014-08-21 20:12:52
25f7840993b9f4ae47b900fcbde67fcd86d537ee...ecbc8de2496bb8399a06defb5adfd0860adad788,1,1,1,2,1,2014-09-10 19:08:05,2014-09-10 19:08:05
d7e29a2cc8ca749a40e3aa5a42713f76c0d49830...f3ed7b601fa6151868416254e79a18751c5ff024,2,55,41,96,5,2014-09-08 23:08:50,2014-09-08 23:08:28
f3ed7b601fa6151868416254e79a18751c5ff024...d128d9e669d840160f9f2357324f710d59a7a7d7,1,1,0,1,1,2014-09-08 23:09:16,2014-09-08 23:09:16
d128d9e669d840160f9f2357324f710d59a7a7d7...fec81690ccaf4c4b81342f632bc1a3ec3ad6b86c,1,2,3,5,3,2014-09-09 17:12:03,2014-09-09 17:12:03
1ed467a9aeb5323dfd457cecbd83cd1b5ef0a1af...6a8cae3e03d7253f2013b6c56eef64b18aea038f,1,2,2,4,2,2014-09-09 18:07:20,2014-09-09 17:31:11
1ed467a9aeb5323dfd457cecbd83cd1b5ef0a1af...c604dc292e72c0cbb84184b92b4b2bd3631c862e,9,83,102,185,31,2014-09-09 18:05:58,2014-09-09 17:49:57
1ed467a9aeb5323dfd457cecbd83cd1b5ef0a1af...4b3b54ca388cd49cd790def66fbce9af2be2f20f,1,1,1,2,1,2014-09-09 17:51:13,2014-09-09 17:45:42
f1095b801efae1824a77d8d39220d98590a7a783...2e7cf6b0cec3e5cc6f05fa5011cf7b5e49a44ae4,2,31,6,37,5,2014-09-09 20:40:46,2014-09-09 12:47:25
f1095b801efae1824a77d8d39220d98590a7a783...73617e5e18159e5f791d2860c7857cd5dea31be4,1,7,1,8,3,2014-09-09 12:18:20,2014-08-20 20:36:42
f1095b801efae1824a77d8d39220d98590a7a783...fcc7ec8073311cf9d150179895e5d0a32f4cb2e7,1,2,2,4,2,2014-09-09 05:16:19,2014-09-05 08:22:32
2a832f617bb7db65aa083d73f650cb1ad756da1a...69a75c673ccf0aebf19c7b350243f1b0cefad8be,10,148,15,163,20,2014-09-09 19:03:38,2014-07-18 18:48:19
e91de29e0818b40adec155c3353e510d7bcf87b5...1a0347ff1dd1035066b5faf86db0587491b5d638,1,3,1,4,3,2014-09-19 18:08:57,2014-09-19 18:08:57
e91de29e0818b40adec155c3353e510d7bcf87b5...0fe56ce1b97736c374d3d649d2df0a19f3b2884f,1,4,0,4,3,2014-09-19 18:02:12,2014-09-19 18:02:12
e91de29e0818b40adec155c3353e510d7bcf87b5...ed072ed71dfbd3539d769fc2aa882f6029b7bc64,1,15,0,15,1,2014-09-19 18:00:28,2014-09-19 18:00:28
e91de29e0818b40adec155c3353e510d7bcf87b5...aa536b27a7897373384ab0335c44f44b0bb83455,1,80,80,160,80,2014-09-19 17:56:24,2014-09-19 08:21:25
aa536b27a7897373384ab0335c44f44b0bb83455...9720078f9e299f6b7207060599c322a58fc9b8b8,2,6,6,12,6,2014-09-19 17:56:25,2014-09-19 08:37:50
9720078f9e299f6b7207060599c322a58fc9b8b8...3812a6a8466f639cfd538c05c3ff2730a70b1440,1,1,1,2,1,2014-09-19 17:56:25,2014-09-19 08:43:07
3812a6a8466f639cfd538c05c3ff2730a70b1440...f312f784e18f3a0a087e615162c1e38b1bae8e51,1,1,1,2,1,2014-09-19 17:56:25,2014-09-19 12:30:02
f312f784e18f3a0a087e615162c1e38b1bae8e51...66cd3640f16f5b91893dacd6de3f8c5ae55e2f2c,1,16,16,32,16,2014-09-19 18:11:50,2014-09-19 12:33:57
66cd3640f16f5b91893dacd6de3f8c5ae55e2f2c...27a27b73880c4e79d23b65c9032264a4a8fca1cd,1,3,3,6,3,2014-09-19 18:11:54,2014-09-19 12:38:21
27a27b73880c4e79d23b65c9032264a4a8fca1cd...b6325907e9de4020381ad1d016614f819da58cc6,1,7,7,14,7,2014-09-19 18:11:54,2014-09-19 17:46:43
b6325907e9de4020381ad1d016614f819da58cc6...6e8c9e7bee5319b1e324c72240ef9d7a77946135,1,1,1,2,1,2014-09-19 18:11:54,2014-09-19 17:47:59
6e8c9e7bee5319b1e324c72240ef9d7a77946135...00b82fcab6492a853958a3a5f43f95469a60e12f,1,2,2,4,2,2014-09-19 18:11:54,2014-09-19 17:49:28
00b82fcab6492a853958a3a5f43f95469a60e12f...1ddd013b194d7f551547bd2940a92ba3db72f95e,1,3,3,6,3,2014-09-19 18:11:54,2014-09-19 17:50:23
1ddd013b194d7f551547bd2940a92ba3db72f95e...cc54b77fce1ab0d6bfa78947ee46ffdd104f21c5,1,6,6,12,6,2014-09-19 18:11:54,2014-09-19 17:51:37
cc54b77fce1ab0d6bfa78947ee46ffdd104f21c5...2e2422b0eb163829127692250973472456d0ed77,1,2,2,4,2,2014-09-19 18:11:54,2014-09-19 17:52:20
e91de29e0818b40adec155c3353e510d7bcf87b5...e1b968f1981f21470a67ed617c36f1c6802bd0a7,2,21,4,25,4,2014-09-19 17:43:50,2014-09-16 17:44:15
e91de29e0818b40adec155c3353e510d7bcf87b5...be6bce6ab8bd0e3a7bd175d3fbe3f6e4fab6b02b,1,1,1,2,1,2014-09-19 17:33:00,2014-09-19 17:33:00
d244e8c3796b93c3c5889f49e50c15d1f66577a5...bfa3d5fa726dc27e44208b51557edca9b64cf4e9,1,2,1,3,1,2014-08-28 20:44:41,2014-08-28 20:41:17
d244e8c3796b93c3c5889f49e50c15d1f66577a5...59d58352dfb66a12000d4b65f6c337c7936326e3,1,0,1,1,1,2014-08-28 15:22:26,2014-08-28 15:22:26
d244e8c3796b93c3c5889f49e50c15d1f66577a5...3256050ed44b13694d81e78d24e2c7f6006c4bbd,1,15,0,15,3,2014-08-28 13:58:54,2014-07-30 14:51:28
014471ad39b2f2a0ffbe4d943c2d0068dd3105e0...40f0bf75640f686b2160092db6fc874e672cfd16,3,3,1,4,3,2014-09-03 12:26:16,2014-08-31 20:08:28
014471ad39b2f2a0ffbe4d943c2d0068dd3105e0...c0c525b3d1a527738c1d942efd70e810908c0eac,1,1,1,2,1,2014-09-01 03:38:25,2014-08-28 17:02:32
014471ad39b2f2a0ffbe4d943c2d0068dd3105e0...ead942156cadb0ef329379a52f1c42d7693a2dea,1,43,0,43,1,2014-09-01 01:32:52,2014-08-27 05:19:00
014471ad39b2f2a0ffbe4d943c2d0068dd3105e0...d27f1bb00006fc936c0cb393c93131427e68fef6,1,26,2,28,4,2014-08-31 19:20:49,2014-08-24 10:18:56
d27f1bb00006fc936c0cb393c93131427e68fef6...2852037018e435dc61a27725a307595a6f57da40,1,15,10,25,9,2014-08-31 23:55:53,2014-08-31 23:55:53
3ef2fc7f0f025d3e4fc97ccbcc75cbfa667ccb2d...06bf79552d222ef6c4547ae8b0f3cb474a031c76,1,1,0,1,1,2014-11-12 22:55:32,2014-11-12 22:55:32
e4fe85fc9554c09c210bb441161906f34ebe90db...fb62e184412b6d2bf38975a7051738f05b1f413d,2,35,2,37,6,2014-11-10 16:32:16,2014-10-23 12:50:06
e4fe85fc9554c09c210bb441161906f34ebe90db...b92d7cd60db0a03b0ace62a2a6c11df9f64f4256,1,0,1,1,1,2014-11-10 12:23:46,2014-11-10 12:23:46
703ef3caa825cd0433ef5c0990641e7daaa4bceb...447387474a5379f941457ece191c6920191c2a35,2,11,1,12,2,2014-11-11 05:56:27,2014-11-11 05:54:31
0b4132782a7ceec6815e73a10e50d7b007d7b9dd...5cd53195fddd9a2843ad57c6e1ac11bec1ac37f0,1,4,1,5,1,2014-11-11 08:24:45,2014-11-10 17:14:12
af54dc215f08ef1a56eaef54e8e4cc5e6f7d21a9...f4acfeebda431239c98e07ed8c0d55422e165d4e,1,4,3,7,2,2014-11-19 02:13:10,2014-11-19 02:13:10
af54dc215f08ef1a56eaef54e8e4cc5e6f7d21a9...57b6993c2c99dd89a3cbe012935a82966d88aa92,1,17,12,29,4,2014-11-19 02:06:22,2014-11-18 00:41:54
af54dc215f08ef1a56eaef54e8e4cc5e6f7d21a9...a0fb8eca30fd97aaa592268b4b6e8ac7737b78ac,2,2,2,4,2,2014-11-19 01:42:33,2014-11-19 01:42:25
54d6d12556d7f83ad3e9a3ee081ddb6cc98549b4...471adb73a9c3a23ac7c599621531b5fada1a127f,1,0,39,39,1,2014-11-04 01:46:33,2014-11-04 01:46:33
471adb73a9c3a23ac7c599621531b5fada1a127f...4b4b88a8730b459944b0b0ab51adc7d401c87667,1,1,1,2,1,2014-11-04 01:48:50,2014-11-04 01:48:50
61e4b4e1d015032e6e7ee17658023c4101be3e36...20218f39718673d3ae5822aeecfd08ea0c6e8126,1,1,1,2,1,2014-11-22 00:18:40,2014-11-15 20:49:47
61e4b4e1d015032e6e7ee17658023c4101be3e36...7c225333f22378e380309bd0c3afc1b3311b1373,2,62,0,62,5,2014-11-20 07:34:27,2014-11-15 04:38:02
61e4b4e1d015032e6e7ee17658023c4101be3e36...b4346c4810c4801e8885485b2bf0311f1b6d00ec,1,8,4,12,2,2014-11-18 12:33:53,2014-11-16 13:13:14
61e4b4e1d015032e6e7ee17658023c4101be3e36...b273c447e0f0b124d5f81ff60033a4894e2acec8,1,5,5,10,5,2014-11-18 01:14:39,2014-11-16 06:40:48
61e4b4e1d015032e6e7ee17658023c4101be3e36...ab7a6544b09c0b061e35aa7df766ef7adc1fd2fe,3,208,59,267,170,2014-11-17 07:41:25,2014-11-15 22:53:11
61e4b4e1d015032e6e7ee17658023c4101be3e36...bdaa76e8cf3baeeaa645d91aed168028301f537f,1,1,1,2,1,2014-11-16 19:23:22,2014-11-16 19:23:22
fb1540199e2a7fb8aaf7918a9a35d1f21adeaad5...acdf766069f8e8c65fd3de3ce4f8efc15f421abd,1,29,26,55,17,2014-11-22 01:54:50,2014-11-14 14:33:13
265a89a605ad6cdbd6abb85804644f4fd3f30050...461d33eeb0fe1058c9fcea39124c2d1f9e141765,3,292,29,321,8,2014-10-29 23:43:58,2014-10-29 23:43:18
c87d9a1de62678743436887edecdbde2e5a67a1a...07f2e794867030c755901ae5479df03e3c4ce189,1,3,2,5,2,2014-08-25 18:59:53,2014-08-22 14:37:37
c87d9a1de62678743436887edecdbde2e5a67a1a...01094c15680c0a33367e1dcc69ec9f4018efd2ac,2,101,24,125,12,2014-08-22 10:58:05,2014-07-29 05:50:16
c87d9a1de62678743436887edecdbde2e5a67a1a...61b129d81802e3c988cc0e67e488b24968dd748a,38,335,68,403,163,2014-08-21 19:35:20,2014-08-21 19:35:20
0d70706b4b6bf9d5a5daf46dd147ca71270d0ab7...bd8c9dc2395032a893e959e48f9a8536858d67e0,3,103,41,144,18,2014-08-13 22:56:34,2014-08-04 22:53:10
bd8c9dc2395032a893e959e48f9a8536858d67e0...e0a076d486ea49529dc3aeef2179eb0c406d0773,1,23,19,42,10,2014-08-13 22:56:34,2014-08-04 23:02:29
e0a076d486ea49529dc3aeef2179eb0c406d0773...d9753ba20d5e602b0980687353d76c874b563042,3,52,6,58,13,2014-08-13 22:56:34,2014-08-04 23:14:43
d9753ba20d5e602b0980687353d76c874b563042...2b0776c883c41cda0b86808fe86e4df6e1aa1cd5,2,204,127,331,8,2014-08-13 22:56:53,2014-08-05 00:05:56
2b0776c883c41cda0b86808fe86e4df6e1aa1cd5...860c13b788944410a98a6ad5b5cfb74de0a8405b,3,111,33,144,26,2014-08-13 22:57:37,2014-08-05 01:20:53
860c13b788944410a98a6ad5b5cfb74de0a8405b...617edd89f48a7082bf4ec1d28ec12eefd1057a2f,2,9,8,17,5,2014-08-13 22:57:37,2014-08-05 21:40:50
617edd89f48a7082bf4ec1d28ec12eefd1057a2f...41870a42bee9c394c61aba4bd81f782dbd38da12,2,44,30,74,17,2014-08-13 22:58:54,2014-08-06 17:40:43
41870a42bee9c394c61aba4bd81f782dbd38da12...feda8fbb21489f64aa3b7340c94473a08502bd6b,1,2,1,3,1,2014-08-13 22:58:54,2014-08-07 04:13:06
feda8fbb21489f64aa3b7340c94473a08502bd6b...b7550cd456e29874279499a546b07bb062a12096,1,1,1,2,1,2014-08-13 22:58:54,2014-08-07 04:15:34
b7550cd456e29874279499a546b07bb062a12096...6ae05936e1f343a2ecc51b8f642bdc8b93325d81,2,4,4,8,3,2014-08-13 22:58:54,2014-08-07 17:50:25
6ae05936e1f343a2ecc51b8f642bdc8b93325d81...be22d7ac2db6396becd63ec2dd28b9731011c9b9,1,4,1,5,3,2014-08-13 22:58:54,2014-08-11 17:50:02
be22d7ac2db6396becd63ec2dd28b9731011c9b9...a2afb2b1e37e72cab0d68cfe8dd0ec830b7a54e5,2,105,66,171,13,2014-08-13 22:58:54,2014-08-11 18:07:37
a2afb2b1e37e72cab0d68cfe8dd0ec830b7a54e5...c4a00d549d0b895bb990491cbdf58aabe2891842,3,18,10,28,6,2014-08-13 22:58:54,2014-08-11 18:35:18
c4a00d549d0b895bb990491cbdf58aabe2891842...972c89493148f930388097816663d453bf3e8c2c,1,41,9,50,11,2014-08-13 22:58:54,2014-08-11 22:00:55
972c89493148f930388097816663d453bf3e8c2c...ebf5d4657d14c7b57a5ca1c7b8689077b18b33dc,1,16,6,22,7,2014-08-13 22:58:54,2014-08-12 20:08:26
ebf5d4657d14c7b57a5ca1c7b8689077b18b33dc...2ec1b697c1a7c0ecc534b9ebffd7ba40ea285ff7,2,23,13,36,8,2014-08-13 22:58:55,2014-08-13 01:03:11
2ec1b697c1a7c0ecc534b9ebffd7ba40ea285ff7...73ced636800c150640e2f0d307842b0f9259b611,2,19,17,36,7,2014-08-13 22:58:55,2014-08-13 21:56:35
73ced636800c150640e2f0d307842b0f9259b611...25c519e829640ebb23061b82c6ace88c5983b63d,5,13,17,30,16,2014-08-13 23:08:50,2014-08-13 21:58:57
91a2f22acac569b8e1bf279845c53e0499de50d4...af5ced62ca604846b5e9ab852c7d47c9c176c702,1,27,7,34,6,2014-08-12 22:21:55,2014-08-12 22:21:55
af5ced62ca604846b5e9ab852c7d47c9c176c702...e608312677d26f1f5b4f76852917d4f149ef88c1,1,0,19,19,3,2014-08-12 22:30:21,2014-08-12 22:30:21
91a2f22acac569b8e1bf279845c53e0499de50d4...631fadc0b9c46c1af82f9161deab83a7fb797c2a,1,2,0,2,1,2014-08-12 21:37:42,2014-08-12 21:37:42
8595a4ff7a18f6eb80e28d49d4dbecca794b369e...b94f2c4c6d6fa7b3efc0dbf8874735b12d00b57c,1,58,11,69,13,2014-08-12 00:32:38,2014-08-04 06:13:22
8595a4ff7a18f6eb80e28d49d4dbecca794b369e...1e2ce72ffe28867021121745538c636e22f6f9e8,1,0,11,11,1,2014-08-12 00:12:34,2014-08-12 00:12:34
8595a4ff7a18f6eb80e28d49d4dbecca794b369e...df9650eebb12d980aaf114ac7b2223764dc964b7,1,1,1,2,1,2014-08-11 23:37:58,2014-08-11 23:37:58
8595a4ff7a18f6eb80e28d49d4dbecca794b369e...8a4d2d6f7fc2f9ab5ea488d4b4ba76313862fbc0,1,2,0,2,1,2014-08-11 21:36:09,2014-08-11 21:36:09
8a4d2d6f7fc2f9ab5ea488d4b4ba76313862fbc0...58ef92f89e5c6637506d2d03784daba50e82d7ff,1,10,5,15,3,2014-08-11 21:40:35,2014-08-11 21:40:35
57e0cbb991783f3b5a6b24afe6c5978cd9839a01...84146719d8b8322e302e7a0250fe8a3ee1a4edcd,5,75,1,76,12,2014-08-13 13:12:33,2014-06-02 19:08:39
e033425f0bcf58f1409e7a10a408c778f1c754e4...73210671764fc3de133a627205582e069e1ff43d,13,208,185,393,37,2014-08-11 18:47:21,2014-08-08 20:18:18
73210671764fc3de133a627205582e069e1ff43d...29af9c14e442f5cf3760f439d8c0fffaf84e2268,2,0,26,26,2,2014-08-11 18:47:21,2014-08-08 23:21:53
29af9c14e442f5cf3760f439d8c0fffaf84e2268...9694209241074c10d4cc625b24dfedcb2387de93,1,2,3,5,3,2014-08-11 18:47:22,2014-08-08 23:27:13
9694209241074c10d4cc625b24dfedcb2387de93...1a249a5feb9880465594299c1d4965b160e4a14e,1,8,1,9,2,2014-08-12 01:13:27,2014-08-12 01:13:27
4baa240065b8b7dd65f161ad443bd499cf5e6707...179e9deb1abcd1aa8e536aa314f46ea403fb89ba,1,45,31,76,19,2014-12-24 07:26:19,2014-12-24 07:12:27
8722b6db4ba2359d0f63f2bce7dd981a29d220d1...32f1025b22d16872ead5ec2e3650bf76622fae99,1,15,0,15,1,2015-01-06 19:22:45,2014-12-28 23:08:42
8722b6db4ba2359d0f63f2bce7dd981a29d220d1...a1add90d89bacd0f6a7814aa72298af576107dfc,1,2,1,3,1,2014-12-27 15:59:16,2014-12-27 15:56:03
8722b6db4ba2359d0f63f2bce7dd981a29d220d1...c98ae1f88fccd89eb2184cd2b780f9827ad5ad41,4,22,9,31,10,2014-12-27 05:03:48,2014-12-25 03:09:38
c98ae1f88fccd89eb2184cd2b780f9827ad5ad41...732c94a502cbda9a60d76e7af83c0569e919cdb9,1,18,0,18,1,2014-12-27 05:04:27,2014-12-25 04:40:41
8722b6db4ba2359d0f63f2bce7dd981a29d220d1...eda92e8834f0438ab4ec29fa26c66547279413e5,1,25,0,25,1,2014-12-27 04:11:27,2014-12-27 01:19:23
12fef2d8df4e5da024418e324f7e3c3e82220a27...e52988528d20a729ed71e47e4d0a5fcb35c92dfc,1,11,3,14,2,2014-12-30 03:37:31,2014-12-04 01:12:16
12fef2d8df4e5da024418e324f7e3c3e82220a27...1d4a13867053b58971424f8caf219f935fc66fdd,2,37,5,42,6,2014-12-30 03:08:53,2014-12-05 04:31:54
12fef2d8df4e5da024418e324f7e3c3e82220a27...cfaffd1ad26cf64330b87d0f99a883215b4c5a3e,4,58,6,64,9,2014-12-30 02:58:56,2014-12-18 06:46:43
12fef2d8df4e5da024418e324f7e3c3e82220a27...35873e747d5681e42582f51ea48993382cb893a6,5,20,0,20,6,2014-12-30 02:36:04,2014-12-30 02:14:08
7156fb24427d48281892771eb9c6b3db10f361a3...7b0519d1ec8edcec773ef5d1e8f24d6a1b0b29f3,1,1,1,2,1,2014-12-29 21:15:51,2014-12-29 19:43:18
7156fb24427d48281892771eb9c6b3db10f361a3...74ee405a27b19f2d91caaf50029cea3b13ddcaf2,1,3,3,6,3,2014-12-29 21:10:16,2014-12-29 20:34:59
74ee405a27b19f2d91caaf50029cea3b13ddcaf2...e98c08a88fb5f3eedde158a3647a731c31bd4faa,1,20,6,26,5,2014-12-29 21:10:30,2014-12-29 20:56:07
7156fb24427d48281892771eb9c6b3db10f361a3...d27248007f9f4034d1a630e0ac3826af3c3357ec,1,1,1,2,1,2014-12-29 19:02:12,2014-12-29 19:02:12
f7a449f92b88ca2a3db2fb33abade8c25a19c390...e59aad9cd387bf20dc0f4664afdd5c55b394cb5b,1,3,3,6,1,2014-12-19 16:38:12,2014-12-19 16:38:12
502a1a4e1a36cfcdd88139b0b35723e86d6198cf...a70d7aaf282948c6873c03031cee0704cbe86476,1,3,0,3,1,2014-12-19 00:16:55,2014-12-19 00:13:02
a70d7aaf282948c6873c03031cee0704cbe86476...ff4bfcc0e9f171a95dac5cc2650faacf73943057,1,19,15,34,7,2014-12-19 00:16:55,2014-12-19 00:13:56
86c2cdf78242f09dc5ae22ec4cb2c37cdb69db2f...4d7359f63db200298f9d07f6434a7a4b16c25c88,1,0,49,49,1,2014-12-15 02:09:41,2014-12-15 02:09:41
86c2cdf78242f09dc5ae22ec4cb2c37cdb69db2f...70a2b64ef2e31aef84c39b979686e9194aee22a6,1,0,24,24,1,2014-12-14 05:45:02,2014-12-14 05:45:02
84dc197b087dc63280cdae50795a36434a84fa6f...83ef40cbe98e450e1a66bda6eb663be02e5eb7a8,1,2,6,8,1,2015-01-06 19:35:49,2015-01-06 19:16:33
24d03b8ddee1d4b19d3ab34f66e4c54dda8b129e...c9ca5c4dd3a90332cc40d25175e3b54aca1212a8,1,11,2,13,1,2014-12-16 05:25:15,2014-12-16 05:25:09
24d03b8ddee1d4b19d3ab34f66e4c54dda8b129e...4e7fb6b1f03173b0fbc41c18c9e9857b5708974a,1,3,3,6,2,2014-12-16 02:49:53,2014-12-13 00:45:22
4e7fb6b1f03173b0fbc41c18c9e9857b5708974a...fbb9223b1adc16834768acaa7a5776697825deb2,39,150,57,207,58,2014-12-16 04:46:25,2014-12-16 04:25:37
2acb856dff848bd69c5e971f6352854a26362164...edb75b486e5459c8ffce6d6b9d26645c1187c5ff,1,5,22,27,7,2014-12-19 16:13:33,2014-12-19 16:11:10
9a917e732c8f84f365b36a5a92bdb1f546a7e4d1...7a7890950d59abf7bc4f826c605289e1d7586390,1,11,8,19,5,2014-11-20 23:03:27,2014-11-04 03:46:53
7a7890950d59abf7bc4f826c605289e1d7586390...e527be1f14eda5a3d9077517a0398d85c4d7fac6,1,9,8,17,6,2014-11-20 23:09:09,2014-11-20 23:09:09
9a917e732c8f84f365b36a5a92bdb1f546a7e4d1...8d3b13bd7a14aa41eb3d3f3aab1b974af1db4a50,1,11,0,11,1,2014-11-20 22:21:05,2014-11-18 19:42:54
9a917e732c8f84f365b36a5a92bdb1f546a7e4d1...f42176434aa874afb7d633064f2babcf9d5124ab,4,15,22,37,7,2014-11-20 22:19:24,2014-11-20 22:19:24
f42176434aa874afb7d633064f2babcf9d5124ab...56c37536315d4c63c35b766e3335034e488e2189,1,1,11,12,2,2014-11-20 22:22:32,2014-11-20 22:22:22
00c2a8f323548b7d0aa54cfd10a594dd93ddbed0...8635b0248a1166a48dbd0fbe32df7b19f4ccea62,1,8,2,10,1,2014-11-26 02:34:08,2014-11-26 02:34:08
2a517fe103193e09474a4f67b60c09205042261e...7107898d5cf0f86dc1c6dab29e9dbdad3edc9411,3,29,0,29,4,2014-11-14 16:37:03,2014-11-11 16:17:33
2a517fe103193e09474a4f67b60c09205042261e...814bc06d7bf69c7775b775179c7a3edb8d30685c,2,2,2,4,2,2014-11-11 23:18:20,2014-11-11 23:18:20
2a517fe103193e09474a4f67b60c09205042261e...0cef21cfba5b06ce7bd5d6b68865a9df0aca95fc,4,5,8,13,6,2014-11-11 16:44:32,2014-11-11 16:30:07
2a517fe103193e09474a4f67b60c09205042261e...14692d0d417378efc3456ddb810eae5646652bda,1,46,25,71,11,2014-11-11 16:28:33,2014-11-06 18:01:37
739d917d7094db822ecfe927e1e934c3c8ec4047...d4ba00bd4237ebf6e8016a350d95cc060e5e8a05,4,26,15,41,11,2014-11-22 02:11:07,2014-11-20 18:01:59
739d917d7094db822ecfe927e1e934c3c8ec4047...244af451e9bdff5c87bca84e4c15193fc9eebc64,6,75,6,81,9,2014-11-21 13:12:03,2014-11-21 13:12:03
244af451e9bdff5c87bca84e4c15193fc9eebc64...dfcf05a5d070823ade84ffba0e9784cdfe6d54b0,4,3,6,9,4,2014-11-25 11:49:01,2014-11-25 11:49:01
739d917d7094db822ecfe927e1e934c3c8ec4047...2bceaae42399ce33e8c724d1ac435eca6759637b,1,27,0,27,1,2014-11-20 18:05:37,2014-11-14 17:37:04
739d917d7094db822ecfe927e1e934c3c8ec4047...bce9ed0e4c56b85c8a4a5ba2b1af45035deec9dd,1,5,1,6,2,2014-11-20 17:59:50,2014-11-20 17:56:54
739d917d7094db822ecfe927e1e934c3c8ec4047...72c55e82156843c73ab1405b565e63d947b66c10,1,1,1,2,1,2014-11-20 17:02:42,2014-11-20 17:02:21
739d917d7094db822ecfe927e1e934c3c8ec4047...4deac03c65edf34affd66abd3ef8fb88287d2f5a,3,72,1,73,6,2014-11-20 04:36:46,2014-11-03 11:11:29
ce8ebaf0e013fd4a7f6e04b36d0a2c57a19aeef9...054e57a622e6a065c343806e7334920d17a03c5b,7,18,0,18,9,2014-11-21 17:59:44,2014-11-21 17:51:32
c59b308b6b2fc8112a93d64f4922b0ece01a4e6a...e07daa58d99fc1733603a9fbc5c795818cdc6687,1,8,5,13,6,2014-11-24 18:49:09,2014-11-24 18:49:09
c59b308b6b2fc8112a93d64f4922b0ece01a4e6a...d96832cbd2c62103944518866e1fc1219ce048d5,1,1,1,2,2,2014-11-24 18:26:41,2014-11-22 23:21:47
c59b308b6b2fc8112a93d64f4922b0ece01a4e6a...7fbbd515b1018721e91199960d1933383a8262a1,8,78,83,161,61,2014-11-24 15:32:38,2014-11-24 15:32:38
c59b308b6b2fc8112a93d64f4922b0ece01a4e6a...91a8b916b09615119e80a1193f1a2f6c01143106,1,1,0,1,1,2014-11-23 22:57:43,2014-11-23 22:57:43
c59b308b6b2fc8112a93d64f4922b0ece01a4e6a...745e3f77a127c5be2e7d563e402e3e4a7d5d7729,1,1,1,2,1,2014-11-23 19:59:35,2014-11-23 19:59:35
745e3f77a127c5be2e7d563e402e3e4a7d5d7729...5deedef42c7d85835729ecf4fe61ec91612089af,1,1,1,2,1,2014-11-24 18:22:54,2014-11-24 18:22:54
c59b308b6b2fc8112a93d64f4922b0ece01a4e6a...34fe2a372576907cb7ec26cf22ac4e93b8974f6e,1,3,1,4,1,2014-11-22 23:45:14,2014-11-22 23:45:14
c59b308b6b2fc8112a93d64f4922b0ece01a4e6a...30979ad5a0f94097e7dc6763c26fc33dc716d572,1,22,13,35,7,2014-11-22 07:18:11,2014-11-22 05:40:39
27127437a6249bbf6f70707ff681992eb00ac47b...8432224f0ef628b3da42def046e48f9635aa4b23,1,7,4,11,1,2014-11-29 14:18:18,2014-11-25 11:07:02
27127437a6249bbf6f70707ff681992eb00ac47b...095027944f16205c1c75d47d2f60a7c1ac666bf1,3,3,3,6,3,2014-11-28 07:57:07,2014-11-27 11:54:36
27127437a6249bbf6f70707ff681992eb00ac47b...ec8c53228a409dc3af45e5e25798bec84c4d0515,1,1,1,2,1,2014-11-25 15:38:16,2014-11-25 15:38:16
27127437a6249bbf6f70707ff681992eb00ac47b...2e863e8a3849f6ea34dd281aac6f8a6c700bf029,1,167,8,175,9,2014-11-25 07:53:12,2014-11-17 16:13:58
2e863e8a3849f6ea34dd281aac6f8a6c700bf029...eac9f2e5c4fa47b0ef1e064ac2bc62be6f3a3c99,1,8,44,52,25,2014-11-25 07:53:13,2014-11-19 13:29:56
27127437a6249bbf6f70707ff681992eb00ac47b...efb8e8a34550b80a567e7b69ad6bb2644d5a9b09,1,9,2,11,1,2014-11-25 07:41:49,2014-11-25 07:41:49
27127437a6249bbf6f70707ff681992eb00ac47b...f30fee69b14a5fd9df9abb00498f2aff6e378bbe,1,228,0,228,1,2014-11-25 04:18:47,2014-10-24 20:23:50
f30fee69b14a5fd9df9abb00498f2aff6e378bbe...3e08fb5ad2b882b12a396e258bc745254fac6f51,1,21,14,35,10,2014-11-25 04:18:48,2014-11-12 14:25:46
3e08fb5ad2b882b12a396e258bc745254fac6f51...3d6e63e0c4bab556fb8bd0abb65e4f7af35256fd,1,1,1,2,1,2014-11-25 04:18:48,2014-11-13 18:09:05
3d6e63e0c4bab556fb8bd0abb65e4f7af35256fd...7f84174109b734fac309c02e4b474aeff9dfca15,1,36,46,82,31,2014-11-25 04:18:48,2014-11-20 20:46:15
6d6dc2c1a1e36a2c3992186664d4513ce28e84ae...1a1b0f223d5b877271d1484d6235c4a7b9e4cb32,1,12,11,23,6,2014-11-03 21:50:42,2014-10-31 17:55:55
1a1b0f223d5b877271d1484d6235c4a7b9e4cb32...06f366bf0041a223ae848e6a8df0c8cc41f08001,1,2,0,2,1,2014-11-03 21:51:51,2014-11-03 21:51:51
674e11183a32d803d81d3a7bedee5ee96d7cb68a...35703d4f0c79e936bbff1804167ae9e8dde9b76c,1,2,2,4,2,2014-10-29 00:42:03,2014-10-29 00:42:03
a0781f3ea91b47f1a086d441e40296d40a5c84d9...9e137ceb578bd427124d4937bc6e440ae5267bf6,2,21,18,39,19,2014-10-21 01:21:11,2014-10-21 00:48:58
023241614efbbf143041f261df969bed6fc7f645...4119c9d7d955757092adc3410da8d75f972bd3c1,5,18,17,35,14,2014-09-16 16:57:44,2014-09-16 03:30:10
459b403c2ff5341ab15bfaa8fe609571d1a50748...c5e6362c53cbbc09ddbabd5a7323e04438b57d31,9,203,19,222,13,2014-09-17 18:37:46,2014-09-04 20:13:50
459b403c2ff5341ab15bfaa8fe609571d1a50748...1f03e60c2a96a92acae0e4d2fd604ab2c6d55473,5,13,9,22,10,2014-09-17 15:06:17,2014-09-17 15:04:56
1f03e60c2a96a92acae0e4d2fd604ab2c6d55473...277aa9c67415b9b76ab17daea583b51f8560a6a5,1,12,4,16,2,2014-09-17 15:06:17,2014-09-17 13:50:56
459b403c2ff5341ab15bfaa8fe609571d1a50748...adb6910095a18bef64a2da6815acd7d322a4c1e9,1,10,8,18,1,2014-09-17 14:09:39,2014-09-17 14:09:39
f98a1f1f7d9b3ef10c13fc3b6438c978b4d6aa78...4dc4d56db9797159e2e329845e0b94e3e0f780a0,5,26,8,34,12,2014-09-17 03:00:15,2014-09-17 03:00:15
e9b5acba4b7a0a21e030b775b82351189367eb41...640d2ef6f54d96ac4fc3f0f745cb1e6a35148607,1,1,1,2,1,2014-09-18 12:21:00,2014-09-17 20:42:25
e9b5acba4b7a0a21e030b775b82351189367eb41...aa0449c8139afec8e1446bb8650acad886b0a194,1,1,1,2,1,2014-09-18 05:02:05,2014-09-18 05:02:05
aa0449c8139afec8e1446bb8650acad886b0a194...184fe67bbc3759307adb6cb3e5338b5325bb88bb,1,9,9,18,9,2014-09-18 05:09:10,2014-09-18 05:09:10
58dc474e6546e6ae9e4ebd06e9fd844442fea271...ba24820284a7a87642f2b668987c1627d6977ea2,3,23,1,24,3,2014-09-04 05:50:58,2014-09-04 05:50:58
58dc474e6546e6ae9e4ebd06e9fd844442fea271...adc9a14db49f7e8ffd7cecb788bb9b560a7a3aae,1,2,2,4,1,2014-09-04 00:53:45,2014-09-04 00:53:45
58dc474e6546e6ae9e4ebd06e9fd844442fea271...dc2eab2cf48be2dc763f132fea1e1a72b0c8e03c,1,91,64,155,29,2014-09-03 20:30:11,2014-09-03 20:30:11
58dc474e6546e6ae9e4ebd06e9fd844442fea271...a447894946ca2ac47bf1c46f78c4839c75fd740d,1,2,2,4,2,2014-09-03 17:12:10,2014-09-03 17:12:10
58dc474e6546e6ae9e4ebd06e9fd844442fea271...2a7770a712758e9d5071cedd8e44352953bdef72,1,1,1,2,1,2014-09-03 17:06:25,2014-09-03 17:06:25
58dc474e6546e6ae9e4ebd06e9fd844442fea271...9c08364a412a51c80e8d17ae14f92549dc543e68,1,13,10,23,5,2014-09-03 15:03:14,2014-08-27 12:38:12
9c08364a412a51c80e8d17ae14f92549dc543e68...82b0c3e59ca12dd87bf2a9d88a63ff66e7d29fb4,2,10,3,13,7,2014-09-03 15:32:41,2014-08-29 00:16:40
82b0c3e59ca12dd87bf2a9d88a63ff66e7d29fb4...6ba5d67a51d96e6c2923227c99ee049bbf8e5f50,1,3,0,3,1,2014-09-03 15:32:47,2014-09-03 15:27:25
58dc474e6546e6ae9e4ebd06e9fd844442fea271...9c413e3e6f1c6bd6abada707c442862049d29743,1,3,1,4,1,2014-09-03 14:26:56,2014-09-03 14:26:56
58dc474e6546e6ae9e4ebd06e9fd844442fea271...476f1df36f6e8aa16a1e302efe8addec1fe191c9,1,2,2,4,2,2014-09-03 10:28:01,2014-09-02 12:53:50
ac69b661eed2fe410bd4275951e31c6f93e274d3...eac6a5d78906a70ddc3264f8d0a87369aefaedf0,2,8,2,10,6,2014-09-01 18:33:13,2014-07-25 16:42:25
eac6a5d78906a70ddc3264f8d0a87369aefaedf0...2d8695761d0241d2c9b8bfe4274674c702c6a14d,4,24,6,30,18,2014-09-01 18:41:42,2014-09-01 18:41:42
2d1c8bd78647162c7ea7d6bf9390a3d56305eb2d...b47a2fbdc545d649a945e78a22da0c5dd9df0921,1,16,0,16,4,2014-09-11 17:19:07,2014-09-11 17:09:18
2d1c8bd78647162c7ea7d6bf9390a3d56305eb2d...234f0e4f79c27a4820f75a504fdcd45b2981a68a,20,20,20,40,20,2014-09-11 13:00:24,2014-08-29 19:49:16
234f0e4f79c27a4820f75a504fdcd45b2981a68a...6b322ad2d32b1525ad01611f0d6ad8d803f5f6f0,3,9,4,13,4,2014-09-11 13:00:24,2014-08-29 20:04:34
6b322ad2d32b1525ad01611f0d6ad8d803f5f6f0...3a6d1228a83ba0f9dd96138ccccfa758c0956a62,1,1,1,2,1,2014-09-11 13:00:24,2014-08-29 22:21:49
3a6d1228a83ba0f9dd96138ccccfa758c0956a62...ac107995ae4a24195f8bb6b70c26393a87d19982,5,52,6,58,11,2014-09-11 13:00:24,2014-08-30 11:34:09
ac107995ae4a24195f8bb6b70c26393a87d19982...78a847a47ac777f4090c06a82e875ee30f9a1cbd,2,21,4,25,3,2014-09-11 13:00:24,2014-09-01 20:33:06
78a847a47ac777f4090c06a82e875ee30f9a1cbd...92f885d7bd9d4a8f5d30ec650a7625a8727d952e,2,1,5,6,2,2014-09-11 13:00:24,2014-09-03 12:34:11
92f885d7bd9d4a8f5d30ec650a7625a8727d952e...576416c99a0ae8ad27467f217ec21f598e4f4cc8,1,15,10,25,7,2014-09-11 13:00:24,2014-09-03 19:17:17
576416c99a0ae8ad27467f217ec21f598e4f4cc8...91bed436215f272c2956abb969425ee0bfd3a998,1,4,4,8,2,2014-09-11 13:00:24,2014-09-11 12:58:50
2d1c8bd78647162c7ea7d6bf9390a3d56305eb2d...7b1fdd6c0460931d458703e175cba157de9b0246,13,23,23,46,23,2014-09-11 09:09:59,2014-09-11 09:09:59
2d1c8bd78647162c7ea7d6bf9390a3d56305eb2d...c7310b64637ae29a6d7a07b7e533a546e3524654,1,6,0,6,1,2014-09-11 07:04:35,2014-09-11 04:24:51
2d1c8bd78647162c7ea7d6bf9390a3d56305eb2d...ef3920278e6a07254a6dcd9502254ed25656d552,1,1,1,2,1,2014-09-11 06:55:45,2014-09-11 06:55:45
2d1c8bd78647162c7ea7d6bf9390a3d56305eb2d...6e0bc06018b28ac46689708343b8dd57cae772c2,2,15,1,16,3,2014-09-11 02:20:49,2014-09-11 02:20:20
2d1c8bd78647162c7ea7d6bf9390a3d56305eb2d...ec01eb653db9d5e5b9291c1670dde57e7f742874,3,22,19,41,13,2014-09-11 01:56:20,2014-09-11 01:56:20
350b1cf6ea5681e26ea752e2e54ef6c9a04d91e0...950bfe419390bc0e5777ae70bd01f781ae61701a,1,2,3,5,3,2014-09-22 18:17:50,2014-09-22 18:14:49
b5a4c70455019abe016d7880e0c01f1d1d7811ee...b2efdc538de47d37718b8972cd6703be32fc23c2,3,92,53,145,12,2014-09-11 18:29:25,2014-09-10 00:32:14
ed7fb3bbdaa5cbce2563567eaa4cef67fc172270...658a9d0f471b903035869ffadece5806768ab690,2,27,11,38,6,2014-09-12 18:39:14,2014-09-11 23:32:09
ed7fb3bbdaa5cbce2563567eaa4cef67fc172270...440eb7fee88791d4f2f0866b04ff15253b6df8e9,1,6,1,7,2,2014-09-11 22:22:36,2014-09-11 20:49:43
ed7fb3bbdaa5cbce2563567eaa4cef67fc172270...d6f4b2ebb40ac79c3ba21e7196bba3b83124cf16,3,5,5,10,4,2014-09-11 21:20:01,2014-09-11 19:49:07
39ed048aabbc9e2c2981339ce02169d79c6c4f1c...a8775d2f9a211b90474b5709ad75b8e1fcb2e189,2,6,4,10,2,2014-09-22 05:39:09,2014-09-22 05:36:20
39ed048aabbc9e2c2981339ce02169d79c6c4f1c...1d2a1598c54d9ca8d3d02ec5e7b0231a8cf153d3,1,4,4,8,1,2014-09-19 16:34:05,2014-09-19 11:57:38
39ed048aabbc9e2c2981339ce02169d79c6c4f1c...d78936b41842ce725f293f6bba1e3604c91682a3,1,2,2,4,2,2014-09-19 10:22:39,2014-09-19 10:18:21
41f2b3c6bc6971c689f08fbe80b14f7dd0f9550f...2531fba389c8bd25ed1ec7bea38f0ee19c974a26,11,267,148,415,53,2014-09-19 18:21:44,2014-09-19 18:20:10
ba726d9148ee616f0ad069bff6c7732815beb6c6...45407cf00af95b04dd2ff11ce330dd397bf1e095,12,511,332,843,78,2014-09-19 22:47:47,2014-08-28 14:18:08
77193089d8b7dba9e3a045e9e58b65466f6a3c3a...72fe4c8daa86158fef97dceb1bae6395c2b4e05e,1,1,4,5,2,2014-09-19 22:20:35,2014-09-19 21:38:46
72fe4c8daa86158fef97dceb1bae6395c2b4e05e...07cedaab8640a68c480cb90722cb08fcf0a2c043,1,3,1,4,2,2014-09-19 22:40:48,2014-09-19 22:40:48
2aaa8892e3d126e20f2659e9b71a9ce9973cf60f...8892320835ad2b21b0efd4848d2af0d8a791a8e9,2,23,29,52,2,2014-09-01 15:55:39,2014-09-01 15:55:39
8892320835ad2b21b0efd4848d2af0d8a791a8e9...195cee99839a77afec7aaf7fe43cb5a9ceae4f57,2,31,54,85,3,2014-09-01 16:15:20,2014-09-01 16:15:20
ead942156cadb0ef329379a52f1c42d7693a2dea...b23daef3ec9fdecc6b7bcc1e3a657eccf1f5f399,1,4,0,4,1,2014-09-04 20:32:16,2014-09-04 20:32:16
ead942156cadb0ef329379a52f1c42d7693a2dea...23cf3f74072290f2de0e57d87af3236d44e0b039,1,13,7,20,5,2014-09-03 00:44:36,2014-09-03 00:44:36
9ffb0f76f2efa1b5a93f78dec8bcd256f3d99fd2...4aa5da278f49c889d43191f82ff42d3a95266d62,15,150,134,284,109,2014-09-01 21:30:16,2014-08-26 22:05:37
4aa5da278f49c889d43191f82ff42d3a95266d62...3a7e07355a1ad67f71ee4255e06526186fd48f7a,12,61,67,128,50,2014-09-01 21:31:01,2014-08-26 22:44:00
44159f38d2b6d92e21b7c4b43bfd9ba7dce3719e...82f33d86a7c4d41d3c880757d35c81c847a9ab69,1,23,7,30,6,2014-11-21 22:49:09,2014-11-13 23:04:13
c1a40d927999a7e019f1952c2b140ef6e4a76171...ae9bd580af55992974fcb94f73f72cc3b2257fec,5,43,3,46,7,2014-11-21 00:09:06,2014-11-20 15:29:04
14e65b4f81004b0946816f93a46576bd991fe6e2...059e589c3427b1afa1b112acc931f59b5b063e16,2,31,4,35,7,2014-11-05 18:17:55,2014-11-04 23:23:21
14e65b4f81004b0946816f93a46576bd991fe6e2...a368e064a972ab75561ee50067a3168b9d8d277e,1,8,21,29,5,2014-11-04 21:12:23,2014-10-09 17:52:30
3e5cb0c84f390c2c939061ae34754e3924f82790...769b79866aa645d4deeeb0a44120cde7b046f0d1,3,10,5,15,7,2014-11-20 17:33:15,2014-11-20 17:33:15
769b79866aa645d4deeeb0a44120cde7b046f0d1...32ba6ab83c7e47d627a2b971e7f6ca9b56e1be85,1,5,2,7,3,2014-11-20 17:34:35,2014-11-20 17:34:35
32ba6ab83c7e47d627a2b971e7f6ca9b56e1be85...4508bd94b0efd07a0ef48cd090786615e6b8cbb7,1,1,0,1,1,2014-11-20 17:36:54,2014-11-20 17:36:54
4508bd94b0efd07a0ef48cd090786615e6b8cbb7...98307c8faefca5c4347288af18aee4dacbf8802c,1,1,0,1,1,2014-11-20 17:37:46,2014-11-20 17:37:46
98307c8faefca5c4347288af18aee4dacbf8802c...db7fded17fd984fc3c854d1e34bd8d656c3b3692,1,43,0,43,24,2014-11-20 17:38:41,2014-11-20 17:38:41
db7fded17fd984fc3c854d1e34bd8d656c3b3692...4180579313e84ea7e3d85214521a815e95459a90,1,19,15,34,16,2014-11-21 16:31:45,2014-11-20 17:39:08
9974fce28a6aea81f8ea8c43a782d9940822d724...9cc73c62e6779bf2c8eefc4192c017a2c73daf40,1,4,4,8,3,2014-11-29 17:58:16,2014-11-29 17:58:16
9974fce28a6aea81f8ea8c43a782d9940822d724...54050083d1c65d4e7a90371c78c587819df27d2f,1,24,0,24,1,2014-11-27 06:36:55,2014-11-18 23:55:40
9974fce28a6aea81f8ea8c43a782d9940822d724...498f208ade18dffb7362adc37c1f11b1bff187da,1,4,0,4,1,2014-11-27 02:06:40,2014-11-21 21:47:03
9974fce28a6aea81f8ea8c43a782d9940822d724...d53b586ff1b274b529b7912df3052a1bc2ca8dfe,10,153,25,178,13,2014-11-27 00:17:46,2014-11-26 04:09:52
21bba5d93a888e20d7fa8d7dd56efbdd1fd486c1...973c3c768be19b80543631ad9515fe05b95b2d22,1,2,2,4,2,2014-12-23 01:14:14,2014-12-18 10:22:08
21bba5d93a888e20d7fa8d7dd56efbdd1fd486c1...491ff81a0b6653d75b2bc4ca81251d7bf5ee9f3f,1,1,1,2,1,2014-12-23 00:53:36,2014-12-18 10:24:59
d7626e97b61f5f8f5d585ec82d6154395a3f9404...90928eb1140fc0394e2a79d5e9a91dbc0f02484c,9,204,3,207,13,2014-11-26 01:49:25,2014-11-17 23:50:09
d7626e97b61f5f8f5d585ec82d6154395a3f9404...88afbc4d94c4a803e936d602c620b8ab08e24acd,1,22,0,22,5,2014-11-22 13:37:36,2014-11-22 13:25:57
74564e51ad0269a6d3aa4290c6c070b8f249f1cd...05ff40b07a5857b41e17290e1d7cef516f122d6c,1,1,0,1,1,2014-10-30 05:31:19,2014-10-30 05:31:19
b95f6c183bca45e8f38d3c8abc5dcb2d0eee2ad6...5ad4879d2a5ee5af95c8b8ab701a621c8b49609a,2,3,2,5,3,2014-08-14 01:24:33,2014-08-14 01:21:15
b95f6c183bca45e8f38d3c8abc5dcb2d0eee2ad6...fcf37be2b1efa11da1958658da0e04755a225c89,5,9,9,18,9,2014-08-14 01:08:27,2014-08-14 01:08:27
fcf37be2b1efa11da1958658da0e04755a225c89...a0392324f194f4f92e3205f0c0ed8b71dc2fc93f,11,39,39,78,39,2014-08-14 01:36:26,2014-08-14 01:36:26
e608312677d26f1f5b4f76852917d4f149ef88c1...db3db49e9cd8c8fb0f230987e9f111a0509f4666,7,47,0,47,3,2014-08-23 00:06:28,2014-08-23 00:06:28
db3db49e9cd8c8fb0f230987e9f111a0509f4666...e4ff140fddcc0b23e10e5db5a49e77e049460b14,2,43,18,61,17,2014-08-23 01:19:58,2014-08-23 01:19:58
e4ff140fddcc0b23e10e5db5a49e77e049460b14...1d1bb2ae4507f67bd7192dd9f19d13cd1bce7d53,5,42,19,61,10,2014-08-25 23:50:55,2014-08-25 23:50:55
1d1bb2ae4507f67bd7192dd9f19d13cd1bce7d53...161cc21f245cf05c6c2c168a6f5981989026e2cb,1,10,8,18,8,2014-08-26 21:01:10,2014-08-26 21:01:10
161cc21f245cf05c6c2c168a6f5981989026e2cb...77ca0ae9decbdcb8958c20f16d35ec34372b6efe,1,8,8,16,7,2014-08-27 18:49:26,2014-08-27 18:49:26
77ca0ae9decbdcb8958c20f16d35ec34372b6efe...ce73a3bcf77e1333a000a55de8df033dce6e54ae,1,36,30,66,12,2014-08-28 18:04:53,2014-08-28 18:04:53
ce73a3bcf77e1333a000a55de8df033dce6e54ae...0f8d461ed7c8b338d671bea0240b288fa91155b6,1,7,7,14,5,2014-08-28 20:51:38,2014-08-28 20:51:38
a7d116f1b0e81a739e7451e6f852805c479c68d6...5073554ca67f7f1f3f21d87cab766708556486c2,1,1,1,2,1,2014-08-14 12:20:38,2014-08-14 12:20:38
01995ebebb3f26a2bd1e1131b5794e8b6b6ae18e...a44f065f171cb91867630e752c09fde4b01d4c98,2,11,19,30,2,2014-08-12 08:22:25,2014-08-12 07:48:36
a44f065f171cb91867630e752c09fde4b01d4c98...c19e0fe7e2c626218c854aa97fd3f23d29f11615,2,57,51,108,4,2014-08-12 09:40:14,2014-08-12 09:36:49
01995ebebb3f26a2bd1e1131b5794e8b6b6ae18e...fcddecc828a95083db8975391e623289b2fe1254,1,2,2,4,2,2014-08-12 05:56:57,2014-08-12 05:56:57
4a81661f5e28273f764df34d8a1019db61d2ba77...8d7ee3697036d2d1f6c43efcb50b8d8b6c627584,1,2,2,4,2,2014-12-26 17:31:01,2014-12-26 17:31:01
4a81661f5e28273f764df34d8a1019db61d2ba77...6df1eff85e5614dfc1b09e1ff5c4e9cadb0dde0f,1,1,1,2,1,2014-12-26 06:54:38,2014-12-26 06:37:43
4a81661f5e28273f764df34d8a1019db61d2ba77...6e96dcec3c524dc05b7d72aa0aab4fd734c03a7d,1,2,1,3,2,2014-12-25 23:06:56,2014-12-25 23:06:45
d7f72188ffe3cf98481292d780da463b7de05e58...3c03827e73647cad27a0656ce685c8aea8ed4d21,1,22,1,23,6,2015-01-01 15:01:26,2014-11-15 17:54:21
3c03827e73647cad27a0656ce685c8aea8ed4d21...3011aa4e9984b0631b67f640a191677e2f3d0a8f,1,6,9,15,4,2015-01-05 18:34:49,2015-01-05 18:34:28
d7f72188ffe3cf98481292d780da463b7de05e58...50eb14244d3139e8aa9141d8f7076043ffecbc6e,1,45,6,51,6,2015-01-01 10:21:42,2014-12-29 18:21:45
50eb14244d3139e8aa9141d8f7076043ffecbc6e...70161b4d45ec990a4e597e133092e389e168ad79,1,70,65,135,55,2015-01-01 10:21:42,2014-12-30 18:18:21
a444643f97e47de72723631f3e2d6ce495f88337...f339d3bceb4634bba1bc27e455d0fd8505df17bf,1,0,2,2,1,2015-01-06 18:07:13,2014-12-30 23:26:12
a444643f97e47de72723631f3e2d6ce495f88337...4e679f218c5da33856df25069368b24e78d8bb85,1,7,7,14,2,2014-12-31 02:36:16,2014-12-31 02:36:16
a444643f97e47de72723631f3e2d6ce495f88337...e704dd31e79114a2156c4fdda3247a181ad6435d,1,67,45,112,16,2014-12-30 22:32:25,2014-12-30 19:34:35
13250569f664e33c7c92f6304d35045d5145f5ba...6599aa3368f369e6b8632cc2c12f214b0450a5a6,2,19,1,20,2,2014-12-19 19:00:28,2014-12-09 20:04:33
e4b2f802ae669f4a89b04576ac92c95858773810...bc4edbbe712a2d0fb839747814933916177daa74,1,1,1,2,1,2014-12-15 09:29:28,2014-12-15 09:26:00
e6a68a1c871e73c7b3f86839e9c21765fba24430...d44c9f91472eb3df4c38c669134df04b2ccf9953,3,150,12,162,9,2014-12-15 21:51:15,2014-12-12 16:01:05
e6a68a1c871e73c7b3f86839e9c21765fba24430...03bdacbb4e4bf2fabf67bfdb8b5118bc7ed1edd2,1,1,0,1,1,2014-12-15 21:44:22,2014-12-15 21:44:22
e6a68a1c871e73c7b3f86839e9c21765fba24430...46b104bd3977c4777b0d99ba6c190f37ae780245,1,46,120,166,4,2014-12-15 20:08:49,2014-12-15 20:07:41
f2b89166cf3d352298496ea19a7b72bf5b1cba54...35a22c9e12c05e2a0a205964702ced78ea39d7a1,9,75,66,141,48,2014-12-18 05:54:23,2014-12-18 02:26:03
532e502e9c37d1caab59f9e8d188f6700b197ebb...2d2b3535cae11d02573d12297d34e9a98a3e984a,1,4,4,8,4,2014-11-21 03:17:00,2014-11-21 03:14:01
532e502e9c37d1caab59f9e8d188f6700b197ebb...6cc75574b3b01fa4dfeeef585e52dbcf8da28586,1,14,5,19,7,2014-11-21 02:07:11,2014-11-21 00:07:55
6cc75574b3b01fa4dfeeef585e52dbcf8da28586...f6c7194539720473aae814d3d1445eab2a78d568,1,3,3,6,3,2014-11-21 02:07:15,2014-11-21 00:20:29
29f4ea2cd5ee0988abb24264e4dbf01fa52d2d54...7b20c1fd1877dc91abfbf6fd57e1f16e3b44c1e0,1,2,2,4,2,2014-11-21 00:54:46,2014-11-21 00:37:48
7b20c1fd1877dc91abfbf6fd57e1f16e3b44c1e0...46437d1a60278d1acfe32412f69b3c22749becf2,1,1,1,2,1,2014-12-02 17:48:39,2014-12-01 17:49:27
75b47467aa81b203f565eef7a182f0f805d0f812...921346be48d20a66b2b5763144b064395285bb32,1,1,1,2,1,2014-12-01 08:28:08,2014-12-01 08:28:08
75b47467aa81b203f565eef7a182f0f805d0f812...750dc335a983fcd2c1410bffe5e23d1b0b3c3e3c,1,4,2,6,1,2014-11-26 19:50:07,2014-11-26 18:46:00
75b47467aa81b203f565eef7a182f0f805d0f812...8b881df9b1f3c8fa7c36dd5b2fb3e7235f6d4654,1,1,1,2,1,2014-11-26 19:09:44,2014-11-26 19:09:44
75b47467aa81b203f565eef7a182f0f805d0f812...64fd3e89c7f6164b5522b5e611e7daf4a2bdae9c,1,2,2,4,2,2014-11-26 18:22:16,2014-11-26 18:19:10
75b47467aa81b203f565eef7a182f0f805d0f812...12bc51603bddac886363756d550ab79a53bcac8f,1,1,1,2,1,2014-11-26 15:15:10,2014-11-26 15:15:10
67fda331973fdd23f3da79588ea899dc577f46e8...e201d5bcd46a3dcb70dd6b6e23ee375e4b5b5f40,1,3,1,4,1,2014-12-03 23:53:19,2014-12-03 23:53:19
39284be960d3d528ecf3faaa7900f4718e959c06...c83cd5c7ac6dca270ef77adbca0be63441573c91,2,38,1,39,3,2014-11-25 21:22:04,2014-11-24 22:54:50
39284be960d3d528ecf3faaa7900f4718e959c06...faab87cc36fb6f02ddd53e1be09f10623a40773a,3,178,34,212,8,2014-11-24 22:27:05,2014-10-28 21:18:45
faab87cc36fb6f02ddd53e1be09f10623a40773a...294843ef23fcff3c080d9fbd12df17ae7006a9f8,7,14,12,26,14,2014-11-24 23:02:30,2014-11-03 22:57:18
294843ef23fcff3c080d9fbd12df17ae7006a9f8...fa1484d12c5b66f7db03a9c93002ba3df56cdb4e,1,1,0,1,1,2014-11-24 23:03:40,2014-11-03 23:00:49
fa1484d12c5b66f7db03a9c93002ba3df56cdb4e...1cb17f03d0b217acf2d2c289b4946d367f9d3e80,11,176,13,189,21,2014-11-24 23:03:40,2014-10-29 19:06:51
1cb17f03d0b217acf2d2c289b4946d367f9d3e80...9c01bc249dc628280f3fc019d5f0e0ace71be248,5,58,4,62,10,2014-11-24 23:03:40,2014-11-08 15:38:42
9c01bc249dc628280f3fc019d5f0e0ace71be248...209deff9633b82198925846ebcb0a02191553005,5,27,3,30,9,2014-11-24 23:03:40,2014-11-11 11:02:14
209deff9633b82198925846ebcb0a02191553005...221617dbcd9431f14a3779d8bac9aba52f78ea21,4,553,1,554,6,2014-11-24 23:03:41,2014-10-20 19:35:48
221617dbcd9431f14a3779d8bac9aba52f78ea21...1852cc38415c3d63d18c2938af9c112fbc4dfc10,2,24,2,26,9,2014-11-24 23:03:41,2014-10-20 19:36:28
1852cc38415c3d63d18c2938af9c112fbc4dfc10...31d1d733037b22591e2dd2edfe6c4d2d4b8086cc,1,8,0,8,2,2014-11-24 23:03:41,2014-10-31 17:18:39
31d1d733037b22591e2dd2edfe6c4d2d4b8086cc...330171e1d9ec537d7f691fd63c697a0540589053,1,8,0,8,4,2014-11-24 23:03:41,2014-11-18 21:33:13
330171e1d9ec537d7f691fd63c697a0540589053...f6d9780229bfa52c86762d49a7a7e644dcd8f6df,3,23,10,33,5,2014-11-24 23:03:41,2014-11-19 16:27:34
f6d9780229bfa52c86762d49a7a7e644dcd8f6df...2ec2237909ba51d3fe10a2ee6cfb81f315408f68,2,13,0,13,2,2014-11-25 00:06:45,2014-11-24 23:28:20
2ec2237909ba51d3fe10a2ee6cfb81f315408f68...b21e1d4a00f2687ef24aa47039ac2f0281294365,2,17,1,18,2,2014-11-25 00:07:01,2014-11-14 22:47:37
748fe7a0fa8df73d89df729ce307c24ac881ae1e...c7e4cc4a531b5337d64bda22df8553e646a96fe7,3,27,8,35,7,2014-11-24 20:49:54,2014-11-14 01:52:55
4083fa26208fe4a1b78cad9ab85cdbb50293cedd...9c5e61c24c490ca3e9d52855ee26d4a8e9032fb2,1,1,1,2,1,2014-11-28 18:48:50,2014-11-28 18:48:50
4083fa26208fe4a1b78cad9ab85cdbb50293cedd...9f8c14026ce2ddf0f69eb7a416cfb56da5443032,1,1,1,2,1,2014-11-28 12:36:27,2014-11-28 12:36:27
353ff40181276a0278b323e569cc887d0510ae69...c57317893a743720a241ae328d1bdf7bd02b1fea,2,5,6,11,6,2014-12-02 09:02:59,2014-11-30 09:14:34
c57317893a743720a241ae328d1bdf7bd02b1fea...d680ca5c96484474757fb6f92274f47bf1520631,4,16,16,32,15,2014-12-03 12:57:23,2014-12-03 12:57:23
d680ca5c96484474757fb6f92274f47bf1520631...2352f00e4ff2cd102a4d591d67aba8e1c7eaa7b6,6,41,41,82,9,2014-12-03 13:06:19,2014-12-03 13:06:19
353ff40181276a0278b323e569cc887d0510ae69...47d8ec0a42ce2cd71a0275665f2e7d74a5a56cbf,2,20,21,41,8,2014-12-01 00:23:38,2014-11-16 20:14:45
353ff40181276a0278b323e569cc887d0510ae69...eb8e84c48a8a20895b78299dbc2d8429d092be8d,1,2,3,5,1,2014-11-30 06:36:19,2014-11-24 23:22:50
b487d2f2ff9562301c1e9a1e705876ff3e3f3c10...f3cedce3608afe7bd570666a7fc878ab85c7bc03,2,42,23,65,7,2014-12-05 01:16:22,2014-12-03 02:45:07
b487d2f2ff9562301c1e9a1e705876ff3e3f3c10...266a1044deb9a085ed43dccdc6cfa0723e5142b0,1,8,4,12,2,2014-12-04 07:43:03,2014-12-04 07:40:16
b487d2f2ff9562301c1e9a1e705876ff3e3f3c10...59da197de8f040eed7560747476f97ce8afad293,3,0,20,20,4,2014-12-02 18:47:57,2014-12-02 18:47:57
b487d2f2ff9562301c1e9a1e705876ff3e3f3c10...fb06e1c6ebcf5408e6a7d0bfcf9264571eab69a1,3,45,51,96,7,2014-12-02 11:02:25,2014-12-02 11:02:25
7ebcdad03043a5cb423aaecbc7932fea76a2f7db...3db5ea1617549bbef7f645d4ecbf482ad1f31c71,2,4,1,5,2,2014-11-25 22:44:16,2014-11-25 22:41:42
7ebcdad03043a5cb423aaecbc7932fea76a2f7db...61b2766e758f21b8b6bd32dc82ba624c2f0c5fd6,1,10,0,10,4,2014-11-25 19:12:26,2014-11-20 22:20:26
61b2766e758f21b8b6bd32dc82ba624c2f0c5fd6...305e9cd2fab974c38064a1acd2ef1f552a3a1357,1,5,8,13,4,2014-12-01 19:54:14,2014-12-01 19:54:14
7ebcdad03043a5cb423aaecbc7932fea76a2f7db...b4b962444765ea76457465000f42d1a52021020e,1,0,19,19,1,2014-11-25 19:11:13,2014-11-25 19:05:43
a10876d35520df10b9a10feb941ffe6922844782...36dae27fa26fe58efaf68296169cd2c6ba6dfcfe,1,2,2,4,2,2014-10-21 16:38:19,2014-10-21 15:06:57
a10876d35520df10b9a10feb941ffe6922844782...7cf322dffc5e9a4ea495ec08e0b0594cad01da92,1,7,7,14,2,2014-10-21 07:00:25,2014-10-21 07:00:25
a10876d35520df10b9a10feb941ffe6922844782...6ed610fb8014d500e001bb0677f0e1af0dc9312d,7,1,15,16,9,2014-10-21 06:04:11,2014-10-21 05:59:23
a10876d35520df10b9a10feb941ffe6922844782...d2cd8e77a6ce83fdfafd32828610e8cd3ed258eb,1,9,9,18,7,2014-10-19 06:47:53,2014-10-19 06:47:53
9df3e45ba985a6ed7e9a07b308d56d694d1c13ad...a34831f0168156ded7ecf96a1734c2735fede1ca,2,37,1,38,3,2014-10-21 20:17:37,2014-10-21 19:26:20
9df3e45ba985a6ed7e9a07b308d56d694d1c13ad...5df2c878a1b2baeb22538bb66be631b8da33236a,1,7,12,19,1,2014-10-21 19:58:05,2014-10-21 18:17:20
c694c66e2facc5194b225fa2bf4bca084cf7e5ee...f9d80712d9417feadd63cb71c0c7825c4e9f9fd4,1,2,2,4,2,2014-11-04 17:05:47,2014-10-22 08:15:57
458b019e62bd41da08b99d49db9b2ee079fee29a...1ff1befd12027f9de33f715e241a9818ee9a4a41,1,2,0,2,1,2014-09-17 22:36:04,2014-09-17 22:36:04
458b019e62bd41da08b99d49db9b2ee079fee29a...9aa71549d61875fcf0713a9da11b034e70e1c3b0,8,48,41,89,36,2014-09-17 21:38:22,2014-09-04 06:21:51
277aa9c67415b9b76ab17daea583b51f8560a6a5...55cac6c9421702ca1e42b3e3f92266e865a5c769,1,20,0,20,1,2014-09-17 15:24:07,2014-09-17 15:24:07
3ea5a20776ce6024752cc2c5964b08aeb8ce6c7d...3446735a3e30788689ea3d66994f9b27b9327e18,1,35,0,35,1,2014-10-01 13:20:49,2014-10-01 13:20:49
3446735a3e30788689ea3d66994f9b27b9327e18...12fe99ae47a3446ef0c2ac01052c263c28345b65,1,1,0,1,1,2014-10-01 13:32:21,2014-10-01 13:25:48
12fe99ae47a3446ef0c2ac01052c263c28345b65...e08f22cdb2b1e10661f76582f9a8ba7d1cb80bea,2,2,2,4,2,2014-10-02 06:43:30,2014-10-02 06:39:55
3ea5a20776ce6024752cc2c5964b08aeb8ce6c7d...9e2eb0f1cc3c4ef000e139f1d85a20f0e00971e6,3,9,1,10,3,2014-09-23 17:21:25,2014-09-23 11:46:02
3ea5a20776ce6024752cc2c5964b08aeb8ce6c7d...81c9927f8f3c190ed9dd15b62716a240ce20fc51,1,33,0,33,1,2014-09-23 14:24:18,2014-09-23 13:55:14
81c9927f8f3c190ed9dd15b62716a240ce20fc51...2add198a7abc084dd394f61ed26057ec5d639a4c,1,28,0,28,2,2014-09-23 15:19:25,2014-09-23 14:19:06
3ea5a20776ce6024752cc2c5964b08aeb8ce6c7d...3824ec62e81d78db4dd36ffd64b17ef4c620b47f,3,11,70,81,4,2014-09-23 11:15:09,2014-09-22 14:18:19
3824ec62e81d78db4dd36ffd64b17ef4c620b47f...682fbe0134180488c1a7f2b755b6bb9ae09e9448,2,16,30,46,4,2014-09-23 11:15:09,2014-09-22 14:23:20
682fbe0134180488c1a7f2b755b6bb9ae09e9448...5e2ea69606850cf2da1c50ec4bc32c981999aafd,2,18,21,39,4,2014-09-23 11:15:58,2014-09-22 14:51:42
5e2ea69606850cf2da1c50ec4bc32c981999aafd...6bb44b6d7441d1a2b7136063a73c31c946be625f,3,20,19,39,3,2014-09-23 11:15:58,2014-09-22 15:24:14
6bb44b6d7441d1a2b7136063a73c31c946be625f...139b6ed3aa81d5d3c6ceaacc5041afca4d39d75a,3,19,19,38,3,2014-09-23 11:15:58,2014-09-22 15:41:13
139b6ed3aa81d5d3c6ceaacc5041afca4d39d75a...2d802d7f23ad0d9f59abd8144f2bad094e338339,3,18,17,35,3,2014-09-23 11:15:58,2014-09-22 16:47:01
2d802d7f23ad0d9f59abd8144f2bad094e338339...c58391bbd03a6dd71096fb2d7541e10fa9123e27,3,20,19,39,3,2014-09-23 11:15:58,2014-09-22 17:21:39
c58391bbd03a6dd71096fb2d7541e10fa9123e27...570f1153b9b09fc8b23b86a15fd6f37c2f873a67,2,13,10,23,4,2014-09-23 14:58:28,2014-09-22 17:26:51
570f1153b9b09fc8b23b86a15fd6f37c2f873a67...0c899cefdd2f1826d16bd979651003a9502888e9,2,17,35,52,5,2014-09-23 14:58:32,2014-09-22 17:36:43
3ea5a20776ce6024752cc2c5964b08aeb8ce6c7d...1e93639aed80588e70e65a850b7c7843d381d3dd,1,1,1,2,1,2014-09-23 06:10:05,2014-09-23 06:10:05
1e93639aed80588e70e65a850b7c7843d381d3dd...d1613e1d59d0a1e29feafe0537d12675dee24f39,1,16,0,16,1,2014-09-23 06:18:46,2014-09-23 06:18:46
3ea5a20776ce6024752cc2c5964b08aeb8ce6c7d...46319a5c33c324b26bc4c8ad647632744ef88cbc,1,1,1,2,1,2014-09-23 05:04:00,2014-09-23 05:04:00
3ea5a20776ce6024752cc2c5964b08aeb8ce6c7d...ec000cbf30426e745e31a406ecc1c7b1854b1220,1,1,0,1,1,2014-09-23 00:42:32,2014-09-23 00:42:32
db5edfb748e8840784ed01b728ecc7083f0889d4...7e9ba22dc358196ac0d13524aa05677327f19ff9,1,10,2,12,1,2014-09-22 20:40:20,2014-09-22 20:40:20
7e9ba22dc358196ac0d13524aa05677327f19ff9...636e8561a86ffba909790e9188ffe282770570f0,1,6,0,6,2,2014-09-22 21:03:31,2014-09-22 21:03:31
db5edfb748e8840784ed01b728ecc7083f0889d4...4e11902d05816ba76e15f4af91dd4c507946072e,3,3,3,6,3,2014-09-19 00:12:33,2014-09-18 14:55:38
db5edfb748e8840784ed01b728ecc7083f0889d4...003afaf1ce9f9d2983c84093fb00f4b68a99b0fa,1,5,1,6,1,2014-09-18 21:40:53,2014-09-18 21:38:22
003afaf1ce9f9d2983c84093fb00f4b68a99b0fa...42dafe4bd84842532361a2d704493d124f438ab1,2,139,75,214,2,2014-09-18 21:54:42,2014-09-18 21:36:34
db5edfb748e8840784ed01b728ecc7083f0889d4...4e9925d780665149b8bc940d5ba242ada1973c4e,2,117,29,146,28,2014-09-18 14:34:58,2014-05-15 20:50:58
adc9a14db49f7e8ffd7cecb788bb9b560a7a3aae...e44bdd612b93e806a1cfcba8c156860de5ef3791,1,3,0,3,1,2014-09-05 17:48:51,2014-09-05 17:48:51
affef9e785febbf9ecd832022113b21b5b7e10a3...defe01daf87237e42a9275a0b286b0f71c60de25,1,5,3,8,4,2014-09-04 00:14:19,2014-09-03 22:56:58
defe01daf87237e42a9275a0b286b0f71c60de25...39310448da1ed05d39f4400a56dd43e71591ae5b,1,8,3,11,3,2014-09-04 00:14:19,2014-09-04 00:12:36
dbe112360718b6ddf6e74c8fcb6cf63204f2bbf2...f17410da5e4b5fa0e0dd2614f9b6e00dbcf66da6,1,9,9,18,6,2014-09-04 15:43:28,2014-09-04 15:43:28
23f490427f80f6b48f19767cbebb10ddff6997f3...a8914293fbb1328f9a5c931bd51e34f5d6584e17,1,16,20,36,7,2014-09-16 16:17:34,2014-09-14 15:13:40
23f490427f80f6b48f19767cbebb10ddff6997f3...c4db3b8075ab4b8bd0c6599cb19e09eb77c82946,1,1,1,2,1,2014-09-15 00:58:45,2014-09-08 17:18:13
23f490427f80f6b48f19767cbebb10ddff6997f3...81357e12e7a019c14d87dc491705ad92409293b7,1,1,1,2,1,2014-09-13 20:26:40,2014-09-13 20:26:40
23f490427f80f6b48f19767cbebb10ddff6997f3...09b700288e4804162ef86c99466e08b6b016e0c4,4,119,20,139,16,2014-09-13 18:27:34,2014-09-13 16:42:10
06d0853682314c973eb976e011795b0a880cc540...623ebf203bc4f4e6ddefdd494f201a1401ab72a6,4,20,7,27,8,2014-09-22 18:48:26,2014-09-10 07:34:38
623ebf203bc4f4e6ddefdd494f201a1401ab72a6...652cd6a842377ec55b53333c7ddc0fc50b587a99,2,102,0,102,2,2014-09-22 18:49:21,2014-09-10 16:43:16
32b5d145faac9013f9f78adfe3bb2a171d818863...a5ca549a18fb5c1006005cc220ab330eec3018de,7,47,13,60,12,2014-09-25 16:44:19,2014-09-11 13:27:51
32b5d145faac9013f9f78adfe3bb2a171d818863...3ec564bfda57f068aac813f4b985385c1c7e4f23,2,33,12,45,12,2014-09-12 13:51:21,2014-09-12 13:51:21
32b5d145faac9013f9f78adfe3bb2a171d818863...78fe117076289695ab03c90d266c47438ab8db7a,1,4,4,8,1,2014-09-12 10:04:40,2014-09-12 10:04:40
32b5d145faac9013f9f78adfe3bb2a171d818863...555ce0cb54943dab39f16582fc1923467e42af14,1,1,1,2,1,2014-09-12 07:42:12,2014-09-12 07:42:12
555ce0cb54943dab39f16582fc1923467e42af14...82bdd88e9c9db40ee8072f7c4c2832dfb3f73823,1,6,2,8,3,2014-09-12 07:44:51,2014-09-12 07:44:25
82bdd88e9c9db40ee8072f7c4c2832dfb3f73823...41cbce8c005c201169e13902d62112ced9902928,1,37,0,37,2,2014-09-12 07:45:50,2014-09-12 07:45:50
32b5d145faac9013f9f78adfe3bb2a171d818863...3109fc9537682a7b9ee566f3674484b1b2296707,1,19,0,19,2,2014-09-12 05:51:14,2014-09-06 01:59:31
3109fc9537682a7b9ee566f3674484b1b2296707...3b6a29b81a5280187b3d03c91950cf93f7e263ec,2,65,11,76,12,2014-09-12 05:51:14,2014-09-07 19:33:51
3b6a29b81a5280187b3d03c91950cf93f7e263ec...41e9e93e27ccd637d9490412622529bdc7d7b8ff,3,31,36,67,22,2014-09-12 06:05:07,2014-09-08 10:22:50
32b5d145faac9013f9f78adfe3bb2a171d818863...0517099a91a3ca073efb2131684bbf3ab565644a,2,35,8,43,10,2014-09-12 03:34:01,2014-09-12 03:30:20
32b5d145faac9013f9f78adfe3bb2a171d818863...df8dbfa45dee108c6bb002f49a5f36e7d911616d,3,7,3,10,4,2014-09-12 01:10:07,2014-09-11 05:54:03
63a15486882e1dad12e427737fd150194be6c511...8c2b170c6ef3f8ec40c3a1bd6fdfc37f9271852a,1,5,2,7,1,2014-09-17 00:20:47,2014-09-13 23:02:02
27226d47c17588c867f2c533b87977955f2ca66e...c2dc4245f1fb9462d0f22e0bc2aceb02903211ab,2,39,0,39,3,2014-09-22 07:52:23,2014-09-19 12:31:57
27226d47c17588c867f2c533b87977955f2ca66e...fd3f2e175fa6ddb606d2c681ff86a97faccfebbd,1,1,1,2,1,2014-09-22 06:54:58,2014-09-22 06:54:58
fd3f2e175fa6ddb606d2c681ff86a97faccfebbd...a7ee201ee85c95afb8556323d79e32cf9e2d8737,2,5,1,6,3,2014-09-22 06:55:46,2014-09-22 06:55:46
27226d47c17588c867f2c533b87977955f2ca66e...7faa43d707e1c0a67262d149cd42dab4bf3f8812,2,6,0,6,2,2014-09-22 03:33:38,2014-09-22 03:32:34
11446d30f798c3568343b306cc74644d09a66e60...8a9e827216eb5db4fcbe67c3c638f9e85f4de9bf,2,1,3,4,4,2014-09-20 00:30:37,2014-09-20 00:30:37
11446d30f798c3568343b306cc74644d09a66e60...d64d55eca85232af721859a8cc6f20ff473ce94c,2,30,0,30,2,2014-09-19 23:06:49,2014-09-19 20:54:32
e7a9662974ad12e1926599e64dca44aaf1a90145...c5805c8772b2439ce9d8c7022bd8c8208648bc5b,1,30,30,60,2,2014-09-21 01:10:11,2014-09-21 00:59:52
7e461915a610174bbbdd20aab30f6ed30c2909b5...cd329d062bddaffcfea3ac0cd3245c0be5bf5542,2,40,1,41,3,2014-09-23 21:16:00,2014-09-23 19:08:42
31d2701377c6667ad099226fe25004345017fb5d...7de977368cf5d8290c76b7127246996e90932e13,1,4,0,4,1,2014-08-29 01:08:56,2014-08-29 01:08:38
31d2701377c6667ad099226fe25004345017fb5d...e64131d1bf7c79358d5ee7a1a98626730db3593b,6,147,51,198,25,2014-08-29 00:22:33,2014-05-01 04:26:24
e64131d1bf7c79358d5ee7a1a98626730db3593b...79501dcd4f7a207067c234766ae4788007a1d91b,1,24,0,24,1,2014-08-29 01:33:13,2014-08-29 01:33:13
ca63cceae5bb8420c2af866e1fa83e84e7770eeb...72652c597385980c1bf6adebe4cded760dbf2663,1,6,24,30,7,2014-09-01 23:54:32,2014-09-01 23:28:02
7ff488e74183dd4a5b255bdfdd3bfd166ed427ba...cf31787cd0559012c1ee581eaf27143af1cc6ce3,14,260,86,346,49,2014-09-01 22:18:25,2014-09-01 22:17:33
cf31787cd0559012c1ee581eaf27143af1cc6ce3...688741df31396ece5f72cbc5ecc0250b3d06a8bc,1,1,1,2,1,2014-09-01 22:18:30,2014-09-01 22:18:30
c478143ec0ca8f610f7980991b9b2ba0e1160b3e...5cd9b7513f05948ddc1068041f6c6d822875921e,1,147,0,147,1,2014-11-11 13:48:11,2014-11-11 13:48:11
c478143ec0ca8f610f7980991b9b2ba0e1160b3e...224999d9c21dc6d1d9aa43fb364ded09726e1d56,2,2,3,5,2,2014-11-04 23:53:34,2014-11-04 23:53:34
224999d9c21dc6d1d9aa43fb364ded09726e1d56...cbb88741e40315c5e92f2be92faedc178cf32d1c,1,0,4,4,1,2014-11-05 13:36:08,2014-11-05 13:36:08
c478143ec0ca8f610f7980991b9b2ba0e1160b3e...e621f99923ae8ab74a44d1fa2416e28a6dbc6eb0,1,1,1,2,1,2014-11-04 22:47:13,2014-11-04 22:47:13
b63a254522319b9f49cb45f15689968405cf9045...a7aa2c8ad26149e9be753bc08964f35cb09d313c,3,100,54,154,19,2014-11-05 05:38:52,2014-10-30 20:47:31
b63a254522319b9f49cb45f15689968405cf9045...930a756ad55ad5f4e5e6391b41673743d7254c2b,5,21,19,40,6,2014-10-30 21:04:56,2014-10-30 21:04:56
b63a254522319b9f49cb45f15689968405cf9045...5e02468e76d61060f83a4d755b43f834981188f1,1,10,7,17,5,2014-10-30 20:50:33,2014-10-30 17:42:57
b63a254522319b9f49cb45f15689968405cf9045...8a81c462722c7158e481f974f628843e7c172158,2,16,16,32,2,2014-10-30 18:55:08,2014-10-30 18:52:13
8a81c462722c7158e481f974f628843e7c172158...417e48e4a00c891e8fe5614ac6a1ef12de951f72,2,17,11,28,6,2014-10-30 19:11:33,2014-10-30 19:10:38
417e48e4a00c891e8fe5614ac6a1ef12de951f72...c2cf97a0747976c2307e991028dc703b2b430d80,2,67,3,70,9,2014-10-30 20:24:57,2014-10-30 19:33:26
b63a254522319b9f49cb45f15689968405cf9045...36ffbd7acf60d15942c0591bb4fec498f021331e,4,16,15,31,13,2014-10-30 13:04:35,2014-10-29 09:17:02
36ffbd7acf60d15942c0591bb4fec498f021331e...eaa050fdb8fed612b3cd5d204fddaedf27a20370,2,2,2,4,2,2014-10-31 01:57:54,2014-10-31 01:57:54
b63a254522319b9f49cb45f15689968405cf9045...acd64278f13ef0ee565f4819951393b9c3fe89eb,10,8,7,15,8,2014-10-30 12:48:30,2014-10-30 12:48:30
f68b8b33e6827c54d86abdd7ef36356453d3703b...d8b17d785a03246cb3a081223a0242469af7d410,4,4,4,8,4,2014-10-31 01:36:07,2014-10-30 01:38:44
b98c352e4f7ada1a381746c8fff4feed959881d9...abfb7138871993c53050a2d159ca0fae07bf65e8,4,139,2,141,4,2014-12-27 00:28:03,2014-10-06 10:15:09
abfb7138871993c53050a2d159ca0fae07bf65e8...cf455017e059e4b52d8d0357070e24ee153e3069,3,99,14,113,17,2015-01-13 19:34:15,2014-12-27 00:30:34
b98c352e4f7ada1a381746c8fff4feed959881d9...ed21031353ee188e2837a3030b3fbda88e1ce614,1,276,71,347,2,2014-12-26 23:44:47,2014-12-26 23:39:59
ed21031353ee188e2837a3030b3fbda88e1ce614...587286bbaafa604078b4d72643c6a855a33e5aa1,1,6,0,6,6,2014-12-26 23:53:40,2014-12-26 23:53:40
b98c352e4f7ada1a381746c8fff4feed959881d9...8803174e4f8a3f0a2e5d0d077e8bed0607f3cbe3,1,3,0,3,1,2014-12-26 21:59:25,2014-12-26 21:59:25
b98c352e4f7ada1a381746c8fff4feed959881d9...d30d12c1027e8f2bdb6cac01f8e7cc25d82b0d6a,1,5,0,5,1,2014-12-26 21:51:53,2014-12-26 21:50:18
b98c352e4f7ada1a381746c8fff4feed959881d9...f91650376a8e8af883790aa777e6ec9185aff461,2,83,18,101,4,2014-12-25 20:06:59,2014-12-25 17:40:31
273472a5c21075fa6fd223e30ddd6451fa180044...81f84023bef5e94dfbcfbb44443bc03707b355c4,2,15,14,29,10,2015-01-09 00:23:54,2015-01-08 22:51:47
273472a5c21075fa6fd223e30ddd6451fa180044...2639e073b19f526ceecbede9439aed0aba0a4ad8,2,9,1,10,2,2015-01-08 23:37:07,2015-01-08 23:14:04
273472a5c21075fa6fd223e30ddd6451fa180044...813ff7f19d6a097f39dae363d8dd81b70eee515a,19,448,65,513,78,2015-01-08 23:13:09,2015-01-08 23:03:19
b2ab733c993ee6124c164defceac6996206d69fa...21e44d7a21014f6f0d5e159221f9b9165874a2e1,6,87,158,245,35,2015-01-05 23:56:48,2014-12-04 21:12:29
21e44d7a21014f6f0d5e159221f9b9165874a2e1...e6c9343457c501c1da718c25bb9601f87d82cd7d,1,46,46,92,18,2015-01-06 02:01:13,2015-01-06 01:30:38
b2ab733c993ee6124c164defceac6996206d69fa...04ee071692c320ac9dd8e66475c02c6ec3166251,1,1,0,1,1,2015-01-05 18:28:36,2015-01-05 18:28:36
b2ab733c993ee6124c164defceac6996206d69fa...e583cc1eb47c29d7473f1dac7d4f39ddeb8ae1e6,1,143,144,287,47,2015-01-03 17:20:59,2015-01-03 17:15:40
e583cc1eb47c29d7473f1dac7d4f39ddeb8ae1e6...975f5b0c281fe579336fc0ffeb49ac0907465a5a,17,915,926,1841,351,2015-01-05 10:45:10,2015-01-05 10:45:10
b2ab733c993ee6124c164defceac6996206d69fa...e3d813f37f48ed52330e3dc26aa363e58401fbf5,1,4,0,4,2,2015-01-03 11:38:25,2014-11-14 11:34:59
e3d813f37f48ed52330e3dc26aa363e58401fbf5...fc7f0550965d06dd8dd31fb55c74fe02e9a436dc,1,1,1,2,1,2015-01-03 11:40:25,2014-12-23 18:48:12
b2ab733c993ee6124c164defceac6996206d69fa...0c21905a3d7cdae98ebad3155e4a1b3fe98f29a7,1,37,0,37,1,2015-01-03 06:42:45,2015-01-03 06:42:45
b2ab733c993ee6124c164defceac6996206d69fa...1edf16e977a3dd18f9ff15b4acf40b0c1ac64788,4,8,28,36,9,2015-01-03 05:36:58,2015-01-03 05:36:58
1edf16e977a3dd18f9ff15b4acf40b0c1ac64788...f6cb1ea85a7a75193644b8ba4516cb586c5dc52f,1,2,9,11,3,2015-01-03 05:38:52,2015-01-03 05:38:52
f6cb1ea85a7a75193644b8ba4516cb586c5dc52f...05c2d2db9a95266217a639e2109be6fc6482a716,5,88,28,116,13,2015-01-05 21:31:05,2015-01-03 05:40:43
b2ab733c993ee6124c164defceac6996206d69fa...2338a9cf5a1ba5576b92e49065335a9c9251ade0,12,333,33,366,29,2015-01-02 23:21:26,2014-11-03 18:15:55
b2ab733c993ee6124c164defceac6996206d69fa...686585f33a80f7dfaa45400b700235d0615b7fce,1,3,1,4,2,2015-01-02 21:01:28,2014-12-29 18:39:09
686585f33a80f7dfaa45400b700235d0615b7fce...1aac999f707773e4530c1d126ce51ec19cf9d243,1,18,7,25,4,2015-01-03 00:21:51,2015-01-03 00:21:51
1aac999f707773e4530c1d126ce51ec19cf9d243...92ef40a8260e5e8dcd5579a6f9d942c4e68702ed,2,4,0,4,2,2015-01-15 02:03:09,2015-01-15 02:03:09
92ef40a8260e5e8dcd5579a6f9d942c4e68702ed...c252d5f3f4fc98062fbda6335a04cca2602a4223,1,2,1,3,1,2015-01-15 16:39:16,2015-01-15 16:39:16
b2ab733c993ee6124c164defceac6996206d69fa...4669d98bff6cde7a54cff702c7adbb723aab0687,1,4,4,8,2,2015-01-02 19:18:26,2015-01-02 19:18:26
1510a324dbd51f3e65ac6ad8ed1bc2e625f2c827...6d801a3caa54ad7ef574bc426aa1ffc412c5af82,16,271,84,355,39,2015-01-06 18:57:48,2014-10-23 21:30:11
1510a324dbd51f3e65ac6ad8ed1bc2e625f2c827...32ac770f753a6435cd83f957c1e5d73722d09974,1,1,1,2,1,2015-01-06 17:52:21,2015-01-06 11:34:14
1510a324dbd51f3e65ac6ad8ed1bc2e625f2c827...a2b529ead21e6ab9eafcb1b1d2437c725c43a06a,41,390,89,479,180,2015-01-06 12:40:14,2014-10-15 21:14:12
a2b529ead21e6ab9eafcb1b1d2437c725c43a06a...4dc962d09a05b5422c692f4762a32c24cb506e6b,1,0,11,11,1,2015-01-06 12:40:14,2014-09-04 20:49:01
4dc962d09a05b5422c692f4762a32c24cb506e6b...41be2f73c7ce2cbb5450ee8bb35bf7235125ca63,5,184,345,529,126,2015-01-06 12:41:16,2014-11-05 16:57:51
41be2f73c7ce2cbb5450ee8bb35bf7235125ca63...1d09fc22ca14b0b83bdc81cba06d3d7ac886a3e6,3,13,5,18,5,2015-01-06 12:44:27,2014-11-13 14:39:51
1d09fc22ca14b0b83bdc81cba06d3d7ac886a3e6...08f0f1ee1db2dea79e622764891cb8b1432bcab1,2,2,3,5,3,2015-01-06 12:44:27,2014-11-19 08:42:10
08f0f1ee1db2dea79e622764891cb8b1432bcab1...8a785792cd3c3fb4494bced475263aef5fa4534b,3,85,142,227,75,2015-01-06 12:46:38,2014-11-24 16:34:13
8a785792cd3c3fb4494bced475263aef5fa4534b...1db927113f3e7af83fac548c0e2da05bccbd8d56,1,3,3,6,2,2015-01-06 15:48:10,2015-01-06 15:44:36
2f588c69f271f69ac5da48903a5342a23313d7af...eeefa2dc8c45a9be4cfb3a52029e6b46570e5ebe,2,32,4,36,4,2015-01-07 01:58:30,2015-01-07 01:58:30
03142fd5d24bc5509b06742665b2f89ebdbefb87...97f07bb61ccf6e5a3a0fcc72894d5f37310d0109,1,2,2,4,2,2014-12-15 23:15:07,2014-12-15 22:30:52
62cb97278d1ff35a13a09cc845c64d6a417f5874...b61ad60675999439bc2d937afbb0c3c82f6f7b06,1,25,8,33,6,2014-10-17 01:06:32,2014-10-15 19:21:18
b61ad60675999439bc2d937afbb0c3c82f6f7b06...d79defb7478973a0b554bc775efb1bf716fbcb1f,1,4,4,8,4,2014-10-17 01:16:52,2014-10-15 19:21:18
d3707a94114288344bede715989e5221ff6e0a8f...be5bfbe2217905ba129588fe17264b96c866e26d,3,51,8,59,5,2014-11-28 17:44:47,2014-11-27 07:00:13
e2a4b730ca6cc339122d013f33fedd593d95d1f3...b91d330088958bca4e59285a55fdc5593d2a86ad,1,7,0,7,1,2014-12-04 01:49:06,2014-12-04 01:49:06
df7c22dd2307cb530b300a84ae9ddcc951dc3e47...feca1b1780a0942aafc1796d1fd52026a673bf92,5,93,55,148,5,2014-11-24 23:10:37,2014-11-24 23:10:37
feca1b1780a0942aafc1796d1fd52026a673bf92...5794b5373ef26846b3cc5e48e651208771d12b19,3,10,7,17,9,2014-11-24 23:47:42,2014-11-24 23:47:42
e6ec703df31f04c3ea3a6aeb19881494a6ae58ae...4dd3368b51b2b00936f91fcc951d81d0c0d918ae,1,29,0,29,1,2014-11-25 01:02:27,2014-11-24 16:33:38
5d49d2bb7a3bafcd1481a05d56ebc39ecd394393...826f809d0959d59d4f478615be4dc9b7db7c46f1,1,2,1,3,1,2014-12-03 22:13:48,2014-12-03 22:13:48
826f809d0959d59d4f478615be4dc9b7db7c46f1...0888c1880f836703987313049100bad9ce821584,1,2,1,3,1,2014-12-03 22:14:08,2014-12-03 22:14:08
595cd5279e90f1225eb015708b3db5e2e8766c0f...fdf745768350d2068aecd34734b38a2c27810132,6,118,128,246,22,2014-12-05 23:08:22,2014-11-28 19:25:14
595cd5279e90f1225eb015708b3db5e2e8766c0f...4bf72613fed9424356e2146d795ddbfa825befa4,1,2,2,4,2,2014-12-01 04:12:57,2014-12-01 04:12:57
53d5299a40ad149be420bb87e5c97c616c1df821...cd9ad8d584374224cd253f48703954d48cf06401,1,16,0,16,1,2014-12-19 22:19:35,2014-12-08 16:01:42
53d5299a40ad149be420bb87e5c97c616c1df821...e0792e7ece7a71da83c902a03654bda4797ab054,1,4,4,8,4,2014-12-08 02:45:43,2014-12-08 02:40:12
e0792e7ece7a71da83c902a03654bda4797ab054...2d51d71561565987fc6a600234f2e2d15e0ecf31,1,6,2,8,3,2014-12-08 02:45:50,2014-12-08 02:44:07
53d5299a40ad149be420bb87e5c97c616c1df821...1ae7be716eadf6efdc7ee033c83127e975222a76,1,1,1,2,1,2014-12-08 02:35:37,2014-12-08 02:35:37
53d5299a40ad149be420bb87e5c97c616c1df821...ee1ba252187a7e1a80e3773fe9748410d01a39b8,1,4,4,8,4,2014-12-07 21:31:35,2014-12-07 20:43:20
53d5299a40ad149be420bb87e5c97c616c1df821...4f6cdb12ab64cf76f5a57cb1d24081882c61def3,1,128,77,205,46,2014-12-07 12:40:29,2014-12-07 12:40:29
906c7211e6965a29b538e93af3ade981000dff98...bcef3535579b2e9a8f672626dd014b77ed44c5c0,2,17,8,25,7,2014-12-02 21:49:17,2014-12-02 21:42:04
1dadc51adc9f8d20c4e1d20c120dfe253b61b99c...bd4fe9b9867c7633e520130b99e02798f49e6b44,1,43,47,90,11,2014-11-25 23:55:40,2014-11-07 18:44:35
b905f88ee55d562cf3b8a780fc03f51eddf391c8...0d70ad1c7205ba9e82dd1f244d26df93dc79de9e,1,1,1,2,1,2014-12-11 04:55:51,2014-12-11 04:55:51
b905f88ee55d562cf3b8a780fc03f51eddf391c8...b3ade99a7822f4edb21400a1003ff0e3893caa38,1,1,1,2,1,2014-12-10 19:59:32,2014-12-10 19:59:18
aca253d6d0b84c74a32c624d7c39e3a5fcae7773...bfe21f095d491dc9ee7e664b260239cbed8f505f,1,1,1,2,1,2014-10-31 01:10:17,2014-10-31 01:10:17
25c32d3167b13e52001d63690dcca23a70097372...9a03652d9614e9d0a816bab2d2c672236d2d3d23,1,49,39,88,4,2014-10-27 16:35:27,2014-10-22 22:14:02
25c32d3167b13e52001d63690dcca23a70097372...93e17b2ecadc4a409fc55b1460bc2721a4345716,1,1,1,2,1,2014-10-22 22:51:14,2014-10-22 22:51:14
25c32d3167b13e52001d63690dcca23a70097372...e0c9d7b654221a0d4e5a310b0f9a0adb9ef69aa0,4,128,0,128,4,2014-10-22 21:05:45,2014-10-14 03:41:22
25c32d3167b13e52001d63690dcca23a70097372...5572dbb7504c951f4ddd2710a4037844a95caa6a,3,49,23,72,17,2014-10-22 20:34:42,2014-10-03 17:38:44
25c32d3167b13e52001d63690dcca23a70097372...64cb7725381740986022eb4633c8f91be3dd7b4f,2,2,2,4,2,2014-10-22 14:57:39,2014-10-22 14:48:37
a07ee0db627f592661fa905e35cb58e1593c1be8...373fd1ce16f5699afc55d595ec6a4e684b7483bc,1,1,1,2,1,2014-10-21 23:47:43,2014-10-21 23:42:21
a07ee0db627f592661fa905e35cb58e1593c1be8...ba5370c116e3879c88736d3456586ec5703f581b,1,14,14,28,8,2014-10-21 22:51:09,2014-10-21 22:48:32
8b97e2c28732c5bf24e1e41bfa2033554e352821...fc75ade4f81229d5f6c36150b1c99c0edb7a8e8f,2,4,1,5,2,2014-09-17 18:46:49,2014-09-17 18:37:47
c7c78acf815c081ca56616a8b4c145217329f5e3...db9f8ba55cf2293f590ea5d129463ffc9a4eb23d,8,197,0,197,25,2014-09-18 00:40:55,2014-09-16 06:43:08
75ecfdd63cf4d45c87011e0bc300f2638c3866e2...7aa88a4ff66aa0c256dc15e5e5a4ddda34ed0f46,1,1,1,2,1,2014-09-24 17:30:39,2014-09-24 17:30:39
e909bbccc3bcd37d48509e9e2fb4fa61a93a833b...77975722492adcd791e1210a12e5f58fa81c29e8,1,1,1,2,1,2014-09-19 00:20:12,2014-09-19 00:20:12
bc26aa7b50a5e9b01b274cffb89e3e0249d279f1...98f57d1c392eab7df30fa3179c8e0f99a418e772,1,7,5,12,4,2014-09-04 18:27:41,2014-09-03 21:44:57
a612d859165d297287164be30bfab4e676f1369c...aa2af817bee123827f4a857555db8fea5e01e7d7,2,18,1,19,2,2014-09-12 17:45:07,2014-09-12 17:45:07
a612d859165d297287164be30bfab4e676f1369c...fe5b72e7bb4f7c043409196cb98d46796f2dc390,15,29,29,58,29,2014-09-12 16:57:43,2014-09-12 14:49:59
4778d7d52d97666b3c7d886861f30a39ecc1bb24...f304d4b190276939c9aff2090925342d16c7405e,2,75,181,256,95,2014-09-23 00:09:49,2014-09-06 00:42:51
f304d4b190276939c9aff2090925342d16c7405e...ab43ad7d5fa8361736446af323c1fce77f150296,19,288,704,992,385,2014-09-23 00:09:49,2014-09-22 00:05:58
4778d7d52d97666b3c7d886861f30a39ecc1bb24...9b755412ab03816f0b7d6013618c65ae68781bcb,2,4,4,8,3,2014-09-22 21:41:14,2014-09-22 20:50:36
827634d355bcbda3e75a05598022edf2262a2585...6c60e8c7849742c111a2b0a5ad4ff88fc8e960ef,6,8,1,9,7,2014-09-29 22:43:07,2014-09-24 00:24:52
827634d355bcbda3e75a05598022edf2262a2585...a471eb4d9388dc44be0a9c81fa2f15061df636c5,2,26,4,30,10,2014-09-24 18:04:28,2014-09-24 01:13:26
d369612b416484301e172bfae3fc692e9c176faf...5cdf7f507771e159ddd335f3757cd33f7ba4e426,2,18,2,20,3,2014-09-25 22:58:35,2014-09-25 22:58:35
d369612b416484301e172bfae3fc692e9c176faf...40c7b53791b598364ffe2290c88875e4fc65be11,1,1,1,2,1,2014-09-25 18:14:25,2014-08-21 08:06:32
40c7b53791b598364ffe2290c88875e4fc65be11...d742c57f534352b6cad596d0c9fe8cf84044e92a,4,50,32,82,20,2014-09-25 18:58:24,2014-09-10 13:35:48
d742c57f534352b6cad596d0c9fe8cf84044e92a...29a62ceefc62836cc918093b60aef6b23a649d76,2,88,0,88,6,2014-09-25 18:58:43,2014-09-25 14:50:10
c751e1739d56e38aa9a813c369d78c6dbdc37b07...f013aa7f96d7fc818f06f5b7fe0bbd20ff2d3294,1,3,1,4,2,2014-09-16 00:30:38,2014-09-15 11:50:22
c751e1739d56e38aa9a813c369d78c6dbdc37b07...0619512582bada62681816e6cb9cdfe01bf2fdec,1,8,2,10,1,2014-09-15 12:15:55,2014-09-15 12:15:55
c751e1739d56e38aa9a813c369d78c6dbdc37b07...90dcc7c8405437a10b81e932b49a856502cee626,53,0,0,0,0,2014-09-15 11:46:29,2014-09-15 11:46:29
c751e1739d56e38aa9a813c369d78c6dbdc37b07...140229677af2cf4865424e535b06440f043e163b,1,1,1,2,1,2014-09-15 11:10:46,2014-09-15 11:10:46
5ad82d3ea641a9cc569fc49853759bb98f043fa9...86a3a9a2822e5473816d5ced945b37fcc2131e1e,1,10,6,16,2,2014-09-23 01:47:20,2014-09-22 14:47:20
5ad82d3ea641a9cc569fc49853759bb98f043fa9...e315493b0c49978a43dacf7c436839d64a401640,1,12,2,14,2,2014-09-22 18:58:09,2014-09-22 18:58:09
5ad82d3ea641a9cc569fc49853759bb98f043fa9...c69896d8a013fca05ffee479e08605552715f901,1,8,9,17,3,2014-09-22 14:53:12,2014-09-22 14:38:55
9c7d97561499b1fd92bef755ea485b6942e65a66...77d29847e2a59a7b3e56144c774c28a3b7370c91,1,1,1,2,1,2014-09-22 16:03:19,2014-09-22 15:38:12
9c7d97561499b1fd92bef755ea485b6942e65a66...473bb5274ce7a520bc73ccb3529f99729a799062,1,8,2,10,4,2014-09-22 15:57:28,2014-09-18 15:04:18
473bb5274ce7a520bc73ccb3529f99729a799062...d2c104c3a01217f1a860d23143672af74a32e93a,1,4,4,8,5,2014-09-22 15:57:28,2014-09-18 13:29:19
81a643211bbd88545d21550defc9cd7e3f8437bd...aa129b356ff9f16409cba25e9f16805923970cad,3,9,3,12,3,2014-09-25 21:25:43,2014-09-25 18:22:24
81a643211bbd88545d21550defc9cd7e3f8437bd...808257654a4147ad9b54cfeddc5d0ad236c26e3f,10,48,48,96,38,2014-09-24 22:53:27,2014-09-23 23:18:09
07040103132d34a92023260ed74092e46190ab81...c0a5ec75c5a8f2d3ccb2f0c1a90f30bb20cdd60b,1,4,2,6,1,2014-09-02 00:09:52,2014-09-02 00:09:52
92c840c87de759411229e3d1ace9f8a41cba83dc...a00a1a1fca020d21cb677439160e018bda5c3835,2,46,15,61,4,2014-12-02 00:26:30,2014-12-02 00:24:43
50ff27caa13b4c558b0ddc9f65297b6ef6eb119d...7bb4b56cf98662ef5f1deb64bdf8a120490bc258,2,7,0,7,3,2015-01-20 00:17:58,2015-01-20 00:16:36
6d780139c4b7960b482a5f4fbf043adb6673864b...eb3ea3b43c716ad727521a7d0bc20d7321bb0867,9,253,32,285,30,2015-01-07 00:33:26,2014-09-11 14:42:17
6d780139c4b7960b482a5f4fbf043adb6673864b...cc3bf34c787f4fdf067a459158f38f8413ec4e33,2,10,2,12,6,2015-01-06 23:35:45,2015-01-06 23:26:04
d7b6f186880e183dcbba1ab15395140d0c43442f...7b2331061e428176cf513487745ac496e2bd7027,5,7,7,14,7,2015-01-06 07:01:10,2015-01-06 07:01:10
d7b6f186880e183dcbba1ab15395140d0c43442f...d1e5078f318f69b24ed47f2bf283903650ced4d9,1,16,0,16,1,2015-01-06 05:37:07,2015-01-05 00:53:39
d7b6f186880e183dcbba1ab15395140d0c43442f...af053ccf6b3179978e087defd0062664152697ef,1,4,2,6,3,2015-01-06 04:25:39,2015-01-06 03:33:53
3ec695924009421f9b1f79368e9e5b1e3e2ca94f...5f699a465dd428d6285080ca07cb4a6634952744,1,1,1,2,1,2015-01-12 20:48:44,2015-01-12 20:48:44
3fbf723e81fa2696daa95847ccdcacddba6484da...c754555b8742df282bd46ef056837934e973be98,1,1,1,2,1,2015-01-09 00:44:04,2015-01-09 00:22:38
7eb5262d1b0c7f9c46239f07cf664f8596ab860c...e3c5e0ceb0e83c393472ed2e2f12ca754d47e6b3,1,1,1,2,1,2015-01-05 00:59:34,2015-01-05 00:59:34
7eb5262d1b0c7f9c46239f07cf664f8596ab860c...f957f258d722fa563ead0a14978acca7c6745d3f,1,6,21,27,11,2015-01-04 20:05:54,2015-01-04 19:57:20
f957f258d722fa563ead0a14978acca7c6745d3f...a3d5f874c108d3e7d58a7f86c0ef0eea6fcca85f,1,2,2,4,2,2015-01-04 20:45:06,2015-01-04 20:15:30
a3d5f874c108d3e7d58a7f86c0ef0eea6fcca85f...131c62d7661ace86453de540cb1a58956b59e347,1,3,5,8,4,2015-01-04 20:49:16,2015-01-04 20:49:16
131c62d7661ace86453de540cb1a58956b59e347...26187bd851141236a909c0bada5a2743fc237e0e,1,4,1,5,1,2015-01-05 00:24:33,2015-01-05 00:24:33
7eb5262d1b0c7f9c46239f07cf664f8596ab860c...9bbed5ab4ceaff5e78c21f0fa2d84de5ffd41f94,1,1,1,2,1,2015-01-04 00:10:48,2015-01-03 22:07:24
640e0fc578e5acdaa71216a300396dfa9af8054f...d10d0e568e44a4e55293610a5cac84359719baff,1,9,0,9,2,2015-01-15 04:06:13,2015-01-15 04:06:13
d10d0e568e44a4e55293610a5cac84359719baff...457f2123739df7bc896008b6d796353aae7a0429,1,6,5,11,2,2015-01-16 02:32:38,2015-01-16 02:32:38
457f2123739df7bc896008b6d796353aae7a0429...73baa673c72a49e9cccfde6e844c7dee2e478d8e,1,1,1,2,1,2015-01-17 16:21:25,2015-01-17 16:21:25
640e0fc578e5acdaa71216a300396dfa9af8054f...f88066fd43454be005ec303977ee45561f3436e6,1,1,1,2,1,2015-01-15 01:28:50,2015-01-15 01:28:50
25f8c2664066a523f3f59f4cc5cdc8cf81c8a7c8...a1bfe3aa420d458cb84be1770202fe1b3f546ebe,1,1,1,2,1,2015-01-05 23:00:32,2015-01-05 22:15:16
25a8602cbabaec44d5646923b2ae1564a3ba7f8b...f6777c7a40efdae161f6ba99223f4d6a625d4762,1,13,2,15,3,2015-01-16 00:09:48,2015-01-16 00:09:48
91509bfb669dca00dc1fd7ef680fc762a5deff61...e23d07a110fcf615bf36defd76e7be06cd7e80df,2,14,0,14,2,2015-01-07 04:30:03,2015-01-06 04:18:36
b241571102f245a8d526620598930fc53c126070...8d9e25dbddc189f4094e0f25a90f2b8a25deec9d,1,4,4,8,5,2014-12-02 23:28:13,2014-12-02 23:23:49
e15ffa45a670041ceee06c3b51dff177b5f3378f...6d560e197ccde8f1d711ad8260cf399b078c404d,2,8,29,37,6,2014-12-04 06:10:55,2014-12-04 06:05:45
e15ffa45a670041ceee06c3b51dff177b5f3378f...7c7026bd2255cef47cbb026afe0b984d4c9a9130,1,1,1,2,1,2014-12-04 01:36:14,2014-12-04 01:36:14
7c7026bd2255cef47cbb026afe0b984d4c9a9130...7ba9a18ade7393d942d995d34a92d757ef4af0b7,2,1,8,9,2,2014-12-04 01:43:26,2014-12-04 01:42:25
7ba9a18ade7393d942d995d34a92d757ef4af0b7...02a021119fb2b3e051b98817831a8c1a8a9fd464,2,4,8,12,5,2014-12-04 01:47:28,2014-12-04 01:47:28
02a021119fb2b3e051b98817831a8c1a8a9fd464...fa753e67ae2bf573c9dfb1da1e1135c5ef5ef415,3,5,7,12,6,2014-12-04 01:52:06,2014-12-04 01:52:06
fa753e67ae2bf573c9dfb1da1e1135c5ef5ef415...4ee3a318a1f43f35a8c6ec8b6b73db5ea8824de9,1,1,1,2,1,2014-12-04 02:45:51,2014-12-04 02:45:51
4ee3a318a1f43f35a8c6ec8b6b73db5ea8824de9...6fd818f3ef8ca018b74544362c37d41a1095ba9d,1,1,1,2,1,2014-12-04 03:02:51,2014-12-04 03:02:51
c8ccfcb93048e24dbe08b2c449dd1ad802f730f4...654da4e151c449725b6996d47b7ff33767e87da9,3,5,0,5,3,2014-12-05 20:13:25,2014-12-03 23:29:54
c8ccfcb93048e24dbe08b2c449dd1ad802f730f4...269b37503e00f86b9215bc6fe27c502cf4d90072,14,494,17,511,26,2014-12-03 22:53:11,2014-12-03 22:53:11
653be15f176fc64a442bc68e67dda89d4b14008c...e98e56bb1edc3835bc835c9e034780845c64d797,1,98,7,105,5,2014-12-02 02:13:52,2014-12-02 01:57:53
653be15f176fc64a442bc68e67dda89d4b14008c...c8a3d31332074ddc226086ff1f0c042b6e120232,7,57,16,73,17,2014-12-01 22:54:15,2014-12-01 17:16:49
653be15f176fc64a442bc68e67dda89d4b14008c...9200fdd197f7c80c495597104928596516b36f41,1,4,6,10,2,2014-12-01 16:44:13,2014-12-01 16:44:13
653be15f176fc64a442bc68e67dda89d4b14008c...7754ef1f064be08419bf397e2ea7e4ce99bdf90d,1,1,1,2,1,2014-12-01 14:05:58,2014-12-01 14:05:58
653be15f176fc64a442bc68e67dda89d4b14008c...b1dc0db56ac9a27d51ab2a3684ed398d7b80a80c,1,1,1,2,1,2014-12-01 13:58:02,2014-12-01 13:58:02
653be15f176fc64a442bc68e67dda89d4b14008c...ffda2035e5a9e6a723c4c84cd5f88c5f4a9dc2ba,1,1,2,3,1,2014-12-01 13:37:04,2014-12-01 13:37:04
653be15f176fc64a442bc68e67dda89d4b14008c...51172493ab6d2b31760b9fe273c7d4d0917a9bb7,1,1,0,1,1,2014-12-01 08:46:59,2014-12-01 08:45:53
bb24f99d741cd8d6a8b882afc929c15c633c39cb...a25168d28d552c33988c1a0f3d6a54355c246566,1,14,33,47,3,2014-12-10 07:57:38,2014-12-09 19:21:21
bb24f99d741cd8d6a8b882afc929c15c633c39cb...8dcbd6ab636e756736cef5408710ff97fd207370,3,15,5,20,7,2014-12-09 21:52:07,2014-12-09 00:45:42
12252e39a0abc188e1cd1fe9e921eef967308e1c...340ea25ac1c01561399175e4de8cecc2928ccf4b,1,4,1,5,1,2014-12-10 22:29:41,2014-12-08 18:18:17
c587a3faf65c94b50fa1b56ba2af3ae3c547933f...2597bffe9a6538c2db73e2ce380294547b738e2e,1,13,0,13,1,2014-12-09 14:55:56,2014-11-24 21:20:18
1eb5e5d25faac6ef175285fb8606484928309802...20575d20bad60172b9d1f40c9fe357b7c069f466,3,42,21,63,8,2014-11-26 00:46:09,2014-10-24 18:12:54
20575d20bad60172b9d1f40c9fe357b7c069f466...68bc8de111e4faa2a16583cd45b5c0fd253a3bba,2,39,1,40,4,2014-11-26 00:48:36,2014-10-24 21:39:12
5ca4ba9ed0fcf7df0ee40e4212d0415e112080e7...0b3caf1f78c167239d7879d3bfd0d0d95a48a3d7,1,1,2,3,1,2014-12-12 19:28:54,2014-12-10 21:57:02
5343ede602aa032fce5ad0be4566047b7fd964db...ee17b93df9ef2150d0ef25e077f1f87637a54508,1,1,1,2,1,2014-10-23 18:30:39,2014-10-23 18:30:39
5343ede602aa032fce5ad0be4566047b7fd964db...9b430f4ec1083d2e73abe4269a85c8cdd91a5ade,1,8,7,15,7,2014-10-23 17:34:06,2014-10-23 17:34:06
9b430f4ec1083d2e73abe4269a85c8cdd91a5ade...6589044b5b84f82a71a756708b4a77b0bc49db42,1,1,1,2,1,2014-10-23 18:13:11,2014-10-23 18:13:11
5343ede602aa032fce5ad0be4566047b7fd964db...9451cf39eff037eccb04319c1e601d08495cab3c,1,1,6,7,2,2014-10-23 02:49:33,2014-10-21 04:24:01
9451cf39eff037eccb04319c1e601d08495cab3c...2c2edabca5471fa969358cb98619f277d585e76c,2,17,1,18,2,2014-10-23 03:35:12,2014-10-21 05:27:47
5343ede602aa032fce5ad0be4566047b7fd964db...fb6ee865a949905f678aa7c7066c809664a8a4aa,3,52,0,52,5,2014-10-23 02:42:37,2014-09-30 08:30:58
ba14ddf85b08aef63d51355ffe1c0e15ee0103e7...0390d04d8a236c427f553ead4328f6b4947a61ef,1,186,31,217,12,2014-10-23 02:12:08,2014-10-22 02:30:59
1aa67071cb3e6bc8a08f662d913cdb1b1eda1645...8b40d385b58f118cbda9f62da9cc88f91afd1f26,1,1,1,2,1,2014-10-23 17:54:40,2014-10-23 17:54:40
22bd54be4a3ab1976336035e7196b9c3fe6f251b...9f142bf9be0174bf957812d1045a7cf0aa34ad88,2,43,1,44,2,2014-09-29 19:22:18,2014-09-29 17:23:10
22bd54be4a3ab1976336035e7196b9c3fe6f251b...8e70d553f93e624b38bef6bc4aa3dd2e4bed6a81,1,7,0,7,2,2014-09-29 18:59:48,2014-09-29 18:59:48
f7c0ac9a8bc3602b9156a3ac8ae0b9bc0671d78d...021722cf7afade02c382294e4f276ca7edd1ca69,1,1,1,2,1,2014-09-08 18:38:02,2014-09-04 21:03:01
f7c0ac9a8bc3602b9156a3ac8ae0b9bc0671d78d...58e89878374d12c916fa9e2b5436f5e042bc6978,2,176,0,176,2,2014-09-05 01:09:00,2014-09-05 01:09:00
58e89878374d12c916fa9e2b5436f5e042bc6978...eb8d0c1ccffe612f2c017871d5b8b39320256c6f,1,66,64,130,19,2014-09-08 18:43:09,2014-09-08 18:43:09
eb8d0c1ccffe612f2c017871d5b8b39320256c6f...a899b8a63ec83bc5fa70ff8663db5ae3671d56a9,1,6,4,10,5,2014-09-08 19:36:52,2014-09-08 19:36:52
a899b8a63ec83bc5fa70ff8663db5ae3671d56a9...5fea2b5be32165364294e22bc24aee3fa34cf756,1,19,20,39,16,2014-09-08 23:30:39,2014-09-08 23:30:39
5fea2b5be32165364294e22bc24aee3fa34cf756...5b6c4051d58bf535eded3ae557a0996937e96045,1,2,0,2,1,2014-09-09 00:32:29,2014-09-09 00:32:29
857b739e29be658dd08974cd81752257b1d6f386...d7725ececab8f948356342a032be2f6b370560f5,1,20,0,20,1,2014-09-25 19:48:17,2014-09-23 18:23:15
0bb5f987315a51ef39f5fb070bff03c2849d059d...a049ac32d1850e9bc5b16640a859b1709bc4af62,27,4124,0,4124,27,2014-09-26 22:48:12,2014-09-25 00:29:23
a049ac32d1850e9bc5b16640a859b1709bc4af62...ea6a480128316be5494284dbb688b58bd65e6f63,6,96,24,120,36,2014-09-26 22:52:08,2014-09-26 21:24:04
0bb5f987315a51ef39f5fb070bff03c2849d059d...882223c0f8a55c2011277aba08f1487a2930c075,2,40,1,41,4,2014-09-26 18:36:44,2014-09-26 18:28:21
ac758359312783c123b5173ceb84a6e703b73485...97b50e0f292847a8e3f166aa9386f3e51b1c5e95,1,11,27,38,6,2014-09-22 17:32:50,2014-08-13 14:23:11
97b50e0f292847a8e3f166aa9386f3e51b1c5e95...5d1cb9d0051c5263e23f06ccb431481f8e5b3d57,1,30,0,30,1,2014-09-22 17:34:57,2014-08-13 14:30:45
5d1cb9d0051c5263e23f06ccb431481f8e5b3d57...c6965e3e45cc1c46afc885c57e0e6b9a7769722c,3,54,43,97,5,2014-09-22 18:02:51,2014-08-13 16:02:04
ac758359312783c123b5173ceb84a6e703b73485...10ab2089ce189d5bea3f7aaac3b5081471309478,5,17,6,23,9,2014-09-22 17:29:56,2014-09-18 00:53:04
8dd11c7175147d31761b647daac10fb18f0420c2...acd40d50799a117c4e7c318abdbc8c14b9eb1632,3,324,102,426,33,2014-09-26 03:44:51,2014-09-22 13:41:02
8dd11c7175147d31761b647daac10fb18f0420c2...be4454c4f0ba1a1d9fdd2f0ec7e631403ee61f63,1,6,6,12,1,2014-09-24 08:45:56,2014-09-24 08:45:56
8dd11c7175147d31761b647daac10fb18f0420c2...1625cbfc4c02843ff0fbbf43bd46c13698609f2a,2,9,6,15,3,2014-09-24 08:29:27,2014-09-24 08:29:27
1625cbfc4c02843ff0fbbf43bd46c13698609f2a...ab4738b49fa72b5ac1d5cc441f6e5bb4328a04c6,2,33,39,72,6,2014-09-24 08:38:48,2014-09-24 08:38:48
ab4738b49fa72b5ac1d5cc441f6e5bb4328a04c6...52cf331206b9e50ba9b52f950b5a377179cf7aa5,3,16,17,33,12,2014-09-24 09:15:55,2014-09-24 09:15:55
52cf331206b9e50ba9b52f950b5a377179cf7aa5...51a56399f6384decee03a7e1aa56a3f46cb7c63f,11,52,54,106,28,2014-09-24 13:09:14,2014-09-24 12:42:17
51a56399f6384decee03a7e1aa56a3f46cb7c63f...d302d9296125d2c7abf4adf992fd6739a19d5fbd,3,16,9,25,5,2014-09-24 13:09:18,2014-09-24 12:55:52
3fa0ed01425dc6facb85a00338ddf99ed74a86be...9ae9d7db574083ce6233b33e8b0bbefb219d7fe6,2,38,1,39,2,2014-09-26 15:31:02,2014-09-25 02:46:57
5f6b420f9141ae557ad53af8611578e392a46986...e0339d4b88989a31b72be02582eee72433d2f0ec,17,72,72,144,68,2014-09-02 20:01:11,2014-08-31 15:20:35
5f6b420f9141ae557ad53af8611578e392a46986...054b921a2c140f9b8250f6c7e12dec9fba23ce0f,3,215,3,218,7,2014-09-02 17:58:36,2014-07-23 18:12:42
054b921a2c140f9b8250f6c7e12dec9fba23ce0f...a9971a89ccb0bd8688e7a8ab8058dcbb66d61687,1,50,0,50,1,2014-09-02 19:13:21,2014-07-23 18:39:14
5f6b420f9141ae557ad53af8611578e392a46986...18587469789594f7ca26fc942c6d23b971a14dd3,3,48,0,48,5,2014-09-02 14:35:25,2014-09-02 14:35:25
f65b781d2151973c233d7c517635208c2b96dce4...6df0fdf91b426a4c3ec5fb4f53381cde4ee249f2,3,132,60,192,124,2015-01-16 03:56:41,2015-01-15 08:38:24
f65b781d2151973c233d7c517635208c2b96dce4...43d45e601fa13bc43228ae3b76b1b5c5737b0558,1,1,0,1,1,2015-01-08 07:12:31,2015-01-07 11:57:24
f65b781d2151973c233d7c517635208c2b96dce4...66387aee5970a9b100f0d14612d7b7726eaf7b9d,2,4,2,6,2,2015-01-07 18:07:44,2014-12-15 12:28:42
f65b781d2151973c233d7c517635208c2b96dce4...736558b6ae15afb3f5f0d7ba7801fa44bec9f285,1,2,2,4,2,2015-01-07 15:12:02,2015-01-07 15:12:02
f65b781d2151973c233d7c517635208c2b96dce4...d9ec04e18d5e1fede1afcec27a0d2c69d514a123,1,3,1,4,1,2015-01-07 10:01:32,2015-01-07 09:50:30
d9ec04e18d5e1fede1afcec27a0d2c69d514a123...b69580615f82efe1fccecf15fd09a6c5dfbb01f1,1,3,3,6,1,2015-01-08 08:33:08,2015-01-08 08:22:42
f65b781d2151973c233d7c517635208c2b96dce4...cf27b310c4fc8d2c13ba181398a628d03e1e3c58,6,102,6,108,15,2015-01-07 06:19:47,2015-01-07 00:32:23
53253ee1fbd3239d9f2efd5d7f0c40dd4c58ced3...367e66e9721c33a64ab091bd5430ab4a9af12083,1,1,1,2,1,2015-01-05 19:13:37,2015-01-05 19:13:37
53253ee1fbd3239d9f2efd5d7f0c40dd4c58ced3...8d1485bd3f1c1c8c94b8673ba818ed374fe10022,1,4,1,5,2,2015-01-05 19:08:22,2015-01-05 19:02:17
53253ee1fbd3239d9f2efd5d7f0c40dd4c58ced3...6c126d443b3ee3bbb6d0a437a1b5c51cbf9e47f2,2,56,18,74,6,2015-01-05 19:06:16,2014-11-04 23:02:06
53253ee1fbd3239d9f2efd5d7f0c40dd4c58ced3...99a5da5ada7facc79336b3e0cc62f36c5bfa0620,1,23,21,44,16,2015-01-05 19:03:17,2014-12-29 20:42:20
99a5da5ada7facc79336b3e0cc62f36c5bfa0620...5ad41ce01a3489d2a09d86cd8a8bdf847bf70cf9,1,1,1,2,1,2015-01-05 19:03:25,2015-01-02 19:00:27
ae493e721ee2cee68e06f0c2cc935c3e8de9d428...88905793add88c8d5ff93f0e9b1edca5f012da33,2,40,2,42,3,2015-01-15 20:49:30,2015-01-15 19:34:59
ae493e721ee2cee68e06f0c2cc935c3e8de9d428...ed13110e88846694a675696c161ce6456402f3ef,3,3,3,6,3,2015-01-15 20:20:41,2015-01-15 20:19:19
ae493e721ee2cee68e06f0c2cc935c3e8de9d428...2082ff82b581dfbe252338829c1ce7c31797f66c,1,1,4,5,3,2015-01-15 14:40:31,2015-01-08 09:15:55
2082ff82b581dfbe252338829c1ce7c31797f66c...c3ed49dcdb2d835bf4fbdebe3f07318c945282c8,1,69,0,69,1,2015-01-16 09:58:26,2015-01-16 09:58:26
6ce4f82ebe822dbc3cf945abba5f8a09ca48ea9f...d3ac9ea98e872fee808693c736bc5a465d6426e2,4,27,3,30,5,2014-10-26 03:25:25,2014-10-08 04:09:08
6ce4f82ebe822dbc3cf945abba5f8a09ca48ea9f...3e10b93106dea94e5747ab32fe4ac765aa22f9bc,4,23,1,24,6,2014-10-23 21:56:51,2014-10-01 00:37:30
3e10b93106dea94e5747ab32fe4ac765aa22f9bc...85744a35de0e30c2dd6741b833f38ff218c8a3fc,2,12,6,18,3,2014-10-23 21:58:39,2014-10-01 01:56:45
85744a35de0e30c2dd6741b833f38ff218c8a3fc...c7c620dd9fce0e7b437ee185c7a58341f3b8e3aa,5,30,8,38,5,2014-10-23 22:01:19,2014-10-08 02:31:43
6ce4f82ebe822dbc3cf945abba5f8a09ca48ea9f...7cff8db4a381f68d503fe828fb0fb35cf979741c,1,0,9,9,1,2014-10-17 14:49:21,2014-10-17 14:49:21
6ce4f82ebe822dbc3cf945abba5f8a09ca48ea9f...4e8f69bfe06897054611ee3c7fb41e5babce2224,1,1,1,2,1,2014-10-17 02:16:29,2014-10-17 02:16:29
6ce4f82ebe822dbc3cf945abba5f8a09ca48ea9f...210db1234dfb8d279bc1e5e2c8438dc8db2ee27d,1,1,3,4,2,2014-10-17 01:41:23,2014-10-17 01:41:23
bc7ef42716ba8574845b1f172a363930831ab9e0...a61a4a31882335020cfbffc49ffe274847a5c803,4,5,5,10,5,2014-12-03 02:46:16,2014-11-06 14:09:09
a61a4a31882335020cfbffc49ffe274847a5c803...aa00ad47e243b41b863354e6360a5d3a46aa3212,1,60,4,64,5,2014-12-03 02:46:16,2014-11-06 15:58:07
aa00ad47e243b41b863354e6360a5d3a46aa3212...a2aa78f6ec9e0a654f92c57336f8e487477d4040,1,139,7,146,2,2014-12-03 02:46:16,2014-11-10 10:30:30
a2aa78f6ec9e0a654f92c57336f8e487477d4040...a74c12177f02be97730b83ded9521a14ba568bcd,1,37,16,53,16,2014-12-03 02:46:16,2014-11-21 00:36:37
a74c12177f02be97730b83ded9521a14ba568bcd...94d67d5d5b300c346e17503810d521c91db89c14,4,4,4,8,4,2014-12-03 02:46:23,2014-11-21 00:48:27
94d67d5d5b300c346e17503810d521c91db89c14...070a519a9b972ffffda62b82fbc27825d4a6f9b0,4,5,5,10,5,2014-12-03 02:46:23,2014-11-21 22:17:13
603fe406615817678e6f6b67ab6ac5ec094a8988...da667581cffec4048d848454266b8d3cad55c859,1,10,57,67,8,2014-12-04 20:02:29,2014-12-04 12:26:36
603fe406615817678e6f6b67ab6ac5ec094a8988...1bb02117db80e75f406f6c63d8d50680c1569019,3,76,1,77,3,2014-12-04 19:10:44,2014-11-27 16:08:39
603fe406615817678e6f6b67ab6ac5ec094a8988...eb7d646a44d76c4a7f96fa6ef28de9fbbbaf17ca,5,5,5,10,5,2014-12-04 17:35:31,2014-12-04 17:30:16
bfde3f2cd1807cf4472462819645851c58b22e72...5c91bb93a7e35b2d443090cabc7ec0a2ca59b6ee,3,36,1,37,3,2014-12-04 22:06:40,2014-12-04 22:06:40
bfde3f2cd1807cf4472462819645851c58b22e72...f47d6b9b9de8c567e9e42e12243cbcce99a7bfc7,1,2,1,3,2,2014-12-04 20:03:44,2014-12-04 20:03:44
70c4b4ededd5bfe2f67c7a0c687c80bd45fa2fba...48ec176cd51da20e23564941da2d9906a7779d28,2,33,4,37,5,2014-12-03 21:12:24,2014-12-03 20:36:57
70c4b4ededd5bfe2f67c7a0c687c80bd45fa2fba...92fd49f7ca42cf5d97825853034eac685b90fc1d,1,8,2,10,4,2014-12-03 18:44:05,2014-12-03 18:35:20
92fd49f7ca42cf5d97825853034eac685b90fc1d...385917e22c5bd0d577a5a0be0de9e88a0499fe87,1,1,0,1,1,2014-12-04 06:26:06,2014-12-04 06:23:31
70c4b4ededd5bfe2f67c7a0c687c80bd45fa2fba...bb00453e58a86b9787ac4b3e7df3c48d8ddc3f87,1,1,5,6,1,2014-12-03 18:06:43,2014-12-03 18:06:43
bb00453e58a86b9787ac4b3e7df3c48d8ddc3f87...b721d6d8d0313fbb4b80e12318c96fc4004ee96b,1,0,5,5,1,2014-12-03 18:06:43,2014-12-03 18:06:43
b721d6d8d0313fbb4b80e12318c96fc4004ee96b...004d8b9b337f4a6cf68c124e89e02e673c6320fc,1,0,1,1,1,2014-12-03 18:06:43,2014-12-03 18:06:43
004d8b9b337f4a6cf68c124e89e02e673c6320fc...0db6cc85edfccb16ce5308eea767530e1a3f6906,1,19,7,26,3,2014-12-03 18:06:43,2014-12-03 18:06:43
0db6cc85edfccb16ce5308eea767530e1a3f6906...824a87f7efb94e4f307d920c3c3689156d6e633f,1,16,12,28,3,2014-12-03 18:06:43,2014-12-03 18:06:43
824a87f7efb94e4f307d920c3c3689156d6e633f...5be77901cd505aad002b912b5febe2ba6baa23fd,1,0,3,3,1,2014-12-03 18:06:43,2014-12-03 18:06:43
5be77901cd505aad002b912b5febe2ba6baa23fd...7b2b15d3e9f9b7ad898a36bbe5ceb42c9ca58d47,2,108,67,175,24,2014-12-03 18:06:43,2014-12-03 18:06:43
7b2b15d3e9f9b7ad898a36bbe5ceb42c9ca58d47...442247927b8e6c102ce1f94de58c7f93aab3d271,1,38,19,57,9,2014-12-03 18:06:43,2014-12-03 18:06:43
442247927b8e6c102ce1f94de58c7f93aab3d271...ad9118c696c0953ec48eec15ea4b7546296d7c20,1,46,30,76,6,2014-12-03 18:06:43,2014-12-03 18:06:43
ad9118c696c0953ec48eec15ea4b7546296d7c20...6d347aeb6984ebdcb1051212ab3103880ef69ab0,1,3,5,8,2,2014-12-03 18:06:43,2014-12-03 18:06:43
6d347aeb6984ebdcb1051212ab3103880ef69ab0...7b0a1b814b8f13e30df466dd66c3fdc2114eac28,1,1,2,3,2,2014-12-03 18:06:43,2014-12-03 18:06:43
7b0a1b814b8f13e30df466dd66c3fdc2114eac28...f078bcd8e50913fd8b05022ebd047c5a1f2e3d52,1,15,11,26,6,2014-12-03 18:06:43,2014-12-03 18:06:43
f078bcd8e50913fd8b05022ebd047c5a1f2e3d52...359a38b26a164f430c79fe542babb77c6e48dcc3,1,1,1,2,1,2014-12-03 18:06:43,2014-12-03 18:06:43
359a38b26a164f430c79fe542babb77c6e48dcc3...4d39e056aac2fadffcb8560101f3c31a2b7db3ae,1,30,2,32,5,2014-12-03 18:06:43,2014-12-03 18:06:43
4d39e056aac2fadffcb8560101f3c31a2b7db3ae...39dc7829dea87d4be8e6e9b2a598fb354ebf4ba0,1,63,0,63,2,2014-12-03 18:06:43,2014-12-03 18:06:43
39dc7829dea87d4be8e6e9b2a598fb354ebf4ba0...a44c23fe6604d1de59c64bbb9dc234c7c3dbede9,1,9,8,17,7,2014-12-03 18:06:43,2014-12-03 18:06:43
a44c23fe6604d1de59c64bbb9dc234c7c3dbede9...14d0dd855ee1e7cd1a3185c3d5a00e7afccb5c43,1,9,27,36,9,2014-12-03 18:06:43,2014-12-03 18:06:43
14d0dd855ee1e7cd1a3185c3d5a00e7afccb5c43...e28a419e1197bf50bbb378b02f0226c3115edeaa,1,46,8,54,13,2014-12-03 18:06:43,2014-12-03 18:06:43
e28a419e1197bf50bbb378b02f0226c3115edeaa...c115c4aa45ba82f27859b0afba5724d437857879,1,142,7,149,15,2014-12-03 18:06:43,2014-12-03 18:06:43
c115c4aa45ba82f27859b0afba5724d437857879...17b75a21a667a27a9a27565ab282cd615dbdb66e,1,9,0,9,2,2014-12-03 18:06:43,2014-12-03 18:06:43
26872872892268923ea8160ea1151f232270bcf5...243a640d3e593ee11e31ac55a4df8c887c2b09c9,1,41,0,41,1,2014-12-09 22:30:49,2014-12-04 01:27:39
243a640d3e593ee11e31ac55a4df8c887c2b09c9...67e3ddb75ff27b8de0022e330413b4308ec5b010,10,211,86,297,45,2014-12-09 22:30:49,2014-12-06 00:50:56
eba451b6595e72ab7bb23af5ba76ce0038a81d00...3b4de1070fac41c400c22f200438c90823e7769d,1,3,2,5,3,2014-12-11 01:43:21,2014-12-11 01:37:31
3b4de1070fac41c400c22f200438c90823e7769d...9a7a1e5be01b829e64b32a8b0f1d260f0a2a45c3,1,34,30,64,10,2014-12-11 02:11:27,2014-12-11 02:08:40
eba451b6595e72ab7bb23af5ba76ce0038a81d00...1a9b640e0d3e6916bff9cd7dd8ab435a70c6a0e8,2,14,0,14,4,2014-12-11 00:53:43,2014-12-11 00:53:43
58ce0146e16e2e63b7a94d34a48722a9c7400c18...6743be44ca9006cb7ca26cd3d8410877727a6313,2,19,0,19,2,2014-12-08 19:33:18,2014-12-08 19:33:18
77dcab133c784fa04cd61ddd73661624628be0bf...1262b5f605e8f897acb2b9ee261edbab7f1f8947,2,49,7,56,6,2014-10-23 20:19:12,2014-10-05 04:21:59
45c511fd5a2f48d05763f7385c9fb6c2d9686f94...cdd6e97910c50e5766c8bec2121f906e9ee2d119,5,56,9,65,9,2014-10-24 00:23:25,2014-10-24 00:23:25
8b40d385b58f118cbda9f62da9cc88f91afd1f26...78a272ce14a43f81a79f1b948d5cfd120405f8c9,3,58,1,59,3,2014-10-23 21:31:34,2014-10-23 20:30:18
8b40d385b58f118cbda9f62da9cc88f91afd1f26...291b84610fc87622c7116ac71328c1ce3181a6db,25,452,20,472,34,2014-10-23 19:00:05,2014-10-23 19:00:05
8b40d385b58f118cbda9f62da9cc88f91afd1f26...3a1eafb4889041be13f0e4e450b5eaf0ae7938c8,1,1,1,2,1,2014-10-23 18:06:36,2014-10-23 18:06:36
94da44cacf189de091509d73298cfdc19fda557e...81cddaaa7ddd09cd928529e988df28d17a180203,1,1,1,2,1,2014-10-03 20:18:40,2014-10-03 20:18:40
4547b6d529df10d83ffc1937abc260c8a2ede743...92df943fbf225d78b160babb36e9c6fd38cdc0d0,8,75,42,117,38,2014-09-26 18:44:46,2014-09-25 16:55:53
4547b6d529df10d83ffc1937abc260c8a2ede743...e2b8d4bd4a77426b555bb1e6f57fc27f04f6c84b,2,84,8,92,10,2014-09-25 15:54:48,2014-09-25 15:24:41
4547b6d529df10d83ffc1937abc260c8a2ede743...8e7aa44f0e610f471dec9dd232599b4b9cba80b2,4,49,4,53,11,2014-09-25 14:59:23,2014-09-25 14:57:37
4547b6d529df10d83ffc1937abc260c8a2ede743...cb6b196ab470dad0ced37e20f525758625e488cb,2,62,44,106,18,2014-09-25 06:07:55,2014-09-25 06:07:55
42ec80bec02b7cb921397fc79ca58a18190e2c4b...5239ba3d06b2efccd986231a93e839d4693d2d0c,2,26,1,27,3,2014-09-25 13:23:39,2014-09-24 15:00:01
42ec80bec02b7cb921397fc79ca58a18190e2c4b...6a5f09b752c32983472bd194fef1828a73c95203,1,2,2,4,2,2014-09-23 22:20:41,2014-09-23 22:20:41
42ec80bec02b7cb921397fc79ca58a18190e2c4b...ab30e19b96ce498c8a7de748e197f12b5550a7b2,2,10,1,11,6,2014-09-23 21:47:33,2014-09-23 21:47:33
42ec80bec02b7cb921397fc79ca58a18190e2c4b...8edacc673a0ecb4320377457f0bf9dbdaa08f843,2,24,1,25,3,2014-09-23 20:55:51,2014-09-23 20:31:42
5b6c4051d58bf535eded3ae557a0996937e96045...a2ba4d56eb134f95eba790bb484e0c8bd77d1fc4,1,0,2,2,1,2014-09-10 21:26:03,2014-09-10 21:26:03
5b6c4051d58bf535eded3ae557a0996937e96045...bcb9378c5b91f8fd7bc99d1ad0904f5cba6ee613,1,31,42,73,9,2014-09-10 20:46:11,2014-09-08 21:59:16
6df533adb45c50757311e2a6fa11e6344c194ab0...afacaba79bc17641858a16bb265c63006a23a8d6,1,1,1,2,1,2014-09-26 04:28:39,2014-09-26 04:28:39
6df533adb45c50757311e2a6fa11e6344c194ab0...05060a7c9496056fb792330027b7a73aec192697,14,74,18,92,14,2014-09-26 01:25:36,2014-09-25 05:32:51
05060a7c9496056fb792330027b7a73aec192697...71e28f9d645ce3e216f87ad0a56c2800ec98155d,15,64,0,64,15,2014-09-26 01:55:36,2014-09-26 01:55:36
e2728d98926bb8921610f7ce2e5e4401623ae33c...d19d800898a48aebf90947ced17157e26e3803e2,1,2,2,4,2,2014-09-25 21:23:27,2014-09-25 21:23:27
d142b18aab2a3b90959a2ab32676b388a5e98769...cbb81c30bd50952f84d4a60e850c1cede3318a77,1,33,0,33,5,2014-10-02 20:18:47,2014-10-02 17:01:10
cbb81c30bd50952f84d4a60e850c1cede3318a77...0597b6445db0b0aeb4a0459f3af4f074a865a42f,1,116,174,290,53,2014-10-02 21:13:37,2014-10-02 21:13:37
d142b18aab2a3b90959a2ab32676b388a5e98769...5730abc16728404c328b896c893f9487effbec55,1,4,1,5,1,2014-09-30 00:59:12,2014-09-28 23:45:41
d142b18aab2a3b90959a2ab32676b388a5e98769...83f0f46b7c0475ae1da329cd97a8c0a67bdc2a6a,2,54,8,62,6,2014-09-29 21:13:39,2014-09-29 15:34:58
d142b18aab2a3b90959a2ab32676b388a5e98769...65640994fda8e1667de3642d8f4daf76dd3de302,3,43,0,43,4,2014-09-29 10:37:31,2014-09-15 19:43:21
65640994fda8e1667de3642d8f4daf76dd3de302...a297d6ab8c08a13503fd004ec1ad7ee9e23bd22a,4,4,68,72,6,2014-09-29 10:37:31,2014-09-24 18:19:55
d142b18aab2a3b90959a2ab32676b388a5e98769...8833d800bf622dcb6a66da0fe4c7a61a1620b62c,4,24,5,29,8,2014-09-29 10:21:54,2014-09-29 09:52:13
d142b18aab2a3b90959a2ab32676b388a5e98769...8ffdf6022e88e19c6d1f434a69ff5cbd3dc7db6b,3,28,28,56,5,2014-09-29 03:51:44,2014-09-29 03:48:57
d142b18aab2a3b90959a2ab32676b388a5e98769...a7cd25b8b69fe23c6458f5242dcd9f9039c99f48,2,68,0,68,3,2014-09-29 02:51:00,2014-09-29 02:45:03
999d4117f6544aeefaba3c40aef678042c71aa7a...35aa3fd5f20f1d9575e3f25366680f9ed9f36aa0,1,1,1,2,1,2014-09-29 23:58:47,2014-09-29 23:58:47
1d8c66347eeea164d900dd16006109814dc3c261...7c22b3d599ff1ff6431f06849abc1cec231ad705,1,1,1,2,1,2014-09-25 22:19:59,2014-09-25 22:19:59
07da2e03b14c91f464f9fdfdbe8848ae8fc3725e...c7f3fdc629dd654af2fc795c1f3fa1acdaf2552f,3,45,0,45,3,2014-09-26 16:26:21,2014-09-25 21:41:32
87fd6375f1ad6fc5c0bcea2f39c6a16d3f91d5da...d245a8a706558c4a66498cb8d1a1d8fe38dd67ee,5,37,2,39,5,2015-01-30 23:22:11,2015-01-30 19:45:02
ab86f591c323b38c918a026f38a26df120a475ac...ee78e3f28459b655bf7df71eb4e2e22a04a8948d,3,30,21,51,3,2015-01-13 23:22:04,2015-01-13 19:17:26
11e47996dc3efe8b358f21b4ff243d9c3e5fa1ec...3807d96d379cb5b08ad3dae3d624fb3d24306b77,1,16,16,32,2,2015-01-08 22:21:54,2015-01-07 19:27:24
11e47996dc3efe8b358f21b4ff243d9c3e5fa1ec...568f86eb186731b907b659e4ec64bda21c2fe31d,31,1506,381,1887,207,2015-01-08 20:14:58,2014-10-07 01:54:52
568f86eb186731b907b659e4ec64bda21c2fe31d...6f0068f2733232b8357c2308517f6ddddb63aace,6,290,282,572,15,2015-01-08 20:15:00,2015-01-07 23:42:01
6f0068f2733232b8357c2308517f6ddddb63aace...33b931e718b89fec64705471534f8df3d5e42c4c,1,4,1,5,1,2015-01-08 21:16:43,2015-01-08 21:11:48
11e47996dc3efe8b358f21b4ff243d9c3e5fa1ec...16dbd84f6386519dbbcefeb81cdfa708bca8cfa8,5,7,10,17,9,2015-01-08 18:29:24,2015-01-08 18:29:24
11e47996dc3efe8b358f21b4ff243d9c3e5fa1ec...e54d8c47e45ca19ab9548a7e3689aa1584733210,1,6,0,6,1,2015-01-08 15:24:52,2015-01-08 15:15:45
11e47996dc3efe8b358f21b4ff243d9c3e5fa1ec...f4551b8a48bdc7a135466398eecfb103fcde25c6,2,3,1,4,2,2015-01-08 15:21:09,2015-01-08 15:21:01
11e47996dc3efe8b358f21b4ff243d9c3e5fa1ec...6f20b957b09c0a7c81013088db7bcec6b3222613,2,53,21,74,4,2015-01-08 14:56:30,2015-01-08 14:56:30
11e47996dc3efe8b358f21b4ff243d9c3e5fa1ec...b7cb29137bd9c8d7de73993cc7415b62acd498cd,1,54,54,108,2,2015-01-08 04:27:09,2015-01-08 04:27:09
11e47996dc3efe8b358f21b4ff243d9c3e5fa1ec...7275cd4bbccb9a3b3ea6b9422a59a092fb08bf8d,1,1,0,1,1,2015-01-08 04:14:45,2015-01-08 04:14:45
ef2d6dda0f25d29e19b7cc6afeee57c2d6971660...93d51e5e971e001d80e9ffa863439f2d72215b5a,5,115,38,153,20,2015-01-20 00:35:55,2015-01-09 17:06:48
ef2d6dda0f25d29e19b7cc6afeee57c2d6971660...a6a748b9a0ce459fe1e250fdc5d107363315aeca,3,12,6,18,8,2015-01-12 17:56:43,2015-01-09 20:10:54
ef2d6dda0f25d29e19b7cc6afeee57c2d6971660...30eff2720a110f3ece0e429ef1897a254f0d9e71,2,16,1,17,2,2015-01-10 05:48:41,2015-01-10 02:18:57
ef2d6dda0f25d29e19b7cc6afeee57c2d6971660...4374d3bc81cf47866bd3f5c240307915931084cf,1,4,0,4,1,2015-01-09 21:53:03,2015-01-09 21:53:03
ef2d6dda0f25d29e19b7cc6afeee57c2d6971660...09c033ff872334cdcc45172ac57dbf21573481ef,2,37,16,53,8,2015-01-09 16:20:07,2015-01-09 16:20:07
22437eb9609cdbf4ed221d07557e206bc0066e18...9ab73260f8e4662e7321b257c636928892f023cf,4,106,7,113,9,2015-01-19 16:00:32,2015-01-16 20:57:08
22437eb9609cdbf4ed221d07557e206bc0066e18...750373875e25455acb046001cb0582873a90bd73,6,11,11,22,10,2015-01-19 01:57:44,2015-01-19 01:57:44
22437eb9609cdbf4ed221d07557e206bc0066e18...43b97368422843108a2090633367beaba434245b,1,1,1,2,1,2015-01-16 11:16:10,2015-01-16 10:48:00
22437eb9609cdbf4ed221d07557e206bc0066e18...933f957e773d5b9da13e32649d0f987b30e87eb5,1,1,1,2,1,2015-01-16 07:45:37,2015-01-16 07:45:37
8916e2582b4a4276080373563ea2e1b83bb2de3e...e3b3719f16cbae506d15474c122276e21f59d3a5,1,9,1,10,2,2015-01-08 19:37:48,2015-01-07 07:10:05
e3b3719f16cbae506d15474c122276e21f59d3a5...17373ca54b9caf2bc24d8a69c6b9639d167cb0cb,1,1,1,2,1,2015-01-08 19:37:53,2015-01-07 17:43:07
8916e2582b4a4276080373563ea2e1b83bb2de3e...09e3467452d24aca38810fa79a09d6371d2c0b5c,3,35,1,36,5,2015-01-08 19:30:08,2015-01-08 19:30:08
43a75f5b9332f4b3c002f79ea342b00127811b5b...3873b19c31a882a3240fc04b63e23e8a557028c0,1,1,1,2,1,2015-01-12 23:01:09,2015-01-12 23:01:09
43a75f5b9332f4b3c002f79ea342b00127811b5b...e5869b2b0bdf85d15813c714565fd49943c3d754,7,9,9,18,10,2015-01-12 22:47:36,2015-01-12 22:47:36
e5869b2b0bdf85d15813c714565fd49943c3d754...b70632ec532d4a948e227a646f8286d7c439cb4f,1,1,2,3,2,2015-01-12 22:52:19,2015-01-12 22:52:19
645a752f17c0bf66942357dc3c54ce0475c795e6...21fcca7fdc8622567b79bc84c3921a9ae7c22501,1,2,2,4,2,2015-01-09 02:10:59,2015-01-09 02:10:59
645a752f17c0bf66942357dc3c54ce0475c795e6...fa8560e3859037e7f5a7e2b37fedd91c7f6d0cf9,1,0,1,1,1,2015-01-09 02:09:23,2015-01-09 02:09:23
645a752f17c0bf66942357dc3c54ce0475c795e6...7724260224c69eeb948c75c247d4868256e5081a,1,1,1,2,1,2015-01-09 01:06:27,2015-01-09 01:06:27
70fbd45a5c88f6f39a07b04f81a07721bf5f3eed...c0969ed3d896c9add0a2cca7b9a9074cd138571b,8,111,111,222,87,2015-01-28 21:54:10,2015-01-16 13:04:24
70fbd45a5c88f6f39a07b04f81a07721bf5f3eed...0fab79f20343db9d95da191cf473651c3c8f5f42,1,20,5,25,4,2015-01-28 21:26:40,2015-01-28 21:08:41
3837c080228143378b1041364a90aa5bcf59fa00...bff3509e431ce6d68e2accbb842c99d4abe86e05,3,70,30,100,19,2015-01-17 04:01:52,2015-01-16 13:11:29
3837c080228143378b1041364a90aa5bcf59fa00...48b1dd0084904678728817d728bb9ab1c0183aad,8,103,33,136,20,2015-01-16 19:43:43,2015-01-15 21:40:39
3837c080228143378b1041364a90aa5bcf59fa00...41e20cecb9944137de82ff5fa0898f953aa2bf87,8,484,63,547,42,2015-01-15 22:04:14,2014-12-12 01:55:15
41e20cecb9944137de82ff5fa0898f953aa2bf87...ac8d964b28f23c9790102462a040054e7857cb26,1,21,2,23,5,2015-01-15 22:04:14,2014-10-22 18:07:03
ac8d964b28f23c9790102462a040054e7857cb26...188b56c836e49e3c888e1e27e4e26b5cc0f1caaa,6,254,2,256,17,2015-01-15 22:05:05,2014-10-01 00:03:57
188b56c836e49e3c888e1e27e4e26b5cc0f1caaa...bcc0a343bb9c75443238e614e4c2da5f707aef8d,1,4,7,11,6,2015-01-15 22:05:05,2014-10-10 00:34:52
bcc0a343bb9c75443238e614e4c2da5f707aef8d...3e4fd005449448ab85c917a5d27ca584b260309c,1,1,1,2,1,2015-01-15 22:05:05,2014-10-10 00:32:16
3e4fd005449448ab85c917a5d27ca584b260309c...e9b590d85e9c622316b8be71004737f63e6b9503,2,14,4,18,4,2015-01-15 22:05:05,2014-11-15 00:22:06
e9b590d85e9c622316b8be71004737f63e6b9503...e23362597dcaa8839271210d24bda2ba55f1e12f,1,16,5,21,5,2015-01-15 22:05:05,2014-12-12 21:30:12
e23362597dcaa8839271210d24bda2ba55f1e12f...a0f92a26d90e870dfddae9694a5de97e36d3f586,8,1025,0,1025,8,2015-01-15 22:05:05,2014-12-12 19:27:22
a0f92a26d90e870dfddae9694a5de97e36d3f586...dbb4b03bfc82eadefaf68c1a81d215949980550e,4,28,15,43,12,2015-01-15 22:05:05,2014-12-15 20:42:52
dbb4b03bfc82eadefaf68c1a81d215949980550e...0336b0cdaa74ac03003c4a933eb866fb0cec8125,6,208,240,448,85,2015-01-15 22:05:05,2014-12-17 00:57:37
0336b0cdaa74ac03003c4a933eb866fb0cec8125...7d61255f578bae7dc5c2a5d44c50bf32bbc9f568,5,29,21,50,11,2015-01-15 22:05:05,2014-12-19 22:44:18
7d61255f578bae7dc5c2a5d44c50bf32bbc9f568...d094eb6f7ffe6b608ecde54297e107e5caa0954d,2,62,32,94,23,2015-01-15 22:05:05,2014-12-20 00:14:04
d094eb6f7ffe6b608ecde54297e107e5caa0954d...1b43144ad8597d0d0ca089042c1162ba668259ab,1,14,14,28,8,2015-01-15 22:05:05,2014-12-22 22:58:08
1b43144ad8597d0d0ca089042c1162ba668259ab...7eeda3f14de744b98b1c5aca4f2ecce87a479baa,1,1,1,2,1,2015-01-15 22:05:05,2014-12-23 02:58:01
7eeda3f14de744b98b1c5aca4f2ecce87a479baa...213e3d116642431adbe634d39740eddc5a81e063,6,117,33,150,23,2015-01-15 22:05:05,2014-12-23 21:40:06
213e3d116642431adbe634d39740eddc5a81e063...25945a40c4f352a754cbd8dba9c846c7539fe463,5,82,93,175,22,2015-01-15 22:05:06,2015-01-02 19:13:11
25945a40c4f352a754cbd8dba9c846c7539fe463...8ceb9d20d66097b90ca3a529da258669ef6b8412,4,32,9,41,10,2015-01-15 22:05:06,2015-01-07 22:59:12
8ceb9d20d66097b90ca3a529da258669ef6b8412...1a9cdb13943c6af397472e235708cb10824681cd,1,8,3,11,3,2015-01-15 22:05:06,2015-01-07 23:55:29
1a9cdb13943c6af397472e235708cb10824681cd...9a38aa0279ccae5aeded854a9cbbd7e398088ab2,1,12,11,23,3,2015-01-15 22:05:06,2015-01-12 22:17:50
9a38aa0279ccae5aeded854a9cbbd7e398088ab2...ef96c28754706da921644e5cf9202f9cc78d4c7e,1,11,0,11,1,2015-01-15 22:05:06,2015-01-12 19:47:40
ef96c28754706da921644e5cf9202f9cc78d4c7e...2fc2862a73dbbc612f59f61f66c465d2e48bcbea,1,60,0,60,1,2015-01-15 22:05:06,2015-01-12 21:26:49
2fc2862a73dbbc612f59f61f66c465d2e48bcbea...f138f7bd50a1c5a435f3146f0b0298a2a4e260ce,1,7,9,16,5,2015-01-15 22:05:06,2015-01-12 22:30:19
f138f7bd50a1c5a435f3146f0b0298a2a4e260ce...dbec2317e503b8a0190102332168f9d0256392b7,3,63,14,77,12,2015-01-15 22:05:06,2015-01-13 18:46:32
dbec2317e503b8a0190102332168f9d0256392b7...92d5eafe03eca8ca931ddca5ef7d6e41ca25caad,1,45,1,46,2,2015-01-15 22:05:06,2015-01-13 23:19:44
92d5eafe03eca8ca931ddca5ef7d6e41ca25caad...750b41ced42bda0ccda405c1aa7c43ded5821e40,2,133,130,263,12,2015-01-15 22:05:06,2015-01-13 23:48:49
750b41ced42bda0ccda405c1aa7c43ded5821e40...9c6f8e14398e794cbe20504556c22a1c83260bd8,3,60,44,104,25,2015-01-15 22:05:06,2015-01-15 00:46:31
9c6f8e14398e794cbe20504556c22a1c83260bd8...f11f3f6203da596f50eec0edc3c5dfb8c93bc271,1,0,6,6,2,2015-01-15 22:05:06,2015-01-15 01:14:14
f11f3f6203da596f50eec0edc3c5dfb8c93bc271...dd914f91d779f64e20ce86767ab4f84f40b9ef6a,1,20,3,23,5,2015-01-15 22:05:06,2015-01-15 21:06:52
dd914f91d779f64e20ce86767ab4f84f40b9ef6a...f29aacbc4804e3aca1c21b9411e960b2a2543da1,1,1,0,1,1,2015-01-16 19:34:45,2015-01-16 19:34:45
3837c080228143378b1041364a90aa5bcf59fa00...611a23aa7f443284fbbbb80716c46159e438bf52,2,73,2,75,5,2015-01-15 19:16:31,2015-01-06 19:46:03
4c38045be1deed08bc1494261fd9a3e2812e67ad...b682d7cde619c61eace60811296c26f70e94c6b4,2,2,3,5,3,2015-01-19 20:38:51,2015-01-19 20:00:57
4c38045be1deed08bc1494261fd9a3e2812e67ad...9c3380039e15f11fc07741edd4cbc0c7e5c490aa,2,30,0,30,3,2015-01-19 20:15:51,2015-01-19 20:10:37
9c3380039e15f11fc07741edd4cbc0c7e5c490aa...022e1232f84966c4b70a612bc35463ebb58e3137,1,6,0,6,1,2015-01-19 20:57:25,2015-01-19 20:11:40
022e1232f84966c4b70a612bc35463ebb58e3137...d2593546f9a234699cd0034cc6b97c748c10c93e,2,11,8,19,3,2015-01-19 21:28:02,2015-01-19 21:28:02
4c38045be1deed08bc1494261fd9a3e2812e67ad...315260203c3a683fe7e93aa6c937128d38d52ae4,1,2,17,19,4,2015-01-19 20:09:02,2015-01-17 00:38:11
d515590d153ed1299ffe386eb30598c15bf61007...6229a364324ba603789bc38607bb628177280ebf,26,1822,0,1822,26,2014-10-24 22:01:52,2014-10-24 16:38:36
6229a364324ba603789bc38607bb628177280ebf...7c62cee51edc91634046b4faa6c6f1841cd53ec1,61,111,79,190,95,2014-10-24 22:03:06,2014-10-24 17:12:35
7c62cee51edc91634046b4faa6c6f1841cd53ec1...b3b40433451d8e76d02dc70d591027f680c9a3bf,1,8,4,12,2,2014-10-24 22:03:24,2014-10-24 18:20:17
b3b40433451d8e76d02dc70d591027f680c9a3bf...b99dcb3c7ef6e66754354292f2ec0217341c8d2b,2,0,162,162,2,2014-10-24 22:03:24,2014-10-24 20:47:52
b99dcb3c7ef6e66754354292f2ec0217341c8d2b...ee7dd44c017458c8fe0be8e09569b1238366dca3,32,32,32,64,64,2014-10-24 22:11:48,2014-10-24 22:11:48
8dfcbf62edb2853176eb3f5cf077dae68f2e85c3...522e6310967bcb4fadd99d76dc3205991ecae1ad,2,12,2,14,2,2014-12-05 11:06:11,2014-12-05 11:04:46
984b072a37ee090bc24511137919211ec2fbb542...46b1194d996f6535e657bcb88428303305d3fe68,1,1,2,3,2,2014-12-06 14:52:19,2014-12-06 14:42:32
984b072a37ee090bc24511137919211ec2fbb542...c128c134d71d01c555a6354d2ae7f6964f93df90,2,46,0,46,5,2014-12-06 02:44:31,2014-12-06 02:30:03
6e7a210db69eb59b08a1b1deb76f89630d5bece4...e01baa6be782320d3c0800697c882c2b919b202f,19,190,115,305,94,2014-12-05 00:43:38,2014-11-28 04:21:55
74bbb935715a3f384a4a3a527053af5419f5a72e...862952c8d4d3df69f35535af5ce5a079b5fe739e,1,4,2,6,2,2014-12-12 01:22:59,2014-12-12 01:22:59
74bbb935715a3f384a4a3a527053af5419f5a72e...fa3ec89515431ce425f924c8a9a804d5cb18382f,6,335,79,414,20,2014-12-11 21:26:01,2014-12-05 21:58:46
fa3ec89515431ce425f924c8a9a804d5cb18382f...b7f352b0fb7159af283275437ad69142addab13b,8,131,169,300,36,2014-12-11 21:26:01,2014-11-30 16:39:28
b7f352b0fb7159af283275437ad69142addab13b...ff4d05ed73dfff44f9bb919a0a6fccff17f866a9,1,64,20,84,17,2014-12-11 21:26:01,2014-12-05 20:33:11
ff4d05ed73dfff44f9bb919a0a6fccff17f866a9...5f0f0c228d438f01c3b9837eb6e8e97133d9d1f5,1,139,0,139,1,2014-12-11 21:26:01,2014-12-05 21:40:53
5f0f0c228d438f01c3b9837eb6e8e97133d9d1f5...0e71a48d4e89ce40c0ab94cc18599481d9e8a6b0,1,54,0,54,1,2014-12-11 21:26:51,2014-12-03 19:04:51
0e71a48d4e89ce40c0ab94cc18599481d9e8a6b0...7496cbbccc278c084620661812ed5f6390c1d2f1,1,75,0,75,1,2014-12-11 21:26:52,2014-11-27 20:14:15
7496cbbccc278c084620661812ed5f6390c1d2f1...a57eee2229c2f0c53c32372587fcc2a8327044ea,1,52,0,52,1,2014-12-11 21:26:52,2014-11-27 20:39:43
a57eee2229c2f0c53c32372587fcc2a8327044ea...e4ba82d50ee4642412a1e1bdf43a7b94fadd2428,2,246,0,246,2,2014-12-11 21:26:52,2014-12-08 20:40:27
e4ba82d50ee4642412a1e1bdf43a7b94fadd2428...7862f831fe99a221a0499b7764a8709e5f463bb9,3,60,31,91,14,2014-12-11 21:28:24,2014-12-08 21:14:56
7862f831fe99a221a0499b7764a8709e5f463bb9...001ac15b54686761960352103ebf4ff2c6e1d803,2,41,39,80,10,2014-12-11 21:29:13,2014-12-08 21:19:24
001ac15b54686761960352103ebf4ff2c6e1d803...af2021955cb01507984cbd076edaf3caaf5b89b3,1,29,0,29,1,2014-12-11 21:29:15,2014-12-08 22:33:46
af2021955cb01507984cbd076edaf3caaf5b89b3...bff1d9dbce76bed1e267a067eb4a1a74ef4da312,4,15,8,23,7,2014-12-11 21:29:27,2014-11-27 21:55:03
bff1d9dbce76bed1e267a067eb4a1a74ef4da312...fdabd6b14e394721aaf61402bb88073e7eb424bf,1,34,0,34,1,2014-12-11 21:29:28,2014-12-10 23:19:04
fdabd6b14e394721aaf61402bb88073e7eb424bf...5b851982da2b4fc4c42a7ad0279c65f8d1de08de,2,15,1,16,2,2014-12-11 21:33:20,2014-12-01 11:00:44
5b851982da2b4fc4c42a7ad0279c65f8d1de08de...9f48be69e5c315f4e08390e796fbceaed3ed92e0,1,1,1,2,1,2014-12-11 21:35:22,2014-12-11 21:29:49
74bbb935715a3f384a4a3a527053af5419f5a72e...916cba9c587a3f3ce97b407993fecd96ac2fecaf,1,18,12,30,9,2014-12-11 19:07:16,2014-12-11 18:40:16
fa7e01794f6fafb92579487fd3324ab13fa12123...a62cbdeb47e5e504e670c546ad8bec45e696f370,1,1,1,2,1,2014-12-10 03:08:24,2014-12-10 03:08:24
6700580bbc92525ac0a848103dca7649d60b4f2f...3a08bbc4d29835fe5b8f3d2c5bde442f6a7014a0,1,1,1,2,1,2014-12-11 17:57:23,2014-12-11 17:57:23
3076115e2c313402aa91af1366ada66fab8a9112...1cab340c10be71382a8cfde8402f475d503c94be,1,0,4,4,2,2014-12-12 02:05:07,2014-12-12 02:05:07
3076115e2c313402aa91af1366ada66fab8a9112...cfc24769a26e825e4267cbfdd59af807e27508b9,2,37,1,38,3,2014-12-10 19:09:03,2014-12-10 19:09:03
88e669391260900e48945c54ac74773b9b31816e...c0f0f5c9887032c606750b645001829d9f14f47c,2,36,1,37,5,2014-11-02 19:29:46,2014-10-23 21:54:35
88e669391260900e48945c54ac74773b9b31816e...12028fc159c6c383b1b9e8810a7a41a7c6c985bc,1,1,1,2,1,2014-10-24 00:22:21,2014-10-24 00:22:21
a76c924e6a23329569136bb8569168319f738656...ca6cc6560987a87b8f3b4fe4c3c227d692c49117,4,1586,4,1590,6,2014-10-24 18:25:44,2014-10-24 00:23:36
c681bea0620d24e9df370147a13a98f94bc66ee0...61f8001c23dc4fbd7b1113f20b89a0dbade9aa82,6,27,0,27,8,2014-10-24 22:56:37,2014-10-24 22:48:23
c6f242b88f7a40d183a95ab68f2a97052ec514a5...3eba719400d5016aa0cbecbed1e222f810237b5b,2,44,10,54,3,2014-10-24 20:27:17,2014-10-03 19:46:42
c6f242b88f7a40d183a95ab68f2a97052ec514a5...a7aedca4a1afe72d63346b67b577437f175776b9,2,3,3,6,4,2014-10-24 20:03:46,2014-10-24 18:04:54
c6f242b88f7a40d183a95ab68f2a97052ec514a5...cc45b13ad4e4384f016764c15a52eda95eb548a4,3,7,7,14,4,2014-10-24 19:00:47,2014-10-24 19:00:47
cc45b13ad4e4384f016764c15a52eda95eb548a4...fcae37402aac7372414fd4947b7a280bec398557,1,2,0,2,1,2014-10-24 20:17:14,2014-10-24 20:17:14
c6f242b88f7a40d183a95ab68f2a97052ec514a5...417fde550e30e6e2b8853f73f6c85f25b9c6a80f,1,1,1,2,1,2014-10-24 07:09:20,2014-10-24 07:09:20
c6f242b88f7a40d183a95ab68f2a97052ec514a5...7f1ea7129e7b87e60ea4b1e4449b0541f6f432c9,1,3,2,5,1,2014-10-24 02:41:19,2014-10-24 02:41:19
a71b2ec54ad7b5f809176c023ab22c7e062ad909...4bae6235c0aec3a0e3805b046a08fc7e6aadd46b,2,8,4,12,5,2014-10-24 01:36:07,2014-10-23 01:45:21
beff5067c8b97b37c4fd7e9bee08a0adb8947c99...007b4f63409c6c642fb075640a8ec7d58825edc8,2,2,2,4,2,2014-10-03 20:55:39,2014-10-03 20:55:39
007b4f63409c6c642fb075640a8ec7d58825edc8...b10b458b6ef8327268676744a7c3230e33c9baf6,1,12,2,14,1,2014-10-03 23:17:51,2014-10-03 22:33:11
44264f48e43bd556636326229e7e11c0fb8a23e1...c0e632246d821f3f70ffcf7244cf7a9b336b0344,13,64,64,128,52,2014-10-06 20:15:17,2014-10-06 14:26:55
44264f48e43bd556636326229e7e11c0fb8a23e1...30d6ff99fc6a22937b21bd9f35610d5f74a9b6e7,1,3,1,4,2,2014-10-06 16:20:10,2014-10-06 15:47:04
44264f48e43bd556636326229e7e11c0fb8a23e1...d29c7e51cf0c260e6b528f78783aa27e5953b4bf,1,24,18,42,13,2014-10-06 15:41:53,2014-10-06 15:41:53
d29c7e51cf0c260e6b528f78783aa27e5953b4bf...39fe2a3e4e059c4235f2e1692e240058fccc0ea3,2,21,13,34,17,2014-10-06 19:00:58,2014-10-06 19:00:58
39fe2a3e4e059c4235f2e1692e240058fccc0ea3...d202ff2ece6812f90af60292b88a9a20adb807ee,1,4,2,6,4,2014-10-06 19:19:41,2014-10-06 19:19:41
d202ff2ece6812f90af60292b88a9a20adb807ee...d1a85078b552bf35e76a4e12fca6ecbdecb1c3b6,1,6,3,9,4,2014-10-06 19:27:56,2014-10-06 19:27:56
d1a85078b552bf35e76a4e12fca6ecbdecb1c3b6...ae3b59c1715840ba322fbe19002994e717b10b48,5,41,38,79,35,2014-10-06 19:34:39,2014-10-06 19:34:39
ae3b59c1715840ba322fbe19002994e717b10b48...9e45069e0ab8023bb7c8bcbda9a525fb6932dcf8,1,11,11,22,7,2014-10-06 19:57:27,2014-10-06 19:57:27
44264f48e43bd556636326229e7e11c0fb8a23e1...e457b21db32359af085b04b5900ca6aab993ac86,1,1,1,2,1,2014-10-06 14:04:27,2014-10-06 13:43:09
44264f48e43bd556636326229e7e11c0fb8a23e1...e857716d2d881aaf1cf5a775d02ee5b109d9e423,1,1,1,2,1,2014-10-06 08:58:33,2014-10-06 08:23:56
27567e55937fded6601d4c6b1fcb82fdfcb4ce04...7d74be162c9704df848c865a9b4bcd4047da9124,3,14,7,21,9,2014-09-25 18:48:49,2014-09-23 22:58:05
826439c537f9e3346e66dda9b65fd936e470d840...9f59e2223d59829892e57d38b95cd951d1fbdc9e,1,1,0,1,1,2014-09-29 21:37:51,2014-09-29 21:37:51
826439c537f9e3346e66dda9b65fd936e470d840...f90d201d887028e21290a413046eb1af7fc8e609,1,57,33,90,12,2014-09-29 20:59:43,2014-09-29 20:59:43
5e69f4a1885310e8e4dd386bb4ff8c2d80bec40f...115436e038a83ae24b0e89aefd8309133b013e1c,2,35,0,35,6,2014-10-06 16:50:40,2014-09-30 22:41:43
5e69f4a1885310e8e4dd386bb4ff8c2d80bec40f...10efa07fa28e400a597ed7076aa0d730a081ebf2,1,1,1,2,1,2014-10-01 22:37:46,2014-10-01 22:32:27
5e69f4a1885310e8e4dd386bb4ff8c2d80bec40f...42b377904b081170c74b6526959cb70215778f21,3,80,49,129,35,2014-09-30 20:30:14,2014-09-24 23:05:35
42b377904b081170c74b6526959cb70215778f21...36db0a30fa471aa96cf5acd8139b554db78cec22,2,42,32,74,23,2014-10-02 21:08:39,2014-09-24 23:05:35
dd5657ffd1a60fe89d57f585454a91823b2da516...d9fd5f6199aebb9ea784f5b23ec97b960f89f3d4,6,420,59,479,28,2014-09-23 21:21:00,2014-09-23 21:21:00
d9fd5f6199aebb9ea784f5b23ec97b960f89f3d4...6747dfc8031205f0e629a3508f14125b3b66a5b2,2,36,42,78,28,2014-09-23 22:51:17,2014-09-23 22:51:17
6747dfc8031205f0e629a3508f14125b3b66a5b2...950eccab4ad4d79a5afa154849567ddfdf8dc7eb,2,44,33,77,15,2014-09-24 01:26:02,2014-09-24 01:26:02
3151ecd7bb99b473fe0dfb4c259080d6867c632c...0a8fb80d99e41f2d8d05f593fd77018e26f4ee2c,1,0,0,0,0,2014-09-26 13:31:59,2014-09-26 13:31:59
3151ecd7bb99b473fe0dfb4c259080d6867c632c...0f15221240b078c53e86c653c4098bf66e9e30ac,1,1,1,2,1,2014-09-26 09:48:28,2014-09-26 09:46:21
2682393ce18b62867e900edd284d05e5a3280579...8b3fbac15c0579c1372f3e13f607c1001d149d16,1,6,28,34,5,2014-09-29 20:35:09,2014-09-29 20:35:09
2682393ce18b62867e900edd284d05e5a3280579...8d7c7bd2e3aba3bba72264d477c56444c5dc6350,2,26,12,38,6,2014-09-29 18:56:04,2014-09-27 00:42:24
45667fb1bb30fb206dd6c481f0bd8952c68cf122...193654e3ef26067315d6c68c3066215e5c509ae5,11,288,28,316,21,2014-10-02 22:19:56,2014-10-02 22:19:43
8128339bc8fe3ed7f5c8fd9cc69a73d2dd519a83...17500eb188a5d5d049fc66c6387a8562f21c6a79,1,71,50,121,39,2014-09-30 16:00:15,2014-09-30 08:43:28
8128339bc8fe3ed7f5c8fd9cc69a73d2dd519a83...bfc9d8bbea2f41247fa543034bbbf64704ae3aae,3,3,3,6,3,2014-09-30 11:22:09,2014-09-28 15:01:35
8128339bc8fe3ed7f5c8fd9cc69a73d2dd519a83...b845a62149d5f4990462ac6c9167c5cfaa0e66cb,8,26,20,46,18,2014-09-30 06:16:27,2014-09-30 06:16:27
b845a62149d5f4990462ac6c9167c5cfaa0e66cb...73f4bfed810b65943f1d9d038a8db9bd834067fa,2,28,21,49,4,2014-09-30 06:21:41,2014-09-30 06:21:41
73f4bfed810b65943f1d9d038a8db9bd834067fa...30d5a42c1f24e26f681b7330249f04fec891aee9,30,23,24,47,39,2014-09-30 06:23:36,2014-09-30 06:23:36
8128339bc8fe3ed7f5c8fd9cc69a73d2dd519a83...ea09f036824aee74112a75ac99579ae4f10251b5,5,78,8,86,9,2014-09-30 03:11:19,2014-09-26 23:25:50
27c5269b4ee1b77011974a1d1e1776f0b8e00648...8019eec68169d35fd4eff78fcceed0f151abfcd7,1,1,2,3,1,2014-09-29 17:03:07,2014-09-29 16:47:55
595b5bf06e6d4e6ddf4f493b956a8eab112dd52b...87e732a0f3503517d7a66804bb9a7f74977347e5,8,117,6,123,16,2014-09-30 00:06:22,2014-09-29 10:44:32
87e732a0f3503517d7a66804bb9a7f74977347e5...c2c5e57a8ea4b1dc35c58654443a8c4508277904,5,17,5,22,7,2014-09-30 00:43:47,2014-09-29 23:34:45
c2c5e57a8ea4b1dc35c58654443a8c4508277904...226bc669aa9a886c5a6855e054b751e72d20971b,2,9,9,18,5,2014-09-30 18:15:23,2014-09-30 00:59:29
226bc669aa9a886c5a6855e054b751e72d20971b...08547dff29490236949317ca604dbda9d8feac4f,3,68,60,128,7,2014-09-30 19:10:03,2014-09-30 19:10:03
9b2afa04f8ab491d56614835de09eb0880250309...0cd30cf3991de1b491cac3c0cecdc976f0098f29,3,52,3,55,6,2015-01-21 00:14:23,2015-01-19 00:27:14
0eefae8e0db0c3c567e8807f09434a0da3fc1261...23feaaa240853c0e7f9817f8c2d272dd1c93ac3f,10,91,5,96,21,2015-01-14 00:35:17,2014-11-25 20:10:53
23feaaa240853c0e7f9817f8c2d272dd1c93ac3f...15e8f3fdd31dc498be106a69a7e29ba459c36c1a,1,32,0,32,1,2015-01-14 00:39:08,2015-01-14 00:39:08
99a15ec8bd548563a1ac4f652c55d4bb1ff769e4...492b18ac08e2652c1b95fd9f3c786e1fb1f28c3a,1,8,13,21,8,2015-01-13 22:14:36,2015-01-13 22:14:36
99a15ec8bd548563a1ac4f652c55d4bb1ff769e4...3c01c971cdec8822086d03f509e119cb8a8c719c,1,4,1,5,1,2015-01-13 19:34:55,2015-01-13 19:34:55
e9d3e237e5cffef0dfcd4949c31959cd25863f3f...142369456d2469a06e3860bdfe13169a908a3707,1,4,3,7,1,2015-01-20 19:11:59,2015-01-20 19:11:59
e9d3e237e5cffef0dfcd4949c31959cd25863f3f...9462dbb242449b126ff473d081cec04afaa936d2,1,61,0,61,4,2015-01-20 18:51:15,2015-01-15 18:37:30
de9783980be2a7b3ca10eb8183ea5989acbd3e7e...79910625f0a7aa76590e4362817dda22f28343aa,1,573,0,573,1,2015-01-12 18:37:46,2014-12-08 07:25:31
de9783980be2a7b3ca10eb8183ea5989acbd3e7e...8d414fd434c55f1d9ac9387e17dd16608fca1bfd,1,98,67,165,1,2015-01-12 05:20:27,2015-01-12 05:01:38
044d979f4ec83aac5664691d29123c34f6db68d6...90c5ff4f06b8672cd2b427d120a8988bfc9f1de7,1,23,6,29,4,2015-01-13 23:32:47,2014-12-17 22:17:14
90c5ff4f06b8672cd2b427d120a8988bfc9f1de7...33286589291a56fe0a4728f8b45ad3feb5494226,1,7,5,12,6,2015-01-13 23:32:47,2014-12-18 09:38:31
33286589291a56fe0a4728f8b45ad3feb5494226...476cf1b906ca14cc3ce1347f1aa479713fa6ce6e,1,113,71,184,13,2015-01-13 23:52:44,2015-01-13 23:24:51
044d979f4ec83aac5664691d29123c34f6db68d6...c03e15c9daddac86a4fdc7e6660f338b1b733f22,1,4,3,7,1,2015-01-13 23:20:17,2015-01-13 23:20:17
edaf23b7a7f71626bdafb4e3a9677ad05fa17cab...71763636f232477b0c890e0506b7b858505f1b33,1,1,1,2,1,2015-01-24 18:21:11,2015-01-24 18:21:11
edaf23b7a7f71626bdafb4e3a9677ad05fa17cab...ba3bad66f92da057dba2a43ff9a512cf7ad72375,3,21,5,26,5,2015-01-23 19:30:27,2015-01-23 17:54:17
27602f2a21732656180397cd4e30b9d246b75a0b...232d59baeb13778abc242a602ca434d83e1eb6e8,8,46,72,118,13,2015-01-19 19:48:25,2015-01-17 05:00:44
27602f2a21732656180397cd4e30b9d246b75a0b...6b04d9342c3d76f5979850f93a4afd41afa33227,5,45,15,60,16,2015-01-19 18:37:31,2015-01-16 22:52:16
27602f2a21732656180397cd4e30b9d246b75a0b...f0d79c021d7cd6c78cc830154b6bbee1dcf9ec8b,1,2,1,3,2,2015-01-19 18:28:57,2015-01-19 18:09:46
0da9540eda55caaa8ed486b6814afc253a0e181d...400d92871cb300ee8696dbcedcfd6a95f4d9d5a7,2,2,5,7,2,2015-01-13 01:38:12,2015-01-13 01:38:12
400d92871cb300ee8696dbcedcfd6a95f4d9d5a7...2292167b02ce0489d38e0a6beeb792bcb7534f34,1,54,0,54,1,2015-01-14 07:25:58,2015-01-14 07:25:58
a83e904611006c3039d932e0b4907ab802224c8b...2677f1add48961115f08016da422d74cafbf4c8b,1,7,5,12,5,2015-01-09 16:53:39,2015-01-09 06:07:15
cb4ea2c778eb022475e5bcd9305176e7b8413fad...2b51d1a167055834df331fb23c6cd373ebc06211,1,1,1,2,1,2015-01-12 18:40:42,2015-01-12 18:40:00
cb4ea2c778eb022475e5bcd9305176e7b8413fad...115d8bac6017cc5703fe34e679f1a30a4759a9ff,10,395,40,435,34,2015-01-12 18:38:15,2015-01-12 18:38:15
115d8bac6017cc5703fe34e679f1a30a4759a9ff...582a79f00a1d87ba0debd8f3785d867c02451e5f,1,5,4,9,4,2015-01-12 18:43:33,2015-01-12 18:43:33
cb4ea2c778eb022475e5bcd9305176e7b8413fad...00fd63e55807c36fedf0878645dfec995fba381d,6,19,12,31,16,2015-01-12 18:34:35,2015-01-09 22:14:52
b505db5e3c0b5ca60977e268572a05c499f4703c...0eed1f4d8da893d7c91be811197032a064053155,6,24,60,84,22,2015-01-29 21:46:12,2015-01-29 21:46:12
b505db5e3c0b5ca60977e268572a05c499f4703c...f1bc02e91f79b4a54f47e0ad4abfd3d48b698ec4,1,3,2,5,1,2015-01-29 17:09:44,2015-01-29 17:09:44
b505db5e3c0b5ca60977e268572a05c499f4703c...761a020f9dbb5e5610dce0dc8c762de09f8a0d46,1,13,0,13,2,2015-01-29 02:32:38,2015-01-29 01:11:51
7b48488c5641f092e111aa9d5562b368f7e66711...cb81ed34a52420528281ccaa99e16c472f4f533a,2,12,0,12,3,2015-01-20 01:35:20,2015-01-19 20:31:54
8b95ad230e2ee76450ceb9a80aa8e942a56bb397...3a1dbef8232ee4f58cbaf3a2776c27a4d5b04bc4,1,8,0,8,1,2015-01-19 19:23:31,2015-01-19 19:23:31
8b95ad230e2ee76450ceb9a80aa8e942a56bb397...79f17dcf7404d0547db68dba8b629c9c1141e47b,1,2,2,4,2,2015-01-18 04:07:20,2015-01-18 03:21:45
cb9db04fd72cf31b3df802fe19a0cff4cf682438...6ef8057700b63e2c5fd5cec206915ef1f2088578,1,26,15,41,7,2015-01-21 15:08:37,2015-01-16 23:33:26
2d61a62378a2aa9d0b05023e05d2632b596c61c4...a09a665d99c84be74ffff68a39dde83ad3c0d34a,1,39,0,39,1,2015-01-19 22:37:08,2015-01-19 22:37:08
2d61a62378a2aa9d0b05023e05d2632b596c61c4...dbb642b7fbdf42d3b401d610403ba58ebbde38d7,1,1,0,1,1,2015-01-19 22:06:53,2015-01-19 20:52:39
dbb642b7fbdf42d3b401d610403ba58ebbde38d7...4cfe9df0a9c206c368a90f460fea8fab197265d9,2,5,5,10,4,2015-01-19 22:21:10,2015-01-19 21:40:50
092d52281d20e3456677ac11d781abf1cd0bdd8f...eb76cb2301fc883941bc4ca2d9ebc3a486ab8e0a,1,1,0,1,1,2015-01-20 19:22:04,2015-01-20 19:22:04
eb76cb2301fc883941bc4ca2d9ebc3a486ab8e0a...6bb65864589fbd720622cbd795763d108999a366,1,2,1,3,2,2015-01-20 21:00:41,2015-01-20 20:17:41
c9285a08b161f31f37915f929252c9ba1a83ffa9...d1535131d259bb8a980770d47c0865a1be4373e3,4,26,4,30,6,2014-12-08 23:41:07,2014-12-08 23:04:34
8e59bda173669366ae99944458f2a5a03d13fb99...48a596a804a24a5b4b3512a58a785b17781c49d0,1,4,0,4,1,2014-12-05 06:30:54,2014-12-05 06:30:47
48a596a804a24a5b4b3512a58a785b17781c49d0...5f2000944b0377f1e5ce86a887f495f1f295dd90,1,24,0,24,1,2014-12-05 06:42:48,2014-12-05 06:41:18
8e59bda173669366ae99944458f2a5a03d13fb99...b4b899264ed892818ef31c3626acad8fb110aabb,2,107,62,169,7,2014-12-05 02:13:22,2014-12-03 00:40:33
b4b899264ed892818ef31c3626acad8fb110aabb...b266ad9c607588e8541926dfca7e338148e904ff,2,15,5,20,6,2014-12-05 03:05:38,2014-12-05 03:05:38
8e59bda173669366ae99944458f2a5a03d13fb99...11a75ec97f904b1807dbdc7121ac4e19dc229d49,1,5,1,6,2,2014-12-05 02:01:13,2014-12-05 02:01:13
ce1393cb553fba082e2a3cf349c7325f4ae6bc7e...d04debddd983b3aa48ad38659d2c3debe794d374,1,1,1,2,1,2014-12-12 02:25:14,2014-12-12 02:25:14
d152a93b5f3acbd14e9176169934b83963f3ab61...1c62e0ae4efad190477f6464e56cd97fee87cbb5,1,2,12,14,3,2014-10-03 22:24:14,2014-10-03 22:24:14
a650ab7f29ea89d89a1bdee19823ca45fac4d4a4...9fe1dd3103071a7ce8e6d7a1ce204351e8eaa248,1,12,0,12,1,2014-10-07 03:14:25,2014-10-07 03:14:25
9fe1dd3103071a7ce8e6d7a1ce204351e8eaa248...0a2c481c7f24fcd295b1e1f6504732971b289919,4,36,38,74,6,2014-10-07 03:26:59,2014-10-07 03:24:43
a650ab7f29ea89d89a1bdee19823ca45fac4d4a4...300c51c3a4ca47b022eb2efb75d1e8cf7736b0ff,1,9,10,19,7,2014-10-07 00:59:12,2014-10-07 00:59:12
a650ab7f29ea89d89a1bdee19823ca45fac4d4a4...0a056a31faa194998a1d4499c4f6ad292cadd3b3,1,1,1,2,1,2014-10-06 22:28:50,2014-10-06 22:28:50
166c56cabdd18054a10b8f196c6ba178ad72ba83...e95b6fb648ab6301b556192a9730a843fab7209f,2,51,3,54,5,2014-10-06 18:21:46,2014-10-06 17:30:42
887d9238f5af04123755dcf513c28c891246363b...21dff8cbecce458e7f532cedf1ca109c1f4fe6e2,1,1,1,2,1,2014-10-06 17:04:10,2014-10-06 17:04:10
1379c6ec504f348454796b0ac1d46025c183bb4e...1df87b95066198c30312147393c18e0be0564fd0,7,43,26,69,26,2014-09-25 22:24:38,2014-09-25 21:23:59
1379c6ec504f348454796b0ac1d46025c183bb4e...5630d466b28283c4d52ecfa5859a67112e8ccaa4,1,3,0,3,1,2014-09-25 19:51:02,2014-09-25 19:51:02
a7d61e0ffba4567d53f9c154cc7c060406d6ba3d...392eec20751bd1da7f84fa4974042eaa263a56d2,14,747,294,1041,142,2014-09-29 21:23:42,2014-09-29 21:23:42
392eec20751bd1da7f84fa4974042eaa263a56d2...532c29ef7deea38bed68506b785f067796a1836b,2,3,2,5,3,2014-09-29 21:35:25,2014-09-29 21:35:25
4c8b8861ecb6b47230e0e021760922e15e8afd3f...ecff6303a366a5e8fd178b7baa1c64895a3a3622,4,42,10,52,25,2014-10-01 22:55:29,2014-09-23 22:53:43
7c1aee62910405720f977e5777fafefc662dc175...32dca1a7b0e800d796e54fc8f253818ba64fa075,10,53,464,517,31,2014-09-29 22:40:26,2014-09-29 22:40:26
3f2e4e94d7dffe40a9cc1139cc2e6e5dcd1459f3...2c5b5cfc929c8d6ffaefcbc85d2c9ad16ad301b8,2,35,1,36,3,2014-10-01 14:34:36,2014-07-15 17:17:20
3f2e4e94d7dffe40a9cc1139cc2e6e5dcd1459f3...da34672de6b84fce801d8ffaf03b52bf66458a61,1,1,1,2,1,2014-10-01 14:14:48,2014-10-01 14:14:48
3f2e4e94d7dffe40a9cc1139cc2e6e5dcd1459f3...f10a08887e939936662071e5609670f7da9fb62c,1,1,1,2,1,2014-10-01 13:51:47,2014-10-01 13:51:47
1b6da6a6fe98ef2d67c50be3549244952743b5e7...9c201c5836fcee4455806a06fbada17cabd4296d,1,5,6,11,2,2014-10-06 13:49:33,2014-09-30 20:04:17
1b6da6a6fe98ef2d67c50be3549244952743b5e7...f5f4d2d9cbeefb1d896d987a87058eeb65b4ebf6,4,259,83,342,47,2014-10-01 22:25:02,2014-09-30 15:00:24
1b6da6a6fe98ef2d67c50be3549244952743b5e7...61c6f206b073159c5463a083e0d04e5934351dfe,8,181,107,288,29,2014-10-01 20:19:40,2014-08-26 23:21:04
61c6f206b073159c5463a083e0d04e5934351dfe...8a6c7100ea7f6ea82ba567863b6401f45766625b,6,1002,1,1003,6,2014-10-01 20:19:40,2014-09-30 17:42:44
8a6c7100ea7f6ea82ba567863b6401f45766625b...7c88e8f13d9f0c68de6da0cd467a541231304dd5,11,971,13,984,32,2014-10-02 01:26:06,2014-10-02 01:26:06
7c88e8f13d9f0c68de6da0cd467a541231304dd5...22e59009e491dc8b32b512e0d2297662d278af45,2,2,1,3,2,2014-10-03 00:41:57,2014-10-03 00:41:57
1b6da6a6fe98ef2d67c50be3549244952743b5e7...c8f3151aa6a0b68674aa68061b723424278a54c5,1,4,0,4,1,2014-10-01 18:05:12,2014-09-30 18:41:23
1b6da6a6fe98ef2d67c50be3549244952743b5e7...ee0b64f7a79b7d704110d1f541710ae6fba5eb37,16,32,16,48,32,2014-09-30 17:53:29,2014-09-30 15:23:20
e32b54fe35a8632f4d512e081c5325e36b67cf44...021ecb1d1355e8291a5a872c761a1e367072e308,7,126,11,137,13,2014-09-30 18:26:58,2014-09-17 18:36:51
bb4d24de06e96efea180bee9761dfa181b6439b6...de8ea06d7dab7c5278f84728f7e0aa69e3301ad0,2,26,0,26,3,2015-01-31 19:31:41,2015-01-31 19:28:11
0db6bb3cbf508edd89b83c60c242333b5f05d501...18a2c77435cdad8f759421500cba6ac20057daf8,10,22,13,35,19,2015-01-15 02:20:48,2015-01-07 04:23:32
0db6bb3cbf508edd89b83c60c242333b5f05d501...c18fdc37042dc7fb041475a524fe7abb0bd7afdc,2,31,12,43,7,2015-01-14 04:12:07,2015-01-14 04:09:11
0db6bb3cbf508edd89b83c60c242333b5f05d501...78820a63d647276cf17dac9ac71ed2beb19f285d,1,1,1,2,1,2015-01-13 20:57:48,2015-01-13 20:57:48
9305020d9f5471c15666cf7203dd1c0734987c72...c2a25058e8c85b4d6295c6a1375c0b70b0959260,1,7,10,17,3,2015-01-21 22:34:27,2015-01-21 22:32:36
c2a25058e8c85b4d6295c6a1375c0b70b0959260...606c71d424cb21c8256968eb5d965a0855d1af2d,1,58,1,59,4,2015-01-21 22:34:40,2015-01-21 22:34:08
9305020d9f5471c15666cf7203dd1c0734987c72...5e8285b08120f674b12a34c3f146216f6854a173,1,17,8,25,6,2015-01-21 02:04:22,2015-01-20 23:05:39
9305020d9f5471c15666cf7203dd1c0734987c72...51b5dc185b12c3447f1b69a705f7828242d10a2e,3,8,6,14,8,2015-01-20 23:26:04,2015-01-20 20:53:24
9305020d9f5471c15666cf7203dd1c0734987c72...e744b0dcbacd5e226fd79aba5a2e83f432d2d13f,4,54,13,67,8,2015-01-20 20:54:56,2015-01-16 19:48:25
5f5e02d22c2bd9793e35eb982592c37a65f37674...65f58e2a742205c9e8470b360bd439642a5c8211,8,155,0,155,17,2015-01-21 04:21:46,2015-01-07 22:43:04
65f58e2a742205c9e8470b360bd439642a5c8211...2640a10bca29c4a4199c906a26f658aac8a68dc2,7,340,10,350,25,2015-01-21 04:21:46,2015-01-08 00:22:42
2640a10bca29c4a4199c906a26f658aac8a68dc2...4f174aa79276c12a1b2b98df2f02d6bee36b7a93,14,191,94,285,60,2015-01-21 04:21:46,2015-01-08 02:02:08
4f174aa79276c12a1b2b98df2f02d6bee36b7a93...cc658804c000b8f652750ccf3233a73cc6f03073,1,60,59,119,6,2015-01-21 04:21:46,2015-01-19 21:20:58
cc658804c000b8f652750ccf3233a73cc6f03073...2d4fc1de0560c8052b4480035bb364fb28525b39,8,30,56,86,20,2015-01-21 04:21:46,2015-01-19 22:07:21
2d4fc1de0560c8052b4480035bb364fb28525b39...2f46b7601a3f5e11359b79624d73075b69778fbb,6,243,151,394,29,2015-01-21 04:21:46,2015-01-19 23:29:42
2f46b7601a3f5e11359b79624d73075b69778fbb...76141a00779880368b15ef2a5ffd28a80e4637df,7,180,4,184,9,2015-01-21 04:21:47,2015-01-20 00:10:26
76141a00779880368b15ef2a5ffd28a80e4637df...217a2bd1b62788e53fd38810b30672db58a4efc5,3,13,2,15,5,2015-01-21 04:21:47,2015-01-20 19:37:50
217a2bd1b62788e53fd38810b30672db58a4efc5...4b173199fde99a2b275421ed070b0ec004730e35,3,16,10,26,7,2015-01-21 16:55:23,2015-01-21 02:13:47
5f5e02d22c2bd9793e35eb982592c37a65f37674...f46923be8eba81dd9e261554128b26a1c83ce398,3,78,2,80,4,2015-01-21 03:52:08,2015-01-21 03:37:21
f46923be8eba81dd9e261554128b26a1c83ce398...681f4d84ae05a98b7096d52a168222bae362d9e1,1,8,11,19,2,2015-01-21 03:52:08,2015-01-21 03:40:19
8ac075b846609f73ad8aa29d6e9dbb6cd2392293...a92281637f5b629e110b5bd074566bb6c302bb62,2,33,9,42,7,2015-01-14 20:54:23,2015-01-14 01:30:49
fac1213ecb8a8e9292615ba4da0e466d55d1a042...6292354dc359a6d8f47b3199284147d557d2c697,1,1,1,2,1,2015-01-09 22:03:11,2015-01-09 22:03:11
c9dab702bed3ffd6335a61df74b73e89b44fcbf9...b5aba426d4bb903825ec4b3b4912f521daac4c2a,2,2,4,6,2,2015-01-14 04:35:21,2015-01-14 04:35:21
c9dab702bed3ffd6335a61df74b73e89b44fcbf9...d5df948829bfd6e12dc2c0ca3228b583386b6e87,8,16,1,17,8,2015-01-14 02:40:14,2014-12-29 08:19:42
283597ad37446ccad57f6ba881652ee6f67e576e...573cd092a5f467d0fab1acbd9cc0b80040cae565,2,1,27,28,4,2015-01-26 14:15:32,2015-01-23 22:15:35
f1bc0376b822128888a825c5607cee1d861e1c0b...06af013f8bdf5c9af85c4b3f158292d79ab644a5,3,45,3,48,6,2015-01-22 00:28:19,2015-01-21 16:14:30
06af013f8bdf5c9af85c4b3f158292d79ab644a5...007ef161b45dd91afcfb7ef9cd32e6c88dbf196e,2,51,0,51,5,2015-01-22 00:55:05,2015-01-22 00:55:05
007ef161b45dd91afcfb7ef9cd32e6c88dbf196e...a34a7930b5c1e9a1e6ddd4a40b1810a86f7d24ab,2,2,0,2,2,2015-01-22 18:29:15,2015-01-22 18:29:15
a34a7930b5c1e9a1e6ddd4a40b1810a86f7d24ab...42612ff6dba2d885a0c55af80128201a4d5166cb,1,29,0,29,2,2015-01-22 18:51:04,2015-01-22 18:51:04
42612ff6dba2d885a0c55af80128201a4d5166cb...d55e977cf5963f8ae5efdfbee458727f704be398,1,15,7,22,6,2015-01-22 19:22:31,2015-01-22 19:22:31
f1bc0376b822128888a825c5607cee1d861e1c0b...1820003078eeae6ab25e2440669c490caff59b57,1,4,1,5,3,2015-01-22 00:25:01,2015-01-21 03:19:11
1820003078eeae6ab25e2440669c490caff59b57...614e09a8c7990e05509edb4c335c4b59001cea61,1,38,0,38,1,2015-01-22 00:25:01,2015-01-22 00:12:02
f1bc0376b822128888a825c5607cee1d861e1c0b...12d83e727dd3522006b53afbcfac3cdce178117a,2,2,1,3,2,2015-01-21 23:14:01,2015-01-21 17:44:24
12d83e727dd3522006b53afbcfac3cdce178117a...4e4a5b25328566efad9ade3e7e0737ba48c090ab,1,9,2,11,3,2015-01-21 23:14:01,2015-01-21 22:16:39
2feb2d07b6f98364a585d82af250d32664fd8df3...8ec6c692dba14b7d95acd2c56e4fd8b020151ce1,2,30,30,60,17,2015-01-20 18:13:58,2015-01-20 18:13:58
2feb2d07b6f98364a585d82af250d32664fd8df3...d821c63e0d5fe2abe10ff885de6298acc4db956e,1,12,9,21,3,2015-01-18 09:27:16,2015-01-18 08:02:47
9b0072a7e63f560614fb9ba1b454b444cf4fe13e...21a809d9ae0ef8392f37c9262dca93ff31966e22,10,275,2,277,13,2015-01-13 03:27:17,2014-10-05 02:47:54
9b0072a7e63f560614fb9ba1b454b444cf4fe13e...71b03d8aeb76b50ca05116c04ad724f380ef08f3,1,1,1,2,1,2015-01-13 02:56:53,2015-01-13 02:07:16
9b0072a7e63f560614fb9ba1b454b444cf4fe13e...009041cdfd815c0ab49493f9f5757b171ee8c987,5,47,5,52,8,2015-01-13 02:12:59,2015-01-13 01:36:06
2677f1add48961115f08016da422d74cafbf4c8b...b20363c4c056bebe256f0d53283ca1e537ed5cf6,2,5,4,9,2,2015-01-09 16:54:58,2015-01-09 06:09:06
bb4025c4e206cf46de3ba3267efb3df96db45b91...667dc58c3929112a2b8b8bc67ae54a394169c6df,1,2,2,4,1,2015-01-28 00:40:11,2015-01-28 00:40:11
d748ec31d5f89f4cbe363ac9b38310906bf2a9e0...7d62943178e803663b4939666377b75a21d3e537,1,10,2,12,4,2015-01-30 22:37:44,2015-01-30 22:37:44
d748ec31d5f89f4cbe363ac9b38310906bf2a9e0...403d981d70dc8a493a9a10be4b5d2e2ce871f380,8,127,129,256,34,2015-01-30 22:20:32,2015-01-30 22:20:32
d748ec31d5f89f4cbe363ac9b38310906bf2a9e0...e9f6f1a930b74c6b06f257eac838d062bbdd0d16,3,109,1,110,4,2015-01-30 05:28:20,2015-01-30 05:28:20
e9f6f1a930b74c6b06f257eac838d062bbdd0d16...3414307306dc1780f80c5ca5e9dd7a8822e27eec,2,0,2,2,2,2015-01-30 17:37:50,2015-01-30 17:37:50
9e10a888a3d4c804eb4a2aebcf0467b8ae0e4076...080a6f1e4b7c33ce9b7b1b90cbf8fd90658226c2,1,5,0,5,1,2015-01-29 18:19:18,2015-01-29 18:19:18
8dbaed1d9630d8170e6ad464bb3344fc9049a7a6...e7f6433109fad4762379aed88ae70da36805f198,1,0,2,2,2,2015-01-29 22:50:42,2015-01-29 22:50:42
00d19150bb937bcc4572edf1f397d4051abb37c1...bf14bacac3f1cae15ce7b32b5341122c305e630e,1,1,1,2,1,2015-01-16 22:36:50,2015-01-16 22:36:50
f3aed2a2974bba4fdca947227d877bcc2c7d540b...4d7707e183e8dcb8e0ab1415e401cb530df17c92,1,31,13,44,5,2015-01-22 00:00:15,2015-01-21 20:14:28
f3aed2a2974bba4fdca947227d877bcc2c7d540b...58c142bcfa2b9edce7efe72d393e9f90b9df9927,2,10,5,15,2,2015-01-21 23:08:32,2015-01-21 20:11:53
f3aed2a2974bba4fdca947227d877bcc2c7d540b...db9b1e3654464b0e7008fbad15d43fbbba87b1a4,6,11,12,23,10,2015-01-21 19:44:23,2015-01-21 19:44:23
f3aed2a2974bba4fdca947227d877bcc2c7d540b...811b138f7e6c742b821da15e34338651f33f9ec2,2,8,20,28,5,2015-01-21 19:25:35,2015-01-21 17:04:43
06da161aeeb6b458cac2db44db6e3af59d091402...4bb113f24e1ea12ab7ab9ddfe0508e4f833445e5,1,86,5,91,11,2015-01-21 08:15:30,2015-01-19 17:35:40
06da161aeeb6b458cac2db44db6e3af59d091402...a687e8d86ba07ebb42d988b6e13102569b60e673,1,11,0,11,1,2015-01-20 18:31:12,2015-01-20 17:00:04
a687e8d86ba07ebb42d988b6e13102569b60e673...0c8be9da3763d86c2a6e847e1667410056d6071d,1,9,2,11,2,2015-01-20 18:31:19,2015-01-19 19:43:19
fcc4abc870e7f62590e418f10ff6f743a47fad12...9c7689a10e60cd921e1521c729c07184b7c1076c,1,1,1,2,1,2015-01-22 01:15:34,2015-01-22 01:15:34
fcc4abc870e7f62590e418f10ff6f743a47fad12...d25a65375c880017ac0c516389b0b7afde810517,32,464,296,760,101,2015-01-22 01:11:31,2014-12-16 23:06:35
92a9b87a57069422779e3d1a8fd9cf43d17720b0...9b5e6d40f5996a13f8e45e63f9dd4a9acae6061a,1,2,2,4,3,2014-10-07 05:54:30,2014-10-07 05:54:30
12203e475de1da4c6c58b52cc458e353f2b7ea3a...50fa9dffcf023c81f3142f0ddd294db4ac6b8281,3,111,6,117,5,2014-10-07 23:45:35,2014-10-07 22:39:50
7304c09ecc8cd7c97ca1a30e97f8e2a206e8b737...d0f12a0f7379b95e848c773fa16dd706a49197c6,1,1,1,2,1,2014-10-21 01:46:39,2014-10-02 01:26:36
7304c09ecc8cd7c97ca1a30e97f8e2a206e8b737...aabba9801a63228bb2e5144c8688b60e4d429ac2,1,12,0,12,3,2014-10-02 15:37:13,2014-10-02 15:37:13
7304c09ecc8cd7c97ca1a30e97f8e2a206e8b737...7f261ebe6cc60c01fd10f5f86f1c22d512be3f5f,1,2,2,4,2,2014-10-02 01:11:10,2014-10-02 01:11:10
f69a262464bd9d6dccb1d059b3a84c6ef9587a87...f440c6b2246cc4cfac4c5d351172e209dca2c765,10,53,15,68,14,2014-10-04 03:33:12,2014-10-02 23:58:53
f69a262464bd9d6dccb1d059b3a84c6ef9587a87...98ceae1a8499979f725bd04dfbc47ccf831331a7,1,26,5,31,8,2014-10-03 12:18:25,2014-10-02 18:16:51
516c72d71b941f38c14d2d92482f65bda7a875aa...86bfb9bca6a5e1e78b01741b076505c137f52673,2,86,1,87,3,2014-10-03 18:18:25,2014-10-01 02:06:31
8a0733ce69a12cd129953b903c106ac0f85b818d...88e21c6a75310da158bbee3a5fdc135697c93ba1,6,54,1,55,11,2014-10-03 20:22:38,2014-10-02 23:46:06
8a0733ce69a12cd129953b903c106ac0f85b818d...3eaa1c99c1acf8758175658450d58b15ddf0764a,1,1,1,2,1,2014-10-02 22:52:37,2014-10-02 22:52:37
7813f85e7d6ef4194cee1c1a5d32b649c6483287...30cfa148b9b4bfe390cbd7936e77efe2962bd506,1,23,46,69,9,2014-10-14 00:17:41,2014-10-14 00:17:41
7813f85e7d6ef4194cee1c1a5d32b649c6483287...3b9d88210e763bebdfd7badb6ed3fd507d0f6513,2,45,13,58,10,2014-10-08 16:53:43,2014-10-08 12:41:26
7813f85e7d6ef4194cee1c1a5d32b649c6483287...9ced509e6d89d1ab4e0c4b49485be7931b505354,2,27,34,61,7,2014-10-07 20:19:02,2014-10-07 20:04:06
9ced509e6d89d1ab4e0c4b49485be7931b505354...acd511786e5d9d2aa440f4265ed8d4dda149d1cc,1,62,22,84,19,2014-10-07 23:51:51,2014-10-07 22:35:32
acd511786e5d9d2aa440f4265ed8d4dda149d1cc...dbe6c6651e744bd6f6cab04fcaed2871779d36a0,2,37,17,54,5,2014-10-08 22:15:51,2014-10-08 00:58:39
7813f85e7d6ef4194cee1c1a5d32b649c6483287...053c3557b3198466ecfbe066fefdbab2a78771d5,2,2,1,3,2,2014-10-07 18:09:08,2014-10-07 18:09:08
7813f85e7d6ef4194cee1c1a5d32b649c6483287...c95b0e02928e28c0bd5400b58b6ed043c1bbff23,1,1,1,2,1,2014-10-07 15:29:47,2014-10-07 15:13:17
04251b3e544d82db2dfc140bd27172a7f1876e5e...34672240b4e69f5f50448e462540bb0259eecf31,1,1,1,2,1,2014-10-01 21:18:23,2014-10-01 21:09:54
ffc499dbabdef0cdfeb5e71b96b445efa6f12c2e...823cb1281060981a537b4d36315bf0a02074b2a2,1,5,0,5,1,2015-02-06 22:50:51,2015-02-06 22:36:11
fcdfc8ccc86044f06da0b47dc028894fe3ea25f9...8d7683af864be7e8e15442a354653d7a0c0f645b,1,0,1,1,1,2015-01-31 21:21:06,2015-01-31 21:21:06
fcdfc8ccc86044f06da0b47dc028894fe3ea25f9...843f3045bd84987dc9410425b1c116dd957b38c5,2,69,41,110,19,2015-01-31 20:54:57,2015-01-31 01:26:00
5862422a49fd8585a74630cf99792a1b3851a2e7...79d30364c95f13b9ff2ce3b4df9bb70d2ddd41f0,2,29,5,34,6,2015-01-14 04:28:44,2015-01-13 23:19:12
5862422a49fd8585a74630cf99792a1b3851a2e7...28cf8fddd4c19e98fd0a6fcf0a6e7ea545521412,2,124,2,126,3,2015-01-14 00:03:25,2015-01-13 23:33:05
5862422a49fd8585a74630cf99792a1b3851a2e7...f9876dade26fd779c1cb0e2156e635c85c6e8ee2,3,0,0,0,0,2015-01-13 22:31:25,2015-01-13 22:31:25
5862422a49fd8585a74630cf99792a1b3851a2e7...02923d43e20f7be6c2e1ed48846d188a682ff919,3,38,111,149,38,2015-01-13 21:43:31,2015-01-13 21:41:34
f67c6d313b971a068262a09840f7afdf4d34b292...67588d0ec4d73a8f2efb150d555c38b7ebfca7f6,1,9,0,9,1,2015-01-15 15:54:45,2015-01-14 22:47:17
f67c6d313b971a068262a09840f7afdf4d34b292...02246d2d9f9fe8eb040d1eb1ac4b7a84c3f3f059,2,26,0,26,2,2015-01-15 00:49:08,2015-01-15 00:44:53
f67c6d313b971a068262a09840f7afdf4d34b292...798215af24953f5e3dcacb08965f3714b2fd903f,1,2,0,2,1,2015-01-14 22:40:07,2015-01-14 22:40:07
f67c6d313b971a068262a09840f7afdf4d34b292...5ce60217f1ba07015af72978e715a08259e2efc1,1,2,2,4,2,2015-01-14 22:01:36,2015-01-14 22:01:36
5ce60217f1ba07015af72978e715a08259e2efc1...bb96e53b0f947a31a4b66e76607eed0097917ed5,1,2,2,4,2,2015-01-14 22:03:00,2015-01-14 22:03:00
bb96e53b0f947a31a4b66e76607eed0097917ed5...a75b02fe72f3da73f9788919ff2c22f183978db7,5,10,10,20,10,2015-01-14 22:12:03,2015-01-14 22:12:03
8ba4484084b573874331797d3590ea7cd57421f5...cdc14c7cbf3ad912588e8cc51f798183f369c9cc,1,1,0,1,1,2015-01-10 02:22:19,2015-01-10 02:22:19
8ba4484084b573874331797d3590ea7cd57421f5...d43f0b9fc5ec3eae816466ec0307682c13945b31,10,53,57,110,24,2015-01-10 00:28:40,2015-01-10 00:28:40
94e169b44f3bcc346c7d0f9a733a8c76f1eace55...b3dfe1a63a51639400e691939b0879e9b0807703,1,5,0,5,2,2015-01-26 19:19:29,2015-01-26 19:01:40
94e169b44f3bcc346c7d0f9a733a8c76f1eace55...b4283209d55289abb2c5b63df949a27c2704f5af,1,5,7,12,1,2015-01-26 17:38:20,2015-01-23 19:14:52
e15300b251e813cd8b262832fccc8af475979f1c...ab589b442d55597de74201729ba893977ea73b7f,1,20,16,36,6,2015-01-27 18:21:35,2015-01-27 18:21:35
10ab6dcb4f8f63ffab44023d286403c494fa24b8...a124bfaef37a9d209de881325dbe653d9b07ef4d,1,3,0,3,1,2015-01-22 22:28:35,2015-01-22 20:58:59
10ab6dcb4f8f63ffab44023d286403c494fa24b8...02a793c6a133f46129d0fc83ce218d3a92f1e644,1,40,25,65,8,2015-01-22 20:37:39,2015-01-07 13:08:34
02a793c6a133f46129d0fc83ce218d3a92f1e644...6ca2875e580e16a309eb9c9486bb358bde3622ff,1,3,3,6,2,2015-01-22 20:37:39,2015-01-08 22:19:23
6ca2875e580e16a309eb9c9486bb358bde3622ff...048b20e58a1b9d516dd6fb34676d765ebd5a8959,1,1,1,2,1,2015-01-22 20:37:39,2015-01-08 23:24:59
048b20e58a1b9d516dd6fb34676d765ebd5a8959...a51554988e615b317e95125f5612a28c3bff8e8a,1,3,3,6,3,2015-01-22 20:46:01,2015-01-22 20:46:01
9f2c48614497dee2448b65c81aa6d44953484372...12a7e78b125afd277adb7cd099817a419f4faaa0,2,15,11,26,4,2015-01-13 14:23:13,2015-01-09 19:57:05
9f2c48614497dee2448b65c81aa6d44953484372...00bd7b4c414061d71d7f94b5850cbe132da623f0,1,8,4,12,2,2015-01-13 07:40:24,2015-01-13 07:24:01
9f2c48614497dee2448b65c81aa6d44953484372...9a9339d9a23e0005b769bd2f44c722c4a6be730f,1,23,0,23,1,2015-01-13 07:16:28,2015-01-09 23:42:55
9f2c48614497dee2448b65c81aa6d44953484372...e721ed9b5319e8e7c1daf87c34690f8a4e62c9e3,1,1,1,2,1,2015-01-13 05:05:30,2015-01-07 07:16:04
d400ac756cae9c937089f9f20bcc75826e99ea67...743c9ba1fb1d946ac99bc86fb573341b2d5a0a8b,1,20,14,34,8,2015-02-20 01:53:39,2015-01-29 15:28:44
d400ac756cae9c937089f9f20bcc75826e99ea67...f73a6b3845a498107cfb22e4d962f0a30870e7c6,1,18,0,18,2,2015-01-30 15:50:27,2015-01-30 15:50:27
d400ac756cae9c937089f9f20bcc75826e99ea67...0ce3a49d64bcfd81823fe0e9bf54c51ddf6e35d4,7,33,16,49,10,2015-01-29 10:50:43,2015-01-29 10:35:37
5b9b5aff06aa0e2c8397ee4cfb62e7f1ea249e0e...7d7a002e51a1a1172f09741896f0a6c001438a49,1,2,6,8,2,2015-01-30 16:16:17,2015-01-29 18:36:56
78b7a484db5ac876e116eb248f1ba538bcc426a2...da01690a0a22ced060d4fb4fc46cb545ff1604df,2,2,2,4,2,2015-01-17 04:46:01,2015-01-17 04:46:01
649ad2d56e303013e43ef374083d97556eb94499...bbc38497b6f522b0a9c4e5e976abfd79692b8b5f,1,43,23,66,6,2015-01-21 23:33:53,2015-01-21 21:42:31
b1f2fdeee213c437a363db9eda235444ffdcc4a5...dcfa881a7b12e9a737b25ada98ec0c76e58c9c9c,1,1,1,2,1,2015-01-27 03:19:02,2015-01-27 03:19:02
b1f2fdeee213c437a363db9eda235444ffdcc4a5...f709da192cda47c9aaaa212b03442d4f28afdb97,2,3,3,6,2,2015-01-27 01:13:44,2015-01-26 13:29:49
b1f2fdeee213c437a363db9eda235444ffdcc4a5...6bbf19dfbe44a06dadb755e08069b5ee031f5312,1,0,0,0,0,2015-01-26 06:11:20,2015-01-26 06:11:20
3c77e7d63446f0e0b133010fb3731af5556628bb...05d04843e6b80f131c07882c882f7e4da018a306,1,9,0,9,2,2015-02-09 19:01:12,2015-01-22 15:22:40
3c77e7d63446f0e0b133010fb3731af5556628bb...54c10fe81d1894f9683293601a53a0d87a0d7fbd,3,9,0,9,6,2015-01-23 14:52:04,2015-01-22 14:06:21
3c77e7d63446f0e0b133010fb3731af5556628bb...aac6090f2df3cc9192d1813e3c1f48b882f063d4,1,6,1,7,1,2015-01-23 08:36:55,2015-01-23 08:36:55
3c77e7d63446f0e0b133010fb3731af5556628bb...99dc224d850a8838f42b9f41229b484197f75fa5,1,1,1,2,1,2015-01-23 00:43:57,2015-01-22 09:07:20
3c77e7d63446f0e0b133010fb3731af5556628bb...752a0d6f34ee3c92dc877273c33b8cd0239fda71,1,3,9,12,4,2015-01-22 19:06:24,2015-01-22 18:59:32
3c77e7d63446f0e0b133010fb3731af5556628bb...4d10b32380793ce5e324a429ce2db60125aae205,1,1,6,7,2,2015-01-22 07:36:20,2015-01-22 07:36:20
3c77e7d63446f0e0b133010fb3731af5556628bb...51060ee07aaf3ff10ac7187558bd665f4ddd3507,18,630,0,630,18,2015-01-22 02:37:08,2015-01-21 19:52:35
3c77e7d63446f0e0b133010fb3731af5556628bb...9e37a04665395cb98687cd09b05ba33736984547,1,66,0,66,1,2015-01-22 02:35:51,2015-01-17 02:52:27
3c77e7d63446f0e0b133010fb3731af5556628bb...c97d8b1233bc17a9e58ce97473329ab5de59969a,1,1,1,2,1,2015-01-22 02:07:10,2015-01-22 02:07:10
34c804a139cc086e9fa6d3f99442f083b6d5e1e7...10c3d9f80fa1584ea37eb0465748d35341d9d227,1,1,2,3,2,2015-02-06 22:04:21,2015-01-14 23:26:42
10c3d9f80fa1584ea37eb0465748d35341d9d227...2a3225eb82274d245c25fc6191945dde1f25f668,1,27,0,27,2,2015-02-06 22:05:08,2015-01-15 19:03:46
2a3225eb82274d245c25fc6191945dde1f25f668...0f8f04a77492ddf37ca9c163ef0c3ddaf8a93a40,1,4,4,8,2,2015-02-06 22:05:08,2015-01-15 19:06:35
c2428ff8653cba5bb3aef4ace7066fa6fdb916b0...a36ba19ccad8ea551a912ce16921af89d9e59012,1,15,1,16,2,2014-10-08 01:26:48,2014-10-08 01:23:54
60908acff6753a9a74cef011ca53d720997f019a...de32f48e6668e9f071272d588cf6acdd7090b9ca,3,15,4,19,6,2014-10-08 02:37:08,2014-10-08 02:07:51
88e21c6a75310da158bbee3a5fdc135697c93ba1...103a4e0676f0099759e6f9a29ea1c9dc32766806,1,3,1,4,4,2014-10-03 20:46:24,2014-09-29 22:51:36
103a4e0676f0099759e6f9a29ea1c9dc32766806...ab4188c08d9eb63c84c461a9b922f2af479b5a04,1,4,4,8,4,2014-10-03 20:46:24,2014-09-29 23:52:27
ab4188c08d9eb63c84c461a9b922f2af479b5a04...deffc572ced3909c0ecd77dd21686e0e67c0ea33,1,41,5,46,7,2014-10-03 20:46:24,2014-09-29 23:56:10
deffc572ced3909c0ecd77dd21686e0e67c0ea33...a4875937293f3b0a8ffc569608bbca40a456e9c8,4,84,44,128,18,2014-10-03 20:46:24,2014-09-30 00:06:26
a4875937293f3b0a8ffc569608bbca40a456e9c8...f1087c5fcf070f151601f643418f3963facfea84,1,10,0,10,1,2014-10-03 20:46:24,2014-09-30 00:10:15
f1087c5fcf070f151601f643418f3963facfea84...b669025949f1dba1ad3af9bab6711736863d6e24,2,15,3,18,8,2014-10-03 20:46:24,2014-10-03 20:29:09
06b74875b6e5197f7ead3655a3fda91ee38ec58b...ee101c3b2c9efdd0f11e4e96659db18ada3734c8,1,71,90,161,47,2014-10-03 20:28:43,2014-10-03 14:38:22
06b74875b6e5197f7ead3655a3fda91ee38ec58b...ed55a2db06c7343f00a71844b166da1bbfbb812d,1,5,2,7,5,2014-10-03 14:17:42,2014-10-03 14:17:42
06b74875b6e5197f7ead3655a3fda91ee38ec58b...6480b30a997a8fe9884504f669b9c5a68d887f55,1,2,2,4,2,2014-10-03 04:13:59,2014-10-03 03:58:50
06b74875b6e5197f7ead3655a3fda91ee38ec58b...c5e728c953e29b8008cdfb8367910e33ba28b99c,2,19,6,25,6,2014-10-03 00:46:17,2014-10-03 00:46:17
06b74875b6e5197f7ead3655a3fda91ee38ec58b...c68e6b15a5d128eee1637c55471907d90cb828d2,2,27,20,47,4,2014-10-02 23:39:39,2014-10-02 23:39:39
c68e6b15a5d128eee1637c55471907d90cb828d2...3e473c08b479e3ad783b31ad564f46ab87c8f034,1,3,1,4,2,2014-10-06 18:18:25,2014-10-06 18:18:25
e4976b8cc1236730ed52fc4e798f1be836364c28...ae4689f14d59ece06bbd2a08a9687dc075e42d6d,2,23,5,28,5,2014-10-14 03:54:32,2014-10-14 03:54:32
e4976b8cc1236730ed52fc4e798f1be836364c28...e0a1df8e683879bb999623a9521b272aafcc4208,1,1,1,2,1,2014-10-14 03:34:24,2014-10-14 03:34:24
4eb812e042e10e8158161ba7d6236a9ca8044ebe...5e6f16e34264fa81205c8becbdcd401823261056,2,4,4,8,3,2014-10-10 01:18:12,2014-09-30 08:57:17
5e6f16e34264fa81205c8becbdcd401823261056...c496f24157afd81c9a26f5746175236485e97fa7,1,40,0,40,2,2014-10-20 03:10:31,2014-10-20 03:10:31
4eb812e042e10e8158161ba7d6236a9ca8044ebe...4c6b7cd1b560c72f2c79c28f77644f05b3ee657e,5,7,30,37,9,2014-10-09 20:17:47,2014-10-09 20:17:47
4c6b7cd1b560c72f2c79c28f77644f05b3ee657e...b66ac6a80990d382a3859cd5ca8c53f038bdc1ff,4,1,65,66,4,2014-10-09 20:46:21,2014-10-09 20:20:38
01864d3281aa2596fecf2cdfb30c804a86e72aab...8bfdad9a0dee26b45b15f985977769ef37888f8a,3,9,2,11,4,2015-01-31 23:12:34,2015-01-31 00:11:47
f8331f700babd58d9759f9d0d7d1cb2de0d14346...dd0bebde026b02c67d1a8aa0b9464efbe7fafe26,1,1,1,2,1,2015-02-01 09:38:20,2015-02-01 09:38:20
18d8fe12494197773727c5d1a866e2d82d6e5602...e22793fb46fb9b494ea7faefd26528c65504a382,1,1,1,2,1,2015-01-31 17:06:20,2015-01-31 17:06:20
18d8fe12494197773727c5d1a866e2d82d6e5602...cb3be586d6fa9c504f8575a832b19e8e3b2e64c2,1,1,1,2,1,2015-01-31 17:02:09,2015-01-31 17:02:09
18d8fe12494197773727c5d1a866e2d82d6e5602...50c3ffd00969f8b1f2a00849973f2587984a26bf,1,1,1,2,1,2015-01-31 16:37:27,2015-01-31 16:02:11
18d8fe12494197773727c5d1a866e2d82d6e5602...267b56bd337475dab23add65f984dc2f1f93b897,1,1,1,2,1,2015-01-31 15:18:50,2015-01-31 15:09:45
18d8fe12494197773727c5d1a866e2d82d6e5602...a131eb55d4f42f3f1e21ac3293f52d3989849568,1,1,1,2,1,2015-01-31 12:15:59,2015-01-31 12:09:07
5136b11514b4d891334c06a0692c5deeecfd5b32...409407091a7282d0c4086b71e86397e2d089ba13,11,62,1,63,19,2015-01-14 23:41:31,2015-01-13 21:52:51
5136b11514b4d891334c06a0692c5deeecfd5b32...e7cfb1c28b2a52f34c8e48ede2e24645991d1104,2,4,2,6,2,2015-01-14 17:55:35,2015-01-14 17:50:58
91b5634deeabb90eaa41d8d47802746bbe19e512...41178adb7e4e3df27c99c462b069dc9c196af2c3,1,3,0,3,1,2015-01-13 00:24:15,2015-01-11 05:01:53
91b5634deeabb90eaa41d8d47802746bbe19e512...5b8c8b1819d0f2dcbe7d708b1ae8f579a73401bd,1,3,0,3,1,2015-01-10 06:25:53,2015-01-10 06:25:53
91b5634deeabb90eaa41d8d47802746bbe19e512...f29ee870512e8809bfc396c1771fd74235c9de7b,2,4,4,8,4,2015-01-10 04:24:54,2015-01-07 16:19:14
f29ee870512e8809bfc396c1771fd74235c9de7b...807f486f874d87adb423d486944f5dc59842f1eb,1,2,2,4,2,2015-01-10 04:31:38,2015-01-07 16:19:52
807f486f874d87adb423d486944f5dc59842f1eb...cd5902fc7bb0da36fedb6ff6a1bb8ef200b212d9,1,1,1,2,1,2015-01-12 19:49:52,2015-01-12 19:49:52
a3c5223b2a7f2a31c77910e93c2229bf01c41955...44f4c95c0ece887023d3ad7ab9c4f147c81d9d3f,1,21,21,42,11,2015-01-26 19:16:29,2015-01-26 19:16:29
b3402f34b2049a0e82a061640f04c707b8cca99b...71f8b09543d782727ada8f63ba7d6fa177ec54db,1,1,1,2,1,2015-01-28 01:54:40,2015-01-28 01:23:57
3466baafc16ff4592f2b5714dd74f781d67487bc...9c744cb454f7d912ae1dd6215caf550a25929944,2,9,7,16,4,2015-01-22 07:06:46,2015-01-22 03:58:43
5a6f84ce089f7a562010564ad7e2ebcb60a39d5d...47769994e5cba81a96529b418052afce7a6d51a3,1,4,2,6,1,2015-01-22 22:42:17,2015-01-22 22:42:17
a51554988e615b317e95125f5612a28c3bff8e8a...eaf1b88212bb10019cf1d7b1555a305c12001f06,2,11,4,15,3,2015-01-23 02:31:39,2015-01-23 02:17:55
6e5c5d33dd6efd65f6d6239099acb2be989423c5...9f59b057be25656214d65040ae113c0d76d99324,1,26,1,27,1,2015-01-13 17:10:50,2014-12-21 00:16:19
9f59b057be25656214d65040ae113c0d76d99324...18c0b415644b594969bbec49de51098be62d18f8,1,1,0,1,1,2015-01-13 17:10:50,2014-12-21 00:25:15
f207dd5e7c3a99b1f26014a575197e8b9cc41ed8...7c7c7f84dcc985dfac5aac5004d39d15e35f7812,2,39,1,40,2,2015-02-24 11:28:40,2015-02-24 11:28:40
f207dd5e7c3a99b1f26014a575197e8b9cc41ed8...33fa1978799599f48694680ad6f73b7ecfaa924d,2,44,10,54,16,2015-02-23 23:16:30,2015-02-22 18:48:09
f207dd5e7c3a99b1f26014a575197e8b9cc41ed8...3346c2e4d9ce0cf92b056b6ddc883adf5b8beddd,5,30,6,36,6,2015-02-23 22:32:25,2015-02-22 05:20:03
f207dd5e7c3a99b1f26014a575197e8b9cc41ed8...f37351f9e88e077b2a1b219cd412e781ebb2ef9c,1,2,2,4,2,2015-02-22 22:51:32,2015-02-22 22:51:32
f207dd5e7c3a99b1f26014a575197e8b9cc41ed8...47a847bca8aa91f55c6b18c726bd4a6d960322d1,1,1,0,1,1,2015-02-22 21:59:41,2015-02-22 21:44:51
f207dd5e7c3a99b1f26014a575197e8b9cc41ed8...4c7d41ac180bba52bf567515bf9f033ecfa70de7,1,3,3,6,3,2015-02-22 20:47:39,2015-02-22 01:06:52
f207dd5e7c3a99b1f26014a575197e8b9cc41ed8...811132f4b95817b26d28c5e182d3f6f6d62f45bf,1,1,1,2,1,2015-02-22 20:47:22,2015-02-22 20:39:43
f207dd5e7c3a99b1f26014a575197e8b9cc41ed8...c28d33ff5071a34ad1fd051a6a45308a8a89f5ed,1,1,1,2,1,2015-02-22 19:43:51,2015-02-22 19:43:51
f207dd5e7c3a99b1f26014a575197e8b9cc41ed8...29b62053c45e2a608748c0beb5e240f653b27062,1,1,1,2,1,2015-02-21 18:25:37,2015-02-21 16:42:27
f207dd5e7c3a99b1f26014a575197e8b9cc41ed8...7122b6643e4124db3d37b3b46f4741a97ba03611,1,4,3,7,1,2015-02-21 12:21:57,2015-02-10 18:45:50
c12fb48a8a7df71ec3b952800ead1f21aea9ada6...29ac29a4361e0392979ad6a99341bff174f76967,3,34,8,42,8,2015-01-30 09:30:42,2015-01-23 12:17:05
c12fb48a8a7df71ec3b952800ead1f21aea9ada6...80b843b7313234f56ffd9881bd50a56d85b52e7f,1,18,12,30,9,2015-01-30 00:01:05,2015-01-29 21:40:09
c12fb48a8a7df71ec3b952800ead1f21aea9ada6...e636df8d9637514e125afe7418a3b98e5270858f,1,4,38,42,5,2015-01-29 21:52:59,2015-01-29 18:57:30
c12fb48a8a7df71ec3b952800ead1f21aea9ada6...4ff56bbddf23c64586920a8861f75c3d35413e49,1,1,1,2,1,2015-01-29 19:49:28,2015-01-29 18:51:13
fb55c0ecc6e1694e13787928ccbb6bcbec17cd00...726f89d77a575c6a121829eb8fe63c1d3d6452fe,3,47,2,49,11,2015-01-31 06:36:04,2015-01-31 06:21:34
726f89d77a575c6a121829eb8fe63c1d3d6452fe...6816d27591a24b7a3a5b2e4c85294abffda977a2,1,2,2,4,2,2015-02-09 22:51:48,2015-02-09 22:51:48
fb55c0ecc6e1694e13787928ccbb6bcbec17cd00...6a1da678de2150a0dcf943614b6c1a1a2012ab38,1,2,2,4,2,2015-01-30 16:20:50,2015-01-30 16:20:50
a98355561d23a6b02d5c8d8c94e6ff54866efabf...14131b65c41ee9f562c3311e533e0f7d9c9de97b,1,236,167,403,22,2015-02-13 17:47:58,2015-02-10 00:57:52
a98355561d23a6b02d5c8d8c94e6ff54866efabf...1ce9fa1c601cc6f09f9a39df535515aec355e95e,2,15,10,25,5,2015-02-09 17:45:50,2015-02-09 14:59:05
a98355561d23a6b02d5c8d8c94e6ff54866efabf...35d48258384a07affac6f49b89a70dd7ffa60428,2,54,1,55,2,2015-02-09 17:33:58,2015-02-09 16:17:41
a98355561d23a6b02d5c8d8c94e6ff54866efabf...10a28da8fd5e4e7b29864e98965eed5f2fbd6b7c,1,1,0,1,1,2015-02-09 16:30:09,2015-02-09 16:30:09
a98355561d23a6b02d5c8d8c94e6ff54866efabf...5c7a947b3c12a7cba52ee7813d483f56cea1b8b7,1,2,0,2,1,2015-02-09 14:09:51,2015-02-09 14:09:51
3b0326fc81bee04f0b40047be0f99f1b71a4de90...2f5919966af49cd530a60c01b21ddd00c888f207,1,1,1,2,1,2015-01-30 17:44:42,2015-01-30 17:31:41
4245952f79106acd0f8125ad05b5f7560f7ae524...44cde56333fe891e087b8aa5ba914345bbdedbc0,1,2,0,2,1,2015-01-18 15:17:49,2015-01-18 15:17:49
4245952f79106acd0f8125ad05b5f7560f7ae524...a738df0354cc615c8d0fa3254621b3db811fe0b9,3,82,44,126,17,2015-01-17 12:14:25,2014-12-18 14:57:36
4245952f79106acd0f8125ad05b5f7560f7ae524...b8f7526fc6333e5b67282e5b73eee497dd13ec34,2,3,13,16,3,2015-01-17 12:05:56,2015-01-16 14:47:32
c48f61cb7a22cebd7f8074f481e69a62122ed70e...87d2adf070a44d3d62dfe7ca8c13e95e92f53b64,3,3,3,6,3,2015-01-27 01:12:54,2015-01-27 01:12:54
d3a6a53fa5d399ed0d728e48eed8ea38bca9dc2c...07d190a61c60cff2f20186e700abca46f18d35ac,1,1,1,2,1,2015-01-29 02:15:56,2015-01-29 02:15:56
d3a6a53fa5d399ed0d728e48eed8ea38bca9dc2c...310337dc89a78cbe245977236f02dcda73728df8,1,17,4,21,5,2015-01-23 09:26:13,2015-01-19 12:44:04
0d5daa4a8f12a451dfceba03161be68e1ece57e3...8ceb213b3e86973c795ec87a724c7dc7a794d57e,1,1,2,3,1,2014-10-08 20:44:21,2014-10-08 20:44:21
8ceb213b3e86973c795ec87a724c7dc7a794d57e...c257dcc9a4a78aa4455fbd417d0f80b2efb4713a,9,581,0,581,13,2014-10-08 20:46:44,2014-10-06 18:57:09
c257dcc9a4a78aa4455fbd417d0f80b2efb4713a...6a874cf711a7df5e60f1290e02fe4ca25851b985,3,7,7,14,7,2014-10-08 20:46:44,2014-10-07 16:01:17
0d5daa4a8f12a451dfceba03161be68e1ece57e3...c985302c5c2fb6d922acf29106b550cb36faaab6,4,54,9,63,8,2014-10-08 20:25:51,2014-10-08 19:01:25
0d5daa4a8f12a451dfceba03161be68e1ece57e3...9acf7c765c7e074f6c75eaf162ca06ecfe40d692,4,66,7,73,8,2014-10-08 18:17:27,2014-10-08 17:13:32
0d5daa4a8f12a451dfceba03161be68e1ece57e3...2fd0e8eb5f062bd549f961122d172ecdf1ae085e,1,1,2,3,1,2014-10-08 13:31:12,2014-10-08 12:52:20
9d1c9a4075306e5d1e753a836913ef119d85934f...018ce19b31bbd8d752658835e9442fa7d59a47e3,2,6,1,7,3,2014-10-14 06:24:38,2014-10-14 06:24:22
9273040a208ce2b9c2bf0ad0bc09068b32143ff8...d619b5594ba136ab285b93128bbe8fe246678488,1,1,1,2,1,2015-02-02 14:39:03,2015-02-02 14:39:03
9273040a208ce2b9c2bf0ad0bc09068b32143ff8...f0c9818eba0a9220766b020612f3b1d63c7d9c80,1,1,1,2,1,2015-02-02 02:39:28,2015-02-02 02:39:28
c98007f9d2292b4075e23ceea056209705596ab6...3859c485317a395de1e8eb48270d0e3b1207a204,2,92,1,93,2,2015-02-06 16:52:18,2015-01-15 14:49:48
c98007f9d2292b4075e23ceea056209705596ab6...2203b37733e76d653cfe3b0ec5870786076adce7,9,250,145,395,76,2015-02-04 15:59:16,2015-02-04 03:51:35
95c0f07966035ce79c6b51a2eee8c60c59fb523c...0e9acf76844a0dcd76bc855b945d0e4b80149195,2,0,20,20,3,2015-01-16 01:09:01,2015-01-16 00:33:11
0e9acf76844a0dcd76bc855b945d0e4b80149195...c6309229a0f5e3d8ee18d7ce80d1d0bd1d193e07,2,18,0,18,3,2015-01-16 21:49:46,2015-01-16 21:49:46
95c0f07966035ce79c6b51a2eee8c60c59fb523c...034466d356ecc5bc993f255c5ec5fb96e7327b8b,1,1,1,2,1,2015-01-15 01:18:11,2015-01-15 01:16:44
034466d356ecc5bc993f255c5ec5fb96e7327b8b...82bfb3852ea0835d96d456c256f40633b020bd1e,1,1,1,2,1,2015-01-15 07:02:17,2015-01-15 07:02:17
95c0f07966035ce79c6b51a2eee8c60c59fb523c...39343b86182b4e997dc991645729ae130bd0f5f2,2,26,3,29,2,2015-01-15 00:55:56,2015-01-09 01:00:00
39343b86182b4e997dc991645729ae130bd0f5f2...3183af8b19d2adf29dd3fb80689d764353a3fe00,1,1,1,2,1,2015-01-15 00:55:56,2015-01-13 19:13:27
95c0f07966035ce79c6b51a2eee8c60c59fb523c...e1ef33449f484678d236cb49e80daf5ba1e1899c,1,25,4,29,4,2015-01-15 00:14:27,2015-01-15 00:08:28
5b8c8b1819d0f2dcbe7d708b1ae8f579a73401bd...883d1415355244b2a2710d0860e5019bc697839b,1,3,0,3,1,2015-01-12 17:35:12,2015-01-11 04:24:49
2cb82c11cf43df0590a803c8733a8e77be704b85...c1e3f6196124f8c757a7017ae2bba7f8c05fde20,3,34,2,36,7,2015-01-29 00:30:00,2015-01-29 00:30:00
2cb82c11cf43df0590a803c8733a8e77be704b85...ef957f43518a8e636bca48604ebe02afdba775bd,1,30,25,55,20,2015-01-28 17:54:48,2015-01-28 17:44:56
364c64cf1aa912ea8197caa6b23b96e20ead64fb...a90e91b500bb1a39a7726025973b5748148768c1,1,1,1,2,1,2015-01-26 20:58:45,2015-01-26 20:58:45
c03d6f57b6956f305a9afcbdc530a15bbe729fce...d83b6918a7d18a09f86858709f173277d62c268e,1,3,1,4,2,2015-02-10 07:34:33,2015-02-10 07:34:33
c03d6f57b6956f305a9afcbdc530a15bbe729fce...aee28e0e87385de153e60e21c314032892b350f2,2,21,4,25,3,2015-02-09 02:36:49,2015-02-09 02:36:49
c03d6f57b6956f305a9afcbdc530a15bbe729fce...ab4bc988bcf2aae34c27be7e91d86a4c63a1af8d,1,2,2,4,2,2015-02-07 15:37:58,2015-02-03 16:13:33
c03d6f57b6956f305a9afcbdc530a15bbe729fce...c4340de04faec1b9d54da62a8a2174da4d6a301b,1,1,1,2,1,2015-02-07 09:09:20,2015-02-07 09:09:20
196cdf145032f64c0b45cf4f3bd87193cfa8d124...86aea582b66929c68de3346a26a26633b62a5784,1,7,4,11,4,2015-01-28 02:09:53,2015-01-28 02:09:53
70ea474de9bb7474d8859a05e98d21f98a05c7eb...1e41d57bd44bd503d0642c8ea20123541c146218,1,2,0,2,1,2015-01-26 23:57:43,2015-01-24 06:35:03
1e41d57bd44bd503d0642c8ea20123541c146218...a78130467a03b95d1852bb2e6d10120bd8e6a6e7,2,9,8,17,4,2015-01-26 23:57:44,2015-01-26 06:37:03
a78130467a03b95d1852bb2e6d10120bd8e6a6e7...64f67af2b2bab7c9d3b4458b194c10f7428bf257,1,3,1,4,2,2015-01-26 23:57:44,2015-01-26 11:26:38
64f67af2b2bab7c9d3b4458b194c10f7428bf257...60089ace4895d9ab9c9fe9f2fb4b0db8a0d9aeda,2,12,7,19,3,2015-01-26 23:57:45,2015-01-26 11:44:17
17e840a47a7e65a96d53db1bbace43f59a4b1a31...e16bcc3928d0ae07cb9c02840fbb92f1ed2a7a3f,3,5,3,8,3,2015-01-29 01:57:10,2015-01-28 22:33:15
e16bcc3928d0ae07cb9c02840fbb92f1ed2a7a3f...f750f17451f7e36367c49f2e45c9fcc261a000cc,1,13,13,26,2,2015-01-29 23:18:25,2015-01-29 04:53:53
09c4b4571225852692c1ac1beb8e9fe5209a62be...301b3ffbbb6660a16096e68a942e8d5b073893e3,1,1,1,2,1,2015-02-24 16:21:49,2015-02-24 16:15:47
09c4b4571225852692c1ac1beb8e9fe5209a62be...30ede3632427338b4a80bdc0c4dac3d6fac630a1,1,7,1,8,2,2015-02-24 01:07:12,2015-02-24 01:07:12
f8dbcdc5994a300308f4d259c62b58974a25e028...ed3fe85ba3b30d2586108a707fe20bba6c667e91,1,5,4,9,1,2015-02-27 23:05:06,2015-02-26 03:18:19
bac58e971104bf375bf241913747e1d98dadf2cf...8c19e43dff7d46e6213eac512d44bb2582d1c959,1,11,2,13,4,2015-02-23 04:44:31,2015-02-09 08:25:42
8c19e43dff7d46e6213eac512d44bb2582d1c959...814916457b50082e4299691ae92b4ed368ddb076,1,6,5,11,3,2015-02-23 04:44:31,2015-02-12 03:02:54
bac58e971104bf375bf241913747e1d98dadf2cf...6009f2eac4d8d707b64bfada507345e11977643d,1,11,17,28,6,2015-02-23 02:00:50,2015-01-30 23:49:43
6009f2eac4d8d707b64bfada507345e11977643d...3c9d45e2130e86c45da94aa00ce9a75e0d514e61,2,42,15,57,11,2015-02-23 02:00:50,2015-02-12 03:48:12
382f187b1a4d038b45d0e7965a0af8e158a2e9da...e58fdaae056491207349df8747289ed52e04462a,2,56,30,86,7,2015-02-03 01:53:14,2015-02-02 12:48:12
382f187b1a4d038b45d0e7965a0af8e158a2e9da...4ee05a4d3e6f9ad955d96075a1e63d59ed73ac78,3,5,5,10,5,2015-02-02 22:53:20,2015-02-02 22:53:20
f4dc496d36d31cf9ca1b3508f10954066ff7f8bc...0fadc9bd90c14acfd14a8c5e87d80e7a72438e2a,1,2,0,2,1,2015-02-13 07:45:50,2015-02-06 17:51:01
f4dc496d36d31cf9ca1b3508f10954066ff7f8bc...66ab357edf7491179c541ed3cfff21904396e56a,2,40,1,41,2,2015-02-10 18:52:36,2015-01-22 21:30:47
f4dc496d36d31cf9ca1b3508f10954066ff7f8bc...d92b4232f7c7cb64efd8e56c33238b4426fe22af,4,1989,4,1993,6,2015-02-10 18:48:54,2015-02-10 18:48:54
ee95aa1b813f53d52e42a7d37a3f4988918058ce...16aa64dc82b6434ec78878fa35eb96e4983b46f8,3,36,16,52,7,2015-02-19 22:19:38,2015-02-16 05:00:51
ee95aa1b813f53d52e42a7d37a3f4988918058ce...bc37c036b568f9ae27a7aa457ec73d0c5c6a61cf,5,56,0,56,8,2015-02-17 08:43:41,2015-02-13 22:53:39
ee95aa1b813f53d52e42a7d37a3f4988918058ce...987050a52b0ce6d5ae77554a03af5923304bd3e5,3,10,9,19,5,2015-02-13 22:50:42,2015-02-13 22:50:42
62ce5de1c192fa772233146935ebd21a01eccdcb...ae9cdbbde7824951b124a648e897ac4c291108e3,1,1,0,1,1,2015-02-09 19:04:50,2015-02-09 19:03:07
765c89791bb32cc992a17ad4d4dc7ae28163666d...4bc4587f05a754f52e40928c32c84ea48cc3522f,1,2,4,6,1,2015-02-09 22:22:22,2015-02-09 22:19:08
9939dbe58bae371ca08ce65610aa8a1f7915b506...41bfa87b6c27b3f0041906f99ae9d0d9531db898,1,2,0,2,1,2015-02-11 16:30:45,2015-02-11 16:30:45
41bfa87b6c27b3f0041906f99ae9d0d9531db898...064ff42d6d34b9c92e634f30ac1549d9786ab26f,1,2,0,2,1,2015-02-11 16:30:46,2015-02-11 16:30:46
467b7c8213901ffd788dba1753ac08291c979ec0...1b4a926377524455653019c772355bd71a148045,1,1,1,2,1,2015-01-19 10:02:23,2015-01-19 10:02:23
467b7c8213901ffd788dba1753ac08291c979ec0...9dc2d0b8a35724946139f954f9575411b31695ea,1,5,0,5,1,2015-01-19 08:44:13,2015-01-19 08:15:27
467b7c8213901ffd788dba1753ac08291c979ec0...1b2032c82e344b918578ce2de3618597e36fd7d6,6,95,1,96,6,2015-01-19 04:23:39,2015-01-18 23:55:08
467b7c8213901ffd788dba1753ac08291c979ec0...3fb06dc104bb66c3ec7be8a95a33845310083999,2,12,0,12,2,2015-01-18 23:23:57,2015-01-18 23:23:57
3ac5596fe05a910a91f021de10b2c6cd16eacb07...0c8d17b5c1a142bc09abe1105d985e76db6f225d,2,41,14,55,5,2015-01-28 04:54:26,2015-01-28 03:03:27
3ac5596fe05a910a91f021de10b2c6cd16eacb07...5945de43b02406dbc0eee44954eb21e5926bde00,1,3,3,6,3,2015-01-28 03:45:43,2015-01-28 03:45:43
3ac5596fe05a910a91f021de10b2c6cd16eacb07...1d04cc513a958009131ca54bd6904be14fef774e,2,1,15,16,2,2015-01-28 00:47:11,2015-01-28 00:47:11
a79d363d2dca151d4e0056e3ebd0481b6046e26f...6a2c6e971d8b760931402e15513e91c71cba4b72,2,56,56,112,2,2015-01-27 01:17:08,2015-01-27 01:17:08
99bffdf10ef31d80ae5d5bcb6dff64d49d4ae03e...d277714614f62dba276227f70cc2a47eac6e02e7,2,15,7,22,6,2015-01-26 22:00:51,2015-01-26 22:00:51
99bffdf10ef31d80ae5d5bcb6dff64d49d4ae03e...fd2d45d7d465fe02f159f21389b92164dbb433d3,2,18,7,25,6,2015-01-26 22:00:44,2015-01-26 22:00:44
99bffdf10ef31d80ae5d5bcb6dff64d49d4ae03e...0091c490dd31b9b9a5248cacaaf1f515ff26a5e7,1,2,8,10,2,2015-01-24 01:24:05,2015-01-24 01:24:05
99bffdf10ef31d80ae5d5bcb6dff64d49d4ae03e...2cd5b7dae80c5451b729a0be2ade03cbdf2c5c26,1,2,2,4,2,2015-01-23 22:44:30,2015-01-23 22:44:30
99bffdf10ef31d80ae5d5bcb6dff64d49d4ae03e...ec953b0e7ba89ff3b13b3187d9cee0b8c232b4ff,2,5,0,5,3,2015-01-23 22:00:15,2015-01-23 22:00:15
99bffdf10ef31d80ae5d5bcb6dff64d49d4ae03e...c49cd3d2a51ad6d2304c24f7b609cde804a0d6c5,2,0,3,3,3,2015-01-23 21:20:29,2015-01-23 21:17:54
99bffdf10ef31d80ae5d5bcb6dff64d49d4ae03e...3ca5af6b1ab6d1b75e014265e1ad4f5e45960826,4,76,16,92,15,2015-01-21 06:08:00,2015-01-20 00:32:29
2f5f437bc12164e7fa8ff935b5b29120d4f20adf...fb7ceeb170447cdbef3e74a92358eb9b084c0bf7,1,8,0,8,1,2014-10-10 23:58:49,2014-10-10 23:58:49
2f5f437bc12164e7fa8ff935b5b29120d4f20adf...0099b5e68cc76080f01e9150d3a3b86e0cb2b741,1,6,5,11,2,2014-10-10 06:12:12,2014-10-10 06:12:12
0099b5e68cc76080f01e9150d3a3b86e0cb2b741...4a5cefa1731ae99ee592e1898c6007904fb5943a,2,61,9,70,5,2014-10-10 06:12:15,2014-10-08 20:33:01
4a5cefa1731ae99ee592e1898c6007904fb5943a...b10dfb7de3c24cd6b4184d4228925517803f7ec7,2,75,96,171,23,2014-10-10 22:18:25,2014-10-10 19:02:22
2f5f437bc12164e7fa8ff935b5b29120d4f20adf...5b8379a4349105eb387a4b9836bbd1d83ebe6928,5,6,120,126,8,2014-10-09 22:15:17,2014-10-09 22:15:17
2f5f437bc12164e7fa8ff935b5b29120d4f20adf...e01e913d80dcbd509a003feb55c7cdb6fc9758c2,1,1,1,2,1,2014-10-09 21:54:22,2014-10-09 21:54:22
2f5f437bc12164e7fa8ff935b5b29120d4f20adf...a260772e48bdb69a2e95b78fccf9ea0fd1a9898b,2,38,22,60,10,2014-10-09 19:18:28,2014-10-03 15:43:22
0ab2f192786c0e630229f6fd888f8acc546160af...24189b2c36985f8345691fa6ec2c0766cfc133a7,2,37,2,39,3,2014-10-14 06:58:55,2014-10-14 06:58:55
d095659c6eef1125fc710d4bcb637311efbb3d31...8aa468ef56001ad2da3015383df2a8723ca1afa3,5,73,81,154,5,2014-10-10 00:13:13,2014-10-09 20:09:58
0d5a1cbaae15dec5953fe00edf206d341e8bcf62...532513153f64abdda87332b3cf76863dd07bf0ff,1,32,1,33,2,2015-02-05 08:42:33,2015-02-02 20:16:18
0d5a1cbaae15dec5953fe00edf206d341e8bcf62...4904f1f31fec2929c26b769fcfe20fbbcbd7136f,1,0,14,14,1,2015-02-02 23:19:20,2015-02-02 23:19:20
0d5a1cbaae15dec5953fe00edf206d341e8bcf62...ab4f9495ba9e3bd31ccb3800f2c574771b86744a,1,32,11,43,7,2015-02-02 23:01:13,2015-02-02 19:27:18
0d5a1cbaae15dec5953fe00edf206d341e8bcf62...9f6e7e9aed85464651745090692317b30e4a3526,1,7,7,14,3,2015-02-02 19:55:25,2015-01-22 15:09:50
0d5a1cbaae15dec5953fe00edf206d341e8bcf62...af90fe6a633be3a5bff4d20b0a59b9189a171176,2,18,1,19,2,2015-02-02 12:07:52,2015-01-28 21:03:21
0d5a1cbaae15dec5953fe00edf206d341e8bcf62...aceb735dbaa7845aeacfdaa62656de558554d8b7,1,0,37,37,1,2015-02-02 11:47:19,2015-02-02 11:47:19
a271eaeba224652e3a12af0287afbae6f82a9333...6088df20c33afafa523b9dd9b0acdd3b987c4534,3,27,28,55,11,2015-02-06 01:46:55,2015-02-06 01:46:55
a271eaeba224652e3a12af0287afbae6f82a9333...c8a06069bcee4214cd03468343aec7fcc4a37143,2,6,2,8,3,2015-02-04 21:23:13,2015-02-02 23:54:14
a271eaeba224652e3a12af0287afbae6f82a9333...46d4e491c8a1394596e824ac65b360f6d7211c6f,1,1,1,2,1,2015-02-04 20:27:02,2015-02-03 09:33:09
a59b6f4ce616aeae7d711461a58566f3d4919480...89bdaa35e04b74b7c6528783e0f7b8154b2a3d31,47,0,84,84,41,2015-03-07 02:21:51,2015-03-07 01:39:32
a59b6f4ce616aeae7d711461a58566f3d4919480...a0ca9190cc29215ce9ae69a6187d85bf689c8aa7,2,10,2,12,3,2015-03-07 02:18:53,2015-01-28 22:44:09
db6ecffc69ce0367623ee7d4686e54128af16470...79e8ca04f5764c150b61b1b05785fb3926613fa1,1,1,1,2,1,2015-01-27 14:33:42,2015-01-27 14:33:42
949f2ca8cbddadc00f9430b6f5ce50fd5a5dcb52...b54305ae2330bcadd2ef657a17f4a87896031d1f,2,78,3,81,2,2015-01-26 20:22:32,2015-01-22 02:40:19
a1eb2bebb812e22c05eeec057b63810b14f6a563...40486d97098a457bcafd20691ca28648f373a0dc,1,1,1,2,1,2015-02-09 02:04:55,2015-02-09 02:04:55
8d49ebd3381af51370df346b797515b4a32ac153...a6c6d8bb91a9e2fc2f9bd3da78382112794d17fe,1,1,1,2,1,2015-02-05 14:41:13,2015-01-28 18:08:27
8d49ebd3381af51370df346b797515b4a32ac153...77f840fb8bc679b8d0c3eb4ce7f443f904b7f9ac,3,493,156,649,3,2015-01-25 20:00:59,2014-11-09 19:59:57
de52a1998dbec1b5a7f9e27bcf527971b8df3666...629815b42472635c87ec6ce9ed4ec37019ae4ffa,2,60,14,74,5,2015-01-28 02:11:05,2015-01-28 02:10:28
d0bc3537d7cc7f152842c7d21c9eae85e0a95a4c...cfc8372c0a610ab87fed92f6ba6dd4100fef26d8,1,1,0,1,1,2015-02-25 00:30:22,2015-02-24 23:44:36
d0bc3537d7cc7f152842c7d21c9eae85e0a95a4c...6a9edfdc3b8ef4ed6febe8cee13dfd6786541b3b,1,1,0,1,1,2015-02-24 20:04:33,2015-02-24 20:04:33
d0bc3537d7cc7f152842c7d21c9eae85e0a95a4c...e9e993922d3173a292d4caaf35cb913ddc494f0c,1,0,1,1,1,2015-02-24 19:44:14,2015-02-24 19:44:14
347a418f35b26293d317276b9481e89941e2cf7a...1a26ed09ee6199341297f5e5ef8c5ed30efb6596,11,212,123,335,44,2015-02-23 10:16:52,2015-01-30 17:29:46
1a26ed09ee6199341297f5e5ef8c5ed30efb6596...3bd3f7854ad87420cc8779f8f44356775ae4f878,3,19,10,29,9,2015-02-24 16:59:04,2015-02-11 00:04:09
7e2328b76e041bb7a1acb3e20dbea0c379f7f024...7646e3f9574aabe7ebbd6eb8dc2ef0f4fcc4e3a9,1,4,0,4,1,2015-02-26 15:10:50,2015-02-26 15:10:50
7e2328b76e041bb7a1acb3e20dbea0c379f7f024...5b794c413a147dbc06f76caa6f2c32d1f4b1f2ce,1,1,1,2,1,2015-02-26 11:11:27,2015-02-26 11:03:44
44e9715e46db46d9c88b5bba6072c0fe42aa5837...459e58ffc9bff8206a860fb63f973e4f07129756,4,93,29,122,18,2015-03-17 18:15:00,2015-03-11 14:33:06
7d2188f9955d3f2002ff8c2e566ef84121de5217...ba93f8316ce796ebeee62f704f8311af8b9f250a,6,23,24,47,23,2015-02-23 15:15:56,2015-02-23 15:15:56
7d2188f9955d3f2002ff8c2e566ef84121de5217...743f0bcc83b0b1b8ccc1980300e96a9003b5cd0f,22,10,5,15,6,2015-02-23 11:10:54,2015-02-21 23:16:34
1d27930faaacf6ebe4553c7b23087e2164816470...e63a693c6d4ae76cded0029bb7f60216c4b11da6,1,74,0,74,1,2015-02-24 19:05:05,2015-02-24 19:05:05
1d27930faaacf6ebe4553c7b23087e2164816470...7fed7d7eb4d7766d9342821f2667d160c5f958eb,4,18,18,36,15,2015-02-24 18:47:47,2015-02-24 18:47:47
7fed7d7eb4d7766d9342821f2667d160c5f958eb...f57c26553b91e16fa3ee6a815943eaf8f29af82b,3,53,50,103,41,2015-02-24 23:27:49,2015-02-24 19:12:47
1d27930faaacf6ebe4553c7b23087e2164816470...f8e77dfb3de50b3c4f0f8c852389a6ed5bcbcd6e,2,4,0,4,3,2015-02-24 18:01:35,2014-09-29 08:03:56
f8e77dfb3de50b3c4f0f8c852389a6ed5bcbcd6e...7f091eca704970a5cb8a4fdab295dae543c47a89,3,69,0,69,7,2015-02-24 18:01:35,2015-01-09 21:07:00
7f091eca704970a5cb8a4fdab295dae543c47a89...b30257ccf96f646c6b008312d39544d6700f5cb1,2,49,3,52,4,2015-02-24 18:01:35,2014-10-01 09:35:44
b30257ccf96f646c6b008312d39544d6700f5cb1...6d4cd446fe1df4074f44267c4c5b0134bcedc65c,2,8,0,8,5,2015-02-24 18:01:35,2014-10-01 15:13:59
6d4cd446fe1df4074f44267c4c5b0134bcedc65c...3210d13fc8fb93263a7a5eadef0a0f133087a889,1,22,19,41,6,2015-02-24 18:01:35,2014-10-24 21:11:00
3210d13fc8fb93263a7a5eadef0a0f133087a889...5767548fa79342cee94dbb66b9c41671d4a1879f,2,27,0,27,6,2015-02-24 18:01:36,2015-01-09 21:08:26
5767548fa79342cee94dbb66b9c41671d4a1879f...17abfc3ddc79592753289a8556a343e276fb15b5,8,84,25,109,27,2015-02-24 18:01:36,2015-02-05 11:26:05
17abfc3ddc79592753289a8556a343e276fb15b5...4a9fa9650b154e70d55f750c3674c2d6dd390bef,1,2,1,3,2,2015-02-24 18:01:36,2015-01-12 19:52:44
1d27930faaacf6ebe4553c7b23087e2164816470...681182ea7a45b513430c84484d8aa2c0c42514e5,1,7,7,14,4,2015-02-24 16:49:03,2015-02-24 16:49:03
1d27930faaacf6ebe4553c7b23087e2164816470...d96e8853145ed6a03529e093c49b91f0053472a6,1,1,1,2,1,2015-02-24 14:52:47,2015-02-24 11:42:51
1cc774b4faebdc11f419add5467a6bc19288bce9...fcb975cfd17cfbe45b7f6661c2c1c4a94de04c94,3,3,3,6,3,2015-02-05 00:57:33,2015-02-05 00:57:33
1cc774b4faebdc11f419add5467a6bc19288bce9...16a15ea5812e3dce0f23e1f4ac7ac576f45bfeb4,1,38,65,103,6,2015-02-05 00:37:15,2015-02-02 03:35:01
1cc774b4faebdc11f419add5467a6bc19288bce9...a7a9ce2635e75eb138fc761d8a5bba4156562a8c,1,12,11,23,5,2015-02-05 00:30:57,2015-02-02 23:43:10
1cc774b4faebdc11f419add5467a6bc19288bce9...9867dfa6176c000f1afe25316f67f4d409b2b177,1,3,3,6,1,2015-02-05 00:26:53,2015-02-05 00:26:53
662dffee4fccbf6f7853605c8f558ec21ee668fe...072fbf92714e121f92b0599740444e4cc28c4fee,1,5,5,10,1,2015-02-03 04:04:08,2015-02-03 04:03:03
662dffee4fccbf6f7853605c8f558ec21ee668fe...1da2abb596178a3cb67ef83686f4425c31987640,2,3,4,7,3,2015-02-03 03:55:08,2015-02-03 03:55:08
19019722d944ecc17a1a62acc418d74ef4e23407...828e76a5aa8742661e8b7ee9603ce7166e90a34c,1,83,0,83,1,2015-02-21 01:19:08,2015-02-11 01:45:34
19019722d944ecc17a1a62acc418d74ef4e23407...f058e9c43c8752dedcd4d251ddf105b22d0ed1d5,8,11,11,22,11,2015-02-13 17:13:29,2015-02-11 22:16:41
19019722d944ecc17a1a62acc418d74ef4e23407...8d1a0086c1a9297c2dc44a997134de7d30d0498f,1,5,3,8,1,2015-02-11 00:08:57,2015-02-11 00:08:57
19019722d944ecc17a1a62acc418d74ef4e23407...db2d875b5e621378baf690d261969712fbfffcfd,1,14,22,36,4,2015-02-10 23:46:42,2015-02-10 23:46:42
f4749acad48f03454c951081a0a3f0149a23e260...0ae455333b3357f30f27da10557e4d9c006b5ba7,1,2,2,4,1,2015-02-20 04:37:17,2015-02-12 08:00:32
f4749acad48f03454c951081a0a3f0149a23e260...0ae1ef3b12f2599c05835cab6485b3518feef461,1,2,2,4,2,2015-02-16 18:13:12,2015-02-16 06:34:55
f4749acad48f03454c951081a0a3f0149a23e260...e1be475c5b3269246d5ecaf2b7943608941cc966,1,2,1,3,1,2015-02-12 23:02:18,2015-02-11 23:11:22
f4749acad48f03454c951081a0a3f0149a23e260...f6e697d2ace2ea659c1b3f7e3dcef7493baa481c,2,62,1,63,3,2015-02-12 16:38:52,2015-02-12 16:38:52
f4749acad48f03454c951081a0a3f0149a23e260...ccde3a1f73bb4f64845e736d3173eb6f6935971f,3,66,33,99,12,2015-02-12 05:44:31,2015-02-12 05:18:48
ccde3a1f73bb4f64845e736d3173eb6f6935971f...72a070c5da8b6fe832794a6de37aace7f9b93306,1,16,14,30,2,2015-02-12 07:54:41,2015-02-12 07:54:41
f4749acad48f03454c951081a0a3f0149a23e260...df8d80710297385aa7c8db41fdd1ef6795e39ae3,1,8,1,9,2,2015-02-12 02:39:41,2015-02-11 16:01:43
df8d80710297385aa7c8db41fdd1ef6795e39ae3...49d1ab0eb2ab5ed880e2e1ed66bb62c68b801457,3,21,21,42,11,2015-02-12 02:39:41,2015-02-12 02:21:09
49d1ab0eb2ab5ed880e2e1ed66bb62c68b801457...d79e597f301fdf42a0f441f35b48504a5b07eb8b,1,4,5,9,2,2015-02-12 02:39:41,2015-02-12 02:26:50
f4749acad48f03454c951081a0a3f0149a23e260...fa228d8cbc3778a9abbab49208b60b31bf026621,1,17,15,32,2,2015-02-12 00:46:53,2015-02-06 12:31:53
fa228d8cbc3778a9abbab49208b60b31bf026621...f3713010dd6355cc89944cc4185b4c5023fd95c5,1,35,0,35,1,2015-02-12 02:39:07,2015-02-12 02:39:07
99ca215c65e9a482f981790f2d4dbe8d4ccce4be...b81105eaca56e7b22c97e24b7314419ee0a4f2a9,2,109,86,195,36,2015-02-18 01:09:09,2015-02-14 22:25:13
99ca215c65e9a482f981790f2d4dbe8d4ccce4be...ae8f1fa712196474da633b4c832ea073e8995edb,1,1,1,2,1,2015-02-16 18:18:27,2015-02-14 20:42:33
99ca215c65e9a482f981790f2d4dbe8d4ccce4be...00f2fd1dd5dee53919cda7ed9f5c70ba8558edb5,1,14,1,15,2,2015-02-14 16:04:06,2015-02-13 00:17:33
99ca215c65e9a482f981790f2d4dbe8d4ccce4be...4f377fbe9f30ea44be5e10a0c7b9bc3c6eb421b1,2,14,2,16,3,2015-02-14 11:26:56,2015-02-12 19:20:48
99ca215c65e9a482f981790f2d4dbe8d4ccce4be...57d34241fdff146eaeae748c959940489335ed2a,1,6,1,7,1,2015-02-14 11:00:38,2015-02-14 10:44:56
99ca215c65e9a482f981790f2d4dbe8d4ccce4be...5dbaea1ca99ecb51174259f5ebb814101c349edc,2,42,16,58,9,2015-02-14 10:17:42,2015-02-14 09:19:57
d21ecf94fea1b715e5237a2b613074af95e58943...b4089114efe23b18218886ec2085455d463c7179,3,76,15,91,7,2015-02-10 01:02:05,2014-12-02 16:21:43
b4089114efe23b18218886ec2085455d463c7179...32c6179f475183ba778cb90656a971cde81340dc,3,18,23,41,10,2015-02-10 01:02:05,2015-02-09 04:02:16
d21ecf94fea1b715e5237a2b613074af95e58943...c237f9f201bbf5c4b06fbfd65254eb2af75e136f,3,36,23,59,11,2015-02-09 23:50:02,2015-02-06 04:31:04
c237f9f201bbf5c4b06fbfd65254eb2af75e136f...6257505dbc44bb58c56ac92677dbf07548c0c74a,1,5,5,10,4,2015-02-09 23:50:02,2015-02-09 04:07:31
d21ecf94fea1b715e5237a2b613074af95e58943...aadb6289ccd84b9997a43c8b74b2948236f30e76,8,17,17,34,17,2015-02-09 23:01:52,2015-02-09 23:01:52
df7a04f9a64fc7b8e528a3b99beb71b97b4b22d0...f8a146311d1ea1645e25b38910b717335bb684c0,1,15,7,22,1,2015-02-25 14:56:58,2015-02-19 17:40:23
df7a04f9a64fc7b8e528a3b99beb71b97b4b22d0...95668ed128c77b373bac54b721231bd320fa174d,9,53,62,115,22,2015-02-19 17:20:50,2015-02-12 22:00:30
acb8e08296b2570d109af3fdb447f470fdb5f665...9cea20ffc5904201efdda2c8d6623759e15ad8eb,1,76,18,94,60,2015-01-28 16:52:06,2015-01-28 16:52:06
acb8e08296b2570d109af3fdb447f470fdb5f665...e662775ffb096fdb4a7f247bb25b8e3022006c1b,2,86,1,87,4,2015-01-27 18:07:01,2015-01-27 04:56:34
acb8e08296b2570d109af3fdb447f470fdb5f665...6774be62d647b2e2f258bc7b4158cb9e10a3ecf6,2,11,3,14,3,2015-01-27 04:58:29,2015-01-27 04:55:43
990a3e30fa66e7bd3df3c78c873c97c5b1310486...d477d42dd3e6a98f82c6ed2abb1dfeeb2782539f,2,39,5,44,6,2015-01-24 22:27:37,2015-01-24 21:08:47
62c50abf1382fb3a4cfb72131d0f1573a25ad000...d5c78a4c07929eda2d448f9b2a09fb3d65a75a2d,1,2,2,4,2,2015-01-23 22:48:28,2015-01-23 22:32:36
7fa7c42ce2f151d438ad83fd2dcd5a0679015618...2709c4677c252a07d49a24f7583adcc17b38fa14,5,52,6,58,10,2014-10-13 07:41:12,2014-10-08 03:10:31
7fa7c42ce2f151d438ad83fd2dcd5a0679015618...801edfa9b8a765e734ac4a909ab032f0cb03fe87,1,8,5,13,1,2014-10-13 07:30:08,2014-10-07 03:56:55
7fa7c42ce2f151d438ad83fd2dcd5a0679015618...3d2f10e28ae6aa278aca4403d2e3b55cc8071022,1,33,23,56,4,2014-10-13 07:06:18,2014-10-08 01:44:01
7fa7c42ce2f151d438ad83fd2dcd5a0679015618...3732cd6612943b39ec36ae6fc0819e7003642121,1,1,1,2,1,2014-10-13 07:00:58,2014-10-13 07:00:58
7fa7c42ce2f151d438ad83fd2dcd5a0679015618...687215c32f10b85ce1c3fffef356e505daccf3f4,2,16,0,16,4,2014-10-13 06:32:18,2014-10-13 06:32:18
7fa7c42ce2f151d438ad83fd2dcd5a0679015618...d883fb66b04b58bf446fa2b493644d0f453829cb,2,10,17,27,5,2014-10-13 04:10:29,2014-10-13 04:10:29
7fa7c42ce2f151d438ad83fd2dcd5a0679015618...44e9a59665bd34f20d54e775d9afb0332bf8590d,2,15,4,19,7,2014-10-13 03:53:16,2014-10-13 03:53:16
7fa7c42ce2f151d438ad83fd2dcd5a0679015618...da42ae536cf86dafbdad88901b9322ea7317f154,2,19,18,37,8,2014-10-13 02:32:55,2014-10-13 02:26:42
7fa7c42ce2f151d438ad83fd2dcd5a0679015618...61387427cb9b1ed6a4c34e0a7960183159ee305d,1,41,1,42,2,2014-10-13 01:34:18,2014-10-11 16:15:54
7fa7c42ce2f151d438ad83fd2dcd5a0679015618...ba7038c8d2a86e34bba2128b5b973864eb41c7a6,1,1,1,2,1,2014-10-12 21:41:24,2014-10-12 21:41:24
7fa7c42ce2f151d438ad83fd2dcd5a0679015618...b10e11f30e111e6d4ae4b439e64463e08b3ab78b,1,6,6,12,2,2014-10-12 19:59:46,2014-10-12 19:59:46
7fa7c42ce2f151d438ad83fd2dcd5a0679015618...137bad4b48f899cb544500bf898cbd74464a8d2f,1,6,6,12,6,2014-10-12 07:05:58,2014-10-12 07:03:41
7fa7c42ce2f151d438ad83fd2dcd5a0679015618...f1c319f77cc4ba97ab56a7b0d1e18a4cf12db7ba,1,6,5,11,4,2014-10-11 20:30:36,2014-10-11 20:30:36
248ec5d74e4f33bbcf946609fc5f9081a267fb8b...19fb942d3609f647adeda68c6ca106371c7b32ac,3,16,5,21,7,2014-10-13 10:49:26,2014-10-10 15:02:04
248ec5d74e4f33bbcf946609fc5f9081a267fb8b...e8b8cf61a9c4f905befc3462e7e80ca7729ffe4d,1,8,1,9,4,2014-10-10 23:04:28,2014-10-03 23:16:03
e8b8cf61a9c4f905befc3462e7e80ca7729ffe4d...a152f37674df3f2a31e60cbfb764fa348333e805,2,14,7,21,5,2014-10-10 23:04:28,2014-10-08 21:03:39
a152f37674df3f2a31e60cbfb764fa348333e805...7d21ea6627ae964425da9bc52bbb9e21b7da3cf9,1,4,3,7,3,2014-10-10 23:04:28,2014-10-08 23:11:04
7d21ea6627ae964425da9bc52bbb9e21b7da3cf9...456f493659d92ef271bc3573c537d10ae5d0847b,1,26,15,41,20,2014-10-10 23:04:29,2014-10-08 23:14:54
456f493659d92ef271bc3573c537d10ae5d0847b...15d5c7f10f56faeaa04f6374341e1cfd3e03cab1,2,20,12,32,7,2014-10-10 23:04:29,2014-10-10 00:34:34
15d5c7f10f56faeaa04f6374341e1cfd3e03cab1...73a9089306ac1ed25c594e54c9b2a11a0ac8e610,1,3,3,6,3,2014-10-10 23:04:29,2014-10-10 00:31:54
73a9089306ac1ed25c594e54c9b2a11a0ac8e610...85fd8213afe9497da5df5583d776659ed187c9e9,1,1,1,2,1,2014-10-10 23:04:29,2014-10-10 22:20:28
85fd8213afe9497da5df5583d776659ed187c9e9...3be4551a9164c5fac577e9e3683dea65c2fc193a,1,13,0,13,1,2014-10-10 23:09:56,2014-10-07 18:00:17
248ec5d74e4f33bbcf946609fc5f9081a267fb8b...7d1e197f25d119fd8917d1867cc0284ceea46db4,1,42,3,45,1,2014-10-10 22:40:52,2014-10-10 22:40:52
95b67895c4a5bfa604cf850d202ecb2b4a7f3f14...06d633e1f68d003f6183403b134142b12a24c9ca,1,2,2,4,2,2014-10-14 13:15:35,2014-10-14 13:15:35
165ea5c158cff3fc40d476ffe233a5ccc03e7d61...3166c4df835be40d438fd71bcb16de27c70a1246,2,18,10,28,9,2015-02-04 04:17:56,2015-02-04 04:17:56
165ea5c158cff3fc40d476ffe233a5ccc03e7d61...ef3192f161a89bbff11d88da523be61484a822f2,2,2,2,4,2,2015-02-04 02:47:37,2015-02-04 02:47:37
165ea5c158cff3fc40d476ffe233a5ccc03e7d61...ea6db8af18c9eee2147d78f987cdacacd37e93fb,2,2,2,4,2,2015-02-04 02:12:46,2015-02-04 02:12:46
01b46c21aac9f533b7515d86de1bcf1d1befa247...d18f5c3808f8df40fb8e3e153887e921bc71103b,1,2,2,4,2,2015-02-03 16:30:37,2015-02-03 16:30:37
01b46c21aac9f533b7515d86de1bcf1d1befa247...196a7216a327dc4eb5de37faf80f2e89e13242c7,1,2,2,4,2,2015-02-03 15:55:14,2015-02-03 15:55:14
01b46c21aac9f533b7515d86de1bcf1d1befa247...198ff76de59a600ce900497fd4a6131ee4448c48,3,61,14,75,10,2015-02-03 07:40:20,2015-01-21 19:08:19
198ff76de59a600ce900497fd4a6131ee4448c48...73d5baf585e3ef55864abeef43d45fe0b3a1c2bc,4,130,33,163,18,2015-02-03 07:40:24,2015-02-02 21:17:12
73d5baf585e3ef55864abeef43d45fe0b3a1c2bc...22e2254c744d1ed2d75f3cdc802e4347727dea6a,1,1,1,2,1,2015-02-03 07:42:18,2015-02-03 07:42:18
9491cec22494ad3e180ce6933ed72df6d344b342...2471134ae38cf5a3743dc530ea746fb2ee42a107,1,1,1,2,1,2015-02-06 23:07:42,2015-01-21 22:24:19
5a5726c5e4cd21b5988f9253f322974f1b0dcd08...c809fc552b65ea90ed695d39c24447aa3dbc7891,1,2,2,4,2,2015-02-04 21:51:44,2015-02-04 21:51:44
5a5726c5e4cd21b5988f9253f322974f1b0dcd08...14452bcfc2ba0f98987734c0ec00ee439f71a740,1,82,0,82,2,2015-02-04 21:43:09,2015-02-03 19:46:28
14452bcfc2ba0f98987734c0ec00ee439f71a740...7cbd2d08c0c8b9d6cb2aa2d7e511833bb529462e,1,12,11,23,6,2015-02-04 22:14:15,2015-02-04 22:14:15
7cbd2d08c0c8b9d6cb2aa2d7e511833bb529462e...1578f21067b92338c90f15a9a3473137b1db2b99,1,5,3,8,1,2015-02-05 00:58:31,2015-02-05 00:58:31
1578f21067b92338c90f15a9a3473137b1db2b99...30cd215b86337526ce1a7431d8fe4c0f66b5cfff,1,3,3,6,1,2015-02-07 03:39:31,2015-02-05 19:04:40
5a5726c5e4cd21b5988f9253f322974f1b0dcd08...4855612aaecf7719edc36693d402279c743be7fc,1,1,1,2,1,2015-02-04 21:35:20,2015-02-04 21:35:20
faa6fd40f436587999e24b0f5c3369c007a6c482...2a5a50dca7dc56d390a70c0258ac1b8df3cd4d94,2,63,2,65,6,2015-03-08 05:44:25,2015-03-08 05:44:25
faa6fd40f436587999e24b0f5c3369c007a6c482...efc625fcd00b0f76e484d0bc081bafcfd789cfbb,11,1209,964,2173,279,2015-03-07 22:40:34,2015-03-07 13:06:40
faa6fd40f436587999e24b0f5c3369c007a6c482...3c37f88aff42c1d900d18d1a8c81fc857e650d44,3,4,4,8,4,2015-03-07 12:45:46,2015-03-07 12:45:46
faa6fd40f436587999e24b0f5c3369c007a6c482...d18689dff71ccbc3b955a4416ae04077356fd5c9,3,20,9,29,4,2015-03-07 09:09:01,2015-03-07 09:03:44
02e0a23d80a4c19c2d475c3f205eba79a45f8a59...afa92a9af0f1a77ef25aab73b11aa855a1823666,3,35,8,43,10,2015-03-10 18:43:17,2015-03-10 14:22:29
55566f2f8f10086d3f030deebd53915978f0591f...116367eb07351125754aef01f7d3da152b018710,3,116,60,176,21,2015-02-20 06:21:17,2015-02-06 22:17:34
55566f2f8f10086d3f030deebd53915978f0591f...6871b9b16afe46e7566ac2937246b4a64be97269,19,46,36,82,26,2015-02-20 05:40:12,2015-02-04 21:22:38
1060a5334efac1b478ed7b61fa0d4fb8dc184ff0...e6f88f091d59a32f7a1cd9baa18b9d792548f36d,1,2,0,2,2,2015-02-25 00:39:42,2015-02-24 23:44:36
11717741fd31cf9e27a07138dfb998f7aed9da4f...db1f8f7481a825a921295adea36d2e56ee8703ae,1,2,14,16,1,2015-02-25 02:50:55,2015-02-25 02:50:55
11717741fd31cf9e27a07138dfb998f7aed9da4f...9aff77156b74cc248542601e146d87011819c10c,1,22,46,68,9,2015-02-25 02:28:16,2015-02-25 00:24:19
11717741fd31cf9e27a07138dfb998f7aed9da4f...c3e28351a1547f4999aafb0780e4b1a5d84d78ac,1,4,3,7,1,2015-02-24 23:52:06,2015-02-24 23:52:06
c861231a70342472ad9322320bf6fb62e6afba35...c5fdc93f89db3cb3ea4489999296487fad0f440d,1,2,2,4,2,2015-03-19 12:29:30,2015-03-19 12:28:42
c861231a70342472ad9322320bf6fb62e6afba35...133983190622bf2618df6c36fb77669e30458e17,1,30,0,30,1,2015-03-19 12:20:04,2015-03-19 12:19:39
c861231a70342472ad9322320bf6fb62e6afba35...1d9fb2583cd85261f0813edcf5d3ddf89fefc397,1,1,3,4,1,2015-03-19 08:51:45,2015-03-19 08:51:45
a5269223a78d963774b12359a1e505b10fa9ac81...ae61593417bd9bcf3d862f79271c7d5b83c1e6d5,6,7,5,12,8,2015-03-18 05:01:40,2015-03-18 03:17:28
f4f10cf43ba1298284dcab926b2594bafda1087a...5ff122f79713f177c07dbc43bb81f991243472d5,4,100,10,110,14,2015-03-17 07:20:19,2014-12-19 10:25:33
5ff122f79713f177c07dbc43bb81f991243472d5...6a313e81ccfada1f8266a521ba480b3e7764754f,1,8,6,14,3,2015-03-17 08:01:52,2015-03-17 07:36:56
f4f10cf43ba1298284dcab926b2594bafda1087a...6c492a2d05cc59d79d03c2015b8ed8140d44b343,1,1,0,1,1,2015-03-17 00:53:54,2015-03-17 00:53:54
05ba127f060a1e9fee819e15bef300d56ddda1cf...7a9c944b827dc0cd416d701fe6460264f05166bb,20,146,129,275,115,2015-02-23 18:43:10,2015-02-21 04:48:23
05ba127f060a1e9fee819e15bef300d56ddda1cf...a936ea88dab9751250a51b6e32ee4e7aa57d8e9d,1,1,0,1,1,2015-02-23 18:19:51,2015-02-23 18:19:51
05ba127f060a1e9fee819e15bef300d56ddda1cf...f9bb0afc6c37ea5b6f2d413474c5dcbdd84259f1,1,1,1,2,1,2015-02-23 17:37:11,2015-02-23 17:31:52
6dd2364dc2c6ba0d95a5dc52dae447c80d9af5d0...72f356be6a662ed92e04ba9c58acac63c5a15264,1,3,0,3,1,2015-02-05 01:05:27,2015-01-23 03:29:21
72f356be6a662ed92e04ba9c58acac63c5a15264...0c0f0d5ab41cae62a441502f26c1c300fc61e25d,4,40,13,53,10,2015-02-05 01:12:56,2015-02-05 01:12:56
abdfb21e3a761efdd70614de42905ff7911c5372...e45deceb462351f841aa077819fdef3166381c50,2,57,1,58,4,2015-02-06 19:32:01,2015-02-05 22:55:08
abdfb21e3a761efdd70614de42905ff7911c5372...32d6d49539f5876e6ef75f00db917d8a3aaa0569,3,12,9,21,6,2015-02-06 17:13:57,2015-02-05 10:48:58
32d6d49539f5876e6ef75f00db917d8a3aaa0569...899a2dda097a57a12f8794ded4a706781173aa5d,1,127,0,127,1,2015-02-06 17:14:38,2015-02-06 13:00:13
abdfb21e3a761efdd70614de42905ff7911c5372...6ffb77afd4c3705322417f0673d254038f01a187,5,21,13,34,10,2015-02-06 00:13:51,2015-01-26 19:04:16
6ffb77afd4c3705322417f0673d254038f01a187...f9ae2d4fd4c5b4afb7a2299b93a800f718b63a2a,8,44,21,65,16,2015-02-06 19:42:45,2015-02-06 18:18:49
abdfb21e3a761efdd70614de42905ff7911c5372...8a8dcf1930cbd3354994938d5f8e420fb3e66d95,1,4,1,5,1,2015-02-05 11:33:22,2015-01-19 17:09:02
6081a3ca90f7994ae19d22009e3691de03afad14...d1f33d12d4126aae80c51ab1075a5b8323a5f957,2,19,0,19,2,2015-02-06 22:00:53,2015-02-06 22:00:53
6081a3ca90f7994ae19d22009e3691de03afad14...ea0fd0e8e5ba5cccdf5bf0e475a165c4996bd9aa,1,7,1,8,3,2015-02-05 20:36:30,2015-02-02 00:42:35
8a91926cd90b10e1be097eb2adb2ac58de1889a0...48ee443ecaae002cc688c7b03e07ecc670b3b193,1,1,1,2,1,2015-02-04 21:15:18,2015-02-04 18:48:53
eb435d70c138c842c238b4513c3c63cb7547c030...ec728939b167a32226d7556af38a51d3bc3a1b9e,11,813,603,1416,26,2015-03-13 05:27:49,2015-03-12 23:29:10
e82cf741e3d1cf0990836ea1112ff6e1edfa680f...d1b515dcc5a2a57610aaab54a27fbee321d355d1,1,97,30,127,12,2015-02-23 19:34:22,2015-02-23 19:32:28
e82cf741e3d1cf0990836ea1112ff6e1edfa680f...ed3bc3b9864dff42a7949aa9202ea242e9ed0a9b,1,23,0,23,2,2015-02-23 19:31:38,2015-02-20 00:27:20
8b010d9f10b42377bcd741dfbe00006994bd8adc...b55346b3279a3243da8cab82a7ddc427454aba61,3,3,3,6,3,2015-02-13 20:45:50,2015-02-13 20:09:56
65623e22aa79b6974f8fc4f0384a7533cbb9c570...d15f8feaa86453147161db6e1b2ec2538e11ecfd,1,23,0,23,1,2015-02-16 00:02:56,2015-02-16 00:02:56
65623e22aa79b6974f8fc4f0384a7533cbb9c570...2f53820ce409ce1afb6513b7799d094b9c53779d,1,2,2,4,2,2015-02-12 23:42:27,2015-02-12 23:42:27
d8f60a6cf7790b8951fdb1c5af2ca2aef5353ec6...ac6cb41d52ca229d2b628ab0bb5ef6103bd86ce1,2,20,16,36,9,2015-02-12 23:11:19,2015-02-12 19:51:28
d8f60a6cf7790b8951fdb1c5af2ca2aef5353ec6...74b050bd0cfa897c0ef2fa50e26725af3c29a65e,1,18,23,41,3,2015-02-12 22:02:56,2015-02-12 21:50:39
d8f60a6cf7790b8951fdb1c5af2ca2aef5353ec6...7a7c00ca0834e6bad0132d834399bcee4d3b957b,1,1,5,6,1,2015-02-12 19:40:56,2015-02-12 19:40:56
cd9769c55e3c0c405854b84c2c4bd273be79b23d...a5a0353dbee6d95f7ce403705e6823c2d9f02275,1,167,182,349,28,2015-02-19 21:42:23,2015-02-19 17:11:22
a5a0353dbee6d95f7ce403705e6823c2d9f02275...a61766be9f7667d5153fde26b3c362471c9b9474,1,2,1,3,1,2015-02-20 01:29:46,2015-02-20 01:29:46
cd9769c55e3c0c405854b84c2c4bd273be79b23d...ea8cb16af7e8c83a264a1d1c48db3cacd4cc082b,1,2,2,4,2,2015-02-19 17:44:38,2015-02-19 17:41:48
cd9769c55e3c0c405854b84c2c4bd273be79b23d...c7bec92891180ccffd1536839ba3bcc85d9c96a4,3,34,26,60,12,2015-02-19 06:46:25,2015-02-14 10:27:06
9456a2541462c3cbf8afca8e14f3102887566dd7...582c360d5741a6dce35af1e7607ee636bcf4eb4c,1,1,1,2,1,2015-02-14 16:51:28,2015-02-14 16:41:57
9ee8d41ab27181a919da11828c573c030e8a5611...ab6ae7215eab36a21c9f1c286b9e157f6b644edc,1,6,4,10,3,2015-02-20 18:25:10,2015-02-16 18:27:33
9ee8d41ab27181a919da11828c573c030e8a5611...01bd90c4ad5322d443d6952c897dd6ba8d17a3ba,1,1,1,2,1,2015-02-16 18:23:29,2015-02-16 18:23:29
c33ac6067cdf50fc1dc284cdf9c634efff27ab2e...bfba622f86eb45e25d4ff6dc6808cd740bd2a671,1,1,1,2,1,2015-02-15 03:06:18,2015-02-15 03:06:18
d14751bf30a70abe7bc6048af61848eed32ca140...1654dfdf146df42a1271696c0290027460cce59a,2,13,1,14,2,2015-02-10 19:43:45,2015-02-10 19:10:10
30293e3fd0b03aa6bcd7b725fc2429e4cbeeb169...471006c02f03d9451721dfbd7e3d62f0db0fc7c7,2,2,2,4,2,2015-01-24 07:08:33,2015-01-24 07:05:44
30293e3fd0b03aa6bcd7b725fc2429e4cbeeb169...a5cc1c556dcd6dfe5c1aed4bec95aaff6ddfad61,1,0,1,1,1,2015-01-24 06:43:03,2015-01-24 06:43:03
30293e3fd0b03aa6bcd7b725fc2429e4cbeeb169...957cbdbf302750f3fb3467237bebf29d87234208,2,35,35,70,2,2015-01-24 00:18:39,2014-12-30 22:05:00
957cbdbf302750f3fb3467237bebf29d87234208...ecdbc1a0aff40fa28389d1971528641e2824e5a9,2,4,0,4,2,2015-01-24 00:18:39,2014-12-30 22:22:31
ecdbc1a0aff40fa28389d1971528641e2824e5a9...547c95957679672c3ed2e97c7a2950d3c0a03321,1,4,0,4,1,2015-01-24 00:18:39,2014-12-30 23:24:53
547c95957679672c3ed2e97c7a2950d3c0a03321...43d1c2010125e3c1ef1013ee2e8b4d9371d70d77,3,133,132,265,4,2015-01-24 00:20:46,2015-01-19 20:11:19
939227a81a6055ea7984b047f95f9b3d387ba0c3...1150c1639a9efbd2e5e4ac1e71961aef77a32de0,5,200,40,240,33,2014-10-14 01:59:45,2014-10-13 20:14:35
547c42d8d0027e7148f63d7d39a954328aab1e36...8fedf718ce0c788311d8d3382b0aaeb9b9a792d4,6,12,24,36,14,2014-10-13 19:53:20,2014-10-13 19:53:20
9d5e3a54a0237bb9bf5a752d49959fed751f02a3...5bf3ac573816d718a1c318e5eea7da0142ae92d1,2,13,3,16,6,2014-10-14 01:54:41,2014-10-13 05:53:35
9d5e3a54a0237bb9bf5a752d49959fed751f02a3...6b285c4cd6fe4a28c73a7137fe47753510befd3f,2,41,41,82,2,2014-10-14 01:53:10,2014-10-14 01:52:10
23be0486f64adf6fbe5cdd13f7277e67d64b4339...d8cd8165a94dc60d1f7a1053bb789fd302252279,2,122,134,256,3,2014-10-16 21:34:28,2014-10-14 21:32:25
23be0486f64adf6fbe5cdd13f7277e67d64b4339...e5e0baa6d4651dd0182413f0db622ab82e53841f,1,1,1,2,1,2014-10-14 17:45:26,2014-10-14 17:41:52
23be0486f64adf6fbe5cdd13f7277e67d64b4339...712e8da885de00d1957a15c0c7f862fb3b2f6beb,2,2,19,21,6,2014-10-14 17:16:45,2014-10-14 17:16:45
23be0486f64adf6fbe5cdd13f7277e67d64b4339...ba311ee58a7114270d7853ebae5f1e86efdc8005,1,4,4,8,4,2014-10-14 15:45:29,2014-10-14 15:45:29
bdbdbcc945739bf59324557919e004187e7acb8b...c42d2625d1c86aca5a724ec73d16178cae73ae90,1,32,39,71,33,2015-02-18 22:06:58,2015-02-04 14:07:37
bdbdbcc945739bf59324557919e004187e7acb8b...3cb78bfa76b2b4cc13d697ba6d0136465588828f,15,15,0,15,15,2015-02-04 16:07:56,2015-02-04 15:03:06
bdbdbcc945739bf59324557919e004187e7acb8b...132d0028ba5b3ab608e3a6fc198d4196466bab27,3,184,17,201,5,2015-02-04 15:53:31,2015-01-23 18:58:28
bdbdbcc945739bf59324557919e004187e7acb8b...fdfa2057863e4fd32d477855f8c8f289c0898293,3,32,2,34,3,2015-02-04 15:20:28,2015-02-04 15:20:28
eda9c14cb9d3bd6a99ea8badbdb0446cd4c1faf9...270642643452b440b159216d843ea4fc2239ff4f,1,2,2,4,2,2015-02-06 06:07:17,2015-02-06 06:07:17
270642643452b440b159216d843ea4fc2239ff4f...0552f1a0caf8f8e57736d05c2ed42f82e97df5f6,1,21,0,21,1,2015-02-07 23:04:22,2015-02-07 23:04:22
989ca9b357ba6e229aa53c881b2400a192edfc36...88fdcfef02cdc8b4fcff10cded6a89a42a360ec1,2,2,2,4,2,2015-02-04 17:21:36,2015-02-04 17:21:36
989ca9b357ba6e229aa53c881b2400a192edfc36...8475795f76eed9d76cef409f636624936b3a2ec4,1,0,3,3,1,2015-02-03 19:50:46,2015-02-03 19:50:40
8475795f76eed9d76cef409f636624936b3a2ec4...2e9c498e347bdd15befc5e38ce831d7b07a828aa,1,6,1,7,2,2015-02-03 23:04:37,2015-02-03 23:04:37
414a37f90aa7f01a29e4abdf04b73bb46c896e18...0ce42dcc96d0f3bbfb89b23eb3c255d2ddaa9624,7,131,59,190,10,2015-02-07 00:28:49,2015-01-31 00:23:47
7cc98582233bf9873007d6e6c3d05a4f8fac601b...969ba5c7edfdca1d97a836e9549d80ce547a86a0,1,34,41,75,3,2015-02-06 21:02:58,2015-02-04 23:28:51
7cc98582233bf9873007d6e6c3d05a4f8fac601b...2507e0b64fc037a38bf48405b9a0cce1e56cb7c8,4,8,0,8,4,2015-02-05 00:12:05,2015-02-05 00:12:05
7cc98582233bf9873007d6e6c3d05a4f8fac601b...1095d5e5e43654aa27952f131b71c55f18fedc4b,3,10,13,23,5,2015-02-04 23:37:14,2015-02-04 23:37:14
7cc98582233bf9873007d6e6c3d05a4f8fac601b...72a9000fcfa2ec5a2c4a29fb62a17c34e6dd186f,2,2,5,7,4,2015-02-04 23:06:34,2015-02-04 23:06:34
93e78ac8e7a0d4d08638ae4a7cd987505915cfb9...cddb443da428c0b9c9f4f5910a36f478110db224,1,7,5,12,5,2015-03-11 19:14:32,2015-03-11 16:56:04
93e78ac8e7a0d4d08638ae4a7cd987505915cfb9...2687502ba4e3d3eb41b6da6b52de151ef5dca9a2,1,1,0,1,1,2015-03-09 23:54:08,2015-03-09 23:48:48
93e78ac8e7a0d4d08638ae4a7cd987505915cfb9...fb25a2f2aa757bbb96892cdac6db79049c253603,1,2,0,2,2,2015-03-09 12:36:09,2015-03-09 12:36:09
93e78ac8e7a0d4d08638ae4a7cd987505915cfb9...79a0fa29f1de0be0d69adf54a63eed7312d4be70,2,5,11,16,5,2015-03-08 23:18:43,2015-03-08 23:18:43
79a0fa29f1de0be0d69adf54a63eed7312d4be70...4ab18fa2ac119c26516f2156dabda9dd0a781301,1,5,5,10,1,2015-03-11 02:28:55,2015-03-11 02:28:55
7c4951d552d25c0608c44d03529c6b8cbe5d1e06...44ffb199d03f0d63a2c9ad05e9fd03a6a08c594d,3,89,45,134,26,2015-03-11 05:48:35,2015-03-10 03:53:28
f208201375278e0e572d2a7f5a57e5c8b2ee1e4b...2f69da2a5ef77966a057ff139d442e9f14ca7083,1,1,1,2,1,2015-02-08 20:36:00,2015-02-03 14:42:26
f208201375278e0e572d2a7f5a57e5c8b2ee1e4b...06ea5fe979f39645fe0bcac4c830f4ccb7a7b6ae,3,13,11,24,5,2015-02-08 12:56:18,2015-01-30 02:55:22
f208201375278e0e572d2a7f5a57e5c8b2ee1e4b...e4f02abb51534e560311b0afcfb7b586d9587e67,8,85,29,114,25,2015-02-08 11:36:49,2015-02-04 17:34:25
e4f02abb51534e560311b0afcfb7b586d9587e67...d1e9d07c1b09a145b881a7ee6d58cc2e860167c8,2,29,27,56,15,2015-02-08 16:09:02,2015-02-08 03:30:44
934535db9c78b20481c8ccabdf174926c6e04d4d...de35ef2ebed3a7e8173abae39933d04e9874790c,1,14,0,14,1,2015-02-19 23:46:38,2015-02-19 02:45:39
934535db9c78b20481c8ccabdf174926c6e04d4d...27c61c39db414dd717aea04fc9440ee6d02b626d,1,20,12,32,8,2015-02-19 23:32:00,2015-02-19 21:33:23
309eec23787d9e1e4de58b6475467a1af73c4c26...2ba0fbb0ae1701b638a4bb956187dd878385dc80,4,43,0,43,4,2015-02-27 15:27:12,2015-02-27 15:27:12
309eec23787d9e1e4de58b6475467a1af73c4c26...c1b7792186c2408817e5027fdc1c2e4fa355dcf4,1,2,1,3,2,2015-02-27 04:08:16,2015-02-25 08:04:46
309eec23787d9e1e4de58b6475467a1af73c4c26...d9d9175507f3ac2d43fa27bc5f0710c79cd14cfc,2,34,1,35,2,2015-02-26 04:01:35,2015-02-26 04:01:35
309eec23787d9e1e4de58b6475467a1af73c4c26...690a85797e70c3816a1dec768bff0c454e1e23a9,3,10,10,20,9,2015-02-25 16:09:47,2015-02-25 15:59:29
690a85797e70c3816a1dec768bff0c454e1e23a9...7e7646c28a599731e62afec4c0c4dc0942309b7f,3,4,4,8,4,2015-02-25 19:52:37,2015-02-25 19:52:37
309eec23787d9e1e4de58b6475467a1af73c4c26...f6e95ef3a4d379fa2d5bd42bd293d61768d8208b,1,10,0,10,4,2015-02-25 09:09:06,2015-02-25 08:53:43
309eec23787d9e1e4de58b6475467a1af73c4c26...e2aa8f0cd984fbb31231240052e5505e1b1e3d2f,2,13,0,13,3,2015-02-25 07:19:59,2015-02-25 07:19:59
309eec23787d9e1e4de58b6475467a1af73c4c26...26444e5e9ad3bc2babd62b76a9a4b46d82414738,1,1,0,1,1,2015-02-25 05:04:47,2015-02-25 05:03:50
309eec23787d9e1e4de58b6475467a1af73c4c26...5ecab9e831c6d39e649430013087a3e2a85fb949,6,11,7,18,8,2015-02-25 04:23:53,2015-02-25 03:43:29
309eec23787d9e1e4de58b6475467a1af73c4c26...1e746a8a2b2f8a88903feca430f254605dcc6cc8,1,2,0,2,1,2015-02-25 02:29:26,2015-02-25 02:16:57
1e746a8a2b2f8a88903feca430f254605dcc6cc8...2420c1f03bba2c90d2406e486974cdc0c8af0cea,2,18,14,32,3,2015-02-25 18:27:32,2015-02-25 18:27:32
2420c1f03bba2c90d2406e486974cdc0c8af0cea...1a5ea50aa81112c745030b3cf421a9baebcdb9f5,1,2,2,4,1,2015-02-25 22:04:35,2015-02-25 22:04:35
21811f07861007da1481c7a1ad100720e09ffa98...53ece336dcab8e778fc37afc7a264f7d168110ff,5,72,19,91,8,2015-02-26 18:31:18,2015-02-25 18:27:14
21811f07861007da1481c7a1ad100720e09ffa98...17b6583a5a352d5cf6d8ba20b018dc96f231f476,1,11,3,14,4,2015-02-26 18:24:34,2015-02-26 02:08:17
2768ce0e4e773d0a0331c6294f31fd9ff9450062...202709d178a24bcbfac223f0bcd9c4eda669e928,1,1,1,2,1,2015-02-27 22:48:39,2015-02-27 22:48:39
2768ce0e4e773d0a0331c6294f31fd9ff9450062...caaae78247d9ceecba07da381401c2376b478c2b,3,5,5,10,5,2015-02-27 22:40:04,2015-02-25 04:19:49
481e75203d8c5db264a795c35d422d081a2f03b0...ab545aed4c90134b33c9aab600ab2d18b6eafd73,167,2,32246,32248,95,2015-02-26 01:41:39,2015-02-17 04:05:38
ab545aed4c90134b33c9aab600ab2d18b6eafd73...3e84b9e56abdff7230e84a1830085c79c73aa3b7,6,42,23,65,8,2015-02-26 01:41:39,2015-02-18 04:20:46
3e84b9e56abdff7230e84a1830085c79c73aa3b7...8d4459fffb5c1885b65506093538e059f0b51d90,3,15,6,21,6,2015-02-26 01:41:39,2015-02-25 00:37:36
8d4459fffb5c1885b65506093538e059f0b51d90...ac47a877403a894ac02724aaa111870edc7c2f8b,2,15,3,18,6,2015-02-26 01:41:39,2015-02-25 12:35:08
ac47a877403a894ac02724aaa111870edc7c2f8b...0365e8c20422f96d14c6448218b02e59734e59ea,1,10,0,10,10,2015-02-26 01:41:39,2015-02-25 12:46:55
0365e8c20422f96d14c6448218b02e59734e59ea...6d4b0f53342f4b56ad0770bd0e1bce6fcd898a41,3,35,0,35,3,2015-02-26 02:11:29,2015-02-25 23:46:55
481e75203d8c5db264a795c35d422d081a2f03b0...8be8e41429a3af59df35a6b0281eefd2bb34e1b5,1,1,1,2,2,2015-02-25 23:53:07,2015-02-25 23:53:07
70092e5ebbb0afe9ce6b125643265541298309fe...d173669fdff8ec1acc33d2da28e2a473a3844e56,1,2,2,4,2,2015-03-19 12:38:00,2015-03-19 12:31:12
831c796fb7cdf7f9bd429d65b6e420405e2cae83...60ef4ae6fcb015546a646eb3b613344a9c4fc27b,11,139,35,174,19,2015-03-19 18:42:23,2015-03-19 18:42:23
9324cdac07484373c752f3368c3cb30db070b839...a6824ea7f2b22f7c3da11307c55acd04dac6505a,2,12,12,24,10,2015-03-04 16:35:56,2015-02-26 17:25:57
9324cdac07484373c752f3368c3cb30db070b839...2e567d22da23773bbd7997cec138c0ea92b69cb3,1,1,1,2,1,2015-02-26 16:45:59,2015-02-26 16:45:59
2e567d22da23773bbd7997cec138c0ea92b69cb3...02639c03b78e325f2e87e0fbcb4f1db4e04fe847,2,1,1,2,1,2015-02-26 16:48:58,2015-02-26 16:48:58
082b7726e22c4e7e161cb715158675ed24fc3e4c...48354301659d870bd23e643c6e916a5a652ae93c,1,9,2,11,2,2015-02-26 21:03:39,2015-02-26 20:49:22
cf071bb9620cc36ab446c467a332a7c287856726...b5763f8fa7309f95e21271fca99d0a71c05d0fef,2,6,0,6,2,2015-03-18 05:10:02,2015-03-18 05:08:17
cf071bb9620cc36ab446c467a332a7c287856726...efa65d16b6e0b835c1786a47140c974e5c0f71cb,1,7,3,10,3,2015-03-18 03:35:44,2015-03-14 08:31:35
8e6d0107df333c29f736e69442a81ed001a41073...f5a154f2d2b2bea5054ae35314d15021a8bf8ae4,1,0,7,7,1,2015-03-17 23:04:15,2015-03-17 23:04:15
e79c91447f623da6ac9bd5f8097a4e54421b50ab...03de73a5e075e16656f5399f1957f7190f7bdc44,1,1,1,2,1,2015-03-13 15:18:10,2015-03-13 15:18:10
50c6c675e666d2e17a961b40a82306219053c2a1...906974b185b431a8c493479f748677f3c0bc4ca3,3,3,3,6,3,2015-03-13 09:14:56,2015-03-13 09:12:02
83bf0ac96d0ce41c4f74735a7a17a71641f7ac2f...69246e15276d7010c00269be140b9fb1a5c11ae5,3,72,41,113,5,2015-02-25 17:24:34,2015-02-13 19:46:14
83bf0ac96d0ce41c4f74735a7a17a71641f7ac2f...b686b65c9b5f5eabc7a618faf0055aff06e4c0c4,5,27,3,30,22,2015-02-23 22:08:05,2015-02-19 04:06:23
83bf0ac96d0ce41c4f74735a7a17a71641f7ac2f...44adbf23b5476ce26f807f956a21f27f07311a10,1,3,0,3,1,2015-02-23 21:12:44,2015-02-23 21:12:44
aa073ac05e6171ddfbaca4977f002b821a45f556...df5334183fd681812f0d2cb03600d3eb0f3ef513,2,11,22,33,6,2015-02-17 09:29:23,2015-02-14 06:59:01
aa073ac05e6171ddfbaca4977f002b821a45f556...00cd214afe46e79848e0f807bcdd19c20251cd2f,1,2,1,3,2,2015-02-14 07:26:08,2015-02-14 07:21:16
aa073ac05e6171ddfbaca4977f002b821a45f556...48d8757700f876ffdeb22d76261128238a8f7a17,1,4,9,13,5,2015-02-14 06:12:06,2015-02-14 06:01:58
aa073ac05e6171ddfbaca4977f002b821a45f556...8f5156e584233f3e83cfc889583fa016aabfeea9,1,1,1,2,1,2015-02-13 17:18:46,2015-02-13 17:18:46
aa073ac05e6171ddfbaca4977f002b821a45f556...8017cb0d3b0fdb1dc9367b8445b3bc456d4666c7,1,3,3,6,2,2015-02-13 15:11:16,2015-02-13 15:02:54
aa073ac05e6171ddfbaca4977f002b821a45f556...75f1c440dd9332d28d33585bf16e05a7647412c9,1,1,1,2,1,2015-02-13 12:57:04,2015-02-13 12:37:21
aa073ac05e6171ddfbaca4977f002b821a45f556...82fda400b8a2528b1b90e64fc4be6827afbd04ed,1,2,2,4,2,2015-02-13 11:52:11,2015-02-13 11:52:11
7829e7b40fafdc6bbe4489cf91a01fbf381c73b9...967d85a28fa1e9a8ac4d668960bca8760af2b722,1,15,9,24,8,2015-02-19 22:45:26,2015-02-18 07:59:13
7829e7b40fafdc6bbe4489cf91a01fbf381c73b9...401e93bbb9b4bd682234f0ebca59aa83bfbe3f2e,1,9,1,10,4,2015-02-19 22:05:14,2015-02-19 15:18:58
f70567e9a9a8c086f798f2c3b00f93ad1ae40b15...b422d8da8f1d1e51da6cfff4890e6a08252da7c5,2,16,9,25,7,2015-02-21 03:42:01,2015-02-21 03:18:30
f70567e9a9a8c086f798f2c3b00f93ad1ae40b15...54ca9aca71e4cbbff55f42ae88e8c8b8b5be4eec,1,2,4,6,2,2015-02-20 23:05:52,2015-02-20 23:01:08
924b7154baa94e639b8655087e4ba5a5cf0125a4...0826ac1581bdb71b889a0cb260422ce985aca317,4,45,2,47,4,2015-02-17 02:38:52,2015-02-17 02:38:52
924b7154baa94e639b8655087e4ba5a5cf0125a4...a9a19bd91122984b9efaae81cb8b0becb99c96de,3,63,0,63,3,2015-02-16 18:20:00,2015-02-16 18:09:18
924b7154baa94e639b8655087e4ba5a5cf0125a4...effa5e2c18f27b81fc46d1a925d04e6af5695459,1,69,77,146,24,2015-02-16 16:46:07,2015-02-16 16:43:09
f2d2862459ee501bafec2b0f33e52ae849dd7993...92c353582c210ebc351f7f5911273af76398a2a8,2,40,2,42,2,2015-02-20 21:38:03,2015-02-20 21:26:11
f2d2862459ee501bafec2b0f33e52ae849dd7993...4581240e585d5188955507fbd1de1affcd2ffc1b,1,3,2,5,3,2015-02-20 20:25:10,2015-02-17 00:59:41
028968f1a2de966fdabcc76244d8a57ea68da411...a69b189fc5796248bedc01a9feb34da765c73547,2,6,0,6,2,2015-02-17 02:22:28,2015-02-17 02:22:28
839660ada11389892c0dfd43060b69ec7725d7b4...380fe94614cecad6af85263af17245c5fc4103e8,2,5,5,10,4,2014-10-13 23:20:55,2014-10-13 23:16:17
587e2f1ddc98ab3fafaea9647b4abe2419223e3f...5bcff59febc1ac798d735b52cc4e92db1ab41bd9,1,76,17,93,9,2014-10-14 02:05:09,2014-09-25 04:13:30
dc243c812b7f5584bb5c1d0008839e4bdf0152c0...3893e220e840054dfdadba637372bc30f683fe58,2,11,1,12,2,2014-10-16 18:52:14,2014-10-16 18:39:22
dc243c812b7f5584bb5c1d0008839e4bdf0152c0...7a062b2b8f7751fbb926e6ddc9f7df8a1b281eb6,3,9,1,10,3,2014-10-16 02:39:51,2014-10-16 02:39:51
dc243c812b7f5584bb5c1d0008839e4bdf0152c0...63637b9d277d322a06f24e3195fab48bc2a705d6,3,17,4,21,6,2014-10-15 08:47:15,2014-10-15 03:33:11
63637b9d277d322a06f24e3195fab48bc2a705d6...3f2eb353bdbb36ce26690909bcf761d4289294d6,1,1,1,2,1,2014-10-15 18:08:23,2014-10-15 18:08:23
dc243c812b7f5584bb5c1d0008839e4bdf0152c0...1c68de798fdebba5eefa1c66a79e946c7bb06fb5,2,11,1,12,3,2014-10-15 07:24:53,2014-10-15 07:24:53
dc243c812b7f5584bb5c1d0008839e4bdf0152c0...a64ff0bf7a8c69e5698dc7e757d4ac56dd91b738,4,8,8,16,4,2014-10-15 06:48:43,2014-10-15 06:48:43
dc243c812b7f5584bb5c1d0008839e4bdf0152c0...a1ef2207dd1f63a4104cfbf7927931174f5438a5,3,11,0,11,3,2014-10-15 04:00:17,2014-10-15 04:00:17
a1ef2207dd1f63a4104cfbf7927931174f5438a5...96f342f7030c3955900f8f2ddf06b0d36b1d993c,3,12,3,15,5,2014-10-15 08:44:14,2014-10-15 08:44:14
dc243c812b7f5584bb5c1d0008839e4bdf0152c0...7fa449191ce9abc3e0a5261b66d8338948f66940,3,3,2,5,3,2014-10-15 03:08:18,2014-10-15 03:08:04
dc243c812b7f5584bb5c1d0008839e4bdf0152c0...fbaa41b5aa920ca752481e1b94aeff29857cb76d,1,2,0,2,1,2014-10-14 18:17:41,2014-10-14 18:17:41
fbaa41b5aa920ca752481e1b94aeff29857cb76d...fcfe80f63397c0a8bdd6605798c0639ec3dcda56,1,4,4,8,2,2014-10-14 18:47:01,2014-10-14 18:47:01
dc243c812b7f5584bb5c1d0008839e4bdf0152c0...91f33fcaaaa47ef60acc4a8cfa7a2be41edd724e,1,1,1,2,1,2014-10-14 17:58:35,2014-10-14 17:58:35
91f33fcaaaa47ef60acc4a8cfa7a2be41edd724e...a44296603f8188278241cc8d8a353952ee50ec54,1,1,1,2,1,2014-10-14 17:59:01,2014-10-14 17:59:01
a44296603f8188278241cc8d8a353952ee50ec54...be31a66b7a1f015d4f1448baebd7c7eb2c23e506,1,1,1,2,1,2014-10-14 17:59:11,2014-10-14 17:59:11
be31a66b7a1f015d4f1448baebd7c7eb2c23e506...c091397d518408a7a9c493f066dc47438d588985,1,6,6,12,6,2014-10-14 17:59:19,2014-10-14 17:59:19
c091397d518408a7a9c493f066dc47438d588985...949ab477103c93d6d4779b35efbd647541eb1b14,1,8,8,16,8,2014-10-14 17:59:38,2014-10-14 17:59:38
c2f82bba0a7d365ae4712804d9aed50dff788898...c73e3bf4dc0382cd188db3e51c52eaf8bf605795,2,23,0,23,2,2015-02-06 23:00:00,2015-01-15 03:30:28
68b0ed54cb7ed9e4b66e8a9e0708577b32088de2...1e6e68361c6cc42ab92288e0a0132b14ef6c9426,1,13,8,21,2,2015-02-06 09:52:01,2015-02-04 03:36:52
68b0ed54cb7ed9e4b66e8a9e0708577b32088de2...66839cf3a6718f844e71d2561cc706c95f5629ec,1,20,30,50,11,2015-02-06 09:48:19,2015-02-04 20:22:28
66839cf3a6718f844e71d2561cc706c95f5629ec...eb814e4e703b4676e0cb410052d1145ee9f8628e,3,123,98,221,33,2015-02-06 09:48:19,2015-02-05 03:42:11
68b0ed54cb7ed9e4b66e8a9e0708577b32088de2...0b2f734462df3062acefe4bc4bd14d0604bae286,1,1,1,2,1,2015-02-06 08:52:09,2015-02-06 08:52:09
68b0ed54cb7ed9e4b66e8a9e0708577b32088de2...df3933621372e6f974801717cbb9fe3846efbfd6,1,4,2,6,1,2015-02-06 02:45:10,2015-02-06 02:45:10
1ff904e045c9415bb6d109742cd7f78316d44fa6...311a600f1912c0d2a30becffdecde6026ada2624,5,23,4,27,5,2015-03-10 02:09:12,2015-03-10 02:09:12
1ff904e045c9415bb6d109742cd7f78316d44fa6...0eb3544c43cb8e9488d6bf329ceecc11fa0db6f1,8,91,49,140,25,2015-03-09 08:13:20,2015-01-21 12:40:59
0eb3544c43cb8e9488d6bf329ceecc11fa0db6f1...fcf8e85a35cddfd1f75f652a513015bb6f169257,1,1,1,2,1,2015-03-09 15:58:14,2015-03-09 15:57:59
fcf8e85a35cddfd1f75f652a513015bb6f169257...0dcc970432677ddd13d8ed583de84ae075888228,2,18,17,35,8,2015-03-10 09:02:43,2015-03-10 08:56:42
0dcc970432677ddd13d8ed583de84ae075888228...40d540637168fd5781e0c4a9cbd91959b7407d96,1,4,4,8,5,2015-03-13 08:40:53,2015-03-13 08:34:27
6f0733a9e3ea96af823e750ff67925b05b6b4e33...2e95bb5f1a65d90f412568d6df82a9e2cdd3e790,7,177,45,222,43,2015-03-09 19:03:55,2015-02-19 10:01:27
6135ec89ad41bbf4ebf6af3b8830c0f332ac30c2...933f207fd8d413e6ba7fef283a0bf5bcfd923e9f,3,188,160,348,44,2015-03-10 20:30:46,2015-03-09 18:31:32
6135ec89ad41bbf4ebf6af3b8830c0f332ac30c2...b2f05c220721d5ef9a31fc259e3f6c2c057ab4ab,2,2,1,3,2,2015-03-09 17:14:56,2014-11-25 11:45:20
52f6da223839a5ac1fc003b259b74f6a02fc2858...8a5b50d65dae2d0607e046c57241dd6b46b65c6a,3,9,8,17,6,2015-03-13 23:08:34,2015-02-05 15:23:25
52f6da223839a5ac1fc003b259b74f6a02fc2858...a02256577ab0806f004e41fd94aaaed52d1aff97,1,1,1,2,1,2015-03-12 13:22:51,2015-03-12 13:21:58
52f6da223839a5ac1fc003b259b74f6a02fc2858...98610282c23746eed4399b5ddf4f7d93de255298,1,4,4,8,4,2015-03-12 11:06:48,2015-03-12 11:06:48
f92213af882761a739fa0d8408e180e437b1a380...0ab28c658952267af8e86a5b1055dd4b9cf0ec51,1,4,0,4,1,2015-03-02 22:01:56,2015-03-02 21:45:45
f92213af882761a739fa0d8408e180e437b1a380...351074edcd22e4ca587713feda541268a66cdb86,3,107,5,112,4,2015-03-02 21:38:19,2015-02-28 05:53:36
e0823b09ec679a64a0d9d0f73f470abbd43dd75a...4e5ea0c8755231dfffd7b82bc6551415b14ed0de,1,1,5,6,1,2015-03-04 21:24:17,2015-03-04 21:24:17
e0823b09ec679a64a0d9d0f73f470abbd43dd75a...e8dc07dabc962e02876cadfe5f7b508a2453bec1,2,58,36,94,2,2015-03-04 21:01:30,2015-03-03 03:15:34
e8dc07dabc962e02876cadfe5f7b508a2453bec1...26e5a9d76a802662bf287ce9de1f98988749636a,3,71,60,131,4,2015-03-04 21:13:22,2015-03-04 02:17:46
f5850e8e30b9420d26bd12136d8bbb6669d1e2bb...e2b8933d213b283578babc1d86538950295e4fc7,5,163,34,197,9,2015-03-04 20:16:31,2015-02-27 18:50:55
f5850e8e30b9420d26bd12136d8bbb6669d1e2bb...08ea03ccb9c6c671b465572e4a5c9a5d1da1fda0,1,1,1,2,1,2015-03-02 11:14:22,2015-02-28 04:54:01
f5850e8e30b9420d26bd12136d8bbb6669d1e2bb...39b3690ba1801b36c1f43fa220ae5128958a0739,2,3,3,6,2,2015-02-27 20:18:32,2015-02-27 14:45:37
f5850e8e30b9420d26bd12136d8bbb6669d1e2bb...b5eeab6e061d183be050143426dd7fd774c89a20,1,2,1,3,2,2015-02-27 16:24:41,2015-02-27 02:08:33
f5850e8e30b9420d26bd12136d8bbb6669d1e2bb...d5ea4bae4a15cc9f3c16c046389737682277ff0f,2,5,10,15,4,2015-02-27 11:09:17,2015-02-27 03:53:11
b52a2cfdf1aabf15a4a1a630b3899ae373516517...40dc18e2fa3724c5c4361f42a413c754ee03a492,1,1,1,2,1,2015-02-28 10:43:28,2015-02-28 10:43:28
b52a2cfdf1aabf15a4a1a630b3899ae373516517...5c1559a754f7b1fba45be01a6f1a4b3c7c6c4c68,1,4,4,8,4,2015-02-28 10:04:10,2015-02-28 10:04:10
b52a2cfdf1aabf15a4a1a630b3899ae373516517...a8713271355c68023ea090eb223682e784c64f93,1,1,0,1,1,2015-02-28 06:56:42,2015-01-27 19:02:24
a8713271355c68023ea090eb223682e784c64f93...91770ec9e4b5bce330ddebc421248d275549ccc5,1,13,4,17,5,2015-02-28 07:11:55,2015-02-28 07:11:55
89db94ecf904bf09dbf80ca879a2b759443e2392...c62230a879e0461c43a4fc7d2e2e2efdd466fedd,2,4,0,4,2,2015-03-02 17:33:26,2015-03-02 17:33:26
89db94ecf904bf09dbf80ca879a2b759443e2392...e5bc50b5cd5237e820f5a708d0c351581905f1e2,1,2,2,4,2,2015-03-02 16:52:53,2015-03-02 16:52:53
321f4f06837fb5b8c1e8beb472a41c4961ec6f3a...3f39050637d454e9ee8075153a917c8bfccb5bae,16,365,10,375,34,2015-02-26 00:37:43,2015-02-11 19:21:38
4bccf278bd1f19ac5d9499818bffa7fa6f8d7f98...5c05b5c992417cd7c6650b7dc785a06ca51ae228,1,67,0,67,1,2015-03-04 21:32:38,2015-03-04 17:14:58
4bccf278bd1f19ac5d9499818bffa7fa6f8d7f98...eeb36c9348b7af339638936a98d66ee4f9be62ee,2,18,0,18,3,2015-03-04 21:21:59,2015-03-04 21:18:45
98630b2ef62653d288430b25867ddacbf1731441...dd56fa190695a969673f6f663cd5fe78b7c22787,1,2,0,2,2,2015-03-04 11:01:39,2015-03-04 11:01:39
9732c254ad6eba3a1707f5b45b9023e672ca8613...c680dd9e5adfe7255ac4499bff26bbb6edf7fe78,2,62,16,78,9,2015-03-18 14:41:01,2015-03-18 14:11:01
42f5c874254798c2e2bc8060939e48ade5c97e23...844c0f154abff1fc6e9e3907b23d1f3d99b0e840,1,76,73,149,22,2015-03-20 04:07:02,2015-03-18 23:22:25
ef78cc01916da2dc77811c67864dd65f225b7452...88dc6cc2dfcc538f433c98c18652a5c84b0769d9,2,52,3,55,4,2015-03-18 00:27:53,2015-03-18 00:27:53
2243e32cbbf1c9809c262a7376d34ca43a7a36dc...ed345fb18ee9d003f30884b696628b75380a426a,7,47,10,57,12,2015-02-19 06:30:43,2015-02-14 10:27:31
2243e32cbbf1c9809c262a7376d34ca43a7a36dc...c1a54048e241bd565feabf274b79dfac61c396d4,1,5,4,9,3,2015-02-18 07:24:36,2015-02-18 06:18:28
2243e32cbbf1c9809c262a7376d34ca43a7a36dc...28842d3f093e69cf62a090a532aacba1e6ff6d1c,5,132,3,135,8,2015-02-18 00:51:04,2015-02-17 20:27:07
2243e32cbbf1c9809c262a7376d34ca43a7a36dc...d03ce18b0bfaa5abaaac10b5bfb4a8d92683c0b3,7,270,77,347,39,2015-02-17 17:58:58,2015-02-16 21:24:13
d03ce18b0bfaa5abaaac10b5bfb4a8d92683c0b3...0581e8652dd0debb235864eac46986ff3625e8af,1,16,8,24,4,2015-02-17 18:55:19,2015-02-17 18:55:19
0581e8652dd0debb235864eac46986ff3625e8af...abc6896984cfa1ac4ab39a4a683038eaa10dee5d,1,1,1,2,1,2015-02-17 19:02:25,2015-02-17 19:02:25
abc6896984cfa1ac4ab39a4a683038eaa10dee5d...1b36272dc30659e528e0dd7028e69b48fec3cdde,1,13,15,28,11,2015-02-17 23:59:29,2015-02-17 23:59:29
1b36272dc30659e528e0dd7028e69b48fec3cdde...112aa1e341e4c9392b27a3752d276671c0376f38,1,16,16,32,14,2015-02-18 00:10:32,2015-02-18 00:10:32
2243e32cbbf1c9809c262a7376d34ca43a7a36dc...112829434d5aa517a00d89c3b476233fa277eb94,1,1,1,2,1,2015-02-17 15:53:18,2015-02-17 15:32:12
2243e32cbbf1c9809c262a7376d34ca43a7a36dc...57abf4afe9f0416666475690c63b1c4ed03dd888,1,9,15,24,1,2015-02-17 15:12:02,2015-02-17 15:12:02
57abf4afe9f0416666475690c63b1c4ed03dd888...34b7c10e3eed8bd4d71b998d06ca10766ce4c754,1,14,0,14,1,2015-02-19 23:18:13,2015-02-19 23:18:13
2243e32cbbf1c9809c262a7376d34ca43a7a36dc...cad770f992ee5837273a02edb28f73624898bee1,1,4,0,4,1,2015-02-17 13:01:34,2015-02-17 10:15:51
2243e32cbbf1c9809c262a7376d34ca43a7a36dc...d7ec4360c14421c146642f0a514e829207607f1a,1,1,1,2,1,2015-02-17 01:11:31,2015-02-17 01:11:31
4f24b77826227a17048432a51d728a5ea05dceaa...6217f2944f7e9aea4a81615102b7c68740db9350,2,29,14,43,7,2015-02-13 20:14:38,2015-02-13 20:14:38
c6110bd48f75911dde94559b74010b881d32ac5d...5dfef4fe08b890022f600fe742e5a4372b023767,2,69,10,79,8,2015-02-16 18:52:23,2015-01-28 12:56:22
5dfef4fe08b890022f600fe742e5a4372b023767...ba99a73c2fc3050475bd6c066c32dcb557cf6f25,2,32,10,42,8,2015-02-16 19:08:32,2015-02-16 19:08:32
c6110bd48f75911dde94559b74010b881d32ac5d...029ca9829df1d42a67289e0318db416cdbcfaf35,1,1,1,2,1,2015-02-16 18:14:54,2015-02-14 08:01:33
df7ba57f5f962b1a2d2e267a89ae465541a92371...321874f37672b2424a7609caa1aac616b3b23c6a,6,43,12,55,27,2015-03-04 14:04:25,2015-02-26 04:16:44
9a827137725d13dbe14c577df40dc35d061152b3...74d0485885cbb0e5f7561bd31399e5c13209d8d6,1,14,8,22,1,2014-10-15 23:08:07,2014-10-15 23:08:07
5494432f917eb0f6e4cf73deed366f6830ec64ec...3bcd2006b56ad57caa7e8723c3269cbd50af1f4a,1,11,1,12,3,2015-03-12 00:38:35,2015-03-12 00:38:35
feb02a2bbf9b4b4eb8f68bcec652ac687195f462...ece4b5bde8ff6ea21b51275a69787191d12a5d65,1,3,2,5,2,2015-03-10 00:24:49,2015-03-10 00:24:49
feb02a2bbf9b4b4eb8f68bcec652ac687195f462...40c8e78757a75a9e251223f563fc5adb2bc9bf99,1,2,2,4,2,2015-03-10 00:00:45,2015-03-09 23:56:51
feb02a2bbf9b4b4eb8f68bcec652ac687195f462...9e63b0d0f9530a0a7d6445606062b8ca99793792,1,11,11,22,10,2015-03-09 23:55:00,2015-03-09 23:55:00
1a5e46ce8957149d45eb8792254625ae696c8e4e...1ec2eac50db2c98e00a488664625a22bf3757066,10,64,25,89,25,2015-03-16 10:46:07,2015-03-11 15:42:49
c3c29284ae677ef0b48601d6d3934d1cd4112228...add13cb7827aace3a14d0ec251d6d5d41a0a6489,2,1,2,3,1,2015-03-11 03:47:06,2015-03-11 03:47:06
e4b753c1de558a07a8a079b39013677211badbd7...17a784aa092fe2ccb6463e4e4d5e0ff5279b4efa,1,2,3,5,1,2015-03-10 19:18:43,2015-03-10 19:18:43
e2ca237aa26c73717af9111babf7f82c1123e5df...68a9cd63cc4ca3c898388fe814a2dd8b7fca385e,1,12,4,16,1,2015-03-16 22:09:40,2015-03-16 16:30:32
e2ca237aa26c73717af9111babf7f82c1123e5df...636037c3637eb1d09cc469cebe39ffb915bb0aa9,4,20,7,27,7,2015-03-16 19:22:00,2015-03-16 19:22:00
636037c3637eb1d09cc469cebe39ffb915bb0aa9...793ebba3d6c7882897125116cd22ade87c6f37a6,1,2,8,10,3,2015-03-16 20:42:59,2015-03-16 20:37:49
e2ca237aa26c73717af9111babf7f82c1123e5df...9839e9784d12a00666ceddbc4f2b1b730da420bc,2,11,5,16,4,2015-03-14 20:45:44,2015-03-02 21:11:49
8e107a93210c54f22ec1354d969c771b1abfbe05...6564e0ad2f63257458a5bad68f47504223b00285,1,3,1,4,1,2015-03-07 02:03:39,2015-03-03 01:40:10
8e107a93210c54f22ec1354d969c771b1abfbe05...ce02578317d03ea04f40416db96b679a55b55451,2,51,0,51,3,2015-03-03 22:38:45,2015-02-09 21:02:53
8e107a93210c54f22ec1354d969c771b1abfbe05...93c82360a6b530ef86769ee04e027f6159dc55da,3,13,12,25,4,2015-03-03 21:58:35,2015-03-03 21:58:35
8e107a93210c54f22ec1354d969c771b1abfbe05...8625a281c66180af867f59a041560bf5035ae404,4,4,10,14,6,2015-03-03 19:42:38,2015-03-03 19:41:26
8e107a93210c54f22ec1354d969c771b1abfbe05...5595da2bde6574fe13785f07c55a155a2e90a7ca,4,42,30,72,25,2015-03-03 18:02:23,2015-03-03 17:04:06
8e107a93210c54f22ec1354d969c771b1abfbe05...2c0e027ab9b7da131451d571c4d0f25bc5fc14eb,1,14,14,28,14,2015-03-03 15:39:04,2015-03-03 15:39:04
8e107a93210c54f22ec1354d969c771b1abfbe05...f3dd2db4ff7de1399a49af928cd3eae4fccf8764,7,30,15,45,17,2015-03-03 03:21:19,2015-02-09 07:15:07
f3dd2db4ff7de1399a49af928cd3eae4fccf8764...dc0a6c1f5edd78d23ab676c54c3e84df3c2b2bbf,4,7,6,13,5,2015-03-03 04:32:17,2015-02-27 05:38:16
8e107a93210c54f22ec1354d969c771b1abfbe05...dec67f7f573855cd1760ed180efc006f5a900c2d,1,23,23,46,10,2015-03-03 01:33:38,2015-03-03 01:33:38
dec67f7f573855cd1760ed180efc006f5a900c2d...e6a18da53f99185882ecd0e915c236cf9d14f522,1,21,0,21,1,2015-03-16 23:28:54,2015-03-03 01:42:26
32ccde46dde5130adcfb170c846c8f0317761aee...5118f1431c9cae757d5e7c193ed85fc8fca3ae85,1,32,0,32,1,2015-03-02 22:20:16,2015-02-28 05:37:25
5035fa1e21947bfd229639c5c83c89d6bda0a1a9...9be2ca2394112d8e988dc492f482cefd93a5b5fb,3,48,23,71,8,2015-03-06 18:25:47,2015-03-06 14:36:23
5035fa1e21947bfd229639c5c83c89d6bda0a1a9...f3d96e81e9c2a738ec577b814092f8953932de3a,5,50,11,61,11,2015-03-05 23:22:08,2015-03-05 16:39:32
5035fa1e21947bfd229639c5c83c89d6bda0a1a9...3c9425d40dbb069db9fe795eddc3fccfc62164f8,1,75,51,126,8,2015-03-05 17:39:10,2015-03-05 13:50:43
5035fa1e21947bfd229639c5c83c89d6bda0a1a9...9057ca2541582fc41eb7cb45edd332247a813bba,3,21,1,22,3,2015-03-05 05:22:01,2015-03-05 05:22:01
5035fa1e21947bfd229639c5c83c89d6bda0a1a9...26e85b0db1b896e98071f121fb14b2c6d905ed4f,2,36,1,37,3,2015-03-05 02:09:50,2015-03-05 02:09:50
92e632c84e7b1abc1a2c5cb3a22e0725951a82af...3a70f9d422e2d47dad0d8d5825832dd7f85f049a,1,4,3,7,3,2015-03-06 16:52:40,2015-03-06 06:01:49
92e632c84e7b1abc1a2c5cb3a22e0725951a82af...957bc8ac50ee4e2498143fca7848b4ccaab6147a,1,6,0,6,1,2015-03-06 03:39:14,2015-03-06 03:36:56
92e632c84e7b1abc1a2c5cb3a22e0725951a82af...8ba64b383dee8827c70f9c0a0d71aa61d0f0c595,1,3,1,4,2,2015-03-06 01:15:11,2015-03-06 01:15:11
92e632c84e7b1abc1a2c5cb3a22e0725951a82af...06a40f0f281b4679855a406bc202e122d2875949,5,31,1,32,5,2015-03-06 01:02:21,2015-03-03 03:15:17
92e632c84e7b1abc1a2c5cb3a22e0725951a82af...d046f56e8826f597ddd1752b9289d93b9054fa9d,1,2,0,2,2,2015-03-05 23:50:15,2015-03-05 22:42:52
1dddf8a9a6dcdca036a9e264831345516e88745e...1d4b2524ec080a19f47292020a7fb6a9a00c8932,1,2,2,4,2,2015-02-28 21:13:03,2015-02-28 18:53:48
661c31737dde7770d6f9bd5125ce85751887c3b7...06c939e5279eb62b9088202a27d02d67c1cba6a5,1,2,2,4,3,2015-03-19 21:21:19,2015-03-18 23:32:06
06c939e5279eb62b9088202a27d02d67c1cba6a5...2b12b099b8c60f02142ab8ece68987a8fba00292,1,6,1,7,1,2015-03-19 21:27:17,2015-03-19 21:27:17
fdf49d758f6f93d04077ad0c82a7fd7312b2ffdc...97c573bf020e946fe1b9af61269f7f13f7f63f67,1,35,0,35,1,2015-03-20 02:18:00,2015-03-19 17:06:06
50bf3cbedc923985868bd84515460aad174dcccb...ec7530afde3f45a31d51abe17f602a3c5dc6389e,1,0,1,1,1,2015-03-19 07:51:36,2015-03-18 17:31:24
50bf3cbedc923985868bd84515460aad174dcccb...e6ae89a45a699bd44f03517396777e34ec76018b,11,151,4,155,19,2015-03-19 00:57:13,2015-02-06 14:33:01
50bf3cbedc923985868bd84515460aad174dcccb...f4a458e67f9cedae9167cc70d15fd8bbe942f880,1,1,0,1,1,2015-03-18 21:17:21,2015-03-18 21:17:21
50bf3cbedc923985868bd84515460aad174dcccb...b6a42673abb8c2df5920343b9144a4ce422b2d50,4,39,6,45,12,2015-03-18 20:48:01,2015-03-18 18:44:14
50bf3cbedc923985868bd84515460aad174dcccb...bd8661e8fafd5f80ce12fa966b9f8e990b7d7714,1,11,2,13,4,2015-03-18 20:00:53,2015-03-18 19:52:42
d2cb3af75b5c8597be5cddfe15f1002f482870cf...73b33db04b29a516bf8c50fbe646f563298fcfd9,1,49,18,67,6,2015-03-20 20:11:05,2015-03-20 19:10:06
d2cb3af75b5c8597be5cddfe15f1002f482870cf...9ececa14ba860c9934d3cd8d3e704e53e828e22b,4,60,13,73,17,2015-03-20 16:34:39,2015-03-18 06:45:30
068d343ddfad23ca2f7b407f5be03803029ac311...0306a41909175b467d08ebc97d4c5136ca9e7ebd,5,91,5,96,7,2015-03-19 02:07:55,2015-03-19 01:44:15
6374c12fbb09d3fa04a46bc951e3c9e8baeac63f...dba4651760d3ba41ea94cb9ab55abcd91cce1229,1,2,2,4,1,2015-03-13 18:48:09,2015-03-13 18:48:09
6374c12fbb09d3fa04a46bc951e3c9e8baeac63f...14887e2e1f8d11f30ab8c25beed0ff9e70354005,3,166,0,166,3,2015-03-13 18:46:59,2015-02-03 23:41:26
14887e2e1f8d11f30ab8c25beed0ff9e70354005...47a6afb93f7f71c7ef7dc692c0f50ac81b5a8c98,13,242,50,292,32,2015-03-13 19:13:21,2015-02-04 19:04:58
47a6afb93f7f71c7ef7dc692c0f50ac81b5a8c98...dd6d2cd6603af51a49e41048511038ed8770d32b,1,143,0,143,2,2015-03-13 19:13:37,2015-02-04 21:44:52
dd6d2cd6603af51a49e41048511038ed8770d32b...bdf3a0295d401624483d4103fdaacc2bea1c7d46,11,67,3,70,16,2015-03-13 22:02:09,2015-02-06 00:24:47
6374c12fbb09d3fa04a46bc951e3c9e8baeac63f...eade8eac09ad8cfdaf762e88d382daf6017201d7,12,56,19,75,13,2015-03-13 18:33:49,2015-03-13 18:33:49
6374c12fbb09d3fa04a46bc951e3c9e8baeac63f...334382a8c31285689f0b060de81b8f631d928970,1,5,0,5,1,2015-03-13 18:12:50,2015-03-13 17:51:54
6374c12fbb09d3fa04a46bc951e3c9e8baeac63f...cdfdfbfb6223fdd5b319942d412caac6bc09cdeb,14,113,8,121,22,2015-03-13 16:47:09,2015-02-17 15:20:06
cdfdfbfb6223fdd5b319942d412caac6bc09cdeb...abb5e9a0777469e64fe2c7ecfa66ea01083d2071,8,264,11,275,23,2015-03-13 17:02:04,2015-01-07 00:04:10
abb5e9a0777469e64fe2c7ecfa66ea01083d2071...389eee1084ea7613fa56e5f6b3e24678bf9aebc2,3,30,1,31,7,2015-03-13 17:02:04,2015-01-22 20:47:10
389eee1084ea7613fa56e5f6b3e24678bf9aebc2...7d89e66dac59999ae2f07970b273e227fdf73ea7,13,296,21,317,23,2015-03-13 17:02:04,2015-02-17 00:36:03
7d89e66dac59999ae2f07970b273e227fdf73ea7...5de1298f41ad0ab0b13c839854d6b2a5354294b8,1,21,1,22,2,2015-03-13 17:02:04,2015-03-09 05:18:59
5de1298f41ad0ab0b13c839854d6b2a5354294b8...03cea0ef23595ec711fc6e702e249f3561afa36a,3,21,21,42,12,2015-03-13 18:56:33,2015-03-13 16:38:41
03cea0ef23595ec711fc6e702e249f3561afa36a...fae92d5f0a1d81a48dc210d5ae28ef83c724b5ac,10,111,111,222,58,2015-03-17 00:08:40,2015-03-16 20:28:55
88c706e442fb489387ba8ef5fd2de42479f74b87...82e2e1a11af60a41100e2ced24f23cf2872e5604,2,40,0,40,2,2015-03-17 14:50:12,2015-03-17 14:50:12
88c706e442fb489387ba8ef5fd2de42479f74b87...fa1fa50160ec78f87ef7e461c752d9b4d1410cd3,1,35,18,53,12,2015-03-13 07:28:09,2015-03-13 07:28:09
09b785f3bed812736fe7526535088ca73c1fa10d...d0dc14e5d6fe5f8ef9d4a8a8dc95fa087439a5b4,1,16,1,17,2,2015-02-20 21:24:59,2015-02-18 07:20:20
09b785f3bed812736fe7526535088ca73c1fa10d...e39ea834a92154574be3dde67ae30acdb25b32f7,1,1,1,2,1,2015-02-18 03:29:17,2015-02-18 03:29:17
09b785f3bed812736fe7526535088ca73c1fa10d...0d41c6abadaee4c1b1d0ef1cf75b4642740a218d,1,6,0,6,2,2015-02-17 09:16:46,2015-02-18 03:03:30
a78ce5c228b895d8c614d72354a52e324817b9fc...70407ce40ca98d763da8472e7ee94b6e8d66912d,16,290,251,541,299,2015-02-20 22:04:36,2015-02-20 06:56:02
a78ce5c228b895d8c614d72354a52e324817b9fc...492a58f05fe026653e27ed75d3ad4221f2e615b1,5,28,0,28,7,2015-02-20 17:51:10,2015-02-20 09:37:27
492a58f05fe026653e27ed75d3ad4221f2e615b1...5d615dff10f31ea6bf77a1233b1821b0e525e456,2,2,2,4,2,2015-02-20 17:51:10,2015-02-20 17:35:32
a78ce5c228b895d8c614d72354a52e324817b9fc...11c7c9710a670ad1f49de8f2814caa51d2f7adb6,2,52,3,55,5,2015-02-20 16:27:08,2015-02-11 20:01:30
a78ce5c228b895d8c614d72354a52e324817b9fc...0050efcd8f82144ea7f6c74f9bc9af357743370d,1,1,1,2,1,2015-02-20 15:46:29,2015-02-20 15:46:29
a78ce5c228b895d8c614d72354a52e324817b9fc...6ecf23861ec7036aa4210fe6d3b7dbfaaedbd6d0,2,16,16,32,2,2015-02-20 14:56:21,2015-02-20 10:38:55
a78ce5c228b895d8c614d72354a52e324817b9fc...606283875616bf71af4814fc47ee5c2ca7b729c6,1,1,7,8,1,2015-02-20 08:58:44,2015-02-20 08:58:44
2eb9c0bfd457665840b1bc5b80cc5a967c1ede5d...143f438e6e7a4c8205af59ba6e9f52cb450f1cce,1,2,2,4,1,2014-10-16 17:36:36,2014-10-16 17:36:36
2eb9c0bfd457665840b1bc5b80cc5a967c1ede5d...d040de6dd4660041dd37792a9a702cf8317a71d9,1,3,3,6,2,2014-10-16 16:14:26,2014-10-16 16:14:26
2eb9c0bfd457665840b1bc5b80cc5a967c1ede5d...f6140060e3b7fc8e6f577ca95be0eb5bf8cd1fd4,4,9,9,18,9,2014-10-16 10:10:58,2014-10-16 10:08:15
5d174e000f9e0d0d4d557367ab7685834d190a71...46d4f12fbf25d605f2d034c8cc68f25a47164190,3,64,19,83,28,2015-03-12 14:54:22,2015-03-12 14:16:16
c5af44e6d0a1ae8cdc1a91de28c0b73dd5478fb2...1bf529a45674dc07de6efba806b854f63f3dc0bf,1,12,6,18,2,2015-03-19 01:46:53,2015-03-10 02:00:07
c5af44e6d0a1ae8cdc1a91de28c0b73dd5478fb2...0648e59ad85e676f8e0a02156ea5e79a6e106267,4,2,6,8,5,2015-03-11 03:38:37,2015-03-10 08:14:43
c5af44e6d0a1ae8cdc1a91de28c0b73dd5478fb2...42aec0c771fbc43398d02822383942ddcea49cb9,1,9,1,10,2,2015-03-10 14:00:22,2015-03-10 13:55:55
c5af44e6d0a1ae8cdc1a91de28c0b73dd5478fb2...a853f8e4687adb78c0e63019caae32b216cce925,1,4,1,5,3,2015-03-10 12:47:12,2015-03-10 12:43:49
c5af44e6d0a1ae8cdc1a91de28c0b73dd5478fb2...8d138eb7fa69ec0ca8d47220d56635d8acea2eba,1,1,1,2,1,2015-03-10 09:03:28,2015-03-10 09:03:28
c5af44e6d0a1ae8cdc1a91de28c0b73dd5478fb2...d172f1253a6a277dce71cd59b0d87119f3ed282e,4,227,178,405,48,2015-03-10 01:33:15,2015-03-04 20:05:17
c5af44e6d0a1ae8cdc1a91de28c0b73dd5478fb2...09b4c2585284d1125d4d299a7d58b36c1d0baf17,5,48,25,73,6,2015-03-10 01:02:59,2015-03-07 01:12:41
830544044edff87980a176d8984c1288822755cc...c0f7819905050ebdb583afba5b6f760d3892adb8,3,3,3,6,3,2015-03-12 15:13:00,2015-03-12 13:15:32
830544044edff87980a176d8984c1288822755cc...c5c72cf151b21482b2f27417322342c6d781108c,2,39,3,42,5,2015-03-11 19:39:31,2015-03-11 16:17:23
830544044edff87980a176d8984c1288822755cc...1b46248a332dab1a886d9c4352f9e0057e6c284f,3,4,4,8,4,2015-03-11 16:04:30,2015-03-11 16:04:30
830544044edff87980a176d8984c1288822755cc...779dca61e56696193de6fd5cbacdaba6c8f974ea,2,2,2,4,2,2015-03-11 14:43:33,2015-03-11 14:40:46
558c3b09db41a26d77dae831f4d55ee6947a60e5...f63a29ddeee62c8e4fcb1cf8eaf84aff305380c0,1,5,0,5,1,2015-03-11 10:46:01,2015-03-11 10:46:01
f63a29ddeee62c8e4fcb1cf8eaf84aff305380c0...2b051bcbda06ec48287e75da506bacf95be2b652,2,6,3,9,4,2015-03-11 10:58:32,2015-03-11 10:48:57
2b051bcbda06ec48287e75da506bacf95be2b652...491b63e0daa9103cf9471c03c4b41026f6955323,1,7,1,8,3,2015-03-11 13:24:30,2015-03-11 13:11:15
558c3b09db41a26d77dae831f4d55ee6947a60e5...802c90500073ad79e5a6520402ef2a7268c824b7,1,5,9,14,1,2015-03-11 09:14:49,2015-03-11 09:14:49
558c3b09db41a26d77dae831f4d55ee6947a60e5...12b278d3540bc32699e8c2197b556188fd98b77b,9,168,67,235,19,2015-03-11 07:50:27,2015-02-24 08:51:46
558c3b09db41a26d77dae831f4d55ee6947a60e5...179e45f27c5e6d526d4082296bba563705195755,1,5,3,8,1,2015-03-11 06:41:56,2015-03-11 06:41:56
13bfbfc84bd63fd2014bc6590a8a568c0560d5f8...645f8a32df3b5b22e5e194664a9f0733709714c9,4,32,3,35,4,2015-03-11 14:30:44,2015-03-09 21:44:14
13bfbfc84bd63fd2014bc6590a8a568c0560d5f8...72f366238f443f7cbbf4ada76bd5ab4b36495251,1,1,0,1,1,2015-03-11 00:01:06,2015-02-11 07:46:32
13bfbfc84bd63fd2014bc6590a8a568c0560d5f8...10c01fce45b27959db8d8131271f5ce27c1b4221,2,7,7,14,4,2015-03-10 22:13:34,2015-03-10 21:10:28
13bfbfc84bd63fd2014bc6590a8a568c0560d5f8...081c6c76e2e9924159e1d320525048e4657a9e74,3,62,50,112,6,2015-03-10 22:06:16,2015-02-13 23:08:42
13bfbfc84bd63fd2014bc6590a8a568c0560d5f8...d59212e6056da0ae4434882c3048f9b8c0c27518,1,3,3,6,3,2015-03-10 20:45:13,2015-03-10 20:45:13
7125ae00bb36e250a5b8662a6ec75e8d009e255f...b5036ad5c64f19a52806df500b6a89d9c3294ac6,1,6,6,12,5,2015-03-05 14:41:56,2015-03-05 14:41:56
e058b7980d6ddf09fac8ef68d806dcc26e63e264...f6f2bad7ea5ca642a261df4d8a0ddb43d09bda62,1,2,0,2,1,2015-03-06 22:45:26,2015-03-06 22:45:26
e058b7980d6ddf09fac8ef68d806dcc26e63e264...8c575f263dff23bec76dd0aa169e278fe4bfcb74,46,1853,204,2057,15,2015-03-06 22:10:55,2015-03-06 18:01:31
8c575f263dff23bec76dd0aa169e278fe4bfcb74...efde5ec9bea6ec6ea17a162a0031839b9a58392a,2,3,39,42,8,2015-03-06 22:21:17,2015-03-06 22:21:17
e058b7980d6ddf09fac8ef68d806dcc26e63e264...d1dc24e5db27f7a77458898ceb6be27a9acf01da,1,29,0,29,1,2015-03-06 22:05:26,2015-03-06 22:05:26
2a8a2d24285b40cf450f10dcb174dbef50e276ad...0e3f2f2ac07c69922bd837f864219a088d243248,2,33,13,46,11,2015-03-09 12:40:38,2015-03-06 20:44:31
2a8a2d24285b40cf450f10dcb174dbef50e276ad...2ea6c2c264f0f43beb877a83aea3e6e6ad38ae5d,1,5,2,7,2,2015-03-07 01:40:09,2015-03-06 21:38:05
2a8a2d24285b40cf450f10dcb174dbef50e276ad...518fdf972d874a9fd0e1af739ffc978c6b39e126,1,11,8,19,4,2015-03-06 17:06:14,2015-03-06 17:06:14
2a8a2d24285b40cf450f10dcb174dbef50e276ad...b3769f0ca6f70303e7fa4a3ec1cc47bab91de34b,1,6,0,6,2,2015-03-06 13:43:57,2015-03-06 13:41:41
2a8a2d24285b40cf450f10dcb174dbef50e276ad...00d3727106ef4d1280175a135b36b80c8bfc6a7b,1,9,1,10,6,2015-03-06 07:35:52,2015-03-06 07:13:27
a61716e5d93796ebc29b16942d5f27d387e56fba...15924f238503ffe44e5fcb99415ff753a36e5971,7,284,27,311,13,2015-03-04 02:38:50,2015-02-17 18:25:36
a61716e5d93796ebc29b16942d5f27d387e56fba...adfd1ddfc6e094295d07ff2b36fb6e91cf7878dd,1,4,4,8,4,2015-03-02 09:06:38,2015-03-02 09:06:38
a61716e5d93796ebc29b16942d5f27d387e56fba...f4ac86de84c25bf1793d1e934695b7119dc51b70,1,3,3,6,3,2015-03-01 18:11:15,2015-03-01 18:11:15
a61716e5d93796ebc29b16942d5f27d387e56fba...41dc0e08d3f77b334670cc2ff3fb1a0c16fd9300,4,12,0,12,4,2015-03-01 06:36:00,2015-03-01 06:36:00
455a272aef4e109ce57c20f9ea224e4d4b32ece7...49cb1a289f19565132824e67bb83a2e255b13c8a,1,2,2,4,2,2015-03-20 00:38:19,2015-03-19 22:45:01
620339f166984540f15aadef2348646eee9a5b42...b32bf64f6f3cc09334f52a08a4449a109ad123ff,1,21,4,25,1,2015-03-09 17:41:00,2015-03-08 03:13:56
620339f166984540f15aadef2348646eee9a5b42...43804baa33958466e2f487ce0b96cba475116ab1,1,26,2,28,2,2015-03-05 18:00:47,2015-02-19 12:43:09
d338c613bf7c9dc7e77bebf104ba83f69aaeb8a7...a8faba021c569a53f03ed68b27d2f53db2d70f3d,1,2,2,4,2,2015-03-19 15:51:12,2015-03-19 15:42:15
2cde817458a6ff3d371406cf226552fbd4fd3de9...74664dabff906f42b9acfbad516eeae484b47af9,2,26,0,26,2,2015-03-19 09:03:40,2015-03-19 09:03:40
2cde817458a6ff3d371406cf226552fbd4fd3de9...0b1e2b5a553565e99afd7ceda36beab098f506d0,4,11,0,11,7,2015-03-19 02:34:15,2015-03-16 22:42:15
0b1e2b5a553565e99afd7ceda36beab098f506d0...f7dd1333b5a6dfa34ce8b2fb15533f1aca6efdc3,3,9,0,9,5,2015-03-19 02:34:15,2015-03-16 23:06:47
f7dd1333b5a6dfa34ce8b2fb15533f1aca6efdc3...c7267017e931cee8ecd0e8d88473f26a80a3314c,4,87,2,89,6,2015-03-19 02:34:42,2015-03-16 23:41:38
e1a0bff6b8aefdea341d01a75a0c7e9235cda421...b311066d240e6f034c8a5749f01897739f26c7bb,1,3,3,6,3,2015-03-19 14:53:50,2015-03-18 22:08:40
54232084c59b0356141f5630beafdfc2d58970e9...b4ebcdef155d2c517192a07ddfa80e163d78b1b1,1,2,2,4,1,2015-03-19 15:11:51,2015-03-18 21:30:11
385d4beaa5060667f7b2ec51b16fef3f4830271c...0c0e9836c4bed0190718b0ddd0028790b19c200c,2,29,2,31,5,2015-03-20 13:12:59,2015-02-28 15:55:59
0c0e9836c4bed0190718b0ddd0028790b19c200c...16309bef6395a50ee2871780b81caed8bc6c498e,5,55,44,99,18,2015-03-20 16:34:35,2015-03-18 21:26:14
385d4beaa5060667f7b2ec51b16fef3f4830271c...b4beb0637a61c6002bb3b0b1dc150899db3b44e4,2,23,2,25,4,2015-03-20 12:55:48,2015-03-20 12:14:31
385d4beaa5060667f7b2ec51b16fef3f4830271c...301bd57b1d5ce78fe3e26f68c8f8f797abfbb5ca,1,4,0,4,1,2015-03-20 12:36:34,2015-03-20 12:36:34
a97fbe7d7819041e605048ab386bbd5fba2d5b33...949a21b55f3b8d7d1ae7a7b9829111a8f0dbf7e2,38,13,79,92,15,2015-03-13 20:04:08,2015-03-13 02:16:56
334382a8c31285689f0b060de81b8f631d928970...8ef79ae8e42ae020a373712bd7d08bcb81e3fa97,1,1,1,2,1,2015-03-14 23:02:53,2015-03-14 23:00:38
b6ac111abfbed628a80b67f0b092a248083b354c...6784a772baaa20936f00b8adc00a4b4444356181,4,4,2,6,4,2015-03-17 05:53:41,2015-03-17 05:23:40
b6ac111abfbed628a80b67f0b092a248083b354c...173642c8660adb39619ecfe725bd44b984d4c627,1,7,0,7,1,2015-03-17 05:20:25,2015-03-17 05:19:59
b6ac111abfbed628a80b67f0b092a248083b354c...6ddfe883dd0d6ce1f97a121652927ac1b1dbaefe,8,87,77,164,34,2015-03-17 04:49:33,2015-03-17 04:49:33
cb77ad4757947adcff7bf4cd95969e75a7018614...04ca2c1f2bcf9251689dc346baed6715fb99fb0e,1,230,99,329,50,2015-03-17 16:07:10,2015-03-17 16:06:23
61e7efeadd3af1d9cf666866940d999ae7fd450b...55f0ca94e57fc8ec26a79061d04ddd3aeaecb94b,1,10,8,18,10,2015-03-16 21:21:00,2015-03-16 21:18:33
2f024bd9e1d0c0ba13e915c486d0c3cd7c2e68bb...b7a1776878d4851019c65edee1df10fda530dc9a,1,1,1,2,1,2015-02-18 16:26:24,2015-02-18 14:02:48
2f024bd9e1d0c0ba13e915c486d0c3cd7c2e68bb...06c01b02f5d8149407028324e751df5c0a92fd14,6,14,4,18,11,2015-02-18 15:19:52,2015-02-06 17:25:42
2f024bd9e1d0c0ba13e915c486d0c3cd7c2e68bb...2f35f60348663b3775f038eadea4fccbd0591725,1,1,1,2,1,2015-02-18 13:07:17,2015-02-18 13:07:17
2f024bd9e1d0c0ba13e915c486d0c3cd7c2e68bb...c5b312dcf5efa4f91dee59f4b701ea7a26a6d41e,1,14,6,20,7,2015-02-18 10:27:44,2015-02-18 09:55:08
009efd04c1d85004affb0c347696a9fdbeb9d31f...06685a53c16468a5fd3dfcc247a7a8dd5aaf85c1,3,14,10,24,7,2015-02-19 21:18:20,2015-02-18 07:57:44
b062ef05e59ecfc0c08dccdea3d81c024c491350...6bbb456138e48c7558cfe5c797c57d136f1a694b,2,9,4,13,5,2015-02-21 07:14:38,2015-02-16 19:32:25
6bbb456138e48c7558cfe5c797c57d136f1a694b...102e0611475c7267dd4d2a87044fcc40b2eddcc0,4,22,2,24,5,2015-02-21 07:24:30,2015-02-21 07:24:30
b3052b0fca571683fdfc7328152239ebb9a35f4e...4f0429621c7e6ccaac8bc9a62a703bf68f2d4cd4,1,0,3,3,1,2015-02-20 16:51:42,2015-02-20 16:51:42
973c32c8a07bca01aa5889689f37b99694673490...80d585b0c7f3b48e6d2342d63f9e5b41cd3c3fdb,2,2,0,2,2,2015-03-04 16:28:32,2015-03-04 15:10:56
565cff84b1ae13e21fa74af83e58d29bafbca47a...7804cd36eec45c184dcabdbcb52033c1c0179c03,1,14,0,14,1,2015-03-16 22:39:50,2015-03-12 21:59:57
565cff84b1ae13e21fa74af83e58d29bafbca47a...27aab3acc6b38ddc39d19e16d61d47f0a4436350,1,14,5,19,5,2015-03-12 18:32:16,2015-03-12 16:09:23
2fb89b2e2ca1043abf8d4c02532ce42135efe6f6...c8c11bfc363363fcc26da5868292544cbabea320,1,1,1,2,1,2015-03-10 15:50:03,2015-03-10 15:50:03
c8c11bfc363363fcc26da5868292544cbabea320...821ec8334fd4ff3500b4e2d2338f3cc8935e17bd,1,3,0,3,1,2015-03-10 16:43:11,2015-03-10 16:43:11
1b1cc100f2859c937ddad9adfe6059bb48e514a1...2977fd2b7aed42008ca2ad90dcd8fec5ead4e86b,8,54,2,56,12,2015-03-10 22:29:05,2015-03-10 18:25:47
8ae20d8eba127361bc07260580e2d3b8e3628c3e...3559b4177e611920d87c4dae607c641efb645783,4,56,54,110,39,2015-03-16 21:14:45,2015-02-14 03:10:14
d010bf0d994ce562a3be693f6afef71d55bea887...c553be5a4f3ff24079337e2ffe2437325f9969e1,16,160,39,199,30,2015-03-11 18:49:15,2015-03-11 18:49:15
d010bf0d994ce562a3be693f6afef71d55bea887...89e2e5fc55620634df3f2c9403594b0f701b0c5c,26,758,66,824,75,2015-03-11 18:29:13,2015-03-11 17:43:56
d010bf0d994ce562a3be693f6afef71d55bea887...e424c54d9c4030dc3290701e8e76add372e09e08,4,47,26,73,25,2015-03-11 17:28:56,2015-03-10 21:19:32
d010bf0d994ce562a3be693f6afef71d55bea887...4602241f11b626d40bf67cfe3a13d3c146adf335,3,167,1,168,3,2015-03-11 17:11:13,2015-03-11 17:08:51
d010bf0d994ce562a3be693f6afef71d55bea887...ed3f3835071496e9314d0e2a1806ac43f304decc,1,1,1,2,1,2015-03-11 17:09:40,2015-03-11 17:09:40
495f5e4998d5d6d4eb2115a196cb33ae7716ab9b...0cd857d99f3b57db7db9f8668f57fb1788a7ae01,1,2,1,3,1,2015-03-15 11:35:43,2015-03-15 11:20:38
495f5e4998d5d6d4eb2115a196cb33ae7716ab9b...dc899c4eaf1261ba0d5a740271bba0bfc866ae3c,3,5,3,8,3,2015-03-15 04:31:36,2015-03-15 04:28:55
dd6f76a76cb4e12d74fcd974ebd6a9c4f8d43751...004ac85aa25f08e350465140ee7404ad31602d75,1,4,5,9,4,2015-03-11 21:27:11,2015-03-11 05:09:09
2772a475199b4503212d7d02aa675aa4faed7304...ce1a0b612d300210fadf12556e1b38885f098197,1,1,1,2,1,2015-03-11 03:13:39,2015-03-11 03:13:39
2772a475199b4503212d7d02aa675aa4faed7304...837eec064d2d40a4d86acbc6f47fada8263e0d4c,12,90,58,148,39,2015-03-11 01:31:18,2015-03-11 01:31:18
2772a475199b4503212d7d02aa675aa4faed7304...bffe04b582d143f074297b260a359dfb54a7763b,11,28,28,56,28,2015-03-11 00:47:45,2015-03-11 00:47:45
9611b6470843c2ec616978e14bc73e9e27260c0f...33c94eb23857f23fb91899b77ba8615c4e6bdadf,1,5,5,10,5,2015-03-16 22:32:47,2015-03-16 22:32:47
5929f401fcf5433ef0f2df960191cc44bf859618...cbb149f52f5624cec41498398ab48c4043678707,4,13,0,13,4,2015-03-05 01:21:38,2015-03-05 01:21:38
5929f401fcf5433ef0f2df960191cc44bf859618...8833779ae0384f3f9a995f94e42478451107a5ed,2,158,51,209,14,2015-03-05 00:13:53,2015-03-01 20:13:33
5929f401fcf5433ef0f2df960191cc44bf859618...1a22418f9f1573ca8521831d52c8e0562cb3ef8f,8,76,12,88,20,2015-03-04 22:10:37,2015-03-04 02:40:16
5929f401fcf5433ef0f2df960191cc44bf859618...baebff38d5f5d1cdecbc2544e22a42acf82bbf93,1,0,1,1,1,2015-03-04 02:42:52,2015-03-04 02:42:52
cfe5767045745a7453bc7b74d4ce684ff4270162...fb6fab83df5663eb76c8cd57e3845f58c9ee36b3,1,1,1,2,1,2015-03-06 22:37:28,2015-03-06 20:26:28
cfe5767045745a7453bc7b74d4ce684ff4270162...e0fa57737879681a8888de992eb6d2f0e624da74,3,126,1,127,8,2015-03-06 19:54:57,2015-02-09 06:03:42
cfe5767045745a7453bc7b74d4ce684ff4270162...7910cb52435f6edbd30444114d12d9bfaa34b37c,153,8452,5167,13619,578,2015-03-06 19:25:55,2015-02-23 18:58:20
7910cb52435f6edbd30444114d12d9bfaa34b37c...68ba5f0b69c9f383269fb5bc2c78798b312e98cc,16,758,414,1172,188,2015-03-06 22:46:58,2015-03-05 17:55:14
e4a90897e129627529a0ce946b8b3f98ec7e72b6...4eb2fd169f8c9adbee4a9a0bd387f96b4e725963,2,1,8,9,3,2015-03-05 18:55:44,2015-03-05 18:47:40
79744811623cc794d028abfc70ac3f58db9f4b9b...fe21c7a4bebd5d6d0065e0529d03a03723fc697b,1,8,8,16,2,2015-03-20 21:51:39,2015-03-20 21:46:42
79744811623cc794d028abfc70ac3f58db9f4b9b...770e9b6b819b495a933b2f467bf768a1b785d5ad,2,2,2,4,2,2015-03-20 18:09:33,2015-03-03 18:59:50
2ab105e9fe604bb709dfaf25a19f4af003a8ddad...39d49ba7ba21f204f5fc174aaf319ed1cdad790f,1,1,1,2,1,2015-03-17 17:39:17,2015-03-17 17:39:17
2ab105e9fe604bb709dfaf25a19f4af003a8ddad...241579a34faed177100f407465a6ae47bb5b98d2,1,1,1,2,1,2015-03-17 17:07:09,2015-03-17 17:07:09
ad56b5c603b504e601c992d299ff2bbac133b520...a2b0c9778feac970524b98ef7a91b5528fdeb9d5,28,984,115,1099,133,2015-03-17 10:10:42,2015-02-27 02:23:50
c858cbffe06897966033dab9af31f877af4d2f47...75e29f4550027f02aa0c61ceeb53315c9f627571,9,744,0,744,9,2015-03-17 17:47:45,2015-03-11 15:17:22
75e29f4550027f02aa0c61ceeb53315c9f627571...514be385f7451df8bbf9e1a7bb015e3baec406f1,3,24,29,53,20,2015-03-17 17:50:35,2015-03-11 15:17:48
eb0d65933dbb7fae54d8acd5a1f060957c9b48c2...c15970eff946580f10e4d5a6c216f004caa9efb8,1,13,3,16,2,2015-02-18 23:17:15,2015-02-18 23:07:31
eb0d65933dbb7fae54d8acd5a1f060957c9b48c2...ded88a3170749cc2661c8a48a6d1398faad0fe5c,1,8,0,8,2,2015-02-18 19:49:05,2015-02-18 19:49:05
eb0d65933dbb7fae54d8acd5a1f060957c9b48c2...e995670935118ad7ff485aee7fd3d4767e4c3e29,1,4,0,4,2,2015-02-18 19:27:38,2015-02-18 19:27:38
eb0d65933dbb7fae54d8acd5a1f060957c9b48c2...c1deb7f524da94adc0f7dd3ddf4607bbb92b8d02,1,13,0,13,1,2015-02-18 19:01:55,2015-02-18 19:01:55
2f35f60348663b3775f038eadea4fccbd0591725...27a73a98b704b77eaa7c4caebfeaa84743969c67,3,5,5,10,5,2015-02-19 06:52:33,2015-02-18 22:04:42
27a73a98b704b77eaa7c4caebfeaa84743969c67...8ca37e47607b16535468eb119e90567d4f598b8f,2,16,0,16,2,2015-02-19 06:56:03,2015-02-19 06:53:04
8ca37e47607b16535468eb119e90567d4f598b8f...1c9b37cb965be459a93ce07539d7b2a53fbdbc6a,2,11,24,35,13,2015-02-19 07:04:56,2015-02-18 21:32:42
87a8658eb625d25d4d72bf65efc5629be4c99d40...200123b317cd1bad052d3c503278d03d712e4812,3,4,4,8,4,2015-03-17 00:27:59,2015-03-17 00:21:32
5b5b09275e47d3b2a91eef0122865388dc7774a8...37d856db14280a35bcc4b53009db5a286f1ef9b6,1,114,39,153,20,2015-03-11 22:41:57,2015-03-08 16:42:14
88924993a29c2997809471b802f046549b7f0d18...4a8b3cad6096854027151dfbcfb4b2cd8841ad95,2,20,2,22,2,2015-03-20 20:13:32,2015-03-16 06:59:10
88924993a29c2997809471b802f046549b7f0d18...b89d04dd62e1a779f449804772c5bc5b64af65e8,1,13,6,19,3,2015-03-16 11:46:18,2015-02-17 18:58:36
88924993a29c2997809471b802f046549b7f0d18...210ab030bc3dab7bcf8f7252f2f9facb5a26cb6b,14,24,24,48,24,2015-03-16 11:05:53,2015-03-16 08:35:15
88924993a29c2997809471b802f046549b7f0d18...3bf125fce3b98bd04a359a9294aed644a9c11f09,3,5,15,20,6,2015-03-16 11:02:53,2015-03-16 11:02:53
88924993a29c2997809471b802f046549b7f0d18...4b0744b1191622722c0cd24e9b4d46286e5e9c79,2,2,2,4,2,2015-03-16 10:50:52,2015-03-16 10:50:52
bc7d1d6ef307b05b0951f5c884620a87c5ac8f7d...703cab12e77189432e160772f67e5f131fd14baa,1,4,0,4,2,2015-03-17 00:50:17,2015-03-16 07:07:33
bc7d1d6ef307b05b0951f5c884620a87c5ac8f7d...8dc5791f7302aea0734a26dc1f54d96b04771b8f,2,30,1,31,3,2015-03-16 11:55:34,2015-03-16 11:55:34
a2fcae41efdc52087d733d962b9ee3ef37a81450...241c37197643a2495adbca8985c6399dba52a370,1,7,0,7,1,2015-03-16 22:49:38,2015-03-11 18:29:29
a2fcae41efdc52087d733d962b9ee3ef37a81450...ec92e84b85bafaa00867bcb6515062bae773e8da,4,79,1,80,4,2015-03-16 22:38:26,2015-03-03 23:22:06
57f061211aa0870f0fdac2c5f86c0d62f84322fd...a7639c2e1f377b1f5903bb6435473cba4db6522f,2,17,20,37,5,2015-03-20 23:25:34,2015-03-20 22:32:40
f42acd070afeefd630952c69fafa58f0121797fb...3ddf5d75179f529356f19acb77e46e97388d4490,2,40,33,73,31,2015-03-18 23:32:59,2015-03-17 23:59:59
f42acd070afeefd630952c69fafa58f0121797fb...959b35d9741e0478209445fa5960d50346cd4ca6,1,19,1,20,5,2015-03-18 21:52:49,2015-03-18 21:52:49
f42acd070afeefd630952c69fafa58f0121797fb...4307ec283b817997bdcf989767a99d57f7361b9f,1,118,0,118,2,2015-03-18 07:51:14,2015-03-17 21:45:10
f42acd070afeefd630952c69fafa58f0121797fb...4e6a01023b7422dc3df7f02e248bb06361069fcc,6,33,95,128,29,2015-03-17 21:48:28,2015-03-08 14:41:08
ed6685369740035b0af9675bf9add52d0af7657b...f60ed98e79fbc91e7aa280769c62c5a59c7eba00,2,196,285,481,130,2015-03-17 17:15:46,2015-03-12 22:23:56
ed435fb458d71757e561ee267e0954f17c06559c...491f8ab14493babb1c06e240c7a9de64f34827a0,1,2,1,3,1,2015-03-16 22:36:50,2015-03-16 22:34:43
ed435fb458d71757e561ee267e0954f17c06559c...591f821aee9e1d59ec3c619e15344c90047463d6,8,25,28,53,15,2015-03-16 22:13:40,2015-03-16 18:41:40
ed435fb458d71757e561ee267e0954f17c06559c...334aea3441d9e499b7f999098a16abcb81d16a68,1,7,1,8,2,2015-03-16 20:52:00,2015-03-16 19:54:35
ed435fb458d71757e561ee267e0954f17c06559c...9a78ed8f48f2d1404c4fadcb6116ffd46cd335f5,3,51,13,64,7,2015-03-16 19:44:28,2015-03-11 01:40:20
