id,files,locs added,locs removed,locs total,hunks,commit time,author time
4b825dc642cb6eb9a060e54bf8d69288fbee4904...0ca71b3737cbb26fbf037aa15b3f58735785e6e3,4,126,0,126,4,2009-04-24 18:13:34,2009-04-24 18:13:34
0ca71b3737cbb26fbf037aa15b3f58735785e6e3...2573354e9b1619e92b8847d098555a0b6997c231,1,18,4,22,6,2009-04-24 18:24:38,2009-04-24 18:24:38
2573354e9b1619e92b8847d098555a0b6997c231...fd9500eef2eba7e8f66f984c924a11282daaa870,1,21,4,25,3,2009-04-24 18:45:02,2009-04-24 18:45:02
fd9500eef2eba7e8f66f984c924a11282daaa870...e25a6bf837ba378b0a8264e580c61069951dce66,1,7,2,9,3,2009-04-24 18:52:27,2009-04-24 18:52:27
e25a6bf837ba378b0a8264e580c61069951dce66...b77172f8140d830a9160306c8ee10ceed413ba23,1,44,9,53,12,2009-04-24 19:48:41,2009-04-24 19:48:41
b77172f8140d830a9160306c8ee10ceed413ba23...8b4a77f2a16d730f7261d66991107ab404b3b4ac,1,36,4,40,7,2009-04-24 20:48:08,2009-04-24 20:48:08
8b4a77f2a16d730f7261d66991107ab404b3b4ac...33ff583ad7a52edb5ed9d869109e04c846d6209d,1,11,1,12,2,2009-04-24 21:05:14,2009-04-24 21:05:14
33ff583ad7a52edb5ed9d869109e04c846d6209d...2c71b7c46d1ff887fb276a9d42346678a2948a00,1,9,6,15,6,2009-04-24 21:42:33,2009-04-24 21:42:33
2c71b7c46d1ff887fb276a9d42346678a2948a00...768d6d10051cbf2d0261b9cf671b1f969fb77a61,1,42,13,55,4,2009-04-24 21:53:10,2009-04-24 21:53:10
768d6d10051cbf2d0261b9cf671b1f969fb77a61...847e868167eb0e8a270004cbccec4ae36db06626,2,99,2,101,4,2009-04-25 01:35:50,2009-04-25 01:35:50
847e868167eb0e8a270004cbccec4ae36db06626...210d083904914dd4668e032870f92ff0d5d441cc,1,13,5,18,5,2009-04-25 01:49:19,2009-04-25 01:49:19
210d083904914dd4668e032870f92ff0d5d441cc...d691265880abea4428783beb858683be56f3b340,2,25,11,36,3,2009-04-25 02:05:30,2009-04-25 02:05:30
d691265880abea4428783beb858683be56f3b340...96db2c0448c2f6040c098d73570a96413338c662,2,36,15,51,11,2009-04-25 02:38:58,2009-04-25 02:36:06
96db2c0448c2f6040c098d73570a96413338c662...9a8821ff33d5abc9d2603dd91c04872016d40982,2,19,15,34,11,2009-04-25 02:57:14,2009-04-25 02:57:14
9a8821ff33d5abc9d2603dd91c04872016d40982...eb7b590c8c63994051545bf1fe1f650f5dc4aedb,1,53,3,56,6,2009-04-25 03:28:30,2009-04-25 03:28:30
eb7b590c8c63994051545bf1fe1f650f5dc4aedb...13648af5eecd0880a64b6ea4b14f485f53daa2f1,1,40,15,55,11,2009-04-25 03:41:19,2009-04-25 03:41:19
13648af5eecd0880a64b6ea4b14f485f53daa2f1...b9de53532c3e7aa6b01aa188e0f0f17a266c099d,1,12,1,13,2,2009-04-25 04:06:45,2009-04-25 04:06:45
b9de53532c3e7aa6b01aa188e0f0f17a266c099d...a13a299996725a979f5a7d6bd878b0237de0f26d,1,4,8,12,4,2009-04-25 04:07:04,2009-04-25 04:07:04
a13a299996725a979f5a7d6bd878b0237de0f26d...8c384754d8db80f74d3916100772171753bee4f9,1,8,0,8,1,2009-04-26 12:53:14,2009-04-26 12:53:14
8c384754d8db80f74d3916100772171753bee4f9...d0eb1b1417b855b262b5ad31d025840ea6e52094,2,42,31,73,21,2009-04-26 12:59:12,2009-04-26 12:59:12
d0eb1b1417b855b262b5ad31d025840ea6e52094...86de04c6eb9ffcb4ed11f1f18bcc62f868cfb743,1,1,1,2,1,2009-04-26 13:55:59,2009-04-26 13:55:59
86de04c6eb9ffcb4ed11f1f18bcc62f868cfb743...1f73862f3b63bbc9f0a8a8a12dd58e1a39a3355f,1,3,3,6,1,2009-04-26 19:54:42,2009-04-26 19:54:42
1f73862f3b63bbc9f0a8a8a12dd58e1a39a3355f...0ad3dd8534215648e381663979ea99db855578b6,1,5,15,20,13,2009-04-26 19:55:56,2009-04-26 19:55:56
0ad3dd8534215648e381663979ea99db855578b6...1490e1546a380814fdd68dc3776023e58da60d48,1,72,1,73,5,2009-04-26 20:31:27,2009-04-26 20:28:56
1490e1546a380814fdd68dc3776023e58da60d48...a046c7b124de17c4f8aa8f1c3ee7fa5745dde30e,1,4,1,5,2,2009-04-26 20:33:38,2009-04-26 20:33:38
a046c7b124de17c4f8aa8f1c3ee7fa5745dde30e...a64f3a7286c4e554b38cd3f7dc8c722aab97cf98,2,38,18,56,14,2009-04-26 20:53:57,2009-04-26 20:53:57
a64f3a7286c4e554b38cd3f7dc8c722aab97cf98...49cf82288aac5f0dcb152e2d75cd340e48d9e760,1,4,1,5,3,2009-04-26 21:07:16,2009-04-26 21:07:16
49cf82288aac5f0dcb152e2d75cd340e48d9e760...fa16ab36ad014bcc03acc4313bb0918fb241b54d,1,34,0,34,1,2009-04-26 21:43:53,2009-04-26 21:43:53
fa16ab36ad014bcc03acc4313bb0918fb241b54d...795e730e71e8a068ce0cb0790512dab0f1922369,1,1,1,2,1,2009-04-26 21:44:18,2009-04-26 21:44:18
795e730e71e8a068ce0cb0790512dab0f1922369...34a82bda7766f000ef646130ed3f6af58ca23aa2,1,3,4,7,4,2009-04-26 22:05:49,2009-04-26 22:05:49
34a82bda7766f000ef646130ed3f6af58ca23aa2...942dce5578c8eb03fdc7f9109c8418d499e931ff,1,18,2,20,7,2009-04-26 22:06:08,2009-04-26 22:06:08
942dce5578c8eb03fdc7f9109c8418d499e931ff...ea28d674423aa580bfdbe24991ffcf796f2dd3dc,1,1,1,2,1,2009-05-01 01:57:32,2009-05-01 01:57:32
ea28d674423aa580bfdbe24991ffcf796f2dd3dc...7b7ba4bb3792572bd6c22c95082e064754de47be,1,13,1,14,5,2009-05-24 19:29:25,2009-05-24 19:28:54
7b7ba4bb3792572bd6c22c95082e064754de47be...f96bc79019083cdc41cf7f699979f9b5e250d160,1,1,1,2,1,2009-05-30 04:47:59,2009-05-30 04:47:59
f96bc79019083cdc41cf7f699979f9b5e250d160...43a3951243ebcfb8ef4c47259ecb2d0dfaadbce4,2,29,7,36,13,2009-05-30 05:12:32,2009-05-30 05:05:43
43a3951243ebcfb8ef4c47259ecb2d0dfaadbce4...f4f29557e7e02c318931395c1cd4fd1ba090fdfd,1,2,2,4,2,2009-05-30 05:12:34,2009-05-30 05:10:14
f4f29557e7e02c318931395c1cd4fd1ba090fdfd...8e79043c47d69032a86e5587a69289304dd5ca23,1,5,0,5,3,2009-05-30 05:12:58,2009-05-30 04:48:07
8e79043c47d69032a86e5587a69289304dd5ca23...7ee9eef340170da6d13b9a0ab5a8d23950523b0d,1,8,5,13,6,2009-05-30 05:51:38,2009-05-30 05:28:20
7ee9eef340170da6d13b9a0ab5a8d23950523b0d...1cc2cfff91c61bb56236914da7be7b15584951df,1,77,1,78,6,2009-05-30 07:18:27,2009-05-30 07:18:27
1cc2cfff91c61bb56236914da7be7b15584951df...eb4fb91094cf5e20bf7570da3fadb50e444284bc,1,4,0,4,1,2009-05-30 07:33:17,2009-05-30 07:33:17
eb4fb91094cf5e20bf7570da3fadb50e444284bc...1a8c36dc5fdd8c439c65f18a91ad211050201fc8,1,6,2,8,3,2009-05-30 07:33:39,2009-05-30 07:33:39
1a8c36dc5fdd8c439c65f18a91ad211050201fc8...d713e2d87a5003da02d95a4ac5be28a1e9fdc3ce,2,44,20,64,15,2009-05-30 08:13:47,2009-05-30 08:11:43
d713e2d87a5003da02d95a4ac5be28a1e9fdc3ce...e75d1da38a7091c15ebd3c80539e4aab20faf5b7,6,392,0,392,6,2009-05-30 18:06:58,2009-05-30 18:05:33
e75d1da38a7091c15ebd3c80539e4aab20faf5b7...dd07906252a3983fdec396ea6c58de12548713e1,1,62,0,62,1,2009-05-30 18:24:31,2009-05-30 18:24:31
dd07906252a3983fdec396ea6c58de12548713e1...c8a98d4f8730d85a6f693d5dbcd4c1309d97f7c8,1,3,0,3,1,2009-06-15 18:12:40,2009-06-15 18:12:40
c8a98d4f8730d85a6f693d5dbcd4c1309d97f7c8...6aa76263eed68ffed7405687f407e66deec30b02,1,21,2,23,2,2009-07-02 16:39:48,2009-07-02 16:39:48
6aa76263eed68ffed7405687f407e66deec30b02...76a7356f56655dbcbbc9d472e0cdc85c6ed3759f,1,2,0,2,1,2009-07-07 21:41:38,2009-07-07 21:41:38
76a7356f56655dbcbbc9d472e0cdc85c6ed3759f...b64a7aa26c72fcae7b6e1decd88ed706c185cda7,1,2,2,4,2,2009-07-09 00:17:31,2009-07-09 00:17:31
b64a7aa26c72fcae7b6e1decd88ed706c185cda7...5d1a5da411a8ec90cd7a7819bfc74440e3f2545c,1,3,0,3,1,2009-07-10 19:14:33,2009-07-10 19:14:33
5d1a5da411a8ec90cd7a7819bfc74440e3f2545c...344f58abe599cba53a056c0a707c9a99e2cd13a8,1,5,0,5,1,2009-07-16 18:31:50,2009-07-16 18:31:50
344f58abe599cba53a056c0a707c9a99e2cd13a8...0af6aa46751aa6c1ec393155b938601ce0b5f7ae,1,2,0,2,1,2009-08-01 05:19:48,2009-08-01 05:19:48
0af6aa46751aa6c1ec393155b938601ce0b5f7ae...ef7596677c181c649436fe97356dd31c1cb4a13e,1,3,0,3,1,2009-08-02 21:48:41,2009-08-02 21:48:20
ef7596677c181c649436fe97356dd31c1cb4a13e...e1a5b9d3e708d6be1a4c5220dc492da9f2694411,1,1,1,2,1,2009-08-12 22:25:18,2009-08-12 22:24:50
e1a5b9d3e708d6be1a4c5220dc492da9f2694411...558e7a57e20fe68aee05f74f8005b7a39795ac15,1,1,1,2,1,2009-08-12 22:38:00,2009-08-12 22:38:00
558e7a57e20fe68aee05f74f8005b7a39795ac15...2987e6add32f3367be8cc196ecac9195a213e415,1,1,1,2,1,2009-08-20 17:25:29,2009-08-20 11:30:45
2987e6add32f3367be8cc196ecac9195a213e415...33aaa697a2386a02002f9fb8439d11243f12e1c7,1,2,1,3,1,2009-08-26 14:42:27,2009-08-26 14:41:03
33aaa697a2386a02002f9fb8439d11243f12e1c7...227f78114752eee2e8ae3368089716d73d32dd8b,3,2,7,9,4,2009-08-26 14:45:13,2009-08-26 14:43:43
4b825dc642cb6eb9a060e54bf8d69288fbee4904...16d6b8ab6fd7f68bfd9f4d312965cb99e8ad911b,1,150,0,150,1,2007-01-30 23:16:59,2007-01-30 23:16:59
16d6b8ab6fd7f68bfd9f4d312965cb99e8ad911b...da96cd9e2449295d00cea0e48dc4ca251ab00227,1,15,3,18,2,2007-01-31 08:39:20,2007-01-31 08:39:20
da96cd9e2449295d00cea0e48dc4ca251ab00227...06bb04454fb91fbc144ed2b3abb3492c923f98f5,1,7,2,9,2,2007-01-31 08:49:41,2007-01-31 08:49:41
06bb04454fb91fbc144ed2b3abb3492c923f98f5...72b2f0ada30adbb2880d551bd92d9519396897dd,1,15,11,26,12,2007-01-31 15:39:46,2007-01-31 15:39:46
72b2f0ada30adbb2880d551bd92d9519396897dd...d93ed31ac4b1f8963fa83d02aa6bf6148f86e50d,1,5,3,8,4,2007-01-31 18:43:16,2007-01-31 18:43:16
d93ed31ac4b1f8963fa83d02aa6bf6148f86e50d...9466d479e27afe864d42e3d501489b033b8da83f,1,20,11,31,6,2007-01-31 19:16:26,2007-01-31 19:16:26
9466d479e27afe864d42e3d501489b033b8da83f...3f2ddd47c7f311516dc7092b0a89b46291e40271,1,13,3,16,3,2007-01-31 19:48:39,2007-01-31 19:48:39
3f2ddd47c7f311516dc7092b0a89b46291e40271...701ce876331eca10031c104f42cc6fccc425ac94,1,27,25,52,13,2007-01-31 20:54:56,2007-01-31 20:54:56
701ce876331eca10031c104f42cc6fccc425ac94...f6148d912965686f8bb081a53107ad21a9227007,1,14,39,53,7,2007-01-31 21:13:17,2007-01-31 21:13:17
f6148d912965686f8bb081a53107ad21a9227007...a39811b46e213737b9aaf34157f41fd1ac8a8a9e,1,14,14,28,6,2007-01-31 21:19:18,2007-01-31 21:19:18
a39811b46e213737b9aaf34157f41fd1ac8a8a9e...0dd0b9d01116d57c612a5fa90de803bdd836ce11,1,31,58,89,9,2007-01-31 21:31:28,2007-01-31 21:31:28
0dd0b9d01116d57c612a5fa90de803bdd836ce11...2385536282d809e923af3895624d8c66b01ec433,1,4,6,10,4,2007-01-31 21:38:07,2007-01-31 21:38:07
2385536282d809e923af3895624d8c66b01ec433...f26037dce365b3e525596c6f0236ab203d87a872,1,3,0,3,1,2007-01-31 21:41:08,2007-01-31 21:41:08
f26037dce365b3e525596c6f0236ab203d87a872...214bed82390479bdba31337ac420bb09e9b366e9,1,1,0,1,1,2007-01-31 21:47:53,2007-01-31 21:47:53
214bed82390479bdba31337ac420bb09e9b366e9...71f7c0d0bb20936fc831e49bbfc9355f1e5ca211,1,13,2,15,5,2007-01-31 22:03:01,2007-01-31 22:03:01
71f7c0d0bb20936fc831e49bbfc9355f1e5ca211...79799d52b2665d54f1f3fae8cebe49143f6b1e7b,1,0,0,0,0,2007-01-31 22:09:24,2007-01-31 22:09:24
79799d52b2665d54f1f3fae8cebe49143f6b1e7b...61b3cf7c471d2f94eefcf6616c1204f32e641542,1,35,2,37,7,2007-01-31 23:08:51,2007-01-31 23:08:51
61b3cf7c471d2f94eefcf6616c1204f32e641542...f16255f559c96b8c5fb096b00c94a69f5fcc498f,1,3,18,21,8,2007-02-01 07:23:39,2007-02-01 07:23:39
f16255f559c96b8c5fb096b00c94a69f5fcc498f...68f1336fe370ca2153d691631876b0f85a3fb17f,1,67,59,126,5,2007-02-01 16:42:23,2007-02-01 16:42:23
68f1336fe370ca2153d691631876b0f85a3fb17f...6d48d12f5d34a2acb6d8b56bfe3c26d4db92b1a5,1,65,29,94,18,2007-02-01 17:19:55,2007-02-01 17:19:55
6d48d12f5d34a2acb6d8b56bfe3c26d4db92b1a5...c4cf2d4f8793ea8f889052391d72dd4066e88155,1,12,5,17,5,2007-02-07 21:57:01,2007-02-07 21:57:01
c4cf2d4f8793ea8f889052391d72dd4066e88155...e3d37cf0980646b3dbc19e01684c665482a3129d,1,1,1,2,1,2007-02-07 22:09:49,2007-02-07 22:09:49
e3d37cf0980646b3dbc19e01684c665482a3129d...1cd573866a76d62866b65c458e723983ba58117e,1,16,3,19,4,2007-02-07 22:25:56,2007-02-07 22:25:56
1cd573866a76d62866b65c458e723983ba58117e...23efd2545b292208740b0f2fb7446d99ce744000,1,8,3,11,4,2007-02-07 22:37:54,2007-02-07 22:37:54
23efd2545b292208740b0f2fb7446d99ce744000...1e30c07dfcd0ca74ff4aec2004b5722e69b5a639,1,1,1,2,1,2007-02-07 22:51:51,2007-02-07 22:51:51
1e30c07dfcd0ca74ff4aec2004b5722e69b5a639...7315866824607e0a7da807dbee84c60cfe5c5719,1,6,1,7,2,2007-02-08 14:45:16,2007-02-08 14:45:16
7315866824607e0a7da807dbee84c60cfe5c5719...c9c527d7b60f406e143c1f7947a8c6c5ea9d9a8a,1,16,6,22,5,2007-02-08 14:53:11,2007-02-08 14:53:11
c9c527d7b60f406e143c1f7947a8c6c5ea9d9a8a...20c7bc76b90084da6b99a1627427c000c06ef53a,1,25,0,25,1,2007-02-08 22:00:19,2007-02-08 22:00:19
20c7bc76b90084da6b99a1627427c000c06ef53a...b41507a42769c9e40d024593c6924769d9cb961b,1,6,10,16,6,2007-02-10 08:25:22,2007-02-10 08:25:22
b41507a42769c9e40d024593c6924769d9cb961b...8718f3ec9a550c8c2419576a3765c20189029c99,1,15,5,20,6,2007-02-10 09:05:29,2007-02-10 09:05:29
8718f3ec9a550c8c2419576a3765c20189029c99...fe2193183add84d185c0691166fde4460a333412,1,1,1,2,1,2007-02-10 09:05:51,2007-02-10 09:05:51
fe2193183add84d185c0691166fde4460a333412...f7d63b0c99945f4b358df06e4d09837f66db6a88,1,40,0,40,1,2007-02-10 09:26:03,2007-02-10 09:26:03
f7d63b0c99945f4b358df06e4d09837f66db6a88...fc21f8a1dab090ceb63c479705104cbb95585a2f,1,10,6,16,3,2007-02-11 17:04:39,2007-02-11 17:04:39
fc21f8a1dab090ceb63c479705104cbb95585a2f...12d04ca7da3bcfec123fb56d3d143ccda729a7f4,1,0,3,3,3,2007-02-11 20:35:34,2007-02-11 20:35:34
12d04ca7da3bcfec123fb56d3d143ccda729a7f4...44b3add6519d6a85fb75b90173ecd6e7ec1ba650,1,21,12,33,9,2007-02-12 19:28:58,2007-02-12 19:28:58
44b3add6519d6a85fb75b90173ecd6e7ec1ba650...766887e110898d4ec6f08d19061db323a1ac2b27,1,50,9,59,9,2007-02-12 20:04:59,2007-02-12 20:04:59
766887e110898d4ec6f08d19061db323a1ac2b27...dcacf8b447be74efaa5335f42c502ee1c397c436,1,74,34,108,24,2007-02-12 20:41:45,2007-02-12 20:41:45
dcacf8b447be74efaa5335f42c502ee1c397c436...53b03239aa899677bcadf69f757354b72797e457,1,4,1,5,3,2007-02-12 20:44:02,2007-02-12 20:44:02
53b03239aa899677bcadf69f757354b72797e457...77083daac72612ab8ded6cba82a72924f3a867b4,1,1,0,1,1,2007-02-12 20:56:46,2007-02-12 20:56:46
77083daac72612ab8ded6cba82a72924f3a867b4...930d3cc94e98ccecfa8762ef79f7c29af4a72769,1,23,7,30,3,2007-02-12 21:05:21,2007-02-12 21:05:21
930d3cc94e98ccecfa8762ef79f7c29af4a72769...0563a4538a33c7ae9da41628d6f8849c38a2f935,1,90,38,128,25,2007-02-14 16:13:17,2007-02-14 16:13:17
0563a4538a33c7ae9da41628d6f8849c38a2f935...f1e9b5345efade26961289860ced9e5c428360a4,1,7,6,13,5,2007-02-14 16:16:14,2007-02-14 16:16:14
f1e9b5345efade26961289860ced9e5c428360a4...90dc3dfdc8ab903f5eb12f7081dd43b67c8c112a,1,1,1,2,1,2007-02-17 15:18:22,2007-02-17 15:18:22
90dc3dfdc8ab903f5eb12f7081dd43b67c8c112a...9c9fec3d28a77240fc7dbf44ba2f0805fed5f012,1,2,0,2,1,2007-02-21 16:51:07,2007-02-21 16:51:07
9c9fec3d28a77240fc7dbf44ba2f0805fed5f012...161958cc2f71eefbf514b2265741f7d2eb1a5f0b,1,15,7,22,8,2007-02-22 08:03:39,2007-02-22 08:03:39
161958cc2f71eefbf514b2265741f7d2eb1a5f0b...47e33ec082a4ee5d2925760cb1150b25f4ef392e,1,2,1,3,1,2007-02-22 08:22:36,2007-02-22 08:22:36
47e33ec082a4ee5d2925760cb1150b25f4ef392e...5ea919de226177e52f62d1c92208ad9687fd76d7,1,0,2,2,1,2007-02-22 09:20:53,2007-02-22 09:20:53
5ea919de226177e52f62d1c92208ad9687fd76d7...6392a40e5ec1cc1190f5870f6d7c9cc3710dfd46,1,4,1,5,1,2007-03-07 18:58:54,2007-03-07 18:58:54
6392a40e5ec1cc1190f5870f6d7c9cc3710dfd46...3ef674bd4b2f651d769cd5b464ba26313eab290a,1,103,57,160,19,2007-03-08 20:27:59,2007-03-08 20:27:59
3ef674bd4b2f651d769cd5b464ba26313eab290a...934371385c6e2e26132190542f4082c1655587e7,1,2,2,4,1,2007-03-08 20:34:40,2007-03-08 20:34:40
934371385c6e2e26132190542f4082c1655587e7...a0f22e996c9d2f0e2a4a8feae852478f4aa667b5,1,0,0,0,0,2007-03-10 08:49:19,2007-03-10 08:49:19
a0f22e996c9d2f0e2a4a8feae852478f4aa667b5...59f1d2b52d71c5082359f4caa9af5752f90d26a9,1,4,1,5,2,2007-03-10 09:25:34,2007-03-10 09:25:34
59f1d2b52d71c5082359f4caa9af5752f90d26a9...478764bc8261857e7eca2deac409e34c2778347a,1,14,1,15,4,2007-03-10 09:53:07,2007-03-10 09:53:07
478764bc8261857e7eca2deac409e34c2778347a...85a8f1ac3ba10e20fab0e7f38e0d74213535c7ae,1,60,1,61,4,2007-03-10 10:46:26,2007-03-10 10:46:26
85a8f1ac3ba10e20fab0e7f38e0d74213535c7ae...43cc31e8a252d3ed326faa28d9a5d406c96d7b0d,1,98,37,135,7,2007-03-10 16:46:49,2007-03-10 16:46:49
43cc31e8a252d3ed326faa28d9a5d406c96d7b0d...dd87020bd3969dbac5ae26c527bcf50fe0ebb845,1,7,1,8,4,2007-03-10 20:23:49,2007-03-10 20:23:49
dd87020bd3969dbac5ae26c527bcf50fe0ebb845...4fe2ca17f779e14554ebca1208310ae4eb0806b5,1,12,8,20,7,2007-03-10 20:30:24,2007-03-10 20:30:24
4fe2ca17f779e14554ebca1208310ae4eb0806b5...0bcff6121d68d8733e9b572eba357bcd8e91e23e,1,208,0,208,1,2007-03-12 22:00:34,2007-03-12 22:00:34
0bcff6121d68d8733e9b572eba357bcd8e91e23e...5aba82fd5056fa57f467f3c5fe81fe71ee0e8b99,1,6,2,8,2,2007-03-13 08:14:45,2007-03-13 08:14:45
5aba82fd5056fa57f467f3c5fe81fe71ee0e8b99...09a14fb52410cfda029b51832316616b44348505,1,73,17,90,16,2007-03-13 15:36:10,2007-03-13 15:36:10
09a14fb52410cfda029b51832316616b44348505...794a913a0096a383560eb06e0fdf1d8331e12c0a,1,9,1,10,3,2007-03-14 16:31:47,2007-03-14 16:29:46
794a913a0096a383560eb06e0fdf1d8331e12c0a...d7873afdf426b2f430f5635ff460012eb9c00d05,2,2,2,4,2,2007-03-14 16:33:46,2007-03-14 16:33:46
d7873afdf426b2f430f5635ff460012eb9c00d05...4d9e5fcea65f22c6bd9e1f3e5ae2f79c3af613db,1,4,0,4,1,2007-03-14 18:03:16,2007-03-14 18:03:16
4d9e5fcea65f22c6bd9e1f3e5ae2f79c3af613db...d566209e7fecffb61a3209766cc937bf027e2c6c,1,11,4,15,3,2007-03-14 22:30:23,2007-03-14 22:30:23
d566209e7fecffb61a3209766cc937bf027e2c6c...f72537f97e81398b597c05f12c112c52e8201b63,1,3,3,6,1,2007-03-15 18:07:06,2007-03-15 18:07:06
f72537f97e81398b597c05f12c112c52e8201b63...228d36c92b022ae7941b542731c89db5d9de3eac,1,4,4,8,3,2007-03-16 12:47:46,2007-03-16 12:47:46
228d36c92b022ae7941b542731c89db5d9de3eac...09e16455e028ae264347067a8c86a7b9a1e5889c,1,13,0,13,2,2007-03-19 10:57:10,2007-03-19 10:57:07
09e16455e028ae264347067a8c86a7b9a1e5889c...95d27cb75d70331cc775f37d1f3396cd01e5e238,1,2,2,4,2,2007-03-19 11:04:37,2007-03-19 11:04:37
95d27cb75d70331cc775f37d1f3396cd01e5e238...86949eef4088d7b57fe7433568d573a926816f5c,3,115,68,183,3,2007-03-19 19:59:12,2007-03-19 19:59:12
86949eef4088d7b57fe7433568d573a926816f5c...c8c3911685de1185ca7c0afe62bb3964ebc82d38,1,4,1,5,3,2007-03-19 20:02:30,2007-03-19 20:02:30
c8c3911685de1185ca7c0afe62bb3964ebc82d38...4f5cf76a55ecb3252b0924d0c4a16f3b037908cd,1,240,3,243,6,2007-03-19 21:25:17,2007-03-19 21:25:17
4f5cf76a55ecb3252b0924d0c4a16f3b037908cd...83dce55af3c792134787bdc807f932dc8a67ea74,1,2,0,2,1,2007-03-19 21:26:36,2007-03-19 21:26:36
83dce55af3c792134787bdc807f932dc8a67ea74...05140f342e1df7319dd3da2ef8157bfd5760fee6,1,2,2,4,2,2007-03-20 17:32:47,2007-03-20 17:32:47
05140f342e1df7319dd3da2ef8157bfd5760fee6...b984733c8048423537540fdca681ddc448b60fcc,1,582,8,590,12,2007-03-20 19:54:23,2007-03-20 19:54:23
b984733c8048423537540fdca681ddc448b60fcc...0828ab140360c4c831e112f8d244923a7f032e74,1,9,9,18,8,2007-03-20 19:59:30,2007-03-20 19:59:30
0828ab140360c4c831e112f8d244923a7f032e74...c715706b15426c7b106677868ce48e4bd78b94d6,1,3,2,5,3,2007-03-20 20:13:49,2007-03-20 20:13:49
c715706b15426c7b106677868ce48e4bd78b94d6...c5fdcbcc20ebf0716fd17e3ac4f73baacf38a699,2,0,928,928,2,2007-03-20 21:09:27,2007-03-20 21:09:27
c5fdcbcc20ebf0716fd17e3ac4f73baacf38a699...0b69b469257424bcf015b7d3d03303c015c133f8,1,74,0,74,1,2007-03-20 21:41:00,2007-03-20 21:41:00
0b69b469257424bcf015b7d3d03303c015c133f8...b4aa8d12b48af84242a4a484673bc41326566ac9,1,6,0,6,2,2007-03-21 07:27:33,2007-03-21 07:27:33
b4aa8d12b48af84242a4a484673bc41326566ac9...04219c04b7554d13b049d4aba534ce02a12abeb4,1,18,11,29,5,2007-03-21 09:11:20,2007-03-21 09:11:20
04219c04b7554d13b049d4aba534ce02a12abeb4...5d0b6042d4a33dbd78840a8e0d8957441e2cfa72,1,1,1,2,1,2007-03-21 09:57:54,2007-03-21 09:57:54
5d0b6042d4a33dbd78840a8e0d8957441e2cfa72...1932a6ac7c3725aec20574942e5eed9b1e1c5dee,1,1,1,2,1,2007-03-21 10:01:18,2007-03-21 10:01:18
1932a6ac7c3725aec20574942e5eed9b1e1c5dee...20618650058741117d909e086c2e78c003e5cfcd,1,4,0,4,1,2007-03-21 12:05:30,2007-03-21 12:05:30
20618650058741117d909e086c2e78c003e5cfcd...53150250b13e7621c8ade1d59d19c946b745dd39,1,8,6,14,6,2007-03-21 20:04:12,2007-03-21 20:04:12
53150250b13e7621c8ade1d59d19c946b745dd39...e7f0d0d9b9dc99a3f748ed686625cc9f87d9a267,2,7,7,14,6,2007-03-22 08:15:32,2007-03-22 08:13:01
e7f0d0d9b9dc99a3f748ed686625cc9f87d9a267...a559b289bd78d5a3fac0f908be7d5ff92ad09dcb,1,1,1,2,1,2007-03-22 19:27:41,2007-03-22 19:27:41
a559b289bd78d5a3fac0f908be7d5ff92ad09dcb...f5816a5522763f46e075cc618eab12110107a917,2,4,4,8,2,2007-03-22 19:36:28,2007-03-22 19:36:28
f5816a5522763f46e075cc618eab12110107a917...6ae8de88f53f92dd593c5d03b67d0194e7d4eefe,1,36,12,48,4,2007-03-22 20:10:25,2007-03-22 20:10:25
6ae8de88f53f92dd593c5d03b67d0194e7d4eefe...8136a6399c886dec8d1b806a7d8728324e906729,1,3,0,3,1,2007-03-22 20:27:14,2007-03-22 20:27:14
8136a6399c886dec8d1b806a7d8728324e906729...569d1bd4092aacd44a826852e087d0f0e9928ce8,1,4,1,5,2,2007-03-22 20:34:16,2007-03-22 20:34:16
569d1bd4092aacd44a826852e087d0f0e9928ce8...179caebff4a917dc35c8166ec183bc5c76df53e1,2,33,11,44,10,2007-03-22 21:17:42,2007-03-22 21:17:42
179caebff4a917dc35c8166ec183bc5c76df53e1...9512497bcf574a2f70e43be0bcb58e35fb6aaba8,2,50,15,65,8,2007-03-23 08:16:07,2007-03-23 08:16:07
9512497bcf574a2f70e43be0bcb58e35fb6aaba8...967f72e21b9f38725d64a7520bca99bbef9e8ab3,1,16,15,31,1,2007-03-23 08:30:41,2007-03-23 08:30:41
967f72e21b9f38725d64a7520bca99bbef9e8ab3...cb2c9db507cda6804f85ebbacb58a7458ab127a6,1,17,5,22,2,2007-03-24 08:15:11,2007-03-24 08:15:11
cb2c9db507cda6804f85ebbacb58a7458ab127a6...274917a3d65109cfdf225615177fe27624d8461a,1,1,1,2,1,2007-03-24 08:18:20,2007-03-24 08:18:20
274917a3d65109cfdf225615177fe27624d8461a...9863f4055e1219904f6d26c2803a72fc6c8ce561,1,14,14,28,14,2007-03-24 15:35:05,2007-03-24 15:35:05
9863f4055e1219904f6d26c2803a72fc6c8ce561...e20a9e530a02fefaec31b484bd224784b8814554,1,10,6,16,3,2007-03-25 22:13:51,2007-03-25 22:13:51
e20a9e530a02fefaec31b484bd224784b8814554...8910ac0e888daeefdbe6f7391bece150b12b1ad0,1,16,13,29,5,2007-03-26 06:18:55,2007-03-26 06:18:55
8910ac0e888daeefdbe6f7391bece150b12b1ad0...1f4ba1cbfc1d08a9c120012c9199caaec3dc5f58,1,57,1,58,3,2007-03-26 20:34:34,2007-03-26 20:34:34
1f4ba1cbfc1d08a9c120012c9199caaec3dc5f58...a46668faf7f02c3fb55bf877e16c7ffdf8c9a129,1,2,2,4,2,2007-03-28 15:05:38,2007-03-28 15:05:38
a46668faf7f02c3fb55bf877e16c7ffdf8c9a129...c9b50e6307aa9931e18b6cd4d00de817b8e4a4c2,2,20,21,41,9,2007-03-29 17:15:24,2007-03-29 17:15:24
c9b50e6307aa9931e18b6cd4d00de817b8e4a4c2...2a9489c0249c8aef6c6ead501bae25771e710e12,1,2,2,4,2,2007-04-01 11:39:39,2007-04-01 11:39:39
2a9489c0249c8aef6c6ead501bae25771e710e12...711544b00c22b1c2559333e8925e449812f9e5cf,1,4,4,8,3,2007-04-01 13:40:46,2007-04-01 13:40:46
711544b00c22b1c2559333e8925e449812f9e5cf...01ce1fe9676e3f714f3a2d068bf8cfe021f4073c,2,33,3,36,5,2007-04-07 21:46:50,2007-04-07 21:46:50
01ce1fe9676e3f714f3a2d068bf8cfe021f4073c...1f52af6c732bc17415474c426dc009f9e6a36a83,1,3,1,4,3,2007-04-07 22:07:02,2007-04-07 22:07:02
1f52af6c732bc17415474c426dc009f9e6a36a83...cb53e1f8e9a78ab3f980250d2388a62ae2a42d77,1,6,2,8,3,2007-04-07 22:12:02,2007-04-07 22:12:02
cb53e1f8e9a78ab3f980250d2388a62ae2a42d77...68ed351ab51c8b5731665fe6a8a7cc9651edf6c9,1,1,1,2,1,2007-04-08 07:00:55,2007-04-08 07:00:55
68ed351ab51c8b5731665fe6a8a7cc9651edf6c9...f9a3a4f796461276bbbcfef965984086e8e00b46,2,77,3,80,6,2007-04-08 08:08:26,2007-04-08 08:08:26
f9a3a4f796461276bbbcfef965984086e8e00b46...c45b1cfe1eda2cc67c4f07a0cd6986911d7c2fd8,1,2,1,3,1,2007-04-08 08:13:32,2007-04-08 08:13:32
c45b1cfe1eda2cc67c4f07a0cd6986911d7c2fd8...10c3211b81a2f67c3853900e462333933f910696,1,1,1,2,1,2007-04-08 08:15:47,2007-04-08 08:15:47
10c3211b81a2f67c3853900e462333933f910696...7243b350b3469eb78be950331290ea16e57c3de8,1,22,0,22,1,2007-04-08 08:21:56,2007-04-08 08:21:56
7243b350b3469eb78be950331290ea16e57c3de8...80b5910fac79b22ccc8eabb2262562c913d5603c,1,6,0,6,2,2007-04-09 10:43:40,2007-04-09 10:43:40
80b5910fac79b22ccc8eabb2262562c913d5603c...fd4ca86a0b920ddde464e787ef2350126f083d75,1,1,0,1,1,2007-04-13 20:21:10,2007-04-13 20:21:10
fd4ca86a0b920ddde464e787ef2350126f083d75...f291b4e3d47fb03a65c0dfcfbd28f8fabb6187c1,1,1,4,5,1,2007-04-14 09:21:50,2007-04-14 09:21:50
f291b4e3d47fb03a65c0dfcfbd28f8fabb6187c1...8b72ca0f76213eb375840e6b9069b260d97f8286,1,1,18,19,5,2007-04-14 14:05:54,2007-04-14 14:05:54
8b72ca0f76213eb375840e6b9069b260d97f8286...5e80dd4d7e34fdd507997615d7fdefc2411571eb,1,3,3,6,3,2007-04-14 14:09:43,2007-04-14 14:09:43
5e80dd4d7e34fdd507997615d7fdefc2411571eb...90865adc01213520980459ddc261a019f673cce8,1,5,2,7,3,2007-04-15 07:34:15,2007-04-15 07:34:15
90865adc01213520980459ddc261a019f673cce8...51a2640afdd12475642728dc3576966abe0dba6d,1,32,6,38,5,2007-04-15 07:59:56,2007-04-15 07:59:56
51a2640afdd12475642728dc3576966abe0dba6d...ff5dba20e324fb394b7077d0b1d1c5eb4357959f,1,2,6,8,2,2007-05-01 16:28:38,2007-05-01 16:28:38
ff5dba20e324fb394b7077d0b1d1c5eb4357959f...1c094184da5c7bf572c907633279890bd15d1952,1,1,1,2,1,2007-05-01 21:15:48,2007-05-01 21:15:48
1c094184da5c7bf572c907633279890bd15d1952...8f8725314dbed75dc1e603646ea6a2c630025f6e,1,40,40,80,29,2007-05-01 21:23:00,2007-05-01 21:23:00
8f8725314dbed75dc1e603646ea6a2c630025f6e...28359251395c1647bf40adcdabbe4d85d7b085af,1,0,16,16,8,2007-05-01 21:26:19,2007-05-01 21:26:19
28359251395c1647bf40adcdabbe4d85d7b085af...a844b7406f17ac6e069e617509a2997d7e128500,1,17,0,17,1,2007-05-07 18:14:17,2007-05-07 18:14:17
a844b7406f17ac6e069e617509a2997d7e128500...084835805565726c825f0853626a33a0263066bf,1,5,5,10,2,2007-05-15 12:27:56,2007-05-15 12:31:06
084835805565726c825f0853626a33a0263066bf...ac1fde55a71e166a86468582961908ab0d01413b,1,1,0,1,1,2007-05-15 12:44:32,2007-05-15 12:42:56
ac1fde55a71e166a86468582961908ab0d01413b...caace111129545559bf798d83ac8cfd596d36f66,1,19,17,36,15,2007-05-15 13:15:07,2007-05-15 12:57:57
caace111129545559bf798d83ac8cfd596d36f66...25df95cce470d74cdc5e8905a298bbc36c7ec6d0,1,11,5,16,5,2007-05-15 13:15:07,2007-05-15 13:15:39
25df95cce470d74cdc5e8905a298bbc36c7ec6d0...42890f6291ab8b718dec5a3346875c45724d4ebb,1,1,1,2,1,2007-05-15 14:07:02,2007-05-15 14:07:02
42890f6291ab8b718dec5a3346875c45724d4ebb...95962f318e0f00cd4e2ebb54531c3d738aa39ece,1,1,1,2,1,2007-05-15 14:07:41,2007-05-15 13:51:25
95962f318e0f00cd4e2ebb54531c3d738aa39ece...cd6cc0d31845576082fabc7f246a99988aca6d26,1,1,0,1,1,2007-05-15 14:15:26,2007-05-15 14:15:26
cd6cc0d31845576082fabc7f246a99988aca6d26...81f2373f89895a47ed0251ac0856798514cfb618,1,1,3,4,1,2007-05-15 21:06:43,2007-05-15 21:06:43
81f2373f89895a47ed0251ac0856798514cfb618...d336c15835c924ba8d153edbfceca88d5c748582,1,13,2,15,4,2007-05-16 07:41:46,2007-05-16 07:41:26
d336c15835c924ba8d153edbfceca88d5c748582...c3c46244518178bac49caf21d6ba3a782292bb10,1,1,1,2,1,2007-05-16 07:43:13,2007-05-16 07:43:13
c3c46244518178bac49caf21d6ba3a782292bb10...dc1a93b6dce1d38e6e0ddd8980d8ccd64937fcb1,1,2,0,2,1,2007-05-16 10:12:39,2007-05-16 10:12:39
dc1a93b6dce1d38e6e0ddd8980d8ccd64937fcb1...ca0affe7bbc0ef507e2ec01c75e4f54d309dfad7,1,2,0,2,1,2007-05-16 11:15:34,2007-05-16 11:15:34
ca0affe7bbc0ef507e2ec01c75e4f54d309dfad7...5c4153e4880a90c05612521e9ee575a308d207db,1,3,1,4,1,2007-05-17 05:42:38,2007-05-17 05:42:38
5c4153e4880a90c05612521e9ee575a308d207db...f9162f6a4cc9f4af3e527412b364a8eda4502920,1,4,3,7,3,2007-05-17 07:09:05,2007-05-17 07:02:45
f9162f6a4cc9f4af3e527412b364a8eda4502920...463e8af65577b1df4495cb08640840234ac80c86,1,6,3,9,4,2007-05-17 07:13:54,2007-05-17 07:13:54
463e8af65577b1df4495cb08640840234ac80c86...8a2820def44f163ec8909863aefa5e8f98a236ea,1,0,39,39,2,2007-05-17 17:44:50,2007-05-17 17:44:50
8a2820def44f163ec8909863aefa5e8f98a236ea...1c9d393d30797decad703b642fa87b67a5236af4,1,0,17,17,1,2007-05-17 18:15:47,2007-05-17 18:15:47
1c9d393d30797decad703b642fa87b67a5236af4...8ead4fda3fbaba93aae46931285e9613a058c08b,1,4,1,5,1,2007-05-17 18:26:58,2007-05-17 18:26:58
8ead4fda3fbaba93aae46931285e9613a058c08b...c6d44cb1a1a9bca58d91ef414b9dbaa393d2de3a,2,12,4,16,4,2007-05-17 18:57:05,2007-05-17 18:57:05
c6d44cb1a1a9bca58d91ef414b9dbaa393d2de3a...48df6fd850b2d9dc52a8a89a9e6deecd2cf1d351,1,4,2,6,3,2007-05-17 19:18:53,2007-05-17 19:18:53
48df6fd850b2d9dc52a8a89a9e6deecd2cf1d351...ef48f9093ced75ca20295f42b993bd390873573d,2,41,2,43,7,2007-05-17 20:17:49,2007-05-17 20:17:49
ef48f9093ced75ca20295f42b993bd390873573d...71bd9bacec6a18c2db582e1f32b1902c82359376,1,0,2,2,1,2007-05-17 20:22:26,2007-05-17 20:22:26
71bd9bacec6a18c2db582e1f32b1902c82359376...05094f987c2f141ec9b873ad6d6303b0aca173a4,1,2,7,9,4,2007-05-18 18:32:35,2007-05-18 18:32:35
05094f987c2f141ec9b873ad6d6303b0aca173a4...66c6a9b559a883460b1aeed7dadec713be17588c,1,0,4,4,2,2007-05-18 18:39:38,2007-05-18 18:39:38
66c6a9b559a883460b1aeed7dadec713be17588c...4b97ffb1e462c2334b38047fbf2b7e8b24c36aed,1,45,242,287,21,2007-05-18 19:45:23,2007-05-18 19:45:23
4b97ffb1e462c2334b38047fbf2b7e8b24c36aed...8f9b2e082b54787676bdad793ca013ba4fb4e407,1,18,3,21,4,2007-05-18 20:13:26,2007-05-18 20:13:26
8f9b2e082b54787676bdad793ca013ba4fb4e407...29bdbac1cd5fc4126b62c9a030403d56ae43c204,1,76,14,90,16,2007-05-19 08:23:12,2007-05-19 08:23:12
29bdbac1cd5fc4126b62c9a030403d56ae43c204...d5904674d1a52620a702b4f5efa1afe21f8a5947,1,9,17,26,6,2007-05-19 09:07:32,2007-05-19 09:07:32
d5904674d1a52620a702b4f5efa1afe21f8a5947...71b112d4a4e070170af7b5a50647f7dac9b48e56,1,29,10,39,11,2007-05-19 09:54:11,2007-05-19 09:54:11
71b112d4a4e070170af7b5a50647f7dac9b48e56...9bda3a8556681c90309ec34e2ee5ae50306b61a6,1,5,5,10,3,2007-05-19 10:05:40,2007-05-19 10:05:40
9bda3a8556681c90309ec34e2ee5ae50306b61a6...b607e71efdd23cd676645b5d7bf49d985834fab8,1,21,2,23,4,2007-05-20 08:55:54,2007-05-20 08:55:54
b607e71efdd23cd676645b5d7bf49d985834fab8...59fa4171090ae8dcc7087ac617dca40e66f9b33a,1,3,0,3,2,2007-05-20 13:15:34,2007-05-20 13:15:34
59fa4171090ae8dcc7087ac617dca40e66f9b33a...64ffb06a9c940e57a215d313cd58f702d695e919,1,1,1,2,1,2007-05-20 13:24:01,2007-05-20 13:24:01
64ffb06a9c940e57a215d313cd58f702d695e919...47a130b7bf74b8f61d9fee01f5dbb745d8f44b29,1,8,5,13,4,2007-05-20 14:33:21,2007-05-20 14:33:21
47a130b7bf74b8f61d9fee01f5dbb745d8f44b29...c1b296b9f19a62aa9e444cc454b3d62ffaa98da4,1,47,14,61,11,2007-05-20 14:55:05,2007-05-20 14:55:05
c1b296b9f19a62aa9e444cc454b3d62ffaa98da4...8a5fc95b43ab25e7ce0ca14cf733669e5708b448,1,3,0,3,1,2007-05-20 21:39:40,2007-05-20 21:39:40
8a5fc95b43ab25e7ce0ca14cf733669e5708b448...24f7b53fdd0bcc76453fc087932ca2cdecf47f9d,1,4,0,4,1,2007-05-20 21:42:22,2007-05-20 21:42:22
24f7b53fdd0bcc76453fc087932ca2cdecf47f9d...b1561ee25628c074b3afac738ead387181d3b311,1,6,0,6,1,2007-05-20 21:52:51,2007-05-20 21:52:51
b1561ee25628c074b3afac738ead387181d3b311...341dc1c1793455875086373a865db4d0a132ef6e,1,17,6,23,8,2007-05-20 22:39:16,2007-05-20 22:39:16
341dc1c1793455875086373a865db4d0a132ef6e...33be3e6550c7051c3ac4bc624c7dacfad6974b4f,1,6,5,11,2,2007-05-21 06:44:16,2007-05-21 06:44:16
33be3e6550c7051c3ac4bc624c7dacfad6974b4f...dc5240369610a6f72eab9b59447889dfd69b31c5,1,2,0,2,1,2007-05-21 07:34:56,2007-05-21 07:34:56
dc5240369610a6f72eab9b59447889dfd69b31c5...faf1bd202640263b06c99c335269971aa9d9ead1,1,7,1,8,4,2007-05-21 08:05:30,2007-05-21 08:05:30
faf1bd202640263b06c99c335269971aa9d9ead1...cbf5efa61a30d6454f5739cee3498f98a01210da,1,3,0,3,1,2007-05-21 08:08:11,2007-05-21 08:08:11
cbf5efa61a30d6454f5739cee3498f98a01210da...7944f1425c0665eef6a5b9f5cc92e15cddb42984,1,14,20,34,4,2007-05-21 09:04:26,2007-05-21 09:04:26
7944f1425c0665eef6a5b9f5cc92e15cddb42984...5834684d51ee6e0c21cce8d1b5df06a34a36a4f9,1,32,5,37,3,2007-05-21 20:57:06,2007-05-21 20:57:06
5834684d51ee6e0c21cce8d1b5df06a34a36a4f9...af8da89cb7225c7938a836de0812467c059ca52d,1,1,1,2,1,2007-05-21 21:25:51,2007-05-21 21:25:51
af8da89cb7225c7938a836de0812467c059ca52d...52102d4784a5f16fd84eaf98b61f714460b68693,1,11,2,13,5,2007-05-21 21:44:24,2007-05-21 21:44:24
52102d4784a5f16fd84eaf98b61f714460b68693...a028a98e9ae83231f0657fdb112f7d9c0cf0b98c,1,25,12,37,13,2007-05-22 22:03:08,2007-05-22 22:03:08
a028a98e9ae83231f0657fdb112f7d9c0cf0b98c...01a9c9c5a80c6a1e82298870ca8e5bc73b2a828d,1,6,1,7,3,2007-05-22 22:07:35,2007-05-22 22:07:35
01a9c9c5a80c6a1e82298870ca8e5bc73b2a828d...57284050a8123a4c2d22d435a8c6daf1b53011e8,1,10,5,15,4,2007-05-22 22:15:50,2007-05-22 22:15:50
57284050a8123a4c2d22d435a8c6daf1b53011e8...a396b292678838b4cae1b358c62da6b4e0929fc2,1,8,1,9,2,2007-05-22 22:33:34,2007-05-22 22:33:34
a396b292678838b4cae1b358c62da6b4e0929fc2...65d2ade95e6ef5a15a30d5115073477dfe03fb85,1,1,1,2,1,2007-05-23 14:41:46,2007-05-23 14:41:46
65d2ade95e6ef5a15a30d5115073477dfe03fb85...0c66a783936d5cd7b1f28400c6b192c37690304a,1,14,4,18,3,2007-05-23 18:07:57,2007-05-23 18:07:57
0c66a783936d5cd7b1f28400c6b192c37690304a...a6d5da36af9a7087cf14e717b72c66ef2c34eb3b,1,3,1,4,1,2007-05-23 21:29:01,2007-05-23 21:27:31
a6d5da36af9a7087cf14e717b72c66ef2c34eb3b...ac3e0d79eef4535bb61d79315688fb1d225dea3b,1,3,1,4,1,2007-05-23 21:32:32,2007-05-23 21:32:32
ac3e0d79eef4535bb61d79315688fb1d225dea3b...66a2f523958129e9b697d30ed44a5174010cb42a,1,3,0,3,1,2007-05-23 21:40:48,2007-05-23 21:40:48
66a2f523958129e9b697d30ed44a5174010cb42a...ad192f2888816454df14b8a35945fb418bcb9e13,1,1,1,2,1,2007-05-23 21:44:19,2007-05-23 21:44:19
ad192f2888816454df14b8a35945fb418bcb9e13...b3fd1b28083cded86fd141c812cfd6d215ef4d5b,1,3,2,5,1,2007-05-23 21:53:14,2007-05-23 21:53:14
b3fd1b28083cded86fd141c812cfd6d215ef4d5b...ebd8116870247fbc9fb27656d28f1b8a43aae766,1,4,0,4,3,2007-05-23 22:24:52,2007-05-23 22:24:52
ebd8116870247fbc9fb27656d28f1b8a43aae766...c1f9197f372a5378c3dbb36adeedf37ae175ecf1,1,4,0,4,2,2007-05-24 12:17:29,2007-05-24 12:07:55
c1f9197f372a5378c3dbb36adeedf37ae175ecf1...d1874ed33bc346dca8b86891757703c908634aad,1,19,9,28,3,2007-05-24 19:23:04,2007-05-24 19:23:04
d1874ed33bc346dca8b86891757703c908634aad...2cc58fd99ae5bc5845792393f232853da1ff6082,1,0,1,1,1,2007-05-24 20:10:40,2007-05-24 20:10:40
2cc58fd99ae5bc5845792393f232853da1ff6082...abcd790fe9bc168041dcc2a0e678d22a135d33c8,1,28,30,58,7,2007-05-24 20:25:36,2007-05-24 20:25:36
abcd790fe9bc168041dcc2a0e678d22a135d33c8...10f880f8d4e2c6390928a0bcc8b43161b5f845b2,1,4,0,4,1,2007-05-24 20:28:28,2007-05-24 20:28:28
10f880f8d4e2c6390928a0bcc8b43161b5f845b2...65c5f3e3f2dfb470c16628032235222a492e3239,1,6,2,8,4,2007-05-25 06:44:41,2007-05-25 06:44:41
65c5f3e3f2dfb470c16628032235222a492e3239...4280e5333354c6dddcd994bdacd3c6a11ac2da5e,1,2,2,4,2,2007-05-25 06:49:18,2007-05-25 06:49:18
4280e5333354c6dddcd994bdacd3c6a11ac2da5e...417a7a6fc8c3d77e3e9a3bb0e11cb2eea978e20b,1,3,2,5,1,2007-05-25 08:28:46,2007-05-25 08:28:46
417a7a6fc8c3d77e3e9a3bb0e11cb2eea978e20b...01265103fe3966abd720ebb0bba1882a5701f327,2,13,17,30,10,2007-05-25 08:36:10,2007-05-25 08:36:10
01265103fe3966abd720ebb0bba1882a5701f327...d414c74afd8610c8c22dadf62b5ba8c6efa59e75,1,4,2,6,3,2007-05-25 09:36:42,2007-05-25 09:36:42
d414c74afd8610c8c22dadf62b5ba8c6efa59e75...877db584aae9816671147da45c30c31748ef287f,1,0,3,3,1,2007-05-25 17:43:38,2007-05-25 17:43:38
877db584aae9816671147da45c30c31748ef287f...cb4f1280dd5691890abea4521bff0a3d6e3facfd,1,5,1,6,4,2007-05-25 20:34:30,2007-05-25 20:34:30
cb4f1280dd5691890abea4521bff0a3d6e3facfd...a3c55c09ecae2a9c852c8c10e668c901639e845b,1,1,6,7,3,2007-05-27 13:48:01,2007-05-27 13:48:01
a3c55c09ecae2a9c852c8c10e668c901639e845b...ce6f33c83537a04a3fb7557d7a74fe81ebccd7e4,1,13,22,35,7,2007-05-28 12:22:53,2007-05-23 19:46:29
ce6f33c83537a04a3fb7557d7a74fe81ebccd7e4...cebdf5af319ce638862fe2e2cd2797840962ddbb,1,30,18,48,14,2007-05-28 12:28:58,2007-05-23 19:53:11
cebdf5af319ce638862fe2e2cd2797840962ddbb...7cb5cbefd2c8b4c24bc87c6e30906907f94726ad,1,2,2,4,2,2007-05-28 12:29:11,2007-05-23 19:55:48
7cb5cbefd2c8b4c24bc87c6e30906907f94726ad...c8cbbee980ac3961d5cdae164f2cb0a6b88075e0,1,2,2,4,1,2007-05-28 12:43:25,2007-05-28 12:43:25
c8cbbee980ac3961d5cdae164f2cb0a6b88075e0...5c1131c964f745e8d12a196b89e94d19db320656,0,0,0,0,0,2007-05-28 14:08:19,2007-05-23 20:10:46
5c1131c964f745e8d12a196b89e94d19db320656...b016d39756f7d82e51c35e281673ed30b95cc586,1,58,27,85,23,2007-05-28 14:15:29,2007-05-23 20:10:46
b016d39756f7d82e51c35e281673ed30b95cc586...bce4c5fc0b6aa9e599fc181c5350b461dafecee2,1,19,21,40,11,2007-05-28 14:15:43,2007-05-23 20:14:33
bce4c5fc0b6aa9e599fc181c5350b461dafecee2...6754a299d8d977326e396d641106cc5db4d29db1,1,20,10,30,10,2007-05-28 14:17:27,2007-05-23 20:41:50
6754a299d8d977326e396d641106cc5db4d29db1...8b41a97f8a3e2778ce733cd3d7e181bc28cc43a0,1,12,9,21,9,2007-05-28 14:18:31,2007-05-23 21:20:53
8b41a97f8a3e2778ce733cd3d7e181bc28cc43a0...b76f0565bfcfedba9e8920aa5120fc97796b642f,1,4,4,8,3,2007-05-28 14:19:10,2007-05-23 21:29:34
b76f0565bfcfedba9e8920aa5120fc97796b642f...b25b20656dceff6145a1286f10618ab25d717537,1,16,14,30,15,2007-05-28 14:20:50,2007-05-23 21:49:35
4b825dc642cb6eb9a060e54bf8d69288fbee4904...cb07fc2a29c86d1bc11f5415368f778d25d3d20a,1,764,0,764,1,2006-11-06 19:20:27,2006-11-06 19:20:27
cb07fc2a29c86d1bc11f5415368f778d25d3d20a...131f503b7262b001eae434182feb08cb5e6fa4be,1,214,56,270,37,2006-11-06 21:08:26,2006-11-06 21:07:32
131f503b7262b001eae434182feb08cb5e6fa4be...6f6eed286f6a056fab1f887871ba5287f609e1f1,1,12,7,19,9,2006-11-07 08:05:16,2006-11-06 23:22:19
6f6eed286f6a056fab1f887871ba5287f609e1f1...e210e67451f22f97c1476d6b78b6fa7fdd5817f9,1,75,24,99,32,2006-11-07 08:05:16,2006-11-07 00:12:58
e210e67451f22f97c1476d6b78b6fa7fdd5817f9...6e27d826c807153a4773f197e5056d66a6a809c0,1,137,2,139,5,2006-11-07 08:05:16,2006-11-07 01:03:36
6e27d826c807153a4773f197e5056d66a6a809c0...ec6b424abb8d0a5c6399bcffdfde19aa47f16d18,2,238,102,340,18,2006-11-07 08:05:17,2006-11-07 01:50:59
ec6b424abb8d0a5c6399bcffdfde19aa47f16d18...e57ca85e113437649ec908ce48fc43a659d650f8,1,119,41,160,38,2006-11-07 08:05:17,2006-11-07 02:34:10
e57ca85e113437649ec908ce48fc43a659d650f8...bd1e2b4028e183f7b4d564aad69c3eae8bdb661a,1,29,7,36,12,2006-11-07 08:05:17,2006-11-07 03:03:05
bd1e2b4028e183f7b4d564aad69c3eae8bdb661a...8c0ce436826f01e17cba90ebcaf6483ad3b8c984,1,124,0,124,8,2006-11-07 08:05:17,2006-11-07 04:13:23
8c0ce436826f01e17cba90ebcaf6483ad3b8c984...cc4b1c0213ad2d99121135125b8c2ea630bebe3d,1,29,13,42,9,2006-11-07 08:05:17,2006-11-07 04:47:05
cc4b1c0213ad2d99121135125b8c2ea630bebe3d...b8ce6f0ec8a275bf9e32ff7666d00a88154fd50b,1,10,4,14,4,2006-11-07 08:05:18,2006-11-07 05:20:56
b8ce6f0ec8a275bf9e32ff7666d00a88154fd50b...661448922fd55b907449962d35d3fdb92397ce9d,1,4,3,7,1,2006-11-07 08:05:18,2006-11-07 05:53:39
661448922fd55b907449962d35d3fdb92397ce9d...ee3dc9354d23b1262fb9c71c648435e0ccf01d7e,1,30,6,36,8,2006-11-07 08:05:18,2006-11-07 07:18:18
ee3dc9354d23b1262fb9c71c648435e0ccf01d7e...07123f4002efdb881f6ce08c5c4411e17e34e141,1,25,12,37,7,2006-11-07 08:05:18,2006-11-07 07:57:46
07123f4002efdb881f6ce08c5c4411e17e34e141...d47ae541cef50f5fbfaec195597cf1cebc2840f5,1,5,2,7,1,2006-11-07 08:05:34,2006-11-07 08:00:20
d47ae541cef50f5fbfaec195597cf1cebc2840f5...393ec6f01ce38eb731d12557c8f596c36044cf02,1,32,0,32,1,2006-11-07 08:29:05,2006-11-07 08:18:34
393ec6f01ce38eb731d12557c8f596c36044cf02...3d9d029bde946d7a230ce85460c53686e10bdfe0,1,6,0,6,1,2006-11-07 08:30:26,2006-11-07 08:30:26
3d9d029bde946d7a230ce85460c53686e10bdfe0...37af79d10d980418eaeca953c4ba1c08a85d37e9,1,43,31,74,14,2006-11-07 09:19:49,2006-11-07 09:19:49
37af79d10d980418eaeca953c4ba1c08a85d37e9...0d4f3eb5f330a53300e630c1ffe4ea1fa61f5dd9,1,19,5,24,5,2006-11-07 09:26:02,2006-11-07 09:26:02
0d4f3eb5f330a53300e630c1ffe4ea1fa61f5dd9...d33ba5fa809be1714c7f31f128a7a72461a96d96,1,70,9,79,15,2006-11-07 10:02:15,2006-11-07 10:02:15
d33ba5fa809be1714c7f31f128a7a72461a96d96...c5437df168379f33c7148c60b232b5c2887dd537,1,4,2,6,2,2006-11-07 10:06:40,2006-11-07 10:06:40
c5437df168379f33c7148c60b232b5c2887dd537...868c8752451c0b75502a0134068f0cfe055eb7ad,1,47,12,59,6,2006-11-08 04:48:20,2006-11-07 23:34:09
868c8752451c0b75502a0134068f0cfe055eb7ad...93f654df7ec9a509e9362e06821c2af0b2bacc82,1,67,40,107,23,2006-11-08 04:48:20,2006-11-08 00:30:54
93f654df7ec9a509e9362e06821c2af0b2bacc82...6b29267542546b443fd885b2ed6dc896680b09ed,1,43,44,87,23,2006-11-08 04:48:20,2006-11-08 00:58:37
6b29267542546b443fd885b2ed6dc896680b09ed...0fb8f9ce05bf65cc9c22f078c4a6dc7dec3ec27a,1,91,88,179,26,2006-11-08 04:48:21,2006-11-08 01:27:46
0fb8f9ce05bf65cc9c22f078c4a6dc7dec3ec27a...d1536c488e2f410c9f622356e29d9a5870d2403f,1,11,0,11,2,2006-11-08 04:48:21,2006-11-08 01:40:35
d1536c488e2f410c9f622356e29d9a5870d2403f...e534f3a88676fe0a08eb20359e1a43c6aa7dfe84,1,42,9,51,9,2006-11-08 04:48:21,2006-11-08 02:27:29
e534f3a88676fe0a08eb20359e1a43c6aa7dfe84...988b8a7d63ff52f252bb4c517d9f05c3952aa728,1,2,0,2,2,2006-11-08 04:48:21,2006-11-08 02:30:46
988b8a7d63ff52f252bb4c517d9f05c3952aa728...2bc5b3487e47dc6caa8d543fc50a944e80651c59,1,1,1,2,1,2006-11-08 04:48:22,2006-11-08 02:38:22
2bc5b3487e47dc6caa8d543fc50a944e80651c59...0a462d67761b8178f09e23ef85a9298d1e19a2eb,1,3,1,4,2,2006-11-08 04:48:22,2006-11-08 02:43:16
0a462d67761b8178f09e23ef85a9298d1e19a2eb...ec39d83a55124660d03a744e0e7f67072a833950,1,39,1,40,4,2006-11-08 04:48:22,2006-11-08 03:00:38
ec39d83a55124660d03a744e0e7f67072a833950...bfe4c924da3853956d1b476afaa5f04429695223,1,2,0,2,1,2006-11-08 04:48:22,2006-11-08 03:03:03
bfe4c924da3853956d1b476afaa5f04429695223...e4ee9af4946557370cfe18efdfa46c265a10639f,1,1,1,2,1,2006-11-08 04:48:23,2006-11-08 03:09:55
e4ee9af4946557370cfe18efdfa46c265a10639f...7fe7e733fafbab0373ee0d8fc35b9e284a598ee4,1,19,19,38,13,2006-11-09 03:48:34,2006-11-09 03:48:34
7fe7e733fafbab0373ee0d8fc35b9e284a598ee4...d4ab2035ca64ccb380c42a73f1ce0aefe1669a39,1,1,1,2,1,2006-11-09 03:51:09,2006-11-09 03:51:09
d4ab2035ca64ccb380c42a73f1ce0aefe1669a39...97bf01c46526a680fb04ac88cb0ecaefbd3b4d7f,1,19,10,29,4,2006-11-09 04:05:46,2006-11-09 04:05:46
97bf01c46526a680fb04ac88cb0ecaefbd3b4d7f...2d19516db4a6807e817879e6d30fd3137a4a7817,1,88,61,149,6,2006-11-09 04:42:51,2006-11-09 04:42:51
2d19516db4a6807e817879e6d30fd3137a4a7817...49b86f010c3f2d6576a8fba45c5c6b9a23f76fa0,1,6,3,9,3,2006-11-12 05:15:59,2006-11-11 20:16:01
49b86f010c3f2d6576a8fba45c5c6b9a23f76fa0...9861671de26bf7cd41f591bd2099ac299349f284,1,60,1,61,5,2006-11-12 05:16:00,2006-11-11 20:51:41
9861671de26bf7cd41f591bd2099ac299349f284...b2c6fcf197fd09a6fedb39e4d8d13e6fdc2df4d4,1,11,6,17,6,2006-11-12 05:16:00,2006-11-11 21:16:25
b2c6fcf197fd09a6fedb39e4d8d13e6fdc2df4d4...7d9e1d5e8a398a9ed3b782e7c2b49d1dcb5f53f7,1,0,3,3,1,2006-11-12 05:16:00,2006-11-11 22:46:04
7d9e1d5e8a398a9ed3b782e7c2b49d1dcb5f53f7...03e4ec5364f955f5e1af0775166c679ed60f7fb4,1,36,36,72,17,2006-11-12 05:16:01,2006-11-11 22:52:16
03e4ec5364f955f5e1af0775166c679ed60f7fb4...68e009dec44a023efd6f6fcd61c1583b23b04f32,1,13,8,21,9,2006-11-12 05:16:01,2006-11-11 22:59:34
68e009dec44a023efd6f6fcd61c1583b23b04f32...7f1df79bb7bad696d1d8965da3937edeb1cfe9f6,1,56,29,85,19,2006-11-12 05:16:01,2006-11-11 23:38:00
7f1df79bb7bad696d1d8965da3937edeb1cfe9f6...73ad179bbbba56c053045c555b7e5f1882380533,1,4,4,8,2,2006-11-12 05:16:01,2006-11-11 23:42:42
73ad179bbbba56c053045c555b7e5f1882380533...3963678da9e78e87fa9b57f2f3ad75ba1c70e589,1,55,55,110,53,2006-11-12 05:16:02,2006-11-11 23:46:52
3963678da9e78e87fa9b57f2f3ad75ba1c70e589...da5239dcab0e8f899a4e6bfb34b574f6286b9dbb,1,25,31,56,7,2006-11-12 05:16:02,2006-11-12 00:03:06
da5239dcab0e8f899a4e6bfb34b574f6286b9dbb...44be340e4d8d39475e86d3e00cec31fec0d0f6c1,1,16,20,36,12,2006-11-12 05:16:02,2006-11-12 00:10:10
44be340e4d8d39475e86d3e00cec31fec0d0f6c1...c4fe7728529fd9f3dc2c413ce889d359732cd3a4,1,19,10,29,4,2006-11-12 05:16:02,2006-11-12 00:32:24
c4fe7728529fd9f3dc2c413ce889d359732cd3a4...390adaeafbefc49a88d06c3a2ad68bc00fe0c614,1,16,11,27,11,2006-11-12 05:16:03,2006-11-12 00:40:33
390adaeafbefc49a88d06c3a2ad68bc00fe0c614...62aac80b133de4fa004d90d27a97f574aec9d02d,1,10,3,13,4,2006-11-12 05:16:03,2006-11-12 01:00:35
62aac80b133de4fa004d90d27a97f574aec9d02d...0e794311833fd4d6f0c3204a5449372284318bda,1,66,0,66,4,2006-11-12 05:16:03,2006-11-12 01:24:23
0e794311833fd4d6f0c3204a5449372284318bda...6c6dd01a041e628ce6efb583ea865d1a694ff7b2,1,4,6,10,7,2006-11-12 05:16:03,2006-11-12 01:33:30
6c6dd01a041e628ce6efb583ea865d1a694ff7b2...1daf1d0c81c7c2623867f7884c8cbc5ff0a10d30,1,8,3,11,2,2006-11-12 05:16:03,2006-11-12 01:44:03
1daf1d0c81c7c2623867f7884c8cbc5ff0a10d30...058803f400d8bbd72aa8b8584e9a6e93dbd17d54,1,1,0,1,1,2006-11-12 05:16:04,2006-11-12 01:45:52
058803f400d8bbd72aa8b8584e9a6e93dbd17d54...f019c96add051aa9265c3dba8940c29f307aae81,1,10,4,14,2,2006-11-12 05:16:04,2006-11-12 02:02:37
f019c96add051aa9265c3dba8940c29f307aae81...2c26e6f5279286aa844a54363d877acffb4a4310,1,27,1,28,5,2006-11-12 05:16:04,2006-11-12 02:14:28
2c26e6f5279286aa844a54363d877acffb4a4310...16403d0b1f9d17bec6bce488356ec8bf84cace48,1,72,4,76,9,2006-11-12 05:16:05,2006-11-12 02:52:06
16403d0b1f9d17bec6bce488356ec8bf84cace48...b4946930fa0f7aa538e33f1d799beffb7e10e7a9,1,92,100,192,70,2006-11-12 05:40:38,2006-11-12 05:40:38
b4946930fa0f7aa538e33f1d799beffb7e10e7a9...16fccd7a1111c1fca6ce973ddaff690188e742d0,1,29,8,37,7,2006-11-12 07:22:21,2006-11-12 07:22:21
16fccd7a1111c1fca6ce973ddaff690188e742d0...b5834d70fe970ccf955378d4f6e60a51a94bbaaf,1,4,4,8,3,2006-11-12 07:27:28,2006-11-12 07:27:28
b5834d70fe970ccf955378d4f6e60a51a94bbaaf...00f949fbd831bda29dc909baf4a21d00a7c2c119,1,1,1,2,1,2006-11-12 07:30:02,2006-11-12 07:30:02
00f949fbd831bda29dc909baf4a21d00a7c2c119...51f4d16b1d8e2e709f28a4e52b951236950cb1d5,1,158,46,204,23,2006-11-12 08:47:00,2006-11-12 08:47:00
51f4d16b1d8e2e709f28a4e52b951236950cb1d5...92148d8091d148e219b88e4d555a386ffa78f575,1,124,16,140,17,2006-11-12 10:27:00,2006-11-12 10:27:00
92148d8091d148e219b88e4d555a386ffa78f575...74e6b12f5831a8c93a5d3c90118a73e908d0680a,1,79,64,143,14,2006-11-12 11:35:14,2006-11-12 11:35:14
74e6b12f5831a8c93a5d3c90118a73e908d0680a...e01b42211cad31b1262d152b7e2561cb8bf218ed,1,6,4,10,4,2006-11-12 11:46:26,2006-11-12 11:46:26
e01b42211cad31b1262d152b7e2561cb8bf218ed...8009dcdc8d9bee0b5aab1f6e860a834ffbb0b08f,1,4,1,5,2,2006-11-12 11:53:56,2006-11-12 11:53:56
8009dcdc8d9bee0b5aab1f6e860a834ffbb0b08f...4af2c384eaae62300765e205c705c7741dd7dd31,1,1,2,3,1,2006-11-13 05:10:37,2006-11-12 20:04:15
4af2c384eaae62300765e205c705c7741dd7dd31...7b64d0b7d62ec0eb6e8b37f0be2e62f2a719de16,1,6,4,10,4,2006-11-13 05:10:37,2006-11-12 20:45:35
7b64d0b7d62ec0eb6e8b37f0be2e62f2a719de16...4ccdab028263dfdeb0adf9764466bb3a43265395,1,25,17,42,8,2006-11-13 05:10:37,2006-11-12 21:20:36
4ccdab028263dfdeb0adf9764466bb3a43265395...6bbd1cb95aede2991d0748d2a54088f2c1291602,1,16,13,29,7,2006-11-13 05:10:38,2006-11-12 21:24:52
6bbd1cb95aede2991d0748d2a54088f2c1291602...ebf336b9422302ec89bce14b83017060d7ccd3e6,1,6,2,8,4,2006-11-13 05:10:38,2006-11-12 21:53:19
ebf336b9422302ec89bce14b83017060d7ccd3e6...4658b56fce4e8b7c4489ae7b0fe9ecf1e236b70b,1,43,12,55,10,2006-11-13 05:10:38,2006-11-12 22:58:08
4658b56fce4e8b7c4489ae7b0fe9ecf1e236b70b...333b0c74b33fe54f0489813950345edbeb62c0b5,1,9,18,27,14,2006-11-13 05:10:38,2006-11-12 23:03:19
333b0c74b33fe54f0489813950345edbeb62c0b5...c8ebafd84537473bb8a53880a6a6740d723b83bc,1,16,1,17,2,2006-11-13 05:10:39,2006-11-12 23:08:10
c8ebafd84537473bb8a53880a6a6740d723b83bc...043f701116c30067c2a7096135b6e419dd1f7b47,1,70,70,140,59,2006-11-13 05:10:39,2006-11-12 23:16:45
043f701116c30067c2a7096135b6e419dd1f7b47...2cbe5577a0e83ae7368eb2202ffe62c1d607b0bb,1,9,4,13,5,2006-11-13 05:10:39,2006-11-12 23:22:59
2cbe5577a0e83ae7368eb2202ffe62c1d607b0bb...fd2656fdfe575b55424b672f8bc274bf86526b9e,1,11,4,15,5,2006-11-13 05:10:39,2006-11-12 23:51:38
fd2656fdfe575b55424b672f8bc274bf86526b9e...358d8de8f3b9d09c9c4d7d43c03d33a4f60ba1da,1,55,11,66,9,2006-11-13 05:10:39,2006-11-13 00:20:02
358d8de8f3b9d09c9c4d7d43c03d33a4f60ba1da...aaf1085a03a53eacff1b26459d0281a133f573d5,1,1,0,1,1,2006-11-13 05:10:40,2006-11-13 00:29:04
aaf1085a03a53eacff1b26459d0281a133f573d5...7f09cfafa8acf507f3a1358e05002e566f41783f,1,5,1,6,1,2006-11-13 05:10:40,2006-11-13 00:33:33
7f09cfafa8acf507f3a1358e05002e566f41783f...c11b5f20d3bc2e8bc4fcd965b16e1575b87c0d5f,1,26,4,30,4,2006-11-13 05:10:40,2006-11-13 02:11:12
c11b5f20d3bc2e8bc4fcd965b16e1575b87c0d5f...135f76ed996b6a0478831c561e1cddd249b7e19d,1,4,4,8,3,2006-11-13 05:10:40,2006-11-13 02:49:49
135f76ed996b6a0478831c561e1cddd249b7e19d...3e7b0e1d0ae509a54ca61c2b4c4990c8e6f0b2c0,1,10,12,22,4,2006-11-13 05:10:41,2006-11-13 03:06:37
3e7b0e1d0ae509a54ca61c2b4c4990c8e6f0b2c0...1e5c18fb431c2d2493996e24ea68408e59ef6c16,1,5,7,12,6,2006-11-13 05:10:41,2006-11-13 03:41:34
1e5c18fb431c2d2493996e24ea68408e59ef6c16...fce89e466ae75961018ab88fec7000568f981d46,1,12,22,34,5,2006-11-13 05:48:44,2006-11-13 05:48:44
fce89e466ae75961018ab88fec7000568f981d46...f7f8d32226595c22cb4f28f8e9e139cf42e1e640,1,25,11,36,9,2006-11-13 09:22:42,2006-11-13 09:22:42
f7f8d32226595c22cb4f28f8e9e139cf42e1e640...7d0d289e457eb643b8638b6385a0ce056f1f5a97,1,6,9,15,4,2006-11-13 19:25:53,2006-11-13 19:25:53
7d0d289e457eb643b8638b6385a0ce056f1f5a97...a37eee4406ff965fda4d234759aa58526657cbe3,1,9,7,16,1,2006-11-13 19:37:41,2006-11-13 19:37:41
a37eee4406ff965fda4d234759aa58526657cbe3...24263b77165edfd438045ed3c25ec6669b3e76d4,1,111,25,136,28,2006-11-13 21:06:38,2006-11-13 21:06:38
24263b77165edfd438045ed3c25ec6669b3e76d4...99058720df7981aaaaf64e9a0d2c658d90b82340,1,11,11,22,11,2006-11-14 06:19:03,2006-11-14 06:19:03
99058720df7981aaaaf64e9a0d2c658d90b82340...8f52548a9ed078d581379ad526a4259920f80a88,1,34,34,68,30,2006-11-14 06:29:32,2006-11-14 06:29:32
8f52548a9ed078d581379ad526a4259920f80a88...04b393824ff57b5fcb881a00466e513cd4ad2a7f,1,20,11,31,9,2006-11-14 06:42:32,2006-11-14 06:42:32
04b393824ff57b5fcb881a00466e513cd4ad2a7f...bbe3b3b9b93763ff4eff4fbb638b1c6a4bed8c95,1,66,35,101,21,2006-11-15 23:06:29,2006-11-15 23:06:29
bbe3b3b9b93763ff4eff4fbb638b1c6a4bed8c95...e8ab64461968392f126b0a0e2fef4ce8bdcca623,1,118,68,186,44,2006-11-15 23:55:05,2006-11-15 23:55:05
e8ab64461968392f126b0a0e2fef4ce8bdcca623...b3678bacbcd2dc0e1c61fd91f4146d0c037e626f,1,14,0,14,1,2006-11-18 04:56:14,2006-11-16 01:04:17
b3678bacbcd2dc0e1c61fd91f4146d0c037e626f...fbee8500a5b64a1c0c6103232879bcecc30f64b4,1,6,5,11,3,2006-11-18 04:56:15,2006-11-16 03:13:45
fbee8500a5b64a1c0c6103232879bcecc30f64b4...4aca740b3915b35d7fa1707be79b268b0cc94123,1,55,0,55,2,2006-11-18 04:56:15,2006-11-16 03:35:26
4aca740b3915b35d7fa1707be79b268b0cc94123...dbccbbda4f4c049552495a87b1747b1b2a1e2823,1,12,2,14,2,2006-11-18 04:56:15,2006-11-16 03:45:33
dbccbbda4f4c049552495a87b1747b1b2a1e2823...306500fc09e7d8be042e8b9abbd9011b80b3300d,1,2,0,2,1,2006-11-18 04:56:15,2006-11-16 03:53:53
306500fc09e7d8be042e8b9abbd9011b80b3300d...c1237ae288aae7e45a18f3d5097b49451293acfe,1,60,8,68,4,2006-11-18 04:56:16,2006-11-16 04:52:20
c1237ae288aae7e45a18f3d5097b49451293acfe...06c311157a045c2189acc5496fdc71a806c28f8c,1,78,0,78,2,2006-11-18 05:31:00,2006-11-18 05:31:00
06c311157a045c2189acc5496fdc71a806c28f8c...cbbaa28bc0a2b607b0f5e2e23f910d1619b52b0f,1,6,3,9,2,2006-11-18 06:20:37,2006-11-18 06:20:37
cbbaa28bc0a2b607b0f5e2e23f910d1619b52b0f...4539eacd6dde87b4e73c859e946bb0a2c89d71f4,1,46,28,74,16,2006-11-18 07:50:58,2006-11-18 07:50:58
4539eacd6dde87b4e73c859e946bb0a2c89d71f4...32e0bcab59334ed8f1955c8afa830de22362c1ec,1,21,17,38,15,2006-11-18 08:03:16,2006-11-18 08:03:16
32e0bcab59334ed8f1955c8afa830de22362c1ec...b67651129897738496a9dcd3c01129a42acd11db,1,10,10,20,10,2006-11-18 08:08:51,2006-11-18 08:08:51
b67651129897738496a9dcd3c01129a42acd11db...c4ed879fc2b64b6c6f8a42bd156b2e4bd18e9420,1,29,3,32,5,2006-11-18 08:24:20,2006-11-18 08:24:20
c4ed879fc2b64b6c6f8a42bd156b2e4bd18e9420...a49c67d1ff9861d80bae57642d891016ea5debd5,1,19,11,30,18,2006-11-18 08:27:23,2006-11-18 08:27:23
a49c67d1ff9861d80bae57642d891016ea5debd5...53716a7bc94497cd6d2dfd53b1e4f7669d677b01,1,2,1,3,2,2006-11-18 08:31:25,2006-11-18 08:31:25
53716a7bc94497cd6d2dfd53b1e4f7669d677b01...ef5c971506bef5046f1a50e1bfb2630cf458afff,1,0,4,4,2,2006-11-18 08:41:54,2006-11-18 08:41:54
ef5c971506bef5046f1a50e1bfb2630cf458afff...24ac9b752d6df7ab309826d487fbeaae53806025,1,79,18,97,18,2006-11-19 03:46:07,2006-11-19 01:59:49
24ac9b752d6df7ab309826d487fbeaae53806025...d63efae2816a277e40a379eb5c5f23f2a656fddc,1,25,15,40,6,2006-11-19 03:46:07,2006-11-19 02:07:05
d63efae2816a277e40a379eb5c5f23f2a656fddc...bca680b054ffa736e876075fad358bee1caa898a,1,5,5,10,3,2006-11-19 03:46:07,2006-11-19 02:13:16
bca680b054ffa736e876075fad358bee1caa898a...54896cf7c150038bd286b909897673f85c691abc,1,18,3,21,6,2006-11-19 03:46:07,2006-11-19 02:33:04
54896cf7c150038bd286b909897673f85c691abc...d7c0d7c86191925dcd0dfff353823f9f7e473de5,1,0,4,4,1,2006-11-19 04:17:41,2006-11-19 04:17:41
d7c0d7c86191925dcd0dfff353823f9f7e473de5...1461c5f3d0634f6fad0013eba1ef1087a38cc748,1,157,28,185,18,2006-11-19 05:29:55,2006-11-19 05:29:55
1461c5f3d0634f6fad0013eba1ef1087a38cc748...74d18d2edfc84d35b20e1b4520e496aadc14c365,1,18,5,23,2,2006-11-19 05:37:49,2006-11-19 05:37:49
74d18d2edfc84d35b20e1b4520e496aadc14c365...dde5974ef109ed3aadfbac4d233899fb04d1c9ff,1,4,1,5,3,2006-11-19 05:46:08,2006-11-19 05:46:08
dde5974ef109ed3aadfbac4d233899fb04d1c9ff...86291555c94300b057a156d87239a6cab09511b3,1,8,6,14,7,2006-11-19 06:00:48,2006-11-19 06:00:48
86291555c94300b057a156d87239a6cab09511b3...0d5709cf88e9f242e0e31ccbda42a1c827c90a22,1,3,0,3,1,2006-11-19 06:06:42,2006-11-19 06:06:42
0d5709cf88e9f242e0e31ccbda42a1c827c90a22...51cc47fedaaea46a556aac7d4e32683abca1b57b,1,5,2,7,3,2006-11-19 06:20:42,2006-11-19 06:20:42
51cc47fedaaea46a556aac7d4e32683abca1b57b...0c70864b8506ea17cc0615ae4ba55b60fed6af58,1,0,3,3,1,2006-11-19 06:23:06,2006-11-19 06:23:06
0c70864b8506ea17cc0615ae4ba55b60fed6af58...38dbe273ffb86d8dc5c90403c27c561e683ade4a,1,43,37,80,14,2006-11-19 07:46:52,2006-11-19 07:46:52
38dbe273ffb86d8dc5c90403c27c561e683ade4a...bd11b82db88049fc4822d52764c009cc55b55afd,1,1,0,1,1,2006-11-19 07:57:58,2006-11-19 07:57:58
bd11b82db88049fc4822d52764c009cc55b55afd...a29481e2123c2fd14fbcb2531be9de16adf21779,1,24,14,38,7,2006-11-19 08:38:48,2006-11-19 08:38:48
a29481e2123c2fd14fbcb2531be9de16adf21779...375f38828e9c50ad79b6582e768db410216c2c41,1,5,4,9,4,2006-11-19 08:46:29,2006-11-19 08:46:29
375f38828e9c50ad79b6582e768db410216c2c41...f18e40a1a60d506065b6cc0e45704ce29ea0a035,1,78,63,141,32,2006-11-21 05:22:33,2006-11-21 02:27:22
f18e40a1a60d506065b6cc0e45704ce29ea0a035...444f92d097425e8d1043a14571ebfd82c1c3b0a5,1,13,0,13,2,2006-11-21 05:22:34,2006-11-21 02:43:41
444f92d097425e8d1043a14571ebfd82c1c3b0a5...21d7744fbc98b526bc00138fce287565df2c0075,1,10,8,18,11,2006-11-21 05:22:34,2006-11-21 02:59:19
21d7744fbc98b526bc00138fce287565df2c0075...93a79912055dfc0cbdc974e98c705bc75950862a,1,4,2,6,2,2006-11-21 05:22:34,2006-11-21 03:17:15
93a79912055dfc0cbdc974e98c705bc75950862a...75e355d6bec2796ea0e69f4f4421670141ac77a2,1,4,0,4,2,2006-11-21 05:22:34,2006-11-21 03:22:10
75e355d6bec2796ea0e69f4f4421670141ac77a2...a4abfa62d69ff92e3159ca0fd41184f5b72e16a4,1,12,12,24,11,2006-11-21 05:22:35,2006-11-21 04:01:47
a4abfa62d69ff92e3159ca0fd41184f5b72e16a4...82aa23545f84f01e83fb2164b5751b41fd449b62,1,58,0,58,3,2006-11-21 05:22:35,2006-11-21 04:55:51
82aa23545f84f01e83fb2164b5751b41fd449b62...0c8d7839c9dafcfd33dae2bd35b9bf4a98ffa07a,1,29,11,40,4,2006-11-21 07:33:56,2006-11-21 07:33:56
0c8d7839c9dafcfd33dae2bd35b9bf4a98ffa07a...bdc9ea202407114737d1d58f7bef00b9579df9b7,1,11,10,21,3,2006-11-21 07:36:55,2006-11-21 07:36:55
bdc9ea202407114737d1d58f7bef00b9579df9b7...53f7a33bdc89a6ec870fdce5221c05a2759974d3,1,12,3,15,4,2006-11-21 07:46:51,2006-11-21 07:46:51
53f7a33bdc89a6ec870fdce5221c05a2759974d3...7b85a17b86062c87ceebbf70acfbd62e00cd4bac,1,20,14,34,11,2006-11-21 16:57:41,2006-11-21 16:57:41
7b85a17b86062c87ceebbf70acfbd62e00cd4bac...3add5d3517972f6407da450fcd7dff08187cca34,1,1,3,4,1,2006-11-21 17:00:50,2006-11-21 17:00:50
3add5d3517972f6407da450fcd7dff08187cca34...1d8b3cbf2841612791178853efbfe9ba60b48f2b,1,81,1,82,3,2006-11-21 20:28:14,2006-11-21 20:28:14
1d8b3cbf2841612791178853efbfe9ba60b48f2b...1d72cb6c1833ec0b5065e33cfc7b5a55ee6b3d8e,1,8,1,9,1,2006-11-21 20:38:49,2006-11-21 20:38:49
1d72cb6c1833ec0b5065e33cfc7b5a55ee6b3d8e...b673bbc59cf6950808d12b0d4020ae606019a8cd,1,3,2,5,2,2006-11-22 03:34:27,2006-11-22 01:21:11
b673bbc59cf6950808d12b0d4020ae606019a8cd...d075242923691e5f3c671f240945b0bdf26a7cd0,1,26,13,39,8,2006-11-22 03:34:27,2006-11-22 01:33:09
d075242923691e5f3c671f240945b0bdf26a7cd0...5040f926f9b06946b6b6144eb358db1850dce505,1,6,4,10,1,2006-11-22 03:58:28,2006-11-22 03:58:28
5040f926f9b06946b6b6144eb358db1850dce505...4c2035d55e0a5c013677a8e83193e37d51000793,1,11,7,18,4,2006-11-23 00:24:41,2006-11-23 00:24:41
4c2035d55e0a5c013677a8e83193e37d51000793...e734817db0af028f2aea356b44c74b7ac51023cd,1,177,7,184,8,2006-11-24 02:40:45,2006-11-24 02:40:45
e734817db0af028f2aea356b44c74b7ac51023cd...8553b772d7aeebe8c83710233877483dd409b846,1,30,1,31,4,2006-11-24 20:38:18,2006-11-24 20:38:18
8553b772d7aeebe8c83710233877483dd409b846...9342e26d3a832dd24878725b42444b8efe4fa1c4,1,3,0,3,3,2006-11-24 20:59:34,2006-11-24 20:59:34
9342e26d3a832dd24878725b42444b8efe4fa1c4...700a65ce380f29a5083bcc230aa1ef5c28e66f2c,1,61,0,61,4,2006-11-24 22:30:12,2006-11-24 22:30:12
700a65ce380f29a5083bcc230aa1ef5c28e66f2c...d90d83a3a95e5fb4672906589ac0a19c19f1187b,1,1,1,2,1,2006-11-25 07:45:19,2006-11-25 07:45:19
d90d83a3a95e5fb4672906589ac0a19c19f1187b...2171bf4b44884fd75bc5c1c412a39c2d4e645453,1,5,1,6,2,2006-11-25 07:47:18,2006-11-25 07:47:18
2171bf4b44884fd75bc5c1c412a39c2d4e645453...359ca42a4b9288421d2f0409652f76e9a365b801,1,37,9,46,7,2006-11-25 08:33:03,2006-11-25 08:33:03
359ca42a4b9288421d2f0409652f76e9a365b801...bb1ad51a5365cbe48d5dcee7e00a8d9f90d89171,1,8,8,16,7,2006-11-25 08:35:33,2006-11-25 08:35:33
bb1ad51a5365cbe48d5dcee7e00a8d9f90d89171...85ab313ed3dc9a951ec3859fcc3a32a6c5c3ee19,1,10,7,17,7,2006-11-25 08:38:39,2006-11-25 08:38:39
85ab313ed3dc9a951ec3859fcc3a32a6c5c3ee19...84e0bf1de4fcdada4698e2bd53bafaeaea6b5cbd,1,50,1,51,2,2006-11-25 09:04:24,2006-11-25 09:04:24
84e0bf1de4fcdada4698e2bd53bafaeaea6b5cbd...9208487b34706887fcc10ce6423099134f301f5e,1,7,2,9,4,2006-11-26 03:52:03,2006-11-25 17:40:29
9208487b34706887fcc10ce6423099134f301f5e...5e926cbf7eeb2c89e0957bed7941c2c6490767c2,1,15,5,20,3,2006-11-26 04:16:16,2006-11-26 04:16:16
5e926cbf7eeb2c89e0957bed7941c2c6490767c2...f70c3a2caccf4f0f5abfd3d0db4120e8659dd0d7,1,3,0,3,2,2006-11-27 05:48:49,2006-11-27 00:45:39
f70c3a2caccf4f0f5abfd3d0db4120e8659dd0d7...c15ad650c77ef3213d723efec4e1dca89efba6cd,1,2,2,4,1,2006-11-27 05:48:49,2006-11-27 00:46:45
c15ad650c77ef3213d723efec4e1dca89efba6cd...eae2ce619277903e73550663e6826f0299191bf3,1,3,3,6,3,2007-01-21 07:54:15,2006-12-08 00:59:46
eae2ce619277903e73550663e6826f0299191bf3...557afe820baccb21206c974fbd4afa65bd7f1e03,1,29,0,29,1,2007-01-21 07:54:15,2006-12-08 03:07:38
557afe820baccb21206c974fbd4afa65bd7f1e03...51e7e568c0a7854b2f93b86d6085695ce80053cc,1,9,8,17,4,2007-01-21 07:54:16,2006-12-13 03:44:38
51e7e568c0a7854b2f93b86d6085695ce80053cc...81c0f29a5633f6a9ab01e0e9ded5e1c6d715b70b,1,5,9,14,2,2007-01-21 07:54:16,2007-01-20 23:38:12
81c0f29a5633f6a9ab01e0e9ded5e1c6d715b70b...6b0f3f46293e2f718054e9947e209c0344721a69,1,2,0,2,2,2007-01-21 07:54:16,2007-01-20 23:50:14
6b0f3f46293e2f718054e9947e209c0344721a69...68cbfb13919132cb2ddc591a765f4f20f9294657,1,2,2,4,2,2007-01-21 07:54:16,2007-01-20 23:54:56
68cbfb13919132cb2ddc591a765f4f20f9294657...bdadecbae5b9f7317994bf2f521bb15068823a1d,1,1,1,2,2,2007-01-21 07:54:17,2007-01-21 00:03:26
bdadecbae5b9f7317994bf2f521bb15068823a1d...4d583c86ec52f8b2937a0b9dc02667b54c4a28a2,1,7,7,14,7,2007-01-21 07:54:17,2007-01-21 00:07:46
4d583c86ec52f8b2937a0b9dc02667b54c4a28a2...c25623321d52642fe8fb80c64904a53363f91b12,1,1,1,2,1,2007-01-21 07:54:18,2007-01-21 00:45:26
c25623321d52642fe8fb80c64904a53363f91b12...41bdcda37376a5faa63028f01260890723c3fcfa,4,32,5,37,7,2007-01-21 07:54:18,2007-01-21 01:00:07
41bdcda37376a5faa63028f01260890723c3fcfa...2f4479fb177fbbeab7c7311f3b2f1f31c6de428a,1,4,3,7,2,2007-01-21 07:54:18,2007-01-21 01:04:02
2f4479fb177fbbeab7c7311f3b2f1f31c6de428a...0499b24ad664d7f6a33d4cfe4a11912ae455b039,1,13,5,18,1,2007-01-21 07:54:19,2007-01-21 01:08:20
0499b24ad664d7f6a33d4cfe4a11912ae455b039...f1cee4e6d19919f6e333f9e671c720003a9a7cec,4,63,6,69,9,2007-01-21 07:54:19,2007-01-21 01:31:09
f1cee4e6d19919f6e333f9e671c720003a9a7cec...98063115920338a1a6472a22c6792b13e37012b5,1,10,0,10,2,2007-01-21 07:54:19,2007-01-21 01:47:31
98063115920338a1a6472a22c6792b13e37012b5...f7b9f6e4406458d522f9b376efdfecadf6b4ab35,1,2,1,3,1,2007-01-21 07:54:19,2007-01-21 01:53:37
f7b9f6e4406458d522f9b376efdfecadf6b4ab35...8ff487c737fe7a611da03c20f08888fb7f3a3550,1,40,0,40,2,2007-01-21 07:54:20,2007-01-21 02:23:21
8ff487c737fe7a611da03c20f08888fb7f3a3550...16d18b853b91e66219a26130c0485914c2969389,1,7,19,26,7,2007-01-21 07:54:20,2007-01-21 02:36:21
16d18b853b91e66219a26130c0485914c2969389...c950c66ed91ba8e66dd26c3b19167e6eecb47fe9,1,97,110,207,65,2007-01-21 07:54:20,2007-01-21 02:48:56
c950c66ed91ba8e66dd26c3b19167e6eecb47fe9...c2758a17cb268fa2bb7ff46e27b571038a9eeb5d,1,20,17,37,14,2007-01-21 07:54:21,2007-01-21 02:55:05
c2758a17cb268fa2bb7ff46e27b571038a9eeb5d...dccfa6727e78190002364981158cb46878fdcfe2,1,1,1,2,1,2007-01-21 07:54:21,2007-01-21 02:56:25
dccfa6727e78190002364981158cb46878fdcfe2...c2faa43677ec2471dadc3cc789cab27f6bc2abbb,1,6,1,7,2,2007-01-21 07:54:21,2007-01-21 03:00:28
c2faa43677ec2471dadc3cc789cab27f6bc2abbb...0812665e578cf8ac1fe9a69b5557e3781be2d8ff,1,27,27,54,22,2007-01-21 07:54:21,2007-01-21 03:06:51
0812665e578cf8ac1fe9a69b5557e3781be2d8ff...21e409ad7f85b0557b0baa6d32f9b2064c7aa633,1,101,113,214,20,2007-01-21 07:54:22,2007-01-21 03:45:19
21e409ad7f85b0557b0baa6d32f9b2064c7aa633...b4b2b8454bca8f0636260358e3a63b9097351fc1,1,3,4,7,4,2007-01-21 07:54:22,2007-01-21 03:57:19
b4b2b8454bca8f0636260358e3a63b9097351fc1...5989a57734dfd4d6cb7eb0045a008dfdc90c2fbb,1,2,4,6,2,2007-01-21 07:54:22,2007-01-21 03:58:52
5989a57734dfd4d6cb7eb0045a008dfdc90c2fbb...ac39160cd27cd4a57dbea80db6fbaec21ddb6ff4,1,14,14,28,4,2007-01-21 07:54:23,2007-01-21 04:00:28
ac39160cd27cd4a57dbea80db6fbaec21ddb6ff4...93e912c5e62220bd3cc2d00bfe357ed8fd44d413,1,22,22,44,17,2007-01-21 07:54:23,2007-01-21 04:07:04
93e912c5e62220bd3cc2d00bfe357ed8fd44d413...de5f6d5d178a1c8113aaca34c8f6b3842732a741,1,2,8,10,3,2007-01-21 07:54:23,2007-01-21 04:10:30
de5f6d5d178a1c8113aaca34c8f6b3842732a741...7d40edfa06adf7f31f787bb6379c1eb454242c19,1,9,18,27,4,2007-01-21 07:54:23,2007-01-21 04:20:17
7d40edfa06adf7f31f787bb6379c1eb454242c19...b4b491e388627b75ed3aee5dc60e4199eae7b362,1,15,35,50,6,2007-01-21 07:54:24,2007-01-21 04:33:34
b4b491e388627b75ed3aee5dc60e4199eae7b362...31a8d1968ed12c0b98c1c34d789a66f54ecbbc13,1,1,4,5,1,2007-01-21 07:54:24,2007-01-21 04:35:39
31a8d1968ed12c0b98c1c34d789a66f54ecbbc13...833eda736ad1ec99c30b2c4d7a565ccc406c97a0,1,11,10,21,6,2007-01-21 07:54:24,2007-01-21 04:46:53
833eda736ad1ec99c30b2c4d7a565ccc406c97a0...ab26abd483d2e63f782a4335331ba6b2cfeed1bc,1,1,1,2,1,2007-01-21 07:54:25,2007-01-21 04:52:19
ab26abd483d2e63f782a4335331ba6b2cfeed1bc...c5ab47cbe4cf9f2f3068c9bf23a666404b615176,1,180,3,183,5,2007-01-21 07:54:25,2007-01-21 06:31:14
c5ab47cbe4cf9f2f3068c9bf23a666404b615176...bd29ebc3927780c2bc6c91abb12054a283201c15,1,6,0,6,2,2007-01-21 07:54:25,2007-01-21 06:34:55
bd29ebc3927780c2bc6c91abb12054a283201c15...887412d4e84c8249987a686aded6a7eab4345cb8,1,131,2,133,3,2007-01-21 07:54:25,2007-01-21 07:14:00
887412d4e84c8249987a686aded6a7eab4345cb8...0a25f93cdaee5ef4da67c4b1db2cb06bfc88e84a,1,11,3,14,4,2007-01-21 07:54:26,2007-01-21 07:21:45
0a25f93cdaee5ef4da67c4b1db2cb06bfc88e84a...859d8057bd0194bf21fac74d196cd9c07e2fec19,1,29,3,32,7,2007-01-21 07:54:26,2007-01-21 07:27:26
859d8057bd0194bf21fac74d196cd9c07e2fec19...62efea111fe6935c5916f3537fb135bdab324264,1,4,0,4,2,2007-01-21 08:13:13,2007-01-21 08:13:13
62efea111fe6935c5916f3537fb135bdab324264...6f48f3a6885e9dcc7d05a3a392723084dbf960d2,1,0,41,41,4,2007-01-21 09:19:33,2007-01-21 09:19:33
6f48f3a6885e9dcc7d05a3a392723084dbf960d2...6858efbda324ab30f8857a06000933bcc55b11cc,1,3,6,9,2,2007-01-21 09:28:22,2007-01-21 09:28:22
6858efbda324ab30f8857a06000933bcc55b11cc...4f9d8519fb3297063392d0268c0430fe5a6a02f1,1,22,22,44,7,2007-01-21 09:51:45,2007-01-21 09:51:45
4f9d8519fb3297063392d0268c0430fe5a6a02f1...3dcdfdf015746c7ec10d915705c1a76cc9d9de31,1,1,0,1,1,2007-01-21 09:54:01,2007-01-21 09:54:01
3dcdfdf015746c7ec10d915705c1a76cc9d9de31...e21594a998d71eff39d80af878162abe94ef6e17,1,4,3,7,3,2007-01-21 09:57:11,2007-01-21 09:57:11
e21594a998d71eff39d80af878162abe94ef6e17...20a53c029efe15cacc26c0e6a0c980ff4bda6635,1,41,41,82,35,2007-01-22 03:47:53,2007-01-21 16:37:58
20a53c029efe15cacc26c0e6a0c980ff4bda6635...82cb8706bb9f4f43c72e0228ad33d91c29448f3f,1,25,17,42,8,2007-01-22 03:47:53,2007-01-21 16:54:16
82cb8706bb9f4f43c72e0228ad33d91c29448f3f...3b4db3c1a3b9be66b46d8bd64560ee3f14f1084d,1,37,10,47,11,2007-01-22 03:47:53,2007-01-21 17:30:51
3b4db3c1a3b9be66b46d8bd64560ee3f14f1084d...fec4a78590229aab648e37195a071e3aae02bfe0,1,64,24,88,8,2007-01-22 03:47:54,2007-01-21 18:12:02
fec4a78590229aab648e37195a071e3aae02bfe0...079d0d5057dd66916c8d23802d48b19235fedf09,1,16,9,25,6,2007-01-22 03:47:54,2007-01-21 18:18:11
079d0d5057dd66916c8d23802d48b19235fedf09...6bdc929984f84318783ef320115f46151fa4f0d6,1,7,4,11,3,2007-01-22 03:47:54,2007-01-21 18:22:26
6bdc929984f84318783ef320115f46151fa4f0d6...a4b1786b954917294483feb176e6ca473e01b615,1,1,1,2,1,2007-01-22 03:47:54,2007-01-21 18:25:06
a4b1786b954917294483feb176e6ca473e01b615...68c30b4af1b1d6f95ae6724364641aa787247f0f,1,4,0,4,1,2007-01-22 03:47:55,2007-01-21 18:27:43
68c30b4af1b1d6f95ae6724364641aa787247f0f...14efcc748597f8b00d362df26adf5c4b4b7777f7,1,4,4,8,4,2007-01-22 03:47:55,2007-01-21 18:34:00
14efcc748597f8b00d362df26adf5c4b4b7777f7...f8a1518d06378c34fa8a0d8530e5041527004af5,1,17,15,32,9,2007-01-22 03:47:55,2007-01-21 18:37:53
f8a1518d06378c34fa8a0d8530e5041527004af5...66cc17d1d3bead2ebf6fbe41ea31e7ec111d891b,1,26,36,62,14,2007-01-22 03:47:55,2007-01-21 18:56:38
66cc17d1d3bead2ebf6fbe41ea31e7ec111d891b...15e1374927b1dc42a575235c63852d444cf9c1ab,1,54,19,73,11,2007-01-22 03:47:56,2007-01-21 19:14:54
15e1374927b1dc42a575235c63852d444cf9c1ab...884fd059f8c86dc815ea7fd769f7190e3f248536,1,1,1,2,1,2007-01-22 03:47:56,2007-01-21 19:16:40
884fd059f8c86dc815ea7fd769f7190e3f248536...37d2a1c9fa2f94093cb6bd5e6b2aa6a38c95593e,1,2,1,3,1,2007-01-22 03:47:56,2007-01-21 19:23:51
37d2a1c9fa2f94093cb6bd5e6b2aa6a38c95593e...ca52156618ce374711e37c8d633f0ee30cdd58c3,1,11,9,20,7,2007-01-22 03:47:56,2007-01-21 19:49:45
ca52156618ce374711e37c8d633f0ee30cdd58c3...3c2369773929e299002d5e4e7737ea769ddc3bf8,1,14,6,20,8,2007-01-22 03:47:57,2007-01-21 19:58:01
3c2369773929e299002d5e4e7737ea769ddc3bf8...19e283f5c25b64a55fca099342f9bebddef4e17e,1,38,39,77,6,2007-01-22 03:47:57,2007-01-21 20:38:09
19e283f5c25b64a55fca099342f9bebddef4e17e...e754d6efe7810f5f2c6cbd48dca21f1bc84a6a5e,1,10,0,10,1,2007-01-22 03:47:57,2007-01-21 20:40:55
e754d6efe7810f5f2c6cbd48dca21f1bc84a6a5e...c845692d7551cbcbfd8c6dda2aa2e3b135838e39,1,34,5,39,8,2007-01-22 03:47:57,2007-01-21 21:28:59
c845692d7551cbcbfd8c6dda2aa2e3b135838e39...f250091b77949766724ffb67beb7a6adadc6b5b4,1,6,5,11,3,2007-01-22 03:47:58,2007-01-21 21:37:05
f250091b77949766724ffb67beb7a6adadc6b5b4...b36ffe800d830556e8df7eda8743c15dfac70e27,1,3,0,3,3,2007-01-22 03:47:58,2007-01-21 21:43:14
b36ffe800d830556e8df7eda8743c15dfac70e27...4343434307dca441cd2dade1ece7c0ef5d4a7de2,1,24,9,33,6,2007-01-22 03:47:58,2007-01-21 22:02:25
4343434307dca441cd2dade1ece7c0ef5d4a7de2...9c10deab6ceb15b6b576d9bc77955c24d5baa709,1,36,10,46,6,2007-01-22 03:47:59,2007-01-21 22:22:40
9c10deab6ceb15b6b576d9bc77955c24d5baa709...d4dd034ab5bb13162c4a4e6c588fe530c7739a95,1,4,9,13,3,2007-01-22 03:47:59,2007-01-21 22:26:22
d4dd034ab5bb13162c4a4e6c588fe530c7739a95...c5a1eb889ca3df51ac443916a037b59c46983239,1,5,5,10,5,2007-01-22 03:47:59,2007-01-21 22:50:42
c5a1eb889ca3df51ac443916a037b59c46983239...f5925d934fdd1ffc3ded7272ea278437608f5f50,1,9,1,10,2,2007-01-22 03:47:59,2007-01-21 23:00:03
f5925d934fdd1ffc3ded7272ea278437608f5f50...8ce03164842d250f1cf1dfbf9a245fd030195e24,1,1,0,1,1,2007-01-22 04:11:47,2007-01-22 04:11:47
8ce03164842d250f1cf1dfbf9a245fd030195e24...46aaf90b4901cbae9da9d59ba8cc914dcfc38aa3,1,4,10,14,4,2007-01-22 22:10:38,2007-01-22 22:10:38
46aaf90b4901cbae9da9d59ba8cc914dcfc38aa3...e0c781b34756ce47ab9a6ae89eba8067733d6e5c,1,2,0,2,1,2007-01-23 06:48:49,2007-01-22 23:24:45
e0c781b34756ce47ab9a6ae89eba8067733d6e5c...75e78c8a1bb273461c14a5b37f9b06215f502e67,1,3,3,6,3,2007-01-23 06:48:50,2007-01-22 23:31:12
75e78c8a1bb273461c14a5b37f9b06215f502e67...e54a1bd122007af30fcf174a57f892157501673f,1,1,0,1,1,2007-01-23 06:48:50,2007-01-23 00:18:39
e54a1bd122007af30fcf174a57f892157501673f...124355d32c0612192e729e12f1d3d68849754f29,1,6,8,14,3,2007-01-23 06:48:50,2007-01-23 03:41:13
124355d32c0612192e729e12f1d3d68849754f29...464c9ffee45520c8be3ec656f926224501bcf977,1,3,0,3,1,2007-01-23 07:08:09,2007-01-23 07:08:09
464c9ffee45520c8be3ec656f926224501bcf977...19b41e455932d56a578becdfd91095a9a041f21c,1,23,5,28,5,2007-01-23 07:33:58,2007-01-23 07:33:58
19b41e455932d56a578becdfd91095a9a041f21c...d3596fd9486b602252d5b2c3e14ac55a07a2bdb9,1,8,0,8,1,2007-01-23 08:18:37,2007-01-23 08:18:37
d3596fd9486b602252d5b2c3e14ac55a07a2bdb9...4e62e2725e487b515a57e1c6ae5ef9b81546884d,1,1,0,1,1,2007-01-23 08:25:17,2007-01-23 08:25:17
4e62e2725e487b515a57e1c6ae5ef9b81546884d...0565246a7c886475878ea08cd501ea7ac4de6ada,1,0,1,1,1,2007-01-23 08:30:02,2007-01-23 08:30:02
0565246a7c886475878ea08cd501ea7ac4de6ada...51a989ba5a4d1299d08ddad19c6a45485bdb7dd8,1,14,9,23,12,2007-01-23 09:07:18,2007-01-23 09:07:18
51a989ba5a4d1299d08ddad19c6a45485bdb7dd8...59885273c337df937430b8731633c2e9020ce8e3,1,22,1,23,8,2007-01-23 09:40:21,2007-01-23 09:40:21
59885273c337df937430b8731633c2e9020ce8e3...0fd49d0a7d579722bd1a0a1645afc16646b05794,1,64,3,67,5,2007-01-25 05:25:31,2007-01-24 20:21:01
0fd49d0a7d579722bd1a0a1645afc16646b05794...b5b6b434527e5f0df43f994d690a48dad1fb4555,1,101,15,116,7,2007-01-25 05:25:31,2007-01-24 21:51:59
b5b6b434527e5f0df43f994d690a48dad1fb4555...f747133720d26e52b6ed83dfd57cdd1a74668b3d,1,2,4,6,2,2007-01-25 05:25:31,2007-01-24 22:01:49
f747133720d26e52b6ed83dfd57cdd1a74668b3d...bb816c5a25e3a87d4d9588ddcccf83b8a10d8d31,1,11,0,11,2,2007-01-25 05:25:31,2007-01-25 00:08:49
bb816c5a25e3a87d4d9588ddcccf83b8a10d8d31...86773d9bfc6124dec7b33094103f4819684bc4ae,1,1,0,1,1,2007-01-25 05:25:32,2007-01-25 01:39:30
86773d9bfc6124dec7b33094103f4819684bc4ae...a25c51893317bcbd8e8a85b6da3a573fcd096d86,1,110,12,122,12,2007-01-25 05:25:32,2007-01-25 02:20:57
a25c51893317bcbd8e8a85b6da3a573fcd096d86...30b14ed390f543e52665c8fc4f626aab78e3dcab,1,4,0,4,2,2007-01-25 05:25:32,2007-01-25 02:30:23
30b14ed390f543e52665c8fc4f626aab78e3dcab...4e55d19a1377de55c950a90c10b31ae37b79363d,1,6,3,9,4,2007-01-25 17:54:59,2007-01-25 17:54:59
4e55d19a1377de55c950a90c10b31ae37b79363d...b9a75e3a979cc39f5c8d0e6d79e19ae31aef17e3,1,1,0,1,1,2007-01-25 17:55:20,2007-01-25 17:55:20
b9a75e3a979cc39f5c8d0e6d79e19ae31aef17e3...23effa79f7697cd27f04cb6edc9680e11e15f02a,1,1,0,1,1,2007-01-25 17:57:57,2007-01-25 17:57:57
23effa79f7697cd27f04cb6edc9680e11e15f02a...5753ef1a4eca7b4ce04d1e4ea2250442bba4dbb9,1,4,6,10,1,2007-01-25 18:01:16,2007-01-25 18:01:16
5753ef1a4eca7b4ce04d1e4ea2250442bba4dbb9...68567679a2d7cec04be1a62e09874189e46de4b6,1,1,1,2,1,2007-01-25 18:07:53,2007-01-25 18:07:53
68567679a2d7cec04be1a62e09874189e46de4b6...fb08baca3340099d149a88f6ede19a6870870c08,1,33,42,75,19,2007-01-25 21:50:15,2007-01-25 21:50:15
fb08baca3340099d149a88f6ede19a6870870c08...3f7fd924a92c07c0fd4e8bd80b941171097db7f0,1,9,45,54,9,2007-01-25 22:16:22,2007-01-25 22:16:22
3f7fd924a92c07c0fd4e8bd80b941171097db7f0...d070c4cb17e807c157aaeb24d9b80a1112334e57,1,7,0,7,1,2007-01-25 22:16:57,2007-01-25 22:07:03
d070c4cb17e807c157aaeb24d9b80a1112334e57...5f8b70b1dc3d149782564e04d5d55565a5157d93,1,5,8,13,2,2007-01-26 05:41:01,2007-01-26 02:33:06
5f8b70b1dc3d149782564e04d5d55565a5157d93...156b29211ae4f8143f143fd6cce6e93b60c51f43,1,5,5,10,5,2007-01-26 05:41:01,2007-01-26 03:38:59
156b29211ae4f8143f143fd6cce6e93b60c51f43...1d6a9787526372609d3b105659e9cb5f3718df4a,1,158,0,158,6,2007-01-26 05:41:01,2007-01-26 04:50:27
1d6a9787526372609d3b105659e9cb5f3718df4a...86a2af608700896a004be50c939a76a539bdba4d,1,5,68,73,4,2007-01-26 05:47:44,2007-01-26 05:47:44
86a2af608700896a004be50c939a76a539bdba4d...b972ea59e422588963bda7be8e04c59728accadf,1,1,0,1,1,2007-01-26 05:49:17,2007-01-26 05:49:17
b972ea59e422588963bda7be8e04c59728accadf...6c3d1481bab96659a80771194d935cb6db02300e,1,29,18,47,11,2007-01-26 06:29:00,2007-01-26 06:29:00
6c3d1481bab96659a80771194d935cb6db02300e...bc7452f5e7c0c472bc580e2e00d84f31d1af50ce,1,43,2,45,3,2007-01-26 07:02:09,2007-01-26 07:02:09
bc7452f5e7c0c472bc580e2e00d84f31d1af50ce...e4834837a8a02708efb6a7f8a248087a8cd49ab3,1,213,12,225,6,2007-01-26 08:33:56,2007-01-26 08:33:56
e4834837a8a02708efb6a7f8a248087a8cd49ab3...ce9735dfbd77ab7cbcb97ba8749b2f6eaa7f2527,1,61,0,61,2,2007-01-26 08:54:05,2007-01-26 08:54:05
ce9735dfbd77ab7cbcb97ba8749b2f6eaa7f2527...ee3cfb595415e2f076d5b90efba83088e5af961c,1,4,2,6,2,2007-01-26 08:58:56,2007-01-26 08:58:56
ee3cfb595415e2f076d5b90efba83088e5af961c...dff7e88febf85b1b8b1b789cd7c99434b70fb19b,1,24,4,28,5,2007-01-26 09:07:34,2007-01-26 09:07:34
dff7e88febf85b1b8b1b789cd7c99434b70fb19b...5f39dbf64f5e57c6ab7b20ba8c397df1074bc30c,1,15,0,15,2,2007-01-26 09:11:10,2007-01-26 09:11:10
5f39dbf64f5e57c6ab7b20ba8c397df1074bc30c...729a6f60ddd0b3317c581a01687a32e585fa0c3e,1,13,7,20,7,2007-01-26 09:16:39,2007-01-26 09:16:39
729a6f60ddd0b3317c581a01687a32e585fa0c3e...c539449b2df0381de1d34c70b093b68370e89a4e,1,50,27,77,16,2007-01-26 09:43:43,2007-01-26 09:43:43
c539449b2df0381de1d34c70b093b68370e89a4e...6b90d39186dbfabfff94692d33d0a6e94f02016c,1,2,6,8,3,2007-01-27 07:31:01,2007-01-27 07:31:01
6b90d39186dbfabfff94692d33d0a6e94f02016c...273984fc4f26ab92aa8ebf5b033b9cdb56322b71,1,44,4,48,4,2007-01-29 06:12:42,2007-01-29 01:00:36
273984fc4f26ab92aa8ebf5b033b9cdb56322b71...20ddfcaa7e7f91816f1195a2dbb1b5268fd71e3d,1,104,34,138,22,2007-01-29 06:12:42,2007-01-29 01:58:47
20ddfcaa7e7f91816f1195a2dbb1b5268fd71e3d...35874c163e2f5c1def3cc5c3465beceea0355b8f,1,459,0,459,4,2007-01-29 06:12:42,2007-01-29 05:50:41
35874c163e2f5c1def3cc5c3465beceea0355b8f...3eddda98435f67ffb0afc8baf4bfb51ed8160f2c,1,26,18,44,2,2007-01-29 07:50:10,2007-01-29 07:50:10
3eddda98435f67ffb0afc8baf4bfb51ed8160f2c...c94dd1c8c2da1601c83443292b4ab34be3ab3358,1,3,3,6,3,2007-01-29 07:52:06,2007-01-29 07:52:06
c94dd1c8c2da1601c83443292b4ab34be3ab3358...db45378165f499dcc4412b4f4b0f4ec5cbc65914,1,6,0,6,2,2007-01-29 07:56:07,2007-01-29 07:56:07
db45378165f499dcc4412b4f4b0f4ec5cbc65914...463ca37b61b0d12aae8949c730bd38cc2149923f,1,3,1,4,1,2007-01-29 08:03:29,2007-01-29 08:03:29
463ca37b61b0d12aae8949c730bd38cc2149923f...8f6c07b902b297329e63799d5332758530ec4d99,1,4,2,6,2,2007-01-29 08:09:28,2007-01-29 08:09:28
8f6c07b902b297329e63799d5332758530ec4d99...915616e4ebaedc486a2dd235e70f25ceb39b4515,1,33,1,34,8,2007-01-29 10:33:27,2007-01-29 10:33:27
915616e4ebaedc486a2dd235e70f25ceb39b4515...e7fb6c69f7612d4e8545f1812a2830f97f183f87,1,74,21,95,25,2007-01-29 10:51:49,2007-01-29 10:51:49
e7fb6c69f7612d4e8545f1812a2830f97f183f87...747c0cf93c75207da095709a92a615aae0553289,1,61,63,124,25,2007-01-29 11:23:12,2007-01-29 11:23:12
747c0cf93c75207da095709a92a615aae0553289...37f1db80a46cf753308bfc9b5de9dd3b3a551218,1,58,13,71,9,2007-01-29 11:56:00,2007-01-29 11:56:00
37f1db80a46cf753308bfc9b5de9dd3b3a551218...63faf4df6e174cc1e33a759d49133044c732ea32,1,6,1,7,2,2007-02-08 20:59:39,2007-02-08 20:59:39
63faf4df6e174cc1e33a759d49133044c732ea32...9bccb782c35b864988e51d433271faba2ac3e96f,1,99,38,137,10,2007-02-08 22:07:59,2007-02-08 22:07:59
9bccb782c35b864988e51d433271faba2ac3e96f...42b922fcf6f3bd16c4579f2b9e1e52c79096eba2,1,1,0,1,1,2007-02-08 22:13:51,2007-02-08 22:13:51
42b922fcf6f3bd16c4579f2b9e1e52c79096eba2...cf25ddc8b31ef883cf23eeb8d2eae21535a98002,1,30,14,44,15,2007-02-08 23:03:41,2007-02-08 23:03:41
cf25ddc8b31ef883cf23eeb8d2eae21535a98002...64a906f8611ee195efcde76f5587c8e08bac7a25,1,12,7,19,9,2007-02-08 23:10:05,2007-02-08 23:10:05
64a906f8611ee195efcde76f5587c8e08bac7a25...db7f34d4c54c1162d976be4d1752642c85e063b4,1,28,26,54,3,2007-02-08 23:14:44,2007-02-08 22:47:17
db7f34d4c54c1162d976be4d1752642c85e063b4...2ebba528dcb64ec1a408ec3b06cf9f928a7fb76d,1,136,84,220,28,2007-02-09 00:10:52,2007-02-09 00:10:52
2ebba528dcb64ec1a408ec3b06cf9f928a7fb76d...258871d3058a3117d204009b7173bf8c7df2414d,1,35,13,48,9,2007-02-09 00:41:32,2007-02-09 00:41:32
258871d3058a3117d204009b7173bf8c7df2414d...24d2bf2f02c104b8402e2c19b383aecd1e2ccf17,1,2,2,4,2,2007-02-09 00:44:49,2007-02-09 00:44:49
24d2bf2f02c104b8402e2c19b383aecd1e2ccf17...df6287ecd78206095796512bca80e87cc5a5e33b,1,8,8,16,8,2007-02-09 00:53:36,2007-02-09 00:53:36
df6287ecd78206095796512bca80e87cc5a5e33b...6910ae80d0e84f03151473ee55055c46b5480ec5,1,160,199,359,37,2007-02-09 02:39:27,2007-02-09 02:39:27
6910ae80d0e84f03151473ee55055c46b5480ec5...1351ba13e599ef80bbfd9f9ef4ff22117418f030,1,6,1,7,1,2007-02-09 03:41:51,2007-02-09 03:41:51
1351ba13e599ef80bbfd9f9ef4ff22117418f030...486ef5270ce3162ee14634db825884cc466a32bf,1,72,22,94,26,2007-02-09 06:59:38,2007-02-09 06:59:38
486ef5270ce3162ee14634db825884cc466a32bf...d585e782b0bfb11173028091cb11c8459766135c,1,3,1,4,3,2007-02-09 07:28:32,2007-02-09 07:28:32
d585e782b0bfb11173028091cb11c8459766135c...0960f7d6db89fa8418486cd088759e54dd51d54e,1,0,8,8,1,2007-02-11 22:19:38,2007-02-11 22:19:38
4b825dc642cb6eb9a060e54bf8d69288fbee4904...161332a521fe10c41979bcd493d95e2ac562b7ff,1,320,0,320,1,2005-08-07 17:49:46,2005-08-07 17:49:46
161332a521fe10c41979bcd493d95e2ac562b7ff...4c02e3c56f95858f9e75fd102dbdf311431a6d10,1,179,74,253,41,2005-08-07 17:52:52,2005-08-07 17:52:52
4c02e3c56f95858f9e75fd102dbdf311431a6d10...ecb378f5b57b3b8eaa3cbccfb81f29bab8f4a1b7,1,63,77,140,38,2005-08-07 17:53:54,2005-08-07 17:53:54
ecb378f5b57b3b8eaa3cbccfb81f29bab8f4a1b7...e0389bd7f23cd49f46c82bb764fdc898b91fadc5,1,73,59,132,34,2005-08-07 17:54:31,2005-08-07 17:54:31
e0389bd7f23cd49f46c82bb764fdc898b91fadc5...b531daf3a17b7787e631a713a42a58a25dd537df,1,9,42,51,8,2005-08-07 17:55:05,2005-08-07 17:55:05
b531daf3a17b7787e631a713a42a58a25dd537df...c068cff1f95c68f29cb514d5be7b9ddcbd28d824,1,30,12,42,13,2005-08-07 17:56:10,2005-08-07 17:56:10
c068cff1f95c68f29cb514d5be7b9ddcbd28d824...adf3ee8e48fd4f3a75d4ee9a2e3209bd087c6417,1,23,22,45,16,2005-08-07 17:56:44,2005-08-07 17:56:44
adf3ee8e48fd4f3a75d4ee9a2e3209bd087c6417...22fafb99e37d5b8b4f8ef57b9d09f233a7efa40a,1,8,3,11,5,2005-08-07 17:56:59,2005-08-07 17:56:59
22fafb99e37d5b8b4f8ef57b9d09f233a7efa40a...823d5dc81f7452395725cf771e5710b113c7b27c,1,46,17,63,15,2005-08-07 17:57:58,2005-08-07 17:57:58
823d5dc81f7452395725cf771e5710b113c7b27c...52ccdd40923bc189fbaf5eab9c515d3d27025773,1,26,3,29,5,2005-08-07 17:58:12,2005-08-07 17:58:12
52ccdd40923bc189fbaf5eab9c515d3d27025773...44ad2978e69dd69956ca8eadf542789f484dba17,1,70,49,119,31,2005-08-07 17:59:24,2005-08-07 17:59:24
44ad2978e69dd69956ca8eadf542789f484dba17...1b1433800ec2cf5961eaa5a924b2799f6b05ae10,1,33,27,60,23,2005-08-07 17:59:41,2005-08-07 17:59:41
1b1433800ec2cf5961eaa5a924b2799f6b05ae10...a7e09a96a8b92913bebd89a45e43367c28a49072,1,37,33,70,24,2005-08-07 18:00:05,2005-08-07 18:00:05
a7e09a96a8b92913bebd89a45e43367c28a49072...e334d18cfd28697912806e20130287ae7252c106,1,100,74,174,34,2005-08-07 18:02:33,2005-08-07 18:02:33
e334d18cfd28697912806e20130287ae7252c106...12a88f2f031d10a1a7b46a913e629e90531b08b6,1,26,26,52,19,2005-08-07 18:02:47,2005-08-07 18:02:47
12a88f2f031d10a1a7b46a913e629e90531b08b6...703ac7102fb66f748f9a636f57852909b4425496,1,45,5,50,2,2005-08-07 18:03:14,2005-08-07 18:03:14
703ac7102fb66f748f9a636f57852909b4425496...3f714537ae72948a35db827d87363226200af646,1,33,70,103,16,2005-08-07 18:03:52,2005-08-07 18:03:52
3f714537ae72948a35db827d87363226200af646...3e029299d8c6608298c3a2fc1f02af6b2cef0f29,1,102,85,187,42,2005-08-07 18:05:15,2005-08-07 18:05:15
3e029299d8c6608298c3a2fc1f02af6b2cef0f29...959c6a1efcd54558cf6b1899f7b6068655a6fbf4,1,4,9,13,3,2005-08-07 18:05:32,2005-08-07 18:05:32
959c6a1efcd54558cf6b1899f7b6068655a6fbf4...8ed23e1bfb9233303898e2d5a9f240467bf89495,1,43,39,82,17,2005-08-07 18:05:44,2005-08-07 18:05:44
8ed23e1bfb9233303898e2d5a9f240467bf89495...d767d59c8a194dfe4c56040540df63f4d64ce5e0,1,36,19,55,21,2005-08-07 18:05:55,2005-08-07 18:05:55
d767d59c8a194dfe4c56040540df63f4d64ce5e0...022be3d0f105afbf55092056d242406685ccdb7e,1,69,100,169,31,2005-08-07 18:06:09,2005-08-07 18:06:09
022be3d0f105afbf55092056d242406685ccdb7e...54b0a43c3f64b02ecd30aceb5ad58842e4a6a4b2,1,30,24,54,17,2005-08-07 18:08:03,2005-08-07 18:08:03
54b0a43c3f64b02ecd30aceb5ad58842e4a6a4b2...86eed32d36e65dbce8572f86f8bb5087ba556ed2,1,35,15,50,8,2005-08-07 18:08:29,2005-08-07 18:08:29
86eed32d36e65dbce8572f86f8bb5087ba556ed2...991910a9ff03fa4032449d8f75a657d17fa84d86,1,32,28,60,15,2005-08-07 18:09:33,2005-08-07 18:09:33
991910a9ff03fa4032449d8f75a657d17fa84d86...fbb592a91ed2e2d7216d162831aeaea1ed12a6cf,1,59,84,143,32,2005-08-07 18:12:11,2005-08-07 18:12:11
fbb592a91ed2e2d7216d162831aeaea1ed12a6cf...ff7669a5b9922e86831e59398e89bad1372dc581,1,102,83,185,34,2005-08-07 18:13:02,2005-08-07 18:13:02
ff7669a5b9922e86831e59398e89bad1372dc581...185f09e5ba4031f689659045a7f840a14b5ab909,1,26,18,44,8,2005-08-07 18:13:11,2005-08-07 18:13:11
185f09e5ba4031f689659045a7f840a14b5ab909...2ad9331e15fba4476cb734f46b845638ee82222e,1,70,43,113,11,2005-08-07 18:14:48,2005-08-07 18:14:48
2ad9331e15fba4476cb734f46b845638ee82222e...a59d4afd69e497193ac63c8633431f9b32211b4d,1,38,28,66,11,2005-08-07 18:15:44,2005-08-07 18:15:44
a59d4afd69e497193ac63c8633431f9b32211b4d...061cc7cdcfda9527f5afb986e0396e393ed0c9f5,1,14,13,27,13,2005-08-07 18:15:57,2005-08-07 18:15:57
061cc7cdcfda9527f5afb986e0396e393ed0c9f5...d51e902a09f96029b01141b41e297ec7774f55c0,1,45,9,54,11,2005-08-07 18:16:07,2005-08-07 18:16:07
d51e902a09f96029b01141b41e297ec7774f55c0...2ae100df543b8c287e72bcc470b3b3b1de70d3d7,1,64,35,99,22,2005-08-07 18:17:00,2005-08-07 18:17:00
2ae100df543b8c287e72bcc470b3b3b1de70d3d7...b51103f3cd4f1a08f5c26f5f6cd835dd2e6ead13,1,7,5,12,4,2005-08-07 18:17:09,2005-08-07 18:17:09
b51103f3cd4f1a08f5c26f5f6cd835dd2e6ead13...664f4cc5eba8c6fab56e6ab112f295d5ef26316e,1,5,2,7,3,2005-08-07 18:17:19,2005-08-07 18:17:19
664f4cc5eba8c6fab56e6ab112f295d5ef26316e...9cd3d988730949f7d1cc6f6c96417bf5aa845110,1,115,96,211,48,2005-08-07 18:17:42,2005-08-07 18:17:42
9cd3d988730949f7d1cc6f6c96417bf5aa845110...820e4f6b6b4141b779c140d08e46fde0aa30117c,1,11,6,17,4,2005-08-07 18:17:50,2005-08-07 18:17:50
820e4f6b6b4141b779c140d08e46fde0aa30117c...1207151d40bec83569fb5bb67c0aee6a1a36c353,1,27,19,46,15,2005-08-07 18:18:01,2005-08-07 18:18:01
1207151d40bec83569fb5bb67c0aee6a1a36c353...d63577da05b8994f97bba210aa5816848c1c03a5,1,65,36,101,27,2005-08-07 18:18:13,2005-08-07 18:18:13
d63577da05b8994f97bba210aa5816848c1c03a5...334538f11d30024de28b4490ed6b006d82fadb80,1,12,13,25,7,2005-08-07 18:18:30,2005-08-07 18:18:30
334538f11d30024de28b4490ed6b006d82fadb80...927dcec4805b32b1f7252e0c4dea341df166deb0,1,56,54,110,23,2005-08-07 18:18:44,2005-08-07 18:18:44
927dcec4805b32b1f7252e0c4dea341df166deb0...2bb7c6d4179ca7cd5cfd353400866ef0aed16777,1,22,22,44,14,2005-08-07 18:19:45,2005-08-07 18:19:45
2bb7c6d4179ca7cd5cfd353400866ef0aed16777...6191f8e1ddbc03dd2b5db2f6d433f7a1da93c4af,1,119,94,213,36,2005-08-07 18:19:56,2005-08-07 18:19:56
6191f8e1ddbc03dd2b5db2f6d433f7a1da93c4af...034df39ef7c80bd7e41e244c39400019123273c1,1,100,88,188,30,2005-08-07 18:20:07,2005-08-07 18:20:07
034df39ef7c80bd7e41e244c39400019123273c1...2735983d79172313359cdf57afce723cc89326fd,1,80,47,127,29,2005-08-07 18:20:20,2005-08-07 18:20:20
2735983d79172313359cdf57afce723cc89326fd...b87d78d60ce3798c8938ba1d3ed176b6ed9ba539,1,338,199,537,107,2005-08-07 18:21:04,2005-08-07 18:21:04
b87d78d60ce3798c8938ba1d3ed176b6ed9ba539...09bd78984114118208fecb2c52e4dabdba20fa17,1,337,162,499,117,2005-08-07 18:21:23,2005-08-07 18:21:23
09bd78984114118208fecb2c52e4dabdba20fa17...eb28240b64396e8dd35c79dd0158bcd80021fcc4,1,13,11,24,8,2005-08-07 18:21:34,2005-08-07 18:21:34
eb28240b64396e8dd35c79dd0158bcd80021fcc4...42f7eb94a0016125523cc24dbabfbf4ad5f60a59,1,66,47,113,34,2005-08-07 18:21:46,2005-08-07 18:21:46
42f7eb94a0016125523cc24dbabfbf4ad5f60a59...c07ad4b97128d26949ed34a2fd4a3a7039278fe8,1,103,77,180,49,2005-08-07 18:22:44,2005-08-07 18:22:44
c07ad4b97128d26949ed34a2fd4a3a7039278fe8...8ab1da2c4ffeaabacd1644fab820bf99828652f3,1,16,5,21,5,2005-08-07 18:22:53,2005-08-07 18:22:53
8ab1da2c4ffeaabacd1644fab820bf99828652f3...ede5e1009e9a5f80e84a7f360a734f1af9f4c4e7,1,233,52,285,49,2005-08-07 18:23:12,2005-08-07 18:23:12
ede5e1009e9a5f80e84a7f360a734f1af9f4c4e7...9ea82aa8e02c8d24316e77244c9859b011eec565,1,7,6,13,7,2005-08-07 18:23:24,2005-08-07 18:23:24
9ea82aa8e02c8d24316e77244c9859b011eec565...e925f38c2d2d38298088903419dd9dbfde2268b0,1,28,25,53,26,2005-08-07 18:23:35,2005-08-07 18:23:35
e925f38c2d2d38298088903419dd9dbfde2268b0...7403d50bd2c6a9e72dd5e3db61d68befa8dc34fb,1,9,4,13,5,2005-08-07 18:23:49,2005-08-07 18:23:49
7403d50bd2c6a9e72dd5e3db61d68befa8dc34fb...440c60068b85db4c637f9cdb088ca267cd367fa2,1,30,19,49,11,2005-08-07 18:24:01,2005-08-07 18:24:01
440c60068b85db4c637f9cdb088ca267cd367fa2...0db37973ed6ce0ee96bf2a333f7c5f141e692fb6,1,89,13,102,18,2005-08-07 18:24:35,2005-08-07 18:24:35
0db37973ed6ce0ee96bf2a333f7c5f141e692fb6...fa378499c7f935ba4bbeffe230cb4188e7317b30,1,27,22,49,11,2005-08-07 18:24:43,2005-08-07 18:24:43
fa378499c7f935ba4bbeffe230cb4188e7317b30...a4d26ef062e68d276f94fa8be9130375a3b9ebe8,1,10,5,15,5,2005-08-07 18:24:51,2005-08-07 18:24:51
a4d26ef062e68d276f94fa8be9130375a3b9ebe8...10dba28d74a22f304e3c64b2e190a35ea3306523,1,118,106,224,38,2005-08-07 18:25:27,2005-08-07 18:25:27
10dba28d74a22f304e3c64b2e190a35ea3306523...bddec01de1bf3081174b2ffc379d228c080f957d,1,124,73,197,41,2005-08-07 18:25:42,2005-08-07 18:25:42
bddec01de1bf3081174b2ffc379d228c080f957d...7ab0d2b64619f0e9ca1eaecd333bd2dd68464dd8,1,25,28,53,17,2005-08-07 18:25:54,2005-08-07 18:25:54
7ab0d2b64619f0e9ca1eaecd333bd2dd68464dd8...2bf7a52c6195a52e12cb2b9821a9a026846e7b1c,1,23,11,34,8,2005-08-07 18:26:03,2005-08-07 18:26:03
2bf7a52c6195a52e12cb2b9821a9a026846e7b1c...1f22c267772b2c707d5162cf3374a4332fdd7388,1,8,7,15,2,2005-08-07 18:26:12,2005-08-07 18:26:12
1f22c267772b2c707d5162cf3374a4332fdd7388...198066916a8ea02b90430aa58e2cf5f5ad92ffdc,1,583,226,809,131,2005-08-07 18:26:27,2005-08-07 18:26:27
198066916a8ea02b90430aa58e2cf5f5ad92ffdc...dcea8d0b8478e6b108174cce8e1411b6432237ef,1,23,5,28,6,2005-08-07 18:26:38,2005-08-07 18:26:38
dcea8d0b8478e6b108174cce8e1411b6432237ef...ea4a6df4089f6cfba0e6c6c50290ed18033f641b,1,56,52,108,12,2005-08-07 18:26:49,2005-08-07 18:26:49
ea4a6df4089f6cfba0e6c6c50290ed18033f641b...c994d620cc841e0eff036b6a89cdf31ca1a88950,1,228,128,356,58,2005-08-07 18:27:18,2005-08-07 18:27:18
c994d620cc841e0eff036b6a89cdf31ca1a88950...71be1e7948e1ce9ba91b40bf758666cd8f9db610,1,17,8,25,10,2005-08-07 18:27:27,2005-08-07 18:27:27
71be1e7948e1ce9ba91b40bf758666cd8f9db610...4fac5294de00025e1b5788140788b713a640a300,1,44,26,70,20,2005-08-07 18:27:38,2005-08-07 18:27:38
4fac5294de00025e1b5788140788b713a640a300...d05c19eeb2cc9341ba3e9b629d99b87cdb1e4bb9,1,27,16,43,9,2005-08-07 18:27:49,2005-08-07 18:27:49
d05c19eeb2cc9341ba3e9b629d99b87cdb1e4bb9...1b1cd421826c07a98936385664934887f88ef159,1,33,7,40,9,2005-08-07 18:28:01,2005-08-07 18:28:01
1b1cd421826c07a98936385664934887f88ef159...f6375b2452894f0e1ac156a1fcc30fcbaf54f360,1,10,6,16,6,2005-08-07 18:28:33,2005-08-07 18:28:33
f6375b2452894f0e1ac156a1fcc30fcbaf54f360...f49201a9957b9dd13cc4c68038e9d701369feee1,1,19,8,27,5,2005-08-07 18:28:42,2005-08-07 18:28:42
f49201a9957b9dd13cc4c68038e9d701369feee1...d8a20ba9bc6a065b929310d1319ddd190671ba0b,1,110,24,134,29,2005-08-07 18:28:53,2005-08-07 18:28:53
d8a20ba9bc6a065b929310d1319ddd190671ba0b...d263a6bd453df849c9f9211f1966c830c3cf913a,1,44,27,71,8,2005-08-07 18:29:03,2005-08-07 18:29:03
d263a6bd453df849c9f9211f1966c830c3cf913a...f5dfb3f6a6655d4d60fdd0aaeef7b5b14226147f,1,16,0,16,1,2005-08-07 20:39:58,2005-08-07 20:39:58
f5dfb3f6a6655d4d60fdd0aaeef7b5b14226147f...e4669df9a6f638299ebab57cc87318a2a9e24b0c,1,6,2,8,2,2005-08-07 22:02:39,2005-08-07 22:02:39
e4669df9a6f638299ebab57cc87318a2a9e24b0c...f7ab660c15b5e3cb7fee035191e0cd5160bf8299,1,64,36,100,11,2005-08-10 01:53:09,2005-08-10 01:53:09
f7ab660c15b5e3cb7fee035191e0cd5160bf8299...d8d17b5debd37a3f0e42eba2d69d375b74f20fe9,1,31,11,42,14,2005-08-12 19:43:32,2005-08-12 19:43:32
d8d17b5debd37a3f0e42eba2d69d375b74f20fe9...53b89d8ddb0ec0643ab0c14d5c251d1e7ffbc8cb,1,2,2,4,2,2005-08-12 20:12:58,2005-08-12 20:12:58
53b89d8ddb0ec0643ab0c14d5c251d1e7ffbc8cb...e00c9e18a7382209b158efdc0c600165cde295a5,1,2,0,2,2,2005-08-18 16:24:28,2005-08-18 16:24:28
e00c9e18a7382209b158efdc0c600165cde295a5...a48e11ca90ff0cb01bff953ab4095a33a5561a70,1,10,7,17,3,2005-08-31 01:25:29,2005-08-31 01:25:29
a48e11ca90ff0cb01bff953ab4095a33a5561a70...c24fd7b7cc9178af7e1e02d4a0fde549533b56c6,1,18,6,24,3,2005-08-31 01:47:13,2005-08-31 01:47:13
c24fd7b7cc9178af7e1e02d4a0fde549533b56c6...48c771f4a7c10e28bb1c14a59035df30169f5edf,1,2,2,4,2,2005-08-31 01:54:45,2005-08-31 01:54:45
48c771f4a7c10e28bb1c14a59035df30169f5edf...76a8323ac7f543d5abb8849aa6f6a991cffc281f,1,2,2,4,2,2005-08-31 02:11:33,2005-08-31 02:11:33
76a8323ac7f543d5abb8849aa6f6a991cffc281f...c91da262b388c106d7f77831cc6ab2264396e793,1,37,41,78,9,2005-09-03 12:50:33,2005-09-03 12:50:33
c91da262b388c106d7f77831cc6ab2264396e793...86f5b8a098e60912a3396eb85481fa85c67133c9,1,1,1,2,1,2005-09-03 12:51:13,2005-09-03 12:51:13
86f5b8a098e60912a3396eb85481fa85c67133c9...f9127561461fe209171aaf81afd2bbe234756d7b,1,11,2,13,2,2005-09-03 23:37:25,2005-09-03 23:37:25
f9127561461fe209171aaf81afd2bbe234756d7b...324d7cca6800a6c0bd6ea4ee4fcbcb5d79bc667f,1,1,1,2,1,2005-09-06 21:26:10,2005-09-06 21:26:10
324d7cca6800a6c0bd6ea4ee4fcbcb5d79bc667f...55d0b8e4f718e5b28deae474866a936375b584cc,1,1,1,2,1,2005-09-06 21:26:57,2005-09-06 21:26:57
55d0b8e4f718e5b28deae474866a936375b584cc...25f422fb87014107bffb265483809909f300c537,1,24,25,49,12,2005-09-13 00:21:59,2005-09-13 00:21:59
25f422fb87014107bffb265483809909f300c537...bd4d3c92d7bbe527bfc24e1a0bc4aa42900e4c90,1,1,1,2,1,2005-09-13 00:22:51,2005-09-13 00:22:51
bd4d3c92d7bbe527bfc24e1a0bc4aa42900e4c90...c39e47d98a05beb6f5194900b1b081ccc00d70e7,1,8,0,8,3,2005-09-17 01:00:21,2005-09-17 01:00:21
c39e47d98a05beb6f5194900b1b081ccc00d70e7...972062bbb8d097186eee6772e7486f5a4a025d5a,1,1,1,2,1,2005-09-20 08:25:01,2005-09-20 08:25:01
972062bbb8d097186eee6772e7486f5a4a025d5a...d8f1c5c2f37433ef9ce56847d81314ea2798ac3c,1,9,9,18,7,2005-10-03 23:12:47,2005-10-03 23:12:47
d8f1c5c2f37433ef9ce56847d81314ea2798ac3c...0c3eb45fa414326564cb1a9692c7a22319939fc0,1,1,1,2,1,2005-10-03 23:13:22,2005-10-03 23:13:22
0c3eb45fa414326564cb1a9692c7a22319939fc0...9312944d35b571c4a7fdde266131b1a6f8d03241,1,13,6,19,4,2005-10-17 01:27:54,2005-10-17 01:27:54
9312944d35b571c4a7fdde266131b1a6f8d03241...11044297b21e0ecabc22c055e43be7bfd3972dff,1,15,3,18,4,2005-10-19 01:18:45,2005-10-19 01:18:45
11044297b21e0ecabc22c055e43be7bfd3972dff...5b6dcc3fded7acd02c61c2a10a7f83ced31b4d3e,1,1,1,2,1,2005-10-19 01:24:27,2005-10-19 01:24:27
5b6dcc3fded7acd02c61c2a10a7f83ced31b4d3e...cc3245b6512a01d74c0fd460d762ba8a1e8b968a,3,11,0,11,3,2005-11-14 04:43:02,2005-11-14 04:43:02
cc3245b6512a01d74c0fd460d762ba8a1e8b968a...85852d44e48c1d1c6d815cc5fccf1b580f2f2cad,2,3,3,6,2,2005-11-14 04:45:31,2005-11-14 04:45:31
85852d44e48c1d1c6d815cc5fccf1b580f2f2cad...353347b0b811fcdb7c7064a85d1729433c0b8d51,1,199,191,390,120,2005-11-14 04:47:18,2005-11-14 04:47:18
353347b0b811fcdb7c7064a85d1729433c0b8d51...182167100f707eda8ab543b1b36e19f777ebe67a,1,5,5,10,4,2005-11-14 05:10:07,2005-11-14 05:10:07
182167100f707eda8ab543b1b36e19f777ebe67a...7f2a645e4f0ca88184440980d64bf3ccb2ec8c97,1,1,1,2,1,2005-11-14 05:12:33,2005-11-14 05:12:33
7f2a645e4f0ca88184440980d64bf3ccb2ec8c97...a9e60b7d097c6f1a0ebca058ae24e544e231f91d,1,2,2,4,3,2005-11-14 14:15:12,2005-11-14 14:15:12
a9e60b7d097c6f1a0ebca058ae24e544e231f91d...40c138134f183e635712ceace33d04e10744607f,1,241,232,473,146,2005-11-19 16:41:29,2005-11-19 16:41:29
40c138134f183e635712ceace33d04e10744607f...b8470d86e5e8d8ef50304fea534e985e5d4a16f0,1,1,1,2,1,2005-11-19 16:56:29,2005-11-19 16:56:29
b8470d86e5e8d8ef50304fea534e985e5d4a16f0...afeaa5d8da4c4f1abde1a01285f6d612919c64ee,1,3,2,5,2,2005-11-20 01:03:09,2005-11-20 01:03:09
afeaa5d8da4c4f1abde1a01285f6d612919c64ee...d81caf21e98d2ac42268c7d8660db7692ef3c006,1,1,1,2,1,2005-11-20 01:03:29,2005-11-20 01:03:29
d81caf21e98d2ac42268c7d8660db7692ef3c006...440c8a2ad0105b3c2010d5fd5c0bab11698b8105,1,1,1,2,1,2005-11-20 01:12:45,2005-11-20 01:12:45
440c8a2ad0105b3c2010d5fd5c0bab11698b8105...5b7a14fb4d1d38e73026e69608f11f0016f0870a,1,1,1,2,1,2005-11-20 01:13:08,2005-11-20 01:13:08
5b7a14fb4d1d38e73026e69608f11f0016f0870a...10bb9036604006979c3a168760b01812e5dbbb40,1,3,2,5,4,2005-11-23 03:26:40,2005-11-23 03:26:40
10bb9036604006979c3a168760b01812e5dbbb40...2fe8f1c04a7fb2ffd37be9f2ff15244cc4a6ab7a,1,1,0,1,1,2005-11-23 14:09:59,2005-11-23 14:09:59
2fe8f1c04a7fb2ffd37be9f2ff15244cc4a6ab7a...7597763d5becf151e5b0629206f24d789f5615c3,1,1,0,1,1,2005-11-23 14:16:49,2005-11-23 14:16:49
7597763d5becf151e5b0629206f24d789f5615c3...8f1deb5f53f606ac60563175c988b676627e31ce,1,1,0,1,1,2005-11-23 15:02:13,2005-11-23 15:02:13
8f1deb5f53f606ac60563175c988b676627e31ce...e13dd505c5e60341177ac0bd7fcdc5f4955d3f02,1,1,1,2,1,2005-11-23 17:00:34,2005-11-23 17:00:34
e13dd505c5e60341177ac0bd7fcdc5f4955d3f02...232ff5536c6d2016e1ac14c3f1c8703b54a69ad8,1,222,206,428,134,2005-11-24 15:56:55,2005-11-24 15:56:55
232ff5536c6d2016e1ac14c3f1c8703b54a69ad8...3957fa17798f2cfdfac69bef43fb768d1a5dc276,1,0,1,1,1,2005-11-24 16:15:30,2005-11-24 16:15:30
3957fa17798f2cfdfac69bef43fb768d1a5dc276...6dc05fa7496fe2f87f50e77395c63b143f289bcd,1,1,1,2,1,2005-11-24 16:30:38,2005-11-24 16:30:38
6dc05fa7496fe2f87f50e77395c63b143f289bcd...ae78620525445407cca9830b7395668388769db6,1,2,2,4,2,2005-11-24 17:14:25,2005-11-24 17:14:25
ae78620525445407cca9830b7395668388769db6...e7e470c9b80bd1a77ae263f3446c81b81848fbf7,1,1,1,2,1,2005-11-24 17:14:44,2005-11-24 17:14:44
e7e470c9b80bd1a77ae263f3446c81b81848fbf7...f5ac835a58c7487b2e4d5a93a5cf4aab3dcf0d08,1,1,1,2,1,2005-11-24 18:43:53,2005-11-24 18:43:53
f5ac835a58c7487b2e4d5a93a5cf4aab3dcf0d08...94140c7ab0eac7a8ec57b003620d00c00eb63861,1,1,1,2,1,2005-11-24 18:44:28,2005-11-24 18:44:28
94140c7ab0eac7a8ec57b003620d00c00eb63861...6a928415e25da49b0f19b6924b6d9bbf1f8d5a4b,1,45,14,59,15,2005-12-07 08:44:06,2005-12-07 08:44:06
6a928415e25da49b0f19b6924b6d9bbf1f8d5a4b...4cdd1f9031fefce45423de13ad987bbde45e363e,1,1,1,2,1,2005-12-07 08:47:34,2005-12-07 08:47:34
4cdd1f9031fefce45423de13ad987bbde45e363e...045e531a8f2ef75605ec839d66d80abe126647b4,1,5,1,6,1,2005-12-07 09:12:55,2005-12-07 09:12:55
045e531a8f2ef75605ec839d66d80abe126647b4...70dd8acb9a9c0964efcea114e68fea47021fdd37,1,1,1,2,1,2005-12-07 09:13:19,2005-12-07 09:13:19
70dd8acb9a9c0964efcea114e68fea47021fdd37...4df11910716b25bc7720ee25950c6b81734a2674,1,17,14,31,11,2005-12-07 09:51:42,2005-12-07 09:51:42
4df11910716b25bc7720ee25950c6b81734a2674...4e8c09a331ca3917c45dfe646213b604af19db95,1,1,1,2,1,2005-12-07 09:51:59,2005-12-07 09:51:59
4e8c09a331ca3917c45dfe646213b604af19db95...edde3735d06e2581647308966a6b7a77d09a1427,1,22,7,29,10,2005-12-07 15:10:01,2005-12-07 15:10:01
edde3735d06e2581647308966a6b7a77d09a1427...c2488d064bb5225e8d816f9ca8e8ee904bf6eb92,1,3,1,4,3,2005-12-07 15:32:51,2005-12-07 15:32:51
c2488d064bb5225e8d816f9ca8e8ee904bf6eb92...fdeb2fb6166904adc6396c6eeb5b89f6f81b5ef7,1,1,1,2,1,2005-12-07 15:33:08,2005-12-07 15:33:08
fdeb2fb6166904adc6396c6eeb5b89f6f81b5ef7...8240accb65872589f9721dab681708055adc3c1c,1,4,1,5,1,2005-12-19 03:09:02,2005-12-19 03:09:02
8240accb65872589f9721dab681708055adc3c1c...212848746e2cdfab6bd262a99376214b660e61b8,1,1,1,2,1,2005-12-19 03:09:32,2005-12-19 03:09:32
212848746e2cdfab6bd262a99376214b660e61b8...d3a6fd94863b618893f300b98588c47921c9cf86,1,4,4,8,2,2005-12-22 21:58:29,2005-12-22 21:58:29
d3a6fd94863b618893f300b98588c47921c9cf86...df2c37a5a1087b445589e366f6673ded8fdef7f0,1,33,16,49,17,2006-01-09 12:13:39,2006-01-09 12:13:39
df2c37a5a1087b445589e366f6673ded8fdef7f0...f76ddc20159256a1bc6e3ba81910ae94faaf2fa8,1,1,1,2,1,2006-01-09 12:14:00,2006-01-09 12:14:00
f76ddc20159256a1bc6e3ba81910ae94faaf2fa8...2c5c008b462fd5d2e32318077aaa3bc4e67c84fd,1,5,4,9,2,2006-01-17 02:50:20,2006-01-17 02:50:20
2c5c008b462fd5d2e32318077aaa3bc4e67c84fd...2326acfa95ac86a53804ca8eeeb482c2f9265e34,1,1,1,2,1,2006-01-17 02:50:44,2006-01-17 02:50:44
2326acfa95ac86a53804ca8eeeb482c2f9265e34...281bf0cf4e1646237daa15ab6b032d6dd9aee0c9,1,3,3,6,3,2006-05-01 01:40:22,2006-05-01 01:40:22
281bf0cf4e1646237daa15ab6b032d6dd9aee0c9...8872653e5a75a2bfdb0955191575236f199549e6,1,1,1,2,1,2006-05-01 01:40:54,2006-05-01 01:40:54
8872653e5a75a2bfdb0955191575236f199549e6...00cd07943a8868eed41ac9debb03f3bbc1a512c3,1,3,3,6,2,2006-05-22 12:30:47,2006-05-22 12:30:47
00cd07943a8868eed41ac9debb03f3bbc1a512c3...9e4f7d9a5dc724a94ef9452e22b654e510a710e9,1,1,1,2,1,2006-05-22 12:31:09,2006-05-22 12:31:09
9e4f7d9a5dc724a94ef9452e22b654e510a710e9...bfb689bcf33addfe3fdfe8cb214a661c9d6d4b19,1,1,1,2,1,2006-05-30 12:40:10,2006-05-30 12:40:10
bfb689bcf33addfe3fdfe8cb214a661c9d6d4b19...1130ef362fc8d9c3422c23f5d5a833e93d3f5c13,1,1,1,2,1,2006-05-30 12:41:04,2006-05-30 12:41:04
4b825dc642cb6eb9a060e54bf8d69288fbee4904...1db95b00a2d2a001fd91cd860a71c639ea04eb53,1,418,0,418,1,2005-05-09 04:08:39,2005-05-09 04:08:39
1db95b00a2d2a001fd91cd860a71c639ea04eb53...0327d27a18e0d92a75a36a9e57512f940a906d88,1,32,20,52,15,2005-05-10 00:23:42,2005-05-10 00:23:42
0327d27a18e0d92a75a36a9e57512f940a906d88...5ad588de729eb11629f8ff31a248e8abd44e4a9a,1,66,8,74,11,2005-05-10 01:02:55,2005-05-10 01:02:55
5ad588de729eb11629f8ff31a248e8abd44e4a9a...b5721c72b7b69df1dd7417cf8f784aac7a8fee2e,1,64,43,107,18,2005-05-10 12:08:22,2005-05-10 12:08:22
b5721c72b7b69df1dd7417cf8f784aac7a8fee2e...d2610d110ea75e35e62ca492d6f410a62d74dbc9,1,81,34,115,9,2005-05-11 00:45:38,2005-05-11 00:45:38
d2610d110ea75e35e62ca492d6f410a62d74dbc9...e5c2d856444f495d41aa33747ce91beebf04aae9,1,202,53,255,36,2005-05-11 23:44:54,2005-05-11 23:44:54
e5c2d856444f495d41aa33747ce91beebf04aae9...9a40c50c1e05c0658b7a7c68b56d615eb6f170dd,1,53,3,56,11,2005-05-12 23:46:16,2005-05-12 23:46:16
9a40c50c1e05c0658b7a7c68b56d615eb6f170dd...98f350e50124567f90691f6142e1c048c2b4600c,1,197,30,227,28,2005-05-15 05:56:51,2005-05-15 05:56:51
98f350e50124567f90691f6142e1c048c2b4600c...1d10f36d7fc8aa500198d0bccd3ec2dfad3762c0,1,160,89,249,29,2005-05-15 12:55:47,2005-05-15 12:55:47
1d10f36d7fc8aa500198d0bccd3ec2dfad3762c0...276819b35bb457648d91ee431c29ad5af3c20bef,1,3,3,6,3,2005-05-15 12:57:02,2005-05-15 12:57:02
276819b35bb457648d91ee431c29ad5af3c20bef...e47120cb9390a32e3e52f39fb53373d1288c04b8,1,3,3,6,3,2005-05-15 21:49:26,2005-05-15 21:49:26
e47120cb9390a32e3e52f39fb53373d1288c04b8...43bddeb43d86c2a8093aed0217137afd27eb821b,1,56,2,58,5,2005-05-15 23:19:18,2005-05-15 23:19:18
43bddeb43d86c2a8093aed0217137afd27eb821b...0fba86b3a9d3f74304b25c2f724f019831cd90ff,1,63,10,73,15,2005-05-16 23:54:58,2005-05-16 23:54:58
0fba86b3a9d3f74304b25c2f724f019831cd90ff...df3d83b143d0e149767acfebc91b2041f44507ef,1,139,70,209,39,2005-05-17 23:23:07,2005-05-17 23:23:07
df3d83b143d0e149767acfebc91b2041f44507ef...173860663e62b517e51a71cefe9c6d463afb281d,1,66,35,101,34,2005-05-18 22:51:00,2005-05-18 22:51:00
173860663e62b517e51a71cefe9c6d463afb281d...5842215ee93af489c0ed5d29942aafea5d042609,1,41,20,61,17,2005-05-19 10:56:42,2005-05-19 10:56:42
5842215ee93af489c0ed5d29942aafea5d042609...39ad85705cb2e9665a71d55e2d84b6ab8bc40d6d,1,28,3,31,9,2005-05-19 12:35:53,2005-05-19 12:35:53
39ad85705cb2e9665a71d55e2d84b6ab8bc40d6d...887fe3c4748b88b66cf2be88fb6c37ccaa5d37df,1,132,17,149,25,2005-05-21 07:35:37,2005-05-21 07:35:37
887fe3c4748b88b66cf2be88fb6c37ccaa5d37df...cfb4563c836b40dca2e1ef9d4ef3d2b943645edb,1,63,56,119,24,2005-05-31 12:14:42,2005-05-31 12:14:42
cfb4563c836b40dca2e1ef9d4ef3d2b943645edb...d4e95cb6cf0c65ec1e9e40ae967e128d7f0e45a9,1,4,7,11,3,2005-06-01 00:02:13,2005-06-01 00:02:13
d4e95cb6cf0c65ec1e9e40ae967e128d7f0e45a9...c2f6a0225153fcaa92e94613d85ff0c463fabd9a,1,43,11,54,11,2005-06-10 07:54:49,2005-06-10 07:54:49
c2f6a0225153fcaa92e94613d85ff0c463fabd9a...9ccbdfbfbcd26ab751e3edaa9ccd9dff278857c1,1,438,318,756,66,2005-06-16 00:27:23,2005-06-16 00:27:23
9ccbdfbfbcd26ab751e3edaa9ccd9dff278857c1...ea13cba175bc35e1af3d60181b2419ac987f1938,1,13,4,17,9,2005-06-16 10:54:04,2005-06-16 10:54:04
ea13cba175bc35e1af3d60181b2419ac987f1938...84ba73458059ff0a50dbf1a63dff73be63f09795,1,122,30,152,24,2005-06-17 00:12:26,2005-06-17 00:12:26
84ba73458059ff0a50dbf1a63dff73be63f09795...a823a91131616c28f9c3ef5601b09b7e01393204,1,78,58,136,18,2005-06-21 00:01:38,2005-06-21 00:01:38
a823a91131616c28f9c3ef5601b09b7e01393204...2efef4b9b5e65b436eff3b481edc273204453c72,1,12,4,16,2,2005-06-21 00:20:04,2005-06-21 00:20:04
2efef4b9b5e65b436eff3b481edc273204453c72...b490a991761bb3bebdb720957f15dee222a052ab,1,94,94,188,40,2005-06-22 00:25:38,2005-06-22 00:25:38
b490a991761bb3bebdb720957f15dee222a052ab...806ce0971895249d1ebb641b77f1fa870d86d73e,1,6,1,7,2,2005-06-22 08:15:15,2005-06-22 08:15:15
806ce0971895249d1ebb641b77f1fa870d86d73e...6c20ff3423e39f9982436953b6b9103f3f8447f8,1,71,11,82,9,2005-06-22 09:53:32,2005-06-22 09:53:32
4b825dc642cb6eb9a060e54bf8d69288fbee4904...2744b2344dc42fa2a1ddf17f4818975cd48f6d42,3,458,0,458,3,2005-04-12 06:46:50,2005-04-12 06:46:50
2744b2344dc42fa2a1ddf17f4818975cd48f6d42...853916ff7f1a5b34bd2728fe81059e6270bac134,4,63,5,68,9,2005-04-12 08:40:20,2005-04-12 08:40:20
853916ff7f1a5b34bd2728fe81059e6270bac134...e90a4c0ed17b66c302f48ec0a234cac6f27e5eec,0,0,0,0,0,2005-04-18 23:11:32,2005-04-18 23:11:32
e90a4c0ed17b66c302f48ec0a234cac6f27e5eec...61096819949d9c7f6e7032ec949daba35cf57226,1,1,1,2,1,2005-04-19 00:40:32,2005-04-19 00:40:32
61096819949d9c7f6e7032ec949daba35cf57226...ad4e9ce4f9b34c4e6dd941b3244bcf56a3e3d62d,2,53,4,57,11,2005-04-20 15:23:00,2005-04-20 15:23:00
ad4e9ce4f9b34c4e6dd941b3244bcf56a3e3d62d...50eb31d10390f638be2a99f3b064afcd090c08ea,1,5,6,11,4,2005-04-29 21:56:18,2005-04-29 21:56:18
50eb31d10390f638be2a99f3b064afcd090c08ea...8c7b86632c2e54ed98abf922101ee177de75e0eb,4,52,3,55,4,2005-04-30 17:58:41,2005-04-30 17:58:41
8c7b86632c2e54ed98abf922101ee177de75e0eb...62c1f6b4afc68f6448d5ce94b00380405aa101eb,2,15,2,17,7,2005-05-02 04:42:53,2005-05-02 04:42:53
62c1f6b4afc68f6448d5ce94b00380405aa101eb...c9049d41b8d91a198e4642b266e50a506024f0aa,1,3,3,6,1,2005-05-17 16:35:01,2005-05-17 16:35:01
c9049d41b8d91a198e4642b266e50a506024f0aa...6a9853cd4587c9dd16553b429c6d4a9d8111a396,1,1,1,2,1,2005-05-18 00:15:56,2005-05-18 00:15:56
6a9853cd4587c9dd16553b429c6d4a9d8111a396...3e91311ae750af9bf2e3517b1e701288ac3066b9,2,256,1,257,2,2005-05-24 08:07:31,2005-05-24 08:07:31
3e91311ae750af9bf2e3517b1e701288ac3066b9...e69a19f784b3ff19efc8ab765166e877fffb052e,1,9,3,12,4,2005-05-24 16:06:51,2005-05-24 16:06:51
e69a19f784b3ff19efc8ab765166e877fffb052e...e16c03b5495432579b864c279833d522ea463e5f,1,33,1,34,3,2005-05-24 16:36:33,2005-05-24 16:36:33
e16c03b5495432579b864c279833d522ea463e5f...b535a802b2b849f67a57c689eadf3faf87b819b3,1,1,1,2,2,2005-05-24 16:59:55,2005-05-24 16:59:55
b535a802b2b849f67a57c689eadf3faf87b819b3...1db0819a9cb30234678df73a99b82cb96babeca5,1,2,2,4,2,2005-05-24 17:15:42,2005-05-24 17:15:42
1db0819a9cb30234678df73a99b82cb96babeca5...d2b6f7c2fdd4012402b61b0a0a333b8b2011e8bc,1,4,0,4,2,2005-05-24 19:57:12,2005-05-24 19:57:12
d2b6f7c2fdd4012402b61b0a0a333b8b2011e8bc...aff9f97a4fd98e34b0dfde06dacd9dbd82de0b58,1,37,27,64,7,2005-05-31 04:00:09,2005-05-31 04:00:09
aff9f97a4fd98e34b0dfde06dacd9dbd82de0b58...97b865ba7954046072900a95571a308307ed8a00,1,1,4,5,1,2005-06-05 21:09:03,2005-06-05 21:09:03
97b865ba7954046072900a95571a308307ed8a00...f48516746fada1405e476f04bc855bf91412ed46,1,1,1,2,1,2005-06-05 21:12:53,2005-06-05 21:12:53
f48516746fada1405e476f04bc855bf91412ed46...a196d8d4238f582b6441e8e0c56764679c266231,3,11,62,73,12,2005-06-23 16:40:23,2005-06-23 16:40:23
a196d8d4238f582b6441e8e0c56764679c266231...fc7ef1e8ae8c19c06a4fa3d574c13d793e66186a,1,2,1,3,1,2005-06-23 18:00:23,2005-06-23 18:00:23
fc7ef1e8ae8c19c06a4fa3d574c13d793e66186a...c5f7674a97e621bfab5544165098b4860ee6e247,7,5,358,363,5,2005-07-16 17:05:26,2005-07-16 17:05:26
4b825dc642cb6eb9a060e54bf8d69288fbee4904...e83c5163316f89bfbde7d9ab23ca2e25604af290,11,1244,0,1244,11,2005-04-07 22:13:13,2005-04-07 22:13:13
e83c5163316f89bfbde7d9ab23ca2e25604af290...8bc9a0c769ac1df7820f2dbf8f7b7d64835e3c68,8,40,0,40,8,2005-04-07 22:16:10,2005-04-07 22:16:10
8bc9a0c769ac1df7820f2dbf8f7b7d64835e3c68...e497ea2a9b6c378f01d092c210af20cbee762475,1,41,1,42,4,2005-04-08 04:03:28,2005-04-08 04:03:28
e497ea2a9b6c378f01d092c210af20cbee762475...bf0c6e839c692142784caf07b523cd69442e57a5,2,35,10,45,5,2005-04-08 16:16:38,2005-04-08 16:16:38
bf0c6e839c692142784caf07b523cd69442e57a5...19b2860cba5742ab31fd682b80fefefac19be141,8,9,9,18,12,2005-04-08 16:59:28,2005-04-08 16:59:28
19b2860cba5742ab31fd682b80fefefac19be141...24778e335a6450e34257a311d0bf4a12bdb3006c,2,33,9,42,11,2005-04-08 21:42:29,2005-04-08 21:42:29
24778e335a6450e34257a311d0bf4a12bdb3006c...2ade9340262cb87163b5c5c270268175ff3b3c15,2,12,0,12,2,2005-04-08 22:01:15,2005-04-08 22:01:15
2ade9340262cb87163b5c5c270268175ff3b3c15...20222118ae4cbd0a7ba91a7012574cd2f91101ec,1,106,0,106,1,2005-04-08 22:02:42,2005-04-08 22:02:42
20222118ae4cbd0a7ba91a7012574cd2f91101ec...7660a188dfd0c5e52884790bebf5637d24f990d4,1,4,1,5,2,2005-04-08 22:04:51,2005-04-08 22:04:51
7660a188dfd0c5e52884790bebf5637d24f990d4...94261677654d493f6a6219c78aae986a146f92d4,1,1,1,2,1,2005-04-08 22:31:19,2005-04-08 22:31:19
94261677654d493f6a6219c78aae986a146f92d4...1ea34e365b1ea233be332245bc34a8df415a7d61,1,42,11,53,8,2005-04-09 00:11:14,2005-04-09 00:11:14
1ea34e365b1ea233be332245bc34a8df415a7d61...59c1e249808c6ba38194733fa00efddb9e0eb488,3,4,3,7,5,2005-04-09 07:25:22,2005-04-09 07:25:22
59c1e249808c6ba38194733fa00efddb9e0eb488...eb38c22f535c7c973f27b62845c5136c4be0ae49,3,37,36,73,3,2005-04-09 16:26:55,2005-04-09 16:26:55
eb38c22f535c7c973f27b62845c5136c4be0ae49...734aab758cc2b9f5e2ed43375dbfec1b5bfde43b,3,33,32,65,5,2005-04-09 16:48:20,2005-04-09 16:48:20
734aab758cc2b9f5e2ed43375dbfec1b5bfde43b...33db5f4d9027a10e477ccf054b2c1ab94f74c85a,2,145,1,146,3,2005-04-09 16:53:05,2005-04-09 16:53:05
33db5f4d9027a10e477ccf054b2c1ab94f74c85a...f7391ce3bd306c5731bc8206f8a0fa0947ca9474,1,8,10,18,6,2005-04-09 16:59:44,2005-04-09 16:59:44
f7391ce3bd306c5731bc8206f8a0fa0947ca9474...8d3af1d53255ac36494492720ebb83e932b0c0bc,1,3,2,5,2,2005-04-09 18:24:41,2005-04-09 18:24:41
8d3af1d53255ac36494492720ebb83e932b0c0bc...197ee8c97076ee784db9f4b5a9294e86f42d068c,3,75,73,148,9,2005-04-09 19:09:27,2005-04-09 19:09:27
197ee8c97076ee784db9f4b5a9294e86f42d068c...83adac3c57ad8cd2c8d44b525414b949950e316d,2,82,50,132,15,2005-04-09 19:11:25,2005-04-09 19:11:25
83adac3c57ad8cd2c8d44b525414b949950e316d...79517a067a293ddf19867e363f0d9237c7ef8e22,2,2,1,3,2,2005-04-09 19:59:11,2005-04-09 19:59:11
79517a067a293ddf19867e363f0d9237c7ef8e22...9174026cfe69d73ef80b27890615f8b2ef5c265a,2,113,1,114,3,2005-04-09 20:00:54,2005-04-09 20:00:54
9174026cfe69d73ef80b27890615f8b2ef5c265a...16d4d1ba6c1de7a414a6826eb6f363d4b20345bf,1,5,0,5,4,2005-04-09 20:02:30,2005-04-09 20:02:30
16d4d1ba6c1de7a414a6826eb6f363d4b20345bf...f768846e34997fb847c9b875615867d4716d632f,2,24,9,33,8,2005-04-09 22:36:41,2005-04-09 22:36:41
f768846e34997fb847c9b875615867d4716d632f...4e6616ab77ed6a53f857d4b1082c4dc4140f34f5,1,9,0,9,2,2005-04-09 22:47:03,2005-04-09 22:47:03
4e6616ab77ed6a53f857d4b1082c4dc4140f34f5...d6d3f9d0125a7215f3cdc2600b2307ca55b69536,4,70,22,92,16,2005-04-10 00:09:34,2005-04-10 00:09:34
d6d3f9d0125a7215f3cdc2600b2307ca55b69536...121481abf8d752ef871821d4ab9a3747595d86ae,5,70,11,81,13,2005-04-10 18:32:54,2005-04-10 18:32:54
121481abf8d752ef871821d4ab9a3747595d86ae...73134b6d3f700bb9e6c66aa2f099de644c6b8d09,3,67,29,96,28,2005-04-10 21:03:58,2005-04-10 21:03:58
73134b6d3f700bb9e6c66aa2f099de644c6b8d09...eeb7991695b0944e4e8d6474b8f7cd2da8830b20,1,23,24,47,14,2005-04-10 22:08:02,2005-04-10 22:08:02
eeb7991695b0944e4e8d6474b8f7cd2da8830b20...262e82b4a7ec708d8c9e641421509b16b8ec69f1,1,53,6,59,4,2005-04-11 04:49:26,2005-04-11 04:49:26
262e82b4a7ec708d8c9e641421509b16b8ec69f1...76e7f4ec485f24b167b76db046dc2ca4562debd4,1,7,7,14,6,2005-04-11 05:06:50,2005-04-11 05:06:50
76e7f4ec485f24b167b76db046dc2ca4562debd4...8ba0bbb237af3de317f8d009302500e9a7e2b3c3,1,100,4,104,7,2005-04-11 06:13:09,2005-04-11 06:13:09
8ba0bbb237af3de317f8d009302500e9a7e2b3c3...f1257f3a33c49ea4f3fd43c7aed97d8a270190dd,1,1,0,1,1,2005-04-11 06:22:59,2005-04-11 06:22:59
f1257f3a33c49ea4f3fd43c7aed97d8a270190dd...91af81a98ea5c5594c67a63abc933250e05c13c6,1,1,1,2,1,2005-04-11 06:33:52,2005-04-11 06:33:52
91af81a98ea5c5594c67a63abc933250e05c13c6...bf16c71e2f9fc9ca44273f7f4637dce194a49cce,2,4,4,8,2,2005-04-11 15:37:17,2005-04-11 15:37:17
bf16c71e2f9fc9ca44273f7f4637dce194a49cce...711cf3a026a539f68ab647e012f145a03e12a5e7,1,99,19,118,8,2005-04-11 16:39:21,2005-04-11 16:39:21
711cf3a026a539f68ab647e012f145a03e12a5e7...075b845a8572006d8c80f8500a0652166a0fba00,1,361,0,361,1,2005-04-11 17:18:16,2005-04-11 17:18:16
075b845a8572006d8c80f8500a0652166a0fba00...cfd88e2b7a1a1d2b0f22173a5cc128adce7391e3,2,4,4,8,4,2005-04-11 17:24:41,2005-04-11 17:24:41
cfd88e2b7a1a1d2b0f22173a5cc128adce7391e3...32d197f18d0be74a4d82e8c42513d83423091a22,1,6,5,11,6,2005-04-11 18:33:58,2005-04-11 18:33:58
32d197f18d0be74a4d82e8c42513d83423091a22...0dcad32ae239906217065b6a2b0fca41962e5d57,1,3,1,4,3,2005-04-11 20:53:49,2005-04-11 20:53:49
0dcad32ae239906217065b6a2b0fca41962e5d57...84fe972055398ba0790ac0a8f159c79c83efcef4,2,142,1,143,3,2005-04-11 20:55:10,2005-04-11 20:55:10
84fe972055398ba0790ac0a8f159c79c83efcef4...9614b8dcf8f295b6063d2a85bf8ec53960b072b6,2,47,39,86,11,2005-04-11 22:39:26,2005-04-11 22:39:26
9614b8dcf8f295b6063d2a85bf8ec53960b072b6...4bb04f2190d526f8917663f0be62d8026e1ed100,6,12,12,24,11,2005-04-11 22:47:57,2005-04-11 22:47:57
4bb04f2190d526f8917663f0be62d8026e1ed100...97d9c3cdeafb9f48075987c76373a71e6874c6eb,1,68,44,112,22,2005-04-11 23:42:13,2005-04-11 23:42:13
97d9c3cdeafb9f48075987c76373a71e6874c6eb...28258afe912303f717fcdccaca124c1ae3e8e004,1,99,13,112,12,2005-04-12 00:23:58,2005-04-12 00:23:58
28258afe912303f717fcdccaca124c1ae3e8e004...771364af0ebc34ba968590eeebf0b78ee148f0a5,1,2,2,4,2,2005-04-12 00:40:58,2005-04-12 00:40:58
771364af0ebc34ba968590eeebf0b78ee148f0a5...3607c27f5fa144992c7962bb8817b950e033fe94,1,8,4,12,5,2005-04-12 01:02:00,2005-04-12 01:02:00
3607c27f5fa144992c7962bb8817b950e033fe94...8695c8bfe181677ca112502c1eef67930d84a75d,2,168,1,169,3,2005-04-12 01:55:38,2005-04-12 01:55:38
8695c8bfe181677ca112502c1eef67930d84a75d...74b46e32cb3907a4a062a0f11de5773054b7c71a,2,52,1,53,3,2005-04-12 07:23:14,2005-04-12 07:23:14
74b46e32cb3907a4a062a0f11de5773054b7c71a...5e76011c0dd9e3f7f6eb766e8c28dd8fcd4adcf9,1,1,3,4,2,2005-04-12 09:01:12,2005-04-12 09:01:12
5e76011c0dd9e3f7f6eb766e8c28dd8fcd4adcf9...c0fb976aa779c508314305f309f240fa6bfc3128,1,45,4,49,7,2005-04-12 09:04:44,2005-04-12 09:04:44
c0fb976aa779c508314305f309f240fa6bfc3128...727ff277878490f50a3acefdd1ce6a94b3c9f4c2,1,8,0,8,3,2005-04-12 19:35:11,2005-04-12 19:35:11
727ff277878490f50a3acefdd1ce6a94b3c9f4c2...40e88b95cdce955059e94d288e8ebdb7d1e9fa88,1,74,7,81,9,2005-04-12 20:40:03,2005-04-12 20:40:03
40e88b95cdce955059e94d288e8ebdb7d1e9fa88...29d76d4b05bc537ac59fd1e6f849ab3386c01502,1,7,5,12,2,2005-04-12 21:17:28,2005-04-12 21:17:28
29d76d4b05bc537ac59fd1e6f849ab3386c01502...3d8c7a57903f91decd5e6c531974a1af1aaa3c97,1,6,6,12,5,2005-04-12 21:37:42,2005-04-12 21:37:42
3d8c7a57903f91decd5e6c531974a1af1aaa3c97...e2e5e98a40d6ed04b7acf791cc2243ff32923db3,1,13,1,14,4,2005-04-13 08:40:09,2005-04-13 08:40:09
e2e5e98a40d6ed04b7acf791cc2243ff32923db3...c57a3a91f1cc0d037e7b7992cbfa6f4213dcf37e,1,1,1,2,1,2005-04-13 08:46:35,2005-04-13 08:46:35
c57a3a91f1cc0d037e7b7992cbfa6f4213dcf37e...7912c07037cf704394e9bcb7cb24c05ee03aa921,2,58,2,60,4,2005-04-13 09:02:34,2005-04-13 09:02:34
7912c07037cf704394e9bcb7cb24c05ee03aa921...5c2a7fbc362e4227ced84c32c3fdc9682d085962,2,23,2,25,3,2005-04-13 09:14:06,2005-04-13 09:14:06
5c2a7fbc362e4227ced84c32c3fdc9682d085962...bdd4da595a265a091a859754a22688f7351cddee,2,20,4,24,4,2005-04-13 09:20:38,2005-04-13 09:20:38
bdd4da595a265a091a859754a22688f7351cddee...2de381f919829aec1e35d6c7cc33519295dcd053,13,77,69,146,47,2005-04-13 09:28:48,2005-04-13 09:28:48
2de381f919829aec1e35d6c7cc33519295dcd053...31cedfb95e7dda1e43aead0107d32f90f85f2160,1,1,1,2,1,2005-04-13 09:31:06,2005-04-12 15:04:17
31cedfb95e7dda1e43aead0107d32f90f85f2160...42d545e8ff33f478a4b7b99562ab073d8820b334,1,1,1,2,1,2005-04-13 09:32:13,2005-04-12 15:08:12
42d545e8ff33f478a4b7b99562ab073d8820b334...aebb2679085d2ecc4d1c943ecfb2e87c699f00d0,7,9,9,18,9,2005-04-13 09:35:04,2005-04-12 18:36:26
aebb2679085d2ecc4d1c943ecfb2e87c699f00d0...5ade862839133563d588627f17cde7d4c4f0f6f2,1,4,0,4,4,2005-04-13 09:38:44,2005-04-13 09:38:44
5ade862839133563d588627f17cde7d4c4f0f6f2...35bb47855d8a102deda07cfc1732095f45318c02,1,1,1,2,1,2005-04-13 09:39:33,2005-04-13 09:39:33
35bb47855d8a102deda07cfc1732095f45318c02...33b238d128a4f7ada055eac99ae8f9546003e7d0,1,6,2,8,2,2005-04-13 09:42:04,2005-04-13 09:42:04
33b238d128a4f7ada055eac99ae8f9546003e7d0...d9839e030592292267e6317fba308383e0012001,1,133,76,209,20,2005-04-13 16:57:30,2005-04-13 16:57:30
d9839e030592292267e6317fba308383e0012001...2845dbe4a451b20f963f872c3914b9184142ff3f,1,3,0,3,1,2005-04-13 19:35:08,2005-04-13 19:35:08
2845dbe4a451b20f963f872c3914b9184142ff3f...bcee6fd8e7164aa7a4170f109af8347d88f0175e,1,19,14,33,9,2005-04-13 23:42:09,2005-04-13 23:42:09
bcee6fd8e7164aa7a4170f109af8347d88f0175e...f864ba7448564d06e8076d1b6a66eca00a337d8c,1,28,11,39,4,2005-04-14 00:47:12,2005-04-14 00:47:12
f864ba7448564d06e8076d1b6a66eca00a337d8c...458754a9fe2c2e889e38d1f4f53d5d457eba6faa,3,121,202,323,8,2005-04-14 04:37:59,2005-04-14 04:37:59
458754a9fe2c2e889e38d1f4f53d5d457eba6faa...33deb63a36f523c513cf29598d9c05fe78a23cac,2,132,1,133,3,2005-04-14 08:37:23,2005-04-14 08:37:23
33deb63a36f523c513cf29598d9c05fe78a23cac...aa1c48df8172f844455cc12f25aa49be8ffdd828,1,90,18,108,14,2005-04-15 15:37:05,2005-04-15 15:37:05
aa1c48df8172f844455cc12f25aa49be8ffdd828...27de946d0ee70fad497253bbaab76d2fa7b1c77c,2,165,6,171,12,2005-04-15 15:39:57,2005-04-15 15:39:57
27de946d0ee70fad497253bbaab76d2fa7b1c77c...ccc4feb579265266d0a4a73c0c9443ecc0c26ce3,7,64,60,124,30,2005-04-15 17:44:27,2005-04-15 17:44:27
ccc4feb579265266d0a4a73c0c9443ecc0c26ce3...9945d9805130fdb752a91fcfae7084b219b9dec3,1,35,0,35,2,2005-04-15 18:08:33,2005-04-15 18:08:33
9945d9805130fdb752a91fcfae7084b219b9dec3...b83c83457eb647a54fee7dd8a89f1787226c1be7,1,9,3,12,5,2005-04-15 18:11:01,2005-04-15 18:11:01
b83c83457eb647a54fee7dd8a89f1787226c1be7...ca2a0798656aa1219c6ff4fa66cd0f3340ddd5be,1,12,5,17,5,2005-04-15 22:08:09,2005-04-15 22:08:09
ca2a0798656aa1219c6ff4fa66cd0f3340ddd5be...6cbd72f8d5d794112eab68f7e7222c9a0c5d6587,1,10,3,13,4,2005-04-15 22:11:57,2005-04-15 22:11:57
6cbd72f8d5d794112eab68f7e7222c9a0c5d6587...d07f651c25ce3980e9519872f772af12a12c8d26,1,20,3,23,6,2005-04-16 02:20:42,2005-04-16 02:20:42
d07f651c25ce3980e9519872f772af12a12c8d26...13e897e58072678cdae3ec1db51cc91110dc559d,1,1,1,2,1,2005-04-16 04:42:34,2005-04-16 04:42:34
13e897e58072678cdae3ec1db51cc91110dc559d...f5cabd13d814bb5c547a13af03bcc42122531141,3,9,5,14,6,2005-04-16 04:45:38,2005-04-16 04:45:38
f5cabd13d814bb5c547a13af03bcc42122531141...c347ea5d6fc6bae6b6ea3196013c4df7ec4406a8,1,18,0,18,2,2005-04-16 05:04:54,2005-04-16 05:04:54
c347ea5d6fc6bae6b6ea3196013c4df7ec4406a8...95fd5bf82ae28da47dcbf8e6e4570e64d71dc532,2,13,6,19,6,2005-04-16 05:51:44,2005-04-16 05:51:44
95fd5bf82ae28da47dcbf8e6e4570e64d71dc532...d99082e0e3436f5fcf259aa1a4189473f6bb5ce3,1,53,6,59,8,2005-04-16 05:53:45,2005-04-16 05:53:45
d99082e0e3436f5fcf259aa1a4189473f6bb5ce3...fcf712e60e3221a7971cb2ad89e61c565172f524,1,1,1,2,1,2005-04-16 15:30:20,2005-04-16 15:30:20
fcf712e60e3221a7971cb2ad89e61c565172f524...aee461985f52857fa04999b2a988986dd8c84aba,2,25,9,34,9,2005-04-16 15:33:23,2005-04-16 15:33:23
aee461985f52857fa04999b2a988986dd8c84aba...43f91266a493c4888b4ff2a7997ccc4a381e7238,1,53,17,70,7,2005-04-16 16:11:49,2005-04-16 16:11:49
43f91266a493c4888b4ff2a7997ccc4a381e7238...7b937ca33142ff5ecc655f2be61678a512352122,1,31,5,36,4,2005-04-16 19:05:45,2005-04-16 19:05:45
7b937ca33142ff5ecc655f2be61678a512352122...2fbdd1317480d2f14756d94e41a8eb07442d4841,2,1,149,150,3,2005-04-16 19:24:12,2005-04-16 19:24:12
2fbdd1317480d2f14756d94e41a8eb07442d4841...eec8c633c117c83a9fd2be7054b169d3cee5806d,1,10,1,11,4,2005-04-16 19:43:32,2005-04-16 19:43:32
eec8c633c117c83a9fd2be7054b169d3cee5806d...0f2303f71957ec68c92487f185435fbec6bd1c79,1,15,26,41,7,2005-04-16 20:57:39,2005-04-16 20:57:39
0f2303f71957ec68c92487f185435fbec6bd1c79...b8f80925e3cdf229f03245f2ebb02323ddd98118,1,30,8,38,6,2005-04-17 04:29:45,2005-04-17 04:29:45
b8f80925e3cdf229f03245f2ebb02323ddd98118...d94c6128e6df3161b111e7af73a7ef782eb4b63e,1,19,9,28,6,2005-04-17 04:29:45,2005-04-17 04:29:45
d94c6128e6df3161b111e7af73a7ef782eb4b63e...9bd94cafdf104e613d7609401e60711cd08e209c,1,60,4,64,5,2005-04-17 04:29:45,2005-04-17 04:29:45
9bd94cafdf104e613d7609401e60711cd08e209c...b70c8942d3fab4dff86461919a8c18eb3d020cea,1,4,4,8,2,2005-04-17 04:29:45,2005-04-17 04:29:45
b70c8942d3fab4dff86461919a8c18eb3d020cea...d2522a6528a1212933e71c592950097bcfe64e7d,1,3,4,7,4,2005-04-17 04:29:45,2005-04-17 04:29:45
d2522a6528a1212933e71c592950097bcfe64e7d...9fec8b26eff58e1f595e8619abf1e42c07645ff8,1,13,0,13,1,2005-04-17 04:29:45,2005-04-17 04:29:45
9fec8b26eff58e1f595e8619abf1e42c07645ff8...e44794706eeb57f2ee38ed1604821aa38b8ad9d2,5,21,6,27,8,2005-04-17 05:26:31,2005-04-17 05:26:31
e44794706eeb57f2ee38ed1604821aa38b8ad9d2...8f41523fc1a8cd127ff39fa111b3b5bb5105cc84,1,0,1,1,1,2005-04-17 16:53:35,2005-04-17 16:53:35
8f41523fc1a8cd127ff39fa111b3b5bb5105cc84...c4e3cca1f71d34e69bdbfa0de0144ddb00f75505,1,3,1,4,1,2005-04-17 16:53:35,2005-04-17 16:53:35
c4e3cca1f71d34e69bdbfa0de0144ddb00f75505...fa06d442c6c5113fcff9991f349157bdb0c4b989,1,1,3,4,2,2005-04-17 16:55:36,2005-04-17 16:55:36
fa06d442c6c5113fcff9991f349157bdb0c4b989...a38800fde24a44b12a9ed14852339466de1cb9c9,1,9,2,11,1,2005-04-17 17:02:21,2005-04-17 17:02:21
a38800fde24a44b12a9ed14852339466de1cb9c9...c747fc6facdbbde4386418cfe6ad7e231a1b4eaf,1,6,9,15,9,2005-04-17 17:02:22,2005-04-17 17:02:22
c747fc6facdbbde4386418cfe6ad7e231a1b4eaf...e8871e88adca0637eb0299a41d85400beac928bd,1,1,1,2,1,2005-04-17 17:04:48,2005-04-17 17:04:48
e8871e88adca0637eb0299a41d85400beac928bd...7223a88ce7795f38f47812ebca4433e7f8b82a30,1,2,4,6,1,2005-04-17 17:55:12,2005-04-17 17:55:12
7223a88ce7795f38f47812ebca4433e7f8b82a30...89d21f4b649d5d31b18da3220608cb349f29e650,2,40,79,119,2,2005-04-17 18:39:18,2005-04-17 18:39:18
89d21f4b649d5d31b18da3220608cb349f29e650...01796b0e9180f92ed23aa8dc2261857b9dec7d13,2,11,7,18,7,2005-04-17 19:07:00,2005-04-17 19:07:00
01796b0e9180f92ed23aa8dc2261857b9dec7d13...15000d78996db926d18dd68e6f5f5770de09cad3,1,1,16,17,2,2005-04-17 19:09:20,2005-04-17 19:09:20
15000d78996db926d18dd68e6f5f5770de09cad3...6683463ed6b2da9eed309c305806f9393d1ae728,2,61,1,62,3,2005-04-17 19:18:17,2005-04-17 19:18:17
227f78114752eee2e8ae3368089716d73d32dd8b...add00a3229ba4ada0cb47a447fdc483658df78e9,1,8,0,8,1,2009-10-02 15:51:25,2009-10-02 15:51:25
227f78114752eee2e8ae3368089716d73d32dd8b...8ac5eca1eaa88bd5b998e91531937404bc6425c4,1,1,0,1,1,2009-09-30 12:29:42,2009-09-30 12:29:42
b25b20656dceff6145a1286f10618ab25d717537...9226c03c3279d66e2dea21a7a3e9f187e5ee9b9a,1,5,5,10,5,2007-05-28 17:23:19,2007-05-28 17:23:19
9226c03c3279d66e2dea21a7a3e9f187e5ee9b9a...cfeb59be256bf9cd2853ed04d4af056b2f0eff31,1,2,2,4,1,2007-05-28 17:24:57,2007-05-28 17:24:57
b25b20656dceff6145a1286f10618ab25d717537...4addad229169ece62f36c6c17cc15bdf532a60bc,1,18,14,32,14,2007-05-28 14:45:26,2007-05-23 21:49:35
4addad229169ece62f36c6c17cc15bdf532a60bc...6326aa58662932212678a25c6f482a8da4195ac9,1,153,109,262,62,2007-05-28 15:50:04,2007-05-23 21:49:35
6326aa58662932212678a25c6f482a8da4195ac9...bb6e09b27afeaae780dabfda7a07d59fc7efc4cf,1,134,90,224,40,2007-05-30 16:44:15,2007-05-23 21:49:35
0960f7d6db89fa8418486cd088759e54dd51d54e...663e7cf81d970d8320147d4d58dce37aaebfb09b,1,7,3,10,2,2007-02-12 20:37:50,2007-02-12 20:37:50
663e7cf81d970d8320147d4d58dce37aaebfb09b...7e81d4eead48c189d52406379150b09fd4096987,3,6,6,12,5,2007-02-12 21:12:04,2007-02-12 21:12:04
7e81d4eead48c189d52406379150b09fd4096987...5d643cd3cebf5eab44d99c5c7e54a1dbef28cba6,1,5,1,6,2,2007-02-12 21:14:44,2007-02-12 21:14:44
5d643cd3cebf5eab44d99c5c7e54a1dbef28cba6...6a6459bc8f1aa9e83b5b46f7c40454891bf5e92a,1,3,5,8,4,2007-02-12 21:38:29,2007-02-12 21:38:29
6a6459bc8f1aa9e83b5b46f7c40454891bf5e92a...07d082bf5b4bc353648ffd207fe2fbd9e57e4386,1,37,4,41,3,2007-02-12 22:05:10,2007-02-12 22:05:10
07d082bf5b4bc353648ffd207fe2fbd9e57e4386...fdf6cfc4266d1e88e74c09e9166fa0b5c9ad29cb,1,1,1,2,1,2007-02-12 22:45:21,2007-02-12 22:45:21
0a8f4f0020cb35095005852c0797f0b90e9ebb74...41292ddd37202ff6dce34986c87a6000c5d3fbfa,1,1,1,2,1,2006-06-10 19:41:54,2006-06-10 19:41:54
6c20ff3423e39f9982436953b6b9103f3f8447f8...c8dfbcf995f3a6a13d3c6db1411f7f5fa42d2dcb,1,180,86,266,43,2005-06-25 05:39:21,2005-06-25 05:39:21
c8dfbcf995f3a6a13d3c6db1411f7f5fa42d2dcb...ee3dc72e30a7e9b4eed301bd4fd21b306f811e36,1,8,0,8,2,2005-06-25 06:37:13,2005-06-25 06:37:13
ee3dc72e30a7e9b4eed301bd4fd21b306f811e36...e2ede2b9f59e1bb95a4a862daf57cb47d97d0d8c,1,11,1,12,2,2005-06-27 00:37:11,2005-06-27 00:37:11
e2ede2b9f59e1bb95a4a862daf57cb47d97d0d8c...8a0a74ad7764db655f07c464ce931cc233f550b5,1,17,10,27,8,2005-06-27 03:38:29,2005-06-27 03:38:29
8a0a74ad7764db655f07c464ce931cc233f550b5...74daedb62cd2aa0420ee7fac5180246508867679,1,87,0,87,4,2005-06-27 09:27:32,2005-06-27 09:27:32
74daedb62cd2aa0420ee7fac5180246508867679...7e952e797c98fca1853463247bcaf3b8d58bc36c,1,7,2,9,3,2005-06-27 10:04:26,2005-06-27 10:04:26
7e952e797c98fca1853463247bcaf3b8d58bc36c...bdbfbe3dc943a2e76dcd4d78ce1df74966af4e71,1,140,43,183,7,2005-06-27 12:56:40,2005-06-27 12:56:40
98e031f0bb6e857c684e6db24d03d22cfc1a532a...60ea0fdd7de001405fcc7591beb18a66a1f0dd09,1,2,0,2,1,2005-07-16 17:27:19,2005-07-16 17:27:19
60ea0fdd7de001405fcc7591beb18a66a1f0dd09...9c2b1c0cd89d8cc8a3882e85c6b6535f282bf59f,1,1,1,2,1,2005-07-16 17:31:38,2005-07-16 17:31:38
9c2b1c0cd89d8cc8a3882e85c6b6535f282bf59f...d089391c0058f500768bb68f3bee7af78975de58,1,28,10,38,9,2005-07-16 20:26:33,2005-07-16 20:26:33
d089391c0058f500768bb68f3bee7af78975de58...d1c133f5d48a45ad8ba29c4cb2c2a824f4f600fa,5,67,109,176,17,2005-07-16 20:55:50,2005-07-16 20:55:50
6683463ed6b2da9eed309c305806f9393d1ae728...6eb8ae00d4bceaf660a07d8bc5ab8d6ddccbe1af,4,87,0,87,4,2005-04-18 18:39:48,2005-04-18 18:39:48
6eb8ae00d4bceaf660a07d8bc5ab8d6ddccbe1af...175785e5ff7395be8a458694a7df0511ac14e948,4,272,0,272,4,2005-04-18 18:39:48,2005-04-18 18:39:48
175785e5ff7395be8a458694a7df0511ac14e948...5873b67eef184d771359c187889c6e5c412b9d43,2,38,48,86,14,2005-04-18 18:39:48,2005-04-18 18:39:48
5873b67eef184d771359c187889c6e5c412b9d43...ff5ebe39b0ca5cbdcbe11f092b5b43dbeada820e,2,38,72,110,15,2005-04-18 18:39:48,2005-04-18 18:39:48
ff5ebe39b0ca5cbdcbe11f092b5b43dbeada820e...b5039db6d25ae25f1cb2db541ed13602784fafc3,2,82,44,126,12,2005-04-18 18:39:48,2005-04-18 18:39:48
6683463ed6b2da9eed309c305806f9393d1ae728...7d60ad7cc948b1b9e1066a3e740c91651bdc7e8d,2,4,7,11,4,2005-04-17 19:40:18,2005-04-17 19:40:18
7d60ad7cc948b1b9e1066a3e740c91651bdc7e8d...d0d7cbe730c31a6e1d12bd68975ff73c60f1de6c,1,14,0,14,3,2005-04-17 22:26:13,2005-04-17 22:26:13
d0d7cbe730c31a6e1d12bd68975ff73c60f1de6c...08ca0b04ba80b7127dd19b6d17c548eaca057ab3,3,29,23,52,24,2005-04-17 23:19:32,2005-04-17 23:19:32
08ca0b04ba80b7127dd19b6d17c548eaca057ab3...5e5128ed1cf4223fd32a36f858263d361ade5310,1,15,0,15,1,2005-04-17 23:52:54,2005-04-17 23:52:54
5e5128ed1cf4223fd32a36f858263d361ade5310...d9f98eebcd31e123e859a4b8c6506bf3f3c4bad6,1,2,0,2,1,2005-04-18 01:39:14,2005-04-18 01:39:14
d9f98eebcd31e123e859a4b8c6506bf3f3c4bad6...74b2428f5573b1f68ce717706296ae7d1832cd65,1,3,3,6,2,2005-04-18 02:12:14,2005-04-18 02:12:14
74b2428f5573b1f68ce717706296ae7d1832cd65...75118b13bc8187c629886b108929f996c47daf01,2,131,1,132,3,2005-04-18 02:52:54,2005-04-18 02:52:54
75118b13bc8187c629886b108929f996c47daf01...64982f75109dfc42967773f35301f2dcd30a1a9f,1,2,2,4,1,2005-04-18 03:31:40,2005-04-18 03:31:40
64982f75109dfc42967773f35301f2dcd30a1a9f...6ad6d3d36c5924c8ff502ebbb6a6216df01e7efb,1,401,109,510,15,2005-04-18 04:52:23,2005-04-18 04:52:23
6ad6d3d36c5924c8ff502ebbb6a6216df01e7efb...1bc992acacf5961e65d9fdddeb8561284e708c74,1,11,2,13,2,2005-04-18 17:42:48,2005-04-18 17:42:48
1bc992acacf5961e65d9fdddeb8561284e708c74...a4b7dbef4ef53f4fffbda0a6f5eada4c377e3fc5,1,0,1,1,1,2005-04-18 18:44:31,2005-04-18 18:44:31
39ee6ecf7ed8b3c6a5c8ed24f825211f3b920f76...6f2012cdc021f6b47ed19bc7fe64159ce9eeda8a,3,5,9,14,6,2009-10-02 20:08:58,2009-10-02 19:22:15
6f2012cdc021f6b47ed19bc7fe64159ce9eeda8a...2275f7077d5ea2bb9201599dec0dd8f2a5de2e40,1,3,1,4,3,2009-10-02 20:09:48,2009-10-02 20:09:09
2275f7077d5ea2bb9201599dec0dd8f2a5de2e40...e31d1e2f30c943473de7a23bbbcd2dcea698e312,1,3,2,5,1,2009-10-02 22:23:54,2009-10-02 22:23:54
e31d1e2f30c943473de7a23bbbcd2dcea698e312...c567d9e59fceb93d7334a1414d0a2a9d6f4913de,2,14,0,14,2,2009-11-04 19:50:33,2009-11-04 19:50:33
c567d9e59fceb93d7334a1414d0a2a9d6f4913de...d8b2c0da177ddfc2bc8d1e47278aa1c240d63034,1,339,0,339,1,2009-11-15 17:13:19,2009-11-15 17:13:08
d8b2c0da177ddfc2bc8d1e47278aa1c240d63034...0d31de303f9e8e28cc1649dbf41c1cc635bae2d8,1,20,0,20,2,2009-11-15 17:18:13,2009-11-14 01:29:39
0d31de303f9e8e28cc1649dbf41c1cc635bae2d8...d20ac24c2fe860dba99b40d76fe371a323e9918d,1,3,1,4,2,2009-11-15 17:18:15,2009-11-14 01:29:40
d20ac24c2fe860dba99b40d76fe371a323e9918d...d344532afd3d99c9cdd6d7cfc46bd92ff7def4e8,1,4,0,4,2,2009-11-21 00:43:47,2009-11-21 00:43:47
5e926eed9fb8746e762bdb147f35d44c7a65321e...b86f73782eafd1c61bb706ec5ca3d1ec548d82f5,1,24,29,53,16,2007-05-30 16:58:19,2007-05-23 21:49:35
b86f73782eafd1c61bb706ec5ca3d1ec548d82f5...6a49f8e2e04317175060576d85a5d2062ebb43a4,1,63,26,89,14,2007-05-30 19:21:46,2007-05-23 21:49:35
6a49f8e2e04317175060576d85a5d2062ebb43a4...9320da8dd492c13f1d32b7fde8c9e60bdbd10217,1,2,2,4,2,2007-05-30 19:22:57,2007-05-23 21:49:35
9320da8dd492c13f1d32b7fde8c9e60bdbd10217...183b8ef89be041cd50803427cfc46fe1afed17bb,1,10,5,15,3,2007-05-30 19:35:32,2007-05-23 21:49:35
183b8ef89be041cd50803427cfc46fe1afed17bb...a3287be5bc40c1aa036eb5422db5a6a087d1736e,1,1,1,2,1,2007-05-30 19:38:32,2007-05-23 21:49:35
a3287be5bc40c1aa036eb5422db5a6a087d1736e...96e07dd23c570fe5e65e619c0f1e3c87be2a8352,1,21,14,35,6,2007-05-30 19:57:59,2007-05-23 21:49:35
96e07dd23c570fe5e65e619c0f1e3c87be2a8352...982bb8a30376d0024a1794426e6e2291a7a21294,1,13,8,21,6,2007-05-30 20:33:18,2007-05-23 21:49:35
982bb8a30376d0024a1794426e6e2291a7a21294...f2eda79f6967363f9377ef3b137a35d0c86aca2c,1,3,0,3,1,2007-05-30 21:50:41,2007-05-23 21:49:35
f2eda79f6967363f9377ef3b137a35d0c86aca2c...d2c6dd30eff648aef30d003ef327ab9415f86db0,1,21,35,56,6,2007-05-31 14:29:25,2007-05-23 21:49:35
d2c6dd30eff648aef30d003ef327ab9415f86db0...86dff6b6762149d5f3d4b44bb57f58a8399a33ee,1,32,22,54,20,2007-05-31 15:38:30,2007-05-23 21:49:35
86dff6b6762149d5f3d4b44bb57f58a8399a33ee...b17f88b5445210c2223b0642917c43581c767761,1,0,1,1,1,2007-05-31 15:40:24,2007-05-23 21:49:35
b17f88b5445210c2223b0642917c43581c767761...b1ce94472684957cd5aba759f495a889f154a9a2,1,18,10,28,10,2007-05-31 17:21:58,2007-05-23 21:49:35
b1ce94472684957cd5aba759f495a889f154a9a2...7530a40ce2006082580865f4db6d32b956ca8dc0,1,3,2,5,2,2007-06-05 23:29:59,2007-05-23 21:49:35
fdf6cfc4266d1e88e74c09e9166fa0b5c9ad29cb...022fef30facd6865d99b0cfceead7de3d60fe7de,1,1,1,2,1,2007-02-13 15:35:58,2007-02-13 15:26:16
b4d2b04c9b6dc42c0bcf0513b9d8f731ec26db82...ea5e370aa9203f999dd8bcd4a9cd29452f1c9181,3,77,14,91,4,2007-02-12 17:17:31,2007-02-12 09:08:43
ea5e370aa9203f999dd8bcd4a9cd29452f1c9181...d63ea115948a892f94451677c322c5a6f233adc6,1,1,3,4,2,2007-02-12 17:19:45,2007-02-12 14:17:11
41292ddd37202ff6dce34986c87a6000c5d3fbfa...c7162c1db6fef6527eafb8829d60cf26b02b0108,1,5,5,10,5,2006-06-16 10:04:19,2006-05-24 01:34:24
c7162c1db6fef6527eafb8829d60cf26b02b0108...8a97e368882afbc2bdc030214339bed54ed6545c,1,13,4,17,6,2006-06-16 10:04:19,2006-05-28 22:23:56
8a97e368882afbc2bdc030214339bed54ed6545c...4a393f2b53f0997f79d47793d4c774fa0072887c,1,11,4,15,4,2006-06-16 10:04:19,2006-06-10 06:27:01
4a393f2b53f0997f79d47793d4c774fa0072887c...ce475dfcb5021339d8545a020e8697dd35a1bbea,1,23,11,34,10,2006-06-16 10:04:19,2006-06-02 22:16:41
ce475dfcb5021339d8545a020e8697dd35a1bbea...b63af9b340dd831840c70103c9f609940a910031,1,9,2,11,2,2006-06-16 10:04:19,2006-06-03 09:56:33
b63af9b340dd831840c70103c9f609940a910031...162f41292167a800432fc6bbacfcd9f93a90b0c8,1,9,2,11,3,2006-06-16 10:04:19,2006-05-15 03:00:00
162f41292167a800432fc6bbacfcd9f93a90b0c8...bf78b1d89b29f8524ccfbd7042fa277277e316ff,1,14,1,15,4,2006-06-16 10:04:20,2006-04-28 10:42:38
bf78b1d89b29f8524ccfbd7042fa277277e316ff...098749d9bee6694abc8a0991996ff94b607abc7f,1,9,2,11,5,2006-06-16 10:04:20,2006-04-28 10:51:16
098749d9bee6694abc8a0991996ff94b607abc7f...6dfbe5163e26e3e1126c9b08c3cb38195e92a82c,1,8,1,9,1,2006-06-16 10:04:20,2006-05-04 05:54:00
6dfbe5163e26e3e1126c9b08c3cb38195e92a82c...883d0a78d2a28add079f809ffb8dd077f4a766d8,2,85,16,101,18,2006-06-16 10:04:20,2006-05-24 08:22:07
883d0a78d2a28add079f809ffb8dd077f4a766d8...b8c92caddac61e556254bf93c3a4bd744de94320,1,46,36,82,16,2006-06-16 10:04:20,2006-05-24 08:40:37
b8c92caddac61e556254bf93c3a4bd744de94320...dc5869c00d9aafbddcc11b93b5a0a7fcdeb755ea,1,17,1,18,5,2006-06-16 10:04:20,2006-05-24 09:07:32
dc5869c00d9aafbddcc11b93b5a0a7fcdeb755ea...f8ab6b732f0a2cead5089aea2ce0c3c3aa97cafe,1,8,2,10,3,2006-06-16 10:04:20,2006-05-31 22:49:56
f8ab6b732f0a2cead5089aea2ce0c3c3aa97cafe...9d55b41aadd65b1ebfbbe1336db00168c2dd01c5,1,424,5,429,14,2006-06-16 10:04:20,2006-06-12 22:53:13
9d55b41aadd65b1ebfbbe1336db00168c2dd01c5...7a97de4e19757b5576f32ce67d90cb792dbb893b,1,13,0,13,2,2006-06-16 10:04:20,2006-06-12 12:57:02
7a97de4e19757b5576f32ce67d90cb792dbb893b...79bb8d88fc61b03a80fe99915f15a25172286c1f,1,243,17,260,10,2006-06-16 10:04:20,2006-06-01 09:35:44
79bb8d88fc61b03a80fe99915f15a25172286c1f...a5e0cedc0a4d0018f3e7e4ba8ca54c91742dd859,3,974,111,1085,72,2006-06-16 10:04:20,2006-06-12 22:23:48
a5e0cedc0a4d0018f3e7e4ba8ca54c91742dd859...42d328701dbdbc02c3361673629a44df478e69d7,4,224,132,356,57,2006-06-16 10:04:20,2006-06-13 11:02:23
42d328701dbdbc02c3361673629a44df478e69d7...6c5cda89e93915ed2984ba560f3c3d048c7a5702,1,8,18,26,4,2006-06-16 10:04:20,2006-06-15 04:24:03
6c5cda89e93915ed2984ba560f3c3d048c7a5702...cf7424b021f99fbc5dc1127725e57ca3d48e981c,1,81,65,146,25,2006-06-16 10:04:20,2006-06-15 19:50:12
cf7424b021f99fbc5dc1127725e57ca3d48e981c...968bdf1f3da677255c8950bb5b5a9de7e1150279,1,23,33,56,8,2006-06-16 10:04:21,2006-06-15 20:36:12
968bdf1f3da677255c8950bb5b5a9de7e1150279...c0d4822268d30b1668e94986a845b8bb5441e8b3,1,52,8,60,7,2006-06-16 10:04:21,2006-06-16 01:48:22
c0d4822268d30b1668e94986a845b8bb5441e8b3...86f363791b281fb916414a89282b2e67cdaa36c0,2,9,4,13,3,2006-06-16 10:04:21,2006-06-16 02:13:56
86f363791b281fb916414a89282b2e67cdaa36c0...0e8a002c59cbaca692dac81320be44c965588291,2,51,43,94,5,2006-06-16 10:04:21,2006-06-16 02:51:05
0e8a002c59cbaca692dac81320be44c965588291...1a82e79315ed633f6b0b1fc4076054950c5380d3,1,19,2,21,7,2006-06-16 10:04:21,2006-06-16 09:55:13
bdbfbe3dc943a2e76dcd4d78ce1df74966af4e71...4a2139f52f5ee919cc2e9c3812ee4ec20b43ae5a,1,66,9,75,12,2005-06-28 23:47:48,2005-06-28 23:47:48
5569bf9bbedd63a00780fc5c110e0cfab3aa97b9...bac15c454ecc8ee0824451ffdd5406150714c432,1,1,1,2,1,2005-06-22 21:07:41,2005-06-22 21:07:41
bac15c454ecc8ee0824451ffdd5406150714c432...60646e9a7170750093599fc52ad56453fc516185,1,3,12,15,4,2005-06-23 00:54:44,2005-06-21 15:58:46
60646e9a7170750093599fc52ad56453fc516185...3f571e0b3a7893ed068acd75f27e152d29945637,2,9,1,10,2,2005-06-23 01:49:43,2005-06-23 01:49:43
3f571e0b3a7893ed068acd75f27e152d29945637...e4bcaac17e8959eb970a348519a25d0d396395f0,1,0,4,4,1,2005-06-23 02:06:34,2005-06-23 02:06:34
e4bcaac17e8959eb970a348519a25d0d396395f0...6e4c0a51092e3ec3429ca91890b99e198aa367bd,1,61,0,61,2,2005-06-23 02:15:04,2005-06-23 02:01:09
6e4c0a51092e3ec3429ca91890b99e198aa367bd...170774a39d32755fc013601d9d682ee034974625,1,7,4,11,5,2005-06-23 02:15:04,2005-06-23 02:01:12
170774a39d32755fc013601d9d682ee034974625...5fca669f1933ca3ef5f93ee2bf8871183bc2a7c2,1,8,2,10,4,2005-06-23 15:59:00,2005-06-23 15:59:00
5fca669f1933ca3ef5f93ee2bf8871183bc2a7c2...aefa4a5b1cb6cafab14b8179dc803881d1da45bf,1,4,1,5,2,2005-06-23 16:00:01,2005-06-23 16:00:01
aefa4a5b1cb6cafab14b8179dc803881d1da45bf...180926636e47ecfe28d03cec493af75899994f0f,1,6,12,18,4,2005-06-23 20:56:55,2005-06-23 20:56:55
180926636e47ecfe28d03cec493af75899994f0f...f97672225b3b1a2ca57cfc16f49239bed1efcd87,2,81,1,82,3,2005-06-23 22:06:04,2005-06-23 22:06:04
f97672225b3b1a2ca57cfc16f49239bed1efcd87...023d66ed7b397c811a0693f34851d8590b69247b,1,81,26,107,14,2005-06-24 17:12:55,2005-06-24 17:12:55
023d66ed7b397c811a0693f34851d8590b69247b...9de48752fedc4923502c522af0e1f5b94c5fea2e,1,91,0,91,8,2005-06-25 05:56:58,2005-06-25 05:56:58
9de48752fedc4923502c522af0e1f5b94c5fea2e...7323aa11af1527d5a786d93ee34401c72c5df051,1,4,5,9,2,2005-06-25 20:41:10,2005-06-25 18:23:36
7323aa11af1527d5a786d93ee34401c72c5df051...c323ac7d9c573c5ee8b45b9b9def92a4d4d8204d,2,406,1,407,3,2005-06-25 21:42:43,2005-06-25 21:42:43
c323ac7d9c573c5ee8b45b9b9def92a4d4d8204d...49397104f2317c91ac54a250cd8c65cacfc0bb9e,1,1,1,2,1,2005-06-25 22:24:30,2005-06-25 22:24:30
49397104f2317c91ac54a250cd8c65cacfc0bb9e...bad50dc80f3b81a0bedb85ca0382b0086e5bf0c2,2,107,1,108,3,2005-06-25 22:27:14,2005-06-25 22:27:14
bad50dc80f3b81a0bedb85ca0382b0086e5bf0c2...d38c3721a1813048a6c7c1597b0c2e5b18517f9d,1,1,0,1,1,2005-06-25 22:58:42,2005-06-25 22:58:42
d38c3721a1813048a6c7c1597b0c2e5b18517f9d...745369583105c8a048a765f8b5cbf7e7ebd1f982,1,58,5,63,9,2005-06-25 22:59:31,2005-06-25 22:59:31
745369583105c8a048a765f8b5cbf7e7ebd1f982...9cb480f2ad653d834fe5e4ba7a8a25f74ad1d89b,1,9,5,14,7,2005-06-25 23:52:16,2005-06-25 09:21:16
9cb480f2ad653d834fe5e4ba7a8a25f74ad1d89b...5fec3ef101c0f18bbf2400423dc70e686e9d25b0,1,67,8,75,8,2005-06-25 23:52:16,2005-06-25 09:22:05
5fec3ef101c0f18bbf2400423dc70e686e9d25b0...93c36dcd0a4f6373e3a02a8505046801106ddb85,2,87,1,88,2,2005-06-25 23:52:16,2005-06-25 09:22:59
93c36dcd0a4f6373e3a02a8505046801106ddb85...59e6b23acef9d29b9bdabc38ee80361e19ef7ebe,2,50,1,51,2,2005-06-25 23:52:16,2005-06-25 09:23:43
59e6b23acef9d29b9bdabc38ee80361e19ef7ebe...1abb3f14c872ac1b5b70db4334b21dde60e57b7a,2,150,14,164,47,2005-06-25 23:52:16,2005-06-25 09:24:16
1abb3f14c872ac1b5b70db4334b21dde60e57b7a...aacc15ec5261fca8a02570f93028e3ac4213caae,1,5,2,7,1,2005-06-25 23:52:16,2005-06-25 09:24:50
aacc15ec5261fca8a02570f93028e3ac4213caae...b155725daeec48436d1fcbec4854ffd317408a6e,4,43,17,60,17,2005-06-25 23:52:16,2005-06-25 09:25:29
b155725daeec48436d1fcbec4854ffd317408a6e...613d872cfbe53213e1a9bbc77d75be9a6403b2b2,1,4,2,6,2,2005-06-25 23:52:16,2005-06-25 09:25:57
613d872cfbe53213e1a9bbc77d75be9a6403b2b2...a81efcba8cc9b55daf19bf0f2ae2058db1d25d31,1,15,6,21,7,2005-06-25 23:52:16,2005-06-25 09:26:29
a81efcba8cc9b55daf19bf0f2ae2058db1d25d31...eb41ab11e8eaa1bd71a4413d71583d72dd181b33,1,1,0,1,1,2005-06-26 01:12:07,2005-06-26 00:36:26
eb41ab11e8eaa1bd71a4413d71583d72dd181b33...78817c15de0dfb408d1e35a2f692f54dc51e80a3,1,5,4,9,2,2005-06-26 01:29:23,2005-06-26 01:29:23
78817c15de0dfb408d1e35a2f692f54dc51e80a3...75c42d8cc3b42e4b82946848b8ba902b4bbcc38d,7,28,17,45,13,2005-06-26 02:30:20,2005-06-26 02:30:20
75c42d8cc3b42e4b82946848b8ba902b4bbcc38d...f846bbff1507ebd0f25e480feacef2954a2629dd,1,4,4,8,4,2005-06-26 02:35:47,2005-06-26 02:35:47
f846bbff1507ebd0f25e480feacef2954a2629dd...d116a45a9a505d9a58cdd1c79193f759316c440d,1,17,7,24,9,2005-06-26 03:17:59,2005-06-26 03:17:59
d116a45a9a505d9a58cdd1c79193f759316c440d...8ee378a0f00a56cbffedee21fdbba30870d84436,3,261,18,279,19,2005-06-26 14:33:23,2005-06-26 11:29:18
8ee378a0f00a56cbffedee21fdbba30870d84436...c4fb06c0d04f433ab71d84674ebfe18cda162369,2,49,62,111,31,2005-06-26 15:40:08,2005-06-26 15:40:08
c4fb06c0d04f433ab71d84674ebfe18cda162369...641e1cac73acd67d0b1830dfd7196bca58dffbf2,1,0,1,1,1,2005-06-26 15:49:48,2005-06-26 15:49:48
641e1cac73acd67d0b1830dfd7196bca58dffbf2...042a4ed7c51f909fa53a8fa2f1024a1938812f27,1,15,15,30,8,2005-06-26 18:34:30,2005-06-26 18:34:30
042a4ed7c51f909fa53a8fa2f1024a1938812f27...102fc37f3b3d213841d4cff47a75d385824a3027,2,174,1,175,2,2005-06-26 20:11:59,2005-06-26 18:15:16
102fc37f3b3d213841d4cff47a75d385824a3027...521a4f4cf4bb2d59a51a5355bfb6b148c4aa31ed,1,16,12,28,7,2005-06-26 20:43:41,2005-06-26 20:43:41
521a4f4cf4bb2d59a51a5355bfb6b148c4aa31ed...9ce43d1c90dc199bf8ced85fa5fdadc152753022,2,11,9,20,11,2005-06-26 22:26:05,2005-06-26 22:26:05
9ce43d1c90dc199bf8ced85fa5fdadc152753022...27225f2e87f26351a5def9738f7b1d025159aa93,1,23,4,27,10,2005-06-26 22:27:28,2005-06-26 22:27:28
27225f2e87f26351a5def9738f7b1d025159aa93...f336e71f86560df3503c1da1f68635a184af28a9,1,9,0,9,1,2005-06-27 00:38:47,2005-06-27 00:38:47
f336e71f86560df3503c1da1f68635a184af28a9...9b66ec04741b4030e7654dcb7b978a29a8214b31,4,25,32,57,9,2005-06-27 00:50:46,2005-06-27 00:50:46
9b66ec04741b4030e7654dcb7b978a29a8214b31...c38138cd78f284b261a02323e8f18a1dee87c7fa,5,158,62,220,17,2005-06-27 03:27:56,2005-06-27 03:27:56
c38138cd78f284b261a02323e8f18a1dee87c7fa...e18088451d92fbf83bfb57fd48201eda117f8103,4,26,16,42,19,2005-06-27 05:01:46,2005-06-27 05:01:46
e18088451d92fbf83bfb57fd48201eda117f8103...e2efb676ef0e70364f130c4097b7b9d67804753f,1,1,1,2,1,2005-06-27 19:12:18,2005-06-27 19:12:18
e2efb676ef0e70364f130c4097b7b9d67804753f...ee85cbc6887d6ae4eb09a3e2c7319f66ae7c9034,2,15,5,20,6,2005-06-27 22:27:50,2005-06-27 19:03:07
ee85cbc6887d6ae4eb09a3e2c7319f66ae7c9034...c4584ae3fd7cd595a638a07dfd853e9d2745e930,25,22,948,970,51,2005-06-27 22:27:51,2005-06-27 10:33:33
c4584ae3fd7cd595a638a07dfd853e9d2745e930...36e4d74a210ba618e1520f11ce7fc2f8baec5bb8,4,27,31,58,7,2005-06-27 22:27:51,2005-06-27 10:34:06
36e4d74a210ba618e1520f11ce7fc2f8baec5bb8...1f688557c0b4963d5e0b93ad5cddad31e5322709,2,458,12,470,18,2005-06-27 22:27:51,2005-06-27 10:35:33
1f688557c0b4963d5e0b93ad5cddad31e5322709...2700628e64939c9496f8ca532b7c188e5927d500,1,1,0,1,1,2005-06-28 00:02:56,2005-06-28 00:02:56
07ee0d77c66d6f356cd3f82435e67510779aa53c...2a9c3fe838a21cb2097347e15bec71e848f8d625,1,26,10,36,6,2005-07-19 11:03:47,2005-07-19 11:03:47
2a9c3fe838a21cb2097347e15bec71e848f8d625...f0b32737ad5a35cc047db47353a75faccfe5939e,1,5,1,6,3,2005-07-19 11:20:39,2005-07-19 11:20:39
f0b32737ad5a35cc047db47353a75faccfe5939e...8b64647dd9009f52e23e7fdb443b7b8f9502278a,2,40,1,41,3,2005-07-22 17:26:01,2005-07-22 16:56:39
8b64647dd9009f52e23e7fdb443b7b8f9502278a...d854f783af2a441827d66b4b70e9d0d9e3434b15,1,38,7,45,8,2005-07-22 17:26:01,2005-07-22 16:56:57
d854f783af2a441827d66b4b70e9d0d9e3434b15...3727531899aecac02c50c6580e84c627c25fcaa6,1,38,10,48,5,2005-07-22 23:29:28,2005-07-22 23:04:19
3727531899aecac02c50c6580e84c627c25fcaa6...44d2eb51b1c360c0337429f9a4a4f95d26d047eb,2,40,8,48,11,2005-07-22 23:29:28,2005-07-22 23:04:34
44d2eb51b1c360c0337429f9a4a4f95d26d047eb...5c2c972f474f22894f5cbcc1234b5dc022de5a33,1,43,6,49,12,2005-07-22 23:29:28,2005-07-22 23:04:47
5c2c972f474f22894f5cbcc1234b5dc022de5a33...f2a1f9a56e135bbab622d03661b075c6870e1de8,2,1,1,2,1,2005-07-23 00:48:45,2005-07-20 01:17:47
f2a1f9a56e135bbab622d03661b075c6870e1de8...8228326e467342408d27000edcd6739f2c9cc2a6,1,1,1,2,1,2005-07-23 00:48:45,2005-07-19 21:59:09
8228326e467342408d27000edcd6739f2c9cc2a6...62b532b080d56e02d8f486e801110456ab0bb380,1,3,4,7,3,2005-07-23 00:48:45,2005-07-16 20:18:40
62b532b080d56e02d8f486e801110456ab0bb380...421cbeb2f7d122177cd0dd456f0ea22480704de3,1,1,1,2,1,2005-07-23 00:48:45,2005-07-16 20:19:24
421cbeb2f7d122177cd0dd456f0ea22480704de3...3dcb90f526e63a46375c1e92d2511e0955e055ed,2,11,2,13,3,2005-07-23 00:48:45,2005-07-13 02:12:40
3dcb90f526e63a46375c1e92d2511e0955e055ed...99cff830e0b5d57fb299f1937a46d62602f23c9b,1,4,2,6,1,2005-07-23 00:48:45,2005-07-23 00:30:26
99cff830e0b5d57fb299f1937a46d62602f23c9b...5bb2c65aba9161ee77c42002009634e757005b4f,2,37,6,43,7,2005-07-23 03:34:16,2005-07-23 02:08:32
5bb2c65aba9161ee77c42002009634e757005b4f...a38e727925bfad369fc98165f6ff161193397f28,1,7,1,8,1,2005-07-23 03:34:16,2005-07-23 02:08:47
a38e727925bfad369fc98165f6ff161193397f28...f6e1a4d6dc4d1b3d82d5e87fdd817b3994dda5e0,5,12,12,24,7,2005-07-23 03:34:16,2005-07-23 02:09:05
f6e1a4d6dc4d1b3d82d5e87fdd817b3994dda5e0...8cc393068aedc7378166ccc013d3954cd87f0deb,2,15,2,17,6,2005-07-23 03:34:16,2005-07-23 02:09:20
8cc393068aedc7378166ccc013d3954cd87f0deb...bf0dd8a8de9c4fc90f90bdcbce5ecf7e87a35b29,1,3,1,4,1,2005-07-23 03:34:16,2005-07-23 02:09:34
bf0dd8a8de9c4fc90f90bdcbce5ecf7e87a35b29...1cadb5a2719eef7dc4e707ee2f796c94661f4622,1,23,18,41,6,2005-07-23 03:34:16,2005-07-23 02:11:22
1cadb5a2719eef7dc4e707ee2f796c94661f4622...a692b9656a7975b933fde40cdd6319f9ca898a29,1,18,22,40,7,2005-07-23 03:34:17,2005-07-23 02:13:07
a692b9656a7975b933fde40cdd6319f9ca898a29...4311d328fee11fbd80862e3c5de06a26a0e80046,1,25,1,26,3,2005-07-23 17:01:49,2005-07-23 17:01:49
4311d328fee11fbd80862e3c5de06a26a0e80046...71fb3de0eed70bba1c7e28c8a0a2968efc48b9f3,3,13,7,20,7,2005-07-23 18:05:58,2005-07-22 05:55:56
71fb3de0eed70bba1c7e28c8a0a2968efc48b9f3...34862b2e243316e5536832dd01f1c5ba9ec1754d,2,2,0,2,2,2005-07-23 18:05:58,2005-07-22 06:36:07
34862b2e243316e5536832dd01f1c5ba9ec1754d...5ba884483fe1a5f9ce1ce5e3c5e1c37c0fd296c4,1,43,28,71,6,2005-07-23 18:05:58,2005-07-21 13:10:36
5ba884483fe1a5f9ce1ce5e3c5e1c37c0fd296c4...ce6f8e7ec2bbebe2472e23b684cae0a4adf325ad,1,3,1,4,2,2005-07-23 18:10:21,2005-07-23 18:10:21
ce6f8e7ec2bbebe2472e23b684cae0a4adf325ad...1d8fa411e04130e175eae7a41e0918e4be7797a5,1,27,37,64,8,2005-07-23 18:13:11,2005-07-23 09:10:31
1d8fa411e04130e175eae7a41e0918e4be7797a5...d727782eaf85d7bbf49e666776deadd3fee85715,1,38,12,50,8,2005-07-23 22:21:22,2005-07-23 22:21:22
d727782eaf85d7bbf49e666776deadd3fee85715...a7333f9e56456055dc38fe05dad3970c8078cd4b,1,31,21,52,13,2005-07-23 22:24:53,2005-07-23 22:24:53
a7333f9e56456055dc38fe05dad3970c8078cd4b...18705953af75aed190badfccdc107ad0c2f36c93,2,57,1,58,3,2005-07-24 01:28:18,2005-07-24 00:54:03
18705953af75aed190badfccdc107ad0c2f36c93...508e67ab6ea338c6c54c97690501423b39992732,2,59,3,62,4,2005-07-24 01:28:18,2005-07-24 00:54:15
508e67ab6ea338c6c54c97690501423b39992732...0fec0822721cc18d6a62ab78da1ebf87914d4921,2,106,1,107,2,2005-07-24 01:28:19,2005-07-24 00:54:26
0fec0822721cc18d6a62ab78da1ebf87914d4921...8f3f9b09dc5ac8a946422422c3c70a4a4c284be3,9,1025,1,1026,13,2005-07-24 01:28:19,2005-07-24 00:54:41
8f3f9b09dc5ac8a946422422c3c70a4a4c284be3...61e3ef3620493834ed5997d56d481c171d8bd5ac,2,46,0,46,2,2005-07-24 01:28:19,2005-07-24 00:54:56
61e3ef3620493834ed5997d56d481c171d8bd5ac...c0a58fbb511028a3500987417376a5cfb2c141da,3,63,3,66,3,2005-07-24 01:28:19,2005-07-24 00:55:07
c0a58fbb511028a3500987417376a5cfb2c141da...fd1fcd9f57406cd5f278adb6b3ceeb1b7637062a,3,5,2,7,1,2005-07-24 01:46:27,2005-07-24 01:46:27
fd1fcd9f57406cd5f278adb6b3ceeb1b7637062a...399144f21c1b3bcd4c9dadd4f534118475de840d,2,8,1,9,2,2005-07-24 01:52:22,2005-07-24 01:52:22
399144f21c1b3bcd4c9dadd4f534118475de840d...2002eed6c9e0e08d7a30da38e459b92f7808b319,1,17,6,23,4,2005-07-24 03:27:49,2005-07-23 23:35:25
2002eed6c9e0e08d7a30da38e459b92f7808b319...154d3d2dd2656c23ea04e9d1c6dd4e576a7af6de,1,3,3,6,3,2005-07-24 03:28:34,2005-07-24 03:28:34
154d3d2dd2656c23ea04e9d1c6dd4e576a7af6de...0fad0fdd4beadb2ff06af8d5a16d509cd8796ee4,1,26,6,32,8,2005-07-25 22:24:53,2005-07-25 22:18:35
0fad0fdd4beadb2ff06af8d5a16d509cd8796ee4...b7e438f951f68be704b001343811e9ff89da07f7,1,11,5,16,4,2005-07-25 23:34:26,2005-07-25 06:17:16
b7e438f951f68be704b001343811e9ff89da07f7...f87f94974869b1ddd579d4c6aaff12a5f86ca26e,2,157,21,178,25,2005-07-26 00:03:52,2005-07-24 22:26:09
f87f94974869b1ddd579d4c6aaff12a5f86ca26e...30b0535f251a42aa3936e44041a8d25e0e578ab9,1,92,4,96,3,2005-07-26 00:03:52,2005-07-24 22:47:26
30b0535f251a42aa3936e44041a8d25e0e578ab9...e7baa4f45f4420a6d2da6a13e8959f8405c3ea19,3,51,26,77,20,2005-07-26 00:15:34,2005-07-25 20:05:44
e7baa4f45f4420a6d2da6a13e8959f8405c3ea19...ca8c9156f8f980455f64e2cedcf0347328e46029,1,1,1,2,1,2005-07-26 00:16:20,2005-07-25 21:31:19
ca8c9156f8f980455f64e2cedcf0347328e46029...2bbcddee877c01ea1008efe2137d7ef599189ef5,18,34,34,68,28,2005-07-26 07:22:43,2005-07-26 07:22:43
2bbcddee877c01ea1008efe2137d7ef599189ef5...2779fad61302da0fe3a24995e343ab894f32fa42,1,1,1,2,1,2005-07-27 00:21:16,2005-07-27 00:21:16
2779fad61302da0fe3a24995e343ab894f32fa42...bdf25142aaac016f4d992001f336d53ab4fbc75e,2,56,1,57,2,2005-07-27 05:23:18,2005-07-27 03:04:22
bdf25142aaac016f4d992001f336d53ab4fbc75e...a977d2cf589c8e4d66e53e9399a61ef08a8ddcad,3,27,1,28,3,2005-07-27 05:23:19,2005-07-23 19:26:32
a977d2cf589c8e4d66e53e9399a61ef08a8ddcad...b55db7ba283c1f7d2ff3cbc7e351d3ae504c9b1d,1,1,1,2,1,2005-07-27 18:47:51,2005-07-27 08:36:08
b55db7ba283c1f7d2ff3cbc7e351d3ae504c9b1d...ab421d2c7886341c246544bc8dea43c66a44d909,2,38,1,39,2,2005-07-27 18:53:47,2005-07-26 07:30:36
ab421d2c7886341c246544bc8dea43c66a44d909...9969b649999a04d6ce8eebccfc1ee766f6e5377a,1,15,16,31,8,2005-07-27 18:53:48,2005-07-26 18:47:31
9969b649999a04d6ce8eebccfc1ee766f6e5377a...b134922992e3051e7095b1e76a89361fea86206d,1,2,0,2,1,2005-07-27 18:53:48,2005-07-27 03:04:22
b134922992e3051e7095b1e76a89361fea86206d...54c6870ebf4c364dd809a1a58eb8485855344812,3,3,3,6,3,2005-07-27 18:53:49,2005-07-27 07:04:16
54c6870ebf4c364dd809a1a58eb8485855344812...f3157244314a66b6293af2f6a283a596367dc80e,1,1,1,2,1,2005-07-27 18:53:49,2005-07-27 03:04:22
f3157244314a66b6293af2f6a283a596367dc80e...f7cc77d78b9ee59dce162a50815ac6c1918a4397,1,11,5,16,3,2005-07-28 01:56:29,2005-07-27 22:12:48
f7cc77d78b9ee59dce162a50815ac6c1918a4397...de2eb7f694da6396828e52588c9807a948a039a0,1,22,1,23,4,2005-07-28 01:57:03,2005-07-27 22:16:03
de2eb7f694da6396828e52588c9807a948a039a0...4e81304afc529c0caca7c012a155be4e342b52d4,1,15,30,45,7,2005-07-28 01:57:13,2005-07-27 22:29:38
4e81304afc529c0caca7c012a155be4e342b52d4...64071805eda2b57d2b77943bb3f9865d90562ecf,3,37,12,49,10,2005-07-28 01:57:14,2005-07-27 23:08:43
64071805eda2b57d2b77943bb3f9865d90562ecf...fb6a3d862137c3f77c387729395a0c558950437b,2,10,2,12,3,2005-07-28 01:57:14,2005-07-28 01:55:18
fb6a3d862137c3f77c387729395a0c558950437b...d36ac03e457ce7e2caeea9aa2530a218ac0ede43,1,68,5,73,3,2005-07-28 05:47:06,2005-07-25 05:26:47
d36ac03e457ce7e2caeea9aa2530a218ac0ede43...429a9358763dfb98cd063e40dc49cbc049e2a268,1,34,0,34,1,2005-07-28 05:47:07,2005-07-25 06:13:11
429a9358763dfb98cd063e40dc49cbc049e2a268...df076bdbccd26ccaf49fc332303f512403c8cde6,1,100,31,131,10,2005-07-28 05:47:07,2005-07-23 08:24:59
df076bdbccd26ccaf49fc332303f512403c8cde6...629170973d6fca813a7593c3aac9bb18a8e476a8,1,10,2,12,4,2005-07-29 04:05:06,2005-07-29 03:37:23
629170973d6fca813a7593c3aac9bb18a8e476a8...b614e3d75730490180f9271cec714a4a8c721636,1,11,4,15,2,2005-07-29 07:12:02,2005-07-28 21:33:17
b614e3d75730490180f9271cec714a4a8c721636...bd6bc56d4ebf04113657647e6d071e24ca708dad,1,1,1,2,1,2005-07-29 07:12:02,2005-07-28 14:48:13
bd6bc56d4ebf04113657647e6d071e24ca708dad...148519b7dc5a45ee73a85d39e4647099976be3b8,1,6,2,8,1,2005-07-29 07:12:03,2005-07-28 14:48:37
148519b7dc5a45ee73a85d39e4647099976be3b8...bfb15365b0e9ebb2e4f3facca282c7f585f96e3f,1,4,0,4,2,2005-07-29 07:12:03,2005-07-28 14:51:41
b51ad4314078298194d23d46e2b4473ffd32a88a...839a7a06f35bf8cd563a41d6db97f453ab108129,3,83,0,83,3,2005-04-18 19:15:10,2005-04-18 19:15:10
839a7a06f35bf8cd563a41d6db97f453ab108129...0a02ce72d9ab78d061b2cc919bc15e36fe620ddc,1,39,32,71,18,2005-04-18 19:49:39,2005-04-18 19:49:39
0a02ce72d9ab78d061b2cc919bc15e36fe620ddc...0fcfd160b0495c0881e142c546c4418b8cea7e93,4,288,271,559,5,2005-04-18 20:04:43,2005-04-18 20:04:43
0fcfd160b0495c0881e142c546c4418b8cea7e93...e590d694ead8d50c2afc7086161d4ddc5d907655,1,24,2,26,2,2005-04-18 20:12:21,2005-04-18 20:12:21
e590d694ead8d50c2afc7086161d4ddc5d907655...3407bb4940c25ca67c846a48ef2c2c60c02178e0,2,39,1,40,4,2005-04-18 21:11:01,2005-04-18 21:11:01
3407bb4940c25ca67c846a48ef2c2c60c02178e0...e3b4be7f6c31d85b5f6abc42bd24d61bce5027b4,2,41,46,87,11,2005-04-18 21:17:58,2005-04-18 21:17:58
e3b4be7f6c31d85b5f6abc42bd24d61bce5027b4...00829b5def72f36269796727c9589316a214dc85,1,2,2,4,2,2005-04-18 22:01:48,2005-04-18 22:01:48
00829b5def72f36269796727c9589316a214dc85...c157d376740f224789f464785718f3757ea8aa92,1,6,16,22,6,2005-04-18 22:07:24,2005-04-18 22:07:24
c157d376740f224789f464785718f3757ea8aa92...d0db466326c32ca4b3faa849a81fab7d60615c6f,1,10,1,11,2,2005-04-18 22:07:24,2005-04-18 22:07:24
d0db466326c32ca4b3faa849a81fab7d60615c6f...8f3671dcd93b8c5ab21582752f736646c66e2249,1,10,34,44,8,2005-04-18 22:07:24,2005-04-18 22:07:24
8f3671dcd93b8c5ab21582752f736646c66e2249...5a6ad74623571a1479af7914ec16783a9566e4b2,1,4,3,7,3,2005-04-18 22:07:24,2005-04-18 22:07:24
5a6ad74623571a1479af7914ec16783a9566e4b2...ff69ab9ad87d839e381b1e4abfe45032d18bada7,1,25,4,29,6,2005-04-18 22:07:24,2005-04-18 22:07:24
ff69ab9ad87d839e381b1e4abfe45032d18bada7...4789576e0e5364dcd3916ef583b2ea61bef23f24,1,13,7,20,10,2005-04-18 22:07:24,2005-04-18 22:07:24
4789576e0e5364dcd3916ef583b2ea61bef23f24...0ffb0bcaf6ab6277527f6ac8623632a9de55114d,1,1,1,2,1,2005-04-18 23:49:21,2005-04-18 23:49:21
0ffb0bcaf6ab6277527f6ac8623632a9de55114d...8c1becff243aeeec455eeabe513fa180631be83c,1,0,3,3,1,2005-04-18 23:51:09,2005-04-18 23:51:09
8c1becff243aeeec455eeabe513fa180631be83c...f43b8abc6f051aece327a3779e903106916d6e67,1,1,1,2,1,2005-04-19 00:35:31,2005-04-19 00:35:31
f43b8abc6f051aece327a3779e903106916d6e67...b70070f0208be5d5d7b7a3b259e7ff3da19307d0,1,9,5,14,5,2005-04-19 00:37:32,2005-04-19 00:37:32
b70070f0208be5d5d7b7a3b259e7ff3da19307d0...0a9ea850005de0fb74b6288d281eb0417e869b00,1,10,1,11,2,2005-04-19 02:55:19,2005-04-19 02:55:19
0a9ea850005de0fb74b6288d281eb0417e869b00...3b7d368f34715003c834233d9f23456bcb62b44a,1,4,0,4,1,2005-04-19 16:52:24,2005-04-19 16:52:24
3b7d368f34715003c834233d9f23456bcb62b44a...4aaef1064a1091ec38ab6adc823f26b82cf4998d,1,3,1,4,2,2005-04-19 16:53:58,2005-04-19 16:53:58
4aaef1064a1091ec38ab6adc823f26b82cf4998d...ca016f0e4e7e508407fe17e121fcd520fbb7c865,1,39,2,41,11,2005-04-19 18:16:12,2005-04-19 18:16:12
ca016f0e4e7e508407fe17e121fcd520fbb7c865...a3a65234dba0f90a0b8e06fa7b5f269fe5126761,1,39,5,44,3,2005-04-19 18:41:18,2005-04-19 18:41:18
a3a65234dba0f90a0b8e06fa7b5f269fe5126761...8ccfbf3279b07028035aeb58baed5c4a79b63567,1,2,2,4,2,2005-04-19 19:56:47,2005-04-19 19:56:47
8ccfbf3279b07028035aeb58baed5c4a79b63567...7fa6b4e7692926d2d07adee1ef8e277157929058,1,1,1,2,1,2005-04-19 20:59:17,2005-04-19 20:59:17
7fa6b4e7692926d2d07adee1ef8e277157929058...c9823a427a0a7aabc4f840a90e82548e91f9bdd6,2,86,1,87,4,2005-04-19 21:00:34,2005-04-19 21:00:34
c9823a427a0a7aabc4f840a90e82548e91f9bdd6...17cf781661e6d38f737f15f53ab552f1e95960d7,1,1,1,2,1,2005-04-19 21:11:06,2005-04-19 21:11:06
17cf781661e6d38f737f15f53ab552f1e95960d7...b96afa59ebfd2c0902e2fd2653e29f291bf0cac7,1,4,2,6,1,2005-04-19 22:46:06,2005-04-19 22:46:06
b96afa59ebfd2c0902e2fd2653e29f291bf0cac7...e74f8f6aa7807d479d78bfc680a18a9a5198b172,2,274,2,276,5,2005-04-20 04:00:09,2005-04-20 04:00:09
e74f8f6aa7807d479d78bfc680a18a9a5198b172...abdb007d1f0ee1579c3719fc4fadbe4755163d74,1,16,0,16,2,2005-04-20 04:39:28,2005-04-20 04:39:28
abdb007d1f0ee1579c3719fc4fadbe4755163d74...4696cb93d1e2ded452e4e673633fd6495698ffcd,1,6,9,15,3,2005-04-20 04:48:15,2005-04-20 04:48:15
4696cb93d1e2ded452e4e673633fd6495698ffcd...addb315d341437b11477d617fda3fd80e7bce3c1,1,3,8,11,2,2005-04-20 04:48:15,2005-04-20 04:48:15
addb315d341437b11477d617fda3fd80e7bce3c1...cb126d8d7906b3c15f313ca479259e567042840a,1,14,16,30,5,2005-04-20 04:48:15,2005-04-20 04:48:15
cb126d8d7906b3c15f313ca479259e567042840a...d98b46f8d9a3daf965a39f8c0089c1401e0081ee,5,158,13,171,12,2005-04-20 08:10:46,2005-04-20 08:10:46
d98b46f8d9a3daf965a39f8c0089c1401e0081ee...f18ca7316631914776136455c151d70318299459,1,9,5,14,4,2005-04-20 08:34:54,2005-04-20 08:34:54
f18ca7316631914776136455c151d70318299459...706bc531a19f268bb03dda7551929dee20172548,1,22,4,26,3,2005-04-20 16:28:05,2005-04-20 16:28:05
706bc531a19f268bb03dda7551929dee20172548...4990aadc4cbb872cb71acdc0ca842eacb86f1362,1,39,4,43,4,2005-04-20 19:16:57,2005-04-20 19:16:57
4990aadc4cbb872cb71acdc0ca842eacb86f1362...ca9be05421ff3b641182ab4063c7c3ac834750b5,2,21,24,45,15,2005-04-20 19:36:41,2005-04-20 19:36:41
ca9be05421ff3b641182ab4063c7c3ac834750b5...2dee0609685a0a01d7fd65e6a804363c3514087c,2,2,1,3,2,2005-04-20 20:00:08,2005-04-20 20:00:08
2dee0609685a0a01d7fd65e6a804363c3514087c...6ca25ed331c57576a82c83f43040f4071671b1a7,1,2,47,49,4,2005-04-20 20:10:13,2005-04-20 20:10:13
6ca25ed331c57576a82c83f43040f4071671b1a7...f4913f91a960ebcfbc9c6a09dc909ce638cb5c66,2,44,0,44,2,2005-04-21 01:06:49,2005-04-21 01:06:49
f4913f91a960ebcfbc9c6a09dc909ce638cb5c66...38357e6703db9f2c1bff31de1ce7c7503c6db96a,1,1,16,17,3,2005-04-21 01:06:49,2005-04-21 01:06:49
38357e6703db9f2c1bff31de1ce7c7503c6db96a...c1fdf2a6abb6a7c5b8092d72514264ae378d60ee,1,4,21,25,5,2005-04-21 01:06:50,2005-04-21 01:06:50
c1fdf2a6abb6a7c5b8092d72514264ae378d60ee...23b127ed085cbe2f853ce63b53c732a7b9e6de74,1,5,6,11,4,2005-04-21 01:06:50,2005-04-21 01:06:50
23b127ed085cbe2f853ce63b53c732a7b9e6de74...b12ec373b8ecf7de6ea37db392fde57f13c5b51c,1,24,10,34,5,2005-04-21 01:06:50,2005-04-21 01:06:50
b12ec373b8ecf7de6ea37db392fde57f13c5b51c...32347c375250fd470973a5d76185cac718955fd5,1,1,1,2,1,2005-04-21 01:48:27,2005-04-21 01:48:27
32347c375250fd470973a5d76185cac718955fd5...860edf7a710245ac748ada2ae3c0581a79f51f55,1,2,2,4,2,2005-04-21 01:49:41,2005-04-21 01:49:41
860edf7a710245ac748ada2ae3c0581a79f51f55...80913d4364c0be4d9b97eabcd2c8acb800c647c1,1,1,1,2,1,2005-04-21 02:19:11,2005-04-21 02:19:11
80913d4364c0be4d9b97eabcd2c8acb800c647c1...c5bac17ad21c8e79fcca21c366832e75be095322,4,20,16,36,15,2005-04-21 02:49:16,2005-04-21 02:49:16
c5bac17ad21c8e79fcca21c366832e75be095322...94dfb7f2e38fde5014fe50f9e74bde7d2d264184,2,3,4,7,3,2005-04-21 16:58:24,2005-04-21 16:58:24
94dfb7f2e38fde5014fe50f9e74bde7d2d264184...65bb49144d26a10837582a99e66041035319ff91,1,28,16,44,20,2005-04-21 17:15:02,2005-04-21 17:15:02
65bb49144d26a10837582a99e66041035319ff91...bb233d690a9782e1570dc93ead2bf04aaca7cfe4,6,31,20,51,19,2005-04-21 17:55:18,2005-04-21 17:55:18
bb233d690a9782e1570dc93ead2bf04aaca7cfe4...b2c007186786c39693d42d18a1e491aa2e7defce,2,1,164,165,2,2005-04-21 18:21:33,2005-04-21 18:21:33
b2c007186786c39693d42d18a1e491aa2e7defce...cc1ad5c8309fbace11e3a68e3ec8ffcbded442a6,1,4,2,6,2,2005-04-21 19:14:46,2005-04-21 19:14:46
cc1ad5c8309fbace11e3a68e3ec8ffcbded442a6...cef661fc799a3a13ffdea4a3f69f1acd295de53d,4,209,12,221,6,2005-04-21 19:33:22,2005-04-21 19:33:22
cef661fc799a3a13ffdea4a3f69f1acd295de53d...aba06682473e2d797011f966d66c93043e3ed57a,1,6,7,13,5,2005-04-22 23:35:06,2005-04-22 23:35:06
aba06682473e2d797011f966d66c93043e3ed57a...94537c78a82619b2625cb827ec0094703579bfed,3,71,63,134,5,2005-04-22 23:42:37,2005-04-22 23:42:37
94537c78a82619b2625cb827ec0094703579bfed...b5af9107270171b79d46b099ee0b198e653f3a24,3,58,182,240,26,2005-04-23 00:15:28,2005-04-23 00:15:28
b5af9107270171b79d46b099ee0b198e653f3a24...a6ef3518f9ac8a1c46a36c8d27173b1f73d839c4,4,283,1,284,6,2005-04-23 06:08:43,2005-04-23 06:08:43
a6ef3518f9ac8a1c46a36c8d27173b1f73d839c4...144bde78e9ff22d53682ef46b3d9845b83e70f54,1,26,3,29,5,2005-04-23 18:09:32,2005-04-23 18:09:32
144bde78e9ff22d53682ef46b3d9845b83e70f54...bfac5d94291bdb951ae3e739598a32bf868ea806,1,206,13,219,11,2005-04-23 23:37:31,2005-04-23 23:37:31
bfac5d94291bdb951ae3e739598a32bf868ea806...93256315b2444601a35484f4fb76cd5723284201,1,7,0,7,1,2005-04-23 23:48:32,2005-04-23 23:48:32
93256315b2444601a35484f4fb76cd5723284201...65bc81d6fef619d7aadc5c7116be52860539f17a,1,1,1,2,1,2005-04-24 01:05:07,2005-04-24 01:05:07
65bc81d6fef619d7aadc5c7116be52860539f17a...90ffd0952f61717d93858b154d2505d0ba051b14,1,1,1,2,1,2005-04-24 01:41:48,2005-04-24 01:41:48
90ffd0952f61717d93858b154d2505d0ba051b14...dd97f850c3fc049f4f0d8b1fd252d54bc1ba6994,2,61,6,67,5,2005-04-24 01:47:23,2005-04-24 01:47:23
dd97f850c3fc049f4f0d8b1fd252d54bc1ba6994...08692164e0937352fb2c8aab5a7318facbd07daa,2,29,3,32,9,2005-04-24 01:47:23,2005-04-24 01:47:23
08692164e0937352fb2c8aab5a7318facbd07daa...8237b1854c64492ab5772994b4ac4efd7f1c2fc0,2,77,0,77,3,2005-04-24 01:47:23,2005-04-24 01:47:23
8237b1854c64492ab5772994b4ac4efd7f1c2fc0...b6b15db3f464b18180eee79927cb324fd63e15ff,1,44,48,92,7,2005-04-24 01:47:23,2005-04-24 01:47:23
b6b15db3f464b18180eee79927cb324fd63e15ff...6eb7ed5403b7d57d5ed7e30d0cd0b312888ee95c,6,482,2,484,8,2005-04-24 01:47:23,2005-04-24 01:47:23
6eb7ed5403b7d57d5ed7e30d0cd0b312888ee95c...64745109c41a5c4a66b9e3df6bca2fd4abf60d48,2,24,1,25,2,2005-04-24 02:04:40,2005-04-24 02:04:40
64745109c41a5c4a66b9e3df6bca2fd4abf60d48...4056c09114e66ce3c2368551f0122e83628750d6,1,5,2,7,1,2005-04-24 02:21:28,2005-04-24 02:21:28
4056c09114e66ce3c2368551f0122e83628750d6...58e28af6a4d4d4faa1fa628e91c0b33c2b87aade,4,13,26,39,8,2005-04-24 03:29:22,2005-04-24 03:29:22
58e28af6a4d4d4faa1fa628e91c0b33c2b87aade...e2b6a9d0bf9335f24aa8b2be8ff00d3a4ccf6505,2,49,9,58,13,2005-04-24 03:50:10,2005-04-24 03:50:10
e2b6a9d0bf9335f24aa8b2be8ff00d3a4ccf6505...c5b423860d4a0f2c1144c578207f327e0985bba7,1,76,2,78,7,2005-04-24 05:08:00,2005-04-24 05:08:00
c5b423860d4a0f2c1144c578207f327e0985bba7...da6abf5d9c342a74dffbcc2015b9c27d7819a900,1,2,0,2,1,2005-04-24 21:04:13,2005-04-24 21:04:13
da6abf5d9c342a74dffbcc2015b9c27d7819a900...4728b861ace127dc39c648f3bea64c3b86bbabc5,2,9,2,11,3,2005-04-24 21:10:55,2005-04-24 21:10:55
4728b861ace127dc39c648f3bea64c3b86bbabc5...d32987be618181db1f435a5c0a1bea85e90c7c7d,2,2,2,4,4,2005-04-24 21:17:13,2005-04-24 21:17:13
d32987be618181db1f435a5c0a1bea85e90c7c7d...c35dfe858991ee1969870d2da9337a1da567157e,2,2,2,4,2,2005-04-24 21:22:09,2005-04-24 21:22:09
c35dfe858991ee1969870d2da9337a1da567157e...235ac40772e259adfd978850b56192dca9791bb8,2,8,4,12,3,2005-04-24 21:31:57,2005-04-24 21:31:57
235ac40772e259adfd978850b56192dca9791bb8...32718b6c5e8dfe3ca39731b962ec6ada40407af4,1,7,2,9,3,2005-04-24 22:14:16,2005-04-24 22:14:16
32718b6c5e8dfe3ca39731b962ec6ada40407af4...c6e007b0942a373bbf87fa3e4e11e2d90907de8c,1,27,6,33,6,2005-04-24 22:14:16,2005-04-24 22:14:16
c6e007b0942a373bbf87fa3e4e11e2d90907de8c...3f053897b3445988309d0ae7378944783c34d152,1,1,2,3,2,2005-04-24 22:49:09,2005-04-24 22:49:09
3f053897b3445988309d0ae7378944783c34d152...e6948b6d88c69a864e9c461911287c5cc5932a3b,1,2,0,2,1,2005-04-24 23:20:53,2005-04-24 23:20:53
e6948b6d88c69a864e9c461911287c5cc5932a3b...a44c9a5e2e6d4108452f2c64dbd11f74a83745af,5,38,100,138,28,2005-04-25 17:19:53,2005-04-25 17:19:53
a44c9a5e2e6d4108452f2c64dbd11f74a83745af...f5b913c9cb52cee019585375546817cfe5c75426,2,3,3,6,3,2005-04-25 19:04:55,2005-04-25 19:04:55
f5b913c9cb52cee019585375546817cfe5c75426...ec4465adb38d21966acdc9510ff15c0fe4539468,3,165,1,166,4,2005-04-25 19:07:44,2005-04-25 19:07:44
ec4465adb38d21966acdc9510ff15c0fe4539468...56ce69f7afa6d7ce2f33a1173c143a1b89bb9663,1,6,3,9,3,2005-04-25 22:21:49,2005-04-25 22:21:49
56ce69f7afa6d7ce2f33a1173c143a1b89bb9663...65f0d0ee4627dd0f0468ceded38677076d78feb5,1,8,0,8,1,2005-04-25 22:23:53,2005-04-25 22:23:53
65f0d0ee4627dd0f0468ceded38677076d78feb5...cd2fb81d1165cabf76e7f1c31386796e35dd1987,1,3,2,5,2,2005-04-25 22:29:45,2005-04-25 22:29:45
cd2fb81d1165cabf76e7f1c31386796e35dd1987...889262eacf43a7a8810c288c00732b9134d79630,1,25,5,30,6,2005-04-25 23:31:13,2005-04-25 23:31:13
889262eacf43a7a8810c288c00732b9134d79630...ab7df1874d87d3f7494397442e67e900b580a346,1,6,1,7,3,2005-04-25 23:34:13,2005-04-25 23:34:13
ab7df1874d87d3f7494397442e67e900b580a346...86436c28289eedd2ee9b7f9c872a0ed039866a0f,4,130,98,228,6,2005-04-26 01:22:47,2005-04-26 01:22:47
86436c28289eedd2ee9b7f9c872a0ed039866a0f...d1df5743809614241883ecad51876607cf432034,4,363,1,364,5,2005-04-26 01:26:45,2005-04-26 01:26:45
d1df5743809614241883ecad51876607cf432034...be3cfa85f45e32722a65349d023667be906a66b6,4,271,270,541,39,2005-04-26 16:25:05,2005-04-26 16:25:05
be3cfa85f45e32722a65349d023667be906a66b6...5697ecc7be275f884d4f843d0f77f19de2eb604c,1,1,1,2,1,2005-04-26 17:13:31,2005-04-26 17:13:31
5697ecc7be275f884d4f843d0f77f19de2eb604c...f2a19340ada1188e278d5b198d3466ed7411e2d4,1,7,0,7,3,2005-04-26 18:55:42,2005-04-26 18:55:42
f2a19340ada1188e278d5b198d3466ed7411e2d4...812666c8e66a21e668c0789d0422aa5a7db54961,18,54,41,95,38,2005-04-26 19:00:58,2005-04-26 19:00:58
812666c8e66a21e668c0789d0422aa5a7db54961...9831d8f86095edde393e495d7a55cab9d35d5d05,1,11,3,14,2,2005-04-26 19:26:46,2005-04-26 19:26:46
9831d8f86095edde393e495d7a55cab9d35d5d05...0a7668e99f513bd481ef6c4bc69995c434b91cb1,1,32,31,63,12,2005-04-27 00:17:36,2005-04-27 00:17:36
0a7668e99f513bd481ef6c4bc69995c434b91cb1...b8a55ce71d0d46204d64fe35787956e994d2a802,1,1,1,2,1,2005-04-27 00:37:11,2005-04-27 00:37:11
b8a55ce71d0d46204d64fe35787956e994d2a802...0b32ff0dd99136719f0977ba1470894d6d3ab430,1,18,9,27,11,2005-04-27 00:39:01,2005-04-27 00:39:01
0b32ff0dd99136719f0977ba1470894d6d3ab430...a5cd7e16205f29c757ccd925d3f6ac8b5e6cc553,1,1,1,2,1,2005-04-27 00:48:57,2005-04-27 00:48:57
a5cd7e16205f29c757ccd925d3f6ac8b5e6cc553...b0fe89caeb0c37405874bad66702f49ff4977972,1,39,22,61,7,2005-04-27 01:03:07,2005-04-27 01:03:07
b0fe89caeb0c37405874bad66702f49ff4977972...520fc2415e83c0adfc1186ee922472c338cb4146,1,1,1,2,1,2005-04-27 02:27:27,2005-04-27 02:27:27
520fc2415e83c0adfc1186ee922472c338cb4146...77eb2720460a3061ecdf3456d96a7093565fb4e9,2,72,40,112,14,2005-04-27 16:21:00,2005-04-27 16:21:00
77eb2720460a3061ecdf3456d96a7093565fb4e9...4a6bf9e18a96eaa14c5cc0074d2b2ea75f6206ff,1,42,14,56,11,2005-04-27 16:21:00,2005-04-27 16:21:00
4a6bf9e18a96eaa14c5cc0074d2b2ea75f6206ff...3ebfd4aa29e30187ad7a3f75fa2d2971878468e7,1,26,9,35,5,2005-04-27 16:21:00,2005-04-27 16:21:00
3ebfd4aa29e30187ad7a3f75fa2d2971878468e7...f92a4465813b42b0c116bc9ab2a105ee19f076d8,1,28,9,37,7,2005-04-27 16:21:00,2005-04-27 16:21:00
f92a4465813b42b0c116bc9ab2a105ee19f076d8...91f192a90902952f40cf24be004e8df3508b16c8,1,1,1,2,1,2005-04-27 16:21:00,2005-04-27 16:21:00
91f192a90902952f40cf24be004e8df3508b16c8...c9cddabe997e4342eb7acfc3f5922e85baddb300,1,44,18,62,12,2005-04-27 16:41:15,2005-04-27 16:41:15
c9cddabe997e4342eb7acfc3f5922e85baddb300...4765dd57e6115d6e04e26a652676f02abe9c143d,1,0,2,2,2,2005-04-27 17:21:13,2005-04-27 17:21:13
4765dd57e6115d6e04e26a652676f02abe9c143d...ec8f81160d605505f9117461916e7f69f151f2d2,1,1,0,1,1,2005-04-27 20:46:36,2005-04-27 20:46:36
ec8f81160d605505f9117461916e7f69f151f2d2...d15aa4309cadae5c998c9ce1c45b7a104f3d80f5,1,9,9,18,6,2005-04-27 22:22:02,2005-04-27 22:22:02
d15aa4309cadae5c998c9ce1c45b7a104f3d80f5...ce9be4e4e8f397413ff5d87cda458c7e466897b1,1,1,1,2,1,2005-04-27 22:36:01,2005-04-27 22:36:01
ce9be4e4e8f397413ff5d87cda458c7e466897b1...3a663fd9842aaa9e232ab43a811d11f1d7f0b7bc,1,1,1,2,1,2005-04-27 23:25:59,2005-04-27 23:25:59
3a663fd9842aaa9e232ab43a811d11f1d7f0b7bc...a510bfaa8c001413f363e0d0b9c6cf15dbcbb7b3,2,21,1,22,3,2005-04-28 14:46:33,2005-04-28 14:46:33
a510bfaa8c001413f363e0d0b9c6cf15dbcbb7b3...2636f6143751a064e366cb7763d0705b296726e3,3,89,1,90,3,2005-04-28 14:46:33,2005-04-28 14:46:33
2636f6143751a064e366cb7763d0705b296726e3...e9eefa676178a972f055c978cac9a9ae06b6703a,2,43,0,43,4,2005-04-28 14:46:33,2005-04-28 14:46:33
e9eefa676178a972f055c978cac9a9ae06b6703a...c418eda493a7471d2a2a02583b2bc962ff81f7bc,1,34,87,121,14,2005-04-28 14:46:33,2005-04-28 14:46:33
c418eda493a7471d2a2a02583b2bc962ff81f7bc...d5e276884a0780c61d4306f1527047f6c4180ab2,2,4,1,5,2,2005-04-28 14:50:39,2005-04-28 14:50:39
d5e276884a0780c61d4306f1527047f6c4180ab2...2f97813870c73a89b673ea7882f2a078d25c2dcd,1,36,20,56,10,2005-04-28 15:04:39,2005-04-28 15:04:39
2f97813870c73a89b673ea7882f2a078d25c2dcd...91a6eaa05da5627b1238b7168be1d8ae69516383,1,50,60,110,11,2005-04-28 17:13:01,2005-04-28 17:13:01
91a6eaa05da5627b1238b7168be1d8ae69516383...532149d72735b4c5035f73abd06f3995c6303acf,1,24,5,29,7,2005-04-28 17:13:01,2005-04-28 17:13:01
532149d72735b4c5035f73abd06f3995c6303acf...b836825b55d59ea3dde5c495cc03ff9343c2b485,1,2,2,4,2,2005-04-28 17:13:01,2005-04-28 17:13:01
b836825b55d59ea3dde5c495cc03ff9343c2b485...9ff768e9408b2afac5dbb484eb5c301312bdee80,1,97,8,105,10,2005-04-28 18:44:04,2005-04-28 18:44:04
9ff768e9408b2afac5dbb484eb5c301312bdee80...731ab9ccf23b813d1218bd638043bd11af98012f,2,364,1,365,2,2005-04-28 19:16:43,2005-04-28 19:16:43
731ab9ccf23b813d1218bd638043bd11af98012f...0cc087e3044a7ce19d276f736d983ad8344162f6,1,1,1,2,1,2005-04-28 19:22:11,2005-04-28 19:22:11
0cc087e3044a7ce19d276f736d983ad8344162f6...cf9a113d3526c301b380fbd8a5d3b9d74d322c71,1,16,37,53,12,2005-04-28 22:06:25,2005-04-28 22:06:25
cf9a113d3526c301b380fbd8a5d3b9d74d322c71...40469ee9c6a6f4c85df5520ef719bba3d38a64f0,7,45,39,84,13,2005-04-28 23:42:27,2005-04-28 23:42:27
40469ee9c6a6f4c85df5520ef719bba3d38a64f0...db413479f1bb0dabfc613b2b0017ca74aeb5a919,1,25,29,54,9,2005-04-29 05:19:02,2005-04-29 05:19:02
db413479f1bb0dabfc613b2b0017ca74aeb5a919...d840b3b285a0e6d742c687d344ddefd05e02c60a,1,1,1,2,1,2005-04-29 19:08:03,2005-04-29 19:08:03
d840b3b285a0e6d742c687d344ddefd05e02c60a...a3df180138b85a603656582bde6df757095618cf,4,44,38,82,9,2005-04-29 21:09:11,2005-04-29 21:09:11
a3df180138b85a603656582bde6df757095618cf...aed7a5a9dab96d1a17be4fadf7685086047178cc,1,1,1,2,1,2005-04-29 21:54:50,2005-04-29 21:54:50
aed7a5a9dab96d1a17be4fadf7685086047178cc...2d280e1c5e6fdcf5428e60219eae14a2c6629c51,2,18,18,36,14,2005-04-29 22:02:43,2005-04-29 22:02:43
2d280e1c5e6fdcf5428e60219eae14a2c6629c51...e515f31896844071f9721f114d289139afa8f662,1,1,2,3,2,2005-04-29 22:04:13,2005-04-29 22:04:13
e515f31896844071f9721f114d289139afa8f662...0fc65a4572625405ff6dd9d8c16d835f2b1ebd49,3,5,5,10,5,2005-04-29 23:25:05,2005-04-29 23:25:05
0fc65a4572625405ff6dd9d8c16d835f2b1ebd49...87fec8fc9e790fedbee0c9fc810dbd1bf006d7b6,2,54,16,70,13,2005-04-30 02:51:04,2005-04-30 02:51:04
87fec8fc9e790fedbee0c9fc810dbd1bf006d7b6...e1a1388d858fa8522f187d3fdea92ff84e21528c,1,8,1,9,1,2005-04-30 03:00:40,2005-04-30 03:00:40
e1a1388d858fa8522f187d3fdea92ff84e21528c...d167f147dc6995e452cdc374ffcd07f5d9abf0bc,2,11,133,144,9,2005-04-30 03:27:04,2005-04-30 03:27:04
d167f147dc6995e452cdc374ffcd07f5d9abf0bc...ecee9d9e793c7573cf3730fb9746527a0a7e94e7,4,191,27,218,10,2005-04-30 16:46:49,2005-04-30 16:46:49
ecee9d9e793c7573cf3730fb9746527a0a7e94e7...9da3acfb1942ef28424ea58068faf6ac3a3fc2c8,1,4,0,4,1,2005-04-30 16:51:03,2005-04-30 16:51:03
9da3acfb1942ef28424ea58068faf6ac3a3fc2c8...b6829693676c882ecb0d8ebc0a3a083e5e38131e,2,10,1,11,2,2005-04-30 16:51:03,2005-04-30 16:51:03
b6829693676c882ecb0d8ebc0a3a083e5e38131e...ae200ee594545be43ed9dfb51c9db8e1a014a8f5,2,5,5,10,3,2005-04-30 16:51:03,2005-04-30 16:51:03
ae200ee594545be43ed9dfb51c9db8e1a014a8f5...4b18242190c40653549ec0663eea211bd87fcaed,1,1,2,3,2,2005-04-30 16:59:31,2005-04-30 16:59:31
4b18242190c40653549ec0663eea211bd87fcaed...9b23b4bc1c64fd4ada4fd932195544cc839e0ff4,2,2,2,4,2,2005-04-30 18:02:21,2005-04-30 18:02:21
9b23b4bc1c64fd4ada4fd932195544cc839e0ff4...3a6a23e67d752e3083a52ad04c20c04e40c148e1,1,18,12,30,3,2005-04-30 18:22:26,2005-04-30 18:22:26
3a6a23e67d752e3083a52ad04c20c04e40c148e1...89967023da94c0d874713284869e1924797d30bb,3,238,106,344,26,2005-04-30 20:19:56,2005-04-30 20:19:56
89967023da94c0d874713284869e1924797d30bb...17710391299af14fc38cdee10cc7cc9d44668329,2,6,6,12,4,2005-04-30 20:59:38,2005-04-30 20:59:38
17710391299af14fc38cdee10cc7cc9d44668329...eaa85129230e568757b39b965beee513c8106b37,1,7,2,9,2,2005-04-30 21:25:02,2005-04-30 21:25:02
eaa85129230e568757b39b965beee513c8106b37...a90588821ac9d3dafc4afa7ebe4e0bc48e9f77c9,1,3,1,4,2,2005-04-30 21:31:28,2005-04-30 21:31:28
a90588821ac9d3dafc4afa7ebe4e0bc48e9f77c9...5e2a78a4101ec1dafb885c989cc0f958c0de9222,1,51,45,96,3,2005-04-30 21:53:12,2005-04-30 21:53:12
5e2a78a4101ec1dafb885c989cc0f958c0de9222...92e2311b6c10bf1e4f3e1231d26a6e71d81c5f47,1,5,1,6,2,2005-04-30 22:21:57,2005-04-30 22:21:57
92e2311b6c10bf1e4f3e1231d26a6e71d81c5f47...7f26664f1f03571cf3bde2fb3d321b9933690638,1,8,2,10,2,2005-04-30 23:18:41,2005-04-30 23:18:41
7f26664f1f03571cf3bde2fb3d321b9933690638...5e7921e7c1a844974469a5f865ebf0001ff06311,1,0,5,5,1,2005-04-30 23:26:56,2005-04-30 23:26:56
5e7921e7c1a844974469a5f865ebf0001ff06311...4250a5e5b1755e45153248217fe1d5550c972c8d,5,114,154,268,22,2005-04-30 23:53:56,2005-04-30 23:53:56
4250a5e5b1755e45153248217fe1d5550c972c8d...a6f3f3b1088a2515255f3fb5a8302d9c9071193b,1,11,6,17,5,2005-05-01 00:59:35,2005-05-01 00:59:35
a6f3f3b1088a2515255f3fb5a8302d9c9071193b...c983370e5e208cca4deda82184478ba445a156e6,1,15,11,26,10,2005-05-01 16:33:12,2005-05-01 16:33:12
c983370e5e208cca4deda82184478ba445a156e6...5d2f8b2753183e6cf2238a6f2d847e54211ba11f,2,62,2,64,2,2005-05-01 16:33:12,2005-05-01 16:33:12
5d2f8b2753183e6cf2238a6f2d847e54211ba11f...21a08dcbe70a79206b76c89fb95e26d3a7fdf1f4,1,18,23,41,8,2005-05-01 16:33:12,2005-05-01 16:33:12
21a08dcbe70a79206b76c89fb95e26d3a7fdf1f4...e2a669bb2e667d2cde998bdbbefe51dd04e2bff1,1,1,1,2,1,2005-05-01 16:33:12,2005-05-01 16:33:12
e2a669bb2e667d2cde998bdbbefe51dd04e2bff1...198b0fb635ed8a007bac0c16eab112c5e2c7995c,1,152,54,206,14,2005-05-01 18:48:34,2005-05-01 18:48:34
198b0fb635ed8a007bac0c16eab112c5e2c7995c...68849b544258cafdf42f3ebe9772ee7a346f7147,2,23,9,32,6,2005-05-01 19:34:56,2005-05-01 19:34:56
68849b544258cafdf42f3ebe9772ee7a346f7147...3c249c950649a37f2871a8b193f01a0640a20aef,16,46,16,62,16,2005-05-01 23:36:56,2005-05-01 23:36:56
3c249c950649a37f2871a8b193f01a0640a20aef...35ad33823e90fb166a6480cdc9195051535e9788,1,62,5,67,3,2005-05-02 01:13:16,2005-05-02 01:13:16
35ad33823e90fb166a6480cdc9195051535e9788...ca4c7db9ef0e3ea95a768defeeaa7bea0f0b3dc6,1,0,44,44,2,2005-05-02 02:16:06,2005-05-02 02:16:06
ca4c7db9ef0e3ea95a768defeeaa7bea0f0b3dc6...11e7d5c594e79258f73c8c2a2e7e90dd60d05ce3,1,12,9,21,3,2005-05-02 02:28:18,2005-05-02 02:28:18
11e7d5c594e79258f73c8c2a2e7e90dd60d05ce3...fa9e9c7bc4d6437537a78517f7f6909340e25ad9,1,1,0,1,1,2005-05-02 02:40:39,2005-05-02 02:40:39
fa9e9c7bc4d6437537a78517f7f6909340e25ad9...90535218ddcf530bfdbae450f92385eeef954ce8,1,10,5,15,9,2005-05-02 04:07:40,2005-05-02 04:07:40
90535218ddcf530bfdbae450f92385eeef954ce8...ee4f439fea8974c4d9de798460eb95a2ac001156,3,12,11,23,8,2005-05-02 04:07:40,2005-05-02 04:07:40
ee4f439fea8974c4d9de798460eb95a2ac001156...dfcb405799fa620028e492299a60438a7b4a35ff,2,112,1,113,3,2005-05-02 04:09:28,2005-05-02 04:09:28
dfcb405799fa620028e492299a60438a7b4a35ff...7fa76eeb75d2062d4e8ba3ac5dab925b0bbac6cd,1,2,4,6,3,2005-05-02 04:09:28,2005-05-02 04:09:28
7fa76eeb75d2062d4e8ba3ac5dab925b0bbac6cd...b02a26cb877319f0367725ce87aead42488714cb,1,41,24,65,9,2005-05-02 04:10:04,2005-05-02 04:10:04
b02a26cb877319f0367725ce87aead42488714cb...bab5583a49bff27c53f9ab22489b7faae21f607d,2,5,5,10,5,2005-05-02 04:23:04,2005-05-02 04:23:04
bab5583a49bff27c53f9ab22489b7faae21f607d...0980d9b3a51d48ed2b1b7d64c0da8a49b552904e,1,1,1,2,1,2005-05-02 04:53:36,2005-05-02 04:53:36
d344532afd3d99c9cdd6d7cfc46bd92ff7def4e8...e1ce417d0cb4bfe719efa07417c690b1ce0326e9,1,1,1,2,1,2010-02-02 15:23:26,2010-01-19 19:51:19
d344532afd3d99c9cdd6d7cfc46bd92ff7def4e8...6da401386ea37f1bda3f6717d7c77fb0e5c351b2,1,2,2,4,2,2010-01-06 22:11:43,2010-01-06 22:11:43
6da401386ea37f1bda3f6717d7c77fb0e5c351b2...2da0969a794eac50401fd25ea072224d4378a5fe,1,26,4,30,10,2010-01-10 12:09:23,2010-01-09 18:55:35
2da0969a794eac50401fd25ea072224d4378a5fe...0a562948ae1fe7130f4e9a29ce4107311ab93b91,1,26,8,34,4,2010-01-10 12:09:26,2010-01-09 18:56:05
0a562948ae1fe7130f4e9a29ce4107311ab93b91...da949cc554304bf9dc2b20ffcd470fb6b8a35576,1,4,1,5,1,2010-01-10 12:09:26,2010-01-09 22:01:39
da949cc554304bf9dc2b20ffcd470fb6b8a35576...6e25f79f353a1c1f454ae0c44aa45ff3ab44551c,1,2,2,4,2,2010-01-12 21:38:21,2010-01-12 21:38:21
6e25f79f353a1c1f454ae0c44aa45ff3ab44551c...12629161a89511847ec5703ca457ee373deb33cb,1,1,1,2,1,2010-01-12 21:38:34,2010-01-12 21:38:34
12629161a89511847ec5703ca457ee373deb33cb...13ea2b5e0786e70780f91637fb82ca18dd03a730,1,104,2,106,8,2010-01-12 22:27:36,2010-01-12 22:04:25
13ea2b5e0786e70780f91637fb82ca18dd03a730...4a6ea5ce301c9844722bfdb9291bd9cb7797d9ed,1,2,0,2,1,2010-01-12 22:27:39,2010-01-12 22:04:56
4a6ea5ce301c9844722bfdb9291bd9cb7797d9ed...6bd910a82155ae3def5cf38acb27d36a192c449e,1,2,2,4,2,2010-01-12 22:34:52,2010-01-12 22:34:52
7530a40ce2006082580865f4db6d32b956ca8dc0...1b9a46849a45f2b0f58d6286957316f720a301b6,1,5,0,5,1,2007-06-08 21:19:16,2007-05-23 21:49:35
7530a40ce2006082580865f4db6d32b956ca8dc0...845b42cb6c1c1e80c4283234ea2162cae809bd50,1,4,1,5,1,2007-06-07 07:19:34,2007-06-07 07:19:34
845b42cb6c1c1e80c4283234ea2162cae809bd50...583e170706f5d69770d0de220286f8f0f73667f3,1,3,2,5,3,2007-06-07 07:37:13,2007-06-07 07:37:13
583e170706f5d69770d0de220286f8f0f73667f3...330f53b8d679ece8363a73ed6f6e211d99cd5fdf,1,2,1,3,1,2007-06-07 07:39:51,2007-06-07 07:39:51
330f53b8d679ece8363a73ed6f6e211d99cd5fdf...6509e19cd1f6b5620d339a2be35b8a160ab30794,1,4,3,7,1,2007-06-07 07:41:53,2007-06-07 07:41:53
6509e19cd1f6b5620d339a2be35b8a160ab30794...68c42153060cab9ea6c16256febcf736a2a710d9,1,1,0,1,1,2007-06-07 10:51:03,2007-06-07 10:51:03
68c42153060cab9ea6c16256febcf736a2a710d9...b0d10df77a1130bdf3b4f59fdc18312432b90823,1,1,3,4,2,2007-06-07 11:09:14,2007-06-07 11:09:14
b0d10df77a1130bdf3b4f59fdc18312432b90823...a52d5c7bc027248fca472a402882586a9eaf59bf,1,1,1,2,1,2007-06-07 11:10:20,2007-06-07 11:10:20
a52d5c7bc027248fca472a402882586a9eaf59bf...f7baba8b092bdbc31196de1095c7779b633e28b1,1,5,0,5,3,2007-06-07 12:11:15,2007-06-07 12:07:01
f7baba8b092bdbc31196de1095c7779b633e28b1...98ad4faf95c1e98d6f1aaccda6d96a00a3cddeed,1,1,1,2,1,2007-06-07 13:08:33,2007-06-07 13:08:33
98ad4faf95c1e98d6f1aaccda6d96a00a3cddeed...db775559c2d866de895cc36532ddff6b1ebbeda9,1,2,2,4,2,2007-06-07 13:13:59,2007-06-07 13:13:59
db775559c2d866de895cc36532ddff6b1ebbeda9...c4b33253c221d928f3edde71123a44765495b31a,1,1,1,2,1,2007-06-07 13:28:04,2007-06-07 13:28:04
c4b33253c221d928f3edde71123a44765495b31a...5e100b5cd7210f8054fd3464872c0366abc3c1dc,1,5,0,5,1,2007-06-07 19:52:12,2007-06-07 19:12:25
5e100b5cd7210f8054fd3464872c0366abc3c1dc...a3fdd57901bfe1014c4a48e13815d80f1f0e8577,1,24,14,38,4,2007-06-07 20:54:32,2007-06-07 20:54:32
a3fdd57901bfe1014c4a48e13815d80f1f0e8577...df450923a2a08c50976f2d241a1c4992cf03b3a7,1,5,5,10,2,2007-06-08 06:49:22,2007-06-08 06:49:22
022fef30facd6865d99b0cfceead7de3d60fe7de...81347223066fee64997cbb731925bc8c1abd35d7,1,31,23,54,24,2007-02-14 02:32:52,2007-02-13 03:48:56
81347223066fee64997cbb731925bc8c1abd35d7...54acdd95b81d3675381a749e7cd7fc14956853c3,1,32,0,32,1,2007-02-14 04:15:25,2007-02-14 04:15:25
54acdd95b81d3675381a749e7cd7fc14956853c3...cdf6e08880b4924fa717bd6ca700081f445c9065,1,5,3,8,4,2007-02-14 04:43:48,2007-02-14 04:43:48
cdf6e08880b4924fa717bd6ca700081f445c9065...5ac58f5ba1392416a911c618abba6d874987a1b0,1,4,4,8,4,2007-02-14 05:10:20,2007-02-14 05:10:20
5ac58f5ba1392416a911c618abba6d874987a1b0...ed3adde081645c5f93685b22d39f2d74e068873d,1,7,0,7,2,2007-02-14 05:28:00,2007-02-14 05:28:00
ed3adde081645c5f93685b22d39f2d74e068873d...26370f73c0e82bd67103e0868f84a44b536ff3fc,1,11,6,17,4,2007-02-14 06:55:16,2007-02-14 06:55:16
26370f73c0e82bd67103e0868f84a44b536ff3fc...101e3ae7a6b041aa86505bfd3e8b901f1dc245c3,1,30,0,30,6,2007-02-15 06:34:40,2007-02-15 06:28:34
101e3ae7a6b041aa86505bfd3e8b901f1dc245c3...b90d479255d3b47e3604493b58e271cb9cd8dccd,1,21,5,26,6,2007-02-16 05:24:03,2007-02-16 05:24:03
b90d479255d3b47e3604493b58e271cb9cd8dccd...372ef954a15c321a1065bf7e764449ce7767277f,1,21,15,36,5,2007-02-18 07:12:32,2007-02-18 07:12:32
372ef954a15c321a1065bf7e764449ce7767277f...ee40599330e75d9266672ed5031b3f75764fea3d,1,1,1,2,1,2007-02-21 05:11:01,2007-02-19 00:06:09
ee40599330e75d9266672ed5031b3f75764fea3d...871f4c97ad7e021d1a0a98c80c5da77fcf70e4af,4,136,10,146,18,2007-02-21 05:11:01,2007-02-19 02:06:48
871f4c97ad7e021d1a0a98c80c5da77fcf70e4af...019f42a4ffe66e35cfe32a18c3def0183e6a0129,1,1,1,2,1,2007-02-21 05:11:02,2007-02-19 02:08:04
019f42a4ffe66e35cfe32a18c3def0183e6a0129...c0f7a6c33da7ec875fb084c9d97e471cd3a14535,1,1,1,2,1,2007-02-21 06:24:57,2007-02-21 06:24:57
c0f7a6c33da7ec875fb084c9d97e471cd3a14535...7391b2e9991e138786a2ac049ce7f276f7abce40,1,0,44,44,1,2007-02-21 06:29:05,2007-02-21 06:29:05
7391b2e9991e138786a2ac049ce7f276f7abce40...981193786fc30b9ee73b9f223a75642b4ed455b9,1,8,8,16,2,2007-02-21 06:33:59,2007-02-21 06:33:59
67c7575947b06a2a9bbdb355357895149bdbd8e5...d647c2ea44110630dd39757bae152029dfa62791,1,8,2,10,6,2007-02-13 00:18:12,2007-02-12 23:20:34
d647c2ea44110630dd39757bae152029dfa62791...92360538739ac7ccff94ff2be4e3907a5136443e,1,23,3,26,6,2007-02-13 00:32:04,2007-02-13 00:28:15
92360538739ac7ccff94ff2be4e3907a5136443e...2055f3b5780daae6ec841cd47cae53358cb8827d,1,13,10,23,9,2007-02-13 00:40:25,2007-02-13 00:19:34
2055f3b5780daae6ec841cd47cae53358cb8827d...1e8b0d486e9b244eb1692886ffb50ef728696c52,1,1,1,2,1,2007-02-13 03:19:45,2007-02-05 11:37:27
1e8b0d486e9b244eb1692886ffb50ef728696c52...07fef5fc1599d11f5750ae2440e0da6616c297b8,1,26,7,33,6,2007-02-13 03:20:08,2007-02-12 17:30:28
5b139a66fcac6ebe6a1ca483ced8cc70f65d3a78...ada7781dc3602e6efc052e5e0da37a63caae0489,2,12,5,17,8,2006-06-17 05:33:46,2006-06-15 21:26:21
ada7781dc3602e6efc052e5e0da37a63caae0489...d8498500ba5cf348577202e0bb7810cbd68fa120,1,3,3,6,1,2006-06-17 05:34:09,2006-06-14 13:01:05
d8498500ba5cf348577202e0bb7810cbd68fa120...b19ee24b22b3c1d08f06e8f868f11d9e8639fd30,2,24,5,29,9,2006-06-17 05:45:11,2006-06-13 06:08:31
b19ee24b22b3c1d08f06e8f868f11d9e8639fd30...71b08148366bbc4d02b3477e7ded35b049206f89,1,16,1,17,5,2006-06-17 05:45:11,2006-06-11 08:12:09
71b08148366bbc4d02b3477e7ded35b049206f89...2f57c69792146e6c178a05edec18ab15d0138ad6,1,28,14,42,4,2006-06-17 05:45:11,2006-06-11 08:12:20
2f57c69792146e6c178a05edec18ab15d0138ad6...8f732649bc4d5619a1b399e5808b3f4c662ad200,1,30,7,37,4,2006-06-17 05:45:11,2006-06-12 11:50:49
8f732649bc4d5619a1b399e5808b3f4c662ad200...e34ef621482a14143187bb99a8e341fad885c5d5,1,107,1,108,4,2006-06-17 05:45:11,2006-06-11 15:45:19
e34ef621482a14143187bb99a8e341fad885c5d5...5996ca0836e21ab4e6be0a16a615eff965f18b8b,1,25,2,27,4,2006-06-17 05:45:12,2006-06-12 08:31:57
5996ca0836e21ab4e6be0a16a615eff965f18b8b...bfbd0bb6ecbbbf75a5caaff6afaf5a6af8fa518e,9,28,27,55,18,2006-06-17 05:45:12,2006-06-11 12:03:28
bfbd0bb6ecbbbf75a5caaff6afaf5a6af8fa518e...9202434cbdfb123f41fc677bbf36ff21f6094fc8,3,8,1,9,5,2006-06-17 05:53:11,2006-06-11 17:57:35
9202434cbdfb123f41fc677bbf36ff21f6094fc8...e968751573a4ded76201a0e4414ec36649a92dda,1,1,1,2,1,2006-06-17 23:06:18,2006-06-17 17:46:40
e968751573a4ded76201a0e4414ec36649a92dda...175fb6c0406e63a10791ab793cdac2acf185eab0,1,1,8,9,1,2006-06-17 23:06:20,2006-06-17 06:53:45
175fb6c0406e63a10791ab793cdac2acf185eab0...f0338bbd820f45df51663342827e5aefc4550bf7,13,89,5,94,14,2006-06-17 23:06:21,2006-06-17 15:02:45
f0338bbd820f45df51663342827e5aefc4550bf7...4839c0b5fa14a09c5559317afe5d16e5c81dd176,17,626,0,626,17,2006-06-17 23:26:20,2006-06-17 22:20:36
4839c0b5fa14a09c5559317afe5d16e5c81dd176...2662dbfa58a2d12d1ab3d240b643b9506f43523b,1,2,0,2,1,2006-06-17 23:27:12,2006-06-12 19:48:35
2662dbfa58a2d12d1ab3d240b643b9506f43523b...ae448e3854d8b6e7e37aa88fa3917f5dd97f3210,1,14,8,22,5,2006-06-18 00:05:36,2006-06-17 23:58:51
4a2139f52f5ee919cc2e9c3812ee4ec20b43ae5a...b74fd579662c9d05db5cfb4b0e2b95f8919b9916,1,247,18,265,22,2005-07-16 11:46:13,2005-07-16 11:46:13
b74fd579662c9d05db5cfb4b0e2b95f8919b9916...14c9dbd69bfed89011f99278c7f293b0d186ffc7,1,137,43,180,29,2005-07-17 01:53:55,2005-07-17 01:53:55
14c9dbd69bfed89011f99278c7f293b0d186ffc7...e2ed4324b0b99fd3cb93bd14b6e1599c6fcbfe23,1,34,19,53,15,2005-07-17 07:39:44,2005-07-17 07:39:44
e2ed4324b0b99fd3cb93bd14b6e1599c6fcbfe23...4f2c2642ca7331e4950e8d6c1d112eef1918c980,1,13,33,46,17,2005-07-17 15:11:44,2005-07-17 15:11:44
4f2c2642ca7331e4950e8d6c1d112eef1918c980...f3b8b3ce3ec672ac096bb1431ea7e609f4624f45,1,18,1,19,3,2005-07-18 16:16:35,2005-07-18 16:16:35
f3b8b3ce3ec672ac096bb1431ea7e609f4624f45...f06548617ddb79d26108a5293c918efd60774f0d,1,32,14,46,9,2005-07-18 18:29:03,2005-07-18 18:29:03
85c1f337be49eaa9a22e42a1c9958deef5ab57c3...f49fb35d0d58271dc7c93c2752ced0d743fdf12e,1,2,0,2,1,2005-06-28 01:26:11,2005-06-28 01:26:11
f49fb35d0d58271dc7c93c2752ced0d743fdf12e...eb7add9f6b220256ef6126399c12f01ca7ca35d6,1,3,3,6,2,2005-06-28 02:10:01,2005-06-28 02:10:01
eb7add9f6b220256ef6126399c12f01ca7ca35d6...cebe403bfe07bda11f2c781698519a2f9efefdd3,1,32,15,47,13,2005-06-28 02:40:21,2005-06-28 01:40:31
cebe403bfe07bda11f2c781698519a2f9efefdd3...d410c0f5a99637e1859bb276409d29e8cde10800,1,27,12,39,4,2005-06-28 02:40:21,2005-06-28 02:03:13
d410c0f5a99637e1859bb276409d29e8cde10800...d6771bd0608e2d141d33c9e2024a4cf03043ef94,1,0,1,1,1,2005-06-28 02:48:02,2005-06-28 02:48:02
d6771bd0608e2d141d33c9e2024a4cf03043ef94...635f67f9437b104be852cadb645006f4e858421f,1,7,2,9,2,2005-06-28 03:10:32,2005-06-28 03:10:32
89ab859e9452cbc8f1f15afab52257e9b789c899...4a30976e285139a6dd9c08b8893fd0b11e84c0c3,1,10,0,10,1,2005-07-29 17:21:19,2005-07-29 02:24:13
4a30976e285139a6dd9c08b8893fd0b11e84c0c3...a05ed8cb0c0179c732cfd7f99437e0a8ed9a8b39,1,40,40,80,30,2005-07-29 17:23:38,2005-07-29 05:33:45
a05ed8cb0c0179c732cfd7f99437e0a8ed9a8b39...6c3b84c81c39a1751545cd3fb70d57249d37e9d7,1,11,0,11,1,2005-07-30 00:21:46,2005-07-29 22:50:30
6c3b84c81c39a1751545cd3fb70d57249d37e9d7...fee8825613001931daaa30d038521ae2a85d5234,1,73,29,102,19,2005-07-30 00:21:47,2005-07-29 06:32:20
fee8825613001931daaa30d038521ae2a85d5234...1df092d211868b3b74f5b3981fad9b195a0bedad,2,32,18,50,15,2005-07-30 00:21:47,2005-07-29 06:53:29
1df092d211868b3b74f5b3981fad9b195a0bedad...e35f9824159bba94eecdf22d198799701ed60940,8,15,12,27,14,2005-07-30 00:21:48,2005-07-29 14:49:14
e35f9824159bba94eecdf22d198799701ed60940...0b124bb4bf8eafae8a4eae9c1fc44bf63da2e62e,3,6,8,14,6,2005-07-30 00:21:49,2005-07-29 09:00:45
0b124bb4bf8eafae8a4eae9c1fc44bf63da2e62e...4d1f11903393bd79998144ce1089ce427a49a2ed,17,17,18,35,18,2005-07-30 00:21:50,2005-07-29 09:01:26
4d1f11903393bd79998144ce1089ce427a49a2ed...5bdac8b3269aea963c3192c93c26c1524def5464,1,38,18,56,8,2005-07-30 00:21:51,2005-07-29 15:48:26
5bdac8b3269aea963c3192c93c26c1524def5464...e468305a954d95a26bfcdec3bc6e4bd477d95676,1,8,66,74,4,2005-07-30 00:21:51,2005-07-29 15:48:50
e468305a954d95a26bfcdec3bc6e4bd477d95676...28818ffada5c811b215b8fef7b61f8ae696abd17,1,57,30,87,15,2005-07-30 00:21:52,2005-07-29 15:50:24
28818ffada5c811b215b8fef7b61f8ae696abd17...dd53c7ab297cc491eb5164198e63d670c7b48530,2,12,2,14,5,2005-07-30 00:21:52,2005-07-29 15:50:51
dd53c7ab297cc491eb5164198e63d670c7b48530...eb3c430a85306d08ad5f1cb3d29f990041bc2457,1,7,0,7,1,2005-07-30 00:21:53,2005-07-29 22:32:43
eb3c430a85306d08ad5f1cb3d29f990041bc2457...623c8a1460125f66274f451691b3576b0d0f7a4c,1,8,7,15,1,2005-07-30 00:21:53,2005-07-29 17:21:53
623c8a1460125f66274f451691b3576b0d0f7a4c...adcd3512f5e499a3cc14b865e83580b8c3d235c1,1,23,2,25,3,2005-07-30 00:21:53,2005-07-29 18:10:46
adcd3512f5e499a3cc14b865e83580b8c3d235c1...9e44f8980b8f41fbeea0a68035865e5778e4dc7d,1,1,1,2,1,2005-07-30 01:38:15,2005-07-30 01:38:15
9e44f8980b8f41fbeea0a68035865e5778e4dc7d...9e95049b129fcc2ee14737ddf1f67fa40c98510c,1,3,1,4,3,2005-07-30 18:10:44,2005-07-30 05:43:06
9e95049b129fcc2ee14737ddf1f67fa40c98510c...8cc6a083198877fc32224b73c61ec6e6cf8a96f5,2,159,1,160,2,2005-07-30 21:03:14,2005-07-30 17:08:20
8cc6a083198877fc32224b73c61ec6e6cf8a96f5...4f7eb2e5a351e0d1f19fd4eab7e92834cc4528c2,1,36,38,74,7,2005-07-31 05:58:21,2005-07-30 22:10:20
4f7eb2e5a351e0d1f19fd4eab7e92834cc4528c2...b2c0bd652a0bd0e0c307968387e2edbb873f7b50,1,8,1,9,3,2005-07-31 06:01:09,2005-07-31 00:14:23
0980d9b3a51d48ed2b1b7d64c0da8a49b552904e...7e8c174a97c45ea87306aad56c762e7752cab324,1,73,16,89,7,2005-05-02 16:06:33,2005-05-02 16:06:33
7e8c174a97c45ea87306aad56c762e7752cab324...f220fb6b84e982417dda30b2fd09a0f1d987d2e4,1,1,1,2,1,2005-05-02 21:56:39,2005-05-02 17:57:02
f220fb6b84e982417dda30b2fd09a0f1d987d2e4...8500349208e6bfd0e8bc67d294bfea93da2328a2,3,57,7,64,5,2005-05-02 23:13:18,2005-05-02 23:13:18
8500349208e6bfd0e8bc67d294bfea93da2328a2...aa03413467a2f2ada900817dc2a8e3904549b5fe,1,1,1,2,1,2005-05-03 04:10:54,2005-05-03 04:10:54
0980d9b3a51d48ed2b1b7d64c0da8a49b552904e...285bf834bea11981ae7c2242e9f087d3effe7de8,1,0,0,0,0,2005-05-02 06:17:28,2005-05-02 06:17:28
285bf834bea11981ae7c2242e9f087d3effe7de8...74400e7175e3dac994e75452973d78f6a42de65e,5,79,52,131,6,2005-05-02 06:45:49,2005-05-02 06:45:49
74400e7175e3dac994e75452973d78f6a42de65e...0ff5bf7cfcb20a6c2404fe7b9cc6ff18e47db812,1,9,0,9,1,2005-05-02 06:50:51,2005-05-02 06:50:51
0ff5bf7cfcb20a6c2404fe7b9cc6ff18e47db812...ee28152d03f2cf4b5e3ebc25f7f03f9654d3aa0d,1,26,38,64,18,2005-05-02 06:53:32,2005-05-02 06:53:32
b2f166e4e22a53c71dc8b67bd76b07d4539bf746...e2d0a4502f115ee63b8ff96661cfcc8aad075822,1,1,2,3,1,2010-02-02 15:30:11,2010-02-02 15:30:11
e2d0a4502f115ee63b8ff96661cfcc8aad075822...37668a13edbc8bd8f8ac5ecbd5bf839a4171c09b,1,19,2,21,2,2010-02-06 02:02:52,2010-02-06 00:48:11
37668a13edbc8bd8f8ac5ecbd5bf839a4171c09b...349a70d5cf127222c8a089f116070614ebd18732,1,5,1,6,1,2010-02-06 20:06:45,2010-02-06 20:05:17
349a70d5cf127222c8a089f116070614ebd18732...ec54f0d9adb50baa14eae44a1b8c410f794d32de,2,13,0,13,2,2010-02-06 20:06:45,2010-02-06 03:02:43
ec54f0d9adb50baa14eae44a1b8c410f794d32de...77ba30585213ee8e2be21841ba38786fd5bb26a5,2,21,3,24,3,2010-02-08 20:02:29,2010-02-08 20:00:42
77ba30585213ee8e2be21841ba38786fd5bb26a5...00889c8ca7017d7b9d07d47843e3a3e245a1de26,1,2,1,3,1,2010-02-09 00:42:15,2010-02-09 00:42:15
00889c8ca7017d7b9d07d47843e3a3e245a1de26...6fe986307d983704d3c6b3540f91fa301ff48549,1,2,2,4,2,2010-02-09 00:44:41,2010-02-09 00:44:41
6fe986307d983704d3c6b3540f91fa301ff48549...c6ca48d4dc5b93a7576d2afa66b057f8c8a20718,1,26,2,28,2,2010-02-09 01:31:51,2010-02-09 01:31:51
c6ca48d4dc5b93a7576d2afa66b057f8c8a20718...ae3301876cfea3b7260fbe0840635d508968a047,1,3,3,6,1,2010-02-09 03:02:04,2010-02-09 01:43:09
ae3301876cfea3b7260fbe0840635d508968a047...c00d1d11688dc02f066196ed18783effdb7767ab,4,77,18,95,17,2010-02-13 19:45:04,2010-02-13 19:32:21
69d8cc8b991564daf7b0c71ea50c492bcc0aedeb...5265bfcb06f420841e6304b278b552a4654a4ba0,1,3,3,6,1,2007-06-08 22:31:49,2007-05-23 21:49:35
5265bfcb06f420841e6304b278b552a4654a4ba0...7aded26ce870ba2998e276604fc3c18dad6133bd,1,1,1,2,1,2007-06-09 22:22:30,2007-06-09 22:22:30
7aded26ce870ba2998e276604fc3c18dad6133bd...cae7b732d859b06a4f560271099891f15c5700f6,1,6,4,10,5,2007-06-10 08:57:40,2007-06-10 08:57:40
cae7b732d859b06a4f560271099891f15c5700f6...6e5295c4d3e4e79838d1dd7ab4a8b4965e1c7f96,1,6,1,7,1,2007-06-11 06:50:57,2007-06-11 06:50:57
6e5295c4d3e4e79838d1dd7ab4a8b4965e1c7f96...86fda6a327ce9355ae9eab69fc7a3ec33fb5d7d1,1,1,1,2,1,2007-06-11 06:54:45,2007-06-11 06:54:45
86fda6a327ce9355ae9eab69fc7a3ec33fb5d7d1...a43ff00c7c2981426d06b3621bbf62476aa5ec0d,1,2,0,2,1,2007-06-11 07:59:27,2007-06-11 07:59:27
a43ff00c7c2981426d06b3621bbf62476aa5ec0d...6581de096e8323385b8ec7d467e91927a80ce3b9,1,5,6,11,1,2007-06-11 08:01:58,2007-06-11 08:01:58
6581de096e8323385b8ec7d467e91927a80ce3b9...c3bf3f1301319faab7344e2d8b5ab10a3d648856,1,2,1,3,1,2007-06-11 21:15:38,2007-06-11 20:48:07
c3bf3f1301319faab7344e2d8b5ab10a3d648856...a9d1a27af1f1c997eeef67aed54136ae83355bb9,1,4,1,5,2,2007-06-11 21:28:03,2007-06-11 21:28:03
a9d1a27af1f1c997eeef67aed54136ae83355bb9...81b462a629c2feff9ab1dc43148643aad9571271,1,3,3,6,2,2007-06-11 21:30:23,2007-06-11 21:30:23
81b462a629c2feff9ab1dc43148643aad9571271...e6b711f00e4578eb4b2127af12f73a5fa438f948,1,3,3,6,2,2007-06-11 21:41:41,2007-06-11 21:40:25
e6b711f00e4578eb4b2127af12f73a5fa438f948...27d2d8119bf985a0b59152737316f04f871e03f7,1,26,19,45,2,2007-06-12 12:31:59,2007-06-12 12:31:59
27d2d8119bf985a0b59152737316f04f871e03f7...d7e3868cdfdc73c3de15296ecf32138a8308c07e,1,10,2,12,2,2007-06-12 12:34:46,2007-06-12 12:34:46
d7e3868cdfdc73c3de15296ecf32138a8308c07e...cbae7080a7fe0586255e85e1d14f1011260e8eee,1,1,1,2,1,2007-06-12 13:27:52,2007-06-12 13:27:52
cbae7080a7fe0586255e85e1d14f1011260e8eee...3c699645f589612065b048ecde45a4ea293dc75f,1,1,0,1,1,2007-06-16 11:09:21,2007-06-16 11:09:21
3c699645f589612065b048ecde45a4ea293dc75f...da4a660161cfe9d04c0849d77fa460c6ffc6503c,1,17,3,20,1,2007-06-16 20:06:06,2007-06-08 18:13:55
da4a660161cfe9d04c0849d77fa460c6ffc6503c...6555b2ccfe63913b3e5c8b02e117f0f476307ca2,1,13,3,16,4,2007-06-17 09:25:59,2007-06-17 09:25:34
6555b2ccfe63913b3e5c8b02e117f0f476307ca2...1a2edf4e8dff05fea66daf82c675cfab673c1242,1,6,0,6,1,2007-06-17 13:10:24,2007-06-17 13:10:24
1a2edf4e8dff05fea66daf82c675cfab673c1242...09d89de2e31ed4d62b6ff344e9ad9ef29550121b,1,27,1,28,2,2007-06-20 21:13:20,2007-06-20 21:10:28
09d89de2e31ed4d62b6ff344e9ad9ef29550121b...9ceab36375dfd4088b265033e1de9225b3527cab,1,2,2,4,2,2007-06-21 22:00:34,2007-06-21 22:01:57
981193786fc30b9ee73b9f223a75642b4ed455b9...92446aba47b0e0db28f7b858ea387efcca30ab44,1,19,6,25,6,2007-02-25 07:18:26,2007-02-25 07:18:11
ea44949605781d1947ba1422ee541867e7ce9b81...26cfcfbff451a67412d2570759250a7418f648d2,5,490,2,492,6,2007-02-13 23:15:05,2007-02-13 23:15:05
26cfcfbff451a67412d2570759250a7418f648d2...437b1b20df4b356c9342dac8d38849f24ef44f27,1,1,1,2,1,2007-02-14 00:00:00,2007-02-14 00:00:00
07fef5fc1599d11f5750ae2440e0da6616c297b8...ccf5aa8dd3bc64837a4ca391d0b8bd0e3e481b7e,1,8,8,16,1,2007-02-13 06:00:45,2007-02-13 05:43:44
ccf5aa8dd3bc64837a4ca391d0b8bd0e3e481b7e...7b3fab877d468a51bab6050385ab701697301c62,5,13,2,15,10,2007-02-13 06:17:04,2007-02-13 00:33:37
7b3fab877d468a51bab6050385ab701697301c62...25b51e2c7f6fd220cee2a363297b04a246143372,1,1,1,2,1,2007-02-13 07:06:54,2007-02-13 07:06:54
25b51e2c7f6fd220cee2a363297b04a246143372...acb39f64c6f5f0a3220da787fda9badad9f57554,1,1,1,2,1,2007-02-13 07:22:07,2007-02-13 07:21:34
acb39f64c6f5f0a3220da787fda9badad9f57554...85b1f98871f19617ff7ee8ec245fe4e817a74aa4,1,2,15,17,2,2007-02-13 07:31:00,2007-02-11 21:41:23
85b1f98871f19617ff7ee8ec245fe4e817a74aa4...c2120e5e4b9f7c548b0c49f914bc0881d7cece6f,3,23,0,23,3,2007-02-13 17:19:34,2007-02-13 13:01:42
c2120e5e4b9f7c548b0c49f914bc0881d7cece6f...72f627d2bc860c560e4ea4ee172982b1d38ceca8,1,1,1,2,1,2007-02-13 17:33:09,2007-02-13 14:23:58
72f627d2bc860c560e4ea4ee172982b1d38ceca8...e19b91b4ea8479da3bb3cd600c94d63d04bb8ac2,1,9,12,21,3,2007-02-13 18:12:37,2007-02-13 16:39:01
e19b91b4ea8479da3bb3cd600c94d63d04bb8ac2...bd3a5b5ee5cc627dc278d2028fb017161705fe02,3,3,0,3,3,2007-02-13 18:12:37,2007-02-13 17:23:59
bd3a5b5ee5cc627dc278d2028fb017161705fe02...cec8d146fc020c3815d424ff6d94b3d3a1aaf1ff,1,6,16,22,1,2007-02-13 18:12:37,2007-02-13 16:58:01
07fef5fc1599d11f5750ae2440e0da6616c297b8...207dfa07919baba034291f1d5169f86272839d59,11,14,59,73,15,2007-02-13 03:33:03,2007-02-07 18:37:03
207dfa07919baba034291f1d5169f86272839d59...4cc41a16c15a6d73b13f9211eb8bf49ec869705f,9,2,160,162,10,2007-02-13 03:33:03,2007-02-08 01:03:46
ae448e3854d8b6e7e37aa88fa3917f5dd97f3210...cd112cef999c59a7ca2a96c37b197d303a355924,3,73,11,84,24,2006-06-18 00:08:16,2006-06-13 16:45:44
f06548617ddb79d26108a5293c918efd60774f0d...3c461ffe88a7e2653663d60d9ba9f145621c9b7c,1,133,47,180,22,2005-07-20 13:13:46,2005-07-20 13:13:46
3c461ffe88a7e2653663d60d9ba9f145621c9b7c...7eab29339bb856e314e799bbb57d945299c8cc51,1,29,14,43,9,2005-07-20 16:25:54,2005-07-20 16:25:54
7eab29339bb856e314e799bbb57d945299c8cc51...9d2a52eca1b5ea6c7beb351b45aa2aff092bbd6c,1,363,4,367,6,2005-07-28 03:15:47,2005-07-28 03:15:47
9d2a52eca1b5ea6c7beb351b45aa2aff092bbd6c...4ef175376341b15f25098f0ef0ae77852bd3dc88,1,3,2,5,2,2005-07-28 03:16:51,2005-07-28 03:16:51
4ef175376341b15f25098f0ef0ae77852bd3dc88...73b6a6cbda9cd568e2544f2c7dd6c217e369cc37,1,13,11,24,5,2005-07-28 12:29:59,2005-07-28 07:28:44
73b6a6cbda9cd568e2544f2c7dd6c217e369cc37...c8a4acbf4a7b0f9da3e320877b2b2d12cd58700b,1,84,7,91,11,2005-07-29 14:23:03,2005-07-29 14:23:03
b43d44779bf98977b211256f936d0edda8a9625a...5b35bcd53a1cf12c657197d15db0fb2a5dca7b96,1,1,0,1,1,2005-07-06 15:47:08,2005-07-06 06:52:17
5b35bcd53a1cf12c657197d15db0fb2a5dca7b96...c619ad510b39a07c76cc6a112e4a065e0b8d1b14,1,1,0,1,1,2005-07-06 15:47:08,2005-07-06 06:37:12
c619ad510b39a07c76cc6a112e4a065e0b8d1b14...ce11895d5cc5920e5ef01525aa8355357ee0820e,2,106,111,217,2,2005-07-06 16:26:13,2005-07-06 10:11:24
ce11895d5cc5920e5ef01525aa8355357ee0820e...8904591a9b7be14e14cb91bd4de2014f9c520710,1,247,0,247,1,2005-07-06 16:26:13,2005-07-06 10:11:27
8904591a9b7be14e14cb91bd4de2014f9c520710...f6069c5995114d0fb2fba1140be5db717ff3b396,1,3,1,4,1,2005-07-06 16:26:13,2005-07-06 10:11:29
f6069c5995114d0fb2fba1140be5db717ff3b396...f755494cec27fed8c9693bb91c26762061518b0b,4,8,9,17,9,2005-07-06 16:31:17,2005-07-06 16:31:17
f755494cec27fed8c9693bb91c26762061518b0b...7e21c29b56f80e8fd24613207b4e0116659ad5f8,1,4,1,5,4,2005-07-06 16:38:06,2005-07-06 16:38:06
7e21c29b56f80e8fd24613207b4e0116659ad5f8...bce6286670c6735d0ca2fdf582047e0388dfcd84,3,13,15,28,4,2005-07-06 16:56:16,2005-07-06 16:56:16
bce6286670c6735d0ca2fdf582047e0388dfcd84...f79b65aa65b7697a1cae0f895061ce822f410c5d,1,14,0,14,4,2005-07-06 17:08:08,2005-07-06 17:08:08
f79b65aa65b7697a1cae0f895061ce822f410c5d...9e9824ba0e641095f1cbc01c724d8e0a382c0580,1,3,2,5,2,2005-07-06 17:09:58,2005-07-06 17:09:58
9e9824ba0e641095f1cbc01c724d8e0a382c0580...ab580acea4b1b79daaca0c8727b810073a610e2a,2,120,0,120,3,2005-07-06 17:19:04,2005-07-06 16:39:34
ab580acea4b1b79daaca0c8727b810073a610e2a...d2d02a490669320054065556a61c44b9ac851a07,1,7,0,7,3,2005-07-06 17:25:04,2005-07-06 17:25:04
d2d02a490669320054065556a61c44b9ac851a07...d2775a817a19d966ec35a1da9440e2feb55276f4,1,3,7,10,2,2005-07-06 17:28:02,2005-07-06 16:39:34
d2775a817a19d966ec35a1da9440e2feb55276f4...4d3a63ba3a1f80e03312c5ec28734b27583a0756,1,20,0,20,1,2005-07-06 17:29:30,2005-07-06 16:39:35
4d3a63ba3a1f80e03312c5ec28734b27583a0756...ff9206e72c71aa2e51c7cbee911f47b5838a5845,1,1,1,2,1,2005-07-06 17:29:30,2005-07-06 16:39:35
ff9206e72c71aa2e51c7cbee911f47b5838a5845...b2cb94254be7bf8b44c851897dd29a00ce654e3c,3,25,1,26,4,2005-07-06 17:39:58,2005-07-06 08:11:52
b2cb94254be7bf8b44c851897dd29a00ce654e3c...f312de018b48853d166040908b0ba2bf666e26c1,5,6,6,12,6,2005-07-06 17:39:59,2005-07-06 08:21:46
f312de018b48853d166040908b0ba2bf666e26c1...e6c3505b44e943b73a01d9d48b442f8f49b0dfad,1,1,0,1,1,2005-07-06 17:51:43,2005-07-06 17:51:43
e6c3505b44e943b73a01d9d48b442f8f49b0dfad...960cea2dd108b425fdc4470b48f5eb02963a9be9,1,2,3,5,3,2005-07-06 23:52:49,2005-07-06 23:52:49
960cea2dd108b425fdc4470b48f5eb02963a9be9...889adfe31477455b57a17e15436095e744c3f1e7,1,1,1,2,1,2005-07-06 23:55:53,2005-07-06 23:55:53
889adfe31477455b57a17e15436095e744c3f1e7...f573571a218ddf0d48caaef33c8c7e4c59132b5f,1,417,0,417,1,2005-07-07 01:00:28,2005-07-07 00:50:04
f573571a218ddf0d48caaef33c8c7e4c59132b5f...28346d2d3c6e609a618c6c429d865e9d5d50b998,4,7,33,40,7,2005-07-07 01:00:28,2005-07-07 00:50:07
28346d2d3c6e609a618c6c429d865e9d5d50b998...a7336ae514738f159dad314d6674961427f043a6,1,2,4,6,5,2005-07-07 01:03:53,2005-07-07 00:59:13
a7336ae514738f159dad314d6674961427f043a6...84b18a8e63a0036084f2e2f070634219704a98b2,1,3,3,6,3,2005-07-07 01:47:38,2005-07-07 01:26:43
84b18a8e63a0036084f2e2f070634219704a98b2...dd7ba8b4949535c24e604a37709db0e3be9ccbbc,1,1,1,2,1,2005-07-07 01:51:56,2005-07-07 01:51:56
635f67f9437b104be852cadb645006f4e858421f...5db47c2bb3b7e77fd32aeef12b6f6de8d14cb43b,1,69,4,73,3,2005-06-28 15:53:21,2005-06-28 06:58:08
5db47c2bb3b7e77fd32aeef12b6f6de8d14cb43b...f2a06330f0bc259b9c7faa029d2d4dace8f4956b,1,4,6,10,2,2005-06-28 15:53:21,2005-06-28 06:58:45
f2a06330f0bc259b9c7faa029d2d4dace8f4956b...62bb99606d0377fc14f206cbdf95acb57149d87a,2,19,6,25,7,2005-06-28 15:53:22,2005-06-28 06:59:18
62bb99606d0377fc14f206cbdf95acb57149d87a...a69d09436687746a898f86f32c180083f323b616,3,23,14,37,10,2005-06-28 16:58:23,2005-06-28 16:58:23
a69d09436687746a898f86f32c180083f323b616...5571be75ebb6c8a1f88b3897d9631279106d8e0f,1,1,1,2,1,2005-06-28 17:15:10,2005-06-28 17:15:10
5571be75ebb6c8a1f88b3897d9631279106d8e0f...4397f0148ad0967cf3a2d794fb3d6b2c7f8738d7,2,21,0,21,2,2005-06-28 18:10:06,2005-06-28 18:10:06
4397f0148ad0967cf3a2d794fb3d6b2c7f8738d7...d22b9290ab6de119d03154844910ae5d963b5f1f,1,15,6,21,8,2005-06-28 18:10:48,2005-06-28 18:10:48
635f67f9437b104be852cadb645006f4e858421f...a57a9493df00b6fbb3699fda8ceedf4ac0783ac6,3,576,360,936,11,2005-06-28 14:48:40,2005-06-28 14:48:40
a57a9493df00b6fbb3699fda8ceedf4ac0783ac6...2a3e1a85b5432b94499db7d7fbe4ec9b65b6c88d,1,48,30,78,22,2005-06-28 17:49:19,2005-06-28 17:49:19
2a3e1a85b5432b94499db7d7fbe4ec9b65b6c88d...f65ae603db8ffc36e25cc835eeffcfe4909c3148,1,8,2,10,3,2005-06-28 17:58:40,2005-06-28 17:58:40
f65ae603db8ffc36e25cc835eeffcfe4909c3148...465416694a98a8f071abf6290c9a2a48d9789a98,1,25,4,29,5,2005-06-28 19:08:15,2005-06-28 19:08:15
465416694a98a8f071abf6290c9a2a48d9789a98...e694dbabbfdb847d6adb33c33ea188b5a8f0c175,1,20,4,24,4,2005-06-28 19:11:23,2005-06-28 19:11:23
e694dbabbfdb847d6adb33c33ea188b5a8f0c175...6c9a0dc2b5fffdb67593ee6bb828fcc578b84207,1,19,15,34,5,2005-06-28 19:21:33,2005-06-28 19:21:33
6c9a0dc2b5fffdb67593ee6bb828fcc578b84207...4abdecbf85151b4881aed4840e84823a112f96a5,1,22,4,26,1,2005-06-30 09:55:57,2005-06-30 09:55:57
4abdecbf85151b4881aed4840e84823a112f96a5...4f7c0caa8f37934fa05f22a48a987a6e14dd0e07,1,1,1,2,1,2005-06-30 10:19:48,2005-06-30 10:19:48
4f7c0caa8f37934fa05f22a48a987a6e14dd0e07...dbc1aeace608ebd9422d86efde000dc11a1563be,1,0,3,3,1,2005-06-30 10:28:31,2005-06-30 10:28:31
dbc1aeace608ebd9422d86efde000dc11a1563be...0fa2824f358febe306861f0cab73d25815372ee4,1,1,1,2,1,2005-06-30 15:23:22,2005-06-30 15:23:22
0fa2824f358febe306861f0cab73d25815372ee4...e371046b6473907aa6d62b7862a3afe9d33561e1,1,6,1,7,1,2005-06-30 20:09:42,2005-06-30 20:09:42
e371046b6473907aa6d62b7862a3afe9d33561e1...4c24e089a33d27e9f15dc746c43a816fabcc060c,1,5,0,5,1,2005-06-30 20:10:32,2005-06-30 20:10:32
4c24e089a33d27e9f15dc746c43a816fabcc060c...2be4fcc345b03910d1a7bf96f640cde4dcacbd6e,1,6,3,9,4,2005-06-30 20:54:01,2005-06-30 20:54:01
2be4fcc345b03910d1a7bf96f640cde4dcacbd6e...f21140605ce0729338aed46ec824c947e56adcc4,1,82,0,82,1,2005-06-30 20:54:33,2005-06-30 20:54:33
f21140605ce0729338aed46ec824c947e56adcc4...1cd3674add10d1e511446f3034a1d233a3da7eab,1,1,1,2,1,2005-07-03 07:43:00,2005-07-03 07:43:00
1cd3674add10d1e511446f3034a1d233a3da7eab...f9714a4a0cd4ed0ccca3833743d98ea874a2232d,2,27,9,36,9,2005-07-03 09:40:44,2005-07-03 09:34:59
f9714a4a0cd4ed0ccca3833743d98ea874a2232d...a92bebe6978edaea2885a627e7bef6f7f8b208c2,1,0,8,8,1,2005-07-03 09:40:45,2005-07-03 09:38:06
a92bebe6978edaea2885a627e7bef6f7f8b208c2...8d0ea3117597933610e02907d14b443f8996ca3b,1,3,1,4,2,2005-07-03 10:26:51,2005-07-03 10:26:51
8d0ea3117597933610e02907d14b443f8996ca3b...34155390a576d8124e0adc864aaf2f11bbf5168b,2,23,3,26,4,2005-07-03 11:02:06,2005-07-03 11:02:06
34155390a576d8124e0adc864aaf2f11bbf5168b...9da07f34931f175402cce70dae9499fa67b84cbc,1,2,2,4,2,2005-07-03 17:03:30,2005-07-03 17:03:30
80bd6f3064a6009cd18a4dab9ce6d29681cec4af...96155e55e175e7fed1d8ebd73557d339f35629d8,4,188,4,192,6,2005-07-31 18:56:44,2005-07-26 05:42:18
96155e55e175e7fed1d8ebd73557d339f35629d8...60036a41e1f25ee3e89142fa92e203dbbc6145cc,2,15,0,15,2,2005-07-31 18:58:43,2005-07-31 00:31:47
60036a41e1f25ee3e89142fa92e203dbbc6145cc...5da5c8f4cf4fb4e1cbccca4e7cebe70b77cf0b00,3,127,2,129,10,2005-07-31 18:58:49,2005-07-30 07:58:28
5da5c8f4cf4fb4e1cbccca4e7cebe70b77cf0b00...a52b41b265969e51c8ddab1bc128928cd880bc3e,1,3,3,6,2,2005-07-31 19:06:22,2005-07-31 19:06:22
a52b41b265969e51c8ddab1bc128928cd880bc3e...9f6cf65e66c441d99f4838b6b74971d48c4efc72,1,2,3,5,3,2005-07-31 23:28:56,2005-07-31 19:59:20
9f6cf65e66c441d99f4838b6b74971d48c4efc72...b1bf95bba26c8de1581f401dcab1f743bad7fc1d,5,186,30,216,13,2005-08-01 06:30:59,2005-07-31 19:17:43
b1bf95bba26c8de1581f401dcab1f743bad7fc1d...bf592c5057a7e5e1dabd65cd1ddd526a4eca6c53,2,135,1,136,12,2005-08-01 06:30:59,2005-08-01 00:53:44
bf592c5057a7e5e1dabd65cd1ddd526a4eca6c53...182005b954d81b2a08162de93511ca238b242bea,1,175,6,181,6,2005-08-01 06:30:59,2005-08-01 00:54:17
182005b954d81b2a08162de93511ca238b242bea...0f2b4c4654a046bc2ccaeafd3340450edf4aeb7e,4,3,181,184,6,2005-08-01 07:41:49,2005-08-01 07:41:49
0f2b4c4654a046bc2ccaeafd3340450edf4aeb7e...c742b813971a415fea6e623de4d9e45286a0a976,1,1,1,2,1,2005-08-01 19:47:19,2005-08-01 14:05:57
c742b813971a415fea6e623de4d9e45286a0a976...7da71deb118f5c04553df0d1036a57df5fd2284e,1,22,6,28,5,2005-08-01 19:47:20,2005-08-01 14:32:58
7da71deb118f5c04553df0d1036a57df5fd2284e...3206014a51bfc8886df1d55bb0bcee65ba6834b3,1,4,6,10,2,2005-08-01 19:47:30,2005-08-01 19:33:05
3206014a51bfc8886df1d55bb0bcee65ba6834b3...ade75a59fd0738757019456e0a5a39d3d1af85d7,1,17,19,36,11,2005-08-01 20:27:08,2005-08-01 14:33:19
ade75a59fd0738757019456e0a5a39d3d1af85d7...9b75e9fa7b2c9bae2d386a380e7f80a7b6c4462e,1,1,1,2,1,2005-08-01 20:27:09,2005-08-01 14:32:37
9b75e9fa7b2c9bae2d386a380e7f80a7b6c4462e...4d8fa916c9ff89613234f41b9222a2b679bce5c3,3,4,4,8,4,2005-08-01 20:28:58,2005-08-01 19:11:53
4d8fa916c9ff89613234f41b9222a2b679bce5c3...bbd14cb0113ca26d679970f4db9ad953fb273e36,2,22,10,32,11,2005-08-01 22:20:14,2005-07-29 12:53:38
bbd14cb0113ca26d679970f4db9ad953fb273e36...541ad6e2a9cfd71dc1e4131fb2b47e3c630417ed,1,1,1,2,1,2005-08-01 22:20:14,2005-08-01 22:19:34
541ad6e2a9cfd71dc1e4131fb2b47e3c630417ed...4b7581f04ce61c6e3a674cc492d67ddd384e5f73,1,1,0,1,1,2005-08-03 05:51:05,2005-08-03 00:24:11
4b7581f04ce61c6e3a674cc492d67ddd384e5f73...72d7121cc00c890c2962a5b4bff06a2af6a15df5,1,1,1,2,1,2005-08-03 05:51:06,2005-08-02 21:18:57
72d7121cc00c890c2962a5b4bff06a2af6a15df5...0bc3cdfc823e48069b778468196d8f5185a452cb,1,5,2,7,3,2005-08-03 05:51:07,2005-08-02 19:20:27
0bc3cdfc823e48069b778468196d8f5185a452cb...19614330ddaf02367a7faf2ff5e09f1f39fd63c4,4,71,37,108,25,2005-08-03 05:51:09,2005-08-02 21:24:22
19614330ddaf02367a7faf2ff5e09f1f39fd63c4...29f3b3de99a9dc08b6ef6946cafaa559a7b4f725,1,2,0,2,1,2005-08-03 05:52:58,2005-08-03 01:27:57
29f3b3de99a9dc08b6ef6946cafaa559a7b4f725...66e481b007e843be54b9ff6a4be6e139c103a695,3,65,1,66,6,2005-08-03 05:53:07,2005-08-02 23:45:48
66e481b007e843be54b9ff6a4be6e139c103a695...1e8be59d14f36128e5eb12cc0457e676bb79690c,5,97,54,151,24,2005-08-03 05:53:09,2005-08-02 23:46:10
1e8be59d14f36128e5eb12cc0457e676bb79690c...70b9829ea73931f7e2f23fbe5f1853e0dca5ca12,3,57,24,81,10,2005-08-03 05:53:11,2005-08-02 23:46:29
70b9829ea73931f7e2f23fbe5f1853e0dca5ca12...83b24437c2c6262eeb1e4b36cd9cbb28331c141a,2,266,0,266,2,2005-08-03 05:53:12,2005-07-31 08:17:25
83b24437c2c6262eeb1e4b36cd9cbb28331c141a...479cec960c20a5022e2cfc7e46c88817d8540758,1,61,0,61,1,2005-08-03 05:53:13,2005-07-31 08:17:25
479cec960c20a5022e2cfc7e46c88817d8540758...6ff3376ca625d0c458e13956fc21b33e6fd6def0,1,1,1,2,1,2005-08-03 05:53:15,2005-07-31 08:17:25
6ff3376ca625d0c458e13956fc21b33e6fd6def0...9133261f1e1be3409eebdfcc90a9c11ff942240c,1,3,13,16,4,2005-08-03 05:53:16,2005-08-01 00:04:24
9133261f1e1be3409eebdfcc90a9c11ff942240c...f3d9f3546b2280aa794922f97501dbf01fc97e38,1,8,10,18,4,2005-08-03 05:53:17,2005-08-01 00:04:24
f3d9f3546b2280aa794922f97501dbf01fc97e38...78488b2c4dda24e35aff51422707e897ca785e08,1,10,1,11,5,2005-08-03 05:53:18,2005-08-01 00:04:24
78488b2c4dda24e35aff51422707e897ca785e08...8037d1a31a60e9645c56a8bebb01d0e13970b93f,1,28,14,42,7,2005-08-03 05:53:22,2005-08-01 00:04:24
8037d1a31a60e9645c56a8bebb01d0e13970b93f...3342d8500f8393ace9030a44496943b6a8de1dc3,1,9,2,11,5,2005-08-03 05:53:23,2005-08-01 00:04:24
3342d8500f8393ace9030a44496943b6a8de1dc3...ca9a7d657101cb88246e1770b29296678601750b,1,2,2,4,2,2005-08-03 05:53:25,2005-08-01 00:04:25
ca9a7d657101cb88246e1770b29296678601750b...e205735da94f6ce44c56f6088b392ba5a3268d77,1,24,11,35,6,2005-08-03 05:53:26,2005-08-03 01:45:22
e205735da94f6ce44c56f6088b392ba5a3268d77...a6d62cdd21f0684e1229e4e22f90d9bd4c9517b5,1,13,0,13,1,2005-08-03 05:53:27,2005-08-03 01:45:22
a6d62cdd21f0684e1229e4e22f90d9bd4c9517b5...5825e5b25c557d977b6d877c19edc27322a8bf08,1,12,16,28,13,2005-08-03 05:53:28,2005-08-01 06:05:16
5825e5b25c557d977b6d877c19edc27322a8bf08...40b64d47c3dd071c84445dece4003bb52a194339,1,8,1,9,2,2005-08-03 19:41:12,2005-08-03 19:41:12
40b64d47c3dd071c84445dece4003bb52a194339...ee639140c9d3d7d0c8821e6b7d36c75ae578b326,1,5,1,6,3,2005-08-03 19:57:55,2005-08-03 12:11:00
ee639140c9d3d7d0c8821e6b7d36c75ae578b326...8d5afef0f9b3a252f7b90406d35c295dc698e26d,6,199,0,199,10,2005-08-03 23:27:38,2005-08-02 23:45:21
8d5afef0f9b3a252f7b90406d35c295dc698e26d...f88395ac233572b19f67b3a47b9fe024f397a85b,3,226,94,320,25,2005-08-04 00:16:29,2005-08-03 23:35:29
f88395ac233572b19f67b3a47b9fe024f397a85b...9553d20bd216a9e3b1acc1b9da835ff230302626,1,47,1,48,3,2005-08-04 00:16:30,2005-08-04 00:15:44
9553d20bd216a9e3b1acc1b9da835ff230302626...a765c99a412343c6dd3364044fbcfe49c859e7b6,1,2,2,4,1,2005-08-04 04:41:38,2005-08-03 23:39:48
a765c99a412343c6dd3364044fbcfe49c859e7b6...20f6633112c2a95b4907b4ff2e41e3c450395d34,3,1,51,52,3,2005-08-04 04:41:55,2005-08-04 02:13:52
20f6633112c2a95b4907b4ff2e41e3c450395d34...635d37afff321a9c296ed5d6e0203f2a1c91373f,3,3,5,8,5,2005-08-04 04:41:56,2005-08-04 03:35:37
635d37afff321a9c296ed5d6e0203f2a1c91373f...0dd385c44a309774476b923803eafd9bb73b4804,1,0,50,50,1,2005-08-04 09:46:45,2005-08-04 08:49:03
0dd385c44a309774476b923803eafd9bb73b4804...7f47e72fb3b947db4ffde56a40d999c2fe99ead2,1,2,2,4,1,2005-08-04 09:46:46,2005-08-04 08:17:05
7f47e72fb3b947db4ffde56a40d999c2fe99ead2...b03e2d2091153d239063cfc086a840d74a9eadde,1,1,0,1,1,2005-08-05 04:43:43,2005-08-05 04:43:43
b03e2d2091153d239063cfc086a840d74a9eadde...37fde874c2448ae2cd98abe24df2bd2a50aa2cda,4,51,17,68,13,2005-08-05 07:47:56,2005-08-05 07:47:56
37fde874c2448ae2cd98abe24df2bd2a50aa2cda...9938af6a85dd08436ad373fc07a1ddba8dcfa170,4,235,223,458,11,2005-08-05 07:51:07,2005-08-04 05:15:49
9938af6a85dd08436ad373fc07a1ddba8dcfa170...1215879cdcc508e30415e45ca2c8022f4f3976d6,1,30,8,38,6,2005-08-05 08:25:31,2005-08-04 09:31:15
1215879cdcc508e30415e45ca2c8022f4f3976d6...1eef0b33c6b33d9bc6fcce784b34599931256a36,1,5,2,7,1,2005-08-05 08:27:13,2005-07-26 20:26:52
54c26fb9d0cdff94c7717125d0a222b324bfea8a...92d4c85d248728b1937d01fdd088173753c6994d,1,8,5,13,2,2005-05-03 14:57:56,2005-05-03 14:57:56
92d4c85d248728b1937d01fdd088173753c6994d...aac17941320f7f73e5d411b152bfd041572e8a66,2,39,96,135,18,2005-05-03 18:46:16,2005-05-03 18:46:16
aac17941320f7f73e5d411b152bfd041572e8a66...a31c6d022e2435a514fcc8ca57f9995c4376a986,1,14,1,15,2,2005-05-03 22:16:18,2005-05-03 22:16:18
c00d1d11688dc02f066196ed18783effdb7767ab...9c632ea29ccd58a9967690c2670edec31dc468cd,1,4,0,4,2,2010-06-24 05:53:05,2010-06-24 05:53:05
c00d1d11688dc02f066196ed18783effdb7767ab...448e71e2637e0d7546fb0a2b386e74bc7aa93be8,1,13,4,17,2,2010-05-07 19:59:56,2010-05-07 19:21:25
448e71e2637e0d7546fb0a2b386e74bc7aa93be8...39f5fff0d53bcc68f5c698150d2d3b35eececc27,2,13,1,14,3,2010-05-20 20:40:09,2010-05-20 20:40:09
92446aba47b0e0db28f7b858ea387efcca30ab44...9b28a8b9c2051bf85f71cdec85c142a0ab561f10,1,28,22,50,2,2007-02-26 16:17:11,2007-02-26 16:17:11
9b28a8b9c2051bf85f71cdec85c142a0ab561f10...fd234dfdb7ee1955922ded27ed18df59259193d9,1,6,0,6,1,2007-02-26 16:22:10,2007-02-26 16:22:10
fd234dfdb7ee1955922ded27ed18df59259193d9...51bd9d7b8cf29e0e441531fb0a671cc7093f278b,1,18,0,18,1,2007-02-26 16:47:14,2007-02-26 16:47:14
51bd9d7b8cf29e0e441531fb0a671cc7093f278b...c3e8a0a4ddb7d32970c49117e0386a3b1c182413,1,2,8,10,1,2007-03-01 19:37:34,2007-03-01 19:37:34
c3e8a0a4ddb7d32970c49117e0386a3b1c182413...0b5ea163d21163343579cd6eb9274ccc2190a0fe,1,15,7,22,6,2007-03-06 07:13:23,2007-03-06 07:13:23
5bac4a671907604b5fb4e24ff682d5b0e8431931...e4a15f40bcd9e5679345d3cc74db3162310a7c83,1,12,0,12,1,2007-02-22 00:39:09,2007-02-21 22:59:08
e4a15f40bcd9e5679345d3cc74db3162310a7c83...4917d2a66e8fa8c40ea6082c0fd8b58492c9444e,1,2,1,3,1,2007-02-22 05:47:42,2007-02-22 04:49:51
4917d2a66e8fa8c40ea6082c0fd8b58492c9444e...755b99d81539461645088085ea033a3b36152da5,1,4,0,4,1,2007-02-23 05:02:39,2007-02-22 20:28:12
755b99d81539461645088085ea033a3b36152da5...75b62b489af7b62a5518c3f199d2a2776205e088,1,2,1,3,1,2007-02-23 05:24:34,2007-02-23 04:20:32
437b1b20df4b356c9342dac8d38849f24ef44f27...1b0baf14014a2c98f1a03630294163447ce1976c,1,53,44,97,3,2007-02-28 05:30:38,2007-02-28 04:47:54
437b1b20df4b356c9342dac8d38849f24ef44f27...308efc10d890265a4c62a8b58f025aaf8a1f244d,1,1,1,2,1,2007-02-26 03:08:48,2007-02-26 02:17:15
308efc10d890265a4c62a8b58f025aaf8a1f244d...17cd29b25c0f480a3c6e1dd9617d9c6046e3c280,1,1,1,2,1,2007-02-26 03:08:48,2007-02-26 02:42:07
437b1b20df4b356c9342dac8d38849f24ef44f27...2e0afafebd8c5a1a8cdddb0714073461229ecfef,11,575,4,579,14,2007-02-23 06:30:33,2007-02-22 00:59:14
2e0afafebd8c5a1a8cdddb0714073461229ecfef...fa257b0554d5cea91c2bba98c2017336e0890b36,2,63,49,112,28,2007-02-23 06:30:33,2007-02-22 18:14:14
fa257b0554d5cea91c2bba98c2017336e0890b36...fb9a54150d308345a7027baae528b8fe90bd41f7,1,48,27,75,3,2007-02-23 06:30:33,2007-02-22 20:25:41
fb9a54150d308345a7027baae528b8fe90bd41f7...3d1efd8f1ddc0de423426b5a2a8c6c0a30f1d46e,1,1,1,2,1,2007-02-23 06:30:33,2007-02-23 01:56:31
3d1efd8f1ddc0de423426b5a2a8c6c0a30f1d46e...239296770dae75e21c179733785731ec6ffae1f5,1,4,3,7,3,2007-02-23 06:30:33,2007-02-23 02:17:51
239296770dae75e21c179733785731ec6ffae1f5...64d99e9c5a4a3fb35d803894992764a6e288de5d,1,1,1,2,1,2007-02-24 09:16:58,2007-02-24 09:16:58
437b1b20df4b356c9342dac8d38849f24ef44f27...e52a5de45ab8b61bdddf48a466cb3388b38ad7a4,4,241,1,242,10,2007-02-23 05:03:41,2007-02-23 00:35:03
e52a5de45ab8b61bdddf48a466cb3388b38ad7a4...094e03b039aeaad759227540491c235b3a83b83a,2,13,6,19,6,2007-02-28 01:29:02,2007-02-27 15:20:31
094e03b039aeaad759227540491c235b3a83b83a...f8493ec09bcdbd616084dcfa6f5b8ca0bbb68acf,2,14,9,23,4,2007-02-28 01:29:37,2007-02-27 15:21:04
437b1b20df4b356c9342dac8d38849f24ef44f27...aeabfa072564d9261fa80b1314949bdfd9b78632,1,6,1,7,3,2007-02-23 04:58:36,2007-02-22 19:11:21
437b1b20df4b356c9342dac8d38849f24ef44f27...2b5f9a8c0cff511f2bb0833b1ee02645b79323f4,1,11,10,21,4,2007-02-22 08:31:51,2007-02-22 08:28:49
2b5f9a8c0cff511f2bb0833b1ee02645b79323f4...7b802b86a6734a47c964d84922af2a016d836882,1,10,1,11,3,2007-02-22 08:31:53,2007-02-22 08:30:45
7b802b86a6734a47c964d84922af2a016d836882...b4e1e4a787d3771f617182b3344dcdd9224bd0cb,5,27,11,38,12,2007-02-22 10:02:15,2007-02-10 02:51:40
437b1b20df4b356c9342dac8d38849f24ef44f27...32043c9f8c60fc03b0b6a324c559d98094729323,4,20,5,25,11,2007-02-20 07:05:16,2007-02-14 11:48:14
32043c9f8c60fc03b0b6a324c559d98094729323...8565d2d853d85f246faa9bcde91aba3415a24d54,1,2,2,4,1,2007-02-23 06:06:26,2007-02-15 10:43:56
437b1b20df4b356c9342dac8d38849f24ef44f27...83a5ad61268bbfea7e0d3180528366690f951554,6,55,13,68,18,2007-02-20 03:20:05,2007-02-20 02:01:44
83a5ad61268bbfea7e0d3180528366690f951554...b0e908977ebe43b49badad7fe34bf259dd5d263b,4,9,18,27,10,2007-02-24 08:26:18,2007-02-23 19:03:10
437b1b20df4b356c9342dac8d38849f24ef44f27...c4025103faf02a1b457b945cf5e4e12c97fa72d7,1,21,4,25,2,2007-02-20 03:07:01,2007-02-19 02:14:59
437b1b20df4b356c9342dac8d38849f24ef44f27...59d3f541cfe48345d708330bc19d8a880c80c595,1,16,7,23,5,2007-02-20 03:03:59,2007-02-20 00:08:48
437b1b20df4b356c9342dac8d38849f24ef44f27...e63ccb84e3e29d428548669a7a1206d386a57d6d,1,25,6,31,2,2007-02-18 23:57:36,2007-02-18 08:44:42
437b1b20df4b356c9342dac8d38849f24ef44f27...c5a8c3ecd7fcec68b05b38640d4eac4e1cc7f50f,1,39,18,57,12,2007-02-18 23:45:51,2007-02-18 16:27:24
437b1b20df4b356c9342dac8d38849f24ef44f27...dc7b24364dcbe9ab74d937c92af9999ac1a2db0b,2,103,8,111,6,2007-02-17 21:13:32,2007-02-17 21:12:52
dc7b24364dcbe9ab74d937c92af9999ac1a2db0b...700ea47936e393a217f4174f80a19aa01f698b56,1,3,5,8,1,2007-02-18 08:54:04,2007-02-18 02:12:46
700ea47936e393a217f4174f80a19aa01f698b56...aea1945744214bf84908586af8be1c098a6f346d,1,4,4,8,4,2007-02-20 02:44:21,2007-02-20 01:58:58
aea1945744214bf84908586af8be1c098a6f346d...56185f49d03cae28048146e902089ea366c6cd6c,2,46,28,74,21,2007-02-20 02:44:59,2007-02-20 01:57:29
56185f49d03cae28048146e902089ea366c6cd6c...eac70c4f64a618744e05d4a5be61a356c0011033,1,9,6,15,3,2007-02-20 03:02:12,2007-02-20 02:45:49
eac70c4f64a618744e05d4a5be61a356c0011033...c24e9757e9f608ad3985ee9093d28ca5cd37f052,1,49,2,51,9,2007-02-21 09:14:22,2007-02-21 09:14:22
c24e9757e9f608ad3985ee9093d28ca5cd37f052...6c912f5b04e3216a5487e03235a8454b754a464e,1,8,2,10,2,2007-02-21 09:14:34,2007-02-21 08:58:18
6c912f5b04e3216a5487e03235a8454b754a464e...9987d7c58a847ab1605ae3216ff1ca95b19f0ad1,2,18,9,27,13,2007-02-21 22:42:15,2007-02-21 22:31:10
9987d7c58a847ab1605ae3216ff1ca95b19f0ad1...3e8a5db966c26a0a986161103d59683b909a6c78,2,111,4,115,8,2007-02-22 00:05:56,2007-02-22 00:05:56
3e8a5db966c26a0a986161103d59683b909a6c78...fe6e0eecb03379e6acb742f77b0b5f589a7b7422,1,43,74,117,9,2007-02-22 00:18:45,2007-02-22 00:18:45
437b1b20df4b356c9342dac8d38849f24ef44f27...24424fc2f7cd7b3875fe6863587f47c043ac449d,1,9,0,9,1,2007-02-15 09:52:14,2007-02-15 09:46:27
437b1b20df4b356c9342dac8d38849f24ef44f27...6c510bee2013022fbce52f4b0ec0cc593fc0cc48,8,251,5,256,13,2007-02-14 19:19:22,2007-02-13 19:07:23
6c510bee2013022fbce52f4b0ec0cc593fc0cc48...d7f4633405acf3dc09798a759463c616c7c49dfd,3,6,2,8,3,2007-02-14 19:19:28,2007-02-14 02:16:12
d7f4633405acf3dc09798a759463c616c7c49dfd...634ede32ae7d4c76e96e88f9cd5c1b3a70ea08ac,1,206,0,206,1,2007-02-14 22:54:00,2007-02-14 22:54:00
634ede32ae7d4c76e96e88f9cd5c1b3a70ea08ac...6716027108f426c83038b05baf3f20ceefe6fbd1,2,43,10,53,12,2007-02-17 23:27:47,2007-02-17 20:37:25
437b1b20df4b356c9342dac8d38849f24ef44f27...b2741f63d43a17ce9dafd1f97614bd6dbba72887,1,15,0,15,1,2007-02-14 10:15:42,2007-02-13 15:12:45
437b1b20df4b356c9342dac8d38849f24ef44f27...b74e8cbd80c13257c8c0a68341e9aff9926d31f2,1,105,69,174,4,2007-02-14 05:43:52,2007-01-16 06:56:34
b74e8cbd80c13257c8c0a68341e9aff9926d31f2...d4289fff870a85b1b7e55ead2a5baf98847fc72a,5,227,124,351,6,2007-02-14 05:43:52,2007-01-16 08:23:24
d4289fff870a85b1b7e55ead2a5baf98847fc72a...fbe2687eba70385dab7e3d1f5cdcdfdc11dfe0ec,2,131,51,182,3,2007-02-14 05:43:53,2007-01-16 09:53:29
fbe2687eba70385dab7e3d1f5cdcdfdc11dfe0ec...d1e0ef6cc89e5ef2f914c37719b9c2327e534834,2,49,29,78,3,2007-02-14 05:43:53,2007-01-16 10:31:36
d1e0ef6cc89e5ef2f914c37719b9c2327e534834...86551586da8cba6c06ac04783a656843a4e47f35,2,91,45,136,3,2007-02-14 05:43:53,2007-01-16 21:43:28
86551586da8cba6c06ac04783a656843a4e47f35...46ce8b6d2a88b67a839fb53bfa0b8849215352b5,1,25,2,27,5,2007-02-14 05:43:53,2007-02-13 01:21:39
46ce8b6d2a88b67a839fb53bfa0b8849215352b5...95339912b97279c29bd842fe036c70fca33d0d66,1,2,1,3,1,2007-02-14 05:43:53,2007-02-13 01:21:40
95339912b97279c29bd842fe036c70fca33d0d66...617669da4f80ecf05db7ef1976b56260e2124cc2,1,1,1,2,1,2007-02-14 05:43:53,2007-02-13 01:21:41
617669da4f80ecf05db7ef1976b56260e2124cc2...fee7c2c71d9e35b2f54aa3631072bd7f73bb7b4c,1,4,4,8,3,2007-02-24 12:35:31,2007-02-24 12:35:31
437b1b20df4b356c9342dac8d38849f24ef44f27...a989a5ef2cc30dc623478bd9353c6e1c68e1c5ca,1,12,14,26,5,2007-02-14 04:58:56,2007-02-14 03:25:08
a989a5ef2cc30dc623478bd9353c6e1c68e1c5ca...7a33631f7821b3b91e8bd5b6c8d4e2088ef7582d,1,1,1,2,1,2007-02-14 06:32:36,2007-02-14 06:32:36
7a33631f7821b3b91e8bd5b6c8d4e2088ef7582d...727d38d75753f646b54ae12715eb5934c6cceb41,1,1,0,1,1,2007-02-14 06:42:51,2007-02-14 06:42:51
727d38d75753f646b54ae12715eb5934c6cceb41...4b02c5290e410e6bbb58b507942f722dff9d76a8,1,4,1,5,2,2007-02-14 06:45:22,2007-02-14 06:45:22
437b1b20df4b356c9342dac8d38849f24ef44f27...6132bd5cac91c2a42d67f92fd2e266678c6c8474,1,4,0,4,1,2007-02-14 00:43:24,2007-02-14 00:43:24
c8a4acbf4a7b0f9da3e320877b2b2d12cd58700b...1115fb38df53d1151eba3142f8acb9672ea2c9c4,1,9,5,14,5,2005-07-31 11:35:21,2005-07-31 11:35:21
dd7ba8b4949535c24e604a37709db0e3be9ccbbc...e95ab1edf38a0747832330cfa66763c25af9ad62,1,67,1,68,2,2005-07-07 22:53:35,2005-07-06 20:04:21
e95ab1edf38a0747832330cfa66763c25af9ad62...776566000ffed2ffed5783f2227bb36859c85005,5,11,3,14,4,2005-07-07 22:53:35,2005-07-07 18:39:10
776566000ffed2ffed5783f2227bb36859c85005...1038f0c0a1cde01f7e4af045d3a2acfea69b7c20,1,1,1,2,1,2005-07-07 22:54:57,2005-07-07 22:12:20
dd7ba8b4949535c24e604a37709db0e3be9ccbbc...a9db297485a7b8c641d3cf686d03cb63b774e530,2,60,0,60,4,2005-07-07 20:09:50,2005-07-07 20:09:50
d22b9290ab6de119d03154844910ae5d963b5f1f...9a217f2a725b085982e57b2a900d46128713cb27,2,43,19,62,9,2005-06-28 22:16:25,2005-06-28 21:56:57
9a217f2a725b085982e57b2a900d46128713cb27...8a498a05c3c6b2f53db669b24f36257ab213eb4c,2,76,13,89,13,2005-06-28 22:17:12,2005-06-28 21:58:33
d22b9290ab6de119d03154844910ae5d963b5f1f...a733cb606fed08130317d803956e946f73b0b88e,4,174,73,247,48,2005-06-28 21:21:02,2005-06-28 21:21:02
a733cb606fed08130317d803956e946f73b0b88e...23676d407c63a6f67f8ce3ff192199bda03e6a03,1,16,4,20,6,2005-06-28 21:51:52,2005-06-28 08:49:39
23676d407c63a6f67f8ce3ff192199bda03e6a03...d85a4feeee2cb94ff7060de45a5421f575ddf7b8,1,1,0,1,1,2005-06-28 22:12:25,2005-06-28 21:55:16
9da07f34931f175402cce70dae9499fa67b84cbc...a9174a14fcdac48b23e43db83649847a931fb1d8,1,1,1,2,1,2005-07-05 12:22:53,2005-07-05 12:22:53
9da07f34931f175402cce70dae9499fa67b84cbc...866d13108e969773347828daa9b7f3476ec70cb8,1,1,1,2,1,2005-07-03 21:40:48,2005-07-03 21:40:48
866d13108e969773347828daa9b7f3476ec70cb8...2eb6d82eaa869a1faf4ba3326fd628f76f9f93a8,1,48,33,81,14,2005-07-03 22:43:26,2005-07-03 22:43:26
2eb6d82eaa869a1faf4ba3326fd628f76f9f93a8...79ee456cf222982f7ee3f003440c57b5f7cffa8b,1,23,20,43,8,2005-07-04 11:36:59,2005-07-04 11:36:59
79ee456cf222982f7ee3f003440c57b5f7cffa8b...46e63efc072bc440e4c6aad33d3157b70f5172b6,1,2,1,3,2,2005-07-04 13:28:36,2005-07-04 13:28:36
46e63efc072bc440e4c6aad33d3157b70f5172b6...6e7e37b0bfc921aa1f0cb30560fc128e87a41966,1,1,1,2,1,2005-07-04 13:35:30,2005-07-04 13:35:30
6e7e37b0bfc921aa1f0cb30560fc128e87a41966...28537171e7ec23c8677ea6e77c208583f95caa28,1,5,4,9,4,2005-07-04 15:10:06,2005-07-04 15:10:06
28537171e7ec23c8677ea6e77c208583f95caa28...175011320690864d1483e7eec19da7f71d14dad7,1,3,2,5,2,2005-07-04 15:36:25,2005-07-04 15:36:25
175011320690864d1483e7eec19da7f71d14dad7...fc6e714c838846aad566528f6ada904651c514f9,1,0,2,2,1,2005-07-04 21:18:35,2005-07-04 21:18:35
fc6e714c838846aad566528f6ada904651c514f9...210569f9aecee4d41420b9d9c8780f5c6bbee3cc,1,27,5,32,6,2005-07-05 11:19:59,2005-07-05 11:19:59
638ccfdf0eeabf3d985426308b2a82db6207ae28...b50abe8843006e9856c633b5abeb4eab53b46629,1,41,15,56,5,2005-08-05 08:39:15,2005-07-29 22:37:11
b50abe8843006e9856c633b5abeb4eab53b46629...b32e986cd7a2b3ab4227d63657ef439786a82024,1,2,2,4,2,2005-08-05 20:53:17,2005-08-04 22:31:12
b32e986cd7a2b3ab4227d63657ef439786a82024...4fa1604f10c4878ae2cfbe4b9419a67d6306bb5d,1,1,1,2,1,2005-08-05 23:50:54,2005-08-05 23:50:54
4fa1604f10c4878ae2cfbe4b9419a67d6306bb5d...51b0fca012310910783de76f2eacfd10b0f2f9fc,1,22,5,27,5,2005-08-06 06:05:33,2005-08-06 06:05:33
51b0fca012310910783de76f2eacfd10b0f2f9fc...f2db68eda89f2fbe7e4c1a69a3c10b25ea43667c,2,29,0,29,3,2005-08-06 06:06:58,2005-08-04 20:43:03
f2db68eda89f2fbe7e4c1a69a3c10b25ea43667c...64f8a631e1112efdd4d4236442d59fe871da4bac,1,4,3,7,3,2005-08-06 06:06:58,2005-08-04 20:49:49
64f8a631e1112efdd4d4236442d59fe871da4bac...eca35ecdcaa1448de8cc9ec64590f47a9012264a,1,2,2,4,2,2005-08-06 06:06:58,2005-08-05 15:34:38
eca35ecdcaa1448de8cc9ec64590f47a9012264a...2c6e4771959dbe8116f39587d912f1215c06cd0d,19,58,50,108,39,2005-08-06 06:07:00,2005-08-05 15:05:02
a31c6d022e2435a514fcc8ca57f9995c4376a986...705acc5c943e1147e552daf613c679c07b9772d9,1,1,0,1,1,2005-05-04 14:12:18,2005-05-04 14:12:18
705acc5c943e1147e552daf613c679c07b9772d9...13019d413647c4fbd3bb1564bbdf0d934c0a74d7,5,27,11,38,20,2005-05-04 17:58:15,2005-05-04 17:44:15
13019d413647c4fbd3bb1564bbdf0d934c0a74d7...552e2bd12ee7b3a73345f64cf66b2ce67d9d98dd,1,3,2,5,2,2005-05-05 00:02:16,2005-05-05 00:02:16
552e2bd12ee7b3a73345f64cf66b2ce67d9d98dd...770896e548d0e68ab120507895e1e878c5ee347c,2,5,5,10,4,2005-05-05 00:03:09,2005-05-05 00:03:09
770896e548d0e68ab120507895e1e878c5ee347c...4feb7a016ae0b237af5e667277fa632326a58eac,1,3,1,4,1,2005-05-05 00:26:41,2005-05-05 00:26:41
a31c6d022e2435a514fcc8ca57f9995c4376a986...b2d62f161ebfb628cbe32900213ac18f9aa5bcb4,1,30,7,37,11,2005-05-04 08:26:24,2005-05-04 08:26:24
b2d62f161ebfb628cbe32900213ac18f9aa5bcb4...fd0ffd3ad12d6aa49b8ac2cce7728976d678cc63,1,16,9,25,7,2005-05-04 08:28:45,2005-05-04 08:28:45
fd0ffd3ad12d6aa49b8ac2cce7728976d678cc63...ae7c0c92c0713307986bcd1fb54fa0694aae962a,2,60,5,65,7,2005-05-04 08:33:33,2005-05-04 08:33:33
ae7c0c92c0713307986bcd1fb54fa0694aae962a...6fa28064b0c9da9c2c8696b4eac28ee5beaee469,2,55,40,95,10,2005-05-04 08:38:06,2005-05-04 08:38:06
6fa28064b0c9da9c2c8696b4eac28ee5beaee469...b46f0b6dfd09629645efc59cda76e7e4fad7ca39,3,62,24,86,17,2005-05-04 08:45:24,2005-05-04 08:45:24
b46f0b6dfd09629645efc59cda76e7e4fad7ca39...8a9d32b7e9f3aebd9c322c4613c4608224d09a60,1,9,0,9,1,2005-05-04 17:45:36,2005-05-04 17:45:36
8e770bd389f1810a4b1a53da51e0761ca1435f3a...df2302d77449832eb4167999d747aef57e4bd1fc,1,1,3,4,2,2010-06-24 20:57:58,2010-06-24 20:57:58
df2302d77449832eb4167999d747aef57e4bd1fc...242b20dc0ae51719c32776fb5996c5d6cb463928,1,3,7,10,3,2010-07-21 17:41:38,2010-07-21 16:58:05
242b20dc0ae51719c32776fb5996c5d6cb463928...7f74d65b12ecb5142442c276da805b42e3023a9d,1,1,1,2,1,2010-08-12 15:15:57,2010-08-12 15:15:57
7f74d65b12ecb5142442c276da805b42e3023a9d...11f1511e7650a78709d0d7198bb150cd5392d9d1,1,1,1,2,1,2010-10-21 19:18:51,2010-09-13 19:16:57
11f1511e7650a78709d0d7198bb150cd5392d9d1...7f86ff0fe292a5061757f3ceaffdd992c5feaa9f,1,69,43,112,24,2010-10-21 19:24:51,2010-08-12 16:54:55
7f86ff0fe292a5061757f3ceaffdd992c5feaa9f...9a40fcc2014cc4a85eca71f81ff4c86d49b7a9e2,1,7,7,14,3,2010-10-21 19:28:18,2010-10-21 19:28:18
9a40fcc2014cc4a85eca71f81ff4c86d49b7a9e2...6f4f84fa2a03f441826f323c291ca6566acd0d3a,1,1,1,2,1,2010-11-10 05:20:32,2010-11-09 14:34:49
6f4f84fa2a03f441826f323c291ca6566acd0d3a...915b9894abe94169e60a14e4dc671f6bd15131f3,1,28,0,28,4,2010-11-10 05:20:48,2010-11-10 04:18:36
915b9894abe94169e60a14e4dc671f6bd15131f3...856bea1f71db30339539b0c917d6d7dc32729d0f,1,1,1,2,1,2011-03-01 00:49:42,2011-03-01 00:49:42
856bea1f71db30339539b0c917d6d7dc32729d0f...2793ee6ba6da57d97e9c313741041f7eb2e88974,1,1,0,1,1,2011-03-01 04:48:50,2011-03-01 04:48:50
2793ee6ba6da57d97e9c313741041f7eb2e88974...9153f19f6d340b97c7d581d44884b6318e627155,1,0,0,0,0,2012-02-11 17:28:23,2012-01-29 21:57:36
9153f19f6d340b97c7d581d44884b6318e627155...9e2a55a276df9647d0f79c0695e23e5164835c0d,1,0,0,0,0,2012-02-11 17:28:44,2012-01-29 22:09:15
9e2a55a276df9647d0f79c0695e23e5164835c0d...d3a04e06c77d57978bb5230361c64946232cc346,1,405,241,646,29,2012-02-11 17:29:09,2012-01-29 22:09:58
ee4fd1adfda5b6ebde93b289227986bf884babab...fc746df6476078fa04f821aea00f84bbe13dbf9f,1,6,0,6,1,2007-06-24 09:02:28,2007-06-22 15:49:08
0b5ea163d21163343579cd6eb9274ccc2190a0fe...c7bafad10d294cc0b26ab6171efd89dd9b132f70,1,1,1,2,1,2007-03-12 17:03:47,2007-03-12 17:03:47
c7bafad10d294cc0b26ab6171efd89dd9b132f70...56a7fde16ed060bc4169cc78308f8cf10f1d92a8,1,6,19,25,6,2007-03-12 17:25:58,2007-03-12 17:25:58
56a7fde16ed060bc4169cc78308f8cf10f1d92a8...bb616ddd159508e6c6469626d494a69e28da7032,4,9,135,144,17,2007-03-12 17:26:04,2007-03-12 17:26:04
bb616ddd159508e6c6469626d494a69e28da7032...756d846fea4ac4b3bf0a0aea9fbf721138cf34cc,1,5,7,12,3,2007-03-12 17:26:06,2007-03-12 17:24:10
0b5ea163d21163343579cd6eb9274ccc2190a0fe...0c3b4aac8ecdd039bac663a7d1b6bd373b7e250d,1,5,0,5,1,2007-03-07 00:08:46,2007-03-06 23:44:37
cef19c7af5202c547abe4c8a538ac7b9a4970f0e...ab242f809a9e06ebf935c0512155fc5661ab84ab,1,1,1,2,1,2007-02-25 09:28:44,2007-02-25 09:24:34
ab242f809a9e06ebf935c0512155fc5661ab84ab...128917274943bd0e2dea69862c5a9893a962e350,1,9,5,14,1,2007-02-25 09:29:43,2007-02-25 09:29:43
128917274943bd0e2dea69862c5a9893a962e350...ffa84ffb77b06f9793967fb4f4dd5c946da8e341,1,9,3,12,3,2007-02-25 18:50:12,2007-02-25 17:34:27
ffa84ffb77b06f9793967fb4f4dd5c946da8e341...d2dc6222d4e2f7fa5efc82175d14d60d7b804687,2,60,1,61,2,2007-02-25 18:53:42,2007-02-25 18:53:42
75b62b489af7b62a5518c3f199d2a2776205e088...8ab40a20053aa4a0f8d92d08ece88ff09b771435,1,4,2,6,2,2007-02-24 08:17:38,2007-02-23 17:12:33
8ab40a20053aa4a0f8d92d08ece88ff09b771435...bdd69c2f64d303f99b0f530263c3c04d329c2227,1,11,4,15,1,2007-02-24 08:25:05,2007-02-23 16:03:43
bdd69c2f64d303f99b0f530263c3c04d329c2227...c06d2daa12f72f175e3569bbb2a5f25e5f134f5e,1,21,7,28,10,2007-02-24 08:55:56,2007-02-23 22:27:58
c06d2daa12f72f175e3569bbb2a5f25e5f134f5e...b1440cc8060e79f885691ebeae7ce033bd606a7c,1,1,1,2,1,2007-02-24 09:06:19,2007-02-24 09:05:27
b1440cc8060e79f885691ebeae7ce033bd606a7c...5089277718503a4de7817b5f6754cb03116d5524,1,4,2,6,2,2007-02-24 09:26:52,2007-02-23 11:44:30
0b1f6475570b915c56f380f2bd790ff94e606ef4...4fc970c43884e6215c13d6944a2def1eb2134ed5,2,34,7,41,6,2007-02-26 06:25:30,2007-02-26 06:24:47
4fc970c43884e6215c13d6944a2def1eb2134ed5...c5ddca1fff44896b7e94801da75392ccc234060c,1,13,0,13,1,2007-02-26 07:50:29,2007-02-26 07:26:11
c5ddca1fff44896b7e94801da75392ccc234060c...4e5104c1fc42e440b9f086d428157d45897e1273,1,1,1,2,1,2007-02-26 08:24:41,2007-02-21 05:03:36
4e5104c1fc42e440b9f086d428157d45897e1273...0d9b9ab1284ce125fd49cf7dbf4d28e0540cf035,2,18,12,30,5,2007-02-26 08:26:06,2007-02-26 07:58:50
8ab3e1858676b91bf351537b8afd5599c6640e6f...3d84df43e134d01cb790ddd47a14963ecd110152,1,4,5,9,4,2007-03-02 23:06:25,2007-03-02 19:29:20
3d84df43e134d01cb790ddd47a14963ecd110152...62273826fe977d4c1fa445edf9d0e4ab02274fa2,1,1,1,2,1,2007-03-02 23:14:48,2007-03-02 14:28:00
62273826fe977d4c1fa445edf9d0e4ab02274fa2...43bc820db78be5e3230ae675018a7a7af50ccc88,1,10,2,12,3,2007-03-03 00:38:47,2007-03-03 00:31:16
43bc820db78be5e3230ae675018a7a7af50ccc88...5e00f6faf47b4e456080c792d148bd490efa94c3,1,5,1,6,2,2007-03-03 00:39:18,2007-03-03 00:31:17
7bd59dee5b4b42f2ed233141e33713a7f012dd22...28a4d940443806412effa246ecc7768a21553ec7,2,65,0,65,3,2007-02-24 10:06:18,2007-02-24 02:08:20
efdfd6c8d418a2c12f31cacb50fa8a91b2b868c8...646b3299613f0dd947557bc965660986d024322b,1,1,1,2,1,2007-02-25 22:42:23,2007-02-25 22:34:31
3ddad98b74924d76116d05e7601ab1e163d68500...46d49472f4d49d13ea77179cd072fc1234985eed,2,14,4,18,6,2007-03-05 06:49:10,2007-03-05 06:49:10
46d49472f4d49d13ea77179cd072fc1234985eed...ac3ec0d5558ed6805e55d5b18bd8ee893fda9065,63,731,0,731,63,2007-03-05 08:27:37,2007-03-05 08:09:39
ac3ec0d5558ed6805e55d5b18bd8ee893fda9065...5ced0572217f82f20c4a3460492768e07c08aeea,1,2,2,4,2,2007-03-05 08:45:57,2007-03-05 08:23:42
3ddad98b74924d76116d05e7601ab1e163d68500...c112f689c2c4dfbf2e4dca0e91aa527dd96ab333,11,386,13,399,18,2007-03-05 01:31:29,2007-03-03 23:12:06
c112f689c2c4dfbf2e4dca0e91aa527dd96ab333...33ee4cfb6929c77307887bc2124eaeaf011892dc,8,40,76,116,40,2007-03-05 01:31:29,2007-03-05 00:08:04
4b22f634a3f1752d98e1fc5eee4fa7ce0efe157c...34c6a82b8afca18eab28eeca659e29db0faabc62,1,1,1,2,1,2007-02-21 06:44:35,2007-02-19 14:56:04
34c6a82b8afca18eab28eeca659e29db0faabc62...b97e911643341cb31e6b97029b9ffd96fc675b1d,1,2,0,2,1,2007-02-21 06:45:09,2007-02-17 09:13:10
b97e911643341cb31e6b97029b9ffd96fc675b1d...d2cd696322011eb13125930e747f0d2a7778b992,1,4,0,4,1,2007-02-21 07:55:22,2007-02-20 09:04:32
d2cd696322011eb13125930e747f0d2a7778b992...4a6b9bb60ab3cdb3a749ec43763845a7a60d40d4,2,23,11,34,13,2007-02-21 07:58:27,2007-02-18 17:17:08
4a6b9bb60ab3cdb3a749ec43763845a7a60d40d4...7b9a13ece8a1e7c0fd2a82d4bd4fcf0a9ce0e8c4,1,30,0,30,1,2007-02-21 07:58:37,2007-02-20 20:13:42
7b9a13ece8a1e7c0fd2a82d4bd4fcf0a9ce0e8c4...1918278ea1019553b01297aad2caeed88e9092a4,3,46,17,63,9,2007-02-21 07:58:39,2007-02-20 20:13:43
1918278ea1019553b01297aad2caeed88e9092a4...13e36ec51bee59c6433322b23323b75e9a635d35,1,25,14,39,13,2007-02-21 08:03:37,2007-02-20 14:08:46
13e36ec51bee59c6433322b23323b75e9a635d35...b5a40a57240cc292c32e691d3b3c550f6cf8d98c,1,1,1,2,1,2007-02-21 08:07:24,2007-02-21 05:03:36
0bce7a52f2b723bf6717be2951df7c0a49337592...1e592d65b50dbec87fde9f4ef1b7fd8d90bf7b8c,3,26,1,27,5,2007-02-20 02:34:33,2007-02-19 04:00:00
1e592d65b50dbec87fde9f4ef1b7fd8d90bf7b8c...a53b12c3a22b62c3b47c527f6641bb5ceceb0c1b,1,4,0,4,1,2007-02-20 08:44:35,2007-02-20 08:44:35
ef1a5c2fa8bc67abea6cbacf975ea3260cd40fa3...d976acfd89a7ea539cdaf3fc806308d426b8007a,1,24,16,40,17,2007-02-23 08:57:08,2007-01-04 08:45:03
d976acfd89a7ea539cdaf3fc806308d426b8007a...4a87db0e12df48408501610605bd7cde81c6d20e,1,19,25,44,3,2007-02-23 08:57:08,2007-01-04 09:38:18
4a87db0e12df48408501610605bd7cde81c6d20e...d81bf827192f0af6b1cca64d2cdbaac9b5ca2020,1,173,149,322,58,2007-02-23 08:57:08,2007-01-10 09:22:38
d81bf827192f0af6b1cca64d2cdbaac9b5ca2020...336f1714ae4211f97a33e2f672ec9c3479b4e5ba,1,15,13,28,8,2007-02-23 08:57:08,2007-01-11 10:14:43
336f1714ae4211f97a33e2f672ec9c3479b4e5ba...9b981fc6596e369e82bc744e12afd5e54f2514f0,1,485,0,485,1,2007-02-23 08:57:08,2007-01-11 20:14:21
9b981fc6596e369e82bc744e12afd5e54f2514f0...d2866f9e1fbe24d9ac9e24501a9be07c3c189d34,1,18,20,38,17,2007-02-23 08:57:08,2007-01-11 20:26:16
d2866f9e1fbe24d9ac9e24501a9be07c3c189d34...8164b6525ef6d95d4b656a8f4226f1758a611989,1,31,41,72,11,2007-02-23 08:57:08,2007-01-11 23:35:55
8164b6525ef6d95d4b656a8f4226f1758a611989...e7db67e6f18495332c4d688d3291b05851526a6e,2,29,27,56,8,2007-02-23 08:57:08,2007-01-12 01:09:26
e7db67e6f18495332c4d688d3291b05851526a6e...ad2f90851e03294b5b30f735252001bfc1bd9de3,1,26,0,26,1,2007-02-23 08:57:08,2007-01-12 01:55:50
ad2f90851e03294b5b30f735252001bfc1bd9de3...5969cbe13c7e65db6441632d58e7dee40795a980,1,5,7,12,2,2007-02-23 08:57:09,2007-01-12 01:58:39
5969cbe13c7e65db6441632d58e7dee40795a980...f8c9d1d27f250a7fe13d4d33a1a94604ad355529,1,325,327,652,18,2007-02-23 08:57:09,2007-01-12 10:35:20
f8c9d1d27f250a7fe13d4d33a1a94604ad355529...e7f023c81a03ccdd25ce4b4c7ed77f367c8f7edd,1,28,43,71,15,2007-02-23 08:57:09,2007-01-12 10:49:01
e7f023c81a03ccdd25ce4b4c7ed77f367c8f7edd...c843c464b83237fba65dc46a10133fda9f475cc5,1,1,1,2,1,2007-02-23 08:57:09,2007-01-12 11:07:31
c843c464b83237fba65dc46a10133fda9f475cc5...44320b9e0e279cd1f549e259d00753a02c86c21b,1,233,133,366,91,2007-02-23 08:57:09,2007-01-14 06:35:53
44320b9e0e279cd1f549e259d00753a02c86c21b...396988e0b9cd00d5d13edb157b91dbd5050ef99f,1,0,4,4,2,2007-02-23 08:57:09,2007-01-14 07:00:47
396988e0b9cd00d5d13edb157b91dbd5050ef99f...1c8443b05074cfa466845c4dad98fe962f6dd4c2,1,51,38,89,18,2007-02-23 08:57:09,2007-01-14 10:17:00
1c8443b05074cfa466845c4dad98fe962f6dd4c2...d7ad3bed8cfbaf21aeaaff2cd10e3696d8785b78,1,38,84,122,10,2007-02-23 08:57:09,2007-01-14 11:14:28
d7ad3bed8cfbaf21aeaaff2cd10e3696d8785b78...1ce255dc168cc1fcf849a7c82bdf45753b0dfe09,1,17,495,512,14,2007-02-23 08:57:09,2007-01-15 07:21:16
1ce255dc168cc1fcf849a7c82bdf45753b0dfe09...d05d72e07e49869fe988d4d99e6ac60711570db5,2,3,593,596,17,2007-02-23 08:57:09,2007-01-16 06:59:26
d05d72e07e49869fe988d4d99e6ac60711570db5...706587fc6d56db1ba6c7207d4c0c456bac6f77c2,2,367,279,646,66,2007-02-23 08:57:09,2007-01-19 01:50:01
706587fc6d56db1ba6c7207d4c0c456bac6f77c2...780a2f58e727386ae81223d7a5c16fbc55cfd9fa,1,2,1,3,2,2007-02-23 08:57:09,2007-01-19 02:15:23
780a2f58e727386ae81223d7a5c16fbc55cfd9fa...f6f0987646069bff3a7674aca257fd84f939d960,1,6,4,10,4,2007-02-23 08:57:09,2007-01-19 02:22:18
f6f0987646069bff3a7674aca257fd84f939d960...47e39c55c91993b94824b7a317ebeb965aaeb45a,2,129,6,135,10,2007-02-23 08:57:09,2007-01-21 12:27:09
47e39c55c91993b94824b7a317ebeb965aaeb45a...15710b6f34da26d30079dbc83c797a8335040b75,2,110,92,202,10,2007-02-23 08:57:09,2007-01-22 10:20:33
15710b6f34da26d30079dbc83c797a8335040b75...8b8fc06824cde2b314807e5e3a20e0adfd948cda,2,45,17,62,20,2007-02-23 08:57:09,2007-01-22 19:44:57
8b8fc06824cde2b314807e5e3a20e0adfd948cda...b805b44a923e32251af1abd4e8d7bf5f7d4d8ef6,2,44,7,51,5,2007-02-23 08:57:09,2007-01-22 21:52:04
b805b44a923e32251af1abd4e8d7bf5f7d4d8ef6...a2003abc23a5961534e8a0cc70b881eb78d54328,2,13,1,14,2,2007-02-23 08:57:09,2007-01-22 23:22:50
a2003abc23a5961534e8a0cc70b881eb78d54328...07a1c95045a8c4983d3868f6070d9fa9ba5ff596,2,6,25,31,4,2007-02-23 08:57:09,2007-01-22 23:47:41
07a1c95045a8c4983d3868f6070d9fa9ba5ff596...536c4b09370f3f443fbe87284d2378fd21f94350,1,1,0,1,1,2007-02-23 08:57:09,2007-01-23 19:35:53
536c4b09370f3f443fbe87284d2378fd21f94350...9bf046372b370fba8958ba6ef9dc63b232d7637c,1,14,3,17,3,2007-02-23 08:57:09,2007-01-23 21:03:29
9bf046372b370fba8958ba6ef9dc63b232d7637c...e6434f876097f196acbd9a806637d0f6076752fd,2,89,21,110,12,2007-02-23 08:57:09,2007-01-24 00:29:23
e6434f876097f196acbd9a806637d0f6076752fd...7f578c55af80e9346135004bd47099cbb451f859,2,40,8,48,7,2007-02-23 08:57:10,2007-01-24 10:16:25
7f578c55af80e9346135004bd47099cbb451f859...ef3cfaad19f2587ea4ff7d46574d9118f8d9555e,1,41,9,50,9,2007-02-23 08:57:10,2007-01-24 11:30:57
ef3cfaad19f2587ea4ff7d46574d9118f8d9555e...1492b4245ad735e74f226bd796dc85de4f843739,1,15,0,15,1,2007-02-23 08:57:10,2007-01-25 18:52:36
1492b4245ad735e74f226bd796dc85de4f843739...97f6987afaae239f7e3ae3944e0b29343b43a894,3,42,35,77,17,2007-02-23 08:57:10,2007-01-25 19:53:13
97f6987afaae239f7e3ae3944e0b29343b43a894...e5a0b240fc237af6165b728ae9c79288ef624d3b,2,34,23,57,11,2007-02-23 08:57:10,2007-01-25 23:44:54
e5a0b240fc237af6165b728ae9c79288ef624d3b...3ebe8df7f690281c21e330eec156098c14f4e685,2,68,37,105,17,2007-02-23 08:57:10,2007-01-26 01:35:40
3ebe8df7f690281c21e330eec156098c14f4e685...d3a840dc74d2098c31aac1b89093d847e1d33dd8,3,48,4,52,10,2007-02-23 08:57:10,2007-01-26 09:32:45
d3a840dc74d2098c31aac1b89093d847e1d33dd8...6e8548cca888205a99773a18a73533b2b8dc651d,1,123,82,205,18,2007-02-23 08:57:10,2007-01-27 09:32:00
6e8548cca888205a99773a18a73533b2b8dc651d...6139535436d7ec9808fca75821f14d4d5061f343,1,139,142,281,17,2007-02-23 08:57:10,2007-01-27 22:33:08
6139535436d7ec9808fca75821f14d4d5061f343...21819a370839fdae818975967cef384510e4a8cd,1,8,25,33,4,2007-02-23 08:57:10,2007-01-27 22:38:10
21819a370839fdae818975967cef384510e4a8cd...0af9c9f94ae8a327536679ec1976df65ecd64b6e,1,120,91,211,11,2007-02-23 08:57:10,2007-01-28 06:28:56
0af9c9f94ae8a327536679ec1976df65ecd64b6e...2fa6a23efb200cea814add88ce1d1d193ba83860,1,3,1,4,3,2007-02-23 08:57:10,2007-01-28 12:02:01
2fa6a23efb200cea814add88ce1d1d193ba83860...2b27f6c8847ebee631e7ad17ac9986e461d7674b,2,69,8,77,9,2007-02-23 08:57:10,2007-01-28 12:59:05
2b27f6c8847ebee631e7ad17ac9986e461d7674b...ce2a0f2f9d9fd8eee8eaa1f24a60bdafade80c24,2,8,4,12,4,2007-02-23 08:57:10,2007-01-29 05:34:23
ce2a0f2f9d9fd8eee8eaa1f24a60bdafade80c24...24e22aa8a5762b11a8025c6ad82c945828667d0f,1,12,25,37,7,2007-02-23 08:57:10,2007-01-29 08:07:49
24e22aa8a5762b11a8025c6ad82c945828667d0f...90c1b15da303fa40457e0a9e5c11a57adbfa1879,1,2,2,4,4,2007-02-23 08:57:10,2007-01-30 00:27:08
90c1b15da303fa40457e0a9e5c11a57adbfa1879...f7c3fc4a269ad4f12cc9d97d70e46ba3d5dfdb79,1,9,4,13,5,2007-02-23 08:57:10,2007-01-30 02:34:55
f7c3fc4a269ad4f12cc9d97d70e46ba3d5dfdb79...5d3b7cd5fe5d0410915cc68b641415901e1b113e,1,27,15,42,10,2007-02-23 08:57:10,2007-01-30 03:16:01
5d3b7cd5fe5d0410915cc68b641415901e1b113e...289370578ca5833641fbb59813173ac6db1986d1,2,27,4,31,5,2007-02-23 08:57:10,2007-01-30 08:35:18
289370578ca5833641fbb59813173ac6db1986d1...f0ecca1041aff2e1398edcdaf5f0ce08a96f5f0f,2,39,94,133,9,2007-02-23 08:57:10,2007-01-30 21:11:14
f0ecca1041aff2e1398edcdaf5f0ce08a96f5f0f...8a603774def11e5a90ae2dbbc0c8d4abacdb2d99,2,43,15,58,15,2007-02-23 08:57:10,2007-01-31 10:45:50
8a603774def11e5a90ae2dbbc0c8d4abacdb2d99...9760adccccc0cc4dccc2f28765611550db640ceb,2,24,24,48,14,2007-02-23 08:57:11,2007-01-31 11:06:56
9760adccccc0cc4dccc2f28765611550db640ceb...c7eba7163b452840c8492b9ad87846b44cc98ea7,1,3,0,3,2,2007-02-23 08:57:11,2007-01-31 11:45:28
c7eba7163b452840c8492b9ad87846b44cc98ea7...d4eff2bda5fc28559e96d62604ecaf78a4ff806b,1,37,38,75,9,2007-02-23 08:57:11,2007-01-30 22:04:22
d4eff2bda5fc28559e96d62604ecaf78a4ff806b...47a0b75e01876b6e138d78c9504eebedd45c1283,1,3,2,5,1,2007-02-23 08:57:11,2007-01-31 13:13:30
47a0b75e01876b6e138d78c9504eebedd45c1283...ecc712ddc41999e5f082cb69406d30caa062c6b9,1,22,4,26,8,2007-02-23 08:57:11,2007-01-31 20:28:10
ecc712ddc41999e5f082cb69406d30caa062c6b9...373274f978a48b62549f20059bff630d85533533,1,36,4,40,7,2007-02-23 08:57:11,2007-01-31 21:54:23
373274f978a48b62549f20059bff630d85533533...9c93fee51e26d5db82414317fa169294f3fa94b0,1,23,7,30,9,2007-02-23 08:57:11,2007-02-01 01:22:31
9c93fee51e26d5db82414317fa169294f3fa94b0...ce4b4af7ff36d4e4999da937dffd2f9a3a420277,1,9,15,24,5,2007-02-23 08:57:11,2007-02-01 01:57:36
ce4b4af7ff36d4e4999da937dffd2f9a3a420277...d8115c5104dbee29433a7f33a3e0d3e1738a581e,2,12,10,22,6,2007-02-23 08:57:11,2007-02-01 11:30:31
d8115c5104dbee29433a7f33a3e0d3e1738a581e...88cf4107eb70cdcdc226f2385a3ee54fb428c41d,1,12,1,13,3,2007-02-23 08:57:11,2007-02-01 11:59:07
88cf4107eb70cdcdc226f2385a3ee54fb428c41d...471bc000528cf49928dae8872609b7fefc0c59ee,1,4,1,5,1,2007-02-23 08:57:11,2007-02-01 12:06:27
471bc000528cf49928dae8872609b7fefc0c59ee...ef70de968509c447f5c02f4ba99f1cf0cadf5c1f,1,1,11,12,2,2007-02-23 08:57:11,2007-02-01 12:12:41
ef70de968509c447f5c02f4ba99f1cf0cadf5c1f...502c1bf629154b4a248105b10346a06a6ff07387,1,6,1,7,1,2007-02-23 08:57:11,2007-02-01 12:26:00
502c1bf629154b4a248105b10346a06a6ff07387...9fa00b655cfd67bf344668a0d913f90ec9a8141d,4,16,16,32,13,2007-02-23 08:57:11,2007-02-03 20:49:48
9fa00b655cfd67bf344668a0d913f90ec9a8141d...4bb9ed0466e9ca6b72b3d9c454a743aea862b1f4,2,131,13,144,12,2007-02-23 08:57:11,2007-02-03 21:29:17
4bb9ed0466e9ca6b72b3d9c454a743aea862b1f4...fbcc1737d61f2b83846c59a7cc0d820e09833350,1,49,54,103,7,2007-02-23 08:57:11,2007-02-07 02:35:30
fbcc1737d61f2b83846c59a7cc0d820e09833350...d2ae14346c71d57c57dc7b1c1f8272c09f51ccf9,1,48,7,55,4,2007-02-23 08:57:11,2007-02-07 19:50:16
d2ae14346c71d57c57dc7b1c1f8272c09f51ccf9...e518192f3be92097ba550098dbb69d769ca18429,1,120,28,148,25,2007-02-23 08:57:11,2007-02-08 20:53:57
e518192f3be92097ba550098dbb69d769ca18429...b9dffd8cad737a07d6a05503318c6746ac593f9c,2,18,3,21,3,2007-02-23 08:57:11,2007-02-09 09:28:30
b9dffd8cad737a07d6a05503318c6746ac593f9c...d542aedb9424872474e896a6d20407745d4bd627,1,3,8,11,2,2007-02-23 08:57:11,2007-02-09 10:19:41
d542aedb9424872474e896a6d20407745d4bd627...e20bea654513aa7eba7e356994fa56cc90bb5b6d,1,2,19,21,3,2007-02-23 08:57:11,2007-02-09 10:32:48
e20bea654513aa7eba7e356994fa56cc90bb5b6d...0bed5eaa0edc3a2dfa0d5910ff1fb280539b242d,3,17,16,33,15,2007-02-23 08:57:11,2007-02-09 10:45:03
0bed5eaa0edc3a2dfa0d5910ff1fb280539b242d...4e9f6cc78e5d955bd0faffe76ae9aea6590189f1,1,19,13,32,11,2007-02-23 08:57:12,2007-02-09 20:17:57
4e9f6cc78e5d955bd0faffe76ae9aea6590189f1...9e3cdbd4f2e02bf63bfaa8f6e2747601f117cf2d,1,4,4,8,4,2007-02-23 08:57:12,2007-02-09 20:23:47
9e3cdbd4f2e02bf63bfaa8f6e2747601f117cf2d...74a81227f95b52b1c3f7ac7ba84ac1a6e1708995,2,113,24,137,11,2007-02-23 08:57:12,2007-02-10 21:28:50
74a81227f95b52b1c3f7ac7ba84ac1a6e1708995...490f49ea5899b7aacfb82c0ed5639d722a56704a,1,2,10,12,2,2007-02-23 08:57:12,2007-02-10 21:58:33
490f49ea5899b7aacfb82c0ed5639d722a56704a...8a49ee9759f72ba7c61e035a2ca4b10d8a51c94e,1,105,10,115,14,2007-02-23 08:57:12,2007-02-11 04:46:50
8a49ee9759f72ba7c61e035a2ca4b10d8a51c94e...91b03282b586cc521f9b009ea8273444fb58f2f1,1,35,9,44,9,2007-02-23 08:57:12,2007-02-11 08:51:33
91b03282b586cc521f9b009ea8273444fb58f2f1...93f2689ccdf7b62864aac40097bfd51328fae5b7,1,21,32,53,10,2007-02-23 08:57:12,2007-02-11 09:20:26
93f2689ccdf7b62864aac40097bfd51328fae5b7...97ae091169b233ecd80eb5ef2da80145f8c724f7,2,43,12,55,11,2007-02-23 08:57:12,2007-02-11 23:21:24
97ae091169b233ecd80eb5ef2da80145f8c724f7...26a62d57a27407132d48e91b3c8f455a5fb22e4b,2,134,50,184,32,2007-02-23 08:57:12,2007-02-12 21:25:25
26a62d57a27407132d48e91b3c8f455a5fb22e4b...c3560e535c67b4084852da00507ff4b7fdf98ffc,1,4,0,4,1,2007-02-23 08:57:12,2007-02-13 00:03:32
c3560e535c67b4084852da00507ff4b7fdf98ffc...db03cd24a155a727349a47ce0e5ba3f4c4032cb8,1,83,33,116,20,2007-02-23 08:57:12,2007-02-13 08:38:02
db03cd24a155a727349a47ce0e5ba3f4c4032cb8...2edb9c5cf98e1a65c775ede6fc5b10a15bb94384,2,105,1,106,3,2007-02-23 08:57:12,2006-12-05 05:17:38
2edb9c5cf98e1a65c775ede6fc5b10a15bb94384...a8ae26235ced15d8ce129a8ff72c558b8a567813,1,51,22,73,7,2007-02-23 08:57:12,2007-02-13 22:22:11
a8ae26235ced15d8ce129a8ff72c558b8a567813...ce207c7ad1604c6afd5014051641e40f346a59c6,1,1,1,2,1,2007-02-23 08:57:12,2007-02-13 23:56:08
ce207c7ad1604c6afd5014051641e40f346a59c6...3bc718ba66f8b101b4017e778138660d66829312,1,20,3,23,2,2007-02-23 08:57:12,2007-02-14 01:09:40
3bc718ba66f8b101b4017e778138660d66829312...ccb6b6f5b50bb32f90222a3e801a1901bf0b5657,5,23,15,38,19,2007-02-23 08:57:12,2007-02-14 01:38:58
ccb6b6f5b50bb32f90222a3e801a1901bf0b5657...e98671e5c2067a39759c8f08b79c260a9f0b2771,1,33,25,58,8,2007-02-23 08:57:12,2007-02-14 10:21:19
e98671e5c2067a39759c8f08b79c260a9f0b2771...dadc6d2a0904e55ac5a5a810dffac4d44fff0b66,3,36,24,60,12,2007-02-23 08:57:12,2007-02-14 20:27:41
dadc6d2a0904e55ac5a5a810dffac4d44fff0b66...28710f74ea1f1d8a46c867ddd471dae3d7c3a664,2,31,2,33,3,2007-02-23 08:57:12,2007-02-14 21:32:21
28710f74ea1f1d8a46c867ddd471dae3d7c3a664...b4d57e5ea3349a6bf63c3626f6fb36bac11be3c0,1,35,51,86,8,2007-02-23 08:57:12,2007-02-14 23:10:44
b4d57e5ea3349a6bf63c3626f6fb36bac11be3c0...6af1db447b10c03db4c04a55000efaa9aad38caa,1,7,2,9,5,2007-02-23 08:57:12,2007-02-15 00:04:10
6af1db447b10c03db4c04a55000efaa9aad38caa...e8d120bd5a7e09b24c6fa2245cf429e3411028ee,1,8,7,15,3,2007-02-23 08:57:12,2007-02-15 00:29:52
e8d120bd5a7e09b24c6fa2245cf429e3411028ee...7447b4bc837d2f73fb4cd34f2a44a0cb120c5c39,1,3,2,5,2,2007-02-23 08:57:13,2007-02-15 02:38:46
7447b4bc837d2f73fb4cd34f2a44a0cb120c5c39...60d9c97adf96533e4f02d3fc2fecec998104e8ea,1,8,2,10,2,2007-02-23 08:57:13,2007-02-15 02:47:16
60d9c97adf96533e4f02d3fc2fecec998104e8ea...a836a0e1729d1758b4085cd07fc79cb9acb64908,2,84,123,207,25,2007-02-23 08:57:13,2007-02-15 03:34:56
a836a0e1729d1758b4085cd07fc79cb9acb64908...488a63ec233ce7edc5fd70172c196628b1d6a82b,1,9,2,11,3,2007-02-23 08:57:13,2007-02-15 08:40:42
488a63ec233ce7edc5fd70172c196628b1d6a82b...1e889ef36c45b5554f7e317493ed3f4f901f8d9f,1,26,2,28,6,2007-02-23 08:57:13,2007-02-16 09:45:13
1e889ef36c45b5554f7e317493ed3f4f901f8d9f...905f8b7dfc2c520b91f418ab0f2aecb1c371fbe4,1,63,28,91,16,2007-02-23 08:57:13,2007-02-16 11:22:40
905f8b7dfc2c520b91f418ab0f2aecb1c371fbe4...d6d3346babaf19864ea104b0140279e62f32f7e3,1,6,4,10,4,2007-02-23 08:57:13,2007-02-16 12:05:33
d6d3346babaf19864ea104b0140279e62f32f7e3...b7e5348c7f6369554813207a24cf841f48bd8b23,2,7,1,8,2,2007-02-23 08:57:13,2007-02-16 12:09:28
b7e5348c7f6369554813207a24cf841f48bd8b23...0425ea90889f967c3966ace3e5a85b9a5a44c358,1,20,1,21,3,2007-02-23 08:57:13,2007-02-17 02:45:01
0425ea90889f967c3966ace3e5a85b9a5a44c358...aea736cc6db64219b946adb4ca77f5d17bc7ab77,1,25,1,26,3,2007-02-23 08:57:13,2007-02-17 03:15:21
aea736cc6db64219b946adb4ca77f5d17bc7ab77...62e349d235ecbb20c5338de5d4cbff9ce5c6aa66,1,58,2,60,6,2007-02-23 08:57:13,2007-02-17 03:57:29
62e349d235ecbb20c5338de5d4cbff9ce5c6aa66...befc9adc0ced7d3e1c1316d6420007357d50b202,4,619,140,759,29,2007-02-23 08:57:13,2007-02-17 10:53:07
befc9adc0ced7d3e1c1316d6420007357d50b202...e2b36f6018062cfa44b6952ce73c0609db0af240,2,613,0,613,2,2007-02-23 08:57:13,2007-02-18 09:30:35
e2b36f6018062cfa44b6952ce73c0609db0af240...a81ed0b63edb0d473e17e078de2269b735156a79,1,81,34,115,10,2007-02-23 08:57:13,2007-02-18 10:10:51
a81ed0b63edb0d473e17e078de2269b735156a79...0dfaf0a4e1905a9137d3f2f691620529aeb3b4fa,2,29,8,37,9,2007-02-23 08:57:13,2007-02-18 10:34:09
0dfaf0a4e1905a9137d3f2f691620529aeb3b4fa...1a97a506043691741f25e8967e76123c1114d1fb,1,3,1,4,2,2007-02-23 08:57:13,2007-02-20 08:43:19
1a97a506043691741f25e8967e76123c1114d1fb...5253dc33b713e3de63a25305bfc5e966999a0fbe,1,23,0,23,2,2007-02-23 08:57:13,2007-02-20 09:36:30
5253dc33b713e3de63a25305bfc5e966999a0fbe...18ea92bd818d38c808329abf77ee8f1ca156f446,1,8,0,8,4,2007-02-23 09:01:02,2007-02-22 23:32:29
18ea92bd818d38c808329abf77ee8f1ca156f446...a0d7fe3fcd790876e510c11459df95a0d595e2ad,1,5,0,5,1,2007-02-23 09:01:02,2007-02-22 23:32:30
a0d7fe3fcd790876e510c11459df95a0d595e2ad...f30603fcf37f44942a2173386c0f580a508158df,1,3,7,10,5,2007-02-23 09:26:26,2007-02-23 09:26:26
f30603fcf37f44942a2173386c0f580a508158df...e2c475d91cc65b110a20c9836142a4a7e608a87c,1,1,0,1,1,2007-02-23 09:59:34,2007-02-23 09:57:40
e2c475d91cc65b110a20c9836142a4a7e608a87c...2e5e24803fc92a1da5b941495dc22f888fc612b6,1,5,1,6,3,2007-02-23 10:21:59,2007-02-23 10:21:59
2e5e24803fc92a1da5b941495dc22f888fc612b6...509b4d73b26bb442fd409bbca3772ba22875d310,1,1,0,1,1,2007-02-23 11:11:52,2007-02-23 11:11:52
88459358cdd70246e805b0ee7db7fffb9564f80e...dcf01c6e6b9f63d6f6239a6c6ff9f6373e4c5ff8,1,6,4,10,5,2007-02-27 10:39:51,2007-02-27 10:39:51
dcf01c6e6b9f63d6f6239a6c6ff9f6373e4c5ff8...dec56c8cf1da06fe9ff4c9d3a26f74fb1ddd2fc6,1,13,6,19,4,2007-02-28 00:12:23,2007-02-26 19:37:43
dec56c8cf1da06fe9ff4c9d3a26f74fb1ddd2fc6...c7d68c80002090bddc1eb740d83818aa0a08bbbe,1,2,0,2,1,2007-02-28 07:51:48,2007-02-28 07:51:48
c7d68c80002090bddc1eb740d83818aa0a08bbbe...e6eebbb3ae2f2831fe1319d5acdb6477b8abeadb,2,0,14,14,2,2007-03-01 01:01:00,2007-03-01 01:01:00
e6eebbb3ae2f2831fe1319d5acdb6477b8abeadb...855b34680ea334f05385b3ad58232c3ccdca51d5,1,6,4,10,2,2007-03-01 01:02:18,2007-03-01 01:02:18
855b34680ea334f05385b3ad58232c3ccdca51d5...f98ef68faf81f10f89d9168c21acae71dd50c69e,1,1,0,1,1,2007-03-04 23:36:08,2007-03-04 23:36:08
4b02c5290e410e6bbb58b507942f722dff9d76a8...958545c5a11e5d6745e34df28abdd4a03a1f40fa,1,8,2,10,2,2007-02-14 09:50:28,2007-02-14 09:50:28
958545c5a11e5d6745e34df28abdd4a03a1f40fa...20276889d6610d87c17b058ac0c49601ed950e61,1,10,0,10,4,2007-02-14 18:25:41,2007-02-14 17:10:26
20276889d6610d87c17b058ac0c49601ed950e61...37b73cf97c0480878c4eff576295deae19bad506,1,2,5,7,3,2007-02-14 18:55:24,2007-02-14 18:54:25
37b73cf97c0480878c4eff576295deae19bad506...bd07326dcd46196c14be81c68800ce2d1f4144c4,1,20,0,20,1,2007-02-14 19:05:11,2007-02-14 19:01:41
bd07326dcd46196c14be81c68800ce2d1f4144c4...5faaf24634a4d3a630bd3655cc85fa96f8bc1903,2,10,5,15,4,2007-02-14 21:20:41,2007-02-14 21:20:41
5faaf24634a4d3a630bd3655cc85fa96f8bc1903...78a28df9388cccb1ec85aa5642808f0d3392155f,1,3,5,8,4,2007-02-14 23:22:08,2007-02-14 17:11:40
78a28df9388cccb1ec85aa5642808f0d3392155f...204d409247e7bbc7848569462aa11a87e373c8d6,1,11,10,21,2,2007-02-14 23:25:27,2007-02-14 19:33:04
1115fb38df53d1151eba3142f8acb9672ea2c9c4...8d858d1a3a0f7df94a256dd5f51b94599c36c9f5,1,81,28,109,25,2005-08-04 23:52:16,2005-08-04 23:52:16
e27a56a676a1524036add6067948c647d3093ce8...659cacf5a9a2c7e0eed982e4684f84b47a3e2951,1,3,1,4,2,2005-07-08 00:05:41,2005-07-08 00:05:41
659cacf5a9a2c7e0eed982e4684f84b47a3e2951...924e1219548253a1eaf744c1ea61a8466ec98d63,1,3,1,4,1,2005-07-08 00:59:23,2005-07-08 00:59:23
924e1219548253a1eaf744c1ea61a8466ec98d63...0acfc9725287d21ab7478020b66f39d7ea511804,2,123,1,124,2,2005-07-08 01:07:12,2005-07-05 20:19:05
0acfc9725287d21ab7478020b66f39d7ea511804...acb46f8769dd0031a98a284e06ebc5a09b151bfd,3,4,3,7,3,2005-07-08 17:45:07,2005-07-08 17:45:07
acb46f8769dd0031a98a284e06ebc5a09b151bfd...b33e9666082ce692e64ccfd688dc2a5075566f75,10,40,30,70,19,2005-07-08 17:57:21,2005-07-08 17:57:21
b33e9666082ce692e64ccfd688dc2a5075566f75...6fb737be5e4803feabe0d1b6169de36131936368,4,76,41,117,8,2005-07-08 18:01:10,2005-07-08 06:58:32
6fb737be5e4803feabe0d1b6169de36131936368...b10d0ec7321a6bd6cc1a62f44fee305a0d184dca,1,3,30,33,5,2005-07-08 18:01:10,2005-07-08 07:02:52
b10d0ec7321a6bd6cc1a62f44fee305a0d184dca...99a0a6e09f2c9737d1155f25e8cd4c3bc512a8ea,1,7,8,15,6,2005-07-08 20:56:05,2005-07-08 20:56:05
99a0a6e09f2c9737d1155f25e8cd4c3bc512a8ea...584c6cc91a61ec615419452ca540041be6ba9f38,1,111,17,128,15,2005-07-08 20:58:40,2005-07-08 20:58:40
584c6cc91a61ec615419452ca540041be6ba9f38...51cb06c36de67007f3464d864f63d93213fcaf86,3,4,1,5,2,2005-07-08 21:24:25,2005-07-08 21:24:25
51cb06c36de67007f3464d864f63d93213fcaf86...ba375acff7692cbca16f7cc2e69b71563188ab7f,1,14,2,16,4,2005-07-08 22:46:33,2005-07-08 22:46:33
ba375acff7692cbca16f7cc2e69b71563188ab7f...5c5dc2fb51ad43100881d563a9d07ac1b70a5607,2,0,0,0,0,2005-07-08 22:59:29,2005-07-08 22:59:29
5c5dc2fb51ad43100881d563a9d07ac1b70a5607...26c8a533afac9540e46e7d7707d9179772c6d2c8,4,62,29,91,4,2005-07-08 23:20:59,2005-07-08 23:20:59
26c8a533afac9540e46e7d7707d9179772c6d2c8...113b94751d7f10617e22de0d017033a52b224c68,2,7,5,12,2,2005-07-08 23:22:22,2005-07-08 23:22:22
113b94751d7f10617e22de0d017033a52b224c68...7558ef89edce07555c6436cfcb98c31388dd99b0,1,13,1,14,1,2005-07-09 00:07:12,2005-07-09 00:07:12
7558ef89edce07555c6436cfcb98c31388dd99b0...7672db20c2060f20b01788e4a4289ebc5f818605,11,113,75,188,16,2005-07-09 00:07:37,2005-07-08 23:51:55
7672db20c2060f20b01788e4a4289ebc5f818605...df6e151636992edc5824af53b62b451737b0d24d,2,36,9,45,10,2005-07-09 00:07:37,2005-07-08 23:52:12
df6e151636992edc5824af53b62b451737b0d24d...69a97f1d9bb9455b634564e91f33479ffc35c02b,1,5,26,31,3,2005-07-09 00:07:37,2005-07-08 23:52:28
69a97f1d9bb9455b634564e91f33479ffc35c02b...3ba513c32e7b9102187d94d1c43f33d9559fb334,2,4,5,9,4,2005-07-09 00:38:44,2005-07-09 00:38:44
3ba513c32e7b9102187d94d1c43f33d9559fb334...918c05f1b653d24a03d5b29c576894ede63a6787,1,16,4,20,3,2005-07-09 01:23:06,2005-07-09 01:23:06
918c05f1b653d24a03d5b29c576894ede63a6787...ed616049d76a59df10a9064f8883009ab1329da4,1,242,8,250,7,2005-07-09 01:26:19,2005-07-09 01:26:19
ed616049d76a59df10a9064f8883009ab1329da4...1855c044629a02488baa1bd25ae45341da33bd4e,1,14,8,22,6,2005-07-09 02:48:44,2005-07-09 02:27:15
1855c044629a02488baa1bd25ae45341da33bd4e...d36f7b805eccaf702c0be1c00d034711d0da1f77,1,24,3,27,6,2005-07-09 17:43:02,2005-07-09 17:43:02
d36f7b805eccaf702c0be1c00d034711d0da1f77...167a4a3308f4a1606e268c2204c98d6999046ae0,2,12,5,17,7,2005-07-09 17:52:35,2005-07-09 17:52:35
167a4a3308f4a1606e268c2204c98d6999046ae0...454fbbcde3beb5eb36a4554e5b7074f8d501a6f1,1,15,0,15,3,2005-07-10 22:09:46,2005-07-10 22:09:46
454fbbcde3beb5eb36a4554e5b7074f8d501a6f1...a5eda52bfe8f0afe3abc0c7eaceb487c2ffb7ebb,3,72,21,93,10,2005-07-10 22:39:08,2005-07-10 22:25:38
a5eda52bfe8f0afe3abc0c7eaceb487c2ffb7ebb...d5f1befca880ee64230d876535f0f98c5ea6bb86,2,4,15,19,8,2005-07-10 22:39:08,2005-07-10 22:27:02
d5f1befca880ee64230d876535f0f98c5ea6bb86...0ee19dce2cc21f15fa77e2eb01bdaa3eb490d8ac,1,2,2,4,2,2005-07-10 22:43:54,2005-07-10 22:43:54
0ee19dce2cc21f15fa77e2eb01bdaa3eb490d8ac...4bc5fbf82e225aef0694c91458c31515409455e6,1,1,0,1,1,2005-07-10 23:10:21,2005-07-10 23:10:21
4bc5fbf82e225aef0694c91458c31515409455e6...cf219196a89becccb50ad4a0a667a2814ddae60f,1,2,2,4,2,2005-07-10 23:14:22,2005-07-10 23:14:22
cf219196a89becccb50ad4a0a667a2814ddae60f...a3eb250f996bf5e12376ec88622c4ccaabf20ea8,1,5,3,8,1,2005-07-10 23:16:34,2005-07-10 22:40:43
a3eb250f996bf5e12376ec88622c4ccaabf20ea8...013aab8265a806c8d3c9b040485839091bca30f4,2,5,4,9,3,2005-07-11 17:13:09,2005-07-11 06:55:56
013aab8265a806c8d3c9b040485839091bca30f4...ab90ea5d6e6ef358c8ee5869307c33a939be0e66,1,6,3,9,5,2005-07-11 17:13:09,2005-07-11 07:00:55
ab90ea5d6e6ef358c8ee5869307c33a939be0e66...9c1fa70aaa03f48fb172f9a96d57148f144bc3a9,2,19,2,21,5,2005-07-11 17:20:53,2005-07-11 03:53:44
9c1fa70aaa03f48fb172f9a96d57148f144bc3a9...c1c774e7965ba08061c3fc7bc57aebc7eeb6b40f,2,17,8,25,7,2005-07-11 17:26:07,2005-07-11 14:57:49
c1c774e7965ba08061c3fc7bc57aebc7eeb6b40f...ab6625e06a647c4be555cadc63dfa8f0d4a7f48e,1,5,6,11,2,2005-07-11 21:06:57,2005-07-11 20:30:54
ab6625e06a647c4be555cadc63dfa8f0d4a7f48e...b1de9de2b93510affbbac2a4ffa47208b3beda7a,1,2,2,4,1,2005-07-11 21:20:10,2005-07-11 21:03:09
b1de9de2b93510affbbac2a4ffa47208b3beda7a...e33b2ef8f59a136402ae434cc743408300d69e9a,1,0,3,3,1,2005-07-12 01:03:34,2005-07-12 01:03:34
e33b2ef8f59a136402ae434cc743408300d69e9a...79162bb8ad43aefb23172b9f164ea13ac2b60744,1,5,1,6,2,2005-07-12 01:27:25,2005-07-12 01:27:25
79162bb8ad43aefb23172b9f164ea13ac2b60744...714fff2aa8979c5dd169481909a364a860481f0e,1,1,1,2,1,2005-07-12 01:32:30,2005-07-12 01:32:30
714fff2aa8979c5dd169481909a364a860481f0e...91dcdfd3b5331d955cfb60edf8930f1b5c142905,1,23,0,23,4,2005-07-12 03:44:20,2005-07-12 03:44:20
91dcdfd3b5331d955cfb60edf8930f1b5c142905...37f1a519f2ea0ce912ccd7c623aea992147c3900,2,13,1,14,2,2005-07-12 04:30:23,2005-07-12 04:30:23
37f1a519f2ea0ce912ccd7c623aea992147c3900...f85639c3030de6fd6af0e95e230b6bf7c3ea2086,2,7,7,14,5,2005-07-12 17:07:18,2005-07-12 17:07:18
f85639c3030de6fd6af0e95e230b6bf7c3ea2086...ced7c8482124ba66cfa8e5b9a3f62bf663cb1826,1,1,0,1,1,2005-07-12 17:12:52,2005-07-12 17:12:52
ced7c8482124ba66cfa8e5b9a3f62bf663cb1826...26a2d8ae898f5442904dd2fbf89c5fe34480ea85,2,5,5,10,5,2005-07-12 17:33:06,2005-07-12 17:33:06
26a2d8ae898f5442904dd2fbf89c5fe34480ea85...6aa33f4035d547ac2bd629b1cfd9c46262809d73,4,156,71,227,10,2005-07-12 18:49:27,2005-07-12 18:49:27
6aa33f4035d547ac2bd629b1cfd9c46262809d73...e30e814dbfef7a6e89418863e5d7291a2d53b18f,1,1,1,2,1,2005-07-12 20:04:31,2005-07-12 18:54:21
e30e814dbfef7a6e89418863e5d7291a2d53b18f...d6d8dac032e0e0c55b3edffbefd0abb00ca960fc,1,1,1,2,1,2005-07-12 22:37:25,2005-07-12 21:35:32
d6d8dac032e0e0c55b3edffbefd0abb00ca960fc...8a62a3097c55b22ee4543edef10322775ef62c92,1,1,1,2,1,2005-07-13 19:55:07,2005-07-13 19:45:06
8a62a3097c55b22ee4543edef10322775ef62c92...52f28529f4f90cebdca47f8eacbff5cb20004bed,6,38,1,39,8,2005-07-13 19:55:07,2005-07-13 19:45:51
52f28529f4f90cebdca47f8eacbff5cb20004bed...dda2d79af2d2858b37bab7f6e088d0730c0959d1,11,96,180,276,20,2005-07-13 20:09:17,2005-07-13 19:52:35
dda2d79af2d2858b37bab7f6e088d0730c0959d1...1b668341db6576d8d851473c74388031b319798a,1,49,35,84,10,2005-07-14 00:25:53,2005-07-14 00:25:53
1b668341db6576d8d851473c74388031b319798a...2408cff9f738459019709c8c12d0bd8a5605566f,1,2,2,4,2,2005-07-14 00:27:48,2005-07-14 00:27:48
2408cff9f738459019709c8c12d0bd8a5605566f...2386d65822c912f0889ac600b1698b0659190133,2,91,2,93,9,2005-07-14 01:46:20,2005-07-14 01:46:20
2386d65822c912f0889ac600b1698b0659190133...85c414b5e05d2087e779cdd3587d6ad4cae56e72,1,1,1,2,2,2005-07-14 02:40:06,2005-07-14 02:40:06
85c414b5e05d2087e779cdd3587d6ad4cae56e72...a87e8be2aece466e3f41dfde81c80709e1d56cd3,2,118,1,119,2,2005-07-14 02:45:26,2005-07-14 02:45:26
a87e8be2aece466e3f41dfde81c80709e1d56cd3...5ccdf4cef212183597a0893c23c91da2ded80694,1,1,1,2,2,2005-07-14 03:05:17,2005-07-14 03:05:17
5ccdf4cef212183597a0893c23c91da2ded80694...9b011b2fe5379f76c53f20b964d7a3cecb9d8c79,1,38,0,38,1,2005-07-14 03:42:26,2005-07-14 03:21:54
9b011b2fe5379f76c53f20b964d7a3cecb9d8c79...f16ebbdd1a3660c07e321057f9351e6442c947b8,1,1,1,2,1,2005-07-14 03:42:26,2005-07-14 03:23:40
f16ebbdd1a3660c07e321057f9351e6442c947b8...d46ad9c989c0c4afc9507b48206f26f75a2fbd24,1,5,0,5,2,2005-07-14 03:42:26,2005-07-14 03:25:07
d46ad9c989c0c4afc9507b48206f26f75a2fbd24...6ec311da34cbbc8a571bf889b6ef00c4efb441b5,5,142,3,145,9,2005-07-14 03:42:26,2005-07-14 03:25:54
6ec311da34cbbc8a571bf889b6ef00c4efb441b5...fd7791103078a63d19a1cb7fd7756e7cee046f07,1,1,1,2,1,2005-07-14 03:53:33,2005-07-14 03:26:54
fd7791103078a63d19a1cb7fd7756e7cee046f07...f28198e1367bd11eafbc18425f19c157d06a7e61,1,0,13,13,1,2005-07-14 03:53:33,2005-07-14 03:27:41
f28198e1367bd11eafbc18425f19c157d06a7e61...12dd6e8cb0643231628d0240fdbb4afdef6629ea,2,19,13,32,9,2005-07-14 03:53:33,2005-07-14 03:28:55
12dd6e8cb0643231628d0240fdbb4afdef6629ea...516236ce3fc6208c217e39d2c005cb162ad56486,1,1,1,2,1,2005-07-14 03:55:56,2005-07-14 03:55:56
516236ce3fc6208c217e39d2c005cb162ad56486...5f40520f8c4ca24b29295a36c7a7b6059ad5a888,4,161,1,162,5,2005-07-14 15:54:31,2005-07-14 07:08:05
5f40520f8c4ca24b29295a36c7a7b6059ad5a888...8b3d9dc0e21eb8c7d90173acb330932569e6f52c,4,130,7,137,8,2005-07-14 15:54:31,2005-07-14 07:08:37
8b3d9dc0e21eb8c7d90173acb330932569e6f52c...2a24501363727dad1df47cc0fca47c57fedfd895,3,89,1,90,3,2005-07-14 15:54:31,2005-07-14 07:10:05
2a24501363727dad1df47cc0fca47c57fedfd895...2f2de9b4cdc86fef4465925ae7d5b2dcce8ffc8c,1,42,23,65,8,2005-07-14 15:54:31,2005-07-14 07:10:48
2f2de9b4cdc86fef4465925ae7d5b2dcce8ffc8c...b0966e1010547095ea6fe546dcbbe23a03b62841,1,1,1,2,1,2005-07-14 15:57:14,2005-07-14 15:57:14
b0966e1010547095ea6fe546dcbbe23a03b62841...d1918a728574a627e2a9e0dfc087cfd58e9d8acd,1,2,0,2,1,2005-07-14 16:29:35,2005-07-14 16:29:35
d1918a728574a627e2a9e0dfc087cfd58e9d8acd...d48a72f337fa8edfb7a09e620e75cbbb2a5fe836,1,8,12,20,5,2005-07-14 16:58:45,2005-07-14 16:58:45
d48a72f337fa8edfb7a09e620e75cbbb2a5fe836...0ca14a57f159fc9d0923dbb122705dd8d6a45488,4,54,7,61,9,2005-07-14 18:26:31,2005-07-14 18:26:31
0ca14a57f159fc9d0923dbb122705dd8d6a45488...3e58763542ab858ed2b2c7c704594f420df28c8b,2,7,5,12,6,2005-07-14 18:39:27,2005-07-14 18:39:27
3e58763542ab858ed2b2c7c704594f420df28c8b...a74ba54bd15d63bfb962b584fa96937b06cdfc87,1,2,2,4,2,2005-07-14 20:19:19,2005-07-14 20:19:19
a74ba54bd15d63bfb962b584fa96937b06cdfc87...fdee7d07ba6c79b3e5125e96adbe1d9c3e75ce1d,1,28,2,30,4,2005-07-14 23:43:01,2005-07-14 23:43:01
fdee7d07ba6c79b3e5125e96adbe1d9c3e75ce1d...c0fd1f517efeb67df32b8d4ffa209afab14be436,4,33,23,56,7,2005-07-14 23:55:06,2005-07-14 23:55:06
c0fd1f517efeb67df32b8d4ffa209afab14be436...e68b6f1525c670f474d735009fec419473df0962,7,25,39,64,27,2005-07-15 00:59:17,2005-07-15 00:59:17
e68b6f1525c670f474d735009fec419473df0962...7d80694af1a68ee1915e36bad9b26fa9fe054f06,1,10,10,20,4,2005-07-15 16:27:05,2005-07-15 16:27:05
7d80694af1a68ee1915e36bad9b26fa9fe054f06...e64e1b79d7c50a234e97d59aadc7a4911de91efe,1,11,1,12,4,2005-07-15 16:32:16,2005-07-15 16:32:16
e64e1b79d7c50a234e97d59aadc7a4911de91efe...d289d13625ffa568c3007c3620eaafeb521ac06d,3,12,10,22,3,2005-07-15 17:00:35,2005-07-15 00:50:33
d289d13625ffa568c3007c3620eaafeb521ac06d...7a868a84143c0bad2dce3fd0337320524436da27,1,2,2,4,2,2005-07-15 17:00:35,2005-07-15 00:52:31
7a868a84143c0bad2dce3fd0337320524436da27...aed022ab4ca1055e1c962b73e14dbf41380f84a9,4,130,1,131,5,2005-07-15 17:00:35,2005-07-15 00:55:09
aed022ab4ca1055e1c962b73e14dbf41380f84a9...9153368d1bc296b6dbd0c3606a04a7274c6edc7e,1,4,0,4,1,2005-07-15 17:00:35,2005-07-15 00:57:53
9153368d1bc296b6dbd0c3606a04a7274c6edc7e...ec3f5a46eae8dd36995ff4709360417b55bc2d7d,1,1,0,1,1,2005-07-15 17:00:35,2005-07-15 01:00:15
ec3f5a46eae8dd36995ff4709360417b55bc2d7d...c818566d5c585f9f82dabfbed82edcdd89ba4e5b,2,10,3,13,5,2005-07-15 17:00:35,2005-07-15 01:02:10
c818566d5c585f9f82dabfbed82edcdd89ba4e5b...d7b8a164e4dff577f84eb89d6b1ac036ce973fc9,1,2,1,3,2,2005-07-15 18:38:24,2005-07-15 01:20:25
d7b8a164e4dff577f84eb89d6b1ac036ce973fc9...9dce3c0617ce7065eec53e8e3bb68c571f7d6ee5,1,1,1,2,1,2005-07-15 18:38:24,2005-07-15 01:20:50
9dce3c0617ce7065eec53e8e3bb68c571f7d6ee5...87a81c834bf48f8cbf8778cae78ed553f3bbd32c,2,19,0,19,3,2005-07-15 18:38:24,2005-07-15 01:21:57
87a81c834bf48f8cbf8778cae78ed553f3bbd32c...49ce3d0c4e732bbabb7a2bda1d89d80eeb76d5b6,1,10,4,14,6,2005-07-15 18:38:24,2005-07-15 01:24:23
49ce3d0c4e732bbabb7a2bda1d89d80eeb76d5b6...7421abfdbdfb34ad2719ce4fcf720450918cc4fc,6,121,0,121,6,2005-07-15 18:38:24,2005-07-15 01:26:31
7421abfdbdfb34ad2719ce4fcf720450918cc4fc...e7c1ca4273e3306760f220ea1e6c4685aa7a8b92,1,80,7,87,6,2005-07-15 18:40:14,2005-07-15 07:59:34
e7c1ca4273e3306760f220ea1e6c4685aa7a8b92...3eb5128a108d59be350ce7f43d1579d588158430,1,283,74,357,20,2005-07-15 19:08:15,2005-07-15 18:40:56
3eb5128a108d59be350ce7f43d1579d588158430...71931c19658bd99747ebbb93f0155384ba97df2c,2,2,2,4,2,2005-07-15 21:57:09,2005-07-15 21:57:09
71931c19658bd99747ebbb93f0155384ba97df2c...78d9d414123ad6f4f522ffecbcd9e4a7562948fd,1,2,2,4,2,2005-07-15 23:08:01,2005-07-15 23:08:01
78d9d414123ad6f4f522ffecbcd9e4a7562948fd...eaa9491955ef645bd2d3ca989f17bb80b9896d23,1,43,1,44,6,2005-07-16 03:42:28,2005-07-16 03:42:28
eaa9491955ef645bd2d3ca989f17bb80b9896d23...66e631def8ad6a15eed57bcbde4157e0964ad8fc,1,121,21,142,8,2005-07-16 04:51:57,2005-07-16 04:51:57
66e631def8ad6a15eed57bcbde4157e0964ad8fc...2c38fe4c574812601c8338d8db1ba0d2528b5ae4,1,1,1,2,1,2005-07-16 04:53:22,2005-07-16 03:54:04
2c38fe4c574812601c8338d8db1ba0d2528b5ae4...a232a132eab77815a5f2662e8c064de0d956e553,1,42,19,61,9,2005-07-16 04:53:22,2005-07-16 03:56:12
a232a132eab77815a5f2662e8c064de0d956e553...02d57da4a5c238eff7ea115c69d2e5c977bf1adb,1,38,20,58,10,2005-07-16 05:53:31,2005-07-16 05:53:31
02d57da4a5c238eff7ea115c69d2e5c977bf1adb...f170e4b39d87365cda17b80436ba6db4a2044e88,4,104,32,136,11,2005-07-16 16:23:06,2005-07-16 07:16:24
f170e4b39d87365cda17b80436ba6db4a2044e88...0c04094bc153ef1073524267b4eb49989c7b8ccb,5,130,6,136,10,2005-07-16 16:23:06,2005-07-16 07:17:42
0c04094bc153ef1073524267b4eb49989c7b8ccb...e2418c01b1d351c2f9939ecc4cda2b19df8d6d78,1,29,0,29,2,2005-07-16 16:57:03,2005-07-16 16:57:03
fead2836a16829fba427635f92d7df9acf771a55...e1ddc9768469cb8c25387dc0c75dd4f40ea71096,2,4,4,8,2,2005-06-29 00:12:18,2005-06-28 23:49:28
e1ddc9768469cb8c25387dc0c75dd4f40ea71096...75c660ac9373b588a7815fa922dac02b2e4519d4,1,6,1,7,3,2005-06-29 00:13:32,2005-06-28 23:58:27
75c660ac9373b588a7815fa922dac02b2e4519d4...67e5a5ece41eebc7fec497911690e5a8ca38aea6,1,190,228,418,43,2005-06-29 03:34:23,2005-06-29 03:34:23
67e5a5ece41eebc7fec497911690e5a8ca38aea6...9d5ab9625ddb53a68a99516225d0bcb39ec473d5,1,20,5,25,2,2005-06-29 03:37:42,2005-06-29 00:49:27
9d5ab9625ddb53a68a99516225d0bcb39ec473d5...69a2d426f0d249bca2c6f754b3c1283c0fa72fd4,3,37,46,83,9,2005-06-29 04:38:47,2005-06-29 04:27:45
69a2d426f0d249bca2c6f754b3c1283c0fa72fd4...01247d87421d621db3866ce7f2124784fc7f46e5,5,31,31,62,15,2005-06-29 05:15:57,2005-06-29 05:15:57
01247d87421d621db3866ce7f2124784fc7f46e5...e5e3e0f5001f51fe388d530481e56651729add1a,1,18,20,38,3,2005-06-29 05:42:45,2005-06-29 05:42:45
e5e3e0f5001f51fe388d530481e56651729add1a...dcde55bc58ae845307efbdce3a1071f75ccd758e,6,35,58,93,15,2005-06-29 16:11:38,2005-06-29 06:49:56
dcde55bc58ae845307efbdce3a1071f75ccd758e...3c84974207fb6a98eaa393cd4c3481d8ecdb8ce2,3,6,9,15,6,2005-06-29 16:11:38,2005-06-29 07:32:11
3c84974207fb6a98eaa393cd4c3481d8ecdb8ce2...f9253394a271a9fefdd234a86c228adeb6d0136a,10,231,18,249,33,2005-06-29 16:11:39,2005-06-29 09:51:27
f9253394a271a9fefdd234a86c228adeb6d0136a...cca7081a93b192219e8f4f7252c7fc7c2cabfd9a,1,14,13,27,7,2005-06-29 16:38:02,2005-06-29 16:38:02
cca7081a93b192219e8f4f7252c7fc7c2cabfd9a...dddafffef66041689f54837ac8e9bf717bb057b4,1,6,1,7,2,2005-06-29 16:53:20,2005-06-29 16:53:20
dddafffef66041689f54837ac8e9bf717bb057b4...e06eb4c6f50ece75f210a91bfcb776e537aafaae,1,4,2,6,2,2005-06-29 16:53:57,2005-06-29 06:07:34
e06eb4c6f50ece75f210a91bfcb776e537aafaae...3c90f03d3206cb2c2bff6e20f7477bbfcd624887,1,20,6,26,6,2005-06-29 17:40:14,2005-06-29 17:40:14
3c90f03d3206cb2c2bff6e20f7477bbfcd624887...36f8d17445087a59d81963520ded982e03dfb6cb,1,91,13,104,11,2005-06-29 18:30:24,2005-06-29 18:30:24
36f8d17445087a59d81963520ded982e03dfb6cb...ad6ce07c44c8f76599d506d38cc3194e886e694a,1,1,4,5,1,2005-06-29 18:40:58,2005-06-29 18:40:58
ad6ce07c44c8f76599d506d38cc3194e886e694a...575f497456e4d4669b3b0095482ba2b86f6d2807,3,326,1,327,4,2005-06-30 00:52:11,2005-06-30 00:52:11
575f497456e4d4669b3b0095482ba2b86f6d2807...61221472a5f8591f2d06d5e5c5aafb03271b8066,2,120,1,121,3,2005-06-30 02:09:05,2005-06-30 02:09:05
61221472a5f8591f2d06d5e5c5aafb03271b8066...f3a3214e83be2905c57eff5d9035d169cae4644e,5,148,126,274,17,2005-06-30 03:50:15,2005-06-30 03:50:15
f3a3214e83be2905c57eff5d9035d169cae4644e...da4b932a0c5b249694216b1580b7bc2ded9e0280,1,5,0,5,1,2005-06-30 03:53:10,2005-06-29 23:45:30
da4b932a0c5b249694216b1580b7bc2ded9e0280...99c2bc93000dfadc3ac26ddced23e50520cf30d0,2,9,11,20,7,2005-06-30 03:53:10,2005-06-30 01:51:34
99c2bc93000dfadc3ac26ddced23e50520cf30d0...2ba1beebd37a57ad07c283da67c82847f6cb2ef9,1,2,3,5,3,2005-06-30 03:53:10,2005-06-30 02:41:55
2ba1beebd37a57ad07c283da67c82847f6cb2ef9...3ed35678903f14c8be26b5b4fce1155e4c69230f,1,3,3,6,3,2005-06-30 03:53:10,2005-06-30 02:41:57
3ed35678903f14c8be26b5b4fce1155e4c69230f...9d89d19c4873f73f3165e1cef45fdb17ef39a5d0,1,8,8,16,4,2005-06-30 03:53:10,2005-06-30 02:41:59
9d89d19c4873f73f3165e1cef45fdb17ef39a5d0...1a3e71767c835c1ae9367e235bbaac2db59fee91,1,1,1,2,1,2005-06-30 04:08:21,2005-06-30 04:08:21
1a3e71767c835c1ae9367e235bbaac2db59fee91...e4b5c7fff47d3a794249ea2da6b9ec4e33e157f3,1,58,3,61,5,2005-06-30 05:31:41,2005-06-30 05:31:41
e4b5c7fff47d3a794249ea2da6b9ec4e33e157f3...7f8e982834bbc476e73c2ec02ebe8749caef51bc,2,42,27,69,15,2005-06-30 05:50:48,2005-06-30 05:50:48
7f8e982834bbc476e73c2ec02ebe8749caef51bc...eb1af2df0b1a766a591f1e3ab6f647a617330520,1,35,17,52,6,2005-06-30 06:01:14,2005-06-30 06:01:14
eb1af2df0b1a766a591f1e3ab6f647a617330520...56b6ed8881f3504b686a254cccdb5aa1a1a9e925,1,11,0,11,1,2005-06-30 06:07:01,2005-06-30 06:07:01
56b6ed8881f3504b686a254cccdb5aa1a1a9e925...2eca23daf5ab7c921c544d86cd53707f8b4ff9a4,1,59,5,64,5,2005-06-30 17:15:22,2005-06-30 17:15:22
2eca23daf5ab7c921c544d86cd53707f8b4ff9a4...94fdb7aa17cc778dff084857192e155aabca86f1,1,79,12,91,3,2005-06-30 17:17:39,2005-06-30 17:17:39
94fdb7aa17cc778dff084857192e155aabca86f1...f65fdf04a13d2252de8b2b4b161db7c43f2c28ad,1,18,2,20,5,2005-06-30 18:04:59,2005-06-30 18:04:59
f65fdf04a13d2252de8b2b4b161db7c43f2c28ad...d0efc8a71da1855c705fd2074b219bcb158b6dbd,2,32,39,71,16,2005-06-30 19:28:24,2005-06-30 19:28:24
d0efc8a71da1855c705fd2074b219bcb158b6dbd...c62266f37c677c1de7415ac6cf1e2eb6726590e1,2,44,38,82,10,2005-07-01 05:33:47,2005-07-01 00:13:07
c62266f37c677c1de7415ac6cf1e2eb6726590e1...f3bf92240956241e6b21e80a1c281ec7716b9f23,7,156,44,200,34,2005-07-01 05:33:47,2005-07-01 00:15:39
f3bf92240956241e6b21e80a1c281ec7716b9f23...ad8c80a58f7bf8f7d5d34794355e5540cd7b3218,3,84,1,85,5,2005-07-01 05:33:47,2005-07-01 00:17:20
ad8c80a58f7bf8f7d5d34794355e5540cd7b3218...8a65ff7666db1299449a397bab3d39d74b82aa54,3,77,53,130,8,2005-07-03 03:23:36,2005-07-03 03:23:36
8a65ff7666db1299449a397bab3d39d74b82aa54...4d235c8044a638108b67e22f94b2876657130fc8,1,4,4,8,4,2005-07-03 16:58:44,2005-07-03 16:58:44
4d235c8044a638108b67e22f94b2876657130fc8...7ec4e60819764128351d526a77859a403c0d4ff4,1,1,0,1,1,2005-07-03 17:00:01,2005-07-03 17:00:01
7ec4e60819764128351d526a77859a403c0d4ff4...944d858969e4e14adefdd8f21fac5c8ab45f83f7,4,18,63,81,15,2005-07-03 17:01:38,2005-07-03 17:01:38
944d858969e4e14adefdd8f21fac5c8ab45f83f7...44c9e8594e7854fcead68ae0959e00137c2bbb59,1,10,1,11,3,2005-07-03 17:02:35,2005-07-03 17:02:35
44c9e8594e7854fcead68ae0959e00137c2bbb59...6da4016aea2dc5bf311fea160bd8ef96ca82b999,9,18,18,36,16,2005-07-03 17:10:45,2005-07-03 17:10:45
6da4016aea2dc5bf311fea160bd8ef96ca82b999...c33303839c76c41c9f85e5bd3f7b04fab60c38ca,1,26,0,26,2,2005-07-03 17:40:38,2005-07-03 17:40:38
c33303839c76c41c9f85e5bd3f7b04fab60c38ca...dade09c2269ec2117df085e8a99efcabccf08c53,2,7,0,7,2,2005-07-03 20:06:36,2005-07-03 20:06:36
dade09c2269ec2117df085e8a99efcabccf08c53...960bba0d8c14c9eb76bbb42eebc39eff58fc452b,2,14,3,17,6,2005-07-03 20:07:52,2005-07-03 20:07:52
960bba0d8c14c9eb76bbb42eebc39eff58fc452b...eb019375abf545ec644e043f830ab573c2a4cd74,1,9,1,10,4,2005-07-03 20:08:40,2005-07-03 20:08:40
eb019375abf545ec644e043f830ab573c2a4cd74...12d2a18780321e0d00a0656f4965716ada910f66,1,11,0,11,4,2005-07-03 20:29:54,2005-07-03 20:29:54
12d2a18780321e0d00a0656f4965716ada910f66...1c4a29120240a35b9c02afa636dac3e55ac96cb0,1,7,0,7,3,2005-07-03 20:36:58,2005-07-03 20:36:58
1c4a29120240a35b9c02afa636dac3e55ac96cb0...b2d46199d24856a05f455236031935dd35b3116f,2,19,1,20,2,2005-07-03 20:38:01,2005-07-03 20:38:01
b2d46199d24856a05f455236031935dd35b3116f...2396ec85bd167b87e21edbd3a64d46eeb19d6a5d,2,68,1,69,3,2005-07-03 21:27:34,2005-07-03 21:27:34
2396ec85bd167b87e21edbd3a64d46eeb19d6a5d...5f3de58ff85c49620ae2a1722d8d4d37c881a054,2,20,17,37,15,2005-07-03 22:34:04,2005-07-03 22:34:04
5f3de58ff85c49620ae2a1722d8d4d37c881a054...5736bef18c37e811f39bafb9895fee349fa7bbe6,1,76,3,79,4,2005-07-04 03:27:06,2005-07-04 03:27:06
5736bef18c37e811f39bafb9895fee349fa7bbe6...671fe4bb20cf36b0f9de763b863425f5bea30c06,1,49,0,49,2,2005-07-04 04:01:11,2005-07-04 04:01:11
671fe4bb20cf36b0f9de763b863425f5bea30c06...a61eea6abdbd336c7a3364c170cce3de01421599,1,15,15,30,12,2005-07-04 15:22:32,2005-07-04 13:15:36
a61eea6abdbd336c7a3364c170cce3de01421599...f71925983ddc365c167559ecc623f2c000607cda,4,92,74,166,7,2005-07-04 18:57:58,2005-07-04 18:57:58
f71925983ddc365c167559ecc623f2c000607cda...013e7c7ff498aae82d799f80da37fbd395545456,3,22,21,43,3,2005-07-04 20:24:30,2005-07-04 20:24:30
013e7c7ff498aae82d799f80da37fbd395545456...def88e9afbf915ad76781aba7274398963b5e1a7,3,216,4,220,4,2005-07-04 20:26:53,2005-07-04 20:26:53
def88e9afbf915ad76781aba7274398963b5e1a7...6cada6a98d357a4891cafa241e04c5fcb500107a,1,5,0,5,1,2005-07-04 22:28:19,2005-07-04 22:28:19
6cada6a98d357a4891cafa241e04c5fcb500107a...fb9040cc83540fff9d05c8056433a4aa05b8a7c2,2,116,10,126,16,2005-07-04 22:29:17,2005-07-04 22:29:17
fb9040cc83540fff9d05c8056433a4aa05b8a7c2...75bfc6c232689ae06aba6a7d4aa15ac2791d9a11,2,100,25,125,16,2005-07-04 23:35:13,2005-07-04 23:35:13
75bfc6c232689ae06aba6a7d4aa15ac2791d9a11...7620d39fcbff834d00320d295fbdbd9b7006d66a,1,2,1,3,1,2005-07-04 23:36:48,2005-07-04 23:36:48
7620d39fcbff834d00320d295fbdbd9b7006d66a...7a662e896bcd391265477e304d7af6e5d2ca1deb,1,1,1,2,1,2005-07-04 23:49:37,2005-07-04 23:49:37
3f81fc82743ccd4fd7157f1f1db41605eb018fb9...e4ad5f0979bf4791a0c4a755a3dd184c8f178550,1,1,1,2,1,2005-08-06 17:19:17,2005-08-06 17:04:50
e4ad5f0979bf4791a0c4a755a3dd184c8f178550...db27ee63929fa4a161c321daf52df5635fd4828c,1,0,7,7,1,2005-08-06 17:19:38,2005-08-06 17:16:52
db27ee63929fa4a161c321daf52df5635fd4828c...15e02b372ddebd2aac829707786462798f91d509,1,20,0,20,2,2005-08-06 17:19:38,2005-08-06 17:12:03
15e02b372ddebd2aac829707786462798f91d509...f5b749560980a30d7472183e3d6360baa5a1f0d5,1,1,0,1,1,2005-08-06 17:19:39,2005-08-06 16:28:31
f5b749560980a30d7472183e3d6360baa5a1f0d5...d3af621b147bb90a31fdc3b55e07853f45deb658,7,76,33,109,27,2005-08-06 20:49:26,2005-08-06 19:50:14
d0d0d0bd3c2c4591ffbc292d7e082e8ad8f2057f...4bea3b6926609b0cfb1319b1b2e9b2697629b13f,1,1,0,1,1,2005-05-05 09:21:42,2005-05-05 09:21:42
4bea3b6926609b0cfb1319b1b2e9b2697629b13f...2af87aae7801c3de62d6fca709ccb723d99a9452,1,1,1,2,1,2005-05-05 14:36:54,2005-05-05 11:30:25
2af87aae7801c3de62d6fca709ccb723d99a9452...5210372fe4a2e2ec73291434e86c07345524a276,1,1,1,2,1,2005-05-05 14:36:54,2005-05-05 12:31:53
5210372fe4a2e2ec73291434e86c07345524a276...8ae0a8c514dc492de8aadf3ca6bb4ad55e33960e,7,74,27,101,19,2005-05-05 15:23:01,2005-05-05 12:38:25
8ae0a8c514dc492de8aadf3ca6bb4ad55e33960e...160c8433d904340615bafd7757355618e99e20d5,1,13,2,15,5,2005-05-05 16:31:09,2005-05-05 16:31:09
160c8433d904340615bafd7757355618e99e20d5...67cc5c4ef8b84961946e58bfb896c11b7fd33cc7,3,58,46,104,4,2005-05-05 18:43:30,2005-05-05 18:43:30
67cc5c4ef8b84961946e58bfb896c11b7fd33cc7...ed4eeaf203d0f293bd5ffc2a0ad8711f052db1f3,1,1,1,2,1,2005-05-05 20:02:26,2005-05-05 19:51:34
634392b26275fe5436c0ea131bc89b46476aa4ae...603ee0f0c3d1b8fc09929d185817c43e231317e7,1,4,2,6,2,2012-04-10 01:23:10,2012-03-20 23:11:49
603ee0f0c3d1b8fc09929d185817c43e231317e7...c96c5383ff05e58be83116f1b97bd438bffc7450,6,0,143,143,6,2012-04-10 03:11:25,2012-04-10 03:11:25
c96c5383ff05e58be83116f1b97bd438bffc7450...5163d476d04dc940b2e74d79c60e3b32fea12f02,1,6,3,9,4,2012-04-10 03:25:58,2012-01-29 22:17:43
5163d476d04dc940b2e74d79c60e3b32fea12f02...187bc2da5bc2172a7cc8a0da3b4c0994e7a0d9fc,1,3,0,3,1,2012-04-10 03:26:10,2012-04-10 02:39:08
187bc2da5bc2172a7cc8a0da3b4c0994e7a0d9fc...7ff8463dba0d74fc07a766bed457ae7afcc902b5,1,21,20,41,10,2012-04-10 03:26:10,2012-04-10 02:13:03
7ff8463dba0d74fc07a766bed457ae7afcc902b5...c3d884a68806d1b56f14b5ba1cfa3493aa7b277d,1,69,0,69,1,2012-04-10 03:26:10,2012-02-05 22:29:06
c3d884a68806d1b56f14b5ba1cfa3493aa7b277d...311391da90639e759974839d5c1f9d93fb03a09b,1,1,1,2,1,2012-04-10 03:26:19,2012-04-10 03:07:02
311391da90639e759974839d5c1f9d93fb03a09b...926b1ec63ee045503f609e88ca445b94c06bd5d7,1,18,12,30,9,2012-04-10 03:26:19,2012-04-10 03:19:01
1066c2c5482b8b5fb968c3a4acaa32a48bad2534...f58494bf82c260bf8794b2744158d84fc242cbf0,1,3,2,5,3,2007-06-24 09:16:00,2007-06-18 21:30:36
f58494bf82c260bf8794b2744158d84fc242cbf0...09381b458f5f1ac1a78df1aaeeb53aa79fcf2c4f,1,5,0,5,1,2007-06-24 09:36:56,2007-06-19 11:44:43
09381b458f5f1ac1a78df1aaeeb53aa79fcf2c4f...0d351e9ca23ea3be9aa7631b1b548f5d75f01a13,1,4,3,7,1,2007-06-24 09:37:40,2007-06-19 16:47:41
0d351e9ca23ea3be9aa7631b1b548f5d75f01a13...aeb59328453cd4f438345ea79ff04c96bccbbbb8,1,12,4,16,5,2007-06-24 09:46:35,2007-06-20 20:47:34
2ec0cb7959b0bf965d54f95453f5b4b34e8d3100...f6f2aa39ef97cae03c71ecfecc334f0df60d7920,1,6,4,10,2,2007-04-04 16:08:46,2007-04-04 16:08:46
2ec0cb7959b0bf965d54f95453f5b4b34e8d3100...e2a1bc67d321a0c03737179f331c39a52e7049d7,1,3,0,3,2,2007-04-04 15:37:55,2007-04-04 15:31:49
e2a1bc67d321a0c03737179f331c39a52e7049d7...3cf0bad830c93176acc6e6436da42e1936bb2282,1,45,19,64,20,2007-04-04 15:37:56,2007-03-27 10:29:08
3cf0bad830c93176acc6e6436da42e1936bb2282...df0cd69558b826a0f43420ecc808557656961f62,1,15,4,19,15,2007-04-04 15:37:56,2007-03-27 10:31:02
df0cd69558b826a0f43420ecc808557656961f62...53a291a435a173a18969011753104f8ab41234c8,1,18,46,64,18,2007-04-04 15:37:57,2007-03-27 10:31:55
53a291a435a173a18969011753104f8ab41234c8...4372da3441561b3852c0bf466304f1e4f3c06b3f,1,2,0,2,2,2007-04-04 15:45:33,2007-04-04 15:45:33
eec102524fda2df7d2846e865805ca213119bf10...58db64f73c3dedb41467f915b45d305d52d04d2c,1,2,1,3,1,2007-03-07 01:09:53,2007-03-07 00:48:59
58db64f73c3dedb41467f915b45d305d52d04d2c...ef203f08564c1c6d267fedf8e0357c56d477892f,1,4,1,5,1,2007-03-07 18:01:44,2007-03-07 17:04:24
597388f6a1c18a117904c307c20542d8a79a1fcd...edaec3fbe8821a5761e35e9b01937eea9b2544c1,4,24,23,47,12,2007-02-28 20:00:00,2007-02-28 19:45:56
edaec3fbe8821a5761e35e9b01937eea9b2544c1...53bca91a7d337ea648197b9642b41a92704c17f7,4,6,6,12,6,2007-02-28 20:00:00,2007-02-28 19:52:04
53bca91a7d337ea648197b9642b41a92704c17f7...d0d8e14d1bad5f5ad3fb27a6ac819ff4e7006f03,1,1,1,2,1,2007-02-28 20:00:00,2007-02-28 19:57:39
0d9b9ab1284ce125fd49cf7dbf4d28e0540cf035...34fc5cefa7068492d5103b40dca1b55f69986eb8,6,147,19,166,10,2007-02-27 09:02:32,2007-02-26 19:10:59
34fc5cefa7068492d5103b40dca1b55f69986eb8...ee24ee55c28e46b502e4e2d219feced5a5d67e6b,1,3,3,6,2,2007-02-27 09:03:37,2007-02-26 23:11:35
ee24ee55c28e46b502e4e2d219feced5a5d67e6b...63e50d492c658b4a0d616f57f8b43a7a9ba1bbcc,1,2,1,3,1,2007-02-27 09:33:14,2007-02-27 09:31:42
16d53152f10bf5c1cae4eb1f85dfab7dc280f913...2eb06531e3d53c2604f20c32e5cb791d5044ff02,1,64,1,65,6,2007-02-28 23:06:38,2007-02-28 23:06:38
4808bec6f9b5fe414f0dbc2cc0445f54f28e9e9c...78a8d641c14dc2f0a306d787fa1e42d400b3af4d,12,101,12,113,16,2007-03-03 00:58:05,2007-03-02 21:11:30
78a8d641c14dc2f0a306d787fa1e42d400b3af4d...723024d696a47556baac77700e47fef288691f37,2,64,1,65,3,2007-03-04 02:59:41,2007-03-03 19:32:46
723024d696a47556baac77700e47fef288691f37...a249a9b5a26e841a28f6e993a560d749303cf91c,1,10,0,10,2,2007-03-04 03:30:34,2007-03-03 19:38:00
2c7ca1fcf19d3803a225130491e26dca86d1781d...17e48368751ae8df7ed0332ae8ef900ce983fce6,3,66,1,67,4,2007-02-25 19:09:56,2007-02-25 02:18:22
17e48368751ae8df7ed0332ae8ef900ce983fce6...56cf9806a97f5fe9a91c38aa3eb8cec0c76480e6,3,27,34,61,3,2007-02-25 19:09:56,2007-02-25 00:59:52
56cf9806a97f5fe9a91c38aa3eb8cec0c76480e6...6c09c451389ade6477d98b05d277aab0dd2f272e,1,2,0,2,1,2007-02-25 19:09:56,2007-02-25 06:26:33
048f48a2fdefdf71e7af19ec7111000ce2ebf52e...34a5e1a2d900b5dd9b9c446a3db9fdb3b29e0575,3,17,3,20,8,2007-02-26 09:20:55,2007-02-25 22:34:54
5ced0572217f82f20c4a3460492768e07c08aeea...efec43c028c52bc252afdaa586b46f83186d3eaa,1,1,1,2,1,2007-03-05 08:55:19,2007-03-05 08:21:24
efec43c028c52bc252afdaa586b46f83186d3eaa...7efbff7531af4281487d54c1dc1401308d988e33,2,19,9,28,8,2007-03-05 08:55:19,2007-03-05 08:21:37
7efbff7531af4281487d54c1dc1401308d988e33...e2b4f63512357d83f1f11bafadb22063e5d56621,1,21,5,26,11,2007-03-05 08:55:19,2007-03-05 08:22:06
8a3fbdd9e6c37c74b12fd0e8bd7cde8372861288...ed8ad7e2e29d4adf342964f6cc15d6b84f62c700,1,6,2,8,3,2007-03-11 20:28:13,2007-03-11 18:49:08
ed8ad7e2e29d4adf342964f6cc15d6b84f62c700...538778469ca267c8888bc659d20680c3a1e077fd,1,3,3,6,3,2007-03-12 05:49:08,2007-03-06 09:42:24
538778469ca267c8888bc659d20680c3a1e077fd...497bdc88d661b3da15fdd5365293381bd66010c9,1,9,4,13,2,2007-03-12 05:49:25,2007-03-10 08:27:28
497bdc88d661b3da15fdd5365293381bd66010c9...afdb269c76cb965cf8bbb1012c2ec0e2bf7172b1,3,1,50,51,4,2007-03-12 05:49:31,2007-03-10 08:27:52
afdb269c76cb965cf8bbb1012c2ec0e2bf7172b1...f1000898d43a30f6a0d3bbde7b4927e97913d010,2,27,7,34,8,2007-03-12 05:49:34,2007-03-10 08:28:00
f1000898d43a30f6a0d3bbde7b4927e97913d010...ebcb5d16ca911d5e21bb8071c185fb47a0c1fbb3,2,22,7,29,9,2007-03-12 05:49:37,2007-03-10 08:28:05
ebcb5d16ca911d5e21bb8071c185fb47a0c1fbb3...4919bf0354e2a1cfb948c320d45d51319ada30eb,2,37,1,38,9,2007-03-12 05:49:40,2007-03-10 08:28:08
4919bf0354e2a1cfb948c320d45d51319ada30eb...6c319a22e47e6b49d799f5893aeac92e723a5e6f,1,24,19,43,2,2007-03-12 05:49:43,2007-03-10 08:28:11
6c319a22e47e6b49d799f5893aeac92e723a5e6f...1d9e8b56fe3a0360bf61ce633827af8fa9a7013c,1,24,2,26,3,2007-03-12 05:49:46,2007-03-10 08:28:13
1d9e8b56fe3a0360bf61ce633827af8fa9a7013c...f43cd49fb82b0eee10b88833b58edd711fe8298d,3,62,58,120,32,2007-03-12 05:56:03,2007-03-10 08:28:16
8a3fbdd9e6c37c74b12fd0e8bd7cde8372861288...b867092fec81c59a35337d24d2d976ab2acc2488,2,57,0,57,4,2007-03-11 08:04:05,2007-03-09 11:52:12
8a3fbdd9e6c37c74b12fd0e8bd7cde8372861288...0746d19a823aa12239df9d32db6fa6795d8c8539,7,229,36,265,31,2007-03-11 07:41:58,2007-03-08 09:58:35
0746d19a823aa12239df9d32db6fa6795d8c8539...45994a1e33398e55426268fcd5d4ab3143497e29,1,17,14,31,5,2007-03-11 07:41:58,2007-03-08 21:59:54
9360f27ff79df898b68ee7931c701569298d1e7e...cff0302c14522ba7b34265ee39f23e6321a4777d,1,5,0,5,1,2007-02-21 06:03:14,2007-02-20 09:51:22
cff0302c14522ba7b34265ee39f23e6321a4777d...cc44c7655fe2dd0cfb46e841156634fe622df397,48,211,211,422,203,2007-02-21 06:03:15,2007-02-20 09:53:29
cc44c7655fe2dd0cfb46e841156634fe622df397...599065a3bb94ae9f48e3808b8fafc8443017af28,13,44,44,88,42,2007-02-21 06:03:15,2007-02-20 09:54:00
599065a3bb94ae9f48e3808b8fafc8443017af28...1968d77dd632a9a9e5c6f5681649e5e65ed13088,9,13,13,26,13,2007-02-21 06:03:15,2007-02-20 09:55:07
204d409247e7bbc7848569462aa11a87e373c8d6...efa13f7b7ea1605deab3a6478fa0d0706c828170,1,3,1,4,2,2007-02-16 01:03:11,2007-02-16 01:02:06
ddfff2665150f6194944864c96649cce08ac4fbd...a44a0c9966dd83bfc0c1fada1896f98fbf4170a6,1,3,0,3,1,2007-02-14 08:41:32,2007-02-14 08:41:32
a44a0c9966dd83bfc0c1fada1896f98fbf4170a6...6fc666862535b3543d28172bab0901898da09993,1,39,0,39,1,2007-02-14 08:46:52,2007-02-14 08:45:24
6fc666862535b3543d28172bab0901898da09993...f5d43056a1b2487d032682a70c58f04d159718d7,1,1,1,2,1,2007-02-14 08:49:06,2007-02-14 08:49:06
f5d43056a1b2487d032682a70c58f04d159718d7...9a894e8e7c85794d39745eb83462a2001816ac3b,1,2,2,4,2,2007-02-14 18:14:26,2007-02-14 11:20:32
210a0be504829bad5a2821488d3c25cc406fed4a...885a86abe2e9f7b96a4e2012183c6751635840aa,21,113,96,209,86,2006-06-18 01:49:18,2006-06-14 23:45:13
885a86abe2e9f7b96a4e2012183c6751635840aa...d3ff6f55012c939740ce0982b24aeb6fba3c6e4f,6,48,42,90,37,2006-06-18 01:49:45,2006-06-18 01:26:18
d3ff6f55012c939740ce0982b24aeb6fba3c6e4f...cb115748ec0d4c6faccd09f3637ea436482dd7d5,3,14,2,16,4,2006-06-18 01:49:52,2006-06-18 01:47:58
8d858d1a3a0f7df94a256dd5f51b94599c36c9f5...d698206c12a4680a92c5f4894f0345dc7dcfe62a,1,99,10,109,14,2005-08-06 12:06:06,2005-08-06 12:06:06
7a662e896bcd391265477e304d7af6e5d2ca1deb...723c31fea2f1c4994de837bda9022ffa8b6de1bb,7,37,14,51,13,2005-07-05 18:31:32,2005-07-05 18:31:32
723c31fea2f1c4994de837bda9022ffa8b6de1bb...0a623e7ce8aedd938e8fd5611ccf7ae28c1eb7d9,1,18,33,51,2,2005-07-05 18:38:37,2005-07-05 18:38:37
0a623e7ce8aedd938e8fd5611ccf7ae28c1eb7d9...f03f2ba0a558c6fbfcf40ca24da55a8e9d602e46,1,2,1,3,1,2005-07-05 19:02:10,2005-07-05 19:02:10
d3af621b147bb90a31fdc3b55e07853f45deb658...bfe19f876cb20bea606e1a698030c017f31965c1,1,3,1,4,1,2005-08-07 03:44:20,2005-08-07 01:01:03
d3af621b147bb90a31fdc3b55e07853f45deb658...7a59013290bb26b80c997e5698757a735f1a92e0,4,18,10,28,7,2005-08-07 00:23:52,2005-08-06 20:10:43
ed4eeaf203d0f293bd5ffc2a0ad8711f052db1f3...fc54a9c30ccad3fde5890d2c0ca2e2acc0848fbc,1,101,38,139,19,2005-05-05 23:14:01,2005-05-05 23:14:01
ed4eeaf203d0f293bd5ffc2a0ad8711f052db1f3...b28858bf65d4fd6d8bb070865518ec43817fe7f3,1,56,22,78,9,2005-05-05 23:10:21,2005-05-05 23:10:21
ed4eeaf203d0f293bd5ffc2a0ad8711f052db1f3...db823d4a5a47d614895c959dce2a379a2364b677,1,1,3,4,2,2005-05-05 23:01:46,2005-05-05 23:01:46
db823d4a5a47d614895c959dce2a379a2364b677...d5a72fd622ecedaea272cd6292abb7138a49e460,1,1,1,2,1,2005-05-05 23:07:56,2005-05-05 23:07:56
d5a72fd622ecedaea272cd6292abb7138a49e460...42ea9cb286423c949d42ad33823a5221182f84bf,3,28,2,30,3,2005-05-05 23:18:48,2005-05-05 23:18:48
42ea9cb286423c949d42ad33823a5221182f84bf...d5f415e6f5c1f3930a4651c2804cd4e2205a79de,1,1,0,1,1,2005-05-05 23:51:46,2005-05-05 23:34:10
ed4eeaf203d0f293bd5ffc2a0ad8711f052db1f3...660265909fc178581ef327076716dfd3550e6e7b,1,19,4,23,4,2005-05-05 22:35:49,2005-05-05 22:35:49
ed4eeaf203d0f293bd5ffc2a0ad8711f052db1f3...c4b83e618f1df7d8ecc9392fa40e5bebccbe6b5a,1,41,3,44,8,2005-05-05 22:29:06,2005-05-05 22:29:06
ed4eeaf203d0f293bd5ffc2a0ad8711f052db1f3...9e30dd7c0ecc9f10372f31539d0122db97418353,1,0,0,0,0,2005-05-05 22:10:49,2005-05-05 22:10:49
7945c7fad05da2ac7f6f1f89202799993a591eac...cc999a3a0845fcab83a8dcecd3fcdd86f03c10b6,1,1,0,1,1,2012-04-11 16:51:00,2012-04-04 12:25:44
cc999a3a0845fcab83a8dcecd3fcdd86f03c10b6...36e6c803a1ef68b8acdc4138597db4fb087112be,3,31,2,33,3,2012-04-11 19:17:17,2012-04-11 19:17:17
aeb59328453cd4f438345ea79ff04c96bccbbbb8...cfc0aef1ffb8a9fe2792667597a05bbf3b6b1258,1,7,4,11,5,2007-06-25 06:12:31,2007-06-24 22:23:28
cfc0aef1ffb8a9fe2792667597a05bbf3b6b1258...125b7630521918b75c136bd95309054d3f6d9da5,2,18,11,29,8,2007-06-25 08:51:21,2007-06-24 22:23:34
aeb59328453cd4f438345ea79ff04c96bccbbbb8...47d0b4ff57f391786ed050f38c0de51462eda97a,1,30,22,52,7,2007-06-25 01:01:29,2007-06-24 17:10:40
47d0b4ff57f391786ed050f38c0de51462eda97a...0f157315a1020fce76fe2c5a703e40684b9b1699,1,20,1,21,2,2007-06-25 05:56:40,2007-06-24 17:29:33
aeb59328453cd4f438345ea79ff04c96bccbbbb8...0cae23467ada9b94210a0e770064841efea8ad40,2,29,28,57,2,2007-06-25 00:45:01,2007-06-25 00:04:11
0cae23467ada9b94210a0e770064841efea8ad40...1b1dce4bae760248a1fc3e29548a72c446e77270,5,546,5,551,9,2007-06-25 00:45:02,2007-06-25 00:11:14
1b1dce4bae760248a1fc3e29548a72c446e77270...ad562a817256adff4faadc17900b4aba67ca471a,1,1,0,1,1,2007-06-27 00:27:25,2007-06-26 13:38:42
ad562a817256adff4faadc17900b4aba67ca471a...c54b7817f4f6bf422ea532d81217c28f63c259c5,2,17,4,21,8,2007-06-27 01:58:45,2007-06-25 17:56:55
c54b7817f4f6bf422ea532d81217c28f63c259c5...68a163c9b483ae352fcfee8c4505d113213daa73,2,12,2,14,2,2007-06-27 01:58:59,2007-06-25 17:58:28
aeb59328453cd4f438345ea79ff04c96bccbbbb8...161fea832a8e8ea7d6cdc1bdc388f19825641a53,1,3,0,3,1,2007-06-24 23:42:16,2007-06-24 23:42:16
aeb59328453cd4f438345ea79ff04c96bccbbbb8...9378c16135100fb65ad575cd35074af166de1cab,6,148,2,150,7,2007-06-24 22:11:42,2007-06-24 22:11:24
3ed02de2f46105cbc45fcc8f3287513f470eb4a3...115f0fe49951b951495bdcd0420a44fb11c2173a,1,1,2,3,1,2007-03-12 18:44:46,2007-03-12 17:40:31
f6f2aa39ef97cae03c71ecfecc334f0df60d7920...681bfd59ce1a93a4492e11a480e438099f721294,1,1,1,2,1,2007-05-02 16:44:44,2007-05-02 16:44:44
d025d1e322c715ecf7fa7c10ce9e6b4a1be982d0...19c821487b28f56180290aa7d1f30e6bd5316225,1,1,1,2,1,2007-04-15 04:35:13,2007-04-14 19:10:48
19c821487b28f56180290aa7d1f30e6bd5316225...69dd97a430d3deebbcade1d38c53110342440890,1,0,3,3,2,2007-04-17 17:15:56,2007-04-17 17:15:56
69dd97a430d3deebbcade1d38c53110342440890...845d377b2880a0c5d74f785244469ab1ac815bde,1,4,0,4,3,2007-04-17 17:16:14,2007-04-17 10:31:47
27ebd6e0443bdd795869f598ecebc9eadd64a26c...dee41f3e5569f9465018535f02d45796d84aebd8,2,13,2,15,4,2007-03-14 04:18:37,2007-03-13 18:40:36
27ebd6e0443bdd795869f598ecebc9eadd64a26c...c4b4a5af1604a7546c0b0786e47bcff8a47a6039,5,405,1,406,5,2007-03-14 00:14:05,2007-03-06 05:05:16
27ebd6e0443bdd795869f598ecebc9eadd64a26c...f4bba25bdc0ecb4ac338de81a2a65af487701833,2,31,1,32,8,2007-03-13 06:40:17,2007-03-12 18:37:45
f4bba25bdc0ecb4ac338de81a2a65af487701833...e4507ae84ed04c835b66f77195a0549b72f99c39,2,19,8,27,7,2007-03-13 06:40:17,2007-03-12 18:37:55
e4507ae84ed04c835b66f77195a0549b72f99c39...b1daf300d0f56a01e5800a3d989b4cb150d99140,1,30,99,129,13,2007-03-13 06:40:17,2007-03-12 23:00:11
b1daf300d0f56a01e5800a3d989b4cb150d99140...1a8f27413bfe438ce8f8aba56aa48f980f6144d1,3,4,4,8,3,2007-03-13 06:40:18,2007-03-12 19:33:18
1a8f27413bfe438ce8f8aba56aa48f980f6144d1...df91ba36b1e93053ff9353a8d5c0c8c5f754a391,1,3,3,6,3,2007-03-13 06:40:18,2007-03-12 23:00:15
df91ba36b1e93053ff9353a8d5c0c8c5f754a391...15a1c012635f2f57a8f0146e198b5e1334d527cf,1,15,21,36,3,2007-03-13 06:40:18,2007-03-12 23:00:19
15a1c012635f2f57a8f0146e198b5e1334d527cf...b49809c9615e7d2b854ce88b3dd0cd7790588fe5,1,5,18,23,2,2007-03-13 06:40:18,2007-03-12 23:00:21
b49809c9615e7d2b854ce88b3dd0cd7790588fe5...e8016abf8d6716296829d12324ea02e34c757256,1,10,25,35,7,2007-03-13 06:40:18,2007-03-12 23:00:26
e8016abf8d6716296829d12324ea02e34c757256...38b1c6626b4690a745e23be9aa9ada98c1a55f41,1,29,55,84,8,2007-03-13 06:40:18,2007-03-12 23:00:29
27ebd6e0443bdd795869f598ecebc9eadd64a26c...87ab799234639c26ea10de74782fa511cb3ca606,5,287,248,535,51,2007-03-13 06:33:41,2007-03-12 19:52:04
87ab799234639c26ea10de74782fa511cb3ca606...f0658cf2106074b2465a5de0e20f459f966a9e18,1,34,3,37,2,2007-03-13 06:33:41,2007-03-12 19:52:06
f0658cf2106074b2465a5de0e20f459f966a9e18...ae1a7437355a1fbc907b6d6cad9ed79227c29164,8,35,1,36,6,2007-03-13 06:33:41,2007-03-12 19:52:07
ef203f08564c1c6d267fedf8e0357c56d477892f...c816eb1784b324fcf3988253affac4d43bce78c9,1,1,1,2,1,2007-03-11 04:05:01,2007-03-05 00:13:09
c816eb1784b324fcf3988253affac4d43bce78c9...923642fe1bdf010a1f2bef1507e17b9ee97cbf87,1,2,2,4,1,2007-03-11 04:05:01,2007-03-11 02:45:29
923642fe1bdf010a1f2bef1507e17b9ee97cbf87...fabbd8f6ca610a570d7bfcbbfc80bb0e03247b2a,1,3,11,14,1,2007-03-11 04:05:01,2007-03-11 02:52:39
fabbd8f6ca610a570d7bfcbbfc80bb0e03247b2a...ed4eb0d8f3560c20a3b8eefefdcaae4d864743c6,1,1,1,2,1,2007-03-11 04:05:01,2007-03-11 03:00:12
ed4eb0d8f3560c20a3b8eefefdcaae4d864743c6...1dc71a9155e209ed4da866eeb7c3064e4568532e,1,21,4,25,20,2007-03-11 04:05:01,2007-03-11 03:38:13
1dc71a9155e209ed4da866eeb7c3064e4568532e...8ce9d83b78fa95addf61cb911fa052ec4f37f77e,1,1,1,2,1,2007-03-11 04:05:02,2007-03-11 03:58:54
ef203f08564c1c6d267fedf8e0357c56d477892f...443b92b6e50462942a8b2ca22a7def87036762ff,1,2,0,2,1,2007-03-10 00:46:53,2007-03-09 22:38:57
443b92b6e50462942a8b2ca22a7def87036762ff...c4431d380c20b4c05c373980c600798fc02e79b0,1,3,3,6,2,2007-03-10 01:27:43,2007-03-09 20:21:41
ba66c58637734a7a70196515a43328c2e92016c8...c390ae97beb9e8cdab159b593ea9659e8096c4db,1,2,2,4,2,2007-03-06 11:08:06,2007-03-06 03:58:56
ba66c58637734a7a70196515a43328c2e92016c8...86ab4906a7c86719cae33b28dac1a4157d665867,2,100,116,216,18,2007-03-06 09:08:34,2007-03-05 21:10:06
86ab4906a7c86719cae33b28dac1a4157d665867...2b064697a5b0610254f52523ce5b70c81118da80,3,13,5,18,9,2007-03-06 09:08:34,2007-03-06 00:10:28
2b064697a5b0610254f52523ce5b70c81118da80...c2dea5a11cc7106d0beec9931e527467b7189ab3,1,33,13,46,5,2007-03-06 09:08:34,2007-03-06 00:16:32
c2dea5a11cc7106d0beec9931e527467b7189ab3...c33d8593851ef1b3b59fc9b8022019cb955e8d59,1,18,8,26,10,2007-03-06 09:08:34,2007-03-06 02:23:57
c33d8593851ef1b3b59fc9b8022019cb955e8d59...80e25ceece17fd575735c40dc923086154402cbe,1,35,20,55,7,2007-03-06 09:08:34,2007-03-06 00:17:27
80e25ceece17fd575735c40dc923086154402cbe...892ae6bf13d3811f36e6fe65c4ff85841e1c4f14,1,1,1,2,1,2007-03-06 11:00:18,2007-03-06 11:00:18
892ae6bf13d3811f36e6fe65c4ff85841e1c4f14...8839ac9442c9ded41bfa369a142fd2e659a44377,1,8,8,16,2,2007-03-06 11:20:55,2007-03-06 11:20:55
8839ac9442c9ded41bfa369a142fd2e659a44377...8315588b59bea45c4b82451cc3ac337fa5c68526,2,24,1,25,4,2007-03-07 06:06:46,2007-03-06 21:57:07
8315588b59bea45c4b82451cc3ac337fa5c68526...18449ab0e9754ae04ae2f232449241ac361f3db4,2,23,3,26,5,2007-03-08 01:38:48,2007-03-07 23:43:05
18449ab0e9754ae04ae2f232449241ac361f3db4...9e64d109f905afb225f48409c4e0e068b2203332,1,26,59,85,15,2007-03-08 02:02:10,2007-03-08 00:27:44
9e64d109f905afb225f48409c4e0e068b2203332...263703fff38d252907d1c7ae9977038715e2e22f,1,2,1,3,1,2007-03-09 06:57:51,2007-03-09 02:48:27
263703fff38d252907d1c7ae9977038715e2e22f...d58c6184e345b9c8c8bfe8cc3eb1bbfe2f5ee4f9,1,2,4,6,2,2007-03-09 06:58:03,2007-03-09 02:48:46
d58c6184e345b9c8c8bfe8cc3eb1bbfe2f5ee4f9...2e578f9a4f08ade4e8da52614c566e5dc1c8ca00,1,2,2,4,2,2007-03-09 06:59:07,2007-03-09 02:50:06
ba66c58637734a7a70196515a43328c2e92016c8...74f2b2a8d006a49e1be7e30731c2f7365d2741d1,3,62,42,104,36,2007-03-06 08:48:13,2007-03-06 06:35:01
74f2b2a8d006a49e1be7e30731c2f7365d2741d1...2314c947706b9480ddd8c1420efa8da523d99c9f,3,5,5,10,5,2007-03-06 08:48:13,2007-03-06 07:09:14
2314c947706b9480ddd8c1420efa8da523d99c9f...31d0399c3c310d035cd7ed55c094f0b636ac5e20,2,6,4,10,5,2007-03-07 01:16:37,2007-03-06 22:37:18
31d0399c3c310d035cd7ed55c094f0b636ac5e20...b777434383bd2f365be6896d8c89be6c1b62a135,1,7,3,10,2,2007-03-07 01:17:07,2007-03-06 23:44:49
b777434383bd2f365be6896d8c89be6c1b62a135...a6f37099d0fce10b536abc1d1a8111460638bac0,1,8,2,10,2,2007-03-07 01:17:13,2007-03-06 23:05:34
63e50d492c658b4a0d616f57f8b43a7a9ba1bbcc...7ee70a7119e7d7edc1f85992d0ba8860c1c60a96,1,3,3,6,3,2007-02-27 23:38:05,2007-02-27 15:43:28
7ee70a7119e7d7edc1f85992d0ba8860c1c60a96...aa27e46111a777ae8b11e00675e13b1a9cde7fc2,1,2,0,2,1,2007-02-28 01:09:55,2007-02-28 00:22:52
aa27e46111a777ae8b11e00675e13b1a9cde7fc2...0a43acbe85fedf0226bd04aa210c529c72325982,1,4,5,9,2,2007-02-28 04:44:52,2007-02-28 03:27:44
0a43acbe85fedf0226bd04aa210c529c72325982...79c96c573357385cdc6d15b37bf65e5c137092ef,1,14,17,31,12,2007-02-28 05:24:56,2007-02-28 04:13:09
79c96c573357385cdc6d15b37bf65e5c137092ef...ae648606220c55074dfa12d1a11f60e62a7254ac,1,1,1,2,1,2007-02-28 05:41:48,2007-02-26 08:31:57
ae648606220c55074dfa12d1a11f60e62a7254ac...a91d49cd369ac5fc8e1a17357a975d09cf6c8cb3,1,8,2,10,2,2007-02-28 05:58:46,2007-02-28 04:47:19
a91d49cd369ac5fc8e1a17357a975d09cf6c8cb3...163d7b9b8536d206eda7eb0eccb0fc211812346f,1,3,1,4,2,2007-02-28 06:02:41,2007-02-28 05:44:42
8807d321af394ffb2180d085669337bcd5018c50...047f636d903c773e237f684826cc68c79a1a0075,1,4,0,4,1,2007-02-26 08:32:48,2007-02-24 15:32:56
047f636d903c773e237f684826cc68c79a1a0075...c260d790c85c07a5f50235f664c36725deedfb10,1,3,1,4,1,2007-02-26 09:16:01,2007-02-26 09:16:01
2eb06531e3d53c2604f20c32e5cb791d5044ff02...20f50f1670c18173d74a34527b0c538c3fbbfde3,3,6,6,12,6,2007-03-01 11:27:36,2007-03-01 05:14:23
20f50f1670c18173d74a34527b0c538c3fbbfde3...112f63851bae2ff6f04092a2eb4261d6e5990c65,1,67,52,119,17,2007-03-01 21:25:59,2007-03-01 19:41:17
2eb06531e3d53c2604f20c32e5cb791d5044ff02...fcfa33ec905fcde1c16e7cbbe00d7147b89f1f01,4,64,2,66,4,2007-03-01 00:32:31,2007-02-25 22:35:27
253e772edeb56092e0fad43ec0640658671313c5...118f8b241355b38cd21e644e8620d81f10190627,4,74,25,99,11,2007-03-04 03:59:37,2007-03-02 20:53:33
c49b260e99d3e0fdd5d84615091ebb969adef5b2...c47e6a43d30c8a1fd4b8e9234883f01fe3bac805,1,1,1,2,1,2007-03-14 16:14:51,2007-03-14 14:25:52
c49b260e99d3e0fdd5d84615091ebb969adef5b2...459bad77e72122f200314a4b0a059a845e0072b3,1,8,0,8,4,2007-03-14 09:09:32,2007-03-13 17:25:22
459bad77e72122f200314a4b0a059a845e0072b3...392e28170bcd2dec93ed629e7f8b2c22c560bf34,1,6,3,9,6,2007-03-14 09:09:33,2007-03-13 17:25:23
efa13f7b7ea1605deab3a6478fa0d0706c828170...de6f0def506935811384a39fb0660095f5555e68,1,9,6,15,1,2007-02-16 23:08:25,2007-02-16 23:08:25
c230390b4773b9e4469085283033da9e910e50a6...870b39c15fd084d4db977298b3d3af645b57d083,1,4,1,5,3,2007-02-14 03:30:03,2006-11-05 19:52:43
870b39c15fd084d4db977298b3d3af645b57d083...44478d99ee0b2c219a733545efe0cb422658bf60,1,2,1,3,1,2007-02-14 05:40:24,2007-02-13 14:24:06
44478d99ee0b2c219a733545efe0cb422658bf60...859f9c45814afae3250424946e2156ea366224f7,3,28,1,29,5,2007-02-14 05:40:42,2007-02-14 00:30:29
cb115748ec0d4c6faccd09f3637ea436482dd7d5...37958be79227dc01f965993174af42672fc6756c,1,15,25,40,2,2006-06-18 11:17:49,2006-06-18 10:57:56
37958be79227dc01f965993174af42672fc6756c...9236cdd488c26ec09e23adec34f64fd6fca3dc7c,1,10,5,15,5,2006-06-18 11:18:25,2006-06-18 10:57:59
9236cdd488c26ec09e23adec34f64fd6fca3dc7c...6698060c15e837babb3b80f980bbed290934a692,1,5,2,7,4,2006-06-18 11:18:43,2006-06-18 10:58:01
cb115748ec0d4c6faccd09f3637ea436482dd7d5...ca3bcabf1187f4f09e62fdb1bc8aafa16d3ceea0,1,20,8,28,10,2006-06-18 02:17:34,2006-06-14 22:36:00
cb115748ec0d4c6faccd09f3637ea436482dd7d5...6c4cca1c72f98c84a21a2d1916a8e86be57d26e6,1,5,2,7,1,2006-06-18 01:51:53,2006-06-12 19:31:38
d698206c12a4680a92c5f4894f0345dc7dcfe62a...94a2eede68f2d3cacef489044f5b822f45f2a10d,1,23,7,30,10,2005-08-07 05:27:57,2005-08-07 05:27:57
94a2eede68f2d3cacef489044f5b822f45f2a10d...d6e8149bc53de57cab7cc0d9aff6c2341f3a7efa,1,1,1,2,1,2005-08-07 10:01:24,2005-08-07 10:01:24
bbca20accefe8329f976371d0d8c111c965cdf1a...12ba7eaf1d8188ff85439abb98c5ce64cc81b319,1,2,2,4,2,2005-07-05 19:12:50,2005-07-05 19:12:50
12ba7eaf1d8188ff85439abb98c5ce64cc81b319...4f7770c87ce3c302e1639a7737a6d2531fe4b160,1,3,38,41,3,2005-07-05 21:39:30,2005-07-05 21:39:30
4f7770c87ce3c302e1639a7737a6d2531fe4b160...41cb7488b9e5998ce1d665bbe10beca0a0f69c1c,3,20,18,38,4,2005-07-05 22:44:09,2005-07-05 22:44:09
41cb7488b9e5998ce1d665bbe10beca0a0f69c1c...2f34ba32dde0131ab280f8ca902f04e39af7dcc0,1,2,2,4,1,2005-07-05 22:45:00,2005-07-05 22:45:00
2f34ba32dde0131ab280f8ca902f04e39af7dcc0...1fcc8ea55d9a126156c037a8c80dc256ceec0855,2,209,1,210,2,2005-07-05 22:45:37,2005-07-05 22:45:37
1fcc8ea55d9a126156c037a8c80dc256ceec0855...72347a233e6f3c176059a28f0817de6654ef29c7,1,1,4,5,1,2005-07-05 22:47:34,2005-07-05 22:47:34
72347a233e6f3c176059a28f0817de6654ef29c7...291ec0f2d2ce65e5ccb876b46d6468af49ddb82e,1,0,2,2,1,2005-07-06 00:06:09,2005-07-06 00:06:09
291ec0f2d2ce65e5ccb876b46d6468af49ddb82e...0271611e390c3aaacc4f4f0529c10c7b095ed682,2,30,1,31,2,2005-07-06 00:08:02,2005-07-06 00:08:02
0271611e390c3aaacc4f4f0529c10c7b095ed682...319aae27567f3ddc40e9083c425f7eaf567006a0,1,1,1,2,1,2005-07-06 00:19:20,2005-07-06 00:19:20
319aae27567f3ddc40e9083c425f7eaf567006a0...f17a1b1bec5cef1d39521aac92f94858acda6433,1,10,4,14,3,2005-07-06 01:10:59,2005-07-06 01:10:59
bfe19f876cb20bea606e1a698030c017f31965c1...200e7fbbac82b6665f8175af0e375fbef3568c30,1,0,1,1,1,2005-08-07 21:11:02,2005-08-07 21:11:02
55bc3fe36a4b931c3899dc453bf2d554ccabc495...d5928d602667546d9834beb0ab8bf641ad45c028,1,2,1,3,2,2005-08-07 03:54:49,2005-08-07 03:38:13
d5928d602667546d9834beb0ab8bf641ad45c028...f29eaed12fc07bc5b2e4d1a302136a26ff4488ce,2,6,6,12,3,2005-08-07 05:29:21,2005-08-07 05:29:21
74c7cfa875448c71a18d21a0cc7c973afe759fa5...c64b9b88605f9d6824bf953a84d993c4a70fd759,1,1128,0,1128,1,2005-05-06 06:48:52,2005-05-06 06:48:52
c64b9b88605f9d6824bf953a84d993c4a70fd759...ac4e0869294cd03b9320de3b2d851f2a3980d927,1,294,287,581,155,2005-05-06 06:49:58,2005-05-06 06:49:58
ac4e0869294cd03b9320de3b2d851f2a3980d927...4df1e7950787197f7cad081b98f9ffe6c4089fc9,1,104,0,104,12,2005-05-06 06:50:22,2005-05-06 06:50:22
4df1e7950787197f7cad081b98f9ffe6c4089fc9...cc167ccaeb1adcdc392f9e03ed1225762ea3cf96,1,31,6,37,3,2005-05-06 08:12:04,2005-05-06 08:12:04
cc167ccaeb1adcdc392f9e03ed1225762ea3cf96...e78d97723cd77d46d8767a5a27965077249fd080,6,60,15,75,23,2005-05-06 08:37:21,2005-05-06 08:37:21
e78d97723cd77d46d8767a5a27965077249fd080...20d37ef67286e5131d2333d7b4662bc70f9d4937,2,36,10,46,12,2005-05-06 09:00:45,2005-04-22 02:47:08
20d37ef67286e5131d2333d7b4662bc70f9d4937...ffbe1addd5a5b7b7c2f987625a5aa6c1d22e3705,3,49,9,58,10,2005-05-06 15:41:12,2005-05-06 13:45:01
ffbe1addd5a5b7b7c2f987625a5aa6c1d22e3705...22b781051bc1902b656708acbc51f39654ce969d,1,0,1,1,1,2005-05-06 15:49:07,2005-05-06 15:49:07
22b781051bc1902b656708acbc51f39654ce969d...fcfda02bc7e3a9dacf63fa43df8eee530a471f96,1,31,2,33,3,2005-05-06 16:01:27,2005-05-06 08:00:11
fcfda02bc7e3a9dacf63fa43df8eee530a471f96...e0965d83c533e8b6a51f1c6c1be12f5edee5ca65,1,77,9,86,13,2005-05-06 17:03:17,2005-05-06 17:03:17
e0965d83c533e8b6a51f1c6c1be12f5edee5ca65...f4f21ce367a5119be1c4396d01271ece6e40ff70,1,27,3,30,9,2005-05-06 17:56:35,2005-05-06 17:56:35
f4f21ce367a5119be1c4396d01271ece6e40ff70...bd2c39f58f915af532b488c5bda753314f0db603,9,115,70,185,44,2005-05-06 18:02:01,2005-05-06 17:48:34
bd2c39f58f915af532b488c5bda753314f0db603...cee99d2257790edea79a11513032f95475e07acc,1,58,3,61,7,2005-05-06 18:42:47,2005-05-06 18:42:47
cee99d2257790edea79a11513032f95475e07acc...a90a6e6a781129574802c8777f0e083eb255a463,1,13,13,26,5,2005-05-06 21:42:59,2005-05-06 20:55:42
a90a6e6a781129574802c8777f0e083eb255a463...03d791ff117dfdca610a7bfe9ba12dddda504b94,1,20,5,25,6,2005-05-06 21:42:59,2005-05-06 20:55:52
03d791ff117dfdca610a7bfe9ba12dddda504b94...71058b1f2be17bde78f8cf5832a3e03952fa4aac,1,40,18,58,8,2005-05-06 21:42:59,2005-05-06 20:56:01
71058b1f2be17bde78f8cf5832a3e03952fa4aac...08f09dac0126482005013e4f9a108de8c7d42f43,1,13,10,23,9,2005-05-06 21:42:59,2005-05-06 20:56:08
08f09dac0126482005013e4f9a108de8c7d42f43...d5776d50aa83ba90c639a6c1201af144f9ee992d,1,47,13,60,19,2005-05-06 21:42:59,2005-05-06 20:56:16
d5776d50aa83ba90c639a6c1201af144f9ee992d...5aad72f2bc1527e1fcdf460f0a36b0bcc4117b4a,2,31,2,33,3,2005-05-06 21:55:16,2005-05-06 20:17:13
5aad72f2bc1527e1fcdf460f0a36b0bcc4117b4a...f80cd783c6f346388bbb0a6a15672be99a71f7ed,2,29,0,29,2,2005-05-06 22:28:59,2005-05-06 22:28:59
f80cd783c6f346388bbb0a6a15672be99a71f7ed...a02ebff6127c5fc981668fb570f0a80f2b7657ca,1,24,1,25,3,2005-05-06 22:33:59,2005-05-06 22:33:59
a02ebff6127c5fc981668fb570f0a80f2b7657ca...ee267527aa80807f37caf1d00bcf1b5263945adb,3,8,42,50,13,2005-05-06 23:48:43,2005-05-06 23:48:43
ee267527aa80807f37caf1d00bcf1b5263945adb...3d0291c4506f4bfa3869771e580b7304817fec00,3,0,12,12,3,2005-05-07 00:00:20,2005-05-06 23:32:28
3d0291c4506f4bfa3869771e580b7304817fec00...bf60144c0ab50e88c0086a90c5cb35b81613ad14,2,0,3,3,2,2005-05-07 00:02:24,2005-05-06 23:33:39
bf60144c0ab50e88c0086a90c5cb35b81613ad14...e7d3dd248f50501f98b29c917e70bddcf3ea925a,1,7,8,15,5,2005-05-07 05:12:08,2005-05-07 00:57:06
36e6c803a1ef68b8acdc4138597db4fb087112be...30fd3a54256a54e5a6006a203c923e97641fb2c2,1,9,0,9,1,2012-04-16 05:44:39,2012-04-14 23:15:17
36e6c803a1ef68b8acdc4138597db4fb087112be...5c293a6be48d2e2ab4516aa113bb340b5cf0a12a,1,120,0,120,1,2012-04-15 20:36:41,2012-04-11 21:57:03
5c293a6be48d2e2ab4516aa113bb340b5cf0a12a...74a8c849f1257dde0c42feac95ba517bae625647,1,85,0,85,1,2012-04-22 05:39:06,2012-04-17 10:27:15
74a8c849f1257dde0c42feac95ba517bae625647...3bf421ea624fb083ea4d88fd487ae8b7b8bae06a,1,6,6,12,4,2012-04-22 05:39:06,2012-04-15 19:44:16
3bf421ea624fb083ea4d88fd487ae8b7b8bae06a...3954068128e1907521c19f09dca27068ce8c6945,1,2,2,4,2,2012-04-22 05:39:06,2012-04-15 19:44:17
3954068128e1907521c19f09dca27068ce8c6945...69ef3c0296e173535b73c7376469a722d54681f2,2,18,0,18,5,2012-04-22 05:39:06,2012-04-15 19:44:18
69ef3c0296e173535b73c7376469a722d54681f2...3ffcd08688a0e5f5de808c1077d10552d1f84e70,2,7,1,8,3,2012-04-22 05:39:07,2012-04-15 19:44:19
3ffcd08688a0e5f5de808c1077d10552d1f84e70...911d5da6f20e28cfe16ea539a4f1b86293a7280e,2,19,1,20,3,2012-04-22 05:39:07,2012-04-15 19:44:20
e1341abc3759950e891822088cb0163b71b316b3...4fb8c8075a9952a9d544721e2122a1b2941d8ef6,1,5,2,7,3,2007-06-27 01:06:58,2007-06-26 15:39:07
4fb8c8075a9952a9d544721e2122a1b2941d8ef6...b658d50325c938d87d4891cb62e2eefb0b58a62c,1,1,1,2,1,2007-06-27 01:18:47,2007-06-25 11:04:26
39741ab1c54c6e7411b983f2a64d5813bc5b4059...0227f9887bcc158dcd22ac4f60e5e428b259dd2d,1,5,4,9,2,2007-06-30 18:44:20,2007-06-30 18:44:20
68a163c9b483ae352fcfee8c4505d113213daa73...795cbe938fdc60228c4c9654a658aa27a7570b79,1,1,1,2,1,2009-06-11 21:01:15,2009-06-11 20:27:55
68a163c9b483ae352fcfee8c4505d113213daa73...f09c9b8c5ff9d8a15499b09ccd6c3e7b3c76af77,3,151,4,155,12,2007-06-27 01:58:59,2007-06-25 17:59:43
9cc0589ae85b782534b893faedc6a482fd9905ea...db1696b8ab1d1bde67e78c773c58d837fa8b5e70,4,95,21,116,11,2007-06-27 06:16:17,2007-06-25 14:00:24
65d61e5f512f15b8384a2b6bfe818713fe5bebcb...ad0f8c9ea76dcce82eb3fa1b308e495c21b834d1,1,11,8,19,3,2007-03-14 04:16:05,2007-03-13 17:24:26
681bfd59ce1a93a4492e11a480e438099f721294...a1a4975824e8f9f88a8c96ae908c488a2c6047c5,1,2,2,4,2,2007-05-08 14:35:58,2007-05-08 11:33:06
0220f1ebdee113e02031de0dba2d5e2c8623d6bb...ab6029415b7e8acbc1beff7363c74bb94c3f0d9d,2,38,1,39,2,2007-04-18 00:47:59,2007-04-18 00:32:23
845d377b2880a0c5d74f785244469ab1ac815bde...f20db5ff30af2169a0fe8a0afe015c30cdbe0256,1,26,20,46,6,2007-04-24 06:11:40,2007-04-24 06:11:40
4739cea5668bc398600197d2a4a425119c8dc322...86952cdabdcc550a20794794db539c41877d17fc,1,1,0,1,1,2007-03-14 08:29:26,2007-03-14 08:29:26
86952cdabdcc550a20794794db539c41877d17fc...0497c620cae0531815afc4ada783b488eab3f447,1,4,1,5,2,2007-03-14 08:33:41,2007-03-08 10:12:06
0497c620cae0531815afc4ada783b488eab3f447...6cd7895feeaee3970b76988ed82b2c701a5b28df,1,1,1,2,1,2007-03-14 08:33:49,2007-03-11 13:19:07
6cd7895feeaee3970b76988ed82b2c701a5b28df...09f2825147d44bd0333f7f47d8ab3837f0848867,1,14,1,15,2,2007-03-14 08:37:50,2007-03-12 12:11:29
3635a187704ed30b32eb11f5098496e5e435a19d...18bdec1118df92649b70ce126aff2f147deecad5,5,46,4,50,10,2007-03-19 05:43:37,2007-03-19 05:14:37
8bb2b516d56722776255faaccc0b1d63e444a93e...96a5702409e193616ad7e56700dd6051ad324654,1,1,1,2,1,2007-03-11 05:47:45,2007-03-11 01:35:00
96a5702409e193616ad7e56700dd6051ad324654...38448147553917c584a353ed6c39ad55b037f694,1,18,6,24,4,2007-03-11 05:58:21,2007-03-10 18:21:25
38448147553917c584a353ed6c39ad55b037f694...60fa08ed617dd148a9843bfdef2dfecf2ef60123,1,53,24,77,4,2007-03-11 05:58:26,2007-03-10 18:22:26
84da035f3862b72d103d21104a1f67b003d17ebb...8e663d9e90d3d9efc9bb99ad597a6819efe625ce,1,1,2,3,3,2007-03-07 22:45:40,2007-03-07 21:50:24
8e663d9e90d3d9efc9bb99ad597a6819efe625ce...3e6e152c7496c1acd298ec2b916d62acb56f11c0,1,4,4,8,2,2007-03-07 22:45:42,2007-03-07 21:50:43
3e6e152c7496c1acd298ec2b916d62acb56f11c0...c8dd277109c1cdb9422e474e6bd6e32a382291a0,1,44,19,63,14,2007-03-07 22:45:43,2007-03-07 21:51:09
c8dd277109c1cdb9422e474e6bd6e32a382291a0...8aaf7d6410119ee221f5d3ebdc4fc5a57f862665,2,36,32,68,18,2007-03-07 22:47:09,2007-03-07 21:51:59
8aaf7d6410119ee221f5d3ebdc4fc5a57f862665...05ef58ec1f2fb69d6e7ae7fca84163f75bd95050,3,191,62,253,30,2007-03-07 23:03:33,2007-03-07 21:52:05
c390ae97beb9e8cdab159b593ea9659e8096c4db...93e72d8d8fbfbbf28abee82c3e769337d7b940ec,1,6,8,14,2,2007-03-07 22:11:02,2007-03-07 22:09:21
93e72d8d8fbfbbf28abee82c3e769337d7b940ec...60b9004cdb106ce56589cbe587b6b5e7d6ad3cf9,1,26,9,35,2,2007-03-07 23:05:38,2007-03-07 23:05:38
60b9004cdb106ce56589cbe587b6b5e7d6ad3cf9...e8438420bb7d368bec3647b90c557b9931582267,3,56,1,57,4,2007-03-07 23:07:26,2007-03-07 23:07:26
c390ae97beb9e8cdab159b593ea9659e8096c4db...edc04e90f5a79b7805f1188ca94f06ef7eed81f5,1,3,3,6,3,2007-03-07 03:04:07,2007-03-07 01:21:25
edc04e90f5a79b7805f1188ca94f06ef7eed81f5...e3d842cf12f6ef6d155ef578957cf98d93abe09a,3,5,0,5,3,2007-03-07 18:22:44,2007-03-07 12:18:59
e3d842cf12f6ef6d155ef578957cf98d93abe09a...d9cb5399ee6e3ca4b3190f158ada7bd3802b3c70,2,81,24,105,10,2007-03-07 18:30:22,2007-03-07 09:43:41
d9cb5399ee6e3ca4b3190f158ada7bd3802b3c70...30fee0625d9e7012a3baf92c1315cfde751b8582,1,1,0,1,1,2007-03-07 18:35:16,2007-03-07 01:44:08
30fee0625d9e7012a3baf92c1315cfde751b8582...2d88451b7a8cdd8bc233c7910c775bbb0ac76457,1,16,9,25,9,2007-03-07 18:41:33,2007-03-07 01:44:11
2d88451b7a8cdd8bc233c7910c775bbb0ac76457...ff1f99453f1fe2fd9470f6ea268aed5a1839bd09,1,2,0,2,2,2007-03-07 18:42:07,2007-03-07 01:44:14
ff1f99453f1fe2fd9470f6ea268aed5a1839bd09...3a55602eeca4ac8670e8698a7187e18b95683344,16,40,42,82,35,2007-03-07 18:47:10,2007-03-07 01:44:17
3a55602eeca4ac8670e8698a7187e18b95683344...326bf396778bc9ab8f9e253bb514e7f41ef1502b,5,15,15,30,12,2007-03-07 19:02:33,2007-03-07 01:44:19
326bf396778bc9ab8f9e253bb514e7f41ef1502b...7cadf491c6d7a29e345e1608c23b0d98cee5e848,1,30,33,63,26,2007-03-07 19:02:38,2007-03-07 01:44:24
7cadf491c6d7a29e345e1608c23b0d98cee5e848...c4001d92be61766d3494489b15590ca0147ee19d,6,54,47,101,43,2007-03-07 19:06:25,2007-03-07 01:44:30
c4001d92be61766d3494489b15590ca0147ee19d...6777a59fcdfd96b9ca5cba49cb265c6c47de3d02,2,28,28,56,26,2007-03-07 19:06:33,2007-03-07 01:44:34
6777a59fcdfd96b9ca5cba49cb265c6c47de3d02...dc49cd769b5fa6b7e0114b051c34a849828a7603,16,83,59,142,60,2007-03-07 19:15:26,2007-03-07 01:44:37
163d7b9b8536d206eda7eb0eccb0fc211812346f...cf70c16fc0661ec562b01222055b8be4bfd1a7e7,1,2,1,3,2,2007-02-28 18:22:50,2007-02-28 12:35:39
cf70c16fc0661ec562b01222055b8be4bfd1a7e7...2c46759db757eb742590e8547cb0c63e8bdb1da1,1,1,1,2,1,2007-02-28 20:12:02,2007-02-28 20:12:02
2c46759db757eb742590e8547cb0c63e8bdb1da1...a94f457e89f78a5a15e63417abdb281ce655f986,1,15,4,19,3,2007-02-28 20:38:08,2007-02-28 20:02:02
a94f457e89f78a5a15e63417abdb281ce655f986...14b4f2dbd10c0c5f25ed7804eb5e803637231b32,1,18,6,24,8,2007-02-28 20:39:14,2007-02-28 19:59:48
14b4f2dbd10c0c5f25ed7804eb5e803637231b32...4fa96e15571cb3ccf4e0ac1feb1ecf96521c6b70,1,1,0,1,1,2007-02-28 21:48:10,2007-02-28 20:57:42
4fa96e15571cb3ccf4e0ac1feb1ecf96521c6b70...db554bf0a7a111de5157286cfa216817001f87fa,1,14,3,17,3,2007-02-28 22:05:42,2007-02-28 22:05:42
db554bf0a7a111de5157286cfa216817001f87fa...a1367d1219439fef8e82e546cbe742910231e5b3,2,56,1,57,2,2007-02-28 22:17:45,2007-02-28 22:17:45
4e4b55dd0f5b4644767265f7c16a8b370278ce56...ada5ef3b48be7ded62af1f9b7fdb71db3024ac71,1,16,27,43,14,2007-02-27 23:44:40,2007-02-21 05:54:39
ada5ef3b48be7ded62af1f9b7fdb71db3024ac71...1872adabccdd904f31f16276b147c63fa03079d4,1,1,0,1,1,2007-02-27 23:51:03,2007-02-27 12:49:09
1872adabccdd904f31f16276b147c63fa03079d4...8538e876b191901b7d37ec34a83287e51df91816,1,38,9,47,8,2007-02-28 00:01:58,2007-02-27 13:46:55
4e4b55dd0f5b4644767265f7c16a8b370278ce56...d65a16f6c45c9b2a16f3abc45f727dc6507c853d,1,12,12,24,9,2007-02-27 09:34:21,2007-02-26 19:55:55
d65a16f6c45c9b2a16f3abc45f727dc6507c853d...2b87c45ba6f8950ffc44cb6a3c861ad2e5f176a8,1,51,59,110,44,2007-02-27 09:34:21,2007-02-26 19:55:56
2b87c45ba6f8950ffc44cb6a3c861ad2e5f176a8...9ba630318f6fbc2f129e5a6872d70d2914cacb39,1,1,1,2,1,2007-02-27 09:34:21,2007-02-26 19:55:57
9ba630318f6fbc2f129e5a6872d70d2914cacb39...df8436622fb553f468180b61032fe34bd6712752,7,39,48,87,18,2007-02-27 09:34:21,2007-02-26 19:55:58
df8436622fb553f468180b61032fe34bd6712752...21666f1aae4e890d8f50924f9e80763b27e6a45d,37,265,289,554,222,2007-02-27 09:34:21,2007-02-26 19:55:59
21666f1aae4e890d8f50924f9e80763b27e6a45d...0ab179504a17907c395a4009f7c23d2f71bba1d3,3,18,24,42,6,2007-02-27 09:34:21,2007-02-26 19:56:00
e551208dea5cd40721c437faafb6d604dedffef5...ae792aa52bb0962079f500bd491363f2b48457b6,1,13,1,14,1,2007-03-04 07:45:14,2007-03-04 07:45:14
e551208dea5cd40721c437faafb6d604dedffef5...9509af686bffdbd7c3f17faf3c07d2034d480ffc,5,414,204,618,11,2007-03-04 06:59:34,2007-03-01 04:26:30
9509af686bffdbd7c3f17faf3c07d2034d480ffc...f52463a58275c8dd12b26b02bc0388d015547fcc,1,6,13,19,2,2007-03-04 21:15:09,2007-03-04 13:26:05
f52463a58275c8dd12b26b02bc0388d015547fcc...0e6240447c6e0e75e22c30ece7eedb16e1e8ff0b,1,2,2,4,1,2007-03-06 05:55:31,2007-03-06 05:46:00
bd1fc628b8d456bdaea3e10d435cf1e98bc5d8a8...a858c006fae17cef44dd63737771f2bebb6eeae8,1,10,4,14,6,2007-03-09 08:09:25,2007-02-25 21:13:17
bd1fc628b8d456bdaea3e10d435cf1e98bc5d8a8...896bdfa2581f96d3df9a312510c39ce7d80790cd,1,17,1,18,4,2007-03-09 08:06:00,2007-02-28 03:31:10
bd1fc628b8d456bdaea3e10d435cf1e98bc5d8a8...6cbf07efc5702351897dee4742525c9b9f7828ac,2,23,7,30,8,2007-03-09 08:05:23,2007-03-05 07:57:53
31930b5beece8ff86f823b62cf0937e73e9494fa...c044aa18f68bcba4f7ec6fd625eb48c2520a1bb1,1,6,0,6,2,2007-03-06 07:28:36,2007-03-06 06:48:00
240c77c7146a58834cf7e425bde956b646c69024...4a62d3f5b237fb9fab7df778ecf62906ff892065,2,19,1,20,3,2007-03-12 06:53:57,2007-03-11 17:19:44
4a62d3f5b237fb9fab7df778ecf62906ff892065...34572ed2c809c2e0b00dc660bdb2dd201c5ff85f,1,8,3,11,4,2007-03-12 06:55:46,2007-03-09 16:30:15
803527f1d9b284fa848d4a4bad23158c162a5d54...9debc3241b5d54891600c839b4df4f48b2daa60c,7,79,22,101,19,2007-03-16 09:10:12,2007-03-15 08:23:20
9debc3241b5d54891600c839b4df4f48b2daa60c...dbb2b41aa49aa0cd088f5fabd5326dcfed7144e3,1,2,2,4,2,2007-03-16 09:12:14,2007-03-16 01:02:51
dbb2b41aa49aa0cd088f5fabd5326dcfed7144e3...0d38ab259e074cd0962451075faf120c416a0706,1,2,2,4,2,2007-03-17 04:22:05,2007-03-17 04:22:05
0d38ab259e074cd0962451075faf120c416a0706...e8e91fece83cf67810e5b8b2908601c048ecd19c,1,13,20,33,9,2007-03-17 04:27:35,2007-03-16 17:20:19
e8e91fece83cf67810e5b8b2908601c048ecd19c...82868f72b5393d3dbe3ef976dba8d5aa63ffddc3,1,1,1,2,1,2007-03-17 04:27:35,2007-03-16 17:37:42
82868f72b5393d3dbe3ef976dba8d5aa63ffddc3...ac527b0b7c9be37ad7f2f7d871b6e9b41fd0c431,1,65,6,71,9,2007-03-17 04:27:36,2007-03-16 17:50:18
ac527b0b7c9be37ad7f2f7d871b6e9b41fd0c431...4287307833a7c67b09973fc1023311e473f830b2,6,90,87,177,56,2007-03-17 04:27:36,2007-03-16 20:42:50
803527f1d9b284fa848d4a4bad23158c162a5d54...0053e902b4f777ba454b62263d3695e5292b1559,2,12,5,17,6,2007-03-14 23:22:18,2007-03-13 08:57:22
803527f1d9b284fa848d4a4bad23158c162a5d54...41bbf9d58575095234c64df979ee884334469758,9,118,14,132,25,2007-03-14 23:21:19,2007-03-14 00:17:04
41bbf9d58575095234c64df979ee884334469758...3161b4b52112acb6a3eb57f3bf882e8ca131e7d3,2,0,13,13,2,2007-03-14 23:21:19,2007-03-14 17:36:42
3161b4b52112acb6a3eb57f3bf882e8ca131e7d3...68aacb2f3ceef528ded945b510094918bfe3cb37,2,27,4,31,8,2007-03-14 23:21:19,2007-03-14 18:12:13
68aacb2f3ceef528ded945b510094918bfe3cb37...822cac015589889c1a9e6d49a2c054b7f1b838ba,2,8,0,8,3,2007-03-14 23:21:19,2007-03-14 18:12:51
822cac015589889c1a9e6d49a2c054b7f1b838ba...0a4ba7f8c6140c516f0ee073a6b71d0db24d6242,1,9,2,11,3,2007-03-14 23:21:19,2007-03-14 20:12:18
0a4ba7f8c6140c516f0ee073a6b71d0db24d6242...dd47aa31339d2b8acdf909fd0067544c31cd9358,1,6,0,6,5,2007-03-14 23:21:19,2007-03-14 20:18:15
dd47aa31339d2b8acdf909fd0067544c31cd9358...0c66d6be4f888096865b8f3d5fdc00c83e4ecc3f,1,80,0,80,1,2007-03-16 09:13:27,2007-03-14 22:57:23
de6f0def506935811384a39fb0660095f5555e68...f44213258de3fbef932f9c655213202f69dccc80,1,3,0,3,2,2007-02-17 05:39:21,2007-02-16 08:50:58
f44213258de3fbef932f9c655213202f69dccc80...185c975faaa790a98a4e00f124461473283500d6,6,46,16,62,11,2007-02-17 06:56:06,2007-02-17 06:43:48
185c975faaa790a98a4e00f124461473283500d6...5ca2db53763ed93a75de7ddbda753fc09327d7aa,1,14,8,22,2,2007-02-17 18:08:21,2007-02-17 09:31:50
5ca2db53763ed93a75de7ddbda753fc09327d7aa...d7f078b8b92b1a29f9dd62c2c470fa51e15e2ffa,9,15,14,29,13,2007-02-17 18:20:27,2007-02-17 09:43:42
6698060c15e837babb3b80f980bbed290934a692...9cd625b79babaf50f50a0e5d96903eaacb1ee600,1,1,1,2,1,2006-06-18 18:29:36,2006-06-18 13:25:33
9cd625b79babaf50f50a0e5d96903eaacb1ee600...3e4339e6f96e8c4f38a9c6607b98d3e96a2ed783,5,149,74,223,10,2006-06-18 20:51:27,2006-06-18 18:45:02
3e4339e6f96e8c4f38a9c6607b98d3e96a2ed783...476a4dfc05f8d67406af277a00f7079b5d6d51e1,1,1,3,4,1,2006-06-18 20:58:20,2006-06-18 20:33:21
476a4dfc05f8d67406af277a00f7079b5d6d51e1...b47f509ba59df5bd9a780745ca710272c6dd175b,1,1,1,2,1,2006-06-19 03:12:20,2006-06-18 23:25:16
d6e8149bc53de57cab7cc0d9aff6c2341f3a7efa...8b19280930eba7d66549f64344a49b3641821046,1,14,2,16,2,2005-08-07 22:40:24,2005-08-07 20:58:56
8b19280930eba7d66549f64344a49b3641821046...fa4da7b32e1197fa5032db6a2de7749868253f8b,1,78,39,117,22,2005-08-07 23:47:22,2005-08-07 23:47:22
e7d3dd248f50501f98b29c917e70bddcf3ea925a...8c59926f5e00082a4cbf1d9f31275917c5f7f001,1,4,1,5,3,2005-05-07 14:09:44,2005-04-19 02:16:15
8c59926f5e00082a4cbf1d9f31275917c5f7f001...c899350e9dbe8700ad3c945b9743e9472732684b,1,4,4,8,3,2005-05-08 14:15:59,2005-05-08 14:15:59
c899350e9dbe8700ad3c945b9743e9472732684b...6ffcee883bfa6d343a3792a583775084d588afd3,1,1,1,2,1,2005-05-08 15:29:33,2005-05-08 09:34:40
6ffcee883bfa6d343a3792a583775084d588afd3...92747a907cba83938def6e7eb3ee1b4d3d9e609f,1,3,0,3,1,2005-05-09 21:33:02,2005-05-09 21:33:02
92747a907cba83938def6e7eb3ee1b4d3d9e609f...883550481f885ab2865ab71819167230d21d4c14,2,4,4,8,2,2005-05-10 22:58:16,2005-05-10 22:58:16
e7d3dd248f50501f98b29c917e70bddcf3ea925a...ace1534d6f3a710ed82e7e27ba1fe77c0c278695,3,93,20,113,14,2005-05-07 07:38:04,2005-05-07 07:38:04
ace1534d6f3a710ed82e7e27ba1fe77c0c278695...e4f5b8c69d5f29b2b95b1febe76ccd91d1dffb33,1,1,1,2,1,2005-05-07 07:48:00,2005-05-07 07:48:00
e4f5b8c69d5f29b2b95b1febe76ccd91d1dffb33...651df67bbc41e8d0cb84f35aa541542bd6806825,2,9,2,11,3,2005-05-07 08:11:00,2005-05-07 08:11:00
651df67bbc41e8d0cb84f35aa541542bd6806825...383f85b72a41279f69a3a569420615761491b8a2,1,1,0,1,1,2005-05-07 08:27:00,2005-05-07 08:27:00
383f85b72a41279f69a3a569420615761491b8a2...36997b45adeb8915978de5a927130873073683dd,1,1,0,1,1,2005-05-07 08:32:24,2005-04-14 06:26:38
36997b45adeb8915978de5a927130873073683dd...8eef4d3ed13d7604056b26ce58d0db007be530dd,1,31,4,35,4,2005-05-07 19:22:02,2005-05-07 19:22:02
8eef4d3ed13d7604056b26ce58d0db007be530dd...c7d1d4e1b50a60abfec5c5daaeb104bc9838b44c,1,4,4,8,2,2005-05-07 19:26:15,2005-05-07 19:26:15
c7d1d4e1b50a60abfec5c5daaeb104bc9838b44c...a1df57abb90d456b6b600b8cf6a5232a39cd3f5e,4,4,0,4,4,2005-05-07 19:32:21,2005-05-07 08:41:41
a1df57abb90d456b6b600b8cf6a5232a39cd3f5e...29c2cce41bc623e0a0d770a2634bf6c544345ea7,1,8,2,10,3,2005-05-07 19:37:49,2005-05-07 08:41:54
29c2cce41bc623e0a0d770a2634bf6c544345ea7...a4f35a2dc0f98f4cac906f9a748857f61bb3b84c,1,21,3,24,6,2005-05-07 21:43:32,2005-05-07 21:43:32
a4f35a2dc0f98f4cac906f9a748857f61bb3b84c...77a837314ef504ed3447087c0fed7222ebb9ae42,1,2,1,3,1,2005-05-08 04:44:17,2005-05-08 04:44:17
77a837314ef504ed3447087c0fed7222ebb9ae42...0f1e4f04013fec0ba8a51a93fc5d3ec6df706168,1,85,0,85,2,2005-05-08 04:48:12,2005-05-08 04:48:12
0f1e4f04013fec0ba8a51a93fc5d3ec6df706168...192268c197c0f143989662f648b1d900014e7d89,5,65,23,88,21,2005-05-08 04:55:21,2005-05-08 04:55:21
192268c197c0f143989662f648b1d900014e7d89...4c5abf428203524aac7ec094da692e5b89782127,1,12,3,15,2,2005-05-08 07:05:18,2005-05-08 07:05:18
4c5abf428203524aac7ec094da692e5b89782127...cf5af17e4561102899ec455d84b6293c9d299910,1,125,125,250,18,2005-05-08 19:49:48,2005-05-08 17:22:45
cf5af17e4561102899ec455d84b6293c9d299910...ddd5d0568d2b3f5f5ec22e13fedbfd041b49019c,1,24,4,28,5,2005-05-08 20:51:13,2005-05-08 20:51:13
ddd5d0568d2b3f5f5ec22e13fedbfd041b49019c...aa575f815e2350e46a1895a6905fd8ad548c946a,1,1,1,2,1,2005-05-08 21:02:19,2005-05-08 21:02:19
aa575f815e2350e46a1895a6905fd8ad548c946a...03ea2802495df568690760906e26dda753f75e1d,3,971,501,1472,289,2005-05-08 21:44:20,2005-05-08 17:22:48
03ea2802495df568690760906e26dda753f75e1d...b3f94c4b554cd6c3db3e99dc33bdac7d8155d606,1,3,1,4,2,2005-05-08 22:31:33,2005-05-08 22:31:33
b3f94c4b554cd6c3db3e99dc33bdac7d8155d606...d19938ab6053e3dad75a68a60ef8cad1f378b0e5,11,130,39,169,29,2005-05-10 00:57:56,2005-05-10 00:57:56
d19938ab6053e3dad75a68a60ef8cad1f378b0e5...8ac069ac0ab34e751e5f96b0244a5fec10f3e54f,7,81,35,116,23,2005-05-10 05:57:58,2005-05-10 05:57:58
8ac069ac0ab34e751e5f96b0244a5fec10f3e54f...b4635be7c9e0855a29609d8171fc9ff27db573ee,1,1,2,3,1,2005-05-10 06:48:21,2005-05-10 06:48:21
b4635be7c9e0855a29609d8171fc9ff27db573ee...3be4b61aa4ffb54a42c717772518b2a14b1e352b,1,1,1,2,1,2005-05-10 20:25:27,2005-05-10 20:25:27
3be4b61aa4ffb54a42c717772518b2a14b1e352b...2cf565c53c88c557eedd7e5629437b3c6fe74329,39,2262,1712,3974,40,2005-05-10 21:55:22,2005-05-10 21:32:30
2cf565c53c88c557eedd7e5629437b3c6fe74329...204ee6a91ba35740d6417cf64bde4d117d40b07d,1,48,36,84,10,2005-05-10 21:59:56,2005-05-10 21:32:37
204ee6a91ba35740d6417cf64bde4d117d40b07d...c1bdacf97e3f51ac5c239a16e300e0986a5da53d,8,128,20,148,11,2005-05-10 22:01:23,2005-05-10 21:32:38
c1bdacf97e3f51ac5c239a16e300e0986a5da53d...b790abb874890926e4cfda552bfa89d1d4ff972b,1,24,0,24,1,2005-05-10 22:03:34,2005-05-10 21:32:39
745ef0625b0eb93d1be68dd4160d0d85fbb4cc0f...f9d995d5dd39c942c06829e45f195eeaa99936e1,1,26,0,26,6,2012-04-24 21:50:06,2012-04-24 21:50:06
68fb4650497d6acbf6d407513cd2e2d960442e3b...2275d502114c71045af991697048191fed88aac4,3,58,10,68,12,2007-06-27 02:00:39,2007-06-25 14:03:55
2275d502114c71045af991697048191fed88aac4...91c8d5905c33e9d7c9014a1c6c7cec8eb86584df,4,8,7,15,5,2007-06-27 04:48:53,2007-06-24 19:20:41
91c8d5905c33e9d7c9014a1c6c7cec8eb86584df...384f122b7c6dd2b52cc6029afee16560c38850ae,1,2,0,2,1,2007-06-27 04:49:44,2007-06-24 19:13:11
9a54463a8ab04f19a7f6127df7287320cc731a91...444649e5a833c6ed24e0e92364923324d9ffb386,1,2,1,3,2,2007-07-02 08:14:00,2007-07-02 08:14:00
444649e5a833c6ed24e0e92364923324d9ffb386...ecda072380e54084d5160d7b6a9cdb23369da804,2,107,6,113,14,2007-07-02 08:33:44,2007-06-24 21:06:07
ecda072380e54084d5160d7b6a9cdb23369da804...bffe71f4cd44b8050e7561b9f9245febb8b21f0a,1,17,4,21,5,2007-07-02 08:33:44,2007-06-26 23:40:58
bffe71f4cd44b8050e7561b9f9245febb8b21f0a...59c93929c8b98b7be00496d61fae8979bab1841d,1,11,0,11,1,2007-07-02 08:33:44,2007-06-29 08:31:08
59c93929c8b98b7be00496d61fae8979bab1841d...7627943a1bb0cda6f37b66381a62facf9e200285,2,3,3,6,3,2007-07-02 08:33:44,2007-06-28 14:15:25
7627943a1bb0cda6f37b66381a62facf9e200285...a2f8028d3d661b314d5a784764f2f5f9e4c2dde0,1,15,0,15,1,2007-07-02 08:33:44,2007-07-01 21:51:58
a2f8028d3d661b314d5a784764f2f5f9e4c2dde0...967506bbbdc38e75263d6e6a90e3b8dbba6cec0f,4,9,9,18,7,2007-07-02 08:33:44,2007-07-02 05:24:59
967506bbbdc38e75263d6e6a90e3b8dbba6cec0f...792d2370f975f032a708cb35044193b5b5310840,2,5,5,10,3,2007-07-02 08:33:45,2007-07-02 05:28:20
ee36856d8c8c1f8d53650a70d8f61561fb65ba38...06f59e9f5daa06fc4bd51cf4c508b3edd3ed514a,6,55,1,56,6,2007-07-01 03:16:12,2007-06-29 17:40:46
a0c0447b8eda07529eec2ae8fbc6bf68e1ff2d67...94af7c31a52ba1a26bd663c794e33284acf41a49,1,4,0,4,1,2009-06-12 06:35:05,2009-06-11 07:30:27
fe5e7f332c8a95680a869eaca8033213676cbc7b...5483c71d7ac06b4f16c646886abbb2d0f88a2855,2,36,30,66,17,2007-06-28 04:00:36,2007-06-28 03:59:37
5483c71d7ac06b4f16c646886abbb2d0f88a2855...f57882505efe05990102a0d96b37c09baadae03d,2,17,1,18,2,2007-06-28 04:02:44,2007-06-27 14:28:53
ad0f8c9ea76dcce82eb3fa1b308e495c21b834d1...41f5d73391e3fe5c4cb2829582b26a85930964d1,1,1,1,2,1,2007-03-14 16:48:13,2007-03-14 16:48:13
41f5d73391e3fe5c4cb2829582b26a85930964d1...9debca9aac99bc25c99727767ee50c8e405e9591,1,1,1,2,1,2007-03-14 21:38:38,2007-03-14 21:08:41
9debca9aac99bc25c99727767ee50c8e405e9591...3d4e1932f24346d26f15e98dd6a74798035e7870,3,26,2,28,3,2007-03-14 22:56:49,2007-03-14 22:56:49
f0bc498ec17eeb046c3494126e2ff12339abde77...cc1f83fbdff1ae248c91ab231ab4100351e1ba0a,1,2,0,2,1,2007-05-09 01:38:46,2007-05-09 01:38:46
cc1f83fbdff1ae248c91ab231ab4100351e1ba0a...1f07c4e5cefec88d825045ade24eee71f6a2df47,2,157,1,158,2,2007-05-09 01:38:54,2007-05-08 23:54:05
1f07c4e5cefec88d825045ade24eee71f6a2df47...c74b6c66f00ce51b2c01d20fc5ef0e6429811124,6,139,185,324,61,2007-05-09 01:38:54,2007-05-09 00:33:47
c74b6c66f00ce51b2c01d20fc5ef0e6429811124...28bf928cf81eec720bc8a31179a0c9cf688d5af3,1,2,1,3,1,2007-05-09 01:38:54,2007-05-09 01:31:31
28bf928cf81eec720bc8a31179a0c9cf688d5af3...685caf9af672811b45ebeaaa299b8f9fbd743d82,3,123,133,256,52,2007-05-09 01:38:55,2007-05-09 01:33:14
685caf9af672811b45ebeaaa299b8f9fbd743d82...c6127856eb318157121b0aeab150c074e9eeb3de,1,9,3,12,2,2007-05-09 01:58:25,2007-05-09 01:58:25
c6127856eb318157121b0aeab150c074e9eeb3de...3e45ee1ef268c73539903f89c737af89034d391f,1,47,9,56,5,2007-05-09 02:36:01,2007-05-09 02:36:01
3e45ee1ef268c73539903f89c737af89034d391f...a0db0d61fbc447f13cb0aadf01c83eb193b22dc9,2,25,11,36,8,2007-05-09 02:48:47,2007-05-09 02:48:47
a0db0d61fbc447f13cb0aadf01c83eb193b22dc9...0511798f06d3456885682605b54bd3bc378e8fda,1,18,17,35,9,2007-05-09 04:36:25,2007-05-09 04:36:25
0511798f06d3456885682605b54bd3bc378e8fda...76486bbefbaeb606f662dadde0ca5dac59a4ec31,1,10,4,14,3,2007-05-09 04:48:27,2007-05-09 04:48:27
76486bbefbaeb606f662dadde0ca5dac59a4ec31...6b3d8b97cb48bcc6e2ac020312a56e1d9a2828b2,1,1,1,2,1,2007-05-10 21:53:34,2007-05-09 22:35:04
6b3d8b97cb48bcc6e2ac020312a56e1d9a2828b2...d6da71a9d16b8cf27f9d8f90692d3625c849cbc8,1,1,1,2,1,2007-05-10 21:54:45,2007-05-10 21:54:45
53a58245863eff3d70aaa3ac75d7d57e843fc91d...52c80037e423c7e7806cf2f198ed978dc36fa654,1,6,7,13,3,2007-05-08 04:25:09,2007-05-08 03:34:26
52c80037e423c7e7806cf2f198ed978dc36fa654...b51be13c9c83621551824876ee037151a92f0323,1,2,2,4,2,2007-05-08 05:02:40,2007-05-08 04:46:08
b51be13c9c83621551824876ee037151a92f0323...22f09585d402f79f8248b30253c3338f69114ba3,1,4,1,5,2,2007-05-09 05:09:04,2007-05-08 14:19:41
22f09585d402f79f8248b30253c3338f69114ba3...1cc202bd4ebd0390d738f0d633d42791cb79dd05,3,32,2,34,3,2007-05-09 05:11:17,2007-05-09 05:10:56
53a58245863eff3d70aaa3ac75d7d57e843fc91d...d966e6aa66d397908b4fbf69cef2e2da88737321,1,1,1,2,1,2007-05-08 01:13:40,2007-05-08 01:13:40
3f28f63f5a87c566ac471e04791daf3da20c67da...2f1a955b99954fd18c512244e1321dc4cff856b4,1,4,3,7,4,2007-05-02 17:06:09,2007-04-29 00:49:22
2f1a955b99954fd18c512244e1321dc4cff856b4...1afd1ec1077a6d43b9492e19ea88f5928204d4cc,1,13,0,13,1,2007-05-02 17:06:09,2007-04-29 01:26:27
1afd1ec1077a6d43b9492e19ea88f5928204d4cc...d45b52b540b13a6dae816b65f0f5431b56583570,1,2,5,7,2,2007-05-02 17:06:10,2007-04-29 01:32:27
d45b52b540b13a6dae816b65f0f5431b56583570...2739291b77fefe7cfae16481756716f11a01e654,1,21,38,59,16,2007-05-02 17:06:10,2007-04-29 02:00:02
2739291b77fefe7cfae16481756716f11a01e654...7416bbc65cbcc3db9cafe50b92c14193ac295dbe,1,114,256,370,148,2007-05-02 17:06:10,2007-04-29 03:14:08
7416bbc65cbcc3db9cafe50b92c14193ac295dbe...dc6716b83d3f90f8b1b2c611fe4f9f7c9fb14f5e,1,12,11,23,4,2007-05-02 17:06:11,2007-04-29 05:54:57
dc6716b83d3f90f8b1b2c611fe4f9f7c9fb14f5e...c6a5e4030320c934bca70471d04aa9e7d8e2cd67,2,16,2,18,4,2007-05-02 17:06:11,2007-04-29 07:02:10
c6a5e4030320c934bca70471d04aa9e7d8e2cd67...f522c9b5ed367172f969397589ae3d686b867ac0,17,3991,3947,7938,75,2007-05-08 03:35:48,2007-05-08 03:35:48
f522c9b5ed367172f969397589ae3d686b867ac0...a35d65d9c8a2a6a10d369c00e22aded6fbdff2a9,4,57,39,96,28,2007-05-08 03:35:50,2007-05-01 06:59:53
a35d65d9c8a2a6a10d369c00e22aded6fbdff2a9...60aa065f6958a888d14178ca94f17a60100d3709,2,23,0,23,2,2007-05-08 03:35:51,2007-05-01 19:51:09
60aa065f6958a888d14178ca94f17a60100d3709...a6c9b081b6860816615e84b75bbc7916aab184e9,2,21,16,37,17,2007-05-08 03:35:51,2007-05-02 17:56:27
a6c9b081b6860816615e84b75bbc7916aab184e9...349f92e3a25216b6f79c58044d74b61c89de20b8,1,13,7,20,3,2007-05-08 03:35:52,2007-05-02 18:25:22
349f92e3a25216b6f79c58044d74b61c89de20b8...1fc4ba86f80c1365943abac54679dd1924a6737b,1,54,45,99,12,2007-05-08 03:35:52,2007-05-03 22:21:39
1fc4ba86f80c1365943abac54679dd1924a6737b...ebcaadabcb90eaf35a3bd69a50cccce4be4dcc2c,1,14,6,20,6,2007-05-08 03:35:53,2007-05-05 06:28:41
ab6029415b7e8acbc1beff7363c74bb94c3f0d9d...1401f46bb42d1eb6225a5e08543c06a5b18fd3b7,2,2,2,4,2,2007-04-18 05:00:18,2007-04-18 03:34:34
60fa08ed617dd148a9843bfdef2dfecf2ef60123...be242d576c4457bec1cb748b144eb287e98ac0b5,1,6,1,7,1,2007-03-12 06:49:20,2007-03-11 16:28:56
be242d576c4457bec1cb748b144eb287e98ac0b5...fc095242b16d57bad1bfe089f919b9d6e6deda1b,1,13,0,13,1,2007-03-12 06:52:03,2007-03-11 17:19:43
dc49cd769b5fa6b7e0114b051c34a849828a7603...46be82dfd0850d7e96b1401a81a396e0cd0e0527,1,2,0,2,1,2010-07-28 21:08:44,2010-07-28 16:36:31
a1367d1219439fef8e82e546cbe742910231e5b3...2ba91e96981fb92f42b01dfae8a315b2965077d5,1,1,5,6,1,2007-03-01 21:24:54,2007-03-01 19:41:14
2ba91e96981fb92f42b01dfae8a315b2965077d5...d53ebb429a858bb7ec1f22e80ac3da26d24d414a,1,4,4,8,1,2007-03-01 21:25:14,2007-03-01 19:41:15
d53ebb429a858bb7ec1f22e80ac3da26d24d414a...5ef1f8d4889ccf6aaea62c5d465c8ad30a41dfc2,1,6,6,12,3,2007-03-01 21:25:24,2007-03-01 19:41:16
5ef1f8d4889ccf6aaea62c5d465c8ad30a41dfc2...3e4e8c03ca948e96b7f6a1730fb67034a6f942e3,1,1,1,2,1,2007-03-01 21:26:18,2007-03-01 17:08:17
3e4e8c03ca948e96b7f6a1730fb67034a6f942e3...0df56eabf2cde83cb63c4acd7da2346c34220ac0,1,1,1,2,1,2007-03-01 21:26:57,2007-02-27 23:55:48
0df56eabf2cde83cb63c4acd7da2346c34220ac0...eecc8367f4eaafc8449fc08c4e33f3f8ac474469,1,7,3,10,3,2007-03-02 08:10:12,2007-03-01 16:09:12
0ab179504a17907c395a4009f7c23d2f71bba1d3...fef742c4ed2be2b3b72f510314b7b2f3a7a7d0a7,1,2,1,3,2,2007-02-28 05:37:46,2007-02-28 01:38:31
fef742c4ed2be2b3b72f510314b7b2f3a7a7d0a7...66035a6b3d629b546daef3784f5351d58f4f17b1,1,5,5,10,5,2007-02-28 05:40:18,2007-02-27 15:00:33
ae792aa52bb0962079f500bd491363f2b48457b6...102a0a2db14cd7604a8a2b6590ecbd6bf3136394,1,2,2,4,2,2007-03-04 08:34:01,2007-03-04 08:15:29
ae792aa52bb0962079f500bd491363f2b48457b6...5332b2af104180b8135e0b3528ace7596cb9ba09,2,31,5,36,7,2007-03-04 07:45:47,2007-02-25 22:36:10
5332b2af104180b8135e0b3528ace7596cb9ba09...3afaa72d7d4e52d5fa1bc19abb68301f2b09aca6,2,40,21,61,5,2007-03-04 08:17:27,2007-03-04 08:17:27
3afaa72d7d4e52d5fa1bc19abb68301f2b09aca6...0c725f1bd938fa2b626e910773e622a385daced2,1,17,17,34,3,2007-03-04 08:20:31,2007-02-25 22:36:31
0c725f1bd938fa2b626e910773e622a385daced2...5bd74506cd30e897d1493639b7438c6cc80dea8e,29,110,110,220,109,2007-03-04 08:24:15,2007-02-25 22:36:53
34572ed2c809c2e0b00dc660bdb2dd201c5ff85f...e7411303861f02a28b76a4c43451c427a3439a5c,1,50,0,50,1,2007-03-12 19:02:13,2007-03-12 18:58:50
34572ed2c809c2e0b00dc660bdb2dd201c5ff85f...1358e7d670306a9fe8a612f1ebd1f058474d20af,1,5,5,10,6,2007-03-12 18:30:38,2007-03-12 18:30:38
1358e7d670306a9fe8a612f1ebd1f058474d20af...9dc09c766463333ca51311a2db86fd67f4fec19b,1,9,6,15,3,2007-03-12 23:31:35,2007-03-12 18:37:28
9dc09c766463333ca51311a2db86fd67f4fec19b...6016e35bc18e801a7bd855b1581da6c7fd755470,1,7,1,8,1,2007-03-13 00:37:30,2007-03-12 22:59:16
1589e0517fd22c198799504d6888d5a475024152...6757ada403bf0eb0fb1fddcffbbeb74d91cbbb51,5,82,1,83,5,2007-03-17 07:34:19,2007-03-14 01:58:22
3a81b9f571a6b7edd83b3d5f27c3c95d9b1c9d5c...3301521a2584128c23cae14bebbe260326dbcedf,2,2,2,4,2,2007-03-26 01:00:23,2007-03-26 00:39:36
3301521a2584128c23cae14bebbe260326dbcedf...0b59451c1be6be3d0df80be9dc8aeedb355ca44b,1,4,2,6,1,2007-03-26 01:01:28,2007-03-25 23:35:31
0b59451c1be6be3d0df80be9dc8aeedb355ca44b...b6da18b1d103617a5944d470a1f17e398f8141e4,2,41,14,55,8,2007-03-26 01:01:50,2007-03-26 01:00:45
b6da18b1d103617a5944d470a1f17e398f8141e4...52c813f22fef784c0c66fb3cb18217489cbacf3a,1,43,2,45,3,2007-03-26 05:22:33,2007-03-26 01:34:41
52c813f22fef784c0c66fb3cb18217489cbacf3a...c0ce981f5ebfd02463ff697b2fca52c7a54b0625,1,1,1,2,1,2007-03-26 06:14:06,2007-03-26 04:14:40
d54fe394acbad36e9d0fd960d5e10f2769a8041b...7976ce1b909f8d61aa40108f8443e9fe585d15ac,1,3,1,4,1,2007-03-18 22:58:07,2007-03-18 22:58:07
7976ce1b909f8d61aa40108f8443e9fe585d15ac...9cec65399d3575774910b21c1cfd762a5e88a245,3,7,5,12,6,2007-03-19 02:13:48,2007-03-19 02:11:54
9cec65399d3575774910b21c1cfd762a5e88a245...d6678c28e30e836449092a2917d4b0bd6254b06c,1,9,4,13,1,2007-03-19 02:30:10,2007-03-19 02:30:10
d6678c28e30e836449092a2917d4b0bd6254b06c...abec100c3382f7d7b759f915a86e9773277263b6,2,6,5,11,3,2007-03-19 04:10:03,2007-03-19 01:37:53
94b9816c5ce5bfc8bf4a8baf2128fa2d429a6898...d55552f6e3b63ab6f33dd61071760bee42b9bc5e,1,57,24,81,5,2007-03-19 08:40:27,2007-03-17 19:40:12
d55552f6e3b63ab6f33dd61071760bee42b9bc5e...c711a214c1e9a4dfb5043bc1a11d0f76313b097e,1,1,3,4,2,2007-03-19 08:48:56,2007-03-18 20:38:19
c711a214c1e9a4dfb5043bc1a11d0f76313b097e...5d86501742663978dfa4dd8accaee4bb93639fee,1,34,10,44,6,2007-03-19 09:01:39,2007-03-18 22:18:30
5d86501742663978dfa4dd8accaee4bb93639fee...843d49a47906bfc7b89553da0c5e4f06ed4c348b,1,2,1,3,2,2007-03-19 09:48:37,2007-03-19 09:48:37
843d49a47906bfc7b89553da0c5e4f06ed4c348b...ceb8442af7367611c3f5db124a5dc1dbb7fb438f,2,50,2,52,7,2007-03-19 09:56:29,2007-03-19 09:28:29
ceb8442af7367611c3f5db124a5dc1dbb7fb438f...3358004a006714477c2c44577507081cb5124fa4,1,3,3,6,3,2007-03-20 01:15:59,2007-03-19 20:28:51
3358004a006714477c2c44577507081cb5124fa4...5e08ecbff219dc68a13eb372b39030134e737c8a,1,31,8,39,10,2007-03-20 01:16:02,2007-03-19 20:31:04
5e08ecbff219dc68a13eb372b39030134e737c8a...567fb65e251d946cee2b73a9b188231652fe663c,3,3,3,6,3,2007-03-20 01:16:03,2007-03-19 21:42:40
567fb65e251d946cee2b73a9b188231652fe663c...57584d9eddc3482c5db0308203b9df50dc62109c,1,2,3,5,1,2007-03-20 05:17:10,2007-03-20 05:17:10
57584d9eddc3482c5db0308203b9df50dc62109c...824f782c3f8f2db8e884b0c555d21ed4cfd6fff2,1,20,2,22,3,2007-03-20 05:17:25,2007-03-20 03:05:10
824f782c3f8f2db8e884b0c555d21ed4cfd6fff2...e29b96d5aa942325ddba0488c819ef5dd8fd7c48,1,52,0,52,1,2007-03-20 05:17:38,2007-03-20 02:29:56
e29b96d5aa942325ddba0488c819ef5dd8fd7c48...1b89ef1731d21c607b06cc48be375b7de882acf7,1,49,0,49,1,2007-03-20 05:19:29,2007-03-20 02:41:11
1b89ef1731d21c607b06cc48be375b7de882acf7...3e993bb657daad31d8a7b1ef0a6a9f73bdd5f950,2,607,0,607,2,2007-03-20 05:21:19,2007-03-20 04:33:41
3e993bb657daad31d8a7b1ef0a6a9f73bdd5f950...456cdf6edbf0c14b75fd9048708e9abea43e6aa1,1,15,2,17,2,2007-03-20 06:13:17,2007-03-20 05:49:53
456cdf6edbf0c14b75fd9048708e9abea43e6aa1...7e8c8255e9bf33dd046b95c4bd1ef554ad3c71b2,1,2,1,3,2,2007-03-20 06:46:30,2007-03-20 02:18:18
460ca302fdf453459850676c049ed7b46b43a0d4...21b4875a51dd9aae68a1c4932d54cad9fc589401,1,19,2,21,5,2007-02-18 00:15:22,2007-02-17 23:47:46
53756f290b94a0f8ee7021713fa63540d1a7e4e8...2afc29aa84f518906c50a1f005e3d715babb5c20,2,22,7,29,9,2007-02-17 19:26:49,2007-02-17 18:22:35
64e86c57867593ba0ee77a7b0ff0eb8e9d4d8ed5...855419f764a65e92f1d5dd1b3d50ee987db1d9de,7,67,5,72,7,2006-06-20 01:42:21,2006-06-19 17:44:15
855419f764a65e92f1d5dd1b3d50ee987db1d9de...0e26f7a1c3275214312bd7171fc850addb71f68d,1,1,1,2,1,2006-06-20 01:43:20,2006-06-19 19:40:37
0e26f7a1c3275214312bd7171fc850addb71f68d...0da4677149b433e5424537c6acf45bd4d2f7a6df,1,17,4,21,3,2006-06-20 01:43:30,2006-06-19 22:00:17
0da4677149b433e5424537c6acf45bd4d2f7a6df...d281786fcd6d0df47dd46e415f1a804b2e81ed9b,2,5,7,12,6,2006-06-20 01:43:49,2006-06-20 00:01:35
64e86c57867593ba0ee77a7b0ff0eb8e9d4d8ed5...8ed05fb5e90f8ad2051ff7071b7425a53c594892,4,50,30,80,17,2006-06-19 04:58:19,2006-06-13 20:21:42
8ed05fb5e90f8ad2051ff7071b7425a53c594892...e690e84315de1bb806eb2292f8a87cbee30b75ab,4,48,33,81,11,2006-06-19 04:58:20,2006-06-13 20:21:46
e690e84315de1bb806eb2292f8a87cbee30b75ab...34488e3c375d159506d5d98e012f3b36e7cd9fe7,4,61,46,107,23,2006-06-19 05:10:28,2006-06-13 20:21:50
34488e3c375d159506d5d98e012f3b36e7cd9fe7...7499c996156ea99702fe13e203b97ae60d8868ad,4,19,9,28,11,2006-06-19 05:12:16,2006-06-13 20:21:53
7499c996156ea99702fe13e203b97ae60d8868ad...fefe81c9964a12394d6ea81ce474ff402f0eb070,4,18,11,29,14,2006-06-19 05:12:19,2006-06-13 20:21:57
fefe81c9964a12394d6ea81ce474ff402f0eb070...854b4629f97fb216a91805706cd61b33beb49172,4,11,5,16,8,2006-06-19 05:12:20,2006-06-13 20:22:00
64e86c57867593ba0ee77a7b0ff0eb8e9d4d8ed5...aedd9425ce211d132f8671bc3d94623ab9595f02,2,58,60,118,4,2006-06-19 04:19:13,2006-06-17 09:23:56
aedd9425ce211d132f8671bc3d94623ab9595f02...f5aa79d909f8c4838bf500c22fa5f7967d219925,1,39,4,43,8,2006-06-19 04:19:14,2006-06-17 11:32:15
f5aa79d909f8c4838bf500c22fa5f7967d219925...ad14e9317513f132293406e570f0b9360704371e,1,3,3,6,3,2006-06-19 04:19:14,2006-06-17 16:07:24
ad14e9317513f132293406e570f0b9360704371e...2d00737489b8c61ed616b261c7c9bd314e2b0b41,1,44,0,44,3,2006-06-19 04:19:14,2006-06-17 22:01:06
2d00737489b8c61ed616b261c7c9bd314e2b0b41...c729127ca745d25df1e6bddb265d03166931f49a,1,4,0,4,1,2006-06-19 04:19:14,2006-06-18 06:45:03
64e86c57867593ba0ee77a7b0ff0eb8e9d4d8ed5...cfd432e63d77478d913497a62827ed95c56dda73,3,22,13,35,5,2006-06-19 04:19:09,2006-06-18 15:18:03
cfd432e63d77478d913497a62827ed95c56dda73...63f175693e46c8e1562e68a40086ec864f43886b,1,2,1,3,2,2006-06-19 04:19:09,2006-06-18 15:18:04
63f175693e46c8e1562e68a40086ec864f43886b...b4b1550315c6184ea50936be305a4f1c78ad16a8,1,22,19,41,9,2006-06-19 04:19:09,2006-06-18 15:18:05
b4b1550315c6184ea50936be305a4f1c78ad16a8...04f086071e780d921f6dac83b5ffc21c3a2d7bb6,1,2,2,4,2,2006-06-19 04:19:10,2006-06-18 15:18:06
04f086071e780d921f6dac83b5ffc21c3a2d7bb6...571ea603a6464cab86dad2d470034e0f3b6e67df,1,1,2,3,1,2006-06-19 04:19:10,2006-06-18 15:18:07
571ea603a6464cab86dad2d470034e0f3b6e67df...2bda77e080dd8d47ca0b87c78e9061fbaa37455a,1,1,1,2,1,2006-06-19 04:19:10,2006-06-18 15:18:08
64e86c57867593ba0ee77a7b0ff0eb8e9d4d8ed5...7f29f7a95c906250c9c99d08242c2c4084c48d24,2,23,1,24,2,2006-06-19 04:19:07,2006-06-17 23:23:58
bf9e9542f94bc39e8bc653065d477bd25e79010e...50f575fc9836704d45a5f732125b8f58103425a4,1,58,41,99,18,2006-06-22 22:08:36,2006-06-22 20:53:31
50f575fc9836704d45a5f732125b8f58103425a4...f60349aa786d519368938d7b6e5bb2006eccb0cf,1,1,0,1,1,2006-06-22 23:18:32,2006-06-22 21:06:39
fa4da7b32e1197fa5032db6a2de7749868253f8b...b1ba39e7e80cdee3e7c1c80334cd9aa87b9b7b69,1,19,10,29,5,2005-08-09 11:09:27,2005-08-09 03:04:20
d59a6043a8a7aed97c684fb4f14fe5221df1fcaf...3c4e8a636f4de3668b24d0020df731cdc78ae6e9,1,1,0,1,1,2005-08-09 00:52:51,2005-08-08 22:58:54
16cc55ce1fba4885ab8fa7a11a520c0db14ef315...24db845c40b09c55eb810c01e7fda2f4505d35ba,1,15,8,23,6,2005-08-08 06:15:49,2005-08-08 03:18:19
24db845c40b09c55eb810c01e7fda2f4505d35ba...b1d096f2926c4e37c9c0b6a7bf2119bedaa277cb,1,1,1,2,1,2005-08-08 06:21:38,2005-08-08 06:21:38
b1d096f2926c4e37c9c0b6a7bf2119bedaa277cb...80f45687f44b6258b0eacae6b1ae15e3ad4a6552,1,1,1,2,1,2005-08-08 22:03:39,2005-08-08 22:03:39
f1a7eb36b017c62d9a007b6b8660bdeec3f94f97...90c4851b1787dfc1d3d3a5cf78c558d136c69bdd,1,9,9,18,9,2005-05-11 00:06:44,2005-04-15 03:35:00
90c4851b1787dfc1d3d3a5cf78c558d136c69bdd...bebc5c61439a291e8f0f99e037ebdf63d3dfac46,1,2,2,4,2,2005-05-11 00:08:53,2005-04-25 21:28:33
bebc5c61439a291e8f0f99e037ebdf63d3dfac46...f7ec43ae2257241ef76a69d9d3df031a181f6ebb,1,2,2,4,2,2005-05-11 00:15:14,2005-05-11 00:15:14
f7ec43ae2257241ef76a69d9d3df031a181f6ebb...2a45925180152b3e54248de4d7f69e8cc5c4051f,1,15,5,20,4,2005-05-11 02:44:59,2005-05-11 02:44:59
2a45925180152b3e54248de4d7f69e8cc5c4051f...7ffeb8c24bb3eb83bf39e9d0348899f7f8178b2a,1,8,1,9,3,2005-05-11 02:49:36,2005-05-11 02:49:36
7ffeb8c24bb3eb83bf39e9d0348899f7f8178b2a...d81ed1b591b1db413c91e29b66de6a14dc543ffc,1,2,2,4,1,2005-05-11 03:54:57,2005-05-11 03:54:57
d81ed1b591b1db413c91e29b66de6a14dc543ffc...071c41a047e4c851836669648716e361f8e0b5ad,1,1,1,2,1,2005-05-11 20:37:58,2005-04-26 19:04:55
071c41a047e4c851836669648716e361f8e0b5ad...cb1da3a794fb384cab6a515afc008991e180831e,1,1,1,2,1,2005-05-11 20:43:24,2005-04-14 11:18:19
cb1da3a794fb384cab6a515afc008991e180831e...62d046a07b4cd4328d3d40aab097a1d97c4d7b20,1,3,0,3,1,2005-05-11 20:45:42,2005-04-17 21:34:51
62d046a07b4cd4328d3d40aab097a1d97c4d7b20...1c9da46da4fe5cf99c5f6ab251419d0f412ecfba,1,5,2,7,3,2005-05-11 20:47:46,2005-04-26 22:00:01
1c9da46da4fe5cf99c5f6ab251419d0f412ecfba...06cd3b94b27c285fc9877e7c6d9e1f35fbc0a7a4,1,3,3,6,3,2005-05-11 21:01:20,2005-05-11 21:01:20
06cd3b94b27c285fc9877e7c6d9e1f35fbc0a7a4...aceedfe32e766b169d480c0ec24777d1b09bb118,1,2,0,2,1,2005-05-11 21:05:47,2005-04-14 10:35:27
aceedfe32e766b169d480c0ec24777d1b09bb118...c599caca3ab7d5d66d7cadbbf589c2e4b5587d3e,1,1,0,1,1,2005-05-11 21:08:20,2005-04-14 10:43:44
c599caca3ab7d5d66d7cadbbf589c2e4b5587d3e...14242464811bff9e8d1af8eb33367a01480a18d0,1,4,1,5,2,2005-05-11 21:16:23,2005-05-11 21:16:23
14242464811bff9e8d1af8eb33367a01480a18d0...1126b419d6835f6b8c45ccfffc0ada9b09e32d87,1,46,3,49,5,2005-05-12 19:36:27,2005-05-12 00:02:45
1126b419d6835f6b8c45ccfffc0ada9b09e32d87...a15c1c60db9abb981754b1ba3b899f49949ae8b7,2,6,3,9,4,2005-05-13 05:30:23,2005-05-13 00:16:04
a15c1c60db9abb981754b1ba3b899f49949ae8b7...6ca45943121a92cad5c6ebef71764fb441bff356,2,91,18,109,17,2005-05-13 05:34:59,2005-05-13 00:17:54
6ca45943121a92cad5c6ebef71764fb441bff356...f77b100ada80e9d149bf763ae64d563352ebb577,1,3,2,5,1,2005-05-13 22:01:41,2005-05-12 21:31:05
f77b100ada80e9d149bf763ae64d563352ebb577...95649d6cf9ec68f05d1dc57ec1b989b8d263a7ae,1,2,1,3,1,2005-05-13 22:27:49,2005-05-12 23:51:08
95649d6cf9ec68f05d1dc57ec1b989b8d263a7ae...e1970ce43abfbf625bce68516857e910748e5965,3,336,0,336,3,2005-05-14 14:45:05,2005-05-14 05:50:32
e1970ce43abfbf625bce68516857e910748e5965...368f99d57e8ed17243f2e164431449d48bfca2fb,6,375,0,375,6,2005-05-14 15:41:01,2005-05-14 05:52:42
368f99d57e8ed17243f2e164431449d48bfca2fb...ceede59ea90cebad52ba9c8263fef3fb6ef17593,2,0,0,0,0,2005-05-14 15:42:02,2005-05-14 15:42:02
ceede59ea90cebad52ba9c8263fef3fb6ef17593...dfe070511c652f2b8e1bf6540f238c9ca9ba41d3,1,3,0,3,1,2005-05-14 15:45:33,2005-05-14 15:45:33
dfe070511c652f2b8e1bf6540f238c9ca9ba41d3...902d960b382a0cd424618ff4e1316da40e4be2f6,1,3,4,7,4,2005-05-14 15:57:32,2005-05-14 15:57:32
902d960b382a0cd424618ff4e1316da40e4be2f6...d6928ebd5098452b5bce0f1a5bd3afab5c4f9225,1,3,2,5,2,2005-05-14 15:58:22,2005-05-14 15:58:22
d6928ebd5098452b5bce0f1a5bd3afab5c4f9225...94e8afa28558786d1413645fd8aaadf157fb6eb4,1,2,2,4,2,2005-05-14 16:01:30,2005-05-14 16:01:30
94e8afa28558786d1413645fd8aaadf157fb6eb4...886856aba21b5e6ee41e9e91c9e6fcebc7a5ad1c,3,26,24,50,11,2005-05-14 16:06:21,2005-05-14 07:24:27
886856aba21b5e6ee41e9e91c9e6fcebc7a5ad1c...986aa7f17e363128856e51efb34c878e0563c509,1,174,0,174,1,2005-05-14 16:14:45,2005-05-14 07:25:06
986aa7f17e363128856e51efb34c878e0563c509...f50c9f76ca516051e9f7e7ef68d6a4d0f5830dda,6,26,1,27,3,2005-05-14 23:34:22,2005-05-14 23:34:22
f50c9f76ca516051e9f7e7ef68d6a4d0f5830dda...947adb2739845df3421c0f9647a68acad70c2614,1,134,0,134,1,2005-05-14 23:40:05,2005-05-14 08:45:42
947adb2739845df3421c0f9647a68acad70c2614...1bb4624417dc7a9a73454fae471e6d2b195ae84d,1,0,0,0,0,2005-05-14 23:42:31,2005-05-14 23:42:31
1bb4624417dc7a9a73454fae471e6d2b195ae84d...2ecd90502f4615c4f1a9340dfaed3f78ecd23747,1,313,0,313,1,2005-05-14 23:44:30,2005-05-14 08:46:46
2ecd90502f4615c4f1a9340dfaed3f78ecd23747...273b98343c5d743d89ee4d8a1556ca74dfddb786,1,12,10,22,3,2005-05-14 23:49:30,2005-05-14 01:40:14
273b98343c5d743d89ee4d8a1556ca74dfddb786...13ab4462d2aefb252d7c916bd537151856b7c967,1,50,0,50,1,2005-05-15 00:00:29,2005-05-14 05:52:42
13ab4462d2aefb252d7c916bd537151856b7c967...99665af5c0be0fe4319b39183e84917993153576,6,5,5,10,5,2005-05-15 00:05:03,2005-05-14 01:40:54
99665af5c0be0fe4319b39183e84917993153576...902b92e00e491a60d55c4b2bce122903b8347f34,2,11,11,22,8,2005-05-15 00:06:05,2005-05-14 01:41:36
902b92e00e491a60d55c4b2bce122903b8347f34...127cfd0d2f1db6ef690e01aafd1c660ea1c82499,1,10,2,12,3,2005-05-15 09:58:12,2005-05-15 02:04:25
127cfd0d2f1db6ef690e01aafd1c660ea1c82499...5d728c8411a092f80171f787b5409d98978690c7,8,8,8,16,8,2005-05-15 10:26:25,2005-05-15 02:04:25
5d728c8411a092f80171f787b5409d98978690c7...dbbce55b3a1129fcc6c5141dd5b8053512286b83,3,11,11,22,11,2005-05-15 10:37:39,2005-05-15 02:04:25
dbbce55b3a1129fcc6c5141dd5b8053512286b83...7ab6f3d437b9dbe5c139162777ee46d224371ee7,1,0,4,4,1,2005-05-15 10:38:55,2005-05-15 10:38:55
7ab6f3d437b9dbe5c139162777ee46d224371ee7...14cd1ff396b3414c3c13e67c74e1ad805cd455ef,2,4,3,7,4,2005-05-15 22:22:10,2005-05-15 21:21:13
14cd1ff396b3414c3c13e67c74e1ad805cd455ef...02481aec2a2cfce7bc47d0d10876be5507f0b7ba,2,3,1,4,2,2005-05-17 18:47:13,2005-05-17 18:47:13
02481aec2a2cfce7bc47d0d10876be5507f0b7ba...bf0f910d1dd5e5b291ea818f3037e8f8fe8caffc,10,23,23,46,22,2005-05-18 15:44:23,2005-05-18 12:14:09
bf0f910d1dd5e5b291ea818f3037e8f8fe8caffc...b58f23b38a9a9f28d751311353819d3cdf6a86da,2,12,9,21,7,2005-05-18 16:39:40,2005-05-18 16:10:47
b58f23b38a9a9f28d751311353819d3cdf6a86da...1024932f019905ff1a9e06e5acbee441919d4d05,2,74,22,96,4,2005-05-18 17:16:14,2005-05-18 17:16:14
1024932f019905ff1a9e06e5acbee441919d4d05...e7bd907db6a707481066f2c8d58e208110824358,1,4,4,8,2,2005-05-18 17:19:59,2005-05-18 17:19:59
e7bd907db6a707481066f2c8d58e208110824358...915838c3cbf5695e754b2826ee5e8fd46b23b0b7,4,170,19,189,25,2005-05-18 18:16:24,2005-05-18 06:29:49
915838c3cbf5695e754b2826ee5e8fd46b23b0b7...ad87de7c9d191df4fbd5cbcb2f767520201688ae,1,0,2,2,1,2005-05-18 18:33:06,2005-05-18 18:33:06
ad87de7c9d191df4fbd5cbcb2f767520201688ae...e11b29c50c985f86f730893c71b0f8bd6f26c33a,1,5,4,9,2,2005-05-18 18:33:46,2005-05-18 18:33:46
e11b29c50c985f86f730893c71b0f8bd6f26c33a...b11645be0139f907488b17ca4267e593ee58dd30,1,27,21,48,8,2005-05-18 20:06:47,2005-05-18 20:06:47
b11645be0139f907488b17ca4267e593ee58dd30...0a8365a179685feecee427075a9c2db8a66c434a,1,27,11,38,8,2005-05-18 20:10:17,2005-05-18 20:10:17
0a8365a179685feecee427075a9c2db8a66c434a...73848892adeaa421825672bce929b9cc16043fa9,1,7,1,8,2,2005-05-18 20:43:58,2005-05-18 20:43:58
73848892adeaa421825672bce929b9cc16043fa9...cb6c8ed2fea4515ee876c40a2bbd5541e24fc12b,1,5,0,5,1,2005-05-18 20:50:24,2005-05-18 20:50:24
cb6c8ed2fea4515ee876c40a2bbd5541e24fc12b...ed1a368ba137898bf012dbb8cda0a4cac89d64da,1,11,9,20,2,2005-05-18 21:07:42,2005-05-18 21:07:42
ed1a368ba137898bf012dbb8cda0a4cac89d64da...850e82d889f374465dc7aa6cb4af3098c7e02f1f,1,2,0,2,1,2005-05-18 21:17:22,2005-05-18 21:17:22
850e82d889f374465dc7aa6cb4af3098c7e02f1f...fbab835c03f1c73e4de920d00cd26519506d33fe,1,2,2,4,2,2005-05-18 21:23:04,2005-05-18 21:11:07
fbab835c03f1c73e4de920d00cd26519506d33fe...961784ee422c22075e131292b2235782e378c612,2,24,6,30,4,2005-05-18 23:14:22,2005-05-18 23:14:22
961784ee422c22075e131292b2235782e378c612...9b632be30c72f25ac180fa2bf7286505c87e46d2,1,2,2,4,1,2005-05-18 23:16:51,2005-05-18 23:16:51
9b632be30c72f25ac180fa2bf7286505c87e46d2...9dc527adbc013b67cd85cce67bdccc3c10ed4792,1,2,0,2,1,2005-05-19 14:31:23,2005-05-19 06:34:03
9dc527adbc013b67cd85cce67bdccc3c10ed4792...21949255d1a9c04ed8cba9c54ddac13889b2ea26,1,9,0,9,1,2005-05-19 14:42:07,2005-05-19 06:55:07
21949255d1a9c04ed8cba9c54ddac13889b2ea26...a310d4349467d78266f38d29e500c77b96ee5bef,5,511,2,513,7,2005-05-19 15:56:22,2005-05-19 14:27:14
a310d4349467d78266f38d29e500c77b96ee5bef...5c97558c9a813a0a775c438a79cfc438def00c22,12,533,239,772,75,2005-05-19 15:59:40,2005-05-19 10:32:35
5c97558c9a813a0a775c438a79cfc438def00c22...ce7d9c9c3cea73ab81bf38df93927abb580669ec,1,1,1,2,1,2005-05-19 16:07:19,2005-05-19 16:07:19
ce7d9c9c3cea73ab81bf38df93927abb580669ec...875d0f8ddb1d420f6465498842740c4f5ab03e6f,1,0,3,3,1,2005-05-19 16:20:00,2005-05-19 16:20:00
875d0f8ddb1d420f6465498842740c4f5ab03e6f...415e96c8b7e7d47f98a45ae1b6d524418245a3b4,8,157,47,204,21,2005-05-19 16:50:57,2005-05-15 21:23:12
415e96c8b7e7d47f98a45ae1b6d524418245a3b4...7984eabe071298df0ce53da2af449ec16dd747d8,3,7,5,12,6,2005-05-19 16:58:44,2005-05-19 16:24:54
7984eabe071298df0ce53da2af449ec16dd747d8...5b486c3b6531755853e9700ceba0d01f1ed15d21,1,17,4,21,10,2005-05-19 17:37:29,2005-05-19 17:13:01
5b486c3b6531755853e9700ceba0d01f1ed15d21...9669e17a2f79e8ef0bd5981f8178cada5e53d46b,1,2,2,4,2,2005-05-19 17:46:49,2005-05-19 13:23:18
9669e17a2f79e8ef0bd5981f8178cada5e53d46b...667bb59b2d5b0a2e7fca5970d6f757790a6edd74,19,50,50,100,48,2005-05-19 17:52:00,2005-05-19 11:17:16
667bb59b2d5b0a2e7fca5970d6f757790a6edd74...dc26bd890d0a8571c38397e2ab33c0f3963c01a7,1,35,6,41,5,2005-05-19 20:44:29,2005-05-19 20:44:29
dc26bd890d0a8571c38397e2ab33c0f3963c01a7...57fe64a40d95dd99d798c6d7c81c1a76d24a8e7c,11,192,125,317,85,2005-05-20 05:33:07,2005-05-20 02:00:36
57fe64a40d95dd99d798c6d7c81c1a76d24a8e7c...de809dbbce497e0d107562615c1d85ff35b4e0c5,6,8,3,11,5,2005-05-20 05:39:27,2005-05-20 05:39:27
de809dbbce497e0d107562615c1d85ff35b4e0c5...7c4d07c7cc8543f1000639dc19cfaacbc76e5348,1,8,4,12,6,2005-05-20 14:49:17,2005-05-20 14:49:17
7c4d07c7cc8543f1000639dc19cfaacbc76e5348...e59363822f7026896209a9e986c6bf80b10ab37a,1,4,1,5,2,2005-05-20 15:00:01,2005-05-20 07:26:27
e59363822f7026896209a9e986c6bf80b10ab37a...958ba6c96eb58b359c855c9d07e3e45072f0503e,2,20,0,20,2,2005-05-20 16:09:18,2005-05-20 16:09:18
958ba6c96eb58b359c855c9d07e3e45072f0503e...e46091d5f3da713cd3c141ce0bfcd805c6d0ddf8,1,1,1,2,1,2005-05-20 16:11:46,2005-05-20 16:11:46
e46091d5f3da713cd3c141ce0bfcd805c6d0ddf8...63713028cd2c747b225c110193f63caff0f58aeb,3,332,170,502,4,2005-05-20 16:27:43,2005-05-20 15:32:07
63713028cd2c747b225c110193f63caff0f58aeb...411746940f02f6fb90c4b6b97c6f07cee599c2e1,2,62,1,63,3,2005-05-20 17:08:56,2005-05-20 16:48:38
411746940f02f6fb90c4b6b97c6f07cee599c2e1...7ca45252a35df8c78060ff233957fc558714a5d6,1,15,23,38,5,2005-05-20 17:08:56,2005-05-20 16:54:07
7ca45252a35df8c78060ff233957fc558714a5d6...e99d59ff0bff349ef205cef1076e0354c8130680,18,33,31,64,30,2005-05-20 18:46:10,2005-05-20 18:46:10
e99d59ff0bff349ef205cef1076e0354c8130680...91d7b8afc2dc8bacde2012ad076cd8d0c4d36697,2,21,13,34,4,2005-05-20 22:41:45,2005-05-20 20:57:28
91d7b8afc2dc8bacde2012ad076cd8d0c4d36697...d1af002dc608be3213ba18df1a99ced0ab42e6d6,10,202,6,208,23,2005-05-20 22:41:45,2005-05-20 20:59:17
d1af002dc608be3213ba18df1a99ced0ab42e6d6...e002a16ba54096666c2d1768daa122e29fba11ee,3,360,2,362,5,2005-05-20 22:41:45,2005-05-20 21:00:23
e002a16ba54096666c2d1768daa122e29fba11ee...ca3ebdf5b2579d45b478909435b57420a0d2a103,1,1,1,2,1,2005-05-21 01:03:47,2005-05-21 00:49:13
ca3ebdf5b2579d45b478909435b57420a0d2a103...c8265ac096afe8a0eb460a41c0620f6ae13394fe,1,1,1,2,1,2005-05-21 16:44:16,2005-05-21 16:44:16
c8265ac096afe8a0eb460a41c0620f6ae13394fe...427dcb4bca49117664d9428fd4e86483f516d703,16,944,432,1376,97,2005-05-21 16:58:03,2005-05-21 09:39:09
427dcb4bca49117664d9428fd4e86483f516d703...52e9578985fb636ec1d3f6cf794fdadd5ec896fc,14,140,51,191,55,2005-05-21 16:58:03,2005-05-21 09:40:01
52e9578985fb636ec1d3f6cf794fdadd5ec896fc...c3e7fbcbd0561cd13abc8cefcea3e09ab6090d50,3,40,3,43,5,2005-05-21 16:58:03,2005-05-21 09:42:35
c3e7fbcbd0561cd13abc8cefcea3e09ab6090d50...cebf03c4cd24eb692fe9eb426a4bac2c3fad248c,1,1,0,1,1,2005-05-21 16:59:37,2005-05-21 16:59:37
cebf03c4cd24eb692fe9eb426a4bac2c3fad248c...da196b603e665a81943e5df4e8daa3d981846624,1,3,3,6,3,2005-05-21 17:11:37,2005-05-21 17:11:37
da196b603e665a81943e5df4e8daa3d981846624...3258c902e7f286d770ed6fba9219973b2b5bc01d,1,16,3,19,4,2005-05-21 18:04:19,2005-05-21 18:04:19
3258c902e7f286d770ed6fba9219973b2b5bc01d...057c7d30183672d6ef96a9f3e87860058e1c08f8,6,6,6,12,6,2005-05-21 22:17:16,2005-05-21 22:02:51
057c7d30183672d6ef96a9f3e87860058e1c08f8...d6db01075b65da2b8584a0450619390893aae103,1,8,1,9,2,2005-05-21 22:42:53,2005-05-21 22:42:53
d6db01075b65da2b8584a0450619390893aae103...58b103f55d5b95dc24cce2fb4f64e697958fd204,1,20,18,38,8,2005-05-21 23:22:57,2005-05-21 22:55:18
58b103f55d5b95dc24cce2fb4f64e697958fd204...38c6f78059c3060db6f94b24f4a90063a91090d2,9,71,53,124,32,2005-05-22 05:49:19,2005-05-22 02:40:36
38c6f78059c3060db6f94b24f4a90063a91090d2...81e50eabf06dd68e8e62a9b697eaf60904c58b22,16,322,313,635,97,2005-05-22 05:49:19,2005-05-22 02:42:18
81e50eabf06dd68e8e62a9b697eaf60904c58b22...cd1870edb6658d8118ed6015651a0ff080ae7162,1,2,2,4,2,2005-05-22 16:38:26,2005-05-22 08:31:28
cd1870edb6658d8118ed6015651a0ff080ae7162...26dee0adfcfa6fc15a522d32765eabbe4f295237,1,2,0,2,1,2005-05-22 16:46:06,2005-05-22 06:33:32
26dee0adfcfa6fc15a522d32765eabbe4f295237...6b14d7faf0bad026a81a27bac07b47691f621b8f,11,265,167,432,74,2005-05-22 17:17:50,2005-05-22 17:04:37
6b14d7faf0bad026a81a27bac07b47691f621b8f...7ef76925d9c19ef74874e1735e2436e56d0c4897,3,43,34,77,3,2005-05-22 18:03:24,2005-05-22 18:03:24
7ef76925d9c19ef74874e1735e2436e56d0c4897...b2bf34d6c5f0867ab189fc64b1c519bfa613275d,1,21,7,28,4,2005-05-22 18:07:22,2005-05-22 17:44:15
b2bf34d6c5f0867ab189fc64b1c519bfa613275d...8ac866a869a61d382486ace6ea39f9741d9159f8,1,291,289,580,59,2005-05-22 18:07:22,2005-05-22 17:44:16
8ac866a869a61d382486ace6ea39f9741d9159f8...6c84e2e0c76c8c5defb7f67791cf2006d5b8a536,1,21,25,46,11,2005-05-22 18:07:22,2005-05-22 17:44:16
6c84e2e0c76c8c5defb7f67791cf2006d5b8a536...7096a645cde91c96ce849c43750c04433164418c,1,89,70,159,40,2005-05-22 18:07:22,2005-05-22 17:44:17
7096a645cde91c96ce849c43750c04433164418c...2aef5bbae99aeba3551408eae13faea02bf55b67,4,89,10,99,7,2005-05-22 18:07:22,2005-05-22 17:44:17
2aef5bbae99aeba3551408eae13faea02bf55b67...ca67f002194cfe00ec349c7d4e2c936e35f8c669,1,2,2,4,2,2005-05-22 18:40:07,2005-05-22 18:27:28
ca67f002194cfe00ec349c7d4e2c936e35f8c669...6b0c3121061df6b323f430700e8077b324b5e9dd,14,1,35,36,18,2005-05-22 18:54:17,2005-05-22 18:54:17
6b0c3121061df6b323f430700e8077b324b5e9dd...6f97a894d6fe78c9ae24a128e6b93765b4cc76ff,1,5,2,7,3,2005-05-22 21:32:26,2005-05-22 21:32:26
6f97a894d6fe78c9ae24a128e6b93765b4cc76ff...09d74b3b5ac634495e17b92b2b785fa996ffce97,2,5,5,10,5,2005-05-22 21:33:43,2005-05-22 21:33:43
09d74b3b5ac634495e17b92b2b785fa996ffce97...2cb45e95438c113871fbbea5b4f629f9463034e7,2,17,5,22,5,2005-05-22 22:08:15,2005-05-22 22:08:15
2cb45e95438c113871fbbea5b4f629f9463034e7...c1bb93502012b710ec5a31dff62d4aca7bf51adc,2,318,1,319,2,2005-05-23 17:52:17,2005-05-23 17:52:17
c1bb93502012b710ec5a31dff62d4aca7bf51adc...60896c7bfed67f1c7364595213ef9239642f83c5,2,80,10,90,7,2005-05-23 18:49:30,2005-05-23 04:24:49
60896c7bfed67f1c7364595213ef9239642f83c5...f7c1512af8ff4f821c530f9a4bc8f8ff25733d51,7,244,138,382,45,2005-05-23 18:49:30,2005-05-23 04:26:09
f7c1512af8ff4f821c530f9a4bc8f8ff25733d51...046aa6440fdf9a94df5e2f0609bef5d7415ff94a,1,2,1,3,1,2005-05-23 18:49:30,2005-05-23 07:25:15
046aa6440fdf9a94df5e2f0609bef5d7415ff94a...5831b563a442e7c3198a444a51d8caba4d072506,2,13,2,15,2,2005-05-23 19:17:09,2005-05-23 19:07:55
5831b563a442e7c3198a444a51d8caba4d072506...5e224a2ed01facb1233474dd169307f499e70257,1,1,1,2,1,2005-05-23 19:31:59,2005-05-23 19:31:59
5e224a2ed01facb1233474dd169307f499e70257...46979f567bde4c299fa18fdc72180361511b0057,1,74,42,116,12,2005-05-23 21:38:49,2005-05-23 21:38:49
46979f567bde4c299fa18fdc72180361511b0057...a4acb0eb140d80141ac564a09219a10c3ab76449,1,217,31,248,21,2005-05-23 23:09:09,2005-05-23 23:09:09
a4acb0eb140d80141ac564a09219a10c3ab76449...b6d8f309d9bbd8193d9b73eb41c6fcdaa8001298,13,494,366,860,81,2005-05-23 23:23:10,2005-05-23 21:55:33
b6d8f309d9bbd8193d9b73eb41c6fcdaa8001298...881b07654c81a944001f25799908f65787c8a7ae,1,1,1,2,1,2005-05-23 23:32:19,2005-05-23 23:32:19
881b07654c81a944001f25799908f65787c8a7ae...9ab55bd29a9f110810b72d82be912380f74051b3,1,5,5,10,2,2005-05-23 23:37:47,2005-05-23 23:37:47
9ab55bd29a9f110810b72d82be912380f74051b3...4dfdbe10dc8ca02fff2d5f0ce181b45d39394d56,1,5,0,5,4,2005-05-23 23:42:21,2005-05-23 23:42:21
4dfdbe10dc8ca02fff2d5f0ce181b45d39394d56...9a4a100eb46a769d1c5fa80c2daeb0b48a592d8d,1,68,19,87,17,2005-05-24 02:13:55,2005-05-24 02:13:55
9a4a100eb46a769d1c5fa80c2daeb0b48a592d8d...bceafe752c03f4b13b9b1671a55d9e2acd26432d,8,69,127,196,32,2005-05-24 02:17:06,2005-05-24 01:14:03
bceafe752c03f4b13b9b1671a55d9e2acd26432d...b1c006dd651fce55e25a7b06d00382cfdc1a3f91,2,7,5,12,3,2005-05-24 02:17:06,2005-05-24 01:20:39
b1c006dd651fce55e25a7b06d00382cfdc1a3f91...587e49405be6c4053a69ee8a938660125aa1b51f,1,3,2,5,1,2005-05-24 02:17:06,2005-05-24 01:58:00
587e49405be6c4053a69ee8a938660125aa1b51f...1e3f6b6e64511491d86ac7ce447ee26cea362d12,1,46,4,50,3,2005-05-24 02:54:55,2005-05-24 02:54:55
1e3f6b6e64511491d86ac7ce447ee26cea362d12...25d5ea410fd528c13e5f56f7836ee8a3b839b168,6,314,252,566,63,2005-05-24 08:26:26,2005-05-24 08:10:48
25d5ea410fd528c13e5f56f7836ee8a3b839b168...c4bd907d959673a9113e32e53f65a279b9786f25,1,5,2,7,2,2005-05-24 17:21:13,2005-05-24 17:21:13
c4bd907d959673a9113e32e53f65a279b9786f25...320d3a1b1aa04d75f0aaff3cc7cf582e144a84c6,1,40,4,44,4,2005-05-24 21:40:28,2005-05-24 21:40:28
320d3a1b1aa04d75f0aaff3cc7cf582e144a84c6...d0309355c9d0df60836b0610169044873f791caf,1,2,12,14,6,2005-05-25 00:47:05,2005-05-24 09:05:08
d0309355c9d0df60836b0610169044873f791caf...d7f6ea3d7d2b06b5ee8c308a8acaf394b5ce9714,2,110,13,123,15,2005-05-25 00:47:05,2005-05-24 08:51:27
d7f6ea3d7d2b06b5ee8c308a8acaf394b5ce9714...bba0f401eea22ddc345df8aa32ac0ccb2c73dc15,1,1,1,2,1,2005-05-25 00:47:05,2005-05-24 18:57:01
bba0f401eea22ddc345df8aa32ac0ccb2c73dc15...85976974581060716311d6807b03a671cb71cbde,4,116,7,123,7,2005-05-25 00:47:05,2005-05-24 19:09:32
85976974581060716311d6807b03a671cb71cbde...6c56c5340a96aa2c80565813ee7f25a222a70cd9,1,22,14,36,10,2005-05-25 01:10:11,2005-05-25 01:10:11
6c56c5340a96aa2c80565813ee7f25a222a70cd9...c4ee2952b3146fe7dc9433b92bf066e55987ef74,1,4,1,5,1,2005-05-25 03:09:46,2005-05-25 01:20:08
c4ee2952b3146fe7dc9433b92bf066e55987ef74...ea84480f01406a0779d2932bb53f35f366ca0e6c,1,25,24,49,11,2005-05-25 04:34:12,2005-05-25 04:34:12
ea84480f01406a0779d2932bb53f35f366ca0e6c...f4d89f26cec4e2de3abde7fb2ab3aed8840d5435,1,2,2,4,1,2005-05-25 16:12:12,2005-05-25 06:35:38
f4d89f26cec4e2de3abde7fb2ab3aed8840d5435...4cae1a967a99962e51777fcc950321902cce0adf,2,12,2,14,6,2005-05-25 16:32:54,2005-05-25 06:24:22
4cae1a967a99962e51777fcc950321902cce0adf...6f93a631acd2017c5f7c5bc29294b753588b0bea,1,1,1,2,1,2005-05-25 18:09:12,2005-05-25 18:09:12
6f93a631acd2017c5f7c5bc29294b753588b0bea...ea88ee46de82bf1e398d0cfef05e3dcdf48b1b88,1,2,2,4,2,2005-05-25 18:59:37,2005-05-25 17:21:09
ea88ee46de82bf1e398d0cfef05e3dcdf48b1b88...c5434dead6a52a48c520dfa3d8ed24dc3673ab1a,1,12,3,15,3,2005-05-25 21:05:13,2005-05-25 21:05:13
c5434dead6a52a48c520dfa3d8ed24dc3673ab1a...908bddab96230ed6d43726a8464057ad4c32d1a1,1,4,3,7,2,2005-05-25 22:21:57,2005-05-25 22:06:50
908bddab96230ed6d43726a8464057ad4c32d1a1...96716a197658e069557e7615ce2019107d72225e,2,25,14,39,12,2005-05-25 22:21:57,2005-05-25 22:07:08
96716a197658e069557e7615ce2019107d72225e...9fdade06739af0b3e27422a973ae4fd83e3c918e,3,40,2,42,5,2005-05-25 23:06:24,2005-05-25 23:00:04
9fdade06739af0b3e27422a973ae4fd83e3c918e...e871b649a3f4ede26eb98c7d46df7acdc7ecbe81,1,2,1,3,2,2005-05-26 01:25:08,2005-05-26 01:25:08
e871b649a3f4ede26eb98c7d46df7acdc7ecbe81...3ff1fbbb9446e03050047a67247151887ee59e70,2,5,0,5,2,2005-05-26 01:27:14,2005-05-26 01:27:14
3ff1fbbb9446e03050047a67247151887ee59e70...a6f68d4767835d5720cff61785b93eaf99376241,1,42,15,57,13,2005-05-26 01:29:09,2005-05-26 01:29:09
a6f68d4767835d5720cff61785b93eaf99376241...bd1e17e245153fdc75feaaf5e556b922d98ca699,3,7,1,8,3,2005-05-26 02:26:28,2005-05-26 02:26:28
bd1e17e245153fdc75feaaf5e556b922d98ca699...368da62598b30a521970866327ce493e34f7f590,2,3,5,8,3,2005-05-26 02:37:10,2005-05-26 02:11:31
368da62598b30a521970866327ce493e34f7f590...19c58fb84d2fba1a1bb8bd8fef44c0463aa4e236,1,146,90,236,58,2005-05-26 17:23:51,2005-05-26 17:23:51
19c58fb84d2fba1a1bb8bd8fef44c0463aa4e236...3f40315aaa4f1abc4883c85ca0a8ea9570da6e24,1,77,15,92,13,2005-05-26 18:40:43,2005-05-26 18:40:43
3f40315aaa4f1abc4883c85ca0a8ea9570da6e24...fab2c257be908e8aded03addb447b1d2a4d2f748,1,68,28,96,15,2005-05-26 19:25:52,2005-05-26 19:25:52
fab2c257be908e8aded03addb447b1d2a4d2f748...5041aa70405d2359114b285e7c97b877aa0c079a,1,72,10,82,12,2005-05-26 20:11:24,2005-05-26 20:11:24
5041aa70405d2359114b285e7c97b877aa0c079a...0e87e048e161c6636fe6c0136a30092165b728d1,1,1,1,2,1,2005-05-26 20:28:42,2005-05-26 20:28:42
0e87e048e161c6636fe6c0136a30092165b728d1...a577284aee793d71982e896b711c7b3d57e6bcf2,1,96,26,122,17,2005-05-26 22:10:02,2005-05-26 22:10:02
a577284aee793d71982e896b711c7b3d57e6bcf2...4130b99571903fb93e4c6e0d6677be7b6b986426,2,42,9,51,10,2005-05-26 22:18:55,2005-05-26 09:24:30
4130b99571903fb93e4c6e0d6677be7b6b986426...4ba406a75ca80e335acfddf77f8d119af6d34d9e,1,67,0,67,1,2005-05-26 22:18:55,2005-05-26 09:31:05
4ba406a75ca80e335acfddf77f8d119af6d34d9e...6d3a5077ddb78a73fe26b154c459bc4731bca0dd,3,227,18,245,21,2005-05-26 22:18:55,2005-05-26 17:52:50
6d3a5077ddb78a73fe26b154c459bc4731bca0dd...2eab945e865317cb7d390aec214303f1d931b53a,5,94,94,188,14,2005-05-26 22:18:55,2005-05-26 21:38:19
2eab945e865317cb7d390aec214303f1d931b53a...c504aae2a6c96f1363562a3aa1dc05fb4462e978,2,46,1,47,2,2005-05-26 23:21:13,2005-05-26 23:03:26
c504aae2a6c96f1363562a3aa1dc05fb4462e978...fbe082a528861af785be15bb37d1c7d8f574daa4,1,0,2,2,1,2005-05-27 00:41:28,2005-05-27 00:41:28
fbe082a528861af785be15bb37d1c7d8f574daa4...a9c9cef161b26ca610783dd0b180d18956c7b119,1,5,1,6,2,2005-05-27 01:50:38,2005-05-27 00:52:43
a9c9cef161b26ca610783dd0b180d18956c7b119...84c1afd7e7c69c6c3c0677d5ee01925d4c70d318,1,5,12,17,1,2005-05-27 17:22:09,2005-05-27 17:22:09
84c1afd7e7c69c6c3c0677d5ee01925d4c70d318...8310c2c0b585d3ac35a275f795e15fd9887e8b7d,1,3,1,4,3,2005-05-27 17:34:24,2005-05-27 02:59:10
8310c2c0b585d3ac35a275f795e15fd9887e8b7d...0746b620010d5e3b48f6fdb210edf3a066d0bc6a,1,4,0,4,1,2005-05-29 17:59:18,2005-05-28 14:42:17
0746b620010d5e3b48f6fdb210edf3a066d0bc6a...a00d7d106aa333c4b4d0095f58e05c0c4621bbc2,1,1,1,2,1,2005-05-29 18:17:43,2005-05-27 22:49:54
a00d7d106aa333c4b4d0095f58e05c0c4621bbc2...226406f693013ea3eadab258cb5fc9d8e83df916,5,15,13,28,6,2005-05-29 18:17:43,2005-05-27 22:50:30
226406f693013ea3eadab258cb5fc9d8e83df916...847941fdd962d71a724d72b9f90389bae835d2c0,1,1,2,3,1,2005-05-29 18:17:43,2005-05-27 22:51:52
847941fdd962d71a724d72b9f90389bae835d2c0...1a0756ffe4a4faf2dd70b36c36519d8530d98e7c,1,0,1,1,1,2005-05-29 18:17:43,2005-05-27 22:52:55
1a0756ffe4a4faf2dd70b36c36519d8530d98e7c...903d475a0bcde34a03e462b56a77564252876483,2,1,3,4,3,2005-05-29 18:17:43,2005-05-27 22:53:31
903d475a0bcde34a03e462b56a77564252876483...09d9d1a648ecff1dd914224b3ee616b0486ec525,2,4,4,8,4,2005-05-29 18:17:43,2005-05-27 22:54:06
09d9d1a648ecff1dd914224b3ee616b0486ec525...19feebc8c3ca7bd40f2f32f4f856b68b9a02870c,5,19,16,35,13,2005-05-29 18:17:43,2005-05-27 22:54:37
19feebc8c3ca7bd40f2f32f4f856b68b9a02870c...be020332a152ef95e0e8435fb69d8c02d5da29bb,2,0,25,25,2,2005-05-29 18:17:43,2005-05-27 22:55:01
be020332a152ef95e0e8435fb69d8c02d5da29bb...367cec1c024c3849cb32eaac15884a4adfefe1de,6,81,26,107,20,2005-05-29 18:17:43,2005-05-27 22:55:28
367cec1c024c3849cb32eaac15884a4adfefe1de...15d061b435a7e3b6bead39df3889f4af78c4b00a,4,169,80,249,31,2005-05-29 18:17:43,2005-05-27 22:55:55
15d061b435a7e3b6bead39df3889f4af78c4b00a...6145ee8b361959db04b8cdefc883e4fc2dc27276,4,19,19,38,16,2005-05-29 18:17:43,2005-05-27 22:56:17
6145ee8b361959db04b8cdefc883e4fc2dc27276...f0c6b2a2fd98b51f1f2655ea69ace9763da28e79,6,102,9,111,18,2005-05-29 18:17:44,2005-05-27 22:56:38
f0c6b2a2fd98b51f1f2655ea69ace9763da28e79...2bc2564145835996734d6ed5d1880f85b17233d6,1,4,1,5,3,2005-05-29 18:40:40,2005-05-28 04:05:38
2bc2564145835996734d6ed5d1880f85b17233d6...6af1f0192ff8740fe77db7cf02c739ccfbdf119c,5,195,156,351,45,2005-05-29 18:40:40,2005-05-28 07:05:38
6af1f0192ff8740fe77db7cf02c739ccfbdf119c...e25de75696dc99f327c8dd8e2cba937939e281ca,5,18,5,23,8,2005-05-29 18:42:29,2005-05-28 09:53:43
e25de75696dc99f327c8dd8e2cba937939e281ca...844e6e4d58d3e52eee7fb490bfaeadaa5ea2d59c,3,0,3,3,3,2005-05-29 18:42:29,2005-05-28 09:55:16
844e6e4d58d3e52eee7fb490bfaeadaa5ea2d59c...8b7d510fb182ca40bd0f905bb2f5543b0d9549de,1,3,0,3,1,2005-05-29 19:01:06,2005-05-28 19:22:38
8b7d510fb182ca40bd0f905bb2f5543b0d9549de...b97e3dfa7699776cd4bcc1a712e884992d757f40,1,12,1,13,1,2005-05-29 19:06:32,2005-05-29 19:06:32
b97e3dfa7699776cd4bcc1a712e884992d757f40...cad88fdf8d1ebafb5d4d1b92eb243ff86bae740b,1,49,6,55,4,2005-05-30 17:20:44,2005-05-30 17:20:44
cad88fdf8d1ebafb5d4d1b92eb243ff86bae740b...ddafa7e93325d45cd4bd950dd8e89ff3188d0250,5,219,18,237,10,2005-05-30 17:35:49,2005-05-29 23:54:59
ddafa7e93325d45cd4bd950dd8e89ff3188d0250...befe86392c767b62e4a6498cf951faae6f2c5ea3,5,25,16,41,5,2005-05-30 17:35:49,2005-05-29 23:56:13
befe86392c767b62e4a6498cf951faae6f2c5ea3...01c4e70f637c0617e24d9a7abb7239e25de9a51d,3,7,7,14,6,2005-05-30 17:35:49,2005-05-29 23:56:48
01c4e70f637c0617e24d9a7abb7239e25de9a51d...9d429ff6ff2832d6e63933e6d33b8380be703017,1,7,2,9,1,2005-05-30 17:35:49,2005-05-30 07:07:39
9d429ff6ff2832d6e63933e6d33b8380be703017...2cd68882ee8629f9782be017007fff4c78e45e45,2,35,32,67,5,2005-05-30 17:35:49,2005-05-30 07:08:07
2cd68882ee8629f9782be017007fff4c78e45e45...f345b0a066572206aac4a4f9a57d746e213b6bff,13,433,29,462,36,2005-05-30 17:35:49,2005-05-30 07:08:37
f345b0a066572206aac4a4f9a57d746e213b6bff...a3e870f2e2bcacc80d5b81d7b77c15a7928a9082,4,104,2,106,6,2005-05-30 19:51:00,2005-05-30 19:51:00
a3e870f2e2bcacc80d5b81d7b77c15a7928a9082...53d4b460858745949287d5bb51f5210b80d86305,2,245,172,417,31,2005-05-31 00:37:20,2005-05-30 01:52:19
53d4b460858745949287d5bb51f5210b80d86305...866b973b5d418622cbe28fea85169379dcb30f9d,1,2,2,4,2,2005-05-31 00:45:41,2005-05-31 00:45:41
866b973b5d418622cbe28fea85169379dcb30f9d...2036d841020b7500eca7d568bd0c353b4fe73408,2,8,10,18,2,2005-05-31 01:10:46,2005-05-30 20:53:45
2036d841020b7500eca7d568bd0c353b4fe73408...af5323e0274fad058f13949b89a9191a7bef7e38,10,167,10,177,22,2005-05-31 01:10:46,2005-05-30 07:09:07
af5323e0274fad058f13949b89a9191a7bef7e38...70aadac081d8c05ae31616c8f63b73ee3e83c45a,2,24,2,26,6,2005-05-31 01:10:46,2005-05-30 23:40:16
70aadac081d8c05ae31616c8f63b73ee3e83c45a...ac5155ef59a686f02e984d449476208ffe33b66d,2,3,2,5,3,2005-05-31 01:44:02,2005-05-31 01:44:02
ac5155ef59a686f02e984d449476208ffe33b66d...8906300f65a3b0c3e061af9d2c7ba48fedfa26a4,1,50,5,55,5,2005-05-31 01:46:32,2005-05-31 01:46:32
8906300f65a3b0c3e061af9d2c7ba48fedfa26a4...97658004c311c54e2e4755dc545a9da261bd1441,1,14,2,16,3,2005-05-31 02:30:07,2005-05-31 02:30:07
97658004c311c54e2e4755dc545a9da261bd1441...381ca9a3bcfb6eae40340ecd683b189fd5781f14,1,5,13,18,4,2005-05-31 22:05:59,2005-05-31 22:05:59
381ca9a3bcfb6eae40340ecd683b189fd5781f14...1d9e6f92bc6a1a1a37d187db72dcc02642ba04f6,1,8,8,16,3,2005-05-31 22:17:58,2005-05-31 22:17:58
1d9e6f92bc6a1a1a37d187db72dcc02642ba04f6...edb0c724287a0ee7cefa11f28ef43d8c5cfa1985,6,43,83,126,9,2005-05-31 23:17:27,2005-05-31 21:47:25
edb0c724287a0ee7cefa11f28ef43d8c5cfa1985...8c7fa2478e16227c8f42d05758bf669b144c5055,1,413,0,413,1,2005-06-01 02:50:34,2005-06-01 02:50:34
8c7fa2478e16227c8f42d05758bf669b144c5055...66204988fe2e5a2a18c4ff55798c7203775d9fd4,3,146,52,198,18,2005-06-01 03:32:27,2005-06-01 01:46:47
66204988fe2e5a2a18c4ff55798c7203775d9fd4...95bedc9eecfa4d905a9d85dff8b406049476d9e7,1,9,4,13,2,2005-06-01 03:50:49,2005-06-01 03:50:49
95bedc9eecfa4d905a9d85dff8b406049476d9e7...837eedf41bc9acd0fe6e2e408386eac847493419,1,11,11,22,11,2005-06-01 14:39:36,2005-06-01 14:39:36
837eedf41bc9acd0fe6e2e408386eac847493419...ef6a46e6eaae5e70df8b7ef9d7ead66c3313027e,1,1,1,2,1,2005-06-01 14:51:51,2005-06-01 04:31:02
ef6a46e6eaae5e70df8b7ef9d7ead66c3313027e...e3bc7a3bc7b77f44d686003f5a9346a135529f73,3,86,69,155,6,2005-06-01 15:34:23,2005-06-01 15:34:23
e3bc7a3bc7b77f44d686003f5a9346a135529f73...9d97aa6466fe03db504291e1cef3ac4c0c5160a9,1,22,5,27,5,2005-06-01 15:42:22,2005-06-01 15:42:22
9d97aa6466fe03db504291e1cef3ac4c0c5160a9...e764b8e8b3c50b131be825532ba26fa346d6586e,3,9,2,11,4,2005-06-01 16:13:26,2005-06-01 16:13:26
e764b8e8b3c50b131be825532ba26fa346d6586e...81bb573ed882523e345f0923b88db2aac8f4b93c,1,19,8,27,5,2005-06-01 16:27:22,2005-06-01 16:27:22
81bb573ed882523e345f0923b88db2aac8f4b93c...67574c403f1e27660bbd0348b81b31adc9889b20,5,17,15,32,9,2005-06-01 20:24:03,2005-06-01 18:38:07
67574c403f1e27660bbd0348b81b31adc9889b20...f35ca9ed3ef02541a938f3bd43cad83af93eb94f,1,97,3,100,3,2005-06-02 00:48:33,2005-06-02 00:48:33
f35ca9ed3ef02541a938f3bd43cad83af93eb94f...c4483576b8d30fadcae208d8f12383febd060d0a,2,16,12,28,3,2005-06-02 00:54:59,2005-06-02 00:54:59
c4483576b8d30fadcae208d8f12383febd060d0a...5180cacc202bb20b15981469487eb8d6b0509997,2,74,19,93,6,2005-06-02 14:57:25,2005-06-02 14:57:25
5180cacc202bb20b15981469487eb8d6b0509997...cc29f7328551eca7bb6a8f37653c3fe3b7a973a5,1,6,6,12,6,2005-06-02 14:58:41,2005-06-02 14:58:41
cc29f7328551eca7bb6a8f37653c3fe3b7a973a5...81f2bb1f54b20abefa9d102ea98c4ac73d81a66d,1,50,36,86,3,2005-06-02 16:19:53,2005-06-02 16:19:53
81f2bb1f54b20abefa9d102ea98c4ac73d81a66d...3b42a63cb5845ef1c818f6b00e693c61469ee966,1,21,17,38,2,2005-06-02 16:25:44,2005-06-02 16:25:44
3b42a63cb5845ef1c818f6b00e693c61469ee966...4a62b61939396c512bd7592f800110bddf45af72,10,66,6,72,17,2005-06-02 22:48:33,2005-06-02 22:19:00
4a62b61939396c512bd7592f800110bddf45af72...65c2e0c349aa5c7f605defb52dc67f1b3658a1b9,3,67,5,72,5,2005-06-02 22:48:33,2005-06-02 22:20:54
65c2e0c349aa5c7f605defb52dc67f1b3658a1b9...a7b209091ad2a8277727d62ef1193e109b7fe9ff,1,28,13,41,2,2005-06-03 00:15:32,2005-06-03 00:15:32
a7b209091ad2a8277727d62ef1193e109b7fe9ff...9b5b9f398c56f83839bdc4fc630f38afadc94c21,1,4,7,11,3,2005-06-03 01:30:08,2005-06-02 18:50:48
9b5b9f398c56f83839bdc4fc630f38afadc94c21...d3a15c49d4e2abdad900faf723f3bd3ab8ab19e9,1,8,1,9,2,2005-06-03 01:30:08,2005-06-02 18:50:42
d3a15c49d4e2abdad900faf723f3bd3ab8ab19e9...d3d49c3d3559d4b5e79ae99fe485af48606d5cab,1,106,0,106,1,2005-06-03 01:30:08,2005-06-02 20:50:17
d3d49c3d3559d4b5e79ae99fe485af48606d5cab...a325a11b88bc13d569be1571ce559858dc224af4,1,1,1,2,1,2005-06-03 14:36:42,2005-06-03 11:25:18
a325a11b88bc13d569be1571ce559858dc224af4...5b86040679626e36c12345039f6df62f4622aef2,1,7,20,27,7,2005-06-03 16:51:01,2005-06-03 16:21:23
5b86040679626e36c12345039f6df62f4622aef2...355e76a4a3c5e49ae15a642806457bce10fe2ef4,5,40,25,65,13,2005-06-03 18:23:03,2005-06-03 08:36:03
355e76a4a3c5e49ae15a642806457bce10fe2ef4...ce24067549a8554b214e723d7aa4bc063c54409e,10,33,27,60,17,2005-06-03 18:23:03,2005-06-03 08:36:43
ce24067549a8554b214e723d7aa4bc063c54409e...0e3994fa97e9876b571531444b97ae6e63fd744d,5,62,28,90,11,2005-06-03 18:23:03,2005-06-03 08:37:54
0e3994fa97e9876b571531444b97ae6e63fd744d...eeaa4603147974b988d7b958571628d6ecd697f3,3,224,43,267,25,2005-06-03 18:23:03,2005-06-03 08:40:28
eeaa4603147974b988d7b958571628d6ecd697f3...dba385bb3ed541c4d18e2b8080960eee358394fa,2,93,32,125,14,2005-06-03 23:07:29,2005-06-03 21:43:52
dba385bb3ed541c4d18e2b8080960eee358394fa...337cb3fb8da45f10fe9a0c3cf571600f55ead2ce,1,21,24,45,11,2005-06-04 21:38:28,2005-06-04 21:38:28
337cb3fb8da45f10fe9a0c3cf571600f55ead2ce...fa375c7f1b6298b128492b0935e92ecd0fd668e4,2,168,1,169,2,2005-06-05 03:21:35,2005-06-05 03:21:35
fa375c7f1b6298b128492b0935e92ecd0fd668e4...848b292e835f10b0f859b22415be6e3fa951c55e,1,11,1,12,5,2005-06-05 03:33:01,2005-06-05 03:33:01
848b292e835f10b0f859b22415be6e3fa951c55e...000182eacf99cde27d5916aa415921924b82972c,4,67,22,89,19,2005-06-05 16:02:03,2005-06-05 16:02:03
000182eacf99cde27d5916aa415921924b82972c...477606f57d6b1cce3f354d394be26745b92808f7,1,11,9,20,7,2005-06-05 16:55:27,2005-06-05 16:55:27
477606f57d6b1cce3f354d394be26745b92808f7...3cca928d4aae691572ef9a73dcc29a04f66900a1,1,187,10,197,12,2005-06-05 18:03:13,2005-06-05 18:03:13
3cca928d4aae691572ef9a73dcc29a04f66900a1...6e7c92a91d2706ddd9955cb9807b65a63b0bbfdf,1,82,15,97,15,2005-06-05 19:16:32,2005-06-05 19:16:32
6e7c92a91d2706ddd9955cb9807b65a63b0bbfdf...30996652e752d5fdf18f6978a70905747d1fdabc,1,27,12,39,4,2005-06-05 19:43:56,2005-06-05 19:43:56
30996652e752d5fdf18f6978a70905747d1fdabc...5aa7d94cd6376b2c9a7fa7bdc33fb306b940360a,1,121,4,125,9,2005-06-05 21:05:43,2005-06-05 21:05:43
5aa7d94cd6376b2c9a7fa7bdc33fb306b940360a...0601e131c95940701c153e35ba73b97914ec0b3f,1,6,5,11,6,2005-06-05 21:14:58,2005-06-04 06:02:23
0601e131c95940701c153e35ba73b97914ec0b3f...49d9e85d1103fe1d0fcb73956643b93acc5c1f4f,1,2,2,4,2,2005-06-05 21:14:58,2005-06-04 06:04:07
49d9e85d1103fe1d0fcb73956643b93acc5c1f4f...f78c79c5d4486f47dcd69ea7fef93e84051d4496,2,9,15,24,6,2005-06-05 21:14:58,2005-06-04 06:05:57
f78c79c5d4486f47dcd69ea7fef93e84051d4496...a48e1d67e167507091f25dc00e2bd6c280fa538e,9,113,12,125,17,2005-06-05 21:18:00,2005-06-05 06:11:38
a48e1d67e167507091f25dc00e2bd6c280fa538e...33f4d087a95a537095371a2fe02b96787518f389,1,3,3,6,2,2005-06-05 21:26:50,2005-06-05 21:26:50
33f4d087a95a537095371a2fe02b96787518f389...4a1332d04b676a226eba5a7c1247db199d463570,1,241,0,241,1,2005-06-05 22:23:57,2005-06-05 21:30:58
4a1332d04b676a226eba5a7c1247db199d463570...1a93a7662d6f8c3a4f48cb9468eb494ec823f2a5,1,35,1,36,2,2005-06-05 22:23:57,2005-06-05 21:39:49
1a93a7662d6f8c3a4f48cb9468eb494ec823f2a5...f7b797073c2286fff8c4d46842ed00d868f3b2fa,1,3,0,3,1,2005-06-05 22:25:28,2005-06-05 22:25:28
f7b797073c2286fff8c4d46842ed00d868f3b2fa...dc93841715dfa9a9cdda6f2c4a25eec831ea7aa0,7,14,12,26,7,2005-06-05 22:31:52,2005-06-05 22:31:52
dc93841715dfa9a9cdda6f2c4a25eec831ea7aa0...418aaf847a8b3ffffb4f777a2dd5262ca5ce0ef7,6,26,26,52,21,2005-06-05 23:12:27,2005-06-05 22:41:05
418aaf847a8b3ffffb4f777a2dd5262ca5ce0ef7...9b63f50148bd155c00b6893dbbf48583f7b0848d,2,9,7,16,5,2005-06-05 23:57:23,2005-05-31 16:52:43
9b63f50148bd155c00b6893dbbf48583f7b0848d...02ede67ad45973f9f8d07db7896a537de97d21b6,2,54,5,59,10,2005-06-06 03:02:31,2005-06-06 03:02:31
02ede67ad45973f9f8d07db7896a537de97d21b6...76f38347b4199f65e8c897ebf4f9ce1d3a24378b,1,14,14,28,9,2005-06-06 03:28:33,2005-06-06 03:28:33
76f38347b4199f65e8c897ebf4f9ce1d3a24378b...12dccc165400beae564d2357ce86c71937e5cdc0,4,192,174,366,16,2005-06-06 04:59:54,2005-06-06 04:59:54
12dccc165400beae564d2357ce86c71937e5cdc0...220a0b527bd6ecd30a9d6dfed22195c95e6f445a,3,107,23,130,22,2005-06-06 05:07:31,2005-06-06 05:07:31
220a0b527bd6ecd30a9d6dfed22195c95e6f445a...e6ee623b7be2a59a3f3d1ff8c513d72b6f15344f,1,44,15,59,6,2005-06-06 05:59:59,2005-06-06 05:59:59
e6ee623b7be2a59a3f3d1ff8c513d72b6f15344f...6ee67f2610d0060bee45eee0b83fe42143441589,2,2,1,3,2,2005-06-06 06:15:40,2005-06-06 06:15:40
6ee67f2610d0060bee45eee0b83fe42143441589...a76d74fb7146d1785cdefc58a91c50ab9acec775,1,2,2,4,3,2005-06-06 06:32:53,2005-06-06 06:32:53
a76d74fb7146d1785cdefc58a91c50ab9acec775...c3f13d59f75e144e615b4a5b480348057a7b8b3f,1,18,1,19,2,2005-06-06 06:33:38,2005-06-06 06:18:16
c3f13d59f75e144e615b4a5b480348057a7b8b3f...d925ffbd064802bc8a6ab0bccf0c43b00a7fe710,1,1,1,2,1,2005-06-06 06:38:18,2005-06-06 06:38:18
d925ffbd064802bc8a6ab0bccf0c43b00a7fe710...a3437b8c26a63d971437c8b6ac6f6d4f632be548,8,840,18,858,26,2005-06-06 16:07:26,2005-06-06 15:39:40
a3437b8c26a63d971437c8b6ac6f6d4f632be548...64de356299c74d891de5c11385538b7bcbc15bae,1,1,0,1,1,2005-06-06 16:09:43,2005-06-06 16:09:43
64de356299c74d891de5c11385538b7bcbc15bae...90334cf780428f1ca68e5f29fb543e3605fb2fc1,1,8,2,10,2,2005-06-06 17:12:31,2005-06-06 17:12:31
90334cf780428f1ca68e5f29fb543e3605fb2fc1...96cd5429a48235fe978ddcb4af56f13e5397cdeb,1,5,17,22,7,2005-06-06 20:13:27,2005-06-06 19:20:55
96cd5429a48235fe978ddcb4af56f13e5397cdeb...d723c690637f2918d9861e8d602e592c5fa0bc5b,1,110,163,273,25,2005-06-06 21:01:58,2005-06-06 21:01:58
d723c690637f2918d9861e8d602e592c5fa0bc5b...451322512f2f72fe07461a8aeae0df4cfce7fda1,1,10,14,24,3,2005-06-06 21:33:11,2005-06-06 21:33:11
451322512f2f72fe07461a8aeae0df4cfce7fda1...95fc75129acf14d980bdd56b9b2ee74190f81d91,5,207,2,209,7,2005-06-07 00:09:45,2005-06-06 20:31:29
95fc75129acf14d980bdd56b9b2ee74190f81d91...9182f89ab2b0d861226c3ee3d98f9a6a670970e3,1,2,2,4,1,2005-06-07 00:09:45,2005-06-06 20:35:02
9182f89ab2b0d861226c3ee3d98f9a6a670970e3...cd541a68b38cead87f5fa69d5331c467bce71656,5,63,9,72,8,2005-06-07 00:11:11,2005-06-06 20:38:26
cd541a68b38cead87f5fa69d5331c467bce71656...c7c4bbe63193f580abd2460e96dd7e65f2d4904c,2,41,5,46,9,2005-06-07 00:12:47,2005-06-06 20:43:27
c7c4bbe63193f580abd2460e96dd7e65f2d4904c...3f4eff75308b86fe462a2333108470bd6556e3c4,1,0,3,3,1,2005-06-07 00:39:14,2005-06-07 00:39:14
3f4eff75308b86fe462a2333108470bd6556e3c4...ed37b5b2b94398f3ab8312dfdf23cfd25549e3ec,2,3,3,6,3,2005-06-07 00:40:22,2005-06-07 00:40:22
ed37b5b2b94398f3ab8312dfdf23cfd25549e3ec...e5b905c4481a3364070094b8ce0c2bf7fa5d481e,1,5,1,6,1,2005-06-07 02:37:25,2005-06-07 02:37:25
e5b905c4481a3364070094b8ce0c2bf7fa5d481e...63aff4fed94355889be98ad44371e29942ff70e4,2,45,11,56,11,2005-06-07 02:49:45,2005-06-07 02:30:39
63aff4fed94355889be98ad44371e29942ff70e4...c859600954df4c292ec7c81d7f2f9d0a62b5975b,4,698,13,711,7,2005-06-07 18:41:51,2005-06-07 18:36:30
c859600954df4c292ec7c81d7f2f9d0a62b5975b...972d1bb067d0cea6334da081f6a3e2a6bad6f20b,1,5,5,10,5,2005-06-07 20:44:11,2005-06-07 20:35:56
972d1bb067d0cea6334da081f6a3e2a6bad6f20b...001d4a27dbfaaa59c25dc35dafc69bd9b9bc21d3,4,13,8,21,8,2005-06-07 21:23:46,2005-06-07 21:23:46
001d4a27dbfaaa59c25dc35dafc69bd9b9bc21d3...d4f8b390a4326625f0c3d65a8d120336e38928d7,3,336,2,338,5,2005-06-07 22:11:28,2005-06-07 22:11:28
d4f8b390a4326625f0c3d65a8d120336e38928d7...ccef66b55a6a2eb2c5f6a9dd29a86b181df21af9,1,66,24,90,11,2005-06-07 22:13:24,2005-06-07 21:35:43
ccef66b55a6a2eb2c5f6a9dd29a86b181df21af9...b5b425074e5f84f261b1290b1a83eca635c49147,1,5,5,10,1,2005-06-07 22:17:33,2005-06-07 22:17:33
b5b425074e5f84f261b1290b1a83eca635c49147...a57f0b58d7d4aee2b874ff349e53b9f7ee3aeb54,1,3,1,4,2,2005-06-07 22:20:39,2005-06-07 22:20:39
a57f0b58d7d4aee2b874ff349e53b9f7ee3aeb54...b0bf8f24e9c7bdeb7e472e6b1fa5f51de1cdcc97,1,105,0,105,1,2005-06-07 22:23:30,2005-06-06 00:46:06
b0bf8f24e9c7bdeb7e472e6b1fa5f51de1cdcc97...28f8fafff8511d4f03f956819f7819b481d7fd50,1,1,1,2,1,2005-06-07 22:23:30,2005-06-06 00:54:10
28f8fafff8511d4f03f956819f7819b481d7fd50...fcbfd5a6b2c87dc5ecd1d6c4e94c56eebf44c8ac,1,89,1,90,1,2005-06-07 22:52:06,2005-06-07 22:52:06
fcbfd5a6b2c87dc5ecd1d6c4e94c56eebf44c8ac...af3f929f9546268ede788b4217ff0b6a655ab62a,1,5,2,7,1,2005-06-08 15:11:47,2005-06-08 15:11:47
af3f929f9546268ede788b4217ff0b6a655ab62a...32798c707e701a7b0b7c19b469a1fcb57bda1f66,1,7,0,7,2,2005-06-08 15:17:29,2005-06-01 11:27:23
32798c707e701a7b0b7c19b469a1fcb57bda1f66...4e7346735aaf0e0d15f0b18023ac21d983b9fd83,2,177,3,180,5,2005-06-08 16:37:10,2005-06-08 14:37:41
4e7346735aaf0e0d15f0b18023ac21d983b9fd83...5b1ea09de1eb2ae190169ca77e16a79de0e1ede7,2,2,5,7,3,2005-06-08 17:09:41,2005-06-08 17:09:41
5b1ea09de1eb2ae190169ca77e16a79de0e1ede7...7d95ee935182a06374d152d7638bdd999e78f80b,2,30,32,62,5,2005-06-08 17:19:53,2005-06-08 09:08:54
7d95ee935182a06374d152d7638bdd999e78f80b...f9e7750621ca5e067f58a679caff5ff2f9881c4c,1,1,1,2,1,2005-06-08 18:31:53,2005-06-08 18:31:53
f9e7750621ca5e067f58a679caff5ff2f9881c4c...2a68a8659f7dc55fd285d235ae2d19e7a8116c30,1,19,12,31,9,2005-06-08 18:40:59,2005-06-08 18:40:59
2a68a8659f7dc55fd285d235ae2d19e7a8116c30...e0f0e891c1742c6ae22dbc648a1000ad8655ff34,1,6,1,7,3,2005-06-08 20:03:25,2005-06-06 21:27:00
e0f0e891c1742c6ae22dbc648a1000ad8655ff34...5d6ccf5ce7f28e576a87f6c6f4f99fae90e06db6,14,22,22,44,21,2005-06-08 20:04:53,2005-06-03 15:05:39
5d6ccf5ce7f28e576a87f6c6f4f99fae90e06db6...1ae4ee8942903ebb978c0980a34182bc4b60240e,1,7,6,13,1,2005-06-08 20:09:01,2005-06-02 09:55:03
1ae4ee8942903ebb978c0980a34182bc4b60240e...3c65eb184992c2d088f30e0a788e598dab5bba2a,1,20,3,23,1,2005-06-08 20:19:31,2005-06-08 20:19:31
3c65eb184992c2d088f30e0a788e598dab5bba2a...9c065315f70fb1086ef16fc37e72e3edbaf3e919,2,15,3,18,3,2005-06-08 20:33:15,2005-06-08 20:33:15
9c065315f70fb1086ef16fc37e72e3edbaf3e919...7f1d1129628c63f46aebe03afacdb2ab259ef2d6,1,2,1,3,1,2005-06-08 20:44:32,2005-06-08 20:44:32
7f1d1129628c63f46aebe03afacdb2ab259ef2d6...8544a6f1b8e7340924c406d717ac37becd2f6046,1,4,0,4,2,2005-06-08 22:54:45,2005-06-08 21:26:55
8544a6f1b8e7340924c406d717ac37becd2f6046...f225b21807a5f6ac589132e4d004e78038d23375,2,366,12,378,6,2005-06-08 22:56:09,2005-06-08 21:55:35
f225b21807a5f6ac589132e4d004e78038d23375...17ebe977d72290dcdc848b78ae2e65b59d4e1b4c,3,227,259,486,93,2005-06-08 22:59:09,2005-06-08 20:59:43
384f122b7c6dd2b52cc6029afee16560c38850ae...e46f7a0e1c641cd80affd80516677f1e370cd72c,2,25,7,32,7,2007-06-27 05:22:06,2007-06-26 22:48:30
384f122b7c6dd2b52cc6029afee16560c38850ae...9690c118facbdc4539bbc4921a94ac2edee5efd3,2,46,24,70,17,2007-06-27 04:55:55,2007-06-25 19:28:01
9690c118facbdc4539bbc4921a94ac2edee5efd3...30d038e2ffb5d11cd8047c0e88b71f39f379dd6c,1,355,0,355,1,2007-06-27 06:36:40,2007-06-25 19:24:21
30d038e2ffb5d11cd8047c0e88b71f39f379dd6c...ef5a6fb59759006605b36c28cb1e61ec08ac2725,4,686,0,686,1,2007-06-29 03:46:35,2007-06-28 20:09:12
06f59e9f5daa06fc4bd51cf4c508b3edd3ed514a...3dfab993c8c9a30450635e4d660f26bb508ae3af,1,22,14,36,7,2007-07-01 06:36:16,2007-06-30 08:56:13
3dfab993c8c9a30450635e4d660f26bb508ae3af...40cb8f8f08d409b3a2d39aae8c6b99bccd945436,1,4,0,4,3,2007-07-01 06:36:32,2007-06-30 08:56:14
06f59e9f5daa06fc4bd51cf4c508b3edd3ed514a...6caf5b1891bdef234b3a386ed2c40d5b36ebfb7d,1,1,0,1,1,2007-07-01 03:52:41,2007-06-22 09:15:03
06f59e9f5daa06fc4bd51cf4c508b3edd3ed514a...d8c3d03a0b7f10977dd508a5a965a417b7f1b065,4,8,10,18,6,2007-07-01 03:51:31,2007-06-29 05:54:37
d8c3d03a0b7f10977dd508a5a965a417b7f1b065...706098af6b53403b5ea3db9216fb99afbe06f52d,2,17,0,17,2,2007-07-01 03:51:31,2007-06-29 05:56:07
706098af6b53403b5ea3db9216fb99afbe06f52d...af3abef94af9c821a0c192c693c3e5342ab8729f,1,9,12,21,3,2007-07-01 03:51:31,2007-06-29 06:11:40
af3abef94af9c821a0c192c693c3e5342ab8729f...b9905fed7a028cc9749cf8ad479cbb07940c8638,2,44,3,47,6,2007-07-01 03:51:31,2007-06-29 06:14:13
06f59e9f5daa06fc4bd51cf4c508b3edd3ed514a...f2c66ed196d1d1410d014e4ee3e2b585936101f5,3,163,1,164,3,2007-07-01 03:50:51,2007-06-30 05:37:09
f2c66ed196d1d1410d014e4ee3e2b585936101f5...09ccdb630517842e6ad3d9354fbd856174c70d17,2,163,0,163,2,2007-07-01 06:37:00,2007-07-01 05:26:08
09ccdb630517842e6ad3d9354fbd856174c70d17...9488e875862de4e3c9b022ecd9d0845bc28d1996,2,30,31,61,16,2007-07-01 22:29:01,2007-07-01 22:29:01
9488e875862de4e3c9b022ecd9d0845bc28d1996...aaca4914e9074f5f5b51c8966688a75e7fe132d7,1,2,2,4,1,2007-07-02 04:38:05,2007-07-02 04:20:06
aaca4914e9074f5f5b51c8966688a75e7fe132d7...006a86646434e5212defdea59092059fe41387b0,1,1,1,2,1,2007-07-02 04:38:27,2007-07-02 04:20:34
006a86646434e5212defdea59092059fe41387b0...401de4057ac83d473f8bead9b11d00b6371bd6a0,1,5,0,5,2,2007-07-02 04:45:13,2007-07-02 04:21:24
401de4057ac83d473f8bead9b11d00b6371bd6a0...9a5391cf1836fa1b66f3c89ce9b38f8249bb0521,1,4,4,8,3,2007-07-02 06:33:52,2007-07-02 05:24:59
94af7c31a52ba1a26bd663c794e33284acf41a49...32ae83194b0f287a9b6644cdad175c56417c31f3,1,10,0,10,1,2009-06-12 16:20:18,2009-06-12 10:51:37
32ae83194b0f287a9b6644cdad175c56417c31f3...5e9758e2968238906c730c9c77ecc95c21e7495e,2,3,2,5,2,2009-06-12 16:20:21,2009-06-12 10:51:38
5e9758e2968238906c730c9c77ecc95c21e7495e...0fd41f2d66fdb7c8125f341c72f075aca045017f,1,3,2,5,2,2009-06-12 16:20:22,2009-06-12 10:51:39
f57882505efe05990102a0d96b37c09baadae03d...7051c3b1294a110a862a7b48e983490fba32389f,1,1,1,2,1,2007-06-29 04:16:53,2007-06-28 11:12:07
7051c3b1294a110a862a7b48e983490fba32389f...2b9a50208f2664d228b238affd8496d4d9677d56,1,10,12,22,4,2007-06-29 04:18:01,2007-06-27 12:40:41
f57882505efe05990102a0d96b37c09baadae03d...4576518dd7459f44583f33375dbd8799792fc1f3,3,15,7,22,7,2007-06-28 05:22:17,2007-06-07 12:50:29
4576518dd7459f44583f33375dbd8799792fc1f3...279050d04428e9adaa90aebe54a485a334102ab8,1,1,1,2,1,2007-06-28 05:22:17,2007-06-07 12:50:30
3d4e1932f24346d26f15e98dd6a74798035e7870...2be08a84bae10a0c7ecf2ef921896ce838a6ed0b,1,2,2,4,2,2007-03-16 11:34:17,2007-03-16 10:46:09
d6da71a9d16b8cf27f9d8f90692d3625c849cbc8...b9e7efb8b5f7d424466dd1ce61fd20658f60543f,2,44,4,48,8,2007-05-17 22:10:26,2007-05-17 22:01:50
1cc202bd4ebd0390d738f0d633d42791cb79dd05...c69f4050958b648acd668b37dc77772e05148a97,1,0,1,1,1,2007-05-10 02:04:54,2007-05-09 22:13:44
c69f4050958b648acd668b37dc77772e05148a97...c2f599e09fd0496413d1744b5b89b9b5c223555d,1,8,1,9,1,2007-05-10 20:26:14,2007-05-10 00:11:15
c2f599e09fd0496413d1744b5b89b9b5c223555d...e18ee576b1420e7b2cfc5c686872fa3b439ac45f,1,1,1,2,1,2007-05-10 20:26:26,2007-04-30 18:37:57
e18ee576b1420e7b2cfc5c686872fa3b439ac45f...b722b9585518c9d75ec5d8731cb90dc0c9fb918c,1,4,0,4,2,2007-05-10 20:26:26,2007-05-10 20:24:21
da774e82726209cbdb806566e93ff728c83ad7ab...419ca50e4c5afbf6a3f956db5531ed85f2b54bb9,1,0,1,1,1,2007-05-10 21:32:40,2007-05-09 22:13:44
070739fd351702ea9bb4f65595728ae25a488075...b991625611da1cba39c6ac50d0329e5d5ce5d0ab,1,6,1,7,3,2007-05-07 22:29:29,2007-05-07 02:35:04
b991625611da1cba39c6ac50d0329e5d5ce5d0ab...ec0e0f25dce3686fa7ad8fb1783140076983822c,1,180,0,180,1,2007-05-07 22:34:55,2007-05-06 19:50:54
ec0e0f25dce3686fa7ad8fb1783140076983822c...0fc4baebf318d211ad35af447cde7cd814aa57e9,2,3,3,6,2,2007-05-07 22:39:57,2007-05-06 18:09:34
0fc4baebf318d211ad35af447cde7cd814aa57e9...3082acfa7c626a34aa419a163585051c2df2bf09,1,8,6,14,4,2007-05-07 22:45:24,2007-05-07 17:33:24
1401f46bb42d1eb6225a5e08543c06a5b18fd3b7...0c1ec5a1f769021ebe96dfff493c561921dbba52,2,6,0,6,2,2007-04-18 19:39:04,2007-04-18 07:17:33
0c1ec5a1f769021ebe96dfff493c561921dbba52...0afa7644f2f3543a033d327468ab97d7581f9d13,2,34,2,36,2,2007-04-18 22:33:01,2007-04-18 21:58:56
0afa7644f2f3543a033d327468ab97d7581f9d13...0ad64fd0b8d073e0c73836858a54f693c9191918,1,3,1,4,2,2007-04-18 22:41:59,2007-04-18 22:10:22
86da9dec0af55d8212b37337911cd93214b8f00f...2c7801bdd194f33879d32bd109031ee3bf7eb632,1,44,1,45,6,2007-04-18 01:03:00,2007-04-18 01:03:00
fc095242b16d57bad1bfe089f919b9d6e6deda1b...f022f85f6d50b66ac5f4c49830a040627a0d8194,1,2,2,4,2,2007-03-12 19:01:44,2007-03-11 02:39:17
eecc8367f4eaafc8449fc08c4e33f3f8ac474469...b8ac23bcf82e67ccc56b90217c68d7a46b4b2bbc,1,1,1,2,1,2007-03-02 23:11:52,2007-03-02 12:20:10
7f09ac4714214d1dc12877cc98fb69cdee22e33e...061e35c581cb75cb228640a4e40f0d4a5986c11c,1,2,2,4,2,2007-03-12 19:48:37,2007-03-12 19:48:37
5bb44a51038a18f4f940968aed84e6cc26afcebe...62f255ad586a987461c96b1da123da5e2cc3f619,1,14,2,16,3,2007-03-18 22:36:59,2007-03-17 19:42:15
62f255ad586a987461c96b1da123da5e2cc3f619...e5e01619bcb753a3c45fb51d498371c9ff0677da,1,42,1,43,4,2007-03-18 22:36:59,2007-03-17 19:44:06
e5e01619bcb753a3c45fb51d498371c9ff0677da...a0cba10847c85b0becc3c7045a423e3dc8a8f4ae,1,10,4,14,4,2007-03-18 22:36:59,2007-03-18 01:13:57
a0cba10847c85b0becc3c7045a423e3dc8a8f4ae...304de2d2d6afc7500fe9b8f2e22dd0a16a902d8b,3,36,29,65,28,2007-03-18 22:36:59,2007-03-18 03:06:24
c0ce981f5ebfd02463ff697b2fca52c7a54b0625...e15b484f6af581270f2ee03149e4e0d6af053ddf,1,5,5,10,1,2007-03-29 14:06:28,2007-03-27 15:38:59
e15b484f6af581270f2ee03149e4e0d6af053ddf...20fa04ea6bad985d74bd2c0180701f1c69272801,1,12,14,26,12,2007-03-29 16:22:44,2007-03-27 16:12:22
20fa04ea6bad985d74bd2c0180701f1c69272801...ce5b6d752bf4fdc72697ef85b3589983f52d7007,1,5,6,11,2,2007-03-29 16:22:48,2007-03-27 22:00:03
ce5b6d752bf4fdc72697ef85b3589983f52d7007...d1dc6959bbff89496e3ae5d845d73e98ae213e09,1,2,2,4,2,2007-03-29 16:22:50,2007-03-29 10:46:59
d1dc6959bbff89496e3ae5d845d73e98ae213e09...262c981ea720c3c67d01d9a556069f79a6170786,1,5,5,10,5,2007-03-29 16:23:01,2007-03-29 10:55:11
262c981ea720c3c67d01d9a556069f79a6170786...ddc0c49753001d2b5da4df7df2d42378c8c3a295,1,36,42,78,7,2007-03-29 16:29:33,2007-03-29 13:39:59
ddc0c49753001d2b5da4df7df2d42378c8c3a295...b7b36f92fd096d1ff0d4cccd8980c93c3bff4fa8,1,1,1,2,1,2007-03-29 16:29:48,2007-03-29 13:46:31
b7b36f92fd096d1ff0d4cccd8980c93c3bff4fa8...5a174f1a2ee338172d1ca1dab4e30f5968535f2d,1,4,4,8,4,2007-03-29 16:29:52,2007-03-29 13:48:31
5a174f1a2ee338172d1ca1dab4e30f5968535f2d...365cf979c48a52eec65f29a02a973753418396f4,1,14,2,16,4,2007-03-29 16:29:53,2007-03-29 14:03:17
365cf979c48a52eec65f29a02a973753418396f4...1346c9996350e96c7b38a57ede5d503821d84fe3,1,1,1,2,1,2007-03-29 16:29:54,2007-03-29 14:05:02
1346c9996350e96c7b38a57ede5d503821d84fe3...27090aa1eabdc44553a0d8a51ff4ab9543c64c65,1,15,12,27,12,2007-03-30 02:46:16,2007-03-29 15:39:46
c0ce981f5ebfd02463ff697b2fca52c7a54b0625...e4d9516b2196623d927e232b4e8766269a837fe6,1,4,14,18,1,2007-03-27 19:43:39,2007-03-26 18:55:39
e4d9516b2196623d927e232b4e8766269a837fe6...0d315468f38729ebb15711349cece98a467032c9,1,2,1,3,1,2007-03-27 19:43:49,2007-03-26 13:57:23
0d315468f38729ebb15711349cece98a467032c9...8302012097f68caba5be82ba37b191b317886f2b,1,8,0,8,1,2007-03-27 19:48:30,2007-03-27 04:49:57
8302012097f68caba5be82ba37b191b317886f2b...89d589238988bce7a7bf5409561ae094197630e1,1,5,0,5,1,2007-03-27 19:51:13,2007-03-27 19:51:13
89d589238988bce7a7bf5409561ae094197630e1...b704e589f411d51c7240d104d88422aa2d757822,1,20,2,22,4,2007-03-27 19:52:41,2007-03-26 10:16:16
b704e589f411d51c7240d104d88422aa2d757822...e82973cfb046b4298114368e6d194a3418f2a30c,1,2,1,3,1,2007-03-27 19:56:01,2007-03-27 19:55:44
e82973cfb046b4298114368e6d194a3418f2a30c...f73bbb2d0cdbd0153b7a2b7cd5bab72d1b495a45,1,3,3,6,3,2007-03-27 19:58:23,2007-03-27 00:07:11
f73bbb2d0cdbd0153b7a2b7cd5bab72d1b495a45...66d5871ead74ae363274f221c9fa5945c18c4aa2,1,1,1,2,1,2007-03-27 19:58:46,2007-03-27 10:13:42
66d5871ead74ae363274f221c9fa5945c18c4aa2...608d48b2207a6152839a9762c7a66f217bceb440,1,3,1,4,2,2007-03-27 20:00:13,2007-03-27 16:50:20
608d48b2207a6152839a9762c7a66f217bceb440...aa4cfa8516f33ccde36b6cadf3dab2ddefb972af,1,1,1,2,1,2007-03-27 23:57:26,2007-03-27 22:30:19
aa4cfa8516f33ccde36b6cadf3dab2ddefb972af...c6e0caa3846f05831c1d4785ef373820c75eba2b,1,1,11,12,3,2007-03-27 23:57:57,2007-03-27 22:30:08
c6e0caa3846f05831c1d4785ef373820c75eba2b...4621af371686f5c787c172c285562ad997281821,1,1,1,2,1,2007-03-28 00:04:26,2007-03-27 23:26:28
4621af371686f5c787c172c285562ad997281821...465b3518a9ad5080a4b652ef35fb13c61a93e7a4,1,1,0,1,1,2007-03-28 00:05:12,2007-03-27 23:45:06
465b3518a9ad5080a4b652ef35fb13c61a93e7a4...fa21b6023288d5ee0afa79021493a199b1c9bac5,1,108,0,108,1,2007-03-28 01:57:01,2007-03-28 00:08:28
fa21b6023288d5ee0afa79021493a199b1c9bac5...2afea3bcd2a2b3327d7e8bdabc9aebd6bef24c6e,3,14,11,25,8,2007-03-28 11:44:16,2007-03-28 09:46:15
2afea3bcd2a2b3327d7e8bdabc9aebd6bef24c6e...9c880b3ea56a7ff2f66dcf12eb2351f0f51a54ef,1,3,17,20,6,2007-03-28 11:44:23,2007-03-28 09:47:35
9c880b3ea56a7ff2f66dcf12eb2351f0f51a54ef...542e165cdc4fbebbfe7c8954ca1aa1d4162e38cb,2,12,8,20,7,2007-03-28 20:44:04,2007-03-28 20:33:37
542e165cdc4fbebbfe7c8954ca1aa1d4162e38cb...6a5ea2d023906a6e8feea42afa45536db6fd493f,1,2,1,3,1,2007-03-28 21:27:43,2007-03-28 21:09:05
6a5ea2d023906a6e8feea42afa45536db6fd493f...03bcaacaadbb325f412e6dffec27fea6acb9321e,1,42,0,42,1,2007-03-28 21:28:00,2007-03-28 21:08:36
bb95e19c5f1e470d2efe1c0e4e04c291019e4b25...08727ea8bba8c81678e5cf15124ada23ad097bc3,1,2,2,4,1,2007-03-20 08:52:11,2007-03-18 23:16:23
21b4875a51dd9aae68a1c4932d54cad9fc589401...256c3fe6c71bfe5899dec7bc4b49fe148b4d3884,1,1,0,1,1,2007-02-18 23:58:08,2007-02-18 09:36:22
256c3fe6c71bfe5899dec7bc4b49fe148b4d3884...38eb9329babb49e5bed52f4e2a577ac01c8d2fcb,1,6,6,12,6,2007-02-18 23:58:20,2007-02-18 09:36:51
38eb9329babb49e5bed52f4e2a577ac01c8d2fcb...4bc94d289221e16cccbc72f73b3b5b1de0b822c5,3,13,8,21,6,2007-02-19 00:18:43,2007-02-19 00:18:43
69bc0e22d37db4fa9875b717a64949bbfce4ebdf...b758120144f8850bb2db2f233e2c828be4ba4958,1,15,10,25,5,2007-02-18 00:18:14,2007-02-17 23:50:36
d281786fcd6d0df47dd46e415f1a804b2e81ed9b...c07eee1f2ab9e9b168e050c0ef0b48d039c71470,3,41,6,47,5,2006-06-20 08:31:57,2006-06-20 00:59:35
d281786fcd6d0df47dd46e415f1a804b2e81ed9b...1f1e895fccc52a1e227c464c4558d74604301a9f,14,151,131,282,77,2006-06-20 01:45:48,2006-06-20 00:42:35
d281786fcd6d0df47dd46e415f1a804b2e81ed9b...f0b7367cb124a628b80697f5ed095c5859022e21,3,15,0,15,3,2006-06-20 01:44:58,2006-06-20 01:25:21
854b4629f97fb216a91805706cd61b33beb49172...928e47e3d50527adcfef20932f3b2764b9f11f06,2,2,2,4,2,2006-06-20 00:04:27,2006-06-19 22:55:20
c729127ca745d25df1e6bddb265d03166931f49a...75c84ddb468a87006eaaa894cccf1a279a579406,1,222,50,272,7,2006-06-19 20:13:07,2006-06-19 18:27:59
2bda77e080dd8d47ca0b87c78e9061fbaa37455a...1d7f171c3a456b980d821ee0f68e01535a5f7e36,19,72,69,141,63,2006-06-20 08:59:46,2006-06-18 15:18:09
7f29f7a95c906250c9c99d08242c2c4084c48d24...9c3796fc0474ac6fc77da4886a246a37a7fbe856,3,37,4,41,5,2006-06-20 00:30:34,2006-06-19 22:51:58
9c3796fc0474ac6fc77da4886a246a37a7fbe856...5f1a63e0efc750c54a25644a36cf2905495a9b93,2,58,15,73,9,2006-06-20 00:53:13,2006-06-19 23:48:03
f60349aa786d519368938d7b6e5bb2006eccb0cf...8d3cbd27d46bdf42d632de0a2e7f048855941128,1,2,0,2,1,2006-06-23 23:55:15,2006-06-23 15:36:21
8d3cbd27d46bdf42d632de0a2e7f048855941128...cda8ab59bbdb24b4ef87083781dac1f4f1b973a1,1,3,1,4,3,2006-06-23 23:55:51,2006-06-23 13:43:38
f60349aa786d519368938d7b6e5bb2006eccb0cf...1f330269371cc77b7abfcc99c7b15ad7b86f09c9,1,1,1,2,1,2006-06-22 23:20:54,2006-06-22 22:43:47
b1ba39e7e80cdee3e7c1c80334cd9aa87b9b7b69...466e4fdd6696c89700294e1a54fa73e1fb94643b,1,21,10,31,17,2005-08-10 12:50:28,2005-08-10 12:50:28
3c4e8a636f4de3668b24d0020df731cdc78ae6e9...affa40d2f8c5e72af5896cf395ef77d4162908cd,3,3,3,6,3,2005-08-09 05:51:44,2005-08-08 09:53:23
affa40d2f8c5e72af5896cf395ef77d4162908cd...35c3c6298308563a3dd4a5c4bb0870748833643f,1,7,2,9,1,2005-08-09 05:51:44,2005-08-08 20:33:08
35c3c6298308563a3dd4a5c4bb0870748833643f...1cf58e72225f45472124266c020f8595988374d8,1,1,0,1,1,2005-08-09 05:51:45,2005-08-08 18:44:43
1cf58e72225f45472124266c020f8595988374d8...bfc66daf5c0dcb1a507ff2533760ac5505eee6a3,1,12,2,14,5,2005-08-09 05:51:45,2005-08-08 18:45:36
bfc66daf5c0dcb1a507ff2533760ac5505eee6a3...7bf058f0082d17b25b343782e3a33779cc7c956d,1,1,0,1,1,2005-08-09 05:51:46,2005-08-08 18:46:13
7bf058f0082d17b25b343782e3a33779cc7c956d...adee7bdf504120055b0f36b4918bdd3e6156912b,1,4,0,4,1,2005-08-09 05:51:46,2005-08-08 18:46:58
adee7bdf504120055b0f36b4918bdd3e6156912b...c882bc932f6702a935c748893536356b0bba11ce,1,15,5,20,4,2005-08-09 05:51:46,2005-08-09 00:04:42
17ebe977d72290dcdc848b78ae2e65b59d4e1b4c...ec73962d8e17e89ac0c4b21f07cefe16594e07a2,1,29,15,44,11,2005-06-08 23:51:26,2005-06-08 23:38:20
17ebe977d72290dcdc848b78ae2e65b59d4e1b4c...ae3858e7e9146208f1608445975e2761c9b0482e,1,2,1,3,2,2005-06-08 23:35:30,2005-06-08 23:35:30
50a991ec46d57ffc4b7fbd0e8a13182dab3cd5de...3eb9699733355d27fd5442492d66ec3c759e0c8b,1,1,1,2,1,2009-06-18 16:55:34,2009-06-17 13:38:36
50a991ec46d57ffc4b7fbd0e8a13182dab3cd5de...48fb7deb5bbd87933e7d314b73d7c1b52667f80f,8,12,16,28,10,2009-06-18 16:22:46,2009-06-18 00:22:27
50a991ec46d57ffc4b7fbd0e8a13182dab3cd5de...bc2bbc4542a220da5d28c432b6bf78a845a421c0,2,5,10,15,4,2009-06-15 04:14:10,2009-06-14 23:08:56
bc2bbc4542a220da5d28c432b6bf78a845a421c0...6fb37f86bce7cf19b4dbff2aa8a93df5ac5c4cbe,1,12,5,17,2,2009-06-18 16:53:53,2009-06-17 12:49:39
6fb37f86bce7cf19b4dbff2aa8a93df5ac5c4cbe...ef52aafa0f8b1d34f2ecd9b58f2198711c87cab3,1,4,4,8,4,2009-06-18 17:10:30,2009-06-15 02:39:00
b8364903c3e4cde713102e4a36d3926b020b0f70...824af25ace464177820fc69c19fc03ae4fc9e4b1,1,36,2,38,3,2009-06-14 00:08:21,2009-06-13 23:58:42
824af25ace464177820fc69c19fc03ae4fc9e4b1...6e0800ef2575751f2e20d11e2cfe305304e5e9b8,3,16,2,18,5,2009-06-14 00:08:37,2009-06-13 23:58:43
b8364903c3e4cde713102e4a36d3926b020b0f70...d67114a5f3cbbedd4f01e6ff87fd5d4db9563ead,1,11,0,11,1,2009-06-12 16:22:14,2009-06-12 10:51:40
d67114a5f3cbbedd4f01e6ff87fd5d4db9563ead...f74fe34b96816bad1f568202ec51ef18ae7513b3,2,3,2,5,2,2009-06-12 16:22:15,2009-06-12 10:51:41
f74fe34b96816bad1f568202ec51ef18ae7513b3...a1b5b371994beb044053da22ec4a9607630a83a2,1,1,1,2,1,2009-06-12 16:22:17,2009-06-12 10:51:42
3b0d9992ee9849cf12b16662f2b3c272e6792213...36e5e70e0f40cf7ca4351b8159d68f8560a2805f,3,19,2,21,3,2007-07-03 05:39:10,2007-06-30 18:49:17
36e5e70e0f40cf7ca4351b8159d68f8560a2805f...5be60078c935ed08ee8eb5a32680bdfb6bb5bdf3,142,2094,2094,4188,1510,2007-07-03 05:52:14,2007-07-03 05:52:14
5be60078c935ed08ee8eb5a32680bdfb6bb5bdf3...fcb10a964875a987f764af401537689e4aea82c6,2,7,6,13,5,2007-07-03 06:15:45,2007-07-03 06:15:45
fcb10a964875a987f764af401537689e4aea82c6...2ecf3cee0754961401200e9f35071001ccdbbce3,3,6,0,6,3,2007-07-03 06:29:54,2007-07-03 06:29:54
2ecf3cee0754961401200e9f35071001ccdbbce3...14a4091c16d14fd461f576e4bf1395da65e5d95e,2,47,15,62,14,2007-07-04 02:04:38,2007-07-03 19:04:24
14a4091c16d14fd461f576e4bf1395da65e5d95e...843103d69388a5c74ed99753e1c162a66835b04d,1,1,1,2,1,2007-07-04 02:04:49,2007-07-03 08:59:06
843103d69388a5c74ed99753e1c162a66835b04d...c401b33c349beaf4c218c6441c3e2b58a958de6f,3,266,184,450,3,2007-07-04 02:04:49,2007-07-03 23:41:55
c401b33c349beaf4c218c6441c3e2b58a958de6f...72909befaa043fcc975115bb56d25a6e7dc65fb6,2,12,0,12,2,2007-07-04 02:05:55,2007-06-30 17:47:07
72909befaa043fcc975115bb56d25a6e7dc65fb6...e4465f0e71cc389a26bcf7474ad12112f683f633,1,2,2,4,1,2007-07-04 02:08:58,2007-07-04 01:33:11
e4465f0e71cc389a26bcf7474ad12112f683f633...f6b78c6eb626d477b252d39ef2801d4670675a2b,1,35,0,35,1,2007-07-04 04:44:16,2007-07-03 16:50:19
96c48153c9a2905fb2f1d588c11e36272635cb79...a44c4267090366c81303b964ab64f3d51b78f885,1,0,0,0,0,2007-07-01 20:25:55,2007-07-01 03:14:01
a44c4267090366c81303b964ab64f3d51b78f885...20314271679e169f324c118c69c8d9e0399feec9,2,55,1,56,3,2007-07-01 20:26:05,2007-06-29 17:32:46
20314271679e169f324c118c69c8d9e0399feec9...9a3c6f7ba7c567e277da58a45ac6fa50461297e3,1,2,2,4,2,2007-07-01 21:47:20,2007-07-01 15:48:54
2be08a84bae10a0c7ecf2ef921896ce838a6ed0b...6bf035f2780bde45682e0edf40e35a150bd83706,3,30,2,32,3,2007-03-18 21:43:29,2007-03-18 21:40:35
b9e7efb8b5f7d424466dd1ce61fd20658f60543f...306fc124621657234b21dce542496440d53147a6,1,1,1,2,1,2007-05-22 07:22:51,2007-05-22 07:22:51
306fc124621657234b21dce542496440d53147a6...3d5793bf52223ccec40aff2839a3c5bad96bca8b,1,3,6,9,2,2007-05-24 06:33:13,2007-05-24 06:33:13
3d5793bf52223ccec40aff2839a3c5bad96bca8b...ea75ee3598ab6f8d0828f8cc6ec3d4a5f8d66813,2,16,4,20,7,2007-05-27 04:03:37,2007-05-27 04:03:37
2b93bfac0f5bcabbf60f174f4e7bfa9e318e64d5...1dcb3b6478cac3d301349c2df4af2e5ec69dfffe,1,1,1,2,1,2007-05-10 22:21:50,2007-05-10 22:10:36
1dcb3b6478cac3d301349c2df4af2e5ec69dfffe...56822cc9ab9003c80b18201c097e4faa6f0ffbd3,1,3,0,3,1,2007-05-10 22:21:54,2007-05-10 22:09:38
56822cc9ab9003c80b18201c097e4faa6f0ffbd3...843142ada000a992fa87bd2dc7796501332a52d9,2,9,2,11,4,2007-05-10 22:22:02,2007-05-10 21:49:36
4662231e5654924c78fcb4b630fb48c58b945b7f...abda5227770b39bb4abd8f0b4c1a0f69c2778300,1,6,11,17,7,2007-05-09 05:47:09,2007-05-08 02:57:15
abda5227770b39bb4abd8f0b4c1a0f69c2778300...842aaf93238377976111fc801aaacbf8a491db33,4,11,3,14,6,2007-05-09 05:47:17,2007-05-08 13:28:26
842aaf93238377976111fc801aaacbf8a491db33...618e613a706638a7a1fb5c87cd418158c9b2687c,4,4,4,8,4,2007-05-09 05:47:17,2007-05-08 13:28:26
618e613a706638a7a1fb5c87cd418158c9b2687c...467592ea926d105e1cb78b2471b28bf37e8c62c6,2,23,3,26,7,2007-05-09 06:47:35,2007-05-09 06:47:35
a9d9a1bfdddd5f177617abc943fba10f6cc68066...7e9116b1d8adef635ae900af7eff4b320390eeb3,1,1,1,2,1,2007-05-12 16:16:50,2007-05-12 10:35:29
7e9116b1d8adef635ae900af7eff4b320390eeb3...a6e3768f641c2703266422aa05c05f1d01e886b2,1,1,1,2,1,2007-05-12 16:20:51,2007-05-12 11:32:34
a6e3768f641c2703266422aa05c05f1d01e886b2...96f12b54f7b2067d668a1ea578a1fc3773e31148,1,2,2,4,2,2007-05-12 16:36:06,2007-05-11 20:35:22
96f12b54f7b2067d668a1ea578a1fc3773e31148...cbb84e5d174cf33fd4dcf3136de50a886ff9a2e2,1,70,7,77,7,2007-05-12 18:13:08,2007-05-12 17:11:13
cbb84e5d174cf33fd4dcf3136de50a886ff9a2e2...fdc99cbbdcdcf4ee2c336f02b7b2dbcb11696392,2,64,3,67,4,2007-05-12 19:35:54,2007-03-29 08:02:50
3082acfa7c626a34aa419a163585051c2df2bf09...78bc403aaffe4dc7854da118e977685b38bdc5b7,1,11,0,11,1,2007-05-08 01:20:18,2007-05-06 23:10:03
78bc403aaffe4dc7854da118e977685b38bdc5b7...ed224deac9436215f8c0b098baa0aecfcff1c293,2,136,2,138,5,2007-05-08 01:20:18,2007-05-06 23:10:04
ed224deac9436215f8c0b098baa0aecfcff1c293...e72c0eaf9bbdb2a9467f3f026b39b1c1755c1105,1,181,40,221,17,2007-05-08 01:20:19,2007-05-06 23:10:05
e72c0eaf9bbdb2a9467f3f026b39b1c1755c1105...493e01db51ae003255a27dbcc81953fbfdab958a,1,73,66,139,47,2007-05-08 01:20:19,2007-05-06 23:10:06
493e01db51ae003255a27dbcc81953fbfdab958a...fb1dde4a908ddcfaa884f67734a60dc6bd639b59,1,7,5,12,6,2007-05-08 01:20:19,2007-05-06 23:10:07
fb1dde4a908ddcfaa884f67734a60dc6bd639b59...208ecb2e860364aeffb22eb1f644db077b1c5162,1,8,12,20,2,2007-05-08 01:20:19,2007-05-06 23:10:08
3082acfa7c626a34aa419a163585051c2df2bf09...fc3abdf5cb16914fb22747d7c3fb44258712a36d,1,17,5,22,7,2007-05-07 22:54:32,2007-05-03 20:05:48
fc3abdf5cb16914fb22747d7c3fb44258712a36d...6e0b8ed6d35d0ed94b22652d6e8545b610cc43ab,1,4,68,72,7,2007-05-07 22:54:32,2007-05-07 08:14:21
6e0b8ed6d35d0ed94b22652d6e8545b610cc43ab...50b2b53897d6f0331c192f2964542ed62a9911c0,1,1,0,1,1,2007-05-07 22:54:32,2007-05-03 20:04:53
50b2b53897d6f0331c192f2964542ed62a9911c0...a0cb94006ccc6bde6fe89b2a4d8bf7ea84c8b876,1,1,0,1,1,2007-05-07 22:54:32,2007-05-07 08:24:27
5f5dbd719d0d8ec136f32a0a56674902bd85f72f...a42cbacc1133f57de23734e5d52324208606806e,1,1,1,2,1,2007-05-08 03:53:06,2007-05-08 03:53:06
0ad64fd0b8d073e0c73836858a54f693c9191918...9f1beb7140584b3eb803cc9a69cbced528209f6e,1,1,1,2,1,2007-04-19 00:57:25,2007-04-18 23:51:21
9f1beb7140584b3eb803cc9a69cbced528209f6e...6e6db39afc305e1205a4d2dcf34680bfa80bfc24,2,2,2,4,2,2007-04-19 02:26:33,2007-04-19 02:08:15
745654f82a3ea02b15c59991d4461090a00b5645...8c67c392e1620fc3b749aa9e0b8da13bd84226f8,4,26,3,29,5,2010-08-19 23:03:18,2010-08-19 23:03:18
b8ac23bcf82e67ccc56b90217c68d7a46b4b2bbc...81035bba0a15f9c8c28016c131dda864b70774f3,1,1,1,2,1,2007-03-03 20:11:22,2007-03-03 17:28:14
81035bba0a15f9c8c28016c131dda864b70774f3...64edf4b2eb19e5b94eda60c0e21d85e45602a8f1,2,1,3,4,2,2007-03-03 20:26:50,2007-03-03 16:14:25
64edf4b2eb19e5b94eda60c0e21d85e45602a8f1...7d79c860a6e2a8ceee10039153b47f0a8580607d,1,1,1,2,1,2007-03-03 21:04:54,2007-03-03 21:04:54
7d79c860a6e2a8ceee10039153b47f0a8580607d...78cb59c8e5b5ac6ab709b8544698e13511759a76,1,5,0,5,1,2007-03-04 01:45:48,2007-03-03 23:17:23
78cb59c8e5b5ac6ab709b8544698e13511759a76...ee96d11bebcbb4826f9b59b5dca64e2b8a204bc0,1,2,0,2,2,2007-03-04 02:43:25,2007-03-03 18:28:46
ee96d11bebcbb4826f9b59b5dca64e2b8a204bc0...41b200179dfac7bf4c3b98270951937b537e2b24,1,6,0,6,2,2007-03-04 02:55:04,2007-03-03 18:28:52
41b200179dfac7bf4c3b98270951937b537e2b24...2832114532d92bdd533f84fa520050c5de95c012,1,6,4,10,5,2007-03-04 02:55:10,2007-03-03 18:28:57
2832114532d92bdd533f84fa520050c5de95c012...fd547a972ad1ad714e1dac0a9ffc7637a64dd9b2,2,15,2,17,5,2007-03-04 02:55:17,2007-03-03 18:29:03
fd547a972ad1ad714e1dac0a9ffc7637a64dd9b2...7943b3a94f0f862dc9d7dcec6b5639ae5bf027bd,1,0,1,1,1,2007-03-04 03:35:17,2007-03-03 18:28:39
5bcbc7ff1014c58e7296713926206bf6a69e0f4c...8ff21b1a3307c7059ea1e00b5117a50a2bc5fec8,3,12,5,17,5,2007-04-10 01:51:40,2007-04-09 15:12:53
18acb3e6c76b42d109cac956d63a1c709b0d76b2...6f01e6b37008e45efb2b17a027f045600a011e93,1,9,7,16,2,2007-03-30 06:10:21,2007-03-29 07:42:35
6f01e6b37008e45efb2b17a027f045600a011e93...b275a0c9e742e4bbfed9794b1e477000440eaf6a,1,1,1,2,1,2007-03-30 06:11:33,2007-03-29 21:38:20
0a98f9d13802880a68ce6564b9f47b1c3e3341c7...43a8e4fe8e3c92fc15ae16b818d44241568d484e,1,3,1,4,1,2007-03-28 22:40:17,2007-03-28 22:40:17
43a8e4fe8e3c92fc15ae16b818d44241568d484e...7685227e973fce34340d3766b1775263751afa56,1,1,1,2,1,2007-03-28 22:58:09,2007-03-28 22:58:09
08727ea8bba8c81678e5cf15124ada23ad097bc3...8685da42561d16bb01aeaa1a2392459965187925,2,27,4,31,6,2007-03-21 05:08:25,2007-03-20 19:32:35
8685da42561d16bb01aeaa1a2392459965187925...ce9fbf16e0000ecca92870a90e4b30afcb3917b7,3,4,23,27,4,2007-03-21 05:09:57,2007-03-20 20:02:09
ce9fbf16e0000ecca92870a90e4b30afcb3917b7...9096c660a85c4a3d30f8885c766c34ce0766e869,1,9,9,18,7,2007-03-21 05:09:59,2007-03-20 21:07:48
9096c660a85c4a3d30f8885c766c34ce0766e869...acdeec62cb644e48436bbe931e69b3d4842344cb,1,4,2,6,1,2007-03-21 05:17:17,2007-03-20 17:05:20
acdeec62cb644e48436bbe931e69b3d4842344cb...ac54c277f05c65f441efdc1b9cd7a04aaa6cf75a,1,9,4,13,2,2007-03-21 05:17:32,2007-03-20 18:38:34
ac54c277f05c65f441efdc1b9cd7a04aaa6cf75a...57216856999babf6f90235cf6c41dfcef98a3dab,1,6,1,7,2,2007-03-21 05:17:44,2007-03-21 02:26:47
57216856999babf6f90235cf6c41dfcef98a3dab...3254d218b4f9ef1550d1d83670fad8f455b08578,1,4,4,8,2,2007-03-21 05:17:47,2007-03-21 03:32:13
3254d218b4f9ef1550d1d83670fad8f455b08578...171dccd511bb4642e4491dc5115549b67a859a5b,1,13,13,26,12,2007-03-21 06:37:51,2007-03-21 06:37:51
171dccd511bb4642e4491dc5115549b67a859a5b...a8c40471ab0851bf9a58f7dc76f121258e0690e2,6,14,15,29,13,2007-03-21 17:21:56,2007-03-21 17:07:46
a8c40471ab0851bf9a58f7dc76f121258e0690e2...6fda5e5180c2e7c130978361aea53b4e66f36823,15,60,62,122,50,2007-03-21 17:21:57,2007-03-21 17:08:25
6fda5e5180c2e7c130978361aea53b4e66f36823...4651ece8540a90a42af355e995847fb89192cc81,2,57,62,119,10,2007-03-21 18:15:26,2007-03-21 17:09:56
4651ece8540a90a42af355e995847fb89192cc81...7d2f667b12334cea68087eb7da717efd7b3d80f6,1,35,6,41,6,2007-03-22 07:29:49,2007-03-21 16:51:47
7d2f667b12334cea68087eb7da717efd7b3d80f6...ccc744abbb27d3766175aee971991bc0f1fd4f00,1,37,23,60,4,2007-03-22 07:34:39,2007-03-21 19:34:46
ccc744abbb27d3766175aee971991bc0f1fd4f00...1d848f643cd8ba86044d729d08d6866425c1539e,1,28,5,33,6,2007-03-22 07:36:00,2007-03-22 00:00:27
08727ea8bba8c81678e5cf15124ada23ad097bc3...8bf0e3d15d3d327ae16d8eaa56374492d03a7b88,1,15,1,16,3,2007-03-20 08:54:49,2007-03-18 20:34:46
4bc94d289221e16cccbc72f73b3b5b1de0b822c5...f496454e0fd22d003e9c9b5c3742b12d526bc0a4,2,3,3,6,3,2007-02-20 02:14:29,2007-02-19 12:35:35
f496454e0fd22d003e9c9b5c3742b12d526bc0a4...bc6b4f52fc79712db637ff90a472b82b32695e11,3,28,0,28,6,2007-02-20 02:20:30,2007-02-20 00:22:56
bc6b4f52fc79712db637ff90a472b82b32695e11...e326bce65c2a8b10f40c1869e13c7450a243b109,1,23,14,37,10,2007-02-20 02:20:49,2007-02-20 00:27:09
f5a92647694f18fb3544060a1a964ac082d072b2...d516c2d11945cf13ed3d961fa63817c60b7a566b,8,227,64,291,17,2007-02-23 04:59:55,2007-02-22 20:50:10
c07eee1f2ab9e9b168e050c0ef0b48d039c71470...5b276ee4fb01a5c3cf4970df69d319a3c93c81c9,1,34,24,58,6,2006-06-21 05:19:29,2006-06-20 14:38:13
5b276ee4fb01a5c3cf4970df69d319a3c93c81c9...4170af82328e50a75723cee084ae779e7a882b9d,1,1,2,3,1,2006-06-21 05:21:11,2006-06-20 09:47:14
75c84ddb468a87006eaaa894cccf1a279a579406...7b6511a13f9913a7a54e76b18e21c2b2bfae18cf,1,2,2,4,2,2006-06-20 04:16:09,2006-06-20 04:11:32
5f1a63e0efc750c54a25644a36cf2905495a9b93...92a28be0ce12a50e0e53268be99130c2ef504c7e,1,0,2,2,1,2006-06-20 08:21:51,2006-06-20 07:45:53
92a28be0ce12a50e0e53268be99130c2ef504c7e...e33d0611c0dd438ed9c1960518540c707201707a,1,1,1,2,1,2006-06-20 08:21:53,2006-06-20 07:51:09
cda8ab59bbdb24b4ef87083781dac1f4f1b973a1...5e7c91d6f744dbf9a18152d2d49057aa3dd06160,1,1,1,2,1,2006-06-24 05:49:41,2006-06-23 21:45:40
5e7c91d6f744dbf9a18152d2d49057aa3dd06160...39a3f5ea7c0352a530338d30d4e618f6b4db84e4,2,46,4,50,6,2006-06-24 07:12:52,2006-06-24 02:34:38
39a3f5ea7c0352a530338d30d4e618f6b4db84e4...ce88ac5b129dd562a1062522039366ebbf1157e1,1,3,3,6,3,2006-06-24 07:12:52,2006-06-24 05:44:33
cda8ab59bbdb24b4ef87083781dac1f4f1b973a1...0d21efa51cc7de5250d5da46bceacda78ba35373,9,81,20,101,26,2006-06-24 00:35:27,2006-06-14 15:40:23
bc1f262d67cbe1c736c5dca911f6f085f47ac9bb...86378b32895ee5d788491b8407608a54e5cf064c,1,1,1,2,1,2006-06-24 08:10:27,2006-06-24 08:10:27
466e4fdd6696c89700294e1a54fa73e1fb94643b...b664550c066810b770ad3e19cafe2fbdd42c6793,1,25,22,47,10,2005-08-10 23:56:23,2005-08-10 23:56:23
f10e0e0b18c8e2e69535e7380fb3c1f9b097cfda...96ad15ae2ff6416cf04c4c75a11783632cdc8fb4,1,1,1,2,1,2005-08-10 05:28:18,2005-08-09 20:54:40
96ad15ae2ff6416cf04c4c75a11783632cdc8fb4...4ec99bf080f2d95c7c3d706f65eea1c6b9302f23,9,21,16,37,14,2005-08-10 05:28:19,2005-08-09 15:30:22
4ec99bf080f2d95c7c3d706f65eea1c6b9302f23...79db12e8ba74827724873beff2caeb6b85e0c6a9,2,6,5,11,4,2005-08-10 05:28:19,2005-08-10 04:25:46
79db12e8ba74827724873beff2caeb6b85e0c6a9...763e287a3525ca36fb5b75d91a825833fb11d43a,1,1,1,2,1,2005-08-10 05:28:20,2005-08-10 05:21:51
763e287a3525ca36fb5b75d91a825833fb11d43a...4852f7232b7a83fbd1b745520181bd67bf95911b,2,16,3,19,3,2005-08-10 05:28:20,2005-08-03 15:15:42
4852f7232b7a83fbd1b745520181bd67bf95911b...76cd8eb619cf2896b5171d46d6bbf8e97d19e728,1,11,1,12,5,2005-08-10 05:28:21,2005-08-08 09:37:21
76cd8eb619cf2896b5171d46d6bbf8e97d19e728...5ccfb758b0e69b77b0ad830cc35d7770b08589eb,1,3,0,3,1,2005-08-10 05:28:21,2005-08-09 02:31:37
5ccfb758b0e69b77b0ad830cc35d7770b08589eb...0c091296c001836e408b8c98de1548d6c7ada67d,3,107,24,131,16,2005-08-10 05:28:22,2005-08-09 00:03:14
0c091296c001836e408b8c98de1548d6c7ada67d...62033318abbe648e8be49121b0a3570c07d38a9d,2,65,8,73,4,2005-08-10 05:28:23,2005-08-09 00:39:18
62033318abbe648e8be49121b0a3570c07d38a9d...d87449c553262a24df26648633c7c73b2db7dcc6,3,36,9,45,10,2005-08-10 05:28:23,2005-08-09 05:15:40
d87449c553262a24df26648633c7c73b2db7dcc6...045f82cbee3135a3d75256828b0cf101eedf38c8,2,38,0,38,2,2005-08-10 06:38:49,2005-08-10 05:30:17
045f82cbee3135a3d75256828b0cf101eedf38c8...32173e69881a35e4e7a53be3ba80091ae9fa8f35,1,7,1,8,1,2005-08-10 06:38:49,2005-08-07 03:59:47
32173e69881a35e4e7a53be3ba80091ae9fa8f35...4282c4fbddfeae3383c6c327e2ca98b25500ea31,3,47,22,69,17,2005-08-10 06:38:50,2005-08-07 22:51:09
4282c4fbddfeae3383c6c327e2ca98b25500ea31...972b6fe746f0d9a3ea13118d80d9371a9ff68dba,2,87,27,114,9,2005-08-10 06:38:51,2005-08-08 08:20:03
972b6fe746f0d9a3ea13118d80d9371a9ff68dba...46b1c7c03c3ae3bf17aa87bf9ae2f9fb38d08789,1,62,1,63,1,2005-08-10 06:38:51,2005-08-08 05:55:45
46b1c7c03c3ae3bf17aa87bf9ae2f9fb38d08789...185612b8d3562c82975b017c0c6e1d47dd302897,1,7,1,8,3,2005-08-10 07:00:22,2005-08-10 06:58:35
185612b8d3562c82975b017c0c6e1d47dd302897...c35a7b8d806317dc1762e36561cbd31c2530dd9c,1,2,1,3,1,2005-08-10 07:06:56,2005-08-10 07:06:16
c882bc932f6702a935c748893536356b0bba11ce...93b5fcdd8ddaa7f55ce1a43d8b9eaed1d5febc98,1,1,1,2,1,2005-08-09 17:16:12,2005-08-09 17:16:12
566487c8a617c12d68bf22c7078bce0b94fc8121...e0226add28e53a35ce91cdbebb1919519f02b291,1,18,7,25,7,2005-06-09 00:36:47,2005-06-09 00:36:47
e0226add28e53a35ce91cdbebb1919519f02b291...98a96b00b88ee35866cd0b1e94697db76bd5ddf9,1,15,42,57,11,2005-06-09 00:56:09,2005-06-09 00:56:09
98a96b00b88ee35866cd0b1e94697db76bd5ddf9...438195ccedce7270cf5ba167a940c90467cb72d7,1,38,9,47,5,2005-06-09 19:51:01,2005-06-09 19:51:01
438195ccedce7270cf5ba167a940c90467cb72d7...22f77b772dd16e6b63ff7c0359fd37e7d14cc04d,2,114,1,115,3,2005-06-09 22:30:21,2005-06-09 22:13:13
22f77b772dd16e6b63ff7c0359fd37e7d14cc04d...aa16021efcd969a44b480d0964e07d52167517db,2,20,6,26,7,2005-06-09 22:34:04,2005-06-09 22:34:04
aa16021efcd969a44b480d0964e07d52167517db...025a0709b6179506ffc0d35967bdd4fb804d30fb,1,6,2,8,2,2005-06-10 14:42:45,2005-06-10 08:32:37
025a0709b6179506ffc0d35967bdd4fb804d30fb...206de27efac383cecc3d0f938e220dc359be36c1,1,1,1,2,1,2005-06-12 16:37:49,2005-06-12 16:37:49
206de27efac383cecc3d0f938e220dc359be36c1...dc7090efbc8280e482a6b2dc7419e525cbc3c5d7,2,2,1,3,2,2005-06-13 03:29:31,2005-06-13 00:23:15
dc7090efbc8280e482a6b2dc7419e525cbc3c5d7...a8db165ee90c7a460916c3efbf97750dd019872c,1,19,1,20,2,2005-06-13 03:29:31,2005-06-13 00:44:21
a8db165ee90c7a460916c3efbf97750dd019872c...ba88e54b1a39aa700cc2f8da402e6167d124329d,1,1,0,1,1,2005-06-13 03:34:09,2005-06-13 03:34:09
ba88e54b1a39aa700cc2f8da402e6167d124329d...a7fa68c5f942706fce5636b9136d1b229e089190,1,1,1,2,1,2005-06-13 03:35:04,2005-06-13 03:35:04
a7fa68c5f942706fce5636b9136d1b229e089190...2210100ac00b8a46f1d94c044391bfa50b25afa4,2,9,2,11,2,2005-06-13 03:40:19,2005-06-12 03:55:20
2210100ac00b8a46f1d94c044391bfa50b25afa4...d327b89a224e6d8db37ad97be1f8c0a54e380a29,1,0,7,7,1,2005-06-13 03:40:19,2005-06-03 19:11:07
d327b89a224e6d8db37ad97be1f8c0a54e380a29...a7ca65405c364e674cf4359b07ae959d4ece01ab,1,10,3,13,6,2005-06-13 03:40:20,2005-06-11 01:31:02
a7ca65405c364e674cf4359b07ae959d4ece01ab...f2ce9fde57513af026e0641073a6781a086251d5,7,108,21,129,24,2005-06-13 03:40:20,2005-06-12 03:57:13
f2ce9fde57513af026e0641073a6781a086251d5...76bc82ca0ed4a0af85b7d741c04c8191738e8395,1,42,35,77,35,2005-06-13 03:40:20,2005-06-11 01:34:34
76bc82ca0ed4a0af85b7d741c04c8191738e8395...03efa6d9a4c974c502dbad457749ad316aac9cc6,2,393,4,397,9,2005-06-13 03:40:20,2005-06-11 01:36:08
03efa6d9a4c974c502dbad457749ad316aac9cc6...e7f9bc411c8519468c33e1d882fb02cbe9c1ea55,3,31,15,46,12,2005-06-13 03:40:20,2005-06-11 01:37:47
e7f9bc411c8519468c33e1d882fb02cbe9c1ea55...32192e6622d78347448cfc0572827d6e64e0de28,3,168,21,189,22,2005-06-13 03:40:20,2005-06-11 09:50:51
32192e6622d78347448cfc0572827d6e64e0de28...036d51cc557bcf919246ad30cb2ac7736bfc836b,2,15,0,15,2,2005-06-13 03:40:20,2005-06-11 09:53:57
036d51cc557bcf919246ad30cb2ac7736bfc836b...9939664a0bbd58373095cfb534c6f0191be656a6,1,40,35,75,3,2005-06-13 03:40:20,2005-06-11 01:44:36
9939664a0bbd58373095cfb534c6f0191be656a6...667628d97a5baf18ffa0c701cab6d00e7d812741,1,1,1,2,1,2005-06-13 03:48:18,2005-06-10 06:22:06
667628d97a5baf18ffa0c701cab6d00e7d812741...861cb6f02c91b66cdec572dd443ae947e795824a,1,3,1,4,1,2005-06-13 03:48:18,2005-06-10 06:27:47
861cb6f02c91b66cdec572dd443ae947e795824a...1cc92ff6cab993c119a5d125a04a5a4e9cc4b09e,1,7,5,12,4,2005-06-13 03:48:18,2005-06-10 06:33:44
1cc92ff6cab993c119a5d125a04a5a4e9cc4b09e...9718a00b90b35fd077dbe2216915f1afcf0bb361,1,19,8,27,5,2005-06-13 03:48:18,2005-06-10 06:38:32
9718a00b90b35fd077dbe2216915f1afcf0bb361...84fb9a4dca7efe1427c917e2f46a045e48180826,1,1,1,2,1,2005-06-13 04:04:27,2005-06-13 04:04:27
84fb9a4dca7efe1427c917e2f46a045e48180826...178cb243387a24b1dec7613c4c5e97158163ac60,2,72,1,73,3,2005-06-13 17:06:50,2005-06-13 17:06:50
178cb243387a24b1dec7613c4c5e97158163ac60...f04b05697c140953c1c50bb2794c41f26ba689b9,1,1,1,2,1,2005-06-13 17:07:25,2005-06-13 17:07:25
f04b05697c140953c1c50bb2794c41f26ba689b9...8ebb0184028d3dcdbc659920523338dd53770b03,1,25,2,27,8,2005-06-13 17:21:11,2005-06-13 17:21:11
8ebb0184028d3dcdbc659920523338dd53770b03...d6cb5e5f99b5fe4a83f452923622e50f268d68b1,1,3,1,4,1,2005-06-13 17:22:39,2005-06-13 17:22:39
d6cb5e5f99b5fe4a83f452923622e50f268d68b1...921d865ea24ffea6452f9b24302e651a347d7905,1,31,2,33,2,2005-06-13 18:14:20,2005-06-13 18:14:20
921d865ea24ffea6452f9b24302e651a347d7905...940c1bb0181cb20454bf3573134175f86983a0ce,2,17,1,18,2,2005-06-13 22:09:34,2005-06-13 22:09:34
940c1bb0181cb20454bf3573134175f86983a0ce...de4971b50076b5ef901c2ae0bbee9dd2c14f06ea,1,1,0,1,1,2005-06-14 03:41:38,2005-06-14 03:41:38
de4971b50076b5ef901c2ae0bbee9dd2c14f06ea...96069cf03aca672e93d862813f2e7f05c1c7ac72,1,31,12,43,2,2005-06-14 17:20:14,2005-06-14 17:20:14
96069cf03aca672e93d862813f2e7f05c1c7ac72...fc865468d88d45e76e21a9db2445a4b970f7423b,1,17,2,19,2,2005-06-14 18:01:49,2005-06-14 18:01:49
fc865468d88d45e76e21a9db2445a4b970f7423b...7737314de711aa3a2e4201355777cd41fb791c98,1,3,2,5,1,2005-06-14 19:08:06,2005-06-14 17:09:39
7737314de711aa3a2e4201355777cd41fb791c98...479346adc5ebb099121063d4c06da30093ed9b3b,1,4,3,7,3,2005-06-14 19:09:34,2005-06-14 10:37:38
479346adc5ebb099121063d4c06da30093ed9b3b...40d8cfe4117564e5520e8f4f953addaa94844476,6,10,4,14,6,2005-06-15 01:56:05,2005-06-15 01:56:05
40d8cfe4117564e5520e8f4f953addaa94844476...ce30a4b68ac220a2322dfe2a182194910143fafd,1,19,7,26,4,2005-06-15 02:00:00,2005-06-15 02:00:00
ce30a4b68ac220a2322dfe2a182194910143fafd...7875b50d1a9928e683299b283bfe94778b6c344e,1,1,0,1,1,2005-06-15 17:25:46,2005-06-15 17:25:46
7875b50d1a9928e683299b283bfe94778b6c344e...c538d2d34ab1eafb197921a02f786d687c8754f2,1,64,0,64,1,2005-06-17 18:30:04,2005-06-17 18:30:04
c538d2d34ab1eafb197921a02f786d687c8754f2...aeac6681250440bc9801d6d6cc293cc708895b46,1,3,3,6,3,2005-06-17 19:46:38,2005-06-17 19:46:38
aeac6681250440bc9801d6d6cc293cc708895b46...b7e8039a6f4a250bc0b9c9ca2d75b60368058413,1,5,2,7,1,2005-06-17 22:23:40,2005-06-17 22:23:40
b7e8039a6f4a250bc0b9c9ca2d75b60368058413...753fd78458b6d7d0e65ce0ebe7b62e1bc55f3992,2,4,4,8,4,2005-06-17 22:34:19,2005-06-17 22:34:19
753fd78458b6d7d0e65ce0ebe7b62e1bc55f3992...8b3a1e056f2107deedfdada86046971c9ad7bb87,1,80,0,80,5,2005-06-18 05:54:50,2005-06-18 05:54:50
8b3a1e056f2107deedfdada86046971c9ad7bb87...28342a5d328fa11829dbe883837e21e08dd83388,1,24,0,24,3,2005-06-18 20:52:05,2005-06-18 20:52:05
28342a5d328fa11829dbe883837e21e08dd83388...deb153a75ae1f5eca628a38b911474a69edd242d,1,4,1,5,1,2005-06-18 22:38:23,2005-06-18 22:31:15
deb153a75ae1f5eca628a38b911474a69edd242d...3d958064e0f26f3cbd5b201f295c182b6aa119da,1,1,1,2,1,2005-06-19 03:02:49,2005-06-19 03:02:49
3d958064e0f26f3cbd5b201f295c182b6aa119da...12676608fefd6b148bd9fd4cbd4eb6c2ff3e15e9,1,88,89,177,15,2005-06-19 03:21:34,2005-06-19 03:21:34
12676608fefd6b148bd9fd4cbd4eb6c2ff3e15e9...2160a025d2a20202e323d33d879521d23e28b709,1,0,1,1,1,2005-06-19 06:34:12,2005-06-19 06:34:12
2160a025d2a20202e323d33d879521d23e28b709...1c107dc422498085493a5cccbac50096284ebe94,2,3,3,6,3,2005-06-19 06:44:54,2005-06-19 06:44:54
1c107dc422498085493a5cccbac50096284ebe94...b389237ae8cd04c2f53db52e37c02e30c63bcc89,1,16,2,18,4,2005-06-19 17:40:10,2005-06-19 17:40:10
b389237ae8cd04c2f53db52e37c02e30c63bcc89...44ab20cd884dcb3d2ef4cfbda4591dd2cd9bee79,1,1,0,1,1,2005-06-19 17:48:41,2005-06-17 08:13:18
44ab20cd884dcb3d2ef4cfbda4591dd2cd9bee79...31b6d200d6c5ed019f62d88ef0926faeb0150aac,1,18,6,24,4,2005-06-19 17:48:41,2005-06-17 16:26:57
31b6d200d6c5ed019f62d88ef0926faeb0150aac...55a716cc8c93fd2eb161ae17f316ee01e8061be6,1,3,1,4,3,2005-06-20 02:42:21,2005-06-20 02:42:21
55a716cc8c93fd2eb161ae17f316ee01e8061be6...170241b7d1437e082c13a6f6b812eb827a7d48e0,1,9,5,14,2,2005-06-20 02:57:01,2005-06-20 02:57:01
170241b7d1437e082c13a6f6b812eb827a7d48e0...4727f640036fbdad414bdcbe31d08f6a8fd70923,8,37,18,55,24,2005-06-20 03:13:18,2005-06-19 20:14:05
4727f640036fbdad414bdcbe31d08f6a8fd70923...232b75ab3d60475b19270be022a966772c25c84b,7,130,15,145,13,2005-06-20 03:13:18,2005-06-19 20:14:53
232b75ab3d60475b19270be022a966772c25c84b...366175ef8c3b1e145f4ba846e63a1dea3ec3cacc,4,186,95,281,40,2005-06-20 03:13:18,2005-06-19 20:17:50
366175ef8c3b1e145f4ba846e63a1dea3ec3cacc...dec5eda7860f6d8babf3fa14c00bc5e1d4e06b4f,1,375,61,436,16,2005-06-20 03:13:18,2005-06-20 02:29:26
dec5eda7860f6d8babf3fa14c00bc5e1d4e06b4f...8cd1033e10b3d51d19676902bf522be15eb95751,1,2,0,2,1,2005-06-20 03:13:18,2005-06-20 02:29:29
8cd1033e10b3d51d19676902bf522be15eb95751...d6bd56a0e2d710d17c9dc61cfc7fea1b8e3f4629,1,3,1,4,1,2005-06-20 03:13:18,2005-06-20 02:29:31
d6bd56a0e2d710d17c9dc61cfc7fea1b8e3f4629...c3c1163137b0b1bbe1edf9da0421832e452c7a10,1,6,10,16,2,2005-06-20 03:13:18,2005-06-20 02:29:33
c3c1163137b0b1bbe1edf9da0421832e452c7a10...eff19d5eccd02341a25f1543ff89fa7351163e3f,1,21,14,35,1,2005-06-20 03:13:18,2005-06-20 02:29:36
eff19d5eccd02341a25f1543ff89fa7351163e3f...51b1e1713b1ed8e962e994cd0850ea439ad8c3de,2,10,8,18,6,2005-06-20 03:13:18,2005-06-20 02:29:38
51b1e1713b1ed8e962e994cd0850ea439ad8c3de...5e749e259b39a74b31f6c768588b4e628e3802cb,1,11,2,13,3,2005-06-20 03:13:18,2005-06-20 02:29:41
5e749e259b39a74b31f6c768588b4e628e3802cb...fc4263ce4b6a613622dbe985a8e6aca015789cf1,1,1,1,2,1,2005-06-20 03:15:22,2005-06-20 03:15:22
fc4263ce4b6a613622dbe985a8e6aca015789cf1...800644c5cb3aad99a229a09112f42fa88b63c1c4,1,14,14,28,2,2005-06-20 15:29:13,2005-06-20 15:29:13
800644c5cb3aad99a229a09112f42fa88b63c1c4...c591412cc0aaf10890cdda4cf97a4fbc782d7d49,1,15,9,24,8,2005-06-20 22:49:39,2005-06-20 18:52:38
c591412cc0aaf10890cdda4cf97a4fbc782d7d49...9d73fad4ca15bc0fffe34ee66aea5b9691ab3d2f,1,4,1,5,2,2005-06-20 23:14:13,2005-06-20 23:14:13
9d73fad4ca15bc0fffe34ee66aea5b9691ab3d2f...6c88be169881c9223532796bd225e79afaa115e1,1,3,1,4,3,2005-06-21 03:26:03,2005-06-21 03:26:03
6c88be169881c9223532796bd225e79afaa115e1...a8be83fe00eded0bd6cb0001879ddf211a2cf2f2,1,57,4,61,6,2005-06-21 03:28:09,2005-06-21 03:28:09
a8be83fe00eded0bd6cb0001879ddf211a2cf2f2...218e441daf24b9c3be0f5ec423ace5185389ca61,1,5,5,10,5,2005-06-21 04:06:47,2005-06-21 04:06:47
218e441daf24b9c3be0f5ec423ace5185389ca61...0ed3715ffc97325a625e1e4ef44121d870b98679,1,11,5,16,3,2005-06-21 04:18:54,2005-06-21 04:18:54
0ed3715ffc97325a625e1e4ef44121d870b98679...0795495388d703dc84110a9a7917dd6ec9516bb4,1,1,0,1,1,2005-06-21 04:20:41,2005-06-21 04:20:41
0795495388d703dc84110a9a7917dd6ec9516bb4...69f956e10484f92f9e0ab191b668c79d697b9f0f,1,5,3,8,1,2005-06-21 15:41:56,2005-06-21 15:14:30
69f956e10484f92f9e0ab191b668c79d697b9f0f...83ba99bc8c2cdbaa9a0b4ec286e72c3ecb31bf8a,1,32,18,50,6,2005-06-21 15:58:56,2005-06-21 14:18:00
83ba99bc8c2cdbaa9a0b4ec286e72c3ecb31bf8a...303e5f4c325d008c68e5e70e901ab68b289ade2e,2,31,1,32,2,2005-06-21 16:47:37,2005-06-21 16:47:37
303e5f4c325d008c68e5e70e901ab68b289ade2e...a79944d76cf4098e42d13e5743a3dccb61ebaca6,1,9,6,15,5,2005-06-21 16:59:26,2005-06-21 16:59:26
a79944d76cf4098e42d13e5743a3dccb61ebaca6...e8b11749f031428f743c1e01a6934f6ff34cec16,1,23,16,39,6,2005-06-21 18:03:11,2005-06-21 18:03:11
e8b11749f031428f743c1e01a6934f6ff34cec16...dc14841102bb364c2be200e8456146fc8df970b9,1,1,1,2,1,2005-06-21 18:14:47,2005-06-21 18:14:47
dc14841102bb364c2be200e8456146fc8df970b9...d565b3412a0242e2c729bd77d18c74ecd57184dc,5,12,12,24,10,2005-06-21 20:30:55,2005-06-21 20:04:33
d565b3412a0242e2c729bd77d18c74ecd57184dc...6b38a402e97274037982a5346ca4168cc8ee026c,3,5,5,10,5,2005-06-21 21:04:13,2005-06-21 21:04:13
6b38a402e97274037982a5346ca4168cc8ee026c...ef0bfa25e99627b809c0902d21072821955db3fe,2,14,1,15,3,2005-06-21 22:40:00,2005-06-21 22:40:00
ef0bfa25e99627b809c0902d21072821955db3fe...9661c256400d1a17a27e014592f887359f74707e,1,1,1,2,1,2005-06-22 00:12:38,2005-06-22 00:12:38
9661c256400d1a17a27e014592f887359f74707e...89e4202f9828c18f5db4db80a008a2a8a458855e,3,27,4,31,7,2005-06-22 01:29:12,2005-06-22 00:35:10
89e4202f9828c18f5db4db80a008a2a8a458855e...3173bd49690b02c756e32d2c9c3ed13e451806d2,1,34,1,35,4,2005-06-22 01:29:13,2005-06-22 00:35:53
3173bd49690b02c756e32d2c9c3ed13e451806d2...fa3e0655a45f53bbc1b48edc8f931426b183cba1,1,47,2,49,4,2005-06-22 01:29:13,2005-06-22 00:45:49
fa3e0655a45f53bbc1b48edc8f931426b183cba1...5c8af185cc547b1babdd6292b1c77bec1941922f,1,47,2,49,3,2005-06-22 02:10:21,2005-06-22 02:10:21
5c8af185cc547b1babdd6292b1c77bec1941922f...f5ab6ccae3063725e0a6bfacffaffb245d6df83c,2,33,5,38,7,2005-06-22 17:23:48,2005-06-22 08:52:06
f5ab6ccae3063725e0a6bfacffaffb245d6df83c...03b4538badb405b2f159531ad35873700d073bb8,1,2,2,4,2,2005-06-22 17:23:48,2005-06-22 09:29:16
03b4538badb405b2f159531ad35873700d073bb8...96c912a48401fbc8fce94c791f6afc49dcb9f7ac,1,93,1,94,8,2005-06-22 17:23:48,2005-06-22 09:29:46
96c912a48401fbc8fce94c791f6afc49dcb9f7ac...d0587fd59f4452ed8461416d21bc7e47378e70b3,1,72,0,72,1,2005-06-22 17:23:48,2005-06-22 09:30:17
d0587fd59f4452ed8461416d21bc7e47378e70b3...fae22ac9d7b5fd8bbf0fcfb01aab01c27d84912f,15,2152,0,2152,15,2005-06-22 17:23:49,2005-06-22 09:30:47
4f4fa9c228a1ac2854c0814b5b23df43b8d98203...5d87dd4fcac808fc0f0b993b470644ba7d2d62a2,1,48,8,56,6,2009-06-18 18:38:36,2009-06-14 20:38:51
5d87dd4fcac808fc0f0b993b470644ba7d2d62a2...9462e3f59cd5a545330a9490a27d68b79f1d0ce7,1,6,1,7,3,2009-06-18 18:38:43,2009-06-16 18:41:16
9462e3f59cd5a545330a9490a27d68b79f1d0ce7...2ff4d1ab9ef6660c88020ddaadc410157e130cdc,1,22,31,53,17,2009-06-22 03:19:21,2009-06-21 21:16:09
4f4fa9c228a1ac2854c0814b5b23df43b8d98203...907ffe1522560ba71991ae4d2b03e357a8f57110,2,26,3,29,6,2009-06-18 17:19:50,2009-06-16 14:21:04
4f4fa9c228a1ac2854c0814b5b23df43b8d98203...02232adfd8bdc692bbe408ead7332ebfe416e83d,1,9,2,11,4,2009-06-18 16:57:38,2009-06-16 19:07:40
02232adfd8bdc692bbe408ead7332ebfe416e83d...ee78cac22b3e5e3f93898361b87a38b488c5592e,1,1,0,1,1,2009-06-18 16:57:44,2009-06-16 19:08:21
ee78cac22b3e5e3f93898361b87a38b488c5592e...1d7b1af42028c321aeca18ab1c719b21089108bf,1,1,1,2,1,2009-06-21 04:50:11,2009-06-19 15:10:39
4f4fa9c228a1ac2854c0814b5b23df43b8d98203...cb8a9bd518002dd4fb693df6230b4976bafc15e0,4,80,10,90,14,2009-06-18 16:55:59,2009-06-18 12:31:32
4f4fa9c228a1ac2854c0814b5b23df43b8d98203...b3c32ead20bc4d3baa6cffe00dd862f069463869,1,8,0,8,1,2009-06-18 16:50:14,2009-06-16 22:32:57
b3c32ead20bc4d3baa6cffe00dd862f069463869...3ddd170323fcf24af8c4a321ed9c73cda532986e,1,8,1,9,1,2009-06-18 16:50:25,2009-06-16 22:32:58
b941ffac506d3f57246e46a8913da614e62a1d48...098e711e6c0d123dff2f38d6b804ec632ad7dd78,1,7,0,7,1,2007-07-03 03:57:45,2007-07-02 02:00:08
098e711e6c0d123dff2f38d6b804ec632ad7dd78...05dcd69891632101d347b2f8a6bc37a08878aa1a,1,17,10,27,9,2007-07-03 03:58:16,2007-07-02 11:28:42
05dcd69891632101d347b2f8a6bc37a08878aa1a...dbd21447361364d646f3972738a475a92f711513,6,76,3,79,9,2007-07-03 04:05:45,2007-07-02 00:48:59
7c851733e4bc2b36bd9df63cab2fe11180242670...124d3e4cacdf018ddad3449919f471a624e85433,1,88,13,101,13,2007-06-29 16:20:06,2007-06-29 16:20:06
124d3e4cacdf018ddad3449919f471a624e85433...bfc04bb9b847912ee41a21fc23110962851878b2,2,14,9,23,2,2007-06-30 07:00:30,2007-06-30 06:42:47
bfc04bb9b847912ee41a21fc23110962851878b2...72bb989d6e15f1ff443454b5836358ced1dc5bea,1,24,5,29,11,2007-06-30 17:49:14,2007-06-28 16:56:57
e2b1accc59ab5d682d71fd801ebe959c3e871488...41c7c1bd6f151f351365451acbf9fade6eb6044c,1,2,2,4,2,2007-07-04 17:00:38,2007-07-04 16:22:14
41c7c1bd6f151f351365451acbf9fade6eb6044c...54adf3706c5c799584c1bcdcac96fb3285b97de4,5,13,0,13,5,2007-07-04 17:09:32,2007-07-03 18:18:11
54adf3706c5c799584c1bcdcac96fb3285b97de4...d9fb395ae30b50e8a1059338884090b574d8a3e0,1,3,1,4,1,2007-07-04 17:12:26,2007-07-03 08:47:58
d9fb395ae30b50e8a1059338884090b574d8a3e0...e754e9901a7f0912506c12977a916feddcd1b786,1,1,1,2,1,2007-07-04 19:37:17,2007-07-04 19:37:17
e754e9901a7f0912506c12977a916feddcd1b786...88c447e8f467c6b2ca09ad91f3fa1d1d662dd04d,1,1,1,2,1,2007-07-04 19:39:43,2007-07-04 10:33:46
88c447e8f467c6b2ca09ad91f3fa1d1d662dd04d...d54276f207081e35174c5d742e378cfff6e9843f,1,8,7,15,5,2007-07-04 19:39:58,2007-07-04 10:37:27
d54276f207081e35174c5d742e378cfff6e9843f...c57a3494c135ffb7ab5d070afecfcc42a3922edc,1,6,2,8,1,2007-07-04 19:41:10,2007-07-04 12:08:17
c57a3494c135ffb7ab5d070afecfcc42a3922edc...586e4ce2487932b2ae770aad17d343b9021080e0,1,2,1,3,1,2007-07-04 19:41:42,2007-07-04 12:06:04
586e4ce2487932b2ae770aad17d343b9021080e0...5efb48b5ed7dd6838962a7b25845c6d8e2d40422,1,4,4,8,3,2007-07-04 19:43:02,2007-07-04 14:33:30
5efb48b5ed7dd6838962a7b25845c6d8e2d40422...73616fd3d21ab5eefc912fa886ff8808e59d6e7e,1,6,5,11,4,2007-07-04 19:43:24,2007-07-04 14:50:45
73616fd3d21ab5eefc912fa886ff8808e59d6e7e...f66a4d68d2066998605f5910c3c8dd1e4a25fc7f,1,4,4,8,4,2007-07-04 19:45:42,2007-07-04 19:45:42
f66a4d68d2066998605f5910c3c8dd1e4a25fc7f...ef6f0af2b6975e6568542123d015aa7e39bea0c3,1,37,3,40,6,2007-07-04 19:53:30,2007-07-03 22:49:19
ef6f0af2b6975e6568542123d015aa7e39bea0c3...49aba0bb3a85a4364cf3f0f73b3b6ddf98f7e037,1,2,1,3,1,2007-07-04 19:56:02,2007-07-04 08:33:36
49aba0bb3a85a4364cf3f0f73b3b6ddf98f7e037...b5669a05043e402f2f41636c1b18e7865f41b9c0,1,4,0,4,1,2007-07-04 19:56:09,2007-07-04 08:36:24
b5669a05043e402f2f41636c1b18e7865f41b9c0...32c37c123741bee79617a6830257519c53681704,1,16,7,23,4,2007-07-04 20:32:41,2007-07-04 07:32:47
32c37c123741bee79617a6830257519c53681704...7730fbe62490f9e6ee33f6136ecd0e75869894e3,1,1,0,1,1,2007-07-05 04:06:07,2007-07-04 21:07:42
7730fbe62490f9e6ee33f6136ecd0e75869894e3...d97bc5de929e525add9977a9c1ab3834b8c04657,1,2,2,4,2,2007-07-05 04:06:12,2007-07-04 22:21:49
d97bc5de929e525add9977a9c1ab3834b8c04657...1308c17b3e6bd3f5636f5b9bcadb2fbdf559009d,2,43,4,47,6,2007-07-05 04:12:39,2007-07-04 20:09:10
1308c17b3e6bd3f5636f5b9bcadb2fbdf559009d...114fd812f78ea375ee6782d4ff0203f3ae20b076,1,1,1,2,1,2007-07-05 05:10:14,2007-07-05 05:09:20
114fd812f78ea375ee6782d4ff0203f3ae20b076...37ba05619c76f9dbde35c418c6fc8af7bcda24c8,6,63,59,122,7,2007-07-06 04:43:48,2007-07-04 22:21:36
37ba05619c76f9dbde35c418c6fc8af7bcda24c8...9f62e18a60dd2f636bbdf849f66a00a5906b1cea,1,19,6,25,6,2007-07-06 04:47:12,2007-07-05 05:46:09
9f62e18a60dd2f636bbdf849f66a00a5906b1cea...6cb93bf478e7dd6253c9a644aff8758ce9aacf49,1,2,1,3,1,2007-07-06 05:12:42,2007-07-05 16:07:48
6cb93bf478e7dd6253c9a644aff8758ce9aacf49...09ff69bb39b386e24a39723d9e20263a915bc6d6,1,13,1,14,2,2007-07-06 05:12:59,2007-07-05 22:06:56
09ff69bb39b386e24a39723d9e20263a915bc6d6...8c1ce0f46b85d40f215084eed7313896300082df,2,36,11,47,9,2007-07-06 05:16:28,2007-07-04 14:36:01
8c1ce0f46b85d40f215084eed7313896300082df...8960b5a7dfb160be65dc9122df8c7603a5f8aced,1,1,1,2,1,2007-07-06 05:44:26,2007-07-05 16:21:16
8960b5a7dfb160be65dc9122df8c7603a5f8aced...68ad8910f7b090a431b2da4e5f7be3de96112fa7,1,13,4,17,2,2007-07-06 05:52:44,2007-07-05 22:54:33
68ad8910f7b090a431b2da4e5f7be3de96112fa7...20ccef49689b3f4dc7510c63d9867e1969eed1e3,1,18,7,25,6,2007-07-06 06:00:50,2007-07-05 23:10:44
20ccef49689b3f4dc7510c63d9867e1969eed1e3...46f74f007b86452c4b4135f5145f94eefc994ea2,1,12,7,19,2,2007-07-06 06:22:12,2007-07-06 00:29:41
6bf035f2780bde45682e0edf40e35a150bd83706...a947ab79d43353ba29633f6716659d605d4600bc,1,1,1,2,1,2007-03-21 09:22:28,2007-03-21 08:37:36
a947ab79d43353ba29633f6716659d605d4600bc...979ea5856cddace7223ddd715a448dbe49fcb290,1,6,4,10,4,2007-03-22 10:05:19,2007-03-21 18:43:37
6bf035f2780bde45682e0edf40e35a150bd83706...0a3985dcfbab7359e5b5e198061d03df56c4055c,1,1,1,2,1,2007-03-19 01:53:19,2007-03-16 15:45:29
0a3985dcfbab7359e5b5e198061d03df56c4055c...21f13ee203b0dfe5bd9fdd18897cc11343f09ef7,1,1,1,2,1,2007-03-19 01:53:29,2007-03-18 17:39:56
21f13ee203b0dfe5bd9fdd18897cc11343f09ef7...06e7ea37875e4ee4a0ada701d52e2466f344c0f3,1,2,2,4,1,2007-03-19 01:53:50,2007-03-18 00:40:13
06e7ea37875e4ee4a0ada701d52e2466f344c0f3...f562e6f3169f652dd9e840286e43d9e8ca45cf14,4,392,428,820,16,2007-03-19 03:06:00,2007-03-18 21:02:37
f562e6f3169f652dd9e840286e43d9e8ca45cf14...cbd919221f598811e0eb2587d361581f7552e2e7,1,29,29,58,15,2007-03-19 03:06:00,2007-03-18 21:53:29
cbd919221f598811e0eb2587d361581f7552e2e7...81b6c950dede5bca60dac0834de25b6f30ec10bb,1,21,22,43,9,2007-03-19 03:06:00,2007-03-19 03:02:14
ea75ee3598ab6f8d0828f8cc6ec3d4a5f8d66813...905d9c9653a7dc324a1c6fbf883a1b9bcdc6e5bf,1,8,6,14,1,2007-05-30 23:34:40,2007-05-30 15:27:49
ea75ee3598ab6f8d0828f8cc6ec3d4a5f8d66813...994a794288d73ee9151481805c2ea98f448cf3e0,1,1,1,2,1,2007-05-28 21:50:22,2007-05-28 21:50:22
994a794288d73ee9151481805c2ea98f448cf3e0...5b6ffff644237682c5a20e8ec0a16164bdeb3bfb,4,26,3,29,6,2007-05-28 21:50:40,2007-05-28 15:04:59
5b6ffff644237682c5a20e8ec0a16164bdeb3bfb...26ae37d6fc9eeec27a0edf98c820b8a0b98e96f3,2,15,2,17,4,2007-05-28 21:50:41,2007-05-28 15:11:56
26ae37d6fc9eeec27a0edf98c820b8a0b98e96f3...cd12901b8f247bfcec161d5de658dae6c8185691,1,18,14,32,2,2007-05-28 21:50:41,2007-05-28 15:22:13
cd12901b8f247bfcec161d5de658dae6c8185691...f8371706635b7ea19e8df2739e09b8bd3fbf7768,1,19,12,31,6,2007-05-28 21:50:41,2007-05-28 15:28:16
f8371706635b7ea19e8df2739e09b8bd3fbf7768...f60fdd0eaaaf92882f3e6aeb19bb85482fab6d39,1,4,0,4,1,2007-05-28 21:50:41,2007-05-28 15:34:47
f60fdd0eaaaf92882f3e6aeb19bb85482fab6d39...61f82ce79abe965c466bb7d3d1d89ae631fbbd24,2,151,0,151,3,2007-05-28 21:50:42,2007-05-28 16:52:57
61f82ce79abe965c466bb7d3d1d89ae631fbbd24...aa252f194b6a32240117ef339631f42842b6d5b4,2,350,0,350,2,2007-05-28 21:50:42,2007-05-28 19:23:32
aa252f194b6a32240117ef339631f42842b6d5b4...fc8ce406fac73536a14611ce871a06db5a5a22b3,2,2,0,2,2,2007-05-28 21:58:07,2007-05-28 21:58:07
e986e26a86616054f96373280e8f9cc89d7ea8ca...5f85505265601823cc228fdc94d67d3b0ba582e4,1,2,1,3,2,2007-05-18 00:35:33,2007-05-17 20:54:28
843142ada000a992fa87bd2dc7796501332a52d9...211fb4fe787ba5dc8103d5920fb890febffbf6df,1,9,7,16,7,2007-05-11 04:59:13,2007-05-11 04:59:13
211fb4fe787ba5dc8103d5920fb890febffbf6df...f859c846e90b385c7ef873df22403529208ade50,2,49,0,49,2,2007-05-12 05:11:07,2007-05-12 05:11:07
f859c846e90b385c7ef873df22403529208ade50...64cab59159d1308365d56e218a10bfc0d3cd0fd0,3,84,10,94,4,2007-05-12 05:26:08,2007-05-12 05:26:08
64cab59159d1308365d56e218a10bfc0d3cd0fd0...16a4c6176ad096881d0021f1a922fbcc2835f799,2,10,5,15,9,2007-05-12 05:33:31,2007-05-11 06:44:53
16a4c6176ad096881d0021f1a922fbcc2835f799...93c44d493b8c98b9bb74e4f78aa90ee20a01f078,2,44,7,51,6,2007-05-12 08:01:28,2007-05-12 06:42:00
93c44d493b8c98b9bb74e4f78aa90ee20a01f078...2206537c07973fc2933092313d95340e076440e4,1,2,1,3,2,2007-05-12 16:19:08,2007-05-12 10:42:32
2206537c07973fc2933092313d95340e076440e4...02851e0b9ed840c2e6881dd56072eefc17c8b98b,2,4,4,8,4,2007-05-12 16:35:07,2007-05-11 16:55:21
02851e0b9ed840c2e6881dd56072eefc17c8b98b...a25907dac4a3b79523290f19232157b9705dfe55,1,9,8,17,9,2007-05-12 17:19:13,2007-05-11 23:35:18
843142ada000a992fa87bd2dc7796501332a52d9...fefe49d134b4dadf3a184ba7a8e48388f3c15a24,2,4,2,6,2,2007-05-10 22:25:01,2007-05-05 20:48:54
843142ada000a992fa87bd2dc7796501332a52d9...68db31cc289c686c4b4454dfbb121aff59a6c602,10,39,30,69,28,2007-05-10 22:24:44,2007-05-09 10:33:20
843142ada000a992fa87bd2dc7796501332a52d9...0d7566a5baa9cc67fd3361b64bb48757e637fdb0,3,50,3,53,12,2007-05-10 22:24:40,2007-05-09 19:48:39
843142ada000a992fa87bd2dc7796501332a52d9...fa736f72b0840950e32dfd8bc470e91831107b10,2,21,8,29,7,2007-05-10 22:22:33,2007-05-09 16:31:28
fa736f72b0840950e32dfd8bc470e91831107b10...479b56ba50144b30f28c5b225d412125c07def9f,1,3,3,6,3,2007-05-10 22:22:33,2007-05-09 16:59:40
efa615ba089e88c0d2645f444373751de0529214...35c49eeae7e71e8554f27958a16405397c69b552,3,12,8,20,8,2007-05-10 21:13:29,2007-05-09 10:49:41
35c49eeae7e71e8554f27958a16405397c69b552...63fcbe00a66d7cb7d8bce9a36120a19a809a33b8,1,9,10,19,10,2007-05-10 21:13:29,2007-05-09 01:41:50
467592ea926d105e1cb78b2471b28bf37e8c62c6...b3b53439701189597c116aec10a6e503f80820d8,1,120,0,120,1,2007-05-09 06:55:58,2007-05-02 00:45:22
fdc99cbbdcdcf4ee2c336f02b7b2dbcb11696392...ae9ee41de86cc98adad1a0c70651c55acc3fb699,1,24,4,28,3,2007-05-13 07:19:58,2007-05-13 04:49:33
ae9ee41de86cc98adad1a0c70651c55acc3fb699...b18a2be37a0de27902ad6491960ed910083b0310,1,19,0,19,1,2007-05-13 07:24:46,2007-05-13 07:12:52
b18a2be37a0de27902ad6491960ed910083b0310...0ab311d60108f8d93dbcac53623e8e593901b5ea,1,0,1,1,1,2007-05-13 18:57:00,2007-05-13 18:57:00
0ab311d60108f8d93dbcac53623e8e593901b5ea...b24dd51bf6102f5341d4753fad8ff73413ca66d3,1,5,0,5,2,2007-05-13 19:00:28,2007-05-13 11:41:45
b24dd51bf6102f5341d4753fad8ff73413ca66d3...645833b564f585a25acd75c878ffda752909c273,1,1,1,2,1,2007-05-13 19:10:42,2007-05-12 21:36:20
645833b564f585a25acd75c878ffda752909c273...0dc03d6a30213e9aa0eb88886cee24b993a24a29,1,42,26,68,6,2007-05-13 19:10:42,2007-05-13 08:04:43
0dc03d6a30213e9aa0eb88886cee24b993a24a29...4c03c3eb4e31c2d1f88ca0c7106c647a246e81ff,1,0,1,1,1,2007-05-13 19:10:42,2007-05-13 08:04:44
4c03c3eb4e31c2d1f88ca0c7106c647a246e81ff...4a1bb4c3f87f355dd52fcd0babcbd005d59d7ed6,6,19,16,35,13,2007-05-13 19:10:43,2007-05-13 16:58:14
6e6db39afc305e1205a4d2dcf34680bfa80bfc24...27c8f8cda42b9e47dc18e94152b28472488bef1c,1,4,1,5,2,2007-04-19 05:06:21,2007-04-19 03:03:14
27c8f8cda42b9e47dc18e94152b28472488bef1c...6b04600a34a89241e7b1eb344667c8146a5dc99e,1,1,1,2,1,2007-04-19 05:07:57,2007-04-19 03:03:26
6b04600a34a89241e7b1eb344667c8146a5dc99e...c91ee2714ecd01594cf2feef57157098dc486590,1,1,1,2,1,2007-04-19 05:08:03,2007-04-19 03:03:31
c91ee2714ecd01594cf2feef57157098dc486590...9bc20aa73152784ee758f6432e20820e581c9412,2,15,11,26,3,2007-04-19 05:08:16,2007-04-19 03:03:37
6fb8e8f401a065bdffe379764871551e37a041a0...c774aab98ce6c5ef7aaacbef38da0a501eb671d4,1,89,21,110,5,2007-04-18 23:20:57,2007-04-17 01:42:50
8c67c392e1620fc3b749aa9e0b8da13bd84226f8...8bd9fd50014424643bddfde51423d42e0fc60800,1,2,1,3,1,2010-08-20 16:27:38,2010-08-20 15:09:51
7943b3a94f0f862dc9d7dcec6b5639ae5bf027bd...0bc25a78428a7dc3a3acf00eb9637424419c3afd,1,1,1,2,1,2007-03-05 00:47:32,2007-02-06 07:51:26
0bc25a78428a7dc3a3acf00eb9637424419c3afd...1c73bb0ef7bf6632d1aa5d6760bba7ea4e336fe9,1,1,1,2,1,2007-03-05 00:47:32,2007-02-19 23:46:09
1c73bb0ef7bf6632d1aa5d6760bba7ea4e336fe9...1c95c565c2472a07be8316f2658e7100e62bf94d,1,4,1,5,2,2007-03-05 00:47:32,2007-03-03 18:33:48
1c95c565c2472a07be8316f2658e7100e62bf94d...3512193034cbc5207a955d6c4c8506f028d48f2d,1,15,9,24,2,2007-03-05 00:47:32,2007-03-03 19:04:42
3512193034cbc5207a955d6c4c8506f028d48f2d...365aa199196c8665e978ec7092323167621a69ea,1,46,0,46,2,2007-03-05 00:47:32,2007-03-03 19:30:32
365aa199196c8665e978ec7092323167621a69ea...ef561ac7380cae589549237c804ad88e8dd449ef,1,77,25,102,11,2007-03-05 00:47:32,2007-03-03 20:34:27
ef561ac7380cae589549237c804ad88e8dd449ef...2aa54fa872adf37fb3e062dbcafefa30506eed49,1,9,0,9,2,2007-03-05 00:47:33,2007-03-04 18:07:43
2aa54fa872adf37fb3e062dbcafefa30506eed49...7193db3685b71be3e93aaac785bdc554d91d2167,2,15,12,27,8,2007-03-05 01:20:38,2007-03-05 01:20:38
8ff21b1a3307c7059ea1e00b5117a50a2bc5fec8...895a1d1e57c8dfb8470bb742f05f1969b9961e07,1,84,0,84,4,2007-04-10 19:55:56,2007-04-05 10:22:54
895a1d1e57c8dfb8470bb742f05f1969b9961e07...e3c6f240fd9c5bdeb33f2d47adc859f37935e2df,1,29,13,42,2,2007-04-10 19:58:17,2007-04-05 10:22:55
e3c6f240fd9c5bdeb33f2d47adc859f37935e2df...b9849a1ab63143c3b70e339491a897ef62a4173b,2,93,0,93,2,2007-04-17 07:14:59,2007-04-16 07:42:29
8ff21b1a3307c7059ea1e00b5117a50a2bc5fec8...ea4b52a86f6b6b8e5aef8e47fb557f37422512bf,2,2,2,4,2,2007-04-10 19:55:51,2007-04-07 12:42:01
ea4b52a86f6b6b8e5aef8e47fb557f37422512bf...4c4caafc9cef1031beb46babe9adfdcc03f3cd52,1,20,14,34,7,2007-04-10 19:55:51,2007-04-07 12:49:19
4c4caafc9cef1031beb46babe9adfdcc03f3cd52...ac7f0f436e4f45d616ca509f5163fddab104516b,1,11,5,16,5,2007-04-10 19:55:51,2007-04-07 12:52:57
ac7f0f436e4f45d616ca509f5163fddab104516b...4d50895a390658bf1b9a9385dbc0b9f90b48c803,1,26,3,29,2,2007-04-10 19:55:51,2007-04-07 13:41:13
4d50895a390658bf1b9a9385dbc0b9f90b48c803...885b98107547fe3f6d17ca0af0578e040f7600d0,1,528,0,528,1,2007-04-10 19:55:51,2007-04-07 14:17:35
8ff21b1a3307c7059ea1e00b5117a50a2bc5fec8...3714e7c8950681b440508244a1fcf5899a1b0966,2,58,3,61,3,2007-04-10 19:48:35,2006-12-22 21:15:59
3714e7c8950681b440508244a1fcf5899a1b0966...3d711d97a0db41633a5137e47358cf503b91b074,2,67,5,72,5,2007-04-10 19:48:35,2007-04-08 08:28:00
3d711d97a0db41633a5137e47358cf503b91b074...238128d88885b5d0f5a3e28d392362a9b267a03f,1,1,1,2,1,2007-04-16 23:52:55,2007-04-13 20:13:10
238128d88885b5d0f5a3e28d392362a9b267a03f...4848509a970e5c805a06fdba12c3377472308443,7,0,0,0,0,2007-04-16 23:53:09,2007-04-13 20:13:51
8ff21b1a3307c7059ea1e00b5117a50a2bc5fec8...57059091fad25427bce9b3d47e073ce0518d164b,7,17,22,39,16,2007-04-10 19:48:14,2007-04-09 05:06:28
57059091fad25427bce9b3d47e073ce0518d164b...8723f216263ba4a0f06be7b93fada863c0931e09,5,12,4,16,5,2007-04-10 19:48:14,2007-04-09 05:06:29
8723f216263ba4a0f06be7b93fada863c0931e09...d7dd02231f75604e388afb905f7bf8afd1bf4b24,3,34,16,50,18,2007-04-10 19:48:14,2007-04-09 05:06:30
d7dd02231f75604e388afb905f7bf8afd1bf4b24...78d1e84fe5586ed45740b915b52e6856bb3f1c44,3,24,0,24,10,2007-04-10 19:48:14,2007-04-09 05:06:31
78d1e84fe5586ed45740b915b52e6856bb3f1c44...ee5743ce191d4f39f976e76fe4c12bf8fc67a590,1,13,3,16,10,2007-04-10 19:48:14,2007-04-09 05:06:32
ee5743ce191d4f39f976e76fe4c12bf8fc67a590...c553ca25bd60dc9fd50b8bc7bd329601b81cee66,1,87,12,99,14,2007-04-10 19:48:14,2007-04-09 05:06:33
c553ca25bd60dc9fd50b8bc7bd329601b81cee66...d1a46a9eab2ce136240fe2e8db34b36338052e97,1,57,9,66,9,2007-04-10 19:48:14,2007-04-09 05:06:34
d1a46a9eab2ce136240fe2e8db34b36338052e97...74e34e1fca2ed9998581cc94073bc2dd28bbb8f3,1,89,29,118,14,2007-04-10 19:48:14,2007-04-09 05:06:35
74e34e1fca2ed9998581cc94073bc2dd28bbb8f3...32637cdf4a6a8d806feaa6b018bc4e4c7e2eb366,1,59,9,68,5,2007-04-10 19:48:14,2007-04-09 05:06:36
32637cdf4a6a8d806feaa6b018bc4e4c7e2eb366...8c681e07c91b544756e2631493ebc15abd1e8589,1,27,20,47,18,2007-04-10 19:48:14,2007-04-09 05:06:37
8c681e07c91b544756e2631493ebc15abd1e8589...4ba7d711539122c21bd44af06b6cab4fc4f65a74,2,32,6,38,10,2007-04-10 19:48:14,2007-04-09 21:32:03
4ba7d711539122c21bd44af06b6cab4fc4f65a74...91ecbeca48e675fef8141451edb2c86577f9d63c,1,34,12,46,4,2007-04-10 19:48:14,2007-04-10 04:15:41
91ecbeca48e675fef8141451edb2c86577f9d63c...2dca1af44806924946828e2fdc82ea408353d286,3,40,2,42,5,2007-04-12 02:23:32,2007-04-11 17:59:51
2dca1af44806924946828e2fdc82ea408353d286...39551b6926ef869e15af41f4eaa9356da98b2b5e,1,1,1,2,1,2007-04-12 02:31:24,2007-04-11 17:35:13
39551b6926ef869e15af41f4eaa9356da98b2b5e...6e5417769c587c8b1f3412e19a1f80645fe82a3c,1,146,0,146,1,2007-04-12 02:32:03,2007-04-10 20:26:10
6e5417769c587c8b1f3412e19a1f80645fe82a3c...29b734e4788143603adf8046174219bac67794e0,1,25,27,52,10,2007-04-12 02:35:25,2007-04-11 02:54:36
29b734e4788143603adf8046174219bac67794e0...8a5a8d6c97e36dbd95361eab1109e4380fe45df4,1,12,15,27,9,2007-04-17 00:43:30,2007-04-16 16:28:10
8a5a8d6c97e36dbd95361eab1109e4380fe45df4...adcc70950e594065050c375ace8a039678d2e31f,1,1,1,2,1,2007-04-17 00:43:30,2007-04-16 16:28:52
adcc70950e594065050c375ace8a039678d2e31f...898b14cedc353de95945fcc56e14f463c3066bf0,1,32,44,76,12,2007-04-17 00:43:31,2007-04-16 16:29:16
898b14cedc353de95945fcc56e14f463c3066bf0...9668cf59a83d1aa881036818abf29cc2ea9e291b,1,22,31,53,8,2007-04-17 00:43:31,2007-04-16 16:29:54
9668cf59a83d1aa881036818abf29cc2ea9e291b...f7ae6a930a3c5d501439cdba98417af747350738,1,14,72,86,3,2007-04-17 00:43:31,2007-04-16 16:30:15
f7ae6a930a3c5d501439cdba98417af747350738...81a216a5d6a12976b20d9a39829562f280ae96f2,1,72,55,127,23,2007-04-17 00:43:31,2007-04-16 16:31:05
81a216a5d6a12976b20d9a39829562f280ae96f2...a3fbf4dfe1bf2386add261dc7c2809b652b5f9ae,1,12,14,26,5,2007-04-17 00:43:31,2007-04-16 16:31:31
a3fbf4dfe1bf2386add261dc7c2809b652b5f9ae...54dab52ae8518da67e271b5b3a1f91af1fd5e314,2,40,34,74,3,2007-04-17 00:43:31,2007-04-16 16:31:56
54dab52ae8518da67e271b5b3a1f91af1fd5e314...5c49c11686df9d1c27a194349d0b2092e6446f42,1,126,80,206,28,2007-04-17 00:43:31,2007-04-16 16:32:13
5c49c11686df9d1c27a194349d0b2092e6446f42...e4d58311ba1a6cefa2ac5a3d95918af0d9b43588,1,3,11,14,4,2007-04-20 03:37:41,2007-04-20 02:28:02
e4d58311ba1a6cefa2ac5a3d95918af0d9b43588...be18c1fe1291ed839aef817283a880e09e222be5,2,10,0,10,2,2007-04-20 03:38:00,2007-04-20 02:16:53
8ff21b1a3307c7059ea1e00b5117a50a2bc5fec8...844c11ae259bd33b971b9ca389b3f9619427e9a8,1,3,12,15,3,2007-04-10 05:30:04,2007-04-10 04:13:29
844c11ae259bd33b971b9ca389b3f9619427e9a8...5d5cea67af386cfd53428f1eb404841eca8e9062,1,3,0,3,1,2007-04-10 05:30:05,2007-04-10 04:13:58
5d5cea67af386cfd53428f1eb404841eca8e9062...0ebde32c87da2efac5985a808e6bd4130831b7a8,2,83,0,83,2,2007-04-10 20:44:16,2007-04-10 04:14:26
0ebde32c87da2efac5985a808e6bd4130831b7a8...9eec4795d44439cd170fb52c73827c728252648d,1,19,1,20,3,2007-04-10 20:46:58,2007-04-10 04:14:58
9eec4795d44439cd170fb52c73827c728252648d...8d9721c86b0169c282ad1c5528317eafeb7fb0f7,2,22,2,24,7,2007-04-10 20:46:58,2007-04-10 04:15:29
8d9721c86b0169c282ad1c5528317eafeb7fb0f7...f35a6d3bce79c2995bbf0a3bd9fcad29e54a8d3c,4,54,6,60,12,2007-04-10 20:50:43,2007-04-10 04:20:29
f35a6d3bce79c2995bbf0a3bd9fcad29e54a8d3c...1833a925484675b328d5df04ffca62efa7a0a012,1,2,2,4,2,2007-04-12 00:21:12,2007-04-11 21:39:12
1833a925484675b328d5df04ffca62efa7a0a012...095952585c2a955f45deac69df17a702d7584c80,3,121,19,140,9,2007-04-12 02:09:55,2007-04-11 21:49:44
095952585c2a955f45deac69df17a702d7584c80...e011054b0fdcd1e29d85cdde7ffa5d5c125bd753,1,138,62,200,10,2007-04-12 22:09:25,2007-04-12 19:29:40
e011054b0fdcd1e29d85cdde7ffa5d5c125bd753...ab22aed3b7517c6390cb622b368bfcf503b7a37a,1,2,0,2,1,2007-04-12 23:23:25,2007-04-12 21:32:21
e8811929344c46aed7669e148527af054eb3e18b...a208362fad4ebfd341f4c57fee795302a4b1f42c,1,6,1,7,3,2007-03-30 07:56:36,2007-03-30 07:56:36
a208362fad4ebfd341f4c57fee795302a4b1f42c...aa453216d1b3e49e7f6f98441fa56946ddcd6a20,1,1,1,2,1,2007-03-30 08:03:09,2007-03-30 08:03:09
aa453216d1b3e49e7f6f98441fa56946ddcd6a20...5ae917acdf40444945271e5e014cda37e202504e,1,2,2,4,2,2007-03-31 07:47:48,2007-03-30 21:41:26
5ae917acdf40444945271e5e014cda37e202504e...86747c132b87fc97bbb134baaffe9ecc12c5a90d,2,13,12,25,11,2007-03-31 07:59:19,2007-03-30 16:18:45
86747c132b87fc97bbb134baaffe9ecc12c5a90d...46efd2d93ce39fd5c1a91f0a2f918f2d8bbfdf92,5,6,6,12,6,2007-03-31 08:11:11,2007-03-30 23:07:05
46efd2d93ce39fd5c1a91f0a2f918f2d8bbfdf92...a6a15a9958cbd77e7181c2110e1e2568a808a204,1,11,5,16,2,2007-03-31 08:11:13,2007-03-31 00:54:48
a6a15a9958cbd77e7181c2110e1e2568a808a204...4557e0de5b7ef9d25cc7618ca37ae5f1acf82806,2,605,0,605,2,2007-03-31 08:21:18,2007-03-30 19:16:26
4557e0de5b7ef9d25cc7618ca37ae5f1acf82806...4f01748d51b530c297eeb5a0ece9af923d5db937,1,57,0,57,1,2007-03-31 08:26:28,2007-03-26 23:15:32
4f01748d51b530c297eeb5a0ece9af923d5db937...a97e4075a16e0cbdf9c4aed736b5e762e035508b,1,31,6,37,5,2007-03-31 20:39:15,2007-03-31 11:49:38
a97e4075a16e0cbdf9c4aed736b5e762e035508b...d6bad6610aece0bcaf4449ce170de22970793110,1,3,0,3,1,2007-03-31 22:22:59,2007-03-31 21:00:18
d6bad6610aece0bcaf4449ce170de22970793110...d8b6a1a10b93666246984a50d64a163e71163aeb,1,5,3,8,1,2007-03-31 23:00:27,2007-03-31 13:32:13
7685227e973fce34340d3766b1775263751afa56...7b8a74f39cbd58b514dce963e7a571904508661b,1,18,3,21,5,2007-03-28 23:48:50,2007-03-25 11:56:49
7b8a74f39cbd58b514dce963e7a571904508661b...7ef195ba3efe0ffa815e12afc4cb1e39a21ddfb4,1,17,0,17,1,2007-03-28 23:48:50,2007-03-25 11:56:50
7ef195ba3efe0ffa815e12afc4cb1e39a21ddfb4...d3d4fa86319a0bf97752e285907a8d34a2824951,1,2,0,2,2,2007-03-28 23:48:50,2007-03-27 06:45:23
1d848f643cd8ba86044d729d08d6866425c1539e...a1bf91e081de236af34bf8acd484881ce146fc93,1,4,4,8,2,2007-03-22 09:56:53,2007-03-22 09:54:59
a1bf91e081de236af34bf8acd484881ce146fc93...85295a52e683a24d8404c6989d8b8f134a0ea684,1,4,0,4,1,2007-03-22 10:01:43,2007-03-22 09:07:30
85295a52e683a24d8404c6989d8b8f134a0ea684...0a0d080bdc68d2bd4a1824b08123690c8065badb,1,6,0,6,1,2007-03-22 10:02:31,2007-03-20 10:58:32
0a0d080bdc68d2bd4a1824b08123690c8065badb...605fac8b5bd6d4a2ca817631e2c56ba2d0a1ed91,1,21,0,21,1,2007-03-22 10:02:48,2007-03-21 21:11:44
1d848f643cd8ba86044d729d08d6866425c1539e...80573baec4a6211fc9a01d83690c0d73015cfbdc,1,3,1,4,3,2007-03-22 08:26:26,2007-03-19 15:55:57
80573baec4a6211fc9a01d83690c0d73015cfbdc...92a39a14d00fdfe6868bacf86cbf933a2cc6be93,1,6,2,8,1,2007-03-22 08:26:26,2007-03-19 15:55:58
92a39a14d00fdfe6868bacf86cbf933a2cc6be93...d55820ced668477e07be7d9488c7965906a61b54,2,19,3,22,4,2007-03-22 08:26:26,2007-03-19 15:55:59
d55820ced668477e07be7d9488c7965906a61b54...eb1780d480c2c57c58024692055a6ee33074a95f,1,34,6,40,4,2007-03-22 08:26:26,2007-03-19 15:56:00
eb1780d480c2c57c58024692055a6ee33074a95f...920a449af5a6b4ecbf01a5a4e3bc4894ad302634,1,1,0,1,1,2007-03-22 08:26:26,2007-03-19 15:56:01
920a449af5a6b4ecbf01a5a4e3bc4894ad302634...0cf611a300fbbbd12827f9defb9cbcc934a3b1d6,1,1,3,4,2,2007-03-31 23:09:49,2007-03-31 13:57:47
0cf611a300fbbbd12827f9defb9cbcc934a3b1d6...473937ed44c112e5d3ced52ab3f9a9e53eccc272,1,4,2,6,2,2007-04-08 06:02:13,2007-04-07 14:58:09
473937ed44c112e5d3ced52ab3f9a9e53eccc272...febe7dcc088020366bbc601a219a1d6c30ced0c2,1,83,4,87,3,2007-04-08 07:23:14,2007-04-07 14:58:10
febe7dcc088020366bbc601a219a1d6c30ced0c2...4db0c8dec5c009cbbb61135a321a48278e668a25,1,40,0,40,2,2007-04-12 21:59:46,2007-04-11 22:51:33
4db0c8dec5c009cbbb61135a321a48278e668a25...0f76a543e398b116882a49fc115273988cc9eb29,1,9,3,12,2,2007-04-12 22:03:56,2007-04-12 14:43:36
0f76a543e398b116882a49fc115273988cc9eb29...b2475703d8c95b39e9a05b4d5638452bacfc2a8b,1,4,0,4,1,2007-04-12 23:22:34,2007-04-12 14:54:28
b2475703d8c95b39e9a05b4d5638452bacfc2a8b...047528680e783046b89bb6b220a7576d74c538d0,1,27,0,27,1,2007-04-14 02:43:04,2007-04-13 16:13:42
1d848f643cd8ba86044d729d08d6866425c1539e...7054b6089d413f3d466491f1e6e8f565f4aff031,1,1,1,2,1,2007-03-22 08:00:12,2007-03-22 05:11:35
7054b6089d413f3d466491f1e6e8f565f4aff031...457f08a030c8542b90172d24de4b8d11c4dae80f,2,61,6,67,11,2007-03-22 08:32:31,2007-03-22 05:15:54
457f08a030c8542b90172d24de4b8d11c4dae80f...1c4fea3a40e836dcee2f16091bf7bfba96c924d0,1,160,2,162,2,2007-03-22 08:44:17,2007-03-22 05:16:24
1c4fea3a40e836dcee2f16091bf7bfba96c924d0...bab36bf57d7a565e0077e1f5d2e3a10afa319ecc,1,33,1,34,2,2007-03-23 09:32:26,2007-03-23 06:22:07
e326bce65c2a8b10f40c1869e13c7450a243b109...3efb1f343a9d6214a59a814029cab96638e9b915,1,16,21,37,10,2007-02-21 03:10:57,2007-02-21 01:34:56
4170af82328e50a75723cee084ae779e7a882b9d...bb9e15a83c425ff31e4da6b004bd4557d528b755,1,5,4,9,1,2006-06-21 09:30:46,2006-06-21 09:04:12
7b6511a13f9913a7a54e76b18e21c2b2bfae18cf...57bd4d3523efecf60197040cad34154aff4ddf80,1,1,1,2,1,2006-06-20 09:59:55,2006-06-20 06:19:31
86378b32895ee5d788491b8407608a54e5cf064c...1054dcd1652644f3a80cf6ce546d24c1fee4066a,1,3,2,5,1,2006-06-24 10:06:30,2006-06-24 09:41:25
1054dcd1652644f3a80cf6ce546d24c1fee4066a...0ec2f6b7392f8f041fd48f824bbf22c4dd13ac40,1,1,1,2,1,2006-06-24 11:24:34,2006-06-24 11:20:39
0ec2f6b7392f8f041fd48f824bbf22c4dd13ac40...acb70149bc5e9b9d99631a0cb59e7c2f80e92ddd,1,3,6,9,4,2006-06-24 12:19:30,2006-06-24 12:19:30
86378b32895ee5d788491b8407608a54e5cf064c...7d0c68871a86df0654454df047458836afa13129,5,72,24,96,18,2006-06-24 08:11:19,2006-06-23 08:37:02
86378b32895ee5d788491b8407608a54e5cf064c...b65bc21e7d8dc8cafc70dfa6354cb66b8874b2d9,3,113,0,113,3,2006-06-24 08:10:40,2006-06-24 07:59:49
b65bc21e7d8dc8cafc70dfa6354cb66b8874b2d9...b57cbbf8a8630b6d75c885348dc79b8b8cb96c2e,2,32,9,41,5,2006-06-24 09:59:20,2006-06-24 09:59:20
b57cbbf8a8630b6d75c885348dc79b8b8cb96c2e...84702995f89361c5872029cb93983c704d80e993,1,195,156,351,13,2006-06-24 10:02:00,2006-06-24 09:31:20
b664550c066810b770ad3e19cafe2fbdd42c6793...244edd1241cc6168fba0b580c41a6adeb63f1216,1,48,1,49,5,2005-08-17 11:27:55,2005-08-17 11:27:55
244edd1241cc6168fba0b580c41a6adeb63f1216...f6075ebadb1fce2bd75f2dd68b8aeae40a69158a,1,413,166,579,62,2005-08-17 23:30:10,2005-08-17 23:30:10
c35a7b8d806317dc1762e36561cbd31c2530dd9c...ef0bd2e6e643f09a8294937caf99463328b9215a,2,39,3,42,5,2005-08-10 17:22:49,2005-08-10 03:07:36
cd58b71e3a4ca4d4aea7f2b21db828f1019e0bdf...010b260e6f23b8964ef53b989e1c1baa8973edbe,1,11,53,64,2,2012-04-26 18:04:41,2012-04-26 18:02:36
49902bd8561392e979c54344ae98dfab7a7ecf05...9d33f7c22fda81f7be8a7aa1576e6d399d3b45ec,1,3,1,4,2,2009-07-16 22:07:24,2009-07-16 21:25:18
9d33f7c22fda81f7be8a7aa1576e6d399d3b45ec...b45a09c4b4a80ccc6eeb0f390ab8f4eb6f31c922,1,0,2,2,1,2009-07-16 22:09:21,2009-07-16 21:25:19
b45a09c4b4a80ccc6eeb0f390ab8f4eb6f31c922...78d3b06e0f5e6aaea001ee8e3e7c8e401dc4b244,1,1,1,2,1,2009-07-18 23:57:30,2009-07-18 19:26:38
3ba4f3a9fc68ba4c5a0064107e8993c5fc5b684f...c6720cfa49fde6d78b010c088a476d226d161983,1,5,5,10,1,2009-06-21 09:01:28,2009-06-21 09:01:28
c6720cfa49fde6d78b010c088a476d226d161983...e2f6331a14213f01a6e68e71ed63c77323a3e759,1,1,1,2,1,2009-06-21 17:42:37,2009-06-19 10:42:53
e2f6331a14213f01a6e68e71ed63c77323a3e759...a437900fd7643408e1d7a130b4a6b81bfd816d4e,1,7,5,12,3,2009-06-21 17:43:10,2009-06-21 09:35:18
cb8a9bd518002dd4fb693df6230b4976bafc15e0...977e289e0d73ad66883425efbd37eadb7d91fd61,1,4,1,5,1,2009-06-23 23:41:27,2009-06-22 17:32:52
3ddd170323fcf24af8c4a321ed9c73cda532986e...0ba17dd0229582481d048388024741cfef3298a3,1,1,1,2,1,2010-04-14 18:20:27,2010-04-09 23:58:28
3ddd170323fcf24af8c4a321ed9c73cda532986e...e064c170b4abe21f50658f2ec3b07e4ec7520767,1,9,0,9,1,2009-06-18 16:50:31,2009-06-16 22:32:59
e064c170b4abe21f50658f2ec3b07e4ec7520767...2e6a30ef8fbaedc5f2ee199d36f7256bb0cfdf1e,2,11,25,36,13,2009-06-18 16:50:37,2009-06-16 22:33:00
2e6a30ef8fbaedc5f2ee199d36f7256bb0cfdf1e...0e987a12fc1d481d81ad9c56f4714efb08667213,6,97,24,121,40,2009-06-18 18:54:48,2009-06-16 22:33:01
0e987a12fc1d481d81ad9c56f4714efb08667213...fcdd0e92d9d42b8fa4569d92ba1013bb0eedfcd8,3,92,24,116,21,2009-06-18 18:54:57,2009-06-18 01:07:37
1a6f3999998a22325ff820bf8c840e3baf3d2281...68f6c019fd8d49fbaa72f1aeeb21eb921b6a16bf,3,62,1,63,6,2007-07-03 04:34:12,2007-07-03 00:33:54
46f74f007b86452c4b4135f5145f94eefc994ea2...483891810c5f814ede2407999a0d0b961def246c,1,7,7,14,1,2007-07-06 17:49:12,2007-07-06 07:02:20
483891810c5f814ede2407999a0d0b961def246c...95fd73ab22f9a9a1b7a1275c934991340eeb8839,1,1,1,2,1,2007-07-07 01:56:34,2007-07-07 01:23:54
95fd73ab22f9a9a1b7a1275c934991340eeb8839...b2493649fe41f8a0db48ff4e809ea53c8a304a61,1,1,0,1,1,2007-07-07 01:56:42,2007-07-07 00:56:31
b2493649fe41f8a0db48ff4e809ea53c8a304a61...b4372ef136b0a5a2c1dbd88a11dd72b478d0e0a5,9,64,40,104,24,2007-07-07 05:39:15,2007-07-06 12:05:59
b4372ef136b0a5a2c1dbd88a11dd72b478d0e0a5...813a0bd8a4b074f7ea0094c065b211873bd86c19,1,3,3,6,2,2007-07-07 05:39:23,2007-07-06 17:38:38
813a0bd8a4b074f7ea0094c065b211873bd86c19...3cd2491aa2e5f07fa7fbeaa529b77de8c005a01c,1,1,0,1,1,2007-07-07 05:48:30,2007-07-06 19:57:47
3cd2491aa2e5f07fa7fbeaa529b77de8c005a01c...1e76b702c1e754c7e6df1ced9ce6f1863cb7e092,1,4,4,8,2,2007-07-07 06:13:34,2007-06-17 08:31:02
1e76b702c1e754c7e6df1ced9ce6f1863cb7e092...ae740a588d581b34d2794a0993ae45cdca6d5ece,1,2,0,2,1,2007-07-07 06:16:59,2007-07-05 01:11:36
ae740a588d581b34d2794a0993ae45cdca6d5ece...34a3e695497ab2abbf2fc33a46380accaa8c7c15,1,1,1,2,1,2007-07-07 06:21:39,2007-07-06 21:54:09
34a3e695497ab2abbf2fc33a46380accaa8c7c15...4d3f4b80e49275c7eaf6ba0dbddd6180957926b9,1,1,1,2,1,2007-07-07 18:53:49,2007-07-07 18:19:08
46f74f007b86452c4b4135f5145f94eefc994ea2...150937c42591b0e9fb6c17f96c459d57b5f3bfdb,2,89,1,90,5,2007-07-06 08:43:24,2007-07-02 11:14:49
46f74f007b86452c4b4135f5145f94eefc994ea2...29a3eefde111f6a24292163c4308f00ab3572627,3,39,36,75,18,2007-07-06 07:21:41,2007-07-06 07:18:54
29a3eefde111f6a24292163c4308f00ab3572627...30b250104d9307e1225031c7fc39b66643265ed1,6,10,10,20,16,2007-07-06 07:22:12,2007-07-04 18:05:46
30b250104d9307e1225031c7fc39b66643265ed1...f258475a6ede3617ae768b69e33f78cbab8312de,7,256,15,271,22,2007-07-06 08:20:47,2007-07-06 07:45:10
f258475a6ede3617ae768b69e33f78cbab8312de...e0e324a4dc18a4341e1320a7cfac9733d81f8b0b,3,84,71,155,29,2007-07-07 08:49:58,2007-07-07 08:49:58
e0e324a4dc18a4341e1320a7cfac9733d81f8b0b...2c3fa66f3577d1305fb0fac5a181261fb2597859,2,21,5,26,5,2007-07-07 19:25:11,2007-07-07 19:25:11
979ea5856cddace7223ddd715a448dbe49fcb290...f9308a182e220c97cdbf90ee8de2ce21980cb7e9,1,1,1,2,1,2007-03-23 21:54:52,2007-03-23 20:04:31
fd2a75972e90d34bc8d4bebe1d669645557a2192...d3e41ebff44745055001e59e460509a8f04b81a2,1,1,1,2,1,2007-03-28 10:34:55,2007-03-28 10:05:08
d3e41ebff44745055001e59e460509a8f04b81a2...75c962c99a9115d489549ad9b8419d3e37e85f02,1,2,1,3,1,2007-03-28 21:54:30,2007-03-23 01:05:28
75c962c99a9115d489549ad9b8419d3e37e85f02...d0e50cb4cb8e0cc8b445a9749547019efaa5703e,1,5,2,7,2,2007-03-28 22:06:18,2007-03-28 21:52:09
d0e50cb4cb8e0cc8b445a9749547019efaa5703e...9529a2524a29c15107905f2f8f0b310a40880dc7,3,24,2,26,3,2007-03-28 22:28:14,2007-03-28 20:53:00
905d9c9653a7dc324a1c6fbf883a1b9bcdc6e5bf...b8848f7753762ff8c4e34b3c15e788c5f7e6781f,3,5,5,10,5,2007-06-01 03:32:54,2007-06-01 03:32:54
8299886619b8dab99773b5810f50c63a50b2d611...d77b5673e90f47309d6bf87a7653896169945da0,1,2,1,3,2,2007-05-18 00:37:30,2007-05-17 02:24:19
d77b5673e90f47309d6bf87a7653896169945da0...e7738553723dcff0237b1aed2771886c8d87d224,2,125,2,127,9,2007-05-18 00:37:31,2007-05-17 02:31:12
e7738553723dcff0237b1aed2771886c8d87d224...4229aa5141b5d7716d283fa8625209b59398d7ba,1,4,2,6,3,2007-05-18 00:37:31,2007-05-17 02:30:42
4229aa5141b5d7716d283fa8625209b59398d7ba...5e6cfc80e26a4d0ebac38cff74c2cdebbe66cd27,4,26,8,34,9,2007-05-18 23:36:45,2007-05-18 22:09:41
5e6cfc80e26a4d0ebac38cff74c2cdebbe66cd27...760f0c62ef8980cc46422894791649b010cc480f,1,2,2,4,2,2007-05-19 00:02:47,2007-05-18 12:33:32
760f0c62ef8980cc46422894791649b010cc480f...7f79b0173d2464a31fcb69ff33df9821172b2219,1,0,7,7,1,2007-05-19 00:12:36,2007-05-18 23:12:32
667152528df417627e54de6cb281a63a727369af...24a0d61e51c0a5e3b9d799af4fcfdd5dc4405502,1,20,17,37,7,2007-05-12 22:46:55,2007-05-12 21:43:11
24a0d61e51c0a5e3b9d799af4fcfdd5dc4405502...a2983cb7406210c69415b35528f83afa8e9c7b68,1,2,2,4,2,2007-05-13 19:12:19,2007-05-12 18:47:38
a2983cb7406210c69415b35528f83afa8e9c7b68...198a2a8a69921327513c32512bdac77f52ab95d3,1,15,1,16,4,2007-05-13 19:12:30,2007-05-12 19:16:34
198a2a8a69921327513c32512bdac77f52ab95d3...f987afa8fe13c2a1512094362b06172419977bc4,1,3,3,6,1,2007-05-13 19:14:22,2007-05-13 00:16:24
479b56ba50144b30f28c5b225d412125c07def9f...960ccca6803c9fb57429d43572a9545a96107e32,8,84,10,94,20,2007-05-10 22:23:09,2007-05-09 20:56:50
479b56ba50144b30f28c5b225d412125c07def9f...726f852b0ed7e03e88c419a9996c3815911c9db1,6,11,126,137,11,2007-05-10 22:22:33,2007-05-09 18:42:42
fba23c87fda0ac6698f191db6df57b8fdf23e2f8...469be5b258d72cec68c8d4e0c2fe44030bfc8787,1,5,0,5,1,2007-05-09 19:34:00,2007-05-09 16:19:42
469be5b258d72cec68c8d4e0c2fe44030bfc8787...7b6e0eb3c38696c89f7527318e010b339ba978df,1,1,0,1,1,2007-05-10 07:09:28,2007-05-10 07:03:15
7b6e0eb3c38696c89f7527318e010b339ba978df...7f9778b19b07601ae8134fc4ff23b7bf7cac28bd,1,10,4,14,1,2007-05-10 07:42:43,2007-05-10 07:32:07
4a1bb4c3f87f355dd52fcd0babcbd005d59d7ed6...223fa32784c79bdae7e68266511f9b5e0d65d03e,1,2,2,4,2,2007-05-14 21:24:02,2007-05-14 21:24:02
223fa32784c79bdae7e68266511f9b5e0d65d03e...2dc189a3536a367444a4176684c89b994e93e736,1,1,1,2,1,2007-05-14 23:52:02,2007-05-14 14:44:51
2dc189a3536a367444a4176684c89b994e93e736...7b1885d1e74029fe978be739d2d8d911a34ed8bf,2,2,2,4,2,2007-05-15 00:23:52,2007-05-14 14:44:52
7b1885d1e74029fe978be739d2d8d911a34ed8bf...870e0d61d30a943dc050a67574f3f32faff226db,1,19,16,35,9,2007-05-15 00:25:02,2007-05-14 14:44:53
870e0d61d30a943dc050a67574f3f32faff226db...b4b20b2164e433fead84beb526b713a889fc31df,1,5,1,6,3,2007-05-15 00:26:46,2007-05-14 23:55:44
b4b20b2164e433fead84beb526b713a889fc31df...52e7b744d365ad4fcbb49fbb2a7b59ddfea90440,2,38,1,39,2,2007-05-15 00:51:12,2007-05-15 00:49:55
9bc20aa73152784ee758f6432e20820e581c9412...87859f34434dda61cabb03447efd1dd2fe7ebac7,1,1,0,1,1,2007-04-29 00:01:36,2007-04-28 23:59:47
87859f34434dda61cabb03447efd1dd2fe7ebac7...475d1b333a03b0c13cbbc4ebf395fe11c989f931,1,2,0,2,1,2007-04-29 00:03:25,2007-04-29 00:01:27
9bc20aa73152784ee758f6432e20820e581c9412...928c210a47fb7e38c56744bb14570638e6c23d7f,1,1,1,2,1,2007-04-21 00:25:27,2007-04-21 00:25:27
928c210a47fb7e38c56744bb14570638e6c23d7f...4a40cbd949d81863375a10e320f74c8fc595d05e,1,1,1,2,1,2007-04-21 20:06:24,2007-04-21 07:55:00
4a40cbd949d81863375a10e320f74c8fc595d05e...97317061c6799765c7f2f83d8e3f4f74df469793,2,21,8,29,5,2007-04-21 20:57:07,2007-04-21 20:57:07
2de00bf9e8815970c61cefaef35efeacd8a7d6de...851c603e9ca9d0954d89be1532d924a28ccb79fa,1,29,25,54,3,2007-04-20 05:48:21,2007-04-20 05:48:21
8bd9fd50014424643bddfde51423d42e0fc60800...4ab18264e06aa4ad6d9793519828950234caf15d,1,4,1,5,1,2010-08-20 17:53:56,2010-08-20 05:04:02
4ab18264e06aa4ad6d9793519828950234caf15d...f2aff316d3bf99d84e19827099036a933f48aa61,1,1,1,2,1,2010-08-22 04:53:16,2010-08-21 06:21:22
c11969de93e741ae42d1d1d60ce716de6cf5e22b...09a0ec58ce57413dcb2b2cfb4b4ece11ad616e7b,1,4,1,5,2,2010-08-20 18:17:28,2010-08-20 17:41:47
7193db3685b71be3e93aaac785bdc554d91d2167...56333bac66ccdefa3f6d67f78da9f5267119c4a6,1,27,0,27,1,2007-03-05 22:49:22,2007-03-05 15:37:54
7193db3685b71be3e93aaac785bdc554d91d2167...734c91f9e292cf6ed1401c178bc9fbb902cc82dd,1,11,5,16,4,2007-03-05 17:31:09,2007-03-05 17:31:09
734c91f9e292cf6ed1401c178bc9fbb902cc82dd...2f6dc35d2ad0bd2a8648902a692f087f47d1ee86,1,8,1,9,1,2007-03-05 17:43:14,2007-03-05 17:43:14
f8ce1829922ee13016d56c5de0bba2c87f1d4ede...c2b8b13494f3de6bd9a22162973e4df32665a966,1,27,7,34,8,2007-04-11 00:24:35,2007-04-06 21:58:11
c2b8b13494f3de6bd9a22162973e4df32665a966...b06dcf8cb83a9b7655bad5f0f6d84e68fc78beb3,1,7,4,11,5,2007-04-11 00:24:35,2007-04-06 21:58:24
4848509a970e5c805a06fdba12c3377472308443...b9b727ddb3c9e005bc4e9af0b990b6ef06d7f621,1,2,0,2,1,2010-01-30 23:59:09,2010-01-30 23:59:09
ab22aed3b7517c6390cb622b368bfcf503b7a37a...a8ee75bc7a2ddbb10e0a4303b21bb5c300f98cc2,1,4,4,8,2,2007-04-14 10:14:12,2007-04-13 16:24:13
a8ee75bc7a2ddbb10e0a4303b21bb5c300f98cc2...6e2f441bd42c55c73b5e7ac1fdc2aded07901cb3,1,34,0,34,2,2007-04-14 10:14:14,2007-04-13 16:25:01
6e2f441bd42c55c73b5e7ac1fdc2aded07901cb3...f0807e62b42df51a079c730dcf4868de9ad44ea5,1,32,13,45,10,2007-04-14 10:14:16,2007-04-13 16:26:04
ab22aed3b7517c6390cb622b368bfcf503b7a37a...ea376fa7f2c209593bcc63008a2831fe013d4e39,1,34,0,34,2,2007-04-13 04:24:33,2007-04-13 04:03:39
ea376fa7f2c209593bcc63008a2831fe013d4e39...9129e056fb021df45d98c9472b6029456941a508,1,29,13,42,9,2007-04-13 04:24:34,2007-04-13 04:08:52
d8b6a1a10b93666246984a50d64a163e71163aeb...a8f4ef727a7e626f23878e7e3f9f19f0a1052df0,1,15,8,23,7,2007-04-02 20:29:38,2007-04-02 20:29:38
a8f4ef727a7e626f23878e7e3f9f19f0a1052df0...bbf4b41baff11d9fdc353c60527f258e84223121,1,1,0,1,1,2007-04-04 02:04:56,2007-04-03 16:33:46
bbf4b41baff11d9fdc353c60527f258e84223121...04483524ecfe67e4d4f120b0bf6d91b43a02d40a,1,10,10,20,9,2007-04-04 02:04:56,2007-04-03 16:27:28
d8b6a1a10b93666246984a50d64a163e71163aeb...3cfaf11b1dc742dcbbf48dd3d6a5ce376e23a2b8,1,18,3,21,10,2007-04-01 06:59:47,2007-03-28 11:00:23
3cfaf11b1dc742dcbbf48dd3d6a5ce376e23a2b8...81b63c707ed5962d45bd575c946a7127c19a3e35,3,38,1,39,8,2007-04-01 06:59:47,2007-03-28 11:12:07
81b63c707ed5962d45bd575c946a7127c19a3e35...6bdb18a9cef9124937941c6e5bd2b645c9da6537,1,24,3,27,6,2007-04-01 06:59:47,2007-03-28 11:22:02
6bdb18a9cef9124937941c6e5bd2b645c9da6537...68daee085cef975c76d9eeba91a3836cf88bcc3f,1,1,3,4,2,2007-04-01 06:59:47,2007-03-29 10:06:48
68daee085cef975c76d9eeba91a3836cf88bcc3f...30551781938ec98811b8903b653c58ee95368fe4,1,2,0,2,2,2007-04-01 06:59:48,2007-03-30 07:59:43
d8b6a1a10b93666246984a50d64a163e71163aeb...7878b383d6c87824d7c33fa5bfcd0c38aa3f51f5,1,26,0,26,7,2007-04-01 06:59:42,2007-03-27 10:26:01
7878b383d6c87824d7c33fa5bfcd0c38aa3f51f5...7a585c0e6ad872af9a7b88c7c4760a2c606be1ec,1,21,4,25,7,2007-04-01 06:59:42,2007-03-27 11:25:15
7a585c0e6ad872af9a7b88c7c4760a2c606be1ec...5250929d6010083779d334634dcd6766de045b1f,1,4,5,9,2,2007-04-01 06:59:42,2007-03-27 16:03:43
5250929d6010083779d334634dcd6766de045b1f...faced1af7112353bcb67e033cd2a4fb47e21b201,1,5,1,6,3,2007-04-01 06:59:42,2007-03-29 10:07:47
d8b6a1a10b93666246984a50d64a163e71163aeb...02f0559ebafffac3af362ea1b1b0ee009090efa1,1,37,18,55,6,2007-04-01 06:58:10,2007-03-26 21:00:54
02f0559ebafffac3af362ea1b1b0ee009090efa1...3cc5ca3923c4db78d638fb94a3dfb70f103267bf,1,55,28,83,10,2007-04-01 06:58:10,2007-03-28 16:44:34
d8b6a1a10b93666246984a50d64a163e71163aeb...9fc42d609197ef331f1c5b2ce5ef6fc9f2ee634f,5,95,9,104,13,2007-04-01 00:41:32,2007-03-31 03:39:30
1c2c6112a4bf655faa768ddfca067945edf2809e...2a4646904a3766abeca7741f15a481d79e97e9e7,1,26,6,32,5,2007-03-24 06:38:32,2007-03-23 07:40:54
2a4646904a3766abeca7741f15a481d79e97e9e7...1daa09d9a833d3969b64e763865a58df56bc3871,1,151,98,249,28,2007-03-24 06:38:32,2007-03-24 00:54:03
2603fa5fb358ee7834bc9e1a2e391f69d8fce815...620d3f4216e5a9cf29f1de8c91ea5380e766238c,1,6,0,6,1,2007-03-26 00:42:32,2007-03-26 00:42:32
3efb1f343a9d6214a59a814029cab96638e9b915...c750da256a54f189de28d3deb054328d67f9b9be,1,6,3,9,3,2007-02-21 16:09:57,2007-02-14 16:03:12
bb9e15a83c425ff31e4da6b004bd4557d528b755...86f660b1f1dc207897281a77f969a56b2e551374,1,3,0,3,1,2006-06-21 10:56:00,2006-06-21 02:46:05
bb9e15a83c425ff31e4da6b004bd4557d528b755...b1c71b72815cb82a8bad14020a047320b88a04eb,1,163,14,177,9,2006-06-21 09:34:14,2006-06-21 01:26:34
b1c71b72815cb82a8bad14020a047320b88a04eb...363b7817e017b7c7e27a925d766c4d9bacfe4471,2,43,7,50,13,2006-06-21 09:34:14,2006-06-21 05:48:23
363b7817e017b7c7e27a925d766c4d9bacfe4471...efc7fa5355da79326f92716eef37ddd71c7ec034,9,7,263,270,11,2006-06-21 09:34:14,2006-06-21 06:54:26
efc7fa5355da79326f92716eef37ddd71c7ec034...583b7ea31b7c16f872b178d541591ab816d16f85,6,139,23,162,30,2006-06-21 09:50:32,2006-06-21 07:30:21
57bd4d3523efecf60197040cad34154aff4ddf80...7bedd9fc811df1fd865cebdae016f2f278501cc5,1,6,0,6,1,2006-06-20 20:46:30,2006-06-20 06:17:03
7bedd9fc811df1fd865cebdae016f2f278501cc5...1f1ab5f05b8e8b45545d8a406d64887f772a69da,2,246,154,400,68,2006-06-20 21:01:13,2006-06-20 14:58:12
acb70149bc5e9b9d99631a0cb59e7c2f80e92ddd...d2543b8ee3abeb611c352f17a9177732bfde7e36,1,6,12,18,7,2006-06-25 03:16:55,2006-06-24 17:20:32
d2543b8ee3abeb611c352f17a9177732bfde7e36...3eaa38da94c7e683163ebf78465b8681d3e8a211,1,16,9,25,12,2006-06-25 05:18:44,2006-06-24 20:10:11
3eaa38da94c7e683163ebf78465b8681d3e8a211...817151e61a74241df5b5dd206d27086283f28b84,12,48,30,78,26,2006-06-25 06:16:25,2006-06-24 14:01:25
817151e61a74241df5b5dd206d27086283f28b84...29f4ad867cd15f4029c280c417f4a0866d5229a9,1,12,7,19,1,2006-06-25 07:35:52,2006-06-23 22:04:05
acb70149bc5e9b9d99631a0cb59e7c2f80e92ddd...7ccd9009ac1fb4764ddf47a1a924ea917ff9468a,1,22,17,39,7,2006-06-24 12:30:06,2006-06-24 11:13:08
7ccd9009ac1fb4764ddf47a1a924ea917ff9468a...061303f0b50a648db8e0af23791fc56181f6bf93,1,8,7,15,5,2006-06-25 03:08:25,2006-06-24 19:42:20
1ef9e05dbf36a80bb65fb150dd7bdd60852db777...8096fae7269e7b3882394100151bc017446b01a1,7,16,16,32,16,2006-06-27 17:56:05,2006-06-27 16:54:26
8096fae7269e7b3882394100151bc017446b01a1...8dcaefb52f81115d71e1dfa27d45f4a677bcbc09,1,1,1,2,1,2006-06-28 08:18:18,2006-06-28 05:59:23
8dcaefb52f81115d71e1dfa27d45f4a677bcbc09...2386c2975d66e03d02a9ebf15a1d07092975e527,1,15,14,29,11,2006-06-28 08:38:19,2006-06-28 08:38:19
2386c2975d66e03d02a9ebf15a1d07092975e527...dc62e25cbd0ec1726d5108a8caa539e60492cc7a,4,44,12,56,14,2006-06-28 10:20:29,2006-06-28 10:07:14
dc62e25cbd0ec1726d5108a8caa539e60492cc7a...c1927a8554284d0dc5bb7fcf8e79d3877e4a497c,2,230,13,243,20,2006-06-28 10:20:50,2006-06-28 02:39:11
c1927a8554284d0dc5bb7fcf8e79d3877e4a497c...27e9fb8d415a7bbc14001c14580f4c568e246381,2,112,19,131,10,2006-06-28 10:20:50,2006-06-28 02:39:12
27e9fb8d415a7bbc14001c14580f4c568e246381...a00439acd209142167bf891dcf646a6501a814e5,2,167,46,213,26,2006-06-28 10:20:50,2006-06-28 02:39:13
a00439acd209142167bf891dcf646a6501a814e5...80f50749da3441502aabd5b6c5129c9eb3bdf870,1,23,11,34,20,2006-06-28 10:20:51,2006-06-28 02:39:14
80f50749da3441502aabd5b6c5129c9eb3bdf870...33ebb8717f15a85615f712df125c37737062e1b2,1,1,2,3,2,2006-06-28 10:20:51,2006-06-28 09:17:21
33ebb8717f15a85615f712df125c37737062e1b2...66eb64cba64a26dbf2b1d4e319d6514696154fee,1,3,8,11,4,2006-06-28 10:20:51,2006-06-28 09:11:06
66eb64cba64a26dbf2b1d4e319d6514696154fee...554fe20d805693d962bd41647c5dc075cf7f5261,11,16,15,31,16,2006-06-28 10:24:37,2006-06-28 09:04:39
554fe20d805693d962bd41647c5dc075cf7f5261...c78963d280adc11646b95156e3d9271d0404ce7f,1,4,6,10,4,2006-06-28 10:50:33,2006-06-28 10:50:33
c78963d280adc11646b95156e3d9271d0404ce7f...3b44f15a35b3550f34a4f796706fceccdc90d506,1,8,4,12,5,2006-06-28 10:51:00,2006-06-28 10:51:00
3b44f15a35b3550f34a4f796706fceccdc90d506...c5f448b0f2dcba3b14cd8fcae7414def4d3f4e45,1,24,38,62,5,2006-06-28 10:53:37,2006-06-28 10:13:23
c5f448b0f2dcba3b14cd8fcae7414def4d3f4e45...f0ef05967f3b261fb16f5fdea6dd104c9bdb4c8c,1,6,1,7,2,2006-06-28 10:54:31,2006-06-28 10:24:23
f0ef05967f3b261fb16f5fdea6dd104c9bdb4c8c...47e5c0ca2cabb406518dda5c09432dc996f7ef2b,1,3,1,4,2,2006-06-28 10:55:36,2006-06-28 10:45:27
47e5c0ca2cabb406518dda5c09432dc996f7ef2b...8f4a9b62ee16eb018a9d3a675563115e14708953,1,1,0,1,1,2006-06-28 18:45:52,2006-06-28 18:45:52
8f4a9b62ee16eb018a9d3a675563115e14708953...abc02670169cee9541793a86324a014272ca8ed5,2,73,2,75,2,2006-06-29 02:30:51,2006-06-28 18:47:28
1ef9e05dbf36a80bb65fb150dd7bdd60852db777...c6744349df5089133b7662e67aba28282b6a963f,6,136,144,280,58,2006-06-26 21:58:40,2006-06-24 17:21:53
c6744349df5089133b7662e67aba28282b6a963f...a610786f4bc282410d348aba97316115a57740a0,2,14,36,50,7,2006-06-26 21:58:40,2006-06-24 17:23:06
a610786f4bc282410d348aba97316115a57740a0...c9b5ef998a3027d9f11b0820bb13896096833ccb,7,18,3,21,9,2006-06-26 21:58:40,2006-06-24 17:24:14
c9b5ef998a3027d9f11b0820bb13896096833ccb...0e677e1a6b0d1c0e848ed19d18dda1c3c797c75e,2,2,6,8,3,2006-06-26 21:58:41,2006-06-24 17:25:08
0e677e1a6b0d1c0e848ed19d18dda1c3c797c75e...39bc9a6c2051a9fc31dc9b34b40bdd3dd94a8afb,6,14,13,27,11,2006-06-26 21:58:41,2006-06-25 10:54:14
39bc9a6c2051a9fc31dc9b34b40bdd3dd94a8afb...5e2b0636c709884e45ef941cd4514c225f204982,1,5,6,11,4,2006-06-26 21:58:41,2006-06-25 11:28:19
5e2b0636c709884e45ef941cd4514c225f204982...9dafea267806988d7f5821780de688ca84766a40,1,16,11,27,7,2006-06-26 21:58:41,2006-06-25 12:39:35
9dafea267806988d7f5821780de688ca84766a40...946c3784a3586e70c70c3a676f590654ca39a3cb,1,42,5,47,10,2006-06-27 17:59:34,2006-06-27 12:09:17
946c3784a3586e70c70c3a676f590654ca39a3cb...f005df391057ce8487a6b2f9896f8e0507351be8,1,1,0,1,1,2006-06-27 18:03:41,2006-06-27 12:39:29
f005df391057ce8487a6b2f9896f8e0507351be8...17985627455901b6ae3a471b67d46239463cebb5,1,0,1,1,1,2006-06-27 18:04:16,2006-06-27 13:27:51
17985627455901b6ae3a471b67d46239463cebb5...3223847a8fbd6200e38f4a8f1146ca9dc20a813e,1,0,3,3,1,2006-06-27 18:04:47,2006-06-27 16:43:22
1ef9e05dbf36a80bb65fb150dd7bdd60852db777...fcb3d0adc13b398c930814a5e0c886717acc1b70,2,141,0,141,2,2006-06-26 21:44:03,2006-06-25 01:51:08
fcb3d0adc13b398c930814a5e0c886717acc1b70...9c6efa366eed0526e82a052b77227451273af0c3,1,80,0,80,6,2006-06-26 21:44:04,2006-06-25 01:52:01
9c6efa366eed0526e82a052b77227451273af0c3...ece3c67f9c8f0074cae76204a648cbfc6075bb44,1,69,0,69,1,2006-06-26 22:40:09,2006-06-26 22:40:09
ece3c67f9c8f0074cae76204a648cbfc6075bb44...8780bd8fd2fb9a85c39de8d7d3105b94c6a9cf40,1,4,4,8,4,2006-06-27 17:55:33,2006-06-27 08:12:12
8780bd8fd2fb9a85c39de8d7d3105b94c6a9cf40...81db094107df9a73a0be4538a74a26115a84dd13,1,4,10,14,2,2006-06-27 23:03:59,2006-06-27 20:38:04
81db094107df9a73a0be4538a74a26115a84dd13...982b64e4ccc993e51a7e7a1e1713953ecf95e4f2,1,3,3,6,2,2006-06-29 05:48:34,2006-06-29 05:48:34
982b64e4ccc993e51a7e7a1e1713953ecf95e4f2...9fdc3bb5c20e37e410e03ed5b6c71a7e647ccee8,1,1,1,2,1,2006-06-29 05:49:42,2006-06-29 05:49:42
1ef9e05dbf36a80bb65fb150dd7bdd60852db777...3c2f75b590c35675cc67dc43cabe2298bec86afc,72,2579,0,2579,72,2006-06-26 21:36:40,2006-06-26 20:46:52
3c2f75b590c35675cc67dc43cabe2298bec86afc...47979d5d5bb86d058dce77801648734abe1e593b,18,1263,3,1266,24,2006-06-27 06:29:11,2006-06-27 06:29:11
f6075ebadb1fce2bd75f2dd68b8aeae40a69158a...e5ea701b8e2901dd01b50e9ca296ad940cd65cbc,1,32,69,101,11,2005-08-18 10:40:39,2005-08-18 10:40:39
2b64f88f09ae2169ec85652b46897574e352936d...0b9442d618bedd5bef7ec4ef5829b82df57e89eb,1,22,7,29,5,2005-08-12 01:26:12,2005-08-10 23:26:32
0b9442d618bedd5bef7ec4ef5829b82df57e89eb...b4ad66b7785c27ba05df78841b6f599e7207ee3d,1,68,6,74,5,2005-08-12 01:26:13,2005-08-12 01:13:55
b4ad66b7785c27ba05df78841b6f599e7207ee3d...5acc5bfd6303f1fec4b3d175a15a2ff800983be7,8,44,8,52,10,2005-08-12 01:26:14,2005-08-10 23:54:36
5acc5bfd6303f1fec4b3d175a15a2ff800983be7...8e832ebce61e6b82c7187365cbf12b2ef614c188,1,4,4,8,4,2005-08-12 01:26:14,2005-08-11 05:53:27
8e832ebce61e6b82c7187365cbf12b2ef614c188...da7bc9b081ad8e45c997678c4ab4e7da9cd335ed,4,7,0,7,4,2005-08-12 01:26:15,2005-08-11 02:15:02
da7bc9b081ad8e45c997678c4ab4e7da9cd335ed...d9bdd39eee54ebd77bc01235c00e827ddbe892d0,1,2,1,3,2,2005-08-12 01:26:15,2005-08-11 02:10:01
d9bdd39eee54ebd77bc01235c00e827ddbe892d0...4d9d62fa7ca01c481d224e2a2187e38ec2f0996a,7,39,28,67,30,2005-08-12 01:26:16,2005-08-11 03:56:21
4d9d62fa7ca01c481d224e2a2187e38ec2f0996a...41184273d173c252532b3aba730ee7fdf35291f4,1,5,3,8,6,2005-08-12 01:26:16,2005-08-11 16:00:40
41184273d173c252532b3aba730ee7fdf35291f4...a6bc31338ee99b1ade13b260c96800ea826bb9d1,1,2,1,3,1,2005-08-12 01:52:34,2005-08-12 01:52:34
a6bc31338ee99b1ade13b260c96800ea826bb9d1...f88fcf8bab6a3dcd1255bc64f50235c745458962,1,32,25,57,4,2005-08-12 01:59:19,2005-08-11 23:38:09
f88fcf8bab6a3dcd1255bc64f50235c745458962...0d62fb5672c7b6e3fc6c5418d61ff39bf6034741,1,1,0,1,1,2005-08-12 05:08:29,2005-08-12 03:17:55
df6a6f0e87c44ff6daab7de3fde2237555ae95ac...bf570303153902ec3d85570ed24515bcf8948848,1,6,0,6,1,2005-08-10 21:43:08,2005-08-10 21:43:08
010b260e6f23b8964ef53b989e1c1baa8973edbe...082afee621aeb2d3746c8ae290af98823f981f34,1,18,2,20,2,2012-04-27 08:28:54,2012-04-26 19:34:02
78d3b06e0f5e6aaea001ee8e3e7c8e401dc4b244...55d5d5bab7c3f9ab6310b9cf436a7935d7d32165,1,5,8,13,5,2009-07-22 22:37:55,2009-07-22 21:48:28
55d5d5bab7c3f9ab6310b9cf436a7935d7d32165...b810cbbde9232cbe9a3841edccc5b606bbd3a82e,2,93,7,100,5,2009-07-22 22:38:22,2009-07-22 21:48:29
b810cbbde9232cbe9a3841edccc5b606bbd3a82e...735c674416b87505400fcf738fd3a38b52f0eccb,2,20,3,23,2,2009-07-23 01:54:55,2009-07-23 00:24:38
78d3b06e0f5e6aaea001ee8e3e7c8e401dc4b244...1830d9cb62772c0626297e4bb6e537664283ebfa,2,81,1,82,2,2009-07-22 18:15:06,2009-07-22 16:38:58
26192bee8e632e27d361d0d67a6e2a544fb1489b...647ac702d83b7ec8dbe6abe566151a064257433f,1,60,60,120,48,2009-07-08 17:42:27,2009-07-07 20:22:19
647ac702d83b7ec8dbe6abe566151a064257433f...6c32a7a99495da3f49e2a142791bc10af3f6f059,1,101,110,211,57,2009-07-08 17:42:27,2009-07-07 20:22:20
6c32a7a99495da3f49e2a142791bc10af3f6f059...eb1f7e0dc0b606bba2af0ec61d4d307f975c83ef,1,11,10,21,2,2009-07-08 17:42:27,2009-07-07 20:22:21
eb1f7e0dc0b606bba2af0ec61d4d307f975c83ef...0da3e1d21f931aef887ff30b2ebf171e3f343ff7,1,4,4,8,1,2009-07-08 17:42:27,2009-07-07 20:22:22
dd787c19c4f011cc3adb422ef856f2c58d989640...f581de1b7b9d17c83b188bf8ffe536fb8a9dd2a4,1,6,5,11,1,2009-07-06 16:45:00,2009-06-30 05:08:38
c5764c095c2a563b657c1bd8f4a3e47bdeee14b0...69932bc6117d7ec2689557693ad300756c961cdc,2,67,81,148,12,2009-06-21 06:50:42,2009-06-21 04:40:46
702beb3af0531bae95ab559fff043785614d53f2...606475f3178784e5a6b3a01dce1a54314345cf43,4,17,13,30,10,2009-07-02 02:46:30,2009-07-01 20:18:04
6abe0f0383a9b77266810df0d1109b6d0783906e...478524508e2f49af8cc76f2d7294a3b33facf121,1,20,8,28,5,2007-07-07 21:18:13,2007-07-04 05:10:42
478524508e2f49af8cc76f2d7294a3b33facf121...76e4f5d025d80479c3a01ed9c65b024e9b80d931,1,2,2,4,2,2007-07-07 21:18:29,2007-07-03 22:11:23
76e4f5d025d80479c3a01ed9c65b024e9b80d931...40375a83d2bc3e2c86f998fe47fef573502a9922,1,9,3,12,3,2007-07-07 21:18:29,2007-06-28 18:57:07
40375a83d2bc3e2c86f998fe47fef573502a9922...c956395e2bf94a50fe843935605914573f4c7787,2,7,0,7,2,2007-07-07 21:18:29,2007-06-28 22:15:22
c956395e2bf94a50fe843935605914573f4c7787...d3a93dc96786847f9d148da42ecadee5f027c9a7,1,16,6,22,3,2007-07-08 07:25:59,2007-07-08 07:25:59
d3a93dc96786847f9d148da42ecadee5f027c9a7...b24f56d60491416a1c5a8fc71863bbaa0f390f23,1,3,3,6,2,2007-07-09 01:24:18,2007-07-08 08:28:18
b24f56d60491416a1c5a8fc71863bbaa0f390f23...4017761fd89060f2b57d7799f6bbda8b3568d3d4,4,28,9,37,8,2007-07-09 01:24:19,2007-07-08 12:41:21
4017761fd89060f2b57d7799f6bbda8b3568d3d4...a7342913e21a96597f38ce0b48e3093c9739df1f,1,11,9,20,2,2007-07-09 01:24:19,2007-07-06 14:42:27
a7342913e21a96597f38ce0b48e3093c9739df1f...561b0fbb4a2d336faeb929380bddd6ec420d7b11,1,6,4,10,3,2007-07-09 01:24:19,2007-07-08 21:42:05
561b0fbb4a2d336faeb929380bddd6ec420d7b11...797e99a27848a0f6da1f3c85cb3714652fde23ba,1,11,0,11,1,2007-07-09 01:24:19,2007-07-08 19:36:34
797e99a27848a0f6da1f3c85cb3714652fde23ba...18640d991bde7e081fb851cea5114c09472b188f,2,32,10,42,10,2007-07-09 01:24:19,2007-07-08 02:01:29
18640d991bde7e081fb851cea5114c09472b188f...3df0a859aa5cc68a2bd616cb686f01cf0e2468c1,1,4,4,8,2,2007-07-09 01:24:19,2007-07-08 02:02:13
3df0a859aa5cc68a2bd616cb686f01cf0e2468c1...8e4a91bd780b89c7337f281a8601f2e0cae108fc,2,14,0,14,3,2007-07-09 01:24:19,2007-07-08 02:02:47
8e4a91bd780b89c7337f281a8601f2e0cae108fc...82576ddb70d0a2ed88fa3fee2f4ad05ab5b77401,1,3,0,3,1,2007-07-09 01:24:19,2007-07-08 20:32:22
f9308a182e220c97cdbf90ee8de2ce21980cb7e9...290b1467a387a3e5306028f36118a52958fa36c5,1,2,2,4,2,2007-03-25 05:25:40,2007-03-06 03:58:56
290b1467a387a3e5306028f36118a52958fa36c5...346d5e1835937d701785300717ce34f92609c2b3,1,3,3,6,3,2007-03-25 05:25:47,2007-03-07 01:21:25
346d5e1835937d701785300717ce34f92609c2b3...4ae89b76252d1c13a6675a2a4e491983946d72ec,1,1,1,2,1,2007-03-25 05:25:55,2007-03-24 19:59:13
4ae89b76252d1c13a6675a2a4e491983946d72ec...cd67c8e0bc6f61ffccc12d1775bc1a200df5fe85,1,184,0,184,1,2007-03-25 05:26:33,2007-03-24 19:59:53
9529a2524a29c15107905f2f8f0b310a40880dc7...3e63e0df4f1a1610782e679be56ea75f820343fc,1,1,1,2,1,2007-03-29 08:38:11,2007-03-29 06:41:42
3e63e0df4f1a1610782e679be56ea75f820343fc...c2c6d9302a98ae4c4c76822a1c83551c039271a0,1,8,8,16,1,2007-03-29 08:38:28,2007-03-29 06:42:44
c2c6d9302a98ae4c4c76822a1c83551c039271a0...3ac53e0d13fa7483cce90eb6a1cfcdcbda5b8e35,1,1,0,1,1,2007-03-29 08:41:23,2007-03-27 23:45:06
b8848f7753762ff8c4e34b3c15e788c5f7e6781f...c289f6fa1f8642a5caf728ef8ff87afd5718cd99,1,14,6,20,2,2007-06-02 03:08:29,2007-06-01 23:09:56
c289f6fa1f8642a5caf728ef8ff87afd5718cd99...160e82284eda034fea84dcc946f9c1965176f25f,1,1,1,2,1,2007-06-02 03:12:56,2007-06-01 22:20:30
cdd5b82ee8e6941eee9c7b09df63c44789fd5c4b...dfab71cb923d031715ebc3cf9f920d801250c552,1,36,0,36,1,2007-05-29 06:54:35,2007-05-27 10:52:11
dfab71cb923d031715ebc3cf9f920d801250c552...c78974f7b6a6a0e9f848907620b4361ee088f7c2,1,1,1,2,1,2007-05-29 06:54:35,2007-05-26 19:16:27
c78974f7b6a6a0e9f848907620b4361ee088f7c2...893c365abab7806354ab5b268e38e88ea81b8e38,1,5,3,8,2,2007-05-29 07:11:22,2007-05-27 12:33:06
893c365abab7806354ab5b268e38e88ea81b8e38...548428954aa088aecd88805aa5a8e64aee0d3e8b,1,11,1,12,1,2007-05-29 07:11:22,2007-05-27 12:33:07
548428954aa088aecd88805aa5a8e64aee0d3e8b...a192a909c0cdb8ea09b6513c4839fd6762989cb1,1,2,2,4,2,2007-05-29 07:11:22,2007-05-27 12:33:08
71a9db534a6bb4a6e9824c01b557a96ccaae0e89...fc4e8da727d5c1737322b14386282456fd3c99c9,1,15,20,35,4,2007-06-01 03:37:34,2007-05-31 00:39:46
d6b3e3a33f71910526ccf80af6c13a230363cd89...b6e4db6a9974766ae8855501b63ec331a1c737da,1,3,1,4,1,2007-05-19 00:28:24,2007-05-19 00:28:24
43d151a1b087db22e2f9a754772b469de1194f67...785cdea9befecc63b2b576c8042c5482fbf7bceb,1,19,11,30,6,2007-05-14 01:22:54,2007-05-13 10:39:22
785cdea9befecc63b2b576c8042c5482fbf7bceb...331b51d24050c221221049421a924c1a150887db,6,60,39,99,21,2007-05-14 01:44:50,2007-05-13 23:25:45
52e7b744d365ad4fcbb49fbb2a7b59ddfea90440...df8cfac815a1fae75afd20a86beb194d9d947971,1,1,1,2,1,2007-05-16 18:54:22,2007-05-16 16:22:26
52e7b744d365ad4fcbb49fbb2a7b59ddfea90440...045fe3ccdaeb81f12f657b44b5a117b65d9d38e2,1,1,1,2,1,2007-05-15 03:17:00,2007-05-15 02:51:02
045fe3ccdaeb81f12f657b44b5a117b65d9d38e2...cf606e3ddd8666b990a6560be77eb9f28af0e47d,2,7,1,8,2,2007-05-16 01:14:42,2007-05-15 16:33:25
97317061c6799765c7f2f83d8e3f4f74df469793...c7f34c180b7117cf60ad12a8b180eed33716e390,2,8,1,9,3,2007-04-23 08:44:00,2007-04-23 08:21:25
c7f34c180b7117cf60ad12a8b180eed33716e390...81178fe48c1466f400741842f9e3da1528cfd124,1,1,1,2,1,2007-04-23 23:58:10,2007-04-23 23:56:45
81178fe48c1466f400741842f9e3da1528cfd124...6777c3806da18d4a3a05e5bcdde0aa9efb9b3b9f,1,1,1,2,1,2007-04-24 05:14:24,2007-04-24 00:32:04
6777c3806da18d4a3a05e5bcdde0aa9efb9b3b9f...ce748f59923b3a3d432d6e8a12366f71284b595f,1,1,2,3,1,2007-04-24 05:19:36,2007-04-24 00:02:34
ce748f59923b3a3d432d6e8a12366f71284b595f...bbc6354171a08e2c43d651f8645bcdb76bf9f92b,1,2,0,2,2,2007-04-24 06:17:41,2007-04-24 06:17:41
bbc6354171a08e2c43d651f8645bcdb76bf9f92b...41728d69426dd707d4978929f8f4ac7a16f115f3,1,2,0,2,1,2007-04-24 06:55:08,2007-04-23 12:06:29
754eeb33df25b5e34508c5b9cfef374f4929998d...9398e5aa1698cdb518f7118e6f6eeebbea7f5e58,1,284,0,284,1,2007-04-20 06:27:09,2007-04-20 06:08:47
9398e5aa1698cdb518f7118e6f6eeebbea7f5e58...413689d36f9b98c57bff9510ac4cdfb40e4ef9fc,1,28,14,42,8,2007-04-20 06:27:51,2007-04-19 11:16:58
413689d36f9b98c57bff9510ac4cdfb40e4ef9fc...744747ef1d75c85fb3a1785cb08d36497128d3d3,1,52,52,104,87,2007-04-20 06:28:15,2007-04-19 04:51:06
f9c33605700e37b75279ed6ce4bffaad3eb0cf10...24c61c44e65f672ffcd032e43519824719d249c4,1,5,2,7,3,2010-08-24 16:28:02,2010-08-23 12:08:22
f9c33605700e37b75279ed6ce4bffaad3eb0cf10...e860795d8a4556114a11224da246e127cbee5807,1,5,4,9,1,2010-08-20 21:15:47,2010-08-20 10:20:36
e860795d8a4556114a11224da246e127cbee5807...438ded457b6e0d1e615edd593faeeafdc8818fea,2,3,1,4,2,2010-08-20 21:16:21,2010-08-20 10:21:53
438ded457b6e0d1e615edd593faeeafdc8818fea...f1005987e2c5295f57b19504baa86f1e8fc4a8c2,2,3,2,5,2,2010-08-20 21:16:21,2010-08-20 10:23:54
f1005987e2c5295f57b19504baa86f1e8fc4a8c2...1b6c6cf006eb18cbd7c93b53a8cb494bd35e963a,1,2,2,4,2,2010-08-20 21:16:21,2010-08-20 10:26:13
1b6c6cf006eb18cbd7c93b53a8cb494bd35e963a...3988da063611de7391f794791a4622caf47c0708,1,2,2,4,2,2010-08-20 21:16:21,2010-08-20 10:28:53
3988da063611de7391f794791a4622caf47c0708...c300578f12ec23ba22f16af16259650e38e88f87,1,3,3,6,2,2010-08-20 21:16:21,2010-08-20 10:30:24
c300578f12ec23ba22f16af16259650e38e88f87...9257a1efe1f8a0e8244da6f4a4d8178fbb41699d,1,2,2,4,2,2010-08-20 21:16:21,2010-08-20 10:30:56
9257a1efe1f8a0e8244da6f4a4d8178fbb41699d...12378c0aa8d06cb0e965935ca6d393a9b66b095a,7,10,10,20,9,2010-08-20 21:16:22,2010-08-20 10:31:58
12378c0aa8d06cb0e965935ca6d393a9b66b095a...6dcca4d0ea4fe9ee09c939eaa0898f5895e5100a,1,4,4,8,3,2010-08-20 21:16:22,2010-08-20 10:32:36
6dcca4d0ea4fe9ee09c939eaa0898f5895e5100a...e1906c46697a5081a0e2d7667f5325557a477418,1,4,4,8,3,2010-08-20 21:16:22,2010-08-20 10:33:48
e1906c46697a5081a0e2d7667f5325557a477418...fc621bd08aefb9e81c85998247197137f383aa3d,1,1,1,2,1,2010-08-20 21:16:22,2010-08-20 10:34:29
fc621bd08aefb9e81c85998247197137f383aa3d...4cacbf677d4747e02586ca6f12d16cf8b5dc34e8,1,5,4,9,3,2010-08-20 21:16:22,2010-08-20 10:35:03
4cacbf677d4747e02586ca6f12d16cf8b5dc34e8...70676e69a58025ff6e224bd6f0ed80ae1b158388,1,9,9,18,8,2010-08-20 21:16:50,2010-08-20 10:37:51
70676e69a58025ff6e224bd6f0ed80ae1b158388...3c56c84eb8d6e74a6a0457ddc3853f2f0200acb5,1,2,2,4,2,2010-08-20 21:16:50,2010-08-20 10:38:14
3c56c84eb8d6e74a6a0457ddc3853f2f0200acb5...b9190e79134ceea2ed0f4a3d1aa90ce6398858f7,4,4,4,8,4,2010-08-20 21:16:51,2010-08-20 10:39:48
b9190e79134ceea2ed0f4a3d1aa90ce6398858f7...4fccc0494aa04a061f351217cd59ce02291be026,1,1,1,2,1,2010-08-20 21:16:51,2010-08-20 10:40:31
4fccc0494aa04a061f351217cd59ce02291be026...a5218458009620ba5142438b01a0032ee00ea395,1,4,4,8,1,2010-08-20 21:19:46,2010-08-20 10:37:06
c2d4eb7e04397595aa1369414aaab52f27bb9e3a...043d76050d3136b8684b5a3938e8bc0c1f8483fd,1,6,0,6,1,2007-03-06 05:21:09,2007-03-05 19:46:05
043d76050d3136b8684b5a3938e8bc0c1f8483fd...b8105375abfeee54e0a34e1c290983fd15e743cf,2,5,3,8,3,2007-03-06 05:21:39,2007-03-06 03:27:44
566f5b217df73d6a642a0857cc5c13c11f84e7c3...2d9e4a47d16e9d2100cc88ef6126aa7619be51ed,4,31,11,42,10,2007-04-12 01:48:30,2007-04-11 23:58:07
2d9e4a47d16e9d2100cc88ef6126aa7619be51ed...171ddd91771f042e49db49ff068694b5ed6f845d,2,165,0,165,2,2007-04-12 01:48:40,2007-04-11 23:58:08
171ddd91771f042e49db49ff068694b5ed6f845d...6aead43db34313e6cdbc72e2f7a70f6b82c78cf2,4,22,18,40,8,2007-04-12 02:13:55,2007-04-09 23:01:44
00d3278c8534a8244ae3447189401111e017fd5d...c32056e0ef193002f80d75fd795e156ddf65c4ab,1,2,0,2,1,2010-01-31 00:08:41,2010-01-31 00:04:25
aa3698516109df16f763ed2f0182075edabd7ea0...b8652b4de0e9b386f9a93fbfb1dac06df230cd0a,1,1,4,5,1,2007-04-17 04:44:40,2007-04-17 04:40:50
b8652b4de0e9b386f9a93fbfb1dac06df230cd0a...f948792990f82a35bf0c98510e7511ef8acb9cd3,1,1,1,2,1,2007-04-17 05:07:12,2007-04-17 04:51:48
f9135dbcdda7319d12dfc7b5e0b86138719cd3ad...5698454ea052369dc98d38b45c21307b07a6c4a3,1,25,7,32,6,2007-04-15 00:42:58,2007-04-14 23:22:08
5698454ea052369dc98d38b45c21307b07a6c4a3...04786756f90a734445cc300a5acf9fcfc9fd4c04,1,20,0,20,2,2007-04-15 19:52:48,2007-04-15 18:14:28
04786756f90a734445cc300a5acf9fcfc9fd4c04...1c3e5c4ebc326c5c70350d3f4dc7f2b29e813480,1,85,0,85,1,2007-04-19 00:08:42,2007-04-18 23:55:45
045f5759c97746589a067461e50fad16f60711ac...89815cab95268e8f0f58142b848ac4cd5e9cbdcb,3,187,16,203,11,2007-04-04 05:47:01,2007-04-04 05:47:01
c0718268e810895d33a81929bebb7441c6582de6...a23f0a73d10542297249b3c57cad0b7cd63b87be,1,24,24,48,12,2007-04-04 09:37:34,2007-04-01 20:21:38
a23f0a73d10542297249b3c57cad0b7cd63b87be...3be8e720d95f8d040dbfdd8a579616a9423280df,1,8,8,16,5,2007-04-04 09:37:35,2007-04-01 20:22:21
3be8e720d95f8d040dbfdd8a579616a9423280df...e421fc0797d0a6c8a40bce96c4383223c8ae2da7,1,4,1,5,3,2007-04-04 09:37:35,2007-04-03 08:57:08
e421fc0797d0a6c8a40bce96c4383223c8ae2da7...d5ad36fe3584551a09160edce3e76d559d412ae5,1,1,1,2,1,2007-04-04 23:01:49,2007-04-04 18:32:33
d5ad36fe3584551a09160edce3e76d559d412ae5...d72308e01c5977177cda0aed06cfeee9192e1247,6,24,25,49,16,2007-04-05 21:59:47,2007-04-04 20:49:04
d72308e01c5977177cda0aed06cfeee9192e1247...566842f62bdf1f16c2e94fb431445d2e6c0f3f0b,3,15,3,18,6,2007-04-05 22:00:03,2007-04-04 14:46:14
566842f62bdf1f16c2e94fb431445d2e6c0f3f0b...b18825876ae60e67e646097945c8365779175ee2,1,10,3,13,3,2007-04-05 22:07:16,2007-04-04 13:14:14
b18825876ae60e67e646097945c8365779175ee2...0424138d5715dbf8605bacfbd22210aac85a1a8f,3,2,3,5,3,2007-04-05 22:07:16,2007-04-02 04:13:27
0424138d5715dbf8605bacfbd22210aac85a1a8f...ec0cc704692a83c1d01b53f366b9919accdd4268,1,13,6,19,7,2007-04-05 22:07:16,2007-04-02 04:34:34
ec0cc704692a83c1d01b53f366b9919accdd4268...81e1bc47687dc78598ad003f0d02a328a6ddae72,1,2,2,4,2,2007-04-05 22:07:16,2007-04-02 05:07:26
81e1bc47687dc78598ad003f0d02a328a6ddae72...7da3bf372cfcd25ea44164afb90c306836b62e23,1,6,6,12,5,2007-04-05 22:07:16,2007-04-02 05:46:06
7da3bf372cfcd25ea44164afb90c306836b62e23...fd1c3bf0533c6cc7e44646d4e52d378d5b5a1631,4,4,4,8,4,2007-04-05 22:07:16,2007-04-02 05:14:40
fd1c3bf0533c6cc7e44646d4e52d378d5b5a1631...33580fbd308593e36395926fd35b501976ad322a,1,1,1,2,1,2007-04-05 22:07:16,2007-04-05 19:31:53
c0718268e810895d33a81929bebb7441c6582de6...21cd8d00b6908dd8e1d4a5d101c1ba49d3645053,1,31,9,40,8,2007-04-04 07:19:28,2007-03-30 08:55:37
21cd8d00b6908dd8e1d4a5d101c1ba49d3645053...7f7932ab25f2ddd6080c8b1e8bfd698e523eb7d4,1,7,7,14,6,2007-04-04 07:19:28,2007-04-02 07:06:12
7f7932ab25f2ddd6080c8b1e8bfd698e523eb7d4...9a4d8fdc25d6ba08564766c6ded165212f423b61,2,8,9,17,9,2007-04-04 07:19:28,2007-04-02 22:06:59
9a4d8fdc25d6ba08564766c6ded165212f423b61...2960a1d9eef846de9cfd9d6e32d203339d792120,1,1,0,1,1,2007-04-04 07:19:29,2007-04-02 19:40:19
2960a1d9eef846de9cfd9d6e32d203339d792120...b8ba1535bda7bd553f46ea57bdbcee1c90e500a0,1,8,2,10,3,2007-04-04 07:19:29,2007-04-02 23:29:56
b8ba1535bda7bd553f46ea57bdbcee1c90e500a0...c81935348be263de3da085e6ac828b583a85c905,1,112,1,113,3,2007-04-04 07:25:10,2007-03-16 06:25:22
00cec846f157b5363b0967d1e4cba76b44d48e77...cc96fd092a55a7a8685f0dee1e287ded70bc08b7,1,10,7,17,5,2007-03-23 00:32:51,2007-03-23 00:32:51
cc96fd092a55a7a8685f0dee1e287ded70bc08b7...3007a78033fec09b97ff1ca816a2d23c292dd956,1,2,1,3,1,2007-03-23 01:08:37,2007-03-23 01:05:28
3007a78033fec09b97ff1ca816a2d23c292dd956...cc65343a8436896f4c78f5f802595870784df454,1,2,2,4,2,2007-03-23 08:48:29,2007-03-22 16:18:08
cc65343a8436896f4c78f5f802595870784df454...a17c4101003dbadc13d404a5dd5d106de1e57a3a,3,138,3,141,8,2007-03-23 08:54:47,2007-03-23 07:49:59
a17c4101003dbadc13d404a5dd5d106de1e57a3a...abba9dbbf450d4037a5e2054250f197169ac63eb,1,10,2,12,4,2007-03-23 09:48:09,2007-03-23 09:37:19
abba9dbbf450d4037a5e2054250f197169ac63eb...673e58389fd8531ee1ac191350c2c10b1656486e,1,1,1,2,1,2007-03-23 20:15:21,2007-03-23 20:15:21
673e58389fd8531ee1ac191350c2c10b1656486e...12cb8137332e21957195c3af2923c03a8aad5b5a,1,1,1,2,1,2007-03-23 20:29:55,2007-03-23 20:24:22
12cb8137332e21957195c3af2923c03a8aad5b5a...a4e9d71edb5f87b4dae57b8a474124451e397e6c,1,1,1,2,1,2007-03-24 00:20:43,2007-03-23 20:34:49
a4e9d71edb5f87b4dae57b8a474124451e397e6c...7891a2811dc7cae375e34c9f4fa6c8ecaef0f6d7,1,6,6,12,2,2007-03-24 06:25:54,2007-03-24 05:29:58
7891a2811dc7cae375e34c9f4fa6c8ecaef0f6d7...cc070d1f797c7488ed479817d893ad78fc4dae2b,1,3,3,6,1,2007-03-24 06:26:02,2007-03-24 05:31:16
cc070d1f797c7488ed479817d893ad78fc4dae2b...fed820ad5662d8b6f11b5e7f788fa87afe1ad919,1,39,34,73,11,2007-03-24 06:26:11,2007-03-24 05:31:49
fed820ad5662d8b6f11b5e7f788fa87afe1ad919...1207f9e705bcd69af286b2f887e67ae2baad3faf,1,21,0,21,7,2007-03-24 06:29:09,2007-03-24 05:30:33
1207f9e705bcd69af286b2f887e67ae2baad3faf...6cea055547c6f90450a34a5f30db4a48e154ab81,1,3,3,6,1,2007-03-24 06:29:29,2007-03-24 05:32:05
86f660b1f1dc207897281a77f969a56b2e551374...5fdc8499658969e5ed03184f87cb4290541a0763,1,14,16,30,5,2006-06-21 19:39:39,2006-06-21 18:01:12
86f660b1f1dc207897281a77f969a56b2e551374...58634dbff8221f158118342975f6cd281af14fd9,2,202,10,212,14,2006-06-21 10:56:29,2006-06-21 10:04:41
58634dbff8221f158118342975f6cd281af14fd9...c3fb0e358e594d081c7c0f37d557e29d2a5460b4,1,106,0,106,1,2006-06-21 10:56:29,2006-06-18 10:33:12
c3fb0e358e594d081c7c0f37d557e29d2a5460b4...693c15dc282c36042eac8d215beae3067db7565c,2,15,0,15,2,2006-06-21 10:56:30,2006-06-21 10:04:42
583b7ea31b7c16f872b178d541591ab816d16f85...ba0012c36705dcf847865759af69bba783afb69d,1,1,1,2,1,2006-06-21 23:37:48,2006-06-21 23:37:48
1f1ab5f05b8e8b45545d8a406d64887f772a69da...7a9b4c5fe3b8d291063c398ecb655281a60b2be7,2,21,21,42,16,2006-06-21 09:02:00,2006-06-21 07:48:02
7a9b4c5fe3b8d291063c398ecb655281a60b2be7...ae20de5386f74dbde991186694cfdac323b21e47,1,11,2,13,5,2006-06-21 09:02:01,2006-06-21 07:48:03
ae20de5386f74dbde991186694cfdac323b21e47...3f7f271004cd6b8f98bc4437408411c96a4766eb,1,3,3,6,2,2006-06-21 09:02:01,2006-06-21 07:48:04
29f4ad867cd15f4029c280c417f4a0866d5229a9...3acb27b6a4bd98dd58c1c17234b9b53ce0d78454,1,6,1,7,2,2006-06-25 17:09:19,2006-06-25 16:07:15
3acb27b6a4bd98dd58c1c17234b9b53ce0d78454...e898081dfbedcb77e3dfcdc9c347669f6c093d65,2,2,0,2,2,2006-06-26 09:11:44,2006-06-26 08:26:13
e898081dfbedcb77e3dfcdc9c347669f6c093d65...07d68930c247325116ad4a63422eb1520aaf6ef8,1,2,0,2,1,2006-06-26 09:11:53,2006-06-26 08:27:07
29f4ad867cd15f4029c280c417f4a0866d5229a9...2ad47d61b93e4027bd20f71963dcf1429dccc1fa,1,18,3,21,1,2006-06-25 12:28:58,2006-06-25 12:28:58
29f4ad867cd15f4029c280c417f4a0866d5229a9...801235c5e6bff0ec1c4e41c9d46535ead3b693c1,2,80,15,95,5,2006-06-25 07:39:13,2006-06-24 11:06:23
29f4ad867cd15f4029c280c417f4a0866d5229a9...9a99c087da7cd6b4a41c19df3053542f645315c5,2,23,5,28,4,2006-06-25 07:38:34,2006-06-25 01:29:47
9a99c087da7cd6b4a41c19df3053542f645315c5...9e4bc7dd1bb9d92491c475cec55147fa0b3f954d,1,5,28,33,7,2006-06-25 07:38:34,2006-06-25 01:29:48
9e4bc7dd1bb9d92491c475cec55147fa0b3f954d...d5e673b60be2eb99153276366b6b5ff3277805df,3,73,2,75,3,2006-06-25 07:38:34,2006-06-25 01:29:49
abc02670169cee9541793a86324a014272ca8ed5...a9ed376b158faf82d3685b51d546ccaeda716da3,2,19,0,19,3,2006-06-29 05:24:32,2006-06-29 04:57:12
a9ed376b158faf82d3685b51d546ccaeda716da3...83788070a3dd0a4905dd76c865320c51f7d74a83,1,119,15,134,11,2006-06-29 05:24:45,2006-06-28 18:18:27
83788070a3dd0a4905dd76c865320c51f7d74a83...0c7993839b92f466278439a724023f8be50391c1,3,240,1,241,5,2006-06-29 05:24:45,2006-06-29 05:06:36
a959e0dc16907c4dc123cfac7bd22c636064a638...3969cf7db1a13a78f3b7a36d8c1084bbe0a53459,4,38,19,57,20,2006-06-27 22:33:40,2006-06-27 22:08:19
3969cf7db1a13a78f3b7a36d8c1084bbe0a53459...2c0b4dfd5a2099bdbbdfad71c3193a25c9052f2d,1,1,1,2,1,2006-06-28 10:58:55,2006-06-28 08:46:41
47979d5d5bb86d058dce77801648734abe1e593b...d410e43b35a8044472606a7e7018aa64d96a5f0f,7,581,1,582,9,2006-06-29 07:28:30,2006-06-29 07:01:07
47979d5d5bb86d058dce77801648734abe1e593b...9e76bab14e50c46c624ae35f13c527a7a1b1185d,6,4,10,14,10,2006-06-27 22:36:19,2006-06-27 22:36:19
e5ea701b8e2901dd01b50e9ca296ad940cd65cbc...022bc2ac74a300ff9b1ad9a11a5a6da0c981dc5c,1,4,8,12,3,2005-08-19 00:22:04,2005-08-19 00:22:04
022bc2ac74a300ff9b1ad9a11a5a6da0c981dc5c...04c13d38772c77997d8789ee2067cc351b66e2aa,1,2,0,2,2,2005-08-19 00:22:24,2005-08-19 00:22:24
04c13d38772c77997d8789ee2067cc351b66e2aa...f1d83ba34ccb4c7fa8c488a669eeaaba1adc68e0,1,93,6,99,12,2005-08-19 12:14:28,2005-08-19 12:14:28
f1d83ba34ccb4c7fa8c488a669eeaaba1adc68e0...106288cb023cff311ca499fe41b128afbdf82997,1,64,29,93,14,2005-08-19 13:11:39,2005-08-19 13:11:39
379955c696a417f0fb6118f2fd91dbffd2816ad1...23bb8df2fb334368b6bd36908d13877cf6eae219,2,76,1,77,3,2005-08-18 17:25:52,2005-08-18 15:28:57
23bb8df2fb334368b6bd36908d13877cf6eae219...accd952fd89d30761e64146c49c902979cdd0ed9,1,113,2,115,3,2005-08-18 17:26:06,2005-08-18 16:42:56
0d62fb5672c7b6e3fc6c5418d61ff39bf6034741...87b7b84159381f5f0483e425122886cd952e374e,2,8,2,10,3,2005-08-12 17:38:20,2005-08-12 08:45:52
bf570303153902ec3d85570ed24515bcf8948848...38b1afd812e0ce048046055ba38821c64c5845e8,2,7,1,8,2,2005-08-11 05:05:59,2005-08-11 05:05:59
735c674416b87505400fcf738fd3a38b52f0eccb...a4c0d463c0a1b38b7af45c1e7dd5608860eb1e28,1,16,3,19,3,2009-07-25 06:42:34,2009-07-24 21:21:43
a4c0d463c0a1b38b7af45c1e7dd5608860eb1e28...9a5abfc737b18c23d060ff3be1ee8df560b81fa5,2,41,3,44,4,2009-07-25 06:42:44,2009-07-24 21:21:44
735c674416b87505400fcf738fd3a38b52f0eccb...302e04ea4d0c0414cedd716de882fa3dbe3480eb,1,11,7,18,1,2009-07-24 16:32:46,2009-07-23 11:09:29
735c674416b87505400fcf738fd3a38b52f0eccb...1ec648278e3a3e5a04dfaac916f68e2f675ff9ea,1,12,0,12,1,2009-07-24 05:07:51,2009-07-23 15:33:45
1ec648278e3a3e5a04dfaac916f68e2f675ff9ea...7f3140cd23f126e578ccaaea8c2cebe36824a7ac,7,20,4,24,8,2009-07-24 16:10:16,2009-07-23 15:33:49
735c674416b87505400fcf738fd3a38b52f0eccb...eafb45265bb9fcbee3cc03b451da7e17db9e6be7,1,3,2,5,2,2009-07-23 06:07:05,2009-07-23 06:07:05
eafb45265bb9fcbee3cc03b451da7e17db9e6be7...e6e4a47ba12bd19ed956251f191b1ea9915f61f8,1,5,5,10,3,2009-07-24 04:56:00,2009-07-23 17:17:04
e6e4a47ba12bd19ed956251f191b1ea9915f61f8...191d1ac435c01e2a7acfb93fb9da8378da90214c,1,14,10,24,5,2009-07-24 04:56:04,2009-07-23 19:05:34
191d1ac435c01e2a7acfb93fb9da8378da90214c...7e9ff00bbe1f437ff492a714758a4f7360feb22b,1,23,15,38,5,2009-07-24 04:56:07,2009-07-23 19:13:48
7e9ff00bbe1f437ff492a714758a4f7360feb22b...96d69b554325b6caa323428e64fba62ca033310d,1,10,4,14,4,2009-07-24 16:12:26,2009-07-24 08:17:13
96d69b554325b6caa323428e64fba62ca033310d...01ae841ccf3aa5d5331a4e6aed6122fee6617740,1,1,0,1,1,2009-07-24 16:20:34,2009-07-24 05:30:07
d1926f63ec93e84dba1a54c5de898fb517d9ca59...e24c76bf09576e0d197db1e40dff655a75e9efe1,1,2,2,4,2,2009-07-26 18:27:27,2009-07-18 16:45:44
e24c76bf09576e0d197db1e40dff655a75e9efe1...df73af5f667a479764d2b2195cb0cb60b0b89e3d,1,12,3,15,2,2009-07-26 18:51:45,2009-07-26 10:01:52
df73af5f667a479764d2b2195cb0cb60b0b89e3d...02944cc4929c6a7438dbde9216f9ebb193f1ae81,1,1,1,2,1,2009-07-28 20:30:42,2009-07-28 14:42:15
02944cc4929c6a7438dbde9216f9ebb193f1ae81...f552e51ef9d376c17fa707b7af9582108f4ec81c,5,10,9,19,6,2009-07-28 20:32:59,2009-07-28 08:32:18
58b1ef2f0fce75ebf4fbf88e5bdf76a0afaeacce...3de4a44308d5c84c468f3fb69a3c3f3092eaf369,1,22,19,41,3,2009-07-18 23:57:49,2009-07-15 14:34:24
3de4a44308d5c84c468f3fb69a3c3f3092eaf369...d5cee0f78654357965cb88c4e6d3cfa272d9ae28,1,20,0,20,1,2009-07-18 23:57:49,2009-07-17 14:28:06
d5cee0f78654357965cb88c4e6d3cfa272d9ae28...bba0fd22ad654460a81c4b35462b600d9432a869,3,2,28,30,4,2009-07-19 00:20:52,2009-07-19 00:19:47
bba0fd22ad654460a81c4b35462b600d9432a869...77acc32b29990a76ac6a63d3211b7c70adcef64d,1,47,10,57,9,2009-07-19 00:21:35,2009-07-18 20:01:49
77acc32b29990a76ac6a63d3211b7c70adcef64d...f0e8b1a3ed48716fa48c93f64214da1ee20ed534,2,0,0,0,0,2009-07-20 05:50:06,2009-07-19 10:08:27
f0e8b1a3ed48716fa48c93f64214da1ee20ed534...2a679c7a3148978a3f58f1c12100383638e744c5,1,4,2,6,2,2009-07-20 05:50:06,2009-07-20 05:08:45
f581de1b7b9d17c83b188bf8ffe536fb8a9dd2a4...1d8842d921cc2695f155f4a10904eeffad085c77,6,40,52,92,11,2009-07-09 08:11:26,2009-05-14 20:22:36
1d8842d921cc2695f155f4a10904eeffad085c77...dba2e2037f40685bffc87d3e7114a02c5bda1eff,3,30,31,61,24,2009-07-09 08:11:28,2009-07-09 02:24:39
dba2e2037f40685bffc87d3e7114a02c5bda1eff...caa6b7825aaddb8a97a5b793ca61df0c1ec9b76b,1,9,5,14,6,2009-07-09 08:11:30,2009-07-09 02:31:49
caa6b7825aaddb8a97a5b793ca61df0c1ec9b76b...443e061a41bee30de34793648793ed70477ac575,1,42,5,47,3,2009-07-10 03:05:19,2009-07-09 20:14:28
443e061a41bee30de34793648793ed70477ac575...867f72bf434a05b9eadf851a81564be5173fbba5,1,40,35,75,23,2009-07-10 03:05:19,2009-07-09 20:23:59
867f72bf434a05b9eadf851a81564be5173fbba5...b9fd284657de3ec30922fb17c0baf243ae947fdd,2,20,11,31,5,2009-07-10 03:05:19,2009-07-09 20:35:31
b9fd284657de3ec30922fb17c0baf243ae947fdd...f62ce3de9dd4803f50f65e17f5fc03c7bdb49c40,1,4,0,4,3,2009-07-10 05:38:34,2009-07-09 20:37:02
606475f3178784e5a6b3a01dce1a54314345cf43...c8400d9ef57dc68925d93d0cb9f1777396b380e2,1,2,0,2,1,2009-07-06 16:36:08,2009-07-01 00:24:47
c8400d9ef57dc68925d93d0cb9f1777396b380e2...f290974390c9be76e9166df6f0ab5ad790b812ac,2,2,6,8,3,2009-07-06 16:36:16,2009-07-03 04:34:54
f290974390c9be76e9166df6f0ab5ad790b812ac...5d0e634343bf83735b59c611b96c1d0f8ff2b28a,1,1,1,2,1,2009-07-06 16:36:24,2009-06-03 20:20:58
5d0e634343bf83735b59c611b96c1d0f8ff2b28a...444f29ce42a6de8e29a05f892f9ce5215cd38d56,1,1,1,2,1,2009-07-06 16:36:39,2009-07-06 13:33:07
444f29ce42a6de8e29a05f892f9ce5215cd38d56...3115fe9821912f67d1774cb2e33bcb2ffc162916,1,2,1,3,1,2009-07-06 16:36:43,2009-07-06 13:33:45
606475f3178784e5a6b3a01dce1a54314345cf43...47e3de0e7968a4176e2c54a36b214d3e7b24ad15,2,3,1,4,2,2009-07-05 19:16:26,2009-07-05 18:57:46
4f2b15ce88b70dd9e269517a9903864393ca873b...b8e8db281cea9641253233a2bf8d01ab1f908abe,2,5,0,5,3,2009-06-29 19:32:51,2009-06-29 17:28:25
b8e8db281cea9641253233a2bf8d01ab1f908abe...6fac1b83bdb9aee73363f93874ffaffd1bc3ad5c,1,3,2,5,3,2009-06-30 18:20:04,2009-06-30 04:24:24
6fac1b83bdb9aee73363f93874ffaffd1bc3ad5c...b8f262699f6c527b13ff95a322fafc0bfbc5a232,1,3,7,10,2,2009-06-30 18:23:21,2009-06-30 13:33:57
b8f262699f6c527b13ff95a322fafc0bfbc5a232...6167c136579f17066e985a8bf7d9c020878b9a3e,1,1,2,3,2,2009-06-30 23:12:14,2009-06-30 20:24:13
4f2b15ce88b70dd9e269517a9903864393ca873b...1965ff744a7e4cdefcc467991182b779f3c9d0e8,4,58,32,90,26,2009-06-28 05:26:58,2009-06-23 01:10:01
5c054a985a5b7e758f48353ac03582c9b2a9f919...ae7aa49914072b9007ba62245e68b8bbd24f964a,1,51,4,55,4,2007-07-09 01:29:02,2007-07-09 00:15:09
ae7aa49914072b9007ba62245e68b8bbd24f964a...11d6596709e04b8d2b429f230b2ed570d013f812,1,20,0,20,2,2007-07-09 06:18:08,2007-07-09 02:03:19
11d6596709e04b8d2b429f230b2ed570d013f812...1ed84157a21a3e868228b15588e4aadfbe5a030b,1,1,13,14,3,2007-07-09 06:18:22,2007-07-09 02:05:31
b08bbae7e1676e5a47fa9054e268ff14ee819a3a...e43b01058222da3fa0ba9b662f6621709a5981b3,1,5,5,10,2,2007-03-24 09:50:22,2007-03-23 16:06:11
e43b01058222da3fa0ba9b662f6621709a5981b3...2499857b0b5c1801da659e8bff976c1e038f3f3f,1,27,0,27,1,2007-03-24 10:08:54,2007-03-24 10:08:54
2499857b0b5c1801da659e8bff976c1e038f3f3f...46d409d0bf25b361f812eec4888c46509c203a6d,1,3,222,225,11,2007-03-25 05:30:53,2007-03-23 10:21:59
46d409d0bf25b361f812eec4888c46509c203a6d...0e55181f29ee6599ab6888ac54d186c83d355a70,3,6,6,12,6,2007-03-25 05:32:39,2007-03-24 15:58:22
0e55181f29ee6599ab6888ac54d186c83d355a70...b5b8d8141af7d854cf481a640d07aed7bddfaaaa,1,1,0,1,1,2007-03-25 05:32:41,2007-03-24 16:02:27
b5b8d8141af7d854cf481a640d07aed7bddfaaaa...2a18c266d04273be05ed29c589a5c29b8e68134d,1,3,0,3,1,2007-03-25 05:32:55,2007-03-25 00:55:43
2a18c266d04273be05ed29c589a5c29b8e68134d...06aff47b225506c4603a6f5ec5b4b16aa6a9d7ba,3,12,18,30,7,2007-03-25 06:01:36,2007-03-25 00:56:13
3ac53e0d13fa7483cce90eb6a1cfcdcbda5b8e35...eb3359663d62f35999330797455dbe738bd5ed99,2,26,4,30,8,2007-04-04 02:01:36,2007-04-03 23:28:46
eb3359663d62f35999330797455dbe738bd5ed99...9694ec4533b30c1299e9ce7742c65c78b4fa3c5d,3,20,2,22,3,2007-04-04 02:27:41,2007-04-03 18:31:21
160e82284eda034fea84dcc946f9c1965176f25f...6309172ea56294d08674cf35df92d6a3fa695480,1,1,1,2,1,2007-06-02 23:56:27,2007-06-02 21:18:46
6309172ea56294d08674cf35df92d6a3fa695480...cfb07cca7d9a517fae1bdc741c41c06d150a852f,1,16,0,16,1,2007-06-03 00:00:55,2007-06-02 20:11:26
cfb07cca7d9a517fae1bdc741c41c06d150a852f...cb8773d16c8619901f46a96ecfc5c2b11c2e82a2,1,6,14,20,2,2007-06-03 01:01:29,2007-06-03 00:09:00
c0e9892637e8144f10f2c408e276a470520f3601...c906b18122af72a8219c76281473490f812e5a40,1,2,1,3,1,2007-05-19 02:49:45,2007-05-19 00:47:51
c906b18122af72a8219c76281473490f812e5a40...2ff3f61ab6125edc53e4da8065b787bd10d0fdbb,1,25,34,59,3,2007-05-19 04:43:13,2007-05-19 04:43:13
331b51d24050c221221049421a924c1a150887db...c30c43c07dc2f53d7a1b247813597e087313a518,1,1,1,2,1,2014-10-08 20:51:46,2014-10-08 20:46:10
331b51d24050c221221049421a924c1a150887db...dfaa61bd524799d61b50bbbcee8b7972910ea41c,1,5,2,7,1,2007-05-14 01:45:15,2007-05-14 00:39:11
dfaa61bd524799d61b50bbbcee8b7972910ea41c...460c6996e27208898d3e24897e2ea35295c1cbf1,1,1,0,1,1,2007-05-14 06:57:27,2007-05-13 17:49:05
738a1154db190c75a7454da85d85be68ad7db065...77e4e8bd9b862d7285ca408d5e6dfc2134dba911,1,490,0,490,1,2007-05-21 02:59:04,2007-05-19 00:19:20
77e4e8bd9b862d7285ca408d5e6dfc2134dba911...93d496a560cdcd4f72c8dee1b0b2efa324e1c3bb,2,22,0,22,5,2007-05-21 03:31:50,2007-05-19 00:13:29
df9f91f8738167becda7a80f0db0ba856cdc0ecb...61d7256431da590dfca689e0681ed9437fd5d448,1,1,1,2,1,2007-05-16 19:32:29,2007-05-16 05:48:47
61d7256431da590dfca689e0681ed9437fd5d448...0ab564be6e59c66c7aa4fc44997f3fc62ebcd0d9,1,1,0,1,1,2007-05-16 19:37:25,2007-05-15 15:35:13
3545193735522f733fdb4e345f16ddf131e2007a...af9b54bb2cb0e15780bf3e820b5f1ce399deb2c4,4,28,28,56,18,2007-05-15 02:03:32,2007-05-14 13:37:25
5b5fe9a526e3841ff6f61dda743b9624dc8f6426...4e6380e5c3af2d8cea8ffac2a7759b4f4e62089b,1,1,4,5,2,2007-04-29 08:33:13,2007-04-28 07:15:48
4e6380e5c3af2d8cea8ffac2a7759b4f4e62089b...2342c4ee1437277a36c07246ab577a520dab588b,1,1,0,1,1,2007-04-29 08:34:59,2007-04-29 07:22:00
2342c4ee1437277a36c07246ab577a520dab588b...d0c32b63394992f8dd083a4f2f380ab190dbb2ca,1,1,1,2,1,2007-04-29 08:34:59,2007-04-29 07:31:14
d0c32b63394992f8dd083a4f2f380ab190dbb2ca...4e58bf970bfddb8106541d98c3321fdf2a6ba23b,2,2,0,2,2,2007-04-29 08:34:59,2007-04-29 01:40:12
4e58bf970bfddb8106541d98c3321fdf2a6ba23b...e9d54bd18bcf5dc9eb68eb1cba9a6a7ba3f71fd6,1,1,0,1,1,2007-04-29 08:34:59,2007-04-29 02:46:42
41728d69426dd707d4978929f8f4ac7a16f115f3...b51b8bbf146d17556226bff14f97957e84aa0207,1,7,2,9,2,2007-04-24 08:12:36,2007-04-24 07:51:35
b51b8bbf146d17556226bff14f97957e84aa0207...7d4f4a2f0dd440ce6116ed318440c2474afdd843,2,2,2,4,2,2007-04-24 21:27:41,2007-04-24 21:27:00
7d4f4a2f0dd440ce6116ed318440c2474afdd843...ce11873921e19be44082660882e07b205082643b,1,4,1,5,2,2007-04-25 04:40:17,2007-04-25 01:02:07
744747ef1d75c85fb3a1785cb08d36497128d3d3...a5c1780a0355a71b9fb70f1f1977ce726ee5b8d8,1,8,0,8,3,2007-04-20 15:23:45,2007-04-20 15:23:45
a5c1780a0355a71b9fb70f1f1977ce726ee5b8d8...46f6178a3f4e7a5bf8b47da0f3cc5c998d907ce8,1,6,1,7,1,2007-04-24 16:14:40,2007-04-24 11:51:04
46f6178a3f4e7a5bf8b47da0f3cc5c998d907ce8...00be8dcc1aca3c1c1a94b39f0563d30d1fa89290,1,1,1,2,1,2007-04-24 20:14:48,2007-04-24 19:56:02
744747ef1d75c85fb3a1785cb08d36497128d3d3...ad57cbca61afc921349ddb9e884ceee5bf2322a8,1,3,62,65,11,2007-04-20 08:43:57,2007-04-20 06:37:18
ad57cbca61afc921349ddb9e884ceee5bf2322a8...2c9750cc8b902a55669183e05533207dd7ec71fd,1,256,4,260,11,2007-04-20 08:46:42,2007-04-19 16:56:03
b8105375abfeee54e0a34e1c290983fd15e743cf...c93d88a574220c00954e3694bd78181b8b95249a,1,3,0,3,1,2007-03-06 07:11:19,2007-03-05 20:35:41
6aead43db34313e6cdbc72e2f7a70f6b82c78cf2...9aef12673e966fcbefea7716239e159c03b8d94e,1,1,1,2,1,2007-04-13 00:43:28,2007-04-12 05:21:18
9aef12673e966fcbefea7716239e159c03b8d94e...2bfe3cec92be4f5e3bfc0e71ed560df4a726c07b,2,1,1,2,2,2007-04-13 00:43:28,2007-04-12 10:04:05
6aead43db34313e6cdbc72e2f7a70f6b82c78cf2...199c45bf2b168cb8b2231e45f35e5fd588c2fc19,2,14,3,17,6,2007-04-12 03:02:03,2007-04-09 09:34:05
199c45bf2b168cb8b2231e45f35e5fd588c2fc19...5d23e133d23bc9e26d6f23a4d136901e18e6ffba,4,228,32,260,19,2007-04-12 03:02:03,2007-04-10 00:01:27
5d23e133d23bc9e26d6f23a4d136901e18e6ffba...d7a17cad9798693dc31043aa4efcce0b207483b9,2,89,0,89,5,2007-04-12 03:02:03,2007-04-09 10:40:38
d7a17cad9798693dc31043aa4efcce0b207483b9...55a643ed1b9b9af4d3bd9dc934dfccd142d1c632,1,15,0,15,2,2007-04-12 03:02:03,2007-04-10 22:28:32
f948792990f82a35bf0c98510e7511ef8acb9cd3...bb1faf0d5bc53b193bbe25e7425458c8eb85efa3,3,25,5,30,9,2007-04-17 07:19:11,2007-04-16 07:53:24
f948792990f82a35bf0c98510e7511ef8acb9cd3...2c1cbec1e2f0bd7b15fe5e921d287babfd91c7d3,3,24,20,44,8,2007-04-17 06:36:11,2007-04-17 05:10:19
2c1cbec1e2f0bd7b15fe5e921d287babfd91c7d3...100c5f3b0b27ec6617de1a785c4ff481e92636c1,8,23,43,66,12,2007-04-17 06:36:16,2007-04-17 05:11:43
89815cab95268e8f0f58142b848ac4cd5e9cbdcb...364b8523529163ffeeb71521239a18ac1f550512,1,2,2,4,2,2007-04-04 20:11:33,2007-04-04 19:39:05
364b8523529163ffeeb71521239a18ac1f550512...2b93edbf32700d91c500806e4502077829d66d21,2,10,6,16,7,2007-04-04 21:12:03,2007-04-04 21:12:03
2b93edbf32700d91c500806e4502077829d66d21...5850cb645d3ca44c3bc014f92672dae6394c0315,1,0,0,0,0,2007-04-05 05:17:59,2007-04-04 11:52:12
5850cb645d3ca44c3bc014f92672dae6394c0315...265d528032e55c48798266c538d3e6338cb1e2b6,3,7,1,8,3,2007-04-05 21:10:10,2007-04-05 20:55:43
265d528032e55c48798266c538d3e6338cb1e2b6...b24bace5ca9420033be83ef6c14fb092c9371fe1,2,32,0,32,3,2007-04-05 21:12:41,2007-04-05 14:53:07
b24bace5ca9420033be83ef6c14fb092c9371fe1...957d6ea78fcbe71481a6f46a58768e100f7908e0,1,4,2,6,2,2007-04-05 21:14:55,2007-04-05 11:45:41
957d6ea78fcbe71481a6f46a58768e100f7908e0...1e31fbe24fac983b0057af39824f73d65dba6502,1,2,2,4,1,2007-04-05 21:14:55,2007-04-05 18:09:31
1e31fbe24fac983b0057af39824f73d65dba6502...01ebb9dc8846af729c13d5d8c9d939a6d1159240,2,12,2,14,3,2007-04-05 21:53:22,2007-04-05 14:20:55
01ebb9dc8846af729c13d5d8c9d939a6d1159240...766b084f59c97bc8b096a59cd5c8d06df5aa2bc5,1,1,1,2,1,2007-04-05 22:03:48,2007-04-05 22:03:48
766b084f59c97bc8b096a59cd5c8d06df5aa2bc5...79ee194e52a140412da475e102145bad80d5d00a,2,27,2,29,3,2007-04-05 22:06:58,2007-04-04 15:19:14
79ee194e52a140412da475e102145bad80d5d00a...b5da24679ec73f458988523dce9dd17b4e9b0e02,2,2,2,4,2,2007-04-05 22:39:12,2007-04-05 19:05:57
89815cab95268e8f0f58142b848ac4cd5e9cbdcb...30ca07a249744e57163c02250fca420cea364299,13,50,23,73,22,2007-04-04 06:44:32,2007-04-01 06:09:02
30ca07a249744e57163c02250fca420cea364299...5e7f56ac33f7a5583f9fa4e0b6088709fea7a6f8,6,30,16,46,11,2007-04-04 06:44:32,2007-04-01 06:27:41
89815cab95268e8f0f58142b848ac4cd5e9cbdcb...3e0318a3613ae8e89dcb1fc39d909145e64287b9,2,64,3,67,4,2007-04-04 06:43:59,2007-03-29 08:02:50
33580fbd308593e36395926fd35b501976ad322a...3b486cd229f1db437462a45103ef01d50c47a00d,1,2,2,4,2,2007-04-05 22:13:44,2007-04-04 20:42:33
33580fbd308593e36395926fd35b501976ad322a...38a47fd6e316030ba1e72ea447243cb47adf2505,2,99,26,125,13,2007-04-05 22:13:14,2007-04-04 05:12:02
38a47fd6e316030ba1e72ea447243cb47adf2505...6fe9c570ccd9f893d9a981cd8ea5f51dc21ceec8,1,15,4,19,3,2007-04-05 22:13:14,2007-04-05 03:33:53
6fe9c570ccd9f893d9a981cd8ea5f51dc21ceec8...6fecf1915c5fd0b14e2ca2ec9e1a6b620abfb5c2,1,4,5,9,1,2007-04-06 05:51:14,2007-04-06 05:51:14
6fecf1915c5fd0b14e2ca2ec9e1a6b620abfb5c2...4f50671699090089b7967880f9b0291391c8de1a,1,37,1,38,2,2007-04-07 00:55:48,2007-04-06 05:52:37
4f50671699090089b7967880f9b0291391c8de1a...0a5280a9f444c33b0e4ebf2f073df5899c112cf8,2,58,44,102,12,2007-04-07 00:55:57,2007-04-06 06:27:44
640ee0d1cd771bf6093602f1beb143d356607446...8d1608b8bf49d6dfbc843b981c2dfb730fc3a96b,2,77,1,78,2,2007-04-08 06:59:32,2007-04-08 06:59:32
5fdc8499658969e5ed03184f87cb4290541a0763...c1f8064b143f98e8b3c5ff1ce12ebd0800df5d67,1,2,1,3,2,2006-06-22 07:11:23,2006-06-22 01:47:00
c1f8064b143f98e8b3c5ff1ce12ebd0800df5d67...79ee555bac7a5ff846c8a381792bbe93cdffbf97,2,23,0,23,4,2006-06-22 07:20:20,2006-06-21 13:17:31
79ee555bac7a5ff846c8a381792bbe93cdffbf97...bbc932c845ad17087ed601625f878adf5bae6e96,1,1,1,2,1,2006-06-22 09:04:27,2006-06-22 09:04:27
bbc932c845ad17087ed601625f878adf5bae6e96...ec9d00d078ed1625d8c85a25618dfa2aa8042b69,1,8,6,14,4,2006-06-22 09:15:16,2006-06-22 08:22:46
693c15dc282c36042eac8d215beae3067db7565c...5887ac821f9df614cfcf3349960523e1c36f2de7,1,10,13,23,8,2006-06-22 08:46:48,2006-06-22 08:44:54
3f7f271004cd6b8f98bc4437408411c96a4766eb...49f582a0401f3b9b9a80ff6fe0dd601520579b7d,1,2,1,3,2,2006-06-21 21:01:15,2006-06-21 15:06:39
75dedd5a21246be03ae443e9fc6a9f75c6d2995b...51d1e83f91a16363930023a5c39f79f270c04653,1,7,0,7,1,2006-06-29 22:24:29,2006-06-29 21:04:01
75dedd5a21246be03ae443e9fc6a9f75c6d2995b...cc7d5bcf006e92d554cae0aefc9d8681d4659dce,1,1,1,2,1,2006-06-29 21:48:22,2006-06-29 21:48:22
75dedd5a21246be03ae443e9fc6a9f75c6d2995b...52cab8a0848463d793a3fc819b6d604ffc077ac1,1,46,18,64,11,2006-06-29 20:50:46,2006-06-29 13:16:46
52cab8a0848463d793a3fc819b6d604ffc077ac1...7c6f8aaf6d795f0c9a75671acceb9754ea06fd81,3,242,238,480,3,2006-06-29 20:50:46,2006-06-29 13:17:32
7c6f8aaf6d795f0c9a75671acceb9754ea06fd81...31609c17251f368584f7b94d44b06194112b4251,2,17,4,21,4,2006-07-02 01:13:25,2006-07-01 23:29:26
31609c17251f368584f7b94d44b06194112b4251...0d2c9d67d9e1a2fd87b2daeefffffaff0b3f3a49,2,53,9,62,8,2006-07-02 01:13:47,2006-07-01 23:29:37
0d2c9d67d9e1a2fd87b2daeefffffaff0b3f3a49...31aea7ef77aff64a02afe1ea5f10375565911808,1,3,4,7,2,2006-07-02 01:14:03,2006-07-01 23:29:58
31aea7ef77aff64a02afe1ea5f10375565911808...c0fa8255c652e148f0910425d2cc2b8029065008,4,9,19,28,5,2006-07-02 17:58:25,2006-07-02 09:49:38
c0fa8255c652e148f0910425d2cc2b8029065008...542ccefe896a8960a6ce0b0ba4519537649ae29a,1,20,20,40,15,2006-07-02 18:34:17,2006-07-02 18:34:17
542ccefe896a8960a6ce0b0ba4519537649ae29a...2ef108013ec15e8d5feee6d5c42692ae956ee302,1,2,1,3,2,2006-07-03 10:02:27,2006-07-03 10:02:27
2ef108013ec15e8d5feee6d5c42692ae956ee302...160b7983034cdd24ea1bf6ef7a2532a2296461c6,3,17,7,24,5,2006-07-03 10:05:20,2006-07-03 10:05:20
f252281102514d8d3cc15a3df5ae633619c93835...27e1b127f32640bea68b84e0ff57d640fd31cc92,1,2,1,3,1,2006-06-29 07:19:36,2006-06-29 07:18:52
d410e43b35a8044472606a7e7018aa64d96a5f0f...b319b02e2a75bfe71829cfe1506b86ec7644987d,10,263,0,263,10,2006-07-02 05:02:17,2006-07-02 05:02:17
bc483d04804888c2da64e4c6685c2860a9041122...ac83aa2e1fffcb4e7560431ddc15b288dc237634,1,5,1,6,1,2006-07-06 02:44:03,2006-07-06 02:44:03
bc483d04804888c2da64e4c6685c2860a9041122...79d3696cfb438467749160481c6119e43d4d2851,1,327,51,378,21,2006-07-05 23:41:23,2006-06-30 10:04:05
106288cb023cff311ca499fe41b128afbdf82997...9843c3074dfbf57117565f6b7c93e3e6812857ee,1,126,19,145,10,2005-08-30 00:57:11,2005-08-30 00:57:11
9d34c29db39bdb5c2443475dd6a24cfc5c2c9e37...2f5703c3a09b0d5a851e6846b33a9ed0824f6725,1,22,6,28,5,2005-08-18 19:53:30,2005-08-18 19:17:47
2f5703c3a09b0d5a851e6846b33a9ed0824f6725...66e06b6a17f1074401ad23f4b2a8a146b2900333,1,1,1,2,1,2005-08-18 20:00:53,2005-08-18 20:00:53
87b7b84159381f5f0483e425122886cd952e374e...724249862e4251b4ff16ca444b8300e79bcd15b1,1,1,1,2,1,2013-10-31 22:11:28,2013-10-31 21:41:11
724249862e4251b4ff16ca444b8300e79bcd15b1...61e2e22f60e9d346382482b18f7db427108ee864,1,1,1,2,1,2013-11-01 16:13:35,2013-11-01 15:42:43
87b7b84159381f5f0483e425122886cd952e374e...33b8303466af9a839265abc9829e5479f6f12488,3,51,27,78,18,2005-08-12 17:38:21,2005-08-12 09:08:29
33b8303466af9a839265abc9829e5479f6f12488...b097584b790b3ec214ceed4ecc6eb6a8f4a69a8f,1,11,1,12,3,2005-08-12 17:38:21,2005-08-12 13:32:42
b097584b790b3ec214ceed4ecc6eb6a8f4a69a8f...5a571cdd8ab390e13fc02da6d6489d2ffa668aa4,1,5,2,7,3,2005-08-12 17:38:22,2005-08-12 08:03:07
5a571cdd8ab390e13fc02da6d6489d2ffa668aa4...b05701c5b4c7983ef04d8c286c65089596553bd6,2,28,25,53,17,2005-08-12 17:38:22,2005-08-06 05:36:15
b05701c5b4c7983ef04d8c286c65089596553bd6...a682ef9f06075b4bb83dcf479c91d578125084b9,4,12,11,23,8,2005-08-12 17:38:23,2005-08-04 23:56:38
a682ef9f06075b4bb83dcf479c91d578125084b9...3e386508f87278610d1892aaaa08cd17907f71c5,1,14,14,28,3,2005-08-12 17:38:23,2005-08-04 22:52:46
3e386508f87278610d1892aaaa08cd17907f71c5...704a66f52edbc0cc88dca3b0993a072ae49d0f39,3,3,4,7,3,2005-08-12 17:38:24,2005-08-12 17:37:33
704a66f52edbc0cc88dca3b0993a072ae49d0f39...5b6a8b649010d1b9362e703f8fe769c44fc0d7de,2,2,2,4,2,2005-08-12 19:25:34,2005-08-12 19:25:34
5b6a8b649010d1b9362e703f8fe769c44fc0d7de...b8c20680c863379a7089091a4f1cd6ece20fd9e6,2,7,1,8,2,2005-08-12 20:32:02,2005-08-12 20:32:02
b8c20680c863379a7089091a4f1cd6ece20fd9e6...af36b70ef939cc44c447a4b9cbaadd7eba9a20b1,2,30,27,57,3,2005-08-13 04:16:01,2005-08-13 00:38:15
b22d301b24b55dc59549833d285decbdd9b1ca53...146fe8ce2488fea8a8e35285d825bfbbe07b806d,1,19,0,19,2,2012-04-16 05:59:31,2012-04-16 05:59:31
9e234af281107d44116ecf31eef65de145c46d15...fe4a0a288842e225f99254b3e6ce14ff98875501,3,14,0,14,3,2012-09-03 04:10:01,2012-09-01 11:25:27
fe4a0a288842e225f99254b3e6ce14ff98875501...ba4d1c7b1623b2c7ec198aee08036acf779375e6,1,1,1,2,1,2012-09-03 04:10:24,2012-09-01 11:34:09
ba4d1c7b1623b2c7ec198aee08036acf779375e6...85556d4e37db4c8ed88c68a602f6f85054996bea,1,25,22,47,20,2012-09-03 04:11:48,2012-09-01 11:27:35
85556d4e37db4c8ed88c68a602f6f85054996bea...50d89ad6542c8acafefa6d42f8b42dfa9b8fafe1,3,19,17,36,11,2012-09-03 04:13:50,2012-09-01 15:27:06
130b04ab37d74e574d525df7948b963b13c6bdbf...b3601a633801861da9dc1e6b4f7d62b05ca1706c,1,13,2,15,3,2009-07-25 07:51:21,2009-07-25 07:51:21
01ae841ccf3aa5d5331a4e6aed6122fee6617740...422a82f21370fe38b3e926a83b460bf2b1dd13ab,2,9,5,14,4,2009-07-25 08:29:20,2009-07-25 08:29:20
248b6c0609cf7cc9411a9094c4868ce9cdbd4922...a1142892fd505c304e2e825902bf5d7a38044e87,2,3,2,5,3,2009-07-23 04:56:51,2009-07-21 20:23:06
a1142892fd505c304e2e825902bf5d7a38044e87...65180c6618653acf7642fc2f2d4a93afacb489d8,1,44,0,44,1,2009-07-23 04:57:41,2009-07-22 21:39:30
65180c6618653acf7642fc2f2d4a93afacb489d8...f693b7e9a5b7b009e71389310322fe864cd16046,2,31,12,43,4,2009-07-23 04:57:41,2009-07-22 21:39:31
f693b7e9a5b7b009e71389310322fe864cd16046...520707905388e293a482066599a1c181ef32f2f0,1,3,3,6,3,2009-07-23 04:57:41,2009-07-22 05:30:58
520707905388e293a482066599a1c181ef32f2f0...67da52bedc5750c10a732b9da7d64d5ef73f3b8a,1,1,1,2,1,2009-07-23 04:57:41,2009-07-22 21:34:33
67da52bedc5750c10a732b9da7d64d5ef73f3b8a...f630cfda8800aee03c7eb2fcd0f840730fbe43b9,3,4,3,7,4,2009-07-23 04:57:41,2009-07-22 21:34:34
f630cfda8800aee03c7eb2fcd0f840730fbe43b9...98cb6f30f708ef416572bf65bd26ac9f998ae0dc,3,4,2,6,3,2009-07-23 04:57:41,2009-07-22 21:34:35
98cb6f30f708ef416572bf65bd26ac9f998ae0dc...24deea5273709f3685f981c33468a0cead6cc147,2,2,3,5,2,2009-07-23 04:57:41,2009-07-22 21:51:55
24deea5273709f3685f981c33468a0cead6cc147...0ad8ff2cd185e84fd49dd961370411e379681f10,1,2,3,5,1,2009-07-23 04:57:41,2009-07-22 22:20:53
441b40d833fdfa93eb2908e52742248faf0ee993...0a53e9ddeaddad63ad106860237bbf53411d11a7,3,15,7,22,5,2009-07-29 07:32:42,2009-07-29 07:32:42
2a679c7a3148978a3f58f1c12100383638e744c5...a91f453f641ca9966a438bdd3896656b00423407,5,103,11,114,16,2009-07-23 04:54:54,2009-07-22 17:52:15
20f3749977c0ea48538553dcd85b7cd445d43415...0039ba7e5e630502be9ac601845b214abce93750,1,1,1,2,1,2009-07-11 06:50:29,2009-07-10 17:10:43
0039ba7e5e630502be9ac601845b214abce93750...9398b85994ee7d602e29e0b82de01b9605ee535f,1,2,1,3,2,2009-07-11 06:50:29,2009-07-10 17:10:44
9398b85994ee7d602e29e0b82de01b9605ee535f...ecc395c112b45b00df6c8b1e8d665123c1a28bca,2,11,0,11,3,2009-07-11 06:50:29,2009-07-10 17:10:45
ecc395c112b45b00df6c8b1e8d665123c1a28bca...1fdffc1bd8865fc07107d021d2fce7cd707b9b84,1,13,0,13,1,2009-07-11 06:50:29,2009-07-10 17:10:46
1fdffc1bd8865fc07107d021d2fce7cd707b9b84...7c74ff50626faca2fd302d83610494dd9106896d,1,6,6,12,4,2009-07-11 06:50:29,2009-07-10 18:31:19
7c74ff50626faca2fd302d83610494dd9106896d...d9eb0205a217984f3e70bf18ae66c02a22d3d475,2,60,27,87,12,2009-07-11 06:53:17,2009-07-09 23:52:30
916e1373fb86db9d7019de4e7e74e39c9474a153...1c49a4e1f324dcaa000ce92ed44d0e5b9eb16843,2,59,39,98,19,2009-06-30 18:06:30,2009-06-29 22:00:48
1c49a4e1f324dcaa000ce92ed44d0e5b9eb16843...f88bafadd9b2562a0cd2500c5a9669d3741243b5,1,5,1,6,1,2009-06-30 18:06:32,2009-06-29 22:00:49
f88bafadd9b2562a0cd2500c5a9669d3741243b5...ba9247339dfbd2c2671603e012d011b4b474fa4b,1,9,7,16,2,2009-06-30 18:06:34,2009-06-29 22:00:50
ba9247339dfbd2c2671603e012d011b4b474fa4b...e9fdd74e5374dd1efe1577057d14a2836b4cae78,3,86,3,89,11,2009-06-30 18:06:35,2009-06-29 22:00:51
e9fdd74e5374dd1efe1577057d14a2836b4cae78...5a371b7bbbffeddfb356b327995a95cf7bae71d5,1,22,2,24,2,2009-06-30 18:06:36,2009-06-29 22:00:52
5a371b7bbbffeddfb356b327995a95cf7bae71d5...679a1a1d420616be1647bdf8b2e93f1f86c7bdae,1,27,7,34,7,2009-06-30 18:06:36,2009-06-29 22:00:53
679a1a1d420616be1647bdf8b2e93f1f86c7bdae...7d25ef41c84850ec1405400efc95d78fa6523efc,1,1,0,1,1,2009-06-30 18:06:37,2009-06-29 22:00:54
916e1373fb86db9d7019de4e7e74e39c9474a153...a429d2dd76c81cb52fb17463821a457e541637ce,1,3,3,6,3,2009-06-27 21:11:28,2009-06-26 05:14:09
a429d2dd76c81cb52fb17463821a457e541637ce...5a56da58060e50980fab0f4c38203a25440d1530,3,92,111,203,8,2009-06-27 21:11:28,2009-06-26 05:14:10
916e1373fb86db9d7019de4e7e74e39c9474a153...668f3aa776bcd293de08413bf1b25b91c15f1b01,1,1,1,2,2,2009-06-27 21:10:09,2009-06-26 04:48:27
668f3aa776bcd293de08413bf1b25b91c15f1b01...02c48cd69b3ebfac3867f0f9ceb1503a5af118fc,2,22,1,23,3,2009-06-27 21:10:09,2009-06-26 04:48:28
02c48cd69b3ebfac3867f0f9ceb1503a5af118fc...2374502c6ca1c8007cb35682f13fb5db044df9ea,1,1,4,5,3,2009-06-27 21:10:10,2009-06-26 04:48:29
2374502c6ca1c8007cb35682f13fb5db044df9ea...32164131db0984544b222ac515f95f917fa01441,1,1,0,1,1,2009-06-27 21:10:10,2009-06-26 04:48:30
32164131db0984544b222ac515f95f917fa01441...2d8ad46919213ebbd7bb72eb5b56cca8cc3ae07f,2,68,2,70,7,2009-06-27 21:10:10,2009-06-26 04:48:31
2d8ad46919213ebbd7bb72eb5b56cca8cc3ae07f...25e0ca5dd61f8a4625393fa1b71e1f88c9fab754,1,88,0,88,1,2009-06-27 21:10:10,2009-06-26 04:48:32
25e0ca5dd61f8a4625393fa1b71e1f88c9fab754...8af15d282e59a7f566b5e7eb71caebfc40ca5cd6,1,6,0,6,1,2009-06-27 21:10:10,2009-06-26 04:48:33
916e1373fb86db9d7019de4e7e74e39c9474a153...5eec27e35f0a6231d2b0c50d94c726a67f14b23e,3,54,4,58,6,2009-06-25 07:38:16,2009-05-29 15:09:42
5eec27e35f0a6231d2b0c50d94c726a67f14b23e...9a8c92ac9e4698da150a413ce80f185005447f4c,1,3,0,3,1,2009-06-25 07:38:16,2009-05-31 01:17:06
9a8c92ac9e4698da150a413ce80f185005447f4c...ca5e880ec2172f33dd0113129775f6eb65f2f678,1,2,0,2,1,2009-06-25 07:38:16,2009-06-04 03:45:51
ca5e880ec2172f33dd0113129775f6eb65f2f678...195643f2fc80b4d06a75b954b9a8ef2300976755,3,164,6,170,13,2009-06-25 07:38:17,2009-06-04 03:45:52
195643f2fc80b4d06a75b954b9a8ef2300976755...6224406914c3d3fecec73e32ed271dbdc0c8736a,2,170,22,192,18,2009-06-25 08:58:09,2009-06-23 17:02:08
6224406914c3d3fecec73e32ed271dbdc0c8736a...f7050599310c18bd67b35b8d59486116b30ff1f6,1,3,1,4,1,2009-06-25 09:28:25,2009-06-25 09:28:15
f7050599310c18bd67b35b8d59486116b30ff1f6...2317d289fefbe04fa57379fa6d115717bb25ba14,1,0,1,1,1,2009-06-26 18:05:36,2009-06-25 23:09:59
2317d289fefbe04fa57379fa6d115717bb25ba14...50ff23667020768fa18dcffd154406fc41ebaa84,1,8,1,9,3,2009-06-26 21:08:52,2009-06-26 14:52:09
50ff23667020768fa18dcffd154406fc41ebaa84...b5c9b38bc3f7a1151dc6b1af1f3fabe9d1c4aefa,1,66,57,123,18,2009-06-27 22:01:57,2009-06-26 21:08:19
b5c9b38bc3f7a1151dc6b1af1f3fabe9d1c4aefa...ab81a3643ba3a68aae8a60d2c84f164b2c301b86,1,35,9,44,6,2009-06-27 22:05:42,2009-06-26 20:49:19
916e1373fb86db9d7019de4e7e74e39c9474a153...3f721d1d6d6e6e55dbb5bfcb0e09346478adbb72,1,7,9,16,4,2009-06-23 23:43:16,2009-06-22 22:27:44
47e3de0e7968a4176e2c54a36b214d3e7b24ad15...303e7c48eae7e140a9612ff1f9b5a95ca80b65c4,1,3,2,5,2,2009-07-05 19:16:27,2009-07-04 19:26:38
303e7c48eae7e140a9612ff1f9b5a95ca80b65c4...5709e0363a891b72eb9e9756d7fb121d9bf6a7c7,7,7,19,26,8,2009-07-05 19:16:27,2009-07-04 19:26:39
5709e0363a891b72eb9e9756d7fb121d9bf6a7c7...0ac77ec3150f43a5c2a6b1e47e9db5aafe53fb72,6,58,86,144,28,2009-07-06 09:44:49,2009-07-04 19:26:40
0ac77ec3150f43a5c2a6b1e47e9db5aafe53fb72...b99d5f40d6a5cba7d7cd7599063b3cd78aa4d219,1,8,1,9,1,2009-07-06 09:44:56,2009-07-04 19:26:41
b99d5f40d6a5cba7d7cd7599063b3cd78aa4d219...c024beb56da679839d61f352d088b9a86823233a,5,13,13,26,12,2009-07-06 09:45:50,2009-07-04 19:26:42
c024beb56da679839d61f352d088b9a86823233a...90e41a89caa464a84e13cbc9378b0348a61f713b,1,4,16,20,8,2009-07-06 09:45:52,2009-07-04 19:26:43
90e41a89caa464a84e13cbc9378b0348a61f713b...5a7a3671b74c043216549b94a718da04cc3ffcd6,1,1,1,2,1,2009-08-04 17:04:29,2009-08-04 09:28:40
5a7a3671b74c043216549b94a718da04cc3ffcd6...0b91322311b649a4b5f9581fec2dca9e1c2da716,1,28,3,31,3,2009-08-08 20:51:25,2009-08-08 20:44:20
725cf7b45da1f983fa1cbb0757b0e8855e5ac2de...8cfe5f1cd5dabc3a21bc792327747deefeff6dff,3,17,0,17,3,2009-07-02 02:16:37,2009-07-01 22:01:43
8cfe5f1cd5dabc3a21bc792327747deefeff6dff...5dd06d38795b2f6d05f851b25c814732238f8df1,2,12,15,27,12,2009-07-02 02:16:45,2009-07-01 22:02:38
5dd06d38795b2f6d05f851b25c814732238f8df1...046802d015b3be2e055ae68f29f76741023bc32d,4,40,1,41,4,2009-07-02 02:16:46,2009-07-01 22:03:44
046802d015b3be2e055ae68f29f76741023bc32d...49de3216983cc921ea66ade18a8521d4d74bbf3f,1,32,29,61,6,2009-07-02 02:16:48,2009-07-01 22:05:17
49de3216983cc921ea66ade18a8521d4d74bbf3f...2944e4e6145bdfcb1a8730d7da671786d72c86ed,5,98,13,111,21,2009-07-02 02:16:49,2009-07-01 22:06:34
2944e4e6145bdfcb1a8730d7da671786d72c86ed...60ecac98ed6f420c6bf823491074219087c749d4,5,50,3,53,14,2009-07-02 02:16:50,2009-07-01 22:07:24
60ecac98ed6f420c6bf823491074219087c749d4...ed24e401e0e6ab860475b8575e28a2c6ea99cc69,2,6,10,16,5,2009-07-03 04:36:42,2009-07-01 22:06:34
725cf7b45da1f983fa1cbb0757b0e8855e5ac2de...8715227df65071b38a3c91553cdb51365aa5cfd9,1,2,1,3,1,2009-07-01 18:16:54,2009-07-01 07:26:28
1965ff744a7e4cdefcc467991182b779f3c9d0e8...b7047abc1213719c225a481f9618ca5a250e6fe9,1,10,5,15,2,2010-02-09 00:49:00,2010-02-09 00:45:21
1ed84157a21a3e868228b15588e4aadfbe5a030b...848d732c10616269886d0b9c82e434b65ffc33f0,1,7,1,8,2,2007-07-09 06:48:17,2007-07-09 04:45:21
cb8773d16c8619901f46a96ecfc5c2b11c2e82a2...9adccb057e2654f259bd98c04012e97a30322c1b,1,8,10,18,7,2007-06-06 05:14:12,2007-06-05 21:50:02
8e29f903eb366b2d2e846dc35ec4510d2cb263ad...4159c5781303bb24d82be69b6a5de92d51d8d4f0,2,3,5,8,3,2007-06-02 18:28:13,2007-06-01 09:10:30
4159c5781303bb24d82be69b6a5de92d51d8d4f0...cedb8d5d33e6496cfc70493db841b3db886e8658,8,145,101,246,15,2007-06-02 18:59:19,2007-06-02 17:08:54
cedb8d5d33e6496cfc70493db841b3db886e8658...996e2d6ea2626f55a59e70ac7305a02ce0171814,2,12,8,20,7,2007-06-02 19:00:26,2007-06-01 21:08:12
93d496a560cdcd4f72c8dee1b0b2efa324e1c3bb...f02153696fc319c3c6dba2c27a5f7aed98eec465,1,5,3,8,4,2007-05-21 04:55:26,2007-05-13 18:28:19
f02153696fc319c3c6dba2c27a5f7aed98eec465...d01fb92f8d27cf8f0a843f4e9c0f8f022856b34d,1,36,32,68,7,2007-05-21 04:55:26,2007-05-13 18:34:56
d01fb92f8d27cf8f0a843f4e9c0f8f022856b34d...17b08f2cd0000d42bb9f0a36354ab9300d64d420,1,104,27,131,20,2007-05-21 04:55:26,2007-05-13 19:06:18
17b08f2cd0000d42bb9f0a36354ab9300d64d420...ebe27b137c971d6d436c8d2125296ee526f6d02b,1,71,49,120,15,2007-05-21 04:55:26,2007-05-13 19:09:16
ebe27b137c971d6d436c8d2125296ee526f6d02b...6b94b1a09af9cf877f0bc43d6097bce56f856866,4,26,7,33,11,2007-05-21 04:55:26,2007-05-13 19:47:09
6b94b1a09af9cf877f0bc43d6097bce56f856866...01c12a23121780b7b1d84943fe310cf8773f8745,1,9,0,9,2,2007-05-23 18:09:48,2007-05-23 17:11:33
01c12a23121780b7b1d84943fe310cf8773f8745...dca3957b8581ffd0faab135191bbee3029953bd2,1,3,2,5,2,2007-05-25 02:45:14,2007-05-25 02:06:42
93d496a560cdcd4f72c8dee1b0b2efa324e1c3bb...a5bbda8b7b7f25f6caaa9f940e455e702f39766e,2,41,6,47,9,2007-05-21 04:43:46,2007-05-19 20:08:11
93d496a560cdcd4f72c8dee1b0b2efa324e1c3bb...5751f49010ec54164b93529e31165e71f5996856,4,264,172,436,15,2007-05-21 04:32:56,2007-05-12 15:45:53
5751f49010ec54164b93529e31165e71f5996856...6b62816cb12e621c5952f088542bec6dfc7ec5d6,6,261,241,502,10,2007-05-21 04:32:56,2007-05-12 15:45:59
6b62816cb12e621c5952f088542bec6dfc7ec5d6...5d46c9d41febe5fe85f94f7db2b190d8abf1e71e,2,70,0,70,9,2007-05-21 04:32:56,2007-05-12 15:46:03
5d46c9d41febe5fe85f94f7db2b190d8abf1e71e...b516968ff62ec153e008d033c153affd7ba9ddc6,2,53,11,64,13,2007-05-21 04:32:57,2007-05-16 02:50:19
b516968ff62ec153e008d033c153affd7ba9ddc6...8558fd9ece4c8250a037a6d5482a8040d600ef47,4,70,122,192,19,2007-05-26 08:20:10,2007-05-25 05:20:56
93d496a560cdcd4f72c8dee1b0b2efa324e1c3bb...efe7f3586156bff4d29c347a1c41f93627c9f3e3,1,40,3,43,4,2007-05-21 03:36:24,2007-05-20 12:45:59
efe7f3586156bff4d29c347a1c41f93627c9f3e3...077e1af5983000266bc7c1423a87b7768ca03754,1,15,33,48,7,2007-05-21 06:51:06,2007-05-21 06:51:06
0ab564be6e59c66c7aa4fc44997f3fc62ebcd0d9...504ceab6d24bc19ed5a04b5978c8899fa58dffe1,1,1,1,2,1,2007-05-17 05:33:04,2007-05-17 05:15:16
504ceab6d24bc19ed5a04b5978c8899fa58dffe1...164b19893ab5bc66b531a26480149a0dff082969,1,9,0,9,1,2007-05-18 00:36:38,2007-05-17 05:08:50
0ab564be6e59c66c7aa4fc44997f3fc62ebcd0d9...126640afbc3732f3d7c65d89d9f0505941c7ca24,1,219,0,219,1,2007-05-17 00:36:13,2007-05-10 10:36:15
126640afbc3732f3d7c65d89d9f0505941c7ca24...a5fc33b4937fb6f38918710be6f23ef925630a8a,1,18,28,46,11,2007-05-18 01:02:35,2007-05-12 23:48:31
a5fc33b4937fb6f38918710be6f23ef925630a8a...343cad921780be8eb55e10933c73bb5e04d2e0f2,1,134,94,228,44,2007-05-18 01:03:59,2007-05-13 02:17:03
343cad921780be8eb55e10933c73bb5e04d2e0f2...2624d9a5aa4a98fbfb91b330b297488365af4701,1,245,239,484,7,2007-05-18 01:05:46,2007-05-13 02:55:40
2624d9a5aa4a98fbfb91b330b297488365af4701...4db75b70d1a4c56bb6d91e03e6f9a84bccb6c760,2,0,174,174,2,2007-05-18 01:05:46,2007-05-13 03:52:24
4db75b70d1a4c56bb6d91e03e6f9a84bccb6c760...82c8bf28f8e4b5d2c647289abccb69b5fe69d3b1,2,42,52,94,2,2007-05-18 01:08:02,2007-05-13 04:14:40
82c8bf28f8e4b5d2c647289abccb69b5fe69d3b1...9e2163ea45b688e9de4744ebb9b01ea7e1ed8d56,2,296,297,593,2,2007-05-18 01:20:10,2007-05-13 05:48:47
9e2163ea45b688e9de4744ebb9b01ea7e1ed8d56...46acd3fa32404a9373d48c9caba271c34357ec9f,1,19,0,19,1,2007-05-18 01:58:51,2007-05-13 06:14:45
46acd3fa32404a9373d48c9caba271c34357ec9f...99eaefdd32f25a6b76b2bd52bb253e19a4a3cad4,1,3,0,3,1,2007-05-18 01:58:53,2007-05-13 06:23:11
99eaefdd32f25a6b76b2bd52bb253e19a4a3cad4...629d9f785fecb964245dac52b422aec0bd00278e,1,48,0,48,1,2007-05-18 01:58:53,2007-05-14 02:58:06
629d9f785fecb964245dac52b422aec0bd00278e...eda694491933ac5f209892f3e284b648bb0185a0,1,50,40,90,15,2007-05-18 03:23:08,2007-05-15 04:00:29
af9b54bb2cb0e15780bf3e820b5f1ce399deb2c4...2924415f4fb081d9dde687092248c86ec0c40195,1,1,1,2,1,2007-05-16 04:15:54,2007-05-15 12:39:25
2924415f4fb081d9dde687092248c86ec0c40195...8a912bcb250d8bf57b225e1cf02c0d69d54c8920,12,15,16,31,16,2007-05-16 04:16:03,2007-05-15 12:49:22
8a912bcb250d8bf57b225e1cf02c0d69d54c8920...b211c320eb5d753a7a44a03eccb9a15cfbcc563b,1,1,0,1,1,2007-05-16 19:40:06,2007-05-15 23:59:55
b211c320eb5d753a7a44a03eccb9a15cfbcc563b...7e431ef9ab933d7ff899a999e40627ab49774f3a,1,4,3,7,4,2007-05-16 19:40:06,2007-05-15 23:56:10
af9b54bb2cb0e15780bf3e820b5f1ce399deb2c4...c56f0d9c661dc918a088e60d0ab69dd48019a9be,1,30,15,45,7,2007-05-15 02:18:55,2007-05-09 23:06:36
e9d54bd18bcf5dc9eb68eb1cba9a6a7ba3f71fd6...bcd8ee5b4368594f2fe646c97d75a8bcdfb1d4e7,1,2,2,4,2,2007-04-30 22:50:13,2007-04-29 21:05:54
bcd8ee5b4368594f2fe646c97d75a8bcdfb1d4e7...b3cb7e4582410c7fcaa531a2283b43499eb8fb22,2,12,12,24,3,2007-04-30 22:58:37,2007-04-29 08:35:27
b3cb7e4582410c7fcaa531a2283b43499eb8fb22...a7af09d2dbf39bae4c12c7d1c8829f8598011257,1,9,1,10,3,2007-04-30 23:39:18,2007-04-30 16:04:25
a7af09d2dbf39bae4c12c7d1c8829f8598011257...34b604af293ec288ed11cbb5cac90a2ddb87e159,1,4,0,4,1,2007-04-30 23:43:12,2007-04-30 11:21:38
34b604af293ec288ed11cbb5cac90a2ddb87e159...928a559000e1c9ba0d570c5d3d4e11155b4d1ffd,1,4,3,7,2,2007-04-30 23:50:55,2007-04-30 12:37:28
928a559000e1c9ba0d570c5d3d4e11155b4d1ffd...b5cc62f701abf8b903387a5d7c77a59f347d66fd,2,15,7,22,4,2007-05-01 00:09:48,2007-05-01 00:09:48
25dc5e2995cc60c59a29b07963f71a1f7608b52f...28a94f885a735e7474357698ec384de24d526620,5,7,2,9,5,2007-04-29 09:05:06,2007-04-29 01:40:28
28a94f885a735e7474357698ec384de24d526620...093dc5bee61c47f5b0f3bea04339c9bf8839ca47,2,18,6,24,7,2007-04-29 09:05:06,2007-04-12 22:50:45
093dc5bee61c47f5b0f3bea04339c9bf8839ca47...7c1c6782e0b88c9366c575fd47e48050070afdd3,4,101,82,183,9,2007-04-29 09:05:06,2007-04-27 07:41:15
7c1c6782e0b88c9366c575fd47e48050070afdd3...f95673849c99baf3b10756e944d6ebe22394a2c0,1,39,3,42,10,2007-04-29 09:05:06,2007-04-27 07:42:15
f95673849c99baf3b10756e944d6ebe22394a2c0...e0173ad9fcabfcabe54d65be2c8b6602f61079e6,4,10,10,20,6,2007-04-29 09:05:11,2007-04-29 06:38:52
e0173ad9fcabfcabe54d65be2c8b6602f61079e6...96651ef50837e1c121def715dcf7416e9bcb1d0b,1,5,1,6,2,2007-04-29 09:05:11,2007-04-28 22:32:49
ce11873921e19be44082660882e07b205082643b...d1efefa46fda6bb68bcd73a5e532eef98ef28a1d,2,11,11,22,11,2007-04-25 21:22:24,2007-04-25 08:02:27
d1efefa46fda6bb68bcd73a5e532eef98ef28a1d...c21aa54e190e6527f05a2a943b343032e9dac90b,1,5,1,6,3,2007-04-26 00:34:37,2007-04-25 22:28:17
c21aa54e190e6527f05a2a943b343032e9dac90b...b03c7a63a0fae58a576749d7a6b0507edde12584,1,5,5,10,3,2007-04-26 03:58:02,2007-04-25 18:50:32
b03c7a63a0fae58a576749d7a6b0507edde12584...238cc6352eabe3f87f13093bc4015162bf424509,1,2,0,2,1,2007-04-26 03:58:46,2007-04-26 02:37:15
238cc6352eabe3f87f13093bc4015162bf424509...71c7da94218fbe36e64a326825ff30ef811b2a88,1,2,2,4,2,2007-04-26 03:59:57,2007-04-26 02:37:16
71c7da94218fbe36e64a326825ff30ef811b2a88...8e3d436b0b5148bac11259bac55621e285eeb6c4,1,6,4,10,4,2007-04-26 04:01:40,2007-04-26 02:37:17
8e3d436b0b5148bac11259bac55621e285eeb6c4...af068d274245be9aedc58e6835c2e43329639974,1,3,4,7,4,2007-04-26 04:03:03,2007-04-26 02:37:18
af068d274245be9aedc58e6835c2e43329639974...732263d411fe2e3e29ee9fa1c2ad1a20bdea062c,1,14,5,19,3,2007-04-26 04:11:15,2007-04-26 02:37:19
732263d411fe2e3e29ee9fa1c2ad1a20bdea062c...c38f0247a88f2c54c0c8535d645f33140201522f,1,2,1,3,2,2007-04-26 04:11:58,2007-04-26 02:37:20
c38f0247a88f2c54c0c8535d645f33140201522f...2b69bfc23d89d2ec5507bc6906b533e8429b313d,1,5,4,9,4,2007-04-26 04:12:16,2007-04-26 02:37:21
2b69bfc23d89d2ec5507bc6906b533e8429b313d...f073a592d6400b3aa653ce02943535bf917078b5,1,9,1,10,4,2007-04-26 04:15:16,2007-04-26 02:37:22
f073a592d6400b3aa653ce02943535bf917078b5...03044a9854b006a64c5117d971b01c1d1586edd9,1,9,0,9,1,2007-04-26 04:15:21,2007-04-26 02:37:23
03044a9854b006a64c5117d971b01c1d1586edd9...56973d20c181abdc5cc13eab976733feec0c590b,1,4,0,4,3,2007-04-26 06:05:44,2007-04-25 19:42:58
56973d20c181abdc5cc13eab976733feec0c590b...bf7af1167411cbdd5ade7587a64b18d1b7b2ea69,1,1,0,1,1,2007-04-26 06:18:17,2007-04-26 04:53:22
bf7af1167411cbdd5ade7587a64b18d1b7b2ea69...8abe88a29c0789276c6d028b76b1190630b101c6,2,39,1,40,2,2007-04-26 06:27:07,2007-04-26 06:27:07
520d7e278cfd25057e883575060b7378dfab61dc...886a39074be34d21afc6c1b8af1f7f4b3ef54dc5,1,4,0,4,1,2007-04-24 18:21:47,2007-04-24 18:21:47
886a39074be34d21afc6c1b8af1f7f4b3ef54dc5...b9d14ffbf1f42eb80231d0378dd2f019a162c054,1,5,3,8,3,2007-04-24 20:46:02,2007-04-24 20:46:02
520d7e278cfd25057e883575060b7378dfab61dc...40689ae1ef9a05503c75298ec50b194ca9d15522,1,3,0,3,1,2007-04-24 07:08:49,2007-04-22 16:43:56
40689ae1ef9a05503c75298ec50b194ca9d15522...a0cd87a57044efa8aef39b476fd9240af57a1853,2,10,2,12,6,2007-04-24 07:08:49,2007-04-23 20:55:05
a0cd87a57044efa8aef39b476fd9240af57a1853...e5709a4a6809e45bf59b851debf24a813e1c6b58,2,8,0,8,4,2007-04-24 07:08:49,2007-04-22 16:43:58
e5709a4a6809e45bf59b851debf24a813e1c6b58...bb6c2fba4103948445304493b6211998a02810ce,2,13,5,18,8,2007-04-24 07:08:49,2007-04-22 16:43:59
bb6c2fba4103948445304493b6211998a02810ce...01618a3ab131548582f4e2371b9b5e7328f61e4a,1,14,6,20,7,2007-04-24 07:08:49,2007-04-22 16:44:00
01618a3ab131548582f4e2371b9b5e7328f61e4a...43342941dd736fe06fe607a1594422cc8ba461a1,1,1,1,2,1,2007-04-24 07:08:49,2007-04-23 06:56:22
2c9750cc8b902a55669183e05533207dd7ec71fd...2a1a3dce3333950d16f78caf34b3bb2ac46ab4d4,1,0,1,1,1,2007-04-21 02:16:12,2007-04-21 01:30:06
2c9750cc8b902a55669183e05533207dd7ec71fd...dfdac5d9b877641d3aad8ec49f64c2730a3487e3,1,57,1,58,7,2007-04-20 08:47:47,2007-04-20 08:39:39
c214f2c80c70c2a3803bf1f3efc323cee5496024...b6c7c41b17857138491f4fd3392644326cf4e64d,1,0,2,2,2,2010-03-21 21:40:02,2010-03-21 17:30:16
b6c7c41b17857138491f4fd3392644326cf4e64d...dddfb3f1263d20a050890256dcbd5aeb00f221bb,1,1,1,2,1,2010-03-21 21:40:18,2010-03-21 17:30:17
dddfb3f1263d20a050890256dcbd5aeb00f221bb...a3cfb7f83f0e77a0e94716d08e2511084456c13e,1,0,6,6,6,2010-03-21 21:42:24,2010-03-21 17:30:18
a3cfb7f83f0e77a0e94716d08e2511084456c13e...476386858c70c1457bf32ff6d93b2100f03513fc,1,5,5,10,5,2010-03-21 21:45:05,2010-03-21 17:30:19
42c4b58059fa9af65e90f2c418bb551e30d1d32f...fdd3e7d95986ffe4c146952bc91d0b46964aeeb8,1,5,1,6,1,2007-04-22 06:51:27,2007-04-22 06:51:27
fdd3e7d95986ffe4c146952bc91d0b46964aeeb8...2d76548b6af66c49acaf0af7819c6dfb8fcf3389,2,2,2,4,2,2007-04-22 07:21:17,2007-04-22 07:11:41
2d76548b6af66c49acaf0af7819c6dfb8fcf3389...7392b03aa45846a4450e5990ce1381ed6fd706e2,1,51,26,77,7,2007-04-22 07:26:56,2007-04-22 07:26:56
7392b03aa45846a4450e5990ce1381ed6fd706e2...2b6854c863ae83dd8b4766a159a45a02e883a41f,1,18,12,30,9,2007-04-22 07:43:24,2007-04-22 01:14:39
2b6854c863ae83dd8b4766a159a45a02e883a41f...67e22ed58f776372de5ed0a5e6fb329bc24b52b2,1,5,5,10,3,2007-04-22 17:44:38,2007-04-22 14:12:22
67e22ed58f776372de5ed0a5e6fb329bc24b52b2...4629795816bf3f58a02872ec389a92de7efd38c4,1,4,2,6,2,2007-04-22 17:44:56,2007-04-22 14:11:54
4629795816bf3f58a02872ec389a92de7efd38c4...aef5aedd8536fddbbd2e19245dfab201d05afb25,1,6,0,6,2,2007-04-22 18:49:35,2007-04-22 18:49:35
aef5aedd8536fddbbd2e19245dfab201d05afb25...b6b32ccb927de0c631b1aaf27b1664bd4eb300c7,1,14,2,16,4,2007-04-22 19:28:34,2007-04-22 19:28:34
b6b32ccb927de0c631b1aaf27b1664bd4eb300c7...a5878961b14c1b4f6d1d08c0d3a2f5234659fb8a,1,11,11,22,10,2007-04-23 01:59:34,2007-04-23 01:59:34
a5878961b14c1b4f6d1d08c0d3a2f5234659fb8a...d83c9af5c6a437ddaa9dd2747e83aee642501a44,1,1,1,2,1,2007-04-23 02:00:16,2007-04-23 02:00:16
d83c9af5c6a437ddaa9dd2747e83aee642501a44...f1af60bdba465779df92090ed370988f202ff043,5,182,5,187,10,2007-04-23 05:16:14,2007-04-23 00:52:55
f1af60bdba465779df92090ed370988f202ff043...96a02f8f6d2192d3686cd1c719044082c89e8391,7,154,185,339,57,2007-04-23 05:18:05,2007-04-18 18:27:45
96a02f8f6d2192d3686cd1c719044082c89e8391...13aaf148258808437c485d3ef54c7ae7668384d7,6,27,34,61,14,2007-04-23 05:18:05,2007-04-20 18:10:07
13aaf148258808437c485d3ef54c7ae7668384d7...180a9f226860e18cdc2c3987ae89c239b318b408,2,40,0,40,6,2007-04-23 05:18:05,2007-04-20 19:05:27
180a9f226860e18cdc2c3987ae89c239b318b408...55a9137d8a33449425c55104c00bc9189381754a,1,2,7,9,1,2007-04-23 05:18:05,2007-04-20 19:27:44
55a9137d8a33449425c55104c00bc9189381754a...4280cde95fa4e3fb012eb6d0c239a7777baaf60c,2,7,0,7,4,2007-04-23 05:49:25,2007-04-23 05:49:25
b5da24679ec73f458988523dce9dd17b4e9b0e02...edbe4466746e577418b48922003a2c8a9cb55bee,2,8,5,13,2,2007-04-06 23:45:58,2007-04-06 21:52:39
edbe4466746e577418b48922003a2c8a9cb55bee...407049c59e0ac58076664981fde61e606a70686b,1,6,2,8,3,2007-04-06 23:46:06,2007-04-06 21:52:40
407049c59e0ac58076664981fde61e606a70686b...7bf77644e70d881f407c77e6d65ebe70c90916d6,1,6,4,10,4,2007-04-06 23:46:11,2007-04-06 21:52:41
7bf77644e70d881f407c77e6d65ebe70c90916d6...7b14b3c58034bdba3a5919e0e4536647c293f6cf,1,27,27,54,8,2007-04-06 23:46:16,2007-04-06 21:52:42
7b14b3c58034bdba3a5919e0e4536647c293f6cf...0e070f997b529e81f7daff79fea1b61bc9166f6b,1,3,3,6,3,2007-04-06 23:46:23,2007-04-06 21:52:43
0e070f997b529e81f7daff79fea1b61bc9166f6b...a925b89cea15c90ccf131a4ec9770ca1323e4a7f,1,1,1,2,1,2007-04-06 23:49:44,2007-04-05 23:50:24
a925b89cea15c90ccf131a4ec9770ca1323e4a7f...08b984fb5456c23b04c573f9021141ce27af707d,1,3,3,6,1,2007-04-06 23:51:46,2007-04-06 05:42:04
08b984fb5456c23b04c573f9021141ce27af707d...d26f9fef470443dfb0d09c08341634208f4fb6f7,1,1,1,2,1,2007-04-06 23:54:37,2007-04-06 08:33:06
d26f9fef470443dfb0d09c08341634208f4fb6f7...19eba1515a7d3b0dac6d4ee73492d978c3c2149b,2,6,10,16,3,2007-04-06 23:54:39,2007-04-06 12:13:00
19eba1515a7d3b0dac6d4ee73492d978c3c2149b...ae25c67acae4971594b574e4fc02b131a3da156a,1,4,4,8,4,2007-04-07 00:20:34,2007-04-06 23:48:36
ae25c67acae4971594b574e4fc02b131a3da156a...4c84f0dcc630817aaf71049163ee63b96d543a38,1,1,1,2,1,2007-04-07 00:21:11,2007-04-06 23:48:54
4c84f0dcc630817aaf71049163ee63b96d543a38...d93f7c1817f8b9e8bbb2e8ed70e87e84bc55b9f2,1,6,5,11,1,2007-04-07 04:19:28,2007-04-06 23:49:03
d93f7c1817f8b9e8bbb2e8ed70e87e84bc55b9f2...63b4b7a7ed657f406eb274f88a7e2c61fd6fe958,1,1,0,1,1,2007-04-07 04:29:15,2007-04-06 23:49:17
63b4b7a7ed657f406eb274f88a7e2c61fd6fe958...d79073922fcb8c8a0bd57112817a2154f1ed05c1,2,17,4,21,6,2007-04-07 04:29:16,2007-04-06 05:17:20
ee9693e246669f48f6b058a1044cefa973a44c22...68faf68938ee943fc251c702f2027e4dfda354db,7,373,3,376,14,2007-04-07 09:29:40,2007-02-16 00:32:45
ee9693e246669f48f6b058a1044cefa973a44c22...39878b0cb7d0afc3ff4c8adb715815f116188178,1,2,0,2,1,2007-04-07 09:27:31,2007-04-07 06:04:55
39878b0cb7d0afc3ff4c8adb715815f116188178...fd1d1b05e937ff3164be38b111e5d76d592ee548,1,8,7,15,7,2007-04-07 09:27:31,2007-04-07 06:04:53
49f582a0401f3b9b9a80ff6fe0dd601520579b7d...4c5c20261c5403650a31a91ebce0cc9444182383,1,3,1,4,1,2006-06-22 09:23:12,2006-06-20 13:41:05
4c5c20261c5403650a31a91ebce0cc9444182383...8adc4bd4a5e800a16e5680f4825ca76ed7cf9a2e,1,4,4,8,3,2006-06-22 09:25:39,2006-06-22 06:52:57
93326071ea84a7685783ae76d9a8cec0a11845d0...8dbbd14ea3ae1b4e825f1e7d314afddf26c67298,1,3,2,5,2,2006-06-30 06:48:29,2006-06-30 03:44:52
8dbbd14ea3ae1b4e825f1e7d314afddf26c67298...fc046a75d539a78e6b2c16534c4078617a69a327,4,27,13,40,8,2006-06-30 06:48:31,2006-06-30 04:38:55
f23c75a8eca5eeabf9aaf303ee7e14a94da42ddc...3dd4e7320de037a5b0adf3c53fbf5baf94a6c540,1,47,18,65,3,2006-07-04 10:14:23,2006-07-04 09:02:22
3dd4e7320de037a5b0adf3c53fbf5baf94a6c540...4205eca8de6163385eb1b6eb6577ef7acfe116e7,1,1,0,1,1,2006-07-04 21:32:52,2006-07-04 19:22:20
4205eca8de6163385eb1b6eb6577ef7acfe116e7...58ecf5c1cd9b2f712f85e23f065d3214cd867a71,3,8,16,24,6,2006-07-05 00:45:22,2006-07-05 00:45:22
58ecf5c1cd9b2f712f85e23f065d3214cd867a71...b7d936b2fd917bef7acf0edb086de5902449b780,1,1,1,2,1,2006-07-07 00:18:30,2006-07-06 07:16:35
6adc876016942161146e0cb782d55f28d77cc3f0...026625e78eaf8ea2ae960525c367b5e8f1629fd4,4,68,6,74,10,2006-06-29 19:07:27,2006-06-29 19:00:12
ac83aa2e1fffcb4e7560431ddc15b288dc237634...3d3e95af823787d5a7cb1810cdd3d0fed9e8ca57,1,1,1,2,1,2006-07-06 23:50:50,2006-07-06 20:35:54
ac83aa2e1fffcb4e7560431ddc15b288dc237634...b75bf2c3f08b70a3e4850867290a8c215d2c1abf,1,24,8,32,11,2006-07-06 07:10:49,2006-07-05 21:17:49
9843c3074dfbf57117565f6b7c93e3e6812857ee...6e2dda35c2f012298f4f4759db2d651ef18e39a0,1,9,1,10,3,2005-09-22 00:07:36,2005-09-22 00:07:36
6e2dda35c2f012298f4f4759db2d651ef18e39a0...a69875318bf5f7a493ecb77c63073ee18f8ad557,1,1,1,2,1,2005-09-26 00:22:43,2005-09-26 00:22:43
a69875318bf5f7a493ecb77c63073ee18f8ad557...9e026d3967776a1c1206890492ffc9d172bf1e9b,1,1,1,2,1,2005-09-27 00:29:41,2005-09-27 00:29:41
b30245c8e92ecaf8fb877189d7620a5a9a205120...e20ce6ac762589868e46603ee1223f2f852c4403,1,2,2,4,2,2005-08-19 23:19:16,2005-08-18 07:59:37
66e06b6a17f1074401ad23f4b2a8a146b2900333...1bff6490b0225aef07d2fd13cbb806ac8ce115de,1,1,6,7,1,2005-08-18 22:52:58,2005-08-18 22:52:58
1bff6490b0225aef07d2fd13cbb806ac8ce115de...d571c2be99cb4ab96ff70c62c31d587271db9567,1,8,0,8,2,2005-08-18 23:26:50,2005-08-18 22:31:40
d571c2be99cb4ab96ff70c62c31d587271db9567...a8055f8a8ed10a6d3272382f38a0808427ab4921,1,3,1,4,1,2005-08-18 23:30:36,2005-08-18 23:30:36
a8055f8a8ed10a6d3272382f38a0808427ab4921...75ea6911d64bbe1b202eed61eda3ebaa4d76cb99,1,1,1,2,1,2005-08-19 04:55:46,2005-08-19 04:10:08
af36b70ef939cc44c447a4b9cbaadd7eba9a20b1...0cfe1d303ab1cab13315c1d42df26ab93bf09b86,1,72,4,76,6,2005-08-14 01:28:47,2005-08-13 06:39:15
0cfe1d303ab1cab13315c1d42df26ab93bf09b86...314082512403f7f6969cc6d5ded4a48c68a9962e,1,130,0,130,1,2005-08-14 01:28:49,2005-08-13 06:48:09
314082512403f7f6969cc6d5ded4a48c68a9962e...02a4a32c2da9a89eb9ebc58325adcb47775c9ed5,2,5,9,14,2,2005-08-14 01:28:50,2005-08-13 17:50:56
02a4a32c2da9a89eb9ebc58325adcb47775c9ed5...3c3852e33b3e40ad64885d845cb92a52c7b15884,1,1,1,2,1,2005-08-14 01:28:51,2005-08-13 18:05:25
3c3852e33b3e40ad64885d845cb92a52c7b15884...31f584c242e7af28018ff920b6c8d1952beadbd4,1,2,1,3,2,2005-08-14 01:28:52,2005-08-13 15:29:32
31f584c242e7af28018ff920b6c8d1952beadbd4...e54c5ea93e0785dfd37fd9201797977a02ca0ddb,2,3,3,6,3,2005-08-14 01:28:54,2005-08-13 10:22:46
e54c5ea93e0785dfd37fd9201797977a02ca0ddb...068eac91ce04b9aca163acb1927c3878c45d1a07,3,7,8,15,5,2005-08-14 01:28:55,2005-08-13 10:58:56
50d89ad6542c8acafefa6d42f8b42dfa9b8fafe1...85566460897ee76555a7c90a951fe2d50272eb5e,2,34,0,34,2,2012-09-07 17:01:35,2012-09-05 21:22:19
422a82f21370fe38b3e926a83b460bf2b1dd13ab...54bc13ce5300bf7c2237aba3fd123dd587e56d31,4,19,17,36,9,2009-07-25 09:14:56,2009-06-19 02:18:37
f87dd2152a6941dfa7f3ddaf599bc30f58562a98...397f7c6371d309aa399bf32b773397f3c068d0c9,1,13,2,15,5,2009-07-24 16:27:18,2009-07-22 08:31:34
0ad8ff2cd185e84fd49dd961370411e379681f10...53d48885931614a43e414e1272a7f126f8d0c901,3,129,9,138,10,2009-07-25 09:17:54,2009-07-24 21:59:28
0ad8ff2cd185e84fd49dd961370411e379681f10...4aacaeb3dc82bb6479e70e120053dc27a399460e,2,31,0,31,2,2009-07-23 06:45:29,2009-07-20 09:06:24
0a53e9ddeaddad63ad106860237bbf53411d11a7...5ed5bbc7e1c3a0144db42d6ec4689e01b2f37516,1,2,3,5,3,2009-08-05 19:37:13,2009-08-02 07:42:24
0a53e9ddeaddad63ad106860237bbf53411d11a7...85738ba3df8ae7e01091b479be7f67383ce250b6,1,2,2,4,1,2009-08-05 19:36:38,2009-08-01 18:49:47
85738ba3df8ae7e01091b479be7f67383ce250b6...46068383aa825dfe9026f9255cea07da07e06253,1,6,0,6,1,2009-08-05 19:36:38,2009-08-04 15:54:32
0a53e9ddeaddad63ad106860237bbf53411d11a7...4f6339b0c353b5c03b566b605e50a743d97fc08e,1,87,0,87,1,2009-07-30 03:18:25,2009-07-29 21:02:39
4f6339b0c353b5c03b566b605e50a743d97fc08e...77716755cbdf970fa0814a5f77c884b1f17693de,2,5,1,6,2,2009-07-30 03:20:12,2009-06-14 13:08:28
77716755cbdf970fa0814a5f77c884b1f17693de...b6986d8a75812a003a1623e0f0dff93c4a026b44,3,18,2,20,4,2009-07-30 03:24:28,2009-07-30 03:22:25
0a53e9ddeaddad63ad106860237bbf53411d11a7...17635fc900674037bcaa9ca0fadcc5c23d6162e9,2,35,21,56,13,2009-07-29 19:34:56,2009-07-15 22:31:12
0a53e9ddeaddad63ad106860237bbf53411d11a7...a0f4afbe87ddda7902e36350d163dea146166550,6,63,5,68,11,2009-07-29 19:22:30,2009-06-30 22:33:45
0a53e9ddeaddad63ad106860237bbf53411d11a7...f245194f9a13d5108c3a59fd4ab1770ae9fd5b65,4,97,4,101,8,2009-07-29 17:22:39,2009-05-22 19:45:29
f245194f9a13d5108c3a59fd4ab1770ae9fd5b65...90b1994170900514a1ce7a3345e25cb7216915cc,7,9,9,18,9,2009-07-29 17:22:39,2009-05-23 08:15:35
0a53e9ddeaddad63ad106860237bbf53411d11a7...6641575963388b61f408f177d91cdacad25d2e26,3,53,2,55,3,2009-07-29 16:33:29,2009-07-29 16:33:29
d9eb0205a217984f3e70bf18ae66c02a22d3d475...596f91ee70552230636aee5ee6cdabc0082d473a,2,31,22,53,4,2009-07-12 21:36:40,2009-07-12 10:24:32
d9eb0205a217984f3e70bf18ae66c02a22d3d475...3c49a03524b686c7b575e0a667736217e5445447,1,23,22,45,4,2009-07-11 21:14:32,2009-07-06 23:39:52
3c49a03524b686c7b575e0a667736217e5445447...0b2af457a49e3b00d47d556d5301934d27909db8,2,21,30,51,15,2009-07-11 21:14:32,2009-07-06 23:40:02
0b2af457a49e3b00d47d556d5301934d27909db8...b3e95936274a7f5d516e7c37b39e1a56b2d09709,1,7,7,14,7,2009-07-11 21:14:36,2009-07-11 21:13:12
b3e95936274a7f5d516e7c37b39e1a56b2d09709...69fb8283937a18a031aeef12ea2a530c8ccf3e83,1,1,1,2,1,2009-07-13 18:09:02,2009-07-12 12:31:28
69fb8283937a18a031aeef12ea2a530c8ccf3e83...2657420d9ecee5c68f300cdabdf2bec7e76a2d05,2,5,0,5,2,2009-07-13 18:09:41,2009-07-13 15:11:44
2657420d9ecee5c68f300cdabdf2bec7e76a2d05...4fe1a61973c82c459ac0a25cb5342d00d347dfd9,1,1,1,2,1,2009-07-13 18:09:51,2009-07-13 15:11:45
4fe1a61973c82c459ac0a25cb5342d00d347dfd9...f222abdeec7838891e79abd152c6cb67e532b68d,1,1,1,2,1,2009-07-14 20:50:29,2009-07-13 21:41:12
f222abdeec7838891e79abd152c6cb67e532b68d...a38837341c995773f2adc29ff5971196187b07fb,1,2,1,3,1,2009-07-14 20:50:33,2009-07-14 18:25:17
a38837341c995773f2adc29ff5971196187b07fb...05c1da2f5e7a5c0d2bbd1154bbb6c5cc9cb2b17f,1,1,1,2,1,2009-07-14 22:17:01,2009-07-14 21:19:10
05c1da2f5e7a5c0d2bbd1154bbb6c5cc9cb2b17f...4525e8e41a8c0c4246a95097744604ea72198dad,3,2,9,11,5,2009-07-15 22:10:06,2009-07-15 22:10:06
a69f8c980933b420b9ab5ca1391e55fcc119bc49...cff4231a1dfbe68b4a163b31406d862567d3243a,3,40,2,42,3,2009-06-22 04:15:50,2009-06-22 04:02:49
5a56da58060e50980fab0f4c38203a25440d1530...db137fe91ea4afda7a2073364c610fe61dc769b8,2,31,4,35,3,2009-08-17 16:20:52,2009-08-17 15:35:44
3125be17d66e65c854249fb6a0c05322798593fe...4ecbc178704ca6c1027a38483e98f5fe493b1322,1,7,7,14,3,2009-07-09 08:19:51,2009-07-09 06:37:35
11a264050f61bb15c413cced058db2ac96fd96f9...f39a946a1fb0fa4856cd0027b9da3603a1b06fdc,3,168,19,187,24,2007-07-10 03:06:16,2007-07-10 02:58:23
f39a946a1fb0fa4856cd0027b9da3603a1b06fdc...52aaf649cb70134090c3e3a762bed730d5451c17,2,46,15,61,5,2007-07-10 06:39:59,2007-07-09 13:47:24
52aaf649cb70134090c3e3a762bed730d5451c17...54dadbdb29668fbd51effefd0a0c65d915f5422b,1,2,3,5,2,2007-07-10 06:39:59,2007-07-10 01:30:39
54dadbdb29668fbd51effefd0a0c65d915f5422b...dfd255dd1a7c04ad24891db50e5d80d96f93fd4a,3,30,4,34,6,2007-07-10 06:39:59,2007-07-10 04:47:23
dfd255dd1a7c04ad24891db50e5d80d96f93fd4a...1d735267c9fb74892b0db41b567dc55dcc878006,1,11,10,21,8,2007-07-10 06:39:59,2007-07-10 04:47:26
baa79ca42d0ba5e93e4bb021706ec9a65cca6dda...55feb1200f0e1a7f6cb8670de0dee97f09d8cb9f,1,4,1,5,2,2007-07-11 19:58:32,2007-07-05 00:36:48
55feb1200f0e1a7f6cb8670de0dee97f09d8cb9f...835252272e0192bd26983e22428480c5c89775fb,3,33,0,33,5,2007-07-11 20:52:16,2007-07-11 14:18:17
835252272e0192bd26983e22428480c5c89775fb...36d56de649aacdbf555d2c9743c514cc52368f2c,2,50,2,52,4,2007-07-11 21:59:31,2007-07-10 13:50:49
36d56de649aacdbf555d2c9743c514cc52368f2c...defd53142e0c3326c3677cc3d623a6aeef899518,1,13,24,37,26,2007-07-11 22:02:05,2007-07-10 21:53:45
defd53142e0c3326c3677cc3d623a6aeef899518...b61a8a67478310eb3349d869119ce7a729090273,1,51,0,51,2,2007-07-11 22:02:56,2007-07-10 21:59:43
b61a8a67478310eb3349d869119ce7a729090273...5206d13091a38b2fef534c78e893814dbab0af26,1,201,1,202,3,2007-07-11 22:04:00,2007-07-10 23:11:53
5206d13091a38b2fef534c78e893814dbab0af26...b42f69273bf5ae2d5bb0c7479bfa9827e7b351ac,3,51,18,69,10,2007-07-11 22:28:15,2007-07-10 17:48:40
b42f69273bf5ae2d5bb0c7479bfa9827e7b351ac...6f084a56fcb3543d88d252bb49c1d2bbf2bd0cf3,4,69,132,201,25,2007-07-11 23:03:58,2007-07-10 17:50:44
6f084a56fcb3543d88d252bb49c1d2bbf2bd0cf3...73f893605050c291dd8c4d8f3f50b8fec47dcf51,1,212,0,212,1,2007-07-12 04:15:23,2007-07-12 03:02:25
73f893605050c291dd8c4d8f3f50b8fec47dcf51...975e0daf5edba09060147d643e628b8c89e1d467,2,38,25,63,17,2007-07-12 04:17:07,2007-07-11 18:50:34
975e0daf5edba09060147d643e628b8c89e1d467...d972cce06da6e4e6cfcdce8417910bb4a7772ae2,1,1,1,2,1,2007-07-12 05:52:45,2007-07-12 05:52:45
baa79ca42d0ba5e93e4bb021706ec9a65cca6dda...c7bd55028ff463fa0162bffb35ac519beb462ca5,1,1,1,2,1,2007-07-10 13:51:42,2007-07-10 13:51:42
c7bd55028ff463fa0162bffb35ac519beb462ca5...48b4c3d5ab1610c6dc0198fe94334d78e8a82e16,1,5,1,6,1,2007-07-15 02:47:14,2007-07-13 12:39:05
48b4c3d5ab1610c6dc0198fe94334d78e8a82e16...b6f3481bb456acbbb990a1045344bb06e5a40283,3,195,9,204,13,2007-07-15 05:41:23,2007-07-15 05:40:37
9adccb057e2654f259bd98c04012e97a30322c1b...a46fe1c1c0007fbbe0c196e7cc0db89567a8eae0,1,40,2,42,25,2007-06-06 05:26:42,2007-06-01 03:58:55
a46fe1c1c0007fbbe0c196e7cc0db89567a8eae0...d89a494fcae246b696a2fe234ccf166669a3a45e,1,38,39,77,17,2007-06-06 05:26:43,2007-06-01 04:05:49
d89a494fcae246b696a2fe234ccf166669a3a45e...bea39c2ddb01af2908a5932231fde02b52a262d7,1,9,4,13,1,2007-06-06 05:26:43,2007-06-01 04:08:58
bea39c2ddb01af2908a5932231fde02b52a262d7...f96cd7b6c9e9664d2fd6ec50bbade126355ad4f4,1,30,46,76,13,2007-06-06 05:26:43,2007-06-01 04:38:31
f96cd7b6c9e9664d2fd6ec50bbade126355ad4f4...c9e6bfd8a9a18c12d01e0d96c74ca0a7f64a2846,1,22,3,25,3,2007-06-06 05:26:44,2007-06-01 05:04:46
c9e6bfd8a9a18c12d01e0d96c74ca0a7f64a2846...37ebc93f6dddb6d73034f027873266eef1e3e774,1,3,0,3,2,2007-06-06 05:26:45,2007-06-01 06:59:21
37ebc93f6dddb6d73034f027873266eef1e3e774...41bf23d6cc58c229e5e966a98c1b2c9cd06e95f7,1,125,1,126,5,2007-06-06 05:26:45,2007-06-01 07:01:45
41bf23d6cc58c229e5e966a98c1b2c9cd06e95f7...74fe89857807c2194b1c202b4e429289d777ecb2,1,23,5,28,4,2007-06-06 05:26:45,2007-06-01 07:19:27
74fe89857807c2194b1c202b4e429289d777ecb2...8154e1a624cd768aada2565857151e6032b42a8c,1,0,6,6,1,2007-06-06 05:26:45,2007-06-01 07:33:28
8154e1a624cd768aada2565857151e6032b42a8c...b5a4122474486ccf785dfb78e939e040ac43067c,1,1,1,2,1,2007-06-06 05:26:46,2007-06-01 07:34:00
b5a4122474486ccf785dfb78e939e040ac43067c...ddc1fa8f883fdef4d7501f3f08474f8f75927533,1,3,3,6,3,2007-06-06 05:26:46,2007-06-01 19:31:01
ddc1fa8f883fdef4d7501f3f08474f8f75927533...223475a77c36919942c92f66c87b1e772a0ee2af,1,47,11,58,8,2007-06-06 05:26:46,2007-06-01 20:10:56
223475a77c36919942c92f66c87b1e772a0ee2af...d0b741dc08d1c036e0fbf68c72dda02545c39b85,1,79,25,104,18,2007-06-06 05:26:46,2007-06-01 21:55:43
d0b741dc08d1c036e0fbf68c72dda02545c39b85...982cf98fa47b8db890b84febda325e461f8a407d,1,20,8,28,5,2007-06-06 05:26:47,2007-06-01 22:29:20
982cf98fa47b8db890b84febda325e461f8a407d...22c6769d917635732fe9e6824aa30536155266b3,1,188,30,218,20,2007-06-06 05:26:47,2007-06-02 01:47:12
22c6769d917635732fe9e6824aa30536155266b3...669fbc3d09b259bb3bc3bd2ab126ceb28db61b16,1,9,3,12,3,2007-06-06 05:26:47,2007-06-02 01:54:06
669fbc3d09b259bb3bc3bd2ab126ceb28db61b16...79c50bf3ee1e0fb5c257ed6f6680cae726a4c412,1,7,0,7,1,2007-06-06 05:26:47,2007-06-02 01:59:29
79c50bf3ee1e0fb5c257ed6f6680cae726a4c412...08dda17e00e676c5cd1b4f2a8245c318d6c97f82,1,6,2,8,2,2007-06-06 05:26:48,2007-06-02 03:48:18
08dda17e00e676c5cd1b4f2a8245c318d6c97f82...b55a243dfc51865445e4b13e84dc6d4cb917bcdf,1,3,0,3,1,2007-06-06 05:26:48,2007-06-02 04:09:55
b55a243dfc51865445e4b13e84dc6d4cb917bcdf...0eab69a4a97294c9d6751fad17d1273e28f4a4cd,1,3,27,30,15,2007-06-06 05:26:48,2007-06-02 06:38:26
0eab69a4a97294c9d6751fad17d1273e28f4a4cd...063257076d8ea2bbf185ca33192583e03099e955,1,10,1,11,4,2007-06-06 05:26:48,2007-06-02 06:55:53
063257076d8ea2bbf185ca33192583e03099e955...000a10696c0bc1e428bbd22af9e19b27795e72dd,1,3,2,5,3,2007-06-06 05:26:49,2007-06-02 18:31:01
000a10696c0bc1e428bbd22af9e19b27795e72dd...375e1365a62df3cd944ec0e91051b94d710a7c6d,1,1,1,2,1,2007-06-06 05:26:49,2007-06-02 18:35:44
375e1365a62df3cd944ec0e91051b94d710a7c6d...81fb7efeda2ce14cbb44b91eed37aeeb2e541832,1,7,0,7,2,2007-06-06 05:26:49,2007-06-02 18:41:10
81fb7efeda2ce14cbb44b91eed37aeeb2e541832...b61101579fdc647c14a54105a361b549a97c09a4,1,1,4,5,3,2007-06-06 05:26:49,2007-06-02 18:45:35
b61101579fdc647c14a54105a361b549a97c09a4...c17c1751339bbb13e8927b0e98274cfee406821e,1,34,32,66,13,2007-06-06 05:26:50,2007-06-02 19:13:35
c17c1751339bbb13e8927b0e98274cfee406821e...14c4dfd3d1807885121b5e7b16610e335f824da4,1,46,75,121,17,2007-06-06 05:26:50,2007-06-02 19:34:52
14c4dfd3d1807885121b5e7b16610e335f824da4...2f85b7e4b421ab032cc2342808640479a988277f,1,39,30,69,19,2007-06-06 05:26:50,2007-06-02 20:01:43
2f85b7e4b421ab032cc2342808640479a988277f...c5db65aef3b4268adbadc8019ecbd7d3fdc374e8,1,2,0,2,1,2007-06-06 05:26:50,2007-06-02 20:03:52
c5db65aef3b4268adbadc8019ecbd7d3fdc374e8...fc816d7b857a5033982b421a384f7b2d932f57e6,1,58,58,116,44,2007-06-06 05:26:51,2007-06-03 03:26:24
fc816d7b857a5033982b421a384f7b2d932f57e6...debcd0fd02bda82e3c81e6739bcb26135ac00b85,3,12,1,13,8,2007-06-06 05:26:51,2007-06-02 21:15:56
debcd0fd02bda82e3c81e6739bcb26135ac00b85...172c92b47512adc45516cd72e607bea55b2414b4,1,113,63,176,44,2007-06-06 05:26:51,2007-06-02 22:21:18
172c92b47512adc45516cd72e607bea55b2414b4...383d4e0f8b72f739c16ef7d723a134d59a0a0c2f,1,72,58,130,20,2007-06-06 05:26:52,2007-06-02 23:03:55
383d4e0f8b72f739c16ef7d723a134d59a0a0c2f...0dfed77b3cc81342aee4c81e477d636a378c51cb,1,42,13,55,16,2007-06-06 05:26:52,2007-06-04 08:07:35
0dfed77b3cc81342aee4c81e477d636a378c51cb...5d198d676667ecd3beeac816049bfc777b9c8566,1,61,19,80,16,2007-06-06 06:53:36,2007-06-06 06:53:36
5d198d676667ecd3beeac816049bfc777b9c8566...949da61b9b84bfb48ed2ff2dea068a1d19fb847b,1,6,4,10,4,2007-06-06 07:03:52,2007-06-06 07:03:16
949da61b9b84bfb48ed2ff2dea068a1d19fb847b...0f32da53df706220e7392a29d8e462b57345df3d,1,13,9,22,8,2007-06-06 07:22:22,2007-06-06 07:22:22
0f32da53df706220e7392a29d8e462b57345df3d...d80ded01de0189fe7179913d3ecdeecadf2052a0,1,7,7,14,6,2007-06-08 06:50:07,2007-06-08 06:02:48
996e2d6ea2626f55a59e70ac7305a02ce0171814...41cf68a85ca2a9199b32eb3932582b234fa474b4,3,55,2,57,3,2007-06-02 23:02:49,2007-06-02 22:01:33
bd724be4bec4e75014e8e528a9c3c9a90b2d4488...b75c6c6de1e8f801edb142b59e7809a166a63adc,1,1,1,2,1,2007-05-31 07:15:18,2007-05-29 19:08:35
b75c6c6de1e8f801edb142b59e7809a166a63adc...5049012f4f9fc754c68d5e89ddabd4f664cea0a7,1,3,3,6,2,2007-05-31 23:22:28,2007-05-31 23:00:48
5049012f4f9fc754c68d5e89ddabd4f664cea0a7...302665473cfe233516cc4c29a1a0359153e5506d,1,0,1,1,1,2007-06-02 18:26:51,2007-06-02 17:56:44
03f6db0ec058ca1d34672a3100293c3bf56c3b6b...e40a30452d3ab024b06238abab3968b872dd5e1c,1,1,1,2,1,2007-05-20 07:19:48,2007-05-20 00:53:45
e40a30452d3ab024b06238abab3968b872dd5e1c...aba170cdb4874b72dd619e6f7bbc13c33295f831,3,26,22,48,12,2007-05-20 07:30:39,2007-05-20 07:30:39
337233c5021745b802bb4b9e862a1fe89ffc0527...670a3c1d5a27bfb1cc6b526559c6f5874f00042f,1,21,0,21,3,2014-10-14 17:59:04,2014-10-14 17:59:04
fbf5df024e9137d446c5a85adeae7e4780365d1b...302b9282c9ddfcc704ca759bdc98c1d5f75eba2f,14,27,27,54,25,2007-05-22 06:34:54,2007-05-21 20:08:28
302b9282c9ddfcc704ca759bdc98c1d5f75eba2f...23615708e2abef5c293ddee9335950161a038133,4,44,7,51,13,2007-05-22 06:56:28,2007-05-21 07:20:25
2555699aa2863861e32d222ede2c3df2dbf92088...32309f54ed4b71510f67f2376d755cd2733f29b1,1,5,2,7,3,2007-05-23 07:17:51,2007-05-23 05:52:59
322bcd9a9a2c0081c66414bde64e0d443c9ec922...65c6aca4d4c6fabc2767b8fa1ce7e67d3d594b1e,1,5,4,9,7,2007-05-30 17:45:55,2007-05-30 00:55:47
65c6aca4d4c6fabc2767b8fa1ce7e67d3d594b1e...5c5ba73b21a6910ee67d97cb87a5d78409112375,1,5,19,24,4,2007-05-31 01:23:37,2007-05-30 23:18:24
5c5ba73b21a6910ee67d97cb87a5d78409112375...f7c22cc68ccba0cb5bbd43177507795c48afb1f5,1,18,4,22,8,2007-05-31 06:35:07,2007-05-31 02:48:13
322bcd9a9a2c0081c66414bde64e0d443c9ec922...a588d88aaff312f3afd5713ffcb4e4b1829fb5a6,1,6,2,8,1,2007-05-29 08:24:42,2007-05-28 21:20:57
a588d88aaff312f3afd5713ffcb4e4b1829fb5a6...074b2eea296886e179ef73e1c364f370a223618a,2,59,15,74,9,2007-05-29 08:24:42,2007-05-28 21:20:58
074b2eea296886e179ef73e1c364f370a223618a...e3dfddb377478dbee9c5b88636e97d62312f562d,2,12,0,12,4,2007-05-29 08:24:42,2007-05-28 21:20:59
e3dfddb377478dbee9c5b88636e97d62312f562d...5476a8adcc29985e5496dac7a340dfd178f43a17,1,11,18,29,3,2007-05-31 06:32:42,2007-05-31 01:43:12
a3342a2f52a5351739577f8773eab2a1db20b651...1d431b22357389d0833830daf814ff0c4dc9189d,1,69,0,69,1,2007-05-22 07:00:42,2007-05-20 22:31:56
1d431b22357389d0833830daf814ff0c4dc9189d...1978659a7421098095fd6a8613302771cae81dd1,1,69,0,69,1,2007-05-22 07:00:42,2007-05-20 22:31:57
1978659a7421098095fd6a8613302771cae81dd1...240ba7f235c9b946678bd6d34826fb73ea8fd90e,1,34,0,34,1,2007-05-22 07:00:42,2007-05-20 22:31:58
a3342a2f52a5351739577f8773eab2a1db20b651...bc32fed5516375ef78bc0f6270eb57bf1bb12d47,1,14,13,27,12,2007-05-22 06:58:20,2007-05-19 07:19:23
bc32fed5516375ef78bc0f6270eb57bf1bb12d47...a74db82e15cd8a2c53a4a83e9a36dc7bf7a4c750,1,34,1,35,7,2007-05-22 06:58:20,2007-05-19 07:39:31
a74db82e15cd8a2c53a4a83e9a36dc7bf7a4c750...6315d52a84e4e6016acf7095ce4c88abffad6496,1,0,2,2,1,2007-05-23 06:04:49,2007-05-23 06:04:49
164b19893ab5bc66b531a26480149a0dff082969...a5c2d26a044af3899669b010a5b85801a8c2b6a7,1,2,2,4,2,2007-05-19 00:12:10,2007-05-18 23:21:53
cecb98a9c3ed9271b0974bb6d7edbcf16e8a68f3...6b68342edc392bb640b30c2115eb6585a3303e25,2,14,3,17,4,2007-05-19 00:21:43,2007-05-19 00:21:31
fdcb769916c93b53517ef1b4cae447a3333c9b86...d26c4264e584a1a8cbadbc161fa52cf947f5230a,1,8,1,9,1,2007-05-16 23:13:42,2007-05-16 22:05:55
d26c4264e584a1a8cbadbc161fa52cf947f5230a...2eb54efc6c12cb20403db9a4739bd736c3bfaad1,1,3,1,4,1,2007-05-17 04:04:16,2007-05-17 04:04:16
fdcb769916c93b53517ef1b4cae447a3333c9b86...7841ce79854868eaaa146c1d018b17fc4f3320be,6,30,11,41,17,2007-05-16 19:48:18,2007-05-16 17:09:41
b5cc62f701abf8b903387a5d7c77a59f347d66fd...775477aa1da94cb9fb9b9afdc217231a0cd42ac1,1,19,0,19,1,2007-05-02 17:22:34,2007-05-01 21:42:44
b5cc62f701abf8b903387a5d7c77a59f347d66fd...adb7b5fc86d96fc2baf5a5c0ce12fb581b3ad275,1,3,2,5,3,2007-05-01 09:59:08,2007-05-01 09:47:55
adb7b5fc86d96fc2baf5a5c0ce12fb581b3ad275...a7da9adb1ff4e2a378fdb2eb486a83ee2d68c847,1,1,1,2,1,2007-05-02 17:41:52,2007-05-02 00:43:14
a07157ac624b2524a059a3414e99f6f44bebc1e7...600682aaa12c56d55bd24233828205c43ece2ded,1,1,1,2,1,2007-04-30 23:57:47,2007-04-30 22:22:53
600682aaa12c56d55bd24233828205c43ece2ded...8503ee4394dd47af136019bd8da53e5adec17e5d,1,3,0,3,1,2007-04-30 23:57:50,2007-04-30 22:26:36
8503ee4394dd47af136019bd8da53e5adec17e5d...e44b5d106c2934b93cfba2ea7fb2ed1e32edaae2,2,2,3,5,2,2007-04-30 23:57:52,2007-04-30 22:27:05
e44b5d106c2934b93cfba2ea7fb2ed1e32edaae2...fe5d30b6302369990499c428b28921b903153b81,1,1,0,1,1,2007-04-30 23:57:59,2007-04-30 22:31:52
8abe88a29c0789276c6d028b76b1190630b101c6...4551d05fe44c6d87ff8a24cfba7a79bba0179d5e,2,3,3,6,3,2007-04-27 05:43:10,2007-04-27 04:58:55
4551d05fe44c6d87ff8a24cfba7a79bba0179d5e...42905294de0c1885f5636319c4790f184d767875,1,12,5,17,3,2007-04-27 05:43:10,2007-04-27 04:58:56
42905294de0c1885f5636319c4790f184d767875...2bc060cc6fce9f51240bf35803a5690dd1813c7c,1,24,1,25,2,2007-04-27 05:43:10,2007-04-27 04:58:57
2bc060cc6fce9f51240bf35803a5690dd1813c7c...cf0d720b7f861e90b9cadfc989d5b57c4b1ff531,1,15,4,19,5,2007-04-27 05:43:10,2007-04-27 04:58:58
cf0d720b7f861e90b9cadfc989d5b57c4b1ff531...a44f88e251a82c32dcc4715f063e3e3e39562a8d,1,22,2,24,1,2007-04-27 05:43:10,2007-04-27 04:58:59
a44f88e251a82c32dcc4715f063e3e3e39562a8d...d8190a8ec86bc9c75cd85352b0a186991c70a5bb,1,11,2,13,3,2007-04-27 05:43:10,2007-04-27 04:59:00
d8190a8ec86bc9c75cd85352b0a186991c70a5bb...f5158a07d26b957f700dc6cc4fdb5a693a1314b3,1,14,0,14,2,2007-04-27 05:43:10,2007-04-27 04:59:01
f5158a07d26b957f700dc6cc4fdb5a693a1314b3...71e2e5993b6f2afdfda0cc92e0d55e84c9f876b0,1,4,0,4,1,2007-04-27 05:43:11,2007-04-27 04:59:02
edb4fd79ec34254fc4a1c35e8834df4c92cb3bfd...0b952a98f1dafc61e966237947e7836814fb74f5,1,2,2,4,2,2007-04-15 22:59:09,2007-04-15 21:40:31
0b952a98f1dafc61e966237947e7836814fb74f5...b0732115342d190d8c547ceaf5bf7a3534e3be5d,1,7,7,14,7,2007-04-15 22:59:09,2007-04-15 18:51:29
edb4fd79ec34254fc4a1c35e8834df4c92cb3bfd...d0bfd026a8241d544c339944976927b388d61a5e,8,453,2,455,10,2007-04-14 15:57:06,2007-04-12 08:07:32
d0bfd026a8241d544c339944976927b388d61a5e...35ebfd6a0cd71795c4fa510b99e55ad89fb654f1,3,84,7,91,7,2007-04-14 15:57:06,2007-04-13 05:30:05
35ebfd6a0cd71795c4fa510b99e55ad89fb654f1...8c701249d2257699c19822b528c101668abc55b9,2,31,27,58,11,2007-04-14 15:57:06,2007-04-13 06:05:29
8c701249d2257699c19822b528c101668abc55b9...201ac8efc79668353281583629aa15ac7f36e843,1,78,44,122,15,2007-04-15 20:35:45,2007-04-15 20:35:45
201ac8efc79668353281583629aa15ac7f36e843...40250af411f33afa0c39a5d461829b676453ce3b,1,3,2,5,1,2007-04-15 21:35:11,2007-04-15 21:35:11
40250af411f33afa0c39a5d461829b676453ce3b...6d4da3dea0ba01bb17a9001efd3ab2bbce531b6f,1,1,1,2,1,2007-04-15 21:35:34,2007-04-15 20:39:32
6d4da3dea0ba01bb17a9001efd3ab2bbce531b6f...f48fd68887a03756658a46486a5dd1301c5a655f,2,132,48,180,32,2007-04-15 22:43:06,2007-04-14 15:54:37
f48fd68887a03756658a46486a5dd1301c5a655f...fc2d07b05fb691f98b3a55c1499fae6fb25a7d31,1,1,0,1,1,2007-04-15 22:49:41,2007-04-14 15:56:35
fc2d07b05fb691f98b3a55c1499fae6fb25a7d31...e4aee10a2eaf0937d86d046f85ee569a75cae9ac,3,52,7,59,12,2007-04-15 22:49:41,2007-04-15 21:56:09
e4aee10a2eaf0937d86d046f85ee569a75cae9ac...b568a503def81f49704ba94f5a822d523022102a,2,38,0,38,2,2007-04-15 23:01:35,2007-04-15 01:27:20
b568a503def81f49704ba94f5a822d523022102a...515106fa1335462393c08fa8712dddd767dc147a,5,169,82,251,31,2007-04-17 08:04:59,2007-04-17 04:33:31
515106fa1335462393c08fa8712dddd767dc147a...3e5261a24071ca23c3514c0ebd5ee55f1e79d9cc,1,35,21,56,4,2007-04-17 08:04:59,2007-04-17 04:58:01
3e5261a24071ca23c3514c0ebd5ee55f1e79d9cc...a129d96f4144215711e379565af97f6a82197f4f,1,129,7,136,5,2007-04-17 21:11:20,2007-04-17 05:59:18
a129d96f4144215711e379565af97f6a82197f4f...47579efc009c6f7afaf31be107eb92395a4f10db,1,72,0,72,1,2007-04-17 21:21:22,2007-04-17 07:05:00
47579efc009c6f7afaf31be107eb92395a4f10db...f3ef6b6bbe9bfd3d09130f7e26b87dbe11b93c5b,2,235,13,248,19,2007-04-18 08:43:42,2007-04-18 05:51:45
f3ef6b6bbe9bfd3d09130f7e26b87dbe11b93c5b...be89cb239e8ec02e23015675cc8b2d60992a6cfc,1,12,2,14,3,2007-04-18 08:50:00,2007-04-18 08:47:21
be89cb239e8ec02e23015675cc8b2d60992a6cfc...153920da5b62024c0aceef23252b82ad18e5fe22,2,131,79,210,30,2007-04-18 19:30:26,2007-04-18 18:27:32
153920da5b62024c0aceef23252b82ad18e5fe22...3086486d326b00ce308208e62e0e0de831f3563b,1,12,0,12,3,2007-04-18 19:30:49,2007-04-18 19:18:25
3086486d326b00ce308208e62e0e0de831f3563b...a5e92abde61d59a8612c5b87d0bae681e90f7fdb,6,43,26,69,22,2007-04-18 23:17:13,2007-04-18 23:16:37
a5e92abde61d59a8612c5b87d0bae681e90f7fdb...15ba3af2d5056313fa19ceb0cb7f7cb3cdd54f16,1,4,1,5,2,2007-04-19 02:21:52,2007-04-19 02:05:57
15ba3af2d5056313fa19ceb0cb7f7cb3cdd54f16...d56dbd67097a84dac1dbdf28c1a254f63f93724a,1,2,7,9,1,2007-04-19 02:22:57,2007-04-19 02:22:57
d56dbd67097a84dac1dbdf28c1a254f63f93724a...4392da4d5d7585a9defa6869517cb354f7460f35,2,15,7,22,13,2007-04-20 03:47:04,2007-04-20 03:47:04
4392da4d5d7585a9defa6869517cb354f7460f35...163b95919428cd7d782af91296e0b886683f2daa,2,89,60,149,31,2007-04-20 05:37:44,2007-04-20 05:37:19
163b95919428cd7d782af91296e0b886683f2daa...88e7fdf2cb436e068434241b0519577293055c19,3,300,2,302,4,2007-04-20 05:38:02,2007-04-20 03:48:03
88e7fdf2cb436e068434241b0519577293055c19...ac78e548049f4e86b38368d2c4b4dbb546c64ac6,6,51,60,111,46,2007-04-21 06:24:34,2007-04-19 00:05:03
ac78e548049f4e86b38368d2c4b4dbb546c64ac6...e87b1c943a50af9ab51df20b3419cbffa4e75484,1,2,1,3,2,2007-04-21 07:05:31,2007-04-21 07:05:31
e87b1c943a50af9ab51df20b3419cbffa4e75484...6073ee85719be6d959e74aa667024fcbec44a588,1,28,20,48,5,2007-04-21 18:55:23,2007-04-21 06:44:02
6073ee85719be6d959e74aa667024fcbec44a588...5e635e396020cc08bc21a3e67c20c5294d6d13fd,2,6,1,7,4,2007-04-21 18:55:23,2007-04-21 10:11:10
476386858c70c1457bf32ff6d93b2100f03513fc...b75686455c0524f167b6a878c124df40db34b325,1,1,0,1,1,2010-04-19 08:28:21,2010-04-19 07:37:20
476386858c70c1457bf32ff6d93b2100f03513fc...2e0052a5eb336dc48856bae0283a23198346b5ac,1,3,3,6,1,2010-04-13 04:45:03,2010-04-12 23:25:25
2e0052a5eb336dc48856bae0283a23198346b5ac...628511a5883fa809e86b34ebc147ac62eb214458,1,0,1,1,1,2010-04-13 04:45:08,2010-04-12 23:25:26
628511a5883fa809e86b34ebc147ac62eb214458...28de5b6b400fcdbd2d0665bc0cec7d7e4b813b43,1,21,22,43,9,2010-04-13 04:45:13,2010-04-12 23:25:27
28de5b6b400fcdbd2d0665bc0cec7d7e4b813b43...e451d06bf39df35d1106ad9bde5e38505533d805,2,23,0,23,3,2010-04-13 04:45:17,2010-04-12 23:25:28
e451d06bf39df35d1106ad9bde5e38505533d805...03e8b541b38d95d1cd7b287963c82617a0469f80,2,50,7,57,12,2010-04-13 20:04:50,2010-04-12 23:25:29
4280cde95fa4e3fb012eb6d0c239a7777baaf60c...2cc3167c688d1c91bc4cb9b1caa737b9d4971056,1,29,3,32,2,2007-04-23 07:21:02,2007-04-23 07:21:02
2cc3167c688d1c91bc4cb9b1caa737b9d4971056...4c474b6f92a2aa0b5aea282fe281e8f65279380a,2,6,4,10,6,2007-04-24 04:39:28,2007-04-23 17:17:19
4c474b6f92a2aa0b5aea282fe281e8f65279380a...557b1e0da595cfb61f9500bd8dd74a32f97616ff,1,4,4,8,4,2007-04-24 04:45:22,2007-04-23 18:46:21
557b1e0da595cfb61f9500bd8dd74a32f97616ff...bd4b0aeb1f4db2d7552623f77b62b9a24f8cac9e,1,1,1,2,1,2007-04-24 05:05:22,2007-04-24 05:05:22
bd4b0aeb1f4db2d7552623f77b62b9a24f8cac9e...ab69e89c7e95f309564c3967222bd39f0587a74c,1,10,7,17,6,2007-04-24 05:11:20,2007-04-24 05:10:47
ab69e89c7e95f309564c3967222bd39f0587a74c...2122591b3b5c6d93d3052a3151afcfa3146ede84,4,22,2,24,10,2007-04-24 05:13:50,2007-04-24 00:18:16
2122591b3b5c6d93d3052a3151afcfa3146ede84...afb5f39e24eadc5933b34cfd17c1089e482d6a6b,2,11,6,17,5,2007-04-24 07:08:01,2007-04-23 19:26:26
4280cde95fa4e3fb012eb6d0c239a7777baaf60c...228e94f93570b580da388069900c56b813c91953,2,20,11,31,2,2007-04-23 05:53:54,2007-04-02 01:14:06
228e94f93570b580da388069900c56b813c91953...4aab5b46f44a7ba860e07a52be506b7b57b2bd5f,2,155,121,276,86,2007-04-23 05:53:54,2007-04-02 06:26:07
d79073922fcb8c8a0bd57112817a2154f1ed05c1...e94a4f6eed31d652b94e8cccca8636d824ff2622,1,4,4,8,4,2007-04-08 06:01:54,2007-04-07 14:58:08
e94a4f6eed31d652b94e8cccca8636d824ff2622...732bcf942c6e99879349711fd29b5062a704e248,2,47,1,48,2,2007-04-08 06:33:38,2007-04-08 06:33:14
fc046a75d539a78e6b2c16534c4078617a69a327...e3a56298135ed4cce302e7da792793d3e5623c29,1,3,3,6,2,2006-07-01 00:25:20,2006-06-30 18:30:29
e3a56298135ed4cce302e7da792793d3e5623c29...560b25a86f30ad81d2bc3a383da19c3b7e631b8b,1,28,17,45,10,2006-07-01 03:14:47,2006-07-01 02:55:30
560b25a86f30ad81d2bc3a383da19c3b7e631b8b...03e0ea871206e50bcd1c5167c6fc9a41c6642abb,1,12,2,14,2,2006-07-01 05:50:47,2006-07-01 04:42:53
03e0ea871206e50bcd1c5167c6fc9a41c6642abb...c64ea8521bc81b52da45d3deb3a419928d4b6b29,1,3,3,6,1,2006-07-02 00:09:01,2006-07-02 00:07:40
c64ea8521bc81b52da45d3deb3a419928d4b6b29...ac3bc6c1d1f549f6809d8a7d29bcaed302f3c193,1,12,6,18,10,2006-07-02 00:09:26,2006-07-01 21:56:26
ac3bc6c1d1f549f6809d8a7d29bcaed302f3c193...6631c73685bea3c6300938f4900db0d0c6bee457,1,14,4,18,5,2006-07-02 01:21:03,2006-07-01 03:21:59
6631c73685bea3c6300938f4900db0d0c6bee457...0556a11a0df6b4119e01aa77dfb795561e62eb34,1,53,44,97,18,2006-07-02 01:28:15,2006-06-30 18:20:33
fc046a75d539a78e6b2c16534c4078617a69a327...e14421b9aa85f11853a0dacae09498515daab7b8,4,8,6,14,5,2006-06-30 06:49:16,2006-06-29 20:11:25
e14421b9aa85f11853a0dacae09498515daab7b8...7b8cf0cf2973cc8df3bdd36b9b36542b1f04d70a,3,9,9,18,5,2006-06-30 06:49:16,2006-06-29 21:26:54
bf928e9d2cf124ed73711f90666f9cee3c084e59...8048e24b87b2b897acaa27fe37df715f354947cb,2,6,1,7,2,2006-07-07 02:29:00,2006-07-07 02:21:47
8048e24b87b2b897acaa27fe37df715f354947cb...be4c7014f2f5945c59001297d2b0f282056f6d34,1,37,8,45,3,2006-07-07 05:37:51,2006-07-07 05:37:51
be4c7014f2f5945c59001297d2b0f282056f6d34...97beb812dbbba750e6c9326a7f25655ebcf7bb44,1,5,2,7,6,2006-07-07 10:25:14,2006-07-07 10:10:45
97beb812dbbba750e6c9326a7f25655ebcf7bb44...c9c95bbc9c9f7b8a3c87ab486b4aec220a239577,1,3,1,4,1,2006-07-07 10:48:10,2006-07-07 10:33:44
c9c95bbc9c9f7b8a3c87ab486b4aec220a239577...6bdca8905764affcab0c92a60a6a319080d76652,1,38,3,41,2,2006-07-07 19:17:49,2006-07-07 18:57:55
e40e0135f24a140935c218af43d0bf8b7b07067b...869659a6a1010ea0943329113a1de41c38bd4a00,1,1,1,2,1,2006-07-13 05:51:25,2006-07-13 05:51:25
869659a6a1010ea0943329113a1de41c38bd4a00...a72f9373c01f9bbebd14af7cec6ff0de4c27c578,1,3,1,4,1,2006-07-13 06:00:46,2006-07-13 06:00:46
f3bc46821263cfc2ab41b561727da4592ae5ea3b...047fbe906b375e8a3a7564ad0e4443f62dd528a2,1,3,1,4,2,2006-07-02 05:15:40,2006-07-02 05:15:40
c31cfb3db3decf36874273a97f54f3d597e98efe...17e6019a2ac9ad392c2e1c7fb6ce9c53d3d45acf,1,22,11,33,5,2006-07-07 00:03:52,2006-07-06 07:35:47
c31cfb3db3decf36874273a97f54f3d597e98efe...60d02ccc18408e54ace8692532fcc73d4035b3c2,14,28,61,89,15,2006-07-07 00:02:47,2006-07-06 07:14:16
60d02ccc18408e54ace8692532fcc73d4035b3c2...4b832e819de51bd2f32eb798cb648dc8d4064dbc,1,9,2,11,3,2006-07-07 10:17:59,2006-07-07 10:17:16
4b832e819de51bd2f32eb798cb648dc8d4064dbc...140245b3e2347aa37c4feead7c5f58df2d0b8833,1,1,0,1,1,2006-07-07 19:43:45,2006-07-07 11:26:31
140245b3e2347aa37c4feead7c5f58df2d0b8833...02853588a48eddbaa42b58764960394e416d68bf,1,1,1,2,1,2006-07-09 09:44:58,2006-07-09 09:44:58
02853588a48eddbaa42b58764960394e416d68bf...cb652963486a89eeac926d407c2893dbdbdcf66b,1,1,1,2,1,2006-07-09 10:30:51,2006-07-09 09:36:23
4f12d529abbf233e1df93e7ffa5f2719005a2258...344c52aee5f2dfaad2a065f8dcc8566d52d0d6c9,3,16,24,40,7,2006-07-10 07:13:28,2006-07-08 18:34:02
344c52aee5f2dfaad2a065f8dcc8566d52d0d6c9...4ad4515dfe15bec59ede5d526c2794bd30b04d86,1,3,3,6,3,2006-07-10 07:19:34,2006-07-10 03:20:48
9e026d3967776a1c1206890492ffc9d172bf1e9b...8b7e5d76e836396a097bb6f61cf930ea872a7bd3,1,2,2,4,2,2005-10-27 06:01:15,2005-10-25 20:01:42
51017101c7a308745ba3c04944457f1dc6a55780...61f01a5b773915402da37a34e706db56fe90b776,1,4,0,4,2,2005-08-30 08:08:24,2005-08-30 08:08:24
e20ce6ac762589868e46603ee1223f2f852c4403...89e2c5f17b901edf28a8bb778ece3f6c18bbb721,4,105,52,157,9,2005-08-19 23:23:31,2005-08-19 00:20:08
89e2c5f17b901edf28a8bb778ece3f6c18bbb721...4426ac70a1d15e103bd8a4bd1aa16be16b80c5bc,3,97,18,115,18,2005-08-19 23:23:31,2005-08-19 20:53:13
4426ac70a1d15e103bd8a4bd1aa16be16b80c5bc...51890a64eb152fb914d0dd3676f549ab8d8cc49a,2,16,6,22,7,2005-08-20 04:38:36,2005-08-20 04:38:36
51890a64eb152fb914d0dd3676f549ab8d8cc49a...b779dd5ee38d103c74e15a7c361f78f1025a0872,1,2,1,3,1,2005-08-20 08:05:12,2005-08-20 08:05:12
b779dd5ee38d103c74e15a7c361f78f1025a0872...165e160e4c4fb5b03146d5c41c2f6b078260b098,1,8,4,12,3,2005-08-20 08:21:21,2005-08-20 08:21:21
75ea6911d64bbe1b202eed61eda3ebaa4d76cb99...f1d090e13a46d30a14089de0575dbb2fc44a583a,1,1,2,3,2,2005-08-19 09:06:52,2005-08-19 09:06:52
f1d090e13a46d30a14089de0575dbb2fc44a583a...cc5625a5e2e10a94560347333c43b7032c2566f3,1,1,1,2,1,2005-08-19 18:32:54,2005-08-19 10:35:03
cc5625a5e2e10a94560347333c43b7032c2566f3...7f1335c74c4ba0baac8649974e95f6e6f84f8632,1,2,0,2,1,2005-08-19 20:07:43,2005-08-19 18:28:35
068eac91ce04b9aca163acb1927c3878c45d1a07...3f971fc425bca3d9e97b04e9db39e4d5e43921bc,13,231,17,248,22,2005-08-15 00:24:36,2005-08-15 00:24:36
3f971fc425bca3d9e97b04e9db39e4d5e43921bc...d5a63b99835017d2638e55a7e34a35a3c1e80f1f,3,88,71,159,23,2005-08-15 10:00:20,2005-08-15 00:25:57
d5a63b99835017d2638e55a7e34a35a3c1e80f1f...aae4f42c45704986210ea2a30bd31afba1008275,1,26,15,41,6,2005-08-15 10:00:20,2005-08-15 00:25:57
aae4f42c45704986210ea2a30bd31afba1008275...c65a9470fbaa57b9b815addde51ad22648f6d353,1,9,3,12,3,2005-08-15 10:00:21,2005-08-13 20:39:41
c65a9470fbaa57b9b815addde51ad22648f6d353...365a00a3f280f8697e4735e1ac5b42a1c50f7887,3,288,0,288,3,2005-08-15 10:00:21,2005-08-15 08:25:53
365a00a3f280f8697e4735e1ac5b42a1c50f7887...7c27558c6236225b07c5d5def76299d2b5fe7635,4,125,0,125,4,2005-08-15 10:00:22,2005-08-15 08:42:15
7c27558c6236225b07c5d5def76299d2b5fe7635...3998f8eba9f14efcb08468ecdbe2a69ed6da880d,1,9,1,10,3,2005-08-15 10:00:22,2005-08-15 08:56:23
3998f8eba9f14efcb08468ecdbe2a69ed6da880d...90933efb6d12fb7fe3084bb257e93120f487171b,1,6,6,12,5,2005-08-15 22:29:24,2005-08-15 15:23:06
90933efb6d12fb7fe3084bb257e93120f487171b...a2f15a812c16cc0fa56a74af0e52d30ff4e615db,1,153,0,153,1,2005-08-15 22:36:52,2005-08-15 22:36:52
a2f15a812c16cc0fa56a74af0e52d30ff4e615db...2ad77e67c7c95982ebc9b99ee6a2d007feada62e,3,4,4,8,3,2005-08-15 22:37:37,2005-08-15 22:37:37
2ad77e67c7c95982ebc9b99ee6a2d007feada62e...b0c6f8d767387d39058648b4e3a04518350f789c,1,18,15,33,4,2005-08-15 22:37:37,2005-08-15 22:37:37
b0c6f8d767387d39058648b4e3a04518350f789c...e31bb3bb939a8feb7af472c55d95f41a90bbc438,4,97,0,97,5,2005-08-15 22:48:47,2005-08-15 22:48:47
6517452d7a4269e9a34648a28b8931640299f458...8f0bef6df91c48d79f982bdb55f784ce445ba5b2,1,55,27,82,12,2009-08-14 19:40:09,2009-08-13 12:29:39
8f0bef6df91c48d79f982bdb55f784ce445ba5b2...b319ef70a94731a5c6f18d07a49d5dda3f06f5d3,1,36,0,36,1,2009-08-14 19:40:09,2009-08-13 12:29:40
6517452d7a4269e9a34648a28b8931640299f458...ea41cfc4f54f884582dbda307287f12bb1fc15e9,3,19,8,27,7,2009-07-31 14:33:06,2009-07-27 18:37:10
6517452d7a4269e9a34648a28b8931640299f458...71c020c53ec472b04678237d8fe5687f2299db2a,1,1,1,2,1,2009-07-25 17:07:06,2009-07-25 12:06:50
6517452d7a4269e9a34648a28b8931640299f458...2da9ee0888a8570f9a85ef11f208556c5316e3d4,3,81,0,81,7,2009-07-25 11:09:43,2009-07-19 23:00:52
2da9ee0888a8570f9a85ef11f208556c5316e3d4...6b48829dbbe06798eded1e7c5f70810940591f79,3,21,5,26,8,2009-07-25 11:09:43,2009-07-25 07:00:50
6b48829dbbe06798eded1e7c5f70810940591f79...eaa14ff8c7dbe51dfdfe7e2d9ede839fc62dcf52,2,20,7,27,5,2009-07-25 11:09:43,2009-07-25 08:36:06
eaa14ff8c7dbe51dfdfe7e2d9ede839fc62dcf52...5af9b77b553eae80a14dd06f14bf1ee1268a0288,1,2,0,2,1,2009-07-25 11:09:44,2009-07-25 09:11:39
5af9b77b553eae80a14dd06f14bf1ee1268a0288...884cce5bd042e67a0d2a1a9317f8435634486ad1,1,1,1,2,1,2009-07-25 11:09:44,2009-07-25 09:29:28
884cce5bd042e67a0d2a1a9317f8435634486ad1...5f8b2cbacd3bad38d0ae4d358fe9b34e98190935,1,5,1,6,1,2009-07-25 20:37:02,2009-07-25 20:14:16
54bc13ce5300bf7c2237aba3fd123dd587e56d31...33016c491367c5144b3007927cd76492ac193d16,1,1,1,2,2,2009-07-29 06:31:38,2009-07-29 01:30:02
33016c491367c5144b3007927cd76492ac193d16...5c6d8bb29043a3e53c84f1782392a4d71dd10ff9,1,5,0,5,1,2009-07-29 06:56:01,2009-05-31 05:08:02
5c6d8bb29043a3e53c84f1782392a4d71dd10ff9...e276f018f2c1f0fc962fbe44a36708d1cdebada8,3,38,2,40,3,2009-07-29 06:59:30,2009-07-29 06:52:58
397f7c6371d309aa399bf32b773397f3c068d0c9...0a49a7997b7380c1552786adb544d50d005368f8,1,1,1,2,1,2009-07-25 08:39:15,2009-07-24 22:44:01
0a49a7997b7380c1552786adb544d50d005368f8...6de9433fd0525632094f3cc172a606f217fa2097,2,8,2,10,3,2009-07-25 08:39:16,2009-07-24 22:44:02
6de9433fd0525632094f3cc172a606f217fa2097...11930423d11c1256014e10b940c4ee8f12328739,1,14,13,27,4,2009-07-25 08:39:16,2009-07-24 22:44:03
11930423d11c1256014e10b940c4ee8f12328739...3665e7e7f2b210f6896815d563255c364a861a6e,2,8,2,10,4,2009-07-25 08:39:16,2009-07-24 22:44:04
3665e7e7f2b210f6896815d563255c364a861a6e...a36817b6e7af625a6f1218a2d57874f5016e2c8d,1,8,0,8,1,2009-07-25 08:39:16,2009-07-24 22:44:05
a36817b6e7af625a6f1218a2d57874f5016e2c8d...aef37684ea713c96dc3e4913cf33962df1efb92b,2,11,8,19,5,2009-07-25 08:39:16,2009-07-24 22:44:06
f0df1293acdba9513cae17e2c63b4169f1347371...5749b0b2f935dc418c98ba8e7c52c3291451bc4a,2,12,4,16,3,2009-08-06 03:14:54,2009-08-05 20:55:07
b6986d8a75812a003a1623e0f0dff93c4a026b44...da02ca508b842e61c71d920310ff30bbe0238993,3,18,5,23,6,2009-08-18 10:32:45,2009-08-17 06:53:12
b6986d8a75812a003a1623e0f0dff93c4a026b44...b6b0737d02e3bb9b3015ec66f5b6454d5b83d57b,1,6,0,6,1,2009-08-09 17:37:24,2009-08-09 15:35:02
90b1994170900514a1ce7a3345e25cb7216915cc...2cfe8a68ccba86f046080f890102a9a43361cfdd,2,9,1,10,2,2011-03-16 22:57:19,2011-03-16 22:46:08
90b1994170900514a1ce7a3345e25cb7216915cc...0e098b6d79fbcab763874f2b6fde5aa82144d150,1,0,0,0,0,2009-08-27 23:45:12,2009-08-27 07:38:27
0e098b6d79fbcab763874f2b6fde5aa82144d150...97bf2a08095197f43b20b3bc1124552ae24d71bf,1,2,2,4,2,2009-08-30 21:13:01,2009-08-30 20:27:02
6641575963388b61f408f177d91cdacad25d2e26...1c9b2d3aa12ea4e34c1d04cc2af4e07a1eecb964,1,23,0,23,1,2009-07-29 17:26:10,2009-05-11 09:31:42
6641575963388b61f408f177d91cdacad25d2e26...acd2a45b83e50c0f33b01ee74df241f1adfdff39,8,40,33,73,17,2009-07-29 17:15:00,2009-02-11 10:28:03
acd2a45b83e50c0f33b01ee74df241f1adfdff39...375881fa6a43e21ab922b20b2061f9868ef18644,2,14,25,39,10,2009-07-29 17:15:42,2009-02-09 08:19:46
4525e8e41a8c0c4246a95097744604ea72198dad...ca4ca9ed069c8ce13e1a38e79fbaea849754de94,1,1,1,2,1,2009-07-19 18:04:13,2009-07-17 23:18:34
ca4ca9ed069c8ce13e1a38e79fbaea849754de94...ae03ee644ec52f2aa2769dfd4929c5ff85c2a899,1,6,0,6,4,2009-07-19 18:04:18,2009-07-18 10:14:37
4525e8e41a8c0c4246a95097744604ea72198dad...a418441b4ea2ab69a17636c3020a29394d4c6562,1,14,0,14,1,2009-07-19 17:28:50,2009-07-16 00:09:14
a418441b4ea2ab69a17636c3020a29394d4c6562...d44e71261f91d3cc81293e0976bb40daa8abb583,2,13,6,19,4,2009-07-19 17:29:38,2009-07-19 07:45:16
3f55e4107f7906134df029f9a5c44864f9258110...0fcb2caf29d2ff9822cbb3440c5c2c495cf430f0,2,29,0,29,3,2009-08-07 03:50:15,2009-08-07 01:08:12
0fcb2caf29d2ff9822cbb3440c5c2c495cf430f0...46caf5053f0a784911c66530928e6e4361a783f2,1,5,1,6,1,2009-08-07 03:52:09,2009-08-07 01:08:13
3f55e4107f7906134df029f9a5c44864f9258110...1bfd363184d5bd0eb81565bfa2cc1084f35dbbdf,1,6,2,8,3,2009-08-06 21:03:25,2009-08-06 14:25:39
1bfd363184d5bd0eb81565bfa2cc1084f35dbbdf...b4c07792970fde7255a8ebb7aef3e1ecd0bd3923,1,9,0,9,1,2009-08-06 21:04:38,2009-08-06 14:27:26
b4c07792970fde7255a8ebb7aef3e1ecd0bd3923...cbdefb5ac43a1a34e71121a7a6a6434f0b8aa1cf,1,9,0,9,2,2009-08-06 21:05:27,2009-08-06 14:28:25
3f55e4107f7906134df029f9a5c44864f9258110...8918f5cf962866c2bb36bdf6b417bfcdb523280a,1,8,5,13,4,2009-08-06 20:30:36,2009-07-31 07:23:09
8918f5cf962866c2bb36bdf6b417bfcdb523280a...1a3d834f06260e51396a6047ec746fc7895de316,1,14,8,22,3,2009-08-06 20:33:52,2009-08-05 16:42:33
1a3d834f06260e51396a6047ec746fc7895de316...18b07930363d54778e616f1b86de8ccd5ebe88fc,1,4,1,5,1,2009-08-06 20:33:57,2009-08-05 21:20:32
18b07930363d54778e616f1b86de8ccd5ebe88fc...4cfbe06fc788aad7bb4e5ea0c2c93345840acc28,1,4,2,6,1,2009-08-06 20:34:50,2009-08-05 14:56:25
4cfbe06fc788aad7bb4e5ea0c2c93345840acc28...d68dc34cb41c30515e64766c303c2930994e5085,1,5,0,5,3,2009-08-06 20:35:55,2009-08-06 12:15:14
d68dc34cb41c30515e64766c303c2930994e5085...4d590f0607184021c7b52430aa41483e6fd0d044,1,1,1,2,1,2009-08-06 21:01:13,2009-08-06 15:11:48
4d590f0607184021c7b52430aa41483e6fd0d044...1c370ea4e519f8facaf321b633f79eb68a14a0db,2,8,0,8,3,2009-08-07 21:40:29,2009-08-06 10:47:21
3f55e4107f7906134df029f9a5c44864f9258110...afdeeb00eec471d86c9d421781ba8cb545be849c,2,2,0,2,2,2009-08-06 03:14:07,2009-08-05 20:22:19
afdeeb00eec471d86c9d421781ba8cb545be849c...120703292b2828d3c35c937b7f5e75ec570a42e9,3,5,0,5,4,2009-08-06 03:14:09,2009-08-05 20:22:36
120703292b2828d3c35c937b7f5e75ec570a42e9...481c7a6db907774d0f06565d00fd06500a7ae7a4,1,19,1,20,3,2009-08-06 03:14:11,2009-08-05 20:23:26
3f55e4107f7906134df029f9a5c44864f9258110...d7c208a92e6b15cdcd159e30cd1fc0177fd967e9,3,175,0,175,5,2009-08-06 02:28:21,2009-08-05 23:13:20
d7c208a92e6b15cdcd159e30cd1fc0177fd967e9...b26a9d50899a5d65bafcb521c5495f03b2e2e0e9,1,3,3,6,2,2009-08-06 20:56:19,2009-08-06 20:56:19
b26a9d50899a5d65bafcb521c5495f03b2e2e0e9...b8e48a89b8f581eaf95b57782bb8e620ca30e968,1,22,10,32,6,2009-08-06 20:56:45,2009-08-06 02:42:15
b8e48a89b8f581eaf95b57782bb8e620ca30e968...fd536d3439fa2a06730884df31e2e98c9006c947,1,2,2,4,2,2009-08-06 20:56:45,2009-08-06 20:52:58
fd536d3439fa2a06730884df31e2e98c9006c947...139e3456ecf18fc03a75eda7a77441e8fec344b9,1,16,12,28,3,2009-08-06 20:56:45,2009-08-06 03:28:07
139e3456ecf18fc03a75eda7a77441e8fec344b9...7b5075fcfb069fc36ba4cfe5567234974793ab58,1,16,12,28,8,2009-08-06 20:56:45,2009-08-06 03:49:41
7b5075fcfb069fc36ba4cfe5567234974793ab58...ab14c823dfbf1245712c8179952b51822135d8a8,1,26,30,56,6,2009-08-06 20:56:45,2009-08-06 14:20:54
ab14c823dfbf1245712c8179952b51822135d8a8...e869e113c8f91999f9a433436e0b863fe2727b61,1,1,1,2,1,2009-08-06 20:56:45,2009-08-06 14:27:57
e869e113c8f91999f9a433436e0b863fe2727b61...5d5210c35aa83342163ab0ab80b8e6d6fa3ce931,2,7,11,18,9,2009-08-06 20:56:45,2009-08-06 14:45:46
5d5210c35aa83342163ab0ab80b8e6d6fa3ce931...30d12d4c16abc052e8961c07651f97bea2c061bd,1,90,27,117,8,2009-08-08 05:19:45,2009-08-06 19:41:00
30d12d4c16abc052e8961c07651f97bea2c061bd...66c9c6c0fbba0894ebce3da572f62eb05162e547,1,4,3,7,2,2009-08-08 05:32:46,2009-08-08 04:16:46
66c9c6c0fbba0894ebce3da572f62eb05162e547...926172c5e4808726244713ef70398cd38b055f1e,1,24,1,25,2,2009-08-11 00:26:51,2009-08-10 23:52:07
926172c5e4808726244713ef70398cd38b055f1e...30ba0de726d92ccfc93009eb60f2c30b0886f61b,1,60,69,129,3,2009-08-12 20:32:54,2009-08-12 19:45:48
30ba0de726d92ccfc93009eb60f2c30b0886f61b...dc52fd29738c2af98f3e986691eca34addfd4914,1,18,5,23,7,2009-08-12 20:35:54,2009-08-12 19:46:41
dc52fd29738c2af98f3e986691eca34addfd4914...660231aa9727d29c7d2c16319bc6a3fa8bed3e0e,1,30,2,32,3,2009-08-12 20:36:32,2009-08-12 19:47:55
660231aa9727d29c7d2c16319bc6a3fa8bed3e0e...ee7dc310af660f423732369e955651ef2f05011d,1,4,1,5,1,2009-08-13 17:41:02,2009-08-13 04:29:14
ee7dc310af660f423732369e955651ef2f05011d...a12218572f2875e91b6c3c12559b076c4949a675,1,2,2,4,2,2009-08-15 02:13:00,2009-08-14 22:52:15
e33cc592deae8132936eea119554799e1039bc0f...8ff883029a97b38b893b15199393d0e4e7190c0d,1,1,1,2,1,2010-02-10 18:19:13,2010-02-10 18:18:55
4ecbc178704ca6c1027a38483e98f5fe493b1322...c4593faf2df8f9c5e8ac409e40be991294a73e54,2,176,1,177,3,2009-07-11 13:41:15,2009-07-11 01:38:08
4ecbc178704ca6c1027a38483e98f5fe493b1322...404d42e5efe05ef8dd40713e00001746a060b66b,1,19,21,40,4,2009-07-11 06:56:40,2009-07-08 05:15:38
404d42e5efe05ef8dd40713e00001746a060b66b...4855b2a220cacb01b77a2bf431b5b176bfa1d732,1,12,9,21,5,2009-07-11 06:57:15,2009-07-08 05:15:39
4855b2a220cacb01b77a2bf431b5b176bfa1d732...c9c3c6781c5b97c37b3ce16af7ea9bc613413c7e,2,20,23,43,7,2009-07-11 06:57:20,2009-07-08 05:15:40
4ecbc178704ca6c1027a38483e98f5fe493b1322...6edd14968bf969a651d057ea7fb7757393d282bf,1,3,2,5,2,2009-07-11 03:17:33,2009-07-11 03:17:33
3f2fd36ebcc2ef15df196bd0544cc9c39da57dbf...4cb08df553e270ab516a140caeeddd8e94f1e497,5,48,43,91,39,2007-07-15 06:31:01,2007-07-14 17:51:44
4cb08df553e270ab516a140caeeddd8e94f1e497...a5e407988b35b7353bd03c770afc647670c25981,1,33,17,50,14,2007-07-15 06:33:22,2007-07-14 18:48:42
d80ded01de0189fe7179913d3ecdeecadf2052a0...615b865358f32537bd4a7065a042de435e9413f3,2,0,3,3,2,2007-06-11 23:06:10,2007-06-11 23:06:10
41cf68a85ca2a9199b32eb3932582b234fa474b4...a1a5a6347b4ac1005c5d9c2b636e906bf6c8ec12,1,4,2,6,2,2007-06-06 22:20:12,2007-06-06 08:11:55
a1a5a6347b4ac1005c5d9c2b636e906bf6c8ec12...e59ade9f90de0eacdac06f52d39b74074fc664af,1,2,2,4,1,2007-06-06 22:20:13,2007-06-06 21:23:16
e59ade9f90de0eacdac06f52d39b74074fc664af...23fcdc79713c47a6a0d50762b9311c9933a60d3f,1,3,3,6,2,2007-06-06 22:23:35,2007-06-05 06:06:30
86eff8c512b96ce3ee0ae5818edfa035b98cdf08...9b07873a52cc0243c2eddfac2e9c514152b96fb7,1,2,2,4,2,2007-06-02 19:07:44,2007-06-02 17:59:49
aba170cdb4874b72dd619e6f7bbc13c33295f831...56d99c67d1ad95326902f3a739ab2a3c7bb2d6fe,1,3,0,3,3,2007-05-21 06:09:26,2007-05-19 21:35:21
56d99c67d1ad95326902f3a739ab2a3c7bb2d6fe...5cfb4fe525034b758ca39a32d05cc8b2a53d2a13,1,3,3,6,4,2007-05-24 05:10:15,2007-05-24 05:01:02
5cfb4fe525034b758ca39a32d05cc8b2a53d2a13...1fd6bec9bcb2d7fc710a9866bd53ea52f43d4428,1,23,0,23,4,2007-05-24 05:25:34,2007-05-24 05:25:34
1fd6bec9bcb2d7fc710a9866bd53ea52f43d4428...bfbd131f52ff8373ffabbb30f275b4af8213f5f0,1,1,1,2,1,2007-05-24 05:26:58,2007-05-24 05:26:58
bfbd131f52ff8373ffabbb30f275b4af8213f5f0...c70680ce7cec72a465468c223d43c08f5254d31f,1,14,1,15,4,2007-05-24 05:36:46,2007-05-24 05:36:46
c70680ce7cec72a465468c223d43c08f5254d31f...fb72759b7de504f077250fd5bd557e3b9e2a5682,1,14,2,16,3,2007-05-24 05:46:49,2007-05-24 05:46:49
fb72759b7de504f077250fd5bd557e3b9e2a5682...8f87fae6459b7d5b8058691911f1c18c59a5dcbd,1,2,2,4,2,2007-05-24 05:51:30,2007-05-24 05:51:30
8f87fae6459b7d5b8058691911f1c18c59a5dcbd...12977705b3da7eb63cdfd890f838b971e8d81485,1,12,2,14,6,2007-05-24 06:07:45,2007-05-24 06:07:45
670a3c1d5a27bfb1cc6b526559c6f5874f00042f...4d24d5202c3c08c999231cc30bf8de70bf11dc80,2,9,3,12,7,2014-10-15 22:17:08,2014-10-15 18:49:28
4d24d5202c3c08c999231cc30bf8de70bf11dc80...2ea40f01c51b7a3e0e5ab32dbacfb1c38e852631,2,74,0,74,2,2014-10-15 22:18:27,2014-10-15 18:50:18
670a3c1d5a27bfb1cc6b526559c6f5874f00042f...2b2b1e4d27b4e44c0c46d4857c76b8391d303af3,1,10,5,15,10,2014-10-15 17:47:20,2014-09-10 21:01:46
2b2b1e4d27b4e44c0c46d4857c76b8391d303af3...1054af7d04aef64378d69a0496b45cdbf6a0bef2,3,12,11,23,4,2014-10-15 17:47:20,2014-07-16 18:01:18
1054af7d04aef64378d69a0496b45cdbf6a0bef2...3c93c847cacea68e520f6099b18c69f406ab9407,1,1,1,2,1,2014-10-15 17:47:21,2014-10-02 14:59:02
3c93c847cacea68e520f6099b18c69f406ab9407...9ccc0c089667e6dccc888590376f138521784e5e,2,23,0,23,3,2014-10-15 17:47:21,2014-07-16 18:20:36
9ccc0c089667e6dccc888590376f138521784e5e...dbdcac7d5c5eea314ec4c318a5e88cff427e9f0e,1,5,4,9,4,2014-10-15 17:47:21,2014-05-15 15:25:23
dbdcac7d5c5eea314ec4c318a5e88cff427e9f0e...db7516ab9f435e3ce86b257c6631fb4d2dfb12ae,11,54,44,98,37,2014-10-15 17:47:22,2014-04-30 19:22:42
db7516ab9f435e3ce86b257c6631fb4d2dfb12ae...7522e3dbcc3946d481e6b6ac59037b884cc0a2a6,1,1,1,2,1,2014-10-15 17:47:22,2014-04-30 19:41:04
7522e3dbcc3946d481e6b6ac59037b884cc0a2a6...8a9df90d9a726fa9b1a1ebd13b9e43409e18c606,1,5,2,7,2,2014-10-15 17:47:22,2014-05-01 17:40:10
8a9df90d9a726fa9b1a1ebd13b9e43409e18c606...5d94a1b03318d14847a40f233560c2a87fb16cfa,1,6,6,12,1,2014-10-15 17:47:23,2014-05-01 17:43:39
5d94a1b03318d14847a40f233560c2a87fb16cfa...5fe7d825da8af83a9a3b9bc7f3295f836b6e3a75,1,32,18,50,18,2014-10-15 17:47:23,2014-05-01 18:16:07
5fe7d825da8af83a9a3b9bc7f3295f836b6e3a75...28e6a97e39edb84599693db971e36d793d36e413,2,23,12,35,11,2014-10-15 17:47:23,2014-05-16 21:14:38
28e6a97e39edb84599693db971e36d793d36e413...cd94f765720e32ea0bf72996c8dc7dd0b1cc30d0,1,24,10,34,3,2014-10-15 17:47:23,2014-04-28 20:49:07
cd94f765720e32ea0bf72996c8dc7dd0b1cc30d0...aae383db8c384dc46abe199899235f67c838e601,2,8,5,13,3,2014-10-15 17:47:23,2014-04-28 22:36:58
aae383db8c384dc46abe199899235f67c838e601...7695d118e5a3c9c6fcb4cb15eb766a1c57422aed,28,124,92,216,82,2014-10-15 17:47:24,2014-07-15 19:59:36
7695d118e5a3c9c6fcb4cb15eb766a1c57422aed...014e7db3f5563a61cefbe1f6f5747931c799a37e,1,70,0,70,1,2014-10-15 17:47:24,2014-09-13 17:52:25
014e7db3f5563a61cefbe1f6f5747931c799a37e...62a2d52514aed2b684409cb48e40e0cd14335d1b,6,68,3,71,14,2014-10-15 17:47:25,2014-09-11 01:22:48
62a2d52514aed2b684409cb48e40e0cd14335d1b...18f29fc61ed88145a0664657c3cea9e9732ea5e8,1,4,3,7,2,2014-10-15 17:47:25,2014-09-11 17:34:36
18f29fc61ed88145a0664657c3cea9e9732ea5e8...f3cc52d840418c1a38bb4ae9a09a479e77d95e77,2,4,16,20,4,2014-10-15 17:47:25,2014-09-26 19:22:22
f3cc52d840418c1a38bb4ae9a09a479e77d95e77...8159f4af7d21e106ed04d69c428b395701b94205,3,84,74,158,9,2014-10-15 17:47:25,2014-09-25 22:02:39
8159f4af7d21e106ed04d69c428b395701b94205...d0f810f0bc0d6b51722b400f70c2590713f168e8,5,273,38,311,34,2014-10-15 17:47:26,2014-09-03 18:45:43
d0f810f0bc0d6b51722b400f70c2590713f168e8...971c41c71728d057115b105f427202f98565f933,1,5,0,5,1,2014-10-15 17:47:26,2014-09-05 21:35:17
971c41c71728d057115b105f427202f98565f933...2ebb49ca8ac34afb0ffe00e4bceac73e8c825ef1,1,11,4,15,3,2014-10-15 17:47:26,2014-09-11 15:42:57
2ebb49ca8ac34afb0ffe00e4bceac73e8c825ef1...5a603b046351894a3c892d5bd6948fcee1bee5ab,1,27,19,46,13,2014-10-15 17:47:26,2014-08-28 23:42:37
5a603b046351894a3c892d5bd6948fcee1bee5ab...fb43bd1cd187bcd29312df3b0394a457d524906d,2,0,11,11,2,2014-10-15 17:47:27,2014-08-28 23:41:34
fb43bd1cd187bcd29312df3b0394a457d524906d...65732845e89eee69422b725bb495f4282065284f,1,6,2,8,4,2014-10-15 17:47:27,2014-08-29 00:01:35
670a3c1d5a27bfb1cc6b526559c6f5874f00042f...8f7ff5b2fe7f52966c034a12cf8980dae1160222,1,2,1,3,1,2014-10-14 20:06:13,2014-10-14 10:49:45
4bc708347e2b94564d9ec5e0e3a2ab0e3d6b2fd9...aa7e44bf571717aeb4435e6605391d51f3117047,4,245,341,586,76,2007-06-02 20:14:18,2007-06-01 19:18:05
2720de426112269df2025eb83af8806203958237...072570ee2689c5f19513157d654f04f5a7113a24,1,17,8,25,4,2007-05-23 22:09:49,2007-05-20 15:46:46
6b68342edc392bb640b30c2115eb6585a3303e25...e448ff877b5bff0f2e6c5281652ed5183a41ed6c,5,5,1,6,6,2007-05-19 04:47:40,2007-05-18 13:39:33
e448ff877b5bff0f2e6c5281652ed5183a41ed6c...97925fde00743e557fa5e792004483a27e31fbd8,6,19,9,28,8,2007-05-19 04:47:45,2007-05-18 13:39:34
7a33b0bfced9cfcea785dac5ddf189d937a42446...9cf04301b182c4c57d62ea63554d109db613f9d3,1,1,1,2,1,2007-05-04 05:12:40,2007-05-02 12:53:23
9cf04301b182c4c57d62ea63554d109db613f9d3...cdda666201710dcf50d7ebee804aac65fdec32fd,1,7,6,13,3,2007-05-04 05:12:40,2007-05-03 20:00:43
cdda666201710dcf50d7ebee804aac65fdec32fd...5094102e13640d7559a02fd7c77b44dc9254cbbb,2,13,8,21,2,2007-05-04 05:28:55,2007-05-03 02:49:41
5094102e13640d7559a02fd7c77b44dc9254cbbb...5318f69812b3a06326524852d965e6a79fa52f85,1,1,1,2,1,2007-05-04 05:36:32,2007-05-03 22:58:56
5318f69812b3a06326524852d965e6a79fa52f85...e4e92b3f4bead3ee17164db35a44f8904eac9104,2,2,2,4,2,2007-05-04 05:56:23,2007-05-03 18:29:15
e4e92b3f4bead3ee17164db35a44f8904eac9104...c256acb8fbd0ac1dddb6ec39aa9b3c816493122c,1,1,1,2,1,2007-05-04 05:58:01,2007-05-02 21:53:23
c256acb8fbd0ac1dddb6ec39aa9b3c816493122c...e3ad95a8be82663d27cb501eaf9bad86a30f9cda,1,10,16,26,11,2007-05-04 06:22:12,2007-05-01 21:12:13
07c785dbb799ce7fa74686e776cd07d69c3ce01e...4c1611249432733818e724fe04a3e9b04848cdab,2,38,6,44,11,2007-05-01 00:30:02,2007-05-01 00:30:02
71e2e5993b6f2afdfda0cc92e0d55e84c9f876b0...bb924cb331c143eaf92ba8d86b65caff15252543,1,4,4,8,4,2007-04-28 06:17:58,2007-04-27 19:56:47
bb924cb331c143eaf92ba8d86b65caff15252543...26e60160a074747fbe8866ddac4e0c7660c17ff6,2,29,0,29,3,2007-04-28 06:18:15,2007-04-27 18:57:53
26e60160a074747fbe8866ddac4e0c7660c17ff6...cb2cada6da9d71604fd09efbff47cddbea453e1e,1,6,0,6,3,2007-04-29 01:06:00,2007-04-29 00:29:23
6169a89c4fd29cf9c747bab7bd310877328bc7e2...c135ee88f8584996ead993c76015d2c03798ab9e,1,19,13,32,2,2007-04-26 06:43:16,2007-04-25 20:06:59
c135ee88f8584996ead993c76015d2c03798ab9e...8a359819273a4460d5806d2d5e76cd7993a84843,2,28,0,28,4,2007-04-26 06:43:16,2007-04-25 20:07:45
8a359819273a4460d5806d2d5e76cd7993a84843...0d5e6c9781aae33795243452fd50663d17ec2b9d,1,1,1,2,1,2007-04-26 23:11:39,2007-04-26 19:13:49
0d5e6c9781aae33795243452fd50663d17ec2b9d...8e404f82abdfd912ad43c6fae7c218ff75a5d122,1,1,1,2,1,2007-04-27 03:58:04,2007-04-26 21:35:39
8e404f82abdfd912ad43c6fae7c218ff75a5d122...024e5b31af6f06d39542ab1a44de358d7734388b,1,54,23,77,6,2007-04-27 03:59:49,2007-04-26 21:36:24
024e5b31af6f06d39542ab1a44de358d7734388b...c855195cd014f8b5a32a32b36cb77319654583a3,1,1,1,2,1,2007-04-27 03:59:55,2007-04-26 21:37:16
da94faf671c6b7c4db1ae07137bd93e31e232b4c...cc2903fc70ea9e1bb7788a6f5f46b5d3dd1b6fe4,1,4,4,8,4,2007-04-25 20:15:27,2007-04-25 14:17:56
cc2903fc70ea9e1bb7788a6f5f46b5d3dd1b6fe4...efbc5831264fbe3696e6fc264bba9319265d7344,2,4,4,8,4,2007-04-25 20:15:59,2007-04-25 14:18:08
efbc5831264fbe3696e6fc264bba9319265d7344...3511a3774e60783d979ebc2ef7b04371a23602bb,1,8,9,17,2,2007-04-25 20:44:27,2007-04-25 14:18:17
3511a3774e60783d979ebc2ef7b04371a23602bb...79dbbedd78ae064be6bb8a0f61fd4872222e47dd,1,4,5,9,2,2007-04-25 20:44:45,2007-04-25 14:18:28
79dbbedd78ae064be6bb8a0f61fd4872222e47dd...3e0a93a5bf9fe10453599a94af8191f421ee3b16,1,1,2,3,2,2007-04-25 20:45:12,2007-04-25 14:18:41
3e0a93a5bf9fe10453599a94af8191f421ee3b16...a7b02ccf9a682fa0c2b28df6ca20f9199cdca4de,9,71,17,88,20,2007-04-26 04:39:43,2007-04-25 06:36:22
da94faf671c6b7c4db1ae07137bd93e31e232b4c...3fed15f568c24ec00ef78fddc6cbb881fbbb0277,3,252,12,264,18,2007-04-25 05:38:51,2007-04-22 02:09:02
3fed15f568c24ec00ef78fddc6cbb881fbbb0277...aa4ed402c9721170fde2e9e43c3825562070e65e,3,282,3,285,19,2007-04-25 05:38:51,2007-04-21 10:14:13
7a1593972c19df26aee7d14c7d7c8c4fce24fb26...15320175355fc4770d9fb8b5a89ba8b36ef96246,1,3,0,3,1,2007-04-16 06:17:55,2007-04-16 05:35:25
15320175355fc4770d9fb8b5a89ba8b36ef96246...c7263d4d3d75d177f0ad8a8a730e1e3b401488c7,1,2,1,3,2,2007-04-16 08:06:00,2007-04-16 05:51:11
c7263d4d3d75d177f0ad8a8a730e1e3b401488c7...b48caa20de7f62f648de7d3dbb0ceb462879e903,3,34,3,37,7,2007-04-16 08:06:02,2007-04-16 07:46:48
b48caa20de7f62f648de7d3dbb0ceb462879e903...9474eda6c239bae68a095013ee50a8c90dd0f182,1,1,1,2,1,2007-04-16 08:23:56,2007-04-16 08:17:32
d16a5dafdcec037631a5453ca7923992ce27a151...0b3dcfe721dc8734e2688f936afad055d8541d97,3,5,10,15,5,2010-03-22 00:01:22,2010-03-22 00:01:22
732bcf942c6e99879349711fd29b5062a704e248...512b620bd9fef7f170562ecad835e37479f051ce,1,4,1,5,3,2007-04-09 02:53:42,2007-04-03 08:57:08
512b620bd9fef7f170562ecad835e37479f051ce...13c823fb520eaf1cded520213cf0ae4c3268208d,1,21,20,41,9,2007-04-09 02:53:54,2007-04-08 07:59:19
13c823fb520eaf1cded520213cf0ae4c3268208d...c16d08713e2d7f5c440f7649ceb68f838b4b8bea,1,9,2,11,4,2007-04-09 02:54:07,2007-04-08 07:59:22
c16d08713e2d7f5c440f7649ceb68f838b4b8bea...24c64d6add05f1f4d2e277af2d44c961910c98d3,1,1,0,1,1,2007-04-09 05:14:16,2007-04-09 05:14:16
0556a11a0df6b4119e01aa77dfb795561e62eb34...02d3dca3bff6a67dead9f5b97dfe3576fe5b14e5,1,1,1,2,1,2006-07-02 17:55:59,2006-07-02 17:55:59
02d3dca3bff6a67dead9f5b97dfe3576fe5b14e5...35c636ec487d0d5c38e0ce8d3d7bc7ca42c6e5c1,1,1,1,2,1,2006-07-03 00:07:45,2006-07-02 22:21:00
0556a11a0df6b4119e01aa77dfb795561e62eb34...b00d7079ce000afe8803b6e88a7ab0f09942462d,1,3,7,10,3,2006-07-02 01:29:25,2006-07-01 01:54:32
b00d7079ce000afe8803b6e88a7ab0f09942462d...e0becd944578ed2a38742911dff75fa7774059e5,1,1,0,1,1,2006-07-02 01:29:25,2006-07-01 02:11:18
e0becd944578ed2a38742911dff75fa7774059e5...dc6d9b4999bfdf6bcabf8803f9fa886eb9eaba28,1,27,28,55,20,2006-07-02 01:29:26,2006-06-21 13:07:08
dc6d9b4999bfdf6bcabf8803f9fa886eb9eaba28...a51d37c1df66386a4d9b7559d64a39241d4e47da,4,335,1,336,5,2006-07-02 01:29:26,2006-07-01 22:14:14
a51d37c1df66386a4d9b7559d64a39241d4e47da...07002287f3e219a16a948a8a6eca0a41162a491f,1,5,5,10,1,2006-07-02 18:04:50,2006-07-02 09:31:30
07002287f3e219a16a948a8a6eca0a41162a491f...6ee030d68adc1fb51c3abda458999fa7afc43db5,1,3,3,6,1,2006-07-02 18:04:56,2006-07-02 11:56:16
0556a11a0df6b4119e01aa77dfb795561e62eb34...cdd4037d7053647c97139ac77d4319124f17d47e,1,3,7,10,3,2006-07-02 01:29:13,2006-07-01 01:54:32
cdd4037d7053647c97139ac77d4319124f17d47e...85b7cfb1036b4218d13cbc215729ad083a61a0ea,1,1,0,1,1,2006-07-02 01:29:13,2006-07-01 02:11:18
85b7cfb1036b4218d13cbc215729ad083a61a0ea...4a87b43e374626a95c14362f21c9ca1023638a2c,1,27,28,55,20,2006-07-02 01:29:13,2006-06-21 13:07:08
7b8cf0cf2973cc8df3bdd36b9b36542b1f04d70a...556677144b55aad8457851a9019e86c3676bd422,5,48,0,48,5,2006-07-03 00:11:52,2006-07-02 23:56:48
556677144b55aad8457851a9019e86c3676bd422...92b878ade12f6672ce7ff7d12ac74b69c8e35c59,1,2,0,2,1,2006-07-08 21:24:06,2006-07-08 21:07:07
92b878ade12f6672ce7ff7d12ac74b69c8e35c59...633b423961df659fbf110fd7b127ebc9a0a38277,1,113,1,114,1,2006-07-09 09:19:38,2006-07-08 21:07:08
633b423961df659fbf110fd7b127ebc9a0a38277...d3a6db981179a1dc772768ff6af0414d17848d93,1,16,1,17,5,2006-07-09 09:20:32,2006-07-08 21:07:09
d3a6db981179a1dc772768ff6af0414d17848d93...eb0f255d6144af26361b12cb38aae9c23581a955,1,13,2,15,4,2006-07-09 09:20:40,2006-07-08 21:07:10
eb0f255d6144af26361b12cb38aae9c23581a955...1bbbadbc2c32d1a6d0e97713e4f6e417daa72759,1,12,3,15,4,2006-07-09 09:20:47,2006-07-08 21:07:11
1bbbadbc2c32d1a6d0e97713e4f6e417daa72759...ebdf53210ca30eaaa6cf5f555200678bf5f256ac,1,21,7,28,6,2006-07-09 09:20:54,2006-07-08 21:07:12
ebdf53210ca30eaaa6cf5f555200678bf5f256ac...fd22c0271b33227e651be456beb4cead934f5624,2,12,0,12,2,2006-07-09 09:20:57,2006-07-08 21:07:13
fd22c0271b33227e651be456beb4cead934f5624...f671957206bb5e9cc6db630e74b57bd1ae1157a7,1,15,14,29,15,2006-07-09 09:20:59,2006-07-08 21:07:14
f671957206bb5e9cc6db630e74b57bd1ae1157a7...81d0e51e28607000712b92f5d7295ad07eb3ccb7,1,1,1,2,1,2006-07-09 09:47:31,2006-07-09 09:46:17
81d0e51e28607000712b92f5d7295ad07eb3ccb7...66142aa1f53979a87678159a82734b0174d98070,1,12,12,24,11,2006-07-15 05:33:10,2006-07-15 05:29:19
66142aa1f53979a87678159a82734b0174d98070...2d023581c9a0ae5efdebfd0084d54d09669a25d5,1,1,0,1,1,2006-07-15 05:33:12,2006-07-15 05:29:21
6bdca8905764affcab0c92a60a6a319080d76652...a0c2089c1d48dc9969822126170d35c6e5aa141f,1,8,2,10,1,2006-07-08 00:48:02,2006-07-08 00:48:02
a0c2089c1d48dc9969822126170d35c6e5aa141f...6244b24906f9efa4c1d573fa79e73eaf8e557551,7,8,7,15,7,2006-07-08 10:28:19,2006-07-08 08:56:28
6244b24906f9efa4c1d573fa79e73eaf8e557551...6e959ab05a0a626f6805581a04dfc4e220054c02,1,2,2,4,2,2006-07-08 18:28:32,2006-07-08 15:27:10
6e959ab05a0a626f6805581a04dfc4e220054c02...d9bffc08fd2cec626e3a390fa4cc47587a8c7f9e,6,6,5,11,6,2006-07-08 18:35:20,2006-07-08 15:32:04
d9bffc08fd2cec626e3a390fa4cc47587a8c7f9e...135a522e3f0ddc85664b3cd094918f095ac76d79,1,2,2,4,4,2006-07-09 07:46:56,2006-07-07 10:55:41
135a522e3f0ddc85664b3cd094918f095ac76d79...f3aafa4db29c3d4799eeeda21efaf15d364ae59a,1,3,0,3,1,2006-07-09 07:48:16,2006-07-09 06:28:21
6bdca8905764affcab0c92a60a6a319080d76652...ae3e5e1ef2271524882d6bb7c0469f777a255315,1,51,2,53,5,2006-07-07 20:32:31,2006-07-03 09:59:32
6bdca8905764affcab0c92a60a6a319080d76652...6d64ea965bc2894ef0aee16ac23a5e47f20eb824,2,5,1,6,3,2006-07-07 19:28:04,2006-07-07 10:33:57
6d64ea965bc2894ef0aee16ac23a5e47f20eb824...63ac4501199ca768e95ad3442f6580e41a002a33,1,1,1,2,1,2006-07-07 19:28:04,2006-07-07 13:57:07
63ac4501199ca768e95ad3442f6580e41a002a33...ca49920f6f8e7de3463757662841c608ca978888,1,2,1,3,1,2006-07-07 19:28:04,2006-07-07 13:57:08
ca49920f6f8e7de3463757662841c608ca978888...d507bb15008d6ee657eebaf2803bf0964af12c93,1,6,0,6,1,2006-07-07 19:28:04,2006-07-07 13:57:09
d3ba675aae3c6c5722ad15cd9d0f3b7634e976ce...1b3a667461c7b85068d38eb50fa60529959855fb,1,7,3,10,4,2006-07-14 04:21:27,2006-07-13 20:22:13
1b3a667461c7b85068d38eb50fa60529959855fb...5716e794bf12ad9740da41d06c94e2771fe9e0ee,1,7,0,7,2,2006-07-14 04:21:34,2006-07-13 20:22:14
5716e794bf12ad9740da41d06c94e2771fe9e0ee...a40d384caca008c0334a35e9ac298f2eeb5decd2,42,161,104,265,117,2006-07-14 04:40:43,2006-07-14 02:51:12
a40d384caca008c0334a35e9ac298f2eeb5decd2...19b3bd3e2d260323c5e727212a6dcd7fc0f7aa07,1,9,2,11,3,2006-07-14 04:40:43,2006-07-13 22:17:22
19b3bd3e2d260323c5e727212a6dcd7fc0f7aa07...855409296d74d3e53fdaa3cdefd1171e4c950fab,6,8,0,8,8,2006-07-14 04:40:44,2006-07-14 04:39:13
855409296d74d3e53fdaa3cdefd1171e4c950fab...8d5e26848d0ddd5063f078b0c34c6c48b68d0d94,1,3,3,6,1,2006-07-14 04:48:45,2006-07-14 04:48:45
8d5e26848d0ddd5063f078b0c34c6c48b68d0d94...ad8b4f56b5ec1e5385156c20d95649ea8cee6af4,1,11,8,19,4,2006-07-14 04:50:14,2006-07-13 10:02:29
ad8b4f56b5ec1e5385156c20d95649ea8cee6af4...258e93a155f88fd7385e4d1e26f287044ba973e9,1,14,0,14,2,2006-07-14 04:50:20,2006-07-13 16:32:11
258e93a155f88fd7385e4d1e26f287044ba973e9...5f490ce03c16411b737374c12ed377c74af1ca9d,1,4,0,4,1,2006-07-14 04:50:22,2006-07-13 11:07:59
5f490ce03c16411b737374c12ed377c74af1ca9d...45ed5d7f4cf641d1f64a83613f5a29b31268f8e8,1,17,0,17,4,2006-07-14 04:50:41,2006-07-13 10:18:08
45ed5d7f4cf641d1f64a83613f5a29b31268f8e8...a5262768e1e4af96bbca60ee712e97105f80de24,1,28,1,29,4,2006-07-14 04:50:46,2006-07-13 16:47:13
a5262768e1e4af96bbca60ee712e97105f80de24...ff4d78041e85d1eddb17f2eee497e29aaeee4564,2,7,5,12,3,2006-07-14 04:52:42,2006-07-12 19:54:51
ff4d78041e85d1eddb17f2eee497e29aaeee4564...f37399e6b0689b8b9a5a4cf9149ede5a39fca549,1,106,56,162,4,2006-07-14 04:53:23,2006-07-13 16:06:12
f37399e6b0689b8b9a5a4cf9149ede5a39fca549...f5b571fcf7929ca6e85b3c35c4bb96db305d0b1e,1,18,6,24,5,2006-07-14 04:53:25,2006-07-13 16:08:06
f5b571fcf7929ca6e85b3c35c4bb96db305d0b1e...3dffd2c82862f3e49dd9399adb480cd80d4f34ae,1,13,19,32,4,2006-07-14 05:00:16,2006-07-13 08:30:43
3dffd2c82862f3e49dd9399adb480cd80d4f34ae...4b7ce6e2d6ba088da50de1df38b040ea2c0b8f18,1,8,1,9,4,2006-07-14 05:02:43,2006-07-13 19:36:22
d3ba675aae3c6c5722ad15cd9d0f3b7634e976ce...1974632c664c2d573b36a00fa993c1c13dd8a967,22,87,92,179,71,2006-07-13 06:18:03,2006-07-12 03:45:31
1974632c664c2d573b36a00fa993c1c13dd8a967...e5a78b1ca8b62aee8567d67f0e0db5ac7706806a,1,3,3,6,3,2006-07-14 06:37:52,2006-07-14 06:37:52
d3ba675aae3c6c5722ad15cd9d0f3b7634e976ce...756aaf4ac5906e79b22001a96dd4f6aec0d1c89d,1,12,14,26,3,2006-07-13 06:16:29,2006-07-12 05:00:16
047fbe906b375e8a3a7564ad0e4443f62dd528a2...d7de00f7e0d2374cb7933d2ee1ebe5273a8acf53,1,13,0,13,1,2006-07-02 05:26:00,2006-06-24 17:26:49
d7de00f7e0d2374cb7933d2ee1ebe5273a8acf53...5faf64cd28bf79f0c2939717d2ba117498717059,2,0,14,14,2,2006-07-02 05:26:00,2006-06-24 17:28:42
8499294c41fe92a560a083c42caad36b4e27fb51...9af25117963382b5f4c342bc9dbae7b4e60c4a11,1,3,0,3,1,2006-07-10 07:21:33,2006-07-10 03:07:27
9af25117963382b5f4c342bc9dbae7b4e60c4a11...930cf7dd7cc6b87d173f182230763e1f1913d319,1,67,60,127,5,2006-07-10 07:30:11,2006-07-10 03:18:57
930cf7dd7cc6b87d173f182230763e1f1913d319...82e5a82fd73edb80a841f5fab1660e14b9b8f3ad,34,56,56,112,50,2006-07-10 07:36:44,2006-07-10 05:50:18
82e5a82fd73edb80a841f5fab1660e14b9b8f3ad...a9486b02ec7e03d17317fe538b0d06ca04379f23,10,33,31,64,21,2006-07-10 07:47:13,2006-07-10 06:57:51
8b7e5d76e836396a097bb6f61cf930ea872a7bd3...232475d38231552f04f2e4221936700a923a531e,1,102,68,170,23,2005-11-14 23:34:03,2005-11-14 23:34:03
c1067050ce58b5b39f528fe634732da858664603...1e1cba6433a15d68eeca7eda7646d687714c18e3,1,1,1,2,1,2005-09-27 01:29:26,2005-09-27 01:29:26
1e1cba6433a15d68eeca7eda7646d687714c18e3...3cc35e29ec252d0dca1139106fbaa70cb9ad6ef1,1,1,1,2,1,2005-09-27 07:15:45,2005-09-27 07:15:45
61f01a5b773915402da37a34e706db56fe90b776...670f5fe34f0f6a363297d5dcd73051089b78fe82,1,6,2,8,2,2005-08-30 18:57:28,2005-08-30 18:04:39
670f5fe34f0f6a363297d5dcd73051089b78fe82...cc9f24d024e7e4bf0b2fbd4e1beb7eb1a425805f,1,22,6,28,7,2005-08-30 19:45:41,2005-08-30 19:45:41
cc9f24d024e7e4bf0b2fbd4e1beb7eb1a425805f...8db9307c9ca143fedaa972236054a5783c40bd37,9,508,357,865,149,2005-08-30 20:55:34,2005-08-30 20:51:01
8db9307c9ca143fedaa972236054a5783c40bd37...5da22bc14b6a8329c181067ad8a8b383dab512fc,1,1,0,1,1,2005-08-30 20:56:21,2005-08-30 16:07:50
165e160e4c4fb5b03146d5c41c2f6b078260b098...b909a15edef8c79b2b045bd90d25e19ea58f299c,1,6,6,12,3,2005-08-20 17:54:27,2005-08-20 16:02:16
b909a15edef8c79b2b045bd90d25e19ea58f299c...d57306c7945becfba70d3139af0a3a8f525a6bb5,2,6,3,9,3,2005-08-20 17:59:28,2005-08-20 09:05:31
d57306c7945becfba70d3139af0a3a8f525a6bb5...90a734dc7f37a7bd1f3beec4d33acad559360f6c,1,1,2,3,2,2005-08-21 10:48:33,2005-08-21 07:14:16
90a734dc7f37a7bd1f3beec4d33acad559360f6c...1dfcfbce2d643b7c7b56dc828f36ced9de2bf9f2,1,0,1,1,1,2005-08-21 10:52:55,2005-08-21 09:43:08
8edf8c0a9bddb33f45017a856e909c5e47c8a7f6...486b65a4c3fe3a62e3793dba8c0c6e303b237fc9,2,37,1,38,2,2013-11-07 22:39:47,2013-11-07 22:39:47
944adac909185f8bf2fe13be53b6768ed7d7b0ff...f26f72de159d7ade2fbe8b48734ce98c1aba4d72,1,17,0,17,1,2013-11-04 23:05:08,2013-11-04 23:05:08
e31bb3bb939a8feb7af472c55d95f41a90bbc438...2150cc99fe29fd81db1e9c5971e13bcb78373ebf,1,11,5,16,5,2005-08-15 23:32:58,2005-08-15 22:37:37
efe0a206a24179bf085463ea88f8c95ebc7c4768...53284de77712b2234c739afa3aa5f024fc89fc83,1,17,45,62,7,2012-09-11 18:41:35,2012-09-11 18:41:35
b319ef70a94731a5c6f18d07a49d5dda3f06f5d3...46b5139cae7306194a39fdaf5c6abc12ab531c84,2,31,14,45,9,2009-08-14 19:40:09,2009-08-13 12:29:41
46b5139cae7306194a39fdaf5c6abc12ab531c84...d002ef4d9446b9fe4d0c397131edce58781df2f1,4,154,6,160,14,2009-08-15 22:17:47,2009-08-15 11:48:31
d002ef4d9446b9fe4d0c397131edce58781df2f1...4f353658b9c15e9188530fac5ae79d0aa1538e85,4,199,1,200,14,2009-08-15 22:18:05,2009-08-15 11:48:30
4f353658b9c15e9188530fac5ae79d0aa1538e85...dda1f2a5c3aca5072aada32eef159067ba16f0e9,4,145,18,163,15,2009-08-15 22:19:31,2009-08-13 12:29:44
367ea191e659da05a2e79a7025d8628a02f8268a...f300fab5440f25aabb22c6d1fec411ee10e154b1,2,3,3,6,2,2009-08-15 22:21:22,2009-08-13 12:29:45
f300fab5440f25aabb22c6d1fec411ee10e154b1...933766c1a9df4981aa99120e192d8444150c9765,1,5,0,5,1,2009-08-18 19:28:42,2009-08-18 06:12:44
933766c1a9df4981aa99120e192d8444150c9765...14c674e9dc52c4b93512b22748c01ca6ccdef7bd,1,0,0,0,0,2009-08-27 23:44:47,2009-08-27 07:35:55
14c674e9dc52c4b93512b22748c01ca6ccdef7bd...3c2eb80fe3f3c7efbb25e929df9f70d7c896a5ef,3,39,8,47,7,2009-09-02 05:03:11,2009-08-18 21:38:40
ae71760d242abd564eef2f5587a9633f2ee882dc...2ceb639f93d4ca05467ec34f49de8b6ceb0deb03,1,2,1,3,1,2009-07-26 06:58:29,2009-07-25 00:28:50
2ceb639f93d4ca05467ec34f49de8b6ceb0deb03...d8f7be2ebcb7e3ec40269080a9ab9a28bc06ba17,1,7,4,11,5,2009-07-26 07:05:34,2009-07-26 07:04:50
e276f018f2c1f0fc962fbe44a36708d1cdebada8...65807ee697a28cb30b8ad38ebb8b84cebd3f255d,2,12,1,13,2,2010-01-26 19:20:06,2010-01-26 15:02:16
e276f018f2c1f0fc962fbe44a36708d1cdebada8...929e37d3dfef13895ef6e4b54c7d45962b234461,1,1,0,1,1,2009-09-07 22:02:31,2009-09-07 08:48:01
929e37d3dfef13895ef6e4b54c7d45962b234461...493b7a08d80535def6756b281873e4e0937ba6c2,3,29,27,56,14,2009-09-07 22:03:04,2009-09-05 12:31:17
e276f018f2c1f0fc962fbe44a36708d1cdebada8...ebdaae372b460ffdf5d153dcd0ac235d52b0d2ce,2,9,6,15,3,2009-07-31 15:38:30,2009-07-30 11:41:57
ebdaae372b460ffdf5d153dcd0ac235d52b0d2ce...69931b718307ad5adf85292b03e46d822156840a,1,0,1,1,1,2009-08-04 22:20:35,2009-08-04 21:57:34
69931b718307ad5adf85292b03e46d822156840a...b0c051d1a0939ed0013d359065b3afaebe3a717f,1,1,1,2,1,2009-08-04 22:20:45,2009-08-03 16:41:34
b0c051d1a0939ed0013d359065b3afaebe3a717f...e77095e8b8d541b41c242aa6dbc8319cb99def5e,1,1,1,2,1,2009-08-05 16:45:00,2009-08-05 15:36:28
aef37684ea713c96dc3e4913cf33962df1efb92b...aa7dd05e6a622ec17d034980c4440b0aed583c6e,2,36,0,36,6,2009-09-01 15:34:24,2009-09-01 11:39:16
aa7dd05e6a622ec17d034980c4440b0aed583c6e...4af819d4cad206648b832f4d6103547981ab8004,6,939,87,1026,25,2009-09-01 15:34:24,2009-09-01 11:39:17
4af819d4cad206648b832f4d6103547981ab8004...e206d62a922d80f2d00427ddfb93435adbf1cc59,2,110,3,113,5,2009-09-01 15:34:25,2009-09-01 11:39:18
e206d62a922d80f2d00427ddfb93435adbf1cc59...c4ccf61f4caf8c293713586531b4a2ea709756c8,2,53,9,62,7,2009-09-01 15:34:25,2009-09-01 11:39:19
c4ccf61f4caf8c293713586531b4a2ea709756c8...63267de2acc18027fc0208c0937fd62b91301fec,1,20,0,20,7,2009-09-01 15:34:25,2009-09-01 11:39:20
63267de2acc18027fc0208c0937fd62b91301fec...e42a05f75c9ff5d10d0b8f6784fc244873818a99,1,5,2,7,1,2009-11-20 07:02:30,2009-11-19 19:44:46
e42a05f75c9ff5d10d0b8f6784fc244873818a99...6aa2de51511bf847f6e69dfcfc9e7d977ef171a6,1,6,1,7,1,2009-11-25 08:04:39,2009-11-25 00:45:15
6aa2de51511bf847f6e69dfcfc9e7d977ef171a6...6821dee9a91131e1a003ee65b2f4218a19ea8f3d,1,5,5,10,4,2009-11-25 08:06:32,2009-11-25 03:51:40
6821dee9a91131e1a003ee65b2f4218a19ea8f3d...e627e50a70677c057e984aea8bac4c27687e9614,1,8,1,9,2,2009-12-01 04:09:41,2009-11-26 20:12:15
e627e50a70677c057e984aea8bac4c27687e9614...87e573f660dd0e871f3eb673d0b856488b6d8336,1,11,0,11,1,2009-12-01 19:25:21,2009-12-01 16:54:26
5dc36a5888a7063ff4536c9ea50eb0557bfef627...584c43567be838c8e2dd89c881cac028f5bd4565,2,29,0,29,3,2009-08-10 23:54:23,2009-08-07 01:08:12
584c43567be838c8e2dd89c881cac028f5bd4565...af12fb7b3048c5bdd2e90885a6736ebc29d84f01,1,5,1,6,1,2009-08-10 23:54:29,2009-08-07 01:08:13
5dc36a5888a7063ff4536c9ea50eb0557bfef627...28e9cf6512cae1b50a2d2003bb59da4392d99e2e,3,13,12,25,3,2009-08-10 21:39:39,2009-08-10 16:22:18
28e9cf6512cae1b50a2d2003bb59da4392d99e2e...0a7f448355f38b8a626ec3c120ad7118690897fe,1,4,0,4,1,2009-08-10 21:39:41,2009-08-10 16:22:22
5dc36a5888a7063ff4536c9ea50eb0557bfef627...f0e588dffc1a592ec7879cdb610654937cbbe25e,1,1,1,2,1,2009-08-10 01:38:47,2009-08-08 22:24:02
5dc36a5888a7063ff4536c9ea50eb0557bfef627...ce0646184696ae6d87c0e243d058cf5df6459c4f,1,50,0,50,1,2009-08-09 19:34:19,2009-08-09 10:01:48
ce0646184696ae6d87c0e243d058cf5df6459c4f...751c59746c7522982214528eb653dfb61d372257,3,10,11,21,5,2009-08-09 19:34:20,2009-08-09 10:02:24
751c59746c7522982214528eb653dfb61d372257...69a8b7c74192dfa7bde3937d2c84324a2cd1506b,3,16,1,17,3,2009-08-09 19:34:21,2009-08-09 10:02:51
2cfe8a68ccba86f046080f890102a9a43361cfdd...af7b41c923677ff9291bab56ec7069922e37453b,2,6,0,6,2,2011-05-31 16:20:31,2011-05-31 15:33:56
af7b41c923677ff9291bab56ec7069922e37453b...28b9264dd6cbadcef8b3e48c24ffcb2893b668b3,4,11,6,17,4,2011-05-31 16:21:36,2011-05-31 16:14:17
b65954d1720960f888d1d51e51befb84e05018eb...133cfaeb8ba40f12e4c0ad99bdd3a0a4f8d0ade2,1,22,2,24,3,2009-07-29 18:02:49,2009-07-27 21:27:47
133cfaeb8ba40f12e4c0ad99bdd3a0a4f8d0ade2...e6580020057afd207b7cfb9c96905f99e13cfe4d,1,679,0,679,1,2009-07-29 19:19:43,2009-06-29 15:32:22
e6580020057afd207b7cfb9c96905f99e13cfe4d...86b5efb2864ca50d86437f94ec4c26042cba193e,2,8,2,10,4,2009-07-31 14:47:38,2009-07-27 18:49:56
86b5efb2864ca50d86437f94ec4c26042cba193e...79559f27be7e2963213d840a857dee92c579843f,2,16,1,17,5,2009-07-31 14:48:09,2009-07-28 02:20:22
79559f27be7e2963213d840a857dee92c579843f...a4782b3d6e298488d2265b6a24cab5aab876f37e,1,1,1,2,1,2009-07-31 15:39:07,2009-07-30 23:08:53
a4782b3d6e298488d2265b6a24cab5aab876f37e...2da846e70945a55b2b3378f4aa5fadcc404f0f01,1,3,2,5,1,2009-07-31 18:22:50,2009-07-31 17:45:00
2da846e70945a55b2b3378f4aa5fadcc404f0f01...07a4a3b4962e1fd4e40fd877427cddd7428c1bc3,1,69,73,142,52,2009-07-31 18:24:18,2009-07-31 16:50:50
d1f6c18bd6ea5fd373f9f6356e02854678ffa0fd...1ab012cf811abba5745fa0da70db963decd65f21,1,1,1,2,1,2009-06-22 07:44:14,2009-06-22 07:30:38
68ea4741643d9e7c4bdac7cbbe6292edc69430ef...a8563ec8515d87259590a7aad182922def8e2cf2,4,144,2,146,9,2009-08-29 05:39:17,2009-08-26 23:39:10
a8563ec8515d87259590a7aad182922def8e2cf2...11cae066b2433fcec807810b45f317f8203df358,3,30,2,32,4,2009-08-29 05:39:24,2009-08-29 05:19:45
68ea4741643d9e7c4bdac7cbbe6292edc69430ef...b42c9af2cd3dcc56c8aae9a7d73ed1fc342e1f02,1,0,3,3,1,2009-08-27 23:20:10,2009-08-27 15:35:46
b42c9af2cd3dcc56c8aae9a7d73ed1fc342e1f02...1630726e849b8b0f1802ad0681b94a64d4851a30,1,3,3,6,3,2009-08-27 23:20:53,2009-08-27 16:16:33
1630726e849b8b0f1802ad0681b94a64d4851a30...f203d6969b7cfbb56460d5bf8e99b0a7d1abe03b,1,5,5,10,5,2009-08-27 23:21:23,2009-08-27 16:16:34
68ea4741643d9e7c4bdac7cbbe6292edc69430ef...7a4ee28f41270bf032d0dd0bfb17f601b9b3971a,3,122,28,150,16,2009-08-27 02:36:20,2009-08-26 19:05:08
46caf5053f0a784911c66530928e6e4361a783f2...dff4b0ef30cd3f06e1f2383ce09f81b8da94d5b3,1,2,1,3,1,2011-08-29 16:07:54,2011-08-29 15:22:06
cbdefb5ac43a1a34e71121a7a6a6434f0b8aa1cf...34b31a8d5f48283ec3039777b24706585b4f9d41,1,2,2,4,2,2009-08-25 23:33:06,2009-08-25 04:59:48
34b31a8d5f48283ec3039777b24706585b4f9d41...05526071cb5ce2f040514b7f50a4e32b16802ffd,2,74,66,140,3,2009-08-28 02:56:02,2009-08-28 02:07:07
05526071cb5ce2f040514b7f50a4e32b16802ffd...e39e0d375d1d84fc1fff14b58c729fbd289cdd01,1,78,0,78,1,2009-08-28 02:56:28,2009-08-25 05:03:48
ea5b1f6e129883479246e607e664b427b4ba779c...7d53a07a2833116cdf52ca256375c6b37f4d6b46,1,1,1,2,1,2009-08-09 17:41:37,2009-08-09 15:38:04
7d53a07a2833116cdf52ca256375c6b37f4d6b46...d82e75e86c8d1555aaa6415034aff215633fe7f2,1,6,0,6,1,2009-08-09 17:43:24,2009-08-09 16:02:55
d82e75e86c8d1555aaa6415034aff215633fe7f2...eaf0551d56b4fd3a97c8d0f5ded1ea6e891f9005,4,4,4,8,4,2009-08-09 17:48:39,2009-08-09 08:37:52
eaf0551d56b4fd3a97c8d0f5ded1ea6e891f9005...91c8b825ce2a301e9861be60c3d7853fefa93c04,2,3,3,6,3,2009-08-09 17:49:34,2009-08-09 08:38:11
91c8b825ce2a301e9861be60c3d7853fefa93c04...f423ef5f2bec35efbc328f02e468a18612970242,1,8,1,9,2,2009-08-09 17:50:32,2009-08-09 08:39:45
f423ef5f2bec35efbc328f02e468a18612970242...c14417c4f5f8d7765e232f1e908b85d2ae14ec34,1,2,0,2,1,2009-08-09 17:51:47,2009-08-09 08:50:37
a12218572f2875e91b6c3c12559b076c4949a675...d5f6a96fa4792f6143d06d9c0b572a96d7235305,1,1,1,2,2,2009-08-18 19:26:01,2009-08-18 00:18:23
d5f6a96fa4792f6143d06d9c0b572a96d7235305...51ea55190b6e72c77c96754c1bf2f149a4714848,3,40,2,42,3,2009-08-18 21:16:37,2009-08-18 19:26:55
51ea55190b6e72c77c96754c1bf2f149a4714848...e9c5dcd1313dd4e2f606419ce3d228c99fae2c40,1,2,2,4,2,2009-08-18 21:18:36,2009-08-18 19:37:22
e9c5dcd1313dd4e2f606419ce3d228c99fae2c40...30ae47b4cc19dce42f51b4fa378d315a71b08957,9,11,526,537,18,2009-08-18 21:19:40,2009-08-18 00:09:56
105a6339d8454d3856099f6ccea14435a05e2268...8b2337a5893479ee18dfb21a1d4aa5fc1608872d,1,4,4,8,6,2010-02-09 07:06:08,2010-02-09 04:07:25
8b2337a5893479ee18dfb21a1d4aa5fc1608872d...3c651491f28e01a9ee0ddaecd05fb7a211d218c3,1,1,1,2,1,2010-02-10 18:01:43,2010-02-10 16:30:29
c9c3c6781c5b97c37b3ce16af7ea9bc613413c7e...7cfe0c9802d6d6c915cba91b73a591622dbcbc93,2,15,18,33,9,2009-07-11 06:57:21,2009-07-08 05:15:41
a49eb197d809d2d7efbd81d935c61e1a0caa983e...2af202be3d2f128c6974290cabe13179c6462196,23,42,42,84,41,2009-06-21 04:52:55,2009-06-18 17:28:43
b9dcf846e20ed5287e239c9a0942c5d150081bab...baafd6e76522d4f20c9e1755537005f1cfd2f492,1,2,1,3,2,2007-07-12 21:17:26,2007-07-12 21:17:26
baafd6e76522d4f20c9e1755537005f1cfd2f492...c83f032e09e49e5bc60686663f7c78d36f72cef4,1,10,4,14,3,2007-07-12 21:18:14,2007-07-12 18:33:21
c83f032e09e49e5bc60686663f7c78d36f72cef4...750bd6ac350079cf1f76c24acb7686ad89a95102,1,26,0,26,1,2007-07-12 21:18:15,2007-07-12 07:40:18
750bd6ac350079cf1f76c24acb7686ad89a95102...b492bbd8362840f9ac1e5389cdfaa8dd73ca793b,1,1,1,2,1,2007-07-12 21:18:24,2007-07-12 14:16:11
b492bbd8362840f9ac1e5389cdfaa8dd73ca793b...a1dab41af4c575bb72231c73df26ecb2af4814d6,1,2,0,2,1,2007-07-12 21:32:34,2007-07-12 12:55:47
a1dab41af4c575bb72231c73df26ecb2af4814d6...11779e79078c9da604753e570d02134c8d4bae6a,2,17,0,17,4,2007-07-12 21:32:35,2007-07-12 12:55:48
11779e79078c9da604753e570d02134c8d4bae6a...0b87b6e081e75170ffa40e92aebde1e22ad3161e,2,48,11,59,5,2007-07-12 21:32:35,2007-07-12 13:32:26
0b87b6e081e75170ffa40e92aebde1e22ad3161e...a97773ce7e4fb635615d3b363f144d8c8a780fea,1,44,8,52,12,2007-07-12 21:32:35,2007-07-12 13:07:46
a97773ce7e4fb635615d3b363f144d8c8a780fea...121b42a5b4839c7d8756b0da3e6ed18e720b1295,1,2,1,3,2,2007-07-12 21:32:35,2007-07-12 12:55:51
121b42a5b4839c7d8756b0da3e6ed18e720b1295...e93b15cd7441369f28dd4841ab504cea83c18b10,3,28,0,28,3,2007-07-12 21:32:35,2007-07-12 12:55:52
e93b15cd7441369f28dd4841ab504cea83c18b10...5a235b5ed02fa0f9f67c4fbec703e3126eb3c7f5,1,9,10,19,11,2007-07-12 21:36:09,2007-07-12 21:07:59
5a235b5ed02fa0f9f67c4fbec703e3126eb3c7f5...4f50f6a966dc9a1ff7d11b2ca5eb116fa9dd139a,1,9,0,9,2,2007-07-12 21:36:41,2007-07-12 14:52:30
4f50f6a966dc9a1ff7d11b2ca5eb116fa9dd139a...248c648a0de945ec37af13e0a9b8671da525c323,1,65,0,65,1,2007-07-12 21:38:15,2007-07-12 14:48:48
248c648a0de945ec37af13e0a9b8671da525c323...868bc068bb45e3b9d135151f2126ce3dba849426,1,19,0,19,3,2007-07-12 21:38:36,2007-07-12 18:39:27
a5e407988b35b7353bd03c770afc647670c25981...9f90c7335e223c26d19f3c01a6d89e6c0cd8b827,1,18,5,23,4,2007-07-17 06:35:24,2007-07-16 03:58:10
9f90c7335e223c26d19f3c01a6d89e6c0cd8b827...788001908c8960daa162c32baf3dc0f9ad1c16f8,1,7,21,28,1,2007-07-17 06:35:33,2007-07-16 03:58:11
788001908c8960daa162c32baf3dc0f9ad1c16f8...062410bb9d6553e6bc4f8fa7f0cab1ed63b75628,1,23,0,23,1,2007-07-18 15:29:05,2007-07-18 08:56:31
062410bb9d6553e6bc4f8fa7f0cab1ed63b75628...86506fe54c8e9e5f75a73956840497e3e5744f86,1,17,12,29,5,2007-07-18 15:29:31,2007-07-18 10:40:12
86506fe54c8e9e5f75a73956840497e3e5744f86...144ff46b196e49fd52b2ecf0aaa1db4c190393b9,1,5,21,26,1,2007-07-18 15:29:38,2007-07-18 15:27:50
a5e407988b35b7353bd03c770afc647670c25981...f97949235470920578dff360f100e848894f73d4,1,0,26,26,7,2007-07-15 22:23:36,2007-07-15 19:49:33
f97949235470920578dff360f100e848894f73d4...21ad54467a41f742491bc1d6223e9dd944ce8c97,1,9,20,29,9,2007-07-15 22:23:36,2007-07-15 19:51:01
21ad54467a41f742491bc1d6223e9dd944ce8c97...e3b4968f9caa04e83b2f27b64182187b13b86dab,3,1,0,1,1,2007-07-15 22:23:37,2007-07-15 19:52:32
e3b4968f9caa04e83b2f27b64182187b13b86dab...9dfdf14b3805e89aa2782458bda15b3dfae24c09,1,15,1,16,5,2007-07-15 23:41:17,2007-07-15 23:41:17
9dfdf14b3805e89aa2782458bda15b3dfae24c09...99c01de402b543647a6500ceeaca7f62e343b144,1,1,1,2,1,2007-07-16 03:21:51,2007-07-15 09:46:11
99c01de402b543647a6500ceeaca7f62e343b144...29633bb91c7bcff31ff3bb59378709e3e3ef627d,4,194,0,194,4,2007-07-16 05:35:09,2007-07-16 04:53:50
29633bb91c7bcff31ff3bb59378709e3e3ef627d...33b1f3d54406dce2cc9cbed35993e55829a94626,1,2,2,4,1,2007-07-17 04:34:44,2007-07-16 11:38:47
33b1f3d54406dce2cc9cbed35993e55829a94626...726f9bced9717fb8b3c1e91228be1cdce514a98e,1,3,4,7,2,2007-07-17 08:33:04,2007-07-17 06:59:54
615b865358f32537bd4a7065a042de435e9413f3...b2f3bb1b66d9422aa5049f994c6e370a18d89759,1,2,1,3,1,2007-06-11 23:48:41,2007-06-11 23:39:55
b2f3bb1b66d9422aa5049f994c6e370a18d89759...39fa2a983d55b37759b99e67f9f1892879efb775,6,26,9,35,9,2007-06-12 03:52:43,2007-06-12 03:52:43
23fcdc79713c47a6a0d50762b9311c9933a60d3f...5035242c4785bd23c53827a1656b5f97394f724e,2,42,1,43,4,2007-06-08 08:19:13,2007-06-08 08:19:13
23fcdc79713c47a6a0d50762b9311c9933a60d3f...defe13a24a254f19596b8008095829068e742f9c,2,47,1,48,2,2007-06-06 23:40:03,2007-06-06 23:39:05
23fcdc79713c47a6a0d50762b9311c9933a60d3f...e2ac7cb5fbcf1407003aa07cdcd14141527ea2e3,2,9,1,10,4,2007-06-06 22:43:18,2007-06-06 10:25:17
8009533070638490603eee06e1622f3e5aa3bfb2...d3017e9373d1fea0558c77de7297648667e3a713,1,4,0,4,2,2007-06-03 03:02:15,2007-06-03 00:46:47
d3017e9373d1fea0558c77de7297648667e3a713...c94bf41c9a78dc1c084f2a2895f95b6b6d8f79b1,1,8,9,17,6,2007-06-03 03:02:19,2007-06-03 02:55:54
6d9d26d82623b8189fa88ebb7b47e45f8ccbb3b1...c23290d528c208a25641f0fc278bac9bb9838265,1,37,2,39,16,2007-05-26 08:12:43,2007-05-25 10:50:08
693f62ff6862b2bcee2bfba8db8d1e9196fa239c...19b5d50cb15637f20b9cce01806b3a256491d613,1,17,4,21,3,2014-10-21 20:35:44,2014-10-21 20:35:44
1a8b76912e6ccef6bec3531eec30a0693bc25ae7...556df5e9c4ddbc481d7a25aef63ee41d9b1b6215,2,110,1,111,2,2007-06-03 02:34:54,2007-06-03 02:32:48
7be003b0261d13c99ed8d6764d20676a2b5c8347...aaa3ca747780f2fa0b6b8c182dc7d898dfe3ee63,1,1,0,1,1,2007-06-06 07:28:10,2007-06-05 13:26:12
aaa3ca747780f2fa0b6b8c182dc7d898dfe3ee63...d0f51a8b2ae25ad9a676d0214616241685e8f1d0,1,2,1,3,2,2007-06-06 07:28:24,2007-06-05 13:43:17
d0f51a8b2ae25ad9a676d0214616241685e8f1d0...ec563e8153cba89728a271a26c8a94e7a42d8152,1,2,2,4,2,2007-06-06 07:31:40,2007-06-05 16:40:41
ec563e8153cba89728a271a26c8a94e7a42d8152...e6ff0f42bb0c63515c8489c1992f37d1d1e8b2f4,2,67,44,111,16,2007-06-06 07:35:15,2007-06-05 20:06:53
e6ff0f42bb0c63515c8489c1992f37d1d1e8b2f4...2571ac67229370e9b27d19df29f529e7fd5f7502,1,1,1,2,1,2007-06-06 07:40:50,2007-06-06 04:24:19
2571ac67229370e9b27d19df29f529e7fd5f7502...11f68d908229d1e954009805cd139a89872b9208,2,53,30,83,12,2007-06-06 08:10:53,2007-06-06 08:10:14
98ee8187e4e331716be0797169ba9ddbb26efe56...d63bd9a217c0f9284e4195495dc0d078f5e6577e,4,133,30,163,24,2007-05-25 02:01:56,2007-05-24 22:15:36
d63bd9a217c0f9284e4195495dc0d078f5e6577e...56752391a8c0c591853b276e4fa0b45c34ced181,1,2,2,4,2,2007-05-25 02:05:39,2007-05-24 18:41:39
98ee8187e4e331716be0797169ba9ddbb26efe56...1568fea01eb25a293f8dae570a31ca34d41b5442,2,24,5,29,5,2007-05-24 05:38:44,2007-05-22 21:48:23
1568fea01eb25a293f8dae570a31ca34d41b5442...ee4931486b752b0a3ee04be31f25aed13913cb31,2,17,1,18,5,2007-05-24 05:38:44,2007-05-22 21:48:47
ee4931486b752b0a3ee04be31f25aed13913cb31...3427b375b594b93ed47ae80ca1d6bb361d7d8f5e,2,11,2,13,2,2007-05-24 05:38:44,2007-05-23 20:21:39
97925fde00743e557fa5e792004483a27e31fbd8...6442754d6cc0056cf5b69b43d218f8b6d317e7f5,1,2,0,2,2,2007-05-19 19:26:36,2007-05-19 09:58:37
6442754d6cc0056cf5b69b43d218f8b6d317e7f5...dc431666d3a54a84ac32b6007f020fb13062345b,1,5,0,5,1,2007-05-19 19:28:50,2007-05-19 10:59:02
97925fde00743e557fa5e792004483a27e31fbd8...cd50aba918c2d801602278db7b461a92a811b430,2,8,1,9,3,2007-05-19 04:57:19,2007-05-18 03:56:08
cd50aba918c2d801602278db7b461a92a811b430...93f9cc675d6ca9d9170f72def005ecffd9590e9c,1,45,49,94,11,2007-05-19 05:00:27,2007-05-18 04:51:42
93f9cc675d6ca9d9170f72def005ecffd9590e9c...8fae22250fab25bc59efe24e849a7e9f20e3386c,1,21,0,21,1,2007-05-19 05:00:45,2007-05-15 04:30:58
8fae22250fab25bc59efe24e849a7e9f20e3386c...187b0d80dfad2f51df580bffbbc1e7bc2103f6d4,1,16,0,16,1,2007-05-19 05:00:55,2007-05-19 04:37:25
187b0d80dfad2f51df580bffbbc1e7bc2103f6d4...2dc53617a43fda3df12e51e765fe4043935cfc22,1,69,2,71,2,2007-05-19 05:06:05,2007-05-16 00:31:40
db81e67a7d559544f8464cdfd011208e60b76344...8b0eca7c7b73d0dc5d49f400a878d9b781ec4bec,4,45,39,84,5,2007-05-02 17:24:18,2007-05-02 16:13:14
8b0eca7c7b73d0dc5d49f400a878d9b781ec4bec...cbc6bdab08af239b5a6477e7e6db16a766ec4986,1,2,32,34,2,2007-05-02 17:24:21,2007-05-02 16:14:15
cbc6bdab08af239b5a6477e7e6db16a766ec4986...b3431bc603df74cfe2da56e9a5c3f60327dd56b9,1,5,2,7,3,2007-05-02 17:24:23,2007-05-02 16:59:55
e3ad95a8be82663d27cb501eaf9bad86a30f9cda...cc1793e2cef20a06aed6d8987c3361e7fbd09305,1,13,19,32,10,2007-05-04 22:03:48,2007-05-04 07:03:22
cc1793e2cef20a06aed6d8987c3361e7fbd09305...171af11082d41f8e7a678e1e1a4ec6f610d01cf4,2,21,15,36,5,2007-05-04 22:08:31,2007-05-03 05:51:35
171af11082d41f8e7a678e1e1a4ec6f610d01cf4...71f4b1834a8b4d1cb24ea326ca4a3fcc02796a5a,2,4,4,8,2,2007-05-04 23:58:03,2007-05-04 18:27:10
71f4b1834a8b4d1cb24ea326ca4a3fcc02796a5a...3b559eab55693111e0922cd3dd41bfdba2e22989,1,22,0,22,1,2007-05-04 23:58:17,2007-05-04 22:48:35
3b559eab55693111e0922cd3dd41bfdba2e22989...e330a406cd20cf45a6816929155181c37678bc47,1,4,4,8,1,2007-05-06 04:09:34,2007-05-05 22:18:03
e330a406cd20cf45a6816929155181c37678bc47...dd166aa8e52dba39a3087b8012113af331d3110b,1,40,12,52,4,2007-05-06 05:40:13,2007-05-05 16:13:26
dd166aa8e52dba39a3087b8012113af331d3110b...c63777c0d7687a1edff2c0da307ad8ac1d75c8f6,1,13,2,15,3,2007-05-06 05:40:27,2007-05-06 04:18:57
c63777c0d7687a1edff2c0da307ad8ac1d75c8f6...c2a063691e1dcec137ed1f0def406d3bf3567e71,1,132,0,132,1,2007-05-06 05:40:39,2007-05-06 05:36:19
c2a063691e1dcec137ed1f0def406d3bf3567e71...cf593cc41828c6fc0a2cec50ddac0713ea8a07ec,1,1,1,2,1,2007-05-06 06:10:59,2007-05-05 18:23:12
cf593cc41828c6fc0a2cec50ddac0713ea8a07ec...e102d4353d7cfd69a597cd976eabdcb74641be69,1,3,1,4,1,2007-05-06 06:46:18,2007-05-04 21:51:32
6644d2f2c490f8a7081bd7e5da12c19400c8b6ef...50acc58914bf02217e55fdd739a844f2bfc45410,1,2,8,10,5,2007-05-03 07:03:15,2007-05-03 06:58:14
402fa75eed29c104ae5392ce88560f6bffc64ce7...a59b276e18f3d4a548caf549e05188cb1bd3a709,5,116,65,181,11,2007-04-16 23:51:09,2007-04-16 23:03:15
a59b276e18f3d4a548caf549e05188cb1bd3a709...ca135e7acc06f7d24ead732d2a1a531428da7135,3,61,2,63,10,2007-04-16 23:51:11,2007-04-16 23:05:10
ca135e7acc06f7d24ead732d2a1a531428da7135...f06a6a493a14ae632cdd3d04af04301769f4ef71,1,5,2,7,2,2007-04-16 23:51:47,2007-04-16 23:51:47
ad336054068074ed614d0bb54bb169e5263499d7...65b26eb4668f0499bc1e671edb59842529cb286d,1,1,1,2,1,2010-09-06 05:10:22,2010-09-05 12:56:11
65b26eb4668f0499bc1e671edb59842529cb286d...55b4e9e43227632dd372f916c08dca6e26118af5,1,4,4,8,1,2010-09-06 05:12:29,2010-09-05 19:36:33
55b4e9e43227632dd372f916c08dca6e26118af5...d2c030d4773f1f00165bffc34e2487043df326e7,1,9,9,18,2,2010-09-06 05:32:05,2010-09-06 05:32:05
ad336054068074ed614d0bb54bb169e5263499d7...2e3400c0521e4997601916790b8b2a9ff588c6f3,2,2,2,4,2,2010-09-04 05:13:08,2010-09-03 20:51:53
8165952517bf82b6a632cefc047ad14f36a74b25...580b7d36055492024c5381b9d4a7d9d766a6a2fa,1,1,1,2,1,2010-04-20 00:52:14,2010-04-19 09:52:30
580b7d36055492024c5381b9d4a7d9d766a6a2fa...3d8167677ddd71405906409994a72306ba993a1f,1,6,6,12,1,2010-04-20 01:05:00,2010-04-19 08:14:32
0b3dcfe721dc8734e2688f936afad055d8541d97...5856b5f568ba957a0ea094fa676641ab246021fc,1,11,7,18,3,2010-03-24 21:40:56,2010-03-22 14:22:04
0b3dcfe721dc8734e2688f936afad055d8541d97...44211e8c2ea48e1149cb36a02bd54f2d21c207f4,5,9,4,13,5,2010-03-24 21:33:54,2010-03-21 19:01:50
0b3dcfe721dc8734e2688f936afad055d8541d97...846b8f681a0a75cec2b930007c84e98346940459,1,3,0,3,1,2010-03-24 18:31:45,2010-03-22 20:45:33
0b3dcfe721dc8734e2688f936afad055d8541d97...7337b138bf47a8f7d8da400710014006386d31cc,1,1,1,2,1,2010-03-24 18:11:58,2010-03-22 13:36:30
0b3dcfe721dc8734e2688f936afad055d8541d97...4916c8f9535866210df6ec837ab910f3b8348784,2,10,8,18,4,2010-03-24 18:00:25,2010-03-22 18:07:52
b46946aae74361731ab229f13f0e0a3bf1a35bb7...511da22ecfb325bb693c0877e2a0d35fdba69a90,2,23,1,24,2,2010-03-03 07:11:36,2010-03-03 07:11:36
24c64d6add05f1f4d2e277af2d44c961910c98d3...fc1f458c3506ea3f76a328f10b4008c45af32c4b,1,8,3,11,3,2007-04-10 01:52:41,2007-04-09 11:24:02
fc1f458c3506ea3f76a328f10b4008c45af32c4b...8bd26c4a2f7539f6418934858710c674bb139cdd,1,16,0,16,3,2007-04-10 01:54:52,2007-04-09 20:57:36
35c636ec487d0d5c38e0ce8d3d7bc7ca42c6e5c1...8fced61cbc32f0c4b81a3dcecfeb40b7d96339ce,1,2,2,4,2,2006-07-03 07:58:34,2006-07-03 07:53:13
35c636ec487d0d5c38e0ce8d3d7bc7ca42c6e5c1...b1edc53d062c4f6adae08a15be08d6e7bccd242e,6,516,9,525,15,2006-07-03 00:14:40,2006-06-24 02:34:29
b1edc53d062c4f6adae08a15be08d6e7bccd242e...eca1f6fdb862e6ca07288ac385725c95fd96490e,2,26,1,27,4,2006-07-03 00:14:40,2006-06-24 02:34:31
eca1f6fdb862e6ca07288ac385725c95fd96490e...8062f81c2d9df5e6552bf267b258ffcc5f647f93,2,28,6,34,4,2006-07-03 00:14:40,2006-06-24 02:34:34
8062f81c2d9df5e6552bf267b258ffcc5f647f93...63df97ae7baeedc3ce04995139fa0f6bc5eea76c,3,27,2,29,4,2006-07-03 00:14:40,2006-06-24 02:34:36
63df97ae7baeedc3ce04995139fa0f6bc5eea76c...5c4082fd687bd0784d3a4d96550e8afab332b63a,2,831,0,831,3,2006-07-03 00:14:40,2006-06-24 02:34:40
5c4082fd687bd0784d3a4d96550e8afab332b63a...97b16c067492506287a6f474e79ef6cbe0a30e49,2,60,16,76,17,2006-07-03 00:14:40,2006-06-24 02:34:42
97b16c067492506287a6f474e79ef6cbe0a30e49...8b9150e3e3cc6bf78b21b2e01dcc5e3ed45597a4,2,183,22,205,22,2006-07-03 00:14:41,2006-06-24 02:34:44
8b9150e3e3cc6bf78b21b2e01dcc5e3ed45597a4...d79850e1fd22abd44e447214a64e5a774ada311e,1,53,23,76,15,2006-07-03 00:14:41,2006-06-24 02:34:47
d79850e1fd22abd44e447214a64e5a774ada311e...d43ba4680754c150124b6ac3cd9c6e52765c6881,1,35,2,37,8,2006-07-03 00:14:41,2006-06-24 02:34:49
d43ba4680754c150124b6ac3cd9c6e52765c6881...d5c7721d586225c46c675b893b7693220e28cfd5,1,129,28,157,14,2006-07-03 00:14:41,2006-06-24 02:34:51
d5c7721d586225c46c675b893b7693220e28cfd5...8f00660fc13df9ed22f059f032a65c60168a2057,1,21,24,45,14,2006-07-03 00:14:41,2006-06-24 02:34:53
8f00660fc13df9ed22f059f032a65c60168a2057...f6af75d29c7e01e1d538dc3458c743e1a34defb6,1,13,7,20,5,2006-07-03 00:14:41,2006-06-24 00:57:48
f6af75d29c7e01e1d538dc3458c743e1a34defb6...5e6ab8607e4ae53c0abb5b3027904f1e3f539969,1,2,0,2,1,2006-07-03 00:14:41,2006-06-24 00:56:11
5e6ab8607e4ae53c0abb5b3027904f1e3f539969...523bbaa4580a103b0994b5e3c71efcb1a8c6a7db,1,1,1,2,1,2006-07-03 00:14:42,2006-06-24 12:16:17
523bbaa4580a103b0994b5e3c71efcb1a8c6a7db...d595a473ee628d0f88989d06871d9752caafa7e9,3,20,13,33,13,2006-07-03 00:14:42,2006-06-25 01:35:12
d595a473ee628d0f88989d06871d9752caafa7e9...f6276fe159fe985af2d5831f4629ceefb33d082e,2,6,2,8,3,2006-07-03 00:14:42,2006-06-25 02:41:03
f6276fe159fe985af2d5831f4629ceefb33d082e...a6065b548fc74ce4d8a655e17bfb1dba39540464,1,57,11,68,3,2006-07-03 00:14:42,2006-06-25 01:54:23
a6065b548fc74ce4d8a655e17bfb1dba39540464...24c4b7143639cc821b6d06f9e125429e65dad8cd,2,6,6,12,5,2006-07-03 00:14:42,2006-06-25 01:54:26
24c4b7143639cc821b6d06f9e125429e65dad8cd...71efe0ca3c9c8bc8e7863e583cd2a808769c3bab,1,2,1,3,1,2006-07-03 00:14:42,2006-06-25 01:54:28
71efe0ca3c9c8bc8e7863e583cd2a808769c3bab...c2eeb4dcfece31a90f7de168092f4dfeaab96f95,1,1,1,2,1,2006-07-03 00:14:42,2006-06-26 08:27:54
c2eeb4dcfece31a90f7de168092f4dfeaab96f95...de86e131b538a021c14d53c6cc98bd7f0330dc92,1,1,1,2,1,2006-07-03 00:14:43,2006-06-26 22:21:07
de86e131b538a021c14d53c6cc98bd7f0330dc92...8d7f586f13f5aac31dca22b1d726e1583e180cb5,1,38,28,66,25,2006-07-03 00:14:43,2006-06-25 01:47:03
8d7f586f13f5aac31dca22b1d726e1583e180cb5...c9093fb38b48dcf09dbf1fb5cbf72e2b1f2c1258,1,4,2,6,2,2006-07-03 00:14:43,2006-06-26 22:23:08
c9093fb38b48dcf09dbf1fb5cbf72e2b1f2c1258...f1b8fd4abae7910d9227ae019220944e8fac6884,2,2,2,4,2,2006-07-03 00:14:43,2006-06-28 10:17:07
f1b8fd4abae7910d9227ae019220944e8fac6884...c35ebc902fd5c48c978d0d4cfab52ccdb4b11f54,1,3,0,3,1,2006-07-03 00:14:43,2006-06-29 05:08:54
c35ebc902fd5c48c978d0d4cfab52ccdb4b11f54...893973a6f271429fbe1973d61dc8e1d76753327e,2,2,2,4,2,2006-07-03 00:14:43,2006-06-30 00:02:21
893973a6f271429fbe1973d61dc8e1d76753327e...3553309f5ba7f9fed61ac2767d53677c309826b2,1,1,0,1,1,2006-07-03 00:14:44,2006-06-30 07:43:43
3553309f5ba7f9fed61ac2767d53677c309826b2...1d8c9dc47de0cbf3955ccc9408564cccbda8e348,2,2,2,4,2,2006-07-03 00:14:44,2006-06-30 05:09:23
1d8c9dc47de0cbf3955ccc9408564cccbda8e348...1434dbce02aaa96ae5d0a1f4f000cce5727498fa,1,2,0,2,1,2006-07-03 00:14:44,2006-06-30 05:09:26
1434dbce02aaa96ae5d0a1f4f000cce5727498fa...b9795608c4d82ba119d78980b479d78bdfe753b6,1,19,2,21,6,2006-07-03 00:14:44,2006-06-30 05:09:28
b9795608c4d82ba119d78980b479d78bdfe753b6...e6634ac9841f8df3ce1c0c461c677faf2d59af3e,2,38,32,70,4,2006-07-03 00:14:44,2006-07-01 23:38:56
e6634ac9841f8df3ce1c0c461c677faf2d59af3e...e2a38710941775761298d0bd7e6be2e7039fcd3d,2,5,7,12,3,2006-07-03 00:14:44,2006-07-01 23:48:32
e2a38710941775761298d0bd7e6be2e7039fcd3d...d78f099d8956947576cd5ccc1c5c13f94075b476,1,3,3,6,3,2006-07-03 00:14:44,2006-07-02 09:53:03
d78f099d8956947576cd5ccc1c5c13f94075b476...65a4e98a22eab9317a05d1485c7c5a9c5befd589,1,0,4,4,2,2006-07-03 00:14:45,2006-07-02 20:57:17
65a4e98a22eab9317a05d1485c7c5a9c5befd589...d3140f5c2a6b42361bca960f627b00264d5c7372,3,12,3,15,4,2006-07-03 00:15:31,2006-07-02 23:49:12
d3140f5c2a6b42361bca960f627b00264d5c7372...3c767a08243244b18d48315f8433ba07e435f654,1,13,0,13,1,2006-07-03 08:09:03,2006-07-03 06:54:47
3c767a08243244b18d48315f8433ba07e435f654...6fcca938b05c33bcd8b502d6b6f178e377609fa3,5,7,16,23,5,2006-07-04 01:34:53,2006-07-03 21:16:32
6fcca938b05c33bcd8b502d6b6f178e377609fa3...dc2613de8633cecb1c0759657eadf6a637cebfa5,3,39,3,42,4,2006-07-04 01:35:19,2006-07-03 20:47:55
dc2613de8633cecb1c0759657eadf6a637cebfa5...3cb8caf7294bf8909b924ab63ca7d8f90917e677,1,8,22,30,7,2006-07-04 01:35:21,2006-07-03 20:47:58
3cb8caf7294bf8909b924ab63ca7d8f90917e677...c7a30e56840b089c1d110b312475f692b5c1b6a4,2,51,9,60,2,2006-07-04 01:35:23,2006-07-03 20:48:01
c7a30e56840b089c1d110b312475f692b5c1b6a4...998c4daaf4a921fb03d478b50d6e06223326d7ef,1,7,3,10,1,2006-07-08 21:15:09,2006-07-07 20:04:35
998c4daaf4a921fb03d478b50d6e06223326d7ef...0270083ded143fd49841e3d3d0cac5eb06081d2a,7,114,24,138,35,2006-07-09 08:20:01,2006-07-03 20:48:03
0270083ded143fd49841e3d3d0cac5eb06081d2a...3c479c37f8651d09e1d08b8d6ea9757164ee1235,2,42,0,42,2,2006-07-09 08:20:01,2006-07-03 20:48:05
3c479c37f8651d09e1d08b8d6ea9757164ee1235...7fb39d5f58efd05e982fe148630edc97ded753b6,1,31,136,167,19,2006-07-09 08:20:01,2006-07-03 20:48:07
7fb39d5f58efd05e982fe148630edc97ded753b6...96bc4de85cf810db5c7cd94bf0688a98a64a0bc7,1,10,4,14,4,2006-07-26 04:13:30,2006-07-26 01:03:58
24cf6e5847073d50390e0b7950e8e6b5a09103bc...5209eda86363a3ba2e000903ad8de29589b18b58,1,7,2,9,3,2006-07-26 21:29:40,2006-07-26 21:11:46
24cf6e5847073d50390e0b7950e8e6b5a09103bc...8fd2cb4069178539d8cf7711586d4e6378722bf3,4,172,45,217,28,2006-07-26 20:36:36,2006-07-26 04:32:18
8fd2cb4069178539d8cf7711586d4e6378722bf3...11be42a47632a6f7219d34f5e312aa20ae076142,8,269,295,564,13,2006-07-26 20:36:36,2006-07-26 01:52:35
11be42a47632a6f7219d34f5e312aa20ae076142...ac64a722072bb348476a8a029de9a82073e07fba,2,86,5,91,11,2006-07-26 20:36:36,2006-07-26 17:47:54
88f0d5d7d95f815d2e8a36a8ceb7459dbd90992c...addf88e455f85bc6cfe0284b70aaad10b6d3486e,21,34,34,68,33,2006-07-09 09:42:41,2006-07-09 07:44:30
addf88e455f85bc6cfe0284b70aaad10b6d3486e...cfc01c038709e4cdbf506d29937cac2bc1b76d39,2,10,10,20,7,2006-07-09 10:26:49,2006-07-09 09:59:39
cfc01c038709e4cdbf506d29937cac2bc1b76d39...85fb65ed6e41e93760a91b33b512d3d9dc67ac66,4,11,1,12,5,2006-07-09 10:27:03,2006-06-06 23:58:40
85fb65ed6e41e93760a91b33b512d3d9dc67ac66...3e564f3a6c3a49d1f8f0e5f5b34f3df19338fefa,1,1,1,2,1,2006-07-09 10:29:35,2006-07-09 09:36:23
3e564f3a6c3a49d1f8f0e5f5b34f3df19338fefa...ff4c848527137b5ca52dfe97c25fcc8bcc4b8726,2,7,7,14,7,2006-07-09 10:31:36,2006-07-09 09:36:24
88f0d5d7d95f815d2e8a36a8ceb7459dbd90992c...575ba9d69d5dfd07d95343fe946a5991c4cb27d6,5,69,0,69,9,2006-07-09 07:57:23,2006-06-25 13:56:18
575ba9d69d5dfd07d95343fe946a5991c4cb27d6...e82e058d3ad1d50fbb99fac8630ad7b511ca4abe,1,1,1,2,2,2006-07-09 07:57:23,2006-06-28 09:15:00
e82e058d3ad1d50fbb99fac8630ad7b511ca4abe...1d0361e806086f6076c221ff5bb40b73643e96c3,1,1,0,1,1,2006-07-13 06:09:00,2006-07-13 06:09:00
88f0d5d7d95f815d2e8a36a8ceb7459dbd90992c...ba84a797e76c27932e0b317c7ce54925e81093f7,5,266,48,314,7,2006-07-09 07:57:22,2006-07-06 17:16:22
88f0d5d7d95f815d2e8a36a8ceb7459dbd90992c...25b7c18ecd9779158cb1c02572396bab22c6e0cf,1,1,0,1,1,2006-07-09 07:57:22,2006-07-07 06:39:30
88f0d5d7d95f815d2e8a36a8ceb7459dbd90992c...6ece0d3030ae2dc5b49fcfcc83df4966a52e0d0b,1,10,10,20,9,2006-07-09 07:57:09,2006-07-06 00:41:39
6ece0d3030ae2dc5b49fcfcc83df4966a52e0d0b...b1e9fff7e76c13cc16f0b4a4eda19600320bd7e7,1,41,52,93,22,2006-07-09 07:57:09,2006-07-06 01:00:02
868227b0d1f3a295ea9afe7a3be3a1fbdff62442...f443455a5bb1f274dc7a14f09bbbcb931f4388a2,1,6,0,6,2,2006-07-10 20:48:22,2006-07-10 17:57:21
f443455a5bb1f274dc7a14f09bbbcb931f4388a2...b75a82b75402c9462cfd2e9891d2fbe7ce6239f4,2,1,2,3,2,2006-07-10 21:48:56,2006-07-10 11:40:44
b75a82b75402c9462cfd2e9891d2fbe7ce6239f4...0b0fe4a65d24d7c17d72706e5cd179ecc7134721,2,1,1,2,2,2006-07-11 04:12:40,2006-07-11 00:27:54
0b0fe4a65d24d7c17d72706e5cd179ecc7134721...a3a733e63bb8dfbd6921b8f405d652db1821d4fd,2,21,4,25,9,2006-07-11 04:21:16,2006-07-11 02:48:47
a3a733e63bb8dfbd6921b8f405d652db1821d4fd...55b7835e1b81a6debc7648149d2b8a4c5c64ddba,2,16,6,22,11,2006-07-11 04:21:27,2006-07-11 03:38:35
55b7835e1b81a6debc7648149d2b8a4c5c64ddba...8ff99e7417fcbff67d2c31445671fa97e44c95e7,4,5,3,8,5,2006-07-11 19:32:54,2006-07-11 19:01:54
8ff99e7417fcbff67d2c31445671fa97e44c95e7...c3f17061be95de3498449a548e93883aebff23d6,1,3,3,6,1,2006-07-11 19:39:09,2006-07-11 21:02:00
c3f17061be95de3498449a548e93883aebff23d6...2a75848edd49b1c4e26ac58df40b989e7dad33e3,1,1,1,2,1,2006-07-11 19:45:20,2006-07-11 10:19:33
2a75848edd49b1c4e26ac58df40b989e7dad33e3...d2216f231782b37c6379a533d4d845534651e93b,1,0,1,1,1,2006-07-11 19:48:18,2006-07-11 10:19:37
d2216f231782b37c6379a533d4d845534651e93b...38d3874ddc5c15120c7fbbdcad26bf5478f58e98,2,2,4,6,3,2006-07-11 19:58:53,2006-07-11 17:10:29
38d3874ddc5c15120c7fbbdcad26bf5478f58e98...ed0e078f96a96ffe515899ef42051a568be4693a,1,1,1,2,1,2006-07-11 21:14:09,2006-07-11 21:06:39
d507bb15008d6ee657eebaf2803bf0964af12c93...b68ea12e305043a7feef085b6ba098f42357af9b,2,19,0,19,5,2006-07-07 19:28:53,2006-07-07 11:01:23
b68ea12e305043a7feef085b6ba098f42357af9b...fef88bb0134dfd47b4bd17e668bbb860588dcb39,1,2,0,2,1,2006-07-07 19:28:54,2006-07-07 12:27:24
fef88bb0134dfd47b4bd17e668bbb860588dcb39...b53766483ff14f73be954617349b18ea56c3187a,2,38,4,42,7,2006-07-07 19:28:54,2006-07-07 12:28:05
b53766483ff14f73be954617349b18ea56c3187a...83ad63cfebdf652ff7c7b255d700d8b12c756913,8,17,11,28,11,2006-07-08 10:11:01,2006-07-08 08:05:16
83ad63cfebdf652ff7c7b255d700d8b12c756913...3a895e0268537da731f5efe914ece5e7eac35ef3,1,2,2,4,2,2006-07-08 10:11:16,2006-07-08 08:50:02
4b7ce6e2d6ba088da50de1df38b040ea2c0b8f18...dd4c59121ff8277d49a64a8f105936878a9fd7af,1,1,1,2,1,2006-07-14 18:31:50,2006-07-14 18:31:50
dd4c59121ff8277d49a64a8f105936878a9fd7af...d5b9e6cfa7a20932ca17649c9172619c9d961db4,1,5,6,11,2,2006-07-14 18:32:39,2006-07-14 16:37:06
d5b9e6cfa7a20932ca17649c9172619c9d961db4...7eae7b993ec3c1f5dfeb78d79673627b48d5f772,1,1,1,2,1,2006-07-14 18:33:14,2006-07-14 15:06:57
4b7ce6e2d6ba088da50de1df38b040ea2c0b8f18...93821bd97aa516b3b557fc5d1b32fd3431536e44,5,111,8,119,14,2006-07-14 06:11:56,2006-07-11 19:48:08
4b7ce6e2d6ba088da50de1df38b040ea2c0b8f18...57a39690b936c003662b6710241732b980e58790,2,11,4,15,5,2006-07-14 06:10:21,2006-07-10 10:34:34
4b7ce6e2d6ba088da50de1df38b040ea2c0b8f18...6d297f81373e19d86b8f02cb68120201d1b0ab1d,10,1773,52,1825,39,2006-07-14 06:10:19,2006-07-08 16:42:41
6d297f81373e19d86b8f02cb68120201d1b0ab1d...06d30f4f3eea71bce4cf48db3ea384976b3983b7,4,36,12,48,8,2006-07-14 06:10:19,2006-07-09 07:42:26
232475d38231552f04f2e4221936700a923a531e...36a7cad6e4ae8a331731666d985a7619a76bb4fb,1,31,65,96,6,2005-11-19 07:54:17,2005-11-19 07:54:17
36a7cad6e4ae8a331731666d985a7619a76bb4fb...e246483dc5b56d7deb04a93b0aa08aba4cde0625,1,1,1,2,1,2005-11-19 07:55:50,2005-10-30 09:06:46
e246483dc5b56d7deb04a93b0aa08aba4cde0625...fd913b39101c6ff185e76e459479621c9b475fa1,1,2,4,6,3,2005-11-19 08:00:37,2005-11-11 15:09:12
fd913b39101c6ff185e76e459479621c9b475fa1...e3fe532ddce7311cfbbdc98d2e157d33f6275231,1,3,1,4,2,2005-11-19 08:24:40,2005-11-05 19:55:29
e3fe532ddce7311cfbbdc98d2e157d33f6275231...f6e2869f48f7a9b51a2a867ce955c39a9314ef3b,1,12,11,23,3,2005-11-20 12:08:22,2005-11-20 12:08:22
3cc35e29ec252d0dca1139106fbaa70cb9ad6ef1...edde7a8b5324d88f07fcb8204da313c19b4988fa,3,4,3,7,4,2005-09-27 07:16:39,2005-09-24 19:50:29
edde7a8b5324d88f07fcb8204da313c19b4988fa...5da1606d0bf5b970fadfa0ca91618a1e871f6755,4,10,7,17,5,2005-09-27 07:16:39,2005-09-26 20:54:01
5da1606d0bf5b970fadfa0ca91618a1e871f6755...820eca68c2577d7499d203d7f4f7ae479b577683,5,13,1,14,6,2005-09-27 07:16:40,2005-09-27 01:38:08
820eca68c2577d7499d203d7f4f7ae479b577683...1ddea77e449ef28d8a7c74521af21121ab01abc0,1,16,8,24,11,2005-09-27 07:19:18,2005-09-26 17:52:11
1ddea77e449ef28d8a7c74521af21121ab01abc0...ee1bec3d1001ce3d84b72be4a72694c1aef37980,1,41,13,54,8,2005-09-27 23:59:44,2005-09-27 01:13:08
ee1bec3d1001ce3d84b72be4a72694c1aef37980...1f7f99de841f533b99b80420bbaf44a808ea5b84,1,10,1,11,3,2005-09-27 23:59:45,2005-09-27 01:13:32
1f7f99de841f533b99b80420bbaf44a808ea5b84...148ccbb0384829ab051d6d789b8adf761adf7817,1,2,2,4,2,2005-09-27 23:59:45,2005-09-27 01:13:53
5da22bc14b6a8329c181067ad8a8b383dab512fc...d3968363b43b3d6badd662869e13fa3aa34c5b41,1,593,0,593,1,2005-08-30 22:30:30,2005-08-30 09:56:52
d3968363b43b3d6badd662869e13fa3aa34c5b41...076b2324cdca9a2825c569cf9ec02d219c237e26,1,2,0,2,1,2005-08-31 02:19:02,2005-08-30 23:59:37
076b2324cdca9a2825c569cf9ec02d219c237e26...914328ac02d3699407fe1df6b45ef4b7e8eff23a,1,370,291,661,186,2005-08-31 06:08:06,2005-08-31 06:08:06
1dfcfbce2d643b7c7b56dc828f36ced9de2bf9f2...5be4efbefafcd5b81fe3d97e8395da1887b4902a,1,165,36,201,28,2005-08-21 20:41:28,2005-08-21 19:55:33
f26f72de159d7ade2fbe8b48734ce98c1aba4d72...d95bfb12b87a0be9666f806683e198df9738d0e7,4,21,1,22,6,2014-02-24 22:50:56,2013-11-04 23:14:41
d95bfb12b87a0be9666f806683e198df9738d0e7...55ca3f99ae4895605a348322dd2fc50f2065f508,3,14,0,14,4,2014-02-24 22:51:35,2013-12-13 23:40:35
55ca3f99ae4895605a348322dd2fc50f2065f508...4b8d14b4c5d73dd4adb354d9689022d1b87828d5,1,21,4,25,5,2014-02-24 22:51:35,2013-12-16 13:55:04
f26f72de159d7ade2fbe8b48734ce98c1aba4d72...1ba98a79f1b991e6f2b1d01ac392ba2edadc3ca1,2,25,8,33,2,2013-11-25 21:16:19,2013-11-23 16:07:55
f26f72de159d7ade2fbe8b48734ce98c1aba4d72...3651e45c341fc40302b7c21bf1e60a5b038439d3,1,53,27,80,5,2013-11-06 20:11:30,2013-11-05 02:07:29
2150cc99fe29fd81db1e9c5971e13bcb78373ebf...d9ac9df41c8c1c3a2f5b0fb1bcc0546dc1bafba2,1,8,5,13,3,2005-08-16 00:44:16,2005-08-16 00:20:34
d9ac9df41c8c1c3a2f5b0fb1bcc0546dc1bafba2...8c5989029215227230cccc9b5da54e798e2f2029,1,1,1,2,1,2005-08-16 18:59:09,2005-08-16 18:28:02
8c5989029215227230cccc9b5da54e798e2f2029...8b8840e046923f34d6b3e76adc44106f9e63ab4c,1,23,11,34,6,2005-08-16 19:09:33,2005-08-15 09:28:19
8b8840e046923f34d6b3e76adc44106f9e63ab4c...b0921331030d52febf52839753eee1b2b9ca1f24,2,10,3,13,5,2005-08-16 19:09:33,2005-08-15 18:18:25
b0921331030d52febf52839753eee1b2b9ca1f24...c508df5edfe12b9df7dfea4d438c1dab2812b3e9,2,10,2,12,4,2005-08-16 19:09:33,2005-08-16 04:10:03
c508df5edfe12b9df7dfea4d438c1dab2812b3e9...08b1161697996b5478f726541c0d8a457abcc439,1,91,21,112,13,2005-08-16 19:09:33,2005-08-16 04:10:32
08b1161697996b5478f726541c0d8a457abcc439...d920032042c9fb3de04db640afe8611dfd4b6c21,1,7,5,12,3,2005-08-16 19:09:33,2005-08-16 05:48:09
d920032042c9fb3de04db640afe8611dfd4b6c21...abe0582207c72ec848e78707577c61a98f5c633d,2,13,6,19,6,2005-08-16 19:09:33,2005-08-16 05:39:29
283097e9ed751b866c9d405d17c21a10bfb9465f...62bc83349d52be49b037d2c800a7f4064cfbc5b5,1,24,0,24,1,2012-04-27 21:12:56,2012-04-27 21:12:56
140011d8f2d17b050942e8a4bb33ecbd6827df2e...1a002c73ba63799dda75a4c28da5b562eea7a3ff,2,33,1,34,2,2012-09-24 19:50:00,2012-09-24 19:50:00
45c58ba00a9c4e31e94997b59fd8112f962fa222...d3d7d47e6e0c3077fa39ffcca2b7f5f48ea97812,2,15,0,15,2,2009-09-13 08:28:07,2009-09-13 00:33:23
d3d7d47e6e0c3077fa39ffcca2b7f5f48ea97812...7fb6bcff2dece2ff9fbc5ebfe526d9b2a7e764c4,4,33,3,36,5,2009-09-13 08:28:13,2009-09-13 08:04:23
5a3669340b3c81fd25a10f02f44ecd27cc100fd2...67e56eca34e38545bc4fb673e0f13f3e97dc474c,2,0,0,0,0,2009-08-15 02:49:31,2009-08-10 12:09:00
67e56eca34e38545bc4fb673e0f13f3e97dc474c...b2139dbd72d16e40eddfd5b9ad1314703b39fe65,1,38,1,39,2,2009-08-15 02:49:35,2009-08-14 06:58:31
e532e7b08f3de1a590db909c2c93532c2a39e9ae...e89df7dcda9836518a68cce27231625f90d94749,1,1,1,2,1,2009-08-12 23:15:47,2009-08-11 13:03:10
e89df7dcda9836518a68cce27231625f90d94749...07436e43daf1a97d3d702090d6289f745bd5ad90,4,103,5,108,10,2009-08-12 23:15:47,2009-08-08 07:51:08
7ecc9b153c89aeec7470256f7b121fd845101b57...6c4f3ec9b477df534cd376f88618a57353f0f0fe,2,40,17,57,15,2009-08-08 03:45:31,2009-08-07 22:45:30
1d2a7e0c589e8c1328ebabd64f74d26357d431b2...21d0bc2f9a5bcbee2593e9f2ad05d64d3dcf3a0e,3,11,11,22,11,2009-08-26 19:05:57,2009-08-26 08:38:50
21d0bc2f9a5bcbee2593e9f2ad05d64d3dcf3a0e...8d9518439595c9d2c601e841a6792d9ee30f9293,1,2,1,3,1,2009-08-26 19:05:58,2009-08-26 14:04:54
8d9518439595c9d2c601e841a6792d9ee30f9293...d8526a4c3b31d91b623f698be6ed7552ed4fdc52,9,65,10,75,13,2009-08-26 19:05:58,2009-08-15 14:23:12
648f40701764cc3b47f2d2978518852e2aeb42cf...68b890a8d5aab897f392928105596de85cc9135e,3,66,2,68,3,2009-12-26 22:11:46,2009-12-26 22:11:46
07a4a3b4962e1fd4e40fd877427cddd7428c1bc3...c7e4f0d78aaac33d5e3cec54cddd40439e77d16c,2,13,3,16,5,2009-08-05 19:13:56,2009-08-05 03:31:56
c7e4f0d78aaac33d5e3cec54cddd40439e77d16c...c8f373a5ce8be2b85da25f1e3b1ef9056ecca4a6,2,9,19,28,12,2009-08-05 19:13:57,2009-08-05 03:31:57
c8f373a5ce8be2b85da25f1e3b1ef9056ecca4a6...6a2d3f50f5a509fdfefca371c7178e36c0bcf7e9,2,0,19,19,2,2009-08-05 19:13:58,2009-08-05 03:31:58
6a2d3f50f5a509fdfefca371c7178e36c0bcf7e9...c2ca1d79dbd54b06a05e5d14a897699e59dc9f9f,3,40,3,43,7,2009-08-05 19:14:00,2009-08-05 03:31:59
07a4a3b4962e1fd4e40fd877427cddd7428c1bc3...86c91f91794cd6af8e19fbe68ab283d567d2b66f,11,389,10,399,31,2009-08-05 18:59:56,2009-08-04 11:16:49
07a4a3b4962e1fd4e40fd877427cddd7428c1bc3...6eb996b5707b6d14cf9875a9231f4e909a443665,4,243,0,243,4,2009-08-05 17:34:01,2009-08-05 05:01:53
6eb996b5707b6d14cf9875a9231f4e909a443665...a2d725b7bdf756ade7680945ebc3fb62e5dd8bcc,3,145,135,280,9,2009-08-05 17:34:09,2009-08-05 05:01:56
a2d725b7bdf756ade7680945ebc3fb62e5dd8bcc...1088261f6fc90324014b5306cca4171987da85ce,4,11,9,20,9,2009-08-06 01:37:12,2009-08-05 05:01:59
07a4a3b4962e1fd4e40fd877427cddd7428c1bc3...29796c6ccff3e70622398379fdcdfa3fe43333ac,2,33,2,35,2,2009-08-05 09:21:11,2009-08-04 23:25:40
29796c6ccff3e70622398379fdcdfa3fe43333ac...26da1d78674204c482ec90905dd4de3f6bcd3c5f,1,0,18,18,2,2009-08-05 09:21:11,2009-08-05 05:08:16
26da1d78674204c482ec90905dd4de3f6bcd3c5f...50b7e70f338e54f3534ee1b14c3bdb4c80d0dcf7,3,199,50,249,32,2009-08-06 15:36:53,2009-08-05 06:49:33
50b7e70f338e54f3534ee1b14c3bdb4c80d0dcf7...4d4d5726aee31522e90df21ef62ee3377c5d8f8d,3,120,3,123,14,2009-08-07 04:16:01,2009-08-05 07:04:51
4d4d5726aee31522e90df21ef62ee3377c5d8f8d...3a5d13a3c32e0f39d8fc83330255fac27af5d853,2,22,14,36,12,2009-08-08 06:03:36,2009-08-08 06:03:36
3a5d13a3c32e0f39d8fc83330255fac27af5d853...d249b098893809c6de6e5e20063a22ac2c629ce7,3,93,84,177,63,2009-08-10 19:50:30,2009-08-10 04:59:30
d249b098893809c6de6e5e20063a22ac2c629ce7...23900a964608bbfda6989a0a2cd4342f19f9194c,2,8,5,13,8,2009-08-10 19:54:07,2009-08-10 06:08:40
23900a964608bbfda6989a0a2cd4342f19f9194c...f766b36783c7ceeb0427f5e1af862b9a67ae1c4c,3,60,61,121,4,2009-08-10 19:56:36,2009-08-10 06:12:19
f766b36783c7ceeb0427f5e1af862b9a67ae1c4c...7637868362ab64fe22521c645006ba70c4ef83a9,2,38,23,61,12,2009-08-10 19:56:43,2009-08-10 07:36:33
7637868362ab64fe22521c645006ba70c4ef83a9...60c2993c92fa1aa7f4d4aab7de6d8769052ced6f,1,9,4,13,4,2009-08-15 08:58:37,2009-08-15 08:58:37
60c2993c92fa1aa7f4d4aab7de6d8769052ced6f...3fa509dfbdb8526453f4213f79b371bdfa493f0e,1,4,2,6,2,2009-08-15 09:33:21,2009-08-15 09:14:14
07a4a3b4962e1fd4e40fd877427cddd7428c1bc3...6639ffc2e026b34b906854b8c60bd72d4b95e78d,1,140,7,147,3,2009-08-04 05:42:14,2009-08-04 04:13:21
6639ffc2e026b34b906854b8c60bd72d4b95e78d...b7da721f02638083cc3debfd9ae7221d76a96b26,1,7,4,11,1,2009-08-04 07:26:03,2009-07-31 06:48:49
b7da721f02638083cc3debfd9ae7221d76a96b26...30ca4ca7b25082574d93b3a6d46a966d39de0488,1,12,0,12,1,2009-08-05 17:26:41,2009-08-05 07:59:18
30ca4ca7b25082574d93b3a6d46a966d39de0488...995bdc73fe0e28d622af0897440f0ea298345585,4,9,7,16,7,2009-08-05 17:28:05,2009-08-05 07:59:19
995bdc73fe0e28d622af0897440f0ea298345585...f621a8454d19d17fe46e6951b7e3d22bebd92aba,4,16,4,20,4,2009-08-05 17:29:37,2009-08-05 07:59:20
1ab012cf811abba5745fa0da70db963decd65f21...6651c3f706cc47d8055ab43f9f7907202d10655d,1,1,1,2,1,2009-06-23 23:57:15,2009-06-22 16:42:33
c14417c4f5f8d7765e232f1e908b85d2ae14ec34...b932705b457ad191481a871292d71088bb23d244,1,102,67,169,13,2009-08-10 21:25:20,2009-07-29 23:13:46
c14417c4f5f8d7765e232f1e908b85d2ae14ec34...4ebe6e92c3b62d5192b6cc8158fde701bf2c0dcb,1,11,3,14,3,2009-08-10 08:29:40,2009-08-04 01:40:37
4ebe6e92c3b62d5192b6cc8158fde701bf2c0dcb...63de84ad60984105b1cd60fb888968b352539313,1,2,1,3,1,2009-08-10 08:29:40,2009-08-04 01:40:38
63de84ad60984105b1cd60fb888968b352539313...a7d72544b112f093b6189a86d05b198b2be73828,2,6,1,7,4,2009-08-10 09:35:55,2009-08-07 19:21:21
c14417c4f5f8d7765e232f1e908b85d2ae14ec34...f5f1e164bd4234683e5a1fc4a49a77b1b01855f8,1,16,1,17,2,2009-08-10 01:33:41,2009-08-09 00:47:36
efd17968387482f5765a969813707629b85bf74f...19a7fcbf16276321f83e0c1748b3935a2ea42675,2,24,5,29,2,2009-08-12 22:50:09,2009-08-12 03:27:40
efd17968387482f5765a969813707629b85bf74f...540e694b139dd034b21de087001ac9b6d7606c94,2,35,2,37,4,2009-08-12 06:17:55,2009-08-11 15:43:59
30ae47b4cc19dce42f51b4fa378d315a71b08957...5f6a11259ab0045a9f79bd789393de7a77e3c5d6,1,3,3,6,3,2012-07-23 04:11:35,2012-07-22 23:39:54
5f6a11259ab0045a9f79bd789393de7a77e3c5d6...23119ffb4ea91cdf30016254df60e1adc64b478c,1,2,2,4,1,2012-07-23 04:13:53,2012-07-22 23:40:54
23119ffb4ea91cdf30016254df60e1adc64b478c...f200197c39d9181c02cac06c26433edaa9d31219,1,2,3,5,1,2012-07-23 16:41:29,2012-07-23 06:29:14
64d5fe0a23e3a16179c7c185662f25d85fe631dd...33e7018c459e6583b899690cabd21c808ffd3c85,9,65,10,75,13,2009-08-18 20:14:17,2009-08-15 14:23:12
64d5fe0a23e3a16179c7c185662f25d85fe631dd...1e7f2aad7dd9b0b5ec8bbae2e3015915687e2cd2,2,3,1,4,2,2009-08-18 19:27:57,2009-08-16 01:10:08
1e7f2aad7dd9b0b5ec8bbae2e3015915687e2cd2...1d5bec8b9cee65b1f98a118ba79120ea686252e3,1,25,3,28,2,2009-08-19 05:50:30,2009-08-19 01:45:19
1d5bec8b9cee65b1f98a118ba79120ea686252e3...d69ecf6f0ed2c1a31875a3f642deef0358ac9377,1,79,0,79,1,2009-08-19 05:50:40,2009-08-19 01:45:20
d69ecf6f0ed2c1a31875a3f642deef0358ac9377...9aec7e0ba69334cf9bfc6bca6abbea7e84d676b2,1,3,3,6,3,2009-08-19 05:51:31,2009-08-19 01:45:21
9aec7e0ba69334cf9bfc6bca6abbea7e84d676b2...15fc56a853648c60697df691c5cd8a11ad718611,3,124,4,128,9,2009-08-19 05:57:37,2009-08-19 01:45:22
15fc56a853648c60697df691c5cd8a11ad718611...b13fd5c1a2bd450cdf7b853e0c4861f361882a18,3,36,3,39,8,2009-08-19 05:59:12,2009-08-19 01:45:23
b13fd5c1a2bd450cdf7b853e0c4861f361882a18...64b19ffeddda499e7380b38b43a3dee579734905,3,51,6,57,11,2009-08-19 05:59:58,2009-08-19 01:45:24
64b19ffeddda499e7380b38b43a3dee579734905...e3ae4a8613151c93ffce78c674ac91c1ee34eef6,1,4,2,6,2,2009-08-20 23:59:45,2009-08-20 09:24:54
e3ae4a8613151c93ffce78c674ac91c1ee34eef6...e7fed18a89fae97655687e19f13cd802d8d70845,3,31,2,33,7,2009-08-20 23:59:50,2009-08-19 23:07:43
d1672d90bae20d33512fbf8f9b8330e5840da0c5...f476c0b7b30b26157b4a12b565a08a3c015edf6d,1,1,15,16,3,2010-02-10 21:47:46,2010-02-10 21:47:46
f476c0b7b30b26157b4a12b565a08a3c015edf6d...c8089af6c6754153d75de74d0f147adcd46a6b59,2,5,3,8,4,2010-02-12 06:10:00,2010-02-11 22:27:14
f8db7884286232274c8e7c7d82a35a2478b097d3...61c3f9086a733124258168f5c8e7437e3c56f3c3,2,10,2,12,4,2007-07-12 21:54:33,2007-07-12 21:54:33
61c3f9086a733124258168f5c8e7437e3c56f3c3...7d7baa5e15b9ad6768d782d9bae5badc4e51d4ea,1,1,0,1,1,2007-07-13 03:11:41,2007-07-13 02:27:12
7d7baa5e15b9ad6768d782d9bae5badc4e51d4ea...dbddb714b0e69ef15fba64e74f34244ab95f0610,3,21,0,21,3,2007-07-13 03:20:49,2007-07-12 23:54:06
dbddb714b0e69ef15fba64e74f34244ab95f0610...fd0368f985c2d6179d76cdf3569b0798d42f9196,2,2,1,3,2,2007-07-13 03:22:06,2007-07-12 23:54:07
fd0368f985c2d6179d76cdf3569b0798d42f9196...af83bed6903256c581f081ba7bba372f19804b30,1,14,1,15,2,2007-07-13 03:22:07,2007-07-12 23:54:08
af83bed6903256c581f081ba7bba372f19804b30...b06c6bc831cbb9e9eb82fd3ffd5a2b674cd940d0,1,1,0,1,1,2007-07-13 05:48:54,2007-07-13 04:17:49
b06c6bc831cbb9e9eb82fd3ffd5a2b674cd940d0...689b4d552b8108d2c92c63258990ecd2bc791739,1,1,1,2,1,2007-07-13 15:54:06,2007-07-13 15:54:06
689b4d552b8108d2c92c63258990ecd2bc791739...9a4cbdca34f6aa9424fce8a55fe9dd6f7c25d97b,1,4,4,8,2,2007-07-13 15:55:15,2007-07-13 14:14:50
9a4cbdca34f6aa9424fce8a55fe9dd6f7c25d97b...793ad04198a79c14094bd1311a9c42f1293c6183,1,3,2,5,3,2007-07-14 05:33:16,2007-07-12 22:30:35
6fb73e442a7dc3e4b296b409a6f30145d85750e9...c4fba0a358d43fdb2301dd122d68c49dd8471d71,4,20,9,29,12,2007-07-19 00:30:03,2007-07-18 18:31:03
c4fba0a358d43fdb2301dd122d68c49dd8471d71...a7738c77f1f17ced885ce96e986b948a0b256452,1,3,1,4,1,2007-07-20 07:01:26,2007-07-19 10:43:51
a7738c77f1f17ced885ce96e986b948a0b256452...ef0c2abf3e5061f891b7f07953ef3b0695f52c89,10,129,23,152,12,2007-07-20 07:46:34,2007-07-20 05:09:35
ef0c2abf3e5061f891b7f07953ef3b0695f52c89...69a9b41c15f25e1e91df5d9c4d5e3d56706f8f0e,1,10,10,20,2,2007-07-20 08:21:06,2007-07-20 00:15:09
c1c10a3f272ec0908e63bc105a5ffe94c1279fba...0cf7375542504e3762753cdc4cff3bb5c8fc628e,2,59,25,84,27,2007-07-19 00:01:00,2007-07-17 18:28:28
0cf7375542504e3762753cdc4cff3bb5c8fc628e...ec96e0f6a4244e3bccc745eeb4cb6daa80a347e4,1,7,4,11,3,2007-07-19 00:01:10,2007-07-17 08:15:42
ec96e0f6a4244e3bccc745eeb4cb6daa80a347e4...b59d398beab604e577846ef8393735478c1ca3c2,1,29,4,33,4,2007-07-19 00:01:10,2007-07-17 17:34:44
b59d398beab604e577846ef8393735478c1ca3c2...575d025c0d0fdc9d8b5d68cb802957c527eb0d14,1,1,1,2,1,2007-07-19 00:01:10,2007-07-17 17:02:57
575d025c0d0fdc9d8b5d68cb802957c527eb0d14...af580e9c5afcffe7020e6f955f5136ee4220834f,1,17,14,31,10,2007-07-19 00:07:46,2007-07-18 13:17:43
39fa2a983d55b37759b99e67f9f1892879efb775...82a2d6bdf9532812e2f315477494956a2f26e2cd,1,7,1,8,3,2007-06-21 03:22:49,2007-06-19 14:48:09
82a2d6bdf9532812e2f315477494956a2f26e2cd...fb626dc00044c106652ae39300b4cb613af70ab1,1,5,1,6,3,2007-06-21 03:25:23,2007-06-12 04:04:30
31c74ca67162674e3ff8fcc294b75881c3e7cc15...6894f49f7bd52da77a3f4ba7fc52d44046f419ac,1,3,0,3,1,2007-06-12 07:13:20,2007-06-11 12:56:56
6894f49f7bd52da77a3f4ba7fc52d44046f419ac...2cf69cf6edbaa15ed47f9c73c0eb60ce7983ba6b,1,2,1,3,1,2007-06-12 07:13:49,2007-06-11 17:04:40
5035242c4785bd23c53827a1656b5f97394f724e...29cf5e1245344b8827ffc0bbcb6f712a3ccc647d,3,3,3,6,3,2007-06-09 17:42:48,2007-06-09 15:44:12
c94bf41c9a78dc1c084f2a2895f95b6b6d8f79b1...2169368fc183ffb2bda203c52edda77ef6f5147b,1,1,0,1,1,2007-06-03 21:54:56,2007-06-03 15:27:52
2169368fc183ffb2bda203c52edda77ef6f5147b...00f429af7bfaa6a9141bc0ac30995d4fae24836a,2,59,10,69,13,2007-06-03 23:51:53,2007-06-03 15:42:44
00f429af7bfaa6a9141bc0ac30995d4fae24836a...20f1eb6b46645115695329a371d412eb3e714865,2,45,2,47,15,2007-06-05 05:42:49,2007-06-05 02:44:00
20f1eb6b46645115695329a371d412eb3e714865...6bfce93e04d13ecb42008a3cf214cc892f480f0c,4,11,17,28,7,2007-06-05 06:07:00,2007-06-05 02:36:11
6bfce93e04d13ecb42008a3cf214cc892f480f0c...9f30855d0ff5206e85e45f0307be9d18ffda41d3,2,20,0,20,2,2007-06-05 06:07:19,2007-06-05 02:36:49
c94bf41c9a78dc1c084f2a2895f95b6b6d8f79b1...980ea5c5bb1dfbbf93b919942c703b9158c35968,2,46,11,57,10,2007-06-03 03:04:14,2007-06-03 00:05:39
c94bf41c9a78dc1c084f2a2895f95b6b6d8f79b1...6f6826c52bb751450e2bfa28f07c817dfa5802d6,3,479,1,480,3,2007-06-03 03:04:04,2007-06-03 00:31:28
6f6826c52bb751450e2bfa28f07c817dfa5802d6...aee078bf81d5810cb461e86950f6807d2d45befa,1,1,0,1,1,2007-06-05 07:07:31,2007-06-05 07:07:31
aee078bf81d5810cb461e86950f6807d2d45befa...350d8575293dc3f25b0c6ec4bbfd9303a0eebd76,1,3,3,6,3,2007-06-06 07:29:47,2007-06-05 14:12:08
350d8575293dc3f25b0c6ec4bbfd9303a0eebd76...d674ee4cfcfc15cdee07c49d7f36656fe6c3e14d,1,0,0,0,0,2007-06-06 08:29:52,2007-06-06 07:29:39
d674ee4cfcfc15cdee07c49d7f36656fe6c3e14d...c12764b8b7e004f84b1e685b76f2d662bee8e196,1,1,1,2,1,2007-06-06 19:31:56,2007-06-06 15:24:07
c12764b8b7e004f84b1e685b76f2d662bee8e196...9840906026be807d0882f96396de3a3cdb9fb43e,2,26,12,38,4,2007-06-06 19:49:16,2007-06-05 15:58:13
9840906026be807d0882f96396de3a3cdb9fb43e...2766ce28150597677bb91c424e6033a298c71510,2,13,28,41,13,2007-06-06 19:49:16,2007-06-06 07:43:41
2766ce28150597677bb91c424e6033a298c71510...3520e1e86878c6787c3abfe677e6472ce2c97f66,1,5,9,14,2,2007-06-06 19:49:16,2007-06-06 18:38:35
03e1bed4a4887607ae90cd121cb4851d10ef2e8b...573fe6d77da51f7baa20800a3809b5db9296a83c,1,33,9,42,4,2007-06-21 03:26:57,2007-06-03 00:56:51
d1c7c27ea3d9c92be2c7a9c5fc72ba5f228c424a...59d10247e444b752a993cf4aa2e0665bc633d32f,1,2,2,4,2,2007-05-29 03:00:45,2007-05-29 02:05:43
18bece43675ea0dc9022a7868865e02808b7af7f...ddcf786fd7d5755711439371dcfd9a7ba1dfa7a5,1,9,10,19,6,2007-05-26 04:42:47,2007-05-26 03:37:40
18bece43675ea0dc9022a7868865e02808b7af7f...51e7ecf4ecb506fb36cd5933cb7b78fb4b315ac9,4,20,7,27,8,2007-05-25 04:37:08,2007-05-23 21:01:29
18bece43675ea0dc9022a7868865e02808b7af7f...ba505322a4f0ac052f059e7381b55c4ab8bfeacd,1,37,1,38,8,2007-05-25 04:37:03,2007-05-23 21:34:27
ba505322a4f0ac052f059e7381b55c4ab8bfeacd...684f6742512d223ac89310b36eb4e230283eca23,1,8,2,10,3,2007-05-25 04:37:03,2007-05-23 21:31:13
18bece43675ea0dc9022a7868865e02808b7af7f...e5d80641d7b17b6943d54c729fbbd0bc5a8fe84d,2,10,3,13,5,2007-05-25 04:37:00,2007-05-24 15:06:55
18bece43675ea0dc9022a7868865e02808b7af7f...d45cc6e2670bbfecb16c608a2bb0e3f358a9ece7,7,6,228,234,10,2007-05-25 04:36:53,2007-05-20 00:10:13
d45cc6e2670bbfecb16c608a2bb0e3f358a9ece7...59c8e2cb2aee2e4eb75007602b264bc4e7928bc0,9,10,280,290,14,2007-05-25 04:36:53,2007-05-25 02:25:25
f95c6780c244e90abf87222126ad3b4bb18a504e...523d12e5003eee0c2cb670b51e39d719cd56aacd,1,3,5,8,1,2007-05-22 01:42:57,2007-05-21 00:57:27
ebc2e5a593ce7082bed03b2d22e2fe83583a9f5d...49c3e926349e964b311b46251bb2b97d3d669855,4,30,3,33,5,2014-10-29 17:48:45,2014-10-29 17:48:38
6abd0fb396a0c575dafd4e1021d37d178740396c...3a86f36bedab00446a5b9117981bce25120adfb1,1,7,0,7,1,2007-06-06 20:13:58,2007-06-06 18:57:40
3a86f36bedab00446a5b9117981bce25120adfb1...f07dfbad29d473b35b5fecebf4baf77e32c7f97f,1,0,1,1,1,2007-06-06 20:19:16,2007-06-04 11:53:05
6abd0fb396a0c575dafd4e1021d37d178740396c...33aa6fff5d502d8e2806d31bb0916006993c1f24,1,28,16,44,3,2007-06-06 09:49:08,2007-06-06 09:13:01
33aa6fff5d502d8e2806d31bb0916006993c1f24...211b7f19c7b046a6cadd36d54c549e4f335f0519,3,51,44,95,23,2007-06-06 09:49:08,2007-06-06 09:13:02
6abd0fb396a0c575dafd4e1021d37d178740396c...8b7f5fc1cac8eb49b4846021706fc06ce074881b,1,22,14,36,15,2007-06-06 09:35:49,2007-05-30 00:56:41
8b7f5fc1cac8eb49b4846021706fc06ce074881b...cbc9be5ca3989e522f6ad0dfe3697657ecb4b595,2,18,7,25,6,2007-06-06 09:35:49,2007-06-04 09:01:34
cbc9be5ca3989e522f6ad0dfe3697657ecb4b595...06baffd3df7031d4d5cea223daf3512038d25f45,1,2,0,2,1,2007-06-06 09:35:49,2007-06-04 09:01:49
2be2e267aaae6f7b77a820591463b7888b30cbc3...f7b47b273ed2c9e9b298c4f5dd02884b46dfbced,4,48,9,57,5,2007-05-20 07:15:53,2007-05-20 01:18:24
e102d4353d7cfd69a597cd976eabdcb74641be69...953f3d6ff939b3c51d6c733a3d0e3f54e7477034,1,15,5,20,4,2007-05-07 05:03:52,2007-04-18 04:20:46
953f3d6ff939b3c51d6c733a3d0e3f54e7477034...e34caace588612e9bc492aa9188390de42546aad,1,82,2,84,81,2007-05-07 05:03:52,2007-04-18 04:46:19
e34caace588612e9bc492aa9188390de42546aad...597230403be52a13b8373222b7604047bacb4bd4,1,40,33,73,14,2007-05-07 05:03:52,2007-04-30 15:11:02
597230403be52a13b8373222b7604047bacb4bd4...58c19d1f95f4742efc6b3ca7d2fddbccd015e0b0,1,3,4,7,4,2007-05-07 05:03:53,2007-05-07 04:16:33
58c19d1f95f4742efc6b3ca7d2fddbccd015e0b0...c64415e29ecf8e26dc2c4451f9a04023dd941ac7,1,47,35,82,21,2007-05-07 05:03:53,2007-05-07 04:56:45
c64415e29ecf8e26dc2c4451f9a04023dd941ac7...a1dc34fa951a2ee8a2c85fbb9d8fdf1d63b54b43,1,3,4,7,1,2007-05-07 05:03:53,2007-05-07 05:01:42
a1dc34fa951a2ee8a2c85fbb9d8fdf1d63b54b43...604d7a1ac0405c2ce048a1113e60d9d0c0d3e3d9,1,1,1,2,1,2007-05-07 06:30:38,2007-05-07 05:28:34
9aae177a4adff326421e55c7c0f3138de15ce2c1...ff06c743dcd7f451381b41aeac4288179eaec428,1,32,9,41,9,2007-05-04 06:27:03,2007-05-01 06:08:23
ff06c743dcd7f451381b41aeac4288179eaec428...86b9e017e485a4e56fb8f096cb9094c415483118,1,4,1,5,4,2007-05-04 06:27:03,2007-05-01 07:24:59
86b9e017e485a4e56fb8f096cb9094c415483118...cc0e6c5adc783bcb29954f3a0b7a6197bcc9b1b3,2,51,24,75,28,2007-05-06 07:07:07,2007-05-04 21:54:57
abf411e28d9df669b0e690578a1eb95c0bd29847...5fd898141ce2a243abf75192c9a55cb0a4e1ba80,1,3,1,4,2,2010-12-26 19:17:18,2010-12-25 12:38:46
af24059fa299f1656692f5807eddd3b30b5f3cfb...e92fa514a9ade4526ad5c119e3f12e69621c97b6,1,3,1,4,2,2010-09-07 00:32:28,2010-09-06 21:40:16
e92fa514a9ade4526ad5c119e3f12e69621c97b6...04df568be53c42d07aea393effc7c5653f245d9a,1,0,1,1,1,2010-09-07 00:33:59,2010-09-06 21:53:24
af24059fa299f1656692f5807eddd3b30b5f3cfb...fd4ec4f2bb980ce07bb28d5823a95610f251d00b,32,256,260,516,147,2010-09-06 21:30:53,2010-09-06 18:39:54
28bf4ba014c9b41679f41580fa9e1cc294b240d9...79bf149061fa29482512d903192a0d929e82872b,2,25,1,26,4,2010-07-27 17:58:46,2010-07-26 15:06:51
79bf149061fa29482512d903192a0d929e82872b...593ce2bea5dad436e87b5dd37c205961d73feae9,4,20,3,23,5,2010-07-27 21:09:11,2010-07-27 21:07:41
3d8167677ddd71405906409994a72306ba993a1f...f9dae0d3e63455206c1e1e169c76aca55aeb5d90,1,6,2,8,2,2010-04-22 06:46:51,2010-04-22 01:18:21
846b8f681a0a75cec2b930007c84e98346940459...a9a746364bd26d333c7229c6f7e851b507cd284a,3,27,4,31,9,2010-03-24 21:15:09,2010-03-24 20:22:34
a9a746364bd26d333c7229c6f7e851b507cd284a...937491944292fa3303b565b9bd8914c6b644ab13,5,27,4,31,10,2010-04-09 06:06:39,2010-04-08 07:15:39
8bd26c4a2f7539f6418934858710c674bb139cdd...f98157720239f0dd94d03632dc873e3eb3135e2f,2,4,4,8,3,2007-04-11 07:51:20,2007-04-09 22:56:33
f98157720239f0dd94d03632dc873e3eb3135e2f...8eb2d0bee8813ac37dc602d12b0abba632e96152,1,16,8,24,3,2007-04-11 21:05:36,2007-04-11 08:28:43
8eb2d0bee8813ac37dc602d12b0abba632e96152...cb52d9a1fbb2298d73bfa5dc86a0155cc462ecf2,1,1,0,1,1,2007-04-11 23:55:33,2007-04-11 20:38:19
cb52d9a1fbb2298d73bfa5dc86a0155cc462ecf2...9b11d24d4156e0b2246383faad16eb8aa0caeefb,2,23,8,31,6,2007-04-12 00:19:36,2007-04-11 21:39:07
8fced61cbc32f0c4b81a3dcecfeb40b7d96339ce...a0764cb838c2f1885fb58ca794c21523fb05c825,1,2,0,2,1,2006-07-25 01:37:40,2006-07-18 17:14:51
8fced61cbc32f0c4b81a3dcecfeb40b7d96339ce...12f6c308d53509dcb11e309604457d21d60438db,8,23,5,28,9,2006-07-03 20:55:11,2006-07-03 20:11:47
12f6c308d53509dcb11e309604457d21d60438db...f560069bc59e155c3078ba5482ce69ded68849df,1,6,0,6,1,2006-07-04 01:41:58,2006-07-04 01:30:01
f560069bc59e155c3078ba5482ce69ded68849df...3f492ba1fc4e63073378cc097154bed1ed2563c8,1,139,58,197,24,2006-07-04 01:43:49,2006-07-04 01:30:02
3f492ba1fc4e63073378cc097154bed1ed2563c8...624314fda7e7bd1107db7de4e877ee6285d7d6eb,1,2,2,4,2,2006-07-04 01:48:23,2006-07-04 01:48:23
624314fda7e7bd1107db7de4e877ee6285d7d6eb...280242d1cc1fe2847f649d2f16b273e168fcbc48,2,24,5,29,3,2006-07-04 02:04:46,2006-07-02 23:03:59
9673198ee867cea4ed70d2cf54c1a2eb8f27bb46...4c5cf8c44ce06a79da5bafd4a92e6d6f598cea2e,1,4,0,4,2,2006-08-13 17:25:00,2006-08-13 11:13:25
5209eda86363a3ba2e000903ad8de29589b18b58...6c35119ac711c69c69874d7d52f5cfa12c07ccce,2,13,2,15,3,2006-07-27 20:55:31,2006-07-14 15:53:29
6c35119ac711c69c69874d7d52f5cfa12c07ccce...cc41cd2e60da8224dcd04f23d837853cff5d4eda,3,4,4,8,4,2006-07-27 21:21:03,2006-07-27 18:58:53
cc41cd2e60da8224dcd04f23d837853cff5d4eda...c2c487cf3a6c37bc9b4e3f0e10ad08d9ce048404,1,1,1,2,1,2006-07-28 02:33:06,2006-07-27 14:03:43
5209eda86363a3ba2e000903ad8de29589b18b58...cadbcf2712ff346dcd757d0b116359380920b2a4,1,4,4,8,2,2006-07-26 21:32:13,2006-07-26 20:51:52
ff4c848527137b5ca52dfe97c25fcc8bcc4b8726...f324943816789fa047441f66edbe11669dc8a9ab,1,90,190,280,15,2006-07-09 10:38:12,2006-07-05 01:46:42
f324943816789fa047441f66edbe11669dc8a9ab...cd6f207a445f96966eb119b874306dca291fcd22,1,45,0,45,2,2006-07-09 10:38:12,2006-07-05 00:35:20
182a8dabd5f5f646608f3857f10f3ac18c3d1445...89b0c4b5a3a9d026d9adb30d4e896965e480725e,1,5,7,12,6,2006-08-14 02:19:34,2006-08-14 02:19:34
182a8dabd5f5f646608f3857f10f3ac18c3d1445...c04c4e5708c9ad3dc534ff50ad8f28de5a7cfbff,1,12,10,22,3,2006-08-13 05:21:43,2006-07-06 01:12:12
ed0e078f96a96ffe515899ef42051a568be4693a...f6801d669ee11f0d5e67b2e86aec270d2a225224,1,12,2,14,2,2006-07-11 21:18:42,2006-07-11 10:19:34
f6801d669ee11f0d5e67b2e86aec270d2a225224...49da1dafc075e353c0eb3869de4acf600c594621,1,6,2,8,3,2006-07-11 21:18:42,2006-07-11 20:10:26
49da1dafc075e353c0eb3869de4acf600c594621...e130ddaaf3451d0bd60860cb0019e47c9f421442,1,29,33,62,26,2006-07-13 05:00:22,2006-07-12 22:55:10
e130ddaaf3451d0bd60860cb0019e47c9f421442...e918c6abac65fb56b381f37cc139753fbe6768a3,1,10,6,16,4,2006-07-13 05:21:47,2006-07-13 05:21:05
ed0e078f96a96ffe515899ef42051a568be4693a...e1447e38c00bdc1904458cfabb4bb3ffb678a271,2,16,4,20,7,2006-07-11 21:16:53,2006-07-11 05:52:54
e1447e38c00bdc1904458cfabb4bb3ffb678a271...09a28eccce58d349d93280fd3ac08c5ad0eaa3c5,1,1,1,2,1,2006-07-11 21:16:53,2006-07-11 06:10:19
09a28eccce58d349d93280fd3ac08c5ad0eaa3c5...5a6852fef1d76369d6dfcad1a40ca5287bb781a6,1,5,2,7,3,2006-07-11 21:16:53,2006-07-11 06:25:09
5a6852fef1d76369d6dfcad1a40ca5287bb781a6...8ef1c7c77d3e5950a839d9ae348827fa288a9a11,2,11,4,15,6,2006-07-14 06:08:24,2006-07-14 04:47:23
83e12e51c1826b29b5ab2ebcfa13ed99ce98ee98...c6e1d9ed509265a66fe9d155b1a66aa954cce675,1,13,13,26,10,2006-07-25 01:21:51,2006-07-23 20:26:30
c6e1d9ed509265a66fe9d155b1a66aa954cce675...cff0771bfbc8a8c1a432a99bc297a52a5ba94304,1,29,6,35,4,2006-07-25 01:21:51,2006-07-23 20:28:55
cff0771bfbc8a8c1a432a99bc297a52a5ba94304...93d5f0619ccf10d7a16834b9e3be38871d2aae6c,1,3,0,3,1,2006-07-25 01:21:52,2006-07-23 20:30:08
93d5f0619ccf10d7a16834b9e3be38871d2aae6c...634331061599a82968daddae2d2c0896b6137d4c,1,21,20,41,9,2006-07-25 01:21:52,2006-07-23 20:31:15
09f5dc406a9e6630af881108af815f6c3fb6d9df...143c89b00348759d2768003d57e0f506d281dc61,1,1,1,2,1,2006-07-25 21:05:55,2006-07-24 22:07:23
143c89b00348759d2768003d57e0f506d281dc61...28f7581806479471093b0ec021871a4343874d13,3,3,6,9,3,2006-07-25 21:08:09,2006-07-25 07:30:18
28f7581806479471093b0ec021871a4343874d13...42217f13efcfd7901636877f020de246d6c58838,1,1,1,2,1,2006-07-25 21:09:21,2006-07-25 10:48:52
42217f13efcfd7901636877f020de246d6c58838...96256bba949f43548a0be0af877680eb62b156f6,1,56,14,70,10,2006-07-25 21:11:36,2006-07-25 11:57:57
bf6d324e7333f62f6aee56ebb886e82e1f49e1ce...3af244caa8297793f29d7422bb19d9da1bf07b5e,1,364,526,890,185,2006-07-28 02:39:15,2006-07-27 11:17:07
3af244caa8297793f29d7422bb19d9da1bf07b5e...5a753613406286962df514db21094afc99525989,1,189,191,380,98,2006-07-28 02:39:15,2006-07-27 17:12:29
5a753613406286962df514db21094afc99525989...bd669986f7ecfb0215e5d5fa29ec8449a6225bc1,1,1,64,65,7,2006-07-28 02:39:15,2006-07-27 17:12:51
bd669986f7ecfb0215e5d5fa29ec8449a6225bc1...5d3afe05d9466a8472be315793dfc08594b1e9c4,1,0,22,22,4,2006-07-28 02:39:15,2006-07-27 17:13:08
5d3afe05d9466a8472be315793dfc08594b1e9c4...7b3f5daabc9fcfffc632a6a963cf5466745b7dbd,1,4,1,5,2,2006-07-28 02:39:15,2006-07-27 17:13:24
7b3f5daabc9fcfffc632a6a963cf5466745b7dbd...c1d20846f4a7112c44653dfe25411ccd19297790,1,23,23,46,14,2006-07-28 02:39:15,2006-07-27 17:13:47
c1d20846f4a7112c44653dfe25411ccd19297790...3058e9339f05379462b7e14d832d091cc3d9b2b9,1,4,5,9,2,2006-07-28 02:39:15,2006-07-27 17:14:17
3058e9339f05379462b7e14d832d091cc3d9b2b9...a060b803b49c04cd6e3b0d859f131349dab6b26f,1,1,1,2,1,2006-07-28 05:02:45,2006-07-28 05:02:45
a060b803b49c04cd6e3b0d859f131349dab6b26f...f59aac47f3839367d0da04019b0fc2bd61345225,1,2,2,4,2,2006-07-30 21:23:00,2006-07-30 16:35:21
5cd060b56c3d0b9f2340377d73dfe1abbcbe8a20...c7543ce0be5609df8123f88ac75a06c1bda98f0e,1,1,0,1,1,2006-07-14 23:32:38,2006-07-14 23:32:38
c7543ce0be5609df8123f88ac75a06c1bda98f0e...a3e65d74ee7ec9e6f49de7688a1cdac052910bd4,2,11,8,19,4,2006-07-14 23:36:00,2006-07-14 23:36:00
f6e2869f48f7a9b51a2a867ce955c39a9314ef3b...757f17bca50f4a227db2974dd8fd10c8b61a69f1,1,5,1,6,3,2005-11-20 22:56:07,2005-11-20 22:56:07
3eeb419968c1f8f0a762a7127db770e9d9c8037d...a4caa5214058ad7e2bc7b74e989d6b3ffb47bec3,1,19,1,20,2,2005-11-19 10:54:07,2005-11-19 10:54:07
a4caa5214058ad7e2bc7b74e989d6b3ffb47bec3...6ed64058e1241f9939c4abf5d6a9eaed6a2cc795,1,14,21,35,6,2005-11-19 20:13:53,2005-11-19 20:13:53
6ed64058e1241f9939c4abf5d6a9eaed6a2cc795...22a06b3c474d256e945dbc0d2a830c3f467288b5,1,2,5,7,2,2005-11-20 03:21:11,2005-11-20 03:21:11
22a06b3c474d256e945dbc0d2a830c3f467288b5...397c76697f898e0341699fba8ef783f3342329c7,1,6,1,7,1,2005-11-20 03:50:44,2005-11-20 03:50:44
397c76697f898e0341699fba8ef783f3342329c7...80e21a9ed809d98788ff6fb705d911bee37d460b,1,4,0,4,1,2005-11-20 03:57:54,2005-11-20 03:50:44
80e21a9ed809d98788ff6fb705d911bee37d460b...29508e1efb8d5a18f78ca0f9be45fdde49ef6b76,5,635,976,1611,76,2005-11-20 04:17:24,2005-11-18 19:02:58
29508e1efb8d5a18f78ca0f9be45fdde49ef6b76...e388ab74dbaea5cdbf07b175be8d6980579392f4,1,139,136,275,78,2005-11-20 04:17:24,2005-11-18 19:03:04
e388ab74dbaea5cdbf07b175be8d6980579392f4...5e3a769186bc41f94c1970579f96f3b68b046ed6,1,10,2,12,2,2005-11-20 04:17:24,2005-11-18 19:03:11
5e3a769186bc41f94c1970579f96f3b68b046ed6...acf59575cac330f3a505247dd7a9d6551a2a9cf8,1,163,156,319,40,2005-11-20 04:17:25,2005-11-18 19:03:18
acf59575cac330f3a505247dd7a9d6551a2a9cf8...7b8999674955b9d6b58de2b8f71b2e2ede795f65,1,14,3,17,8,2005-11-20 04:17:25,2005-11-18 19:03:25
7b8999674955b9d6b58de2b8f71b2e2ede795f65...11979b98adc301fed84122237d0d5a26a360fede,1,35,36,71,3,2005-11-20 04:17:25,2005-11-19 01:06:46
11979b98adc301fed84122237d0d5a26a360fede...0890098780f295f2a58658d1f6b6627e40426c72,2,6,12,18,3,2005-11-20 04:17:25,2005-11-19 01:08:36
0890098780f295f2a58658d1f6b6627e40426c72...10bea152a34b2bf1194ede5e0c9e5595ab2100f3,2,295,1,296,4,2005-11-20 04:47:29,2005-11-17 21:32:36
10bea152a34b2bf1194ede5e0c9e5595ab2100f3...1b1e59c5084ac8b0af0aa443bb1713179d400211,3,29,1,30,3,2005-11-20 04:47:29,2005-11-17 21:44:55
1b1e59c5084ac8b0af0aa443bb1713179d400211...2d2465c01518eb7defa9aa39ae864c9646cfb6f4,2,111,0,111,2,2005-11-20 04:47:30,2005-11-17 21:49:19
2d2465c01518eb7defa9aa39ae864c9646cfb6f4...942c1f53aef03cb3d8b5c39b38997a379c3fad20,1,180,0,180,1,2005-11-20 04:47:30,2005-11-17 21:50:08
942c1f53aef03cb3d8b5c39b38997a379c3fad20...54f4b87454824fedc629219620ce9b7cdcab3d27,2,73,0,73,3,2005-11-20 04:50:37,2005-11-17 19:37:14
54f4b87454824fedc629219620ce9b7cdcab3d27...0870ca7fabe6f25095431280e480859f7c66e8ab,2,60,57,117,11,2005-11-20 04:50:38,2005-11-18 22:59:34
0870ca7fabe6f25095431280e480859f7c66e8ab...8d6301329156e4eeb0d25d6bce14f6e958314986,2,7,25,32,7,2005-11-20 04:50:38,2005-11-17 19:37:14
8d6301329156e4eeb0d25d6bce14f6e958314986...faea9ccbadf75128a9e394dca80ed9454e19c7a9,1,33,22,55,4,2005-11-20 04:50:39,2005-11-17 19:37:14
faea9ccbadf75128a9e394dca80ed9454e19c7a9...7b5d895da6d86eda36af84516a359192ca1da469,1,24,5,29,1,2005-11-20 04:50:39,2005-11-17 19:37:14
7b5d895da6d86eda36af84516a359192ca1da469...4ddba79db76bd6425f00e99ceb1d82d179319aec,5,258,61,319,41,2005-11-20 07:15:07,2005-11-20 05:52:22
4ddba79db76bd6425f00e99ceb1d82d179319aec...13cfdfd5fade73c7784ec45506b446e40e76c742,1,105,0,105,1,2005-11-20 07:50:48,2005-11-20 07:50:48
13cfdfd5fade73c7784ec45506b446e40e76c742...9ae2172aed289f2706a0e88288909fa47eddd7e7,1,1,5,6,1,2005-11-20 18:40:31,2005-11-20 18:40:31
9ae2172aed289f2706a0e88288909fa47eddd7e7...a6322d079b1d2e2cb72da1271171b35a173f3d22,1,2,2,4,2,2005-11-20 18:47:16,2005-11-20 12:14:37
a6322d079b1d2e2cb72da1271171b35a173f3d22...f98d863d2122e1b8781dfb9889df98876a26f315,4,70,8,78,13,2005-11-20 18:53:06,2005-11-20 12:24:18
07cdbb35ccc5dc9d9a6ef34faa8998b8221d73ee...8fc7ba85c9f6f3d599e9f81cf9fbd0d014b5dad4,1,5,2,7,3,2005-09-27 16:01:08,2005-09-27 16:01:08
8fc7ba85c9f6f3d599e9f81cf9fbd0d014b5dad4...e8f71fce3720016d1e9ae3070a8774c19888dc59,1,2,1,3,2,2005-09-27 16:02:24,2005-09-27 16:02:24
d710b2655c72f37f3d065b2c8c93e022f596d460...1775451793b4538e27047dfdb2feec4b46b766a9,1,4,0,4,1,2005-09-28 23:37:37,2005-09-28 23:37:37
1775451793b4538e27047dfdb2feec4b46b766a9...4c505f71e60b9d152a3a9d7a59b8b5146991a288,1,73,0,73,2,2005-09-28 23:37:58,2005-09-28 23:37:58
4c505f71e60b9d152a3a9d7a59b8b5146991a288...49744d63e9c5ffdfb4677bd3aaeafb3371c3fdc1,2,14,4,18,7,2005-09-28 23:52:21,2005-09-28 23:52:21
49744d63e9c5ffdfb4677bd3aaeafb3371c3fdc1...296fdc53bdd75147121aa290b4de0eeb3b4e7074,1,1,0,1,1,2005-09-28 23:53:56,2005-09-28 23:53:56
296fdc53bdd75147121aa290b4de0eeb3b4e7074...918e723204651252e5a823481cc8450e498a45f9,1,3,0,3,2,2005-09-28 23:56:08,2005-09-28 23:56:08
918e723204651252e5a823481cc8450e498a45f9...6573faff34eb002535843bbb59365be4ad58a120,3,77,18,95,18,2005-09-29 00:26:44,2005-09-29 00:26:44
6573faff34eb002535843bbb59365be4ad58a120...dc4afa57ce3e07645690bec1e4c20ab59e8a9bd0,1,1,1,2,1,2005-09-29 01:00:24,2005-09-29 01:00:24
dc4afa57ce3e07645690bec1e4c20ab59e8a9bd0...e72456bb67bfcadf3703dc2f8240af7d9d8aebdb,1,0,4,4,3,2005-09-29 01:01:55,2005-09-29 01:01:55
e72456bb67bfcadf3703dc2f8240af7d9d8aebdb...a23cd8ece70262fac2a80ef3e454c1cf1c63605a,1,24,24,48,14,2005-09-29 02:08:37,2005-09-29 02:08:37
d710b2655c72f37f3d065b2c8c93e022f596d460...3e03aaf523331d4f3e92e680f75e6053d1813b64,1,12,31,43,10,2005-09-28 19:56:18,2005-09-28 19:56:18
3e03aaf523331d4f3e92e680f75e6053d1813b64...05dd8e2ee2ecba1b4ef1dbbde5c81281152604b4,4,43,8,51,16,2005-09-28 23:22:00,2005-09-26 05:54:23
05dd8e2ee2ecba1b4ef1dbbde5c81281152604b4...60fa056052b8233c22098a711ab780679d0c5b7e,1,4,7,11,2,2005-09-28 23:29:11,2005-09-28 23:29:11
60fa056052b8233c22098a711ab780679d0c5b7e...49c188fa8ff599cb6863eb5d86bfdbe22f2b8496,1,2,0,2,2,2005-09-28 23:38:50,2005-09-27 07:06:05
49c188fa8ff599cb6863eb5d86bfdbe22f2b8496...5acb6de13d7af33abcfcbdc885ec365e6a51c486,1,19,0,19,2,2005-09-28 23:38:51,2005-09-27 17:45:27
5acb6de13d7af33abcfcbdc885ec365e6a51c486...a7928f8ec7fb3c368e6086ab48f41e33a22e1b94,3,5,5,10,5,2005-09-28 23:38:52,2005-09-28 12:04:54
a7928f8ec7fb3c368e6086ab48f41e33a22e1b94...bf7960eb51a26bcf52f27a60bfcf005661266b1e,9,39,32,71,30,2005-09-28 23:42:44,2005-09-28 01:14:27
914328ac02d3699407fe1df6b45ef4b7e8eff23a...1eb446fa9fe66df037b416d2fb3c44cf36250354,1,12,0,12,1,2005-08-31 18:48:41,2005-08-31 18:48:41
1eb446fa9fe66df037b416d2fb3c44cf36250354...6e7722e6f88c049f43a1c00c45c502542d1a5752,1,13,2,15,2,2005-09-01 00:11:39,2005-09-01 00:11:39
6e7722e6f88c049f43a1c00c45c502542d1a5752...7e011c40bc6c7dbd48b033fb16c861b1166f808c,1,16,4,20,2,2005-09-01 00:13:48,2005-09-01 00:13:48
7e011c40bc6c7dbd48b033fb16c861b1166f808c...2d56993347eac4e4f91c0539ff3c5f05fd777495,1,20,25,45,4,2005-09-01 00:15:25,2005-09-01 00:15:25
5be4efbefafcd5b81fe3d97e8395da1887b4902a...56fc5108a2e82a5780179f05a46d3b8be507dc8c,1,73,35,108,12,2005-08-22 19:58:03,2005-08-22 00:27:50
56fc5108a2e82a5780179f05a46d3b8be507dc8c...792fe559d02e55c12d2d544fd6d6f202cbaab6f4,1,8,2,10,1,2005-08-23 01:32:38,2005-08-21 20:56:52
792fe559d02e55c12d2d544fd6d6f202cbaab6f4...4f7599ac2543e1d59f2b2b865ecff272ae5f4ea5,1,41,0,41,3,2005-08-23 01:34:09,2005-08-21 09:43:54
4f7599ac2543e1d59f2b2b865ecff272ae5f4ea5...f76412ed6dbf2f9863115ee38f4198368dbaf7b1,4,343,7,350,8,2005-08-23 01:34:10,2005-08-21 09:51:10
f76412ed6dbf2f9863115ee38f4198368dbaf7b1...f5e375c9a99d731c05eef701f119da85d62fc158,6,128,140,268,10,2005-08-23 06:18:17,2005-08-23 06:16:46
152a9c17a802379a3a48e025b74dedd76e2623cc...6ba01babcd37e92e88221fcf35ee4471aa66bf4c,1,1,1,2,1,2013-11-06 22:35:19,2013-11-06 22:35:19
abe0582207c72ec848e78707577c61a98f5c633d...a7e66ae3f70e6e1ae08250d61ff8a968b714754d,1,1,1,2,1,2005-08-17 01:33:51,2005-08-16 05:46:34
a7e66ae3f70e6e1ae08250d61ff8a968b714754d...e3fdb7f202c910652f2f19bab55af47b269023d3,1,11,9,20,1,2005-08-17 01:33:51,2005-08-17 00:24:34
e3fdb7f202c910652f2f19bab55af47b269023d3...83db04ff878f40146952ee5d3d2d113568455f5b,1,24,0,24,7,2005-08-17 01:33:51,2005-08-17 00:41:32
1a002c73ba63799dda75a4c28da5b562eea7a3ff...666ca59a8c88e1750386fa64c7ed4be698fd1b2a,1,1,8,9,2,2012-09-25 16:00:28,2012-09-25 04:31:19
b58f3a645bc04f3b52aa41c75a019d51b615c647...1084f3b844d80d84d2d318bc562b78514cd78028,1,13,0,13,2,2012-09-14 19:34:11,2012-09-14 19:34:11
39836a2e3cc38735d532a08465774194e5099daf...75f492ace708afb4603b922a99ced318d980b8d5,2,4,4,8,4,2009-08-11 02:05:00,2009-08-11 00:52:07
f47af92594b0bdc2f634c1fd491999ad04b772dd...d9b9784f572a71b2f4ea0f8772b0d586ea0f848f,4,50,3,53,5,2009-08-22 03:16:10,2009-08-21 19:02:25
2cd9c2aff0d65bbce704a68d9cbe7a17e02257fe...13354f5377d82baee4d8c930df824c8dbeda396d,1,10,2,12,1,2009-08-17 07:03:39,2009-08-17 06:19:17
2e1176d51ef4fc07f487818acdfcf2fc4b789203...b85e6c5f8107c802c627981e044e680999884c5f,2,20,6,26,6,2009-08-25 20:06:18,2009-08-22 00:45:18
2d11f21c365821ccba1e093f22b99ad71b955f21...b4194828dc00e97dcd07ecb4bb4f87650a6fca1d,3,10,2,12,5,2011-05-31 18:24:12,2011-05-31 17:06:44
86c91f91794cd6af8e19fbe68ab283d567d2b66f...0cef4e765c10118f6e33dd770a475b9cd89a7960,1,0,1,1,1,2014-12-09 22:25:53,2014-12-09 17:28:18
1088261f6fc90324014b5306cca4171987da85ce...0feb7c66e9db3c639b799503cf0996dd690044d5,1,0,3,3,3,2012-06-15 18:09:57,2012-06-14 20:23:37
1088261f6fc90324014b5306cca4171987da85ce...f395cd06755c7563df7d0a0408807199c3f60635,1,3,0,3,1,2009-08-06 20:38:51,2009-08-06 13:14:44
f395cd06755c7563df7d0a0408807199c3f60635...ae209bd34914c05d141030b3affcf276f07e2490,1,1,1,2,1,2009-08-06 20:39:35,2009-08-06 13:14:45
ae209bd34914c05d141030b3affcf276f07e2490...17fd9f571f5596b0e69e143bf6d72a19c780dd25,1,1,1,2,1,2009-08-07 18:41:01,2009-08-07 04:21:33
17fd9f571f5596b0e69e143bf6d72a19c780dd25...611c7f6a373fc6e7140f81bf9c26bde9f78390d4,1,10,2,12,4,2009-08-07 18:55:52,2009-08-07 05:08:09
611c7f6a373fc6e7140f81bf9c26bde9f78390d4...ad17f01399a9220b78678b322bd42b0a29898e01,1,9,2,11,3,2009-08-07 19:20:29,2009-08-07 19:09:29
ad17f01399a9220b78678b322bd42b0a29898e01...c9e388bb48bdafdf19574add915ab0ce33a1907d,4,6,22,28,8,2009-09-04 04:27:36,2009-09-04 02:13:49
c9e388bb48bdafdf19574add915ab0ce33a1907d...2d14d65ce7b136b0fb18dcf27e5caff67829f658,1,14,7,21,3,2009-09-04 04:27:36,2009-09-04 02:13:51
2d14d65ce7b136b0fb18dcf27e5caff67829f658...85cdaa468d9449bbc5889ba94359c77ccafb65cd,2,2,4,6,2,2009-09-12 05:35:30,2009-09-12 05:35:30
3fa509dfbdb8526453f4213f79b371bdfa493f0e...76e2f7ce323c7ddb3a7c29e56407da6a69a4fa53,6,75,14,89,19,2009-08-22 19:15:57,2009-08-08 06:31:57
76e2f7ce323c7ddb3a7c29e56407da6a69a4fa53...173e6c8852be3c543689f8613ddf3fdafd9ca7b9,1,106,8,114,5,2009-08-22 19:18:00,2009-08-05 06:55:22
173e6c8852be3c543689f8613ddf3fdafd9ca7b9...9e4b7ab652561e1807702fe5288e04b8873fc437,9,89,50,139,21,2009-08-22 19:18:00,2009-08-15 09:27:39
9e4b7ab652561e1807702fe5288e04b8873fc437...9b4fe22990dd3fab9494927935c371b072ee7c8f,1,1,1,2,1,2009-09-06 06:15:51,2009-09-05 08:50:26
9b4fe22990dd3fab9494927935c371b072ee7c8f...01d8ba187d6e8a6bfa908fbef16a36d1186981dd,1,25,20,45,3,2009-09-06 06:16:25,2009-09-05 08:53:48
01d8ba187d6e8a6bfa908fbef16a36d1186981dd...dd2be243d62260d4c825c22fdd2f61a7da12de22,1,14,7,21,6,2009-09-06 06:16:27,2009-09-05 08:54:14
dd2be243d62260d4c825c22fdd2f61a7da12de22...6f15787181a163e158c6fee1d79085b97692ac2f,2,15,3,18,6,2009-09-06 06:16:31,2009-09-05 08:55:37
6f15787181a163e158c6fee1d79085b97692ac2f...7c9f7038e923e6eb135b27c6fca9a010b034bc27,2,46,7,53,6,2009-09-06 06:16:32,2009-09-05 08:59:56
6651c3f706cc47d8055ab43f9f7907202d10655d...4813926921862887c23e4160908ec7b8ad9e19dd,1,4,0,4,1,2009-06-27 20:15:39,2009-06-27 18:47:43
4813926921862887c23e4160908ec7b8ad9e19dd...0f7050469b7ae9a95ab01880ecd5cf22e6e41dd2,1,30,0,30,1,2009-06-27 20:15:41,2009-06-27 18:47:44
0f7050469b7ae9a95ab01880ecd5cf22e6e41dd2...1bed73c64a354248d6b342e58df257e8233bcbd2,1,9,1,10,2,2009-06-27 20:15:57,2009-06-27 16:24:11
6651c3f706cc47d8055ab43f9f7907202d10655d...345a38039414366e91a32f3c01257c3afcf78e27,1,1,1,2,1,2009-06-25 21:47:49,2009-06-25 21:21:35
554555ac7da0b9b78bd97cff05daa60498eb1bba...eeefa7c90e1b754a2b01d73fd93aaf90afdc4914,13,28,30,58,30,2009-09-01 06:26:28,2009-09-01 05:35:10
eeefa7c90e1b754a2b01d73fd93aaf90afdc4914...dcda3614d44bf83aaeb7632353ab668bc689986c,1,3,1,4,3,2009-09-01 14:55:56,2009-09-01 09:18:52
dcda3614d44bf83aaeb7632353ab668bc689986c...0b1fac320c10b83133f824805055ff428b331e19,1,6,8,14,5,2009-09-01 15:02:51,2009-09-01 09:18:29
f402a7b17202c1eb2677a432673e4d607b5f0928...5ae9ebfd582a6e8c2d6fd3d27b7df6cb12a98839,1,1,0,1,1,2009-08-10 20:25:25,2009-08-10 15:55:48
5ae9ebfd582a6e8c2d6fd3d27b7df6cb12a98839...bb99190e27c455867bb364059f9a44c0571fc914,1,6,9,15,9,2009-08-10 20:26:11,2009-08-10 15:59:55
bb99190e27c455867bb364059f9a44c0571fc914...0c4f21e452dca5a705c36ca7e363c1a3b3c2a5b8,1,5,1,6,1,2009-08-10 20:26:18,2009-08-10 16:05:06
6ffd781226f04629eff63a684b47ad7555143312...1c244f6ee5775b227177a66cdcf49a410d9d6871,3,49,5,54,13,2009-08-15 02:50:11,2009-08-13 19:32:50
1c244f6ee5775b227177a66cdcf49a410d9d6871...ef92e1a43632c5b29b89da058f45d9c085ad18b7,1,1,1,2,1,2009-08-15 08:50:52,2009-08-15 08:40:42
6ffd781226f04629eff63a684b47ad7555143312...5fd448f1142c61da31b28c74d7d340938ab0e01d,1,16,11,27,4,2009-08-15 02:48:45,2009-08-11 11:12:13
6ffd781226f04629eff63a684b47ad7555143312...b186a261b1f7ec1fbda8c5f6d84595f3a7716d92,3,42,1,43,3,2009-08-13 04:41:09,2009-08-12 23:01:59
b186a261b1f7ec1fbda8c5f6d84595f3a7716d92...6f5748e14cc5bb0a836b649fb8e2d6a5eb166f1d,6,96,54,150,36,2009-08-13 05:17:56,2009-08-12 03:14:27
6f5748e14cc5bb0a836b649fb8e2d6a5eb166f1d...c83f4e686445c83edbe9c1d3055c0c43921e1ab8,1,1,1,2,1,2009-08-13 05:22:45,2009-08-13 05:20:02
540e694b139dd034b21de087001ac9b6d7606c94...83b327ba4ec6d29fd59e343b734f642d266aeafc,1,10,14,24,6,2009-08-24 00:11:28,2009-08-20 13:46:55
83b327ba4ec6d29fd59e343b734f642d266aeafc...dbd57f99680eac33626d5058459efd7f118f5170,3,16,0,16,3,2009-08-24 00:11:28,2009-08-20 13:46:56
dbd57f99680eac33626d5058459efd7f118f5170...44a3691362dc71241a5d68d90b07642c46992e4a,6,109,3,112,15,2009-08-24 00:11:28,2009-08-20 13:46:57
44a3691362dc71241a5d68d90b07642c46992e4a...b4d1690df11ae6ce382b93778616b1a20f1774ff,8,199,26,225,14,2009-08-24 00:13:32,2009-08-20 13:46:58
b4d1690df11ae6ce382b93778616b1a20f1774ff...52030836943c0d28d8be4202762ede28e921dc21,2,148,2,150,3,2009-08-24 00:13:32,2009-08-20 13:46:59
52030836943c0d28d8be4202762ede28e921dc21...b5041c5f3b9ea70ce7aa9711af6ed6f2d02909b0,1,2,3,5,2,2009-08-24 00:13:32,2009-08-20 13:47:00
b5041c5f3b9ea70ce7aa9711af6ed6f2d02909b0...c28b3d6e7b0471a02f81324a90b26effae0f4bde,6,95,22,117,16,2009-08-24 00:13:33,2009-08-20 13:47:01
c28b3d6e7b0471a02f81324a90b26effae0f4bde...32f54ca31747c47f56abb7ae87a6da0f5b8d97c3,1,2,0,2,1,2009-08-24 00:13:33,2009-08-20 13:47:02
32f54ca31747c47f56abb7ae87a6da0f5b8d97c3...c84de70781674a35b9bfd20aa5bc8c47582615df,1,6,0,6,1,2009-08-24 00:13:33,2009-08-20 13:47:03
c84de70781674a35b9bfd20aa5bc8c47582615df...cb097534230a6bd7438e19ce6dff719697cbf983,2,20,16,36,7,2009-08-24 00:13:33,2009-08-20 13:47:04
cb097534230a6bd7438e19ce6dff719697cbf983...ed5336a7541e19b267de53afc8d15cffdbde8286,1,44,0,44,1,2009-08-24 00:13:33,2009-08-20 13:47:05
ed5336a7541e19b267de53afc8d15cffdbde8286...e663db2f446b84bfe39b4dcb3d26b33826d52c1a,2,11,1,12,3,2009-08-24 00:13:33,2009-08-20 13:47:06
e663db2f446b84bfe39b4dcb3d26b33826d52c1a...35a5aa79d040e2121b6f6bbb17b173f4644699e3,1,18,5,23,4,2009-08-24 00:13:33,2009-08-20 13:47:07
35a5aa79d040e2121b6f6bbb17b173f4644699e3...08aefc9e47eb2eaf231352223c939d69b0fb3759,7,48,7,55,14,2009-08-24 00:14:41,2009-08-20 13:47:08
08aefc9e47eb2eaf231352223c939d69b0fb3759...e800ec9d72a0fafbc323c41e90f7757062c2680e,2,83,1,84,7,2009-08-24 00:14:41,2009-08-20 13:47:09
e800ec9d72a0fafbc323c41e90f7757062c2680e...f1f523eae99020d58ad6e7a1ef8187569e15c270,1,12,0,12,3,2009-08-24 00:14:41,2009-08-20 13:47:10
f1f523eae99020d58ad6e7a1ef8187569e15c270...a5d07d0f5c838acb2c9d69a19907c50f72848b3b,2,8,2,10,4,2009-08-24 00:14:42,2009-08-20 13:47:11
a5d07d0f5c838acb2c9d69a19907c50f72848b3b...d6b38f61c8125423abdf2b9c10f2187c5fecd80e,1,154,0,154,1,2009-08-24 00:14:42,2009-08-20 13:47:12
d6b38f61c8125423abdf2b9c10f2187c5fecd80e...9e1afb16753d583a696c988d33f45655f81e8f7c,2,10,7,17,6,2009-08-24 00:14:42,2009-08-20 13:47:13
9e1afb16753d583a696c988d33f45655f81e8f7c...bbbe508d771f6a4c65fea43343597ecfa1eb540e,1,0,0,0,0,2009-11-26 00:08:22,2009-11-25 22:46:16
bbbe508d771f6a4c65fea43343597ecfa1eb540e...56cac48c3550de88d71b3944576d44337261d71b,5,26,9,35,12,2009-12-14 22:03:58,2009-12-14 11:43:58
56cac48c3550de88d71b3944576d44337261d71b...7fce6e3c9a3cf652099ee5f0e52b59c407692044,2,9,6,15,6,2009-12-14 22:05:34,2009-12-14 11:43:59
7fce6e3c9a3cf652099ee5f0e52b59c407692044...a67e28116287ea84b162b22a5b69ec02ebd34023,1,17,1,18,2,2009-12-31 07:10:53,2009-12-30 14:11:44
a67e28116287ea84b162b22a5b69ec02ebd34023...cd83ac4156a211e019b47fa58de0784cee547ddf,1,12,0,12,1,2010-01-07 02:28:11,2010-01-04 12:34:14
cd83ac4156a211e019b47fa58de0784cee547ddf...8740773ee5ef450cefd03d3576f348fe65e92edf,2,13,0,13,2,2010-01-07 02:29:23,2010-01-04 12:34:15
3f189d0ffca46dda01be99a7a8f36b7efacb0a8a...61f36a79da11accfaaab986bf65453ed30fdbd9f,1,3,3,6,2,2009-08-19 03:47:11,2009-08-14 08:11:58
61f36a79da11accfaaab986bf65453ed30fdbd9f...5268f9edc3c86b07a64fcc2679e5ffe39be28d97,2,54,0,54,4,2009-08-19 03:47:37,2009-08-16 21:22:12
5268f9edc3c86b07a64fcc2679e5ffe39be28d97...f3a87d922a0333a56b5a912440aa324883019d81,1,9,0,9,1,2009-08-19 03:51:32,2009-08-18 23:54:40
f3a87d922a0333a56b5a912440aa324883019d81...91e50b2c0a3bfa818454590fcc6a1ef70c3c58d0,1,11,3,14,4,2009-08-19 06:32:28,2009-08-18 21:41:12
618d18b5aa9420fe446f7a1ed69d65fb45fa49b7...85f6b439f2d6ddc468d20f5ab34e11882f00375a,1,1,1,2,1,2010-02-12 17:08:17,2010-02-12 14:11:47
85f6b439f2d6ddc468d20f5ab34e11882f00375a...f93742170248127eec46e6d1afc65da2919480db,1,8,8,16,8,2010-02-12 17:38:02,2010-02-12 09:47:53
f93742170248127eec46e6d1afc65da2919480db...9b4c8b0ae8a71535ff03a4ad88ac8ad67d58d845,1,8,0,8,1,2010-02-12 17:38:20,2010-02-10 20:33:58
d60a6a662fac58f833efde93c962314fd5d83541...ee8f838e0346751b21250f8d107049829b855a98,4,15,2,17,9,2007-07-14 05:47:49,2007-07-13 23:00:42
ee8f838e0346751b21250f8d107049829b855a98...73013afd14c14ba178ab2aaa458168ec1d5506de,5,21,24,45,9,2007-07-14 06:14:52,2007-07-14 06:14:52
73013afd14c14ba178ab2aaa458168ec1d5506de...b727a235a786423c93ce4f09eee296fbb5a919d1,1,8,0,8,1,2007-07-14 06:22:52,2007-07-14 06:03:37
b727a235a786423c93ce4f09eee296fbb5a919d1...1701872fc2cfc48c740175848c1ef6fc10eb0e10,1,9,2,11,3,2007-07-14 06:48:03,2007-07-14 06:48:03
1701872fc2cfc48c740175848c1ef6fc10eb0e10...bdecd9d41b3528e17aea2290344c584412e2424e,3,62,7,69,7,2007-07-14 06:52:46,2007-07-13 17:41:38
bdecd9d41b3528e17aea2290344c584412e2424e...9d6f220cc8ffbd71b4c68765b52c3a7c41dd729b,4,8,7,15,6,2007-07-14 08:07:44,2007-07-14 08:05:43
9d6f220cc8ffbd71b4c68765b52c3a7c41dd729b...af6861b14488a91ab932c63852979eaf78b549d2,1,38,0,38,1,2007-07-14 20:43:49,2007-07-14 20:43:09
af6861b14488a91ab932c63852979eaf78b549d2...94008931716e9db59afcc82cf5319f8278e5a907,1,3,0,3,3,2007-07-14 20:44:58,2007-07-14 20:44:58
94008931716e9db59afcc82cf5319f8278e5a907...46cf98baa5a1d74a9d00dc1092b29e4af93e8615,1,4,1,5,2,2007-07-14 20:47:08,2007-07-14 19:40:32
46cf98baa5a1d74a9d00dc1092b29e4af93e8615...baffc0e7708de1655665d150081e8880501736fe,12,17,5,22,17,2007-07-15 05:44:09,2007-07-14 23:14:45
baffc0e7708de1655665d150081e8880501736fe...a82830a4577dfe93d329918e7624741fee13842c,1,1,1,2,1,2007-07-15 05:56:47,2007-07-15 05:56:47
69a9b41c15f25e1e91df5d9c4d5e3d56706f8f0e...e1abc69b72401c5b2eb0e402e0fe10e8e0e5db27,1,6,5,11,5,2007-07-21 06:36:39,2007-07-21 06:11:19
e1abc69b72401c5b2eb0e402e0fe10e8e0e5db27...6368f3f8e701cb080b83ceb8ee622636046c514c,2,55,10,65,7,2007-07-21 23:04:13,2007-07-21 17:09:41
6368f3f8e701cb080b83ceb8ee622636046c514c...a3c8ab30a54c30a6a434760bedf04548425416ef,1,116,50,166,23,2007-07-22 05:29:28,2007-07-21 23:30:27
a3c8ab30a54c30a6a434760bedf04548425416ef...a644ffde0afabc873863ac57d9fdaf5f605f50b7,1,2,2,4,1,2007-07-22 05:37:56,2007-07-22 05:37:56
a644ffde0afabc873863ac57d9fdaf5f605f50b7...98ec4ad7f908a6df8c2d4eedf309c06fe840c5c3,1,14,8,22,5,2007-07-22 06:04:20,2007-07-21 23:53:49
98ec4ad7f908a6df8c2d4eedf309c06fe840c5c3...e5633cbb8577b430f175f62cf4e7ed53f2434a89,2,8,5,13,5,2007-07-22 08:38:26,2007-07-22 06:18:33
e5633cbb8577b430f175f62cf4e7ed53f2434a89...c4640fe8d9e25fd3e206a39233c71a6dbb68917e,1,4,1,5,1,2007-07-22 08:40:21,2007-07-22 08:23:05
c4640fe8d9e25fd3e206a39233c71a6dbb68917e...16a7fcfe5e568b50ddebe2369600e71da67d1405,2,15,3,18,2,2007-07-22 22:59:27,2007-07-22 20:20:26
16a7fcfe5e568b50ddebe2369600e71da67d1405...a781785d8f1eb7adf05a24b121104716a086a67a,1,20,7,27,8,2007-07-22 23:35:50,2007-07-22 21:41:20
a781785d8f1eb7adf05a24b121104716a086a67a...7296096c9d7e9fa12901c02fd1d12f4f996043e2,1,2,0,2,1,2007-07-24 05:38:50,2007-07-24 00:03:26
7296096c9d7e9fa12901c02fd1d12f4f996043e2...dfa49f33489dbb142bcc796a4e932863f9dcce1f,1,34,16,50,17,2007-07-24 06:04:15,2007-07-23 22:45:49
dfa49f33489dbb142bcc796a4e932863f9dcce1f...3b38ec16d51a84bb5d4ef349f441de5f7ecd54f2,1,7,7,14,7,2007-07-24 06:06:12,2007-07-24 02:18:28
3b38ec16d51a84bb5d4ef349f441de5f7ecd54f2...dfd05e38f07f76505158399cc433b0b1870a769a,3,182,60,242,40,2007-07-24 06:15:09,2007-07-23 17:34:13
dfd05e38f07f76505158399cc433b0b1870a769a...8e64006eee9c82eba513b98306c179c9e2385e4e,2,17,0,17,3,2007-07-24 06:57:50,2007-07-23 23:38:40
8e64006eee9c82eba513b98306c179c9e2385e4e...1cffddd654d3c094b632e3c41b0ed4641cfa33df,2,6,1,7,2,2007-07-24 07:47:05,2007-07-24 07:46:35
1cffddd654d3c094b632e3c41b0ed4641cfa33df...1130845be8b72aa47b7264186c16d788d52fda63,1,4,4,8,4,2007-07-24 08:58:56,2007-07-24 08:58:51
1130845be8b72aa47b7264186c16d788d52fda63...93c22eeb30d2f43fc1e7a397e71f9bf8fb767962,1,113,111,224,18,2007-07-24 10:16:26,2007-07-24 10:12:47
93c22eeb30d2f43fc1e7a397e71f9bf8fb767962...3473e7df5f8c7f8dc3e2c3f2fdc99a1d1a719c16,1,10,3,13,1,2007-07-25 00:26:04,2007-07-24 23:19:58
3473e7df5f8c7f8dc3e2c3f2fdc99a1d1a719c16...24d00634948452d0bec1b373b6a2eb9145fc8bfc,1,1,1,2,1,2007-07-25 00:28:10,2007-07-24 21:29:29
24d00634948452d0bec1b373b6a2eb9145fc8bfc...1843d8d545de0e94dc4c7d3c9125fb47a99962c4,1,3,9,12,5,2007-07-25 00:28:10,2007-07-24 21:54:25
1843d8d545de0e94dc4c7d3c9125fb47a99962c4...f836f1ae9b1535d6a1aeb4a0e8a33d65edaf9ff8,1,5,0,5,1,2007-07-25 00:28:10,2007-07-24 22:56:20
f836f1ae9b1535d6a1aeb4a0e8a33d65edaf9ff8...2d8ae400d134c326f3ab0ec15ae522fb74cd0b1d,1,1,1,2,1,2007-07-25 00:28:10,2007-07-24 14:50:38
2d8ae400d134c326f3ab0ec15ae522fb74cd0b1d...7b69b873faf3cfd592bb64a496c6982a540aa7ea,3,9,7,16,7,2007-07-25 00:28:10,2007-07-23 23:39:50
7b69b873faf3cfd592bb64a496c6982a540aa7ea...af66366a9feb0194ed04b1f538998021ece268a8,1,9,0,9,2,2007-07-25 00:28:10,2007-07-24 18:18:34
af66366a9feb0194ed04b1f538998021ece268a8...d1cc130a5eb50d5bfe1e8b76cab3d8970fd70ad1,6,163,5,168,11,2007-07-25 03:46:54,2007-07-23 04:17:42
d1cc130a5eb50d5bfe1e8b76cab3d8970fd70ad1...ca193cf1ad5bf8982db2e42abb2fa713011ee726,1,6,0,6,1,2007-07-25 03:48:04,2007-07-24 00:02:25
ca193cf1ad5bf8982db2e42abb2fa713011ee726...c4eaed49c22366f1994a75179adeac47e7863794,1,39,25,64,8,2007-07-25 07:06:38,2007-07-25 06:25:38
c4eaed49c22366f1994a75179adeac47e7863794...1c911dc86cd8c504fbad98a75b28cbc92317a0e8,1,2,2,4,2,2007-07-25 07:06:38,2007-07-24 18:59:47
1c911dc86cd8c504fbad98a75b28cbc92317a0e8...ceefa44fe2d72f73548c4c36b42916b9c60ae16b,1,1,1,2,1,2007-07-25 07:06:38,2007-07-24 10:02:28
ceefa44fe2d72f73548c4c36b42916b9c60ae16b...f48a203a563ae8a46daa8b8923b5d81dc40502fb,1,33,3,36,6,2007-07-25 07:06:53,2007-07-25 04:39:33
f48a203a563ae8a46daa8b8923b5d81dc40502fb...4eb994733d75d40cab87e7b4736166cf33e7787a,1,7,0,7,1,2007-07-25 20:27:26,2007-07-25 10:08:17
4eb994733d75d40cab87e7b4736166cf33e7787a...ceff079bdcaebb67b0379a1036a32b4dfebb6012,2,8,0,8,2,2007-07-25 22:34:52,2007-07-25 22:32:22
ceff079bdcaebb67b0379a1036a32b4dfebb6012...887c5266d64e0a724986af1610985bb42af5bd47,1,1,1,2,1,2007-07-25 22:50:42,2007-07-25 22:49:55
887c5266d64e0a724986af1610985bb42af5bd47...537601ac74db2d93665b20a67ba05851703bb2c3,1,5,2,7,1,2007-07-25 22:51:26,2007-07-25 22:51:26
537601ac74db2d93665b20a67ba05851703bb2c3...b2d2d16af7ff686fb96d344daaf49653fd67366a,1,2,1,3,1,2007-07-25 23:06:54,2007-07-25 07:31:38
b2d2d16af7ff686fb96d344daaf49653fd67366a...1a44be9a0ff6fa623ff6061992f5ad1831dc7cab,1,0,1,1,1,2007-07-25 23:13:55,2007-07-25 23:13:55
1a44be9a0ff6fa623ff6061992f5ad1831dc7cab...d58e8d34b019d435b424811c6f972910dfac6f55,1,13,0,13,1,2007-07-25 23:22:55,2007-07-25 23:22:55
d58e8d34b019d435b424811c6f972910dfac6f55...e7a7be8831b159b9a7331b34c3ec6915d4a72190,2,11,15,26,3,2007-07-26 04:34:53,2007-07-26 04:34:53
e7a7be8831b159b9a7331b34c3ec6915d4a72190...b87841e1645f900fbec0a937a45f98b70b5684ca,1,2,0,2,1,2007-07-26 04:35:17,2007-07-26 03:14:54
b87841e1645f900fbec0a937a45f98b70b5684ca...91e1ee776283a238cc135fbbfc3f812492bcbd86,1,3,1,4,3,2007-07-26 06:38:43,2007-07-26 06:35:51
91e1ee776283a238cc135fbbfc3f812492bcbd86...654a7ccc56f5dee3d11fbf6e928c14402c7495de,1,3,1,4,1,2007-07-26 06:45:42,2007-07-26 06:45:42
654a7ccc56f5dee3d11fbf6e928c14402c7495de...383e45cec40a0b881e59e44e011c410218ef476a,2,5,3,8,2,2007-07-26 23:57:24,2007-07-26 20:34:59
383e45cec40a0b881e59e44e011c410218ef476a...7ab3cc70a6aad2e4f8ccaa98e5520aa126eaef8f,1,4,3,7,1,2007-07-27 06:24:28,2007-07-27 06:24:28
69a9b41c15f25e1e91df5d9c4d5e3d56706f8f0e...62e09ce998dd7f6b844deb650101c743a5c4ce50,7,538,13,551,21,2007-07-20 08:27:25,2007-07-19 23:42:28
62e09ce998dd7f6b844deb650101c743a5c4ce50...4d87b9c5db2590f7616fedfc0a538fc78f528e14,4,15,3,18,6,2007-07-21 23:51:14,2007-07-20 12:06:09
4d87b9c5db2590f7616fedfc0a538fc78f528e14...e317cfafd247b279055e9ee64a6a982043bd06e7,2,57,16,73,15,2007-07-21 23:59:33,2007-07-21 12:13:12
e317cfafd247b279055e9ee64a6a982043bd06e7...2ae68fcb785a617793813abcea19893e13e436b0,6,115,3,118,7,2007-07-27 05:51:27,2007-07-27 04:07:34
2ae68fcb785a617793813abcea19893e13e436b0...f653aee5a37b909e772d612eb7e226f09fd2f3d3,3,15,2,17,5,2007-07-27 05:51:44,2007-07-23 11:58:27
fb626dc00044c106652ae39300b4cb613af70ab1...4e817d1ac4f10916343a2610a55f5af8bc949f65,2,8,7,15,3,2007-06-22 05:10:12,2007-06-22 05:10:12
4e817d1ac4f10916343a2610a55f5af8bc949f65...fffaaba3588b0da14f4e3265540d400859aad49e,1,5,1,6,1,2007-06-27 04:27:13,2007-06-27 04:27:13
fffaaba3588b0da14f4e3265540d400859aad49e...7e508eb1a2efce72be1651a35ab3150bfa3c88d6,1,1,2,3,1,2007-06-27 04:35:30,2007-06-26 19:27:35
29cf5e1245344b8827ffc0bbcb6f712a3ccc647d...99f171bb7ac5032dde256c02476240c0d019a5fe,1,5,5,10,3,2007-06-10 20:38:50,2007-06-05 22:33:27
99f171bb7ac5032dde256c02476240c0d019a5fe...1da158ea339e863a1907225501f9153df5741db0,1,1,1,2,1,2007-06-10 20:38:50,2007-06-05 08:47:51
1da158ea339e863a1907225501f9153df5741db0...8ceca74a39788eeda64e9aa625fdebaad219ab42,1,1,0,1,1,2007-06-10 20:38:50,2007-06-05 22:42:58
8ceca74a39788eeda64e9aa625fdebaad219ab42...d9bd321c7b1e2bfff696e10d56eac5b559240e22,1,4,0,4,1,2007-06-10 20:39:53,2007-02-06 07:55:07
d9bd321c7b1e2bfff696e10d56eac5b559240e22...23c9ccb215709422f9dff2ace6cf460ceb1e61dc,1,2,2,4,1,2007-06-10 20:46:17,2007-06-10 20:20:34
abc403f58452da667b261274a1091af61dfec35c...693b63273e05b5db4612178989271de14439b08f,3,143,6,149,10,2007-06-08 09:56:18,2007-06-07 14:57:01
693b63273e05b5db4612178989271de14439b08f...fd1cd91e9407bccba3380dad6dcb60c4154d94a2,2,7,4,11,4,2007-06-16 05:38:45,2007-06-15 01:01:52
fd1cd91e9407bccba3380dad6dcb60c4154d94a2...226bccb9ad42441269507a2101b47424d7c9c477,3,25,2,27,4,2007-06-16 05:38:48,2007-06-15 01:01:53
4f01d0f92db5cb38aaaab83adb50557beb35fb91...18a936805e82d769e33ea0dd866f8fe12ef1827e,1,1,1,2,1,2007-06-16 05:43:58,2007-06-13 23:12:20
18a936805e82d769e33ea0dd866f8fe12ef1827e...fa0c87c34471286b6c261c781a45ed090135295c,3,31,0,31,4,2007-06-16 05:48:34,2007-06-13 18:54:32
fa0c87c34471286b6c261c781a45ed090135295c...634cd48a8afdd920fa26c8ec3ae43e96c82c81f2,4,11,17,28,7,2007-06-16 06:27:23,2007-06-05 02:36:11
634cd48a8afdd920fa26c8ec3ae43e96c82c81f2...fadf488f9b8c4fc709f0b083d2769ecc1e0e1119,2,20,0,20,2,2007-06-16 06:28:10,2007-06-05 02:36:49
fadf488f9b8c4fc709f0b083d2769ecc1e0e1119...1367214417ee55266ab951cf198bf1aa7e051965,1,2,2,4,2,2007-06-16 06:33:06,2007-06-16 06:33:06
1367214417ee55266ab951cf198bf1aa7e051965...7b99befef7d0ae173980f531e80916126011ca41,2,53,30,83,12,2007-06-16 06:35:32,2007-06-16 06:35:32
7b99befef7d0ae173980f531e80916126011ca41...66e41f7b9912b3c9231c6577891eb12886d430e3,1,2,1,3,1,2007-06-16 06:48:35,2007-06-16 06:48:35
66e41f7b9912b3c9231c6577891eb12886d430e3...4c7100a9f438c281c18c800b450ea12045d22d62,5,14,4,18,6,2007-06-16 08:11:16,2007-06-15 05:20:16
4c7100a9f438c281c18c800b450ea12045d22d62...c7c84859ad586ae5670224e1abc4f846f7c3a9ae,3,63,2,65,3,2007-06-16 08:13:35,2007-06-16 06:58:18
d44c782bbd6b0e806e056f9e8ff8cd8e426e67a3...a6080a0a44d5ead84db3dabbbc80e82df838533d,256,645,852,1497,496,2007-06-07 07:04:01,2007-06-07 07:04:01
d44c782bbd6b0e806e056f9e8ff8cd8e426e67a3...5c08931dfc9fa0acbf8667581e4c98d643e66dbe,1,2,24,26,2,2007-06-06 23:14:28,2007-06-03 06:56:36
d44c782bbd6b0e806e056f9e8ff8cd8e426e67a3...4faac2468de86f4dfd482d55d7c9adc7f2796f07,1,4,0,4,1,2007-06-06 23:07:53,2007-06-03 14:46:04
4faac2468de86f4dfd482d55d7c9adc7f2796f07...493c774e58a05bbbac06e4ae1654ca3d24e4e5cf,4,10,7,17,4,2007-06-06 23:07:53,2007-06-03 14:46:36
493c774e58a05bbbac06e4ae1654ca3d24e4e5cf...dace6e44f6599495eb4317efa90885b6eba5c62e,1,72,0,72,1,2007-06-06 23:07:53,2007-06-06 07:01:21
dace6e44f6599495eb4317efa90885b6eba5c62e...892c41b98ae2e6baf3aa13901cb10db9ac67d2f3,9,204,57,261,25,2007-06-06 23:07:53,2007-06-06 07:10:42
892c41b98ae2e6baf3aa13901cb10db9ac67d2f3...7ae3df8c0aa3b7337ae9ac7b6184ac05985bf996,5,14,14,28,11,2007-06-06 23:07:53,2007-06-03 14:48:16
7ae3df8c0aa3b7337ae9ac7b6184ac05985bf996...6c56049ff6b0f59df8a2e23bc83e10c50d9d0218,1,17,12,29,13,2007-06-06 23:07:53,2007-06-06 07:13:26
6c56049ff6b0f59df8a2e23bc83e10c50d9d0218...3ae4a867d37237e8f8156be1409a4a992bd37fb0,1,92,0,92,1,2007-06-06 23:07:53,2007-06-06 07:14:25
3ae4a867d37237e8f8156be1409a4a992bd37fb0...f4f51add2712293b7bc9e7aaebf6a589bb37c7c7,1,5,0,5,2,2007-06-06 23:07:53,2007-06-06 21:29:59
d44c782bbd6b0e806e056f9e8ff8cd8e426e67a3...3af51928ab7cefa35048e3a5a9e78a127749d405,1,35,12,47,10,2007-06-06 23:04:02,2007-06-03 18:21:41
9f30855d0ff5206e85e45f0307be9d18ffda41d3...5771907a5745799c559ff21ccfcabfd21cc23b36,2,10,1,11,3,2007-06-05 06:10:29,2007-06-05 02:37:13
3520e1e86878c6787c3abfe677e6472ce2c97f66...685ef546b62d063c72b401cd38b83a879301aac4,2,54,3,57,7,2007-06-09 19:16:49,2007-06-08 00:30:35
685ef546b62d063c72b401cd38b83a879301aac4...813b4734fcb82e541658b33b8563387c197d6247,1,7,17,24,6,2007-06-09 19:20:20,2007-06-08 21:28:39
813b4734fcb82e541658b33b8563387c197d6247...cfabd6eee1745cfec58cfcb794ce8847e43b888a,2,22,1,23,2,2007-06-09 19:24:16,2007-06-08 21:28:50
c56ed464b0ba275d9f2e3598c61b391e98fc217b...99b5a79e1329468bee26ae3bd9070c47418279d0,1,38,28,66,12,2007-05-27 03:00:55,2007-05-26 16:25:31
49c3e926349e964b311b46251bb2b97d3d669855...e50cd67ba477133458158a016ffabb8e4bfc81bf,1,1,1,2,1,2014-11-06 17:51:08,2014-11-06 07:40:32
49c3e926349e964b311b46251bb2b97d3d669855...729dbbd9fc715fac1fc7cd8b603f0a7d625f2dfc,1,2,0,2,1,2014-10-30 18:17:51,2014-10-29 17:11:58
98349e5364da6164add4ede3e63ceba2cc39159b...15c6ef7b06e57746c7d8ec81c0a125df54434b60,2,2,7,9,3,2014-10-20 19:04:46,2014-10-20 19:04:46
98349e5364da6164add4ede3e63ceba2cc39159b...19a583dc39e3e1110f746e837c5ce1953d6ebfa1,3,13,1,14,8,2014-10-19 22:26:31,2014-10-19 11:13:55
19a583dc39e3e1110f746e837c5ce1953d6ebfa1...a915459097b72da9cc058172a54029352b684b0f,5,25,38,63,19,2014-10-19 22:26:34,2014-10-19 11:14:20
9d04401ffe18138138e8f765c2bb31420f3efe25...13da0fc092b8cf082eda2f16971c75903aa5aefc,1,17,5,22,4,2014-10-20 20:07:32,2014-10-20 20:07:32
30ba3809a4670c99c73800393ce29473c84c8521...9354768ab7a349f0df7c8aa08e6fe98547882809,1,1,1,2,1,2007-06-12 07:23:31,2007-06-11 08:02:17
9354768ab7a349f0df7c8aa08e6fe98547882809...d52fd42acd77613970dc8eef2c589fff6cc1e330,3,3,3,6,3,2007-06-12 07:23:31,2007-06-11 09:10:47
d52fd42acd77613970dc8eef2c589fff6cc1e330...ca6c097089a38d447de0190ea61e9746a40a170c,2,6,3,9,4,2007-06-12 08:00:38,2007-06-11 20:12:19
f7b47b273ed2c9e9b298c4f5dd02884b46dfbced...078f8380f65acfdffee077a642e982453277873a,1,2,1,3,2,2007-05-20 21:39:16,2007-05-20 12:19:17
078f8380f65acfdffee077a642e982453277873a...1472966c04103874096fb786657459ea6628e451,1,2,4,6,3,2007-05-20 21:40:34,2007-05-20 13:35:46
1472966c04103874096fb786657459ea6628e451...0a76f6652459e4bbf5311347e9bf726e203e86d6,1,0,4,4,1,2007-05-20 21:40:41,2007-05-20 17:26:37
0a76f6652459e4bbf5311347e9bf726e203e86d6...cab333cb6ac0ac857dcfb112989ea32aea5d0ec1,1,34,0,34,1,2007-05-20 23:00:22,2007-05-20 22:12:57
cab333cb6ac0ac857dcfb112989ea32aea5d0ec1...0cb21911f49176866ee5170e292d351f4697634e,1,9,8,17,3,2007-05-20 23:00:23,2007-05-20 22:12:58
0cb21911f49176866ee5170e292d351f4697634e...5b6dedd6a0b7566f7e8466b6aefe8f019c52f5d3,1,1,1,2,1,2007-05-21 02:56:28,2007-05-21 02:56:28
125a5f1c2a93f217e92dd88210c2cb503032c02f...9159afbfce955db86373dab95b5f8e31fb763dae,2,2,2,4,2,2007-05-06 08:07:04,2007-05-06 08:07:04
9159afbfce955db86373dab95b5f8e31fb763dae...bc3561f35991f97adfa2b22a8a5093f19717c71f,1,5,1,6,2,2007-05-07 07:14:53,2007-05-06 21:11:55
bc3561f35991f97adfa2b22a8a5093f19717c71f...e701ccc3883959b4ba5fada7a903e8e9eaddcba7,1,5,1,6,2,2007-05-07 07:15:00,2007-05-06 21:11:56
55c6e6dc38188d27b4ec0315db93d6c40725cdd6...ae3f7218b9829ac4b7031f4a2735ab391ca69b3c,1,1,1,2,1,2010-08-22 05:09:13,2010-08-21 16:18:37
ae3f7218b9829ac4b7031f4a2735ab391ca69b3c...0eb032d86c99ac8f23435ad5ea9f2b83f1be744f,1,2,2,4,2,2010-08-22 06:00:31,2010-08-18 21:20:33
26517dea245cc6332ffb80cf7747f6c211aa2e4d...5cd3e10737135163f47e97e0338dbf33f4772511,1,2,1,3,2,2010-12-28 19:22:16,2010-12-27 08:03:43
cb198b3b67feb2c0a6f22199ec14fa48d18ac1ce...d5f53338ab2ee29c588f46d5cb28d7e3b25018f2,2,48,4,52,2,2012-07-11 16:25:56,2012-07-11 16:08:28
cb198b3b67feb2c0a6f22199ec14fa48d18ac1ce...ab4356111afb28568bf1ad2e909b6ecf9f83a5e6,1,33,0,33,1,2011-01-10 18:00:14,2011-01-09 20:10:04
cb198b3b67feb2c0a6f22199ec14fa48d18ac1ce...ea640cc691d56f7151c5ba654b09c4a987dbef93,2,52,2,54,4,2011-01-10 17:10:54,2011-01-10 10:37:26
cb198b3b67feb2c0a6f22199ec14fa48d18ac1ce...fc7642a096b99295a636ebde03e4b951a7da9c5a,1,1,1,2,1,2011-01-10 17:07:24,2011-01-10 12:57:43
04df568be53c42d07aea393effc7c5653f245d9a...ef5644ea6ecec4ee6d6254612af2ed58499ac2fe,1,4,1,5,1,2010-09-10 00:18:04,2010-09-09 19:02:45
ef5644ea6ecec4ee6d6254612af2ed58499ac2fe...1b6ecbad3511b1aaa65172ef8b520dd3b5141614,1,2,3,5,1,2010-09-10 00:18:29,2010-09-09 19:02:46
04df568be53c42d07aea393effc7c5653f245d9a...5b220a6876f37d6c88d1d7a54ec115efc1e25255,1,1,0,1,1,2010-09-10 00:09:44,2010-09-09 18:49:51
04df568be53c42d07aea393effc7c5653f245d9a...a03bc5b6ad4ada4eb0669289429a9bc21ff6cdb0,2,49,0,49,5,2010-09-08 16:11:15,2009-06-08 21:34:12
347c47e61e5daf1efb3503724a431e4316c6eb5b...18a826924284339e2b637ab747f196235bee1939,22,260,192,452,66,2010-09-09 22:56:20,2010-09-07 01:42:54
18a826924284339e2b637ab747f196235bee1939...dbedf8bf42f63847b096aeb7d6b96cf3a2233b7a,1,82,58,140,29,2010-09-09 22:58:32,2010-09-07 01:47:07
dbedf8bf42f63847b096aeb7d6b96cf3a2233b7a...76bbcd4382797dedb72a50387111a65d88230fa9,1,1,1,2,1,2010-09-09 22:58:45,2010-09-07 01:49:10
76bbcd4382797dedb72a50387111a65d88230fa9...8fe5aeddcbeb194ea0f6e23e1f7b4ac38809921b,1,40,24,64,6,2010-09-09 23:01:10,2010-09-07 01:52:27
8fe5aeddcbeb194ea0f6e23e1f7b4ac38809921b...a814615a6a1722839c69dcc998ed4fae9da08310,1,1,1,2,1,2010-09-09 23:02:47,2010-09-07 08:22:53
a814615a6a1722839c69dcc998ed4fae9da08310...fd3c32c9815441ebbc3d46a3ff4ef862b3a9688c,1,50,41,91,20,2010-09-09 23:03:11,2010-09-07 10:29:20
4682693e9ccc04252d0fad6f5627fc056abcdbba...c2e0940b44ded03f0af02be95c35b231fea633c1,2,4,4,8,3,2010-09-06 21:27:35,2010-09-06 18:41:06
593ce2bea5dad436e87b5dd37c205961d73feae9...6b3020a241e2c0a1eaa6b74a10a796603bb90975,2,7,2,9,3,2010-12-01 21:40:12,2010-12-01 18:36:15
593ce2bea5dad436e87b5dd37c205961d73feae9...9474a029d5817a9a5a0f96cf257fa95befd93e62,1,2,1,3,1,2010-11-29 22:49:54,2010-11-09 20:59:00
593ce2bea5dad436e87b5dd37c205961d73feae9...b7c1ce4f14f37600a8a5bf8d81e0a723d42644b9,1,2,7,9,4,2010-11-24 19:25:16,2010-11-23 07:53:48
593ce2bea5dad436e87b5dd37c205961d73feae9...8837d33595b78dc4a52038856bc9a5c3f4b2ff50,2,10,1,11,2,2010-10-17 01:57:35,2010-10-10 17:24:06
593ce2bea5dad436e87b5dd37c205961d73feae9...f7bff00314f473be1ef6c166e91447fabd1822d8,1,11,10,21,3,2010-08-02 21:40:48,2010-08-02 21:37:06
ddd02b70f0d80fc3cac6b2f2c42005560d572413...ebdc94f3bec7ec54babb21b1d785af0cd75b21e6,3,159,0,159,6,2010-04-21 08:15:33,2010-04-20 20:48:39
ebdc94f3bec7ec54babb21b1d785af0cd75b21e6...f70d0586d68c41304e7ff95c7fa2a06b74896e77,1,1,1,2,1,2010-06-06 17:16:30,2010-06-03 23:17:33
f70d0586d68c41304e7ff95c7fa2a06b74896e77...57456ef459f137cf81c1875f771ab9485b1fa810,1,48,2,50,3,2010-06-06 17:16:31,2010-06-03 23:17:35
57456ef459f137cf81c1875f771ab9485b1fa810...97b03c353856602a3c30b01baae1efb8dfe4243e,1,1,1,2,1,2010-06-06 17:16:35,2010-06-03 23:17:36
97b03c353856602a3c30b01baae1efb8dfe4243e...cb7529e13bce186f8b883c9fbb08602cd3a0795f,2,18,0,18,3,2010-06-06 17:16:37,2010-06-03 23:17:37
937491944292fa3303b565b9bd8914c6b644ab13...851c34b04e0ce866e15c28e144986eca7533a6f4,3,10,5,15,6,2010-05-09 05:27:54,2010-05-08 15:13:49
851c34b04e0ce866e15c28e144986eca7533a6f4...3a0942598ce33b195bfaaf250b2da23e4eceb3c6,1,6,0,6,3,2010-05-09 05:28:01,2010-05-08 15:18:06
5deb15e47e1e14ded0c586da4bff88e33d11f301...66cfd1026ffadc9dd7053823196af7578aa112bf,4,17,3,20,5,2010-04-23 06:04:21,2010-04-23 05:46:24
6d84bcb5de78251d98f7d3e80e822d9a4b8f4df3...b91a8a3ee17629ca7b9806fede2937232a05116c,1,1,0,1,1,2010-03-04 09:45:15,2010-03-03 20:34:31
b91a8a3ee17629ca7b9806fede2937232a05116c...3acae29e81d6c1efb06b9c71e630f7f5543f1213,1,2,1,3,2,2010-03-04 09:45:15,2010-03-03 20:34:32
241b9254e1c8ff071d8054f8b6fbe1883b389d69...81b50f3ce40bfdd66e5d967bf82be001039a9a98,90,97,97,194,7,2010-02-22 22:29:41,2010-02-22 16:42:18
9b11d24d4156e0b2246383faad16eb8aa0caeefb...e4b023332c687d824cff41855b41f604ee72e0d2,1,1,0,1,1,2007-04-13 00:46:51,2007-04-12 18:52:03
01aaf1f88ddc2b99162c302710339f202996f39b...e77235ea38385a127d2afc969435a56d3ff2b16d,1,1,1,2,1,2006-08-13 08:46:28,2006-08-13 07:34:37
e77235ea38385a127d2afc969435a56d3ff2b16d...9a1ae9ab03abaffc977421f182997f3e735e7098,1,5,1,6,1,2006-08-13 08:46:28,2006-08-13 08:41:22
280242d1cc1fe2847f649d2f16b273e168fcbc48...4d62eaabeb283d6dab56cfb2f2e54144b98afafd,1,2,2,4,1,2006-07-04 09:55:52,2006-07-04 08:04:24
280242d1cc1fe2847f649d2f16b273e168fcbc48...00449f992b629f7f7884fb2cf46ff411a2a4f381,5,362,177,539,7,2006-07-04 02:42:41,2006-07-03 15:18:43
280242d1cc1fe2847f649d2f16b273e168fcbc48...30a95f30730a5ee738ad6ef17e76e61ad7c1f53e,1,163,0,163,1,2006-07-04 02:12:43,2006-07-04 01:09:54
d7b6c3c0f54b951c85cd41c6e6571c65cf090111...60a144f28047b4fa0e4a795972c483fa85a7d3c8,3,15,2,17,5,2006-08-15 10:13:47,2006-08-15 09:01:31
60a144f28047b4fa0e4a795972c483fa85a7d3c8...3c2f5886c78454276a045c1312eca652c11d98d6,1,151,32,183,23,2006-09-03 05:57:42,2006-09-03 05:57:42
3c2f5886c78454276a045c1312eca652c11d98d6...9594b326dcd6b879807fe6614f55ba50fa3d4551,2,0,42,42,2,2006-09-03 05:58:32,2006-09-03 05:58:32
9594b326dcd6b879807fe6614f55ba50fa3d4551...81a71734bb73c2def1e86de88fb8de9fb6379cc5,7,24,114,138,35,2006-09-03 05:58:48,2006-09-03 05:58:48
81a71734bb73c2def1e86de88fb8de9fb6379cc5...18b0fc1ce1ef92716d4c5d5c7acd5d5a61a0a556,5,15,224,239,21,2006-09-23 21:02:40,2006-09-23 18:20:47
18b0fc1ce1ef92716d4c5d5c7acd5d5a61a0a556...f7661ce0b8ee068e53d57249625199dda2829e30,4,1,22,23,7,2006-09-30 01:52:38,2006-09-29 07:34:51
c2c487cf3a6c37bc9b4e3f0e10ad08d9ce048404...5f468c4805c785115cd9c5f6a8f299f23a9034f5,1,1,1,2,1,2006-07-28 05:15:01,2006-07-28 05:15:01
5f468c4805c785115cd9c5f6a8f299f23a9034f5...dee4e384f376020e08cb78f6dfaf00ae84e97a9e,1,4,1,5,2,2006-07-28 05:27:44,2006-07-28 05:27:44
dee4e384f376020e08cb78f6dfaf00ae84e97a9e...ef1d9c5aa4c8fd57b2a8043c0cd9fea1c507db6a,5,11,7,18,14,2006-07-28 05:55:44,2006-07-28 05:55:44
ef1d9c5aa4c8fd57b2a8043c0cd9fea1c507db6a...2941cab99ca9dec3356f0126be41bc3995bb1fef,1,2,0,2,1,2006-07-28 18:15:35,2006-07-28 09:17:46
2941cab99ca9dec3356f0126be41bc3995bb1fef...e5a94313c06b83e034179ca6092ea23343e48dec,2,77,12,89,17,2006-07-28 18:18:02,2006-07-28 15:46:11
e5a94313c06b83e034179ca6092ea23343e48dec...ab9f30fd7538ec5385bf5a3d11117f23f4f320ee,1,6,0,6,1,2006-07-28 19:21:17,2006-07-28 19:21:17
ab9f30fd7538ec5385bf5a3d11117f23f4f320ee...5afa69b415fd020d6dd36751bdcf45fdbf07dd4a,1,2,2,4,1,2006-07-28 19:23:28,2006-07-28 19:23:28
c2c487cf3a6c37bc9b4e3f0e10ad08d9ce048404...c6b69bdbc1b0b914aa0d1e59a29305fce82d6f06,5,12,17,29,13,2006-07-28 02:33:48,2006-07-27 21:56:14
c6b69bdbc1b0b914aa0d1e59a29305fce82d6f06...4211e4d10cd98b1aeed97bdb6cdebb9411956bb5,5,49,37,86,14,2006-07-28 02:33:48,2006-07-27 21:56:17
4211e4d10cd98b1aeed97bdb6cdebb9411956bb5...8e87ca661513d9f4b737295b234e93767cd2ee0c,4,74,10,84,15,2006-07-28 02:33:48,2006-07-27 21:56:19
8e87ca661513d9f4b737295b234e93767cd2ee0c...8e29f6a07e321a24f1d4f579817f5a8a43cdac05,2,36,17,53,17,2006-07-28 02:33:48,2006-07-27 21:56:22
460cccd3ba1d38fd64c9e83e40d58bcf3e9d7d2c...847e01fb00872401c093957c2d6dd908aa8af30d,1,125,125,250,101,2006-08-14 23:29:28,2006-08-14 00:05:47
847e01fb00872401c093957c2d6dd908aa8af30d...a446d6bb53cb59f559603c411747d7ac5373e326,1,45,35,80,3,2006-08-14 23:56:10,2006-08-14 00:07:00
a446d6bb53cb59f559603c411747d7ac5373e326...17d07443188909ef5f8b8c24043cb6d9fef51bca,2,23,16,39,5,2006-08-15 00:02:42,2006-08-14 00:08:27
17d07443188909ef5f8b8c24043cb6d9fef51bca...581860e1b8ac01c2cdcb5d98862ef7a80e789781,1,60,36,96,2,2006-08-15 00:03:20,2006-08-14 00:09:08
581860e1b8ac01c2cdcb5d98862ef7a80e789781...1e0cf030c047741cab9ef36b91bc2ae57b83e405,1,32,18,50,2,2006-08-15 00:10:52,2006-08-14 00:10:06
1e0cf030c047741cab9ef36b91bc2ae57b83e405...d294e1cad4eef263c7f4912332fd0094e37e95a7,2,47,9,56,11,2006-08-15 00:28:01,2006-08-14 00:14:20
d294e1cad4eef263c7f4912332fd0094e37e95a7...618918e5411e2e769ad5e8d44c5d1cc363b983b5,1,1,0,1,1,2006-08-15 00:30:16,2006-08-14 00:15:22
618918e5411e2e769ad5e8d44c5d1cc363b983b5...d5aa50de621220d7451a5d497479327d2a608009,1,4,1,5,1,2006-08-15 00:33:19,2006-08-14 00:16:33
d5aa50de621220d7451a5d497479327d2a608009...4a4a1a53d1c4a272d4cf0d53116896d057174671,2,146,95,241,3,2006-08-15 00:40:50,2006-08-14 00:18:33
4a4a1a53d1c4a272d4cf0d53116896d057174671...2de21fac9842650fceb3db68f15711e38fabc3c8,2,6,1,7,4,2006-08-15 01:09:33,2006-08-14 22:50:49
2de21fac9842650fceb3db68f15711e38fabc3c8...b4e275992f7ea56b7944abb2b9339c7f6f5c9423,1,1,4,5,1,2006-08-15 01:38:07,2006-08-14 20:18:11
b4e275992f7ea56b7944abb2b9339c7f6f5c9423...b756776d19356a961cc3d1861b15720a6d0e8462,1,1,3,4,1,2006-08-15 01:38:07,2006-08-14 20:22:15
b756776d19356a961cc3d1861b15720a6d0e8462...9e0ec82cac84e6963d7e4aa229b7464daaed4ef8,1,2,4,6,1,2006-08-15 01:38:07,2006-08-14 20:26:58
9e0ec82cac84e6963d7e4aa229b7464daaed4ef8...8c0b2bb636c15a1cd0adb8bcf3b42497d699c884,1,1,3,4,1,2006-08-15 01:38:07,2006-08-14 20:34:16
8c0b2bb636c15a1cd0adb8bcf3b42497d699c884...0bc87ffb6c8edbb44bd72a4e1a5aa81c64f7eb37,1,1,4,5,1,2006-08-15 01:41:12,2006-08-14 20:37:05
0bc87ffb6c8edbb44bd72a4e1a5aa81c64f7eb37...968a1d65f430e4e8234204c62361e3d21cac810c,1,3,7,10,2,2006-08-15 01:41:12,2006-08-14 20:38:14
968a1d65f430e4e8234204c62361e3d21cac810c...a976b0a5933f37e7e8a1829703705268bc829794,1,2,9,11,3,2006-08-15 01:41:12,2006-08-15 01:36:00
a976b0a5933f37e7e8a1829703705268bc829794...eddd1c8cefa596abbb81ac5a0af21ba104033b3d,1,5,4,9,3,2006-08-15 01:43:49,2006-08-14 20:19:15
eddd1c8cefa596abbb81ac5a0af21ba104033b3d...cf995ede2cf53d70e5de2525184597211c827dc5,1,6,6,12,4,2006-08-15 01:43:49,2006-08-14 20:39:27
cf995ede2cf53d70e5de2525184597211c827dc5...f7f0fbfcf4fb9367a12aba3a205fb5e1276a2800,1,1,2,3,2,2006-08-15 01:59:03,2006-08-14 20:20:12
f7f0fbfcf4fb9367a12aba3a205fb5e1276a2800...b5524c826dc36e5d9d2455cfca85aa62f1a776d1,1,2,3,5,3,2006-08-15 01:59:03,2006-08-14 20:36:18
b5524c826dc36e5d9d2455cfca85aa62f1a776d1...aa145403da905aaa9f129b0f13b5bca7994cb329,1,1,2,3,2,2006-08-15 01:59:03,2006-08-14 20:38:50
aa145403da905aaa9f129b0f13b5bca7994cb329...74b504f67173a9f4dd06f01d109c58ea13f279b4,1,1,2,3,2,2006-08-15 01:59:03,2006-08-14 20:40:06
74b504f67173a9f4dd06f01d109c58ea13f279b4...59076eba6e1a41c2e0032dbd656d8429e9655358,1,5,6,11,2,2006-08-15 01:59:03,2006-08-14 20:40:51
59076eba6e1a41c2e0032dbd656d8429e9655358...78b713a1d0909c8eb8dc0bad5df624c33d065c16,1,2,2,4,2,2006-08-15 02:01:00,2006-08-14 20:32:01
78b713a1d0909c8eb8dc0bad5df624c33d065c16...6a0ebe8ced66b154a48074d3e3321ff1972ec669,1,46,0,46,1,2006-08-15 06:24:55,2006-08-15 06:24:55
6a0ebe8ced66b154a48074d3e3321ff1972ec669...f686d03034c74bd0de2002b7c277a0838662ea00,1,12,16,28,14,2006-08-15 06:26:51,2006-08-15 06:26:51
f686d03034c74bd0de2002b7c277a0838662ea00...f4e14ca9e05876ec1e0d79d7c12b5b3a6b2e9d08,1,0,1,1,1,2006-08-15 09:57:24,2006-08-15 09:01:20
f4e14ca9e05876ec1e0d79d7c12b5b3a6b2e9d08...ab5573ae9f4178a7b6f6920f04c73a65feb3c690,1,4,2,6,1,2006-08-15 09:57:42,2006-08-15 09:01:25
ab5573ae9f4178a7b6f6920f04c73a65feb3c690...d1b9944db8f66131b259be407472e53db33718ea,1,1,0,1,1,2006-08-15 09:58:47,2006-08-15 09:01:27
d1b9944db8f66131b259be407472e53db33718ea...3cd4f5e8eb04ae01298ceaf46bb41a4277031916,1,141,65,206,23,2006-08-15 10:11:52,2006-08-15 09:23:06
460cccd3ba1d38fd64c9e83e40d58bcf3e9d7d2c...c35f4c371ac12f4d29b08e46c519ddc0a6494f6e,1,43,1,44,2,2006-08-14 06:00:01,2006-08-13 18:30:27
c04c4e5708c9ad3dc534ff50ad8f28de5a7cfbff...937a515a15f776aa84430574f71367292a52b978,1,92,9,101,8,2006-08-13 05:51:53,2006-07-06 04:28:20
b9718d41c7e9c171e432bafac97a33be36f0e2bf...482faa8dafdf5dcf207b866b9c757271d9a45301,1,2,1,3,2,2006-07-17 20:01:27,2006-07-17 20:01:27
482faa8dafdf5dcf207b866b9c757271d9a45301...e7a0f6714bdfa7e3a169cc756a05cbbf787997eb,1,0,5,5,1,2006-07-17 20:10:58,2006-07-17 20:08:14
e7a0f6714bdfa7e3a169cc756a05cbbf787997eb...1b91abe35079f3d6e6440b9a49766de06f3f1659,2,44,14,58,11,2006-07-24 05:51:14,2006-07-18 02:22:49
1b91abe35079f3d6e6440b9a49766de06f3f1659...ce1a79b6a74b031213d8efd4f72cb0e954e261d5,3,43,4,47,7,2006-07-24 06:35:13,2006-07-20 09:30:44
ce1a79b6a74b031213d8efd4f72cb0e954e261d5...d0d8f7dc5ffe029d3fc047fb7ffecd7ecfb6601c,1,16,7,23,5,2006-07-24 06:35:24,2006-07-20 08:43:01
d0d8f7dc5ffe029d3fc047fb7ffecd7ecfb6601c...51a6e56fb7f63e110dc0c3c1fddd07ca9e22ced6,1,2,0,2,1,2006-07-24 06:35:29,2006-07-22 13:39:02
51a6e56fb7f63e110dc0c3c1fddd07ca9e22ced6...9f56a7fda940caa7d4a1b06947481b5157510557,1,1,1,2,1,2006-07-24 06:35:32,2006-07-22 13:39:32
9f56a7fda940caa7d4a1b06947481b5157510557...73389f12bf0ef39820685a322527fab549676f33,1,23,1,24,3,2006-07-24 06:36:03,2006-07-22 13:39:53
73389f12bf0ef39820685a322527fab549676f33...5df52584fa6cce1789009ad8a11f9eee92d5168a,1,2,1,3,1,2006-07-24 06:36:05,2006-07-22 13:40:13
5df52584fa6cce1789009ad8a11f9eee92d5168a...8eb38cad440d8d51d8737d546a067a88361f6c3d,1,22,8,30,3,2006-07-24 06:39:37,2006-07-24 04:28:28
8eb38cad440d8d51d8737d546a067a88361f6c3d...4812a93a8c0ad25ee701da8ff46a3c5d62994224,2,16,1,17,5,2006-07-24 06:40:35,2006-07-23 05:50:30
4812a93a8c0ad25ee701da8ff46a3c5d62994224...f8263c5339fd70ee00b60c37b715c7e46b30a3bf,1,2,0,2,1,2006-07-24 06:44:00,2006-07-23 17:51:04
f8263c5339fd70ee00b60c37b715c7e46b30a3bf...cbd64afbb3b1ad5433585ac71d94bd0c63270e38,1,4,2,6,1,2006-07-24 06:58:40,2006-07-19 20:28:00
cbd64afbb3b1ad5433585ac71d94bd0c63270e38...ce43697379ad8ffcaf061a4709489728c1dbe911,3,26,18,44,11,2006-07-24 07:04:41,2006-07-23 09:24:18
ce43697379ad8ffcaf061a4709489728c1dbe911...5e27e27e5d3da5dcbe5fbfe204c2ade0128538a5,1,2,1,3,1,2006-07-24 07:32:24,2006-07-22 22:54:40
5e27e27e5d3da5dcbe5fbfe204c2ade0128538a5...0d516adab8014bc0d16a0ae7bed7a76e4bd98ec5,1,2,0,2,1,2006-07-24 07:56:16,2006-07-18 17:14:51
0d516adab8014bc0d16a0ae7bed7a76e4bd98ec5...e557667e2d0439451f404794cb308affbc0acfb1,1,1,1,2,2,2006-07-24 17:49:11,2006-07-24 12:41:41
e557667e2d0439451f404794cb308affbc0acfb1...57c7d9a7756f9c0165d0aa003eb8a05c08cd9fae,1,19,0,19,1,2006-07-25 00:32:22,2006-07-24 23:23:03
b9718d41c7e9c171e432bafac97a33be36f0e2bf...9919f41c91e525fd813fd2cd006f8fdcf976a661,1,9,1,10,2,2006-07-17 08:10:03,2006-07-17 07:34:44
634331061599a82968daddae2d2c0896b6137d4c...1f2857ea32fa82ba6039b7fd298dc763b1e6c112,1,70,1,71,2,2006-07-25 01:21:52,2006-07-23 20:34:55
1f2857ea32fa82ba6039b7fd298dc763b1e6c112...4f7b34c98f6f3853c6b82a85f3e49121c59180f7,1,7,1,8,1,2006-07-25 01:21:52,2006-07-23 20:36:32
4f7b34c98f6f3853c6b82a85f3e49121c59180f7...cc1bf97e24129db2b8c4634bc733ae0a16b2beba,1,11,4,15,4,2006-07-25 01:21:52,2006-07-23 20:37:53
cc1bf97e24129db2b8c4634bc733ae0a16b2beba...acb0f6f33760b43c1fc9617a45346ab3738f021a,1,5,14,19,3,2006-07-25 01:21:53,2006-07-23 21:17:48
96256bba949f43548a0be0af877680eb62b156f6...afd222967c6abedcf75e28fe0e57cd5644f6c865,1,21,0,21,1,2006-07-26 18:05:44,2006-07-26 13:44:08
afd222967c6abedcf75e28fe0e57cd5644f6c865...b7a036bb5f19d3b44443dcc319321663910250e8,1,2,26,28,2,2006-07-26 18:05:44,2006-07-26 18:01:07
b7a036bb5f19d3b44443dcc319321663910250e8...2b5d2d8792c861913d48bcfe02d8a6049c3911f5,1,3,1,4,2,2006-07-26 19:24:15,2006-07-26 14:33:18
2b5d2d8792c861913d48bcfe02d8a6049c3911f5...941ba215fb9fc9e08705e86ea93e0f6f74d0faaf,1,1,1,2,1,2006-07-26 19:24:19,2006-07-26 14:32:51
941ba215fb9fc9e08705e86ea93e0f6f74d0faaf...4325b4ad16821e936cb619f5e25d273c281bdeeb,1,2,2,4,2,2006-07-26 19:24:36,2006-07-26 14:58:35
4325b4ad16821e936cb619f5e25d273c281bdeeb...a1dad607fa5227c844c0f8ab180b811d23792c02,1,15,0,15,1,2006-07-26 19:24:49,2006-07-26 17:41:05
a1dad607fa5227c844c0f8ab180b811d23792c02...2c3cff49301c44767c72391cb5288aa0d10563a9,1,6,3,9,2,2006-07-26 20:03:01,2006-07-26 19:59:08
96256bba949f43548a0be0af877680eb62b156f6...bb6b8e4f877e8b59b3756960e29d1955072dab56,2,24,13,37,8,2006-07-25 21:15:48,2006-07-17 22:04:47
bb6b8e4f877e8b59b3756960e29d1955072dab56...ceec1361ebbc4613813ba42976503f5e304cfacf,1,16,0,16,1,2006-07-25 21:15:48,2006-07-17 22:06:23
ceec1361ebbc4613813ba42976503f5e304cfacf...8e27364128b091e76059229d4f009bc7f869fa9f,1,1,0,1,1,2006-07-25 21:15:48,2006-07-17 22:10:10
96256bba949f43548a0be0af877680eb62b156f6...4ab243a944a6013d9e862adadd6fe6152c842401,1,30,6,36,5,2006-07-25 21:15:46,2006-07-24 12:10:45
4ab243a944a6013d9e862adadd6fe6152c842401...6acbcb927f8e34857fa8f68fcb4f9076941b24ff,3,58,47,105,8,2006-07-25 21:15:47,2006-07-25 18:24:22
c1a788aceecb0a8e95d6442938ade9ca43df033e...7a85b848ad77c72c539c5887ead99a89140541da,1,52,28,80,10,2006-07-31 06:55:49,2006-07-30 18:27:10
7a85b848ad77c72c539c5887ead99a89140541da...c1f3089e4bb5a3e8e8f92915800f2d5a2d4dd246,1,2,0,2,1,2006-07-31 22:41:12,2006-07-31 10:42:35
c1f3089e4bb5a3e8e8f92915800f2d5a2d4dd246...c8b87ef8b0da6b08a19ed4f98eb58f46748af1e9,2,2,1,3,2,2006-08-03 23:17:51,2006-08-03 23:17:51
c8b87ef8b0da6b08a19ed4f98eb58f46748af1e9...3d234d0afacd355eb30b330a56bd2efa73bd44d5,1,4,2,6,1,2006-08-04 18:30:35,2006-08-04 16:21:41
3d234d0afacd355eb30b330a56bd2efa73bd44d5...5b982f84ee6eb3027e5bdf2e917a0efa48aded6a,1,20,24,44,4,2006-08-09 21:46:47,2006-08-09 13:04:16
5b982f84ee6eb3027e5bdf2e917a0efa48aded6a...c1964a006f9035cbdc6de8e55768fc6ad00d4825,1,9,13,22,11,2006-08-09 21:49:26,2006-08-09 13:07:31
c1964a006f9035cbdc6de8e55768fc6ad00d4825...934d9a24078e65111e9946ad3449c3fa9c06475e,1,12,0,12,1,2006-08-09 21:54:00,2006-08-09 16:43:03
934d9a24078e65111e9946ad3449c3fa9c06475e...8918b0c9c2667c5a69461955135c709b09561f72,1,12,1,13,2,2006-08-09 21:57:22,2006-08-09 20:30:58
8918b0c9c2667c5a69461955135c709b09561f72...984b65707e25c426a32feb9b9d46f077b605cb31,1,4,2,6,1,2006-08-09 21:57:27,2006-08-09 20:31:49
984b65707e25c426a32feb9b9d46f077b605cb31...4147d801db66df9b127ffe315601f467aa9d1c48,1,3,3,6,2,2006-08-10 21:30:01,2006-08-10 14:47:21
a3e65d74ee7ec9e6f49de7688a1cdac052910bd4...26a8ad25b28a1cb906c88bdf539d840774ca5aeb,1,5,4,9,3,2006-07-16 07:00:09,2006-07-16 07:00:09
26a8ad25b28a1cb906c88bdf539d840774ca5aeb...7b520e62a2738ce776d1c9f11144021ff1fc63b6,1,1,1,2,1,2006-07-16 20:46:47,2006-07-15 14:10:56
a3e65d74ee7ec9e6f49de7688a1cdac052910bd4...d1566f7883f727f38bf442af3fdb69d36e6fcea2,3,30,0,30,5,2006-07-15 03:41:36,2006-07-15 00:48:51
d1566f7883f727f38bf442af3fdb69d36e6fcea2...cc35de8470541e389b7d2bdda4c901574720fa81,2,22,9,31,7,2006-07-15 03:41:37,2006-07-15 00:49:04
cc35de8470541e389b7d2bdda4c901574720fa81...da56645dd7c1175fc2ed1628ac35fdd35e705641,2,16,0,16,5,2006-07-15 03:41:37,2006-07-15 00:49:08
da56645dd7c1175fc2ed1628ac35fdd35e705641...76af073457320ffcba937a8c7ed4e8b37150cca8,1,6,3,9,3,2006-07-15 05:47:53,2006-07-15 05:47:53
757f17bca50f4a227db2974dd8fd10c8b61a69f1...2ed49d542470e265cbebbe1eb8083f61a512c680,1,42,41,83,24,2005-11-23 10:21:27,2005-11-23 01:39:53
2ed49d542470e265cbebbe1eb8083f61a512c680...495473c08a957464e7e326ae7bafb477db90fcbe,1,3,2,5,3,2005-11-23 10:21:33,2005-11-23 04:15:01
8fc66df237afce0b4318657f166b3583831949f3...bd22c904a0f1c88a3a7bfa96bbf690de2f5cb278,4,31,32,63,33,2005-11-21 06:14:16,2005-11-21 00:52:52
bd22c904a0f1c88a3a7bfa96bbf690de2f5cb278...3d32051f4fd657747de00cb9d516dc3512bb377d,1,15,10,25,3,2005-11-21 06:17:56,2005-11-21 05:11:22
3d32051f4fd657747de00cb9d516dc3512bb377d...936a23420c8e1630e013578ba9285cd69cf918f7,1,15,4,19,4,2005-11-21 06:19:58,2005-11-20 21:42:11
936a23420c8e1630e013578ba9285cd69cf918f7...e0a87193d3f2b78b7b687405c0315e1517d36912,1,1,1,2,1,2005-11-21 07:37:13,2005-11-21 07:37:13
e0a87193d3f2b78b7b687405c0315e1517d36912...924215024c72bc359fad920010dd6b356a5140c8,2,24,6,30,6,2005-11-21 08:43:12,2005-11-21 08:43:12
924215024c72bc359fad920010dd6b356a5140c8...60abce3c0f41952de7dc1a4abefcb988898b71a4,1,3,4,7,3,2005-11-21 20:21:06,2005-11-21 18:59:31
60abce3c0f41952de7dc1a4abefcb988898b71a4...88b5a74883f146eac4b15b30e74bbdeb5ab5a63a,1,3,2,5,2,2005-11-21 20:21:24,2005-11-21 20:17:22
88b5a74883f146eac4b15b30e74bbdeb5ab5a63a...9f70b806920e3ea158d7e189a1ec668445c13359,2,7,0,7,2,2005-11-21 20:21:24,2005-11-21 20:18:23
9f70b806920e3ea158d7e189a1ec668445c13359...aa7f412abf605d824c7f72dbfaedd27d5429a025,1,4,1,5,1,2005-11-21 21:42:55,2005-11-21 21:42:55
aa7f412abf605d824c7f72dbfaedd27d5429a025...4dbd13527933261076bbed1a5a2daa60a752d096,3,72,87,159,27,2005-11-21 21:47:00,2005-11-17 19:37:14
4dbd13527933261076bbed1a5a2daa60a752d096...ce335fe04f32261e0204280281989ffbb5d990c6,2,14,18,32,6,2005-11-21 21:47:00,2005-11-21 09:21:18
ce335fe04f32261e0204280281989ffbb5d990c6...f801477645146fd7eff018b4997b86dfa1a0767d,1,71,1,72,3,2005-11-21 21:48:58,2005-11-04 14:57:16
f801477645146fd7eff018b4997b86dfa1a0767d...e814bc4d159f62941fafe135c3008b3ff103444d,1,45,7,52,8,2005-11-21 21:48:58,2005-11-19 11:48:56
e814bc4d159f62941fafe135c3008b3ff103444d...3dd94e3b2e2f5b00512273f96ab5628c742c112c,2,2,0,2,2,2005-11-21 22:04:22,2005-11-21 10:18:20
3dd94e3b2e2f5b00512273f96ab5628c742c112c...b17e659dd4007cb1d3eb5ac32b524c0c5ab59601,2,29,9,38,6,2005-11-21 22:04:28,2005-11-20 20:22:19
b17e659dd4007cb1d3eb5ac32b524c0c5ab59601...ef07618fdd660057b80fe75007405c62502a5820,2,2,2,4,2,2005-11-21 22:08:49,2005-11-21 20:38:31
ef07618fdd660057b80fe75007405c62502a5820...f35230fb1123a0db4776c574a874aecec1f38db8,1,6,0,6,2,2005-11-21 22:36:43,2005-11-21 17:07:23
f35230fb1123a0db4776c574a874aecec1f38db8...1b1480ff6acda6e53325961e20fb13ae6895ee69,1,21,12,33,5,2005-11-21 22:54:33,2005-11-21 22:17:12
1b1480ff6acda6e53325961e20fb13ae6895ee69...d6ebd2590cb427a564a7bc21f893b238ce26e26f,1,15,13,28,9,2005-11-22 00:37:58,2005-11-21 23:44:15
d6ebd2590cb427a564a7bc21f893b238ce26e26f...c3df8568424684bbcc7df7722eb3ec34bdae8b2d,1,5,4,9,2,2005-11-22 04:51:22,2005-11-22 03:18:23
c3df8568424684bbcc7df7722eb3ec34bdae8b2d...07f92477227e2a1770dfbb6318caedc4f091f6c1,1,3,2,5,2,2005-11-22 05:50:00,2005-11-18 21:29:04
07f92477227e2a1770dfbb6318caedc4f091f6c1...9ce392f4826558357af2b2c7eb6ad876fdb53a91,8,19,9,28,8,2005-11-22 07:00:50,2005-11-22 06:52:37
9ce392f4826558357af2b2c7eb6ad876fdb53a91...c7d77dab9333112cfce8cce51e56005b5e8b4076,3,13,9,22,7,2005-11-22 07:44:35,2005-11-22 07:44:35
c1aaa5d9ea4a148a964f8c4d6de8bc65f1dc44fd...9106c097ad87577019544f45fda11c4d73986597,4,6,10,16,5,2005-10-28 09:01:42,2005-10-09 09:30:17
9106c097ad87577019544f45fda11c4d73986597...a60d2d8f2dbeb7025e04dd65fc2dedd8271c9cc6,1,6,0,6,2,2005-10-28 09:15:14,2005-10-27 09:57:44
a60d2d8f2dbeb7025e04dd65fc2dedd8271c9cc6...6d0de319d6249096fe934317e937177d07b1b84f,1,3,0,3,2,2005-10-28 09:15:18,2005-10-27 10:03:43
6d0de319d6249096fe934317e937177d07b1b84f...a77a9222127b6e873ffab08dd57bd5d37b069f41,1,6,0,6,1,2005-10-28 09:39:56,2005-10-28 09:39:56
a77a9222127b6e873ffab08dd57bd5d37b069f41...f07a524195a73537d4187460ccbd072bcb1ff486,1,4,4,8,4,2005-10-28 09:59:01,2005-10-28 03:00:43
f07a524195a73537d4187460ccbd072bcb1ff486...50b8e355b64c93a71d5008557e15f52c032240ff,4,9,5,14,5,2005-10-28 20:37:38,2005-10-28 17:04:49
50b8e355b64c93a71d5008557e15f52c032240ff...41f222e87a9062833712367d66114cae90b3769a,3,3,0,3,3,2005-10-28 21:25:02,2005-10-28 16:45:53
41f222e87a9062833712367d66114cae90b3769a...af13cdf298b927d171a58ec30c885d2a9c9bf727,2,28,0,28,3,2005-10-28 21:25:05,2005-10-28 19:41:49
af13cdf298b927d171a58ec30c885d2a9c9bf727...f9362de96131c323a00ce5e135dd76f7134c7f01,1,2,1,3,1,2005-10-29 05:21:27,2005-10-29 04:17:17
f9362de96131c323a00ce5e135dd76f7134c7f01...0363ecf6414e75d4423814ba930f67edaef91683,1,1,1,2,1,2005-10-29 05:21:29,2005-10-29 04:16:12
0363ecf6414e75d4423814ba930f67edaef91683...1cb7f22e5c344026524300941f66573f313ff093,1,0,4,4,1,2005-10-29 05:21:32,2005-10-29 04:16:01
1cb7f22e5c344026524300941f66573f313ff093...59df2a11fea918dd605bd805c233b193a134e59e,1,38,27,65,16,2005-10-29 05:21:35,2005-10-29 04:15:49
59df2a11fea918dd605bd805c233b193a134e59e...2f9d685c6188ac5537fefa1729c91f1cd3de66cd,1,6,0,6,2,2005-10-29 05:26:15,2005-10-29 04:16:20
2f9d685c6188ac5537fefa1729c91f1cd3de66cd...c485104741ccdf32dd0c96fcb886c38a0b5badbd,1,10,3,13,3,2005-10-29 05:26:16,2005-10-29 04:16:33
c485104741ccdf32dd0c96fcb886c38a0b5badbd...7d8b7c21c9c0bee0d94fcf3b350e24ebdb920b74,2,32,2,34,8,2005-10-29 05:28:57,2005-10-28 09:43:31
7d8b7c21c9c0bee0d94fcf3b350e24ebdb920b74...23d61f8343282643c830e1c446962b213dbcc09a,1,132,32,164,9,2005-10-29 05:56:58,2005-10-28 02:46:27
23d61f8343282643c830e1c446962b213dbcc09a...1baaae5e1f9ac09aafe11b5aa4daa69bae68173b,1,52,20,72,10,2005-10-29 05:56:58,2005-10-28 02:47:07
1baaae5e1f9ac09aafe11b5aa4daa69bae68173b...6b17c674aa517c4b22cd88809fcf1532b8204fbf,1,136,0,136,1,2005-10-29 05:56:58,2005-10-28 02:47:38
6b17c674aa517c4b22cd88809fcf1532b8204fbf...eebda31d21d5d5df351b41994df875918863294e,1,43,0,43,1,2005-10-29 05:56:59,2005-10-28 02:48:03
eebda31d21d5d5df351b41994df875918863294e...f0243f26f6d8403cd8e83c7d498c81e01a1f1735,1,22,5,27,5,2005-10-29 05:56:59,2005-10-28 02:48:32
f0243f26f6d8403cd8e83c7d498c81e01a1f1735...211b5f9e62cc961acda59392fbf5a3efa8106c97,2,16,1,17,5,2005-10-29 05:57:00,2005-10-28 02:48:54
211b5f9e62cc961acda59392fbf5a3efa8106c97...1bd8c8f00b1c7facb67c99047fe777b53f2c49ff,1,24,23,47,9,2005-10-29 05:57:00,2005-10-28 02:49:16
1bd8c8f00b1c7facb67c99047fe777b53f2c49ff...c4c86f07d01bc4a05126b129f644e70dd9e244d0,2,46,17,63,12,2005-10-29 05:57:01,2005-10-28 02:50:26
c4c86f07d01bc4a05126b129f644e70dd9e244d0...1f5881bb5f4da97d0bb23024ae91079137326c7e,2,10,5,15,4,2005-10-29 05:57:01,2005-10-28 03:56:41
1f5881bb5f4da97d0bb23024ae91079137326c7e...8d7d1670a87743c699aa8a981506c952088dc2d4,1,2,2,4,2,2005-10-29 05:57:01,2005-10-28 03:59:29
8d7d1670a87743c699aa8a981506c952088dc2d4...a67c1d0809f683e21baa9119f6a356c81b7e30b4,1,6,6,12,6,2005-10-29 07:50:42,2005-10-29 07:50:42
a67c1d0809f683e21baa9119f6a356c81b7e30b4...0ffdbbfe36a25682cbb2e6b18b9217c93c97b424,1,3,2,5,3,2005-10-29 20:02:18,2005-10-29 20:02:18
0ffdbbfe36a25682cbb2e6b18b9217c93c97b424...52e4478dbd3425332ed4ef6a4cadeb034ee8c4b6,1,10,18,28,4,2005-10-29 20:11:36,2005-10-29 20:11:36
52e4478dbd3425332ed4ef6a4cadeb034ee8c4b6...5773c9f2b28c3af92b7e9c6832536e99ab11cc78,3,59,7,66,9,2005-10-29 21:32:56,2005-10-29 21:32:56
5773c9f2b28c3af92b7e9c6832536e99ab11cc78...46774a81f9d6ca4d230d33757afe9dd07bfe398b,2,7,1,8,2,2005-10-29 21:35:11,2005-10-29 21:35:11
46774a81f9d6ca4d230d33757afe9dd07bfe398b...c2d07d24e48fd7109ac4c717bcdc6b82609ece1a,1,1,1,2,1,2005-10-31 01:27:38,2005-10-31 01:27:38
c2d07d24e48fd7109ac4c717bcdc6b82609ece1a...b0bafe0364860ba45b74a5aec5b920213d5caa34,1,7,0,7,2,2005-10-31 01:28:00,2005-10-29 21:46:41
b0bafe0364860ba45b74a5aec5b920213d5caa34...14470c0de3d5a4388960f59ea96038206bacd888,2,25,8,33,6,2005-10-31 01:28:01,2005-10-29 21:46:41
14470c0de3d5a4388960f59ea96038206bacd888...918db541e0e833b695ee45ee6cf563d018096860,2,15,1,16,4,2005-10-31 01:28:01,2005-10-29 21:46:41
918db541e0e833b695ee45ee6cf563d018096860...69e0c256415a98cd683d977386e624f034643829,2,70,17,87,8,2005-10-31 01:28:02,2005-10-30 09:03:45
69e0c256415a98cd683d977386e624f034643829...5a83f3be2465c8b824a0bb80dcffdcd70457b907,1,2,0,2,2,2005-10-31 01:28:02,2005-10-30 09:08:35
5a83f3be2465c8b824a0bb80dcffdcd70457b907...12ea5bea587093cdb716f57e112a1a43db4132e0,1,6,1,7,2,2005-10-31 01:28:03,2005-10-30 09:14:33
12ea5bea587093cdb716f57e112a1a43db4132e0...64b1f6e676a5621483feac0082e11cd79c1ad825,1,5,4,9,1,2005-10-31 01:28:03,2005-10-30 22:23:47
64b1f6e676a5621483feac0082e11cd79c1ad825...80e0c0ab91e1cf6a6315d0431bf6873ebbf8bef0,1,1,1,2,1,2005-10-31 01:28:04,2005-10-30 23:07:01
0542f48c894f924d94a2bd05f7e4cbab25656112...11b1a5db4f8d5750781d8ed9a1ae539b28267370,1,1,0,1,1,2005-09-29 06:22:02,2005-09-29 06:22:02
11b1a5db4f8d5750781d8ed9a1ae539b28267370...bb8c91d617e8a2ab4a78712086d1574da6e24e68,1,25,30,55,10,2005-09-29 06:31:18,2005-09-29 06:31:18
bb8c91d617e8a2ab4a78712086d1574da6e24e68...fef1ef8e1b87f28f019bf973547644e41f4be7cd,1,1,1,2,1,2005-09-29 17:38:26,2005-09-29 17:38:26
bf7960eb51a26bcf52f27a60bfcf005661266b1e...60fb5b2c4d9e26204f480f8a18ae1ff0051a6440,1,44,4,48,3,2005-09-29 07:24:41,2005-09-26 02:43:51
2d56993347eac4e4f91c0539ff3c5f05fd777495...a1d4aa742416953a3ac9be9154c55e90a4193cd6,4,148,14,162,6,2005-09-01 23:56:13,2005-09-01 23:56:13
a1d4aa742416953a3ac9be9154c55e90a4193cd6...89bc8c785e20258efba3b2b5ffc26098fa0b8bc8,1,6,2,8,2,2005-09-02 04:45:00,2005-09-01 14:13:50
89bc8c785e20258efba3b2b5ffc26098fa0b8bc8...06ec2b4bb4ab9096d1304ba5a2ec388078dcdf7f,1,33,18,51,12,2005-09-02 09:34:13,2005-09-02 09:34:13
06ec2b4bb4ab9096d1304ba5a2ec388078dcdf7f...79882c2883267e16280d630730d6a8b5a86a8092,1,0,1,1,1,2005-09-02 17:39:57,2005-09-02 17:39:57
79882c2883267e16280d630730d6a8b5a86a8092...86b13da46cd710a45a89968880c691452d5b70b4,3,15,9,24,8,2005-09-02 17:53:15,2005-09-02 17:53:15
86b13da46cd710a45a89968880c691452d5b70b4...953e5842f8fcd40c3e7013a9793746719016db1b,1,6,0,6,1,2005-09-02 18:46:43,2005-09-02 18:46:43
f5e375c9a99d731c05eef701f119da85d62fc158...45d197a469f9ebeda91e7fd4fd522bb558e88bca,1,90,6,96,4,2005-08-23 06:19:18,2005-08-23 00:55:26
45d197a469f9ebeda91e7fd4fd522bb558e88bca...7fc9d69fca0ea8afab6709622b694f31662fb2ee,30,1194,1,1195,31,2005-08-23 08:49:47,2005-08-23 08:49:47
7fc9d69fca0ea8afab6709622b694f31662fb2ee...0360e99d06acfbb0fcb72215cf6749591ee53290,1,3,3,6,3,2005-08-23 19:42:58,2005-08-23 17:47:54
0360e99d06acfbb0fcb72215cf6749591ee53290...90e18481137b2071b20fc675d69af4fc60a05267,2,2,2,4,2,2005-08-23 19:43:57,2005-08-23 17:31:41
90e18481137b2071b20fc675d69af4fc60a05267...0a5a9ea433031c5e23f1909bcca0a9b7ac7cf375,1,32,20,52,3,2005-08-23 20:18:00,2005-08-23 20:18:00
0a5a9ea433031c5e23f1909bcca0a9b7ac7cf375...2a29da7c6d6103c4719c71f6cce88e853260912c,2,275,195,470,148,2005-08-23 22:28:34,2005-08-23 22:28:34
0ecd94d7d728606e0047a44e60a277ff4e7b3990...eb8e7e1d9a946f439e0e35f2ada9efb434ea8b60,9,2,37,39,10,2013-11-12 22:10:17,2013-11-10 15:47:28
eb8e7e1d9a946f439e0e35f2ada9efb434ea8b60...925ceccf050e2998c2b805476b529bdf5352cf74,9,5,173,178,14,2013-11-12 22:10:19,2013-11-10 15:47:29
925ceccf050e2998c2b805476b529bdf5352cf74...7c4012812aa87a0cceb13b695e95e66d628516ec,6,0,111,111,6,2013-11-12 22:10:21,2013-11-10 15:47:30
7c4012812aa87a0cceb13b695e95e66d628516ec...816b2c04c90ef7115581412f7b9552b848ebb6a9,6,0,48,48,6,2013-11-12 22:10:22,2013-11-10 15:47:31
816b2c04c90ef7115581412f7b9552b848ebb6a9...bb5d531efa804bbf09064e4a7ce65e096599f3c7,2,1,2,3,3,2013-12-03 20:35:22,2013-12-02 23:37:10
0ecd94d7d728606e0047a44e60a277ff4e7b3990...0ffa154b5b37396462aeff3750933f05982ace63,7,22,22,44,20,2013-11-12 18:47:17,2013-11-09 00:48:52
0ecd94d7d728606e0047a44e60a277ff4e7b3990...382d20e3ebc69ad20f54e71fc5f6ca17baa23973,3,4,4,8,4,2013-11-12 17:24:27,2013-11-12 15:17:42
382d20e3ebc69ad20f54e71fc5f6ca17baa23973...7e7cf80d7480fd457674fad01466c867a87ed27c,1,2,2,4,2,2013-11-12 17:42:08,2013-11-12 15:17:43
7e7cf80d7480fd457674fad01466c867a87ed27c...68840cb5af52541cb3354cfa06f2df86ae6ea6f6,4,4,4,8,4,2013-11-12 17:42:21,2013-11-12 15:17:45
0ecd94d7d728606e0047a44e60a277ff4e7b3990...361412828ab580e145c3350cf075b283ebe331a5,2,12,4,16,6,2013-11-11 22:10:57,2013-11-11 20:55:52
694a88a309c74ffeefa9a0db0396ee4c168a521c...d7aced95cd681b761468635f8d2a8b82d7ed26fd,1,17,1,18,4,2013-12-12 22:24:39,2013-12-12 22:24:39
6ba01babcd37e92e88221fcf35ee4471aa66bf4c...c13a5fe47b03cc115985ec79bff00b5510023092,1,7,0,7,1,2013-11-13 22:12:23,2013-10-04 14:20:07
83db04ff878f40146952ee5d3d2d113568455f5b...d288a70030eaa5c205a72b4548635e17f8e523c0,8,147,19,166,21,2005-08-17 01:47:22,2005-08-17 01:06:34
d288a70030eaa5c205a72b4548635e17f8e523c0...a579defe5a43bdd242d79750039758f319b82a38,1,2,3,5,2,2005-08-17 04:33:22,2005-08-17 02:50:37
a579defe5a43bdd242d79750039758f319b82a38...f332726eaad74ac2aac0c3fb2dcb662acdbc3a31,3,55,42,97,7,2005-08-17 04:33:25,2005-08-17 03:44:32
f332726eaad74ac2aac0c3fb2dcb662acdbc3a31...af5260ee785b8418c7319a84b1d1a0d26e770ed0,1,20,11,31,6,2005-08-17 05:22:35,2005-08-16 22:23:50
af5260ee785b8418c7319a84b1d1a0d26e770ed0...9577e7e3db2299febdc17539478bba38874d4120,1,15,11,26,7,2005-08-17 05:22:35,2005-08-17 01:22:05
9577e7e3db2299febdc17539478bba38874d4120...6bff6a60680ef402f614abae8189c2cb198cfa49,3,27,4,31,12,2005-08-17 05:22:35,2005-08-17 05:18:27
69c835701b507e336fd5354f9f3b05e42d20c07d...cd1e74874049c8ba8e510f2fae064e510cccd32b,1,386,334,720,323,2012-04-28 12:27:01,2012-04-28 12:27:01
666ca59a8c88e1750386fa64c7ed4be698fd1b2a...49ba92b4eaca44ee4d7444b2256d60c2f32268ee,1,41,0,41,2,2012-09-28 00:25:48,2012-09-26 21:47:51
49ba92b4eaca44ee4d7444b2256d60c2f32268ee...bafed0dfb405b27e8b2b9680beece1dfaf5fdab2,1,19,0,19,1,2012-09-28 00:25:52,2012-09-26 21:51:06
b5d156c3622fa522966034c78fd6ed9a15504d46...df995c7dd21bca9c61f9e5480fdfc1a015b4f1a0,2,2,5,7,2,2012-09-28 00:57:26,2012-09-24 02:40:24
1084f3b844d80d84d2d318bc562b78514cd78028...cc76011effc295cf84a8c4b170ba834bd7b41e10,1,5103,1805,6908,889,2012-09-15 02:26:13,2012-09-15 02:26:13
1084f3b844d80d84d2d318bc562b78514cd78028...a731fa916e5ce000eeb23f3c858c9218c78633d6,1,9,0,9,1,2012-09-14 23:05:52,2012-09-14 16:54:22
a731fa916e5ce000eeb23f3c858c9218c78633d6...1b3185fc2be3cc92a834fcfcb7110d1072184700,2,21,6,27,4,2012-09-18 05:00:27,2012-09-15 03:38:24
a75aba4a5306d0fee6a8ee8b48943e2c19eb2750...10d4332e007132a38dc61f03c760d355da5cd550,1,16,0,16,4,2012-04-30 01:00:47,2012-04-30 01:00:47
5b590d783a461c63fa803d1c21b57bc79c0207f7...511a3fc116799df5e3b2262f8f6e501ca73ba2fe,1,4,1,5,1,2009-09-13 08:31:02,2009-09-12 10:39:30
511a3fc116799df5e3b2262f8f6e501ca73ba2fe...2b7ca830c6a6e4f0e1722e24973a026b5b867227,7,14,9,23,9,2009-09-13 08:31:10,2009-09-12 08:54:32
75f492ace708afb4603b922a99ced318d980b8d5...0b74f5dc3a27a058cd5dfe45b5ada4d2853dc447,1,1,1,2,1,2009-08-12 23:14:31,2009-08-11 10:10:21
0b74f5dc3a27a058cd5dfe45b5ada4d2853dc447...22f1fb66be859fb5ab1620a7dce8e54702d4a07c,1,1,1,2,1,2009-08-12 23:14:32,2009-08-11 13:03:58
22f1fb66be859fb5ab1620a7dce8e54702d4a07c...57f6ec029090f64377ec5c0926b6e2e39b0caa4f,8,10,10,20,10,2009-08-12 23:14:41,2009-08-07 14:24:21
13354f5377d82baee4d8c930df824c8dbeda396d...800324c3addbf60b15114c4292204806b1300060,1,3,1,4,1,2009-08-18 20:59:44,2009-08-17 09:09:43
13354f5377d82baee4d8c930df824c8dbeda396d...b8f423327bea8b82f1cd08cbed52a54a757de856,1,10,0,10,1,2009-08-18 19:20:58,2009-08-17 20:38:46
b8f423327bea8b82f1cd08cbed52a54a757de856...83e355a62cd05fba4533d59f9ab4e104c0596279,1,6,6,12,1,2009-08-18 20:35:55,2009-08-18 09:51:00
749086fa090d81c10ebf16b1abfd138c3fa0232e...4b9fa0e359a710b5d8dae542a92df7dbe56d9915,1,6,1,7,1,2009-08-29 02:24:43,2009-08-26 12:20:53
094574b32b799af01e5c0e0a44c2f41eb4a3f671...c14f3727913a67835ad38d17edcbfe4e1c94e9a7,1,6,1,7,2,2011-04-03 06:08:13,2011-04-03 06:08:13
c14f3727913a67835ad38d17edcbfe4e1c94e9a7...d83a831bf4eca748f159b326d5a2562085013900,3,34,2,36,3,2011-04-03 07:12:31,2011-04-03 07:12:31
cd03eebbfdae712bd4a10d6b393980a8137ce305...3d913526b19545eb4e463f96d2f3b8db8daae6ef,1,3,7,10,3,2009-09-13 08:32:04,2009-09-12 08:54:32
3d913526b19545eb4e463f96d2f3b8db8daae6ef...41698375ada57d51cf6db5cf25970ccd1b918180,5,8,8,16,8,2009-09-13 08:32:20,2009-09-12 08:43:27
41698375ada57d51cf6db5cf25970ccd1b918180...f7835a251c2c98df152792b15793b03e22bf078e,3,23,1,24,4,2009-09-13 08:32:26,2009-09-12 09:03:48
f7835a251c2c98df152792b15793b03e22bf078e...1cdd64e8000716945e1cb96c46a4273a2db0ec74,1,1,1,2,1,2009-09-13 08:32:49,2009-09-13 02:40:27
7c9f7038e923e6eb135b27c6fca9a010b034bc27...95b9f9f927a7d9ea2bc2849b6ae624335e98362f,1,7,0,7,1,2011-05-29 20:00:06,2011-05-26 20:43:20
95b9f9f927a7d9ea2bc2849b6ae624335e98362f...000f97bd11e94fa8ede7fcdb43f5633997fed672,2,5,4,9,3,2011-05-29 20:00:10,2011-05-26 20:43:21
7c9f7038e923e6eb135b27c6fca9a010b034bc27...46b77a6b487fceeeb297a9473631939aefd7e6fd,1,5,5,10,2,2009-09-06 06:16:38,2009-09-05 08:52:18
46b77a6b487fceeeb297a9473631939aefd7e6fd...482a6c106132bea454bf839f458c014f84ddbd99,2,4,2,6,2,2009-11-27 03:15:57,2009-11-26 15:24:38
482a6c106132bea454bf839f458c014f84ddbd99...14ed05ddd6a8cdd3cb792e2c991207d1640943d1,1,166,0,166,9,2009-11-27 23:14:59,2009-11-27 21:29:30
14ed05ddd6a8cdd3cb792e2c991207d1640943d1...84dbe7b867cfaaa929ed1941f930d564514ae714,3,95,97,192,8,2009-12-05 17:27:23,2009-12-05 15:04:37
84dbe7b867cfaaa929ed1941f930d564514ae714...3fe2a894e98566dd91e69982552454cfb381cf24,2,18,7,25,6,2009-12-05 17:27:56,2009-12-05 15:04:38
3fe2a894e98566dd91e69982552454cfb381cf24...4a7cc2fdf39c90e6eff84d30b86490cac2c33705,3,9,2,11,4,2009-12-07 08:40:22,2009-12-07 05:17:15
4a7cc2fdf39c90e6eff84d30b86490cac2c33705...8661768fc9cfdeeaae76693501b82940cfcbedc2,2,9,12,21,4,2009-12-07 08:41:14,2009-12-07 05:26:25
8661768fc9cfdeeaae76693501b82940cfcbedc2...c521bb7114e081d81eb7cd77cf5989d30160d0a2,1,18,0,18,1,2009-12-08 20:54:57,2009-12-08 10:12:01
c521bb7114e081d81eb7cd77cf5989d30160d0a2...68cfc6f551a02d29a2bc48c6473fad6ab42a476f,3,156,44,200,29,2009-12-09 05:52:47,2009-12-08 10:12:02
68cfc6f551a02d29a2bc48c6473fad6ab42a476f...309883015ff3af6ce14ff9fe401e06cfce8adb13,1,4,6,10,6,2009-12-12 08:47:02,2009-12-12 07:45:24
309883015ff3af6ce14ff9fe401e06cfce8adb13...dd20f8af1ae54773569b78b1b71d1ea663705d2c,2,2,2,4,2,2009-12-12 09:21:38,2009-12-12 08:18:12
dd20f8af1ae54773569b78b1b71d1ea663705d2c...3c5884536563518ce6cd4dc782b0ebb670bf3b6d,4,13,5,18,11,2009-12-12 09:22:10,2009-12-12 07:53:41
1bed73c64a354248d6b342e58df257e8233bcbd2...650d30d8a120c8982309ccb9ef40432b4ea2eb74,3,9,2,11,5,2009-07-08 18:22:51,2009-06-29 09:55:51
1bed73c64a354248d6b342e58df257e8233bcbd2...1c3acfcd575cdd1bfc9981baf5782eb5cf433362,2,4,2,6,2,2009-06-30 18:17:54,2009-06-28 12:55:45
1c3acfcd575cdd1bfc9981baf5782eb5cf433362...fe104986c65b7c9a3c6e6ee92256be4d664e14b2,1,1,1,2,1,2009-06-30 18:17:54,2009-06-29 19:42:08
fe104986c65b7c9a3c6e6ee92256be4d664e14b2...21d777f2577a8003d12bdc1c5f3c1ff68750c598,1,12,12,24,8,2009-06-30 18:17:55,2009-06-29 15:13:58
21d777f2577a8003d12bdc1c5f3c1ff68750c598...476cc724242e715c150dce0d26d2feabe2dbe5e1,1,2,2,4,1,2009-06-30 18:33:30,2009-06-30 18:29:36
476cc724242e715c150dce0d26d2feabe2dbe5e1...d4c985653a580e78db94c549bdcd71669067b8a9,1,2,0,2,1,2009-06-30 23:12:24,2009-06-30 22:30:00
df01e7c5ee732cd6673de18743b42bf5234a5c76...5ad9dce7e691106fecde413de8cc321b937367a6,1,27,6,33,8,2009-09-08 00:20:02,2009-09-08 00:20:02
0b1fac320c10b83133f824805055ff428b331e19...7e787953fb89fbe403060585f7c39f0c75f29318,1,46,4,50,5,2009-09-03 16:44:41,2009-09-03 12:15:00
0b1fac320c10b83133f824805055ff428b331e19...228e7b5d4d6eca8616c7dc3d979478909dbdbfd1,1,1,1,2,2,2009-09-02 05:29:51,2009-09-01 20:13:53
228e7b5d4d6eca8616c7dc3d979478909dbdbfd1...2e5ed5f21b5b978268d7e4823fe777fdff20f544,1,1,1,2,1,2009-09-03 02:47:50,2009-08-31 19:28:34
c8dacba762e1c672b9592e0d1e8dca722422f325...b17a01df49a43e0edd7d26397deb79c1b1089d0c,2,29,1,30,2,2012-08-06 22:51:58,2012-08-06 22:51:58
ebcfa444c436c0a501d38ffd5bae670fe6ee01c5...ccc1188fa34cd9519185a22b13599256ccfac7e1,2,13,1,14,3,2012-07-24 04:02:06,2012-07-24 04:02:06
ccc1188fa34cd9519185a22b13599256ccfac7e1...f628825481b706baa3d9bf871a081cb1285c2778,2,8,1,9,3,2012-07-24 19:43:44,2012-07-24 13:43:59
aab9ea1aad2447522928d7e9af0bb030558012cb...8648732e298b74b25171c97e6ea144818f29c403,1,15,0,15,1,2009-08-28 23:36:24,2009-08-28 22:32:41
ca5812d2e3c72b09008422975740aff41a2c65a0...e923eaeb901ff056421b9007adcbbce271caa7b6,3,11,1,12,4,2010-02-12 23:45:05,2010-02-12 23:45:05
7ab3cc70a6aad2e4f8ccaa98e5520aa126eaef8f...fb47cfbd59b12ea67e1a5c6a9d0bd665fcae4581,2,31,1,32,3,2007-07-27 17:59:42,2007-07-24 20:43:09
7ab3cc70a6aad2e4f8ccaa98e5520aa126eaef8f...5d5a7a67384ad03007eea1f365ee255c02a40fa3,1,102,14,116,2,2007-07-27 07:02:05,2007-07-26 17:34:14
5d5a7a67384ad03007eea1f365ee255c02a40fa3...6cbf973c9a6f06e9c45b3f6a76f0ceae8e7fd291,1,18,12,30,9,2007-07-27 07:02:05,2007-07-26 16:55:28
6cbf973c9a6f06e9c45b3f6a76f0ceae8e7fd291...65a5a21d024373674d6068a03c71558035775e0c,1,15,0,15,1,2007-07-27 07:02:05,2007-07-27 05:13:12
55d1932bce99d83fa0d891331fe3f3562d33af2e...f9286765b2c409e5b88efe8c20a2634d6842bc5f,1,1,0,1,1,2007-08-11 06:50:00,2007-08-06 13:05:56
7e508eb1a2efce72be1651a35ab3150bfa3c88d6...7aecb128779ffd8258f01f4382df963900ae6acd,1,5,3,8,3,2007-06-30 04:43:20,2007-06-29 11:32:29
e58db03bbee4af96e60b6ac88b84c1c11b8b037e...730b5b45fb8a7751106885d350466c197b671b1c,3,12,4,16,6,2007-06-10 12:27:29,2007-06-06 01:19:47
730b5b45fb8a7751106885d350466c197b671b1c...301ac38b12126133445d544f7cc5d65768b9310f,1,29,17,46,1,2007-06-10 15:17:30,2007-06-10 15:17:30
301ac38b12126133445d544f7cc5d65768b9310f...e36cb1c16dfd10622fb9da1dffb478240b7e7713,2,3,1,4,2,2007-06-10 22:15:17,2007-05-30 17:42:41
e36cb1c16dfd10622fb9da1dffb478240b7e7713...6cfec0368038ec4c564798701e95a84658e6b705,1,7,7,14,3,2007-06-10 23:00:36,2007-06-10 23:00:36
e58db03bbee4af96e60b6ac88b84c1c11b8b037e...f291504563a5c96862e600247d233f91572a005f,1,4,4,8,2,2007-06-10 01:16:12,2007-06-10 01:15:24
f291504563a5c96862e600247d233f91572a005f...b82871b3c32faa8a317007f343fdf2d0ddc9954e,2,12,3,15,7,2007-06-10 01:34:58,2007-06-10 01:14:56
e58db03bbee4af96e60b6ac88b84c1c11b8b037e...f1eccbab638df66a7d8ec881f6f695514b26f44f,2,16,2,18,4,2007-06-09 18:53:05,2007-06-09 12:40:35
e58db03bbee4af96e60b6ac88b84c1c11b8b037e...54a8ad925cfac90bb4141c9904b1f97f0c5b83d4,1,86,73,159,12,2007-06-09 18:53:01,2007-06-09 06:22:58
54a8ad925cfac90bb4141c9904b1f97f0c5b83d4...163f0ee5ad0a5cb7d862431479c270ae3fef79cf,1,17,18,35,5,2007-06-09 18:53:01,2007-06-09 07:07:34
163f0ee5ad0a5cb7d862431479c270ae3fef79cf...3c8b7df1ba6dd2093672afc460fd5de0e755f162,1,12,11,23,8,2007-06-09 18:53:01,2007-06-09 07:14:04
3c8b7df1ba6dd2093672afc460fd5de0e755f162...6125796f7d6e8b84431f92c13d7e79bd30f94f53,2,112,1,113,4,2007-06-09 18:53:01,2007-06-09 08:23:53
6125796f7d6e8b84431f92c13d7e79bd30f94f53...1ed10b886bc69c129c06772ee4310c00e001657f,2,53,6,59,3,2007-06-09 18:53:01,2007-06-09 08:37:14
1ed10b886bc69c129c06772ee4310c00e001657f...bb9fca80ce27eeb5a29a9ef1d2b4447b28882e54,1,22,3,25,2,2007-06-09 18:53:01,2007-06-09 18:01:23
c7c84859ad586ae5670224e1abc4f846f7c3a9ae...582c7393a47894ea299a82c2ae91fec3101e7559,1,3,0,3,1,2007-06-27 01:02:13,2007-06-26 21:19:41
582c7393a47894ea299a82c2ae91fec3101e7559...1164f1e48d7c8ed613e8a371ecfce27220606e09,1,4,1,5,1,2007-06-27 01:02:15,2007-06-26 21:34:02
1164f1e48d7c8ed613e8a371ecfce27220606e09...e3ae6bb9aaf030251f1d13c4de3aa220cf282460,1,18,12,30,3,2007-06-27 01:17:53,2007-06-26 23:44:22
e3ae6bb9aaf030251f1d13c4de3aa220cf282460...e373bb73889e15452b622df67465b77803876aa6,1,2,0,2,2,2007-06-27 01:19:20,2007-06-25 14:03:53
e373bb73889e15452b622df67465b77803876aa6...b69ba460bb0710b2af8a20b4b0d62233f29401ec,2,12,2,14,2,2007-06-27 01:20:47,2007-06-25 14:03:54
c43f64a0afd7b4bd87ec83449995fad21b741af6...aa32eedc69e4966cc822a2f9f07c30b437e40b8c,1,1,1,2,1,2007-06-13 05:16:29,2007-06-12 20:59:21
aa32eedc69e4966cc822a2f9f07c30b437e40b8c...9a7d941056fcf6df8324097b73c78353174e4e1b,1,3,1,4,2,2007-06-13 05:22:06,2007-06-07 09:27:08
9a7d941056fcf6df8324097b73c78353174e4e1b...6718f1f0d07167128c2d23c15081ea5660e865e9,1,1,0,1,1,2007-06-13 05:26:07,2007-06-09 20:34:16
6718f1f0d07167128c2d23c15081ea5660e865e9...6815e56933f5bb03d6af1eb2d2b356356cf7bf8e,2,25,11,36,5,2007-06-13 06:00:31,2007-06-11 13:39:44
684a93d958262695473b6e3ff815df1ec948e4b7...66688334375adbc469419692a16857f3cda01a21,1,1,7,8,1,2007-06-09 09:03:30,2007-05-16 11:15:07
a6080a0a44d5ead84db3dabbbc80e82df838533d...709b148a907e68bfb57808de8f65b186cc9a5e21,1,4,4,8,4,2007-06-08 09:37:18,2007-05-30 04:47:08
709b148a907e68bfb57808de8f65b186cc9a5e21...225696af2ceaa2e06345954003eda742a76c4e0a,1,3,0,3,1,2007-06-08 09:37:18,2007-05-30 04:47:09
225696af2ceaa2e06345954003eda742a76c4e0a...4890888d742e12044b1f4b89a5d10437a6371253,2,45,0,45,2,2007-06-08 09:37:18,2007-06-07 14:57:00
4890888d742e12044b1f4b89a5d10437a6371253...e1944f4074f845e4dd15fb77856b4463f51c7d81,1,0,2,2,1,2007-06-08 09:37:18,2007-06-07 20:44:59
e1944f4074f845e4dd15fb77856b4463f51c7d81...52fae7de4e8455dad048f1b8a645729571c42848,5,7,7,14,6,2007-06-08 09:37:19,2007-06-07 20:45:00
52fae7de4e8455dad048f1b8a645729571c42848...2d93b9facef75d1880a2979366d36bc1832e8c1d,2,8,11,19,6,2007-06-08 09:37:19,2007-06-08 09:24:58
2d93b9facef75d1880a2979366d36bc1832e8c1d...fcd056a6d23bafb13f991ffb673fb87c7100b8f2,3,4,6,10,3,2007-06-08 09:37:19,2007-06-08 09:22:56
fcd056a6d23bafb13f991ffb673fb87c7100b8f2...16befb8b7fbfcc9b2d38931f4081669558300adf,9,6,32,38,12,2007-06-08 09:54:57,2007-06-08 09:54:57
a6080a0a44d5ead84db3dabbbc80e82df838533d...6e66bf3c7953d68a5a2d57300e0f9077cf1767bf,1,27,12,39,12,2007-06-08 07:40:39,2007-06-07 23:43:05
6e66bf3c7953d68a5a2d57300e0f9077cf1767bf...bcdb34f70d59d4e090ef9a34e4b77fe7e5369f3e,1,82,0,82,1,2007-06-08 07:43:22,2007-06-08 07:43:22
f4f51add2712293b7bc9e7aaebf6a589bb37c7c7...4394efecfa9f94ad14fe49bc9f499c5806aa83af,1,18,4,22,9,2007-06-13 06:04:14,2007-06-08 20:57:55
71e66ecf0f0be3bffedd2cbfb55cab97a747c4bb...27c96c4fd38ffbde98df22699c755a043bb383d1,1,1,1,2,1,2007-06-09 17:07:29,2007-06-09 06:31:12
27c96c4fd38ffbde98df22699c755a043bb383d1...e876e741113e63e5ee1641baddb2d537bec5ddb8,1,0,7,7,2,2007-06-09 17:51:46,2007-06-09 00:12:37
0f2890acd999e63892d0b5b401e70bdaefe3ba51...55f22ff22e5ff6c21b50cf379ee946f9642fc3cb,2,16,0,16,2,2007-06-23 06:20:44,2007-06-21 17:05:30
3270736bd1e63c63679f64f8325690889322df08...9489d0f197185d584294aa99a09a1b3c5ebb25e0,1,2,1,3,2,2007-06-06 23:08:37,2007-06-06 07:16:56
99b5a79e1329468bee26ae3bd9070c47418279d0...b33271808ba3fdbad66cfc3827b8849a1f3095bc,1,4,2,6,2,2007-05-29 07:27:06,2007-05-28 22:48:07
b33271808ba3fdbad66cfc3827b8849a1f3095bc...2e4aef58932cdb345893103d77823a9dd6a146a6,1,7,5,12,5,2007-05-29 07:27:21,2007-05-27 03:09:27
2e4aef58932cdb345893103d77823a9dd6a146a6...b3c81cff02e56a62bd657148da757fdfd8dc6255,1,2,0,2,2,2007-05-29 07:27:21,2007-05-27 12:33:09
b3c81cff02e56a62bd657148da757fdfd8dc6255...24a97d84adb649ca5d90c9b1e6d894f4acee1a6b,2,34,3,37,6,2007-05-29 07:27:21,2007-05-27 12:33:10
99b5a79e1329468bee26ae3bd9070c47418279d0...843366961cf14aad6490fbeb30f7b98f37f8833a,1,57,51,108,11,2007-05-27 03:28:13,2007-05-26 01:38:58
843366961cf14aad6490fbeb30f7b98f37f8833a...366b53c170ed4ac6a497757da1cbd0e316e48767,1,6,13,19,3,2007-05-27 03:28:13,2007-05-26 02:16:27
99b5a79e1329468bee26ae3bd9070c47418279d0...d079837eeeadc37d266113a1fd2deb0a01aaee91,5,49,6,55,13,2007-05-27 03:28:08,2007-05-26 05:24:19
d079837eeeadc37d266113a1fd2deb0a01aaee91...7dc24aa5a62cc5f77e6637674581c837f4bdf78e,1,3,2,5,2,2007-05-27 03:28:08,2007-05-26 05:24:40
7dc24aa5a62cc5f77e6637674581c837f4bdf78e...693d2bc625e7168299741d673e7205e9d2c969df,1,1,1,2,2,2007-05-27 03:28:08,2007-05-26 05:25:11
693d2bc625e7168299741d673e7205e9d2c969df...1055880e7c096907ac87203dd83fdc6830251115,1,5,2,7,1,2007-05-30 00:53:44,2007-05-29 23:29:51
1055880e7c096907ac87203dd83fdc6830251115...7ff895c0d229c2c60b73e91b0c389a4e3ce69e46,1,10,0,10,1,2007-05-30 05:50:10,2007-05-30 04:50:26
7ff895c0d229c2c60b73e91b0c389a4e3ce69e46...eaa867703927c1f383637979d16c40d996cea240,2,2,2,4,2,2007-05-30 06:30:11,2007-05-30 06:12:28
eaa867703927c1f383637979d16c40d996cea240...b77ffe8a57a0921f58cff22dcf1ed6ae64d89d6a,1,4,1,5,1,2007-05-30 06:31:06,2007-05-30 06:13:14
b77ffe8a57a0921f58cff22dcf1ed6ae64d89d6a...bc8e478a285ff549a3e5182461b064313d400de3,1,1,1,2,1,2007-05-30 06:31:19,2007-05-30 06:13:42
99b5a79e1329468bee26ae3bd9070c47418279d0...70c7ac22de681a83621bda03e676348170c8d8a2,5,262,1,263,5,2007-05-27 03:24:07,2007-05-26 13:56:40
70c7ac22de681a83621bda03e676348170c8d8a2...88961ef2589433044365213fab98de081a1ce70f,1,143,0,143,1,2007-06-02 19:48:07,2007-06-02 01:27:42
c80e07d4959591f5addcd48c7d42017b40c25f36...7ca055f75ad7ffd2251d4b607fbb86d7bcfd77c7,1,5,5,10,2,2007-05-23 18:06:38,2007-05-23 11:13:21
e50cd67ba477133458158a016ffabb8e4bfc81bf...71069cdfc7fe0ebcf3735cd75a82b49b3098f870,1,1,1,2,1,2014-11-10 18:06:25,2014-11-09 16:19:33
71069cdfc7fe0ebcf3735cd75a82b49b3098f870...a79c3a1b815b2ee5bdf5ad0d2c0c0cebbaa74fa9,1,1,1,2,1,2014-11-10 19:25:26,2014-11-08 10:45:39
ca6c097089a38d447de0190ea61e9746a40a170c...b10ee7606e14265c6116639aafccb863b77043f5,1,1,1,2,1,2007-06-12 08:06:21,2007-06-11 19:12:21
b10ee7606e14265c6116639aafccb863b77043f5...bf2d824660c976e0d0e773f9c5095a6abaf388ae,1,5,4,9,2,2007-06-12 08:06:21,2007-06-11 19:12:22
bf2d824660c976e0d0e773f9c5095a6abaf388ae...d57dd255a696cb68c880110a990085c08343f618,2,2,2,4,2,2007-06-12 08:06:21,2007-06-11 19:12:23
d57dd255a696cb68c880110a990085c08343f618...941987a554812b982094e09c5c817f18be953365,2,47,18,65,18,2007-06-12 08:06:21,2007-06-11 19:12:24
941987a554812b982094e09c5c817f18be953365...891dbc6e40b93a2fa5c4af74e2684d40fb1aad4c,2,63,1,64,2,2007-06-12 08:06:21,2007-06-12 07:05:21
891dbc6e40b93a2fa5c4af74e2684d40fb1aad4c...a88ca3427770b9142db71c29154abcce4c5b8a9d,1,1,1,2,1,2007-06-16 05:46:04,2007-06-13 22:01:10
5b6dedd6a0b7566f7e8466b6aefe8f019c52f5d3...bc4e7d035840539eb5aa13ab3d51ab43cc2c1b50,1,2,2,4,1,2007-05-22 01:34:14,2007-05-21 07:58:01
bc4e7d035840539eb5aa13ab3d51ab43cc2c1b50...243bfd33997484ee8ea2450f1910306f7138193b,1,13,0,13,1,2007-05-22 01:35:37,2007-05-21 12:48:49
243bfd33997484ee8ea2450f1910306f7138193b...0ba956d331e4c14fb1600a62044492c6c27af71a,4,39,0,39,6,2007-05-22 01:36:02,2007-05-22 00:12:17
0eb032d86c99ac8f23435ad5ea9f2b83f1be744f...22e5e58a3c75b73764b860907e4d871195f276ac,17,26,26,52,25,2010-08-22 20:25:08,2010-08-22 11:12:12
0eb032d86c99ac8f23435ad5ea9f2b83f1be744f...506049c7df2c68f1db5a4bae502cfb1af0a73048,1,8,1,9,1,2010-08-22 06:53:26,2010-08-21 05:00:13
02377cf4bc6050cdbf600ce65114a5438b049763...e1e9115dcd647ce59f4ce7501ec1ee84aa574aab,1,1,1,2,1,2010-09-07 00:30:57,2010-09-06 18:12:09
e1e9115dcd647ce59f4ce7501ec1ee84aa574aab...1d02a0055a01478d6253c405b346297bd4217bb1,1,1,1,2,1,2010-09-07 00:31:04,2010-09-06 18:12:10
1d02a0055a01478d6253c405b346297bd4217bb1...052fbea26e51121d155ccaa3b0ae6ac892cc41ea,3,17,1,18,7,2010-09-07 00:31:06,2010-09-06 18:12:11
fc7642a096b99295a636ebde03e4b951a7da9c5a...68595cd442caabbd8b43ff0789d2829454efff1b,1,15,18,33,4,2011-02-10 00:06:47,2010-11-28 19:43:57
68595cd442caabbd8b43ff0789d2829454efff1b...547e8b9205349b47003ed25a82673e413e71c255,3,9,0,9,3,2011-02-10 00:06:51,2011-02-09 22:43:57
9db41eba4259126dbe1c68e2207d342d11f14745...920a5d436b0309072de598a44b493ba0793b074c,1,0,4,4,1,2011-01-10 17:09:02,2011-01-10 12:42:23
1b6ecbad3511b1aaa65172ef8b520dd3b5141614...9904fadfea002edf2ef22e8ec9a978e45d1f540b,1,3,2,5,2,2010-09-10 16:31:13,2010-09-10 01:39:37
7505ae272bad53c6451f34ff5f04ad24f29b6dd9...761e742d69296393804e9a942263e86ece369257,111,107,107,214,19,2010-09-07 00:41:18,2010-09-07 00:29:57
761e742d69296393804e9a942263e86ece369257...3a4e6c727f939414c96a01c097c8e9f2feb201d6,1,1,1,2,1,2010-09-09 23:17:59,2010-09-09 23:17:59
6b3020a241e2c0a1eaa6b74a10a796603bb90975...cbcab75c54b5956dcaa4f24a4074bc99adc49629,3,12,2,14,3,2010-12-02 20:13:27,2010-12-02 20:06:06
e5498e8a9f9a596ecff78426bbf904626cd7863a...245b10ca1b0ff21de42b12ee2c1e3c9f8d1d98a3,3,13,2,15,4,2010-07-27 23:36:51,2010-07-27 22:04:49
ffd45f967817a484933c7f905572c9f31f9b9aab...ec136663c7d5a8e2ce1664ce79f2297e2e61c86f,1,3,3,6,3,2010-07-26 06:14:18,2010-07-22 16:58:20
ec136663c7d5a8e2ce1664ce79f2297e2e61c86f...938791cd01bfb9729feed95a12f743fd077d0467,2,13,7,20,8,2010-07-26 06:14:18,2010-07-22 19:15:11
938791cd01bfb9729feed95a12f743fd077d0467...c1e02b2b383a6cd29353067c942384028745314c,1,6,3,9,3,2010-07-26 06:14:18,2010-07-22 08:13:33
c1e02b2b383a6cd29353067c942384028745314c...0edf06dc4008ff8152cf777c44875ef49d04b6f7,1,33,0,33,1,2010-07-26 06:14:18,2010-07-25 03:57:35
0edf06dc4008ff8152cf777c44875ef49d04b6f7...cdad3c54f1020b0b1c0d2d907748f77a60b41a28,1,7,0,7,1,2010-07-26 06:14:18,2010-07-25 09:30:32
cdad3c54f1020b0b1c0d2d907748f77a60b41a28...5d314759d787885c2cc389efbfb3aea1c47b56d9,1,6,6,12,6,2010-07-26 06:14:18,2010-07-24 15:20:23
5d314759d787885c2cc389efbfb3aea1c47b56d9...662c83ff8ffa714efab5d7d530bd7d4f82e3ef03,1,4,0,4,1,2010-07-26 06:14:19,2010-07-24 16:07:53
662c83ff8ffa714efab5d7d530bd7d4f82e3ef03...9a9fb5d3c4c8601beb2d7b8e3b9283c6c3815a2d,1,23,10,33,1,2010-07-26 06:14:19,2010-07-24 16:03:15
cb7529e13bce186f8b883c9fbb08602cd3a0795f...81f4953120f021832a0023dc704a0d7eb0ddf475,1,35,0,35,1,2011-08-25 23:40:48,2011-08-25 16:49:13
81f4953120f021832a0023dc704a0d7eb0ddf475...281eee473000e5bd46e59d636626132dc9ea85cb,2,53,4,57,15,2011-08-26 00:35:44,2011-08-26 00:35:39
281eee473000e5bd46e59d636626132dc9ea85cb...c3502fa8822fab99ee51b3f74cf3f100492d88e2,2,11,7,18,4,2011-08-26 02:40:51,2011-08-26 00:51:50
c3502fa8822fab99ee51b3f74cf3f100492d88e2...c05b988a69c10d7eef2f34932eed61923c18b4a5,1,11,8,19,6,2011-09-15 15:53:11,2011-09-15 08:34:31
66cfd1026ffadc9dd7053823196af7578aa112bf...e92e9cd3c388544f4f521736df844b37908c3879,1,34,9,43,3,2010-04-23 19:33:41,2010-04-23 17:40:15
be2fb164ec2ec6837428201390ebe30f6f8798b5...1d8cd418b49f08146d6d47cf8881965f922686cb,1,9,9,18,3,2010-03-07 08:37:35,2010-03-06 15:40:38
1d8cd418b49f08146d6d47cf8881965f922686cb...ebaa79f462c48e0ed0341d9c8f9c97de557afcfd,4,10,14,24,11,2010-03-07 08:37:35,2010-03-06 15:40:39
ebaa79f462c48e0ed0341d9c8f9c97de557afcfd...5f8763a81b96b94f24af6aa728107997adcf60bd,1,1,1,2,1,2010-03-07 08:37:35,2010-03-06 15:40:40
5f8763a81b96b94f24af6aa728107997adcf60bd...912b26324dbc1eb9500e49c90d271a330cbcb30b,2,33,0,33,4,2010-03-07 08:37:36,2010-03-06 15:40:41
912b26324dbc1eb9500e49c90d271a330cbcb30b...200a76b74db5c2c75bcf73773cb85c5603ec038e,3,34,20,54,16,2010-03-07 08:37:36,2010-03-06 15:40:42
200a76b74db5c2c75bcf73773cb85c5603ec038e...0ea1c89ba616397ef7e5f6f601ef7a24d2c27b8e,1,34,0,34,4,2010-03-07 08:37:36,2010-03-06 15:40:43
0ea1c89ba616397ef7e5f6f601ef7a24d2c27b8e...f6b6098316192475ff0b3fa2ba894d7e555bdfac,4,10,14,24,11,2010-03-10 22:26:54,2010-03-09 20:00:36
be2fb164ec2ec6837428201390ebe30f6f8798b5...8b74d75cd26d28d38d2ff88267585fc308b89cef,2,16,0,16,2,2010-03-07 07:58:33,2010-03-06 20:34:40
8b74d75cd26d28d38d2ff88267585fc308b89cef...cac42b266a5868fc54b2e54986fa2689676ec447,2,4,1,5,2,2010-03-07 07:58:46,2010-03-06 20:34:41
cac42b266a5868fc54b2e54986fa2689676ec447...c62f6ec341b1a768be7c9adf84d07c5b3b113a81,1,40,3,43,9,2010-03-07 07:58:47,2010-03-06 20:34:42
c62f6ec341b1a768be7c9adf84d07c5b3b113a81...b5c1a28b4c7d7e1324fa3e88ae03801d4fe9f6bb,1,98,0,98,1,2010-03-07 07:58:47,2010-03-06 20:34:43
b5c1a28b4c7d7e1324fa3e88ae03801d4fe9f6bb...ab7e63e85f2307447f8fc6679e1f355385881236,1,5,1,6,2,2010-03-07 07:58:47,2010-03-06 20:34:44
ab7e63e85f2307447f8fc6679e1f355385881236...8e75abfd8dc6649d800b8877304eaa0fd404c10f,1,3,12,15,2,2010-03-20 18:19:36,2010-03-06 20:34:46
8e75abfd8dc6649d800b8877304eaa0fd404c10f...28db756feead84929cdfaaee8bccd301384daab4,1,2,1,3,2,2010-03-21 02:25:48,2010-03-21 02:01:20
be2fb164ec2ec6837428201390ebe30f6f8798b5...a9f979093dabe8b1c7bf8d67863adc378a8bec45,3,19,9,28,7,2010-03-05 10:57:54,2010-03-03 20:10:21
a9f979093dabe8b1c7bf8d67863adc378a8bec45...402e139c7e30eb95312aeafdc1a9e8e8167c14cb,1,1,1,2,1,2010-03-05 10:57:57,2010-03-03 20:10:22
402e139c7e30eb95312aeafdc1a9e8e8167c14cb...942c9aad4f3b69f6f53af77321662d9d69a1bdeb,1,0,1,1,1,2010-03-05 10:58:11,2010-03-03 20:10:23
942c9aad4f3b69f6f53af77321662d9d69a1bdeb...b0779246a11d4213c4d9d8af8d3f6e39649c9b4a,1,1,0,1,1,2010-03-05 11:02:51,2010-03-04 10:23:53
81b50f3ce40bfdd66e5d967bf82be001039a9a98...5e838ea7aa74dfbc9820bcf798c0f118e91532f9,2,14,0,14,4,2011-09-04 19:27:17,2011-09-04 19:26:14
5e838ea7aa74dfbc9820bcf798c0f118e91532f9...dab76d3aa682a340e886df84da33326368c38633,3,35,7,42,11,2011-09-04 19:39:32,2011-09-04 19:37:45
dab76d3aa682a340e886df84da33326368c38633...b10a53583f5725b796de630c946e41bbd48fcfe2,1,104,0,104,1,2011-09-05 01:19:36,2011-09-05 01:19:36
e4b023332c687d824cff41855b41f604ee72e0d2...dc61b10d987d32522803044eccaa801ffbca4bfe,1,1,2,3,1,2007-04-14 02:06:40,2007-04-13 22:19:05
dc61b10d987d32522803044eccaa801ffbca4bfe...1ad029b6a1e2fb0254667a2bea8d1ee180cc6ac7,1,26,10,36,2,2007-04-14 02:34:35,2007-04-13 10:23:20
1ad029b6a1e2fb0254667a2bea8d1ee180cc6ac7...eabb0bfd09031d334152a268c47feb2bc3796a3e,1,7,0,7,1,2007-04-14 02:39:28,2007-04-13 16:02:30
eabb0bfd09031d334152a268c47feb2bc3796a3e...5cb71f82de7fc370dfcd7aad505c36d89e8fec5d,1,10,0,10,1,2007-04-14 02:39:28,2007-04-13 16:02:31
5cb71f82de7fc370dfcd7aad505c36d89e8fec5d...5007af8c7ed04ae5074ee84491526d416d460f97,1,2,2,4,2,2007-04-14 02:39:28,2007-04-13 16:02:32
5007af8c7ed04ae5074ee84491526d416d460f97...befc9c42043d67c2ccf5a8a0b660aac8e84bbeee,1,1,1,2,1,2007-04-14 02:39:28,2007-04-13 16:02:33
befc9c42043d67c2ccf5a8a0b660aac8e84bbeee...1fa9bf362acbe2c939c246684ab0fe59aec74ba8,1,2,2,4,2,2007-04-14 10:39:36,2007-04-13 21:34:18
9a1ae9ab03abaffc977421f182997f3e735e7098...66c4509b73eeb66de3196a43e3171b3764f74100,1,2,0,2,2,2006-08-15 09:55:39,2006-08-15 09:01:22
66c4509b73eeb66de3196a43e3171b3764f74100...1d6249e609289940dca179b626fe4ae5433c90cc,2,8,1,9,3,2006-08-16 04:00:20,2006-08-16 00:20:32
1d6249e609289940dca179b626fe4ae5433c90cc...53e1a761be8d338cd957870bc1e48a8c15d7d2c0,1,3,8,11,3,2006-08-16 04:02:16,2006-08-15 23:28:08
4d62eaabeb283d6dab56cfb2f2e54144b98afafd...2718ff098a1cd1bf48fc230164259b56e3e7178f,4,58,13,71,14,2006-07-04 21:50:35,2006-07-04 19:29:10
2718ff098a1cd1bf48fc230164259b56e3e7178f...4bbf599f7bb6bd6debb3624b27815f366b7b34a1,1,1,1,2,1,2006-07-05 23:17:47,2006-07-05 12:14:00
4bbf599f7bb6bd6debb3624b27815f366b7b34a1...b5dd9d2027c1bd5758033c7baf6d087752b0263d,1,7,6,13,4,2006-07-05 23:17:56,2006-07-04 22:35:52
4d62eaabeb283d6dab56cfb2f2e54144b98afafd...5390590f6d72ffb80da74ed4cbc8648400ea3481,1,5,1,6,2,2006-07-04 10:15:46,2006-07-04 09:31:50
5390590f6d72ffb80da74ed4cbc8648400ea3481...fcfe34b5ace3e75d37c462712c7103e39cdb1fbc,1,10,5,15,3,2006-07-04 10:15:46,2006-07-04 09:43:40
fcfe34b5ace3e75d37c462712c7103e39cdb1fbc...088b084bbbb7c076a85db941ad60edce582017b4,1,11,4,15,5,2006-07-04 10:15:46,2006-07-04 09:44:48
fff8fd5b1ee9c13694c29ba3544f5b1ebf0f4fb2...1b03dfed182a1dc47cc0eb1047a34cd914440ce6,1,3,3,6,3,2006-07-29 00:13:00,2006-07-29 00:10:07
1b03dfed182a1dc47cc0eb1047a34cd914440ce6...818f477c40fee62ab8ea5b493c51bb357f38957c,2,17,0,17,5,2006-07-29 03:53:53,2006-07-29 03:44:51
e6a4e5816e0b521713e899cafa60b0dd6bc74eec...ca7a741647f961eb3b6b9df14d079c99fdc9a827,1,3,0,3,1,2006-07-30 20:36:12,2006-07-29 16:26:18
ca7a741647f961eb3b6b9df14d079c99fdc9a827...41e95f699088b14c6a949ec858499f98df4f34f6,1,4,0,4,1,2006-07-31 00:45:57,2006-07-30 01:30:29
41e95f699088b14c6a949ec858499f98df4f34f6...0347a8c7648ea9504badce7bb4ed4c4f3dbacf16,1,36,40,76,6,2006-07-31 00:45:57,2006-07-30 01:30:29
0347a8c7648ea9504badce7bb4ed4c4f3dbacf16...b63fafdfd844c2037fba53b9944431c1378b4135,1,5,0,5,1,2006-07-31 01:18:13,2006-07-31 00:26:27
3cd4f5e8eb04ae01298ceaf46bb41a4277031916...0bef57ee44a2f924ad0066b751a3c87888633f56,7,11,13,24,9,2006-08-15 22:06:03,2006-08-15 20:37:19
0bef57ee44a2f924ad0066b751a3c87888633f56...6f002f984f1d1ddfdae990582a423dc5263697ae,4,8,8,16,8,2006-08-15 23:12:09,2006-08-15 17:40:06
3cd4f5e8eb04ae01298ceaf46bb41a4277031916...789a09b4874ae2616987794e0e739b8227957175,1,1,5,6,3,2006-08-15 10:39:47,2006-08-15 10:39:47
789a09b4874ae2616987794e0e739b8227957175...520cd3eca5743bebd217423e1fd0721f32613bb1,1,193,0,193,1,2006-08-16 04:32:54,2006-08-15 20:09:49
520cd3eca5743bebd217423e1fd0721f32613bb1...42f774063db1442fc3815f596d263f90dcd8380b,3,42,4,46,5,2006-08-16 04:38:07,2006-08-16 04:38:07
42f774063db1442fc3815f596d263f90dcd8380b...0fc82cff12a887c1e0e7e69937dbd8a82843c081,1,1,52,53,2,2006-08-16 05:12:54,2006-08-16 04:40:43
409d1d2053657f73a3222651111740606122aa80...d4baf9eaf47ea1ba204f1ab5ecd22326913dd081,1,2,1,3,2,2006-08-17 10:04:38,2006-08-17 09:21:28
409d1d2053657f73a3222651111740606122aa80...03eb8f8aeb8a483b11b797cca012fdded818a5c1,1,7,3,10,4,2006-08-17 04:08:45,2006-08-16 23:07:20
03eb8f8aeb8a483b11b797cca012fdded818a5c1...d4c452f03b49072ebb46fc524e6d85056a35ef13,1,8,2,10,3,2006-08-17 04:08:45,2006-08-16 23:08:14
d4c452f03b49072ebb46fc524e6d85056a35ef13...2cda1a214e9d2e362242027b4b622ecb3d9260de,3,49,6,55,9,2006-08-17 04:08:45,2006-08-16 23:09:25
2cda1a214e9d2e362242027b4b622ecb3d9260de...57dc397cff09bfabd79ddbc38b704cdd0c2bc6e3,3,198,23,221,31,2006-08-17 08:23:08,2006-08-17 00:55:29
57dc397cff09bfabd79ddbc38b704cdd0c2bc6e3...82e2765f59126f96da6e5dc30adf7c6189e9697d,2,80,49,129,17,2006-08-18 10:10:19,2006-08-18 10:10:19
82e2765f59126f96da6e5dc30adf7c6189e9697d...a2bf404e280b8d56d0efa15bd9700464cf8f0d4d,2,84,2,86,10,2006-08-18 10:14:48,2006-08-18 10:14:48
a2bf404e280b8d56d0efa15bd9700464cf8f0d4d...0e9ee32358413feaa4e1cb664cb0a1e6d52f434f,1,1,1,2,1,2006-08-22 22:49:28,2006-08-22 22:49:28
0e9ee32358413feaa4e1cb664cb0a1e6d52f434f...8938045a4eae7a9c39631508a3c3d34c50c6257a,2,3,3,6,2,2006-08-27 22:53:20,2006-08-27 22:53:20
3fbe2d54d7d91378934df7b16d70dc5877586fae...0f03ca946142bd656c1af9ff811cb9efbc8314da,3,23,4,27,9,2006-11-24 10:35:26,2006-11-23 09:36:33
7b520e62a2738ce776d1c9f11144021ff1fc63b6...f8f0b1f0e7e96bf996c657d2c5c15e0ba3a4eeac,1,2,2,4,2,2006-07-17 06:25:12,2006-07-17 06:25:12
7b520e62a2738ce776d1c9f11144021ff1fc63b6...8641fb24ee3ab86bac62f88d31f6e92a9323f699,1,105,0,105,1,2006-07-17 05:15:21,2006-07-16 10:38:40
8641fb24ee3ab86bac62f88d31f6e92a9323f699...c28c571c143a5145665f4bf334671ac3a7d0980c,1,18,3,21,2,2006-07-17 06:28:36,2006-07-17 06:28:23
c28c571c143a5145665f4bf334671ac3a7d0980c...eed46644ca48ad08e1fd71e14afbe801399e8a67,1,17,7,24,6,2006-07-17 06:52:09,2006-07-17 06:52:09
eed46644ca48ad08e1fd71e14afbe801399e8a67...7f95aef28fa1e2662aebb4556c71ad6912d395e5,1,24,5,29,7,2006-07-17 07:10:47,2006-07-17 07:10:47
7f95aef28fa1e2662aebb4556c71ad6912d395e5...56ac168f6f89bebf2846c4bafed01318fe3f25cd,1,1,1,2,1,2006-07-24 06:27:41,2006-07-18 17:46:34
495473c08a957464e7e326ae7bafb477db90fcbe...d327244a8435539b62d73ab151bd6c46324cbeb6,1,10,12,22,9,2005-11-28 09:41:56,2005-11-28 09:41:56
d327244a8435539b62d73ab151bd6c46324cbeb6...671bc1538a88d82096a8e59d9ccef4f4a5c40a32,1,8,1,9,1,2005-11-28 09:46:49,2005-11-28 00:12:51
302ebfe52192fff9a2c1c612dff22325fd073acc...bb931cf9d73d94d9940b6d0ee56b6c13ad42f1a0,1,21,0,21,3,2005-11-22 20:38:16,2005-11-18 22:17:50
bb931cf9d73d94d9940b6d0ee56b6c13ad42f1a0...60435f68bb1ff319f9a718c91c0efff7c495dcc4,1,26,6,32,6,2005-11-22 20:38:21,2005-11-22 14:56:35
60435f68bb1ff319f9a718c91c0efff7c495dcc4...2b6e34c1a3c5d787f478c32a359cfe50cb8114b8,1,0,2,2,2,2005-11-22 20:38:23,2005-11-22 14:58:41
2b6e34c1a3c5d787f478c32a359cfe50cb8114b8...d1ab157759f0738a13bfb04bca8c436814913d4b,1,8,7,15,4,2005-11-22 20:38:25,2005-11-22 14:59:22
d1ab157759f0738a13bfb04bca8c436814913d4b...c61642185d411e5e3350566a68483e358ca392b9,1,1,1,2,1,2005-11-22 20:38:27,2005-11-22 13:54:23
c61642185d411e5e3350566a68483e358ca392b9...b99a394cd1e7042ad219046a6ea81ad3f93004ca,1,10,10,20,7,2005-11-24 00:10:11,2005-11-24 00:08:36
b99a394cd1e7042ad219046a6ea81ad3f93004ca...fbf8ac212caa74fc506434da83f8e9630b09ed12,1,12,8,20,4,2005-11-24 00:23:11,2005-11-24 00:23:11
fbf8ac212caa74fc506434da83f8e9630b09ed12...073dab137a746a44606e8e11629e05ff8343346f,1,17,8,25,6,2005-11-24 00:51:26,2005-11-23 11:04:23
073dab137a746a44606e8e11629e05ff8343346f...30c7bb249e9b2038dd05271e055d347f84336576,1,5,1,6,3,2005-11-24 00:52:52,2005-11-23 17:57:54
30c7bb249e9b2038dd05271e055d347f84336576...b7884981f8f2a063f577df12c65e9af8b1a4f1b8,1,11,7,18,8,2005-11-24 01:19:37,2005-11-24 00:56:55
b7884981f8f2a063f577df12c65e9af8b1a4f1b8...9c20a4706767e6003e62f6500ed94ccddcbe322f,2,8,6,14,4,2005-11-24 06:25:55,2005-11-22 05:46:57
9c20a4706767e6003e62f6500ed94ccddcbe322f...a50b870aa18738ec10ed31fd4a32a284ee1cfe50,1,25,29,54,15,2005-11-24 06:25:55,2005-11-22 05:49:06
a50b870aa18738ec10ed31fd4a32a284ee1cfe50...ee72aeaf009417156a3599b0eb69da3f7023ca07,6,51,51,102,44,2005-11-24 19:10:40,2005-11-24 10:36:01
ee72aeaf009417156a3599b0eb69da3f7023ca07...2c52a42dd720ed3cf1eadbc4a4e92be4cdf52f1d,1,1,1,2,1,2005-11-25 11:38:18,2005-11-25 01:37:09
2c52a42dd720ed3cf1eadbc4a4e92be4cdf52f1d...874fbc332349bb77d8da596d3fef534ad9afc0e9,1,1,1,2,1,2005-11-25 11:38:41,2005-11-25 10:03:05
874fbc332349bb77d8da596d3fef534ad9afc0e9...3a2f2bb354d920e3f1b7f4334d3656c77e9fb423,1,5,5,10,5,2005-11-25 19:10:49,2005-11-25 19:10:49
3a2f2bb354d920e3f1b7f4334d3656c77e9fb423...f678dd180a037283decb76201b537dca24de848f,1,4,1,5,2,2005-11-25 21:33:14,2005-11-25 21:33:14
f678dd180a037283decb76201b537dca24de848f...e8cc80d03934cc607e3a4d89a05350c238dbf9c5,2,3,2,5,2,2005-11-25 21:49:17,2005-11-24 07:46:13
e8cc80d03934cc607e3a4d89a05350c238dbf9c5...ae2b0f15180d4b044828c836bcab6a990efa5c8e,26,34,31,65,28,2005-11-25 21:49:17,2005-11-24 08:12:11
ae2b0f15180d4b044828c836bcab6a990efa5c8e...5d318ce6a9fb18448e4a1a9b61d355d391ddc5ec,1,2,0,2,1,2005-11-25 23:16:35,2005-11-24 09:31:01
5d318ce6a9fb18448e4a1a9b61d355d391ddc5ec...5e7bfe256755ef2862e960864db1edb829c82b77,1,37,5,42,6,2005-11-25 23:43:41,2005-11-25 23:43:41
5e7bfe256755ef2862e960864db1edb829c82b77...2a1ddc58e4d2220feea7eba4623dac07a0f83f94,1,2,7,9,1,2005-11-25 23:55:50,2005-11-25 23:52:57
80e0c0ab91e1cf6a6315d0431bf6873ebbf8bef0...bd66361195c5503261a2d1eef6aa685deb058ffb,3,45,0,45,3,2005-10-31 06:54:39,2005-10-31 04:05:32
60fb5b2c4d9e26204f480f8a18ae1ff0051a6440...7d167feb8bdb52a21a0ef1a4d3b2a8d1f1d413f1,1,2,0,2,2,2005-09-30 05:47:37,2005-09-29 16:19:50
7d167feb8bdb52a21a0ef1a4d3b2a8d1f1d413f1...cdda474525f67d6f7c8bb9ae8e4c6bada2c50afa,1,2,2,4,2,2005-09-30 05:47:40,2005-09-29 20:53:14
cdda474525f67d6f7c8bb9ae8e4c6bada2c50afa...264b16b621d9996006b73786b0ccdf8b80d29c49,1,5,3,8,3,2005-09-30 07:09:04,2005-09-30 07:09:04
264b16b621d9996006b73786b0ccdf8b80d29c49...894a8a8b1b935639ac2ea503e8fa2887fd6bd44b,2,6,11,17,5,2005-09-30 07:27:11,2005-09-30 07:27:11
953e5842f8fcd40c3e7013a9793746719016db1b...6d35cc76909512d386b503a3feb1b40c153c3195,6,157,2,159,9,2005-09-03 05:38:30,2005-09-03 04:19:26
6d35cc76909512d386b503a3feb1b40c153c3195...baeda3a749ddcb6feee8354cf2b6f8f55cbd7200,1,2,2,4,2,2005-09-04 17:18:45,2005-09-02 09:56:52
baeda3a749ddcb6feee8354cf2b6f8f55cbd7200...2ab141a26f93c4d97e243a6be8a38a7dd4eb35a3,3,7,7,14,7,2005-09-04 17:28:38,2005-09-02 12:17:10
2ab141a26f93c4d97e243a6be8a38a7dd4eb35a3...ce726ec8d80ccce4e4956a026d807cb02bdc6de9,1,2,1,3,2,2005-09-04 17:28:43,2005-09-04 09:43:16
ce726ec8d80ccce4e4956a026d807cb02bdc6de9...3292ae4794012994560816e6111d27c809f5e86a,1,20,17,37,13,2005-09-04 17:28:43,2005-09-04 10:55:06
3292ae4794012994560816e6111d27c809f5e86a...52586ecb16f2158de29daabb0ed72b094ca8d5cc,1,8,0,8,1,2005-09-04 17:28:43,2005-09-04 10:55:29
52586ecb16f2158de29daabb0ed72b094ca8d5cc...07a95d0ed36dea806e32f23df309506be74915db,1,2,1,3,1,2005-09-04 17:37:07,2005-09-04 17:37:07
07a95d0ed36dea806e32f23df309506be74915db...433ef8a2fb93627e311217b2a41b3132933e6b0b,1,7,3,10,3,2005-09-04 18:00:28,2005-09-04 17:29:02
433ef8a2fb93627e311217b2a41b3132933e6b0b...c743e6e3c0764ea784f9c13310d0eef5b57c52fb,1,21,2,23,1,2005-09-04 18:25:56,2005-09-04 18:25:56
c743e6e3c0764ea784f9c13310d0eef5b57c52fb...52be5fcd29e074cb549b9a92ff8caceb736e4851,1,148,0,148,1,2005-09-04 22:44:55,2005-09-04 22:40:18
2a29da7c6d6103c4719c71f6cce88e853260912c...9585e406224b97b24b46131005b809a6612a3eac,2,73,15,88,10,2005-08-24 04:08:59,2005-08-24 04:08:59
9585e406224b97b24b46131005b809a6612a3eac...0d6a873cfe4ba9428cf361c633faf701cadc04b8,1,3,0,3,1,2005-08-24 04:18:49,2005-08-24 04:18:49
2a29da7c6d6103c4719c71f6cce88e853260912c...6c5f9baa3bc0d63e141e0afc23110205379905a4,5,8,8,16,8,2005-08-24 03:41:11,2005-08-23 20:31:09
6c5f9baa3bc0d63e141e0afc23110205379905a4...c7c81b3a51de2778535c8bb18d42a4bb7dfd57bc,11,43,19,62,23,2005-08-24 03:41:12,2005-08-23 20:34:07
c7c81b3a51de2778535c8bb18d42a4bb7dfd57bc...3cd6ecda4a02e943934885910feeba957b730123,1,1,0,1,1,2005-08-24 03:41:12,2005-08-23 20:34:44
3cd6ecda4a02e943934885910feeba957b730123...e72a7d45dc67afa1328750d401ddd4dbeb2131d9,3,3,3,6,3,2005-08-24 03:41:12,2005-08-23 20:52:01
e72a7d45dc67afa1328750d401ddd4dbeb2131d9...fb2af0375bcef9f5f5cbb1f4dc9f81459ce1f4b1,1,18,8,26,1,2005-08-24 03:41:12,2005-08-23 20:52:52
15a42a10ec71eb18983750562a2a8a43b224fef0...a4552ceb8a7666e50b5e6ca3ffaecf0c4fc4994c,1,1,1,2,1,2013-12-05 22:12:52,2013-12-01 07:49:14
a4552ceb8a7666e50b5e6ca3ffaecf0c4fc4994c...3fb5aead2971c6181dbf143295c427175b8bf082,1,3,11,14,4,2013-12-05 22:12:52,2013-12-01 07:49:15
3fb5aead2971c6181dbf143295c427175b8bf082...956623157f828b2b4fd91a9bc5e78ba8e42437d9,3,21,10,31,7,2013-12-05 22:12:52,2013-12-01 07:49:16
956623157f828b2b4fd91a9bc5e78ba8e42437d9...59556548230e617b837343c2c07e357e688e2ca4,88,459,459,918,437,2013-12-05 22:13:21,2013-11-30 20:55:40
706150404d42c712a1a00acf191cbe3e1c499ca2...c939d241673ad093336e936075a029127368d87e,1,1,1,2,1,2013-11-18 21:45:56,2013-11-18 04:12:42
706150404d42c712a1a00acf191cbe3e1c499ca2...03973056a08d1694cf1c819eb2e8b9557650f70e,1,1,1,2,1,2013-11-13 20:59:31,2013-11-13 20:59:31
706150404d42c712a1a00acf191cbe3e1c499ca2...1e2371ea6656beaf94fd706eb414febac88c6398,1,16,16,32,7,2013-11-12 21:32:11,2013-11-12 21:32:11
d7aced95cd681b761468635f8d2a8b82d7ed26fd...b527773092c1455e964d756777d4092c09c9222d,1,68,0,68,1,2013-12-19 00:26:12,2013-12-19 00:08:10
b527773092c1455e964d756777d4092c09c9222d...a21bae33d9e13c59217639b866355f1a02211a2c,2,34,15,49,6,2013-12-19 00:29:05,2013-12-19 00:08:11
a21bae33d9e13c59217639b866355f1a02211a2c...6d8940b562adc5e43068868109dffe1b9bff7f78,4,23,0,23,6,2013-12-19 00:39:00,2013-12-19 00:08:12
d7aced95cd681b761468635f8d2a8b82d7ed26fd...c235d960cb32ddca352d12c3f8dc053ddfd421dd,1,21,17,38,14,2013-12-17 18:43:30,2013-12-17 18:43:30
c235d960cb32ddca352d12c3f8dc053ddfd421dd...4454e9cb5994467fb1a6b60b3b2637fd4ff76ac0,1,24,14,38,14,2013-12-18 23:53:56,2013-12-17 23:22:31
d7aced95cd681b761468635f8d2a8b82d7ed26fd...fc2b6214542a46f97d7067b2f7df530ed37737a7,3,42,36,78,28,2013-12-16 22:06:19,2013-12-14 11:31:16
c13a5fe47b03cc115985ec79bff00b5510023092...11037ee7e3057e60d765d6f77dd154e83323dfcd,5,18,42,60,18,2013-11-13 22:12:37,2013-01-05 00:02:29
6bff6a60680ef402f614abae8189c2cb198cfa49...30b96fcef1243930497a4653c6ae47291316b6b7,1,18,12,30,9,2005-08-17 19:11:36,2005-08-16 19:36:46
30b96fcef1243930497a4653c6ae47291316b6b7...86947d72d422aeaaeb4c1f41b49fc7a606c96321,1,16,8,24,5,2005-08-17 19:11:36,2005-08-16 20:01:39
86947d72d422aeaaeb4c1f41b49fc7a606c96321...22cff6a5abef29ce74da3e57ba3488d77686fec8,1,8,3,11,1,2005-08-17 19:11:36,2005-08-17 01:08:19
22cff6a5abef29ce74da3e57ba3488d77686fec8...e4aec26f8068100ae7b496b904d013943626d8c2,1,20,5,25,4,2005-08-17 19:11:36,2005-08-16 17:58:10
e4aec26f8068100ae7b496b904d013943626d8c2...35cc4bcd10862db190df9685b7ad221f2a25404f,2,43,2,45,2,2005-08-17 19:13:12,2005-08-17 07:01:07
35cc4bcd10862db190df9685b7ad221f2a25404f...fbfd60d65142848299513dfa6b477d0f5299cc15,2,10,4,14,7,2005-08-17 19:13:12,2005-08-17 09:19:20
fbfd60d65142848299513dfa6b477d0f5299cc15...cdacb6208fdb6779b21350644d61bd90e63db3d5,2,6,6,12,6,2005-08-17 19:13:12,2005-08-17 16:37:04
cdacb6208fdb6779b21350644d61bd90e63db3d5...d5a8664ed50ad86a6cdd0c096c20e4d1e64d818b,1,1,1,2,2,2005-08-17 19:13:12,2005-08-17 03:02:16
d5a8664ed50ad86a6cdd0c096c20e4d1e64d818b...f01c0fceef2b14c04b1e927626473d059aecf453,1,1,1,2,1,2005-08-17 19:13:12,2005-08-17 12:17:27
f01c0fceef2b14c04b1e927626473d059aecf453...da139813a7242f96e6926fd15881b9df94625132,1,198,0,198,1,2005-08-17 20:50:40,2005-08-17 14:56:48
fac15bc683b227c0da0114aefd73df3b445f0b62...170e98998310e9751764734ee9af6f3cfdfdea66,1,351,306,657,266,2012-04-29 16:14:59,2012-04-29 16:06:55
abc05cbcd3fdc6e5e14daec80c00b6f51b8e4c7e...b0ec16b49eb283156e13bbef26466d948e4fd992,2,24,1,25,6,2012-10-01 20:09:47,2012-10-01 20:09:47
b0ec16b49eb283156e13bbef26466d948e4fd992...d117dd20961c132b9db780c72a78ca8ecf7508eb,1,24,24,48,22,2012-10-02 17:17:25,2012-10-02 14:35:55
d117dd20961c132b9db780c72a78ca8ecf7508eb...1ec6f488de495a3b77b6a6b6fb42919f64a4bff0,1,7,3,10,3,2012-10-02 19:07:44,2012-10-02 15:38:00
cc76011effc295cf84a8c4b170ba834bd7b41e10...14147865ddaf7a33eadb8158a2c8f1918dffee92,1,3904,528,4432,454,2012-09-21 14:54:42,2012-09-21 14:54:42
14147865ddaf7a33eadb8158a2c8f1918dffee92...4e0266756d1eccbabed53f27bec6d6a68cdf3efb,1,6,5,11,3,2012-09-26 07:06:36,2012-09-26 07:06:36
cc76011effc295cf84a8c4b170ba834bd7b41e10...ef317cd51e1b36398764a1ceea1fd896779f6e1b,1,4074,571,4645,453,2012-09-15 03:17:00,2012-09-15 03:17:00
1b3185fc2be3cc92a834fcfcb7110d1072184700...ee1431bfc565c5031e66408bc70c42be87a626aa,2,2,2,4,2,2012-09-27 06:39:13,2012-09-26 20:16:39
10d4332e007132a38dc61f03c760d355da5cd550...6163cd8a2a8703bdbd30920731aec32c68c39453,2,2,2,4,2,2012-05-03 17:22:56,2012-05-03 01:51:00
6163cd8a2a8703bdbd30920731aec32c68c39453...d240d4102103215e9fe38431b1702a4024d2f1a7,1,52,26,78,7,2012-05-03 17:22:56,2012-05-03 01:51:01
d240d4102103215e9fe38431b1702a4024d2f1a7...853907097af803c595f0c12fc355c907702eb7c8,1,25,31,56,4,2012-05-03 17:22:56,2012-05-03 01:51:02
853907097af803c595f0c12fc355c907702eb7c8...9cb513b7988c2fe443c47186e42dd827b76ddb14,4,54,24,78,25,2012-05-03 17:22:56,2012-05-03 01:51:03
9cb513b7988c2fe443c47186e42dd827b76ddb14...5544049def9a80bc5ea09a5649e13c1b56160518,3,61,5,66,10,2012-05-03 17:22:56,2012-05-03 01:51:04
5544049def9a80bc5ea09a5649e13c1b56160518...60df6bd19ad40e3eae2926f3785a63e670c150ea,1,3,5,8,5,2012-05-03 17:22:56,2012-05-03 01:51:05
60df6bd19ad40e3eae2926f3785a63e670c150ea...ebf5374afa87afa334b040faec35144c2a3d03d5,1,28,11,39,5,2012-05-03 17:22:57,2012-05-03 01:51:06
ebf5374afa87afa334b040faec35144c2a3d03d5...2158f883d99a92f801534c91294305ccbe171f79,3,88,12,100,18,2012-05-03 17:22:57,2012-05-03 01:51:07
2158f883d99a92f801534c91294305ccbe171f79...c743c21591f9433fe784ac38902872701ce2e850,3,74,1,75,4,2012-05-03 17:22:57,2012-05-03 01:51:08
c743c21591f9433fe784ac38902872701ce2e850...2dd42334dea6619c0774511beda9a02642088f67,1,39,40,79,9,2012-05-03 17:22:57,2012-05-03 08:52:16
10d4332e007132a38dc61f03c760d355da5cd550...dc801e71a72201f760618c6a706a31edccdc6fd2,77,400,353,753,169,2012-04-30 21:17:26,2012-04-30 20:38:58
10d4332e007132a38dc61f03c760d355da5cd550...c179837cfb43f5e354417c44c31410de5a74623b,1,15,9,24,7,2012-04-30 17:49:49,2012-04-30 15:33:12
c179837cfb43f5e354417c44c31410de5a74623b...b0cea47e6c19e8116df833ac5c466630f4b922ce,1,23,29,52,4,2012-04-30 17:52:06,2012-04-30 15:33:13
b0cea47e6c19e8116df833ac5c466630f4b922ce...4064e665ca02f1a05011c4010043de802ba1d569,1,6,7,13,3,2012-04-30 17:54:28,2012-04-30 15:33:14
57f6ec029090f64377ec5c0926b6e2e39b0caa4f...cc580af88507ce02eca1a3a6512044dd19c84d80,2,43,9,52,3,2009-08-25 07:02:38,2009-08-25 03:03:16
57f6ec029090f64377ec5c0926b6e2e39b0caa4f...86386829d425a3d3ae6ce713c58328607e50e523,2,61,2,63,5,2009-08-24 22:03:56,2009-08-24 04:04:09
57f6ec029090f64377ec5c0926b6e2e39b0caa4f...9a217391e931763d168d177decfe5e962d306bac,2,44,7,51,7,2009-08-14 07:52:08,2009-08-13 19:41:14
32ef08f4e5ab6ce8f3b47201f1df46d1a33deb80...c86485dd15d54fc6ff2cd0dda3b2a9faa4f2d66e,1,67,20,87,12,2009-12-01 20:50:23,2009-11-30 23:54:08
32f4cc49ae742e496355bea93c7b9481336f12cd...606417bc6dba270ea2b0867cd490c2b57cb3bfa8,1,2,5,7,3,2009-08-27 05:21:30,2009-08-27 05:17:25
606417bc6dba270ea2b0867cd490c2b57cb3bfa8...200c75f0d6c83039c201ec6784e4ef3fb95f8fcf,6,233,2,235,8,2009-08-27 05:21:32,2009-08-23 08:56:19
200c75f0d6c83039c201ec6784e4ef3fb95f8fcf...f43c97f5720f48598e59629f7dc9892d082d8b0e,1,12,4,16,1,2009-08-27 05:21:33,2009-08-25 08:20:00
f43c97f5720f48598e59629f7dc9892d082d8b0e...017678b4f47dc1b2a6691631373c46daf8f63206,10,149,29,178,23,2009-08-27 05:22:22,2009-08-27 04:36:05
017678b4f47dc1b2a6691631373c46daf8f63206...43485d3d16e4fe221ac79fd53c0a2fe38f9ea5cb,1,13,1,14,2,2009-08-27 05:30:33,2009-08-27 05:30:33
32f4cc49ae742e496355bea93c7b9481336f12cd...01b89f0cd5d1c36990bbd3595b7d54c5f67d01e3,1,2,2,4,2,2009-08-23 21:53:54,2009-08-23 08:28:09
32f4cc49ae742e496355bea93c7b9481336f12cd...9029055207443c28ca65a705d1a1b96cce3995fd,1,63,30,93,28,2009-08-23 01:51:05,2009-08-22 22:10:07
9029055207443c28ca65a705d1a1b96cce3995fd...36e4986f26d18defa51fd7af60ec7e7a98337902,1,27,5,32,5,2009-08-23 01:51:06,2009-08-23 01:11:44
36e4986f26d18defa51fd7af60ec7e7a98337902...33012fc429af24fee64f39406d401662feb947a8,2,92,63,155,10,2009-08-31 02:59:11,2009-08-31 02:26:05
33012fc429af24fee64f39406d401662feb947a8...4f6552ea4cf2f1fdfd850b17b25864c761d14580,1,55,8,63,7,2009-08-31 05:04:46,2009-08-31 02:26:46
4f6552ea4cf2f1fdfd850b17b25864c761d14580...34dc6e73b01011fcbe0f314d47fd6120382ae145,1,75,0,75,1,2009-08-31 05:04:56,2009-08-31 02:30:16
34dc6e73b01011fcbe0f314d47fd6120382ae145...931e8e27d94dbc24abc9c969ae0b414e0361abff,2,6,3,9,3,2009-08-31 05:04:56,2009-08-31 02:31:42
32f4cc49ae742e496355bea93c7b9481336f12cd...41fe87fa49cbeec8f05c3e51d6ffd9c57f6c754c,2,5,5,10,4,2009-08-23 01:23:52,2009-08-22 19:48:48
83e355a62cd05fba4533d59f9ab4e104c0596279...beb5af43a6114b551f14bc13f1beecfe8de930d9,4,49,5,54,7,2009-08-21 19:41:25,2009-08-19 02:34:33
beb5af43a6114b551f14bc13f1beecfe8de930d9...b97c470b577071b74315a0e57dd9a03dca120e93,1,276,0,276,1,2009-08-24 21:39:29,2009-08-21 18:20:34
af4f6405296dec699321ca59d48583ffa0323b0e...cb572206d9dac4ba52878e7e1a4a7028d85707ab,4,30,3,33,5,2009-09-16 21:53:26,2009-09-16 21:53:26
48ae73b11487e12f8f7198e18779e65500d4ca0c...e71c008dce548ba882a604b255dd7945b3a61b21,1,0,2,2,1,2009-08-29 07:50:31,2009-08-29 07:49:32
e71c008dce548ba882a604b255dd7945b3a61b21...82c3e210002d452867a46a9d8806a8aee82ae9d0,4,36,3,39,5,2009-08-29 21:31:01,2009-08-29 21:31:01
2c6b5d88287689e5a1acd5b5fefb8edd96931b6d...2faa15274d7bf474d3c382ce36a3e4b7b21bdaa4,1,1,0,1,1,2011-07-19 18:17:46,2011-07-16 13:03:21
2faa15274d7bf474d3c382ce36a3e4b7b21bdaa4...5cf5ade371d60f97fef2eb7ef37780ed86fa4963,1,8,4,12,3,2011-07-19 18:17:46,2011-07-16 13:03:22
5cf5ade371d60f97fef2eb7ef37780ed86fa4963...760fec7d7e488899137d662c0b0d1addd20c516e,1,19,15,34,11,2011-07-19 18:17:46,2011-07-16 13:03:23
760fec7d7e488899137d662c0b0d1addd20c516e...c00dd33b1fe602520f7b0e54b2c4d83b03571053,1,47,0,47,1,2011-07-19 18:17:47,2011-07-16 13:03:24
c00dd33b1fe602520f7b0e54b2c4d83b03571053...4e51ba238fb92ad732b4d34200fc8f53e29b333f,3,9,4,13,6,2011-07-19 18:17:47,2011-07-16 13:03:25
4e51ba238fb92ad732b4d34200fc8f53e29b333f...3ea7d09461e4e1b95f6a55f04b2eb66d929464bd,2,3,2,5,2,2011-07-19 18:17:47,2011-07-16 13:03:26
3ea7d09461e4e1b95f6a55f04b2eb66d929464bd...b4b872994b59be397519ff76354ba4002e74de48,2,2,2,4,2,2011-07-19 18:17:47,2011-07-16 13:03:27
b4b872994b59be397519ff76354ba4002e74de48...e173587252ea0db16efc5c64c2cb165ccb406495,3,14,18,32,8,2011-07-19 18:17:47,2011-07-16 13:03:28
e173587252ea0db16efc5c64c2cb165ccb406495...1843f0ce4d31e3c37f7d07dd1d13f6fb034ac2b0,1,9,1,10,2,2011-07-19 18:17:47,2011-07-16 13:03:29
1843f0ce4d31e3c37f7d07dd1d13f6fb034ac2b0...0fb56ce716090248ed4895aff69dd3953b00882f,1,3,1,4,1,2011-07-19 18:17:47,2011-07-16 13:03:30
0fb56ce716090248ed4895aff69dd3953b00882f...460d10262dae14b54123ff45e7548d872ff63983,5,62,22,84,13,2011-07-19 18:17:47,2011-07-16 13:03:31
460d10262dae14b54123ff45e7548d872ff63983...be56862f198d946dc75ac7092606e78a4f2ff1d3,3,75,0,75,9,2011-07-19 18:17:47,2011-07-16 13:03:32
d83a831bf4eca748f159b326d5a2562085013900...34df9abb41289e475befd05754e518f44f921ef0,1,12,5,17,6,2011-04-03 19:24:25,2011-03-31 09:17:33
34df9abb41289e475befd05754e518f44f921ef0...e41d718c7df31c891b242bcf3a1cfea812308e40,2,8,5,13,5,2011-04-03 19:24:27,2011-03-31 09:17:34
d83a831bf4eca748f159b326d5a2562085013900...ebae9ff95de2d0b36b061c7db833df4f7e01a41d,1,1,0,1,1,2011-04-03 19:21:34,2011-03-18 20:23:52
c2ff10c98e22ae64d553273e6d67bb123a1c916f...1945237486851bc3a0c6d65eaeb21cb22cac2ea1,1,23,0,23,1,2010-01-10 07:34:10,2010-01-08 02:12:40
1945237486851bc3a0c6d65eaeb21cb22cac2ea1...7b69079be964ca0a09a1a7895455ba3df379984e,1,21,0,21,1,2010-01-10 07:34:10,2010-01-08 02:12:41
7b69079be964ca0a09a1a7895455ba3df379984e...20e8b465a53e651cc3f50bd60f39d577ecdb7722,6,77,48,125,13,2010-01-10 07:34:10,2010-01-08 02:12:42
20e8b465a53e651cc3f50bd60f39d577ecdb7722...4232826771d5bdc4cc0bd21188b6ee5f3e700a52,2,7,4,11,5,2010-01-10 07:34:10,2010-01-08 02:12:43
4232826771d5bdc4cc0bd21188b6ee5f3e700a52...08d63a422ba7293119865e6cbbc3a34619be32f7,2,10,1,11,2,2010-01-10 07:34:10,2010-01-08 02:12:44
08d63a422ba7293119865e6cbbc3a34619be32f7...c1ceea1d273925fe6ecb0824e7ea08eb6e6e2635,1,4,1,5,2,2010-01-10 07:34:11,2010-01-08 02:12:45
c2ff10c98e22ae64d553273e6d67bb123a1c916f...99c419c91554e9f60940228006b7d39d42704da7,2,80,10,90,4,2009-12-30 09:24:56,2009-12-30 06:43:04
f00ecbe42b82f3c8e6a170074f2299487026e400...d1094fdd1b8c97b957591ef2902587c654f4e18c,1,2,1,3,1,2009-08-22 01:48:01,2009-08-21 22:13:21
639bdcc7177818c69df340a225c071fe4d6027b4...bc9e7dd41fe8b51cc7f2e79312a2ff777899f930,1,20,10,30,5,2012-06-25 18:31:07,2012-06-25 18:31:07
d4c985653a580e78db94c549bdcd71669067b8a9...653a31c16a0b83c11f00eb94ef49857ce8f2e37b,1,4,3,7,3,2009-07-01 20:20:00,2009-07-01 09:40:30
5ad9dce7e691106fecde413de8cc321b937367a6...3de8ba021718e80ef1bbf8a5a541beec86930f4c,1,2,2,4,1,2009-09-09 06:32:43,2009-09-09 01:50:59
3de8ba021718e80ef1bbf8a5a541beec86930f4c...aaa68dd50f7b4226fdfdfbbe8bbb2dfd9a9e6d66,1,1,12,13,4,2009-09-09 19:11:44,2009-09-03 20:27:24
aaa68dd50f7b4226fdfdfbbe8bbb2dfd9a9e6d66...0460dba4b4c47ac0b11ccb85b319792280422bc9,1,7,1,8,3,2009-09-10 17:22:05,2009-09-08 13:54:38
0460dba4b4c47ac0b11ccb85b319792280422bc9...1d7367dce7b55cbb1804c4863c56bd20ab12bda8,1,5,7,12,4,2009-09-10 18:22:22,2009-09-10 07:02:38
1d7367dce7b55cbb1804c4863c56bd20ab12bda8...26d9443925517f6d93dbcb6f4eca30af82703de3,1,9,5,14,2,2009-09-11 04:34:36,2009-09-09 01:51:00
26d9443925517f6d93dbcb6f4eca30af82703de3...5beb577db8c61a7a511fac1d970a5ae3dde11eca,1,24,14,38,9,2009-09-11 04:34:43,2009-09-10 20:28:19
5beb577db8c61a7a511fac1d970a5ae3dde11eca...e019961d7f55ff76eff93d74e7705d6bd55218eb,1,1,1,2,1,2009-09-11 07:11:44,2009-09-11 00:09:20
e019961d7f55ff76eff93d74e7705d6bd55218eb...434a6db7dcf8688fe08098e218113c18b7c9aeaf,3,10,2,12,4,2009-09-11 07:23:07,2009-09-11 00:29:58
434a6db7dcf8688fe08098e218113c18b7c9aeaf...2affea4125a0ae6c528a14f14731748c1fad9a8a,3,17,9,26,6,2009-09-11 23:33:54,2009-09-11 17:40:08
2affea4125a0ae6c528a14f14731748c1fad9a8a...25fc1786ab147daa9ffa43ebcbaf5c1cc6e50d4f,1,4,2,6,2,2009-09-11 23:35:08,2009-09-11 17:45:07
25fc1786ab147daa9ffa43ebcbaf5c1cc6e50d4f...0c3d3ac352427738e7c4393c0a959e0e698a0c7a,1,1,1,2,1,2009-09-12 04:41:15,2009-09-09 14:59:37
5ad9dce7e691106fecde413de8cc321b937367a6...fadd069d036c9d376769692e2726c5a1600d281c,1,21,4,25,3,2009-09-08 21:46:36,2009-09-08 05:43:11
4a452ede390996b0c5dbb7d36536cb5552c6d9fb...5f2b1e67ca807239cd3596c1eb943357def1ce17,1,8,3,11,1,2009-09-13 08:36:13,2009-09-13 06:43:10
5f2b1e67ca807239cd3596c1eb943357def1ce17...eaf1c941bbc10f5aa67fcf64e316fb548b910cfe,1,31,0,31,7,2009-09-13 08:50:33,2009-09-13 08:50:22
eaf1c941bbc10f5aa67fcf64e316fb548b910cfe...12efe45a3363ebecd8954d04caadb23eba2e5020,1,1,7,8,2,2009-09-13 18:24:26,2009-09-13 18:23:34
12efe45a3363ebecd8954d04caadb23eba2e5020...9f67fee2f0190e0b10e73862cbb88a3f7216f619,2,4,3,7,4,2009-09-13 18:29:18,2009-09-13 16:56:45
9f67fee2f0190e0b10e73862cbb88a3f7216f619...65d15ed992746068d34b5fa7397ab39a940d2c69,1,1,1,2,1,2009-09-13 18:58:54,2009-09-13 13:35:05
65d15ed992746068d34b5fa7397ab39a940d2c69...98df233e2d7d815b1f2e2e253b9d6c6ce1bfe58f,1,33,21,54,7,2009-09-13 20:22:29,2009-09-13 10:49:45
98df233e2d7d815b1f2e2e253b9d6c6ce1bfe58f...05d3951ec9c531d348fe0dbb9ae058d38728a550,3,4,3,7,4,2009-09-13 20:23:40,2009-09-13 12:05:52
05d3951ec9c531d348fe0dbb9ae058d38728a550...518ef8f07f72271dff4040c1e7452ab6de73d199,1,9,21,30,3,2009-09-13 20:40:25,2009-09-11 23:23:45
518ef8f07f72271dff4040c1e7452ab6de73d199...0f4b377c20fb7d93f8bfeec39efb2b9392d6aebc,2,41,3,44,8,2009-09-13 20:54:39,2009-09-13 20:17:01
0f4b377c20fb7d93f8bfeec39efb2b9392d6aebc...03aa8ff3be3b35522b2e378651e65e0e86778018,6,6,5,11,6,2009-09-14 09:23:36,2009-09-14 06:41:16
03aa8ff3be3b35522b2e378651e65e0e86778018...39c448c19de7269e6130b6e183645c5b9afe0579,1,1,1,2,1,2009-09-14 09:23:49,2009-09-14 08:47:06
39c448c19de7269e6130b6e183645c5b9afe0579...20f34902d154f390ebaa7eed7f42ad14140b8acb,1,2,1,3,1,2009-09-14 09:27:25,2009-09-14 08:49:01
b17a01df49a43e0edd7d26397deb79c1b1089d0c...be9d0a3a4cbd736911afc10154c7a541129503bd,2,52,7,59,13,2012-08-14 21:00:17,2012-08-14 20:35:27
9ebfda109eeb69e8f313ffa7fb85bdba0f16e405...044239b0a1fbdcccefafe1dab5f9c21e5a2a9150,1,0,2,2,2,2009-08-20 04:04:56,2009-08-20 01:27:08
e923eaeb901ff056421b9007adcbbce271caa7b6...e8b14d7e3fa5194fbc776cdd253b0b5403b2226d,1,1,1,2,1,2011-11-15 23:51:05,2011-11-15 23:51:05
e923eaeb901ff056421b9007adcbbce271caa7b6...d30db5605b03a45b2848fa9131c3485dc93f7dad,1,1,1,2,1,2011-10-06 20:24:59,2011-10-06 18:25:55
e923eaeb901ff056421b9007adcbbce271caa7b6...91b849b273a7f3786d8cac569352aaa8bca7b46c,1,12,0,12,3,2011-10-04 17:27:48,2011-10-04 14:02:03
e923eaeb901ff056421b9007adcbbce271caa7b6...acd6d7e70a0dd2a91c6028e5ca68d19c5de4d00b,1,5,2,7,2,2011-09-21 12:00:20,2011-09-21 06:21:50
e923eaeb901ff056421b9007adcbbce271caa7b6...cd8e3711bf2dce3e2d18aac41e7f42242fbba338,2,6,3,9,2,2011-07-12 16:11:14,2011-07-11 09:14:18
e923eaeb901ff056421b9007adcbbce271caa7b6...0d8fc3efc65df74a2b39b3f9798861a1b2055b62,2,57,14,71,5,2011-05-06 22:01:56,2011-05-05 00:42:51
e923eaeb901ff056421b9007adcbbce271caa7b6...1a812f3a701969824caf96803e160cbad6050520,1,14,4,18,5,2011-04-28 20:18:30,2011-04-28 10:19:02
e923eaeb901ff056421b9007adcbbce271caa7b6...5e7a5d97f8a74181634a70e0e7b1464855c5af2d,1,3,1,4,2,2011-04-11 21:10:05,2011-04-10 20:54:17
5e7a5d97f8a74181634a70e0e7b1464855c5af2d...e96c19c50fb0807570b85cb5b8aae6dfcfa9b9ec,2,9,11,20,9,2011-04-11 21:10:06,2011-04-10 20:54:18
e923eaeb901ff056421b9007adcbbce271caa7b6...ded0abc73c67c6a9b9dbc2a22755fab01ae17e41,2,21,10,31,7,2011-02-22 18:57:58,2011-02-19 08:04:56
ded0abc73c67c6a9b9dbc2a22755fab01ae17e41...abb371a1ef5bddee904551afdec38854f95e99bb,1,11,4,15,3,2011-02-22 18:58:18,2011-02-19 08:16:32
e923eaeb901ff056421b9007adcbbce271caa7b6...c50c4316e1eed362bee387e4cbfbe1138957f75b,1,6,2,8,3,2010-10-22 05:23:34,2010-10-22 04:02:27
e923eaeb901ff056421b9007adcbbce271caa7b6...3cee92369ec8cc908fe3a4307f08cfc22a9ba954,1,62,0,62,2,2010-08-13 04:22:55,2010-08-13 01:50:49
3cee92369ec8cc908fe3a4307f08cfc22a9ba954...cf65426de682bf4e336eddd2964a7c1585597f48,2,11,2,13,3,2010-08-13 04:23:23,2010-08-13 01:50:50
e923eaeb901ff056421b9007adcbbce271caa7b6...7f71a6ae184d4aad78b37b9eeda4d7a6e5a01d99,1,55,47,102,32,2010-08-02 17:28:09,2010-07-31 06:14:25
7f71a6ae184d4aad78b37b9eeda4d7a6e5a01d99...eec3fc03092e308694d56b875a858065730822e2,2,24,14,38,4,2010-08-09 19:15:53,2010-07-31 06:14:26
eec3fc03092e308694d56b875a858065730822e2...700e66d66100fff952ffca439834a6deb1062d11,3,30,13,43,8,2010-08-09 19:16:01,2010-07-31 06:14:27
700e66d66100fff952ffca439834a6deb1062d11...711f151a7b56f450e3a17b734e84f71bb57522c6,1,1,4,5,2,2010-08-09 19:16:01,2010-07-31 06:14:28
711f151a7b56f450e3a17b734e84f71bb57522c6...74da98f9c761b2e63366a643fa52749844ddc6a1,2,3,1,4,2,2010-08-09 19:16:02,2010-07-31 06:14:29
e923eaeb901ff056421b9007adcbbce271caa7b6...c4805393d73425a5f467f10fa434fb99bfba17ac,2,101,0,101,4,2010-05-12 06:02:49,2010-05-11 22:37:57
e923eaeb901ff056421b9007adcbbce271caa7b6...9ee6bcd398057cb0cf3c52b9dc93b094d3d37235,1,28,1,29,3,2010-04-10 04:11:03,2010-04-08 02:15:16
9ee6bcd398057cb0cf3c52b9dc93b094d3d37235...eb9d47cf9b1cb36876df1cfd48ab57278729be6d,2,2,1,3,2,2010-04-10 04:11:09,2010-04-08 02:15:17
eb9d47cf9b1cb36876df1cfd48ab57278729be6d...d8fab07208abfbe7dc93aea97c5577cdd73266c5,2,9,7,16,8,2010-04-10 04:16:11,2010-04-08 02:15:18
e923eaeb901ff056421b9007adcbbce271caa7b6...9b25949a07933fb9ce7c10bd309ac176dbe2df2e,1,6,11,17,2,2010-03-07 07:53:00,2010-03-06 14:30:21
9b25949a07933fb9ce7c10bd309ac176dbe2df2e...24ff4d56cf400126aa93ac9a5b9d8a21afadf3f6,2,16,5,21,4,2010-03-07 07:53:00,2010-03-06 14:30:29
24ff4d56cf400126aa93ac9a5b9d8a21afadf3f6...51667147be4a5aed6d735d43630ce36b74134eee,1,138,30,168,19,2010-03-07 07:53:00,2010-03-06 14:30:42
51667147be4a5aed6d735d43630ce36b74134eee...c1376c12b781e511fd2c94c5d538b075cc1913e3,1,170,0,170,1,2010-03-07 07:53:00,2010-03-06 14:31:04
c1376c12b781e511fd2c94c5d538b075cc1913e3...59f5ced65b46370a121916593cce7fcd210a15df,1,126,0,126,1,2010-03-07 07:53:00,2010-03-06 14:31:17
e923eaeb901ff056421b9007adcbbce271caa7b6...ae6c098f158dd306462024c5cb137b8f7f65cfbd,3,38,3,41,8,2010-03-07 03:57:44,2010-02-16 23:39:34
ae6c098f158dd306462024c5cb137b8f7f65cfbd...ca9e0a1b8738959f5bd5a17ec81fa3bd1a326c9d,1,34,39,73,18,2010-03-08 23:55:41,2010-03-07 22:46:46
ca9e0a1b8738959f5bd5a17ec81fa3bd1a326c9d...c42600346bb6c3427df7ea1c5a33d723ec02d731,2,56,7,63,7,2010-03-08 23:55:41,2010-03-07 22:46:47
c42600346bb6c3427df7ea1c5a33d723ec02d731...f434c083a097bdc43991e4b0282b9aa1a994a60e,2,76,4,80,7,2010-03-08 23:55:42,2010-03-07 22:46:48
e923eaeb901ff056421b9007adcbbce271caa7b6...90ff12a86073e27c9f423a255a4da4314c28936d,1,6,4,10,3,2010-03-04 06:47:24,2010-01-29 22:38:19
e923eaeb901ff056421b9007adcbbce271caa7b6...cd1d61c44fb5c3d1c8e4c19becb66d90bbb9c676,3,19,45,64,5,2010-03-02 19:43:40,2010-03-01 21:46:25
cd1d61c44fb5c3d1c8e4c19becb66d90bbb9c676...560119b9abfa39504c93ed08735426dae947d5a9,4,25,29,54,20,2010-03-02 19:51:48,2010-03-01 21:46:26
560119b9abfa39504c93ed08735426dae947d5a9...11f3aa2305426d11945c72479d24a15d30768d50,3,42,2,44,4,2010-03-03 05:16:44,2010-03-01 21:46:27
11f3aa2305426d11945c72479d24a15d30768d50...3a15048d833e2d6599091a9f7c14b0fa926c3bbf,2,9,6,15,5,2010-03-03 05:16:45,2010-03-01 21:46:28
e923eaeb901ff056421b9007adcbbce271caa7b6...fe4bc2a5aeb59b5767a3f8f4246ac088d4a13d73,1,4,2,6,3,2010-03-02 19:10:35,2010-03-02 10:49:25
fe4bc2a5aeb59b5767a3f8f4246ac088d4a13d73...6cbd6e92616773457574f9755910f44b3c34a983,3,34,22,56,3,2010-03-02 19:10:35,2010-03-02 10:49:26
6cbd6e92616773457574f9755910f44b3c34a983...b5e59989eb20a8d6257760605052fe1d3fefca88,1,1,1,2,1,2010-03-02 19:10:36,2010-03-02 10:49:27
b5e59989eb20a8d6257760605052fe1d3fefca88...09ae9aca14750f00c9e25fd16cdf60819fb410a8,1,17,0,17,1,2010-03-02 19:10:36,2010-03-02 10:49:28
09ae9aca14750f00c9e25fd16cdf60819fb410a8...888692b733b3109874bb570bb0680e93287ed338,4,12,8,20,10,2010-03-02 19:10:36,2010-03-02 10:49:29
888692b733b3109874bb570bb0680e93287ed338...aec49756020d20bd073e4daeaa5d7b4fed1fe300,1,1,2,3,2,2010-03-02 19:10:36,2010-03-02 10:49:30
aec49756020d20bd073e4daeaa5d7b4fed1fe300...26e1e0b23a1d145f9fee699538c11bbbb996d558,1,3,10,13,7,2010-03-02 19:10:36,2010-03-02 10:49:31
e923eaeb901ff056421b9007adcbbce271caa7b6...48a7c1c49d675fa37b609b499dd9e27439ec7f51,3,28,12,40,3,2010-02-25 00:24:25,2010-02-24 23:34:14
48a7c1c49d675fa37b609b499dd9e27439ec7f51...94c8ccaaba4ac8b0225f5adeae4ff29f01951bce,2,13,0,13,2,2010-02-25 00:24:25,2010-02-24 23:34:15
94c8ccaaba4ac8b0225f5adeae4ff29f01951bce...7d750f0ea511dcc26c3c9de996a9b75444366ecc,1,7,0,7,1,2010-02-25 00:24:25,2010-02-24 23:34:16
7d750f0ea511dcc26c3c9de996a9b75444366ecc...74ae14199dfb4b3b22a10d3dcecb62b457245564,1,10,10,20,10,2010-02-25 00:24:25,2010-02-24 23:34:17
74ae14199dfb4b3b22a10d3dcecb62b457245564...5ce9086ddfe6931ef34fcd99778c9235e2ee1839,1,11,11,22,7,2010-02-25 00:24:25,2010-02-24 23:34:18
e923eaeb901ff056421b9007adcbbce271caa7b6...3731449591130b2f5ca7257c46721785a6340a18,1,2,0,2,1,2010-02-24 20:59:09,2010-02-24 20:49:03
e923eaeb901ff056421b9007adcbbce271caa7b6...13e65fe6314bf44e64f22b9b66a4e5940adaa2e5,1,20,26,46,11,2010-02-24 18:41:12,2010-02-24 18:22:05
13e65fe6314bf44e64f22b9b66a4e5940adaa2e5...bba5322a71a3399a94f53e1dddf5bd66e493dfbc,2,29,1,30,4,2010-02-24 18:51:07,2010-02-24 18:22:06
bba5322a71a3399a94f53e1dddf5bd66e493dfbc...e6cc51046f3669332f51a52a7de966d842b9d4e4,2,40,7,47,5,2010-02-24 19:16:36,2010-02-24 19:02:05
e923eaeb901ff056421b9007adcbbce271caa7b6...c54b74afb78e385d645447711da2201ad45151fa,1,2,1,3,1,2010-02-24 16:35:43,2010-02-24 12:50:20
c54b74afb78e385d645447711da2201ad45151fa...409b8d82dfc216ce5e89c81fdc2431dbf897c2d7,2,10,0,10,3,2010-02-24 16:35:43,2010-02-24 12:50:21
e923eaeb901ff056421b9007adcbbce271caa7b6...c63437cbd79e4c11ddcd06cc59f81401ae393794,1,8,3,11,2,2010-02-24 16:32:04,2010-02-23 21:02:57
c63437cbd79e4c11ddcd06cc59f81401ae393794...424cce832d180843ab9b54eec3a7643948fc1afd,1,12,55,67,3,2010-02-24 16:32:20,2010-02-23 21:02:58
424cce832d180843ab9b54eec3a7643948fc1afd...8024ea60db290dd64db294e1019a0ada64ce1770,1,7,4,11,2,2010-02-24 16:32:26,2010-02-23 21:02:59
8024ea60db290dd64db294e1019a0ada64ce1770...66729509457f11b15216c3cdfdbb2f34eddfbe89,1,9,0,9,2,2010-02-24 16:32:31,2010-02-23 21:03:00
e923eaeb901ff056421b9007adcbbce271caa7b6...aa0945701e39cf099ca9c28f79e239359781e4f6,1,1,1,2,1,2010-02-23 21:20:15,2010-02-23 11:42:56
e923eaeb901ff056421b9007adcbbce271caa7b6...53a52ff33d42faf2dcceea5b33f8049bd9416555,1,17,2,19,3,2010-02-23 21:19:10,2010-02-23 12:33:48
e923eaeb901ff056421b9007adcbbce271caa7b6...7aba6185d55e06db3f3ef18daa63baf3821e5030,1,67,0,67,1,2010-02-22 23:24:45,2010-02-22 22:32:11
7aba6185d55e06db3f3ef18daa63baf3821e5030...00787ed55adbc2350efa911bf0bdebf6ca08c095,3,69,71,140,3,2010-02-22 23:24:45,2010-02-22 22:32:12
00787ed55adbc2350efa911bf0bdebf6ca08c095...b862b61c03797fd00490bb8caf05be840b79c6cb,3,27,2,29,5,2010-02-22 23:24:45,2010-02-22 22:32:13
b862b61c03797fd00490bb8caf05be840b79c6cb...f80c7ae8fe9c0f3ce93c96a2dccaba34e456e33a,3,10,20,30,10,2010-02-22 23:24:46,2010-02-22 22:32:14
f80c7ae8fe9c0f3ce93c96a2dccaba34e456e33a...1d9740cb324f7f5d798ecfc259dc213b244ad9b7,1,0,1,1,1,2010-02-22 23:24:46,2010-02-22 22:32:15
1d9740cb324f7f5d798ecfc259dc213b244ad9b7...5256b006312e4d06e11b49a8b128e9e550e54f31,2,4,4,8,4,2010-02-22 23:24:46,2010-02-22 22:32:16
e923eaeb901ff056421b9007adcbbce271caa7b6...ea68b0ce9f8ce8da3e360aed3cbd6720159ffbee,1,10,0,10,2,2010-02-21 19:39:10,2010-02-21 06:32:19
e923eaeb901ff056421b9007adcbbce271caa7b6...9892bebafe0865d8f4f3f18d60a1cfa2d1447cd7,1,10,14,24,7,2010-02-21 19:36:23,2010-02-21 04:27:31
9892bebafe0865d8f4f3f18d60a1cfa2d1447cd7...748af44c63ea6fec12690f1693f3dddd963e88d5,1,9,0,9,6,2010-02-22 06:33:25,2010-02-21 20:48:06
e923eaeb901ff056421b9007adcbbce271caa7b6...73e9da019655261e456ed862340880de365111f0,12,66,11,77,28,2010-02-19 01:21:40,2010-02-17 04:55:58
e923eaeb901ff056421b9007adcbbce271caa7b6...06b65939b083ba1b71043005bf83b4883e98264e,4,24,41,65,6,2010-02-17 23:11:33,2010-02-16 23:42:55
e923eaeb901ff056421b9007adcbbce271caa7b6...72a534dab016813eec71935323b197650a2c0c9d,1,29,54,83,7,2010-02-17 23:06:45,2010-02-17 20:56:02
e923eaeb901ff056421b9007adcbbce271caa7b6...149794dd1db18b22f4df94ef13cf61520d7be1d8,1,1,1,2,1,2010-02-17 20:30:41,2010-02-17 20:30:41
e923eaeb901ff056421b9007adcbbce271caa7b6...90b45187ba51a15c8a80680597240e32421f53bb,1,16,0,16,4,2010-02-17 20:17:35,2010-02-16 23:42:31
90b45187ba51a15c8a80680597240e32421f53bb...d8a8488d569420c4e0a96a8df36b246d888e68d4,3,26,10,36,4,2010-02-17 20:17:53,2010-02-16 23:44:46
d8a8488d569420c4e0a96a8df36b246d888e68d4...b02a17f2b7d0d3f5899ffdd9709ded8cea8ae019,1,0,2,2,1,2010-02-26 06:47:36,2010-02-26 04:00:20
b02a17f2b7d0d3f5899ffdd9709ded8cea8ae019...a94d305bf8043a7a0579037c7e52e632613410f7,2,21,1,22,2,2010-02-26 06:47:48,2010-02-26 04:00:21
a94d305bf8043a7a0579037c7e52e632613410f7...160ad147fe9f644fc35224095e1d1a01be0208de,1,7,2,9,3,2010-03-03 00:27:03,2010-03-03 00:27:03
e923eaeb901ff056421b9007adcbbce271caa7b6...3deea89c5feb0dfdfb99ea752f83497d97a3bdd5,2,12,2,14,4,2010-02-17 19:14:04,2010-02-16 10:21:14
e923eaeb901ff056421b9007adcbbce271caa7b6...3fc366bdbbcafa36ac4e35e3124959beb94c7fce,1,28,29,57,29,2010-02-17 19:08:42,2010-02-17 19:05:51
3fc366bdbbcafa36ac4e35e3124959beb94c7fce...212818160d588fae403dfc823250e95ffbac76e5,1,25,10,35,18,2010-02-17 19:08:42,2010-02-17 19:05:52
212818160d588fae403dfc823250e95ffbac76e5...427cb22c40484f9b8c2881bc9e99636591a22655,1,17,46,63,14,2010-02-17 19:08:43,2010-02-17 19:05:53
427cb22c40484f9b8c2881bc9e99636591a22655...89e0a3a131d251b5345845529d5258ab91105c9b,2,7,10,17,7,2010-02-17 19:08:43,2010-02-17 19:05:54
89e0a3a131d251b5345845529d5258ab91105c9b...8c2ca8dd8a5d6d8beaa0a4abed0c135004eef772,1,11,0,11,1,2010-02-17 19:08:44,2010-02-17 19:05:55
8c2ca8dd8a5d6d8beaa0a4abed0c135004eef772...b500d5e11ea67d29dd7be622f65571d611d6e9a3,1,2,6,8,2,2010-02-17 19:08:44,2010-02-17 19:05:56
e923eaeb901ff056421b9007adcbbce271caa7b6...8420ccd8b884e1edceca9ea5824f3ff300c0c4ba,2,18,4,22,6,2010-02-17 17:39:03,2010-02-17 07:59:46
8420ccd8b884e1edceca9ea5824f3ff300c0c4ba...eb734454098fb68af1fb0e157dd5e67bb15a602d,2,15,1,16,4,2010-02-17 17:51:23,2010-02-16 23:39:52
eb734454098fb68af1fb0e157dd5e67bb15a602d...8a3d203bd02bec48a02557961899d81da172fa23,3,76,11,87,7,2010-02-17 18:20:49,2010-02-17 18:20:49
8a3d203bd02bec48a02557961899d81da172fa23...635530a2fcd4bb3714452403f341f1317ae9c9f6,2,39,16,55,24,2010-04-06 21:49:33,2010-04-06 21:48:55
635530a2fcd4bb3714452403f341f1317ae9c9f6...b0e621adfd5a60b7cbe95e59f09c87f0870321cb,2,2,2,4,2,2010-04-09 06:13:48,2010-04-08 19:42:37
b0e621adfd5a60b7cbe95e59f09c87f0870321cb...4f62c2bc577bbb85b65f3261c7fab7ef74def4cd,2,19,30,49,22,2010-04-09 06:13:48,2010-04-08 17:17:17
e923eaeb901ff056421b9007adcbbce271caa7b6...b0d66e156c5b312d468344569202d8ca4094f67f,2,10,1,11,4,2010-02-16 17:11:22,2010-02-16 07:18:21
e923eaeb901ff056421b9007adcbbce271caa7b6...e6e592db4c0099a6412aed6e868769535900f112,1,6,3,9,2,2010-02-15 02:50:22,2010-02-14 21:46:28
e923eaeb901ff056421b9007adcbbce271caa7b6...9fabb6d7513ab0a264de146d72a8447bc85b5e85,2,2,2,4,2,2010-02-15 02:23:16,2010-02-14 11:55:53
9fabb6d7513ab0a264de146d72a8447bc85b5e85...64778d24a93ad455e5883120aef350ede20061c4,3,5,5,10,5,2010-02-15 02:23:17,2010-02-14 11:59:59
64778d24a93ad455e5883120aef350ede20061c4...06300d9753349a83212360445d241d70a46375fa,1,6,2,8,2,2010-02-15 02:23:17,2010-02-14 12:02:35
06300d9753349a83212360445d241d70a46375fa...190c1cda7eb6dc03be80f45d3d174c313d23da2c,1,7,2,9,2,2010-02-15 02:23:17,2010-02-14 12:06:10
190c1cda7eb6dc03be80f45d3d174c313d23da2c...f6dff119d51e0067d213068093039bb2f939d139,2,14,4,18,2,2010-02-15 06:05:17,2010-02-15 05:04:13
f6dff119d51e0067d213068093039bb2f939d139...60b6e2200deff208a9757721544a3a311034804f,1,163,0,163,1,2010-02-20 17:34:28,2010-02-19 07:18:58
60b6e2200deff208a9757721544a3a311034804f...2d3ca21677597902f66bf2f2b2cf1b4a623f1e4f,2,82,11,93,14,2010-02-21 19:08:17,2010-02-20 08:50:25
2d3ca21677597902f66bf2f2b2cf1b4a623f1e4f...8c33b4cf67f47ee46fe0984751fd40c4cf7cf392,1,6,6,12,5,2010-02-22 22:19:28,2010-02-22 08:46:33
e923eaeb901ff056421b9007adcbbce271caa7b6...9b2504831859ffdffbe15b9a6a7b7ede37557b06,3,13,2,15,3,2010-02-13 23:04:00,2010-02-13 23:04:00
e923eaeb901ff056421b9007adcbbce271caa7b6...318721e3acd8f9c06fde0d528b7547a99f65c4a1,3,19,2,21,3,2010-02-13 23:01:37,2010-02-13 23:01:37
e923eaeb901ff056421b9007adcbbce271caa7b6...40dae3094db123be664c69b356b6e4f4e33d80e6,1,16,10,26,8,2010-02-13 19:29:27,2010-02-13 19:29:27
40dae3094db123be664c69b356b6e4f4e33d80e6...20322e0b552b9860377c162675ce5c49bfd32e83,1,2,7,9,2,2010-02-13 19:38:42,2010-02-13 19:38:42
20322e0b552b9860377c162675ce5c49bfd32e83...5cdd628c84d808feb6ec407b2ecd74dfea63f865,1,19,1,20,7,2010-02-13 19:57:08,2010-02-13 19:57:08
5cdd628c84d808feb6ec407b2ecd74dfea63f865...88fb7f27f6036028b3470e0e2a0efed1d9c7ee78,1,22,0,22,3,2010-02-13 20:25:28,2010-02-13 20:05:44
11bb2d4fa9ebc7481828c25752d8c23233b24c76...f12e925ac23ad6169e046cfe05b8438a1611ad58,1,3,0,3,1,2007-07-28 07:06:00,2007-07-28 01:44:48
f12e925ac23ad6169e046cfe05b8438a1611ad58...cbeaccc316affa2e0fb0b60f569d5da9bf444881,1,17,6,23,7,2007-07-28 07:06:00,2007-07-28 06:41:31
cbeaccc316affa2e0fb0b60f569d5da9bf444881...83b3df7d582429d9036f34d2c95abfff7bf0ab24,1,7,6,13,2,2007-07-28 07:06:00,2007-07-28 06:51:45
83b3df7d582429d9036f34d2c95abfff7bf0ab24...90ae710e0b642b177d44df4528966c7ae37ebf5f,1,2,5,7,2,2007-07-29 01:44:52,2007-07-29 00:24:27
90ae710e0b642b177d44df4528966c7ae37ebf5f...01ac1e38dbb1ae3ad3c4bbea60a9c0855606ae11,1,35,3,38,5,2007-07-29 01:46:32,2007-07-28 14:27:31
01ac1e38dbb1ae3ad3c4bbea60a9c0855606ae11...12075103ddc9a061cf6f3b04feb206123bb78e2f,2,40,5,45,7,2007-07-29 01:47:51,2007-07-28 14:27:32
12075103ddc9a061cf6f3b04feb206123bb78e2f...8b4aee015e2d81dc6cc53328aedc66742a5306d8,1,1,1,2,1,2007-07-29 01:50:36,2007-07-28 18:26:35
8b4aee015e2d81dc6cc53328aedc66742a5306d8...f22cca44ba5022d93bfd895ec08682fbda7efb8c,1,7,1,8,1,2007-07-29 01:54:56,2007-07-28 23:04:09
f22cca44ba5022d93bfd895ec08682fbda7efb8c...c22486c9677682416ae6ad3ee77688e8b6923ee3,1,1,1,2,1,2007-07-29 01:55:04,2007-07-28 23:44:40
c22486c9677682416ae6ad3ee77688e8b6923ee3...82cb8afa9bf24d2f77a6d565cdc08d6aa1febeb4,2,2,1,3,2,2007-07-29 20:24:42,2007-07-29 09:49:56
82cb8afa9bf24d2f77a6d565cdc08d6aa1febeb4...89b2f19cb516249b8d9546bb1f3f46a1ec5b3242,1,3,2,5,3,2007-07-29 22:23:28,2007-07-29 22:23:28
922b0e35b9622d81732f4cb6db4862d17ebf1855...0ec29a4760e7c1dd1e168f6dbdd22b87559a26e9,1,28,16,44,3,2007-07-30 06:28:55,2007-07-29 00:17:17
0ec29a4760e7c1dd1e168f6dbdd22b87559a26e9...283884422f35594db9eab491d3f8c91e49f9d62f,2,0,4,4,2,2007-07-30 06:28:55,2007-07-29 00:20:52
283884422f35594db9eab491d3f8c91e49f9d62f...d7f6bae28142e07e544efdab73260cf9f60ca899,2,72,5,77,5,2007-07-30 06:29:04,2007-07-29 00:57:25
d7f6bae28142e07e544efdab73260cf9f60ca899...5c759f96d020d7021a7e674c8d1e5bebd17dcd2f,1,1,1,2,1,2007-07-30 08:27:34,2007-07-30 01:50:24
5c759f96d020d7021a7e674c8d1e5bebd17dcd2f...299726d53841984450524f4ade428112e51c853e,1,3,3,6,2,2007-07-30 19:24:54,2007-07-29 23:24:38
299726d53841984450524f4ade428112e51c853e...bf655fd7009bf5b8f493c52ca77c0d9e09dcb762,1,36,3,39,2,2007-07-31 00:49:50,2007-07-30 09:08:21
bf655fd7009bf5b8f493c52ca77c0d9e09dcb762...0781b8a9b2fe760fc4ed519a3a26e4b9bd6ccffe,1,10,1,11,2,2007-07-31 00:49:50,2007-07-31 00:12:58
0781b8a9b2fe760fc4ed519a3a26e4b9bd6ccffe...18508c39c48d457fd095e0e30391471658698a1a,1,1,0,1,1,2007-07-31 05:16:40,2007-07-31 05:16:40
18508c39c48d457fd095e0e30391471658698a1a...bef19da9b663044887ecac5ee091ca93567ef331,2,10,1,11,3,2007-07-31 08:23:43,2007-07-29 18:35:45
bef19da9b663044887ecac5ee091ca93567ef331...cf32190aa6966dea519e77cdcc80b87026beb3b4,1,5,5,10,1,2007-07-31 09:06:14,2007-07-31 09:06:14
04d70bebe72c264a1c4d26cbe306672e3e4098e3...09afcd6933e8497c997205dda71d718e62b4de62,1,7,1,8,1,2007-08-13 19:58:38,2007-08-11 10:22:47
09afcd6933e8497c997205dda71d718e62b4de62...8fdc39729b9aaa02e89eca9d7964182a72052665,1,6,4,10,1,2007-08-13 19:58:38,2007-08-11 10:23:21
8fdc39729b9aaa02e89eca9d7964182a72052665...77b258f436874bdd1caecd4b3c9c63e3d49bd147,1,19,17,36,7,2007-08-13 19:58:38,2007-08-11 21:08:20
77b258f436874bdd1caecd4b3c9c63e3d49bd147...d616813d75b888b7c29bbad19808fe5cffa5380c,5,51,5,56,12,2007-08-13 19:58:38,2007-08-11 21:59:01
d616813d75b888b7c29bbad19808fe5cffa5380c...95eb6853af73ba91188a481a882076fa2639f15f,1,6,0,6,1,2007-08-13 19:58:38,2007-08-12 15:24:30
95eb6853af73ba91188a481a882076fa2639f15f...4b37666ccbab015e75fda745c29a2f5d58a54482,1,10,8,18,4,2007-08-13 20:04:18,2007-08-12 17:44:06
4b37666ccbab015e75fda745c29a2f5d58a54482...89d07f750a3f878c42b3de96ee93dc571b42b230,2,7,1,8,2,2007-08-13 20:06:23,2007-08-12 17:46:55
89d07f750a3f878c42b3de96ee93dc571b42b230...7da660f4372f4113184f782634c0fafb2cf46cef,1,1,1,2,1,2007-08-13 22:23:14,2007-08-13 18:40:50
7da660f4372f4113184f782634c0fafb2cf46cef...70f64148bf7ca5136f2aa18c41b3b8f4bebfd138,1,2,2,4,2,2007-08-13 23:47:38,2007-08-11 19:24:29
70f64148bf7ca5136f2aa18c41b3b8f4bebfd138...0476786e645ae18096d6a63de5fd4b756071b522,1,1,1,2,1,2007-08-14 04:19:20,2007-08-14 04:03:18
0476786e645ae18096d6a63de5fd4b756071b522...b2bc9a30981ace8c18d1a73b3e10153efc5c20f7,3,12,15,27,4,2007-08-14 04:19:48,2007-08-11 13:36:28
b2bc9a30981ace8c18d1a73b3e10153efc5c20f7...30c5cd312472574f6a8d8c82ba7c4af76d43ff7c,1,55,0,55,1,2007-08-14 04:19:48,2007-08-13 05:38:11
30c5cd312472574f6a8d8c82ba7c4af76d43ff7c...180787c48f21c40a047ae3ee5432821d7e033e44,1,4,4,8,2,2007-08-14 06:34:38,2007-08-13 22:05:50
180787c48f21c40a047ae3ee5432821d7e033e44...fb13227e089f22dc31a3b1624559153821056848,3,61,0,61,5,2007-08-14 08:55:00,2007-08-03 20:33:31
fb13227e089f22dc31a3b1624559153821056848...9fa3465d6be83c08ed24762c82eb33cb005729f3,4,15,0,15,4,2007-08-14 08:59:33,2007-07-20 18:15:13
9fa3465d6be83c08ed24762c82eb33cb005729f3...b798671fa935492ce511766bc99fb26b2892499b,2,95,23,118,5,2007-08-15 05:20:01,2007-08-14 22:33:07
b798671fa935492ce511766bc99fb26b2892499b...eef427a09ce7fcbdc54c73ae363cbab331eccd88,1,2,2,4,2,2007-08-15 05:20:13,2007-08-14 19:42:37
eef427a09ce7fcbdc54c73ae363cbab331eccd88...f21a47b27ceef8ff2f6f218d5b7266d5fd9e2e93,1,10,0,10,1,2007-08-15 05:20:23,2007-08-14 19:44:53
f21a47b27ceef8ff2f6f218d5b7266d5fd9e2e93...7647b17f1d7a98362f8bdbe48b30d94ed655229c,6,7,17,24,8,2007-08-15 05:20:26,2007-08-14 19:45:58
7647b17f1d7a98362f8bdbe48b30d94ed655229c...6d2d9e8666ef72c8878af4822e243ca33b6752a0,3,9,3,12,7,2007-08-15 05:34:58,2007-08-14 22:41:00
6d2d9e8666ef72c8878af4822e243ca33b6752a0...6b06d518caa6ef98cc0efb796713d0a0693895bf,1,5,0,5,2,2007-08-15 05:46:01,2007-08-14 13:18:38
6b06d518caa6ef98cc0efb796713d0a0693895bf...a44131181a13eb599ed35647709692b1699706eb,1,41,26,67,11,2007-08-15 06:19:06,2007-08-14 08:40:45
a44131181a13eb599ed35647709692b1699706eb...1a9d7e9b484e77436edc7f5cacd39c24ec605e6d,3,150,11,161,6,2007-08-15 06:19:10,2007-08-14 08:41:02
1a9d7e9b484e77436edc7f5cacd39c24ec605e6d...1467b5fec376b6c43a5fa54bffd356e458a8d57c,1,62,19,81,24,2007-08-15 07:01:57,2007-08-15 06:52:36
1467b5fec376b6c43a5fa54bffd356e458a8d57c...6ed77266c6e85130920ef30cd290d36ad4464695,2,63,9,72,7,2007-08-15 19:09:48,2007-08-15 16:55:18
6ed77266c6e85130920ef30cd290d36ad4464695...79d722224dbad49a50072f92f823d8b12c2e5707,2,9,7,16,4,2007-08-15 20:43:08,2007-08-15 15:59:24
79d722224dbad49a50072f92f823d8b12c2e5707...f34f2b0b384b42f7a0d0d92966c145b05fe55217,1,6,2,8,4,2007-08-16 04:36:37,2007-08-15 22:45:10
7aecb128779ffd8258f01f4382df963900ae6acd...c8e23aaf1814b95d64fc536fdf1acaa54bb28411,1,3,1,4,1,2007-07-04 06:29:32,2007-07-04 06:29:32
b8336519450fdedc8f9cafebc73f7a0226e34e1f...38d697a156f6e6702cfe9d460296cb521e3fb1b2,1,7,4,11,3,2007-06-30 17:50:18,2007-06-30 08:56:12
38d697a156f6e6702cfe9d460296cb521e3fb1b2...181ea688b83d3b46b9d0e55f1db0123332611db6,1,7,0,7,2,2007-06-30 17:50:28,2007-06-30 08:56:16
181ea688b83d3b46b9d0e55f1db0123332611db6...206488774238c94ff337dd5c997be441dbde5112,1,3,3,6,1,2007-06-30 18:16:09,2007-06-30 17:05:03
c85d4f166096225fa78a9aec8707c6b834da74cb...47598d7a4920f02c60d7091e7186c50468d83aab,2,26,0,26,4,2007-06-10 23:57:48,2007-06-08 11:24:56
47598d7a4920f02c60d7091e7186c50468d83aab...ada3e1f7334b19c98688bcbd7a24d6b559173dfa,1,8,1,9,1,2007-06-10 23:57:48,2007-06-08 11:26:31
ada3e1f7334b19c98688bcbd7a24d6b559173dfa...90921740bd00029708370673fdc537522aa48e6f,1,202,111,313,11,2007-06-10 23:57:48,2007-06-08 11:27:42
90921740bd00029708370673fdc537522aa48e6f...deaa01a9f59875dcfd0c9e08ce48f4168f29cb81,1,27,11,38,2,2007-06-10 23:57:48,2007-06-08 11:29:49
deaa01a9f59875dcfd0c9e08ce48f4168f29cb81...91af4ce4ec3f39e1190ab702f51f141e18cdcc1e,1,14,3,17,3,2007-06-10 23:57:48,2007-06-08 11:32:44
91af4ce4ec3f39e1190ab702f51f141e18cdcc1e...cd030c3a7053aec0f9dbf321ef139ce02a821f3b,1,99,12,111,11,2007-06-10 23:57:48,2007-06-08 11:33:28
90ac368afd75c9a53c6d953a693380369a41f8db...48dd1da8e190c435de692c0cfff5a8f6eacedbe5,1,2,0,2,1,2007-06-13 09:02:10,2007-06-13 09:00:01
48dd1da8e190c435de692c0cfff5a8f6eacedbe5...334d28ae606c2d007803594cfc20d9e7997c0543,1,6,2,8,2,2007-06-13 09:02:10,2007-06-13 08:28:21
334d28ae606c2d007803594cfc20d9e7997c0543...b79d18c92d9f4841a6a1a29b7b2373a8ff9871e1,3,3,3,6,3,2007-06-13 09:02:10,2007-06-13 08:22:51
b79d18c92d9f4841a6a1a29b7b2373a8ff9871e1...4175e9e3a8734be1e96e385b0fa2428b86ed5809,8,6,64,70,11,2007-06-13 09:02:10,2007-06-13 08:42:05
4175e9e3a8734be1e96e385b0fa2428b86ed5809...30a844874db6ee25b6f54ea786f0adabd8e074d7,1,18,1,19,3,2007-06-13 09:14:20,2007-06-13 08:46:15
30a844874db6ee25b6f54ea786f0adabd8e074d7...1be846f6e48bae57c3d5cc346300eaf9550f6c8d,1,1,1,2,1,2007-06-13 09:14:26,2007-06-13 08:46:16
1be846f6e48bae57c3d5cc346300eaf9550f6c8d...b54a901e05235b2717da54d2a51b8cbd571cefcd,1,11,5,16,2,2007-06-13 17:56:44,2007-06-13 09:37:03
b54a901e05235b2717da54d2a51b8cbd571cefcd...b3bf96d483ac2ff4a7523445a4e3f53f266501a4,1,40,0,40,1,2007-06-13 18:01:49,2007-06-13 09:37:04
b3bf96d483ac2ff4a7523445a4e3f53f266501a4...38570a47fcd9d7631c03673249f587697fa85677,1,1,1,2,1,2007-06-13 18:23:51,2007-06-13 09:37:05
90ac368afd75c9a53c6d953a693380369a41f8db...2abd31b07864049f0352d86c0c90413123f40945,2,16,1,17,6,2007-06-13 07:41:52,2007-06-11 13:39:50
2abd31b07864049f0352d86c0c90413123f40945...e96980ef8164f266308ea5fec536863a629866dc,3,36,53,89,11,2007-06-13 07:41:52,2007-06-12 21:42:14
90ac368afd75c9a53c6d953a693380369a41f8db...80583c0ef61cc966c7eee79cf3623a83197e19b8,9,123,73,196,49,2007-06-13 07:41:21,2007-06-11 07:34:54
80583c0ef61cc966c7eee79cf3623a83197e19b8...4234a76167b12a7669dae0e6386c62e712b9dcf5,2,258,135,393,23,2007-06-13 07:41:21,2007-06-12 05:10:55
4234a76167b12a7669dae0e6386c62e712b9dcf5...c927e6c69b50877e116340671ed35aaf6d3a8f49,1,1,1,2,1,2007-06-17 00:55:44,2007-06-16 22:37:39
952c8c56380734d45bddf369fe478895672c5a3a...3e48af387522bfff8ae410cfda28c3eefd1cebad,1,3,1,4,2,2007-06-16 16:10:18,2007-06-16 16:10:18
3e48af387522bfff8ae410cfda28c3eefd1cebad...7cbf2f24ee8430fbf48a2c6f106f22adf9df62e1,1,2,4,6,4,2007-06-16 16:11:58,2007-06-12 20:52:10
7cbf2f24ee8430fbf48a2c6f106f22adf9df62e1...29a6c3f8046ca2de39958a1e9fa93d4afc9461bf,1,9,0,9,2,2007-06-16 20:08:05,2007-06-16 19:03:43
29a6c3f8046ca2de39958a1e9fa93d4afc9461bf...6da08783022ab7e54fcf63c55ea7a52bd3900b99,2,8,2,10,3,2007-06-16 20:08:09,2007-06-16 19:03:45
6da08783022ab7e54fcf63c55ea7a52bd3900b99...c9bf7be238ac3c767f9ac6546d5bb7b11765253c,1,4,0,4,1,2007-06-16 20:08:11,2007-06-16 19:03:44
c9bf7be238ac3c767f9ac6546d5bb7b11765253c...cb877cd7b6c2a47ca4cbf58cd018ed1e73e8e0f3,1,13,0,13,1,2007-06-16 20:08:12,2007-06-16 19:03:46
cb877cd7b6c2a47ca4cbf58cd018ed1e73e8e0f3...e3c1500fcf16fd8155b5c009c17715213882f62f,1,4,0,4,2,2007-06-16 20:08:14,2007-06-16 19:03:42
e3c1500fcf16fd8155b5c009c17715213882f62f...ef3cb65c21d684df6e4c8b81ebe69a8652591998,1,1,1,2,1,2007-06-16 20:10:28,2007-06-16 19:03:37
ef3cb65c21d684df6e4c8b81ebe69a8652591998...13120fdc5ea8a8651850845f3ea320914f85056e,1,9,0,9,1,2007-06-16 20:10:49,2007-06-16 19:03:39
13120fdc5ea8a8651850845f3ea320914f85056e...2e88c266261489a16708ba5ee0ddfbabcb17e3a4,1,7,0,7,1,2007-06-16 20:10:52,2007-06-16 19:03:38
2e88c266261489a16708ba5ee0ddfbabcb17e3a4...3c740268c40f10010dd5dec7df85a1f0d2062c59,1,2,2,4,1,2007-06-20 23:22:09,2007-06-16 23:52:50
3c740268c40f10010dd5dec7df85a1f0d2062c59...a90918e8244d98862d0183de949fe9764c40e4d5,1,10,4,14,1,2007-06-20 23:22:09,2007-06-18 08:43:34
a90918e8244d98862d0183de949fe9764c40e4d5...45fd8bd32dd68ce6b14a406d0abbd6f56490131c,1,1,1,2,1,2007-06-20 23:22:09,2007-05-08 10:49:31
7ca055f75ad7ffd2251d4b607fbb86d7bcfd77c7...b259157f3c8705e0f775a3df2b33198499aede4f,1,1,0,1,1,2007-05-24 03:36:47,2007-05-23 21:00:22
b259157f3c8705e0f775a3df2b33198499aede4f...20f546a86c5c673fc49050479a12edfb9f8672bf,1,1,1,2,1,2007-05-24 03:36:47,2007-05-23 21:01:49
20f546a86c5c673fc49050479a12edfb9f8672bf...654aaa37ab5c70650bdd16d57b56c2d0f9aa43cf,1,31,27,58,3,2007-05-24 04:11:48,2007-05-24 04:05:19
654aaa37ab5c70650bdd16d57b56c2d0f9aa43cf...aac65ed1bc63619d32516079995f5cbe4bb46492,2,36,5,41,3,2007-05-24 04:50:19,2007-05-24 04:32:31
7ca055f75ad7ffd2251d4b607fbb86d7bcfd77c7...421f9d1685b4b7d286b5929489a0d95139c6ecce,2,6,1,7,6,2007-05-23 18:30:49,2007-05-23 16:07:25
a1ad2475a710a90e28f41c5110f59e2cf7282b70...66edfe9ddc29102fa39edd37f9aecccbaca6a013,1,1,1,2,1,2014-11-07 20:01:01,2014-11-07 20:01:01
0ba956d331e4c14fb1600a62044492c6c27af71a...9902387d20e7a73662a97f5c4b66ba4ec80dc9ce,1,7,0,7,1,2007-05-23 05:42:42,2007-05-23 05:07:54
22e5e58a3c75b73764b860907e4d871195f276ac...6325ca3129ef969077115ba600d8356b8412b4d2,1,1,1,2,1,2010-08-24 16:58:40,2010-08-24 07:14:53
6325ca3129ef969077115ba600d8356b8412b4d2...ef45e4dae0a0f45fc72b7cd34b32dd465a38697d,1,1,1,2,1,2010-08-24 17:37:39,2010-08-22 16:26:38
22e5e58a3c75b73764b860907e4d871195f276ac...2839478774f48074d7d87b8a9838827742a5b058,7,19,18,37,16,2010-08-24 16:48:20,2010-08-23 21:20:25
8fc824f397b2d10a2643a6177ff03c56b1017673...31c79549b85c6393be4f40432f5b86ebc097fc7e,1,34,0,34,4,2012-07-16 04:46:26,2012-07-16 04:46:26
01388518c30c20ccbbb9f99e00314ef291ecda37...b60e188c51242b72061b5f2f0d4df80397f6125a,8,63,51,114,34,2012-07-11 16:42:45,2012-07-11 09:22:37
547e8b9205349b47003ed25a82673e413e71c255...c0336ff27a9a4bf9db87d65c5dec1ebf7dd9f8c6,1,1,0,1,1,2011-05-18 04:27:19,2011-05-16 20:08:21
547e8b9205349b47003ed25a82673e413e71c255...cf1af1b1f3ddd2554f64aae120635952801a9632,1,100,0,100,1,2011-04-29 22:37:08,2011-04-29 22:23:54
cf1af1b1f3ddd2554f64aae120635952801a9632...6aaeca900b05a8265d1930d3dc0a2df19002771f,2,8,3,11,4,2011-04-29 22:37:43,2011-04-29 22:24:32
547e8b9205349b47003ed25a82673e413e71c255...90a6464b4ad5887e4d12e660f51dabdbd5c00812,4,86,2,88,4,2011-03-23 23:05:44,2011-03-11 00:02:50
547e8b9205349b47003ed25a82673e413e71c255...206b099d269955337bd6169f71aa08ba28a0cf4f,1,55,11,66,7,2011-02-15 19:42:20,2011-02-15 16:57:24
9904fadfea002edf2ef22e8ec9a978e45d1f540b...b294ed637d3c13cd96ba6f0e464e02e170cc54a6,2,11,0,11,2,2010-09-12 20:52:03,2010-09-11 18:47:09
9904fadfea002edf2ef22e8ec9a978e45d1f540b...d555ff54820ade336d0d0f3900d62d5c09c0f63e,1,6,1,7,2,2010-09-11 17:23:03,2010-09-11 09:59:18
d555ff54820ade336d0d0f3900d62d5c09c0f63e...e22148f406a7a31a25ebda01d21d9a4646ce82ea,1,64,62,126,19,2010-09-12 20:46:58,2010-09-11 17:53:29
8ac8cf5bc17ef11a9c5d51ab128ad010cb37c464...99f55ebc6757ec8777627142e7f8e1dc50f68d2c,1,4,4,8,3,2010-09-10 16:30:14,2010-09-10 16:13:38
8ac8cf5bc17ef11a9c5d51ab128ad010cb37c464...fb1bb96516d4bc985393c0bfb8bb7a6d6ce95045,2,14,2,16,6,2010-09-10 15:37:14,2010-09-10 13:28:59
2e1e96126f93653badaa0afd17204e417dfc8e7d...7e100effc6c3a8acbb4bf305638c7b324a63236d,2,9,3,12,5,2010-09-15 19:47:37,2010-09-15 19:47:37
b886656403ed26a9a78f73724c640a3149636ada...9855b08d35edf8a8a441f24ff7b00e220a29f261,3,56,2,58,3,2010-09-29 22:26:17,2010-09-29 21:07:59
5b45c55545dc492ff9cbe19d17c275b96b198eed...3b3a8ed4beadf5d9437597108355b23c7143bc81,1,1,1,2,1,2010-09-10 18:55:55,2010-09-10 18:55:55
cbcab75c54b5956dcaa4f24a4074bc99adc49629...ea2d4ed35902ce15959965ab86d80527731a177c,2,14,1,15,3,2012-07-10 21:16:41,2012-07-10 20:40:29
3d045897585c4b1ca0dce6bb5a33331f1b48c2bf...8ef1abe5504acb22f6a3fd24a0fda8c4b9f172a5,1,13,10,23,1,2010-08-18 19:41:57,2010-08-11 19:37:31
8ef1abe5504acb22f6a3fd24a0fda8c4b9f172a5...93a5724613861e6cd85964c85f2fa0891caab258,3,37,6,43,3,2010-08-18 19:42:04,2010-08-06 21:19:23
93a5724613861e6cd85964c85f2fa0891caab258...71ce42c0a6b3b4c75836cf074fcdf289633f41b4,1,1,1,2,1,2010-08-18 19:42:04,2010-08-06 21:19:24
71ce42c0a6b3b4c75836cf074fcdf289633f41b4...be53deef0d94b80b0a2df465d16f21ed29c3165b,1,40,5,45,2,2010-08-18 19:42:04,2010-08-06 21:19:25
be53deef0d94b80b0a2df465d16f21ed29c3165b...c91cfd19160be63e97f28dce8c9af421b61c9938,9,24,32,56,18,2010-08-18 19:42:04,2010-08-06 22:09:09
c91cfd19160be63e97f28dce8c9af421b61c9938...ce60653e59f89b409b80a1a381275914fddce07f,2,23,4,27,7,2010-08-18 19:42:04,2010-08-11 12:04:38
ce60653e59f89b409b80a1a381275914fddce07f...b6b84d1b7458676d2564ac7f8dad8a10bf900239,2,55,1,56,2,2010-08-18 19:42:14,2010-08-08 14:49:24
b6b84d1b7458676d2564ac7f8dad8a10bf900239...d15e9ebc5c8a627844275e02a2b15a101ce46d4a,1,66,0,66,1,2010-08-18 19:42:14,2010-08-08 14:49:25
d15e9ebc5c8a627844275e02a2b15a101ce46d4a...4678a5cd71312f27b77228ddc398a6f0fa2e88a0,1,1,1,2,2,2010-08-18 19:42:14,2010-08-08 14:49:26
4678a5cd71312f27b77228ddc398a6f0fa2e88a0...e38efac87d4542d2368ad772d1e9dd51ab650acb,2,13,0,13,2,2010-08-18 19:42:14,2010-08-08 14:49:27
e38efac87d4542d2368ad772d1e9dd51ab650acb...3f5e042b9cfdbb972a3ddcabe3b13e5350231751,1,4,0,4,1,2010-08-18 19:42:18,2010-07-25 19:52:39
3f5e042b9cfdbb972a3ddcabe3b13e5350231751...bc548efe0037839e1a4a611e5f0f24b33fc39dc5,1,11,3,14,6,2010-08-18 19:42:18,2010-07-25 19:52:40
bc548efe0037839e1a4a611e5f0f24b33fc39dc5...b5eed98104853dfed63e5c9f2a6214df74f7b0a7,1,2,0,2,1,2010-08-18 19:42:18,2010-07-25 19:52:41
b5eed98104853dfed63e5c9f2a6214df74f7b0a7...7432bd5fbde117620e3b47d28e05827a334f42bf,2,5,0,5,3,2010-08-18 19:42:18,2010-07-25 19:52:42
7432bd5fbde117620e3b47d28e05827a334f42bf...df07acfe0bf000e0852c31e65d915faf3d1b43f7,2,5,0,5,3,2010-08-18 19:42:18,2010-07-25 19:52:43
df07acfe0bf000e0852c31e65d915faf3d1b43f7...0c357544b0d4415c464fb8b35593b21db1d1f7f7,1,42,0,42,2,2010-08-18 19:42:37,2010-07-25 19:52:44
0c357544b0d4415c464fb8b35593b21db1d1f7f7...e8b55f5c58d1d9e5d5cd5b24d96b7d3b51047440,1,9,0,9,1,2010-08-18 19:42:37,2010-07-25 19:52:45
e8b55f5c58d1d9e5d5cd5b24d96b7d3b51047440...e146d1772b57f595cd7c6537045eedbb82b98e37,1,2,1,3,2,2010-08-18 19:42:37,2010-07-26 07:43:41
e146d1772b57f595cd7c6537045eedbb82b98e37...41be8ea22371b82e2a8eb308386b704c6775ed03,8,42,90,132,45,2010-08-18 19:42:45,2010-07-28 10:34:55
41be8ea22371b82e2a8eb308386b704c6775ed03...f6c1998f1412ffb31ac69e0c725c5b8d88b0389a,1,7,11,18,5,2010-08-18 19:42:45,2010-07-28 10:34:56
f6c1998f1412ffb31ac69e0c725c5b8d88b0389a...8c42791061b2e9231e8ff64dd5f6e7eeacd2c1cf,1,11,13,24,10,2010-08-18 19:42:45,2010-07-28 10:34:57
8c42791061b2e9231e8ff64dd5f6e7eeacd2c1cf...2c4f302607070c44b1bb1beca26ab4653a604baf,1,22,27,49,23,2010-08-18 19:42:45,2010-07-28 10:34:58
2c4f302607070c44b1bb1beca26ab4653a604baf...99d9050d256d1a928ce6d13fe275d8fd4bfcbdee,1,18,3,21,2,2010-08-18 19:42:45,2010-07-28 10:34:59
99d9050d256d1a928ce6d13fe275d8fd4bfcbdee...063b7e0cd4a9017045fc6323a526e82b670dc740,1,8,6,14,4,2010-08-18 19:42:45,2010-08-11 19:04:04
063b7e0cd4a9017045fc6323a526e82b670dc740...2c7e134cfe6fa10665b2545d5f6e2fb5d160618e,1,9,7,16,4,2010-08-18 19:42:45,2010-08-11 19:04:05
2c7e134cfe6fa10665b2545d5f6e2fb5d160618e...fab68aa2bab70198c9a57890a30ea0250f99bc9d,1,5,5,10,4,2010-08-18 19:42:45,2010-08-11 19:04:06
fab68aa2bab70198c9a57890a30ea0250f99bc9d...49f32489d3c436206acf988ccc99e06df4f3ed41,1,24,9,33,12,2010-08-18 19:42:46,2010-08-11 19:04:07
49f32489d3c436206acf988ccc99e06df4f3ed41...b5fa2891485353a0cf57300d373e8f85b73b9ca1,1,15,7,22,6,2010-08-18 19:42:46,2010-08-11 19:04:08
b5fa2891485353a0cf57300d373e8f85b73b9ca1...a0beb1326c5de2e9859f91c8ed5b9108a6454660,1,21,17,38,15,2010-08-18 19:42:46,2010-08-11 19:04:09
a0beb1326c5de2e9859f91c8ed5b9108a6454660...e1697cc5b5d765f0544b370ccdb87145cdfd91fc,1,60,22,82,29,2010-08-18 19:42:46,2010-08-11 19:04:10
e1697cc5b5d765f0544b370ccdb87145cdfd91fc...d0736f7b81ac2fcb763279b3bf3e90faa3fb6609,1,20,12,32,6,2010-08-18 19:42:46,2010-08-10 23:37:48
d0736f7b81ac2fcb763279b3bf3e90faa3fb6609...617344d77bf2a11b507fb74160b14e5b7476f8ad,1,1,1,2,1,2010-08-18 19:43:23,2010-08-14 11:37:05
617344d77bf2a11b507fb74160b14e5b7476f8ad...535d9742852e12a4d4cfc878eb2e734df70a8f22,6,16,31,47,9,2010-08-18 19:43:23,2010-08-13 20:40:04
535d9742852e12a4d4cfc878eb2e734df70a8f22...f04593199b1e1b91687463e46ad4595280853677,1,70,34,104,36,2010-08-18 19:43:23,2010-08-13 20:40:05
f04593199b1e1b91687463e46ad4595280853677...f2f7b6a550008151a1d312b058c853cd7a61f9ab,4,23,28,51,24,2010-08-18 19:43:23,2010-08-13 20:40:06
f2f7b6a550008151a1d312b058c853cd7a61f9ab...900eab442721087c2ca620caab0d1be0cc20c6df,1,18,21,39,15,2010-08-18 19:43:23,2010-08-13 20:40:07
900eab442721087c2ca620caab0d1be0cc20c6df...3731231d4c81d1234d231e2a82f3720f10bdbe76,1,0,1,1,1,2010-08-18 19:43:23,2010-08-13 20:40:08
3731231d4c81d1234d231e2a82f3720f10bdbe76...57cd35e6adc68a33163136ef416ffa43b4821ab0,1,83,82,165,74,2010-08-18 19:43:23,2010-08-13 20:40:09
57cd35e6adc68a33163136ef416ffa43b4821ab0...f9444147fa4f5f4c2e3eb4980c762844f4b39f87,1,40,3,43,36,2010-08-18 19:43:23,2010-08-13 20:40:10
f9444147fa4f5f4c2e3eb4980c762844f4b39f87...d2b263cb8c02164d27e4bded471a823b70228466,1,4,4,8,4,2010-08-18 19:43:23,2010-08-13 20:40:11
d2b263cb8c02164d27e4bded471a823b70228466...c2c09e23ef270d517d88cb597c41ae436c60436e,1,13,11,24,10,2010-08-18 19:43:23,2010-08-13 20:40:12
c2c09e23ef270d517d88cb597c41ae436c60436e...06eaaa783c9ba36ac45143eaa3b707f804d377a4,1,15,13,28,12,2010-08-18 19:43:24,2010-08-13 20:40:13
06eaaa783c9ba36ac45143eaa3b707f804d377a4...9b777a165e050f9a881a74a5902a8ddd2de30da5,5,9,11,20,5,2010-08-18 19:43:24,2010-08-16 16:25:01
9b777a165e050f9a881a74a5902a8ddd2de30da5...568899539d23be8689da4e7ee989deb8b8dc1a75,1,1,0,1,1,2010-08-31 19:11:06,2010-07-25 14:55:46
568899539d23be8689da4e7ee989deb8b8dc1a75...aed604c7789146392bb4d4445717388c81c2701f,1,8,8,16,7,2010-08-31 19:12:01,2010-08-19 16:08:09
aed604c7789146392bb4d4445717388c81c2701f...6cec5c683535c8eacf6055064c9c5753b47bb031,1,15,14,29,14,2010-08-31 19:12:01,2010-08-19 16:08:10
6cec5c683535c8eacf6055064c9c5753b47bb031...62f539043c714031ccb78d13ed6c49d350233604,1,7,1,8,1,2010-08-31 19:12:01,2010-08-19 16:08:11
62f539043c714031ccb78d13ed6c49d350233604...7b905119703f480b1cf0791116b85a7e23aa3ba4,1,31,0,31,2,2010-08-31 19:12:01,2010-08-19 16:08:12
7b905119703f480b1cf0791116b85a7e23aa3ba4...07431fc8dc136573f31cb9db6605f49f792c8b10,1,7,1,8,2,2010-08-31 19:12:02,2010-08-24 07:34:10
07431fc8dc136573f31cb9db6605f49f792c8b10...0d314ce834df9ad6bb5d6e9583c38aefd047fc9b,1,6,6,12,2,2010-08-31 19:12:02,2010-08-30 12:00:42
0d314ce834df9ad6bb5d6e9583c38aefd047fc9b...e4c62e640db3f704b4c27435c6b8efdb170988dc,5,3,13,16,7,2010-08-31 19:12:02,2010-08-30 09:50:42
3d045897585c4b1ca0dce6bb5a33331f1b48c2bf...54fb7f9b08270873b0646d84164e1cebe2deb857,1,1,1,2,1,2010-08-15 23:43:35,2010-08-15 13:15:54
54fb7f9b08270873b0646d84164e1cebe2deb857...3235b7053c45a734c1cdf9b117bda68b7ced29c9,3,99,2,101,4,2010-08-15 23:43:37,2010-08-15 13:15:55
3d045897585c4b1ca0dce6bb5a33331f1b48c2bf...3f527372d9ec6d7b6890773e41c4b3542d7ad451,2,33,1,34,5,2010-08-15 02:35:37,2010-08-09 22:04:29
3f527372d9ec6d7b6890773e41c4b3542d7ad451...4709455db3891f6cad9a96a574296b4926f70cbe,5,260,1,261,6,2010-08-15 02:35:37,2010-08-09 22:11:11
4709455db3891f6cad9a96a574296b4926f70cbe...951f316470acc7c785c460a4e40735b22822349f,7,432,1,433,8,2010-08-15 02:35:37,2010-08-09 22:17:34
951f316470acc7c785c460a4e40735b22822349f...1d73b52f5ba4184de6acf474f14668001304a10c,7,210,3,213,11,2010-08-15 02:35:37,2010-08-09 22:34:42
1d73b52f5ba4184de6acf474f14668001304a10c...3bbaec00a8ffc6ea7e71c3b707851fe663d93a45,7,274,2,276,10,2010-08-15 02:35:37,2010-08-09 22:39:43
3bbaec00a8ffc6ea7e71c3b707851fe663d93a45...c0e6c23dca84227167a6fe1077503ddf32208919,5,443,2,445,6,2010-08-15 02:35:37,2010-08-09 22:48:10
c0e6c23dca84227167a6fe1077503ddf32208919...21746aa34fc99d2c73634bc9829387c27c109dbe,8,372,2,374,11,2010-08-15 02:35:38,2010-08-09 22:55:00
21746aa34fc99d2c73634bc9829387c27c109dbe...712308f29ab05f821365edec9550b45d8b616c2a,1,6,8,14,2,2010-08-15 02:35:38,2010-08-09 22:55:43
712308f29ab05f821365edec9550b45d8b616c2a...d0fc40c741176a9f4092eaeb1a3d18aca60ac5df,1,4,1,5,2,2010-08-15 02:35:38,2010-08-09 22:58:36
d0fc40c741176a9f4092eaeb1a3d18aca60ac5df...be47d5a646f53454c081ec7cf0da2db945eb0f99,1,2,2,4,1,2010-08-15 02:35:38,2010-08-12 21:30:47
be47d5a646f53454c081ec7cf0da2db945eb0f99...6ad263ce7afc6c21c3ada1691f4772993b8ae46b,1,15,15,30,15,2010-08-15 02:35:38,2010-08-12 22:02:57
6ad263ce7afc6c21c3ada1691f4772993b8ae46b...78457bc0ccc1af8b9eb776a0b17986ebd50442bc,5,81,0,81,8,2010-08-15 02:35:38,2010-08-13 23:59:40
78457bc0ccc1af8b9eb776a0b17986ebd50442bc...68b4cfbc91583b43e96d38b8d7efc8e6690589ad,1,73,73,146,40,2010-08-15 02:35:38,2010-08-14 00:01:34
68b4cfbc91583b43e96d38b8d7efc8e6690589ad...6117abae569e53485f7a90d2595b135c7beb3c96,1,3,2,5,1,2010-08-15 02:35:38,2010-08-14 00:03:17
6117abae569e53485f7a90d2595b135c7beb3c96...24f1136894b6db0a21b7b89a77da2ae2909487e9,1,1,1,2,1,2010-08-15 02:35:38,2010-08-14 00:04:50
24f1136894b6db0a21b7b89a77da2ae2909487e9...7e45e0569c6b659dbe4f7a95d59ee0c98f8b7cb6,1,1,1,2,1,2010-08-15 02:35:38,2010-08-14 00:06:15
7e45e0569c6b659dbe4f7a95d59ee0c98f8b7cb6...cd9a7b57a7118672441f9e9670a9fbb42249cf67,1,0,0,0,0,2010-08-19 20:07:14,2010-08-19 15:53:50
245b10ca1b0ff21de42b12ee2c1e3c9f8d1d98a3...520ea857e66f25a681401fd534b2f0d099fd2d31,1,5,5,10,1,2010-08-30 05:36:32,2010-08-28 18:18:36
9a9fb5d3c4c8601beb2d7b8e3b9283c6c3815a2d...35039ced9296786bc0971bf5385c0d6f6ea5ea1e,2,2,1,3,2,2010-07-27 20:28:54,2010-07-27 18:32:36
35039ced9296786bc0971bf5385c0d6f6ea5ea1e...dcbeac48a7e61154c53ae800ea224607c1f7d52a,2,0,2,2,2,2010-07-27 20:29:14,2010-07-27 18:37:07
dcbeac48a7e61154c53ae800ea224607c1f7d52a...7f1592db5d4cba2b3de3a1ce46eb8c05bd33e0a1,1,1,1,2,1,2010-07-27 20:29:32,2010-07-27 18:44:51
9a9fb5d3c4c8601beb2d7b8e3b9283c6c3815a2d...293b07f114796d39c5571d5fe4808e898e5af0c8,1,2,2,4,1,2010-07-27 16:04:21,2010-07-26 08:36:24
293b07f114796d39c5571d5fe4808e898e5af0c8...e8b4ac37d8ec149582527c09369720a6526984af,1,1,0,1,1,2010-07-27 16:05:01,2010-07-26 08:40:58
e8b4ac37d8ec149582527c09369720a6526984af...d3b9dd136ea5735c88a831b5a0f6f2e5dd623701,1,2,1,3,1,2010-07-27 16:12:23,2010-07-26 16:32:09
d3b9dd136ea5735c88a831b5a0f6f2e5dd623701...49bb1f2ac6b6e5c7113241e066545802e5a14c9c,1,1,1,2,1,2010-07-27 16:44:17,2010-07-27 05:40:32
9a9fb5d3c4c8601beb2d7b8e3b9283c6c3815a2d...9a3028b987d73e4c85e8db9980720feba6a1b5c6,2,2,0,2,2,2010-07-26 06:14:48,2010-07-23 22:58:44
408dee5222fd732ac8d59d4d95ee47f5662150d2...54fd955c211db6f4a2c91301f792ec9de86eed31,1,1,4,5,2,2010-04-10 05:42:57,2010-04-09 20:08:35
11766ca4a89ba960271e94281463d1b44654ca3b...00b84e9dbfa6fabbac971dd70bc5a44802b0c36e,1,27,6,33,2,2010-04-18 20:55:41,2010-03-28 18:03:50
00b84e9dbfa6fabbac971dd70bc5a44802b0c36e...5ce4f4e3bf9894ae5a00c7b4f0ba7ba6d953b008,1,36,23,59,9,2010-04-18 20:56:05,2010-04-06 08:38:19
5ce4f4e3bf9894ae5a00c7b4f0ba7ba6d953b008...b6c8d2d663234a2383cbe4634de93ca03f4717e1,1,34,1,35,3,2010-04-18 20:56:17,2010-04-07 05:44:41
b6c8d2d663234a2383cbe4634de93ca03f4717e1...272a36b67b0df4725f3e28f3302f45274b39012f,1,2,3,5,1,2010-04-18 20:56:24,2010-04-18 00:56:37
272a36b67b0df4725f3e28f3302f45274b39012f...d43427d3d9134524d3ebbe176e30cea38f2a0818,1,23,28,51,17,2010-04-18 20:56:29,2010-04-18 00:57:37
11766ca4a89ba960271e94281463d1b44654ca3b...1367b12ad623e28546ba40c435015d94e7fbb248,3,14,0,14,3,2010-04-06 06:02:33,2010-03-25 02:51:52
11766ca4a89ba960271e94281463d1b44654ca3b...8b5fe8c9ec3f961ec9b09844eca6225f06af5b0b,1,0,2,2,2,2010-04-05 17:16:11,2010-04-05 17:16:11
0476228de500049804ae599f557658c3f9042ad0...0ae08401beb0daef9946b6fe25224a4cf167c655,1,2,3,5,1,2010-03-29 04:35:09,2010-03-28 00:45:12
0476228de500049804ae599f557658c3f9042ad0...bb6ad28c23f05e1ea04e3f1c6b9b08cc070c5318,1,1,1,2,1,2010-03-28 16:26:16,2010-03-28 05:42:48
bb6ad28c23f05e1ea04e3f1c6b9b08cc070c5318...42accaec0174f80c81681c4a6f896ca452ba3f76,2,16,5,21,2,2010-03-28 16:29:12,2010-03-27 21:58:09
42accaec0174f80c81681c4a6f896ca452ba3f76...4c367c6ae978ef18477fba6b00458c32f1d49d0d,1,38,33,71,9,2010-03-29 00:42:11,2010-03-29 00:42:11
e92e9cd3c388544f4f521736df844b37908c3879...02646fe55dbbbdd8559f7ed2f38385ffb6b9571c,1,6,1,7,2,2010-05-04 22:29:50,2010-05-04 02:57:10
02646fe55dbbbdd8559f7ed2f38385ffb6b9571c...ae00dc191a8da2309a6d7c68a254ede1357d877d,1,39,29,68,4,2010-05-04 22:29:54,2010-05-04 02:57:36
ae00dc191a8da2309a6d7c68a254ede1357d877d...ed715b5e393f922b7726460c348c8cb7eb7de49b,1,7,0,7,2,2010-05-04 22:29:56,2010-05-04 02:58:04
ed715b5e393f922b7726460c348c8cb7eb7de49b...600372497c668045a365b9eab76987ee19405f7a,2,60,1,61,2,2010-05-04 22:30:59,2010-05-04 02:59:55
600372497c668045a365b9eab76987ee19405f7a...c197702156e2164074327f5e870ab0d3021977fc,5,39,5,44,9,2010-05-04 22:38:58,2010-05-04 03:18:57
e92e9cd3c388544f4f521736df844b37908c3879...aecda37c66ecf215fc67b0b48998a8c69c10d5a5,2,25,1,26,2,2010-05-01 19:00:44,2010-05-01 09:25:12
aecda37c66ecf215fc67b0b48998a8c69c10d5a5...ac472ba65f75fbdbc52328f2bdc8645e5289e683,1,0,2,2,1,2010-05-08 18:12:28,2010-05-01 09:27:20
e92e9cd3c388544f4f521736df844b37908c3879...48bb30331dc1139a7279d1665cfc76f14b5d0e67,1,2,0,2,1,2010-05-01 18:11:52,2010-04-26 09:50:39
48bb30331dc1139a7279d1665cfc76f14b5d0e67...ed215b109fc0e352456ea2ef6a0f8375e28466d5,1,1,1,2,1,2010-05-01 18:58:37,2010-04-29 15:42:47
e92e9cd3c388544f4f521736df844b37908c3879...30c56eaa2e7ab230a89a6fdc76682d2afaf5d4b1,1,214,0,214,1,2010-05-01 18:01:27,2010-04-24 12:11:51
30c56eaa2e7ab230a89a6fdc76682d2afaf5d4b1...50ab6558bf688e15048e189bdaf9174b217e1748,3,16,0,16,3,2010-05-01 18:02:21,2010-04-24 12:15:37
50ab6558bf688e15048e189bdaf9174b217e1748...5bab69172fc20bb86b5245bd1ec41c32dae9eaa6,1,2,2,4,2,2010-05-08 04:30:29,2010-05-08 04:29:50
f6b6098316192475ff0b3fa2ba894d7e555bdfac...3e333036ccbb97fddf54bd8fe74b12ba46f1687b,1,5,3,8,3,2010-06-11 20:46:25,2010-06-11 15:02:50
99f5b0845ac53f9f6e845fe4401e68fcef154690...6a6955134b87ba3ea7d54467e637be0da7ba170b,1,10,9,19,6,2010-03-29 04:57:59,2010-03-29 04:57:59
251a4951a20b23760c3ccf3f3122d4394ab37357...3fdcdbdf301dadb7af58fe038501f0af6419a2e0,4,33,0,33,4,2010-02-25 20:27:38,2010-02-25 20:03:44
2e0e8b68e3ba8ea87f001c45c78f9b7ce549c61f...c88cd03edb4553c726a488a57df5d482cbada9ce,1,2,1,3,2,2010-03-10 23:31:34,2010-03-10 23:31:34
1fa9bf362acbe2c939c246684ab0fe59aec74ba8...1bb88be99e4fdedcd5cc5292c11b566a00028deb,1,1,1,2,1,2007-04-15 00:37:28,2007-04-14 21:26:20
53e1a761be8d338cd957870bc1e48a8c15d7d2c0...d78b0f3d6aa04510dd0c22c3853d3954c5f5b531,1,16,9,25,4,2006-08-16 20:19:06,2006-08-16 08:44:02
2ad6ba353aa3815894674a0dee56aa75f8a5fc7b...8da714939458fed99ff750ca09d4169fe68b034e,1,10,10,20,10,2006-08-23 21:27:00,2006-08-23 06:49:00
8da714939458fed99ff750ca09d4169fe68b034e...87cb004e4251722ca7b888f8b6c77335acb71a85,1,4,6,10,4,2006-08-23 21:31:20,2006-08-23 21:31:20
284fe4beb6b4835ef6857cd56b34c70c1d12b14d...1965efb1599f59b8e3380335d1fa395e2008a30b,1,1,1,2,1,2006-10-01 10:08:55,2006-10-01 10:08:55
1965efb1599f59b8e3380335d1fa395e2008a30b...7c2738cefb07e6549cafa42d1d383a3bb54ed0f3,1,3,3,6,2,2006-10-02 04:41:46,2006-10-02 04:41:46
818f477c40fee62ab8ea5b493c51bb357f38957c...db6296a566eb1a8007a84330a911b38055720743,12,25,22,47,28,2006-07-29 05:03:06,2006-07-29 04:21:48
db6296a566eb1a8007a84330a911b38055720743...a633fca0c056aa221d23493c276d3713191621b3,35,128,144,272,96,2006-07-29 08:34:07,2006-07-29 05:44:25
b63fafdfd844c2037fba53b9944431c1378b4135...7f8508e8d320d768a34483682e9f2dc5af1af04b,1,1,1,2,1,2006-07-31 18:55:56,2006-07-31 16:55:15
7f8508e8d320d768a34483682e9f2dc5af1af04b...3e04228b0c4bbb4b5cd46db9a714dfe699fa4cb8,1,7,8,15,7,2006-07-31 20:42:13,2006-07-31 20:13:55
b63fafdfd844c2037fba53b9944431c1378b4135...2608003f55ca3e02cfdcafbec54fdd325340a78e,1,4,0,4,1,2006-07-31 10:07:12,2006-07-31 10:07:12
b63fafdfd844c2037fba53b9944431c1378b4135...83c31614ceae2612b7cdba40e6401716fe854cd2,1,5,8,13,3,2006-07-31 07:15:59,2006-07-27 09:32:25
83c31614ceae2612b7cdba40e6401716fe854cd2...d587ed13bc37550a6d21067127f6c057c5d5e7fc,1,1,1,2,1,2006-07-31 07:15:59,2006-07-27 09:32:46
b63fafdfd844c2037fba53b9944431c1378b4135...16da134b1f9b0fbd1d328999875d34d02e5470b4,4,521,485,1006,86,2006-07-31 06:31:31,2006-07-30 18:25:18
16da134b1f9b0fbd1d328999875d34d02e5470b4...076b0adcf9dac7bd9d18624087f679cc811aeb77,3,410,397,807,12,2006-07-31 06:31:39,2006-07-30 18:26:15
b63fafdfd844c2037fba53b9944431c1378b4135...5be01bc8d5cf9c63827311ad76dd8b66353253e1,1,30,28,58,14,2006-07-31 01:21:28,2006-07-29 20:43:40
5be01bc8d5cf9c63827311ad76dd8b66353253e1...b9182987a80f7e820cbe1f8c7c4dc26f8586e8cd,1,27,24,51,23,2006-07-31 01:28:34,2006-07-31 01:28:34
b9182987a80f7e820cbe1f8c7c4dc26f8586e8cd...dda754f7d4fa1bccd9f3349d73304856144a7cd2,1,9,23,32,1,2006-07-31 01:30:10,2006-07-29 20:55:01
dda754f7d4fa1bccd9f3349d73304856144a7cd2...044bfdc8cbc4955f20afd7f9a245dfc20527ecbd,1,17,12,29,12,2006-07-31 01:34:47,2006-07-29 21:01:00
044bfdc8cbc4955f20afd7f9a245dfc20527ecbd...cefda27f741a948a78ce27180f5332c2d19199c4,1,2,2,4,2,2006-07-31 01:35:21,2006-07-30 02:08:17
cefda27f741a948a78ce27180f5332c2d19199c4...0881d2d1303a067a02e3811d43a1aed04a47945e,1,9,10,19,10,2006-07-31 01:37:29,2006-07-30 12:58:11
0881d2d1303a067a02e3811d43a1aed04a47945e...b18f9bf462cd37bc19368cb7d5c539e019d8fd67,1,34,0,34,1,2006-07-31 01:38:17,2006-07-30 12:59:57
b18f9bf462cd37bc19368cb7d5c539e019d8fd67...0d83ddc40f356aa0b5618a6571f5146818ec2b41,1,66,169,235,38,2006-07-31 01:39:36,2006-07-30 13:01:07
0d83ddc40f356aa0b5618a6571f5146818ec2b41...3dc1383290f9db3371a13ae8009ce4fcd5ffc93a,1,1,0,1,1,2006-07-31 01:40:15,2006-07-30 13:02:27
3dc1383290f9db3371a13ae8009ce4fcd5ffc93a...7d91010df4d8c3d6f38734dc37cf7013a490670e,1,1,1,2,1,2006-07-31 01:40:49,2006-07-30 15:47:22
7d91010df4d8c3d6f38734dc37cf7013a490670e...898a893fc9bd6510022e6248af39ca4f521e40d6,1,1,1,2,1,2006-07-31 01:41:00,2006-07-30 14:14:43
898a893fc9bd6510022e6248af39ca4f521e40d6...43ffc06d98e944670b71869ba7126003597a2fa0,1,32,36,68,3,2006-07-31 01:41:26,2006-07-30 15:49:00
43ffc06d98e944670b71869ba7126003597a2fa0...6855f42ecd8cfb77ec7494ac9eea9b1ef2d634a0,1,3,3,6,3,2006-07-31 01:41:41,2006-07-30 18:31:00
6855f42ecd8cfb77ec7494ac9eea9b1ef2d634a0...27fb8c40c6b634c67f5b5fb3b354a207cc10b343,1,40,60,100,25,2006-07-31 01:42:27,2006-07-30 18:32:01
27fb8c40c6b634c67f5b5fb3b354a207cc10b343...7ca84b506281495b9ec43801d08b7209b08be92d,1,1,0,1,1,2006-07-31 01:42:33,2006-07-30 20:36:04
7ca84b506281495b9ec43801d08b7209b08be92d...594e212bc849039a204deef1d16c2eddcc451532,1,22,31,53,12,2006-07-31 01:43:28,2006-07-31 00:21:52
594e212bc849039a204deef1d16c2eddcc451532...9f5dcb8168d5ea9f0169e11f017ecd9710d85797,2,184,209,393,20,2006-07-31 10:09:28,2006-07-31 09:22:13
9f5dcb8168d5ea9f0169e11f017ecd9710d85797...822c185907f27c02ce7791985ea9241e37041d5f,1,1,1,2,1,2006-07-31 19:08:29,2006-07-31 16:33:37
822c185907f27c02ce7791985ea9241e37041d5f...0349b4650969c9c59c58d99c95be3677f5bb2d15,1,1,1,2,1,2006-07-31 19:08:41,2006-07-31 18:58:00
0349b4650969c9c59c58d99c95be3677f5bb2d15...717b831178a6c0e86ed5e7cd61002bd9ec0c2a95,1,967,903,1870,86,2006-07-31 19:28:52,2006-07-31 19:22:15
717b831178a6c0e86ed5e7cd61002bd9ec0c2a95...8e85cdc4efd15fa70dfbbfebaf3ef9a758c2772c,1,25,56,81,3,2006-07-31 22:52:49,2006-07-31 21:46:25
8e85cdc4efd15fa70dfbbfebaf3ef9a758c2772c...7a13b999a5aa6de236c7b16139c765eb9e5cb3c4,1,8,16,24,3,2006-08-01 02:21:38,2006-08-01 02:18:34
7a13b999a5aa6de236c7b16139c765eb9e5cb3c4...b77aeb249a0ebdb8daa85ba58bbecde537f84025,1,1,1,2,1,2006-08-01 02:22:04,2006-08-01 02:12:18
b77aeb249a0ebdb8daa85ba58bbecde537f84025...46b059d718777ab146b8089afd3d2fcdd6000154,1,5,3,8,1,2006-08-01 02:24:37,2006-08-01 02:24:37
46b059d718777ab146b8089afd3d2fcdd6000154...498934a7e5410b815a9089c1b5205271d73e0f11,1,1,1,2,1,2006-08-01 02:36:50,2006-08-01 02:36:50
498934a7e5410b815a9089c1b5205271d73e0f11...5d1acf4da0d22d73c6b5d70887003d8fa7642ecc,1,3,3,6,3,2006-08-01 04:00:58,2006-08-01 04:00:16
5d1acf4da0d22d73c6b5d70887003d8fa7642ecc...6326b60cfd9c953e64ddab9659587afeedccd95b,1,35,22,57,15,2006-08-01 04:12:36,2006-08-01 00:59:12
6326b60cfd9c953e64ddab9659587afeedccd95b...5d043a3d856bd40d8b34b8836a561e438d23573b,3,47,10,57,12,2006-08-01 22:44:47,2006-08-01 19:34:08
5d043a3d856bd40d8b34b8836a561e438d23573b...281f2f6b45bf62e5bc81a6b457f1f7d26c426ea3,4,8,25,33,7,2006-08-01 22:55:19,2006-07-30 22:38:39
281f2f6b45bf62e5bc81a6b457f1f7d26c426ea3...ee0d3234b1e4e69819635d4fc9e9c37933c0ea82,1,5,1,6,2,2006-08-01 22:56:28,2006-08-01 22:56:28
ee0d3234b1e4e69819635d4fc9e9c37933c0ea82...22987ae0bc354bb2277c068ce15e9887f7cf0626,1,1,0,1,1,2006-08-01 23:23:47,2006-08-01 23:23:47
22987ae0bc354bb2277c068ce15e9887f7cf0626...c8d138a8c004ebce6ef840cfcc7c47227c2d16ba,2,14,7,21,6,2006-08-02 20:56:34,2006-08-02 19:23:34
c8d138a8c004ebce6ef840cfcc7c47227c2d16ba...bb55f77fcd0748e0faf152a565eef65b2066cfb4,2,6,1,7,2,2006-08-02 20:56:34,2006-08-02 20:29:36
bb55f77fcd0748e0faf152a565eef65b2066cfb4...06c084d28b150ac1e2ed0c6f3ce7db6ca42dfc67,2,18,18,36,10,2006-08-02 20:58:04,2006-08-02 20:50:20
06c084d28b150ac1e2ed0c6f3ce7db6ca42dfc67...f9f02d012927cba2264b948d16008ede025f7c71,1,6,3,9,2,2006-08-05 00:21:41,2006-08-04 22:14:27
f9f02d012927cba2264b948d16008ede025f7c71...154b4d78cf35025268ed74c45f182b25ebaf4acc,1,2,0,2,2,2006-08-06 08:52:51,2006-08-05 10:55:20
154b4d78cf35025268ed74c45f182b25ebaf4acc...cfd826693688245c6d8f48a5fdc1f6780ecca65b,1,2,2,4,2,2006-08-06 08:53:16,2006-08-05 10:56:04
cfd826693688245c6d8f48a5fdc1f6780ecca65b...623e4aeb42c313360d2c1edba7f844908882c2a1,1,1,1,2,1,2006-08-06 08:53:26,2006-08-05 10:56:42
623e4aeb42c313360d2c1edba7f844908882c2a1...dbd954a8969a31741a676e9e7cc2dfd00f8f4e93,1,5,16,21,11,2006-08-06 08:53:38,2006-08-05 10:58:06
dbd954a8969a31741a676e9e7cc2dfd00f8f4e93...e484a2d6ad26ff7a6ebe84085dda00591476014e,1,6,6,12,6,2006-08-06 08:53:54,2006-08-05 11:12:51
e484a2d6ad26ff7a6ebe84085dda00591476014e...cac4bd94fb6d5f3066614051827669476a9f0b56,1,46,46,92,45,2006-08-06 08:58:21,2006-08-05 11:13:53
cac4bd94fb6d5f3066614051827669476a9f0b56...e2860ead31579a15ee94831f2b9b55e43caa2cac,1,1,1,2,1,2006-08-06 08:59:36,2006-08-05 11:15:24
e2860ead31579a15ee94831f2b9b55e43caa2cac...668e34d7cc1ab7d6135f0004ee7bea2ffdca0de0,1,2,2,4,1,2006-08-06 08:59:45,2006-08-05 11:16:03
668e34d7cc1ab7d6135f0004ee7bea2ffdca0de0...10161355ba3b121c823649ef1acca526d73363f6,1,6,7,13,4,2006-08-06 09:00:32,2006-08-05 11:18:58
10161355ba3b121c823649ef1acca526d73363f6...f16db173a4680aebc2f14c103a1e125c3f4d4531,1,18,19,37,4,2006-08-06 09:00:32,2006-08-06 00:08:31
f16db173a4680aebc2f14c103a1e125c3f4d4531...403ccc4f36101ca5084e659a8c3c9911ccc91de8,1,1,0,1,1,2006-08-06 20:38:14,2006-08-06 10:47:33
403ccc4f36101ca5084e659a8c3c9911ccc91de8...bd943f4757ab1d62d862ea12b4cf8b6b495e115f,1,1,1,2,1,2006-08-06 20:40:19,2006-08-06 13:55:02
bd943f4757ab1d62d862ea12b4cf8b6b495e115f...b5ff2cf9a6a4246a5443e904acf3165e89654b1e,1,1,1,2,1,2006-08-06 20:41:49,2006-08-06 14:14:25
b5ff2cf9a6a4246a5443e904acf3165e89654b1e...e349d21ab47ae4a3753749c4579cce150c71c768,1,7,3,10,3,2006-08-06 20:42:39,2006-08-06 15:59:52
e349d21ab47ae4a3753749c4579cce150c71c768...1568515d5b8350a6087c0976c841387d71075c01,1,7,1,8,2,2006-08-06 20:42:41,2006-08-06 17:24:47
1568515d5b8350a6087c0976c841387d71075c01...dd04c428cfea1d9dd7684bbd9e2919fbad051b26,1,12,5,17,3,2006-08-06 20:50:43,2006-08-06 11:25:41
dd04c428cfea1d9dd7684bbd9e2919fbad051b26...f1efc38bf2856f875b878177c0f0a98d9eb3bb4e,1,0,2,2,2,2006-08-08 00:29:40,2006-08-07 23:15:05
c9c3470aec3a1d753ac1e5f21358f6374c1add95...96f1e58f524fac8607cfc38896b365b6e8365b51,42,163,163,326,91,2006-08-16 04:22:20,2006-08-15 17:23:48
96f1e58f524fac8607cfc38896b365b6e8365b51...19a8721ef8f82153fee93c62bd050659cf718d6d,2,14,2,16,4,2006-08-16 04:54:26,2006-08-15 21:03:17
19a8721ef8f82153fee93c62bd050659cf718d6d...06a9d86b49b826562e2b12b5c7e831e20b8f7dce,1,27,0,27,1,2006-08-16 04:55:17,2006-08-15 22:23:50
06a9d86b49b826562e2b12b5c7e831e20b8f7dce...1c2a4f5addce479c619057c6cdc841802139982f,1,84,87,171,64,2006-08-16 04:55:19,2006-08-15 22:24:30
1c2a4f5addce479c619057c6cdc841802139982f...e79ca7cc25755ac1a3be921f30630f4f064bf862,1,17,3,20,3,2006-08-16 20:37:40,2006-08-16 12:50:34
e79ca7cc25755ac1a3be921f30630f4f064bf862...6493cc09c2aa626ffbe6024dd705e1495c2d87e4,1,0,57,57,6,2006-08-16 20:58:32,2006-08-16 20:58:32
8e3abd4c97b8e7e1128ad0cc44dcc267f478659a...076a10c7282a08f783a28c1b64d0e114a3fe3d39,1,1,1,2,1,2006-08-17 02:18:27,2006-08-16 20:12:26
d4baf9eaf47ea1ba204f1ab5ecd22326913dd081...a89fccd28197fa179828c8596791ff16e2268d20,31,74,71,145,66,2006-08-17 21:23:53,2006-08-17 18:54:57
a89fccd28197fa179828c8596791ff16e2268d20...55c3eb434ab6d489c632263239be15a1054df7f2,1,6,6,12,2,2006-08-17 21:24:54,2006-08-17 18:44:16
55c3eb434ab6d489c632263239be15a1054df7f2...43134fcb350fb70d26634be163db1f71c14db19f,1,44,60,104,23,2006-08-21 02:14:56,2006-08-19 14:52:21
d4baf9eaf47ea1ba204f1ab5ecd22326913dd081...756d2f064b2419fcdf9cd9c851f352e2a4f75103,1,35,33,68,27,2006-08-17 10:04:46,2006-08-16 22:28:36
756d2f064b2419fcdf9cd9c851f352e2a4f75103...5c95fab017681f6ab21bf82c195bf0a3826fe014,1,11,5,16,5,2006-08-17 10:04:46,2006-08-16 22:28:38
5c95fab017681f6ab21bf82c195bf0a3826fe014...6132b7e4bbdbca14aff72d87784909810edefb82,1,1,1,2,1,2006-08-17 10:04:46,2006-08-16 22:28:39
6132b7e4bbdbca14aff72d87784909810edefb82...13d02165042c6139905dad38ee8324780d771d99,1,2,1,3,2,2006-08-17 10:04:46,2006-08-16 22:28:40
13d02165042c6139905dad38ee8324780d771d99...d16d093c2dcdd31b71b278591db18a9b0ccdbe90,1,67,65,132,5,2006-08-17 10:04:46,2006-08-17 09:21:23
d16d093c2dcdd31b71b278591db18a9b0ccdbe90...cb9c6e5b0a3772a979aff10f58a2b7fcd0fbe7d9,1,37,4,41,7,2006-08-17 17:41:58,2006-08-17 15:29:46
cb9c6e5b0a3772a979aff10f58a2b7fcd0fbe7d9...3899e7a329aabfc22eca9beb82599e1bb214b3d2,1,1,1,2,1,2006-08-17 21:30:21,2006-08-17 20:52:09
3899e7a329aabfc22eca9beb82599e1bb214b3d2...59fb1c944551083bbd4bccd1b5783488745f6bc4,1,14,8,22,8,2006-08-17 21:31:14,2006-08-17 17:39:29
59fb1c944551083bbd4bccd1b5783488745f6bc4...f0321866be971bf7dda2464d143e5a156182eba8,1,1,1,2,1,2006-08-18 05:58:05,2006-08-18 05:56:23
f0321866be971bf7dda2464d143e5a156182eba8...ddb8d900489216a0bf821a26901a21f89571a1c3,1,100,23,123,15,2006-08-20 22:51:59,2006-08-20 06:23:04
ddb8d900489216a0bf821a26901a21f89571a1c3...740e67f903ce738b25876f6d60faaff21f70fb4a,1,27,0,27,1,2006-08-21 21:33:54,2006-08-21 21:07:00
740e67f903ce738b25876f6d60faaff21f70fb4a...e8e41a9383ff8e1fb22a7abb899b16486ad25fe1,1,97,81,178,24,2006-08-21 21:33:55,2006-08-21 21:08:52
e8e41a9383ff8e1fb22a7abb899b16486ad25fe1...7c278014730dc15bf03b8640b1d406c657447092,2,7,4,11,4,2006-08-22 22:50:54,2006-08-22 10:02:48
7c278014730dc15bf03b8640b1d406c657447092...63e4220b75d4fd7c8820209193641f3207d24238,2,12,10,22,10,2006-08-22 22:51:01,2006-08-22 10:38:59
63e4220b75d4fd7c8820209193641f3207d24238...952c65fc0201c3d506f7c4d7377ec2d8bb346d4b,1,178,79,257,57,2006-08-22 22:51:45,2006-08-22 14:52:50
952c65fc0201c3d506f7c4d7377ec2d8bb346d4b...134a6941ec7f44b9deb2cbb51429ff6a47e0d08b,1,5,4,9,3,2006-08-22 23:05:09,2006-08-22 14:55:34
134a6941ec7f44b9deb2cbb51429ff6a47e0d08b...77a153fd92ae6e4e40e0ccb15c9f808d63e198a0,1,8,9,17,4,2006-08-22 23:06:31,2006-08-22 14:59:20
77a153fd92ae6e4e40e0ccb15c9f808d63e198a0...59b9f61a3f76762dc975e99cc05335a3b97ad1f9,1,44,31,75,7,2006-08-22 23:10:56,2006-08-22 21:42:53
59b9f61a3f76762dc975e99cc05335a3b97ad1f9...1149fecfc270a2effc344897989f40afe449a72c,1,1,1,2,1,2006-08-22 23:12:26,2006-08-22 17:05:24
1149fecfc270a2effc344897989f40afe449a72c...498fe00201401b766a200cf423a8ec42b5d5643e,1,12,10,22,4,2006-08-22 23:12:27,2006-08-22 17:05:25
498fe00201401b766a200cf423a8ec42b5d5643e...eee08903b2cb9cfaf9ee2cd69a255ace829ae7c5,1,201,122,323,14,2006-08-26 02:28:18,2006-08-23 22:15:14
eee08903b2cb9cfaf9ee2cd69a255ace829ae7c5...af33ef21bfb0171973393e21deac7621efd2ec7a,2,5,1,6,2,2006-08-26 02:29:36,2006-08-23 23:58:49
af33ef21bfb0171973393e21deac7621efd2ec7a...1613b79faa63e3d0c1add4facc286c18cf1204db,1,0,1,1,1,2006-08-26 02:34:26,2006-08-24 17:32:13
1613b79faa63e3d0c1add4facc286c18cf1204db...157e43b4b0dd5a08eb7a6838192ac58bca62fa5b,1,7,8,15,7,2006-08-26 02:38:30,2006-08-24 17:34:36
157e43b4b0dd5a08eb7a6838192ac58bca62fa5b...470b96d4837c5b019f15c8a5b013501724236de4,1,52,0,52,1,2006-08-26 02:39:34,2006-08-24 17:37:04
470b96d4837c5b019f15c8a5b013501724236de4...3066c359c63d1dc32db5147ebf015fe9bba4c5bb,1,2,3,5,3,2006-08-26 02:39:55,2006-08-24 17:39:32
3066c359c63d1dc32db5147ebf015fe9bba4c5bb...56a322f16113119bcc3770ef9565297ab59c29d2,1,16,0,16,1,2006-08-26 02:40:05,2006-08-24 17:41:23
56a322f16113119bcc3770ef9565297ab59c29d2...edf735abfad53a07ae91ca60576386f239bf7482,1,3,7,10,3,2006-08-26 02:40:10,2006-08-24 17:45:30
edf735abfad53a07ae91ca60576386f239bf7482...420e92f255982564a782b6ea8cd3c522f48c7d12,1,27,10,37,11,2006-08-26 02:40:25,2006-08-24 21:53:54
420e92f255982564a782b6ea8cd3c522f48c7d12...fe87585e53860f1c89a088e91c08dd89b6702a74,1,30,25,55,16,2006-08-26 02:41:05,2006-08-25 18:59:39
fe87585e53860f1c89a088e91c08dd89b6702a74...e4e4f825455f2903e4d015e51c09ec0527a0be86,2,19,1,20,4,2006-08-26 02:41:09,2006-08-25 19:04:13
e4e4f825455f2903e4d015e51c09ec0527a0be86...ef10ee877f6d4db4c9bc65d0e36b3670f0fe114e,2,20,4,24,4,2006-08-26 02:41:12,2006-08-25 19:05:07
ef10ee877f6d4db4c9bc65d0e36b3670f0fe114e...c2c8ff24380efe0149815fc014445e31f81c3403,1,7,7,14,3,2006-08-26 02:41:15,2006-08-25 19:05:45
c2c8ff24380efe0149815fc014445e31f81c3403...990dd0de51530a47f4c8fad961268d4b8545a7be,1,2,4,6,1,2006-08-26 02:41:18,2006-08-25 19:06:49
990dd0de51530a47f4c8fad961268d4b8545a7be...7c5e2ebb5d8ca3d8428e19593c69a4f329d64855,1,132,17,149,6,2006-08-26 02:42:07,2006-08-25 19:13:34
7c5e2ebb5d8ca3d8428e19593c69a4f329d64855...9b71b1f6b3b57b3771151d252a5e22886524a154,1,68,25,93,10,2006-08-26 02:42:24,2006-08-25 19:14:49
9b71b1f6b3b57b3771151d252a5e22886524a154...8cce8e3ddb2c2f7e0ab028012ae4dc729c8bf3f9,1,0,71,71,1,2006-08-26 02:42:33,2006-08-25 19:15:27
8cce8e3ddb2c2f7e0ab028012ae4dc729c8bf3f9...903acca75329841996bbf0c3a32a7cfeb3ae0d0f,1,0,6,6,2,2006-08-26 02:42:34,2006-08-25 19:35:27
808239a7db1b4c04c5a9edcf9ee33ff33217fad2...c774b2dcf6c16a408757e9da1bf7c006528fc6a6,1,4,0,4,1,2006-09-20 14:53:43,2006-09-19 12:20:19
c774b2dcf6c16a408757e9da1bf7c006528fc6a6...8059319acc3638c8398d1bd34f647a2b28f48d5c,1,1,1,2,1,2006-09-20 14:54:29,2006-09-19 11:57:03
8059319acc3638c8398d1bd34f647a2b28f48d5c...45ad9b5096b5b823f8cec562500dc8830d5961b5,1,28,28,56,16,2006-09-20 15:36:12,2006-09-20 10:15:39
45ad9b5096b5b823f8cec562500dc8830d5961b5...44d2775a98c14daa77baa66b039080acad5efa0c,1,9,0,9,2,2006-09-20 16:00:14,2006-09-20 10:23:41
44d2775a98c14daa77baa66b039080acad5efa0c...cd90e75ff4a9b01a9cf59505d8d10d79fd1071ca,1,20,9,29,6,2006-09-20 16:49:31,2006-09-19 22:49:51
cd90e75ff4a9b01a9cf59505d8d10d79fd1071ca...d04d3d424b913332f5c400162f0d87faac1ad3ea,1,4,0,4,1,2006-09-20 16:49:39,2006-09-19 19:53:22
d04d3d424b913332f5c400162f0d87faac1ad3ea...9704d75ddc3e38f4945e23f5afffb849fb51b09f,1,2,8,10,2,2006-09-20 17:24:44,2006-09-19 12:31:49
9704d75ddc3e38f4945e23f5afffb849fb51b09f...120ddde2a843e923944abd5d6e61f8625e820e92,1,42,24,66,13,2006-09-20 17:26:05,2006-09-19 12:33:22
120ddde2a843e923944abd5d6e61f8625e820e92...62e27f273d66afa996cb7aee6cdb25fbedc053f6,1,2,2,4,2,2006-09-20 17:26:08,2006-09-19 18:47:27
808239a7db1b4c04c5a9edcf9ee33ff33217fad2...e1e22e37f47e3f4d741d28920e1d27e3775c31ad,5,217,53,270,16,2006-09-18 02:09:11,2006-09-11 23:37:32
e1e22e37f47e3f4d741d28920e1d27e3775c31ad...b37a562a1097af7403c649a5f903a93acaf279e8,1,6,0,6,1,2006-09-18 02:09:11,2006-09-12 03:10:15
b37a562a1097af7403c649a5f903a93acaf279e8...ed378ec7e85fd2c5cfcc7bd64b454236357fdd97,7,74,84,158,50,2006-09-18 02:09:11,2006-09-12 03:17:35
ed378ec7e85fd2c5cfcc7bd64b454236357fdd97...434cd0cd30d17bc703397a76480fdd129cecc064,3,25,22,47,13,2006-09-18 02:09:12,2006-09-14 17:14:47
434cd0cd30d17bc703397a76480fdd129cecc064...ef176ad06afde424b2167da290a0fdd7fb8ca3d4,1,2,5,7,1,2006-09-18 02:09:12,2006-09-16 20:46:00
ef176ad06afde424b2167da290a0fdd7fb8ca3d4...f62363fb02865967e5efd17de1a09de6e02f3e3f,1,2,4,6,1,2006-09-18 02:13:56,2006-09-18 02:13:56
f62363fb02865967e5efd17de1a09de6e02f3e3f...b3dc864c6d5ffb96513328f976c076c3a90331b0,1,1,0,1,1,2006-09-18 07:34:38,2006-09-18 07:34:38
b3dc864c6d5ffb96513328f976c076c3a90331b0...5b10b091139ea5ef87376998c89f3a20dd7c7793,1,4,6,10,4,2006-09-18 08:08:00,2006-09-18 08:08:00
5b10b091139ea5ef87376998c89f3a20dd7c7793...53cce84c05d3cba237ab45540b1e882be9c97215,1,4,2,6,2,2006-09-20 14:56:03,2006-09-19 20:58:23
53cce84c05d3cba237ab45540b1e882be9c97215...cc4c4f0ce25cc3803197bc19c275fd6f59a2a511,1,1,1,2,1,2006-09-21 04:10:17,2006-09-21 04:10:17
cc4c4f0ce25cc3803197bc19c275fd6f59a2a511...cb5d709ff8a4bae19d57a470ba2b137c25938a44,18,79,71,150,68,2006-09-21 04:47:42,2006-09-21 04:47:42
cb5d709ff8a4bae19d57a470ba2b137c25938a44...8da197755450d4f16018bd4b5486dc8ed88b0f2a,23,75,49,124,56,2006-09-21 05:02:01,2006-09-21 05:02:01
8da197755450d4f16018bd4b5486dc8ed88b0f2a...13e4aa90acad5738f54385c8a336f89fb6aacdd0,1,3,1,4,1,2006-09-21 07:06:50,2006-09-21 07:06:05
13e4aa90acad5738f54385c8a336f89fb6aacdd0...968846015229fe0fec28e3c85db722e131c15f93,1,75,9,84,9,2006-09-21 07:06:54,2006-09-21 07:06:06
671bc1538a88d82096a8e59d9ccef4f4a5c40a32...712fcc08c7a2d338f9480033597ad62223c657ec,1,88,54,142,17,2005-11-29 22:28:16,2005-11-29 22:28:16
56fc63193975edd4b9f520b6c65c2b97ecd8ee38...55d1eb047d4dffc633502ea2a80dd092194fc900,1,32,21,53,21,2005-11-27 22:42:51,2005-11-27 22:29:30
55d1eb047d4dffc633502ea2a80dd092194fc900...4e72dcec89c7cda7022d4ec2dd686e77deb5376e,3,9,0,9,3,2005-11-28 00:09:40,2005-11-28 00:09:40
4e72dcec89c7cda7022d4ec2dd686e77deb5376e...650e4be59b9f385f56e5829d97d09e8440f174b8,1,35,24,59,8,2005-11-28 00:26:50,2005-11-28 00:22:16
650e4be59b9f385f56e5829d97d09e8440f174b8...f1f909e3185b5ee366e198042447afe749bfc813,1,9,8,17,6,2005-11-28 00:29:38,2005-11-28 00:29:38
f1f909e3185b5ee366e198042447afe749bfc813...9f63892b3803701c97259d51143e199fe9603d3f,2,12,5,17,5,2005-11-28 09:29:52,2005-11-28 09:29:52
9f63892b3803701c97259d51143e199fe9603d3f...0dccc7dceef03e4231b24c9e126110b338e1c1e1,1,1,1,2,1,2005-11-28 09:46:15,2005-11-28 09:46:15
0dccc7dceef03e4231b24c9e126110b338e1c1e1...90109b320d45520cf5721de08d761ad06c0445ab,1,1,1,2,1,2005-11-28 10:54:05,2005-11-28 10:54:05
2a1ddc58e4d2220feea7eba4623dac07a0f83f94...ab5f86275c070331c308a133afa3a648b347c062,1,1,2,3,1,2005-11-26 04:57:02,2005-11-26 04:57:02
ab5f86275c070331c308a133afa3a648b347c062...f359ae42ac102ef98d5708f1dc8b06e6af2701c1,1,22,9,31,3,2005-11-26 06:19:23,2005-11-23 10:19:41
f359ae42ac102ef98d5708f1dc8b06e6af2701c1...2d76d0d151239538c43b61572283405b10df43ac,1,3,4,7,1,2005-11-26 07:36:58,2005-11-26 07:36:58
2d76d0d151239538c43b61572283405b10df43ac...51b3c00e9d95371a9ad202204f01c5981f241b20,1,2,2,4,2,2005-11-26 20:09:07,2005-11-26 20:09:07
51b3c00e9d95371a9ad202204f01c5981f241b20...ab9cb76f661c1794800361c27bc5a515245aaaef,3,22,0,22,4,2005-11-27 09:32:59,2005-11-25 23:59:09
ab9cb76f661c1794800361c27bc5a515245aaaef...1644162ad53da1d0107c5c45c866e75ef95660bb,1,1,0,1,1,2005-11-27 09:32:59,2005-11-25 18:48:26
1644162ad53da1d0107c5c45c866e75ef95660bb...4f629539cd99fb9fc68dbdc56812f291565d0f87,3,64,42,106,17,2005-11-27 09:32:59,2005-11-26 00:03:56
4f629539cd99fb9fc68dbdc56812f291565d0f87...22752e4c43e1bc864eaf1c2c015031a2b5e98a3b,1,1,0,1,1,2005-11-27 09:32:59,2005-11-26 00:08:48
22752e4c43e1bc864eaf1c2c015031a2b5e98a3b...3ae64dff6894adc995c913aaf7fe2d65c78c3529,1,19,27,46,12,2005-11-27 22:40:28,2005-11-27 20:58:52
3ae64dff6894adc995c913aaf7fe2d65c78c3529...f6bc189a457b2575587f26e27f1eabdd615b2d78,1,10,2,12,3,2005-11-27 22:40:28,2005-11-27 21:04:14
f6bc189a457b2575587f26e27f1eabdd615b2d78...ca203ee7db708baa278950501f8d01f29c5190be,1,1,1,2,1,2005-11-27 22:40:29,2005-11-27 21:06:42
ca203ee7db708baa278950501f8d01f29c5190be...b933e818e951c290e8355ae544567bba949f392e,1,4,4,8,3,2005-11-27 22:40:29,2005-11-27 21:08:33
b933e818e951c290e8355ae544567bba949f392e...26169747b811b8ecd5693adfce4f5c7e322d2487,1,5,0,5,1,2005-11-27 22:40:29,2005-11-27 21:11:33
bd66361195c5503261a2d1eef6aa685deb058ffb...710c97dbb1a4469816ae01f4a26661cdba2c401b,2,6,1,7,2,2005-11-01 22:03:13,2005-11-01 22:03:13
710c97dbb1a4469816ae01f4a26661cdba2c401b...77ab8798d3f8df39877235be17bb6e70077aaba2,2,3,3,6,2,2005-11-01 22:05:12,2005-11-01 18:56:03
77ab8798d3f8df39877235be17bb6e70077aaba2...4f9dcf7e5cf6c82455925102d315daf3b833e6d6,1,0,44,44,44,2005-11-01 22:45:48,2005-11-01 20:22:22
4f9dcf7e5cf6c82455925102d315daf3b833e6d6...e3a39000e295e4bd6faff97decc31e6cb4520bb1,2,1,95,96,2,2005-11-01 22:45:48,2005-11-01 20:26:03
e3a39000e295e4bd6faff97decc31e6cb4520bb1...3c64314c4b1f90488391a0ffea2a4ed04c8f6b79,2,49,0,49,3,2005-11-01 22:45:49,2005-11-01 20:45:55
3c64314c4b1f90488391a0ffea2a4ed04c8f6b79...085c1e2212e1adef2e8c72a28641bc4a8314a4e6,1,0,2,2,1,2005-11-01 22:45:49,2005-11-01 20:47:10
085c1e2212e1adef2e8c72a28641bc4a8314a4e6...f676fa76e26faed3ac02a9dae8f9f7addb9542a4,1,2,0,2,1,2005-11-01 22:45:49,2005-11-01 22:46:27
f676fa76e26faed3ac02a9dae8f9f7addb9542a4...319f8b3da6858f78282de9483be7b27b4bb1ffba,2,12,5,17,3,2005-11-02 00:46:38,2005-11-02 00:46:38
319f8b3da6858f78282de9483be7b27b4bb1ffba...d44e8cf0298a794648271cbff2f74a0063a672b3,1,4,0,4,1,2005-11-02 00:57:14,2005-11-02 00:48:22
d44e8cf0298a794648271cbff2f74a0063a672b3...211dcac6430cdf77fcf2a968ffaf9313b5c059b0,2,12,4,16,4,2005-11-02 00:57:38,2005-11-02 00:48:47
211dcac6430cdf77fcf2a968ffaf9313b5c059b0...9acb552d984f172f00bbb79888f4bdeb0032332f,1,1,0,1,1,2005-11-02 00:57:53,2005-11-02 00:53:23
9acb552d984f172f00bbb79888f4bdeb0032332f...8e6ae4ad5ff14a6fd958ada867e24f8d248aac58,1,1,1,2,1,2005-11-02 01:07:21,2005-11-02 01:07:21
300b4801b75a59961e66ad9fa96941e46fd76be5...2f29dd521832540450610893319561a5a136b3fb,1,33,33,66,12,2005-09-30 17:46:25,2005-09-30 17:46:25
2f29dd521832540450610893319561a5a136b3fb...d6b89e7bf882648c23bd7fd4598696087487329d,1,0,1,1,1,2005-09-30 17:46:42,2005-09-30 17:46:42
d6b89e7bf882648c23bd7fd4598696087487329d...1b4713fb9e6ec614e8dbca90b1a57d5ffa2f3fde,1,2,6,8,2,2005-09-30 17:47:50,2005-09-30 17:47:50
1b4713fb9e6ec614e8dbca90b1a57d5ffa2f3fde...7626e49e9f04ac386965d16ae11e130e20ebd518,1,1,1,2,1,2005-09-30 17:48:21,2005-09-30 17:48:21
7626e49e9f04ac386965d16ae11e130e20ebd518...9220282a9c6fae98d326bd10e4f427f1692b71ed,1,2,2,4,2,2005-09-30 18:01:57,2005-09-30 18:01:57
9220282a9c6fae98d326bd10e4f427f1692b71ed...039c6f162a63e9d91f360e2e6138e21a4015c543,2,13,6,19,2,2005-09-30 18:02:26,2005-09-30 18:02:26
894a8a8b1b935639ac2ea503e8fa2887fd6bd44b...88cd621deedd2aab8f0a4c6ea3afed7269e66d0c,4,4,3,7,5,2005-10-01 05:12:01,2005-09-30 21:02:47
88cd621deedd2aab8f0a4c6ea3afed7269e66d0c...1fea629f794cda57cc161979dab903ec7460cc7c,1,13,0,13,2,2005-10-01 06:52:48,2005-10-01 06:25:23
1fea629f794cda57cc161979dab903ec7460cc7c...f8d839ad992d92e1e31d7a557c198371d1fb7692,2,2,2,4,2,2005-10-01 18:58:43,2005-10-01 18:58:43
f8d839ad992d92e1e31d7a557c198371d1fb7692...38ec15a973a1f075f0d94d130b0ef279562921cd,1,2,0,2,1,2005-10-02 06:14:06,2005-10-01 19:01:07
38ec15a973a1f075f0d94d130b0ef279562921cd...37f15d50c93398eac90370cfe07315905501bdad,1,7,1,8,3,2005-10-02 06:14:48,2005-09-30 07:15:12
37f15d50c93398eac90370cfe07315905501bdad...94c23343dce0f556392fe8bbbba1b38cd37da481,1,11,7,18,5,2005-10-02 06:15:23,2005-09-30 08:48:57
94c23343dce0f556392fe8bbbba1b38cd37da481...49a0f240f7be05728f97903efd97ad7898ff6d08,1,161,23,184,18,2005-10-02 06:17:14,2005-09-28 17:14:04
49a0f240f7be05728f97903efd97ad7898ff6d08...271421cd345a9b5e2fc7e30e672d2c998f50e1dc,1,11,4,15,4,2005-10-02 06:17:14,2005-09-30 07:07:39
271421cd345a9b5e2fc7e30e672d2c998f50e1dc...4fa2197e614950279527b14825d1e9572454a48c,1,0,1,1,1,2005-10-02 06:17:15,2005-09-30 23:27:47
4fa2197e614950279527b14825d1e9572454a48c...ed1aadf1b0cb4afc7cb0aaf4cec4f5ad84e3307d,1,24,1,25,3,2005-10-02 06:18:38,2005-09-29 21:35:15
ed1aadf1b0cb4afc7cb0aaf4cec4f5ad84e3307d...9b143c6e155a8eead165b2a813b533e0f3e0018a,1,14,1,15,2,2005-10-02 06:19:32,2005-09-26 02:30:24
9b143c6e155a8eead165b2a813b533e0f3e0018a...ca8db1424d1808a1f78bc9905efd267f7c154d8e,3,42,49,91,14,2005-10-02 06:19:32,2005-09-25 16:59:37
ca8db1424d1808a1f78bc9905efd267f7c154d8e...a876ed83be5467d6075da8a16306724cb1babc2a,3,64,88,152,11,2005-10-02 06:19:33,2005-09-30 21:08:25
a876ed83be5467d6075da8a16306724cb1babc2a...8098a178b26dc7a158d129a092a5b78da6d12b72,16,176,57,233,34,2005-10-02 06:19:33,2005-09-30 21:26:57
8098a178b26dc7a158d129a092a5b78da6d12b72...455a7f3275d264f6e66045b92c83747ec461dda5,4,34,22,56,10,2005-10-02 06:19:48,2005-09-30 20:31:16
455a7f3275d264f6e66045b92c83747ec461dda5...5d1a5c02e8ac1c16688ea4a44512245f25a49f8a,4,24,12,36,13,2005-10-02 06:55:47,2005-10-01 20:24:27
5d1a5c02e8ac1c16688ea4a44512245f25a49f8a...5cd5ace72bf8944c920a20a7b98c82f7ed663d8a,1,5,3,8,1,2005-10-02 06:56:16,2005-10-01 20:39:47
5cd5ace72bf8944c920a20a7b98c82f7ed663d8a...18c5a52537173b12bd78ce25c6dd524d147e87a7,1,4,0,4,1,2005-10-02 07:00:53,2005-10-01 06:23:26
18c5a52537173b12bd78ce25c6dd524d147e87a7...0842acff57f386ba749c3ea6b5e034771f074f6b,2,50,12,62,6,2005-10-02 07:20:45,2005-10-02 07:20:45
0842acff57f386ba749c3ea6b5e034771f074f6b...7dd43575f8641c8a73b1e976715056ebdc773904,1,2,8,10,4,2005-10-02 07:50:16,2005-10-02 07:50:16
7dd43575f8641c8a73b1e976715056ebdc773904...af215114f52af0f308ef19f67e544df8ea5e4ac2,1,601,185,786,62,2005-10-02 17:03:00,2005-10-02 15:43:07
af215114f52af0f308ef19f67e544df8ea5e4ac2...500b97e4bb184c954a52550843e6314ecf97a208,3,82,2,84,5,2005-10-02 17:31:18,2005-10-02 15:33:38
500b97e4bb184c954a52550843e6314ecf97a208...23822a355de674f1d1321ad7e112f0fe40124aca,1,12,0,12,4,2005-10-02 17:42:46,2005-09-29 15:16:12
23822a355de674f1d1321ad7e112f0fe40124aca...f9d72413bcbf33ced45f12e17ef156abd73963f6,1,21,1,22,2,2005-10-02 18:13:44,2005-10-02 18:13:44
f9d72413bcbf33ced45f12e17ef156abd73963f6...a2775c2a410be4bec1e29ae78bccd3247829e2be,1,14,1,15,4,2005-10-02 23:06:08,2005-10-02 19:42:57
a2775c2a410be4bec1e29ae78bccd3247829e2be...91dd674e30ba0298e89c9be2657024805170c2ac,2,7,1,8,2,2005-10-02 23:07:29,2005-10-02 19:56:31
52be5fcd29e074cb549b9a92ff8caceb736e4851...8de8a292eb2460ff5166854875083ac1ac657add,1,1,0,1,1,2005-09-05 06:32:56,2005-09-05 06:30:08
8de8a292eb2460ff5166854875083ac1ac657add...1f038a0c31e06e7a248be0990549ac717399c540,1,81,5,86,17,2005-09-05 06:33:17,2005-09-05 05:13:07
1f038a0c31e06e7a248be0990549ac717399c540...f9e320c319a36a548fd239a272a02ffd52877c75,1,9,4,13,3,2005-09-05 06:33:19,2005-09-05 05:13:07
f9e320c319a36a548fd239a272a02ffd52877c75...0516de30e8bdd26086e2a3edd3375981fd0c34d6,5,43,102,145,6,2005-09-05 07:47:39,2005-09-05 07:47:39
0d6a873cfe4ba9428cf361c633faf701cadc04b8...ccf1ee327f9a7d51704578fa41ba255abfd3a730,1,20,1,21,4,2005-08-24 17:40:58,2005-08-24 17:40:58
ccf1ee327f9a7d51704578fa41ba255abfd3a730...4866ccf0f434db118c4dcdeeab840eb4844d50a4,1,54,67,121,33,2005-08-24 21:30:04,2005-08-24 21:30:04
4866ccf0f434db118c4dcdeeab840eb4844d50a4...ff84d327dfb8a9aa0634b0aaaca1c018cdc5117a,5,7,7,14,6,2005-08-24 21:31:36,2005-08-24 21:31:36
ff84d327dfb8a9aa0634b0aaaca1c018cdc5117a...d998a0895fc20c03007d8b2a74b78b37e1cdfaba,1,8,8,16,9,2005-08-24 23:50:16,2005-08-24 21:58:42
d998a0895fc20c03007d8b2a74b78b37e1cdfaba...ac4b0cff00b7629657e61a1d6e1f1a1250d03198,3,151,23,174,5,2005-08-24 23:50:49,2005-08-20 09:52:24
ac4b0cff00b7629657e61a1d6e1f1a1250d03198...853a3697dc2bc609650c38ed03a1f8fa9f145f97,1,147,42,189,10,2005-08-24 23:50:50,2005-08-20 09:54:34
853a3697dc2bc609650c38ed03a1f8fa9f145f97...e0bfc81e05e57679916ab070c8fb2525f24771d4,4,12,87,99,6,2005-08-24 23:50:50,2005-08-20 09:57:26
e0bfc81e05e57679916ab070c8fb2525f24771d4...d9f3be7e2e4c9b402bbe6ee6e2b39b2ee89132cf,2,104,0,104,2,2005-08-24 23:50:51,2005-08-20 09:58:42
d9f3be7e2e4c9b402bbe6ee6e2b39b2ee89132cf...92c533ef0ea2cb43f0d7d493f006f5b4dfa7cda1,1,4,1,5,1,2005-08-24 23:50:51,2005-08-20 10:00:03
92c533ef0ea2cb43f0d7d493f006f5b4dfa7cda1...6687f8fea22e1e43ab163a8fe180155a0a0a956a,2,6,3,9,2,2005-08-24 23:50:52,2005-08-20 10:05:42
6687f8fea22e1e43ab163a8fe180155a0a0a956a...ae2da40690a3f3f101de5780a7799781b09e2e05,1,37,8,45,7,2005-08-24 23:50:52,2005-08-23 04:28:33
ae2da40690a3f3f101de5780a7799781b09e2e05...521003ff52d1cf742350e1342bc2dd4ab1b51e6b,1,12,2,14,3,2005-08-24 23:50:52,2005-08-23 04:57:59
521003ff52d1cf742350e1342bc2dd4ab1b51e6b...efe9bf0f3b34d12b3b76f8277550f91700609b25,2,26,7,33,10,2005-08-24 23:50:53,2005-08-23 05:52:43
efe9bf0f3b34d12b3b76f8277550f91700609b25...ff27adf3dae36695f1af1b6f0e01ec6738ce0249,3,24,6,30,11,2005-08-24 23:50:53,2005-08-24 07:40:14
ff27adf3dae36695f1af1b6f0e01ec6738ce0249...ab9b31386b494b6c16d651d1560f3ba11c3a1964,8,170,63,233,30,2005-08-24 23:50:54,2005-08-24 23:23:08
ab9b31386b494b6c16d651d1560f3ba11c3a1964...c95173410d6f290e65c15232e56f4963f8279ef1,1,53,20,73,7,2005-08-24 23:50:55,2005-08-24 23:46:11
10d781b9caa4f71495c7b34963bef137216f86a8...2c04662d89eaa55cecb6effd743c17051d1458ec,5,8,8,16,8,2005-08-29 19:41:03,2005-08-29 19:41:03
cdc0c0f52075e67be432807add1879a0799df583...d7d2c87955f7700289c5b516f12579a5be4b879d,3,21,2,23,4,2013-11-08 20:06:19,2013-11-08 20:06:19
59556548230e617b837343c2c07e357e688e2ca4...666c90b6290dae0f4d3672a2b0caf6dea67dd1e3,2,0,20,20,4,2013-12-05 22:13:56,2013-12-01 07:49:18
c939d241673ad093336e936075a029127368d87e...85176d725134446ca2b8585d85f8fbd2daf45515,1,4,0,4,1,2013-11-18 21:45:56,2013-11-18 04:12:43
85176d725134446ca2b8585d85f8fbd2daf45515...d3243d738ddcf1a9cf6c8bd63f66c57080f1040b,2,4,2,6,2,2013-11-18 21:45:57,2013-11-18 04:12:44
d3243d738ddcf1a9cf6c8bd63f66c57080f1040b...4945725c647a513326c3ce31dd99b91eefd97ede,1,1,1,2,1,2013-11-18 21:45:57,2013-11-18 04:12:45
4945725c647a513326c3ce31dd99b91eefd97ede...5105edd411bc472015d63eadaf1f826bebdc92e5,1,2,2,4,2,2013-11-18 21:45:58,2013-11-18 04:12:46
5105edd411bc472015d63eadaf1f826bebdc92e5...25607db2c30c618a18f66350f01b1ccb05c551c6,1,1,1,2,1,2013-11-18 21:45:58,2013-11-18 04:12:47
25607db2c30c618a18f66350f01b1ccb05c551c6...962df3dab78a2f5f583f096814ae952fc4426498,1,9,9,18,1,2013-11-18 21:45:59,2013-11-18 04:12:48
962df3dab78a2f5f583f096814ae952fc4426498...b2bff43170d052cf3a0ecc69dd03c0467b5782d0,1,10,10,20,1,2013-11-18 21:45:59,2013-11-18 04:12:49
b2bff43170d052cf3a0ecc69dd03c0467b5782d0...6c68a404e6e9eec850b298f98fa30c5a25aa846e,3,8,9,17,5,2013-11-18 21:46:00,2013-11-18 04:12:50
03973056a08d1694cf1c819eb2e8b9557650f70e...569fb49fce19cf1dc80e7d99d8a4267827f28da3,1,84,82,166,58,2013-11-18 22:35:55,2013-11-14 17:01:13
03973056a08d1694cf1c819eb2e8b9557650f70e...07981dce81eefd3d1e8966dfe27902dd339d276a,2,12,2,14,4,2013-11-18 22:30:11,2013-11-18 22:23:11
07981dce81eefd3d1e8966dfe27902dd339d276a...0386dd37b1999ec9d531583f5b77eec0245de3a7,1,4,1,5,3,2013-11-18 22:30:23,2013-11-15 21:10:28
6d8940b562adc5e43068868109dffe1b9bff7f78...0df49bef95fe1668805cdb76abadfb82a8956b6b,1,0,4,4,1,2014-01-10 23:30:45,2014-01-10 20:10:31
da139813a7242f96e6926fd15881b9df94625132...db4b65821e65138177de9afbce70f141cc831224,2,55,5,60,9,2005-08-17 21:53:39,2005-08-16 10:35:27
db4b65821e65138177de9afbce70f141cc831224...049f28c3929fa722634ecb7bb39d78457018815a,1,1,1,2,1,2005-08-17 21:53:39,2005-08-16 21:27:09
049f28c3929fa722634ecb7bb39d78457018815a...828cc617c1908a16b36734f62bb10299c2cfba6f,2,2,1,3,2,2005-08-17 21:53:39,2005-08-17 20:31:49
828cc617c1908a16b36734f62bb10299c2cfba6f...cfb0af1d50247e66ea1d46014650e60e9cfb87b9,1,2,0,2,2,2005-08-17 21:53:40,2005-08-17 20:32:22
cfb0af1d50247e66ea1d46014650e60e9cfb87b9...6a0049c07623a387bf7f7e7c90b71344c23decfa,1,4,2,6,2,2005-08-17 22:17:03,2005-08-17 22:17:03
6a0049c07623a387bf7f7e7c90b71344c23decfa...0f87f893657129907ff966f44aed7c7624d7ba1b,1,5,1,6,1,2005-08-17 22:18:41,2005-08-17 22:18:41
0f87f893657129907ff966f44aed7c7624d7ba1b...99a92f928fd02a87d841a8bb19511e7ce526819d,1,10,7,17,3,2005-08-17 22:19:57,2005-08-17 22:19:57
89c0aac44034ec04f9d5abffc15f91f1797f5cee...839f7f8eed3bbb757dbbb6c2ef1a838974aa4bc8,1,399,345,744,294,2012-05-01 23:46:35,2012-04-28 08:28:03
8426f672fc65239135b1f1580bb79ecb16fd05f0...e984c54ada086e7676419b6b1b8a2d7a2429da48,1,74,33,107,8,2009-09-18 23:32:33,2009-09-17 07:33:19
8426f672fc65239135b1f1580bb79ecb16fd05f0...e481b1d8db9947681a5c124545ef06951f42155d,1,1,0,1,1,2009-09-17 07:38:49,2009-09-17 07:21:02
e481b1d8db9947681a5c124545ef06951f42155d...1f986c4ac4df6fcac4b19bc9cd3a8b6c8f0ffdea,1,7,3,10,3,2009-09-19 02:47:15,2009-09-17 17:20:53
1f986c4ac4df6fcac4b19bc9cd3a8b6c8f0ffdea...812bdbc31b246fcd5f3293e4dbac27eaec1ef4fa,1,9,9,18,1,2009-09-19 02:48:48,2009-09-18 19:11:52
812bdbc31b246fcd5f3293e4dbac27eaec1ef4fa...0d30ad71fa094dd89ae31b3381c2e63a41119c76,3,14,5,19,12,2009-09-19 03:00:41,2009-09-16 08:20:17
0d30ad71fa094dd89ae31b3381c2e63a41119c76...627735f9bf322c5c964b396f4a55d14e18d34aa2,1,5,0,5,2,2009-09-19 03:00:42,2009-09-16 08:20:18
627735f9bf322c5c964b396f4a55d14e18d34aa2...3f83bf3784d49e162532212230a271a8cc8edbf0,1,2,5,7,1,2009-09-19 03:00:42,2009-09-16 08:20:19
3f83bf3784d49e162532212230a271a8cc8edbf0...a6ca8c62467570d5d227eba4f2b838ce4b9940e8,2,5,2,7,3,2009-09-19 03:00:42,2009-09-16 08:20:20
a6ca8c62467570d5d227eba4f2b838ce4b9940e8...d7fa500fb598d725bda3427535e87f06caf93ee8,2,3,3,6,3,2009-09-19 03:00:42,2009-09-16 08:20:21
d7fa500fb598d725bda3427535e87f06caf93ee8...71064e3f86fbf2eb5c2b55a3024051f9542ae229,6,15,13,28,11,2009-09-19 03:00:42,2009-09-16 08:20:22
71064e3f86fbf2eb5c2b55a3024051f9542ae229...55fcb06482c9971d95f3575274a8617c0d9f5d92,14,14,0,14,14,2009-09-19 03:00:42,2009-09-16 08:20:23
55fcb06482c9971d95f3575274a8617c0d9f5d92...16fe1e03694e75a3923c3a757ec946aa6098aec7,5,256,0,256,5,2009-09-19 03:00:42,2009-09-16 08:20:24
16fe1e03694e75a3923c3a757ec946aa6098aec7...d75f8e61315cc502c34aec6600db00a7c7192ffd,3,93,0,93,3,2009-09-19 03:00:42,2009-09-16 08:20:25
d75f8e61315cc502c34aec6600db00a7c7192ffd...435bdf8c7ffa493f8f6f2e8f329f8cc22db16ce6,7,13,12,25,9,2009-09-19 03:00:42,2009-09-16 08:20:26
435bdf8c7ffa493f8f6f2e8f329f8cc22db16ce6...386ac45102df71e186d4de62b63a41ae35e71089,1,2,0,2,1,2009-09-19 03:00:42,2009-09-16 08:20:27
386ac45102df71e186d4de62b63a41ae35e71089...164a5e3faab931a6c6459b56acae7f91dde6337d,3,128,1,129,5,2009-09-19 03:00:42,2009-09-16 08:20:28
164a5e3faab931a6c6459b56acae7f91dde6337d...a2c6bf0e7661a4e6eafe7810cca1cd08187d311f,1,39,0,39,1,2009-09-19 03:00:42,2009-09-16 08:20:29
a2c6bf0e7661a4e6eafe7810cca1cd08187d311f...259d87c354954e8ee3b241dce1393c27186e8ee7,8,1503,1,1504,9,2009-09-19 03:00:42,2009-09-16 08:20:30
259d87c354954e8ee3b241dce1393c27186e8ee7...f5c3178151e3963cc8cf73fdc200831850b7a632,1,1,0,1,1,2009-09-19 03:00:42,2009-09-16 08:20:31
86386829d425a3d3ae6ce713c58328607e50e523...6523078b96cd39f681e6fa11135049808591fb95,1,6,2,8,5,2009-09-06 05:25:26,2009-09-03 23:08:33
6523078b96cd39f681e6fa11135049808591fb95...0ef95f72f878184fbce8d7c855ab4346c081abed,1,28,0,28,2,2009-09-06 05:27:08,2009-09-04 01:54:03
0748494e866041034605aaf177f29a61bdc25951...c0ecb07048ce2123589a2f077d296e8cf29a9570,1,3,3,6,2,2009-12-02 18:42:48,2009-12-01 22:44:11
c0ecb07048ce2123589a2f077d296e8cf29a9570...b809d9cd0787e68f442c6795ec76580bb37d1a00,2,2,2,4,2,2009-12-02 18:50:17,2009-12-02 18:50:17
cb572206d9dac4ba52878e7e1a4a7028d85707ab...a26345b6085340ebd61e156aa8154a80196bee0f,1,75,0,75,4,2010-01-12 08:47:50,2010-01-11 06:39:36
cb572206d9dac4ba52878e7e1a4a7028d85707ab...bb8cccd01762d26c832b85d3b09798650e294c5f,1,2,1,3,2,2009-09-20 19:11:29,2009-09-20 17:33:20
be56862f198d946dc75ac7092606e78a4f2ff1d3...3266de10747c4ad3fa972994004fcb0fca9ebe1f,1,7,1,8,2,2012-08-22 18:15:16,2012-08-22 10:57:05
be56862f198d946dc75ac7092606e78a4f2ff1d3...82670a5cb57d6a590f261430b6e2b39d09c22900,2,13,0,13,5,2011-07-19 18:17:47,2011-07-16 13:03:33
82670a5cb57d6a590f261430b6e2b39d09c22900...d2e73c6f2ac3e2d32cd27afd80bfa7c1661a52d4,1,84,69,153,3,2011-07-19 18:17:47,2011-07-16 13:03:34
d2e73c6f2ac3e2d32cd27afd80bfa7c1661a52d4...cc567322acbfd5b32e61ab5d005352347cd7eeaf,1,15,8,23,8,2011-07-19 18:17:47,2011-07-16 13:03:35
cc567322acbfd5b32e61ab5d005352347cd7eeaf...1f25c50419c5f46cd6b818438fe641cf942ee6ad,2,4,7,11,7,2011-07-19 18:17:48,2011-07-16 13:03:36
1f25c50419c5f46cd6b818438fe641cf942ee6ad...6c8151a32e59c3109b3acc886358bfe6c14612fb,4,67,2,69,8,2011-07-19 18:17:48,2011-07-16 13:03:37
6c8151a32e59c3109b3acc886358bfe6c14612fb...9504bc9d5a1e672ce5945679f86294e61bbea3a6,3,19,2,21,4,2011-07-19 18:17:48,2011-07-16 13:03:38
9504bc9d5a1e672ce5945679f86294e61bbea3a6...4d2ec306e88b4de5aeb611b18b00139c90d4fa78,1,1,1,2,1,2011-07-19 18:17:48,2011-07-16 13:03:39
4d2ec306e88b4de5aeb611b18b00139c90d4fa78...a515ebe9f1ac9bc248c12a291dc008570de505ca,2,29,42,71,10,2011-07-19 18:17:48,2011-07-16 13:03:40
a515ebe9f1ac9bc248c12a291dc008570de505ca...105fe3e457fba1dc005aa649410ec3962624232a,1,4,0,4,1,2011-07-19 18:17:48,2011-07-16 13:03:41
e41d718c7df31c891b242bcf3a1cfea812308e40...365c2aaafcdefa65db994ff13071a3a7cd7910fc,1,5,2,7,1,2011-05-09 16:19:42,2011-05-09 04:43:20
8f84c95fb23848fce7f817daa5818f9822ddc0f9...cb35c0646d2b6a911f516ac2e45d2e23b038f646,2,21,23,44,9,2011-04-03 07:18:50,2011-04-03 07:18:50
cb35c0646d2b6a911f516ac2e45d2e23b038f646...1e4cd68c0041d4c6aaa0562a4528a030944d37ee,7,9,9,18,9,2011-04-03 17:14:53,2011-04-03 07:06:54
1e4cd68c0041d4c6aaa0562a4528a030944d37ee...37be802240a5201750679e20ad599dbb78376c72,1,0,2,2,2,2011-04-03 17:32:13,2011-03-31 02:26:01
37be802240a5201750679e20ad599dbb78376c72...13ee1384ef0004bd9fa6e4d2b832b49ce2e8a032,2,1,6,7,6,2011-04-03 17:59:40,2011-03-28 01:32:19
13ee1384ef0004bd9fa6e4d2b832b49ce2e8a032...6b3d83efaceefdc198df270c7ad6e9fbf51c7537,1,2,2,4,2,2011-04-03 18:06:07,2011-04-03 13:33:39
6b3d83efaceefdc198df270c7ad6e9fbf51c7537...485cdb9bd8bd7de6c7099c1c3e9c6fca6a60fdd3,1,10,3,13,2,2011-04-03 18:08:54,2011-02-04 10:59:18
9e7ad090fad725e5f1862f64b07dc15d54bdc5b9...c18d5d82b45cb6963b3229556cedd587d94afca9,1,5,2,7,3,2009-12-30 09:25:27,2009-12-30 00:58:48
c18d5d82b45cb6963b3229556cedd587d94afca9...4cc47382dfc2a71257934042f6c009287e101cb3,1,2,5,7,1,2009-12-31 07:29:12,2009-12-31 03:04:38
bc9e7dd41fe8b51cc7f2e79312a2ff777899f930...df5df20c1308f936ea542c86df1e9c6974168472,3,43,12,55,10,2012-06-26 22:08:10,2012-06-26 21:55:23
df5df20c1308f936ea542c86df1e9c6974168472...b64b7feb730b7a23c7a473a484ba6e68d410c990,2,27,4,31,2,2012-06-26 22:09:29,2012-06-26 21:55:24
b64b7feb730b7a23c7a473a484ba6e68d410c990...994fd91d1fd5e9feffc88ab7db19e9c9461b4543,1,5,1,6,1,2012-07-05 22:33:25,2012-07-04 11:32:04
bc9e7dd41fe8b51cc7f2e79312a2ff777899f930...572a7c52bb12e22b3b8471133253b9884643a4e2,3,1,7,8,3,2012-06-26 20:17:50,2012-06-26 14:51:54
572a7c52bb12e22b3b8471133253b9884643a4e2...f2b6a19907ccb366790c7ec7b640f9111ac7ad32,2,12,2,14,6,2012-06-26 20:17:53,2012-06-26 14:51:55
f2b6a19907ccb366790c7ec7b640f9111ac7ad32...a230949409f4a650c6a1a9a5879e2a8b993ba695,2,29,4,33,9,2012-06-26 20:17:56,2012-06-26 14:51:56
a230949409f4a650c6a1a9a5879e2a8b993ba695...0fbb95dc83c80fa12f731e703e88e61d9391abd5,1,24,23,47,6,2012-06-26 20:17:57,2012-06-26 14:51:57
653a31c16a0b83c11f00eb94ef49857ce8f2e37b...595b8dbfeefc2f1b0b47c4d2b947a1068bb37aeb,1,3,1,4,1,2009-07-08 16:45:28,2009-07-01 16:00:31
79b4fde573eb5e86a8109d100ad182be1eb5fc54...da8ba5e7da01be597aa9417c563dbd516ea5f204,1,1,1,2,1,2009-10-11 23:40:43,2009-09-18 05:12:17
da8ba5e7da01be597aa9417c563dbd516ea5f204...6caa7b555336dcb6e52bc7dfce1dd953bf53c3d5,1,1,1,2,1,2009-10-11 23:40:43,2009-09-20 00:26:16
6caa7b555336dcb6e52bc7dfce1dd953bf53c3d5...353c5eeb5cad63218ca796352cce9986df7b9c62,1,12,12,24,3,2009-10-11 23:40:43,2009-09-19 23:36:45
79b4fde573eb5e86a8109d100ad182be1eb5fc54...3fb9d58235ce4985689840b901aecacc6e3bd094,1,3,3,6,2,2009-09-06 05:34:27,2009-09-04 11:58:32
9ffdd46ae4465f85a5866d96afd5368095e51663...b1d9b1d0f1880c753d5146e8af63b9dc72803e4a,1,0,13,13,2,2012-08-06 22:58:38,2012-08-06 22:58:38
b1d9b1d0f1880c753d5146e8af63b9dc72803e4a...e15c16de396a1e1f42001b03cb885ce64eb4098e,2,1,5,6,2,2012-08-07 17:39:34,2012-08-07 17:39:34
18502e36061bb91131628032b5c46ea4fc8f18a3...a9ebc43bd07e219922d1dab17df319f1cae5d600,1,7,13,20,5,2012-07-26 21:23:35,2012-07-26 20:27:55
a9ebc43bd07e219922d1dab17df319f1cae5d600...34565f27fef10546a62c734c55c0d280aad63460,1,1,1,2,1,2012-07-26 21:23:35,2012-07-26 20:28:00
34565f27fef10546a62c734c55c0d280aad63460...1f4bf34578e93e8f5fa06652695e839bc51ea90f,1,8,17,25,4,2012-07-26 21:23:35,2012-07-26 20:30:29
1f4bf34578e93e8f5fa06652695e839bc51ea90f...ceacd91a063b8efea169d07913cabb0f4d33aee4,1,1,1,2,1,2012-07-26 21:23:35,2012-07-26 20:31:15
ceacd91a063b8efea169d07913cabb0f4d33aee4...1d7dc26498b5d7b7879d579f40be63210c50400c,1,10,3,13,2,2012-07-26 21:23:35,2012-07-26 20:32:31
1d7dc26498b5d7b7879d579f40be63210c50400c...8c8b3bc3f4e859be0af49f91e0d1831a9ae50324,1,17,0,17,2,2012-07-26 21:23:35,2012-07-26 20:32:50
044239b0a1fbdcccefafe1dab5f9c21e5a2a9150...0ded47581aa6097f1a685443d3c2fc0cebaf8c3c,2,53,6,59,4,2009-08-23 22:03:53,2009-08-21 14:24:48
044239b0a1fbdcccefafe1dab5f9c21e5a2a9150...43673fddd3c8a0e2cadc8ba724552531fac55464,4,5,5,10,5,2009-08-22 03:45:40,2009-08-21 08:57:58
43673fddd3c8a0e2cadc8ba724552531fac55464...3deffc52d88df73af72a80a406eb863880bb4d2a,5,27,11,38,11,2009-08-22 04:19:35,2009-08-21 08:57:59
044239b0a1fbdcccefafe1dab5f9c21e5a2a9150...f5d5ea525b6aa8b6435d4e8c92f5e797b4076fc0,1,0,0,0,0,2009-08-21 16:56:31,2009-08-21 08:32:25
c4805393d73425a5f467f10fa434fb99bfba17ac...56499eb9b84453742222676d98e11be3c390c34d,1,142,0,142,1,2010-05-20 03:36:15,2010-05-19 20:43:09
56499eb9b84453742222676d98e11be3c390c34d...fd6cce9e89ab5ac1125a3b5f5611048ad22379e7,7,222,76,298,44,2010-05-20 03:36:15,2010-05-19 20:43:10
fd6cce9e89ab5ac1125a3b5f5611048ad22379e7...5ec3e67052289217c84e53d2cda90d939ac5725b,7,91,56,147,48,2010-05-20 03:42:34,2010-05-19 20:43:11
5ec3e67052289217c84e53d2cda90d939ac5725b...942e7747678ecf5f118ea5b2d0c763166de21f3a,8,188,51,239,32,2010-06-07 04:20:04,2010-06-04 19:29:08
59f5ced65b46370a121916593cce7fcd210a15df...0c3ef984fa2d4a42be787e168cfb189d15b00919,2,18,6,24,3,2010-04-08 06:46:23,2010-04-08 04:14:31
c24138bc55bcbbde2ea8601c504752e5a39f53f2...bce02c1b4de20de545a2fab899cb96b66e01097d,1,4,47,51,3,2010-03-17 02:25:20,2009-10-21 20:02:48
c24138bc55bcbbde2ea8601c504752e5a39f53f2...db826571e4099066fe44233d95642591016c831b,1,2,2,4,1,2010-03-17 02:05:54,2010-03-15 17:14:33
db826571e4099066fe44233d95642591016c831b...ab04a9056788cf77f6b6c72605fc6027f21d9d7c,1,1,0,1,1,2010-03-17 02:05:57,2010-03-15 17:14:34
ab04a9056788cf77f6b6c72605fc6027f21d9d7c...71c4d6c6354036597534931d8fe9e80a9ae3c0af,1,1,14,15,2,2010-03-17 02:05:58,2010-03-15 17:14:35
71c4d6c6354036597534931d8fe9e80a9ae3c0af...2e85575a0216b5ad4b1209cea77e1a2769fbd0b7,1,1,0,1,1,2010-03-17 02:05:59,2010-03-15 18:35:03
2e85575a0216b5ad4b1209cea77e1a2769fbd0b7...80700fde91e4a57897d811aa40daf9251b39c77c,1,1,1,2,1,2010-03-17 02:06:01,2010-03-15 17:14:37
c24138bc55bcbbde2ea8601c504752e5a39f53f2...431d6e7bc85f693fe49a04142a8ab4d2d72b0257,2,18,14,32,8,2010-03-15 22:26:35,2010-03-15 16:21:10
5ce9086ddfe6931ef34fcd99778c9235e2ee1839...c7e1a73641e24340bf93f6f1792220fa9154cda3,5,58,21,79,18,2010-03-05 06:16:33,2010-03-04 21:20:33
c7e1a73641e24340bf93f6f1792220fa9154cda3...9297f77e6d350f33de961e149dc33c77e7392db4,5,46,12,58,20,2010-03-08 23:49:23,2010-03-08 12:53:19
9297f77e6d350f33de961e149dc33c77e7392db4...ae6d5c1b6f78ef48f606e5a267915fa31b37a679,2,33,18,51,4,2010-03-13 06:17:17,2010-03-11 21:50:25
ae6d5c1b6f78ef48f606e5a267915fa31b37a679...85adbf2f751a91429de6b431c45737ba9d7e9e00,3,88,9,97,10,2010-03-13 06:17:24,2010-03-12 21:23:52
85adbf2f751a91429de6b431c45737ba9d7e9e00...3bfc45047654c7dd38b32033321228e97fc8f60e,6,17,4,21,9,2010-03-14 05:56:35,2010-03-13 22:00:27
409b8d82dfc216ce5e89c81fdc2431dbf897c2d7...d51a47552a913dcd4ba436d529d092e4f38a3182,1,2,2,4,2,2014-01-14 18:46:17,2014-01-14 18:26:21
409b8d82dfc216ce5e89c81fdc2431dbf897c2d7...84f88512aa5067687d226a239810f6da952673b5,1,4,4,8,2,2010-02-24 16:35:43,2010-02-24 12:50:22
84f88512aa5067687d226a239810f6da952673b5...bde873c52914b40377a12764cab926ee974c3f32,3,10,4,14,3,2010-02-24 16:35:44,2010-02-24 12:50:23
bde873c52914b40377a12764cab926ee974c3f32...8afd8dc065c54d3c8d8e0397506aa99261703414,4,10,10,20,9,2010-02-24 16:35:44,2010-02-24 12:50:24
8afd8dc065c54d3c8d8e0397506aa99261703414...5bd631b3688e93ddedb33d4087deb91e2aae9e8e,1,6,10,16,6,2010-02-24 16:35:44,2010-02-24 12:50:25
5bd631b3688e93ddedb33d4087deb91e2aae9e8e...d01b3c02e8a066054c308ee2ce521a2ea44738d3,6,27,12,39,11,2010-02-24 16:35:44,2010-02-24 12:50:26
d01b3c02e8a066054c308ee2ce521a2ea44738d3...7838106925653e02b5c00ccb47a240c4c837c0f6,2,11,2,13,5,2010-02-24 16:35:44,2010-02-24 12:50:27
7838106925653e02b5c00ccb47a240c4c837c0f6...9839018e874d4f15e820e1272f1ac575186c4fdc,4,18,5,23,9,2010-02-24 16:35:45,2010-02-24 12:50:28
9839018e874d4f15e820e1272f1ac575186c4fdc...212cfe157effe53537ec42f156fbf7415441efd0,1,2,2,4,1,2010-02-24 16:38:08,2010-02-24 12:50:29
748af44c63ea6fec12690f1693f3dddd963e88d5...776ea3707a0248b9d36d696ee92beeeac5ccf1a1,1,25,21,46,7,2010-04-12 16:51:38,2010-04-12 16:11:07
776ea3707a0248b9d36d696ee92beeeac5ccf1a1...7ce4721ad8c65ab4d9a9e94176001f12bb4b5218,1,8,11,19,5,2010-04-12 16:51:42,2010-04-12 16:12:06
7ce4721ad8c65ab4d9a9e94176001f12bb4b5218...7734d7f2f6e57973bce3d7b2af815ac737f4637c,1,12,12,24,5,2010-04-12 22:30:58,2010-04-12 20:50:35
90a2bf9ca155c8e0e43d9e30197d9562dd02ea96...bf60fff8f1e814e1603328141b68686337a5a0b5,1,2,2,4,2,2010-03-13 09:16:17,2010-02-24 18:09:01
bf60fff8f1e814e1603328141b68686337a5a0b5...95109f29475a0ffc5ed4d2be1e95b01062ad1e94,2,2,0,2,2,2010-03-13 09:16:17,2010-02-24 18:09:02
3deea89c5feb0dfdfb99ea752f83497d97a3bdd5...caa9c3cabe9c2719a340425db5c0968fd3588fc9,1,1,1,2,1,2010-03-03 22:33:21,2010-03-03 22:19:09
4b7f59af2a5b072a0a3950c956842e4d6223a167...10861beaa89a4cec61e04dd4954452da24b7a757,2,17,5,22,7,2007-08-01 05:36:55,2007-08-01 04:30:35
10861beaa89a4cec61e04dd4954452da24b7a757...67d454fed6ae1f127d2daa57db946df200f2382a,2,24,14,38,5,2007-08-01 05:56:15,2007-07-31 09:58:43
67d454fed6ae1f127d2daa57db946df200f2382a...773a69fb09acfdfa2ce5566548d8a8a370a59fde,1,6,0,6,2,2007-08-01 05:56:15,2007-07-31 10:30:52
773a69fb09acfdfa2ce5566548d8a8a370a59fde...be52a41c4ea02fe7fabfef4ea9af821cdfd69a15,1,19,13,32,3,2007-08-01 05:56:15,2007-07-31 22:01:17
be52a41c4ea02fe7fabfef4ea9af821cdfd69a15...61988f1127587f8597b8b41da78a65717851e1fa,1,1,1,2,1,2007-08-01 06:04:10,2007-08-01 06:03:41
61988f1127587f8597b8b41da78a65717851e1fa...274e13e0e9c7e475bbc342a10d614dd40b0e4c15,1,15,5,20,2,2007-08-01 06:05:43,2007-07-31 10:36:32
274e13e0e9c7e475bbc342a10d614dd40b0e4c15...12ace0b20de33d57100435a60e09bb3971420003,1,134,0,134,1,2007-08-01 06:10:26,2007-07-31 19:37:30
12ace0b20de33d57100435a60e09bb3971420003...73a7a65663223d08d8cabac8d873de21b7e9678d,2,30,2,32,6,2007-08-01 07:37:23,2007-07-27 21:00:29
73a7a65663223d08d8cabac8d873de21b7e9678d...e5392c51469c25851f9c6e53165d75fc61901768,5,98,1,99,5,2007-08-01 07:38:30,2007-08-01 00:28:59
e5392c51469c25851f9c6e53165d75fc61901768...e663674722d8a64a208d8c176d5bfc340c04b964,2,41,0,41,2,2007-08-01 07:38:30,2007-08-01 00:29:17
e663674722d8a64a208d8c176d5bfc340c04b964...d7ac12b25d375d32372b13f74e90425ca21d5dc1,2,9,0,9,2,2007-08-01 07:38:31,2007-08-01 00:29:38
d7ac12b25d375d32372b13f74e90425ca21d5dc1...e90fdc39b6903502192b2dd11e5503cea721a1ad,10,216,221,437,56,2007-08-01 07:38:31,2007-08-01 00:30:14
c576304d512df18fa30b91bb3ac15478d5d4dfb1...da899deb24ff66ec2166389516a915c01bf0a387,1,2,1,3,2,2007-08-16 04:39:07,2007-08-15 23:59:27
da899deb24ff66ec2166389516a915c01bf0a387...e06c5a6c7bdaa8c96b72e29f7fb49a331f1e0cc2,3,117,25,142,15,2007-08-16 04:39:07,2007-08-15 17:22:09
e06c5a6c7bdaa8c96b72e29f7fb49a331f1e0cc2...d250626cbbfc1d047b234681d2f71f56e3ada07a,1,3,4,7,2,2007-08-16 04:39:07,2007-08-16 02:46:01
d250626cbbfc1d047b234681d2f71f56e3ada07a...312efe9b58edb428132f0bf0fdc7f3d6a41f1183,2,10,2,12,3,2007-08-16 04:39:07,2007-08-16 03:55:44
312efe9b58edb428132f0bf0fdc7f3d6a41f1183...13cc4c81df8f6b45540bd50ddffd3c11f98829bf,1,1,1,2,1,2007-08-16 19:20:25,2007-08-16 19:20:25
13cc4c81df8f6b45540bd50ddffd3c11f98829bf...19b28bf5454380f9f65063e8bc3cdee669e731a9,1,10,1,11,1,2007-08-16 22:32:46,2007-08-16 22:02:17
19b28bf5454380f9f65063e8bc3cdee669e731a9...d1d028ea16af27158f5d77154cfa60dbd9143314,1,6,4,10,1,2007-08-16 23:44:19,2007-08-16 22:56:08
d1d028ea16af27158f5d77154cfa60dbd9143314...a9ab2009dbbf769aadd52957950c1bad60a0c8fd,1,3,6,9,3,2007-08-17 04:19:06,2007-08-17 02:24:08
c8e23aaf1814b95d64fc536fdf1acaa54bb28411...f1e031bbebb8910ef11f1d5d566b357b50050c56,1,3,3,6,1,2007-07-06 07:59:34,2007-07-06 02:16:38
f1e031bbebb8910ef11f1d5d566b357b50050c56...840bcfa7b55dd94bd97a2d19a250f38d9ce80c77,1,6,1,7,2,2007-07-06 08:01:31,2007-07-06 02:15:00
840bcfa7b55dd94bd97a2d19a250f38d9ce80c77...87b49a533b0ee0da06c06fb466844885ae0d35bd,1,4,0,4,1,2007-07-06 08:02:02,2007-07-06 02:19:33
87b49a533b0ee0da06c06fb466844885ae0d35bd...47282d4646372aa859908c3b9471b96c385abe5f,1,6,0,6,2,2007-07-06 08:02:18,2007-07-05 22:39:40
206488774238c94ff337dd5c997be441dbde5112...57887443c24e5a2b4b04e7db69b44b53d8e87b44,3,29,2,31,3,2007-07-02 07:35:58,2007-07-02 07:35:58
38570a47fcd9d7631c03673249f587697fa85677...efd8f793e472069459c30e5d21bb2d203436c72a,1,3,2,5,2,2007-06-16 08:20:26,2007-06-15 14:22:37
efd8f793e472069459c30e5d21bb2d203436c72a...c5f71ad09994b46d80878ce72d1ca6f59935d952,1,33,31,64,10,2007-06-16 08:20:26,2007-06-15 03:43:59
38570a47fcd9d7631c03673249f587697fa85677...733a65aa5d33196fac708ebd12a98a1060cbf3c2,2,152,9,161,6,2007-06-13 18:24:23,2007-06-13 09:23:28
1a15fed84a511b86feaed7731850a5629d76a97f...25fd2f7a310df17dca298a3acf2aba716ceb8ce3,1,2,2,4,2,2007-06-17 01:00:07,2007-06-16 22:43:40
c927e6c69b50877e116340671ed35aaf6d3a8f49...4cd008a925f3c7c0064d86a4cb4b06278e79e9e7,1,2,2,4,2,2007-06-17 00:55:58,2007-06-15 12:19:07
45fd8bd32dd68ce6b14a406d0abbd6f56490131c...92d7c8e37b96244f2c55f5c66ec52c6325acca1d,1,1,1,2,1,2007-06-22 22:44:04,2007-06-22 22:44:04
45fd8bd32dd68ce6b14a406d0abbd6f56490131c...6762079a96dd18bcaab75f2d05034f7447434161,1,13,7,20,4,2007-06-20 23:33:24,2007-06-16 22:26:08
6762079a96dd18bcaab75f2d05034f7447434161...47ee8ed292f14e819d8e449a56c2de02d1892483,2,3,24,27,4,2007-06-23 05:13:49,2007-06-21 21:48:56
47ee8ed292f14e819d8e449a56c2de02d1892483...37cd4f7e820da82e5731c06b7ebf83963d796e5e,4,156,5,161,6,2007-06-23 05:32:32,2007-06-21 04:51:00
37cd4f7e820da82e5731c06b7ebf83963d796e5e...0ce396431ee710aa406f7e41ad9578dcac54085f,2,45,1,46,6,2007-06-23 05:43:51,2007-06-21 11:52:11
0ce396431ee710aa406f7e41ad9578dcac54085f...63daae47e59b72ebec3595ca3e9917e6c595c814,2,2,2,4,2,2007-06-23 06:19:43,2007-06-23 06:19:43
4d9b58076395899e2501b7c2b3527c998f61619e...750f7b668f33c9e8decbdd8141115328992d6fea,5,70,1,71,7,2007-06-23 06:37:11,2007-06-19 21:22:46
750f7b668f33c9e8decbdd8141115328992d6fea...9f38e1ef7e7992ca490b9b419f52fb4d11efb0e4,1,28,9,37,7,2007-06-23 06:37:21,2007-06-21 17:22:59
1d6d7c4c8545af7c5fd57a4c1ff753f1d4035097...c1fd897a25d85424a2ee93a8ae2eb247ba7c2558,1,2,1,3,2,2007-07-04 08:23:05,2007-06-22 05:29:20
c1fd897a25d85424a2ee93a8ae2eb247ba7c2558...1eb96a25c9e76b70ca3f335bce7e60d66220eaa9,1,2,2,4,2,2007-07-05 03:16:20,2007-07-04 18:06:28
caea1a2bb52262c64fdef545578ee7c5ceb113c5...2672671872adf28be744b789f9acd6b2a50d5ed1,5,22,0,22,6,2014-11-11 22:47:04,2014-11-11 20:17:07
66edfe9ddc29102fa39edd37f9aecccbaca6a013...1404bcbb6b3bdb248d32024430644e55faec91ce,3,124,2,126,9,2014-12-01 01:15:13,2014-11-26 22:44:16
1404bcbb6b3bdb248d32024430644e55faec91ce...4d7a5ceacc97e69c4ab5e1543f61fafafb963a9c,1,87,9,96,9,2014-12-01 01:54:30,2014-12-01 01:54:30
66edfe9ddc29102fa39edd37f9aecccbaca6a013...511726e4b191ad76e7b4875d8f2361b05d5cfb39,1,1,1,2,1,2014-11-10 20:08:20,2014-11-09 12:30:47
511726e4b191ad76e7b4875d8f2361b05d5cfb39...d0923b6d4c01e3c5b86d56b1741292eda7c181fe,1,27,0,27,1,2014-11-10 20:08:21,2014-11-09 12:30:48
d0923b6d4c01e3c5b86d56b1741292eda7c181fe...bebf5c04767b3c67dadfa8b65e6f0ceb258f6b83,1,54,55,109,43,2014-11-10 20:08:21,2014-11-09 12:30:49
bebf5c04767b3c67dadfa8b65e6f0ceb258f6b83...4282af0fc91e7a2667f8cba7282a5b70347f6e6f,1,21,17,38,16,2014-11-10 20:08:21,2014-11-09 12:30:50
4282af0fc91e7a2667f8cba7282a5b70347f6e6f...b0de56c6a5bb41da71babafefc9207b0fc211d66,1,17,18,35,6,2014-11-12 18:58:09,2014-11-12 00:40:12
b0de56c6a5bb41da71babafefc9207b0fc211d66...52694cdabbf68f19c8289416e7bb3bbef41d8d27,1,54,49,103,12,2014-11-12 18:59:50,2014-11-12 00:40:13
52694cdabbf68f19c8289416e7bb3bbef41d8d27...d73a5b933db1e722faa54d6709e89e2450d7c1e3,3,28,11,39,14,2014-11-12 19:00:11,2014-11-12 00:40:14
d73a5b933db1e722faa54d6709e89e2450d7c1e3...8a4acd699536c518c9245714d6175aa39d13eb9d,2,13,2,15,2,2014-11-12 19:00:22,2014-11-12 00:40:15
8a4acd699536c518c9245714d6175aa39d13eb9d...908a3203632a02568df230c0fccf9a2cd8da24e6,1,601,699,1300,195,2014-11-14 21:33:09,2014-11-12 00:40:16
66edfe9ddc29102fa39edd37f9aecccbaca6a013...a2bae2dce1fc2fe14894d46e01ee093b5704941a,2,29,35,64,24,2014-11-10 18:04:13,2014-11-09 13:49:54
66edfe9ddc29102fa39edd37f9aecccbaca6a013...b226293b44750f4e2ebd121e6f85528170f8e2c5,1,1,2,3,2,2014-11-10 18:03:39,2014-11-09 13:49:58
66edfe9ddc29102fa39edd37f9aecccbaca6a013...39942766ab9bc738f49f93d4c8ea68ffbaadc305,2,26,15,41,4,2014-11-10 16:55:10,2014-11-09 22:42:32
9902387d20e7a73662a97f5c4b66ba4ec80dc9ce...5fdcf75c68d2c382de54af4e55713ca770bb9031,1,1,1,2,1,2007-05-24 00:48:42,2007-05-23 22:16:12
ef45e4dae0a0f45fc72b7cd34b32dd465a38697d...1fda91b511c76eb233f99877c60d1c5f7801f647,2,4,9,13,5,2010-08-25 19:11:59,2010-08-24 17:33:59
1fda91b511c76eb233f99877c60d1c5f7801f647...2244eab01bfef95621ab61d2d08a3d21ba1353cf,1,4,1,5,1,2010-08-25 23:31:21,2010-08-25 02:53:11
2244eab01bfef95621ab61d2d08a3d21ba1353cf...ea16a030aaaaebb3d0038e3ec2d9cd837985dee0,1,2,1,3,1,2010-08-26 23:42:25,2010-08-26 21:34:29
bc38219f50ba9228945fba8e900d636f15082f16...a2c2cef0cd5210aa870e1d226d348a7ddd0277ff,1,3,3,6,1,2010-08-31 21:28:20,2010-08-31 21:16:39
a2c2cef0cd5210aa870e1d226d348a7ddd0277ff...382f013bc40452e4c24b8698217a14ff35f6dcec,3,5,3,8,4,2010-08-31 21:30:28,2010-08-31 20:44:39
382f013bc40452e4c24b8698217a14ff35f6dcec...f506b8e8b5fb231e63b69668b6b7516f12b32228,4,164,4,168,10,2010-08-31 21:30:29,2010-08-23 17:17:03
f506b8e8b5fb231e63b69668b6b7516f12b32228...bf1dfc31032bf6195be63dd92d0b67906e4ff4f8,4,55,0,55,4,2010-08-31 21:30:29,2010-08-31 21:27:41
bc38219f50ba9228945fba8e900d636f15082f16...25641fcdb0d31130fadd649861035cc7db859cf7,1,26,23,49,3,2010-08-24 16:33:09,2010-08-24 02:37:24
bc38219f50ba9228945fba8e900d636f15082f16...5e1f9605c48617d2ab4d99272f3363301b48e781,1,9,9,18,8,2010-08-23 16:05:32,2010-08-23 09:02:37
5e1f9605c48617d2ab4d99272f3363301b48e781...a6190565abbe12f04910624e8f13f439ddc4d6b2,1,28,28,56,6,2010-08-23 16:05:32,2010-08-23 09:02:38
a6190565abbe12f04910624e8f13f439ddc4d6b2...1884df1aad3d1745bb3abcd6a717ab3d41623779,1,2,1,3,1,2010-08-23 16:05:32,2010-08-23 09:02:39
e3efa9c12c1797f5eeb140ebeb44ff6d210ec215...7e42332e476a6f47ccc5a62cc8b93bcb4d758f7c,1,1,1,2,1,2010-09-01 16:25:17,2010-09-01 16:25:17
e3efa9c12c1797f5eeb140ebeb44ff6d210ec215...fd5c363da4635d81f29193ae19d8fa7b5657ab39,3,13,11,24,5,2010-09-01 15:00:51,2010-09-01 02:29:08
31c79549b85c6393be4f40432f5b86ebc097fc7e...c2d140db08e772e14ca17044821bcf94ae09cd0f,1,2,1,3,1,2012-07-25 17:06:50,2012-07-25 14:53:07
c2d140db08e772e14ca17044821bcf94ae09cd0f...c7108bf9ed72403bdf6274bf46263731590bffcf,5,53,42,95,35,2012-07-25 17:09:14,2012-07-25 14:53:08
c7108bf9ed72403bdf6274bf46263731590bffcf...465d6a00e9bae9786d2b12cfda4fd80d937cad9b,3,3,3,6,3,2012-07-27 05:33:37,2012-07-25 14:53:09
465d6a00e9bae9786d2b12cfda4fd80d937cad9b...c021fbf615f5cbd29ad4d9349bd2c36347655f3b,1,0,25,25,1,2012-07-27 05:34:15,2012-07-25 14:53:10
c021fbf615f5cbd29ad4d9349bd2c36347655f3b...42e6504f5e1366aeda4fdcd466a2e8bc7a75235e,1,5,6,11,4,2012-07-27 05:34:15,2012-07-25 14:53:11
42e6504f5e1366aeda4fdcd466a2e8bc7a75235e...31023e0a9fdba7ed6458caf2082dd6d82df6a56c,1,0,3,3,1,2012-07-27 05:34:15,2012-07-25 14:53:12
31023e0a9fdba7ed6458caf2082dd6d82df6a56c...55653a689e17cfa896aa0454e751a9002b519f4b,3,88,78,166,60,2012-07-27 05:34:15,2012-07-25 14:53:13
31c79549b85c6393be4f40432f5b86ebc097fc7e...390f4da8af9cf0fc44fa03588e5b3901094697e4,1,14,14,28,11,2012-07-19 17:30:25,2012-07-19 07:49:56
390f4da8af9cf0fc44fa03588e5b3901094697e4...610473a6f75c495e6d4f7cd618aefcfe67ce7594,1,12,12,24,10,2012-07-19 17:30:25,2012-07-19 07:49:57
610473a6f75c495e6d4f7cd618aefcfe67ce7594...7f8cf48c4dd2bc86f8c0933a27d4f21df2033910,1,5,7,12,5,2012-07-19 17:30:25,2012-07-19 07:49:58
7f8cf48c4dd2bc86f8c0933a27d4f21df2033910...c8e134a236692a64b44869717abe4080d6243a39,1,2,2,4,2,2012-07-19 17:30:26,2012-07-19 07:49:59
c8e134a236692a64b44869717abe4080d6243a39...ac5fc1c57f2a964e1b5480a25b6fd447ab18b9b9,1,17,11,28,5,2012-07-19 17:30:26,2012-07-19 07:50:00
ac5fc1c57f2a964e1b5480a25b6fd447ab18b9b9...dc7ace5f776f30fe4e10d8a3fa8146ad21893544,1,3,2,5,2,2012-07-19 17:30:26,2012-07-19 07:50:01
dc7ace5f776f30fe4e10d8a3fa8146ad21893544...8242ff470f2a34b5c0f193c4010cbf3d9b57f9bd,2,14,0,14,2,2012-07-19 17:30:26,2012-07-19 07:50:02
31c79549b85c6393be4f40432f5b86ebc097fc7e...e3bd4ddaa9a60fa4e70efdb143b434b440d6cec4,1,4,5,9,5,2012-07-19 08:15:50,2012-06-24 21:40:05
31c79549b85c6393be4f40432f5b86ebc097fc7e...ac4bbb41b25949adff3afa96b2821f648abad8b3,1,1,1,2,1,2012-07-16 18:06:13,2012-07-16 12:00:46
ac4bbb41b25949adff3afa96b2821f648abad8b3...dcb1ea620d1e8bd1d7e7622b7ca69050d0c119d7,1,8,1,9,3,2012-07-16 18:06:14,2012-07-16 12:00:47
dcb1ea620d1e8bd1d7e7622b7ca69050d0c119d7...2045e293eb69204ac06910c7570718efb09b7059,1,22,2,24,6,2012-07-16 19:52:40,2012-07-16 19:46:37
2045e293eb69204ac06910c7570718efb09b7059...93e92d4d7c8883b346c8975c636286d6f6479142,1,17,7,24,3,2012-07-16 19:52:40,2012-07-16 19:46:38
93e92d4d7c8883b346c8975c636286d6f6479142...5c481745fbed5aa0eb63726c9e05538ededa63bb,1,1,1,2,1,2012-07-16 19:52:40,2012-07-16 19:46:39
5c481745fbed5aa0eb63726c9e05538ededa63bb...f690ddfdb7d06eaf5f62d8deb969289d59bed9cd,1,3,0,3,2,2012-07-16 19:52:40,2012-07-16 19:46:40
f690ddfdb7d06eaf5f62d8deb969289d59bed9cd...a393f48823ba619092f8057ed807a20358e0165c,1,2,0,2,1,2012-07-16 19:52:40,2012-07-16 19:46:41
a393f48823ba619092f8057ed807a20358e0165c...ebd5fe1c15b8e576042017d6b07b7e0ed96eaf66,1,9,4,13,3,2012-07-16 19:52:40,2012-07-16 19:46:42
ebd5fe1c15b8e576042017d6b07b7e0ed96eaf66...fa316e090a58421c7caf50eefa58f6cb30c6df89,1,1,1,2,1,2012-07-17 18:51:45,2012-07-17 14:05:59
fa316e090a58421c7caf50eefa58f6cb30c6df89...2272400c93332629e8c34dcf3b1207159352e539,2,53,16,69,8,2012-07-17 18:53:11,2012-07-17 14:06:00
14154ce3caaf572aed3c26fd52c389bd13a9c688...b312b4123b053898a583aa6e8da1b26ea828105a,1,0,1,1,1,2011-01-19 16:27:22,2011-01-10 22:00:49
c0336ff27a9a4bf9db87d65c5dec1ebf7dd9f8c6...590e081dea7c064056941bfae28b25ce956585f5,2,10,1,11,3,2011-05-20 01:35:58,2011-05-19 11:37:55
206af7c96b134b4962fa04fa174a25f29efd7e5e...99694544358b74c14982f2b9769f8804f017672c,1,10,4,14,5,2011-08-04 19:05:47,2011-08-04 18:39:10
206b099d269955337bd6169f71aa08ba28a0cf4f...959dfcf42f264e8644d88b355224ff468ebae10d,1,1,1,2,2,2011-03-14 18:58:51,2011-03-14 18:28:17
a8e4a5943a63c8fd4a3a9b70ccf4608bcc973707...1368f65002bf39fdde7dd736a75ae35475184371,4,11,4,15,6,2011-02-10 21:47:56,2010-10-11 02:59:26
fa1c8542cb3ed2a193aac2e514ebe12d7fe22a04...51baceeec4884c14ac8c77902ec6973ab36421ca,1,3,2,5,1,2010-12-16 21:01:31,2010-12-14 09:18:34
51baceeec4884c14ac8c77902ec6973ab36421ca...4a689afb030c1cd5aa1c141db94bbf9dde42f05e,2,2,0,2,2,2010-12-16 21:01:36,2010-12-14 09:18:35
e22148f406a7a31a25ebda01d21d9a4646ce82ea...dc91e1b2cbb74797ad60a39d571553f9cd3419f6,1,2,2,4,1,2010-12-01 19:26:43,2010-12-01 14:51:25
dc91e1b2cbb74797ad60a39d571553f9cd3419f6...bd40d252ec1ed2716ac9e6bbeab48b3b40bd0d58,1,1,1,2,1,2010-12-01 19:51:59,2010-12-01 13:17:00
e22148f406a7a31a25ebda01d21d9a4646ce82ea...beb172172f3dc63b4e7ad671e34826fb812281f8,1,109,0,109,1,2010-09-24 01:34:58,2010-09-19 09:59:27
beb172172f3dc63b4e7ad671e34826fb812281f8...ad14b450c0c70bfcf90de0aa19ffa5e44e402b69,1,1,1,2,1,2010-09-24 01:35:07,2010-09-19 09:59:28
ad14b450c0c70bfcf90de0aa19ffa5e44e402b69...c099789bb01b810e40f9cfaa5c842ed568110fc8,1,14,24,38,3,2010-09-30 18:43:07,2010-09-26 16:26:56
e22148f406a7a31a25ebda01d21d9a4646ce82ea...d391c0ff94e1b314b0664db0e8eb5bd92934f9cb,2,34,3,37,4,2010-09-24 01:32:32,2010-09-21 21:01:24
e22148f406a7a31a25ebda01d21d9a4646ce82ea...ae8285ed63b9cca3324fda6481b2a97a92e3e50d,1,2,2,4,2,2010-09-18 22:14:10,2010-09-15 20:47:39
ae8285ed63b9cca3324fda6481b2a97a92e3e50d...aad8441483408119ea19d4cf9e5cccb4a7a3639d,1,4,2,6,1,2010-09-18 22:14:16,2010-09-15 20:47:40
aad8441483408119ea19d4cf9e5cccb4a7a3639d...cca5d0b04aa78c048239a0d5c36174f04d6d7f3a,1,4,4,8,1,2010-09-18 22:14:19,2010-09-15 20:47:41
cca5d0b04aa78c048239a0d5c36174f04d6d7f3a...06cdac5ab61eaf129cb3a14b7538b05ca53d606f,1,7,7,14,7,2010-09-18 22:14:24,2010-09-15 20:47:42
06cdac5ab61eaf129cb3a14b7538b05ca53d606f...9980d7de93b1bd932f16478349dce30209070387,1,7,0,7,1,2010-09-18 22:14:26,2010-09-15 20:47:43
9980d7de93b1bd932f16478349dce30209070387...d537c7492b7d16bf439ace7e31f8a9c0a7b617c3,1,26,17,43,6,2010-09-18 22:14:41,2010-09-15 20:47:44
e22148f406a7a31a25ebda01d21d9a4646ce82ea...95ce9ce296e1636a2b78e73b96905d781ef2ddc7,1,21,22,43,5,2010-09-13 02:56:21,2010-09-13 02:30:48
95ce9ce296e1636a2b78e73b96905d781ef2ddc7...5aaeb733f5745b37878901c4687ba67c6a70e581,3,83,13,96,13,2010-09-13 08:11:55,2010-09-13 05:15:35
9ab5a338fc03d5ea5c3ad4cd56e04029cd863c83...6070bac82a1e9c61d86f8ad2fb282ebb62d1c5d6,1,10,2,12,2,2010-09-10 18:54:34,2010-09-10 18:54:34
02567e88ee8bdbf4d3852c2d6b9e5ce64a55a9e6...84d694027fbecfc61683aa584725491bf614b5e1,1,1,1,2,1,2010-09-17 21:42:13,2010-09-15 20:58:22
84d694027fbecfc61683aa584725491bf614b5e1...14d872987a270f383e20dc183f4a960cca0f0f36,1,1,1,2,1,2010-09-17 21:58:08,2010-09-17 21:42:51
9855b08d35edf8a8a441f24ff7b00e220a29f261...c6038169a77854c26536f1c95176cbeb237e9e11,1,3,3,6,2,2010-09-30 19:20:31,2010-09-30 13:42:54
c6038169a77854c26536f1c95176cbeb237e9e11...fe0f944f3bbe4adac815808654b16837a05905fc,1,11,11,22,10,2010-09-30 19:20:32,2010-09-30 13:42:55
fe0f944f3bbe4adac815808654b16837a05905fc...f9237e61576c9bd1ba6a00276a9a849a4b5354fb,1,7,7,14,7,2010-09-30 19:20:32,2010-09-30 13:42:56
f9237e61576c9bd1ba6a00276a9a849a4b5354fb...acf071b0923d9939b8f37ece18d2424f8e627b4d,1,1,1,2,1,2010-09-30 19:20:32,2010-09-30 13:42:57
acf071b0923d9939b8f37ece18d2424f8e627b4d...1d50bfd9c7ae6a0bc7d60b34162c56c670db540d,1,1,1,2,1,2010-09-30 19:20:32,2010-09-30 13:42:58
1d50bfd9c7ae6a0bc7d60b34162c56c670db540d...c438ea2a8bd25054057220498eca4caa2aca0131,1,1,2,3,2,2010-09-30 19:20:32,2010-09-30 13:42:59
c438ea2a8bd25054057220498eca4caa2aca0131...4bf597ee05495b6fed37972eac722e5269a6b957,1,1,3,4,2,2010-09-30 19:20:32,2010-09-30 13:43:00
4bf597ee05495b6fed37972eac722e5269a6b957...0d290a46346f465a735bf50244d033e2257b0326,1,1,1,2,1,2010-09-30 19:20:32,2010-09-30 13:43:01
0d290a46346f465a735bf50244d033e2257b0326...ff483897317b5379e189d6bd782270dd08c09966,1,1,1,2,1,2010-09-30 19:20:33,2010-09-30 13:43:02
ff483897317b5379e189d6bd782270dd08c09966...d5c7d69d0fa25f1b5df50e12280a622f28319f16,1,1,1,2,1,2010-09-30 19:20:33,2010-09-30 13:43:03
d5c7d69d0fa25f1b5df50e12280a622f28319f16...e9bf741b887aadd227557804d3560ebd07b1dd09,1,1,1,2,1,2010-09-30 19:20:33,2010-09-30 13:43:04
e9bf741b887aadd227557804d3560ebd07b1dd09...5e2c2ab1599f0a7a26b58adf1a3b9314e51bfb5e,1,1,1,2,1,2010-09-30 19:20:33,2010-09-30 13:43:07
5e2c2ab1599f0a7a26b58adf1a3b9314e51bfb5e...529dd386dda6c6e6d0dad801785d2d943756fb3f,1,1,1,2,1,2010-09-30 19:20:33,2010-09-30 13:43:08
529dd386dda6c6e6d0dad801785d2d943756fb3f...41ae8f1d6cf70f32328c984cdbe51d0f156cd501,2,3,4,7,3,2010-09-30 19:20:33,2010-09-30 13:43:09
41ae8f1d6cf70f32328c984cdbe51d0f156cd501...49f73852c80ee681c179ee2eb76b1a792d7b1b22,1,2,2,4,1,2010-09-30 20:06:42,2010-09-30 13:43:05
49f73852c80ee681c179ee2eb76b1a792d7b1b22...35b6ab955d2288e1c2671bde67298ed3abe32781,1,2,2,4,1,2010-09-30 20:06:47,2010-09-30 19:03:31
9855b08d35edf8a8a441f24ff7b00e220a29f261...8ff76f4c3b4e72ac8259465bdf6e33f4da19170d,1,1,1,2,2,2010-09-30 18:47:19,2010-09-26 11:34:56
8ff76f4c3b4e72ac8259465bdf6e33f4da19170d...929909375034eb609f855fe51b2ffc57123e6dd4,1,19,2,21,3,2010-09-30 18:48:26,2010-09-26 13:02:25
929909375034eb609f855fe51b2ffc57123e6dd4...958a8467216ca607ca6a24059d5c641347927333,2,14,1,15,4,2010-09-30 18:50:26,2010-09-26 13:02:26
958a8467216ca607ca6a24059d5c641347927333...9b93aeb29cea16880926bc150ac31cfb31475a44,1,1,0,1,1,2010-09-30 18:50:33,2010-09-26 13:02:24
3b3a8ed4beadf5d9437597108355b23c7143bc81...b5d3450c914a51a6543d517c428fd41a670a113d,1,4,4,8,2,2010-09-12 21:01:55,2010-09-12 09:41:04
b5d3450c914a51a6543d517c428fd41a670a113d...89d1b5b8f70c1572c71ec04d5bb164f0849815dc,1,2,2,4,1,2010-09-12 21:01:59,2010-09-12 09:41:05
3b3a8ed4beadf5d9437597108355b23c7143bc81...5418d96ddca8134b5abeb99430f61c062d91f722,3,10,5,15,6,2010-09-12 17:24:55,2010-09-09 17:24:06
3235b7053c45a734c1cdf9b117bda68b7ced29c9...f3f3d9366edc4c150c59df929198a77ecdf69cfd,3,20,5,25,9,2010-10-06 18:19:50,2010-10-03 09:56:39
f3f3d9366edc4c150c59df929198a77ecdf69cfd...4de066b6f12a17b2b4d3206ee66efb251e1cdd29,3,33,0,33,5,2010-10-06 18:19:58,2010-10-04 02:48:11
4de066b6f12a17b2b4d3206ee66efb251e1cdd29...8cf2a84e9d6adcfc42dadfe4ec2f9bdbb0cdb59b,2,20,0,20,2,2010-10-06 18:19:58,2010-10-03 09:56:41
8cf2a84e9d6adcfc42dadfe4ec2f9bdbb0cdb59b...10d4b02b9962170e15d1d65b03581ef8bef66e2e,1,6,6,12,6,2010-10-06 18:19:58,2010-10-03 09:56:42
10d4b02b9962170e15d1d65b03581ef8bef66e2e...5102c6173c5a1c683dfdd8ccd07528adddd51745,2,110,2,112,6,2010-10-06 18:19:58,2010-10-03 09:56:43
5102c6173c5a1c683dfdd8ccd07528adddd51745...21444f1805d2ea3c7b297101e9470048cdcf58d2,1,26,12,38,2,2010-10-06 18:19:59,2010-10-03 09:56:44
21444f1805d2ea3c7b297101e9470048cdcf58d2...dc1ae7048794ba15b514ca1a67f50163a2e48eb8,1,23,0,23,1,2010-10-06 18:19:59,2010-10-03 09:56:45
dc1ae7048794ba15b514ca1a67f50163a2e48eb8...50906e04e8f48215b0b09841686709b92a2ab2e4,1,4,3,7,4,2010-10-06 18:21:57,2010-10-03 09:56:46
3235b7053c45a734c1cdf9b117bda68b7ced29c9...bb0a484e985ef8d9bbbbeb172b1fcf4982634bef,2,57,17,74,6,2010-08-17 20:58:13,2010-08-17 09:22:46
cd9a7b57a7118672441f9e9670a9fbb42249cf67...b0ad24be8ca9acd86393ce099d3217872d838915,1,12,2,14,2,2010-11-24 00:20:22,2010-10-11 03:00:40
b0ad24be8ca9acd86393ce099d3217872d838915...97a5e3453abf63bbf5926979fcd89efb4388e937,3,18,6,24,6,2010-12-08 00:03:55,2010-12-05 09:35:17
97a5e3453abf63bbf5926979fcd89efb4388e937...3c93983875af53b9f172d7f7a1022d0954cb5689,1,2,2,4,2,2010-12-08 00:04:02,2010-12-05 09:32:53
3c93983875af53b9f172d7f7a1022d0954cb5689...8e9d453ce77b7942dd35c23e145981dc472fb8c8,1,6,0,6,1,2010-12-09 17:26:07,2010-12-09 06:53:59
520ea857e66f25a681401fd534b2f0d099fd2d31...ffa1eeaeea38f6d667e304f9b12c890b7c14d088,3,37,2,39,4,2010-11-24 00:24:24,2010-11-22 04:42:53
520ea857e66f25a681401fd534b2f0d099fd2d31...fbbb4e19bee8c4d62f274f9e07b91c45e4df838c,1,6,0,6,1,2010-11-24 00:15:16,2010-11-20 06:50:51
33a0292e612915320e56f392b3372589f602a9e6...2aedccd3d51ec922020f7c7e39df5d2c4d3af515,4,29,3,32,5,2010-07-27 23:42:53,2010-07-27 23:42:47
ba9523ea809dc496a14f3644bdc1dd6f486983c0...1e39d7deea6719074b5b1487d1634d4704da357b,1,12,17,29,3,2010-07-28 20:50:11,2010-07-28 09:39:10
1e39d7deea6719074b5b1487d1634d4704da357b...6a58696f5b446cef4874c45b1c953403707325b8,1,3,5,8,1,2010-07-28 20:51:12,2010-07-28 14:12:59
6a58696f5b446cef4874c45b1c953403707325b8...43e331e6ee46ba156d43f1fd3ebc91cc35575e47,1,2,1,3,1,2010-07-28 20:51:33,2010-07-28 14:11:25
43e331e6ee46ba156d43f1fd3ebc91cc35575e47...61bf126ecb24977b883079942b71ff96174c19fb,1,23,24,47,2,2010-07-28 21:08:56,2010-07-28 18:40:53
34c071aea4aed9db484eca21c12dd443888f43ec...d599e0484f8ebac8cc50e9557a4c3d246826843d,3,8,9,17,4,2010-04-24 01:27:17,2010-04-24 01:27:17
3bcad5a23d7d114f831d7c11c7b29a8052b5a9f8...6f9a332144cda5f4d7e6e03c37fb17f8ffac1fe3,2,36,0,36,2,2011-10-05 21:48:39,2011-09-22 03:19:38
6f9a332144cda5f4d7e6e03c37fb17f8ffac1fe3...739453a3fb74ade725243ac972f02ba1aedabdf6,1,68,3,71,13,2011-10-05 21:50:46,2011-09-22 03:32:28
739453a3fb74ade725243ac972f02ba1aedabdf6...b7200e839737491dfe8f0297fba54621fd7d7583,2,59,2,61,6,2011-10-05 21:51:26,2011-09-20 22:10:08
b7200e839737491dfe8f0297fba54621fd7d7583...3c9f1e7c11186f4c7b39a0e966428587ab20fda5,1,13,16,29,5,2011-10-05 21:51:26,2011-09-16 18:22:57
3c9f1e7c11186f4c7b39a0e966428587ab20fda5...cf7316663e2ae459591bc52f0a1c91c3a684e48b,2,25,15,40,6,2011-10-05 21:51:26,2011-09-16 18:37:08
cf7316663e2ae459591bc52f0a1c91c3a684e48b...c0168147831fce00975949213eef3471b7a2b76b,1,19,1,20,2,2011-10-05 21:51:26,2011-09-20 22:52:57
c0168147831fce00975949213eef3471b7a2b76b...898eacd8ada2d012f977948350ed60845e238037,5,78,26,104,27,2011-10-07 17:11:47,2011-10-07 06:12:09
898eacd8ada2d012f977948350ed60845e238037...22a8699a6b1587024b884a80d88631db6a0ef511,1,1,1,2,1,2011-10-09 19:53:04,2011-10-08 16:18:00
22a8699a6b1587024b884a80d88631db6a0ef511...273c7032e9e79613349e24db3b0e40e8b5c0c62c,1,1,0,1,1,2011-10-09 20:20:54,2011-10-09 17:33:34
273c7032e9e79613349e24db3b0e40e8b5c0c62c...90a321c04c639488e7f66fa4dd53b14c2363cd70,1,1,1,2,1,2011-10-16 03:20:13,2011-10-15 17:46:59
90a321c04c639488e7f66fa4dd53b14c2363cd70...d050464541d51ab65863218d93b351de3392f476,2,18,0,18,5,2011-11-09 13:31:09,2011-11-09 13:05:00
54fd955c211db6f4a2c91301f792ec9de86eed31...d8c416b2518a96e5d535b8e4b2349e7c647a4be5,1,10,9,19,2,2010-04-11 19:17:42,2010-04-11 19:17:42
407a963cae2867e16a62dafbdfaf6f85301d4cd6...5469e2dab133a197dc2ca2fa47eb9e846ac19b66,2,9,2,11,5,2010-04-19 05:19:04,2010-04-19 05:19:04
c197702156e2164074327f5e870ab0d3021977fc...fc6fa0d0f38f4e5b47f260fe2755ba0d1b17ae53,1,43,0,43,2,2010-05-28 22:35:00,2010-05-27 15:34:50
fc6fa0d0f38f4e5b47f260fe2755ba0d1b17ae53...cee9f2b37bd7c65de5fb507d11b4caac31c29039,1,27,2,29,3,2010-05-28 22:35:23,2010-05-27 15:34:51
cee9f2b37bd7c65de5fb507d11b4caac31c29039...a45e1a87adc7cd7ace911049829308ae97b2e914,2,6,8,14,4,2010-06-13 16:38:43,2010-06-12 14:15:39
ed215b109fc0e352456ea2ef6a0f8375e28466d5...dfea79004c54bc96143386d6ac22de500ba4f747,4,13,19,32,17,2010-05-04 22:19:14,2010-05-04 20:41:34
ed215b109fc0e352456ea2ef6a0f8375e28466d5...582aa00bdffb27abcf1b27d541b4c231a395d3b8,7,11,11,22,11,2010-05-02 14:59:50,2010-05-02 13:04:41
ea0edad58f58378cb42c2895c5578524bbaba296...f2cabf6abfb1ebf8c1f1a4789ae003990b5f0ba9,1,5,5,10,6,2010-05-08 04:33:19,2010-04-24 12:29:52
f2cabf6abfb1ebf8c1f1a4789ae003990b5f0ba9...bf4d382615ac2a3d2df7eae3020dc9103889d2ae,1,0,0,0,0,2010-05-10 18:52:16,2010-05-10 09:51:39
6a6955134b87ba3ea7d54467e637be0da7ba170b...4d80fa8f7562766013e0c589f270f74c25448755,1,9,0,9,1,2010-03-30 04:18:07,2010-03-29 13:05:57
4d80fa8f7562766013e0c589f270f74c25448755...b2e256b0f0980dac6f0761d5bff0b43170022799,2,2,1,3,2,2010-03-30 04:18:07,2010-03-29 13:05:58
6a6955134b87ba3ea7d54467e637be0da7ba170b...3bfdf87c47d516abfe9a84e8fdd918a930543189,1,7,0,7,3,2010-03-29 16:40:06,2010-03-26 08:39:57
f7311dc2293d9c52827c518933c80bd664023e97...abeb09b646921b725561870ef4dd62294f9863ad,2,5,2,7,3,2010-02-28 19:04:19,2010-02-27 14:20:25
abeb09b646921b725561870ef4dd62294f9863ad...ad2c928001d2d94f2cbf3c75734061eb8fc4383c,2,21,8,29,8,2010-02-28 19:06:10,2010-02-27 14:20:26
ad2c928001d2d94f2cbf3c75734061eb8fc4383c...e80d4cbefce106506ec217f9ab279bcf0b84a2e9,3,26,7,33,9,2010-02-28 19:07:49,2010-02-27 14:20:27
e80d4cbefce106506ec217f9ab279bcf0b84a2e9...6d8d8e0de3ca753cd482012d3695602e36356145,1,96,0,96,1,2010-02-28 19:10:39,2010-02-27 14:20:28
f7311dc2293d9c52827c518933c80bd664023e97...ae5b370c9bbc161c68059cea7d9f7eb5b556e050,2,74,38,112,30,2010-02-26 09:30:23,2010-02-22 07:57:20
ae5b370c9bbc161c68059cea7d9f7eb5b556e050...9560808f2ef5a34d2a69c454cfa6003a2f8467cb,3,581,53,634,46,2010-02-26 09:30:23,2010-02-22 07:57:21
9560808f2ef5a34d2a69c454cfa6003a2f8467cb...6a2009e7f34148a737d8832887dcd491905017be,2,2,2,4,2,2010-02-26 09:30:23,2010-02-22 18:12:53
6a2009e7f34148a737d8832887dcd491905017be...d32fad2b89c81ca29128722e0e2f5985426e5e7a,1,11,5,16,3,2010-02-26 09:33:56,2010-02-24 03:13:50
1aea303d7eafc5f178b253f4d069eb5f2acfb409...5d6dfc7cb140a6eb90138334fab2245b69bc8bc4,1,39,27,66,11,2011-12-22 19:43:02,2011-12-22 19:43:02
dc865af65f2f97a738a1761d7e9d389101e29e7b...bc1bbe0c19a6ff39522b4fa3259f34150e308e1f,2,2,2,4,2,2011-11-13 06:14:53,2011-11-13 06:14:53
e94b4d2f2a3a9b2aaaac15c33d5d31f76531ecbf...61d6ed139ff572937c8ff342cfa16e40d2f9011e,4,22,18,40,8,2007-04-15 02:47:20,2007-04-09 23:01:44
61d6ed139ff572937c8ff342cfa16e40d2f9011e...5f2e1df5c9fa7856e5d7dda7d6c618ed08822b82,1,5,0,5,1,2007-04-15 23:05:24,2007-04-15 22:36:06
d78b0f3d6aa04510dd0c22c3853d3954c5f5b531...c5203bdf66531c848a2b6cd74f3c02cb18286c55,2,8,1,9,2,2006-08-21 21:15:43,2006-08-18 10:42:39
c5203bdf66531c848a2b6cd74f3c02cb18286c55...6e17886d376ee8480cc9a8b9bc5046f2d721565f,1,1,1,2,1,2006-08-21 21:15:45,2006-08-21 20:22:25
6e17886d376ee8480cc9a8b9bc5046f2d721565f...60a6bf5f53635005f4f68d8b8a33172309193623,1,44,60,104,23,2006-08-21 21:15:52,2006-08-19 14:52:21
5ff9d11409c706e3a9bf55005f6a555d0bf9202e...c470701a98700533024b1864b789d4fc17e5e823,1,3,5,8,3,2006-08-28 03:49:35,2006-08-27 23:55:46
c470701a98700533024b1864b789d4fc17e5e823...b3c952f8386cebe12fc95227866683bb1cec99a9,2,2,2,4,2,2006-08-28 03:49:43,2006-08-28 00:26:07
b3c952f8386cebe12fc95227866683bb1cec99a9...4cac42b1324951579036a9d3ac403f5c2c3eeed8,10,21,44,65,16,2006-08-28 04:19:39,2006-08-28 04:19:39
4cac42b1324951579036a9d3ac403f5c2c3eeed8...370e0966ef4abff81f08c9ea5c7d167eb0b0d354,1,1,0,1,1,2006-08-28 06:32:07,2006-08-27 11:19:49
f5961572a02ef08324f297fe93b704ff2137e5a6...cb626bc6300c988d066aacc53a3f5893ee5dba53,1,6,0,6,1,2006-10-03 08:02:27,2006-10-02 17:23:53
cb626bc6300c988d066aacc53a3f5893ee5dba53...b599deec18719379167c639613379abb9205e065,1,1,1,2,1,2006-10-03 08:02:27,2006-10-03 00:02:15
b599deec18719379167c639613379abb9205e065...54bd25580e227c15a5f1a2b01be794b65e434665,2,2,1,3,2,2006-10-03 08:04:19,2006-10-03 05:52:57
54bd25580e227c15a5f1a2b01be794b65e434665...e70866f53a8d31cde6cfff6396ba0d1f64029afb,1,1,0,1,1,2006-10-03 08:04:41,2006-10-02 21:54:53
e70866f53a8d31cde6cfff6396ba0d1f64029afb...128eead19821ba18e2912ebf30e5621d08735e79,1,25,1,26,3,2006-10-03 08:09:56,2006-10-03 08:03:28
f5961572a02ef08324f297fe93b704ff2137e5a6...7a21632fa346df58d94d32f09625025931ef13ec,1,6,0,6,1,2006-10-02 18:49:45,2006-10-02 17:23:53
f5961572a02ef08324f297fe93b704ff2137e5a6...9e756904d05a53f1f519492ea1addc3e3163c678,1,21,1,22,4,2006-10-02 07:49:42,2006-10-01 21:57:48
9e756904d05a53f1f519492ea1addc3e3163c678...a9455919064ab316b7852d0006c1bd771b727f2e,1,4,0,4,1,2006-10-05 06:02:31,2006-10-03 18:07:43
a9455919064ab316b7852d0006c1bd771b727f2e...45a3b12cfd3eaa05bbb0954790d5be5b8240a7b5,2,56,19,75,9,2006-10-08 06:12:12,2006-10-07 13:17:47
45a3b12cfd3eaa05bbb0954790d5be5b8240a7b5...34c06118ede69b37b76fcf71564f0f24234c5752,1,4,0,4,2,2006-10-11 21:42:22,2006-10-11 20:31:15
3e04228b0c4bbb4b5cd46db9a714dfe699fa4cb8...9590b041ea464c46d5a6811df5bce83c5dd4d457,2,8,6,14,6,2006-07-31 22:32:23,2006-07-31 09:53:46
9590b041ea464c46d5a6811df5bce83c5dd4d457...aa086eb813d4fe21aac556a94efe5e29b44d8ca4,5,12,1,13,5,2006-07-31 22:32:24,2006-07-29 22:27:43
bc9e1b8483b16d117d2f868f96e354be2a678d52...6ebdee5af47df0c64354e452419015a694c25f5f,1,3,2,5,2,2006-08-02 07:27:17,2006-07-29 16:12:34
6ebdee5af47df0c64354e452419015a694c25f5f...1fd4da643cb829618bbe76ab37df7f1b4dafc656,1,2,1,3,1,2006-08-02 07:27:17,2006-07-29 16:20:41
1fd4da643cb829618bbe76ab37df7f1b4dafc656...7ffe7098dca297016f87a7e10554e6736f7c3ae2,2,6,8,14,4,2006-08-02 07:27:18,2006-07-29 16:25:03
7ffe7098dca297016f87a7e10554e6736f7c3ae2...446c6faec69f7ac521b8b9fc2b1874731729032f,2,245,17,262,13,2006-08-02 07:27:18,2006-07-29 17:15:47
446c6faec69f7ac521b8b9fc2b1874731729032f...579d1fbfaf25550254014fa472faac95f88eb779,3,35,6,41,11,2006-08-02 07:27:18,2006-07-30 15:38:28
579d1fbfaf25550254014fa472faac95f88eb779...8e76483ce0ce256b01345abc4ca97b1f94aed354,1,1,4,5,1,2006-08-02 07:27:18,2006-07-30 16:00:40
8e76483ce0ce256b01345abc4ca97b1f94aed354...822a7d507151e1d6310f52d5b05234d65db11a88,4,33,42,75,14,2006-08-02 07:27:18,2006-07-30 21:42:25
bc9e1b8483b16d117d2f868f96e354be2a678d52...dfa464781286e3a6fb1d56a834bb15ac7fc4fb16,1,3,0,3,2,2006-08-01 08:43:26,2006-08-01 08:34:53
dfa464781286e3a6fb1d56a834bb15ac7fc4fb16...2de196fec1feba8350f272c567989595901bb67e,1,3,4,7,4,2006-08-03 23:01:58,2006-08-03 23:01:58
f1efc38bf2856f875b878177c0f0a98d9eb3bb4e...26298b5f7ba816960032f427aef331a46e2fb71b,1,7,7,14,4,2006-08-10 21:30:28,2006-08-10 10:38:47
f1efc38bf2856f875b878177c0f0a98d9eb3bb4e...d636ad9743783c728469a9b644c23c0415fe1a7b,1,9,7,16,6,2006-08-08 01:15:29,2006-08-04 22:11:47
d636ad9743783c728469a9b644c23c0415fe1a7b...82f930deadc9a7990cbc0988255e6a5afd641f4b,2,5,1,6,2,2006-08-08 01:15:29,2006-08-04 22:09:59
e866ffdf9b2add0e0981d19b3c212c4621fd8a57...3f0073a2fabce18303aeef154dd6ec5aa8faa5e7,1,1,1,2,1,2006-08-22 03:19:45,2006-08-21 18:11:48
3f0073a2fabce18303aeef154dd6ec5aa8faa5e7...7230e6d042ae385377f09c4d226d9b1aa7a2c13b,5,32,46,78,15,2006-08-22 03:22:23,2006-08-21 18:43:43
7230e6d042ae385377f09c4d226d9b1aa7a2c13b...da7560110f91088ee2a664e98f75ff54e0d9e1e1,1,12,0,12,2,2006-08-22 03:24:56,2006-08-21 07:10:02
da7560110f91088ee2a664e98f75ff54e0d9e1e1...44c10841ea3edeef47cc6be0fdba5058344e2e95,1,0,3,3,1,2006-08-22 03:26:14,2006-08-21 07:10:36
b4c27c186f6282ead5d2af0cfd9b6015b011bc38...73c9083f52ac918b530c51887bbf5fd0a1119b4c,1,1,2,3,1,2006-08-26 19:26:42,2006-08-26 10:33:17
73c9083f52ac918b530c51887bbf5fd0a1119b4c...17848fc67cf466b805f35608230f4df898943ec1,1,16,9,25,3,2006-08-26 20:52:57,2006-08-26 17:14:22
17848fc67cf466b805f35608230f4df898943ec1...f2e73302994b6072e556df1af998c0afd643e833,1,17,3,20,4,2006-08-26 20:56:09,2006-08-26 17:14:25
f2e73302994b6072e556df1af998c0afd643e833...090525541ffd3f52867d5d26de5e02ce4998460b,1,1,1,2,1,2006-08-27 00:56:49,2006-08-26 21:33:58
090525541ffd3f52867d5d26de5e02ce4998460b...c8a99d76749aeaa6b7fd8555724a4921eb677a37,1,1,1,2,1,2006-08-27 22:12:10,2006-08-26 17:14:23
c8a99d76749aeaa6b7fd8555724a4921eb677a37...023782bd4df765b0555b8abc1830d9a90cdccca2,1,0,51,51,1,2006-08-27 22:15:27,2006-08-27 21:44:38
023782bd4df765b0555b8abc1830d9a90cdccca2...0aea33762b1262d11fb43eda9f3fc152b5622cca,1,3,20,23,2,2006-08-27 22:19:28,2006-08-27 21:45:26
0aea33762b1262d11fb43eda9f3fc152b5622cca...6bcf4b46c9a4ba7a6e5c78201c619fa41ac76a99,1,24,9,33,10,2006-08-27 22:35:01,2006-08-27 21:49:36
62e27f273d66afa996cb7aee6cdb25fbedc053f6...e49521b56d8715f46b93ee6bc95f7de9c6858365,3,40,49,89,3,2006-09-20 23:08:14,2006-09-20 23:04:46
e49521b56d8715f46b93ee6bc95f7de9c6858365...7dd45e15c259e44b1c8b5ffdfc0c3d002c7f642c,1,26,0,26,2,2006-09-20 23:11:08,2006-09-20 23:11:08
7dd45e15c259e44b1c8b5ffdfc0c3d002c7f642c...11031d7e9f34f6a20ff4a4bd4fa3e5e3c0024a57,5,21,0,21,6,2006-09-20 23:15:45,2006-09-20 23:07:54
11031d7e9f34f6a20ff4a4bd4fa3e5e3c0024a57...9edd7e4652e080a1a3b1ef614d22eba75b39ef87,1,7,6,13,4,2006-09-21 05:37:50,2006-09-21 00:07:19
9edd7e4652e080a1a3b1ef614d22eba75b39ef87...199a92186b6721b23a2400c91f8bd44e7ffa349a,4,27,0,27,4,2006-09-21 06:32:22,2006-09-21 00:10:30
199a92186b6721b23a2400c91f8bd44e7ffa349a...053d62bb5bd523f492c6ef2e202da837b7f56905,1,1,0,1,1,2006-09-21 08:15:23,2006-09-21 07:48:21
053d62bb5bd523f492c6ef2e202da837b7f56905...16fdb4882e3f7b5b60907a2729df494aaa1410a3,1,7,5,12,4,2006-09-21 08:16:45,2006-09-21 00:05:50
16fdb4882e3f7b5b60907a2729df494aaa1410a3...1d782b03b078c1a525cbb5728f6dc5eb06f06924,1,5,0,5,2,2006-09-21 19:55:51,2006-09-21 16:09:12
1d782b03b078c1a525cbb5728f6dc5eb06f06924...609ff267fb03fb10dcefd15fc1f0ef3d7a1ba5ce,1,2,1,3,1,2006-09-22 03:56:33,2006-09-21 23:58:40
609ff267fb03fb10dcefd15fc1f0ef3d7a1ba5ce...cae1862a3b55b487731e9857f2213ac59d5646d1,1,38,4,42,9,2006-09-22 03:57:43,2006-09-22 01:19:41
cae1862a3b55b487731e9857f2213ac59d5646d1...35749ae566b15d1860cbfba5bc5ac227eb785715,1,2,7,9,2,2006-09-22 03:58:50,2006-09-22 01:19:44
35749ae566b15d1860cbfba5bc5ac227eb785715...1d62be25ed931f1892fad8639037c99677db5d1d,1,2,1,3,1,2006-09-22 04:00:51,2006-09-22 01:19:46
1d62be25ed931f1892fad8639037c99677db5d1d...6ef4cb2e8dd791612044f5e71f61a4788e87c4ac,1,2,0,2,1,2006-09-22 04:01:28,2006-09-22 01:19:48
6ef4cb2e8dd791612044f5e71f61a4788e87c4ac...35329cc1ccd8c720628a72276402d5c3788b48e7,1,4,4,8,4,2006-09-22 04:18:26,2006-09-22 01:19:50
35329cc1ccd8c720628a72276402d5c3788b48e7...f35274dad8e617c1ea2c55c2b7b0fbbcb1abd8ae,1,4,4,8,4,2006-09-22 04:21:04,2006-09-22 01:19:53
f35274dad8e617c1ea2c55c2b7b0fbbcb1abd8ae...26d0a976e88cf2e1ccb0b4d8172e9ce24d144d1f,1,5,5,10,3,2006-09-22 23:49:36,2006-09-22 23:00:12
26d0a976e88cf2e1ccb0b4d8172e9ce24d144d1f...d72672074361a738afbf3139d8921ddf8bd782f8,1,1,1,2,1,2006-09-22 23:58:51,2006-09-22 23:56:43
d72672074361a738afbf3139d8921ddf8bd782f8...74d6166751ddcf08029ffc90a14158a86f80cd40,1,1,1,2,1,2006-09-22 23:59:04,2006-09-22 23:15:18
74d6166751ddcf08029ffc90a14158a86f80cd40...5c7d2cf3d6a059038d8d0bda6a76fa7818a9caa0,1,1,1,2,1,2006-09-22 23:59:22,2006-09-22 23:21:20
5c7d2cf3d6a059038d8d0bda6a76fa7818a9caa0...3d5c0cc9387b35df47c988fbc0e4379e413d783e,1,1,1,2,1,2006-09-23 00:00:36,2006-09-22 22:35:20
62e27f273d66afa996cb7aee6cdb25fbedc053f6...49ba83fb67d9e447b86953965ce5f949c6a93b81,5,229,11,240,22,2006-09-20 18:15:39,2006-09-20 01:31:51
62e27f273d66afa996cb7aee6cdb25fbedc053f6...cd0d74d2f9c7578b36e705dda55f79731dbe9696,1,4,9,13,3,2006-09-20 18:15:32,2006-09-18 09:29:01
cd0d74d2f9c7578b36e705dda55f79731dbe9696...d0b353b1a7a2f5168a8e2c992403f2a7d1e323f8,1,1,0,1,1,2006-09-25 03:16:23,2006-09-25 02:31:11
62e27f273d66afa996cb7aee6cdb25fbedc053f6...83b5d2f5b0c95fe102bc3d1cc2947abbdf5e5c5b,4,531,506,1037,14,2006-09-20 18:14:38,2006-09-17 23:02:52
83b5d2f5b0c95fe102bc3d1cc2947abbdf5e5c5b...8ecae9b032cd0427079d557a3bb6c39116420d4b,2,17,0,17,4,2006-09-20 18:14:39,2006-09-17 22:43:40
8ecae9b032cd0427079d557a3bb6c39116420d4b...bd95fcd34543d7d98bff033c00054341165bc9ce,2,86,1,87,7,2006-09-20 18:14:39,2006-09-18 00:23:20
bd95fcd34543d7d98bff033c00054341165bc9ce...f69895fb0c5921f5b399f35a71caa9a023776ddf,1,3,1,4,1,2006-09-20 18:14:39,2006-09-18 06:52:42
f69895fb0c5921f5b399f35a71caa9a023776ddf...a2ed6ae402582a3ee76e9b4639848eba261a12de,1,8,2,10,2,2006-09-20 18:14:39,2006-09-18 17:07:51
a2ed6ae402582a3ee76e9b4639848eba261a12de...480c1ca6fd8df58a783e231648b489ed2bfd17f1,2,42,16,58,20,2006-09-20 19:39:46,2006-09-20 19:39:46
480c1ca6fd8df58a783e231648b489ed2bfd17f1...2d10c555374df257e32848ba6f77fd73d608645f,3,27,54,81,13,2006-09-20 20:21:56,2006-09-20 20:21:56
968846015229fe0fec28e3c85db722e131c15f93...913c983e0481b477ccc11fa72ebeb0d6ec8d06aa,1,3,3,6,3,2006-09-22 03:54:41,2006-09-21 21:29:59
913c983e0481b477ccc11fa72ebeb0d6ec8d06aa...afdcec73660737d0ac28a808829ab76587a9befa,1,6,0,6,1,2006-09-22 03:54:43,2006-09-21 22:07:01
afdcec73660737d0ac28a808829ab76587a9befa...7c1a278d99a18445e12bd55e308cd69080963198,1,1,1,2,1,2006-09-22 23:53:31,2006-09-22 23:08:45
7c1a278d99a18445e12bd55e308cd69080963198...6d15987c1e06dab2c0470b86cf9f3df747891f5a,1,1,1,2,1,2006-09-23 04:31:40,2006-09-23 04:31:40
6d15987c1e06dab2c0470b86cf9f3df747891f5a...5fd6f5cffc7b8bc679c922b8ff0b1cd35bb1a30c,1,3,6,9,3,2006-09-23 04:41:49,2006-09-23 04:41:49
634b8d05142a4812bf35fe8b14cc62c84494c78f...793c400cc1028cca4078281d69aa43fac2d6d0ba,1,1,1,2,1,2006-11-24 22:01:23,2006-11-24 21:25:50
793c400cc1028cca4078281d69aa43fac2d6d0ba...7002243f7ee7eb557a1e49420487e150730ff46f,1,2,2,4,2,2006-11-24 22:07:41,2006-11-24 22:04:01
634b8d05142a4812bf35fe8b14cc62c84494c78f...d4f694ba89857a87e259557d0f236c761b4041ef,4,84,23,107,19,2006-11-24 11:59:05,2006-11-24 08:26:49
712fcc08c7a2d338f9480033597ad62223c657ec...b5c2f30689d66761ce4e8a5e69c9924c0c389233,1,142,34,176,25,2005-12-01 09:01:51,2005-11-29 21:15:51
b5c2f30689d66761ce4e8a5e69c9924c0c389233...38ad0910a0fad012943e6e87f1fc0b1de5851d91,1,22,30,52,8,2005-12-01 11:42:46,2005-12-01 11:42:46
38ad0910a0fad012943e6e87f1fc0b1de5851d91...4dd5d0d9eb8429a217ec43682e2e2eef8a8cbf6d,1,66,44,110,22,2005-12-05 22:46:23,2005-12-05 22:46:23
4dd5d0d9eb8429a217ec43682e2e2eef8a8cbf6d...fd8ccbec4f0161b14f804a454e68b29e24840ad3,1,374,94,468,7,2005-12-07 12:28:22,2005-12-07 12:28:22
36d277c72d90d32f99616072b64a2652248f5264...7f4bd5d831ea838668d1de5f5af022f763230eee,1,27,1,28,3,2005-11-28 21:00:31,2005-11-28 21:00:31
7f4bd5d831ea838668d1de5f5af022f763230eee...f2e6f1c9763f65918211ed28caf77a40effa4e7e,1,2,2,4,2,2005-11-29 04:51:44,2005-11-29 04:51:44
f2e6f1c9763f65918211ed28caf77a40effa4e7e...3e2f62bebfe8e9aeea63849c37c65f25ea001e65,1,1,1,2,1,2005-11-29 05:56:30,2005-11-29 00:51:54
3e2f62bebfe8e9aeea63849c37c65f25ea001e65...ffb1a4bed55534e276a0e4fc7dc1c94d17be8579,1,95,0,95,1,2005-11-29 06:54:30,2005-11-29 06:54:30
ffb1a4bed55534e276a0e4fc7dc1c94d17be8579...9ef2b3cbf62d15aa0312bde349347873d7c0f399,4,29,16,45,13,2005-11-29 06:55:25,2005-11-29 06:55:25
8e6ae4ad5ff14a6fd958ada867e24f8d248aac58...e5215804ded0102f6d6f3d694374ae5e106fd9c0,1,3,3,6,2,2005-11-02 06:01:28,2005-11-02 06:01:28
e5215804ded0102f6d6f3d694374ae5e106fd9c0...e125c1a717bb732319596d8b792a67c2b7b15ef7,1,11,4,15,1,2005-11-02 06:19:36,2005-11-02 06:19:36
e125c1a717bb732319596d8b792a67c2b7b15ef7...4ccafd7a02fd9905cc5382b2c1d5abdb11a7525a,1,2,2,4,1,2005-11-03 00:50:58,2005-11-02 20:01:06
4ccafd7a02fd9905cc5382b2c1d5abdb11a7525a...13d1cc3604a1a64cb5a6025bba8af8b74a373963,2,5,1,6,2,2005-11-03 00:50:58,2005-11-02 20:17:47
13d1cc3604a1a64cb5a6025bba8af8b74a373963...d317e4384acd5646f2ba44197a531c129b26b57e,2,13,1,14,2,2005-11-03 00:50:58,2005-11-02 13:05:45
d317e4384acd5646f2ba44197a531c129b26b57e...db2c075d9375a32b8010d2b17c1d420aa8696710,1,8,0,8,1,2005-11-03 00:50:58,2005-11-02 21:02:57
db2c075d9375a32b8010d2b17c1d420aa8696710...2fd955cc0b49de9e64b2f073ce76033975f0be24,1,1,1,2,2,2005-11-03 00:50:58,2005-11-02 19:27:31
2fd955cc0b49de9e64b2f073ce76033975f0be24...9534f40bc42dd826cc26c8c8c84f6a8a5fc569f6,9,21,14,35,13,2005-11-03 00:50:58,2005-11-02 23:19:13
9534f40bc42dd826cc26c8c8c84f6a8a5fc569f6...a3114b3428595710d4719dd668531210af5993c9,1,8,0,8,1,2005-11-03 07:41:25,2005-11-03 07:41:25
a3114b3428595710d4719dd668531210af5993c9...123ee3ca7b57c32bb3ecd8cfede20dbb9dd5a8a8,2,22,12,34,13,2005-11-03 22:55:10,2005-11-02 03:30:11
123ee3ca7b57c32bb3ecd8cfede20dbb9dd5a8a8...64da9e604eea25c9c20cfe12618285ccd0bf3cfe,4,10,2,12,4,2005-11-03 22:55:10,2005-11-02 03:34:49
64da9e604eea25c9c20cfe12618285ccd0bf3cfe...160252f81626d865b9e902abffe5e4976944c930,1,7,0,7,1,2005-11-03 22:55:11,2005-11-03 09:51:25
160252f81626d865b9e902abffe5e4976944c930...66158e331b385a81ac825c208c6160a0cdd2324c,1,40,0,40,1,2005-11-03 22:55:48,2005-11-03 21:52:44
66158e331b385a81ac825c208c6160a0cdd2324c...36f05ef485d023eda3bf750e7b207d07d5feb39d,1,35,0,35,1,2005-11-03 22:55:48,2005-11-03 21:52:44
36f05ef485d023eda3bf750e7b207d07d5feb39d...2be8fd085e865097fa0908fe1a94c8edf9cde7f5,1,26,0,26,1,2005-11-03 22:55:49,2005-11-03 21:52:44
79a9d8ea0d88a3667ad19be8e705405ab5d896f1...c8c5b21a3714db3272f869c82f3ce862ed9c2cc6,1,1,5,6,3,2005-10-03 23:29:48,2005-10-03 23:05:50
91dd674e30ba0298e89c9be2657024805170c2ac...c807f771947de65dceb22960d1a093d702f42105,1,11,1,12,1,2005-10-03 00:29:21,2005-10-03 00:29:21
c807f771947de65dceb22960d1a093d702f42105...99a19b43021024e12ddb67831f8e5919f86a5979,1,68,21,89,16,2005-10-03 04:40:51,2005-10-03 04:40:51
99a19b43021024e12ddb67831f8e5919f86a5979...88f8f0a52b2962452d89e854ad751283595473e4,3,9,3,12,4,2005-10-03 07:25:42,2005-10-03 06:13:09
88f8f0a52b2962452d89e854ad751283595473e4...5a82b4fb3e547c4aa14cd417790b3f925713a422,1,1,1,2,1,2005-10-03 07:36:13,2005-10-03 07:36:13
5a82b4fb3e547c4aa14cd417790b3f925713a422...df8baa42fe4eeb5a021ac262caf601f44d2a5746,26,209,192,401,68,2005-10-03 20:23:47,2005-10-03 17:16:30
91dd674e30ba0298e89c9be2657024805170c2ac...baaac6a7143ad07de62926421f8740cd640c241c,1,1,1,2,1,2005-10-02 23:37:27,2005-10-02 23:37:27
0516de30e8bdd26086e2a3edd3375981fd0c34d6...89580e3f6d671102bd8a7dda5f28cbfae2356269,3,3,4,7,4,2005-09-06 16:06:32,2005-09-06 16:06:32
89580e3f6d671102bd8a7dda5f28cbfae2356269...0d821d4dab346c9891e937d5f10c3261e1bbf13a,2,39,11,50,7,2005-09-06 18:57:37,2005-09-06 17:36:01
0d821d4dab346c9891e937d5f10c3261e1bbf13a...760b6634461ded0a9f09e86388c0ad7500641f1e,3,16,15,31,6,2005-09-06 20:49:11,2005-09-06 19:21:16
c95173410d6f290e65c15232e56f4963f8279ef1...9e3e2a55961b846f0b92867591ce971a744b7583,1,1,1,2,1,2005-08-25 00:50:05,2005-08-25 00:50:05
2c04662d89eaa55cecb6effd743c17051d1458ec...48313592bf318139b39d6017a863f27420e3939a,4,185,39,224,13,2005-08-29 19:52:02,2005-08-28 06:53:27
48313592bf318139b39d6017a863f27420e3939a...e47e35acdda5e334befcde6ffaf207cb5a63b6f4,6,5,194,199,6,2005-08-29 19:52:03,2005-08-27 00:27:07
e47e35acdda5e334befcde6ffaf207cb5a63b6f4...de2b82c65dac0e9768bc32f38e96b61d0b778843,3,75,1,76,4,2005-08-29 19:52:03,2005-08-28 10:01:09
de2b82c65dac0e9768bc32f38e96b61d0b778843...d4a9ce78f6d516568bfca4d808033d9e8254c33f,2,554,86,640,54,2005-08-29 19:52:05,2005-08-28 19:33:16
d4a9ce78f6d516568bfca4d808033d9e8254c33f...8e5dd22b297a9a5d89d9639e6665b706ccd34282,1,108,22,130,19,2005-08-30 00:19:47,2005-08-30 00:19:47
8e5dd22b297a9a5d89d9639e6665b706ccd34282...d5acdcf18e255308f5f16ae9e7fe48bf21ff68c0,1,43,8,51,6,2005-08-30 00:20:07,2005-08-29 17:29:53
d5acdcf18e255308f5f16ae9e7fe48bf21ff68c0...f85a41916163097c3c307ac45d1a935564c52bf0,8,297,149,446,75,2005-08-30 00:21:06,2005-08-30 00:21:06
d7d2c87955f7700289c5b516f12579a5be4b879d...83786fa412662f6d7cdade9e4043882c5ad21c1a,2,77,6,83,12,2013-12-06 19:48:47,2013-11-13 10:19:00
d7d2c87955f7700289c5b516f12579a5be4b879d...4528aa1aaf4ac69061de2537e071258894ed235d,1,78,148,226,109,2013-11-18 21:33:55,2013-11-15 01:34:01
4528aa1aaf4ac69061de2537e071258894ed235d...19d6eb412cd6f47960737dd66bf1d1866e26986f,1,14,13,27,11,2013-11-18 21:38:43,2013-11-15 01:34:02
d7d2c87955f7700289c5b516f12579a5be4b879d...ca03c3682a45c9c10273cbdfaa48edea084ffd11,1,31,3,34,2,2013-11-18 21:30:51,2013-11-14 23:08:45
d7d2c87955f7700289c5b516f12579a5be4b879d...d007dbf7d6d647dbcf0f357545f43f36dec46f3b,1,0,1,1,1,2013-11-18 18:15:45,2013-11-18 18:15:45
d7d2c87955f7700289c5b516f12579a5be4b879d...c20e6fb1df0b9049377b0050599d320dd3822150,1,5,5,10,1,2013-11-13 22:06:17,2013-11-13 06:21:48
c20e6fb1df0b9049377b0050599d320dd3822150...b20cc13e73fcec3d80eed4d9fc7f6ee8acc206ac,1,23,23,46,20,2013-11-13 22:09:14,2013-11-13 06:21:49
d7d2c87955f7700289c5b516f12579a5be4b879d...70cce99441eac7ae35aa51586e71dd516ba0dc2e,1,7,8,15,3,2013-11-11 20:18:05,2013-11-08 17:54:05
e3f118594683b075d70fb479a81613f614a7b1f1...384364b5f1aa0c3b7610a1b3c9eca2c210e61b41,2,147,1,148,2,2014-03-07 23:22:37,2014-03-07 23:12:19
c302941cd7670357bcd8209218e5f73c39e13d16...dcbbc8fa2e4210b3b564361cf794464ce8968946,1,10,1,11,2,2013-11-27 18:44:13,2013-11-25 19:02:00
dcbbc8fa2e4210b3b564361cf794464ce8968946...e9e03a77994f4bf030760e2644f718776de0eb39,1,20,6,26,6,2013-11-27 18:44:15,2013-11-25 20:04:08
e9e03a77994f4bf030760e2644f718776de0eb39...cde0a0576c8950599ef11184bc35aea648f7e717,1,1,1,2,1,2013-12-02 20:46:01,2013-12-01 20:41:55
c302941cd7670357bcd8209218e5f73c39e13d16...bc380fca60080beb26f3e47ae7e5881abd5fc3f9,5,0,0,0,0,2013-11-25 23:01:22,2013-11-25 20:52:44
bc380fca60080beb26f3e47ae7e5881abd5fc3f9...2179b6727efb5493f9871f8903883d6359486208,10,0,0,0,0,2013-11-25 23:01:22,2013-11-25 20:53:54
2179b6727efb5493f9871f8903883d6359486208...2e820ba9bc4f565a5cea5d3f055f6c4595734700,4,0,2,2,2,2013-11-25 23:01:22,2013-11-25 20:55:30
2e820ba9bc4f565a5cea5d3f055f6c4595734700...30a3318ac06c639f0ccb25b3abf627b3120c4dc9,3,0,533,533,3,2013-11-26 22:21:15,2013-11-25 20:58:48
30a3318ac06c639f0ccb25b3abf627b3120c4dc9...b018c73526ca9d941c64d6a41d9c24968de38c2b,8,4,17,21,8,2013-11-26 22:21:26,2013-11-25 21:02:16
b018c73526ca9d941c64d6a41d9c24968de38c2b...c74c72034f061d1d9d5b8b1fba20ce0138d423b4,15,64,20,84,15,2013-11-26 22:23:52,2013-11-25 21:03:06
c74c72034f061d1d9d5b8b1fba20ce0138d423b4...11d62145b904b81013d1ad558d68a74e22e81a91,10,19,28,47,13,2013-11-26 22:23:56,2013-11-25 21:03:52
99a92f928fd02a87d841a8bb19511e7ce526819d...f1671ecbfa92825fa346fbf6964e1f09f2076b0e,1,61,43,104,24,2005-08-18 02:37:24,2005-08-18 01:20:08
0f3ddd4a3abe863fae9c36ec4311ac936a2d8ed9...2a8a4490c20e3f39dc15721b49715867511163ba,1,14,7,21,8,2012-06-12 20:23:17,2012-06-12 18:09:38
242cab397214b017ac837e870ac9950efc2968c3...f760c903b8525878cd3b426fc61a7a2cf8742609,1,25,7,32,8,2012-05-02 20:11:18,2012-05-02 19:53:50
d4018a5e4a79d0c7f17334f0724c773cfa8acd72...d8cf053dacb4f78920c112d10c7be21e4f5a5817,3,11,2,13,5,2012-09-30 06:20:47,2012-09-30 05:33:25
fa11d7c87940154f3f6463353335c6010b13e5db...f84667def209e4a84e37e8488a08e9eca3f208c1,1,12,0,12,3,2012-10-03 04:18:40,2012-10-03 04:18:40
261b5119c7a7cb778dd812cfb006b511c5bc4065...03c82da32e5b1143276b7b13084ec029f0f91561,1,4179,755,4934,648,2012-10-15 07:35:49,2012-10-15 07:35:49
1692579dd3569ebc01187872db91ee2ad93cc962...986977847e6fb46448fc9c567292ccd2a93d40b3,1,6,1,7,2,2013-01-14 17:15:39,2013-01-12 20:46:01
7c3932334ef57e78f8cd170e3337f218646d7077...df3dac3758e0b3e8178aff03fd0ceaf340735527,2,2,2,4,2,2010-01-28 08:41:52,2010-01-28 08:41:52
e984c54ada086e7676419b6b1b8a2d7a2429da48...73cf0822b2a4ffa7ad559d1f0772e39718fc7776,1,22,19,41,5,2009-10-28 06:38:43,2009-10-25 21:28:11
73cf0822b2a4ffa7ad559d1f0772e39718fc7776...b1a01e1c0762d117da7dac009b773f310479be12,1,14,3,17,4,2009-10-28 06:38:46,2009-10-25 21:28:12
b1a01e1c0762d117da7dac009b773f310479be12...95c96d48e65a597cfd2bf7228ddc8c7ca30b55b7,2,13,0,13,2,2009-11-15 00:03:06,2009-11-13 21:25:56
f5c3178151e3963cc8cf73fdc200831850b7a632...f2d50d937bd17eb413cb78ccb37c17c2d933f76d,1,1,1,2,1,2009-10-09 05:50:58,2009-10-08 15:21:44
f2d50d937bd17eb413cb78ccb37c17c2d933f76d...b5d18b8e6f68746a85edfea08e9aff3351d7e891,2,2,2,4,2,2009-10-09 05:53:12,2009-10-08 15:33:31
5e64650d938d7a23b73532b4a68bc6bd08cfd041...d2feb01aa580843261c25d8609369d17bcdf6028,1,20,20,40,20,2009-09-03 01:41:42,2009-09-02 09:23:10
b809d9cd0787e68f442c6795ec76580bb37d1a00...bed575e4002cfa1dfa7d87b9db38e69c6f600e2e,3,25,3,28,7,2010-01-13 08:01:53,2009-12-07 22:45:27
bed575e4002cfa1dfa7d87b9db38e69c6f600e2e...f9c01817bb7a0a7b61652ec8e3ac12c900526f0e,1,109,0,109,1,2010-01-13 09:13:56,2010-01-13 08:12:54
b809d9cd0787e68f442c6795ec76580bb37d1a00...02b47cd77e4af40da95a74c90846965a2ea6999b,3,24,2,26,6,2009-12-03 20:41:22,2009-12-02 22:16:18
02b47cd77e4af40da95a74c90846965a2ea6999b...788070a261ecc3a37a7e0ed9301ecec4a333586d,3,29,0,29,3,2009-12-03 20:41:37,2009-12-02 23:49:19
b809d9cd0787e68f442c6795ec76580bb37d1a00...5d2dcc423ec689ff4a6bcb83b00d5b43657b0c88,3,3,3,6,5,2009-12-03 18:08:54,2009-12-02 21:28:40
e2d2e383d87dcbcd296ca9f21f3c8b7ef853c928...bbc09c22b9f7784b1aab71d4876227956e6e8f4f,5,8,324,332,18,2010-01-13 09:04:54,2010-01-13 03:06:41
bbc09c22b9f7784b1aab71d4876227956e6e8f4f...885d211e714b3787cd059e347694f9b24e1db1f3,1,1,8,9,2,2010-01-13 09:05:04,2010-01-13 03:21:46
885d211e714b3787cd059e347694f9b24e1db1f3...7e622650d756955a94f546866eddd51506aa93a3,2,8,1,9,4,2010-01-15 20:54:00,2010-01-15 20:50:54
7e622650d756955a94f546866eddd51506aa93a3...308162372d0aa202ff45743e02253e20a4fac4d7,2,78,0,78,5,2010-01-15 20:54:02,2010-01-15 20:52:40
bc29df602267b1e5783a93d6ff10909c597e5fdc...e1f8f0cfbef594edd12aba13df8ec53d401ce944,1,1,1,2,1,2009-09-06 07:39:14,2009-09-06 06:46:25
e1f8f0cfbef594edd12aba13df8ec53d401ce944...14b772a0d7cb983ab0c13d672ea89192c460d070,1,3,3,6,1,2009-09-06 07:39:15,2009-09-06 06:47:20
f324cb50be3d88c6fb6123c85da749695a749f60...2b72ccb20a3b758afb9de410a955f01d1b411414,1,416,0,416,1,2009-09-03 16:49:13,2009-09-03 12:15:00
3266de10747c4ad3fa972994004fcb0fca9ebe1f...850bc56defe2abf68ce26c5c80761d3df59c2ba7,1,2,5,7,2,2013-01-08 21:20:45,2013-01-07 11:57:09
d64a09fe223cec5535aec246dba87ec24d0158bb...2cbd969bcfef26b32c78bfbe475ce0ad9646ea06,2,11,3,14,5,2011-06-09 01:29:48,2011-06-09 01:29:48
2cbd969bcfef26b32c78bfbe475ce0ad9646ea06...2c162b56f370f5c33e6a945e6922d598006c5ec4,2,9,1,10,2,2011-06-09 16:22:44,2011-06-09 07:08:57
485cdb9bd8bd7de6c7099c1c3e9c6fca6a60fdd3...7cd52b5b4bf3be1f5d33fed889af186aae1ea7b8,4,29,35,64,8,2011-04-05 06:20:39,2011-04-05 05:40:23
cd3065f9e3c27594a91540e971d147f1acba89de...8523d071ad350539ab0f7e6efe192b8530320962,1,1,1,2,1,2011-03-25 21:12:00,2011-03-25 18:08:36
8523d071ad350539ab0f7e6efe192b8530320962...d6d9e76d7f06c5ba94517d258e051544885780c5,1,2,1,3,2,2011-03-25 21:13:57,2011-03-25 18:09:03
459a18864fe5afaf1d7a7856906c921d6b756733...38743b7d10cfacca3b1b74ba5edc2bb1cd277597,2,2,0,2,2,2010-01-23 00:15:14,2010-01-20 19:25:51
38743b7d10cfacca3b1b74ba5edc2bb1cd277597...3521c1bf5bd9323567715b3e8b369075a7f50ec1,1,1,1,2,1,2010-01-23 00:15:16,2010-01-20 19:34:14
3521c1bf5bd9323567715b3e8b369075a7f50ec1...c2c2be137ac491c17c4fe1fdd27b6a8ac5c1e6c6,1,26,1,27,6,2010-01-23 00:34:50,2010-01-23 00:34:50
c2c2be137ac491c17c4fe1fdd27b6a8ac5c1e6c6...aba7dea83bfba411dee0271491d6199d2dca61d9,1,3,0,3,1,2010-01-23 00:35:42,2010-01-20 19:45:12
994fd91d1fd5e9feffc88ab7db19e9c9461b4543...2147f844ed13fa5052161d38f8cf7dca6f83c06e,2,21,12,33,8,2012-07-24 16:03:33,2012-07-24 12:17:03
235db154f8b92e53b97ffb93725d394b6e20f398...d17982f19c570744c98c10c167d54024e9d22909,1,59,1,60,6,2009-08-29 02:48:56,2009-08-29 02:48:56
d17982f19c570744c98c10c167d54024e9d22909...53a1116c611e9e717d90e1406b29d97648460773,5,28,29,57,6,2009-08-29 21:07:25,2009-08-29 09:04:52
53a1116c611e9e717d90e1406b29d97648460773...f7aec129fa78e39e200352502377f57952516f98,10,11,5,16,11,2009-08-29 21:08:03,2009-08-29 09:05:00
84b051462fcaf9892f31f178a47c261ddd5c9695...85b3c75f4fd3aa4da976bac702827dc8d7d1bf15,1,15,2,17,1,2011-09-23 21:28:17,2011-08-01 01:52:41
39add7a36feca434ba85267cb76e4fd69bcdc13a...625a860cb73b259683a4285705ac17e92298d5d5,1,1,1,2,1,2009-11-23 00:14:48,2009-11-22 21:19:53
625a860cb73b259683a4285705ac17e92298d5d5...73a1d050c47dfa0fc758eedd9d3bb60b7449e14f,1,2,2,4,2,2009-11-23 00:20:28,2009-11-22 09:47:04
73a1d050c47dfa0fc758eedd9d3bb60b7449e14f...b48275998399561780af85d429da3caceeecd2fe,2,9,0,9,3,2009-11-23 00:20:59,2009-11-22 15:58:09
b48275998399561780af85d429da3caceeecd2fe...37bb5d744309df6ff05ea5f34112082cdc301d69,2,38,9,47,3,2009-11-23 00:22:02,2009-11-22 16:15:29
37bb5d744309df6ff05ea5f34112082cdc301d69...3288f20171ce6aee5d9d51d111ee17cd4b426af4,1,4,0,4,1,2009-11-23 00:22:18,2009-11-22 16:15:31
39add7a36feca434ba85267cb76e4fd69bcdc13a...4d0157d6995925ea55ff181ea94d058583333f90,1,2,0,2,2,2009-11-22 20:54:59,2009-11-22 20:37:06
4d0157d6995925ea55ff181ea94d058583333f90...9be30eed61993a6f2d04a1609723e64e7632a64e,2,26,0,26,3,2009-11-23 02:15:42,2009-11-23 02:11:32
39add7a36feca434ba85267cb76e4fd69bcdc13a...64485b4aba98b39f2cf4528aed95b6ddca62f332,2,21,8,29,3,2009-11-22 20:08:00,2009-11-22 19:43:20
64485b4aba98b39f2cf4528aed95b6ddca62f332...38a39647b43ea57c96bd6e4a351d0d5353c805bb,1,6,3,9,2,2009-11-22 20:08:04,2009-11-22 19:43:42
38a39647b43ea57c96bd6e4a351d0d5353c805bb...f9821e2b2139e5e2fbe9fde3df58ddc98ae4ce19,1,8,8,16,7,2009-11-22 20:08:07,2009-11-22 19:43:53
f9821e2b2139e5e2fbe9fde3df58ddc98ae4ce19...c34ec65567793d16119c28df6ebeecfe8eb3d9f5,1,2,2,4,2,2009-11-22 20:08:08,2009-11-22 19:53:29
c34ec65567793d16119c28df6ebeecfe8eb3d9f5...5c931c8da2db4a8e0b5713e97cce474b6596e2ff,1,7,5,12,3,2009-11-23 09:21:51,2009-11-23 07:40:24
6ea71fe7d36cf5b81c2100d97a822ecf0bc04746...75194438f412714f4e82ca01e9038dc6714498c4,7,51,1,52,8,2009-09-12 04:33:20,2009-09-09 11:38:58
75194438f412714f4e82ca01e9038dc6714498c4...edf563fbaa2ab50734db4a61e9092f25fbb5a417,4,15,0,15,8,2009-09-12 04:33:24,2009-09-09 11:43:03
6ea71fe7d36cf5b81c2100d97a822ecf0bc04746...e4b48eaab724d9fd5941c6a683a34ee38a864897,2,60,15,75,15,2009-09-07 21:53:56,2009-09-07 12:40:00
6ea71fe7d36cf5b81c2100d97a822ecf0bc04746...d071d942963fa76b11826f25c54fdfd8b09d7626,1,28,25,53,17,2009-09-07 19:58:45,2009-09-07 08:56:00
d071d942963fa76b11826f25c54fdfd8b09d7626...1c2eafb89bcaf2ddbf4dfb93df19673c0fadaaeb,5,106,10,116,13,2009-09-08 08:18:46,2009-09-07 08:56:33
d7d3b56bb15256af63a61c6f00e367eba36a647a...cd7c0be19f49efe77a8b0690ab92d2eb1cff1778,3,11,2,13,5,2012-08-15 20:39:53,2012-08-15 20:39:53
e15c16de396a1e1f42001b03cb885ce64eb4098e...fa0aad4ff5079132e0a163daa701506d652b2bf8,2,2,1,3,2,2012-08-08 16:59:17,2012-08-08 07:58:27
e15c16de396a1e1f42001b03cb885ce64eb4098e...90b29cb7a8213a947e08c41ea4680ced7ac7c67c,1,2,1,3,1,2012-08-07 22:01:37,2012-08-07 05:01:49
c9de921848061db9316fe8dc2ebff4bcadf8117f...bd5bce7cbc55fa52277cc8a39f673c3e2dc60670,3,16,2,18,3,2011-11-18 19:28:05,2011-11-18 19:28:05
b73c6834dd8796a9d6a8443dfd75368f5a91e5c2...c9e7aa4f689e08510e3c68e85687ed4f6778c870,1,40,1,41,6,2011-10-14 05:18:04,2011-10-14 05:15:39
541d1fa85ca4741e8b6db281f3d788dcfc423bdc...f23e8decd544c8f81b40c98211f6cb028fa70cdc,3,60,2,62,5,2011-05-06 22:12:30,2011-05-06 19:27:05
f23e8decd544c8f81b40c98211f6cb028fa70cdc...8c5cea0095ee57c36fddfb9016810c230ce26557,1,14,2,16,4,2011-05-06 23:03:37,2011-05-06 21:59:47
60dafdd37d7df358b6ff67b317dbe738b50ea6d6...b499549401cb2b1f6c30d09681380fd519938eb0,5,152,10,162,17,2010-03-24 21:42:57,2010-03-24 20:34:04
6eb3adff9e3b4d37903c8a2e0e708049ad154617...7ff8b790bb6a0733177ab712cc7e4374a218f34b,2,35,1,36,2,2010-03-08 08:50:37,2010-03-08 08:50:24
3bfc45047654c7dd38b32033321228e97fc8f60e...eee49b6ce4b7b3fed28794676c67ad3609f658ac,3,47,17,64,12,2010-04-10 18:51:56,2010-04-10 17:01:12
8be1d04a7e9251380a5de80564284f0099774038...08f19cfe9bff097e8828a289d2daf5f066e1af9d,1,6,3,9,1,2014-01-14 18:47:36,2014-01-14 18:26:21
809780b662355a9ded05b450a07bbe79d0d2e26e...e5afb3a6f96e4d3a8733fbeee2c3cb44829e386b,1,4,1,5,1,2010-03-14 20:02:47,2010-03-14 15:15:33
e5afb3a6f96e4d3a8733fbeee2c3cb44829e386b...f60812efa3a790b0a2be389b7531a090d8369892,1,7,2,9,5,2010-03-14 20:02:47,2010-03-14 15:16:09
f60812efa3a790b0a2be389b7531a090d8369892...134550fe21f2c70519b32cada993bfd0c644925b,1,67,1,68,8,2010-03-14 20:02:47,2010-03-14 15:16:45
caa9c3cabe9c2719a340425db5c0968fd3588fc9...14e940d719e9d3250b802fbc975210dafaf896d8,1,2,1,3,1,2010-03-03 22:33:22,2010-03-03 22:19:10
14e940d719e9d3250b802fbc975210dafaf896d8...2ea6c2c9ab6555cbd48ca017bf5027162707a0b1,1,1,0,1,1,2010-03-10 07:15:01,2010-03-09 14:55:32
44e0f450350661b110c61ea0eff2657f58fe6ad0...1b22b6c897efa8aec6eeb51f72a73d507d5e336f,4,33,55,88,9,2010-02-17 23:30:20,2010-02-16 23:42:54
1b22b6c897efa8aec6eeb51f72a73d507d5e336f...f965c525a4d04837b1b7ed43e3fa2dc8c0df4e2b,4,28,28,56,4,2010-02-23 21:10:56,2010-02-23 20:02:37
7d181222ea568ada9952f23a8f92b35bce161cc2...3609ad8ec204f337f6fe12b3487b57e0d40c0d88,1,25,1,26,4,2010-03-05 06:39:38,2010-03-05 06:39:38
b599672316ae0e0cf827e5e2cd6d3bb403d7b8cd...5f02d31597df35ca98e9080e12bfbb18dadadcbe,1,16,9,25,3,2010-02-17 03:19:05,2010-02-16 02:34:28
b599672316ae0e0cf827e5e2cd6d3bb403d7b8cd...6977c250ac6cacb5ee441bff832fdeab4d0cd8f9,1,23,0,23,1,2010-02-16 07:04:34,2010-02-16 06:55:21
6977c250ac6cacb5ee441bff832fdeab4d0cd8f9...1caaf225f86b7b1818103e72774e191fb1f3d0bb,1,15,0,15,2,2010-02-22 05:57:19,2010-02-22 02:58:44
e90fdc39b6903502192b2dd11e5503cea721a1ad...ab62677b1424d4e53cf222c973b841d3dada4cf3,1,1,1,2,1,2010-02-17 18:55:12,2010-02-17 04:18:50
e90fdc39b6903502192b2dd11e5503cea721a1ad...420acb31acbfbd78e0c35ac0c614de8717daed0a,1,10,5,15,2,2007-08-01 18:34:13,2007-08-01 18:26:59
420acb31acbfbd78e0c35ac0c614de8717daed0a...96ffe892e307ea512abbc633f822558c568cece1,2,18,2,20,3,2007-08-02 00:56:28,2007-08-01 14:59:35
96ffe892e307ea512abbc633f822558c568cece1...21e9757e31d136fad0c04f3ce9da11b8b128b4f2,1,13,6,19,4,2007-08-02 00:58:12,2007-08-01 12:57:43
21e9757e31d136fad0c04f3ce9da11b8b128b4f2...08874658b450600e72bb7cb0d0747c1ec4b0bfe1,1,3,2,5,2,2007-08-02 01:00:17,2007-08-01 21:47:20
08874658b450600e72bb7cb0d0747c1ec4b0bfe1...6d4bbebd35e3a6e8091d7188f1c4d49af7f054e3,2,5,6,11,6,2007-08-02 01:15:43,2007-08-02 01:14:41
6d4bbebd35e3a6e8091d7188f1c4d49af7f054e3...434e6ef89d73dcc812b3a44dfaff0ca8204a206e,4,26,26,52,19,2007-08-02 01:15:43,2007-08-01 15:43:06
434e6ef89d73dcc812b3a44dfaff0ca8204a206e...c9e6589288b09f4e631c7f12f0f9a77c29851632,2,9,1,10,3,2007-08-02 01:17:56,2007-08-01 22:31:03
c9e6589288b09f4e631c7f12f0f9a77c29851632...50cff52f1a896118d5260c752900188e7d231cf6,1,1,0,1,1,2007-08-02 02:52:17,2007-08-01 23:48:44
a9ab2009dbbf769aadd52957950c1bad60a0c8fd...324a8bd0cfb696458bc651d3713d7523fd0d7479,2,31,2,33,8,2007-08-18 02:03:32,2007-08-18 01:51:12
a9ab2009dbbf769aadd52957950c1bad60a0c8fd...97a5d8cce913aa1727a026a07422a0c9b5ca0e38,1,1,1,2,1,2007-08-17 09:44:09,2007-08-04 14:25:53
97a5d8cce913aa1727a026a07422a0c9b5ca0e38...e63b58ba0b67262674c94321693c4f84a58ecf80,1,1,1,2,1,2007-08-17 22:20:35,2007-08-17 21:38:24
e63b58ba0b67262674c94321693c4f84a58ecf80...5876b8ee3c09553912a4d033051bb25faa52ad94,2,2,2,4,2,2007-08-17 23:32:57,2007-08-17 23:13:04
5876b8ee3c09553912a4d033051bb25faa52ad94...0734d2656a3098f66b835b35f9f81079854ebb9f,1,6,9,15,2,2007-08-17 23:51:15,2007-08-17 20:13:36
0734d2656a3098f66b835b35f9f81079854ebb9f...374a58c9fbd4613800d01087c77373e561db90ae,1,32,0,32,4,2007-08-19 07:38:33,2007-08-12 18:46:12
374a58c9fbd4613800d01087c77373e561db90ae...c905e09006838c209be842dbe740943b2ad2d25b,1,11,11,22,11,2007-08-19 07:38:34,2007-07-15 08:57:40
c905e09006838c209be842dbe740943b2ad2d25b...ea08a6fd194991f9d800e4cac5ae55fdb02dd235,2,52,1,53,3,2007-08-19 07:38:34,2007-08-03 03:37:21
ea08a6fd194991f9d800e4cac5ae55fdb02dd235...3149007475f8c38ee66b448af9c55fc102534c46,1,1,6,7,1,2007-08-19 07:38:34,2007-08-01 04:32:36
3149007475f8c38ee66b448af9c55fc102534c46...401d53fa35098266e2a4a904a4598b59f1b74663,3,69,2,71,6,2007-08-19 07:38:35,2007-08-01 04:05:15
401d53fa35098266e2a4a904a4598b59f1b74663...2c570cde98cfde704ee67ea29031493c633f971e,3,39,5,44,8,2007-08-19 07:38:35,2007-08-01 04:24:25
2c570cde98cfde704ee67ea29031493c633f971e...1fdb649c6ac4cfc536983077b4851a1959cbc1c4,3,74,17,91,19,2007-08-19 07:38:35,2007-08-01 06:22:53
1fdb649c6ac4cfc536983077b4851a1959cbc1c4...ac053c02029d88c7ed4d7e92949a1586eb3f7704,3,84,0,84,8,2007-08-19 07:38:36,2007-08-01 14:23:08
ac053c02029d88c7ed4d7e92949a1586eb3f7704...8acb3297f34fd04bb8f3a35ace3667b59236286e,1,93,0,93,2,2007-08-19 07:42:41,2007-08-03 06:00:37
8acb3297f34fd04bb8f3a35ace3667b59236286e...904b1941514e78543bd636b4db71fbcf57898388,1,58,4,62,10,2007-08-19 07:42:41,2007-08-03 08:47:04
904b1941514e78543bd636b4db71fbcf57898388...7e5dcea8311472156ed0fea164e689777353f931,1,5,3,8,5,2007-08-19 17:11:01,2007-08-19 09:50:18
47282d4646372aa859908c3b9471b96c385abe5f...88dce86f38bed84abadd73bbc40d9df92b7519db,1,4,0,4,1,2007-07-09 01:06:43,2007-07-09 01:06:43
57887443c24e5a2b4b04e7db69b44b53d8e87b44...8d2244ba74f5207b9f7f9f1b4efbcccacbbb2c7b,1,20,0,20,3,2007-07-02 23:41:18,2007-07-02 12:56:58
f8186e92e3399ddd742f2397e802467cabf2849f...d4c5307701551ec65c10bef0dacc643205313098,1,6,1,7,1,2007-07-08 21:41:24,2007-07-08 21:41:24
d4c5307701551ec65c10bef0dacc643205313098...d696702209dd0d4c20d2b87b5bc10cae3d54e839,1,59,16,75,6,2007-07-08 23:18:01,2007-07-08 22:48:08
d696702209dd0d4c20d2b87b5bc10cae3d54e839...a840566770c262f76e8fd7fb69239fbedd10b259,1,9,1,10,3,2007-07-09 00:54:47,2007-06-21 04:44:16
7fa1365c54c28b3cd9375539f381b54061a1880d...89ea90351dd32fbe384d0cf844640a9c55606f3b,1,6,10,16,7,2015-01-08 21:55:10,2014-12-03 04:20:49
7fa1365c54c28b3cd9375539f381b54061a1880d...ac1596a684a44144efa2d52d9104b0d627e6d9a1,3,14,3,17,8,2014-12-15 23:17:25,2014-03-24 21:38:27
ac1596a684a44144efa2d52d9104b0d627e6d9a1...2cf770f50185fc7a1e3aaa0463eb452d32517f83,1,33,0,33,1,2014-12-15 23:18:24,2014-12-04 19:11:30
7fa1365c54c28b3cd9375539f381b54061a1880d...a0d4923ddfb65c91d2b84ca74eee09424f986a8b,3,3,7,10,3,2014-12-12 19:23:45,2014-12-12 19:16:38
7fa1365c54c28b3cd9375539f381b54061a1880d...10c497aa0cc7ccb5bd213f53fc0cd803bd73a508,1,11,9,20,6,2014-12-10 17:27:24,2014-12-10 10:40:07
10c497aa0cc7ccb5bd213f53fc0cd803bd73a508...6a49870a7245934eac671e3dcd7186a90dac255d,1,15,12,27,10,2014-12-10 17:28:54,2014-12-10 10:40:19
6a49870a7245934eac671e3dcd7186a90dac255d...ea417833ea9a07d7b8d568358ff20f57851cb26e,1,2,3,5,2,2014-12-10 17:40:33,2014-12-10 10:40:36
7fa1365c54c28b3cd9375539f381b54061a1880d...27234a2ef3815050f7df5bf6ad356580f845a3ea,1,3,0,3,1,2014-12-04 20:16:04,2014-12-04 15:23:05
7fa1365c54c28b3cd9375539f381b54061a1880d...ff7aa81f8971daf29826b3881e0e2df5bd7df90c,1,9,0,9,1,2014-12-04 20:10:52,2014-12-04 13:26:44
ff7aa81f8971daf29826b3881e0e2df5bd7df90c...356e91f2ecc581f3a446bba566ab1756dc57a583,2,14,4,18,6,2014-12-10 00:27:47,2014-12-08 16:28:45
7fa1365c54c28b3cd9375539f381b54061a1880d...85ed2f32064b82e541fc7dcf2b0049a0556e4960,1,10,0,10,1,2014-12-04 20:10:26,2014-12-04 18:07:35
7fa1365c54c28b3cd9375539f381b54061a1880d...d543d9c0f44a89f30ec1670f16c698b5da801476,5,113,7,120,6,2014-12-04 19:58:36,2014-12-04 02:24:17
7fa1365c54c28b3cd9375539f381b54061a1880d...59b386526a6cdd0289cdf35dd8038ae1bdfd630f,4,19,1,20,5,2014-12-04 18:11:12,2014-12-04 03:46:48
59b386526a6cdd0289cdf35dd8038ae1bdfd630f...e652c0eb5d772076f92245c7e076bf6aaf6af223,2,16,4,20,3,2014-12-04 18:22:42,2014-12-04 03:52:29
7fa1365c54c28b3cd9375539f381b54061a1880d...814dd8e07890c442480c5aacff9a7f1d10beb062,2,0,21,21,2,2014-12-01 16:39:43,2014-12-01 16:39:43
7fa1365c54c28b3cd9375539f381b54061a1880d...b799a696b221ff72d25cc06ac9fd7535ff08fc88,1,1,1,2,1,2014-12-01 02:50:35,2014-11-28 18:00:11
7fa1365c54c28b3cd9375539f381b54061a1880d...59362e560d3c439e77768983b00eade08be9bc3e,4,21,12,33,17,2014-12-01 00:39:47,2014-11-24 19:33:54
7fa1365c54c28b3cd9375539f381b54061a1880d...7d665f35849309faaa73cdfbf23210950cd4389d,1,1,1,2,1,2014-11-25 18:06:08,2014-11-24 23:03:31
7fa1365c54c28b3cd9375539f381b54061a1880d...3a0a3a8972369060a1eff8353b64bf7377714b22,1,2,1,3,1,2014-11-25 00:02:38,2014-11-23 17:14:55
7fa1365c54c28b3cd9375539f381b54061a1880d...bba5fccc03a936982d1ee388f2c957c4d239e504,1,1,1,2,1,2014-11-24 19:34:32,2014-11-24 18:29:37
7fa1365c54c28b3cd9375539f381b54061a1880d...0edad17d6728df055c3b92bf89d5329f0afdcefd,1,4,0,4,1,2014-11-20 18:13:25,2014-11-20 15:15:31
0edad17d6728df055c3b92bf89d5329f0afdcefd...d0e08d62335ce9685ac547287771e589587334b6,1,13,14,27,8,2014-11-20 18:52:23,2014-11-20 15:15:51
d0e08d62335ce9685ac547287771e589587334b6...cb357221a402c55b23bf99ec9f3b361709d45fa7,1,8,0,8,1,2014-11-20 18:54:10,2014-11-20 15:16:09
7fa1365c54c28b3cd9375539f381b54061a1880d...13dbf46a397260675a16b506314b0b2ed9713bbb,1,5,1,6,2,2014-11-18 19:23:10,2014-11-18 17:10:22
7fa1365c54c28b3cd9375539f381b54061a1880d...e204b001cfa33e36eb06bc9d2437d75fc4efafe8,1,3,0,3,1,2014-11-18 18:15:14,2014-11-18 17:43:09
e204b001cfa33e36eb06bc9d2437d75fc4efafe8...64c07db9ad98fdeb43e739bdabd4cc423b10c272,1,5,5,10,5,2014-11-18 19:15:04,2014-11-18 18:38:38
64c07db9ad98fdeb43e739bdabd4cc423b10c272...ca2051d6e3a7cf1d562d9dd1e465766d30093b0b,1,3,0,3,1,2014-11-18 19:15:50,2014-11-18 18:43:47
7fa1365c54c28b3cd9375539f381b54061a1880d...83915ba5219955e8c0b747ec413afe4f78bea289,1,2,2,4,2,2014-11-17 16:54:34,2014-11-15 13:27:21
7fa1365c54c28b3cd9375539f381b54061a1880d...ba6fad02b6cbbfbf5acf3303b4d8ddfd8624fdb2,1,1,1,2,1,2014-11-17 16:45:50,2014-11-16 21:06:26
7fa1365c54c28b3cd9375539f381b54061a1880d...8942821ec046238b6cea12e6dd4dfa7ba51c133e,2,21,19,40,2,2014-11-13 18:53:50,2014-11-13 10:40:07
7fa1365c54c28b3cd9375539f381b54061a1880d...f904f6603a0c34645dbb307408e0e4033b5e1113,1,1,1,2,1,2014-11-13 18:41:56,2014-11-13 07:36:07
7fa1365c54c28b3cd9375539f381b54061a1880d...c4f901d1593f3ef097c3e73daa2847ed9ad9efe0,1,15,12,27,7,2014-11-13 18:40:41,2014-11-12 13:10:22
f6f61cbbad0611e03b712cc354f1665b5d7b087e...022cf2bf88e63c8f19935d0b66abf20e6dde1c8a,1,1,1,2,1,2014-11-11 22:46:08,2014-11-11 19:13:36
80b581dd099c4307e5a5775fe7b0ffbdb50ae937...6066a7eac4b2bcdb86971783b583e4e408b32e81,1,2,2,4,2,2014-11-10 22:43:19,2014-11-10 21:17:00
4d7a5ceacc97e69c4ab5e1543f61fafafb963a9c...21b138d0f64d99b55e901f90d4211e036b881e64,1,28,25,53,17,2014-12-01 21:57:28,2014-12-01 21:57:28
21b138d0f64d99b55e901f90d4211e036b881e64...0855331941b723b227e93b33955bbe0b45025659,4,116,2,118,6,2015-01-08 22:28:43,2014-12-01 23:29:54
908a3203632a02568df230c0fccf9a2cd8da24e6...85cb1d0ba883627f38ad994aa489bf0b3dc40f7f,1,1,1,2,1,2015-01-22 20:23:42,2015-01-22 11:59:36
5fdcf75c68d2c382de54af4e55713ca770bb9031...c075aea5da6c35edfe86da7d3edced67cdb009c8,1,4,0,4,2,2007-05-24 20:36:54,2007-05-24 19:20:42
c075aea5da6c35edfe86da7d3edced67cdb009c8...0b1f113075aafb0c91a406d984d0152e55c981da,1,1,0,1,1,2007-05-25 01:56:06,2007-05-25 01:46:22
88bf110494c7f0dd3bcef7b7a8aebbbc2e9a826b...b49c452bb178cbf4dd0d46d88b564e3246b55da2,2,74,1,75,2,2010-09-01 22:11:07,2010-09-01 21:17:32
b49c452bb178cbf4dd0d46d88b564e3246b55da2...1e2847634e7f171b1625295e3f41c1660ff4a61f,1,6,11,17,8,2010-09-03 16:33:23,2010-09-01 21:01:49
1e2847634e7f171b1625295e3f41c1660ff4a61f...4bf9dd97827bf6f475a52e8f621dad24a3db9b4c,2,3,3,6,3,2010-09-03 16:34:32,2010-09-01 21:28:27
154adcf9c08218077275f7a4c7a6e61632516561...8c7d05171e8c7588b3f87b66b1428ac298d72ba1,1,165,0,165,1,2011-02-27 09:21:27,2010-09-06 10:37:10
8c7d05171e8c7588b3f87b66b1428ac298d72ba1...23fcc98f7f4880829ab47210278ff9ff3c7d5f59,1,57,37,94,29,2011-03-23 22:57:10,2011-03-02 01:51:01
154adcf9c08218077275f7a4c7a6e61632516561...f98548764ea0baf7490b76782e323f90a941cc74,1,7,7,14,7,2010-09-10 00:11:06,2010-09-09 19:15:57
f98548764ea0baf7490b76782e323f90a941cc74...a1d558d254f84e4b816497fe30b2b8ef0b47ba71,1,2,0,2,2,2010-09-10 00:11:06,2010-09-09 19:15:58
a1d558d254f84e4b816497fe30b2b8ef0b47ba71...f31dbdc7dad3511e1ee73cb04a032773d11231cd,1,3,0,3,2,2010-09-10 00:15:58,2010-09-09 18:56:36
f31dbdc7dad3511e1ee73cb04a032773d11231cd...042cca38866569ca8a64c6ef1f95c58b157e4d36,1,28,2,30,2,2010-09-10 00:16:08,2010-09-09 18:56:37
042cca38866569ca8a64c6ef1f95c58b157e4d36...bff42061214e17f342efc909c73f29bf66df51e9,1,5,0,5,1,2010-09-10 00:19:18,2010-09-09 19:02:47
154adcf9c08218077275f7a4c7a6e61632516561...56bfd762e5e602031eab8ce881b8ab0c50d2cfcc,1,66,0,66,1,2010-09-10 00:01:32,2010-09-08 06:40:40
56bfd762e5e602031eab8ce881b8ab0c50d2cfcc...86273e5764ab7faaa84c3de1a428ed24a6cfdf1f,2,10,10,20,4,2010-09-10 00:03:02,2010-09-08 06:40:41
154adcf9c08218077275f7a4c7a6e61632516561...06f44c3cc5ca5eca638f300a518c65aa98d26d6d,1,46,4,50,8,2010-09-09 22:47:47,2010-09-06 12:33:19
b312b4123b053898a583aa6e8da1b26ea828105a...3b21a438c99b38c772247201d30b7ee80b278463,2,2,2,4,2,2011-01-27 01:26:58,2011-01-27 00:26:59
3b21a438c99b38c772247201d30b7ee80b278463...4ac5356c62d02b118c49cd85f88c7e6f65590400,1,1,0,1,1,2011-01-27 01:27:02,2011-01-27 00:27:11
6a7f71d376becc1a5b0357b682dd0c20842104b0...f6918da789b07fabbc82e189d0bac50a79622828,1,6,2,8,1,2011-08-29 06:50:04,2011-08-29 06:42:21
6a7f71d376becc1a5b0357b682dd0c20842104b0...cc5c54e78b18c2edc42228c06dab22002fa304fa,1,33,29,62,8,2011-06-08 23:39:33,2011-06-08 18:29:01
a35138af75070adb32cf281a56186c9343af36a4...99f790f22e2b2dabf00cf386339e829fe2bac6bc,1,6,2,8,2,2011-03-15 23:06:58,2011-03-15 12:08:01
99f790f22e2b2dabf00cf386339e829fe2bac6bc...d53de8b97de9d3c037c873cd8e01041cf9d51a39,1,20,7,27,8,2011-03-15 23:07:15,2011-03-15 12:08:02
d53de8b97de9d3c037c873cd8e01041cf9d51a39...afa1dd9a46d02a2a893840427e06fe847c8a531a,1,1,1,2,1,2011-03-15 23:07:21,2011-03-15 12:08:03
a35138af75070adb32cf281a56186c9343af36a4...67e6d817945202427977cf950b5ccbad3060e9e4,1,0,7,7,2,2011-03-15 19:23:29,2011-03-15 10:09:24
67e6d817945202427977cf950b5ccbad3060e9e4...3c995beb14b7aef9fa724cde9d2b7a4ea4ae53cc,1,2,1,3,1,2011-03-15 19:23:29,2011-03-15 09:05:10
3c995beb14b7aef9fa724cde9d2b7a4ea4ae53cc...e91b6c504961a147f0ab4e2fc05be914f881290a,1,1,6,7,2,2011-03-15 19:23:29,2011-03-15 09:04:15
e91b6c504961a147f0ab4e2fc05be914f881290a...8f323c00dd3c9b396b01a1aeea74f7dfd061bb7f,7,4,16,20,12,2011-03-15 19:23:30,2011-03-15 09:04:49
8f323c00dd3c9b396b01a1aeea74f7dfd061bb7f...95a1d12e9b9faddc02187ca28fdeb4fddd354c59,1,5,18,23,4,2011-03-15 19:23:57,2011-03-15 10:10:45
1368f65002bf39fdde7dd736a75ae35475184371...75323459b8a773613374188ad4439a7b45cd9e34,1,3,0,3,1,2011-02-11 18:13:14,2011-02-11 10:36:44
75323459b8a773613374188ad4439a7b45cd9e34...3446a54c9afe3f78ca27fc51f618884ba49493de,1,1,1,2,1,2011-02-11 22:24:34,2011-02-10 22:59:31
54f4cd9e8c7992f70d16efac3c6fc0a18ac0b156...3f142468997f9d14d8051a96b2e9db265d41ac0d,1,2,2,4,2,2011-01-12 20:43:58,2011-01-12 18:29:14
4a689afb030c1cd5aa1c141db94bbf9dde42f05e...4be0c3522421329f255a1cd9021ee86519f00f96,2,2,2,4,2,2010-12-17 19:53:53,2010-12-16 07:16:49
4be0c3522421329f255a1cd9021ee86519f00f96...8e8aa44057b1f92bad43a0bd3a2d448e9cb45b18,1,1,1,2,1,2010-12-17 21:40:32,2010-12-16 22:38:42
8e8aa44057b1f92bad43a0bd3a2d448e9cb45b18...b34f69f9916e52e742f35c2f88286375142260de,1,2,2,4,2,2010-12-19 06:58:40,2010-12-18 16:17:53
b34f69f9916e52e742f35c2f88286375142260de...0c806a06a311081ba02f60ffd2711853c1b9d6fc,1,0,3,3,1,2010-12-19 06:58:40,2010-12-18 05:38:38
0c806a06a311081ba02f60ffd2711853c1b9d6fc...05bb5a2584ca0e1c87a2135a83c5573b9337d06f,1,47,42,89,2,2010-12-19 06:58:45,2010-12-18 20:02:13
d391c0ff94e1b314b0664db0e8eb5bd92934f9cb...6517cf7de8fe7a2b2c90655a79d11cba586a36e6,2,14,12,26,10,2010-09-29 23:53:25,2010-09-29 11:35:22
6517cf7de8fe7a2b2c90655a79d11cba586a36e6...ab3b7b9a6e3bf5793520f06eb76fb03ffe8231cb,2,78,0,78,5,2010-09-29 23:53:25,2010-09-29 11:35:23
ab3b7b9a6e3bf5793520f06eb76fb03ffe8231cb...900647104e02e545064789f3c6b90a5807fba07b,6,30,21,51,29,2010-09-29 23:53:25,2010-09-29 11:35:24
5879b6bbcaba7696e4abfa717748da166f915405...6348624010888bd2353e5cebdc2b5329490b0f6d,1,2,0,2,1,2010-09-15 19:33:09,2010-09-14 20:09:20
5879b6bbcaba7696e4abfa717748da166f915405...ae69fd0481fa7bb39ee9ee68dc2e009d500e3b1d,1,3,14,17,3,2010-09-15 17:14:15,2010-09-15 02:21:42
ae69fd0481fa7bb39ee9ee68dc2e009d500e3b1d...829ef383a2b03a614d7d23e575270f2b10a805c1,1,7,2,9,1,2010-09-15 17:14:16,2010-09-15 02:21:43
829ef383a2b03a614d7d23e575270f2b10a805c1...000866909a5d9233c89d8fcc33a8125cc84f24d6,1,15,3,18,4,2010-09-29 20:09:48,2010-09-27 15:19:09
5879b6bbcaba7696e4abfa717748da166f915405...89bf1bace388c118137261e852635db92e607888,1,2,1,3,2,2010-09-14 19:27:01,2010-09-14 19:02:24
5879b6bbcaba7696e4abfa717748da166f915405...77f2e4f5f3e448794fd4fa80e898e4388042fabb,1,40,37,77,14,2010-09-13 17:59:06,2010-09-10 22:06:36
1125297ca1744be09f9e392aab0dd2c70d838583...87b50542a08ac6caa083ddc376e674424e37940a,3,8,14,22,4,2010-09-18 21:55:08,2010-09-18 21:55:08
1e633418479926bc85ed21a4f91c845a3dd3ad66...adc3192ef95bd572f61a5a88cab260ee3ff75d47,5,9,9,18,9,2010-10-06 19:08:48,2010-10-05 19:44:08
1e633418479926bc85ed21a4f91c845a3dd3ad66...e7cf4e94c6f147953af4d079ca2e9ef0d7a29ae9,1,6,5,11,6,2010-10-01 22:08:42,2009-12-28 17:04:21
e7cf4e94c6f147953af4d079ca2e9ef0d7a29ae9...4091bfc9616d5ac0371bb2ed80558f4a8f4d12f5,1,13,1,14,4,2010-10-01 22:08:43,2009-12-28 17:13:52
4091bfc9616d5ac0371bb2ed80558f4a8f4d12f5...9b9784cab9bba925ab35c7aa8d4e5967a4268093,2,37,5,42,8,2010-10-01 22:08:44,2010-03-17 15:17:34
9b9784cab9bba925ab35c7aa8d4e5967a4268093...442dada22d3b6e511d30b05a80bab153619e52a7,1,6,2,8,3,2010-10-01 22:08:45,2010-03-18 21:45:19
442dada22d3b6e511d30b05a80bab153619e52a7...4e57bafe8bc60e35b9841b22f99882581c466daf,1,5,0,5,1,2010-10-01 22:08:46,2010-06-11 22:45:35
4e57bafe8bc60e35b9841b22f99882581c466daf...3ba9ba8f34eda286867fba37e496850dc109af74,3,6,10,16,6,2010-10-01 22:08:47,2010-09-27 21:02:57
3ba9ba8f34eda286867fba37e496850dc109af74...a94114ad3d0fc584dea3ecd508135307882066a9,2,3,0,3,2,2010-10-01 22:08:48,2010-09-12 09:37:24
a94114ad3d0fc584dea3ecd508135307882066a9...97f2c33a52d2c33d6f6c8569e875fde0ef18e2e2,1,1,1,2,1,2010-10-01 22:08:48,2010-09-17 13:27:56
97f2c33a52d2c33d6f6c8569e875fde0ef18e2e2...ca02ad3447efdbd4cb2aa9ba0ee3fc6124035274,1,3,1,4,2,2010-10-03 22:29:19,2010-09-17 13:16:01
ca02ad3447efdbd4cb2aa9ba0ee3fc6124035274...36e035f5dcd214039d5ea96c29de110ae7435137,1,1,2,3,1,2010-10-03 22:31:13,2010-07-20 23:29:16
36e035f5dcd214039d5ea96c29de110ae7435137...5e9677cbdf1840836e22d9cf23198de34877e283,2,21,6,27,3,2010-10-03 22:31:59,2010-09-30 13:24:07
5e9677cbdf1840836e22d9cf23198de34877e283...1a4042096c2e8893246a99ef8e43c07acb76f54b,1,2,2,4,2,2010-10-03 22:34:02,2010-09-23 17:35:25
1a4042096c2e8893246a99ef8e43c07acb76f54b...b248e950966769f5f981321ea9d12f2b238c978c,1,5,1,6,2,2010-10-03 22:34:23,2010-07-07 01:48:47
b248e950966769f5f981321ea9d12f2b238c978c...77df1f1edfab61bf605f707aeb3b5f5bd54ffb76,1,6,0,6,1,2010-10-03 22:34:24,2010-09-27 11:01:59
77df1f1edfab61bf605f707aeb3b5f5bd54ffb76...5debf9a5ac89e9ba49dedc960078cf22bba25c50,2,7,0,7,2,2010-10-03 22:34:25,2010-09-27 11:02:17
7ebee44167fc25b975f5543472c851ab1840af1b...a9ca8a85ef493aac947f9da44a4fbb5724768897,3,47,0,47,3,2010-11-29 21:25:53,2010-11-26 15:31:57
a9ca8a85ef493aac947f9da44a4fbb5724768897...03a2b6effaeaebef86a3c524ecd6c77c70f53273,1,59,0,59,1,2010-11-29 21:25:53,2010-11-26 15:31:58
03a2b6effaeaebef86a3c524ecd6c77c70f53273...fc4045ee3eae49c829a466752da1937cfa13e048,1,51,2,53,2,2010-11-29 21:25:53,2010-11-26 15:31:59
fc4045ee3eae49c829a466752da1937cfa13e048...8fbee484a8ee0f00096571aff92c253ec39f28c2,1,47,0,47,1,2010-11-29 21:25:53,2010-11-26 15:32:00
8fbee484a8ee0f00096571aff92c253ec39f28c2...7194660205c39b39badcf555eb76200a80295814,1,67,0,67,1,2010-11-29 21:25:54,2010-11-26 15:32:01
7194660205c39b39badcf555eb76200a80295814...8718ed61251ae1fd80a375a9f907edb2635a8a29,1,267,0,267,1,2010-11-29 21:25:54,2010-11-26 15:32:02
8718ed61251ae1fd80a375a9f907edb2635a8a29...351fa1dc9fac3fc88895f30e6ef59e09ceb68bef,1,46,0,46,1,2010-11-29 21:25:54,2010-11-26 15:32:03
351fa1dc9fac3fc88895f30e6ef59e09ceb68bef...3f388c173092c7e0a214f2bafce8bac6e94951f9,1,48,0,48,1,2010-11-29 21:25:54,2010-11-26 15:32:04
3f388c173092c7e0a214f2bafce8bac6e94951f9...555b96abdeb66c2f193219489c148a0169080c89,1,291,0,291,1,2010-11-29 21:25:54,2010-11-26 15:32:05
555b96abdeb66c2f193219489c148a0169080c89...561a7e667fb8b589c90b67fe4cac32d03b6f840f,1,266,0,266,1,2010-11-29 21:25:55,2010-11-26 15:32:06
561a7e667fb8b589c90b67fe4cac32d03b6f840f...9a5976cd389c1c0b31cb3f9b3d260c0d05521f4c,1,47,0,47,1,2010-11-29 21:25:55,2010-11-26 15:32:07
9a5976cd389c1c0b31cb3f9b3d260c0d05521f4c...bc25c1038f2b90be377b670fb8566cf94650ffa0,1,49,0,49,1,2010-11-29 21:25:55,2010-11-26 15:32:08
bc25c1038f2b90be377b670fb8566cf94650ffa0...773ec9319e4718e0346aa5a273e16ff5b35a0e4b,1,67,0,67,1,2010-11-29 21:25:55,2010-11-26 15:32:09
773ec9319e4718e0346aa5a273e16ff5b35a0e4b...3c3b0a00924aeb6a5e5534341299c6dc7824dd49,1,267,0,267,1,2010-11-29 21:25:55,2010-11-26 15:32:10
3c3b0a00924aeb6a5e5534341299c6dc7824dd49...713b3721e2cb8d0bc3dc8d3f43cb27fe77c4f131,1,49,0,49,1,2010-11-29 21:25:56,2010-11-26 15:32:11
713b3721e2cb8d0bc3dc8d3f43cb27fe77c4f131...dc1c7834b383732120f490801d5f8471aa050f2f,1,50,0,50,1,2010-11-29 21:25:56,2010-11-26 15:32:12
dc1c7834b383732120f490801d5f8471aa050f2f...69bf2b1604ebf068d732caf111ad11973b8fe90f,1,291,0,291,1,2010-11-29 21:25:56,2010-11-26 15:32:13
69bf2b1604ebf068d732caf111ad11973b8fe90f...f7c85883224600c3027bc2faced0368ccb933c4f,1,268,0,268,1,2010-11-29 21:25:56,2010-11-26 15:32:14
f7c85883224600c3027bc2faced0368ccb933c4f...af62cc1ba686dd94f5c0ca4181db00e1b8519af8,1,135,0,135,1,2010-11-29 21:25:56,2010-11-26 15:32:15
af62cc1ba686dd94f5c0ca4181db00e1b8519af8...cf83243b0b8a8c444c03b37286b4498ec78f5666,1,129,0,129,1,2010-11-29 21:25:57,2010-11-26 15:32:16
cf83243b0b8a8c444c03b37286b4498ec78f5666...37eecb3db60843f54bf53f4168bb7fd1d1001c58,1,71,0,71,1,2010-11-29 21:25:57,2010-11-26 15:32:17
37eecb3db60843f54bf53f4168bb7fd1d1001c58...09327fd8f77cc7115684902528a5ba31bd6c5cff,1,266,0,266,1,2010-11-29 21:25:57,2010-11-26 15:32:18
09327fd8f77cc7115684902528a5ba31bd6c5cff...4a00884291a1cdd150b162ee148b88b7cd2c30cb,1,128,0,128,1,2010-11-29 21:25:57,2010-11-26 15:32:19
4a00884291a1cdd150b162ee148b88b7cd2c30cb...21b3466f59847165a5f58208e94b832b448e5cb6,1,130,0,130,1,2010-11-29 21:25:57,2010-11-26 15:32:20
21b3466f59847165a5f58208e94b832b448e5cb6...fd4e1888ae16978ce687de25409ee36eb11138ad,1,337,0,337,1,2010-11-29 21:25:57,2010-11-26 15:32:21
fd4e1888ae16978ce687de25409ee36eb11138ad...5362cbfcf3b8939edc4bd0058d6b8b08d4621234,1,267,0,267,1,2010-11-29 21:25:58,2010-11-26 15:32:22
5362cbfcf3b8939edc4bd0058d6b8b08d4621234...73a509ce44f94ad9a50126ab04490bce926feb8e,1,48,0,48,1,2010-11-29 21:25:58,2010-11-26 15:32:23
73a509ce44f94ad9a50126ab04490bce926feb8e...468d68226c6514a1c30390819da96c8a495c23d0,1,50,0,50,1,2010-11-29 21:25:59,2010-11-26 15:32:24
468d68226c6514a1c30390819da96c8a495c23d0...cdcef7d546e1ccc0b610a23c8a0831ca86b58589,1,68,0,68,1,2010-11-29 21:25:59,2010-11-26 15:32:25
cdcef7d546e1ccc0b610a23c8a0831ca86b58589...00bc13a9774610de0ea0952d0f011b14c18e52cb,1,268,0,268,1,2010-11-29 21:25:59,2010-11-26 15:32:26
00bc13a9774610de0ea0952d0f011b14c18e52cb...2e8c6bab2e75b4965dea90663a9cbd5d4377a12f,1,49,0,49,1,2010-11-29 21:25:59,2010-11-26 15:32:27
2e8c6bab2e75b4965dea90663a9cbd5d4377a12f...6ab5da1185e50051bcc375dfa3ad6f2de7054b2b,1,50,0,50,1,2010-11-29 21:25:59,2010-11-26 15:32:28
6ab5da1185e50051bcc375dfa3ad6f2de7054b2b...a2f509e1d8d8103a719fd6784e859c0af8c1adf5,1,39,0,39,1,2010-11-29 21:26:00,2010-11-26 15:32:29
a2f509e1d8d8103a719fd6784e859c0af8c1adf5...e0d769d1fda4f66a1c0b99f3f52a25d4f4006162,1,269,0,269,1,2010-11-29 21:26:00,2010-11-26 15:32:30
e0d769d1fda4f66a1c0b99f3f52a25d4f4006162...80d868b068b9e68a4aac91be578a8f097f45d8da,1,6,1,7,1,2010-11-29 21:26:00,2010-11-26 15:32:31
7ebee44167fc25b975f5543472c851ab1840af1b...8009d83c7e7af0a298ef858609a8201d01086396,3,19,19,38,19,2010-11-03 16:18:58,2010-11-02 15:31:19
8009d83c7e7af0a298ef858609a8201d01086396...0e615b252f35006ea824fae1a95dc6af55326b9a,10,11,11,22,11,2010-11-03 16:19:04,2010-11-02 15:31:20
0e615b252f35006ea824fae1a95dc6af55326b9a...60109d0ef5974b5066b6998fafe1da7187174c88,3,6,6,12,4,2010-11-03 16:19:08,2010-11-02 15:31:21
60109d0ef5974b5066b6998fafe1da7187174c88...bc6dafc1445a9e04141ed6bf28326114bc2e9191,1,3,3,6,2,2010-11-03 16:19:10,2010-11-02 15:31:22
bc6dafc1445a9e04141ed6bf28326114bc2e9191...8b3f3f84b27e6bbac1b1558166b44431a8e78bb1,10,24,24,48,18,2010-11-03 16:20:41,2010-11-02 15:31:23
8b3f3f84b27e6bbac1b1558166b44431a8e78bb1...29b9a66f285f602ad67362ccbe2c6bfaac769f54,6,18,15,33,13,2010-11-03 16:20:47,2010-11-02 15:31:24
29b9a66f285f602ad67362ccbe2c6bfaac769f54...13931236b9ee2895a98ffdbdacbd0f895956d8a8,10,20,18,38,16,2010-11-03 16:20:47,2010-11-02 15:31:25
13931236b9ee2895a98ffdbdacbd0f895956d8a8...66a062a1259000669cec0a8105a807a67b9287ef,1,16,3,19,4,2010-11-03 16:20:47,2010-11-02 21:06:20
66a062a1259000669cec0a8105a807a67b9287ef...45dfd40396b47720387c31c4140eb3aebdf06cf7,1,5,2,7,2,2010-11-03 16:20:48,2010-11-02 15:31:27
45dfd40396b47720387c31c4140eb3aebdf06cf7...4eec6f988dc1638ff5b5ee3131f7452d29042a61,1,2,1,3,1,2010-11-03 16:20:48,2010-11-02 15:31:28
7ebee44167fc25b975f5543472c851ab1840af1b...2844923d62a4c408bd59ddb2caacca4aa7eb86bc,3,40,0,40,7,2010-10-29 00:52:22,2010-10-27 08:39:52
2844923d62a4c408bd59ddb2caacca4aa7eb86bc...25fe66f84cea9c2e0a7f6b53180542784b94485a,1,18,0,18,2,2010-10-29 00:52:43,2010-10-27 08:39:53
7ebee44167fc25b975f5543472c851ab1840af1b...72a5b561fc1c4286bc7c5b0693afc076af261e1f,5,21,1,22,5,2010-10-29 00:37:35,2010-10-28 21:39:13
7ebee44167fc25b975f5543472c851ab1840af1b...ca209065f3cc3462eb0ae6090f6b13f38aa2114c,1,3,3,6,3,2010-10-28 18:45:00,2010-10-28 01:08:21
2850c1a882ff78e181d0e44b54b595e6b272a02b...da48616f1df51ff43acc64cdf8966f7b72142a11,1,160,76,236,67,2010-12-15 05:06:38,2010-12-02 08:17:13
da48616f1df51ff43acc64cdf8966f7b72142a11...dbda3b10902e13826862505900eb7a537505a492,1,110,8,118,6,2010-12-15 05:55:55,2010-12-15 04:57:58
2aedccd3d51ec922020f7c7e39df5d2c4d3af515...5bc0e247c4f281b44cfb72a5b31f479233a981f5,1,10,2,12,1,2010-07-28 20:56:45,2010-07-28 07:24:27
5bc0e247c4f281b44cfb72a5b31f479233a981f5...25e932504096ad5cba21978a0b9a13e2708bae87,2,44,0,44,2,2010-07-28 20:57:36,2010-07-28 08:20:16
25e932504096ad5cba21978a0b9a13e2708bae87...c97ca277a9a23780ffc322392608429f0b7e707a,1,7,0,7,1,2010-08-02 16:07:39,2010-08-02 16:07:39
c97ca277a9a23780ffc322392608429f0b7e707a...ac2e1e632e50c682305fee902b32b1a23ce71546,1,5,2,7,3,2010-08-02 16:11:28,2010-07-30 15:01:50
61bf126ecb24977b883079942b71ff96174c19fb...8a883b0260ba7f8d6e4c025ae3c32b454e80ade5,1,4,4,8,2,2010-08-02 18:53:18,2010-07-31 12:54:55
61bf126ecb24977b883079942b71ff96174c19fb...3713e2226bcda64513efd537f370ce4d7f767a1e,2,15,0,15,4,2010-07-30 07:49:21,2010-07-30 02:30:13
3713e2226bcda64513efd537f370ce4d7f767a1e...181264ad590ffef9d956fdd023369869c2d0a55f,2,12,0,12,2,2010-08-02 21:21:56,2010-08-02 19:58:19
d599e0484f8ebac8cc50e9557a4c3d246826843d...8b130262fb7b5d09df2af63f47d9bff1da220bfb,1,3,1,4,1,2010-10-22 18:51:10,2010-10-22 12:26:02
d599e0484f8ebac8cc50e9557a4c3d246826843d...6426f2d2afb42e51dac901ff666c3296424c6f5c,1,5,0,5,5,2010-08-27 23:47:42,2010-08-27 20:28:15
6426f2d2afb42e51dac901ff666c3296424c6f5c...2c642ed8668745271a714f0a672dbfcd6b0a6fa8,3,18,7,25,4,2010-08-27 23:47:45,2010-08-27 20:28:16
d599e0484f8ebac8cc50e9557a4c3d246826843d...b6b987a09457e9c8d49aad9170df32b1f607c5b9,1,2,0,2,1,2010-08-26 16:53:35,2010-08-26 06:21:46
b6b987a09457e9c8d49aad9170df32b1f607c5b9...dabb061fa358e8884889632f0be5b6c76916c893,1,4,1,5,1,2010-08-26 16:53:35,2010-08-26 06:21:47
dabb061fa358e8884889632f0be5b6c76916c893...4a5e74feb1a75a479acbc2f839e930966fdc2f2f,1,1,1,2,1,2010-08-26 16:53:36,2010-08-26 06:21:48
4a5e74feb1a75a479acbc2f839e930966fdc2f2f...7e1ec0d415dbea96d4ec6995c00cb66cdff7ceff,1,12,13,25,5,2010-08-26 16:53:36,2010-08-26 06:21:49
d599e0484f8ebac8cc50e9557a4c3d246826843d...6106ce4669051f1f4d3d21a2b22d24747e643147,1,6,0,6,1,2010-08-25 21:29:46,2010-08-25 17:52:55
6106ce4669051f1f4d3d21a2b22d24747e643147...3ee1757baeecb6fe6c8b2446b3afe0519584b63f,2,4,2,6,2,2010-08-25 21:39:09,2010-08-25 17:52:56
d599e0484f8ebac8cc50e9557a4c3d246826843d...5b3270817712e8eedb468e906cb1042a5a311ad4,1,16,0,16,1,2010-08-25 18:30:21,2010-08-22 21:06:29
d599e0484f8ebac8cc50e9557a4c3d246826843d...f15652d90c37ca56db08d325c871f2cc8f7d509e,2,84,4,88,7,2010-07-09 23:10:54,2010-07-09 13:10:51
f15652d90c37ca56db08d325c871f2cc8f7d509e...f433f70547ebf038a862ca72565ae42e50d4adfa,1,35,0,35,1,2010-07-09 23:11:13,2010-07-09 13:10:52
f433f70547ebf038a862ca72565ae42e50d4adfa...37348937ff391f01981e8af10b2f615268fd2509,2,80,19,99,13,2010-07-09 23:12:42,2010-07-09 13:10:53
37348937ff391f01981e8af10b2f615268fd2509...5a2580d62f9aaa30f0acd10df9dbe7a581dd77d9,3,15,4,19,4,2010-07-09 23:13:00,2010-07-09 13:10:54
5a2580d62f9aaa30f0acd10df9dbe7a581dd77d9...060df624228187c77ca53a437ae0e9896076f045,2,30,1,31,3,2010-07-09 23:16:29,2010-07-09 13:10:55
060df624228187c77ca53a437ae0e9896076f045...253fb5f8897d988d93ce276f8147c2964da3eefb,1,8,0,8,1,2010-07-09 23:16:47,2010-07-09 13:10:56
253fb5f8897d988d93ce276f8147c2964da3eefb...2fd1ea14056cb630bbf99588b78d7d68f51907ce,1,1,1,2,1,2010-07-27 19:51:35,2010-07-27 16:54:58
2fd1ea14056cb630bbf99588b78d7d68f51907ce...dd5685818bca9b0cadc61a87c6470fa7df227302,2,3,3,6,3,2010-08-13 04:38:39,2010-08-13 02:09:12
dd5685818bca9b0cadc61a87c6470fa7df227302...a3e413675478585206966bdbb7fd7bf24b9d1ea7,1,1,1,2,1,2010-08-18 18:55:38,2010-08-17 23:52:27
a3e413675478585206966bdbb7fd7bf24b9d1ea7...5601ba6574cfbd1249a6d38b72159a7d3ccf8315,1,31,0,31,1,2010-08-18 19:08:05,2010-08-17 23:53:18
5601ba6574cfbd1249a6d38b72159a7d3ccf8315...ae745487ad7a4ceca0e903da6df21be2c1ebfc29,2,2,1,3,2,2010-08-18 19:08:08,2010-08-17 23:53:19
ae745487ad7a4ceca0e903da6df21be2c1ebfc29...96ecac677aa84639a0b8e0aa0d781b197a2d16fe,1,2,6,8,3,2010-08-20 15:26:56,2010-08-20 12:55:40
d599e0484f8ebac8cc50e9557a4c3d246826843d...ebef82776512f56eec4b6ac98b076369eb5a93fa,2,2,1,3,2,2010-05-31 23:59:26,2010-05-14 09:31:32
ebef82776512f56eec4b6ac98b076369eb5a93fa...66dbfd55e38128db02eb340fcd89f54b734d4c6e,14,68,46,114,25,2010-05-31 23:59:26,2010-05-14 09:31:33
66dbfd55e38128db02eb340fcd89f54b734d4c6e...48793cf46a286a21df420fdd7fc4b0c91c60a0c8,3,20,2,22,9,2010-05-31 23:59:26,2010-05-14 09:31:34
48793cf46a286a21df420fdd7fc4b0c91c60a0c8...4b05548fc0523744b7a1276cfa0f4aae19d6d9c9,26,45,45,90,45,2010-05-31 23:59:27,2010-05-14 09:31:35
4b05548fc0523744b7a1276cfa0f4aae19d6d9c9...d1b1a919461c2f00d4e10f5ba227b13f800a6ac3,5,7,3,10,7,2010-05-31 23:59:27,2010-05-14 09:31:36
d1b1a919461c2f00d4e10f5ba227b13f800a6ac3...4fdf71be1ca3a817851a14f91b75e7d30f885a48,19,59,55,114,48,2010-05-31 23:59:27,2010-05-14 09:31:37
4fdf71be1ca3a817851a14f91b75e7d30f885a48...7b3bdbb335b6be938b4748e86a41357e51c97804,3,14,5,19,4,2010-06-01 00:35:20,2010-06-01 00:35:20
7b3bdbb335b6be938b4748e86a41357e51c97804...b2b0026eede10894d3317920a277b2a579cd86c5,2,6,0,6,6,2010-06-01 00:36:27,2010-05-14 09:31:38
b2b0026eede10894d3317920a277b2a579cd86c5...fcf3a21acce45aa73001ee1d3ae119f653294def,1,4,1,5,2,2010-06-01 00:36:27,2010-05-14 09:31:39
fcf3a21acce45aa73001ee1d3ae119f653294def...0a9b167ede027c09eca7aa2ea7522f058e153a13,2,15,3,18,3,2010-06-01 00:36:27,2010-05-14 09:31:40
0a9b167ede027c09eca7aa2ea7522f058e153a13...5a857c74baa96c4b20cdf9cab83a77972e6560de,2,32,7,39,3,2010-06-01 00:36:27,2010-05-14 09:31:41
5a857c74baa96c4b20cdf9cab83a77972e6560de...e88a135bc55a974ea04576ccc014c5e2bdc4b892,4,54,0,54,5,2010-06-01 00:36:27,2010-05-14 09:31:42
e88a135bc55a974ea04576ccc014c5e2bdc4b892...f9f33cdc78b5893a4764b1437b59536f399a50d1,3,14,0,14,4,2010-06-01 00:36:27,2010-05-14 09:31:43
f9f33cdc78b5893a4764b1437b59536f399a50d1...520fbc2a0da2ba830a54b9e1992a3f658c3ae1db,1,3,0,3,1,2010-06-01 00:36:27,2010-05-14 09:31:44
520fbc2a0da2ba830a54b9e1992a3f658c3ae1db...614dd90506476f82ab2595da384f71e78254f33e,1,12,0,12,1,2010-06-01 00:36:28,2010-05-14 09:31:45
614dd90506476f82ab2595da384f71e78254f33e...176959d7423988183ffbe1b35fc1de7f786bb596,1,6,0,6,2,2010-06-02 17:24:27,2010-05-14 09:31:47
176959d7423988183ffbe1b35fc1de7f786bb596...e78673ff0bef100535cc2ed146e4a59929c7b4fd,1,8,0,8,1,2010-06-02 17:24:27,2010-05-14 09:31:48
e78673ff0bef100535cc2ed146e4a59929c7b4fd...46856f4e9d3d0fbfe1888ee19d632dfc04de8fab,1,7,0,7,1,2010-06-02 17:24:27,2010-05-14 09:31:49
46856f4e9d3d0fbfe1888ee19d632dfc04de8fab...09ce4bb6ea7c06c1de82f042cb3ade622b0fa36c,2,3,1,4,3,2010-06-05 16:36:13,2010-06-05 16:36:13
09ce4bb6ea7c06c1de82f042cb3ade622b0fa36c...5e87eae97df69a48a575fd79131e85067f9dbf13,2,16,10,26,3,2010-06-11 20:45:05,2010-06-11 16:40:25
d599e0484f8ebac8cc50e9557a4c3d246826843d...374664478f204ab45bbd494ab21492f331d8b1f0,1,35,26,61,17,2010-05-20 04:06:40,2010-05-03 22:38:07
d599e0484f8ebac8cc50e9557a4c3d246826843d...5f35afadb032e1d2585f6f0246bf05f2e4e49c27,1,8,4,12,4,2010-05-10 18:57:31,2010-05-10 17:17:45
5f35afadb032e1d2585f6f0246bf05f2e4e49c27...d4e6c4bdc3e065f738b0c2fc47d9fe9c3778d746,1,12,0,12,2,2010-05-10 18:57:32,2010-05-10 17:17:46
d4e6c4bdc3e065f738b0c2fc47d9fe9c3778d746...75589220289ca8400388813af66c7219811e0334,1,1,1,2,1,2010-05-10 18:57:32,2010-05-10 17:17:47
75589220289ca8400388813af66c7219811e0334...97d45bcb2f6bdd9cb164d151a6e064ffdcd5e2bc,1,3,3,6,2,2010-05-10 18:57:33,2010-05-10 17:17:48
97d45bcb2f6bdd9cb164d151a6e064ffdcd5e2bc...2234ec5422201cd58f51b82fb4af146cf896767d,1,6,1,7,2,2010-05-10 18:57:33,2010-05-10 17:17:49
2234ec5422201cd58f51b82fb4af146cf896767d...403994e83dd3ad2424f0b3084c8dc4fd1ca6374a,1,36,29,65,3,2010-05-10 18:57:33,2010-05-10 17:17:50
403994e83dd3ad2424f0b3084c8dc4fd1ca6374a...8c6bdfdf8ba9a3d7a03d64b7a98305a460921130,2,10,4,14,4,2010-05-10 19:02:14,2010-05-10 17:17:51
8c6bdfdf8ba9a3d7a03d64b7a98305a460921130...f0ecac2b70bf6b44b89dfa493abd2f544010b1eb,4,21,9,30,6,2010-05-10 19:02:20,2010-05-10 17:17:52
d599e0484f8ebac8cc50e9557a4c3d246826843d...e3925b1222b0adac00b957132526b5b25f341702,1,4,1,5,1,2010-05-09 05:30:36,2010-05-09 03:57:28
e3925b1222b0adac00b957132526b5b25f341702...57e8743d1a2a06c4141b2a231bfcc54e2b0c2ad6,1,1,0,1,1,2010-05-09 05:30:51,2010-05-09 04:00:10
d599e0484f8ebac8cc50e9557a4c3d246826843d...9eb3f816dea9fa00e7c20204516b0cb288219057,2,26,20,46,5,2010-05-09 05:30:02,2010-05-09 03:19:35
9eb3f816dea9fa00e7c20204516b0cb288219057...8d6888ec6aee97f8b2b395e7e075dd00d9689c25,2,75,1,76,5,2010-05-09 05:30:02,2010-05-09 03:21:34
8d6888ec6aee97f8b2b395e7e075dd00d9689c25...ed9098fda2c8d178aad3a47c0c2f97474c60e82c,1,59,0,59,1,2010-05-09 05:30:02,2010-05-09 03:21:59
ed9098fda2c8d178aad3a47c0c2f97474c60e82c...0097971031e8b112a33038d47f5c864dad8e9363,1,20,11,31,5,2010-05-09 05:30:02,2010-05-09 03:23:58
0097971031e8b112a33038d47f5c864dad8e9363...59893a88f96b3ed4223c20942fd3db5d8c43f7c0,1,42,0,42,1,2010-05-09 05:30:03,2010-05-09 03:30:41
59893a88f96b3ed4223c20942fd3db5d8c43f7c0...66c4c32d29de5d24161dc804197918453d9cd2d3,1,19,17,36,3,2010-05-09 05:30:03,2010-05-09 03:32:24
66c4c32d29de5d24161dc804197918453d9cd2d3...c5ce1836719dc77e3c8495206653037cb5c4e511,1,29,18,47,6,2010-05-09 05:30:03,2010-05-09 03:33:28
c5ce1836719dc77e3c8495206653037cb5c4e511...1a3eb9a0325fc1d1d168b517210b7760d31d3022,1,6,6,12,3,2010-05-09 05:30:03,2010-05-09 03:37:21
d599e0484f8ebac8cc50e9557a4c3d246826843d...18f3b5a9d37de606604f00360df55e5a5fe70739,1,45,0,45,2,2010-05-06 20:22:37,2010-04-22 20:30:19
18f3b5a9d37de606604f00360df55e5a5fe70739...980bde389491e65df3a6f26f755064013b65740c,2,16,7,23,7,2010-05-06 20:22:44,2010-04-22 20:30:20
d599e0484f8ebac8cc50e9557a4c3d246826843d...409578912cb21bdad4a75f34af7c0a815ac9d06b,1,57,24,81,6,2010-05-03 16:40:27,2010-05-02 11:00:42
409578912cb21bdad4a75f34af7c0a815ac9d06b...2d7671ef43946cdfce140e6e9c3ca1eeea361676,1,24,3,27,5,2010-05-03 16:40:32,2010-05-02 11:00:43
2d7671ef43946cdfce140e6e9c3ca1eeea361676...8028184eecf1051e4b39b308a3ad909eed1371c4,4,145,3,148,9,2010-05-03 16:40:32,2010-05-02 11:00:44
8028184eecf1051e4b39b308a3ad909eed1371c4...95a2618f60a61fae8097695255419f257f74dff9,1,1,0,1,1,2010-05-08 23:09:31,2010-05-08 21:07:39
d599e0484f8ebac8cc50e9557a4c3d246826843d...8515392f5d4c5a36a0f9e4a73068f7106d7f4638,1,12,7,19,4,2010-05-01 22:42:02,2010-04-27 20:45:19
8515392f5d4c5a36a0f9e4a73068f7106d7f4638...152d94348f6a38eb7cb5f4af8397f51ba06ddffb,3,35,11,46,14,2010-05-01 22:42:19,2010-05-01 20:36:15
d599e0484f8ebac8cc50e9557a4c3d246826843d...daae19224a05be9efb9a39c2a2c1c9a60fe906f1,2,75,0,75,4,2010-05-01 19:15:06,2010-04-24 16:06:08
d599e0484f8ebac8cc50e9557a4c3d246826843d...5ae8030fdeb0bb00b94cc830dc98d4fb9d0d532e,1,3,0,3,1,2010-05-01 19:09:35,2010-04-24 13:50:09
5ae8030fdeb0bb00b94cc830dc98d4fb9d0d532e...377bee3424ba871278d230ed296f74ccac8ad607,1,6,1,7,2,2010-05-01 19:09:43,2010-04-24 13:53:19
377bee3424ba871278d230ed296f74ccac8ad607...c42b00c8f2b8c04ff9829e88dcde92d7294cd460,1,3,2,5,2,2010-05-01 19:09:51,2010-04-24 13:56:13
d599e0484f8ebac8cc50e9557a4c3d246826843d...c8c073c4201600b958f5d3bd9e8051b2060bd3f7,1,8,9,17,5,2010-05-01 18:11:11,2010-04-28 11:29:06
d050464541d51ab65863218d93b351de3392f476...fe46fa9d267fc5465b320d0d2877de45333efeb8,2,40,9,49,7,2011-12-16 17:25:20,2011-12-16 17:00:11
fe46fa9d267fc5465b320d0d2877de45333efeb8...f032d66ddb0cc81807be14c6a9052367df6d1cbc,2,2,4,6,3,2011-12-19 19:59:57,2011-12-19 19:59:57
c512b035556eff4d8f869afeda5fd78bc7a4966d...fcd424011bf7b841e9d4b3154ecadf6bf5e6e686,4,30,3,33,5,2010-04-11 20:42:33,2010-04-11 20:41:43
3b0c19663e7976cd32188b42e762c980d1bb93d4...e28a243b0000e7b82adcc5eb7445ef132f22b9de,2,0,2,2,2,2010-04-10 07:43:59,2010-04-10 06:34:40
e28a243b0000e7b82adcc5eb7445ef132f22b9de...f5b26b1d14d3362fa41e51f4f78cdf56968733ba,1,3,0,3,2,2010-04-10 07:43:59,2010-04-10 06:58:27
f5b26b1d14d3362fa41e51f4f78cdf56968733ba...6cb3f6b28294cb2b3766370f42a570fb46ba4e97,2,18,0,18,4,2010-04-10 07:43:59,2010-04-10 07:11:53
6cb3f6b28294cb2b3766370f42a570fb46ba4e97...1b908b6fb48f4f8009804c097b14106df548247c,1,14,8,22,7,2010-04-10 07:43:59,2010-04-10 07:19:46
1b908b6fb48f4f8009804c097b14106df548247c...2381e39e5ff740883b98c5aca019950f9167b67f,2,20,8,28,9,2010-04-10 07:43:59,2010-04-10 07:33:17
5469e2dab133a197dc2ca2fa47eb9e846ac19b66...944163a4bd4cc4c35392147d10020ba57c6d7d87,3,8,2,10,4,2010-04-19 23:34:49,2010-04-19 23:31:25
944163a4bd4cc4c35392147d10020ba57c6d7d87...111fb858654b95355da05772b4dcdf91decc4721,3,90,2,92,7,2010-04-19 23:39:24,2010-04-19 23:31:31
5469e2dab133a197dc2ca2fa47eb9e846ac19b66...9ae144fbf2648a52da1cc5269918931b328180f9,1,26,13,39,8,2010-04-19 20:01:46,2010-04-19 08:46:13
9ae144fbf2648a52da1cc5269918931b328180f9...580fb25b7a941267aad747afdc74b9b4a42e154a,2,90,6,96,7,2010-04-19 20:01:49,2010-04-19 08:46:14
b807c524df69fb44d7fe2a68a899985a7f7e6838...537f6c7fb40257776a513128043112ea43b5cdb8,1,15,1,16,4,2010-04-06 22:00:01,2010-04-06 22:00:01
cc64c6970a0d50ecb75ba902d406bac7ea461f97...e07665e524d0398a34059d605f674182bfeeaf39,2,20,1,21,2,2010-03-29 04:32:25,2010-03-29 04:32:25
faf752693abd0a891a9a47a2d398353cc59ee93a...0acb62f202617cc58b6b4039dc9c7ad955ef0c88,2,19,2,21,4,2010-03-29 04:34:40,2010-03-28 19:36:00
dfea79004c54bc96143386d6ac22de500ba4f747...296c6bb21a6980f6e5b42f0790d6365c1e3f696f,3,99,6,105,15,2010-06-06 22:14:27,2010-05-26 02:50:12
dfea79004c54bc96143386d6ac22de500ba4f747...70b89f871e1afa1fe3ffa22bf3e2043d4405954a,1,3,2,5,2,2010-05-28 23:46:09,2010-05-26 14:24:34
ddb27a5a6b5ed74c70d56c96592b32eed415d72b...b331fe54762770c647b8f95c8f5b16004c6120da,2,82,1,83,6,2010-05-03 16:38:52,2010-04-27 19:34:44
b331fe54762770c647b8f95c8f5b16004c6120da...592ea4173af6b445042d74b989762fd41aecdf4c,2,92,53,145,6,2010-05-03 16:38:54,2010-04-27 19:34:45
ddb27a5a6b5ed74c70d56c96592b32eed415d72b...493429b89600daf43a818701ba7011b8e538f7b0,1,1,0,1,1,2010-05-02 15:27:58,2010-04-25 20:17:05
493429b89600daf43a818701ba7011b8e538f7b0...64b90323f65d2a3ac8d1ff4ed73be881f76aac8a,1,12,0,12,1,2010-05-04 17:01:49,2010-04-16 13:53:59
64b90323f65d2a3ac8d1ff4ed73be881f76aac8a...28ba96ab27d0471af101b4796534ad4085019db1,2,6,2,8,3,2010-05-04 17:02:46,2010-04-23 12:37:22
87b3c0117a340df61bdbac6794611c74696bd42a...727c3718a51605a2b93a7b2ac57e0175decc122a,1,4,2,6,2,2010-04-03 04:07:44,2010-04-02 23:37:00
727c3718a51605a2b93a7b2ac57e0175decc122a...3e3ec2abe0f275dda285e989224e4c3da19e7adb,3,25,5,30,8,2010-04-03 04:08:04,2010-04-02 23:37:08
3e3ec2abe0f275dda285e989224e4c3da19e7adb...b27eb49948c90af11cee39301d03c37a05e066de,1,42,0,42,1,2010-04-04 21:21:00,2010-04-02 23:37:15
b27eb49948c90af11cee39301d03c37a05e066de...d511bd330d66fe8f0be21855888e30af2f3e373b,3,48,54,102,44,2010-04-04 21:21:54,2010-04-02 23:37:23
d511bd330d66fe8f0be21855888e30af2f3e373b...4e35c51e5113e83155a6c44a8f9adeafed9125d2,1,14,0,14,1,2010-04-04 21:21:54,2010-04-02 23:37:30
4e35c51e5113e83155a6c44a8f9adeafed9125d2...a347b17f15dd5358ced8d447af144a46b224982d,1,29,24,53,7,2010-04-04 21:21:54,2010-04-02 23:37:37
87b3c0117a340df61bdbac6794611c74696bd42a...766ac6a6ba26b0d58c75234bb3553178eafa80b0,1,4,4,8,3,2010-03-31 16:37:26,2010-03-29 16:48:23
766ac6a6ba26b0d58c75234bb3553178eafa80b0...df61c8897950759bfe93c2b9d828487bcc7fbb6b,1,4,4,8,2,2010-03-31 16:37:26,2010-03-29 16:48:24
df61c8897950759bfe93c2b9d828487bcc7fbb6b...580d5f83e71f7f9e61cdb181e21c10b09c81f6e5,1,2,0,2,2,2010-03-31 16:37:26,2010-03-29 16:48:25
580d5f83e71f7f9e61cdb181e21c10b09c81f6e5...88f3b2b0a21f712d14b0b7a7fda30f578027424a,1,5,0,5,1,2010-03-31 16:37:26,2010-03-29 16:48:26
88f3b2b0a21f712d14b0b7a7fda30f578027424a...73b49a759216bf33cc366eeac113ce00d8c49cc6,1,120,12,132,7,2010-04-01 04:40:11,2010-03-29 16:48:27
73b49a759216bf33cc366eeac113ce00d8c49cc6...7aeaa2fc0abbf439534769e15b3a59a5814cc3d1,7,456,0,456,7,2010-04-01 04:40:16,2010-03-29 16:48:28
7aeaa2fc0abbf439534769e15b3a59a5814cc3d1...2cb5a48195362845fce284626f3d6eb62dcad204,1,70,0,70,1,2010-04-04 21:25:43,2010-03-29 16:48:29
2cb5a48195362845fce284626f3d6eb62dcad204...f733f6a0c690a3d5e399c438d4dc3f2307418171,2,4,8,12,2,2010-04-10 03:47:22,2010-04-09 15:57:45
f733f6a0c690a3d5e399c438d4dc3f2307418171...63a2f6139c33b7231baad8e3bfcc218ef6b63418,1,6,0,6,1,2010-04-13 05:10:50,2010-04-12 14:24:28
02125bcc41aed022ddcb5955935726e50d89b60e...9c00de5a3135c8f7273668d4013c225d48d47861,2,65,4,69,4,2010-04-09 06:10:43,2010-04-08 17:21:13
dc05d73104fda239fc03342e0b53aa5741c53531...758df17ab07a58e5b0f8effdf2d1b71fe8d79f1d,3,18,7,25,4,2010-03-07 19:09:02,2010-03-07 16:52:45
758df17ab07a58e5b0f8effdf2d1b71fe8d79f1d...55f638bdc6507b3a2ce03290741f592934afaee7,4,78,34,112,22,2010-03-08 08:30:44,2010-03-07 16:52:46
55f638bdc6507b3a2ce03290741f592934afaee7...00588bb5cd4a7ff5e2b1ded97d4459bfe6aad6eb,4,27,2,29,16,2010-03-08 08:30:59,2010-03-07 16:52:47
bc1bbe0c19a6ff39522b4fa3259f34150e308e1f...5e9637c629702e3d41ad01d95956d1835d7338e0,37,1291,39,1330,85,2011-12-06 04:46:55,2011-11-17 23:14:42
bc1bbe0c19a6ff39522b4fa3259f34150e308e1f...d05e69701053c0cf786e99251879f860702374b7,1,6,3,9,4,2011-11-18 19:53:46,2011-11-18 11:11:08
d05e69701053c0cf786e99251879f860702374b7...4bd4e73093eb741a87b7d80bc84469d880f4e2f3,1,6,6,12,4,2011-11-18 19:55:05,2011-11-18 11:11:28
4bd4e73093eb741a87b7d80bc84469d880f4e2f3...73b7eae60c18036eab21a84e42bfa8b5297fe679,1,21,2,23,6,2011-11-18 19:55:58,2011-11-18 11:13:08
bc1bbe0c19a6ff39522b4fa3259f34150e308e1f...53b10a140527253f61cfc209a4e85e132c0bc4ee,7,39,1,40,7,2011-11-16 00:11:52,2011-11-15 20:15:03
bc1bbe0c19a6ff39522b4fa3259f34150e308e1f...620771c83ec67c7f066d366acbc2efdfa75e7d14,1,0,8,8,1,2011-11-16 00:08:48,2011-11-15 16:59:36
620771c83ec67c7f066d366acbc2efdfa75e7d14...7356b51e4bd07893256d76468d301dc244f4299d,1,3,3,6,3,2011-11-16 00:09:02,2011-11-15 16:59:37
7356b51e4bd07893256d76468d301dc244f4299d...5e12e78e52b4219ce27c14404351648fd47854cc,1,1,1,2,1,2011-11-16 00:09:20,2011-11-15 16:59:39
5e12e78e52b4219ce27c14404351648fd47854cc...e4ac953b2a1e33fedf210ac59394db480a6ade33,1,1,1,2,1,2011-11-16 00:09:34,2011-11-15 17:31:09
bc1bbe0c19a6ff39522b4fa3259f34150e308e1f...f0c7fd49c0b9454808486e8c56cd3d9c022d56f2,4,55,31,86,21,2011-11-15 23:39:33,2011-11-15 23:39:33
f0c7fd49c0b9454808486e8c56cd3d9c022d56f2...5e1e6b93d024b5a01f4e957a2bedba899cb22f68,1,5,5,10,5,2011-11-16 00:59:46,2011-11-15 09:31:32
5e1e6b93d024b5a01f4e957a2bedba899cb22f68...09116a1c31e3754cb18bb69ef057342cd7808935,2,17,10,27,6,2011-11-17 05:52:24,2011-11-17 00:54:32
09116a1c31e3754cb18bb69ef057342cd7808935...4d2440fe0daa9ad1556dfd220af8b3a883cf849d,2,2,5,7,3,2011-11-17 19:06:15,2011-11-17 19:06:15
4d2440fe0daa9ad1556dfd220af8b3a883cf849d...418c9b176cbabf954b6325cca0bea7f9be251afe,2,34,24,58,25,2011-11-17 23:06:27,2011-11-16 08:03:36
bc1bbe0c19a6ff39522b4fa3259f34150e308e1f...c6893323917cbf4cb66c29ba2ac03014a44f0f0c,12,36,32,68,33,2011-11-13 20:21:06,2011-11-13 10:22:14
c6893323917cbf4cb66c29ba2ac03014a44f0f0c...d5a35c114ab6b4337a1c7598bf75c331d94ee092,8,66,28,94,31,2011-12-06 00:21:06,2011-11-13 10:22:15
6f62cd7ab1c47a7ea32ab05cf1292d82c47310e9...68be2fea50e7a34c0e5f9fdf6adb9040c8df197f,4,11,2,13,5,2011-11-17 06:05:21,2011-11-17 06:04:13
5f2e1df5c9fa7856e5d7dda7d6c618ed08822b82...cb1881c6eeb021102a7a0ae87dbddfd52bf1f04f,1,11,12,23,6,2007-04-16 08:10:28,2007-04-16 04:37:10
cb1881c6eeb021102a7a0ae87dbddfd52bf1f04f...40c8279f9b4f1c37f5e994c1c053b69446133559,1,5,4,9,2,2007-04-16 08:10:28,2007-04-16 04:37:11
40c8279f9b4f1c37f5e994c1c053b69446133559...b71083043c66b241713ff0698f113eb7c8bc9a90,1,8,4,12,2,2007-04-16 08:10:28,2007-04-16 04:37:12
b71083043c66b241713ff0698f113eb7c8bc9a90...4f752407964a81cf2ba5750343a7f0daf54c19b8,1,3,3,6,1,2007-04-16 08:10:28,2007-04-16 04:37:13
4f752407964a81cf2ba5750343a7f0daf54c19b8...72a76c955bcbe6370db7dc34b962851de189e650,1,42,2,44,1,2007-04-16 08:10:29,2007-04-16 04:37:14
72a76c955bcbe6370db7dc34b962851de189e650...a536b08b491dbb7565fb6ce109dbcf1997f9ab7a,1,20,18,38,6,2007-04-16 08:10:29,2007-04-16 04:37:15
a536b08b491dbb7565fb6ce109dbcf1997f9ab7a...25d9f3fa2d493bc769e39d18bf843cf11c235062,1,8,7,15,6,2007-04-16 08:10:29,2007-04-16 04:37:16
25d9f3fa2d493bc769e39d18bf843cf11c235062...5c19f244c3ca1ef5bf419bcc822c3b8184d24f8f,1,16,9,25,10,2007-04-16 08:14:46,2007-04-16 07:21:31
5c19f244c3ca1ef5bf419bcc822c3b8184d24f8f...982f65ace6c2be08b881318ca3241736dddd8aee,1,10,4,14,2,2007-04-16 08:14:46,2007-04-16 06:40:06
982f65ace6c2be08b881318ca3241736dddd8aee...0b9a9dd00a4c08b09d5661942b31c7ee590626b7,1,7,6,13,2,2007-04-16 08:14:46,2007-04-16 06:20:40
0b9a9dd00a4c08b09d5661942b31c7ee590626b7...635f4a30f0f73fcd3ed29c8d70be334689cc4082,4,85,67,152,10,2007-04-16 08:14:46,2007-04-16 06:20:34
635f4a30f0f73fcd3ed29c8d70be334689cc4082...5946d88a349407f2830b4d186201076b80a7cce4,1,1,0,1,1,2007-04-16 08:35:33,2007-04-16 08:30:42
5946d88a349407f2830b4d186201076b80a7cce4...91776491da19f1b72e1cd192c9ea42bb1aae4415,1,6,1,7,1,2007-04-16 08:35:39,2007-04-16 08:31:35
60a6bf5f53635005f4f68d8b8a33172309193623...883653babd8ee7ea23e6a5c392bb739348b1eb61,1,34,5,39,4,2006-09-13 07:54:43,2006-09-13 06:53:27
370e0966ef4abff81f08c9ea5c7d167eb0b0d354...d819e4e682d68ca41378e4352b9e2bba084971dc,1,106,7,113,10,2006-08-28 06:32:36,2006-08-21 02:03:13
128eead19821ba18e2912ebf30e5621d08735e79...604cb211a9b5401b265d1c1ca3d57dad243e7260,1,7,0,7,2,2006-10-04 06:58:38,2006-10-03 21:48:46
604cb211a9b5401b265d1c1ca3d57dad243e7260...281e67d6fa8e523147792c17fbe6db03f13f72e1,1,1,1,2,1,2006-10-04 06:58:38,2006-10-03 20:11:25
281e67d6fa8e523147792c17fbe6db03f13f72e1...c065b6e4293f856012ec53fcff7bf4d47ac50927,1,0,27,27,1,2006-10-04 06:58:38,2006-10-03 16:38:25
128eead19821ba18e2912ebf30e5621d08735e79...954a6183756a073723a7c9fd8d2feb13132876b0,1,86,13,99,6,2006-10-03 08:10:03,2006-10-01 09:16:11
954a6183756a073723a7c9fd8d2feb13132876b0...2172ce4b01c862e66e3d581282dc92223cbd28fa,1,20,6,26,5,2006-10-03 09:30:47,2006-10-03 09:30:47
2172ce4b01c862e66e3d581282dc92223cbd28fa...9074484a2ba28cd41a78e0b10074a8882653bf3a,1,13,86,99,6,2006-10-04 21:55:16,2006-10-04 21:54:32
9074484a2ba28cd41a78e0b10074a8882653bf3a...9dc5f8c9c2a10f77ecfa448c93da6ceec759df73,1,9,3,12,4,2006-10-04 21:56:13,2006-10-04 07:12:17
9dc5f8c9c2a10f77ecfa448c93da6ceec759df73...c8aeaaf7fc7dd93a284218e6a2b6e96b90e3100c,1,7,5,12,3,2006-10-04 21:56:50,2006-10-04 07:13:38
c8aeaaf7fc7dd93a284218e6a2b6e96b90e3100c...b2d3476e15cefdbd94366d4cf46fd05c1623034f,2,42,7,49,9,2006-10-04 22:00:49,2006-10-03 12:49:03
ff989b8d466ee2ec42c69c02e6551add430b8497...47292d65dec754bbe37d82369faabeaf8f0cdb7a,1,1,1,2,1,2006-10-03 09:08:19,2006-10-03 09:08:19
47292d65dec754bbe37d82369faabeaf8f0cdb7a...03a182107fdb36170a72b8a3d94de2b52e3f6668,1,4,17,21,6,2006-10-03 09:15:18,2006-10-03 09:15:18
03a182107fdb36170a72b8a3d94de2b52e3f6668...422b4a0e03658d0933a7abc149f175735ea9c4b5,1,1,0,1,1,2006-10-05 04:37:15,2006-10-05 04:37:15
72bbc38b0a458439f670932ecfb33226e6a9479a...7768e27e1d3f3d5e253e795433033b5de1d1c157,1,1,1,2,1,2006-10-19 08:49:26,2006-10-19 08:33:01
aa086eb813d4fe21aac556a94efe5e29b44d8ca4...c27d205aaefb654c12a4ab9e0b4fae1882c0fc70,2,6,1,7,3,2006-07-31 22:51:25,2006-07-31 13:27:00
822a7d507151e1d6310f52d5b05234d65db11a88...8f615493e6b6fd47bc4011c264cb7e6f01052d37,2,3,3,6,3,2006-08-02 18:30:42,2006-08-02 15:28:16
8f615493e6b6fd47bc4011c264cb7e6f01052d37...ec19a22b74d39da1bf22e10acadc7f712a4976c5,1,0,87,87,1,2006-08-02 18:31:03,2006-08-02 15:37:42
ec19a22b74d39da1bf22e10acadc7f712a4976c5...7fe08af485a02e28ea11b978e6543fbb78d80943,2,4,4,8,4,2006-08-02 18:32:04,2006-08-02 16:32:32
7fe08af485a02e28ea11b978e6543fbb78d80943...d4ad9b0484fa17de3d161f48ae58190ec2cccd45,1,0,1,1,1,2006-08-02 18:33:33,2006-08-02 16:34:44
d4ad9b0484fa17de3d161f48ae58190ec2cccd45...53bb2c002a53cdd0746444defbf5323ea21eb8d5,4,6,6,12,7,2006-08-02 18:36:01,2006-08-02 16:32:32
53bb2c002a53cdd0746444defbf5323ea21eb8d5...e12c095aa69d8aca0326eb11960427d9bf9e2db7,4,8,4,12,7,2006-08-03 00:05:14,2006-08-02 21:51:59
e12c095aa69d8aca0326eb11960427d9bf9e2db7...25f38f064f7f9ccde337eafcf575e4a5a1079346,2,4,2,6,4,2006-08-03 00:05:21,2006-08-02 21:52:00
25f38f064f7f9ccde337eafcf575e4a5a1079346...fba0cbd95d796857622d642160176907930ae511,1,17,3,20,4,2006-08-03 00:05:34,2006-08-02 22:04:56
822a7d507151e1d6310f52d5b05234d65db11a88...da7bad50ed0816cf2ee7f558ed154a7c67fb546d,1,1,0,1,1,2006-08-02 07:27:48,2006-07-30 15:52:09
962ad61874267b715311b424c767d36c1ab921a6...f5fffbd3e878d2be4154174c588a229ca37b04f1,1,6,0,6,2,2006-08-03 23:28:24,2006-08-03 23:28:24
f5fffbd3e878d2be4154174c588a229ca37b04f1...5a716826a6f7f209777f344143cdd9e4f2903097,1,1,1,2,1,2006-08-03 23:40:20,2006-08-03 23:40:20
5a716826a6f7f209777f344143cdd9e4f2903097...15e593e4d37d1d350fef20ab666d58f6881c7f5f,5,5,5,10,5,2006-08-04 04:38:24,2006-08-03 15:38:39
15e593e4d37d1d350fef20ab666d58f6881c7f5f...8cdf33643dc0b21d9ea922a3fdd7f64226c421aa,5,7,7,14,6,2006-08-04 04:44:13,2006-08-03 15:48:41
8cdf33643dc0b21d9ea922a3fdd7f64226c421aa...cba05fa840b637db2708014142a753680d930082,4,5,5,10,5,2006-08-04 04:55:41,2006-08-04 04:55:41
44c10841ea3edeef47cc6be0fdba5058344e2e95...68d42c41ef33cde500307660bb64a1c74f62711e,1,1,1,2,1,2006-08-23 10:04:01,2006-08-23 10:02:59
68d42c41ef33cde500307660bb64a1c74f62711e...b05faa2da9ec24d737bbba47c71e815255f3eaa7,1,1,1,2,1,2006-08-23 10:05:27,2006-08-23 09:17:55
44c10841ea3edeef47cc6be0fdba5058344e2e95...678dac6b45437d65fa958c03ca47f4a0337efad4,2,58,5,63,11,2006-08-22 23:40:40,2006-08-22 17:37:41
b17fda5c07744190e2f9caa24321596830064083...3dfb9278dff6d81fcc062e9a56edab9ece38ea7d,8,31,11,42,13,2006-08-28 23:20:33,2006-08-28 13:52:13
3dfb9278dff6d81fcc062e9a56edab9ece38ea7d...25691fbe6d02135d55dfc3a5180e29890dce1521,1,54,36,90,36,2006-08-28 23:21:34,2006-08-28 15:49:58
25691fbe6d02135d55dfc3a5180e29890dce1521...b7f9253df9bf351527f319d67bf67a95a4b8d79a,1,31,32,63,6,2006-08-28 23:21:34,2006-08-28 12:48:10
b7f9253df9bf351527f319d67bf67a95a4b8d79a...d50a9398fe9428f94ec7f2081626cc49c938e704,1,0,1,1,1,2006-08-28 23:21:34,2006-08-28 12:48:11
d50a9398fe9428f94ec7f2081626cc49c938e704...6fd92a28ebfcbf5d0fc5b51653e223d4e2e727a6,2,18,0,18,3,2006-08-28 23:21:34,2006-08-28 12:48:12
6fd92a28ebfcbf5d0fc5b51653e223d4e2e727a6...fba20b429a45a682796214140a7e92fac52a3dbe,1,1,0,1,1,2006-08-28 23:21:35,2006-08-28 12:48:13
fba20b429a45a682796214140a7e92fac52a3dbe...b4657e7759fa5f3b1ef09d147c2fd0254f8fcb2d,1,49,22,71,8,2006-08-28 23:21:35,2006-08-28 12:48:14
b4657e7759fa5f3b1ef09d147c2fd0254f8fcb2d...a44465ccd998bcb6fbfb49cb63d5206dce26051a,1,10,2,12,2,2006-08-28 23:44:14,2006-08-28 21:17:31
a44465ccd998bcb6fbfb49cb63d5206dce26051a...9e848013968959bd4de5d407c2ee91cb960c53bb,1,1,1,2,1,2006-08-29 09:17:15,2006-08-29 09:12:14
9e848013968959bd4de5d407c2ee91cb960c53bb...071fa89e25855a746728b835359eb263c7c7ee7f,1,17,2,19,1,2006-08-29 18:56:39,2006-08-29 18:47:30
071fa89e25855a746728b835359eb263c7c7ee7f...c9b0597d3d3168e29f68b0e82fa755ee165f6b72,1,1,3,4,2,2006-08-29 21:26:04,2006-08-29 10:50:29
c9b0597d3d3168e29f68b0e82fa755ee165f6b72...104ff34a742672b360b1da2b7d7668a14da551c2,1,1,1,2,1,2006-08-29 21:26:14,2006-08-29 10:51:14
104ff34a742672b360b1da2b7d7668a14da551c2...28f5c70b859e02e6b688bf35605678680c08045b,2,0,2,2,2,2006-08-29 21:28:41,2006-08-29 11:02:35
28f5c70b859e02e6b688bf35605678680c08045b...fc1c75ec74c372670f01f22c68193156a445728a,1,66,50,116,6,2006-08-30 07:19:42,2006-08-29 11:37:06
fc1c75ec74c372670f01f22c68193156a445728a...3a36bc846949df8a7fb0ad9b2fc8ffe294cdca7c,1,0,4,4,1,2006-08-31 19:48:37,2006-08-31 19:32:45
3a36bc846949df8a7fb0ad9b2fc8ffe294cdca7c...4b5dc988c0db1e7ce5ba41c09a1e75cbc71c3f35,1,1,1,2,1,2006-08-31 19:57:08,2006-08-29 07:19:02
4b5dc988c0db1e7ce5ba41c09a1e75cbc71c3f35...cb849b46ac68feea716a45fd1de99cfdd71123d0,1,43,19,62,12,2006-08-31 19:57:52,2006-08-30 22:32:15
cb849b46ac68feea716a45fd1de99cfdd71123d0...fa702003e4f63ecdc71d16b51efc02f33fe7931f,1,59,44,103,5,2006-08-31 19:58:07,2006-08-30 22:35:07
fa702003e4f63ecdc71d16b51efc02f33fe7931f...0edcb37d6707c8c9b566bcbb51a2d70275bd30da,1,3,3,6,1,2006-08-31 19:58:31,2006-08-30 22:36:04
3d5c0cc9387b35df47c988fbc0e4379e413d783e...31756c5da8198eb09f2792230e1bed4d107f5135,5,0,135,135,6,2006-09-23 21:00:27,2006-09-23 15:06:11
31756c5da8198eb09f2792230e1bed4d107f5135...3fc8284e2114624f2657142b3fecdc6f514b2090,2,2,3,5,2,2006-09-23 21:00:32,2006-09-23 15:06:35
3fc8284e2114624f2657142b3fecdc6f514b2090...8f41db8c370d535ed0132ef33d73e47edcc5af03,1,4,0,4,1,2006-09-24 06:52:53,2006-09-23 22:25:19
8f41db8c370d535ed0132ef33d73e47edcc5af03...a2f3db2f5de2a3667b0e038aa65e3e097e642e7d,1,11,21,32,11,2006-09-24 06:53:18,2006-09-23 22:18:41
a2f3db2f5de2a3667b0e038aa65e3e097e642e7d...ed1795fcc5f2aa3f105630429bcbed49c50053fa,1,2,2,4,2,2006-09-24 07:00:47,2006-09-24 00:20:45
3d5c0cc9387b35df47c988fbc0e4379e413d783e...16854571aae6302f457c5fbee41ac64669b09595,2,7,3,10,4,2006-09-23 02:24:52,2006-09-21 04:11:59
16854571aae6302f457c5fbee41ac64669b09595...43057304c0bbaf7bc7511daaf81df08c7909a90b,4,104,114,218,55,2006-09-23 08:51:33,2006-09-21 04:05:37
3d5c0cc9387b35df47c988fbc0e4379e413d783e...ae35b30433f5b732bd21f9577711584e3f9bba06,1,20,11,31,11,2006-09-23 02:24:12,2006-09-05 18:46:11
b0ed9eafb35b2330d5a96be79307f0e65547febb...81b84c42d645dd9c30b77f804abc07e128dc490b,1,0,2,2,1,2006-09-25 02:55:07,2006-09-24 15:30:44
81b84c42d645dd9c30b77f804abc07e128dc490b...3d74982f0b1f8895d27937aa6ed62c1ddd50a020,3,326,314,640,5,2006-09-25 02:55:08,2006-09-24 15:31:10
3d74982f0b1f8895d27937aa6ed62c1ddd50a020...fd88d9c81ecdefd656b01f288ed9127b7abef53e,8,53,200,253,15,2006-09-25 02:55:08,2006-09-24 21:42:01
7002243f7ee7eb557a1e49420487e150730ff46f...983d2ee284936e8bf14823863d3945b4d8740b94,1,4,0,4,1,2006-11-25 03:07:24,2006-11-25 03:07:24
983d2ee284936e8bf14823863d3945b4d8740b94...75e6e2132006770156d9df1881b4114862919c94,2,51,6,57,12,2006-11-25 04:52:54,2006-11-24 13:45:10
75e6e2132006770156d9df1881b4114862919c94...67affd5173da059ca60aab7896985331acacd9b4,1,8,4,12,3,2006-11-25 07:10:23,2006-11-25 07:10:23
67affd5173da059ca60aab7896985331acacd9b4...747fa12cef73b6ca04fffaddaad7326cf546cdea,1,65,72,137,37,2006-11-25 07:16:58,2006-11-25 06:38:17
747fa12cef73b6ca04fffaddaad7326cf546cdea...d25c26e771fdf771f264dc85be348719886d354f,1,12,8,20,3,2006-11-25 07:17:00,2006-11-25 06:38:18
7002243f7ee7eb557a1e49420487e150730ff46f...9b8dc263e1b0d470cc67a824837d8884ae3e7136,1,61,34,95,9,2006-11-24 23:42:49,2006-10-30 19:08:43
9b8dc263e1b0d470cc67a824837d8884ae3e7136...ed09aef06fda2ba06a7412e3fa43ab1c3449f723,6,150,4,154,14,2006-11-24 23:42:49,2006-10-30 19:09:06
ed09aef06fda2ba06a7412e3fa43ab1c3449f723...016e6ccbe03438454777e43dd73d67844296a3fd,3,96,5,101,17,2006-11-24 23:42:49,2006-10-30 19:09:29
016e6ccbe03438454777e43dd73d67844296a3fd...f53514bc2d82f2f5cc7b447575e74aa266ed46f0,6,97,21,118,24,2006-11-24 23:42:49,2006-10-30 19:09:53
f53514bc2d82f2f5cc7b447575e74aa266ed46f0...abef3a1625b7aff168a5fa062432dc6ef2006963,1,2,1,3,2,2006-11-24 23:42:49,2006-11-11 13:57:23
abef3a1625b7aff168a5fa062432dc6ef2006963...16ad35791099e5da118a0b6cfa0c3db4e2feff81,1,45,0,45,1,2006-11-24 23:42:49,2006-10-30 19:10:13
16ad35791099e5da118a0b6cfa0c3db4e2feff81...cf01bd52efeb21084652b2b06b778ed458004e8f,1,7,4,11,3,2006-11-24 23:42:49,2006-11-14 06:04:56
cf01bd52efeb21084652b2b06b778ed458004e8f...fcd1e3190612fc59c2d820537280b5164d290d9d,1,0,3,3,1,2006-11-24 23:42:49,2006-11-14 06:04:56
fcd1e3190612fc59c2d820537280b5164d290d9d...c6702f4b95699c6bd47337516c32e3408dda0595,1,1,0,1,1,2006-11-24 23:42:49,2006-11-14 06:47:45
c6702f4b95699c6bd47337516c32e3408dda0595...176d45cb20eb4ffc661d73383aec01943e056e10,1,1,0,1,1,2006-11-24 23:42:49,2006-11-14 06:47:46
176d45cb20eb4ffc661d73383aec01943e056e10...d6491e3a214541aeb016b0688d0920845b03932d,1,1,1,2,1,2006-11-24 23:42:49,2006-11-24 14:58:04
d6491e3a214541aeb016b0688d0920845b03932d...1f2de769812f0adea598269d788c9c75d23e80b8,1,1,1,2,1,2006-11-24 23:42:50,2006-11-24 14:58:25
1f2de769812f0adea598269d788c9c75d23e80b8...d158631549b87e11f2415622e421546539b09b67,1,2,0,2,1,2006-11-24 23:42:50,2006-11-24 14:59:12
d158631549b87e11f2415622e421546539b09b67...d64d6c9fc712cf6fad9a3ec7f659cf843ee2e18d,1,3,1,4,1,2006-11-24 23:42:50,2006-11-24 14:58:50
d64d6c9fc712cf6fad9a3ec7f659cf843ee2e18d...4bcb310c2539b66d535e87508d1b7a90fe29c083,1,2,1,3,1,2006-11-24 23:42:50,2006-11-24 15:00:13
fd8ccbec4f0161b14f804a454e68b29e24840ad3...418c4c7bceb7276e2a95772aa34f0cee5e1c47e8,1,11,9,20,9,2006-02-06 22:10:18,2006-02-06 22:10:18
418c4c7bceb7276e2a95772aa34f0cee5e1c47e8...b77b02785d2f589ca336fc449ee1c27837263dac,1,99,501,600,25,2006-02-06 22:13:52,2006-02-06 22:13:52
069b20a198f171512a1d2d2163b40f70c94f5257...562051809589574576971c53c23aad93f8c395d9,1,15,2,17,2,2005-11-30 06:46:12,2005-11-30 05:59:04
9ef2b3cbf62d15aa0312bde349347873d7c0f399...2c4ed386e8861e730037abe4f4d9e032c5c46242,1,1,1,2,1,2005-11-29 07:55:12,2005-11-29 06:20:49
2c4ed386e8861e730037abe4f4d9e032c5c46242...3e9fabc85ef44fa0f275dd89738a2dacb7b6f5db,1,3,2,5,3,2005-11-29 18:51:39,2005-11-29 17:33:36
3e9fabc85ef44fa0f275dd89738a2dacb7b6f5db...b020dcd54cc3f2b783339f83d09e46bb7ff08a3e,1,7,7,14,3,2005-11-29 18:51:41,2005-11-29 14:59:56
b020dcd54cc3f2b783339f83d09e46bb7ff08a3e...034908047d8c46fb4e1323285b3b066567c7fadc,2,21,29,50,12,2005-11-29 18:51:43,2005-11-29 07:13:04
9ef2b3cbf62d15aa0312bde349347873d7c0f399...4ca0660816671f65546626b6e2c2038b6a347a8b,2,27,3,30,7,2005-11-29 07:13:01,2005-11-26 07:14:15
4ca0660816671f65546626b6e2c2038b6a347a8b...edf2e37002eeb30a2ccad5db3b3e1fe41cdc7eb0,1,18,0,18,3,2005-11-29 07:13:01,2005-11-26 07:14:15
edf2e37002eeb30a2ccad5db3b3e1fe41cdc7eb0...e44eb3e4c74c5f6c1fca1cf92ddb454ad248c24c,1,3,0,3,1,2005-11-29 07:13:02,2005-11-26 07:50:21
e44eb3e4c74c5f6c1fca1cf92ddb454ad248c24c...61e2b01529d4cb4138c00a653006d16f7a9179ce,1,2,0,2,1,2005-11-29 07:13:02,2005-11-26 07:52:04
61e2b01529d4cb4138c00a653006d16f7a9179ce...c3e9a6534c88767e2ad9126ed45598157c28d1f4,1,11,1,12,4,2005-11-29 07:13:02,2005-11-26 08:22:48
c3e9a6534c88767e2ad9126ed45598157c28d1f4...706fe6ae03e2c1452d59892944701c56237b903f,1,15,3,18,3,2005-11-29 07:13:02,2005-11-26 08:30:07
706fe6ae03e2c1452d59892944701c56237b903f...b191fa72ea501c0789fb1bd7a80fcec9da38804d,1,14,5,19,5,2005-11-29 07:13:02,2005-11-26 08:40:50
b191fa72ea501c0789fb1bd7a80fcec9da38804d...5a3277133d200151fe526e56e036c933d343958a,8,15,0,15,8,2005-11-29 07:13:02,2005-11-26 08:47:59
5a3277133d200151fe526e56e036c933d343958a...53228a5fb8e80f87803e4a3ba8ed25b70fb4871d,14,29,1,30,15,2005-11-29 07:13:02,2005-11-26 08:50:02
53228a5fb8e80f87803e4a3ba8ed25b70fb4871d...710b7098e28513355cbdbedbb8d9c35ce5b4a488,1,1,1,2,1,2005-11-29 07:13:02,2005-11-28 06:53:20
710b7098e28513355cbdbedbb8d9c35ce5b4a488...1abacf3b5b53f6cde7148862234d451cd88d0de3,1,5,0,5,1,2005-11-29 07:13:03,2005-11-28 07:15:02
1abacf3b5b53f6cde7148862234d451cd88d0de3...9cc2527cd2943c82cf448dccec564869b0a762e6,1,2,4,6,3,2005-11-29 07:13:03,2005-11-28 07:16:15
9cc2527cd2943c82cf448dccec564869b0a762e6...eefaa4fca79f5240eaefd0046a338dbdac8b4204,1,1,2,3,1,2005-11-29 07:13:03,2005-11-28 07:18:04
eefaa4fca79f5240eaefd0046a338dbdac8b4204...7ea2fc47d258657d673ce3b9403ed98cc50e2600,1,1,1,2,1,2005-11-29 07:13:03,2005-11-28 07:19:06
7ea2fc47d258657d673ce3b9403ed98cc50e2600...d6ea70af7708af5f29db09b2d782ab3b9ce50f79,1,8,4,12,2,2005-11-29 07:13:03,2005-11-28 07:19:58
d6ea70af7708af5f29db09b2d782ab3b9ce50f79...d165fa14f0a111dfc85d964ecc037d0b280cd54f,6,30,0,30,6,2005-11-29 07:13:03,2005-11-28 07:33:54
d165fa14f0a111dfc85d964ecc037d0b280cd54f...99e01692063cc48adee19e1f738472a579c14ca2,1,2,2,4,2,2005-11-29 07:13:03,2005-11-28 11:19:03
9ef2b3cbf62d15aa0312bde349347873d7c0f399...b3cfd939c330211c9812f814094aa1dbe9531bdc,2,17,11,28,10,2005-11-29 07:11:38,2005-11-27 19:32:03
b3cfd939c330211c9812f814094aa1dbe9531bdc...e9a45d75b5eccfc288c4533b5e34af1f77dd32c9,1,20,5,25,5,2005-11-29 07:11:38,2005-11-28 01:42:05
9ef2b3cbf62d15aa0312bde349347873d7c0f399...3c5e8468a93cdb427b4c4a129339e80e1813e5c0,3,55,215,270,17,2005-11-29 07:00:14,2005-11-26 17:38:20
3c5e8468a93cdb427b4c4a129339e80e1813e5c0...b45c569b6f257d8905acd8313224dc086266f602,1,4,5,9,5,2005-11-29 07:00:14,2005-11-27 19:00:09
b45c569b6f257d8905acd8313224dc086266f602...e2466376ec9a8508b4c8ba2b0c29945c5bfc6cc2,1,26,4,30,6,2005-11-29 07:00:14,2005-11-28 06:48:08
e2466376ec9a8508b4c8ba2b0c29945c5bfc6cc2...32b5904b5f94829aa7ae11b585ca9c639d57cc74,1,3,1,4,1,2005-11-29 07:03:12,2005-11-28 10:30:04
32b5904b5f94829aa7ae11b585ca9c639d57cc74...246cc52f388cae8ca99e5a12b8458c9bfa467765,3,22,56,78,28,2005-11-29 07:06:29,2005-11-28 10:32:42
2be8fd085e865097fa0908fe1a94c8edf9cde7f5...50496b2170cbe87b4c13f89f274aa2f181522bb9,1,5,0,5,2,2005-11-04 02:35:18,2005-11-04 01:54:52
50496b2170cbe87b4c13f89f274aa2f181522bb9...a10aad6a9a37fbafcda590a00ddaf7b2bfda940e,1,13,11,24,8,2005-11-04 07:05:49,2005-11-03 23:26:43
a10aad6a9a37fbafcda590a00ddaf7b2bfda940e...810bf1f9448c1db7f52cfa43c077c677fb080fce,1,39,4,43,4,2005-11-04 08:04:17,2005-11-04 08:04:17
810bf1f9448c1db7f52cfa43c077c677fb080fce...3746501664e3fcf6c44080cb599b50bf9cbea2be,4,88,11,99,8,2005-11-04 08:18:29,2005-11-04 08:06:20
3746501664e3fcf6c44080cb599b50bf9cbea2be...d8ae1d10cd08ff1f0b749222d083446ef7bd8f3f,2,3,2,5,2,2005-11-05 02:17:16,2005-11-05 02:17:16
d8ae1d10cd08ff1f0b749222d083446ef7bd8f3f...bccf5956c323a043e9a5d540b3c842ae6e5e5220,2,103,32,135,24,2005-11-05 03:28:39,2005-11-05 02:36:08
bccf5956c323a043e9a5d540b3c842ae6e5e5220...fdd089793c1d694fa742da51dfbf0227d61d4c0e,4,30,4,34,6,2005-11-05 09:39:18,2005-11-05 09:37:00
fdd089793c1d694fa742da51dfbf0227d61d4c0e...bd7c8aab7098e6e340060c0d7f1fab8595905b2d,1,7,0,7,2,2005-11-05 10:48:29,2005-11-05 10:47:07
bd7c8aab7098e6e340060c0d7f1fab8595905b2d...28ffb8987af97e28accc707c724207fbd745b027,1,20,0,20,1,2005-11-05 10:55:18,2005-11-05 10:55:18
28ffb8987af97e28accc707c724207fbd745b027...e6c64fc1e9b3b9a5ea7101f8a2a499c9e2112da5,1,4,1,5,3,2005-11-05 19:02:56,2005-11-05 19:02:56
e6c64fc1e9b3b9a5ea7101f8a2a499c9e2112da5...32276c8059908874afb7a2db039ccc7bcfd84ec7,1,3,24,27,3,2005-11-05 19:07:22,2005-11-05 19:07:22
32276c8059908874afb7a2db039ccc7bcfd84ec7...3d95bf074e8532fd0643b886422eddd0768a3f2c,1,1,2,3,1,2005-11-05 19:44:35,2005-11-05 19:44:35
df8baa42fe4eeb5a021ac262caf601f44d2a5746...e1d04f8aad59397cbd55e72bf8a1bd75606f5350,2,7,1,8,2,2005-10-03 23:27:46,2005-10-03 23:26:51
df8baa42fe4eeb5a021ac262caf601f44d2a5746...619e5a0ed4a53653085961b7aefe1f93ed879949,1,2,1,3,1,2005-10-03 22:45:44,2005-10-03 22:45:44
760b6634461ded0a9f09e86388c0ad7500641f1e...b893f09104ee5f1d8710dfe17cdf1cbac995f17a,1,4,0,4,1,2005-09-06 23:46:34,2005-09-06 23:46:34
b893f09104ee5f1d8710dfe17cdf1cbac995f17a...597c9cc540c2ca5d0b0eeaa3f453dffa14afab6d,7,36,40,76,14,2005-09-07 19:22:56,2005-09-07 19:22:56
597c9cc540c2ca5d0b0eeaa3f453dffa14afab6d...5077fa9c1e3af760dd3573ac94be6cb27ad74849,4,167,18,185,15,2005-09-07 21:20:57,2005-09-07 21:08:38
5077fa9c1e3af760dd3573ac94be6cb27ad74849...0270f7c500cf1645e7102cbe4ddd32cbcaf5f8a9,1,14,9,23,6,2005-09-07 21:24:39,2005-09-07 21:17:18
0270f7c500cf1645e7102cbe4ddd32cbcaf5f8a9...f67545eade1913858346dba15ff613d3a5a6fbf5,1,16,9,25,6,2005-09-07 21:24:41,2005-09-07 21:18:51
f67545eade1913858346dba15ff613d3a5a6fbf5...8bfcd309907b1f612e82477739bbe2b98b5689a4,1,9,10,19,5,2005-09-07 21:24:41,2005-09-07 21:19:48
8bfcd309907b1f612e82477739bbe2b98b5689a4...fa6a1427c608e4e4a22aa6d176dd7b001b5f3021,1,10,10,20,5,2005-09-07 21:24:41,2005-09-07 21:20:41
fa6a1427c608e4e4a22aa6d176dd7b001b5f3021...452ce291a99131768e2d61d2dcf8a4a1b78d39a3,1,12,12,24,6,2005-09-07 21:28:21,2005-09-07 21:28:21
452ce291a99131768e2d61d2dcf8a4a1b78d39a3...7eb93c89651c47c8095d476251f2e4314656b292,1,1,3,4,1,2005-09-07 21:29:50,2005-09-07 07:29:20
9e3e2a55961b846f0b92867591ce971a744b7583...ab22707f0a9480b2fe47d20030a03994f8e5d0b3,1,2,0,2,1,2005-08-25 01:53:15,2005-08-23 21:03:14
ab22707f0a9480b2fe47d20030a03994f8e5d0b3...569061432e3a695d5a4178d515971ddcc0a80709,1,1,1,2,1,2005-08-25 01:53:29,2005-08-24 00:14:13
f85a41916163097c3c307ac45d1a935564c52bf0...62cd033daa48f5fadda8921635a7073d3adc4a32,1,17,9,26,6,2005-08-30 04:10:08,2005-08-30 02:31:22
62cd033daa48f5fadda8921635a7073d3adc4a32...1efdd27f54e42746c23944cfe77e568673b2a0fa,1,8,10,18,5,2005-08-30 04:10:09,2005-08-30 02:32:04
1efdd27f54e42746c23944cfe77e568673b2a0fa...b5dca4bbd97dc43e34c1361a32c212298508102c,1,10,8,18,7,2005-08-30 04:10:09,2005-08-30 02:33:14
b5dca4bbd97dc43e34c1361a32c212298508102c...cf6de18aabf774dfce7efd9c59babfe9d909d433,1,2,6,8,3,2005-08-30 04:10:10,2005-08-30 02:34:07
cf6de18aabf774dfce7efd9c59babfe9d909d433...5de36bfec9beb65f8d0328b367dcf0e7d74d30bb,2,2,2,4,2,2005-08-30 04:17:21,2005-08-30 04:17:21
5de36bfec9beb65f8d0328b367dcf0e7d74d30bb...9fa4db544e2e4d6c931f6adabc5270daec041536,1,1,1,2,1,2005-08-30 04:19:04,2005-08-30 04:19:04
9fa4db544e2e4d6c931f6adabc5270daec041536...bc4af68a1a876a9eb6ff030b88b76a90fd09a9ea,1,3,0,3,1,2005-08-30 04:25:19,2005-08-30 04:25:19
bc4af68a1a876a9eb6ff030b88b76a90fd09a9ea...3459c2c433ac46eac596810d2ef2c3d4ef949852,1,199,0,199,1,2005-08-30 04:50:49,2005-08-30 04:50:49
d007dbf7d6d647dbcf0f357545f43f36dec46f3b...becb4336cb05c5ec456babaeafefa2e24ee85773,3,13,2,15,4,2013-11-20 19:26:08,2013-11-20 19:26:08
384364b5f1aa0c3b7610a1b3c9eca2c210e61b41...9fe0cf3a5ee01ebe0c323789cce3916b443980dc,1,23,23,46,1,2014-03-24 19:43:07,2014-03-10 05:32:01
4a3fc52d34adcc83e32fb23b003c15715ebce64a...d2446dfd7f3b3f8948142cfb07a0270e2497d93f,2,6,1,7,2,2013-11-27 20:14:45,2013-11-27 20:14:45
039a6d24638dc995d716bbc6916ae670c185bf11...5fd09df3937f54c5cfda4f1087f5d99433cce527,1,1,1,2,1,2013-11-20 19:27:26,2013-11-20 19:18:25
e8a2f5f271c2709a6960931df9788f8f8f4b66c4...864085aaf6bafceb19191debbbdb19a5959248e2,1,15,0,15,3,2014-01-13 19:39:09,2014-01-13 19:39:09
2ae48a9bb87193de9e9da10abd9e7286c0e4c43d...d22e567770866a0bbe746316561be50b521eb8a5,1,4,0,4,1,2012-06-15 20:22:52,2012-06-15 18:14:46
d22e567770866a0bbe746316561be50b521eb8a5...1fd8f97f6e2c5f928e7399adb59b6d87ac82eb08,1,24,7,31,4,2012-06-15 20:24:06,2012-06-15 18:05:05
f760c903b8525878cd3b426fc61a7a2cf8742609...c26ddce86d7215b4d9687bd4c6b5dd43a3fabf31,1,1,1,2,1,2012-06-04 19:54:48,2012-06-04 19:20:59
d8cf053dacb4f78920c112d10c7be21e4f5a5817...a9073097b984a2a1db4f3b0df86cfaf624dfef21,1,2,2,4,2,2012-10-02 19:39:55,2012-10-02 07:25:32
d8cf053dacb4f78920c112d10c7be21e4f5a5817...0971e992c4e2806b427a09239ee48a90280c9b15,1,29,30,59,21,2012-10-01 19:27:45,2012-09-30 19:44:36
f84667def209e4a84e37e8488a08e9eca3f208c1...15fabd1bbd4c997d0edb2249295e2717bc18b6c7,1,79,25,104,6,2012-10-09 23:04:12,2012-10-09 23:04:12
15fabd1bbd4c997d0edb2249295e2717bc18b6c7...7687a0541e0a6d86c5005d84057321368181c1b5,3,134,131,265,4,2012-10-09 23:17:50,2012-10-09 23:17:50
7687a0541e0a6d86c5005d84057321368181c1b5...c5c31d3381d11903c01d51aff4437fe9f76d0268,3,45,39,84,4,2012-10-10 06:21:29,2012-10-03 21:47:48
c5c31d3381d11903c01d51aff4437fe9f76d0268...918d4e1c907983d26b0c4d82d7f7abff4dbec4e5,2,9,2,11,4,2012-10-10 06:21:29,2012-10-09 23:40:03
918d4e1c907983d26b0c4d82d7f7abff4dbec4e5...34a4ae55b260bbd1520d6a7c6718b4de2d5c7632,2,8,2,10,3,2012-10-10 06:21:29,2012-10-03 21:50:51
f84667def209e4a84e37e8488a08e9eca3f208c1...f271fad2661d2f26654e9b4b3ecb17ad0ea711e8,2,63,5,68,5,2012-10-05 22:48:12,2012-08-20 01:39:40
f271fad2661d2f26654e9b4b3ecb17ad0ea711e8...14d3ce1120287e0f03d9d0349ba25c36a9b54fd8,2,53,1,54,2,2012-10-05 22:48:12,2012-08-20 01:39:41
14d3ce1120287e0f03d9d0349ba25c36a9b54fd8...a967cb15d3eee0d4992f92edab50da0ddbb97738,1,4,4,8,2,2012-10-05 22:48:12,2012-08-19 22:43:19
a967cb15d3eee0d4992f92edab50da0ddbb97738...9478b11968d61085bb4c4343395b6f52ce06380f,2,12,1,13,2,2012-10-05 22:48:12,2012-08-30 22:53:57
9478b11968d61085bb4c4343395b6f52ce06380f...f3045919d148b443158d2b64a5a73375286514c1,2,2,2,4,2,2012-10-05 22:48:12,2012-09-18 00:09:31
f3045919d148b443158d2b64a5a73375286514c1...52de6fa2c7ac26a67027e715d45771cb908eb77c,1,2,2,4,2,2012-10-05 22:48:12,2012-09-17 09:13:31
52de6fa2c7ac26a67027e715d45771cb908eb77c...dc01f880a53e56d4a5c6f30cb2d7b9412e17bfe7,1,0,1,1,1,2012-10-05 22:52:52,2012-10-05 07:04:31
6de030dd469f2720b00b22abdd04dbe566f9f4f6...9306b5b9a33185e7867202718162d8a38d5627ab,1,415,437,852,396,2012-10-16 00:39:10,2012-10-16 00:39:10
9768cafe681a7844d5a1d067991053b25db83bbb...ec57a821a3bacdaaaf5eeba55a124bf1a502a13f,1,14,16,30,3,2012-05-01 18:01:47,2012-05-01 17:10:12
ec57a821a3bacdaaaf5eeba55a124bf1a502a13f...4434e6ba6c2de994bd28892abe9fb3bdf1641560,1,37,0,37,1,2012-05-01 18:02:12,2012-05-01 17:10:13
4434e6ba6c2de994bd28892abe9fb3bdf1641560...e18872b2f0fba4cb860c9350bb8b8d8680dfc83b,2,24,22,46,5,2012-05-02 04:26:46,2012-05-01 17:10:14
9768cafe681a7844d5a1d067991053b25db83bbb...8d7ec3629cb1fc315b3218a8f277545157334a86,2,14,5,19,7,2012-04-30 22:59:01,2012-04-30 00:57:14
8d7ec3629cb1fc315b3218a8f277545157334a86...0f224e5b73a73f37887eb7cb3e51073f889a3f9c,1,92,0,92,1,2012-04-30 22:59:38,2012-04-30 00:57:15
0f224e5b73a73f37887eb7cb3e51073f889a3f9c...b6ad6dcc3b0629d525abc9fe0882e1b0eb969e17,3,20,5,25,11,2012-04-30 23:00:04,2012-04-30 00:57:16
b6ad6dcc3b0629d525abc9fe0882e1b0eb969e17...9d7d446ae94d03ff3b7b32e7341198d9b2c5b222,3,185,28,213,16,2012-04-30 23:00:08,2012-04-30 00:57:17
9768cafe681a7844d5a1d067991053b25db83bbb...82247e9bd5f7c90c4eac9674fb7518845cd3e432,15,24,24,48,24,2012-04-30 22:45:51,2012-04-30 00:28:45
82247e9bd5f7c90c4eac9674fb7518845cd3e432...5eaeda70de1e7763d070e8ccfbcd8ca10baea800,1,1,1,2,1,2012-04-30 22:45:54,2012-04-30 00:28:46
216d2e0f3f9ab672077d0aa7aa20e6e9c2ac8ff3...4133fd25525022f99d2c7ba339618433bdd919fe,4,50,3,53,5,2010-02-10 21:44:11,2010-02-10 21:44:11
04ce83e2b9a1f1512d3d0c873e8f13d06761620c...1cd749cc0722533bd1849f491ec9ab19e17232e1,1,6,3,9,3,2009-10-07 20:05:03,2009-09-29 06:40:09
14b772a0d7cb983ab0c13d672ea89192c460d070...6d71c1dca4396de545a6c9667b3dcf0c03e42b30,1,18,15,33,16,2009-09-07 22:45:13,2009-09-06 10:22:58
6d71c1dca4396de545a6c9667b3dcf0c03e42b30...90e431152e05d3e8eb80a0db2e81b7cf50ecc745,1,2,0,2,2,2009-09-07 22:45:13,2009-09-07 12:34:35
850bc56defe2abf68ce26c5c80761d3df59c2ba7...c8a9f3d385bea60438b577f5db9285faf254fcc2,1,4,6,10,3,2013-01-09 22:10:53,2013-01-09 19:44:38
c8a9f3d385bea60438b577f5db9285faf254fcc2...29b1b21f07f8d9b1778a4f3df690e004832d4be8,1,47,39,86,9,2013-01-09 22:16:06,2013-01-09 19:45:29
39e2e020608716e8710ff391e0d2b6d035cb3dd6...304b7d99a705e8c125650dda347a571402222a3e,3,14,2,16,6,2012-09-18 21:34:31,2012-09-18 21:34:31
2c162b56f370f5c33e6a945e6922d598006c5ec4...12bf828348922935b1d5ca10f2d829c9a64b6e41,4,30,5,35,7,2011-06-19 21:37:23,2011-06-18 22:12:01
2c162b56f370f5c33e6a945e6922d598006c5ec4...b8a9733377a648483958bf5472158f7c01641420,1,4,1,5,1,2011-06-16 22:02:31,2011-06-16 20:22:16
b8a9733377a648483958bf5472158f7c01641420...452993c297530498780d4b0c7b2b267258cb625f,1,1,2,3,1,2011-06-16 22:10:54,2011-06-16 20:23:14
452993c297530498780d4b0c7b2b267258cb625f...924aaf3ef764a5e8e976f68e024ecacf54ff6306,1,50,30,80,26,2011-06-16 22:10:59,2011-06-16 20:24:51
2c162b56f370f5c33e6a945e6922d598006c5ec4...302bd999fd0ef41f3605a2212c23f54ae43649f8,2,2,2,4,2,2011-06-16 16:21:36,2011-06-16 16:21:36
2c162b56f370f5c33e6a945e6922d598006c5ec4...2321286298bf956a3fa8e91dd361b8cf4e81e6a0,1,14,4,18,4,2011-06-15 22:56:28,2011-06-15 22:31:28
2321286298bf956a3fa8e91dd361b8cf4e81e6a0...40e7629194c79e72009b5b8e98cce65921b0faf2,1,1,1,2,1,2011-06-22 18:12:34,2011-06-22 01:22:20
40e7629194c79e72009b5b8e98cce65921b0faf2...13e0f88d4aba326da9217c225d6ab5e642eb611d,4,52,27,79,13,2011-06-22 18:12:35,2011-06-22 01:23:33
13e0f88d4aba326da9217c225d6ab5e642eb611d...4d7c98986379b0ab93cbf9092b60dfb5ab1cee7c,4,7,4,11,5,2011-06-22 18:12:35,2011-06-22 01:24:07
4d7c98986379b0ab93cbf9092b60dfb5ab1cee7c...56baa61d011e9ed5199766fea89ea8c2c183f0ba,4,41,41,82,16,2011-06-22 18:12:35,2011-06-22 01:24:48
56baa61d011e9ed5199766fea89ea8c2c183f0ba...08716b3c11f4899c1be046eca735761b30ca686d,1,19,6,25,2,2011-06-22 18:12:35,2011-06-22 01:25:25
08716b3c11f4899c1be046eca735761b30ca686d...767cf4579f0e34a3cfc6704d5c313842321dfafa,3,165,1,166,11,2011-06-22 18:12:35,2011-06-22 01:26:31
767cf4579f0e34a3cfc6704d5c313842321dfafa...0e804e09938905ed4fe6984f832057267cc5d86f,3,51,0,51,5,2011-06-22 18:12:35,2011-06-22 01:27:35
0e804e09938905ed4fe6984f832057267cc5d86f...7b97730b764cac823531ccd14669f9c5b45496dc,8,49,13,62,20,2011-06-22 18:12:35,2011-06-22 03:17:35
2c162b56f370f5c33e6a945e6922d598006c5ec4...b7d878075e751859ff344c8334ae016228676c4d,1,5,0,5,1,2011-06-15 22:30:16,2011-06-15 16:54:15
2c162b56f370f5c33e6a945e6922d598006c5ec4...adb231cfdabd9b62c2d99519ac5f8ba29d689478,1,9,3,12,1,2011-06-13 18:23:28,2011-06-09 07:47:02
adb231cfdabd9b62c2d99519ac5f8ba29d689478...15ffb7cde48b73b3d5ce259443db7d2e0ba13750,2,188,6,194,5,2011-06-13 18:24:48,2011-06-13 17:15:26
d6d9e76d7f06c5ba94517d258e051544885780c5...97b1b4f3a682377aa8f03348618e79bd1df1772e,2,5,1,6,3,2011-03-25 21:16:01,2011-03-25 18:10:38
97b1b4f3a682377aa8f03348618e79bd1df1772e...4b3ffe5184bd550dddacdd0b32b18ad0e73c7908,2,12,1,13,2,2011-03-25 21:16:27,2011-03-25 18:13:31
b7fcb582e53cf2b3600263afa08cf4dce49a13f7...bd757c18597789d4f01cbd2ffc7c1f55e90cfcd0,4,5,7,12,5,2010-01-04 00:17:03,2010-01-03 16:20:30
bd757c18597789d4f01cbd2ffc7c1f55e90cfcd0...4ecbc65fa7decb2aa271d68d54e8563a679e6ec1,1,1,1,2,1,2010-01-06 06:40:58,2010-01-06 06:37:59
aba7dea83bfba411dee0271491d6199d2dca61d9...1cef6500a9edc7997bd0aa4cd1f739f5106ab0a9,1,24,0,24,3,2010-01-23 11:23:03,2010-01-07 00:25:21
1cef6500a9edc7997bd0aa4cd1f739f5106ab0a9...41c01693ac13846c73a31c8f5c3a60206e1643be,1,15,4,19,1,2010-01-23 11:23:03,2010-01-07 00:25:22
41c01693ac13846c73a31c8f5c3a60206e1643be...a83b91e7246fed3df5686c29a3c64eed8670fd98,1,4,0,4,1,2010-01-23 11:23:03,2010-01-11 16:20:43
a83b91e7246fed3df5686c29a3c64eed8670fd98...99bacd6c25d30766921468d09323b2c34cf62cb8,1,11,1,12,1,2010-01-23 11:23:03,2010-01-11 16:21:23
99bacd6c25d30766921468d09323b2c34cf62cb8...6594f0b793507a1e00f79c9884b8911c6d047c1c,1,6,2,8,2,2010-01-23 11:23:04,2010-01-11 16:21:51
6594f0b793507a1e00f79c9884b8911c6d047c1c...a65f3c202b8771f79117b566946d9cb3348f6fad,1,13,0,13,1,2010-01-23 11:23:04,2010-01-11 16:22:27
a65f3c202b8771f79117b566946d9cb3348f6fad...c79f1189bc4e7d9bb9cb673c043ce8f587a9a92d,3,485,127,612,80,2010-01-23 11:23:04,2010-01-21 21:55:48
c79f1189bc4e7d9bb9cb673c043ce8f587a9a92d...3e18ce1ac3034b1562ec748523aa7636e1b58b52,4,140,8,148,12,2010-01-23 11:23:04,2010-01-23 08:30:00
3e18ce1ac3034b1562ec748523aa7636e1b58b52...075762085c6668f11c4ea165ecec17f69245ef09,4,320,20,340,10,2010-01-23 11:23:04,2010-01-23 08:30:01
aba7dea83bfba411dee0271491d6199d2dca61d9...a88183f168660bb784baad536e44239a1f3dffb8,1,12,0,12,2,2010-01-23 06:07:29,2010-01-23 06:03:36
a0b1cb60ab296476084b3d4766a943e2d62719b8...632052641517de1a965c1f045b97d2eaa541b2e9,4,36,3,39,5,2011-09-23 21:43:05,2011-09-23 21:38:39
3288f20171ce6aee5d9d51d111ee17cd4b426af4...8a3c63e01d2b1df471beafff5fb78df4bade9388,2,22,4,26,3,2009-11-23 23:36:07,2009-11-23 22:40:03
1f73566af5bec28cd8489c6139a9ede95817349c...56932249cf7d327115eae608d550e3a8cca4ea06,1,2,0,2,2,2010-01-17 00:43:49,2010-01-15 20:12:15
56932249cf7d327115eae608d550e3a8cca4ea06...928500e00e0a73a11f5b2296d9baa82dafa7a1a8,1,14,2,16,3,2010-01-17 00:43:51,2010-01-15 20:12:16
928500e00e0a73a11f5b2296d9baa82dafa7a1a8...3e34d6657733430164ef67ab2f000fa3d10d51b5,1,8,29,37,6,2010-01-17 00:43:52,2010-01-15 20:12:17
3e34d6657733430164ef67ab2f000fa3d10d51b5...75301f90159a505f3683a5eba10174928dc30fb1,3,50,49,99,12,2010-01-17 00:43:53,2010-01-15 20:12:18
75301f90159a505f3683a5eba10174928dc30fb1...b6f714f89a2abb591e6d46595f43bc8d4d356a72,2,19,25,44,6,2010-01-17 00:43:55,2010-01-15 20:12:19
b6f714f89a2abb591e6d46595f43bc8d4d356a72...44626dc7d562d23b54d969bb73ddeda12d5602e9,6,217,11,228,19,2010-01-17 02:16:06,2010-01-15 20:12:20
44626dc7d562d23b54d969bb73ddeda12d5602e9...a6d15bc33529f923b205930d0a58fe6226570dc1,1,19,17,36,3,2010-01-17 02:16:13,2010-01-15 20:12:21
1f73566af5bec28cd8489c6139a9ede95817349c...ee6fc514f2df821c2719cc49499a56ef2fb136b0,4,124,17,141,16,2010-01-17 00:40:50,2010-01-16 17:42:24
1f73566af5bec28cd8489c6139a9ede95817349c...e9fcd1e2121100d43d2d212eb6c6f1fc82aade1d,5,136,1,137,10,2010-01-17 00:39:58,2010-01-16 21:45:31
1f73566af5bec28cd8489c6139a9ede95817349c...688cd6d2b9335f2ac20d02996215a0e6da1779b5,2,2,2,4,2,2010-01-16 04:40:25,2010-01-14 15:02:21
688cd6d2b9335f2ac20d02996215a0e6da1779b5...4e1a7baa2e466afded9ff50b9a4539b24dbd3584,1,2,1,3,2,2010-01-19 23:04:23,2010-01-17 08:43:13
cd7c0be19f49efe77a8b0690ab92d2eb1cff1778...f8750a0ea951a328481b67b5d0558c0402f0cdfd,1,308,273,581,41,2012-08-24 04:30:51,2012-08-23 05:33:15
cd7c0be19f49efe77a8b0690ab92d2eb1cff1778...c142616fb2152d7887f9c38ff20e07167d31b0c8,2,156,118,274,49,2012-08-22 18:15:43,2012-08-22 10:52:30
fa0aad4ff5079132e0a163daa701506d652b2bf8...41c1709a56da5dd4f4f68268a91d2c55370826cd,1,2,2,4,2,2012-08-08 19:11:53,2012-08-08 18:32:37
41c1709a56da5dd4f4f68268a91d2c55370826cd...1b7b522c2698ced2a60d5c26bf5b16e01bd45a75,1,3,0,3,1,2012-08-08 19:11:53,2012-08-08 18:34:33
1b7b522c2698ced2a60d5c26bf5b16e01bd45a75...63b903962a201fb6c618051b2c7f1366035f27be,1,1,0,1,1,2012-08-08 19:11:53,2012-08-08 18:34:39
63b903962a201fb6c618051b2c7f1366035f27be...c6632eba5a14791b1fa376cd59eb334c29732327,4,5,3,8,4,2012-08-08 19:11:54,2012-08-08 18:34:49
c6632eba5a14791b1fa376cd59eb334c29732327...cf6aaff3771916e71bac0ced545ec420b768f172,1,6,2,8,3,2012-08-08 21:31:12,2012-08-08 20:56:04
cf6aaff3771916e71bac0ced545ec420b768f172...eb28501e15c069d61c7dd7601fad2655449ebb14,1,1,2,3,2,2012-08-08 21:31:41,2012-08-08 20:56:42
eb28501e15c069d61c7dd7601fad2655449ebb14...7d02b574f40b33d6abfecf8fed98cee94a738071,1,0,1,1,1,2012-08-08 21:31:59,2012-08-08 20:57:13
7d02b574f40b33d6abfecf8fed98cee94a738071...5fafce0b782dabc48e47828bde5478a15040298f,2,5,24,29,3,2012-08-08 21:32:17,2012-08-08 20:57:52
cf7864837c12c396ad5927cb6c0bbaa790cda7ad...476109fa4c261c57cf20858b1879d5fede32e32c,1,19,2,21,2,2012-07-24 21:08:43,2012-07-24 21:08:43
52b195f2b8e0d8c9d4583aab44846698ed3149f2...15b7898c5e9fc6fed9a6064213cfcd08cf7d7314,4,30,3,33,5,2011-12-14 05:32:30,2011-12-14 05:30:40
bd5bce7cbc55fa52277cc8a39f673c3e2dc60670...5480207c4ee395fbb82682bc2065c93a43e24328,1,6,3,9,1,2011-11-21 17:29:06,2011-11-21 13:30:40
bd5bce7cbc55fa52277cc8a39f673c3e2dc60670...1e501a7c47ad5ada53d3b1acfb9f131f76e969ec,1,1,1,2,1,2011-11-21 17:14:34,2011-11-14 22:55:52
cf8ddeead9d0f5b13b268633ead6837803cd40de...463b0ea22b5b9a882e8140d0308433d8cbd0d1fe,2,38,2,40,2,2011-10-14 21:45:49,2011-10-14 20:53:31
ed36a48e6d246f4f60d44b27e8c1e660151cd0b4...5f9f8d15f176a02cc66531cf5b5f749bec068961,1,61,43,104,21,2011-11-18 07:35:22,2011-11-18 01:27:46
a5794988dd055fa4c2d28c4d73000577970beb1e...dbe9c5adf95e99c35dd728af2114fccfb9117c65,1,18,3,21,5,2011-05-11 18:56:11,2011-05-11 18:56:11
3970fc5512ac52e798579cf734957a2fac852cfd...4e3aa87d13b339fa678cd3cb7f23664d3a48fb21,1,29,3,32,8,2011-05-06 18:13:08,2011-05-06 18:13:08
9f5df6fa670938a505a64edf1b779b1326311481...e839fe6c1206292aeb4518939b8f124ae5068619,3,81,2,83,3,2011-04-27 19:09:04,2011-04-27 19:09:04
b7511571e3ecd6b81a47e42a52cf9b5160a3d6e9...212f0ba357cde43d1cf66692f73a2f662d13ac55,3,42,2,44,3,2010-05-09 05:58:36,2010-05-09 05:58:36
212f0ba357cde43d1cf66692f73a2f662d13ac55...70ee0b7797041621b22c448726f4f88102b5a4f5,1,2,0,2,2,2010-05-09 08:22:31,2010-05-04 23:36:47
70ee0b7797041621b22c448726f4f88102b5a4f5...cb82dbf8be199d114cd220713e4f57574b4636f8,1,1,1,2,1,2010-05-09 08:25:18,2010-05-07 19:50:03
cb82dbf8be199d114cd220713e4f57574b4636f8...1174768b460a5f24ef0323783ab69c578e5aa44a,1,0,1,1,1,2010-05-09 08:25:19,2010-05-08 16:40:41
1174768b460a5f24ef0323783ab69c578e5aa44a...73d419558d9fa4de3be28bd58158636bc739808e,2,29,0,29,4,2010-05-09 08:25:19,2010-05-06 20:20:43
f1ba1c90e1704e937ff59ee510a8d46a5ab52a1a...8b1fa778676ae94f7a6d4113fa90947b548154dd,6,102,1,103,10,2010-03-28 16:48:25,2010-03-26 22:53:57
8b1fa778676ae94f7a6d4113fa90947b548154dd...572e4f6a0c14f650d4cd71876e4249be4c3ad019,1,19,32,51,7,2010-03-28 16:50:02,2010-03-26 22:56:01
572e4f6a0c14f650d4cd71876e4249be4c3ad019...b3d83d9f2ef1b0f0f53bb7254e234c743aa42817,1,1,1,2,1,2010-05-21 10:59:12,2010-05-21 10:07:47
f1ba1c90e1704e937ff59ee510a8d46a5ab52a1a...9db5ebf4022d8e11ac20e75a3d43af161b752fcd,3,122,3,125,7,2010-03-21 23:43:30,2010-03-21 15:34:38
f1ba1c90e1704e937ff59ee510a8d46a5ab52a1a...502be959531b34e2d9283213b7bca51842639240,4,19,6,25,6,2010-03-20 16:03:52,2010-03-20 14:48:08
502be959531b34e2d9283213b7bca51842639240...100e762a60a691a4978434f1cd5532e19cad39fc,7,17,17,34,15,2010-03-20 16:04:38,2010-03-20 14:48:09
f1ba1c90e1704e937ff59ee510a8d46a5ab52a1a...65f83dc082ee6916188f8193f9a72acca008cea1,1,4,39,43,39,2010-03-20 15:17:00,2010-03-19 23:36:34
65f83dc082ee6916188f8193f9a72acca008cea1...f3b1fbf8602e9038ee12a44bbd71b49e6ab59fe1,1,1,1,2,1,2010-03-20 15:21:50,2010-03-19 23:36:35
f3b1fbf8602e9038ee12a44bbd71b49e6ab59fe1...49de47cfb2d717b64cf93c5abeeefb87ee483de0,1,1,1,2,1,2010-03-20 15:22:32,2010-03-20 00:10:20
f1ba1c90e1704e937ff59ee510a8d46a5ab52a1a...a502ab93339adeef014e1d95cb8f2520379a8651,1,1,1,2,1,2010-03-20 14:27:55,2010-03-18 15:03:43
a502ab93339adeef014e1d95cb8f2520379a8651...a673cfede6987ee815de9189eab054fc462e5c9f,1,11,10,21,11,2010-03-20 15:28:16,2010-03-20 03:20:12
a673cfede6987ee815de9189eab054fc462e5c9f...4a45f7dd49ba9a8943ad9b11fb7bed04f0cb4f15,5,67,58,125,8,2010-03-20 16:15:17,2010-03-20 08:29:11
4a45f7dd49ba9a8943ad9b11fb7bed04f0cb4f15...6a01298a7ed2c18cd68358127304024575b27cc0,1,1,1,2,1,2010-03-20 16:18:48,2010-03-19 04:39:10
7ff8b790bb6a0733177ab712cc7e4374a218f34b...4a2284b9997400d46b439a9cd272ba16cbf4f377,1,12,12,24,12,2010-03-12 05:40:33,2010-03-12 05:40:33
c6830a3b7ea043714966121e40f47d1077c681ac...e007240cb940811a6e075d35f5c3a93a44c54f5a,1,21,3,24,4,2010-03-08 08:54:05,2010-03-08 08:54:05
eee49b6ce4b7b3fed28794676c67ad3609f658ac...f9a2743c3529baab6de650aa3e3eb96de9386fec,3,8,7,15,9,2010-04-11 20:48:46,2010-04-11 20:40:12
3a27f415dfa46bd9e5b693abcac708903d3134f4...2ec33cdd19bd80308fcef45828e37e79c4b56dc5,2,9,2,11,2,2010-03-15 06:08:09,2010-03-15 04:48:22
134550fe21f2c70519b32cada993bfd0c644925b...68ce93307fcc0364816664114a71c58f60bbad94,1,6,12,18,6,2010-04-10 20:01:17,2010-04-10 14:53:53
68ce93307fcc0364816664114a71c58f60bbad94...59a8630338ea0173b9777eb9b3e3c9185643efb1,1,7,4,11,3,2010-04-10 20:01:20,2010-04-10 14:53:54
59a8630338ea0173b9777eb9b3e3c9185643efb1...79ca070ce5927e9cfc535e195b9082eb7dc5c55c,1,6,0,6,1,2010-04-10 20:01:21,2010-04-10 14:53:55
79ca070ce5927e9cfc535e195b9082eb7dc5c55c...69cf7bfd131ae6246931459a1e6513d51f0b0119,3,12,11,23,12,2010-04-10 20:01:23,2010-04-10 14:53:56
5e4f61474202122f376b16181b760f390623bf4e...10e13ec8ed36019d131d27cd9fe2e8cc0f99b896,1,7,5,12,4,2010-03-28 16:52:59,2010-03-26 15:25:32
10e13ec8ed36019d131d27cd9fe2e8cc0f99b896...d1723296af67e6bbadf6e73cd1e921aefafe491f,2,9,0,9,2,2010-03-28 16:53:01,2010-03-26 15:25:33
d1723296af67e6bbadf6e73cd1e921aefafe491f...80d706afed6c6c6fb3ac9c168a6a958244405b45,5,51,15,66,5,2010-03-28 16:53:04,2010-03-26 15:25:34
80d706afed6c6c6fb3ac9c168a6a958244405b45...25755e842f814751fbdb7abfc8255a40f24bfaa3,1,1,1,2,1,2010-03-28 16:53:05,2010-03-26 15:25:35
5e4f61474202122f376b16181b760f390623bf4e...10439d89ebe77a1fb8f05a8ad5d5f4071639bb3e,1,3,3,6,2,2010-03-28 16:24:25,2010-03-27 15:00:19
5e4f61474202122f376b16181b760f390623bf4e...0ef37164c2e453e8348fee05e50d3a4ed6d69f6b,2,2,1,3,2,2010-03-28 16:19:05,2010-03-17 19:55:51
0ef37164c2e453e8348fee05e50d3a4ed6d69f6b...502ffe3491bb6a3aff3f93e7eea19c01cf30c337,1,3,1,4,2,2010-03-28 16:19:11,2010-03-17 19:55:52
502ffe3491bb6a3aff3f93e7eea19c01cf30c337...8030e44215fe8f34edd57d711a35f2f0f97a0423,2,31,0,31,4,2010-03-28 16:43:20,2010-03-17 19:55:53
8030e44215fe8f34edd57d711a35f2f0f97a0423...e640551773c9730a47779dfc93155feb092c8e3c,2,10,6,16,3,2010-04-04 17:33:53,2010-04-04 17:33:53
e640551773c9730a47779dfc93155feb092c8e3c...cf87463e79a3018f666bfc9af113d3eea58a3d82,2,7,7,14,4,2010-04-04 22:55:29,2010-04-04 21:49:31
5e4f61474202122f376b16181b760f390623bf4e...419fe5bc861517c789c8f028519e085fd8d1992f,2,22,0,22,3,2010-03-25 02:39:40,2010-03-24 07:15:58
419fe5bc861517c789c8f028519e085fd8d1992f...6183a6adf140966d85521aa0360518743813ba37,1,29,35,64,23,2010-03-25 02:39:59,2010-03-24 07:15:59
6183a6adf140966d85521aa0360518743813ba37...6d6f6e68c3e2a18c3f02eba98e35ea13204ec68e,1,115,0,115,2,2010-03-25 02:40:27,2010-03-24 07:16:00
6d6f6e68c3e2a18c3f02eba98e35ea13204ec68e...15cb500786c3bc618dafa3c6bc9535236e7bfdcd,1,8,21,29,5,2010-03-25 02:40:43,2010-03-24 07:16:01
15cb500786c3bc618dafa3c6bc9535236e7bfdcd...e242148012196772e3fe2652d538fb923b91ca92,3,17,5,22,5,2010-03-25 02:41:19,2010-03-24 07:16:02
e242148012196772e3fe2652d538fb923b91ca92...fcb243f7dbfa30311c017346a7677c93ea5b1321,1,44,83,127,28,2010-03-25 02:42:10,2010-03-24 07:16:03
fcb243f7dbfa30311c017346a7677c93ea5b1321...63e671508782ca2dd386e5878d3682090fd64eda,1,3,1,4,1,2010-03-25 02:45:31,2010-03-24 07:16:04
3609ad8ec204f337f6fe12b3487b57e0d40c0d88...c9c8c56e072ae568b480eb1a808bd172bf373431,1,16,8,24,6,2010-03-07 04:00:02,2010-03-05 08:20:38
c9c8c56e072ae568b480eb1a808bd172bf373431...5d005922bc781c1f6ec9ae0af466f308a7576612,1,1,0,1,1,2010-03-07 04:00:42,2010-03-05 18:43:23
354d9f861b40e9c9bfeae7f939dc61e232aea415...d3f69766c431bab6321fed1ce64d914dc44ff87f,1,21,1,22,2,2010-02-17 06:25:03,2010-02-17 06:25:03
7e5eb8f1834722507e2d2171a253b78b1d924458...ae9c606ed228ea6a17ddde3a1e26451d02f51df7,2,135,15,150,9,2010-02-17 18:30:43,2010-02-16 06:34:07
7e74a73e6b57652c2710a9814a5449afeec5bd44...45a0ee116348d1b36756fe47d338713c06b918ad,2,47,1,48,2,2010-06-17 00:00:53,2010-06-16 23:56:53
50cff52f1a896118d5260c752900188e7d231cf6...68d4229847b0f94982b4f2f58ce5e9cbd0f6f8fc,1,13,1,14,5,2007-08-02 07:13:03,2007-08-02 07:13:03
68d4229847b0f94982b4f2f58ce5e9cbd0f6f8fc...a4eba020f96e1b85f856a992782b8bb2bab6a719,1,1,1,2,1,2007-08-02 07:40:25,2007-07-23 22:51:49
a4eba020f96e1b85f856a992782b8bb2bab6a719...7fcff9def564fae7de5d2a34a095229a999b80b0,1,3,3,6,3,2007-08-02 07:40:28,2007-07-23 22:56:37
7fcff9def564fae7de5d2a34a095229a999b80b0...c29ba0c3edc513259eee572f9c9257ec7cd94a56,1,4,0,4,1,2007-08-03 00:26:02,2007-08-02 08:56:42
c29ba0c3edc513259eee572f9c9257ec7cd94a56...d825a974950b397c6ffbf44b84a7158bfcaba819,1,0,1,1,1,2007-08-03 00:26:07,2007-08-02 21:36:37
d825a974950b397c6ffbf44b84a7158bfcaba819...29093c28a21d75500e9388ad103b9af9a0bab1ae,2,2,4,6,4,2007-08-03 00:26:07,2007-08-02 22:45:56
29093c28a21d75500e9388ad103b9af9a0bab1ae...6490a3383f1d0d96c122069e510ef1af1d019fbb,1,14,8,22,4,2007-08-03 00:26:26,2007-08-02 22:10:56
6490a3383f1d0d96c122069e510ef1af1d019fbb...d20602eec97caa8766820150eff2a07e205c44e1,1,1,0,1,1,2007-08-03 08:35:36,2007-07-27 08:23:03
d20602eec97caa8766820150eff2a07e205c44e1...a697ec69cbd3eb1a8fb70e4e0587e5049cd1ad83,1,2,2,4,1,2007-08-03 21:31:47,2007-08-03 21:31:47
a697ec69cbd3eb1a8fb70e4e0587e5049cd1ad83...4f8f03d6435e3e1c0d4f95d43022b81c95d6347f,1,3,3,6,2,2007-08-03 22:33:57,2007-08-03 22:33:57
50cff52f1a896118d5260c752900188e7d231cf6...72a4f4b657846af6c65360d92aa09d8b7f3dfbb0,1,7,5,12,3,2007-08-02 04:51:20,2007-08-01 17:03:37
72a4f4b657846af6c65360d92aa09d8b7f3dfbb0...3d5c418ff56645e13bdbd8c9f7d84fdaf7c8494b,6,79,40,119,15,2007-08-02 06:42:36,2007-08-02 06:42:36
4e837a98b65fbe0c83376cae5167605b771421d8...86bab9615c3516d4ac7756ae3c1285d331b78f04,1,21,7,28,5,2007-09-02 07:00:00,2007-09-02 07:00:00
88dce86f38bed84abadd73bbc40d9df92b7519db...56e29f597c8f85b0dfee9ba7408f8d09fd5adb5a,1,13,9,22,5,2007-07-10 01:12:35,2007-07-09 15:55:45
56e29f597c8f85b0dfee9ba7408f8d09fd5adb5a...e87fb0f1b4a4b458394a65d664145a9a8001e821,1,4,0,4,4,2007-07-10 01:13:26,2007-07-09 15:14:00
8d2244ba74f5207b9f7f9f1b4efbcccacbbb2c7b...e8964a5b91e13169ad73c7b1db2e904441ad93f5,1,1,1,2,1,2007-07-03 03:54:01,2007-07-02 16:48:34
4ca131250c9e56efec638831d6157aaf4f130be9...6233ab17297684c0049923cb8492393276672b01,1,26,12,38,11,2007-07-09 01:12:45,2007-06-30 08:34:59
6233ab17297684c0049923cb8492393276672b01...b1fa2bfff36933f94dada476ba5b3d3cb894b723,4,287,213,500,6,2007-07-09 01:12:46,2007-07-04 02:57:18
b1fa2bfff36933f94dada476ba5b3d3cb894b723...3206c63d0a365b11a430225a31f6a673f7645c25,4,185,165,350,6,2007-07-09 01:12:47,2007-07-04 03:33:59
3206c63d0a365b11a430225a31f6a673f7645c25...6f2a3fc812623bc82fb4997adb5a9a547b5dae1a,2,40,21,61,16,2007-07-09 01:12:48,2007-07-04 04:15:41
6f2a3fc812623bc82fb4997adb5a9a547b5dae1a...79a060e477a743ad49508aec9a491fe1aa7d7c3b,2,60,18,78,15,2007-07-09 01:12:49,2007-07-04 05:10:41
79a060e477a743ad49508aec9a491fe1aa7d7c3b...dd87efc8cc71ceb6aa9a27e900976c317c927846,2,49,4,53,6,2007-07-09 01:12:50,2007-07-04 06:19:53
dd87efc8cc71ceb6aa9a27e900976c317c927846...774173aa5f24023a82ce79f2a71fe3f664b747ad,1,198,22,220,16,2007-07-09 01:12:51,2007-07-04 08:21:57
774173aa5f24023a82ce79f2a71fe3f664b747ad...7618e6b1c1676dfdc2cc4c8af9e259c3e885825f,3,249,114,363,22,2007-07-09 01:12:52,2007-07-04 20:38:13
7618e6b1c1676dfdc2cc4c8af9e259c3e885825f...560eddc00c02e82077998200e8d8a45c31af924c,1,2,3,5,2,2007-07-09 01:12:53,2007-07-05 04:07:11
560eddc00c02e82077998200e8d8a45c31af924c...7cf044266779d69d3a16322b4d505bc87267a005,4,26,5,31,7,2007-07-09 01:12:54,2007-07-05 05:07:06
7cf044266779d69d3a16322b4d505bc87267a005...ba1964be26b8b9e3441591257a2c87f5811d6b50,2,88,14,102,13,2007-07-09 01:12:55,2007-07-05 06:23:53
ba1964be26b8b9e3441591257a2c87f5811d6b50...311e02a4a5c7b82c996214f06d58e2b51b3ecc22,1,14,4,18,3,2007-07-09 01:12:56,2007-07-05 23:19:37
311e02a4a5c7b82c996214f06d58e2b51b3ecc22...699d5601f59938d62ec2506f319c25a656a403da,5,67,64,131,59,2007-07-09 01:12:57,2007-07-06 03:16:13
699d5601f59938d62ec2506f319c25a656a403da...d41b43eb4c73044d0fff2057211fc78e4e7b2094,11,746,449,1195,49,2007-07-09 02:34:46,2007-07-08 22:40:56
d41b43eb4c73044d0fff2057211fc78e4e7b2094...02087abccea681bc0e1f6a9607e97df79ebbf2d9,1,20,1,21,2,2007-07-09 02:34:51,2007-07-09 01:19:59
02087abccea681bc0e1f6a9607e97df79ebbf2d9...84d3d7b84c600d90486205bf801580009dc523a8,1,5,0,5,2,2007-07-09 02:34:52,2007-07-09 01:29:54
84d3d7b84c600d90486205bf801580009dc523a8...827c71199da9b762e0758fe96302d0c8b7a04bb9,2,5,0,5,2,2007-07-09 02:34:53,2007-07-09 01:34:28
827c71199da9b762e0758fe96302d0c8b7a04bb9...b29bd5ca3b0060513b7b96380fc43f7ab4f12156,2,87,41,128,11,2007-07-09 02:34:53,2007-07-09 02:01:47
b29bd5ca3b0060513b7b96380fc43f7ab4f12156...51530d1722b0a4cccc630043fc4b46d075bf8558,2,8,12,20,6,2007-07-09 02:34:54,2007-07-09 02:06:33
51530d1722b0a4cccc630043fc4b46d075bf8558...b79223064e163aa0ce7f5b63d12158e87f8729e4,2,55,18,73,14,2007-07-09 02:48:19,2007-07-09 02:48:19
b79223064e163aa0ce7f5b63d12158e87f8729e4...0b81261622afad691501ee51d7811048cf4a5fce,13,258,84,342,41,2007-07-09 05:17:09,2007-07-09 05:17:09
0b81261622afad691501ee51d7811048cf4a5fce...02efd48f520d14012fc82c999172306a94862dee,1,4,12,16,3,2007-07-09 06:10:39,2007-07-09 06:10:39
02efd48f520d14012fc82c999172306a94862dee...c67298902ca36579b4cc43c1868cdb41279ef21b,1,4,1,5,1,2007-07-09 06:13:00,2007-07-09 06:13:00
c67298902ca36579b4cc43c1868cdb41279ef21b...70a7595cc07f38d4a83dff1d4697eb49c2e65b2c,1,1,0,1,1,2007-07-09 06:30:24,2007-07-09 06:30:24
70a7595cc07f38d4a83dff1d4697eb49c2e65b2c...c136f2b8b9eaac7a702799de25648b74ef12618a,1,24,13,37,3,2007-07-09 06:47:33,2007-07-09 06:47:33
c136f2b8b9eaac7a702799de25648b74ef12618a...74c4763c76a111809747652210962ad09896b74f,2,29,34,63,4,2007-07-09 07:07:05,2007-07-09 07:07:05
74c4763c76a111809747652210962ad09896b74f...7eafa2f1578e605e1e68d8ccba9d600cc6b89173,2,31,21,52,9,2007-07-09 07:38:10,2007-07-09 07:28:41
58f1d950e373afe35ed8661045914d23e973d067...8e36a6d5752ced382ecd46a5f2cd94276f79451c,4,38,3,41,5,2014-12-17 19:44:59,2014-12-17 19:44:59
a305b15f82984bd000351e5ab4720a4a170e42b0...2c380e7a8da9bd9a4e40221e36cb68f756d49829,1,93,2,95,4,2014-12-22 20:43:16,2014-12-22 20:43:16
3a0a3a8972369060a1eff8353b64bf7377714b22...33baa6983de95da801ba710560740e263f8fc150,1,0,6,6,2,2015-02-23 02:56:23,2015-02-23 00:07:14
9c70e2c105f9c4b4708af6ae25d2678929b3d61d...f5709437d963e585df0691989d3ccfee1de1572b,1,14,0,14,1,2014-11-12 20:13:39,2014-11-12 20:12:50
f5709437d963e585df0691989d3ccfee1de1572b...49e0c5ad0ab95e450138105ff27688861a4a1557,1,1,1,2,1,2014-11-14 21:31:15,2014-11-14 21:31:15
0b1f113075aafb0c91a406d984d0152e55c981da...a58f3c01f7e6aecb486aadece040a6293eb43059,1,29,29,58,22,2007-05-26 03:54:16,2007-05-25 22:37:38
a58f3c01f7e6aecb486aadece040a6293eb43059...5adf317b31729707fad4967c1aef6cdba43d0dd3,2,2,2,4,2,2007-05-26 03:54:23,2007-05-25 22:37:40
5adf317b31729707fad4967c1aef6cdba43d0dd3...c1bab2889eb71bf537497fc77a2fdb6a74bc92e6,1,4,0,4,1,2007-05-26 03:54:38,2007-05-25 22:37:39
c1bab2889eb71bf537497fc77a2fdb6a74bc92e6...4b7cc26a74b01ceab14a32ef66704557b26d5622,1,2,2,4,2,2007-05-26 04:43:33,2007-05-26 03:42:36
4b7cc26a74b01ceab14a32ef66704557b26d5622...293623edbc9488adbc71c2e0de1100b52cb193ac,1,4,4,8,4,2007-05-26 07:23:23,2007-05-26 05:00:54
293623edbc9488adbc71c2e0de1100b52cb193ac...816366e23dfe366b938b427eac8ea1c8345ea339,1,22,3,25,4,2007-05-26 07:26:20,2007-05-26 07:26:20
816366e23dfe366b938b427eac8ea1c8345ea339...a23bfaed7da90ccdc75cbfd0099741080381f60a,3,6,6,12,6,2007-05-26 07:33:03,2007-05-26 07:33:03
a23bfaed7da90ccdc75cbfd0099741080381f60a...20b3d206acbbb042c7ad5f42d36ff8d036a538c5,2,46,1,47,2,2007-05-26 08:17:58,2007-05-24 04:37:06
515cc0101943b766fde7aa894827119e332ec033...7dce19d374a37932e9d4c3a6202af407cf5114eb,6,231,17,248,25,2010-11-12 23:06:03,2010-11-12 12:54:52
7dce19d374a37932e9d4c3a6202af407cf5114eb...be254a0ea99b441a6c514cb8b25cd72357383700,7,83,9,92,18,2010-11-12 23:06:03,2010-11-10 23:55:02
be254a0ea99b441a6c514cb8b25cd72357383700...c1a3c3640deb8bd6929026a55b18feb1dda74e77,5,84,3,87,7,2010-11-12 23:06:03,2010-11-10 23:55:41
c1a3c3640deb8bd6929026a55b18feb1dda74e77...1c1f3537c0283c92abbca9155813ed62b05cb481,1,2,1,3,1,2010-12-10 07:42:05,2010-12-10 07:42:05
515cc0101943b766fde7aa894827119e332ec033...2caa321503cbb6dfd3867d5befe615ae541a77b3,1,33,20,53,16,2010-09-28 18:04:02,2010-08-30 11:30:50
2caa321503cbb6dfd3867d5befe615ae541a77b3...3a3a29c1da97b36dda2761c2e6b61c1a82e20a54,2,23,9,32,10,2010-09-28 18:05:35,2010-08-30 11:30:51
515cc0101943b766fde7aa894827119e332ec033...3cd474599f1ede41863c523ddf76c94941b08164,7,8,6,14,7,2010-08-30 05:42:49,2010-08-29 02:04:17
515cc0101943b766fde7aa894827119e332ec033...7ec344d802970782036146e29ba2213e86d49fe1,3,40,14,54,5,2010-08-27 23:47:01,2010-08-27 20:44:56
af6c6e0b19dc396849e7e09727044ba1a725e811...22da742982eeeb95b6fb4cd757509a8c4c2202d8,2,47,1,48,2,2010-09-01 22:10:03,2010-09-01 21:15:35
bff42061214e17f342efc909c73f29bf66df51e9...909a5494f869371565ed9326e984adeabf42611d,3,20,1,21,5,2010-09-10 16:38:29,2010-09-10 16:18:14
a1155adc2dde23fd664ad47399379cd0561762af...8a1c0d322e9b6963f3be6949475983d517d79796,1,36,1,37,3,2010-09-30 00:32:35,2010-09-20 08:28:34
8a1c0d322e9b6963f3be6949475983d517d79796...7edba4c45c33ba1e17d88907c1601dc660a44522,1,8,3,11,2,2010-09-30 00:32:36,2010-09-20 08:28:35
7edba4c45c33ba1e17d88907c1601dc660a44522...df0b99f00458dd0d442b17d78dd4c171a89f7bb2,1,30,0,30,1,2010-09-30 00:32:36,2010-09-20 08:28:36
df0b99f00458dd0d442b17d78dd4c171a89f7bb2...af6e17519978eed17c406206e1afc9f0501abf77,1,128,0,128,2,2010-09-30 00:32:36,2010-09-20 08:28:37
af6e17519978eed17c406206e1afc9f0501abf77...3398f2f58317e1a22093a0149a5eae1fe208b024,1,58,0,58,2,2010-09-30 00:32:36,2010-09-20 08:28:38
3398f2f58317e1a22093a0149a5eae1fe208b024...588504b694133cba85982fbace532d2156f859eb,1,38,0,38,1,2010-09-30 00:32:36,2010-09-20 08:28:39
588504b694133cba85982fbace532d2156f859eb...52304ecddf9458dcf4321c89c96a5e1bc025676d,1,63,0,63,1,2010-09-30 00:32:36,2010-09-20 08:28:40
52304ecddf9458dcf4321c89c96a5e1bc025676d...707983484b7dcdd5fe3e09b30d0fdf6dac89c940,1,79,0,79,1,2010-09-30 00:32:36,2010-09-20 08:28:41
707983484b7dcdd5fe3e09b30d0fdf6dac89c940...d09c0a3935c6f28b1e7710f3f08a6ff5dec50f73,1,20,15,35,1,2010-09-30 00:32:37,2010-09-20 08:28:42
d09c0a3935c6f28b1e7710f3f08a6ff5dec50f73...fa0ae3b1ddeeb8c872f3804950fa95b5fc8b4138,1,47,0,47,1,2010-09-30 00:32:37,2010-09-20 08:28:43
fa0ae3b1ddeeb8c872f3804950fa95b5fc8b4138...c976260d0f3d3f99dc3594e3f98436bfd920dc97,1,21,3,24,3,2010-09-30 00:32:37,2010-09-20 08:28:44
c976260d0f3d3f99dc3594e3f98436bfd920dc97...583942df098b04f545fb6bbe7b0d1590cc7b7b1d,1,76,0,76,1,2010-09-30 00:32:37,2010-09-20 08:28:45
583942df098b04f545fb6bbe7b0d1590cc7b7b1d...f63622c0a9665913f7ebade27910d8094ab4f9c4,1,85,0,85,1,2010-09-30 00:32:37,2010-09-20 08:28:46
f63622c0a9665913f7ebade27910d8094ab4f9c4...41d70bd6a94d1bd1ec09d2a3d6ebd419abb25bca,1,14,6,20,4,2010-09-30 00:32:37,2010-09-20 08:28:47
41d70bd6a94d1bd1ec09d2a3d6ebd419abb25bca...09c01f856f65ffdde9a61708a5d74a372d68807a,1,14,12,26,6,2010-09-30 00:32:37,2010-09-20 08:28:48
09c01f856f65ffdde9a61708a5d74a372d68807a...605c1bcfc46b60f76dfb4f89f76029b7bb13d232,1,0,18,18,2,2010-09-30 00:32:38,2010-09-20 08:28:49
605c1bcfc46b60f76dfb4f89f76029b7bb13d232...6ef2cb008f132e4649ef925a8e1950d3138054d5,1,20,11,31,2,2010-09-30 00:32:38,2010-09-20 08:28:50
6ef2cb008f132e4649ef925a8e1950d3138054d5...5e3ce663b03bf14443ef8b4c60b407664f97040b,1,22,13,35,2,2010-09-30 00:32:38,2010-09-20 08:28:51
5e3ce663b03bf14443ef8b4c60b407664f97040b...0c4918d1c1722c1faaa909f3f8486d5a0d816538,1,43,28,71,2,2010-09-30 00:32:38,2010-09-20 08:28:52
0c4918d1c1722c1faaa909f3f8486d5a0d816538...25c3936349ba052f0c7e9ba3ce138b89abcae6ee,1,44,0,44,3,2010-09-30 00:32:38,2010-09-20 08:28:53
25c3936349ba052f0c7e9ba3ce138b89abcae6ee...2ff739f9d2fd2f34e7a7bfb9b5f2d1d2b2ec5326,1,30,3,33,4,2010-09-30 00:37:03,2010-09-20 08:28:54
2ff739f9d2fd2f34e7a7bfb9b5f2d1d2b2ec5326...384c166807e6eefbefa3e9f253216b2aee6d912a,1,3,0,3,1,2010-09-30 00:37:03,2010-09-20 08:28:55
384c166807e6eefbefa3e9f253216b2aee6d912a...9c0bbb50f0dd916fe1684991d10d93f3c67311ba,1,47,36,83,7,2010-09-30 00:37:03,2010-09-20 08:28:56
9c0bbb50f0dd916fe1684991d10d93f3c67311ba...36de17048aaa3c3011c8b4ee1f89ee65b7ad2f99,1,9,9,18,6,2010-09-30 00:37:03,2010-09-20 08:28:57
36de17048aaa3c3011c8b4ee1f89ee65b7ad2f99...61b8bcae2d8f71c566150b0a12e35a9fdc76b82b,1,4,2,6,2,2010-09-30 00:37:03,2010-09-20 08:28:58
61b8bcae2d8f71c566150b0a12e35a9fdc76b82b...2a669c341a857f53d946dec762e6f22a54b12dd2,2,3,2,5,3,2010-09-30 00:37:04,2010-09-20 08:28:59
2a669c341a857f53d946dec762e6f22a54b12dd2...07413c5a3115df424bee1ebe627676df0734f787,2,42,17,59,4,2010-09-30 00:37:04,2010-09-20 08:29:00
07413c5a3115df424bee1ebe627676df0734f787...161cf7f9490285700432f23a953f8e238f3469f5,1,6,26,32,2,2010-09-30 00:37:04,2010-09-20 08:29:01
161cf7f9490285700432f23a953f8e238f3469f5...3b130adf9c8b0b37acb0959b84a3222bc22ebcff,1,20,2,22,2,2010-09-30 00:37:04,2010-09-20 08:29:02
3b130adf9c8b0b37acb0959b84a3222bc22ebcff...882fd11aff6f0e8add77e75924678cce875a0eaf,2,16,37,53,4,2010-09-30 00:37:04,2010-09-20 08:29:03
882fd11aff6f0e8add77e75924678cce875a0eaf...71f7ffcc02a2f38436c59146b86897389130a538,1,9,0,9,2,2010-09-30 00:37:04,2010-09-20 08:29:04
71f7ffcc02a2f38436c59146b86897389130a538...a0de2f6bd3b79f7ab61ea90f795b964a7f7f3d6d,2,10,2,12,5,2010-09-30 00:37:04,2010-09-20 08:29:05
a0de2f6bd3b79f7ab61ea90f795b964a7f7f3d6d...2adc7dcc111636ed16601dc7516ced1c5cfda088,2,4,5,9,5,2010-09-30 00:37:05,2010-09-20 08:29:06
2adc7dcc111636ed16601dc7516ced1c5cfda088...4ab9a157d06956ce5a1060a28404cbade3039fa2,2,24,6,30,7,2010-09-30 00:37:05,2010-09-20 08:29:07
4ab9a157d06956ce5a1060a28404cbade3039fa2...84a08a47b9559e76df96645c536845f31ba4dc7b,2,17,10,27,10,2010-09-30 00:37:05,2010-09-20 08:29:08
84a08a47b9559e76df96645c536845f31ba4dc7b...ef02b317212443036be6007bba3a1a5946460dc9,2,59,1,60,3,2010-09-30 00:37:05,2010-09-20 08:29:09
ef02b317212443036be6007bba3a1a5946460dc9...4c0c1810c98e20ce05b2f026d6f9d62cfef7aefc,1,2,15,17,6,2010-09-30 00:37:05,2010-09-20 08:29:10
4c0c1810c98e20ce05b2f026d6f9d62cfef7aefc...c8516500b1ee6025466a207cd86dc30421c3b6e6,1,1,1,2,1,2010-10-21 14:34:33,2010-10-21 14:34:33
c8516500b1ee6025466a207cd86dc30421c3b6e6...9f6cea97c97ee505bd6771db7df69f04df9b4fc4,1,32,32,64,12,2010-11-17 21:50:20,2010-11-08 21:29:26
5cba1229d8246da2a6d1d956eeed8227f69e185b...3776ea9d7006f48c380e80ccc57db681f4e9adfb,2,2,2,4,2,2010-08-22 20:26:13,2010-08-22 11:12:12
a121d53fa6ce711e695d65ecff300127ff8e1047...17367939ebd64f5e6eb4fa5a32ece513f497e6e6,2,33,1,34,2,2010-12-28 21:48:54,2010-12-28 21:48:54
97c793404910fbe8b51ec29661619ad0196ac1ae...e39beac6731575bfff53bf1ef1256c89a6b94050,1,1,1,2,1,2012-08-01 20:58:47,2012-08-01 17:09:09
4a5b32403159f8f847ad9dffe36fa31d32a773d5...e7719469154fc9bbf910df89b80a5145c7d93959,1,24,56,80,3,2012-07-22 20:20:24,2012-07-22 20:20:24
5ce3258122939f93a927c75d308c1c34038f0386...a1231de0020b60076f946012b8230db9b1c00cfd,1,3,0,3,1,2011-01-27 18:24:05,2011-01-26 20:33:32
a1231de0020b60076f946012b8230db9b1c00cfd...960ac5ff99304404d287b8174d7c8a7743c6d97a,1,1,1,2,1,2011-01-27 18:24:09,2011-01-21 00:36:24
b20e9b0b521a416b00a81d6c4788dfd2df25efc0...25f3af3f9d351a3d50cb9fc2bf7bddf941e4bc58,1,1,1,2,1,2011-01-20 21:18:51,2011-01-20 20:12:20
25f3af3f9d351a3d50cb9fc2bf7bddf941e4bc58...8c0db6fd51cec5fd82cf4054818c0a1ca4a58f37,1,2,7,9,2,2011-01-21 20:41:14,2011-01-21 18:37:34
2f0b5fa4591faa293f06f5a1e58e22f713973861...11bc3e92bf036480ab31657825903b9b63ad9c49,1,22,1,23,6,2011-05-20 04:02:20,2011-05-20 03:50:07
7eacc2bc29cc810fd5722096aa3c2c9dc8db34ab...665b051b904fc451088d74dd37dc314f7099faba,1,15,35,50,8,2011-05-26 17:41:33,2011-05-26 17:41:33
665b051b904fc451088d74dd37dc314f7099faba...a9930e359c45302f92639e8cd0a61c9c912e0b22,1,1,0,1,1,2011-05-26 18:20:48,2011-05-26 13:55:50
c9321a0e20f3461cf4ae07a8320aa80480107f24...b0b35a6ac38a4e2532e9aa60273680a6d404c7a1,1,11,0,11,4,2011-08-23 22:28:18,2011-08-23 22:28:18
da656f17d37fe96454645c08f21a24134f5aa900...c4c42f2cbd2eb14871881cc0d27412b477f699a7,1,1,1,2,1,2011-10-24 06:54:58,2011-10-24 04:24:51
da656f17d37fe96454645c08f21a24134f5aa900...6280dfdc3b22aa821521182781e5a247b19fb515,2,51,8,59,9,2011-08-05 22:56:54,2011-08-05 22:36:22
da656f17d37fe96454645c08f21a24134f5aa900...d7c9bf22351e39756f93f09b4251a6b5861d9cc0,2,67,2,69,3,2011-03-24 05:44:22,2011-03-24 02:41:01
da656f17d37fe96454645c08f21a24134f5aa900...2140b14064ffe6b12ba6818b2894d1461a943fb9,2,12,4,16,3,2011-02-25 20:13:55,2011-02-25 09:07:57
1d5742cbf746f9556e6aefdfbed54c452c235d51...0986de94f942d889622e6cfe55b565ea9519826b,1,4,0,4,1,2011-03-15 21:18:34,2011-03-15 19:58:14
b76bf72428e2efd978fee421606662e78ba0b2cf...9971d6d52c5afeb8ba60ae6ddcffb34af23eeadd,4,31,3,34,5,2011-02-11 22:39:55,2011-02-11 22:39:55
3f142468997f9d14d8051a96b2e9db265d41ac0d...92fda79ed048d2d37e760e7a1b6055b2fc801ee3,1,9,5,14,2,2011-01-13 19:25:32,2011-01-13 02:26:36
92fda79ed048d2d37e760e7a1b6055b2fc801ee3...a93e530184b3f7ae9d9bfb0e569734687f8d1c0b,1,3,1,4,1,2011-01-13 19:26:09,2011-01-13 02:28:09
a6fd3d4925ca3629e7edc73a60f5e1c50c1d5390...7fad99e14af6da89efe0d078e19ac8b7c02a3b5d,1,1,1,2,1,2011-01-11 21:01:43,2011-01-10 23:21:26
05bb5a2584ca0e1c87a2135a83c5573b9337d06f...00f66f0e4913110e19972a71a150a7b9d1bfd02f,1,2,2,4,2,2010-12-21 20:26:21,2010-12-21 18:50:47
00f66f0e4913110e19972a71a150a7b9d1bfd02f...77e572653b5089c9e3639fe4088f59e4cfef4eea,1,2,2,4,1,2010-12-21 21:26:32,2010-12-21 20:27:55
05bb5a2584ca0e1c87a2135a83c5573b9337d06f...7b3b7e37581fb5266a260687c21af1571b4ade81,2,34,2,36,5,2010-12-21 19:16:28,2010-12-21 18:35:53
05bb5a2584ca0e1c87a2135a83c5573b9337d06f...4579bb418c2995a8459de7dba42b63a26006f9a6,2,8,2,10,2,2010-12-20 18:28:19,2010-12-13 17:02:25
4579bb418c2995a8459de7dba42b63a26006f9a6...4c28e4ada03f5440251545cf91e0d81bce9b010d,1,32,22,54,18,2010-12-21 01:45:51,2010-12-21 01:00:36
05bb5a2584ca0e1c87a2135a83c5573b9337d06f...b1b14ec3f14edfc5f76643aaaac6548fc94fb47e,1,22,0,22,1,2010-12-20 02:17:00,2010-12-18 14:54:11
b1b14ec3f14edfc5f76643aaaac6548fc94fb47e...9ec09b0495f5e672223025f5e681371034da2538,2,3,4,7,3,2010-12-20 02:41:32,2010-12-18 14:54:12
38a5932be8a8f0b0bd3bb949bdc5258d9c753f15...1b9743462d9ef3c0e73a3c439de45c0c16b6c938,2,43,7,50,19,2010-12-17 05:43:08,2010-12-17 05:43:08
6a2e93f1074d5a8b25c2020805e6b8d795d13e4d...13a4899886958c211b96bced228fdaaa42674491,1,82,86,168,8,2012-03-01 19:59:51,2012-03-01 02:14:14
13a4899886958c211b96bced228fdaaa42674491...5597e84b514454f18bba7b13eee2feea04f0165b,1,39,7,46,16,2012-03-01 20:00:01,2012-03-01 02:14:15
5597e84b514454f18bba7b13eee2feea04f0165b...b3f01ff29f7131e959bcfdfd004744d74d5fa319,2,2,5,7,2,2012-03-01 20:00:01,2012-03-01 02:14:16
900647104e02e545064789f3c6b90a5807fba07b...2564aa48ce007ad265c0d31a7cb7513239447d2b,1,3,1,4,2,2011-10-28 15:41:56,2011-10-28 15:28:28
2564aa48ce007ad265c0d31a7cb7513239447d2b...55e7c0aaa1b2c00d147b1b4b1aa88a71d90dacf4,1,11,0,11,3,2011-10-28 16:36:55,2011-10-28 16:36:55
87b50542a08ac6caa083ddc376e674424e37940a...8f6811efed5451c72aac53f8ee12b1edcd426a73,1,1,0,1,1,2012-09-24 16:28:36,2012-09-23 07:37:47
87b50542a08ac6caa083ddc376e674424e37940a...9ef5b2bd166aa390778d7dcda58714ee222d7377,1,1,0,1,1,2012-05-18 19:26:49,2012-05-18 13:48:53
87b50542a08ac6caa083ddc376e674424e37940a...37e7793d473019eac69c347f1a79e3273567b9bf,1,1,1,2,1,2011-12-06 21:16:37,2011-12-06 16:35:08
87b50542a08ac6caa083ddc376e674424e37940a...fc001b526c42e5fb776340136a2fb247e391a61b,2,2,2,4,2,2011-11-28 18:37:50,2011-11-27 10:15:32
87b50542a08ac6caa083ddc376e674424e37940a...f737632938868adaa0e8f777235e8e15d40ab14c,1,4,3,7,1,2011-10-16 07:22:31,2011-10-12 15:52:06
87b50542a08ac6caa083ddc376e674424e37940a...f01cae918feb564da8c7a286b32c7c917599acdd,1,2,0,2,1,2011-09-22 17:54:47,2011-09-22 17:54:47
87b50542a08ac6caa083ddc376e674424e37940a...91a640ffb6d9dd10c293a575a692d9771b6e13c7,1,3,0,3,1,2011-09-16 18:19:43,2011-09-16 18:14:27
87b50542a08ac6caa083ddc376e674424e37940a...3749fde561ad495dea74b0d3a13bba571068396d,12,15,22,37,19,2011-04-24 05:34:43,2011-04-24 05:34:13
3749fde561ad495dea74b0d3a13bba571068396d...76399c0195278ed2b52716b821cf064f77131736,2,9,6,15,5,2011-04-24 05:34:43,2011-04-22 22:55:55
76399c0195278ed2b52716b821cf064f77131736...fa7b290895ba2c4407ae818911ba620eaca53bbd,3,6,11,17,5,2011-04-24 05:34:43,2011-04-22 23:05:58
fa7b290895ba2c4407ae818911ba620eaca53bbd...095ce9538b738db28d5e9a6e05d94c7e3f55f39d,2,95,2,97,6,2011-04-24 05:35:13,2011-04-22 23:19:27
87b50542a08ac6caa083ddc376e674424e37940a...f1e9c548ce45005521892af0299696204ece286b,2,4,2,6,2,2011-04-21 02:23:16,2011-04-20 09:12:11
87b50542a08ac6caa083ddc376e674424e37940a...ccdc4ec3044bd108ae1e20d772f078c10df114b3,4,16,13,29,4,2011-03-21 19:43:10,2011-03-21 17:16:10
ccdc4ec3044bd108ae1e20d772f078c10df114b3...483fbe2b7cb89ddcf700a677735d21aa176bc5a6,1,14,1,15,2,2011-03-21 21:49:46,2011-03-21 17:18:19
87b50542a08ac6caa083ddc376e674424e37940a...9d79b7e95d9acf07ff1479f41faa860503ce280e,1,8,26,34,6,2011-03-15 23:06:05,2011-03-15 21:24:55
9d79b7e95d9acf07ff1479f41faa860503ce280e...e235b9168d8df2bc00ca2c77703ce1a98935c906,1,33,0,33,1,2011-03-15 23:06:08,2011-03-15 21:24:56
87b50542a08ac6caa083ddc376e674424e37940a...502dc5b663fe3fe241accca5eda28a94d674fbb6,1,1,1,2,1,2010-12-07 00:41:44,2010-12-01 18:50:46
502dc5b663fe3fe241accca5eda28a94d674fbb6...69e7236c6df44bfcde8913972b75a6ccb360d58f,2,23,19,42,2,2010-12-07 00:42:07,2010-12-04 23:27:35
87b50542a08ac6caa083ddc376e674424e37940a...ed7158b42475e3b13ac90c52d9ce0bbc855e18c2,1,34,72,106,22,2010-12-07 00:30:42,2010-12-07 00:00:02
87b50542a08ac6caa083ddc376e674424e37940a...b6c4ceccb3d6026c612fa55865c51374b26eb176,1,24,17,41,8,2010-11-03 16:24:47,2010-10-28 18:13:06
b6c4ceccb3d6026c612fa55865c51374b26eb176...3ba7a065527a27f45659398e882feaa1165cbb4c,1,6,1,7,3,2010-11-03 16:24:57,2010-10-28 18:13:06
87b50542a08ac6caa083ddc376e674424e37940a...24305cd7009d682ba4115103c95844446a2bb305,2,32,1,33,3,2010-10-29 21:13:33,2010-10-18 18:39:17
87b50542a08ac6caa083ddc376e674424e37940a...e32dfec79f99738df3c2ffca8a9b2257c9b681fb,1,3,2,5,3,2010-10-19 16:23:24,2010-10-19 09:50:43
87b50542a08ac6caa083ddc376e674424e37940a...a1980c4efcfea516e2ba442bf7e56a39d9a7933f,2,9,4,13,4,2010-10-13 23:39:45,2010-09-29 20:49:49
a1980c4efcfea516e2ba442bf7e56a39d9a7933f...2d502e1f378a39ef375d6d5c1b3312d286ed2524,4,48,2,50,6,2010-11-10 16:42:40,2010-09-29 21:41:08
87b50542a08ac6caa083ddc376e674424e37940a...419f37db4d1e2fe3c394c869c5375e545b3e364d,3,317,0,317,4,2010-10-13 23:08:58,2010-10-12 16:39:41
419f37db4d1e2fe3c394c869c5375e545b3e364d...3a9ed4bdee5032ecb9328aea51a752d69a2d966e,6,142,0,142,6,2010-10-13 23:09:26,2010-10-12 16:39:42
3a9ed4bdee5032ecb9328aea51a752d69a2d966e...7f3ecebfcda9b32252a4791dc716c1e3d88c9f70,6,377,0,377,6,2010-10-13 23:09:28,2010-10-12 16:39:43
7f3ecebfcda9b32252a4791dc716c1e3d88c9f70...7851b1e60fabe350216d48e6de03a3ed21a49953,5,21,18,39,12,2010-11-19 19:04:20,2010-11-17 17:15:34
87b50542a08ac6caa083ddc376e674424e37940a...3fcb88785da831ad7d53cf18b4398099179c9c87,1,58,4,62,4,2010-09-27 04:25:40,2010-09-24 20:40:38
3fcb88785da831ad7d53cf18b4398099179c9c87...9027fa9eb7df606b6658dd48a40bb993ce222ddd,2,15,8,23,7,2010-09-27 04:27:37,2010-09-24 22:15:34
87b50542a08ac6caa083ddc376e674424e37940a...c9be27f39488b20946e3a7ba57d776e03708a1fa,1,14,3,17,3,2010-09-24 08:21:54,2010-08-21 18:52:14
c9be27f39488b20946e3a7ba57d776e03708a1fa...a3c75056dc73661a6cdab180659f52cdb03b357c,2,53,1,54,4,2010-09-24 08:23:53,2010-09-02 22:32:06
a3c75056dc73661a6cdab180659f52cdb03b357c...8565a568cdd8604d4b5a00e52c64064a8aebf690,1,2,1,3,1,2010-09-24 16:24:20,2010-09-23 22:05:03
80d868b068b9e68a4aac91be578a8f097f45d8da...d0740ce0ba9417c34e00b5a61161d84f85ba7fbc,1,2,1,3,1,2012-05-18 19:23:01,2012-05-18 09:23:24
80d868b068b9e68a4aac91be578a8f097f45d8da...dbdf5854b21852676de6a8baf052147217ce809b,2,15,5,20,6,2010-12-22 22:34:24,2010-11-26 15:32:33
ca209065f3cc3462eb0ae6090f6b13f38aa2114c...ccdd3da6527ca7d8d731e691b9ff0f9b8657298e,2,5,1,6,3,2010-11-05 17:28:01,2010-11-04 20:27:12
ca209065f3cc3462eb0ae6090f6b13f38aa2114c...c455bd8950e0e5593949b746ad96d1449bbbf9d5,1,52,0,52,1,2010-11-05 17:03:17,2010-11-04 17:12:48
c455bd8950e0e5593949b746ad96d1449bbbf9d5...9edb8a0f7b3e2ca06b360abce2e2aaa2b5760a68,3,3,3,6,3,2010-11-05 17:05:31,2010-11-04 17:18:17
9edb8a0f7b3e2ca06b360abce2e2aaa2b5760a68...49bd56a5f7b09f89b59a6a77d331e8f85f6d7fde,2,10,4,14,3,2010-11-05 17:05:46,2010-11-04 21:17:29
ca209065f3cc3462eb0ae6090f6b13f38aa2114c...772991af40e139814368762d4075be324bfdab77,2,59,1,60,5,2010-11-04 23:53:49,2010-11-04 01:35:09
772991af40e139814368762d4075be324bfdab77...088d880247dc7bb1a27f07e320bab7f9b63e06bc,5,96,4,100,7,2010-11-04 23:53:49,2010-11-04 01:35:10
088d880247dc7bb1a27f07e320bab7f9b63e06bc...da523cc597b1be7fe61ee870cf93b142e70fab7f,4,18,6,24,7,2010-11-04 23:53:49,2010-11-04 01:35:11
da523cc597b1be7fe61ee870cf93b142e70fab7f...bb34c5aabe9f8d86a40d5ab8518fc78602264179,1,3,13,16,3,2010-11-04 23:53:50,2010-11-04 01:35:12
ca209065f3cc3462eb0ae6090f6b13f38aa2114c...06ac01a46af471207b93266e55eb9880e87e0114,1,1,1,2,1,2010-10-29 21:09:48,2010-09-20 09:31:22
06ac01a46af471207b93266e55eb9880e87e0114...e806c43537e2e9b5ab96d03b777a5759ef57b13d,1,1,1,2,1,2010-10-29 21:12:31,2010-10-18 09:09:54
ca209065f3cc3462eb0ae6090f6b13f38aa2114c...92c62a3f4f93432c0c82e3031a9e64e03ba290f7,4,34,28,62,7,2010-10-28 20:28:44,2010-10-19 14:39:28
7e4eb210bdf2a612d8bf4cc106d99ba190f73e3e...3bae8d4da1ee7fce0cf1ef9fcf49656ca1e48769,1,2,2,4,1,2010-12-03 23:22:52,2010-12-03 20:04:17
3bae8d4da1ee7fce0cf1ef9fcf49656ca1e48769...f36a4fa8ef611c37c890ed21a388a5ece801a3de,1,4,0,4,1,2010-12-03 23:22:59,2010-12-03 16:47:35
f36a4fa8ef611c37c890ed21a388a5ece801a3de...6079ec6680da5e40d15d981c24051e9bf5c226fc,2,11,3,14,3,2010-12-03 23:23:01,2010-12-03 23:18:06
7e4eb210bdf2a612d8bf4cc106d99ba190f73e3e...a180055a47c6793eaaba6289f623cff32644215b,1,83,83,166,30,2010-12-03 21:44:07,2010-12-03 16:47:36
a180055a47c6793eaaba6289f623cff32644215b...b968708b3ed486a25c65a8481af927ab3884bfba,1,2,1,3,1,2010-12-03 21:46:24,2010-12-03 16:47:37
b968708b3ed486a25c65a8481af927ab3884bfba...81f42f11496b9117273939c98d270af273c8a463,2,13,7,20,9,2010-12-03 21:49:14,2010-12-03 16:47:38
81f42f11496b9117273939c98d270af273c8a463...14ea67c0071804b7eb73cca35c87860f8fc6db95,2,13,7,20,5,2010-12-03 22:05:32,2010-12-03 16:47:39
7e4eb210bdf2a612d8bf4cc106d99ba190f73e3e...c4f4157ee84ff27dd7a398f80002be59eb2f69e7,1,3,2,5,1,2010-12-03 19:16:45,2010-12-03 08:20:54
eec0daf6fd5a31cda601caeaa3a0bfebf2d17fe8...d8a94803842989582989fd5f5c3062c49134ad5b,1,3,3,6,2,2010-08-31 16:52:48,2010-08-27 17:38:16
9d52f15af7de943779cf6302cef4f1a88ce447be...84974217151a66b65ae5b173045483ce5eeb5142,2,15,0,15,4,2010-08-02 20:16:16,2010-07-30 22:35:59
84974217151a66b65ae5b173045483ce5eeb5142...0b45010e76ef2114a530d81da626871de23f467f,1,1,1,2,1,2010-08-02 22:01:14,2010-08-02 20:21:47
0b45010e76ef2114a530d81da626871de23f467f...b73f294150c0c134a954ab6772688a9a39b54896,1,3,0,3,3,2010-08-02 22:18:18,2010-08-02 18:20:38
b73f294150c0c134a954ab6772688a9a39b54896...9f9aa761305e909aca9a46ccb33a5872b36bcb8e,2,11,1,12,2,2010-08-02 22:31:59,2010-07-31 20:11:46
181264ad590ffef9d956fdd023369869c2d0a55f...46cb16fb599451f417e7cd668e77866f5aa03fc0,1,2,0,2,2,2010-08-05 06:33:23,2010-08-03 23:21:25
1a9fe453263137be7d42e6fbfc041b5b2d9521d7...69a636ad1ac73a596d8c99a4206a6475b15e8d8d,1,71,70,141,40,2011-02-10 22:08:07,2011-02-06 18:43:30
69a636ad1ac73a596d8c99a4206a6475b15e8d8d...02ac45fa628ef7c529e63bb99fe198704606e7f8,1,23,30,53,14,2011-02-10 22:08:07,2011-02-06 18:43:31
02ac45fa628ef7c529e63bb99fe198704606e7f8...10ffca7db2946b4392a38a8f114a0cb3fd6e069c,1,2,2,4,3,2011-02-10 22:08:07,2011-02-06 18:43:32
10ffca7db2946b4392a38a8f114a0cb3fd6e069c...dc4a4b7387f2d7ac5ecce2f5feb2dfa85f378beb,1,0,8,8,4,2011-02-10 22:08:08,2011-02-06 18:43:33
dc4a4b7387f2d7ac5ecce2f5feb2dfa85f378beb...99de0640f2837d31f84d2889a770d936ae4394be,1,41,39,80,11,2011-02-10 22:08:08,2011-02-06 18:43:34
99de0640f2837d31f84d2889a770d936ae4394be...342623224823cbadf61370a43df6941fba477b59,2,217,209,426,20,2011-02-10 22:08:08,2011-02-06 18:43:35
342623224823cbadf61370a43df6941fba477b59...95135b06fe5f44f1efaeac729021a350b52652e5,4,22,2,24,6,2011-02-10 22:08:08,2011-02-06 18:43:36
95135b06fe5f44f1efaeac729021a350b52652e5...6bb4e485cff86d87b5265f26d6138357444e5eb9,2,256,256,512,161,2011-02-10 22:08:08,2011-02-06 18:43:37
6bb4e485cff86d87b5265f26d6138357444e5eb9...9765b6abeb00145df18cde6b76a9b1fa97eeef53,2,14,6,20,9,2011-02-10 22:08:08,2011-02-06 18:43:38
9765b6abeb00145df18cde6b76a9b1fa97eeef53...cf432ca0512d68afa603941ecddbb45bb7ded01d,2,100,182,282,20,2011-02-10 22:08:08,2011-02-06 18:43:39
cf432ca0512d68afa603941ecddbb45bb7ded01d...f3889b84010f16558421fd45cb3d0062f9d6e024,1,0,6,6,4,2011-02-10 22:08:08,2011-02-06 18:43:40
f3889b84010f16558421fd45cb3d0062f9d6e024...8f9bfb64c5d5179cc7439715379077875248c4ab,2,7,7,14,6,2011-02-10 22:08:08,2011-02-06 18:43:41
8f9bfb64c5d5179cc7439715379077875248c4ab...71786f54c4128821eab8a23f258848c76b5a2071,2,9,48,57,10,2011-02-10 22:08:08,2011-02-06 18:43:42
96ecac677aa84639a0b8e0aa0d781b197a2d16fe...4ce6fb805803cd9bf82c08c84a2fdc8cd6bae8ef,1,9,1,10,1,2010-09-08 15:53:54,2010-09-07 19:33:02
daae19224a05be9efb9a39c2a2c1c9a60fe906f1...0adc6a3d49a46436780b2dd636918c9840d82236,2,8,2,10,4,2010-05-28 22:08:27,2010-05-26 21:50:34
c42b00c8f2b8c04ff9829e88dcde92d7294cd460...c2394fe93441618056363a14c8b63f526afa9615,1,205,154,359,42,2010-05-09 05:26:49,2010-05-07 12:54:04
c2394fe93441618056363a14c8b63f526afa9615...a0446e7ba8dc05c67052b67c2faacdf5f7ce625a,1,52,2,54,3,2010-05-09 05:26:52,2010-05-07 12:54:05
a0446e7ba8dc05c67052b67c2faacdf5f7ce625a...45aa9895c5bef3914b6f3707b983f7a53900ebb7,1,13,8,21,3,2010-06-11 15:54:35,2010-06-05 21:11:18
c42b00c8f2b8c04ff9829e88dcde92d7294cd460...7a59745710e964f9498f37a3184bf95b9b4a772b,1,23,4,27,7,2010-05-01 19:09:58,2010-04-24 14:00:04
7a59745710e964f9498f37a3184bf95b9b4a772b...efb2d0c5dcea1069bae2d26c9534e2025ee63e66,1,19,13,32,2,2010-05-01 19:10:05,2010-04-24 14:01:10
f032d66ddb0cc81807be14c6a9052367df6d1cbc...b7e642ecec4347b170d206c84850ae0a46b5f46e,1,1,1,2,1,2012-01-11 05:51:15,2012-01-11 05:45:52
fcd424011bf7b841e9d4b3154ecadf6bf5e6e686...adda3c3beb0a244719becb1895e16227b0393bd1,2,7,6,13,3,2010-04-12 16:50:09,2010-04-12 16:28:13
2381e39e5ff740883b98c5aca019950f9167b67f...1282988b4d3d37926050a5f21ad4f7516d9a2d7f,1,1,1,2,1,2011-06-02 15:48:41,2011-06-02 05:54:49
1282988b4d3d37926050a5f21ad4f7516d9a2d7f...150b493ad42757b60eacbf98ff11982456481982,2,127,0,127,4,2011-06-02 18:59:19,2011-06-02 16:07:11
2381e39e5ff740883b98c5aca019950f9167b67f...c1909e72952ec6b95f819a4ad8faa8d69f1d961d,1,1,1,2,1,2010-05-02 05:05:14,2010-05-02 05:05:14
537f6c7fb40257776a513128043112ea43b5cdb8...c9b5fde7593ac88b1c475bea51d21ba1a1d57d65,3,38,4,42,7,2010-04-07 22:22:57,2010-04-06 08:40:35
537f6c7fb40257776a513128043112ea43b5cdb8...a751b5cc96c87be3b794a9e24c2beb7a8740c645,1,1,1,2,1,2010-04-07 04:55:50,2010-04-06 15:11:44
537f6c7fb40257776a513128043112ea43b5cdb8...016e5ff24345f974a084375da83ee143b5f2772d,3,7,6,13,8,2010-04-07 04:55:27,2010-04-07 00:08:54
e07665e524d0398a34059d605f674182bfeeaf39...657ab61efa918f46f1b412613643d1a1bbed2194,2,12,1,13,3,2010-03-30 04:22:37,2010-03-30 02:46:38
70b89f871e1afa1fe3ffa22bf3e2043d4405954a...4b2343fa4125f73a26cb20016a3ae3a27c00dd6f,1,7,0,7,1,2010-05-29 01:26:33,2010-05-20 15:55:42
6b6f5d4664c9088636418653a61f600b5e3a9ea4...3bf7886705b4ea7189f046fa5258fdf6edcdbe23,1,27,1,28,3,2010-05-04 22:27:52,2010-05-02 08:53:41
592ea4173af6b445042d74b989762fd41aecdf4c...7202db86478390ead1b5ca6c6d47d44badff10f3,1,4,2,6,2,2013-10-14 23:19:15,2013-10-06 20:50:46
28ba96ab27d0471af101b4796534ad4085019db1...921eabde9d0b9b43b293b37ac701bdfd10a64f54,1,2,1,3,1,2010-05-09 22:18:10,2010-05-09 20:10:17
28ba96ab27d0471af101b4796534ad4085019db1...2b873e064c4eac816887f823c1dfefbc9c3b4b0e,1,15,0,15,1,2010-05-04 17:12:26,2010-04-24 07:34:02
a347b17f15dd5358ced8d447af144a46b224982d...d35711adc4cffe0c4aebd85c197080c7163bcb77,2,30,1,31,3,2010-12-01 22:34:00,2010-11-30 08:22:04
890a13a45285ad44858add2ce2f74eb478f549c8...8830bf4bc5b2d03027eff8a4dc6a0cb823ec3c3b,2,2,1,3,2,2010-04-03 04:23:26,2010-04-03 00:33:55
8830bf4bc5b2d03027eff8a4dc6a0cb823ec3c3b...0e6ce21361c5d8e35cd15327539eec1f627aa0e3,4,43,14,57,16,2010-04-03 04:23:35,2010-04-03 00:35:05
0e6ce21361c5d8e35cd15327539eec1f627aa0e3...bb4bbf75829d1a6c021e34943ff4e942f064bb55,3,22,16,38,9,2010-04-03 04:23:38,2010-04-03 00:35:54
bb4bbf75829d1a6c021e34943ff4e942f064bb55...09b89d1a082a298a182875076c068711210bb5c2,2,14,4,18,8,2010-04-03 04:23:40,2010-04-03 00:40:33
09b89d1a082a298a182875076c068711210bb5c2...a8ab675f21b6e8b003b7a8ba0a72933cf34afb68,1,13,10,23,5,2010-04-03 04:23:41,2010-04-03 00:36:44
a8ab675f21b6e8b003b7a8ba0a72933cf34afb68...e3918594f6269b37ad7bd7e419df433b6d586428,1,7,9,16,5,2010-04-03 04:23:42,2010-04-03 00:37:33
890a13a45285ad44858add2ce2f74eb478f549c8...c00e657df23d9e83d86a79657ff9061b1c2d357b,2,4,4,8,4,2010-04-02 06:49:03,2010-04-02 00:03:18
c00e657df23d9e83d86a79657ff9061b1c2d357b...b76c056b95ccb15ae3b0723da983914de88b4bae,1,4,0,4,1,2010-04-02 06:49:29,2010-04-02 00:04:14
890a13a45285ad44858add2ce2f74eb478f549c8...a50dec22f2800fd073aa6ca1d112f25b4f667a56,1,12,10,22,5,2010-04-02 06:43:16,2010-04-01 22:43:54
a50dec22f2800fd073aa6ca1d112f25b4f667a56...2c4dc02346c05eead81fa526a9c06212e63dd30e,3,426,0,426,3,2010-04-02 16:19:17,2010-04-02 10:10:11
2c4dc02346c05eead81fa526a9c06212e63dd30e...73276235263485449a97be7c4d4e59eaf691c3ce,1,2,2,4,1,2010-04-02 18:37:03,2010-04-02 12:27:18
73276235263485449a97be7c4d4e59eaf691c3ce...1f2362a944e09883cf1905e40b98554f488ed041,1,1,1,2,1,2010-04-02 18:38:00,2010-04-02 12:27:19
890a13a45285ad44858add2ce2f74eb478f549c8...42653c09c85015addc6fa8dd4d49cb250253412e,3,24,2,26,4,2010-04-02 06:24:59,2010-04-01 22:14:35
9c00de5a3135c8f7273668d4013c225d48d47861...cefb2a5e39b165146aee3b093872721cc1155a87,2,29,5,34,8,2010-05-12 05:55:44,2010-05-11 17:20:23
9e2b8857413127ae200735fa004bd445b2c8ca61...82cd8358e8203fa02da18e8ee71449cb45c4157d,1,3,0,3,1,2010-03-02 20:15:41,2010-03-02 11:52:11
2dccad3c6f9df2b1eea7eb5617e2748a7f2daa40...42f16113ee87ff667fef3a821e530ce2393c6a35,1,50,53,103,5,2012-01-23 22:07:43,2012-01-23 22:02:55
42f16113ee87ff667fef3a821e530ce2393c6a35...ad17ea734770126bfe1027a8a999e9e2d9f62145,2,9,2,11,4,2012-01-23 22:24:14,2012-01-23 22:04:29
ad17ea734770126bfe1027a8a999e9e2d9f62145...ba8c6ef62787c5c8a8c1e911ce72fb07294553e3,1,1,0,1,1,2012-01-23 22:25:19,2012-01-23 22:25:19
ba8c6ef62787c5c8a8c1e911ce72fb07294553e3...60f40791f9f7b671b300b752a9beebc7737a5242,1,1,1,2,1,2012-01-27 18:26:37,2012-01-24 00:31:09
2dccad3c6f9df2b1eea7eb5617e2748a7f2daa40...876a6f4991abdd72ea707b193b4f2b831096ad3c,1,48,1,49,8,2011-12-20 00:39:54,2011-12-20 00:39:54
e4ac953b2a1e33fedf210ac59394db480a6ade33...ef563de6dd6997b913d5c87f6caf09db7e44bdcd,1,1,1,2,1,2011-11-21 19:00:57,2011-11-21 18:42:09
4c00c852b3f2596f246811ca933eef357183581b...024c843d472658a3dabb344c843c9242c2f7e4de,1,24,7,31,9,2011-11-18 19:35:08,2011-11-18 09:58:21
91776491da19f1b72e1cd192c9ea42bb1aae4415...d627de6b13138257dac3fcb4d7778d8afdcab974,1,4,1,5,1,2007-04-17 10:33:22,2007-04-15 10:01:29
d627de6b13138257dac3fcb4d7778d8afdcab974...c284914a7c6646ddf999d3df7924b10f06ac6979,1,2,2,4,2,2007-04-17 10:33:22,2007-04-17 09:41:43
883653babd8ee7ea23e6a5c392bb739348b1eb61...0b7c5a5450951dfed9017ff4dec5682219228639,1,0,1,1,1,2006-09-18 04:40:03,2006-09-15 20:46:07
0b7c5a5450951dfed9017ff4dec5682219228639...f2b5792564754d5ba812a0d3eaec2440dfc0652a,1,19,4,23,1,2006-09-18 05:13:01,2006-09-16 06:19:02
f2b5792564754d5ba812a0d3eaec2440dfc0652a...82ca50556471eadfc3212cb478161c3da5c4d02a,1,1,1,2,1,2006-09-30 05:32:16,2006-09-29 09:06:24
d819e4e682d68ca41378e4352b9e2bba084971dc...74c0cc21a57a15bbce46ee02bc882064ee9bcf6b,1,11,4,15,4,2006-08-28 06:32:37,2006-08-21 02:03:50
74c0cc21a57a15bbce46ee02bc882064ee9bcf6b...355f541249633487aa2685e7e7e29963f596b308,1,39,8,47,5,2006-08-28 06:32:37,2006-08-21 02:32:43
355f541249633487aa2685e7e7e29963f596b308...d9edcbd6061a392c1315ab6f3aedb9992a3c01b1,2,1,13,14,4,2006-09-07 09:36:31,2006-09-07 08:40:04
c065b6e4293f856012ec53fcff7bf4d47ac50927...6030649591256a8bc1b504ec1e4fce86ab0ad064,1,3,0,3,1,2006-10-05 08:57:18,2006-10-05 08:42:16
6030649591256a8bc1b504ec1e4fce86ab0ad064...9ccb64c8e0791a865ad520bcfff4b02cc7c50097,2,9,5,14,2,2006-10-05 09:26:12,2006-10-05 09:26:12
9ccb64c8e0791a865ad520bcfff4b02cc7c50097...c530c5aa31f44adafd1f4ecb05223024162e689c,1,2,2,4,1,2006-10-05 09:31:01,2006-10-05 09:29:57
c530c5aa31f44adafd1f4ecb05223024162e689c...13f8e0b24b546c0da942ab8ebe334d6e55fe1ea6,1,2,2,4,2,2006-10-05 16:09:13,2006-10-05 09:30:44
13f8e0b24b546c0da942ab8ebe334d6e55fe1ea6...6e0e92fda893311ff5af91836e5007bf6bbd4a21,1,0,5,5,1,2006-10-05 20:05:00,2006-10-05 19:22:57
6e0e92fda893311ff5af91836e5007bf6bbd4a21...db94b41aee0dfeae06e9c6f03d38a2aa30f8fd10,1,6,0,6,1,2006-10-05 21:21:12,2006-10-05 20:30:31
db94b41aee0dfeae06e9c6f03d38a2aa30f8fd10...51a7c66a73ce74fad3b7b05109ed6ce013202fa5,1,6,1,7,2,2006-10-05 22:02:13,2006-09-23 19:36:01
c065b6e4293f856012ec53fcff7bf4d47ac50927...91b489776c25866568c081e8cf4ae83fa41f8707,1,1,1,2,1,2006-10-04 22:02:04,2006-10-03 16:29:26
91b489776c25866568c081e8cf4ae83fa41f8707...b758789c202dc491555b698149afe4d4941f7cd5,2,15,2,17,6,2006-10-04 22:02:04,2006-10-03 16:29:31
b2d3476e15cefdbd94366d4cf46fd05c1623034f...63e02a1be308aa57f3cabd7e951a94ac3b7aeb51,1,24,11,35,5,2006-10-15 10:29:09,2006-10-15 10:29:09
422b4a0e03658d0933a7abc149f175735ea9c4b5...26e5fc3415a294546b4009c7280fed4d367d4e62,1,1,1,2,1,2006-10-06 09:52:37,2006-10-06 09:10:54
26e5fc3415a294546b4009c7280fed4d367d4e62...4057deb5de110176ac19519177654108607b685c,2,12,7,19,2,2006-10-08 08:35:18,2006-10-08 08:35:18
4057deb5de110176ac19519177654108607b685c...b3d4204fc49959ddcd54c329be94189f98714d73,2,15,10,25,12,2006-10-08 08:36:08,2006-10-08 08:36:08
b3d4204fc49959ddcd54c329be94189f98714d73...1974bf620b436b014bfe86179ff76485610a4887,1,1,1,2,1,2006-10-10 04:15:59,2006-10-10 04:15:59
1974bf620b436b014bfe86179ff76485610a4887...a9cb3c6ecb97c4734423045f47899e03f135d3bd,2,12,3,15,4,2006-10-16 06:06:31,2006-10-12 21:52:42
a9cb3c6ecb97c4734423045f47899e03f135d3bd...3b463c3f02f83ef0bce2d5daa193459418e5258f,2,14,2,16,2,2006-10-19 08:28:47,2006-10-19 08:28:47
3b463c3f02f83ef0bce2d5daa193459418e5258f...c31820c26b8f164433e67d28c403ca0df0316055,5,223,132,355,6,2006-10-24 03:43:49,2006-10-23 21:27:45
c31820c26b8f164433e67d28c403ca0df0316055...5d9e8ee78b1df7a9c1b2d13c2b58628201f01f72,1,3,6,9,3,2006-10-24 05:48:45,2006-10-24 05:48:45
5d9e8ee78b1df7a9c1b2d13c2b58628201f01f72...97f7a7bd0d9d618e503623ded5b22eafada9e174,1,1,1,2,1,2006-10-27 01:38:05,2006-10-26 19:39:05
422b4a0e03658d0933a7abc149f175735ea9c4b5...ab2a1a32ffa5a39aaf4204bd717562bce49e0a36,3,32,20,52,7,2006-10-06 06:17:11,2006-10-06 06:16:15
ab2a1a32ffa5a39aaf4204bd717562bce49e0a36...694500edbd51baef365c588986abe41f01acf0de,1,1,1,2,1,2006-10-24 04:15:34,2006-10-24 04:15:34
e19343ad547e32aaf511b0b38be083e1b3145d4e...cee7f245dcaef6dade28464f59420095a9949aac,8,1314,0,1314,8,2006-10-20 05:42:49,2006-10-19 23:00:04
cee7f245dcaef6dade28464f59420095a9949aac...d24bba8008d8e537cb48e9760f7621cbe7ae9e38,2,130,7,137,14,2006-10-20 07:27:05,2006-10-20 01:49:30
d24bba8008d8e537cb48e9760f7621cbe7ae9e38...18abd745a05197f498219f5ba88ce238a3d51580,2,102,3,105,8,2006-10-20 07:30:44,2006-10-20 01:50:17
18abd745a05197f498219f5ba88ce238a3d51580...1617baa5878c9b3886926f0f2e6dc52d067ada4a,1,1,1,2,1,2006-10-21 01:37:10,2006-10-21 01:37:10
1617baa5878c9b3886926f0f2e6dc52d067ada4a...1ca6ca876e3553d9609823a70d168c50d7beba7e,1,3,0,3,1,2006-10-21 01:48:18,2006-10-21 01:48:18
1ca6ca876e3553d9609823a70d168c50d7beba7e...5ff62c300209d761e8e7b3c78da19b910cd9b860,1,48,23,71,19,2006-10-21 01:48:23,2006-10-20 21:51:12
5ff62c300209d761e8e7b3c78da19b910cd9b860...4a0fc95f182dbf5b0c58e6d6cfe8cd7459da7ab6,1,32,4,36,8,2006-10-21 01:48:23,2006-10-20 22:37:12
4a0fc95f182dbf5b0c58e6d6cfe8cd7459da7ab6...612702e8ea3aa070586001f1aa0a2070058664e0,1,19,7,26,9,2006-10-21 06:49:41,2006-10-21 06:49:31
612702e8ea3aa070586001f1aa0a2070058664e0...46014766bdacec8ad22355ce78898b895bf172d6,1,25,20,45,17,2006-10-21 07:41:38,2006-10-21 07:41:38
46014766bdacec8ad22355ce78898b895bf172d6...f6c0e191020ad330c06438c144e0ea787ca964fd,1,101,37,138,16,2006-10-21 09:56:33,2006-10-21 09:56:33
f6c0e191020ad330c06438c144e0ea787ca964fd...aec8fa1f587d68a0e50ada2720c8dc6e09709a9c,1,50,41,91,9,2006-10-21 10:30:53,2006-10-21 10:30:53
aec8fa1f587d68a0e50ada2720c8dc6e09709a9c...54a4c6173e30774125016f7ff4976eb4a7485d0c,1,121,21,142,38,2006-10-29 23:29:25,2006-10-29 11:07:40
54a4c6173e30774125016f7ff4976eb4a7485d0c...2c40f98439e07b8579d0549109a4feed54da9e40,1,8,2,10,2,2006-10-30 07:50:55,2006-10-30 07:50:38
2c40f98439e07b8579d0549109a4feed54da9e40...f5f75c652b9c2347522159a87297820103e593e4,1,1,0,1,1,2006-10-30 07:56:12,2006-10-30 07:56:12
f5f75c652b9c2347522159a87297820103e593e4...ae86ad65757b857337f10f25ff31cb3348d3943d,1,10,5,15,4,2006-10-30 22:27:52,2006-10-30 22:27:52
ae86ad65757b857337f10f25ff31cb3348d3943d...f69e743d97cdb3f6647ea0620a22311e7bf36051,1,43,25,68,7,2006-10-31 01:17:41,2006-10-31 01:17:41
f69e743d97cdb3f6647ea0620a22311e7bf36051...0d981c67d8bcf4610e165744059c1e9e14609baa,1,20,4,24,6,2006-10-31 09:00:01,2006-10-31 09:00:01
0d981c67d8bcf4610e165744059c1e9e14609baa...62476c8e331a22e224d87c18830913129f5f303b,3,55,3,58,5,2006-10-31 22:22:34,2006-10-31 22:22:34
62476c8e331a22e224d87c18830913129f5f303b...20239bae943733d766e6475cf0916966c868246b,1,11,4,15,5,2006-11-02 08:11:30,2006-11-02 07:22:49
20239bae943733d766e6475cf0916966c868246b...2f3f8b218abae6fc0574d0e22d3614fc0f5e983d,3,7,1,8,5,2006-11-04 20:18:12,2006-11-02 08:02:11
2f3f8b218abae6fc0574d0e22d3614fc0f5e983d...0421d9f812acc819dcf9e9c6707618aca7e80bf4,1,11,1,12,2,2006-11-04 20:20:18,2006-11-04 20:20:09
0421d9f812acc819dcf9e9c6707618aca7e80bf4...650e2f6752ad29b0cba394535d3b098cf4bb102b,1,15,9,24,2,2006-11-04 20:37:02,2006-11-04 20:37:02
650e2f6752ad29b0cba394535d3b098cf4bb102b...334947843cbd50895f1dc58d8bd2f217e1f1ef77,1,103,62,165,16,2006-11-05 00:39:03,2006-11-05 00:39:03
334947843cbd50895f1dc58d8bd2f217e1f1ef77...854b97f6eb3bcbeb76b2705bfbffead1558bde77,1,42,19,61,11,2006-11-05 03:19:16,2006-11-05 03:18:50
854b97f6eb3bcbeb76b2705bfbffead1558bde77...2bc45477a53b9b7a5202a816b96c14428f683c38,1,3,0,3,3,2006-11-05 19:49:56,2006-11-05 19:47:53
2bc45477a53b9b7a5202a816b96c14428f683c38...c2e525d97f81bc178567cdf4dd7056ce6224eb58,1,62,38,100,21,2006-11-05 19:51:41,2006-11-05 19:51:41
c2e525d97f81bc178567cdf4dd7056ce6224eb58...931233bc666b40de039d50f82f12279c94e5e5f0,1,83,13,96,8,2006-11-07 06:09:44,2006-11-07 01:08:32
931233bc666b40de039d50f82f12279c94e5e5f0...7bd9641df5b7cca91b21bfdc587962c59700786c,1,19,0,19,1,2006-11-08 00:24:37,2006-11-08 00:20:02
fba0cbd95d796857622d642160176907930ae511...f82cd3c6104733e2ff3305c325a440731aa1d17c,1,1,4,5,2,2006-08-03 18:50:10,2006-08-03 18:50:10
f82cd3c6104733e2ff3305c325a440731aa1d17c...47781bf7793205cfb7b8ce89b9c3627ecf5480fc,1,1,1,2,1,2006-08-03 20:21:07,2006-08-03 15:42:44
47781bf7793205cfb7b8ce89b9c3627ecf5480fc...a91af794bb4349e0b35d6a9615db31ae2f6ee355,1,1,1,2,1,2006-08-03 20:44:09,2006-08-03 20:44:09
a91af794bb4349e0b35d6a9615db31ae2f6ee355...c43ce6d603c68f716f83f1da68cc4692202085e0,2,136,0,136,2,2006-08-03 21:41:29,2006-08-03 21:41:29
c43ce6d603c68f716f83f1da68cc4692202085e0...ef677686efe1868432d3cc9d4c41a93b44f3def8,3,4,6,10,5,2006-08-03 21:41:53,2006-08-03 19:01:01
ef677686efe1868432d3cc9d4c41a93b44f3def8...53dd8a9cb524ac2bd99072d86ee31ee48c99d0be,1,1,1,2,1,2006-08-03 21:41:53,2006-08-03 18:57:11
fba0cbd95d796857622d642160176907930ae511...657b062dbab2e17c750050d76de3e76ea28e603e,1,33,2,35,4,2006-08-03 00:16:40,2006-08-02 22:38:11
657b062dbab2e17c750050d76de3e76ea28e603e...c4b1b1401cedefe480e32ceccd4ed678f9409e89,1,50,50,100,2,2006-08-03 00:16:40,2006-08-02 22:38:56
c4b1b1401cedefe480e32ceccd4ed678f9409e89...eb858c56cb9dcced05d61d47c0351b4f8768d379,1,22,0,22,2,2006-08-03 00:16:41,2006-08-02 22:40:40
eb858c56cb9dcced05d61d47c0351b4f8768d379...656517b9ef5cf443f72110dcd56b15825bc7f1ef,1,21,0,21,1,2006-08-04 18:46:27,2006-08-04 15:55:57
656517b9ef5cf443f72110dcd56b15825bc7f1ef...465e649d0c62847fd5cca212766e1a01183baeef,2,24,21,45,6,2006-08-04 18:53:13,2006-08-04 15:55:58
465e649d0c62847fd5cca212766e1a01183baeef...34d4a67f47bb8954475077e91d513f445713c534,1,12,0,12,1,2006-08-04 18:55:42,2006-08-04 15:55:59
34d4a67f47bb8954475077e91d513f445713c534...3068f6c47d8ece84c7daba243d3f60492bd0611e,1,2,2,4,1,2006-08-04 23:33:18,2006-08-04 23:33:18
3068f6c47d8ece84c7daba243d3f60492bd0611e...f7b5e8d03a97e7d4a6e543d5f9972d1285947908,1,1,2,3,1,2006-08-04 23:34:30,2006-08-04 21:28:11
f7b5e8d03a97e7d4a6e543d5f9972d1285947908...8c6ab35efe635b2f70cdd471903cd80886ec6eec,1,8,2,10,2,2006-08-04 23:46:16,2006-08-04 23:46:16
8c6ab35efe635b2f70cdd471903cd80886ec6eec...d5c31a1ccfa1195cff160bbad995c68037180570,1,31,16,47,14,2006-08-07 08:22:13,2006-08-04 21:43:59
d5c31a1ccfa1195cff160bbad995c68037180570...3900145ed72bf1dfd656af6a5b31034e818b425f,3,9,2,11,3,2006-08-08 20:32:04,2006-08-08 16:35:23
3900145ed72bf1dfd656af6a5b31034e818b425f...b52b1d433b47888d79a73a514aa3430257cba863,1,1,1,2,1,2006-08-08 20:32:34,2006-08-08 16:36:21
b52b1d433b47888d79a73a514aa3430257cba863...af6058cc2bf309631fc7f5cd44fb39b567286506,1,9,6,15,5,2006-08-08 20:34:00,2006-08-08 16:38:06
af6058cc2bf309631fc7f5cd44fb39b567286506...424adc50b73f269ac3f3bd0195f9e7fea935109f,2,60,31,91,22,2006-08-09 00:19:18,2006-08-08 16:39:06
424adc50b73f269ac3f3bd0195f9e7fea935109f...1b1b678e3c4eebe0302455c248941e5627ce2b5b,2,2,2,4,3,2006-08-09 00:19:28,2006-08-08 20:42:35
1b1b678e3c4eebe0302455c248941e5627ce2b5b...7b1e9d3d854f0c0df58b88809793c1b114a45b90,1,1,1,2,1,2006-08-09 00:47:36,2006-08-09 00:19:22
7b1e9d3d854f0c0df58b88809793c1b114a45b90...a20b4d899ae75e075641d7bfe9462a239c8b9236,1,101,57,158,6,2006-08-09 05:07:08,2006-08-09 00:15:10
fba0cbd95d796857622d642160176907930ae511...70b9c59656f974590fc050dfb3429106fd37c9ee,1,1,0,1,1,2006-08-03 00:06:50,2006-08-02 22:44:07
022f25e8d4bd3eaed6bb6d80a242f8930687d483...fd7bcfb524a3313ef5361bdd8493ba50635f50f0,1,19,9,28,4,2006-08-13 00:08:07,2006-08-12 23:16:47
fd7bcfb524a3313ef5361bdd8493ba50635f50f0...40aaae88adfe05be435b7bd17093d49869f3276f,11,20,32,52,13,2006-08-13 00:08:25,2006-08-12 08:03:47
40aaae88adfe05be435b7bd17093d49869f3276f...6c7f4cebdb40c0d95c63d59538fd235dcf978029,1,4,2,6,2,2006-08-13 01:11:10,2006-08-13 01:04:07
cba05fa840b637db2708014142a753680d930082...d249b455475977f305240bb73473f25d040012cf,1,5,0,5,2,2006-08-04 09:08:02,2006-08-04 08:11:15
d249b455475977f305240bb73473f25d040012cf...7e18e56920bd38ffc1f2c068d943bfd3f012473d,1,4,2,6,3,2006-08-04 09:08:20,2006-08-04 08:54:08
7e18e56920bd38ffc1f2c068d943bfd3f012473d...3a3c3fc42a021f11aa8f35dc40cc69d4d4af7224,1,1,1,2,1,2006-08-04 18:30:19,2006-08-04 15:46:19
cba05fa840b637db2708014142a753680d930082...d6b64ed0f3549f56c4d948dc2c0f12abc52fd6c9,4,8,5,13,8,2006-08-04 06:15:11,2006-08-03 15:24:35
d6b64ed0f3549f56c4d948dc2c0f12abc52fd6c9...5d4a60033543e063bc9d77ca957de0187fb58fb3,4,7,5,12,8,2006-08-04 06:15:11,2006-08-03 15:24:36
5d4a60033543e063bc9d77ca957de0187fb58fb3...6441363079d85cf17aee21b8925e9745c8abda16,4,9,7,16,9,2006-08-04 06:15:11,2006-08-03 15:24:37
6441363079d85cf17aee21b8925e9745c8abda16...640ce1052bbd6a8f1dd4d58beaa521d7592a0f02,4,7,5,12,8,2006-08-04 06:15:11,2006-08-03 15:24:38
640ce1052bbd6a8f1dd4d58beaa521d7592a0f02...e414156ab6e7869b29622ee3439e3c91361f5b0e,4,18,16,34,19,2006-08-04 08:23:19,2006-08-04 08:23:19
e414156ab6e7869b29622ee3439e3c91361f5b0e...f754fa9c5480c4556ad268fb5014c4b96cc7b9dc,5,116,106,222,28,2006-08-04 08:51:04,2006-08-04 08:51:04
f754fa9c5480c4556ad268fb5014c4b96cc7b9dc...efffea033457eedb90ad63596687564f797f12de,1,36,36,72,13,2006-08-04 09:04:00,2006-08-04 09:04:00
b05faa2da9ec24d737bbba47c71e815255f3eaa7...60b7f38e0e08867b72022de5c20715d8eb72de24,2,8,8,16,7,2006-08-24 01:47:38,2006-08-23 10:39:10
60b7f38e0e08867b72022de5c20715d8eb72de24...c5fba16c500ad5847842876df0418664cddf6e50,2,5,4,9,3,2006-08-24 01:47:38,2006-08-23 10:39:11
c5fba16c500ad5847842876df0418664cddf6e50...b5bf7cd6b7dbcbef9181e21bfae21612c75738c4,2,2,2,4,2,2006-08-24 01:47:38,2006-08-23 10:39:12
b5bf7cd6b7dbcbef9181e21bfae21612c75738c4...d828f6ddf8bc33f848688655b94c82791edfe0d7,2,6,6,12,5,2006-08-24 01:47:39,2006-08-23 10:39:13
d828f6ddf8bc33f848688655b94c82791edfe0d7...599f8d63140f3626604d4fc83a48cd00c67b804a,1,0,3,3,1,2006-08-24 01:47:39,2006-08-24 01:39:49
599f8d63140f3626604d4fc83a48cd00c67b804a...dd305c846231e2fddf61c1e1314029b53af88a77,1,1,3,4,1,2006-08-24 01:47:39,2006-08-23 10:39:15
dd305c846231e2fddf61c1e1314029b53af88a77...5df7dbbae4a51e20afc00acc5c87ea4536d1302c,1,3,3,6,2,2006-08-24 01:47:39,2006-08-23 10:39:16
b05faa2da9ec24d737bbba47c71e815255f3eaa7...e702496e434a160f798447b95b9cea3cd138c140,34,81,78,159,76,2006-08-23 20:53:10,2006-08-23 06:49:00
e702496e434a160f798447b95b9cea3cd138c140...a8e0d16d85fb2ea53775f64549cac2396cd621a6,6,9,5,14,6,2006-08-23 20:57:23,2006-08-23 20:57:23
1efca00ad8fc1a7ad04d80a76ba852e0cce847b0...2c6d22df9f8a975c88fc9a93c4db8bb0bd116b74,1,2,0,2,1,2006-08-31 21:16:09,2006-08-31 21:14:20
ed1795fcc5f2aa3f105630429bcbed49c50053fa...648ad18f5077295c4317f0784b29e09d2c0bac93,3,13,5,18,3,2006-09-24 07:13:49,2006-09-23 10:05:43
648ad18f5077295c4317f0784b29e09d2c0bac93...7be1d62c6f6b322d826d145762db0050057aeb69,1,44,0,44,1,2006-09-24 07:13:49,2006-09-23 10:40:17
7be1d62c6f6b322d826d145762db0050057aeb69...5372806a849cf117596b1f7c8c7d512c519f8092,2,33,8,41,7,2006-09-24 07:13:49,2006-09-23 20:53:04
5372806a849cf117596b1f7c8c7d512c519f8092...6cc7c36d5e2fd89be596a164bcc2afede9d855d3,1,25,0,25,2,2006-09-24 09:00:21,2006-09-23 20:55:35
ed1795fcc5f2aa3f105630429bcbed49c50053fa...448c3ef144b2f528bb6dc50153ac13cc2abbc3c4,2,132,41,173,10,2006-09-24 07:12:44,2006-09-23 05:48:39
448c3ef144b2f528bb6dc50153ac13cc2abbc3c4...d0c25035df4897bb58422b4d64f00b54cf11f07e,1,97,25,122,8,2006-09-24 07:12:44,2006-09-23 07:37:19
2f60e4e9c18c4cbe1ceacad1bb975a6206ec0411...f7bae37f9ab2fdc567780d23495733c9af526e02,2,16,1,17,4,2006-09-25 03:19:22,2006-09-25 02:50:15
f7bae37f9ab2fdc567780d23495733c9af526e02...8815788e93c0a5a2e47e067dfa0764b17b8d1ddd,1,1,1,2,1,2006-09-25 03:19:28,2006-09-25 03:04:55
8815788e93c0a5a2e47e067dfa0764b17b8d1ddd...8391548e5e78677eb81f97334d998418802ea194,1,6,6,12,3,2006-09-25 03:33:09,2006-09-24 21:57:40
e9800b28c24465377dc2b8e26b322d362912647c...4431fcc4b134ae501e3e57dc568ae4f031e57898,5,11,12,23,11,2006-09-27 08:42:44,2006-09-27 08:09:18
4431fcc4b134ae501e3e57dc568ae4f031e57898...ac5409e420e5fdd7c4a381f873ffcedfb83d7117,4,50,5,55,11,2006-09-27 09:01:42,2006-09-27 08:58:57
ac5409e420e5fdd7c4a381f873ffcedfb83d7117...cede7526534c47436de17977eb39e55aa8c1e646,3,13,9,22,10,2006-09-27 09:06:31,2006-09-27 09:06:31
cede7526534c47436de17977eb39e55aa8c1e646...3159c8dc2da4c88dcecabb95404fe88edc5441e4,1,15,73,88,10,2006-09-27 09:45:07,2006-09-27 09:40:06
3159c8dc2da4c88dcecabb95404fe88edc5441e4...94d8213f2c98c4a5fd50484fcb11b4b24b403294,1,1,0,1,1,2006-09-27 20:47:21,2006-09-27 20:47:21
d25c26e771fdf771f264dc85be348719886d354f...f64d7fd267c501f501e18a888e3e1e0c5b56458f,1,6,5,11,4,2006-11-25 09:04:28,2006-11-25 09:04:28
d25c26e771fdf771f264dc85be348719886d354f...61f5cb7f0d9ea6990f331bd7082630691c88abd2,2,4,0,4,2,2006-11-25 08:20:01,2006-10-25 04:48:55
3c23bea8ac211332086d26c90cd7348d6d0e129f...fde97d8ac63efa466dd48436d2178bd364b846de,2,34,55,89,5,2006-11-27 20:08:36,2006-11-27 19:37:43
fde97d8ac63efa466dd48436d2178bd364b846de...4ad91321ee95598c2488ab5e39afec13575d4e3f,1,30,0,30,4,2006-11-27 20:08:58,2006-11-27 08:40:47
4ad91321ee95598c2488ab5e39afec13575d4e3f...f2bb9f88805f370b9de1c116f42e3ceb30321c80,1,57,5,62,2,2006-11-27 20:09:04,2006-11-27 08:41:01
f2bb9f88805f370b9de1c116f42e3ceb30321c80...d33909bf6e78e6ab8a45bfdd19bc19213fde5501,1,9,0,9,4,2006-11-27 20:09:10,2006-11-27 08:41:12
d33909bf6e78e6ab8a45bfdd19bc19213fde5501...d3d717a4ad0c8d7329e79f7d0313baec57c6b585,1,19,0,19,2,2006-11-27 20:09:16,2006-11-27 08:41:28
d3d717a4ad0c8d7329e79f7d0313baec57c6b585...f53352fbaf2bcc6d209388bb2a68d888ceb8014e,1,44,16,60,6,2006-11-27 20:09:58,2006-11-27 08:41:43
f53352fbaf2bcc6d209388bb2a68d888ceb8014e...1273231ee9c7a576a3654d8f2ba77267393564ab,1,17,0,17,3,2006-11-27 20:10:50,2006-11-27 08:41:59
1273231ee9c7a576a3654d8f2ba77267393564ab...61d926a3cdb8f03147580de53e448fc22370cbb1,1,32,6,38,6,2006-11-27 20:11:07,2006-11-27 08:42:07
61d926a3cdb8f03147580de53e448fc22370cbb1...6e31b866e4c8e6fc432e6087d56be73c08cf0f83,1,26,8,34,5,2006-11-27 20:11:12,2006-11-27 08:42:18
6e31b866e4c8e6fc432e6087d56be73c08cf0f83...35e65ecca78ceeca8eca72149e7546de94ed8607,1,14,4,18,3,2006-11-27 20:17:52,2006-11-27 08:42:32
35e65ecca78ceeca8eca72149e7546de94ed8607...5de40f59d4954738448e238b06eed72f73cca740,1,154,0,154,6,2006-11-27 20:17:59,2006-11-27 09:44:47
5de40f59d4954738448e238b06eed72f73cca740...ce1e39d29ee373786ceda9e79d0906a6451ab5a5,1,20,10,30,6,2006-11-27 20:57:15,2006-11-27 20:10:42
ce1e39d29ee373786ceda9e79d0906a6451ab5a5...b51ec6bddb572def384a21a18d5919a488e06ffb,1,19,1,20,5,2006-11-27 20:57:21,2006-11-27 20:11:52
b51ec6bddb572def384a21a18d5919a488e06ffb...88329195159865c0fcc57a6017c959d13d7a1ad6,1,53,0,53,4,2006-11-27 20:57:22,2006-11-27 20:12:03
88329195159865c0fcc57a6017c959d13d7a1ad6...6f23ebf600188fe4246c2fb118f0c977ba1a2ed6,1,4,2,6,3,2006-11-27 21:55:49,2006-11-27 21:20:53
6f23ebf600188fe4246c2fb118f0c977ba1a2ed6...86d11cf264c55d570484cbdfff073092c77a6342,1,84,84,168,72,2006-11-27 22:21:30,2006-11-27 22:21:30
86d11cf264c55d570484cbdfff073092c77a6342...1d541c120b4de5c70e73f8a20e1d961324cc55fe,1,1,1,2,1,2006-11-28 00:55:42,2006-11-27 23:29:21
1d541c120b4de5c70e73f8a20e1d961324cc55fe...f0df4ed5629c25e9978708115ad654b9f83f55df,1,20,15,35,3,2006-11-28 00:56:54,2006-11-27 23:18:55
b77b02785d2f589ca336fc449ee1c27837263dac...69d47bdd6c1d6cb9c8603fd1da8b756e2903f955,1,34,48,82,23,2006-02-09 23:29:26,2006-02-09 23:29:26
5e80092f7e6db09a40a62e837ca3f74f0bc5ad73...2fa090b6c145db9f6219a037c773fb63fe727019,2,104,87,191,72,2005-12-08 00:05:21,2005-12-08 00:05:21
2fa090b6c145db9f6219a037c773fb63fe727019...12bd7e78ee138e3ceefa5442db224c8288204b64,2,6,7,13,7,2005-12-08 00:16:04,2005-12-08 00:16:04
12bd7e78ee138e3ceefa5442db224c8288204b64...6bad1902f52c861e5e0adfc479987ff84b22dafe,1,2,1,3,1,2005-12-08 00:26:49,2005-12-08 00:26:49
6bad1902f52c861e5e0adfc479987ff84b22dafe...361c06d8f5777c1037ad5c0e4d58f44cda4a5044,1,12,11,23,7,2005-12-08 00:44:12,2005-12-08 00:44:12
361c06d8f5777c1037ad5c0e4d58f44cda4a5044...64224caf888253601b7285ab242f4a12779894b9,1,4,0,4,2,2005-12-08 01:48:53,2005-12-08 01:48:53
64224caf888253601b7285ab242f4a12779894b9...128aed684d0b3099092b7597c8644599b45b7503,3,17,3,20,6,2005-12-08 05:05:39,2005-12-08 02:04:38
128aed684d0b3099092b7597c8644599b45b7503...49ccb0877f64308662669a09db7b221419c13d0a,1,12,1,13,1,2005-12-08 06:05:05,2005-12-08 05:52:28
49ccb0877f64308662669a09db7b221419c13d0a...9688a882e12a80bc94d6e34d5a4b34816990e9eb,3,7,7,14,6,2005-12-08 22:04:33,2005-12-08 22:04:33
9688a882e12a80bc94d6e34d5a4b34816990e9eb...bcaf60b25b6f62049f195e253d6a974b42442066,1,1,1,2,1,2005-12-08 22:10:02,2005-12-08 22:10:02
bcaf60b25b6f62049f195e253d6a974b42442066...63ae26f87ae1d3a95a8ecc2fc761b7a7987e3ce5,2,6,2,8,3,2005-12-08 23:50:13,2005-12-08 23:28:05
63ae26f87ae1d3a95a8ecc2fc761b7a7987e3ce5...68e37f8402d5ad33b423686558265e55655a2db6,1,1,1,2,1,2005-12-08 23:50:13,2005-12-08 23:28:05
68e37f8402d5ad33b423686558265e55655a2db6...16cc50d12e8852583bde5c1116e4075f79d0a403,1,1,1,2,1,2005-12-08 23:50:13,2005-12-08 23:28:05
16cc50d12e8852583bde5c1116e4075f79d0a403...eaa54efc619879ef0d0f7b95f5357d8dab86a713,1,12,6,18,7,2005-12-08 23:50:14,2005-12-08 23:28:05
eaa54efc619879ef0d0f7b95f5357d8dab86a713...e293de3efb9d49d0c66d8dc5817d1851f8b4a50c,1,3,1,4,2,2005-12-08 23:50:14,2005-12-08 23:28:05
e293de3efb9d49d0c66d8dc5817d1851f8b4a50c...56e5e9170e597f8ccba771cf2a7aa5de86e74799,1,1,1,2,1,2005-12-08 23:50:14,2005-12-08 23:28:05
56e5e9170e597f8ccba771cf2a7aa5de86e74799...d9722174573fc657c9b6c4adde6165d65c4e8de6,1,2,2,4,2,2005-12-08 23:50:14,2005-12-08 23:28:05
d9722174573fc657c9b6c4adde6165d65c4e8de6...674b28085e89c3be37d07063b253069101669b55,3,4,4,8,4,2005-12-08 23:50:14,2005-12-08 23:28:05
674b28085e89c3be37d07063b253069101669b55...d4ce5f7e508c0a52aea2938cf2f7e25bf62eec3a,2,8,2,10,3,2005-12-08 23:50:14,2005-12-08 23:28:05
d4ce5f7e508c0a52aea2938cf2f7e25bf62eec3a...6f855371a53bf6a906e573f9ff32a2f9e1dfcfa8,1,17,6,23,6,2005-12-08 23:50:15,2005-12-08 23:28:05
6f855371a53bf6a906e573f9ff32a2f9e1dfcfa8...5e34c99d95e1336b679a185f11747ee8392de9df,1,1,1,2,1,2005-12-08 23:50:15,2005-12-08 23:28:05
5e34c99d95e1336b679a185f11747ee8392de9df...31f232819f602d6df484837bbe4e021c5efd3586,1,8,1,9,2,2005-12-08 23:50:15,2005-12-08 23:28:05
31f232819f602d6df484837bbe4e021c5efd3586...5dd7342142f209b209e95b6a87c366d5205acd6a,1,6,0,6,1,2005-12-08 23:50:15,2005-12-08 23:28:05
5dd7342142f209b209e95b6a87c366d5205acd6a...03f6c23c5edb2590c71e4e8c33f20c3449407a72,1,1,1,2,1,2005-12-08 23:50:15,2005-12-08 23:28:05
03f6c23c5edb2590c71e4e8c33f20c3449407a72...d839091d13c408cc0662e22830cab6ef36be74bf,1,20,20,40,2,2005-12-08 23:50:15,2005-12-08 23:28:05
d839091d13c408cc0662e22830cab6ef36be74bf...8c667f4bb878a7bcb45eb6dbd920b8aba9718d7e,1,1,1,2,1,2005-12-08 23:50:16,2005-12-08 23:28:06
8c667f4bb878a7bcb45eb6dbd920b8aba9718d7e...c82365dc6f211722cbbed96f41a61f477914c91a,1,29,1,30,2,2005-12-09 00:30:24,2005-12-09 00:30:24
c82365dc6f211722cbbed96f41a61f477914c91a...2dee581667d62d113605e97de0beda6a9dbca153,1,6,1,7,1,2005-12-09 01:29:11,2005-12-09 01:29:11
2dee581667d62d113605e97de0beda6a9dbca153...2b86976bfd6e42609692d57fffaef72bd985c23a,2,14,19,33,6,2005-12-09 07:18:41,2005-12-09 07:18:41
2b86976bfd6e42609692d57fffaef72bd985c23a...0f737464a6734d917431cf8df14eb04bd9c4cd8d,1,2,2,4,1,2005-12-09 20:51:04,2005-12-08 20:25:55
0f737464a6734d917431cf8df14eb04bd9c4cd8d...10b94e283aa76d56b85cfc9fcb8bc63f167b580b,1,2,3,5,3,2005-12-10 01:32:18,2005-12-10 01:32:18
10b94e283aa76d56b85cfc9fcb8bc63f167b580b...db9536c8566bc7b2f2dd388a066bb0fda960b379,2,139,0,139,2,2005-12-10 07:07:29,2005-12-10 07:07:29
db9536c8566bc7b2f2dd388a066bb0fda960b379...8b15e2fbc9d9b9d04c70fe590a3d0562d4334c38,2,11,10,21,4,2005-12-10 07:41:03,2005-12-10 07:41:03
8b15e2fbc9d9b9d04c70fe590a3d0562d4334c38...2777ef76be7174f698b3f53cc4ff38b4118de320,1,16,0,16,2,2005-12-11 01:41:39,2005-11-24 07:47:39
2777ef76be7174f698b3f53cc4ff38b4118de320...f88961a85f14dd3fae4f5204f8187ba5d9a7646e,1,28,23,51,22,2005-12-11 01:41:39,2005-11-24 07:48:57
f88961a85f14dd3fae4f5204f8187ba5d9a7646e...5744f27794c284758a5c7956b9e5d5669c5dd318,1,2,3,5,1,2005-12-11 01:41:40,2005-11-24 07:50:27
5744f27794c284758a5c7956b9e5d5669c5dd318...1136fb5284a5be907a28d887811e8c08aaa3b4da,1,1,1,2,1,2005-12-11 01:41:40,2005-11-24 07:51:33
1136fb5284a5be907a28d887811e8c08aaa3b4da...42f44b08bc1bf84a6e620cf7254b820a9656daca,1,135,90,225,22,2005-12-11 01:41:40,2005-11-24 07:52:43
42f44b08bc1bf84a6e620cf7254b820a9656daca...6df896b50a8f1294d00e8da9d3662d9422dd0533,1,111,98,209,29,2005-12-11 01:41:40,2005-11-24 07:53:55
6df896b50a8f1294d00e8da9d3662d9422dd0533...3e525e673849393035a2639e17ff74e616a618b9,1,171,28,199,21,2005-12-11 01:41:40,2005-11-24 07:55:04
3e525e673849393035a2639e17ff74e616a618b9...6e33101abd82f38393b8f2a137601add845722f7,1,2,2,4,2,2005-12-11 01:41:40,2005-11-24 07:56:31
6e33101abd82f38393b8f2a137601add845722f7...10945e006a9567f4da1dac15cfdc1035752c5c5e,1,1,5,6,2,2005-12-11 01:41:40,2005-11-24 07:58:16
10945e006a9567f4da1dac15cfdc1035752c5c5e...024510c8d947be6ae4765840e21a89d5a21271c4,4,52,3,55,8,2005-12-11 02:57:57,2005-12-10 22:25:24
024510c8d947be6ae4765840e21a89d5a21271c4...73ab46d6d03fc38e7b57f7fb731da432d4433268,1,14,14,28,14,2005-12-11 03:00:24,2005-12-11 02:36:15
73ab46d6d03fc38e7b57f7fb731da432d4433268...eea420693befc2f876079a8a4585ea8ebf07c047,2,36,2,38,5,2005-12-11 04:55:32,2005-12-11 04:55:32
eea420693befc2f876079a8a4585ea8ebf07c047...7564577a6c05a1153ddb94cbe68e75c391b52f20,1,10,4,14,2,2005-12-11 06:22:35,2005-12-11 06:22:35
7564577a6c05a1153ddb94cbe68e75c391b52f20...28e77a81647584bfbe112f19e12e9952ab0b2fab,1,46,8,54,6,2005-12-11 09:47:15,2005-12-11 06:05:01
28e77a81647584bfbe112f19e12e9952ab0b2fab...157dc07368faf6537af1d2ce676a4f2dda2f71a6,1,5,12,17,2,2005-12-11 09:55:52,2005-12-11 09:55:52
157dc07368faf6537af1d2ce676a4f2dda2f71a6...b825e6ff5d003db8efd1ed43cdbbb9d637df0a0c,1,164,0,164,1,2005-12-11 20:44:46,2005-12-11 20:44:46
562051809589574576971c53c23aad93f8c395d9...0738fc2192109f946c033b3b003cb10aace9554e,1,1,1,2,1,2005-11-30 18:51:24,2005-11-30 15:37:10
562051809589574576971c53c23aad93f8c395d9...10637b84d91cf8870d1db8609a10dc5e58722378,2,64,8,72,8,2005-11-30 08:14:18,2005-11-30 05:06:10
10637b84d91cf8870d1db8609a10dc5e58722378...354b9b59b0a02ce7e32a7b0c10caaa1e3532f22b,1,1,5,6,1,2005-11-30 08:14:19,2005-11-30 05:06:10
354b9b59b0a02ce7e32a7b0c10caaa1e3532f22b...15bf57a18aaf10c038e2026dfe54281edbb6080a,2,5,23,28,5,2005-11-30 10:17:51,2005-11-30 10:16:36
15bf57a18aaf10c038e2026dfe54281edbb6080a...58cce8a85da745e20c9527c569a0e0935ff3ab30,1,0,2,2,1,2005-11-30 10:37:06,2005-11-30 10:37:06
58cce8a85da745e20c9527c569a0e0935ff3ab30...0501c2409d7661d2b13f094136d246b9b5b8acf9,1,7,8,15,5,2005-11-30 10:38:24,2005-11-30 10:38:24
034908047d8c46fb4e1323285b3b066567c7fadc...4518bb88392fcd44bacae640754e7326a8fdf477,1,3,9,12,1,2005-11-29 23:34:46,2005-11-26 02:45:52
4518bb88392fcd44bacae640754e7326a8fdf477...8bf2c69c2dd7430944898fa23edb8562c75c57e0,1,27,0,27,1,2005-11-29 23:43:20,2005-11-29 22:10:24
034908047d8c46fb4e1323285b3b066567c7fadc...e1355547fd30b21fbdc3fe4e576759683777c4ce,1,1,1,2,1,2005-11-29 22:14:42,2005-11-29 22:14:42
e1355547fd30b21fbdc3fe4e576759683777c4ce...bf3e274873e56d7df25d60800c8d59a309e0d8c6,1,24,13,37,4,2005-11-29 22:18:27,2005-11-29 21:53:30
bf3e274873e56d7df25d60800c8d59a309e0d8c6...99e368b996d6fcc2383a4b385130a0cb70c164e2,1,0,1,1,1,2005-11-29 22:25:00,2005-11-29 21:51:27
99e368b996d6fcc2383a4b385130a0cb70c164e2...a004d3f70f1c074f2d9bd55e7a925ff5916ebbeb,1,1,1,2,1,2005-11-29 22:26:48,2005-11-29 21:51:27
a004d3f70f1c074f2d9bd55e7a925ff5916ebbeb...830273d10cf1cfe646db39b87d3ccb49bf88b73a,1,5,1,6,2,2005-11-29 22:27:59,2005-11-29 21:51:27
9cac9d368934f68e75810df95211a6522d4d139e...b34403aa97047f90c0cdd5177e63a8e7530e3388,1,12,16,28,3,2005-12-01 01:46:35,2005-12-01 01:32:01
b34403aa97047f90c0cdd5177e63a8e7530e3388...a3e3dc46901e3ba20a9f1d3ae503ac2faf5a8ea9,1,5,0,5,1,2005-12-01 20:24:51,2005-12-01 20:24:51
a3e3dc46901e3ba20a9f1d3ae503ac2faf5a8ea9...2731d04883317f5de03a942bb0ea8c1eba6babad,1,3,0,3,1,2005-12-01 20:26:41,2005-12-01 20:26:41
2731d04883317f5de03a942bb0ea8c1eba6babad...0f8f45cb4a7e664b396f73c25891da46b953b8b8,1,41,24,65,6,2005-12-01 20:27:22,2005-12-01 18:35:51
0f8f45cb4a7e664b396f73c25891da46b953b8b8...f59846718ed98e153c0423eaa5f7ff0526d2a6f8,1,6,0,6,2,2005-12-01 22:43:54,2005-12-01 21:15:20
f59846718ed98e153c0423eaa5f7ff0526d2a6f8...c639a5548a5d8414b55202592885449f66ee2f33,1,11,2,13,4,2005-12-01 22:54:00,2005-12-01 22:54:00
c639a5548a5d8414b55202592885449f66ee2f33...ce3ca275452cf069eb6451d6f5b0f424a6f046aa,1,1,1,2,1,2005-12-02 01:02:04,2005-12-02 01:02:04
ce3ca275452cf069eb6451d6f5b0f424a6f046aa...10b15b86f545e081aebba8783ad9e9acf6bf0d98,1,12,7,19,2,2005-12-02 01:06:37,2005-12-01 12:48:35
10b15b86f545e081aebba8783ad9e9acf6bf0d98...a6b51f11ab7f7f838a9b17f81059eebfc36e4c84,1,1,1,2,1,2005-12-02 05:39:41,2005-12-02 05:39:41
a6b51f11ab7f7f838a9b17f81059eebfc36e4c84...57ae0d09ed3c4e409bed78b77322fa5e9bad3f3f,1,38,0,38,2,2005-12-02 06:49:52,2005-12-02 06:49:52
57ae0d09ed3c4e409bed78b77322fa5e9bad3f3f...1c2c10b6e6d86066d68635a2a968c7162498ea41,1,7,1,8,1,2005-12-02 09:08:14,2005-12-02 08:50:59
1c2c10b6e6d86066d68635a2a968c7162498ea41...54dd99a127caf4d20e1b91a43949655763d188ed,1,8,0,8,1,2005-12-02 09:08:14,2005-12-02 08:54:50
54dd99a127caf4d20e1b91a43949655763d188ed...3ace1fe34bbf24a62215d06614f9cf29a80def4a,1,6,4,10,1,2005-12-02 09:08:14,2005-12-02 09:05:35
3ace1fe34bbf24a62215d06614f9cf29a80def4a...3f41f5a9fefafabb561db4ce9c9b4e0944ec1f85,1,6,4,10,3,2005-12-02 20:20:34,2005-12-02 11:37:13
3f41f5a9fefafabb561db4ce9c9b4e0944ec1f85...d2abdd2647c6241ec7cced9df9cdd4b98d3d6898,1,7,7,14,1,2005-12-02 20:20:34,2005-12-02 20:15:23
d2abdd2647c6241ec7cced9df9cdd4b98d3d6898...56b5e946f2ba4fd57bbe14f9e3ec2e0ae314d5e6,1,21,1,22,2,2005-12-02 20:20:34,2005-12-02 11:37:13
56b5e946f2ba4fd57bbe14f9e3ec2e0ae314d5e6...4275df517022604f5c33ba05ae45a885b84e3472,1,2,1,3,1,2005-12-03 20:28:52,2005-12-03 10:40:21
4275df517022604f5c33ba05ae45a885b84e3472...d3bfdb755e06c04492ad3977e7df3d780b6e02f2,1,13,0,13,1,2005-12-03 20:28:57,2005-12-03 10:40:39
d3bfdb755e06c04492ad3977e7df3d780b6e02f2...72d1216a04232f5cc85c6b41109db964b55f8289,1,25,0,25,1,2005-12-03 20:29:05,2005-12-03 10:41:20
72d1216a04232f5cc85c6b41109db964b55f8289...7057463463ad01266db264acf7e7b5e95e7b4ecf,1,92,0,92,1,2005-12-03 20:29:07,2005-12-03 10:41:54
7057463463ad01266db264acf7e7b5e95e7b4ecf...e40b61fb6bd2e0ed2dc4799096fcf4c828c28d6d,3,53,9,62,10,2005-12-04 06:25:25,2005-12-02 23:08:28
e40b61fb6bd2e0ed2dc4799096fcf4c828c28d6d...7950571ad75c1c97e5e53626d8342b01b167c790,2,42,18,60,7,2005-12-04 07:07:17,2005-12-04 01:57:48
7950571ad75c1c97e5e53626d8342b01b167c790...d79374c7b58d3814ffdc277de608243f8e665e3a,2,159,58,217,16,2005-12-04 07:17:42,2005-12-03 09:45:57
3d95bf074e8532fd0643b886422eddd0768a3f2c...b52d9f9ba7276b9a9516ba359849f771b354d65b,1,1,1,2,1,2005-11-05 21:08:18,2005-11-05 21:08:18
b52d9f9ba7276b9a9516ba359849f771b354d65b...b748421aaae3fbb8e0e6466ba532bcec1c71e660,1,1,1,2,1,2005-11-06 08:21:45,2005-11-06 08:21:45
b748421aaae3fbb8e0e6466ba532bcec1c71e660...4607166d0735d13e0ee4ffe8df0c2fc899957852,2,33,14,47,6,2005-11-06 08:26:21,2005-11-06 06:26:52
4607166d0735d13e0ee4ffe8df0c2fc899957852...9e5d2b40967059dd5f35d02fba323751ef22ac4e,1,14,0,14,1,2005-11-06 08:26:21,2005-11-06 08:09:59
d53174dbae060153176279f8b4797e3a35421c95...4514385edd913f6c10fa03c828effc5ba974369e,1,1,0,1,1,2005-10-04 02:13:20,2005-10-04 02:05:01
619e5a0ed4a53653085961b7aefe1f93ed879949...0bc458902020b705fa913ca340aa40fea0f87096,1,15,6,21,4,2005-10-04 01:50:06,2005-10-03 04:40:51
0bc458902020b705fa913ca340aa40fea0f87096...f5a5e9b9f4f08544660fd55cd211bdd57c55b32f,1,1,1,2,1,2005-10-04 02:11:32,2005-10-04 02:11:32
99977bd5fdeabbd0608a70e9411c243007ec4ea2...215a7ad1ef790467a4cd3f0dcffbd6e5f04c38f7,160,1023,915,1938,787,2005-09-08 00:45:20,2005-09-08 00:26:23
215a7ad1ef790467a4cd3f0dcffbd6e5f04c38f7...f0ebff0dfebc667e5edf6f67d190fd960513ab66,3,19,3,22,8,2005-09-08 05:08:28,2005-09-05 23:24:03
f0ebff0dfebc667e5edf6f67d190fd960513ab66...a3b427b9fa1fdfd6d0c119d1f9db075ff92ffdf7,2,43,0,43,3,2005-09-08 05:08:30,2005-09-08 02:13:26
a3b427b9fa1fdfd6d0c119d1f9db075ff92ffdf7...6a2e50f9dfdca7ac572bbe30dd0efdf19ca250f6,2,13,2,15,4,2005-09-08 05:08:30,2005-09-08 04:26:52
6a2e50f9dfdca7ac572bbe30dd0efdf19ca250f6...7c3693f1f240e17772c864fad35bc16226038fc8,1,3,1,4,2,2005-09-08 05:08:30,2005-09-08 01:50:01
7c3693f1f240e17772c864fad35bc16226038fc8...35ef3a4c63d6b60cda8f26c842c0efee8d2cb5cc,4,74,28,102,15,2005-09-08 06:04:52,2005-09-08 06:04:52
35ef3a4c63d6b60cda8f26c842c0efee8d2cb5cc...2f0f8b71ee45bcf91c2de480474a26030596fe3c,2,7,5,12,5,2005-09-08 19:15:52,2005-09-08 19:15:52
2f0f8b71ee45bcf91c2de480474a26030596fe3c...bc6146d2abcf3800eb3683cfe972cabd38ff4796,5,33,25,58,14,2005-09-09 01:50:33,2005-09-09 01:50:33
bc6146d2abcf3800eb3683cfe972cabd38ff4796...e8623d45b42f4d379c6258a34ebf96fe840b195c,1,1,1,2,1,2005-09-09 06:16:52,2005-09-09 06:14:33
e8623d45b42f4d379c6258a34ebf96fe840b195c...922fb98e1c1cfed0c5075256f328fd8d01587c61,1,1,1,2,1,2005-09-09 08:17:54,2005-09-09 08:17:54
922fb98e1c1cfed0c5075256f328fd8d01587c61...c87d41ebf7b9312138a7095bcfcb0cf2528ec072,1,5,5,10,1,2005-09-09 16:58:50,2005-09-09 14:11:35
c87d41ebf7b9312138a7095bcfcb0cf2528ec072...96768e3108f76a20699b23f7a1218949144b2394,1,1,1,2,1,2005-09-09 16:59:03,2005-09-09 15:41:15
96768e3108f76a20699b23f7a1218949144b2394...03d98d395a2bb87ad19986a35a8fd0ad46627f7c,1,1,1,2,1,2005-09-09 18:20:54,2005-09-09 18:08:50
03d98d395a2bb87ad19986a35a8fd0ad46627f7c...44ec46a9dff34d0d0d207741094b3a8ebd0e5324,1,45,1,46,25,2005-09-09 18:55:56,2005-09-09 18:55:56
44ec46a9dff34d0d0d207741094b3a8ebd0e5324...a9ab586a5db015d200dfdadcf5876d62f15dd36c,13,16,318,334,20,2005-09-09 21:48:54,2005-09-09 21:48:54
a9ab586a5db015d200dfdadcf5876d62f15dd36c...1f8af483df5ea7070c421489eff40ca8e508b778,2,73,17,90,18,2005-09-09 23:35:53,2005-09-09 22:40:45
1f8af483df5ea7070c421489eff40ca8e508b778...d5e34380afcc98764a10a078b9fe7033795d14b1,1,1,1,2,1,2005-09-10 10:33:33,2005-09-10 09:51:51
d5e34380afcc98764a10a078b9fe7033795d14b1...866ff2f7ce60519e562a6ae37886609c69d5eb70,1,1,0,1,1,2005-09-10 17:40:47,2005-09-10 17:40:47
866ff2f7ce60519e562a6ae37886609c69d5eb70...b779d5f009f8e12df13d650ad8a57e63068a9c82,1,180,4,184,11,2005-09-10 17:44:21,2005-09-10 11:42:24
b779d5f009f8e12df13d650ad8a57e63068a9c82...6bac10d89d0889118a3e747c9c9210fd437c140d,2,39,5,44,7,2005-09-10 19:42:32,2005-09-10 19:42:32
6bac10d89d0889118a3e747c9c9210fd437c140d...e204de28e69617265e88c73dd13c416ffa15f355,1,47,3,50,7,2005-09-10 22:18:31,2005-09-10 22:18:31
e204de28e69617265e88c73dd13c416ffa15f355...b595ed1478e6240593df4c927c4a240575f53d44,1,11,1,12,2,2005-09-10 22:23:09,2005-09-10 22:23:09
b595ed1478e6240593df4c927c4a240575f53d44...c9d023b2a63ef233c63e1b8f95aabac74362719d,1,1,1,2,1,2005-09-11 01:27:20,2005-09-11 01:24:46
c9d023b2a63ef233c63e1b8f95aabac74362719d...77675e2aff434cb1f0e62540ae42f5716a5a778d,2,24,0,24,3,2005-09-11 01:27:40,2005-09-05 06:03:51
77675e2aff434cb1f0e62540ae42f5716a5a778d...680bab3d9a33029be38590681832ae9b6d74ad60,2,14,0,14,2,2005-09-11 01:27:40,2005-09-05 06:04:18
680bab3d9a33029be38590681832ae9b6d74ad60...ee6566e8d70da682ac4926dd8a67ac821b2c1743,2,421,804,1225,57,2005-09-11 01:27:41,2005-09-05 06:04:48
ee6566e8d70da682ac4926dd8a67ac821b2c1743...3d89cb4f3f5333d5eb5899352566ad071dbd0d0c,1,92,0,92,1,2005-09-11 01:27:41,2005-09-05 06:05:17
3d89cb4f3f5333d5eb5899352566ad071dbd0d0c...2ab706a38fbe6f4adb2fd09806a5d5faf33d355f,1,10,3,13,9,2005-09-11 01:27:42,2005-09-05 08:13:36
2ab706a38fbe6f4adb2fd09806a5d5faf33d355f...4d3fe0c5f342d0b00209916cf6951c2f8db414d2,2,44,8,52,12,2005-09-11 01:27:42,2005-09-06 19:53:56
4d3fe0c5f342d0b00209916cf6951c2f8db414d2...bb97a2a804e0afdd686ed9f18fed2ddc15833540,1,1,0,1,1,2005-09-11 01:27:42,2005-09-11 01:14:14
bb97a2a804e0afdd686ed9f18fed2ddc15833540...91063bbc6c4187184e94ebc4ab2b807e6d53cd0a,5,381,2,383,5,2005-09-11 01:30:41,2005-09-08 20:47:12
91063bbc6c4187184e94ebc4ab2b807e6d53cd0a...2276aa6c098a0337bc2bec49742e332bdd1b802c,4,88,39,127,8,2005-09-11 01:30:41,2005-09-11 00:56:19
2276aa6c098a0337bc2bec49742e332bdd1b802c...0f69be537618036c45bc07919248b88afbf7af3e,2,55,0,55,2,2005-09-11 01:30:42,2005-09-09 08:15:47
0f69be537618036c45bc07919248b88afbf7af3e...720d150c48fc35fca13c6dfb3c76d60e4ee83b87,9,741,7,748,20,2005-09-11 02:46:53,2005-09-11 00:46:27
3857284f7b892f855edffc5b9c196a0dd74b1b7d...8572aa85a7f1e9377f44b816788ced4306cf427b,1,2,2,4,1,2005-08-25 05:46:07,2005-08-25 05:46:07
3459c2c433ac46eac596810d2ef2c3d4ef949852...8d0991d7d7d7e68ef39fe8d302f43110ef2c65d1,3,18,4,22,5,2005-08-30 05:38:12,2005-08-30 05:38:12
feb28ad0a87198b8ac0f2060dcfc8698bb1a67cf...16168986eb5924f21e52de61cf5703b840872c91,1,8,8,16,8,2014-01-21 23:50:27,2014-01-21 23:16:38
16168986eb5924f21e52de61cf5703b840872c91...a8d8e382a95b8412b105ca12fcdad2dff521827f,1,17,0,17,1,2014-01-21 23:50:27,2014-01-21 23:16:39
a8d8e382a95b8412b105ca12fcdad2dff521827f...40f846c35c504a1c2303be5dcca6db069a17b856,2,74,1,75,2,2014-01-22 16:05:04,2014-01-21 23:16:40
40f846c35c504a1c2303be5dcca6db069a17b856...630c4f19f0d4f4c6a485af944d88665979fa0e1f,1,27,0,27,1,2014-01-22 16:05:26,2014-01-21 23:16:41
630c4f19f0d4f4c6a485af944d88665979fa0e1f...0577849d2b2bf21b0faedd30938d663389db7926,1,1,1,2,1,2014-01-22 16:05:26,2014-01-21 23:16:42
0577849d2b2bf21b0faedd30938d663389db7926...0055b56e10f77b1b5f5521b8ba3614f962a09288,2,28,25,53,17,2014-01-22 16:05:27,2014-01-21 23:16:43
0055b56e10f77b1b5f5521b8ba3614f962a09288...0cf1b72a38e6190a7e614bbc53fbb81704a3d4af,3,12,4,16,5,2014-01-22 16:06:19,2014-01-21 23:16:44
0cf1b72a38e6190a7e614bbc53fbb81704a3d4af...79467e61aa30342d7fb17232624ec5ade4cbbe6a,2,25,2,27,2,2014-01-22 16:06:19,2014-01-21 23:16:45
79467e61aa30342d7fb17232624ec5ade4cbbe6a...2000544330d5b047074d8043042f7cc66157f8f5,1,1,1,2,1,2014-01-22 16:06:19,2014-01-21 23:16:46
2000544330d5b047074d8043042f7cc66157f8f5...3d5388afa856fde3efff023f5b672005834e7ca1,1,145,0,145,1,2014-01-22 16:06:19,2014-01-21 23:16:47
3d5388afa856fde3efff023f5b672005834e7ca1...f84cb684634f50df7adde7f52c25f049d257f0e3,1,4,2,6,2,2014-01-22 16:06:20,2014-01-21 23:16:48
becb4336cb05c5ec456babaeafefa2e24ee85773...5c1d2e8af99c1cf24a38fe830d96a4aedce30e2b,1,1,1,2,1,2013-11-27 20:09:50,2013-11-18 04:12:42
becb4336cb05c5ec456babaeafefa2e24ee85773...109efbe4f24b1748f42af52ca6d528b2d7ffe048,1,1,1,2,1,2013-11-22 23:30:51,2013-11-21 15:19:03
becb4336cb05c5ec456babaeafefa2e24ee85773...b039718d925475124cb431a05f5933bd191bae27,19,0,143,143,6,2013-11-21 19:43:42,2013-11-21 11:48:37
becb4336cb05c5ec456babaeafefa2e24ee85773...0b7e4e0da4cf311d106fdc27e9eb46a73d0731c4,1,5,5,10,4,2013-11-20 23:18:39,2013-11-20 01:34:40
d2446dfd7f3b3f8948142cfb07a0270e2497d93f...4616918013bf4fb3ce61175702d963a1fdd87f84,1,6,4,10,3,2014-12-17 18:57:53,2014-11-24 18:36:51
4616918013bf4fb3ce61175702d963a1fdd87f84...96b50cc19003d54f5962d65597c94e2c52eb22e7,1,32,0,32,1,2014-12-17 19:00:37,2014-11-24 18:37:56
96b50cc19003d54f5962d65597c94e2c52eb22e7...cc2fc7c2f07c4a2aba5a653137ac9b489e05df43,2,4,2,6,3,2014-12-17 19:04:31,2014-11-24 18:39:12
cc2fc7c2f07c4a2aba5a653137ac9b489e05df43...450870cba7a9bac94b5527021800bd8bf037c99c,1,27,30,57,1,2014-12-17 19:04:39,2014-11-24 18:40:11
450870cba7a9bac94b5527021800bd8bf037c99c...76e86fc6e3523d28e8db00e7b10c33c553d996b8,2,2,1,3,2,2014-12-17 19:04:39,2014-11-24 18:40:44
76e86fc6e3523d28e8db00e7b10c33c553d996b8...6162a1d323d24fd8cbbb1a6145a91fb849b2568f,2,72,0,72,2,2014-12-17 19:04:39,2014-12-15 22:56:59
6162a1d323d24fd8cbbb1a6145a91fb849b2568f...a42643aa8d88a2278acad2da6bc702e426476e9b,8,45,5,50,13,2014-12-17 19:04:44,2014-12-15 23:15:20
a42643aa8d88a2278acad2da6bc702e426476e9b...a18fcc9ff22b714e7df30c400c05542f52830eb0,2,7,4,11,6,2014-12-17 19:04:45,2014-12-15 23:21:57
a18fcc9ff22b714e7df30c400c05542f52830eb0...1d1d69bc52dcc7def5b2edbd165cc0a4e3911c8e,2,34,0,34,2,2014-12-17 19:04:45,2014-12-16 22:31:03
1d1d69bc52dcc7def5b2edbd165cc0a4e3911c8e...2b4c6efc82119ba8f4169717473d95d1a89e4c69,7,34,0,34,10,2014-12-17 19:04:45,2014-12-16 22:46:59
2b4c6efc82119ba8f4169717473d95d1a89e4c69...d08c13b947335cc48ecc1a8453d97b7147c2d6d6,2,9,3,12,4,2014-12-17 19:04:45,2014-12-10 21:28:27
d2446dfd7f3b3f8948142cfb07a0270e2497d93f...51be46ec4d0b64c1deb60a4814bcd24b6b478eeb,2,77,1,78,2,2014-03-25 19:05:24,2014-03-21 11:36:36
d2446dfd7f3b3f8948142cfb07a0270e2497d93f...a43219f2aaa39fbc53ba0aee2481e1cca3c0e649,1,11,6,17,5,2014-01-28 22:10:06,2014-01-28 21:21:00
d2446dfd7f3b3f8948142cfb07a0270e2497d93f...1c3e0f007c8c18dd4ceda3c67cbfb8e01ef2c894,2,23,13,36,12,2014-01-13 22:37:52,2013-11-27 18:34:09
d2446dfd7f3b3f8948142cfb07a0270e2497d93f...ed7eda8b38ec6230abf79986668ccb6e2e2c7494,1,1,1,2,1,2014-01-03 00:15:29,2013-12-31 12:07:39
d2446dfd7f3b3f8948142cfb07a0270e2497d93f...afbf5ca507470aab6716671f2ad207c74cd585fb,6,26,17,43,17,2014-01-02 18:25:03,2014-01-02 07:38:35
d2446dfd7f3b3f8948142cfb07a0270e2497d93f...e1c1a324fc7061c8f170a113709724f1640addb3,1,2,1,3,2,2014-01-02 18:21:40,2014-01-02 03:03:30
d2446dfd7f3b3f8948142cfb07a0270e2497d93f...92164af978c8cb180c8d9ba9487e0ddddb15fb77,2,8,1,9,2,2014-01-02 18:19:14,2013-12-31 14:36:45
d2446dfd7f3b3f8948142cfb07a0270e2497d93f...64ed07cee0394509c65331f1e7acb36c58fd18fb,2,20,1,21,2,2013-12-26 18:46:26,2013-12-23 09:02:41
d2446dfd7f3b3f8948142cfb07a0270e2497d93f...470faf96544c1844ad775c695dfa370fe0ef3756,3,51,47,98,9,2013-12-12 20:23:02,2013-12-11 09:58:42
470faf96544c1844ad775c695dfa370fe0ef3756...6df5762db354ca55a0cf77451d06b332b7de0b82,3,42,2,44,4,2013-12-12 20:23:02,2013-12-11 09:58:43
6df5762db354ca55a0cf77451d06b332b7de0b82...8a19dfa1aa5bbbc6e3ea8553e418ad4f78448cb3,1,11,0,11,1,2013-12-16 21:12:33,2013-12-16 20:19:23
8a19dfa1aa5bbbc6e3ea8553e418ad4f78448cb3...aad90e85f8e6368533aa30c072b8e2bd7adafa53,1,17,18,35,3,2013-12-16 21:13:05,2013-12-16 20:19:24
d2446dfd7f3b3f8948142cfb07a0270e2497d93f...ffe68cf9acf1127078b0dfa0b09661ce52916642,2,3,3,6,3,2013-12-12 19:53:48,2013-12-11 07:46:04
ffe68cf9acf1127078b0dfa0b09661ce52916642...500a04f196d90ef3a426ff63f76b44df479efc7d,1,0,3,3,1,2013-12-12 19:53:48,2013-12-11 07:46:05
500a04f196d90ef3a426ff63f76b44df479efc7d...bf93eea0f67082ec295ac60fa78986f339adf2c6,2,7,2,9,2,2013-12-12 19:53:48,2013-12-11 07:46:06
bf93eea0f67082ec295ac60fa78986f339adf2c6...de7b5d6218e4b928c5a395e34e5e1de40fae2a0d,4,6,6,12,6,2013-12-12 19:53:48,2013-12-11 07:46:07
de7b5d6218e4b928c5a395e34e5e1de40fae2a0d...303c5d65c972de2e9d0821647b06ab595c21d355,1,5,0,5,1,2013-12-12 19:53:49,2013-12-11 07:46:08
303c5d65c972de2e9d0821647b06ab595c21d355...1f7117ef7a39ff359a964e681f360f50d7a1c8f2,2,8,7,15,7,2013-12-12 19:53:49,2013-12-11 07:46:09
1f7117ef7a39ff359a964e681f360f50d7a1c8f2...44f9f850e8ee6e2824ceb1855d836d484340edf7,1,54,7,61,13,2013-12-12 19:53:49,2013-12-11 07:46:10
44f9f850e8ee6e2824ceb1855d836d484340edf7...bbbb4afc26cd3d711e07a345d1e5f9eedc68100f,1,37,0,37,1,2013-12-12 19:53:49,2013-12-11 07:46:11
bbbb4afc26cd3d711e07a345d1e5f9eedc68100f...769a4fa463bb36ba78eb318f25e0e211f4fae949,2,3,1,4,2,2013-12-12 19:53:49,2013-12-11 07:46:12
769a4fa463bb36ba78eb318f25e0e211f4fae949...34a332221c581585ad06ed43eff12fb7e675cc1d,1,18,1,19,2,2013-12-12 19:53:49,2013-12-11 07:46:13
34a332221c581585ad06ed43eff12fb7e675cc1d...663a8566beb5387530641abe71a8d8b2dafd08b3,3,18,14,32,12,2013-12-30 20:33:11,2013-12-28 11:00:05
d2446dfd7f3b3f8948142cfb07a0270e2497d93f...370c9268d13ef54a05ed84b92baa81b75930e58f,1,11,10,21,7,2013-12-12 19:27:21,2013-12-11 23:01:42
370c9268d13ef54a05ed84b92baa81b75930e58f...6554dfa97af92a159231d94e60403bfe0d6e8e61,2,32,1,33,4,2013-12-12 19:31:25,2013-12-11 23:15:50
d2446dfd7f3b3f8948142cfb07a0270e2497d93f...75f8cbab2a2ddc50728ade82baad223ed54bb040,1,0,6,6,1,2013-12-11 00:14:15,2013-12-05 13:02:28
75f8cbab2a2ddc50728ade82baad223ed54bb040...13eb4626c43b3116bb431671d593565eadc36852,6,14,22,36,16,2013-12-11 00:14:15,2013-12-05 13:02:29
13eb4626c43b3116bb431671d593565eadc36852...0b854bcc2a3b34c09835393234cd807fde08722f,1,3,0,3,1,2013-12-11 00:14:16,2013-12-05 13:02:30
0b854bcc2a3b34c09835393234cd807fde08722f...606e435a0a11634744282068174240caf2926fec,1,6,0,6,1,2013-12-11 00:14:16,2013-12-05 13:02:31
606e435a0a11634744282068174240caf2926fec...ad491366de6c883cd04539cb86db31049201dfbd,5,26,3,29,8,2013-12-11 00:14:16,2013-12-05 13:02:32
ad491366de6c883cd04539cb86db31049201dfbd...b06dcd7d6829c86afda6b311cadf009ee4b4dd59,6,20,8,28,9,2013-12-11 00:14:16,2013-12-05 13:02:33
b06dcd7d6829c86afda6b311cadf009ee4b4dd59...1a30f5a2f2a3d5d9b3cf6e126ac19deb40324515,4,24,11,35,12,2013-12-11 00:14:16,2013-12-05 13:02:34
1a30f5a2f2a3d5d9b3cf6e126ac19deb40324515...58babfffdeeecaa4d6edecaac1fb0c595218b801,4,90,1,91,6,2013-12-11 00:14:16,2013-12-05 13:02:35
58babfffdeeecaa4d6edecaac1fb0c595218b801...8e277383e0902551c0d5d3ef9591196de5a7078c,2,297,0,297,2,2013-12-11 00:14:16,2013-12-05 13:02:36
8e277383e0902551c0d5d3ef9591196de5a7078c...a796ccee5198c6ae11dd73c837f3ec46aaa1e8bf,1,13,9,22,2,2013-12-11 00:14:16,2013-12-05 13:02:37
a796ccee5198c6ae11dd73c837f3ec46aaa1e8bf...f6486f07d25ab4f2f93483690acabb817b0729b8,1,12,12,24,1,2013-12-11 00:14:17,2013-12-05 13:02:38
f6486f07d25ab4f2f93483690acabb817b0729b8...beea4152d94cf7c77eeb6b226805b315d22b3a2f,6,71,7,78,21,2013-12-11 00:14:17,2013-12-05 13:02:39
beea4152d94cf7c77eeb6b226805b315d22b3a2f...4820a33baa963c4559736d7a1c4c35f8dcb37293,5,176,5,181,13,2013-12-11 00:14:17,2013-12-05 13:02:40
4820a33baa963c4559736d7a1c4c35f8dcb37293...79d3a236c551ad59719a6835bee03a1446296e65,4,28,4,32,5,2013-12-11 00:14:17,2013-12-05 13:02:41
79d3a236c551ad59719a6835bee03a1446296e65...48d25cae22667dfc2c31ad620172c0f0a3ac1490,7,79,1,80,11,2013-12-11 00:14:17,2013-12-05 13:02:42
48d25cae22667dfc2c31ad620172c0f0a3ac1490...31c42bff35ffc0a99ca77947389749d1397e1079,1,31,41,72,15,2013-12-11 00:14:17,2013-12-05 13:02:43
31c42bff35ffc0a99ca77947389749d1397e1079...5dbd767601812209273ae007a97b7c9305dc6cfd,5,146,11,157,20,2013-12-11 00:14:17,2013-12-05 13:02:44
5dbd767601812209273ae007a97b7c9305dc6cfd...069c053222bfc62a6522430a137e9b2c7ff36e4c,5,12,3,15,9,2013-12-11 00:14:17,2013-12-05 13:02:45
069c053222bfc62a6522430a137e9b2c7ff36e4c...614db3e2920f4d1c79931833614acf36a00fa88b,2,36,8,44,7,2013-12-11 00:14:18,2013-12-05 13:02:46
614db3e2920f4d1c79931833614acf36a00fa88b...0a1bc12b6e401825f009ac8bb14fc438f77e2d9f,5,201,13,214,27,2013-12-11 00:14:18,2013-12-05 13:02:47
0a1bc12b6e401825f009ac8bb14fc438f77e2d9f...b016918b2f283513758957b06a14eb2f5c2a9619,3,43,4,47,5,2013-12-11 00:14:18,2013-12-05 13:02:48
b016918b2f283513758957b06a14eb2f5c2a9619...58f2ed051fe9b966100d8c531a79200628490ec4,2,9,1,10,2,2013-12-11 00:14:18,2013-12-05 13:02:49
58f2ed051fe9b966100d8c531a79200628490ec4...16094885ca94f72abc28a915f9aa4021e203a16d,6,81,9,90,17,2013-12-11 00:14:18,2013-12-05 13:02:50
16094885ca94f72abc28a915f9aa4021e203a16d...c29a7b8b3f71c1bede1f57626bafe120280aaea3,2,35,3,38,3,2013-12-11 00:14:18,2013-12-05 13:02:51
c29a7b8b3f71c1bede1f57626bafe120280aaea3...f2c681cf12c54ce3859b36693f8a13c36126577b,3,42,5,47,5,2013-12-11 00:14:18,2013-12-05 13:02:52
f2c681cf12c54ce3859b36693f8a13c36126577b...0d7d285f0e29abb994fe32db87ee81b00f403bd2,2,16,2,18,2,2013-12-11 00:14:18,2013-12-05 13:02:53
0d7d285f0e29abb994fe32db87ee81b00f403bd2...eab3296c7e5c99f559818357e70eeae09c24ac99,6,71,2,73,12,2013-12-11 00:14:19,2013-12-05 13:02:54
eab3296c7e5c99f559818357e70eeae09c24ac99...82fba2b9d39163a0c9b7a3a2f35964cbc039e1aa,1,1,6,7,1,2013-12-11 00:14:19,2013-12-05 13:02:55
82fba2b9d39163a0c9b7a3a2f35964cbc039e1aa...16a2743cd08c74d71b17e663c05c878fddffa03c,1,1,1,2,1,2014-01-06 16:26:36,2014-01-05 23:55:01
16a2743cd08c74d71b17e663c05c878fddffa03c...feefdf62c107fd63056becf547ea324dbb730e30,4,0,20,20,4,2014-01-06 17:05:40,2014-01-06 00:00:58
feefdf62c107fd63056becf547ea324dbb730e30...3b32a7ca90b9c63f2306feb2a66b62b94c1a640f,1,2,1,3,2,2014-01-09 19:54:12,2014-01-08 12:13:19
d2446dfd7f3b3f8948142cfb07a0270e2497d93f...212c0a6ff2993530a1dadee9dfbbce9dc350b1d1,1,4,7,11,3,2013-12-09 19:24:16,2013-12-07 05:02:53
d2446dfd7f3b3f8948142cfb07a0270e2497d93f...ee7fb0b1d433cbb433d2ed5cd9d8738023836b27,5,43,4,47,9,2013-12-06 22:00:27,2013-12-05 23:38:46
ee7fb0b1d433cbb433d2ed5cd9d8738023836b27...0ea7d5b6f8e258fdec067edf1b136ed87c5670e5,1,2,2,4,2,2013-12-16 21:04:47,2013-12-16 20:02:21
5fd09df3937f54c5cfda4f1087f5d99433cce527...746be68d31b87422b89ac91ffb7699ab3f39f70f,1,3,3,6,2,2013-11-21 18:33:40,2013-11-21 06:44:20
c6f1b920ac8b41b9175910d5866924a12a0ce6b9...1a72cfd7fa88e5a6c2b94568ac2fe69dfbd87f87,4,58,9,67,10,2013-12-05 22:39:11,2013-12-05 19:44:14
dd1cec578dc626f4e1bef1aa09c00984dae5f482...077f43447c4931dd2e7890f16e8728f7f7376b87,3,135,2,137,3,2013-12-06 19:20:04,2013-12-06 19:20:04
d73f640fcb49e4850e67440ba448a7c758bc0926...34875f4a53b9e495622553a671776f66dc37eb2b,1,42,32,74,8,2012-05-02 21:38:43,2012-05-02 21:11:36
34875f4a53b9e495622553a671776f66dc37eb2b...9a7b0bca366d8d9b3b26f1bb1a75885780c0f0e4,1,2,2,4,1,2012-05-03 07:05:01,2012-05-02 23:43:52
28de297ffeb0d6357118e384f8d943f4a41e75ac...f65ed83c7e272929da3e73f2bb30947704d0a76c,1,54,46,100,15,2012-09-30 06:25:09,2012-09-30 05:50:53
34a4ae55b260bbd1520d6a7c6718b4de2d5c7632...727b6fc3edacebcde0a3dc849af95bd7f5a4d4a1,2,14,0,14,4,2012-10-10 06:21:30,2012-10-03 22:01:34
727b6fc3edacebcde0a3dc849af95bd7f5a4d4a1...0657bcbf6f0830bc4ce25d05060706f35f1d4eb7,1,7,1,8,6,2012-10-10 06:21:30,2012-10-09 23:49:57
dc01f880a53e56d4a5c6f30cb2d7b9412e17bfe7...62e0069056ed11294c29bae25df69b6518f6339e,3,67,1,68,8,2012-10-10 07:33:40,2012-10-09 23:02:56
62e0069056ed11294c29bae25df69b6518f6339e...4a47a4ddec0d4d37e81ad63385ca287abfe90f9b,2,18,4,22,4,2012-10-25 10:00:07,2012-10-22 12:41:48
4a47a4ddec0d4d37e81ad63385ca287abfe90f9b...5637d8573206e8c3d99abacb6b6ca3cf11816202,2,19,1,20,2,2012-10-25 10:04:38,2012-10-24 08:03:35
5637d8573206e8c3d99abacb6b6ca3cf11816202...ce5478006c7318f12e6b2abeb0c0477009db63b5,1,19,6,25,3,2012-10-25 10:05:35,2012-10-24 21:08:26
ce5478006c7318f12e6b2abeb0c0477009db63b5...ce1459f740a591c63697ff6ff3c106123630539c,1,1,1,2,1,2012-10-25 10:06:00,2012-10-24 21:28:29
9306b5b9a33185e7867202718162d8a38d5627ab...34a166439a49172d2fe970c227ce93c0b683b56b,1,475,473,948,426,2012-10-17 01:15:28,2012-10-17 01:15:28
9306b5b9a33185e7867202718162d8a38d5627ab...8f69cccbe43707353b885b04aaa6c8b3d7ca13a9,1,438,441,879,397,2012-10-16 07:38:11,2012-10-16 07:38:11
86bdfa395559b8d99fbec9b8366524aaa311399b...652398a88e7c3d18b6820a2ae369b05d26dc757f,1,9,0,9,3,2012-09-25 17:44:32,2012-09-25 17:44:32
e18872b2f0fba4cb860c9350bb8b8d8680dfc83b...de9658b511377e9eaa2c58a8c3885a1a01b94be8,2,13,1,14,2,2012-06-15 22:00:04,2012-06-15 21:50:30
e18872b2f0fba4cb860c9350bb8b8d8680dfc83b...352ca4e105e6fb37cad97b80f2640d28b133ca9d,1,5,2,7,4,2012-05-02 04:29:03,2012-05-01 17:10:15
352ca4e105e6fb37cad97b80f2640d28b133ca9d...9380aed286df31dcb31fd6ae467b69471c8cf148,1,1,1,2,1,2012-05-02 16:46:41,2012-05-02 07:36:44
4133fd25525022f99d2c7ba339618433bdd919fe...b4ee10f60fb46e0305968023c1ab0f072535b630,1,3,2,5,3,2010-08-06 22:30:16,2010-08-06 21:19:44
4133fd25525022f99d2c7ba339618433bdd919fe...ed0cb46ebb020234da94a843ca341dde8e9e3911,1,3,2,5,1,2010-02-14 21:21:31,2010-02-14 15:44:41
ed0cb46ebb020234da94a843ca341dde8e9e3911...d06f15d9c0c2b072e5eebf87fa93ee9a899ed642,2,9,4,13,4,2010-02-14 21:21:39,2010-02-14 15:44:42
d06f15d9c0c2b072e5eebf87fa93ee9a899ed642...4bb43de25977063187dedf054122985bc5a2660e,3,8,7,15,3,2010-02-16 16:54:34,2010-02-16 05:22:08
4bb43de25977063187dedf054122985bc5a2660e...72ec8ba6dddbe2c53500d35d7ed343c153874fc6,1,10,7,17,7,2010-02-16 16:55:56,2010-02-14 15:44:44
72ec8ba6dddbe2c53500d35d7ed343c153874fc6...3719b2fe554adc2f7a34a16b90f6894f299aab3c,3,301,0,301,3,2010-02-16 16:55:56,2010-02-14 15:44:45
4133fd25525022f99d2c7ba339618433bdd919fe...5da81713703583e795a4faa6a79074b53edb5a9a,1,1,1,2,1,2010-02-12 06:12:36,2010-02-12 02:46:22
b62cb17a65b180c0ee6e48ee3f7395c52b2e5ea1...8e52dc30fc357755985306f2faae4fcfd038e0f3,1,1,1,2,1,2010-01-28 08:58:17,2010-01-28 08:52:18
8e52dc30fc357755985306f2faae4fcfd038e0f3...af86debc8620006702ef217d5b7687b300c75104,1,1,1,2,1,2010-01-28 17:30:14,2010-01-28 14:52:16
af86debc8620006702ef217d5b7687b300c75104...42cab601cfd0364c57434f90c6ba66a1ccb179ec,1,51,0,51,1,2010-01-28 20:12:36,2010-01-28 09:50:20
42cab601cfd0364c57434f90c6ba66a1ccb179ec...d46a8301930ae83de30fbbbbce1bb02a98745204,2,24,4,28,2,2010-01-28 20:12:42,2010-01-28 09:52:22
d46a8301930ae83de30fbbbbce1bb02a98745204...12a258c078da3481a5735a7dca00bbe75cd4713b,2,5,1,6,2,2010-01-28 20:12:50,2010-01-28 09:56:43
12a258c078da3481a5735a7dca00bbe75cd4713b...4ff61c21de519b4b3c9569b354fa5a3905b69c6a,3,15,2,17,4,2010-01-28 20:33:42,2010-01-28 20:33:42
4ff61c21de519b4b3c9569b354fa5a3905b69c6a...00f09d0e4b1826ee0519ea64e919515032966450,1,19,0,19,2,2010-01-28 22:22:37,2010-01-28 01:05:55
9981c808b4b9307d58cedddd17689c2313a0d34a...ad12b81271d76f3e4a8b1f527e252ac8452732fd,3,62,2,64,3,2009-10-17 07:11:43,2009-10-17 07:11:43
63d129d93e756dd88f0db9bf6d56e8a7e41aea5d...a8c9bef4e0b87e596f37ec238991b447c739dee9,1,12,4,16,3,2009-10-09 18:22:43,2009-10-05 19:35:16
a8c9bef4e0b87e596f37ec238991b447c739dee9...162213d2329d5e87f9b74ed8153ce7008788d213,1,5,1,6,1,2009-10-09 21:38:14,2009-10-09 10:15:29
162213d2329d5e87f9b74ed8153ce7008788d213...0f8a02c640397ce22080e1c2eaa5029388638589,2,6,5,11,2,2009-10-09 21:40:25,2009-10-09 10:16:15
0f8a02c640397ce22080e1c2eaa5029388638589...25dcc0d64b9f3c11abcd0f53a9b9cdb6092ed646,2,3,3,6,2,2009-10-09 21:43:04,2009-10-09 18:51:14
25dcc0d64b9f3c11abcd0f53a9b9cdb6092ed646...58d2c961b310d9366dd193f2d95d7eae56edecec,1,6,4,10,2,2009-10-09 21:50:21,2009-10-09 10:18:58
58d2c961b310d9366dd193f2d95d7eae56edecec...bb35f35e67ed2fdfce1892cc9d55827b90fcb775,1,8,8,16,3,2009-10-09 21:54:15,2009-10-09 18:34:08
bb35f35e67ed2fdfce1892cc9d55827b90fcb775...580cbb58a29ee3ebc3714f4792d34f958fd86165,1,3,3,6,1,2009-10-09 21:54:55,2009-10-09 10:20:19
580cbb58a29ee3ebc3714f4792d34f958fd86165...989c530e7f7f85db7fb5a340319cca88ca702b2a,1,6,4,10,1,2009-10-09 21:56:32,2009-10-09 10:25:54
989c530e7f7f85db7fb5a340319cca88ca702b2a...b6aaaa4470ef578add390bb60292ed9b4cb4af3c,1,1,1,2,1,2009-10-09 21:58:13,2009-10-09 12:08:31
b6aaaa4470ef578add390bb60292ed9b4cb4af3c...427e586b197c94961b548c8a25ed721651fc335e,1,1,1,2,1,2009-10-09 22:00:24,2009-10-09 06:21:43
427e586b197c94961b548c8a25ed721651fc335e...e0d78059540aab2e6ff720e7c940d7244cc12c18,1,6,2,8,1,2009-10-09 22:00:40,2009-10-09 06:21:44
e0d78059540aab2e6ff720e7c940d7244cc12c18...e1c1a0674b5848eb3207a29d5513c9112c72d10c,1,6,0,6,2,2009-10-09 22:36:41,2009-10-09 20:49:06
0984e3a77246c536f938f53ecded99533fb31667...a16753dc2e6f885fd30e570610c3e8cf355ecf04,1,1,2,3,1,2009-09-21 07:36:12,2009-09-21 07:34:58
ba7e81430a32614982172c7064c01db43f55b4bb...204d363f5a05bba0bdeb13f96a08d5078dcee820,3,28,0,28,3,2009-10-22 19:59:50,2009-10-22 08:19:06
ba7e81430a32614982172c7064c01db43f55b4bb...fe0a3cb23c7930be419937825591388465ceb47f,1,2,2,4,1,2009-10-15 06:47:03,2009-10-14 18:51:03
f287c65b265e8c676e65ade4ecb2d3a0243411fa...ff6d26a0e1d8fad775010fa3b689c0c027da8bb0,1,38,1,39,5,2010-01-18 00:47:48,2010-01-18 00:47:48
e21a8577089cb10fed5f298796ba3685010dfaef...907a0b1e04ea31cb368e9422df93d8ebb0187914,1,1,1,2,1,2009-12-03 18:07:17,2009-12-03 17:52:46
907a0b1e04ea31cb368e9422df93d8ebb0187914...488bdf2ebe6e99fb30ad958a710b0b3f737b4d0f,2,174,0,174,2,2009-12-03 18:10:35,2009-12-03 03:53:54
1cd749cc0722533bd1849f491ec9ab19e17232e1...02461e0e2833753151ed71899f075c94e5fc495b,2,78,22,100,22,2009-10-10 00:02:21,2009-10-08 17:03:26
1cd749cc0722533bd1849f491ec9ab19e17232e1...ac78b009398f8cab1f57d1ef62db21ac95e11ed1,1,2,5,7,1,2009-10-09 05:54:34,2009-10-09 01:53:35
1cd749cc0722533bd1849f491ec9ab19e17232e1...ebfbdb340ad9a1b6fbaf91464f0fd86643fdcb46,2,16,3,19,4,2009-10-09 05:17:07,2009-10-08 16:46:54
a7aebb9d00332364411e85c703cc25dc0580f2d4...4973aa2286110fcedc0e8ff0da57c10509fb1a65,1,1,8,9,1,2009-10-05 19:03:25,2009-10-05 19:03:25
4973aa2286110fcedc0e8ff0da57c10509fb1a65...f73b3af3f047bcc503e8860c2075052309627e60,1,1,1,2,1,2009-10-07 19:47:24,2009-10-07 12:14:24
a7aebb9d00332364411e85c703cc25dc0580f2d4...9fa708dab1ccf8be69a606ca4eb58e62f3ef334a,3,70,2,72,4,2009-10-05 06:43:32,2009-10-05 06:43:32
90e431152e05d3e8eb80a0db2e81b7cf50ecc745...59b8d38f6e4f19b93c5dc4493ab11706acd101b5,1,0,11,11,1,2009-09-11 08:45:36,2009-09-09 12:33:50
304b7d99a705e8c125650dda347a571402222a3e...25ae7cfd19c8f21721363c64163cd5d9d1135b20,1,8,1,9,2,2012-09-20 16:52:36,2012-09-20 02:15:15
304b7d99a705e8c125650dda347a571402222a3e...dd4f30756150c921ce9acc7b3d0970ff5a6e1158,1,3,2,5,3,2012-09-19 23:35:10,2012-09-19 17:06:37
304b7d99a705e8c125650dda347a571402222a3e...bc40deabbce2fec844c57bf933143babe549bce3,1,2,1,3,1,2012-09-19 04:47:12,2012-09-18 23:25:28
bc40deabbce2fec844c57bf933143babe549bce3...3f8c5a41f10ac35ac362d6e2f125b559d580d3e7,1,18,12,30,1,2012-09-19 04:47:45,2012-09-18 23:25:31
3f8c5a41f10ac35ac362d6e2f125b559d580d3e7...a73d379063dcb8f86065fdacad95e285830e13ef,1,1,1,2,1,2012-09-19 04:49:46,2012-09-18 23:25:32
a73d379063dcb8f86065fdacad95e285830e13ef...068c6745fe1c414e9a611eee4f991c6c9c6e0307,1,4,0,4,1,2012-09-19 04:49:50,2012-09-18 23:25:33
068c6745fe1c414e9a611eee4f991c6c9c6e0307...f0970faa9627c17fc6065bdef136391e82b3055e,1,3,1,4,2,2012-09-19 17:22:49,2012-09-18 23:25:34
302bd999fd0ef41f3605a2212c23f54ae43649f8...7be8b3baba863ae5297aedbc3635d6f4a3336838,7,14,14,28,13,2011-06-16 17:33:50,2011-06-16 13:42:48
15ffb7cde48b73b3d5ce259443db7d2e0ba13750...ad6a599c0a98441e3da0aaeb44bd39a167cb0693,1,8,8,16,8,2012-07-30 17:52:29,2012-07-30 17:51:52
15ffb7cde48b73b3d5ce259443db7d2e0ba13750...877449c136539cf8b9b4ed9cfe33a796b7b93f93,1,8,9,17,5,2011-06-13 19:18:29,2011-06-13 19:17:52
e4ae6efb78ca7d2ff16575f841b1781b96a7582c...2de58b398b5a1f81bf74a385e41cfc2fcd9cb427,1,16,30,46,8,2011-05-13 18:14:07,2011-05-13 18:14:07
4ecbc65fa7decb2aa271d68d54e8563a679e6ec1...2df3299d860feb55c1caa8487238851c0f4622aa,1,1,0,1,1,2010-01-06 20:22:25,2010-01-06 20:22:25
4ecbc65fa7decb2aa271d68d54e8563a679e6ec1...31838b4dcd27961b13e46ffd126233b208a29530,1,2,2,4,2,2010-01-06 09:33:02,2010-01-06 08:04:20
31838b4dcd27961b13e46ffd126233b208a29530...373a5ede53863132dbd3eeab262a8e29e763ddab,1,18,23,41,7,2010-01-06 09:33:22,2010-01-06 08:05:04
373a5ede53863132dbd3eeab262a8e29e763ddab...de54e67c1a892167ade274017a946de1f99920d1,1,7,7,14,7,2010-01-06 09:33:35,2010-01-06 08:06:03
de54e67c1a892167ade274017a946de1f99920d1...13fca9f36b6dfa1a4a8bb3a67bb9a41705bea68a,2,8,11,19,9,2010-01-06 09:33:45,2010-01-06 08:06:58
2bd6dbbe0b0f64ae801be2769a1818fc3ce43fa4...dd8a8d476b65fdc00747f504069befdf646f8454,1,2,2,4,1,2010-01-23 19:26:46,2010-01-23 07:26:26
dd8a8d476b65fdc00747f504069befdf646f8454...76c9c0db3d0b9d17ca4dcbb0f9b6678f78a2492c,1,4,4,8,1,2010-01-24 05:39:11,2010-01-22 21:09:24
9f16184af5a1ccfbc05d7ec763d4b4e0469a326e...fdf96a20acf96a6ac538df8113b2aafd6ed71d50,3,33,2,35,4,2015-01-12 22:06:12,2015-01-12 22:06:12
632052641517de1a965c1f045b97d2eaa541b2e9...f63c79dbc8c5670533557d311ed0e81fcfc9fe3a,1,44,13,57,6,2011-11-17 06:06:08,2011-11-17 06:04:03
632052641517de1a965c1f045b97d2eaa541b2e9...852844561e8daaa6689cab48a725f764ad5779cb,1,2,1,3,2,2011-09-27 16:58:47,2011-09-27 04:46:53
8a3c63e01d2b1df471beafff5fb78df4bade9388...bb96a2c9005f925b4e80ece0a7cd6230f7f4b43d,3,14,9,23,6,2010-02-20 17:18:04,2010-02-19 22:15:01
bb96a2c9005f925b4e80ece0a7cd6230f7f4b43d...3c0ff44a1ee92bd0f811b95d747a08763983566b,1,6,9,15,4,2010-02-20 17:19:06,2010-02-19 22:15:55
3c0ff44a1ee92bd0f811b95d747a08763983566b...68ad5e1e9c10e8a640703aadbdf8b8366014373b,1,5,13,18,6,2010-02-20 17:19:35,2010-02-19 22:16:45
68ad5e1e9c10e8a640703aadbdf8b8366014373b...462749b728f72079a67202d4d0d1ef19ef993f61,1,17,6,23,6,2010-02-20 17:22:44,2010-02-19 22:20:44
f341feb86a97ea184db2e01083e29582afaea63e...12fb25dce80f6804da73e0b9451caeeddb1b16d9,1,22,1,23,8,2009-11-23 03:17:32,2009-11-23 03:16:01
12fb25dce80f6804da73e0b9451caeeddb1b16d9...2fdc0cfcd98c159e487ed502ae41fcaf1545500f,1,15,4,19,2,2009-11-23 06:56:32,2009-11-23 02:07:29
2fdc0cfcd98c159e487ed502ae41fcaf1545500f...7b357240f047bfbeae377b8c5327944337124a0f,1,22,2,24,3,2009-11-23 06:56:38,2009-11-23 02:07:30
7b357240f047bfbeae377b8c5327944337124a0f...d21f9794ceff7d89fd2fc44a3e5ff106d5dbd141,2,2,2,4,4,2009-11-23 06:56:54,2009-11-23 03:03:28
d21f9794ceff7d89fd2fc44a3e5ff106d5dbd141...fc13aa3d09407998e5cb08a5c1da05d0000fe81d,1,1,2,3,1,2009-11-23 06:59:05,2009-11-23 04:16:14
1fdffa616119aeb607e211a77688c9bc3883ca87...b7cc9f82594a2d5fe12867c515d86d91ecedad8f,1,12,3,15,3,2009-11-24 08:57:39,2009-11-23 22:55:12
b7cc9f82594a2d5fe12867c515d86d91ecedad8f...fe3b2b7b827c75c21d61933e073050b6840f6dbc,3,181,2,183,7,2009-11-24 08:58:17,2009-11-23 22:55:50
fe3b2b7b827c75c21d61933e073050b6840f6dbc...af06e93a3e822681ed2527388a9ded07d23428c5,1,27,12,39,4,2009-11-24 09:00:34,2009-11-24 06:54:44
ee6fc514f2df821c2719cc49499a56ef2fb136b0...6a5cedac87ff4f1d8d8b535dac8184e1f7fbc454,1,2,2,4,2,2011-12-08 19:15:01,2011-12-07 21:50:14
ee6fc514f2df821c2719cc49499a56ef2fb136b0...8e08b4198c40cd6d3a5d1a7e60a599adabece08e,2,90,3,93,4,2010-01-17 00:40:56,2010-01-16 17:42:53
8e08b4198c40cd6d3a5d1a7e60a599adabece08e...f17a5d34948363087db94a1cb2c3c715c1ada2d8,4,15,9,24,8,2010-01-17 23:55:11,2010-01-17 19:42:31
f17a5d34948363087db94a1cb2c3c715c1ada2d8...e3d42c4773bccebb50f01b108d20b06c6a11e615,6,56,29,85,34,2010-01-19 01:28:21,2010-01-18 20:26:18
c142616fb2152d7887f9c38ff20e07167d31b0c8...64840701683b4126234b39da746b3cddb6db00a8,2,50,2,52,2,2012-08-24 03:58:20,2012-08-23 04:10:53
64840701683b4126234b39da746b3cddb6db00a8...df1effa6909d07c859e4ade03dbea3e32e5595b4,4,72,37,109,18,2012-08-24 03:58:24,2012-08-23 05:21:53
c142616fb2152d7887f9c38ff20e07167d31b0c8...003c84f6d2b9e9c4d5bbf5262cae994bac7190cb,5,56,4,60,9,2012-08-23 21:37:49,2011-05-02 20:39:16
47e32d071ea7623be4e2b53ce412612139e4127f...2a9a19e1b160c8c63c470d4c236d65709214a66f,2,2,11,13,3,2012-08-15 20:46:16,2012-08-15 20:46:16
f56d036ce95616b3339a11ecf50b717d5cf67c85...23193cfd519a54845f489f95340ff3fbbdbff05e,2,63,1,64,2,2012-09-10 22:39:15,2012-09-10 22:39:15
51e383dd08c3d3a389ab4d9780e503a6f49dfc4f...9e2116adbe192f3090785bdf3412bf7e3e2767b7,1,15,0,15,2,2012-07-28 05:25:19,2012-07-28 05:25:19
476109fa4c261c57cf20858b1879d5fede32e32c...be8779f7ac9a3be9aa783df008d59082f4054f67,2,66,2,68,2,2012-07-25 18:33:24,2012-07-22 14:49:44
476109fa4c261c57cf20858b1879d5fede32e32c...4a15758f2ef97970694012cfd6da7c8449bc68c2,1,5,2,7,2,2012-07-25 17:23:54,2012-07-25 16:16:19
4a15758f2ef97970694012cfd6da7c8449bc68c2...6a17f583f4db98a867d84ca95bbbc4de3cd0feaa,1,4,3,7,1,2012-07-25 18:08:59,2012-07-25 18:01:12
15b7898c5e9fc6fed9a6064213cfcd08cf7d7314...e7622ce8c4c3d5c0a596ace7fb34afe0d1e273ef,1,6,2,8,1,2012-01-04 17:39:36,2012-01-04 10:01:55
15b7898c5e9fc6fed9a6064213cfcd08cf7d7314...0eddcbf1612ed044de586777b233caf8016c6e70,1,1,0,1,1,2011-12-29 21:08:47,2011-12-29 04:42:05
0eddcbf1612ed044de586777b233caf8016c6e70...5c951ef47bf2e34dbde58bda88d430937657d2aa,1,4,5,9,1,2012-01-01 09:18:53,2011-12-31 11:50:56
15b7898c5e9fc6fed9a6064213cfcd08cf7d7314...bd2c86ef00f032be925edacfc2d284ab9b6b9eab,1,5,5,10,5,2011-12-18 02:18:28,2011-12-17 09:37:15
7b51c33b376d22195dba1c4e067180164fd35dbf...0f544ee897ac2cc760f29d3568cc4295ca69fd1f,1,15,6,21,2,2012-01-12 03:21:22,2012-01-11 12:12:38
1e501a7c47ad5ada53d3b1acfb9f131f76e969ec...590a472b363ba9d6e75b1dbf07f20e80ae9a587d,1,1,1,2,1,2011-12-05 19:18:51,2011-12-03 20:35:49
590a472b363ba9d6e75b1dbf07f20e80ae9a587d...cc64b318f26c9e176c4f07b1a459a86e7a04c4eb,2,24,5,29,5,2011-12-05 19:20:50,2011-12-03 20:35:50
1e501a7c47ad5ada53d3b1acfb9f131f76e969ec...0becb3e4b94f19358f66ec2f4bbbf89904251bf5,1,23,13,36,4,2011-11-30 19:30:53,2011-11-30 15:52:51
463b0ea22b5b9a882e8140d0308433d8cbd0d1fe...9931df3fa97c274449c73a224994aa27f6790ae6,1,1,1,2,1,2011-10-15 05:37:29,2011-10-14 22:53:28
9931df3fa97c274449c73a224994aa27f6790ae6...72b5158b25ce67a6886dab58011f19ea529742d6,1,1,0,1,1,2011-10-15 05:37:58,2011-10-14 22:53:30
72b5158b25ce67a6886dab58011f19ea529742d6...184892fb3e19cd28aaced4ca185257ed5b3acc78,1,7,8,15,1,2011-10-15 05:38:15,2011-10-14 22:53:31
184892fb3e19cd28aaced4ca185257ed5b3acc78...b52612ed4f736c517231954ef0d765add1fe29b7,1,4,4,8,4,2011-10-15 05:46:45,2011-10-14 22:53:33
b52612ed4f736c517231954ef0d765add1fe29b7...8850c3da95d17bb23576ee5ee3484bfd3d486444,1,6,1,7,1,2011-10-16 03:13:55,2011-10-15 14:05:19
8850c3da95d17bb23576ee5ee3484bfd3d486444...13d24b018f348401cceca45da5c0dd6d17411268,2,10,0,10,2,2011-10-16 03:14:39,2011-10-15 14:05:20
13d24b018f348401cceca45da5c0dd6d17411268...f64943d242d3b0fff40684d09033f17bb9747a38,1,12,15,27,6,2011-10-16 03:17:32,2011-10-15 14:05:17
69d61daec7a7915f6a664f32002fd9403e7f2a34...5914f2d057c259668695bccab8e9bec3a4bead53,1,49,38,87,19,2011-12-10 07:17:00,2011-12-08 08:43:19
4e3aa87d13b339fa678cd3cb7f23664d3a48fb21...fea33a1ef37a5891ebd1fcf6018849150e7b91cb,2,1,2,3,2,2011-05-15 22:23:31,2011-05-15 19:54:50
fea33a1ef37a5891ebd1fcf6018849150e7b91cb...abb25ac365791e16563dfd09e4ecd3e7e4dcf6b1,1,16,2,18,1,2011-05-15 22:23:32,2011-05-15 19:54:51
abb25ac365791e16563dfd09e4ecd3e7e4dcf6b1...4bbf5a2615420ac50c696b72dc303727e6218562,4,9,17,26,6,2011-05-15 22:23:33,2011-05-15 19:54:52
4bbf5a2615420ac50c696b72dc303727e6218562...e1111cef23cef1d48e9e7f222db87d58c1d51ece,3,14,4,18,5,2011-05-15 22:23:33,2011-05-15 19:54:53
e1111cef23cef1d48e9e7f222db87d58c1d51ece...5bf29b950063c8fa2f3666cb6cf2ca20be61f3d1,2,12,5,17,4,2011-05-15 22:23:34,2011-05-15 19:54:54
4e3aa87d13b339fa678cd3cb7f23664d3a48fb21...ba67aaf2d05d1aa3def2b6eb1dc1d39bdf25bb41,5,524,0,524,5,2011-05-15 03:29:05,2011-05-14 13:47:42
ba67aaf2d05d1aa3def2b6eb1dc1d39bdf25bb41...e00cf070a45351e4170b75e016597695d1962a87,4,61,0,61,4,2011-05-15 03:29:11,2011-05-14 13:47:43
e00cf070a45351e4170b75e016597695d1962a87...64a42951471b03c0e25f9e632973e17e2cc2a758,1,21,9,30,2,2011-05-15 03:29:11,2011-05-14 13:47:44
64a42951471b03c0e25f9e632973e17e2cc2a758...adc3b2b27670f123bd7dd742ba0fa0e0a60e1b19,1,5,1,6,3,2011-05-15 03:29:11,2011-05-14 13:47:45
4e3aa87d13b339fa678cd3cb7f23664d3a48fb21...d61ebbe8f57107afe1b04005be420117d3806675,1,8,4,12,7,2011-05-10 16:03:13,2011-05-02 12:47:43
d61ebbe8f57107afe1b04005be420117d3806675...28911091c120365a415f4cef8a21a5fa450b5fef,2,75,29,104,13,2011-05-10 16:04:26,2011-05-09 15:43:01
4e3aa87d13b339fa678cd3cb7f23664d3a48fb21...838466b8f7f9e8752a14114d5c4b1d685e0c6c25,1,71,0,71,1,2011-05-09 22:26:27,2011-05-09 13:33:30
838466b8f7f9e8752a14114d5c4b1d685e0c6c25...e86226e34097ce22ed78a9e759564110f141dda0,1,16,9,25,7,2011-05-09 22:27:32,2011-05-09 13:34:02
e86226e34097ce22ed78a9e759564110f141dda0...ed747dd5216ba1fe6fa59da9585dcd6cced202bb,4,45,2,47,9,2011-05-09 22:27:50,2011-05-09 13:34:42
4e3aa87d13b339fa678cd3cb7f23664d3a48fb21...ec70f52f6fb6d3e08c7b24f8b5bf25502d8ee59b,4,10,10,20,9,2011-05-09 21:58:52,2011-05-09 19:52:12
ec70f52f6fb6d3e08c7b24f8b5bf25502d8ee59b...c61dcff9d6944eb35abf7fc7faa36f23a49fabf6,1,31,30,61,22,2011-05-09 21:59:09,2011-05-09 20:12:57
c61dcff9d6944eb35abf7fc7faa36f23a49fabf6...83295964b3289e957d028960f14a2b71348c39ed,1,22,26,48,4,2011-05-09 21:59:09,2011-05-09 18:23:04
83295964b3289e957d028960f14a2b71348c39ed...3bfba20dae16384cb7112268462bd01d30d4a698,1,38,41,79,13,2011-05-09 21:59:09,2011-05-09 20:58:31
e839fe6c1206292aeb4518939b8f124ae5068619...9244d69b96c209116390804c9af6bb1f5271ae18,1,50,57,107,34,2011-04-28 16:40:20,2011-04-28 16:01:51
9244d69b96c209116390804c9af6bb1f5271ae18...da4902a73017ad82b9926d03101ec69a2802d1e7,1,11,105,116,55,2011-04-28 16:40:20,2011-04-28 16:01:52
afb497d472c22ba12c5b3313b6fdad132025468e...fbcda3c0a72cbcc105100ebef1b1dae54d854204,2,43,1,44,2,2011-03-16 23:47:40,2011-03-16 23:29:03
4a2284b9997400d46b439a9cd272ba16cbf4f377...00fb3d214cbb867f45de0084e6b844445e076dce,2,20,2,22,3,2010-03-13 20:04:17,2010-03-13 10:25:12
00fb3d214cbb867f45de0084e6b844445e076dce...34b383e7cd57692fd3996c1e8c9e738dab53ac48,1,2,0,2,1,2010-03-13 20:41:20,2010-03-13 20:41:20
34b383e7cd57692fd3996c1e8c9e738dab53ac48...8ca788035644f2aaf7a951272ae16a7bd319554c,1,12,10,22,8,2010-03-13 21:18:09,2010-03-13 17:37:50
8ca788035644f2aaf7a951272ae16a7bd319554c...8fcaca3ff29a193f50a44bb3d5734a503e0539a6,2,13,2,15,4,2010-03-14 05:23:43,2010-03-13 22:47:05
01a5774571d9dcc545d81d5f6d9781df9591c4cf...3330a2c4f6b494f2b02fda2869d85bc1f8e019aa,4,52,3,55,5,2014-02-05 22:13:23,2014-02-05 22:05:31
69cf7bfd131ae6246931459a1e6513d51f0b0119...155b940f7a117e9bba1b62e442c9e6e5853a3c0d,1,1,1,2,1,2011-10-16 03:33:04,2011-10-15 08:44:52
5d005922bc781c1f6ec9ae0af466f308a7576612...5565f47c4054e9a1abfad8c4a754e9a6224dc591,1,2,0,2,1,2010-03-07 19:05:18,2009-11-18 16:15:19
5565f47c4054e9a1abfad8c4a754e9a6224dc591...97222d9634b5518cd3d328aa86b52746a16334a7,3,3,8,11,4,2010-03-07 19:07:51,2010-03-07 19:07:51
45a0ee116348d1b36756fe47d338713c06b918ad...70649945c215b1674611a40eda1d0058118a6d1a,1,1,1,2,1,2010-06-20 18:09:41,2010-06-18 21:01:25
45a0ee116348d1b36756fe47d338713c06b918ad...6c44b6406bc9093945aa030f33c06ecda47ba7f5,1,7,7,14,2,2010-06-18 16:15:52,2010-06-17 21:32:16
4f8f03d6435e3e1c0d4f95d43022b81c95d6347f...0eb4f7cdf85273c88feb95c677a808cee9cfd859,1,9,14,23,3,2007-08-05 21:29:01,2007-08-05 21:18:52
0eb4f7cdf85273c88feb95c677a808cee9cfd859...7a7cc594ca294a58b6d7ae5aa50a65378538e875,1,32,0,32,1,2007-08-05 21:45:47,2007-08-03 22:22:59
7a7cc594ca294a58b6d7ae5aa50a65378538e875...407c0c87e15b3cf60347f4fc0bcdb4d239de4163,1,9,2,11,2,2007-08-05 22:13:56,2007-08-05 22:12:37
4f8f03d6435e3e1c0d4f95d43022b81c95d6347f...7fd53fce1c574f6a4940eedf36383a4e9ed7ae6a,1,7,0,7,3,2007-08-04 07:14:28,2007-08-03 09:04:37
7fd53fce1c574f6a4940eedf36383a4e9ed7ae6a...33f243308589120a700f084b54ee597ce6c26069,1,1,1,2,1,2007-08-04 08:55:08,2007-08-03 17:50:42
33f243308589120a700f084b54ee597ce6c26069...2ec39edad9c3be74b5fed5ab5c122493e6a53c66,2,25,0,25,2,2007-08-04 08:55:08,2007-08-04 03:19:09
2ec39edad9c3be74b5fed5ab5c122493e6a53c66...d5538b418d658d507f7fb9f359b31152a9b5f8e0,1,16,0,16,1,2007-08-04 08:55:08,2007-08-04 06:06:52
d5538b418d658d507f7fb9f359b31152a9b5f8e0...936800bb559afb8e24d79d5fab555bf061a4a88c,1,1,0,1,1,2007-08-04 08:57:29,2007-08-04 08:57:29
936800bb559afb8e24d79d5fab555bf061a4a88c...4465f410d6a8fa7abc5436aac6f58196f2b618d8,1,2,1,3,1,2007-08-05 04:22:14,2007-08-04 22:20:07
4465f410d6a8fa7abc5436aac6f58196f2b618d8...64a476e691cb08c2f8bd6d40cc88fb8ccb9ed955,1,1,1,2,1,2007-08-05 05:35:13,2007-08-05 05:22:15
64a476e691cb08c2f8bd6d40cc88fb8ccb9ed955...936492d3cf96817f03182712ca14eb4744c721ef,1,9,0,9,1,2007-08-05 17:55:55,2007-08-04 05:13:09
936492d3cf96817f03182712ca14eb4744c721ef...00d8c5180dde7434930bfbdf20bc296e9241e4fc,1,3,1,4,2,2007-08-05 17:56:50,2007-08-05 06:48:27
fa548703d1e60231828266856467d3d73ac51f0f...4739809cd0ea12a8de006f9f086fdff9285189b8,3,44,1,45,8,2007-08-11 06:16:18,2007-08-06 10:22:57
4739809cd0ea12a8de006f9f086fdff9285189b8...98e79f63be7e2cf043bd3150ae9ac0c8d118ce61,1,9,5,14,2,2007-08-11 06:16:38,2007-08-07 10:02:12
86bab9615c3516d4ac7756ae3c1285d331b78f04...31f9ec129ef37e50b5cacf26a2ebcb5420fcdc5e,1,2,3,5,1,2007-09-03 18:27:02,2007-08-21 09:53:02
31f9ec129ef37e50b5cacf26a2ebcb5420fcdc5e...14594f4b5747e51b051f647f6430089e6664e77d,1,9,2,11,3,2007-09-03 18:27:02,2007-08-22 07:07:15
14594f4b5747e51b051f647f6430089e6664e77d...4f6432d8cc6ebdcdc366cf67ab39e8125c449d80,1,14,9,23,2,2007-09-03 18:34:32,2007-08-26 13:56:36
4f6432d8cc6ebdcdc366cf67ab39e8125c449d80...e87f37ae42dad89b39620c234fc29c94529a4d07,1,71,69,140,3,2007-09-03 18:34:56,2007-08-26 14:00:52
e87f37ae42dad89b39620c234fc29c94529a4d07...1c49fc197bd05a4c2ed602efcdbe277ef798813a,1,9,9,18,7,2007-09-03 18:35:13,2007-08-26 14:04:34
1c49fc197bd05a4c2ed602efcdbe277ef798813a...c208a24310582d9cf337b66f41a0d7a9fe106bb4,1,45,42,87,2,2007-09-03 18:35:25,2007-08-26 14:07:18
c208a24310582d9cf337b66f41a0d7a9fe106bb4...8134f69c21ff47283d8b3ea3cc5b306727cde256,1,11,17,28,2,2007-09-03 18:35:37,2007-08-26 14:44:55
8134f69c21ff47283d8b3ea3cc5b306727cde256...1ca3d71069620f1438d9f89165a3e69e8d47d302,1,74,2,76,2,2007-09-03 18:35:39,2007-08-26 15:36:55
86bab9615c3516d4ac7756ae3c1285d331b78f04...030e0e5fb77ed04316b2604b5c53a38b0e746460,1,1,1,2,1,2007-09-02 22:03:26,2007-09-02 22:03:26
030e0e5fb77ed04316b2604b5c53a38b0e746460...5587cac28be66acf5edc2a4b83b67c8cfffbc5e9,5,17,3,20,5,2007-09-03 08:28:37,2007-09-02 22:16:44
86bab9615c3516d4ac7756ae3c1285d331b78f04...776398709dee4050fc194fec45c5818ba9b01afe,1,23,2,25,5,2007-09-02 06:53:47,2007-09-02 06:53:47
63f328290a0edda617c0881a356c07280fbba459...95064cbcc8a51fb9e3c16350e8c567a84d131ad7,1,2,1,3,1,2007-08-19 18:38:53,2007-08-19 08:18:47
95064cbcc8a51fb9e3c16350e8c567a84d131ad7...1211be6bed1146dcef953c7c2ab332ee995f7152,2,54,0,54,2,2007-08-19 18:44:47,2007-08-17 16:56:54
1211be6bed1146dcef953c7c2ab332ee995f7152...2f82f760e1b2630073a05c44fe70bdce9706d9e5,1,0,4,4,1,2007-08-19 18:45:31,2007-08-18 22:52:55
2f82f760e1b2630073a05c44fe70bdce9706d9e5...463a849d004b2a3f3c8254b1e7985d4e986b9f1a,2,10,2,12,4,2007-08-19 21:38:45,2007-08-19 17:24:36
463a849d004b2a3f3c8254b1e7985d4e986b9f1a...14cd56071520c3bb37252c8d0abe81c841465378,1,1,1,2,1,2007-08-19 23:41:21,2007-08-19 21:38:57
14cd56071520c3bb37252c8d0abe81c841465378...d56651c0ef1c81c1d0509ea4464451d5724e4036,3,7,0,7,4,2007-08-20 05:52:06,2007-08-20 02:33:43
d56651c0ef1c81c1d0509ea4464451d5724e4036...257a84d9d02e90447b149af58b271c19405edb6a,1,4,1,5,1,2007-08-20 05:56:10,2007-08-20 03:36:38
257a84d9d02e90447b149af58b271c19405edb6a...2be7fcb4764f2dbcee52635b91fedb1b3dcf7ab4,2,2,2,4,2,2007-08-20 06:26:03,2007-08-20 02:27:52
2be7fcb4764f2dbcee52635b91fedb1b3dcf7ab4...23d53358be51bb256699f4d237619a3ee8addf39,1,4,1,5,3,2007-08-20 22:35:15,2007-08-20 22:35:15
23d53358be51bb256699f4d237619a3ee8addf39...4bf53833dbca666f61b5177977e96d453527db20,1,6,7,13,7,2007-08-21 04:57:50,2007-08-21 03:38:14
e87fb0f1b4a4b458394a65d664145a9a8001e821...20f1a10bfb6c31a3728a74bf1c33cb3cc5ac0c7e,1,12,1,13,1,2007-07-12 06:38:14,2007-07-12 06:31:28
e8964a5b91e13169ad73c7b1db2e904441ad93f5...9cb18f56fdee6885884f5f08bd5335a42d9034dc,1,13,3,16,4,2007-07-03 19:25:29,2007-07-03 10:40:20
9cb18f56fdee6885884f5f08bd5335a42d9034dc...3cb567386d5d0349bfb5e3aaf85e973faf685dda,3,7,1,8,4,2007-07-03 20:44:30,2007-07-03 15:01:06
3cb567386d5d0349bfb5e3aaf85e973faf685dda...f8d6957628e222bb9f2090c4900f9994559532e1,1,6,0,6,1,2007-07-03 20:56:07,2007-07-03 20:28:24
f8d6957628e222bb9f2090c4900f9994559532e1...ed5f07a6fdc5653e24a5bd6c216d12bc878496bd,1,3,0,3,1,2007-07-04 02:02:13,2007-07-03 23:38:29
0a84b3d94ff8c29a5d3b738d4f08d1344305b619...5922446794ee1bfcd4bede739467211cd46aa005,1,1,1,2,1,2007-07-10 01:19:22,2007-07-09 15:01:02
5922446794ee1bfcd4bede739467211cd46aa005...6a5955fac3bd5a1369e73512b9606769f0c95e7c,1,1,1,2,1,2007-07-10 01:19:22,2007-07-09 15:09:27
6a5955fac3bd5a1369e73512b9606769f0c95e7c...264f4a32fa898a47e37ccb6f2580746d6f36453f,1,1,1,2,1,2007-07-10 01:19:22,2007-07-09 15:10:26
3d2c1bf2d44ccae8fc696263c771f9c53ca1576e...8bd2c972b1e2343620cad5b0f56de0f2524b7564,1,13,0,13,1,2015-01-09 23:33:39,2015-01-08 20:00:55
8bd2c972b1e2343620cad5b0f56de0f2524b7564...a6c3c638acea34116c6be7cc4be41a9bc55a7fa1,4,30,1,31,5,2015-01-09 23:33:39,2015-01-08 20:00:56
a6c3c638acea34116c6be7cc4be41a9bc55a7fa1...88e011814b9498ee1170d82462a19f72a86f9d82,3,13,0,13,4,2015-01-09 23:33:57,2015-01-08 20:00:57
bbcefffcea9789e4a1a2023a1c778e2c07db77a7...33adc83ddb315a614a59604a0d39caa5a1b27bdd,1,1,1,2,1,2014-12-29 21:14:16,2014-12-24 00:18:45
bbcefffcea9789e4a1a2023a1c778e2c07db77a7...8d025b7cafdd976d1ba34fd8b2df8b669e1cd282,1,1,0,1,1,2014-12-29 17:33:25,2014-12-24 00:18:38
bbcefffcea9789e4a1a2023a1c778e2c07db77a7...47103bd6b3e64965c6a405b6c23a3c9bee40885f,1,819,798,1617,722,2014-12-24 04:22:04,2014-12-21 23:18:04
bbcefffcea9789e4a1a2023a1c778e2c07db77a7...fb86e32dcc9ed07ee2f1df6aafbf34d469007b1f,1,3,1,4,1,2014-12-23 20:42:36,2014-12-23 13:25:05
fb86e32dcc9ed07ee2f1df6aafbf34d469007b1f...b90c95d90ed9e96a0c1515c00fa8c0f92a0cb130,1,5,0,5,1,2014-12-23 20:42:37,2014-12-23 13:25:09
62ce40d9338046a89de5d2bfb6b258872fd366c0...695d95df19b74485be62aba0f978044ff1215ea0,1,106,32,138,16,2014-11-20 20:41:07,2014-11-20 15:17:05
695d95df19b74485be62aba0f978044ff1215ea0...17a4be26060b00a867cbe54ee906fe03813470ec,4,37,5,42,9,2014-11-20 20:42:49,2014-11-20 15:25:39
17a4be26060b00a867cbe54ee906fe03813470ec...ff40d185d25ce821bd6ae5a524e58e4eab01dc86,4,20,6,26,8,2014-11-20 20:42:55,2014-11-20 15:25:52
ff40d185d25ce821bd6ae5a524e58e4eab01dc86...bca45fbc1f8fe0daa76e840fa2ad4a9c663500a0,2,90,13,103,5,2014-11-20 20:43:16,2014-11-20 15:29:18
bca45fbc1f8fe0daa76e840fa2ad4a9c663500a0...71b59849753589c3faa04176e875071417ceddd5,1,4,5,9,3,2014-12-09 22:51:31,2014-12-09 21:01:26
57815a4f56b5788348193abd346bbc9a85ebf879...c2e8e4b9da4d007b15faa2e3d407b2fd279f0572,2,34,1,35,2,2014-12-22 20:20:38,2014-12-22 20:20:38
ca0107e279df1465946970113d68b4ee26ffbcc4...e3f9cab7421e19a1cb36b38ebeb95b92a5c88cf5,1,24,24,48,15,2014-11-20 02:03:10,2014-11-20 02:03:10
e3f9cab7421e19a1cb36b38ebeb95b92a5c88cf5...9aeb4c2b57aaaab208e5cce85dceadd551138a68,7,554,519,1073,362,2014-11-20 02:53:48,2014-11-20 02:53:48
9aeb4c2b57aaaab208e5cce85dceadd551138a68...388a439ca9d00214fb974ed32e4d9cf955067f90,1,2,2,4,2,2014-11-20 06:16:18,2014-11-18 18:06:51
388a439ca9d00214fb974ed32e4d9cf955067f90...e6c1c391a86302a53e0eab44dc5bb597c96a87fb,1,1,3,4,3,2014-11-20 06:16:18,2014-11-20 06:15:15
e6c1c391a86302a53e0eab44dc5bb597c96a87fb...7ba2ba7d12163a8f9a9947d7880bd26f2970d4c5,6,6,30,36,12,2014-11-20 08:23:43,2014-11-20 08:12:34
49e0c5ad0ab95e450138105ff27688861a4a1557...3696a7c2d9a4f3227dd7719b734e9db242aae6af,1,5,2,7,3,2014-11-17 17:24:35,2014-11-16 07:37:44
ef59f324b0a61ce8a74fd6d1e10773739e335280...4ace7ff4557350b7e0b57d024a2ea311b332e01d,2,7,1,8,3,2014-10-31 18:57:23,2014-10-31 18:57:23
20b3d206acbbb042c7ad5f42d36ff8d036a538c5...eb09626b94fb21c67f47f71f8bada0d4aed306f5,1,1,1,2,1,2007-05-28 23:51:55,2007-05-28 23:21:25
eb09626b94fb21c67f47f71f8bada0d4aed306f5...7faf068660f0a060066ccbc80f7debbba6bc2d76,1,10,6,16,1,2007-05-29 06:49:47,2007-05-27 22:59:01
1c1f3537c0283c92abbca9155813ed62b05cb481...a2a564686feddb290afa79c7c18e7939b8ac064e,1,1,1,2,1,2011-01-31 17:59:04,2011-01-31 16:51:25
22da742982eeeb95b6fb4cd757509a8c4c2202d8...d5af51053cd060d7a4893f030626b04351554d1b,2,41,0,41,4,2010-09-03 18:26:49,2010-09-01 20:15:32
22da742982eeeb95b6fb4cd757509a8c4c2202d8...e78d01bf4e29ec92b4aa466ea0a49ae4be388ca9,1,4,1,5,2,2010-09-03 16:37:10,2010-08-30 03:30:22
e78d01bf4e29ec92b4aa466ea0a49ae4be388ca9...dd34b6be8a3e869f3e0d62a13115f02d90cf4f80,3,3,9,12,4,2010-09-03 16:38:53,2010-09-03 16:38:53
9f6cea97c97ee505bd6771db7df69f04df9b4fc4...f59ba1cea02b3bed1025fd22f8601923fc81b6af,1,30,0,30,1,2011-03-02 19:50:07,2011-03-01 01:08:50
f59ba1cea02b3bed1025fd22f8601923fc81b6af...eeba0d1760d6922e7d6ee838b8684e87a6c0c273,1,33,0,33,1,2011-03-02 19:52:59,2011-03-01 01:08:51
eeba0d1760d6922e7d6ee838b8684e87a6c0c273...b2c8c0a762745768e8fb249949801c1aed8f7c1d,2,12,7,19,4,2011-03-02 19:55:06,2011-03-01 01:08:52
b2c8c0a762745768e8fb249949801c1aed8f7c1d...b9b3eef76186d423efb684d01b3e99ef010a61de,1,8,1,9,2,2011-03-18 05:22:06,2011-03-18 05:22:06
bd3a97a27a97485b130802d497214be312b737f9...5bc99d3f633b9fba288b1b2c3ebde3124f374275,1,1,1,2,1,2010-08-19 19:14:34,2010-08-19 19:03:18
17367939ebd64f5e6eb4fa5a32ece513f497e6e6...57da20426417cd0834e7fc442096d1c18924228a,1,2,2,4,2,2010-12-29 21:39:05,2010-12-29 21:02:31
57da20426417cd0834e7fc442096d1c18924228a...9d9f5e72dc5959750498acc81b3e2c8ca76ad499,1,1,1,2,1,2011-01-04 18:48:37,2010-09-04 00:44:39
b120079113c62cf52a23e0d84760b5405bcf6b2e...e6dfbcf12b0e70897818cb36903de0625931a5c6,4,57,3,60,5,2012-07-22 20:07:40,2012-07-22 20:07:40
05a20c87abd08441c98dfcca0606bc0f8432ab26...9a7365cfa45637056e764f1f4759fcd34c4c1822,1,1,14,15,1,2012-08-03 16:13:28,2012-08-03 08:40:23
9a7365cfa45637056e764f1f4759fcd34c4c1822...e0453cd8f09aa03f3752d994011963ced7dea3ee,1,4,1,5,1,2012-08-05 19:34:57,2012-08-05 17:56:38
05a20c87abd08441c98dfcca0606bc0f8432ab26...5578ed744ddcf4e43d4fffa40fe3c76e38a91d11,1,55,31,86,26,2012-08-02 21:42:45,2012-07-27 20:00:48
5578ed744ddcf4e43d4fffa40fe3c76e38a91d11...06ee19e8e5401e90d3b8e60bcee4b25e7b49efc5,1,28,14,42,15,2012-08-02 21:42:47,2012-07-27 20:00:49
06ee19e8e5401e90d3b8e60bcee4b25e7b49efc5...b4943dc96324fec568125d7a5af1c4fdbd078543,1,27,11,38,11,2012-08-02 21:42:56,2012-07-27 20:00:50
b4943dc96324fec568125d7a5af1c4fdbd078543...6a8d999ed4a0030ab7902382ed3b122ce448e581,4,13,11,24,12,2012-08-02 21:42:58,2012-07-27 20:00:51
6a8d999ed4a0030ab7902382ed3b122ce448e581...b1ea6c3829109aff412095b889432bf496f46a90,3,15,13,28,13,2012-08-02 21:42:59,2012-07-27 20:00:52
b1ea6c3829109aff412095b889432bf496f46a90...91e6e0c56cc83e5f53d93e90726380a2d392f5f1,2,58,27,85,4,2012-08-02 21:43:02,2012-07-28 09:38:26
91e6e0c56cc83e5f53d93e90726380a2d392f5f1...82009f304826fcaf3188fb422769a7974ae78afa,1,16,0,16,2,2012-08-02 21:43:10,2012-07-28 09:38:27
82009f304826fcaf3188fb422769a7974ae78afa...280ad88aa0e851b2f2945222edb8e7b681a7574b,2,36,1,37,3,2012-08-02 21:43:58,2012-07-28 09:38:28
280ad88aa0e851b2f2945222edb8e7b681a7574b...ca475a61f8c07d475c505bf64d219f7e9d61e728,4,72,5,77,7,2012-08-02 21:44:04,2012-07-28 09:38:29
ca475a61f8c07d475c505bf64d219f7e9d61e728...8169a3908c72ce08763516745d726d8a2ac51a36,1,0,2,2,1,2012-08-02 21:44:09,2012-07-28 09:38:30
8169a3908c72ce08763516745d726d8a2ac51a36...3def8d088499b94919de36305ce710487a5e2bb0,1,24,0,24,1,2012-08-02 21:45:26,2012-07-28 09:38:31
3def8d088499b94919de36305ce710487a5e2bb0...565e56c2cc7ebe42ad12ee5970f3d5af1dc3f36c,2,9,3,12,5,2012-08-02 21:45:56,2012-07-28 09:38:32
565e56c2cc7ebe42ad12ee5970f3d5af1dc3f36c...dad9090f89b8d24f2cb7ecc70f21f52274224c30,1,6,1,7,2,2012-08-02 21:45:58,2012-07-28 09:47:45
dad9090f89b8d24f2cb7ecc70f21f52274224c30...1a35da0b5dc74dc23d7184f838c5dea9bd544334,1,1,1,2,1,2012-08-02 21:45:59,2012-07-28 09:47:46
1a35da0b5dc74dc23d7184f838c5dea9bd544334...93c3fcbe4d4893fac6c9de64219b2eda0b309a13,4,48,5,53,7,2012-08-02 21:46:00,2012-07-28 09:47:47
93c3fcbe4d4893fac6c9de64219b2eda0b309a13...9c27a57b2da502b7dd3736013b7a185fb6e5064e,3,9,44,53,10,2012-08-02 21:46:01,2012-07-28 09:47:48
9c27a57b2da502b7dd3736013b7a185fb6e5064e...8266fc8be19ef1405d4ef175bb0e75ebc2730f5d,2,5,5,10,5,2012-08-02 21:46:02,2012-07-28 09:47:49
8266fc8be19ef1405d4ef175bb0e75ebc2730f5d...d2fd119c4fcaea266a894354b506959376140c37,5,75,23,98,21,2012-08-02 21:46:03,2012-07-28 09:47:50
d2fd119c4fcaea266a894354b506959376140c37...705b49cb81351020b57f9356487e9b3fdeea1e40,2,22,6,28,11,2012-08-02 21:46:05,2012-07-28 09:47:51
705b49cb81351020b57f9356487e9b3fdeea1e40...5eaa1fd086e826b1ac8d9346a740527edbdb3c34,2,4,5,9,6,2012-08-02 21:46:06,2012-07-28 09:47:52
05a20c87abd08441c98dfcca0606bc0f8432ab26...3b6137f2535938d3066b9b7f7769df71c32aebd8,1,394,39,433,29,2012-08-02 01:35:23,2012-08-02 01:35:23
3b6137f2535938d3066b9b7f7769df71c32aebd8...9802f22966eef97718df0781f50821125de1576f,1,420,44,464,31,2012-08-03 07:28:51,2012-08-03 07:15:23
9802f22966eef97718df0781f50821125de1576f...649900bc126edf59aaae49ba025880dc948980f0,1,451,366,817,60,2012-08-04 23:12:27,2012-08-02 03:50:59
391b14278e59f46ceda3b055fdc12527bc2c87fb...7c978a068f0575a90570e4579c71a5f641bdfad3,1,74,61,135,4,2011-05-23 22:39:33,2011-05-23 20:16:41
7c978a068f0575a90570e4579c71a5f641bdfad3...c95b99bb5d5f3aed88f8154371a813ebd0d2fa1d,1,7,2,9,2,2011-05-23 22:40:51,2011-05-23 20:16:59
c95b99bb5d5f3aed88f8154371a813ebd0d2fa1d...4d5f34719970274990cded2201957eb2262bca10,2,148,2,150,8,2011-05-23 22:43:43,2011-05-23 20:27:34
4d5f34719970274990cded2201957eb2262bca10...3813e69031d2df2702f50b9649fa2e40ea11e558,3,20,13,33,3,2011-05-23 22:46:02,2011-05-23 20:30:14
3813e69031d2df2702f50b9649fa2e40ea11e558...0508fe533dfe1b890f6a2d31ca42ba25466e8ff5,2,131,9,140,13,2011-05-24 16:08:17,2011-05-23 20:31:05
a9930e359c45302f92639e8cd0a61c9c912e0b22...f5008f56d5aba06598e1c6272f4f55b4ee4bb016,1,10,0,10,1,2011-05-30 08:08:32,2011-05-29 11:00:35
a9930e359c45302f92639e8cd0a61c9c912e0b22...ea69619cd1081359e73e597a76fcf6444f222f2d,1,1,1,2,1,2011-05-27 22:52:01,2011-05-27 20:13:02
ea69619cd1081359e73e597a76fcf6444f222f2d...53f2ffa80c1c5ea5feb9fbe7432bf7106cf3047e,3,7,3,10,3,2011-05-27 22:52:03,2011-05-27 20:16:14
c4c42f2cbd2eb14871881cc0d27412b477f699a7...c14daa4845ff2ec0d27807fa50f9fac1ca4d6462,1,6,2,8,3,2011-10-26 21:31:14,2011-10-22 17:44:40
759e84f07fd0fba2f3466b11b74146173d42cb6b...0f54b7d09ac5b87c327a1e8da43bc48be98f2758,1,2,2,4,2,2011-02-21 18:36:56,2011-02-19 15:27:41
0f54b7d09ac5b87c327a1e8da43bc48be98f2758...98885c2914b22d70d09302528d86f87e795f7485,1,1,1,2,1,2011-02-21 18:37:31,2011-02-19 15:27:42
98885c2914b22d70d09302528d86f87e795f7485...49151d8b2cde68bc110a8bb899b8610631430941,3,6,88,94,88,2011-02-21 18:38:40,2011-02-19 18:16:19
49151d8b2cde68bc110a8bb899b8610631430941...d5a719e4afbfd74cf5ccf94c2a5b27aa5d06e914,1,6,1,7,1,2011-02-21 18:55:53,2011-02-19 18:29:09
9971d6d52c5afeb8ba60ae6ddcffb34af23eeadd...48d9e6ae4bcb6fd08562595aed47bef7326ec144,2,30,5,35,8,2011-02-14 23:28:13,2011-02-14 22:13:04
9971d6d52c5afeb8ba60ae6ddcffb34af23eeadd...dab0d4108d7b45905a12ec6cea2cfc20ea8eabef,4,6,4,10,5,2011-02-14 18:48:06,2011-02-07 08:17:27
dab0d4108d7b45905a12ec6cea2cfc20ea8eabef...62b8102c60a716e66cfd2a33e596e9d5be134267,1,1,0,1,1,2011-02-14 18:55:03,2011-02-12 05:18:51
62b8102c60a716e66cfd2a33e596e9d5be134267...1e58dba142c673c59fbb9d10aeecf62217d4fc9c,2,21,39,60,17,2011-02-14 18:55:15,2011-01-02 10:24:55
1e58dba142c673c59fbb9d10aeecf62217d4fc9c...726c4e3d4251d55a944c9d5f3694d55554ace83d,2,2,2,4,2,2011-02-15 18:51:08,2011-02-15 13:09:04
726c4e3d4251d55a944c9d5f3694d55554ace83d...ba9d7fe11c485b5fc10a17c67c8871792ee6ef12,1,2,2,4,2,2011-02-15 18:51:08,2011-02-15 13:09:05
ba9d7fe11c485b5fc10a17c67c8871792ee6ef12...5027fa864dafd5a054aab2de6b4bae089f344fc6,2,3,3,6,2,2011-02-15 18:51:08,2011-02-15 13:09:06
5027fa864dafd5a054aab2de6b4bae089f344fc6...3f40617566a2f683835de9efab54df0f14b19b70,3,5,5,10,3,2011-02-15 18:51:08,2011-02-15 13:09:07
3f40617566a2f683835de9efab54df0f14b19b70...08918e4a38e7aff66077b6325e5b69a4a4e02abf,1,1,1,2,1,2011-02-15 18:51:08,2011-02-15 13:09:08
08918e4a38e7aff66077b6325e5b69a4a4e02abf...8547090c9265bcde7a75feeddcbf49a3eddeaaac,1,1,1,2,1,2011-02-15 18:51:08,2011-02-15 13:09:09
8547090c9265bcde7a75feeddcbf49a3eddeaaac...cfb5e6b2da96c7803aa4a3813d27d2cbb47cda9e,1,6,5,11,4,2011-02-15 18:51:08,2011-02-15 13:09:10
cfb5e6b2da96c7803aa4a3813d27d2cbb47cda9e...24231e063f0f003f8ffd7b64c7ba6a0baaaa5283,1,1,1,2,1,2011-02-15 18:53:24,2011-02-14 16:48:08
00e6ee724640701b32aca27cc930fd6409c87ae2...6390c905dc6c6b0ca898689ee04a9cd6ac2f0b68,3,9,2,11,4,2011-02-13 23:13:41,2011-02-12 13:24:10
6390c905dc6c6b0ca898689ee04a9cd6ac2f0b68...cbef0db6ccf6e2e57ffe74ba73dc91a0fbbf5760,1,1,0,1,1,2011-02-13 23:15:08,2011-02-12 23:21:17
cbef0db6ccf6e2e57ffe74ba73dc91a0fbbf5760...3952710bfaa46917fd0c3a9b29d076ec013d6b6a,2,51,4,55,8,2011-02-14 18:34:49,2011-02-12 00:33:48
3952710bfaa46917fd0c3a9b29d076ec013d6b6a...4e363b11bdc3770efcfe55dac79f6dc18a5e562b,1,0,56,56,3,2011-02-15 18:47:04,2011-02-15 18:47:04
d2f15e29a6161b40dbc0142eb59f82092268e1d6...9cf3f14766b025bfc90fbac856d7a6493ef36c8b,1,18,18,36,2,2011-01-13 19:32:31,2011-01-13 11:30:23
9cf3f14766b025bfc90fbac856d7a6493ef36c8b...3e70e37e72207e780ca1c6e86bbc3c2963e6038c,1,25,25,50,20,2011-01-13 19:32:39,2011-01-13 09:35:34
77e572653b5089c9e3639fe4088f59e4cfef4eea...c2ed29b49b557b7bba8be147551cdd6e22fd743b,1,1,1,2,1,2010-12-23 03:46:52,2010-12-22 23:58:52
77e572653b5089c9e3639fe4088f59e4cfef4eea...ef88ad238779c4eadba9f179146fe213f047b89f,2,17,8,25,3,2010-12-23 00:50:28,2010-12-23 00:50:28
f29db856e7a736dd5109223d71c548367bc127ae...6068ac88488f01400eae5c063d8e4a08e9d87f74,1,66,4,70,42,2010-12-21 01:21:21,2010-12-20 15:18:25
6068ac88488f01400eae5c063d8e4a08e9d87f74...00b0d7f77b65ed2d059f893bbd2011ba5bb4252d,2,4,6,10,4,2010-12-21 17:25:14,2010-12-21 17:24:18
1b9743462d9ef3c0e73a3c439de45c0c16b6c938...fcbc0d8e8216d7b6235eccf9f3b556455ad3be3d,1,1,6,7,1,2010-12-19 18:43:53,2010-12-14 01:59:55
fcbc0d8e8216d7b6235eccf9f3b556455ad3be3d...834d9eb6b70a3447c2ad514f9c0e052bc43e8c8a,1,2,10,12,2,2010-12-19 18:44:06,2010-12-19 11:56:25
834d9eb6b70a3447c2ad514f9c0e052bc43e8c8a...4de0bbd8985ea057050994c5b254c9ef3d845c1e,1,49,35,84,5,2010-12-19 21:51:09,2010-12-13 09:28:05
1b9743462d9ef3c0e73a3c439de45c0c16b6c938...057f327972e7016703317e65e7af144a8e244d0a,1,12,1,13,2,2010-12-17 19:55:19,2010-12-16 06:56:08
55e7c0aaa1b2c00d147b1b4b1aa88a71d90dacf4...8518088fe803131d11eade2b15796f26ae207191,1,3,4,7,2,2011-11-08 00:42:57,2011-11-07 17:33:34
095ce9538b738db28d5e9a6e05d94c7e3f55f39d...75973b2cb58bf2b3038c5c214fc0a1b96d6868fe,2,30,39,69,9,2011-04-24 06:13:28,2011-04-21 01:11:19
3ba7a065527a27f45659398e882feaa1165cbb4c...33e42de0d21a8365496e904235bd32fd4659300d,1,5,0,5,1,2012-02-06 19:05:36,2012-02-06 16:24:52
3ba7a065527a27f45659398e882feaa1165cbb4c...4865d2b6622bd95fc07fea06916eeddf3e13e29b,1,6,4,10,5,2010-11-03 16:25:58,2010-11-01 22:54:20
4865d2b6622bd95fc07fea06916eeddf3e13e29b...f2e872aa5eeb74f429632e14d0f7fa2ed828b65a,1,27,16,43,14,2010-11-03 17:21:46,2010-11-01 22:54:21
9027fa9eb7df606b6658dd48a40bb993ce222ddd...5c47e1c7c56c60360646367e4067ed344a833b01,2,9,3,12,4,2010-09-27 19:39:05,2010-09-27 12:19:36
5c47e1c7c56c60360646367e4067ed344a833b01...89d71f7564cb3945b2775092284a4de807f577e4,1,4,0,4,1,2010-09-27 19:39:50,2010-09-27 12:21:58
9027fa9eb7df606b6658dd48a40bb993ce222ddd...d48b28418355ef41a9501eb28a82ec0b69e62a17,14,17,6,23,14,2010-09-27 19:37:41,2010-09-24 20:00:52
d48b28418355ef41a9501eb28a82ec0b69e62a17...3328acedc6104e3d46e8f0d26006d9650092ef3e,7,10,7,17,10,2010-09-27 19:37:56,2010-09-24 20:00:53
9027fa9eb7df606b6658dd48a40bb993ce222ddd...6e74e075d25aea67cf973e456a6804c0c3741235,3,59,18,77,10,2010-09-27 19:36:57,2010-09-24 17:03:00
9027fa9eb7df606b6658dd48a40bb993ce222ddd...b3457afc4f6da6cfef265359ed182c5fcd6d266c,1,1,1,2,1,2010-09-27 18:45:20,2010-09-12 22:37:45
9027fa9eb7df606b6658dd48a40bb993ce222ddd...311e2ea0062bf09d6f78f5458eeb14dbc6c092ea,3,20,0,20,4,2010-09-27 18:38:55,2010-09-25 04:20:35
9027fa9eb7df606b6658dd48a40bb993ce222ddd...9facb3b05b6a2fbfcd2525d5946cd5505488126b,1,0,3,3,3,2010-09-27 17:49:49,2010-09-23 09:22:10
9027fa9eb7df606b6658dd48a40bb993ce222ddd...7ce896b3000a7bd2ea24f02ad3051f43ad351e1f,3,21,3,24,6,2010-09-27 17:47:04,2010-09-21 07:25:19
9027fa9eb7df606b6658dd48a40bb993ce222ddd...7a0d8bcaddf984f55ac92239946cd010956e65e4,1,3,0,3,1,2010-09-27 17:42:50,2010-09-17 21:00:53
9027fa9eb7df606b6658dd48a40bb993ce222ddd...4af3fab06e41d031ccb2b948ddd7c73159dd9d49,1,1,1,2,1,2010-09-27 17:42:11,2010-09-16 20:53:23
4af3fab06e41d031ccb2b948ddd7c73159dd9d49...4098f6717b8137493dddfc1a28a72b25769ed7bc,1,2,2,4,1,2010-09-27 17:43:49,2010-09-21 17:45:09
4098f6717b8137493dddfc1a28a72b25769ed7bc...055467dd4ae7fac2cf3149352710a5ee64b2138c,1,4,0,4,1,2010-09-27 17:45:29,2010-09-22 19:15:37
055467dd4ae7fac2cf3149352710a5ee64b2138c...afa0876050496d4250e8b27680e5cbc60fbda760,3,5,5,10,5,2010-09-27 17:48:23,2010-09-22 00:35:59
afa0876050496d4250e8b27680e5cbc60fbda760...861514d340021daa85bfa333c335932e9214988e,1,1,1,2,1,2010-09-27 17:52:49,2010-09-23 12:33:51
861514d340021daa85bfa333c335932e9214988e...3695dc0af1bb5871430c028222d1af0a86720e62,1,6,6,12,4,2010-09-27 17:54:17,2010-09-24 16:21:59
3695dc0af1bb5871430c028222d1af0a86720e62...95ad6d2de1f762f20edb52d139d3cc19529a581a,2,4,1,5,3,2010-09-27 17:54:52,2010-09-24 16:43:59
95ad6d2de1f762f20edb52d139d3cc19529a581a...831a8b843bc04bdac989514652149787b7f43da0,1,1,1,2,1,2010-09-27 18:39:44,2010-09-13 14:59:54
831a8b843bc04bdac989514652149787b7f43da0...d212cef936d689d2a3b0932e678fce255362c72a,1,10,3,13,1,2010-09-27 18:40:45,2010-09-26 05:20:18
d212cef936d689d2a3b0932e678fce255362c72a...b822423ed20df158a478c9522373bffb04fa5ecc,1,6,10,16,2,2010-09-27 18:41:25,2010-09-27 02:49:13
b822423ed20df158a478c9522373bffb04fa5ecc...61ef5e9b56e1c16f6d3c142e2c63f6e2c720c64e,1,1,1,2,1,2010-09-27 18:41:45,2010-09-27 03:18:01
61ef5e9b56e1c16f6d3c142e2c63f6e2c720c64e...9d14017adafc4829efc9e1393653579ad1d8ed71,1,1,1,2,1,2010-09-27 18:43:12,2010-09-16 20:53:22
9d14017adafc4829efc9e1393653579ad1d8ed71...442cb08fa0dca38c99cf1ff8a5654a95a5cad7a4,1,8,8,16,1,2010-09-27 22:08:06,2010-09-27 19:14:57
9027fa9eb7df606b6658dd48a40bb993ce222ddd...6355e505bacf0a12a5de77bcd0c1198e74ad340b,2,11,1,12,2,2010-09-27 17:39:54,2010-09-27 17:29:45
d4da4bc764625a9d9d19aec61bc2bb0ddff30d2b...95ae69b95ba595d884d31a5cee92a823ec0c705f,1,1,2,3,2,2010-10-05 15:41:58,2010-10-04 22:51:47
95ae69b95ba595d884d31a5cee92a823ec0c705f...9173912be36c4f967f42f176be767fc5ba3c4077,1,19,13,32,3,2010-10-06 17:46:05,2010-10-04 04:34:27
9173912be36c4f967f42f176be767fc5ba3c4077...349362cc207c96bbf31f503db989f0289c13c05d,3,11,10,21,11,2010-10-06 17:46:45,2010-10-04 09:09:17
349362cc207c96bbf31f503db989f0289c13c05d...b90d9b889588ca1cfd5667d1fa703d976edd71ee,1,10,3,13,1,2010-10-06 17:51:14,2010-10-04 10:53:11
b90d9b889588ca1cfd5667d1fa703d976edd71ee...c03c83152d6ce6fa5ae49a8698da5fc25a53127f,4,15,3,18,4,2010-10-06 18:10:07,2010-10-05 07:24:10
c03c83152d6ce6fa5ae49a8698da5fc25a53127f...6db2103f92cf6c5caeeddec0bfd5f57f94e81d81,1,6,1,7,1,2010-10-06 18:24:17,2010-10-04 17:28:27
dbdf5854b21852676de6a8baf052147217ce809b...3ddf0968c2f64a9f9fa6880d9c22d40459c88335,2,2,4,6,3,2011-05-24 23:20:48,2011-05-24 22:49:36
3ddf0968c2f64a9f9fa6880d9c22d40459c88335...5a0c9eeb89a19a05cbc2bf570f69f1724ef873dd,1,11,4,15,2,2011-05-24 23:20:56,2011-05-24 22:49:45
5a0c9eeb89a19a05cbc2bf570f69f1724ef873dd...06eb708f331f0829081f4f3fb3c465eaae345deb,2,18,40,58,11,2011-05-24 23:25:36,2011-05-24 22:49:55
06eb708f331f0829081f4f3fb3c465eaae345deb...73546c085d49694c5e54b421f80bde6bc25006fb,2,3,5,8,5,2011-05-24 23:25:46,2011-05-24 22:50:35
dbdf5854b21852676de6a8baf052147217ce809b...337e51cedfdf1f98e1c151b72f06c7ca8bcea0fd,1,35,12,47,11,2010-12-22 22:34:24,2010-11-26 15:32:34
337e51cedfdf1f98e1c151b72f06c7ca8bcea0fd...e6aea2dba27798f5d1eca32435e407541caca400,5,51,37,88,41,2010-12-22 22:34:24,2010-11-26 15:32:35
e6aea2dba27798f5d1eca32435e407541caca400...1cd8031b2d2e937239918a3a498b1b217a198cc1,1,9,10,19,7,2010-12-22 22:34:24,2010-11-26 15:32:36
1cd8031b2d2e937239918a3a498b1b217a198cc1...101662c22518de4abfbd5b2fc38b3ec1fa638494,1,8,0,8,1,2010-12-22 22:34:24,2010-11-26 15:32:37
101662c22518de4abfbd5b2fc38b3ec1fa638494...9951d3b37ec7298384640b11d07a990ef031fe83,2,48,48,96,19,2010-12-22 22:34:24,2010-11-26 15:32:38
9951d3b37ec7298384640b11d07a990ef031fe83...b3f66fd3e3abeb9183f33f023727e3a53868849d,2,221,203,424,158,2010-12-22 22:34:24,2010-11-26 15:32:39
b3f66fd3e3abeb9183f33f023727e3a53868849d...835183603b4aed84797f60c91c5ebd79be7b2e11,3,19,28,47,10,2010-12-22 22:34:24,2010-11-26 15:32:40
835183603b4aed84797f60c91c5ebd79be7b2e11...4ad8332ef79c53fd7c214fcbe24a29ff243a531e,1,56,0,56,1,2010-12-22 22:34:24,2010-11-26 15:32:41
4ad8332ef79c53fd7c214fcbe24a29ff243a531e...98acf75985d15e8c53f1dfa1721b1e1128101737,1,8,15,23,3,2010-12-22 22:34:25,2010-11-26 15:32:42
98acf75985d15e8c53f1dfa1721b1e1128101737...e7d1efbe9dc5c03e65a573d6f8c4d8804118eb0a,1,1,1,2,1,2010-12-22 22:34:25,2010-11-26 15:32:43
e7d1efbe9dc5c03e65a573d6f8c4d8804118eb0a...0ed748134748579a13cf27e1e8b3e55371bcd9dc,5,38,0,38,5,2010-12-27 16:34:19,2010-12-27 01:26:04
bb34c5aabe9f8d86a40d5ab8518fc78602264179...185528a859170a659ae8359d13540211775e3056,1,2,0,2,2,2011-10-18 17:34:07,2011-10-18 16:25:50
bb34c5aabe9f8d86a40d5ab8518fc78602264179...52de4db57977175c5ad1d6c3922e772d6de08496,2,75,8,83,6,2010-11-04 23:53:50,2010-11-04 01:35:13
52de4db57977175c5ad1d6c3922e772d6de08496...ef7108caf3cd200620000921f1b121f8c78d9d3b,2,9,0,9,2,2010-11-04 23:53:50,2010-11-04 01:35:14
ef7108caf3cd200620000921f1b121f8c78d9d3b...82fc07b7baa6f9e188025cc06a87ebc60a6f2d5e,2,22,0,22,2,2010-11-04 23:53:50,2010-11-04 01:35:15
82fc07b7baa6f9e188025cc06a87ebc60a6f2d5e...30e1560230bc0154230b315a5f7c4f46870f9c81,1,47,46,93,17,2010-11-04 23:53:50,2010-11-04 01:35:16
30e1560230bc0154230b315a5f7c4f46870f9c81...48cfaea10879790ba6d2c8b566a0df75c411672d,1,4,2,6,4,2010-11-04 23:53:51,2010-11-04 01:35:17
48cfaea10879790ba6d2c8b566a0df75c411672d...cbefd2d6322bff0033fd50bfe175c52b79933571,1,21,7,28,6,2010-11-04 23:53:51,2010-11-04 01:35:18
cbefd2d6322bff0033fd50bfe175c52b79933571...f9c87be6b42dd0f8b31a4bb8c6a44326879fdd1a,1,39,40,79,9,2010-11-04 23:53:51,2010-11-04 01:35:19
f9c87be6b42dd0f8b31a4bb8c6a44326879fdd1a...49521af8a818039f8daf18f2160c4d1e7dbb4270,2,650,0,650,2,2010-11-04 23:53:51,2010-11-04 01:35:20
49521af8a818039f8daf18f2160c4d1e7dbb4270...fdc12114635581b6901940ddb467a78716bc12ca,5,6,81,87,9,2010-11-04 23:53:51,2010-11-04 01:35:21
fdc12114635581b6901940ddb467a78716bc12ca...c295cf06608cb07a132abef5802366522fd2f5e0,1,3,3,6,3,2010-11-04 23:53:52,2010-11-04 01:35:22
c295cf06608cb07a132abef5802366522fd2f5e0...9cddf56ef13c8575ac0c68d82e6196e5b0a2900d,2,6,5,11,4,2010-11-04 23:53:52,2010-11-04 01:35:23
9cddf56ef13c8575ac0c68d82e6196e5b0a2900d...a666b472c7d9e72bfacf4145405dbe8924ee153d,2,73,29,102,14,2010-11-04 23:53:52,2010-11-04 01:35:24
92c62a3f4f93432c0c82e3031a9e64e03ba290f7...d577cd216e0adb9cbc726dddd1a0858b4ab4e6e3,1,10,0,10,1,2011-12-20 22:01:41,2011-12-20 21:42:39
6079ec6680da5e40d15d981c24051e9bf5c226fc...56a5f3afa74c70261dd2319ad76a6810e102026c,1,1,1,2,1,2010-12-09 19:20:25,2010-12-09 06:42:25
56a5f3afa74c70261dd2319ad76a6810e102026c...1e1ade1833db42a75f2792b4472748721f73c827,1,6,6,12,3,2010-12-09 19:20:25,2010-12-09 06:43:32
1e1ade1833db42a75f2792b4472748721f73c827...3cfa4db3226ccef8845589029090d9398b207ba3,1,33,5,38,11,2010-12-09 19:20:26,2010-12-09 06:46:08
3cfa4db3226ccef8845589029090d9398b207ba3...d1645d02defe43fa5b43140050ba265fcc49fa70,1,22,15,37,10,2010-12-09 19:20:26,2010-12-09 06:47:29
6079ec6680da5e40d15d981c24051e9bf5c226fc...f34e9edc7bbb41c52ff6a17dbffbef3d4979ee25,1,6,6,12,3,2010-12-07 21:13:21,2010-12-07 09:07:11
2de3c142d3dc4ef329a3984af32583cf1e5af432...1c2ab4303354da23ff74ce2ea4a99b69fcfae825,1,37,10,47,9,2010-12-02 22:33:26,2010-12-02 22:33:26
d8a94803842989582989fd5f5c3062c49134ad5b...1ee1e43df37e53b0bc50a0eda57dd1772dc220f5,4,30,9,39,13,2010-08-31 18:07:34,2010-08-31 15:56:50
d8a94803842989582989fd5f5c3062c49134ad5b...16034fbe59e88ec9592f73523cde97714d7c727c,1,9,1,10,1,2010-08-31 16:53:56,2010-08-31 15:56:36
16034fbe59e88ec9592f73523cde97714d7c727c...a54ce3ca9e780f824f07519a6db83fe2d7575734,1,3,0,3,1,2010-08-31 16:54:37,2010-08-31 15:56:53
a54ce3ca9e780f824f07519a6db83fe2d7575734...5c8e141414058430155ea179bce38ceb8d750c5d,1,6,1,7,1,2010-08-31 18:09:21,2010-08-31 17:10:55
5c8e141414058430155ea179bce38ceb8d750c5d...d0b8a61742714b93b614f9823491a7557879dfb9,1,3,0,3,1,2010-08-31 18:40:20,2010-08-31 17:26:57
3089c2b97a4d73866375a0ba815fc2fa4e2a1c1e...54aae5e1a08cb8c788d6f7345ca29898a5941140,1,41,0,41,1,2010-11-05 21:21:05,2010-10-19 18:46:31
54aae5e1a08cb8c788d6f7345ca29898a5941140...db54c8e710397fbd58892daead6181b424d6d70a,3,25,7,32,4,2010-11-12 21:44:26,2010-11-12 14:55:08
71786f54c4128821eab8a23f258848c76b5a2071...9180feafbc7c637a4fae72d1ca1d3b2245b4302c,2,6,1,7,2,2012-05-30 18:59:08,2012-05-30 16:39:42
71786f54c4128821eab8a23f258848c76b5a2071...caf038cb4ec224ce2fcc241de302a7b37f73963e,2,2,4,6,3,2011-02-10 22:08:08,2011-02-06 18:43:43
caf038cb4ec224ce2fcc241de302a7b37f73963e...cc1453e1dadc750a2d5c68b0e053b2221d212ef6,2,7,19,26,7,2011-02-10 22:08:08,2011-02-06 18:43:44
cc1453e1dadc750a2d5c68b0e053b2221d212ef6...f4107d9cdce49177a056353a162d82555595850e,1,7,7,14,2,2011-02-10 22:08:08,2011-02-06 18:43:45
f4107d9cdce49177a056353a162d82555595850e...cb82a05d5e2277d2019c43cadf8abee8bc6f97b6,1,9,10,19,9,2011-02-10 22:08:09,2011-02-06 18:43:46
cb82a05d5e2277d2019c43cadf8abee8bc6f97b6...fa99c1e1e16d347a354c817d96c5abbd5a08fcd8,4,167,151,318,14,2011-02-10 22:08:09,2011-02-06 18:43:47
fa99c1e1e16d347a354c817d96c5abbd5a08fcd8...46df82d5fa0f83d3c1108ad70248877d6d9b56bb,4,38,29,67,9,2011-02-10 22:08:09,2011-02-06 18:43:48
46df82d5fa0f83d3c1108ad70248877d6d9b56bb...89c7ae9c3bffe599b46a18a9a504fd3e28a9e715,1,1,3,4,1,2011-02-10 22:08:09,2011-02-06 18:43:49
89c7ae9c3bffe599b46a18a9a504fd3e28a9e715...431b7e7818fe3d118e4bf9e40ba6807ed2c511be,1,59,61,120,44,2011-02-10 22:08:09,2011-02-06 18:43:50
431b7e7818fe3d118e4bf9e40ba6807ed2c511be...4974c2caa215a78dd0c6e3665e23e029d98cbbeb,2,16,16,32,4,2011-02-10 22:08:09,2011-02-06 18:43:51
4974c2caa215a78dd0c6e3665e23e029d98cbbeb...2959c283662c62e90d08d3795073534f278deee6,2,18,33,51,9,2011-02-10 22:08:09,2011-02-06 18:43:52
2959c283662c62e90d08d3795073534f278deee6...84df4560ed92a771d38081ecca2d40ca35811907,4,16,16,32,8,2011-02-10 22:08:09,2011-02-06 18:43:53
84df4560ed92a771d38081ecca2d40ca35811907...7b37a7c6204998faa80a4bdc1e1ab824bd37d941,2,4,4,8,4,2011-02-10 22:08:09,2011-02-06 18:43:54
7b37a7c6204998faa80a4bdc1e1ab824bd37d941...80ff47957b3a8ae057178a7b1113d171404e938f,3,35,2,37,5,2011-02-10 22:08:09,2011-02-06 18:43:55
80ff47957b3a8ae057178a7b1113d171404e938f...b3e4847e50cf0ab3da4ad9664a5e4382e778ebd5,2,25,0,25,3,2011-02-10 22:08:09,2011-02-06 18:43:56
b3e4847e50cf0ab3da4ad9664a5e4382e778ebd5...b325680930c007f87d35fdc60566b3441fedc7c3,1,1,1,2,1,2011-02-10 22:08:09,2011-02-06 18:43:57
b325680930c007f87d35fdc60566b3441fedc7c3...c5e610be5049f04b3ab8370bb8d1649347d2db87,1,2,2,4,2,2011-02-10 22:08:10,2011-02-06 18:43:58
c5e610be5049f04b3ab8370bb8d1649347d2db87...c6f7de5455269ac1fcd268cd3bf592a0f74c1ef8,1,0,1,1,1,2011-02-10 22:08:10,2011-02-06 18:43:59
c6f7de5455269ac1fcd268cd3bf592a0f74c1ef8...c71f8f3d501b155c3efa6aea2bc7768f7ace8cd1,1,0,19,19,5,2011-02-10 22:08:10,2011-02-06 18:44:00
c71f8f3d501b155c3efa6aea2bc7768f7ace8cd1...15a147e61898d25ec8b539190e87f3a09592c9c8,6,85,46,131,10,2011-02-10 22:45:25,2011-02-10 01:54:02
15a147e61898d25ec8b539190e87f3a09592c9c8...fdb76c104af5196fe1faf6d84209daf752e87010,2,3,3,6,2,2011-02-25 20:19:41,2011-02-25 03:32:06
fdb76c104af5196fe1faf6d84209daf752e87010...45e2acf3d33b2bc635f14af0c1d9ce698328954f,1,56,45,101,15,2011-03-05 00:10:06,2011-03-01 01:59:26
478c44658e9c92c2c17ab4775f3c31ea713ec7de...6db5c6e43dccb380ca6e9947777985eb11248c31,2,6,2,8,3,2012-01-13 07:43:28,2012-01-13 07:43:28
adda3c3beb0a244719becb1895e16227b0393bd1...cb6a22c0760f30ff8050b508b9fabbe13ffba1ae,3,21,1,22,10,2010-04-15 19:07:51,2010-04-13 09:07:13
cb6a22c0760f30ff8050b508b9fabbe13ffba1ae...bb15e38281aab342a0e3ca7d5663b0c3f9d5e72e,2,7,0,7,2,2010-04-15 19:15:17,2010-04-15 12:27:49
adda3c3beb0a244719becb1895e16227b0393bd1...f78683f3a85ca16ae16e1180703d3280b272f45d,1,1,1,2,1,2010-04-13 19:27:19,2010-04-13 16:52:55
b92cbb62def240268c1af39f1a688fec8d34ac9b...b9aa901856cee7ad16737343f6a372bb37871258,1,4,1,5,2,2010-04-10 20:05:16,2010-04-10 20:05:16
a751b5cc96c87be3b794a9e24c2beb7a8740c645...df5753c4f6398c1b0a9f5bd4b24d7bf47a33533f,1,24,11,35,7,2010-04-07 23:04:09,2010-04-07 22:59:17
a751b5cc96c87be3b794a9e24c2beb7a8740c645...e3af3cfc401420242a4a8873405f62e1aee5355b,1,10,10,20,7,2010-04-07 21:32:51,2010-04-07 20:57:11
657ab61efa918f46f1b412613643d1a1bbed2194...da1fbed3fff6ed2d64399ff26d8a9ab3bcf00540,1,11,6,17,5,2010-03-30 21:46:33,2010-03-30 17:36:03
da1fbed3fff6ed2d64399ff26d8a9ab3bcf00540...852f098c0667abc634f5aba0b91e0317f714fa67,1,18,2,20,2,2010-03-30 23:34:04,2010-03-30 07:46:23
852f098c0667abc634f5aba0b91e0317f714fa67...09f53b16bc65e14b116a275b3c569b2aa8040ad8,1,1,1,2,1,2010-03-30 23:49:19,2010-03-30 17:20:57
09f53b16bc65e14b116a275b3c569b2aa8040ad8...e4762865c88050745a20a62c64b4ffa542e88c3a,1,2,1,3,1,2010-03-31 15:15:02,2010-03-31 09:24:19
e4762865c88050745a20a62c64b4ffa542e88c3a...7a49c254cdaec6b15a6e2818e29fdb34fc6f7717,1,1,2,3,1,2010-03-31 17:57:04,2010-03-27 19:26:59
7a49c254cdaec6b15a6e2818e29fdb34fc6f7717...21e403a7b956a95a36f218439f82b1c8af869257,1,2,0,2,1,2010-03-31 21:21:39,2010-03-29 10:22:19
21e403a7b956a95a36f218439f82b1c8af869257...21704227904b51197976c61c595b52d807677533,1,2,0,2,2,2010-03-31 21:22:06,2010-03-29 10:57:48
21704227904b51197976c61c595b52d807677533...4318d3ba8fcb136a6ba3beaebaac8f47086bbf5f,1,1,1,2,1,2010-03-31 21:22:17,2010-03-29 11:02:37
5977744d045cacb809a3e3630dbbd28fe83976ae...049e98c875682de2f5638b83e91bfbef5cfbf521,1,33,4,37,11,2010-06-18 18:27:01,2010-06-18 18:27:01
371276bf29314af04b804cfd877abcac62674a58...81c13fde379c46cad6b6e4a03ed7ee4f686c030f,1,9,5,14,2,2010-06-01 01:11:10,2010-03-05 15:56:39
371276bf29314af04b804cfd877abcac62674a58...811dd906dbb391544085a3a7ca6cfc7b53d33131,1,1,1,2,1,2010-06-01 01:05:17,2010-05-26 12:36:10
371276bf29314af04b804cfd877abcac62674a58...c5b41519c723ec1966e5f2d6326862095bfa7bb8,1,17,11,28,5,2010-06-01 00:50:03,2010-05-30 08:41:53
c5b41519c723ec1966e5f2d6326862095bfa7bb8...b831deda174da7864ca5d529f53296af3f41ee18,1,21,19,40,10,2010-06-11 15:47:48,2010-06-01 07:25:23
371276bf29314af04b804cfd877abcac62674a58...a6c6060a0ac04150403b7be420f962c167c27565,1,1,2,3,2,2010-06-01 00:47:36,2010-05-30 17:12:41
3bf7886705b4ea7189f046fa5258fdf6edcdbe23...9d488eb40e253c82dd09811d5eda20f5f8e480c9,4,3,3,6,3,2010-05-08 04:36:27,2010-05-07 19:37:01
9d488eb40e253c82dd09811d5eda20f5f8e480c9...621fd7a287dbb9279e18a6932c7037a8c4d224ef,1,4,2,6,1,2010-05-08 04:36:38,2010-05-07 19:37:03
3bf7886705b4ea7189f046fa5258fdf6edcdbe23...509de65f3b033838357b82d8ebc0ed73445a4fc5,1,6,4,10,4,2010-05-07 16:34:59,2010-05-07 04:51:57
3bf7886705b4ea7189f046fa5258fdf6edcdbe23...9ca5df90615aa3c6b60e1bc8f03db6cae98e816c,5,14,16,30,10,2010-05-07 16:34:27,2010-05-07 04:52:27
3bf7886705b4ea7189f046fa5258fdf6edcdbe23...b6b0afdc30e066788592ca07c9a6c6936c68cc11,2,25,3,28,4,2010-05-06 20:16:14,2010-05-06 08:41:10
b6b0afdc30e066788592ca07c9a6c6936c68cc11...cfb88e9a8d4926b0011ae2dd67e1f57a98f4b768,1,4,4,8,2,2010-05-08 04:38:50,2010-05-05 14:16:25
cfb88e9a8d4926b0011ae2dd67e1f57a98f4b768...e5bd0a1b362ecc4bcd03a4d3628c7e78f861f3ca,1,1,1,2,1,2010-05-08 18:14:40,2010-05-08 17:36:15
e5bd0a1b362ecc4bcd03a4d3628c7e78f861f3ca...43acff34b902c38808ac0f326090f2516250e1f0,1,7,2,9,1,2010-05-08 23:56:21,2010-05-08 23:17:29
3bf7886705b4ea7189f046fa5258fdf6edcdbe23...fb7749e4e4d4d9fef61f35b2f8b40f80c2d5942f,2,59,7,66,3,2010-05-04 22:28:08,2010-05-02 08:57:12
a43948bae9a5c95731f089c14f3379394ff2f380...f737684d34215f029376f65770c401c2d2b24fe4,1,2,1,3,1,2013-10-14 23:20:01,2013-10-06 20:51:31
f737684d34215f029376f65770c401c2d2b24fe4...9371322a60932ca91ed8e27f88eb7af92df29716,1,3,0,3,1,2013-10-14 23:22:28,2013-10-06 20:52:21
9371322a60932ca91ed8e27f88eb7af92df29716...2b7ca916fcffafe9cfd967cce87436a9372ae969,1,1,1,2,1,2013-10-14 23:28:38,2013-10-04 14:34:53
dee40e5178bab78aaf655ee4323f3141acd17654...f4b05a4947f5f1cf3e01fb61ec5919cc28fe11f7,7,163,21,184,27,2010-12-01 22:47:51,2010-11-30 08:29:11
b76c056b95ccb15ae3b0723da983914de88b4bae...aed6ca52e73a35d0aac9aba7d631e09983e46a6f,1,2,2,4,2,2010-04-09 06:30:49,2010-04-09 06:30:49
b76c056b95ccb15ae3b0723da983914de88b4bae...40d52ff77b093fa48f58a168f4b0c4e65b862e56,6,72,72,144,8,2010-04-02 06:53:54,2010-04-02 00:05:23
40d52ff77b093fa48f58a168f4b0c4e65b862e56...a941d5e3958ece565570a2dc3a5476ff5242f340,3,116,0,116,4,2010-04-02 06:58:30,2010-04-02 00:07:40
a941d5e3958ece565570a2dc3a5476ff5242f340...840383b2c2bd7179604f5c2595bf95e22a4e0c84,1,30,36,66,5,2010-04-02 07:01:57,2010-04-02 00:09:26
840383b2c2bd7179604f5c2595bf95e22a4e0c84...d9bae1a178f0f8b198ea611e874975214ad6f990,5,185,9,194,16,2010-04-02 07:05:31,2010-04-02 00:12:15
d9bae1a178f0f8b198ea611e874975214ad6f990...b3373982667dc983b8dacf33861d25b20bafb995,1,4,5,9,2,2010-04-02 07:11:20,2010-04-02 00:14:24
1f2362a944e09883cf1905e40b98554f488ed041...4c926b37c21a088163871bb8e6ccdfc4b4952e34,1,10,0,10,1,2010-04-03 04:25:47,2010-04-02 12:27:20
4c926b37c21a088163871bb8e6ccdfc4b4952e34...4bb6644d03f6932b94c24c3825e28865f493b692,2,10,1,11,3,2010-04-03 04:25:59,2010-04-02 21:44:21
4bb6644d03f6932b94c24c3825e28865f493b692...b2f6fd95756de395bd8df77a4069e45b534eab26,1,15,0,15,1,2010-04-03 18:25:13,2010-04-03 10:11:57
1f2362a944e09883cf1905e40b98554f488ed041...6555b196f00128f13ab8f719ee1e156238f16bb3,1,2,1,3,1,2010-04-03 04:24:30,2010-04-02 07:52:09
4e7d08a229a531f8d7841a8a1a892d5989130d67...0d0925c5e25fad8079739be36d88faa21fc1f588,1,34,2,36,6,2010-03-20 18:42:34,2010-03-20 18:42:34
82cd8358e8203fa02da18e8ee71449cb45c4157d...56a853b62c0ae7ebaad0a7a0a704f5ef561eb795,1,17,10,27,3,2010-03-02 20:52:51,2010-03-02 11:47:52
56a853b62c0ae7ebaad0a7a0a704f5ef561eb795...f206063b4b201ff48c87b886cbe21a068fcf6d49,4,41,3,44,5,2010-03-05 06:05:13,2010-03-04 19:59:50
c0129439d034a59ca761bcd6e0d50becbee80cee...644a36908d6b52cb8c0c4d1ac69fd0b451e38f13,1,22,18,40,18,2012-01-12 02:08:22,2012-01-11 18:15:56
644a36908d6b52cb8c0c4d1ac69fd0b451e38f13...043a4492b3b7da6496617201c369cff6ab7c26f2,3,956,947,1903,13,2012-01-12 02:11:49,2012-01-11 18:15:57
7d883c70a3c0eda163eb452651d5bc4c4c885e34...7e02a6c63a183270b726bb21640059ae16fa48ae,3,29,2,31,3,2011-12-05 23:49:34,2011-12-05 23:49:34
0f64a5a3a25c9a161c4e70ae031c885a6284ddb8...f80a87262aa4468b0941d38deffdb97a757307c5,7,49,25,74,23,2011-11-22 21:30:35,2011-11-22 11:14:29
f80a87262aa4468b0941d38deffdb97a757307c5...dffc86002862753376e31a16a1c1c0306716fbe6,1,24,24,48,6,2011-11-22 21:33:01,2011-11-22 11:15:10
dffc86002862753376e31a16a1c1c0306716fbe6...b8c74690b20b7c4dd405f71d63bab325447356da,1,6,7,13,3,2011-11-22 21:33:49,2011-11-22 11:15:47
b8c74690b20b7c4dd405f71d63bab325447356da...82433cdf4d888639cecddeca162d619cf370417e,4,61,3,64,6,2011-11-22 21:34:44,2011-11-22 11:17:36
82433cdf4d888639cecddeca162d619cf370417e...539047c19ec040819b6f6af2d55714195b812abb,5,185,3,188,19,2011-11-23 02:16:59,2011-11-23 01:27:21
539047c19ec040819b6f6af2d55714195b812abb...c427b211b3f5d3f967e5fc7abd526b02f83a7246,2,2,5,7,3,2011-11-23 02:18:02,2011-11-22 11:20:46
9e9ab407119d9b89a99bbf9e496428cac2f94468...f56ef114eeefee755f422e6cbef2d83974cb90f1,1,1,1,2,1,2011-11-18 22:19:45,2011-11-18 22:19:45
d2c78075496d818d04cc04583b35af117c3a95ed...9859a023fef30ffebdd22ad9639c587ac720b8b6,1,36,1,37,2,2011-12-09 21:52:39,2011-12-09 21:52:36
82ca50556471eadfc3212cb478161c3da5c4d02a...4fddf5798d8a0eb112c60a05272a2d9407eafc8f,2,20,0,20,2,2006-10-02 06:32:39,2006-10-02 05:22:07
4fddf5798d8a0eb112c60a05272a2d9407eafc8f...6fe5b7ff6cafcc94415deba2f3d611770d8e6b1e,1,4,4,8,3,2006-10-02 07:43:52,2006-10-02 07:43:52
551029af305e04bed638771a3932e376243dddcb...8112894d82637c199294702942cac477b756b678,3,5,1,6,3,2006-09-14 06:38:46,2006-09-14 01:03:59
8112894d82637c199294702942cac477b756b678...b85c4bbbd7d16c084f0b2f0eb9678149d08d09e8,3,3,3,6,3,2006-09-14 06:39:33,2006-09-14 01:04:33
b85c4bbbd7d16c084f0b2f0eb9678149d08d09e8...38529e28a4f465ad5d5f2fa249ca17da680bac5f,3,4,4,8,4,2006-09-14 06:39:43,2006-09-14 02:24:04
38529e28a4f465ad5d5f2fa249ca17da680bac5f...7977f0ea53fad7103c83e5bd61777da27451f1d6,1,11,4,15,6,2006-09-14 18:46:11,2006-09-14 17:45:12
7977f0ea53fad7103c83e5bd61777da27451f1d6...5b6df8e45f31c7eb26c30536448cffe1b715e1ce,3,3,3,6,3,2006-09-14 18:48:11,2006-09-14 01:04:09
5b6df8e45f31c7eb26c30536448cffe1b715e1ce...c0011ff8c83f200139267492589575970fb72afc,1,20,10,30,1,2006-09-15 05:38:19,2006-09-14 20:18:59
c0011ff8c83f200139267492589575970fb72afc...c83a77e4e139303a8a830b2ba7802bed0b8fe9d9,1,19,22,41,4,2006-09-15 05:41:13,2006-09-15 01:43:28
c83a77e4e139303a8a830b2ba7802bed0b8fe9d9...fc2b2be031f44aef0106cf7f872b750cd90b2253,1,25,0,25,2,2006-09-15 05:54:40,2006-09-15 02:56:03
fc2b2be031f44aef0106cf7f872b750cd90b2253...d48ffdbb0b2580c6ff58da7cedbf78785ba6121b,1,0,1,1,1,2006-09-15 20:46:07,2006-09-15 20:46:07
d48ffdbb0b2580c6ff58da7cedbf78785ba6121b...17fd965d215060a10911db99c2dacf9c3554787a,1,8,1,9,2,2006-09-16 01:37:01,2006-09-16 01:37:01
17fd965d215060a10911db99c2dacf9c3554787a...d0c2449f7805ee35b97c5dcb22845f157da1cea4,2,8,2,10,2,2006-09-16 05:47:21,2006-09-16 05:47:21
d0c2449f7805ee35b97c5dcb22845f157da1cea4...a1565c447d441234e227fa6881d26eaf227367e3,1,10,7,17,8,2006-09-16 09:03:11,2006-09-15 17:30:34
a1565c447d441234e227fa6881d26eaf227367e3...9d0734ae49c8c0a5a2c6b6bf85011d095182e357,1,10,1,11,2,2006-09-16 09:04:24,2006-09-15 09:11:33
9d0734ae49c8c0a5a2c6b6bf85011d095182e357...e7676d2f6454c9c99e600ee2ce3c7205a9fcfb5f,1,9,1,10,4,2006-09-16 09:21:11,2006-09-11 19:03:15
7bbf88c52b202d543310123e1bad9a44b2d6f028...6ff88de7f7affba3e9899cfdab4dab46b554e93f,1,5,2,7,2,2006-09-07 20:02:29,2006-09-07 11:48:08
6ff88de7f7affba3e9899cfdab4dab46b554e93f...baf1219acbda6ba361c388363ba2e771d95bbb2d,2,13,1,14,4,2006-09-07 20:04:21,2006-09-07 11:48:49
baf1219acbda6ba361c388363ba2e771d95bbb2d...2878836c5074be92b913c95446b94bbf1c9a9e1d,1,1,0,1,1,2006-09-07 20:04:33,2006-09-07 12:30:06
7bbf88c52b202d543310123e1bad9a44b2d6f028...c64ed70d2557101f2a2c3f76315049d027fe645b,4,130,99,229,9,2006-09-07 09:46:01,2006-09-05 04:50:12
c64ed70d2557101f2a2c3f76315049d027fe645b...b5d97e6b0a044b11b409250189c61d40209065f2,1,215,82,297,10,2006-09-07 09:46:01,2006-09-05 06:47:39
b5d97e6b0a044b11b409250189c61d40209065f2...8d1d8f83b5d918c6071b606e321de9c31fed9e68,4,85,93,178,24,2006-09-07 09:46:02,2006-09-06 08:42:23
8d1d8f83b5d918c6071b606e321de9c31fed9e68...106d710bc13f34aec1a15c4cff80f062f384edf6,6,47,15,62,19,2006-09-07 09:46:03,2006-09-06 09:12:09
106d710bc13f34aec1a15c4cff80f062f384edf6...4321134cd85eabc5d4d07a7ce00d4cf6a02c38fb,2,21,2,23,4,2006-09-13 05:59:15,2006-09-13 05:59:15
7bbf88c52b202d543310123e1bad9a44b2d6f028...2b6eef943ff81df63a809857b7b400ee175eb29b,3,11,25,36,8,2006-09-07 09:44:40,2006-09-07 05:45:21
2b6eef943ff81df63a809857b7b400ee175eb29b...82793c55e45ea1c7306ff396d8ce316241e584da,1,7,1,8,2,2006-09-07 09:44:41,2006-09-07 07:54:22
7bbf88c52b202d543310123e1bad9a44b2d6f028...c727fe2afcb86195d72136b4b3ba4b5fea5514d5,1,70,35,105,8,2006-09-07 09:44:25,2006-09-05 21:52:12
51a7c66a73ce74fad3b7b05109ed6ce013202fa5...bc108f63dad7a5f6d95418cb78a587f5f570eae6,1,1,1,2,1,2006-10-05 23:36:15,2006-10-05 23:36:15
bc108f63dad7a5f6d95418cb78a587f5f570eae6...abd6970acad5d758f48c13f7420367ae8216038e,2,23,12,35,7,2006-10-06 00:54:14,2006-10-06 00:54:14
51a7c66a73ce74fad3b7b05109ed6ce013202fa5...d7014dc0811eb24f418830a30dacc203c1a580f4,2,2,1,3,2,2006-10-05 22:10:40,2006-10-03 21:09:56
51a7c66a73ce74fad3b7b05109ed6ce013202fa5...506e49ff9ff2b5be34b2bdf15c88038b00d3ef66,1,100,100,200,73,2006-10-05 22:05:41,2006-10-05 21:00:55
506e49ff9ff2b5be34b2bdf15c88038b00d3ef66...eb93b7240665e35ecc0ed72098e1a5b3352bdc17,1,9,5,14,5,2006-10-05 22:05:41,2006-10-05 21:06:22
eb93b7240665e35ecc0ed72098e1a5b3352bdc17...cf54a029ff82ce9b565e075bfa5d97ec82841283,1,38,4,42,11,2006-10-05 22:05:41,2006-10-05 21:06:26
cf54a029ff82ce9b565e075bfa5d97ec82841283...c137f40f8a9dfe05ee002cf5f23bf562c1f13100,1,45,31,76,4,2006-10-05 22:05:41,2006-10-05 21:06:42
c137f40f8a9dfe05ee002cf5f23bf562c1f13100...b5c698d947c236559e338e45c6234ece7c819338,1,127,22,149,18,2006-10-06 07:13:25,2006-10-05 21:07:42
ccbb3d17ace70be9d986368d3df795f5961e9683...4777b0141a4812177390da4b6ebc9d40ac3da4b5,1,22,6,28,9,2006-10-24 03:55:26,2006-10-24 03:36:10
4777b0141a4812177390da4b6ebc9d40ac3da4b5...88ad729b73264025d2d4c187ff74432d7cacafb2,2,47,16,63,12,2006-10-24 03:55:38,2006-10-24 03:15:46
88ad729b73264025d2d4c187ff74432d7cacafb2...8be2890c994102d5748342f44bd6353bd482b58b,1,4,3,7,3,2006-10-24 03:55:41,2006-10-24 03:18:39
8be2890c994102d5748342f44bd6353bd482b58b...447ef09a5cf98bea28ec5123b968c966afce5772,1,8,0,8,1,2006-10-24 03:55:44,2006-10-24 03:23:46
447ef09a5cf98bea28ec5123b968c966afce5772...f2069411c9b5b5c99756cdfb2e54a61aef5c9f72,1,2,11,13,3,2006-10-25 04:16:44,2006-10-24 11:52:46
f2069411c9b5b5c99756cdfb2e54a61aef5c9f72...62fae51dd57b36cfbb25c9ade539ea5a6ef5ad84,1,6,1,7,2,2006-10-25 04:23:41,2006-10-24 11:54:49
62fae51dd57b36cfbb25c9ade539ea5a6ef5ad84...82560983997c961d9deafe0074b787c8484c2e1d,1,5,3,8,1,2006-10-25 04:36:42,2006-10-24 11:55:33
4b4a5dbb17e1136275665024689625ed5cc5a03d...eeef88cd20f2965325cde66e97a616bce4a757f0,1,44,21,65,9,2006-10-06 07:16:09,2006-10-05 20:55:58
eeef88cd20f2965325cde66e97a616bce4a757f0...d15c55aa052434aee75c73da4ed771af3e3b6f61,1,1,1,2,1,2006-10-11 08:15:36,2006-10-11 07:30:05
7a6a5e406297792075ca20a63427dd37ee4ecb01...87b787ac77e0d8f81468dcba2a39c9d0287870c3,1,24,37,61,14,2006-10-20 23:51:15,2006-10-20 19:38:31
4e273c9dcfe8e898ea43b17213c47733a4fef842...07efc6a6b6e5098ccd2dcce853be421b7dd1e244,1,1,1,2,2,2006-08-05 00:30:24,2006-08-04 21:01:30
5df7dbbae4a51e20afc00acc5c87ea4536d1302c...38db01b7fbbf5c043dc7d397789bd8cf102b76ae,1,1,1,2,1,2013-10-24 22:41:01,2013-10-24 08:42:17
5df7dbbae4a51e20afc00acc5c87ea4536d1302c...7099c9c7c9c14ca3f66b8a04219162e6f259ff37,2,4,4,8,4,2006-08-24 04:24:47,2006-08-24 04:24:47
7099c9c7c9c14ca3f66b8a04219162e6f259ff37...5684ed6d32fdb953e3b318333ed84ed245f2f6b0,1,39,7,46,8,2006-08-26 02:25:46,2006-08-25 00:56:55
5684ed6d32fdb953e3b318333ed84ed245f2f6b0...0dde68998c18064565e8a64181a9742301b6bd05,1,14,4,18,5,2006-08-26 02:25:58,2006-08-25 00:58:20
0dde68998c18064565e8a64181a9742301b6bd05...26e8c5d38543674173a37e4bb2096f836bd2ea2c,1,23,6,29,5,2006-08-26 02:26:05,2006-08-25 01:01:49
26e8c5d38543674173a37e4bb2096f836bd2ea2c...5164b6cd3c3a460e43869e6c7d2145d6b49d5c28,1,50,10,60,10,2006-08-26 02:26:11,2006-08-25 01:04:58
5164b6cd3c3a460e43869e6c7d2145d6b49d5c28...8b70004b8f04e639aa8fd29db64efe834723b3e3,1,2,1,3,2,2006-08-26 02:26:21,2006-08-25 01:05:48
8b70004b8f04e639aa8fd29db64efe834723b3e3...5bab25fd91b839bbbebed2b394deabc13dea99db,1,33,23,56,6,2006-08-26 02:26:27,2006-08-25 01:06:50
5bab25fd91b839bbbebed2b394deabc13dea99db...0ea4d4c94b7662c9668d30d8441c1a9a3376d772,1,114,85,199,50,2006-08-26 02:26:29,2006-08-25 01:07:46
0ea4d4c94b7662c9668d30d8441c1a9a3376d772...f7122265fcb821208c290ad9817d296dec19d523,1,2,2,4,2,2006-08-26 04:26:12,2006-08-25 00:48:04
f7122265fcb821208c290ad9817d296dec19d523...5a990e45f920b50aa6b81823120223fb50f56d97,1,4,0,4,2,2006-08-26 04:26:21,2006-08-25 19:28:18
5a990e45f920b50aa6b81823120223fb50f56d97...2e93115ed84901fb8ee8447a1baf37cd8c343d8e,1,20,2,22,3,2006-08-26 04:26:26,2006-08-25 19:48:23
2e93115ed84901fb8ee8447a1baf37cd8c343d8e...b22d449721b22f6ec090f22c418ae6b0a560f78d,2,61,1,62,5,2006-08-26 07:59:29,2006-08-26 07:01:23
b22d449721b22f6ec090f22c418ae6b0a560f78d...030b52087f0a4b7b1178d34839868ce438eb2f0e,1,1,1,2,1,2006-08-26 07:59:29,2006-08-26 00:13:05
a8e0d16d85fb2ea53775f64549cac2396cd621a6...db5e523fddd2a1a47d9ea63498734d0141925513,3,216,0,216,3,2007-01-14 07:15:01,2006-08-05 06:04:21
db5e523fddd2a1a47d9ea63498734d0141925513...8bcce30126b90af83c1291e072f74950e73a2584,1,163,19,182,20,2007-01-14 07:15:01,2006-08-06 17:51:39
8bcce30126b90af83c1291e072f74950e73a2584...27d6d29035473f01ba5bb3b52c86ee4181d251fe,1,46,47,93,18,2007-01-14 07:15:02,2006-08-08 04:03:59
27d6d29035473f01ba5bb3b52c86ee4181d251fe...ac47a738a7c866eeffc0c6374c0ef3f7ca6ee79d,1,83,66,149,38,2007-01-14 07:15:02,2006-08-08 04:46:13
ac47a738a7c866eeffc0c6374c0ef3f7ca6ee79d...6143f0644e79686407c1dc0e1b4dadff74e80046,1,46,14,60,10,2007-01-14 07:15:03,2006-08-08 05:14:21
6143f0644e79686407c1dc0e1b4dadff74e80046...6bb5b3291df99bf050c91ab742b406d2404b8f73,1,165,5,170,11,2007-01-14 07:15:03,2006-08-08 07:36:45
6bb5b3291df99bf050c91ab742b406d2404b8f73...463acbe1c60fc5009dac9d033df6c2b9c5037a91,1,729,177,906,76,2007-01-14 07:15:03,2006-08-14 04:58:19
463acbe1c60fc5009dac9d033df6c2b9c5037a91...7111feede9c5905199ba48645fadc369faca5711,1,24,4,28,10,2007-01-14 07:15:03,2006-08-14 06:50:18
7111feede9c5905199ba48645fadc369faca5711...c44cdc7eef212ec09901eb2e0996476e0468ed88,1,326,160,486,51,2007-01-14 07:15:04,2006-08-15 00:16:28
c44cdc7eef212ec09901eb2e0996476e0468ed88...c90be46abdbd102ab8e9af0303d33976d552ae58,1,8,9,17,1,2007-01-14 07:15:04,2006-08-16 05:57:57
c90be46abdbd102ab8e9af0303d33976d552ae58...ace4a9d1ae5efd056c5e57cc76aacee3057a73f7,1,1,0,1,1,2007-01-14 07:15:04,2006-08-21 07:29:13
ace4a9d1ae5efd056c5e57cc76aacee3057a73f7...afde8dd96dbb81688d7cb22330e4fffcfc7def21,1,10,5,15,5,2007-01-14 07:15:05,2006-08-23 05:33:47
afde8dd96dbb81688d7cb22330e4fffcfc7def21...d5c57b284e847a56cc1d98b783be95ba94285afe,1,28,6,34,5,2007-01-14 07:15:05,2006-08-23 06:00:31
d5c57b284e847a56cc1d98b783be95ba94285afe...d83971688ba42e4cd37908f4d776801a997ca421,1,87,17,104,19,2007-01-14 07:15:05,2006-08-23 08:17:45
d83971688ba42e4cd37908f4d776801a997ca421...d6c7eb2c160fc40c48fd25fdae15c193eec13bb7,1,4,2,6,4,2007-01-14 07:15:05,2006-08-23 08:31:12
d6c7eb2c160fc40c48fd25fdae15c193eec13bb7...72303d44e9d8f3fc9bef039b472a2bd259509420,1,125,0,125,6,2007-01-14 07:15:06,2006-08-24 07:12:13
72303d44e9d8f3fc9bef039b472a2bd259509420...41e5257fcf4db31dfa2576aac1f50b140f2bb058,1,149,13,162,18,2007-01-14 07:15:06,2006-08-24 08:37:35
41e5257fcf4db31dfa2576aac1f50b140f2bb058...8d8928b0511313ba1740d39c3920f8f12f36a10a,1,3,0,3,1,2007-01-14 07:15:06,2006-08-24 08:46:29
8d8928b0511313ba1740d39c3920f8f12f36a10a...00e2b8842c58e451fcf8038287c8420423bab50a,1,71,98,169,9,2007-01-14 07:15:06,2006-08-24 22:45:26
00e2b8842c58e451fcf8038287c8420423bab50a...02f3389d9647378ed864ff1cdfb6f0238b64ee91,1,4,3,7,6,2007-01-14 07:15:07,2006-08-25 02:38:13
02f3389d9647378ed864ff1cdfb6f0238b64ee91...8435a9cb2662ca4326e96ea78d58b9376fb21f7e,1,1,0,1,1,2007-01-14 07:15:07,2006-08-25 18:53:32
8435a9cb2662ca4326e96ea78d58b9376fb21f7e...a6a1a831d9bdcdc0adb9a23ce450db08779c2871,1,35,1,36,5,2007-01-14 07:15:07,2006-08-25 20:03:04
a6a1a831d9bdcdc0adb9a23ce450db08779c2871...264244a0429e23616a6065f6f52a15711981a8db,1,37,5,42,10,2007-01-14 07:15:08,2006-08-26 03:07:06
264244a0429e23616a6065f6f52a15711981a8db...2eb26d8454de77f45bbbfc32eed2a6c3133fe963,1,2,1,3,2,2007-01-14 07:15:08,2006-08-27 02:38:02
2eb26d8454de77f45bbbfc32eed2a6c3133fe963...35ef237cf630418c2e45752eb527268693a2895b,1,1,1,2,1,2007-01-14 07:15:08,2006-08-27 03:37:31
35ef237cf630418c2e45752eb527268693a2895b...53dbce78a2a018bd2828d3ecc4123015f88ae36f,1,24,20,44,12,2007-01-14 07:15:08,2006-08-27 09:53:48
53dbce78a2a018bd2828d3ecc4123015f88ae36f...5fced8dc6f4844997b6e25a67a00f428775c5233,1,32,0,32,4,2007-01-14 07:15:09,2006-08-27 10:20:49
5fced8dc6f4844997b6e25a67a00f428775c5233...08d7e892a714dec8471cd45add2b1da24f66b3e7,1,2,1,3,1,2007-01-14 07:15:09,2006-08-28 00:13:44
08d7e892a714dec8471cd45add2b1da24f66b3e7...445b85999a309c8e5c7f928484c57325c280152e,1,26,26,52,24,2007-01-14 07:15:09,2006-08-28 14:46:58
445b85999a309c8e5c7f928484c57325c280152e...4cabf8583f934260697a065186f3dce135834ede,1,155,65,220,60,2007-01-14 07:15:10,2006-08-28 16:22:50
4cabf8583f934260697a065186f3dce135834ede...e2eb469d1ff9595882c8329ad415b1d7246769d0,1,32,14,46,14,2007-01-14 07:15:10,2006-08-28 17:02:51
e2eb469d1ff9595882c8329ad415b1d7246769d0...243f801d1d08753cd4eff2a23e245f7575c37ad5,1,23,20,43,11,2007-01-14 07:15:10,2006-08-28 17:15:48
243f801d1d08753cd4eff2a23e245f7575c37ad5...23bc886c966b4362555b61f33c6eef71552e4d0e,1,7,20,27,7,2007-01-14 07:15:10,2006-08-28 17:54:01
23bc886c966b4362555b61f33c6eef71552e4d0e...b54d6422b1a277ee905819e01020f5690196a999,1,11,5,16,4,2007-01-14 07:15:11,2006-08-29 01:43:04
b54d6422b1a277ee905819e01020f5690196a999...8a8c55ea709d26ca397d6588e85579339885f507,1,11,11,22,12,2007-01-14 07:15:11,2006-08-29 02:06:13
8a8c55ea709d26ca397d6588e85579339885f507...cacbdd0afb481a6f3019e5e7db98f88e40941fd5,1,1,0,1,1,2007-01-14 07:15:11,2007-01-12 02:25:01
cacbdd0afb481a6f3019e5e7db98f88e40941fd5...62b6f48388faf0ac2432a07cfc53aa904c591f8f,1,58,0,58,7,2007-01-14 07:15:12,2007-01-12 03:21:38
62b6f48388faf0ac2432a07cfc53aa904c591f8f...9938ffc53a15c755bbd3894c02492b940ea34c4c,1,7,1,8,3,2007-01-14 07:15:12,2007-01-12 03:28:39
2c6d22df9f8a975c88fc9a93c4db8bb0bd116b74...ef1186228d39af29c109785fa752e3866c79a6b3,1,3,7,10,2,2006-08-31 23:24:30,2006-08-31 23:15:38
ef1186228d39af29c109785fa752e3866c79a6b3...2d7320d0b09d7a9aab4e5dbc5458f37bfb6ce9f5,9,16,16,32,16,2006-08-31 23:24:39,2006-08-31 22:32:39
2d7320d0b09d7a9aab4e5dbc5458f37bfb6ce9f5...95676853b2dc5d610a6f917aac37cbb12c57fcd2,1,2,0,2,1,2006-08-31 23:24:40,2006-08-31 22:31:08
95676853b2dc5d610a6f917aac37cbb12c57fcd2...1d3fc68ae711b3f46aea02f8d819423cf8780b7d,1,6,4,10,4,2006-09-01 04:10:17,2006-09-01 03:43:32
1d3fc68ae711b3f46aea02f8d819423cf8780b7d...839837b953c613c1649b9e36ec2f01da759d87e3,2,3,3,6,3,2006-09-01 07:24:06,2006-09-01 07:17:47
2c6d22df9f8a975c88fc9a93c4db8bb0bd116b74...7cf67205ca68a157c6ffdb4e5a4ff231217c0871,10,196,64,260,15,2006-08-31 21:16:38,2006-08-31 06:42:11
8391548e5e78677eb81f97334d998418802ea194...e8daf78a00fc618f4b8b5b6253580226560f7dec,2,16,0,16,3,2006-09-26 04:17:43,2006-09-25 10:31:52
e8daf78a00fc618f4b8b5b6253580226560f7dec...4dafd7d2444051fe0e1eb17e9ded503ad7d9dd25,2,10,5,15,4,2006-09-26 05:11:26,2006-09-25 21:19:00
8391548e5e78677eb81f97334d998418802ea194...a06f678eb998862ea83b73e46ece32f99132935b,7,17,41,58,19,2006-09-25 03:33:35,2006-09-25 02:49:47
f64d7fd267c501f501e18a888e3e1e0c5b56458f...efe4631def181d32f932672a7ea31e52ee0ab308,1,6,2,8,1,2006-11-26 03:59:32,2006-11-26 01:38:41
efe4631def181d32f932672a7ea31e52ee0ab308...93ee7823c0a48b7a51ac0e145b5bcc450c805ea4,1,26,15,41,7,2006-11-26 06:46:35,2006-11-26 03:45:02
f64d7fd267c501f501e18a888e3e1e0c5b56458f...391862e34571c0e7e88a5f6e84211b7b8bf55440,1,17,11,28,3,2006-11-25 09:45:26,2006-11-25 08:43:59
391862e34571c0e7e88a5f6e84211b7b8bf55440...28b9d9f7c67cfd199c4bc9e1ac5197cb17349b15,1,5,4,9,2,2006-11-25 21:54:32,2006-11-25 10:32:08
28b9d9f7c67cfd199c4bc9e1ac5197cb17349b15...ba00b8c1edafcc414cfe13f8a4addac3893c2a29,1,9,3,12,2,2006-11-25 21:54:32,2006-11-25 14:54:32
ba00b8c1edafcc414cfe13f8a4addac3893c2a29...ab23c19d67d283567fdf18966e347a78ade56c22,1,12,2,14,2,2006-11-25 21:54:32,2006-11-25 14:54:33
ab23c19d67d283567fdf18966e347a78ade56c22...91fd2bf3fdc72351532a8fd74cdd0da37b036ed1,1,3,3,6,3,2006-11-25 21:54:32,2006-11-25 14:54:34
91fd2bf3fdc72351532a8fd74cdd0da37b036ed1...e88ce8a45656f750551ee21abf3be5576f6b0be4,1,8,5,13,6,2006-11-26 04:00:22,2006-11-26 01:18:26
b11bd57a384a7bee21245d3895d77d20c33e4d78...7d2ba1229c87268e9ec953c18c747817fbbe34b7,1,47,43,90,2,2006-12-28 09:28:07,2006-12-28 09:10:50
7d2ba1229c87268e9ec953c18c747817fbbe34b7...6f7c86df7ade3956559071ea529a711377d80819,1,1,1,2,1,2006-12-28 09:28:11,2006-12-28 09:10:51
6f7c86df7ade3956559071ea529a711377d80819...e32139aa0e8bea9f976baee2c484d96add37623c,1,6,4,10,3,2006-12-28 09:28:14,2006-12-28 09:10:52
e32139aa0e8bea9f976baee2c484d96add37623c...ed92f17026210db7ee4f3f0af39a569ae220cb5b,2,21,176,197,11,2006-12-28 09:39:09,2006-12-28 09:16:19
ed92f17026210db7ee4f3f0af39a569ae220cb5b...7d60ab2c15ed59169d9512de6aa40811b7940cd2,1,1,1,2,1,2006-12-28 09:39:30,2006-12-28 09:16:20
7d60ab2c15ed59169d9512de6aa40811b7940cd2...2c5c1d5300e1f5f14b06b8eae77b628626d32045,1,2,1,3,1,2006-12-28 09:39:38,2006-12-28 09:16:21
2c5c1d5300e1f5f14b06b8eae77b628626d32045...4a4d94b29b4546e15e6f25f8739663562d4f64a5,1,1,1,2,1,2006-12-28 09:39:47,2006-12-28 09:16:22
4a4d94b29b4546e15e6f25f8739663562d4f64a5...5d6b151fdd0a9e41ba68b444760616da1a008433,2,26,0,26,2,2006-12-28 21:59:39,2006-12-28 16:13:33
5d6b151fdd0a9e41ba68b444760616da1a008433...b81ba571242a1b64b4fbda215ea38dd062f2b05f,1,1,1,2,1,2006-12-28 22:12:48,2006-12-28 15:05:02
f0df4ed5629c25e9978708115ad654b9f83f55df...27a1a8014b842c0d70fdc91c68dd361ca2dfb34c,1,189,5,194,7,2006-11-28 06:22:57,2006-11-28 05:44:48
27a1a8014b842c0d70fdc91c68dd361ca2dfb34c...e15161198a381334b8c8ccee707392163f3a1ab7,4,10,2,12,5,2006-11-28 06:23:06,2006-11-28 05:46:50
e15161198a381334b8c8ccee707392163f3a1ab7...c3e43938839752b48ff3a36862ae59f1cd1e630d,1,1,3,4,1,2006-11-28 22:00:28,2006-11-28 21:49:17
c3e43938839752b48ff3a36862ae59f1cd1e630d...dad73c0bb9f33323ec1aacf560a6263f1d85f81a,1,8,1,9,3,2006-11-28 22:13:43,2006-11-28 22:06:05
dad73c0bb9f33323ec1aacf560a6263f1d85f81a...0864e3ba12ed946f0082297530584a77e2a7097b,1,15,20,35,15,2006-11-28 22:22:52,2006-11-28 10:50:17
0864e3ba12ed946f0082297530584a77e2a7097b...4548e855e4600a0f76329cf4f0dd9e8d17d66b08,1,16,0,16,3,2006-11-28 23:48:52,2006-11-28 17:12:08
4548e855e4600a0f76329cf4f0dd9e8d17d66b08...67ffa1142585742601011440a17528ef841bbf44,1,19,18,37,5,2006-11-28 23:48:55,2006-11-28 17:12:26
67ffa1142585742601011440a17528ef841bbf44...d5cc2de9ff57d2f6734f6e6e34addc2fae1b5b0e,1,10,5,15,2,2006-11-29 00:33:45,2006-11-28 10:27:39
d5cc2de9ff57d2f6734f6e6e34addc2fae1b5b0e...9aca025849d417b04b49fead126c915f6ca47526,1,47,20,67,19,2006-11-29 04:59:35,2006-11-29 02:51:40
9aca025849d417b04b49fead126c915f6ca47526...4511c899e64cbda934ba864c359a2a7a04909264,1,19,21,40,8,2006-11-29 04:59:41,2006-11-29 02:51:41
4511c899e64cbda934ba864c359a2a7a04909264...1ca7558dd838e82f6f6b8611b981654fa4ecde2b,1,9,4,13,3,2006-11-29 04:59:43,2006-11-29 02:51:42
f0df4ed5629c25e9978708115ad654b9f83f55df...255cae88bcc8fcb0088459df13b55fa3d311b9e2,1,5,5,10,2,2006-11-28 01:08:41,2006-11-26 12:10:52
69d47bdd6c1d6cb9c8603fd1da8b756e2903f955...9f1afe05c3ab7228e21ba3666c6e35d693149b37,1,824,727,1551,67,2006-02-19 11:44:47,2006-02-19 11:44:47
9f1afe05c3ab7228e21ba3666c6e35d693149b37...f634248052d3b9bd58d2d28e06ffde0ba46bad8d,1,13,54,67,5,2006-02-27 23:02:03,2006-02-27 23:02:03
f634248052d3b9bd58d2d28e06ffde0ba46bad8d...aa81d97476de941015224c99092cb1f49f451a23,1,23,115,138,14,2006-02-28 00:27:12,2006-02-28 00:27:12
aa81d97476de941015224c99092cb1f49f451a23...8f7d0cecf4b4999f71e0c5346de2f24beebd67dd,1,112,116,228,80,2006-02-28 11:10:19,2006-02-28 11:10:19
8f7d0cecf4b4999f71e0c5346de2f24beebd67dd...8ed164841564802cc0b063a6b365fb19e9a513d1,1,55,24,79,21,2006-03-02 11:56:44,2006-03-02 11:56:44
8ed164841564802cc0b063a6b365fb19e9a513d1...c934a8a3a32896e44123c0a489367a1df1108c4a,1,25,19,44,20,2006-03-02 12:00:44,2006-03-02 12:00:44
c934a8a3a32896e44123c0a489367a1df1108c4a...9f841cf1fbe4150a78555a45fd8a7794010975d4,1,1,0,1,1,2006-03-02 22:56:32,2006-03-02 12:15:05
9f841cf1fbe4150a78555a45fd8a7794010975d4...b06bc2a0784cfb5cd9e1313201a16e08c73ff1c6,1,3,1,4,1,2006-03-07 22:15:32,2006-03-07 22:15:32
b06bc2a0784cfb5cd9e1313201a16e08c73ff1c6...f7a3e8d254bf0034edfacd5aaf6e13ce2ed58d19,1,10,17,27,10,2006-03-17 23:04:48,2006-03-17 23:04:48
f7a3e8d254bf0034edfacd5aaf6e13ce2ed58d19...f4171a19f0a4091093bca4c1671c77b8caa93533,1,6,3,9,3,2006-03-18 05:02:51,2006-03-18 05:02:51
f4171a19f0a4091093bca4c1671c77b8caa93533...d8d2df08f6c5f804878bf9faf0820db87dbd68f5,1,21,8,29,9,2006-03-18 09:42:46,2006-03-18 09:42:46
d8d2df08f6c5f804878bf9faf0820db87dbd68f5...eb447a126ce90fa1e8a4887d50fb04902167e57a,1,53,6,59,9,2006-03-18 12:11:37,2006-03-18 12:11:37
eb447a126ce90fa1e8a4887d50fb04902167e57a...7a1d9d14c8475715c6b923f378eb72be096c7963,1,11,11,22,8,2006-03-21 23:21:45,2006-03-21 23:21:45
90768daaa006516c7ae69ed89d7c2e67243dfac1...66f04f38f42024dceb1679fc4d672de3746cf237,2,28,40,68,8,2006-02-07 10:09:55,2006-02-07 09:37:54
66f04f38f42024dceb1679fc4d672de3746cf237...53f313897e37f25e1411a6a7cfa328d642847345,3,33,2,35,5,2006-02-07 10:13:02,2006-02-07 10:07:39
53f313897e37f25e1411a6a7cfa328d642847345...3904848c6ea8815236db66956f6a7d77e13fb384,1,4,0,4,1,2006-02-07 21:19:40,2006-02-07 11:47:44
3904848c6ea8815236db66956f6a7d77e13fb384...4e783b41e09fb14b8ff72348ec2307fd1d5dec46,1,49,0,49,1,2006-02-07 21:19:42,2006-02-07 11:47:47
4e783b41e09fb14b8ff72348ec2307fd1d5dec46...deb989b57d01cc1ed10ec245245a0e6214a16f87,1,3,2,5,2,2006-02-07 21:19:50,2006-02-07 18:26:41
deb989b57d01cc1ed10ec245245a0e6214a16f87...d19e06fa8f86b611c10115903ef7e50d5de112f0,1,2,0,2,2,2006-02-07 21:19:51,2006-02-07 17:21:02
b825e6ff5d003db8efd1ed43cdbbb9d637df0a0c...d28c8af623b0d15740c2af0106d8e2bf54a3ac52,1,2,0,2,1,2005-12-12 20:57:25,2005-12-12 20:50:40
d28c8af623b0d15740c2af0106d8e2bf54a3ac52...e726715a52e25d8035c89d4ea09398599610737e,2,52,2,54,3,2005-12-12 20:57:25,2005-12-12 20:28:34
e726715a52e25d8035c89d4ea09398599610737e...962537a3eb03a118cf27d9d0da365a3216ed1caa,2,3,3,6,2,2005-12-12 20:57:25,2005-12-12 20:01:52
962537a3eb03a118cf27d9d0da365a3216ed1caa...44db136cad84c003506e231a38935ca6acba4d7d,1,68,4,72,4,2005-12-13 00:20:21,2005-12-13 00:20:21
44db136cad84c003506e231a38935ca6acba4d7d...c7a45bd20e4ec141fdc15f36d261a45d51d95693,2,3,3,6,2,2005-12-13 00:42:38,2005-12-13 00:42:38
c7a45bd20e4ec141fdc15f36d261a45d51d95693...86c9523305f75818d4dce485a18f6b4ccae78233,2,2,52,54,3,2005-12-13 00:43:15,2005-12-13 00:43:15
86c9523305f75818d4dce485a18f6b4ccae78233...0532a5e46b88cd70c952a2bf5dc63681be32a2d9,1,3,2,5,2,2005-12-13 01:15:55,2005-12-13 01:15:55
0532a5e46b88cd70c952a2bf5dc63681be32a2d9...180c4746479892a9e58918b0d45f89911cb48716,1,93,17,110,11,2005-12-13 02:29:53,2005-12-13 02:29:53
180c4746479892a9e58918b0d45f89911cb48716...1e2ccd3abc8f5d96244806f753568493c3e77d4c,7,209,26,235,23,2005-12-13 07:24:06,2005-12-13 07:24:06
1e2ccd3abc8f5d96244806f753568493c3e77d4c...76cead391f77142f153ceafcb21ba50f0b09dd15,3,13,1,14,5,2005-12-13 07:55:09,2005-12-13 07:55:09
76cead391f77142f153ceafcb21ba50f0b09dd15...803f498c03b47b1da88cf8f14ba2c374f0fc16d3,2,71,0,71,2,2005-12-13 09:54:15,2005-12-13 09:54:15
803f498c03b47b1da88cf8f14ba2c374f0fc16d3...9755afbd9467759bb77a6e5a535791243c5b907d,2,49,22,71,8,2005-12-13 10:38:24,2005-12-13 10:38:24
9755afbd9467759bb77a6e5a535791243c5b907d...0a8b4def9ae9e929a3310b536782a80a7c7644e7,1,4,1,5,1,2005-12-13 23:58:00,2005-12-13 23:58:00
0a8b4def9ae9e929a3310b536782a80a7c7644e7...9954f5b876abb6118f9bdf1d113239d86acca7bd,1,4,1,5,4,2005-12-14 01:01:23,2005-12-14 01:01:23
9954f5b876abb6118f9bdf1d113239d86acca7bd...ed24928e122bad83e62d161087f806fa21c46a59,2,14,2,16,6,2005-12-14 02:15:02,2005-12-14 00:45:40
ed24928e122bad83e62d161087f806fa21c46a59...f4f9adaea7e4e46337ae8312f34228a743f0cd89,1,1,1,2,1,2005-12-14 05:39:56,2005-12-14 05:39:56
f4f9adaea7e4e46337ae8312f34228a743f0cd89...01f49e3453d9960fec62d93bc3a66784f1be4c26,1,118,29,147,24,2005-12-14 08:42:45,2005-12-14 08:42:45
d79374c7b58d3814ffdc277de608243f8e665e3a...4c353e890c0107a8e733ab11634da21844ec38ba,1,6,0,6,1,2005-12-04 18:32:49,2005-12-04 16:59:37
4c353e890c0107a8e733ab11634da21844ec38ba...3a2674337c12e958f8c697af991a0ef6c06ddd4d,1,6,2,8,3,2005-12-04 22:41:35,2005-12-04 22:41:35
3a2674337c12e958f8c697af991a0ef6c06ddd4d...9a79c5a8b4e280601bcbeeed22e1e4968d06c10e,1,1,2,3,2,2005-12-04 22:59:58,2005-12-04 22:59:58
9a79c5a8b4e280601bcbeeed22e1e4968d06c10e...7b9b4c452c793d0f8e3ff9f0b7fe526448fc314a,1,29,14,43,9,2005-12-05 00:02:16,2005-12-04 23:31:08
7b9b4c452c793d0f8e3ff9f0b7fe526448fc314a...287f860054345505e4f737466279efa6c3ff04b5,2,84,15,99,9,2005-12-05 00:06:35,2005-12-04 23:58:50
287f860054345505e4f737466279efa6c3ff04b5...8bf14d6ef9245f3b81d24cb7725a868f62343277,3,17,4,21,6,2005-12-05 00:34:35,2005-11-26 22:12:44
8bf14d6ef9245f3b81d24cb7725a868f62343277...f83df6d66e08f1f68b2c1c6aa2ba8b626990df5f,1,1,1,2,1,2005-12-05 00:38:40,2005-12-05 00:38:40
f83df6d66e08f1f68b2c1c6aa2ba8b626990df5f...18d1e701b70014d37a2715ccce0791114587709e,2,0,2,2,2,2005-12-05 07:19:31,2005-12-05 05:13:57
18d1e701b70014d37a2715ccce0791114587709e...b270c634b7d3dd197de6d155770fd7b044d76c5c,1,1,1,2,1,2005-12-05 07:19:31,2005-12-05 05:24:22
b270c634b7d3dd197de6d155770fd7b044d76c5c...1494e03888d084aa1da265f8534d235461b3fc91,1,23,6,29,7,2005-12-05 07:19:31,2005-12-05 06:48:43
1494e03888d084aa1da265f8534d235461b3fc91...6f42f89c1f7030d1101f08bf56d06cc2b6828b83,1,10,110,120,18,2005-12-05 07:19:31,2005-12-05 06:52:19
6f42f89c1f7030d1101f08bf56d06cc2b6828b83...d5eac49868eba3b13d4816b82e99e86ec5ac9eb8,1,3,36,39,5,2005-12-05 07:19:31,2005-12-05 07:02:54
d5eac49868eba3b13d4816b82e99e86ec5ac9eb8...3e15c67c90f8eaa655165cf642d0553919a06464,1,3,130,133,6,2005-12-05 07:19:32,2005-12-05 07:12:36
3e15c67c90f8eaa655165cf642d0553919a06464...556cb4e583ada79b7c2e632a548dca90a98c1b29,1,51,15,66,8,2005-12-05 08:15:24,2005-12-05 08:15:24
556cb4e583ada79b7c2e632a548dca90a98c1b29...63d34b0b13b3527eb63dce5e37098e200f6a0717,1,5,2,7,2,2005-12-05 08:15:44,2005-12-05 08:15:44
63d34b0b13b3527eb63dce5e37098e200f6a0717...dfa2f22f942ffc96105e667024b516e6f4fa07d1,1,10,8,18,1,2005-12-05 08:22:01,2005-12-05 08:22:01
dfa2f22f942ffc96105e667024b516e6f4fa07d1...eb0362a467cc2cb5313bb859d78ea2d152b4a4ff,2,9,0,9,3,2005-12-05 08:58:23,2005-12-05 08:32:01
eb0362a467cc2cb5313bb859d78ea2d152b4a4ff...dc5f9239f7cc577b7d503017583dcc26ad5991f0,2,171,69,240,5,2005-12-05 08:58:23,2005-12-05 08:57:48
dc5f9239f7cc577b7d503017583dcc26ad5991f0...f13d7db4af3bbf611990d63643b34c4e546b127c,1,2,4,6,2,2005-12-05 18:39:17,2005-12-05 18:39:17
f13d7db4af3bbf611990d63643b34c4e546b127c...9cebe90bc55c76638f5cb8132d9fbd2769e05e54,1,0,33,33,2,2005-12-05 19:12:01,2005-12-05 19:12:01
9cebe90bc55c76638f5cb8132d9fbd2769e05e54...53e7181cd9927a8a194f4770c597744d96a113a2,2,0,28,28,7,2005-12-05 20:58:53,2005-11-25 22:22:27
53e7181cd9927a8a194f4770c597744d96a113a2...cd8c4589473d2a6669cf882ebcd708a2d81e9168,1,3,0,3,1,2005-12-05 21:19:39,2005-12-05 18:38:30
cd8c4589473d2a6669cf882ebcd708a2d81e9168...4050c0df8ec7043315e2192695de432875239775,8,129,118,247,24,2005-12-05 23:50:29,2005-12-05 19:54:29
4050c0df8ec7043315e2192695de432875239775...8d69195124c826756c025fc84d993d92ff119075,1,9,4,13,4,2005-12-06 03:12:26,2005-12-06 02:13:31
8d69195124c826756c025fc84d993d92ff119075...23c99d84601316c1e51ebc1f0b9bec5cddd011fb,1,1,1,2,1,2005-12-06 03:12:27,2005-12-06 02:14:34
23c99d84601316c1e51ebc1f0b9bec5cddd011fb...61f693bd5a2ab4d830aad6fce0a1c70863f38009,6,139,79,218,46,2005-12-06 05:47:16,2005-12-06 05:13:03
61f693bd5a2ab4d830aad6fce0a1c70863f38009...9c2e7c0ca240e1508871cd22f2ee380f52d69a53,1,22,10,32,4,2005-12-06 06:29:05,2005-12-06 06:29:05
9c2e7c0ca240e1508871cd22f2ee380f52d69a53...4a62eaed317e260b0bdb0ce5f340757d2a6dfef1,1,1,3,4,1,2005-12-06 06:29:36,2005-12-06 06:29:36
4a62eaed317e260b0bdb0ce5f340757d2a6dfef1...75a46f6b0ed3c3aa6fe4ff53a8c20cb58cbb3732,1,3,1,4,2,2005-12-06 06:31:18,2005-12-06 06:30:07
75a46f6b0ed3c3aa6fe4ff53a8c20cb58cbb3732...5f6da1d9d2b073c72d3588518934ade16df51268,1,1,1,2,1,2005-12-06 06:36:22,2005-12-06 06:36:22
5f6da1d9d2b073c72d3588518934ade16df51268...bb6d7b893e7f9f22e58a63d871b5b4c87b887513,1,31,12,43,8,2005-12-06 07:26:10,2005-12-06 07:26:10
bb6d7b893e7f9f22e58a63d871b5b4c87b887513...be61db922a230ae2638c27c071ee4b8c98f01f72,1,10,2,12,3,2005-12-06 08:07:58,2005-12-06 08:07:58
be61db922a230ae2638c27c071ee4b8c98f01f72...a6da9395a5b6d3df901ce0a6cb61d123f77d7342,3,7,1,8,3,2005-12-07 00:15:55,2005-12-06 22:20:16
a6da9395a5b6d3df901ce0a6cb61d123f77d7342...e23eff8be92a2a2cb66b53deef020063cff285ed,1,6,1,7,1,2005-12-07 01:28:26,2005-12-06 21:41:48
e23eff8be92a2a2cb66b53deef020063cff285ed...9754563ca9a99bc0fe233f43202af15704fbed4d,4,5,5,10,5,2005-12-07 02:09:12,2005-12-06 22:21:52
9754563ca9a99bc0fe233f43202af15704fbed4d...3bd348aeea24709cd9be4b9d741f79b6014cd7e3,2,48,19,67,10,2005-12-07 08:44:30,2005-12-07 08:29:51
3bd348aeea24709cd9be4b9d741f79b6014cd7e3...b539c5e8fbd36e38eb8f589e11aa5b136ddce753,1,9,16,25,3,2005-12-07 08:50:33,2005-12-07 08:50:33
b539c5e8fbd36e38eb8f589e11aa5b136ddce753...d23748a6af3e3db2b239090553f92c3a779b3578,2,104,18,122,13,2005-12-07 09:53:50,2005-12-07 09:45:38
9e5d2b40967059dd5f35d02fba323751ef22ac4e...58e60dd203362ecb9fdea765dcc2eb573892dbaf,3,1725,2,1727,6,2005-11-06 09:14:44,2005-11-02 19:19:24
58e60dd203362ecb9fdea765dcc2eb573892dbaf...c17fb6ee074cb0c9d71e5de42e2ad00786fedc18,1,21,16,37,7,2005-11-06 09:14:44,2005-11-04 22:22:18
c17fb6ee074cb0c9d71e5de42e2ad00786fedc18...0772b9a6331357913417722eab672f8b5aa69e50,1,39,3,42,8,2005-11-06 09:14:45,2005-11-04 22:22:25
0772b9a6331357913417722eab672f8b5aa69e50...26349b2e5ee2311cbb12db1cb92fa48fb0f26ef8,1,147,54,201,33,2005-11-06 09:14:45,2005-11-04 22:22:31
26349b2e5ee2311cbb12db1cb92fa48fb0f26ef8...75187c9debdc57d47e0842f97e30cb912d364ff2,1,79,27,106,29,2005-11-06 09:14:45,2005-11-04 22:22:35
9e5d2b40967059dd5f35d02fba323751ef22ac4e...12aa7456c937f758df9aafcc0123395ed7660fca,1,14,18,32,16,2005-11-06 09:12:31,2005-11-05 07:50:09
12aa7456c937f758df9aafcc0123395ed7660fca...d071e8dbb6849d40038db2d98a601395fe7b0b73,9,68,4,72,13,2005-11-06 09:12:31,2005-11-05 10:39:42
d071e8dbb6849d40038db2d98a601395fe7b0b73...54c2533da0228244bbde7f94abfdb0a7fbb859c1,1,2,2,4,2,2005-11-06 09:12:32,2005-11-05 20:52:56
54c2533da0228244bbde7f94abfdb0a7fbb859c1...9eba845f2088c33de3efe04492b9e33114c5fb52,3,5,5,10,3,2005-11-06 09:12:32,2005-11-05 20:54:25
9eba845f2088c33de3efe04492b9e33114c5fb52...c0a2ed1b491deaf8160a311d6b39bae7e266248c,1,6,0,6,1,2005-11-06 09:12:33,2005-11-05 20:54:40
64a2228b02594d5ccb7aaca293816f571fd1ea84...4b12dae69a41471e7c8139de26c1135f7ecccbd8,2,8,3,11,4,2005-10-05 00:04:44,2005-10-03 19:44:48
4b12dae69a41471e7c8139de26c1135f7ecccbd8...56d33b1105e63590577672de9afb920f6e7fd22c,1,30,5,35,6,2005-10-05 00:04:44,2005-10-03 20:16:39
56d33b1105e63590577672de9afb920f6e7fd22c...c2d5036de5c2e21fb736002ae5b385ceb7c6b23b,2,2,22,24,7,2005-10-05 00:04:44,2005-10-04 05:28:45
c2d5036de5c2e21fb736002ae5b385ceb7c6b23b...a567d3154ec05dd991abf50389eacc36bfc25965,1,14,7,21,3,2005-10-05 00:04:44,2005-10-04 08:11:27
a567d3154ec05dd991abf50389eacc36bfc25965...3ff8cbeda635422f4740d325d56288dfdea10179,2,11,3,14,5,2005-10-05 00:04:45,2005-10-04 19:41:35
952f87a6ca50a4d172bfb99c3c6e44e801212955...8b1f8d04c999421f8d2d8f248c82506390980a2c,2,7,1,8,2,2005-10-05 22:41:49,2005-10-05 22:41:49
f5a5e9b9f4f08544660fd55cd211bdd57c55b32f...70a0c6fe39da7e3f68836051408bc8eb3ce60ba7,1,27,1,28,4,2005-10-04 04:55:31,2005-10-04 04:24:55
720d150c48fc35fca13c6dfb3c76d60e4ee83b87...2c865d9aa7b9c3511f901b2544b667c5188f510e,1,7,0,7,1,2005-09-11 17:51:13,2005-09-11 13:27:47
2c865d9aa7b9c3511f901b2544b667c5188f510e...e1ccf53a60657930ae7892387736c8b6a91ec610,4,12,12,24,11,2005-09-11 17:51:36,2005-09-11 17:29:10
e1ccf53a60657930ae7892387736c8b6a91ec610...a4c5f9aab740b6d3972c395d4b1af10c2026244b,1,49,10,59,7,2005-09-11 17:51:48,2005-09-11 09:26:05
a4c5f9aab740b6d3972c395d4b1af10c2026244b...a5c500b76cfdc3da0f8cb36dadb5f4ba7ecff401,1,5,4,9,4,2005-09-11 17:51:51,2005-09-11 09:26:05
a5c500b76cfdc3da0f8cb36dadb5f4ba7ecff401...241b59675fb9f97531b9d76ae949d61da65c1f3d,1,16,17,33,10,2005-09-11 17:51:54,2005-09-11 09:26:05
241b59675fb9f97531b9d76ae949d61da65c1f3d...1d4710d06ccf6911b42a3a7b4a4bf148008f32a5,1,22,20,42,18,2005-09-11 17:51:56,2005-09-11 09:26:05
1d4710d06ccf6911b42a3a7b4a4bf148008f32a5...127bf00f7d2fee044602bec8c76ec9d6bf368025,1,5,5,10,3,2005-09-11 17:51:57,2005-09-11 09:26:05
127bf00f7d2fee044602bec8c76ec9d6bf368025...65a9289d7e5207ed66199db94593b31fa5550fde,1,1,1,2,1,2005-09-12 01:53:07,2005-09-12 01:03:43
65a9289d7e5207ed66199db94593b31fa5550fde...7fa090844f7d1624c7d1ffc621aae6aec84a1110,1,4,4,8,4,2005-09-12 01:55:20,2005-09-11 20:58:41
720d150c48fc35fca13c6dfb3c76d60e4ee83b87...53e2cc9b9b104662b9d8a571faea384642df2d66,2,7,1,8,2,2005-09-11 02:48:09,2005-09-11 01:37:24
8572aa85a7f1e9377f44b816788ced4306cf427b...628894b26dbfd4e3619eba0996f7da3f69e7dc5b,1,21,3,24,5,2005-08-25 06:26:20,2005-08-25 06:26:20
628894b26dbfd4e3619eba0996f7da3f69e7dc5b...e6fc2346c17b9a4ee274d509429042eec9c14db5,4,71,1,72,5,2005-08-25 07:28:18,2005-08-25 07:28:18
e6fc2346c17b9a4ee274d509429042eec9c14db5...248542ea9ae9125a7ccf214b979ada9908ea1358,1,1,0,1,1,2005-08-25 07:36:41,2005-08-25 07:36:41
248542ea9ae9125a7ccf214b979ada9908ea1358...23e8673093ff78c32d2e6aa271987d489e2f4c76,1,45,23,68,13,2005-08-26 08:41:28,2005-08-26 05:11:08
23e8673093ff78c32d2e6aa271987d489e2f4c76...d8ddb0a41610fffdf9ef1a256d19d5a27face9d7,1,12,2,14,3,2005-08-26 18:11:48,2005-08-25 14:24:13
d8ddb0a41610fffdf9ef1a256d19d5a27face9d7...f358c10f91889b1b75edc257fb45c20b583baf28,5,39,2,41,6,2005-08-26 19:35:51,2005-08-26 19:35:51
f358c10f91889b1b75edc257fb45c20b583baf28...814be007dff08597f6f550f243916aae4bf1d0f8,1,1,1,2,1,2005-08-26 19:52:16,2005-08-26 11:00:03
814be007dff08597f6f550f243916aae4bf1d0f8...579fbe598ddd9608bd2fbcf8411299dde06d1912,1,2,1,3,1,2005-08-26 19:52:23,2005-08-26 11:00:04
579fbe598ddd9608bd2fbcf8411299dde06d1912...88db5f809d1e4a4afd28514151e97b40fd367661,2,3,1,4,2,2005-08-26 19:52:25,2005-08-26 11:00:04
88db5f809d1e4a4afd28514151e97b40fd367661...c68e10b197404a4af0e7b59b5be4167d214b08da,5,65,0,65,5,2005-08-26 19:54:27,2005-08-26 11:00:05
c68e10b197404a4af0e7b59b5be4167d214b08da...85002315798dfcd28da6120ac3a461ca3fadfd2e,1,2,3,5,2,2005-08-26 20:01:12,2005-08-26 11:00:04
8572aa85a7f1e9377f44b816788ced4306cf427b...09661fdbfc1631462bb5c9064349f74097369b4a,2,7,1,8,2,2005-08-25 06:10:41,2005-08-25 06:10:41
8d0991d7d7d7e68ef39fe8d302f43110ef2c65d1...cdcb0ed411021cf8a8db047667e5ae18c4378ec0,1,3,1,4,1,2005-08-30 05:55:42,2005-08-30 05:36:16
cdcb0ed411021cf8a8db047667e5ae18c4378ec0...789d577412f6b470fca990ecf770b28570556df8,1,2,2,4,2,2005-08-30 06:09:22,2005-08-30 06:09:22
5c1d2e8af99c1cf24a38fe830d96a4aedce30e2b...ac1fbbda2013416b6c6a93d65c5dcf6662a60579,2,30,5,35,2,2013-12-02 21:48:06,2013-12-02 21:31:55
ac1fbbda2013416b6c6a93d65c5dcf6662a60579...2f93541d88fadd1ff5307d81c2c8921ee3eea058,4,17,3,20,5,2013-12-02 23:33:30,2013-12-02 23:33:30
109efbe4f24b1748f42af52ca6d528b2d7ffe048...749b668c7db563609de3de7595504f2dca8eef7d,1,1,1,2,1,2014-05-07 17:27:22,2014-05-07 05:48:54
173473c287f88f6ae40c0bad798087d5bb6f8efe...b10cd577d8061912996576a096e2fd5503c770e6,1,37,0,37,3,2013-12-17 22:05:50,2013-12-17 22:05:50
4ab9211ac28a39f275db92ca1b91f638538c7e43...25d1ac0e59f4471c3b124a0c19cad9f9511a26ad,1,13,0,13,2,2014-03-31 23:41:23,2014-03-31 23:41:23
d08c13b947335cc48ecc1a8453d97b7147c2d6d6...6aaf956b08cfab2dcaa1a1afe4192390d0ef14fd,2,35,12,47,4,2014-12-29 20:06:27,2014-12-23 08:45:36
be38bee862d628e29043b3f680580ceb24a6ba1e...2951add0e908f04fd63b48b8fcc138ae4dd66116,1,2,2,4,2,2013-12-03 18:40:40,2013-11-25 23:31:09
2951add0e908f04fd63b48b8fcc138ae4dd66116...a155a5f075cdc09e584a58d68bdce0c80e6c4b5a,4,13,3,16,5,2013-12-03 19:16:56,2013-12-03 19:16:56
077f43447c4931dd2e7890f16e8728f7f7376b87...e46c92e4ef75a74e210dcd517b04d7ea4b6e17ba,1,1,1,2,1,2013-12-09 21:19:56,2013-12-08 05:56:56
e46c92e4ef75a74e210dcd517b04d7ea4b6e17ba...70eabce801b1df4f6870bc205508d564effcd39b,2,1,3,4,3,2013-12-09 21:24:21,2013-12-08 05:56:57
70eabce801b1df4f6870bc205508d564effcd39b...379484b55155d65d9e721b48aca29f6f3d24d95e,1,3,0,3,1,2013-12-09 21:24:33,2013-12-08 05:56:58
379484b55155d65d9e721b48aca29f6f3d24d95e...0a54f709057729d0aa9f1e767e4f201834f14834,1,7,2,9,1,2013-12-09 22:12:24,2013-12-07 13:08:37
077f43447c4931dd2e7890f16e8728f7f7376b87...257ec841b88552471ff45f2e89e9b1142c737231,1,1,1,2,1,2013-12-09 21:18:43,2013-12-07 13:09:40
257ec841b88552471ff45f2e89e9b1142c737231...0c0ebc1fdf57c3ac968e1afdadbc17b9010da6fa,2,20,8,28,8,2013-12-09 21:18:43,2013-12-07 13:09:41
0c0ebc1fdf57c3ac968e1afdadbc17b9010da6fa...e71d13787929d4a043cb3906cfa4afa69e5fd0db,1,3,0,3,1,2013-12-09 21:18:44,2013-12-07 13:09:42
e71d13787929d4a043cb3906cfa4afa69e5fd0db...8d784daebf6cf6e0f0d6125e53190d2501484482,1,68,0,68,1,2013-12-09 21:18:44,2013-12-07 13:09:43
8d784daebf6cf6e0f0d6125e53190d2501484482...1f7feb775343fe2a6d3023d6ab00a6a365699157,1,11,0,11,1,2013-12-26 18:43:56,2013-12-23 20:23:43
077f43447c4931dd2e7890f16e8728f7f7376b87...8b7cb51a9dda0debf48c62ae79b9d60a23507097,1,12,17,29,4,2013-12-06 21:00:38,2013-12-06 07:30:47
8b7cb51a9dda0debf48c62ae79b9d60a23507097...ef79b1f8704668a6cdf4278f9255e03ca785bfb4,7,324,13,337,23,2013-12-06 21:00:39,2013-12-06 07:30:48
ef79b1f8704668a6cdf4278f9255e03ca785bfb4...1649612a227eaa5af7cb0e2d059728c0148485d9,1,18,10,28,6,2013-12-06 21:00:40,2013-12-06 07:30:49
7dba3f73e9571963fa03549956879d15ca7ad2d3...73abda3b2ad0a2053f29a6f0d624ede89531c437,1,14,2,16,6,2012-06-15 23:11:15,2012-06-15 23:02:34
73abda3b2ad0a2053f29a6f0d624ede89531c437...01a1a4bca6c1a46625ebc7dbfa7249b4029cb297,1,1,1,2,1,2012-06-29 20:04:50,2012-06-29 08:07:44
3c524002d67471f8ef5455ef0e5ce3e6fc846b32...0bb2ee1b7d30bbab593453a4d4a6013b8b0ffc5d,1,41,0,41,4,2012-04-16 19:55:11,2012-04-16 19:55:11
e6d29a4b47cf476e18658609033bdee4c42db3b8...83379df0251243b5e1f328598bfdd39327766df3,1,7,0,7,2,2012-09-15 04:44:37,2012-09-15 04:44:37
053a08f5bba3444d40516baf30a5d61e42e4fb93...4a182f6174e1b958777ba6fbc6262e5457151049,1,7,0,7,2,2012-10-16 20:27:23,2012-10-16 20:27:23
4a182f6174e1b958777ba6fbc6262e5457151049...d25c58ce43f45734ef74595b1e6fba1199651699,5,0,25,25,5,2012-10-16 22:35:00,2012-10-16 17:26:23
652398a88e7c3d18b6820a2ae369b05d26dc757f...038e55fec2153a8195236d57dced4bbb001ccf3c,1,72,21,93,12,2012-10-29 06:34:57,2012-10-28 16:16:20
038e55fec2153a8195236d57dced4bbb001ccf3c...d6052abca39fc84fed4f3248be042cfb6bf635d5,1,7,0,7,2,2012-10-29 06:34:57,2012-10-28 16:16:21
d6052abca39fc84fed4f3248be042cfb6bf635d5...e3e46cdbd45c2e7383df9de1787e23489dc66dbc,2,6,0,6,2,2012-10-29 06:34:58,2012-10-28 16:16:22
e3e46cdbd45c2e7383df9de1787e23489dc66dbc...a5ccdbe416081d5749f286c193b70400e48ad03f,1,11,7,18,6,2012-10-29 06:34:58,2012-10-28 16:16:23
a5ccdbe416081d5749f286c193b70400e48ad03f...31171d9e454d71144685866cfd6476b8ac69d314,4,26,17,43,16,2012-10-29 06:34:58,2012-10-28 16:16:24
31171d9e454d71144685866cfd6476b8ac69d314...9e2326c7e1efb1ae42b17e3fa38c16711a8d0bd8,4,91,44,135,22,2012-10-29 06:34:58,2012-10-28 16:16:25
9e2326c7e1efb1ae42b17e3fa38c16711a8d0bd8...1b77d83cab798668d8a54a05b3fa0262486f7dfc,1,13,13,26,8,2012-10-29 06:34:58,2012-10-28 16:16:26
652398a88e7c3d18b6820a2ae369b05d26dc757f...6468a4e5486d01e4da5ea8e8f2990523c3d18688,3,105,1,106,5,2012-10-01 03:16:01,2012-09-27 19:12:52
6468a4e5486d01e4da5ea8e8f2990523c3d18688...50fb51e7e81748182a770d3943ec5730357b27e7,1,5,6,11,5,2012-10-02 19:05:38,2012-10-02 18:50:16
652398a88e7c3d18b6820a2ae369b05d26dc757f...73b0898d0d04d432525f9d56e29bf70fc7bf6ea9,4,76,12,88,14,2012-09-30 04:49:11,2012-09-29 23:05:58
73b0898d0d04d432525f9d56e29bf70fc7bf6ea9...4b7c286ec74c7bb88e9e7ac2d283d86f64b6b0ea,3,45,2,47,3,2012-09-30 23:53:57,2012-09-30 21:01:29
652398a88e7c3d18b6820a2ae369b05d26dc757f...ad4813b3c2513c5dc7e84305ab8a393b32124977,3,24,3,27,4,2012-09-29 18:40:58,2012-09-29 04:41:27
ad4813b3c2513c5dc7e84305ab8a393b32124977...72fd13f71c18b438ca3e482c126bcbcaa2dac650,5,54,2,56,7,2012-09-29 18:41:14,2012-09-29 04:41:28
72fd13f71c18b438ca3e482c126bcbcaa2dac650...baa6378ff2106738c74213280904507d0ed8129c,5,20,4,24,8,2012-09-29 19:07:04,2012-09-29 18:59:52
baa6378ff2106738c74213280904507d0ed8129c...38cfe915bfc3ea0dbcbedaa82c44460a2ada2f42,2,11,0,11,2,2012-09-29 19:15:05,2012-09-29 04:41:29
5da81713703583e795a4faa6a79074b53edb5a9a...8222153d8449cb1d0f9c4b06b7f7f5b0c5128205,1,1,1,2,1,2010-02-12 23:39:03,2010-02-12 23:39:03
8222153d8449cb1d0f9c4b06b7f7f5b0c5128205...341d9a48cc4a6993f952c5c13417ba88227ef427,1,1,1,2,1,2010-02-12 23:40:01,2010-02-12 23:40:01
dace5dd14166ebc2b55f46695d27dce0e64c6464...7b48c170931f35c07c3ce78023519846073152a1,1,1,1,2,1,2010-01-29 17:56:12,2010-01-29 10:31:30
7b48c170931f35c07c3ce78023519846073152a1...02e51243559334e821e85b05dbb358e52b7ba4e5,1,1,0,1,1,2010-01-29 17:56:51,2010-01-29 10:37:23
ad12b81271d76f3e4a8b1f527e252ac8452732fd...c6e8c8005a2b1fc4cff72d279f29178767bd1a47,2,21,18,39,7,2009-10-18 07:38:03,2009-10-18 07:27:24
c6e8c8005a2b1fc4cff72d279f29178767bd1a47...70c9ac2f1999b7e0c17a864235537cffe29dfea4,1,57,3,60,5,2009-10-18 07:38:03,2009-10-18 07:13:47
70c9ac2f1999b7e0c17a864235537cffe29dfea4...46148dd7ea41de10fc784c247924f73ddb21121b,1,5,0,5,3,2009-10-21 22:17:24,2009-10-18 07:49:23
a16753dc2e6f885fd30e570610c3e8cf355ecf04...1414e5788b85787a712a30977b388200f1bc04da,3,28,3,31,5,2009-09-22 19:24:49,2009-09-22 15:10:12
a16753dc2e6f885fd30e570610c3e8cf355ecf04...6426ee61c703f52ba0bea1064f028e64c7a67552,1,14,4,18,6,2009-09-22 01:14:12,2009-09-22 01:14:12
6426ee61c703f52ba0bea1064f028e64c7a67552...f1e3156e627fa66714deea665c8f3585088b9695,1,7,4,11,4,2009-09-22 19:15:42,2009-09-21 11:00:34
f1e3156e627fa66714deea665c8f3585088b9695...3696c4ce89d97c34566a4a89720cfdae2a86fa38,1,4,4,8,2,2009-09-22 19:20:40,2009-09-21 19:44:05
3696c4ce89d97c34566a4a89720cfdae2a86fa38...918c03c2a7c8730dcfd413098b3dc05fa0f3166d,1,7,7,14,6,2009-09-22 19:47:26,2009-09-15 10:21:43
918c03c2a7c8730dcfd413098b3dc05fa0f3166d...59d5eeee9f7e0cb71c10bde3da0fa01c3b3dbf8d,1,16,4,20,5,2009-09-22 19:47:26,2009-09-15 10:21:44
59d5eeee9f7e0cb71c10bde3da0fa01c3b3dbf8d...9f040e9524c45a2f862b427ec78204625e09f50e,1,1,1,2,1,2009-09-22 19:47:27,2009-09-15 10:21:45
9f040e9524c45a2f862b427ec78204625e09f50e...3ddcb1981ba24a45c555152ecbd32b945c32a211,1,1,1,2,1,2009-09-23 02:40:05,2009-09-22 23:48:06
3ddcb1981ba24a45c555152ecbd32b945c32a211...a6dbf8814f433a7fbfa9cde6333c98019f6db1e4,1,6,1,7,3,2009-09-23 05:26:27,2009-09-13 20:38:48
a6dbf8814f433a7fbfa9cde6333c98019f6db1e4...efe47f8f2c7d4e2b7ebedc15dbdd2cc51912b56f,1,8,0,8,1,2009-09-25 21:00:04,2009-09-24 18:21:03
efe47f8f2c7d4e2b7ebedc15dbdd2cc51912b56f...e648f8b6d0dc6fb7e8c8e3ed47eec6b12aaf450a,1,15,1,16,1,2009-09-25 21:48:35,2009-09-24 12:23:15
e648f8b6d0dc6fb7e8c8e3ed47eec6b12aaf450a...fb3650ed100a549f80d822f28ccf0f82e9f75f3e,1,1,1,2,1,2009-09-25 22:10:59,2009-09-25 22:10:21
011c181cc656c8b3e48882729d1b6238e8c5c537...e01de1c9122c3cba118da19fe0ba0ce913fa7285,2,10,7,17,8,2010-03-16 06:37:42,2010-03-16 05:12:55
ff6d26a0e1d8fad775010fa3b689c0c027da8bb0...80235ba79ef43349f455cce869397b3e726f4058,6,57,10,67,11,2010-01-26 03:28:13,2010-01-18 04:09:06
ff6d26a0e1d8fad775010fa3b689c0c027da8bb0...4fc500667636c4ada592a40c4d11ce0560c43c0d,5,52,11,63,14,2010-01-19 01:09:32,2010-01-18 20:44:11
4fc500667636c4ada592a40c4d11ce0560c43c0d...85e2233f982f760d0e731b1258da2580834d8027,1,12,2,14,3,2010-01-19 01:46:28,2010-01-18 20:44:12
ff6d26a0e1d8fad775010fa3b689c0c027da8bb0...433f2be139710e2fc7c0693a8411b2773f1a4b38,3,330,1,331,8,2010-01-19 01:06:54,2010-01-18 17:18:02
488bdf2ebe6e99fb30ad958a710b0b3f737b4d0f...2a113aee9ba6ba55fc9a4c714efc958ab0de6510,2,272,18,290,21,2009-12-07 21:52:52,2009-12-07 11:27:24
2a113aee9ba6ba55fc9a4c714efc958ab0de6510...b2d6b1feafb6a4604b1207c8a6837633de59fdec,1,0,0,0,0,2009-12-07 21:52:52,2009-12-07 11:27:25
b2d6b1feafb6a4604b1207c8a6837633de59fdec...a8b59ef578df2b06a89fecd46f3d379895e77e8f,1,623,0,623,1,2009-12-07 21:52:52,2009-12-07 11:27:26
488bdf2ebe6e99fb30ad958a710b0b3f737b4d0f...eff726f0c28097e7964eb876d005e50e0dcdb9a0,1,2,1,3,1,2009-12-03 20:38:45,2009-12-02 21:14:36
ac78b009398f8cab1f57d1ef62db21ac95e11ed1...0a0c342568458a15528778db1480dbbaa9a0b4d9,1,2,1,3,1,2009-10-12 23:16:36,2009-10-12 19:37:39
ac78b009398f8cab1f57d1ef62db21ac95e11ed1...b145b211baa4129a827cc1b1b1a7984523b8f903,2,15,1,16,2,2009-10-10 21:56:13,2009-10-10 15:51:45
a17a9606e49dd3ad08558706f85475a694deb68b...33405be34bcb72d8fe69463c80c542eacb19b7ef,1,3,2,5,1,2009-10-10 00:21:46,2009-10-09 23:07:39
33405be34bcb72d8fe69463c80c542eacb19b7ef...85886162f1149bb1db48e6a4c8e1c4a4a726173f,1,12,7,19,7,2009-10-10 07:00:40,2009-10-09 12:21:13
85886162f1149bb1db48e6a4c8e1c4a4a726173f...78d553b7d7b269bb22ebd8b1198657c37484a3a0,3,6,7,13,3,2009-10-10 07:05:19,2009-10-10 07:05:19
f539cfbe8c157885197d1b6e4c1bcc6cbc54d0b9...294ac78d145d236447ac41774ee55af436e178a0,1,1,0,1,1,2009-10-08 05:04:19,2009-10-07 01:02:22
294ac78d145d236447ac41774ee55af436e178a0...af4e9e8c87d3e73056c4758279c4c8462fe5e573,1,7,2,9,4,2009-10-08 05:04:25,2009-10-07 08:48:50
af4e9e8c87d3e73056c4758279c4c8462fe5e573...8fd2cfa7accd6b8f877014bf3e4bf8547b8e0d2a,1,2,0,2,1,2009-10-08 05:04:26,2009-10-07 08:48:51
59b8d38f6e4f19b93c5dc4493ab11706acd101b5...b2025146d0718d953036352f8435cfa392b1d799,1,1,1,2,1,2009-09-14 21:48:15,2009-09-14 21:48:15
a96e8078a9135f54052ceb93c26adf4b863780ae...94702dd1ac27618b60198f7c8bceafaaaf7743e2,1,15,0,15,3,2013-01-12 02:51:09,2013-01-12 02:51:09
25ae7cfd19c8f21721363c64163cd5d9d1135b20...f2fef7b55aea64104a6aee662817e1e6f0b22f71,2,7,0,7,2,2012-09-20 17:28:51,2012-09-20 08:10:38
25ae7cfd19c8f21721363c64163cd5d9d1135b20...aa90b9697f9275e4f9cb10d274495e7587f217c0,3,5,3,8,5,2012-09-20 17:26:50,2012-09-19 23:12:02
25ae7cfd19c8f21721363c64163cd5d9d1135b20...6ac964a627e02ac73d4c97c492acf604942030e9,1,2,16,18,3,2012-09-20 17:25:21,2012-09-20 05:58:00
e06130c54cadf080e52d701808a26f42a35219ec...1b57e56c6191c87b7b372fce3be05f930423780b,1,4,4,8,4,2011-08-03 17:16:20,2011-08-03 08:20:08
179aae51bbaa86bd64bbb520f15e6126c92f3f4d...7ef4d6b928281eff2bfcd0b3d76b80f4385f2f3d,1,1,1,2,1,2011-06-17 18:40:39,2011-06-17 08:29:57
7ef4d6b928281eff2bfcd0b3d76b80f4385f2f3d...36bfb0e5f6004e4c4ac9334107dc185c316839a7,1,7,2,9,1,2011-06-17 20:48:53,2011-06-17 20:36:32
28eb1afec90fab398fc58a1d6119b9e99a733f87...dc4cd767108532161d27554162a8742f5b607eb8,4,12,5,17,7,2011-06-20 21:27:36,2011-06-20 07:40:06
28eb1afec90fab398fc58a1d6119b9e99a733f87...6520c84685660fc995a405d7b7511a903fc12e18,2,7,1,8,3,2011-06-20 19:32:39,2011-06-19 01:07:03
6520c84685660fc995a405d7b7511a903fc12e18...7ddc2710b97f223a13d9ff757948cdf9c8a22f66,1,16,0,16,1,2011-06-20 21:17:57,2011-06-19 01:07:05
7ddc2710b97f223a13d9ff757948cdf9c8a22f66...39001007390a699265f16da47474d2b112118931,1,13,0,13,1,2011-06-20 23:31:44,2011-06-20 22:41:01
76c9c0db3d0b9d17ca4dcbb0f9b6678f78a2492c...7ecee3314fdafd8015fd14bfb76ae4b601acc25e,2,36,1,37,2,2010-01-24 18:11:27,2010-01-24 18:11:27
76c9c0db3d0b9d17ca4dcbb0f9b6678f78a2492c...125fd98434ce773de45c4a40927c222ec5c43ae1,3,7,3,10,4,2010-01-24 08:15:29,2010-01-24 08:10:20
125fd98434ce773de45c4a40927c222ec5c43ae1...4d34477f4c5dbebc55aa1362fd705440590a85f1,1,6,4,10,5,2010-01-25 05:03:23,2010-01-23 16:37:26
4d34477f4c5dbebc55aa1362fd705440590a85f1...721ceec1ad12625e90b395fd0be0fae9049ebc22,4,72,1,73,5,2010-01-25 05:04:31,2010-01-24 14:09:00
fdf96a20acf96a6ac538df8113b2aafd6ed71d50...45c956b35731fcbda4cf29fcd1658d9418bec2d1,1,2,1,3,2,2015-02-26 22:02:34,2015-02-25 16:04:41
45c956b35731fcbda4cf29fcd1658d9418bec2d1...e426311befe429ad39b47927cd12153b7aa99542,2,11,0,11,2,2015-02-26 22:02:34,2015-02-26 13:49:34
fdf96a20acf96a6ac538df8113b2aafd6ed71d50...86ceb337ec340c7db9b060b90bfab05a08b8251b,2,39,26,65,10,2015-02-22 20:02:59,2015-02-21 15:52:48
86ceb337ec340c7db9b060b90bfab05a08b8251b...9f6976528b31356ee522d04aa31b86a3ba922f99,1,40,17,57,9,2015-02-22 20:03:54,2015-02-21 15:53:01
9f6976528b31356ee522d04aa31b86a3ba922f99...3f55ccab8e0fec73c8e38b909e9bb4963bfb8f6a,2,56,30,86,12,2015-02-22 20:04:01,2015-02-21 15:52:55
fdf96a20acf96a6ac538df8113b2aafd6ed71d50...51334bb094e085728ffe2b603fa3fe41dd80c075,3,84,13,97,7,2015-02-11 21:38:29,2015-01-17 20:56:38
fdf96a20acf96a6ac538df8113b2aafd6ed71d50...0b86fe8923c25639f77d5f18f086c3346a5ccd61,1,6,2,8,3,2015-02-04 22:27:01,2014-12-11 21:11:06
fdf96a20acf96a6ac538df8113b2aafd6ed71d50...13d261e53abdfe0ee61eb04b483a01509c0b43d2,1,22,3,25,4,2015-01-26 04:08:56,2014-11-19 21:47:32
fdf96a20acf96a6ac538df8113b2aafd6ed71d50...10de86d0d57dfa6680e229bfa0aa8ed31382767e,1,1,1,2,1,2015-01-23 22:44:14,2015-01-23 09:15:12
fdf96a20acf96a6ac538df8113b2aafd6ed71d50...a4c044484ec22fe2ea9210da703444725ec11f5e,1,1,1,2,1,2015-01-22 21:44:14,2015-01-22 19:32:33
fdf96a20acf96a6ac538df8113b2aafd6ed71d50...b4a56a3966e3da8f8c369f8f5674233d34d94999,1,7,3,10,1,2015-01-16 01:38:58,2015-01-16 01:32:57
fdf96a20acf96a6ac538df8113b2aafd6ed71d50...d0a042a18652f35dff5419185dd84de2ea216e7c,1,6,6,12,3,2015-01-14 21:08:12,2015-01-14 20:28:56
fdf96a20acf96a6ac538df8113b2aafd6ed71d50...331004836b3b374ce379775782367e4adf6f204a,1,0,2,2,1,2015-01-13 20:36:04,2015-01-10 18:13:23
cdd159b2f56c9e69e37bbb8f5af301abd93e5407...811929f1695ed7de15cad14b9335534af672b472,1,4,4,8,4,2012-07-29 21:54:13,2012-07-27 17:21:38
811929f1695ed7de15cad14b9335534af672b472...38a44bc59ae1ee6bbf7c91de299f6b78ec6e3801,1,0,4,4,1,2012-07-30 00:37:11,2012-07-29 23:25:35
38a44bc59ae1ee6bbf7c91de299f6b78ec6e3801...51f4de3ac993b52c8a2fab9ca3acc665fca2d833,1,2,8,10,4,2012-07-30 00:39:56,2012-07-29 23:25:36
cdd159b2f56c9e69e37bbb8f5af301abd93e5407...4c8e5c55c2a2125bb3b6a06c1cd0d4415fac0016,1,2,1,3,1,2012-07-27 22:13:25,2012-07-25 03:21:09
4c8e5c55c2a2125bb3b6a06c1cd0d4415fac0016...0ed8fdcdfd2bebdc7f172383b864836581c39123,1,1,2,3,1,2012-07-27 22:13:27,2012-07-25 03:21:10
0ed8fdcdfd2bebdc7f172383b864836581c39123...98d5439dad36f25aa9a2a70cc140d85d94e99bc9,1,16,13,29,2,2012-07-27 22:13:28,2012-07-25 03:21:11
98d5439dad36f25aa9a2a70cc140d85d94e99bc9...ee9be06770223238c6a22430eb874754dd22dfb0,3,11,0,11,3,2012-07-27 22:14:02,2012-07-27 20:04:20
ee9be06770223238c6a22430eb874754dd22dfb0...c2768fa15234fd7eef7abb52eca2a3abe08e525c,6,132,15,147,21,2012-07-27 22:14:50,2012-07-26 23:22:22
c2768fa15234fd7eef7abb52eca2a3abe08e525c...0f80aa03cf17973cb15eb34d5efedbd5eba70596,1,18,4,22,8,2012-07-27 22:14:52,2012-07-26 23:22:23
0f80aa03cf17973cb15eb34d5efedbd5eba70596...29499c0b2741cc2ea13b78a342048bad928dfe2a,3,2321,2319,4640,4,2012-07-27 22:14:53,2012-07-26 23:22:24
29499c0b2741cc2ea13b78a342048bad928dfe2a...5c71028fced46d03bf81b8625680d9ac87c8f4f0,3,9,7,16,8,2012-07-27 22:14:54,2012-07-26 23:22:25
cdd159b2f56c9e69e37bbb8f5af301abd93e5407...f3cfc3b27168a085d4ca7ab5801814c4f419b54d,1,3,3,6,3,2012-07-27 16:44:09,2012-07-26 20:57:56
f3cfc3b27168a085d4ca7ab5801814c4f419b54d...04083f278d19998e0e3f26627791ab54886ac12a,2,46,3,49,3,2012-07-27 17:07:35,2012-07-26 22:50:45
04083f278d19998e0e3f26627791ab54886ac12a...ac39aa612147b595e02876a4c9d6ca7e8063ba3d,3,10,10,20,3,2012-07-27 17:08:33,2012-07-26 13:39:53
ac39aa612147b595e02876a4c9d6ca7e8063ba3d...9a3658b97726df53453bd97add50d267f9ab2978,1,8,13,21,6,2012-07-27 17:10:58,2012-07-26 13:39:54
9a3658b97726df53453bd97add50d267f9ab2978...2b71b5221a66abd881919dd45609285e7af5c56f,1,7,14,21,6,2012-07-27 17:11:06,2012-07-26 13:39:55
2b71b5221a66abd881919dd45609285e7af5c56f...5b0b5dd49b55e474a2df502902682853e2cd6e9d,3,25,17,42,5,2012-07-27 17:11:14,2012-07-26 13:39:56
5b0b5dd49b55e474a2df502902682853e2cd6e9d...308566eb8b35b9279082bd5398c4252169d52b22,1,135,146,281,5,2012-08-22 18:50:50,2012-07-30 09:57:18
b7619006ebd9c9760b34bb38e04ce4dc8c606483...85e9c7e1d42849c5c3084a9da748608468310c0e,2,2,31,33,4,2011-09-23 22:35:57,2011-09-23 22:35:57
65c042d44dc843021f1410f1219104681fdd3469...4fa80cf0e07daa72361cd193fd88927be710c2e6,1,2,4,6,1,2009-11-23 10:55:59,2009-11-23 09:35:53
4fa80cf0e07daa72361cd193fd88927be710c2e6...483106089aea7ad856b7f940e20db254b08bad81,1,1,1,2,1,2009-11-24 05:25:55,2009-11-24 02:31:30
ba2c7476882ea56fcad298ef195b538ed7a7ad32...5d166ccb89faadb7ce5f36d2e33abbd7bb103117,2,9,5,14,8,2009-11-25 08:00:32,2009-11-24 23:08:08
5d166ccb89faadb7ce5f36d2e33abbd7bb103117...b073b7a990deb1cb3425db45642fa18c8b3cb65c,1,1,1,2,1,2009-11-25 08:16:38,2009-11-18 13:53:27
561197238ef95b126b5ff16780250d492ad24233...703601d6780c32d33dadf19b2b367f2f79e1e34c,1,12,13,25,9,2010-01-17 22:29:37,2010-01-16 05:38:34
23242a6f9e838013fbfddd4e8eb023d8c9328d37...e09e4024a070e666ed40b66442e8151b91d623e4,3,58,35,93,19,2012-09-11 18:18:48,2012-09-11 18:18:48
fab4b04e4be5ccfdf93e21e7260040bd9e7faedd...7f9e848cf82311792ccfb286e64846fe6f3d5476,2,23,0,23,3,2012-09-09 03:35:19,2012-09-08 16:54:34
fab4b04e4be5ccfdf93e21e7260040bd9e7faedd...0539ecfdfce677b05992af5e9899a9e974130400,2,29,0,29,2,2012-08-24 16:48:51,2012-08-24 10:31:03
fab4b04e4be5ccfdf93e21e7260040bd9e7faedd...a0788266d310dd3f6343c7ee754106784aa1e2af,1,19,7,26,2,2012-08-24 16:46:01,2012-08-24 09:52:22
fab4b04e4be5ccfdf93e21e7260040bd9e7faedd...4246b0bd900e72dbe83fd07cdfc946483a76214c,1,2,0,2,2,2012-08-23 21:23:18,2012-08-23 07:33:55
2a9a19e1b160c8c63c470d4c236d65709214a66f...8c2913508644bb3ef511c7edac1b15cfafe61df5,1,4,3,7,1,2012-09-17 04:52:52,2012-09-09 20:16:02
8c2913508644bb3ef511c7edac1b15cfafe61df5...67b0fe2eb6b70f530be347260c3792509a900feb,3,128,56,184,13,2012-09-17 04:52:52,2012-09-09 20:16:03
67b0fe2eb6b70f530be347260c3792509a900feb...449bb9cf1a0c42ddf6e9b9b6fd447eda12f9bc92,1,2,18,20,2,2012-09-17 04:52:52,2012-09-09 20:16:04
449bb9cf1a0c42ddf6e9b9b6fd447eda12f9bc92...7e5dd9f2ccf2141d65e4621b765a136796b0d55b,2,56,16,72,9,2012-09-17 04:52:52,2012-09-09 20:16:05
7e5dd9f2ccf2141d65e4621b765a136796b0d55b...5a41c16a81927bbccbcb00895b168a6d560b8c2c,2,4,2,6,4,2012-09-17 04:52:52,2012-09-09 20:16:06
5a41c16a81927bbccbcb00895b168a6d560b8c2c...f7fbc981a4effde51446c2229e34f2fc9210d31d,2,132,2,134,2,2012-09-17 04:52:52,2012-09-09 20:16:07
f7fbc981a4effde51446c2229e34f2fc9210d31d...55ac2ed6f56c153bc71dc80eb7634e2df2747670,1,21,8,29,7,2012-09-17 04:52:52,2012-09-09 20:16:08
55ac2ed6f56c153bc71dc80eb7634e2df2747670...df9c5453b220923d7ec3e6291498d519596e23ed,2,121,0,121,2,2012-09-17 04:52:52,2012-09-09 20:16:09
df9c5453b220923d7ec3e6291498d519596e23ed...b0ccc80d3cd12e41eaa9bc643b3aec3f50d134d8,2,2,2,4,2,2012-09-17 04:52:52,2012-09-09 20:16:10
b0ccc80d3cd12e41eaa9bc643b3aec3f50d134d8...ef739f0829f866b7e70e072a6744dc9cd1e12822,3,75,13,88,12,2012-09-17 04:52:52,2012-09-09 20:16:11
ef739f0829f866b7e70e072a6744dc9cd1e12822...728b7ad8bb6491d1d8bcd7498e06474b15812d52,3,77,0,77,8,2012-09-17 04:52:52,2012-09-09 20:16:12
728b7ad8bb6491d1d8bcd7498e06474b15812d52...6bbfd1372d2aa5b856fc7fb1616cb06c982fcb83,3,105,5,110,8,2012-09-17 04:52:53,2012-09-09 20:16:13
2a9a19e1b160c8c63c470d4c236d65709214a66f...a6253da0f30c5bee1ecb9bea313881dc8e50efda,3,375,0,375,3,2012-08-17 03:34:56,2012-07-27 17:10:06
183154bac897e77a1b941362985d8bc886a2ebec...16d26b168b371b2f4f86b1adb61470c6b08b27b9,1,30,1,31,3,2012-08-29 22:00:30,2012-08-29 22:00:30
034161a94e827ef05790b1c7ce5a6e3e740c864e...e48fb750f579f993062e0e5901e70bd7ddfc94b8,2,271,19,290,9,2012-08-10 19:53:18,2012-08-08 05:35:00
e48fb750f579f993062e0e5901e70bd7ddfc94b8...61b472ed8b090a3e9240590c85041120a54dd268,2,103,2,105,3,2012-08-10 19:53:18,2012-08-09 06:42:53
9e2116adbe192f3090785bdf3412bf7e3e2767b7...0bbe5b483df990a85183b29c29db7a96071e87a6,1,478,475,953,462,2012-07-30 02:24:47,2012-07-30 02:24:47
0bbe5b483df990a85183b29c29db7a96071e87a6...23ff3338034f0f9086f80c02458306f74eab4e0f,1,776,483,1259,463,2012-07-30 22:45:33,2012-07-30 22:45:33
23ff3338034f0f9086f80c02458306f74eab4e0f...fd4652ed541773955d05c45b77b1f7c653399bc2,1,545,529,1074,466,2012-07-31 00:45:53,2012-07-31 00:45:53
fd4652ed541773955d05c45b77b1f7c653399bc2...9c87b0d28f05c8ffcfe28da32161827cf0bac8e7,1,506,494,1000,469,2012-07-31 15:01:15,2012-07-30 15:50:53
9e2116adbe192f3090785bdf3412bf7e3e2767b7...07a71b851a2910931d307c884195d130f3462962,1,0,0,0,0,2012-07-29 22:20:42,2012-07-28 15:18:29
07a71b851a2910931d307c884195d130f3462962...425b8a22aa14d624c807d5eed92c92f5cd32f376,1,1,0,1,1,2012-07-30 01:07:47,2012-07-28 18:48:06
425b8a22aa14d624c807d5eed92c92f5cd32f376...dff9d65dc61af8a00a6eef153ebc59b76de9c412,1,15,0,15,1,2012-07-30 19:22:35,2012-07-30 14:31:18
be8779f7ac9a3be9aa783df008d59082f4054f67...95e7705310bce3b2721ebf789776c170cf424abb,1,23,6,29,6,2012-07-30 19:56:14,2012-07-30 17:51:59
6ea938542610f4c7b978a2d8bac00fade72ce9f1...1327d83954bcf755094995b63317b23986c550f2,1,1,2,3,1,2012-01-04 18:04:59,2012-01-04 15:55:34
5c951ef47bf2e34dbde58bda88d430937657d2aa...07b88a00c0caac055a9f52167523248a75711842,1,4,4,8,1,2012-01-06 20:27:59,2012-01-06 13:08:02
c34ba9967c0cf882bbdaf87bd72fa84e0ef099ed...a8d05d72b9fd60fe63f249250dcab2352b7b1984,1,3,6,9,1,2011-12-08 19:10:12,2011-12-07 15:20:16
a8d05d72b9fd60fe63f249250dcab2352b7b1984...956d86d1c9078eba380eb2530b0ff577a85c2e69,2,2,2,4,2,2011-12-09 18:46:52,2011-12-08 19:39:57
956d86d1c9078eba380eb2530b0ff577a85c2e69...791970425431878c8abe71645a03f0f64e20e461,1,0,7,7,2,2011-12-09 18:49:43,2011-12-09 07:30:45
adc3b2b27670f123bd7dd742ba0fa0e0a60e1b19...7c1fdd7019ea03438744849b9532cf768ba1247c,1,0,1,1,1,2011-06-17 18:30:14,2011-06-17 18:19:26
adc3b2b27670f123bd7dd742ba0fa0e0a60e1b19...8c92516f2dae4778e2b5a41196f7409823283e4b,1,1,0,1,1,2011-06-06 18:35:00,2011-06-06 06:59:10
8c92516f2dae4778e2b5a41196f7409823283e4b...06bc4b796ad69ba93f0a8c451368602e0553c2d3,1,15,15,30,4,2011-06-06 18:35:06,2011-06-06 07:06:02
06bc4b796ad69ba93f0a8c451368602e0553c2d3...df599e9612788b728ce43a03159b85f1fe624d6a,1,20,3,23,4,2011-06-06 18:35:10,2011-06-06 07:08:13
adc3b2b27670f123bd7dd742ba0fa0e0a60e1b19...b9a972691e3967166e642bd91ea229087a6b4874,1,1,0,1,1,2011-05-21 18:57:13,2011-05-21 18:43:42
b9a972691e3967166e642bd91ea229087a6b4874...81dd2fe542f68d1f4c286806ce1560b269c79275,1,3,3,6,3,2011-05-21 18:57:13,2011-05-21 18:43:43
81dd2fe542f68d1f4c286806ce1560b269c79275...bd8643ae51622abadd47535ea2f7763282f7d8ec,1,5,5,10,2,2011-05-21 18:57:13,2011-05-21 18:43:44
bd8643ae51622abadd47535ea2f7763282f7d8ec...a4372c373bc4f1a36137af315a8f8fe20385203b,1,6,6,12,2,2011-05-21 18:57:13,2011-05-21 18:43:45
a4372c373bc4f1a36137af315a8f8fe20385203b...22fdd11432d6177ad6f8b9e32f0c4a8101542786,1,5,2,7,1,2011-05-21 18:57:14,2011-05-21 18:43:46
22fdd11432d6177ad6f8b9e32f0c4a8101542786...790872592ee51318062a2c0cc68d1040d74ca529,1,7,7,14,7,2011-05-21 18:57:14,2011-05-21 18:43:47
790872592ee51318062a2c0cc68d1040d74ca529...a424ca157fec59d0fd7f1fbd8c9b48059fa0b375,1,3,3,6,2,2011-05-21 18:57:14,2011-05-21 18:43:48
a424ca157fec59d0fd7f1fbd8c9b48059fa0b375...d62a1461c31e341bea9a25d54d09dcc1cd1a28a0,1,3,3,6,3,2011-05-21 18:57:14,2011-05-21 18:43:49
d62a1461c31e341bea9a25d54d09dcc1cd1a28a0...7a74d04a46eaa24aaea8080178520266d716e5ad,1,4,1,5,1,2011-05-21 18:57:14,2011-05-21 18:43:50
7a74d04a46eaa24aaea8080178520266d716e5ad...865207a6dd9f7cc0c0941798b6ab4115b14f97a7,1,1,1,2,1,2011-05-21 18:57:14,2011-05-21 18:43:51
865207a6dd9f7cc0c0941798b6ab4115b14f97a7...dff1a98350c97c6ce207c582c8fd042bc6c04cd2,3,7,6,13,5,2011-05-21 18:57:14,2011-05-21 18:43:52
dff1a98350c97c6ce207c582c8fd042bc6c04cd2...39dc30dc1b4335083e322495567093d3886bc09b,1,1,1,2,1,2011-05-21 18:57:15,2011-05-21 18:43:53
39dc30dc1b4335083e322495567093d3886bc09b...a9f578685299239ae2de16fb7389ee9f38364b6e,1,1,0,1,1,2011-05-21 18:57:15,2011-05-21 18:43:54
a9f578685299239ae2de16fb7389ee9f38364b6e...85af5f82a67f87c7c6054572729a48d2182c72d4,1,9,9,18,8,2011-05-21 18:57:15,2011-05-21 18:43:55
85af5f82a67f87c7c6054572729a48d2182c72d4...9f35aaa917455dee3d205fc28e549a3c640fb448,1,3,3,6,3,2011-05-21 18:57:15,2011-05-21 18:43:56
9f35aaa917455dee3d205fc28e549a3c640fb448...3320a973fee4a238e684d0203b0f2d4b941a2c2b,1,6,3,9,1,2011-05-21 18:57:15,2011-05-21 18:43:57
3320a973fee4a238e684d0203b0f2d4b941a2c2b...d0ad8251100c1db6d5265d59275bed09ce4731ce,1,1,0,1,1,2011-05-21 18:57:15,2011-05-21 18:43:58
d0ad8251100c1db6d5265d59275bed09ce4731ce...dc2204fe32385fba349e18d953dacd152c72fe00,1,5,2,7,2,2011-05-21 18:57:15,2011-05-21 18:43:59
dc2204fe32385fba349e18d953dacd152c72fe00...8f3f2c44c5ef06be5a1d1617d01f536669b0b35f,1,1,1,2,1,2011-05-21 18:57:15,2011-05-21 18:44:00
8f3f2c44c5ef06be5a1d1617d01f536669b0b35f...497ee87245bfa9691fde611550b1f3f86678eda5,1,19,19,38,19,2011-05-21 18:57:15,2011-05-21 18:44:01
497ee87245bfa9691fde611550b1f3f86678eda5...ee653c89ff77eaadd2162870267ad812fdc34af5,2,9,10,19,5,2011-05-21 18:57:16,2011-05-21 18:44:02
ee653c89ff77eaadd2162870267ad812fdc34af5...b9b9c22f6db3e3c089098ba04fbc885e2cb4f4dd,1,1,1,2,1,2011-05-21 18:57:16,2011-05-21 18:44:03
b9b9c22f6db3e3c089098ba04fbc885e2cb4f4dd...165119e9e6cd9697caf3141c3433640f6804ae54,2,3,3,6,3,2011-05-21 18:57:16,2011-05-21 18:44:04
165119e9e6cd9697caf3141c3433640f6804ae54...f62f8212e1e47f25cc8e1d3e25b99c6f8c779b17,2,4,4,8,4,2011-05-21 18:57:16,2011-05-21 18:44:05
f62f8212e1e47f25cc8e1d3e25b99c6f8c779b17...490b6d5749c432370c4f8a5ed8d854cbf1116e20,2,3,3,6,3,2011-05-21 18:57:16,2011-05-21 18:44:06
490b6d5749c432370c4f8a5ed8d854cbf1116e20...3a4c3ed7e8b4f54876d6e855d3644c15d5d2207d,2,7,4,11,2,2011-05-21 18:57:16,2011-05-21 18:44:07
3a4c3ed7e8b4f54876d6e855d3644c15d5d2207d...1c2ef66f63e60539044d1e0cd8fbfbccd2cefc2e,2,3,3,6,2,2011-05-21 18:57:16,2011-05-21 18:44:08
1c2ef66f63e60539044d1e0cd8fbfbccd2cefc2e...b3e73449642d3728986f4d7620a4050f1ff0999c,2,8,6,14,7,2011-05-21 18:57:16,2011-05-21 18:44:09
b3e73449642d3728986f4d7620a4050f1ff0999c...8a583bec74d0d0eba0cab1d82cf146561d2f59d4,1,1,0,1,1,2011-05-21 18:57:16,2011-05-21 18:44:10
8a583bec74d0d0eba0cab1d82cf146561d2f59d4...365c656a70a7345ec58c34831e08740faf5d9cf7,1,4,1,5,1,2011-05-21 18:57:16,2011-05-21 18:44:11
365c656a70a7345ec58c34831e08740faf5d9cf7...5a1758710d06ce9ddef754a8ee79408277032d8b,1,2,2,4,2,2011-05-21 18:57:17,2011-05-21 18:44:12
5a1758710d06ce9ddef754a8ee79408277032d8b...b1440ce2bdfa9c5083606711b845e9d0019e2702,1,18,18,36,18,2011-05-21 18:57:17,2011-05-21 18:44:13
b1440ce2bdfa9c5083606711b845e9d0019e2702...33ceddcf243105a348401187c6d5975227c8e151,1,1,1,2,1,2011-05-21 18:57:17,2011-05-21 18:44:14
33ceddcf243105a348401187c6d5975227c8e151...777b6f13734d82a2775abdcc7220faede5e1aea8,1,8,2,10,2,2011-05-21 18:57:17,2011-05-21 18:44:15
777b6f13734d82a2775abdcc7220faede5e1aea8...155da748ef4938382db50ab5784b2a3971932c08,1,4,1,5,1,2011-05-21 18:57:17,2011-05-21 18:44:16
155da748ef4938382db50ab5784b2a3971932c08...eed10649c2864168e6205057ce49101cc1123a13,1,13,2,15,1,2011-05-21 18:57:17,2011-05-21 18:44:17
eed10649c2864168e6205057ce49101cc1123a13...d4ca6c8b3e36b67f214317879c2c4cd80d1b1c25,1,2,1,3,1,2011-05-21 18:57:17,2011-05-21 18:44:18
d4ca6c8b3e36b67f214317879c2c4cd80d1b1c25...dcf9c2e57ab8c916701dd1d4791ef479a3aaf1fc,1,1,0,1,1,2011-05-21 18:57:17,2011-05-21 18:44:19
dcf9c2e57ab8c916701dd1d4791ef479a3aaf1fc...d0238a88f502962d96242e826c003a1e9bc68eb6,1,2,2,4,2,2011-05-21 18:57:17,2011-05-21 18:44:20
d0238a88f502962d96242e826c003a1e9bc68eb6...ddd7a7c2220692ca3b25173b635218736c76b271,1,12,3,15,3,2011-05-21 18:57:18,2011-05-21 18:44:21
ddd7a7c2220692ca3b25173b635218736c76b271...c6649c92711196c477181e1a50e5a080b204c3aa,1,5,2,7,1,2011-05-21 18:57:18,2011-05-21 18:44:22
c6649c92711196c477181e1a50e5a080b204c3aa...9570fc1e6acff65f762b6d540b9ed7fe967a98d6,1,8,8,16,8,2011-05-21 18:57:18,2011-05-21 18:44:23
9570fc1e6acff65f762b6d540b9ed7fe967a98d6...15eaa0494051ae2db7fbc357bd0f5b75d3e17a31,1,6,6,12,5,2011-05-21 18:57:18,2011-05-21 18:44:24
15eaa0494051ae2db7fbc357bd0f5b75d3e17a31...0920925584f4a306daf723d1fbdf75c215755f09,1,7,3,10,2,2011-05-21 18:57:18,2011-05-21 18:44:25
0920925584f4a306daf723d1fbdf75c215755f09...7d0c2d6fbf3141cb4402987cbc2711c75490d217,1,4,2,6,1,2011-05-21 18:57:18,2011-05-21 18:44:26
7d0c2d6fbf3141cb4402987cbc2711c75490d217...55a9fc80438744eb09d2146a1c85798fbdd27764,1,4,3,7,2,2011-05-21 18:57:18,2011-05-21 18:44:27
55a9fc80438744eb09d2146a1c85798fbdd27764...04de099622ff8b5481a383e76207b65cde9b5d1a,1,8,2,10,2,2011-05-21 18:57:19,2011-05-21 18:44:28
04de099622ff8b5481a383e76207b65cde9b5d1a...be508d3a63767a9c7a03368aebf2674d18cc4b74,1,16,9,25,1,2011-05-21 18:57:19,2011-05-21 18:44:29
11c3e2b7bd617334e7730950166188e94e003f2b...a04ff3ec32b8a998a18f8b515ae4c48c1846b327,4,12,12,24,10,2011-05-04 20:30:28,2011-05-03 15:47:27
a04ff3ec32b8a998a18f8b515ae4c48c1846b327...2aab167adfe920bf641a3ad77be1854a8eaefe46,1,4,4,8,4,2011-05-04 20:30:28,2011-05-03 15:47:28
2aab167adfe920bf641a3ad77be1854a8eaefe46...ebaaf316ca5b7317a945a1590e8dab4e39932fbb,1,48,96,144,20,2011-05-04 20:30:28,2011-05-03 15:47:29
ebaaf316ca5b7317a945a1590e8dab4e39932fbb...0cc6330d0c29dcba062e909543f6adf6872622ad,1,16,2,18,3,2011-05-04 20:30:37,2011-05-04 17:19:50
da4902a73017ad82b9926d03101ec69a2802d1e7...3bee6a4733a1ff03b9cc659ea026c6dc17567d4d,1,6,2,8,4,2011-04-28 16:40:21,2011-04-28 16:01:53
3bee6a4733a1ff03b9cc659ea026c6dc17567d4d...dad4277529b856bffe07760ac3928d06b5424fdc,1,8,4,12,4,2011-05-09 04:08:13,2011-04-27 21:27:04
dad4277529b856bffe07760ac3928d06b5424fdc...1a0c9a305f88f979171815cec3548a9caa87a320,1,2,6,8,4,2011-05-10 20:13:50,2011-05-10 20:13:50
fbcda3c0a72cbcc105100ebef1b1dae54d854204...b547ce0b184f152938f2ea709b9932fa0d6181f8,1,5,5,10,3,2011-03-18 16:58:47,2011-03-18 13:14:27
fbcda3c0a72cbcc105100ebef1b1dae54d854204...31d713d069f6586c3b18aa721ccd668fa994219c,1,22,26,48,13,2011-03-17 22:30:47,2011-03-16 05:14:22
31d713d069f6586c3b18aa721ccd668fa994219c...28bd70d811391be10c55ce4aee1b6ee991d7a86b,5,4,55,59,14,2011-03-17 22:30:49,2011-03-16 05:15:31
4b5f94cdde41a58ac893c0bfb3e04f235e53f9dc...1a3e302a251ed9fb46be9552e1a2a45c73112bb9,1,3,0,3,1,2010-12-10 18:50:32,2010-12-10 18:44:15
0e4607c09d72ada4942ea49298dba83ec4145892...a9f2adff802308481f2e638bae0c5b6e205251a3,5,72,10,82,15,2010-05-20 06:57:18,2010-05-14 21:42:07
0e4607c09d72ada4942ea49298dba83ec4145892...04794fdc2701f15d79d92805cfe94c9e754e2e05,1,2,2,4,1,2010-05-19 04:45:04,2010-05-10 16:41:35
04794fdc2701f15d79d92805cfe94c9e754e2e05...67687feae52ff2d3ab7edf3ac42a39c5e44be299,3,13,0,13,3,2010-05-19 04:49:04,2010-05-13 12:31:46
67687feae52ff2d3ab7edf3ac42a39c5e44be299...1c9eecff97beab2d425397dc624281dff5c0be5c,2,2,1,3,2,2010-05-19 04:50:03,2010-05-13 08:59:00
0e4607c09d72ada4942ea49298dba83ec4145892...f89504ddb9392fa6b9407957bf26905fd1d59d0a,2,10,1,11,4,2010-05-19 04:31:51,2010-05-03 02:03:41
8fcaca3ff29a193f50a44bb3d5734a503e0539a6...14cd458126c7c70f8cf180861e3db5ed3b788813,1,6,2,8,2,2010-03-17 02:23:24,2010-03-16 17:52:37
8fcaca3ff29a193f50a44bb3d5734a503e0539a6...3aff874af239965ea78c37d14266d6c2233ad431,1,7,4,11,2,2010-03-17 02:07:09,2010-03-15 22:10:06
8fcaca3ff29a193f50a44bb3d5734a503e0539a6...71928f7f11355a25873b9693e9009acad31f40ef,1,10,10,20,3,2010-03-15 22:20:03,2010-03-15 10:54:45
71928f7f11355a25873b9693e9009acad31f40ef...7325283987430f94712713313c5089e5143f2e17,1,15,13,28,13,2010-03-15 22:25:17,2010-03-15 10:54:46
a6018bbdca918c4f0a35badcfd826077d07502ca...3e8c0eb48f25de62d6f48168487180363fa86cfb,1,1,1,2,1,2010-04-15 07:53:08,2010-04-15 07:35:20
3e8c0eb48f25de62d6f48168487180363fa86cfb...a6ccbbdb66be4e4b90bd54fc644d6366491996b5,1,2,2,4,2,2010-04-17 19:40:19,2010-04-15 09:36:25
a6ccbbdb66be4e4b90bd54fc644d6366491996b5...8de096b6718048e84ee88e604a94b22937a0758e,1,38,37,75,12,2010-04-17 19:40:19,2010-04-15 12:57:18
8de096b6718048e84ee88e604a94b22937a0758e...39407304f11b4ae1977acd9875b9b8540bff2874,1,2,2,4,2,2010-04-17 19:40:20,2010-04-15 13:29:45
39407304f11b4ae1977acd9875b9b8540bff2874...f02dd06e26ed9f6f6f265791cfc7bfb48babf3b5,1,1,1,2,1,2010-04-17 19:40:20,2010-04-17 02:29:18
3330a2c4f6b494f2b02fda2869d85bc1f8e019aa...16402b992e0332d2ac68106f4488b47175bf0a13,2,48,0,48,3,2014-02-10 19:49:53,2014-02-09 00:26:37
16402b992e0332d2ac68106f4488b47175bf0a13...7e2e4b37d3d57a95a525ba1a18224ba04f858768,3,19,13,32,10,2014-02-10 19:49:53,2014-02-09 00:26:38
7e2e4b37d3d57a95a525ba1a18224ba04f858768...35e4d775875603c748a127c82909f5d62a410ac8,1,1,1,2,1,2014-03-11 19:11:49,2014-03-11 07:46:40
3330a2c4f6b494f2b02fda2869d85bc1f8e019aa...5fe8f49b6d59cf143a5898ddbb161444a95fa871,6,7,7,14,7,2014-02-05 22:35:45,2014-02-05 22:19:43
6d816301cd53e54af3398b634d47588a6f184be4...f1863d0d16b9a5288671e17b7fa2eba8244ead2f,4,37,207,244,31,2010-02-17 23:07:15,2010-02-16 23:42:52
6d816301cd53e54af3398b634d47588a6f184be4...453541fcfcbc54aa3b0035667e5d5885d407d0a5,1,2,2,4,2,2010-02-17 19:18:09,2010-02-07 20:51:18
453541fcfcbc54aa3b0035667e5d5885d407d0a5...1df48766137f2040e2e992d7d278d5aca26406cf,1,8,1,9,6,2010-02-17 19:18:12,2010-02-07 20:52:25
3c0ae1bd729284d6cdb7a4bc3cb3d8cfe9fd08c1...d0b8d79510cd9c45a4c6bc08a37c6348f8293e8a,1,1,25,26,8,2010-06-17 00:10:11,2010-06-17 00:10:11
a2c3db8d224554f7cf995ae8403a0f081432cbae...a76c2acb28146f5630592f2ba738c0ebf0f3c1c4,1,14,14,28,6,2007-08-06 05:08:54,2007-08-06 04:34:02
b5ef6ac978012475660a36583b2174e9bd8188a5...059f446d57d51fbacdace3fbadf2414916c201dd,2,11,3,14,4,2007-09-08 04:02:08,2007-09-07 14:20:50
059f446d57d51fbacdace3fbadf2414916c201dd...d05ec5a064e402475ab48617213f2a619a2fabc5,1,0,1,1,1,2007-09-08 04:02:11,2007-09-07 14:20:51
b5ef6ac978012475660a36583b2174e9bd8188a5...b449f4cfc972929b638b90d375b8960c37790618,5,180,28,208,28,2007-09-07 06:57:44,2007-09-06 11:20:05
b449f4cfc972929b638b90d375b8960c37790618...7a604f16b71e3bfd1c6e30d400f05be918e5376e,1,16,49,65,11,2007-09-07 06:57:44,2007-09-06 11:20:06
7a604f16b71e3bfd1c6e30d400f05be918e5376e...4a241d79c9020dcafb1f254774bcab200171ab46,1,13,17,30,9,2007-09-07 06:57:44,2007-09-06 11:20:07
4a241d79c9020dcafb1f254774bcab200171ab46...d52bc66152834dff3fb5f32a54f6ed57730f58c6,1,8,15,23,4,2007-09-07 06:57:44,2007-09-06 11:20:08
b5ef6ac978012475660a36583b2174e9bd8188a5...2c3c4399477533329579ca6b84824ef0b125914f,1,63,1,64,7,2007-09-06 07:08:56,2007-09-05 20:01:37
2c3c4399477533329579ca6b84824ef0b125914f...d4bb43ee273528064192848165f93f8fc3512be1,4,6,0,6,4,2007-09-06 07:08:56,2007-09-05 21:59:59
d4bb43ee273528064192848165f93f8fc3512be1...000dfd3f6e3f61e15ccfd4cecb3a51624adfbf38,2,8,7,15,6,2007-09-17 19:25:26,2007-09-17 06:15:19
000dfd3f6e3f61e15ccfd4cecb3a51624adfbf38...08cdfb13374f31b0c1c47444f55042e7b72c3190,1,93,2,95,8,2007-09-17 19:25:26,2007-09-17 06:20:07
08cdfb13374f31b0c1c47444f55042e7b72c3190...65aa53029a32a1ad36523f3e7a1bb933d4494805,1,11,3,14,4,2007-09-18 06:12:11,2007-09-17 06:24:07
65aa53029a32a1ad36523f3e7a1bb933d4494805...caf9de2f46471dc25180bf519c07537c00a68dda,1,7,2,9,2,2007-09-18 06:12:15,2007-09-17 07:37:06
caf9de2f46471dc25180bf519c07537c00a68dda...e9831e83e063844b90cf9e525d0003715dd8b395,2,17,1,18,3,2007-09-18 06:12:15,2007-09-17 07:39:52
e9831e83e063844b90cf9e525d0003715dd8b395...a087cc9819d5790a0aeb42c2bd74f781c555e8d6,1,17,8,25,4,2007-09-18 06:12:15,2007-09-17 07:44:17
a087cc9819d5790a0aeb42c2bd74f781c555e8d6...95143f9e686dee144e0ff4a20190b923e20e1b64,1,10,5,15,4,2007-09-18 06:12:15,2007-09-17 07:48:39
95143f9e686dee144e0ff4a20190b923e20e1b64...17815501a8f95c080891acd9537514adfe17c80e,3,66,7,73,11,2007-09-18 06:12:16,2007-09-17 07:55:13
5587cac28be66acf5edc2a4b83b67c8cfffbc5e9...6b763c424e4ace1678ade5310f3ca3ffbd11af2c,2,60,1,61,2,2007-09-06 04:58:40,2007-09-06 04:58:40
6b763c424e4ace1678ade5310f3ca3ffbd11af2c...ea09ea22d65d118328642e03ad23c8257304499d,1,6,0,6,1,2007-09-06 05:24:54,2007-09-06 03:33:41
ea09ea22d65d118328642e03ad23c8257304499d...6b1b40d9f41cdc1db9ad60f143c08f8260eef815,1,1,1,2,1,2007-09-06 06:08:22,2007-09-05 23:22:51
6b1b40d9f41cdc1db9ad60f143c08f8260eef815...432e93a16441a1a11aeb8158a634f76c214abb31,1,0,2,2,2,2007-09-06 06:17:04,2007-09-06 02:15:21
432e93a16441a1a11aeb8158a634f76c214abb31...4e560158c6de154fafab9fc3f6028d9edcc53e6b,1,6,0,6,1,2007-09-06 06:25:09,2007-09-06 04:44:08
5587cac28be66acf5edc2a4b83b67c8cfffbc5e9...1e61b7640d09015213dbcae3564fa27ac6a8c151,3,16,2,18,3,2007-09-03 09:40:06,2007-09-03 09:40:06
776398709dee4050fc194fec45c5818ba9b01afe...75d3985319f2eb40008e9fe6454880ecc620a0de,1,42,35,77,10,2007-09-06 06:49:10,2007-09-06 06:13:08
75d3985319f2eb40008e9fe6454880ecc620a0de...ef0316fcd996c1679fef37ae2a53bef403c77356,1,14,14,28,16,2007-09-06 06:49:28,2007-09-06 06:13:09
ef0316fcd996c1679fef37ae2a53bef403c77356...e334977dfad575cd8ac1a9e5f8e73fe4d018cec0,1,14,9,23,8,2007-09-06 07:01:44,2007-09-06 06:13:10
e334977dfad575cd8ac1a9e5f8e73fe4d018cec0...8ecce684a38f7cea084abe9eef80bda04d7c77be,2,90,1,91,12,2007-09-06 07:01:45,2007-09-06 06:13:11
8ecce684a38f7cea084abe9eef80bda04d7c77be...c2a33679a726aeb75529540c2b295f21023ddbc7,1,45,14,59,7,2007-09-10 05:25:33,2007-09-10 04:06:09
c2a33679a726aeb75529540c2b295f21023ddbc7...59921b4b3f24b19e2593085ee27d5e1f2448c6bb,1,5,0,5,1,2007-09-10 05:25:43,2007-09-10 04:06:10
59921b4b3f24b19e2593085ee27d5e1f2448c6bb...367f4a4343d467ac76641362b102bc86da5cb584,2,29,5,34,8,2007-09-10 05:26:06,2007-09-10 04:06:11
367f4a4343d467ac76641362b102bc86da5cb584...b81d9af71e1c6460511322c276b4b7ad7c86c444,1,6,5,11,5,2007-09-10 17:49:11,2007-09-10 12:40:44
b81d9af71e1c6460511322c276b4b7ad7c86c444...693b86fffb4271dece49f439b133595924a75cbb,2,20,1,21,3,2007-09-10 17:50:21,2007-09-10 15:51:34
693b86fffb4271dece49f439b133595924a75cbb...3c70183918d97eda06ae847cd7432fd23257caea,1,20,4,24,8,2007-09-12 19:56:09,2007-09-10 15:10:11
3c70183918d97eda06ae847cd7432fd23257caea...e1ef867328bd7d2cd67499ac30479821bdf96662,1,6,6,12,1,2007-09-15 05:30:20,2007-09-15 05:30:20
941fd1c041204f30279c175ca9b7252ffcb52ba2...a475e8095aeb898c1ca60673b82df97d2300cc95,1,5,2,7,3,2007-08-21 05:48:29,2007-08-21 05:48:29
a475e8095aeb898c1ca60673b82df97d2300cc95...e301bfeea19e284344868840793c58d2e7529c74,1,7,3,10,2,2007-08-22 22:18:13,2007-08-22 01:50:12
e301bfeea19e284344868840793c58d2e7529c74...8fa0ee3b50736eb869a3e13375bb041c1bf5aa12,1,8,0,8,1,2007-08-22 22:18:13,2007-08-22 05:33:49
8fa0ee3b50736eb869a3e13375bb041c1bf5aa12...687157c736d7a1aac152866cbe20030aaa25513f,3,17,27,44,5,2007-08-22 22:19:41,2007-08-21 18:01:16
687157c736d7a1aac152866cbe20030aaa25513f...2f5b3980617bd618ebb4314cadaff4e71ce2a390,1,7,1,8,1,2007-08-22 22:28:58,2007-08-22 16:13:07
2f5b3980617bd618ebb4314cadaff4e71ce2a390...ef08c14993a8d2881941667c0264c97c6874ccee,1,5,3,8,1,2007-08-22 22:29:08,2007-08-22 10:21:38
ef08c14993a8d2881941667c0264c97c6874ccee...620e729dd3625f3329e9cb50a1175648b5672653,1,3,3,6,2,2007-08-22 22:37:30,2007-08-22 08:18:03
620e729dd3625f3329e9cb50a1175648b5672653...63c2bd25d685faeed2c1e486cd957daaaaac7052,1,3,0,3,1,2007-08-22 22:37:56,2007-08-21 17:15:09
63c2bd25d685faeed2c1e486cd957daaaaac7052...412876dcbb7ca10e64ed8118bc1995788d397782,1,3,0,3,2,2007-08-22 22:38:37,2007-08-17 21:38:25
412876dcbb7ca10e64ed8118bc1995788d397782...aabb2e515c334cbca9d9ae9873a188cef2c9b3ba,1,32,0,32,1,2007-08-22 22:38:48,2007-08-16 08:56:45
ed5f07a6fdc5653e24a5bd6c216d12bc878496bd...5fda48d67c82e07950e0b0c21cd8c97daefd7be0,2,11,1,12,3,2007-07-07 18:54:51,2007-07-07 17:50:39
f31b6ff747afeb204299b7a67ce2ec59beb33b7d...b215883de9322b8b475a04b4768d6ba5455373d1,1,1,1,2,1,2007-07-12 06:45:23,2007-07-12 06:45:23
3c84ac86fc896c108b789b8eb26b169cc0e8088a...2ae7f90f263760abd242501471f123632395d7b3,1,1,2,3,1,2015-02-22 20:01:37,2015-02-21 19:49:58
2ae7f90f263760abd242501471f123632395d7b3...008d5d005d862d9b0309af94dfc266e3b06bdf6d,1,3,4,7,3,2015-02-22 20:01:37,2015-02-21 19:51:28
008d5d005d862d9b0309af94dfc266e3b06bdf6d...68d6d6eb402d7e39c89ce43ca37e6c16b941890c,1,1,1,2,1,2015-02-22 20:01:37,2015-02-21 19:53:09
68d6d6eb402d7e39c89ce43ca37e6c16b941890c...2ce63e9fac242a70cd6d9e1325063bbb2e5091f8,1,2,6,8,2,2015-02-22 20:01:38,2015-02-21 19:55:22
3c84ac86fc896c108b789b8eb26b169cc0e8088a...edef953e482ce212b7d68bbe0f59e34b5552db3e,1,29,8,37,7,2015-02-17 21:40:36,2015-02-15 18:31:41
edef953e482ce212b7d68bbe0f59e34b5552db3e...dc8edc8f7d503b96dc4ceb275f7f6ca7637be5a9,1,45,9,54,3,2015-02-17 21:40:49,2015-02-15 18:33:52
3c84ac86fc896c108b789b8eb26b169cc0e8088a...94bc83c5930c8c73fb0106b629123e2413b371af,1,11,1,12,2,2015-02-17 21:15:07,2015-02-17 08:37:35
94bc83c5930c8c73fb0106b629123e2413b371af...5248f2dd4fe763ef9d1267f50481deee36ee57c1,1,16,0,16,1,2015-02-17 21:15:07,2015-02-17 08:40:57
5248f2dd4fe763ef9d1267f50481deee36ee57c1...b48537305229d1a4f25633f71941ee52d2582017,2,56,5,61,6,2015-02-17 21:15:30,2015-02-17 19:09:24
3c84ac86fc896c108b789b8eb26b169cc0e8088a...5e915f3085db3c0edbc80269f889341172e8595b,1,5,1,6,3,2015-02-10 18:35:32,2015-02-10 01:07:19
3c84ac86fc896c108b789b8eb26b169cc0e8088a...697f652818f211aa48e3c007f25d6177647980c1,1,14,6,20,4,2015-01-29 22:07:13,2015-01-29 20:26:09
3c84ac86fc896c108b789b8eb26b169cc0e8088a...b65c05882fd5d42ade3c101e7e96f48a8249c82a,1,2,9,11,3,2015-01-29 06:48:16,2015-01-29 05:15:24
3c84ac86fc896c108b789b8eb26b169cc0e8088a...394e1505b8c359461c4b7cbbd204f86b185c64a0,1,4,5,9,3,2015-01-28 20:21:12,2015-01-27 20:19:11
394e1505b8c359461c4b7cbbd204f86b185c64a0...502e7f9851768974a5b45a9dc00882231dac5c90,1,4,4,8,4,2015-01-28 20:22:01,2015-01-27 20:25:48
502e7f9851768974a5b45a9dc00882231dac5c90...35840a3e789dd67528caefc146deb698bd6ac7a5,1,23,0,23,1,2015-02-02 19:28:55,2015-01-27 20:26:03
3c84ac86fc896c108b789b8eb26b169cc0e8088a...edb72d551128f798f5f43292789cb7c731d1e01f,2,15,9,24,9,2015-01-22 20:19:47,2015-01-22 11:50:15
3c84ac86fc896c108b789b8eb26b169cc0e8088a...1767c51787f2a9aaf99716a48e8928618c1c9481,2,6,1,7,2,2015-01-16 17:33:46,2015-01-16 09:16:49
1767c51787f2a9aaf99716a48e8928618c1c9481...eae69530ae3915d54f660d56cc3f92dd6bed03ae,2,14,5,19,3,2015-01-16 18:36:15,2015-01-16 18:32:09
eae69530ae3915d54f660d56cc3f92dd6bed03ae...f400e51c13eb4143e420d41d9b415d4f5ddbdb85,1,22,3,25,1,2015-02-15 23:48:38,2015-01-27 15:39:01
3c84ac86fc896c108b789b8eb26b169cc0e8088a...f6786c8dcba34d0cea54a065efd79af678cb8dea,1,3,0,3,1,2015-01-14 18:28:02,2015-01-13 02:28:58
3c84ac86fc896c108b789b8eb26b169cc0e8088a...22dfa8a23de4bbb274027736edd3bd311dda2981,5,25,2,27,6,2015-01-13 18:20:32,2015-01-13 01:33:32
77933f4449b8d6aa7529d627f3c7b55336f491db...9b7cbb315923e61bb0c4297c701089f30e116750,4,38,3,41,5,2014-12-17 19:49:34,2014-12-17 19:49:34
7695982c20aa7502297af09b717350a8dd1250fd...beb691f77028ae2e93653fdfccebd0a070042b43,1,831,824,1655,785,2015-01-13 06:05:57,2015-01-13 06:05:57
beb691f77028ae2e93653fdfccebd0a070042b43...fbf5d8c3d056d4b943f0c40463c82996dcebd3ca,1,986,1019,2005,940,2015-01-13 07:23:12,2015-01-13 07:23:12
fbf5d8c3d056d4b943f0c40463c82996dcebd3ca...9905988a57ad16a6152b1ec46f51524eea633bba,1,852,833,1685,786,2015-01-13 19:23:41,2015-01-13 19:22:58
9905988a57ad16a6152b1ec46f51524eea633bba...2a26377047ff75a3b9b5ca3156d9fd912eb4f737,1,865,842,1707,794,2015-01-14 21:55:49,2015-01-14 21:55:49
2a26377047ff75a3b9b5ca3156d9fd912eb4f737...04cb2f28ccc9f321d20f1f785fb362dec2da4035,1,853,830,1683,787,2015-01-17 07:28:36,2015-01-04 04:27:38
04cb2f28ccc9f321d20f1f785fb362dec2da4035...463243d49cc49c1c56412c55074faa66f1af8d9c,1,20,20,40,19,2015-01-17 17:09:56,2014-12-06 19:16:49
463243d49cc49c1c56412c55074faa66f1af8d9c...e1a05ad85144c6d0032f7c62f885f09e3677a849,1,1,1,2,1,2015-01-17 17:10:02,2014-12-31 19:16:35
e1a05ad85144c6d0032f7c62f885f09e3677a849...124d80928d2a89e78212d03eb9fa3ba1aaa4d56b,1,857,836,1693,791,2015-01-17 17:10:46,2014-12-31 19:06:51
f69f5f19cfae949b2bbd6c6ffbb990b6a00d04b0...1165ae6f3d42e0eb0ddfc2d4e6dfa8bd0b88eb60,3,14,2,16,4,2015-03-06 22:58:14,2015-03-06 22:58:14
71b59849753589c3faa04176e875071417ceddd5...3759d27aca3ddd78b4b1169a767809748dc1fc3f,2,5,0,5,2,2015-01-20 23:56:03,2015-01-20 22:14:48
a63373244060d8f7044e32a7a3d00211b62f7f7c...c18b86734113ee2aeb0e140c922c8fbd4accc860,2,57,1,58,2,2014-12-05 20:03:57,2014-12-05 20:03:57
c2e8e4b9da4d007b15faa2e3d407b2fd279f0572...860109937386f2d103a71d3f703ad34cc1ebd136,1,5,2,7,1,2015-01-07 18:21:17,2014-12-30 23:30:30
c2e8e4b9da4d007b15faa2e3d407b2fd279f0572...e0a1f0931312f3eab8134ada4487216eafd8fd30,1,89,105,194,8,2015-01-06 23:03:52,2015-01-04 10:54:47
c2e8e4b9da4d007b15faa2e3d407b2fd279f0572...aa7710e064a9ee644e1e86bd6f89193200ac4ccd,1,3,3,6,3,2014-12-29 20:40:42,2014-12-27 23:39:46
aa7710e064a9ee644e1e86bd6f89193200ac4ccd...fad32bcd83ec4e4f88013e4a0b05f42e32e2c6f5,1,7,3,10,5,2014-12-29 20:40:45,2014-12-27 23:39:47
fad32bcd83ec4e4f88013e4a0b05f42e32e2c6f5...06a604e67051b9342c158432a49e42a5440f9280,1,28,5,33,9,2014-12-29 20:40:48,2014-12-27 23:39:48
c2e8e4b9da4d007b15faa2e3d407b2fd279f0572...6bc02d5627358f6a264c5dbb159b5a9aeb44ebf4,1,7,4,11,3,2014-12-29 19:19:55,2014-12-25 18:25:32
6bc02d5627358f6a264c5dbb159b5a9aeb44ebf4...07913d5ae15d7f583a506ce991a6b88761e600e2,1,9,0,9,1,2014-12-29 19:34:05,2014-12-25 18:25:33
c2e8e4b9da4d007b15faa2e3d407b2fd279f0572...6b33894f9973185135a5ddd7d665c56bf5ca9a20,1,1,3,4,1,2014-12-29 17:39:23,2014-12-24 00:18:31
c2e8e4b9da4d007b15faa2e3d407b2fd279f0572...8547e0f17697affd24d7a185245f0442af246f40,1,1,3,4,2,2014-12-29 17:32:45,2014-12-24 00:18:11
c2e8e4b9da4d007b15faa2e3d407b2fd279f0572...d69360c6b17d1693a60b9f723a3ef5129a62c2e5,1,1,1,2,1,2014-12-23 15:34:19,2014-12-22 23:25:44
7ba2ba7d12163a8f9a9947d7880bd26f2970d4c5...652e759330da379a8e09e03bbf99e03c10c228cc,2,15,14,29,11,2014-11-21 20:10:56,2014-11-21 20:10:56
7ba2ba7d12163a8f9a9947d7880bd26f2970d4c5...1d31e5a2cd9f90799330d5095783e7b972357f0e,2,8,2,10,3,2014-11-21 18:19:14,2014-11-21 16:08:19
ea4f93eb99038329bbd692c5c8246e5ec8c11da9...5a97639b396a007a226308b6eceae5efb71c7500,1,1,1,2,1,2014-11-18 18:16:06,2014-11-18 17:22:31
5a97639b396a007a226308b6eceae5efb71c7500...880ef58b3d0e522bd3cfe49fc4b41b0a0ed33164,2,3,3,6,3,2014-11-18 18:16:09,2014-11-18 17:29:32
e69b1ce000e6c530ac8bf06470742456277e2a36...e32afab7b0376a7b07601a87cd5c6841ff2a811a,1,38,15,53,11,2014-12-03 20:49:24,2014-11-26 20:38:28
e69b1ce000e6c530ac8bf06470742456277e2a36...16d4fa3d9667ca28a519c46c1b1c752a848a693c,1,21,18,39,2,2014-11-25 18:07:45,2014-11-25 08:02:29
16d4fa3d9667ca28a519c46c1b1c752a848a693c...28d3f214d12af4a3d7e625faf4bb0af6c735fa8b,1,9,6,15,5,2014-11-25 18:09:45,2014-11-25 08:02:30
28d3f214d12af4a3d7e625faf4bb0af6c735fa8b...6d6d06c9012e96d74e9ea7aeeb6ce6dcd1a11b0f,1,2,1,3,2,2014-11-25 18:09:49,2014-11-25 08:02:31
6d6d06c9012e96d74e9ea7aeeb6ce6dcd1a11b0f...4a45b2f347245d321bf5c07fbe3f8091d122732f,3,31,31,62,22,2014-11-25 18:09:58,2014-11-25 08:02:32
4a45b2f347245d321bf5c07fbe3f8091d122732f...fcce0da9750345d3f327ef4767cf2e166e40ce12,1,6,6,12,6,2014-11-25 18:10:31,2014-11-25 08:02:33
fcce0da9750345d3f327ef4767cf2e166e40ce12...8552943f41373583b5185a9686102251c544c07e,1,6,8,14,4,2014-11-25 18:10:52,2014-11-25 08:02:34
8552943f41373583b5185a9686102251c544c07e...3383e199847485fedf83d0fa38bbd5363074093a,11,20,20,40,18,2014-11-25 18:11:34,2014-11-25 08:02:35
e69b1ce000e6c530ac8bf06470742456277e2a36...068395150b8a2b3e6fbed3e60ca5cbb7c7bb6a99,1,8,2,10,2,2014-11-20 16:25:03,2014-11-19 22:28:52
4ace7ff4557350b7e0b57d024a2ea311b332e01d...dd83521629d95d0c8e4aff85edb16715a13689a3,1,3,3,6,3,2014-11-03 19:29:10,2014-11-03 15:12:00
dd83521629d95d0c8e4aff85edb16715a13689a3...f745acb028ee8f7dcd1c8f10127b8feeaa255cf7,19,30,30,60,27,2014-11-04 21:14:44,2014-11-03 20:37:07
4ace7ff4557350b7e0b57d024a2ea311b332e01d...fa137f67a40bbcb3f583920586fdd34ce98ddeaf,2,26,3,29,2,2014-11-03 19:00:28,2014-11-02 06:24:37
4ace7ff4557350b7e0b57d024a2ea311b332e01d...d07a63e47ccfb9fb97666d4f189b88807a9f44fa,1,1652,1457,3109,1372,2014-10-31 23:47:46,2014-10-31 23:47:46
a33043f6393ae2a737f08d4f42d78fb06ba1e107...fbecd99861ea5795aeba46faf2ac7a8c1b70d485,1,11,0,11,3,2014-10-24 22:02:17,2014-10-24 22:02:17
7faf068660f0a060066ccbc80f7debbba6bc2d76...192a6be2a77ab3bf446237fdf6575b0aca863d9e,2,3,3,6,2,2007-05-30 22:01:37,2007-05-30 17:32:19
192a6be2a77ab3bf446237fdf6575b0aca863d9e...86d14e1b1d1063fc943c71edc8b05e1ce32c1602,1,1,1,2,1,2007-05-30 22:03:50,2007-05-30 12:39:58
86d14e1b1d1063fc943c71edc8b05e1ce32c1602...90a36e581daa25949fd0ff68fc68ae5b705fc990,1,6,4,10,3,2007-05-31 06:44:59,2007-05-31 00:35:36
90a36e581daa25949fd0ff68fc68ae5b705fc990...17014090036b9b996707dfca5af69f1e87bd2315,1,59,7,66,6,2007-05-31 06:56:37,2007-05-31 00:35:37
597a63054241c122515c93cbce45bc44eb231f18...b09c53a3e331211fc0154de8ebb271e48f8c7ee5,4,102,50,152,14,2011-02-22 23:19:45,2011-01-30 19:40:41
b09c53a3e331211fc0154de8ebb271e48f8c7ee5...2169ddc056b56deba701cbbba28cdaf2e9821224,2,10,1,11,3,2011-02-22 23:19:46,2011-02-01 07:13:47
597a63054241c122515c93cbce45bc44eb231f18...d00d2ed1c5bd41a26c61236e79e82764baad464b,1,55,0,55,1,2011-02-21 17:49:27,2011-02-19 13:17:54
d00d2ed1c5bd41a26c61236e79e82764baad464b...68b28593899d528d4b59e7eb07cc37b85012376a,2,17,1,18,3,2011-02-21 17:50:16,2011-02-19 13:17:55
68b28593899d528d4b59e7eb07cc37b85012376a...1494fcbb75299eb16cfb9817aea591f3f2dcdfed,1,1,1,2,1,2011-02-21 17:51:48,2011-02-19 13:17:56
1494fcbb75299eb16cfb9817aea591f3f2dcdfed...56c093451c7b2b485b194943ea071aca4e74733d,1,7,5,12,5,2011-02-21 17:52:46,2011-02-19 13:17:57
56c093451c7b2b485b194943ea071aca4e74733d...d88e707f17ddcf3f789ec7fb1eb33121cecdcd67,1,4,0,4,1,2011-02-21 17:56:56,2011-02-19 13:17:58
d88e707f17ddcf3f789ec7fb1eb33121cecdcd67...e32e00dc88948a730b8b1f3b8129f30c313713e7,1,2,0,2,1,2011-02-21 17:57:29,2011-02-19 13:17:59
e32e00dc88948a730b8b1f3b8129f30c313713e7...084f6306d4b7b27a5d12236e808604220b8b3e3f,2,40,0,40,3,2011-02-21 17:58:38,2011-02-19 13:18:00
084f6306d4b7b27a5d12236e808604220b8b3e3f...382000769477ed0666e99d01c21df64df9ba0911,2,23,4,27,6,2011-02-21 18:05:44,2011-02-19 13:18:01
597a63054241c122515c93cbce45bc44eb231f18...787d2a784b1d5d9c59c0098533ce9fdb757942d9,1,3,2,5,2,2011-02-07 06:50:26,2011-02-06 00:58:53
787d2a784b1d5d9c59c0098533ce9fdb757942d9...13af8cbd6af3f572a5c6c2fb7adc8fc7c408a3e2,1,1,1,2,2,2011-02-07 22:18:56,2011-02-04 08:41:58
13af8cbd6af3f572a5c6c2fb7adc8fc7c408a3e2...899663f8e452caf158d98d558a41f9b04042b18f,1,4,2,6,3,2011-02-07 22:27:10,2011-02-03 15:31:42
899663f8e452caf158d98d558a41f9b04042b18f...97a853d34baef41f6d235ba49bf390d063fbd9df,1,7,2,9,2,2011-02-07 22:27:25,2011-02-03 15:31:43
97a853d34baef41f6d235ba49bf390d063fbd9df...c91897b3b074d5185c3897e7afc41aa091f6ec66,1,4,0,4,1,2011-02-07 22:27:46,2011-02-03 15:31:44
c91897b3b074d5185c3897e7afc41aa091f6ec66...80aa55b40ba36a4d0c43d6348a2831b0c6f17e62,1,1,1,2,1,2011-02-07 22:28:21,2011-02-03 01:00:32
80aa55b40ba36a4d0c43d6348a2831b0c6f17e62...2e9c8789b7b0d4d3cd2f951e1694387686e2d740,1,6,0,6,1,2011-02-07 22:29:15,2011-02-03 23:20:48
2e9c8789b7b0d4d3cd2f951e1694387686e2d740...a2b7a3b3a966c5801efe968d4b5656fa5a885409,5,71,2,73,5,2011-02-07 23:04:30,2011-02-03 06:23:34
a2b7a3b3a966c5801efe968d4b5656fa5a885409...cf7b1cad0e8b024538de975dff5893262cec72d7,4,6,6,12,5,2011-02-07 23:04:42,2011-02-05 10:52:20
9d9f5e72dc5959750498acc81b3e2c8ca76ad499...6e97ef31ce20ff93a4cc0e3c6ab5171fd6dda5f3,2,3,1,4,2,2011-01-05 22:49:19,2011-01-05 22:49:19
9d9f5e72dc5959750498acc81b3e2c8ca76ad499...6822052427353525fe7158398bc6cf4bbd5d1351,1,9,4,13,1,2011-01-04 18:49:32,2010-09-04 00:45:09
2cd900fcf577af2cc5094ba21d1699809649f3bc...01b97a4cb60723d18b437efdc474503d2a9dd384,2,10,11,21,6,2010-12-28 21:53:24,2010-12-28 21:52:52
01b97a4cb60723d18b437efdc474503d2a9dd384...469bfc962df22a87f0f0c60699d91fa9e647492a,12,26,27,53,21,2011-01-04 19:23:42,2011-01-03 19:03:34
469bfc962df22a87f0f0c60699d91fa9e647492a...081f84ee9edb1775e5a5495375a93b3bc6727742,1,4,3,7,1,2011-01-04 19:23:42,2011-01-04 04:04:46
e6dfbcf12b0e70897818cb36903de0625931a5c6...01d4721565f1562172149ebb91d29d6a7e7f922d,3,21,2,23,4,2012-08-24 16:00:43,2012-07-25 17:41:54
e6dfbcf12b0e70897818cb36903de0625931a5c6...41f597d9bbac33a7e522c5f74b83e712ea2de13a,1,9,0,9,1,2012-07-23 22:10:36,2012-07-23 21:13:12
e6dfbcf12b0e70897818cb36903de0625931a5c6...109859e27445a3ad12eb8f8cba43a5aa8f701733,3,49,5,54,6,2012-07-23 21:42:39,2012-07-23 21:16:12
bfbf4d477a33be413800f531c3ac0d227f46ab44...9145b19ecf163b9a4aa3c9fda38ca3af41cd52d3,1,1,1,2,1,2012-08-06 21:21:13,2012-08-06 21:06:14
bfbf4d477a33be413800f531c3ac0d227f46ab44...bb2ba06fd3e325d377dd011242714fe6b1a112bc,1,9,7,16,6,2012-08-06 15:48:08,2012-08-06 15:48:08
99e63ef24e18c8ca918922b052de96a8ceca48a4...d2d434beeb03e4ee648ca7ca2a1ea1ed09077306,1,1,1,2,1,2011-01-27 20:13:07,2011-01-27 12:51:51
342953a6860915b4b66dfb24147c46a191342daf...630fc7878b6fd1bc188d4916b64f4df37658df96,1,1,7,8,2,2011-01-24 19:00:00,2011-01-24 19:00:00
477039c53c456273d59a1d5427fa6eb2deaaa239...adf872e7837cc92e390f00ee32f32c5639d3a444,2,11,3,14,4,2011-01-13 20:14:18,2011-01-13 19:42:01
c43a1bede3319ee95c21e753ed53d907041f5cee...ccef6048cd697063967e5e02937911fd8125b364,2,3,2,5,3,2011-08-24 19:16:58,2011-08-24 19:16:58
d5a719e4afbfd74cf5ccf94c2a5b27aa5d06e914...4cc6260684207865344f5b9a7065284d564d4e61,2,14,14,28,8,2011-02-22 05:48:55,2011-02-21 20:05:25
5673d695fcce217b26d1a5956c1184ff62dc74f1...be8ef33c1deabf34a82e4af98bd35243939ed9a5,1,121,23,144,8,2011-02-22 05:57:19,2011-02-20 05:21:50
aeb2aaa7712f7af8237d5bceb725a7db8c2d4620...5e839c8f6d5edfaf0d2250f3c9628a238e24c6be,1,27,0,27,5,2011-03-23 05:02:24,2011-03-23 05:02:24
24231e063f0f003f8ffd7b64c7ba6a0baaaa5283...855942528e892cff3cadb4eb1c4cf1d2a7cd83de,1,4,2,6,2,2011-02-16 18:05:14,2011-02-14 13:02:51
24231e063f0f003f8ffd7b64c7ba6a0baaaa5283...b1afe49dfbe9e91631bd011a47034fbf3ffd682e,1,1,1,2,1,2011-02-15 19:53:00,2011-02-15 19:02:56
b1afe49dfbe9e91631bd011a47034fbf3ffd682e...1d5006ab31373bc6f316ddb6c9357cb735332eb2,1,1,1,2,1,2011-02-15 19:53:09,2011-02-15 13:09:11
1d5006ab31373bc6f316ddb6c9357cb735332eb2...23c6a803d3e6523ec20154e30ae8a51d2ff998ca,8,25,25,50,18,2011-02-15 19:53:10,2011-02-15 13:09:12
23c6a803d3e6523ec20154e30ae8a51d2ff998ca...41dbcd45409b2986c011e67dd9e2b4d3072fc88d,2,2,2,4,2,2011-02-15 19:53:11,2011-02-15 13:09:13
41dbcd45409b2986c011e67dd9e2b4d3072fc88d...3b0d24053b50d8da76de28ea5f0d3947fa3d2194,3,13,13,26,12,2011-02-17 19:49:54,2011-02-17 07:48:06
43f9f053010c119c9836b2b5f8a07c72784f79b6...ef5dd8a92249db22b0e30a37c7c960029c56115e,1,9,9,18,12,2011-02-15 21:46:18,2011-02-15 03:09:03
853563d7344ee532aa56f8a9aabcfdfb5c4fe2c3...a2b665de4b694b04959f6371f9887f7ad5cae404,3,74,1,75,7,2010-12-22 18:19:32,2010-12-22 14:40:13
a2b665de4b694b04959f6371f9887f7ad5cae404...4290f690676bc14c49c7cddbcda1c09017948718,1,1,0,1,1,2010-12-22 23:18:47,2010-12-22 23:18:47
853563d7344ee532aa56f8a9aabcfdfb5c4fe2c3...84563a624e1e417c452491f3b9fba8879e989af0,1,8,4,12,5,2010-12-22 18:02:13,2010-12-22 17:09:55
84563a624e1e417c452491f3b9fba8879e989af0...83c90314aa27ae3768c04375d02e4f3fb12b726d,1,56,0,56,3,2011-01-04 21:03:32,2010-12-22 22:13:47
853563d7344ee532aa56f8a9aabcfdfb5c4fe2c3...6cf6bb3e47ac2f667fa0b27a4222e903ff6fb77c,4,56,4,60,7,2010-12-22 03:51:17,2010-12-18 21:28:00
92622e62145b05a159b057a4334205e6a3b07630...4cb6764227173a6483edbdad09121651bc0b01c3,2,6,2,8,3,2011-11-08 00:48:34,2011-11-08 00:48:34
ff5702c52d66773ca5f32b46f9669880437e82e8...234cd45662d5c094339d729bc040ae90ae688de7,3,19,2,21,5,2012-10-08 18:40:43,2012-10-08 18:40:43
f44054c82f4199ccff14f472e4fd7904b0db8ff5...c1d7036b6bfea586a30c6eac672e58e22e5ceaf5,2,16,7,23,7,2011-11-28 18:41:53,2011-11-27 10:15:33
04a67dc622b298226628fe344af835a7191dc1aa...65f13f20bccc71cf6599e9ad6b2ed0cc2312f416,2,15,1,16,2,2011-04-29 18:47:35,2011-04-29 18:47:10
44ec754dc766e38684d9ad4563019378730eea82...8c8674fc954d8c4bc46f303a141f510ecf264fcd,2,12,1,13,2,2011-04-03 19:35:39,2011-03-25 18:13:31
8c8674fc954d8c4bc46f303a141f510ecf264fcd...8e848868fff625a8dda92fb11edf2b7975827e1a,2,38,1,39,2,2011-04-03 19:58:23,2011-04-03 19:58:23
442cb08fa0dca38c99cf1ff8a5654a95a5cad7a4...21802cd32805b19fa32e8e3594ee3914733d53d3,2,31,0,31,2,2010-09-29 20:24:04,2010-09-29 07:26:44
21802cd32805b19fa32e8e3594ee3914733d53d3...3c3bb51c3b205a6838b022896c9323d4b25bf392,2,25,8,33,10,2010-10-04 07:12:13,2010-10-04 07:05:24
442cb08fa0dca38c99cf1ff8a5654a95a5cad7a4...835d6a1f9f6f0f6e47cf32238af7ee8b8d048d78,1,11,0,11,1,2010-09-29 16:59:42,2010-09-28 13:19:51
835d6a1f9f6f0f6e47cf32238af7ee8b8d048d78...57693d03db93959831c9c017953f979aae6cc8eb,2,4,4,8,2,2010-09-29 17:07:09,2010-09-28 13:19:52
57693d03db93959831c9c017953f979aae6cc8eb...92c1e717779a9aa3267cef232ce80ac93e3460fe,4,18,3,21,5,2010-09-29 17:39:53,2010-09-29 16:42:53
92c1e717779a9aa3267cef232ce80ac93e3460fe...2bea593bf0f1159e93dbca1008a18dea4c262e58,1,7,21,28,6,2010-09-29 20:21:24,2010-09-27 15:32:45
2bea593bf0f1159e93dbca1008a18dea4c262e58...fa8347b81609429d578bd67695bf19b096b10f4c,1,2,2,4,2,2010-09-29 20:21:28,2010-09-28 08:20:24
fa8347b81609429d578bd67695bf19b096b10f4c...e1ba4c32cbc48316d07f807bf32b9194601003b0,1,1,1,2,1,2010-09-29 20:21:49,2010-09-28 11:16:07
e1ba4c32cbc48316d07f807bf32b9194601003b0...9ec26eb7cd7767faffac9bac5e22ede0d25e20e3,1,1,1,2,1,2010-09-29 20:25:17,2010-09-29 07:26:23
9ec26eb7cd7767faffac9bac5e22ede0d25e20e3...2f76919517e98bb5e979d6c8c7bbc3478a066a21,1,9,6,15,6,2010-09-29 20:27:50,2010-09-28 21:08:38
6db2103f92cf6c5caeeddec0bfd5f57f94e81d81...95b7a41a80e56e3df904a2080d0665565c231272,1,15,6,21,1,2010-10-06 20:45:42,2010-10-02 04:37:43
95b7a41a80e56e3df904a2080d0665565c231272...7c6eafa35af805578990e76b691ff7f1a25a3c57,1,3,3,6,3,2010-10-06 20:46:02,2010-10-01 21:19:19
6db2103f92cf6c5caeeddec0bfd5f57f94e81d81...892e6f7ea61e39d8504e3f227ee3ae874521f05c,5,82,38,120,10,2010-10-06 20:26:11,2010-10-03 19:59:59
892e6f7ea61e39d8504e3f227ee3ae874521f05c...dd0c69e95638d49f576c3774b8073b68d82ec0ff,1,20,49,69,20,2010-10-06 20:26:11,2010-10-03 20:00:01
dd0c69e95638d49f576c3774b8073b68d82ec0ff...315e76540baa8b2c1887ea1ee0827dcbcda3e267,2,14,14,28,8,2010-10-06 20:26:11,2010-10-03 20:00:02
315e76540baa8b2c1887ea1ee0827dcbcda3e267...b62b3436ffa6acc27a431f29fb25aa08eb441940,1,6,6,12,3,2010-10-06 20:26:11,2010-10-03 20:00:03
b62b3436ffa6acc27a431f29fb25aa08eb441940...5a57bc6bfc5a4d33aa90eace0016bbe768e09a4d,1,1,1,2,1,2010-10-06 20:26:12,2010-10-03 20:00:04
5a57bc6bfc5a4d33aa90eace0016bbe768e09a4d...0564b3ee7c1bfe0eb2a994d89e37def6d0e8ef78,1,27,26,53,12,2010-10-06 20:26:12,2010-10-03 20:00:06
0564b3ee7c1bfe0eb2a994d89e37def6d0e8ef78...5935c581df1d908c8adc293d92a8bf1da5be9005,1,0,1,1,1,2010-10-06 20:26:12,2010-10-03 20:00:07
5935c581df1d908c8adc293d92a8bf1da5be9005...771cf1dab9303bab3c8198b8b631ca6e7093917d,1,15,7,22,3,2010-10-06 20:26:12,2010-10-03 20:00:08
771cf1dab9303bab3c8198b8b631ca6e7093917d...e6f68a2e746405c1aa72f12a030de1485dff3dab,1,10,19,29,9,2010-10-06 20:26:12,2010-10-03 20:00:09
e6f68a2e746405c1aa72f12a030de1485dff3dab...a2b1e53b94e99fa88394b1317be478d5c5d864dc,1,1,1,2,1,2010-10-06 20:26:12,2010-10-03 20:00:10
a2b1e53b94e99fa88394b1317be478d5c5d864dc...af7b252619fd9f73ab6a06af09e7e62838c5f54b,1,6,6,12,6,2010-10-06 20:26:13,2010-10-03 20:00:11
af7b252619fd9f73ab6a06af09e7e62838c5f54b...bc0f35ca238ff88829cd9839641a316e859348a2,1,6,6,12,6,2010-10-06 20:26:13,2010-10-03 20:00:12
bc0f35ca238ff88829cd9839641a316e859348a2...00648ba0505bbe1999bb6ae2f1d02a0ef923b191,5,37,29,66,21,2010-10-06 20:26:33,2010-10-03 20:00:14
b83cfa5949081c32a13b84e8aeea7d2cb7a96331...bd578b507fa79f94009ae1c1a436dc14cf7e6002,1,13,0,13,1,2012-05-23 20:54:23,2012-05-23 20:54:23
0ed748134748579a13cf27e1e8b3e55371bcd9dc...18e051a3981f38db08521bb61ccf7e4571335353,1,7,4,11,1,2011-01-04 21:44:41,2010-12-27 10:54:37
89ba4e7c7f71712133d1d3137f811b99ea43dd31...56fb3ddc89ab94c8b09d178a848cb553b4acf777,1,3,0,3,1,2010-12-09 19:13:55,2010-12-04 18:54:28
56fb3ddc89ab94c8b09d178a848cb553b4acf777...b7037b6a1f463ffe33390f26840d6cc1600dbb18,1,1,1,2,1,2010-12-09 19:13:56,2010-12-04 18:55:51
b7037b6a1f463ffe33390f26840d6cc1600dbb18...1a3b5a3e5cfc00ca36bdbc07b3ffebcdfc9dd989,1,4,0,4,1,2010-12-10 00:00:30,2010-12-04 18:57:30
1a3b5a3e5cfc00ca36bdbc07b3ffebcdfc9dd989...93d85f57be00859f8adecd474da30a7279cd4ec2,1,0,6,6,1,2010-12-10 00:02:53,2010-12-04 19:00:51
89ba4e7c7f71712133d1d3137f811b99ea43dd31...599b0bf438e387dbaf00dbadcbe41b2a0de90db1,1,4,4,8,2,2010-11-24 00:06:46,2010-11-23 18:38:24
599b0bf438e387dbaf00dbadcbe41b2a0de90db1...17194c1e96eddb43d2608fe7bd121256d17118ee,1,4,5,9,3,2010-11-24 00:06:46,2010-11-23 18:38:25
17194c1e96eddb43d2608fe7bd121256d17118ee...20c6788aced1237489824db3b25285afed0ad169,1,3,7,10,2,2010-11-24 00:06:46,2010-11-23 18:38:26
20c6788aced1237489824db3b25285afed0ad169...9585ed519c59d5ac46f8e12b339220cdd0567b7d,2,28,2,30,4,2010-11-24 00:06:47,2010-11-23 18:38:27
9585ed519c59d5ac46f8e12b339220cdd0567b7d...e7772600e94146ddbf5ef6b08d0ea7d6fc8fbcad,1,2,0,2,1,2010-11-24 00:06:47,2010-11-23 18:38:28
e7772600e94146ddbf5ef6b08d0ea7d6fc8fbcad...d1b6e6e015501272c7491b3a4adf3cd3904edefa,7,137,271,408,9,2010-11-24 00:06:50,2010-11-23 18:38:29
f34e9edc7bbb41c52ff6a17dbffbef3d4979ee25...8828aa3418792ff9deb2ab264c6934a5d0bb15e0,1,4,4,8,4,2010-12-09 17:34:11,2010-12-09 16:03:05
f34e9edc7bbb41c52ff6a17dbffbef3d4979ee25...5b02b9baf728f6155e2996e5945e07f2e1a57b05,1,4,0,4,2,2010-12-08 22:54:13,2010-12-08 22:54:13
b5c178143088350c49129acbedb864d70c666215...337967fb7794b300f1633a413c0db525ab517a3e,2,11,8,19,3,2011-02-07 23:45:54,2011-02-07 20:49:33
337967fb7794b300f1633a413c0db525ab517a3e...19e125498bc417e20f0b8c1014b808654e4acfe4,1,29,2,31,5,2011-02-07 23:45:54,2011-02-07 20:50:26
19e125498bc417e20f0b8c1014b808654e4acfe4...c9b78400802acb3e02249c44286162edd9ed2b35,1,78,0,78,4,2011-02-07 23:45:54,2011-02-07 20:51:21
c9b78400802acb3e02249c44286162edd9ed2b35...4f288100ceed14c65a1e964b2db4aaee4f4199fc,2,28,0,28,2,2011-02-07 23:45:54,2011-02-07 20:52:34
4f288100ceed14c65a1e964b2db4aaee4f4199fc...ab1a11be7858e1f92ee2e4ee1d70fabe7d5fe0ee,1,28,0,28,2,2011-02-07 23:45:54,2011-02-07 20:54:01
b5c178143088350c49129acbedb864d70c666215...0d6504cc3cb299eccb3f56bb97d84b3c99e004d4,1,0,0,0,0,2010-12-13 15:23:51,2010-12-13 10:14:02
0d6504cc3cb299eccb3f56bb97d84b3c99e004d4...d38732c28cb43387d6d66f72bbc6fd91f3d0b516,1,14,2,16,3,2010-12-13 19:37:44,2010-12-13 17:22:38
d38732c28cb43387d6d66f72bbc6fd91f3d0b516...28368e9f0bced688e4baf3b02b1bfcb6580909c4,1,0,0,0,0,2010-12-13 19:38:11,2010-12-13 17:07:34
28368e9f0bced688e4baf3b02b1bfcb6580909c4...0137ef7dae553f9eb89cbae1ddb60b72046ba28b,2,0,0,0,0,2010-12-13 19:54:39,2010-12-13 16:12:29
6f10c4103dc7506623f89520ad03517b40788259...fd03881a48fc31197ab3343ac2f02ed0cdbbbaaf,16,17,17,34,17,2010-11-15 17:56:51,2010-11-08 17:56:39
fd03881a48fc31197ab3343ac2f02ed0cdbbbaaf...e21adb8c100cd2859cff1d74f7d0e622ac640085,10,10,12,22,10,2010-11-15 17:57:37,2010-11-08 17:58:51
e21adb8c100cd2859cff1d74f7d0e622ac640085...d52ee6e6131f65bb4360743ebea2e7b400b544e4,14,15,15,30,14,2010-11-15 17:58:13,2010-11-08 18:06:54
d52ee6e6131f65bb4360743ebea2e7b400b544e4...76946b76fe3d26507d61cae97aa0676fad24ed92,13,16,15,31,14,2010-11-15 18:04:43,2010-11-08 18:01:54
76946b76fe3d26507d61cae97aa0676fad24ed92...8c83968385e1e742e188435fd2fe5ebf57565e49,10,14,11,25,10,2010-11-15 18:04:56,2010-11-08 19:54:48
8c83968385e1e742e188435fd2fe5ebf57565e49...4ad5c8044dac83d4fcbe116222c78736b3ac304a,1,1,1,2,1,2010-11-15 18:05:38,2010-11-08 18:02:57
4ad5c8044dac83d4fcbe116222c78736b3ac304a...3927142561e4f5f045aa024f11782446abd1ba6d,1,2,1,3,1,2010-11-15 18:05:44,2010-11-08 18:03:58
3927142561e4f5f045aa024f11782446abd1ba6d...6e565345e87cf9b8da093e11492fe3a025007230,2,5,1,6,2,2010-11-15 18:05:54,2010-11-08 18:04:51
6f10c4103dc7506623f89520ad03517b40788259...5649bd9a5174c5dbd1933b26275f7c7f50fd9224,1,15,5,20,3,2010-11-14 18:43:57,2010-11-14 14:44:15
5649bd9a5174c5dbd1933b26275f7c7f50fd9224...f8d186bba72342fed45ed27e89e1bd1179f31545,2,94,47,141,94,2010-11-14 18:57:19,2010-11-14 14:44:16
6f10c4103dc7506623f89520ad03517b40788259...3962f1d756ab41c1d180e35483d1c8dffe51e0d1,1,5,7,12,5,2010-11-11 17:12:36,2010-11-09 18:27:54
6f10c4103dc7506623f89520ad03517b40788259...58ecbd5edeb2357c313db75bc49d45981a2061b7,2,15,15,30,2,2010-11-10 19:03:13,2010-11-06 11:44:11
58ecbd5edeb2357c313db75bc49d45981a2061b7...463db9b104b5db7d574ce4c5ede8caaa6d02ff4c,3,38,37,75,3,2010-11-10 19:03:38,2010-11-06 11:45:38
463db9b104b5db7d574ce4c5ede8caaa6d02ff4c...33f239365cce2682a1faac0d5670d684aa1981ad,2,113,113,226,2,2010-11-10 19:04:26,2010-11-06 11:46:31
33f239365cce2682a1faac0d5670d684aa1981ad...6bab74e7fb89b7427e5ef24b48a07fe9450c40e7,2,18,18,36,2,2010-11-10 19:07:04,2010-11-06 11:46:52
6bab74e7fb89b7427e5ef24b48a07fe9450c40e7...b0613ce0f9ef3fd111f8c75b84ddd12f9f04fc87,3,62,60,122,3,2010-11-10 19:07:51,2010-11-06 11:47:34
b0613ce0f9ef3fd111f8c75b84ddd12f9f04fc87...bc9b21755ebf82d06a60886947bdbd8d0f14baf1,1,1,1,2,1,2010-11-10 19:08:04,2010-11-06 11:47:57
bc9b21755ebf82d06a60886947bdbd8d0f14baf1...e0500293852910c2f44fce61e7eb856adbc20d8a,2,13,3,16,6,2010-11-10 19:11:07,2010-11-06 19:00:38
db54c8e710397fbd58892daead6181b424d6d70a...cc7e81674b9fef94e64fe3e8c134f1a27ce2fa25,1,4,4,8,4,2011-01-04 23:46:29,2011-01-04 20:56:58
45e2acf3d33b2bc635f14af0c1d9ce698328954f...34840db83495e2112150e55bd7c36b0098d4824e,1,1,2,3,1,2011-06-29 23:32:09,2011-06-28 12:46:14
f5fcb59034ed820ba43b914c3c6038786753d298...16b3b2d969e88be50cb0eb9af3c56fcfcda38756,2,40,1,41,2,2011-10-16 03:55:12,2011-10-16 03:55:12
6db5c6e43dccb380ca6e9947777985eb11248c31...e45a59955ec78bca12930bcf6aa9642fd94c9e7c,1,1,2,3,1,2012-01-17 19:41:41,2012-01-17 05:50:31
e45a59955ec78bca12930bcf6aa9642fd94c9e7c...e6ed3ca651fac702f9d9a9ef64a14c7efadf7365,1,26,7,33,10,2012-01-17 19:53:21,2012-01-17 05:50:32
e6ed3ca651fac702f9d9a9ef64a14c7efadf7365...30249ee68fa5fa63bfb9bb417987b0547253b8e7,2,12,0,12,2,2012-01-17 19:55:04,2012-01-17 05:50:33
30249ee68fa5fa63bfb9bb417987b0547253b8e7...39ef7fae9a398ad4523a211bc87aff599c3d3869,1,1,2,3,2,2012-01-17 19:55:04,2012-01-17 05:50:34
6db5c6e43dccb380ca6e9947777985eb11248c31...8c69c1f92eb79a597225814781fdf1ab4be26758,2,6,0,6,2,2012-01-15 02:39:04,2012-01-14 09:23:22
8c69c1f92eb79a597225814781fdf1ab4be26758...4838237cb73a13d38a7e4348b71be96b60eed21e,2,10,0,10,2,2012-01-16 22:17:18,2012-01-15 10:03:27
f78683f3a85ca16ae16e1180703d3280b272f45d...5e1c71fd1488a33680c313f287b88d9f7a7d3e45,1,27,33,60,27,2010-04-20 05:18:36,2010-04-19 22:08:30
5e1c71fd1488a33680c313f287b88d9f7a7d3e45...da3efdb17bef25dedc753131462ee784d822132e,2,113,4,117,8,2010-04-20 05:19:07,2010-04-19 22:19:18
f78683f3a85ca16ae16e1180703d3280b272f45d...03b6aeb27443f117a3d8375f01bc38baeeff65a5,1,0,1,1,1,2010-04-17 20:55:45,2010-04-17 20:07:34
03b6aeb27443f117a3d8375f01bc38baeeff65a5...d761b2ac0e42416f7fb7752d6ac6cc02c26ea14f,1,4,3,7,1,2010-04-17 20:55:45,2010-04-17 20:07:35
d761b2ac0e42416f7fb7752d6ac6cc02c26ea14f...021ab6f00b66d0d3931310e77383239a606c96c2,1,8,8,16,6,2010-04-17 20:55:45,2010-04-17 20:07:36
021ab6f00b66d0d3931310e77383239a606c96c2...3065274c58a4f4d0c6eef7e29a1484cf2c288131,1,3,6,9,1,2010-04-17 20:55:46,2010-04-17 20:07:37
3065274c58a4f4d0c6eef7e29a1484cf2c288131...0da8b2e7c80a6dd9743e5233cdc5acd836c9a8d3,3,7,11,18,9,2010-04-17 20:55:46,2010-04-17 20:07:38
0da8b2e7c80a6dd9743e5233cdc5acd836c9a8d3...162eb5f838630f75f78f26d28b46b02781724b7d,1,2,4,6,4,2010-04-20 00:55:59,2010-04-19 14:23:05
162eb5f838630f75f78f26d28b46b02781724b7d...fa5fc15d6ecfb9452c578bb4c80e98ccca12750c,2,10,2,12,3,2010-04-20 00:56:08,2010-04-19 14:23:06
fa5fc15d6ecfb9452c578bb4c80e98ccca12750c...9b0aa728705439ca4b4e7ec845f79f8487059320,2,13,3,16,5,2010-04-20 00:56:13,2010-04-19 14:23:07
9b0aa728705439ca4b4e7ec845f79f8487059320...7b64469a363c10e9e875a73d32a220ba48694a28,3,3,4,7,4,2010-04-20 00:56:17,2010-04-19 14:23:08
7b64469a363c10e9e875a73d32a220ba48694a28...fe72d420ab4dda593dddece7b907ee7868ced127,2,52,7,59,8,2010-04-20 00:56:20,2010-04-19 14:23:09
fe72d420ab4dda593dddece7b907ee7868ced127...750ef42516bb343a7755f003720e43cd8dd64c3e,2,54,17,71,11,2010-04-20 00:56:29,2010-04-19 14:23:10
750ef42516bb343a7755f003720e43cd8dd64c3e...90d05713575ea6ed21d05228bcda8461f7b28ccf,1,2,3,5,2,2010-04-20 00:57:50,2010-04-19 14:46:43
f78683f3a85ca16ae16e1180703d3280b272f45d...c308b9c25d54c72977d16155ae04e37f3490d5ac,1,4,4,8,2,2010-04-17 18:50:32,2010-04-17 16:55:26
f78683f3a85ca16ae16e1180703d3280b272f45d...fff0d0abdde6729606824688c2acac72db643e65,1,3,1,4,1,2010-04-15 07:53:40,2010-04-15 07:25:38
fff0d0abdde6729606824688c2acac72db643e65...21798708031ed808cb77232e771e20d3146cf9c8,2,16,6,22,9,2010-04-17 17:23:59,2010-04-15 12:59:37
21798708031ed808cb77232e771e20d3146cf9c8...53b3c47d64b4294ae586d1daa04f9140dadd9ae6,1,4,6,10,2,2010-04-17 17:30:00,2010-04-15 09:34:07
f78683f3a85ca16ae16e1180703d3280b272f45d...fdf1bc48caa008c7f285db3323498f25a7758879,2,117,48,165,44,2010-04-15 00:56:53,2010-04-15 00:38:07
b9aa901856cee7ad16737343f6a372bb37871258...5b16360330822527eac1fa84131d185ff784c9fb,3,46,5,51,6,2010-04-14 01:15:08,2010-04-13 20:31:12
5b16360330822527eac1fa84131d185ff784c9fb...636db2c036d0f26bd0b1139b7abe04bdecf3e036,1,18,0,18,2,2010-04-18 18:19:39,2010-04-18 18:19:39
b9aa901856cee7ad16737343f6a372bb37871258...fe90c93bee8fc72240ccbaf9480f80ed6766cd1c,1,0,0,0,0,2010-04-11 19:13:13,2010-04-11 08:43:46
b9aa901856cee7ad16737343f6a372bb37871258...a9f3049f6c152d4e6c26b15f7eeb08660aaadca3,2,22,6,28,6,2010-04-11 04:45:00,2010-04-06 12:46:37
a9f3049f6c152d4e6c26b15f7eeb08660aaadca3...07814d90095b65b4594efd47c69f9f171ef162d4,2,15,3,18,4,2010-04-11 04:45:01,2010-04-06 12:46:38
b9aa901856cee7ad16737343f6a372bb37871258...fe454b13156e639adaae4526d04fd5b74eb8c84c,1,30,28,58,4,2010-04-11 04:24:43,2010-04-10 05:38:37
fe454b13156e639adaae4526d04fd5b74eb8c84c...a76c944bbe207953c9f0f23311702d2b8225d486,1,88,15,103,15,2010-04-11 04:30:59,2010-04-10 05:39:04
a76c944bbe207953c9f0f23311702d2b8225d486...ce8b54d67678249128b33733ad154dbcd90e6660,1,91,95,186,29,2010-04-11 04:36:07,2010-04-10 05:39:41
970957dbad9361de75bf712cd2049853189b428f...2be10bb5c1cfe15aa4f1b43137ccd17d826d8553,3,13,4,17,6,2010-03-31 22:12:08,2010-03-31 22:12:08
049e98c875682de2f5638b83e91bfbef5cfbf521...fce338a5433d34f119457c0f6e6560799ba14022,1,1,1,2,1,2010-06-21 04:57:34,2010-06-19 16:06:57
fce338a5433d34f119457c0f6e6560799ba14022...1f0eb51391d58958dd9f1e6cbcba622c309303b2,1,4,1,5,1,2010-06-21 04:58:26,2010-06-19 16:06:58
049e98c875682de2f5638b83e91bfbef5cfbf521...eb3005e274d6d342cd4766598d9210995b5dca0c,1,1,0,1,1,2010-06-21 04:44:01,2010-06-19 01:37:33
eb3005e274d6d342cd4766598d9210995b5dca0c...a7524128750ebf34fe0639e1e5d7abd03aff0302,1,32,8,40,8,2010-06-21 04:44:17,2010-06-19 01:37:34
a7524128750ebf34fe0639e1e5d7abd03aff0302...67a4b5864f9423ccfe8090365029dae918504830,1,33,1,34,6,2010-06-21 04:44:32,2010-06-19 01:37:35
67a4b5864f9423ccfe8090365029dae918504830...5e11bee65f601ba97dc4c61c75fcb2f448fdcb1c,4,45,0,45,4,2010-06-24 19:57:34,2010-06-24 00:21:16
5e11bee65f601ba97dc4c61c75fcb2f448fdcb1c...567102819ac56ccf7eb638ea8b5c975c03e88558,1,66,0,66,1,2010-06-30 18:14:44,2010-06-29 07:47:08
6774e2bf0822cd4358620d3e806f9b3df8bd777e...2de03ebe0635c93e182c3367140f999e79bdadcd,1,13,7,20,3,2010-06-02 19:15:48,2010-06-02 19:15:48
6774e2bf0822cd4358620d3e806f9b3df8bd777e...41e4d69fb82cd92bbc39accc9cb2be49b7597b5c,2,5,4,9,3,2010-06-02 17:03:53,2010-06-01 17:54:46
41e4d69fb82cd92bbc39accc9cb2be49b7597b5c...873c3472052e3d0385be4ece7b70cfdf573c051e,2,8,0,8,2,2010-06-02 17:03:53,2010-06-01 15:16:42
873c3472052e3d0385be4ece7b70cfdf573c051e...761a889a97a33d277f8a6607a4696164391f9d5d,1,1,1,2,1,2010-06-02 17:03:53,2010-06-02 01:55:36
81fa024cd8e336ba257f13fe7724b95baacfa3ad...831244bd0df6871c618fc8becbb5c0f1fb8f5459,1,1,7,8,5,2010-06-02 17:09:38,2010-06-02 05:58:34
831244bd0df6871c618fc8becbb5c0f1fb8f5459...2fb0e14f4014a4f5027401bc7156929309449726,1,9,2,11,5,2010-06-02 17:09:41,2010-06-02 05:58:35
2fb0e14f4014a4f5027401bc7156929309449726...7af46595b2667214e98da55ed2f82ce1ac2b404a,1,25,19,44,3,2010-06-02 17:09:47,2010-06-02 05:58:36
7af46595b2667214e98da55ed2f82ce1ac2b404a...4b2095622f61e6ab51f03601e5c3c8d71ace5fc7,1,4,4,8,4,2010-06-02 17:09:52,2010-06-02 05:58:37
4b2095622f61e6ab51f03601e5c3c8d71ace5fc7...7e2bfd3f99f8d6e89c7b855675919dd5404e47a2,1,41,10,51,7,2010-06-02 17:09:56,2010-06-02 05:58:38
7e2bfd3f99f8d6e89c7b855675919dd5404e47a2...aa29ccf4c07a6e1e249794e1fa3c7cd0bf0a9e46,1,95,0,95,1,2010-06-02 17:09:58,2010-06-02 05:58:39
aa29ccf4c07a6e1e249794e1fa3c7cd0bf0a9e46...89d32d33ae562afa789a7723de8d853364101610,1,53,11,64,8,2010-06-02 17:10:05,2010-06-02 05:58:40
89d32d33ae562afa789a7723de8d853364101610...86c7bb47c76948bd1240a0db5b8dd88cf9db855d,1,37,14,51,9,2010-06-02 17:10:07,2010-06-02 05:58:41
81fa024cd8e336ba257f13fe7724b95baacfa3ad...9c7304e3e39ed397b3cc6566573333e2698a52b4,3,41,37,78,37,2010-06-01 01:06:41,2010-05-17 15:34:41
9c7304e3e39ed397b3cc6566573333e2698a52b4...47e9cd28f8a404a0d6293935252ddca5fc243931,4,30,16,46,19,2010-06-13 16:38:14,2010-06-12 12:57:39
81fa024cd8e336ba257f13fe7724b95baacfa3ad...0b3261b84da92011f82ac9f2b9a8e89ac4a5bb04,1,7,2,9,3,2010-06-01 01:03:39,2010-05-29 18:36:51
81fa024cd8e336ba257f13fe7724b95baacfa3ad...a3c158d4a58b17c1e4a8d3f793344beee21d3a4c,2,40,27,67,31,2010-06-01 01:00:21,2010-05-26 07:08:02
a3c158d4a58b17c1e4a8d3f793344beee21d3a4c...81bd1b2a96ecc12dcc72fc2b22aa5b7691186685,1,6,0,6,1,2010-06-01 01:00:21,2010-05-26 07:08:03
81bd1b2a96ecc12dcc72fc2b22aa5b7691186685...7be5761073fde260d3aca10883e8688bd30cbccf,1,147,53,200,55,2010-06-01 01:00:21,2010-05-26 07:23:54
7be5761073fde260d3aca10883e8688bd30cbccf...2efcc977646320123c0d461664d25c4c93aaa9ee,1,27,5,32,4,2010-06-01 01:02:04,2010-05-29 15:32:05
2efcc977646320123c0d461664d25c4c93aaa9ee...b5a4de9d506030fce1b70a06dc49090a46877c3f,1,19,0,19,2,2010-06-01 01:02:07,2010-05-26 07:23:56
b5a4de9d506030fce1b70a06dc49090a46877c3f...4297c0aeb5cc6b9c1c87d770c91e09ac2a837320,1,104,17,121,21,2010-06-01 01:02:20,2010-05-29 15:32:06
81fa024cd8e336ba257f13fe7724b95baacfa3ad...bffd750adf98c4a377571af73cf9a589f86495fb,2,20,10,30,5,2010-06-01 00:53:23,2010-05-31 22:51:32
81fa024cd8e336ba257f13fe7724b95baacfa3ad...05bdcfe5fc3d626b752c2cb574f05ed30b279bcf,1,2,0,2,1,2010-06-01 00:48:38,2010-05-30 08:19:26
81fa024cd8e336ba257f13fe7724b95baacfa3ad...3e5a188f1d5b48dcc0bc73ad520925cdb846dfaf,2,38,3,41,2,2010-06-01 00:44:01,2010-05-30 13:37:17
9ca5df90615aa3c6b60e1bc8f03db6cae98e816c...ee38d823f74bd8872c1e793f98a5b5523ee04646,1,0,1,1,1,2010-08-02 15:30:02,2010-08-02 15:29:42
9ca5df90615aa3c6b60e1bc8f03db6cae98e816c...1da6175d438a9849db07a68326ee05f291510074,2,10,0,10,4,2010-05-07 16:34:28,2010-05-07 04:52:28
1da6175d438a9849db07a68326ee05f291510074...0cdca133ec8aa10fe4c806f6695ccbf32394aa91,3,58,2,60,3,2010-05-07 16:34:29,2010-05-07 04:52:29
0cdca133ec8aa10fe4c806f6695ccbf32394aa91...9feeaa2bf39aed4a0148296f504f88b09b8901d4,1,0,0,0,0,2010-05-10 18:52:03,2010-05-10 09:47:39
43acff34b902c38808ac0f326090f2516250e1f0...87a074df2455f305df8facc22e85dac1cfeb0d6b,2,15,1,16,2,2010-05-10 18:25:37,2010-05-10 09:42:06
2b7ca916fcffafe9cfd967cce87436a9372ae969...c01499ef6933bd0e3fc65277559dc80f13d6a49e,5,5,5,10,5,2013-10-16 17:26:39,2013-10-16 17:26:39
c01499ef6933bd0e3fc65277559dc80f13d6a49e...cc10837929b2afe4116bb305e69b4bd4a95958de,1,7,6,13,5,2013-10-16 17:27:26,2013-09-21 19:15:44
cc10837929b2afe4116bb305e69b4bd4a95958de...f1e835fa1375f3e1c60eedc87012d1a9c96ce511,1,2,2,4,2,2013-10-16 17:27:26,2013-10-15 22:25:45
f1e835fa1375f3e1c60eedc87012d1a9c96ce511...ea6640ec3eb31191bafa6ed4d874d731173e1c15,1,1,1,2,1,2013-10-16 17:27:26,2013-10-15 22:25:53
ea6640ec3eb31191bafa6ed4d874d731173e1c15...b1cdfb54f10ca64dc57be0d9184dcb4c9c069eac,1,1,1,2,1,2013-10-16 17:27:26,2013-10-15 22:27:17
b1cdfb54f10ca64dc57be0d9184dcb4c9c069eac...5f050e3c4ce05de13f24157ca7d3452362e673dc,1,1,1,2,1,2013-10-16 17:27:26,2013-10-15 22:27:34
5f050e3c4ce05de13f24157ca7d3452362e673dc...6b2dd0e56ba2bd668396afe9e983dddfd1f441ca,1,2,2,4,2,2013-10-16 17:27:27,2013-10-15 22:27:51
2b7ca916fcffafe9cfd967cce87436a9372ae969...6fb02165a3885314b5b356263dd267a5966f92be,1,3,3,6,3,2013-10-15 22:47:05,2013-09-23 18:54:35
bac9c06ba093d9254cb2ab3eed074722a3e635a6...cdb791f61d71db24fa54363ff6d4b42a46ebbdf1,1,1,1,2,1,2011-06-24 16:35:44,2011-06-24 06:17:42
bac9c06ba093d9254cb2ab3eed074722a3e635a6...3b368546a0da81aa44d8c46eb40a7e7b955cab65,1,76,0,76,1,2011-06-06 00:53:01,2011-06-03 05:10:10
3b368546a0da81aa44d8c46eb40a7e7b955cab65...61adfd30974a6c49b3d07275e9f2c9fc44bf779c,2,4,2,6,2,2011-06-06 00:53:10,2011-06-03 05:11:13
61adfd30974a6c49b3d07275e9f2c9fc44bf779c...59a5775770e3e491b5af479b3bf72fb13ddd3dbf,2,2,2,4,2,2011-06-07 23:07:07,2011-06-07 23:03:03
59a5775770e3e491b5af479b3bf72fb13ddd3dbf...c1921c184c464e313308e4ef58e28ca78a5b2127,2,10,6,16,6,2011-06-07 23:16:59,2011-06-07 23:03:22
bac9c06ba093d9254cb2ab3eed074722a3e635a6...88135203af9df27c0f9c76c27bbbf48833bb31c8,1,1,1,2,1,2011-05-27 17:59:13,2011-05-27 16:00:38
88135203af9df27c0f9c76c27bbbf48833bb31c8...d1c69255a1014ccaeb9841f2114e20f048556391,3,15,2,17,4,2011-05-27 17:59:16,2011-05-27 16:00:39
d1c69255a1014ccaeb9841f2114e20f048556391...56948cb6aa8189e3b77c700119d179172e0f8c4a,1,4,1,5,2,2011-05-27 17:59:18,2011-05-27 16:00:40
56948cb6aa8189e3b77c700119d179172e0f8c4a...3bdf09c7f555d553b4fee00c00c760b546812d4f,1,3,10,13,1,2011-06-07 19:22:51,2011-06-07 03:49:06
3bdf09c7f555d553b4fee00c00c760b546812d4f...e0f530ff8afbd252170f57e70a8609a83a7cabe1,1,4,3,7,4,2011-06-08 23:34:38,2011-06-08 12:04:41
bac9c06ba093d9254cb2ab3eed074722a3e635a6...5743350f696745a48dfe7976c98dc8eb5c842d72,1,8,2,10,1,2011-05-26 18:07:52,2011-05-26 13:54:18
5743350f696745a48dfe7976c98dc8eb5c842d72...5dd564895e84eacfc728183fb5a9215665ff59a3,2,2,2,4,2,2011-05-26 18:24:24,2011-05-26 13:58:16
5dd564895e84eacfc728183fb5a9215665ff59a3...b1905aeac5aded421cd90f8d264e27bb39672b36,1,1,1,2,1,2011-05-26 18:25:13,2011-05-26 16:28:44
6555b196f00128f13ab8f719ee1e156238f16bb3...882749a04f828fccd795deec4d0bf10ba09ae549,7,288,54,342,32,2010-04-14 17:56:53,2010-04-14 15:59:06
6555b196f00128f13ab8f719ee1e156238f16bb3...9974e290e7c207de569ee24356253a69e5955e67,1,2,1,3,1,2010-04-04 17:17:55,2010-04-03 19:52:17
6555b196f00128f13ab8f719ee1e156238f16bb3...ecebd1e1a75883b3927c0bffe0cd27b933ed2c67,1,1,1,2,1,2010-04-03 18:26:35,2010-04-03 07:47:00
0d0925c5e25fad8079739be36d88faa21fc1f588...28a53178fcd3c9a6576b20040982ca0b9e972f42,1,21,18,39,10,2010-03-21 23:23:40,2010-03-20 18:55:27
28a53178fcd3c9a6576b20040982ca0b9e972f42...531e758d9c861facd4ebcc8c9b0e4e1443b5665a,2,4,9,13,4,2010-03-21 23:23:44,2010-03-20 18:55:28
0d0925c5e25fad8079739be36d88faa21fc1f588...47349a8cc02b3cb39bfc69cb7abec88ad3e34ebf,1,61,4,65,3,2010-03-21 03:36:10,2010-03-21 00:27:17
47349a8cc02b3cb39bfc69cb7abec88ad3e34ebf...6a843348ab08e7c701ac2343ffbe2d11ecb7ebab,1,198,0,198,1,2010-03-21 03:36:10,2010-03-21 00:28:14
6a843348ab08e7c701ac2343ffbe2d11ecb7ebab...8a161433a0b414d15093e312eb9be99587074309,2,15,2,17,10,2010-03-21 03:36:10,2010-03-21 00:31:44
8a161433a0b414d15093e312eb9be99587074309...a4b5e91c49238146f4cb85ff5f7f3bc97e0e51de,4,20,13,33,8,2010-03-21 03:36:10,2010-03-21 00:35:18
a4b5e91c49238146f4cb85ff5f7f3bc97e0e51de...4bb0936206b046a4fe606e9b0c9fe6ecc7a0ff69,2,3,2,5,3,2010-03-21 03:36:11,2010-03-21 00:37:33
4bb0936206b046a4fe606e9b0c9fe6ecc7a0ff69...f01de62e4591a6acc061eb994d44f7eeef7a0cfd,6,17,15,32,16,2010-03-21 03:36:11,2010-03-21 00:38:58
f01de62e4591a6acc061eb994d44f7eeef7a0cfd...f0531a2937e919e763ab05e9800aef51658104fc,2,3,3,6,3,2010-03-21 03:36:11,2010-03-21 00:40:19
f0531a2937e919e763ab05e9800aef51658104fc...e44b3851c9d5fc840e8f33fb76f473a71b658d10,1,6,0,6,1,2010-03-21 03:36:11,2010-03-21 00:40:53
e44b3851c9d5fc840e8f33fb76f473a71b658d10...4c5868f43d1ec2573f4f511d732bc00d56accc70,2,9,3,12,5,2010-03-21 03:36:11,2010-03-21 00:41:38
4c5868f43d1ec2573f4f511d732bc00d56accc70...c4151629e7019d072cefdac992e164820ce9ed1c,2,2,1,3,2,2010-03-21 03:36:11,2010-03-21 00:42:51
c4151629e7019d072cefdac992e164820ce9ed1c...137c6eaa885a421346f0a5abbc3cc4903671fbeb,1,9,0,9,2,2010-03-21 03:36:11,2010-03-21 00:43:32
137c6eaa885a421346f0a5abbc3cc4903671fbeb...d68565402a69fac3fe0e0653718feca7c80c178b,2,64,41,105,20,2010-03-21 03:36:11,2010-03-21 00:45:21
d68565402a69fac3fe0e0653718feca7c80c178b...bf975d379d79ab0eb9e8835af4abab4712e71dad,2,6,3,9,6,2010-03-21 03:36:11,2010-03-21 00:46:07
bf975d379d79ab0eb9e8835af4abab4712e71dad...7ca56aa07619b0345b643e52ae8e616cbaafc187,1,1,0,1,1,2010-03-21 03:36:11,2010-03-21 00:52:21
9a8e485430492a1377885071c94983c2da547174...f3f778df6900881a7bac409c927931c32b82bcb5,3,73,2,75,3,2011-12-28 20:03:24,2011-12-28 19:49:09
7010146f90abf0e4954690f6cd38a8463786fec7...ed727b192bb3506ee7904c1c9e8370d6b4ecaf5d,2,25,6,31,4,2012-02-22 19:13:43,2012-02-22 00:44:17
4cb5d10b14dcbe0155bed9c45ccb94e83bd4c599...d3e05983306537c8ec911fc52092697ba80830fa,2,60,14,74,17,2011-12-09 17:39:30,2011-12-07 03:01:45
4cb5d10b14dcbe0155bed9c45ccb94e83bd4c599...2f139044f96227deb8332942627a04b29c70c2bf,1,2,2,4,2,2011-12-09 00:01:47,2011-12-08 13:10:15
2f139044f96227deb8332942627a04b29c70c2bf...02380389c6d4656c0cc94d33f9811636cb5953e4,10,17,17,34,14,2011-12-09 00:02:26,2011-12-08 13:10:17
02380389c6d4656c0cc94d33f9811636cb5953e4...67b6afe1ed424934679649752c9efb9896bfacf0,1,6,66,72,6,2011-12-09 18:28:24,2011-12-08 13:10:13
67b6afe1ed424934679649752c9efb9896bfacf0...7f9a5fc6876a3158cb29b0c2d13ccb226ec7d679,1,3,3,6,3,2011-12-09 18:38:13,2011-12-08 13:10:16
7f9a5fc6876a3158cb29b0c2d13ccb226ec7d679...5e1136227178f2ca48c472a4cc89ccfc92328965,1,72,72,144,2,2011-12-09 19:30:42,2011-12-09 11:29:13
5e1136227178f2ca48c472a4cc89ccfc92328965...f73e5ee5667138bbcb4220189e36e3ec06168c3f,1,33,34,67,10,2011-12-12 05:15:15,2011-12-09 16:59:11
f73e5ee5667138bbcb4220189e36e3ec06168c3f...13c907c4fe9b0d96a68c04f7d64f66873e0db8b7,1,10,25,35,6,2011-12-12 05:15:17,2011-12-10 08:17:54
9fd389b65002e0e23deb2c7328360f246afec0d4...017d1e134545db0d162908f3538077eaa1f34fb6,1,1,1,2,1,2011-11-23 02:23:36,2011-11-23 02:23:36
f56ef114eeefee755f422e6cbef2d83974cb90f1...1bc01efed17c751e98fd6c5f9889759bfa9a8e9b,4,19,36,55,19,2011-11-21 22:32:40,2011-11-19 07:40:04
f56ef114eeefee755f422e6cbef2d83974cb90f1...3a81f33c526a09b3ae22b01d56c7ab921d19c382,1,1,1,2,1,2011-11-21 03:24:24,2011-11-19 19:38:54
3a81f33c526a09b3ae22b01d56c7ab921d19c382...05bab3ea283d687d7981583aa87e03279f3b1484,1,2,2,4,2,2011-11-21 03:32:09,2011-11-19 19:42:00
9859a023fef30ffebdd22ad9639c587ac720b8b6...b8ffedca6f9e1043956ba611ae52bea449779456,2,18,3,21,3,2011-12-12 23:45:42,2011-12-12 21:16:06
b8ffedca6f9e1043956ba611ae52bea449779456...0579f91dd74a0902e52d1e6e839cc31b99f12cfc,3,63,33,96,18,2011-12-16 23:47:10,2011-12-12 21:16:07
0579f91dd74a0902e52d1e6e839cc31b99f12cfc...53b8d931b649a0d82e16358a6bf1dd980dc24a6b,1,18,18,36,2,2011-12-16 23:47:25,2011-12-12 21:16:08
9859a023fef30ffebdd22ad9639c587ac720b8b6...e4776bd936aa162b7f00cb26260dc4a6ca444abb,1,1,1,2,1,2011-12-12 17:30:23,2011-12-12 11:20:29
e4776bd936aa162b7f00cb26260dc4a6ca444abb...96ec7b1e708863d0cd6b8e72a986d6f0a1bb64db,12,47,50,97,38,2011-12-13 17:26:52,2011-12-13 14:17:48
96ec7b1e708863d0cd6b8e72a986d6f0a1bb64db...8cad4744ee37ebec1d9491a1381ec1771a1ba795,13,26,26,52,26,2011-12-13 17:39:46,2011-12-12 11:20:32
9859a023fef30ffebdd22ad9639c587ac720b8b6...c49b039bdd7ac1942176009a966ada8f693d2df7,1,1,0,1,1,2011-12-12 17:08:51,2011-12-12 05:38:08
c49b039bdd7ac1942176009a966ada8f693d2df7...dfefa935ae050d859022017bf9d5d23f4238a7e5,3,175,163,338,138,2011-12-12 17:08:51,2011-12-12 05:38:09
dfefa935ae050d859022017bf9d5d23f4238a7e5...85be1fe34ab6bf67d232b1deb524c4af34d87222,2,11,11,22,11,2011-12-12 17:08:51,2011-12-12 05:38:10
85be1fe34ab6bf67d232b1deb524c4af34d87222...7c59511ed54aec999c7df3bd8e79b1eb33b92fa6,1,4,4,8,4,2011-12-12 17:08:51,2011-12-12 05:38:11
7c59511ed54aec999c7df3bd8e79b1eb33b92fa6...19b68b1e632ba989dc62d0956b7fd06978347370,1,13,7,20,6,2011-12-12 17:08:52,2011-12-12 05:38:12
19b68b1e632ba989dc62d0956b7fd06978347370...fbd09e41d571fb45ae702027f74bec345887749d,1,5,0,5,1,2011-12-12 17:08:52,2011-12-12 05:38:13
fbd09e41d571fb45ae702027f74bec345887749d...6af1038beef46b46077a873f66e6742d3c0fe99f,1,1,0,1,1,2011-12-12 17:08:52,2011-12-12 05:38:14
6af1038beef46b46077a873f66e6742d3c0fe99f...202a56a92414a2142cd92f0c3fa89bfb29149388,1,25,12,37,4,2011-12-12 17:08:53,2011-12-12 05:38:15
202a56a92414a2142cd92f0c3fa89bfb29149388...316b097ac138c3c5232ce9bbaede83d68fb686ea,1,17,19,36,16,2011-12-12 17:08:53,2011-12-12 05:38:16
316b097ac138c3c5232ce9bbaede83d68fb686ea...3b12482358e58d95d4a8effc840862c87d995c4c,1,9,9,18,7,2011-12-12 17:08:53,2011-12-12 05:38:17
3b12482358e58d95d4a8effc840862c87d995c4c...7f820bd92008a366f391e243fbd51e076d75e3a6,1,6,2,8,1,2011-12-12 17:08:53,2011-12-12 05:38:18
7f820bd92008a366f391e243fbd51e076d75e3a6...b0626608ea80e636faaa030a35200d8e47be5564,1,20,20,40,12,2011-12-12 17:08:53,2011-12-12 05:38:19
b0626608ea80e636faaa030a35200d8e47be5564...064d51dc40bc9df75279ca3346cd84c2611c6aba,1,10,24,34,9,2011-12-12 17:08:53,2011-12-12 05:38:20
064d51dc40bc9df75279ca3346cd84c2611c6aba...fe9c7b78c5487dc4595559fb6e731b46294b6a0d,1,2,5,7,3,2011-12-12 17:08:53,2011-12-12 05:38:21
fe9c7b78c5487dc4595559fb6e731b46294b6a0d...cddc42587cbb37f8ff2f34b53550b5e331aa3aa5,1,22,15,37,5,2011-12-12 17:08:53,2011-12-12 05:38:22
cddc42587cbb37f8ff2f34b53550b5e331aa3aa5...dd73ecd1bc8903036d58cf7afb0010ef4aaf8695,1,5,9,14,5,2011-12-12 17:08:53,2011-12-12 05:38:23
9859a023fef30ffebdd22ad9639c587ac720b8b6...0591cfa8d89aa63eaaaab3fdd5ba458f408fe4cb,1,4,0,4,1,2011-12-12 05:12:55,2011-12-09 23:48:14
0591cfa8d89aa63eaaaab3fdd5ba458f408fe4cb...c145225a35c4975ae922b1906ae07c3fb44b7e07,1,38,0,38,1,2011-12-12 05:13:20,2011-12-09 23:48:15
c145225a35c4975ae922b1906ae07c3fb44b7e07...bf1d68ff4c86f6d6fb3214ae9b0dc9c7ac0ff781,1,3,2,5,2,2011-12-12 05:13:52,2011-12-09 23:48:16
bf1d68ff4c86f6d6fb3214ae9b0dc9c7ac0ff781...57526fde5df201a99afa6d122c3266b3a1c5673a,1,49,0,49,1,2011-12-12 05:13:56,2011-12-09 23:48:17
2e8722fc9e34a53ae19f2b60b1d3038aa2af0ae6...7b6c5836cf02999955b68c79f1cf2d13040acbc3,2,18,1,19,2,2011-12-14 06:08:52,2011-12-14 06:08:52
6fe5b7ff6cafcc94415deba2f3d611770d8e6b1e...9de0834663f28bee9e6b2c4647ed6128241ed26f,1,3,2,5,2,2006-10-17 04:27:44,2006-10-17 02:58:54
e7676d2f6454c9c99e600ee2ce3c7205a9fcfb5f...8aac4b45f39a7c845848a75ac971717a1933d99f,1,43,43,86,28,2006-09-16 20:41:14,2006-09-16 20:41:14
8aac4b45f39a7c845848a75ac971717a1933d99f...4be609625e48e908f2b76d35bfeb61a8ba3a83a0,3,197,34,231,19,2006-09-17 08:12:37,2006-09-17 08:04:24
4be609625e48e908f2b76d35bfeb61a8ba3a83a0...dd70235f5a81e52725365365a554cf7c8cfa37e6,1,27,7,34,3,2006-09-17 08:54:13,2006-09-16 21:08:32
dd70235f5a81e52725365365a554cf7c8cfa37e6...800764cf335cb4de289269c919e865c536635885,1,8,8,16,8,2006-09-17 08:58:56,2006-09-16 21:09:02
800764cf335cb4de289269c919e865c536635885...7939fe44b8abedb4d8bb5090aec7a92eb1aa7a4b,1,4,7,11,1,2006-09-17 09:41:50,2006-09-16 22:30:27
7939fe44b8abedb4d8bb5090aec7a92eb1aa7a4b...32f4aaccaa45fcd79bacd424c7d69051156bb766,2,24,3,27,7,2006-09-17 09:41:58,2006-09-16 22:31:01
e7676d2f6454c9c99e600ee2ce3c7205a9fcfb5f...be4a015b0fed2bd96e509f45b80b63db056b9ca9,1,15,8,23,5,2006-09-16 18:03:36,2006-09-16 17:58:20
be4a015b0fed2bd96e509f45b80b63db056b9ca9...4adffc7b54e8c5d8fc7510007dd9b8235a67430f,1,3,1,4,1,2006-09-16 18:06:02,2006-09-16 18:06:02
e7676d2f6454c9c99e600ee2ce3c7205a9fcfb5f...9f613ddd21cbd05bfc139d9b1551b5780aa171f6,10,1132,28,1160,15,2006-09-16 17:22:02,2006-09-15 20:30:02
e7676d2f6454c9c99e600ee2ce3c7205a9fcfb5f...358ddb62cfd03bba1ca2f1ae8e81b9510f42ea9a,4,116,1,117,4,2006-09-16 09:23:51,2006-09-15 18:19:32
358ddb62cfd03bba1ca2f1ae8e81b9510f42ea9a...305e22c36e674924de6decb29e8a4c22292b5054,1,3,2,5,2,2006-09-16 09:23:51,2006-09-15 21:56:55
305e22c36e674924de6decb29e8a4c22292b5054...c40abef89f746ef7b9b7815b12b740e2f22905c8,1,11,3,14,4,2006-09-17 09:43:02,2006-09-17 04:20:24
c40abef89f746ef7b9b7815b12b740e2f22905c8...ee1a9b2f1824100bbac8d23e7dea1a6e9e85fb21,1,2,2,4,2,2006-09-17 09:43:08,2006-09-17 04:32:24
ee1a9b2f1824100bbac8d23e7dea1a6e9e85fb21...582c5b09be6336e74a366ad900ca7ec3a5d1572d,1,1,0,1,1,2006-09-18 07:35:07,2006-09-18 07:35:07
582c5b09be6336e74a366ad900ca7ec3a5d1572d...c0990ff36f0b9b8e806c8f649a0888d05bb22c37,1,136,0,136,1,2006-09-18 16:24:53,2006-09-18 12:32:41
c0990ff36f0b9b8e806c8f649a0888d05bb22c37...9581e0fca225927dbcbdf03fe70a1d2711ddc6b9,1,17,1,18,3,2006-09-20 15:35:24,2006-09-20 04:14:54
9581e0fca225927dbcbdf03fe70a1d2711ddc6b9...9c13359aaf3176428603cc9dfbdf30da889ab3d3,1,1,1,2,1,2006-09-20 15:35:48,2006-09-20 04:21:25
e7676d2f6454c9c99e600ee2ce3c7205a9fcfb5f...c95b138985186992b222321f332cf92edbbd4141,1,19,4,23,1,2006-09-16 09:23:04,2006-09-16 06:19:02
2878836c5074be92b913c95446b94bbf1c9a9e1d...a41fae9c46a4cb5e59cc1a17d19f6a3a6cbfbb2f,1,36,8,44,2,2006-09-10 05:21:27,2006-09-10 05:21:27
2878836c5074be92b913c95446b94bbf1c9a9e1d...4df096a5ca24f2f39042c51cf51b8a2bec66a2b5,8,375,1,376,9,2006-09-09 18:57:36,2006-09-07 13:12:02
4df096a5ca24f2f39042c51cf51b8a2bec66a2b5...efd8696cd7ccfa5042ef710e89fe0d10efdcd085,3,72,1,73,4,2006-09-09 18:57:37,2006-09-07 13:12:03
efd8696cd7ccfa5042ef710e89fe0d10efdcd085...ec06bff5e6f76b46c22a3b2c97452568f088fa3c,3,30,0,30,4,2006-09-09 18:57:37,2006-09-07 13:12:04
ec06bff5e6f76b46c22a3b2c97452568f088fa3c...39345a216ff37bda9fb7cec85f6de44069f5205d,7,120,0,120,8,2006-09-09 18:57:37,2006-09-07 13:12:05
39345a216ff37bda9fb7cec85f6de44069f5205d...854c4168e77a692dc198311f04bf31939355f2a3,3,23,2,25,3,2006-09-09 20:39:57,2006-09-09 15:02:38
854c4168e77a692dc198311f04bf31939355f2a3...37f944363d5b5fb5bcbf2d184865534739713c01,2,47,33,80,17,2006-09-10 06:57:46,2006-09-10 06:48:03
37f944363d5b5fb5bcbf2d184865534739713c01...326711c16879792da8d7159bf29d080569c3a1e0,2,2,2,4,2,2006-09-10 20:39:01,2006-09-10 16:10:01
326711c16879792da8d7159bf29d080569c3a1e0...8142f603b9955648228549d2e83ace7fbe834114,1,2,0,2,1,2006-09-10 20:39:24,2006-09-10 11:16:39
8142f603b9955648228549d2e83ace7fbe834114...e0ffb24877d4530208905512f7c91dd8d71e2c95,4,16,1,17,11,2006-09-10 20:39:25,2006-09-10 05:42:02
e0ffb24877d4530208905512f7c91dd8d71e2c95...fe5ab763f848cfcda22001f9280625f06c4c3760,1,17,3,20,5,2006-09-10 20:39:32,2006-09-10 11:02:57
2878836c5074be92b913c95446b94bbf1c9a9e1d...0424558190fb85e6702e7c64cd2b11bc31d7be85,2,11,0,11,5,2006-09-07 22:40:25,2006-09-07 06:35:42
0424558190fb85e6702e7c64cd2b11bc31d7be85...7c92fe0eaa4fb89e27fa3617b9ae52f20b511573,4,194,133,327,8,2006-09-08 23:44:10,2006-09-08 08:03:18
7c92fe0eaa4fb89e27fa3617b9ae52f20b511573...c91f0d92efb36d7b349f586cafafaf0e6ac3f5b2,10,349,100,449,12,2006-09-08 23:46:35,2006-09-08 08:05:34
c91f0d92efb36d7b349f586cafafaf0e6ac3f5b2...2074cb0af339f586cab6e0cdc20c4eadf3ba93e8,4,10,1,11,5,2006-09-13 06:20:17,2006-09-12 20:45:12
2074cb0af339f586cab6e0cdc20c4eadf3ba93e8...b982592d6677aebff646a0e68b1075804ca3955f,1,14,0,14,1,2006-09-13 06:20:17,2006-09-11 23:21:17
b982592d6677aebff646a0e68b1075804ca3955f...db830b4f233bd45e28592fbf59395bc98d79dec5,1,1,1,2,1,2006-09-14 06:37:57,2006-09-13 22:37:14
abd6970acad5d758f48c13f7420367ae8216038e...3df196716eb89e752c96cf252d5c712387a7c112,2,6,4,10,5,2006-10-06 09:53:39,2006-10-06 09:15:03
3df196716eb89e752c96cf252d5c712387a7c112...847abc0f2a8d57bf4c1f13e948995491b6bc6f58,1,13,7,20,8,2006-10-06 09:56:50,2006-10-01 21:21:33
847abc0f2a8d57bf4c1f13e948995491b6bc6f58...55ff35cb649e77f7633f9a30e9988ecad1371fe5,1,4,2,6,1,2006-10-07 08:38:46,2006-10-06 13:57:52
55ff35cb649e77f7633f9a30e9988ecad1371fe5...689b7f5ccbbb71f5a1a165cfb1e24abd42c7d009,1,2,2,4,2,2006-10-07 09:16:22,2006-10-06 16:00:17
689b7f5ccbbb71f5a1a165cfb1e24abd42c7d009...7e0fe5c939bdd5cc2885d21799e95304a46bf706,1,3,0,3,1,2006-10-07 09:16:33,2006-10-06 16:55:04
7e0fe5c939bdd5cc2885d21799e95304a46bf706...a144154f85fe1d61da2a515e79ea1d08b5137f20,1,1,1,2,1,2006-10-07 09:19:17,2006-10-06 16:59:33
a144154f85fe1d61da2a515e79ea1d08b5137f20...3de63c3f9f82cd0a43f3f69dd1e3662bc101d629,1,230,228,458,23,2006-10-08 04:28:17,2006-10-07 19:07:40
3de63c3f9f82cd0a43f3f69dd1e3662bc101d629...7a0cf2d0138cf3abd3f2c3c9a1aa4dc55bf0700f,1,3,0,3,3,2006-10-08 04:33:48,2006-10-07 19:27:46
abd6970acad5d758f48c13f7420367ae8216038e...ce91c2f6538fc4a905882f2a7a57d814d82b13e8,1,8,1,9,4,2006-10-06 06:13:26,2006-10-05 23:36:49
ce91c2f6538fc4a905882f2a7a57d814d82b13e8...7a2a0d214169a5d6f22fc62c4ae6a7ca5b27fb3e,1,5,0,5,1,2006-10-06 06:40:15,2006-10-06 06:40:15
7a2a0d214169a5d6f22fc62c4ae6a7ca5b27fb3e...e6b0964af595bbc4dab2a63c17bc4c8064a28073,1,10,3,13,5,2006-10-08 06:37:15,2006-10-07 10:09:05
b5c698d947c236559e338e45c6234ece7c819338...f789e347465dded7fcec3a605473fa3f549792d8,5,29,709,738,6,2006-10-10 03:25:28,2006-10-09 10:32:05
f789e347465dded7fcec3a605473fa3f549792d8...b24642b2f27b2cf01f6e726d816a2a1f5955ae3e,2,45,4,49,6,2006-10-12 07:44:27,2006-10-12 07:44:27
66d0ff1bd35530f84c2b73e2b0e367637805217a...48fd688ab0ba7d41ff4286aee20f6f0b86e4c41c,1,1,1,2,1,2006-10-12 07:47:03,2006-10-12 07:47:03
c56f243e20ce48ae50caf841ada8435a21c2a8bf...baf0bfcb4b335438e9359835f2c27cccf20e54a3,1,1,1,2,1,2006-11-08 00:36:11,2006-11-08 00:36:11
baf0bfcb4b335438e9359835f2c27cccf20e54a3...5dd5ed09fe6b5508cf29dd1dbf40bea2f0d16ad3,1,5,3,8,3,2006-11-08 06:00:45,2006-11-08 06:00:45
5dd5ed09fe6b5508cf29dd1dbf40bea2f0d16ad3...83ee94c12ca16ef020f3d71eda34b6559ed6dc67,1,20,2,22,3,2006-11-08 06:42:05,2006-11-08 06:37:17
83ee94c12ca16ef020f3d71eda34b6559ed6dc67...403d0906e9876871a7913554be4caa93f21f1d15,2,60,19,79,22,2006-11-08 18:38:48,2006-11-08 10:48:56
403d0906e9876871a7913554be4caa93f21f1d15...1d3bc0cc0aaa056ae07a08bccc056e62d42046e8,1,29,1,30,3,2006-11-08 20:34:03,2006-11-08 10:50:07
1d3bc0cc0aaa056ae07a08bccc056e62d42046e8...744d0ac33ab579845808b8b01e526adc4678a226,2,173,76,249,21,2006-11-08 20:34:19,2006-11-08 16:59:41
744d0ac33ab579845808b8b01e526adc4678a226...2b2a8c78ea26791853cbedad3ba282475c620067,1,20,10,30,4,2006-11-08 20:34:25,2006-11-08 20:22:04
2b2a8c78ea26791853cbedad3ba282475c620067...3a946802bb2c1106d12861849414f66fdba62303,1,53,11,64,12,2006-11-08 21:20:46,2006-11-08 21:20:46
07efc6a6b6e5098ccd2dcce853be421b7dd1e244...19c4588178463cd8f0745d430159ab806d9fa6e4,3,3,0,3,3,2006-08-05 20:51:58,2006-08-04 21:01:34
19c4588178463cd8f0745d430159ab806d9fa6e4...0d958ac47a333b68b79cdc3ea206bb9a9b7486ad,1,0,1,1,1,2006-08-05 20:52:05,2006-08-05 07:20:51
0d958ac47a333b68b79cdc3ea206bb9a9b7486ad...f25b79397c9775df9eeef3d59d0cc3b1f913bc60,2,110,10,120,6,2006-08-06 08:37:08,2006-08-05 05:16:42
07efc6a6b6e5098ccd2dcce853be421b7dd1e244...61ffbcb988046dfaf8266569f78a31483be026f6,1,7,42,49,2,2006-08-05 00:40:50,2006-08-04 15:50:41
44e1d764d0d3123a614377e10655b4348cf57771...2e3ed670eb09feffe847af55db38da3dcecc2a88,4,11,7,18,9,2006-08-10 21:19:06,2006-08-10 15:02:38
a7f051987c5f020e60da1e5d6ddefc3d443d3299...de530aaa4b57b1edd9b973d814d7df8354752ccc,1,28,28,56,3,2006-08-27 00:35:15,2006-08-26 08:10:43
de530aaa4b57b1edd9b973d814d7df8354752ccc...7c3e8be30718f9866f330044fe2a0a7c5b2c3461,1,4,21,25,2,2006-08-27 00:35:17,2006-08-26 08:11:02
7c3e8be30718f9866f330044fe2a0a7c5b2c3461...5a18f540a5f8f8ba8b4f8027ed7742bfec85433c,1,6,28,34,15,2006-08-27 00:35:18,2006-08-26 08:11:36
5a18f540a5f8f8ba8b4f8027ed7742bfec85433c...465b26eeef79e3cb4cb6276e405e59d986069926,1,3,7,10,3,2006-08-27 00:35:20,2006-08-26 08:12:04
465b26eeef79e3cb4cb6276e405e59d986069926...eb950c192a0e0dfc069e16e857cbe1ae16d8ad82,1,15,18,33,13,2006-08-27 00:35:21,2006-08-26 08:12:27
eb950c192a0e0dfc069e16e857cbe1ae16d8ad82...095c424d08d96a5f9ee3ca53ae952e92c5cff99b,4,3,8,11,5,2006-08-27 00:52:58,2006-08-26 14:09:17
095c424d08d96a5f9ee3ca53ae952e92c5cff99b...83572c1a914d3f7a8dd66d954c11bbc665b7b923,9,21,26,47,15,2006-08-27 00:54:06,2006-08-26 14:16:18
83572c1a914d3f7a8dd66d954c11bbc665b7b923...5f641ccc69da1e0f2e3953f615cf592e83ec721b,1,1,0,1,1,2006-08-27 00:54:15,2006-08-26 16:52:25
5f641ccc69da1e0f2e3953f615cf592e83ec721b...e4fbbfe9eccd37c0f9c060eac181ce05988db76c,5,424,1,425,5,2006-08-27 01:27:35,2006-08-26 21:19:21
e4fbbfe9eccd37c0f9c060eac181ce05988db76c...9a8e35e98793af086f05d1ca9643052df9b44a74,4,59,12,71,8,2006-08-27 02:12:03,2006-08-26 22:45:26
9a8e35e98793af086f05d1ca9643052df9b44a74...bee597cb7fa40bd24ed8da8f3c581215ad38e15a,1,0,3,3,1,2006-08-27 22:32:11,2006-08-27 11:19:45
bee597cb7fa40bd24ed8da8f3c581215ad38e15a...2e6183840e5c8f1a478975346549be7440405175,1,0,3,3,1,2006-08-27 22:32:37,2006-08-27 11:19:58
1fcdd62adf81a172f45c7c6a58177212d500b9d9...d489bc14919cdd37d3978065591199d21d6719f8,1,31,144,175,20,2007-01-15 03:33:51,2007-01-14 11:20:23
d489bc14919cdd37d3978065591199d21d6719f8...03842d8e24face522fa0ca846283da33e747e4f0,1,5,5,10,4,2007-01-15 05:16:23,2007-01-15 05:16:23
03842d8e24face522fa0ca846283da33e747e4f0...f70b653429ebc7fdde0b36a63e1deb4aadb450d3,1,124,121,245,12,2007-01-15 09:39:05,2007-01-15 09:39:05
f70b653429ebc7fdde0b36a63e1deb4aadb450d3...80144727acc401070039434987692276dcb9273c,1,4,3,7,4,2007-01-15 11:05:22,2007-01-15 10:03:32
80144727acc401070039434987692276dcb9273c...7bfe6e261378a30980886994dabc0e7e4c9ce3d8,1,65,24,89,26,2007-01-15 11:35:41,2007-01-15 11:35:41
7bfe6e261378a30980886994dabc0e7e4c9ce3d8...3e005baf8542a3116e51c4b0a27b72c7e14d949b,1,17,11,28,1,2007-01-15 11:39:39,2007-01-15 11:39:39
3e005baf8542a3116e51c4b0a27b72c7e14d949b...2fce1f3c862845d23b2bd8305f97abb115623192,1,8,3,11,2,2007-01-15 12:12:23,2007-01-15 11:51:58
2fce1f3c862845d23b2bd8305f97abb115623192...d9ee53ce45b0f1c26285417b900b3c5735721f7e,1,68,28,96,13,2007-01-15 13:00:49,2007-01-15 13:00:49
d9ee53ce45b0f1c26285417b900b3c5735721f7e...9d1b1b5ed7f4234ea4f2c1344ba67c6f89e2067c,1,2,0,2,1,2007-01-15 13:05:01,2007-01-15 13:03:38
9d1b1b5ed7f4234ea4f2c1344ba67c6f89e2067c...5d6f3ef6413172388ee5e6090afe9802a30a59f0,1,10,9,19,2,2007-01-16 04:40:27,2007-01-16 04:40:27
5d6f3ef6413172388ee5e6090afe9802a30a59f0...0ea9f045f4eaa1d37c6b318d9d6849a4f447b997,2,48,44,92,36,2007-01-16 05:33:36,2007-01-16 05:33:19
0ea9f045f4eaa1d37c6b318d9d6849a4f447b997...6cf092619376f5bf60987f146d142497ded2f718,1,2,14,16,2,2007-01-16 05:35:41,2007-01-16 05:35:41
6cf092619376f5bf60987f146d142497ded2f718...09543c96bbe41d312bc002c293a193aa328c839d,1,4,5,9,3,2007-01-16 05:44:48,2007-01-16 05:44:48
09543c96bbe41d312bc002c293a193aa328c839d...8455e48476634eeff6fd2cd4f245cadfef14bbc8,1,71,20,91,20,2007-01-16 06:15:31,2007-01-16 06:15:31
8455e48476634eeff6fd2cd4f245cadfef14bbc8...1280158738333109cf0ada2fb378db2cdf7296ad,1,2,4,6,4,2007-01-16 06:17:47,2007-01-16 06:17:47
1280158738333109cf0ada2fb378db2cdf7296ad...0fcbcae75372f96539ba0f9598112c417d81ab0d,1,7,6,13,8,2007-01-16 06:20:57,2007-01-16 06:20:57
0fcbcae75372f96539ba0f9598112c417d81ab0d...eec11c24840bfc5293a80fed3c3b1e5bc10ac453,1,1,1,2,1,2007-01-16 09:25:12,2007-01-16 09:25:12
eec11c24840bfc5293a80fed3c3b1e5bc10ac453...a7ddc48765ff2e4f6601ea146cba4283a342e0b1,1,6,3,9,5,2007-01-16 09:55:41,2007-01-16 09:55:41
a7ddc48765ff2e4f6601ea146cba4283a342e0b1...2369ed79071edf0f040eb2c280e1e2cf9a883bb9,1,24,2,26,8,2007-01-16 21:18:44,2007-01-16 21:18:44
2369ed79071edf0f040eb2c280e1e2cf9a883bb9...2104838bf9b97066f21e4c32efdfa424d41e6b98,1,2,1,3,2,2007-01-17 05:33:18,2007-01-17 05:33:18
2104838bf9b97066f21e4c32efdfa424d41e6b98...6f64f6d9d2b12cdae1648cbf536685c888f3b981,1,3,3,6,5,2007-01-17 06:13:22,2007-01-17 05:57:23
6f64f6d9d2b12cdae1648cbf536685c888f3b981...fd99224eec67d89f970b207e7db031b7c58e812e,1,18,18,36,18,2007-01-17 06:47:25,2007-01-17 06:47:25
fd99224eec67d89f970b207e7db031b7c58e812e...69e74e7412603dd536695c3d6a397673e8ae2bd2,1,15,8,23,8,2007-01-17 07:42:43,2007-01-17 07:42:43
69e74e7412603dd536695c3d6a397673e8ae2bd2...566f44252b00003d1f4e7baaaf709d74bf73770f,1,14,12,26,8,2007-01-18 16:26:06,2007-01-18 16:26:06
566f44252b00003d1f4e7baaaf709d74bf73770f...ebea9dd4f1b62cb3c8302f10aaca3af0231e9818,2,3,2,5,3,2007-01-18 16:30:17,2007-01-18 16:30:17
ebea9dd4f1b62cb3c8302f10aaca3af0231e9818...e5808826c4abe183b4db9bae8f13445624696f66,1,4,12,16,7,2007-01-18 17:02:37,2007-01-18 17:00:49
e5808826c4abe183b4db9bae8f13445624696f66...3b4dce02752d37c3cef9308eefb01ed758efe323,1,49,15,64,6,2007-01-18 18:25:37,2007-01-18 18:14:27
3b4dce02752d37c3cef9308eefb01ed758efe323...50aee995121a103fe2698574e7f1d56660a5b89b,1,184,0,184,1,2007-01-18 18:56:06,2007-01-18 18:26:24
50aee995121a103fe2698574e7f1d56660a5b89b...8232dc427fb4b92b38e74e9e93b52231a67e354f,1,17,17,34,7,2007-01-18 19:49:05,2007-01-18 19:49:05
8232dc427fb4b92b38e74e9e93b52231a67e354f...b715cfbba4083d25ec0d0f94e440ad734607ddb0,2,82,6,88,7,2007-01-18 20:17:58,2007-01-18 20:17:58
0f2ca9d5c99436d048bfe0a7161b4365a731938f...8c02eee29e116355474250a5e9270db6034c60de,1,188,66,254,23,2006-09-01 12:19:45,2006-08-31 22:37:15
8c02eee29e116355474250a5e9270db6034c60de...af04b1271090801b277938836dcb7a39fc059721,1,1,1,2,1,2006-09-01 12:20:03,2006-09-01 08:49:29
af04b1271090801b277938836dcb7a39fc059721...501524e938aee0b9691fe7fb1abf5eb17a23132f,1,1,1,2,1,2006-09-01 19:41:34,2006-09-01 18:42:59
501524e938aee0b9691fe7fb1abf5eb17a23132f...ad1ed5ee896ba5d7f89bc04c7441b1532efb9853,1,45,40,85,11,2006-09-01 22:17:01,2006-09-01 22:17:01
ad1ed5ee896ba5d7f89bc04c7441b1532efb9853...9befac470b4cfad529032dbcffcb71242ec71f91,34,84,76,160,70,2006-09-02 10:24:37,2006-09-02 04:16:31
9befac470b4cfad529032dbcffcb71242ec71f91...6ce4e61f1be690681f6494eb5ca26540c2316f81,10,229,64,293,16,2006-09-02 21:47:53,2006-09-02 16:23:48
1bbb2cff62a7c9ff136d17723b30951159e6291a...2886bdb118699fbc343e3c0b4f93f06fbeae1061,1,10,1,11,2,2006-09-03 21:18:55,2006-09-03 15:32:24
2886bdb118699fbc343e3c0b4f93f06fbeae1061...f2e609473cb4aeb3884b7dd57a3a652df4e5edcf,1,1,1,2,1,2006-09-03 23:15:11,2006-09-03 21:43:03
4dafd7d2444051fe0e1eb17e9ded503ad7d9dd25...fd28b34afd9bbd58297a25edced3f504c9a5487a,3,28,2,30,5,2006-09-27 05:42:52,2006-09-27 05:21:19
fd28b34afd9bbd58297a25edced3f504c9a5487a...191414c025c3f0032d9b4843d629e4877126a748,1,1,0,1,1,2006-09-27 06:43:12,2006-09-26 09:42:55
191414c025c3f0032d9b4843d629e4877126a748...4a0641b7cf833644b286b56bb57d66b5538e4418,1,1,1,2,1,2006-09-27 07:08:51,2006-09-27 03:04:10
4dafd7d2444051fe0e1eb17e9ded503ad7d9dd25...9c7b0b3fc46e552bde1a65cd1950c3634854332b,2,22,0,22,2,2006-09-26 06:54:40,2006-09-26 05:23:37
4dafd7d2444051fe0e1eb17e9ded503ad7d9dd25...4de741b3e1be564233f0de2c6915a859264fe9b0,1,17,16,33,5,2006-09-26 06:09:55,2006-09-26 05:38:16
4de741b3e1be564233f0de2c6915a859264fe9b0...0fa105e7f140fc381ea3cbb776465aacefa22265,1,6,10,16,3,2006-09-27 06:47:10,2006-09-26 19:45:37
0fa105e7f140fc381ea3cbb776465aacefa22265...65910395c08e3dc4be685a9a9f60adfa61c89aa5,1,17,1,18,5,2006-09-27 07:10:17,2006-09-26 23:45:31
65910395c08e3dc4be685a9a9f60adfa61c89aa5...4b02f48372c72b38d2be7484355222f987f3af97,1,1,1,2,1,2006-09-27 07:41:35,2006-09-25 23:54:24
4b02f48372c72b38d2be7484355222f987f3af97...dd1ad5f16708e49722ad455dea8076816054391d,1,2,2,4,2,2006-09-27 07:41:35,2006-09-25 23:56:17
dd1ad5f16708e49722ad455dea8076816054391d...24d0693a68008baacd827b1345c957e871488596,1,47,16,63,18,2006-09-27 07:41:35,2006-09-25 23:57:02
24d0693a68008baacd827b1345c957e871488596...f93bff8d4531d19938a9afbdc28b8d8f4dc97b32,1,10,1,11,2,2006-09-27 07:41:35,2006-09-25 23:58:41
f93bff8d4531d19938a9afbdc28b8d8f4dc97b32...ab41dfbfd4f3f9fedac71550027e9813b11abe3d,1,9,8,17,5,2006-09-27 07:41:36,2006-09-25 23:59:43
ab41dfbfd4f3f9fedac71550027e9813b11abe3d...709f898dae46b9b035e98cc634fa3ac2492b6cee,1,1,17,18,5,2006-09-28 04:29:10,2006-09-28 00:22:03
709f898dae46b9b035e98cc634fa3ac2492b6cee...499faeda1bd131f7c3b216c16eebbe30049728d3,1,34,58,92,13,2006-09-28 04:30:01,2006-09-28 00:23:25
499faeda1bd131f7c3b216c16eebbe30049728d3...eb51ec9c05e6f4b29567f58102e33c453e1a9a57,1,23,12,35,7,2006-09-28 04:56:59,2006-09-28 00:24:49
eb51ec9c05e6f4b29567f58102e33c453e1a9a57...6dd36acd32476a474a5b7d2ad309a82c84513abe,1,8,8,16,8,2006-09-29 01:52:26,2006-09-28 23:47:50
6dd36acd32476a474a5b7d2ad309a82c84513abe...d1d866e9b8d5a6f0dbe490ba3467440bbf87feaf,1,0,1,1,1,2006-09-29 01:52:36,2006-09-28 23:48:40
d1d866e9b8d5a6f0dbe490ba3467440bbf87feaf...de9272f4bd029d0f331d154b59e64d160e6d1d14,1,9,5,14,4,2006-09-29 01:56:35,2006-09-28 23:49:21
de9272f4bd029d0f331d154b59e64d160e6d1d14...ba6ef81017a84c2fce822b7ceba74f67dea6919e,1,2,1,3,1,2006-09-29 01:57:00,2006-09-28 23:50:09
ba6ef81017a84c2fce822b7ceba74f67dea6919e...a2a3bf7b2baf0ff64c5b5ffc78d54be82d9967f1,1,4,5,9,5,2006-09-29 01:58:16,2006-09-28 23:51:43
a2a3bf7b2baf0ff64c5b5ffc78d54be82d9967f1...e46b3c027e7953bccbfe26910ff8c2d43225a17c,1,0,1,1,1,2006-09-29 02:03:28,2006-09-29 00:20:23
e46b3c027e7953bccbfe26910ff8c2d43225a17c...6d81c5a2ea6e0b11fdee87d61d073850c17ce6d8,1,2,2,4,1,2006-09-29 02:04:01,2006-09-29 00:21:07
6d81c5a2ea6e0b11fdee87d61d073850c17ce6d8...6f7ea5fb333554887656f7f6ec683544ec6e3c22,1,9,9,18,4,2006-09-30 07:23:23,2006-09-29 16:57:43
2958d9b5dbebeb82e7230bbfd3f421781d90f3f7...919a3c981323b6f919747bf6756aa8f5af09361f,1,70,0,70,1,2006-09-28 05:24:45,2006-09-28 04:58:03
919a3c981323b6f919747bf6756aa8f5af09361f...5be7649131379e49f27d89cb6dd5bd8d0912a3d6,1,10,0,10,1,2006-09-28 05:26:31,2006-09-28 05:00:38
5be7649131379e49f27d89cb6dd5bd8d0912a3d6...fc12f0829d027a6f7a86b38ae56b1424f2378470,1,6,6,12,1,2006-09-28 05:26:43,2006-09-28 05:02:00
fc12f0829d027a6f7a86b38ae56b1424f2378470...bc7127ef0f81d996e9691c6c898b926867aae89f,1,64,0,64,2,2006-09-30 22:07:58,2006-09-30 09:25:30
bc7127ef0f81d996e9691c6c898b926867aae89f...5e290ff75a0e6996f297dc438aceb8e1f29a20a5,1,43,13,56,9,2006-09-30 22:07:58,2006-09-30 19:37:37
5e290ff75a0e6996f297dc438aceb8e1f29a20a5...5cc3cef997503e7543d927dbe23daca891131168,1,18,8,26,6,2006-09-30 22:07:58,2006-09-30 21:14:31
5cc3cef997503e7543d927dbe23daca891131168...22a3844ebada55c207e2b85fb68509a7c9e2b5f0,1,24,0,24,1,2006-09-30 22:07:58,2006-09-30 21:19:25
22a3844ebada55c207e2b85fb68509a7c9e2b5f0...c0277d15effb9efcaaaa0cd84decf71a327ac07b,1,77,32,109,6,2006-09-30 22:20:44,2006-09-30 22:02:00
c0277d15effb9efcaaaa0cd84decf71a327ac07b...936a9508cc0d5369b00c76ee63cdb81556e7be39,1,0,10,10,1,2006-09-30 22:26:21,2006-09-30 22:21:28
936a9508cc0d5369b00c76ee63cdb81556e7be39...2eaf22242f61b13c38c87cbb0e84c84974c52d66,2,39,8,47,11,2006-10-01 07:32:44,2006-10-01 07:27:27
9f6db11ac5ee33f6fecc33c399838464145cad8c...aabd76930fdc585dd3e198a3351d426583af4081,1,9,2,11,4,2006-11-26 20:24:44,2006-11-26 16:42:49
aabd76930fdc585dd3e198a3351d426583af4081...36f2587ffb6802cb38071510810f48cddfc4f34a,1,21,4,25,7,2006-11-26 22:22:01,2006-11-26 20:47:52
cadd8a7d4dad0a29a9b38b33979e7137adaf62cf...d945d4be20d577868646f1b676b605cd9fdadf86,1,8,4,12,4,2006-11-25 09:10:10,2006-11-25 09:10:10
d945d4be20d577868646f1b676b605cd9fdadf86...310b86d48091ebb6a71782678769b2cb8fe2ecd5,1,25,0,25,2,2006-11-25 09:33:06,2006-11-25 09:33:06
3bd5c81e0243e4ff391b38b31ef237e46eca257b...04ece59399ba159d82cadec8d39f8ce13c12d569,1,70,18,88,8,2006-12-29 02:00:22,2006-12-29 01:58:00
04ece59399ba159d82cadec8d39f8ce13c12d569...e19b9ddab3fb7bd3bf6ed6629d3f014722e57a31,1,2,1,3,1,2006-12-29 02:37:33,2006-12-29 00:32:05
e19b9ddab3fb7bd3bf6ed6629d3f014722e57a31...013672bc589da395fcba9bf62d699e70f3764689,1,1,1,2,1,2006-12-29 02:37:33,2006-12-29 00:32:17
c0b7391bf5dd314523b8c6ea29ffafc8769f2eb1...211e6eb513f372ad79fecc3db19413b3573ae962,1,1,1,2,1,2006-12-06 18:52:04,2006-12-06 18:52:04
211e6eb513f372ad79fecc3db19413b3573ae962...5a4cf3346d6c37007a7f5f94697868a5b2f2fa29,1,22,8,30,3,2006-12-06 19:11:58,2006-12-04 22:47:22
5a4cf3346d6c37007a7f5f94697868a5b2f2fa29...ebdf7b952215946eff863e4da28f924178acea4f,1,1,0,1,1,2006-12-06 19:11:58,2006-12-04 08:51:16
ebdf7b952215946eff863e4da28f924178acea4f...de51faf3888505fa3d661d4c35f32ecaf9fa1087,1,3,2,5,1,2006-12-06 19:22:55,2006-12-06 19:22:55
d9ad59e7636d98daa6131e9fd2cb2b4f5745a853...50319850343dfe534939ee6b38507d5a8fc44b50,1,2,2,4,1,2006-02-22 09:27:02,2006-02-22 09:27:02
d9ad59e7636d98daa6131e9fd2cb2b4f5745a853...cac251d0bc4c68b7ab36026990aff3c783913ae6,1,2,3,5,2,2006-02-22 08:36:09,2006-02-22 01:39:25
cac251d0bc4c68b7ab36026990aff3c783913ae6...fe474b588b3cb1c23c987a3d0f9e869a160d82d2,1,14,10,24,6,2006-02-22 08:36:09,2006-02-22 01:41:41
fe474b588b3cb1c23c987a3d0f9e869a160d82d2...8e1454b5ad285ec5dd25758e799c589045aff9d4,1,85,146,231,20,2006-02-22 08:36:09,2006-02-22 01:43:17
7a1d9d14c8475715c6b923f378eb72be096c7963...16c1ff968ac9717c958129eb05aa089cc0ca51e7,1,12,3,15,4,2006-03-30 07:43:51,2006-03-30 07:43:51
16c1ff968ac9717c958129eb05aa089cc0ca51e7...7b5ff7e7d715391b9745a46fcfaacf1d97d4dc9f,1,2,2,4,2,2006-03-30 09:50:40,2006-03-30 09:50:40
7b5ff7e7d715391b9745a46fcfaacf1d97d4dc9f...f3408449622cad37ce29f23754c8e7a8fb453ff1,1,9,9,18,3,2006-03-30 22:54:24,2006-03-30 22:54:24
f3408449622cad37ce29f23754c8e7a8fb453ff1...be0cd0981f1811b9e5177f1f5c8ff900c33fbdbb,1,35,10,45,10,2006-03-30 22:55:11,2006-03-30 22:55:11
be0cd0981f1811b9e5177f1f5c8ff900c33fbdbb...879e8b1aad021cade0a254db0a5b67f56d99902a,1,21,16,37,4,2006-03-30 23:45:14,2006-03-30 23:45:14
d19e06fa8f86b611c10115903ef7e50d5de112f0...147cf31738e5e66aa304897ede6b556d4e204967,1,11,0,11,1,2006-02-09 20:06:57,2006-02-09 15:12:11
147cf31738e5e66aa304897ede6b556d4e204967...ce1610ead63221738225c415300f3d32620ced04,2,3,3,6,4,2006-02-09 22:41:39,2006-02-09 22:41:39
ce1610ead63221738225c415300f3d32620ced04...67d42212ff104aaafa97b943cb369b8444f61581,1,10,5,15,5,2006-02-10 02:38:52,2006-02-10 01:56:13
67d42212ff104aaafa97b943cb369b8444f61581...d60fc1c8649f80c006b9f493c542461e81608d4b,5,11,12,23,8,2006-02-10 05:06:38,2006-02-09 22:50:04
d60fc1c8649f80c006b9f493c542461e81608d4b...91c7674371c101766242b52ea1880cd919cb3075,1,2,5,7,2,2006-02-10 05:06:38,2006-02-10 01:15:59
d19e06fa8f86b611c10115903ef7e50d5de112f0...ee63802422af14e43eccce3c6dc4150a27ceb1a3,3,67,12,79,9,2006-02-09 19:46:05,2006-02-09 18:30:28
ee63802422af14e43eccce3c6dc4150a27ceb1a3...5b23683251801381a17b5c3e82940c268821681c,1,2,1,3,2,2006-02-09 22:35:19,2006-02-09 22:35:19
5b23683251801381a17b5c3e82940c268821681c...0a798076b8d1a4a31bf2b24c564e2a99fd1c43a1,4,64,32,96,15,2006-02-09 23:23:06,2006-02-09 23:23:06
d19e06fa8f86b611c10115903ef7e50d5de112f0...701ca744e386c2429ca44072ea987bbb4bdac7ce,1,21,1,22,2,2006-02-09 08:08:31,2006-02-09 08:08:31
d19e06fa8f86b611c10115903ef7e50d5de112f0...dfdd309e574df2da93f48d9cf4e83d53233dbe14,1,5,0,5,1,2006-02-09 05:55:34,2006-02-07 21:19:10
dfdd309e574df2da93f48d9cf4e83d53233dbe14...47e013f9207a235a87390ee8ad03c8a7406f4147,1,6,1,7,1,2006-02-09 05:55:34,2006-02-07 23:35:46
d19e06fa8f86b611c10115903ef7e50d5de112f0...5f73076c1a9b4b8dc94f77eac98eb558d25e33c0,13,99,21,120,36,2006-02-09 05:54:42,2006-02-09 05:15:24
5f73076c1a9b4b8dc94f77eac98eb558d25e33c0...8b9b0f3af73233595b6b1103ffb30242508a5e47,1,9,0,9,1,2006-02-09 05:54:48,2006-02-09 05:49:47
8b9b0f3af73233595b6b1103ffb30242508a5e47...2bcab24080dc97fc628e1b601a195a9a96773fac,1,17,1,18,2,2006-02-09 05:54:52,2006-02-09 05:50:18
01f49e3453d9960fec62d93bc3a66784f1be4c26...a4adf54d38ba49e58511aaafd18e99e6d3d4dabb,1,4,3,7,3,2005-12-14 20:57:49,2005-12-14 20:57:49
01f49e3453d9960fec62d93bc3a66784f1be4c26...d025524d9d85b057c3caae68a8398eaf7ba3be1a,4,56,34,90,7,2005-12-14 10:53:43,2005-12-11 09:55:49
d025524d9d85b057c3caae68a8398eaf7ba3be1a...aa9dc7afd2fc40466b430b35fc5c82d3c820cb26,1,2,2,4,1,2005-12-14 10:53:43,2005-12-13 07:38:47
aa9dc7afd2fc40466b430b35fc5c82d3c820cb26...806f36d4d7caf75b6d3e098cb0353d85d3477c7d,14,39,89,128,25,2005-12-14 10:53:43,2005-12-13 22:30:31
806f36d4d7caf75b6d3e098cb0353d85d3477c7d...349701210dcfb87ed155258cd77644035a69f613,1,7,5,12,2,2005-12-14 10:53:43,2005-12-13 22:30:31
349701210dcfb87ed155258cd77644035a69f613...4e7824b12e71127f1e3cf76fe2855887599c0dc6,1,5,14,19,4,2005-12-14 10:53:43,2005-12-13 22:30:31
4e7824b12e71127f1e3cf76fe2855887599c0dc6...cf1fe88ce1fb75db14549e9d57d88c2ad88caf9d,1,3,7,10,2,2005-12-14 10:53:44,2005-12-13 22:30:31
cf1fe88ce1fb75db14549e9d57d88c2ad88caf9d...6cf6193b458a5791dba993a81d3bb77f4dc030ac,1,4,0,4,2,2005-12-14 10:53:44,2005-12-13 22:30:31
6cf6193b458a5791dba993a81d3bb77f4dc030ac...43a95cfbc9ce27bfb40746b90717e041805a906c,1,5,8,13,3,2005-12-14 10:53:44,2005-12-13 22:30:31
43a95cfbc9ce27bfb40746b90717e041805a906c...87358b7a193e24ed6cbe0dd8287a5c558a8ac421,1,5,0,5,2,2005-12-14 10:53:44,2005-12-13 22:30:31
87358b7a193e24ed6cbe0dd8287a5c558a8ac421...d20e2f161b068c00e95c6deea7ada9487945e8b7,1,9,1,10,1,2005-12-14 10:53:44,2005-12-13 22:30:31
d20e2f161b068c00e95c6deea7ada9487945e8b7...7ab099d220e5bbb5c6385c1beb5e70bbed930b4b,1,2,1,3,2,2005-12-14 10:53:44,2005-12-13 22:30:32
7ab099d220e5bbb5c6385c1beb5e70bbed930b4b...3ae39ab232a103c2a4284a6701be62d95f0d0987,1,3,2,5,3,2005-12-14 10:53:44,2005-12-13 22:30:32
3ae39ab232a103c2a4284a6701be62d95f0d0987...9678faaaffd3eba057bf1cb643399c5a5365a611,1,2,1,3,2,2005-12-14 10:53:44,2005-12-13 22:30:32
9678faaaffd3eba057bf1cb643399c5a5365a611...5073eb04d6f0e8ac2578140b9231817e2afefe50,1,1,1,2,1,2005-12-14 10:53:45,2005-12-14 02:19:12
01f49e3453d9960fec62d93bc3a66784f1be4c26...b3f041fb0f7de167dbb6711b0a231d36c4b5de08,3,75,42,117,20,2005-12-14 10:04:56,2005-12-14 06:39:23
c2f3bf071ee90b01f2d629921bb04c4f798f02fa...21b1aced83195af50fd8bc9a88e7734c8ee77c0e,1,1,0,1,1,2005-12-21 20:13:52,2005-12-21 20:09:17
21b1aced83195af50fd8bc9a88e7734c8ee77c0e...455c161c47542de7e67d2ba48bba637e5a645388,1,2,2,4,2,2005-12-21 20:13:53,2005-12-21 20:10:10
455c161c47542de7e67d2ba48bba637e5a645388...9470657ad0d0472e3e3c2e352334f60e7bd777c1,1,1,1,2,1,2005-12-21 20:22:43,2005-12-21 16:53:29
9470657ad0d0472e3e3c2e352334f60e7bd777c1...6689f08735d08a057f8d6f91af98b04960afa517,1,1,1,2,1,2005-12-21 21:00:31,2005-12-21 20:35:48
c2f3bf071ee90b01f2d629921bb04c4f798f02fa...5d9d11db3c6768d67250b47391a944471bcd92c3,2,7,1,8,2,2005-12-21 20:12:26,2005-12-21 20:12:26
4ea836dba92894828c73b8cadd927bc6128866b0...3402f1d6a3d8f4205fe59286e3a1223a9d28aea6,1,3,0,3,1,2005-11-06 18:21:06,2005-11-05 19:12:05
3402f1d6a3d8f4205fe59286e3a1223a9d28aea6...bb73d73c0885fce357e0d70aa51c2215a8e38a4e,3,38,35,73,4,2005-11-06 18:31:48,2005-11-06 16:26:07
bb73d73c0885fce357e0d70aa51c2215a8e38a4e...0cfddacdcca229deca9a1dcdf8628bf168171908,1,4,0,4,1,2005-11-06 18:52:48,2005-11-06 12:33:07
0cfddacdcca229deca9a1dcdf8628bf168171908...fcbc3083e37f3c025d85d7b2c8a1c53d07a81fac,1,24,2,26,2,2005-11-07 01:26:31,2005-11-07 01:26:31
fcbc3083e37f3c025d85d7b2c8a1c53d07a81fac...f1790448628262e46496861bb6da76be63a2a247,1,1,1,2,1,2005-11-07 01:37:40,2005-11-07 01:37:40
f1790448628262e46496861bb6da76be63a2a247...95d117b6051c01726b67d3151f83e47dd41c0743,2,12,3,15,2,2005-11-07 02:17:14,2005-11-06 08:52:57
95d117b6051c01726b67d3151f83e47dd41c0743...bee8e79da08f3e50fd7e3b3b203aea284a933fe1,1,1,1,2,1,2005-11-07 02:31:46,2005-11-06 21:07:45
bee8e79da08f3e50fd7e3b3b203aea284a933fe1...67ffdf4c0af47679b8a4ac2b70e722e2f65fc4f9,1,2,0,2,1,2005-11-07 02:31:46,2005-11-06 23:36:15
67ffdf4c0af47679b8a4ac2b70e722e2f65fc4f9...90279074ca5cc336a8bfffd47d19d089b291b432,1,3,3,6,3,2005-11-07 02:31:47,2005-11-06 23:59:39
3ff8cbeda635422f4740d325d56288dfdea10179...89764f5d8b0ca8600e3a200e9f863c3c7a3ff5e8,1,3,3,6,3,2005-10-10 09:15:09,2005-10-10 09:15:09
89764f5d8b0ca8600e3a200e9f863c3c7a3ff5e8...eaf718f3ece277462de4e47391e5a965bbbaa297,3,772,1,773,3,2005-10-10 09:40:43,2005-10-10 09:40:43
eaf718f3ece277462de4e47391e5a965bbbaa297...2b5e63d1b4a6f1b0ef58755a192ecb2d04e3569d,1,11,5,16,5,2005-10-10 10:33:22,2005-10-10 10:33:22
2b5e63d1b4a6f1b0ef58755a192ecb2d04e3569d...c015bf2bcbdc2021410753b4a024dd35dfef6a33,1,0,25,25,2,2005-10-10 10:34:32,2005-10-10 10:34:32
c015bf2bcbdc2021410753b4a024dd35dfef6a33...f0daa628a297819ed039e6b61d337fde02d8a6dd,1,16,10,26,11,2005-10-10 10:41:15,2005-10-10 10:41:15
f0daa628a297819ed039e6b61d337fde02d8a6dd...6d281217b930466717d0078285e5431c409b7aec,1,4,4,8,4,2005-10-10 10:45:46,2005-10-10 10:45:46
6d281217b930466717d0078285e5431c409b7aec...c6582aba5230301fe826c06d1891a4a8a9d32074,1,1,1,2,1,2005-10-10 11:10:01,2005-10-10 11:10:01
c6582aba5230301fe826c06d1891a4a8a9d32074...37dcf6de60498dfedb5d97ad96789b0527493bcd,1,2,0,2,1,2005-10-10 11:42:48,2005-10-10 11:42:48
37dcf6de60498dfedb5d97ad96789b0527493bcd...8cd4177d5ef651c8acb9c1f113a076e6fae2e1c2,1,6,5,11,4,2005-10-10 12:14:44,2005-10-10 12:14:44
8cd4177d5ef651c8acb9c1f113a076e6fae2e1c2...c7ff5f1d7d6f103802fd6d6b1d4dcdf095e95d5f,1,1,1,2,1,2005-10-10 12:18:38,2005-10-10 12:18:38
c7ff5f1d7d6f103802fd6d6b1d4dcdf095e95d5f...62d72e4b707d6931787e91f611ed49aaabb14391,1,0,2,2,2,2005-10-10 12:19:15,2005-10-10 12:19:15
62d72e4b707d6931787e91f611ed49aaabb14391...f02b3eba7fc6e3fca25e0063dde6ff149aed2b45,1,12,16,28,11,2005-10-10 12:42:59,2005-10-10 12:42:59
f02b3eba7fc6e3fca25e0063dde6ff149aed2b45...bf267d99e88410a31452d4d1ccae0b9b4432b11e,1,125,120,245,14,2005-10-10 12:51:13,2005-10-10 12:51:13
bf267d99e88410a31452d4d1ccae0b9b4432b11e...7ee74a99b2b710b5f5adc22db2fe0aca8a74c809,2,12,7,19,8,2005-10-10 13:14:21,2005-10-10 13:14:21
7ee74a99b2b710b5f5adc22db2fe0aca8a74c809...e7e477dfacecaf362f08a65644d806da5231a9f0,1,6,6,12,3,2005-10-10 13:28:00,2005-10-10 13:28:00
e7e477dfacecaf362f08a65644d806da5231a9f0...3ef378a67b5b39441837700ab4dfb800eb443c5a,2,20,6,26,9,2005-10-10 16:45:00,2005-10-10 16:45:00
3ef378a67b5b39441837700ab4dfb800eb443c5a...22dcbb75129b3124a9fd71ed449030b79093b634,1,1,0,1,1,2005-10-10 16:54:53,2005-10-10 16:54:53
22dcbb75129b3124a9fd71ed449030b79093b634...8470b7f3a3cd5a70ff0b05486e335d351843890f,1,1,1,2,1,2005-10-10 18:10:48,2005-10-10 18:10:48
8470b7f3a3cd5a70ff0b05486e335d351843890f...16e685967d638fd50860fa24bd5f2d06ab4f8e96,1,1,1,2,1,2005-10-11 12:18:01,2005-10-11 12:18:01
16e685967d638fd50860fa24bd5f2d06ab4f8e96...2fa92046a8ae8548a8dff15abbf730506d49009e,1,2,1,3,2,2005-10-11 14:22:03,2005-10-11 14:22:03
2fa92046a8ae8548a8dff15abbf730506d49009e...4a91b796e3f48ad01d06cce46df28321b7a1500b,1,4,35,39,5,2005-10-11 15:02:45,2005-10-11 15:02:45
4a91b796e3f48ad01d06cce46df28321b7a1500b...25f6f325d7a8f7cb686a9ffd9fa2c00b3aa85a60,2,80,19,99,17,2005-10-11 16:13:30,2005-10-11 16:13:30
25f6f325d7a8f7cb686a9ffd9fa2c00b3aa85a60...0090a6185af18a199d5bc12781adf411177f1e1a,1,56,13,69,13,2005-10-11 17:42:27,2005-10-11 17:42:27
0090a6185af18a199d5bc12781adf411177f1e1a...f005dba7c15af5de74e05f8667da4e5d27cf6d1b,1,1,1,2,1,2005-10-16 17:37:25,2005-10-16 17:37:25
f005dba7c15af5de74e05f8667da4e5d27cf6d1b...40dad96e41fcb96e31bdf11deec3c7bf6261adbe,1,2,1,3,1,2005-10-16 17:57:38,2005-10-16 17:57:38
70a0c6fe39da7e3f68836051408bc8eb3ce60ba7...e9b2e586181ae7631a048b88221fb857706900e9,1,0,67,67,1,2005-10-04 06:47:19,2005-10-04 06:47:19
e9b2e586181ae7631a048b88221fb857706900e9...f6413391b1f193cda54c0e4725ac28c9c4883ccc,1,7,4,11,1,2005-10-04 06:49:46,2005-10-04 06:49:46
f6413391b1f193cda54c0e4725ac28c9c4883ccc...b10c1a74f0edb7664f127a4f7308fb287beb5f01,1,1,5,6,2,2005-10-04 07:40:59,2005-10-04 07:40:59
b10c1a74f0edb7664f127a4f7308fb287beb5f01...129056370abff1cc0d347b98fe88afc44a6cb8c0,2,110,0,110,2,2005-10-05 00:04:03,2005-10-04 23:45:01
7fa090844f7d1624c7d1ffc621aae6aec84a1110...ba8a4970c790c9a03bb3ed72e24d86bd8aa11a67,1,11,0,11,1,2005-09-12 20:19:53,2005-09-12 18:23:00
ba8a4970c790c9a03bb3ed72e24d86bd8aa11a67...f22cc3fcbfe7755154a3a151215abd39162e2e85,2,21,1,22,2,2005-09-12 20:20:03,2005-09-12 19:06:10
f22cc3fcbfe7755154a3a151215abd39162e2e85...540bf654d007b3289adec37e3008c588ba677e25,1,6,1,7,2,2005-09-12 20:24:55,2005-09-12 20:24:55
540bf654d007b3289adec37e3008c588ba677e25...8ceba720ba5e5e76384e46629e599124c6f36409,1,1,1,2,1,2005-09-12 21:53:55,2005-09-12 21:29:06
8ceba720ba5e5e76384e46629e599124c6f36409...ace36858d3adfde1e497404e831f1cac8034fd4a,1,12,7,19,5,2005-09-12 21:53:57,2005-09-12 21:29:54
ace36858d3adfde1e497404e831f1cac8034fd4a...654291a2acb1c28b884cb9376a0d7eb5f8c090b5,2,13,14,27,7,2005-09-12 21:53:58,2005-09-12 21:30:47
654291a2acb1c28b884cb9376a0d7eb5f8c090b5...206e587cb8ab22a9d264c20fb6299124a857281a,1,3,0,3,1,2005-09-12 21:53:59,2005-09-12 21:31:22
206e587cb8ab22a9d264c20fb6299124a857281a...4e48fe3f1c42519f1aad92176489eeb174a319c0,1,3,0,3,1,2005-09-12 21:54:00,2005-09-12 21:31:56
4e48fe3f1c42519f1aad92176489eeb174a319c0...5d9d831a51dc7847ad40fac77f9a072aa2d1c0bd,1,41,23,64,2,2005-09-13 02:15:02,2005-09-12 23:46:53
5d9d831a51dc7847ad40fac77f9a072aa2d1c0bd...663a5ed5ca964d83269b5616348266bf3b7a7ab4,2,12,3,15,4,2005-09-13 02:15:02,2005-09-12 00:00:49
663a5ed5ca964d83269b5616348266bf3b7a7ab4...4a5b63e3e966184aa1ff32770410d485202562ca,1,27,11,38,9,2005-09-13 02:15:02,2005-09-11 18:35:20
4a5b63e3e966184aa1ff32770410d485202562ca...7f88c8463caa14ca397048f8e576e348ce73203a,1,1,0,1,1,2005-09-13 02:15:03,2005-09-11 21:12:08
7f88c8463caa14ca397048f8e576e348ce73203a...2aba319a52b3601cff3f32b60bc28023ee45575d,3,54,3,57,6,2005-09-13 02:39:15,2005-09-13 02:39:15
85002315798dfcd28da6120ac3a461ca3fadfd2e...52a22d1e726f91b0ba4ea0afb7cfbfaaf624127b,10,77,106,183,48,2005-08-27 03:53:50,2005-08-27 01:18:48
52a22d1e726f91b0ba4ea0afb7cfbfaaf624127b...905197de9f8f1a2ce619ac888ab7a2e1a67acb56,3,34,34,68,16,2005-08-27 04:33:46,2005-08-27 04:33:46
905197de9f8f1a2ce619ac888ab7a2e1a67acb56...90bc118fc53916a623cad84e72b7dec597907b1e,3,14,1,15,4,2005-08-27 04:46:32,2005-08-25 23:31:43
90bc118fc53916a623cad84e72b7dec597907b1e...b10ac50f1e9ef851128f9800cd481d8cace18f01,2,49,5,54,9,2005-08-27 05:06:17,2005-08-26 01:15:32
b10ac50f1e9ef851128f9800cd481d8cace18f01...7311d9f10476f9b478348dab597bcc3d8736f091,1,83,0,83,1,2005-08-27 05:35:45,2005-08-27 05:35:45
7311d9f10476f9b478348dab597bcc3d8736f091...aba2da13391d2adc72c0a2805e7196db2c803753,1,39,47,86,9,2005-08-27 05:36:54,2005-08-26 01:57:35
017f804efc47234682fb0103a51ac453d96c56c1...429bb40abdb5b42ffdde5b1a58f9a37da723d179,14,24,22,46,20,2014-02-24 22:36:52,2014-01-24 13:40:28
429bb40abdb5b42ffdde5b1a58f9a37da723d179...ebb32893bad46bf5edae881552672a47dd2684b8,5,12,8,20,6,2014-02-24 22:37:09,2014-01-24 13:40:29
ebb32893bad46bf5edae881552672a47dd2684b8...854b09592ce9a497f56f35d973c4abe43af84cd1,7,27,25,52,16,2014-02-24 22:37:14,2014-01-24 13:40:30
854b09592ce9a497f56f35d973c4abe43af84cd1...42b0874a7ef66f9bd561c66df6e989f58d0393b9,1,13,6,19,7,2014-02-24 22:37:19,2014-01-24 13:40:31
42b0874a7ef66f9bd561c66df6e989f58d0393b9...68690fdd0b78762eb6387d7a437b588d15b6cf47,1,6,1,7,2,2014-02-24 22:37:19,2014-01-24 13:40:32
68690fdd0b78762eb6387d7a437b588d15b6cf47...ae8d0824217bdf97c69ead49568cd03fc140627b,6,20,9,29,10,2014-02-24 22:37:19,2014-01-24 13:40:33
ae8d0824217bdf97c69ead49568cd03fc140627b...05b85022c9a76954a1a281a5dc5bcd32ad486b88,1,1,2,3,1,2014-02-24 22:37:24,2014-01-24 13:40:34
05b85022c9a76954a1a281a5dc5bcd32ad486b88...2e70c01799bf663cc1fa5f6e37e025000ffdc0b0,1,2,19,21,3,2014-02-24 22:37:24,2014-01-24 13:40:35
2f93541d88fadd1ff5307d81c2c8921ee3eea058...61e704e38a4c3e181403a766c5cf28814e4102e4,1,1,1,2,2,2014-11-26 18:51:05,2014-11-26 10:12:47
2f93541d88fadd1ff5307d81c2c8921ee3eea058...4825b80ef9a8a407025748e51525787abd69bde0,1,0,12,12,1,2014-03-12 22:04:55,2014-03-11 22:46:44
2f93541d88fadd1ff5307d81c2c8921ee3eea058...649813763c58421d6fdbc57b651e4d46f26f1fea,1,9,3,12,2,2014-03-11 20:40:25,2014-03-11 03:51:57
649813763c58421d6fdbc57b651e4d46f26f1fea...f5b6ffad83469f6f3bb2afaede1c15ed6125fcb6,1,1,1,2,1,2014-03-17 22:04:12,2014-03-17 07:50:49
2f93541d88fadd1ff5307d81c2c8921ee3eea058...62fb6d03dab0f6d93b1e1fcaef312bf6e2718f17,1,1,1,2,1,2014-03-11 20:33:15,2014-03-11 18:35:29
2f93541d88fadd1ff5307d81c2c8921ee3eea058...72c378d8a618b9a57e4edf12700c51b0af86f124,1,3,4,7,1,2014-03-05 20:33:02,2014-03-05 17:26:25
72c378d8a618b9a57e4edf12700c51b0af86f124...17e22ddc1c34858beece1b090b392d7c73d1c0a3,1,1,3,4,1,2014-03-05 20:33:30,2014-03-05 17:26:26
17e22ddc1c34858beece1b090b392d7c73d1c0a3...79192b87ad6a57e2b2a6219f0a17e85ece759c0f,1,3,2,5,1,2014-03-05 20:33:46,2014-03-05 17:26:27
79192b87ad6a57e2b2a6219f0a17e85ece759c0f...03b0403b4a957bb52f5266ac071869da32a3be0a,1,1,1,2,1,2014-03-05 20:33:53,2014-03-05 17:26:28
03b0403b4a957bb52f5266ac071869da32a3be0a...8b7e5f79723b0f2e1d3dca4e959ad2a2041e9453,1,0,2,2,1,2014-03-05 20:34:05,2014-03-05 17:26:29
8b7e5f79723b0f2e1d3dca4e959ad2a2041e9453...3491047e14532f4c01e3459d59d914d9598721c5,1,3,2,5,2,2014-03-05 20:34:26,2014-03-05 17:26:30
2f93541d88fadd1ff5307d81c2c8921ee3eea058...9ef5e2a7223fbabf6a29946c1c120bc2c3c6cf86,1,0,4,4,1,2014-03-05 20:26:51,2014-02-28 11:09:04
2f93541d88fadd1ff5307d81c2c8921ee3eea058...0eea5a6e91d3da6932c13f16fdf4b4e5ed91b93c,1,1,1,2,1,2014-03-03 18:43:40,2014-03-02 07:30:11
2f93541d88fadd1ff5307d81c2c8921ee3eea058...2d4c99339210d43a84841a71a50e88a050d9e21b,1,8,2,10,1,2014-02-26 22:18:54,2014-02-26 22:18:54
2f93541d88fadd1ff5307d81c2c8921ee3eea058...fceb907225745b91aa8b9e0ef2ea068b0351ea01,1,28,21,49,2,2014-02-24 22:50:03,2014-01-25 06:46:49
fceb907225745b91aa8b9e0ef2ea068b0351ea01...f34b205f6cc2c78cbed03a1582422cb59e36f729,3,25,5,30,7,2014-02-24 22:50:14,2014-01-25 06:46:50
2f93541d88fadd1ff5307d81c2c8921ee3eea058...29d9af586ba3ee1e6df1dc070f42ea659ad77cc2,1,47,0,47,2,2014-02-24 22:30:22,2014-01-27 14:45:06
29d9af586ba3ee1e6df1dc070f42ea659ad77cc2...2e2e7ec1ef567ac0a4ad8294ada15836661e6589,2,7,3,10,5,2014-02-24 22:31:10,2014-01-27 14:45:07
2e2e7ec1ef567ac0a4ad8294ada15836661e6589...257627268ad19cb616ad3feb6ca8171d400df287,3,16,12,28,11,2014-02-24 22:31:17,2014-01-27 14:45:08
257627268ad19cb616ad3feb6ca8171d400df287...6e2068ae48000a2dfdb2044bbb91073c11f6fbff,2,3,2,5,2,2014-02-24 22:31:30,2014-01-27 14:45:09
2f93541d88fadd1ff5307d81c2c8921ee3eea058...ce8daa1eb863c9cdefb06feae2ee7c742ea89847,2,32,1,33,2,2014-02-20 22:14:33,2014-02-12 09:54:16
2f93541d88fadd1ff5307d81c2c8921ee3eea058...aba4727281612c3e24914691727e11e1f44a9aac,2,32,3,35,4,2014-02-18 20:06:08,2014-02-16 16:52:34
2f93541d88fadd1ff5307d81c2c8921ee3eea058...39a87a29ce364ed3337e535adce5973731ba2968,2,3,3,6,3,2014-02-05 18:45:51,2014-02-03 11:33:16
2f93541d88fadd1ff5307d81c2c8921ee3eea058...b19c12e6ed91e62d82372fcabcbb60b76b4f7a87,2,0,0,0,0,2014-02-04 18:49:10,2014-02-04 02:20:08
2f93541d88fadd1ff5307d81c2c8921ee3eea058...81966ab2ecae5ae73627def9538e2a9dafae7523,1,3,2,5,1,2014-02-04 18:35:58,2014-02-04 02:56:26
2f93541d88fadd1ff5307d81c2c8921ee3eea058...e4ddb05720710213108cd13ddd5a115e12a6211d,2,14,1,15,2,2014-01-27 17:01:50,2014-01-25 22:06:46
2f93541d88fadd1ff5307d81c2c8921ee3eea058...fd78cedc52a3eab708c1dec2a705b034ddd10d57,1,2,2,4,2,2014-01-27 16:55:28,2014-01-25 13:11:44
2f93541d88fadd1ff5307d81c2c8921ee3eea058...ea97002fc9f682a804ac05212d069e38fa3e365c,1,12,0,12,1,2014-01-21 22:46:17,2014-01-21 02:25:12
ea97002fc9f682a804ac05212d069e38fa3e365c...200abe7458357c83f3859ce6dbf89ea5d4d09b3d,1,11,9,20,1,2014-01-21 22:46:24,2014-01-21 02:25:40
2f93541d88fadd1ff5307d81c2c8921ee3eea058...4c224081118ac27ea62cb249bd95e66cba652483,2,12,1,13,2,2014-01-15 20:37:24,2014-01-15 10:46:13
2f93541d88fadd1ff5307d81c2c8921ee3eea058...e2f5df42449ace700e5a237f604c34b4657c0edf,1,25,6,31,4,2013-12-30 19:37:49,2013-12-30 19:37:49
e2f5df42449ace700e5a237f604c34b4657c0edf...8f29299136c2f11730d876cd62637a9e37d4c388,2,40,1,41,2,2013-12-30 19:58:54,2013-12-30 19:58:54
2f93541d88fadd1ff5307d81c2c8921ee3eea058...5e1361ccdbfaf328b5bae1eae29f16ba965c54b1,2,17,0,17,2,2013-12-20 22:37:03,2013-12-17 04:28:21
2f93541d88fadd1ff5307d81c2c8921ee3eea058...82246b765bdfc191aa809cf3dd672de18ad6352a,1,2,2,4,2,2013-12-20 22:05:07,2013-12-20 10:53:52
2f93541d88fadd1ff5307d81c2c8921ee3eea058...615b8f1a8d41e6c27f308e74eacb5ef9e99a26af,1,32,1,33,2,2013-12-18 18:41:41,2013-12-18 14:25:16
2f93541d88fadd1ff5307d81c2c8921ee3eea058...c5665000327388832fa8be0b3bf17669f672481b,1,8,0,8,1,2013-12-09 21:42:40,2013-12-08 20:40:27
2f93541d88fadd1ff5307d81c2c8921ee3eea058...5594bcad21da70d2e9704cf96baa91b8d99dc27b,2,8,0,8,2,2013-12-06 20:57:10,2013-12-05 03:31:11
2f93541d88fadd1ff5307d81c2c8921ee3eea058...d4d9653b5401b28dd88a84bd1bf1d269b8acccf6,1,1,0,1,1,2013-12-04 19:45:27,2013-12-01 22:48:41
d4d9653b5401b28dd88a84bd1bf1d269b8acccf6...979e652a18eea8e865777239f11c89795d969211,1,1,1,2,1,2013-12-04 19:45:30,2013-12-01 22:48:42
979e652a18eea8e865777239f11c89795d969211...5508f3ed2c1cdb515e658cfc29ca0d5cd6683190,1,5,2,7,2,2013-12-04 19:45:32,2013-12-01 22:48:43
7794a680e63a2a11b73cb1194653662f2769a792...4b3b33a747c325f76b1f6eef89c231609dd4d361,2,39,5,44,11,2014-01-03 18:13:39,2014-01-03 02:28:51
4b3b33a747c325f76b1f6eef89c231609dd4d361...10a6cc8890ec1e5459c05ddeb28a671acdc37d60,2,19,5,24,3,2014-01-03 18:18:40,2014-01-03 02:28:52
7794a680e63a2a11b73cb1194653662f2769a792...2394e94e831991348688831a384b088a424c7ace,1,8,2,10,4,2013-12-27 20:22:19,2013-12-27 08:05:15
7794a680e63a2a11b73cb1194653662f2769a792...5d642e75069334944fcc795a80cf04749dd12857,2,54,0,54,5,2013-12-26 19:53:32,2013-12-21 14:24:20
5d642e75069334944fcc795a80cf04749dd12857...65ea9c3c3d0e74b1f8c0c1d9fea6988550133dba,3,49,3,52,6,2013-12-26 19:54:26,2013-12-21 14:25:22
7794a680e63a2a11b73cb1194653662f2769a792...9af270e8c2a02afd9a3262a2c9312ee7fefbb7a3,4,3,7,10,5,2013-12-26 19:50:20,2013-12-21 14:13:25
25d1ac0e59f4471c3b124a0c19cad9f9511a26ad...b984d333a1367078c3631b8dfdd0d0ec7b332715,1,2,2,4,2,2014-04-07 19:09:10,2014-04-07 13:47:52
b984d333a1367078c3631b8dfdd0d0ec7b332715...c13291108880f9adc26a2ab5c09535869afecb22,1,1,1,2,1,2014-04-07 19:09:10,2014-04-07 13:47:53
c13291108880f9adc26a2ab5c09535869afecb22...697a41519b0d41c1b2c5714b5558f68814d78885,2,17,7,24,6,2014-04-07 19:09:11,2014-04-07 13:47:54
697a41519b0d41c1b2c5714b5558f68814d78885...20fcffcc8de9fcfba15fce916ff38c98ca20323d,1,25,1,26,3,2014-04-07 19:09:11,2014-04-07 13:47:55
20fcffcc8de9fcfba15fce916ff38c98ca20323d...f412411245d4329307dec8ac0b1860c791cdb212,11,40,29,69,24,2014-04-07 19:09:11,2014-04-07 13:47:56
f412411245d4329307dec8ac0b1860c791cdb212...595deb8da69b4f816ff0c8e669b49f7527ff609b,3,3,3,6,3,2014-04-07 19:09:11,2014-04-07 13:47:57
595deb8da69b4f816ff0c8e669b49f7527ff609b...e23d84350a3f4a3bfb86037eb1e6c4b28240324e,1,108,62,170,44,2014-04-07 19:09:11,2014-04-07 13:47:58
e23d84350a3f4a3bfb86037eb1e6c4b28240324e...2f57736002e6a774ce5ab53a15a631da8299f8b4,1,1,1,2,1,2014-04-07 19:09:12,2014-04-07 13:47:59
2f57736002e6a774ce5ab53a15a631da8299f8b4...ed410e611dc39dc7e845f27a660b76b7d0ecbab6,1,41,49,90,26,2014-04-07 19:09:12,2014-04-07 13:48:00
ed410e611dc39dc7e845f27a660b76b7d0ecbab6...1746ef4e9d869fb0f54194bb225604eb61a77501,2,17,15,32,13,2014-04-07 19:09:12,2014-04-07 13:48:01
1746ef4e9d869fb0f54194bb225604eb61a77501...9255f059ff0bfce7605748f62f58d6ba9055a1f3,2,11,11,22,11,2014-04-07 19:09:12,2014-04-07 13:48:02
9255f059ff0bfce7605748f62f58d6ba9055a1f3...ac1177553d8c632e93c507f8efc80b80e6c7d3d8,2,6,6,12,6,2014-04-07 19:09:12,2014-04-07 13:48:03
ac1177553d8c632e93c507f8efc80b80e6c7d3d8...191f241b528c10e242d045bde2cef70fb013a6e5,1,7,0,7,1,2014-04-07 19:09:13,2014-04-07 13:48:04
191f241b528c10e242d045bde2cef70fb013a6e5...3afcc4637452100c68b469de7757dd2b45b4d29c,2,99,63,162,23,2014-04-07 19:09:13,2014-04-07 13:48:05
3afcc4637452100c68b469de7757dd2b45b4d29c...1fbd504942b20a541ba4fcbe90d3ea21b03717e4,3,17,8,25,6,2014-04-07 19:09:13,2014-04-07 13:48:06
1fbd504942b20a541ba4fcbe90d3ea21b03717e4...ff6ee39525244b7c1bca1953743fdcc14605a031,1,7,1,8,2,2014-04-07 19:09:13,2014-04-07 13:48:07
ff6ee39525244b7c1bca1953743fdcc14605a031...726f69166ff0ac3fef0a9a0241f09a7d9f0fa48f,2,8,8,16,7,2014-04-07 19:09:14,2014-04-07 13:48:08
726f69166ff0ac3fef0a9a0241f09a7d9f0fa48f...f11b09fb60556954c6a222f4809631470c81cae6,2,28,28,56,28,2014-04-07 19:09:14,2014-04-07 13:48:09
f11b09fb60556954c6a222f4809631470c81cae6...caa4046c4f480ceae5afb20e3172a437865cc51f,2,164,0,164,4,2014-04-07 19:09:14,2014-04-07 13:48:10
caa4046c4f480ceae5afb20e3172a437865cc51f...aebfc13337e503b5a7d064cb1e9c9916f24c2baf,1,75,67,142,25,2014-04-07 19:09:14,2014-04-07 13:48:11
aebfc13337e503b5a7d064cb1e9c9916f24c2baf...b5c8ea2afb9bea910f0db5f9a4dfe58471184b3d,2,20,33,53,9,2014-04-07 19:09:14,2014-04-07 13:48:12
b5c8ea2afb9bea910f0db5f9a4dfe58471184b3d...5524e2416ec97f8c6d1a2fc12ee857efa9641175,2,10,10,20,10,2014-04-07 19:09:15,2014-04-07 13:48:13
5524e2416ec97f8c6d1a2fc12ee857efa9641175...88615910db7f700ae437318308a8631888bd28cd,1,6,9,15,5,2014-04-07 19:09:15,2014-04-07 13:48:14
88615910db7f700ae437318308a8631888bd28cd...cb198d21d3848f0c5f3d85a471a6a6793e540ca4,1,13,8,21,4,2014-04-07 19:09:15,2014-04-07 13:48:15
cb198d21d3848f0c5f3d85a471a6a6793e540ca4...81c960e4dcbd69e28b031cbe370100cb28acb911,1,19,17,36,9,2014-04-07 19:09:15,2014-04-07 13:48:16
81c960e4dcbd69e28b031cbe370100cb28acb911...84178db76f34d0b8d363545f6e18c99f6e37df4e,1,3,5,8,6,2014-04-07 19:09:15,2014-04-07 13:48:17
84178db76f34d0b8d363545f6e18c99f6e37df4e...6a402338ec9ca0369e1801533dda2108689ceaaf,1,1,4,5,5,2014-04-07 19:09:16,2014-04-07 13:48:18
25d1ac0e59f4471c3b124a0c19cad9f9511a26ad...edac360bdd35eacfb11005583aa7736d72a063bd,1,1,1,2,1,2014-04-01 18:52:37,2014-04-01 18:52:37
edac360bdd35eacfb11005583aa7736d72a063bd...d851ffb91f8c25f51b284cd4e849757d656de0d1,4,26,109,135,15,2014-04-02 21:15:36,2014-04-02 21:15:36
d851ffb91f8c25f51b284cd4e849757d656de0d1...6b869a1eeb4b5b198e7bd3e061d5b33ef84da115,1,0,5,5,1,2014-04-02 21:16:13,2014-04-01 18:55:56
3d8a54eb37d298c251c0b6823dc06935a611bc33...852a15d748034eec87adbee73a72689c8936fb8b,1,1,0,1,1,2015-02-13 20:20:25,2015-02-13 20:20:25
3d8a54eb37d298c251c0b6823dc06935a611bc33...204a8ffe67d2b789a34a14a06618a24756f7d9a9,2,4,2,6,2,2015-02-11 19:01:50,2015-02-08 16:53:53
3d8a54eb37d298c251c0b6823dc06935a611bc33...c536c0755f6450b7bcce499cfda171f8c6d1e593,3,178,1,179,8,2015-02-10 21:40:20,2015-01-29 23:35:24
c536c0755f6450b7bcce499cfda171f8c6d1e593...3c37a2e339e695c7cc41048fe0921cbc8b48b0f0,1,1,1,2,1,2015-02-10 21:41:16,2015-01-30 23:15:59
3c37a2e339e695c7cc41048fe0921cbc8b48b0f0...fdc2c3a926c21e24986677abd02c8bc568a5de32,2,21,0,21,2,2015-02-10 21:41:39,2015-01-30 23:34:13
fdc2c3a926c21e24986677abd02c8bc568a5de32...e0d201b61601e17e24ed00cc3d16e8e25ca68596,3,203,4,207,8,2015-02-10 22:19:48,2015-01-29 20:41:22
3d8a54eb37d298c251c0b6823dc06935a611bc33...e60059276b26db5760e36aa85cf1091f662430fb,1,2,3,5,4,2015-02-10 18:31:48,2015-02-09 21:28:07
3d8a54eb37d298c251c0b6823dc06935a611bc33...d306f3d3513c62342fec4e31457766f2473f9e9a,2,5,5,10,4,2015-02-05 20:38:35,2015-02-05 08:14:19
3d8a54eb37d298c251c0b6823dc06935a611bc33...8196e728955a084303e99affff2ebc1120112516,2,18,1,19,2,2015-02-02 20:35:16,2015-01-30 15:14:03
3d8a54eb37d298c251c0b6823dc06935a611bc33...ac1c2d9a2129b1ccb2e570a2cdaf8522c58f9539,1,2,1,3,1,2015-01-29 06:22:03,2015-01-28 21:17:19
2aa910084681a6cbfb0928b2d9c4d0f9ce54e1b8...5c8213a7696b3d9e29feda2516e350d03d7bd9a4,4,38,3,41,5,2014-12-17 19:18:45,2014-12-17 19:18:45
a155a5f075cdc09e584a58d68bdce0c80e6c4b5a...3e7b066e2229f45d633164beaeb8815b0973a9b4,1,2,4,6,4,2013-12-17 18:54:41,2013-12-17 13:43:58
a155a5f075cdc09e584a58d68bdce0c80e6c4b5a...0162b3c43063ad8886a6e2f5bd52110f1e7ebfaf,1,39,46,85,29,2013-12-16 17:50:42,2013-12-14 11:21:26
a155a5f075cdc09e584a58d68bdce0c80e6c4b5a...c0bc2265ef74331c0314be4a3f148e784800c3de,1,13,4,17,2,2013-12-12 20:37:36,2013-12-11 11:54:41
c0bc2265ef74331c0314be4a3f148e784800c3de...23faf546ae59d945848389070507bc418de733b6,1,32,29,61,24,2013-12-12 20:37:36,2013-12-11 11:54:42
23faf546ae59d945848389070507bc418de733b6...8d646a9bac7d64c38060e0c252fd87eba6c4d5cf,2,105,12,117,13,2013-12-12 20:37:37,2013-12-11 11:54:43
8d646a9bac7d64c38060e0c252fd87eba6c4d5cf...e374747f51736a08d048d3e227053d02b0d28735,1,29,5,34,7,2013-12-12 20:37:37,2013-12-11 11:54:44
a155a5f075cdc09e584a58d68bdce0c80e6c4b5a...141856738152d02beac5d4270a310a6007597282,2,34,0,34,4,2013-12-09 19:01:23,2013-12-06 22:05:48
141856738152d02beac5d4270a310a6007597282...62f162f8e7c28cd60f0c18f5e69933efd72659e0,1,5,1,6,4,2013-12-09 22:39:16,2013-12-06 22:07:52
a155a5f075cdc09e584a58d68bdce0c80e6c4b5a...96174145fc34c584e1e769eae455a92ebbfea735,1,4,16,20,4,2013-12-05 00:11:53,2013-12-03 13:21:40
a155a5f075cdc09e584a58d68bdce0c80e6c4b5a...9c0495d23e6999375976ca44e3812fc65b73626e,1,15,4,19,3,2013-12-05 00:10:51,2013-12-01 02:45:38
a155a5f075cdc09e584a58d68bdce0c80e6c4b5a...c57f6281ff847db7094d708f5c5b939d378f7120,2,45,7,52,9,2013-12-04 19:49:15,2013-12-03 08:32:04
1649612a227eaa5af7cb0e2d059728c0148485d9...74b4f7f27736f3e196a4eb3db41c68e37a6e2160,2,18,1,19,2,2014-01-23 21:03:00,2014-01-23 13:22:05
a890c998de36b8460267b42779bbe34bad9c36d7...0ce2e396ee9fb0fa07e8381b338e49859dbf03db,3,6,10,16,3,2012-06-17 21:07:15,2012-06-17 21:07:15
dd3d0711825aae4c8fcec1e277f0581a4fa2ab6c...a1a031d9356cc89cadc5e14acc4028e3ecc306eb,2,15,12,27,9,2012-06-07 16:14:41,2012-06-07 16:14:41
0577c59af804d78ef8b8125087e592580dacdf6f...6b149cee20cfa6f525964cdf1f386b47894fd758,1,18,33,51,7,2012-09-12 21:37:07,2012-09-12 21:33:50
e2c7a5b646bb9a4f126577346697d79b3143d30b...9376c8603fc1f9b5bf663b76705dfee77f71ef82,2,19,1,20,2,2012-10-02 20:44:59,2012-10-02 20:44:59
83379df0251243b5e1f328598bfdd39327766df3...6ef59319438ba89bf2979baa86fdb9bd1922f659,1,1,1,2,1,2012-09-18 03:58:36,2012-09-18 01:28:07
6ef59319438ba89bf2979baa86fdb9bd1922f659...fcc5ef1cc90ed49400bef51d306216f290eab9cc,1,20,11,31,3,2012-09-18 03:58:55,2012-09-18 01:28:08
fcc5ef1cc90ed49400bef51d306216f290eab9cc...eb9a7cb4bdbd4ea9c7e7ef2ca8de5b2753e3584c,3,32,3,35,8,2012-09-18 03:59:14,2012-09-18 01:28:09
eb9a7cb4bdbd4ea9c7e7ef2ca8de5b2753e3584c...9f4981bac6f492d332785b8ed03f33a167952f38,1,18,0,18,1,2012-09-18 03:59:18,2012-09-18 01:28:10
9f4981bac6f492d332785b8ed03f33a167952f38...9c8e1011b9f6979777946ff87aae7b5846ed20a7,1,3,2,5,3,2012-09-19 19:52:10,2012-09-19 06:43:54
83379df0251243b5e1f328598bfdd39327766df3...6d45eb1720294a93e571e843efb851fee70ac5e1,3,15,5,20,8,2012-09-17 22:42:57,2012-09-17 21:16:39
6d45eb1720294a93e571e843efb851fee70ac5e1...98c573a902d47722b062579c5a9d9e661b4263e4,1,6,2,8,2,2012-09-17 22:43:20,2012-09-17 21:18:27
98c573a902d47722b062579c5a9d9e661b4263e4...32fde6575e4139710ea5259ee9b7c750b7c2dde0,1,1,1,2,1,2012-09-17 22:43:44,2012-09-17 21:23:17
32fde6575e4139710ea5259ee9b7c750b7c2dde0...a6772946a554ad97ea4f6febbff3b98fbaa2f5bf,1,4,0,4,1,2012-09-17 22:44:20,2012-09-17 21:24:42
83379df0251243b5e1f328598bfdd39327766df3...f50fee4a0476dfd1315612f49244e7050280bf68,2,5,4,9,5,2012-09-16 05:58:20,2012-09-15 20:56:07
f50fee4a0476dfd1315612f49244e7050280bf68...82a75299fa63a388a9a4823bcb687e50964d95fb,2,5,3,8,3,2012-09-16 05:58:20,2012-09-15 20:58:15
82a75299fa63a388a9a4823bcb687e50964d95fb...d2aea1371bc240a55f0b3c2265171a16ee023f2e,2,1,2,3,2,2012-09-16 05:58:20,2012-09-15 20:59:59
d2aea1371bc240a55f0b3c2265171a16ee023f2e...ba35480439d05b8f6cca50527072194fe3278bbb,2,30,29,59,5,2012-09-16 05:58:20,2012-09-15 21:02:52
ba35480439d05b8f6cca50527072194fe3278bbb...7e0d4ab585bb8bd4dba722c96e811a02b6c2fdda,2,1,2,3,2,2012-09-16 05:58:20,2012-09-15 21:06:00
7e0d4ab585bb8bd4dba722c96e811a02b6c2fdda...96531a5ede7ede4397eb190411bc20256bca3e93,2,12,16,28,2,2012-09-16 05:58:20,2012-09-15 21:08:39
96531a5ede7ede4397eb190411bc20256bca3e93...72f3196a2db0f58b24acd2f9369c7f97d0d770d5,2,5,4,9,5,2012-09-16 05:58:21,2012-09-16 05:38:28
72f3196a2db0f58b24acd2f9369c7f97d0d770d5...69850be47d1b629543a2c45e8dd254729c5676af,3,1,5,6,3,2012-09-16 05:58:21,2012-09-16 05:39:43
69850be47d1b629543a2c45e8dd254729c5676af...ea03a8e181261b5efda10376ff160dc8df084104,2,2,15,17,4,2012-09-16 05:58:21,2012-09-16 05:43:15
ea03a8e181261b5efda10376ff160dc8df084104...357e9c69c9069b2764d1b58d0074945f8a33ff09,2,1,2,3,2,2012-09-16 05:58:21,2012-09-16 05:44:31
357e9c69c9069b2764d1b58d0074945f8a33ff09...1e24845cc2265b616517aeb54fbe978f5ac0fa61,2,2,4,6,2,2012-09-16 05:58:21,2012-09-16 05:46:26
1e24845cc2265b616517aeb54fbe978f5ac0fa61...cbfb93a12b7f60dcd0f5a0cd3f5f37ee694ecd3a,2,1,2,3,2,2012-09-16 05:58:21,2012-09-16 05:47:42
cbfb93a12b7f60dcd0f5a0cd3f5f37ee694ecd3a...dad148c35975923c7a13058c20e01bb587ace4ef,2,2,4,6,4,2012-09-16 05:58:21,2012-09-16 05:50:09
dad148c35975923c7a13058c20e01bb587ace4ef...250f2492a408be1ed79c563f304a0d43752d032c,2,1,4,5,2,2012-09-16 06:20:40,2012-09-16 06:20:40
d25c58ce43f45734ef74595b1e6fba1199651699...ef6fd72b6ce18b5be694f39b37d30d4cdc6bfd2a,1,70,0,70,1,2012-10-16 23:16:20,2012-10-14 05:42:14
ef6fd72b6ce18b5be694f39b37d30d4cdc6bfd2a...39b6a4bd25b6e4e54c1d12028ad79e16a2cfc528,1,5,33,38,4,2012-10-16 23:16:21,2012-10-14 05:42:15
39b6a4bd25b6e4e54c1d12028ad79e16a2cfc528...196e48f4d0bac31f4a56b7dc4816f813cc17ad13,1,42,4,46,9,2012-10-16 23:16:21,2012-10-14 05:42:16
196e48f4d0bac31f4a56b7dc4816f813cc17ad13...d8574ff209d9c68674bd6ba3bcee4a7cdb699e61,1,4,0,4,1,2012-10-16 23:16:22,2012-10-14 05:42:17
d8574ff209d9c68674bd6ba3bcee4a7cdb699e61...a86c0983d4cc49ac540141d1fcd51596f062ff15,1,4,32,36,4,2012-10-16 23:16:23,2012-10-14 05:42:18
a86c0983d4cc49ac540141d1fcd51596f062ff15...566c69e7156c0d14a655d86f38a130355e084327,1,4,1,5,2,2012-10-16 23:16:23,2012-10-14 05:42:19
566c69e7156c0d14a655d86f38a130355e084327...4d804c0e64d50e0a9b7b5af7f93b50a5659b1ffc,1,159,61,220,28,2012-10-16 23:16:24,2012-10-14 05:42:20
4d804c0e64d50e0a9b7b5af7f93b50a5659b1ffc...ab07681fed75f3810f6c1fca526b763a88d2ba94,2,123,104,227,70,2012-10-16 23:16:26,2012-10-14 05:42:21
ab07681fed75f3810f6c1fca526b763a88d2ba94...bed8a19743f0ae3f92fd6ad5293bb80b587c9279,1,0,2,2,1,2012-10-16 23:16:26,2012-10-14 05:42:22
bed8a19743f0ae3f92fd6ad5293bb80b587c9279...abd66f2207f4ed3ef54b526004120a9f0eddf67a,2,55,4,59,4,2012-10-16 23:16:27,2012-10-14 05:42:23
d25c58ce43f45734ef74595b1e6fba1199651699...cc91a85ec70bdca1f8e88781885610cf70c22fd8,1,4,1,5,1,2012-10-16 23:09:09,2012-10-16 17:20:10
cc91a85ec70bdca1f8e88781885610cf70c22fd8...9fa9728e2c0e7e52e4ff658f60323d494449e412,1,2,2,4,2,2012-10-16 23:09:09,2012-10-16 17:21:57
9fa9728e2c0e7e52e4ff658f60323d494449e412...368dc5d6ae892152b29a7f9b0c282971d398083c,1,2,2,4,1,2012-10-16 23:09:09,2012-10-16 17:23:08
368dc5d6ae892152b29a7f9b0c282971d398083c...5316c8e9399dacd9e0f7c22132f3ad67186408ed,5,34,27,61,10,2012-10-16 23:09:09,2012-10-16 17:24:16
5316c8e9399dacd9e0f7c22132f3ad67186408ed...1797e5c50c00b514b798f7b0441c86ee71fb0fab,11,68,34,102,27,2012-10-18 17:51:34,2012-10-16 17:25:29
1797e5c50c00b514b798f7b0441c86ee71fb0fab...5e00439f0a522c6f240791b0d105a17e0dde3247,1,24,2,26,4,2012-10-25 09:38:14,2012-10-23 17:58:04
3d0a2d654fb080ef976096c4aaf33375cd344264...87a5461fa7b30f7b7baf27204f10219d61500fbf,2,4,5,9,4,2012-10-17 17:39:44,2012-10-17 17:39:44
1b77d83cab798668d8a54a05b3fa0262486f7dfc...7ec30aaa5ba2a71287879d7bd9a5c55363ea1bbe,3,52,16,68,12,2013-02-22 19:37:34,2013-02-20 09:09:24
1b77d83cab798668d8a54a05b3fa0262486f7dfc...059b37934c611b1b9b735e0310ba282a0c7f5eba,5,0,86,86,6,2012-10-29 06:34:58,2012-10-28 16:16:27
e1b6ff44d61bcdd91280c3f7c3c5ace32d4b7c52...4656bf47fca857df51b5d6f4b7b052192b3b2317,8,59,17,76,24,2013-02-04 18:22:36,2013-01-31 21:02:07
4656bf47fca857df51b5d6f4b7b052192b3b2317...af3aec4469f91dcd34d60706a1addfedbb84ece5,1,1,2,3,2,2013-02-05 00:21:42,2013-02-05 00:21:42
af3aec4469f91dcd34d60706a1addfedbb84ece5...3443db51a0f2a43061d4badc6a0065672386eae5,1,1,0,1,1,2013-02-06 15:50:56,2013-02-06 10:39:52
e1b6ff44d61bcdd91280c3f7c3c5ace32d4b7c52...bd4a3d616894c009a4500395e016ee8f0d4751a6,5,23,7,30,8,2013-02-01 22:12:34,2013-01-31 21:59:50
5543501ced8e3303b7612b068831a111af0ab8b7...a3935e6791c619a9f2f472e9e553d45d88c4e263,1,19,50,69,4,2012-05-07 20:39:38,2012-05-07 20:39:38
341d9a48cc4a6993f952c5c13417ba88227ef427...ef0065034a68edfc0ffed9965bb895073ad710db,1,1,0,1,1,2010-02-14 11:04:20,2010-02-14 09:56:46
fc4b10cd2dd4f23443d1c639b9c38a604fff3aa3...a004fb923d74c1d5500d493506b1462eb04cf017,1,1,0,1,1,2010-01-30 03:37:54,2010-01-23 14:20:28
a004fb923d74c1d5500d493506b1462eb04cf017...947c3464e49522c55296a8191aed7946bd0f4308,2,94,15,109,14,2010-01-30 03:42:40,2010-01-29 23:54:05
bcc9b7427d9f720127479bb603159de89c93f872...fb423da0e5668f3945c5a3e34fe5953cde6985a4,1,4,9,13,3,2009-10-19 06:00:02,2009-10-17 16:30:48
46148dd7ea41de10fc784c247924f73ddb21121b...619a644d6daef56d70aeca85514e2d281eb483a5,4,74,3,77,6,2009-10-18 19:34:56,2009-10-18 19:34:56
619a644d6daef56d70aeca85514e2d281eb483a5...61dfa1bb6710690e53fa20bc3ddd1f5fbe8c1d22,1,18,1,19,2,2009-11-21 17:22:55,2009-11-20 11:02:44
61dfa1bb6710690e53fa20bc3ddd1f5fbe8c1d22...9f21e97ddccf114a6919cf4b8cf57c2838328f36,2,94,14,108,4,2010-01-07 19:14:39,2010-01-07 11:05:02
9f21e97ddccf114a6919cf4b8cf57c2838328f36...230a4566382860fc26a3f8d578a41c6504cf865f,2,50,1,51,3,2010-01-07 19:15:20,2010-01-07 11:05:09
fb3650ed100a549f80d822f28ccf0f82e9f75f3e...5bdc32d3e50d8335c65e136e6b5234c5dd92a7a9,1,17,10,27,8,2009-09-26 19:51:04,2009-09-26 03:54:42
5bdc32d3e50d8335c65e136e6b5234c5dd92a7a9...6bbfd1fa98b0c1fa1684bd35e64404799f0cc2b3,3,28,0,28,5,2009-09-29 14:28:47,2009-09-25 18:44:44
6bbfd1fa98b0c1fa1684bd35e64404799f0cc2b3...1b018fd9be290fd6a70ce3093ab1dc1abce74e00,3,24,7,31,7,2009-09-29 15:14:47,2009-09-26 23:15:09
1b018fd9be290fd6a70ce3093ab1dc1abce74e00...42a0ea94ce661a069f0622f6c01d1d1f21cbbc18,1,1,1,2,1,2009-09-29 15:26:43,2009-09-28 08:25:55
42a0ea94ce661a069f0622f6c01d1d1f21cbbc18...c9486ae847d346da44f3bd1aa964520a52d48e2a,1,1,1,2,1,2009-09-29 15:27:45,2009-09-28 14:56:00
c9486ae847d346da44f3bd1aa964520a52d48e2a...0484682ef326db0d3b99e71f6ca4551d0f5a4609,1,1,1,2,1,2009-09-29 15:30:13,2009-09-29 05:42:25
0484682ef326db0d3b99e71f6ca4551d0f5a4609...6f798b9590ca3a26d6c8e9318929eefef9b640f2,1,4,4,8,4,2009-09-29 15:53:51,2009-09-28 10:46:52
6f798b9590ca3a26d6c8e9318929eefef9b640f2...76031f191e5ea340f0a1501125891ae0fed76ff7,1,4,1,5,4,2009-09-29 15:54:37,2009-09-28 11:34:20
76031f191e5ea340f0a1501125891ae0fed76ff7...e0ab002b5093e87f06871d7e25ac03e26841d355,1,11,31,42,7,2009-09-29 15:54:37,2009-09-28 11:34:21
e0ab002b5093e87f06871d7e25ac03e26841d355...1be224ba6e99f0ab34c998d7fa8023b76a15c8b6,1,4,2,6,1,2009-09-29 16:40:55,2009-09-29 06:40:08
fb3650ed100a549f80d822f28ccf0f82e9f75f3e...6900d750f4894e7bee714874c04cc14312cd91ec,1,1,1,2,1,2009-09-25 22:35:05,2009-09-25 15:14:31
6900d750f4894e7bee714874c04cc14312cd91ec...fa9d3485ead15387fd76a35284bd3ffb32d7c6c7,1,1,1,2,1,2009-09-25 22:35:05,2009-09-25 16:43:20
814035c12a07927ea03350184a14f869cdce7276...29981380d03ffa63765dbeaea53a7ac9e8d6bc4f,2,20,2,22,2,2010-07-07 18:11:50,2010-07-06 14:46:05
433f2be139710e2fc7c0693a8411b2773f1a4b38...c49904efb55172e8da0abdc8ba3222ce7507e936,1,1,1,2,1,2011-11-07 05:16:34,2011-11-07 03:36:57
1a56be134f9477296a7ade040e8b802bf3a643a1...163f3925902446735b2f631dc44ab67882a93024,1,20,46,66,11,2009-12-07 07:01:48,2009-12-07 04:22:58
163f3925902446735b2f631dc44ab67882a93024...0205e72f088322a70a77643a7cd2d8b23ee07e14,4,77,18,95,12,2009-12-07 21:50:57,2009-12-07 09:20:59
1a56be134f9477296a7ade040e8b802bf3a643a1...0f6927c2296d6f92f3f233fe9e073c30ca66e0ce,1,75,40,115,5,2009-12-05 00:08:53,2009-12-04 17:06:54
0f6927c2296d6f92f3f233fe9e073c30ca66e0ce...07cd9328b6256d3fdc05546e10c589144b5c63c5,1,51,42,93,13,2009-12-05 00:08:54,2009-12-04 17:06:55
07cd9328b6256d3fdc05546e10c589144b5c63c5...f963bd5d71fd0db01f2c7f6f05df5a5f1af11b82,3,133,0,133,7,2009-12-05 00:08:55,2009-12-04 17:06:56
f963bd5d71fd0db01f2c7f6f05df5a5f1af11b82...9c8398f0c9d1fc92df5c1a7a52c810294d8ac3f8,2,94,25,119,16,2009-12-05 00:10:22,2009-12-04 17:06:57
9c8398f0c9d1fc92df5c1a7a52c810294d8ac3f8...2792f26c3e93c268732957b71c0390a1efe14d7e,1,36,1,37,2,2009-12-05 00:10:39,2009-12-04 17:06:58
2792f26c3e93c268732957b71c0390a1efe14d7e...081751c882f8398081b94335faa23912a655fb1c,3,45,6,51,12,2009-12-05 00:10:59,2009-12-04 17:06:59
081751c882f8398081b94335faa23912a655fb1c...bc3c79aefc9cdb1127e1dfd22ad19cf6c6e94f09,3,58,2,60,8,2009-12-05 20:43:24,2009-12-04 17:07:00
1a56be134f9477296a7ade040e8b802bf3a643a1...cb6020bb017405cc3e7f1faea6f30d4fd1b62e70,12,77,18,95,30,2009-12-04 08:20:48,2009-12-04 08:20:48
0adc030615fbec4ca20b5fe0b61ed118e82122dc...2cf6b4bfec068cf24bdc3e4d46ad233091471a02,1,1,1,2,1,2009-10-24 05:38:44,2009-10-24 05:38:44
ee50af1566e78354c1a2d0feea2115b99a535d9d...7f98ebc8fd34107c6234cbad7b776054810b6fe1,2,2,2,4,2,2009-10-19 07:48:59,2009-10-16 05:59:41
0a0c342568458a15528778db1480dbbaa9a0b4d9...cfe370c6476392095bc3f18013d195b1cccd6184,2,67,1,68,2,2009-10-17 06:47:47,2009-10-16 14:13:25
bf8fc21c69559684b81669ab929db2ff1f37b3d7...dc3c7a7256ed05a14baaffbc35c016f7ffde51c5,1,10,6,16,4,2009-10-09 06:59:15,2009-10-09 06:59:15
78d553b7d7b269bb22ebd8b1198657c37484a3a0...81f45e7dc4e930ffc17dce3e377e6adc3eb3d8de,1,29,9,38,5,2010-02-17 06:53:33,2010-02-09 22:30:49
81f45e7dc4e930ffc17dce3e377e6adc3eb3d8de...1e7ef746d3a635742690817fefe00b66a044dfe5,2,10,0,10,2,2010-02-17 06:53:40,2010-02-09 22:30:48
78d553b7d7b269bb22ebd8b1198657c37484a3a0...b81e00a965c62ca72a4b9db425ee173de147808d,1,6,0,6,2,2009-12-01 20:45:34,2009-12-01 00:23:50
78d553b7d7b269bb22ebd8b1198657c37484a3a0...264b774ba6b27cc07ef4c33d52e491d9abf029bb,2,21,13,34,4,2009-11-30 07:52:31,2009-11-29 12:18:32
264b774ba6b27cc07ef4c33d52e491d9abf029bb...e2ced7de19c85f3b246480bfacdcc934c98c08ca,1,1,0,1,1,2009-11-30 07:52:40,2009-11-29 12:18:33
78d553b7d7b269bb22ebd8b1198657c37484a3a0...ed87465658c83a5a1617920e7b605bd830a78aed,1,1,1,2,2,2009-11-30 02:49:11,2009-11-26 02:23:54
78d553b7d7b269bb22ebd8b1198657c37484a3a0...382da4023f155eabdda58ebd595a1e142408a56d,1,2,1,3,1,2009-11-27 05:16:54,2009-11-26 19:11:59
382da4023f155eabdda58ebd595a1e142408a56d...7e93d3b9e58a359a1073460e8f2cb3fef0368bd7,1,5,0,5,1,2009-11-27 05:23:55,2009-11-26 19:12:00
78d553b7d7b269bb22ebd8b1198657c37484a3a0...79f7ca063d6b74e9d7f3db90c85dfa4a162128e4,2,39,9,48,7,2009-11-25 23:36:54,2009-11-25 19:33:28
78d553b7d7b269bb22ebd8b1198657c37484a3a0...7b1042292d5dc18508213c3be888b740d02f02e3,1,6,7,13,3,2009-11-23 23:38:04,2009-11-23 23:29:17
7b1042292d5dc18508213c3be888b740d02f02e3...e1622bfcbad680225ad5c337e4778df88389227e,8,26,18,44,17,2009-11-24 00:31:07,2009-11-23 23:56:32
78d553b7d7b269bb22ebd8b1198657c37484a3a0...4c371f91270792791f867d15f25b03f800ab35a1,4,14,1,15,7,2009-11-23 00:07:27,2009-11-22 22:26:17
4c371f91270792791f867d15f25b03f800ab35a1...e63ec003b2a0c89f0c1cbc4862dcef7c4a14a785,1,18,2,20,2,2009-11-23 00:07:28,2009-11-22 22:26:18
78d553b7d7b269bb22ebd8b1198657c37484a3a0...4f333bc1d32a84c9ddad737ccdbd6e99ed05d396,1,17,0,17,1,2009-11-22 20:08:44,2009-11-22 17:54:10
4f333bc1d32a84c9ddad737ccdbd6e99ed05d396...c89e32414516e906520e9bdd809560971eb52ef5,3,24,4,28,3,2009-11-28 07:45:24,2009-11-26 19:04:29
78d553b7d7b269bb22ebd8b1198657c37484a3a0...382e54312220ac02586a3cbb06b0e4eb7789f043,1,115,0,115,1,2009-11-21 07:39:58,2009-11-12 19:46:04
78d553b7d7b269bb22ebd8b1198657c37484a3a0...d25e51596be9271ad833805a3d6f9012dc24ee79,16,122,5,127,24,2009-11-21 07:14:02,2009-11-20 16:12:47
78d553b7d7b269bb22ebd8b1198657c37484a3a0...4504107d5ef6a8840aaf278e63722bf4efbf722e,2,52,21,73,21,2009-11-21 06:15:30,2009-11-20 23:43:13
78d553b7d7b269bb22ebd8b1198657c37484a3a0...756078749f7a87bc50d4c22db18e26a09c45059d,1,1,0,1,1,2009-11-20 07:41:29,2009-11-19 18:46:24
78d553b7d7b269bb22ebd8b1198657c37484a3a0...81f40262a491cd0429ca88476365a7ccedb78684,1,1,1,2,1,2009-11-20 07:01:09,2009-11-19 18:41:20
78d553b7d7b269bb22ebd8b1198657c37484a3a0...395de250d9d9762b8ac1ce98b297d60d0b5bd643,5,63,37,100,14,2009-11-18 05:53:11,2009-11-17 17:24:25
395de250d9d9762b8ac1ce98b297d60d0b5bd643...df2a79f4225b7216dce010ebfe41f8ad0de34b24,2,14,8,22,3,2009-11-19 18:01:12,2009-11-19 15:21:15
df2a79f4225b7216dce010ebfe41f8ad0de34b24...0f7fb21a7aec7ab8047536af018daa981b3b2676,1,3,3,6,2,2009-11-21 08:37:26,2009-11-21 08:37:26
78d553b7d7b269bb22ebd8b1198657c37484a3a0...eaa4e6ee2a1df289e6900ee908751463b22a3a54,1,41,35,76,18,2009-11-18 05:35:15,2009-11-18 00:49:10
78d553b7d7b269bb22ebd8b1198657c37484a3a0...be38ca3d19be50be447e1c5952f53fa70bf21a1c,4,5,4,9,5,2009-11-17 16:37:03,2009-11-17 08:42:39
78d553b7d7b269bb22ebd8b1198657c37484a3a0...ff68668695486b72b5f06146eddf85b70841088a,1,4,3,7,1,2009-11-17 06:32:05,2009-11-14 18:35:00
78d553b7d7b269bb22ebd8b1198657c37484a3a0...3ea6025e172273e1bf237dff366c0cc19cdacbf1,1,87,2,89,2,2009-11-17 05:35:26,2009-11-14 04:34:07
3ea6025e172273e1bf237dff366c0cc19cdacbf1...61fdbcf98b4564ee00d5005bb99f871863d457e7,1,40,60,100,6,2009-11-18 05:58:12,2009-11-14 04:34:08
78d553b7d7b269bb22ebd8b1198657c37484a3a0...5183bf67278ce5a0da9779d74f05169beac219b8,4,27,6,33,11,2009-11-17 00:06:46,2009-11-06 09:22:35
78d553b7d7b269bb22ebd8b1198657c37484a3a0...f4f19fb63449e1beee02b0ec845319f7115fa9d0,1,4,0,4,2,2009-11-16 21:21:11,2009-11-16 15:56:25
f4f19fb63449e1beee02b0ec845319f7115fa9d0...8282de94bc76360e0bf76da4076755696b049d23,1,3,3,6,2,2009-11-16 21:21:12,2009-11-16 16:02:02
8282de94bc76360e0bf76da4076755696b049d23...809809bb75e8a65ef543ab706aab4791459be95c,1,5,2,7,3,2009-11-21 06:13:47,2009-11-21 06:13:47
78d553b7d7b269bb22ebd8b1198657c37484a3a0...d4cbaa12a774a97dfa9e99aad9188dc802469bb6,1,3,2,5,1,2009-11-15 20:26:08,2009-11-15 18:25:30
d4cbaa12a774a97dfa9e99aad9188dc802469bb6...31ddd1ee0fdd0a03001994d362023a04d8231eb0,1,13,3,16,2,2009-11-17 06:10:34,2009-11-15 18:25:31
78d553b7d7b269bb22ebd8b1198657c37484a3a0...997c2a45ecf55a8f8bc6fe78a0abc319e23a62d1,1,1,1,2,1,2009-11-15 20:24:46,2009-11-15 19:46:25
78d553b7d7b269bb22ebd8b1198657c37484a3a0...a96e9c286a897637e7aa84f6b10cf99c367317ce,1,4,1,5,1,2009-11-14 23:52:39,2009-11-11 21:59:52
78d553b7d7b269bb22ebd8b1198657c37484a3a0...b31222cfb7f2fcdc5b3d76ce5fcebf6ff1929826,3,777,41,818,3,2009-11-13 20:07:21,2009-11-04 05:58:23
78d553b7d7b269bb22ebd8b1198657c37484a3a0...2c1d2d818895d896f706835142a75978aabdbdc9,1,15,7,22,4,2009-11-13 19:26:43,2009-11-11 08:53:46
2c1d2d818895d896f706835142a75978aabdbdc9...f2f3a6b802e3dae09a1c414cd8516ff2a546a527,3,43,6,49,7,2009-11-13 19:26:43,2009-11-10 21:04:51
78d553b7d7b269bb22ebd8b1198657c37484a3a0...035b76b03f63e077e3465a99bee5dffa29822344,1,2,4,6,2,2009-11-09 01:58:42,2009-10-27 19:11:55
78d553b7d7b269bb22ebd8b1198657c37484a3a0...1d46f2ea143534e46e6bfee3f34cd90b734bfe80,2,28,2,30,4,2009-11-09 01:01:36,2009-11-04 07:19:40
78d553b7d7b269bb22ebd8b1198657c37484a3a0...c30eb852e281d55b04465b7814e00396893f74f3,1,9,9,18,3,2009-11-07 07:48:09,2009-11-05 10:57:57
78d553b7d7b269bb22ebd8b1198657c37484a3a0...b9759f0762c17a5b7bc36af98613c67249931330,1,2,1,3,1,2009-11-06 17:56:34,2009-11-06 15:08:41
78d553b7d7b269bb22ebd8b1198657c37484a3a0...168eff3c802a47a4e8a97b2ec70d86e5f605a012,1,20,0,20,1,2009-10-30 16:42:52,2009-10-28 12:24:30
168eff3c802a47a4e8a97b2ec70d86e5f605a012...a4ca1465ec8afee798bf8f11d727179ca3da64a9,2,7,1,8,2,2009-10-30 16:42:56,2009-10-29 10:45:03
a4ca1465ec8afee798bf8f11d727179ca3da64a9...76fd28283f7eeea246a06994edd43ab60e59d853,1,12,14,26,4,2009-10-31 21:25:15,2009-10-30 17:09:06
78d553b7d7b269bb22ebd8b1198657c37484a3a0...ad3f9a71a8200418e1da59b9712a8fde3f8c4c08,4,32,1,33,7,2009-10-28 23:07:43,2009-10-27 18:28:07
78d553b7d7b269bb22ebd8b1198657c37484a3a0...24ab81ae4d12c81076da256b3f9cdde45277f126,2,30,5,35,7,2009-10-28 06:19:04,2009-10-28 00:52:57
78d553b7d7b269bb22ebd8b1198657c37484a3a0...9f67d2e8279e1885ef2b4681c19cef8534259783,3,44,1,45,12,2009-10-27 19:46:22,2009-10-21 13:35:22
78d553b7d7b269bb22ebd8b1198657c37484a3a0...2aae905f23f79f004625346d057e5be7a81dbcd4,1,1,2,3,3,2009-10-26 02:25:47,2009-10-25 19:15:22
78d553b7d7b269bb22ebd8b1198657c37484a3a0...a75d7b54097ef0d0945cbe673a9940d6c561f95c,35,71,71,142,70,2009-10-25 06:50:28,2009-10-24 08:31:32
78d553b7d7b269bb22ebd8b1198657c37484a3a0...a5ca8367c223b154b485ea51dc8c97201498caa4,1,6,0,6,2,2009-10-22 00:16:58,2009-10-20 03:06:28
78d553b7d7b269bb22ebd8b1198657c37484a3a0...550c66f3f9c8b2106ecca19c267c6e7e019e3cb9,1,13,13,26,11,2009-10-22 00:16:08,2009-10-20 20:38:38
78d553b7d7b269bb22ebd8b1198657c37484a3a0...2a94552887ecbaa8b848a92eb607e032d77c8a2c,1,4,1,5,2,2009-10-22 00:15:43,2009-10-20 10:29:32
78d553b7d7b269bb22ebd8b1198657c37484a3a0...dad5f89fc568639c43bdbf344411757adf39d636,1,7,4,11,1,2009-10-21 22:28:42,2009-10-21 22:26:10
dad5f89fc568639c43bdbf344411757adf39d636...77e3efbf43a1060049121350cc3ae8c208e77d57,2,29,0,29,5,2009-10-21 22:32:32,2009-10-20 21:56:40
78d553b7d7b269bb22ebd8b1198657c37484a3a0...6b276e19fa71fabe64039cf004aba908d7083e82,1,24,24,48,5,2009-10-21 22:12:01,2009-10-21 20:07:49
78d553b7d7b269bb22ebd8b1198657c37484a3a0...d504f6975d34025ed3b5478b657789410b52cdb1,3,66,45,111,5,2009-10-21 21:20:50,2009-10-21 17:21:23
78d553b7d7b269bb22ebd8b1198657c37484a3a0...a97a74686d70a318cd802003498054cc1e8b0ae2,9,108,0,108,12,2009-10-20 01:59:42,2009-10-09 10:21:57
a97a74686d70a318cd802003498054cc1e8b0ae2...65d9fb487f36d4a12a169dc18cbbb5225337c085,6,236,0,236,6,2009-10-20 01:59:42,2009-10-09 10:21:58
65d9fb487f36d4a12a169dc18cbbb5225337c085...fd53c9eb445815696bf84c4701b9af73b5d7f50d,1,102,10,112,5,2009-10-20 01:59:42,2009-10-09 10:21:59
fd53c9eb445815696bf84c4701b9af73b5d7f50d...a5b0c24f3e9a29f8fe496f49db82f2e3f1b687ce,1,98,0,98,1,2009-10-20 01:59:42,2009-10-09 10:22:00
a5b0c24f3e9a29f8fe496f49db82f2e3f1b687ce...d9246d4303f441c0e30614cd3a97a80fbe9354b6,3,107,9,116,9,2009-10-20 01:59:43,2009-10-09 10:22:01
d9246d4303f441c0e30614cd3a97a80fbe9354b6...a8dd2e7d2bd7472b4e02b07aeef795de9c74f3e7,3,289,10,299,12,2009-10-20 02:00:24,2009-10-09 10:22:02
a8dd2e7d2bd7472b4e02b07aeef795de9c74f3e7...3ed24b6aaf35d6ca1eef2643cd0b9128eb152cda,1,47,27,74,5,2009-10-20 02:00:24,2009-10-09 10:22:03
3ed24b6aaf35d6ca1eef2643cd0b9128eb152cda...c56fcc89b951f3e8c9240ea02676b2eef5417da6,3,11,5,16,6,2009-10-20 02:00:24,2009-10-09 10:22:04
c56fcc89b951f3e8c9240ea02676b2eef5417da6...8b208f0213ed349ecb2ab8f7bb6c5072f8011a70,2,5,0,5,2,2009-10-20 02:00:24,2009-10-09 10:22:05
8b208f0213ed349ecb2ab8f7bb6c5072f8011a70...27d57564102a98950bf4398daeeb14a15154478f,2,10,0,10,2,2009-10-20 02:00:24,2009-10-09 10:22:06
27d57564102a98950bf4398daeeb14a15154478f...23123aecf8418a6b0ec23378555ed78c438ae894,1,248,69,317,22,2009-10-20 02:00:24,2009-10-09 10:22:07
23123aecf8418a6b0ec23378555ed78c438ae894...0057c0917d35f9f21e01f2122e7f2b9f169a8b02,1,104,0,104,1,2009-10-20 02:00:24,2009-10-09 10:22:08
0057c0917d35f9f21e01f2122e7f2b9f169a8b02...ef8db638cc96abaf166bbafe31752219f3d2cdc2,1,161,82,243,22,2009-10-20 02:00:24,2009-10-09 10:22:09
ef8db638cc96abaf166bbafe31752219f3d2cdc2...a099469bbcf273e76d81573229971956b4ef0700,1,84,0,84,1,2009-10-20 02:00:24,2009-10-09 10:22:10
78d553b7d7b269bb22ebd8b1198657c37484a3a0...6b87ce231d14b3804974fba27576f1f2ba77cfb0,2,21,10,31,5,2009-10-14 06:19:02,2009-10-13 21:02:24
78d553b7d7b269bb22ebd8b1198657c37484a3a0...b0fa7ab51b29d34579d8f6bb4443dfbcb8278c7a,4,36,2,38,7,2009-10-13 08:07:29,2009-10-12 20:30:32
78d553b7d7b269bb22ebd8b1198657c37484a3a0...58a05c74e7a9341af80eb98731d6b0dafe1b5c29,1,44,0,44,1,2009-10-12 23:24:25,2009-10-12 05:27:04
58a05c74e7a9341af80eb98731d6b0dafe1b5c29...38eedc634bc5d30e8a7a2356d9eb3ae95d9b1d75,3,46,6,52,6,2009-10-12 23:39:59,2009-10-12 23:39:43
38eedc634bc5d30e8a7a2356d9eb3ae95d9b1d75...1ba447b8dc2ec4e6c8ebbbdaa449f38edc29ad3f,1,23,2,25,2,2009-10-13 05:19:35,2009-10-12 05:33:01
78d553b7d7b269bb22ebd8b1198657c37484a3a0...3240269dd9038ea12eb2f19a4be1218d6320a548,1,1,0,1,1,2009-10-12 04:52:22,2009-10-11 21:08:25
3240269dd9038ea12eb2f19a4be1218d6320a548...2775d92c53d7b00758fa98e4ad8bce1e59445b05,1,1,1,2,1,2009-10-12 04:54:44,2009-10-11 20:46:11
2775d92c53d7b00758fa98e4ad8bce1e59445b05...17225c49d501a304a0ae9ff370ca5cc3ae4afe4d,1,2,1,3,1,2009-10-12 23:13:19,2009-10-12 09:00:09
17225c49d501a304a0ae9ff370ca5cc3ae4afe4d...77abcbdc268d048b7a19af405607fb8d14e630ed,3,3,2,5,3,2009-10-12 23:22:35,2009-10-12 20:34:12
8fd2cfa7accd6b8f877014bf3e4bf8547b8e0d2a...c03c1f798d5f865331428e88c7d19b15471d25a8,1,9,2,11,1,2009-10-09 08:31:05,2009-10-09 07:01:04
8fd2cfa7accd6b8f877014bf3e4bf8547b8e0d2a...817350d3af9e1227c737e47ff79f65f0373b31d6,1,2,0,2,2,2009-10-09 05:54:09,2009-10-08 23:07:41
817350d3af9e1227c737e47ff79f65f0373b31d6...651aef3428d9688e3fdffc6760380ead47debb9f,1,12,0,12,2,2009-10-09 05:55:25,2009-10-09 00:09:37
94702dd1ac27618b60198f7c8bceafaaaf7743e2...1b86bbb0ade4641c2da0dc74ebca1c09ec772bb4,2,48,0,48,2,2013-01-23 16:41:49,2013-01-23 06:23:05
1b86bbb0ade4641c2da0dc74ebca1c09ec772bb4...785a04298177e155dc7391e7234945b38b624e34,2,3,10,13,4,2013-01-23 16:41:50,2013-01-23 06:23:27
785a04298177e155dc7391e7234945b38b624e34...d731f0ade129a71237eff5a17f3196002cb439fb,3,13,28,41,16,2013-01-23 16:41:50,2013-01-23 06:24:23
d731f0ade129a71237eff5a17f3196002cb439fb...0a5987fe5e0cea23245e0beab6eb47131864b276,1,21,29,50,9,2013-01-23 16:41:51,2013-01-23 06:25:07
0a5987fe5e0cea23245e0beab6eb47131864b276...9edbb8b1c1fdb199b47650f50fc432b1bfcb9039,1,10,9,19,7,2013-01-23 20:57:50,2013-01-23 06:25:22
9edbb8b1c1fdb199b47650f50fc432b1bfcb9039...6bfe19ee168cd47295e9d25b4343ec318fab3790,1,14,16,30,9,2013-01-23 20:58:27,2013-01-23 06:26:42
6bfe19ee168cd47295e9d25b4343ec318fab3790...4d5c6cefd5c3e37fdf096c955abe9f9ac5938a53,1,7,7,14,6,2013-01-23 20:58:33,2013-01-23 06:27:09
4d5c6cefd5c3e37fdf096c955abe9f9ac5938a53...b3873c336cc2eb5a6eb2b10981a2ca0b65b8c987,1,7,6,13,6,2013-01-23 20:58:33,2013-01-23 06:27:37
94702dd1ac27618b60198f7c8bceafaaaf7743e2...216120ab8387c5c9c13b673eab2ff5e1d2d9cbb7,1,1,1,2,1,2013-01-14 18:31:13,2013-01-12 16:02:13
216120ab8387c5c9c13b673eab2ff5e1d2d9cbb7...07ab4dec80f1c24660ed4bc371849fb4f11a4ee3,3,42,0,42,6,2013-01-16 17:37:45,2013-01-16 07:51:57
07ab4dec80f1c24660ed4bc371849fb4f11a4ee3...07924d4d50e5304fb53eb60aaba8aef31d4c4e5e,5,53,1,54,9,2013-01-16 17:41:18,2013-01-16 07:51:58
94702dd1ac27618b60198f7c8bceafaaaf7743e2...5a7da2dca166fab74f4514697e26dd80e79933f5,4,27,20,47,22,2013-01-14 17:25:40,2013-01-13 05:17:02
5a7da2dca166fab74f4514697e26dd80e79933f5...ec55559f937727bcb0fa8a3dfe6af68c188e968a,5,222,0,222,6,2013-01-18 19:13:22,2013-01-13 05:17:03
ec55559f937727bcb0fa8a3dfe6af68c188e968a...87c86dd14abe8db7d00b0df5661ef8cf147a72a3,1,53,0,53,1,2013-01-18 19:13:22,2013-01-13 05:17:04
94702dd1ac27618b60198f7c8bceafaaaf7743e2...cdbada79f2e38068d87cfb5b12e58051ed9bb658,1,5,0,5,2,2013-01-14 07:31:14,2013-01-14 06:48:07
6ac964a627e02ac73d4c97c492acf604942030e9...243c329c1ed8036c6e1b65d3921cb1a3a24e6385,1,3,3,6,3,2012-09-20 17:48:45,2012-09-20 17:00:22
243c329c1ed8036c6e1b65d3921cb1a3a24e6385...02572c2e3afcc200936260f48863447726212a7c,2,14,1,15,2,2012-09-21 17:33:11,2012-09-20 21:30:58
6a319e393b856461bab89ffe332a02e71befee40...0d7c01c991f2a783cc9cd89c050254ca1eb00213,1,8,1,9,3,2011-08-04 19:06:49,2011-08-04 03:36:08
0d7c01c991f2a783cc9cd89c050254ca1eb00213...927cd1fc940f7b588521b388aeb610ab3890399e,1,1,1,2,1,2011-08-04 19:13:38,2011-08-04 15:52:55
927cd1fc940f7b588521b388aeb610ab3890399e...5d2fc9135a35284176e99708b9b6f32c9e6eb7a2,13,66,66,132,65,2011-08-04 22:49:13,2011-08-04 02:13:29
13b70d2ad96a79fb439c6b4fc0e8058b1762bae2...38ef61cfde8aea0864e898d37ce3213a5771c59e,3,26,17,43,6,2011-08-04 22:40:41,2011-08-04 10:38:59
38ef61cfde8aea0864e898d37ce3213a5771c59e...5ec3118293931cf1fe8677f16449999cfbfc8b92,2,29,9,38,8,2011-08-04 22:40:41,2011-08-04 10:39:00
5ec3118293931cf1fe8677f16449999cfbfc8b92...be33c46cda2cd74344d338150019cbabd88df12f,1,14,14,28,3,2011-08-04 22:40:41,2011-08-04 10:39:01
be33c46cda2cd74344d338150019cbabd88df12f...a2ec3ad28f4608bc848feaa3d087632e44842dbf,1,0,3,3,1,2011-08-04 22:40:42,2011-08-04 10:39:02
a2ec3ad28f4608bc848feaa3d087632e44842dbf...54decbd4d858f21e2c31601f91675700c7093b1f,1,4,4,8,4,2011-08-04 22:40:42,2011-08-04 10:39:03
54decbd4d858f21e2c31601f91675700c7093b1f...708f9d96d95be7e9912eea8350fdf3f04484695f,1,11,11,22,12,2011-08-04 22:40:42,2011-08-04 10:39:04
708f9d96d95be7e9912eea8350fdf3f04484695f...80e1f791883a9b6104a2a1f0149118ade1890f25,1,113,88,201,62,2011-08-04 22:40:43,2011-08-04 10:39:05
80e1f791883a9b6104a2a1f0149118ade1890f25...89641472aafc28469448688a4ba610cf082921fa,1,7,7,14,5,2011-08-04 22:40:43,2011-08-04 10:39:06
89641472aafc28469448688a4ba610cf082921fa...9044143ff150a4ccc834523ae2f9ee11c2c961c3,1,27,11,38,4,2011-08-04 22:40:43,2011-08-04 10:39:07
9044143ff150a4ccc834523ae2f9ee11c2c961c3...04d3d3cfc4a26f003c5ae2b5598cc975a31e4395,2,178,4,182,8,2011-08-04 22:40:44,2011-08-04 10:39:08
04d3d3cfc4a26f003c5ae2b5598cc975a31e4395...6f0322633b2659d26d1c7b20d4af1fba33978690,2,60,2,62,5,2011-08-04 22:40:44,2011-08-04 10:39:09
6f0322633b2659d26d1c7b20d4af1fba33978690...21b14778a9b033d80b3e5757d9576da13ba446cd,1,28,15,43,7,2011-08-04 22:40:45,2011-08-04 10:39:10
21b14778a9b033d80b3e5757d9576da13ba446cd...26ae337be11e440420d8ec7ce415425daaabe573,8,111,20,131,24,2011-08-04 22:41:21,2011-08-04 10:39:11
26ae337be11e440420d8ec7ce415425daaabe573...95eb88d8ee588d89b4f06d2753ed4d16ab13b39f,2,46,0,46,3,2011-08-08 16:24:50,2011-08-04 10:39:12
95eb88d8ee588d89b4f06d2753ed4d16ab13b39f...2d27daa91da1d6376916533de2ec4b50e6acc925,2,35,1,36,3,2011-08-08 16:24:50,2011-08-04 10:39:13
2d27daa91da1d6376916533de2ec4b50e6acc925...21afd0806205d4a41c7c6076bd049842779ec080,2,34,5,39,7,2011-08-08 16:24:51,2011-08-04 10:39:14
21afd0806205d4a41c7c6076bd049842779ec080...5a5d80f4ca16fdb1f2577474ad94135839853a3e,5,287,4,291,15,2011-08-08 16:28:24,2011-08-04 10:39:15
5a5d80f4ca16fdb1f2577474ad94135839853a3e...cf3e2486d698356a130ebcda9d728c53a0569813,1,40,46,86,18,2011-08-08 16:28:46,2011-08-04 10:39:16
cf3e2486d698356a130ebcda9d728c53a0569813...fb3198c57f4dfa462e29844d47fa9eececc3bb8f,1,2,2,4,1,2011-09-11 22:29:21,2011-09-11 22:29:21
033c2dc4364042b9e6dbd44e82e1974f78a72567...5f44324d88a6a6699bc30912b26784ac0ade638d,4,28,0,28,5,2011-07-07 02:09:29,2011-07-07 02:08:55
5f44324d88a6a6699bc30912b26784ac0ade638d...1b4bb16b9ec331c91e28d2e3e7dee5070534b6a2,1,137,1,138,8,2011-07-08 17:03:24,2011-06-30 23:21:58
f574cb3404a87d99604c9fc77efb95fe362f0b72...c565cb452c1e20babe4d0632c58e0f11a9af30c4,1,0,12,12,2,2011-05-15 23:19:16,2011-05-15 23:19:16
9cedd16c62e12521f35b44e10bba80bfe261e69c...c4ce46fc7ac1b59372aa935e641ca15b12359f5b,6,27,23,50,18,2011-05-09 18:58:19,2011-05-08 08:47:33
c4ce46fc7ac1b59372aa935e641ca15b12359f5b...7b41e1e15b2cce13deaafc0aab10580036346a5a,1,31,11,42,5,2011-05-09 18:58:19,2011-05-08 08:47:34
7b41e1e15b2cce13deaafc0aab10580036346a5a...4dd1fbc7b1df0030f813a05cee19cad2c7a9cbf9,2,110,1,111,5,2011-05-13 23:11:18,2011-05-08 08:47:35
77b3b7969d1a817e28639dc75305a9e301f0d4b4...88955ed247333623694149230fa4c42be1a1419f,1,1,1,2,1,2010-01-24 19:01:01,2010-01-23 22:13:17
88955ed247333623694149230fa4c42be1a1419f...0ed3a111638e83d1fd179e684222b3d3e0ae440f,1,7,7,14,2,2010-01-24 19:01:45,2010-01-23 22:18:23
0ed3a111638e83d1fd179e684222b3d3e0ae440f...767f8b31cb3becbe303eb50a3faf3b4753fbaddd,1,3,1,4,3,2010-01-24 19:13:48,2010-01-24 10:10:30
d539de9f25920f099e4e56b0acbb4ebf246ff0f4...4da504608ea94fbcac65eb287d8d5791bddefd88,1,5,6,11,5,2010-01-27 20:05:04,2010-01-27 17:53:17
4da504608ea94fbcac65eb287d8d5791bddefd88...cb21d8f032b3784ffa7b340abbafb8c4b122d2cc,1,1,1,2,1,2010-01-27 20:22:37,2010-01-27 20:22:37
def6dd9bc67725f3d35d1a18f67c395c107cee0a...addfb21a94fb4e6b9d07b270f7bb3748767a8f38,2,18,1,19,3,2015-01-12 22:12:42,2015-01-12 22:12:42
1103996ea4680329baf3853984499b623c6da839...b52183179bb0a97ea4d91d1248aca303d8e8f892,2,35,1,36,2,2012-08-24 19:33:31,2012-08-24 19:33:31
5c71028fced46d03bf81b8625680d9ac87c8f4f0...2c96a6c3f1256d94d5f97fb9e0bdeafb8c0224b4,1,11,4,15,8,2012-07-27 22:35:26,2012-07-27 00:26:00
2c96a6c3f1256d94d5f97fb9e0bdeafb8c0224b4...b74fda1c9b332b1216cc4d02ec256d6e350d5524,4,401,396,797,7,2012-07-27 22:36:06,2012-07-27 00:26:01
b74fda1c9b332b1216cc4d02ec256d6e350d5524...b0e75250c8c1fc40ba9d42c31ae99146f1cdeb71,1,24,12,36,6,2012-07-27 22:36:12,2012-07-27 00:26:02
b0e75250c8c1fc40ba9d42c31ae99146f1cdeb71...b772cb9994e085c4a55820092011ee2b8997b0ac,4,262,258,520,6,2012-07-27 22:36:14,2012-07-27 00:26:03
b772cb9994e085c4a55820092011ee2b8997b0ac...e96cdba110346691794c1160db17f7a1b1f974b5,1,21,23,44,6,2012-07-27 22:36:16,2012-07-27 00:26:04
e96cdba110346691794c1160db17f7a1b1f974b5...10c2aa5928b5309374bb4328f1c2849cb4ae65cc,5,37,33,70,6,2012-07-27 22:36:17,2012-07-27 00:26:05
10c2aa5928b5309374bb4328f1c2849cb4ae65cc...3d9be15fc2b8c8198253ae1c4dcaa343b74c3b8d,5,64,60,124,6,2012-07-27 22:36:19,2012-07-27 00:26:06
6a9aa0c9b224517db0549d9252fdbc5177e6c0e2...3e5f29e8963a9a6f1774add194ec19583c19fbb6,1,4,6,10,3,2012-07-18 20:26:48,2012-07-18 12:04:02
3e5f29e8963a9a6f1774add194ec19583c19fbb6...6319a2a148adaa78f11414e914f8c9f3f1c52b5e,1,1,1,2,1,2012-07-18 20:26:53,2012-07-18 12:04:30
6319a2a148adaa78f11414e914f8c9f3f1c52b5e...9c183a70722804114ac1dc54d17fe791ac1a452c,2,14,0,14,2,2012-07-18 20:26:58,2012-07-18 12:06:26
9c183a70722804114ac1dc54d17fe791ac1a452c...77eab053a48a2062665c42f63348ae12290de03f,1,4,28,32,4,2012-07-18 20:27:02,2012-07-18 13:03:08
8280baf565e1c72adaa6d2dfef70d18837126898...332de7a1c89a579f15ca41c11e606007cc32fdbf,1,1,0,1,1,2011-12-05 22:42:40,2011-12-02 22:55:28
332de7a1c89a579f15ca41c11e606007cc32fdbf...c2857fb8b7903b2bba9217310971e5282549174d,1,0,2,2,1,2011-12-05 23:04:38,2011-12-05 22:29:15
85e9c7e1d42849c5c3084a9da748608468310c0e...9fef9e279055423363e110b7246a9b8bbcf0bd72,1,32,0,32,1,2011-09-30 19:34:38,2011-09-30 10:52:24
9fef9e279055423363e110b7246a9b8bbcf0bd72...cec5dae827f2255578807be6214ece1e0619b8e1,1,9,1,10,3,2011-09-30 19:35:00,2011-09-30 10:52:25
85e9c7e1d42849c5c3084a9da748608468310c0e...160b81ed819d870b7d098bf61b51c4bc959507f3,4,211,8,219,11,2011-09-30 19:18:46,2011-09-28 15:39:35
a536a9db08a1f5ac327940a25e42d30a54730105...b32128793de296348a565e8f7c4257ec82208a48,1,10,2,12,4,2011-09-02 20:26:02,2011-09-02 20:26:02
ad7ace714d353ef49045bc37c1363e8fc904792d...c8e1c3d3e8ed326fe9e8ba5616db2e81a41fcc16,1,1,1,2,1,2009-11-27 02:33:34,2009-11-26 21:49:50
b43ba7891422127eb3ec7bd88c9a8ea102b19d0c...2ce0edcd786b790fed580e7df56291619834d276,1,25,4,29,3,2011-12-21 20:02:13,2011-12-21 20:02:13
871e293c9acbeaacce59dcd98fab6028f552f5be...5f38e5eccb4dbcbd87fd6df9dec9939e310bcc9d,1,5,5,10,2,2012-09-27 18:58:51,2012-09-24 17:16:21
871e293c9acbeaacce59dcd98fab6028f552f5be...d5b4d80d1cc056d5cc4a18f457133b2de8fc685a,1,3,1,4,1,2012-09-09 09:59:58,2012-09-09 09:59:58
871e293c9acbeaacce59dcd98fab6028f552f5be...50bd8b7eb960ff7a646195e0751b48a0e57e03ad,1,28,20,48,4,2012-09-06 20:29:38,2012-09-06 15:16:50
871e293c9acbeaacce59dcd98fab6028f552f5be...e17dba8fe15028425acd6a4ebebf1b8e9377d3c6,5,10,9,19,10,2012-09-06 20:23:22,2012-09-06 12:25:23
871e293c9acbeaacce59dcd98fab6028f552f5be...5b3b8fa2ab188908332358d2c2576491969cd580,1,3,3,6,3,2012-09-04 20:34:46,2012-09-04 17:26:30
5b3b8fa2ab188908332358d2c2576491969cd580...66a51a9aaec3f53250b1d515a1bd81044ebb354b,1,6,5,11,6,2012-09-04 20:34:46,2012-09-04 17:27:54
66a51a9aaec3f53250b1d515a1bd81044ebb354b...5c44252e13db2324d7c79d2b498886a925055111,1,3,12,15,5,2012-09-04 20:34:46,2012-09-04 17:29:22
5c44252e13db2324d7c79d2b498886a925055111...d292bfaf356338b41e14e40ce4dbd6b9c8d600ec,2,3,2,5,3,2012-09-04 20:34:46,2012-09-04 17:30:21
d292bfaf356338b41e14e40ce4dbd6b9c8d600ec...4e2d094dde4f078245d057dd6111ab9d013ae6d0,4,11,10,21,7,2012-09-04 20:34:46,2012-09-04 17:31:14
871e293c9acbeaacce59dcd98fab6028f552f5be...46d98476cfcd6820e316f254615cf1ae43584ddb,1,11,13,24,3,2012-09-03 02:32:30,2012-09-01 18:08:42
46d98476cfcd6820e316f254615cf1ae43584ddb...bb8eb64ef7154dce7d4870f134561729e68ca8c5,1,15,16,31,14,2012-09-03 02:32:30,2012-09-01 18:10:01
bb8eb64ef7154dce7d4870f134561729e68ca8c5...69915d88bca0cb6837c68ca09b702ad051f207e7,1,9,11,20,6,2012-09-03 02:32:30,2012-09-01 18:10:57
69915d88bca0cb6837c68ca09b702ad051f207e7...1c0cc7563b079e17f84cf93e5b735ec9fa4ad11a,1,38,22,60,12,2012-09-03 02:32:31,2012-09-01 18:11:49
1c0cc7563b079e17f84cf93e5b735ec9fa4ad11a...bf4b7219322d007f3ebd2a002114956d025e4703,1,4,0,4,1,2012-09-03 02:32:31,2012-09-01 18:13:19
bf4b7219322d007f3ebd2a002114956d025e4703...d87bd7c15beb688294cf4adb1b719dc4e413c58f,1,4,1,5,1,2012-09-03 02:32:31,2012-09-01 18:26:21
0539ecfdfce677b05992af5e9899a9e974130400...dc9f462d42514f6038f4e512c1d0ad32bcdc4c74,1,6,0,6,2,2012-09-09 03:40:06,2012-09-08 17:01:31
7f6a0719dae5f87e85a68142eb0c99b9c8a32c44...851f7e689efa034701bf41c3be06c927480eaae9,3,46,2,48,3,2012-08-22 18:54:47,2012-08-22 18:49:26
16d26b168b371b2f4f86b1adb61470c6b08b27b9...819a22764f651e250d107e33e0c3daddc61c499d,2,569,503,1072,306,2012-09-04 01:25:50,2012-09-04 01:22:21
819a22764f651e250d107e33e0c3daddc61c499d...ccfca8dc26e14f53bbf7ee7257bbd9e8c0dd4bf7,1,345,339,684,320,2012-09-04 22:38:55,2012-09-04 22:20:57
16d26b168b371b2f4f86b1adb61470c6b08b27b9...f350df429fc664129c3a600f0142287ed13a48f7,1,11,10,21,8,2012-08-31 20:05:05,2012-08-31 12:13:04
61b472ed8b090a3e9240590c85041120a54dd268...5b8056c1552a18e289f185f57b86a4b05253716d,1,6,6,12,6,2012-08-16 12:57:51,2012-08-14 08:58:14
61b472ed8b090a3e9240590c85041120a54dd268...d2018293ca604544a79cd9390953ef0272a65078,2,17,17,34,2,2012-08-12 04:42:12,2012-08-11 16:55:00
d2018293ca604544a79cd9390953ef0272a65078...19516356b29e964dcac3ed20b1eab5ff3cea7bee,1,77,0,77,1,2012-08-12 04:42:13,2012-08-11 16:55:01
19516356b29e964dcac3ed20b1eab5ff3cea7bee...e63231e566e2ac063e9f2aca18f5e3dca29dbc8f,1,14,11,25,12,2012-08-12 04:42:13,2012-08-11 16:55:02
e63231e566e2ac063e9f2aca18f5e3dca29dbc8f...0d1696ef47a61bba1088b0e5cd58a8bc45d936fb,1,8,9,17,7,2012-08-12 04:42:14,2012-08-11 16:55:03
0d1696ef47a61bba1088b0e5cd58a8bc45d936fb...21ef5df4315b8f4f45bffb6af54d1ea338cb2cf5,2,32,7,39,9,2012-08-20 22:52:48,2012-08-11 16:55:04
e7ff66b5ef979553c182a97549244e02ccc72507...780ded430aaad002cd92279e39343f9f0445e498,1,0,38,38,2,2012-09-10 22:41:14,2012-09-10 22:41:14
1327d83954bcf755094995b63317b23986c550f2...ff7f2185d6e04b7bea66f39ee51d79919ab1279c,1,7,8,15,4,2012-01-05 21:29:50,2012-01-05 20:26:48
ff7f2185d6e04b7bea66f39ee51d79919ab1279c...8e09fd1a1e5ea8eaec960d47be51bde85df8870e,1,3,2,5,2,2012-01-05 21:29:51,2012-01-05 20:32:56
07b88a00c0caac055a9f52167523248a75711842...1afca444953639fef53f3e5520202971505d77b9,2,12,1,13,2,2012-01-10 19:25:40,2012-01-10 18:08:21
1afca444953639fef53f3e5520202971505d77b9...77f7f822889411bfede0507dd60aebf11edb2849,1,1,1,2,1,2012-01-10 19:55:27,2012-01-10 19:32:06
77f7f822889411bfede0507dd60aebf11edb2849...909ca7b9ac11711478aaa5dd4ab17a0d1dabe075,1,31,30,61,11,2012-01-10 20:27:37,2012-01-10 20:27:37
909ca7b9ac11711478aaa5dd4ab17a0d1dabe075...c432ef996e28a2f02369c505b841f86ec30c85fb,1,10,1,11,2,2012-01-10 20:28:38,2012-01-10 20:28:38
c432ef996e28a2f02369c505b841f86ec30c85fb...b6fb7fed6afca3376e4cdd70c9fe9737bcd73a6e,1,2,1,3,1,2012-01-10 20:59:31,2012-01-10 14:57:27
b6fb7fed6afca3376e4cdd70c9fe9737bcd73a6e...f14f9803ef13e972371e3f4bce69bca13dd1cd2d,2,12,1,13,2,2012-01-10 21:11:03,2012-01-10 21:11:03
b1af9630d758e1728fc0008b3f18d90d8f87f4c5...7b438f62f4ad901832defe5a72dcdd997b716c9a,1,7,6,13,2,2011-12-08 21:36:05,2011-12-07 14:45:40
7b438f62f4ad901832defe5a72dcdd997b716c9a...67a612c4e5c106ad5b0e627ab3e87f0d5b768b3e,1,0,20,20,2,2011-12-08 21:37:07,2011-12-07 14:49:29
67a612c4e5c106ad5b0e627ab3e87f0d5b768b3e...1af524eba1367a56c02d0e2d6e6d26a1d25ac485,1,127,133,260,27,2011-12-08 22:49:19,2011-12-07 14:50:23
1af524eba1367a56c02d0e2d6e6d26a1d25ac485...ca1ba2010215acb305c7b5d9707e117b862067eb,1,5,4,9,3,2011-12-08 23:25:30,2011-12-06 21:09:55
ca1ba2010215acb305c7b5d9707e117b862067eb...bc8218999863a083d725f2011e5e0371df30aa1f,1,40,0,40,1,2011-12-08 23:35:34,2011-12-07 14:54:14
288396994f077eec7e7db0017838a5afbfbf81e3...fc002330718c2d939b4a1d0603db1a1ae623aa47,3,559,324,883,26,2011-10-18 03:42:59,2011-08-23 02:20:33
fc002330718c2d939b4a1d0603db1a1ae623aa47...55aa5714afc1310fd94936a8cd922e868d694bd2,2,119,0,119,3,2011-10-18 03:45:28,2011-09-17 23:16:14
55aa5714afc1310fd94936a8cd922e868d694bd2...9cffb8c8bfd64d97769b3e3792201bcb3618dd23,1,52,19,71,7,2011-10-18 03:46:49,2011-10-16 14:45:01
9cffb8c8bfd64d97769b3e3792201bcb3618dd23...97a21ca50ef893a171a50c863fe21a924935fd2a,1,0,5,5,1,2011-10-18 03:46:49,2011-10-16 14:45:49
288396994f077eec7e7db0017838a5afbfbf81e3...afd7f1eb0f4ceebcea2427e6e7f80d4dc32081ec,3,146,1,147,7,2011-10-16 08:12:26,2011-09-16 21:02:01
afd7f1eb0f4ceebcea2427e6e7f80d4dc32081ec...cdb51a13c3cf4830d499d1138160eacdd2b8aa46,1,33,5,38,7,2011-10-16 08:22:27,2011-10-10 23:27:37
22f41286be2a07cf96d71a795eaee54b702bb570...5c2f84599c59527ee47a41c05956fa1f8d0704ec,1,16,1,17,5,2011-07-22 22:32:03,2011-07-22 22:32:03
02071b27f1587c65ddc4779017a3ddceb777de9c...b9a62cbeb91e52aea8fc427a84e72f475dfe60cf,3,5,5,10,5,2011-05-17 05:13:34,2011-05-12 23:50:29
b9a62cbeb91e52aea8fc427a84e72f475dfe60cf...9a4905902230c080f0f6a64ed7f0aaa5777d2f5b,2,59,11,70,13,2011-05-19 21:22:47,2011-05-12 22:51:38
9a4905902230c080f0f6a64ed7f0aaa5777d2f5b...5266d369b21f8c260fa60d94fb29c3998c521e4a,2,11,1,12,3,2011-05-21 01:38:50,2011-05-13 20:20:43
5266d369b21f8c260fa60d94fb29c3998c521e4a...f8c8abc5b76ffd763b9c7c5e4fb054358e82ca28,2,5,4,9,2,2011-05-21 01:38:54,2011-05-13 22:33:33
f8c8abc5b76ffd763b9c7c5e4fb054358e82ca28...fd5db55d8b6668a1ff9583a6636a4d54ad9519f2,1,26,17,43,3,2011-05-21 01:38:54,2011-05-13 04:36:42
fd5db55d8b6668a1ff9583a6636a4d54ad9519f2...46bf043807cc5d8986f41139a8c28491f613c5e0,3,210,0,210,4,2011-05-21 01:46:55,2011-05-12 02:30:25
46bf043807cc5d8986f41139a8c28491f613c5e0...dd8e912190540ef6578386aa1343fbbe196cb8c1,3,76,0,76,6,2011-05-21 01:46:58,2011-05-12 21:31:08
dd8e912190540ef6578386aa1343fbbe196cb8c1...b0d9c69f5ee4a626a779d27a33f5565efccd5802,1,1,1,2,1,2011-05-21 06:16:53,2011-05-20 23:14:32
b0d9c69f5ee4a626a779d27a33f5565efccd5802...de6182db67d0f53fdc13256042014f2ddf5f8df3,1,19,2,21,5,2011-05-21 06:16:53,2011-05-13 22:55:00
de6182db67d0f53fdc13256042014f2ddf5f8df3...7ef2d9a2604b0cd554e59f948f2c879b3708dfa5,1,102,3,105,5,2011-05-21 06:16:53,2011-05-13 22:34:58
7ef2d9a2604b0cd554e59f948f2c879b3708dfa5...f0270efd460e5ee28dca8481181f1ac1ed4111d1,2,6,3,9,4,2011-05-21 06:16:53,2011-05-15 02:42:10
f0270efd460e5ee28dca8481181f1ac1ed4111d1...93aa7bd595d37aec09b96da7ea9da89d9f659ebd,1,82,3,85,3,2011-05-21 06:16:53,2011-05-15 02:17:10
93aa7bd595d37aec09b96da7ea9da89d9f659ebd...23c7df6bdd13e3d99ca09b6a7655747cc29ccc41,1,1,1,2,1,2011-05-26 18:25:59,2011-05-26 14:34:20
fb539696861ce2d924245ea34fe3aa467406a495...b602ed7dea968d72c5b3f61ca016de7f285d80ef,1,20,13,33,6,2011-05-17 00:19:24,2011-05-16 23:58:35
b547ce0b184f152938f2ea709b9932fa0d6181f8...958bf6b768aa10fa3985886d312bd0365dee7677,1,6,1,7,1,2011-03-20 04:46:24,2011-03-20 04:46:06
958bf6b768aa10fa3985886d312bd0365dee7677...6368d9f1af7a5d4c8af2f11ffdb6af577f1e98f5,1,2,3,5,3,2011-03-20 04:46:32,2011-03-19 22:53:55
b2f6eab4027beaaa7415e70dad269bdc7cc27722...a3ca9b0fbe21d7a2525877fe0c008b61c56f7104,1,9,22,31,9,2011-03-17 00:02:58,2011-03-16 09:23:23
07873dc5dd67398324278ff0d7627bb1a863ba89...803dbdb9686f249e88fae8530b5306d6eea62c1b,1,1,1,2,1,2011-03-09 05:36:12,2011-03-04 23:16:26
9b5a272e7252332b3a1d6fef54df7626c9eef9c5...ed94cc768c0341f2e033901bb14f6030780a201e,1,8,4,12,8,2010-12-09 23:52:12,2010-12-09 23:52:12
636e87d705c2d6cc53d58eac31b689779d00b292...aca20dd558338446336934a4b18516cfbf7d8393,1,42,0,42,1,2010-05-24 18:22:05,2010-05-22 21:26:39
aca20dd558338446336934a4b18516cfbf7d8393...64fcec78b5c52a054eab482e91d58f7b41d1dfaf,1,11,9,20,3,2010-05-24 18:22:06,2010-05-22 21:28:17
64fcec78b5c52a054eab482e91d58f7b41d1dfaf...c30c10cff1d640ce119596b907c10cc11f83358d,2,10,5,15,5,2010-05-24 18:22:06,2010-05-22 21:29:35
c30c10cff1d640ce119596b907c10cc11f83358d...321ffcc0556a94c461ac84667b35494c193804ec,2,10,4,14,3,2010-05-24 18:22:06,2010-05-22 21:30:48
321ffcc0556a94c461ac84667b35494c193804ec...1baddf4b3781c0c714442adfda496d667e1850cd,2,13,7,20,6,2010-05-24 18:22:06,2010-05-22 21:32:43
1baddf4b3781c0c714442adfda496d667e1850cd...52d799a79f921cc47823a0455b0e646636410b65,2,13,3,16,2,2010-05-24 18:22:07,2010-05-22 21:34:06
52d799a79f921cc47823a0455b0e646636410b65...f96e56733ab3e3ce5c79c27c673c746af1519a86,2,24,10,34,4,2010-05-24 18:22:07,2010-05-22 21:35:07
f96e56733ab3e3ce5c79c27c673c746af1519a86...ed40a0951cedb70777669144478166aa5bb2cf9c,4,58,15,73,16,2010-05-24 18:22:07,2010-05-22 21:43:43
636e87d705c2d6cc53d58eac31b689779d00b292...031a027a72a62ccf45ae22dee5721e554f6ba6e9,2,82,12,94,9,2010-05-20 04:02:58,2010-05-15 15:06:46
031a027a72a62ccf45ae22dee5721e554f6ba6e9...c057bad3701682a208b72473b746de6bb5d89792,2,31,19,50,8,2010-05-20 04:02:59,2010-05-15 15:07:54
c057bad3701682a208b72473b746de6bb5d89792...3052525effbf4b9ab0cc4a66fe32f0f7261b7323,1,13,10,23,1,2010-05-20 04:02:59,2010-05-15 02:46:01
3052525effbf4b9ab0cc4a66fe32f0f7261b7323...475357a32a55c3624011e3945f9659f4cb365f1b,1,24,5,29,5,2010-05-20 04:02:59,2010-05-15 02:46:02
475357a32a55c3624011e3945f9659f4cb365f1b...70d5dd1f71aab4b55bf3bc3e7f5031dc655c7fdf,1,5,0,5,1,2010-05-20 04:02:59,2010-05-15 02:46:03
70d5dd1f71aab4b55bf3bc3e7f5031dc655c7fdf...1dd3f291214b9647f7101d8b25c87371bf4fad48,1,15,1,16,3,2010-05-20 04:02:59,2010-05-15 02:46:04
636e87d705c2d6cc53d58eac31b689779d00b292...3d8b69495fd1132d5af6d7f46425cca97a937d97,3,192,11,203,9,2010-05-20 03:45:41,2010-05-19 18:38:50
7325283987430f94712713313c5089e5143f2e17...d23e7570a764d5e3fd033b7586bb4924d2774370,1,3,1,4,1,2010-03-17 18:03:44,2010-03-17 09:20:35
d23e7570a764d5e3fd033b7586bb4924d2774370...7d182f52f1a754bdccb2e7c7cea54f773f76bc5c,1,1,1,2,1,2010-03-17 18:07:06,2010-03-17 11:14:57
f3bd6ab7ea7b35ca5f26f106eb00a00f257716d7...77bc694907bdf517407cc6f79da8adf9a4879cea,1,1,0,1,1,2010-04-18 18:41:53,2010-04-18 12:01:45
35e4d775875603c748a127c82909f5d62a410ac8...03af7cd1580b7a4d9b77c81081d6eabc0338883e,1,1,1,2,1,2014-11-04 22:44:47,2014-11-04 22:18:33
efe5f1d25d198ae8796b6f095c2cffae270bb9b6...6a7071958620dadcce84e4faaa470407ae3d4108,1,1,1,2,1,2014-02-07 19:56:07,2014-02-07 19:56:07
faa3b4769ce042fc3069c5dcdac279fa97966d61...c2c85ed5d90d96a9d06170729a1a8b15af5256a4,1,4,1,5,2,2010-02-17 23:01:11,2010-02-17 23:01:11
a6954452ecf757523b31d6eaaf7e00c7a2d91e46...7d4aef4027e6a95fa112fa7b069f945cad294a23,1,20,0,20,1,2007-08-06 08:46:31,2007-08-06 08:16:43
7d4aef4027e6a95fa112fa7b069f945cad294a23...3f0a8f3c015f5f2502228a72d8c944d9e700c559,1,2,1,3,1,2007-08-06 23:16:27,2007-08-06 14:15:30
3f0a8f3c015f5f2502228a72d8c944d9e700c559...cad3a2056d2aef3f57c3bb0eccc10614ae69926f,1,4,1,5,2,2007-08-07 04:10:59,2007-08-07 04:08:43
cad3a2056d2aef3f57c3bb0eccc10614ae69926f...87027ae4494cd09c428e85b85337fed45a42e29c,1,3,5,8,1,2007-08-07 04:16:21,2007-08-07 04:15:15
87027ae4494cd09c428e85b85337fed45a42e29c...5b56aaa29e9d7c0371b6d47bd8a6b12a0c4292dd,1,29,10,39,6,2007-08-07 05:40:18,2007-08-06 20:34:50
5b56aaa29e9d7c0371b6d47bd8a6b12a0c4292dd...f9935bf9312dd6681e5051fbdce03204b6458c73,1,1,0,1,1,2007-08-07 06:25:10,2007-08-06 12:56:32
f9935bf9312dd6681e5051fbdce03204b6458c73...4cf3ef97406ea10261cf6faa487520861f8b424b,1,7,0,7,1,2007-08-07 06:47:18,2007-08-07 05:57:47
4cf3ef97406ea10261cf6faa487520861f8b424b...e2c6de1c62373bd4aecf00e91ea7982c8fd6807e,1,3,3,6,2,2007-08-07 20:49:24,2007-08-07 17:39:03
e2c6de1c62373bd4aecf00e91ea7982c8fd6807e...3671757546ce78bb04611aa5481c2aa77a1ffc90,1,1,1,2,1,2007-08-07 20:49:33,2007-08-07 17:38:29
3671757546ce78bb04611aa5481c2aa77a1ffc90...74276ec6f2d2123714066cee24b26a629930e7a8,1,9,5,14,3,2007-08-08 08:58:05,2007-08-07 10:28:00
74276ec6f2d2123714066cee24b26a629930e7a8...aec2196a671de8ef6ba38622869dc862c971df17,1,9,7,16,12,2007-08-08 20:42:32,2007-08-08 20:41:46
aec2196a671de8ef6ba38622869dc862c971df17...ea99c3ae0e2cecaa0950532385319d60c59e97e0,1,30,6,36,7,2007-08-08 20:45:04,2007-08-08 15:06:55
ea99c3ae0e2cecaa0950532385319d60c59e97e0...b50be1d80f4c151447d2ac96eaeb1c4d76ed4ef5,1,2,0,2,2,2007-08-09 05:16:46,2007-08-09 04:26:10
b50be1d80f4c151447d2ac96eaeb1c4d76ed4ef5...3955d994dec590fb7c586b35094d25af92065c9d,1,10,10,20,2,2007-08-10 07:47:53,2007-08-10 07:47:28
3955d994dec590fb7c586b35094d25af92065c9d...b767c792fa202539cfb9bba36f46c62bcbf7c987,1,44,16,60,10,2007-08-10 07:59:43,2007-08-09 06:38:09
b767c792fa202539cfb9bba36f46c62bcbf7c987...d47eed3272311acf16f136c49b0bb341c9a6e39c,1,105,7,112,6,2007-08-10 08:00:16,2007-08-09 06:38:12
d47eed3272311acf16f136c49b0bb341c9a6e39c...cabead982b7cf40f8930e6e38327fc396b7fef81,1,21,10,31,5,2007-08-10 08:00:25,2007-08-09 06:38:16
cabead982b7cf40f8930e6e38327fc396b7fef81...155197e6e770599a5ed7a33a33f2916032184dd3,1,1,1,2,2,2007-08-10 08:00:51,2007-08-09 13:27:57
155197e6e770599a5ed7a33a33f2916032184dd3...94638f89f5bcd1f92b86ebf988f7974167c3fd27,1,24,26,50,18,2007-08-10 08:02:32,2007-08-09 13:27:58
94638f89f5bcd1f92b86ebf988f7974167c3fd27...f1ec6b22a8c1ab1cca0f1875f85aea5d2434e5a6,1,1,1,2,1,2007-08-10 08:03:46,2007-08-10 07:49:27
f1ec6b22a8c1ab1cca0f1875f85aea5d2434e5a6...524e5ffcf41a67ec113a9c3730ddc8fb8d3317f5,1,13,0,13,1,2007-08-10 08:03:51,2007-08-10 07:49:26
524e5ffcf41a67ec113a9c3730ddc8fb8d3317f5...7efeb8f09866ddd09485c0e6f371a6cbba3d2a0a,2,14,44,58,8,2007-08-10 08:12:07,2007-08-05 13:12:53
57543a254c6aef8fca5556e25a9fa6dd5622b037...d2100860fd67dec6474157697888caaa0a0f51d0,1,58,16,74,13,2007-09-10 00:16:49,2007-09-08 21:17:44
d2100860fd67dec6474157697888caaa0a0f51d0...02e665ce491296245f474dafdc02d47a6c8afa86,1,31,10,41,4,2007-09-10 00:16:49,2007-09-08 21:25:55
d52bc66152834dff3fb5f32a54f6ed57730f58c6...cd9519bd2c5c666cfb3ec219ee0b47c83f26f3fe,1,1,0,1,1,2011-11-10 17:04:08,2011-11-10 08:39:22
d52bc66152834dff3fb5f32a54f6ed57730f58c6...af6eb82262e35687aa8f00d688e327cb845973fa,4,45,109,154,29,2007-09-07 06:57:44,2007-09-06 11:20:09
af6eb82262e35687aa8f00d688e327cb845973fa...19b358e8daafdfe5a5d25ff7972e041493b05156,1,18,38,56,13,2007-09-07 06:57:44,2007-09-06 11:20:10
19b358e8daafdfe5a5d25ff7972e041493b05156...5242bcbb638f031818e9ebd4467c8e55d5a06bfb,1,22,37,59,15,2007-09-07 06:57:44,2007-09-06 11:20:11
4e560158c6de154fafab9fc3f6028d9edcc53e6b...451e593181c554b06f1ce292b4233d396a355753,1,1,1,2,1,2007-09-08 04:01:33,2007-09-07 16:43:37
451e593181c554b06f1ce292b4233d396a355753...ee834cf0c7de68557bc5c30552fce3e55f52e109,2,2,2,4,2,2007-09-08 04:02:39,2007-09-07 21:35:07
ee834cf0c7de68557bc5c30552fce3e55f52e109...a51cdb0c0420ee3bef26bbd1a9aa75e1d464e5b7,1,13,1,14,5,2007-09-08 05:23:48,2007-09-07 11:00:40
a51cdb0c0420ee3bef26bbd1a9aa75e1d464e5b7...5701115aa7cfe7edd57c2483085456a37e27a5ba,2,21,4,25,3,2007-09-09 09:28:57,2007-09-08 10:30:22
5701115aa7cfe7edd57c2483085456a37e27a5ba...7b02b85a66fee6b357e02f9e70dd0baa0fd24308,1,3,8,11,1,2007-09-09 09:30:33,2007-09-08 23:33:08
1e61b7640d09015213dbcae3564fa27ac6a8c151...3d9f037c60ceae1bd60ee3c861564812a89b05b1,5,46,29,75,13,2007-09-05 18:29:33,2007-09-05 01:38:24
1e61b7640d09015213dbcae3564fa27ac6a8c151...7b95089c0f59a25bb1c506b6962eb64412c585eb,2,6,4,10,5,2007-09-03 23:46:02,2007-09-03 18:06:36
7b95089c0f59a25bb1c506b6962eb64412c585eb...8460b2fcd45668d91567c36a22ea4f1b14ba133d,6,98,3,101,16,2007-09-03 23:46:16,2007-09-03 18:07:01
8460b2fcd45668d91567c36a22ea4f1b14ba133d...89b4256cfbb8d878cc4cd1104ac4865ba1f2a58e,2,0,16,16,2,2007-09-03 23:46:23,2007-09-03 18:08:01
89b4256cfbb8d878cc4cd1104ac4865ba1f2a58e...b21b9f1de313acb5550c070911ae58c735cdb451,3,46,0,46,9,2007-09-07 05:46:00,2007-09-06 22:32:54
b21b9f1de313acb5550c070911ae58c735cdb451...df4a394f91d7d107c2a57e6c1df3638517cab54f,3,53,8,61,6,2007-09-07 05:51:31,2007-09-06 22:34:06
df4a394f91d7d107c2a57e6c1df3638517cab54f...38c9c9b798a0df875968ae49d699298131dfa24d,3,19,19,38,12,2007-09-07 05:51:41,2007-09-06 16:51:11
38c9c9b798a0df875968ae49d699298131dfa24d...3d59405ced89450fa443b64203a8bd9e34d4014c,1,1,0,1,1,2007-09-09 08:51:13,2007-09-09 05:09:17
3d59405ced89450fa443b64203a8bd9e34d4014c...20fbfd869fe8faae0ce4573b60b540024db7385d,1,1,0,1,1,2007-09-10 07:14:38,2007-09-10 07:14:38
1e61b7640d09015213dbcae3564fa27ac6a8c151...fec60a261d9375d1f129313bb68036fbd2a5175c,1,1,1,2,1,2007-09-03 23:44:35,2007-09-03 16:51:43
1e61b7640d09015213dbcae3564fa27ac6a8c151...38944390220425cc3c4208dd31172397e7f18e8c,2,12,2,14,4,2007-09-03 10:08:12,2007-09-02 20:10:14
1e61b7640d09015213dbcae3564fa27ac6a8c151...34cc60ce2b48f6037997543ddbab1ed9903df4a8,2,109,27,136,18,2007-09-03 09:40:48,2007-09-02 18:06:25
aabb2e515c334cbca9d9ae9873a188cef2c9b3ba...15d54753bb59917db93e27ddfbb3b52d1f4f8c31,1,1,0,1,1,2007-08-23 06:41:36,2007-08-23 05:14:31
aabb2e515c334cbca9d9ae9873a188cef2c9b3ba...47e98eecf3721dca64e3d453fc96e3a02debe54f,1,26,6,32,11,2007-08-23 05:39:22,2007-08-23 05:39:22
47e98eecf3721dca64e3d453fc96e3a02debe54f...217926c08cb634e3b5394ea15b3fe4520069260b,1,8,0,8,4,2007-08-23 05:42:11,2007-08-23 05:42:11
217926c08cb634e3b5394ea15b3fe4520069260b...be86f7a0dfa05dacb2ef512e99d1de576e77a633,1,27,0,27,3,2007-08-23 05:50:49,2007-08-23 05:50:49
1b2782a5e2f88bf5e6e2cbb58e54fea015e21af5...ec0603e13c4e33c3a1501fe16f576db9aff1701a,2,53,0,53,2,2007-07-12 09:22:53,2007-07-12 08:04:16
ec0603e13c4e33c3a1501fe16f576db9aff1701a...ffb293b63d13b3b06b454a5f9f0ff6802ef15f0d,3,30,2,32,3,2007-07-12 19:01:47,2007-07-12 19:01:47
5fda48d67c82e07950e0b0c21cd8c97daefd7be0...5478285961996560147e2fd39daf45b79f580641,1,3,3,6,1,2007-07-08 22:01:28,2007-06-12 15:43:19
5478285961996560147e2fd39daf45b79f580641...f0dc409c31c430e5a5e45161383fba7964b4044d,1,1,1,2,1,2007-07-08 22:02:16,2007-06-22 03:17:40
f0dc409c31c430e5a5e45161383fba7964b4044d...11d515334432e840d9699703e0634e9df58a4441,1,18,1,19,4,2007-07-08 22:17:47,2007-06-18 20:38:22
11d515334432e840d9699703e0634e9df58a4441...ccd71866b0c7253f988c4836eeb888e4abcc2da1,1,1,1,2,1,2007-07-08 22:27:51,2007-06-29 13:08:29
b215883de9322b8b475a04b4768d6ba5455373d1...2dfa54c6cb39c443652440f1ee6fdf5a6067364a,1,1,0,1,1,2007-07-16 06:39:07,2007-07-16 06:39:07
2dfa54c6cb39c443652440f1ee6fdf5a6067364a...ec4fceece4a9f155afcadec254caff5cef781c67,1,1,1,2,1,2007-07-16 22:44:23,2007-07-16 22:44:23
ec4fceece4a9f155afcadec254caff5cef781c67...6eb420ef61317b2efa2993868a6302afed6ae60a,4,5,1,6,5,2007-07-17 05:50:10,2007-07-17 05:50:10
6eb420ef61317b2efa2993868a6302afed6ae60a...91464dfb102d6143182d8f312b68486e9dceb103,1,1,0,1,1,2007-07-18 01:48:57,2007-07-17 21:14:06
91464dfb102d6143182d8f312b68486e9dceb103...6f62b4f782c51bdf0dfdef3da5b5049c9006ff70,1,15,13,28,5,2007-07-18 02:31:16,2007-07-18 02:31:16
6f62b4f782c51bdf0dfdef3da5b5049c9006ff70...2370164f3ceb833b9b4128d80bdfcc81e58682f9,1,5,2,7,2,2007-07-18 02:45:53,2007-07-18 02:45:53
2370164f3ceb833b9b4128d80bdfcc81e58682f9...d164b7548ab61e50d4404d1fbc0da3a8f6c0cc87,1,14,5,19,4,2007-07-18 02:49:44,2007-07-18 02:49:44
d164b7548ab61e50d4404d1fbc0da3a8f6c0cc87...301dfaa9daeb64c66d616efe50fac29d542c9414,1,27,0,27,3,2007-07-18 03:09:31,2007-07-18 03:09:31
301dfaa9daeb64c66d616efe50fac29d542c9414...3972b987d373759ae4868012fe8133ca1e26ea20,2,30,28,58,3,2007-07-18 03:20:56,2007-07-18 03:20:56
3972b987d373759ae4868012fe8133ca1e26ea20...ba7cc6609e5726ddc59158b60ac01f5fc9717ab3,1,37,37,74,2,2007-07-18 03:23:56,2007-07-18 03:23:56
ba7cc6609e5726ddc59158b60ac01f5fc9717ab3...c52c94524bdf9bbe515137b7f3f0240bc10a7f63,1,32,13,45,9,2007-07-18 03:58:56,2007-07-18 03:58:56
c52c94524bdf9bbe515137b7f3f0240bc10a7f63...85d2d59760e5de7f288109cb278eb91da0d5f9bf,2,27,29,56,6,2007-07-18 04:53:14,2007-07-18 04:53:14
85d2d59760e5de7f288109cb278eb91da0d5f9bf...8e891facbef4b0196e51fe2065602175f28508c3,2,58,2,60,3,2007-07-18 05:39:27,2007-07-18 05:39:27
8e891facbef4b0196e51fe2065602175f28508c3...4040971269e28676037448c4a6754d760eea1a64,1,3,3,6,3,2007-07-18 05:48:41,2007-07-18 05:48:41
4040971269e28676037448c4a6754d760eea1a64...46a2df3ac20c53eaec1d2081d5324f7c85b1adef,1,1,1,2,1,2007-07-18 06:27:39,2007-07-18 06:27:39
46a2df3ac20c53eaec1d2081d5324f7c85b1adef...ff749c114a9642e79a1e93250828034f0338f1be,1,65,41,106,27,2007-07-18 06:56:44,2007-07-18 06:56:44
ff749c114a9642e79a1e93250828034f0338f1be...dc5ccdc6cab41e8a4b2ace991b1564fe9bdd172d,1,3,1,4,1,2007-07-19 03:52:18,2007-07-18 13:37:27
dc5ccdc6cab41e8a4b2ace991b1564fe9bdd172d...a870ddc0997881d5e73c0ec4562f3521274c5960,1,4,2,6,3,2007-07-19 04:39:23,2007-07-19 04:39:23
a870ddc0997881d5e73c0ec4562f3521274c5960...d36cd968378cd3e509434b1b9f43f1417fdba57e,1,4,7,11,5,2007-07-19 04:43:16,2007-07-19 04:43:16
d36cd968378cd3e509434b1b9f43f1417fdba57e...c4638f662c9ba5f4150ab97dbbf0e540392aad55,3,304,11,315,7,2007-07-19 05:27:17,2007-07-19 05:13:29
c4638f662c9ba5f4150ab97dbbf0e540392aad55...a42289621e372763d5ef34067d5e38a0872fab15,1,5,0,5,1,2007-07-19 05:45:42,2007-07-19 05:45:42
a42289621e372763d5ef34067d5e38a0872fab15...5dc2cae6f4c5d7218c4323ceafb96ab8469be52e,1,17,68,85,9,2007-07-19 06:24:25,2007-07-19 06:24:25
5dc2cae6f4c5d7218c4323ceafb96ab8469be52e...4578c5cb690df98d0d5fbea043114b4b7dec8f57,2,81,11,92,5,2007-07-21 08:57:57,2007-07-21 08:57:57
4578c5cb690df98d0d5fbea043114b4b7dec8f57...60f7352fe1ae3d42ca7bd7611b6b787ff70cd813,1,5,5,10,5,2007-07-21 09:00:36,2007-07-20 06:13:24
60f7352fe1ae3d42ca7bd7611b6b787ff70cd813...f66b8a68f21d7dba6b80ba213315974476001b93,1,21,25,46,3,2007-07-21 09:00:37,2007-07-20 07:34:56
f66b8a68f21d7dba6b80ba213315974476001b93...eea1ab6e23db4c929500fb11464a438b0ba569f0,1,1,1,2,1,2007-07-21 09:00:37,2007-07-20 07:37:43
eea1ab6e23db4c929500fb11464a438b0ba569f0...dba07411da8debf9e39bf8d28f642b09c5794aff,1,3,1,4,1,2007-07-21 09:00:37,2007-07-20 07:56:06
dba07411da8debf9e39bf8d28f642b09c5794aff...54febd4fe62cc32b1337cd928af17a5a09624d74,1,11,3,14,3,2007-07-21 09:00:37,2007-07-20 08:10:13
54febd4fe62cc32b1337cd928af17a5a09624d74...854ffd3046ba9776934ffea79c5aceb1d51cf3c5,1,0,29,29,1,2007-07-22 07:08:34,2007-07-21 20:32:42
854ffd3046ba9776934ffea79c5aceb1d51cf3c5...7bd197c7ba0b93744bf0f804ec4fb0d448044e83,1,1,0,1,1,2007-07-22 08:09:53,2007-07-22 08:09:53
7bd197c7ba0b93744bf0f804ec4fb0d448044e83...e7d7b1a34ea3d3e4ee44471acbc97eda9bfffb55,1,2,2,4,2,2007-07-23 04:12:30,2007-07-23 04:12:30
e7d7b1a34ea3d3e4ee44471acbc97eda9bfffb55...9c5a3c7797449e1b3e6455327394677c21f0f908,1,1,1,2,1,2007-07-23 04:20:04,2007-07-23 04:20:04
9c5a3c7797449e1b3e6455327394677c21f0f908...83751fc109e951a5cbde9ee39970f6b1d2da07c7,1,11,9,20,3,2007-07-23 04:36:39,2007-07-23 04:36:39
83751fc109e951a5cbde9ee39970f6b1d2da07c7...a8139888f8d250c6d173ddbe892e98fc49763702,1,11,2,13,3,2007-07-23 05:11:08,2007-07-23 05:11:08
a8139888f8d250c6d173ddbe892e98fc49763702...7d5266a704ea55b11799bf0431d1648282f53d54,1,16,14,30,3,2007-07-23 05:28:35,2007-07-22 08:49:06
7d5266a704ea55b11799bf0431d1648282f53d54...30d1990584301132892e9f184bff9705f74a1565,1,6,0,6,3,2007-07-25 08:23:09,2007-07-25 07:27:57
30d1990584301132892e9f184bff9705f74a1565...844c3f6fe9d4d2bdc4e76f6a3bf3dfe86ce8c544,1,230,6,236,8,2007-07-25 08:23:20,2007-07-25 08:13:00
844c3f6fe9d4d2bdc4e76f6a3bf3dfe86ce8c544...becafaace69980d2980802432e86e7873317a4b6,1,33,1,34,3,2007-07-25 08:23:20,2007-07-25 08:20:02
becafaace69980d2980802432e86e7873317a4b6...350a35f0a17af071af3f6f76d9fc6f63265b23d2,1,11,70,81,7,2007-07-25 08:23:31,2007-07-25 07:44:50
350a35f0a17af071af3f6f76d9fc6f63265b23d2...9feefbd2d285f9af629cff9075eff06cf33d9de9,1,9,5,14,5,2007-07-25 08:32:18,2007-07-25 08:32:18
9feefbd2d285f9af629cff9075eff06cf33d9de9...ead49f5a4f6c87e5dc61ed5daaeda1bae7644d05,1,28,4,32,3,2007-07-25 08:54:53,2007-07-25 08:54:53
ead49f5a4f6c87e5dc61ed5daaeda1bae7644d05...bc318ea86d3ecd4074ecde3122b1e65f84cf9996,1,3,0,3,1,2007-07-25 09:02:38,2007-07-25 09:02:38
bc318ea86d3ecd4074ecde3122b1e65f84cf9996...1e0a92fdf74caa0bf850f73e284818473c8f76e0,1,3,2,5,1,2007-07-27 06:30:15,2007-07-27 06:30:15
1e0a92fdf74caa0bf850f73e284818473c8f76e0...360cc106e76ea2a4ba424905c4924e9ed6a4165d,5,18,14,32,13,2007-07-29 07:09:07,2007-07-28 20:17:10
360cc106e76ea2a4ba424905c4924e9ed6a4165d...94a4dd9bfda79a226f8dd57fd20c39c6603ec194,1,4,0,4,1,2007-07-29 07:22:27,2007-07-29 07:22:27
94a4dd9bfda79a226f8dd57fd20c39c6603ec194...0fe055cd2480763393b20676a10fd0bea56b2fc2,1,12,4,16,6,2007-07-29 08:07:13,2007-07-29 08:06:51
0fe055cd2480763393b20676a10fd0bea56b2fc2...95af4d8de16e8e681c196fce6d42e40909933115,1,4,0,4,1,2007-07-30 03:44:51,2007-07-30 01:26:42
95af4d8de16e8e681c196fce6d42e40909933115...37e2199c4c5b45e060f973097d814726cabe2a86,1,6,0,6,3,2007-07-30 03:44:51,2007-07-30 00:29:52
37e2199c4c5b45e060f973097d814726cabe2a86...dac70892638d08f50c49c539155c4cb54a9b9c28,2,18,30,48,6,2007-07-30 03:44:52,2007-07-30 01:19:54
dac70892638d08f50c49c539155c4cb54a9b9c28...84f67537b13bf0a959b1cad50b0d490071dc921a,1,3,3,6,2,2007-07-30 03:44:52,2007-07-30 00:21:54
ea6e82c875a110f93d43cb246b76c55fb8c57de6...627736ca799edacf13881da7e671964a0afb94b8,2,6,1,7,2,2015-01-21 01:35:41,2015-01-21 00:54:58
7ba46269a04de20032bd2dd614be6290cd65caab...290c8e7a3fe182ff64c3e6b76fbbbc6dcff4727c,3,45,0,45,5,2015-01-12 19:10:19,2015-01-11 20:09:22
7ba46269a04de20032bd2dd614be6290cd65caab...a2681d2bacaf01cb769363ada8fd87507ee7b08f,1,1,1,2,1,2015-01-10 00:23:41,2015-01-09 07:48:40
7ba46269a04de20032bd2dd614be6290cd65caab...50fea42ef5202673c80600555f1308a9b3150471,1,0,3,3,3,2015-01-10 00:16:56,2015-01-09 10:12:33
50fea42ef5202673c80600555f1308a9b3150471...10aff315f60847b9d155fce3134593b534b2ea5d,1,0,4,4,2,2015-01-10 00:18:35,2015-01-08 18:56:06
7ba46269a04de20032bd2dd614be6290cd65caab...4dbe66464b4fd695c5989cc272fa0edd6475037c,1,10,0,10,4,2015-01-08 03:48:19,2015-01-08 00:29:20
7ba46269a04de20032bd2dd614be6290cd65caab...fe7611c46f34cc4164a719a94e88e13ca5c978b1,1,72,0,72,1,2015-01-08 03:45:05,2015-01-07 20:32:11
fe7611c46f34cc4164a719a94e88e13ca5c978b1...339de5089115b6d8d85c73c1b8d2aa281e9625d2,2,3,3,6,3,2015-01-08 03:45:05,2015-01-07 20:32:12
9b7cbb315923e61bb0c4297c701089f30e116750...2aa590cb0761818fec9198ba4a1854310e1e0bf1,1,9,8,17,1,2014-12-22 18:02:38,2014-12-19 16:24:20
2aa590cb0761818fec9198ba4a1854310e1e0bf1...69d84a3b58464f1a60a1f93642ecd727a26067fa,1,3,2,5,3,2014-12-22 18:02:46,2014-12-19 16:24:21
69d84a3b58464f1a60a1f93642ecd727a26067fa...3a77c2096d102e43afb7a145c938b68c83f065ab,1,2,2,4,2,2014-12-22 18:03:24,2014-12-19 16:24:22
3a77c2096d102e43afb7a145c938b68c83f065ab...1679acdbff6443e07cd880048598d8de45663370,1,9,7,16,1,2014-12-22 18:03:37,2014-12-19 16:24:23
1679acdbff6443e07cd880048598d8de45663370...32c239d1fb23d47aa95cc8a47f99dc25f152021d,1,11,12,23,1,2014-12-22 18:03:37,2014-12-19 16:24:24
9b7cbb315923e61bb0c4297c701089f30e116750...bef111d0a5e4b5dcac07f92b0fc918bb31184066,1,1,1,2,1,2014-12-22 17:57:42,2014-12-19 08:37:47
9b7cbb315923e61bb0c4297c701089f30e116750...c376d96825d31ef1dc3dea185eb5401453604cc3,1,6,6,12,2,2014-12-22 17:56:25,2014-12-18 01:08:15
48a9a6b5ebda97cbb30ba3fbdf4ebb028220c817...105979f71cc69528eaf31a98ceb4e13295dec87a,1,124,124,248,121,2015-01-18 03:26:57,2015-01-18 03:26:57
c18b86734113ee2aeb0e140c922c8fbd4accc860...b0f4c9087e1e016667e34c6c413c57435e591b45,2,4,0,4,2,2014-12-11 22:13:17,2014-12-08 07:47:06
c18b86734113ee2aeb0e140c922c8fbd4accc860...97f05f43dc73f2855eb4c6acd1ea49d6d6bc4bce,1,3,1,4,2,2014-12-10 21:17:38,2014-12-10 18:16:44
c18b86734113ee2aeb0e140c922c8fbd4accc860...8e9faf27c11d515b2eef526f2a15c1c2a4ac8d4e,2,52,18,70,13,2014-12-10 21:09:21,2014-12-10 09:47:02
c18b86734113ee2aeb0e140c922c8fbd4accc860...83c9433e679635f8fbf8961081ea3581c93ca778,3,181,1,182,10,2014-12-09 22:03:15,2014-12-07 10:47:23
652e759330da379a8e09e03bbf99e03c10c228cc...ae1dcc52c1d4189f21dd59ae6f93ff4582727ce4,1,9,9,18,9,2014-11-28 18:08:50,2014-11-23 15:19:49
652e759330da379a8e09e03bbf99e03c10c228cc...a2b450d6fd8ad94881b257cda86cf90c1ec55385,1,52,51,103,38,2014-11-26 21:18:04,2014-11-21 23:10:04
a2b450d6fd8ad94881b257cda86cf90c1ec55385...b260d265e189728b26e50506ac6ffab6a7d588da,2,6,1,7,2,2014-11-26 21:18:34,2014-11-26 21:18:34
652e759330da379a8e09e03bbf99e03c10c228cc...452dfbed1a80754bfdc52567d9d9dba08a7d0a6d,6,73,1,74,12,2014-11-25 23:24:55,2014-11-25 14:00:55
452dfbed1a80754bfdc52567d9d9dba08a7d0a6d...a078f7321b02eb945b63804a80b0ba52c9da4ed3,3,53,2,55,10,2014-11-25 23:27:01,2014-11-25 14:00:56
652e759330da379a8e09e03bbf99e03c10c228cc...bb29456c89599acfc3ef3046e6a55ce0f48c9865,1,19,6,25,8,2014-11-25 22:00:14,2014-11-25 14:00:26
bb29456c89599acfc3ef3046e6a55ce0f48c9865...8d8140843501107c92e2f9a5acb60ee136352c1f,5,208,0,208,10,2014-11-25 22:00:15,2014-11-25 14:00:27
652e759330da379a8e09e03bbf99e03c10c228cc...fc66505c53f1a471e63b6122b2d629daca6e705b,1,10,0,10,2,2014-11-25 00:04:12,2014-11-24 21:22:02
fc66505c53f1a471e63b6122b2d629daca6e705b...63226218ba39e971c8a75d9419a7668b075ad85e,1,7,13,20,5,2014-12-04 23:10:21,2014-11-25 03:44:14
63226218ba39e971c8a75d9419a7668b075ad85e...f8c4ab611ac5b714b6b4fd296c59512f97f87195,2,1,9,10,2,2014-12-04 23:10:27,2014-11-24 21:22:04
3f78278beb9792368de7edbbb031c3a88e0038a1...e00e13e2aa5e94dc77dedb8f2026198300c7c8fe,1,0,1,1,1,2014-11-21 19:27:37,2014-11-21 19:17:57
e00e13e2aa5e94dc77dedb8f2026198300c7c8fe...1b6a53431c0ffba4fb2428ef09018a5e889f52f8,1,5,14,19,9,2014-11-21 19:27:53,2014-11-21 01:20:27
1b6a53431c0ffba4fb2428ef09018a5e889f52f8...c41d3fedd8a5dec2c2c991822b70b91c50ca047e,1,2,0,2,1,2014-11-21 19:27:53,2014-11-21 01:20:28
c41d3fedd8a5dec2c2c991822b70b91c50ca047e...98a260220c9b464dbefce1a23e4c89ed7b6ccb4d,1,5,11,16,6,2014-11-21 19:27:53,2014-11-21 01:20:29
98a260220c9b464dbefce1a23e4c89ed7b6ccb4d...1e86d5b11dcf31adf11363caa1e96a94612b16f4,3,0,3,3,3,2014-11-21 19:27:53,2014-11-21 09:03:10
bb831db6774aaa733199360dc7af6f3ce375fc20...18d0fec24027ac226dc2c4df2b955eef2a16462a,1,64,1,65,2,2015-02-11 21:54:03,2015-02-11 21:54:03
f745acb028ee8f7dcd1c8f10127b8feeaa255cf7...f1a35295c2b66d2501f034d864afb2c5d8bb0e08,2,31,11,42,11,2014-11-06 00:24:27,2014-11-05 14:29:21
d07a63e47ccfb9fb97666d4f189b88807a9f44fa...5331bfd78554aa9ec0ab94bc43c449cf55a0591d,1,1719,1468,3187,1374,2014-11-01 19:17:37,2014-11-01 19:17:37
d07a63e47ccfb9fb97666d4f189b88807a9f44fa...f507e5dd62c05bdb6c037c76621a09c0c2a8d798,1,1721,1478,3199,1380,2014-11-01 15:51:49,2014-11-01 15:29:19
d07a63e47ccfb9fb97666d4f189b88807a9f44fa...4dcd03eaee42d991a5b27b2432e64c496593735f,1,1777,1529,3306,1425,2014-11-01 02:07:24,2014-11-01 02:07:24
fbecd99861ea5795aeba46faf2ac7a8c1b70d485...8828f2985f1967201c256fb01f92a91acfdb5001,4,4,4,8,4,2014-10-28 21:56:17,2014-10-28 20:52:34
8828f2985f1967201c256fb01f92a91acfdb5001...5e626b91d4a5d2cfee8747facd53d7661f1f9112,1,37,27,64,3,2014-10-30 21:45:52,2014-10-30 17:45:41
5e626b91d4a5d2cfee8747facd53d7661f1f9112...e8eb25122e2cf966bf774fd0e3596d1b3dc93be6,1,35,24,59,7,2014-10-30 21:51:47,2014-10-30 18:01:37
e8eb25122e2cf966bf774fd0e3596d1b3dc93be6...d9362ef9b91ea2dccc80553dbcb37dc6c5d78548,1,58,39,97,7,2014-10-30 21:52:45,2014-10-30 21:35:24
fbecd99861ea5795aeba46faf2ac7a8c1b70d485...abfef3bbf5f637c86032763632393ce1ffd23ccc,1,72,12,84,13,2014-10-24 22:55:26,2014-04-17 06:54:05
abfef3bbf5f637c86032763632393ce1ffd23ccc...9ee13a934e21380ff6082d98a86cab5e890418dc,1,13,16,29,2,2014-10-24 22:55:29,2014-04-17 06:54:06
9ee13a934e21380ff6082d98a86cab5e890418dc...d0b34f241dc59fe2352cb1a724d0c5e8f0d2ff82,1,15,13,28,9,2014-10-24 22:55:35,2014-10-19 04:08:31
d0b34f241dc59fe2352cb1a724d0c5e8f0d2ff82...54b95346c1322bb122e12aba0f03652f241a918b,1,8,14,22,5,2014-10-24 22:55:39,2014-10-20 01:02:53
54b95346c1322bb122e12aba0f03652f241a918b...2b6c613f1a873555475050bd8f5a22828f0d03a3,1,9,21,30,2,2014-10-24 22:55:43,2014-10-21 06:23:22
2b6c613f1a873555475050bd8f5a22828f0d03a3...f947ae4b655b5354ca2a7c2456e04d6567921160,1,4,0,4,1,2014-10-24 22:55:48,2014-10-09 22:49:59
f947ae4b655b5354ca2a7c2456e04d6567921160...dfa72fdb96befbd790f623bb2909a347176753c2,1,13,8,21,4,2014-10-24 22:56:06,2014-10-24 22:53:52
dfa72fdb96befbd790f623bb2909a347176753c2...6725ecaba7af16c69591e5a180acbc521e2bba63,1,0,4,4,1,2014-10-25 07:56:28,2014-10-25 07:56:11
6725ecaba7af16c69591e5a180acbc521e2bba63...aee7d04c126b48a9871309ec65cecf88781b1d32,1,1,1,2,1,2014-10-25 07:56:33,2014-10-25 07:56:12
aee7d04c126b48a9871309ec65cecf88781b1d32...7676aff70973e617c3f58a8633db6d0e3ee99e45,1,0,10,10,3,2014-10-27 01:39:39,2014-10-27 01:39:39
7676aff70973e617c3f58a8633db6d0e3ee99e45...822aaf0f0865299d6cd3a6866e8047638e3f898c,1,4,1,5,2,2014-10-29 19:59:23,2014-10-29 19:31:55
822aaf0f0865299d6cd3a6866e8047638e3f898c...835e3ddeff2ae75b1fe71388686d44c536f2ed55,1,36,27,63,4,2014-10-29 19:59:25,2014-10-29 19:55:02
835e3ddeff2ae75b1fe71388686d44c536f2ed55...4ae9a7b966e61d25605b575163964f8375e37c9a,1,4,6,10,4,2014-10-30 08:29:43,2014-10-29 20:10:29
4ae9a7b966e61d25605b575163964f8375e37c9a...da0bc948ac2e01652a150fd4a57cebad6143242c,1,2,4,6,2,2014-10-30 08:31:28,2014-10-30 08:31:28
da0bc948ac2e01652a150fd4a57cebad6143242c...7ffa35b0479dac547659f06b8a6ea7d31c57cc05,1,11,1,12,1,2014-10-31 10:34:54,2014-10-31 10:34:03
382000769477ed0666e99d01c21df64df9ba0911...ac34efcf214269201849a1ca32ab86614bfe4c8b,1,1,1,2,1,2011-03-13 08:06:25,2011-03-12 16:23:23
ac34efcf214269201849a1ca32ab86614bfe4c8b...f0c9fe050474e0f2a947366a82a62efd6afbf2ce,1,16,0,16,2,2011-03-13 08:06:25,2011-03-12 16:24:49
cf7b1cad0e8b024538de975dff5893262cec72d7...c597ba801048be45d168b1f6335e91bab165448f,1,35,35,70,2,2011-02-07 23:05:46,2011-02-05 14:03:01
c597ba801048be45d168b1f6335e91bab165448f...c4d9986f5f35c22010ed6dd58351b89fd4ee0def,1,8,0,8,2,2011-02-07 23:05:48,2011-02-05 14:03:02
c4d9986f5f35c22010ed6dd58351b89fd4ee0def...cf548cacdd0c553b6524969d0d3fd5e787efeb3c,1,1,2,3,1,2011-02-07 23:15:17,2011-01-05 00:36:34
cf548cacdd0c553b6524969d0d3fd5e787efeb3c...7811d9600f02e70c9f835719c71156c967a684f7,2,9,2,11,3,2011-02-07 23:19:09,2011-02-07 22:24:54
cf7b1cad0e8b024538de975dff5893262cec72d7...c879daa23729547fb28aa7e8783c5e4e619a9e7c,5,63,10,73,14,2011-02-07 23:05:25,2011-02-05 10:52:21
208247adb9fc3702f87c6ec3fc26bd85d10d73e6...df5d43be1f721b0ede37097b815463ceb43b0449,1,7,6,13,2,2010-12-01 21:16:39,2010-12-01 19:15:59
6e97ef31ce20ff93a4cc0e3c6ab5171fd6dda5f3...0cb6ad3c3d8e9c738686ef8dc6f173f725e509bc,2,72,10,82,5,2011-01-11 21:14:56,2011-01-11 20:00:38
6e97ef31ce20ff93a4cc0e3c6ab5171fd6dda5f3...b393515f8ef43d5e873502dd80205233933389a1,1,0,0,0,0,2011-01-09 07:34:02,2011-01-07 01:14:41
f2665ec9fa42b75d92d0301cff85362836c5729a...3ce19eb857c46727239eda3b3dd265d725ea8ddd,1,4,3,7,4,2011-01-04 23:58:57,2010-12-30 21:20:28
3ce19eb857c46727239eda3b3dd265d725ea8ddd...3ca7353cab4ed6c7efac0c8d7477c87112fc7350,1,1,2,3,1,2011-01-04 23:59:26,2010-12-30 21:20:29
f2665ec9fa42b75d92d0301cff85362836c5729a...3aa30471065b212ee6563f3bfcb2de92a2bf2fa9,1,21,17,38,8,2011-01-04 23:31:04,2010-12-30 19:44:48
bb2ba06fd3e325d377dd011242714fe6b1a112bc...33a54e7d9aabe5c0b03c2bf87f02a7a6d6e2d38f,1,442,46,488,33,2012-08-07 16:41:18,2012-08-02 16:06:12
bb2ba06fd3e325d377dd011242714fe6b1a112bc...e5e38ce485342e924c6554eda163acc9e1890982,1,10,8,18,6,2012-08-06 17:10:34,2012-08-06 17:10:34
d2d434beeb03e4ee648ca7ca2a1ea1ed09077306...7ed863a85a6ce2c4ac4476848310b8f917ab41f9,3,11,3,14,4,2011-01-31 03:02:37,2011-01-30 19:53:13
d2d434beeb03e4ee648ca7ca2a1ea1ed09077306...a1cdc251728b4a2553e38a5427851b14643c7649,1,10,3,13,7,2011-01-27 20:58:10,2011-01-26 20:46:55
a1cdc251728b4a2553e38a5427851b14643c7649...ea6f0a23ac63b3a19202db5441704e3d79236ad4,1,12,6,18,5,2011-01-27 20:58:15,2011-01-26 21:01:54
adf872e7837cc92e390f00ee32f32c5639d3a444...8d96e7288f2be9de6d09352dc445f18f89564500,37,668,0,668,37,2011-01-18 16:51:58,2010-12-18 16:17:54
8d96e7288f2be9de6d09352dc445f18f89564500...664d44ee7fb18bdfdd66a1be760c7ee1bbe911c6,1,16,24,40,14,2011-01-18 16:59:39,2011-01-11 21:48:50
664d44ee7fb18bdfdd66a1be760c7ee1bbe911c6...5094d158741f0f62d69bba8e07dcdb6308528888,1,205,245,450,70,2011-01-18 17:02:23,2011-01-11 21:49:57
5094d158741f0f62d69bba8e07dcdb6308528888...5269edf1702b7375a287d5bbbb3c1b1f3a8aa765,4,58,0,58,4,2011-01-18 17:44:22,2011-01-18 17:43:43
adf872e7837cc92e390f00ee32f32c5639d3a444...dded4f12a46274753439e3a8fa4eb756c5d14ae1,3,72,3,75,7,2011-01-18 15:07:01,2011-01-15 06:31:46
adf872e7837cc92e390f00ee32f32c5639d3a444...4fb40c2b8206f7bdffedd8d58d2f9c031227b01b,1,3,6,9,2,2011-01-16 04:34:14,2011-01-16 01:08:42
4fb40c2b8206f7bdffedd8d58d2f9c031227b01b...898243b82db862867106854ad10794e74c215e49,1,1,1,2,1,2011-01-18 18:15:59,2011-01-16 02:16:05
898243b82db862867106854ad10794e74c215e49...60a2e3320f3030d7c1f453a8cadafad7012fd820,1,4,4,8,2,2011-01-18 18:18:25,2011-01-16 03:49:40
60a2e3320f3030d7c1f453a8cadafad7012fd820...5ee5f5a65d5a60cd327f1a4b92ee0f48508f2362,1,1,1,2,1,2011-01-19 00:48:47,2011-01-11 18:17:21
5ee5f5a65d5a60cd327f1a4b92ee0f48508f2362...e5959106d613fe5897ce3e02f573dda266f7c700,1,2,3,5,2,2011-01-19 00:51:13,2011-01-16 02:22:35
e31b0183729cab2d6a8e2c76f009017355dacf06...375f8a032e9f47d362afd5ea2443f77bcba685cb,2,34,1,35,2,2011-05-13 17:57:09,2011-05-13 17:57:09
bf0c5bbe2566d756d7468331161461ea9fec3b1f...be919d50c08fbe3a0653d6ba778b73f4940705ca,1,15,2,17,5,2011-03-27 03:17:15,2011-03-27 03:17:15
be919d50c08fbe3a0653d6ba778b73f4940705ca...8cc299daf29c6726acada3ffad87c3fe2098aa02,1,2,1,3,1,2011-03-28 16:46:44,2011-03-28 00:38:15
8cc299daf29c6726acada3ffad87c3fe2098aa02...cea13a8d685802389fad5b1ffce3af38175a8a01,1,2,0,2,2,2011-03-28 17:54:54,2011-03-28 07:39:59
cea13a8d685802389fad5b1ffce3af38175a8a01...730477f199489d61b960633501c390e03f04cba9,1,10,1,11,1,2011-03-28 21:08:36,2011-03-28 19:16:09
ccef6048cd697063967e5e02937911fd8125b364...b6194678b0eebdaf36d41e894b484206810f8221,2,9,6,15,4,2011-08-29 06:47:55,2011-08-25 18:29:57
ccef6048cd697063967e5e02937911fd8125b364...f877fd825e97a5e851b655e6fde5e796f53fc03e,1,1,1,2,1,2011-08-25 21:42:11,2011-08-25 15:40:50
f877fd825e97a5e851b655e6fde5e796f53fc03e...cd2b8ae983a277fb3f3c2b2c6747b0a075af1421,4,4,4,8,4,2011-08-25 21:47:07,2011-08-25 21:46:52
ccef6048cd697063967e5e02937911fd8125b364...11432bb467c2ba45014fc2fe8c4e23c92b7356d6,1,5,2,7,2,2011-08-25 20:16:46,2011-08-25 10:26:37
f384a2edd62dfc4af0f051dc8248506cebb265f9...e5b8eebc03f80bc21877494ae2ac0c2b63a1b83b,1,2,1,3,2,2011-10-26 21:05:47,2011-10-26 19:13:09
f384a2edd62dfc4af0f051dc8248506cebb265f9...cdf055376907cfa7837e576db219a1a7617df276,1,5,4,9,1,2011-10-26 18:35:49,2011-10-25 17:25:20
cdf055376907cfa7837e576db219a1a7617df276...1487a12ba228c6003f503366f40840eee9887179,1,23,5,28,2,2011-10-26 20:09:04,2011-10-26 18:45:15
1487a12ba228c6003f503366f40840eee9887179...764161391f2dd3fc12a5bec1385e0ab40dd90fd6,1,3,7,10,1,2011-10-26 20:09:23,2011-10-26 19:15:51
0af53e188a3a8915f65c3b3edaeed3e07d8d3802...b91766295f2b873bbd4ef79c06de05aff27f8e12,1,36,3,39,9,2011-08-11 19:12:22,2011-08-11 19:12:22
4cc6260684207865344f5b9a7065284d564d4e61...62270f6b0a4e67e5044fb0d70d0e82ac6e553eb2,1,1,1,2,1,2011-02-27 08:29:58,2011-02-26 03:29:42
5765870d531913310e4a1980aa6256003d1decae...d2559f734bba7fe5257720356a92f3b7a5b0d37c,1,1,1,2,1,2010-12-28 19:27:12,2010-12-22 23:58:53
48e0ad033ffd009df1283858ac70ac53660e2d7c...19128d6cd808800ffc6f14775315e77ece8b8fc7,1,2,0,2,2,2010-12-23 03:56:02,2010-12-22 23:58:51
92b7aacbbc654de4cfae6806bc92cf81ec1823aa...a46034819ecce6872bff099f3d75589f4d38c00c,4,28,3,31,5,2012-03-12 22:52:52,2012-03-12 22:52:52
c0eb9ccfb97297e25ccbab0481159282147b353f...66c11f02b031aca6f1756086fefdf4b8a5575c56,4,21,3,24,5,2011-12-14 05:55:31,2011-12-14 05:55:31
5fbdb9c2e8cc7226d9a9e7de5ad09ac5f0a0b906...ec245ba04944473ba6657a826643ef90ed02b51d,2,35,5,40,20,2012-01-23 19:50:22,2012-01-20 07:47:35
65f13f20bccc71cf6599e9ad6b2ed0cc2312f416...d02244360465f5748fc85e7bc111dbc6269691da,1,2,0,2,1,2011-05-04 21:52:30,2011-05-04 19:58:17
8e848868fff625a8dda92fb11edf2b7975827e1a...9db31bdf5c834689c826f809d6d15bf7ab8d3598,3,36,7,43,7,2011-04-04 17:50:50,2011-04-01 09:42:03
8e848868fff625a8dda92fb11edf2b7975827e1a...9029ebbe118dddfccae0dcbb921722257aef2ecd,1,19,5,24,4,2011-04-04 16:33:05,2011-04-01 19:06:28
9029ebbe118dddfccae0dcbb921722257aef2ecd...d424a47e3400ef597a6f4f3c56ee67290f7c6052,1,1,1,2,1,2011-04-04 17:25:21,2011-04-04 14:59:25
f80b6de4eca9c4c4abfe9407736311de27726e53...6abd9332f97441a568421ba233ad8929b50a7efc,2,55,1,56,7,2010-12-09 20:09:48,2010-09-25 03:51:50
6abd9332f97441a568421ba233ad8929b50a7efc...7d79cb6ad5ef3061c8b5b25ff3f2d779b02ec472,1,1,3,4,2,2010-12-09 20:18:03,2010-12-09 19:53:19
9018af4f98b98738f3cd1268a16d143762ebb6f2...dd15c7fffc9d357956df20a656b55e89db8c6f64,1,0,0,0,0,2010-10-06 19:13:20,2010-10-06 19:13:20
dd15c7fffc9d357956df20a656b55e89db8c6f64...8520913cc53e03dcc4b4395cdf500ab8e60ed792,1,2,2,4,2,2010-10-06 20:45:18,2010-10-04 22:51:48
f7bff60de95951d2c82601350cb3771b347e83ee...8a90438506d3b7c8ef8bd802b7ed10c1f12da1d0,4,9,3,12,5,2010-10-22 00:14:32,2010-10-22 00:14:32
2f76919517e98bb5e979d6c8c7bbc3478a066a21...e14712c9e6801855a033ee1e7013f54580f270a1,1,4,4,8,2,2010-09-30 16:38:47,2010-09-30 15:31:43
e14712c9e6801855a033ee1e7013f54580f270a1...dbda967684dfefd0ac3518f9805ccf9ded9af429,1,14,38,52,4,2010-09-30 17:39:06,2010-09-07 01:50:17
dbda967684dfefd0ac3518f9805ccf9ded9af429...8713feb16dd6a472828bbdcf914a1c8f5c6810a2,1,6,2,8,1,2010-09-30 19:22:02,2010-09-29 22:22:32
8713feb16dd6a472828bbdcf914a1c8f5c6810a2...8695353147e0c20fc8197fd73efec2ca9bce0304,1,1,1,2,1,2010-09-30 19:22:02,2010-09-29 22:22:33
7c6eafa35af805578990e76b691ff7f1a25a3c57...64f003abd9fbb155a6331365c0783b926185882c,1,1,1,2,1,2010-10-18 23:12:09,2010-10-16 17:09:54
7c6eafa35af805578990e76b691ff7f1a25a3c57...d8d2eb7d6b5e48c2bcb0e71a770f8a05375ac03e,2,44,7,51,8,2010-10-14 02:11:26,2010-10-11 15:41:16
d8d2eb7d6b5e48c2bcb0e71a770f8a05375ac03e...bfdfa3d414539e78f049fceab46767f3a0281721,1,17,9,26,4,2010-10-18 23:08:00,2010-10-15 17:12:19
bfdfa3d414539e78f049fceab46767f3a0281721...3e3e1ef53285ceafd24bd88483c03a4cb604fe22,1,2,2,4,2,2010-10-20 06:32:06,2010-10-20 06:32:06
7c6eafa35af805578990e76b691ff7f1a25a3c57...9130ac9fe17831445690ebbb60f09b86f96516b3,4,16,6,22,4,2010-10-14 01:58:33,2010-10-07 18:25:43
7c6eafa35af805578990e76b691ff7f1a25a3c57...33f072f8910081b12780197a2a5423227e437af8,2,14,3,17,4,2010-10-14 01:31:45,2010-10-08 01:07:48
7c6eafa35af805578990e76b691ff7f1a25a3c57...01f6fd4b4e59bc131941d917138cdd2cc6662382,1,1,1,2,1,2010-10-08 20:17:10,2010-10-08 16:46:59
01f6fd4b4e59bc131941d917138cdd2cc6662382...537497be58850dc9c54281d0306b422ab604cdee,1,2,2,4,1,2010-10-13 18:13:09,2010-10-08 06:50:20
537497be58850dc9c54281d0306b422ab604cdee...bc979945305b87caf1e5975d30d42bafd88ad846,1,15,12,27,8,2010-10-13 18:15:14,2010-10-13 18:15:14
bc979945305b87caf1e5975d30d42bafd88ad846...69ae92bda13dfbf0b7d169c57b9f2715af2a9d67,6,23,23,46,15,2010-10-13 18:36:36,2010-10-13 18:36:36
69ae92bda13dfbf0b7d169c57b9f2715af2a9d67...9d83e3827fc1031bbcafb0d26128e95dda306aed,16,20,20,40,20,2010-10-14 02:10:55,2010-10-11 16:03:32
9d83e3827fc1031bbcafb0d26128e95dda306aed...ed84e6d511f9e754d6331c63468bf7421b1e0894,1,3,2,5,1,2010-10-14 02:10:56,2010-10-11 16:04:08
ed84e6d511f9e754d6331c63468bf7421b1e0894...b77134b068f777c9b63ebfb8762c77968c49702f,1,6,2,8,1,2010-10-14 02:10:56,2010-10-11 16:05:32
b77134b068f777c9b63ebfb8762c77968c49702f...24757702395ed4c828af585f2d8ba0efda5cf697,1,3,3,6,1,2010-10-14 02:10:56,2010-10-11 16:06:18
24757702395ed4c828af585f2d8ba0efda5cf697...352953a556e7f8d720e26a32d4aabbf823d3c4d4,1,6,3,9,2,2010-10-14 02:10:56,2010-10-01 18:57:52
7c6eafa35af805578990e76b691ff7f1a25a3c57...62b4698e551c29b3d2539a764ad0e93cfff53c03,27,118,118,236,78,2010-10-08 19:29:52,2010-10-08 17:31:15
62b4698e551c29b3d2539a764ad0e93cfff53c03...01398df31cd5a667faa005e85eb3c9aac66aaf44,1,2,2,4,2,2010-10-08 19:30:52,2010-10-08 18:40:32
01398df31cd5a667faa005e85eb3c9aac66aaf44...0adda9362ab080b0994355c5a3183a896a606cc0,31,33,33,66,33,2010-10-08 19:31:07,2010-10-08 17:31:17
0adda9362ab080b0994355c5a3183a896a606cc0...efc39d6daf6518dac346d2716bf6b1031f73aecf,2,3,3,6,2,2010-10-08 19:31:07,2010-10-08 17:31:18
efc39d6daf6518dac346d2716bf6b1031f73aecf...884220653f2abd381d94c5902e4cb0f237504d03,1,1,1,2,1,2010-10-08 19:31:08,2010-10-08 17:31:19
884220653f2abd381d94c5902e4cb0f237504d03...d0bb13663000be47d83cbe53b6c4bdc8835625cb,2,2,2,4,2,2010-10-08 19:31:08,2010-10-08 17:31:20
00648ba0505bbe1999bb6ae2f1d02a0ef923b191...a48fcd836971d065b9bf16b8cd046fd1aff9b279,84,166,166,332,148,2010-11-09 19:59:49,2010-10-31 01:46:54
a48fcd836971d065b9bf16b8cd046fd1aff9b279...2dec68cf8fec760930c3bc9d13beb17e381d70a3,13,48,48,96,44,2010-11-09 22:45:22,2010-10-31 07:30:58
2dec68cf8fec760930c3bc9d13beb17e381d70a3...fb3340a6a7a956debcac92cd21cbcaea0928048e,2,26,0,26,2,2010-11-09 22:47:17,2010-10-31 07:33:50
fb3340a6a7a956debcac92cd21cbcaea0928048e...cae3aa79aaa62f414c38a44b3073767b1def3a6b,1,92,190,282,15,2010-11-09 22:48:06,2010-10-31 07:34:44
cae3aa79aaa62f414c38a44b3073767b1def3a6b...2b5ec018458bd32f554d4395231680235104d8d8,1,1,1,2,1,2010-11-09 23:00:10,2010-10-31 07:35:49
2b5ec018458bd32f554d4395231680235104d8d8...598f0877aa36b5482734091ffef30e21b4e79803,1,2,3,5,1,2010-11-09 23:00:29,2010-10-31 07:36:19
598f0877aa36b5482734091ffef30e21b4e79803...0155a64e88ad65408f9ca6d988156aec0898863d,1,1,1,2,1,2010-11-09 23:00:43,2010-10-31 07:36:57
0155a64e88ad65408f9ca6d988156aec0898863d...391a825f5bd534063ac0dec42aa0159b67764ede,1,11,12,23,3,2010-11-09 23:01:18,2010-10-31 07:38:25
391a825f5bd534063ac0dec42aa0159b67764ede...99b028e5589702320630c094d510d885ac8c9e50,1,17,18,35,3,2010-11-09 23:01:44,2010-10-31 07:39:51
99b028e5589702320630c094d510d885ac8c9e50...5c947e2c386aea5c94546c7a40a0d4d7f7b3934a,1,9,15,24,4,2010-11-09 23:06:41,2010-10-31 07:40:30
5c947e2c386aea5c94546c7a40a0d4d7f7b3934a...56641f199cc30fa0649ee0e3fa102782ca251d04,1,2,2,4,1,2010-11-09 23:20:20,2010-11-09 23:20:20
56641f199cc30fa0649ee0e3fa102782ca251d04...33fc521193746a0961c270997dbb881b520ad793,1,2,3,5,1,2010-11-09 23:20:44,2010-10-31 07:41:08
00648ba0505bbe1999bb6ae2f1d02a0ef923b191...1dacfbcf13693dad508095735a95bc4b12382c57,2,14,0,14,2,2010-10-22 18:02:59,2010-10-22 06:42:58
1dacfbcf13693dad508095735a95bc4b12382c57...cf9d52e4899219523359ad1542605395c8c86337,2,27,0,27,2,2010-10-22 18:03:56,2010-10-22 06:44:01
cf9d52e4899219523359ad1542605395c8c86337...5d3dd915e64ea42ba6bf7646937784f6ddc71422,2,30,0,30,3,2010-10-22 18:04:52,2010-10-22 06:45:47
5d3dd915e64ea42ba6bf7646937784f6ddc71422...0c8151b6ff5b79e6638e4f8339d62b051998dc2f,2,31,0,31,2,2010-10-22 18:04:53,2010-10-22 06:47:19
0c8151b6ff5b79e6638e4f8339d62b051998dc2f...cbb3167ef8b73109ed5c5e54aa1915d9c50f83d5,2,42,0,42,2,2010-10-22 18:04:53,2010-10-22 06:48:14
cbb3167ef8b73109ed5c5e54aa1915d9c50f83d5...da53eec68873e76c68086e405f3f1329d47055b3,2,13,0,13,2,2010-10-22 18:04:53,2010-10-22 06:49:45
da53eec68873e76c68086e405f3f1329d47055b3...9c7c27eeab73b4c90cf36c6aa06ba6b8b9777629,2,35,0,35,2,2010-10-22 18:04:54,2010-10-22 06:51:00
1c6e3514d093377fec5e30aa02a119187cf743f2...e5af0de202e885b793482d416b8ce9d50dd2b8bc,3,6,2,8,4,2011-06-01 21:08:26,2011-06-01 21:08:26
40d675f417f7b0be7b9367752701bf6bc03db091...18a1d8953b9ee769761fa6a43c9bd6f76363421f,1,15,23,38,13,2010-12-14 16:09:56,2010-10-10 08:35:43
18a1d8953b9ee769761fa6a43c9bd6f76363421f...175659b4ccdf14aa8d9c0144c5ed1a143bdc9c01,1,51,0,51,3,2010-12-14 16:54:05,2010-10-10 08:38:58
175659b4ccdf14aa8d9c0144c5ed1a143bdc9c01...6838d1ad6b52c95c02de4c476aae2192050ac2c9,1,58,49,107,5,2010-12-14 16:55:10,2010-10-09 13:52:58
6838d1ad6b52c95c02de4c476aae2192050ac2c9...f7e3bd37fb9355ee036da4cf11d6e8186b506d5f,1,27,16,43,12,2010-12-14 16:55:11,2010-10-09 13:52:59
f7e3bd37fb9355ee036da4cf11d6e8186b506d5f...b1735b1ab7743700064af528a998cdc952c8b9a1,4,31,10,41,12,2010-12-14 16:55:12,2010-10-09 13:53:00
b1735b1ab7743700064af528a998cdc952c8b9a1...3055d78f97da105acfc0e207266e902251d2949f,4,38,42,80,27,2010-12-14 16:55:13,2010-11-15 19:52:19
3055d78f97da105acfc0e207266e902251d2949f...ada6a4117eb204fe14a83bc51daaf923cd8127ec,1,10,0,10,3,2010-12-14 16:55:52,2010-12-14 15:51:35
0137ef7dae553f9eb89cbae1ddb60b72046ba28b...a31d066524e55351b385e34f9494f36e9f960a6c,2,9,1,10,2,2011-01-09 07:36:37,2010-12-14 18:32:12
a31d066524e55351b385e34f9494f36e9f960a6c...906a9a7d1d86b9002813a531ab62f436e798b66b,1,3,1,4,2,2011-01-09 07:36:37,2010-12-14 18:34:29
906a9a7d1d86b9002813a531ab62f436e798b66b...a28adc2d79bdcc7c780dbe135969af1f914601a9,1,1,0,1,1,2011-01-09 07:36:37,2010-12-14 18:35:48
a28adc2d79bdcc7c780dbe135969af1f914601a9...5b5d53cbe5d67bd86543a4851014fde0837d1344,1,0,1,1,1,2011-01-09 07:36:37,2010-12-14 18:37:43
721e76cbfac650ce676fc789b717eb21e1daa46e...422bff280297b55aff6542cc5df1c078f37ab673,1,27,2,29,5,2010-08-05 08:51:26,2010-08-04 09:51:25
422bff280297b55aff6542cc5df1c078f37ab673...f46e130439a57ce44708971183adab7e58512b34,1,17,28,45,5,2010-08-05 08:51:26,2010-08-05 08:35:45
f46e130439a57ce44708971183adab7e58512b34...e9323e7f09d171739e8dbc9d60d77281caa06177,1,6,0,6,2,2010-08-05 08:51:26,2010-08-05 08:46:04
0d0ba03a18a9c6cbc3d55c1b6834b9c3824f823f...e37c1329fa86683c828f04b51bad8bae03939ced,3,9,0,9,4,2010-08-11 16:24:00,2010-08-06 02:40:35
e37c1329fa86683c828f04b51bad8bae03939ced...a60645f9c54c3050cbe25882feba9d5b3d1ca0d6,2,12,1,13,3,2010-08-11 16:24:00,2010-08-06 02:46:33
a60645f9c54c3050cbe25882feba9d5b3d1ca0d6...ee38dfb89ef88a3e4e6818b7cfe31d122a1c640d,1,9,4,13,4,2010-08-11 16:24:01,2010-08-06 02:52:16
ee38dfb89ef88a3e4e6818b7cfe31d122a1c640d...773b69bf7189f5babb26b899b4c35f604cd993c7,3,11,3,14,4,2010-08-11 16:24:01,2010-08-06 03:01:37
773b69bf7189f5babb26b899b4c35f604cd993c7...ff38d1a9953b3bce7741f8f962c5e067fda2d9ea,3,16,5,21,5,2010-08-11 16:24:26,2010-08-06 03:06:39
ff38d1a9953b3bce7741f8f962c5e067fda2d9ea...d1ea896290629185dc0bf4efa3469b410bd41313,3,7,4,11,5,2010-08-16 02:56:10,2010-08-16 00:36:12
d1ea896290629185dc0bf4efa3469b410bd41313...2cb60093e6c6b53cfc8ffe75f697386a1adab778,3,36,5,41,7,2010-08-16 02:57:33,2010-08-06 03:12:46
2cb60093e6c6b53cfc8ffe75f697386a1adab778...3ba7e6e29afd67e69ff5963d8ed76728824959a0,3,12,5,17,6,2010-08-16 02:57:41,2010-08-06 03:15:09
d6b634fafdb5570d9c25d5176d3d32fe0b22530d...9e70e15814d645b48e2ed892520b88122c992b30,1,1,1,2,1,2010-11-17 21:02:17,2010-11-11 12:26:08
9e70e15814d645b48e2ed892520b88122c992b30...60efa2451e46810bdf7da6a31758c779de8ff4f7,1,16,2,18,4,2010-11-17 21:02:17,2010-11-11 12:26:09
60efa2451e46810bdf7da6a31758c779de8ff4f7...9b3f3de16c4a3b8414e5d49f79dda343a4ec1511,1,7,4,11,3,2010-11-17 21:02:18,2010-11-11 12:26:10
9b3f3de16c4a3b8414e5d49f79dda343a4ec1511...00fa6fef631edeb5e0e34b7748c07882ec0e51d7,1,27,4,31,6,2010-11-17 21:02:18,2010-11-11 12:26:11
00fa6fef631edeb5e0e34b7748c07882ec0e51d7...11e7bece1559695faf72803ef8aa52c1d65350f9,1,16,3,19,4,2010-11-17 21:02:18,2010-11-11 12:26:12
11e7bece1559695faf72803ef8aa52c1d65350f9...c7d94cdbe7ed29a0e26645fa4bb30d87755d86aa,1,9,1,10,1,2010-11-17 21:02:19,2010-11-11 12:26:13
c7d94cdbe7ed29a0e26645fa4bb30d87755d86aa...bb60776063f0575c1a880cd606b7470e36a7cd86,1,26,4,30,3,2010-11-17 21:02:19,2010-11-11 12:26:14
bb60776063f0575c1a880cd606b7470e36a7cd86...0e65699992ddaf68d9d1c30ad8cd1e418cf1bc52,1,6,1,7,2,2010-11-17 21:02:19,2010-11-11 12:26:15
0e65699992ddaf68d9d1c30ad8cd1e418cf1bc52...b891d52a644e58a830091463911cb859499ae504,1,38,0,38,1,2010-11-17 21:02:19,2010-11-11 12:26:16
b891d52a644e58a830091463911cb859499ae504...9d0d42f3450fe34737f92b9bde31ac1cf6deeadb,2,152,20,172,12,2010-11-17 21:04:34,2010-11-11 12:26:17
9d0d42f3450fe34737f92b9bde31ac1cf6deeadb...fc5b8e0163fc9e37707d22dbc484a59040c48292,1,2,0,2,1,2010-11-17 21:04:52,2010-11-11 12:26:18
06de561830250f92e056b0a57bc52b27b13ba2ac...121f71f0da1bc9a4e1e96be2c3e683191a82a354,2,6,1,7,3,2012-06-03 22:53:58,2012-06-03 22:53:58
3ba46634202968045e05e4d7f969d97c61efa53d...5498c5f05283cd248fd5e4f48cb8902e9ca6ce28,1,14,18,32,4,2012-06-01 20:29:48,2012-06-01 20:29:48
770c54170a43ffb3810088a85f25c59c0cbf7b38...feb98d134289527eeb9d1fd11d8c284819a0aa1d,1,21,14,35,3,2010-06-02 18:16:48,2010-05-22 00:28:35
feb98d134289527eeb9d1fd11d8c284819a0aa1d...859c30175f7d8f64f61968cb3ece7aca9218b314,2,39,21,60,13,2010-06-02 18:17:46,2010-05-22 00:28:36
859c30175f7d8f64f61968cb3ece7aca9218b314...3631bf77f75bc34e810216f3ec6abc8203e2d16a,2,85,24,109,6,2010-06-03 21:46:14,2010-05-22 00:28:37
3631bf77f75bc34e810216f3ec6abc8203e2d16a...b2099957752071fec70502c81206364ac986073a,1,24,0,24,1,2010-06-03 21:46:19,2010-05-22 00:28:38
b2099957752071fec70502c81206364ac986073a...86e8e7a566c5546e58f56566d0181a08d60f919f,1,1,1,2,1,2010-06-03 21:46:19,2010-05-22 00:43:52
86e8e7a566c5546e58f56566d0181a08d60f919f...157aaea5fff7dbf2fc39829d827b35df647562a4,3,15,17,32,16,2010-06-12 16:34:17,2010-06-10 12:54:03
770c54170a43ffb3810088a85f25c59c0cbf7b38...f030c96d8643fa0a1a9b2bd9c2f36a77721fb61f,3,13,5,18,7,2010-05-25 16:04:24,2010-05-21 16:10:10
770c54170a43ffb3810088a85f25c59c0cbf7b38...638794cde08bb785410a92d293969949a1f5a846,5,134,105,239,9,2010-05-24 23:48:32,2010-05-23 09:17:55
638794cde08bb785410a92d293969949a1f5a846...9d2e942070b235e1f4a0b8dd4c55a6b3f0fe914a,2,19,1,20,4,2010-05-24 23:48:34,2010-05-23 09:19:44
16b3b2d969e88be50cb0eb9af3c56fcfcda38756...1844f8d591340bb43e4990c96afd0aba424adf48,1,0,1,1,1,2011-10-18 20:28:17,2011-10-06 04:21:33
b63103e908af54e5e2eaa3faad350e4738ef0047...11b17afc933446c3afdbed72afaa440348f2b0ff,2,221,1,222,2,2012-01-18 23:17:27,2012-01-17 22:52:24
2c177a1ca1b82ee6cbaa32521da75b8b1c137a73...6f426c74a4ba6805d6d30619429507aeb6ffbbea,1,41,12,53,14,2010-06-22 17:03:04,2010-06-22 17:03:04
da3efdb17bef25dedc753131462ee784d822132e...0e71bc300432b9e63bdbc8e28b0c5c0fafb601fc,1,2,2,4,2,2010-06-11 20:51:27,2010-06-10 18:43:51
da3efdb17bef25dedc753131462ee784d822132e...d4785cd11dd0a55e30a1185a96910f0e57b6049a,1,46,23,69,22,2010-04-20 05:19:30,2010-04-19 22:08:31
53b3c47d64b4294ae586d1daa04f9140dadd9ae6...d0c26f0f56444d93a08121bb1f3691b2bbbfb958,1,38,11,49,2,2010-04-19 01:19:22,2010-04-18 19:54:20
53b3c47d64b4294ae586d1daa04f9140dadd9ae6...7aa5d43cc6204efab0d2c2f4fbf46d2cfd350fec,1,1,1,2,1,2010-04-18 22:00:03,2010-04-18 18:28:05
7aa5d43cc6204efab0d2c2f4fbf46d2cfd350fec...2ba2fe292c13d6442456c1b8a1948bea27992953,1,150,0,150,1,2010-04-20 17:03:10,2010-04-18 18:27:49
53b3c47d64b4294ae586d1daa04f9140dadd9ae6...03aa87ed9912a6beac1a23e69ef0b70e1589d3d0,1,2,2,4,1,2010-04-18 20:43:53,2010-04-18 18:28:17
2be10bb5c1cfe15aa4f1b43137ccd17d826d8553...8e50175d945166c26f24827019882ee6607f65f7,1,1,1,2,1,2010-04-04 17:18:19,2010-04-04 13:12:16
8e50175d945166c26f24827019882ee6607f65f7...c8a97906bad44c83acfec33e7e0a3bb4b15a716d,1,4,4,8,2,2010-04-04 17:18:21,2010-04-04 13:12:17
b2ebbd8f1311608622ede7a1286839ef64edfc86...a4c24549acf16f7917ea3ddd811c6c61afc5689c,1,21,0,21,5,2010-06-22 16:33:03,2010-06-22 16:18:55
2927a507bf8080661ed84000ce55465941bd28a9...88202b9ce6ae09eaeb228104536ecf78ef50f0db,1,15,0,15,4,2010-06-30 22:49:18,2010-06-30 22:49:07
88202b9ce6ae09eaeb228104536ecf78ef50f0db...45e9a825edf9064ff76f6ff10357fdc79497f0eb,2,12,5,17,7,2010-06-30 22:49:18,2010-06-30 19:22:13
761a889a97a33d277f8a6607a4696164391f9d5d...e1e5ec868fab6f8131e8b228f1d6d543b7501933,1,6,0,6,1,2010-06-05 15:41:39,2010-06-05 08:04:20
225c93a3cac93e8c619e5c8af47d2a781eedcacd...d2c46310618ab0fefe4641b5a0d71899c918bf47,1,10,9,19,2,2010-06-02 16:51:39,2010-06-02 08:33:35
d2c46310618ab0fefe4641b5a0d71899c918bf47...dc267b1ab4f8f6ac33c9145c3e24fe3a96f1394b,1,2,0,2,1,2010-06-02 16:51:48,2010-06-02 08:33:36
dc267b1ab4f8f6ac33c9145c3e24fe3a96f1394b...92f65e6ab6185aae241d1388b54429d171a9d0f5,1,7,1,8,1,2010-06-02 16:53:45,2010-06-02 08:33:37
225c93a3cac93e8c619e5c8af47d2a781eedcacd...2bf1033478a65c1067e1a7922a91406c797852ed,1,8,2,10,2,2010-06-02 16:26:35,2010-06-02 00:13:40
2bf1033478a65c1067e1a7922a91406c797852ed...53dfac44c93d5861f0ab60fc38e1a2d3b67e8c62,1,6,6,12,3,2010-06-02 16:28:12,2010-06-02 00:13:41
53dfac44c93d5861f0ab60fc38e1a2d3b67e8c62...6f89384fe0c5a131d055c19fffe22f8d087a0a7e,1,2,2,4,2,2010-06-02 16:30:35,2010-06-02 00:13:42
6f89384fe0c5a131d055c19fffe22f8d087a0a7e...c289c315c2bfcd5fde99f9e4dbb109f89e29dfce,1,5,5,10,5,2010-06-02 16:33:36,2010-06-02 15:32:26
c289c315c2bfcd5fde99f9e4dbb109f89e29dfce...6508eedf670c180934db880b50a9a6b930acbf02,2,4,2,6,2,2010-06-02 16:36:49,2010-06-02 00:13:44
6508eedf670c180934db880b50a9a6b930acbf02...ae45732214a092baa8b78a5cea462e4a7a538165,1,1,0,1,1,2010-06-14 03:02:45,2010-06-09 21:23:59
ae45732214a092baa8b78a5cea462e4a7a538165...23b093ee087e99049585487f59e262a0e0662b6e,6,39,13,52,13,2010-06-14 03:02:50,2010-06-10 00:24:54
225c93a3cac93e8c619e5c8af47d2a781eedcacd...5853caec96a45ffa7768585acc649dc78eb99354,1,4,0,4,4,2010-06-02 16:15:38,2010-06-01 08:35:49
86c7bb47c76948bd1240a0db5b8dd88cf9db855d...127f04522292fc62152762405c92d6acca4dbcb5,2,27,7,34,4,2011-08-16 17:51:34,2011-08-14 15:22:04
127f04522292fc62152762405c92d6acca4dbcb5...03f622c81fed05bb571519beacb0eeaf595c65f4,1,3,5,8,2,2011-08-16 20:06:13,2011-08-16 18:27:39
86c7bb47c76948bd1240a0db5b8dd88cf9db855d...18c8ff46104302ea30e879a0f2cb5eefb94df1a4,1,7,7,14,7,2010-06-14 17:32:02,2010-06-14 05:28:50
18c8ff46104302ea30e879a0f2cb5eefb94df1a4...f873a273d1381574fd9b2f3f613c0c7e40fe3a1c,3,19,1,20,3,2010-06-25 15:55:48,2010-06-14 05:29:38
bb89e84f95a4885dffc9562137139a3ab4f1e05c...2429e8da954e5c006425bb7d418fe29db063db21,1,1,1,2,1,2010-08-05 16:49:49,2010-08-05 13:08:05
2429e8da954e5c006425bb7d418fe29db063db21...cfbe22f03f9be1f3bbbd33240dcb127099d4346e,1,25,17,42,2,2010-08-06 17:00:39,2010-08-06 03:36:07
cfbe22f03f9be1f3bbbd33240dcb127099d4346e...49cc460d88f5bae79b45ce2db16674f36b6cf38a,2,19,0,19,3,2010-08-06 17:01:45,2010-08-06 03:39:22
49cc460d88f5bae79b45ce2db16674f36b6cf38a...3c8710aeaa81a70ecad9facfc332d843ee37de35,1,2,1,3,1,2010-08-09 16:15:01,2010-07-29 15:10:22
3c8710aeaa81a70ecad9facfc332d843ee37de35...08b29826457ed84f02cce3d8e2a2d58e16064751,1,10,0,10,2,2010-08-09 16:15:41,2010-08-03 18:41:50
08b29826457ed84f02cce3d8e2a2d58e16064751...cf958afd8368ebce1cabb2f7ae2799306cc2de03,2,31,6,37,5,2010-08-09 16:16:11,2010-08-05 16:14:25
cf958afd8368ebce1cabb2f7ae2799306cc2de03...e93487d2f007176804e89042f9f199628e45c864,2,5,2,7,3,2010-08-09 17:12:50,2010-08-06 20:28:09
87a074df2455f305df8facc22e85dac1cfeb0d6b...3368edd4cda6306d524e10758e2c5a187dcd4ba6,1,1,1,2,1,2010-05-12 06:04:23,2010-05-12 03:29:20
cdb791f61d71db24fa54363ff6d4b42a46ebbdf1...2f633f41d69527cdd9ff5b8e04a752f1774fc3df,2,9,3,12,5,2011-08-25 20:39:38,2011-08-25 19:19:24
2f633f41d69527cdd9ff5b8e04a752f1774fc3df...f3738c1ce9193a4bf45ba1a3ea67d0cf32da0257,2,4,1,5,2,2011-08-27 18:47:49,2011-08-27 04:12:44
cdb791f61d71db24fa54363ff6d4b42a46ebbdf1...565e135a1e5fc393f764415a4724f43cc07f4da6,7,7,7,14,7,2011-06-29 16:24:26,2011-06-29 05:35:10
5b42477b59886a85d4b49a60313f9b9d4a0d576f...8e4414edde857a90ce90bb542811f1c22071f16f,1,3,3,6,2,2011-05-30 19:55:16,2011-05-30 15:52:56
5a6d82d0865a616bf22b9bbc3baea1ad4bd4b21b...3c3e0b3c41f4c975828cf51d661614e45bf80dc0,4,36,3,39,5,2011-05-26 17:29:29,2011-05-26 16:45:29
6e67619d0cdc175557ca633dec391d4e795cf965...ac5ad864c2fdd3e354ac72e09e7cfec1df6eae79,1,1,1,2,1,2010-12-19 18:49:34,2010-12-19 03:53:58
7ca56aa07619b0345b643e52ae8e616cbaafc187...bc84a7fbac4ce85bb93eeb57b5cb39548d286ad0,1,34,36,70,15,2010-04-01 18:14:09,2010-03-31 19:22:04
bc84a7fbac4ce85bb93eeb57b5cb39548d286ad0...ae8c79fd8fe47bfebf56ae83461cbedb934cff92,1,58,48,106,6,2010-04-01 18:14:10,2010-03-31 19:22:05
ae8c79fd8fe47bfebf56ae83461cbedb934cff92...3f9083cde3b434155c274168f166ffce2bb243e7,1,45,36,81,5,2010-04-01 18:14:10,2010-03-31 19:22:06
3f9083cde3b434155c274168f166ffce2bb243e7...c674d0527396e4100454e8992ed7381ee29dd54e,2,5,2,7,2,2010-04-01 18:14:10,2010-03-31 19:22:07
c674d0527396e4100454e8992ed7381ee29dd54e...91e525989665d69ace11b8f39618b1e8004fe19a,1,23,2,25,3,2010-04-01 18:14:11,2010-03-31 19:22:08
f3f778df6900881a7bac409c927931c32b82bcb5...8b9624c3741f3449510285fec21106bfee5d4942,1,1,1,2,1,2012-01-10 04:43:48,2012-01-10 02:47:33
f3f778df6900881a7bac409c927931c32b82bcb5...54440e154f33678a80ea9f77085730b81a5e9446,2,8,2,10,2,2012-01-03 20:13:28,2012-01-03 13:46:03
873ce7c8d5a57b5f8f3bcc8f9905dac13cb38988...f3fb07509c2e0b21b12a598fcd0a19a92fc38a9d,1,28,1,29,5,2012-02-01 23:26:53,2012-02-01 06:31:35
b3f17ac3d6609c1ccede32ef783d4f2e92e7eba6...10f4eb652ee4e592f91f638e579d1afcb96c0408,1,38,4,42,6,2011-12-14 07:09:27,2011-12-14 07:09:27
017d1e134545db0d162908f3538077eaa1f34fb6...a96250c6fb612f5f2197df5e0354599f18530c7c,1,5,0,5,1,2011-12-12 07:16:24,2011-12-10 10:30:06
a96250c6fb612f5f2197df5e0354599f18530c7c...89650285d8ef98173190a80f1d070a33092c9314,1,1,1,2,1,2011-12-12 07:16:24,2011-12-10 10:30:10
89650285d8ef98173190a80f1d070a33092c9314...abca927dbef2c310056b8a1a8be5561212b3243a,8,773,0,773,10,2011-12-12 07:16:24,2011-12-10 10:31:11
abca927dbef2c310056b8a1a8be5561212b3243a...d3e847c107c236126476e7efb272be3fa4339825,3,57,0,57,4,2011-12-12 07:16:24,2011-12-10 10:31:17
d3e847c107c236126476e7efb272be3fa4339825...148bb6a7b4d82a6380c6a51951b870933564c115,2,51,98,149,21,2011-12-12 07:16:24,2011-12-10 10:31:21
148bb6a7b4d82a6380c6a51951b870933564c115...118250728e1aa46c19d4d258950b2ba15cb6d5d2,4,119,1,120,8,2011-12-12 07:16:24,2011-12-10 10:31:24
118250728e1aa46c19d4d258950b2ba15cb6d5d2...d5742425ebfd3060fd181195f3be84cd28c1d06f,3,33,0,33,3,2011-12-12 07:16:24,2011-12-10 10:31:30
d5742425ebfd3060fd181195f3be84cd28c1d06f...a78fbb4fb6c69d96cb91dee9d4733d2326c6d019,4,46,2,48,6,2011-12-12 07:16:25,2011-12-10 10:31:34
a78fbb4fb6c69d96cb91dee9d4733d2326c6d019...a6fc9fd3f4b42cd97b5262026e18bd451c28ee3c,3,195,0,195,3,2011-12-12 07:16:25,2011-12-10 10:31:38
a6fc9fd3f4b42cd97b5262026e18bd451c28ee3c...e2770979fec968a25ac21e34f9082bc17a71a780,12,812,5,817,13,2011-12-12 07:16:25,2011-12-10 10:34:14
e2770979fec968a25ac21e34f9082bc17a71a780...6320358e31d42f25fa4ac5eb4e72574630de1692,2,16,3,19,8,2011-12-13 00:00:18,2011-12-12 21:12:56
6320358e31d42f25fa4ac5eb4e72574630de1692...c505116b91d3c92f0c3066cb9806773d2df11088,2,42,0,42,2,2011-12-13 00:08:27,2011-12-10 10:34:20
c505116b91d3c92f0c3066cb9806773d2df11088...71e1b4b6bf7f274f0b3bf45e7325c04abb405b8a,6,248,0,248,6,2011-12-13 00:09:38,2011-12-10 10:34:44
71e1b4b6bf7f274f0b3bf45e7325c04abb405b8a...861444f6d702b15713d0875ce9dc5aff64885fba,1,39,0,39,1,2011-12-13 00:09:38,2011-12-10 10:35:55
017d1e134545db0d162908f3538077eaa1f34fb6...3f59481e338c2d3167b9654a4289a9d1201f7944,2,24,1,25,3,2011-11-28 19:40:46,2011-11-26 02:30:02
3f59481e338c2d3167b9654a4289a9d1201f7944...39bd6f726109942c6f77f59638f6763c9f00706c,5,23,12,35,10,2011-11-28 19:40:46,2011-11-26 08:54:55
017d1e134545db0d162908f3538077eaa1f34fb6...b4524d343b085b63c68cf5e0a70007c19a048197,1,1,1,2,1,2011-11-23 17:29:53,2011-11-23 12:45:36
b4524d343b085b63c68cf5e0a70007c19a048197...2a4037d0a745134a3b94cb3d60d2793a26bd9027,1,2,2,4,4,2011-11-23 18:54:57,2011-11-23 08:49:38
2a4037d0a745134a3b94cb3d60d2793a26bd9027...b15aa973b296ca36ae39592491bcb02944ac0f7a,2,9,0,9,2,2011-11-23 18:56:29,2011-11-23 10:04:52
ced7469f0700216a05b9ca5b58199f3d761a64e5...50dd0f2fd910d9973760db052897ee8e73ed2f1f,2,25,2,27,2,2012-01-23 18:49:34,2012-01-23 17:52:44
dd73ecd1bc8903036d58cf7afb0010ef4aaf8695...b7a025d921e416a708eb2d664d9ff51b303edd97,1,18,24,42,7,2012-01-06 19:12:50,2012-01-06 14:12:31
b7a025d921e416a708eb2d664d9ff51b303edd97...bc98201d84eb3eb283aa4ebb9de9f7a3b32b97af,1,5,5,10,5,2012-01-06 19:15:04,2012-01-06 14:12:32
bc98201d84eb3eb283aa4ebb9de9f7a3b32b97af...85f251045019296a9143fd6527a48461e7b7c0e7,1,3,4,7,4,2012-01-06 19:26:41,2012-01-06 14:12:33
7b6c5836cf02999955b68c79f1cf2d13040acbc3...97f261b1e7f1af54aed700e61cdb8af74dbd2459,1,1,1,2,1,2011-12-21 00:02:08,2011-12-20 23:27:41
7b6c5836cf02999955b68c79f1cf2d13040acbc3...02f7914734eb8360cf314d887931c5d5ad0d8046,2,36,3,39,4,2011-12-19 19:21:29,2011-12-17 10:45:39
7b6c5836cf02999955b68c79f1cf2d13040acbc3...26e94af0ba2f35438bab4a88caa4a16f5e056bac,1,8,11,19,8,2011-12-19 05:38:55,2011-12-19 05:35:01
7b6c5836cf02999955b68c79f1cf2d13040acbc3...28303082609cb7efbdac87d45bf3a18c80eb8e70,1,8,18,26,3,2011-12-17 00:24:35,2011-12-16 11:33:10
7b6c5836cf02999955b68c79f1cf2d13040acbc3...cd1957f5fc6ecc5ae557246126d9e74c029ccd61,5,48,0,48,6,2011-12-16 21:00:15,2011-12-16 11:40:24
7b6c5836cf02999955b68c79f1cf2d13040acbc3...dd98d88be7a2f3782e938701102a96cb09d284da,1,1,0,1,1,2011-12-16 20:33:49,2011-12-16 11:27:50
3453f862e1c74e400da67def9b810300ef90c3ac...17b96be29afd71577374e9deee663120b18eb8f1,1,2,0,2,1,2006-10-17 20:07:13,2006-10-17 18:08:08
17b96be29afd71577374e9deee663120b18eb8f1...e0b0830726286287744cc9e1a629a534bbe75452,1,8,0,8,1,2006-10-18 10:34:46,2006-10-12 22:19:35
e0b0830726286287744cc9e1a629a534bbe75452...1a3b55c6b424904835ebfd74c992a5bffbaa7e7e,1,1,1,2,1,2006-10-19 04:18:42,2006-10-18 19:56:22
1a3b55c6b424904835ebfd74c992a5bffbaa7e7e...8a83157e04e8f9654b3573cf04276895b1cbd68a,1,1,1,2,1,2006-10-19 04:21:50,2006-10-19 01:34:41
8a83157e04e8f9654b3573cf04276895b1cbd68a...6b09c7883f50044a68d93ef6872486bad2e93a9d,1,15,1,16,3,2006-10-19 04:43:30,2006-10-19 03:04:55
3453f862e1c74e400da67def9b810300ef90c3ac...9b709e47ae46079efe1d7858580dcf5b8cf6ea33,1,6,5,11,1,2006-10-17 06:04:05,2006-10-16 00:59:25
4d69065d3adad480b79831ca9f08536aaf563dba...9c95fbf94f9a801d04dbe38898909def7a99793f,1,2,1,3,1,2006-09-17 21:47:18,2006-09-17 14:09:18
9c95fbf94f9a801d04dbe38898909def7a99793f...645927cec82253a3592ca738c4a405427a71eb31,1,21,13,34,8,2006-09-17 21:47:46,2006-09-17 13:29:48
645927cec82253a3592ca738c4a405427a71eb31...f58bb6fb41a24723ef59febe344f36956a9a8d41,1,10,0,10,1,2006-09-17 22:08:29,2006-09-17 10:55:38
f58bb6fb41a24723ef59febe344f36956a9a8d41...02ac04fc9feacc0174fcbddba6dc8c098c315b13,1,11,1,12,2,2006-09-17 22:10:07,2006-09-17 11:02:59
02ac04fc9feacc0174fcbddba6dc8c098c315b13...ac8e3f2bb8a790ca7810df18c3282d07e84ae345,1,1,1,2,1,2006-09-17 22:10:23,2006-09-17 11:52:45
9f613ddd21cbd05bfc139d9b1551b5780aa171f6...1729fa9878ed8c99ae0bb2aecced557618d0c894,1,21,4,25,4,2006-09-21 19:38:38,2006-09-21 09:19:17
9f613ddd21cbd05bfc139d9b1551b5780aa171f6...1f24c58724a64e7b100ae8d8e0318c9e564df88b,1,10,15,25,2,2006-09-20 17:21:46,2006-09-20 16:37:04
a41fae9c46a4cb5e59cc1a17d19f6a3a6cbfbb2f...04f7a94f65f40d24607ba9af77756e121b7c8e4f,1,31,2,33,4,2006-09-11 02:32:58,2006-09-10 22:29:27
04f7a94f65f40d24607ba9af77756e121b7c8e4f...8be683520e5a00cb7bd67acfd71d9346c33305b2,1,54,10,64,9,2006-09-11 02:33:09,2006-09-10 22:36:04
8be683520e5a00cb7bd67acfd71d9346c33305b2...86257aa324d04694408ad806989690979456f29a,3,36,30,66,3,2006-09-11 05:47:30,2006-09-11 04:59:22
86257aa324d04694408ad806989690979456f29a...0f503d77ac9032fbfbd5f3bacafeccbcf408b31f,1,14,3,17,3,2006-09-11 05:48:11,2006-09-11 05:04:50
0f503d77ac9032fbfbd5f3bacafeccbcf408b31f...f42a5c4eb0453cd33276e078cd7541b1ef25b2c4,2,12,3,15,4,2006-09-13 05:30:32,2006-09-12 09:00:13
f42a5c4eb0453cd33276e078cd7541b1ef25b2c4...6d2489235f5430071b8df2281c5f9ce00097bb31,1,1,1,2,1,2006-09-13 05:36:19,2006-09-12 04:43:08
6d2489235f5430071b8df2281c5f9ce00097bb31...cdad8bbe92a447233133be8f9f3015c1bd7e10eb,2,26,0,26,2,2006-09-13 07:31:58,2006-09-11 23:22:49
a41fae9c46a4cb5e59cc1a17d19f6a3a6cbfbb2f...49a52b1d1fb120f52de3a67f1e4e5ae81512ab81,4,66,29,95,7,2006-09-10 20:36:35,2006-09-10 08:06:33
49a52b1d1fb120f52de3a67f1e4e5ae81512ab81...958c24b1b8f463bca857f45c41a2f8198e345c2f,3,39,36,75,8,2006-09-10 20:36:50,2006-09-10 10:20:24
958c24b1b8f463bca857f45c41a2f8198e345c2f...d47f3db75c58139cdcbca5cc63b17bf5db293b6a,4,20,9,29,9,2006-09-10 23:27:08,2006-09-10 23:27:08
56f9686c4d1e1d586b731b815bd98d70f84ecda4...23d6d112c004d4242f9dbd8161f79ccdeb47bde8,2,92,6,98,9,2006-09-11 01:10:55,2006-09-10 10:33:34
23d6d112c004d4242f9dbd8161f79ccdeb47bde8...d3788e19e20cd14aeac99d1f294d9a368437284f,1,38,22,60,7,2006-09-13 05:39:45,2006-09-12 07:26:57
d3788e19e20cd14aeac99d1f294d9a368437284f...d751864cf7f5253da1ce749cf71215466590037f,1,2,2,4,2,2006-09-13 05:43:22,2006-09-13 05:42:31
d751864cf7f5253da1ce749cf71215466590037f...2232c0c69ff114a23011a0698b119aeea0272e8b,1,2,12,14,2,2006-09-14 06:37:14,2006-09-13 20:55:04
2232c0c69ff114a23011a0698b119aeea0272e8b...87af29f09f119c4a4fa7fdf308483ae1abb74b49,1,18,72,90,8,2006-09-17 09:09:31,2006-09-16 19:20:36
7a0cf2d0138cf3abd3f2c3c9a1aa4dc55bf0700f...9cb90b80fc1ec09d8e51451b18a7c8ef7eac8908,1,1,1,2,1,2006-10-08 19:43:07,2006-10-08 13:44:50
9cb90b80fc1ec09d8e51451b18a7c8ef7eac8908...9a7a62ff71c436fb5e024ec409ec28fca460a168,2,14,8,22,4,2006-10-08 20:36:58,2006-10-06 10:31:05
7a0cf2d0138cf3abd3f2c3c9a1aa4dc55bf0700f...cf72fb07b77c73b4777b6a2e0836e3029c5f0f3c,1,2,2,4,2,2006-10-08 06:16:54,2006-10-06 23:47:24
cf72fb07b77c73b4777b6a2e0836e3029c5f0f3c...62cdce17c57a28240048c5064fab57edae19657f,2,44,4,48,7,2006-10-08 06:16:54,2006-10-06 23:47:35
05eb811aa1546b696c6c4d55593cfd4fbef0dce5...4df118ed6041dc0f126d55231a6621be05882b5f,1,8,8,16,5,2006-10-23 05:54:08,2006-10-21 15:53:55
4df118ed6041dc0f126d55231a6621be05882b5f...b6b7fc7283bd091822541c0286340e78b0c497a2,1,24,0,24,1,2006-10-23 05:54:08,2006-10-21 15:54:44
b6b7fc7283bd091822541c0286340e78b0c497a2...178e015c0543b581a40adbf4822f44fa592ff68b,1,13,1,14,3,2006-10-23 06:06:00,2006-10-23 05:09:35
178e015c0543b581a40adbf4822f44fa592ff68b...1d6a003a42b3c23ad7883b0bbe6a034728e51836,1,1,1,2,1,2006-10-23 08:12:04,2006-10-23 07:46:37
1d6a003a42b3c23ad7883b0bbe6a034728e51836...b4aee09e610567529dc619d7324dc2fe85a11db5,1,2,0,2,1,2006-10-23 08:13:49,2006-10-23 00:02:42
659db3f673fe199bad6ce9cc625d3a1b098bfbcf...acca687fa9db8eaa380b65d63c3f0d4364892acf,9,86,1281,1367,28,2006-11-09 02:49:37,2006-11-09 02:47:54
acca687fa9db8eaa380b65d63c3f0d4364892acf...25ffbb27a20278e9884e8f036b39806bb11ec1a8,1,6,5,11,7,2006-11-09 08:13:50,2006-11-08 23:11:10
25ffbb27a20278e9884e8f036b39806bb11ec1a8...225932ed4daa84f862a739ba4ea01a0bba2dfe45,1,2,3,5,2,2006-11-09 08:57:13,2006-11-09 08:57:13
225932ed4daa84f862a739ba4ea01a0bba2dfe45...1c791cfbf843fee5c72b5b23c0c3ca8550e15c08,1,2,0,2,1,2006-11-09 10:33:35,2006-11-09 10:33:35
f25b79397c9775df9eeef3d59d0cc3b1f913bc60...b20805af603380c3abfc1b2e7859d28185e397f1,1,1,1,2,1,2006-08-07 18:35:16,2006-08-07 15:10:21
b20805af603380c3abfc1b2e7859d28185e397f1...1dcb69224ca4da3d97c502de88de73ec4b362082,1,1,1,2,1,2006-08-07 18:38:53,2006-08-07 12:11:23
1dcb69224ca4da3d97c502de88de73ec4b362082...7c49cb288173ab5264b3b9e4257aeeb13388334c,1,122,6,128,10,2006-08-07 18:46:04,2006-08-07 12:11:24
f25b79397c9775df9eeef3d59d0cc3b1f913bc60...b7e58b17b50bbbf00299fc89c480efd7cc92c1bd,1,40,4,44,8,2006-08-07 08:58:53,2006-08-05 11:16:02
b7e58b17b50bbbf00299fc89c480efd7cc92c1bd...6015c28b1d6163f124332769989326ee470afbb6,1,52,21,73,7,2006-08-09 00:17:04,2006-08-08 21:47:32
76db9dec8132d4377f6c32e4d45eb75fa0cc7a9a...8c1f22da9f8124dfabb5da8476845250b5c35ae8,1,1,0,1,1,2007-02-05 21:05:11,2007-02-05 21:05:11
8c1f22da9f8124dfabb5da8476845250b5c35ae8...10831c551323121bdab06c3eaf2f52c6658fd6b8,1,12,12,24,12,2007-02-05 21:34:56,2007-02-05 21:34:56
10831c551323121bdab06c3eaf2f52c6658fd6b8...6c3aac1c69ea0bcb2896bec96a01fdf8aa6176fa,1,5,62,67,17,2007-02-06 01:30:37,2007-02-06 01:30:37
6c3aac1c69ea0bcb2896bec96a01fdf8aa6176fa...6e411d2044072072692f2d9cf9d633421ef6017a,1,655,0,655,1,2007-02-06 02:09:25,2007-02-06 02:09:25
6e411d2044072072692f2d9cf9d633421ef6017a...0b868e0240eb7f6d3dd137171b07f0860665b6e5,2,0,39,39,6,2007-02-06 05:15:37,2007-02-06 05:15:37
0b868e0240eb7f6d3dd137171b07f0860665b6e5...10e8d68820db9c7b6412d5a553a93fd200388f30,1,5,4,9,5,2007-02-06 05:26:49,2007-02-06 05:26:49
10e8d68820db9c7b6412d5a553a93fd200388f30...e5b1444b96b842597348d449722ec876432a6530,1,17,17,34,17,2007-02-06 05:43:59,2007-02-06 05:43:59
e5b1444b96b842597348d449722ec876432a6530...c74ba3d344769b827443b8995853527c85d63567,1,2,2,4,1,2007-02-06 16:59:11,2007-02-06 16:59:11
c74ba3d344769b827443b8995853527c85d63567...e7d06a4b702463f13371eed92ba790b8c527dd76,1,5,10,15,5,2007-02-06 17:05:51,2007-02-06 17:05:51
e7d06a4b702463f13371eed92ba790b8c527dd76...ef94edb53c9a5fd1e5fca9f548adc713d3d8ffe1,1,18,14,32,10,2007-02-06 17:35:02,2007-02-06 17:35:02
ef94edb53c9a5fd1e5fca9f548adc713d3d8ffe1...63e0c8b364e334fc7cc975edf1f16fb4c89594b3,3,214,24,238,21,2007-02-06 19:58:30,2007-02-06 19:58:30
63e0c8b364e334fc7cc975edf1f16fb4c89594b3...7073e69e382bc8247c28859d8b0eda2612cd6b94,3,143,17,160,15,2007-02-06 21:08:06,2007-02-06 21:08:06
7073e69e382bc8247c28859d8b0eda2612cd6b94...9981b6d915a49d325f790f2aa825aa56ae4ac85c,2,2,2,4,2,2007-02-06 21:08:30,2007-02-06 20:46:11
6ce4e61f1be690681f6494eb5ca26540c2316f81...df6d61017a17efe67e4709028fea8e820b5efc5e,1,63,4,67,8,2006-09-03 00:08:10,2006-09-01 22:05:12
df6d61017a17efe67e4709028fea8e820b5efc5e...7042dbf7a1e9137eb856b3b086a062561c50b8a3,1,7,6,13,1,2006-09-03 21:44:46,2006-09-03 21:44:46
7042dbf7a1e9137eb856b3b086a062561c50b8a3...72518e9c2623af0b5de864a7b66208ea94aacadb,4,65,41,106,12,2006-09-04 04:09:18,2006-09-04 04:09:18
f2e609473cb4aeb3884b7dd57a3a652df4e5edcf...5d44cd1c8b27fb677fedc886303d38b19fbb07f7,1,5,4,9,4,2006-09-04 22:24:10,2006-09-04 15:34:12
5d44cd1c8b27fb677fedc886303d38b19fbb07f7...0b5deba13268a196a8b302255453a8c2194c876d,3,7,0,7,4,2006-09-04 22:33:04,2006-09-04 18:32:13
0b5deba13268a196a8b302255453a8c2194c876d...72dbafa1e6696b6acec59c22aa7e3d956cf9992f,1,4,4,8,4,2006-09-04 22:46:32,2006-09-04 16:19:58
72dbafa1e6696b6acec59c22aa7e3d956cf9992f...762c7205f6700070fa3c18c8544a769461b2e567,1,21,8,29,5,2006-09-04 22:46:44,2006-09-04 16:17:58
762c7205f6700070fa3c18c8544a769461b2e567...c23cca17202f6b04cb2f8f850dac6afc289bcd3d,1,1,0,1,1,2006-09-05 01:54:27,2006-09-04 22:55:52
c23cca17202f6b04cb2f8f850dac6afc289bcd3d...f8affe317dbfa3d5eb3cc2705568efc184f844db,1,10,0,10,1,2006-09-05 01:55:35,2006-09-04 22:57:45
f8affe317dbfa3d5eb3cc2705568efc184f844db...f685d07de045423a69045e42e72d2efc22a541ca,1,4,4,8,2,2006-09-05 01:56:09,2006-09-04 22:58:25
f2e609473cb4aeb3884b7dd57a3a652df4e5edcf...f986f2c830b24a0f56f2bf4b3f30353ca1e372a9,2,45,22,67,19,2006-09-04 09:42:00,2006-09-04 05:55:54
f986f2c830b24a0f56f2bf4b3f30353ca1e372a9...3b67d2917a0e93aa583c4069f5a00655e05dbd84,2,7,7,14,6,2006-09-13 19:59:49,2006-09-13 19:59:20
4a0641b7cf833644b286b56bb57d66b5538e4418...16652170bf80542fd77de75fb88da2f7761f65c4,1,113,0,113,1,2006-09-27 19:34:37,2006-09-27 19:34:37
16652170bf80542fd77de75fb88da2f7761f65c4...209e7569313aa045da6d55e333c884e49e7d8fb2,1,1,1,2,1,2006-09-27 19:44:02,2006-09-27 15:18:49
209e7569313aa045da6d55e333c884e49e7d8fb2...b48fb5b6a950a6757b790e9160967065a3e03978,3,45,0,45,5,2006-09-27 23:27:10,2006-09-27 23:27:10
b48fb5b6a950a6757b790e9160967065a3e03978...a3f5d02edb2c1a037ed3ed8d2ebd3f3e5da9d198,1,2,5,7,2,2006-09-27 23:42:53,2006-09-27 23:42:53
4a0641b7cf833644b286b56bb57d66b5538e4418...a2540023dcf833ca02d87c28052e8b7135d56b60,2,96,38,134,21,2006-09-27 09:55:08,2006-09-27 01:53:02
a2540023dcf833ca02d87c28052e8b7135d56b60...785f743276991567a36420f069c228e4dc9d0df3,1,19,10,29,12,2006-09-27 09:57:37,2006-09-27 01:59:41
785f743276991567a36420f069c228e4dc9d0df3...5c5b2ea9ab95f71ac155f12d75d1432b5c93c2bb,2,30,10,40,3,2006-09-29 05:27:29,2006-09-28 22:07:16
5c5b2ea9ab95f71ac155f12d75d1432b5c93c2bb...3ed74e608a69ce0f10bfad2e4ef6cf99eec04613,1,7,4,11,4,2006-09-29 05:32:53,2006-09-28 15:37:39
4a0641b7cf833644b286b56bb57d66b5538e4418...5a03e7f25334a6bf1dbbfdb9830d41de5b8f0d7f,2,17,1,18,4,2006-09-27 07:43:50,2006-09-25 05:24:38
4a0641b7cf833644b286b56bb57d66b5538e4418...eb32d236df0c16b936b04f0c5402addb61cdb311,5,82,45,127,31,2006-09-27 07:11:59,2006-09-21 04:06:49
eb32d236df0c16b936b04f0c5402addb61cdb311...209c554ab45701fb78de77fdcec803fef2c8fd39,1,106,32,138,32,2006-09-27 07:12:00,2006-09-21 04:07:39
209c554ab45701fb78de77fdcec803fef2c8fd39...53dda6ff6263a3f350514d9edae600468c946ed4,1,80,31,111,30,2006-09-27 07:12:00,2006-09-21 04:08:33
53dda6ff6263a3f350514d9edae600468c946ed4...be6b19145f64f62790049c06320c35011f7312a7,1,33,14,47,10,2006-09-27 07:12:00,2006-09-21 04:09:44
be6b19145f64f62790049c06320c35011f7312a7...780e6e735be189097dad4b223d8edeb18cce1928,3,130,96,226,28,2006-09-27 07:12:00,2006-09-23 01:25:04
780e6e735be189097dad4b223d8edeb18cce1928...e4fe4b8ef7cdde842a9e5e2594d0fba1367d9dd3,2,10,5,15,6,2006-09-27 07:12:00,2006-09-26 15:27:39
e4fe4b8ef7cdde842a9e5e2594d0fba1367d9dd3...f130446920b550a69716346fb9a9947c04fc7f90,1,0,1,1,1,2006-09-27 19:35:19,2006-09-27 19:30:21
f130446920b550a69716346fb9a9947c04fc7f90...a2700696995651322796e04092bf4a4bfed31b88,1,1,1,2,1,2006-09-27 20:32:54,2006-09-27 19:42:16
a2700696995651322796e04092bf4a4bfed31b88...63fba759bc1d9405f362e73918096815bf8e2a15,2,13,2,15,3,2006-10-10 08:06:20,2006-10-10 08:06:20
63fba759bc1d9405f362e73918096815bf8e2a15...b6945f570acef7603c58d2aec4a84dce006fbd65,3,28,1,29,4,2006-10-14 04:28:58,2006-10-14 04:28:58
b6945f570acef7603c58d2aec4a84dce006fbd65...3c552873c698117689af4e5159c7e491fe3a89a3,1,10,4,14,5,2006-10-18 17:07:49,2006-10-17 20:23:26
3c552873c698117689af4e5159c7e491fe3a89a3...2d477051ef260aad352d63fc7d9c07e4ebb4359b,1,143,101,244,45,2006-10-20 23:51:46,2006-10-20 18:45:21
2d5b459107cf07bbb307cfb196c2007c497a6dd2...690d8824c852b6a59deb03f65e330297c587752e,1,324,0,324,1,2006-09-28 09:31:25,2006-09-28 09:31:25
690d8824c852b6a59deb03f65e330297c587752e...7b40e7d1ab20aebaac86b4586d48b6b645da57d1,1,8,4,12,5,2006-09-28 16:12:57,2006-09-25 11:08:13
7b40e7d1ab20aebaac86b4586d48b6b645da57d1...c08e52486a7b5e38741c8264979a11f0103ec8c4,1,2,0,2,1,2006-09-28 16:13:16,2006-09-22 11:12:01
c08e52486a7b5e38741c8264979a11f0103ec8c4...695dffe2efa53b9628e7811dbe33447a8014fd77,1,4,0,4,1,2006-09-28 16:14:09,2006-09-28 10:00:35
695dffe2efa53b9628e7811dbe33447a8014fd77...100690b6e8e9cc3cfe2c1d170192b5505d7a2ea8,1,1,1,2,1,2006-09-29 01:22:37,2006-09-28 18:48:14
100690b6e8e9cc3cfe2c1d170192b5505d7a2ea8...e92a54d99cb36eab6e29069fe3b135e6e6b24f12,1,10,3,13,2,2006-09-29 01:23:25,2006-09-28 19:12:28
e92a54d99cb36eab6e29069fe3b135e6e6b24f12...393d340e4f4ae571cd48387c29c85e9ab098b098,1,40,0,40,3,2006-09-29 01:25:25,2006-09-28 19:14:27
393d340e4f4ae571cd48387c29c85e9ab098b098...a28383770ec44357bfce4af834dc09bf14d9410e,2,3,3,6,3,2006-09-29 01:25:36,2006-09-28 19:12:55
a28383770ec44357bfce4af834dc09bf14d9410e...77e565d8f76357781eb6236e031e8e0581de83a9,1,3,2,5,2,2006-09-29 01:26:09,2006-09-28 19:55:35
77e565d8f76357781eb6236e031e8e0581de83a9...3ea099d48b15f69889f4efe71599c9dfde6bb26a,5,31,1,32,9,2006-09-29 02:02:46,2006-09-29 00:10:44
3ea099d48b15f69889f4efe71599c9dfde6bb26a...21ff2bdb887c836aab3346bbfa6a3e0251ff6104,1,1,1,2,1,2006-09-29 07:51:05,2006-09-28 23:28:55
21ff2bdb887c836aab3346bbfa6a3e0251ff6104...bc1a5807575b2f34538d4158834da6524a4fc1f7,1,1,1,2,1,2006-09-29 09:06:24,2006-09-29 09:06:24
bc1a5807575b2f34538d4158834da6524a4fc1f7...18b633cafcd43b83d752738fea62f185d4de1b91,1,16,10,26,7,2006-09-29 20:04:09,2006-09-29 19:36:13
18b633cafcd43b83d752738fea62f185d4de1b91...4839bd8a6605e0c9c5c68ddec40d2a1a5ddd57d8,1,1,0,1,1,2006-09-30 01:54:13,2006-09-29 18:05:40
2d5b459107cf07bbb307cfb196c2007c497a6dd2...0ab7befa31d07fe3ffb51a6cc626d4c09ded1c92,4,112,19,131,27,2006-09-28 06:59:09,2006-09-28 00:50:52
0ab7befa31d07fe3ffb51a6cc626d4c09ded1c92...70d0afba914ddcf8c8a0144e5c6519d43d641dd9,1,8,1,9,4,2006-09-28 06:59:10,2006-09-28 00:55:58
2eaf22242f61b13c38c87cbb0e84c84974c52d66...28bed6ea2198f6589ad43e48666906a879839442,1,1,1,2,1,2006-10-01 15:41:58,2006-10-01 12:36:49
28bed6ea2198f6589ad43e48666906a879839442...14c8a681f751c425f47be38a5e98b514f000d499,2,27,10,37,2,2006-10-01 15:42:01,2006-10-01 12:38:18
14c8a681f751c425f47be38a5e98b514f000d499...26a063a10bca57f65d8fed6c4550a70d44a70b81,1,2,1,3,2,2006-10-01 18:41:00,2006-10-01 18:41:00
26a063a10bca57f65d8fed6c4550a70d44a70b81...d3d0013c59ed840520b86a65697137cb2c62819c,1,4,2,6,1,2006-10-01 22:17:43,2006-10-01 20:16:22
d3d0013c59ed840520b86a65697137cb2c62819c...b431b2822f361efcb940adbc1f2097e122e90ed9,1,1,1,2,1,2006-10-01 22:17:48,2006-10-01 20:33:04
b431b2822f361efcb940adbc1f2097e122e90ed9...367337040d8d39294bf676672dfefc542717195b,1,2,3,5,1,2006-10-02 04:42:20,2006-10-02 04:36:15
eff73751bb94b0241fd2204effb8680fe9973cbf...04509738b5779c33e59b93e4959b0ac19acab838,2,45,9,54,11,2006-12-29 10:25:04,2006-12-29 10:25:04
04509738b5779c33e59b93e4959b0ac19acab838...8757749ecbabbcf7f1a68c17529f02bf7702b424,1,2,0,2,1,2006-12-29 17:49:12,2006-12-29 13:39:09
8757749ecbabbcf7f1a68c17529f02bf7702b424...c889763bf33e9b54843dc93ba3bb38803f86a6cf,2,9,16,25,7,2006-12-29 18:08:19,2006-12-29 18:08:19
c889763bf33e9b54843dc93ba3bb38803f86a6cf...4d06f8ac4389ed8bcd2d03b2dcab4b7e2a858402,4,69,29,98,17,2006-12-29 19:01:31,2006-12-29 19:01:31
eff73751bb94b0241fd2204effb8680fe9973cbf...7ba3c078c76cbda00f7ed2ac16a659d8f48631ba,1,12,12,24,2,2006-12-29 03:06:16,2006-12-28 07:35:20
7ba3c078c76cbda00f7ed2ac16a659d8f48631ba...a970e84e8ad23a740e456fb4191ed61becef8989,1,3,0,3,1,2006-12-29 03:06:16,2006-12-28 07:35:24
a970e84e8ad23a740e456fb4191ed61becef8989...579c9bb1986005282e049c6ad8f594a1ffc35fba,1,5,2,7,3,2006-12-29 03:06:16,2006-12-28 07:35:27
de51faf3888505fa3d661d4c35f32ecaf9fa1087...cd976f5c52694acb4b23c3f2425ed4f0a47ec799,1,104,245,349,10,2006-12-07 05:35:53,2006-12-07 04:18:05
cd976f5c52694acb4b23c3f2425ed4f0a47ec799...46732fae3d049254f4f12b8a716cf56159277eda,1,1,1,2,1,2006-12-07 05:47:07,2006-12-07 04:01:00
de51faf3888505fa3d661d4c35f32ecaf9fa1087...955289bf92f0513377763c9aacfe426d5151b05a,1,3,1,4,1,2006-12-06 19:24:04,2006-12-06 12:07:23
50319850343dfe534939ee6b38507d5a8fc44b50...d27d5b3c5b97ca30dfc5c448dc8cdae914131051,1,1,5,6,1,2006-02-22 11:47:20,2006-02-22 11:47:20
50319850343dfe534939ee6b38507d5a8fc44b50...3fda8c4cc74f884280f7472673b79a687b43f46c,3,2539,0,2539,3,2006-02-22 10:17:07,2006-02-22 09:50:15
50319850343dfe534939ee6b38507d5a8fc44b50...797656e58ddbd82ac461a5142ed726db3a4d0ac0,1,28,10,38,9,2006-02-22 09:47:32,2006-02-22 02:59:37
8e1454b5ad285ec5dd25758e799c589045aff9d4...6b7d25d97bdb8a26719f90d17ff5c9720be68762,1,30,47,77,11,2006-02-22 08:36:09,2006-02-22 01:45:36
6b7d25d97bdb8a26719f90d17ff5c9720be68762...907380eeff27e9a07d6f1c03847c3d80f9e0e79a,1,71,6,77,8,2006-02-23 10:58:37,2006-02-23 10:58:37
879e8b1aad021cade0a254db0a5b67f56d99902a...79b2c75e043ad85f9a6b1a8d890b601a2f761a0e,1,95,93,188,56,2006-04-02 10:47:40,2006-04-02 10:47:40
9086a18cb81f99fff943b36830396ac8c37c7e9f...a7cfb4a43fce841cd673057cf4137f85e6f804eb,1,1,1,2,1,2006-03-26 08:15:01,2006-03-25 22:43:46
4dc870d90cf4cd30b30b59054603fbb09dca1f41...cf7bb589af739563c90dc32b4901bea73aaaa9d0,3,255,177,432,34,2006-02-10 08:54:49,2006-02-10 08:45:59
0a798076b8d1a4a31bf2b24c564e2a99fd1c43a1...297a1aadbe22c978dca60d6512e5c851ebc6688c,3,10,25,35,9,2006-02-10 09:51:12,2006-02-10 09:51:12
297a1aadbe22c978dca60d6512e5c851ebc6688c...d416df8869d803282fb254a18505eccceee9ba3e,2,26,7,33,6,2006-02-10 10:50:53,2006-02-10 10:30:52
2bcab24080dc97fc628e1b601a195a9a96773fac...b92b2ce94e5673ab3a2fbc9c762b39aaf7d72de5,1,7,2,9,1,2006-02-09 08:55:17,2006-02-09 08:55:17
b0d3e9baaa16c805ef941e8f26d55fb23f091ef5...2db8aaeca1dca4e940829b87d1164e5b42ff49b4,1,3,0,3,2,2005-12-14 21:04:25,2005-12-14 11:11:37
9a26dbd120110ad4e07d3047abc13d615183c8ec...773b6339435ab3bddecb9b78e49720e22124b52a,1,1,1,2,1,2005-12-14 21:32:52,2005-12-14 21:32:52
773b6339435ab3bddecb9b78e49720e22124b52a...252fef7149204d52ed4b46fd7e8ac8c803ceb0aa,1,3,0,3,1,2005-12-14 22:26:44,2005-12-13 12:21:34
252fef7149204d52ed4b46fd7e8ac8c803ceb0aa...e0e3ba208d235ab5623a86204fbd20b449520764,2,38,1,39,3,2005-12-15 00:31:06,2005-12-15 00:31:06
e0e3ba208d235ab5623a86204fbd20b449520764...32d9954478734da4062cf2ffc2faf2d057e47fb6,1,18,11,29,7,2005-12-15 01:02:03,2005-12-14 23:36:35
32d9954478734da4062cf2ffc2faf2d057e47fb6...294c695d8cfbcf95a5c33fc6ba386f496964defb,1,34,0,34,1,2005-12-15 01:04:47,2005-12-14 22:48:19
6689f08735d08a057f8d6f91af98b04960afa517...50e7b06730915dd7439e880fe84439a4483ccbb4,1,4,2,6,1,2005-12-21 21:28:24,2005-12-21 20:35:48
50e7b06730915dd7439e880fe84439a4483ccbb4...8ac4838af428a2a32498b3e8d13295eb714654b4,1,4,1,5,1,2005-12-21 21:48:47,2005-12-21 21:48:47
6689f08735d08a057f8d6f91af98b04960afa517...e4e79a217576d24ef4d73b620766f62b155bcd98,2,12,1,13,2,2005-12-21 21:17:54,2005-12-21 21:17:54
2a212746f44f18695d33931039da10f842de7b25...c894168631e4b7da66ed3993a4c92380d38599a8,2,7,1,8,2,2005-12-22 06:33:37,2005-12-22 06:33:37
c894168631e4b7da66ed3993a4c92380d38599a8...724b511d4fb363ebee828ba3992c831ba006444c,2,64,11,75,8,2005-12-22 06:34:59,2005-12-12 00:44:05
724b511d4fb363ebee828ba3992c831ba006444c...6d016c9c7f21a97249c4571e8d7265da1fd2f083,1,68,79,147,21,2005-12-22 07:02:33,2005-12-20 20:05:54
90279074ca5cc336a8bfffd47d19d089b291b432...93d69d86912c44206543f6670e93f9fc6f2f859f,9,70,48,118,26,2005-11-07 07:32:04,2005-11-07 05:30:56
93d69d86912c44206543f6670e93f9fc6f2f859f...44760f1d559ae2087e53be6971ad4f1a8f18f1d7,1,159,8,167,8,2005-11-07 07:32:33,2005-11-07 07:29:35
29504118f8528f658fd0bfc02d8d78d4c01dc2cc...a34484e1c926ff21279d2f178534c1f9565c7f4d,1,2,2,4,2,2005-10-16 19:01:28,2005-10-16 18:59:13
d67c4af41f7975940e8fec6405411581570eb672...a24e658649170c99fdcb4aaa41545679ad02f755,1,83,60,143,16,2005-10-06 08:37:17,2005-10-06 08:37:17
a24e658649170c99fdcb4aaa41545679ad02f755...12aac5de3dd73a1f9d03f81c5b0087e71794cee7,2,2,2,4,2,2005-10-06 21:10:39,2005-10-06 21:10:39
12aac5de3dd73a1f9d03f81c5b0087e71794cee7...bc162e40ea6dc3208e3bda76301d6409607ed3ff,2,29,11,40,11,2005-10-06 21:23:29,2005-10-06 21:10:39
bc162e40ea6dc3208e3bda76301d6409607ed3ff...47f0b6d5d49247b85898083d1ccf4f899ef7294a,3,86,5,91,9,2005-10-06 21:25:52,2005-10-06 21:25:52
47f0b6d5d49247b85898083d1ccf4f899ef7294a...4ebe63dfe6f2a8c652ecd8dfe6ab8a77b6c82b2f,1,5,1,6,1,2005-10-06 21:25:52,2005-10-06 21:25:52
4ebe63dfe6f2a8c652ecd8dfe6ab8a77b6c82b2f...655c7470e2ea7f25f22703b6654d7570e1567a39,1,42,30,72,7,2005-10-06 21:25:52,2005-10-06 21:25:52
655c7470e2ea7f25f22703b6654d7570e1567a39...e11fc02066435b0f370d639e665ec70680e876a6,2,12,4,16,6,2005-10-06 21:25:52,2005-10-06 21:25:52
e11fc02066435b0f370d639e665ec70680e876a6...54ba6013b4eaff0d96f9ab96cf225ca392b08a30,2,12,2,14,4,2005-10-06 21:25:52,2005-10-06 21:25:52
54ba6013b4eaff0d96f9ab96cf225ca392b08a30...8b73edf498adf2895af7ff9c750283cf9325a632,2,96,86,182,19,2005-10-06 22:55:43,2005-10-06 22:55:43
8b73edf498adf2895af7ff9c750283cf9325a632...ec1fcc16af94810dd822c6da533f58fa2750f14a,8,114,55,169,20,2005-10-07 10:42:00,2005-10-07 10:42:00
ec1fcc16af94810dd822c6da533f58fa2750f14a...2cf67f1e35d3a2175e426b4b2841374e68105c2c,1,76,1,77,9,2005-10-07 10:42:00,2005-10-07 10:42:00
2cf67f1e35d3a2175e426b4b2841374e68105c2c...d4dbf36df0eb2efe78822704d9779d662ed4dd8a,1,53,0,53,2,2005-10-07 10:42:00,2005-10-07 10:42:00
d4dbf36df0eb2efe78822704d9779d662ed4dd8a...d1c5f2a42d7b5c0e3d3862212dea1f09809c4963,2,338,1,339,2,2005-10-07 10:44:18,2005-10-07 10:44:18
2af60a0521a8d0514e8bb1ca371cc9d502ea1c58...32e49d5d1ccbc4833b0c6f30d6dfc0f0936cc3f3,2,7,1,8,2,2005-10-10 02:19:36,2005-10-10 02:19:36
129056370abff1cc0d347b98fe88afc44a6cb8c0...0b34379a8da82061308b7a22d0caa1834d579f48,1,1,1,2,1,2005-10-05 00:44:17,2005-10-05 00:44:17
0b34379a8da82061308b7a22d0caa1834d579f48...d6e548d61fa95b98e98b3c1e592a4d73aa308969,1,6,4,10,3,2005-10-05 17:50:57,2005-10-05 14:58:11
d6e548d61fa95b98e98b3c1e592a4d73aa308969...85912b06734286108d0ec33f0479677e2fce252d,1,1,1,2,1,2005-10-05 17:50:59,2005-10-05 15:52:12
85912b06734286108d0ec33f0479677e2fce252d...df34297af1fe5da786e41bd2fee58e10dd810cc4,2,4,4,8,4,2005-10-05 18:23:23,2005-10-05 16:58:10
df34297af1fe5da786e41bd2fee58e10dd810cc4...e091eb93258f05a58bc5d1c60f058f5f57dd92b6,3,56,16,72,8,2005-10-05 21:49:54,2005-10-05 21:49:54
e091eb93258f05a58bc5d1c60f058f5f57dd92b6...f73ae1fc5d5308fecf0a4bdbd7312f7f5b00df55,14,39,38,77,29,2005-10-05 22:08:26,2005-10-05 22:08:26
f73ae1fc5d5308fecf0a4bdbd7312f7f5b00df55...4cfc63db1daa0ebdb284ae6972928e41a317a0c8,1,16,8,24,9,2005-10-05 22:29:48,2005-10-05 22:29:48
2aba319a52b3601cff3f32b60bc28023ee45575d...365527adbfa8a16dfc05ab71818602f55ada55ba,2,9,0,9,2,2005-09-13 05:52:51,2005-09-13 02:47:07
365527adbfa8a16dfc05ab71818602f55ada55ba...22c67ca88ec65c4f278e8c82b2d98f3bd025238b,1,9,2,11,3,2005-09-13 05:52:52,2005-09-13 05:20:02
22c67ca88ec65c4f278e8c82b2d98f3bd025238b...f88ed172e7a391bd907798ad2a3347a83cd24317,1,1,1,2,1,2005-09-13 05:52:52,2005-09-13 05:20:42
f88ed172e7a391bd907798ad2a3347a83cd24317...e4cf17ce0db2dab7c9525a732f86c5e3df3b4ed0,4,4,4,8,5,2005-09-13 07:20:54,2005-09-13 06:22:26
e4cf17ce0db2dab7c9525a732f86c5e3df3b4ed0...a5cd85e084458bf573d0d29fa79c4e1ad7973ed7,1,12,3,15,4,2005-09-13 20:39:06,2005-09-13 20:16:45
a5cd85e084458bf573d0d29fa79c4e1ad7973ed7...ccfd3e99621f489db4ea37a03be7674adbd03f6e,1,22,6,28,8,2005-09-13 20:39:23,2005-09-13 07:05:22
ccfd3e99621f489db4ea37a03be7674adbd03f6e...d9a23fa6f7124befe7803f5f3a8c53999578caa4,1,33,35,68,17,2005-09-13 22:45:23,2005-09-13 21:39:34
d9a23fa6f7124befe7803f5f3a8c53999578caa4...0d214b6619bf14a6409a2a1ba079f3530d40ee41,1,0,1,1,1,2005-09-13 22:45:24,2005-09-13 21:40:23
0d214b6619bf14a6409a2a1ba079f3530d40ee41...87a71b65acc10c4879b13d2030185e5640a087cd,1,4,4,8,4,2005-09-13 22:45:25,2005-09-13 21:40:47
87a71b65acc10c4879b13d2030185e5640a087cd...6511cce24b932eba33d8e13b54664673121a8b7e,1,18,5,23,3,2005-09-13 22:45:25,2005-09-13 21:41:16
6511cce24b932eba33d8e13b54664673121a8b7e...daae66994967ba503f5e868eddf6962a2c1d7871,1,13,14,27,4,2005-09-13 22:45:26,2005-09-13 21:41:39
daae66994967ba503f5e868eddf6962a2c1d7871...74376a686425c6304eafff9f26d8d5fb0d083bc0,1,2,2,4,2,2005-09-14 04:09:03,2005-09-14 04:09:03
74376a686425c6304eafff9f26d8d5fb0d083bc0...2ba6c47be1762726ad0c1d5779064c489150d789,1,9,6,15,1,2005-09-14 05:27:42,2005-09-14 05:27:42
aba2da13391d2adc72c0a2805e7196db2c803753...9740d289ee76097a2ec43e59f7ecb8974bcf8634,1,110,0,110,1,2005-08-27 06:53:07,2005-08-27 06:53:07
9740d289ee76097a2ec43e59f7ecb8974bcf8634...5f5608bcec417d4c92ac727fdcc83563730c21e9,2,21,13,34,4,2005-08-28 06:20:24,2005-08-27 20:54:42
5f5608bcec417d4c92ac727fdcc83563730c21e9...9a9cbb6e9f2a5ceca16cae2a959a7162abc36c54,1,4,0,4,1,2005-08-28 19:14:30,2005-08-26 17:37:17
9a9cbb6e9f2a5ceca16cae2a959a7162abc36c54...9804b7dc1974d59d4d37c37ba4624bb835456207,2,7,8,15,3,2005-08-28 19:15:09,2005-08-26 23:53:26
9804b7dc1974d59d4d37c37ba4624bb835456207...ba966b957908248396402acd785d10ba1da07294,1,30,2,32,4,2005-08-28 19:15:10,2005-08-26 09:12:50
ba966b957908248396402acd785d10ba1da07294...e70a165d3db26dbab62e3430553a21d5e97b74ec,1,1,1,2,1,2005-08-28 21:24:01,2005-08-28 15:24:27
e70a165d3db26dbab62e3430553a21d5e97b74ec...ff3412ee1f74cc267e6d65c03c5fd8ea2214fbe7,1,176,0,176,1,2005-08-28 21:24:05,2005-08-28 15:25:06
ff3412ee1f74cc267e6d65c03c5fd8ea2214fbe7...debb9d84445239ffbc630611548af630fb8e1e7a,1,101,0,101,1,2005-08-28 21:24:06,2005-08-28 15:25:10
debb9d84445239ffbc630611548af630fb8e1e7a...f58b7432d286d30117e76aeca5515c67b3ba5bb0,2,13,20,33,9,2005-08-28 21:32:30,2005-08-28 21:16:01
f58b7432d286d30117e76aeca5515c67b3ba5bb0...a698bafb5529f7a1dbf6c105428fff8eae564484,1,4,2,6,2,2005-08-28 21:32:39,2005-08-28 21:17:15
a698bafb5529f7a1dbf6c105428fff8eae564484...9847f7e0db8359b3932fd51290d777610090c33f,1,55,7,62,3,2005-08-29 00:54:18,2005-08-29 00:54:18
daad3aa255ec5c08f95867feaaf8f4db03346e70...50d829c11a3c82a8b23f2e165ab6944dfd9bbb36,1,14,21,35,2,2013-12-03 22:47:18,2013-12-03 22:33:10
50d829c11a3c82a8b23f2e165ab6944dfd9bbb36...ca02465b41311fe7634acb9bb5b5c61975ef5f38,5,96,8,104,11,2013-12-04 23:11:08,2013-12-03 23:41:15
ca02465b41311fe7634acb9bb5b5c61975ef5f38...fc9261ca611080b1dae76b86b3bf5f36d592042f,2,41,0,41,3,2013-12-04 23:12:34,2013-12-04 00:23:35
bd513393554217c1f224d1a18cd20529e21055a5...86ae05127449b88a55f120634d809a765af12a82,2,22,1,23,2,2014-05-08 17:05:22,2014-05-08 17:05:22
86ae05127449b88a55f120634d809a765af12a82...e28dcdce137b6ce53343aec3a4eccc0cd6f294b5,1,1,1,2,1,2014-05-08 17:26:26,2014-05-07 23:44:01
ccfa587787aa4f3f0990ae45af18b84b55e2c74e...1dc51c663c0a1c58c935677c614d31ddf687b3f1,1,6,2,8,2,2014-05-07 22:51:17,2014-05-07 22:50:15
64a03e970ab3ef0ce45d6bd3c1de1bff1de2beee...bc1c2caa7397e7e462f0cc7631a40f6e7cd480ab,1,8,2,10,2,2015-02-17 18:42:43,2015-02-17 18:06:14
7fd90e0e72d489916f08b359b036dfc7b22c7513...4224916ae979204f13db2996d9e32490e0acb90f,4,31,3,34,5,2014-01-13 19:28:26,2014-01-13 19:28:26
d98c916e8f02c01764831c12553f21de12624892...79fcbf7e703ca5805ebd46b2c7e09d0703f1c1ff,2,13,1,14,3,2014-01-17 20:30:14,2014-01-17 20:30:14
c57f6281ff847db7094d708f5c5b939d378f7120...a8933469309c492ad69af3f25bfddc7b245ab9c3,1,2,0,2,1,2014-01-10 19:28:12,2014-01-08 16:33:44
0ce2e396ee9fb0fa07e8381b338e49859dbf03db...212eb96a96e256933a76e48d85fa4f500bed0dee,2,15,1,16,2,2013-06-21 15:36:07,2013-06-21 11:38:00
0ce2e396ee9fb0fa07e8381b338e49859dbf03db...547d058fb6fefad147675a6d3fdb9439c57916a1,1,5,13,18,3,2012-10-16 17:08:23,2012-10-16 10:22:15
0ce2e396ee9fb0fa07e8381b338e49859dbf03db...656197ad380506ca0e8a0355701f9d9a4a398f66,3,16,6,22,3,2012-09-25 18:07:15,2009-07-24 23:45:00
0ce2e396ee9fb0fa07e8381b338e49859dbf03db...ca92e59e30b503ff8861b6cd4d431d38738a7ee8,6,40,9,49,11,2012-08-30 19:26:50,2012-08-29 06:15:54
ca92e59e30b503ff8861b6cd4d431d38738a7ee8...d023c248a39a7ac3ee226e34eadcee6913913f2f,1,15,0,15,1,2012-08-30 21:00:18,2012-08-29 06:15:55
d023c248a39a7ac3ee226e34eadcee6913913f2f...a73e22e96350c9bcb5c0e31e0298ce67bec0a527,3,7,3,10,3,2012-08-30 21:00:23,2012-08-29 06:15:56
0ce2e396ee9fb0fa07e8381b338e49859dbf03db...05df532655e14ba351b4ee8a0acd8f190ed0b745,1,5,2,7,2,2012-07-19 17:33:44,2012-07-19 08:27:09
0ce2e396ee9fb0fa07e8381b338e49859dbf03db...76759c7dff53e8c84e975b88cb8245587c14c7ba,13,446,10,456,18,2012-07-09 05:03:46,2012-07-08 13:50:25
0ce2e396ee9fb0fa07e8381b338e49859dbf03db...16b183094e7c93e194bc2c471e95fe3386e6fb69,1,2393,685,3078,448,2012-07-01 22:04:09,2012-07-01 22:04:09
0ce2e396ee9fb0fa07e8381b338e49859dbf03db...b4ab1980da71344e5ebb65242f52d68b1a03c42d,6,6,6,12,6,2012-06-19 18:35:19,2012-06-19 17:56:09
b4ab1980da71344e5ebb65242f52d68b1a03c42d...d28436736a078a429213003a9472e8caeb86c286,1,1,1,2,1,2012-06-19 18:36:57,2012-06-19 18:36:57
a1a031d9356cc89cadc5e14acc4028e3ecc306eb...7256fd7c8024e3886556d9a19e84a8d20ded1a17,1,166,4,170,16,2012-06-08 02:40:20,2012-06-08 02:40:20
7256fd7c8024e3886556d9a19e84a8d20ded1a17...b694fbb1440976d1aa86f05fd819eb81b0fbc85a,1,197,20,217,18,2012-06-08 04:24:35,2012-06-08 04:07:25
a1a031d9356cc89cadc5e14acc4028e3ecc306eb...95cfe9588aaa4036913a6d10fd309ce3a3d23f3b,1,4,2,6,1,2012-06-07 18:49:16,2012-06-07 12:05:11
95cfe9588aaa4036913a6d10fd309ce3a3d23f3b...2ca0c53b3198787ba33fe1aebb05799c09778979,1,4,2,6,1,2012-06-07 18:58:09,2012-06-07 12:05:13
2ca0c53b3198787ba33fe1aebb05799c09778979...72a23e6449bc29358760b2ccdfacbd9aa37e9b36,1,6,6,12,2,2012-06-07 18:58:10,2012-06-07 12:05:14
16798d0f48c64c4d967c1598a6748ff8c1b87112...8275905e7e9e8945f0bffdd207f622be39026943,1,13,13,26,20,2012-05-04 16:31:28,2012-05-04 13:52:36
16798d0f48c64c4d967c1598a6748ff8c1b87112...21dfc09d0aac0c1909958b09358957e9388ed238,1,23,9,32,3,2012-05-04 16:12:24,2012-05-03 13:12:00
ce5cf6ffc6feb9fb4f9a50cdfa2f527fa119c94f...5ed75e2a3fb30f93fea7772e481ec6091e9a2c5f,6,144,65,209,17,2012-09-14 17:04:29,2012-09-14 06:52:03
9376c8603fc1f9b5bf663b76705dfee77f71ef82...d4a7ffaae3fa3302a73e00dab01b80c4bfd17cdb,3,3,3,6,3,2012-10-08 21:37:43,2012-10-08 08:08:01
9376c8603fc1f9b5bf663b76705dfee77f71ef82...6347e71619999481139862ac06f0f295ecf98658,1,6,2,8,1,2012-10-08 21:18:19,2012-10-08 17:26:53
9376c8603fc1f9b5bf663b76705dfee77f71ef82...44da6f69ecc4200a488b0647be9f5cb75cae6c4d,1,1,1,2,1,2012-10-05 03:34:28,2012-10-04 07:58:15
44da6f69ecc4200a488b0647be9f5cb75cae6c4d...e6dbffa67b8e4c463a8fe18e8599b8623d7f0485,4,6,22,28,5,2012-10-05 03:34:28,2012-10-04 08:00:19
e6dbffa67b8e4c463a8fe18e8599b8623d7f0485...6c4a060d7d895c90610eb442cb4f910fe43ef13a,1,9,2,11,1,2012-10-05 03:34:28,2012-10-04 08:02:53
6c4a060d7d895c90610eb442cb4f910fe43ef13a...435c83323713066723e4194cd89c31bbec7011a2,1,3,11,14,2,2012-10-05 03:34:29,2012-10-04 08:03:33
9376c8603fc1f9b5bf663b76705dfee77f71ef82...01cd63c4a49ea1e46a2ca371898ee8142e7b79cd,1,7,7,14,7,2012-10-04 17:13:43,2012-10-04 14:23:14
d519e4594c17ea30e33432dd712d2d0887aaf8c7...4c6c949c7da91cdef7b6ce5a25bf7f0584d80e8a,2,4,12,16,9,2012-10-08 18:45:41,2012-10-08 18:45:41
4c6c949c7da91cdef7b6ce5a25bf7f0584d80e8a...9979a507c56c647353ac6e2d9dd1ceb21a5f25d7,1,1,1,2,1,2012-10-09 21:19:37,2012-10-09 14:26:11
a6772946a554ad97ea4f6febbff3b98fbaa2f5bf...6c109904bc87987364e37e214138cff8fcaa924a,2,83,1,84,7,2012-09-20 00:31:25,2012-09-19 10:03:30
abd66f2207f4ed3ef54b526004120a9f0eddf67a...db7fde9caeb9f9d9bc30a5a751a1618509c8a2f9,1,1,1,2,1,2012-10-26 12:38:15,2012-10-25 15:58:19
abd66f2207f4ed3ef54b526004120a9f0eddf67a...2c3af7e748206f385c85d35b902bce522107360b,1,105,71,176,22,2012-10-16 23:17:50,2012-10-14 05:42:24
2c3af7e748206f385c85d35b902bce522107360b...1899cbc5b2e2cb3e7c98cceed818d8adfb242ec2,1,28,0,28,5,2012-10-16 23:17:50,2012-10-14 05:42:25
1899cbc5b2e2cb3e7c98cceed818d8adfb242ec2...51a7e6dbc9b871ddfd73752e1a1b254e38e4336b,1,91,0,91,1,2012-10-16 23:17:51,2012-10-14 05:42:26
51a7e6dbc9b871ddfd73752e1a1b254e38e4336b...658b57ad523e0108bafe5f5d56dbb99c0f3ef95c,1,365,1,366,4,2012-10-16 23:17:51,2012-10-14 05:42:27
658b57ad523e0108bafe5f5d56dbb99c0f3ef95c...eb5dcb2c0290aa0cdbbd3f6c9ddfa77f251deacf,1,169,2,171,9,2012-10-16 23:17:52,2012-10-14 05:42:28
eb5dcb2c0290aa0cdbbd3f6c9ddfa77f251deacf...bfdafa099eb9fd8c3b99f5debdddfa251dcdd855,1,145,11,156,7,2012-10-16 23:17:53,2012-10-14 05:42:29
bfdafa099eb9fd8c3b99f5debdddfa251dcdd855...d66e8f8cf33909fe43f58ca5d87de8624986425c,1,198,30,228,17,2012-10-16 23:17:53,2012-10-14 05:42:30
d66e8f8cf33909fe43f58ca5d87de8624986425c...61717661e6ffc8aa4d0928d04edafa0961e6aadb,1,509,202,711,79,2012-10-16 23:17:54,2012-10-14 05:42:31
61717661e6ffc8aa4d0928d04edafa0961e6aadb...aa7aab3b0b4e001f10c5c7d8f721aaff8753cd88,1,558,0,558,1,2012-10-16 23:17:55,2012-10-14 05:42:32
aa7aab3b0b4e001f10c5c7d8f721aaff8753cd88...96bc8f66f9f3a56c89c9440171049c95f162a3fa,1,37,0,37,1,2012-10-16 23:17:55,2012-10-14 05:42:33
96bc8f66f9f3a56c89c9440171049c95f162a3fa...76095f6d609a465840f62dd601a1ad9f90c75330,1,6,3,9,3,2012-12-09 09:37:49,2012-12-08 21:33:38
76095f6d609a465840f62dd601a1ad9f90c75330...173581412819d5be9035e641bc895d5d4a468d6a,1,13,18,31,2,2012-12-09 09:37:50,2012-12-08 21:33:55
173581412819d5be9035e641bc895d5d4a468d6a...341bf11245463a59dc20060f3157386b6d4aa7e4,1,10,10,20,9,2012-12-09 09:37:51,2012-12-08 21:34:15
341bf11245463a59dc20060f3157386b6d4aa7e4...0684371844335bb20979bc308e1b133de30abaee,1,30,30,60,21,2012-12-09 09:37:51,2012-12-08 21:34:38
0684371844335bb20979bc308e1b133de30abaee...bd6f62c3ff61873dc6a323020162067536283a53,1,50,56,106,34,2012-12-09 09:37:52,2012-12-08 21:34:55
bd6f62c3ff61873dc6a323020162067536283a53...941c1e0402442cebf0add6b609a0efc23f520446,1,1,1,2,1,2012-12-09 09:37:52,2012-12-08 21:35:06
941c1e0402442cebf0add6b609a0efc23f520446...eacdd428bcc32dcb934c0e1e67ba187fb872c290,1,6,6,12,4,2012-12-09 09:37:53,2012-12-08 21:35:39
eacdd428bcc32dcb934c0e1e67ba187fb872c290...828eff76b058c21912e1c6dac33dde1b5d9f913a,1,376,375,751,45,2012-12-09 09:43:45,2012-12-08 21:35:53
87a5461fa7b30f7b7baf27204f10219d61500fbf...9ab55daa55377fa258c18ffb90211547e299eec9,3,62,11,73,14,2012-10-21 19:17:38,2012-10-21 11:32:33
87a5461fa7b30f7b7baf27204f10219d61500fbf...ce80ca566af713c85ce3a1c20b466486058a971a,1,43,19,62,3,2012-10-18 22:40:13,2012-10-18 07:25:22
ce80ca566af713c85ce3a1c20b466486058a971a...3c730fab2cae1bb52d34620af170a628b3b8c537,2,16,35,51,5,2012-10-18 22:43:49,2012-10-18 10:33:02
87a5461fa7b30f7b7baf27204f10219d61500fbf...f3f47a1e8ddbecb0865be3d4c5dfef609cb58867,3,30,6,36,10,2012-10-18 22:01:35,2012-10-18 14:15:50
87a5461fa7b30f7b7baf27204f10219d61500fbf...f5d0e162c49320d5069a63a05960fc5a38d72423,1,21,12,33,3,2012-10-18 21:36:16,2012-10-18 12:02:51
f5d0e162c49320d5069a63a05960fc5a38d72423...22ed79275360a3dbb480e2c510a94c4b817afad2,1,10,5,15,3,2012-10-18 21:36:16,2012-10-18 12:04:08
22ed79275360a3dbb480e2c510a94c4b817afad2...566c7707db4eb18a116659b08d6ff7ad79fcfefd,2,12,1,13,2,2012-10-18 21:36:16,2012-10-18 12:05:17
566c7707db4eb18a116659b08d6ff7ad79fcfefd...0fe700e311f2d7e55eb23fe941fab9155d7f91df,2,17,2,19,4,2012-10-18 21:36:17,2012-10-18 12:07:11
0fe700e311f2d7e55eb23fe941fab9155d7f91df...13baa9fe866f63311af5a5ee318beddb16eb5df4,2,13,11,24,4,2012-10-18 21:36:17,2012-10-18 12:08:03
87a5461fa7b30f7b7baf27204f10219d61500fbf...e297cf5aff0264c16b6c325c0beab71bc04cd496,3,5,15,20,5,2012-10-18 05:42:40,2012-10-18 00:12:55
e297cf5aff0264c16b6c325c0beab71bc04cd496...76141e2e6280101362c3c5ddb22699b6f0458100,4,11,15,26,11,2012-10-18 05:42:40,2012-10-18 04:41:54
76141e2e6280101362c3c5ddb22699b6f0458100...ddf333f66cb8b8647a40e5d39731eaf63ee9fd44,3,18,7,25,6,2012-10-18 05:42:40,2012-10-18 01:51:47
ddf333f66cb8b8647a40e5d39731eaf63ee9fd44...5a664cf2c76ed83166f5f3ce7385e3cb058e8834,2,3,3,6,2,2012-10-18 05:42:40,2012-10-18 02:02:46
5a664cf2c76ed83166f5f3ce7385e3cb058e8834...212620fe7e74f6bd4a30a5a39d7c7b3f685ef888,2,14,4,18,3,2012-10-18 05:42:40,2012-10-18 03:48:25
212620fe7e74f6bd4a30a5a39d7c7b3f685ef888...bd1470b8cb0cfb42c7de3b9084cdd8ae53aa1d4c,3,17,6,23,8,2012-10-18 05:42:40,2012-10-18 04:27:22
bd1470b8cb0cfb42c7de3b9084cdd8ae53aa1d4c...e422c0cf1cd76e9c7957b46b317d1d8fabcdd8ee,1,14,1,15,2,2012-10-19 20:01:05,2012-10-19 20:01:05
e422c0cf1cd76e9c7957b46b317d1d8fabcdd8ee...76323c67b7729076e4f905f6d227329a47e6443f,1,2,1,3,1,2012-10-25 10:15:56,2012-10-21 21:34:07
76323c67b7729076e4f905f6d227329a47e6443f...e39b307d09c41ff660f4ddfcecbcb08177fcd4f3,1,4,0,4,1,2012-10-25 10:15:56,2012-10-21 21:34:09
e39b307d09c41ff660f4ddfcecbcb08177fcd4f3...6454d9f166236965c84650f72ecdd17e309394d6,1,6,7,13,1,2012-10-26 13:25:04,2012-10-21 21:34:10
6454d9f166236965c84650f72ecdd17e309394d6...d84cef1817be9615729b26e3965e8cb8da926dc5,1,7,0,7,1,2012-10-26 14:31:38,2012-10-21 21:34:08
d84cef1817be9615729b26e3965e8cb8da926dc5...1d34c50f132d2234bd70956ef99b2b94786d43dd,1,21,10,31,3,2012-11-13 23:02:46,2012-11-13 18:09:07
87a5461fa7b30f7b7baf27204f10219d61500fbf...74faaa16f016af9fc429770ba701f2aa598d9f21,4,42,36,78,15,2012-10-17 18:50:50,2012-10-17 17:00:37
a3935e6791c619a9f2f472e9e553d45d88c4e263...15793646acba291dc2709cb82d3f72cd5be8c6c0,1,15,9,24,2,2012-07-09 21:36:26,2012-05-16 22:31:18
15793646acba291dc2709cb82d3f72cd5be8c6c0...f3b8f91a6919c8ab806016791c4a4bfd63c5169c,1,8,2,10,2,2012-07-09 21:36:26,2012-05-16 20:21:39
f3b8f91a6919c8ab806016791c4a4bfd63c5169c...798b9ce87bfcd18896f9b0e21918b7bf31109b32,1,2,2,4,1,2012-07-09 21:36:26,2012-05-08 21:38:06
798b9ce87bfcd18896f9b0e21918b7bf31109b32...e42a96e7726365557b5865957927dc1ca272cad2,1,11,7,18,5,2012-07-09 21:36:26,2012-05-08 22:11:02
e42a96e7726365557b5865957927dc1ca272cad2...f4c66eeddd37d3e5f4043df89c2679fbadeb57bd,1,13,7,20,2,2012-07-09 21:36:26,2012-06-13 05:47:12
f4c66eeddd37d3e5f4043df89c2679fbadeb57bd...37b9c903eb825ca741ea0eddc942309f892b682f,1,12,3,15,3,2012-07-09 21:36:26,2012-05-08 20:35:21
37b9c903eb825ca741ea0eddc942309f892b682f...ccf998b297c6d04053eaa9d61e9cb4187bccd0a9,1,56,26,82,11,2012-07-09 21:36:50,2012-05-16 21:03:52
ccf998b297c6d04053eaa9d61e9cb4187bccd0a9...5a812661694efed28b4446724278bcc21fe6d6d6,1,40,19,59,3,2012-07-09 21:36:51,2012-06-12 22:23:54
5a812661694efed28b4446724278bcc21fe6d6d6...813ebf82215ce3e07631ea7ab12b30c609adcccd,1,23,23,46,2,2012-07-09 21:36:51,2012-06-07 21:06:47
813ebf82215ce3e07631ea7ab12b30c609adcccd...ec15be02679ed5a98e4a96b23b99dd1b90196fae,1,29,11,40,7,2012-07-09 21:36:51,2012-06-07 21:10:19
ec15be02679ed5a98e4a96b23b99dd1b90196fae...cfb6f9acc392561bb339763564e21b684e50ce83,2,31,2,33,6,2012-07-09 21:36:51,2012-05-08 20:21:53
cfb6f9acc392561bb339763564e21b684e50ce83...519d1a5b4e044459bd7323cfa6a7cb98cec5c884,1,45,1,46,2,2012-07-09 21:39:21,2012-06-08 16:54:10
519d1a5b4e044459bd7323cfa6a7cb98cec5c884...28ff051268463e93613998a017a10d3de45abbc0,1,50,3,53,7,2012-07-09 21:40:02,2012-05-09 23:10:51
28ff051268463e93613998a017a10d3de45abbc0...e09837e25d50cba97ffcc2934801dbd861e4276d,1,10,10,20,2,2012-07-09 21:40:02,2012-06-13 04:16:02
e09837e25d50cba97ffcc2934801dbd861e4276d...099f3c421a446e2eef3a1bb6aea0e451711ddd88,1,62,8,70,7,2012-07-09 21:40:03,2012-06-07 22:04:11
099f3c421a446e2eef3a1bb6aea0e451711ddd88...4f4a6cb9882516d75f345772c9bf00b891753f10,2,138,6,144,8,2012-07-09 21:40:03,2012-05-09 23:50:58
4f4a6cb9882516d75f345772c9bf00b891753f10...f2633ebd766b7f5817ae0ec69060170bb9b1501f,2,28,0,28,3,2012-07-09 21:40:03,2012-05-10 20:56:49
f2633ebd766b7f5817ae0ec69060170bb9b1501f...78fb67f31edbdcde3580f9abc1048f4630ef1bee,1,10,1,11,2,2012-07-09 21:40:03,2012-05-10 21:08:29
78fb67f31edbdcde3580f9abc1048f4630ef1bee...fdac508933cb2b5265d0bb239eaa50aaa5e64981,1,54,0,54,1,2012-07-10 06:50:10,2012-06-13 05:57:57
a3935e6791c619a9f2f472e9e553d45d88c4e263...f8891cfa2a16d040d799f281684851fa7b2a0c2b,2,19,13,32,3,2012-05-09 21:27:08,2012-05-09 00:44:32
f8891cfa2a16d040d799f281684851fa7b2a0c2b...963c0407f47f5c2c73deb67613f0ac5a0615889c,1,448,0,448,1,2012-05-09 21:27:37,2012-05-09 00:44:33
a3935e6791c619a9f2f472e9e553d45d88c4e263...467d348c19b2ce82753bb9b5a873f6d129eb04e2,2,22,0,22,4,2012-05-09 21:00:15,2012-05-09 20:20:55
467d348c19b2ce82753bb9b5a873f6d129eb04e2...0af596c6ffba19bff4362ac532be35abd67d2630,1,12,5,17,4,2012-05-09 21:03:03,2012-05-09 20:21:56
0af596c6ffba19bff4362ac532be35abd67d2630...5d23ec7664ed41afd92d9d8d7ce5e75f87564f0d,1,13,5,18,5,2012-05-09 21:03:23,2012-05-09 20:22:47
5d23ec7664ed41afd92d9d8d7ce5e75f87564f0d...4b4132fd89b248896d527dffd1ddfb7bbf375a45,1,16,22,38,6,2012-05-09 21:08:27,2012-05-09 20:23:39
4b4132fd89b248896d527dffd1ddfb7bbf375a45...3319e606336c13ba6475d83e700ca53537cedfd9,4,1,54,55,5,2012-05-09 21:08:42,2012-05-09 20:24:34
3319e606336c13ba6475d83e700ca53537cedfd9...be89977543c7798411f336236a506bf07b0a3d71,2,0,46,46,4,2012-05-09 21:13:05,2012-05-09 20:43:30
be89977543c7798411f336236a506bf07b0a3d71...85c20c304f991b33b59fbf00182a66f5cf6d2960,1,1,1,2,1,2012-05-14 17:19:42,2012-05-13 21:41:16
a3935e6791c619a9f2f472e9e553d45d88c4e263...54e6dc7daf8e4160d5ec5d2742ae09d416126a1b,2,25,19,44,17,2012-05-08 17:46:13,2012-05-06 14:23:51
a3935e6791c619a9f2f472e9e553d45d88c4e263...4c5197d10f01f1dce817af05fd0837bce84708b7,1,11,4,15,4,2012-05-08 17:29:39,2012-05-06 13:13:22
ef0065034a68edfc0ffed9965bb895073ad710db...3ac4440801905d11de3ba585c2fe306311db6c45,1,12,5,17,6,2010-02-17 07:00:35,2010-02-16 00:25:40
ef0065034a68edfc0ffed9965bb895073ad710db...7283bbc70a55d7364fbeaefc1009c03fcfc8d929,2,2,2,4,2,2010-02-16 02:20:54,2010-02-15 23:33:18
b10b9184afc9e62140d307dcf2f5d7e625f78c79...3a985c27fe8bb9ed2fa9580a27c4b4dd7c7192ea,1,15,2,17,5,2010-01-30 07:38:31,2010-01-30 07:38:31
3a985c27fe8bb9ed2fa9580a27c4b4dd7c7192ea...31d87385c4fbd7fc4ab295f2848531b5c1021828,1,1,1,2,1,2010-01-30 16:42:42,2010-01-30 16:23:37
31d87385c4fbd7fc4ab295f2848531b5c1021828...bfac23d9534ea88ed2b033cf0cb17b22ec0e4cdb,1,2,0,2,1,2010-01-30 17:11:00,2010-01-30 15:42:58
bfac23d9534ea88ed2b033cf0cb17b22ec0e4cdb...a9c7c4364a6c1e0d95790cf2c8697b5b6ff30b1b,1,5,0,5,3,2010-01-30 21:56:50,2010-01-30 17:45:11
a9c7c4364a6c1e0d95790cf2c8697b5b6ff30b1b...b0883aa6c77111e88496bd0afe073caf68ab9f99,1,5,2,7,3,2010-01-30 21:56:56,2010-01-30 20:08:26
230a4566382860fc26a3f8d578a41c6504cf865f...72a144e213b67621a4c3305dd9a07a200917fbc9,1,4,2,6,1,2010-01-20 03:30:06,2010-01-20 03:30:06
1be224ba6e99f0ab34c998d7fa8023b76a15c8b6...3a7cba95b74dd2460f8b9bf4f7cefa3c21d31fdd,1,11,144,155,11,2009-10-20 05:17:36,2009-10-19 15:42:02
3a7cba95b74dd2460f8b9bf4f7cefa3c21d31fdd...7a7796e9a7cd8f789fa964acbb1eec5efd05436a,1,23,14,37,11,2009-10-20 05:17:36,2009-10-19 15:42:03
7a7796e9a7cd8f789fa964acbb1eec5efd05436a...c94d2dd0807328b1ee4aa8353382caa45bc24055,1,16,21,37,7,2009-10-20 05:17:36,2009-10-19 15:42:04
c94d2dd0807328b1ee4aa8353382caa45bc24055...d23b1ecf11ee48cd9e266ada06f1b8298b917e92,1,1,0,1,1,2009-10-20 05:17:36,2009-10-19 15:42:05
d23b1ecf11ee48cd9e266ada06f1b8298b917e92...f9a88b70f94917f95e247a0e6e4d37f163fb41e3,1,1,1,2,2,2009-10-20 05:17:36,2009-10-19 15:42:06
f9a88b70f94917f95e247a0e6e4d37f163fb41e3...514213bf72cb61725e42440aaf8dd53fa4c33a74,1,21,0,21,1,2009-10-20 05:17:36,2009-10-19 15:42:07
514213bf72cb61725e42440aaf8dd53fa4c33a74...4192e1cd02365c63f1155fc547e4ef2163050c59,1,1,1,2,1,2009-10-23 10:47:37,2009-10-21 17:04:50
4192e1cd02365c63f1155fc547e4ef2163050c59...c36e16385be363a11abaa4a43edd5a2b2b2dff81,3,7,1,8,3,2009-10-23 10:48:04,2009-10-21 17:04:51
c36e16385be363a11abaa4a43edd5a2b2b2dff81...9bccfcdbff3b11e11a69d05c50c8bc1a9a6dbb5f,1,2,0,2,2,2009-10-23 10:48:31,2009-10-22 18:26:29
1be224ba6e99f0ab34c998d7fa8023b76a15c8b6...1655c98790682aed8892eb8a9eb6d44e00d5f69f,1,3,3,6,3,2009-10-09 21:57:06,2009-10-09 12:26:44
1be224ba6e99f0ab34c998d7fa8023b76a15c8b6...5322ef2006cc93ad76140ff742cd96e74c1ec09b,1,2,2,4,2,2009-10-02 07:32:51,2009-09-30 18:49:24
5322ef2006cc93ad76140ff742cd96e74c1ec09b...e3679ab4a80b7c6e1eb83f3540cff72ff6426b09,1,1,0,1,1,2009-10-02 07:58:24,2009-10-02 00:52:11
e3679ab4a80b7c6e1eb83f3540cff72ff6426b09...b4ae5e2ac4651097d0f2916f8e566f955a8fa586,2,0,0,0,0,2009-10-02 08:00:02,2009-10-02 01:59:20
b4ae5e2ac4651097d0f2916f8e566f955a8fa586...dbc1b1f71052c084a84b5c395e1cb4b5ae526fcb,2,2,1,3,2,2009-10-03 10:04:38,2009-10-03 04:20:18
1be224ba6e99f0ab34c998d7fa8023b76a15c8b6...6962b6b02c93c35163c25e07201f6219e5558f45,1,11,11,22,9,2009-10-01 12:21:35,2009-09-23 18:25:39
1be224ba6e99f0ab34c998d7fa8023b76a15c8b6...ffc01f9baddb09a90ad4c5f391344e6e907851c8,1,1,1,2,1,2009-10-01 08:18:36,2009-09-30 14:49:36
1be224ba6e99f0ab34c998d7fa8023b76a15c8b6...a4f3131c07c1f601be1e24b2143ca7e2deea09b5,3,9,9,18,5,2009-10-01 08:12:21,2009-09-30 18:05:49
a4f3131c07c1f601be1e24b2143ca7e2deea09b5...18660bc96ec0419cc096a53998d3197f2b905e8a,2,6,4,10,5,2009-10-01 08:12:21,2009-09-30 18:05:50
1be224ba6e99f0ab34c998d7fa8023b76a15c8b6...c5022f576aa583429c245054d8600564b788ff33,1,102,54,156,7,2009-09-29 17:06:56,2009-09-29 15:12:57
1be224ba6e99f0ab34c998d7fa8023b76a15c8b6...10d1432aece21ac65a89fe962b1c3019ec1f46e0,1,15,1,16,1,2009-09-29 17:06:52,2009-09-26 18:12:32
1be224ba6e99f0ab34c998d7fa8023b76a15c8b6...fdb0c36e903d13c184f9a465035c75565c5c072a,2,44,2,46,2,2009-09-29 17:06:51,2009-09-26 17:46:08
fdb0c36e903d13c184f9a465035c75565c5c072a...46e09f310567b680c03151e048bf2b7e847611e2,1,5,1,6,2,2009-10-30 23:34:49,2009-10-29 22:07:41
46e09f310567b680c03151e048bf2b7e847611e2...3ce9450a810243cbd9d0250d9ae3ea6834f50b9c,1,87,0,87,1,2009-11-09 03:22:33,2009-11-07 15:13:28
3ce9450a810243cbd9d0250d9ae3ea6834f50b9c...b629275fd02aa07c2630d1a8c8a14011ff164043,2,93,21,114,13,2009-11-09 03:22:45,2009-11-07 15:13:29
b629275fd02aa07c2630d1a8c8a14011ff164043...f74a83fcf04c50e8358c8fb493539af13f9b9aa5,1,12,2,14,1,2009-11-24 06:26:58,2009-11-23 17:33:42
1be224ba6e99f0ab34c998d7fa8023b76a15c8b6...f4ea32f0b48bc300afcb7c980c5a294deba31daa,3,7,2,9,4,2009-09-29 17:06:49,2009-09-24 08:28:15
29981380d03ffa63765dbeaea53a7ac9e8d6bc4f...1b0b962d771fb734cbf273f216b487bb58dec7b9,1,2,0,2,1,2010-07-25 17:33:47,2010-07-20 04:46:21
29981380d03ffa63765dbeaea53a7ac9e8d6bc4f...c008c0ff2087da7b98adfa760247776619b32224,1,23,8,31,4,2010-07-13 20:53:20,2010-07-13 00:27:46
29981380d03ffa63765dbeaea53a7ac9e8d6bc4f...b1f47514f207b0601de7b0936cf13b3c0ae70081,2,16,5,21,3,2010-07-09 00:27:43,2010-07-09 00:27:43
77097faa5dc3da2947f4a4bdb6f8a7766f4ef89a...28bea9e53481fddcb12e63d8c049f0ff2917a573,10,22,3,25,21,2009-11-16 02:24:58,2009-11-14 21:33:13
0205e72f088322a70a77643a7cd2d8b23ee07e14...f64b4856243a9ea9445068a0989c71a8915c3862,1,3,2,5,3,2010-01-12 20:33:30,2010-01-12 15:38:34
f64b4856243a9ea9445068a0989c71a8915c3862...05c95dbe44b42f9c3f7efe6793d311a26e1b8181,1,16,5,21,4,2010-01-12 20:34:07,2010-01-12 15:38:35
05c95dbe44b42f9c3f7efe6793d311a26e1b8181...234b3dae2fe83ae7df2c82194cd5f5eb01fd166d,2,25,1,26,2,2010-01-12 20:34:50,2010-01-12 15:38:36
0205e72f088322a70a77643a7cd2d8b23ee07e14...f59baa502f49c3f1579a82bc37d2bb3ce9e7b5da,3,120,0,120,7,2010-01-07 01:18:56,2009-12-08 03:13:14
3880c18336a77b1a37ec88e5a515498c73eb5551...9a424b276c409a3510e7735b6ecc012f50dc2a49,1,21,1,22,2,2009-12-06 01:48:39,2009-12-05 00:51:41
19c61a58cf4e989cee2f11ad856c6c18c039486f...45d76f17182278d4c1de37b3eed60beb3b2f21ab,1,13,3,16,5,2010-01-21 04:01:52,2010-01-20 14:09:16
2cf6b4bfec068cf24bdc3e4d46ad233091471a02...36e561064e83d3f890f8fa128b3ca4e0d7691f10,1,1,1,2,1,2009-10-24 19:25:01,2009-10-24 13:06:57
36e561064e83d3f890f8fa128b3ca4e0d7691f10...3319df6f3aa3271124847e2c91c7e6d0be961bc6,1,1,1,2,1,2009-10-25 00:21:24,2009-10-24 23:39:19
e79999b1a285d4dcf1d84bc893c864516a390cfa...ae0b27023018416c0bfe54823466dee67c20705a,1,16,2,18,4,2009-10-19 07:57:29,2007-11-11 14:14:15
ae0b27023018416c0bfe54823466dee67c20705a...a94410c8134581f2f11a7db838da4d8725911a3c,2,26,9,35,11,2009-10-19 07:57:29,2008-11-10 17:47:00
a94410c8134581f2f11a7db838da4d8725911a3c...00d3947366a50a06da40989a1fd1e3f99885a4c3,1,13,0,13,1,2009-10-23 06:20:16,2009-10-19 06:40:35
cfe370c6476392095bc3f18013d195b1cccd6184...8de65185e873d361ede4d6994ef257e4ac55f37d,1,5,1,6,2,2010-01-19 05:14:49,2010-01-19 05:14:41
6ff9ae9f97101c30897332f608f35ad232b1faf2...452e2256d2d7cb5494ca10fcbbb6bdf29570f2c0,1,1,2,3,1,2009-10-14 08:14:45,2009-10-13 19:51:36
6ff9ae9f97101c30897332f608f35ad232b1faf2...c6dfb399448f6de17ce417052f1bb345c9e022c9,1,1,0,1,1,2009-10-14 06:24:58,2009-10-13 10:53:28
c6dfb399448f6de17ce417052f1bb345c9e022c9...d01a8e32fe10f1086e5e427f85237baff218fb01,2,3,1,4,2,2009-10-14 08:19:15,2009-10-13 22:11:09
d01a8e32fe10f1086e5e427f85237baff218fb01...583371af1f88e9cd48fedbb6bbb147d8091fd591,1,7,1,8,1,2009-10-14 08:19:29,2009-10-14 03:02:04
c274db7057318835e975c26284f6f9d723b938f3...609621a4ad8144e56df6e5f811eb037661967f49,1,1,1,2,1,2009-10-31 02:20:53,2009-10-31 00:47:20
609621a4ad8144e56df6e5f811eb037661967f49...f5615d246770a2796e60b06dd5e17f5e79d5dd0c,2,76,12,88,17,2009-10-31 02:20:53,2009-10-31 00:47:21
f5615d246770a2796e60b06dd5e17f5e79d5dd0c...743c4b7b0fa5422d1bb5dc59c6cb919a881dd98b,1,1,1,2,1,2009-10-31 02:20:53,2009-10-31 00:47:22
743c4b7b0fa5422d1bb5dc59c6cb919a881dd98b...edace6f02eeae6f4a06ed1e4f6308703523d8535,3,39,25,64,14,2009-10-31 02:20:53,2009-10-31 00:47:23
edace6f02eeae6f4a06ed1e4f6308703523d8535...28754ab5f0ce9b4f6ca1641c3e10e2c68bd9b3fc,3,21,22,43,3,2009-10-31 02:20:53,2009-10-31 00:47:24
28754ab5f0ce9b4f6ca1641c3e10e2c68bd9b3fc...78affc49ded26700450d25168534af02b29a6c61,2,50,22,72,15,2009-10-31 02:20:54,2009-10-31 00:47:25
78affc49ded26700450d25168534af02b29a6c61...37a8768f83d5932ca66202f9cc4977c20b022e17,1,14,10,24,7,2009-10-31 02:20:54,2009-10-31 00:47:26
37a8768f83d5932ca66202f9cc4977c20b022e17...cff7123c11aa2b1a849a46028d60b4bc0ab54c51,2,2,2,4,2,2009-10-31 02:20:54,2009-10-31 00:47:27
cff7123c11aa2b1a849a46028d60b4bc0ab54c51...292ce46b60e2c12450c5c21044acf9c41bd837df,3,115,26,141,17,2009-10-31 02:20:54,2009-10-31 00:47:28
292ce46b60e2c12450c5c21044acf9c41bd837df...ef08ef9ea0a271e5be5844408d2496a946d6e8d9,3,198,2,200,16,2009-10-31 02:20:54,2009-10-31 00:47:29
ef08ef9ea0a271e5be5844408d2496a946d6e8d9...ae4efe195752c27cb25fca9451852c0f4eebdb28,6,287,54,341,38,2009-10-31 02:20:54,2009-10-31 00:47:30
ae4efe195752c27cb25fca9451852c0f4eebdb28...d8f67d205eb98ea6dab915c29122158054218128,2,3,1,4,2,2009-10-31 02:20:54,2009-10-31 00:47:31
d8f67d205eb98ea6dab915c29122158054218128...2f4038ab337e55017d4ff21ddbae9427544ca02c,4,396,0,396,4,2009-11-05 01:58:04,2009-10-31 00:47:32
2f4038ab337e55017d4ff21ddbae9427544ca02c...42526b478e369d7e8c9a95186ad87fae9930eea5,2,56,10,66,9,2009-11-05 01:58:14,2009-10-31 00:47:33
42526b478e369d7e8c9a95186ad87fae9930eea5...556cfa3b6d316074d41cd73c4659402fdb6207c8,2,359,4,363,12,2009-11-05 01:58:15,2009-10-31 00:47:34
556cfa3b6d316074d41cd73c4659402fdb6207c8...917adc036086f52b0277ff03d10b7044c9d9d0d2,2,39,25,64,12,2009-11-05 01:58:15,2009-10-31 00:47:35
917adc036086f52b0277ff03d10b7044c9d9d0d2...b9af4ab3cd33f699ea2a978acb83dbddf07900e6,1,8,4,12,3,2009-11-05 01:58:15,2009-10-31 00:47:36
b9af4ab3cd33f699ea2a978acb83dbddf07900e6...0ebb1fa78eb9d6b27ae79c9e48e9306bcfa2a4ac,1,3,7,10,1,2009-11-05 01:58:15,2009-10-31 00:47:37
0ebb1fa78eb9d6b27ae79c9e48e9306bcfa2a4ac...8127f778a0f6495a0b8484a21b5591e56d873de8,1,33,0,33,2,2009-11-05 01:58:15,2009-10-31 00:47:38
8127f778a0f6495a0b8484a21b5591e56d873de8...f5ba2d18f96037749f370c1386935e60f034c87e,1,1,1,2,1,2009-11-05 01:58:15,2009-10-31 00:47:39
f5ba2d18f96037749f370c1386935e60f034c87e...97cc7bc45c2e076184b84749952b216036a6ecd6,1,131,17,148,12,2009-11-05 01:58:15,2009-10-31 00:47:40
97cc7bc45c2e076184b84749952b216036a6ecd6...de1a2fdd38b138c4e4fed6412783dcb74d63d2da,8,374,15,389,33,2009-11-05 01:58:15,2009-10-31 00:47:41
79f7ca063d6b74e9d7f3db90c85dfa4a162128e4...3994e8a98dc7bbf67e61d23c8125f44383499a1f,1,2,2,4,2,2009-12-03 18:06:13,2009-12-03 17:52:45
035b76b03f63e077e3465a99bee5dffa29822344...d691d84eedc0f02b4caebbee89149fff18e1db91,1,8,3,11,4,2009-11-09 01:59:11,2009-11-07 20:08:01
d691d84eedc0f02b4caebbee89149fff18e1db91...b1b952043f8f909649fdf053c371109c84f9cf56,3,13,13,26,3,2009-11-09 01:59:12,2009-11-07 20:10:31
1d46f2ea143534e46e6bfee3f34cd90b734bfe80...02bc5b03f54b51f8b45c81cce74284ced602e6de,3,47,10,57,14,2009-11-10 19:37:47,2009-11-07 09:51:56
02bc5b03f54b51f8b45c81cce74284ced602e6de...d4cb003fffe2af3b868f57d75a352714e7ab03ac,1,12,2,14,14,2009-11-10 19:38:21,2009-11-07 09:52:29
d4cb003fffe2af3b868f57d75a352714e7ab03ac...dce5ef142046e107e20aa03ca5a353032bbf9653,2,41,41,82,32,2009-11-10 19:38:21,2009-11-07 09:53:07
dce5ef142046e107e20aa03ca5a353032bbf9653...2cfa8330e414bc73b01d45f232f8566afc56dd10,2,4,2,6,2,2009-11-10 19:47:30,2009-11-07 09:58:55
24ab81ae4d12c81076da256b3f9cdde45277f126...8947fdd598848b8ceb2cea9ff42e906c946eae5c,2,25,1,26,2,2009-12-08 07:52:46,2009-12-08 07:49:35
6b276e19fa71fabe64039cf004aba908d7083e82...9c4a036b34acef63ab754f0e27e5e54bd9d9a210,6,247,22,269,18,2009-11-10 09:01:06,2009-11-09 20:09:56
9c4a036b34acef63ab754f0e27e5e54bd9d9a210...16679e373fa85a75c85e6e3b4ae5cd58a89a4114,4,62,1,63,7,2009-11-10 09:01:07,2009-11-09 20:10:32
16679e373fa85a75c85e6e3b4ae5cd58a89a4114...7cc91a2f71c95b4e695549b91c4b629f56887a1a,4,48,6,54,6,2009-11-10 09:01:07,2009-11-09 20:11:06
7cc91a2f71c95b4e695549b91c4b629f56887a1a...e2d41c64bfbea592daeb3a065f1aa3900a03e07f,1,11,0,11,1,2009-11-10 09:01:07,2009-11-09 20:11:59
e2d41c64bfbea592daeb3a065f1aa3900a03e07f...f2ef6075c9d248523bf658d82065b46d892b5601,3,51,24,75,7,2009-11-10 09:01:22,2009-11-10 05:03:31
f2ef6075c9d248523bf658d82065b46d892b5601...3cf6134ad016712ecb78186d9079b9cff7b25416,3,6,5,11,6,2009-11-10 09:01:47,2009-11-10 05:03:32
3cf6134ad016712ecb78186d9079b9cff7b25416...f360d844de4b752b4cba2343b95592ae4d55d09a,2,34,2,36,7,2009-11-10 09:02:07,2009-11-10 08:15:47
f360d844de4b752b4cba2343b95592ae4d55d09a...28a1540132ab98a82cb6ed2cb98458e4e7926acd,2,15,4,19,8,2009-11-10 09:02:12,2009-11-10 08:19:43
28a1540132ab98a82cb6ed2cb98458e4e7926acd...8db355964d89c19eb262ffe38e57e5a610e1cc05,1,28,60,88,11,2009-11-10 09:02:15,2009-11-10 08:21:32
6b276e19fa71fabe64039cf004aba908d7083e82...3f7a9b5ad128151e6eb0b45266779e63e4b2287a,1,7,0,7,2,2009-10-22 19:39:10,2009-10-22 14:14:57
3f7a9b5ad128151e6eb0b45266779e63e4b2287a...7c85d27429784c181ca633fb1465a9c651dbce8a,1,45,43,88,9,2009-10-22 19:39:18,2009-10-22 19:25:20
1ba447b8dc2ec4e6c8ebbbdaa449f38edc29ad3f...74de2781130822c2d7948f77270c2898caf1bf66,1,0,0,0,0,2009-11-02 18:46:23,2009-11-02 09:30:05
9ecb2a7f496413b9a6404e4a19f7edee029819b8...dd2e794a214350711db46c4e08d9b19188a7d63a,12,72,46,118,36,2009-10-20 05:28:20,2009-10-19 15:48:08
dd2e794a214350711db46c4e08d9b19188a7d63a...72b103fec7af967d295410c2fd3899bc6e8386e2,1,32,22,54,7,2009-10-20 05:28:25,2009-10-19 15:48:09
72b103fec7af967d295410c2fd3899bc6e8386e2...8f8f5476cd6542387d435c242752404cf144005f,7,86,3,89,15,2009-10-20 05:28:26,2009-10-19 15:48:10
8f8f5476cd6542387d435c242752404cf144005f...391c53bdcd7bbce366eaef7288afb948525ed3e8,1,1,2,3,1,2009-10-20 05:28:26,2009-10-19 15:48:11
391c53bdcd7bbce366eaef7288afb948525ed3e8...b7b10385a84c741a4fe219807c9511f69403640a,2,1,7,8,2,2009-10-20 05:28:26,2009-10-19 15:48:12
07924d4d50e5304fb53eb60aaba8aef31d4c4e5e...4db4f0fba43d7e9b9b87a3a40d85ffbdfcef2884,1,6,0,6,1,2013-04-05 17:57:23,2013-04-05 11:37:30
4db4f0fba43d7e9b9b87a3a40d85ffbdfcef2884...0895c6d4c09045a3faeb7b652a844fc81c774631,1,3,2,5,2,2013-04-05 18:01:08,2013-04-05 12:19:14
5d2fc9135a35284176e99708b9b6f32c9e6eb7a2...285c6cbf3c8eeadb6d4d4c3203888809e1cc7a81,4,12,12,24,7,2011-08-05 22:04:48,2011-08-05 13:31:29
285c6cbf3c8eeadb6d4d4c3203888809e1cc7a81...9dcca58db42e85e056c6523429204f367a671a0e,1,5,5,10,1,2011-08-05 22:06:21,2011-08-05 22:06:21
2765233c64c35eb43a8b46c377fb8b464469221f...3e8e691abe4e1cce73a8a2ef413dada0278e7b3b,3,72,69,141,30,2011-09-26 16:39:36,2011-09-16 02:12:10
3e8e691abe4e1cce73a8a2ef413dada0278e7b3b...6d9990a959c0168ab6dfe75236980f95ac512ce5,1,4,6,10,4,2011-09-26 16:39:45,2011-09-16 20:19:33
2765233c64c35eb43a8b46c377fb8b464469221f...6ee9033d6715db2f01aaf333a89e98b3b0079222,1,95,77,172,6,2011-06-22 21:04:32,2011-06-22 11:50:46
2765233c64c35eb43a8b46c377fb8b464469221f...d9a25fca5fc01ab4e2e114795c442906bc67de26,2,18,8,26,10,2011-06-22 18:56:53,2011-06-22 10:50:56
d907bf8ef327cd47433d4a4bb0a1bb4e96b6e340...d79bcd68056250d7c03bf9b12728ee2fd85a0ab3,1,49,2,51,5,2011-07-19 17:44:51,2011-07-19 17:44:51
4bbfd8e3da6d5fde8f1e98900523996fd138d9fc...ea1ab4b280ed3b041da53e161e32e38930569f3e,1,15,0,15,3,2011-05-16 23:44:50,2011-05-16 23:44:50
fa38cfc2c6ce197960f85798aac18ee78aa83f1f...21ec98a75d9cecaeb1493462da593343441661b6,2,20,0,20,2,2011-04-07 22:53:02,2011-04-07 17:04:19
21ec98a75d9cecaeb1493462da593343441661b6...3a243f7024f21c2c2205cd861f3bb756b0ec43a0,2,6,5,11,5,2011-04-07 22:54:04,2011-04-07 17:04:20
fa38cfc2c6ce197960f85798aac18ee78aa83f1f...e0e2a9cbfa938d0f1e9857d5ca5b196360663440,2,17,7,24,4,2011-04-06 16:41:22,2011-04-05 21:23:15
fa38cfc2c6ce197960f85798aac18ee78aa83f1f...84393bfd731c435120dc1dda63432a70124821cb,2,14,2,16,6,2011-04-06 03:08:41,2011-04-06 02:20:50
01ddb1ff41cdbd98e257aa4c119a7d51a21f80be...eca9388f398eb3256fafbf875a8a4ff5a73ab6f2,1,0,0,0,0,2010-01-24 22:53:24,2010-01-24 21:40:20
ff76d36b3594dabc6fb47e9e1c3ea49c125541be...f18604bbf2c391c689a41fca14cbaeff5e106255,3,191,0,191,7,2015-01-28 19:17:08,2015-01-28 12:04:37
ff76d36b3594dabc6fb47e9e1c3ea49c125541be...15598cf41beed0d86cd2ac443e0f69c5a3b40321,1,1,1,2,1,2015-01-27 22:39:53,2015-01-27 22:39:53
addfb21a94fb4e6b9d07b270f7bb3748767a8f38...9c9b4f2f8b7f27f3984e80d053106d5d41cbb03b,64,109,105,214,81,2015-01-14 17:32:04,2015-01-13 07:44:47
b52183179bb0a97ea4d91d1248aca303d8e8f892...754395d3052fc0d46948b2ff7006b3c6701785c8,4,26,10,36,13,2012-09-14 19:45:50,2012-09-04 10:39:35
b52183179bb0a97ea4d91d1248aca303d8e8f892...8da650b456d8fd744abf401a67535acbdd6c22c7,2,19,18,37,2,2012-09-06 23:19:57,2012-09-06 22:40:57
8da650b456d8fd744abf401a67535acbdd6c22c7...17264bcc4f580d5e2a94703967236e770f6e236f,1,4,0,4,1,2012-09-06 23:19:58,2012-09-06 22:40:58
17264bcc4f580d5e2a94703967236e770f6e236f...a0601dc11fab5b4525a348b2ad6c9bb92529a281,2,4,2,6,2,2012-09-06 23:19:58,2012-09-06 22:40:59
a0601dc11fab5b4525a348b2ad6c9bb92529a281...a5c45218b63ce7ac6f5a4a48c4312a1e37e01f3f,1,4,0,4,1,2012-09-06 23:19:58,2012-09-06 22:41:00
a5c45218b63ce7ac6f5a4a48c4312a1e37e01f3f...3efe5d1d32fde899b23ebbb1fde499a0897e1c4e,2,4,1,5,2,2012-09-06 23:19:58,2012-09-06 22:41:01
3efe5d1d32fde899b23ebbb1fde499a0897e1c4e...7bcf48dad83e7a07f27403c2ce9e5c29af9e317d,1,11,1,12,1,2012-09-06 23:19:58,2012-09-06 22:41:02
7bcf48dad83e7a07f27403c2ce9e5c29af9e317d...f4c21e89d7c6b578140e90c02b40eccb51ab8428,2,2,2,4,3,2012-09-06 23:19:58,2012-09-06 22:41:03
f4c21e89d7c6b578140e90c02b40eccb51ab8428...379a03ad8194192ab7b2910ec3326a981971fda1,1,18,0,18,1,2012-09-06 23:19:58,2012-09-06 22:41:04
379a03ad8194192ab7b2910ec3326a981971fda1...bacca7852f2f304ebe3f579de1a6cf0152af3df1,1,6,2,8,2,2012-09-10 16:31:44,2012-09-09 15:42:20
b52183179bb0a97ea4d91d1248aca303d8e8f892...2162bd8cc461d6c3a12ab81c5db5a44bf5ecabc3,1,21,6,27,7,2012-09-04 21:06:18,2012-09-04 20:23:38
2162bd8cc461d6c3a12ab81c5db5a44bf5ecabc3...bb52d22ebbc6d8792d3a016e6e89fd6e39c7a39f,1,6,21,27,7,2012-09-18 20:32:39,2012-09-18 20:32:39
bb52d22ebbc6d8792d3a016e6e89fd6e39c7a39f...88182bab001a9b9e9b0acd4b888693fa7c28ff4c,1,21,1,22,4,2012-09-18 20:33:09,2012-09-18 19:46:56
88182bab001a9b9e9b0acd4b888693fa7c28ff4c...227bf59806dc408d60f8f80a14d8dfe71b92c6d2,1,24,3,27,9,2012-09-24 17:22:03,2012-09-24 15:56:23
b52183179bb0a97ea4d91d1248aca303d8e8f892...e27ddb64568412b75035a05366c9f091153155ed,2,20,3,23,3,2012-08-31 21:54:18,2012-08-31 21:54:18
b52183179bb0a97ea4d91d1248aca303d8e8f892...f9c75d858d85449a8a6f635bef4b5bd003edd764,2,13,1,14,3,2012-08-28 22:37:29,2012-08-28 21:29:34
b52183179bb0a97ea4d91d1248aca303d8e8f892...1452bd64f14efd888fe9c732f603173ba7fa595e,2,17,13,30,11,2012-08-27 18:42:28,2012-08-25 18:17:12
c2857fb8b7903b2bba9217310971e5282549174d...c3ea051544cb1d98a5ae7f64d077084a9a5db5c1,1,1,1,2,1,2011-12-14 05:09:06,2011-12-08 10:25:54
c2857fb8b7903b2bba9217310971e5282549174d...cfe21f05bb0051aebc96ed7e805a79778f9bb117,1,1,1,2,1,2011-12-12 19:49:49,2011-12-12 07:50:31
cfe21f05bb0051aebc96ed7e805a79778f9bb117...07b8738967a26dd7ab39d02b86aa805dea567319,2,7,2,9,3,2011-12-12 19:52:31,2011-12-12 07:51:24
07b8738967a26dd7ab39d02b86aa805dea567319...77471646d3d87691b4bcf11682945e6ccc27f9e3,1,1,1,2,1,2011-12-12 19:55:46,2011-12-12 07:51:36
77471646d3d87691b4bcf11682945e6ccc27f9e3...cd40b05d13676a41fc68807c351d0de07eb4c270,1,1,1,2,1,2011-12-12 23:43:38,2011-12-12 21:54:17
cd40b05d13676a41fc68807c351d0de07eb4c270...534376ca04d524b99d69a30bdcf5e70ac8062aee,1,2,1,3,1,2011-12-12 23:43:45,2011-12-12 21:54:42
c2857fb8b7903b2bba9217310971e5282549174d...e47a8583a20256851e7fc882233e3bd5bf33dc6e,1,13,0,13,3,2011-12-06 05:06:53,2011-12-06 04:39:36
cec5dae827f2255578807be6214ece1e0619b8e1...6942a3d796ce7a824bd9a69e88cf0a9578225bb2,1,24,64,88,14,2011-10-18 19:00:33,2011-10-18 09:47:01
6942a3d796ce7a824bd9a69e88cf0a9578225bb2...cb9c9df37acf5ff8a452b5fe2eaf7ad6ff8bfb72,2,9,1,10,2,2011-10-21 21:34:08,2011-10-21 18:42:44
614583fa233afd8f7fb8ed33aa409054ee21e1c4...f6f17885ba2f1ff6f18118a0660f8f662cdb9ffb,1,2,2,4,2,2011-09-26 23:39:34,2011-09-26 12:58:35
f6f17885ba2f1ff6f18118a0660f8f662cdb9ffb...8d714b11df2b65e5f4272c1616e561930010be90,2,0,23,23,2,2011-09-27 17:00:35,2011-09-27 11:56:53
c8e1c3d3e8ed326fe9e8ba5616db2e81a41fcc16...06a4755270b86a2af20a5c1f0d785311472b5223,2,11,10,21,5,2009-11-28 06:33:53,2009-11-28 06:04:10
06a4755270b86a2af20a5c1f0d785311472b5223...89cb73a19ac94d15babf77af490fa5db78908234,5,52,9,61,11,2009-11-28 18:05:44,2009-11-27 06:55:18
c8e1c3d3e8ed326fe9e8ba5616db2e81a41fcc16...e7821d73bd0256bfc15c48945beded063e17c1b6,1,5,0,5,1,2009-11-27 08:28:40,2009-11-27 07:42:25
2ce0edcd786b790fed580e7df56291619834d276...23cb5bf3b3b9699bf00fa38c4c08f32f8c60b529,2,20,12,32,7,2011-12-22 19:21:26,2011-12-22 19:21:26
1c88a6d17492b197b9b3298cbc34efa804928302...cbd6b089e821a4ff35970531b26e64a2e621ff04,1,13,0,13,2,2012-09-11 18:27:35,2012-09-11 18:27:35
1403db49b80630cf8c36ba3e8b0f085ea0ab8286...31b808a03290a4f87c571cc1c61f26d8a03c7025,3,218,18,236,7,2012-09-20 21:15:35,2012-09-20 18:04:08
ca23bd2bea823f0ec514c508e953f14899f08ccb...a2e78c2d87499f82a26a371b21933593dfc31cd5,1,45,0,45,3,2012-09-03 23:23:44,2012-09-03 23:23:44
a2e78c2d87499f82a26a371b21933593dfc31cd5...3fc0e4ca00330ce1dfd92baeda04f0aa2fbd7e68,1,9,0,9,6,2012-09-03 23:24:23,2012-09-03 23:24:23
91e4bfe96f1e72a3ce743fe032bfadfc9509fc2a...68f64ff8b49ce5b32b11fe136ac89f0ba838a61c,1,176,0,176,1,2012-10-07 21:10:16,2012-09-19 15:21:15
68f64ff8b49ce5b32b11fe136ac89f0ba838a61c...48ea9f955f52cab0b259c497b4b960832dddd0ac,2,6,0,6,3,2012-10-07 21:10:16,2012-09-19 15:21:16
48ea9f955f52cab0b259c497b4b960832dddd0ac...fd871b94f6d564864194befa10c621586b7b8bcf,2,19,4,23,4,2012-10-07 21:10:16,2012-09-19 15:21:17
fd871b94f6d564864194befa10c621586b7b8bcf...df7428eca46ec25df5ef14bc7e90120bdc267328,3,30,0,30,3,2012-10-07 21:10:16,2012-09-19 15:21:18
df7428eca46ec25df5ef14bc7e90120bdc267328...bfc366d9315561166861bc97a395afc054c976c3,1,31,13,44,12,2012-10-07 21:10:16,2012-09-19 15:21:19
bfc366d9315561166861bc97a395afc054c976c3...271bfd678bb0397dfc6e0dc599c134eb6e782511,1,20,1,21,2,2012-10-07 21:10:17,2012-09-19 15:21:20
271bfd678bb0397dfc6e0dc599c134eb6e782511...19ba02af476a1d17308f06bc78544d712923ed60,1,1,1,2,1,2012-10-07 21:10:17,2012-09-19 15:21:21
19ba02af476a1d17308f06bc78544d712923ed60...271fd1fc2a25ebfc1782aab0d39b613555d22315,6,12,12,24,12,2012-10-07 21:10:17,2012-09-19 15:21:22
271fd1fc2a25ebfc1782aab0d39b613555d22315...f6529de9f4fc66de7679fa1204da1da50f6292fb,1,33,19,52,4,2012-10-07 21:10:17,2012-09-19 15:21:23
f6529de9f4fc66de7679fa1204da1da50f6292fb...3c23953fb220675c1387c8afc23e0cb7c7ed914c,2,14,0,14,4,2012-10-07 21:10:17,2012-09-19 15:21:24
3c23953fb220675c1387c8afc23e0cb7c7ed914c...a9a55613cb9b92e0dd65f8c4554fd7b562377a6e,3,33,4,37,15,2012-10-07 21:10:17,2012-09-19 15:21:25
a9a55613cb9b92e0dd65f8c4554fd7b562377a6e...8d7cd8eb3b4cee410ee391f7d59610e2f90adf4f,1,11,1,12,5,2012-10-07 21:10:17,2012-09-19 15:21:26
8d7cd8eb3b4cee410ee391f7d59610e2f90adf4f...8e43a1d010e22a0e432de440b08cc4389d8370f9,7,95,17,112,22,2012-10-07 21:10:17,2012-09-19 15:21:27
8e43a1d010e22a0e432de440b08cc4389d8370f9...16a7185447e28312d5e316b92b7d3d37cb25b079,1,53,0,53,1,2012-10-07 21:10:17,2012-09-19 15:21:28
16a7185447e28312d5e316b92b7d3d37cb25b079...5bfc76b5b275bbf0ddc2cf1a3a33fa6156addbd8,1,71,0,71,2,2012-10-07 21:10:17,2012-09-19 15:21:29
5bfc76b5b275bbf0ddc2cf1a3a33fa6156addbd8...e99d012a6bc8b8647a0389d486b5489557364ea6,1,84,0,84,1,2012-10-07 21:10:17,2012-09-19 15:21:30
91e4bfe96f1e72a3ce743fe032bfadfc9509fc2a...889d35899ba64640e47798681ecb34a4be043bad,2,6,1,7,2,2012-08-20 00:02:11,2012-08-20 00:02:11
ccfca8dc26e14f53bbf7ee7257bbd9e8c0dd4bf7...f4d33434dc7f728e3013258235d2239796649f8f,1,422,392,814,369,2012-09-08 01:14:46,2012-09-05 00:47:08
ccfca8dc26e14f53bbf7ee7257bbd9e8c0dd4bf7...c160d03fbbc8aada9f57ee5b4cb775852c69b5f4,1,371,341,712,322,2012-09-07 10:33:23,2012-09-04 23:27:16
c160d03fbbc8aada9f57ee5b4cb775852c69b5f4...2d3c33beb21e4bc7aaf726f74280625103177d05,1,372,340,712,322,2012-09-07 17:10:31,2012-09-05 16:17:29
f350df429fc664129c3a600f0142287ed13a48f7...5c3459fc61c035420c90b7d73e23242493be6cbd,1,5,4,9,2,2013-03-17 05:08:53,2013-03-16 01:25:18
247f9d23da8cfd255533433ad2aa07d172afac0b...ccdc6037fee8761db82ccb8751d9c9442f4a9cc7,1,7,2,9,3,2012-01-05 21:30:54,2012-01-05 21:00:01
ccdc6037fee8761db82ccb8751d9c9442f4a9cc7...926f1dd95486b596de1f6b8e108053a870da0e18,1,7,3,10,3,2012-01-06 21:28:55,2012-01-06 19:17:40
926f1dd95486b596de1f6b8e108053a870da0e18...90108a2441fb57f69c3f25d072d1952b306b77ab,3,14,2,16,3,2012-01-06 21:28:57,2012-01-06 19:18:01
f14f9803ef13e972371e3f4bce69bca13dd1cd2d...592ed5673e3074a0d7e0a6d6626faa783c327c29,1,1,1,2,1,2012-01-11 08:09:36,2012-01-11 03:21:38
592ed5673e3074a0d7e0a6d6626faa783c327c29...37475f97d1fbab0842c17b175263eeba6cd5e318,1,1,0,1,1,2012-01-12 03:07:23,2012-01-12 03:05:03
10dd3b2bf1444695416c0dac951297acf7d4e5e4...57590c72b4d3b02e32732c7d79514c0281d6c2b5,1,8,2,10,2,2011-12-15 03:30:41,2011-12-14 14:07:08
57590c72b4d3b02e32732c7d79514c0281d6c2b5...6ac1b2a3b8bd970e9fc175c42927f00d4d465bbf,1,1,1,2,1,2011-12-15 03:31:03,2011-12-14 14:07:09
10dd3b2bf1444695416c0dac951297acf7d4e5e4...0521710a8b9321751ca8768c3f7ea8895901e5c3,2,37,0,37,3,2011-12-13 21:10:03,2011-12-13 20:17:04
0521710a8b9321751ca8768c3f7ea8895901e5c3...a4ddbc33d7906f0e10c68c140a9a1003d9715a77,6,13,6,19,9,2011-12-14 00:34:44,2011-12-14 00:11:56
10dd3b2bf1444695416c0dac951297acf7d4e5e4...afe7c5ff1f7f6741d35f9852a766d151da23d7d8,6,7,12,19,9,2011-12-13 18:08:24,2011-12-13 00:41:37
afe7c5ff1f7f6741d35f9852a766d151da23d7d8...e9d866e32c0c7411a005cb6d6549d3a89f8102ee,1,3,3,6,3,2011-12-13 18:09:07,2011-12-13 00:44:40
e9d866e32c0c7411a005cb6d6549d3a89f8102ee...1e7ba0f9caf1993491aa4c5cbd796cd31cb0f4af,2,38,4,42,3,2011-12-13 18:17:50,2011-12-13 00:48:08
1e7ba0f9caf1993491aa4c5cbd796cd31cb0f4af...bab8d28e774c255a326ad5592af6351e4925efcb,2,0,22,22,2,2011-12-13 18:18:12,2011-12-13 00:49:59
10dd3b2bf1444695416c0dac951297acf7d4e5e4...497215d8811ac7b8955693ceaad0899ecd894ed2,2,64,7,71,6,2011-12-13 00:48:54,2011-12-12 23:52:51
a2add8570c90e14e8e0cedae935091f100c758dc...ee228024933069b93ce23a1bd5eeb7ae12c792f2,1,18,1,19,5,2011-12-17 06:45:03,2011-12-17 06:45:03
d25a265220f7e9a50693d0ec4bb05c7be0539d69...8742218f21e1e87cf9fceb11b9c14927af5ff33f,1,20,0,20,1,2011-10-21 18:01:07,2011-10-21 18:01:07
97a21ca50ef893a171a50c863fe21a924935fd2a...9f7ef0eaf2e54609128add5e8f9b506bdbb81dff,2,44,0,44,2,2011-11-06 06:17:52,2011-11-05 17:36:07
97a21ca50ef893a171a50c863fe21a924935fd2a...cb585a9cda70320647cc5d69e71bedc929244189,1,6,2,8,2,2011-10-18 03:46:49,2011-10-16 14:46:52
cb585a9cda70320647cc5d69e71bedc929244189...6de040df566d4b4489366aa2ae5cc215ec449618,2,187,77,264,54,2011-10-18 03:46:49,2011-10-16 14:47:52
47d45a5ebd5bce543a50546d05e8b92c6971acda...05f6edcd2a418a88eeb953d51408a6aeef312f5c,1,3,1,4,2,2011-10-16 17:58:35,2011-10-16 17:58:35
05f6edcd2a418a88eeb953d51408a6aeef312f5c...e5fa45c159241b609bce40fa7a8687796e4b941d,2,30,1,31,4,2011-10-17 18:44:18,2011-10-17 18:43:30
4db0d0d1ba94c08f9476c7adff61375a752b154d...cde151815eb409d8dd457e7aaa3ded2e53796343,1,3,0,3,1,2011-08-04 22:53:15,2011-08-04 04:36:11
cde151815eb409d8dd457e7aaa3ded2e53796343...650cfc512e189c1af347c9eeaebc0377e0dcb88d,1,5,5,10,2,2011-08-04 22:53:15,2011-08-04 04:36:12
650cfc512e189c1af347c9eeaebc0377e0dcb88d...d42453ab1a482df0fdb428c20de1189a21a2bee1,1,2,4,6,1,2011-08-04 22:53:15,2011-08-04 04:36:13
d42453ab1a482df0fdb428c20de1189a21a2bee1...c0b13b21b8daa4bfb222e9c4d335c8b340c511a0,2,7,1,8,2,2011-08-04 22:53:15,2011-08-04 04:36:14
c0b13b21b8daa4bfb222e9c4d335c8b340c511a0...dcc04366a4658763500724888d9e74cae317c861,1,1,1,2,1,2011-08-04 22:53:16,2011-08-04 04:36:15
dcc04366a4658763500724888d9e74cae317c861...09d7dd7ad62fef60fc223fa74eb04c8dc783c2f6,1,7,0,7,1,2011-08-04 22:53:16,2011-08-04 04:36:16
09d7dd7ad62fef60fc223fa74eb04c8dc783c2f6...352404ac4ccab144cd866b1f24c90b8f29ca33c2,3,14,1,15,3,2011-08-04 22:53:16,2011-08-04 04:36:17
352404ac4ccab144cd866b1f24c90b8f29ca33c2...66a1fb30335191b5ebdbcc331832e8903eb3cd0e,1,6,7,13,6,2011-08-04 22:53:16,2011-08-04 04:36:18
66a1fb30335191b5ebdbcc331832e8903eb3cd0e...a872701755347efe22be998d1e39f454fc422ff2,1,11,10,21,5,2011-08-04 22:53:17,2011-08-04 04:36:19
a872701755347efe22be998d1e39f454fc422ff2...2d72174492b926dffd15d5fd8f4239060fb12247,1,14,3,17,5,2011-08-04 22:53:17,2011-08-04 04:36:20
2d72174492b926dffd15d5fd8f4239060fb12247...cd93bffb91630d8c695e1ac59239aa75cc2ebf92,1,0,1,1,1,2011-08-04 22:53:17,2011-08-04 04:36:21
cd93bffb91630d8c695e1ac59239aa75cc2ebf92...7373eab48e284a808cde766831172d3447f9e320,1,1,2,3,1,2011-08-04 22:53:17,2011-08-04 04:36:22
7373eab48e284a808cde766831172d3447f9e320...ee548df3005d976d4e6a78b3b4454fed812ea28c,3,67,14,81,5,2011-08-04 22:53:18,2011-08-04 04:36:23
ee548df3005d976d4e6a78b3b4454fed812ea28c...46f96a6d8ed70ecac7c1532d7f9775320409917b,1,9,3,12,3,2011-08-04 22:53:18,2011-08-04 04:36:24
46f96a6d8ed70ecac7c1532d7f9775320409917b...d6541bb1ac753a3cc0b92021cf82b07cf459cb28,1,7,6,13,5,2011-08-04 22:53:18,2011-08-04 04:36:25
d6541bb1ac753a3cc0b92021cf82b07cf459cb28...9e37a7e126c98513789ce60c4bec67d7940dbf4b,1,7,2,9,2,2011-08-04 22:53:18,2011-08-04 04:36:26
9e37a7e126c98513789ce60c4bec67d7940dbf4b...27937447efdf2b50e6294e94bde22f07c526b2de,1,4,7,11,2,2011-08-04 22:53:19,2011-08-04 04:36:27
27937447efdf2b50e6294e94bde22f07c526b2de...72541040c3ed00084344de5bf75cbc5a514504bb,1,12,7,19,3,2011-08-04 22:53:19,2011-08-04 04:36:28
72541040c3ed00084344de5bf75cbc5a514504bb...fdf6be8259fc59fc251b325f66e86df0fe905e79,2,9,2,11,2,2011-08-04 22:53:19,2011-08-04 04:36:29
fdf6be8259fc59fc251b325f66e86df0fe905e79...4ca0f188f6ece3098b60b6ba732e1e8551466f60,3,74,18,92,10,2011-08-04 22:53:19,2011-08-04 04:36:30
4ca0f188f6ece3098b60b6ba732e1e8551466f60...c9d8f0ac3b9029d825c7d1c049953aacbc489e1c,1,23,36,59,3,2011-08-04 22:53:20,2011-08-04 04:36:31
c9d8f0ac3b9029d825c7d1c049953aacbc489e1c...ca64d061e0ddf7fa1496a15c75eb5e730c4360e0,3,14,9,23,4,2011-08-04 22:53:20,2011-08-04 04:36:32
ca64d061e0ddf7fa1496a15c75eb5e730c4360e0...d932f4eb9fc88e93040635d291f6c195ea2e4ee3,10,16,16,32,15,2011-08-04 22:53:21,2011-08-04 04:36:33
d932f4eb9fc88e93040635d291f6c195ea2e4ee3...fa92f3233c65251c3311f0834526ce96a1963554,1,3,2,5,2,2011-08-04 22:57:17,2011-08-04 04:47:43
fa92f3233c65251c3311f0834526ce96a1963554...d4d4f8df14c3c19d445a8a79dca56bd33812ee04,1,9,0,9,1,2011-08-04 22:57:17,2011-08-04 04:47:44
d4d4f8df14c3c19d445a8a79dca56bd33812ee04...0216af8356ef562147251c40fef72be25b8b9b07,1,14,1,15,2,2011-08-04 22:57:18,2011-08-04 04:47:45
0216af8356ef562147251c40fef72be25b8b9b07...f5114a40c0d0276ce6ff215a3dc51eb19da5b420,2,14,10,24,11,2011-08-04 22:57:18,2011-08-04 04:47:46
f5114a40c0d0276ce6ff215a3dc51eb19da5b420...87a246e1b562544c25af66f4712cd81bc64f2d44,1,9,0,9,1,2011-08-04 22:57:18,2011-08-04 04:47:47
87a246e1b562544c25af66f4712cd81bc64f2d44...9e8137238d1b7f558dd61c8737883e73c8368e4b,1,13,0,13,1,2011-08-04 22:57:18,2011-08-04 04:47:48
23c7df6bdd13e3d99ca09b6a7655747cc29ccc41...d1bf0e08313927c269846476f99f59d878807371,2,45,37,82,4,2011-05-26 23:47:15,2011-05-20 19:59:01
d1bf0e08313927c269846476f99f59d878807371...b6691092d707860019bbab80eaaf9173ada10586,5,209,16,225,16,2011-05-26 23:47:15,2011-05-20 21:33:31
b602ed7dea968d72c5b3f61ca016de7f285d80ef...d192508cd6867059ccc4ce0946ec1110028dad37,1,2,2,4,3,2011-05-20 02:44:59,2011-05-19 21:24:24
d192508cd6867059ccc4ce0946ec1110028dad37...6db41050a360d83e89114602ecc81c208323080f,2,6,81,87,5,2011-05-20 03:33:38,2011-05-20 03:17:44
b602ed7dea968d72c5b3f61ca016de7f285d80ef...c3ab1a8e4cb8a84967efcf45c5e6bee41b17f9f9,3,49,25,74,10,2011-05-19 17:44:44,2011-05-18 22:44:37
c3ab1a8e4cb8a84967efcf45c5e6bee41b17f9f9...2d370d2fbcf896912cc0739b806224f9a270bb5e,3,35,5,40,9,2011-05-19 17:46:42,2011-05-18 23:02:58
2d370d2fbcf896912cc0739b806224f9a270bb5e...46538012d943156ead4024fb510a1ce5d4ff443a,3,56,5,61,9,2011-05-19 17:54:16,2011-05-18 23:44:30
46538012d943156ead4024fb510a1ce5d4ff443a...cc243c3cebd58d06bc4e064b08fa9c3fdd565250,5,21,3,24,11,2011-05-19 17:55:54,2011-05-19 01:08:09
b602ed7dea968d72c5b3f61ca016de7f285d80ef...a87247731e46255567ec58df940adb697e5b95a8,3,40,3,43,8,2011-05-18 21:37:46,2011-05-18 20:06:00
b602ed7dea968d72c5b3f61ca016de7f285d80ef...f0f90e34b00e5401ef51f636b0735e17a9938e0a,1,1,1,2,1,2011-05-18 18:54:26,2011-05-18 17:56:04
f0f90e34b00e5401ef51f636b0735e17a9938e0a...0c47695a69da42df4c4b7a9dad4ba083c604e3d1,6,84,8,92,11,2011-05-18 19:40:15,2011-05-18 17:56:04
b602ed7dea968d72c5b3f61ca016de7f285d80ef...7a39741999a5216257b1fbcc847cf0c62c114088,3,30,18,48,14,2011-05-18 04:01:17,2011-05-17 15:38:52
7a39741999a5216257b1fbcc847cf0c62c114088...5a2df368c26e4a993db9d09f221af1063d0fe9a8,1,6,1,7,2,2011-05-18 04:01:29,2011-05-17 15:38:53
6368d9f1af7a5d4c8af2f11ffdb6af577f1e98f5...9aec68d3ea935fcb778a3580d950cf20d5bd35f6,1,7,0,7,1,2011-03-21 04:19:38,2011-03-15 09:32:11
9aec68d3ea935fcb778a3580d950cf20d5bd35f6...c3786c8472093ec01b73a71a56f405932044a67e,1,2,1,3,1,2011-03-21 04:58:09,2011-03-21 01:12:26
af4c62ae88d403a417ba7c2b879eca10e7bff8f4...9d379f4fd0a845aba3efa44b254d8e3905c3c029,1,20,26,46,2,2011-03-20 04:48:19,2011-03-19 15:16:55
9d379f4fd0a845aba3efa44b254d8e3905c3c029...b57fb80a7d7d19102b31ab94a28ed43ea1ee07bb,7,157,6,163,20,2011-03-20 04:48:19,2011-03-19 15:16:56
af4c62ae88d403a417ba7c2b879eca10e7bff8f4...c41dd2fd7d3a16e6f0b1629d688bee3240db496c,2,9,2,11,4,2011-03-20 04:46:52,2011-03-19 18:33:15
a3ca9b0fbe21d7a2525877fe0c008b61c56f7104...e2a57aac8a8a2b786739a5a93ea9dcfd2f0fd0e2,14,52,38,90,36,2011-03-17 23:08:30,2011-03-17 11:26:46
a3ca9b0fbe21d7a2525877fe0c008b61c56f7104...ebec842773932e6f853acac70c80f84209b5f83e,1,11,6,17,3,2011-03-17 22:32:43,2011-03-16 07:32:39
2f76a26ee707ab72c043148b38dfffb7a63ae516...e4117b1fe8fa17f54ea30997255299ba5650f445,1,1,2,3,2,2010-12-10 20:57:59,2010-12-10 19:48:25
e4117b1fe8fa17f54ea30997255299ba5650f445...b361888dd5a26c4f1eb6268392e89e2d546accf6,4,4,12,16,8,2010-12-10 20:58:06,2010-12-10 18:32:12
a5080d8e10915daa57b5b42c887483d202b45c55...5ed2ec1041b6aeec81b0f0a9775355a9b2c755a6,1,9,1,10,2,2010-06-14 17:55:38,2010-06-13 10:09:32
a5080d8e10915daa57b5b42c887483d202b45c55...b4b3360078e758221db3f7b496e35ccb43364151,1,1,0,1,1,2010-06-14 04:44:02,2010-06-13 11:27:43
b4b3360078e758221db3f7b496e35ccb43364151...b1a954a37cea7d5a0a123758f6c2ad9005d4481e,1,3,0,3,1,2010-06-14 04:49:22,2010-06-14 04:31:10
3d8b69495fd1132d5af6d7f46425cca97a937d97...656cdf0c9ebe2899ef79020285c9a6243dc84d97,1,1,1,2,1,2011-11-07 05:15:30,2011-11-07 05:12:59
7d182f52f1a754bdccb2e7c7cea54f773f76bc5c...0d12e59f636b68964c80a82a58020d34a6cd5032,1,1,1,2,1,2010-03-20 14:25:02,2010-03-18 05:10:45
0d12e59f636b68964c80a82a58020d34a6cd5032...c40d92e4c73b44d9cb4c3ba3a0ab53464964369c,1,6,0,6,1,2010-03-20 15:25:31,2010-03-20 00:06:15
c40d92e4c73b44d9cb4c3ba3a0ab53464964369c...e9bd32351078d1f664a1608763a92ab402b255f0,1,1,1,2,1,2010-03-20 15:49:31,2010-03-20 02:23:58
e9bd32351078d1f664a1608763a92ab402b255f0...aac1d7b88918f39b1b7c5bc0dcf831dcc9d5d8a8,1,1,1,2,1,2010-03-20 16:25:25,2010-03-13 17:17:04
aac1d7b88918f39b1b7c5bc0dcf831dcc9d5d8a8...8da61a2ab48175526390233c8bcedf63a3cdb6c4,1,1,3,4,2,2010-03-20 16:27:17,2010-03-12 22:27:33
8da61a2ab48175526390233c8bcedf63a3cdb6c4...730b02003070400a82ff89b240573765d71e839a,1,3,2,5,2,2010-03-20 16:28:48,2010-03-15 22:18:48
730b02003070400a82ff89b240573765d71e839a...8fe5d87622a4268079bf1e5738474f85d4e5c3bc,1,7,1,8,3,2010-03-20 18:29:13,2010-03-20 18:29:13
6a7071958620dadcce84e4faaa470407ae3d4108...13f72a1d5faacfdfea43e2fd961cb4009206a605,1,1,1,2,1,2014-02-11 19:02:59,2014-02-08 20:41:34
13f72a1d5faacfdfea43e2fd961cb4009206a605...a2f69581ffc26fadb27bc29dd03074791a16d61e,1,1,1,2,1,2014-02-11 19:03:07,2014-02-08 20:41:35
a2f69581ffc26fadb27bc29dd03074791a16d61e...897e3e454062d2bb9d3c1e4068caf4971fd713ff,1,4,7,11,2,2014-02-11 19:03:07,2014-02-08 20:41:36
897e3e454062d2bb9d3c1e4068caf4971fd713ff...246090a5d0ff3a51df8fed676e8159c3776c954a,1,2,1,3,1,2014-02-11 19:03:07,2014-02-08 20:41:37
60a31eccca583b7272ab32955e37d2fc0a51c54a...8d19b44b316411d6e3a90db257a4901580603884,2,45,1,46,2,2011-11-01 23:41:57,2011-11-01 23:16:36
c69f921560a03cd54d6bfdf95562c67117c02506...e3ff352c73a87d533fd239c3f9d4bb978c8ce387,1,1,1,2,1,2010-02-17 23:00:00,2010-02-17 23:00:00
379e48fa5f09aa9022b43f461eb084764091e5af...8c6b5a84547506c1cfabb966f27a10f5659e7e0b,1,0,21,21,6,2010-06-21 12:49:26,2010-06-21 12:49:26
7efeb8f09866ddd09485c0e6f371a6cbba3d2a0a...63c21c494fc91eda339d06b3a466c4241afffc81,1,0,13,13,1,2007-08-10 18:32:42,2007-08-10 18:32:42
63c21c494fc91eda339d06b3a466c4241afffc81...af3785dc5a76f4d5ddb8039e33c322e0e8b60e72,3,85,5,90,9,2007-08-10 18:44:23,2007-08-09 20:42:50
af3785dc5a76f4d5ddb8039e33c322e0e8b60e72...22631473e0b7a33356587ba3e38a9b4cc4dba2f1,1,8,2,10,2,2007-08-10 20:57:43,2007-08-10 16:51:58
7efeb8f09866ddd09485c0e6f371a6cbba3d2a0a...933bf40a5c6328b6c022b636f45a6f2c48c3838e,4,39,30,69,22,2007-08-10 09:30:44,2007-08-10 05:21:29
ddb95de33e99d547c3b533aea12f18c9e4dd649e...f1696ee398e92bcea3cdc7b3da85d8e0f77f6c50,14,58,34,92,35,2007-09-10 19:48:24,2007-09-10 10:35:04
f1696ee398e92bcea3cdc7b3da85d8e0f77f6c50...4acfd1b799acf43642a28a22cc794266c25129ef,2,13,16,29,10,2007-09-10 19:48:33,2007-09-10 10:35:05
4acfd1b799acf43642a28a22cc794266c25129ef...674d1727305211f7ade4ade70440220f74f55162,8,189,297,486,122,2007-09-10 19:49:50,2007-09-10 10:35:06
674d1727305211f7ade4ade70440220f74f55162...b655d46bb2d8aa12f3203f93c323b41df161fd26,1,6,17,23,3,2007-09-10 19:50:28,2007-09-10 10:35:07
b655d46bb2d8aa12f3203f93c323b41df161fd26...635d043f30c60f5ec8121bd94304e529f90407c7,1,11,20,31,4,2007-09-10 19:50:42,2007-09-10 10:35:08
635d043f30c60f5ec8121bd94304e529f90407c7...fd17f5b5f77716bf90098c6e49e3cf7fd9f56306,5,56,120,176,46,2007-09-10 19:50:58,2007-09-10 10:35:09
fd17f5b5f77716bf90098c6e49e3cf7fd9f56306...760da9607ee08e9dd495dee993262bb857694ac9,2,10,9,19,5,2007-09-14 06:20:47,2007-09-13 22:13:06
760da9607ee08e9dd495dee993262bb857694ac9...917c9a713397b16671ed5b1f1c159515bcfa389e,2,57,15,72,13,2007-09-17 00:30:03,2007-09-15 13:56:50
917c9a713397b16671ed5b1f1c159515bcfa389e...5ecd293d1420bf641a927a015877950f4d79c067,7,240,317,557,104,2007-09-17 00:30:03,2007-09-16 13:51:04
5ecd293d1420bf641a927a015877950f4d79c067...ba3ed09728cb25e004d3b732de14fca8aeb602f6,20,0,20,20,20,2007-09-17 00:30:03,2007-09-15 13:56:50
ba3ed09728cb25e004d3b732de14fca8aeb602f6...c7f9cb14286fff23bfe65033d4ec63f84c77f554,1,72,140,212,51,2007-09-17 00:30:03,2007-09-16 16:54:42
c7f9cb14286fff23bfe65033d4ec63f84c77f554...a08f23ab3eab67aac7163a284038f45fa99ef66f,1,23,36,59,5,2007-09-17 00:30:04,2007-09-15 21:50:12
a08f23ab3eab67aac7163a284038f45fa99ef66f...8b6087fb25068d6af927f112a93dc056930f3108,1,5,30,35,8,2007-09-17 00:30:04,2007-09-16 08:19:01
8b6087fb25068d6af927f112a93dc056930f3108...e6c019d0b0140fae1cdfd661746cbe319b6c3670,7,39,41,80,28,2007-09-18 07:55:10,2007-09-17 09:19:04
e6c019d0b0140fae1cdfd661746cbe319b6c3670...eec813cfc6409a1b72399acf7ac08283faad7b8f,1,68,109,177,47,2007-09-18 07:55:15,2007-09-17 11:48:17
eec813cfc6409a1b72399acf7ac08283faad7b8f...0557656930d41f10c90bccf90e3c5bd87bd53661,1,20,32,52,17,2007-09-18 07:55:25,2007-09-17 12:00:38
0557656930d41f10c90bccf90e3c5bd87bd53661...68d3025a805097ec148ec6e9b0b54a5db1ef138e,1,9,8,17,3,2007-09-18 10:07:58,2007-09-15 21:53:05
61ab92df40b2c256299ad3d812ee0de14353098d...73697a0b572f7f216d8355d83bf69e9b42e9a077,2,23,8,31,6,2007-09-26 07:42:17,2007-09-25 15:43:15
7b02b85a66fee6b357e02f9e70dd0baa0fd24308...aba91192ae39cd1a2f79e7ed91e966df3cfe10b7,2,21,4,25,6,2007-09-10 04:30:54,2007-09-09 00:39:29
aba91192ae39cd1a2f79e7ed91e966df3cfe10b7...05cc2ffc572f05e8aeec495a9ab9bc9609863491,1,2,6,8,1,2007-09-10 06:58:56,2007-09-10 04:15:29
ad00a3b8f8cabcf20aa6ac84ac88bea035fa7ce7...05b4df31537a653eaa30d2c6f53e05d7a12d1bc8,2,23,4,27,8,2007-09-05 22:24:16,2007-09-05 09:35:29
05b4df31537a653eaa30d2c6f53e05d7a12d1bc8...4dbfe2e9bdfdde2d3257194573cee0d41471592b,2,5,22,27,8,2007-09-07 05:53:16,2007-09-07 00:00:08
6972ab7ae10a205bbc05b98408a36403915a9c39...a2f22dbfa3a1039e5c6a9968d2421f1e9716515a,1,1,0,1,1,2007-09-12 19:57:18,2007-09-10 16:43:35
d3392f7e86d130dfafb08736b7fa2067dd2cf070...bc9e7399af3790918140c30a5b2c85bf9a8f1ad3,1,21,7,28,6,2007-09-15 05:40:49,2007-07-08 08:38:32
bc9e7399af3790918140c30a5b2c85bf9a8f1ad3...6c9ad166dbbf9e5a0c09450b892151dbec49b8dc,1,58,14,72,17,2007-09-15 05:40:49,2007-07-09 07:51:23
6c9ad166dbbf9e5a0c09450b892151dbec49b8dc...0f49327c9755b6575b447f79b540749d231cb26d,1,14,58,72,17,2007-11-01 20:46:27,2007-11-01 20:46:20
0f49327c9755b6575b447f79b540749d231cb26d...a64d7784e830b3140e7d0f2b45cb3d8fafb84cca,1,5,6,11,5,2007-11-01 21:30:52,2007-11-01 21:30:30
a64d7784e830b3140e7d0f2b45cb3d8fafb84cca...a9ee9bf9f9840498f2369ebafe6c220deb4327fd,1,5,1,6,2,2007-11-07 22:00:12,2007-11-07 21:10:27
59fc84074218475c06e27e13392fce9bbf2553bd...b1d884a9e3968db1fff91c2d066d871a3b8b013c,1,1,1,2,1,2007-08-23 07:04:10,2007-08-23 05:51:45
b1d884a9e3968db1fff91c2d066d871a3b8b013c...8f728fb96f00860cae58f4f2c5c9c96651e6a626,2,15,3,18,6,2007-08-23 07:18:02,2007-07-14 09:25:28
8f728fb96f00860cae58f4f2c5c9c96651e6a626...191131e538dd4188dbada7ce871f80af80556292,1,1,0,1,1,2007-08-23 08:02:49,2007-08-20 07:23:15
191131e538dd4188dbada7ce871f80af80556292...1d25c8cf82eead72e11287d574ef72d3ebec0db1,2,24,2,26,3,2007-08-23 09:34:19,2007-08-23 08:55:41
1d25c8cf82eead72e11287d574ef72d3ebec0db1...9ec398d200cb07534a92045104862d681c7a7da2,2,45,0,45,2,2007-08-25 01:53:02,2007-08-23 17:18:54
9ec398d200cb07534a92045104862d681c7a7da2...db21872395a1a092faa85ef9c1ea53588d8414f0,3,4,4,8,4,2007-08-25 01:54:37,2007-08-24 00:40:08
db21872395a1a092faa85ef9c1ea53588d8414f0...027830755d2972ab2201c53922ce402862a2bd80,19,40,40,80,35,2007-08-25 01:54:37,2007-08-24 00:44:13
027830755d2972ab2201c53922ce402862a2bd80...5ca4461728adadf22b5b8833693702ab09e556db,1,55,49,104,5,2007-08-25 01:54:37,2007-08-24 15:44:16
5ca4461728adadf22b5b8833693702ab09e556db...0058a33a8eb5a8bfcfc5f5e769a2517cff4b73f1,1,1,1,2,1,2007-08-25 01:54:37,2007-08-24 15:46:16
ffb293b63d13b3b06b454a5f9f0ff6802ef15f0d...fa2e71c9e794c43634670b62d1b4bf58d1ae7e60,1,30,7,37,3,2007-07-18 07:53:09,2007-07-18 05:58:28
fa2e71c9e794c43634670b62d1b4bf58d1ae7e60...281a53bb79786a6d7e54f9715cc8ad46fc2bdb0e,1,6,0,6,2,2007-07-18 23:56:20,2007-07-18 21:33:57
ccd71866b0c7253f988c4836eeb888e4abcc2da1...512e44b24501df0b4b231cc7f999f9646d96617b,1,5,3,8,2,2007-07-10 01:27:55,2007-07-10 01:27:55
84f67537b13bf0a959b1cad50b0d490071dc921a...a13ee29b975d3a9a012983309e842d942b2bbd44,1,3,1,4,2,2007-08-03 02:55:22,2007-08-03 02:55:22
a13ee29b975d3a9a012983309e842d942b2bbd44...51b8c5021a19195e0f138832b081a356a2247bca,1,3,0,3,1,2007-08-04 06:47:30,2007-08-03 09:27:39
4c3dbbf7225c45ab0e04953090d0ece4a15e83a2...97c12a8b71e7d42b87b9588ba2fe0e1e44411c21,1,24,0,24,2,2015-03-03 22:39:10,2015-03-03 22:39:10
a1589043238d7390b453bec0015bc326c4ebcbe1...3188ab3af60df6ace996d3985e8f1ca1ed3cbda5,1,48,0,48,1,2015-02-17 18:22:17,2015-02-17 18:22:17
9a9c1f1fdfb4e8bb253bfa27311e8a8ad82c8859...355d4e1739d1e88561ac04d2a2423c2aa93693d9,1,28,0,28,1,2015-02-22 20:29:36,2015-02-22 20:29:36
627736ca799edacf13881da7e671964a0afb94b8...33cae5428ab504e318cfac880d59e0bda58590d7,3,39,6,45,8,2015-01-22 06:46:59,2015-01-19 01:35:07
ee6e4c70f1b0126edc7fbff4600bbfb74444e6ba...1e6f5b22ad318446500fbd3b94b733eddd5b6414,1,82,0,82,9,2015-01-07 21:28:37,2015-01-07 21:12:54
bef111d0a5e4b5dcac07f92b0fc918bb31184066...eb443e3b39482b3d64c1efd46de7481c3321a87a,1,4,0,4,2,2014-12-22 19:58:56,2014-12-22 18:09:25
bef111d0a5e4b5dcac07f92b0fc918bb31184066...3af74cfb153e20277a1d22414f04249d90d34d5c,1,0,1,1,1,2014-12-22 18:27:42,2014-12-21 19:26:00
3f1509809e728b70ea7912e4e1b40f22965e45ee...8297643fcdb0e0f1edaff1fe026210dc6e073176,1,1,1,2,1,2014-12-22 20:08:46,2014-12-20 22:51:11
8297643fcdb0e0f1edaff1fe026210dc6e073176...1684c1b219e02c91655ad929f752f4f864c72faf,6,16,4,20,7,2014-12-29 17:57:55,2014-12-24 23:05:39
1684c1b219e02c91655ad929f752f4f864c72faf...2dacf26d0985521c0f30e535963a45257b63ea21,5,20,4,24,10,2014-12-29 17:58:25,2014-12-24 23:05:40
670f6a72b83c0164f303af937df8098d623c4046...563d4e59bd167fe2eecc5480e3841d878b1c8c2b,1,27,2,29,6,2015-01-14 20:44:03,2015-01-14 20:44:03
c5b9256360b06efb9453c1627b78b14598e288b8...46f32a99b836ddb79a87690c4c4e2c7922f05896,1,3,3,6,3,2015-01-07 18:36:42,2015-01-06 22:57:50
46f32a99b836ddb79a87690c4c4e2c7922f05896...102fc80d32094ad6598b17ab9d607516ee8edc4a,1,47,43,90,4,2015-01-07 18:38:01,2015-01-06 22:57:51
c5b9256360b06efb9453c1627b78b14598e288b8...76b43094007824e9b487302c87d77779deb4a295,1,4,7,11,3,2015-01-07 18:27:53,2015-01-07 01:22:26
76b43094007824e9b487302c87d77779deb4a295...0120b8c85c7a52b26ea7062fec349d178a4e0208,2,119,0,119,4,2015-01-07 18:30:30,2015-01-07 01:22:27
105979f71cc69528eaf31a98ceb4e13295dec87a...d1f9c7b77e3cd9776f421e796f83a51d61c6e422,1,137,137,274,128,2015-01-19 00:20:28,2015-01-19 00:20:28
105979f71cc69528eaf31a98ceb4e13295dec87a...0ef279509bae33cedf8f3531f8e9a1133128ff14,1,131,131,262,122,2015-01-18 19:30:18,2015-01-18 19:30:18
105979f71cc69528eaf31a98ceb4e13295dec87a...bf41b712c7a36f3af56ef7d760555b1f9c2eab76,1,137,133,270,124,2015-01-18 16:03:27,2015-01-18 16:03:27
3889e7a60c65031f0c5381d8060cefb4294d932e...9abc44b681a669c67d071d858c8aad21f65a0956,1,18,0,18,2,2014-12-12 22:37:33,2014-12-12 22:37:33
97f05f43dc73f2855eb4c6acd1ea49d6d6bc4bce...28c8cfc3635368f06f6deaedb5e90da328df27d2,2,10,0,10,2,2015-03-06 20:11:27,2015-03-04 07:53:04
28c8cfc3635368f06f6deaedb5e90da328df27d2...2185d3b7ad2ccdfe220d5c4139ff671a66fe7d80,1,1,1,2,1,2015-03-06 20:25:33,2015-03-04 07:53:05
b260d265e189728b26e50506ac6ffab6a7d588da...1b74f643f6929c94e0ce6643ffd78e198e4e2bd0,1,1,1,2,1,2014-12-05 19:38:19,2014-12-05 19:38:19
b260d265e189728b26e50506ac6ffab6a7d588da...bc9f2925fba2fee13f75bf0f149c0da7a4688bc2,1,2,25,27,1,2014-12-04 23:39:36,2014-12-04 23:08:13
bc9f2925fba2fee13f75bf0f149c0da7a4688bc2...a785d3f77c9922846f25d09fb04af9a3400ffbd1,2,3,21,24,2,2014-12-04 23:39:37,2014-12-04 23:08:14
a785d3f77c9922846f25d09fb04af9a3400ffbd1...2c6207abbd6c430be06ddfef97d145d7e21446fb,1,30,18,48,4,2014-12-12 19:42:00,2014-12-12 08:56:42
2c6207abbd6c430be06ddfef97d145d7e21446fb...55dfc8de1844e4295bc02d4a279a432e26dc4740,1,5,5,10,5,2014-12-12 19:42:59,2014-12-12 08:56:43
55dfc8de1844e4295bc02d4a279a432e26dc4740...524127afbf8b98350bcebe3fc1f7600fce191716,1,8,8,16,6,2014-12-12 19:43:40,2014-12-12 08:56:44
524127afbf8b98350bcebe3fc1f7600fce191716...2e376b3156ff30dcd359b7c424fcbdbab5ec7709,1,5,3,8,3,2014-12-12 19:43:47,2014-12-12 08:56:45
2e376b3156ff30dcd359b7c424fcbdbab5ec7709...f3b661f766c1525265d065fdd0529985979c80c6,1,41,19,60,11,2014-12-12 19:43:47,2014-12-12 08:56:46
f3b661f766c1525265d065fdd0529985979c80c6...60cc3c4072259609aefbdbc762d1f72bcbd97783,1,42,28,70,7,2014-12-12 19:43:47,2014-12-12 08:56:47
60cc3c4072259609aefbdbc762d1f72bcbd97783...c48a1635355118d490fef5af14d8296a8e6f92df,1,52,42,94,5,2014-12-12 19:43:48,2014-12-12 08:56:48
c48a1635355118d490fef5af14d8296a8e6f92df...aba56c89b21ebe64f38c521c0962c45eb4d23749,1,6,4,10,6,2014-12-12 19:43:48,2014-12-12 08:56:49
aba56c89b21ebe64f38c521c0962c45eb4d23749...98f31d8589d5a26b1b3ab4f30ec9cc81aa625872,1,8,5,13,6,2014-12-12 19:43:48,2014-12-12 08:56:50
98f31d8589d5a26b1b3ab4f30ec9cc81aa625872...c4c4fbf86cd6f3d4fee629629d1f7e2e5d81d592,1,6,6,12,6,2014-12-12 19:43:48,2014-12-12 08:56:51
c4c4fbf86cd6f3d4fee629629d1f7e2e5d81d592...ea7b4f6d3368654b1bd751193eaad4eca71991e4,1,10,9,19,9,2014-12-12 19:43:49,2014-12-12 08:56:52
ea7b4f6d3368654b1bd751193eaad4eca71991e4...ddd64c566d0b9d110ec51e269b8ce8630fa36348,1,26,17,43,17,2014-12-12 19:43:49,2014-12-12 08:56:53
ddd64c566d0b9d110ec51e269b8ce8630fa36348...8c22dd325437337064108409ff2241a842561a4b,1,2,0,2,2,2014-12-12 19:43:49,2014-12-12 08:56:54
8c22dd325437337064108409ff2241a842561a4b...bc11155cea8642ba08f37989a91c8a801953d331,1,8,8,16,8,2014-12-12 19:43:50,2014-12-12 08:56:55
bc11155cea8642ba08f37989a91c8a801953d331...553daf13ea25735ad60fa15c74c2bd266ab8e215,1,5,5,10,5,2014-12-12 19:43:50,2014-12-12 08:56:56
553daf13ea25735ad60fa15c74c2bd266ab8e215...82a645a73f07b19c0d70861929ebd6178e80e3e9,1,10,10,20,10,2014-12-12 19:43:50,2014-12-12 08:56:57
82a645a73f07b19c0d70861929ebd6178e80e3e9...b729effbdbc9ae2d087a83b9e2a165fb8cc04641,1,36,36,72,31,2014-12-12 19:43:51,2014-12-12 08:56:58
b729effbdbc9ae2d087a83b9e2a165fb8cc04641...fa5b1830b0605b39295631f6e167ddb133f2dbde,3,190,133,323,9,2014-12-22 18:11:40,2014-12-12 08:56:59
fa5b1830b0605b39295631f6e167ddb133f2dbde...0b1e654801e52243b63b57e27b50acdfe7c8f853,2,12,21,33,5,2014-12-22 18:13:15,2014-12-12 08:57:00
0b1e654801e52243b63b57e27b50acdfe7c8f853...31e07f76a946831265e741333a3d9e0646c793ad,2,2,16,18,4,2014-12-22 18:13:15,2014-12-12 08:57:01
31e07f76a946831265e741333a3d9e0646c793ad...3581d793351dba4e4a2f779a72f39d6ae84c1c2c,2,9,9,18,2,2014-12-22 18:13:15,2014-12-12 08:57:02
3581d793351dba4e4a2f779a72f39d6ae84c1c2c...c653e0343d04ba89040c8ba18d7ca2e55ece6338,1,2,5,7,2,2014-12-22 18:13:16,2014-12-12 08:57:03
b260d265e189728b26e50506ac6ffab6a7d588da...1f23cfe0ef5b2634a7b911a8b6dc4eff7f78ba5d,1,75,0,75,1,2014-12-04 23:27:47,2014-12-04 03:01:33
b260d265e189728b26e50506ac6ffab6a7d588da...6a0b0b6de996e2ac7eeb951e3d08f577c11c7e54,7,50,37,87,33,2014-12-01 19:32:29,2014-11-30 09:05:00
6a0b0b6de996e2ac7eeb951e3d08f577c11c7e54...1cf9952db243c624cc2763fa74e98adbb38537b1,4,15,30,45,6,2014-12-01 19:32:34,2014-11-30 09:05:01
1cf9952db243c624cc2763fa74e98adbb38537b1...5c6cb9888df9d21ddbb5c3478d511edcdf3cda7c,1,2,1,3,1,2014-12-01 19:33:45,2014-11-30 09:05:02
5c6cb9888df9d21ddbb5c3478d511edcdf3cda7c...4be4f71f55c5677a2671894cd218e311862a98ad,1,6,0,6,1,2014-12-01 19:49:53,2014-12-01 19:48:34
4be4f71f55c5677a2671894cd218e311862a98ad...f1f6224c72255e17230e7347d64a2be292a9f299,1,8,8,16,4,2014-12-01 19:49:53,2014-12-01 19:45:57
8d8140843501107c92e2f9a5acb60ee136352c1f...aca56064f4eebe2ba46a55908b5cfa3b4ffa6785,1,17,17,34,7,2014-11-25 22:11:39,2014-11-25 22:11:39
aca56064f4eebe2ba46a55908b5cfa3b4ffa6785...03335f22959d4ca0176a3073e1670380d3294711,1,151,151,302,29,2014-11-25 23:20:25,2014-11-25 22:14:41
03335f22959d4ca0176a3073e1670380d3294711...acd72b563652b646e65f2a90668b57a854fb3d12,1,47,52,99,10,2014-11-25 23:22:29,2014-11-25 22:21:07
acd72b563652b646e65f2a90668b57a854fb3d12...ee756a8161734e28490616f05ba895182424490b,1,10,10,20,10,2014-11-25 23:22:31,2014-11-25 22:52:42
ee756a8161734e28490616f05ba895182424490b...0720a51b29cdeb3927280669557068e636913128,1,74,76,150,15,2014-11-25 23:22:31,2014-11-25 23:03:45
18d0fec24027ac226dc2c4df2b955eef2a16462a...581d4e0cdbe9526c122b9d0835f951e478f82448,2,7,3,10,4,2015-02-12 19:42:53,2015-02-12 11:12:12
581d4e0cdbe9526c122b9d0835f951e478f82448...31e79f0a54e57454a9677eeb8b1108e4f907b8b9,1,2,1,3,1,2015-02-12 19:42:53,2015-02-12 11:12:13
31e79f0a54e57454a9677eeb8b1108e4f907b8b9...fec14ec38ca65b13f9e0fcdb60f27674c6f9af70,4,17,16,33,15,2015-02-17 19:22:29,2015-02-17 17:00:13
fec14ec38ca65b13f9e0fcdb60f27674c6f9af70...8df4e51138781927962438819d79ae3221b527b5,1,28,17,45,7,2015-02-17 19:22:42,2015-02-17 17:00:14
8df4e51138781927962438819d79ae3221b527b5...1d147bdff0b8132d3aa53a46df8dbab7b673b796,12,31,29,60,20,2015-02-17 19:22:50,2015-02-17 17:00:15
1d147bdff0b8132d3aa53a46df8dbab7b673b796...fb5a6bb61c215546b94156bbb54d43225424f7d0,4,13,12,25,8,2015-02-17 19:23:48,2015-02-17 17:00:16
fb5a6bb61c215546b94156bbb54d43225424f7d0...a908a31c344cdcce2bf1a9fc163f3bccd2349e6a,1,30,0,30,1,2015-02-17 19:23:54,2015-02-17 17:00:17
a908a31c344cdcce2bf1a9fc163f3bccd2349e6a...a933c23e66265eedf822535ac56fcdb4ecb07a8c,2,2,2,4,2,2015-02-17 19:24:20,2015-02-17 17:00:18
a933c23e66265eedf822535ac56fcdb4ecb07a8c...f04c5b5522214cd48b39399d1d26b07848fd0e52,1,2,0,2,1,2015-02-17 19:24:48,2015-02-17 17:00:19
f04c5b5522214cd48b39399d1d26b07848fd0e52...60294596ba6bf2f63506ffad60b9a94fc04612a1,1,2,0,2,1,2015-02-17 19:24:55,2015-02-17 17:00:20
60294596ba6bf2f63506ffad60b9a94fc04612a1...16180334015ab44b0310b9d896e554a66c36a1a4,3,67,21,88,19,2015-02-17 19:24:59,2015-02-17 17:00:21
16180334015ab44b0310b9d896e554a66c36a1a4...4b7b520b9f761704400a82285d0812fd9e50957f,2,14,7,21,3,2015-02-17 19:25:03,2015-02-17 17:00:22
4b7b520b9f761704400a82285d0812fd9e50957f...d1dd721f11b7b124f35e347876e5d7204a3df664,1,43,23,66,6,2015-02-17 19:25:18,2015-02-17 17:00:23
f1a35295c2b66d2501f034d864afb2c5d8bb0e08...1e16b255b95b45374db0b0cf69ef0ecce768ac27,4,191,37,228,22,2014-11-10 17:17:27,2014-11-09 14:55:53
94dd79e9fe1b2d67189ed40ebadd320d5dc12ae4...220c313cc387ffddd266778c4c550a5f0092d399,1,1720,1477,3197,1380,2014-11-02 02:59:00,2014-10-08 02:55:14
220c313cc387ffddd266778c4c550a5f0092d399...6c31a5e94af1036bb29da8a75f1e735e662aee92,1,1738,1473,3211,1385,2014-11-02 17:11:08,2014-10-17 19:39:45
f0c9fe050474e0f2a947366a82a62efd6afbf2ce...accad8e05e7503e456798a35e8bba6f83d8ad8b6,1,3,1,4,1,2011-03-16 21:34:16,2011-03-16 20:52:46
accad8e05e7503e456798a35e8bba6f83d8ad8b6...27c6000b28c89cad7af23df90d52bf33e205f61f,1,23,0,23,1,2011-03-16 21:34:24,2011-03-16 20:53:53
7811d9600f02e70c9f835719c71156c967a684f7...c395c25b8642893dd1bb4be1fd124dd12f9b848c,1,3,2,5,1,2011-03-24 07:09:51,2011-02-10 23:52:41
c395c25b8642893dd1bb4be1fd124dd12f9b848c...93e535a5b78c9861eca3e9371d1c3e5173c0ab02,3,56,4,60,9,2011-03-24 07:37:25,2011-03-24 06:48:24
7811d9600f02e70c9f835719c71156c967a684f7...59ab4eb36e20b0df9231e736f7d685fb43ad9364,1,1,1,2,1,2011-02-09 22:03:51,2011-02-09 09:04:43
0cb6ad3c3d8e9c738686ef8dc6f173f725e509bc...09ebad6faeec11c3dbad0bdaf95faed57be5dcba,1,131,98,229,9,2011-02-08 19:14:25,2011-02-08 10:29:09
09ebad6faeec11c3dbad0bdaf95faed57be5dcba...32669671c7746888aa1e3832907deb7fc8405061,3,126,7,133,16,2011-02-08 19:14:26,2011-02-08 10:32:49
32669671c7746888aa1e3832907deb7fc8405061...f8bd36a433768f1b11642faff5b88e3510aa8af8,1,13,14,27,5,2011-02-08 19:14:26,2011-02-08 10:34:34
f8bd36a433768f1b11642faff5b88e3510aa8af8...6c74ce8c7db669f896a04a2743c09abaa6053173,1,0,0,0,0,2011-02-15 18:43:45,2011-02-15 18:43:45
8594495cd65f0a05ef2ce5a0225d663d89ccc6c3...685e9d9145a186a4b2036ecf2be73cc86d99a9b7,3,9,3,12,5,2011-01-05 22:57:19,2011-01-05 22:46:07
f17adbce64efe49dcbdd3b7d14dc8b3621b5e193...0e4c8822e98e27c3c63125570c8bcbf0a8fd34da,4,35,3,38,5,2012-07-30 20:16:51,2012-07-30 20:09:25
da53e27e94bd3ee1c740d6d634931da070483978...cc2f50dafe28fda6652e1ab78034aae49b495b08,1,903,510,1413,475,2012-08-09 05:39:17,2012-08-09 05:36:41
e5e38ce485342e924c6554eda163acc9e1890982...9aafc933ebb4e08e008cd360fe8af9577266b574,1,7,7,14,7,2012-08-07 11:40:11,2012-08-07 09:25:21
9aafc933ebb4e08e008cd360fe8af9577266b574...195febdac2060b607c299c1f31bac12839a504d1,1,17,17,34,16,2012-08-07 11:48:27,2012-08-07 09:39:30
e5e38ce485342e924c6554eda163acc9e1890982...58b66f8f76ff4d310dba75867f5973ccf2721ebc,1,11,9,20,7,2012-08-07 00:22:59,2012-08-07 00:18:01
7ed863a85a6ce2c4ac4476848310b8f917ab41f9...baf5aaa33383af656a34b7ba9039e9eb3c9e678c,2,13,13,26,11,2012-01-06 19:10:05,2012-01-06 17:13:00
7ed863a85a6ce2c4ac4476848310b8f917ab41f9...9cd7a92b97d0b4321c19e8952a3a9b1874e3abb5,1,3,4,7,3,2011-10-24 04:33:58,2011-10-23 11:51:34
9cd7a92b97d0b4321c19e8952a3a9b1874e3abb5...1d5bd615c0d8dadfa9dee0511b3ba3feaf838877,1,4,1,5,2,2011-10-24 04:34:23,2011-10-23 11:51:35
7ed863a85a6ce2c4ac4476848310b8f917ab41f9...2c93286ab2ca5271e26779ffd1ecfd1c7a082a41,2,46,0,46,2,2011-10-12 19:08:11,2011-10-12 14:33:54
7ed863a85a6ce2c4ac4476848310b8f917ab41f9...008e3cc5d781273053c79d1ccf8cc3bf36086a07,2,19,7,26,7,2011-10-10 19:34:44,2011-10-10 12:54:51
7ed863a85a6ce2c4ac4476848310b8f917ab41f9...723f7a1387f1d79541fdbe66ad3778f2aaa370c4,1,8,4,12,5,2011-10-03 22:20:25,2011-10-03 21:55:09
7ed863a85a6ce2c4ac4476848310b8f917ab41f9...44c8e6049f75b6d9427f91ba09b6104471e84300,1,3,1,4,1,2011-10-03 18:55:57,2011-10-01 17:04:44
7ed863a85a6ce2c4ac4476848310b8f917ab41f9...b33a1b9fe794df53b449ffdbba0b39ef9e1772bf,1,6,26,32,4,2011-10-03 17:56:42,2011-10-03 17:56:42
7ed863a85a6ce2c4ac4476848310b8f917ab41f9...0a1283bc3955a97557019d077b96669c5c93c551,2,47,1,48,4,2011-09-30 17:33:15,2011-09-30 17:33:15
7ed863a85a6ce2c4ac4476848310b8f917ab41f9...ccdbdc79a30413d93d32cc7e5293185228f05459,1,6,0,6,1,2011-09-29 18:16:33,2011-09-29 17:02:45
7ed863a85a6ce2c4ac4476848310b8f917ab41f9...b4f223c6367bb7aefa00c746c808f5afa7b85331,1,3,1,4,3,2011-09-27 01:30:38,2011-09-27 00:00:09
b4f223c6367bb7aefa00c746c808f5afa7b85331...e9c4c11165e48b8f3fe1b4fc4db513f8e57202fb,1,155,196,351,65,2011-09-30 19:28:34,2011-09-29 22:11:42
e9c4c11165e48b8f3fe1b4fc4db513f8e57202fb...43d20a8c50355f7f68548e91bd8822c3cbfff52f,1,1,0,1,1,2011-10-10 17:05:07,2011-10-08 03:20:20
43d20a8c50355f7f68548e91bd8822c3cbfff52f...687296960d774a45df31df7bc371d01106a6f6b7,1,3,0,3,1,2011-10-10 17:05:22,2011-10-08 03:20:21
687296960d774a45df31df7bc371d01106a6f6b7...17d68a54def69b20b39dd4f7323b359a827e6017,1,1,0,1,1,2011-10-10 17:05:39,2011-10-08 03:20:22
7ed863a85a6ce2c4ac4476848310b8f917ab41f9...e2eb527345d48881dac0d88e6bdfc0a267a2eb62,2,15,3,18,2,2011-05-24 18:34:40,2011-05-05 02:11:18
7ed863a85a6ce2c4ac4476848310b8f917ab41f9...58fdef0cff5bcf10f2621d00466b33a5b8a39bf7,1,41,12,53,3,2011-05-01 18:42:59,2011-05-01 05:33:52
7ed863a85a6ce2c4ac4476848310b8f917ab41f9...15366280c27e922ace0ba7d33cb3504dc59d742e,6,14,9,23,7,2011-04-06 03:25:49,2011-04-05 17:44:11
7ed863a85a6ce2c4ac4476848310b8f917ab41f9...59d418fe10c207a510672d17a854697a8abc1e0b,2,7,11,18,3,2011-04-06 03:01:37,2011-04-05 21:20:25
59d418fe10c207a510672d17a854697a8abc1e0b...9355fc9c35a5c40bbd8e380ec9e36013a1b230ed,1,5,5,10,1,2011-04-06 03:01:52,2011-04-05 23:21:13
7ed863a85a6ce2c4ac4476848310b8f917ab41f9...49bee717f7080f99d3405682cc43ad525dde0973,1,9,0,9,5,2011-03-15 00:27:25,2011-03-14 23:48:39
49bee717f7080f99d3405682cc43ad525dde0973...3e63b21aced116badd30a279c479535449a63560,1,16,4,20,9,2011-03-15 19:14:35,2011-03-15 00:59:40
7ed863a85a6ce2c4ac4476848310b8f917ab41f9...f2cba9299be45f8e027f7b45c6e4a3cae55576c6,1,2,0,2,1,2011-03-15 00:25:45,2011-03-14 23:48:38
f2cba9299be45f8e027f7b45c6e4a3cae55576c6...761ecf0bc7b6cddf311f00877c59e6381cdbdeea,1,15,3,18,7,2011-03-15 19:11:28,2011-03-15 00:59:39
7ed863a85a6ce2c4ac4476848310b8f917ab41f9...dce96489162b05ae3463741f7f0365ff56f0de36,5,23,3,26,8,2011-03-11 22:42:54,2010-10-28 18:28:04
dce96489162b05ae3463741f7f0365ff56f0de36...a71f09fe3e8b047d88b5f439c6d552e8fc7e8293,2,2,2,4,2,2011-03-21 05:26:24,2011-03-21 05:26:24
7ed863a85a6ce2c4ac4476848310b8f917ab41f9...987893d82df390d7ed72e46f0cf8340d140952c1,1,1,0,1,1,2011-03-08 18:57:35,2011-03-07 11:43:11
987893d82df390d7ed72e46f0cf8340d140952c1...b6ab349b184b3a33c7bcc03521dafed3f9df380a,1,4,1,5,1,2011-03-08 18:58:00,2011-03-07 12:13:15
7ed863a85a6ce2c4ac4476848310b8f917ab41f9...45781adb9a89c0c47f61ccf8062be26b86a38a54,2,12,47,59,5,2011-03-02 20:26:53,2011-03-01 09:21:36
45781adb9a89c0c47f61ccf8062be26b86a38a54...1a92777504afc09e071d7d828e084e6a4dadfce2,2,1,6,7,3,2011-03-02 20:26:58,2011-03-01 09:21:37
7ed863a85a6ce2c4ac4476848310b8f917ab41f9...853c0ffe42fef0bd1abd5cc69d5e93fdd5a708aa,1,2,2,4,2,2011-02-25 20:00:28,2011-02-25 09:36:39
7ed863a85a6ce2c4ac4476848310b8f917ab41f9...8e2dc6ac06ae90a00965e5c00aa4918dfd447639,1,95,6,101,3,2011-02-24 01:24:59,2011-02-19 00:04:47
7ed863a85a6ce2c4ac4476848310b8f917ab41f9...98acc837a14c2ab1975b38b93cb028e87e47ad4a,2,11,0,11,2,2011-02-23 21:44:36,2011-02-23 09:50:19
98acc837a14c2ab1975b38b93cb028e87e47ad4a...a1f6baa5c97abc8b579fa7ac7c4dc21971bdc048,2,108,8,116,10,2011-02-23 21:46:33,2011-02-23 09:58:41
a1f6baa5c97abc8b579fa7ac7c4dc21971bdc048...c22e7de340df2e0ebc0e98347aa02a32a459835f,1,2,2,4,2,2011-02-24 00:09:33,2011-02-23 09:59:18
7ed863a85a6ce2c4ac4476848310b8f917ab41f9...2161da103950704a92993702696c9b573dcbccae,1,22,54,76,17,2011-02-22 06:57:38,2011-02-20 04:12:26
2161da103950704a92993702696c9b573dcbccae...d7e5c0cbfb0421d8a609f1125267dbad73069410,7,132,4,136,12,2011-02-22 06:58:02,2011-02-20 04:12:27
d7e5c0cbfb0421d8a609f1125267dbad73069410...5b2af8cac9883ab7e666d4aa30ea7fd3d1f1d4de,1,2,0,2,1,2011-02-22 06:58:18,2011-02-20 04:12:28
5b2af8cac9883ab7e666d4aa30ea7fd3d1f1d4de...37f7a8579363a98efc48dfb6964a519034fc9acc,7,158,104,262,38,2011-02-22 06:58:32,2011-02-20 04:12:29
7ed863a85a6ce2c4ac4476848310b8f917ab41f9...60adf7d73e44126289a98dada60f9c335ffc84b0,2,26,0,26,4,2011-02-22 00:30:58,2011-02-21 16:09:11
60adf7d73e44126289a98dada60f9c335ffc84b0...e0b9c34f7eec9d7943bbb8a3134f24e6e4e4ed3e,1,41,8,49,9,2011-02-22 00:33:08,2011-02-18 12:34:19
e0b9c34f7eec9d7943bbb8a3134f24e6e4e4ed3e...59c8afdf475d2b072fb63383df9f62afd2b3b1ee,3,43,4,47,7,2011-02-22 00:34:05,2011-02-21 16:09:12
59c8afdf475d2b072fb63383df9f62afd2b3b1ee...24852d917104e294726c54803d5c9012997506ca,1,4,0,4,2,2011-02-22 01:06:27,2011-02-22 00:58:37
24852d917104e294726c54803d5c9012997506ca...1df2d656cc442dc057e30b6fb130967e5ae19654,6,26,56,82,8,2011-03-09 21:50:54,2011-03-07 12:31:39
1df2d656cc442dc057e30b6fb130967e5ae19654...adbbb31e0d3b4cc7845c6d23d21c00da51025208,2,21,4,25,11,2011-03-09 21:50:54,2011-03-07 12:31:40
adbbb31e0d3b4cc7845c6d23d21c00da51025208...cb56e3093a1b25e105df44640e2224c8f6e6b893,3,34,0,34,3,2011-03-09 21:50:54,2011-03-07 12:31:41
cb56e3093a1b25e105df44640e2224c8f6e6b893...94f605ec0798a1f494023b72cd0d1f10b7a264f7,2,17,1,18,3,2011-03-09 21:50:54,2011-03-07 12:31:42
94f605ec0798a1f494023b72cd0d1f10b7a264f7...fe3b59e595b02ee57314b74a74df915bdd845011,1,12,0,12,1,2011-03-09 21:50:55,2011-03-07 12:31:43
fe3b59e595b02ee57314b74a74df915bdd845011...b1b47554ae889ca76b66349819c9b95a8be5f646,4,13,3,16,5,2011-03-11 05:55:29,2011-03-10 14:45:03
7ed863a85a6ce2c4ac4476848310b8f917ab41f9...ae901090f715fe6e5f589b4d92ec87b74429ed1b,1,15,4,19,5,2011-02-21 18:58:02,2011-02-20 01:18:24
ae901090f715fe6e5f589b4d92ec87b74429ed1b...4fddb41bd77dd0f685d8f79c81d3d40128578fe1,1,16,0,16,2,2011-02-21 18:58:16,2011-02-20 01:18:25
7ed863a85a6ce2c4ac4476848310b8f917ab41f9...bf0ab10fa84df6c49450a06077d1c52756d88222,4,14,4,18,8,2011-02-21 18:21:26,2011-02-19 10:20:51
bf0ab10fa84df6c49450a06077d1c52756d88222...92c57e5c1d29db96a927e2a713c5aa4ae99ce749,2,2,2,4,2,2011-02-21 18:23:36,2011-02-19 10:21:28
92c57e5c1d29db96a927e2a713c5aa4ae99ce749...485445e22ab30e40a94ef5b59e46616912d01720,1,0,1,1,1,2011-02-21 18:23:41,2011-02-19 10:21:57
485445e22ab30e40a94ef5b59e46616912d01720...3ac942d42ebb1fb48e70d3e5a714d06396e3e2c6,2,11,0,11,6,2011-02-21 18:24:07,2011-02-20 09:51:16
3ac942d42ebb1fb48e70d3e5a714d06396e3e2c6...99bfc6691d79eaffaaf170a8b6584bcfe97863dc,4,18,1,19,8,2011-02-21 18:24:08,2011-02-20 09:53:21
99bfc6691d79eaffaaf170a8b6584bcfe97863dc...bebd2fd77d385f198017fe297a6c79e26b2bf61c,1,4,2,6,2,2011-02-21 18:24:10,2011-02-20 09:56:56
7ed863a85a6ce2c4ac4476848310b8f917ab41f9...11f944dd6bdabd003325c85dc60b16389d012361,4,13,11,24,12,2011-02-19 06:25:51,2011-02-19 03:55:19
11f944dd6bdabd003325c85dc60b16389d012361...0940e5f211452ec2520d1b04233acddf0a872c06,6,32,33,65,8,2011-02-19 06:26:28,2011-02-19 04:10:32
0940e5f211452ec2520d1b04233acddf0a872c06...3a4d67692b5a80213ca47a603fa5505a5990cc87,1,1,1,2,1,2011-02-19 06:26:45,2011-02-19 04:12:06
7ed863a85a6ce2c4ac4476848310b8f917ab41f9...a9026187923643235d4f9b876ff5f4c0ebe5c9ae,2,14,1,15,2,2011-02-18 15:05:54,2011-02-18 04:01:52
7ed863a85a6ce2c4ac4476848310b8f917ab41f9...1b4735d9f3e0b7ea62c7c22f0afcb45e10c46c7e,1,9,0,9,3,2011-02-17 20:19:18,2011-02-17 16:18:45
1b4735d9f3e0b7ea62c7c22f0afcb45e10c46c7e...b200021e150320459d4f1edf1099131e0f5ae297,1,52,0,52,1,2011-02-17 20:25:17,2011-02-17 16:18:46
7ed863a85a6ce2c4ac4476848310b8f917ab41f9...f2b5e7af10a2d51ce300a958c32d26ec0cf6f678,1,36,0,36,1,2011-02-17 19:54:57,2011-02-16 16:55:37
f2b5e7af10a2d51ce300a958c32d26ec0cf6f678...2485eab55cc0dcab34311ecd0ac52038aa9d9db4,2,3,1,4,2,2011-02-17 19:56:50,2011-02-17 07:44:42
7ed863a85a6ce2c4ac4476848310b8f917ab41f9...53c403116a947c538132fc721f83196036f7a299,4,12,9,21,7,2011-02-16 18:21:52,2011-02-16 00:54:24
7ed863a85a6ce2c4ac4476848310b8f917ab41f9...65969d43d10512a44f5e7248e4404b946d1d0d9f,2,41,8,49,5,2011-02-15 21:35:35,2011-02-15 01:07:50
7ed863a85a6ce2c4ac4476848310b8f917ab41f9...2fe26b775cfa298a0b4bc3c53011ca6da7c6c298,1,50,0,50,1,2011-02-15 18:40:43,2011-02-05 18:18:44
2fe26b775cfa298a0b4bc3c53011ca6da7c6c298...1d718a5108f905e3c64f9fa791e67a52bd926457,2,12,4,16,3,2011-02-22 06:51:07,2011-02-20 12:13:43
7ed863a85a6ce2c4ac4476848310b8f917ab41f9...0602f3e916a2727dfc4954b81ce5aacd69d9692c,2,42,0,42,2,2011-02-03 20:19:19,2010-12-15 15:02:36
0602f3e916a2727dfc4954b81ce5aacd69d9692c...16dc36fea87e917a7f734400eb91e62e170db1a8,1,5,4,9,5,2011-02-03 20:19:19,2010-12-15 15:02:37
16dc36fea87e917a7f734400eb91e62e170db1a8...66f136252fe1998e2c1381c913795b5f56b6dc8c,8,22,50,72,17,2011-02-03 20:28:15,2010-12-15 15:02:38
66f136252fe1998e2c1381c913795b5f56b6dc8c...475005a11768a3906c42fac55e8b3371794bdef3,1,10,16,26,10,2011-02-03 21:04:23,2010-12-15 15:02:39
475005a11768a3906c42fac55e8b3371794bdef3...2c389fc8ec57722aa1e8f49d316401e2e21d1b05,3,116,112,228,3,2011-02-03 21:22:58,2010-12-15 15:02:40
2c389fc8ec57722aa1e8f49d316401e2e21d1b05...3bd2bcfa982c69c0f5722c3dfe72b15cd0469d15,1,23,0,23,1,2011-02-03 21:22:58,2010-12-15 15:02:41
3bd2bcfa982c69c0f5722c3dfe72b15cd0469d15...48932677d62e426b3f26ac236384cb5195fb9dfd,3,56,71,127,38,2011-02-03 22:08:16,2010-12-15 15:02:42
48932677d62e426b3f26ac236384cb5195fb9dfd...58c4d66619eb21fa23a1305401e0ec4988c1c17e,1,93,77,170,9,2011-02-03 22:08:30,2010-12-15 15:02:43
58c4d66619eb21fa23a1305401e0ec4988c1c17e...bc96cc87dbb229cbdabfd93391e24ef168713a74,5,38,3,41,7,2011-02-03 22:08:30,2010-12-15 15:02:44
bc96cc87dbb229cbdabfd93391e24ef168713a74...86e4ca69e358836599d4eb0c0e217caa9c9e455b,2,14,1,15,3,2011-02-03 22:08:30,2010-12-15 15:02:45
86e4ca69e358836599d4eb0c0e217caa9c9e455b...d38f28093ef795bef13d2fda6621b4952afb42db,5,47,4,51,9,2011-02-03 22:08:30,2010-12-15 15:02:46
d38f28093ef795bef13d2fda6621b4952afb42db...f1a2ddbbc2df4e81e005a7e82f9e23fb6a9f95e3,2,32,0,32,2,2011-02-03 22:08:30,2010-12-15 15:02:47
f1a2ddbbc2df4e81e005a7e82f9e23fb6a9f95e3...61cf28204508c095a68e7a9cb6307ca2a27112c9,2,92,0,92,2,2011-02-03 22:08:30,2010-12-15 15:02:48
61cf28204508c095a68e7a9cb6307ca2a27112c9...afe069d16618190a6f7e84ef8451970e274aedb4,7,20,23,43,15,2011-02-03 22:08:30,2010-12-17 12:43:06
afe069d16618190a6f7e84ef8451970e274aedb4...eb9cb55b944796374402ab4e2639300dc9b0b409,7,22,11,33,19,2011-02-03 22:08:30,2010-12-17 12:43:07
eb9cb55b944796374402ab4e2639300dc9b0b409...898bbd9fb4c749afbddcb8a6b68a64b394366e44,1,1,23,24,1,2011-02-03 22:08:30,2010-12-15 15:02:50
898bbd9fb4c749afbddcb8a6b68a64b394366e44...f34bbc15ce0749a3e9f749f0fef6c486e1482719,1,16,14,30,16,2011-02-03 22:08:30,2010-12-15 15:02:51
f34bbc15ce0749a3e9f749f0fef6c486e1482719...2ed2437a143391c9e882318874905c964f313977,1,1,1,2,1,2011-02-03 22:08:30,2010-12-15 15:02:52
2ed2437a143391c9e882318874905c964f313977...e5e062b6dcdbbc338a0501b97a35e2e5efa56075,1,24,27,51,13,2011-02-03 22:08:30,2010-12-17 12:44:25
e5e062b6dcdbbc338a0501b97a35e2e5efa56075...1376e50723228fc21b7183fe86d71ee484a70dd7,4,30,125,155,21,2011-02-03 22:08:31,2010-12-17 12:45:33
1376e50723228fc21b7183fe86d71ee484a70dd7...b31f688040d07ed8a6fd887e2960db005c20d832,1,18,0,18,1,2011-02-03 22:08:31,2010-12-15 15:02:56
b31f688040d07ed8a6fd887e2960db005c20d832...f577b92fe75643228674c0dcb2a4747587cf541d,1,57,12,69,14,2011-02-03 22:08:31,2011-01-31 20:09:53
5269edf1702b7375a287d5bbbb3c1b1f3a8aa765...42536dd9b9829b4eb4e3706e141b3c8bffa3e826,2,36,2,38,2,2011-05-20 18:39:49,2011-05-20 17:20:12
375f8a032e9f47d362afd5ea2443f77bcba685cb...8c2be75fe117f5079087a6dfb07c573cc6716143,3,6,6,12,5,2011-05-15 01:53:39,2011-05-14 20:19:21
375f8a032e9f47d362afd5ea2443f77bcba685cb...44ca0c8ed927c8e7525ceec412704ff9967ff6ac,1,88,4,92,4,2011-05-14 17:57:51,2011-05-14 16:26:30
44ca0c8ed927c8e7525ceec412704ff9967ff6ac...d4e98b581b5b3b70ca58cb6677ec02bee4ae7007,2,32,5,37,8,2011-05-14 17:57:56,2011-05-14 16:26:58
61e8aaf6215a2983610a770645e6d0a24bafb454...b22520a37c8472751f2c4b3da9b5bc4e5aa5a0a3,4,52,1,53,4,2011-03-30 20:17:07,2011-03-30 19:31:05
61e8aaf6215a2983610a770645e6d0a24bafb454...4793b7e86d007c492a76a5fae379ded97008e7fb,1,4,16,20,9,2011-03-29 06:33:51,2011-03-29 06:33:51
4793b7e86d007c492a76a5fae379ded97008e7fb...07514c83c2b7e6de926ef758905e3f43b4de6bfa,1,3,15,18,7,2011-03-29 06:35:39,2011-03-29 06:35:39
cd2b8ae983a277fb3f3c2b2c6747b0a075af1421...b15b5b10a75e202f3f90e000925545243267cbee,1,7,4,11,1,2011-08-30 17:05:21,2011-08-30 09:21:07
cd2b8ae983a277fb3f3c2b2c6747b0a075af1421...7732118438764cfe49b8e0ad2c63e6dc97be45ed,1,2,2,4,2,2011-08-29 22:23:22,2011-08-29 20:06:04
cd2b8ae983a277fb3f3c2b2c6747b0a075af1421...b8843efc062cd9e0a994943f6fc86182e4ebb0ec,1,5,5,10,2,2011-08-28 20:44:10,2011-08-27 14:29:20
cd2b8ae983a277fb3f3c2b2c6747b0a075af1421...ffaaed88aed2e9b7936a0c5b43c1b198db0dc2ab,2,31,1,32,3,2011-08-26 21:57:09,2011-08-24 14:01:48
ffaaed88aed2e9b7936a0c5b43c1b198db0dc2ab...1686519a0854ec09ee1cdd6db7f570ea4590dfce,1,9,3,12,4,2011-08-26 22:25:41,2011-08-24 18:54:50
3503b8d0da61d920ebd9294fd6a9a0f758328fd3...77e9e496a1248085d3bdf50dc23b79b4e7f0d26d,1,2,1,3,2,2011-08-03 18:21:46,2011-08-03 09:37:29
77e9e496a1248085d3bdf50dc23b79b4e7f0d26d...2ae7345ab290ea1357c0b2f1901ef531c9f59e5b,1,3,1,4,2,2011-08-09 19:05:24,2011-08-09 15:21:08
3503b8d0da61d920ebd9294fd6a9a0f758328fd3...98e840663251fc99055265b9bd4710e398310eb7,1,8,5,13,2,2011-08-03 17:32:02,2011-08-03 13:41:29
98e840663251fc99055265b9bd4710e398310eb7...0922570c76ae407e30477d27d72bb9d72c4b65f9,1,9,9,18,7,2011-08-03 17:32:54,2011-08-03 13:41:30
0922570c76ae407e30477d27d72bb9d72c4b65f9...e9e0643fe64b613b6596b79b59df8ff10746f1a1,1,2,0,2,1,2011-08-03 18:44:23,2011-08-03 18:06:17
3503b8d0da61d920ebd9294fd6a9a0f758328fd3...8894d5358095a08c2f700a87ce9fdefb0b6eb61b,4,39,38,77,5,2011-08-02 21:20:35,2011-07-30 17:13:47
e5b8eebc03f80bc21877494ae2ac0c2b63a1b83b...4804d437916d08068143dfc265cc7b5e2f4883e6,1,1,1,2,1,2011-11-09 13:44:05,2011-11-09 10:02:50
b91766295f2b873bbd4ef79c06de05aff27f8e12...f130b1168e95f51dcd6c7f3667b14bd244a9c61e,1,6,3,9,3,2011-08-14 22:18:51,2011-08-12 22:36:24
f130b1168e95f51dcd6c7f3667b14bd244a9c61e...4349a66805129ba11121b8a5eaf3f81cfd30bdd5,1,33,23,56,7,2011-08-14 22:18:52,2011-08-12 22:36:25
4349a66805129ba11121b8a5eaf3f81cfd30bdd5...db4dd93a4a3553c61b416db924520b55bfee5f7e,1,7,7,14,7,2011-08-14 22:18:52,2011-08-12 22:36:26
db4dd93a4a3553c61b416db924520b55bfee5f7e...e5dbf6056faecbd9a3c5510f5c5cd73de10374b8,1,21,7,28,3,2011-08-14 22:18:52,2011-08-12 22:36:27
e5dbf6056faecbd9a3c5510f5c5cd73de10374b8...ce40979cf83c4c92421f9dd56cc4eabb67c85f29,1,11,4,15,7,2011-08-14 22:18:52,2011-08-12 22:36:28
ce40979cf83c4c92421f9dd56cc4eabb67c85f29...0e88c130f2f6309932464d4919725e54837978c7,1,21,13,34,6,2011-08-14 22:18:52,2011-08-12 22:36:29
0e88c130f2f6309932464d4919725e54837978c7...3ab24efeef37f9a148662f8de4412a72e754b69f,1,1,1,2,1,2011-09-11 22:59:26,2011-09-11 22:59:26
b91766295f2b873bbd4ef79c06de05aff27f8e12...86ab7f0ccaed279271d562049c923a6264d2fc70,1,10,16,26,3,2011-08-14 22:01:57,2011-08-12 21:43:04
86ab7f0ccaed279271d562049c923a6264d2fc70...ba845b755078a043312119609c1ddd7406b20979,1,14,0,14,1,2011-08-14 22:01:58,2011-08-12 21:43:05
ba845b755078a043312119609c1ddd7406b20979...4c7517c9cc7cfc7961a5c31d7539a71f35fae2c2,1,4,4,8,5,2011-08-14 22:01:58,2011-08-12 21:43:06
4c7517c9cc7cfc7961a5c31d7539a71f35fae2c2...d175129857fe712bc7a4d882b0b9ef9f9d0a337e,1,11,6,17,5,2011-08-14 22:01:59,2011-08-12 21:43:07
d175129857fe712bc7a4d882b0b9ef9f9d0a337e...85c4a0d0482525480de4b575445ef8721858eff7,1,5,3,8,3,2011-08-14 22:02:00,2011-08-12 21:43:08
85c4a0d0482525480de4b575445ef8721858eff7...e0a5f9aaae4eea67f513e382d9d917388313d2a6,1,1,4,5,2,2011-08-14 22:02:00,2011-08-12 21:43:09
e0a5f9aaae4eea67f513e382d9d917388313d2a6...d68e1c183c056ae583a45b610d086ac078886154,1,26,25,51,4,2011-08-14 22:02:01,2011-08-12 21:43:10
62270f6b0a4e67e5044fb0d70d0e82ac6e553eb2...ec48d4bb7f3ca1429809500eae2867fdbcda3338,1,1,1,2,1,2011-03-01 19:26:22,2011-03-01 19:26:22
62270f6b0a4e67e5044fb0d70d0e82ac6e553eb2...c7934306d1504325d26950f35759ad478772e9c3,1,30,13,43,11,2011-02-28 21:08:31,2011-02-28 20:52:39
c7934306d1504325d26950f35759ad478772e9c3...38abd9b8b4e11aa0b4cdaa5c7b44e0c0ad06820b,1,16,0,16,1,2011-03-02 19:24:20,2011-02-28 21:13:22
38abd9b8b4e11aa0b4cdaa5c7b44e0c0ad06820b...d131b7afea58f47721dafd013ab6aff4adfc42dd,3,39,6,45,9,2011-03-02 19:25:30,2011-03-02 18:01:54
62270f6b0a4e67e5044fb0d70d0e82ac6e553eb2...20e7ab8ae26108e1d8675c375be7f06820da5cb0,1,4,2,6,2,2011-02-28 06:02:31,2011-02-26 22:32:33
62270f6b0a4e67e5044fb0d70d0e82ac6e553eb2...e7cad3ccd05461b0defdef86c9d786ab6fb9fe40,1,3,1,4,1,2011-02-27 10:13:21,2011-01-31 19:29:46
dca3d715aa41cca8e1c02e78b1291992ad4dbb50...b3c0494aa9b375033415ab1f815246e79d3d2029,1,1,1,2,1,2011-02-23 00:51:20,2011-02-22 22:43:22
b3c0494aa9b375033415ab1f815246e79d3d2029...046613c5465e4fc0611f93a5ef31d3815fb50c22,2,3,3,6,3,2011-02-23 00:51:21,2011-02-22 22:43:23
73e7b2ef6c62b3ec345b557acb71a8da4798c70d...67ac1e1d57e45899a4dfd900a0249f48507584b5,7,97,11,108,18,2010-12-28 19:27:56,2010-12-11 00:51:44
73e7b2ef6c62b3ec345b557acb71a8da4798c70d...71a5d4bc0e4025b3fbdeed76052b39fcef284e8c,3,18,1,19,3,2010-12-27 16:47:21,2010-12-26 09:07:31
71a5d4bc0e4025b3fbdeed76052b39fcef284e8c...a25e47377d6a1ec1efc6972f2e5e55cf429603a1,1,3,1,4,1,2010-12-27 17:19:38,2010-12-27 17:19:38
a46034819ecce6872bff099f3d75589f4d38c00c...d387868a7d29621e85e8c5c061d1f50586db74e5,2,40,3,43,4,2012-03-20 22:39:10,2012-03-20 22:39:10
a46034819ecce6872bff099f3d75589f4d38c00c...16e44810c9602bd7ed494f24c27eec193ff6a674,1,16,23,39,8,2012-03-15 17:50:45,2012-03-15 11:08:00
16e44810c9602bd7ed494f24c27eec193ff6a674...6c556cb8e6a6ef14966bf7e78e5308a38028b54c,1,29,1,30,1,2012-03-15 17:50:58,2012-03-15 11:08:01
a46034819ecce6872bff099f3d75589f4d38c00c...62d39359af1a46de68b600c0dc73a98b78aa5523,1,36,0,36,3,2012-03-14 21:39:01,2012-03-14 19:50:21
62d39359af1a46de68b600c0dc73a98b78aa5523...77d1a520fb5b8ad8cc86228023f16a44b75c05d1,1,63,56,119,4,2012-03-14 21:40:15,2012-03-14 18:24:08
77d1a520fb5b8ad8cc86228023f16a44b75c05d1...6440d3417c1d51a20014d4b6fc6c59bacfa87dab,2,5,2,7,4,2012-03-14 21:41:20,2012-03-14 18:24:09
1e4d0875acbce3c881bc1de66c8900cdc240ebe8...56a33c8f1bb5cef11ddf046f7b570f527ea77d37,2,58,6,64,11,2012-03-07 20:51:55,2012-03-07 20:51:55
79eec363d2f7f77cde3a3f25765e8a72b80f288c...87bf9a7048c623b3567f612ca3e67a0d412fc83d,1,11,55,66,9,2011-11-01 23:44:57,2011-11-01 23:37:33
87bf9a7048c623b3567f612ca3e67a0d412fc83d...3706ed298cbb5d4052ca0793ca36d9f28b4885bc,1,8,5,13,1,2011-11-02 19:35:37,2011-11-02 16:17:12
3706ed298cbb5d4052ca0793ca36d9f28b4885bc...db85b3a74fd1c50f007c198e4dc7265fdc1f2749,1,5,0,5,1,2011-11-02 19:36:56,2011-11-02 15:07:05
db85b3a74fd1c50f007c198e4dc7265fdc1f2749...ee6dfb2d83ba1b057943e705f707fa27e34e47f9,1,11,6,17,2,2011-11-03 21:27:04,2011-11-03 19:15:08
7bfffdc8a0039ebb1af36b62634697638f3b1ea5...40701adbcbbc1e3e4485562a36343f4781e62be5,1,5,0,5,1,2012-10-10 18:09:20,2012-10-10 13:55:52
66c11f02b031aca6f1756086fefdf4b8a5575c56...9e6ed475e7a8d39350f102f0730d321de08e0585,1,6,1,7,1,2012-01-03 20:47:58,2012-01-01 15:13:16
1c08bf50cfcf924094eca56c2486a90e2bf1e6e2...12b1443c2cf41174311c81667022c6f3149aa542,3,296,77,373,30,2011-04-29 21:21:48,2011-04-29 17:51:56
d424a47e3400ef597a6f4f3c56ee67290f7c6052...b9612197798dbfc622c766e83b1fe4c20bffae5c,1,11,12,23,3,2011-04-06 21:38:47,2011-04-06 21:33:33
c752e7f3e8d96a9673ad248addc9418164bd3ce6...a6fa59924d154f2dcfc331357bf553e043aa0242,8,36,32,68,13,2010-11-04 20:53:34,2010-11-02 19:59:07
a6fa59924d154f2dcfc331357bf553e043aa0242...177b29dcab4c6a1b291b718c1fb192d151356f3f,2,24,6,30,10,2010-11-04 20:53:34,2010-11-02 19:59:08
177b29dcab4c6a1b291b718c1fb192d151356f3f...d71b8ba7c959e414d36974af890e3e2cbd2acbb9,2,28,8,36,10,2010-11-04 20:53:35,2010-11-02 19:59:09
d71b8ba7c959e414d36974af890e3e2cbd2acbb9...b1a6c0a96f70fe39958b3315a99667740497d703,3,83,2,85,6,2010-11-04 20:53:35,2010-11-02 19:59:10
b1a6c0a96f70fe39958b3315a99667740497d703...89ac1223c08a19a83f6efb32234ed8665d5ad1ee,2,41,3,44,7,2010-11-04 20:53:35,2010-11-02 19:59:11
89ac1223c08a19a83f6efb32234ed8665d5ad1ee...7951bd3029a849411181935f84600ddbcd97cd0c,4,57,0,57,5,2010-11-04 20:53:36,2010-11-02 19:59:12
c752e7f3e8d96a9673ad248addc9418164bd3ce6...cc4e48fc1eafdb9bec037f10c22708a26fd25ef6,3,29,30,59,3,2010-10-18 23:20:19,2010-10-16 18:36:56
cc4e48fc1eafdb9bec037f10c22708a26fd25ef6...e23f436c35c3e7fd12feeed783064e08aaf27869,2,28,11,39,9,2010-10-18 23:20:19,2010-10-16 18:36:57
e23f436c35c3e7fd12feeed783064e08aaf27869...05236a5e9d29a2628a8f1de96a2a256185687e6c,1,19,7,26,10,2010-10-18 23:20:19,2010-10-16 18:36:58
05236a5e9d29a2628a8f1de96a2a256185687e6c...996621eb4d4f7014a6542778420dd23b1d428896,2,12,8,20,5,2010-10-18 23:20:19,2010-10-16 18:36:59
996621eb4d4f7014a6542778420dd23b1d428896...e674c17db25750f14c1dd1d8f588eb3135b5cea9,1,10,28,38,3,2010-10-18 23:20:19,2010-10-17 00:38:07
c752e7f3e8d96a9673ad248addc9418164bd3ce6...34a6bbb549095544ad8fc9ec29e2c890ef0c27d1,1,27,3,30,5,2010-10-13 23:36:04,2010-10-12 21:38:12
c752e7f3e8d96a9673ad248addc9418164bd3ce6...8205ff8e9957039d508b5702e3b45fc9c4a55648,1,1,1,2,1,2010-10-13 22:08:59,2010-10-10 21:39:33
8205ff8e9957039d508b5702e3b45fc9c4a55648...128191f5eec4365c4798d2bc8ef86008edb7d1bb,1,5,1,6,1,2010-10-13 22:08:59,2010-10-10 21:39:34
128191f5eec4365c4798d2bc8ef86008edb7d1bb...2a5da75579310a674431e6b91fed1d712f4c24ae,1,41,9,50,3,2010-10-13 22:08:59,2010-10-10 21:43:33
2a5da75579310a674431e6b91fed1d712f4c24ae...c3898111ac65c6703691db5c984b0f8493ba40ee,1,17,4,21,5,2010-10-13 22:09:25,2010-10-10 22:06:22
c752e7f3e8d96a9673ad248addc9418164bd3ce6...412ff738addd3f329d641073fd1aa32629d5bfbf,1,5,1,6,2,2010-10-13 22:07:50,2010-10-10 21:48:56
412ff738addd3f329d641073fd1aa32629d5bfbf...3bb8cf88247db589b60e79c0520b081793cfd68e,1,6,1,7,1,2010-10-13 22:07:50,2010-10-10 21:48:57
3bb8cf88247db589b60e79c0520b081793cfd68e...2c7c3877def8629278f5367a461ef269b0cfaa99,1,1,0,1,1,2010-10-13 22:07:50,2010-10-10 21:48:58
c752e7f3e8d96a9673ad248addc9418164bd3ce6...52a0a1bd10f67ffb6d1eec420efed0899c606988,1,15,23,38,13,2010-10-13 21:34:08,2010-10-10 08:35:43
52a0a1bd10f67ffb6d1eec420efed0899c606988...189645ca844da2fd4f7e3318bbd9f7098e886dc4,1,51,0,51,3,2010-10-13 21:34:08,2010-10-10 08:38:58
189645ca844da2fd4f7e3318bbd9f7098e886dc4...a9307f5a6880a4818b042a30760b2cbb75efc53b,1,58,49,107,5,2010-10-13 21:34:08,2010-10-09 13:52:58
a9307f5a6880a4818b042a30760b2cbb75efc53b...4856ff2a195e558c82ca3cab636c4d4fbef148e3,1,27,16,43,12,2010-10-13 21:34:08,2010-10-09 13:52:59
4856ff2a195e558c82ca3cab636c4d4fbef148e3...f66caaf9c8e0feb840a439a58e165b963aec79cf,4,31,10,41,12,2010-10-13 21:34:09,2010-10-09 13:53:00
f66caaf9c8e0feb840a439a58e165b963aec79cf...7980872d4ef3ce24329cbdb6d61dc2ed48cbf1c5,4,38,42,80,27,2010-11-15 23:05:34,2010-11-15 19:52:19
c752e7f3e8d96a9673ad248addc9418164bd3ce6...79bc2af5ae161d1e81b57313c81fb81e3ec6c57d,1,7,5,12,2,2010-10-07 03:30:17,2010-10-02 08:41:00
79bc2af5ae161d1e81b57313c81fb81e3ec6c57d...c72781d6121135ff178e4b2278db07c9cc3ea6c4,1,1,1,2,1,2010-10-08 21:10:33,2010-10-08 21:03:15
c72781d6121135ff178e4b2278db07c9cc3ea6c4...ae5e97ec40a36408a8f90973c23e6143741ec732,1,6,5,11,4,2010-10-13 16:37:31,2010-10-13 11:57:41
ae5e97ec40a36408a8f90973c23e6143741ec732...7e00dc58d14a5f8ea229e5a0acf5f019028e3a40,1,2,2,4,2,2010-10-13 16:40:19,2010-10-13 11:33:48
7e00dc58d14a5f8ea229e5a0acf5f019028e3a40...d0af3734f14410e9c297aa08bf46fdb153a25ccb,1,9,2,11,1,2010-10-13 16:40:38,2010-10-13 11:35:20
d0af3734f14410e9c297aa08bf46fdb153a25ccb...2794ad524462c4e2ecd4573d650e7b4f8da89a5d,3,33,0,33,3,2010-10-13 22:10:31,2010-10-10 03:30:15
8a90438506d3b7c8ef8bd802b7ed10c1f12da1d0...cefd43b7f9b86b1c5de5216a8a03fac5e611afa9,1,14,14,28,7,2010-11-05 21:23:55,2010-10-21 22:12:02
cefd43b7f9b86b1c5de5216a8a03fac5e611afa9...aae1f6acf1984f4ae4453ad299a1fa4d261fb188,1,26,0,26,1,2010-11-05 21:35:46,2010-10-22 05:09:40
8a90438506d3b7c8ef8bd802b7ed10c1f12da1d0...7b8c70518894db9c6376913be04c2c8bf9827e4d,1,11,2,13,9,2010-10-28 22:28:39,2010-10-28 00:49:20
8a90438506d3b7c8ef8bd802b7ed10c1f12da1d0...c3fced64981e3d2700d83c0a6661ac347df5121e,1,2,2,4,2,2010-10-25 07:21:56,2010-10-24 21:03:10
8a90438506d3b7c8ef8bd802b7ed10c1f12da1d0...71064a956b25ef519eab340e364d0bc0e786bd11,1,15,1,16,2,2010-10-22 21:59:58,2010-10-22 20:26:23
8695353147e0c20fc8197fd73efec2ca9bce0304...7f7868eadce9b6a9d93e7e8bc80fd58c5e64cc67,1,1,3,4,2,2010-10-03 23:50:54,2010-10-02 08:35:29
7f7868eadce9b6a9d93e7e8bc80fd58c5e64cc67...06f3549d7146179c5cafe8f76e8fcbc064eba2f7,1,3,1,4,2,2010-10-03 23:50:54,2010-10-02 08:36:52
06f3549d7146179c5cafe8f76e8fcbc064eba2f7...2d2ef5ec82c912fcc5c06fa902c867d45cc8a53e,1,0,1,1,1,2010-10-04 00:55:22,2010-10-03 20:00:00
33f072f8910081b12780197a2a5423227e437af8...ccee60862bbba6aa65fafbdb1ce357d2b31a795b,3,29,13,42,6,2011-06-26 20:06:08,2011-06-25 20:41:25
ccee60862bbba6aa65fafbdb1ce357d2b31a795b...2cd9de3e18183422cd7ec3cd81cebc656068ea42,1,18,17,35,5,2011-06-26 20:15:21,2011-06-25 23:26:02
352953a556e7f8d720e26a32d4aabbf823d3c4d4...27eea66b28e15890ae587303c1c316388845169e,1,6,6,12,4,2010-10-19 21:15:30,2010-10-16 11:09:20
27eea66b28e15890ae587303c1c316388845169e...9373bdc402585963e58f57e75b6396dd08becc77,1,7,7,14,3,2010-10-19 21:15:30,2010-10-18 03:10:45
9373bdc402585963e58f57e75b6396dd08becc77...9fbd8986bb475befb27e0597c2ce0a7ce015334c,1,5,1,6,1,2010-10-19 21:15:30,2010-10-18 11:33:32
9fbd8986bb475befb27e0597c2ce0a7ce015334c...9659df52822a2fd7f85725d2ff680871b1f3bdc7,1,30,10,40,5,2010-10-19 21:15:30,2010-10-14 10:53:11
9659df52822a2fd7f85725d2ff680871b1f3bdc7...5b57413cb3952654031115f6f840e3dcb120914e,1,1,1,2,1,2010-10-19 21:15:30,2010-10-19 09:50:39
352953a556e7f8d720e26a32d4aabbf823d3c4d4...9e5f5d4cfea5bb7706f1f8bb07795d52d37a59fe,1,2,2,4,2,2010-10-18 23:10:55,2010-10-17 19:23:21
9e5f5d4cfea5bb7706f1f8bb07795d52d37a59fe...55846b9abd128185388418e025651cfd6a299a0e,2,14,1,15,5,2010-10-18 23:10:57,2010-10-17 19:23:22
33fc521193746a0961c270997dbb881b520ad793...7569c1f444b38b9f34366302b4a61b7fd80fed00,1,1,1,2,1,2010-11-26 22:45:23,2010-11-25 08:03:39
e5af0de202e885b793482d416b8ce9d50dd2b8bc...28fc3a6857a5d7a6b4f63b2672fb0ce966b0df78,2,11,3,14,3,2011-06-22 18:24:50,2011-06-09 15:51:22
28fc3a6857a5d7a6b4f63b2672fb0ce966b0df78...5bf6529aaa3fa829328ae00ddf7aa851935443b5,2,7,1,8,2,2011-06-22 18:24:50,2011-06-09 15:51:36
5bf6529aaa3fa829328ae00ddf7aa851935443b5...1c2c9bee1bad9a4133a934d04c32b033cc16c8aa,2,9,1,10,2,2011-06-22 18:24:50,2011-06-09 15:52:32
1c2c9bee1bad9a4133a934d04c32b033cc16c8aa...c5d6350bdc8d0d8bd4bd1aa0273313e71cd548f6,2,6,0,6,2,2011-06-22 18:24:51,2011-06-09 15:52:43
c5d6350bdc8d0d8bd4bd1aa0273313e71cd548f6...2f1d9e2b93e1b7fbfcfa59331db89dd6c76a3505,2,17,7,24,7,2011-06-22 18:24:51,2011-06-09 15:54:58
2f1d9e2b93e1b7fbfcfa59331db89dd6c76a3505...f77bccaeba7a4c542e9b89d144af74bddd36fd08,1,1,3,4,2,2011-06-22 18:24:51,2011-06-09 15:55:09
e5af0de202e885b793482d416b8ce9d50dd2b8bc...1a507fc1121865009fd961ef08cb03700650cbd4,1,38,35,73,15,2011-06-10 17:31:34,2011-06-10 17:31:34
1a507fc1121865009fd961ef08cb03700650cbd4...9e7e5ca372a0242069ff4e7eccecc7d5fe7ec385,1,2,2,4,2,2011-06-10 17:39:27,2011-06-10 17:39:27
9e7e5ca372a0242069ff4e7eccecc7d5fe7ec385...5e86c1fb866ca4bc8d6e015ccbdafd114fd616fa,3,17,4,21,4,2011-06-10 17:51:02,2011-06-10 17:45:29
5e86c1fb866ca4bc8d6e015ccbdafd114fd616fa...55bb5c9147a209eba44c3e9866704ece424c3d31,10,105,41,146,31,2011-06-10 18:10:29,2011-06-10 17:55:10
55bb5c9147a209eba44c3e9866704ece424c3d31...225a6f1068f71723a910e8565db4e252b3ca21fa,8,17,10,27,10,2011-06-10 18:18:17,2011-06-10 18:18:17
225a6f1068f71723a910e8565db4e252b3ca21fa...ef49a7a0126d64359c974b4b3b71d7ad42ee3bca,15,142,70,212,67,2011-06-10 18:52:15,2011-06-10 18:52:15
ef49a7a0126d64359c974b4b3b71d7ad42ee3bca...e01503b523e79748ac91d876f506811c597d03cb,1,58,20,78,8,2011-06-10 23:17:19,2011-06-10 19:15:17
e5af0de202e885b793482d416b8ce9d50dd2b8bc...a1e90b2352f9f45293d3d439270f81607284ca9a,1,15,14,29,2,2011-06-09 01:08:20,2011-06-08 22:11:50
a1e90b2352f9f45293d3d439270f81607284ca9a...4a1c26951610fa1d2b9f8d9f7c85979bed856c94,1,66,22,88,8,2011-06-09 01:08:21,2011-06-08 22:11:51
e5af0de202e885b793482d416b8ce9d50dd2b8bc...d8ead15963890a42f99fd0e7f3192b55cacd9404,1,4,2,6,2,2011-06-09 00:21:08,2011-06-08 20:06:33
e5af0de202e885b793482d416b8ce9d50dd2b8bc...8537f0ef936781d3984491603cd1c8ff15d7a8a5,1,7,0,7,1,2011-06-06 20:46:35,2011-06-06 19:57:01
8537f0ef936781d3984491603cd1c8ff15d7a8a5...4d689320049e1ff3bd31e0468d6f17eeb0b7029c,3,9,4,13,4,2011-06-06 20:46:36,2011-06-06 19:58:04
4d689320049e1ff3bd31e0468d6f17eeb0b7029c...f22a17e8da25a043950a13f11035930922bb86e7,1,1,9,10,1,2011-06-06 20:46:36,2011-06-06 19:58:43
d98a20114d641789e1c886f6c26e63d91132f5da...766d6268c6af14970744f69c574e4b34ec056106,1,0,5,5,1,2011-05-31 17:51:18,2011-05-31 17:23:42
fc196b68905958dac66e1baaa3b66b84a2cdacfc...e0fce074fc4fdf2d2175ff97f1cc3db918ea87e9,2,1,3,4,3,2010-08-16 03:00:02,2010-08-06 03:18:53
e0fce074fc4fdf2d2175ff97f1cc3db918ea87e9...f0ef6a6eff15a3df8dc9ec61d93e3f7e540ed0ac,2,2,5,7,4,2010-08-16 03:00:02,2010-08-06 03:20:08
f0ef6a6eff15a3df8dc9ec61d93e3f7e540ed0ac...2bc8c1a8a6b1cdffc19badc7272f552302b79d3e,2,3,8,11,3,2010-08-16 03:00:02,2010-08-06 03:21:40
2bc8c1a8a6b1cdffc19badc7272f552302b79d3e...3668d4238314dc5db98de3034058f68ff57a6b1e,2,2,4,6,3,2010-08-16 03:00:03,2010-08-06 03:27:43
3668d4238314dc5db98de3034058f68ff57a6b1e...41bf3bc232cf5f99fdc6d3d729536a4c4821d3bd,1,2,2,4,2,2010-08-16 16:41:26,2010-08-16 08:08:34
bf9b46c16d28c0e1f938947a98ca518f9644b0c0...0316bba80f496100ec1706f8d9feb071f20d100c,1,15,20,35,2,2011-01-10 17:35:17,2011-01-06 18:00:51
7d43de925b2771d295d8fc4341b7bd544e2a74fa...6612b9e471a3e25079dac5257ead8cf6abe68575,2,41,8,49,6,2010-12-05 20:15:12,2010-11-26 16:00:39
7d43de925b2771d295d8fc4341b7bd544e2a74fa...a9ff277e583782346181f431784e48046b0dfaa9,2,19,2,21,4,2010-12-01 21:26:52,2010-11-28 19:42:46
a9ff277e583782346181f431784e48046b0dfaa9...4980fffb2c0848b354757ca270b4852363e9befa,1,15,18,33,4,2010-12-01 21:27:00,2010-11-28 19:43:57
4980fffb2c0848b354757ca270b4852363e9befa...85c62395b152f99e8867aaf84cea93dddc03243c,3,329,2,331,16,2010-12-01 21:27:37,2010-11-28 19:45:01
85c62395b152f99e8867aaf84cea93dddc03243c...777f80d7429b0f2687cb9ff40f82b196b78384ff,3,86,12,98,10,2010-12-01 21:28:04,2010-11-28 19:45:58
777f80d7429b0f2687cb9ff40f82b196b78384ff...491e359c949ef7b7ed3fd24ba59f1b7e4cc17e87,1,3,3,6,3,2010-12-03 20:28:00,2010-12-03 20:28:00
491e359c949ef7b7ed3fd24ba59f1b7e4cc17e87...a3a6f4c4cdc42a4d432bc51915d3e1d092d8ca9a,1,3,3,6,3,2010-12-13 07:17:44,2010-12-13 06:31:51
7d43de925b2771d295d8fc4341b7bd544e2a74fa...da4b2432cc6fe514dd72431de7be3ff2b4c86d7e,2,29,2,31,6,2010-11-30 01:13:35,2010-11-25 18:43:59
da4b2432cc6fe514dd72431de7be3ff2b4c86d7e...b3f52a9c3a5d02a6d1a3d05fe35deb90b70de510,1,7,2,9,3,2010-11-30 01:14:52,2010-11-29 00:19:08
7d43de925b2771d295d8fc4341b7bd544e2a74fa...150a5daad0095d06d38eadefdde4703fa3cca3e5,2,2,1,3,2,2010-11-30 00:58:27,2010-11-29 22:52:59
150a5daad0095d06d38eadefdde4703fa3cca3e5...f611ddc774b58864b1f0b02962c524683a2f6c59,2,11,12,23,8,2010-12-10 21:52:05,2010-11-10 20:27:12
7d43de925b2771d295d8fc4341b7bd544e2a74fa...1d282327d7354dd3a1caefa4af06562aa816710d,5,17,8,25,10,2010-11-30 00:31:34,2010-11-17 23:40:05
1d282327d7354dd3a1caefa4af06562aa816710d...148135fc24dce1e61cfd7fcedea4210095099e78,3,15,2,17,5,2010-12-10 20:59:52,2010-12-09 17:27:08
7d43de925b2771d295d8fc4341b7bd544e2a74fa...fe249b4219f66ae3aacfac50ad19b38c370ad115,2,15,2,17,2,2010-11-29 23:06:40,2010-11-13 22:58:22
7d43de925b2771d295d8fc4341b7bd544e2a74fa...47e44ed1dc17d3a94ec4bf8dd29810ab7882041c,9,35,35,70,34,2010-11-29 22:01:52,2010-11-27 01:58:14
121f71f0da1bc9a4e1e96be2c3e683191a82a354...1af3d97751ef28d276eb1336a2052771efe09894,3,20,13,33,4,2012-06-15 21:27:35,2012-06-15 20:29:48
1af3d97751ef28d276eb1336a2052771efe09894...af63b543ed9f7d606cdd2c7a3bcded4e2dc8dad4,1,3,3,6,3,2012-06-15 21:27:36,2012-06-15 20:32:55
121f71f0da1bc9a4e1e96be2c3e683191a82a354...7acf438215d1b0e8e47a707f3585de8486a2e5fe,1,1,1,2,1,2012-06-13 20:10:55,2012-06-12 18:46:56
121f71f0da1bc9a4e1e96be2c3e683191a82a354...242f55f61252e610092e93f4b2daebba21cb8acf,1,0,6,6,1,2012-06-11 15:00:11,2012-06-09 14:27:00
121f71f0da1bc9a4e1e96be2c3e683191a82a354...dd4287a2c9e9345e0d48c9aa4ee5c330f50623f4,2,2,2,4,2,2012-06-04 20:46:53,2012-06-04 19:30:04
dd4287a2c9e9345e0d48c9aa4ee5c330f50623f4...223988808971eb5429efd914e9e88855ea0b0e01,1,47,3,50,4,2012-06-04 20:47:32,2012-06-04 20:17:42
223988808971eb5429efd914e9e88855ea0b0e01...365fc8d56a6fdb5a43c71f1c53cc3a67567bf3a6,1,4,2,6,1,2012-06-04 20:49:44,2012-06-04 20:17:43
365fc8d56a6fdb5a43c71f1c53cc3a67567bf3a6...04ab6ae7765700375e9442347430fc3a6de40f81,1,7,0,7,1,2012-06-04 20:49:50,2012-06-04 20:17:44
5498c5f05283cd248fd5e4f48cb8902e9ca6ce28...816fb46be665c8b63647f0096845fef363736b20,7,18,5,23,10,2012-06-03 20:11:34,2012-06-02 18:51:42
816fb46be665c8b63647f0096845fef363736b20...42dcbb738b47ab7e2b265ed981c9a4a7bda92f97,3,26,0,26,6,2012-06-03 20:11:52,2012-06-02 19:01:12
42dcbb738b47ab7e2b265ed981c9a4a7bda92f97...745c7c8e6252ba41430a1442e1fa8da2ec40e9c2,2,3,5,8,4,2012-06-03 20:11:54,2012-06-02 19:03:08
5498c5f05283cd248fd5e4f48cb8902e9ca6ce28...75f7b4b965502f24637eaf1ed7e4411f68d5ed75,1,219,209,428,206,2012-06-01 23:07:27,2012-06-01 23:07:27
75f7b4b965502f24637eaf1ed7e4411f68d5ed75...d691f47942f778cc308b902ae4eb1b588bfd864f,1,227,214,441,203,2012-06-02 09:12:59,2012-06-02 09:12:59
d0b16c8f878bef5c1268e033a3d1f427498c7008...05a59a087c29c0b5dd267ec0bd488829427cc3d7,3,75,6,81,13,2010-06-03 22:02:09,2010-05-25 13:45:51
05a59a087c29c0b5dd267ec0bd488829427cc3d7...46077fa5d477a3e96e0bb96042a2a9fdc9c818cb,2,55,2,57,7,2010-06-03 22:02:12,2010-05-25 14:52:03
d0b16c8f878bef5c1268e033a3d1f427498c7008...18d05328f3333e63bfffa65ac887ea16de60918c,9,50,47,97,26,2010-06-01 00:56:29,2010-05-28 06:25:49
18d05328f3333e63bfffa65ac887ea16de60918c...bc9519683cea289b6ba7d55fa8b947ac155467c6,1,1,0,1,1,2010-06-01 00:56:39,2010-05-28 06:25:50
bc9519683cea289b6ba7d55fa8b947ac155467c6...be5347b398dd35cdbbb2e2d8b102aacca853df86,1,9,5,14,6,2010-06-01 00:56:46,2010-05-28 06:25:51
be5347b398dd35cdbbb2e2d8b102aacca853df86...c0cb4ed3e653a37a53ef3a1e08daa42ac9cbc3fc,2,27,52,79,18,2010-06-01 00:56:53,2010-05-28 06:25:52
c0cb4ed3e653a37a53ef3a1e08daa42ac9cbc3fc...d1127622f5e4aa2abf6b492f6e43c0e17c3e0442,1,1,0,1,1,2010-06-02 18:49:24,2010-05-28 19:11:23
d1127622f5e4aa2abf6b492f6e43c0e17c3e0442...d94775e1f9a9239a823b9aa52d754f9ec2635e6d,1,15,2,17,3,2010-06-02 18:49:33,2010-05-28 19:11:24
d94775e1f9a9239a823b9aa52d754f9ec2635e6d...78646987e41967bb3533fae221205d73ea9af4d1,2,158,3,161,5,2010-06-02 18:54:06,2010-05-28 19:11:25
9d2e942070b235e1f4a0b8dd4c55a6b3f0fe914a...ce83eda15554ffd859ecc9f4c427303d460dab60,1,18,10,28,10,2010-06-23 17:42:07,2010-06-23 17:27:39
11b17afc933446c3afdbed72afaa440348f2b0ff...2ad9ba0382ca0d9a36746db804d1bf01f5281b8e,3,4,8,12,4,2012-02-01 05:27:58,2012-02-01 05:06:06
3daff7c31998faedbe0dd7e2b8651e351be40d64...6f2dd720b68ee8df0afae92e96001c8d3f14c1dc,1,6,6,12,6,2011-12-21 19:33:11,2011-12-21 15:54:14
3daff7c31998faedbe0dd7e2b8651e351be40d64...d7a10c3140de593abe25d55bbdba43373079e82e,1,2,2,4,2,2011-12-21 18:19:04,2011-12-21 01:18:19
d7a10c3140de593abe25d55bbdba43373079e82e...952fba9c63417d19e01fdf0b714f01b8ae9f3618,3,4,4,8,4,2011-12-21 18:19:40,2011-12-21 01:18:20
952fba9c63417d19e01fdf0b714f01b8ae9f3618...ab1900a36ef7fcfe872ff9d0803f9442e356c2f0,4,16,16,32,12,2011-12-21 18:21:04,2011-12-21 01:18:21
6f426c74a4ba6805d6d30619429507aeb6ffbbea...39ac7a7d10564ffdd6634e3a8f23fda069040cc1,1,121,0,121,1,2010-06-25 17:39:53,2010-06-23 19:28:58
39ac7a7d10564ffdd6634e3a8f23fda069040cc1...4c6887516c60dbbe42390b17a379a85d66919082,1,2,1,3,1,2010-06-25 17:39:55,2010-06-23 19:28:59
4c6887516c60dbbe42390b17a379a85d66919082...02ac98374eefbe4a46d4b53a8a78057ad8ad39b7,3,88,7,95,13,2010-06-25 17:39:58,2010-06-23 19:29:00
03aa87ed9912a6beac1a23e69ef0b70e1589d3d0...f62e0a39b69c2752b92f01bb05a6676639f46a65,1,16,0,16,1,2010-04-20 05:14:39,2010-04-19 08:03:03
f62e0a39b69c2752b92f01bb05a6676639f46a65...97a20eea199f490760cc25b1b7df28361f54e536,1,2,2,4,2,2010-04-20 05:16:35,2010-04-19 08:03:40
c8a97906bad44c83acfec33e7e0a3bb4b15a716d...4c35f0dbc41a2bb79e4f597d3b7bdb265c5ea750,1,2,0,2,1,2010-04-08 20:42:36,2010-04-08 19:49:08
a4c24549acf16f7917ea3ddd811c6c61afc5689c...3f3abe3c5aa94a37bb57365262a9ad451c422e36,1,3,1,4,1,2010-06-27 19:25:37,2010-06-27 13:15:22
3f3abe3c5aa94a37bb57365262a9ad451c422e36...b8a6610d84202d1451362cb3e7f4e2da17ed1a39,1,8,7,15,5,2010-06-29 15:48:19,2010-06-28 19:01:07
a4c24549acf16f7917ea3ddd811c6c61afc5689c...4e0d7a80186c27f1a008dd10eaea6f25b0e1fe19,3,5,5,10,5,2010-06-24 16:42:12,2010-06-23 19:40:19
4e0d7a80186c27f1a008dd10eaea6f25b0e1fe19...8b6d7924f865f29e625d0fbd3e1307af30e51908,1,1,1,2,1,2010-06-25 15:57:17,2010-06-25 02:16:24
8b6d7924f865f29e625d0fbd3e1307af30e51908...9eafa1201b2dcc703258ca7cd53de8ac4de74565,1,4,4,8,3,2010-06-25 18:04:16,2010-06-23 19:47:50
45e9a825edf9064ff76f6ff10357fdc79497f0eb...ffc4b8012d9a4f92ef238ff72c0d15e9e1b402ed,1,45,1,46,3,2011-06-12 05:32:25,2011-06-11 19:04:08
45e9a825edf9064ff76f6ff10357fdc79497f0eb...5a8f311789b98cf812343f0ef854561b02144b1a,2,200,199,399,2,2010-07-05 20:38:10,2010-07-05 16:11:39
5a8f311789b98cf812343f0ef854561b02144b1a...1ed6f2c5b97de939e2f52da6a60785f3d9a3de86,2,36,1,37,2,2010-07-05 20:39:02,2010-07-05 16:11:40
1ed6f2c5b97de939e2f52da6a60785f3d9a3de86...f028cdae6663166ebfd777e73aacce1f5e7159d6,16,21,22,43,20,2010-07-05 20:39:13,2010-07-05 16:11:41
45e9a825edf9064ff76f6ff10357fdc79497f0eb...334fba656b50c92345586970bc6b100a449e1fc5,3,75,11,86,9,2010-07-05 19:11:33,2010-07-01 03:18:19
45e9a825edf9064ff76f6ff10357fdc79497f0eb...31991b0260216d16f2e447e68bcabd9d9cce26ba,3,29,3,32,5,2010-07-05 18:53:59,2010-07-05 17:33:03
45e9a825edf9064ff76f6ff10357fdc79497f0eb...8d31635ce22a5ff35d6b023dca6438c09cf49dc9,1,3,1,4,2,2010-07-05 18:44:24,2010-07-03 12:40:04
8d31635ce22a5ff35d6b023dca6438c09cf49dc9...8a57c6e9437eeebf849f0def03389078a510312e,4,64,103,167,19,2010-07-05 18:44:35,2010-07-03 12:41:54
45e9a825edf9064ff76f6ff10357fdc79497f0eb...16adc7cb048f9c31e80b4409aa599d485595c4e0,1,14,12,26,5,2010-07-02 17:29:07,2010-07-02 17:29:07
e1e5ec868fab6f8131e8b228f1d6d543b7501933...3334729cf29605389b51effc1f311656f3fd8086,1,5,4,9,1,2010-06-07 05:13:51,2010-06-06 23:31:34
bdc4204119d2847ea8f1ae5e44614be859951822...7c42e390a37a11b1f7a77f5f07c261a8f930663a,1,2,1,3,2,2010-06-03 20:51:41,2010-06-01 21:24:57
65281b70caf9dcf926c6649c8c20ef8891d6f3c3...e0ef8495e98ae5ae796ec23bf438eef413557193,2,34,16,50,10,2010-06-29 17:36:13,2010-06-14 05:32:09
e93487d2f007176804e89042f9f199628e45c864...327a89dca11ac78aee711e4ab440d2194b9914f8,1,1,1,2,1,2010-11-10 18:25:51,2010-11-09 21:49:37
327a89dca11ac78aee711e4ab440d2194b9914f8...55d060771a15f4ce75e71b966d8117d8a32cc47b,1,5,0,5,2,2010-11-10 18:25:51,2010-11-09 21:49:38
55d060771a15f4ce75e71b966d8117d8a32cc47b...4a9cf1cefc0fd05e0eb46f862e398f1e4ac1c9a7,2,15,1,16,2,2010-11-10 18:25:52,2010-11-09 21:49:39
4a9cf1cefc0fd05e0eb46f862e398f1e4ac1c9a7...a5cdebea55d53406e117d9a1fd4cc316ef036553,1,73,73,146,2,2010-11-10 18:25:52,2010-11-09 21:49:40
a5cdebea55d53406e117d9a1fd4cc316ef036553...e2656c82fd836a3d410230c98f6a725368f15642,2,26,2,28,5,2010-11-10 18:25:52,2010-11-09 21:49:41
e2656c82fd836a3d410230c98f6a725368f15642...180619a58572b17de0ebeb96989e0aa832765186,4,43,37,80,25,2010-11-17 21:21:02,2010-11-14 23:52:26
180619a58572b17de0ebeb96989e0aa832765186...32a36b4d6f3207f5c01e928085b13af87bf223a1,1,9,9,18,1,2010-11-17 21:21:29,2010-11-09 21:49:43
32a36b4d6f3207f5c01e928085b13af87bf223a1...d4990c4b2f5f7066853fea4df775b3f506c79431,5,15,3,18,13,2010-11-17 21:21:29,2010-11-09 21:49:44
d4990c4b2f5f7066853fea4df775b3f506c79431...8ef313e1ec3b9b8ca47dce1fec632597aa34bedc,1,11,6,17,3,2010-11-17 21:21:30,2010-11-09 21:49:45
8ef313e1ec3b9b8ca47dce1fec632597aa34bedc...75ef3f4a5cc69b21bc825ed0e739030d77a4f077,5,392,0,392,10,2010-11-17 21:21:30,2010-11-09 21:49:46
75ef3f4a5cc69b21bc825ed0e739030d77a4f077...56881843d4d916a166ac4c6ba1803e5ceba9c44d,4,47,24,71,10,2010-11-17 21:21:30,2010-11-09 21:49:47
56881843d4d916a166ac4c6ba1803e5ceba9c44d...2085b16aefdbb1dc081aa40c62eb8110a222731d,4,532,11,543,21,2010-11-17 21:21:34,2010-11-14 23:54:11
2085b16aefdbb1dc081aa40c62eb8110a222731d...3228e67120a8c71bf7804a5c52448a841d6f3b58,4,559,2,561,8,2010-11-17 21:21:58,2010-11-14 23:55:12
3228e67120a8c71bf7804a5c52448a841d6f3b58...00f03061e27cad5497abcca2b70fa9fa04818275,1,43,1,44,5,2010-11-17 21:22:49,2010-11-09 21:49:50
00f03061e27cad5497abcca2b70fa9fa04818275...809f38c8abacdbeb7015fdeef03931568c7fddda,5,474,13,487,13,2010-11-17 21:22:49,2010-11-09 21:49:51
809f38c8abacdbeb7015fdeef03931568c7fddda...6abb3655efe364cf0375b5cdae2729af7562ed45,5,394,4,398,21,2010-11-17 21:22:49,2010-11-09 21:49:52
6abb3655efe364cf0375b5cdae2729af7562ed45...443259cf929c0041310e3c77946252cbfc3f787d,4,24,3,27,9,2010-11-17 21:22:49,2010-11-09 21:49:53
443259cf929c0041310e3c77946252cbfc3f787d...6cfd6a9dea889707fa207ee2003010c3b56b2131,2,85,2,87,4,2010-11-17 21:22:49,2010-11-09 21:49:54
6cfd6a9dea889707fa207ee2003010c3b56b2131...a6a09095a08339afc8468d053ff978ed4662a1d5,7,248,4,252,10,2010-11-17 21:22:53,2010-11-14 23:57:17
a6a09095a08339afc8468d053ff978ed4662a1d5...305ddd444ee66607581c014b371ed74af534eca5,1,436,0,436,1,2010-11-17 21:23:55,2010-11-09 21:49:56
305ddd444ee66607581c014b371ed74af534eca5...618cd75707580819f19a5f01dba406ac72219c78,3,47,0,47,7,2010-11-17 21:23:55,2010-11-09 21:49:57
618cd75707580819f19a5f01dba406ac72219c78...2a22c1b35d6110e72d86a2fac4b68dbad0905adb,1,17,16,33,2,2010-11-17 21:23:55,2010-11-09 21:49:58
2a22c1b35d6110e72d86a2fac4b68dbad0905adb...35d2fffdb857836cc46f5a4ada525a246ddd5e11,3,351,3,354,9,2010-11-17 21:23:55,2010-11-09 21:49:59
e93487d2f007176804e89042f9f199628e45c864...24aea033138561e5501ee5dfb3459f3ae4940625,2,4,3,7,4,2010-08-09 17:13:18,2010-08-06 20:28:05
24aea033138561e5501ee5dfb3459f3ae4940625...1702b1381e2a7193d74f6dc649c86e15ec72b4dc,1,8,4,12,2,2010-08-09 18:35:46,2010-08-07 23:09:45
1702b1381e2a7193d74f6dc649c86e15ec72b4dc...1bc6bf6dea0ec3703f2844d838207f2b31ef4ff8,1,1,1,2,1,2010-08-09 18:51:50,2010-08-08 05:13:32
1bc6bf6dea0ec3703f2844d838207f2b31ef4ff8...b1c7946d0cdffb96e4db3b4888399903665e2506,1,3,0,3,1,2010-08-09 18:53:32,2010-08-08 15:31:34
b1c7946d0cdffb96e4db3b4888399903665e2506...5fedde3cb35df40622cb93f2aadd847d77e5a089,1,1,0,1,1,2010-08-09 19:12:22,2010-08-08 21:25:11
5fedde3cb35df40622cb93f2aadd847d77e5a089...48c250a121a425a1860226b6a7061aecfbab5246,1,1,1,2,1,2010-08-09 19:13:27,2010-08-08 21:48:59
48c250a121a425a1860226b6a7061aecfbab5246...977ed83a6da635332a0c9e4cdd8b7e1715a9d363,1,7,1,8,2,2010-08-09 19:33:50,2010-08-09 01:32:43
977ed83a6da635332a0c9e4cdd8b7e1715a9d363...497d9c343902591e98a6612385d529816420ea94,1,5,4,9,2,2010-08-09 20:05:35,2010-08-07 21:56:47
3368edd4cda6306d524e10758e2c5a187dcd4ba6...75b37e704781a9ae4db2f0beaaa023638c06490d,1,2,1,3,2,2010-05-19 05:00:17,2010-05-17 19:07:10
3368edd4cda6306d524e10758e2c5a187dcd4ba6...08bda2085cc095863888bb4bb7a73960a9a379fd,1,4,3,7,3,2010-05-19 04:46:36,2010-05-10 21:38:17
08bda2085cc095863888bb4bb7a73960a9a379fd...56a05720b1c2d5f82d4a3db4142b7a027cf8f3f7,1,1,0,1,1,2010-05-19 04:51:40,2010-05-13 12:47:53
56a05720b1c2d5f82d4a3db4142b7a027cf8f3f7...f3838ce16aaa8ab576a78c980b0962226f6e7a33,1,1,1,2,1,2010-05-19 04:51:50,2010-05-13 12:51:38
f3838ce16aaa8ab576a78c980b0962226f6e7a33...d07ef715757ab1c2436c59adca92484fa46b2b41,1,2,2,4,1,2010-05-19 04:55:11,2010-05-18 10:49:33
3368edd4cda6306d524e10758e2c5a187dcd4ba6...7ffad2501489690edd9335fdd1e69c05699767e3,1,7,0,7,2,2010-05-19 04:32:41,2010-05-08 04:44:34
1668b7d78f81c1a46a12612d4845ea477a8feba5...1d25dd416f08f39042d23340db380f28abb81962,1,30,0,30,4,2013-10-16 19:27:45,2013-10-16 19:27:45
347231f7352a4caac8bd95924c20afde4455c89c...27269fc5f2781cd8f6e832043f9abf7305aa3d49,2,6,6,12,4,2011-06-29 21:38:51,2011-06-29 05:36:48
99ac63b092f592b7181f94b6479f3a24dbfc8fdb...534cea3fce7d32fc924fd477520fa2e631288ca6,1,1,1,2,1,2011-06-29 23:35:29,2011-06-27 22:04:32
534cea3fce7d32fc924fd477520fa2e631288ca6...b586744a864cf4d6886d6436d559302123b01fae,1,10,2,12,4,2011-06-29 23:38:09,2011-06-27 18:02:22
99ac63b092f592b7181f94b6479f3a24dbfc8fdb...787513027a7d0af3c2cd2f04b85bc7136d580586,3,227,6,233,20,2011-06-26 19:50:46,2011-06-25 00:56:06
fb674d767180354d9ad3e69f1d41bee98df6bfe9...e7af8e49cd54f1784fa2a0e382f22ca2f98cf4d8,2,20,1,21,3,2011-05-30 18:18:59,2011-05-30 14:19:05
3c3e0b3c41f4c975828cf51d661614e45bf80dc0...043b5cd93859d25fa39cbbefd64e62d143b9baf0,1,4,3,7,3,2011-05-27 05:15:35,2011-05-27 02:31:11
043b5cd93859d25fa39cbbefd64e62d143b9baf0...fc17df03442185a23583b959fc70617b69ceb0ca,1,23,4,27,3,2011-05-27 05:15:36,2011-05-27 02:31:51
fc17df03442185a23583b959fc70617b69ceb0ca...715e716a1b5bc1bc71715286e7a10b7e0c3188e8,2,5,5,10,4,2011-05-27 05:15:38,2011-05-27 02:32:41
715e716a1b5bc1bc71715286e7a10b7e0c3188e8...62b42d348754231609e07912ac42da6b112008ef,2,4,4,8,2,2011-05-27 05:15:39,2011-05-27 02:33:15
48de6569eb1c4b0ab62e63b20c693fe3017171f2...17b4e93d5b849293e6a3659bbc4075ed8a6e97e2,1,4,72,76,5,2011-12-28 20:07:22,2011-12-28 20:07:22
472fdee793e6d4185b91bf62b2d601009bb32b24...f051ad6d118aff0252beed36d20a56d1823fc90b,1,5,1,6,2,2012-02-28 21:31:05,2012-02-28 21:31:05
2b6dd6a2a8dbc0492fc766a1585488b13bbce10e...ec330158ec04849fe5ff2cb8749797cd63ae592b,1,9,1,10,3,2011-12-22 23:36:48,2011-12-22 23:36:48
65da088244a1c220a6dbc5bf01c758b4b9df63b3...6680a0874f86600cc8b4b5327384934d83d752a8,5,12,37,49,12,2012-02-07 18:44:54,2012-02-07 18:23:02
861444f6d702b15713d0875ce9dc5aff64885fba...98c2924cfa84a7f30b17636bd5632e53a0fa002e,1,3,4,7,2,2012-01-08 22:38:25,2012-01-07 11:54:36
861444f6d702b15713d0875ce9dc5aff64885fba...50d0158fbba5c4cd04184bb757bf43a84c290405,1,4,3,7,1,2011-12-13 00:09:38,2011-12-10 10:40:45
50d0158fbba5c4cd04184bb757bf43a84c290405...6c597aeba1e0fc369e64b1033515b0e39544cbe1,1,0,4,4,1,2011-12-13 00:09:38,2011-12-10 10:40:49
6c597aeba1e0fc369e64b1033515b0e39544cbe1...d3c58b83aee2007ca76dc5d1242c09b6f7989c76,7,58,45,103,8,2011-12-13 00:09:38,2011-12-10 10:40:54
d3c58b83aee2007ca76dc5d1242c09b6f7989c76...1cb0134f3414be187cc3eb98e9740aeeb07dcb16,2,33,16,49,6,2011-12-13 00:09:38,2011-12-10 10:40:57
1cb0134f3414be187cc3eb98e9740aeeb07dcb16...21aeafceda2382d26bfa73a98ba45a937d65d77a,3,96,0,96,6,2011-12-13 00:09:38,2011-12-10 10:41:01
b15aa973b296ca36ae39592491bcb02944ac0f7a...1df9bf46d656970d0db254cb7faab0d0505802e0,1,17,11,28,2,2011-12-12 21:06:36,2011-12-10 12:47:36
1df9bf46d656970d0db254cb7faab0d0505802e0...093a309136c38eca0ea2dd5da3c68b483443d113,2,156,6,162,10,2011-12-12 21:31:32,2011-12-10 12:49:25
093a309136c38eca0ea2dd5da3c68b483443d113...7f13334e074bb053eccd14787e416306bc4b413a,2,34,24,58,15,2011-12-12 21:32:16,2011-08-13 17:06:23
7f13334e074bb053eccd14787e416306bc4b413a...7acaaac275a1d338f7b2540779b7ea60f3f0667c,2,38,0,38,3,2011-12-12 21:32:16,2011-12-10 12:59:48
7acaaac275a1d338f7b2540779b7ea60f3f0667c...218b65fbf9428517e739b8bc26680c29910cf1cd,2,4,14,18,5,2011-12-12 21:33:53,2011-12-10 13:02:12
218b65fbf9428517e739b8bc26680c29910cf1cd...a7eff1e027270062c4c08f11d63b4103f3d917fe,3,1,55,56,4,2011-12-12 21:33:53,2011-12-10 13:03:48
a7eff1e027270062c4c08f11d63b4103f3d917fe...d596118d7a9b104db10e64b2680a30ea80f1439c,3,7,21,28,9,2011-12-12 21:33:53,2011-12-10 13:06:12
b15aa973b296ca36ae39592491bcb02944ac0f7a...5cd75c7d8da8971d0d78f82d78c017e686fb5bb0,1,2,2,4,2,2011-11-23 21:23:33,2011-11-23 06:31:55
5cd75c7d8da8971d0d78f82d78c017e686fb5bb0...d69bafcb36e9a5920d7a848053f070562231a96d,1,4,4,8,3,2011-11-23 21:24:54,2011-11-23 06:44:16
d69bafcb36e9a5920d7a848053f070562231a96d...fc14b89a7e6899b8ac3b5751ec2d8c98203ea4c2,2,2,2,4,2,2011-11-28 22:07:22,2011-11-28 22:07:13
6b09c7883f50044a68d93ef6872486bad2e93a9d...b507b465f7831612b9d9fc643e3e5218b64e5bfa,2,64,0,64,3,2006-10-20 04:28:06,2006-10-20 02:26:08
cdad8bbe92a447233133be8f9f3015c1bd7e10eb...8a5dbef8ac24bc5a28409d646cf3ff6db0cccb3f,3,6,6,12,4,2006-09-13 19:20:15,2006-09-13 08:26:47
cdad8bbe92a447233133be8f9f3015c1bd7e10eb...5df1e0d05cc42aeef9bf2fce243375fb6dac2121,1,34,5,39,4,2006-09-13 07:33:14,2006-09-13 06:53:27
9a7a62ff71c436fb5e024ec409ec28fca460a168...96779be48a8e5d3a50a07e0fcab942e7066235a9,1,3,1,4,3,2006-10-10 02:19:45,2006-10-10 02:19:45
96779be48a8e5d3a50a07e0fcab942e7066235a9...4e27fb06f0fe4206606172f94a18e08d7d87c070,2,54,7,61,10,2006-10-10 03:23:09,2006-10-06 19:39:09
4e27fb06f0fe4206606172f94a18e08d7d87c070...e88ee2915493213ea0d0be64c542c090fefd4b33,1,1,1,2,1,2006-10-11 00:58:34,2006-10-10 19:16:25
e88ee2915493213ea0d0be64c542c090fefd4b33...9861718b305a672f3d17936ea6a6cbd9d9a70059,1,3,3,6,2,2006-10-11 05:29:02,2006-10-11 05:29:02
9861718b305a672f3d17936ea6a6cbd9d9a70059...a057f806674f691f1640d33df14de8de8a3d4c87,1,1,1,2,1,2006-10-11 06:00:29,2006-10-11 06:00:29
a057f806674f691f1640d33df14de8de8a3d4c87...0503f9c178c36a19e1f8e8930b367db0f58ce5ca,1,1,1,2,1,2006-10-11 07:57:17,2006-10-11 07:57:17
9a7a62ff71c436fb5e024ec409ec28fca460a168...83936a29e275bc0c04f60d3333e4951a9e16b1fc,1,54,39,93,18,2006-10-09 00:14:45,2006-10-08 21:31:18
9a7a62ff71c436fb5e024ec409ec28fca460a168...adc446fe5d5f6dc1fb5edeaa9aa016ef94e70da1,1,0,257,257,4,2006-10-09 00:13:15,2006-10-08 19:56:19
eb153837d8509fc6ef59b17630429c63c0993b2d...e30496dfcb98a305a57b835c248cbc3aa2376bfc,1,174,82,256,16,2006-10-25 21:40:20,2006-10-24 03:33:17
eb153837d8509fc6ef59b17630429c63c0993b2d...e42797f5b6d5ed3b8c894d89493e285c40d58dc8,2,111,30,141,30,2006-10-25 21:39:07,2006-10-23 18:50:18
e42797f5b6d5ed3b8c894d89493e285c40d58dc8...636171cb80255682bdfc9bf5a98c9e66d4c0444a,2,224,44,268,33,2006-10-26 07:20:07,2006-10-26 03:28:17
636171cb80255682bdfc9bf5a98c9e66d4c0444a...3c9af366469524920864bbc1af4dcfd72029c314,2,75,6,81,21,2006-10-26 07:20:13,2006-10-26 03:32:59
3c9af366469524920864bbc1af4dcfd72029c314...9bee24785133ba3c2361b17f8c20019ab57b6f72,1,16,3,19,5,2006-10-27 01:27:44,2006-10-26 03:31:53
9bee24785133ba3c2361b17f8c20019ab57b6f72...d9c20ba13dfca737373ba466d2a718cafdc17f92,2,15,206,221,10,2006-10-27 21:58:31,2006-10-27 19:42:17
d9c20ba13dfca737373ba466d2a718cafdc17f92...b89c4e93cc1939493c2bb9b6c3f60eabaf653eff,1,12,12,24,11,2006-10-27 22:00:19,2006-10-27 20:14:23
56532fa147d56057ad4121f5ccea8e254748afdd...5ad0828ca33e7af402466b0e04db16c014428d1a,1,1,1,2,1,2006-11-01 19:31:55,2006-10-30 20:37:54
5ad0828ca33e7af402466b0e04db16c014428d1a...45bd0c808d2a89254ee50807a99b7cf1147aa6d7,1,22,14,36,13,2006-11-01 20:15:39,2006-10-30 21:29:06
45bd0c808d2a89254ee50807a99b7cf1147aa6d7...8b4b94cc7998d6312025fe3350be57c89b803f9c,1,2,2,4,2,2006-11-01 20:26:29,2006-10-30 21:25:11
8b4b94cc7998d6312025fe3350be57c89b803f9c...1da1b3a3e06fdcbbd0b154a6930fc0261a5ee866,1,1,1,2,1,2006-11-01 20:53:13,2006-11-01 20:53:13
1259404c7e5cd88b7f6692986469cd20cbfacdad...e827633a5d7d627eb1170b2d0c71e944d0d56faf,5,110,93,203,6,2006-10-24 03:25:32,2006-10-23 23:01:57
e827633a5d7d627eb1170b2d0c71e944d0d56faf...2b60356da5369dd60ab26eabaa91d95b6badf209,4,29,24,53,5,2006-10-27 01:31:17,2006-10-26 16:52:39
6a96b32d3b045c6e8d1b553fd6b64e03db9b0e45...18d5453ed36331b3f4123afae6c1c6bb4ef4d0a5,1,7,4,11,2,2006-11-09 18:44:56,2006-11-09 18:44:56
7c49cb288173ab5264b3b9e4257aeeb13388334c...aa5481c1af08edbca821a0d025d26e9bc41a5c49,1,3,0,3,1,2006-08-08 19:24:13,2006-08-08 19:23:47
aa5481c1af08edbca821a0d025d26e9bc41a5c49...329a304714255f6e5528b4311d29f9d83c85d201,1,2,1,3,1,2006-08-08 19:47:55,2006-08-08 19:21:33
329a304714255f6e5528b4311d29f9d83c85d201...c96c29093f70f04e01ff1d3a9c1d509ef6afdb00,1,9,1,10,2,2006-08-08 20:20:18,2006-08-08 20:11:16
c96c29093f70f04e01ff1d3a9c1d509ef6afdb00...6c8d06aff107aa2132648d682a278111c1d08565,1,1,1,2,1,2006-08-08 20:30:10,2006-08-08 20:01:32
05ad292d61099f0577c6886cd7b2d849dda0010b...42817b96b1b80b56fd5a4d5e0d6239524b1832a3,2,24,1,25,2,2013-10-30 19:17:47,2013-10-30 19:17:47
9981b6d915a49d325f790f2aa825aa56ae4ac85c...9b92c82fde2dc42e5ec3240e673549418b88163e,1,14,7,21,5,2007-02-07 05:51:58,2007-02-07 05:51:58
9b92c82fde2dc42e5ec3240e673549418b88163e...825769a8fe4d0529268fee7e763bc8f24ed4218e,3,94,6,100,7,2007-02-07 07:03:03,2007-02-07 07:03:03
825769a8fe4d0529268fee7e763bc8f24ed4218e...c499d76849b09194434708376138952e2cac2e68,2,49,33,82,9,2007-02-07 07:19:31,2007-02-07 07:19:31
c499d76849b09194434708376138952e2cac2e68...820b9310127afe3533bb57034d6f458f5aed3e7e,2,27,9,36,5,2007-02-07 07:42:44,2007-02-07 07:42:44
820b9310127afe3533bb57034d6f458f5aed3e7e...22c9f7e4c5b1d14868de413b70d26b9b0670078f,1,6,2,8,1,2007-02-07 07:46:35,2007-02-07 07:46:35
22c9f7e4c5b1d14868de413b70d26b9b0670078f...bdd9f4240f3686ca9beb14d803772995b43f39d5,1,87,0,87,2,2007-02-07 08:49:08,2007-02-07 08:49:08
8f5d6b469fdb41d549fb8624a54dc62ff1760c41...825b045f52daa2c8f28370f30c759adbdec51cbb,1,1,1,2,1,2006-09-05 20:36:19,2006-09-05 20:03:48
825b045f52daa2c8f28370f30c759adbdec51cbb...c41e20b30b2bd4b8167917336676cde6f6aadd06,1,1,1,2,1,2006-09-06 00:40:46,2006-09-05 19:00:17
c41e20b30b2bd4b8167917336676cde6f6aadd06...0caea90be0e565a923b69df7b32c13cbcf892d6d,1,2,0,2,1,2006-09-06 00:40:49,2006-09-05 06:22:16
0caea90be0e565a923b69df7b32c13cbcf892d6d...5d6f0935e6df017fcc446e348aebf4da2d210a27,2,87,74,161,9,2006-09-06 04:28:36,2006-09-06 04:28:36
5d6f0935e6df017fcc446e348aebf4da2d210a27...42cabc341c4e6da3c9873db7af1003bd1a72a8fd,2,31,0,31,6,2006-09-06 04:39:02,2006-09-06 04:39:02
42cabc341c4e6da3c9873db7af1003bd1a72a8fd...0ea2582d1cbbacd91eb0f040c4994ecd2bb6cdb9,1,7,4,11,5,2006-09-06 07:21:57,2006-09-04 05:42:32
8f5d6b469fdb41d549fb8624a54dc62ff1760c41...cb2b9f5ee15547e878c668504140c66f3a42d81c,1,25,0,25,1,2006-09-05 07:13:25,2006-09-04 11:38:40
a3f5d02edb2c1a037ed3ed8d2ebd3f3e5da9d198...07ccbff89b6736a5253e6bba62c9a8e1f2da0ffd,1,15,12,27,10,2006-09-28 04:36:54,2006-09-28 00:44:30
a3f5d02edb2c1a037ed3ed8d2ebd3f3e5da9d198...dd4676299dde0a4c6f8a471e6353170f86a78c8a,4,389,28,417,35,2006-09-28 01:00:52,2006-09-26 14:47:43
dd4676299dde0a4c6f8a471e6353170f86a78c8a...eb30aed7c69190fd648947d54bbb9ebe53c67715,3,61,20,81,18,2006-09-28 01:00:53,2006-09-27 16:16:10
dd0c367e5e1358539bdd11c3a474bb6792504d30...20a3847d8a5032ce41f90dcc68abfb36e6fee9b1,1,25,16,41,13,2006-10-01 05:02:36,2006-10-01 03:33:05
20a3847d8a5032ce41f90dcc68abfb36e6fee9b1...ba0ac36ec5708820e670731001f7ab35351c6c48,2,2,2,4,2,2006-10-01 05:13:28,2006-10-01 03:34:17
4839bd8a6605e0c9c5c68ddec40d2a1a5ddd57d8...ce74618d95088d99de53fb691f361da05932f705,1,2,2,4,2,2006-09-30 02:20:27,2006-09-22 23:17:58
12f9b8a3152ff9fa48464187a83f7c6279fe5094...fbc72799a82bb9a25657a6e30bfcd7b8fe3e5a45,1,4,4,8,3,2006-10-01 07:42:40,2006-10-01 07:42:40
1ed4813f7d018eb35187209d43b98746a2e69542...4b46e22d48271d1a220133a925dc5009048eb577,1,2,0,2,1,2006-12-30 10:18:24,2006-12-30 10:18:24
4b46e22d48271d1a220133a925dc5009048eb577...000792830b8ca96e6d973545192cba8d5df48279,1,8,1,9,2,2006-12-30 10:36:02,2006-12-30 10:35:14
000792830b8ca96e6d973545192cba8d5df48279...5dc7bcc2453ce854dc1192cfffcc8aee1cc3b69d,5,78,0,78,5,2006-12-30 10:36:08,2006-12-30 10:22:38
5dc7bcc2453ce854dc1192cfffcc8aee1cc3b69d...99e09cce8d0eace48209483b07e2a9d99542bd04,2,9,5,14,4,2006-12-30 10:36:13,2006-12-30 10:21:48
99e09cce8d0eace48209483b07e2a9d99542bd04...7cbcf4d5579bdc5d9f8a4bf3f37d3390fc6e2572,3,16,0,16,3,2006-12-30 23:58:32,2006-12-30 19:59:08
7cbcf4d5579bdc5d9f8a4bf3f37d3390fc6e2572...677cfed56ac530878b746ee4cca3ada8af384a81,3,12,2,14,3,2006-12-30 23:58:43,2006-12-30 20:20:43
677cfed56ac530878b746ee4cca3ada8af384a81...53af9816bcb1d441fef76c3adaf0c4cb858768ac,1,45,0,45,2,2006-12-31 00:35:57,2006-12-30 23:49:32
53af9816bcb1d441fef76c3adaf0c4cb858768ac...22b6abcd0872c50f4bff47e96819a86db4bb6e61,1,5,2,7,3,2006-12-31 02:05:05,2006-12-31 01:07:41
22b6abcd0872c50f4bff47e96819a86db4bb6e61...400e74df98e0808ccf233025fe700a316f65854c,1,16,7,23,5,2006-12-31 02:19:19,2006-12-31 01:03:51
400e74df98e0808ccf233025fe700a316f65854c...c869753ebbb00e188da5ab308d42cc738335f0ab,2,18,4,22,9,2006-12-31 06:21:31,2006-12-31 04:53:55
c869753ebbb00e188da5ab308d42cc738335f0ab...ef5ddb2fe0cdb3bd09acb7229512b6ae9193423f,1,2,2,4,1,2006-12-31 06:22:13,2006-12-31 04:28:53
ef5ddb2fe0cdb3bd09acb7229512b6ae9193423f...45b097947d6297a4b3f1016b05c66cdc15b411c2,1,3,3,6,3,2006-12-31 06:22:13,2006-12-31 04:29:11
45b097947d6297a4b3f1016b05c66cdc15b411c2...ad1a382fbb3ecb1bb017854a470816c815cc46c9,1,39,34,73,12,2006-12-31 06:22:13,2006-12-31 04:30:19
ad1a382fbb3ecb1bb017854a470816c815cc46c9...9b0b50936ec76ad8e582d18d5bf54bc81c685e9b,4,9,9,18,8,2006-12-31 06:22:14,2006-12-31 02:55:15
9b0b50936ec76ad8e582d18d5bf54bc81c685e9b...cd83c74cb3161a19b5efd33f40cfe378c2f64ddb,3,30,7,37,9,2006-12-31 06:22:14,2006-12-31 02:55:19
cd83c74cb3161a19b5efd33f40cfe378c2f64ddb...95d3c4f546c664c3571dd4a93f11ae2f54e55e6e,3,8,6,14,6,2006-12-31 06:22:14,2006-12-31 02:55:22
95d3c4f546c664c3571dd4a93f11ae2f54e55e6e...d77a64d353cea0f72655b86dd04bcf9f86cbbea6,3,20,1,21,3,2006-12-31 06:22:14,2006-12-31 03:13:05
d77a64d353cea0f72655b86dd04bcf9f86cbbea6...a862f97e98decc317437fa3b04081f68fb4ffbf3,1,7,7,14,1,2006-12-31 06:39:24,2006-12-31 06:39:24
1ed4813f7d018eb35187209d43b98746a2e69542...e40a9e2c9ed0723088e0fb65deb9b430fc91c367,1,2,5,7,5,2006-12-29 19:37:01,2006-12-29 10:35:40
e40a9e2c9ed0723088e0fb65deb9b430fc91c367...b5ffa5ceef250ae57b9088ac1de22e783faf7ff8,1,112,0,112,1,2006-12-29 20:14:30,2006-12-29 20:14:30
1ed4813f7d018eb35187209d43b98746a2e69542...4d703a1a9016cd0a08994ddf7fc2f4739f223112,3,14,23,37,11,2006-12-29 19:36:44,2006-12-23 07:33:25
4d703a1a9016cd0a08994ddf7fc2f4739f223112...77ccc5bbd1bd403abd5f552be7210073bea856a6,5,17,2,19,6,2006-12-29 19:36:44,2006-12-23 07:33:35
77ccc5bbd1bd403abd5f552be7210073bea856a6...c41ee586dc95b757cdff4deae10a30a691ba758b,4,40,34,74,27,2006-12-29 19:36:44,2006-12-23 07:33:44
c41ee586dc95b757cdff4deae10a30a691ba758b...2dc3a234094afc61c367be3e6018722cd9d92ea9,1,2,2,4,2,2006-12-29 19:36:44,2006-12-23 07:33:47
2dc3a234094afc61c367be3e6018722cd9d92ea9...75025ccdb79b5d6b290c630f8777c9f7bb9d257c,2,17,0,17,2,2006-12-29 19:36:44,2006-12-23 07:33:55
75025ccdb79b5d6b290c630f8777c9f7bb9d257c...9bc879c1ced505089e2a1e420d32599bb15b35b5,2,47,40,87,13,2006-12-29 19:36:44,2006-12-23 07:34:01
9bc879c1ced505089e2a1e420d32599bb15b35b5...03e79c88aa34ce188eb4fb7509e6d127c79c507d,4,85,67,152,50,2006-12-29 19:36:44,2006-12-23 07:34:08
03e79c88aa34ce188eb4fb7509e6d127c79c507d...079afb18fed078af01bd9ab02e2ebbe5d31893b1,3,87,39,126,22,2006-12-29 19:36:44,2006-12-23 07:34:13
079afb18fed078af01bd9ab02e2ebbe5d31893b1...8d8a4ea5530ef9c738341887a7dcece4abd7dcbe,1,12,4,16,2,2006-12-29 19:36:44,2006-12-23 07:34:18
8d8a4ea5530ef9c738341887a7dcece4abd7dcbe...54044bf825d311751e30552248be1e0cac99a5a3,1,30,15,45,5,2006-12-29 19:36:44,2006-12-23 07:34:23
54044bf825d311751e30552248be1e0cac99a5a3...60bb8b1453e2f93d13e7bb44e8e46c085d2dd752,5,76,13,89,9,2006-12-29 19:36:45,2006-12-23 07:34:28
60bb8b1453e2f93d13e7bb44e8e46c085d2dd752...bac2614de3c162de2328f21f2272ffbc30122230,1,1,0,1,1,2006-12-29 19:36:45,2006-12-23 07:34:33
bac2614de3c162de2328f21f2272ffbc30122230...40be82723ca35d4e95daccc3ccf6456f6876430e,1,2,2,4,1,2006-12-29 19:36:45,2006-12-23 07:34:38
40be82723ca35d4e95daccc3ccf6456f6876430e...73b4e4be7128f75346ce6053d6da1672f243bc74,1,3,1,4,1,2006-12-29 19:36:45,2006-12-23 07:34:41
73b4e4be7128f75346ce6053d6da1672f243bc74...11daf39b74321d02d574479def29939d67c319ad,1,27,15,42,7,2006-12-29 19:36:45,2006-12-23 07:34:44
11daf39b74321d02d574479def29939d67c319ad...a53128b60162d7a84adca4206540df5b8e3d9dc8,2,32,0,32,5,2006-12-29 19:36:45,2006-12-23 07:34:47
a53128b60162d7a84adca4206540df5b8e3d9dc8...2dee8af67688bb24575dd6b07106bc41d9997923,1,60,0,60,1,2006-12-29 19:36:45,2006-12-23 07:34:51
2dee8af67688bb24575dd6b07106bc41d9997923...8c82534d89cef9260c12768e74eb4ef6c54f7217,2,7,2,9,4,2006-12-29 19:36:45,2006-12-24 05:46:13
8c82534d89cef9260c12768e74eb4ef6c54f7217...97bfeb34df1aa8a1cf232278624a5a5c924ee380,2,39,8,47,6,2006-12-29 19:36:45,2006-12-24 05:47:19
97bfeb34df1aa8a1cf232278624a5a5c924ee380...c4712e4553f13d87d655325a57538f299402d457,6,22,19,41,15,2006-12-29 19:36:45,2006-12-24 05:47:23
c4712e4553f13d87d655325a57538f299402d457...5fe5c8300da67a07bd430a33c474ef1498cb1d4b,1,4,4,8,3,2006-12-29 19:36:45,2006-12-26 04:40:58
5fe5c8300da67a07bd430a33c474ef1498cb1d4b...f5b1b5a07e2d715c5ee7c098e95bd3dbc8ee745d,1,4,3,7,3,2006-12-29 19:36:45,2006-12-27 07:46:23
f5b1b5a07e2d715c5ee7c098e95bd3dbc8ee745d...9c18df19073bad62e16d6b6b8e1939fd15424612,1,5,2,7,4,2006-12-29 19:36:45,2006-12-29 06:29:06
9c18df19073bad62e16d6b6b8e1939fd15424612...2c039da804ee0542ff41d2f22a444d04a2d37856,1,11,0,11,2,2006-12-29 19:36:46,2006-12-29 08:30:01
9066f4ef2fe27b7636094c06d2361820cd31e03e...a597fb0e713d172a34efb4bf6f65cf2f64cf4536,1,4,2,6,1,2007-01-01 23:07:35,2007-01-01 23:07:35
a597fb0e713d172a34efb4bf6f65cf2f64cf4536...f4bf2184ae8b79f95b9f56c1ea5455d04e559299,2,16,1,17,4,2007-01-01 23:08:06,2007-01-01 23:08:06
f4bf2184ae8b79f95b9f56c1ea5455d04e559299...96a738c0ddd49afc3bfcbf7575be55e492b69a82,1,0,1,1,1,2007-01-02 07:42:53,2007-01-02 07:42:53
96a738c0ddd49afc3bfcbf7575be55e492b69a82...54b9e0225ad150b4528d7a12f2196ad46f058302,1,2,1,3,2,2007-01-02 19:22:08,2007-01-02 19:22:08
54b9e0225ad150b4528d7a12f2196ad46f058302...44a167b007a20189200f4baf9ff4f24aa0f7571e,1,10,0,10,2,2007-01-03 07:25:42,2007-01-02 08:57:11
44a167b007a20189200f4baf9ff4f24aa0f7571e...825cee7b285d9c733e9aec03cf4362e8029ee1c1,3,30,2,32,4,2007-01-03 07:33:21,2007-01-02 14:12:09
efe2c9e0024bf779585a6cdc3651af5a0f8bac72...db9819a40a56b4747931e637c1c22a104dcab902,1,12,13,25,4,2006-12-08 07:10:05,2006-12-08 06:27:21
db9819a40a56b4747931e637c1c22a104dcab902...006ede5e860717ff1ec68125393bcd4e74507e5b,1,3,0,3,1,2006-12-08 10:07:01,2006-12-08 09:55:19
006ede5e860717ff1ec68125393bcd4e74507e5b...bbee1d971dc07c29f840b439aa2a2c890a12cf9f,1,1,1,2,1,2006-12-08 18:51:12,2006-12-08 11:44:31
bbee1d971dc07c29f840b439aa2a2c890a12cf9f...a552db3a64464f1b514b074fbc43aaf599106087,1,39,7,46,3,2006-12-08 19:31:49,2006-12-08 10:20:17
a552db3a64464f1b514b074fbc43aaf599106087...2cdf87ebd9976d98d544669d94b111fea731d2ba,2,2,1,3,2,2006-12-08 22:07:45,2006-12-08 22:07:45
2cdf87ebd9976d98d544669d94b111fea731d2ba...62b339a544b1fa5199de7571c460d770cb286e65,2,20,2,22,5,2006-12-09 02:13:31,2006-12-09 01:28:26
62b339a544b1fa5199de7571c460d770cb286e65...90ffefe564cd849f88b1d1b5817eb25e3d57521b,1,2,2,4,2,2006-12-09 04:11:21,2006-12-09 04:04:21
90ffefe564cd849f88b1d1b5817eb25e3d57521b...4cfeccc75d6ab1ccc433770bac6bf3b15ab486d6,1,14,13,27,7,2006-12-09 04:11:39,2006-12-09 03:58:50
2cf3be1d31b322cf45640f3019a32d19a8a9b6f8...3fe5489a2550118e0eb3f90e348cb78afeeb61e0,1,35,13,48,6,2006-02-24 06:17:42,2006-02-23 19:29:42
2cf3be1d31b322cf45640f3019a32d19a8a9b6f8...d4a1cab541be0c276b38285c8b33050ea411eacf,5,200,1,201,5,2006-02-23 01:10:42,2006-02-21 23:04:51
d4a1cab541be0c276b38285c8b33050ea411eacf...3844cdc8f19dcd848003586d6b98c9f2bd36a7d0,2,55,34,89,12,2006-02-23 01:10:42,2006-02-23 00:37:27
907380eeff27e9a07d6f1c03847c3d80f9e0e79a...c86e8568d87aec483379f2cef0ab81580abd1af5,1,1,1,2,1,2006-02-23 23:50:18,2006-02-23 10:58:37
c86e8568d87aec483379f2cef0ab81580abd1af5...581845f0b8ed97cb718fffe2bc9613b6186d84ee,1,1,1,2,1,2006-02-24 01:03:37,2006-02-24 01:02:56
581845f0b8ed97cb718fffe2bc9613b6186d84ee...eae3fe5e509f3d3890bc99015cb02f9b67aa501c,1,47,30,77,11,2006-02-24 09:29:00,2006-02-24 08:54:59
79b2c75e043ad85f9a6b1a8d890b601a2f761a0e...e100712968cb781183a549f164e34596d6e7fcb2,1,4,3,7,4,2006-04-04 23:14:02,2006-03-30 05:13:12
e100712968cb781183a549f164e34596d6e7fcb2...4e95e1f738720e2f768098f73e76109c15a4e1ff,1,43,1,44,3,2006-04-04 23:39:51,2006-04-04 23:39:51
4e95e1f738720e2f768098f73e76109c15a4e1ff...6e5f7203de440fd46c6709a9f71a7e0641363a5c,1,69,6,75,7,2006-04-05 00:24:03,2006-04-05 00:24:03
6e5f7203de440fd46c6709a9f71a7e0641363a5c...ce08872259d3036f424070cb5a9a4d5ec67f1f7a,1,1,1,2,1,2006-04-05 00:28:34,2006-04-04 06:24:55
ce08872259d3036f424070cb5a9a4d5ec67f1f7a...4840be66b10fd5e5d67e27a8d0c67a96d5b8356a,1,17,6,23,14,2006-04-05 00:29:47,2006-04-04 07:19:45
79b2c75e043ad85f9a6b1a8d890b601a2f761a0e...50b44eceed2105db0bee194904649249cc5f0308,1,334,118,452,59,2006-04-04 00:16:22,2006-04-04 00:16:22
50b44eceed2105db0bee194904649249cc5f0308...d94f8cd6adc746b850aad421e30d5f90f7f11ee4,1,30,29,59,23,2006-04-06 00:18:23,2006-04-06 00:18:23
b4a081b428c607f98c5d0a0eec8d543dc1f2abcd...4c0fea0f1116a4c782696a3e4cf2db31a4aa8adc,1,18,9,27,6,2006-03-31 07:59:19,2006-03-31 07:59:19
4c0fea0f1116a4c782696a3e4cf2db31a4aa8adc...8eef8e09cee1691faad2159ebdab7ca3b232d26b,1,4,4,8,4,2006-04-01 00:23:46,2006-04-01 00:23:46
8eef8e09cee1691faad2159ebdab7ca3b232d26b...7b0c996679e975b666fd27c922e1e0837b611c98,4,8,12,20,8,2006-04-01 00:24:48,2006-03-31 00:52:42
7b0c996679e975b666fd27c922e1e0837b611c98...2a0925be3512451834ec9a3e023f4cff23c1cfb7,1,22,23,45,8,2006-04-01 00:24:48,2006-03-31 01:05:25
2a0925be3512451834ec9a3e023f4cff23c1cfb7...be7db6e574b95c70ac544c78d74fdeea0fb4058d,1,6,4,10,4,2006-04-02 02:16:53,2006-04-02 00:35:06
be7db6e574b95c70ac544c78d74fdeea0fb4058d...22c31bf183bff576c7807f9d67abfc11ee8e1fa4,1,4,1,5,1,2006-04-02 02:55:56,2006-04-02 02:52:58
22c31bf183bff576c7807f9d67abfc11ee8e1fa4...53069686601d156dea3787a100ffc4e35c78040f,1,7,13,20,9,2006-04-02 02:56:16,2006-04-02 02:38:25
53069686601d156dea3787a100ffc4e35c78040f...bbbc8c3a8d455e1f5d15c3764eba70250b5479e9,1,1,1,2,1,2006-04-02 03:13:22,2006-04-02 03:13:22
bbbc8c3a8d455e1f5d15c3764eba70250b5479e9...53909056da869eb79c2a20699794b63c8c87e7fd,1,17,0,17,1,2006-04-02 05:57:52,2006-04-02 02:25:02
53909056da869eb79c2a20699794b63c8c87e7fd...20b1d700c94c8b5b2b8b6f1b4982858d03cd9453,2,31,13,44,21,2006-04-02 05:57:55,2006-04-02 02:25:03
20b1d700c94c8b5b2b8b6f1b4982858d03cd9453...139faba8f5c86a960c893f92e25afd4caa79c2fb,1,0,1,1,1,2006-04-02 19:58:45,2006-04-02 11:12:47
139faba8f5c86a960c893f92e25afd4caa79c2fb...5142db69123b9dd5605ee3e290409787675dd748,2,21,21,42,19,2006-04-02 19:58:46,2006-04-02 11:13:01
5142db69123b9dd5605ee3e290409787675dd748...ec26b4d6b004b6529c79e995a543945076c683aa,2,2,2,4,2,2006-04-02 19:58:47,2006-04-02 11:13:10
65b5e41e24dd76e9cc272399f458857d5b13d63e...dff86e282fa38bf60d53b82cfa54f5f449563338,1,1,1,2,1,2006-03-28 00:08:29,2006-03-28 00:08:29
dff86e282fa38bf60d53b82cfa54f5f449563338...9c48666aa0745c666593bb7383e17f78c43eb36d,1,2,1,3,1,2006-03-28 01:55:20,2006-03-28 01:15:24
9c48666aa0745c666593bb7383e17f78c43eb36d...acb725772964ee11656543a28c303e9aa6d092c5,7,60,6,66,11,2006-03-28 02:43:51,2006-03-28 02:23:31
acb725772964ee11656543a28c303e9aa6d092c5...5cdeae71ea7330c08cf96b581e2c7696949e3840,1,1,1,2,1,2006-03-28 08:04:50,2006-03-28 08:04:50
5cdeae71ea7330c08cf96b581e2c7696949e3840...9181ca2c2b1f2897baa67ff8e48b1984822115b5,1,3,3,6,2,2006-03-29 01:29:09,2006-03-29 01:28:04
9181ca2c2b1f2897baa67ff8e48b1984822115b5...384e99a4a99820c34fe3600b2aad3f0185dd43db,3,51,7,58,10,2006-03-29 01:29:21,2006-03-28 07:58:34
384e99a4a99820c34fe3600b2aad3f0185dd43db...ce4a706388bd26a3f897bb41a397113f1076ffc6,2,18,12,30,5,2006-03-30 03:41:37,2006-03-30 03:41:37
ce4a706388bd26a3f897bb41a397113f1076ffc6...0c8b106b020421c346532351af36028bfdda4c37,1,4,5,9,3,2006-03-30 07:30:52,2006-03-30 07:30:52
0c8b106b020421c346532351af36028bfdda4c37...e464f4c3119b04712ab87329f3dd4d4f21b0a8a7,1,1,3,4,1,2006-03-30 07:53:05,2006-03-30 07:00:42
e464f4c3119b04712ab87329f3dd4d4f21b0a8a7...1b0c7174a17de801051402ed35ac085ebd91e88c,13,156,143,299,17,2006-03-30 07:54:13,2006-03-30 06:55:43
1b0c7174a17de801051402ed35ac085ebd91e88c...98a4fef3f28e48d12a4fecd5cf97daa774c1e5bc,1,6,5,11,6,2006-03-30 23:31:03,2006-03-30 17:00:43
98a4fef3f28e48d12a4fecd5cf97daa774c1e5bc...ef5b4eabb6da7cead197e387589896345d3dfbc6,1,8,2,10,3,2006-03-30 23:31:21,2006-03-30 17:01:23
ef5b4eabb6da7cead197e387589896345d3dfbc6...13ccd6d4f2086ace8f70dc8a60a40ac5836dc881,1,5,2,7,2,2006-03-30 23:40:38,2006-03-30 06:37:18
4d44cb195aca5b744fd9f149af513637ff343a67...e7ad4a9c3c9d383d1df52410e18808174f7be667,1,1,5,6,1,2006-02-10 17:21:02,2006-02-10 15:20:40
e7ad4a9c3c9d383d1df52410e18808174f7be667...39556fbdadaacf67330bc1464e0172468e9c3a5e,1,5,5,10,2,2006-02-10 19:42:56,2006-02-10 18:42:05
39556fbdadaacf67330bc1464e0172468e9c3a5e...9da5c2f0d7e99eca46ce12bfe08755b30f2bdd30,1,15,1,16,4,2006-02-10 19:56:42,2006-02-10 19:56:42
b92b2ce94e5673ab3a2fbc9c762b39aaf7d72de5...8bb2e03b9d47d87657b67ddfaf712e736cf3db8f,1,7,3,10,5,2006-02-12 09:47:57,2006-02-12 09:47:57
8bb2e03b9d47d87657b67ddfaf712e736cf3db8f...f9666adfead47d265a65c7ba6f90d0ebae3e6b21,2,84,1,85,8,2006-02-12 09:48:47,2006-02-12 09:48:47
294c695d8cfbcf95a5c33fc6ba386f496964defb...31ec6abf887ec95642cbe82fe61076e975494ab0,2,16,3,19,2,2005-12-15 05:25:22,2005-12-15 05:25:22
31ec6abf887ec95642cbe82fe61076e975494ab0...988eece42aa4c1c6b7c4cdfd102748c19acba7ed,1,7,0,7,1,2005-12-15 06:24:46,2005-12-15 06:26:46
988eece42aa4c1c6b7c4cdfd102748c19acba7ed...8431c4eb0976b0558eaa1df475ce6de6b52ce484,1,6,0,6,1,2005-12-15 07:08:08,2005-12-15 07:08:08
8431c4eb0976b0558eaa1df475ce6de6b52ce484...6677c4665af2d73f670bec382bc82d0f2e9513fb,3,75,9,84,12,2005-12-15 20:54:00,2005-12-15 20:54:00
6677c4665af2d73f670bec382bc82d0f2e9513fb...c6f60f991f29ce1140b9dede1185562fbffe2549,1,1,1,2,1,2005-12-15 21:03:20,2005-12-15 21:02:25
c6f60f991f29ce1140b9dede1185562fbffe2549...92811b57674ce81e0d7fa1cfeca44023bc650641,1,6,8,14,4,2005-12-16 00:02:04,2005-12-15 22:47:57
92811b57674ce81e0d7fa1cfeca44023bc650641...2a58a9a92ea275c11a83269425677c95c532cc18,1,4,4,8,2,2005-12-16 00:02:21,2005-12-15 22:48:26
2a58a9a92ea275c11a83269425677c95c532cc18...1403959cc804131a91f15117c7afd6822d0fad90,1,5,0,5,1,2005-12-16 00:02:25,2005-12-15 22:48:38
1403959cc804131a91f15117c7afd6822d0fad90...e5e3a9d8f91685cbbb4099f1fdfb9798461ef5d4,1,12,22,34,14,2005-12-16 00:19:11,2005-12-15 16:10:32
e5e3a9d8f91685cbbb4099f1fdfb9798461ef5d4...06d900cf28117ad5260335ea9ab7533f223320bf,1,2,0,2,1,2005-12-16 01:53:44,2005-12-16 01:53:44
06d900cf28117ad5260335ea9ab7533f223320bf...ee34518d629331dadd58b1a75294369d679eda8b,1,5,0,5,1,2005-12-16 01:56:32,2005-12-16 01:40:25
ee34518d629331dadd58b1a75294369d679eda8b...06bf6ac4248e834a229027908d405f5e42ac96d7,1,5,2,7,1,2005-12-16 02:52:51,2005-12-16 02:52:51
06bf6ac4248e834a229027908d405f5e42ac96d7...3ae854c3567dd10055fbe12b8bd91bd2d447f55f,4,47,0,47,4,2005-12-17 02:23:33,2005-12-17 02:23:33
3ae854c3567dd10055fbe12b8bd91bd2d447f55f...68283999f8ae0e9286f8b7f199905b77d608cb80,2,8,4,12,3,2005-12-17 02:23:52,2005-12-16 02:03:59
68283999f8ae0e9286f8b7f199905b77d608cb80...69224716f78d6a772318e73060a70ba5ae67e55b,1,2,0,2,2,2005-12-17 06:28:19,2005-12-17 06:01:06
69224716f78d6a772318e73060a70ba5ae67e55b...01385e275828c1116ea9bfcf827f82f450ee8f5f,2,3,3,6,3,2005-12-17 07:32:47,2005-12-17 07:12:33
01385e275828c1116ea9bfcf827f82f450ee8f5f...80248b2e4888a05adcb903f53af84ee513d22245,3,25,10,35,7,2005-12-17 19:39:39,2005-12-17 19:39:39
80248b2e4888a05adcb903f53af84ee513d22245...011fbc7f07fdf82cf922d1eb269bb4dac3e0cc40,1,3,30,33,3,2005-12-18 07:10:56,2005-12-17 07:19:14
011fbc7f07fdf82cf922d1eb269bb4dac3e0cc40...8872f27b8773dfe7d3dbb440c27d4a5a9dbc8470,1,2,5,7,1,2005-12-18 07:10:56,2005-12-17 07:48:14
8872f27b8773dfe7d3dbb440c27d4a5a9dbc8470...f7087e2e7c34421b4577876969da94d0f6195414,1,0,5,5,1,2005-12-18 07:10:56,2005-12-17 07:48:22
f7087e2e7c34421b4577876969da94d0f6195414...c054d64e8783e5ac2fa68c382f00df9087bca0f9,2,1,49,50,2,2005-12-18 07:10:56,2005-12-17 08:00:50
c054d64e8783e5ac2fa68c382f00df9087bca0f9...ad8972150887a8ed3dd4869fc9318cc2e48dd69f,6,206,173,379,15,2005-12-18 07:11:29,2005-12-15 06:17:38
ad8972150887a8ed3dd4869fc9318cc2e48dd69f...2247efb40b304f158b9ab41455bd711366a44f57,2,2,4,6,3,2005-12-18 09:55:29,2005-12-18 09:55:29
2247efb40b304f158b9ab41455bd711366a44f57...d808111ebdb0b50709527612221eb2970ed6ece9,1,17,13,30,5,2005-12-18 20:11:27,2005-12-18 20:11:27
d808111ebdb0b50709527612221eb2970ed6ece9...ea77e675e564211513ebedb4f5bdcda482d7fd30,1,11,0,11,2,2005-12-18 21:53:33,2005-12-18 20:15:58
ea77e675e564211513ebedb4f5bdcda482d7fd30...112d0bafd620c0e0f10614a3ba021d4de4fae331,1,12,9,21,5,2005-12-18 21:53:40,2005-12-18 20:41:10
112d0bafd620c0e0f10614a3ba021d4de4fae331...3af849a3dae9442767668cd2045e360225724558,1,2,3,5,2,2005-12-19 08:31:08,2005-12-19 08:31:08
3af849a3dae9442767668cd2045e360225724558...42f4570c86c41c5bfdc72465afc8f1928da69eea,2,25,3,28,4,2005-12-19 09:51:16,2005-12-19 01:23:50
42f4570c86c41c5bfdc72465afc8f1928da69eea...ef1cc2cc216b37c33f1f5d68e770404c435fe1f3,1,2,1,3,1,2005-12-20 00:19:06,2005-12-20 00:16:49
ef1cc2cc216b37c33f1f5d68e770404c435fe1f3...3aadad1b32db3555bc19dac0892d41628a8e736d,2,14,2,16,5,2005-12-20 00:38:16,2005-12-20 00:35:48
3aadad1b32db3555bc19dac0892d41628a8e736d...d89056c258bcf1164287c6c6d58ca53344bda0df,1,2,1,3,2,2005-12-20 02:00:54,2005-12-20 01:59:58
d89056c258bcf1164287c6c6d58ca53344bda0df...ba922ccee7565c949b4db318e5c27997cbdbfdba,1,0,62,62,1,2005-12-20 02:02:20,2005-12-20 02:02:20
ba922ccee7565c949b4db318e5c27997cbdbfdba...e32faa8adbc8ba9803088e849bc26680134c853c,5,1,133,134,5,2005-12-20 02:05:49,2005-12-20 02:03:31
e32faa8adbc8ba9803088e849bc26680134c853c...1fdfd05db2f6e6bacd8c8255992fa4a7f1756176,8,0,0,0,0,2005-12-20 02:27:04,2005-12-20 02:27:04
1fdfd05db2f6e6bacd8c8255992fa4a7f1756176...1c15afb9343bca82e687d008ec983a9110ac9c40,9,46,63,109,29,2005-12-20 02:28:16,2005-12-20 00:18:28
1c15afb9343bca82e687d008ec983a9110ac9c40...47dd0d595d04ee5283dfd8a0b4cbd6e6de8ad57f,5,93,23,116,30,2005-12-20 02:32:44,2005-12-14 01:21:41
47dd0d595d04ee5283dfd8a0b4cbd6e6de8ad57f...913419fcc648dd43d7f7afdd94fa25aee4f9798a,2,6,5,11,3,2005-12-20 02:32:44,2005-12-18 10:03:15
913419fcc648dd43d7f7afdd94fa25aee4f9798a...a5c21d6eb7e7ce164666d55e5911c271664ddfe7,1,2,0,2,1,2005-12-20 05:55:12,2005-12-20 05:55:12
a5c21d6eb7e7ce164666d55e5911c271664ddfe7...29e4d3635709778bcc808dbad0477efad82f8d7e,2,110,54,164,11,2005-12-20 08:22:28,2005-12-20 08:02:15
29e4d3635709778bcc808dbad0477efad82f8d7e...407c8eb0d09d4b84bbfda9e04895a35c8fd6fef6,2,44,5,49,8,2005-12-20 20:12:18,2005-12-20 20:12:18
407c8eb0d09d4b84bbfda9e04895a35c8fd6fef6...4b3511b0f8422fd2c5b1b37c9655ae2ce904bca5,1,25,1,26,1,2005-12-20 22:18:47,2005-12-20 22:18:47
4b3511b0f8422fd2c5b1b37c9655ae2ce904bca5...a3431febfe241120205472def2a14ef09a4dbe60,1,3,1,4,1,2005-12-21 04:54:28,2005-12-21 04:54:28
a3431febfe241120205472def2a14ef09a4dbe60...41f93a2c903a45167b26c2dc93d45ffa9a9bbd49,1,9,1,10,4,2005-12-21 05:18:32,2005-12-21 02:13:02
8ac4838af428a2a32498b3e8d13295eb714654b4...f4a11066cfb70c49fddbca7f95aa0fedcee53cca,1,1,1,2,1,2005-12-22 01:05:09,2005-12-21 23:47:09
f4a11066cfb70c49fddbca7f95aa0fedcee53cca...7246ed438c541650c2cd50e4e98b43226f60da0c,5,9,9,18,9,2005-12-22 07:09:40,2005-12-15 07:47:30
ebc12ce5bfcf6401c8fcc7e4935bc50142a65db4...9b15770220aab37302cda115d257eeb4e6e72959,1,8,2,10,3,2005-12-22 07:48:45,2005-12-22 06:25:00
9b15770220aab37302cda115d257eeb4e6e72959...356bece0a2725818191b12f6e991490d52baa1d1,1,24,8,32,4,2005-12-22 07:48:56,2005-12-21 10:23:42
356bece0a2725818191b12f6e991490d52baa1d1...e6c310fd0d7384973efc6b1d5999a5e8a5b2f3bd,2,21,5,26,7,2005-12-23 00:35:37,2005-12-22 22:37:24
44760f1d559ae2087e53be6971ad4f1a8f18f1d7...31b9755a655aa34373d8b39030e9a0f46ffa0078,1,0,0,0,0,2005-11-07 20:52:07,2005-11-07 20:52:07
31b9755a655aa34373d8b39030e9a0f46ffa0078...e66ab03fcfb508efbe2b73bafc7cf0ef16430378,3,4,3,7,3,2005-11-07 21:28:31,2005-11-07 08:23:59
e66ab03fcfb508efbe2b73bafc7cf0ef16430378...5e0306adfa03aebb8f6cf866c4450f04e128c3fd,3,282,1,283,3,2005-11-07 21:28:37,2005-11-07 04:57:08
5e0306adfa03aebb8f6cf866c4450f04e128c3fd...0dd276b8713a484496a2ef694b6c72b1ddbef08b,1,9,1,10,5,2005-11-07 21:29:39,2005-11-07 19:39:37
0dd276b8713a484496a2ef694b6c72b1ddbef08b...92e2eb9c0a868348dd2caf2b923fd6542ca7ceb7,1,12,2,14,4,2005-11-07 21:29:41,2005-11-07 18:23:11
92e2eb9c0a868348dd2caf2b923fd6542ca7ceb7...52963a7a3fad7f3da7b4ec49824d92338a2ab668,1,2,1,3,1,2005-11-08 00:34:04,2005-11-08 00:22:34
52963a7a3fad7f3da7b4ec49824d92338a2ab668...d1745afa2f062764b075300bda06aac1402dfcf6,1,15,7,22,8,2005-11-08 01:13:10,2005-11-07 23:19:44
d1745afa2f062764b075300bda06aac1402dfcf6...79f6ac77d90660971d778f2e300935ab16eb26c2,1,1,1,2,1,2005-11-08 01:53:06,2005-11-08 01:53:06
79f6ac77d90660971d778f2e300935ab16eb26c2...a5ae8e64cfa09cea57cce832c8371818711d94c2,3,36,9,45,5,2005-11-08 02:21:51,2005-11-08 02:21:51
a5ae8e64cfa09cea57cce832c8371818711d94c2...390cb0c17a3a0751cfb7490a496930872f752d27,1,4,0,4,3,2005-11-08 02:23:10,2005-11-08 02:23:10
f865a2ad981f72423aa1c19412ce57c543801957...b8041fe4d84bc75212cb6161d508fd1e9d2203ab,1,1,1,2,1,2005-10-16 21:09:50,2005-10-16 21:09:50
b8041fe4d84bc75212cb6161d508fd1e9d2203ab...622ef9df199cdbc11ff30e1d92324c1abe3f89cb,3,66,2,68,4,2005-10-17 05:41:59,2005-10-17 05:41:59
0d0b7c237af0846123bef73879d65a3e78a56461...230f13225df8b7e7eb0acc91a8c630f9e84967c1,7,88,44,132,18,2005-10-08 22:54:01,2005-10-08 22:54:01
230f13225df8b7e7eb0acc91a8c630f9e84967c1...f22ca7c50d79fcfd769ddcda988e0981fb883a16,1,10,0,10,1,2005-10-08 22:54:35,2005-10-08 22:54:35
f22ca7c50d79fcfd769ddcda988e0981fb883a16...d119e3de13ea1493107bd57381d0ce9c9dd90976,1,3,0,3,2,2005-10-08 22:54:35,2005-10-08 22:54:35
d119e3de13ea1493107bd57381d0ce9c9dd90976...730d48a2ef88a7fb7aa4409d40b1e6964a93267f,4,135,1,136,7,2005-10-08 22:54:36,2005-10-08 22:54:36
730d48a2ef88a7fb7aa4409d40b1e6964a93267f...f48000fcbe1009c18f1cc46e56cde2cb632071fa,1,6,69,75,10,2005-10-08 22:54:36,2005-10-08 22:54:36
f48000fcbe1009c18f1cc46e56cde2cb632071fa...d2b8593fd3754cf2e0b9a121fe6ba63bfefa3a47,2,3,3,6,3,2005-10-08 22:54:37,2005-10-08 22:54:37
d2b8593fd3754cf2e0b9a121fe6ba63bfefa3a47...f7c153431b4049e7697664dee4a3d71013422f9d,1,15,7,22,5,2005-10-09 19:55:49,2005-10-09 19:52:35
f7c153431b4049e7697664dee4a3d71013422f9d...f8e2c54c9a17af3319e96db1d9e97ace36ae6831,1,16,12,28,10,2005-10-10 00:30:19,2005-10-10 00:30:19
4cfc63db1daa0ebdb284ae6972928e41a317a0c8...babfaba23d530e2818db62161825a65e582adbdc,2,17,11,28,8,2005-10-05 23:56:31,2005-10-05 23:56:31
2ba6c47be1762726ad0c1d5779064c489150d789...c80522e30fdc190f8c8c7fc983bbe040a1b03e93,1,5,3,8,1,2005-09-14 06:49:55,2005-09-14 06:49:55
c80522e30fdc190f8c8c7fc983bbe040a1b03e93...705a7148ba1bb9597b1837b7f64a0dcb67f1ad0c,1,3,7,10,2,2005-09-14 20:57:34,2005-09-14 20:41:24
705a7148ba1bb9597b1837b7f64a0dcb67f1ad0c...19397b4521bcc27eb224413fb71519223b94290f,3,8,7,15,5,2005-09-14 21:06:50,2005-09-14 21:06:50
19397b4521bcc27eb224413fb71519223b94290f...ba65af9c1f67461c0dfa6582c911d6a893d80284,1,54,6,60,3,2005-09-15 19:46:30,2005-09-14 08:43:53
ba65af9c1f67461c0dfa6582c911d6a893d80284...1db69b571c9eaab73a7b21303bfedda5fb5f31ce,1,8,0,8,8,2005-09-15 19:46:30,2005-09-13 15:38:58
1db69b571c9eaab73a7b21303bfedda5fb5f31ce...53764ee43defda7109fe547f471eac54c4e8b3d6,2,3,3,6,3,2005-09-15 19:46:31,2005-09-14 10:41:52
53764ee43defda7109fe547f471eac54c4e8b3d6...0f56479d7325083953be36b8c8ee90380ff27f92,12,4,558,562,19,2005-09-15 19:46:31,2005-09-14 20:08:55
0f56479d7325083953be36b8c8ee90380ff27f92...60d0526aaa5d29589420bfadd0623ec878c5edf3,1,0,26,26,3,2005-09-15 19:46:32,2005-09-14 20:15:53
60d0526aaa5d29589420bfadd0623ec878c5edf3...61420a2cb45c01e55d5bfc6abc632b9a41bb73a7,2,17,0,17,2,2005-09-15 20:16:31,2005-09-14 12:48:05
61420a2cb45c01e55d5bfc6abc632b9a41bb73a7...22c6e1d0f76f58a425065d3e8e447b6366ccd98c,1,26,2,28,6,2005-09-15 20:19:29,2005-09-15 01:31:42
22c6e1d0f76f58a425065d3e8e447b6366ccd98c...0de68d28d34f915951324b9f387e6e67172e9951,1,89,16,105,5,2005-09-15 20:42:03,2005-09-15 19:33:14
0de68d28d34f915951324b9f387e6e67172e9951...f71a69ab055c47056d0270b29b8f7455278c2422,7,46,6,52,14,2005-09-15 21:56:37,2005-09-15 21:56:37
f71a69ab055c47056d0270b29b8f7455278c2422...60ab26de9970ce829c95eb11ebb407fe95780148,3,6,1,7,4,2005-09-15 21:57:52,2005-09-15 21:43:17
60ab26de9970ce829c95eb11ebb407fe95780148...98533b90cb8e88484cb381334b19cbf4f7cf92b1,1,1,0,1,1,2005-09-15 22:06:39,2005-09-15 22:06:39
98533b90cb8e88484cb381334b19cbf4f7cf92b1...5098bafb756de69d03882707a3382899c0cb7dd1,3,37,25,62,20,2005-09-15 23:13:43,2005-09-15 23:13:43
5098bafb756de69d03882707a3382899c0cb7dd1...5bdbaaa4e9dd901dd2907b53bbecfdf3eac9276b,1,15,25,40,4,2005-09-15 23:19:44,2005-09-15 22:14:29
5bdbaaa4e9dd901dd2907b53bbecfdf3eac9276b...316eee8fe0282a6f14441b0045a32871bdf90d36,1,2,2,4,1,2005-09-16 00:06:58,2005-09-15 22:40:13
316eee8fe0282a6f14441b0045a32871bdf90d36...b4416b432bde78fac057224d14c7e9c85097a152,1,1,1,2,1,2005-09-16 00:38:26,2005-09-16 00:38:26
b4416b432bde78fac057224d14c7e9c85097a152...c6ae61590f79cb7ff848ef0f2c33396507e60442,1,4,1,5,2,2005-09-16 06:31:44,2005-09-16 04:08:24
c6ae61590f79cb7ff848ef0f2c33396507e60442...b93aa3ec9506618e9a22c04d775b35f31e7e068f,1,1,1,2,1,2005-09-16 06:33:03,2005-09-16 06:33:03
b93aa3ec9506618e9a22c04d775b35f31e7e068f...ed0a84883ec33cd2d4ee7f66204de7dab13353d8,1,5,2,7,1,2005-09-16 22:16:35,2005-09-16 14:24:12
ed0a84883ec33cd2d4ee7f66204de7dab13353d8...0e60471c2a30882b9b44ebfd699d2414a0a348cc,1,20,6,26,6,2005-09-16 22:16:37,2005-09-16 20:38:49
0e60471c2a30882b9b44ebfd699d2414a0a348cc...6b82d16bfcfffebbb5790b114063e1617d17338a,1,2,1,3,1,2005-09-16 22:16:40,2005-09-16 19:30:46
6b82d16bfcfffebbb5790b114063e1617d17338a...28423758591577828672219c1031d463701a11cc,2,2,2,4,2,2005-09-16 22:16:42,2005-09-16 11:54:10
28423758591577828672219c1031d463701a11cc...d0ac30f20ca1dd1d28a1b84bf13687f09cf535ae,1,8,11,19,4,2005-09-16 22:16:45,2005-09-16 21:30:29
d0ac30f20ca1dd1d28a1b84bf13687f09cf535ae...b0d8923ec01fd91b75ab079034f89ced91500157,1,10,2,12,5,2005-09-16 22:19:07,2005-09-16 21:32:48
b0d8923ec01fd91b75ab079034f89ced91500157...8805ccac40348094d26b3b892c6ca3d08dc12ae0,3,12,3,15,5,2005-09-16 22:32:23,2005-09-16 21:55:33
8805ccac40348094d26b3b892c6ca3d08dc12ae0...4447badcd22a889d656192803eff1003602839c5,3,68,5,73,4,2005-09-17 18:56:41,2005-09-17 18:56:41
4447badcd22a889d656192803eff1003602839c5...a09af243fbffeb5ddc5dbc94a4bdf9201c346030,1,1,0,1,1,2005-09-17 18:57:49,2005-09-17 03:40:12
a09af243fbffeb5ddc5dbc94a4bdf9201c346030...2a7055ae982fd66b078ac84cbb2b1f9408b67295,1,3,1,4,2,2005-09-17 18:57:50,2005-09-17 00:53:19
2a7055ae982fd66b078ac84cbb2b1f9408b67295...aa894d8887c96a8b72adf94c2b52c519f7b47174,1,1,1,2,1,2005-09-17 18:57:50,2005-09-17 01:02:46
aa894d8887c96a8b72adf94c2b52c519f7b47174...5a90d4ac1ab4d7700595e415e3a2062ecb378523,3,6,4,10,5,2005-09-17 18:57:50,2005-09-12 05:25:49
5a90d4ac1ab4d7700595e415e3a2062ecb378523...50d69ef4f59756195172721e5f25a9dc28e891ca,1,1,1,2,1,2005-09-17 18:57:50,2005-09-17 06:27:52
50d69ef4f59756195172721e5f25a9dc28e891ca...b3661567cfa604abfa6a67d8e7bbd6db018c3fe6,1,134,35,169,28,2005-09-17 18:57:50,2005-09-15 03:26:08
b3661567cfa604abfa6a67d8e7bbd6db018c3fe6...434d036fe4b8f1b7571eb912957590a483944b26,1,1,1,2,1,2005-09-17 20:51:03,2005-09-17 20:51:03
434d036fe4b8f1b7571eb912957590a483944b26...490e23d22afad5734daa447f1a991eeff3a669bb,1,9,1,10,1,2005-09-18 06:35:49,2005-09-18 06:35:49
490e23d22afad5734daa447f1a991eeff3a669bb...85d106c267ec26f398e0aaf352d8011f661c459a,1,44,32,76,16,2005-09-18 08:01:07,2005-09-18 08:01:07
9847f7e0db8359b3932fd51290d777610090c33f...928f74de22536129b696218073a3940ae4ab1199,1,1,0,1,1,2005-08-29 04:34:28,2005-08-29 04:05:36
59f3e3f1e2b600f122e011b3d90309736799e25d...5512ac5840c8bcaa487806cf402ff960091ab244,4,24,3,27,5,2013-12-17 19:42:12,2013-12-17 19:42:12
fe3623c6359f687495549320762a2a330b2e7128...3f09db07b3dc0758756fad73c96abd0e47cbcd1b,1,26,2,28,5,2014-03-21 20:41:27,2014-03-21 20:41:27
2156a98045f83dd88386b2d4d3241d66bf722ade...5889271114a25b6750bb6137784ae5a93df22b39,4,22,21,43,17,2014-03-03 20:15:10,2014-03-03 09:24:29
8bba7206b503b63a8208355f66bc09c981072d51...bd3e186d811a13d8687584856f345a767e3e4d67,2,47,1,48,3,2014-01-27 19:01:35,2014-01-27 19:01:35
2cd861672e1021012f40597b9b68cc3a9af62e10...7bbc4e8fdb33e0a8e42e77cc05460d4c4f615f4d,5,42,4,46,6,2014-02-13 21:41:53,2014-02-13 21:40:47
e28dcdce137b6ce53343aec3a4eccc0cd6f294b5...eea591373e139fc8aab89a78ccb0b1512a2bf0de,2,3,2,5,3,2014-05-09 17:59:07,2014-05-09 17:59:07
1dc51c663c0a1c58c935677c614d31ddf687b3f1...4da588357a4a8b73f6a8d9c24435dabee74d0a7e,4,25,11,36,9,2014-05-08 21:31:43,2014-05-06 22:45:52
4da588357a4a8b73f6a8d9c24435dabee74d0a7e...482b8f3208e797f00db58edd7ff0d67275e898f5,2,9,4,13,2,2014-05-08 21:31:44,2014-05-06 22:45:53
44484662d83de2ae98d04738ec43d4dea1f859a8...3f784a4dcbe270a1f48b23177917a1832a777d1c,2,8,8,16,5,2014-01-06 19:25:50,2014-01-02 16:15:44
3f784a4dcbe270a1f48b23177917a1832a777d1c...a3c5263438f7c0ff7dd4d0d8ea86ed7a84a32d18,1,2,1,3,3,2014-01-06 19:26:10,2014-01-02 16:16:30
a3c5263438f7c0ff7dd4d0d8ea86ed7a84a32d18...c6127fa3e25551e969d775b0332d37dc84db1969,4,134,117,251,5,2014-01-06 19:26:31,2014-01-02 16:17:11
44484662d83de2ae98d04738ec43d4dea1f859a8...d028b8906afb5b8c24c9449f26e5f930750d8df7,1,1,1,2,2,2014-01-06 17:14:29,2014-01-05 10:18:02
d028b8906afb5b8c24c9449f26e5f930750d8df7...f33c2c0f9e2258a80e6e406af39e9fa3fd6e430e,2,26,4,30,6,2014-01-06 17:14:48,2014-01-05 10:18:03
f33c2c0f9e2258a80e6e406af39e9fa3fd6e430e...422553df49bee5a5ea3c9106dfb7f1e4cbb54153,1,1,0,1,1,2014-01-06 17:17:05,2014-01-05 10:18:04
422553df49bee5a5ea3c9106dfb7f1e4cbb54153...c39a2f117853d89f0aee5b616c52df46a30b108b,1,1,0,1,1,2014-01-06 17:17:25,2014-01-05 10:18:05
44484662d83de2ae98d04738ec43d4dea1f859a8...6bc76725eaa2f4bb8c5fad47f843425d9160e7f3,1,18,18,36,3,2014-01-03 18:29:03,2014-01-03 14:45:46
282616c72d1d08a77ca4fe1186cb708c38408d87...17d65f03e1d2d1678d9960a4f71e4caccacf500f,2,33,0,33,5,2015-03-06 19:11:39,2015-03-06 13:55:32
282616c72d1d08a77ca4fe1186cb708c38408d87...9a6f1287fb69c46c7895f987ffea558b13ae79d1,10,2,13,15,15,2015-03-05 23:46:03,2015-03-05 22:49:46
282616c72d1d08a77ca4fe1186cb708c38408d87...4aff646d17e81084000100da586bef8f9d6a17a5,2,70,2,72,11,2015-03-05 23:27:48,2015-03-05 19:06:02
282616c72d1d08a77ca4fe1186cb708c38408d87...eb32c66e8d02306ac77fa49594652574ec317af3,1,1,1,2,1,2015-03-03 20:07:18,2015-03-01 04:18:14
282616c72d1d08a77ca4fe1186cb708c38408d87...189c860c9ec5deb95845c056ca5c15b58970158e,4,7,7,14,7,2015-03-02 20:32:24,2015-03-02 19:22:31
282616c72d1d08a77ca4fe1186cb708c38408d87...d913022763b633e2694a556dbb07f74684b0ee92,1,2,1,3,1,2015-03-02 19:49:35,2015-03-01 11:58:25
282616c72d1d08a77ca4fe1186cb708c38408d87...ab27389affc78a521fe44fc25518e1d11a4fc433,2,15,1,16,2,2015-03-02 19:31:27,2015-03-02 15:05:39
282616c72d1d08a77ca4fe1186cb708c38408d87...f98c2f7e53062a59f67914337c0b45c82393e11f,1,26,12,38,7,2015-02-27 21:41:21,2015-02-27 01:39:48
f98c2f7e53062a59f67914337c0b45c82393e11f...4d6be03b95c3db21db1bb8fee01128c1b13f70e7,2,85,2,87,2,2015-02-27 21:41:29,2015-02-27 01:42:27
282616c72d1d08a77ca4fe1186cb708c38408d87...77fdb8a82cc624bb3c720b87725abae4d0df5073,1,1,1,2,1,2015-02-27 20:22:41,2015-02-27 14:01:58
282616c72d1d08a77ca4fe1186cb708c38408d87...bcd57cb9e1583fe5174112422caba0397f7ae5f6,1,6,2,8,1,2015-02-26 21:10:40,2015-02-26 13:16:49
282616c72d1d08a77ca4fe1186cb708c38408d87...d5c4b1855dd20ee59aac851a201244280482e14d,1,7,0,7,1,2015-02-20 23:07:19,2015-02-20 19:32:20
d5c4b1855dd20ee59aac851a201244280482e14d...afb5de7f8d0dd9207a587f4ee2fa29d7ee8485ea,1,2,1,3,1,2015-02-20 23:09:23,2015-02-20 19:32:21
282616c72d1d08a77ca4fe1186cb708c38408d87...5e0be134d35a31f41921f89331a95337bb38c152,2,11,1,12,2,2015-02-05 20:37:36,2015-02-05 06:53:28
5e0be134d35a31f41921f89331a95337bb38c152...1d0655c15ebf7dfb460466d058daab790ed285b2,1,6,2,8,1,2015-02-05 21:16:55,2015-02-05 21:00:24
282616c72d1d08a77ca4fe1186cb708c38408d87...8c1e9f40f9de3ce0cddf4ff43c41cb47d3d50ba4,1,1,1,2,1,2015-02-05 20:03:27,2015-02-05 13:28:04
282616c72d1d08a77ca4fe1186cb708c38408d87...57b92a77a0aeff49e82cc0bfd14eac9313683766,1,2,16,18,1,2015-01-28 20:56:06,2015-01-27 12:35:53
282616c72d1d08a77ca4fe1186cb708c38408d87...8b9c2dd4dee01b5a0a9c5cfdd5a107f78edaceb7,2,19,1,20,2,2015-01-27 20:41:45,2015-01-27 20:02:27
282616c72d1d08a77ca4fe1186cb708c38408d87...1044b1f6a1a56ae723fd19cddd769380dc775f48,1,1,1,2,1,2015-01-27 03:57:12,2015-01-26 15:48:33
282616c72d1d08a77ca4fe1186cb708c38408d87...a9c4641df7989c9adf6af471705ebf735c35a92f,1,5,0,5,2,2015-01-22 22:44:36,2015-01-22 08:39:44
282616c72d1d08a77ca4fe1186cb708c38408d87...923fc5ab4017801078a54310f94fd95c28b91ce0,1,1,1,2,1,2015-01-22 20:57:23,2015-01-16 21:54:52
923fc5ab4017801078a54310f94fd95c28b91ce0...2988289f2c5764605105037bfcb12f85b9971cf9,2,127,0,127,2,2015-01-22 20:57:24,2015-01-16 19:54:47
2988289f2c5764605105037bfcb12f85b9971cf9...407a792ef7e3c142a47c6b09a80f9ede4e14f444,1,21,2,23,3,2015-01-22 20:57:24,2015-01-16 23:32:00
282616c72d1d08a77ca4fe1186cb708c38408d87...25143a54fcc14273ed03b0cb77b6187f20d6069d,1,1,1,2,1,2015-01-21 20:40:05,2015-01-21 09:13:51
25143a54fcc14273ed03b0cb77b6187f20d6069d...a9942e108c9848ec5b69b6dddc59977d3f586aa9,1,1,1,2,1,2015-01-21 20:40:08,2015-01-21 09:14:01
282616c72d1d08a77ca4fe1186cb708c38408d87...99902739174be82851143d4be2a0f85727a9efe0,1,4,1,5,1,2015-01-08 20:08:06,2015-01-08 18:08:36
6898b797218ca1f25818d813318b387d965dc1bb...83332636f575f00edff8f3afb15a2f96885bf417,4,38,3,41,5,2014-12-17 19:22:32,2014-12-17 19:22:32
4224916ae979204f13db2996d9e32490e0acb90f...7edc02f4deedb3a11abeb328dc2596b2886c2f47,3,4,5,9,3,2014-01-17 20:09:26,2014-01-17 14:17:09
7edc02f4deedb3a11abeb328dc2596b2886c2f47...c9df6f4574c0174efd5000e0e99dca97ddb5034c,2,0,20,20,2,2014-01-17 20:09:52,2014-01-17 14:17:10
4224916ae979204f13db2996d9e32490e0acb90f...ac930287ff16823531b541a8e6a7436279e612be,1,8,2,10,4,2014-01-17 19:24:30,2013-12-27 08:05:15
4224916ae979204f13db2996d9e32490e0acb90f...b837f5d68da391f3a54817bb04f1e7ec04f9cdac,1,1,1,2,2,2014-01-17 18:50:03,2014-01-17 01:19:46
b837f5d68da391f3a54817bb04f1e7ec04f9cdac...5b711b207fe78de59ebcba70e16886bffaffc73c,1,0,1,1,1,2014-01-17 18:50:10,2014-01-17 01:20:11
5b711b207fe78de59ebcba70e16886bffaffc73c...428d52a5a56f81d3a42871b51480cecafec58fdd,2,2,3,5,3,2014-01-17 18:50:11,2014-01-17 01:21:59
428d52a5a56f81d3a42871b51480cecafec58fdd...b38f70a82b9628d80f5a9bc938a8861ee4dcf49e,1,1,1,2,2,2014-01-17 18:50:13,2014-01-17 01:22:56
b38f70a82b9628d80f5a9bc938a8861ee4dcf49e...cbfe47b67fc1072998c73e6d43cf6ad061a436f5,1,1,1,2,1,2014-01-17 18:50:14,2014-01-17 01:25:40
4224916ae979204f13db2996d9e32490e0acb90f...2ce66e2a0a09c169fb9afcbe15f9e23c1bc28008,1,1,1,2,1,2014-01-16 23:23:56,2014-01-16 22:43:34
4224916ae979204f13db2996d9e32490e0acb90f...01645b749376b7026276112d69d5b9c22b000ee4,1,2,1,3,1,2014-01-16 22:34:51,2014-01-15 17:31:11
4224916ae979204f13db2996d9e32490e0acb90f...b814da891e8261b909fc5d9fb07b4e8b13989c2d,3,46,0,46,3,2014-01-16 00:01:06,2014-01-15 23:18:38
b814da891e8261b909fc5d9fb07b4e8b13989c2d...ef93e3a49c3b2b62c6c450f862ce1626bc8dab54,1,1,1,2,1,2014-01-16 00:01:07,2014-01-15 23:18:39
4224916ae979204f13db2996d9e32490e0acb90f...a39c14af82e973ba1502888e89585b7501721ede,1,52,31,83,5,2014-01-15 20:38:30,2014-01-15 08:26:33
a39c14af82e973ba1502888e89585b7501721ede...f278f40f09fd5a4e8e091be489bcb54230d2e3de,1,5,5,10,4,2014-01-15 20:38:47,2014-01-15 08:27:32
f278f40f09fd5a4e8e091be489bcb54230d2e3de...8cd4249c4cdb19fce489a3f6ba31f499f4331341,2,24,8,32,11,2014-01-15 20:41:03,2014-01-15 08:31:57
8cd4249c4cdb19fce489a3f6ba31f499f4331341...3f6eb30f1dbb6f8f715c9121bba43f2a1d294e28,2,19,0,19,2,2014-01-15 20:43:29,2014-01-15 08:37:23
3f6eb30f1dbb6f8f715c9121bba43f2a1d294e28...9892d5d4541d93a8a6a4fd9ac4178d71d0d308e3,2,32,9,41,6,2014-01-15 20:51:14,2014-01-15 08:40:46
4224916ae979204f13db2996d9e32490e0acb90f...54457fe509ee311abc2c4c2a796d16ea379aa8f2,3,13,10,23,8,2014-01-14 21:58:06,2014-01-14 03:16:07
79fcbf7e703ca5805ebd46b2c7e09d0703f1c1ff...208acbfb82f722fb22320c381e7da8c8fb2e37e8,11,24,7,31,11,2014-03-25 22:09:24,2014-03-25 13:23:26
208acbfb82f722fb22320c381e7da8c8fb2e37e8...1b32decefd840e0ca5d18eefd6472fd8624dd849,5,66,5,71,14,2014-03-25 22:09:49,2014-03-25 13:23:27
79fcbf7e703ca5805ebd46b2c7e09d0703f1c1ff...4dd5c4709a51bb704c2c7fb59170b494b76daab9,1,18,1,19,7,2014-02-11 19:17:04,2014-02-09 14:35:31
79fcbf7e703ca5805ebd46b2c7e09d0703f1c1ff...de0957ce2e88b8ad639f1e4a7197eb556e114a1c,3,29,26,55,5,2014-02-10 18:46:35,2014-02-08 07:08:51
de0957ce2e88b8ad639f1e4a7197eb556e114a1c...9f673f9477c63433aa0774c11b9e42979721f4d6,3,23,5,28,5,2014-02-10 18:46:37,2014-02-08 07:08:52
79fcbf7e703ca5805ebd46b2c7e09d0703f1c1ff...a0f58c5830ac6d9e4da009f0273b1421588dc440,1,2,11,13,8,2014-01-22 19:28:01,2014-01-22 00:20:14
a0f58c5830ac6d9e4da009f0273b1421588dc440...0a88f08e284df1a882771f9e74133e2861b79e2d,1,8,17,25,9,2014-02-24 22:32:21,2014-01-22 00:20:15
0a88f08e284df1a882771f9e74133e2861b79e2d...62cf3ca95a7b34dcbf22d9ba4b2ea56f9fb739c9,1,2,2,4,2,2014-02-24 22:32:41,2014-02-08 09:19:26
62cf3ca95a7b34dcbf22d9ba4b2ea56f9fb739c9...352bbbd9f24b39ae863ceb78170a2685d40e6416,1,31,15,46,5,2014-02-24 22:32:41,2014-02-12 14:27:24
352bbbd9f24b39ae863ceb78170a2685d40e6416...3ee8944fa508675caad9b045af89bc5d845952f3,1,1,8,9,2,2014-02-25 17:51:24,2014-02-22 16:02:47
79fcbf7e703ca5805ebd46b2c7e09d0703f1c1ff...df49095ac25885c1bb1405bf7f10f48f14213852,1,892,812,1704,782,2014-01-17 23:45:37,2014-01-17 23:45:37
05df532655e14ba351b4ee8a0acd8f190ed0b745...35989c68ee5f577ae959f69281e456fd14460469,1,5,20,25,7,2012-07-23 04:39:57,2012-07-23 03:57:07
35989c68ee5f577ae959f69281e456fd14460469...75cd75830993e3b545f2b151d8eea2f3178f9ba4,1,75,53,128,14,2012-07-23 04:41:18,2012-07-23 03:57:08
75cd75830993e3b545f2b151d8eea2f3178f9ba4...c9bdd505200120a8dab0f7417ad3fd7553e39e3f,1,31,24,55,7,2012-07-23 04:42:23,2012-07-23 03:57:09
c9bdd505200120a8dab0f7417ad3fd7553e39e3f...b965e8f44ad76a810c60406d01b45b87d6ac2701,1,1,1,2,1,2012-07-23 04:43:04,2012-07-23 03:57:10
b965e8f44ad76a810c60406d01b45b87d6ac2701...1f2293457579a5bf22bb9c8324ded22b10705cc2,2,31,10,41,11,2012-07-23 16:35:53,2012-07-23 06:05:30
1f2293457579a5bf22bb9c8324ded22b10705cc2...7c7584b97096a168fe1236c84e5e12d7bee24476,1,21,6,27,7,2012-07-25 16:34:04,2012-07-25 03:14:22
7c7584b97096a168fe1236c84e5e12d7bee24476...283abb2c8abb3f40d8d0170ba45c2e45d40f8cdb,1,10,1,11,1,2012-07-25 16:41:54,2012-07-25 03:14:23
283abb2c8abb3f40d8d0170ba45c2e45d40f8cdb...a4cd5be30cdd19c43908dc55d8dd39a0fe79075b,1,32,14,46,13,2012-07-26 18:59:35,2012-07-26 06:07:57
a4cd5be30cdd19c43908dc55d8dd39a0fe79075b...ceb1497a74e75a0c9bd53716b787d33ad6e2397f,1,68,31,99,34,2012-07-26 20:06:00,2012-07-26 19:36:19
ceb1497a74e75a0c9bd53716b787d33ad6e2397f...190f5475f2a7edb777b65367d8796177aa13c830,1,2,1,3,1,2012-07-26 20:07:15,2012-07-25 03:14:24
190f5475f2a7edb777b65367d8796177aa13c830...7a30747fbacd9a2059e861cba80ebd67685ffe80,2,6,3,9,3,2012-08-10 15:07:41,2012-08-10 07:39:22
7a30747fbacd9a2059e861cba80ebd67685ffe80...755e8b3f35e3991a735a6be740eda4567d45a741,3,27,2,29,3,2012-08-10 15:08:08,2012-08-10 08:21:06
755e8b3f35e3991a735a6be740eda4567d45a741...ed36e5bd41f7192e42e9b4c573875a343a9daf48,1,1,1,2,1,2012-08-21 22:27:15,2012-08-21 10:21:40
76759c7dff53e8c84e975b88cb8245587c14c7ba...5f8580ad471ecd1745107b5ab1f9792e1d855743,1,14,20,34,15,2012-08-17 17:29:56,2012-08-17 14:53:10
5f8580ad471ecd1745107b5ab1f9792e1d855743...9a27f967055afe64dc5f7c4ed44e7ca06707e538,1,8,8,16,7,2012-08-20 18:12:58,2012-08-20 18:12:58
3b942e9df7314f40d99e6aaa2c62070bb36024c5...89ce391b8edae97bbfd0fdb33b4c252b6fd0dc53,1,6,6,12,6,2012-07-06 06:59:30,2012-07-06 00:01:29
89ce391b8edae97bbfd0fdb33b4c252b6fd0dc53...ca5ee2d1fbbb030f499587b58a49eb814f5b5ab0,1,31,0,31,4,2012-07-24 22:03:50,2012-07-24 22:03:50
d28436736a078a429213003a9472e8caeb86c286...60475183c0fe76eab2a12fdf840caa0a29217886,1,2,0,2,1,2012-06-21 06:35:08,2012-06-21 06:24:10
02101c969dba9de4200cdd0cc8d88ce665b2c474...8f9facfe94536209fbcfd6151cbcc1cd67fd6e0a,4,541,471,1012,8,2012-06-10 08:45:56,2012-06-09 22:25:56
8f9facfe94536209fbcfd6151cbcc1cd67fd6e0a...9f7ad1479d9ba88f175db57fba1ab704fc7b53d5,3,660,611,1271,5,2012-06-10 08:47:50,2012-06-09 22:28:10
9f7ad1479d9ba88f175db57fba1ab704fc7b53d5...68f532f4ba888f277637a94b4a49136054df0540,3,119,6,125,7,2012-06-10 08:47:53,2012-06-09 22:35:35
02101c969dba9de4200cdd0cc8d88ce665b2c474...a52f00711321f1c60f9e8ee4434cb5ddc43f6b64,1,2,2,4,3,2012-06-08 21:47:08,2012-06-08 21:47:08
a52f00711321f1c60f9e8ee4434cb5ddc43f6b64...ab9d75a8d7e48e03ab0be9fc5e38902f1c173b87,1,16,7,23,6,2012-06-08 22:44:38,2012-06-08 21:50:22
ab9d75a8d7e48e03ab0be9fc5e38902f1c173b87...6e513ba3a624a57fcf9e0f316ba54b3e0c951286,1,11,3,14,4,2012-06-13 21:04:33,2012-06-08 21:56:03
b694fbb1440976d1aa86f05fd819eb81b0fbc85a...d7f22ed23ee11807baeb0c835c50bb7089a0f49d,1,210,6,216,17,2012-06-11 17:04:57,2012-06-08 17:15:10
b694fbb1440976d1aa86f05fd819eb81b0fbc85a...6cb4571b4dc97c575cdcd49d5b87d7abdc1a407e,1,204,8,212,18,2012-06-09 07:23:27,2012-06-09 07:14:03
21dfc09d0aac0c1909958b09358957e9388ed238...d53a35032a67fde5b59c8a6a66e0466837cbaf1e,1,23,15,38,4,2012-06-07 18:46:02,2012-06-07 12:05:10
435c83323713066723e4194cd89c31bbec7011a2...a6eec1263883ce9787a354e1635b7b732e72c3c9,1,1,3,4,1,2013-03-17 05:16:45,2013-03-16 10:25:25
a6eec1263883ce9787a354e1635b7b732e72c3c9...06f15bf1f340f37293b471d8556842d4e89ff63f,2,10,1,11,2,2013-03-17 05:16:56,2013-03-16 10:27:01
06f15bf1f340f37293b471d8556842d4e89ff63f...f59de5d1ff9b0f9d570df99128f41520a281f9a5,1,2,2,4,1,2013-03-17 05:19:29,2013-03-16 10:28:30
d64383ab14c0e728f81a32ddbb8375ba8abde14f...1bfc51ac814125de03ddf1900245e42d6ce0d250,1,45,6,51,5,2012-10-11 18:26:14,2012-10-10 19:31:58
1bfc51ac814125de03ddf1900245e42d6ce0d250...9b7e776c0a5e6e90601badf175ad034ada5a230e,1,35,1,36,4,2012-10-11 18:26:14,2012-10-10 19:32:24
9b7e776c0a5e6e90601badf175ad034ada5a230e...9b3aaf8bf19ce2bf5e73b972dce31430e43df8dc,1,32,23,55,13,2012-10-16 22:39:21,2012-10-16 19:34:05
9b3aaf8bf19ce2bf5e73b972dce31430e43df8dc...76c36c02ff3fe1571051ce9278248bd269f8341b,1,1,1,2,1,2012-10-17 07:44:25,2012-10-17 07:44:25
d64383ab14c0e728f81a32ddbb8375ba8abde14f...b8c78e2a9d6141589202e98b898f477861fcb111,1,24,1,25,1,2012-10-10 20:02:33,2012-10-09 10:12:39
b8c78e2a9d6141589202e98b898f477861fcb111...44bc5ac71fd99f195bf1a3bea63c11139d2d535f,1,1,1,2,1,2012-10-10 20:11:57,2012-10-09 08:41:45
d64383ab14c0e728f81a32ddbb8375ba8abde14f...1266686b97d9c1783b89911a938bf992d8292bc6,1,1,0,1,1,2012-10-10 18:15:35,2012-10-06 17:33:08
6c109904bc87987364e37e214138cff8fcaa924a...50e6af7daf88f42f146c9148df24f7824a1dffac,1,4,0,4,1,2012-10-30 11:12:18,2012-10-30 09:21:40
3d7535e42496a5b24d8cb17da1a332759928bd35...b0576a6a6dd3b311391090b2ce15f991ac9914cf,1,17,3,20,4,2012-09-18 21:43:12,2012-09-18 21:43:12
6a3d05da55a488a4f5b2c3b2091f4445fa3847e9...1b48d56cfb006baf12d34b5e3150ba2ec1900e08,1,1,1,2,1,2013-09-11 16:32:30,2013-09-10 22:33:06
13baa9fe866f63311af5a5ee318beddb16eb5df4...75c96e05cec5654912122cb2435e8c3f928a441d,1,18,0,18,1,2012-10-21 19:07:58,2012-10-21 10:40:31
75c96e05cec5654912122cb2435e8c3f928a441d...b274a7146c44624bc30bbd54124312d4d3e6a28d,2,2,2,4,2,2012-10-21 19:08:42,2012-10-21 10:40:32
4ad4fce63a67cde3a93e6678724ed79b06109ad6...5a90748f2856f587a948148a9b6fad50a43df57c,2,152,1,153,2,2012-11-15 19:21:47,2012-11-15 19:21:47
8ead1bfe111085ef1ad7759e67340f074996b244...8c7a786b6c8eae8eac91083cdc9a6e337bc133b0,3,19,10,29,7,2012-10-21 20:56:23,2012-10-21 20:56:23
74faaa16f016af9fc429770ba701f2aa598d9f21...9667ccbc8c513458cba0606644150eccb8a0c86b,1,45,1,46,3,2012-11-27 21:21:15,2012-11-27 20:55:00
9667ccbc8c513458cba0606644150eccb8a0c86b...99bfd407000302ff27f2809d9d556c97427a9e3b,1,1,1,2,1,2012-11-27 21:21:15,2012-11-27 19:17:14
99bfd407000302ff27f2809d9d556c97427a9e3b...af0ed819c59248bc98f0a572bd4cdcb394f185c7,1,13,13,26,6,2012-11-27 21:21:15,2012-11-27 19:24:54
af0ed819c59248bc98f0a572bd4cdcb394f185c7...a20d3c0de1f107ddd719a4a9cec3addd56e8444f,2,13,10,23,7,2012-11-27 21:21:15,2012-11-27 19:47:46
a20d3c0de1f107ddd719a4a9cec3addd56e8444f...82dfc2c44ecda8a7afe417086c704b141a11cd58,2,5,3,8,3,2012-11-27 21:21:15,2012-11-27 20:05:10
82dfc2c44ecda8a7afe417086c704b141a11cd58...20c8cde45656fc187e06088ef5baf0bbdfdf70bd,1,2,3,5,1,2012-11-27 22:19:36,2012-11-27 22:19:36
20c8cde45656fc187e06088ef5baf0bbdfdf70bd...de9095955c581a664d9ce568a1ae58a98484090e,1,9,11,20,11,2012-11-29 17:46:30,2012-11-29 17:46:30
5d4ef1721ad873b8d0db1c4fc55ad9316accf2cb...ca70c9ea7224e1e47d8ab46ea67ba9e29ce8a121,1,1,1,2,1,2013-03-09 19:13:12,2013-03-09 15:29:25
5d4ef1721ad873b8d0db1c4fc55ad9316accf2cb...2163e5dbb4cad43d65a4ffc8daeacff5eedd7af9,2,8,10,18,5,2013-03-08 15:55:54,2013-03-08 09:29:08
2163e5dbb4cad43d65a4ffc8daeacff5eedd7af9...a6f7f9a32532a636bd458c7a3dc2cc16fbe237d3,3,4,2,6,4,2013-03-08 22:02:31,2013-03-08 09:30:25
a6f7f9a32532a636bd458c7a3dc2cc16fbe237d3...2cd83d10bb6bcf768129e1c4e5a4dee4b6bcd27f,5,41,0,41,6,2013-03-08 22:02:40,2013-03-08 09:32:22
423b5a104422d56645baf8229bfb496fa49c2a56...1098ff5a213265bb0d5df9a87d5493bd168f12a0,1,0,0,0,0,2012-05-22 22:35:00,2012-05-22 20:46:39
1098ff5a213265bb0d5df9a87d5493bd168f12a0...af31a456b4cd38f2630ed8e556e23954f806a3cc,3,290,256,546,4,2012-05-22 22:35:02,2012-05-22 20:46:40
af31a456b4cd38f2630ed8e556e23954f806a3cc...ac3eb1c38420b356b775ed63f7291eb4054d11d9,2,4,0,4,2,2012-06-10 07:34:38,2012-06-10 07:26:35
ac3eb1c38420b356b775ed63f7291eb4054d11d9...b7be4366ea9af9a6947a8be0ebe6a63ff5259b6a,2,12,1,13,3,2012-06-19 22:48:12,2012-05-09 00:44:35
54e6dc7daf8e4160d5ec5d2742ae09d416126a1b...0c3a433f94d6809bd6c81ef3bd5c5315c844aa5d,1,2,0,2,1,2012-08-21 03:57:41,2012-08-20 18:24:56
54e6dc7daf8e4160d5ec5d2742ae09d416126a1b...de37393344ddd4c3be5fbc1d9d168fba47165aa7,1,31,31,62,24,2012-05-08 17:47:41,2012-05-06 14:23:52
bef369219ae90097d187a8a12a82ab75f7f16638...1528d247e53bcf33db5b004a25a7d9b8c75c90e4,1,8,8,16,6,2012-05-11 21:31:27,2012-05-11 14:53:07
1528d247e53bcf33db5b004a25a7d9b8c75c90e4...2b189435f341cb2c7089af4f22e307405e6243df,1,1,8,9,3,2012-05-11 21:31:32,2012-05-11 14:59:25
5410ae422b0f3cfe604d393addcd13526e940112...4d2292e9a90465cbfa23f1c170c11423d11830df,2,5,6,11,6,2012-05-08 08:57:42,2012-05-07 19:35:03
93949627cb18d18f160fc922ace728d215297e6f...822e4a653d968312ab118bced15ac4c60d0adc26,1,2505,1210,3715,731,2012-05-08 08:10:22,2012-05-08 08:10:22
eb0bcd0fbe34befe7648a398efc7f4156b07da48...97a449ee3031e8d128190b7f53a21c7688f73ec9,1,1,0,1,1,2010-02-25 20:20:16,2010-02-25 10:39:50
b0883aa6c77111e88496bd0afe073caf68ab9f99...0455ec0330fd29146d6e16189cc9262566cc566d,3,67,8,75,18,2010-02-06 19:01:59,2010-02-06 18:26:24
b0883aa6c77111e88496bd0afe073caf68ab9f99...f22cd7fcc54a98277b3d2b82f1bb0b593658925c,1,13,2,15,4,2010-02-01 21:03:54,2010-02-01 02:15:04
f22cd7fcc54a98277b3d2b82f1bb0b593658925c...dc78250f15a06cc9f31037040517f3a5c85ad470,1,1,1,2,1,2010-02-01 21:03:55,2010-02-01 02:15:05
b0883aa6c77111e88496bd0afe073caf68ab9f99...46bac904581798eaf0f07f91701c2c72219e207f,3,28,14,42,14,2010-01-31 19:53:10,2010-01-31 19:46:53
b0883aa6c77111e88496bd0afe073caf68ab9f99...7eb151d6e289b98d2ad3d1a9ad08fe3693f05a24,5,13,36,49,30,2010-01-31 19:50:50,2010-01-30 01:22:19
b0883aa6c77111e88496bd0afe073caf68ab9f99...6a5d0b0a90789ed92cb87f1b69cfeef2a1db3566,13,24,24,48,24,2010-01-31 18:24:53,2010-01-31 13:24:39
6a5d0b0a90789ed92cb87f1b69cfeef2a1db3566...de7a79608c94f7319b55060741d6be98826deccb,1,9,5,14,4,2010-01-31 18:25:23,2010-01-31 16:43:49
de7a79608c94f7319b55060741d6be98826deccb...6ddf75ae5d0ff55844cd936a1b850ca9ae5abbe5,1,7,0,7,1,2010-01-31 18:27:56,2010-01-31 09:14:46
6ddf75ae5d0ff55844cd936a1b850ca9ae5abbe5...9f7a3c19dee2064b24b6b9fd5d6f6e770d4d539c,1,4,1,5,2,2010-01-31 19:33:44,2010-01-31 19:11:16
b0883aa6c77111e88496bd0afe073caf68ab9f99...745a2db409c3b8346f28f6b2f1961b19051430f5,1,3,5,8,5,2010-01-30 23:33:06,2010-01-30 22:30:38
745a2db409c3b8346f28f6b2f1961b19051430f5...b62a1a98bc65f52d972a3f403c5b29d6a84642fd,4,72,6,78,10,2010-01-30 23:53:50,2010-01-30 22:30:39
b62a1a98bc65f52d972a3f403c5b29d6a84642fd...62331ef1637f8089bc920b3066a2ec48afd6fd26,2,141,53,194,5,2010-01-30 23:53:52,2010-01-30 22:30:40
62331ef1637f8089bc920b3066a2ec48afd6fd26...24d4afcdc79cb250131841040b803401d261a473,1,3,3,6,3,2010-01-30 23:53:53,2010-01-30 22:30:41
24d4afcdc79cb250131841040b803401d261a473...0cf207f7a621d2f15bc3a5ec0fa6a7c8f3333386,1,9,2,11,4,2010-01-30 23:53:54,2010-01-30 22:30:42
0cf207f7a621d2f15bc3a5ec0fa6a7c8f3333386...1ee4b4ef70e26c540d028cc497313000e63cd7dc,1,12,5,17,5,2010-01-30 23:53:54,2010-01-30 22:30:43
1ee4b4ef70e26c540d028cc497313000e63cd7dc...aa14013abf27637dc2a2c0bee56fb98a981ee08d,1,7,1,8,3,2010-01-30 23:53:55,2010-01-30 22:30:44
dbc1b1f71052c084a84b5c395e1cb4b5ae526fcb...752c0c24926aacbceca0d27de6ad22cbb7dd0709,6,151,0,151,9,2009-10-20 05:31:00,2009-10-19 12:38:32
dbc1b1f71052c084a84b5c395e1cb4b5ae526fcb...6741aa6c399dec3d8f0b25699a73b8fcf974d702,4,32,6,38,7,2009-10-08 04:46:41,2009-10-07 06:13:23
6741aa6c399dec3d8f0b25699a73b8fcf974d702...7725cb5e8bfd27887ee0b984b83708eff655ec9e,1,1,1,2,1,2009-10-19 07:49:09,2009-10-16 06:32:33
6962b6b02c93c35163c25e07201f6219e5558f45...0a85441cdb0298e56487d43e037a8de18a71d24b,1,0,675,675,1,2012-12-27 16:42:33,2012-12-27 14:15:52
1b0b962d771fb734cbf273f216b487bb58dec7b9...3017ed62f47ce14a959e2d315c434d4980cf4243,1,22,15,37,16,2010-12-15 19:16:31,2010-12-14 23:34:01
3017ed62f47ce14a959e2d315c434d4980cf4243...88fcc52e4468d5dfef4f50d2bdee4b168a855368,3,22,2,24,3,2010-12-15 19:19:11,2010-12-15 19:19:11
c008c0ff2087da7b98adfa760247776619b32224...7a0e4d7c39083e951625e4c3434d05abfea8f5e6,1,0,13,13,1,2010-07-16 19:08:27,2010-07-16 19:08:24
878bd809d7c879f1a9ea00bdb4cb97d846ef4e93...c30e742c4981585061ed52c14abd9ebd32a0e18b,2,20,1,21,2,2010-07-07 18:16:32,2010-07-07 17:36:19
78e0dbe772bd365177587aa247c2db20b36d7370...785c58e5c7b7eaade64621a1ad5090da080c1788,1,27,27,54,7,2009-11-16 08:07:48,2009-11-16 08:07:48
d7a0129b3cf40e4f001295a22e2e9f8f6cbc14a4...8a042478967679b0dab3137f5f18367a0ffdc48a,1,5,14,19,3,2011-11-09 00:42:33,2011-11-09 00:42:33
f012d27ff3e37d0412bba34ca53a2d444fd3c563...d6f8fd0b3eeb4349493209740742d67616e0263c,1,7,1,8,2,2010-01-07 23:47:32,2010-01-07 23:47:32
234b3dae2fe83ae7df2c82194cd5f5eb01fd166d...1d621fea180e2612facb190b758bf03dc79e4423,1,2,1,3,1,2010-01-14 08:27:56,2010-01-14 05:54:40
1d621fea180e2612facb190b758bf03dc79e4423...50438340bcadd790956b5081b8a16cba28156e22,1,0,1,1,1,2010-01-14 08:27:56,2010-01-14 05:54:41
50438340bcadd790956b5081b8a16cba28156e22...aa7eaff8b1514ef1241c2f5867670b495b33c455,1,1,2,3,1,2010-01-14 08:27:56,2010-01-14 05:54:42
aa7eaff8b1514ef1241c2f5867670b495b33c455...699f13ca9af6b045826b8d44c2f3870affd7823d,1,1,1,2,1,2010-01-14 08:27:56,2010-01-14 05:54:43
699f13ca9af6b045826b8d44c2f3870affd7823d...bdb011ade4db4a50cde13b5ec870c3dccff7e093,1,4,4,8,3,2010-01-14 08:27:56,2010-01-14 05:54:44
bdb011ade4db4a50cde13b5ec870c3dccff7e093...80883bb30a9c0c41f3b4975874f8f5e527396543,1,34,7,41,7,2010-01-14 08:27:56,2010-01-14 05:54:45
80883bb30a9c0c41f3b4975874f8f5e527396543...0aac0de4feb569ed17d501f04f17ecb8801dbad9,1,11,6,17,5,2010-01-14 08:27:56,2010-01-14 05:54:46
0aac0de4feb569ed17d501f04f17ecb8801dbad9...a4049ae7ac97cb8887e9cd499c4dd0fed0eb968d,1,12,4,16,5,2010-01-14 08:27:56,2010-01-14 05:54:47
a4049ae7ac97cb8887e9cd499c4dd0fed0eb968d...959c0d06eafd7723517c953e80ee1a60881c373b,2,12,3,15,8,2010-01-14 08:27:56,2010-01-14 05:54:48
959c0d06eafd7723517c953e80ee1a60881c373b...5065ed296abc1c0b66ad7c5e963e048cb90b6ee6,2,3,3,6,3,2010-01-14 08:27:56,2010-01-14 05:54:49
5065ed296abc1c0b66ad7c5e963e048cb90b6ee6...f99e269c44a7f07699a92c7e31d31ed93dafb409,1,3,8,11,2,2010-01-14 08:27:56,2010-01-14 05:54:50
f99e269c44a7f07699a92c7e31d31ed93dafb409...ee0a4afbe2baeec2bfdf3d8e7abc77f24294298d,1,10,5,15,6,2010-01-14 08:27:56,2010-01-14 05:54:51
ee0a4afbe2baeec2bfdf3d8e7abc77f24294298d...5c5d059a0d8d2b0341077f7468dd480352775e1c,1,2,2,4,3,2010-01-14 08:27:56,2010-01-14 05:54:52
5c5d059a0d8d2b0341077f7468dd480352775e1c...7756ecffe7d914fdbb42629a408d6da78b9794c1,1,15,12,27,4,2010-01-14 08:27:56,2010-01-14 05:54:53
7756ecffe7d914fdbb42629a408d6da78b9794c1...bde1a68624c59d891ec02fda473c3aef98ec9358,1,20,15,35,9,2010-01-14 08:27:56,2010-01-14 05:54:54
bde1a68624c59d891ec02fda473c3aef98ec9358...a25eb13909088f04f87acec26c522cc555f6b4a9,2,57,31,88,12,2010-01-14 08:27:57,2010-01-14 05:54:55
a25eb13909088f04f87acec26c522cc555f6b4a9...6c4c44c45881260877d7d9fd113fd75b74d7777c,1,26,25,51,10,2010-01-14 08:27:57,2010-01-14 05:54:56
6c4c44c45881260877d7d9fd113fd75b74d7777c...6bdcd0d2fcca7c3985a078c8d343a863136fb675,2,63,39,102,8,2010-01-14 08:27:57,2010-01-14 05:54:57
9a424b276c409a3510e7735b6ecc012f50dc2a49...e9e4c8b7473f6ee21f452c66430a0763681243d7,1,5,1,6,2,2009-12-08 04:25:40,2009-11-29 07:20:21
e9e4c8b7473f6ee21f452c66430a0763681243d7...33f2a3108eeacbd937021470aa6e67c01ceec960,1,2,1,3,1,2009-12-08 04:47:08,2009-12-08 03:28:32
33f2a3108eeacbd937021470aa6e67c01ceec960...f9ad77a739c0d012ee58b64eda2d7ec0d4e1df9d,2,11,1,12,3,2009-12-08 04:49:44,2009-12-08 04:49:38
9a424b276c409a3510e7735b6ecc012f50dc2a49...009fee4774d4fa607cd97519d1044e426ed423b8,4,198,7,205,7,2009-12-07 21:35:06,2009-12-07 10:10:50
e33fd3c326831e70f6ca078e0f1c26ec147cb5b3...d07430f98cfd6fae3f5ee91c2fa314f1cacf6f33,1,16,1,17,5,2010-01-19 02:16:50,2010-01-19 02:16:50
a9d7c9552e471b862f73951b2f2e5945f0f051b4...f29cd3938dbe9300dd75096d8ee2ad6311cc00af,3,15,3,18,5,2009-10-20 19:11:39,2009-10-20 18:46:55
00d3947366a50a06da40989a1fd1e3f99885a4c3...0e82bd043019c9cdda254405c49b3d5fc2d00c55,1,3,0,3,1,2013-01-09 22:08:59,2013-01-09 20:16:45
00d3947366a50a06da40989a1fd1e3f99885a4c3...02edd56b84f00c1a88c5602f5608033d4bc1cbff,1,57,0,57,6,2009-10-23 06:33:48,2009-10-17 21:04:19
02edd56b84f00c1a88c5602f5608033d4bc1cbff...32ca42491246eb00d226826039fff18d58b57081,1,1,1,2,1,2009-11-09 00:51:33,2009-11-08 01:04:21
050dfc4535578c2c49832ffeb3f05dbd4c6adff2...b142da2a5dec8f868a61322e2ab591e9a008ec3b,4,23,2,25,4,2009-10-17 06:57:19,2009-10-17 06:56:55
452e2256d2d7cb5494ca10fcbbb6bdf29570f2c0...e133d65c3e3d7f5f869edb2d6205af68af0fe38f,2,39,5,44,6,2009-10-20 07:08:16,2009-10-16 04:14:59
583371af1f88e9cd48fedbb6bbb147d8091fd591...b3118bdc91876cbc04b7e81dcf7bea71d86ce4f8,2,13,0,13,3,2009-10-14 20:39:37,2009-10-14 14:23:51
de1a2fdd38b138c4e4fed6412783dcb74d63d2da...1e41827d2d5cf0e4c6ebff91958fa47d69b7ff42,1,1,0,1,1,2011-04-26 17:44:33,2011-04-26 15:04:49
de1a2fdd38b138c4e4fed6412783dcb74d63d2da...249b2004d8c9c58ed1ea1665dfd376af0312ed7e,3,160,22,182,27,2009-11-05 01:58:15,2009-10-31 00:47:42
5c30b8f7dd2640a1b75fcbcdd3e175329c5b7bbe...1456b043fc0f0a395c35d6b5e55b0dad1b6e7acc,4,2,172,174,9,2009-12-10 20:21:40,2009-12-10 20:17:11
1456b043fc0f0a395c35d6b5e55b0dad1b6e7acc...782a0005fcb26bb7ef27f720fd139ae40a6f434b,1,10,6,16,2,2009-12-10 23:29:05,2009-12-10 23:27:51
782a0005fcb26bb7ef27f720fd139ae40a6f434b...9861b644e045b5ee0e16dea65b44419205090960,4,27,3,30,5,2009-12-10 23:42:30,2009-12-10 23:42:30
44148f2daf6e1ac3fe087dd07da2930411b3bcf2...73eb40eeaaebc5ebae283c06286b96b4aea00143,4,34,10,44,14,2009-11-30 07:11:46,2008-06-20 07:17:27
73eb40eeaaebc5ebae283c06286b96b4aea00143...8cc5b29065e19267cbc08b39c34674b02c2e3d59,11,162,26,188,34,2010-01-18 06:45:06,2009-11-26 02:23:55
8cc5b29065e19267cbc08b39c34674b02c2e3d59...ee2c79552acceaa59a78518c6c084bd515606374,2,23,2,25,5,2010-01-18 06:45:17,2009-11-26 02:23:57
ee2c79552acceaa59a78518c6c084bd515606374...14e5d40ca4f4f118fe03cbe5302309170b46096d,1,14,7,21,3,2010-01-18 06:46:27,2010-01-18 06:31:38
14e5d40ca4f4f118fe03cbe5302309170b46096d...85e51b783c3a92b42275442147e7a27e17d42276,6,91,18,109,13,2010-01-18 06:46:28,2008-07-01 05:18:57
85e51b783c3a92b42275442147e7a27e17d42276...e3cba962b172804ca1cab82801d94858154bd8cc,1,46,1,47,4,2010-01-18 06:46:28,2009-11-26 02:23:59
e3cba962b172804ca1cab82801d94858154bd8cc...566c511195adc0ce88559853f2f00933e241d862,2,33,1,34,4,2010-01-18 06:46:28,2008-07-18 09:43:00
dda8f4bf2b159d6f8e6d816e35418708cc6f21a1...adf9628ea41bd226dc5ab38daa0bc661097a2127,1,44,0,44,1,2009-12-03 22:07:32,2009-12-03 22:07:32
c6b53c8684966b3e22d0f26dc981a8b4a0b03ce7...080cbc1275ac09445136ba429d90b5ec85e92c1c,4,67,3,70,5,2009-11-16 08:05:12,2009-11-16 08:05:12
b26f39cd9739ea1b4149c7ff79469d953440c913...c1d45cf7b0c1953eed72a3018b5e557dbcd538e0,2,8,5,13,5,2009-11-04 05:39:28,2009-11-04 02:38:51
c1d45cf7b0c1953eed72a3018b5e557dbcd538e0...a45d3d7effdfb4b6b9fe75c9206a79d3cdcb3922,1,4,1,5,3,2009-11-04 05:41:01,2009-11-04 02:52:35
a45d3d7effdfb4b6b9fe75c9206a79d3cdcb3922...0a565de4a50032339d3786d366e70912a4dcf572,1,1,1,2,1,2009-11-05 00:08:55,2009-11-04 21:57:46
8db355964d89c19eb262ffe38e57e5a610e1cc05...4f2e842dd0046a12bd82bb2b5aa066c686dc3f44,2,18,6,24,3,2009-12-31 20:23:41,2009-12-31 09:43:17
3bb18e58fc4f5eddd97bc34fc11dc207b47cc093...63d564b300274ec71a274f9b672366d07ae5620a,1,10,8,18,5,2009-11-20 22:50:43,2009-11-20 10:00:40
63d564b300274ec71a274f9b672366d07ae5620a...8b3dce565084c89ceb19f7ccf0fe22ffd365f7fd,7,20,22,42,14,2009-11-20 23:10:29,2009-11-03 14:59:18
8b3dce565084c89ceb19f7ccf0fe22ffd365f7fd...5486ef0e6d159a8971742fd2464b9656f5457fda,1,6,3,9,4,2009-11-20 23:10:47,2009-11-20 10:33:28
5486ef0e6d159a8971742fd2464b9656f5457fda...60da8b15c1b77706e0701cccef2d534a1c3825ad,2,71,5,76,9,2009-11-20 23:10:47,2009-11-20 10:50:21
60da8b15c1b77706e0701cccef2d534a1c3825ad...d21fc9342cd82bb48bfbf9f54024ae2d4e16a9a3,1,61,0,61,1,2009-11-23 08:49:47,2009-11-23 08:49:47
5f809ff50921bee44bbf88c49056e7d145c0c35f...c8a58ac5a52b0850fbca87898d1c6aa44cf5626f,1,1,0,1,1,2009-10-31 18:16:50,2009-10-31 18:16:50
dca93d2b017184077104cf40566a7518fcf41ecb...e4f59a32de3f90ff5aabc09b9da6bd5818c5076b,3,54,2,56,8,2013-01-14 16:04:50,2013-01-14 16:04:50
0895c6d4c09045a3faeb7b652a844fc81c774631...6562928ae9ea46a3f2a7bd5a3dd500a7c149cc64,1,2,2,4,1,2013-09-26 20:52:16,2013-09-26 20:02:48
def98035d00c57bb8723e7859366536504eb56aa...7af4fc9cf3e3538a9bfb8b14feeacdeb7f6db7d5,1,1,1,2,1,2011-06-22 23:13:16,2011-06-22 23:13:16
d79bcd68056250d7c03bf9b12728ee2fd85a0ab3...66c8448543432308e8fce5e3e04076e875410f67,3,23,31,54,15,2011-07-20 18:38:34,2011-07-18 07:48:51
66c8448543432308e8fce5e3e04076e875410f67...5232586c7985e6a420ee741e19e7fd6d040d43f6,2,53,8,61,5,2011-07-20 18:38:34,2011-07-18 07:49:12
5232586c7985e6a420ee741e19e7fd6d040d43f6...28d0c1017a10a93ce165a2d4e9fb6a691a933bd3,1,1,1,2,1,2011-07-20 18:38:35,2011-07-18 07:49:56
28d0c1017a10a93ce165a2d4e9fb6a691a933bd3...8d677edc4fa3fd1fe12b49bf279aaad5be89b81c,1,11,6,17,3,2011-07-20 18:38:35,2011-07-18 07:50:14
8d677edc4fa3fd1fe12b49bf279aaad5be89b81c...070b4dd5899927cb399b8ae9d75cad1fce537429,2,37,10,47,11,2011-10-16 04:18:20,2011-10-14 07:40:39
070b4dd5899927cb399b8ae9d75cad1fce537429...deba49377b717d1e26c342f65c7f5e75a2db8641,5,8,16,24,8,2011-10-16 04:18:36,2011-10-14 07:40:40
d79bcd68056250d7c03bf9b12728ee2fd85a0ab3...bc5f813af6ab6802662ba4992ccbc78171c38906,1,29,1,30,4,2011-07-20 18:07:17,2011-07-19 22:55:47
e7a85be3cfc4ee017f59f1d1f8ceb63d7c88c9c8...abc06822af57347d35c0cd64b67e1faeb5b65c71,7,78,54,132,18,2011-08-16 18:04:31,2011-08-15 21:17:46
abc06822af57347d35c0cd64b67e1faeb5b65c71...501770e1bb5d132ae4f79aa96715f07f6b84e1f6,3,149,7,156,8,2011-08-23 04:03:38,2011-08-15 21:17:47
e7a85be3cfc4ee017f59f1d1f8ceb63d7c88c9c8...0e8341f29d6541f661cc52f27f96877c0fd469c2,2,26,3,29,4,2011-08-11 20:01:18,2011-08-08 02:49:04
e7a85be3cfc4ee017f59f1d1f8ceb63d7c88c9c8...3da5c54340d67b935b2ad75cc7d162c1e571a644,1,19,0,19,4,2011-08-08 19:02:16,2011-08-07 11:58:13
3da5c54340d67b935b2ad75cc7d162c1e571a644...de88c1ceda8ded0722faaa6ddcc2375957ef8732,1,14,17,31,12,2011-08-08 19:04:21,2011-08-07 11:58:14
de88c1ceda8ded0722faaa6ddcc2375957ef8732...c2b1a95c468d742e61fcb7c6e1592f7f5be60ea6,1,2,5,7,2,2011-08-08 19:04:42,2011-08-07 11:58:15
c2b1a95c468d742e61fcb7c6e1592f7f5be60ea6...6fdd50e95cff54d3fb0ed40cf69e13461aaf64a1,1,3,6,9,2,2011-08-08 19:05:22,2011-08-07 11:58:16
6fdd50e95cff54d3fb0ed40cf69e13461aaf64a1...6ff875c52ae48b8fe6a350df110e33aa2ba8afbc,1,6,12,18,6,2011-08-08 19:05:27,2011-08-07 11:58:17
ea1ab4b280ed3b041da53e161e32e38930569f3e...114a6a889f5d21c26800c395a97cdd400073a9e8,4,20,6,26,7,2011-05-20 03:01:10,2011-05-19 21:33:17
114a6a889f5d21c26800c395a97cdd400073a9e8...902bb3645160cae72fe43b5f7f5289968ac01617,4,78,55,133,21,2011-05-20 03:02:10,2011-05-19 21:34:33
902bb3645160cae72fe43b5f7f5289968ac01617...cff38a5e11217dc997c1ffae8d0856023e05554a,3,35,3,38,6,2011-05-20 03:02:31,2011-05-19 21:34:46
ea1ab4b280ed3b041da53e161e32e38930569f3e...ea5f2208217a332dd02f62f3880052eaf8b1a57b,1,4,2,6,1,2011-05-20 01:41:44,2011-05-19 20:48:51
ea1ab4b280ed3b041da53e161e32e38930569f3e...36268b762c4aa6a0d4831f69852b20ab545aff4d,1,511,0,511,1,2011-05-20 01:23:17,2011-05-19 15:14:25
36268b762c4aa6a0d4831f69852b20ab545aff4d...3d5ae435275e60be3ebd7302c1d2cf8ed6f0b8ad,2,3,2,5,3,2011-05-20 03:30:44,2011-05-20 03:30:44
ea1ab4b280ed3b041da53e161e32e38930569f3e...b5cc003253c8e1b505d5a2fbbcecb1ffcb409758,1,19,0,19,3,2011-05-18 03:44:17,2011-05-17 15:19:08
5cfe4256d98af22a570c78c5e3048391a90f5f98...a02cf90144293f4d7885be7f1d10240576aa161b,1,4,0,4,1,2011-05-26 16:25:47,2011-05-26 16:25:47
026680f881e751311674d97d0f6ed87f06a92bfb...b2c2e4c22c6a4fe151f02380d247cf3d9a9d5d1e,1,6,1,7,1,2010-01-25 01:48:08,2010-01-24 18:05:23
026680f881e751311674d97d0f6ed87f06a92bfb...9bc454df08ca2a27b51ac0ab9ff8f154e51b8698,1,24,5,29,7,2010-01-25 01:46:41,2010-01-19 04:25:57
9bc454df08ca2a27b51ac0ab9ff8f154e51b8698...ffbc5dc2d0cbdbd63a4ae04dc2cc1ebf385fcc25,2,126,1,127,16,2010-01-25 01:46:41,2010-01-19 04:25:58
ffbc5dc2d0cbdbd63a4ae04dc2cc1ebf385fcc25...7349df1142a8dba579c015b51805cc290fcb4e6e,1,48,1,49,12,2010-03-07 04:05:18,2010-03-05 20:25:36
7349df1142a8dba579c015b51805cc290fcb4e6e...ab892a19e83edd1cf9a767bc09d3239f72469d05,2,18,9,27,9,2010-03-07 04:06:50,2010-01-19 04:26:00
ab892a19e83edd1cf9a767bc09d3239f72469d05...812d2a3d61b1bbb1931aff2ed6d2a17e939f5bf2,4,28,22,50,11,2010-03-07 04:06:50,2010-01-19 04:26:01
812d2a3d61b1bbb1931aff2ed6d2a17e939f5bf2...eaf436c09c09a28804697c89f3ff9a7e1ad2361c,1,6,3,9,1,2010-03-09 02:16:05,2010-03-09 01:51:16
fcf04eef75d55eb404e524dd46aa7330d2608746...5135fefaa17b494e4cd3a0f36361cddc8ad445ba,1,20,0,20,2,2015-03-05 20:48:18,2015-03-05 20:48:18
f18604bbf2c391c689a41fca14cbaeff5e106255...93f7d9108a0edf808e1e3bbcdbe6078310c22f9e,3,28,25,53,4,2015-02-26 22:09:20,2015-02-26 03:04:16
15598cf41beed0d86cd2ac443e0f69c5a3b40321...f471494303c2d2a085f384eac705379ef2423590,2,15,5,20,15,2015-02-16 21:26:51,2015-01-31 02:40:17
15598cf41beed0d86cd2ac443e0f69c5a3b40321...3af67924e03ddb29a2b698266a9f27ef30cd663b,1,2,2,4,2,2015-02-04 02:30:24,2015-01-30 09:52:34
15598cf41beed0d86cd2ac443e0f69c5a3b40321...7471cf88f54990831fe2fd84160350fe432a7b76,1,5,5,10,5,2015-01-30 22:02:34,2015-01-30 22:02:34
8023a422107ca5075eb285f7a9358778db66c616...0ce986446163b37c7f663ce7a408e7f94c31ba63,1,52,0,52,2,2012-09-07 18:25:22,2012-09-07 18:25:22
e47a8583a20256851e7fc882233e3bd5bf33dc6e...a15d069a19867b9c508ccfca5702f36448e829e8,1,22,0,22,2,2013-10-14 14:03:59,2013-10-12 22:29:40
a15d069a19867b9c508ccfca5702f36448e829e8...47ce115370cba8ebfced696f9997e718c465435d,1,20,4,24,3,2013-10-16 18:26:09,2013-10-15 00:06:14
4909bbe40af6dd12bc4aeb6b9e449a9e29641a26...8b0e15fa95e11965f18c8d2585dc8ffd9bfc9356,1,44,6,50,9,2011-10-10 23:14:59,2011-10-10 23:14:59
8d714b11df2b65e5f4272c1616e561930010be90...703f05ad5835cff92b12c29aecf8d724c8c847e2,3,6,10,16,3,2011-09-30 21:20:57,2011-09-30 21:20:57
8d714b11df2b65e5f4272c1616e561930010be90...b04ba2bb42957f63567f530e092385f085b25e63,3,21,9,30,9,2011-09-28 00:00:04,2011-09-27 23:56:49
41d5b7e362c33dc54cbc814e50403a2084204f9f...7fc9d1526ed6d55deb1a69b8ed78830e04689dc4,1,1,1,2,1,2009-11-28 18:09:56,2009-11-28 11:41:28
7fc9d1526ed6d55deb1a69b8ed78830e04689dc4...66abce05dd5b9da9c889034781dc3de38b6e231b,1,100,33,133,5,2009-11-28 19:13:59,2009-11-28 19:13:59
41d5b7e362c33dc54cbc814e50403a2084204f9f...ad75ebe5b3f10e77f1150d2d8111e6a60cb9039a,2,23,2,25,9,2009-11-28 06:46:05,2009-11-27 15:42:26
ad75ebe5b3f10e77f1150d2d8111e6a60cb9039a...b8ac923010484908d8426cb8ded5ad7e8c21a7f6,2,29,0,29,6,2009-11-28 06:46:33,2009-11-27 15:43:08
b8ac923010484908d8426cb8ded5ad7e8c21a7f6...6c81a9908206799ccbc9a17bde17f1d766a8eef4,1,30,0,30,5,2009-12-01 22:15:27,2009-12-01 10:33:39
6c81a9908206799ccbc9a17bde17f1d766a8eef4...525ecd26c6cc8d1dc0c6190d8266e5d30b06da51,2,1,23,24,5,2009-12-29 20:07:58,2009-12-28 18:04:24
3503e9ab32c7a478d0d985171c50a901a2695162...e70d1632bdaf25a9ee528e78133cab319083eade,1,26,0,26,4,2012-09-12 21:12:48,2012-09-12 21:10:54
3fc0e4ca00330ce1dfd92baeda04f0aa2fbd7e68...70b67b0792375c59f60f3e24f2d6757b24dc719c,1,30,3,33,2,2012-09-06 17:40:09,2012-09-06 16:36:53
e99d012a6bc8b8647a0389d486b5489557364ea6...279791445b9629d1fc9675cf421e081975ecf4b9,1,2,2,4,1,2013-01-02 00:44:57,2013-01-01 21:42:03
889d35899ba64640e47798681ecb34a4be043bad...5062f9e1b5072adad3b40f1f9f29338f8fdd301d,1,8,6,14,5,2013-01-06 20:57:56,2013-01-06 15:35:05
889d35899ba64640e47798681ecb34a4be043bad...962c38eedd931a608b5e675f12a21569d9f4d39f,2,7,1,8,2,2012-11-16 02:12:17,2012-11-15 18:10:01
889d35899ba64640e47798681ecb34a4be043bad...866f5f82b9fdedb0304708f9b78db1409fecd046,1,5,1,6,3,2012-10-07 23:15:19,2012-10-07 03:13:54
889d35899ba64640e47798681ecb34a4be043bad...4cde519fe666af478be4b86659c518949a853f91,1,16,16,32,2,2012-09-25 17:17:29,2012-09-22 04:55:10
889d35899ba64640e47798681ecb34a4be043bad...a427ef7acc9d932d1c203dd2fae67f51c4b1d1e8,4,64,28,92,7,2012-09-25 16:04:39,2012-09-25 07:48:11
889d35899ba64640e47798681ecb34a4be043bad...e90d065e64702d09fbdfc7cfd1c97456c7faa74c,7,66,1,67,7,2012-09-17 04:54:47,2012-09-16 03:54:15
889d35899ba64640e47798681ecb34a4be043bad...218adaaaa064c436115dbcd5705a0e2c42e90a25,1,4,6,10,4,2012-09-14 16:52:16,2012-09-13 14:16:26
889d35899ba64640e47798681ecb34a4be043bad...4fa7e1989f411b2c507ace390e84ecf3d1eeb424,1,1,1,2,1,2012-08-27 16:26:29,2012-08-27 05:36:49
4fa7e1989f411b2c507ace390e84ecf3d1eeb424...2878568847d5c437f964dec301370c71758e13cc,1,1,1,2,1,2012-08-27 16:26:29,2012-08-27 05:36:50
2878568847d5c437f964dec301370c71758e13cc...b354f11b595bb2bca4bae96b06778b3a9882b621,4,8,8,16,8,2012-08-27 16:26:30,2012-08-27 05:36:51
b354f11b595bb2bca4bae96b06778b3a9882b621...76638d90e88374f8b1396e4fce75a424260ba6da,3,6,6,12,6,2012-08-27 16:26:30,2012-08-27 05:36:52
76638d90e88374f8b1396e4fce75a424260ba6da...9aa98efca286f7e7795a30614d79f120d0cd786c,2,4,4,8,3,2012-08-27 16:26:30,2012-08-27 05:36:53
9aa98efca286f7e7795a30614d79f120d0cd786c...f7dc6a96435e050afbbdbdeffac481fea7ddb8af,1,17,11,28,10,2012-08-27 16:26:30,2012-08-27 05:36:54
f7dc6a96435e050afbbdbdeffac481fea7ddb8af...9a0013819ea541cfa1102292d1fdceb30352c2c3,11,46,22,68,22,2012-08-27 16:26:30,2012-08-27 05:36:55
889d35899ba64640e47798681ecb34a4be043bad...0e7afb18cb354c0860f5db33996ddaf58c2af49d,3,470,0,470,3,2012-08-24 18:18:31,2012-08-23 16:57:45
889d35899ba64640e47798681ecb34a4be043bad...6183d826ba62ec94ccfcb8f6e3b8d43e3e338703,3,37,3,40,9,2012-08-23 21:18:02,2012-08-20 13:47:38
6183d826ba62ec94ccfcb8f6e3b8d43e3e338703...b84869ef14081b298a4ab825219221ccfcb2a3ba,3,45,3,48,8,2012-08-30 19:07:28,2012-08-30 17:23:12
b84869ef14081b298a4ab825219221ccfcb2a3ba...b347d06bf097aca5effd07871adf4d0c8a7c55bd,2,60,0,60,4,2012-08-30 19:07:39,2012-08-30 17:23:13
889d35899ba64640e47798681ecb34a4be043bad...ba8bd8300a544959159f6bd3a7e03ac54f85ea3a,4,18,7,25,8,2012-08-21 21:46:11,2012-08-21 06:10:59
ba8bd8300a544959159f6bd3a7e03ac54f85ea3a...6966073102170171da4c25a4038bbd143fa6a75b,1,4,2,6,3,2012-08-21 21:46:47,2012-08-21 06:26:07
6966073102170171da4c25a4038bbd143fa6a75b...11e50b2736f374f1608e0c5690405be1a74aa16d,1,4,1,5,2,2012-08-21 21:47:07,2012-08-21 06:31:52
11e50b2736f374f1608e0c5690405be1a74aa16d...55b38a48e2a7ccfaaa7897a5fccb98327fa0e3c0,4,11,3,14,5,2012-08-21 21:52:07,2012-08-21 21:52:07
889d35899ba64640e47798681ecb34a4be043bad...a054e049121dcf51b33082e7828abc0b598fef42,1,1,1,2,1,2012-08-20 19:23:14,2012-08-20 12:31:50
a054e049121dcf51b33082e7828abc0b598fef42...0012a3873b5df4476b5b9142d0b5748a101c1ba8,2,25,25,50,7,2012-08-20 19:23:15,2012-08-20 12:31:51
0012a3873b5df4476b5b9142d0b5748a101c1ba8...9e7bbe2d6bcb8cfd2b56a0713ee361b2cc5a138e,1,3,3,6,3,2012-08-20 19:23:15,2012-08-20 12:31:53
9e7bbe2d6bcb8cfd2b56a0713ee361b2cc5a138e...1b56024c7a12d685f85a29badca1cb02241251ab,1,13,13,26,3,2012-08-20 19:23:15,2012-08-20 12:31:52
1b56024c7a12d685f85a29badca1cb02241251ab...efd2a8bd38acc2b764b7eaad97693297feb87781,1,23,23,46,3,2012-08-20 19:23:15,2012-08-20 12:31:54
efd2a8bd38acc2b764b7eaad97693297feb87781...24a85214596c58e95cffb9db621dadc9a78305ff,1,28,28,56,13,2012-08-20 19:23:15,2012-08-20 12:31:55
24a85214596c58e95cffb9db621dadc9a78305ff...d68faec7c07977370623761c9826ac6276a36a36,1,10,10,20,6,2012-08-20 19:23:15,2012-08-20 12:31:56
d68faec7c07977370623761c9826ac6276a36a36...5a72beb791c377d314e251f3f14e1c2eea6f68fa,1,6,6,12,3,2012-08-20 19:23:15,2012-08-20 12:31:57
5a72beb791c377d314e251f3f14e1c2eea6f68fa...0ed217188d1fa75c6c10715d45de20ba276ef96c,1,12,12,24,9,2012-08-20 19:23:15,2012-08-20 12:31:58
0ed217188d1fa75c6c10715d45de20ba276ef96c...e05a10937cd7e7ac627a400053e134f91d91161c,1,20,20,40,6,2012-08-20 19:23:15,2012-08-20 12:31:59
e05a10937cd7e7ac627a400053e134f91d91161c...986d1bb87716d195d6e7e17e5d3233807e4d42ab,1,2,2,4,2,2012-08-20 19:23:16,2012-08-20 12:32:00
986d1bb87716d195d6e7e17e5d3233807e4d42ab...145f9c81aa2e653f461d424d2dd2c9696df88a5a,1,9,9,18,4,2012-08-20 19:23:16,2012-08-20 12:32:01
145f9c81aa2e653f461d424d2dd2c9696df88a5a...32b77add95ae8df149abd4a2f9524946d6807ca6,1,28,28,56,11,2012-08-20 19:23:16,2012-08-20 12:32:02
32b77add95ae8df149abd4a2f9524946d6807ca6...997f44d0dc66a8caf8d31f89172b67012450c9f8,1,8,8,16,2,2012-08-20 19:23:16,2012-08-20 12:32:03
997f44d0dc66a8caf8d31f89172b67012450c9f8...9c23f4c537fc81b03549a5e9b7a4c0332802ff8f,1,39,39,78,9,2012-08-20 19:23:16,2012-08-20 12:32:04
9c23f4c537fc81b03549a5e9b7a4c0332802ff8f...7adaddc21aef1122af523df5e39ca48748935d8e,1,2,2,4,2,2012-08-20 19:23:16,2012-08-20 12:32:06
7adaddc21aef1122af523df5e39ca48748935d8e...1bd31ce6912f55f94777fee244c907378bb0b5f6,1,28,28,56,2,2012-08-20 19:23:16,2012-08-20 12:32:05
1bd31ce6912f55f94777fee244c907378bb0b5f6...bfb0737d9663f420e7788977c64f8dfede7824bf,1,14,14,28,5,2012-08-20 19:23:16,2012-08-20 12:32:07
bfb0737d9663f420e7788977c64f8dfede7824bf...3b787b9678405688e609fb8318e47279eb20ef31,1,14,14,28,7,2012-08-20 19:23:16,2012-08-20 12:32:08
3b787b9678405688e609fb8318e47279eb20ef31...719acedba43ac36af5b7321b39f4778affcc511c,1,24,24,48,10,2012-08-20 19:23:16,2012-08-20 12:32:09
719acedba43ac36af5b7321b39f4778affcc511c...93eced6c1b0d28ac7cc8a6003d1673573b412031,1,8,8,16,4,2012-08-20 19:23:17,2012-08-20 12:32:10
93eced6c1b0d28ac7cc8a6003d1673573b412031...18913521e279aaa7dcc757bd801c830d0ba7a0c7,1,9,9,18,6,2012-08-20 19:23:17,2012-08-20 12:32:11
18913521e279aaa7dcc757bd801c830d0ba7a0c7...61007a5868b2fc7d10c5ee3ed2552b796fb8dce2,1,33,33,66,20,2012-08-20 19:23:17,2012-08-20 12:32:12
61007a5868b2fc7d10c5ee3ed2552b796fb8dce2...cf8fe315e6c74e8fafb688c85237cd2583627317,1,12,12,24,3,2012-08-20 19:23:17,2012-08-20 12:32:13
cf8fe315e6c74e8fafb688c85237cd2583627317...6705c1629c144f8938b22618084b6d372805666d,1,6,6,12,3,2012-08-20 19:23:17,2012-08-20 12:32:14
6705c1629c144f8938b22618084b6d372805666d...4b407bc50632a02523df550dd48e71d03e6e9dbd,1,45,45,90,35,2012-08-20 19:23:17,2012-08-20 12:32:15
4b407bc50632a02523df550dd48e71d03e6e9dbd...483bbf41ca5beb7e38b3b01f21149c56a1154b7a,1,8,8,16,2,2012-08-20 19:23:17,2012-08-20 12:32:16
483bbf41ca5beb7e38b3b01f21149c56a1154b7a...68918696cce2db815a1b07f60d11f3c99e121b1f,1,5,5,10,3,2012-08-20 19:23:17,2012-08-20 12:32:17
68918696cce2db815a1b07f60d11f3c99e121b1f...ce4a5e53d5a937106e9c65f7e968021154b0cf59,1,9,9,18,5,2012-08-20 19:23:17,2012-08-20 12:32:18
ce4a5e53d5a937106e9c65f7e968021154b0cf59...e62cd35a3e8f5baf42f5cd972ff3b9f9834269c7,1,5,5,10,2,2012-08-20 19:23:17,2012-08-20 12:32:19
e62cd35a3e8f5baf42f5cd972ff3b9f9834269c7...377adc3aaf0dfc09277cbe4235013a227352e6d1,1,27,27,54,21,2012-08-20 19:23:18,2012-08-20 12:32:20
377adc3aaf0dfc09277cbe4235013a227352e6d1...373f9221749d71f44214c940ebecda6bb83bc6a0,1,11,11,22,9,2012-08-20 19:23:18,2012-08-20 12:32:21
373f9221749d71f44214c940ebecda6bb83bc6a0...f037dbf49c6c8ef66d7efda30dde01e2cafb57ff,1,6,6,12,2,2012-08-20 19:23:18,2012-08-20 12:32:22
f037dbf49c6c8ef66d7efda30dde01e2cafb57ff...c7d93da38e0c4f6bee1e14c32827e33cdbfb4524,1,10,10,20,5,2012-08-20 19:23:18,2012-08-20 12:32:23
c7d93da38e0c4f6bee1e14c32827e33cdbfb4524...962e629567464733dd43c60b6449a0ac26fc5c7a,1,24,24,48,10,2012-08-20 19:23:18,2012-08-20 12:32:24
962e629567464733dd43c60b6449a0ac26fc5c7a...a6312810227d91e3e7a474b5ee9282b011478ca9,1,4,4,8,2,2012-08-20 19:23:18,2012-08-20 12:32:25
a6312810227d91e3e7a474b5ee9282b011478ca9...6c54dc46aa3e9c7ed655f1586ed8dc6c65cfece5,1,5,5,10,2,2012-08-20 19:23:18,2012-08-20 12:32:26
6c54dc46aa3e9c7ed655f1586ed8dc6c65cfece5...422cad0ab11951fb9dd68cfacf11f92ee72ee4f2,1,11,11,22,4,2012-08-20 19:23:18,2012-08-20 12:32:27
422cad0ab11951fb9dd68cfacf11f92ee72ee4f2...e6b895efdb77f3a1c8e489ff13ed5834bba16736,1,60,60,120,29,2012-08-20 19:23:18,2012-08-20 12:32:28
e6b895efdb77f3a1c8e489ff13ed5834bba16736...4c6881204b39a1065641f2b4f0ebbb77b9c6f3d7,1,32,32,64,27,2012-08-20 19:23:18,2012-08-20 12:32:29
4c6881204b39a1065641f2b4f0ebbb77b9c6f3d7...e08b73535070d42f28614aeea13b168bdcb2c380,1,3,3,6,2,2012-08-20 19:23:19,2012-08-20 12:32:30
e08b73535070d42f28614aeea13b168bdcb2c380...5696d58857a4a5f03cba753860b965bf29fb88db,1,3,3,6,2,2012-08-20 19:23:19,2012-08-20 12:32:31
5696d58857a4a5f03cba753860b965bf29fb88db...8f5b7281b4c0ea173d7f791ef44f2de6e3f65657,1,5,5,10,3,2012-08-20 19:23:19,2012-08-20 12:32:32
8f5b7281b4c0ea173d7f791ef44f2de6e3f65657...78dafaa5cb239e10948198dece9514be5a3dfb89,1,17,17,34,5,2012-08-20 19:23:19,2012-08-20 12:32:33
78dafaa5cb239e10948198dece9514be5a3dfb89...230c6cdb00cddd5f4f1084e6855214da93642219,1,19,19,38,12,2012-08-20 19:23:19,2012-08-20 12:32:34
230c6cdb00cddd5f4f1084e6855214da93642219...fbbae140d3310464387393a8b86da1ad2da44d41,1,42,42,84,23,2012-08-20 19:23:19,2012-08-20 12:32:35
fbbae140d3310464387393a8b86da1ad2da44d41...2477bebb5d2ca50489f81ae28caa44e6f5b54f98,1,6,6,12,2,2012-08-20 19:23:19,2012-08-20 12:32:36
2477bebb5d2ca50489f81ae28caa44e6f5b54f98...f22763161ab29cc0b66807d3d77141c7e442e1da,1,11,11,22,8,2012-08-20 19:23:19,2012-08-20 12:32:37
f22763161ab29cc0b66807d3d77141c7e442e1da...0ff07f24323cd991b40204b8eeb15aa7b80903da,1,2,2,4,2,2012-08-20 19:23:19,2012-08-20 12:32:38
0ff07f24323cd991b40204b8eeb15aa7b80903da...c1e9c2a73dedf79179ee30fd6a552c998d0d4ec7,1,10,10,20,6,2012-08-20 19:23:19,2012-08-20 12:32:39
c1e9c2a73dedf79179ee30fd6a552c998d0d4ec7...2c7c184c3b1e1287df6ba5b39f671c6fbd4c8518,1,9,9,18,4,2012-08-20 19:23:20,2012-08-20 12:32:40
2c7c184c3b1e1287df6ba5b39f671c6fbd4c8518...a3b26dc78d877e7fdbd8c7b8f09e71762723021e,1,18,18,36,6,2012-08-20 19:23:20,2012-08-20 12:32:41
a3b26dc78d877e7fdbd8c7b8f09e71762723021e...72bba2a6bf826091716b75591adc4c91ef032c7b,1,7,7,14,3,2012-08-20 19:23:20,2012-08-20 12:32:42
72bba2a6bf826091716b75591adc4c91ef032c7b...c48bd2c17c3f1ef78caf295e5bea8b4395698723,1,7,7,14,5,2012-08-20 19:23:20,2012-08-20 12:32:43
c48bd2c17c3f1ef78caf295e5bea8b4395698723...d780bef42a1ed0f366a3f4db661c9f806b0ea4f8,1,21,21,42,13,2012-08-22 17:58:28,2012-08-20 12:32:44
d780bef42a1ed0f366a3f4db661c9f806b0ea4f8...c9120b1c9b916047e048aa85987f358626265f0c,1,14,14,28,8,2012-08-22 17:58:28,2012-08-20 12:32:45
c9120b1c9b916047e048aa85987f358626265f0c...b10bf3fa1100ac813c7751af2f490da57e8c4080,1,4,4,8,2,2012-08-22 17:58:28,2012-08-20 12:32:46
b10bf3fa1100ac813c7751af2f490da57e8c4080...c88bba18fbe6b93c4317a3997f1dd3b9442509c4,1,28,28,56,7,2012-08-22 17:58:28,2012-08-20 12:32:47
c88bba18fbe6b93c4317a3997f1dd3b9442509c4...4a4838b46ade09a32958b44c0bb00fe7c708bea4,1,28,28,56,26,2012-08-22 17:58:29,2012-08-20 12:32:48
4a4838b46ade09a32958b44c0bb00fe7c708bea4...82269505b9b0f1e46ba89f3c5e735b3827aa4126,1,5,5,10,3,2012-08-22 17:58:29,2012-08-20 12:32:49
82269505b9b0f1e46ba89f3c5e735b3827aa4126...fb52a452ff8731f01b23ac4f9d53321960c6e81f,1,2,2,4,2,2012-08-22 17:58:29,2012-08-20 12:32:50
fb52a452ff8731f01b23ac4f9d53321960c6e81f...0a245e244af36053e144387eb7d335f34bba561f,1,3,3,6,3,2012-08-22 17:58:29,2012-08-20 12:32:51
0a245e244af36053e144387eb7d335f34bba561f...f6008eb24df1efe419a3e24feea071d5eda1a69a,1,2,2,4,2,2012-08-22 17:58:29,2012-08-20 12:32:52
f6008eb24df1efe419a3e24feea071d5eda1a69a...b5625d072308d5f9f1bd9ea0d7124eaa172736f3,1,5,5,10,4,2012-08-22 17:58:29,2012-08-20 12:32:53
b5625d072308d5f9f1bd9ea0d7124eaa172736f3...b0ff96547ec66979487707ad71f89c23f5e0669d,4,5,5,10,5,2012-08-22 19:02:28,2012-08-20 12:32:54
b0ff96547ec66979487707ad71f89c23f5e0669d...f63cf8c9fbcd86e8ca3bb78917dc280747bb34a8,6,10,10,20,7,2012-08-22 19:02:28,2012-08-20 12:32:55
16133c58fdb7d555f09f3709725d362d1411f35b...9a4f34bb6d11ab47d532f7798ecc2b051f6d8893,1,373,342,715,322,2012-09-12 22:33:25,2012-09-07 09:10:23
9c9b9ede9062ad702a6aa4384a597beb473e0293...3b2d763db07f251e424d7f940938d9df1e1d4d09,2,11,33,44,4,2012-07-30 20:20:00,2012-07-30 20:00:03
b15840e5b89719521c7b3fae1aa991e0efcb4a22...5f4d133fca7eb3cb750f056a6fd0281ba06cd12f,4,22,3,25,5,2012-01-06 20:41:39,2012-01-06 20:41:39
37475f97d1fbab0842c17b175263eeba6cd5e318...15f07e061e272079229d1ab2799d8e7a4f65213f,1,7,2,9,2,2012-01-13 07:06:20,2012-01-12 22:32:34
15f07e061e272079229d1ab2799d8e7a4f65213f...04f6785a089e552585ba022f9d9054eca385ca67,1,5,0,5,1,2012-01-13 07:30:53,2012-01-13 07:30:53
37475f97d1fbab0842c17b175263eeba6cd5e318...c7c2bc0ac9e7f077771db53960d4917fda4b27a7,2,23,0,23,2,2012-01-12 19:27:41,2012-01-12 11:15:33
6c65b5ea439165512d128e18829b67688ddab9cc...804e97fc77b3398db5461fdd79f2f96f6acf467d,2,12,1,13,2,2012-01-10 22:16:49,2012-01-10 22:16:49
8311158c66e0d83df950ea837fb1cb332c51f798...97ba642bcf918de028b2e77165c5210cf3f462e5,3,4,4,8,4,2012-01-11 20:52:12,2012-01-05 12:39:40
ee228024933069b93ce23a1bd5eeb7ae12c792f2...0041f09de6e62efc31c860487f04e8b08bce68c8,4,26,37,63,16,2011-12-18 02:21:37,2011-12-17 10:15:48
0041f09de6e62efc31c860487f04e8b08bce68c8...82889295e76200714d76e0f7beb07b6b9e3b5a88,3,6,8,14,6,2011-12-18 02:22:29,2011-12-17 10:20:07
82889295e76200714d76e0f7beb07b6b9e3b5a88...78e98eaf5ee49bc6d62ef9bdf87066528bfba248,1,3,11,14,5,2011-12-18 02:23:24,2011-12-17 10:27:19
ee228024933069b93ce23a1bd5eeb7ae12c792f2...d16520499d2652b5b59dfb25f9cf2d56a4c6913a,2,34,8,42,4,2011-12-18 02:20:27,2011-12-17 17:39:03
8742218f21e1e87cf9fceb11b9c14927af5ff33f...7fe74f52f95f6265e2e00320d886846b969509e6,1,3,2,5,1,2011-10-24 04:16:31,2011-10-22 11:11:07
7fe74f52f95f6265e2e00320d886846b969509e6...f7d958dff5e194797ef6776bcc77c1349f9f8c81,2,3,2,5,3,2011-10-24 04:48:06,2011-10-24 04:48:06
3dfbe68fc29248feea3a384e156497ca2463f932...2f47eae2a1337bd0cb50dbc936df6433f460bb4a,6,166,100,266,16,2011-11-05 04:40:25,2011-09-08 04:19:47
3dfbe68fc29248feea3a384e156497ca2463f932...40d6987d241cfdf45c420a91353fa47e43c47e27,1,1,1,2,1,2011-10-19 17:50:18,2011-10-19 16:26:02
40d6987d241cfdf45c420a91353fa47e43c47e27...87009edcbd0b4987ccb7ba050a1efe368a315753,1,22,2,24,8,2011-10-19 18:02:13,2011-10-19 05:03:30
87009edcbd0b4987ccb7ba050a1efe368a315753...6cf53d7df689257816370294d46f819e6e8497e8,2,0,0,0,0,2011-10-20 23:52:28,2011-10-20 21:58:33
2e49dab8a114fb8c7dafdd1cda3a8bba0afe94a5...7f41b6bbe3181dc4d1687db036bf22316997a1bf,3,109,2,111,3,2011-10-05 19:54:35,2011-10-05 19:54:35
324b6b1678a3c1c6179f53fccf4e5fe2cef43240...f85a051d13884c5a1059edb6ef7f2a6f8c55f0e9,1,34,1,35,5,2011-08-18 00:48:36,2011-08-18 00:48:36
b35acb53458d0f99ba2400b902980b35e5acc2d3...4764f46492b0849ce3cf2f527978acd9c2d5f7e6,2,44,36,80,4,2011-08-04 22:32:34,2011-08-04 12:00:57
b35acb53458d0f99ba2400b902980b35e5acc2d3...ba8ea7496f2b95c49fccb72ed6b332afbd865e7b,5,47,11,58,15,2011-08-01 23:09:15,2011-08-01 17:20:53
ba8ea7496f2b95c49fccb72ed6b332afbd865e7b...317f63c21c8eac46813eacf487485445f2f79a6d,2,21,13,34,7,2011-08-01 23:11:50,2011-08-01 17:22:52
b35acb53458d0f99ba2400b902980b35e5acc2d3...f40ae5cee61f35bdc46b17ccc11fbc6eb7977c89,1,49,54,103,22,2011-08-01 17:23:38,2011-07-31 13:44:50
f40ae5cee61f35bdc46b17ccc11fbc6eb7977c89...83cf0fe49fc6a7124377ef6dec75a9776c753346,1,1,1,2,1,2011-08-01 17:23:54,2011-07-31 13:45:17
83cf0fe49fc6a7124377ef6dec75a9776c753346...eab30818a9d0b874f9b339374349043f2c4aee5d,1,1,0,1,1,2011-08-01 17:24:15,2011-07-31 13:45:38
eab30818a9d0b874f9b339374349043f2c4aee5d...4e2e6ce45047fe2713546127f3d1ded576e1bf7e,2,33,1,34,3,2011-08-01 17:24:20,2011-07-31 13:45:55
b6691092d707860019bbab80eaaf9173ada10586...013c3bb81ee1643ce69a64197b2075212492c352,1,70,73,143,8,2013-03-14 21:49:32,2013-03-14 20:00:50
013c3bb81ee1643ce69a64197b2075212492c352...7297a440122b329c501e70dda099030373af069f,2,27,1,28,2,2013-03-14 21:49:48,2013-03-14 20:00:51
7297a440122b329c501e70dda099030373af069f...8be412a723459feb9f521062e2919f8f6e8389d3,1,2,2,4,2,2013-03-20 17:10:28,2013-03-20 08:47:57
b6691092d707860019bbab80eaaf9173ada10586...4ae6670444388f5ba68850e42a93af4019922c26,3,35,4,39,6,2011-05-26 23:47:15,2011-05-21 21:05:51
4ae6670444388f5ba68850e42a93af4019922c26...e322ee38ad8d655f5a32b3482ae9ce813b73e4bc,1,41,0,41,2,2011-05-26 23:47:15,2011-05-20 23:47:56
e322ee38ad8d655f5a32b3482ae9ce813b73e4bc...b84c7839170ab35342d4ff098083c780075f015a,1,169,8,177,9,2011-05-26 23:47:15,2011-05-21 01:28:00
b84c7839170ab35342d4ff098083c780075f015a...a265a7f95e6e3ebd81df0c6813b17d61a5ab890a,1,112,14,126,2,2011-05-26 23:47:15,2011-05-22 01:28:41
a265a7f95e6e3ebd81df0c6813b17d61a5ab890a...dd555d8bed255c7949620e6551ea5afd2213bae0,1,12,11,23,5,2011-05-26 23:47:15,2011-05-21 21:25:06
dd555d8bed255c7949620e6551ea5afd2213bae0...6b6cab3f9af2ab7010592e50bb343b990a6a7666,1,24,8,32,7,2011-05-26 23:47:16,2011-05-25 01:02:48
5a2df368c26e4a993db9d09f221af1063d0fe9a8...67e223edc4013b0b3b1caad336e4a43f6d4c66b8,1,1,1,2,1,2011-12-27 19:14:18,2011-12-27 02:03:45
b57fb80a7d7d19102b31ab94a28ed43ea1ee07bb...9be1980bb966cb1bc187b62803e6b76087fd5aac,2,14,2,16,3,2013-01-06 06:44:11,2013-01-05 20:17:04
b57fb80a7d7d19102b31ab94a28ed43ea1ee07bb...4e95fb6c378c4078d8ef258388e43c75d63a2ad9,1,1,1,2,1,2011-04-12 06:57:56,2011-04-12 06:30:49
e2a57aac8a8a2b786739a5a93ea9dcfd2f0fd0e2...5e96a847b391eda693b60347bb190dd45fb1721c,1,20,7,27,8,2011-03-18 19:29:31,2011-03-18 16:00:16
7bf040c5bfcac4f9efe9b3fc9879756728fc098f...c6d059bbccb8460959b9aedfeefbb4d6aac6e842,2,33,1,34,2,2010-12-11 00:35:00,2010-12-11 00:35:00
271c2aa6eed21d4ef9d8d6c2298121545e6ce123...4443091d961e91041e64c1675940f0585eeba456,1,0,13,13,2,2010-12-11 00:40:00,2010-12-11 00:40:00
0925c02e212fc69dfd095ca1116e3d8999a95e44...6068cdcc832040ac644c56953be0670bb09afd12,1,102,11,113,8,2010-06-14 17:06:33,2010-06-14 16:53:02
6339f67fedfec454294dc33ebc3dcec6eeb70e02...57895105c4ff083d7c9bc59b2b88b9b5176c1915,1,9,3,12,5,2010-06-14 17:31:11,2010-04-23 15:20:20
656cdf0c9ebe2899ef79020285c9a6243dc84d97...ca5bc9e61fb26969c9b028c9b853af109f9f00c5,2,2,2,4,2,2012-02-20 07:44:38,2012-02-18 11:17:47
8fe5d87622a4268079bf1e5738474f85d4e5c3bc...11f54989da573df35999222b9e504c12697b9392,1,1,0,1,1,2010-03-21 23:30:17,2010-03-21 13:43:47
8fe5d87622a4268079bf1e5738474f85d4e5c3bc...1fb5fdd25f018480b48f6a74f06bad7e04866440,2,13,1,14,3,2010-03-21 18:44:27,2010-03-21 14:40:16
8fe5d87622a4268079bf1e5738474f85d4e5c3bc...08bb03e4754cf285c0fe49d22d2b8ce13d7609a2,1,3,0,3,3,2010-03-21 02:26:35,2010-03-19 11:02:04
e265f1f7168a262c2f50c68707ff17318ebfdc5a...0dd2a2c9b4da43f0b1e8674e6b257685f4c29dbd,1,965,843,1808,802,2014-02-12 06:15:55,2014-01-03 17:38:12
0dd2a2c9b4da43f0b1e8674e6b257685f4c29dbd...92cd3e35a0493fed026e5baec97e1e7359bcda96,1,1,1,2,1,2014-02-12 06:16:03,2014-02-08 21:01:36
8d19b44b316411d6e3a90db257a4901580603884...939ca96b0e871418ba5f43f0fe620d626305c67c,1,2,0,2,2,2011-11-08 21:37:02,2011-11-08 21:29:30
939ca96b0e871418ba5f43f0fe620d626305c67c...fcbebfdd33bf8b6cc802300f81089148d413eec9,3,46,50,96,12,2011-11-08 21:37:10,2011-11-08 18:17:40
e3ff352c73a87d533fd239c3f9d4bb978c8ce387...cc1b8d8bc6e453b96798574d67ce9590eb3e82e1,10,39,36,75,31,2010-02-18 05:40:09,2010-02-18 01:16:20
79f5e0645ac7239bb0b019f2595bca18d469a280...b48d5a050afa30402c8281c223df9d7e58b4493c,2,29,11,40,16,2007-08-10 20:59:19,2007-08-10 19:15:54
b48d5a050afa30402c8281c223df9d7e58b4493c...288f072ec033cf917eed949119428db3626ddc71,1,3,3,6,4,2007-08-10 21:00:11,2007-08-10 19:21:20
288f072ec033cf917eed949119428db3626ddc71...d699676dda5fdf0996601006c3bac2a9c077a862,1,4,3,7,4,2007-08-10 21:00:25,2007-08-10 19:31:20
d699676dda5fdf0996601006c3bac2a9c077a862...7fa8254f9476de24661e93b2a90c6ce30dc10006,2,17,1,18,4,2007-08-11 05:19:06,2007-08-09 00:01:49
7fa8254f9476de24661e93b2a90c6ce30dc10006...c06793a4ed1bf81902c324d1ed88dd055c3aa468,1,33,0,33,2,2007-08-11 05:19:15,2007-08-09 05:04:06
c06793a4ed1bf81902c324d1ed88dd055c3aa468...442b67a55972e69a054eb1206bbbdf044532130a,1,5,2,7,4,2007-08-11 05:20:35,2007-08-10 22:29:49
442b67a55972e69a054eb1206bbbdf044532130a...21a02980f9025c3a338fb897796542ddef8707d1,1,13,24,37,7,2007-08-11 05:33:44,2007-08-11 00:39:24
21a02980f9025c3a338fb897796542ddef8707d1...cbbb218f8bd219d79907623a9304496ee69d8abd,1,1,0,1,1,2007-08-11 05:50:06,2007-08-10 13:06:22
cbbb218f8bd219d79907623a9304496ee69d8abd...566b5c057c452d04605805ea2f7af210c6fb9b59,1,5,2,7,5,2007-08-11 06:02:14,2007-08-10 19:53:51
39bd2eb56af89d43a08ba54699d9a1849ab57b39...182af8343c307436bb5364309aa6d4d46fa5911d,23,60,197,257,64,2007-09-19 00:42:17,2007-09-15 22:32:36
182af8343c307436bb5364309aa6d4d46fa5911d...ca0328354afbf4ec6941cb4312bfc6908ab06d73,1,1,0,1,1,2007-09-19 08:54:24,2007-09-19 08:37:50
ca0328354afbf4ec6941cb4312bfc6908ab06d73...6b30852ded5074652f4304a303521932235c62db,1,1,1,2,1,2007-09-19 08:54:24,2007-09-19 08:52:59
05cc2ffc572f05e8aeec495a9ab9bc9609863491...060fe5718455828b2ce5721d26be6399d782e415,1,13,5,18,6,2007-09-12 06:05:35,2007-09-11 18:16:51
060fe5718455828b2ce5721d26be6399d782e415...3803bceae84fe122eccb49e3096abead508cde8f,1,2,1,3,1,2007-09-12 07:57:38,2007-09-12 05:53:45
3803bceae84fe122eccb49e3096abead508cde8f...4fb5fd5d301ee53882a3c2ed717c5a9fd6dc0506,1,1,1,2,1,2007-09-12 17:50:27,2007-09-12 16:14:22
4fb5fd5d301ee53882a3c2ed717c5a9fd6dc0506...6143fa2c9cc74023bab3279764cd6158b1227359,1,1,1,2,1,2007-09-12 19:05:56,2007-09-12 18:45:03
05cc2ffc572f05e8aeec495a9ab9bc9609863491...a4503a15af661ee865ed10102df15a6d3b43e60a,1,1,1,2,1,2007-09-10 07:00:26,2007-09-09 23:38:11
88b7dd4597b11db4a99537519df91265fc7533e0...1b655040bec1ff2f44fe309ac0f26085ed6372e9,1,65,38,103,10,2007-09-14 05:36:22,2007-09-13 09:49:40
1b655040bec1ff2f44fe309ac0f26085ed6372e9...98acc3fabc2d197525f1b0119382a00a664014b7,1,77,15,92,11,2007-09-14 05:37:54,2007-09-13 09:50:08
98acc3fabc2d197525f1b0119382a00a664014b7...568d2cde9b9fe0fc6b3202c7987b13289cb1a4a0,1,2,2,4,2,2007-09-14 05:37:54,2007-09-13 09:50:29
88b7dd4597b11db4a99537519df91265fc7533e0...80bffaf7fbe09ef62ecb9a6ffea70ac0171b456c,3,103,1,104,9,2007-09-12 23:40:59,2007-09-12 23:04:22
80bffaf7fbe09ef62ecb9a6ffea70ac0171b456c...db33af0a7f64ffc48de3ad018a1df03f744fb7a2,2,14,3,17,4,2007-09-14 23:53:58,2007-09-14 23:53:58
db33af0a7f64ffc48de3ad018a1df03f744fb7a2...a7a0f3d3f858eef1f1326821343c640c5b3838ce,1,8,1,9,2,2007-09-14 23:59:04,2007-09-14 23:59:04
88b7dd4597b11db4a99537519df91265fc7533e0...359048d6ec296757266887a8ced5a927b97b94c1,1,389,0,389,1,2007-09-12 20:25:07,2007-09-11 01:09:52
359048d6ec296757266887a8ced5a927b97b94c1...6640f88165f77edcc266a2c0c56fb017dc613198,3,26,24,50,3,2007-09-12 20:25:07,2007-09-11 03:17:28
6640f88165f77edcc266a2c0c56fb017dc613198...0e5a7faa3a903cf7a0a66c81e20a76b91f17faab,5,283,1,284,5,2007-09-12 20:25:07,2007-09-11 03:19:34
0e5a7faa3a903cf7a0a66c81e20a76b91f17faab...cbb390cd8f58ca6fc5c7b2c710425649b057b6d6,1,16,0,16,1,2007-09-14 03:54:14,2007-09-14 03:54:14
0058a33a8eb5a8bfcfc5f5e769a2517cff4b73f1...6e30fb0c3241ecdf1ac47c1495bc3b58a0dc6f05,1,11,9,20,3,2007-08-26 14:31:30,2007-08-08 15:34:28
0058a33a8eb5a8bfcfc5f5e769a2517cff4b73f1...ab43e495dd095547c3ada9ae13b72f9741a7f0d2,1,11,0,11,3,2007-08-25 15:33:47,2007-08-25 08:26:20
ab43e495dd095547c3ada9ae13b72f9741a7f0d2...2e3404c3245e1e0031ef0a6574f25e8c35d5aac3,1,6,0,6,2,2007-08-25 15:33:47,2007-08-25 08:26:47
2e3404c3245e1e0031ef0a6574f25e8c35d5aac3...9064d87b06f3d0b4ca0aabb45770eefb84fc3ca2,1,4,0,4,1,2007-08-25 15:33:47,2007-08-25 07:26:04
9064d87b06f3d0b4ca0aabb45770eefb84fc3ca2...1560be16b94a85df166ae26bcfff11bcd57c2fed,1,4,2,6,1,2007-08-26 05:35:35,2007-08-26 03:19:38
1560be16b94a85df166ae26bcfff11bcd57c2fed...480611d170e1c013b06a49e81a178fefd278b313,2,5,3,8,3,2007-08-26 05:35:44,2007-08-26 03:20:06
281a53bb79786a6d7e54f9715cc8ad46fc2bdb0e...4e0b2bbc578f8729cf43939acb36e8db02ed8825,1,1,1,2,1,2007-08-01 04:07:39,2007-07-31 12:48:29
51b8c5021a19195e0f138832b081a356a2247bca...c6951ddb522a7d8ee0fc371cf9c37e727e676989,2,8,1,9,3,2007-08-20 04:38:13,2007-08-20 04:53:04
c6951ddb522a7d8ee0fc371cf9c37e727e676989...18a01a0da428c9e1034247e2b40c62e506b73580,1,1,1,2,1,2007-08-20 06:17:05,2007-08-20 06:17:05
18a01a0da428c9e1034247e2b40c62e506b73580...ce015c213fbef39140b6192db28110bc666dc6c8,1,4,3,7,2,2007-08-21 06:22:53,2007-08-21 06:22:53
ce015c213fbef39140b6192db28110bc666dc6c8...875b7c93686d16e083dcea8b544e4f204113d8de,1,63,51,114,5,2007-08-22 06:41:00,2007-08-22 06:41:00
875b7c93686d16e083dcea8b544e4f204113d8de...9f4119eb7651c7898f385198409be4ca051bc7ef,1,11,12,23,3,2007-08-23 06:39:45,2007-08-23 06:39:45
9f4119eb7651c7898f385198409be4ca051bc7ef...9c9f5fa97fe078b59be14a6bcabb851745ddd48c,1,4,0,4,2,2007-08-23 06:44:13,2007-08-23 06:44:13
9c9f5fa97fe078b59be14a6bcabb851745ddd48c...c80d25dbce759a8483ffc1f085fdf4cd63cf9f05,1,9,1,10,1,2007-08-25 03:15:50,2007-08-25 03:15:50
1e299f52869f3bf40e1c22721cd23bb6b4b43500...3ebda3e9f56d49cc72488e76478d086e75be731d,2,69,1,70,2,2015-03-05 21:15:53,2015-03-05 21:15:53
54d80a934332c809cf098e59c6ebd5a17f4ac3a6...1e607449135792dd117bd528432fc1fbc1115667,6,62,64,126,30,2015-01-21 07:35:37,2015-01-21 07:05:03
eb443e3b39482b3d64c1efd46de7481c3321a87a...6babe76496db332d589c1a2e0a2344fe41ca1dd5,1,4,4,8,5,2015-01-14 18:11:49,2015-01-14 10:06:28
563d4e59bd167fe2eecc5480e3841d878b1c8c2b...b90a3d7b3275fdb23184dce7afc2aaeaaafb8886,2,32,34,66,6,2015-01-15 19:00:52,2015-01-14 23:40:46
b90a3d7b3275fdb23184dce7afc2aaeaaafb8886...0fb1df4af2a28bc95b26fbd9d4f172a461d88ef2,2,0,6,6,2,2015-01-15 19:02:06,2015-01-14 23:40:48
0fb1df4af2a28bc95b26fbd9d4f172a461d88ef2...cb4680500a3e72e0d5811659f9e4f46c8df91696,2,14,15,29,3,2015-01-15 19:04:10,2015-01-14 23:40:53
cb4680500a3e72e0d5811659f9e4f46c8df91696...2b102efc8cd60730f044917d3aa68b3dd54d82d0,2,1,3,4,2,2015-01-15 19:05:47,2015-01-14 22:39:02
2b102efc8cd60730f044917d3aa68b3dd54d82d0...0131c4909674b35f870916f875e6404e3ba58bc9,2,59,59,118,5,2015-01-15 19:05:47,2015-01-14 22:49:24
0131c4909674b35f870916f875e6404e3ba58bc9...667f7eb2eac5b5b369dc2a3f444e6057563e683a,2,3,4,7,2,2015-01-15 19:05:48,2015-01-14 22:57:08
667f7eb2eac5b5b369dc2a3f444e6057563e683a...a355b11daba73f8a73866a318d5eb8550285332b,2,1,2,3,2,2015-01-15 19:05:48,2015-01-14 22:58:44
a355b11daba73f8a73866a318d5eb8550285332b...167832c2ca8e42572c0e8d329a78dbace2ecf2db,2,1,2,3,2,2015-01-15 19:05:48,2015-01-14 23:01:27
563d4e59bd167fe2eecc5480e3841d878b1c8c2b...9a2bb059e76b1368392f86ecf7af2ba188e3cac5,1,1,1,2,1,2015-01-15 08:35:55,2015-01-10 14:35:10
9a2bb059e76b1368392f86ecf7af2ba188e3cac5...a94655dcfedc6b266ba32a3d32b0d52a1ce6a928,1,6,0,6,1,2015-01-15 08:35:55,2015-01-10 14:55:11
07361f12ab8d85d18aa213755a66571f2b1c614f...d9d56b235724a6aaf10f1ce89b82cd457a7ef04c,1,175,176,351,166,2015-01-19 02:23:53,2015-01-18 12:37:57
d9d56b235724a6aaf10f1ce89b82cd457a7ef04c...a235de4bd2bcd24eb63f7ebb4649b2b9fa8b3f96,1,142,141,283,128,2015-01-20 18:23:57,2015-01-19 06:15:29
9abc44b681a669c67d071d858c8aad21f65a0956...bdfdaa4978dd92992737e662f25adc01d32d0774,2,390,418,808,23,2015-01-16 22:40:46,2015-01-16 09:04:04
bdfdaa4978dd92992737e662f25adc01d32d0774...6afbbdda3339349feae91161f4e530d511c4db76,1,7,7,14,7,2015-01-16 22:40:46,2015-01-16 09:04:51
6afbbdda3339349feae91161f4e530d511c4db76...aa07cac43fb03a01bcbcdffdaa49bf72a9eb06d1,1,37,37,74,2,2015-01-16 22:40:46,2015-01-16 09:05:10
aa07cac43fb03a01bcbcdffdaa49bf72a9eb06d1...088c9a86ff5332ee15415be3408ccf34687bc2d2,1,4,7,11,2,2015-01-16 22:40:47,2015-01-16 09:05:16
088c9a86ff5332ee15415be3408ccf34687bc2d2...14e2177a40ca5861f0518cb6bbe0a6856ffa7552,1,8,9,17,4,2015-01-16 22:40:47,2015-01-16 09:05:28
14e2177a40ca5861f0518cb6bbe0a6856ffa7552...f20e56e202fa2a6cd3faa1710ed9f600ba58ce1d,1,5,12,17,4,2015-01-16 22:40:47,2015-01-16 09:05:57
f20e56e202fa2a6cd3faa1710ed9f600ba58ce1d...d468fa2721d1ff918c0991e9e1f762872b3f82ae,1,2,10,12,3,2015-01-16 22:40:47,2015-01-16 09:06:04
9abc44b681a669c67d071d858c8aad21f65a0956...1be976eeb4232a1b09aeb63f863646d30d31decd,1,5,4,9,1,2014-12-12 23:23:08,2014-12-11 23:48:53
1be976eeb4232a1b09aeb63f863646d30d31decd...92be938e96508a87fa2b0b78bd335fc6273f5763,1,13,9,22,1,2015-01-12 23:12:05,2015-01-05 22:22:53
8213d87a83867809f490e8d683ebbaa857547189...b195aa00c17ea38d3f1c9125c37348645ea58f7c,1,4,0,4,2,2014-12-18 19:01:30,2014-12-16 23:19:36
8213d87a83867809f490e8d683ebbaa857547189...b41a36e635803f1dc011007e836ae244f9ae04c1,4,11,3,14,3,2014-12-12 18:23:36,2014-12-12 08:50:12
b41a36e635803f1dc011007e836ae244f9ae04c1...c0e0ed6efe497902a2e2ce5fb1586577a27eea1b,2,11,7,18,8,2014-12-12 18:26:08,2014-12-12 08:50:13
c0e0ed6efe497902a2e2ce5fb1586577a27eea1b...1e3eefbc8d942f94d59d745bbfe91d28d39e680d,4,89,2,91,2,2014-12-12 21:51:54,2014-12-12 08:50:14
1e3eefbc8d942f94d59d745bbfe91d28d39e680d...4b0bf39dd580239f647cb925a57566bf60c1f93c,1,14,12,26,3,2014-12-12 21:54:05,2014-12-12 20:33:56
4b0bf39dd580239f647cb925a57566bf60c1f93c...6fb5df6c77070f7cea5391572003ecfea3235650,1,13,3,16,2,2014-12-16 20:37:43,2014-12-16 08:40:05
8213d87a83867809f490e8d683ebbaa857547189...a46e41fca301be48130cca80b45027eff328903d,1,92,0,92,2,2014-12-11 19:56:26,2014-12-10 23:47:51
a46e41fca301be48130cca80b45027eff328903d...0e729c7ed5b3c0c6be38bf8d8405b1b7f5a74a3f,2,7,11,18,5,2014-12-11 19:56:53,2014-12-10 23:47:52
8213d87a83867809f490e8d683ebbaa857547189...0291973b361bb739df9052d17bfbf2d1e63f2004,1,66,16,82,9,2014-12-05 23:16:25,2014-11-30 20:15:52
c653e0343d04ba89040c8ba18d7ca2e55ece6338...a6a843196869659ee55238e474be29018987c4bf,1,27,16,43,6,2015-01-08 03:56:42,2015-01-08 03:23:15
a6a843196869659ee55238e474be29018987c4bf...b6a4788586d8d1e88eee298c4a9a571416e50e3a,1,1,3,4,1,2015-01-08 03:56:42,2015-01-08 03:23:16
b6a4788586d8d1e88eee298c4a9a571416e50e3a...a1a261457c0577f5e0620fcc2b803999a6d5b8cf,1,13,6,19,2,2015-01-08 03:56:43,2015-01-08 03:23:17
a1a261457c0577f5e0620fcc2b803999a6d5b8cf...222368c6456211a3b2054ce4651cb58703886965,1,37,14,51,13,2015-01-08 03:56:43,2015-01-08 03:23:18
222368c6456211a3b2054ce4651cb58703886965...68deed298ac4c257cd72d6bee543f651cb10d669,1,46,1,47,4,2015-01-08 03:56:43,2015-01-08 03:23:19
68deed298ac4c257cd72d6bee543f651cb10d669...1b70fe5d305462f1dd4b9d6233a2f4cb98e3a581,2,22,2,24,6,2015-01-08 03:56:43,2015-01-08 03:23:20
1b70fe5d305462f1dd4b9d6233a2f4cb98e3a581...7582e9397c5b49de10a138a4f477a38b4ed1b3ab,1,11,7,18,8,2015-01-08 03:56:44,2015-01-08 03:23:21
7582e9397c5b49de10a138a4f477a38b4ed1b3ab...4ff17f10c4297ab3d9948d4216016ca367e737e3,6,66,6,72,14,2015-01-08 03:56:44,2015-01-08 03:23:22
4ff17f10c4297ab3d9948d4216016ca367e737e3...d0e8e09cd8828b278a56d4ebfc52d662ff8038d8,4,13,1,14,7,2015-01-08 03:56:44,2015-01-08 03:23:23
d0e8e09cd8828b278a56d4ebfc52d662ff8038d8...ad35ecabea5e687a777478a8900716a0ea74247f,1,194,0,194,1,2015-01-08 03:56:44,2015-01-08 03:23:24
ad35ecabea5e687a777478a8900716a0ea74247f...04b39f195baf95b79c9c28a096011e9fe0a08303,1,5,0,5,1,2015-01-14 20:07:21,2015-01-13 00:24:02
1e16b255b95b45374db0b0cf69ef0ecce768ac27...d47e55da92932eecb58d01a7d925efa36f30087d,1,1,1,2,1,2015-01-06 20:17:37,2015-01-06 11:00:55
d47e55da92932eecb58d01a7d925efa36f30087d...230c09c06a7300870f3915c54eff7d9335850a4a,1,2,2,4,1,2015-01-06 20:18:32,2015-01-06 11:20:37
6c31a5e94af1036bb29da8a75f1e735e662aee92...c616d845b5c12f46f9a44d3aeb835004ad2aba5f,1,573,573,1146,559,2014-11-14 18:21:52,2014-09-19 16:38:13
c616d845b5c12f46f9a44d3aeb835004ad2aba5f...744437f8e6822180f37d385e2453cb9c8050dcc1,1,4,4,8,2,2014-11-15 17:21:58,2014-09-23 12:54:46
744437f8e6822180f37d385e2453cb9c8050dcc1...d544b2d495295142cb3418b13b5a106d415d2216,1,1663,1414,3077,1317,2014-11-15 17:22:05,2014-10-30 08:00:47
8978166e531e0941811099d4117574ebbbcf35d8...ec8460bd91007f0bd7851cd07494d1019a39937f,1,16,6,22,6,2011-03-02 23:34:23,2011-03-02 20:12:10
ec8460bd91007f0bd7851cd07494d1019a39937f...a3f5e7a32ec2d885fe6ff7fc14ee91de391f1d72,1,8,1,9,1,2011-03-02 23:34:26,2011-03-02 20:12:11
8978166e531e0941811099d4117574ebbbcf35d8...afb0b7933f31e984caf6fb835f6afe6eb37d918c,2,57,1,58,2,2011-02-28 20:28:20,2011-02-28 20:28:20
8978166e531e0941811099d4117574ebbbcf35d8...7218a215efc7ae46f7ca8d82442f354e7ac06262,1,40,21,61,9,2011-02-28 07:29:03,2011-02-02 18:06:51
7218a215efc7ae46f7ca8d82442f354e7ac06262...ebcfb3791a53e0455bf8361046e3310993697a8e,5,48,33,81,26,2011-02-28 07:29:03,2011-02-25 23:43:25
ebcfb3791a53e0455bf8361046e3310993697a8e...e337a04de298f8c3e64ee1a187423203406b9bae,6,125,17,142,20,2011-02-28 07:29:03,2011-02-03 01:29:01
e337a04de298f8c3e64ee1a187423203406b9bae...fb956c1f44b5c99273eb9e3850717c8b489ff78f,1,19,10,29,4,2011-02-28 07:29:03,2011-02-26 00:54:00
fb956c1f44b5c99273eb9e3850717c8b489ff78f...3c9fc074c220d5d1d2173c84cc6ae57d750e2a2c,4,74,2,76,6,2011-02-28 07:29:03,2011-02-26 00:55:26
3c9fc074c220d5d1d2173c84cc6ae57d750e2a2c...4f8ec74efa9fc69aa3b0bd52affe31ca09f2fdd3,1,8,3,11,4,2011-06-06 05:45:36,2011-06-03 22:32:14
4f8ec74efa9fc69aa3b0bd52affe31ca09f2fdd3...38a4556198de17156f27f0463161a4d1b5e11555,1,40,3,43,7,2011-06-06 05:45:36,2011-06-03 22:32:15
38a4556198de17156f27f0463161a4d1b5e11555...d1a0ed187cbea2941a5cc10dcc43f3a7052ce32d,1,23,3,26,5,2011-06-06 05:45:37,2011-06-03 22:32:16
d1a0ed187cbea2941a5cc10dcc43f3a7052ce32d...3de89c9d4216d0fdc11bd1141c419ac4d0d35fed,4,27,166,193,18,2011-06-06 05:45:38,2011-06-03 22:32:17
ae4479d4943a522f3dc3a37dce2b833caa70b9bd...0564d937bfac6729dac8ea5a2b15de52fcd4b8ec,1,0,5,5,1,2011-03-14 17:49:28,2011-03-14 16:23:52
0564d937bfac6729dac8ea5a2b15de52fcd4b8ec...ee55703bace45760c3385d00c9056d6f6f644229,1,3,2,5,1,2011-03-14 17:52:23,2011-03-14 15:47:37
50d3062ab2cea4e999b8f3bafd211ff348bca600...dabdbee10bd6c7d92204ce4bfc1f3ffd60a4046a,1,1,2,3,2,2011-04-29 15:20:10,2011-04-29 09:42:41
dabdbee10bd6c7d92204ce4bfc1f3ffd60a4046a...c54e6be75ae90e2be45c32f4d1949fff59ad7d9d,1,9,7,16,2,2011-04-29 15:27:52,2011-04-29 12:30:30
2cf08b6a0ab09f1b81b78a5686a632a2a602abf4...ad5b6942d5b9127cc940d2135ce82c633013418a,1,1,1,2,1,2011-01-11 19:03:48,2011-01-11 08:53:59
2cf08b6a0ab09f1b81b78a5686a632a2a602abf4...e6ec2b6a23a364de76cd8868d4df20627264eb45,2,1168,1167,2335,601,2011-01-11 18:49:38,2010-12-30 20:51:53
e6ec2b6a23a364de76cd8868d4df20627264eb45...95b104c830caa74a5702bcabc3bbb920b0eba07d,1,6,0,6,1,2011-01-11 18:51:25,2011-01-11 07:44:30
95b104c830caa74a5702bcabc3bbb920b0eba07d...91c031df677f167ac772a3d6a9b3e391b436615c,1,50,44,94,5,2011-01-19 18:27:16,2011-01-19 12:38:22
91c031df677f167ac772a3d6a9b3e391b436615c...786dabecd4766bfda0083491ef543e3b5d1d9f39,1,625,4408,5033,52,2011-01-19 18:27:16,2011-01-19 12:40:51
786dabecd4766bfda0083491ef543e3b5d1d9f39...4868b2ea17b7a5e8171cb109423a25a269bfefe5,2,134,95,229,27,2011-01-21 22:31:24,2011-01-19 12:42:30
4868b2ea17b7a5e8171cb109423a25a269bfefe5...ea472c1e3524e5c46a54c96bdb5c1deca8f7de28,2,21,17,38,6,2011-01-24 18:13:59,2011-01-23 23:49:41
ea472c1e3524e5c46a54c96bdb5c1deca8f7de28...6abbee8c60f16492d605ce087484d2654c068515,1,1,1,2,1,2011-01-24 18:14:57,2011-01-22 20:02:48
685e9d9145a186a4b2036ecf2be73cc86d99a9b7...ac49f5ca84d82e5b10bc1eb022dfdd9b0e8f7749,3,88,12,100,10,2011-02-16 21:20:50,2011-02-16 10:47:44
ac49f5ca84d82e5b10bc1eb022dfdd9b0e8f7749...2f59c947044d535e078941711e562d825eb055e3,2,35,7,42,14,2011-02-16 21:21:09,2011-02-16 10:47:45
685e9d9145a186a4b2036ecf2be73cc86d99a9b7...7f51f8bc2b9d0556f2fbe20056e8fc8839766c99,1,17,17,34,2,2011-01-07 00:29:49,2011-01-06 23:00:38
685e9d9145a186a4b2036ecf2be73cc86d99a9b7...e83c267f71dfef72926807cd69aa8d570e57714e,1,8,1,9,3,2011-01-06 20:21:49,2011-01-06 00:30:01
e83c267f71dfef72926807cd69aa8d570e57714e...ed40ec551d4517323c6a46aa555b83cc7651ddbc,3,37,37,74,37,2011-01-06 20:22:36,2011-01-06 00:30:02
ed40ec551d4517323c6a46aa555b83cc7651ddbc...bc2d159421bb017edc7b8b8d6d5544e1c83073e4,1,3,3,6,3,2011-01-06 20:34:52,2011-01-06 00:30:03
bc2d159421bb017edc7b8b8d6d5544e1c83073e4...9cfdbf9bef8ba8694fde7e9c562b124d2f46d69d,1,4,1,5,2,2011-01-07 21:50:11,2011-01-06 19:06:51
9cfdbf9bef8ba8694fde7e9c562b124d2f46d69d...e17aa8a9dca972ca278dd91a097873101066e964,1,8,0,8,1,2011-01-07 22:14:36,2011-01-06 18:29:23
0e4c8822e98e27c3c63125570c8bcbf0a8fd34da...d17cf5f3a32f07bf8a6b8fb014abfa8e87fd7075,3,23,2,25,3,2012-08-04 23:06:07,2012-08-03 22:21:04
0e4c8822e98e27c3c63125570c8bcbf0a8fd34da...84befcd0a4a074e2ae191c32be09d2e82d5db114,5,281,42,323,27,2012-08-03 16:58:02,2012-08-03 14:53:50
0e4c8822e98e27c3c63125570c8bcbf0a8fd34da...4d4b573977833f887635be386b84681e73834b72,1,5,3,8,3,2012-08-03 16:06:30,2012-08-03 08:21:20
e2eb527345d48881dac0d88e6bdfc0a267a2eb62...035b5bf6431dbf8f3cde2f44b0d7ef893b95b605,2,2,2,4,2,2011-10-13 19:16:36,2011-10-13 15:59:24
3e63b21aced116badd30a279c479535449a63560...cf2ad8e64175bcf4b2bb693a9e4c0a89076111dd,1,4,3,7,2,2011-03-29 19:21:28,2011-03-29 17:24:59
761ecf0bc7b6cddf311f00877c59e6381cdbdeea...8e9182e09127b20b8d8ce19655037991feac798d,1,2,1,3,1,2011-03-29 19:19:58,2011-03-29 17:16:29
761ecf0bc7b6cddf311f00877c59e6381cdbdeea...c12f5917e4f528b056a8b9ca625397aee97ae1e4,1,11,3,14,5,2011-03-21 04:53:11,2011-03-21 04:52:40
c12f5917e4f528b056a8b9ca625397aee97ae1e4...6afca450c3f2f05385900a7b8d3a0d47286f983f,1,6,1,7,2,2011-03-21 04:53:25,2011-03-21 04:52:44
6afca450c3f2f05385900a7b8d3a0d47286f983f...066bf4c2e43c7fb40405843e49f809431314865d,1,4,2,6,2,2011-03-21 04:53:30,2011-03-21 04:52:45
8e2dc6ac06ae90a00965e5c00aa4918dfd447639...f807b3dcab9cafd76936d24936b8353f99b2ae6d,1,9,6,15,3,2011-05-24 21:26:42,2011-05-24 17:08:29
c22e7de340df2e0ebc0e98347aa02a32a459835f...990f6e30eb00adeb8cad75c3be34c0fc9ff6abb0,2,24,0,24,3,2011-04-14 22:42:04,2011-04-14 22:18:09
66ecd2d05306fccc65e8d6a5f49100840ea7d3b6...83c3c6222a2331042c973a991572eafa37f25d1d,1,27,3,30,5,2011-03-10 00:21:16,2011-03-10 00:21:16
b1b47554ae889ca76b66349819c9b95a8be5f646...8ee50594889056322f2fc00a589a36e83b9119fd,1,4,11,15,3,2011-03-21 17:31:37,2011-03-21 10:14:05
8ee50594889056322f2fc00a589a36e83b9119fd...ad5aeeded3295589b2573b143f754762a56f8f82,5,32,10,42,10,2011-03-23 17:16:44,2011-03-21 10:14:06
ad5aeeded3295589b2573b143f754762a56f8f82...6a6ebded7f2288d098f825f97cb2c210f0344497,4,129,3,132,7,2011-03-23 17:20:24,2011-03-23 09:38:51
6a6ebded7f2288d098f825f97cb2c210f0344497...482ce70e14fdd5d03304a92f1740e6a9022e7958,1,8,8,16,4,2011-03-24 18:40:50,2011-03-24 08:21:24
1d718a5108f905e3c64f9fa791e67a52bd926457...9973d9329b71556178ef32b4f8cfedab009a18d8,1,1,1,2,1,2011-04-12 07:03:54,2011-04-12 06:41:19
f577b92fe75643228674c0dcb2a4747587cf541d...9ddf17268c632967abf2dadf9fa2b9d11dcc1867,1,3,3,6,2,2011-03-16 05:24:29,2011-03-16 03:42:32
f577b92fe75643228674c0dcb2a4747587cf541d...9d8b831b36ca936f05e381e0f7f7a4b0d76114ee,1,4,0,4,1,2011-02-16 22:39:00,2011-02-16 22:39:00
f577b92fe75643228674c0dcb2a4747587cf541d...cc5fa2fdafa186d6e1e310828b22d0028e1fb51b,1,28,2,30,10,2011-02-03 22:10:46,2010-12-17 13:26:47
cc5fa2fdafa186d6e1e310828b22d0028e1fb51b...a97a96fc9667cd84dc350db309135ea52adac18d,1,51,0,51,1,2011-02-03 22:10:46,2010-09-19 23:24:29
f67d2e82d6d2fd385d3d20e8d348eaf69dc95041...82553cbb08b791aa0bed920ee58494268c0f579f,1,18,7,25,1,2012-01-12 01:30:16,2012-01-11 20:13:42
f67d2e82d6d2fd385d3d20e8d348eaf69dc95041...5f25b6299d3e9853cf1f43734228d6e25d8f3415,1,1,1,2,1,2011-08-22 18:34:55,2011-08-17 21:30:33
5f25b6299d3e9853cf1f43734228d6e25d8f3415...91f175165aba17903ab928da543052ea335fc924,4,23,28,51,5,2011-08-22 18:34:55,2011-08-17 21:30:34
91f175165aba17903ab928da543052ea335fc924...beba25abbc34a07e07ce933210cda15202ef76cc,1,36,14,50,3,2011-08-22 18:34:55,2011-08-17 21:30:35
f67d2e82d6d2fd385d3d20e8d348eaf69dc95041...090a1a5d95c7b4380e6a52f42add41ead9215ed3,1,13,10,23,5,2011-05-31 19:22:50,2011-05-31 19:22:50
8c2be75fe117f5079087a6dfb07c573cc6716143...ccf5ace0dcfab16dca3870076e81d6ad1e294955,1,1,1,2,1,2011-05-15 22:24:36,2011-05-15 19:16:03
ccf5ace0dcfab16dca3870076e81d6ad1e294955...f4e516834ecedffc330c9735a5665104f8488055,1,7,8,15,8,2011-05-15 22:24:52,2011-05-15 19:16:29
07514c83c2b7e6de926ef758905e3f43b4de6bfa...03bb5789cd97de989897e1c9de71a2831ada0544,3,13,10,23,3,2011-03-29 21:29:17,2011-03-29 20:55:32
03bb5789cd97de989897e1c9de71a2831ada0544...c063f0a973832784f09a6901eac9501b6f796bde,1,1,6,7,2,2011-03-29 21:30:05,2011-03-29 20:56:04
c063f0a973832784f09a6901eac9501b6f796bde...304cc11c6566cf22e811aa791988c61b6d291973,3,6,6,12,6,2011-03-29 21:30:54,2011-03-29 20:56:53
304cc11c6566cf22e811aa791988c61b6d291973...3a03cf6b1d1cf5d05edec1781446a26782eaff09,3,10,4,14,7,2011-03-29 21:31:59,2011-03-29 20:57:27
3a03cf6b1d1cf5d05edec1781446a26782eaff09...7249e91287443c02b2c7eed272a579dae44984ad,2,32,5,37,4,2011-03-29 21:38:55,2011-03-29 20:57:47
7249e91287443c02b2c7eed272a579dae44984ad...92e0d42539a34e90f5c9bf29eb741f0d87173027,2,22,0,22,2,2011-03-29 21:39:24,2011-03-29 20:59:42
92e0d42539a34e90f5c9bf29eb741f0d87173027...ab18b2c0df93b518ff9591d69e5e607fee718814,2,27,12,39,7,2011-03-30 18:36:51,2011-03-30 00:57:19
ab18b2c0df93b518ff9591d69e5e607fee718814...3925b575687f64d49bd777ba6f64557a56b838b6,1,1,1,2,1,2011-04-14 19:24:18,2011-04-14 17:53:13
07514c83c2b7e6de926ef758905e3f43b4de6bfa...4e10cf9a17467c08754b36683c240fbab69156de,2,31,7,38,16,2011-03-29 19:29:10,2011-03-29 19:29:10
b15b5b10a75e202f3f90e000925545243267cbee...2b4aa89c27a5b7db37bfa992ec8500cc9f4b31a5,1,2,1,3,1,2011-09-13 15:35:38,2011-09-13 07:32:42
b15b5b10a75e202f3f90e000925545243267cbee...5a277f3ff7cb57e35ce574e93866b6c7e3bf8971,6,10,39,49,17,2011-09-06 18:10:41,2011-09-06 18:06:32
5a277f3ff7cb57e35ce574e93866b6c7e3bf8971...509d59705ee07094bcc56b49a17ba0ae983da50f,4,13,4,17,5,2011-09-06 18:41:02,2011-09-06 18:41:02
6fcb384869720ed2e9ea7de1938e44c54e56a75a...8d9185bc12650a9839dff45a8754f05618cdb3f5,1,9,15,24,3,2011-08-23 22:44:50,2011-08-23 22:43:38
2ae7345ab290ea1357c0b2f1901ef531c9f59e5b...58725efd4a0583e4a3793b054ebaf57bd40e82fa,2,4,2,6,4,2012-03-28 17:44:55,2012-03-28 11:11:28
e9e0643fe64b613b6596b79b59df8ff10746f1a1...7f684a2aff636f44a5063c05cf84c0db0460ae1a,19,97,6,103,5,2011-08-11 20:02:47,2011-08-07 18:46:13
7f684a2aff636f44a5063c05cf84c0db0460ae1a...3f4ab627146fcb1e1887198f520f39fb84fde73a,5,4,9,13,5,2011-08-11 20:02:47,2011-08-08 18:51:00
e9e0643fe64b613b6596b79b59df8ff10746f1a1...051e4005a37c4ebe8b8855e415e6c6969d68e1a3,1,98,9,107,7,2011-08-08 22:33:28,2011-08-05 20:54:06
e9e0643fe64b613b6596b79b59df8ff10746f1a1...aa0bcf962a6657226b729f263ca4b8e768ed6d5d,1,3,5,8,3,2011-08-08 18:26:40,2011-08-08 01:15:34
aa0bcf962a6657226b729f263ca4b8e768ed6d5d...a7c58f280a57ce64e058111b0adbcd6ea846cbdc,1,8,2,10,3,2011-08-08 18:28:42,2011-08-08 01:17:09
a7c58f280a57ce64e058111b0adbcd6ea846cbdc...23ce5c39dc7b530a71d26598af7d93b01d182534,1,2,2,4,2,2011-08-11 18:11:14,2011-08-11 07:05:48
e9e0643fe64b613b6596b79b59df8ff10746f1a1...070648e9b7fcea628957a0aee0aae94a9c2967ec,1,1,0,1,1,2011-08-08 16:30:12,2011-08-08 08:33:04
070648e9b7fcea628957a0aee0aae94a9c2967ec...ae8044a2f542f5803c161ee510ac14492bc468d8,1,1,0,1,1,2011-08-08 16:30:14,2011-08-08 08:33:05
ae8044a2f542f5803c161ee510ac14492bc468d8...0906f6e14e6e9df0c4ea4edb08ebe9f5d16c2391,1,1,1,2,1,2011-08-08 19:09:38,2011-08-07 02:44:43
8894d5358095a08c2f700a87ce9fdefb0b6eb61b...5879f5684cfe8a38326b4ffd078f96e35c68e640,4,7,6,13,5,2011-09-06 19:50:10,2011-09-04 10:41:59
5879f5684cfe8a38326b4ffd078f96e35c68e640...4a085b16f430bcfe1b6e2e84e7a569f4e191e906,3,28,56,84,10,2011-09-06 19:54:19,2011-09-06 19:32:30
4a085b16f430bcfe1b6e2e84e7a569f4e191e906...f950eb956092831730182daa7160eaa352277fa9,6,15,12,27,7,2011-09-12 21:38:32,2011-09-04 10:42:01
48015465287eb5a1240786ae5d0eba67903aa43e...e8e1c29021da446d0c50573ef9619bf74f515c20,1,1,3,4,2,2011-10-27 19:06:44,2011-10-27 19:06:44
50b68aeb392537a730a86349293acf046a778b74...4bfe7cb6668c43c1136304bbb17eea1b3ddf0237,1,1,49,50,2,2011-08-16 21:23:43,2011-08-16 21:23:43
ec48d4bb7f3ca1429809500eae2867fdbcda3338...b31d20227a4e3c71cf545d2142996e27cacadcec,1,5,7,12,1,2011-03-03 23:45:10,2011-03-03 12:34:51
b31d20227a4e3c71cf545d2142996e27cacadcec...964498e7f90bc5d822746bbf953fb66c6b01ac1c,1,1,1,2,1,2011-03-04 18:05:00,2011-03-03 09:28:30
e3d3f7d204c46c034ce71d8116ac21ef613fb263...6e7293e3ed0e29fd55bb2b4b1224613e4f38fed0,1,1,1,2,1,2011-02-27 23:34:54,2011-02-27 15:50:10
6e7293e3ed0e29fd55bb2b4b1224613e4f38fed0...e5ea66f9e545588c92cf228cca16f0b52d467bb5,1,5,1,6,4,2011-02-27 23:36:33,2011-02-27 16:58:32
046613c5465e4fc0611f93a5ef31d3815fb50c22...80152b09438f757a2beefd632f13dc0628c11418,1,1,1,2,1,2011-03-11 06:38:48,2011-03-10 18:12:28
80152b09438f757a2beefd632f13dc0628c11418...1d66ec587e7d903afdf12a81718772a9eadc15a1,1,16,13,29,5,2011-03-11 06:38:50,2011-03-10 18:12:29
046613c5465e4fc0611f93a5ef31d3815fb50c22...88a21979c5717e3f37b9691e90b6dbf2b94c751a,6,243,17,260,26,2011-03-09 21:10:35,2011-03-06 22:10:46
88a21979c5717e3f37b9691e90b6dbf2b94c751a...8f0700dd33f63e594b9b34c84efe94e670ea4f45,7,114,10,124,13,2011-03-09 21:10:35,2011-03-06 22:11:21
8f0700dd33f63e594b9b34c84efe94e670ea4f45...1fb2550202d6f88d90121624c1fac0b81ff8c33f,3,36,4,40,3,2011-03-09 21:10:35,2011-03-06 22:11:48
1fb2550202d6f88d90121624c1fac0b81ff8c33f...bf42b384058ee2b34f587426d0788353ffa9012a,4,38,5,43,7,2011-03-09 21:10:35,2011-03-06 22:12:19
bf42b384058ee2b34f587426d0788353ffa9012a...c16c3e40b5908ecf28be12b1caf266c7ab8de3c6,3,49,2,51,4,2011-03-09 21:10:35,2011-03-06 22:12:58
c16c3e40b5908ecf28be12b1caf266c7ab8de3c6...e5f522d610d34914e3fcf8b23de1b771c467196e,2,24,1,25,3,2011-03-09 21:10:35,2011-03-06 22:13:36
e5f522d610d34914e3fcf8b23de1b771c467196e...794a3592ad9d8a9b273f6496052bbcb46b1924ed,2,18,0,18,2,2011-03-09 21:10:36,2011-03-06 22:14:15
046613c5465e4fc0611f93a5ef31d3815fb50c22...aa03f60463129194d328035f9974be4fa951dd44,4,117,118,235,52,2011-02-28 20:42:23,2011-02-27 11:31:37
aa03f60463129194d328035f9974be4fa951dd44...ffe6dc081aa23d56e6306d143d99ca508db38c5e,5,24,6,30,8,2011-02-28 20:42:38,2011-02-27 11:32:46
046613c5465e4fc0611f93a5ef31d3815fb50c22...8dc6a373d201839859fe7924b63e57526ee2fc22,3,303,14,317,18,2011-02-26 10:57:58,2010-12-02 10:40:20
046613c5465e4fc0611f93a5ef31d3815fb50c22...ab8632ae36d2e5faf524309696725b60ec18e588,2,4,1,5,2,2011-02-26 09:06:50,2011-02-26 05:08:25
ab8632ae36d2e5faf524309696725b60ec18e588...ebeb60900fbab569ed14f710a0a1abb1637ec792,5,25,63,88,23,2011-02-26 09:06:50,2011-02-26 05:08:53
ebeb60900fbab569ed14f710a0a1abb1637ec792...26db0f2e3afc043e184a5e0ce5eb7c53aeb1f644,1,10,1,11,1,2011-03-08 20:02:31,2011-03-08 08:33:44
046613c5465e4fc0611f93a5ef31d3815fb50c22...c9dbab045dea3dc44b81bfaca957fd8c3c7f079b,1,1,1,2,1,2011-02-26 07:39:41,2011-02-26 02:31:13
0f360763c02d1230614e23f94fb298dab0162aa0...d3f2475c01d9e90dbadacbe2c35854f6d11e6409,1,5,2,7,2,2012-03-26 17:28:55,2012-03-23 11:31:39
d3f2475c01d9e90dbadacbe2c35854f6d11e6409...36384c979da7129393462c2208fd156b1453debd,1,6,0,6,1,2012-03-26 17:46:07,2012-03-23 12:38:42
36384c979da7129393462c2208fd156b1453debd...a12c6b0149e3dadd0701dac4fd0ba2463d251650,1,2,0,2,2,2012-03-26 19:06:48,2012-03-26 02:41:42
b52ab19d91015ebd6bebc83a82b2c3d64b948b36...cb2ed324fc917db0b79d7b1f3756575ffa5f70d5,4,18,4,22,7,2012-04-02 20:07:58,2012-04-02 20:07:58
56a33c8f1bb5cef11ddf046f7b570f527ea77d37...213639494e897502b73648aebbf274e4ae0cb27e,1,17,0,17,1,2012-03-09 19:39:51,2012-03-09 12:43:55
56a33c8f1bb5cef11ddf046f7b570f527ea77d37...1cbc32403b20f064ec7c295c6603f6fd16662bce,2,6,1,7,2,2012-03-08 19:38:09,2012-03-08 08:54:54
1cbc32403b20f064ec7c295c6603f6fd16662bce...561ae0673569f43a92ea6b0776ae0f4c01472dca,2,14,1,15,3,2012-03-08 20:07:50,2012-03-08 08:54:55
ee6dfb2d83ba1b057943e705f707fa27e34e47f9...a3ed7552d6c800b476a3bdfec5fa575295ea4bdf,1,3,1,4,2,2011-11-07 04:31:28,2011-11-07 02:59:23
a3ed7552d6c800b476a3bdfec5fa575295ea4bdf...473935188cc9b0363b30553f23d816231a66cb44,1,2,7,9,3,2011-11-07 04:31:28,2011-11-07 02:59:24
473935188cc9b0363b30553f23d816231a66cb44...c9486eb04dd99fc00df3e68f9b908f9ad7ff9728,3,39,21,60,11,2011-11-07 04:31:28,2011-11-07 02:59:25
c9486eb04dd99fc00df3e68f9b908f9ad7ff9728...1e49f22f07881dffc04f8f09d4ad4e4a65b85b09,4,61,7,68,27,2011-11-07 04:31:28,2011-11-07 02:59:26
47f16e8b110d84bacb586a1b7183ee4bb781c980...be1b0558777dafa7b8993bc371cbe4078350e4e9,2,2,2,4,2,2010-12-02 19:30:35,2010-12-02 19:23:50
40701adbcbbc1e3e4485562a36343f4781e62be5...debf29dc2921e12c4fa8205d894741a694f0c4fc,1,1,1,2,1,2012-10-12 15:43:12,2012-10-11 20:40:35
40701adbcbbc1e3e4485562a36343f4781e62be5...55c61688ea1e41f4a8c26f957bf1bc43cd39ed97,4,51,17,68,21,2012-10-12 15:24:44,2012-10-12 10:49:38
40701adbcbbc1e3e4485562a36343f4781e62be5...e481af06be6fa112cec9f53fabd51d3b4cc6c64d,1,43,6,49,5,2012-10-11 18:54:49,2012-10-11 03:54:03
40701adbcbbc1e3e4485562a36343f4781e62be5...3facc60031a5b860cae8cb26957e5b4e80820c34,1,25,0,25,2,2012-10-11 18:50:00,2012-10-11 03:22:36
12b1443c2cf41174311c81667022c6f3149aa542...ac593b76dde42fa8340fb60e7d6fc315a5be7c40,1,2,2,4,1,2012-01-04 17:54:06,2012-01-04 10:07:45
12b1443c2cf41174311c81667022c6f3149aa542...53c632faab0be2e8510a678a4b7dfa01dc7f41e1,1,1,1,2,1,2011-10-21 21:46:38,2011-10-21 19:04:21
12b1443c2cf41174311c81667022c6f3149aa542...0368c492d664775924388b18494eeb4690692ab8,1,97,44,141,18,2011-04-29 21:21:48,2011-04-29 17:51:57
0368c492d664775924388b18494eeb4690692ab8...4b9447f98ef8699450fa0276d212167a25667d7f,1,9,3,12,4,2011-04-29 21:21:48,2011-04-29 17:51:58
16529f2e5630d3d155e4dff0ebd3c7c5daa882f9...9ca1169fd92c71ebbef92ff18aa5d91a2157d1bd,4,8,9,17,7,2010-12-07 00:51:36,2010-12-06 07:57:42
9ca1169fd92c71ebbef92ff18aa5d91a2157d1bd...1e5ce570ca368b97c8e3b238bb0228c5ca41b494,1,11,12,23,4,2010-12-07 22:15:12,2010-12-02 06:01:18
1e5ce570ca368b97c8e3b238bb0228c5ca41b494...a02dd4ff7dd79eb6aa39b00c90c293e3c3d10b4c,1,7,7,14,2,2010-12-07 22:17:49,2010-12-02 06:05:05
a02dd4ff7dd79eb6aa39b00c90c293e3c3d10b4c...5c400ed2e05070d79b6cd9438ff5607ec0a83589,1,13,0,13,1,2010-12-07 22:19:10,2010-12-02 06:08:57
5c400ed2e05070d79b6cd9438ff5607ec0a83589...c1f4ec9ef45232d6dbdea4c417a9d41eb8ad7f4f,1,2,17,19,1,2010-12-07 22:19:32,2010-12-01 23:30:40
c1f4ec9ef45232d6dbdea4c417a9d41eb8ad7f4f...b57c68a69e028cc41eb01404dc4446a463c0e464,1,2,1,3,1,2010-12-07 22:19:32,2010-12-01 23:31:36
b57c68a69e028cc41eb01404dc4446a463c0e464...b0b3a8b666ac9bcab93c9b05ca7de918d7fa18bc,2,10,1,11,4,2010-12-07 22:19:32,2010-12-01 23:32:16
b0b3a8b666ac9bcab93c9b05ca7de918d7fa18bc...979240fee32628c317998f3c3fe2619cf01decc2,2,3,1,4,3,2010-12-07 22:19:32,2010-12-01 23:32:55
979240fee32628c317998f3c3fe2619cf01decc2...f07d6a1ad1485bcb3078f4601943d81f915c5af6,2,4,1,5,3,2010-12-07 22:19:32,2010-12-01 23:33:22
f07d6a1ad1485bcb3078f4601943d81f915c5af6...309be813c9b75fed70f3a03bf803bf47c6670cfc,1,243,149,392,12,2010-12-07 22:19:32,2010-12-01 23:34:06
16529f2e5630d3d155e4dff0ebd3c7c5daa882f9...d43e90732bbc8eae6cbfd18f61ca6c82c8920732,1,8,8,16,8,2010-11-29 22:03:07,2010-11-28 04:36:38
e674c17db25750f14c1dd1d8f588eb3135b5cea9...339e5638b0a11ea3218214ffb57732098c3705df,1,19,3,22,1,2011-02-17 23:50:37,2011-02-17 12:38:52
e674c17db25750f14c1dd1d8f588eb3135b5cea9...2d59ced10418f60914f353031215ecc6adcef204,1,5,1,6,2,2010-10-18 23:20:19,2010-10-16 18:37:01
2d59ced10418f60914f353031215ecc6adcef204...8ac3ed27d4ca6b3c89c51e4d90e2e7be5de5ab15,1,38,0,38,2,2010-10-18 23:20:19,2010-10-16 18:37:02
8ac3ed27d4ca6b3c89c51e4d90e2e7be5de5ab15...d7c411b71d727600d2f031fec9723873ae93c1c7,4,7,2,9,6,2010-10-18 23:20:19,2010-10-16 18:37:03
2794ad524462c4e2ecd4573d650e7b4f8da89a5d...5edde510181357b0d0376d5542ddfa51a7e7ba12,2,53,4,57,9,2010-10-18 23:41:27,2010-10-18 01:03:38
5edde510181357b0d0376d5542ddfa51a7e7ba12...3421578393a5983db6fa76a203c9dee95c74801d,2,55,9,64,6,2010-10-18 23:42:26,2010-10-18 01:08:53
3421578393a5983db6fa76a203c9dee95c74801d...971728c853f8fcdfcecd768c74010965c383c431,1,42,1,43,2,2010-10-20 05:55:15,2010-10-18 01:44:04
971728c853f8fcdfcecd768c74010965c383c431...b21241253bf1216bd31d24d27446895ea17b1a08,1,1,4,5,2,2010-10-20 21:35:58,2010-10-20 20:25:58
c3fced64981e3d2700d83c0a6661ac347df5121e...2e5955f328a0787c08c69ffb584e8021bb5be818,1,2,0,2,2,2010-11-03 22:20:33,2010-11-03 20:55:48
c3fced64981e3d2700d83c0a6661ac347df5121e...a7eff1a87ad8cdcb93f60efc7969042bc3e669ee,2,20,4,24,5,2010-11-03 19:51:26,2010-11-03 06:26:24
a7eff1a87ad8cdcb93f60efc7969042bc3e669ee...98dbe63dbcb44218e23ccc92e1491c36b2e31945,2,42,11,53,15,2010-11-03 19:51:28,2010-11-03 06:26:25
c3fced64981e3d2700d83c0a6661ac347df5121e...af77aee9cac51c2036e6019b4aebec2049f03e6b,1,7,7,14,1,2010-10-29 17:16:35,2010-10-29 15:33:54
d4c436975214d8f94d38f9be0ef709b4714fc821...28d836c81586e6b49131c69bbc5228a41667f1da,2,15,1,16,4,2010-10-26 18:25:48,2010-10-14 08:53:36
5b57413cb3952654031115f6f840e3dcb120914e...5df4d67d4156ec7cd37089aeb3d5f66ee857a01a,1,29,3,32,1,2010-10-21 22:21:05,2010-10-21 14:30:35
5df4d67d4156ec7cd37089aeb3d5f66ee857a01a...0fe802d4808aef3f0366c7029318f872c86ccca2,1,76,28,104,2,2010-11-10 00:37:40,2010-11-09 04:58:20
5b57413cb3952654031115f6f840e3dcb120914e...a471833d51b0902d68f9190157bf1421d19a951a,2,77,44,121,10,2010-10-20 23:10:14,2010-10-20 22:17:25
a471833d51b0902d68f9190157bf1421d19a951a...cfd1a9849cdb4b9c7fcd0cb71a28cbdbc3494329,2,41,3,44,4,2010-10-20 23:10:15,2010-10-20 22:17:26
5b57413cb3952654031115f6f840e3dcb120914e...598df7bcb775a247cc3f20c5a8b1b36955b16462,1,1,1,2,1,2010-10-20 20:01:33,2010-10-20 05:57:11
38a18873b21f6f2eebedc65aff2249fd6ec2168c...1b8cdce94f4fff2408f8ed26fe4fc2f187a46794,4,38,13,51,16,2010-10-19 19:00:28,2010-10-16 06:57:51
f77bccaeba7a4c542e9b89d144af74bddd36fd08...c8ba163916554e9ffd3ce8cb2beeff003d90c0c3,4,44,0,44,10,2011-06-22 18:25:20,2011-06-09 15:55:23
c8ba163916554e9ffd3ce8cb2beeff003d90c0c3...615ff912c5b30f70d5b0d1f6d6764327a3ecd337,1,2,12,14,2,2011-06-22 18:25:20,2011-06-09 15:55:59
615ff912c5b30f70d5b0d1f6d6764327a3ecd337...2496844bb2e5410019bf51c10b1f3068b621fa27,2,4,2,6,2,2011-06-22 18:25:21,2011-06-09 15:56:42
2496844bb2e5410019bf51c10b1f3068b621fa27...84054f79de35015fc92f73ec4780102dd820e452,3,71,1,72,6,2011-06-22 18:25:21,2011-06-09 20:56:19
4a1c26951610fa1d2b9f8d9f7c85979bed856c94...d78e5aecf931967bbaa4a8601cd40a5359e80e24,1,7,0,7,1,2011-10-03 21:57:36,2011-10-03 18:13:38
d8ead15963890a42f99fd0e7f3192b55cacd9404...695576fddd039b2fdc3cad52bbaab4d89e27b71c,2,37,1,38,2,2011-08-14 21:19:31,2011-08-12 05:19:34
695576fddd039b2fdc3cad52bbaab4d89e27b71c...58040239f59004f71d9ae70d0fcd9e0d4f6a3259,1,39,0,39,1,2011-08-14 21:19:31,2011-08-12 05:19:35
58040239f59004f71d9ae70d0fcd9e0d4f6a3259...7b4ed5941c0d2143cb4467a9e265993121b62ce7,1,61,0,61,1,2011-08-14 21:19:31,2011-08-12 05:19:36
7b4ed5941c0d2143cb4467a9e265993121b62ce7...a0551f212edd13e3df0d3dcd5abf148e0f003e59,1,65,0,65,1,2011-08-14 21:19:31,2011-08-12 05:19:37
a0551f212edd13e3df0d3dcd5abf148e0f003e59...ac6e839241009459b46e860f9d7fc524bb9ecc0b,1,141,0,141,1,2011-08-14 21:19:31,2011-08-12 05:19:38
ac6e839241009459b46e860f9d7fc524bb9ecc0b...f0b75fcc810abaca317f7d82d25c538da95c6987,1,102,0,102,1,2011-08-14 21:19:32,2011-08-12 05:19:39
f0b75fcc810abaca317f7d82d25c538da95c6987...c6966068fb4d2a2daa130202eeabfd2f08b51fa5,1,125,0,125,1,2011-08-14 21:19:32,2011-08-12 05:19:40
c6966068fb4d2a2daa130202eeabfd2f08b51fa5...fe7e9c23e4ef183eaff5256a7ce681296f3a92f6,1,83,0,83,1,2011-08-14 21:19:32,2011-08-12 05:19:41
fe7e9c23e4ef183eaff5256a7ce681296f3a92f6...96b079e5c94b6881335ab1cd9a3d88ee877da96e,1,83,0,83,1,2011-08-14 21:19:32,2011-08-12 05:19:42
96b079e5c94b6881335ab1cd9a3d88ee877da96e...827f2b7d297dfbe20809c0be600827834c2c3992,1,159,0,159,2,2011-08-14 21:19:32,2011-08-12 05:19:43
827f2b7d297dfbe20809c0be600827834c2c3992...a0d3311624638bf3043f2c442e698b14c5fb2d02,1,88,0,88,1,2011-08-14 21:19:33,2011-08-12 05:19:44
a0d3311624638bf3043f2c442e698b14c5fb2d02...0b35deb378ee471f64e1b376d722e0bdd97d5e36,1,77,0,77,1,2011-08-14 21:19:33,2011-08-12 05:19:45
0b35deb378ee471f64e1b376d722e0bdd97d5e36...5b5261baab2571a207c4b7d3d9a7f583b08a7af0,1,1,0,1,1,2011-08-14 21:19:33,2011-08-12 05:19:46
5b5261baab2571a207c4b7d3d9a7f583b08a7af0...f1a0f457b3d3cf3b4acea2addc1e26e7b931d474,1,63,0,63,1,2011-08-14 21:19:33,2011-08-12 05:19:47
f1a0f457b3d3cf3b4acea2addc1e26e7b931d474...7dd9c304be5f9299d7b4b8ddb59072f774ecf081,1,27,0,27,1,2011-08-14 21:19:33,2011-08-12 05:19:48
7dd9c304be5f9299d7b4b8ddb59072f774ecf081...c43ba42e8d3b3b85e322c36d35053f650835ce0a,1,1,1,2,1,2011-08-14 21:19:34,2011-08-12 05:19:49
c43ba42e8d3b3b85e322c36d35053f650835ce0a...abafc88e76dc731e340b8ec0674b38b05d43b4f7,1,1,1,2,1,2011-08-14 21:19:34,2011-08-12 05:19:50
abafc88e76dc731e340b8ec0674b38b05d43b4f7...0c05942087a14be4560d09299fb57117308a69d5,1,10,9,19,3,2011-08-14 21:19:34,2011-08-12 05:19:51
0c05942087a14be4560d09299fb57117308a69d5...650467cf89e61815cfa1c942544a3659eda88aeb,1,9,18,27,6,2011-08-14 21:19:34,2011-08-12 05:19:52
650467cf89e61815cfa1c942544a3659eda88aeb...3d6b8e884c45e65e0abda431690cd4b3bcaf04f0,1,12,8,20,10,2011-08-14 21:19:34,2011-08-12 05:19:53
3d6b8e884c45e65e0abda431690cd4b3bcaf04f0...0b30e8125130a78bc7c0e13e7f45ba105bd206b8,1,7,0,7,1,2011-08-14 21:19:34,2011-08-12 05:19:54
0b30e8125130a78bc7c0e13e7f45ba105bd206b8...7b1c610f84a46fa237627b3307707afb520e555c,2,4,2,6,3,2011-08-14 21:19:34,2011-08-12 05:19:55
7b1c610f84a46fa237627b3307707afb520e555c...f0fd4d05e8a17fe5ccdd4d3edd686bc6702b8144,2,53,13,66,12,2011-08-14 21:19:34,2011-08-12 05:19:56
f0fd4d05e8a17fe5ccdd4d3edd686bc6702b8144...f2507b4e0ef0b7fc8c1e75004e8a86a0430dc512,1,34,15,49,14,2011-08-14 21:19:35,2011-08-12 05:19:57
f2507b4e0ef0b7fc8c1e75004e8a86a0430dc512...70cc3d36eba58f8bf177c91d82781fb727a9a4fa,2,25,16,41,8,2011-08-14 21:19:35,2011-08-12 05:19:58
70cc3d36eba58f8bf177c91d82781fb727a9a4fa...aacb82de3ff8ae7b0a9e4cfec16c1807b6c315ef,1,8,3,11,3,2011-08-14 21:19:35,2011-08-12 05:19:59
aacb82de3ff8ae7b0a9e4cfec16c1807b6c315ef...86d4b528d8a4752cc689279fb6d38c8697a507bb,3,20,0,20,4,2011-08-14 21:19:35,2011-08-12 05:20:00
86d4b528d8a4752cc689279fb6d38c8697a507bb...ed0148a520ec2ec88f0574c2e107aba0a46936e1,2,23,5,28,6,2011-08-14 21:19:36,2011-08-12 05:20:01
ed0148a520ec2ec88f0574c2e107aba0a46936e1...b8ddf16424f2d4f29a73b89dabbb764763744abe,1,17,18,35,10,2011-08-14 21:19:36,2011-08-12 05:20:02
b8ddf16424f2d4f29a73b89dabbb764763744abe...531357a4cc2b93ec68099890b835f50e462ceab7,2,3,2,5,2,2011-08-14 21:19:36,2011-08-12 05:20:03
531357a4cc2b93ec68099890b835f50e462ceab7...0a6b87126e6a4e2649f6da23db67eeaad11d102e,2,57,30,87,11,2011-08-14 21:19:37,2011-08-12 05:20:04
0a6b87126e6a4e2649f6da23db67eeaad11d102e...7769a75e96f998b2f1ef51e8a2e88058f56fa519,1,11,0,11,3,2011-08-14 21:19:37,2011-08-12 05:20:05
7769a75e96f998b2f1ef51e8a2e88058f56fa519...51931bf08e7de1f597d36bc2fd38b5310b6da7dd,3,25,8,33,9,2011-08-14 21:19:37,2011-08-12 05:20:06
51931bf08e7de1f597d36bc2fd38b5310b6da7dd...edd2faf52eda344eca2c01bc0b1d9f7f2f002a42,1,57,131,188,11,2011-08-14 21:19:37,2011-08-12 05:20:07
edd2faf52eda344eca2c01bc0b1d9f7f2f002a42...4f66dade81c2ebc6e1143b6c116960bfcd837067,1,66,68,134,28,2011-08-14 21:19:37,2011-08-12 05:20:08
4f66dade81c2ebc6e1143b6c116960bfcd837067...3c217c077a86d9ae06ed26bb0baa4475d0e28a0e,3,97,8,105,9,2011-08-14 21:19:37,2011-08-12 05:20:09
3c217c077a86d9ae06ed26bb0baa4475d0e28a0e...5b448b8530308b1f5a7a721cb1bf0ba557b5c78d,2,18,5,23,6,2011-08-14 21:19:37,2011-08-12 05:20:10
5b448b8530308b1f5a7a721cb1bf0ba557b5c78d...ec61d14963470b02db0d6e3825e2b5bbb1815cb6,2,26,16,42,10,2011-08-14 21:19:38,2011-08-12 05:20:11
ec61d14963470b02db0d6e3825e2b5bbb1815cb6...6bdaead1e58ab2aa3ea81a998117d1d5afb41a3b,1,37,35,72,6,2011-08-14 21:19:38,2011-08-12 05:20:12
6bdaead1e58ab2aa3ea81a998117d1d5afb41a3b...c52ff85d97c698c902870305a010e2303e297b87,2,14,18,32,5,2011-08-14 21:19:38,2011-08-12 05:20:13
c52ff85d97c698c902870305a010e2303e297b87...a99b7f2256ebd2d1db59c578f3da003e36f259c4,1,27,33,60,13,2011-08-14 21:19:38,2011-08-12 05:20:14
a99b7f2256ebd2d1db59c578f3da003e36f259c4...461f5041178c02f3360920f42b542df7add0033f,1,62,42,104,18,2011-08-14 21:19:38,2011-08-12 05:20:15
461f5041178c02f3360920f42b542df7add0033f...232c635f7e22acb2ddf526753fdcd3d3718afe99,1,39,3,42,7,2011-08-14 21:19:38,2011-08-12 05:20:16
232c635f7e22acb2ddf526753fdcd3d3718afe99...dac4741554e7672e69d1bc6b4f912cd16ad83b38,1,33,9,42,4,2011-08-14 21:19:38,2011-08-12 05:20:17
dac4741554e7672e69d1bc6b4f912cd16ad83b38...434b8525e7a68893106f6360ff0a261f03c37512,3,32,38,70,11,2011-08-14 21:19:39,2011-08-12 05:20:18
434b8525e7a68893106f6360ff0a261f03c37512...b70332520d2ba0f32b5006feff86d71242061011,2,50,36,86,6,2011-08-14 21:19:39,2011-08-12 05:20:19
b70332520d2ba0f32b5006feff86d71242061011...e03acb8bc1f03827210235dd72578b8b26f19c51,1,31,17,48,2,2011-08-14 21:19:39,2011-08-12 05:20:20
e03acb8bc1f03827210235dd72578b8b26f19c51...1ac91b32b5f153a91c10fb236a3769541be60ae9,2,20,3,23,3,2011-08-14 21:19:39,2011-08-12 05:20:21
1ac91b32b5f153a91c10fb236a3769541be60ae9...3672c971483020ba5255576aec0be670c76d019b,2,58,26,84,7,2011-08-14 21:19:39,2011-08-12 05:20:22
3672c971483020ba5255576aec0be670c76d019b...814f7d902b6bcbb67ff8efa5e75eceb7b5fcc0d8,1,5,2,7,4,2011-08-14 21:19:39,2011-08-12 05:20:23
814f7d902b6bcbb67ff8efa5e75eceb7b5fcc0d8...3f680ff0cf41c80b5c3a7ef4e7b417c0aa788dfb,1,26,0,26,1,2011-08-14 21:19:39,2011-08-12 05:20:24
3f680ff0cf41c80b5c3a7ef4e7b417c0aa788dfb...f53d39778cf41cc93aa140bb41bb7d3a6590e179,2,21,15,36,9,2011-08-14 21:19:40,2011-08-12 05:20:25
f53d39778cf41cc93aa140bb41bb7d3a6590e179...3e333a6146ce6565de357e48e439bb94c622d3fe,1,91,0,91,1,2011-08-14 21:19:40,2011-08-12 05:20:26
3e333a6146ce6565de357e48e439bb94c622d3fe...35a74abff32c32c455a74974130ad2af7d81dfd9,2,27,9,36,6,2011-08-14 21:19:40,2011-08-12 05:20:27
35a74abff32c32c455a74974130ad2af7d81dfd9...b630b8147055a6fd56edfdf3ba85e9dea27dd397,1,69,0,69,1,2011-08-14 21:19:40,2011-08-12 05:20:28
b630b8147055a6fd56edfdf3ba85e9dea27dd397...6d63070cacf88cd03b4bc73fd64fea046accd450,2,22,3,25,3,2011-08-14 21:19:40,2011-08-12 05:20:29
6d63070cacf88cd03b4bc73fd64fea046accd450...f701aae0774f4517b46dd866812c269c78f1e198,1,12,4,16,5,2011-08-14 21:27:48,2011-08-13 02:23:51
d8ead15963890a42f99fd0e7f3192b55cacd9404...daab4eeafa0dc620d67ccb57c28e08f6f8b3868c,1,1,1,2,1,2011-06-19 21:46:39,2011-06-19 08:03:26
d8ead15963890a42f99fd0e7f3192b55cacd9404...93a6ad16a64acd0970799adc5039df3455f2d4f9,1,3,6,9,1,2011-06-15 16:46:07,2011-06-15 06:10:08
a6605d76cdad37ed3c55a7be4d2e0af0f4721bb2...08303c3636ef750bfafd1c47f363120cb439b367,3,58,10,68,5,2011-06-06 01:10:50,2011-06-05 15:24:15
08303c3636ef750bfafd1c47f363120cb439b367...a8f0e7649eba3ce78e1f09fc4dcbb2c3fcc3d866,5,40,3,43,7,2011-06-06 01:15:26,2011-06-05 15:24:25
a8f0e7649eba3ce78e1f09fc4dcbb2c3fcc3d866...1d84f72ef1dee1f851e11a6d92e8ab3f1979b2a2,5,49,1,50,6,2011-06-06 01:15:27,2011-06-05 15:24:36
a6605d76cdad37ed3c55a7be4d2e0af0f4721bb2...bcfb95dde46bd7cf2c6673ab8a3e6f0c0429906e,2,13,0,13,4,2011-06-03 16:29:19,2011-06-02 20:31:25
a6605d76cdad37ed3c55a7be4d2e0af0f4721bb2...cee694d0126c8990a52c6cbfb68bb67491812c42,2,113,116,229,3,2011-06-02 18:14:21,2011-06-02 14:55:52
cee694d0126c8990a52c6cbfb68bb67491812c42...560869e32103945f680e0f390fc2062e66b3d04a,1,13,6,19,2,2011-06-02 18:16:56,2011-06-02 14:55:53
560869e32103945f680e0f390fc2062e66b3d04a...80b4dfeeb2512d5b6d44b7f6eb72b77222072ec2,1,15,15,30,2,2011-06-03 17:00:24,2011-06-03 16:31:48
0b0cd0e0a29a139f418991dd769ea4266ffec370...f864f2615b76e5d74518c482ceeef3a2589017fe,1,1,1,2,1,2010-12-07 00:57:48,2010-12-06 10:20:11
f864f2615b76e5d74518c482ceeef3a2589017fe...f188e33e8a4112ce26cee94f5533f5459e62879f,1,5,1,6,3,2010-12-07 21:12:06,2010-10-10 05:50:32
fbfe5de5bdaaf9572c1811e3b4ddfaa35e6bb227...5d7da9a94489da0db3b3c7b766606b80fc71becf,1,2,1,3,1,2012-06-14 17:59:09,2012-06-14 09:37:58
5d7da9a94489da0db3b3c7b766606b80fc71becf...0e59a6f6018182e6648789904672b738a944a524,1,37,37,74,2,2012-06-14 17:59:15,2012-06-14 09:37:59
0e59a6f6018182e6648789904672b738a944a524...32663b22418bb394d71012d17e4954217c02752f,1,1,1,2,1,2012-06-14 17:59:16,2012-06-14 09:38:00
ca4effd8bce5e0dfce7ce1425074475c8643b7f0...941cab3a78a3fd3d21ba3acb3f8da3407a692015,1,1,0,1,1,2012-06-17 21:01:42,2012-05-24 13:57:26
941cab3a78a3fd3d21ba3acb3f8da3407a692015...785ee4960c3d334cbc2b17ab74d2cebdf1b4db64,4,16,3,19,5,2012-06-17 21:04:15,2012-06-17 21:04:15
04ab6ae7765700375e9442347430fc3a6de40f81...fe77b416c774a469a585c4b58fcae5e7a5f3545d,5,8,6,14,8,2012-06-08 15:31:52,2012-06-07 21:03:23
47829ed0105c863efb8cc304d09edf14283b32d9...3fe4498197ced84886b4adaddf18f1109b477f8e,2,2,7,9,3,2012-06-03 22:56:05,2012-06-03 22:56:05
745c7c8e6252ba41430a1442e1fa8da2ec40e9c2...ff5effdf455bd6e694ff0bb3e0793515a2214adb,6,38,6,44,14,2012-08-03 20:03:34,2012-08-03 16:19:16
ff5effdf455bd6e694ff0bb3e0793515a2214adb...ca8e127c9bd65b07a565ca00aff8e0a48628bfc3,1,1,1,2,1,2012-08-10 19:26:42,2012-08-10 07:57:31
ca8e127c9bd65b07a565ca00aff8e0a48628bfc3...d50c3871632451b0cac066eea178198ac8a9dff1,2,15,4,19,8,2012-08-10 19:35:13,2012-08-10 07:57:43
d50c3871632451b0cac066eea178198ac8a9dff1...74991a98df79ff3702dcb3b5c22c7b9ec20cfead,1,6,0,6,1,2012-08-10 21:27:52,2012-08-10 21:27:52
74991a98df79ff3702dcb3b5c22c7b9ec20cfead...9442710801b0b7b9aeefe60408d1835af138cfcc,2,39,10,49,4,2012-08-14 04:52:36,2012-08-14 01:59:27
9442710801b0b7b9aeefe60408d1835af138cfcc...36c60f7a08b28e2cee649d697291ac6b708b213f,1,8,1,9,3,2012-08-14 04:56:05,2012-08-14 02:02:10
745c7c8e6252ba41430a1442e1fa8da2ec40e9c2...fc890030c1430ead948e96ccd3839832cc3e7246,1,4,4,8,8,2012-06-20 19:57:41,2012-06-20 18:30:08
fc890030c1430ead948e96ccd3839832cc3e7246...b8ba629264b85a2daf0df9c61d00873988d006b7,1,16,29,45,16,2012-06-20 19:57:42,2012-06-20 18:30:56
b8ba629264b85a2daf0df9c61d00873988d006b7...60d24dd2556f8b6020f9de37af3ec292c9f3769d,1,25,37,62,9,2012-07-09 14:56:28,2012-07-07 03:39:18
60d24dd2556f8b6020f9de37af3ec292c9f3769d...eea8c32b92ab7eb49202cd1cf29bb652a0ca02fb,1,0,1,1,1,2012-07-09 14:57:29,2012-06-20 18:31:18
eea8c32b92ab7eb49202cd1cf29bb652a0ca02fb...c0219dd5d8cd11ea7a112081efd1db59d0bec105,1,2,2,4,2,2012-07-09 14:57:29,2012-06-20 18:31:33
c0219dd5d8cd11ea7a112081efd1db59d0bec105...47eb28ec0cdb372f4354800e2e0ec713ad4c1992,1,0,1,1,1,2012-07-09 14:57:29,2012-06-20 18:31:42
47eb28ec0cdb372f4354800e2e0ec713ad4c1992...620c293abdc36f3db18edd61a622eae30f01ce8e,2,10,2,12,5,2012-07-09 14:57:29,2012-06-20 18:31:51
620c293abdc36f3db18edd61a622eae30f01ce8e...33ddbcb01208f93c20ac4b904ad3d76777144882,1,0,1,1,1,2012-07-09 15:56:37,2012-07-07 04:42:11
33ddbcb01208f93c20ac4b904ad3d76777144882...be1dbd0a933749526eb763fd00cd00c0bdf7c7a6,2,23,8,31,13,2012-07-09 15:57:52,2012-06-20 18:31:55
be1dbd0a933749526eb763fd00cd00c0bdf7c7a6...2b9391bc675f5435aee0ec9dc3a725c81591bf2d,1,0,3,3,3,2012-07-09 15:57:52,2012-06-20 18:32:10
2b9391bc675f5435aee0ec9dc3a725c81591bf2d...e4dd89ab98466e4d8e5fdadb0576f7e074992f48,2,14,3,17,5,2012-07-09 15:57:52,2012-06-20 18:32:16
e4dd89ab98466e4d8e5fdadb0576f7e074992f48...b5295f322c8828e913a3ef126ddffc6862235b03,1,6,8,14,3,2012-07-09 15:57:52,2012-06-20 18:32:19
b5295f322c8828e913a3ef126ddffc6862235b03...520a6cdce3531867110df012d62d4974376eba1f,1,4,9,13,5,2012-07-09 15:57:52,2012-06-20 18:32:22
520a6cdce3531867110df012d62d4974376eba1f...7b63c77eeea7cc4bf3d29793bcb95dcf659e5126,1,33,0,33,1,2012-07-09 15:57:52,2012-07-07 04:19:09
d691f47942f778cc308b902ae4eb1b588bfd864f...9e383e8807dd65e9eb20d4a1316315eb974303ad,1,264,250,514,222,2012-06-04 06:25:25,2012-06-02 00:37:40
d691f47942f778cc308b902ae4eb1b588bfd864f...f88416b2a4f321a806ff54a0639e4fd7a4f39fa2,1,1855,441,2296,359,2012-06-02 14:49:40,2012-05-18 16:29:52
f88416b2a4f321a806ff54a0639e4fd7a4f39fa2...65752f94d15f7d38b5478aedda11a5ed75530eb1,1,201,20,221,15,2012-06-02 14:49:40,2012-05-23 16:53:40
65752f94d15f7d38b5478aedda11a5ed75530eb1...16abda814b819b46fe35e940729d7eb7466a5f70,1,247,227,474,214,2012-06-02 15:03:29,2012-06-02 15:03:29
16abda814b819b46fe35e940729d7eb7466a5f70...c0dd803da1ed361b1f718f4832efae6a3d862653,1,2,2,4,1,2012-06-02 18:23:21,2012-06-02 18:10:31
ce83eda15554ffd859ecc9f4c427303d460dab60...3c73a1d57f9319dbbaf882835608ad421c8b9600,1,4,4,8,2,2010-06-24 20:36:30,2010-06-24 20:36:30
02ac98374eefbe4a46d4b53a8a78057ad8ad39b7...c17b229454ac3f5d20fd0cff3a663b03c13cb38e,4,19,1,20,4,2011-06-06 05:17:04,2011-06-06 05:17:04
02ac98374eefbe4a46d4b53a8a78057ad8ad39b7...cc70148385d5a36682d3b67fdaa726590577f257,2,7,1,8,2,2010-08-09 19:57:17,2010-08-09 16:52:26
ba4d01bd74edae1e4adb540a03ba17961f8dd4b2...5099b99d25f134c558edc356ad20209da679dd3b,2,57,28,85,16,2010-06-25 17:03:19,2010-06-24 21:52:12
5099b99d25f134c558edc356ad20209da679dd3b...d998bd4ab6714051ad122f89489ddbca2bb3367b,3,53,12,65,14,2010-06-25 17:06:30,2010-06-24 17:44:46
d998bd4ab6714051ad122f89489ddbca2bb3367b...57e1538ac9b352c7a43ca63d8206c5393e04fab3,1,3,0,3,1,2010-06-25 17:07:22,2010-06-24 17:44:47
57e1538ac9b352c7a43ca63d8206c5393e04fab3...fadb5156e485e9d25c89d4b4f96c2d4fe6db6187,40,56,54,110,51,2010-06-25 17:08:20,2010-06-24 17:44:48
fadb5156e485e9d25c89d4b4f96c2d4fe6db6187...335f87871fe5aa6b3fd55b2b4e80f16fe9681483,3,13,13,26,13,2010-06-25 17:08:24,2010-06-24 17:44:49
335f87871fe5aa6b3fd55b2b4e80f16fe9681483...635155fa3d825570080d727245a76e666bbae145,1,5,4,9,3,2010-06-27 17:24:55,2010-06-26 12:42:41
635155fa3d825570080d727245a76e666bbae145...15eeb6e921a08f2565192701c6b1ee5f1cbe9753,1,3,3,6,2,2010-06-29 16:32:56,2010-06-28 22:51:02
15eeb6e921a08f2565192701c6b1ee5f1cbe9753...e1ca1c9d9be497aef8c195de9b3a5715fef54898,1,4,3,7,1,2010-07-05 18:23:31,2010-07-02 14:59:43
e1ca1c9d9be497aef8c195de9b3a5715fef54898...85b0b34ea42628874198772fe6602365650ead88,1,1,1,2,1,2010-07-05 18:23:37,2010-07-02 14:59:44
85b0b34ea42628874198772fe6602365650ead88...9a897893a76063a1fbe07f62ba78ab8f5308dbd3,1,34,3,37,5,2010-07-05 18:23:40,2010-07-02 14:59:45
9a897893a76063a1fbe07f62ba78ab8f5308dbd3...2fac6a4b93c29c0e7226337d76097ea1e61e072d,1,27,0,27,1,2010-07-05 18:23:41,2010-07-02 14:59:46
2fac6a4b93c29c0e7226337d76097ea1e61e072d...97d9fd925bd0db1d11c4fbe8dd919bfb952b2cc1,1,7,0,7,1,2010-07-05 18:23:43,2010-07-02 14:59:47
97d9fd925bd0db1d11c4fbe8dd919bfb952b2cc1...b5500d16cd1021bc1430ad019512c636dd3311d6,1,12,0,12,1,2010-07-05 18:23:45,2010-07-02 14:59:48
b5500d16cd1021bc1430ad019512c636dd3311d6...20873f45e7fe23a8530e643d2eea9566d57f2fd4,1,78,0,78,1,2010-07-05 18:23:47,2010-07-02 14:59:49
20873f45e7fe23a8530e643d2eea9566d57f2fd4...6fd45295ae0abf424c2e8a71118dcd277778abff,1,8,13,21,6,2010-07-05 18:37:30,2010-07-05 18:37:30
6fd45295ae0abf424c2e8a71118dcd277778abff...c9667456d201c435af523ffb7d583efd1784232a,1,31,0,31,1,2010-07-07 04:26:11,2010-07-06 20:04:10
4c35f0dbc41a2bb79e4f597d3b7bdb265c5ea750...e3163c75156f1b85e8a778cecfacae63c14dcdbb,4,10,10,20,7,2010-04-10 04:23:10,2010-04-10 02:50:19
9eafa1201b2dcc703258ca7cd53de8ac4de74565...bbb1b8a35a06203020f7ab6d1ad58bcb4afe8e93,2,10,0,10,2,2010-06-28 16:15:15,2010-06-28 08:59:07
bbb1b8a35a06203020f7ab6d1ad58bcb4afe8e93...89fe121d5fd808391ee38b7f39b88cb3f912776f,1,1,1,2,1,2010-06-28 17:01:26,2010-06-21 18:52:29
ffc4b8012d9a4f92ef238ff72c0d15e9e1b402ed...0c811a7a6f93691604d48b1c13a6868c89971528,1,33,3,36,6,2011-06-12 05:32:30,2011-06-11 19:04:09
0c811a7a6f93691604d48b1c13a6868c89971528...de9f14e26a179462b3d4ed9de64ba7dd9fdbfa02,1,1,1,2,1,2011-06-12 05:32:30,2011-06-11 19:04:10
de9f14e26a179462b3d4ed9de64ba7dd9fdbfa02...188c35e36d22c39074a8b0ee411483a405065a9a,5,54,0,54,5,2011-06-30 19:21:13,2011-06-11 19:04:11
188c35e36d22c39074a8b0ee411483a405065a9a...c6d72c49720aa333e9c646f447147e8e546df174,6,3,87,90,11,2011-07-14 18:02:06,2011-07-14 18:02:06
334fba656b50c92345586970bc6b100a449e1fc5...8fe533f686e20852fa9bd2df2755faed7c7bcdcc,2,48,0,48,2,2011-01-27 18:22:37,2011-01-27 06:07:49
8a57c6e9437eeebf849f0def03389078a510312e...183113a5ca99cb228b2ba0a29e53f1ac11f2c7c2,16,36,31,67,27,2010-07-05 18:47:57,2010-07-04 19:46:19
ad9d8e8f0f13e054ee30fcdcdb51973ddcfadb37...9ba0f0334dd505f78e0374bbe857c5e202f5a778,2,2,1,3,2,2010-07-05 18:57:07,2010-07-04 11:00:17
9ba0f0334dd505f78e0374bbe857c5e202f5a778...869d58813b24c74e84c9388041eafcef40cb51e4,1,11,6,17,5,2010-07-05 20:28:20,2010-07-05 18:52:43
3334729cf29605389b51effc1f311656f3fd8086...2543d9b609d158f611e317738644e67cacac6b9a,3,4,4,8,4,2010-06-07 22:50:21,2010-06-04 09:32:11
7c42e390a37a11b1f7a77f5f07c261a8f930663a...cb944f6b5009e4788041a5194d73b92a0620c9d9,2,2,2,4,2,2010-06-27 17:06:40,2010-06-25 23:41:33
cb944f6b5009e4788041a5194d73b92a0620c9d9...b684e977363ee5cb53d83c69f2298d7898c5f89a,7,18,18,36,13,2010-06-27 17:06:51,2010-06-25 23:41:34
b684e977363ee5cb53d83c69f2298d7898c5f89a...78a395d371ec9fd14297178ec98b8b1042a64fb6,19,40,40,80,40,2010-06-27 17:06:51,2010-06-25 23:41:35
78a395d371ec9fd14297178ec98b8b1042a64fb6...aadceea641806b363ca555ffdc04109ea716c497,3,6,6,12,4,2010-06-27 17:06:51,2010-06-25 23:41:36
aadceea641806b363ca555ffdc04109ea716c497...e8c8b7139c87c3e3017d3bff07f91c4349850d58,11,17,17,34,16,2010-06-27 17:06:51,2010-06-25 23:41:37
e8c8b7139c87c3e3017d3bff07f91c4349850d58...1d2f80fa79cdc6f7f4fa1cefb47d7d19be3bc5ee,16,64,64,128,57,2010-06-27 17:06:52,2010-06-25 23:41:38
7c42e390a37a11b1f7a77f5f07c261a8f930663a...30d00c395e3fb9f104a3f4a85f06a039c989cd8d,1,20,10,30,2,2010-06-13 16:15:09,2010-06-12 16:31:18
30d00c395e3fb9f104a3f4a85f06a039c989cd8d...685359cf2d1996aed2f1b1e2857528819d27105d,1,5,17,22,6,2010-06-13 16:15:11,2010-06-12 16:32:11
685359cf2d1996aed2f1b1e2857528819d27105d...678e484b7d4e6388edeec3470bbbcd206817c148,7,255,13,268,17,2010-06-13 16:16:38,2010-06-12 16:36:51
678e484b7d4e6388edeec3470bbbcd206817c148...0af88c15e2eb0a680c3797da8d8b97636b797f66,3,21,20,41,8,2010-06-13 16:16:50,2010-06-12 16:39:46
0af88c15e2eb0a680c3797da8d8b97636b797f66...832ac79edf0e0e9108f5da5b10b496a227667f40,1,1,1,2,1,2010-06-21 18:11:11,2010-06-21 17:37:13
832ac79edf0e0e9108f5da5b10b496a227667f40...6a1b3fc78311f16834d885e4e0baead8e51ed631,1,2,1,3,2,2010-06-21 18:11:48,2010-06-21 17:37:14
6a1b3fc78311f16834d885e4e0baead8e51ed631...7f5329f46dd3221618124df70aee2391aef6305a,1,0,5,5,1,2010-06-21 18:12:21,2010-06-21 17:37:15
7c42e390a37a11b1f7a77f5f07c261a8f930663a...c5043cc18579854681aa51ddb6e744fe2db24f51,1,37,19,56,14,2010-06-07 22:52:43,2010-06-03 20:28:55
7c42e390a37a11b1f7a77f5f07c261a8f930663a...1603ade81352a526ccb206f41ff81ecbc855df2d,1,19,6,25,8,2010-06-07 22:48:06,2010-06-04 09:50:10
1603ade81352a526ccb206f41ff81ecbc855df2d...0e9716e65e40883759082b35e90113d0d0c8f7a6,1,4,1,5,2,2010-06-07 22:50:00,2010-06-04 09:50:11
e7e1bf0c29f20c505869d2dda7ddb26470f6ebc5...993297717341ef7613ce21d34a9a6b475ed1a67b,1,21,0,21,5,2010-06-21 12:48:18,2010-06-21 12:48:18
497d9c343902591e98a6612385d529816420ea94...d8faea9d182bd0ca2624be74d9dc32b187618840,2,69,2,71,4,2010-08-11 16:46:47,2010-08-09 14:50:53
d8faea9d182bd0ca2624be74d9dc32b187618840...5536934239ed0a66fc5ac1d08cfd7e6a0905f80c,1,2,3,5,3,2010-08-11 17:41:08,2010-08-10 12:14:25
5536934239ed0a66fc5ac1d08cfd7e6a0905f80c...7e7db5e4520388d3a6f1efbe2f7a29d43bd06a2b,2,58,1,59,2,2010-08-11 17:45:15,2010-07-13 11:51:48
7e7db5e4520388d3a6f1efbe2f7a29d43bd06a2b...b5e233ecc411c8685463333d180a135c6866c50e,1,1,1,2,1,2010-08-11 18:23:25,2010-08-11 08:14:13
d07ef715757ab1c2436c59adca92484fa46b2b41...cc24a1d809c75f0b6e5b1e56134b5127196bb2fb,1,7,0,7,1,2010-05-20 03:45:30,2010-05-19 19:01:47
1d25dd416f08f39042d23340db380f28abb81962...ba1b8cfac137604e8b28cd98838ffcde732bc7dc,1,3193,2367,5560,2322,2013-10-18 02:29:33,2013-08-21 19:49:43
b586744a864cf4d6886d6436d559302123b01fae...ec99c9a89a65749093e16aed37d393f646597b31,1,2,6,8,5,2011-08-03 18:23:09,2011-08-03 11:54:03
ec99c9a89a65749093e16aed37d393f646597b31...d24d905509207fb47abe654789e1248a18785dfc,1,3,3,6,3,2011-08-03 18:24:28,2011-08-03 12:07:57
787513027a7d0af3c2cd2f04b85bc7136d580586...4fd731240980f0f4b4565abe9092bd3d08d650e3,1,12,12,24,8,2011-08-27 18:12:08,2011-08-27 00:59:24
4fd731240980f0f4b4565abe9092bd3d08d650e3...d88acc91785661ef261ed816c13b70068400d194,1,1,1,2,1,2011-08-27 18:12:13,2011-08-27 00:59:25
d88acc91785661ef261ed816c13b70068400d194...c995ef49e2a3076236d8fc710cc2015f5ff201c5,1,3,3,6,3,2011-08-27 18:12:15,2011-08-27 00:59:26
c995ef49e2a3076236d8fc710cc2015f5ff201c5...7474b8b452f2600bd2a9e03f67b83b489aeadb37,2,24,4,28,13,2011-08-27 18:12:18,2011-08-27 00:59:27
568d44641bc8e754157cf551e58154106d3532ae...f696543dad6c7ba27b0c4fab167a5687263a9ba0,3,7,8,15,4,2011-06-26 19:41:16,2011-06-26 19:41:16
e7af8e49cd54f1784fa2a0e382f22ca2f98cf4d8...cc663d141a2d900d097973a8fdcb939f697d46bd,1,19,2,21,12,2011-08-29 22:27:01,2011-08-29 20:10:46
cc663d141a2d900d097973a8fdcb939f697d46bd...2fdb5c6219ffe17f40833f32541af764ed2364db,1,2,2,4,1,2011-08-29 22:27:04,2011-08-29 20:10:47
2fdb5c6219ffe17f40833f32541af764ed2364db...688f4f2fbc353887dbe77c450aaad2ccfd13e8fc,1,2,2,4,2,2011-08-29 22:27:05,2011-08-29 20:10:48
688f4f2fbc353887dbe77c450aaad2ccfd13e8fc...b2cd17b925a43c232955a53276caf0e20bfd9095,1,8,1,9,3,2011-08-29 22:27:07,2011-08-29 20:10:49
17b4e93d5b849293e6a3659bbc4075ed8a6e97e2...44df2e297025d7a9af6c265dfefb687b09e2537a,4,80,31,111,28,2012-01-01 09:11:56,2011-12-31 00:14:01
ec330158ec04849fe5ff2cb8749797cd63ae592b...941ba8db57f2d075aee48b002ee30686288cb502,2,40,18,58,7,2012-01-16 22:27:24,2012-01-14 12:19:53
941ba8db57f2d075aee48b002ee30686288cb502...2baad220138b10582c55ef942466f2b8df18944f,1,70,41,111,21,2012-01-16 22:28:27,2012-01-14 12:19:54
2baad220138b10582c55ef942466f2b8df18944f...20e95d0a8475ce467903e1aaad5c2fd47777fcc8,1,44,9,53,5,2012-01-16 22:34:33,2012-01-14 12:19:55
ec330158ec04849fe5ff2cb8749797cd63ae592b...96890f4c428ed62cf52c11aba5773d364a8d6234,25,114,102,216,57,2012-01-04 00:13:14,2011-12-26 16:16:56
98c2924cfa84a7f30b17636bd5632e53a0fa002e...1eb10f4091931d6b89ff10edad63ce9c01ed17fd,1,66,5,71,12,2012-01-10 18:10:36,2012-01-10 04:44:30
1eb10f4091931d6b89ff10edad63ce9c01ed17fd...8ec6c8d79567a71ca3c6f1ec73eb453d371b1ade,1,7,3,10,2,2012-01-10 18:10:43,2012-01-10 04:57:33
8ec6c8d79567a71ca3c6f1ec73eb453d371b1ade...06121a0a8328c8aaa7a023cf6ebb142e9dc2b45c,1,22,17,39,7,2012-01-12 01:37:10,2012-01-11 23:50:10
06121a0a8328c8aaa7a023cf6ebb142e9dc2b45c...35a71f1402b40b580d985a9d7e5fb1c9ec4d0232,1,1,1,2,1,2012-01-17 06:15:19,2012-01-17 06:02:32
21aeafceda2382d26bfa73a98ba45a937d65d77a...67ba123fd1fcb9a7699ae85f05f1229513322c1c,1,1,0,1,1,2012-08-07 05:11:47,2012-08-07 04:10:26
67ba123fd1fcb9a7699ae85f05f1229513322c1c...436783c95a59cca00a7cca1219666bb0af67cb81,1,1,0,1,1,2012-08-07 05:12:43,2012-08-07 03:07:42
21aeafceda2382d26bfa73a98ba45a937d65d77a...a50902590e703878e888fd8a33ec5a22d5347481,2,3,1,4,3,2011-12-13 00:09:38,2011-12-10 10:41:08
a50902590e703878e888fd8a33ec5a22d5347481...ce77aa4813c8a3980283c0a1e760f51f3a405154,1,7,8,15,4,2011-12-13 00:09:39,2011-12-10 10:41:23
ce77aa4813c8a3980283c0a1e760f51f3a405154...9b4b894601a484bec4132f0201c55a7a0d29eab3,1,1,0,1,1,2011-12-13 00:09:39,2011-12-10 10:41:27
9b4b894601a484bec4132f0201c55a7a0d29eab3...3f3a9701aeb1743a3eaedec8791afba67419961c,1,1,0,1,1,2011-12-13 00:09:39,2011-12-10 10:41:30
3f3a9701aeb1743a3eaedec8791afba67419961c...34961d30dae69b00a8a5aabd568fb87f376ebb87,3,188,0,188,3,2011-12-13 00:09:39,2011-12-10 10:53:14
d596118d7a9b104db10e64b2680a30ea80f1439c...bf3de2b373d4fa55b6040c7dc6f7f8668ef45c19,1,1,0,1,1,2011-12-15 21:00:22,2011-12-14 16:54:28
bf3de2b373d4fa55b6040c7dc6f7f8668ef45c19...6bc1a235b1260a8395045261f8004ba9f12677c7,2,44,21,65,12,2011-12-15 21:14:49,2011-12-14 16:54:29
6bc1a235b1260a8395045261f8004ba9f12677c7...0db76962d156c196a23a98014c1585246f561a5d,2,23,6,29,6,2011-12-15 21:15:46,2011-12-14 16:54:30
0db76962d156c196a23a98014c1585246f561a5d...9e1313648d4c0ee1bab0ee3d7ed22553bd5bf87c,1,5,5,10,3,2011-12-15 21:16:52,2011-12-14 16:54:31
9e1313648d4c0ee1bab0ee3d7ed22553bd5bf87c...c6b7c7f3050977577af49e5d81340fae3b5bf2e7,1,29,29,58,28,2011-12-15 21:19:21,2011-12-14 16:54:32
c6b7c7f3050977577af49e5d81340fae3b5bf2e7...bf71009e5389aa2f3187ae9c0352ba3c70780f62,2,2,2,4,2,2011-12-15 21:20:19,2011-12-14 16:54:33
fc14b89a7e6899b8ac3b5751ec2d8c98203ea4c2...406da7803217998ff6bf5dc69c55b1613556c2f4,3,8,11,19,4,2011-12-02 18:02:52,2011-12-02 17:31:32
fc14b89a7e6899b8ac3b5751ec2d8c98203ea4c2...93ccbba6ee5417ac97ce5e7fb8b7d9f1e080826e,1,1,1,2,1,2011-12-01 22:25:30,2011-12-01 02:37:27
fc14b89a7e6899b8ac3b5751ec2d8c98203ea4c2...d1075414dcd48948ecba65ac7bcae23bee73801f,1,6,7,13,6,2011-11-29 00:36:44,2011-11-25 00:09:45
d1075414dcd48948ecba65ac7bcae23bee73801f...9ff5e21f0e2d0944535dbf4d35758a7e027ae0c6,1,54,0,54,1,2011-11-29 00:37:17,2011-11-25 00:09:46
9ff5e21f0e2d0944535dbf4d35758a7e027ae0c6...183868578049f5a28f7166716a4b00768d148958,2,29,7,36,9,2011-11-29 00:38:46,2011-11-25 00:09:47
f1f509cc4504ebe9e2922c7bc61794183e3d441a...967cf9867de7c49393dfc666c941a1861d159639,1,0,2,2,1,2011-12-21 19:15:56,2011-12-21 12:05:27
967cf9867de7c49393dfc666c941a1861d159639...a31275d6ffd35bc1c269b7136f4031abe2abee70,1,2,2,4,1,2011-12-21 19:26:30,2011-12-21 18:14:09
b507b465f7831612b9d9fc643e3e5218b64e5bfa...96a035d1db9082d244867033020d0ceb571cf94e,1,1,1,2,1,2006-10-20 23:37:49,2006-10-20 23:37:49
96a035d1db9082d244867033020d0ceb571cf94e...0b92f1a9d213644d2cd6c1870091c090a6b7eca9,1,1,1,2,1,2006-10-20 23:50:36,2006-10-20 21:24:32
0503f9c178c36a19e1f8e8930b367db0f58ce5ca...9ac13ec941933c32849c2284b5d79ef608023a56,4,19,17,36,14,2006-10-11 18:13:01,2006-10-11 15:49:15
9ac13ec941933c32849c2284b5d79ef608023a56...c35b96e7851e417a24c1e255e353c67b31955466,1,14,4,18,7,2006-10-11 21:41:11,2006-10-11 18:53:21
c35b96e7851e417a24c1e255e353c67b31955466...74a31a100ab96c37ebec5c04e1822bb2681bc345,1,25,7,32,10,2006-10-11 21:41:13,2006-10-11 18:53:22
74a31a100ab96c37ebec5c04e1822bb2681bc345...e8f5d9081cecff026913702dff8254d03e8f08b8,1,123,16,139,16,2006-10-11 22:24:15,2006-10-11 21:53:35
e8f5d9081cecff026913702dff8254d03e8f08b8...b203b769f2f382307f21b4a021ce08f9a4cfa94c,1,2,2,4,2,2006-10-11 22:24:18,2006-10-11 21:53:36
b203b769f2f382307f21b4a021ce08f9a4cfa94c...14763e7bda06a502455ef4420067205797b9a907,1,7,4,11,1,2006-10-12 01:10:38,2006-10-11 23:16:02
14763e7bda06a502455ef4420067205797b9a907...83e9940a5ef79cedc36a24a4a89d097abf1b28c7,1,14,0,14,2,2006-10-12 03:19:49,2006-10-12 01:19:55
83e9940a5ef79cedc36a24a4a89d097abf1b28c7...854de5a5341be4183c401157b9e5593d9a925f4f,1,1,1,2,1,2006-10-12 09:57:39,2006-10-12 09:57:39
854de5a5341be4183c401157b9e5593d9a925f4f...2344d47fba45bdddb0801ebf0789935a96e44352,2,134,17,151,10,2006-10-12 16:30:14,2006-10-12 12:22:14
2344d47fba45bdddb0801ebf0789935a96e44352...23bed43d0c5190b6da89f3f34d8badcc1b3c304b,4,6,6,12,5,2006-10-12 16:42:36,2006-10-12 16:26:34
23bed43d0c5190b6da89f3f34d8badcc1b3c304b...4035b46e12ee6e5c9339e263cd16c2e2422b8928,1,6,6,12,6,2006-10-13 21:21:22,2006-10-13 21:20:27
0503f9c178c36a19e1f8e8930b367db0f58ce5ca...6130259c30695d8a6ceda414a7d0d14183491e82,1,6,2,8,3,2006-10-11 08:18:57,2006-10-10 14:58:23
0a246571d47642dd7b6b796e601b820ca9f0c8c4...29f049a0c277be72637f74f1f90a89dccd3475bc,2,3,7,10,4,2006-10-15 06:38:01,2006-10-15 06:37:41
29f049a0c277be72637f74f1f90a89dccd3475bc...972a9155832165ea38febba2303e7c760050b5d8,1,5,6,11,3,2006-10-15 19:35:07,2006-10-15 12:02:03
972a9155832165ea38febba2303e7c760050b5d8...7cfb5f367e50402c0bc75d89542d7ada4c5b8da4,1,1,7,8,2,2006-10-15 19:35:25,2006-10-15 12:02:18
7cfb5f367e50402c0bc75d89542d7ada4c5b8da4...b32db4d0faec35ad8e6af35c54c37036b3d6c02f,1,1,1,2,1,2006-10-16 05:36:35,2006-10-16 01:00:37
9004dcbe8278b6d66f41e6e401f6d564a64fd1e1...dfb960920d4953066cb0cdf3cb6dd8a5a8d9cf14,1,1,0,1,1,2006-11-05 01:17:45,2006-11-04 18:57:18
dfb960920d4953066cb0cdf3cb6dd8a5a8d9cf14...67e78c3b8aeb44681b2d4ab2cf97145b7cc9a7a2,1,9,0,9,3,2006-11-05 01:17:46,2006-11-04 18:57:44
b89c4e93cc1939493c2bb9b6c3f60eabaf653eff...c7740a943ec896247ebc5514b6be02710caf3c53,4,48,10,58,17,2006-10-29 07:49:17,2006-10-29 07:47:56
c7740a943ec896247ebc5514b6be02710caf3c53...5ca807842fcb709757147df0044e8b4b2946ea22,1,1,1,2,1,2006-10-30 05:10:26,2006-10-30 02:33:22
5ca807842fcb709757147df0044e8b4b2946ea22...4508dde16951df00529207f179fee405e8646a64,4,10,48,58,17,2006-10-31 00:02:07,2006-10-31 00:02:07
7854e526ff170846aef4ae3c71588c98ed9176d0...5c1e235f0f2a4586ca46a5503f6283db0ac1b9ac,1,5,3,8,3,2006-11-03 01:39:58,2006-11-02 11:10:52
5c1e235f0f2a4586ca46a5503f6283db0ac1b9ac...ca8e2d86c44e5cea0def1d01edfb4e6aaf642dee,1,5,3,8,5,2006-11-03 02:04:40,2006-11-02 11:13:32
ca8e2d86c44e5cea0def1d01edfb4e6aaf642dee...34eb33407d4d7eef6d7ddcd6e51525018ef9edf7,2,29,15,44,10,2006-11-03 02:04:40,2006-11-02 15:44:20
34eb33407d4d7eef6d7ddcd6e51525018ef9edf7...3175aa1ec28c8fb119058111a2f629425ef1aab0,1,25,0,25,2,2006-11-03 02:04:40,2006-10-28 20:33:46
3175aa1ec28c8fb119058111a2f629425ef1aab0...cd1464083cd9e61a55148c21fd9b8eb3bf76d190,1,92,61,153,16,2006-11-03 02:04:40,2006-11-02 19:23:11
7854e526ff170846aef4ae3c71588c98ed9176d0...fa438a2eb116c71eaebecdc104a1af01ea83b9fa,3,13,8,21,9,2006-11-01 23:13:10,2006-10-31 21:58:32
368c2ac249ac2261784e1b9b9bc7c98c5e859052...a19f901d9f07b07abd2bfbad62037b9783fcaa7c,1,2,2,4,2,2006-11-10 21:36:44,2006-11-10 21:36:44
a19f901d9f07b07abd2bfbad62037b9783fcaa7c...8eaf79869f9eddf50ddffffb8d73a054e0514fcd,1,2,1,3,1,2006-11-10 21:44:39,2006-11-10 21:39:01
6c8d06aff107aa2132648d682a278111c1d08565...d5dc6a76d49367cddc015e01d2e9aa22e64d7e28,2,41,19,60,7,2006-08-09 00:45:20,2006-08-09 00:26:23
d5dc6a76d49367cddc015e01d2e9aa22e64d7e28...fb6ff943de33dccc3f43541ed4ae4b71abddac8b,1,5,1,6,2,2006-08-09 04:55:05,2006-08-08 05:41:32
fb6ff943de33dccc3f43541ed4ae4b71abddac8b...1d17c25c38a6b98d20b7bbe789b45996fd84d672,1,1,0,1,1,2006-08-09 08:03:39,2006-08-09 07:57:01
1d17c25c38a6b98d20b7bbe789b45996fd84d672...72ee96c0f1861fcdb9eaf39e78d86888437a27a9,2,4,2,6,2,2006-08-09 19:45:27,2006-08-09 19:45:27
72ee96c0f1861fcdb9eaf39e78d86888437a27a9...02c5cba2007856465710aa37cd41b404372ab95b,1,1,1,2,1,2006-08-09 20:17:04,2006-08-09 20:17:04
02c5cba2007856465710aa37cd41b404372ab95b...03b9d560bed6029f43968ad3f09a8f9c015b20e0,1,4,3,7,1,2006-08-09 20:17:19,2006-08-09 20:17:19
03b9d560bed6029f43968ad3f09a8f9c015b20e0...943d5b73e2adf3cd0d3f72c9a06c75681a4ea3ca,1,0,3,3,1,2006-08-09 21:05:23,2006-08-09 21:05:23
943d5b73e2adf3cd0d3f72c9a06c75681a4ea3ca...2c71810b90d122abdcc57fc3cb62174d16e77b58,2,60,0,60,3,2006-08-10 05:47:25,2006-08-10 05:47:25
42817b96b1b80b56fd5a4d5e0d6239524b1832a3...bc147968a4ab0d4fb069b00c9a08ff353266c1f6,1,2,5,7,2,2013-11-18 21:49:42,2013-11-18 17:39:08
bc147968a4ab0d4fb069b00c9a08ff353266c1f6...189a546797413a1c71173c8e5c5073f77acb33f9,1,8,8,16,5,2013-11-18 21:49:42,2013-11-18 17:39:09
189a546797413a1c71173c8e5c5073f77acb33f9...7a48b8321934384098a8392b3c4c814ec5058d00,3,17,2,19,5,2013-11-18 21:49:42,2013-11-18 17:39:10
7a48b8321934384098a8392b3c4c814ec5058d00...b28061ce0d2e31d390fee5a5724b8a061d0492a7,3,69,4,73,8,2013-11-19 18:14:15,2013-11-18 17:39:11
b28061ce0d2e31d390fee5a5724b8a061d0492a7...fddb74c94777351d549b2ddaa36612c41b2176f1,3,30,2,32,5,2013-11-19 18:14:15,2013-11-18 17:39:12
fddb74c94777351d549b2ddaa36612c41b2176f1...db64eb655b48ea2c635480c6cc992b0156817aeb,2,24,6,30,12,2013-11-19 18:14:15,2013-11-18 17:39:13
42817b96b1b80b56fd5a4d5e0d6239524b1832a3...90f867b9a5088a2ea6f5844ae28b617821e77b28,1,2,9,11,3,2013-10-31 18:12:24,2013-10-31 09:25:32
90f867b9a5088a2ea6f5844ae28b617821e77b28...501a75a7b308ed9631cd4802d891e6b56c06821a,4,4,4,8,4,2013-10-31 18:12:26,2013-10-31 09:25:33
501a75a7b308ed9631cd4802d891e6b56c06821a...5a3fd6afd4a26accc20a58bf4980f296772be98a,1,3,1,4,2,2013-10-31 20:45:29,2013-10-31 20:43:35
5a3fd6afd4a26accc20a58bf4980f296772be98a...19ecb564ad15d6eb0544d11d808ca8dc9a198bdf,1,1,0,1,1,2013-10-31 20:46:03,2013-10-31 09:25:36
19ecb564ad15d6eb0544d11d808ca8dc9a198bdf...54d07f2e25eb90f00def6d6406714d787ab0beb9,1,1,2,3,2,2013-10-31 20:46:55,2013-10-31 09:25:38
54d07f2e25eb90f00def6d6406714d787ab0beb9...57b15ead774ed2139d9ece494ef67f3f9fd5bbf2,1,0,1,1,1,2013-10-31 20:47:19,2013-10-31 09:25:39
57b15ead774ed2139d9ece494ef67f3f9fd5bbf2...23cd01ec53abd9a814d6a565a1e40333ae785611,1,1,0,1,1,2013-10-31 20:47:22,2013-10-31 09:25:40
23cd01ec53abd9a814d6a565a1e40333ae785611...c44726438fbdb193c86ee68d53933597a2e10dcb,1,3,4,7,5,2013-10-31 20:47:35,2013-10-31 09:25:41
c44726438fbdb193c86ee68d53933597a2e10dcb...35b2fa5ba3090d56d318acd206204e61b6a3281c,1,1,1,2,1,2013-10-31 20:47:41,2013-10-31 09:25:42
35b2fa5ba3090d56d318acd206204e61b6a3281c...9e57ac55cecec8bd2cf94d675e4458bc68a7336f,1,6,8,14,8,2013-10-31 20:48:05,2013-10-31 09:25:43
9e57ac55cecec8bd2cf94d675e4458bc68a7336f...4e7e4b6b1bd3412a30ac577d06907ab47ede9483,1,1,1,2,1,2013-10-31 20:48:09,2013-10-31 09:25:44
4e7e4b6b1bd3412a30ac577d06907ab47ede9483...5a50085c6b4dd7838167c6ce04042b4b563d8916,1,5,8,13,8,2013-10-31 20:48:26,2013-10-31 09:25:45
5a50085c6b4dd7838167c6ce04042b4b563d8916...abf03eeb8e99538cd31806d5f252214b9fe695a6,1,2,2,4,2,2013-10-31 20:48:32,2013-10-31 09:25:46
bdd9f4240f3686ca9beb14d803772995b43f39d5...209f129857bddd653e4ea2af2d310cbb8d8c8b5f,1,2,2,4,2,2007-02-08 06:35:37,2007-02-08 06:35:37
209f129857bddd653e4ea2af2d310cbb8d8c8b5f...f842fdb01da6037a8be4cf7f084bc6030f1eea5f,1,6,5,11,4,2007-02-08 06:54:42,2007-02-08 06:53:48
f842fdb01da6037a8be4cf7f084bc6030f1eea5f...882227f117a1356a7132cfdc24b1e2389b16133b,1,78,78,156,73,2007-02-08 18:49:06,2007-02-08 18:49:06
882227f117a1356a7132cfdc24b1e2389b16133b...590dd4bfd25b3c7592004258384f7541d9315712,1,105,0,105,1,2007-02-08 20:37:53,2007-02-08 20:26:01
41dc7e004491725e74e3fdd1c364b4c0a234574b...740afd961370ba3925ba3a1edf5b499bb068fd9a,2,3,1,4,2,2007-02-07 05:25:33,2007-02-07 05:25:33
740afd961370ba3925ba3a1edf5b499bb068fd9a...6506e156d99bd406661cd5d2e502db7c0960d716,2,2,7,9,4,2007-02-07 05:33:20,2007-02-07 05:27:09
6506e156d99bd406661cd5d2e502db7c0960d716...451fd65a8ebb8c91fbceac3be705b274aa3e3673,1,17,1,18,2,2007-02-07 08:33:38,2007-02-05 13:27:32
451fd65a8ebb8c91fbceac3be705b274aa3e3673...563b43ee45b87cf1e4bba99d3d0216f396d5c873,1,2,1,3,1,2007-02-07 08:35:15,2007-02-05 13:04:09
563b43ee45b87cf1e4bba99d3d0216f396d5c873...099c7837678361985ca9df1240cdaf6a42fc89f9,1,21,35,56,3,2007-02-07 10:10:56,2007-02-07 10:10:56
03f99c03f806ca13b5974450409426c04af220f2...67c08ce14fb488562666ab896541ad75f1bdcca6,1,4,2,6,2,2006-11-30 03:06:53,2006-11-29 22:15:48
67c08ce14fb488562666ab896541ad75f1bdcca6...ced7b828fadbf3d6de49d75392f1516b4ceb4491,1,5,1,6,2,2006-12-02 05:55:45,2006-11-30 11:28:28
ced7b828fadbf3d6de49d75392f1516b4ceb4491...4c81c213a479e4aae0653a56ad6e8db5c31f019c,2,5,3,8,4,2006-12-02 05:57:04,2006-11-30 11:43:13
4c81c213a479e4aae0653a56ad6e8db5c31f019c...22b1c7ee01ef5bc7f81e620bb88a6fad79c1c605,1,11,18,29,2,2006-12-02 05:57:47,2006-11-30 10:50:28
22b1c7ee01ef5bc7f81e620bb88a6fad79c1c605...3683dc5a9afaf88d00e55c9e6c67a2160ca7fc9c,1,5,5,10,3,2006-12-03 00:58:30,2006-12-03 00:58:30
f388cec3d77751a6c20b3b10415344f5355b5a2f...359850041e8158f6aeb70ad611ef1ba8834b8349,1,2,1,3,1,2006-12-13 20:08:01,2006-12-12 04:25:58
359850041e8158f6aeb70ad611ef1ba8834b8349...1d77043b005921cf7fcebfe680777df23ad10119,1,18,18,36,3,2006-12-13 20:11:03,2006-12-13 20:11:03
1d77043b005921cf7fcebfe680777df23ad10119...ad2c82c0e1a543f4475a948ccb3eb4afcce86f26,1,2,0,2,1,2006-12-13 22:18:16,2006-12-13 21:25:26
ad2c82c0e1a543f4475a948ccb3eb4afcce86f26...62e1aeabc095a02fd3fb7ef46a6884d76da5ce67,1,25,6,31,3,2006-12-13 23:58:41,2006-12-13 23:58:41
f388cec3d77751a6c20b3b10415344f5355b5a2f...b11121d9e330c40f5d089636f176d089e5bb1885,1,14,1,15,4,2006-12-13 19:15:07,2006-12-02 04:45:45
a862f97e98decc317437fa3b04081f68fb4ffbf3...27086d0f8418b1961a5fc2bea978f0a5ff37c50d,1,81,0,81,1,2006-12-31 08:21:37,2006-12-31 07:20:23
cc06c870685865decc7948cdb2d7e9b52ac8ee32...87a3d29f460701bf6fc1f34419290cad658c11a2,1,2,2,4,2,2006-12-31 08:52:25,2006-12-31 08:52:25
87a3d29f460701bf6fc1f34419290cad658c11a2...4b4ee90e587779233488325d2832a946eebe03e0,1,1,12,13,2,2006-12-31 08:59:53,2006-12-31 08:59:53
4b4ee90e587779233488325d2832a946eebe03e0...0ae5f98c7ba29fa4c698989cd6b38deba06d5bf3,1,42,97,139,15,2006-12-31 09:26:53,2006-12-31 09:26:53
0ae5f98c7ba29fa4c698989cd6b38deba06d5bf3...c04197ee1e575cf78662b2c8c055089a5c669214,1,4,7,11,1,2007-01-01 00:15:12,2006-12-31 23:47:33
c04197ee1e575cf78662b2c8c055089a5c669214...36566cc0bc2e5e930e4ed885e1a15fcfd10b0b53,1,4,7,11,2,2007-01-01 00:16:10,2006-12-31 23:47:34
36566cc0bc2e5e930e4ed885e1a15fcfd10b0b53...f65bb2c66fbebc10810857c64466679c81bf8154,1,4,3,7,2,2007-01-01 00:37:20,2006-12-31 23:47:36
f65bb2c66fbebc10810857c64466679c81bf8154...d66409f068df3a8590524c3224e300194c7c8b6b,1,15,10,25,3,2007-01-01 00:44:41,2006-12-31 23:47:38
d66409f068df3a8590524c3224e300194c7c8b6b...63c97ce228f2d2697a8ed954a9592dfb5f286338,1,14,12,26,5,2007-01-01 02:40:17,2006-12-31 04:11:52
63c97ce228f2d2697a8ed954a9592dfb5f286338...fbc9012307d3b2e1bcee84e4455b11e97f580e07,1,22,1,23,6,2007-01-01 02:53:26,2007-01-01 01:44:37
fbc9012307d3b2e1bcee84e4455b11e97f580e07...e90068a9046ccaf0bed82fd180b4748edbd5659a,1,6,4,10,2,2007-01-01 02:55:28,2007-01-01 02:18:23
e90068a9046ccaf0bed82fd180b4748edbd5659a...c6d499a82fbb02e2a03fe3d858ff144fa570fb34,1,17,22,39,4,2007-01-01 07:40:52,2007-01-01 05:49:45
c6d499a82fbb02e2a03fe3d858ff144fa570fb34...5bd3870c37dfb613e5e055f7b6d4c80a7b823719,1,35,49,84,6,2007-01-01 07:40:52,2007-01-01 05:49:46
5bd3870c37dfb613e5e055f7b6d4c80a7b823719...43853554542700e0d129ce853a3d4b16740035d4,3,7,19,26,9,2007-01-01 07:40:52,2007-01-01 05:49:47
43853554542700e0d129ce853a3d4b16740035d4...9d0524d42f340fc49f9e175d966afb7dce3854bb,1,16,65,81,8,2007-01-01 22:35:16,2007-01-01 20:07:26
9d0524d42f340fc49f9e175d966afb7dce3854bb...d1014a1745a8aa90c8de2a5ac7624d8175f96724,2,6,0,6,2,2007-01-01 22:35:16,2007-01-01 07:21:50
d1014a1745a8aa90c8de2a5ac7624d8175f96724...ac9c1108d8915f0937795e354ad72c4ae6890a3f,1,16,7,23,5,2007-01-01 22:36:01,2007-01-01 20:24:15
ac9c1108d8915f0937795e354ad72c4ae6890a3f...33a59fd07d8d75e58a5b1edbcc3c5798c98aa8bf,1,25,44,69,8,2007-01-01 22:36:36,2007-01-01 21:39:06
33a59fd07d8d75e58a5b1edbcc3c5798c98aa8bf...6f0b4ac0d730c99ab1c2962168675b920febb187,1,0,4,4,1,2007-01-01 22:38:08,2007-01-01 21:40:23
76d4e079adba461c127641a1104772a62e38cd81...eb92242f19e58de9c930220caf6bf1b83df54160,1,6,2,8,4,2006-12-31 06:45:00,2006-12-31 03:13:43
eb92242f19e58de9c930220caf6bf1b83df54160...22bac0ea528fd419cb833cab5de79a36fad91524,2,18,8,26,4,2007-01-06 18:34:56,2007-01-05 03:28:08
22bac0ea528fd419cb833cab5de79a36fad91524...ecaebf4af1212f8a74bc560a66c76c22e7c87131,1,1,3,4,1,2007-01-07 08:11:11,2007-01-07 08:11:11
825cee7b285d9c733e9aec03cf4362e8029ee1c1...956259ee74df5695c55f51e9f93bbc217953a41a,1,1,1,2,1,2007-01-03 16:14:46,2007-01-03 15:03:01
956259ee74df5695c55f51e9f93bbc217953a41a...f3673988ecb3d3174f9b6d3d04f00774b1b5c261,3,27,8,35,6,2007-01-03 16:16:02,2007-01-03 15:36:29
f3673988ecb3d3174f9b6d3d04f00774b1b5c261...f3a47405bb27846d62d20b056817f9c7d320e2db,1,4,1,5,3,2007-01-03 16:29:01,2007-01-03 13:34:13
f3a47405bb27846d62d20b056817f9c7d320e2db...c1d179f88add2a8c1e0052d34cf757760c25b8df,1,17,7,24,7,2007-01-03 16:38:01,2007-01-03 16:38:01
c1d179f88add2a8c1e0052d34cf757760c25b8df...9c9410e115add56bc33a57f16c7e64da2e1fb0ec,1,13,4,17,4,2007-01-03 20:19:20,2007-01-03 12:53:27
9c9410e115add56bc33a57f16c7e64da2e1fb0ec...6e72cf43a7b19bca62cebee5b1e4f43943c3b6fb,1,1,1,2,1,2007-01-03 20:19:20,2007-01-03 19:47:24
6e72cf43a7b19bca62cebee5b1e4f43943c3b6fb...1ebb948f656c03a5bdaab4de1a113b9ffcb98bea,1,1,1,2,1,2007-01-03 20:19:20,2007-01-03 19:47:25
1ebb948f656c03a5bdaab4de1a113b9ffcb98bea...af0e4ac0ecf7cad57d9405f188ce0944e7f9b166,1,40,43,83,8,2007-01-03 20:19:20,2007-01-03 20:10:09
af0e4ac0ecf7cad57d9405f188ce0944e7f9b166...0bc72abdb0440f003169211f01b8f3ffb83291e4,3,16,3,19,7,2007-01-03 20:31:43,2007-01-03 12:59:00
0bc72abdb0440f003169211f01b8f3ffb83291e4...60c0f8462fefed22fc8fb9c4e529665ed8204536,1,3,0,3,2,2007-01-03 20:34:20,2007-01-03 20:34:20
60c0f8462fefed22fc8fb9c4e529665ed8204536...d222984e3610c1558778f7a23d23b89f1d91fb36,1,1,1,2,1,2007-01-03 20:48:39,2007-01-03 20:25:55
825cee7b285d9c733e9aec03cf4362e8029ee1c1...e54eef9e1f8adb055c7bbe0e4f50a3716f611dcf,1,1,1,2,1,2007-01-03 07:41:12,2007-01-02 19:26:20
e54eef9e1f8adb055c7bbe0e4f50a3716f611dcf...6e458bf63f48fb7d15cb70ad7c7b7b71915d94a2,2,19,6,25,8,2007-01-03 07:43:21,2007-01-02 19:26:22
6e458bf63f48fb7d15cb70ad7c7b7b71915d94a2...98bf8a47c296f51ea9722fef4bb81dbfb70cd4bb,1,3,2,5,2,2007-01-03 07:43:31,2007-01-02 19:26:23
98bf8a47c296f51ea9722fef4bb81dbfb70cd4bb...3c1eb9cb2d57769f770ddc36fd6b49706608ebb7,1,14,4,18,3,2007-01-03 07:43:50,2007-01-02 19:26:21
4cfeccc75d6ab1ccc433770bac6bf3b15ab486d6...d9671b75ad3bbf2f95f11a8571e9beaa12ccf6dd,2,57,2,59,3,2006-12-09 19:09:27,2006-12-08 21:29:55
d9671b75ad3bbf2f95f11a8571e9beaa12ccf6dd...cda2d3c112a03079af9019c7d6617e65ab88ae7e,2,57,24,81,4,2006-12-09 19:13:17,2006-12-08 21:03:12
cda2d3c112a03079af9019c7d6617e65ab88ae7e...f131dd492f098f9f565df93df13e35c734284590,2,16,0,16,4,2006-12-09 19:13:36,2006-12-08 21:29:56
98214e96be00c5132047ae80bca20d4690933c33...a92c73eccc81b5bfc9e62866505ff1ea72492173,1,5,26,31,5,2006-02-23 11:49:09,2006-02-23 10:26:46
eae3fe5e509f3d3890bc99015cb02f9b67aa501c...bec2a69fe4c2dbb377d2742a4def7e3569b4c1d4,1,30,47,77,11,2006-02-28 05:37:56,2006-02-28 05:37:56
bec2a69fe4c2dbb377d2742a4def7e3569b4c1d4...2b8d9347aa1a11f1ac13591f89ca9f984d467c77,1,56,13,69,11,2006-02-28 05:38:01,2006-02-28 04:09:55
4840be66b10fd5e5d67e27a8d0c67a96d5b8356a...37543541257c1066f8222e5c62933266936efabf,1,1,1,2,1,2006-04-06 00:19:23,2006-04-05 23:02:50
37543541257c1066f8222e5c62933266936efabf...c5a4c4debec43ff98053cb6b69d35d63e45ee131,1,1,1,2,1,2006-04-06 00:20:03,2006-04-06 00:20:03
f916ee427f3d7302c691e94229eed84c0c62534a...fdedbcfb0d71d99f96e08c1903ce8bd5a8f51a39,1,15,5,20,11,2006-04-06 11:22:52,2006-04-06 11:22:52
fdedbcfb0d71d99f96e08c1903ce8bd5a8f51a39...22626ef4fd5a0b2cf1fc8e90bbb23f8ff0ed43ea,1,116,41,157,28,2006-04-16 23:56:02,2006-04-16 23:56:02
22626ef4fd5a0b2cf1fc8e90bbb23f8ff0ed43ea...2516dae2f63b6e6c4f7dbe2eb1322ba32da092c5,1,29,9,38,11,2006-04-21 00:35:31,2006-04-21 00:35:31
2516dae2f63b6e6c4f7dbe2eb1322ba32da092c5...a8aaf19c419a30d335f0640ab644112ecda6dd12,1,23,50,73,13,2006-04-23 12:45:55,2006-04-23 12:45:55
ec26b4d6b004b6529c79e995a543945076c683aa...23091e954c968282d4d9087da00f60c2f02aecc5,1,41,48,89,12,2006-04-03 04:17:32,2006-04-02 21:54:34
23091e954c968282d4d9087da00f60c2f02aecc5...40e907bff260a94306b1fe43d0fb829bf54e3103,1,1,3,4,3,2006-04-03 04:25:57,2006-04-03 03:50:17
be1295d16a2593dcf468fef7d9e811d057d9039f...fb18a2edf7f3d1585b6330b7dde110b992d3b97c,2,6,4,10,4,2006-03-27 03:06:17,2006-03-27 00:28:20
fb18a2edf7f3d1585b6330b7dde110b992d3b97c...8978d043c35ad068e280dbbdc31e06524ea0ab56,1,12,0,12,1,2006-03-27 03:07:43,2006-03-26 20:29:28
8978d043c35ad068e280dbbdc31e06524ea0ab56...b0a3de42316a4e8f1d561cbe12b7bb282631a0d6,2,28,8,36,14,2006-03-27 03:08:24,2006-03-26 14:59:52
be1295d16a2593dcf468fef7d9e811d057d9039f...84f11a43358b77a936770b908cb245ae1ad86c58,1,4,2,6,2,2006-03-26 08:23:52,2006-03-26 02:27:15
3f6726e1f112d221bd2a919e9b1b2927aeef6150...29e55cd5ad9e17d2ff8a1a37b7ee45d18d1e59d6,1,6,4,10,3,2006-02-11 03:11:23,2006-02-11 03:11:23
9da5c2f0d7e99eca46ce12bfe08755b30f2bdd30...9ae6be80163669db921e6522140900da41753ed5,1,18,27,45,4,2006-02-11 02:44:31,2006-02-11 02:38:24
f9666adfead47d265a65c7ba6f90d0ebae3e6b21...7b80be150ce137a790f498a69a784d61d8fc2e78,1,3,3,6,1,2006-02-13 07:46:25,2006-02-13 07:46:25
7246ed438c541650c2cd50e4e98b43226f60da0c...69310a34cb6dcca32b08cf3ea9e91ab19354a874,1,14,16,30,2,2005-12-22 20:39:39,2005-12-22 20:39:39
69310a34cb6dcca32b08cf3ea9e91ab19354a874...e99fcf96deab45ca81b22948328deb2d8586aa8d,1,3,0,3,1,2005-12-22 20:52:29,2005-12-22 19:38:23
e99fcf96deab45ca81b22948328deb2d8586aa8d...a14c225661fa2fc271d9e0fbf262e369dc7254fc,1,8,4,12,4,2005-12-22 20:52:35,2005-12-22 17:09:05
a14c225661fa2fc271d9e0fbf262e369dc7254fc...1e80e0449248edb77b0fb9853f4a3404a599e207,1,2,0,2,1,2005-12-22 20:52:37,2005-12-22 17:55:59
c10d63451883f67c37622d2a21b2fc93be2f90c9...5f94c730f31862c7f500173ee3a9d141c4730f0b,2,18,1,19,3,2005-12-23 06:35:38,2005-12-23 06:35:38
5f94c730f31862c7f500173ee3a9d141c4730f0b...797bd6f490c91c07986382b9f268e0df712cb246,2,22,1,23,5,2005-12-23 06:57:20,2005-12-23 06:57:20
390cb0c17a3a0751cfb7490a496930872f752d27...b2d09f063a01b429fe1e8d5179d00f3938ec598b,1,65,0,65,1,2005-11-08 06:18:48,2005-11-08 02:45:25
b2d09f063a01b429fe1e8d5179d00f3938ec598b...fb612d54c1df7e45d174060c1cbdf060accceb6d,2,36,11,47,8,2005-11-08 08:23:12,2005-11-08 06:21:21
fb612d54c1df7e45d174060c1cbdf060accceb6d...067744bd5dc23540745788b5aa11d4e9dea1ceef,1,8,7,15,5,2005-11-08 08:23:12,2005-11-08 06:50:57
067744bd5dc23540745788b5aa11d4e9dea1ceef...df8171ccb34ef346799b8bc2794d8707209c91d1,1,7,2,9,2,2005-11-08 08:23:12,2005-11-02 19:19:31
df8171ccb34ef346799b8bc2794d8707209c91d1...d0fde471ab2bc10e12288a26dfa47a920605f241,1,3,0,3,1,2005-11-08 08:23:12,2005-11-07 14:03:30
d0fde471ab2bc10e12288a26dfa47a920605f241...f2416c27effb4da4f6558b6f8dd66843948405af,1,138,88,226,62,2005-11-08 08:23:13,2005-11-07 14:33:51
f2416c27effb4da4f6558b6f8dd66843948405af...76bca9d1a95c0fbf9e31bcb7b6a52e1d318577e7,8,18,12,30,9,2005-11-08 09:20:24,2005-11-08 09:20:24
76bca9d1a95c0fbf9e31bcb7b6a52e1d318577e7...39b4ac99686148d356f7ba3c0132eb55dfda4726,2,3,0,3,2,2005-11-08 09:23:52,2005-11-08 08:23:37
39b4ac99686148d356f7ba3c0132eb55dfda4726...4bfb6b62ffc9460798ebc78c3a30e4eff7c409d0,1,19,12,31,10,2005-11-08 09:23:53,2005-11-08 08:41:37
2b2dabc29f53c5835868029585000ee487cf6cbb...4f6fbcdcf960b5afaeb2f5010be61b919c1805fd,2,175,2,177,4,2005-10-18 00:41:54,2005-10-15 04:54:47
4f6fbcdcf960b5afaeb2f5010be61b919c1805fd...22943f1a52142b0ef669c959f8b4367e579da968,2,186,46,232,27,2005-10-18 00:41:54,2005-10-15 04:54:52
22943f1a52142b0ef669c959f8b4367e579da968...22ddf7197958337a8c254122eae4efcd8a54098a,2,19,9,28,6,2005-10-18 00:41:55,2005-10-15 04:56:46
22ddf7197958337a8c254122eae4efcd8a54098a...caf4f582b2bb4d5582540aa49d29749b2600cd03,2,49,15,64,10,2005-10-18 00:41:55,2005-10-15 04:56:46
caf4f582b2bb4d5582540aa49d29749b2600cd03...cf9dfc669e9bae724286d919dec0cd30e3f592e4,1,95,40,135,24,2005-10-18 00:41:56,2005-10-15 04:56:46
cf9dfc669e9bae724286d919dec0cd30e3f592e4...71ac8356d8f64e2408e49ee8bf35d4e69cc9359e,1,35,32,67,11,2005-10-18 00:41:56,2005-10-15 04:56:46
71ac8356d8f64e2408e49ee8bf35d4e69cc9359e...d88156e943ab4ab5990fb8929fc432f7638df7f6,4,33,2,35,7,2005-10-18 00:41:56,2005-10-15 04:56:46
d88156e943ab4ab5990fb8929fc432f7638df7f6...4d2060efebe855e49365c7be117b80c1e486a6b4,1,133,0,133,1,2005-10-18 00:41:57,2005-10-15 23:15:49
4d2060efebe855e49365c7be117b80c1e486a6b4...973d6a2015ead1afa17ea4c728b4b9a4b9716d19,1,17,5,22,7,2005-10-18 00:41:57,2005-10-16 07:39:07
973d6a2015ead1afa17ea4c728b4b9a4b9716d19...58452f9442a1fa20e0fde5d200091b7f02e62cea,2,2,43,45,8,2005-10-18 00:41:58,2005-10-17 05:06:16
58452f9442a1fa20e0fde5d200091b7f02e62cea...28fba290e3868a41e36379906407cf318cedfe57,1,2,2,4,1,2005-10-18 00:41:58,2005-10-17 20:32:03
28fba290e3868a41e36379906407cf318cedfe57...508c1d1c9b13f53783d024ccb28f77d0e6f10e7f,1,11,5,16,7,2005-10-18 00:41:59,2005-10-17 20:32:14
508c1d1c9b13f53783d024ccb28f77d0e6f10e7f...cdb3950801fec8e9efa1607093a6e51737bacba0,2,6,2,8,2,2005-10-18 04:47:06,2005-10-18 04:47:06
cdb3950801fec8e9efa1607093a6e51737bacba0...7a3dd472ad2c69b7450a59eb2a35efb0698993d0,1,8,4,12,3,2005-10-18 07:16:45,2005-10-18 07:16:45
7a3dd472ad2c69b7450a59eb2a35efb0698993d0...ea51d416c02bb26e9d7600f87b27deb42752e6b5,2,9,4,13,5,2005-10-18 07:16:45,2005-10-18 07:16:45
ea51d416c02bb26e9d7600f87b27deb42752e6b5...694a764fc2af9463c2462ab1fc92b442fce1a54c,1,1,1,2,1,2005-10-18 07:16:45,2005-10-18 07:16:45
694a764fc2af9463c2462ab1fc92b442fce1a54c...4bfe1199eabb41eb1f1d67f4ee24df028eb21300,2,3,3,6,3,2005-10-18 07:27:50,2005-10-18 07:27:50
4bfe1199eabb41eb1f1d67f4ee24df028eb21300...4aaa702794447d9b281dd22fe532fd61e02434e1,2,103,18,121,10,2005-10-18 08:29:27,2005-10-18 08:29:27
4aaa702794447d9b281dd22fe532fd61e02434e1...e175768954816b00bbbba131ec1c411d2cd66582,1,1,1,2,1,2005-10-18 18:35:16,2005-10-18 18:35:16
e175768954816b00bbbba131ec1c411d2cd66582...542a01e4895fb3e57baab709194bdb25d7ad5217,1,3,0,3,2,2005-10-18 18:35:17,2005-10-18 18:35:17
542a01e4895fb3e57baab709194bdb25d7ad5217...5f93926c3c5c4fe1def39de82076bc69ec89c058,1,3,0,3,1,2005-10-18 18:35:17,2005-10-18 18:35:17
5f93926c3c5c4fe1def39de82076bc69ec89c058...2759cbc7741d7ce7bf44c2433fa1312d3fc7e64a,1,44,6,50,8,2005-10-18 18:35:17,2005-10-18 18:35:17
2759cbc7741d7ce7bf44c2433fa1312d3fc7e64a...5e5f8091e5c9b4f09ad4019c8fddbf25fd2ccbe9,2,0,4,4,2,2005-10-18 22:41:43,2005-10-18 22:41:43
5e5f8091e5c9b4f09ad4019c8fddbf25fd2ccbe9...3e04c62daab0a8481f907c30414ed246f284a1d9,1,57,21,78,12,2005-10-19 01:26:52,2005-10-19 01:26:52
3e04c62daab0a8481f907c30414ed246f284a1d9...fe5f51ce277df00cb01dfc984dba1e7128718e41,1,5,0,5,1,2005-10-19 01:41:28,2005-10-19 01:29:17
fe5f51ce277df00cb01dfc984dba1e7128718e41...f8765797a41a39f4dfc7030098c38283e6461a83,1,6,1,7,1,2005-10-19 01:42:14,2005-10-19 01:42:14
d5b0c9ea178dab3599674ccff50645c0464b8c31...4769948afe7c502d37746edc2ee2c084c9dcb325,4,36,18,54,16,2005-10-10 20:51:52,2005-10-10 20:50:01
4769948afe7c502d37746edc2ee2c084c9dcb325...77d604c30974587a2e0d36d92c48cef87f6e8e4d,2,43,24,67,11,2005-10-10 21:46:10,2005-10-10 21:46:10
77d604c30974587a2e0d36d92c48cef87f6e8e4d...977ed47d86c40683a1b84f5226d589e924e95785,1,1,2,3,1,2005-10-10 21:46:12,2005-10-10 21:46:12
977ed47d86c40683a1b84f5226d589e924e95785...f336af1711f86e8b00e85eec3b3f73f7a8e4bed0,1,5,41,46,4,2005-10-10 21:46:14,2005-10-10 21:46:14
f336af1711f86e8b00e85eec3b3f73f7a8e4bed0...98438bd0e893c23186fb82ea8b04964c0f1ef9d1,64,0,64,64,64,2005-10-10 21:49:52,2005-10-10 21:49:52
98438bd0e893c23186fb82ea8b04964c0f1ef9d1...72e9340cfde90189d76ef3c8a4793ea7764ff8ee,24,55,55,110,53,2005-10-10 23:01:31,2005-10-10 23:01:31
72e9340cfde90189d76ef3c8a4793ea7764ff8ee...cc1621e2a02ed2a408571ed6f6ba84de2166e334,8,8,8,16,8,2005-10-10 23:01:32,2005-10-10 23:01:32
babfaba23d530e2818db62161825a65e582adbdc...ab1824787dbbe31f96c56e37358b2288014c2db7,1,1,1,2,1,2005-10-07 21:05:03,2005-10-07 21:05:03
ab1824787dbbe31f96c56e37358b2288014c2db7...ab1630a3ed31d6ec5ae83769c78ed542fe3c4a28,2,189,26,215,17,2005-10-07 23:54:06,2005-10-07 23:54:06
ab1630a3ed31d6ec5ae83769c78ed542fe3c4a28...33bb218e9d7299f6ed06177c65d357ec81954ca9,1,21,3,24,3,2005-10-07 23:55:00,2005-10-07 23:55:00
85d106c267ec26f398e0aaf352d8011f661c459a...029f6de377c7e0484f5c4cf070934599580f1784,1,1,1,2,1,2005-09-18 21:11:53,2005-09-18 21:11:53
029f6de377c7e0484f5c4cf070934599580f1784...3a45f625aef0074a41885f1df335844ec8c04f5e,1,34,0,34,1,2005-09-18 21:12:43,2005-09-18 18:13:58
3a45f625aef0074a41885f1df335844ec8c04f5e...1b0c1e672a417c3f4a46b36497168d6d61dba0cb,1,38,7,45,7,2005-09-18 21:14:52,2005-09-18 18:14:19
1b0c1e672a417c3f4a46b36497168d6d61dba0cb...a8783eeb7988a20664dade2379d380ee1a199a10,1,16,0,16,1,2005-09-18 21:18:34,2005-09-18 18:18:30
a8783eeb7988a20664dade2379d380ee1a199a10...37539fbda5962cd3b7d8fe5ae8db743b5d9c9940,1,31,1,32,1,2005-09-18 21:18:38,2005-09-18 18:27:45
37539fbda5962cd3b7d8fe5ae8db743b5d9c9940...34143b2639625f29edf7b1c0c5af58e545845911,1,25,11,36,11,2005-09-18 21:18:57,2005-09-18 19:09:22
34143b2639625f29edf7b1c0c5af58e545845911...87c6aeb4efdd4355918d127a91bd0adc5a02f8ff,1,2,1,3,1,2005-09-18 22:45:09,2005-09-18 22:45:09
5512ac5840c8bcaa487806cf402ff960091ab244...53a3972171723d5d67178c9eba03112931a86cae,1,2,4,6,2,2014-01-06 17:34:19,2014-01-06 13:45:19
53a3972171723d5d67178c9eba03112931a86cae...f05023324c74bd12e66ac1dd04bbe2692c31dbfb,1,2,1,3,2,2014-01-06 17:34:19,2014-01-06 13:45:20
f05023324c74bd12e66ac1dd04bbe2692c31dbfb...831651fde8f8a8d90543917a8783962aa1a534bf,1,11,9,20,8,2014-01-06 17:34:19,2014-01-06 13:45:21
831651fde8f8a8d90543917a8783962aa1a534bf...26c8ae2a577cd283ab9fa8ab5e5f0ced568dc034,1,5,5,10,4,2014-01-06 17:34:20,2014-01-06 13:45:22
26c8ae2a577cd283ab9fa8ab5e5f0ced568dc034...bf10cf70ad0c777dbbbb00bbb741436e285c2181,1,3,2,5,2,2014-01-06 17:34:20,2014-01-06 13:45:23
bf10cf70ad0c777dbbbb00bbb741436e285c2181...9e6f885d146c58b23b166a99b93f115735b7bf22,1,9,13,22,7,2014-01-06 17:34:21,2014-01-06 13:45:24
9e6f885d146c58b23b166a99b93f115735b7bf22...0be0521b23f46dac586e1b464fafe8b97027b645,4,26,13,39,12,2014-01-06 17:34:21,2014-01-06 13:45:25
0be0521b23f46dac586e1b464fafe8b97027b645...f3565c0ca535d3becdcd2266002385709ddfa66c,1,4,3,7,3,2014-01-06 17:34:22,2014-01-06 13:45:26
f3565c0ca535d3becdcd2266002385709ddfa66c...18d37e860dfb9a98fb93ea7bb517ec3c16f995c4,2,20,1,21,3,2014-01-06 17:34:22,2014-01-06 13:45:27
18d37e860dfb9a98fb93ea7bb517ec3c16f995c4...c4c61c763e700d02344490590d6980ee51031a27,1,10,1,11,2,2014-01-21 21:46:07,2014-01-18 22:48:54
c4c61c763e700d02344490590d6980ee51031a27...e5c223e98b985d9faa274039aefa4391d2da25a6,1,12,1,13,2,2014-01-21 21:46:30,2014-01-18 22:48:55
e5c223e98b985d9faa274039aefa4391d2da25a6...ecb2c282c0d6cdd9938ba9cf228316ebc91b397e,1,5,2,7,1,2014-01-21 21:46:32,2014-01-18 22:48:56
ecb2c282c0d6cdd9938ba9cf228316ebc91b397e...863808cd1a7bd23dc12a3b54e32eb3f25d9487bc,1,16,6,22,5,2014-01-21 21:46:47,2014-01-18 22:48:57
863808cd1a7bd23dc12a3b54e32eb3f25d9487bc...fa59ae7971498157370d935adbb2bfc28012aa9f,1,30,22,52,4,2014-01-21 21:46:59,2014-01-18 22:48:58
fa59ae7971498157370d935adbb2bfc28012aa9f...ae4a283e3b4cdc99a548d215739539c3a690f290,1,10,1,11,3,2014-01-21 21:47:13,2014-01-18 22:48:59
ae4a283e3b4cdc99a548d215739539c3a690f290...f1e9e9a4dbe2cfb39dcb14ee4f34628ef46d7b15,1,2,2,4,2,2014-01-21 21:47:24,2014-01-18 22:49:00
f1e9e9a4dbe2cfb39dcb14ee4f34628ef46d7b15...08f555cb82f92797ca0aa0d6ba32e6872f1331e5,1,8,1,9,1,2014-01-21 21:47:28,2014-01-18 22:49:01
5512ac5840c8bcaa487806cf402ff960091ab244...cb0553651d9bbfc7ecdb9ebe8365a449156f3455,1,8,8,16,8,2014-01-03 17:21:38,2014-01-03 17:05:43
5512ac5840c8bcaa487806cf402ff960091ab244...68830470712b370d5ea231f76babd60a8859c105,1,2,0,2,1,2014-01-02 22:40:03,2013-12-28 09:29:15
68830470712b370d5ea231f76babd60a8859c105...a63c12c9be28bf455816b1ece4a52b463ecf6241,2,5,11,16,6,2014-01-02 22:43:11,2013-12-28 09:31:49
a63c12c9be28bf455816b1ece4a52b463ecf6241...738a8beac42d5e2c6b882f997b7fc6577363c544,1,0,3,3,1,2014-01-02 22:43:12,2013-12-28 09:33:40
5512ac5840c8bcaa487806cf402ff960091ab244...b9cf14d43b221fc2cce07b63d1dca408c17946e3,1,1,2,3,2,2013-12-30 20:23:51,2013-12-30 16:28:55
5512ac5840c8bcaa487806cf402ff960091ab244...e228c1736f25c59cd6da51ed97e03ecd80a935e6,4,45,10,55,12,2013-12-28 00:46:25,2013-12-27 20:49:57
5512ac5840c8bcaa487806cf402ff960091ab244...8785b7654bfbdbf718b950e86924753753548ff4,2,4,4,8,4,2013-12-26 19:55:18,2013-12-22 02:56:41
5512ac5840c8bcaa487806cf402ff960091ab244...491a8dec44e9b91149ef77c77c341e7d41df39be,1,30,7,37,3,2013-12-18 22:59:43,2013-12-18 22:59:12
3f09db07b3dc0758756fad73c96abd0e47cbcd1b...9bab5b6061f1bc8ca54f8ac145f4f88c644e3bc4,3,64,3,67,10,2014-03-24 00:28:03,2014-03-22 09:47:34
9bab5b6061f1bc8ca54f8ac145f4f88c644e3bc4...ce7f8745aa773dfe2fc0a1b8c327b50c7ce4a31e,1,56,56,112,2,2014-03-24 00:28:03,2014-03-23 22:26:36
bd3e186d811a13d8687584856f345a767e3e4d67...3253553e12d40da3bca818528f49a63c95f43aa3,5,26,2,28,10,2014-01-27 23:15:52,2014-01-24 00:50:58
3253553e12d40da3bca818528f49a63c95f43aa3...51ba8ce372ad9fcab04a013252b819625c44770a,7,8,0,8,7,2014-02-03 20:11:10,2014-02-01 02:17:59
51ba8ce372ad9fcab04a013252b819625c44770a...883366235f58baf3a225e19004116545ede2282e,1,9,9,18,2,2014-02-03 20:12:18,2014-02-01 02:18:00
883366235f58baf3a225e19004116545ede2282e...3b4e395f510c0193be06f264ec53271a6baf0414,2,13,2,15,6,2014-02-03 20:12:34,2014-02-01 02:18:01
3b4e395f510c0193be06f264ec53271a6baf0414...2f9dc1fb529662e157c53c7d91e5f75e0f72c6ea,1,0,2,2,2,2014-02-03 20:13:44,2014-02-01 02:18:02
2f9dc1fb529662e157c53c7d91e5f75e0f72c6ea...e4a4e7f27ad5d7a8534608b9a4d2d19ee6238925,1,1,1,2,1,2014-02-03 20:13:55,2014-02-01 02:18:03
e4a4e7f27ad5d7a8534608b9a4d2d19ee6238925...b6e9e73e8af20c2301595d58087ad58a9df05725,1,22,28,50,15,2014-02-11 22:48:05,2014-02-10 01:03:36
b6e9e73e8af20c2301595d58087ad58a9df05725...3ee5e54038fd32ee60b24ebd385981aeb14b80a5,5,47,17,64,25,2014-02-11 22:48:20,2014-02-10 01:03:37
3ee5e54038fd32ee60b24ebd385981aeb14b80a5...ea230d8b626d48a5b7851d84f75dd6708479cb59,1,12,1,13,3,2014-02-11 22:52:08,2014-02-10 01:03:38
7bbc4e8fdb33e0a8e42e77cc05460d4c4f615f4d...42c55ce49eb3c8741f62a0abdfb38182d461126c,1,11,10,21,1,2014-07-10 22:25:03,2014-06-27 13:18:36
7bbc4e8fdb33e0a8e42e77cc05460d4c4f615f4d...782735203c316041df120748e5e88c1787cdf4da,2,2,2,4,2,2014-07-02 19:37:05,2014-07-02 18:24:05
782735203c316041df120748e5e88c1787cdf4da...45067fc973c31953ab283f77f0f91eba9a272624,1,2,2,4,2,2014-07-02 19:51:38,2014-07-02 18:44:30
7bbc4e8fdb33e0a8e42e77cc05460d4c4f615f4d...80b47854ca84abec991f6fff42dbeb6626588b87,1,2,1,3,1,2014-07-01 20:30:50,2014-07-01 18:00:01
7bbc4e8fdb33e0a8e42e77cc05460d4c4f615f4d...9393ae79c9b4d3deade544be9ce057b7fa290490,1,1,1,2,1,2014-06-13 22:00:17,2014-06-13 17:40:50
7bbc4e8fdb33e0a8e42e77cc05460d4c4f615f4d...e3fa568cb397a78a56716137c826f21f5e0b0a77,1,4,2,6,1,2014-06-09 21:53:49,2014-06-06 22:33:25
7bbc4e8fdb33e0a8e42e77cc05460d4c4f615f4d...6219bb22ba213ff75ca9cb8aa0d4debd28c34f21,3,4,4,8,3,2014-06-09 21:18:55,2014-06-09 19:23:30
6219bb22ba213ff75ca9cb8aa0d4debd28c34f21...e1ecd9e3c8f800e3eab908df3e9fc4e166fca394,3,4,2,6,3,2014-06-09 21:18:55,2014-06-09 20:54:25
e1ecd9e3c8f800e3eab908df3e9fc4e166fca394...ac2803b9625a9c38c1595f22da8f160969ed9625,1,47,43,90,15,2014-06-09 21:18:55,2014-06-09 20:21:59
ac2803b9625a9c38c1595f22da8f160969ed9625...f23b1d06e5a7a162a7cfc5281b10580e7e3d23d6,1,18,9,27,3,2014-06-09 21:18:55,2014-06-09 20:36:54
f23b1d06e5a7a162a7cfc5281b10580e7e3d23d6...19c8c4a9b70a5c896d2c88250d7f209970fdf8d0,1,4,6,10,5,2014-06-09 21:18:55,2014-06-09 20:43:19
19c8c4a9b70a5c896d2c88250d7f209970fdf8d0...b687cd6aba394bba34ad9fb70aa33cd5cfcebc6c,1,8,14,22,7,2014-06-09 21:18:55,2014-06-09 21:03:10
7bbc4e8fdb33e0a8e42e77cc05460d4c4f615f4d...c057b2424a479a2219666f3806c0dd93867ca5c9,1,3,4,7,1,2014-06-03 17:04:19,2014-06-03 07:17:17
c057b2424a479a2219666f3806c0dd93867ca5c9...d795216ac35f08e1ae2a706fca4c06a887c7d797,1,1,1,2,1,2014-06-03 17:04:21,2014-06-03 07:23:49
7bbc4e8fdb33e0a8e42e77cc05460d4c4f615f4d...b1a013dd6a79826675138cf9bdfaf18fafa786ba,1,3,3,6,3,2014-06-02 20:30:18,2014-06-01 09:00:40
7bbc4e8fdb33e0a8e42e77cc05460d4c4f615f4d...bed137d2d55a3b5cbd642b1e80cd7bd9094db8d4,3,6,3,9,3,2014-05-23 22:32:33,2014-05-23 10:15:31
bed137d2d55a3b5cbd642b1e80cd7bd9094db8d4...c1cebcf4314a8f18ec06e6d10ce39f49a59076ec,2,10,2,12,2,2014-05-23 22:32:54,2014-05-23 18:19:34
7bbc4e8fdb33e0a8e42e77cc05460d4c4f615f4d...88d5a6f6cd1b63e1637027322cdfdbeefe38c3ed,4,16,22,38,5,2014-05-23 19:39:44,2014-05-22 09:44:09
7bbc4e8fdb33e0a8e42e77cc05460d4c4f615f4d...561b46c5c8a9d204974e6edd4f58a5fca343d6d3,1,4,4,8,2,2014-05-23 19:17:38,2014-05-23 18:44:05
7bbc4e8fdb33e0a8e42e77cc05460d4c4f615f4d...dd63f169d9381a77db469325688a2bef1a79a9e1,2,5,6,11,3,2014-05-20 18:09:03,2014-05-20 06:49:20
7bbc4e8fdb33e0a8e42e77cc05460d4c4f615f4d...bd46cfae8224ec2240e58302e8ddd16b701cbe6a,1,8,0,8,1,2014-05-19 20:44:00,2014-05-18 20:28:39
7bbc4e8fdb33e0a8e42e77cc05460d4c4f615f4d...f7febbea07cf6d65f85b0cdb6684d2e3666c557e,1,3,0,3,1,2014-05-15 19:49:23,2011-02-08 06:17:24
7bbc4e8fdb33e0a8e42e77cc05460d4c4f615f4d...d6c8a05bd58be82165be54f01c861c0fae28b8c4,1,5,1,6,5,2014-05-15 17:03:06,2014-05-15 08:54:06
7bbc4e8fdb33e0a8e42e77cc05460d4c4f615f4d...530481004443a00fbf5ab477b36b90508b4dc59d,2,32,12,44,7,2014-05-15 16:35:33,2014-05-14 22:13:06
7bbc4e8fdb33e0a8e42e77cc05460d4c4f615f4d...ad2f7255b3e93dacd0982a946d30f6595dd8a805,4,15,11,26,9,2014-05-15 16:32:08,2014-05-14 22:12:45
7bbc4e8fdb33e0a8e42e77cc05460d4c4f615f4d...0170a3c6ee7eba128d44dd50d0bf7a86d295c19e,1,0,3,3,1,2014-05-08 20:57:11,2014-05-08 20:36:57
7bbc4e8fdb33e0a8e42e77cc05460d4c4f615f4d...7d7d680221e6aac4210cf3c0be9ab237bc45b781,2,12,12,24,12,2014-05-07 18:20:54,2014-05-04 06:12:55
7bbc4e8fdb33e0a8e42e77cc05460d4c4f615f4d...de3d8bb7736cafae0ff10e047e2afa994b1dd901,1,2,0,2,1,2014-04-30 17:30:02,2014-04-30 04:08:29
7bbc4e8fdb33e0a8e42e77cc05460d4c4f615f4d...076cbd6341182d296671cb101c75145eb3bfda0a,2,12,4,16,3,2014-04-28 16:58:09,2014-04-25 23:11:15
7bbc4e8fdb33e0a8e42e77cc05460d4c4f615f4d...8976500cbbb13270398d3b3e07a17b8cc7bff43f,2,54,24,78,25,2014-04-22 19:37:53,2014-04-21 23:53:09
7bbc4e8fdb33e0a8e42e77cc05460d4c4f615f4d...06bdc23b7e5b20ab06bf0feb3d463d032978992f,1,1,0,1,1,2014-04-16 17:21:14,2014-04-16 16:51:47
7bbc4e8fdb33e0a8e42e77cc05460d4c4f615f4d...ff7a1c677a88eda9a24489676052f0631a6b7fc8,1,2,2,4,1,2014-04-11 20:21:56,2014-04-11 08:28:19
7bbc4e8fdb33e0a8e42e77cc05460d4c4f615f4d...00764ca10e0b55b21853fe3f41d688254cfaec08,1,2,2,4,2,2014-04-11 20:19:00,2014-04-11 08:24:02
7bbc4e8fdb33e0a8e42e77cc05460d4c4f615f4d...9aa91af0361e3c32fde5f8388dee963838308cd6,4,21,4,25,5,2014-04-10 19:18:55,2014-04-10 18:54:12
9aa91af0361e3c32fde5f8388dee963838308cd6...426ddeead6112955dfb50ccf9bb4af05d1ca9082,3,69,1,70,6,2014-04-10 19:27:58,2014-04-10 18:31:21
7bbc4e8fdb33e0a8e42e77cc05460d4c4f615f4d...ad1c3fbd26d0aae50abfb3c7d654f7229ba9370d,1,1,1,2,1,2014-03-31 18:48:26,2014-03-31 18:47:17
7bbc4e8fdb33e0a8e42e77cc05460d4c4f615f4d...14d3bb4955a41e146b6f1cd6571602a6b46b2af9,2,11,13,24,4,2014-03-26 21:02:33,2014-03-26 20:42:06
7bbc4e8fdb33e0a8e42e77cc05460d4c4f615f4d...7a76c28ff29d6f819bb0bf9852b858f974b5c53a,2,9,5,14,8,2014-03-26 19:56:30,2014-03-20 12:12:41
7bbc4e8fdb33e0a8e42e77cc05460d4c4f615f4d...93728b23adef675c19b13095f9623c2be18a8738,1,7,2,9,1,2014-03-21 18:55:07,2014-03-21 04:07:08
7bbc4e8fdb33e0a8e42e77cc05460d4c4f615f4d...effd12ec876df016d4346fee0d3d6bf31308fa11,1,6,12,18,1,2014-03-20 18:20:48,2014-03-19 23:02:04
7bbc4e8fdb33e0a8e42e77cc05460d4c4f615f4d...3c3e6f5645c5e661bc8c338e4e7a9252a14e429e,1,2,2,4,2,2014-03-17 22:13:46,2014-03-16 22:54:56
7bbc4e8fdb33e0a8e42e77cc05460d4c4f615f4d...de983a0a1817437fbb0db938ecf91f73023a5f87,1,2,2,4,2,2014-03-17 22:08:36,2014-03-17 22:08:36
7bbc4e8fdb33e0a8e42e77cc05460d4c4f615f4d...7e27173ef9152fe93d3fc42b60febbc782e4db16,1,19,18,37,2,2014-03-14 22:23:49,2014-03-14 21:57:23
7bbc4e8fdb33e0a8e42e77cc05460d4c4f615f4d...89ccc1b09cf4004e6129c66def42b47206ed6b5f,1,4,0,4,2,2014-03-11 21:44:21,2014-03-08 19:29:17
89ccc1b09cf4004e6129c66def42b47206ed6b5f...fb8a4e8079ab8fc37e9cde32957c35637280ab8f,2,17,1,18,3,2014-03-17 18:38:41,2014-03-15 18:56:52
7bbc4e8fdb33e0a8e42e77cc05460d4c4f615f4d...cf424f5fd89bb5cd09b24c96633f8951b6fd7b54,2,19,2,21,3,2014-03-11 19:13:42,2014-03-10 20:37:30
cf424f5fd89bb5cd09b24c96633f8951b6fd7b54...1f2e1088871e777355025a84f80a2d8b5cb04c06,1,6,9,15,1,2014-03-11 19:14:25,2014-03-10 17:24:47
7bbc4e8fdb33e0a8e42e77cc05460d4c4f615f4d...6eca18ca734043a8d3e540e89575362cfe983d6f,2,2,2,4,2,2014-03-06 23:22:34,2014-03-06 23:22:34
7bbc4e8fdb33e0a8e42e77cc05460d4c4f615f4d...305a233c98b2cc2f779789b7003544bbbb93fc14,1,4,4,8,4,2014-03-04 02:29:34,2014-03-04 00:21:43
7bbc4e8fdb33e0a8e42e77cc05460d4c4f615f4d...8358f1acd5f0cc7f886228f3266ab6940995fe1c,1,1,1,2,1,2014-03-03 22:10:55,2014-03-03 21:15:50
8358f1acd5f0cc7f886228f3266ab6940995fe1c...b294097bc64b056685c938c338f047be0c0771d8,1,3,0,3,1,2014-03-03 22:11:18,2014-03-03 21:16:12
7bbc4e8fdb33e0a8e42e77cc05460d4c4f615f4d...d10cb3dfab92bf24e2919ae3d4a16013dba0261f,1,3,4,7,3,2014-02-28 21:24:53,2014-02-28 19:27:29
7bbc4e8fdb33e0a8e42e77cc05460d4c4f615f4d...f57b6cfdf7b395adc6b3c813109c2eb53e93809a,1,11,0,11,1,2014-02-28 20:53:50,2014-02-28 06:17:25
7bbc4e8fdb33e0a8e42e77cc05460d4c4f615f4d...f377e7a37c1b28359a228cf5bb43161a8a22b385,1,20,0,20,1,2014-02-28 20:38:20,2014-02-27 09:00:09
f377e7a37c1b28359a228cf5bb43161a8a22b385...e6f637122ecd60c59df27b8188b6ddac39ac0063,2,45,7,52,8,2014-03-26 19:57:52,2014-02-27 09:00:10
7bbc4e8fdb33e0a8e42e77cc05460d4c4f615f4d...98b406f3ad6a6989a5b11c2a2582a9f539d66263,2,19,1,20,4,2014-02-24 20:53:28,2014-02-24 08:59:03
7bbc4e8fdb33e0a8e42e77cc05460d4c4f615f4d...94eaa806519498de2ca59a424b013812d72d21c5,1,2,16,18,3,2014-02-24 17:53:57,2014-02-24 03:12:35
94eaa806519498de2ca59a424b013812d72d21c5...fcfec8bd9a9bf0a0f36ba4aed85f5768988aa946,1,14,0,14,1,2014-03-05 20:20:23,2014-03-05 09:23:35
7bbc4e8fdb33e0a8e42e77cc05460d4c4f615f4d...c20aec05e35f4f0e62e892b335aebebd6196ca92,1,1,1,2,1,2014-02-24 17:13:30,2014-02-21 17:25:24
7bbc4e8fdb33e0a8e42e77cc05460d4c4f615f4d...b7756d41dcc6720e6005b663bcb6f8b2f2a66763,2,15,3,18,3,2014-02-18 22:40:23,2014-02-16 02:28:03
eea591373e139fc8aab89a78ccb0b1512a2bf0de...c2369bdf7ff082d588c4a4efe280bc4a483d0192,5,30,8,38,5,2014-06-10 20:30:04,2010-07-13 14:17:43
eea591373e139fc8aab89a78ccb0b1512a2bf0de...9352fd570876ea0faf9f12251ecea06954fbe59b,1,1,1,2,1,2014-05-27 19:59:32,2014-05-27 08:45:58
eea591373e139fc8aab89a78ccb0b1512a2bf0de...ccfb5bdad957387cc6b36c9115aaa9615a55a893,1,8,0,8,2,2014-05-14 17:30:03,2012-10-23 23:15:29
ccfb5bdad957387cc6b36c9115aaa9615a55a893...248b68f3f29e63fca83db8421350184d20481610,1,4,4,8,2,2014-05-14 17:30:07,2012-10-23 23:15:29
eea591373e139fc8aab89a78ccb0b1512a2bf0de...670a7297c2afe4de387cb208fddc90f0f59df6aa,1,3,1,4,1,2014-05-13 19:35:00,2014-05-13 18:46:57
eea591373e139fc8aab89a78ccb0b1512a2bf0de...77583e7739c76f623f49681c9ee4d10a313fe786,1,7,2,9,1,2014-05-12 18:27:50,2014-05-12 04:38:39
eea591373e139fc8aab89a78ccb0b1512a2bf0de...a1a301114e0ba3f60474d857c93d02890d00e65b,1,5,0,5,1,2014-05-12 17:19:23,2014-05-10 14:02:59
74ca49330a02d66a47be53e91bf3fa8577ddb946...a25014bc4cef56712f7d005d7b76070d0270f454,1,114,1,115,6,2014-01-10 19:25:01,2014-01-10 19:25:01
932f7e47699993de0f6ad2af92be613994e40afe...1cbd18300a8755ba46791b2aa6249fa537a1d651,2,33,0,33,2,2014-01-07 22:33:04,2014-01-07 21:31:32
1cbd18300a8755ba46791b2aa6249fa537a1d651...bbad9f9314f658b5c0f302148fc9780f5788dcd8,2,25,0,25,2,2014-01-07 22:34:06,2014-01-07 21:32:37
932f7e47699993de0f6ad2af92be613994e40afe...de06c13a9464440778ef060e42a0258c8c55f4ad,1,1,0,1,1,2014-01-07 17:59:25,2014-01-06 17:18:51
74f45dfd78661a84fcff81e616ef6c154deadcb9...f3f407747c1cce420ae4b4857c4a6806efe38680,1,31,0,31,2,2015-02-18 19:53:17,2015-02-18 19:53:17
407a792ef7e3c142a47c6b09a80f9ede4e14f444...0a80bc9f13bf4373778e787b3a050f5b784faf30,1,3,0,3,1,2015-01-22 20:57:24,2015-01-16 21:21:13
99902739174be82851143d4be2a0f85727a9efe0...d6589d1ba42dd87c282c72045537f5eea8aaefcf,1,3,3,6,1,2015-01-21 00:12:54,2015-01-20 19:30:28
ac930287ff16823531b541a8e6a7436279e612be...f02033f1d02a55b32815a4702389e4d492f38bcc,1,17,0,17,1,2014-02-04 19:24:53,2014-02-04 14:25:15
f02033f1d02a55b32815a4702389e4d492f38bcc...74af95d6aac03e1a1227c78d0d0ea8bbc2fa2b4d,1,5,0,5,1,2014-02-04 19:25:15,2014-02-04 14:25:16
74af95d6aac03e1a1227c78d0d0ea8bbc2fa2b4d...e5aa1fc472696bfc337b3f128d45c1ef2aba394d,1,6,0,6,1,2014-02-04 19:25:33,2014-02-04 14:25:17
e5aa1fc472696bfc337b3f128d45c1ef2aba394d...e131daa4c6baa53aba22e5d8bc1defa83b443bf0,1,10,0,10,1,2014-02-04 20:08:47,2014-02-04 14:25:18
e131daa4c6baa53aba22e5d8bc1defa83b443bf0...ddc2a6281595fd24ea01497c496f88c40a59562f,1,64,0,64,1,2014-02-04 20:08:49,2014-02-04 14:25:19
ddc2a6281595fd24ea01497c496f88c40a59562f...655ee9ea3e6c0af57d320e84723ec3bf656cdbf7,3,12,22,34,6,2014-02-04 20:08:49,2014-02-04 14:25:20
ac930287ff16823531b541a8e6a7436279e612be...4824d1b8c2d0e9e6a549c836aa6a7698fdba021b,1,1,1,2,2,2014-01-31 18:44:04,2014-01-29 13:25:00
4824d1b8c2d0e9e6a549c836aa6a7698fdba021b...e36f3a8a6fa1a1d99fb5730cd7642ecd0854b564,1,6,6,12,3,2014-01-31 18:44:04,2014-01-29 13:30:27
e36f3a8a6fa1a1d99fb5730cd7642ecd0854b564...ac39b27786856c3d622d3ad2c1423ce1606ec7d4,1,3,3,6,2,2014-01-31 18:44:05,2014-01-29 13:33:15
ac39b27786856c3d622d3ad2c1423ce1606ec7d4...e666b89d76c9a25ce4cb3b73932a78524475fc27,1,2,1,3,2,2014-01-31 18:44:05,2014-01-29 13:36:15
e666b89d76c9a25ce4cb3b73932a78524475fc27...e23fd15adab11eef216fd49a6329f381ce14061f,1,6,5,11,9,2014-01-31 18:44:05,2014-01-30 15:15:56
e23fd15adab11eef216fd49a6329f381ce14061f...bf7e645c90e08f0d3391502c888453033e446372,1,1,1,2,2,2014-01-31 18:44:05,2014-01-29 16:54:16
bf7e645c90e08f0d3391502c888453033e446372...4f1c0b21e9045ff12e1880b5724a032031716a24,1,3,2,5,3,2014-01-31 18:44:05,2014-01-29 16:59:37
ac930287ff16823531b541a8e6a7436279e612be...088304bf73b9b4149e04d2246fe08a06eef6e795,1,1,0,1,1,2014-01-23 21:11:07,2014-01-23 19:54:57
088304bf73b9b4149e04d2246fe08a06eef6e795...a0332337be53f266682279c72a5e553986638c87,1,1,1,2,1,2014-01-23 21:13:20,2014-01-23 19:55:18
ac930287ff16823531b541a8e6a7436279e612be...75d6e552a8f289fb0ee606a7bdfceace6df93bb3,2,3,3,6,2,2014-01-21 21:50:00,2014-01-19 07:01:15
cbfe47b67fc1072998c73e6d43cf6ad061a436f5...7d0a9a752b66be76c4027ead98caa1be7bac5349,1,1,1,2,1,2014-02-24 17:52:44,2014-02-24 00:54:47
9f673f9477c63433aa0774c11b9e42979721f4d6...62aad1849f3009d1e6c7126a321e5515c1543dc3,1,20,6,26,5,2014-05-27 19:33:53,2014-05-25 00:38:29
d9bb4be53bc5185244b4be9860562a012803bacb...ab0bcec9873f1fcef6c4b8825cc9e762c636ca9e,1,38,3,41,8,2014-01-23 02:54:26,2014-01-23 02:15:19
d9bb4be53bc5185244b4be9860562a012803bacb...f21e1c5d36cfbbff753cec652c21a88a129f1a27,2,5,0,5,2,2014-01-22 20:08:39,2014-01-22 11:23:20
d9bb4be53bc5185244b4be9860562a012803bacb...0c1cddd01543feb101c0d95180e27ab840b280b9,1,16,0,16,1,2014-01-21 21:41:30,2013-11-16 17:37:57
df49095ac25885c1bb1405bf7f10f48f14213852...561580eadd9e41e88b04b565a67641ba500b443a,1,964,843,1807,800,2014-01-18 13:44:13,2014-01-18 13:36:19
df49095ac25885c1bb1405bf7f10f48f14213852...5832c3f2f408c934a165d1f1f18812c9aeae0fe4,1,1240,1149,2389,1058,2014-01-18 02:07:40,2014-01-18 02:07:40
90360c710c4105e3bce74fc2d746c4fa48bf07e7...5addd1c7531cc644787cd562a3c22a3b714c7d77,3,24,2,26,4,2013-07-15 17:39:43,2013-07-15 17:39:43
ad76feb55eb7645661421e213796129efcbb7d56...85318f521f6c0b9843d6da12abf67f2de7608431,1,12,0,12,2,2013-06-26 22:10:17,2013-06-26 22:10:17
726016725d45894c061e8d187385327f82803c9f...b12905140a8239ac687450ad43f18b5f0bcfb62e,1,9,7,16,3,2012-07-03 19:13:19,2012-06-23 13:18:00
726016725d45894c061e8d187385327f82803c9f...11b901747b94b2a36a9b5933bb85b3cea3c0bb5d,1,329,208,537,207,2012-07-03 02:31:59,2012-07-03 02:31:59
11b901747b94b2a36a9b5933bb85b3cea3c0bb5d...5714e413614929a2fceb479bd00dac7d1858df48,1,364,236,600,208,2012-07-03 07:31:59,2012-07-03 07:22:32
5714e413614929a2fceb479bd00dac7d1858df48...9aaa979a24b037fb1af96c0c6a7aa50ee48f7507,1,334,211,545,204,2012-07-04 18:34:21,2012-07-04 18:34:21
9aaa979a24b037fb1af96c0c6a7aa50ee48f7507...b6bf84675d94f3b15a7194ac0334ea7e4d29ecba,1,349,220,569,208,2012-07-05 17:46:50,2012-07-03 16:02:11
b6bf84675d94f3b15a7194ac0334ea7e4d29ecba...6792b93b1965561e85be3733bb3ab00b2e598119,1,351,215,566,206,2012-07-06 01:11:15,2012-07-04 09:20:34
53bcf22afa3a7d02de39679e85b6d1be08331f8c...4b7518a4aa24339d53e04151ba6b337245527c03,1,1,1,2,1,2012-07-17 20:11:03,2012-07-17 20:11:03
60475183c0fe76eab2a12fdf840caa0a29217886...0e64a95ae5824238cebdc921ed060efdef19620d,4,13,3,16,5,2012-06-21 21:43:59,2012-06-21 20:16:46
60475183c0fe76eab2a12fdf840caa0a29217886...e40d724f853269094310e858371cabc4bfdbaeec,1,1,1,2,1,2012-06-21 20:18:49,2012-06-21 20:18:49
c5fe239860cc7afcae33c78307896be8c754517e...cd46259ebf2e624bcee2aaae05c36663d414e1a2,1,1,1,2,1,2012-10-11 18:18:56,2012-10-11 18:18:56
76c36c02ff3fe1571051ce9278248bd269f8341b...de29a7ac0ec31d8f5fa91b7d2f0294165787d558,1,11,5,16,2,2012-12-12 19:07:48,2012-12-11 23:04:36
b0576a6a6dd3b311391090b2ce15f991ac9914cf...5e5c006eb713b785c6761c32b907e02abc277f9a,2,3,3,6,3,2012-12-16 20:01:58,2012-12-16 18:28:09
5e5c006eb713b785c6761c32b907e02abc277f9a...e8e5195573bc0f314ccc288f7d009b47e4440760,1,4,2,6,3,2012-12-20 22:22:03,2012-12-16 18:28:10
e8e5195573bc0f314ccc288f7d009b47e4440760...b8fc855a7804426528c872e6c9ecd39a2897d427,1,1,1,2,1,2012-12-20 22:22:12,2012-12-16 18:28:11
b8fc855a7804426528c872e6c9ecd39a2897d427...0a6d4751daa0d1638ce181ffb54290b84bde3791,1,3,3,6,3,2012-12-20 22:22:12,2012-12-16 18:28:12
0a6d4751daa0d1638ce181ffb54290b84bde3791...565b6fa87bb0554eb7f1b8ec004df93e55d177a9,1,40,45,85,10,2012-12-20 22:22:12,2012-12-16 18:28:13
565b6fa87bb0554eb7f1b8ec004df93e55d177a9...5ebf89e88637fa641ced15edc10be0cf8d5dcbc8,1,105,0,105,2,2012-12-20 22:22:12,2012-12-16 18:28:14
5ebf89e88637fa641ced15edc10be0cf8d5dcbc8...b73d9a2363beedd59c212b5aa6b9db2977c38b2b,2,33,10,43,9,2012-12-20 22:22:12,2012-12-16 18:28:15
1b48d56cfb006baf12d34b5e3150ba2ec1900e08...9462953ad25f9ad6ef933908c317dcbbfd4397ed,1,5,5,10,5,2013-10-30 17:30:30,2013-10-30 08:44:43
9c50374497d5a3259907e32455f228cfbda85ddf...6bb2a1377b4b7a044f69d0107c38479180694fac,3,24,1,25,4,2012-11-08 16:34:08,2012-11-04 07:07:06
6bb2a1377b4b7a044f69d0107c38479180694fac...f992f0c80f30ac5a0aacfdfad55083dafb33047e,1,1,1,2,1,2012-11-08 16:34:22,2012-11-04 07:07:07
f992f0c80f30ac5a0aacfdfad55083dafb33047e...131352433621e89b2e8c58d8327b1d55bf0bc8d0,1,16,22,38,4,2012-11-08 16:34:36,2012-11-04 07:07:08
131352433621e89b2e8c58d8327b1d55bf0bc8d0...031954d443668f6ea771e389c4137628d242c2d8,1,2,2,4,2,2012-11-08 16:34:42,2012-11-04 07:07:09
031954d443668f6ea771e389c4137628d242c2d8...6fa23773d2fa257cf45fb20640d6286d13ded852,1,8,13,21,4,2012-11-08 16:34:44,2012-11-04 07:07:10
9c50374497d5a3259907e32455f228cfbda85ddf...5085a4e2e81f295a93df9b4bd98813d771f18a3c,1,391,0,391,1,2012-11-04 13:35:20,2012-11-04 02:13:23
5085a4e2e81f295a93df9b4bd98813d771f18a3c...23b4a11fa47161a5e5f221c58f47400207403bc4,1,215,2,217,14,2012-11-04 13:35:20,2012-11-04 02:13:24
23b4a11fa47161a5e5f221c58f47400207403bc4...b4e956f7ef8c8d8e30577277b0ebd0840327d42f,1,7,2,9,5,2012-11-04 13:35:20,2012-11-04 02:13:25
b4e956f7ef8c8d8e30577277b0ebd0840327d42f...ffaf84c6631e1ee381ca0d04b363ee5c82fe20ac,1,12,2,14,4,2012-11-04 13:35:20,2012-11-04 02:13:26
ffaf84c6631e1ee381ca0d04b363ee5c82fe20ac...ff247d9e56366a3b03d8ca926fd88b51d3c2df52,1,11,1,12,5,2012-11-04 13:35:20,2012-11-04 02:13:27
ff247d9e56366a3b03d8ca926fd88b51d3c2df52...6497a2bab5880dc353b83bb5d4615074d6552959,1,17,0,17,3,2012-11-04 13:35:20,2012-11-04 02:13:28
6497a2bab5880dc353b83bb5d4615074d6552959...422ab5beb23d461634d202d2446d943513cf329b,1,83,6,89,10,2012-11-04 13:35:20,2012-11-04 02:13:29
422ab5beb23d461634d202d2446d943513cf329b...9490bd04fef0e0f04efa4679668f0a05328768e4,1,53,6,59,14,2012-11-04 13:35:20,2012-11-04 02:13:30
9490bd04fef0e0f04efa4679668f0a05328768e4...46cc3adb60f45273dcb0f9179d20bffe1f77f4ff,1,14,5,19,3,2012-11-04 13:35:20,2012-11-04 02:13:31
46cc3adb60f45273dcb0f9179d20bffe1f77f4ff...7ee719e18074a47e41dd315fcf8ced777a71adbd,2,125,0,125,2,2012-11-04 13:35:20,2012-11-04 02:13:32
7ee719e18074a47e41dd315fcf8ced777a71adbd...dd78478fe115072df2cd0756eb1c59dd70d554da,1,2,1,3,1,2012-11-04 13:35:20,2012-11-04 02:13:33
dd78478fe115072df2cd0756eb1c59dd70d554da...74954ee8aa0530a4c1ccaeaa5f8def71ef6b68bd,1,243,0,243,1,2012-11-04 13:35:21,2012-11-04 02:13:34
74954ee8aa0530a4c1ccaeaa5f8def71ef6b68bd...bb8a956409bb67e46dead1cc32d11871d45d6fdb,1,462,0,462,1,2012-11-04 13:35:21,2012-11-04 02:13:35
bb8a956409bb67e46dead1cc32d11871d45d6fdb...aefc605ada7fe00e1c6b8d4bf3aa17dc07855769,1,5,1,6,1,2012-11-04 13:35:21,2012-11-04 02:13:36
aefc605ada7fe00e1c6b8d4bf3aa17dc07855769...e30473c185442a9ac137f3841fe2d05e0e5ec81a,1,14,8,22,8,2012-11-04 13:35:21,2012-11-04 02:13:37
e30473c185442a9ac137f3841fe2d05e0e5ec81a...12ba4bd4ece3b53c810ac72124ff9ed818cffcd6,1,3,3,6,1,2012-11-04 13:35:21,2012-11-04 02:13:38
12ba4bd4ece3b53c810ac72124ff9ed818cffcd6...7241a9ffab73fe8f0f7eaa50149eaa24109350e5,1,9,0,9,1,2012-11-12 20:34:53,2012-11-12 17:41:05
7241a9ffab73fe8f0f7eaa50149eaa24109350e5...cc8433fad1f64ffaa9c1b8274c79f14419c42f78,1,1,1,2,1,2012-11-12 20:34:53,2012-11-12 17:41:06
cc8433fad1f64ffaa9c1b8274c79f14419c42f78...55dd56e042f96832327e07ee500a60db7fd244b9,1,2,0,2,1,2012-11-12 20:34:53,2012-11-12 17:41:07
55dd56e042f96832327e07ee500a60db7fd244b9...08c2599c3274c1f473ccae2aae67c04d4bbb57e4,1,3,0,3,1,2012-11-12 20:34:53,2012-11-12 17:41:08
08c2599c3274c1f473ccae2aae67c04d4bbb57e4...418673c4bc48c0b54856449739023b4f978ea235,1,1,1,2,1,2012-11-28 02:03:57,2012-11-28 01:01:32
418673c4bc48c0b54856449739023b4f978ea235...1e310551e7e3a2efe41cbe1bc0a6b919cd6f7d34,1,8,4,12,3,2012-11-28 02:04:00,2012-11-28 01:01:33
9c50374497d5a3259907e32455f228cfbda85ddf...b8c2c1fa35f240ea8eee719c0f5a657285864573,1,7,10,17,7,2012-11-04 11:46:55,2012-11-04 06:46:51
b8c2c1fa35f240ea8eee719c0f5a657285864573...1173bb331103b7e6d9e95549c7b7be12546d0697,1,10,13,23,4,2012-11-04 11:46:55,2012-11-04 06:46:52
1173bb331103b7e6d9e95549c7b7be12546d0697...17b73dc699c46d7af5d29d2f3813e7addafdce0d,2,11,9,20,9,2012-11-04 11:46:55,2012-11-04 06:46:53
17b73dc699c46d7af5d29d2f3813e7addafdce0d...06379a65098212aef05010598ba3a8549bd78474,2,49,0,49,6,2012-11-04 11:46:55,2012-11-04 06:46:54
f3828dc0669826660f5034a468913115675ff501...170260ae90cb6a0fec476e7d970e3ac3e81e98f5,5,8,8,16,7,2012-11-19 21:08:28,2012-11-18 09:13:06
170260ae90cb6a0fec476e7d970e3ac3e81e98f5...5d74762d87859d08fdf4c87ec9387e31e097acba,3,29,3,32,5,2012-11-26 19:12:51,2012-11-24 04:33:49
5d74762d87859d08fdf4c87ec9387e31e097acba...8c6abbcd2720dd80b1c9b6db8104c4dcc7cba6c7,4,24,4,28,9,2012-11-26 19:13:13,2012-11-24 04:33:50
8c6abbcd2720dd80b1c9b6db8104c4dcc7cba6c7...c904cd89e4328c0b5041b6ee0bb2df32459a33a2,1,64,1,65,4,2012-11-26 19:16:34,2012-11-24 04:33:51
f3828dc0669826660f5034a468913115675ff501...c9407860f47ec4cf1c64a2c2ca4ae0b451469658,1,78,0,78,1,2012-11-19 18:56:47,2012-11-18 11:08:08
8c7a786b6c8eae8eac91083cdc9a6e337bc133b0...4ae6d4699f4d1df7cd3ffac9dd361c86d62eca42,2,29,3,32,4,2013-02-01 04:30:55,2013-02-01 03:26:21
4ae6d4699f4d1df7cd3ffac9dd361c86d62eca42...e2afb0be9073fbe9f565ad9e952155c0bf7dd7c6,1,12,14,26,3,2013-02-01 04:30:55,2013-02-01 03:19:44
e2afb0be9073fbe9f565ad9e952155c0bf7dd7c6...e28efb1998bb0b73057de13b9568f6aef439a583,1,5,1,6,1,2013-02-01 04:30:55,2013-02-01 03:33:27
8c7a786b6c8eae8eac91083cdc9a6e337bc133b0...4a8273a3ed1d9db48920433471f87090423d1b5e,2,37,37,74,2,2013-01-25 19:07:30,2013-01-25 09:43:48
4a8273a3ed1d9db48920433471f87090423d1b5e...26daa842dc35b2fe522ef18a1404c72421b3894c,1,0,1,1,1,2013-01-25 19:07:39,2013-01-25 09:43:49
26daa842dc35b2fe522ef18a1404c72421b3894c...62b6f7e021cd5e7a7c3ee8d46ec45fe39d1bf562,1,4,2,6,3,2013-01-25 19:07:54,2013-01-25 09:43:50
62b6f7e021cd5e7a7c3ee8d46ec45fe39d1bf562...abaf175cdf85ab0eb8bedd7d84ea8b42b6b3dd01,1,8,49,57,2,2013-01-25 19:08:55,2013-01-25 09:43:51
abaf175cdf85ab0eb8bedd7d84ea8b42b6b3dd01...b2a6b7122e66d4882ef5ac31e3a03969b5b6a199,1,2,10,12,1,2013-01-28 02:32:43,2013-01-25 09:43:52
b2a6b7122e66d4882ef5ac31e3a03969b5b6a199...88d3406ad77dbab4d8ea76756822531228332b1b,1,21,5,26,5,2013-01-28 02:32:54,2013-01-25 09:43:54
88d3406ad77dbab4d8ea76756822531228332b1b...62957bea0c7637ae1db4452fc165c59d9408585b,1,20,3,23,4,2013-01-28 02:33:16,2013-01-27 00:40:06
62957bea0c7637ae1db4452fc165c59d9408585b...073678b8e6324a155fa99f40eee0637941a70a34,6,34,52,86,10,2013-01-29 03:00:38,2013-01-27 00:46:12
8c7a786b6c8eae8eac91083cdc9a6e337bc133b0...25a751f198c7f82e04f7c8ba866b3b89198c534f,1,2,2,4,2,2012-12-22 05:16:51,2012-12-22 05:16:51
25a751f198c7f82e04f7c8ba866b3b89198c534f...ce37596c137aef257b9b75dce1c6b2fd498bab23,1,6,7,13,7,2012-12-22 05:27:38,2012-12-22 05:27:38
ce37596c137aef257b9b75dce1c6b2fd498bab23...68cb7b6f85aa032c33e49137364da9b76b1d95a1,1,2,2,4,2,2012-12-22 07:12:25,2012-12-22 06:24:03
68cb7b6f85aa032c33e49137364da9b76b1d95a1...021f2f4c1aed011c664844408325fe683a4046a8,3,12,7,19,5,2012-12-22 07:55:10,2012-12-22 07:26:16
021f2f4c1aed011c664844408325fe683a4046a8...38ec23ac893e96a9027c1cf8112b3d97a0384d39,2,18,16,34,6,2012-12-22 07:55:40,2012-12-22 05:39:37
38ec23ac893e96a9027c1cf8112b3d97a0384d39...d28b5d47ab72a91d5090748f8f8baaf6ffa084fc,3,28,22,50,6,2012-12-22 07:55:40,2012-12-22 06:06:01
d28b5d47ab72a91d5090748f8f8baaf6ffa084fc...5fe10fe80a04a57affbaa35258f498bc1acb05e9,3,14,0,14,5,2012-12-22 08:21:23,2012-12-22 08:21:23
5fe10fe80a04a57affbaa35258f498bc1acb05e9...4aad08e061df699b49e24c4d34698d734473fb66,2,17,1,18,3,2013-01-02 22:16:07,2013-01-02 22:16:07
4aad08e061df699b49e24c4d34698d734473fb66...7952ea66e72d1129afbebcdde11dcbeecd92698a,3,11,2,13,4,2013-01-04 00:05:44,2013-01-02 22:19:05
8c7a786b6c8eae8eac91083cdc9a6e337bc133b0...9673b8c392a97c0dfa865ecf60b024f70a7dacfe,1,63,0,63,1,2012-11-16 20:01:24,2012-11-16 18:43:45
8c7a786b6c8eae8eac91083cdc9a6e337bc133b0...c190ced600223f0774f6ba33f608b1e1347e623e,2,11,3,14,5,2012-11-16 19:24:11,2012-11-15 10:45:00
8c7a786b6c8eae8eac91083cdc9a6e337bc133b0...afa8c07a26b9783c41b1066b75a35de1610a3cfa,1,3,0,3,1,2012-11-16 01:36:26,2012-11-15 17:12:33
8c7a786b6c8eae8eac91083cdc9a6e337bc133b0...585b96bd4c55e587b7736063125d06bf46e39d18,1,1,1,2,1,2012-11-14 21:45:38,2012-11-14 00:49:30
8c7a786b6c8eae8eac91083cdc9a6e337bc133b0...82f49f294c5ee58aff33dfd469bbd5c0d083e314,1,12,2,14,4,2012-10-29 07:29:43,2012-10-26 19:44:42
82f49f294c5ee58aff33dfd469bbd5c0d083e314...44fa0ef58c9e323ab8824cbbc49417e0586de71b,1,53,2,55,7,2012-10-29 07:29:43,2012-10-26 19:44:43
8c7a786b6c8eae8eac91083cdc9a6e337bc133b0...e980765c59c173e9a10ce1069c763645b87fd50c,1,1,0,1,1,2012-10-25 09:32:11,2012-10-23 20:39:56
8c7a786b6c8eae8eac91083cdc9a6e337bc133b0...38ae92e4d027063b9b87e51a9bf12809d10066f6,2,2,2,4,2,2012-10-25 08:46:13,2012-10-23 21:00:21
8c7a786b6c8eae8eac91083cdc9a6e337bc133b0...ed838e661551958076beda19c9445101da2b70ae,1,178,123,301,52,2012-10-24 07:36:49,2012-10-23 18:59:26
ed838e661551958076beda19c9445101da2b70ae...65ff5301342614cb72639aa8e676e62b77d1165c,1,0,4,4,1,2012-10-24 07:36:51,2012-10-23 19:09:22
65ff5301342614cb72639aa8e676e62b77d1165c...cb20b69166786210bcad406c192763f90be1639a,1,7,2,9,1,2012-10-24 07:36:52,2012-10-23 22:05:49
cb20b69166786210bcad406c192763f90be1639a...35998c89381a56b28433852386986aafde92428d,1,4,0,4,1,2012-10-24 07:36:53,2012-10-23 19:36:12
35998c89381a56b28433852386986aafde92428d...97ed50f93ba592b50278a8161282e862cb87b4c0,2,14,10,24,5,2012-10-24 07:36:54,2012-10-23 19:40:06
97ed50f93ba592b50278a8161282e862cb87b4c0...7acdd6f0bc27bba37591e2d5fc2ca84e2af13ce4,1,35,15,50,16,2012-10-24 07:36:54,2012-10-23 19:51:50
7acdd6f0bc27bba37591e2d5fc2ca84e2af13ce4...00b347d3aa094948d58dd1303aef7ba97ff09519,3,14,22,36,7,2012-10-24 07:36:55,2012-10-23 20:52:44
00b347d3aa094948d58dd1303aef7ba97ff09519...e89558988305c3e912c0674faeb814e44563f7fd,1,2,42,44,4,2012-10-24 07:36:58,2012-10-23 22:00:41
e89558988305c3e912c0674faeb814e44563f7fd...5ba1a8a735c721cc66cc030866163f6fdb7f5ecb,1,1,1,2,1,2012-10-29 05:48:06,2012-10-28 21:05:25
ca70c9ea7224e1e47d8ab46ea67ba9e29ce8a121...f838ce5826a2deffff7b70986fc7392d7114013e,3,6,12,18,4,2013-03-11 03:06:19,2013-03-11 01:31:47
f838ce5826a2deffff7b70986fc7392d7114013e...bd54cf17a4acfb9555b8a83b7e74fb0274c38bb4,3,103,1,104,2,2013-03-11 05:25:22,2013-03-11 01:32:32
ca70c9ea7224e1e47d8ab46ea67ba9e29ce8a121...421a97694590c2be58f3ccebf301c7239289aa00,1,1,1,2,1,2013-03-10 20:11:31,2013-03-10 15:10:20
443d803e0dacd0a1c6700503689f3cd95751aba1...25ed3412f86b136efb17689b6712d9e546cac388,7,151,109,260,13,2013-03-28 17:28:41,2013-03-28 16:47:30
25ed3412f86b136efb17689b6712d9e546cac388...c7edcae06ed90ec0567179a78d7d1170e610c042,2,14,9,23,5,2013-03-28 17:29:10,2013-03-28 16:47:31
c7edcae06ed90ec0567179a78d7d1170e610c042...12da1d1f6ffcd546a892a33302bb34fd37169022,20,2156,2,2158,35,2013-03-28 17:29:22,2013-03-28 16:47:32
12da1d1f6ffcd546a892a33302bb34fd37169022...13b8f68c1f0b6d4ff5a7bed5a834e7e5e34a9fd0,11,332,14,346,20,2013-03-28 17:30:04,2013-03-28 16:47:33
13b8f68c1f0b6d4ff5a7bed5a834e7e5e34a9fd0...39410bf0bf81cb3f76fb9bfa8308cd672bc1442c,1,52,4,56,4,2013-03-28 17:30:28,2013-03-28 16:47:34
39410bf0bf81cb3f76fb9bfa8308cd672bc1442c...4596f190d384872305e502ebece2e38358ba463e,1,26,0,26,4,2013-04-05 17:39:08,2013-04-05 14:34:47
4596f190d384872305e502ebece2e38358ba463e...209618860c2627a4e134a15472587c574b328b40,5,366,7,373,9,2013-04-05 17:39:09,2013-04-05 14:34:48
209618860c2627a4e134a15472587c574b328b40...035ff3987bcbe93a823f47befbe019319c1484b0,2,49,9,58,7,2013-04-12 18:34:12,2013-04-12 16:05:09
035ff3987bcbe93a823f47befbe019319c1484b0...d51c5274e458e9c2545144b6821978ccda85c117,3,250,6,256,5,2013-04-12 18:34:37,2013-04-12 16:05:10
d51c5274e458e9c2545144b6821978ccda85c117...31c61918313c7057a48ac939d8699860e8bfff99,3,31,24,55,22,2013-04-12 18:37:03,2013-04-12 16:05:11
31c61918313c7057a48ac939d8699860e8bfff99...1ddac3ff9aa29d1103aa05f59772812289b4cefa,1,16,3,19,2,2013-04-12 18:37:09,2013-04-12 16:05:12
8a3500cd215534a849dd7be6816107504a1fc7f3...b7fbce05e530a5c7d6bcbadcb3a53aca815d5cc5,1,24,14,38,5,2012-05-10 18:04:31,2012-05-10 18:04:31
e1ebf212377837d676b0b28a821c022b0a3e57f3...aa3982890fe7506badfddf6252402a335a4d72b7,1,25,0,25,5,2013-02-11 04:47:28,2013-02-11 04:47:28
e90020cdb3273af3b0c7915c0aacf16b19bbf994...e7b44f182bc1b2ac32eadbc477a76a185f49ac88,1,43,0,43,3,2012-06-28 22:35:37,2012-06-28 22:35:37
d951615daa9de25687fc4af34a224f62f8d414e5...8bb45b25b2230c84724f6f62bfcc04a79999a90c,1,1,1,2,1,2010-02-24 23:34:00,2010-02-24 14:18:25
2ee8c5b647cf0800e4eb41d84f78f4c3be02df53...c0da5db1e692c2bc74e5cdba67baf8762ac304b4,1,2,3,5,2,2010-01-31 20:20:30,2010-01-31 20:20:30
c0da5db1e692c2bc74e5cdba67baf8762ac304b4...8d9e7d5293d6a8b50c9e0eb8e23ef5fed45c86d0,2,27,5,32,2,2010-02-01 20:08:12,2010-02-01 18:09:39
8d9e7d5293d6a8b50c9e0eb8e23ef5fed45c86d0...562d53fa69933b3ade2691b99cbe67722313f43c,1,1,1,2,1,2010-02-01 20:08:14,2010-01-22 02:33:00
562d53fa69933b3ade2691b99cbe67722313f43c...b8bba419250711a69e09e7648e5c991f4847a127,2,3,3,6,3,2010-02-02 06:04:03,2010-02-02 06:04:03
b8bba419250711a69e09e7648e5c991f4847a127...b659b49bb0ee8995ddc4730e1796866baccc39be,1,1,1,2,1,2010-02-02 17:54:34,2010-02-02 15:33:28
d4556c49eef293594a61fb8697b93b1d83904dc2...2eb41d7200d15f4b12ad6497a99786ec5357217d,1,45,1,46,7,2010-01-21 07:30:45,2010-01-21 07:30:45
2eb41d7200d15f4b12ad6497a99786ec5357217d...4c734803cbd4fac667ba518460c2c0d8725ae3f7,2,29,0,29,2,2010-01-21 07:49:27,2010-01-21 07:49:27
4c734803cbd4fac667ba518460c2c0d8725ae3f7...28414b6b3a0eaf0d0c010c71634a8a832b7972f2,2,0,0,0,0,2010-01-21 08:01:00,2010-01-21 07:57:03
28414b6b3a0eaf0d0c010c71634a8a832b7972f2...5a9f03952927da82ce70822f3d0c5b4b1d37be4f,2,53,24,77,21,2010-01-21 08:42:20,2010-01-21 08:23:48
5a9f03952927da82ce70822f3d0c5b4b1d37be4f...42cfcd20a7e264eb7fc3c42c892ff498cde0542b,1,1,1,2,1,2010-01-21 23:02:45,2010-01-21 20:34:25
42cfcd20a7e264eb7fc3c42c892ff498cde0542b...fb7d3f32b283a3847e6f151a06794abd14ffd81b,2,76,78,154,4,2010-01-22 01:05:13,2010-01-21 19:37:38
fb7d3f32b283a3847e6f151a06794abd14ffd81b...a5031214c4fe5f5d3fcf649d10769744cbc66fed,4,69,67,136,5,2010-01-22 04:03:45,2010-01-21 23:25:19
752c0c24926aacbceca0d27de6ad22cbb7dd0709...3fe271e91b4d1b9ed0b304e218df8fd419012107,1,6,5,11,1,2012-03-14 19:15:46,2012-03-14 17:00:55
752c0c24926aacbceca0d27de6ad22cbb7dd0709...86140d56c150aa17e6c98dde4ba669516f3c302a,1,260,0,260,1,2009-10-24 00:07:33,2009-10-23 11:25:33
a07b10c8f930e88386d3b7424f25190af554275e...d8e3ac7e7264863544c95069024f1cbaedb5db3d,1,4,1,5,2,2010-07-26 04:52:19,2010-07-23 16:31:27
24e7a5be373c95f977bab4f0f41f736bb1d25075...8ac3a66702c43386eb580b7a1a8b1a31cd675327,1,16,0,16,1,2010-07-19 06:31:04,2010-07-18 12:17:49
c9a9766328763a776201b4b11263652b66ff9465...fc051572a3fe171286f10761bd33946c48de3f7f,1,4,1,5,2,2010-07-14 16:42:24,2010-07-14 16:42:24
c30e742c4981585061ed52c14abd9ebd32a0e18b...0e418e568f4104ce1915263ae3ad66e290eebed8,1,1,0,1,1,2010-07-09 23:27:31,2010-07-09 07:05:16
0e418e568f4104ce1915263ae3ad66e290eebed8...142183d09634aa00a47107c7ffc5e39fa6cbf1b0,1,1,1,2,1,2010-07-09 23:28:21,2010-07-09 20:27:48
142183d09634aa00a47107c7ffc5e39fa6cbf1b0...5d1e34158a3023af48541bf1731d202849929a12,1,1,1,2,1,2010-07-10 00:36:28,2010-07-10 00:00:01
d6f8fd0b3eeb4349493209740742d67616e0263c...0afcb5f7915337c76c6743dab70c49facdeddd7e,1,3,3,6,2,2010-01-10 07:39:11,2010-01-08 22:45:08
d6f8fd0b3eeb4349493209740742d67616e0263c...57bddb115331a23816af772172531fb56fceace4,1,17,17,34,10,2010-01-09 20:08:24,2010-01-07 16:32:19
57bddb115331a23816af772172531fb56fceace4...e330d8ca1a9ec38ce40b0f67123b1dd893f0b31c,2,8,0,8,2,2010-01-09 20:08:26,2010-01-07 16:42:27
e330d8ca1a9ec38ce40b0f67123b1dd893f0b31c...ca768288b650a4929bc1d58783a929a9a792e30e,12,28,28,56,23,2010-01-10 12:01:25,2010-01-07 16:49:12
ca768288b650a4929bc1d58783a929a9a792e30e...0b444cdb19bcfcc7f59b7b00783cbfbbc5ddcf63,112,647,647,1294,595,2010-01-10 12:01:28,2010-01-09 23:33:00
d6f8fd0b3eeb4349493209740742d67616e0263c...472e746991db09fea7f11e4cb856c2cec9dc282b,1,39,0,39,1,2010-01-09 07:11:40,2010-01-09 07:07:17
472e746991db09fea7f11e4cb856c2cec9dc282b...53cc5356fb591d0efa9d2725f8430afe5f5630b5,1,90,63,153,5,2010-01-09 07:13:47,2010-01-09 03:14:07
53cc5356fb591d0efa9d2725f8430afe5f5630b5...16e2cfa90993b23bda8ff1ffb958cac20e58b058,1,29,21,50,3,2010-01-09 07:13:47,2010-01-09 04:56:16
16e2cfa90993b23bda8ff1ffb958cac20e58b058...48ffef966c762578eb818c0c54a7e11dd054f5db,2,38,2,40,3,2010-01-09 07:14:50,2010-01-09 07:05:41
d6f8fd0b3eeb4349493209740742d67616e0263c...18e95f279ec62cc8d5e5ab709b162ccc55eebf0a,1,1,3,4,2,2010-01-08 13:53:56,2010-01-08 13:53:56
18e95f279ec62cc8d5e5ab709b162ccc55eebf0a...91c38a21089c4b30d35f392386c752a017ac6db0,4,10,8,18,5,2010-01-10 17:42:54,2010-01-08 15:39:11
91c38a21089c4b30d35f392386c752a017ac6db0...99178c831e72ba80b9edd5455b03070758c55526,1,3,2,5,2,2010-01-10 17:43:22,2010-01-08 16:01:10
99178c831e72ba80b9edd5455b03070758c55526...5aeb3a3a838b2cb03d250f3376cf9c41f4d4608e,3,11,1,12,3,2010-01-17 21:54:28,2010-01-17 21:54:28
5aeb3a3a838b2cb03d250f3376cf9c41f4d4608e...8b770a2a24456089c0dd0230035a7d88aee7e26a,1,1,1,2,1,2010-01-19 23:25:38,2010-01-17 08:19:24
f9ad77a739c0d012ee58b64eda2d7ec0d4e1df9d...2bc35dcbf7ed702e92b925f8e50afe3632dd211b,1,3,1,4,2,2009-12-09 04:38:39,2009-12-08 20:54:10
2bc35dcbf7ed702e92b925f8e50afe3632dd211b...f58415096632946b723fa73216ec1d49b4c6bb55,1,1,1,2,2,2009-12-09 04:39:58,2009-12-08 20:54:11
f9ad77a739c0d012ee58b64eda2d7ec0d4e1df9d...77c29b4acae2f129f71e4856b8d0518982802d83,2,3,9,12,4,2009-12-08 23:26:39,2009-12-08 23:21:02
a24a32ddb30c904d244fe911f4d9e7e3924fdac7...bf3c523c3fd641609adcef67dcec47a43a6abd60,1,69,25,94,21,2009-12-09 20:40:42,2009-12-09 15:26:27
bf3c523c3fd641609adcef67dcec47a43a6abd60...28ed5b3524c1ee5245131691b783d897239f5b03,2,23,7,30,9,2009-12-09 20:40:42,2009-12-09 15:26:28
28ed5b3524c1ee5245131691b783d897239f5b03...25d5cc488a75cc232e97af42759812d9aa398713,2,72,16,88,7,2009-12-09 20:40:42,2009-12-09 15:26:29
25d5cc488a75cc232e97af42759812d9aa398713...aa5af9749f53f7e44bef36c5c40918295430fb03,2,62,31,93,27,2009-12-09 20:40:42,2009-12-09 15:26:30
aa5af9749f53f7e44bef36c5c40918295430fb03...61b075bd3e69cbdc9010a7f817b2017455dd36a7,3,66,6,72,24,2009-12-09 20:40:42,2009-12-09 15:26:31
61b075bd3e69cbdc9010a7f817b2017455dd36a7...fa8c097cc9b416283ae4c1c1507909ff207b7f60,2,142,7,149,17,2009-12-28 08:24:11,2009-12-09 15:26:32
fa8c097cc9b416283ae4c1c1507909ff207b7f60...b236752a8722c77b5a9b4ed488a992ee05252843,4,55,7,62,12,2009-12-28 08:24:15,2009-12-09 15:26:33
b236752a8722c77b5a9b4ed488a992ee05252843...28ca0c90080ec933d82b0f7d050ea5fde2816c57,3,29,10,39,7,2009-12-28 08:24:15,2009-12-09 15:26:34
28ca0c90080ec933d82b0f7d050ea5fde2816c57...27a557a9ff9273ad47aa29c52e9903cf6405f7f7,1,3,0,3,1,2010-01-10 06:38:49,2010-01-09 17:28:12
d07430f98cfd6fae3f5ee91c2fa314f1cacf6f33...4256f36c58238a1b2317372b37be889d75a93198,1,6,10,16,3,2010-01-19 23:27:40,2010-01-19 15:39:12
d07430f98cfd6fae3f5ee91c2fa314f1cacf6f33...640d9d08738db4380c2f856d60ac0a2ceb496c2f,1,32,32,64,27,2010-01-19 20:16:07,2010-01-19 19:03:08
640d9d08738db4380c2f856d60ac0a2ceb496c2f...a12477dbe1be24c3948dd7994874d1d1187c40c3,1,4,4,8,3,2010-01-19 20:21:34,2010-01-19 19:03:09
a12477dbe1be24c3948dd7994874d1d1187c40c3...91fe7324c5a5a11a7fff4993ce5ded81b6e3ee08,1,5,5,10,5,2010-01-19 20:22:19,2010-01-19 19:03:10
67bc7407211d26de518811dafc2c1cf2e6124709...0ab1faae39173be6126364461c1be86542e6b17d,1,4,5,9,5,2010-02-14 03:36:11,2010-02-13 21:28:09
0ab1faae39173be6126364461c1be86542e6b17d...a7e7eff66206829f7752c565198dbe6f40ef72a0,3,30,22,52,19,2010-02-14 03:36:11,2010-02-13 21:28:10
a7e7eff66206829f7752c565198dbe6f40ef72a0...3b78cdbe693092a58d9724deb14bd7be0dd4d7b3,1,48,0,48,1,2010-02-14 03:36:11,2010-02-13 21:28:11
3b78cdbe693092a58d9724deb14bd7be0dd4d7b3...709f79b0894859a6624e99b3a0c4714dd4ece494,2,38,12,50,5,2010-02-14 03:36:11,2010-02-13 21:28:12
709f79b0894859a6624e99b3a0c4714dd4ece494...2626b5367047d8b8d5c4555ec6b579ed37a6625d,2,15,0,15,2,2010-02-14 03:36:12,2010-02-13 21:28:13
2626b5367047d8b8d5c4555ec6b579ed37a6625d...1ec666b092d1df5691cd4d38f20aaeadd5049aa2,2,87,1,88,4,2010-02-14 03:36:12,2010-02-13 21:28:14
1ec666b092d1df5691cd4d38f20aaeadd5049aa2...9b391f218a5b732a5a8abae87d3165e97fe2f6f6,2,15,7,22,5,2010-02-14 03:36:12,2010-02-13 21:28:15
9b391f218a5b732a5a8abae87d3165e97fe2f6f6...73f77b909f87fcaece42ec50d8d0c1c35efbf947,2,180,0,180,3,2010-02-14 03:36:12,2010-02-13 21:28:16
73f77b909f87fcaece42ec50d8d0c1c35efbf947...61a7cca0c6504aee7bae7837582230561bdb81d4,2,180,3,183,6,2010-02-14 03:36:12,2010-02-13 21:28:17
61a7cca0c6504aee7bae7837582230561bdb81d4...cd30539214bb09881b84c796a50d30e409dee3fa,3,112,66,178,51,2010-02-14 03:36:12,2010-02-13 21:28:18
cd30539214bb09881b84c796a50d30e409dee3fa...73f464b5f3fe4dd5109b9fb9e58c1fe55393902d,2,112,60,172,22,2010-02-14 03:36:13,2010-02-13 21:28:19
73f464b5f3fe4dd5109b9fb9e58c1fe55393902d...cd067d3bf4ea3f89969cd143be3e281e1c5ac58a,7,350,40,390,33,2010-02-14 03:36:13,2010-02-13 21:28:20
cd067d3bf4ea3f89969cd143be3e281e1c5ac58a...b24bb99756c8b6fde01c23ebbb4abc37d12fb1eb,1,17,0,17,1,2010-02-14 03:36:13,2010-02-13 21:28:21
b24bb99756c8b6fde01c23ebbb4abc37d12fb1eb...048cdd4665efafde2902cb72376f2ca497254246,1,50,0,50,1,2010-02-14 03:36:13,2010-02-13 21:28:22
048cdd4665efafde2902cb72376f2ca497254246...851c2b3791f24e319c23331887d4b8150ca4d9ba,4,233,51,284,51,2010-02-14 03:36:13,2010-02-13 21:28:23
851c2b3791f24e319c23331887d4b8150ca4d9ba...a0b4dfa9b35a2ebac578ea5547b041bb78557238,2,42,4,46,4,2010-02-14 03:36:14,2010-02-13 21:28:24
a0b4dfa9b35a2ebac578ea5547b041bb78557238...92b3385fca620f47580d695b80b96432c76f0822,3,73,34,107,15,2010-02-14 03:36:14,2010-02-13 21:28:25
92b3385fca620f47580d695b80b96432c76f0822...b0032d1e06e4a53d908309fce6ad3c5f5a3559a3,1,46,1,47,2,2010-02-14 03:36:14,2010-02-13 21:28:26
b0032d1e06e4a53d908309fce6ad3c5f5a3559a3...00fbe63627b72c807e558643f0634e435137122f,2,51,0,51,3,2010-02-14 03:36:14,2010-02-13 21:28:27
00fbe63627b72c807e558643f0634e435137122f...d6576e1fe3ee4bd7bd2cf01d17499c94da24876f,3,115,11,126,10,2010-02-14 03:36:15,2010-02-13 21:28:28
d6576e1fe3ee4bd7bd2cf01d17499c94da24876f...7d541174650fb209a00b629d113cb954c24a19de,1,20,15,35,9,2010-02-14 03:36:15,2010-02-13 21:28:29
7d541174650fb209a00b629d113cb954c24a19de...e397421abf1003c4da824441f91d8c990b70fa98,3,76,6,82,12,2010-02-14 03:36:15,2010-02-13 21:28:30
e397421abf1003c4da824441f91d8c990b70fa98...ba20f15e0a220705695a1ee19fb28234861b890d,2,4,2,6,4,2010-02-14 03:36:15,2010-02-13 21:28:31
ba20f15e0a220705695a1ee19fb28234861b890d...7aa4754e552eff22d70d496dea73a9c7639d66d3,3,74,22,96,29,2010-02-14 03:36:15,2010-02-13 21:28:32
7aa4754e552eff22d70d496dea73a9c7639d66d3...2347fae50b2f75c6c0b362bd9ef24249419ed2b1,3,67,9,76,13,2010-02-14 03:36:16,2010-02-13 21:28:33
2347fae50b2f75c6c0b362bd9ef24249419ed2b1...aaec9bcf6d85a084725e8386bf314a6ef6842468,5,14,8,22,9,2010-02-14 03:36:16,2010-02-13 21:28:34
aaec9bcf6d85a084725e8386bf314a6ef6842468...348f199b2d9250a82453323c90b7e8d3d9462220,2,73,44,117,26,2010-02-14 03:36:16,2010-02-13 21:28:35
348f199b2d9250a82453323c90b7e8d3d9462220...0691cff7dca6b68569183be991d59ebb72b6170e,3,179,12,191,15,2010-02-14 03:36:16,2010-02-13 21:28:36
0691cff7dca6b68569183be991d59ebb72b6170e...5848769f9de68cfb0735710c6c4d2f08aa53f317,1,36,25,61,15,2010-02-14 03:36:17,2010-02-13 21:28:37
5848769f9de68cfb0735710c6c4d2f08aa53f317...e73bbd96c6e9ce11a101dac03402d0f718a1bd23,3,102,8,110,14,2010-02-14 03:36:17,2010-02-13 21:28:38
caa7dac163f7f7fc827da6fd4a5aba259a50e1ab...a29aa47da79cfd0ef7ee0ef423e7e5a9a3cf07bd,1,1,0,1,1,2009-10-28 06:05:24,2009-10-27 13:31:33
a29aa47da79cfd0ef7ee0ef423e7e5a9a3cf07bd...f1be316ada93158507c315ee7948bb9e6007eb91,1,6,1,7,1,2009-10-28 06:12:44,2009-10-27 14:58:14
b142da2a5dec8f868a61322e2ab591e9a008ec3b...f6fdbb6804eac72eb0ccff191162a5911bf2b014,1,14,3,17,4,2009-10-19 07:31:02,2009-10-19 06:49:55
b142da2a5dec8f868a61322e2ab591e9a008ec3b...3edd98ac6569252acd669c2b9cbe39d15eeb7e56,1,1,1,2,1,2009-10-19 02:45:38,2009-10-11 13:32:19
3edd98ac6569252acd669c2b9cbe39d15eeb7e56...989119d96e8d06c69b16d2021856309ec8e0a0c8,1,5,0,5,1,2009-10-19 05:44:22,2009-10-19 04:01:19
989119d96e8d06c69b16d2021856309ec8e0a0c8...fcb044ee5754ad2df2d217748a976ec82970eb29,1,1,1,2,1,2009-10-19 05:47:29,2009-10-19 02:54:12
fcb044ee5754ad2df2d217748a976ec82970eb29...8ef4c28b8d391ee053049d2dc9a3568b86c0dd38,1,1,1,2,1,2009-10-19 05:47:48,2009-10-19 03:57:01
24be49522f00767718e84468d46ccb22cc7734d7...610f99ec7d22b5750f12350f67c1341d6be8030f,1,37,0,37,4,2009-10-26 01:41:09,2009-10-26 01:41:09
b3118bdc91876cbc04b7e81dcf7bea71d86ce4f8...39eea7bdd943a103deadfd4c4fd204bbbf111219,1,3,5,8,3,2009-10-22 06:19:47,2009-10-22 06:06:14
249b2004d8c9c58ed1ea1665dfd376af0312ed7e...94ee8e2c98cf4adf0c69b3b8ce5039eea92347b7,1,1,1,2,1,2015-01-28 20:46:07,2015-01-28 17:58:50
249b2004d8c9c58ed1ea1665dfd376af0312ed7e...b8538603a34b13ccb1a3a096f461b8a35d7ea878,1,50,0,50,7,2009-11-05 01:58:15,2009-10-31 00:47:43
b8538603a34b13ccb1a3a096f461b8a35d7ea878...eeb3aeddb23746912b6c903a7d90dffdd686708f,1,0,2,2,2,2009-11-05 01:58:15,2009-10-31 00:47:44
eeb3aeddb23746912b6c903a7d90dffdd686708f...859d1fb427ca79d3c70a3806c892e4dd148701bf,1,3,4,7,3,2009-11-05 01:58:16,2009-10-31 00:47:45
859d1fb427ca79d3c70a3806c892e4dd148701bf...024bb1256627219671a0924b195582b6e049ca87,3,13,8,21,9,2009-11-05 01:58:16,2009-10-31 00:47:46
024bb1256627219671a0924b195582b6e049ca87...7da4e2280ccaf5ecb357f7cb2b81d62f78f00f9e,5,219,2,221,7,2009-11-05 01:58:16,2009-10-31 00:47:47
7da4e2280ccaf5ecb357f7cb2b81d62f78f00f9e...5abb013b3ddfb42e5baa3c7de052af596a0ee82f,2,36,6,42,13,2009-11-05 01:58:16,2009-11-05 01:16:37
5abb013b3ddfb42e5baa3c7de052af596a0ee82f...7f640b778f8cf87159890157a815f1d728573477,1,229,0,229,1,2009-11-05 01:58:16,2009-11-05 01:16:38
7f640b778f8cf87159890157a815f1d728573477...92815b3363c6cf317337437a986bdf2e8f1aa3a0,1,5,5,10,5,2009-11-09 17:30:01,2009-11-09 15:24:33
92815b3363c6cf317337437a986bdf2e8f1aa3a0...34b6cb8bb032bd16f3d1c93a8417beb75e51ed29,5,86,48,134,7,2009-11-10 00:37:33,2009-11-09 19:26:43
34b6cb8bb032bd16f3d1c93a8417beb75e51ed29...0a8fcbdca28f6c8dad3cac9aca48f866c84b0f11,1,4,4,8,6,2009-11-10 00:40:49,2009-11-09 18:10:36
0a8fcbdca28f6c8dad3cac9aca48f866c84b0f11...203666352f36702a8773ab47f67ef467528245ae,1,3,0,3,1,2009-11-10 00:41:13,2009-11-09 18:10:37
203666352f36702a8773ab47f67ef467528245ae...4a5328d644b67be7fae1ff360e142d5dee4e63e9,1,3,6,9,4,2009-11-13 22:40:05,2009-11-12 04:42:41
4a5328d644b67be7fae1ff360e142d5dee4e63e9...48aec1b1f14578ac7560c8be40890ebf52c91d78,1,4,3,7,3,2009-11-16 06:14:51,2009-11-14 21:10:57
48aec1b1f14578ac7560c8be40890ebf52c91d78...354870171bc98dfef7dfa037b3fe9ac9454c94a2,1,3,0,3,3,2009-11-16 06:15:01,2009-11-14 21:10:58
9861b644e045b5ee0e16dea65b44419205090960...7ee6376938919d36a9f8d45dd3ae20f0cb494574,1,0,1,1,1,2009-12-16 00:20:23,2009-12-15 08:42:06
9861b644e045b5ee0e16dea65b44419205090960...d79f5d17189e70f8a98675a73663113776dcf4fe,1,19,0,19,1,2009-12-15 06:04:30,2009-12-15 03:11:10
d79f5d17189e70f8a98675a73663113776dcf4fe...06500a029953164a3110c705ae579ef43548d006,1,5,2,7,3,2009-12-16 00:21:51,2009-12-15 07:57:18
06500a029953164a3110c705ae579ef43548d006...8b8e862490bba040299905cc0541560f24a11c41,4,26,3,29,7,2009-12-16 20:45:16,2009-12-12 12:25:24
8b8e862490bba040299905cc0541560f24a11c41...b3100fd5557dbaad4eeb5690336758ef21bb08bb,2,20,2,22,3,2009-12-16 20:45:25,2009-12-16 18:50:09
b3100fd5557dbaad4eeb5690336758ef21bb08bb...527b9d704d929a2fff2f9bf1c5e2856725c1416d,4,23,3,26,5,2009-12-16 20:45:25,2009-12-16 18:23:54
9861b644e045b5ee0e16dea65b44419205090960...81334502eed1c78f49fc74936b712b3cf32b682a,2,38,4,42,6,2009-12-14 07:17:46,2009-12-12 00:38:57
81334502eed1c78f49fc74936b712b3cf32b682a...85bf49f9a55fd9ded396460d245a55b651d7bdaa,2,19,1,20,2,2009-12-14 07:40:24,2009-12-12 00:38:58
85bf49f9a55fd9ded396460d245a55b651d7bdaa...f08aa017675bffe2359e0122cff2e447486b97c1,1,1,5,6,3,2009-12-14 07:40:24,2009-12-12 00:38:59
ff86bdd5cac70850eea4791bea78efa19b228ebe...8eb65d96718e442173604d1f76ec3a925b567ea7,1,18,21,39,7,2009-12-09 21:38:52,2009-12-09 21:38:52
adf9628ea41bd226dc5ab38daa0bc661097a2127...e5f591720caea0c6645fa9852903a1c43d7c3672,1,2,0,2,1,2009-12-04 17:11:58,2009-12-04 10:35:57
e5f591720caea0c6645fa9852903a1c43d7c3672...165ca62108464faa42367bcda6b278ac3a0d98cb,1,3,2,5,1,2009-12-04 23:16:40,2009-12-04 23:11:01
165ca62108464faa42367bcda6b278ac3a0d98cb...50d9bbba92c9dd5611a1bb592fc42463212413ad,3,23,11,34,7,2009-12-05 18:03:49,2009-12-04 17:53:21
50d9bbba92c9dd5611a1bb592fc42463212413ad...952dfc6944b29582482ff50a85c04879406c06ba,2,33,5,38,4,2009-12-05 18:28:20,2009-12-04 11:11:58
8ac7a77be668180d515e234d550cc661aa0c1ebd...c5b3e0f54950f983836970050406347ddf82b152,1,1,0,1,1,2009-11-10 22:06:41,2009-11-10 22:06:41
080cbc1275ac09445136ba429d90b5ec85e92c1c...aa8dc9679a6a7daea261abe969af331c741a9f2c,2,0,6,6,3,2009-11-20 07:05:17,2009-11-19 20:58:29
0a565de4a50032339d3786d366e70912a4dcf572...f9bbaa384efd4c5c56b9a13d08680f6fc09324ca,1,1,0,1,1,2009-11-09 01:04:50,2009-11-08 22:07:16
1b52ac5935c3773596fa41f6cf83578ab86b6b83...1a994dc3d258a1603752e0c472b072acc343a963,1,76,58,134,25,2009-11-07 06:44:34,2009-11-05 06:33:52
1a994dc3d258a1603752e0c472b072acc343a963...7c5858a643724a9a4a67f1290c03d57f483ed261,2,98,19,117,15,2009-11-07 06:44:34,2009-11-05 06:33:53
7c5858a643724a9a4a67f1290c03d57f483ed261...b9f3bde150a1be1e2adfb2834caaf415dd7b72ef,1,18,18,36,18,2009-11-07 06:53:53,2009-11-07 06:47:37
b9f3bde150a1be1e2adfb2834caaf415dd7b72ef...5c5dd6e5a42d8d65362a15fb8f54f11ae6e03e22,1,3,2,5,2,2009-11-07 07:01:33,2009-11-07 06:58:14
1b52ac5935c3773596fa41f6cf83578ab86b6b83...ef0555712c9821cc163508777f20b934bf146971,1,2,5,7,2,2009-11-06 07:11:42,2009-11-04 21:32:46
c8a58ac5a52b0850fbca87898d1c6aa44cf5626f...c51f6ceed6a9a436f16f8b4f17eab1a3d17cffed,3,129,4,133,9,2009-11-05 00:59:15,2009-11-04 03:20:11
e4f59a32de3f90ff5aabc09b9da6bd5818c5076b...1542d4cdad9287896fd80d84a4c2256197087308,2,17,18,35,3,2013-01-19 06:35:04,2013-01-19 06:35:04
e4f59a32de3f90ff5aabc09b9da6bd5818c5076b...50c5885e0532bbe0d3fdd1632767e7cc6ae30442,1,1,1,2,1,2013-01-18 20:16:38,2013-01-18 19:24:01
e4f59a32de3f90ff5aabc09b9da6bd5818c5076b...edb54081ad821f89619df47bce993b9acc1d2234,1,1,1,2,1,2013-01-15 19:33:39,2013-01-15 13:50:56
e4f59a32de3f90ff5aabc09b9da6bd5818c5076b...46738bd7e9209e9a636dfddb46e32fd606386d81,1,49,4,53,2,2013-01-15 17:46:29,2013-01-15 00:46:55
46738bd7e9209e9a636dfddb46e32fd606386d81...991a2de45af713ad6476c3d03aefb30ba5599bfe,1,7,7,14,3,2013-01-15 17:46:29,2013-01-15 00:46:56
991a2de45af713ad6476c3d03aefb30ba5599bfe...2c8037edeef9ae6f510335587c04081e58564758,1,17,8,25,7,2013-01-15 17:46:29,2013-01-15 00:46:57
2c8037edeef9ae6f510335587c04081e58564758...3b650fc9869a51190578aed8014d906f01f510a9,1,6,8,14,2,2013-01-15 17:46:29,2013-01-15 00:46:58
3b650fc9869a51190578aed8014d906f01f510a9...55d124376f1d5d91be4376016d92a6ca6474428a,2,31,4,35,3,2013-01-15 17:46:29,2013-01-15 00:46:59
55d124376f1d5d91be4376016d92a6ca6474428a...695d69989429e9268c0587e3606399fc9d6cd6fa,1,6,3,9,1,2013-01-15 17:46:29,2013-01-15 00:47:00
695d69989429e9268c0587e3606399fc9d6cd6fa...c595956db99a728ab2247b564c8283cf5c0d84e6,3,11,14,25,3,2013-01-15 17:46:29,2013-01-15 00:47:01
c595956db99a728ab2247b564c8283cf5c0d84e6...182edef5b473bc13c57a158e3282c0aab4da01d6,1,3,1,4,2,2013-01-15 17:46:30,2013-01-15 00:47:02
182edef5b473bc13c57a158e3282c0aab4da01d6...40d69ac3a4fd72b879bab9975b26e1b445b5f0cc,3,37,3,40,4,2013-01-15 17:46:30,2013-01-15 00:47:03
40d69ac3a4fd72b879bab9975b26e1b445b5f0cc...47497844442615b6e5cd5f9b9e1552e8ba84ce71,1,9,3,12,4,2013-01-15 17:46:30,2013-01-15 00:47:04
47497844442615b6e5cd5f9b9e1552e8ba84ce71...5a8e84cde3711076d3ad7260daa0a24ee40c8e07,2,31,7,38,6,2013-01-15 17:46:30,2013-01-15 00:47:05
5a8e84cde3711076d3ad7260daa0a24ee40c8e07...8c9e8b6e756cce90797e19dc64e3b51426546cf3,3,20,7,27,5,2013-01-15 17:46:30,2013-01-15 00:47:06
8c9e8b6e756cce90797e19dc64e3b51426546cf3...af8c0092503f677afc9ea4070ebd9204133b83ab,1,5,2,7,3,2013-01-15 17:46:30,2013-01-15 00:47:07
af8c0092503f677afc9ea4070ebd9204133b83ab...44e8d26cf3fbc0795fb1c44f54f458847313d35e,3,35,1,36,5,2013-01-15 17:46:30,2013-01-15 00:47:08
e4d15959d45468bfb13c80195e3a6b40f5b0a489...173f9a7145ab71d8ea916840836246afc6db66ef,1,18,0,18,1,2013-04-24 23:22:07,2013-04-24 23:22:07
ce735bf7fd66c6404e86e5a313f35abc0394b838...004825d314db4ba3f34ef499e3522ef72792d896,2,14,1,15,4,2013-02-17 23:35:33,2013-02-17 23:35:33
9ecd9f5dc300235593e4d3e4ecff4448f2500bad...3587b513bafd7a83d8c816ac1deed72b5e3a27e9,1,33,3,36,6,2013-01-25 20:52:55,2013-01-25 20:52:55
963838402a94e7fcbd1a73019f80aff708972af8...986bbc0842334f0e07731fa37f2a55d2930a5b8c,1,3,4,7,3,2011-11-04 16:47:18,2011-11-04 07:03:08
963838402a94e7fcbd1a73019f80aff708972af8...08cfdbb88cd6225b4fc4b8a3cecd0e01758c835d,1,37,1,38,6,2011-10-18 05:08:25,2011-10-18 05:07:57
501770e1bb5d132ae4f79aa96715f07f6b84e1f6...1e42258acd3787f7a817f4265da03c709d2e2aa1,1,3,3,6,1,2011-10-21 17:01:50,2011-10-21 13:49:35
1e42258acd3787f7a817f4265da03c709d2e2aa1...9e76d4a8345b247395b902307407ba4eac737524,1,1,1,2,1,2011-10-21 17:02:02,2011-10-21 13:49:36
beace29a0437068a36bc5963d905fac482724196...cee426811c981c62c4b236ebdcb47d1c2945cf56,1,6,0,6,1,2011-08-19 05:10:23,2011-08-19 05:10:23
957450054cfbbe0d4ae8d33f7b74eace6e290f16...3145b1a282fde9a4485662fbc77e0075f6fe7517,1,14,35,49,11,2011-08-30 23:19:57,2011-08-30 23:09:47
3d5ae435275e60be3ebd7302c1d2cf8ed6f0b8ad...9963e025e88f134cf07ef348d80a5821c69a7eb0,2,16,1,17,2,2011-05-20 16:30:09,2011-05-20 11:16:34
a02cf90144293f4d7885be7f1d10240576aa161b...715876e58d2aeddf7e3b26e2fb5da0fc6e35e86f,1,4,2,6,3,2011-06-15 17:02:09,2011-06-15 11:34:18
b2c2e4c22c6a4fe151f02380d247cf3d9a9d5d1e...10eb00073f07e1c40a17327417aa39cc4cc9c254,1,4,4,8,2,2010-01-30 06:26:39,2010-01-29 14:17:59
b2c2e4c22c6a4fe151f02380d247cf3d9a9d5d1e...13be3e31f1775bd496fc5bc1ab5b745052f4d07d,5,46,12,58,9,2010-01-30 06:11:00,2010-01-30 06:03:24
b2c2e4c22c6a4fe151f02380d247cf3d9a9d5d1e...03ca839537c9df35cc58085daa2b75febd373edd,1,1,1,2,1,2010-01-28 21:49:53,2010-01-28 09:08:46
03ca839537c9df35cc58085daa2b75febd373edd...1f7d57ff76dc21e9d4ff07b8dd26a1c926c4f29b,1,39,0,39,1,2010-01-28 21:58:24,2010-01-28 09:08:47
b2c2e4c22c6a4fe151f02380d247cf3d9a9d5d1e...4cfb2a44bb79fd06763f740754902c31d5ea9ccc,1,1,2,3,1,2010-01-25 17:37:18,2010-01-25 12:32:44
4cfb2a44bb79fd06763f740754902c31d5ea9ccc...6fce51571cb9aadb0a5e048c89044124271251f4,1,1,0,1,1,2010-01-25 17:42:31,2010-01-25 15:56:21
6fce51571cb9aadb0a5e048c89044124271251f4...0aa958d4b40159d5e72a521dda1dbe8f6e769e89,1,2,4,6,1,2010-01-25 17:43:45,2010-01-25 07:06:31
0aa958d4b40159d5e72a521dda1dbe8f6e769e89...9567f082ddc1f3143a153d0ecf59f3727ff0f7a5,1,4,8,12,2,2010-01-25 17:53:02,2010-01-25 07:42:23
9567f082ddc1f3143a153d0ecf59f3727ff0f7a5...2d7f98bac7e1d8b42c558e179ea24f5b06512622,1,0,2,2,1,2010-01-25 17:53:12,2010-01-25 07:05:43
0d1c285af265459006c012aa4415175c2db961ad...9874fca7122563e28d699a911404fc49d2a24f1c,3,12,1,13,3,2015-02-05 21:23:56,2015-02-05 21:23:56
19ece726e194f86b8d316d35b65daa92c245453b...bafc478f1618534fcb85bedc0fa224bd2d462441,4,50,3,53,5,2012-09-15 03:57:23,2012-09-15 03:57:23
0ce986446163b37c7f663ce7a408e7f94c31ba63...e448fed8e6ba9cd9237b7c8045c11cc40afc8595,3,47,8,55,10,2012-09-12 18:43:24,2012-09-12 14:04:42
e448fed8e6ba9cd9237b7c8045c11cc40afc8595...ff919f965d20d003e3882c70de667f41a86349ac,7,213,1,214,8,2012-09-12 18:43:24,2012-09-12 14:04:43
ff919f965d20d003e3882c70de667f41a86349ac...eb5f0c7a616531a024a582b72ca6d8775ff98d46,5,96,0,96,8,2012-09-12 18:43:25,2012-09-12 14:04:44
eb5f0c7a616531a024a582b72ca6d8775ff98d46...31d5451eed2677531c80177ff9dc8f5285f5a187,5,60,0,60,6,2012-09-12 18:43:25,2012-09-12 14:04:45
31d5451eed2677531c80177ff9dc8f5285f5a187...f103f95b11d087f07c0c48bf784cd9197e18f203,5,86,0,86,6,2012-09-12 18:43:25,2012-09-12 14:04:46
f103f95b11d087f07c0c48bf784cd9197e18f203...51f3145c2834c8f1d94c5b7cf3790baf74b9f521,1,1,2,3,2,2012-09-12 18:43:25,2012-09-12 14:04:47
d7afe648dcb188557173c239a337e123ec22cd1b...48c42ff66244f754cc02d9bcca0962c791c7d57e,1,33,0,33,4,2012-07-13 22:48:50,2012-07-13 22:48:50
8b0e15fa95e11965f18c8d2585dc8ffd9bfc9356...79c7ca54e1ae3f8c42baa6f792fd84d6cdab1af3,1,20,20,40,17,2011-10-17 04:08:23,2011-10-17 02:38:05
79c7ca54e1ae3f8c42baa6f792fd84d6cdab1af3...3870a0d1d88e2e42b70c2586d3a1fda63226953c,1,4,8,12,4,2011-10-17 04:09:50,2011-10-17 02:38:06
3870a0d1d88e2e42b70c2586d3a1fda63226953c...8be8bde75f90661ecd118ac890290889e184063d,2,9,1,10,2,2011-10-17 04:10:49,2011-10-17 02:38:07
8be8bde75f90661ecd118ac890290889e184063d...1b7edaf94bf03eed4092d6f8bc8815fa42292685,1,6,6,12,2,2011-10-17 04:11:03,2011-10-17 02:38:08
1b7edaf94bf03eed4092d6f8bc8815fa42292685...760c4512e54e524e3a19905c10a65209fda20c12,1,15,4,19,3,2011-10-17 04:11:33,2011-10-17 02:38:09
760c4512e54e524e3a19905c10a65209fda20c12...8bf90dc9bdf3fb1d2b1b2eb46293a719a3638acb,1,1,1,2,1,2011-10-17 04:12:04,2011-10-17 02:38:10
8bf90dc9bdf3fb1d2b1b2eb46293a719a3638acb...c5f29abd8098275382ff56d8cbb00d660a64b43e,1,3,7,10,2,2011-10-17 04:12:22,2011-10-17 02:38:11
8b0e15fa95e11965f18c8d2585dc8ffd9bfc9356...a6045720bdb5faa6bcf7ecf4fa732632202d52ac,1,23,23,46,6,2011-10-12 19:30:30,2011-10-12 09:35:04
703f05ad5835cff92b12c29aecf8d724c8c847e2...759a904e090b56a3941c1133a0f3302b7fec5054,1,1,1,2,1,2012-02-10 22:53:18,2012-02-10 21:57:55
703f05ad5835cff92b12c29aecf8d724c8c847e2...116eb3abfe4f79907f701317c2d905868941fff7,1,29,0,29,2,2012-02-04 07:11:32,2012-02-02 21:41:42
116eb3abfe4f79907f701317c2d905868941fff7...2c733fb24c10a9d7aacc51f956bf9b7881980870,4,32,2,34,5,2012-02-04 07:11:32,2012-02-02 21:41:43
703f05ad5835cff92b12c29aecf8d724c8c847e2...781f76b15824bb929b6f3f007d8e43894e4980cd,1,2,1,3,2,2011-12-15 18:15:07,2011-12-15 06:55:29
703f05ad5835cff92b12c29aecf8d724c8c847e2...284e3d280ea84957f5bedcb302848dbdcdbb9a62,1,37,13,50,10,2011-11-28 19:30:34,2011-11-28 10:48:12
703f05ad5835cff92b12c29aecf8d724c8c847e2...473f4c96e315478185c4a07d6e7fb65801ee40b9,1,0,3,3,1,2011-11-06 18:36:59,2011-11-06 12:06:22
473f4c96e315478185c4a07d6e7fb65801ee40b9...83838d5c1b8ca2efee52184136776c3cf7d5df2f,2,2,2,4,2,2011-11-06 18:43:18,2011-11-06 12:06:23
703f05ad5835cff92b12c29aecf8d724c8c847e2...335339758c48ed17c8eb34437269e821824f577b,1,7,3,10,4,2011-10-18 17:03:00,2011-10-18 07:26:18
703f05ad5835cff92b12c29aecf8d724c8c847e2...be12681896fab9455eb65ea124df423b462e0072,1,1,1,2,1,2011-10-18 07:16:31,2011-10-18 05:21:21
be12681896fab9455eb65ea124df423b462e0072...92bef1a14a6755ce1407a0e180cdc9e14a5c56b9,1,6,6,12,5,2011-10-18 07:16:32,2011-10-18 05:21:22
92bef1a14a6755ce1407a0e180cdc9e14a5c56b9...f380872f0abc7fe98022696996d346df99c53f1a,1,37,7,44,2,2011-10-18 07:16:32,2011-10-18 05:21:24
f380872f0abc7fe98022696996d346df99c53f1a...38d4debb6d180ca53fcb12b8115e81fd4c5262d0,1,12,6,18,6,2011-10-21 00:17:49,2011-10-18 05:21:23
703f05ad5835cff92b12c29aecf8d724c8c847e2...6d3902b0d05a5aaa31d09db889c03b90749e11b3,3,877,133,1010,4,2011-10-16 18:09:34,2011-10-16 11:07:31
6d3902b0d05a5aaa31d09db889c03b90749e11b3...07ea4df2780663aa851b7f7177d09ab63d1441bb,5,743,346,1089,13,2011-10-16 18:09:34,2011-10-16 11:07:32
07ea4df2780663aa851b7f7177d09ab63d1441bb...86ce2d54825d169bbfbc30292de24889e5599113,2,5,0,5,2,2011-10-16 18:09:35,2011-10-16 11:07:33
86ce2d54825d169bbfbc30292de24889e5599113...cd82323fbc3f431aace056c8a0202c0105ff51e0,1,17,0,17,1,2011-10-16 18:09:35,2011-10-16 11:07:34
cd82323fbc3f431aace056c8a0202c0105ff51e0...55752fa8610ebc16a1ebda2bcaf73f82142dde30,1,7,0,7,3,2011-10-16 18:09:35,2011-10-16 11:07:35
703f05ad5835cff92b12c29aecf8d724c8c847e2...d5570f4d2cb29f3db9f69ff5fcde0a7d54ad2696,2,31,4,35,8,2011-10-16 04:15:06,2011-10-14 21:19:21
703f05ad5835cff92b12c29aecf8d724c8c847e2...4c08018204f95c492c0ad7b033b8f57ccc2e43f5,3,6,1,7,3,2011-10-14 18:42:37,2011-10-14 18:03:48
4c08018204f95c492c0ad7b033b8f57ccc2e43f5...58a6a9cc4397477a7d8b620165e651028cc0e3c9,2,2,2,4,2,2011-10-14 18:43:09,2011-10-14 18:04:16
703f05ad5835cff92b12c29aecf8d724c8c847e2...ac2604cf5fb9fcf538289a470ecbe345f7f0c220,1,5,0,5,1,2011-10-14 18:41:28,2011-10-14 17:44:45
703f05ad5835cff92b12c29aecf8d724c8c847e2...66f4b98ad9a8218ad97b7b2f1604b205072dda62,3,99,39,138,16,2011-10-12 20:17:18,2011-10-08 18:39:52
703f05ad5835cff92b12c29aecf8d724c8c847e2...5a953fc5d1df1fabb5b8ce9f3c884c424ef4f89a,1,93,83,176,33,2011-10-12 18:53:31,2011-10-12 18:29:20
5a953fc5d1df1fabb5b8ce9f3c884c424ef4f89a...88d42af893ba2a5cff01506e623f3543ef78f9ed,1,27,0,27,1,2011-10-12 18:56:31,2011-10-12 18:30:02
703f05ad5835cff92b12c29aecf8d724c8c847e2...f99f4b3667a83f870565bb140711f0e585999108,1,27,16,43,5,2011-10-10 18:59:30,2011-10-09 11:34:49
f99f4b3667a83f870565bb140711f0e585999108...14937c2c06e63f93f65e1bc6693b95d4e54053d7,6,154,6,160,13,2011-10-10 19:05:07,2011-10-09 11:36:57
703f05ad5835cff92b12c29aecf8d724c8c847e2...ba959de165c6fc0d08d851894a98778e739aafc9,2,48,4,52,5,2011-10-10 17:21:11,2011-10-08 13:10:15
ba959de165c6fc0d08d851894a98778e739aafc9...15a31e78852f4ede5335552875006daeedfc3aa7,1,2,2,4,2,2011-10-14 18:11:30,2011-10-14 18:07:26
703f05ad5835cff92b12c29aecf8d724c8c847e2...2a6b149c64f6ba8cc3eef70c6901ee0c67a137a7,1,18,12,30,6,2011-10-07 23:12:25,2011-10-06 17:52:48
703f05ad5835cff92b12c29aecf8d724c8c847e2...5caf19733713b3f04105d1949467014345e6a240,1,1,1,2,1,2011-10-07 23:02:19,2011-10-07 22:51:06
5caf19733713b3f04105d1949467014345e6a240...43a8a04a11d9c3870a4b20fb2d82f89631390e0a,1,50,0,50,1,2011-10-07 23:03:30,2011-10-07 22:51:07
43a8a04a11d9c3870a4b20fb2d82f89631390e0a...c500352e0de75db34b1a071a9e250b815d10f95b,1,33,36,69,9,2011-10-16 04:55:05,2011-10-15 05:04:24
c500352e0de75db34b1a071a9e250b815d10f95b...ed43de6ec35dfd4c4bd33ae9b5f2ebe38282209f,5,36,20,56,14,2011-10-16 04:56:13,2011-10-15 05:04:25
ed43de6ec35dfd4c4bd33ae9b5f2ebe38282209f...e8c1e6c796c1b96b6b208bbd4bc8cfd9acb481b5,2,23,4,27,5,2011-10-16 05:00:37,2011-10-15 05:04:26
703f05ad5835cff92b12c29aecf8d724c8c847e2...05ac978495e84fe03d91ab591524b7ea138900ed,1,2,2,4,2,2011-10-07 22:46:12,2011-10-06 16:03:35
05ac978495e84fe03d91ab591524b7ea138900ed...2b5f07f16c9e554482ed4a2355a051feabd62848,1,6,7,13,6,2011-10-07 22:46:13,2011-10-06 16:14:55
2b5f07f16c9e554482ed4a2355a051feabd62848...8e854b00d86070dd463a91bdbc401fb25dc9ddb5,1,7,6,13,5,2011-10-07 22:46:13,2011-10-06 16:23:11
8e854b00d86070dd463a91bdbc401fb25dc9ddb5...15dafaf80dda8e90114ae178569b9600ebd07109,1,21,36,57,4,2011-10-07 22:46:13,2011-10-06 16:26:24
15dafaf80dda8e90114ae178569b9600ebd07109...5d176fb6b6a22f19f7a15fc344dfb08af1e29ed7,1,14,14,28,10,2011-10-07 22:46:13,2011-10-06 16:50:06
5d176fb6b6a22f19f7a15fc344dfb08af1e29ed7...db99cb700098942d3fced9e5d8ec873aabe6e1ef,1,4,3,7,3,2011-10-07 22:46:14,2011-10-06 16:50:18
db99cb700098942d3fced9e5d8ec873aabe6e1ef...8a94151d61eda539a3588f2ad009e0117867525f,1,43,67,110,10,2011-10-07 22:46:14,2011-10-06 16:50:28
703f05ad5835cff92b12c29aecf8d724c8c847e2...87182b17ed471a7b9cbbc24e1c02f90c8725dc6f,6,6,7,13,7,2011-10-05 17:47:10,2011-10-03 18:21:36
703f05ad5835cff92b12c29aecf8d724c8c847e2...1c64b48e67c2c83508c45817002468a9a633c991,3,15,19,34,11,2011-10-04 20:30:38,2011-10-04 20:02:00
1c64b48e67c2c83508c45817002468a9a633c991...03106768afa0be60346bb335f9fd11063622c91d,1,7,1,8,2,2011-10-04 20:30:38,2011-10-04 20:05:17
03106768afa0be60346bb335f9fd11063622c91d...7ab8777e8dd365e9a5dc06eb3042903e296ef1b0,1,23,1,24,2,2011-10-04 20:30:38,2011-10-04 20:08:20
7ab8777e8dd365e9a5dc06eb3042903e296ef1b0...0c80fdb34200648f18cf19af1514c693d2f141b8,1,14,0,14,1,2011-10-04 20:38:12,2011-10-04 20:09:23
0c80fdb34200648f18cf19af1514c693d2f141b8...3ac64370164fb80e92c3c9136210d3a49f1e01fa,1,2,2,4,1,2011-10-11 20:46:20,2011-10-11 19:25:32
703f05ad5835cff92b12c29aecf8d724c8c847e2...0b20dd8f3d48ed4ad90d2ce0dce768c0e013600b,1,1,0,1,1,2011-10-03 21:53:00,2011-10-03 06:41:20
b04ba2bb42957f63567f530e092385f085b25e63...dc347195ccfbc87b6e445f5c31a5500e1df6c9b5,4,18,7,25,13,2011-11-08 06:12:19,2011-11-05 12:00:08
dc347195ccfbc87b6e445f5c31a5500e1df6c9b5...bf0a59b3872211eaa6d4cebb23ae110522458625,2,12,3,15,6,2011-11-08 06:12:19,2011-11-08 05:34:08
bf0a59b3872211eaa6d4cebb23ae110522458625...0b26abc0f59ce7899257f75d63ce836e1a6566bd,1,37,14,51,19,2011-11-08 06:12:19,2011-11-08 05:37:00
b04ba2bb42957f63567f530e092385f085b25e63...f858c646b5428519c4f847c5f15a9ead72a62b16,2,11,2,13,3,2011-09-28 00:00:06,2011-09-27 23:59:01
f858c646b5428519c4f847c5f15a9ead72a62b16...6acec0380bfcd5e3f91c9100bf4d415db8f7acfd,5,18,1,19,6,2011-09-28 19:46:21,2011-09-28 17:44:30
6acec0380bfcd5e3f91c9100bf4d415db8f7acfd...7cfc60576aeb25e2d234d47e9fd689a6c65ffd76,1,1,3,4,2,2011-09-28 19:46:32,2011-09-28 17:47:50
7cfc60576aeb25e2d234d47e9fd689a6c65ffd76...af1032edf951b4f0f0b3811af4e34e26198a9ef8,1,2,7,9,2,2011-09-28 19:46:34,2011-09-28 17:47:54
66abce05dd5b9da9c889034781dc3de38b6e231b...42ac496edc3dcd1f0b272da62401f62c47f93312,1,1,1,2,1,2009-11-30 02:00:14,2009-11-28 18:38:54
42ac496edc3dcd1f0b272da62401f62c47f93312...5d59a4016bdc068cd49e2a1c43caf4fa59896391,4,16,16,32,15,2009-11-30 07:09:47,2009-11-28 18:38:55
5d59a4016bdc068cd49e2a1c43caf4fa59896391...e160da7f60e67ee548472d907ede3291bbc2a79e,1,13,0,13,1,2009-11-30 07:09:56,2009-11-30 06:19:28
66abce05dd5b9da9c889034781dc3de38b6e231b...528fb08732aa742edf56bc61cc8943c7f6d02977,2,66,2,68,5,2009-11-29 08:51:35,2009-11-29 03:24:48
637afcf4e07616d1dd15d33f56c6b72f90f39821...c0eb604330e1288300d915f25868d1eed88d3038,1,2,2,4,1,2010-01-12 04:34:16,2010-01-11 21:09:44
e70d1632bdaf25a9ee528e78133cab319083eade...52ffe995b9a3fc43de8eca80bedab2e055aac562,7,31,22,53,8,2012-09-14 04:30:21,2012-09-13 22:27:09
b347d06bf097aca5effd07871adf4d0c8a7c55bd...04308e9dc456472fb38cc43df6b350a64e54883a,1,2,1,3,1,2012-09-11 17:02:12,2012-09-01 15:13:10
04308e9dc456472fb38cc43df6b350a64e54883a...ca45d0fa8400325df801cc911f3957d1ae246686,1,3,0,3,1,2012-09-11 17:16:30,2012-09-11 11:58:30
55b38a48e2a7ccfaaa7897a5fccb98327fa0e3c0...8e950dab86eafa8f4ea671fab593ca6210bc2e15,1,1,1,2,1,2012-09-14 05:15:10,2012-09-13 19:40:39
5f4d133fca7eb3cb750f056a6fd0281ba06cd12f...829a1c616967176ccd859c18a6e8ca0dda77f75a,1,1,1,2,2,2012-01-09 23:15:28,2012-01-09 22:55:42
5f4d133fca7eb3cb750f056a6fd0281ba06cd12f...18ab83e8568878edc3f6680ebdf439ccaa5bf5db,2,11,1,12,4,2012-01-09 21:30:59,2012-01-07 10:47:38
8cbfc1189cfc23f96f797a64bcb0c050b6ecc6e6...52a4880bcda7780eeda5a884f73ffa83726dc982,2,52,4,56,5,2012-01-20 22:47:23,2012-01-19 09:52:25
52a4880bcda7780eeda5a884f73ffa83726dc982...a37a8de8d61f5af3a2d347c6d6668f4316f48383,1,5,3,8,1,2012-01-20 22:47:35,2012-01-19 09:52:26
a37a8de8d61f5af3a2d347c6d6668f4316f48383...affb474f6a683f3a314bb24d39ef3b43d83e5cfe,1,35,28,63,7,2012-01-20 22:47:40,2012-01-19 09:52:27
affb474f6a683f3a314bb24d39ef3b43d83e5cfe...4139ecc2f0d18eef54666c660285136488b90c03,1,72,0,72,1,2012-01-20 22:47:43,2012-01-19 09:52:28
4139ecc2f0d18eef54666c660285136488b90c03...a080558ed77952b2394499531edc324eb2885d67,1,41,0,41,1,2012-01-20 22:47:46,2012-01-19 09:52:29
04f6785a089e552585ba022f9d9054eca385ca67...abe199808c6586047fb7255b80e3d17ffc26bf6c,2,29,1,30,4,2012-02-07 00:32:15,2012-01-30 20:10:08
04f6785a089e552585ba022f9d9054eca385ca67...f026358ef20e0c252388a41fcc8eff125b00927c,1,10,8,18,7,2012-02-06 22:00:06,2012-02-06 01:31:51
04f6785a089e552585ba022f9d9054eca385ca67...28b22f8af9053109d1f09fef749b6b96ee41050a,1,0,23,23,2,2012-02-06 07:44:56,2012-02-06 06:29:37
28b22f8af9053109d1f09fef749b6b96ee41050a...f174a2583c9f42315b60205890fa67a79a1f1669,2,3,2,5,3,2012-02-06 07:50:52,2012-02-06 07:46:44
04f6785a089e552585ba022f9d9054eca385ca67...5238cbf65638d7a097bdb5ca8226f5acbe31f143,2,33,4,37,5,2012-01-20 18:14:32,2012-01-20 03:12:09
04f6785a089e552585ba022f9d9054eca385ca67...36ed1913e1d5de0930e59db6eeec3ccb2bd58bd9,2,10,1,11,3,2012-01-20 00:18:27,2012-01-19 19:58:45
04f6785a089e552585ba022f9d9054eca385ca67...6ab260809b61b622e833771fbe08874f14a7e544,1,3,3,6,3,2012-01-13 17:50:17,2012-01-13 16:39:15
6ab260809b61b622e833771fbe08874f14a7e544...87b340b9677c898136b84015d8119972bb7d260b,1,1,1,2,1,2012-01-13 17:50:45,2012-01-13 16:39:16
4570aeb0d85f3b5ff274b6d5a651c2ee06d25d76...3e6e0edde20f536b28cf1dac04c7376000bfc701,3,129,6,135,14,2012-01-08 21:48:27,2012-01-07 14:45:59
4570aeb0d85f3b5ff274b6d5a651c2ee06d25d76...c700b684cf879f80d5e9e918210475b02339fc29,1,290,0,290,1,2012-01-03 22:10:02,2012-01-02 23:05:49
c700b684cf879f80d5e9e918210475b02339fc29...b10048d0e9c4a209997c3b7f44021af15f88d768,2,6,3,9,4,2012-01-03 22:10:02,2012-01-02 23:05:50
b10048d0e9c4a209997c3b7f44021af15f88d768...df5ed9077f18985a73f00fe2bacc2961598f73dc,2,10,3,13,3,2012-01-03 22:10:02,2012-01-02 23:05:51
df5ed9077f18985a73f00fe2bacc2961598f73dc...e3e68643b5c2adec097ba26230e0fcb641febacb,2,21,10,31,6,2012-01-03 22:10:03,2012-01-02 23:05:52
e3e68643b5c2adec097ba26230e0fcb641febacb...ecb7cf98a7d02e943ce44b083639c75011f3d8ec,2,258,101,359,21,2012-01-03 22:10:03,2012-01-02 23:05:53
ecb7cf98a7d02e943ce44b083639c75011f3d8ec...896a681698489e7e21891076ce932a97468ca4c6,1,27,13,40,4,2012-01-03 22:10:03,2012-01-02 23:05:54
d16520499d2652b5b59dfb25f9cf2d56a4c6913a...9e602b24fb33621a01a07eb77c117647d43e224b,5,0,0,0,0,2011-12-27 18:19:06,2011-12-25 02:07:30
9e602b24fb33621a01a07eb77c117647d43e224b...6679c34c47be19ba8e9ea72129dfe768a49c5ab4,2,455,302,757,2,2011-12-27 18:19:30,2011-12-25 02:07:31
6679c34c47be19ba8e9ea72129dfe768a49c5ab4...ef86890ce5f01e6b5716ddcc11daddcd4e297157,2,36,1,37,2,2011-12-27 18:19:30,2011-12-25 02:07:32
ef86890ce5f01e6b5716ddcc11daddcd4e297157...da191d15bfd690e679a9626cba527465e0aafabb,2,69,2,71,2,2011-12-27 18:19:30,2011-12-25 02:07:33
da191d15bfd690e679a9626cba527465e0aafabb...1471c6b1558f45fa11ad606fc9ea72261d965284,2,20,1,21,2,2011-12-27 18:19:30,2011-12-25 02:07:34
1471c6b1558f45fa11ad606fc9ea72261d965284...58c8bc7c1aa0c7cf71c524cc4531a19ef72ea706,2,38,1,39,3,2011-12-27 18:19:30,2011-12-25 02:07:35
58c8bc7c1aa0c7cf71c524cc4531a19ef72ea706...5a92a6ce90d6dbabf8075164e089e1cffbd351f7,2,25,1,26,2,2011-12-27 18:19:30,2011-12-25 02:07:36
5a92a6ce90d6dbabf8075164e089e1cffbd351f7...7fbe1ce9e2050f1d3f64868abcbc0d0794af3d13,1,10,0,10,1,2011-12-27 18:19:30,2011-12-25 02:07:37
7fbe1ce9e2050f1d3f64868abcbc0d0794af3d13...ae3f41f20a0b5a9fa3e83a12557c887855b920f3,1,24,0,24,1,2011-12-27 18:19:31,2011-12-25 02:07:38
ae3f41f20a0b5a9fa3e83a12557c887855b920f3...09fca77b9ecd64e2008835208bab29e15a4b2809,3,55,2,57,4,2011-12-27 18:19:31,2011-12-25 02:07:39
09fca77b9ecd64e2008835208bab29e15a4b2809...28755dbaa5213032b2da202652c214a9f94ff853,3,67,2,69,5,2011-12-27 18:19:31,2011-12-25 02:07:40
f7d958dff5e194797ef6776bcc77c1349f9f8c81...8f41c07f90da5e314cbc428f1e3e936563f7f39d,2,53,3,56,2,2011-10-26 21:35:16,2011-10-24 01:01:27
2f47eae2a1337bd0cb50dbc936df6433f460bb4a...7dac3f83218b9f6c4c7d1c1cf093190f20d27108,1,3,1,4,2,2013-01-31 19:10:44,2013-01-31 18:18:40
2f47eae2a1337bd0cb50dbc936df6433f460bb4a...7a2b128d13d880635e7317a9208cfa42a660f143,59,175,176,351,169,2011-11-05 04:40:25,2011-11-03 02:19:34
7a2b128d13d880635e7317a9208cfa42a660f143...57b58db74c3272ac13d5d201ecedf6483b34cdfe,5,13,8,21,8,2011-11-07 22:06:39,2011-11-05 04:31:28
57b58db74c3272ac13d5d201ecedf6483b34cdfe...47d84b6abcd2fbb2e84495663407829c9bb0da67,1,1,0,1,1,2011-11-07 23:34:30,2011-11-04 21:05:22
47d84b6abcd2fbb2e84495663407829c9bb0da67...dd621df9cde83fc08f9d3924b793b989b8f8a313,3,3,12,15,4,2011-11-07 23:34:30,2011-11-04 21:14:05
dd621df9cde83fc08f9d3924b793b989b8f8a313...4c0ea82da3cd35eff50377cab78208c8ef57933b,1,10,10,20,5,2011-11-07 23:34:30,2011-11-05 00:00:03
4c0ea82da3cd35eff50377cab78208c8ef57933b...cbda121c993bf14d3743c7fdf0f8c476c9f7c636,3,27,18,45,12,2011-11-07 23:34:30,2011-11-05 00:35:42
cbda121c993bf14d3743c7fdf0f8c476c9f7c636...895680f044ebe9df600e6c9e042d40d9d953bc9b,3,92,2,94,6,2011-11-08 18:36:18,2011-11-05 04:06:30
895680f044ebe9df600e6c9e042d40d9d953bc9b...ae8e4c9ce10ea9439a88b79a40aeff4696d40416,4,61,47,108,23,2011-11-08 18:36:53,2011-11-07 21:26:22
ae8e4c9ce10ea9439a88b79a40aeff4696d40416...274a5c06d525da8c9720ae60454fba6779523c52,2,15,4,19,2,2011-11-08 18:36:53,2011-11-07 22:45:10
274a5c06d525da8c9720ae60454fba6779523c52...5231c633f2e54723d53a8cd928d9bc98b39dc35f,3,116,11,127,10,2011-11-09 18:28:04,2011-11-08 00:21:32
5231c633f2e54723d53a8cd928d9bc98b39dc35f...fab47d057559301c74d6642576694fd251a3fd11,1,6,0,6,1,2011-11-09 18:29:42,2011-11-08 00:29:34
fab47d057559301c74d6642576694fd251a3fd11...ed7a42a0752fd71cf04273b8e691966dd2c33ebe,3,76,3,79,5,2011-11-10 06:27:11,2011-11-08 23:38:07
ed7a42a0752fd71cf04273b8e691966dd2c33ebe...79a9312cc99f9c2f2949e1211c708896e6037f64,1,18,13,31,4,2011-11-10 06:27:17,2011-11-09 19:33:55
79a9312cc99f9c2f2949e1211c708896e6037f64...96b8d93a539f3a9f43f0fc38214db8753cac3c2e,2,53,6,59,7,2011-11-13 06:25:07,2011-11-09 19:54:04
f85a051d13884c5a1059edb6ef7f2a6f8c55f0e9...111ee18c31f9bac9436426399355facc79238566,1,9,4,13,2,2011-08-18 20:54:58,2011-08-18 18:34:39
4764f46492b0849ce3cf2f527978acd9c2d5f7e6...475b3777bdae3c7c36f383a6a58f999111bffa18,1,1,1,2,1,2011-11-06 06:14:25,2011-11-05 17:28:42
475b3777bdae3c7c36f383a6a58f999111bffa18...ca0f515d75ee3328b8fa70f6eeedb4f06ba79028,1,2,2,4,2,2011-11-06 06:14:26,2011-11-05 17:28:43
4764f46492b0849ce3cf2f527978acd9c2d5f7e6...6ba7acffdd24e9ed9b31e503ce87f2af31cd0883,1,2,2,4,2,2011-08-04 22:33:34,2011-08-04 12:00:58
6ba7acffdd24e9ed9b31e503ce87f2af31cd0883...d3dfeedf2ec8c72bceaabf4e109c19a14576d333,1,48,0,48,2,2011-08-04 22:33:50,2011-08-04 12:00:59
d3dfeedf2ec8c72bceaabf4e109c19a14576d333...fee92fc1dd4480d9d5c72bd67243d3f6a9b03132,3,28,14,42,16,2011-08-04 22:34:32,2011-08-04 12:01:00
fee92fc1dd4480d9d5c72bd67243d3f6a9b03132...4796e823a3d24d29dbcccfda166d6c88051cbfaa,1,37,11,48,12,2011-08-04 22:35:30,2011-08-04 12:01:01
4796e823a3d24d29dbcccfda166d6c88051cbfaa...b704a8b3fd1d5a2eeeeadcef48c962db2c84b0af,1,82,0,82,2,2011-08-04 22:37:20,2011-08-04 12:01:02
9353e09afa21b24fa356f960300e1c0a1567aa72...7203a2d1ca18b32feda71a48c21e80fb03f2e909,1,10,13,23,5,2011-08-01 17:49:45,2011-08-01 11:16:10
4e2e6ce45047fe2713546127f3d1ded576e1bf7e...0a9feffc47b19b81aba7ee5a93473b4c91f44ea9,1,9,4,13,5,2011-08-22 18:48:38,2011-08-22 08:33:05
0a9feffc47b19b81aba7ee5a93473b4c91f44ea9...807371a92654634d482b31b1d5dd3dff86193990,1,25,0,25,1,2011-08-22 18:49:04,2011-08-22 08:33:06
807371a92654634d482b31b1d5dd3dff86193990...52dced8a568a03d62ceff8e2cd9631074d08dca0,1,53,0,53,1,2011-08-22 18:50:31,2011-08-22 08:33:07
52dced8a568a03d62ceff8e2cd9631074d08dca0...c5cd4ef0fd0838b3a7c97e53f361ba15db736138,1,83,0,83,1,2011-08-22 18:50:38,2011-08-22 08:33:08
c5cd4ef0fd0838b3a7c97e53f361ba15db736138...68cbcf1b2575ca151ed3b11698916bcbbd1b890c,1,1,1,2,1,2011-08-22 18:50:43,2011-08-22 08:33:09
68cbcf1b2575ca151ed3b11698916bcbbd1b890c...04d277b39e3e40f939fd7935c30beb48452015ec,1,5,3,8,2,2011-08-23 04:08:37,2011-08-18 23:44:03
04d277b39e3e40f939fd7935c30beb48452015ec...8ace74c00e87cbb16d7303761ff4f6b91505ee20,2,13,1,14,2,2011-08-23 04:08:37,2011-08-18 23:44:04
8ace74c00e87cbb16d7303761ff4f6b91505ee20...7199cf131c5420b631f8402498f17ec42cdb3b3a,2,31,0,31,3,2011-08-23 04:08:37,2011-08-18 23:44:05
7199cf131c5420b631f8402498f17ec42cdb3b3a...7ca97f6ecc66f1d70ca126edd33b6a3065c914f7,1,64,0,64,1,2011-08-23 04:09:05,2011-08-18 23:44:06
4e2e6ce45047fe2713546127f3d1ded576e1bf7e...bb571486ae93d02746c4bcc8032bde306f6d399a,1,15,2,17,1,2011-08-11 20:03:35,2011-08-01 01:52:41
1f2705e20fa5f2d3c93663296eef723f45d1fa41...8499644ea7af87c02f9b878f162aa6facbd5b8a7,2,53,1,54,2,2011-08-16 19:42:17,2011-08-16 19:13:38
6b6cab3f9af2ab7010592e50bb343b990a6a7666...95dea6eb507109f64ab80f7fa2f73c39a0d14e7c,1,3,1,4,1,2011-07-22 21:30:49,2011-07-22 17:00:03
c6d059bbccb8460959b9aedfeefbb4d6aac6e842...21b5b1e8dc9bed2b518defe29d69ebc27da4b68f,4,39,18,57,10,2011-02-17 00:55:56,2011-02-16 23:12:20
c6d059bbccb8460959b9aedfeefbb4d6aac6e842...d531174fe386af00755619d6a204db74a30954f8,1,8,4,12,4,2010-12-14 19:13:41,2010-12-14 18:27:48
c6d059bbccb8460959b9aedfeefbb4d6aac6e842...fbbfc8a9bb91ddd325995cc346eab91c06c9cd64,1,1,1,2,1,2010-12-14 19:07:11,2010-12-14 18:19:09
fbbfc8a9bb91ddd325995cc346eab91c06c9cd64...531dd7bbf4e579334cddb5be54af94c8d339df10,1,2,3,5,2,2010-12-14 19:07:52,2010-12-14 18:20:38
531dd7bbf4e579334cddb5be54af94c8d339df10...b6fe97483fdfec2176cf17dd38821cad0200a126,1,25,22,47,1,2010-12-14 19:09:13,2010-12-14 18:22:29
b6fe97483fdfec2176cf17dd38821cad0200a126...cff484a98baf57f11daed62744bcf0774bd78c2f,1,10,0,10,2,2010-12-14 19:11:35,2010-12-14 18:25:11
cff484a98baf57f11daed62744bcf0774bd78c2f...1b3187ba6efdb216a9b45dac087aa4bfba0b90ae,1,1,1,2,1,2010-12-14 19:12:10,2010-12-14 18:26:38
c6d059bbccb8460959b9aedfeefbb4d6aac6e842...67976c65e0e931ad73ec21e5effe3dc204003df4,1,23,8,31,10,2010-12-14 19:03:41,2010-12-14 15:54:31
4443091d961e91041e64c1675940f0585eeba456...28042dbcd60f3190d25cfeae0bf81d58a16f4771,1,13,11,24,9,2010-12-13 06:31:45,2010-12-13 06:19:00
28042dbcd60f3190d25cfeae0bf81d58a16f4771...84baa31bcb6925b06dd1b9aaa1ed6f7a725e64cc,1,11,8,19,6,2010-12-13 06:32:01,2010-12-13 03:01:14
84baa31bcb6925b06dd1b9aaa1ed6f7a725e64cc...32574b68c57f3b34e58216a4c9c6d570d11ec47b,3,105,11,116,7,2010-12-15 00:50:45,2010-12-13 03:01:15
32574b68c57f3b34e58216a4c9c6d570d11ec47b...4322842acfaace812308f8aec0fe39a358f3c6f2,1,7,0,7,1,2010-12-16 21:11:42,2010-12-15 09:02:54
6068cdcc832040ac644c56953be0670bb09afd12...7b88176e9bce658fd44c2192c1b7aa6e612ee0c2,3,24,3,27,6,2010-06-16 21:45:09,2010-06-14 16:12:29
6068cdcc832040ac644c56953be0670bb09afd12...6622d9c7103525bb8673f93df4104ab2a46cb174,5,83,3,86,11,2010-06-16 17:08:59,2010-06-16 05:59:25
6622d9c7103525bb8673f93df4104ab2a46cb174...d8e1e5df950f2c514a01696a0a0ff53fb1a07651,1,2,1,3,2,2010-06-16 17:11:19,2010-06-16 05:59:26
bc97e2d8ae24dc2c8d06e616e20a0b4a47c58f67...83d842dc8ce4380aa365485b4d9845762f80c6db,3,74,14,88,12,2014-02-14 16:13:51,2014-02-10 21:29:37
cc1b8d8bc6e453b96798574d67ce9590eb3e82e1...738820a913d05427b6c86d227aafd2bac7cd38d1,5,36,28,64,8,2010-02-19 01:13:18,2010-02-18 09:10:28
6b30852ded5074652f4304a303521932235c62db...e03e05ff73a6f6b4f32eb5cd13b4f1e43275e42f,1,2,3,5,4,2007-09-21 05:19:17,2007-09-19 22:42:10
e03e05ff73a6f6b4f32eb5cd13b4f1e43275e42f...19247e5510279f018f8358a72b38cc5aa62fac8a,4,75,105,180,22,2007-09-21 06:17:22,2007-09-20 08:43:11
19247e5510279f018f8358a72b38cc5aa62fac8a...c76689df6c64a1e987bd779bd71a2042b5131fb9,4,23,20,43,10,2007-09-21 06:17:40,2007-09-19 22:42:12
c76689df6c64a1e987bd779bd71a2042b5131fb9...7fb1011e610a28518959b1d2d48cea17ecc32048,7,191,188,379,77,2007-09-21 06:32:18,2007-09-19 22:42:14
7fb1011e610a28518959b1d2d48cea17ecc32048...663af3422a648e87945e4d8c0cc3e13671f2bbde,10,273,368,641,90,2007-09-21 06:45:49,2007-09-19 22:42:15
663af3422a648e87945e4d8c0cc3e13671f2bbde...7a33bcbe802080f3a926e93d66b65ff7c5e8c5ed,6,86,137,223,39,2007-09-21 10:31:18,2007-09-19 22:42:13
7a33bcbe802080f3a926e93d66b65ff7c5e8c5ed...a8f3e2219c237661a30b54fe23d58e055f0b548c,1,6,3,9,3,2007-09-26 09:27:05,2007-09-26 09:26:06
a8f3e2219c237661a30b54fe23d58e055f0b548c...45f66f64636350b67eaf6832b0c424592be6ddda,2,13,0,13,2,2007-09-26 09:27:05,2007-09-24 09:25:03
45f66f64636350b67eaf6832b0c424592be6ddda...8289b6209552a57c255561a2585d0edbe96d62d3,1,18,25,43,13,2007-09-26 09:27:05,2007-09-24 09:25:04
8289b6209552a57c255561a2585d0edbe96d62d3...1dffb8fa8056860e769f3a0c6e232d436f5a5c17,3,15,25,40,8,2007-09-26 09:27:06,2007-09-25 08:22:44
1dffb8fa8056860e769f3a0c6e232d436f5a5c17...b4833a2c62578bdbfd300e296702214cb1b9a601,1,4,2,6,1,2007-09-27 06:34:01,2007-09-27 06:34:01
b4833a2c62578bdbfd300e296702214cb1b9a601...a9390b9fcefb18c4ccdb521086a051bc9112e03d,3,19,8,27,4,2007-09-27 07:33:29,2007-09-18 00:06:46
a9390b9fcefb18c4ccdb521086a051bc9112e03d...6d69b6f6ac27ab6f71a10da34b813ca25fd2a358,4,28,36,64,17,2007-09-27 07:33:33,2007-09-18 00:06:45
6b30852ded5074652f4304a303521932235c62db...f26a0012262106e0c7e92d8d07f00611112d3a8d,4,58,52,110,45,2007-09-19 19:52:19,2007-09-18 00:06:42
f26a0012262106e0c7e92d8d07f00611112d3a8d...0f729f21348c43a1c80f48faed2e753b1c923e85,2,3,1,4,3,2007-09-19 19:52:19,2007-09-18 00:06:43
3d80017d0c948cca251a7aaa9fdc84a0664e95fe...c32da692de332d3c9a0b283066e3786af00f4931,1,1,1,2,1,2007-09-14 05:33:11,2007-09-12 21:36:03
c32da692de332d3c9a0b283066e3786af00f4931...f28dd4774d4723e8251817e910dbdc5507282113,1,5,1,6,1,2007-09-14 05:39:22,2007-09-13 11:36:22
f28dd4774d4723e8251817e910dbdc5507282113...f5de79956b2abeb0f45b338428d39ce089002b66,1,0,5,5,1,2007-09-14 05:53:53,2007-09-13 15:57:56
f5de79956b2abeb0f45b338428d39ce089002b66...767c98a5929b02152c8904a09f1eabbf8d386395,1,1,0,1,1,2007-09-14 07:45:29,2007-09-14 07:45:29
767c98a5929b02152c8904a09f1eabbf8d386395...8419d2ee9ba8b375186a5c1019df8dfbce610aba,1,30,1,31,2,2007-09-14 07:49:12,2007-09-14 05:30:45
611d8139e4e0a78797a0821074fc94a4f8d74b7b...09d5dc32fbdfa7bfd23fe377455445dd2605c3b9,6,4,19,23,13,2007-09-14 08:02:21,2007-09-14 03:33:11
67c10b422c179b9ce2e4537f7c2a1e7d50649cd4...67aca456a3cfa9ab8420a6e171d8eee7b0ad2209,1,1,1,2,1,2007-08-26 20:22:40,2007-08-26 19:31:32
67aca456a3cfa9ab8420a6e171d8eee7b0ad2209...09b0d9dde03df1432df06dcfcc20d8abecccb860,1,6,4,10,2,2007-08-26 21:01:47,2007-08-26 18:35:26
4e0b2bbc578f8729cf43939acb36e8db02ed8825...33a798c880f9a8bed1fe95531349e5e5ef1e0cd2,1,1,1,2,1,2007-08-06 07:25:35,2007-08-06 07:20:06
33a798c880f9a8bed1fe95531349e5e5ef1e0cd2...93969438dca50c7f0039fcf35e7ab82776d4122f,1,1,1,2,1,2007-08-06 08:36:59,2007-08-05 04:48:08
4e0b2bbc578f8729cf43939acb36e8db02ed8825...5f42ac921fe06bbb80df82d8fa5cb15701ec2f60,1,22,19,41,2,2007-08-05 23:18:05,2007-08-05 23:16:09
c80d25dbce759a8483ffc1f085fdf4cd63cf9f05...6e4ba05c7fee0d0140e2057b63f5ca4eea9a6053,1,2,2,4,2,2007-09-04 03:01:44,2007-09-02 19:19:07
6e4ba05c7fee0d0140e2057b63f5ca4eea9a6053...881d8f24cab5bf4e0fa71b17a3ab82e27b2e8ed7,1,1,1,2,1,2007-09-04 03:01:44,2007-09-02 19:30:26
881d8f24cab5bf4e0fa71b17a3ab82e27b2e8ed7...047d94d505c9837a60c28e121de65471dadce74b,1,6,9,15,4,2007-09-04 03:03:52,2007-09-02 19:38:04
c80d25dbce759a8483ffc1f085fdf4cd63cf9f05...fc703c209d415fe20ad5551465b5b68b8ab8b046,1,15,10,25,3,2007-09-02 01:58:29,2007-09-02 01:58:29
fc703c209d415fe20ad5551465b5b68b8ab8b046...d4b0ccd931cc29f35e8f8493445af27ea72ed03e,1,14,0,14,3,2007-09-02 02:22:42,2007-09-02 02:22:42
d4b0ccd931cc29f35e8f8493445af27ea72ed03e...1ac17950e93a956d01b042db3de70010195eddcc,22,403,398,801,340,2007-09-02 15:54:48,2007-07-21 12:21:34
1ac17950e93a956d01b042db3de70010195eddcc...3845048064352f4e213363239298f4fa3190ddb9,1,19,2,21,4,2007-09-02 15:55:16,2007-07-21 12:17:07
3845048064352f4e213363239298f4fa3190ddb9...2631a81b901fc7baa274f98530a0d9cc05cecd17,1,205,0,205,1,2007-09-02 15:55:18,2007-07-27 23:05:16
2631a81b901fc7baa274f98530a0d9cc05cecd17...e79bbfea9be31957e0532db67b264d7d8581af30,1,1264,0,1264,1,2007-09-02 15:56:00,2007-07-22 01:12:18
e79bbfea9be31957e0532db67b264d7d8581af30...9f1a80877a59aeae1626296fac25360d9a81954e,1,2,0,2,1,2007-09-02 15:56:13,2007-07-22 11:31:45
9f1a80877a59aeae1626296fac25360d9a81954e...660a68cf1816075b935c67aa780fd1b2484c0f2f,3,91,0,91,3,2007-09-02 15:56:13,2007-07-23 20:11:12
660a68cf1816075b935c67aa780fd1b2484c0f2f...3b703b2a380c276da946338ad16801a12962b000,1,152,0,152,1,2007-09-02 15:57:41,2007-07-27 17:24:45
3b703b2a380c276da946338ad16801a12962b000...90a7149ff15ea0ee0e2ad04ea72ac64e29a1cb52,1,1398,0,1398,1,2007-09-02 15:58:17,2007-07-21 12:18:14
90a7149ff15ea0ee0e2ad04ea72ac64e29a1cb52...377eaa03961985b5fa379244ed89de51fbf08045,1,1284,0,1284,1,2007-09-02 15:58:34,2007-07-22 00:08:56
377eaa03961985b5fa379244ed89de51fbf08045...2340a74e5f64243a10ae2daa9403baa28f3d9d11,1,1381,0,1381,1,2007-09-02 15:58:34,2007-07-25 08:59:58
2340a74e5f64243a10ae2daa9403baa28f3d9d11...4fe7626488872e1226490500e70b7e2a4c262906,1,1393,0,1393,1,2007-09-02 15:58:35,2007-07-22 10:51:13
4fe7626488872e1226490500e70b7e2a4c262906...e2b7200fcdb7bdafe7af00860df7d5774969e419,1,1480,0,1480,1,2007-09-02 15:58:35,2007-07-22 11:57:12
e2b7200fcdb7bdafe7af00860df7d5774969e419...f6b7de2acd704bfa33841e8c771054f18963dfac,1,1422,0,1422,1,2007-09-02 15:58:36,2007-07-27 12:37:33
f6b7de2acd704bfa33841e8c771054f18963dfac...fcc73b71557c31ba79acd4e186fec00b096f12f2,1,158,0,158,1,2007-09-02 15:58:36,2007-07-24 12:59:15
fcc73b71557c31ba79acd4e186fec00b096f12f2...b4b093d1109d0a1fd6f20c21751665ee6ca66f9b,1,170,0,170,1,2007-09-02 15:58:37,2007-07-25 12:47:17
b4b093d1109d0a1fd6f20c21751665ee6ca66f9b...2ea22555073a1272ba1dc4ecb9968c0f8616e860,1,1,6,7,1,2007-09-03 04:17:04,2007-09-03 04:17:04
2ea22555073a1272ba1dc4ecb9968c0f8616e860...b86882eda026a0da18472587034250a53e0daf51,1,1,1,2,1,2007-09-03 04:22:19,2007-09-03 04:22:19
b86882eda026a0da18472587034250a53e0daf51...87b63de49c04c3e78d37c68b72a6bcbc86724760,1,4,2,6,3,2007-09-03 04:42:09,2007-09-03 04:42:09
87b63de49c04c3e78d37c68b72a6bcbc86724760...74e528bf44e715774e3a8e0003a6b2b250f4f0b9,1,3,3,6,3,2007-09-03 04:45:25,2007-09-02 12:43:00
74e528bf44e715774e3a8e0003a6b2b250f4f0b9...12fb223326b561132d528bb010c6bdeaa828acd3,1,2,2,4,1,2007-09-04 03:04:54,2007-09-03 22:54:14
1e607449135792dd117bd528432fc1fbc1115667...3b36ef918801e265a1f8d1a7c085f400b9c2540d,1,2,2,4,1,2015-01-26 18:36:04,2015-01-25 11:00:04
3b36ef918801e265a1f8d1a7c085f400b9c2540d...2f334c646183a6796bb731b8df73b82ac880d727,1,2,2,4,2,2015-01-26 18:36:04,2015-01-26 15:34:31
2f334c646183a6796bb731b8df73b82ac880d727...07586ebd4fd2ba273a1dae60403aa5affc352e29,1,1,1,2,1,2015-01-26 18:36:04,2015-01-26 15:34:32
1e607449135792dd117bd528432fc1fbc1115667...573ed5e14717c7bcccbb51357cc311a482135346,1,937,925,1862,869,2015-01-26 17:12:50,2015-01-26 17:12:50
b195aa00c17ea38d3f1c9125c37348645ea58f7c...88c03eb5775546a2cae0d8cc9025ef7969b23485,1,6,3,9,3,2015-02-09 22:09:21,2015-02-06 09:35:31
6fb5df6c77070f7cea5391572003ecfea3235650...830ff021aaaf12c43f06314feaf465377672d3ea,2,56,0,56,2,2015-01-29 19:56:19,2015-01-29 15:43:20
830ff021aaaf12c43f06314feaf465377672d3ea...1f985d60ef04aa9b291d01c093ed7496e26ccaee,1,2,0,2,1,2015-01-29 20:35:05,2015-01-29 15:51:11
d544b2d495295142cb3418b13b5a106d415d2216...b3e4c47565711f5927d87392bd80ff1d6fb25c57,1,2392,2165,4557,2009,2014-11-18 03:22:48,2014-11-18 03:22:48
afb0b7933f31e984caf6fb835f6afe6eb37d918c...467ddc14fe37ea6a3d77058fb24c4240e82e6344,4,70,6,76,9,2011-04-03 06:52:20,2011-03-01 00:11:55
c54e6be75ae90e2be45c32f4d1949fff59ad7d9d...5502039d87337e076e69f7de949cb0e0360de16f,1,585,0,585,1,2011-04-29 18:17:36,2011-04-29 09:36:16
5502039d87337e076e69f7de949cb0e0360de16f...58a8756a98fbd08add1c25ac61ffa4f4f8a6e776,2,4,4,8,5,2011-04-29 18:17:36,2011-04-29 09:36:17
58a8756a98fbd08add1c25ac61ffa4f4f8a6e776...333f3fb0c5307fed170cae336ab3c056f4d6ca1c,3,214,22,236,11,2011-04-29 18:17:36,2011-04-29 09:36:18
333f3fb0c5307fed170cae336ab3c056f4d6ca1c...2d17495196d0dceb0ff492aa97bfff33ef1baa18,4,119,1,120,12,2011-04-29 18:20:03,2011-04-29 09:36:19
2d17495196d0dceb0ff492aa97bfff33ef1baa18...712d2c7dd893212756c21787fc12d6f71327e167,3,81,11,92,12,2011-04-29 18:20:11,2011-04-29 09:36:20
712d2c7dd893212756c21787fc12d6f71327e167...1c57a627bf269f3c83c48ad724cd8b14292502ef,5,176,2,178,11,2011-04-29 18:22:55,2011-04-29 09:36:21
1c57a627bf269f3c83c48ad724cd8b14292502ef...51670fc87e193a42022087d8d773cf2315736604,2,78,30,108,17,2011-04-29 18:22:56,2011-04-29 09:36:22
51670fc87e193a42022087d8d773cf2315736604...7478ac57c4b5cd589cb134d88e8cd78db1247b30,2,15,15,30,9,2011-04-29 18:22:56,2011-04-29 09:36:23
d17cf5f3a32f07bf8a6b8fb014abfa8e87fd7075...35e2d03c2c24462717d774cd9f4eea46f1474ba1,2,31,0,31,2,2012-08-05 19:37:52,2012-08-04 21:07:35
1b8e822e572f3c86e0c0d1e9e8bc29d016a4e3d3...7615cb005bf15abce05cbdde775e5fdf4662d655,5,10,10,20,8,2012-08-06 22:34:20,2012-07-14 22:20:36
5a304dd303cd47d8b05b17766399010a674e799a...85da4d459bd6fe11189a2ccf560c952b31ed67b2,3,71,2,73,3,2012-01-29 21:46:18,2012-01-29 21:46:18
85da4d459bd6fe11189a2ccf560c952b31ed67b2...aad070922157d3249af7095ecff6ebc074c13bb9,1,1,1,2,1,2012-01-30 20:19:06,2012-01-30 19:29:33
066bf4c2e43c7fb40405843e49f809431314865d...44d8dc54e73e8010c4bdf57a422fc8d5ce709029,1,5,4,9,3,2011-03-29 19:20:22,2011-03-29 17:06:19
990f6e30eb00adeb8cad75c3be34c0fc9ff6abb0...00ebc977484e18c03160b6319322858c088bce55,1,77,0,77,1,2011-05-26 21:11:59,2011-05-26 20:41:18
00ebc977484e18c03160b6319322858c088bce55...5b38456ec7bd0229bb35146ab8a905c4b63daeec,2,2,2,4,2,2011-05-26 21:13:38,2011-05-26 20:53:38
5b38456ec7bd0229bb35146ab8a905c4b63daeec...8b8a53744f60274ef07e3a2a51995129c8d42f38,7,14,12,26,9,2011-05-26 22:47:20,2011-05-26 22:27:24
8b8a53744f60274ef07e3a2a51995129c8d42f38...6bf139440c192e157b9c0dab701fa2100fbb1e1e,7,75,76,151,53,2011-05-26 22:56:47,2011-05-26 22:27:49
6bf139440c192e157b9c0dab701fa2100fbb1e1e...9553d2b26395d9a19bf60875784661090f607f4a,6,8,3,11,6,2011-05-26 22:56:55,2011-05-26 22:28:17
adfe4e1ff2c296184856bf55636be845f96b55e5...48bb914ed641fc0880d86b16cbb17c84769c320a,134,4,1134,1138,137,2011-03-11 15:59:16,2011-03-11 05:52:08
48bb914ed641fc0880d86b16cbb17c84769c320a...6ea922d596ffdeef8c4ce3832f9a162810308e07,5,20,0,20,5,2011-03-11 15:59:16,2011-03-11 06:08:48
6ea922d596ffdeef8c4ce3832f9a162810308e07...d8f708f860095245c6973ba6b1ada366ce2d5bdf,1,4,2,6,1,2011-03-13 03:00:38,2011-03-13 03:00:38
82553cbb08b791aa0bed920ee58494268c0f579f...f7e5ea171b693bf5fc88e059d9d4af3753c09143,3,31,6,37,7,2012-01-17 00:04:52,2012-01-16 10:53:00
f7e5ea171b693bf5fc88e059d9d4af3753c09143...ee2d1cb402a7ccda0028b221f2252801b3cb7eef,2,11,2,13,3,2012-01-17 00:06:57,2012-01-16 10:53:01
beba25abbc34a07e07ce933210cda15202ef76cc...4947367267cbcd0ca528711b2393613e2e817878,5,32,19,51,18,2011-09-01 22:46:12,2011-09-01 22:43:33
4947367267cbcd0ca528711b2393613e2e817878...5a48d24012fa39cdd02c1cb614db2e62d445e2ce,3,10,0,10,4,2011-09-01 22:46:13,2011-09-01 22:43:34
23f536cf6236bf2a29026fea52c6bf7624b6485d...0b9deecf625677cf44058a42c2abd7add5167e81,1,15,5,20,6,2011-05-02 23:10:50,2011-05-02 23:10:50
509d59705ee07094bcc56b49a17ba0ae983da50f...e29bee19012d6aa4fb02dae727caa53947d9e39a,1,8,0,8,1,2011-09-21 18:59:33,2011-09-10 17:40:10
509d59705ee07094bcc56b49a17ba0ae983da50f...28f555f6357ee0706847aff5b476b31b472b325c,2,28,4,32,5,2011-09-12 04:39:55,2011-09-02 00:50:33
28f555f6357ee0706847aff5b476b31b472b325c...60e5eee0f1a70e09f28d1e55b3aaddb59eeea887,2,11,1,12,2,2011-09-12 04:39:56,2011-09-02 00:50:34
60e5eee0f1a70e09f28d1e55b3aaddb59eeea887...1822b86a515af708e2259bae2b6a1f2052a2d3aa,1,6,0,6,1,2011-09-12 04:39:58,2011-09-03 15:26:59
1822b86a515af708e2259bae2b6a1f2052a2d3aa...b52d00aedeb94f12a16afcef1bb33c989f9b4105,2,9,4,13,5,2011-09-12 04:40:00,2011-09-10 19:39:23
509d59705ee07094bcc56b49a17ba0ae983da50f...30962fb7fba9a8e57fe34a70bc8abd2e0af8b2ee,1,1,2,3,1,2011-09-12 03:53:00,2011-09-11 12:38:10
509d59705ee07094bcc56b49a17ba0ae983da50f...eb726f2d760dd78915e4a24f014ab411a165daa3,1,3,6,9,1,2011-09-12 01:03:38,2011-09-12 01:03:38
509d59705ee07094bcc56b49a17ba0ae983da50f...8abc5082222b7f65e07453a0aca46ce6d25ce3a5,1,1,1,2,1,2011-09-06 22:48:49,2011-09-05 22:29:34
8abc5082222b7f65e07453a0aca46ce6d25ce3a5...be22d92eac809ad2bfa2b7c83ad7cad5a15f1c43,1,6,1,7,2,2011-09-06 22:49:23,2011-09-05 22:22:02
4b5eac7f03f411f75087e0b6db23caa999624304...c5978246f042967098d7e91b8355c9683a0f3d3c,1,4,1,5,2,2011-09-13 00:00:23,2011-09-03 17:06:13
4b5eac7f03f411f75087e0b6db23caa999624304...40a1530c07a6a720b6cfa52c6132274fac4e4112,3,308,4,312,16,2011-09-01 07:10:22,2011-07-20 22:37:26
40a1530c07a6a720b6cfa52c6132274fac4e4112...85f022e9c124ffeda31a50cab878e1418d694d87,1,1,1,2,1,2011-09-01 07:10:22,2011-08-29 00:45:44
85f022e9c124ffeda31a50cab878e1418d694d87...98c4ab32f80d00d0254bfdcab8d934dcda6a7504,3,19,2,21,3,2011-09-01 19:55:09,2011-08-31 16:48:39
2c4610393195cc6f35ea79efadbc5c7fd7470891...821881d88d3012a64a52ece9a8c2571ca00c35cd,2,20,1,21,3,2011-10-17 21:40:07,2011-10-17 20:26:23
051e4005a37c4ebe8b8855e415e6c6969d68e1a3...2a74532412b9d87d4ad96dacbe9a31ff85f80af5,1,2,0,2,1,2011-08-24 17:50:33,2011-08-24 05:47:17
0906f6e14e6e9df0c4ea4edb08ebe9f5d16c2391...2efe38e7da40fdf2b6e0261984d7adaab16ad930,2,44,7,51,4,2011-08-23 18:25:56,2011-08-22 12:10:18
2efe38e7da40fdf2b6e0261984d7adaab16ad930...6c447f633cedd6e2366151b0b82b1731f8c1ee1d,2,33,3,36,5,2011-08-23 18:25:59,2011-08-22 12:10:19
0906f6e14e6e9df0c4ea4edb08ebe9f5d16c2391...94c3b48247b25773d9c0d7de892cb75cb06708bb,1,6,4,10,3,2011-08-22 18:57:06,2011-08-20 19:04:11
94c3b48247b25773d9c0d7de892cb75cb06708bb...a7e9c34126ce7608bbc971b09b80540d0112091c,1,6,1,7,1,2011-08-22 18:57:07,2011-08-20 19:04:12
0906f6e14e6e9df0c4ea4edb08ebe9f5d16c2391...25e5e2bf85c8a2c2c8945935267539940c11020d,2,70,1,71,3,2011-08-21 06:03:06,2011-08-20 06:32:51
0906f6e14e6e9df0c4ea4edb08ebe9f5d16c2391...2a6f08ac1f6949ed0072aed3240bc04d80051851,1,2,0,2,1,2011-08-16 18:15:41,2011-08-16 00:13:07
0906f6e14e6e9df0c4ea4edb08ebe9f5d16c2391...9a0edb79f2f00c79b9dced22f67d226f6bb9c741,1,41,0,41,1,2011-08-14 21:40:00,2011-08-14 18:32:23
9a0edb79f2f00c79b9dced22f67d226f6bb9c741...8fb3ad76b1782a5439343b9601f73a9287a245cf,2,31,6,37,8,2011-08-14 21:40:01,2011-08-14 18:32:24
0906f6e14e6e9df0c4ea4edb08ebe9f5d16c2391...4cedb78cb5eeb26d6dd47f866b51f061737616f2,1,99,0,99,1,2011-08-11 19:20:56,2011-08-11 10:21:06
4cedb78cb5eeb26d6dd47f866b51f061737616f2...17fb00721b854b1c469e44ad709a9cad2128f11d,2,5,1,6,2,2011-08-11 19:20:56,2011-08-11 10:21:07
17fb00721b854b1c469e44ad709a9cad2128f11d...4b4963c0e1aa094900951df9e66459443111ccc9,3,24,19,43,13,2011-08-11 19:21:03,2011-08-11 10:21:08
4b4963c0e1aa094900951df9e66459443111ccc9...e3c98120f56c191ada76eea45cb213a345682843,1,36,0,36,1,2011-08-11 19:21:05,2011-08-11 10:21:09
e3c98120f56c191ada76eea45cb213a345682843...53f53cff24c5fe6683234bcd5386a447b8b17074,2,9,7,16,6,2011-08-11 19:21:07,2011-08-11 10:21:10
e8e1c29021da446d0c50573ef9619bf74f515c20...c0ad465725302b9411e53d248871c36880b6f8fd,3,17,6,23,5,2011-10-28 18:40:48,2011-10-28 18:40:48
c0ad465725302b9411e53d248871c36880b6f8fd...cdf9db3c83618453809d6a584d1a0db19b3e189f,3,16,9,25,4,2011-10-28 18:52:14,2011-10-28 18:52:14
cdf9db3c83618453809d6a584d1a0db19b3e189f...0e990530ae6d6c6805d31c666953541f762dd402,3,42,23,65,8,2011-10-28 19:34:09,2011-10-28 19:34:09
0e990530ae6d6c6805d31c666953541f762dd402...6c526148644475acbc047faaeb57d42fde1f667d,3,37,17,54,10,2011-11-30 22:27:59,2011-11-18 00:26:54
6c526148644475acbc047faaeb57d42fde1f667d...568508e76570e9ea36aad6446959424cebcf0535,11,403,78,481,22,2011-12-01 19:46:09,2011-10-28 21:48:40
4bfe7cb6668c43c1136304bbb17eea1b3ddf0237...27af01d552331eacf1ed2671b2b4b6ad4c268106,1,50,36,86,27,2011-08-18 00:15:05,2011-08-17 01:53:57
964498e7f90bc5d822746bbf953fb66c6b01ac1c...841d81180e6754b18559220087decf01f504b203,1,1,1,2,1,2011-03-08 19:56:37,2011-03-08 08:31:24
964498e7f90bc5d822746bbf953fb66c6b01ac1c...334f8cb22a085964f1ad7d6063c66767920b3332,1,14,2,16,4,2011-03-06 22:02:45,2011-03-04 22:43:45
964498e7f90bc5d822746bbf953fb66c6b01ac1c...9d158601b3cb9753825e21441c88d31297b97be5,1,6,1,7,3,2011-03-04 22:47:18,2011-03-04 20:25:34
0bd20f10ea1884c1118efc19ee6325ad6cce9105...d98f24cd9d8d8ee20b65d22ec6b78da04b48de85,1,9,0,9,2,2011-03-21 05:14:21,2011-03-21 05:14:21
8dc6a373d201839859fe7924b63e57526ee2fc22...c27e559da5b26faa31858fe6dc5492d4f605b867,1,2,0,2,1,2012-03-10 04:02:44,2012-03-10 03:20:34
c27e559da5b26faa31858fe6dc5492d4f605b867...178e1deaae33f879ea687e85ac72455b3072b0d8,2,41,0,41,2,2012-03-10 04:07:22,2012-03-10 04:07:22
8dc6a373d201839859fe7924b63e57526ee2fc22...4d21bec0d2c2f83e3f1e84edae5a3259cdab862f,1,2,1,3,3,2011-02-26 10:57:58,2010-10-11 02:37:10
4d21bec0d2c2f83e3f1e84edae5a3259cdab862f...deadcef4c15d54d0a397180a1783ae8939254188,1,6,10,16,5,2011-02-26 10:57:58,2010-11-06 17:01:28
deadcef4c15d54d0a397180a1783ae8939254188...d350822fa7d14052713bea0ec62ff1246d8a2f7a,2,33,23,56,15,2011-02-26 10:57:58,2010-10-11 02:39:21
d350822fa7d14052713bea0ec62ff1246d8a2f7a...e5e45ca1e35482d120a7ce776cf208369edcc459,7,50,46,96,38,2011-02-26 10:57:59,2010-10-11 02:41:06
e5e45ca1e35482d120a7ce776cf208369edcc459...850c5ea44ce0b4aac3be7c4d14b38ec901e777d1,2,45,29,74,15,2011-02-26 10:57:59,2011-01-03 00:50:16
850c5ea44ce0b4aac3be7c4d14b38ec901e777d1...232087fd99915abaa7d917fd181ad8477bb689f2,2,67,54,121,2,2011-02-26 10:57:59,2011-01-03 00:51:07
232087fd99915abaa7d917fd181ad8477bb689f2...7b990c90514b24097ee71edbc02cb3a497a9476b,2,20,17,37,11,2011-02-26 10:57:59,2011-01-03 00:52:28
7b990c90514b24097ee71edbc02cb3a497a9476b...d280f68313eecb8b3838c70641a246382d5e5343,2,128,4,132,8,2011-02-26 10:58:21,2011-01-03 01:07:16
d280f68313eecb8b3838c70641a246382d5e5343...e832f43c1d26bf70611d98b62d95870a99292add,4,35,0,35,6,2011-02-26 10:59:37,2011-01-03 03:05:46
e832f43c1d26bf70611d98b62d95870a99292add...cc193f1f0b45e4e65f246f1d5e6e8134844aa35b,2,6,0,6,2,2011-02-26 10:59:37,2011-01-03 03:06:32
cc193f1f0b45e4e65f246f1d5e6e8134844aa35b...cb3f87cf1ba90373fdc240d65a4d65434099d9a3,5,31,7,38,6,2011-02-26 10:59:37,2011-01-03 03:09:38
cb3f87cf1ba90373fdc240d65a4d65434099d9a3...b1c9b798a6dd391aeaea31663a65164815701244,3,52,1,53,5,2011-02-26 10:59:37,2011-01-03 03:10:59
26db0f2e3afc043e184a5e0ce5eb7c53aeb1f644...a9bfbc5b698103b1553e1023c4f77001cc861e79,1,7,2,9,3,2011-12-12 17:09:35,2011-12-12 14:25:51
26db0f2e3afc043e184a5e0ce5eb7c53aeb1f644...becbdae82bb8bb193c2f1e9d8b32a60bdef8b0e4,4,93,0,93,5,2011-03-08 20:12:42,2011-02-26 05:09:41
becbdae82bb8bb193c2f1e9d8b32a60bdef8b0e4...37f3012ff2a1a23dc7f8d390fde959d292fcc4e8,1,13,14,27,13,2011-03-08 20:12:43,2011-02-26 05:10:49
37f3012ff2a1a23dc7f8d390fde959d292fcc4e8...b926c0d10df6c5bdc8bf9a2fc1431e8edb673e4d,2,67,66,133,44,2011-03-08 20:12:43,2011-02-26 05:11:37
26db0f2e3afc043e184a5e0ce5eb7c53aeb1f644...c6053543f288f503b39e946ef58bfcd59f935b5f,2,10,5,15,6,2011-03-08 20:12:04,2011-02-24 14:28:15
c6053543f288f503b39e946ef58bfcd59f935b5f...06796607ef557e8913f1797cca3c98ce4844c36c,2,19,11,30,10,2011-03-08 20:12:04,2011-02-24 14:28:41
06796607ef557e8913f1797cca3c98ce4844c36c...39bc5e4680a1ed7192968fbe9f5784ad56ecbd36,2,12,3,15,4,2011-03-08 20:12:04,2011-02-24 14:28:59
39bc5e4680a1ed7192968fbe9f5784ad56ecbd36...94b3b3746456949d834ec7bf454da3db4eb439cf,2,17,7,24,6,2011-03-08 20:12:04,2011-02-24 14:29:50
94b3b3746456949d834ec7bf454da3db4eb439cf...bbc30f996380eacd71ca061675d5d0c5f21c45d2,8,65,1,66,16,2011-03-08 20:12:04,2011-02-24 14:30:19
bbc30f996380eacd71ca061675d5d0c5f21c45d2...7e2342d0987f7f78bc8582e97bbfbafd80d327ef,2,7,6,13,4,2011-03-08 20:12:04,2011-02-24 14:30:30
26db0f2e3afc043e184a5e0ce5eb7c53aeb1f644...e0335fcdad28da578904bb33fcf1dfbcdf172599,4,93,0,93,5,2011-03-08 20:10:02,2011-02-26 05:09:41
e0335fcdad28da578904bb33fcf1dfbcdf172599...3c624a30fa3f047d401e08cf019d39b3a79095ea,1,13,14,27,13,2011-03-08 20:10:02,2011-02-26 05:10:49
3c624a30fa3f047d401e08cf019d39b3a79095ea...098d0e0e8e7467bea5306d5bc98b283bfe0174fb,2,67,66,133,44,2011-03-08 20:10:03,2011-02-26 05:11:37
098d0e0e8e7467bea5306d5bc98b283bfe0174fb...6578483036695820d05aa7cf482a38169ad321bf,3,28,0,28,3,2011-03-08 20:10:03,2011-02-22 23:41:20
6578483036695820d05aa7cf482a38169ad321bf...bb946bba761288e24b3eb621a3782a4fa804f21d,3,17,1,18,6,2011-03-08 20:10:03,2011-02-22 23:41:21
bb946bba761288e24b3eb621a3782a4fa804f21d...309552295af4b0f2ddd1af15d919441b1744523a,4,26,3,29,5,2011-03-08 20:10:03,2011-02-22 23:41:22
309552295af4b0f2ddd1af15d919441b1744523a...0c9ea33b90f6ed73b9c9151c2cad9ce341d6778b,1,10,2,12,2,2011-03-10 07:50:57,2011-03-10 03:17:58
0c9ea33b90f6ed73b9c9151c2cad9ce341d6778b...cd5513a7168915b31bb5747216473b618c19679e,2,17,0,17,4,2011-03-10 07:52:52,2011-02-22 23:41:23
cd5513a7168915b31bb5747216473b618c19679e...92a684b916edf9e0f4f7962865e62ff71a988445,1,1,0,1,1,2011-03-10 07:52:52,2011-02-25 07:22:12
498a04af143f55a7bbbba484d48a7f123d43be04...cba595bd21fd0731e37898dbd6c5b55f65fd8aea,3,3,3,6,3,2012-03-23 20:52:05,2012-03-22 18:53:24
cba595bd21fd0731e37898dbd6c5b55f65fd8aea...f8582cad8d11cae15e73fe5213b6180ee4b9fcce,2,13,10,23,2,2012-03-23 20:52:13,2012-03-22 18:53:39
f8582cad8d11cae15e73fe5213b6180ee4b9fcce...90d43b07687fdc51d1f2fc14948df538dc45584b,3,12,1,13,5,2012-03-23 20:52:49,2012-03-22 22:52:13
90d43b07687fdc51d1f2fc14948df538dc45584b...4f7cb99ada26be5d86402a6e060f3ee16a672f16,2,17,0,17,2,2012-03-23 20:52:51,2012-03-22 22:52:24
cb2ed324fc917db0b79d7b1f3756575ffa5f70d5...06454cb9a3bd2a34299779b147e388ff0f31c9f7,2,364,33,397,24,2012-04-10 21:34:02,2012-04-07 22:59:20
cb2ed324fc917db0b79d7b1f3756575ffa5f70d5...31558fd48ea5911766781e676504d07eb70eeee5,1,2,2,4,2,2012-04-09 22:06:50,2012-04-07 14:25:52
57cec0aec77eb33bfc1eaaa5fb128f8799bbae43...fa678feb7ca12e306e2eaeb0078028505ab3318a,1,12,21,33,5,2012-03-12 22:59:06,2012-03-12 22:59:06
13ef39663552083235c2773c9aa8414a5be675ee...2b911f818543ae608ea357da8e567f74470f5adf,1,175,169,344,166,2012-03-08 02:20:20,2012-03-08 02:20:20
2b911f818543ae608ea357da8e567f74470f5adf...0eb8fa3a05706ae55e5597d8384c303a00ce1e11,1,3492,0,3492,1,2012-03-08 08:28:35,2010-09-12 20:10:21
0eb8fa3a05706ae55e5597d8384c303a00ce1e11...6874b9edb1a6278e3dbfe5f80030872260f225a8,2,1790,1419,3209,726,2012-03-08 09:56:37,2012-03-08 09:56:37
6874b9edb1a6278e3dbfe5f80030872260f225a8...14c8bced15cb1148f3e3211c10732b1992334784,1,177,169,346,166,2012-03-08 12:55:37,2012-03-08 04:06:53
14c8bced15cb1148f3e3211c10732b1992334784...1aabac6580f9902bddf6d150a4bd2967d15d9ca2,1,1,1,2,1,2012-03-08 16:22:49,2012-03-03 00:34:28
1aabac6580f9902bddf6d150a4bd2967d15d9ca2...6672dc8e694f412090417a95cd6cd4b2b5be6da1,1,1,1,2,1,2012-03-08 16:22:56,2012-03-03 01:03:27
debf29dc2921e12c4fa8205d894741a694f0c4fc...7703477ab9fcb96ee1d2555c85b7499d8c3d69eb,1,1,1,2,1,2012-10-14 04:50:14,2012-10-13 22:32:50
5ae6f5ca2f70bd7d5ca88c20f2be62bf3844af73...791a765e54b9b4c8d2cf4f069222e31cef8aa24e,1,7,2,9,3,2011-05-01 23:29:43,2011-05-01 23:29:43
4b9447f98ef8699450fa0276d212167a25667d7f...0fa920c35c2617d7c1756b1e2bf5c56a81db3232,1,50,39,89,4,2011-04-29 21:21:48,2011-04-29 17:51:59
0fa920c35c2617d7c1756b1e2bf5c56a81db3232...e4e3b32bd2317ab73f03d692ab3f7231e2e6787d,1,16,8,24,4,2011-04-29 21:21:48,2011-04-29 17:52:00
e4e3b32bd2317ab73f03d692ab3f7231e2e6787d...d940c9015d1a770b4f8ed8e9b38cf3d16f47a6cd,4,90,3,93,10,2011-04-29 21:21:48,2011-04-29 17:52:01
0c41f33c19c2f40015e31211557e818b000f9a25...5fb41b883a5d0f9cbc4c6c693e6d84a8a5cee17e,3,6,8,14,4,2011-04-06 17:50:00,2011-04-06 17:49:35
309be813c9b75fed70f3a03bf803bf47c6670cfc...edc54fb5d4ce6774fc2ac76779bd57dc2d6ab189,2,2,2,4,2,2010-12-07 22:25:46,2010-11-11 14:08:03
edc54fb5d4ce6774fc2ac76779bd57dc2d6ab189...979f792951913d75f992f87022b75610303a614f,3,100,3,103,13,2010-12-07 22:25:46,2010-11-28 03:37:32
979f792951913d75f992f87022b75610303a614f...3d6e0f745e5b958387c9116ff5ba6247b990e6e7,2,32,6,38,5,2010-12-09 21:38:05,2010-12-09 21:38:05
0510480510b181216d565ebcedea471d50c200b1...a463aefa353870dd4325ff86ab7da0195521341b,1,4,0,4,1,2011-12-19 20:19:57,2011-12-12 18:09:14
98dbe63dbcb44218e23ccc92e1491c36b2e31945...91cd7e4b426b0dc4755212fcbac3c822499ddd15,1,18,0,18,1,2011-06-30 01:24:40,2011-06-30 00:34:57
91cd7e4b426b0dc4755212fcbac3c822499ddd15...4dca1aa6502a46f8d7b6ecc8e7812c5c23ad0923,2,7,3,10,4,2011-06-30 01:25:49,2011-06-30 00:34:58
af77aee9cac51c2036e6019b4aebec2049f03e6b...c8525c302bfd8c5bc6a7e2f7aec0be2951eefd90,1,66,0,66,1,2010-11-10 17:39:35,2010-11-10 11:17:26
c8525c302bfd8c5bc6a7e2f7aec0be2951eefd90...ac58c4c795455addd0d8f007e969d56e43f1165b,3,16,8,24,6,2010-11-10 17:39:56,2010-11-10 11:17:27
ac58c4c795455addd0d8f007e969d56e43f1165b...e10dfb62ee21a3970ccfe44f30f97fcd6457bb78,1,2,10,12,3,2010-11-10 17:40:18,2010-11-10 11:17:28
e10dfb62ee21a3970ccfe44f30f97fcd6457bb78...81536b2dfae5a2839b6f20b22cc814a3690e4704,1,2,2,4,2,2010-11-10 17:40:34,2010-11-10 11:17:29
81536b2dfae5a2839b6f20b22cc814a3690e4704...3d5854e765dedfaf2a942e8fa1e950a40f9dcee3,2,9,7,16,8,2010-11-10 17:40:35,2010-11-10 11:17:30
af77aee9cac51c2036e6019b4aebec2049f03e6b...f6ce1f25885f3db71935b201c5e3c858eb993f5c,2,26,2,28,3,2010-11-10 16:49:26,2010-10-31 19:59:33
af77aee9cac51c2036e6019b4aebec2049f03e6b...d3d7a421b1439a6f08dfbcd2e3327cbe90c93417,2,47,0,47,3,2010-11-09 17:43:54,2010-11-04 22:36:31
d3d7a421b1439a6f08dfbcd2e3327cbe90c93417...68d5d03bc49a073be3b0e14b22d30d70e7ae686d,2,64,7,71,4,2010-11-09 17:44:19,2010-11-04 22:36:32
af77aee9cac51c2036e6019b4aebec2049f03e6b...dbfdc625a5aad10c47e3ffa446d0b92e341a7b44,1,10,0,10,2,2010-11-09 15:35:16,2010-11-09 02:44:38
af77aee9cac51c2036e6019b4aebec2049f03e6b...ae3cdfe1123d153f720bbe4a4abc97ed3e9f65a4,2,9,4,13,6,2010-11-08 19:39:23,2010-11-07 18:04:58
ae3cdfe1123d153f720bbe4a4abc97ed3e9f65a4...60aa9cf8f370b69eb7feaad2e1cbcd04280bc799,2,7,0,7,2,2010-11-09 17:42:57,2010-11-09 17:12:48
af77aee9cac51c2036e6019b4aebec2049f03e6b...0cb3f80de0d464c0c8a1c2963396bfcdb00dedab,1,1,0,1,1,2010-11-03 19:32:09,2010-05-25 13:44:15
c7deb8dac1f24498a353327ec9fceb99695582c2...1bb28d87e1d8897db662f48455d369860758fbdd,2,2,2,4,2,2010-10-19 21:15:59,2010-10-18 13:11:25
daab4eeafa0dc620d67ccb57c28e08f6f8b3868c...a598ded1e2e9cc9f4ce93d091808b475839e6867,1,2,0,2,2,2011-06-21 21:07:35,2011-06-21 06:41:16
daab4eeafa0dc620d67ccb57c28e08f6f8b3868c...085479e7001b6feb7e9be02e77d84e27be796774,1,1,1,2,1,2011-06-20 20:09:04,2011-06-20 19:31:59
daab4eeafa0dc620d67ccb57c28e08f6f8b3868c...ea2d325b88562a074337a8bd30c37d3405c24fae,2,9,8,17,9,2011-06-20 20:04:49,2011-06-20 18:18:03
daab4eeafa0dc620d67ccb57c28e08f6f8b3868c...588d0e834b244565863fa80e6c48c20e0db9b62f,3,28,12,40,10,2011-06-20 20:00:54,2011-06-20 16:59:28
785ee4960c3d334cbc2b17ab74d2cebdf1b4db64...3f4f4cc0da03b312fabcd5a509baa8092de39534,1,0,9,9,2,2013-01-11 22:57:10,2013-01-11 22:43:42
785ee4960c3d334cbc2b17ab74d2cebdf1b4db64...08ad56f3f0c1df8f75bac84bcef0d9d0c9b4d20f,1,3,1,4,1,2012-10-18 16:40:15,2012-10-18 10:00:12
785ee4960c3d334cbc2b17ab74d2cebdf1b4db64...176943b9658b1fa9ae3972156100d831d19c3576,6,32,4,36,7,2012-09-17 22:24:52,2012-09-17 21:17:58
785ee4960c3d334cbc2b17ab74d2cebdf1b4db64...17bf35a3c7b46df7131681bcc5bee5f12e1caec4,4,96,2,98,7,2012-09-14 17:10:35,2012-09-13 21:21:44
17bf35a3c7b46df7131681bcc5bee5f12e1caec4...208f5aa42615671bae1e55de20a58d9ba046d3e8,1,1,0,1,1,2012-09-14 17:11:44,2012-09-14 09:46:35
208f5aa42615671bae1e55de20a58d9ba046d3e8...13e4fc7e0197ca752cf46674392bf6ef6249e614,1,19,0,19,2,2012-09-14 17:12:56,2012-09-13 23:26:57
13e4fc7e0197ca752cf46674392bf6ef6249e614...a23e3138cb4ddd57e9cbb221e8cbfaf233111d2c,1,18,5,23,4,2012-09-14 17:23:47,2012-09-14 01:54:30
a23e3138cb4ddd57e9cbb221e8cbfaf233111d2c...07a7d656dd550e24e8b9a1802665aa0abba435ee,2,6,3,9,4,2012-09-16 06:35:39,2012-09-15 21:04:36
07a7d656dd550e24e8b9a1802665aa0abba435ee...b327bf74bd631790918d6730404eb97baec267c9,1,18,6,24,6,2012-09-16 06:35:39,2012-09-14 09:46:39
b327bf74bd631790918d6730404eb97baec267c9...dfe3642515d3d2679bdc25c2be4d961201e9f095,1,16,0,16,1,2012-09-16 06:35:40,2012-09-14 09:46:40
dfe3642515d3d2679bdc25c2be4d961201e9f095...00f62a64d489592c97f6f171f9a19fdda530f3c5,1,8,0,8,1,2012-09-16 06:35:40,2012-09-14 09:46:41
00f62a64d489592c97f6f171f9a19fdda530f3c5...2cb03e76a0e65920a0790d5b128fde9185e0e8fe,1,22,16,38,4,2012-09-16 06:35:40,2012-09-14 09:46:42
2cb03e76a0e65920a0790d5b128fde9185e0e8fe...39f2e017203695b9da2ad35589b0e58bcac6fdc8,1,20,0,20,2,2012-09-16 06:35:40,2012-09-14 09:46:43
785ee4960c3d334cbc2b17ab74d2cebdf1b4db64...ffcabccf5df17f12997feedafefeb5589b8c0511,2,16,4,20,3,2012-09-11 01:42:30,2012-09-10 23:30:20
ffcabccf5df17f12997feedafefeb5589b8c0511...9aeaab6811dce596b4f6141d76f5300359bfd009,2,70,25,95,11,2012-09-11 21:30:03,2012-09-11 21:30:03
785ee4960c3d334cbc2b17ab74d2cebdf1b4db64...70c2a258c60583e2650a3a236c532149712c0d14,2,4,5,9,3,2012-09-06 20:26:50,2012-09-06 14:28:03
785ee4960c3d334cbc2b17ab74d2cebdf1b4db64...caae319e49e236205d463de2ecf24ce5aae642ab,1,12,0,12,1,2012-09-04 15:36:33,2012-09-04 15:28:27
caae319e49e236205d463de2ecf24ce5aae642ab...008566e0f8ef9751c43197f40ac08d3bdfce78a7,1,1,1,2,1,2012-09-10 19:59:02,2012-09-10 19:47:38
008566e0f8ef9751c43197f40ac08d3bdfce78a7...8300016e0ab6959c4b45f64ec585832726430fc7,1,17,0,17,1,2012-09-10 19:59:36,2012-09-07 20:49:15
785ee4960c3d334cbc2b17ab74d2cebdf1b4db64...726800a8b3bf3702490a79f0205e33b2a0dbbb64,1,9,9,18,9,2012-08-27 17:49:04,2012-08-27 13:23:37
726800a8b3bf3702490a79f0205e33b2a0dbbb64...e837936c7c08ac5829bc53761ecb57d18d458edd,3,55,54,109,14,2012-08-27 17:49:04,2012-08-27 13:24:31
e837936c7c08ac5829bc53761ecb57d18d458edd...05b577107dda131d46f93aa9bb7817c80bc30ee9,1,1,1,2,1,2012-08-27 17:49:08,2012-08-27 13:24:42
05b577107dda131d46f93aa9bb7817c80bc30ee9...666aae9aed5a29019d2cd696d4258750c0dc96c7,1,7,9,16,4,2012-08-27 17:49:09,2012-08-27 13:25:21
666aae9aed5a29019d2cd696d4258750c0dc96c7...6ac2b3aeb9900a8fb0cd3fd9be0bff00eb3a4b5b,2,25,0,25,4,2012-08-27 17:49:09,2012-08-27 13:25:36
6ac2b3aeb9900a8fb0cd3fd9be0bff00eb3a4b5b...4c71009da60baee436358e84ff1057cd1c80e776,3,28,0,28,3,2012-08-27 17:49:09,2012-08-27 13:25:53
4c71009da60baee436358e84ff1057cd1c80e776...88097030725bf68d1801559cfb4785b93a50f5f8,2,29,23,52,4,2012-08-27 17:49:09,2012-08-27 13:26:04
88097030725bf68d1801559cfb4785b93a50f5f8...b81401c1de0e0fec39f8643ce7a794fda083f7a1,2,16,9,25,5,2012-08-27 17:49:09,2012-08-27 13:27:15
785ee4960c3d334cbc2b17ab74d2cebdf1b4db64...c70c09b6fc9339cba64d5ddd4698a2a3ef754dcd,1,1,1,2,1,2012-08-17 20:25:43,2012-08-17 19:14:57
785ee4960c3d334cbc2b17ab74d2cebdf1b4db64...d9aa3610437e8cfab86fe3d1e3433400de15773d,1,1,0,1,1,2012-08-17 07:26:52,2012-08-16 09:50:18
785ee4960c3d334cbc2b17ab74d2cebdf1b4db64...9c81990bdd9277dc791914c1db7dfadbe3592d3a,1,8,0,8,1,2012-08-17 06:16:28,2012-08-17 06:16:22
785ee4960c3d334cbc2b17ab74d2cebdf1b4db64...cacfc09ba82bfc6b0e1c047247785d56a6054b2f,1,5,0,5,1,2012-08-15 18:47:43,2012-08-09 02:29:26
785ee4960c3d334cbc2b17ab74d2cebdf1b4db64...1af221ef5cb84c792303a0d16ca91197e2b70279,1,1,2,3,2,2012-08-10 16:41:28,2012-08-10 06:51:19
785ee4960c3d334cbc2b17ab74d2cebdf1b4db64...9409c7a5b33d6a4d68f58ccb1034fa50c92cac68,3,11,6,17,8,2012-07-30 15:51:26,2012-07-29 20:43:21
785ee4960c3d334cbc2b17ab74d2cebdf1b4db64...6eafa6d096ce6b0ae20e4c0fbb248958559daf64,2,17,2,19,2,2012-07-12 18:14:40,2012-07-12 17:45:32
785ee4960c3d334cbc2b17ab74d2cebdf1b4db64...5a45c0cafe6d73f6026bd0ea525da2f9765b112d,1,7,14,21,7,2012-07-05 22:22:45,2012-07-04 02:47:24
5a45c0cafe6d73f6026bd0ea525da2f9765b112d...3d1110aa72e4427e82e70563f734c74cd08fe98e,1,1,1,2,1,2012-07-05 22:23:35,2012-07-04 02:47:25
3d1110aa72e4427e82e70563f734c74cd08fe98e...66c857e1aec14e5049dbef659369f140ef220ae4,1,10,0,10,1,2012-07-05 22:29:12,2012-07-04 02:47:26
785ee4960c3d334cbc2b17ab74d2cebdf1b4db64...5742c82ba76b6526639f08b5c7554fd15271087e,1,3,0,3,1,2012-07-03 19:29:42,2012-07-03 18:04:39
785ee4960c3d334cbc2b17ab74d2cebdf1b4db64...0ec4b1650ccac48513f8cfb00d0778ba1d3e8fca,2,11,3,14,3,2012-06-22 21:16:34,2012-06-22 09:35:47
785ee4960c3d334cbc2b17ab74d2cebdf1b4db64...546e0fd9e918b2ea3d9943124641d3b6af59a4fe,4,39,22,61,8,2012-06-22 17:20:18,2012-06-21 18:09:50
546e0fd9e918b2ea3d9943124641d3b6af59a4fe...304970dd5d9e542e70eca98932c1e9f26770678e,2,73,2,75,3,2012-06-22 17:26:13,2012-06-21 18:09:51
fe77b416c774a469a585c4b58fcae5e7a5f3545d...317d74be690f68748e8af9844407db3b100d836f,1,4,1,5,1,2012-06-12 14:48:40,2012-06-11 17:51:47
3fe4498197ced84886b4adaddf18f1109b477f8e...4bee958479bed1d3a8f20a75f33422ee49939dbf,5,16,0,16,6,2012-08-06 16:59:53,2012-08-02 10:38:51
3fe4498197ced84886b4adaddf18f1109b477f8e...83c750acde6ac5847845f9c2eeb3261cf9cc54bc,4,235,3,238,8,2012-06-14 17:15:19,2012-06-05 20:21:24
83c750acde6ac5847845f9c2eeb3261cf9cc54bc...708192637e7d48bfff49c08cdd7cd6e4b052ac32,1,372,0,372,1,2012-06-14 17:15:19,2012-06-05 20:21:25
708192637e7d48bfff49c08cdd7cd6e4b052ac32...96b0ec1a4c3cafd17bc397c9ac836950c316dab6,3,74,7,81,10,2012-06-14 17:15:19,2012-06-05 20:21:26
96b0ec1a4c3cafd17bc397c9ac836950c316dab6...2d1ccebae41541946ddd7e32f291f3c8983feea9,2,329,0,329,4,2012-06-14 17:15:20,2012-06-10 11:17:38
3fe4498197ced84886b4adaddf18f1109b477f8e...e8320f350f523c3219ff8ec639663193941af57d,3,0,29,29,4,2012-06-05 16:38:00,2012-06-05 08:56:04
3fe4498197ced84886b4adaddf18f1109b477f8e...8c3710fd3011d75b9768749bfaf5ac2f31b96085,1,10,6,16,1,2012-06-04 23:24:49,2012-06-04 18:51:13
4fed4c809a9ed73c7147ad33f14eacc82700f41e...bf5cf766af62e4ee34b1217c6351c6fc48eaf255,1,17,0,17,2,2012-02-10 22:04:20,2012-02-10 22:04:20
dc347e9f6a2c106bb684d93dfbc38e3f3df2795b...12766861cdf10fbbfda1023fd65aaf864eb8136a,1,12,1,13,4,2012-02-07 21:01:56,2012-02-07 21:01:56
6e06367ab0586189940a7f08c394d13fce14e87f...bddcefc6380bd6629f3f12b5ffd856ec436c6abd,2,2,10,12,3,2012-01-18 23:53:35,2012-01-18 23:53:35
bddcefc6380bd6629f3f12b5ffd856ec436c6abd...69204d0ab18d28d07ee2c8c9b50bbf5bd80343ab,1,1,1,2,1,2012-01-23 18:11:13,2012-01-23 12:09:58
f526d120f649ec4426b559e94e09655b5a4f2b87...9332441d8e33c3ff9900c8ddd48440846d099020,1,13,0,13,2,2010-06-27 18:32:43,2010-05-14 18:26:50
9332441d8e33c3ff9900c8ddd48440846d099020...52663475a97ecf15b52bee742f3c3a864f3e5fff,1,3,1,4,1,2010-06-27 18:32:43,2010-05-14 18:26:51
c9667456d201c435af523ffb7d583efd1784232a...092c433407279219cb21819d971da0fbf4a60dcd,1,3,1,4,1,2010-08-02 18:53:48,2010-07-31 16:40:05
092c433407279219cb21819d971da0fbf4a60dcd...d596f33abba4e6ba15a13335a26a68a2c1b7ef7d,1,0,3,3,1,2010-08-02 18:53:52,2010-07-31 16:49:53
869d58813b24c74e84c9388041eafcef40cb51e4...41f556b947ef5a161aaa791a865242d9bd8e5610,1,6,5,11,5,2010-07-06 06:22:52,2010-07-06 05:16:15
41f556b947ef5a161aaa791a865242d9bd8e5610...57f2b6b25868e32a25181b2a345b5bab3e3ba78f,2,23,5,28,6,2010-07-06 06:23:37,2010-07-06 06:08:36
2543d9b609d158f611e317738644e67cacac6b9a...e53e6b4433f264250c2e586167caf61721b0185c,1,10,2,12,2,2010-06-18 15:06:18,2010-06-11 02:59:07
2543d9b609d158f611e317738644e67cacac6b9a...cf6aef803df93343e628e0c273a5d8f0d2f0fddb,1,0,0,0,0,2010-06-11 20:33:15,2010-06-08 16:31:25
cf6aef803df93343e628e0c273a5d8f0d2f0fddb...dd44d419d30afa52b863efa07aeec738c4531ea9,6,118,6,124,11,2010-06-11 20:33:17,2010-06-08 16:31:51
dd44d419d30afa52b863efa07aeec738c4531ea9...6ed7ddaadba9217b794aecf6d74a2e455daf7a96,2,13,13,26,13,2010-06-25 17:54:04,2010-06-25 17:20:48
2543d9b609d158f611e317738644e67cacac6b9a...f4c2eb8b34571e645336484d2b444261a535faea,1,1,0,1,1,2010-06-11 16:05:34,2010-06-10 08:59:52
f4c2eb8b34571e645336484d2b444261a535faea...0d4dbcd35e89a549055e34daf410e4579571b984,1,6,0,6,1,2010-06-11 20:49:28,2010-06-10 18:24:46
2543d9b609d158f611e317738644e67cacac6b9a...b096374f4a2cec0403378c1e9b4fb5fe37b517f4,2,12,1,13,3,2010-06-11 16:01:51,2010-06-08 08:16:11
2543d9b609d158f611e317738644e67cacac6b9a...f197ed2fbeb2868c3514ad35bf986a3aa60285f0,1,7,0,7,2,2010-06-11 15:55:57,2010-06-07 00:41:46
2543d9b609d158f611e317738644e67cacac6b9a...cddb42d2c58a9de9b2b5ef68817778e7afaace3e,2,33,0,33,3,2010-06-11 15:44:13,2010-06-01 01:43:35
0c72cead8435b2865efc884060bd0bd49313cbd5...e7b082a4118d15e901f4f44b067394b314a0ae6a,2,16,0,16,2,2010-07-07 18:23:17,2010-07-03 02:55:06
993297717341ef7613ce21d34a9a6b475ed1a67b...e0ae1e6f4d53c68bd219385f6f309c033d0fc673,2,3,3,6,3,2010-06-21 18:18:54,2010-06-21 18:18:54
b5e233ecc411c8685463333d180a135c6866c50e...6e2a09d24b2634cdfec3395122cd4a07eb517b0d,2,8,0,8,2,2010-08-12 20:26:05,2010-08-12 14:18:12
6e2a09d24b2634cdfec3395122cd4a07eb517b0d...0d1d6e50cf3401874b50b77aa1dc0e33357a1556,1,1,1,2,1,2010-08-12 22:35:04,2010-08-12 20:55:54
0d1d6e50cf3401874b50b77aa1dc0e33357a1556...987460611ab08ebac83ead9a5ee316d3b3823e7f,4,10,10,20,6,2010-08-12 22:44:51,2010-08-12 22:11:15
987460611ab08ebac83ead9a5ee316d3b3823e7f...452c6d506b1a6dcf24d4ceaa592afc39c1c1a60e,1,2,2,4,1,2010-08-13 01:06:07,2010-08-02 13:42:44
cc24a1d809c75f0b6e5b1e56134b5127196bb2fb...60890cc60ccfc7000791a47f1f3d69fdb8884dd7,1,3,3,6,3,2010-05-20 23:11:06,2010-05-20 18:57:51
60890cc60ccfc7000791a47f1f3d69fdb8884dd7...fc012c2810c237dd2299a3fc85b18c2beb60b730,2,3,1,4,2,2010-05-20 23:11:29,2010-05-20 18:57:52
fc012c2810c237dd2299a3fc85b18c2beb60b730...c8b296450e5148c576697ea4709072b7855aacd5,3,29,3,32,5,2010-05-20 23:12:13,2010-05-20 18:57:53
f696543dad6c7ba27b0c4fab167a5687263a9ba0...6b37dff17f176d7e87efa93b4cf521dd725de247,4,42,7,49,8,2011-11-07 16:43:11,2011-11-06 09:50:10
f696543dad6c7ba27b0c4fab167a5687263a9ba0...6f9dd67ffea3e86276a73e522ce1186a99bbe65d,1,3,3,6,3,2011-11-04 17:46:25,2011-11-04 14:19:25
6f9dd67ffea3e86276a73e522ce1186a99bbe65d...eb56c82163487fe07ba04f2b365a557282cbd766,1,18,2,20,2,2011-11-04 17:46:56,2011-11-04 14:19:26
eb56c82163487fe07ba04f2b365a557282cbd766...df26c471278f13ca6ad96b12a533ef4172323c13,2,1,16,17,8,2011-11-04 17:47:13,2011-11-04 14:19:27
df26c471278f13ca6ad96b12a533ef4172323c13...093c44a3600323c3ca7a8d28a0d2ba2bc145dd47,2,0,7,7,7,2011-11-04 19:05:01,2011-11-04 17:53:33
f696543dad6c7ba27b0c4fab167a5687263a9ba0...e3eed7f8d238e895922851315447f5df9c475f11,2,13,3,16,3,2011-11-02 20:06:30,2011-11-02 15:46:22
e3eed7f8d238e895922851315447f5df9c475f11...97000ba6e21d25581222e11c36db4bb88c05adcd,1,2,0,2,1,2011-11-06 06:10:24,2011-11-05 15:37:34
97000ba6e21d25581222e11c36db4bb88c05adcd...ebaa1bd407745c4b4c1c0f20c322929fc4371467,1,31,10,41,9,2011-11-06 06:10:43,2011-11-02 15:46:23
f696543dad6c7ba27b0c4fab167a5687263a9ba0...a80b263e37fd06f3f6335c07493541070631d10e,1,3,1,4,1,2011-10-26 21:03:58,2011-10-25 17:15:20
f696543dad6c7ba27b0c4fab167a5687263a9ba0...e9ee84cf28b6c7e5079ab3c020c86a44900a3f46,1,63,34,97,9,2011-10-13 22:12:02,2011-10-13 22:12:02
e9ee84cf28b6c7e5079ab3c020c86a44900a3f46...2727b71f0547f5181653940d279854e7924788fb,3,33,9,42,8,2011-10-13 22:50:21,2011-10-13 22:19:31
f696543dad6c7ba27b0c4fab167a5687263a9ba0...2548183badb98d62079beea62f9d2e1f47e99902,2,9,7,16,3,2011-10-08 00:54:04,2011-10-06 16:06:09
f696543dad6c7ba27b0c4fab167a5687263a9ba0...9fa8aecdebf6339ad4f897ee45f36192fd75325e,2,24,2,26,3,2011-10-06 23:56:34,2011-10-06 17:48:35
9fa8aecdebf6339ad4f897ee45f36192fd75325e...82352cb633f30fef9dd837235c328890da12930e,1,7,5,12,3,2011-10-06 23:56:49,2011-10-06 17:58:01
f696543dad6c7ba27b0c4fab167a5687263a9ba0...089d82e8a6d6443e10052f04c469e9e70784eb93,1,37,0,37,7,2011-10-03 22:38:07,2011-10-03 19:13:28
f696543dad6c7ba27b0c4fab167a5687263a9ba0...8a55caa8a3d9169ba14861b8917e739a50a322fa,2,61,15,76,4,2011-10-03 19:00:44,2011-10-03 06:16:33
8a55caa8a3d9169ba14861b8917e739a50a322fa...d855e4d35de214e651a62909de96d54915273665,1,8,8,16,6,2011-10-06 18:16:16,2011-10-06 17:17:19
f696543dad6c7ba27b0c4fab167a5687263a9ba0...c37c004b0e22806fd976abe5ece800656af2653e,1,21,58,79,8,2011-10-03 18:43:04,2011-10-01 16:36:14
c37c004b0e22806fd976abe5ece800656af2653e...32ec23162e9c77f4648cf0bdc7b3a60ac7f00929,1,1,0,1,1,2011-10-03 18:44:03,2011-10-01 16:39:58
f696543dad6c7ba27b0c4fab167a5687263a9ba0...83933c9832af91a71337e429a6251f1a3b6d6f60,1,5,2,7,3,2011-10-03 18:02:25,2011-10-01 15:38:34
83933c9832af91a71337e429a6251f1a3b6d6f60...26c3177ee41897af984fac9148763131562accf2,2,9,3,12,3,2011-10-03 18:02:56,2011-10-01 15:43:52
26c3177ee41897af984fac9148763131562accf2...468224e580aeb55bd85b37b86f32baada3d17f1e,1,12,27,39,5,2011-10-03 18:03:41,2011-10-01 15:51:39
f696543dad6c7ba27b0c4fab167a5687263a9ba0...480f062cecdd4f662b1d2ed5d497b6f458974b22,2,71,5,76,6,2011-10-03 17:47:07,2011-10-02 00:44:17
f696543dad6c7ba27b0c4fab167a5687263a9ba0...5e82123197229d823a5838126dce20f33f82fe27,1,2,2,4,2,2011-09-26 17:00:44,2011-09-25 23:09:15
f696543dad6c7ba27b0c4fab167a5687263a9ba0...17d26a4d0485229c24b649013a40d5928ba223cc,2,25,3,28,6,2011-09-22 18:35:44,2011-09-22 11:24:22
17d26a4d0485229c24b649013a40d5928ba223cc...a7bc906f2e64f0d9d3fec91964dc38e390ef69a1,1,6,1,7,2,2011-09-22 18:35:48,2011-09-22 11:24:23
f696543dad6c7ba27b0c4fab167a5687263a9ba0...b9ab810b1826a7757e16f152faf0c28c2fdaa679,1,6,4,10,6,2011-09-22 16:35:07,2011-09-21 12:42:22
f696543dad6c7ba27b0c4fab167a5687263a9ba0...6f90969ba88ab862806e58abc6b7047afbc64d27,3,7,1,8,7,2011-09-21 22:05:53,2011-09-21 07:48:36
6f90969ba88ab862806e58abc6b7047afbc64d27...cc1a2b66e9c28ab77ceb122e21222d9c08228259,1,20,20,40,13,2011-09-21 22:05:53,2011-09-21 07:48:37
cc1a2b66e9c28ab77ceb122e21222d9c08228259...1f1f575ebe194d2711f70bf7fc4e1ad9ae136112,1,4,4,8,2,2011-09-21 22:05:53,2011-09-21 07:48:38
f696543dad6c7ba27b0c4fab167a5687263a9ba0...6099835c1900876c813be6114ff4e81f6d90e8a3,2,14,11,25,6,2011-09-15 23:52:43,2011-09-07 18:16:03
f696543dad6c7ba27b0c4fab167a5687263a9ba0...ee646eb48f9a7fc6c225facf2b7449a8a65ef8f2,2,29,11,40,6,2011-09-12 23:49:14,2011-09-09 10:10:33
f696543dad6c7ba27b0c4fab167a5687263a9ba0...6859de45a94ec0e88703250d9d4df64a09042333,1,72,5,77,8,2011-09-12 21:16:41,2011-09-12 19:56:52
f696543dad6c7ba27b0c4fab167a5687263a9ba0...18322badc2b3b7f49f79da5273e003e9c0c4f549,2,13,6,19,3,2011-09-09 20:59:20,2011-09-09 18:22:03
f696543dad6c7ba27b0c4fab167a5687263a9ba0...5bdf0a8468efd55cf8f13cafdb946c0ade3372fe,1,20,17,37,4,2011-09-07 18:47:43,2011-09-07 10:37:47
f696543dad6c7ba27b0c4fab167a5687263a9ba0...8c74ef1e972df2aebc403ee807992017e9cc6838,1,5,4,9,5,2011-08-29 22:54:54,2011-08-29 21:16:12
f696543dad6c7ba27b0c4fab167a5687263a9ba0...2842c0f914f7c05401c449db9d01276ac5a743f0,2,34,6,40,8,2011-08-29 21:32:04,2011-08-29 19:26:05
2842c0f914f7c05401c449db9d01276ac5a743f0...40e372563cfbcce4380820ae03e872f09fa25327,2,3,0,3,3,2011-08-29 22:08:31,2011-08-29 19:31:06
40e372563cfbcce4380820ae03e872f09fa25327...2f88c19700feb8db8f116f94bf558e61c82d543c,1,1,0,1,1,2011-08-29 22:09:17,2011-08-29 20:34:08
f696543dad6c7ba27b0c4fab167a5687263a9ba0...dbc92b072dd7023f8ba1f682a8060022fc72504a,2,39,8,47,9,2011-08-23 01:57:20,2011-08-23 01:05:15
dbc92b072dd7023f8ba1f682a8060022fc72504a...e6baf4a1ae1bb75d59967066ade1290cf105dcd8,3,78,25,103,13,2011-08-23 16:56:14,2011-08-23 01:05:16
f696543dad6c7ba27b0c4fab167a5687263a9ba0...13d6ec913330ba90fb1a67ec5789e437f8ac4193,7,11,11,22,11,2011-08-22 21:04:56,2011-08-22 21:04:56
13d6ec913330ba90fb1a67ec5789e437f8ac4193...9b0ebc722cfc12bd14934aab5cf77ebe654e36e6,2,22,1,23,3,2011-08-22 21:20:11,2011-08-21 11:58:09
f696543dad6c7ba27b0c4fab167a5687263a9ba0...06bb643b72cc6c67d7c0ac9b8d923463bae68822,1,45,42,87,36,2011-08-19 18:58:18,2011-08-19 18:58:18
f696543dad6c7ba27b0c4fab167a5687263a9ba0...594ffe80e7827b20335c5c6dde2cf57c9919db68,1,3,3,6,3,2011-08-18 17:58:19,2011-08-18 12:29:34
594ffe80e7827b20335c5c6dde2cf57c9919db68...09d46644b780ede1a6b757db3e1a1ae9c1128a13,2,10,0,10,3,2011-08-18 18:00:14,2011-08-18 12:29:35
09d46644b780ede1a6b757db3e1a1ae9c1128a13...294e15fc19b5ba370b703d003920d000a4f5547a,3,30,19,49,3,2011-08-18 18:01:18,2011-08-18 12:29:36
294e15fc19b5ba370b703d003920d000a4f5547a...76f5df305beddb864b3d1d12800d0de442d05596,1,12,0,12,4,2011-08-18 18:03:32,2011-08-18 12:29:37
76f5df305beddb864b3d1d12800d0de442d05596...5267d292ecbdc91018db05275ec6057d2c4cfa18,1,15,1,16,2,2011-08-19 18:12:10,2011-08-19 12:43:50
5267d292ecbdc91018db05275ec6057d2c4cfa18...b9ad500262843c6110968da1f4e7b6717bc71303,1,2,0,2,1,2011-08-26 02:47:24,2011-08-25 15:09:30
f696543dad6c7ba27b0c4fab167a5687263a9ba0...131d6afcba657f9348031ee2e20f62d25d69ce7a,4,53,7,60,8,2011-07-24 23:22:21,2011-07-24 22:29:18
f696543dad6c7ba27b0c4fab167a5687263a9ba0...6c1c14480ddf912fca5e09a6a7e66dee7793d2ea,1,24,0,24,1,2011-07-24 18:48:24,2011-07-24 14:59:13
6c1c14480ddf912fca5e09a6a7e66dee7793d2ea...04f89259a67ba1ec291f023b70278d41ed665a13,2,2,4,6,2,2011-07-25 17:50:11,2011-07-24 14:59:14
f696543dad6c7ba27b0c4fab167a5687263a9ba0...452f4fa51e1fd1d0e3155fb4f4d8913298ac63a6,1,3,7,10,4,2011-07-07 16:36:44,2011-07-07 04:23:55
452f4fa51e1fd1d0e3155fb4f4d8913298ac63a6...159607a8f1ad16c0a04e0f17d5f8a35299696bc6,1,32,59,91,9,2011-07-07 16:37:21,2011-07-07 04:23:56
159607a8f1ad16c0a04e0f17d5f8a35299696bc6...1d26b252f1128f7b31885811d7f481b6b7612bd7,3,35,25,60,6,2011-07-07 16:41:24,2011-07-07 04:23:57
1d26b252f1128f7b31885811d7f481b6b7612bd7...46c8f2988dc9a6012babd5833a6245ceff214483,2,168,159,327,4,2011-07-07 16:41:48,2011-07-07 04:23:58
46c8f2988dc9a6012babd5833a6245ceff214483...8c912eea94a2138e8bc608f7c390eb0b313effb0,8,407,1,408,8,2011-07-12 16:29:20,2011-07-12 06:10:25
8c912eea94a2138e8bc608f7c390eb0b313effb0...9f37c275938e1fbca7165872dad039874add09cd,1,16,8,24,5,2011-07-12 16:29:39,2011-07-12 06:10:26
9f37c275938e1fbca7165872dad039874add09cd...86abba801575892a8a2b161aa29518c1ed05e1f1,3,17,10,27,7,2011-07-12 16:30:00,2011-07-12 06:10:27
86abba801575892a8a2b161aa29518c1ed05e1f1...286e2b1a23d523b04c29f92eb5cee31a0a92dc12,1,0,0,0,0,2011-08-03 17:14:50,2011-08-03 07:25:31
286e2b1a23d523b04c29f92eb5cee31a0a92dc12...739864b1ffb379120df9cfa4111c4ec20b823cfd,3,2,20,22,4,2011-08-03 17:15:16,2011-08-01 04:20:07
739864b1ffb379120df9cfa4111c4ec20b823cfd...19f7a9c57785161cdfaa6036eb0ef90853333724,1,9,6,15,4,2011-08-08 20:00:17,2011-08-01 04:20:08
19f7a9c57785161cdfaa6036eb0ef90853333724...43ca7530df839321cc4f62b54a0098f2a1cfb4ad,1,4,27,31,4,2011-08-08 20:00:17,2011-08-01 04:20:09
43ca7530df839321cc4f62b54a0098f2a1cfb4ad...6486a84cb8e69ddf03b2139db3d968400e05f5b3,1,4,5,9,1,2011-08-08 20:00:17,2011-08-01 04:20:10
f696543dad6c7ba27b0c4fab167a5687263a9ba0...7791a1d9b9a4f4e15662c7c9c7f5837f461bb987,93,92,6,98,96,2011-07-06 21:26:26,2011-07-02 02:38:26
f696543dad6c7ba27b0c4fab167a5687263a9ba0...555bdc66eab0178d43c509ec53c1d97303675f90,1,33,0,33,1,2011-06-28 03:26:06,2011-06-18 06:47:58
555bdc66eab0178d43c509ec53c1d97303675f90...eabd73a3b587615ca60e820dfa1b8802d1659db3,1,2,2,4,2,2011-06-28 03:26:08,2011-06-18 06:47:59
eabd73a3b587615ca60e820dfa1b8802d1659db3...124b70a2adad2b2efdf50150a6840f1327d2f2cd,2,7,3,10,2,2011-06-28 03:26:11,2011-06-18 06:48:00
f696543dad6c7ba27b0c4fab167a5687263a9ba0...db61f060be5bc00cc9a44df694bac4ee4b65d02d,1,25,21,46,2,2011-06-27 09:11:41,2011-06-23 19:55:00
db61f060be5bc00cc9a44df694bac4ee4b65d02d...48bf76ca93c7569660712c12b3c4f86c60803352,1,2,2,4,2,2011-06-27 09:11:41,2011-06-23 19:56:37
48bf76ca93c7569660712c12b3c4f86c60803352...c0175f92c7da1c379c25b5a70d53b9d550bcc11d,1,20,7,27,5,2011-06-27 09:11:41,2011-06-23 20:59:26
c0175f92c7da1c379c25b5a70d53b9d550bcc11d...5ad6d387f19d9dd28b323f5cfea8663cb7b74617,2,11,4,15,4,2011-06-27 09:11:41,2011-06-23 21:01:03
406da7803217998ff6bf5dc69c55b1613556c2f4...5ba9b5e7e34459b9249816d5d9a868f08f2bfa7c,1,1,0,1,1,2012-04-22 05:18:44,2012-04-21 21:15:19
406da7803217998ff6bf5dc69c55b1613556c2f4...e5b06629de847663aaf0f7daae8de81338da3901,1,0,5,5,1,2012-02-19 22:32:25,2012-02-19 22:32:25
e5b06629de847663aaf0f7daae8de81338da3901...307ab20b333d9b4c818b1ff912e86944d1a3fdc1,8,24,20,44,17,2012-02-19 23:36:55,2012-02-19 23:36:55
406da7803217998ff6bf5dc69c55b1613556c2f4...cd4c4e2481dd6fcb7ceb39242fa722993f8c0ab1,2,0,12,12,4,2012-02-06 00:32:33,2012-02-05 22:32:21
406da7803217998ff6bf5dc69c55b1613556c2f4...b3256eb8b35937192e85725d0c2bcb422295790c,5,109,5,114,8,2012-02-03 00:41:55,2012-02-02 21:59:13
406da7803217998ff6bf5dc69c55b1613556c2f4...aae5239be2b41477e8dc515f4fa372be2025e70a,1,3,3,6,1,2012-01-22 22:55:16,2011-09-03 20:41:21
406da7803217998ff6bf5dc69c55b1613556c2f4...168c1e012030c65f2c1bcdd56a6ec77e37e5a743,1,1,0,1,1,2011-12-19 03:44:51,2011-12-17 09:22:21
168c1e012030c65f2c1bcdd56a6ec77e37e5a743...5d7910569b2caeb65354d17b26359cb235026b39,1,2,1,3,2,2011-12-19 03:44:51,2011-12-17 09:22:22
5d7910569b2caeb65354d17b26359cb235026b39...57cf4ad6e82af6aaa38bb215ea35ea9c465c6045,1,3,1,4,1,2011-12-19 03:44:52,2011-12-17 09:22:23
57cf4ad6e82af6aaa38bb215ea35ea9c465c6045...b13e3eacefc0fb6f4f89738f74ba5ef14437bed5,1,2,2,4,1,2011-12-19 20:25:43,2011-12-18 22:00:58
406da7803217998ff6bf5dc69c55b1613556c2f4...6b3c4c05475d206fafd650d8d27c82a8b051ac30,1,4,2,6,2,2011-12-15 18:26:40,2011-12-15 13:47:21
6b3c4c05475d206fafd650d8d27c82a8b051ac30...13f8b72d8c8e24215a3dd7771592b30083f1c740,9,20,15,35,16,2011-12-15 18:46:42,2011-12-15 13:47:22
13f8b72d8c8e24215a3dd7771592b30083f1c740...37576c14439a4dfa43bec5a5c953fea1cc436bbf,2,9,0,9,2,2011-12-15 19:35:10,2011-12-15 13:47:23
406da7803217998ff6bf5dc69c55b1613556c2f4...1aed2fe394f45fed7b97e268cfa11d25c3d8da27,3,19,0,19,3,2011-12-06 22:52:18,2011-12-06 17:43:35
1aed2fe394f45fed7b97e268cfa11d25c3d8da27...4eb0346fb8f8a59a1fb7a6bd01154655a7020087,1,95,0,95,1,2011-12-06 22:53:13,2011-12-06 17:43:36
4eb0346fb8f8a59a1fb7a6bd01154655a7020087...996277c520641d650dc15ad751cc4ad33318e298,5,21,11,32,10,2011-12-06 22:57:36,2011-12-06 17:43:37
996277c520641d650dc15ad751cc4ad33318e298...11c8a74a64a49f236d475514f723123a8928463d,2,3,1,4,3,2011-12-06 22:58:53,2011-12-06 17:43:38
11c8a74a64a49f236d475514f723123a8928463d...6c52ec8a9ab48b50fc8bf9559467d5a4cf7eee3b,2,9,2,11,4,2011-12-06 23:13:39,2011-12-06 17:43:39
0b92f1a9d213644d2cd6c1870091c090a6b7eca9...fc61e313da0a124e9f6a213cd76944a8c4e6c918,1,2,0,2,1,2006-10-22 19:15:55,2006-10-21 18:51:04
fc61e313da0a124e9f6a213cd76944a8c4e6c918...5ea0921cbeb248a6505c32601ad841f706f942fd,1,1,1,2,1,2006-10-22 19:26:21,2006-10-22 11:30:24
5ea0921cbeb248a6505c32601ad841f706f942fd...e7fb022a42a83cbdb33e40f82ffca28eceb423c9,1,30,30,60,14,2006-10-22 19:56:41,2006-10-21 15:52:19
e7fb022a42a83cbdb33e40f82ffca28eceb423c9...300454feaba846b6bf95625c607d7096d81d26eb,1,6,3,9,3,2006-10-22 20:24:37,2006-10-21 15:53:09
300454feaba846b6bf95625c607d7096d81d26eb...474a90fef9ebcdedee041b2def4b9a98b94cd146,1,4,1,5,1,2006-10-22 23:38:32,2006-10-22 18:46:36
474a90fef9ebcdedee041b2def4b9a98b94cd146...2eb53e65bd9cdd3b76a6447a1a51dee6e5de96a3,3,8,6,14,7,2006-10-22 23:39:58,2006-10-22 23:01:23
2eb53e65bd9cdd3b76a6447a1a51dee6e5de96a3...0abc0260fa3419de649fcc1444e3d256a17ca6c7,1,1,1,2,1,2006-10-23 03:28:10,2006-10-23 03:28:10
4035b46e12ee6e5c9339e263cd16c2e2422b8928...ce91fc6eb9c4aefc73f845fc7104f332b2b308d2,1,2,2,4,2,2006-10-14 18:48:33,2006-10-14 09:02:37
ce91fc6eb9c4aefc73f845fc7104f332b2b308d2...abdc3fc84216a9334f40f3b7ce13e20a825697d0,5,22,34,56,13,2006-10-14 18:49:52,2006-10-14 10:45:36
abdc3fc84216a9334f40f3b7ce13e20a825697d0...8f9777801d09b195e1820061914ec27fcd5975c8,2,3,12,15,2,2006-10-14 18:49:59,2006-10-14 10:45:45
8f9777801d09b195e1820061914ec27fcd5975c8...6844fc806ace7d7c31ad788a8886cfd0498ceec5,1,2,1,3,1,2006-10-14 19:07:05,2006-10-14 14:05:25
6844fc806ace7d7c31ad788a8886cfd0498ceec5...f7197dff15a3ab12ce59626865c5a388a3bb0976,1,4,2,6,2,2006-10-15 00:38:52,2006-10-14 22:48:35
f7197dff15a3ab12ce59626865c5a388a3bb0976...0a7a9a12d65ca75601f841c93222652f41de09c0,1,51,12,63,7,2006-10-15 01:19:12,2006-10-10 22:20:43
0a7a9a12d65ca75601f841c93222652f41de09c0...d988b82232bb8f5826a1619fd4dcba1a5a330f27,1,1,1,2,1,2006-10-15 01:19:13,2006-10-10 22:33:28
d988b82232bb8f5826a1619fd4dcba1a5a330f27...ced78b3907dd60d8289ad5385ffcfd3339149957,2,7,1,8,2,2006-10-15 01:22:04,2006-10-14 12:02:51
4035b46e12ee6e5c9339e263cd16c2e2422b8928...74e2abe5b70aadf06984472ba9aa9a29900040e6,4,47,12,59,14,2006-10-14 04:37:10,2006-10-12 10:01:00
af70fa4f48fdb12fef49c8bf2abc507f80081bf3...35f401a6706238b16906666b72e207e807e71f8a,1,4,7,11,4,2006-10-26 09:16:30,2006-10-26 08:50:20
35f401a6706238b16906666b72e207e807e71f8a...543551e53a8f8e52e72571e1f24f81d7f6598f9b,1,7,7,14,7,2006-10-27 01:30:56,2006-10-26 14:17:24
01cff2d2ca77dc050973e1fc4702119a715cc919...b8077709243138c3d8cc1c096c06a95b250a9001,2,61,6,67,11,2006-10-29 21:45:03,2006-10-29 09:41:59
b8077709243138c3d8cc1c096c06a95b250a9001...861ed12106d7f8e65b90c8a5ed4a026cd71a044d,1,2,5,7,4,2006-10-31 03:12:29,2006-10-30 22:34:50
c954d33da1c878788e7c01a50a5c1066622802c6...241cc599b342663877a8f468513c77518c94d96f,1,26,33,59,3,2006-11-03 07:11:31,2006-10-31 16:36:27
241cc599b342663877a8f468513c77518c94d96f...6255ef08ae746bdad34851297a989ad6f36f6a21,1,8,3,11,5,2006-11-03 07:13:37,2006-11-01 13:33:21
94d5ca8d0c7b2a4714da6dd2824e2d21a16d5a85...98526e007e293700fa578da9a0a4459d6b5375b0,1,4,5,9,4,2006-11-05 07:33:13,2006-11-05 05:51:10
98526e007e293700fa578da9a0a4459d6b5375b0...b2e2ddfed8006590bc5b8f4f2a22046891958f28,1,1,1,2,1,2006-11-05 07:33:21,2006-11-05 05:51:11
2c71810b90d122abdcc57fc3cb62174d16e77b58...567a03d14cb624b0edc76be9cffda11edac2bea3,1,34,16,50,18,2006-08-10 07:30:33,2006-08-10 07:30:33
567a03d14cb624b0edc76be9cffda11edac2bea3...306ea2df03322ac8c29f4eb5a968acb7ef3c8f72,1,1,0,1,1,2006-08-10 07:50:15,2006-08-10 07:50:15
306ea2df03322ac8c29f4eb5a968acb7ef3c8f72...242abf106c6929028c2dc916504879885cd64d4d,1,1,3,4,2,2006-08-10 07:56:40,2006-08-10 07:56:40
242abf106c6929028c2dc916504879885cd64d4d...83a2b841d6b90e6f4b797df40ed3a105364574b6,8,14,8,22,8,2006-08-10 21:13:53,2006-08-10 15:02:30
83a2b841d6b90e6f4b797df40ed3a105364574b6...6f05b57da8e82c471ea6765da67e813d496ed278,1,6,0,6,3,2006-08-10 21:14:24,2006-08-10 15:02:31
6f05b57da8e82c471ea6765da67e813d496ed278...ae9c86f2b6c89a3a0991209dae51086f884959c0,1,9,7,16,5,2006-08-10 21:14:27,2006-08-10 15:02:32
ae9c86f2b6c89a3a0991209dae51086f884959c0...68f4c78b95b9d119d8888b40b0a93b93a39b2f26,1,5,6,11,2,2006-08-10 21:14:34,2006-08-10 15:02:33
68f4c78b95b9d119d8888b40b0a93b93a39b2f26...fc5fc50980958f742a9f3d79fb7a64f02e87877a,1,16,16,32,2,2006-08-10 21:15:41,2006-08-10 15:02:34
fc5fc50980958f742a9f3d79fb7a64f02e87877a...d0d619c8c50b90fbbd6a7e0994fde073341bf92b,1,8,3,11,3,2006-08-10 21:15:49,2006-08-10 15:02:35
d0d619c8c50b90fbbd6a7e0994fde073341bf92b...f711ab5470cd1da7fdafa3b7b5e39015dcfca5ce,1,9,0,9,1,2006-08-10 21:15:55,2006-08-10 15:02:36
f711ab5470cd1da7fdafa3b7b5e39015dcfca5ce...0eaf22f4c4bba89457e733264e71343368712793,1,3,3,6,3,2006-08-10 21:16:02,2006-08-10 15:02:37
2c71810b90d122abdcc57fc3cb62174d16e77b58...1e8d304507b2d7e3b411d9b351fd348edd253df8,1,1,1,2,1,2006-08-10 06:40:40,2006-08-09 18:54:23
05b07ab9632dc233bf9eebad04256e06a8cbcb35...b4dd485696d9fb754b0a44649ef4796883d3b903,1,5,3,8,2,2007-02-09 00:06:10,2007-02-08 23:59:47
b4dd485696d9fb754b0a44649ef4796883d3b903...4e244cbc5cc4c8a43982d4023bc0d9fb0b0c7d43,3,10,7,17,5,2007-02-09 00:20:52,2007-02-08 20:58:33
4e244cbc5cc4c8a43982d4023bc0d9fb0b0c7d43...e00de24b102da647485aeeeff278c21ab31420a2,1,12,1,13,2,2007-02-09 01:47:38,2007-02-09 00:43:54
e00de24b102da647485aeeeff278c21ab31420a2...eb3a48221fd4a0b38c31976028dbab7df51be6d4,3,15,1,16,3,2007-02-09 01:48:22,2007-02-09 00:28:23
eb3a48221fd4a0b38c31976028dbab7df51be6d4...40facde06e3f9d5231c257e1a7f5b545b563d45f,1,21,8,29,3,2007-02-09 07:24:51,2007-02-09 07:24:51
40facde06e3f9d5231c257e1a7f5b545b563d45f...9e2586ff2f8b2b3f5bbdd7ad47af0db6abf0f6f8,1,54,0,54,1,2007-02-09 07:35:43,2007-02-09 07:35:43
9e2586ff2f8b2b3f5bbdd7ad47af0db6abf0f6f8...b52ba1a5d6c18250f497d3aba03943442766d9e1,1,72,3,75,4,2007-02-09 08:52:52,2007-02-09 08:19:28
b52ba1a5d6c18250f497d3aba03943442766d9e1...f6f125fbaa79c097f10afdbd7103ec068df10397,1,19,4,23,3,2007-02-09 08:52:52,2007-02-09 08:19:59
f6f125fbaa79c097f10afdbd7103ec068df10397...9f85fb324dc21b595a77313936b39930437209e7,1,20,6,26,5,2007-02-09 08:52:52,2007-02-09 08:20:38
9f85fb324dc21b595a77313936b39930437209e7...fa882116006e0403bb1b74973bb5f3f34f1cf523,1,10,14,24,4,2007-02-09 08:52:52,2007-02-09 08:21:03
fa882116006e0403bb1b74973bb5f3f34f1cf523...f0f39bb4c4ba36a07d7a6f034ba12f2ca0522db8,1,44,21,65,6,2007-02-09 08:52:53,2007-02-09 08:21:32
f0f39bb4c4ba36a07d7a6f034ba12f2ca0522db8...96df551cb89264ed88b717b9ace8ad3edc0e09a6,1,10,4,14,4,2007-02-09 08:52:53,2007-02-09 08:21:51
96df551cb89264ed88b717b9ace8ad3edc0e09a6...d2589855df9141ed5885ebd2fe868619d53fa15e,1,86,9,95,11,2007-02-09 08:52:53,2007-02-09 08:22:19
d2589855df9141ed5885ebd2fe868619d53fa15e...ad34a028c126fde97359c9d67e8d634043670a21,1,0,42,42,1,2007-02-09 20:14:40,2007-02-09 17:18:28
ad34a028c126fde97359c9d67e8d634043670a21...02f571c73bfdf1d950848ed24229caea438f1f72,1,8,0,8,1,2007-02-09 23:41:35,2007-02-09 23:41:35
02f571c73bfdf1d950848ed24229caea438f1f72...cc46a74398e6a542d61d8fa0b197b7dedcd7f301,1,1,8,9,3,2007-02-10 00:26:02,2007-02-10 00:22:42
302da67472e322109e6299d38dd1a2c30bde9f4c...fcee5a145d5a9e27afa8086c54e8f718a4a8f1cc,1,3,1,4,2,2007-02-07 17:18:57,2007-02-07 17:18:57
fcee5a145d5a9e27afa8086c54e8f718a4a8f1cc...40db58b8dc17ee9fac86ad126d442bb87b5ad549,1,5,3,8,3,2007-02-07 17:28:23,2007-02-07 11:38:21
278fcd7debf19c1efee18b32f8867becb18d1a22...7c0f7028ee04f135c7481671f05ca4a66072c78f,2,29,0,29,5,2006-12-04 21:34:45,2006-12-04 07:44:08
7c0f7028ee04f135c7481671f05ca4a66072c78f...396db813f2e9b56460cd783c73daf15150e36b41,1,1,1,2,1,2006-12-04 21:39:27,2006-12-04 07:17:00
396db813f2e9b56460cd783c73daf15150e36b41...f848718a6980ebda0eb5afb2ca49c3bc1e7b2b1d,3,57,7,64,8,2006-12-04 21:39:32,2006-12-04 09:50:04
f848718a6980ebda0eb5afb2ca49c3bc1e7b2b1d...e1147267afc0afa269884767c4045847d9a2be8a,1,1,1,2,1,2006-12-04 21:48:58,2006-12-04 13:09:43
e1147267afc0afa269884767c4045847d9a2be8a...b360cca0b100e14abffa4cae78521b493c783738,2,5,5,10,5,2006-12-04 21:49:08,2006-12-04 13:29:09
b360cca0b100e14abffa4cae78521b493c783738...4cd75359ad5d4c90ba6ae6d68ffb6d00e5092b8a,1,1,1,2,1,2006-12-04 21:54:57,2006-12-04 19:34:34
278fcd7debf19c1efee18b32f8867becb18d1a22...857b933e04bc21ce02043c3107c148f8dcbb4a01,5,444,3,447,7,2006-12-03 01:28:19,2006-11-21 22:24:34
857b933e04bc21ce02043c3107c148f8dcbb4a01...53a7085a104936aef29400369aab15e0d1ccbb28,1,7,10,17,5,2006-12-03 01:28:19,2006-11-29 20:06:49
53a7085a104936aef29400369aab15e0d1ccbb28...c2b4faea4522b28a7611ddab5eb6a5c221cc3ee5,1,41,57,98,7,2006-12-03 01:28:19,2006-11-29 20:07:37
c2b4faea4522b28a7611ddab5eb6a5c221cc3ee5...875b8ce47650d712c8f464cfedb9147673fe3ff7,1,5,5,10,1,2006-12-03 01:28:19,2006-11-29 23:24:32
875b8ce47650d712c8f464cfedb9147673fe3ff7...710daa83fc76f79b8f2ee9a765d297187c2c1aeb,1,2,2,4,2,2006-12-03 01:28:19,2006-11-29 23:25:11
710daa83fc76f79b8f2ee9a765d297187c2c1aeb...98e6da8a360b77af2924e8056fd951013835699b,1,5,16,21,4,2006-12-05 21:30:22,2006-12-05 21:15:35
98e6da8a360b77af2924e8056fd951013835699b...ba1f5f353775ddbf97bc0d543888783630693023,5,191,0,191,5,2006-12-06 18:00:24,2006-12-06 15:26:06
ba1f5f353775ddbf97bc0d543888783630693023...fbe0b24ca53111208b8ecd920cc112d0be13f93c,1,16,9,25,5,2006-12-06 18:04:00,2006-12-06 15:45:42
fbe0b24ca53111208b8ecd920cc112d0be13f93c...e2b7008752d85874919ea718d098fec01b4a9019,8,19,88,107,11,2006-12-13 05:47:29,2006-12-12 23:01:41
67bed724f2736925f84edd0aaaf371fea83dddc2...f5e6b89b3a4420481a6ecdc05df325cb6d69d114,1,35,17,52,7,2006-12-14 09:51:44,2006-12-14 08:03:18
00bc0ec26296aad8727dcc75f031c7b11e404f20...dd9142993c0954e2fd325431235bc7556189a01c,1,5,3,8,1,2006-12-18 02:53:24,2006-12-18 02:53:24
dd9142993c0954e2fd325431235bc7556189a01c...64fe031a7a78894955af217335b46059a36a582d,1,15,10,25,6,2006-12-18 03:36:50,2006-12-18 03:27:49
64fe031a7a78894955af217335b46059a36a582d...ff7f22f36e2931db7683121f20ee2e03bd426096,1,2,2,4,2,2006-12-18 08:00:15,2006-12-18 07:26:42
ff7f22f36e2931db7683121f20ee2e03bd426096...0c7a97fafdaf7911183807019dbbb4d8c5079c4e,1,3,5,8,3,2006-12-18 20:13:46,2006-12-18 20:13:46
0c7a97fafdaf7911183807019dbbb4d8c5079c4e...d8285af4810f655e28a0ae0e71a28a920bb6871f,1,4,3,7,4,2006-12-18 21:40:25,2006-12-18 21:33:47
d8285af4810f655e28a0ae0e71a28a920bb6871f...e1bb1d31ea7b5a2a3f20508e5643e8fc9ee5f0fd,1,20,18,38,12,2006-12-18 22:18:54,2006-12-18 22:18:54
e1bb1d31ea7b5a2a3f20508e5643e8fc9ee5f0fd...57b73150c4f1dbc26474a0031f433fb34db1c13f,2,8,9,17,7,2006-12-18 23:30:17,2006-12-18 21:06:50
57b73150c4f1dbc26474a0031f433fb34db1c13f...b3d9899324af174ff123498b5c7ded3749aac2bc,3,3,3,6,3,2006-12-18 23:31:28,2006-12-18 20:16:58
b3d9899324af174ff123498b5c7ded3749aac2bc...38c594d3300b7640532a3716adf5a0778021542c,1,9,1,10,2,2006-12-19 00:03:39,2006-12-18 15:48:33
38c594d3300b7640532a3716adf5a0778021542c...910c00c8ca4d998edb318cc232c03ec855cfa161,1,5,0,5,1,2006-12-19 00:05:08,2006-12-07 06:36:55
910c00c8ca4d998edb318cc232c03ec855cfa161...8336afa563fbeff35e531396273065161181f04c,1,1,1,2,1,2006-12-19 00:20:53,2006-12-19 00:20:53
cf2999eb4cbe39d5a40add574be9e5c019df758b...515377ea9ec6192f82a2fa5c5b5b7651d9d6cf6c,8,9,6,15,9,2007-01-08 02:03:07,2007-01-07 17:31:29
515377ea9ec6192f82a2fa5c5b5b7651d9d6cf6c...3368d11f308eb4ba2ad5703aa059bb0e5a82212f,1,2,2,4,2,2007-01-08 02:04:57,2007-01-07 19:18:26
3368d11f308eb4ba2ad5703aa059bb0e5a82212f...3faa541fa924890b85b240b800312befbf052b9f,1,1,1,2,1,2007-01-08 02:06:45,2007-01-08 01:10:42
3faa541fa924890b85b240b800312befbf052b9f...6211988f77ab20cc8705fb8c9ecb72ba166b80da,1,14,0,14,2,2007-01-08 02:06:49,2007-01-08 01:11:23
6211988f77ab20cc8705fb8c9ecb72ba166b80da...692167774a4fc55cd7ffd91117b2c0ac44e064d9,1,2,2,4,2,2007-01-08 02:20:19,2007-01-08 02:22:42
692167774a4fc55cd7ffd91117b2c0ac44e064d9...59b5f52047dcc1c55122c0f3c475b4d8efa45163,1,5,2,7,1,2007-01-08 05:32:49,2007-01-08 00:25:35
59b5f52047dcc1c55122c0f3c475b4d8efa45163...ae41098714898acd52dba291e476a2fedbd2eae2,2,23,3,26,4,2007-01-08 05:32:49,2007-01-08 03:35:40
ae41098714898acd52dba291e476a2fedbd2eae2...9a5e4075a4b54581821584386e5e184a57f06d18,1,1,1,2,1,2007-01-08 05:32:49,2007-01-08 03:35:41
e27e609bbf81271318d99f2643f378f3fde6c6c6...3a2d3e8678a01e327c8e6c851ed6d2cfd3c21aaf,1,3,4,7,2,2007-01-05 06:28:46,2007-01-04 08:06:50
3a2d3e8678a01e327c8e6c851ed6d2cfd3c21aaf...7c4c9f4cd9c36694ce0de5674f263585064cceec,1,1,1,2,1,2007-01-05 06:28:46,2007-01-04 18:33:48
7c4c9f4cd9c36694ce0de5674f263585064cceec...4fe2cc0c8906ba6d39c4fab89fe88dcf2226b184,1,0,1,1,1,2007-01-05 06:28:46,2007-01-04 18:33:36
4fe2cc0c8906ba6d39c4fab89fe88dcf2226b184...98327e5891471e7baceda5c6543a387f0dd21d3a,1,40,38,78,8,2007-01-05 06:28:46,2007-01-05 02:02:00
98327e5891471e7baceda5c6543a387f0dd21d3a...0d313b2b7bb219542473a25ad042f4b990e69a45,1,37,17,54,7,2007-01-05 06:28:46,2007-01-05 02:04:06
0d313b2b7bb219542473a25ad042f4b990e69a45...2a3240beaad73dd86d9220c8a8a6e76c6d034a57,1,6,4,10,5,2007-01-05 06:28:46,2007-01-05 02:09:56
2a3240beaad73dd86d9220c8a8a6e76c6d034a57...27dd1a83cbedb65d7116814ef2c0bf9d4986c8f5,1,6,2,8,1,2007-01-05 07:19:09,2007-01-03 21:54:29
27dd1a83cbedb65d7116814ef2c0bf9d4986c8f5...244a70e608204a515c214a11c43f3ecf7642533a,1,6,1,7,2,2007-01-05 07:20:43,2007-01-05 02:37:45
73c7f5ec05428b7da2d1b00a02a3267f1235d8e4...bca73251da5cc3e4bea71e28e0096a5cd662bbd9,1,8,2,10,2,2006-12-11 22:12:29,2006-12-10 23:55:07
bca73251da5cc3e4bea71e28e0096a5cd662bbd9...6f9872582246b9b8ee4bdc9f6a563b409aab1ecb,1,2,1,3,1,2006-12-11 22:12:33,2006-12-10 23:51:54
2495ca044795f0c5f459789eb29b66f5970096e1...2b74cffa9179eed274be2a38c59b7e323c813737,1,1,1,2,1,2006-03-02 01:42:00,2006-03-01 23:01:53
d00e0f8101e18e3d48a60d574dacc83dad8e19bb...c436eb8cf1efa3fe2c70100ae0cbc48f0feaf5af,1,25,12,37,3,2006-03-01 09:57:45,2006-02-28 07:38:50
d00e0f8101e18e3d48a60d574dacc83dad8e19bb...49cc27bb46dc5dddc59c9802c1eed1ee6126537e,1,24,0,24,1,2006-03-01 08:07:40,2006-02-23 23:20:51
49cc27bb46dc5dddc59c9802c1eed1ee6126537e...5793aa1cc08df7c4021509556637ade2d639083f,1,21,3,24,6,2006-03-01 08:07:55,2006-03-01 06:30:35
5793aa1cc08df7c4021509556637ade2d639083f...f0bcd511ee3a00b7fd3975a386aa1165c07a0721,1,20,0,20,1,2006-03-01 08:07:55,2006-03-01 07:03:58
c5a4c4debec43ff98053cb6b69d35d63e45ee131...e7da347520486ce33bb77d241b574787c0ec18e8,1,3,2,5,3,2006-04-17 00:27:59,2006-04-17 00:27:59
521a3f676794987bfd03703fe58fbec46ed69d49...1cd88cc9e6d6f83fed554419166a52a900e6f9a5,1,6,1,7,2,2006-04-05 20:00:03,2006-04-05 14:22:52
1cd88cc9e6d6f83fed554419166a52a900e6f9a5...34c5a9e284c88d415559586b79487411ece6f69c,1,1,0,1,1,2006-04-05 20:00:07,2006-04-05 14:22:19
f3a2469b2583a88b84d12b1e819a177cf7d7670f...a90a6d249bc4fe29c11ce3291f9ec90d8e5e67f4,1,48,13,61,18,2006-04-25 07:12:46,2006-04-25 07:12:46
a90a6d249bc4fe29c11ce3291f9ec90d8e5e67f4...d16c0812a9472794175b2543c2aa2df45a927202,1,90,37,127,16,2006-04-25 11:21:10,2006-04-25 11:21:10
40e907bff260a94306b1fe43d0fb829bf54e3103...5941a9e9d882b12dcc2a80e55acb25c180475529,1,6,3,9,2,2006-04-04 07:09:42,2006-04-03 22:18:48
5941a9e9d882b12dcc2a80e55acb25c180475529...5f2f4240022418e9a75505f11298db54a5da12d2,1,1,1,2,1,2006-04-04 07:09:45,2006-04-03 22:18:49
5f2f4240022418e9a75505f11298db54a5da12d2...fc9957b0052df6a8248420395bc9febd66194252,1,2,3,5,3,2006-04-04 07:09:47,2006-04-04 00:41:44
40e907bff260a94306b1fe43d0fb829bf54e3103...c72112e6e1593bd77132a815ba484d0ff880a7b4,1,28,19,47,10,2006-04-03 05:22:27,2006-04-02 23:25:01
29e55cd5ad9e17d2ff8a1a37b7ee45d18d1e59d6...5ee2ad654bc7d19ec4f08e11dc4fed8b97a59222,4,37,5,42,11,2006-02-11 06:28:30,2006-02-11 04:31:09
5ee2ad654bc7d19ec4f08e11dc4fed8b97a59222...c548cf4ee0737a321ffe94f6a97c65baf87281be,1,41,3,44,6,2006-02-12 00:49:52,2006-02-11 18:43:56
c548cf4ee0737a321ffe94f6a97c65baf87281be...98deeaa82fb2b96395854e0574272ed21cbd81fe,1,7,4,11,1,2006-02-12 00:50:03,2006-02-11 18:41:22
98deeaa82fb2b96395854e0574272ed21cbd81fe...21fcd1bdea2440236aea1713ea42a66bc2da5563,2,43,4,47,14,2006-02-12 01:54:18,2006-02-12 01:54:18
21fcd1bdea2440236aea1713ea42a66bc2da5563...7bbdeaa969794edd67cd4a1ed09b9a057b6af4c3,1,1,1,2,1,2006-02-12 01:59:38,2006-02-11 15:44:11
7bbdeaa969794edd67cd4a1ed09b9a057b6af4c3...1536dd9c61b5582cf079999057cb715dd6dc6620,3,12,3,15,3,2006-02-12 02:55:43,2006-02-12 02:55:43
1536dd9c61b5582cf079999057cb715dd6dc6620...16139f9035137ccd81e1e9a9dc203fbede6997a0,1,1,1,2,1,2006-02-12 07:08:23,2006-02-12 07:08:23
1e80e0449248edb77b0fb9853f4a3404a599e207...c5ced64578a82b9d172aceb2f67c6fb9e639f6d9,2,22,1,23,5,2005-12-23 22:14:28,2005-12-23 06:57:20
c5ced64578a82b9d172aceb2f67c6fb9e639f6d9...bb5ebed731378f9ebec9bcd438aa69e086d73359,1,60,11,71,7,2005-12-23 22:16:19,2005-12-23 20:47:18
bb5ebed731378f9ebec9bcd438aa69e086d73359...695bf722da848e0cd2692bc07c4a2773c52b4216,1,10,1,11,3,2005-12-23 23:48:09,2005-12-23 23:48:09
695bf722da848e0cd2692bc07c4a2773c52b4216...9a84074d08e2e816a3310eb34ac69b584faf817b,2,9,2,11,3,2005-12-23 23:51:33,2005-12-23 23:51:33
9a84074d08e2e816a3310eb34ac69b584faf817b...ac44f3e7c05390531004d567481004c96d1b262c,1,1,1,2,1,2005-12-24 07:56:52,2005-12-24 07:56:52
797bd6f490c91c07986382b9f268e0df712cb246...056211053b7516a57ff7a6dd02f503ecef6fca70,1,1,15,16,2,2005-12-23 23:30:07,2005-12-23 00:01:46
797bd6f490c91c07986382b9f268e0df712cb246...a69dd585fca9ab7fc4a07f7563f6cdb106e3ffed,1,18,4,22,8,2005-12-23 22:01:32,2005-12-23 21:39:30
797bd6f490c91c07986382b9f268e0df712cb246...104f3e03c03a83617bac9d120b5e536c5f29d9ef,1,9,0,9,2,2005-12-23 07:16:55,2005-12-23 06:37:50
4bfb6b62ffc9460798ebc78c3a30e4eff7c409d0...f8d294f0a44c4305a9f3a1c70beb6a1c7583f287,2,0,5,5,5,2005-11-08 16:58:52,2005-11-08 16:58:52
f8d294f0a44c4305a9f3a1c70beb6a1c7583f287...cb34882bd61e00295b6213d8c4c7bf9bb0e10a17,1,1,0,1,1,2005-11-08 19:26:03,2005-11-08 10:45:15
cb34882bd61e00295b6213d8c4c7bf9bb0e10a17...23fc63bf8fb7c3627f78ca6743b4f3ae17a5df49,1,8,3,11,2,2005-11-08 19:26:07,2005-11-08 09:51:10
23fc63bf8fb7c3627f78ca6743b4f3ae17a5df49...61f81518a2372dd78fa03da2b3d62173c3268ee7,2,11,2,13,4,2005-11-08 19:26:10,2005-11-08 10:44:33
61f81518a2372dd78fa03da2b3d62173c3268ee7...f4f440a039587c14ca29a8fe127b4d5273eacafc,2,15,15,30,14,2005-11-09 05:33:32,2005-11-08 22:18:31
f4f440a039587c14ca29a8fe127b4d5273eacafc...f37d0cc3ff6ef565f961a0d3741ba016e1ceb31d,1,7,7,14,6,2005-11-09 05:33:36,2005-11-08 23:52:02
f37d0cc3ff6ef565f961a0d3741ba016e1ceb31d...e09f5d7b07ada67f9e9c25ba7e58d76b8d5f4253,1,1,1,2,1,2005-11-09 07:34:29,2005-11-09 07:02:58
e09f5d7b07ada67f9e9c25ba7e58d76b8d5f4253...c8a4f5e5422677b950e7e74b29fa6631fd8ce243,1,4,8,12,6,2005-11-09 20:32:34,2005-11-09 10:36:55
c8a4f5e5422677b950e7e74b29fa6631fd8ce243...186f855fc639f2063e5f02abc75ca39464a35500,1,1,0,1,1,2005-11-09 20:32:36,2005-11-09 10:42:57
186f855fc639f2063e5f02abc75ca39464a35500...c44922a7817398d63bb2b46dc599bd05c710e746,1,6,3,9,2,2005-11-09 20:40:03,2005-11-09 20:40:03
c44922a7817398d63bb2b46dc599bd05c710e746...ff36de0847768873cc793afd6378d3b229591436,1,19,6,25,3,2005-11-09 23:19:50,2005-11-09 22:59:23
4bfb6b62ffc9460798ebc78c3a30e4eff7c409d0...7d4de59b1714d0ed78db7cafc083050e1b86e3df,1,44,6,50,8,2005-11-08 09:24:54,2005-11-05 19:38:02
4bfb6b62ffc9460798ebc78c3a30e4eff7c409d0...fcfa32b9e10b3c0373a263a732146850bdf67242,1,6,2,8,2,2005-11-08 09:24:47,2005-11-02 21:51:57
fcfa32b9e10b3c0373a263a732146850bdf67242...cbce5d8961f7790a621f7cee6ecb2c25ae372867,1,18,3,21,3,2005-11-08 09:24:48,2005-11-02 21:51:57
cbce5d8961f7790a621f7cee6ecb2c25ae372867...c2c07a5c2adf2aebc19b04a608592489b156a8bb,1,6,1,7,1,2005-11-08 09:24:48,2005-11-02 21:51:57
c2c07a5c2adf2aebc19b04a608592489b156a8bb...8168373fe7e6214205fd23e519f72c3f1bbb7080,1,53,37,90,8,2005-11-08 09:24:48,2005-11-02 21:51:57
8168373fe7e6214205fd23e519f72c3f1bbb7080...109fc2b97b73090a4a0a6550cdf9b2446fd12389,1,16,6,22,9,2005-11-08 09:24:49,2005-11-02 21:51:57
109fc2b97b73090a4a0a6550cdf9b2446fd12389...a16db4f472887a9050bf528bc7f0b94d6f7e8319,1,5,0,5,2,2005-11-08 09:24:49,2005-11-02 21:51:57
a16db4f472887a9050bf528bc7f0b94d6f7e8319...01d4f0e7758f0fa837eec18a901a668f816cfc5f,1,6,6,12,3,2005-11-08 09:24:50,2005-11-02 21:51:58
01d4f0e7758f0fa837eec18a901a668f816cfc5f...f3ad062560bfd4a2983122de93d08f43ea66e7cf,1,2,2,4,2,2005-11-08 09:24:50,2005-11-05 07:30:12
f8765797a41a39f4dfc7030098c38283e6461a83...960deccb26a5bee6c6cd63d50e8272f540a27b19,2,59,7,66,19,2005-10-19 21:27:01,2005-10-19 21:27:01
960deccb26a5bee6c6cd63d50e8272f540a27b19...e0004e286c50364f134c951754c34e815489ead0,1,29,0,29,5,2005-10-19 21:27:01,2005-10-19 21:27:01
e0004e286c50364f134c951754c34e815489ead0...49bb805e69f97e75472e54a68e9eb24e08dee011,1,62,2,64,6,2005-10-19 21:27:02,2005-10-19 21:27:02
49bb805e69f97e75472e54a68e9eb24e08dee011...e1c7ada6dd1fdf249d0bb84f3293d3be768b9239,1,4,68,72,10,2005-10-19 21:43:43,2005-10-19 21:43:43
e1c7ada6dd1fdf249d0bb84f3293d3be768b9239...76e712f1b38c6bfa744ee55fb46dfdb45ad3646e,1,3,12,15,3,2005-10-19 21:43:43,2005-10-19 21:43:43
76e712f1b38c6bfa744ee55fb46dfdb45ad3646e...d6a461e17758f369cd7b76e78262b1717cc5c39c,1,1,1,2,1,2005-10-19 22:01:50,2005-10-19 22:01:50
d6a461e17758f369cd7b76e78262b1717cc5c39c...0a8944dd48b97d258240af967dfdfcea4f203b85,1,25,8,33,8,2005-10-19 23:14:34,2005-10-19 23:14:34
0a8944dd48b97d258240af967dfdfcea4f203b85...4dab94d52e25b6a53a715613ec5b06b42b240106,1,23,9,32,6,2005-10-20 04:04:53,2005-10-20 01:28:17
4dab94d52e25b6a53a715613ec5b06b42b240106...d6a73596e766b934e25182e7cdd8e6c2dbcc671e,4,18,10,28,4,2005-10-20 04:25:39,2005-10-20 04:25:39
d6a73596e766b934e25182e7cdd8e6c2dbcc671e...f1f0a2be9fe6e6734d900381de189c56e023be7e,1,10,4,14,5,2005-10-20 04:55:49,2005-10-20 04:55:49
f1f0a2be9fe6e6734d900381de189c56e023be7e...6e1c6c103c522d01829f3a63992a023ff031e851,1,3,1,4,2,2005-10-20 05:49:31,2005-10-20 05:48:16
f8765797a41a39f4dfc7030098c38283e6461a83...ea5a65a59916503d2a14369c46b1023384d51645,1,62,2,64,6,2005-10-19 01:42:19,2005-10-19 01:42:19
b12bbd5986e1fae4120d7a415c1271c0273cad7e...17712991a59824a8d22d5115c0c154d3122fc17b,6,234,1,235,7,2005-10-10 23:31:08,2005-10-10 23:31:08
17712991a59824a8d22d5115c0c154d3122fc17b...340e4f88c083b0692e6554b1c2c27fd43c7cc8d3,1,30,1,31,2,2005-10-11 00:34:08,2005-10-11 00:34:08
340e4f88c083b0692e6554b1c2c27fd43c7cc8d3...1d389ab65dc6867d3059d60bb2b3951bc01a185e,1,587,223,810,63,2005-10-11 06:22:01,2005-10-11 06:22:01
1d389ab65dc6867d3059d60bb2b3951bc01a185e...a7a8d3786e6b60a472d0f88f778cacaead122a6c,1,57,5,62,31,2005-10-11 06:22:01,2005-10-11 06:22:01
a7a8d3786e6b60a472d0f88f778cacaead122a6c...380792390e05e744f9d7eefbc35d1db80e44e27a,1,6,11,17,4,2005-10-11 06:22:01,2005-10-11 06:22:01
380792390e05e744f9d7eefbc35d1db80e44e27a...11f0dafe2be419240c0006c3e9112cbad3568baf,3,14,3,17,4,2005-10-11 06:22:01,2005-10-11 06:22:01
11f0dafe2be419240c0006c3e9112cbad3568baf...031260064840e6e8c6bc36d7856a091ba80330c2,1,7,1,8,7,2005-10-11 06:22:01,2005-10-11 06:22:01
031260064840e6e8c6bc36d7856a091ba80330c2...b721e01f6efd84b04c6946553cd566f2707c964d,3,20,31,51,9,2005-10-11 06:22:01,2005-10-11 06:22:01
b721e01f6efd84b04c6946553cd566f2707c964d...dc1b5ea8781644203213e83b74cf3b432d88d067,1,1,5,6,3,2005-10-11 06:22:02,2005-10-11 06:22:02
dc1b5ea8781644203213e83b74cf3b432d88d067...0a81552e06037a57eeb1f784564a3ac092f60dfb,4,6,6,12,5,2005-10-11 22:15:15,2005-10-11 22:15:15
0a81552e06037a57eeb1f784564a3ac092f60dfb...f2d6a256272b71f4509e4501a86a0f6c46ee65ad,1,2,0,2,1,2005-10-11 22:22:47,2005-10-11 22:22:47
f2d6a256272b71f4509e4501a86a0f6c46ee65ad...013f276eb78967f9742654ebde303c2fbe7a6cd6,4,82,44,126,26,2005-10-11 22:22:48,2005-10-11 22:22:48
013f276eb78967f9742654ebde303c2fbe7a6cd6...5cbb401dbaff5fd810a85b84333cb0c22d264f36,1,6,1,7,1,2005-10-11 22:24:11,2005-10-11 22:24:11
5cbb401dbaff5fd810a85b84333cb0c22d264f36...3e09cdfd114651fc61656dbd45d5ec3d9352cb2b,4,70,9,79,16,2005-10-12 01:45:33,2005-10-12 01:45:33
3e09cdfd114651fc61656dbd45d5ec3d9352cb2b...ec2d15118bd6aa24e9323302e9aaa71dd54bc028,1,1,1,2,1,2005-10-12 01:47:33,2005-10-12 01:47:33
ec2d15118bd6aa24e9323302e9aaa71dd54bc028...e1b10391eabdaaa4c89c53099dd96d5f9d978719,9,118,78,196,18,2005-10-12 01:47:34,2005-10-12 01:47:34
e1b10391eabdaaa4c89c53099dd96d5f9d978719...128af9d1ef6c26b94d14c4dd0028c5dda8d6dd82,1,1,1,2,1,2005-10-12 01:47:34,2005-10-12 01:47:34
2482d7d0ecfe70a14b450e7028954f3b676f477a...b67b9b2034fc8983e796437034ab71cfce162d0b,1,6,8,14,2,2005-10-16 00:03:30,2005-10-16 00:03:30
b67b9b2034fc8983e796437034ab71cfce162d0b...494245d6d1ad365e9b8d76668ed7ff3f888057b1,2,19,212,231,19,2005-10-16 00:03:32,2005-10-16 00:03:32
494245d6d1ad365e9b8d76668ed7ff3f888057b1...652d5dc6c0aef842eafcd9d2f73a4836d20734e2,6,103,38,141,12,2005-10-16 00:10:14,2005-10-16 00:10:14
652d5dc6c0aef842eafcd9d2f73a4836d20734e2...48bc2fb0cd9ca05005c2062c3493e62e13593f55,3,16,0,16,3,2005-10-16 00:10:14,2005-10-16 00:10:14
48bc2fb0cd9ca05005c2062c3493e62e13593f55...5a2e04d2031b229a242d07e11e514220e71a0d33,6,12,6,18,7,2005-10-16 00:14:09,2005-10-16 00:14:09
5a2e04d2031b229a242d07e11e514220e71a0d33...4baf5dda9e30ddc472bec444af7a572e5d3cb467,1,83,0,83,4,2005-10-16 00:14:10,2005-10-16 00:14:10
4baf5dda9e30ddc472bec444af7a572e5d3cb467...a2239b79e554bab92abe47d8568cbbfe5c77ce85,5,18,3,21,5,2005-10-16 01:10:02,2005-10-16 00:30:15
a2239b79e554bab92abe47d8568cbbfe5c77ce85...585793d96c03dcd5d797b50f0cc654da3627318b,2,172,1,173,4,2005-10-16 17:58:30,2005-10-16 17:58:30
585793d96c03dcd5d797b50f0cc654da3627318b...ea56188a2488eff449661e2b4de656f38c88e62d,1,169,39,208,19,2005-10-16 18:05:14,2005-10-16 18:05:14
33bb218e9d7299f6ed06177c65d357ec81954ca9...e1e9c254660244756a72ecfcfff81c15fb32a6e9,2,5,1,6,2,2005-10-08 21:54:41,2005-10-08 21:54:41
e1e9c254660244756a72ecfcfff81c15fb32a6e9...8c51242873d63cfaf87fa2e2e407198a6ad2c3d0,1,6,3,9,4,2005-10-09 09:58:35,2005-10-09 01:01:24
8c51242873d63cfaf87fa2e2e407198a6ad2c3d0...5a6850e8aae7c6ef4f22e07cb620eb9325543732,1,6,2,8,2,2005-10-09 23:50:34,2005-10-09 23:50:34
5a6850e8aae7c6ef4f22e07cb620eb9325543732...9fabdedc0edd4ff150197a53cc3032e7bf27c4d4,1,4,0,4,1,2005-10-09 23:52:50,2005-10-09 23:52:50
9fabdedc0edd4ff150197a53cc3032e7bf27c4d4...fb8024b414b417d85ce215eba3dd23c188500c15,2,2,4,6,4,2005-10-10 02:13:47,2005-10-10 02:13:47
727132834e6be48a93c1bd6458a29d474ce7d5d5...ef34af24dc457f7a3ccfd8047e3d21e07f3f55e4,2,29,0,29,3,2005-09-19 15:49:39,2005-09-19 01:30:50
ef34af24dc457f7a3ccfd8047e3d21e07f3f55e4...3b944aac3b88773d1fae4352706915aad21f3757,1,1,1,2,1,2005-09-20 00:35:30,2005-09-19 17:11:18
3b944aac3b88773d1fae4352706915aad21f3757...bfb73b2ebc2d50c8e14133ad15137604fc54563d,1,2,0,2,2,2005-09-20 00:35:49,2005-09-19 14:11:19
bfb73b2ebc2d50c8e14133ad15137604fc54563d...1f961c196cbb475e612a4fb082b33efde71e7a03,1,1,0,1,1,2005-09-20 00:41:13,2005-09-20 00:19:50
1f961c196cbb475e612a4fb082b33efde71e7a03...0a2ba73860211efec479396c33ba381056715be5,1,5,2,7,1,2005-09-20 02:20:26,2005-09-19 08:12:18
0a2ba73860211efec479396c33ba381056715be5...343d35c9166cf1713eb2787c3506fd2663466262,4,1176,9,1185,7,2005-09-20 02:47:54,2005-09-20 02:47:54
08f555cb82f92797ca0aa0d6ba32e6872f1331e5...0f5274033ecb0262dc77e4ed48fdb1ab07181bd8,1,8,4,12,5,2014-01-22 19:00:07,2014-01-18 23:40:44
c90d3dbe7db37f298e7ce858cfc4c494113f8945...ebba6c0ca617352ceef5caa636ab243f0ef14cc3,1,2,2,4,1,2014-01-13 19:18:34,2014-01-11 16:28:25
c90d3dbe7db37f298e7ce858cfc4c494113f8945...84d5633f986933d640d5dace561f46afe762d20f,1,4,4,8,4,2014-01-09 22:52:44,2014-01-08 14:43:38
84d5633f986933d640d5dace561f46afe762d20f...4346663a14fe2af5e5cec94213203e199b7dfc3f,1,9,26,35,5,2014-01-09 22:56:06,2014-01-08 14:43:39
4346663a14fe2af5e5cec94213203e199b7dfc3f...7902fe03f97e2e74f95c96b8d18a7752bbb2ef6a,1,2,2,4,1,2014-01-09 23:02:36,2014-01-08 14:43:40
c90d3dbe7db37f298e7ce858cfc4c494113f8945...2a07e4374c0ba6f2e991965c99b448ccb563f2fc,2,19,7,26,6,2014-01-07 18:51:04,2014-01-07 08:22:15
c90d3dbe7db37f298e7ce858cfc4c494113f8945...832cf74c0792a58c9c28e32a8fe5dbb694f0cce6,1,2,2,4,2,2014-01-07 17:51:56,2014-01-07 03:32:01
c90d3dbe7db37f298e7ce858cfc4c494113f8945...e54c1f2d2533c5406abeb8e3e0cf78c68ca9c21e,5,28,3,31,5,2014-01-07 17:23:41,2014-01-07 02:14:05
b9cf14d43b221fc2cce07b63d1dca408c17946e3...efa8fd7ee8eb36df55b3549f6009f000347a796d,1,12,1,13,2,2014-01-07 17:20:59,2014-01-05 02:50:48
b9cf14d43b221fc2cce07b63d1dca408c17946e3...145e073b84de03f699e105a3990a7bbf3740309e,2,2,2,4,2,2014-01-06 19:30:17,2014-01-04 09:07:51
b9cf14d43b221fc2cce07b63d1dca408c17946e3...43fda9455c2f9300327e5cf1c532c083354e66b5,1,2,0,2,1,2014-01-06 17:08:18,2014-01-03 18:31:22
ce7f8745aa773dfe2fc0a1b8c327b50c7ce4a31e...a2df5211278df9a084d6a1869b5143a6bf120268,1,1,1,2,1,2014-04-01 21:07:46,2014-04-01 19:27:23
ce7f8745aa773dfe2fc0a1b8c327b50c7ce4a31e...e703d7118c68bb5b1f850dae4060609a88500b18,13,24,24,48,18,2014-03-24 17:43:34,2014-03-23 22:58:12
e703d7118c68bb5b1f850dae4060609a88500b18...ec160ae12b0ae938ed5076b9f604e88976fc429c,3,50,5,55,10,2014-03-24 17:43:35,2014-03-23 23:57:28
ec160ae12b0ae938ed5076b9f604e88976fc429c...b6c2a0d45d4165dfd326bd7a28e66d9cedb8ae84,1,3,0,3,1,2014-03-24 17:43:35,2014-03-23 23:04:36
27ac2b1f24d034f89e87d79768fe94a4e7559b93...00eda23228acb68c85a76f977f4e59f82189ce3f,2,64,3,67,5,2014-03-14 21:27:26,2014-03-13 21:01:17
45067fc973c31953ab283f77f0f91eba9a272624...8c2cfa55446f542454eb4acc7f49d1747e425c94,1,5,7,12,7,2014-07-16 18:10:11,2014-07-16 08:51:33
45067fc973c31953ab283f77f0f91eba9a272624...539e75069f5c8f0ecf9e99f1163647aa9f92c5bd,2,33,4,37,8,2014-07-15 18:50:15,2014-07-15 11:29:45
45067fc973c31953ab283f77f0f91eba9a272624...479eaa8ef8384d8026dc05c1288e96ffd9e296d6,1,1,1,2,1,2014-07-14 00:57:59,2014-07-06 00:43:48
45067fc973c31953ab283f77f0f91eba9a272624...cf3983d1ff861657c8813feb7df82a74a29d06bc,2,32,0,32,3,2014-07-09 16:37:43,2014-07-09 02:10:21
b687cd6aba394bba34ad9fb70aa33cd5cfcebc6c...1bb207e0fecb49e35b14b673987cce2884239e04,2,0,4,4,2,2014-06-13 18:06:21,2014-06-09 21:05:17
8976500cbbb13270398d3b3e07a17b8cc7bff43f...1e4119c81b3e203e1729e03be6e4a53eb9207f5c,2,42,20,62,6,2014-05-19 23:09:53,2014-05-19 22:55:37
531675ad172f984a6dbc2ac840caaf6ba1015eb0...cc291953df19aa4a97bee3590e708dc1fc557500,2,6,1,7,2,2014-04-18 18:21:43,2014-04-18 18:21:43
475c52b7ac59bb5d2f955bd68c069622d9575d50...9c8ce7397bac108f83d77dfd96786edb28937511,1,18,18,36,13,2014-02-14 19:22:56,2014-02-13 10:35:08
9c8ce7397bac108f83d77dfd96786edb28937511...5f95c9f850b19b368c43ae399cc831b17a26a5ac,4,11,33,44,32,2014-02-14 19:35:04,2014-02-14 19:35:04
c2369bdf7ff082d588c4a4efe280bc4a483d0192...bf7283465b42e43b8822a8575abd1a7c6c82e7c9,1,22,6,28,4,2014-08-18 16:45:39,2014-08-16 21:48:33
c2369bdf7ff082d588c4a4efe280bc4a483d0192...13f1df432ea78a9dda2e70036215f754db182934,2,19,10,29,4,2014-06-10 20:31:01,2011-01-07 18:47:23
13f1df432ea78a9dda2e70036215f754db182934...a15d4af4497d147bfdb672e121b67db335ec1c21,1,1,1,2,1,2014-06-10 20:31:01,2014-06-07 06:46:41
7234af6e7ba5c6822f07983768621fb0785bda99...b28aeab4ec1df28f3be3cb62ff4b85e5332d8d13,1,1,1,2,1,2014-05-09 18:23:55,2014-05-09 18:23:25
a25014bc4cef56712f7d005d7b76070d0270f454...85453fd1e36c581c1e6b7939e46badf2581837b3,1,6,0,6,1,2014-01-13 22:20:25,2014-01-11 14:27:12
85453fd1e36c581c1e6b7939e46badf2581837b3...4310e328d416be00e58e90b69ed3b62f5845c744,1,1,1,2,1,2014-01-13 22:20:31,2014-01-11 14:27:13
767f000b4d9d3c602ac02eb1d671958cd614bf49...7f4ba4b6e3ba7075ca6b379ba23fd3088cbe69a8,1,53,0,53,4,2015-02-25 23:44:04,2015-02-25 23:44:04
52d5bf77875275bbfc1bf1d7b690f355d5c869e4...d67f9d5e8fd2c165304153a87fd96054d2b74981,1,25,1,26,2,2015-03-06 23:05:39,2015-03-06 23:05:39
4b23b5d1afbc7fcd8bc744523f4c3ff06dbe25d1...bb8577532add843833ebf8b5324f94f84cb71ca0,4,43,3,46,5,2015-03-14 05:57:25,2015-03-14 05:57:25
7bc4c01d9b66b4bc5ef1a7d77a6743ca135ea680...8004647a217c26f708bce2aa26ed94a4a0ed575d,4,56,3,59,5,2015-02-25 06:14:42,2015-02-25 06:14:42
5e519fb8b09378342e23bd8c075cfb4b8e7b0e4f...9a8c2b67cd5a51666f2c0ce3fbbdb08b97b79b3d,4,38,3,41,5,2014-12-17 19:30:46,2014-12-17 19:30:46
655ee9ea3e6c0af57d320e84723ec3bf656cdbf7...6127ff63cf39471b2c7317c9861016424d3b884b,1,2,2,4,2,2014-04-24 20:46:13,2014-04-24 13:06:09
b21c0bc8e63fda94d326c974bc77da87d7229ddc...b594c975c7e865be23477989d7f36157ad437dc7,2,3,3,6,2,2014-01-23 18:00:28,2014-01-23 07:28:58
812b5e1c1107ff68e5992654bcd849dce93962d4...d74d01808a230847dd501f38f7076765868e9fc6,1,933,826,1759,786,2014-01-21 08:26:56,2014-01-21 08:26:56
d74d01808a230847dd501f38f7076765868e9fc6...cfff71a961bea566e6e9a043dc324646763bd36c,1,972,837,1809,784,2014-01-24 22:17:14,2014-01-18 03:04:21
cfff71a961bea566e6e9a043dc324646763bd36c...608a82348b640e694ac0e9b89f372f9f88d0e442,3,0,7004,7004,4,2014-01-24 22:17:14,2014-01-18 09:08:14
608a82348b640e694ac0e9b89f372f9f88d0e442...5123e7d54fa93710372b5cd44d5d8e3818dc79b3,1,4,0,4,1,2014-01-28 17:16:53,2014-01-28 17:14:08
5123e7d54fa93710372b5cd44d5d8e3818dc79b3...25e2fbb4e2d99f2f1e04f0ae2588ab8396217ee4,1,10404,0,10404,1,2014-01-29 12:29:15,2014-01-20 19:39:30
5addd1c7531cc644787cd562a3c22a3b714c7d77...debecc55583aa498dbc64a1d45b8abba324a2dae,1,1,1,2,1,2013-07-19 17:15:09,2013-07-19 16:26:24
5addd1c7531cc644787cd562a3c22a3b714c7d77...42063f95a0f285382458f357bd256df252000ef1,2,3,3,6,3,2013-07-18 17:56:06,2013-07-18 12:26:55
42063f95a0f285382458f357bd256df252000ef1...465cf8ce453dc3e266171ece2ea886acd8c7d714,1,3,3,6,1,2013-07-18 17:57:01,2013-07-18 12:26:56
85318f521f6c0b9843d6da12abf67f2de7608431...8ceb6fbd63e2b3b82bbca0139a1696955aa753c6,5,10,10,20,10,2013-06-27 16:37:12,2013-06-26 20:06:41
83ce1764496d90a5ef45b0a109ab5fc222a62199...682ce8bb37414afe87515123fc6c26f21dd35b15,1,24,0,24,3,2012-09-10 22:52:21,2012-09-10 22:52:21
8ebae4a552a6f95e1f19cc50739c6f34003fdb74...31e0100e89c3f7c05bd7fdf54e084b2039d398ec,1,37,0,37,4,2012-08-27 19:10:07,2012-08-27 19:10:07
0e64a95ae5824238cebdc921ed060efdef19620d...8d8136c37a98bfb545f46990e3854df3414c3528,5,6,6,12,6,2012-06-22 21:25:04,2012-06-22 20:03:01
3a2c13551e95d27d0cb73e9f313bfd1a89b21917...9bea2b5896701cf952f75c8f6756656cd3c40af0,2,7,2,9,3,2012-06-12 16:10:52,2012-06-12 16:10:52
e98fa647aa5673cc95b6e9be1fdc13c0afa2cb37...7e2010537e96d0a1144520222f20ba1dc3d61441,4,27,3,30,5,2012-10-17 17:36:42,2012-10-17 17:36:01
de29a7ac0ec31d8f5fa91b7d2f0294165787d558...126b59692bb4d1e2283e8528fe0a8103995c23c4,1,20,12,32,17,2012-12-26 19:52:36,2012-12-26 19:15:05
c9407860f47ec4cf1c64a2c2ca4ae0b451469658...0e5ed7cca3c51c821c2bb0465617e75d994f432f,2,3,3,6,3,2014-12-15 17:37:14,2014-12-15 14:34:28
c9407860f47ec4cf1c64a2c2ca4ae0b451469658...d8b453149cdd0f900f2add9d891594cec37e3a56,1,61,43,104,6,2012-11-19 18:56:49,2012-11-18 11:08:09
e28efb1998bb0b73057de13b9568f6aef439a583...5e026920a9465c6c3e026c5bf0d1c4d9d3f05cfa,1,38,2,40,2,2013-02-05 19:20:09,2013-02-05 19:19:32
073678b8e6324a155fa99f40eee0637941a70a34...80ff2b68f28193af70d4c0bb9d363531eb1c3d23,1,15,23,38,13,2013-01-29 22:30:46,2013-01-28 00:52:23
80ff2b68f28193af70d4c0bb9d363531eb1c3d23...5338a6a924b9519dfbd3c92142f83d6ecf925097,1,7,1,8,1,2013-01-29 22:31:22,2013-01-28 00:52:24
5338a6a924b9519dfbd3c92142f83d6ecf925097...17a1f1c5b7041afab2e184304d8194a2f81f196d,1,65,36,101,7,2013-02-03 05:46:52,2013-01-28 00:52:25
17a1f1c5b7041afab2e184304d8194a2f81f196d...665682c9fd81df7e2dc8fe9db28fa5918a2f8ba0,1,40,1,41,5,2013-02-03 05:46:52,2013-01-30 19:55:46
665682c9fd81df7e2dc8fe9db28fa5918a2f8ba0...f35ec546008e8390e0fd8e545680e72fae0efa35,5,36,15,51,7,2013-02-03 05:46:52,2013-01-28 00:52:26
9673b8c392a97c0dfa865ecf60b024f70a7dacfe...ce45ea6a133a68ead5d06b33453cc5296fb5c720,1,12,7,19,5,2012-11-27 17:14:53,2012-11-27 04:13:41
c190ced600223f0774f6ba33f608b1e1347e623e...491e3075a29a0475984098a85cdbbb185d5a1e33,1,9,6,15,3,2012-12-03 17:10:47,2012-12-03 06:16:57
bd54cf17a4acfb9555b8a83b7e74fb0274c38bb4...24676f02ba8bcf0f2c5cccd02825e15ca93bb5f4,1,1,1,2,1,2013-04-10 19:26:14,2013-04-10 17:00:20
421a97694590c2be58f3ccebf301c7239289aa00...03a0fb0ccf48c831060c2243f830b6a12cd8fdf3,1,2,2,4,2,2013-03-11 19:59:57,2013-03-11 19:44:15
407929cb45dd9e1ba1dc15ec77fc3bf5eae3cc5c...c699a7ccdcca832464d51bff8937cd0bffa1fd9e,1,1,1,2,1,2013-03-13 17:45:56,2013-03-13 01:12:20
c699a7ccdcca832464d51bff8937cd0bffa1fd9e...4549162e8d623d69ea48745fce3709e5133ce043,4,28,14,42,7,2013-03-13 17:46:07,2013-03-13 01:12:21
4549162e8d623d69ea48745fce3709e5133ce043...530333cfe851b68a3635ee5bcfe707799dab9b83,1,0,2,2,1,2013-03-25 17:48:24,2013-03-25 17:48:24
530333cfe851b68a3635ee5bcfe707799dab9b83...333ea38db95c77fad8b18daa80bbf0f96fee556c,1,17,9,26,8,2013-03-25 17:50:27,2013-03-24 12:26:23
333ea38db95c77fad8b18daa80bbf0f96fee556c...d401acf7036cf01d93d138239edf87a59f9627b4,1,7,7,14,6,2013-03-25 17:50:31,2013-03-24 12:26:24
d401acf7036cf01d93d138239edf87a59f9627b4...4fa5c0591a7b5c71c8ccf71d8401c3337b7867ad,1,2,5,7,3,2013-03-25 20:32:07,2013-03-25 17:05:13
1ddac3ff9aa29d1103aa05f59772812289b4cefa...18d472db6fe3909537ceb7e0c54cf01fa3466b8f,2,133,5,138,8,2013-07-09 16:24:59,2013-07-09 05:55:04
18d472db6fe3909537ceb7e0c54cf01fa3466b8f...3755b53af779ce75fa3ea4581a0e6525bc67278d,2,4,3,7,2,2013-07-09 16:25:04,2013-07-09 05:55:05
1ddac3ff9aa29d1103aa05f59772812289b4cefa...0f483436e9c2e03bbb80c1dc215d4d7bf8774282,1,2,3,5,2,2013-04-22 02:41:24,2013-04-22 02:40:49
0f483436e9c2e03bbb80c1dc215d4d7bf8774282...499926670665570d785bc7baca4d7cd4420823dc,1,0,4,4,1,2013-04-22 14:53:59,2013-04-22 09:36:22
06d67b876642822828596b0b38cda2f61d438335...4d0d0c3c59800e07d899e53121902833e3fd0cc7,2,27,5,32,3,2013-03-03 09:24:11,2013-03-03 09:24:11
06d67b876642822828596b0b38cda2f61d438335...18505c34237d3544729c3deed3e4f851fb672086,1,23,0,23,2,2013-03-03 06:52:44,2013-03-01 23:35:48
aa3982890fe7506badfddf6252402a335a4d72b7...66c0786ca59ec2f281fe9c78521b79f8bccfc954,1,2,2,4,2,2013-02-12 18:06:25,2013-02-12 12:20:42
aa3982890fe7506badfddf6252402a335a4d72b7...081fd8d093887b0cc5055d8a191ae2c26274846b,3,11,0,11,5,2013-02-11 22:33:04,2013-02-11 22:03:45
55f56fee0765820d5c841e47b22f33f5a7253e16...8aa10d4a5bb2eceb78b689f0c13b334725a1019f,1,2,2,4,1,2013-03-14 21:29:02,2013-03-14 20:19:39
8aa10d4a5bb2eceb78b689f0c13b334725a1019f...e0976dcf83884fd0b48e90f0c62f50852e6971f6,1,3,1,4,1,2013-03-14 21:29:05,2013-03-14 20:19:40
e0976dcf83884fd0b48e90f0c62f50852e6971f6...02c56314aab9474827cd7831518a970f0341e4fd,3,43,4,47,5,2013-03-14 21:33:06,2013-03-14 20:19:41
9a6c84e6e9078b0ef4fd2c50b200e8552a28c6fa...a617578d373972842d41cc86625cf094c113d58b,1,29,9,38,2,2013-02-01 20:35:30,2013-02-01 19:41:14
9a6c84e6e9078b0ef4fd2c50b200e8552a28c6fa...4c9a418227a55832de90ec2662570c9daef537da,1,3,3,6,3,2013-01-31 19:10:26,2013-01-31 02:01:06
772f8113988a8ad3a38323c70ecbad1034e9e699...c4ada6283eaf1d4970b92b0e2cb9503a17da27ad,1,37,2,39,6,2013-01-22 18:01:05,2013-01-22 18:01:05
9de96815493b577ae791d5113a3e354142ffbcae...712693e8dbf188d4e9337c065617f09f7a0d1a16,1,107,3,110,5,2012-06-03 21:34:47,2012-06-03 09:46:47
712693e8dbf188d4e9337c065617f09f7a0d1a16...49301c64f3612d68058efb428a74133ac6e4a071,2,123,1,124,4,2012-06-03 21:35:09,2012-06-03 09:46:48
49301c64f3612d68058efb428a74133ac6e4a071...967b2c66738fe6b168ead0c3106ac47fb9ae22c7,2,47,9,56,10,2012-06-06 18:40:59,2012-06-06 11:57:29
967b2c66738fe6b168ead0c3106ac47fb9ae22c7...758615e2517db8b9fda9218afded06a3e1b42e20,3,18,8,26,10,2012-06-06 18:43:55,2012-06-06 11:57:30
758615e2517db8b9fda9218afded06a3e1b42e20...c517e73d0f116f8293f1fbc7f92bb60ea8047b0f,1,8,3,11,3,2012-06-14 18:00:06,2012-06-14 12:10:27
9de96815493b577ae791d5113a3e354142ffbcae...6f6731e719bff056615d65b700f3d1770ec55f81,1,170,1,171,5,2012-05-21 01:00:39,2012-05-21 01:00:39
9de96815493b577ae791d5113a3e354142ffbcae...754980d02386e09d0277d22284375686c197ddbd,2,2,2,4,2,2012-05-18 21:21:19,2012-05-16 12:02:09
754980d02386e09d0277d22284375686c197ddbd...c9018b0305a56436c85b292edbeacff04b0ebb5d,1,172,150,322,9,2012-05-18 21:22:15,2012-05-16 12:02:10
b652ada42a76548569a0dc9c9cf356343f9e1c3a...388698ce61246771096cc06f5c9d1e88053b3449,1,2005,620,2625,498,2012-05-14 23:10:28,2012-05-14 19:18:32
8bb45b25b2230c84724f6f62bfcc04a79999a90c...04416018a77ced575c35791f8300ab014417aab9,1,2,2,4,1,2010-02-26 06:39:09,2010-02-26 03:40:10
04416018a77ced575c35791f8300ab014417aab9...bfb8306de5382efdee20e9aef3ba6b7a3fae6a64,1,5,5,10,4,2010-02-26 06:39:12,2010-02-26 03:40:11
bfb8306de5382efdee20e9aef3ba6b7a3fae6a64...ec2537beda63f78746f8b43a031120be0d32310e,1,3,3,6,2,2010-02-26 06:39:13,2010-02-26 03:40:12
ec2537beda63f78746f8b43a031120be0d32310e...2e48fcdbc45eeb95b3da1cf70787ddadf62d9bf5,1,8,4,12,3,2010-02-26 06:41:44,2010-02-26 03:40:13
64da6e20de1f2246e2d8d9d85e53ca3cbf393212...77e8466fb98b95ea07d386d64073d0bc6304b37f,1,18,14,32,2,2010-02-28 18:32:06,2010-02-28 15:49:15
77e8466fb98b95ea07d386d64073d0bc6304b37f...c0d3a38293530c1e2ff873553fabe6dc4694aaaf,1,1,3,4,1,2010-02-28 19:13:11,2010-02-27 04:57:48
c0d3a38293530c1e2ff873553fabe6dc4694aaaf...c5e5f6030573b5433284b4e6b4342ab7204f20e1,3,12,7,19,6,2010-02-28 19:41:24,2010-02-28 19:41:24
64da6e20de1f2246e2d8d9d85e53ca3cbf393212...cbf731ed4ec511f2c32598e03d7865f35881fea2,2,43,14,57,4,2010-02-28 18:28:05,2010-02-27 03:50:02
cbf731ed4ec511f2c32598e03d7865f35881fea2...4a9f439415eda734914c7328a2326ee9590246ee,2,43,4,47,3,2010-02-28 18:28:26,2010-02-27 03:50:03
4b7acc186f33037178f4d137b2e6099c67492bde...9517e6b84357252e1882091343661c34d978771e,17,20,19,39,19,2010-02-04 05:28:17,2010-02-04 05:23:18
4b7acc186f33037178f4d137b2e6099c67492bde...79286102ce1620c5b0e73dc4559450eb24918e08,1,1,4,5,2,2010-02-03 20:03:40,2010-02-03 18:16:30
79286102ce1620c5b0e73dc4559450eb24918e08...57017b3e1554b169f3db52a7f8da4e359d043ca8,1,0,4,4,3,2010-02-04 01:14:00,2010-02-03 11:28:28
57017b3e1554b169f3db52a7f8da4e359d043ca8...2fca19fbb524d028bff0467762186e641aa3351a,1,34,20,54,5,2010-02-04 04:38:47,2010-02-04 03:48:26
2fca19fbb524d028bff0467762186e641aa3351a...a2430dde8ceaaaabf05937438249397b883ca77a,1,13,24,37,6,2010-02-04 04:39:24,2010-02-04 03:48:27
a2430dde8ceaaaabf05937438249397b883ca77a...07cf0f2407709e3764ea989696b513ec32613504,6,36,21,57,16,2010-02-04 04:39:56,2010-02-04 03:48:28
07cf0f2407709e3764ea989696b513ec32613504...76ea93ccb5df138eb57b2e8f2aee61dd1ca666ea,1,4,1,5,1,2010-02-04 17:09:50,2010-02-04 02:27:08
76ea93ccb5df138eb57b2e8f2aee61dd1ca666ea...89c38500192e00988966246420902dc946e4f4ef,2,4,4,8,2,2010-02-04 23:12:13,2010-02-04 16:01:16
89c38500192e00988966246420902dc946e4f4ef...9f17688d93c18bdd0532d2733710dc4d23921282,1,9,9,18,1,2010-02-04 23:12:16,2010-02-04 21:19:35
9f17688d93c18bdd0532d2733710dc4d23921282...4d0cc2243778b38c3759c6a08f4f1ed64155a070,3,17,12,29,4,2010-02-04 23:12:17,2010-02-04 19:10:44
4d0cc2243778b38c3759c6a08f4f1ed64155a070...8bff7c5383ed833bd1df9c8d85c00a27af3e5b02,1,36,4,40,3,2010-02-05 07:33:25,2010-01-30 03:14:22
8bff7c5383ed833bd1df9c8d85c00a27af3e5b02...3c8f6c8c4f00414e66076c2c97c834d01f828491,4,1,96,97,10,2010-02-05 17:27:25,2010-02-05 17:20:01
a5031214c4fe5f5d3fcf649d10769744cbc66fed...0b868f0eecf4a5b4f25b5876e731f0b5456edc89,1,1,1,2,1,2015-02-13 21:42:17,2015-02-13 21:18:49
a5031214c4fe5f5d3fcf649d10769744cbc66fed...907a7cb51c6c44d25f4c734a46d5174363190a84,4,4,4,8,6,2010-01-22 04:06:58,2010-01-22 02:25:20
907a7cb51c6c44d25f4c734a46d5174363190a84...b28a1ce04cdafbd3b470ec43c0f562054bd45d4d,4,4,5,9,7,2010-01-22 04:07:06,2010-01-22 03:50:11
e36e6c00cd60130f8792319a5aa0f56d2da68e14...6476b38b1f3d258006566c3c9c6c80cc07fda354,5,24,0,24,6,2009-11-21 06:08:10,2009-11-18 06:50:58
6476b38b1f3d258006566c3c9c6c80cc07fda354...ddae8ae8b59f75d324a5b1ae20705f4fa72db9f3,1,11,10,21,8,2009-11-21 06:08:10,2009-11-19 06:13:15
ddae8ae8b59f75d324a5b1ae20705f4fa72db9f3...0de8b94720501e869a05c52a691985fa4ce69803,1,3,0,3,1,2009-11-21 06:08:11,2009-11-19 06:13:16
e36e6c00cd60130f8792319a5aa0f56d2da68e14...3e97c7c6af2901cec63bf35fcd43ae3472e24af8,2,39,10,49,17,2009-11-21 06:00:36,2009-11-19 21:12:24
e36e6c00cd60130f8792319a5aa0f56d2da68e14...75b9a8a6d5aee29b1d0d03935531081e6180c0db,1,1,1,2,1,2009-11-21 05:58:11,2009-11-20 11:33:53
75b9a8a6d5aee29b1d0d03935531081e6180c0db...7a0d61bb45055cacf85111e7c48dfb9054b0abb0,2,7,1,8,3,2009-11-21 05:58:11,2009-11-18 13:32:26
f6f3921db69a42f0a73d03efd48a2e776dd7ff92...022250adfd2d64ca871c9d4a7873038e33c069f5,2,15,2,17,4,2013-01-10 22:14:37,2012-12-18 15:26:38
022250adfd2d64ca871c9d4a7873038e33c069f5...bf7c3f749db88906dfb040194974808b6151ec22,2,37,1,38,2,2013-01-10 22:17:13,2013-01-10 22:17:13
8fbe9b32ce6f5e12ba3f8b9d4e3ccb0b8acf529f...d27b876b284b8fb82db971bc7cea8c9782614ab2,3,35,15,50,11,2010-07-19 18:10:43,2010-07-17 15:11:43
d27b876b284b8fb82db971bc7cea8c9782614ab2...1f74574ba2d34fc9735e8113ed95def6accb6411,1,0,4,4,1,2010-07-19 18:11:07,2010-07-17 15:53:45
1f74574ba2d34fc9735e8113ed95def6accb6411...f0e5a4b7f3db2d4e1ded9683817d1d1d3a2a220f,1,2,1,3,1,2010-07-19 18:11:46,2010-07-17 15:33:15
fc051572a3fe171286f10761bd33946c48de3f7f...e8b15e6156fc361d3cb0e093747dab840d58fc7e,1,11,2,13,2,2010-07-14 22:35:12,2010-06-10 12:47:01
5d1e34158a3023af48541bf1731d202849929a12...312a30eb5d1926df19c756ba89561507f3cefdc7,1,4,2,6,2,2010-07-13 16:02:59,2010-07-12 18:58:38
312a30eb5d1926df19c756ba89561507f3cefdc7...1b79d1c2a8a90419238f7213870ab1dc465082fe,1,1,0,1,1,2010-07-13 16:13:34,2010-07-13 12:01:40
0afcb5f7915337c76c6743dab70c49facdeddd7e...48cc95ed4a5c4554f8914af3f300558da31a22dc,1,38,0,38,1,2010-01-10 07:43:22,2010-01-09 03:36:40
48cc95ed4a5c4554f8914af3f300558da31a22dc...40c813e00c8de5725c7a6bb127fadedcce1f788f,2,20,4,24,3,2010-01-10 07:43:22,2010-01-09 03:36:41
0afcb5f7915337c76c6743dab70c49facdeddd7e...3caa82396ca8a78da05f7759570444e9a666b2e8,1,8,1,9,6,2010-01-10 07:42:48,2010-01-09 05:10:05
3caa82396ca8a78da05f7759570444e9a666b2e8...15515b73716a6ead5a5a348a7d04cc7d73c74bff,1,20,8,28,4,2010-01-10 07:43:49,2010-01-09 14:13:28
0b444cdb19bcfcc7f59b7b00783cbfbbc5ddcf63...2e294cf23b2114a107d22f7fdfaf06b61d0c7a17,1,6,9,15,1,2010-01-10 12:12:57,2010-01-10 02:59:41
2e294cf23b2114a107d22f7fdfaf06b61d0c7a17...63487e14c834f5e5093f8ef25fe983fffa1ff7a4,1,4,4,8,3,2010-01-10 12:13:01,2010-01-10 03:01:21
63487e14c834f5e5093f8ef25fe983fffa1ff7a4...4fdff3d210724810a061f332bddd9607c856dd8a,1,1,1,2,1,2010-01-10 12:13:05,2010-01-10 12:05:04
4fdff3d210724810a061f332bddd9607c856dd8a...2d0f686c44bfb7055b317d178b703078b76dcc4f,1,1,1,2,1,2010-01-10 20:29:34,2010-01-10 20:29:34
2d0f686c44bfb7055b317d178b703078b76dcc4f...35e9d6303c15faf01fc9551d5ed648564dcd4014,1,9,9,18,2,2010-01-24 12:57:42,2010-01-23 09:26:57
35e9d6303c15faf01fc9551d5ed648564dcd4014...ed4a6baad0c8d446758eed8827e0d9190e624172,1,3,3,6,2,2010-01-24 12:57:42,2010-01-23 09:31:19
ed4a6baad0c8d446758eed8827e0d9190e624172...a4081bacfc78c1e1843590ed8d87544f3873dd10,1,2,2,4,2,2010-01-24 12:57:42,2010-01-23 09:33:37
a4081bacfc78c1e1843590ed8d87544f3873dd10...b40bb374a618534b930ce4da5ffffb215b5cb488,1,26,2,28,1,2010-01-24 12:57:42,2010-01-23 09:42:46
b40bb374a618534b930ce4da5ffffb215b5cb488...30f2bade84a3f6961b38579c1c23c64b72f64f24,1,21,10,31,3,2010-01-24 12:57:42,2010-01-23 09:44:17
30f2bade84a3f6961b38579c1c23c64b72f64f24...29280311f0282857360add2b49db5fc7148d4813,1,18,13,31,2,2010-01-24 12:57:42,2010-01-23 09:45:33
29280311f0282857360add2b49db5fc7148d4813...ebef7e504913a1480310735af9541e26c0b381ba,1,16,36,52,7,2010-01-24 12:57:42,2010-01-23 09:48:42
ebef7e504913a1480310735af9541e26c0b381ba...3588cf94812d47dd34b82039c7776f5225a947fb,1,8,6,14,3,2010-01-24 12:57:59,2010-01-23 22:48:40
48ffef966c762578eb818c0c54a7e11dd054f5db...0d7c2430ab0e25ab973f4b3cf1fae1f22de82fb2,1,6,2,8,2,2010-03-14 07:22:50,2010-03-01 07:31:21
0d7c2430ab0e25ab973f4b3cf1fae1f22de82fb2...29209cbe58e7a977ae7267b11da19250b6878028,1,18,2,20,3,2010-03-14 07:23:08,2010-03-11 07:15:43
29209cbe58e7a977ae7267b11da19250b6878028...b75aea8f5bea614f802256c436b06733486a2088,1,79,0,79,1,2010-03-14 07:23:22,2010-03-01 03:12:31
27a557a9ff9273ad47aa29c52e9903cf6405f7f7...a5487ddf0f8a8190b0722cf46dbe4cdd6ca9fa51,1,43,3,46,3,2010-01-10 18:05:34,2010-01-10 13:07:52
a5487ddf0f8a8190b0722cf46dbe4cdd6ca9fa51...ab0b41daf62ec3076e980fcad492b1997b35f22b,1,42,42,84,2,2010-01-10 18:05:52,2010-01-10 13:08:45
ab0b41daf62ec3076e980fcad492b1997b35f22b...2b541bf8be2bbd6cc8daf8e3d5d4a8ee30b2ce4e,4,96,1,97,9,2010-01-10 18:15:03,2010-01-10 13:11:22
2b541bf8be2bbd6cc8daf8e3d5d4a8ee30b2ce4e...6b02de3b9dc4ac8374cea4964e993ec6636d781c,1,10,4,14,3,2010-01-12 21:10:38,2010-01-12 19:53:29
5b15950ac414a8a2d4f5eb480712abcc9fe176d2...d08bae7e221727e26baab984b792854b842130d7,9,223,2,225,14,2010-01-20 20:29:05,2010-01-20 09:48:25
d08bae7e221727e26baab984b792854b842130d7...b09fe971dea73ff6f5296ce533a566114b23ca4e,9,139,20,159,29,2010-01-20 20:30:25,2010-01-20 09:48:26
b09fe971dea73ff6f5296ce533a566114b23ca4e...e2b53e58081e6a30309625fc6194ccb42772846b,1,15,17,32,3,2010-01-22 04:09:50,2010-01-22 00:21:38
e73bbd96c6e9ce11a101dac03402d0f718a1bd23...43a61b841d261fe51ac64b55d654677b0cd93ad9,1,17,21,38,7,2010-02-25 03:12:48,2010-02-25 00:48:11
43a61b841d261fe51ac64b55d654677b0cd93ad9...c88f0cc78e2bd387c9a2a47973a3c0a3b6328fec,1,2,2,4,1,2010-02-25 05:39:06,2010-02-25 05:39:06
c88f0cc78e2bd387c9a2a47973a3c0a3b6328fec...48716a232a41ad6bda2bfb381e8f84f7d72fede9,1,2,2,4,2,2010-03-05 06:03:35,2010-03-04 14:31:17
47a876a088d2611d5295b0779bd9cf2465848ecd...6c0efa2ac07f275c1edd11ae6646a647d7f19f36,4,23,3,26,5,2009-10-26 01:37:56,2009-10-26 01:37:56
8ef4c28b8d391ee053049d2dc9a3568b86c0dd38...3ed0b11e7e9a8a35956d2c8c39c51c8d8f5eac23,1,1,1,2,1,2009-10-20 07:01:23,2009-10-20 05:22:25
610f99ec7d22b5750f12350f67c1341d6be8030f...ffd5c8e457f8139ee89006083d97d47e17a066b8,1,2,2,4,2,2009-10-27 06:43:23,2009-10-23 06:39:04
ffd5c8e457f8139ee89006083d97d47e17a066b8...cb74a0ca61278b97d9e12af9ed9f7040ab13f507,2,673,0,673,2,2009-10-27 06:45:41,2009-10-20 02:41:59
cb74a0ca61278b97d9e12af9ed9f7040ab13f507...a5e9c7dfe4732b560ab5dfc75e718bfda2027990,1,3,2,5,3,2009-10-27 06:49:02,2009-10-20 02:42:00
a5e9c7dfe4732b560ab5dfc75e718bfda2027990...f1264bd65451a68e87e0f99c9601cfa1b3244db6,2,74,1,75,4,2009-10-27 06:51:31,2009-10-20 02:42:01
f1264bd65451a68e87e0f99c9601cfa1b3244db6...ce62683096d144749c77e557ecd21c91b840b0f1,3,811,0,811,3,2009-10-27 06:51:55,2009-10-20 02:42:02
ce62683096d144749c77e557ecd21c91b840b0f1...dff589ef949e97cbec5363b105ba27f6e85594fb,2,114,0,114,3,2009-10-27 06:54:24,2009-10-20 02:42:03
527b9d704d929a2fff2f9bf1c5e2856725c1416d...34f3999206e8ea41b9e4cf48e30ab1149e01d8a5,1,1,0,1,1,2010-01-19 01:01:29,2010-01-18 21:55:07
527b9d704d929a2fff2f9bf1c5e2856725c1416d...63b76948e1d211ad4a95c3a9c7a0087fe6a1e371,1,8,2,10,3,2009-12-18 05:54:28,2009-12-18 00:05:28
63b76948e1d211ad4a95c3a9c7a0087fe6a1e371...afab0fe052b8a6b36c3860f7673ee1e9731c1679,1,48,2,50,2,2009-12-18 05:54:50,2009-12-18 00:05:29
afab0fe052b8a6b36c3860f7673ee1e9731c1679...e49ca974d6ff2dda1ff4ee39e7cc33af33d1eb2a,1,1,1,2,1,2009-12-20 07:20:05,2009-12-19 12:04:03
4cb51a65a478ff005630d8806d01cd76a8889faf...4966688e55d543fe93f9ba270c0f8b71a2c2a53e,1,0,16,16,1,2009-12-11 00:22:42,2009-12-11 00:22:42
4966688e55d543fe93f9ba270c0f8b71a2c2a53e...e25e2b4201716a912b29397515a858238497dbdd,1,12,2,14,2,2009-12-12 23:32:07,2009-12-12 10:21:46
952dfc6944b29582482ff50a85c04879406c06ba...cd0f0f68e1074e684a014e1714104693097caabc,2,8,4,12,2,2009-12-30 09:05:21,2009-12-30 08:47:03
952dfc6944b29582482ff50a85c04879406c06ba...77cd6ab62108c2d4ddd4343abd9bae17c406be4b,1,10,1,11,3,2009-12-05 18:54:17,2009-12-04 20:07:47
77cd6ab62108c2d4ddd4343abd9bae17c406be4b...aa031314bf8189a15290d5bd0d85fa2a0307ceb7,4,11,5,16,7,2009-12-05 19:08:35,2009-12-05 19:08:35
c5b3e0f54950f983836970050406347ddf82b152...42671caa7d619da9d490e77c438845c1e638c54c,1,48,33,81,4,2009-11-14 23:22:07,2009-11-13 01:02:12
42671caa7d619da9d490e77c438845c1e638c54c...15f0b112d86001b0ae4be2555513c45b3cf65844,1,20,52,72,8,2009-11-14 23:22:09,2009-11-13 01:02:13
15f0b112d86001b0ae4be2555513c45b3cf65844...69ca37d2abe2ae92e3456341aeab2ad6a7380bf0,1,57,89,146,17,2009-11-14 23:22:10,2009-11-13 01:02:14
c5b3e0f54950f983836970050406347ddf82b152...753dc384dc2c4ab3e1049f695425cebf41ff7e6b,4,371,60,431,45,2009-11-14 21:37:59,2009-11-14 21:26:47
753dc384dc2c4ab3e1049f695425cebf41ff7e6b...1a30582b43e137e16b3486d83bb86b0eb090e13d,1,2,3,5,2,2009-11-14 22:34:13,2009-11-14 22:25:11
1a30582b43e137e16b3486d83bb86b0eb090e13d...e2f8617b266e320fd58ab584cae2ebe9906daaac,1,23,0,23,1,2009-11-14 22:43:59,2009-11-14 22:43:20
e2f8617b266e320fd58ab584cae2ebe9906daaac...6111b934991f3ea670ac2442806c976defc7b61c,4,139,2,141,10,2009-11-16 03:30:06,2009-11-16 02:57:16
6111b934991f3ea670ac2442806c976defc7b61c...ce45a45f24cc7b3ccc7f6ebcd0025559b4421bda,1,10,0,10,1,2009-11-17 07:33:58,2009-11-16 10:15:17
aa8dc9679a6a7daea261abe969af331c741a9f2c...1ddf5efc66d92282e3c654ebf263538a0df2ac24,1,1,1,2,1,2009-11-24 05:29:45,2009-11-24 03:07:42
1ddf5efc66d92282e3c654ebf263538a0df2ac24...0b624b4ceee63ce45135cdbb80f2807c20b48646,1,5,0,5,1,2009-11-24 05:31:01,2009-11-23 07:09:12
0b624b4ceee63ce45135cdbb80f2807c20b48646...4f366275189c06ec26c01ee5ace2f3831b2aa46a,4,20,5,25,9,2009-11-24 05:33:09,2009-11-23 17:43:50
f9bbaa384efd4c5c56b9a13d08680f6fc09324ca...6586b1f3465a93e908664ea24fa2f5ff47a587e3,1,5,1,6,2,2009-11-10 18:47:33,2009-11-09 15:04:47
6586b1f3465a93e908664ea24fa2f5ff47a587e3...d629c40b0b8b63b0c8b33d52dcba0ed202d898d7,1,0,1,1,1,2009-11-10 18:50:19,2009-11-09 15:04:58
66276d972c0682d49773c20ca67c33bdab9ab76d...9504f3d3d2e62cb6fba9e7c61c6fe69dec9053a4,3,16,8,24,7,2010-01-20 21:29:21,2010-01-20 21:29:21
c51f6ceed6a9a436f16f8b4f17eab1a3d17cffed...ee0400df4eb13ea9b1ee3f03a50e479048f1780f,1,1,1,2,1,2011-12-21 18:46:10,2011-12-21 14:56:00
8cc62c1677c99c5e204d2b51269b47b7557a79e0...d79d9e13375c43b8774b193ce725ac6c05b3865e,1,20,0,20,1,2009-11-04 19:29:46,2009-11-04 18:05:59
d79d9e13375c43b8774b193ce725ac6c05b3865e...5ca5377da017311a08f625e32c58a0d118e7fda6,1,23,0,23,1,2009-11-04 19:29:46,2009-11-04 18:06:00
eacf0117752780bf418d352a6ad2f033aeda1cce...a894ba17e636cd3dc9c58aa34d5b8211f849ecef,1,1,1,2,1,2013-01-21 00:34:32,2013-01-20 13:15:31
a894ba17e636cd3dc9c58aa34d5b8211f849ecef...29cf0d3873d78f8b94353b37d9d3e32e51766a90,1,6,3,9,3,2013-01-21 00:34:32,2013-01-20 13:15:32
29cf0d3873d78f8b94353b37d9d3e32e51766a90...fadf8c71510e3ff142afd1ecbc65703d7ff27c8b,2,8,1,9,3,2013-01-25 03:32:29,2013-01-20 13:15:33
fadf8c71510e3ff142afd1ecbc65703d7ff27c8b...62c814b6b60f5b5605e34c9806d874fe1088d416,1,10,0,10,2,2013-01-25 03:32:35,2013-01-20 13:15:34
62c814b6b60f5b5605e34c9806d874fe1088d416...cadbf5c7ed4ea60d2b776346586b224e774dca4b,1,2,2,4,2,2013-01-25 03:32:35,2013-01-20 13:15:35
cadbf5c7ed4ea60d2b776346586b224e774dca4b...0846b0c905a885720138e8194fb0289f121b5da1,1,4,4,8,2,2013-01-25 03:32:35,2013-01-20 13:15:36
0846b0c905a885720138e8194fb0289f121b5da1...d04c94a2ea21cb218b43be192d8569c0e669d080,1,7,3,10,3,2013-01-25 03:32:35,2013-01-20 13:15:37
d04c94a2ea21cb218b43be192d8569c0e669d080...f9640ac26ce0478695487f657718157bb7b4f804,1,14,14,28,11,2013-01-25 03:32:35,2013-01-20 13:15:38
f9640ac26ce0478695487f657718157bb7b4f804...3ac221a78eba2f447a7990fc5c4709853dc32fee,1,17,1,18,2,2013-01-28 17:55:14,2013-01-27 14:50:56
3ac221a78eba2f447a7990fc5c4709853dc32fee...ae6037bc710b248946ed715fd659ef535ea78980,1,1,1,2,1,2013-01-30 20:34:55,2013-01-30 19:30:10
eacf0117752780bf418d352a6ad2f033aeda1cce...47263f5875cc16055e8d5ff3d000f3d41434fcf6,1,2,2,4,2,2013-01-17 23:28:12,2012-10-10 21:02:18
47263f5875cc16055e8d5ff3d000f3d41434fcf6...9012f571b46d882dbaed3f31ab59a30d187b2d05,1,1,1,2,1,2013-01-17 23:28:12,2012-10-14 11:45:21
9012f571b46d882dbaed3f31ab59a30d187b2d05...2934a484fdaf9ceea4da2e9402a2f54dcaf59fb1,2,20,2,22,4,2013-01-17 23:28:12,2013-01-17 22:19:33
eacf0117752780bf418d352a6ad2f033aeda1cce...3968e302f8d09104da9ede15079f1133df6d3b68,2,69,1,70,2,2013-01-15 18:01:11,2013-01-15 13:02:39
eacf0117752780bf418d352a6ad2f033aeda1cce...e6bc8a33286599f99a3a7c38654c85b8d37d6605,1,11,0,11,2,2013-01-15 17:57:57,2013-01-09 19:43:38
173f9a7145ab71d8ea916840836246afc6db66ef...56291c141e5c95f1210c72b080674ba36bcf054e,1,2,1,3,1,2013-04-26 16:52:11,2013-04-26 09:18:16
56291c141e5c95f1210c72b080674ba36bcf054e...d87ec816cd2459a27c1d22ae3947d67c8b121bd1,1,10,5,15,5,2013-04-26 16:52:41,2013-04-26 09:18:07
d87ec816cd2459a27c1d22ae3947d67c8b121bd1...93cd8d970b327e916b6a0eca6377fd357d05b15c,1,6,5,11,2,2013-04-26 16:53:31,2013-04-26 09:17:56
93cd8d970b327e916b6a0eca6377fd357d05b15c...86c5e148c9100634f0714e61ac85f90f409e12c7,1,6,4,10,3,2013-04-26 16:53:52,2013-04-26 09:17:43
86c5e148c9100634f0714e61ac85f90f409e12c7...a8addfecf08ab9e3832eeac3f574fd0637a2970c,1,10,4,14,4,2013-04-26 16:54:31,2013-04-26 09:18:28
f678d9b5923b030287687dde020240c2d4709d79...aec3f77941205909f0671aa9767315a50e20ff87,1,25,0,25,2,2013-04-15 19:45:15,2013-04-15 19:45:15
aec3f77941205909f0671aa9767315a50e20ff87...afad20055888937b100798b597d924d087688645,1,6,3,9,3,2013-04-15 23:08:40,2013-04-15 21:47:28
afad20055888937b100798b597d924d087688645...95f31e9ab52b4377086acf7c4d070083e0bee039,1,1,0,1,1,2013-04-16 18:18:35,2010-09-04 08:25:09
004825d314db4ba3f34ef499e3522ef72792d896...b7b021701cea6c9e54c826e1f6bc5faa9d3fef53,1,1,1,2,1,2013-02-20 21:42:20,2013-02-20 19:53:33
b7b021701cea6c9e54c826e1f6bc5faa9d3fef53...e58e57e49eb990e38df19628a744c71b44397ef1,1,4,2,6,1,2013-02-20 21:42:21,2013-02-20 19:54:57
e58e57e49eb990e38df19628a744c71b44397ef1...97a83fa839d818130bfeca060279c4c355036785,3,22,35,57,28,2013-02-20 21:42:21,2013-02-20 19:55:28
97a83fa839d818130bfeca060279c4c355036785...030e9dd64f931c0ccfb6ad4be88775f8272f02eb,1,2,0,2,1,2013-02-20 21:42:21,2013-02-20 20:00:28
030e9dd64f931c0ccfb6ad4be88775f8272f02eb...8f9e3e498c113e987c2b8662485db5461cad1c36,1,4,5,9,3,2013-02-20 21:42:21,2013-02-20 20:00:43
8f9e3e498c113e987c2b8662485db5461cad1c36...6379dd052243aa6b1cc5115b72b78aedbeeed008,1,2,7,9,1,2013-02-20 21:42:21,2013-02-20 20:00:59
6379dd052243aa6b1cc5115b72b78aedbeeed008...090fd4fe24b9da9d912aa5856f4cd32d157924c6,1,14,21,35,11,2013-02-20 21:42:21,2013-02-20 20:01:26
090fd4fe24b9da9d912aa5856f4cd32d157924c6...756e676ca011083dd15264ec29e281c47297ae40,1,13,6,19,4,2013-02-20 21:42:21,2013-02-20 20:01:36
756e676ca011083dd15264ec29e281c47297ae40...e148542870013e40d02490e692818a62691c1a10,2,13,16,29,2,2013-02-20 21:42:21,2013-02-20 20:01:46
e148542870013e40d02490e692818a62691c1a10...cdf4fb8e332f9641ac1ca95e999fe98251d31392,10,19,35,54,20,2013-02-20 21:42:21,2013-02-20 20:01:56
cdf4fb8e332f9641ac1ca95e999fe98251d31392...0380942902b23f02f7f595bc394e09bcd74d4ded,3,36,15,51,10,2013-02-20 21:42:21,2013-02-20 20:02:10
0380942902b23f02f7f595bc394e09bcd74d4ded...819b929d3389f6007e1c469d9060e7876caeb97f,13,22,35,57,21,2013-02-20 21:42:21,2013-02-20 20:02:28
819b929d3389f6007e1c469d9060e7876caeb97f...047ec60205b5ae8b180386579749d143db4c9be3,3,4,3,7,3,2013-02-20 21:42:22,2013-02-20 20:02:45
047ec60205b5ae8b180386579749d143db4c9be3...74543a0423c96130b3b07946c20b10735c3b5b15,11,47,45,92,36,2013-02-20 21:42:22,2013-02-20 20:02:57
74543a0423c96130b3b07946c20b10735c3b5b15...4981fe750b1fc58bfdf5b9ca9843f4f505b9bb4d,6,69,59,128,25,2013-02-24 08:14:15,2013-02-23 22:31:34
4981fe750b1fc58bfdf5b9ca9843f4f505b9bb4d...85edf4f58b5368e2f2acc4bce0d10e1ca9d6c879,6,12,10,22,9,2013-02-24 08:17:38,2013-02-20 20:06:45
85edf4f58b5368e2f2acc4bce0d10e1ca9d6c879...5dbf43602de31cac518607b4d9a04a40d7b154c8,1,2,24,26,2,2013-02-24 08:17:38,2013-02-20 20:07:02
5dbf43602de31cac518607b4d9a04a40d7b154c8...b8054bbee70620b57e11ed78716bf187071bc368,1,59,59,118,2,2013-02-24 08:17:38,2013-02-20 20:07:11
b8054bbee70620b57e11ed78716bf187071bc368...2a4552021a92be17c7c4d2d2313df9913e8eb4bf,1,13,9,22,10,2013-02-24 08:17:38,2013-02-20 20:07:19
2a4552021a92be17c7c4d2d2313df9913e8eb4bf...2ad23273e71ff708936bd924502186b8789a7289,2,27,25,52,23,2013-03-21 15:03:32,2013-03-20 17:43:47
50a6b54c03219ad74b9f3f839e0321be18daeaf6...640d0401be5f29db8c9e914d8a19dbc9b950448d,1,4,2,6,2,2013-01-30 17:00:41,2013-01-28 01:18:14
640d0401be5f29db8c9e914d8a19dbc9b950448d...43722c4d9e04b3749372b13598b32cdceb1f1252,2,4,4,8,3,2013-01-30 17:00:41,2013-01-28 01:18:15
50a6b54c03219ad74b9f3f839e0321be18daeaf6...4f9273d27b399c9b6e0be372e607b9a8176c0699,1,1,1,2,1,2013-01-27 06:00:38,2013-01-27 03:11:04
4f9273d27b399c9b6e0be372e607b9a8176c0699...f629fa597c1736a419e2bd68bbca2883c6a143cf,1,9,5,14,2,2013-01-27 06:00:38,2013-01-27 03:11:05
f629fa597c1736a419e2bd68bbca2883c6a143cf...0f487d308d819cf6c64b866cb2f5c366a13b1639,2,6,0,6,2,2013-01-27 06:00:38,2013-01-27 03:11:06
0f487d308d819cf6c64b866cb2f5c366a13b1639...daa38f4ae0afdc6357c547d2f6bd5270e1e4151a,1,2,9,11,1,2013-01-27 06:00:38,2013-01-27 03:11:07
daa38f4ae0afdc6357c547d2f6bd5270e1e4151a...6112541b444b52d5ac83f491eabefbf571da4997,2,2,4,6,2,2013-01-27 06:00:38,2013-01-27 03:11:08
6112541b444b52d5ac83f491eabefbf571da4997...50038ba92a22743be8c105e16fb559a6d96c3a7a,2,23,30,53,5,2013-01-27 06:00:38,2013-01-27 03:11:09
50038ba92a22743be8c105e16fb559a6d96c3a7a...6492a1041a66f19589f6001400005a3913884882,1,5,2,7,1,2013-01-27 06:00:38,2013-01-27 03:11:10
6492a1041a66f19589f6001400005a3913884882...cfa96496bd9e7828c5626e2cd1353e9fb7d3d0c7,3,26,3,29,8,2013-01-27 06:00:39,2013-01-27 03:11:11
cfa96496bd9e7828c5626e2cd1353e9fb7d3d0c7...bb5ea62d80313f6fd37f3f3c214c78feb34036f9,1,0,9,9,1,2013-01-27 06:00:39,2013-01-27 03:11:12
bb5ea62d80313f6fd37f3f3c214c78feb34036f9...7f0e596276aa120059b0f2df235a8ba1cb9b2554,1,23,1,24,4,2013-01-27 06:00:39,2013-01-27 03:11:13
7f0e596276aa120059b0f2df235a8ba1cb9b2554...dfbf3937008c72cec25dc68da3362cb972a26078,1,117,0,117,1,2013-01-27 06:00:39,2013-01-27 03:11:14
dfbf3937008c72cec25dc68da3362cb972a26078...e93f8695939bae73fbf5122a9a8f53637dce8e39,1,1,0,1,1,2013-01-27 06:00:39,2013-01-27 03:11:15
e93f8695939bae73fbf5122a9a8f53637dce8e39...9d01ae9f20435b90619c909e9cbb9ca29f7de494,2,37,10,47,10,2013-01-27 06:00:39,2013-01-27 03:11:16
9d01ae9f20435b90619c909e9cbb9ca29f7de494...e9df0f9c7a7fbaed924273d0a9b502171ed23b7c,3,27,4,31,6,2013-01-27 06:00:39,2013-01-27 03:11:17
e9df0f9c7a7fbaed924273d0a9b502171ed23b7c...4cea4d66083f0f9116674f7ca54418f61bcf17b9,1,7,4,11,3,2013-01-27 06:00:39,2013-01-27 03:11:18
4cea4d66083f0f9116674f7ca54418f61bcf17b9...d20f0f8e2804bedc2c3743b523724ba7b8d34264,1,10,0,10,4,2013-01-27 06:00:39,2013-01-27 03:11:19
d20f0f8e2804bedc2c3743b523724ba7b8d34264...9bf28855108d7121e7c439da07175ff4c4f33e42,1,2,1,3,1,2013-01-27 06:00:39,2013-01-27 03:11:20
9bf28855108d7121e7c439da07175ff4c4f33e42...c7d34884ae1d37e910ce6813c9baeb06c0912228,1,3,2,5,2,2013-01-27 06:00:39,2013-01-27 03:11:21
c7d34884ae1d37e910ce6813c9baeb06c0912228...2abba3014e54920762eb81236e394af7b152f74c,1,2,1,3,1,2013-01-27 06:00:40,2013-01-27 03:11:22
2abba3014e54920762eb81236e394af7b152f74c...b345d6c3b7517912f1f35f8b235f8a78892d5796,1,9,6,15,2,2013-01-27 06:00:40,2013-01-27 03:11:23
b345d6c3b7517912f1f35f8b235f8a78892d5796...0d60903293d1a839541add545846c9a8b3967c5f,1,26,19,45,15,2013-01-27 06:00:40,2013-01-27 03:11:24
50a6b54c03219ad74b9f3f839e0321be18daeaf6...200ebe362cda2a520219f998d4b2c44767992bdb,1,1,1,2,1,2013-01-26 21:28:19,2013-01-26 09:42:45
200ebe362cda2a520219f998d4b2c44767992bdb...dd0d388c44c28ebc021a24eeddc60287d4ea249c,4,29,33,62,18,2013-01-26 21:28:21,2013-01-26 09:44:06
dd0d388c44c28ebc021a24eeddc60287d4ea249c...be5c9fb9049ed470e7005f159bb923a5f4de1309,3,57,21,78,4,2013-01-26 21:28:22,2013-01-26 09:44:28
08cfdbb88cd6225b4fc4b8a3cecd0e01758c835d...927a13fe87e4b2e0edabb2f8615f0851f70fbbd8,2,181,0,181,2,2011-10-18 07:01:18,2011-10-18 04:52:20
927a13fe87e4b2e0edabb2f8615f0851f70fbbd8...21e4631c076f4b7defcdbe3876873486352310f1,2,161,0,161,2,2011-10-21 20:55:59,2011-10-21 17:28:04
21e4631c076f4b7defcdbe3876873486352310f1...29eec71f21853f2428cdae83d6b04d4ae1084b7d,1,13,0,13,2,2011-10-21 20:56:54,2011-10-21 17:30:21
0b26d1e8b29a4248d56078318fec6906e3007742...1017c1abcb6d733e1de83eb5a1cf7e1bf4ad6aca,2,9,0,9,2,2012-01-24 22:18:18,2012-01-24 21:49:56
0b26d1e8b29a4248d56078318fec6906e3007742...425c771534f9f569d97d69106dc21043f812e506,1,17,1,18,5,2011-10-26 23:23:26,2011-10-26 23:23:26
cee426811c981c62c4b236ebdcb47d1c2945cf56...e831171d67469f3942c56433e3cd3c98fca15e72,3,952,0,952,4,2011-08-21 05:30:46,2011-08-20 22:40:40
e831171d67469f3942c56433e3cd3c98fca15e72...05f3dbba67ac15952e1bf005ee9fd8be3428831f,2,834,0,834,2,2011-08-21 05:30:46,2011-08-20 22:41:11
05f3dbba67ac15952e1bf005ee9fd8be3428831f...fca65d4b260912448c4f103ab3321fa2b82bf907,2,26,26,52,17,2011-08-21 05:33:57,2011-08-20 22:41:41
fca65d4b260912448c4f103ab3321fa2b82bf907...b95c5ada990ee2afb83af9be5b82d2804618a59d,2,25,11,36,15,2011-08-21 05:33:57,2011-08-20 22:41:57
b95c5ada990ee2afb83af9be5b82d2804618a59d...9eceddeec6ccdbcb0c6ce02a45357ffd5a428f39,3,49,23,72,11,2011-08-21 05:33:58,2011-08-20 22:42:18
9eceddeec6ccdbcb0c6ce02a45357ffd5a428f39...d190a0875ff0f33d60a4d7265f2098b35d162f68,3,6,36,42,7,2011-08-29 05:03:26,2011-08-28 20:08:46
cee426811c981c62c4b236ebdcb47d1c2945cf56...fdd7aa17f805b376f49a1bf031bf1b88eec89ddf,1,12,6,18,5,2011-08-19 07:09:17,2011-08-18 07:23:44
fdd7aa17f805b376f49a1bf031bf1b88eec89ddf...240dc3e8edb3ae4ee968febc006fa761811c60e6,1,100,53,153,47,2011-08-19 07:09:17,2011-08-18 07:23:45
240dc3e8edb3ae4ee968febc006fa761811c60e6...bc7a96a8965d4ce0651689301e1702a942dfb9f0,17,369,333,702,29,2011-08-19 07:09:19,2011-08-18 07:23:46
9963e025e88f134cf07ef348d80a5821c69a7eb0...a6253d107734c7ffa6d939307d87cf496795dc78,1,1,1,2,1,2011-05-25 20:08:10,2011-05-25 19:23:44
9963e025e88f134cf07ef348d80a5821c69a7eb0...09ffc706e48f93ed622a9a61704b2f767666b30d,6,6,8,14,8,2011-05-25 16:30:26,2011-05-24 16:40:32
9963e025e88f134cf07ef348d80a5821c69a7eb0...5b5e45949bb310fa8972f3e55b9cb05ce8047f37,1,6,2,8,4,2011-05-22 05:29:29,2011-05-21 19:11:33
5b5e45949bb310fa8972f3e55b9cb05ce8047f37...f792a0b88ec24dd20c29282b4e022c7b48abd59b,1,12,7,19,6,2011-05-22 05:29:30,2011-05-21 19:22:28
f792a0b88ec24dd20c29282b4e022c7b48abd59b...d64d6cdc2071d1eb7f6a45118edc42627e6fc692,1,25,24,49,11,2011-05-22 05:29:31,2011-05-21 19:25:14
d64d6cdc2071d1eb7f6a45118edc42627e6fc692...f12c66b9bb851aa7350d40370e6adf78535c5930,2,58,5,63,5,2011-05-22 05:29:31,2011-05-21 19:29:01
f12c66b9bb851aa7350d40370e6adf78535c5930...12f0967a8a1e3c11c678de181f77d1c7883b37cf,2,5,1,6,2,2011-05-22 05:29:32,2011-05-21 19:35:51
12f0967a8a1e3c11c678de181f77d1c7883b37cf...ea2ca4497bdb716977a3e2526780635cb6bac513,2,40,5,45,9,2011-05-22 05:29:32,2011-05-21 19:38:26
ea2ca4497bdb716977a3e2526780635cb6bac513...f5b7ce1b9041d19658b79d8b956d7e79ec6006bd,1,3,4,7,3,2011-05-22 05:29:33,2011-05-21 19:40:32
f5b7ce1b9041d19658b79d8b956d7e79ec6006bd...f143d9c695cd4c3e86069c536fa0dff04fc93e93,2,16,3,19,5,2011-05-23 18:39:13,2011-05-22 17:29:32
1618297f10c612af3e56187825e3f273e6bbdcdb...2b0b64ee850e72b9a88c821c418b1620fccf2092,2,19,1,20,2,2011-05-31 19:06:40,2011-05-31 19:06:40
4961210b17725e3e3e975d84a5f7f718da5f218e...4066bd6797a36ece00ffcb4814edc11e5ed25f68,2,44,7,51,6,2012-04-05 16:01:03,2012-04-05 12:30:08
4961210b17725e3e3e975d84a5f7f718da5f218e...5df3e2b3ca5ebe8123927a81d682993ad597a584,1,29,1,30,7,2011-05-23 17:54:54,2011-05-23 17:54:54
e38f2a88e56796d13c2a31192bc78ed930b89e54...6be0559183ac0b40680df314748141d1bdf28e41,3,14,11,25,8,2011-04-06 17:57:32,2011-04-06 17:57:32
6be0559183ac0b40680df314748141d1bdf28e41...c3f6163b0b6e2cfae1422050c9607db1130cded0,1,32,32,64,11,2011-04-07 07:37:45,2011-04-07 06:01:21
2d7f98bac7e1d8b42c558e179ea24f5b06512622...c4f3f551a61e138f8ace9523d6b16aff37b30302,6,37,58,95,25,2010-01-26 00:42:23,2010-01-26 00:33:57
c4f3f551a61e138f8ace9523d6b16aff37b30302...f4e6dcc36c37a6e62c8900ed657330356f6e2d8e,1,1,1,2,1,2010-01-26 00:43:28,2010-01-26 00:33:58
f4e6dcc36c37a6e62c8900ed657330356f6e2d8e...e3f67d30b20e49d8fc3eefe819808cba7998b060,2,17,1,18,3,2010-01-26 00:43:36,2010-01-26 00:33:59
2d7f98bac7e1d8b42c558e179ea24f5b06512622...c8610a2e7eca60a060f719f0aeb20f146e339de4,1,14,2,16,7,2010-01-25 23:42:55,2010-01-25 23:37:23
c8610a2e7eca60a060f719f0aeb20f146e339de4...5b594f457afcf2cdddb3c79de8bcc571c775aa55,3,468,49,517,39,2010-01-26 17:20:07,2010-01-25 22:51:39
9874fca7122563e28d699a911404fc49d2a24f1c...0d6accc01d4073d685ece5ba9fd0a439539a5a02,2,5,2,7,3,2015-03-10 22:27:59,2015-03-10 16:11:09
9874fca7122563e28d699a911404fc49d2a24f1c...2acc194075e936de147f3cb01e02ef39e064cc3c,1,19,0,19,1,2015-03-06 20:48:00,2015-03-04 14:10:28
2acc194075e936de147f3cb01e02ef39e064cc3c...53e53c7c81ce2c7c4cd45f95bc095b274cb28b76,1,2,5,7,2,2015-03-06 20:48:02,2015-03-04 14:10:29
9874fca7122563e28d699a911404fc49d2a24f1c...8fa7975b076ae039f63286601f48e64115e2aba7,1,2,3,5,2,2015-03-06 20:03:30,2015-03-02 12:02:37
9874fca7122563e28d699a911404fc49d2a24f1c...ec8a896eb54f326f65b4103307a50475424d9a03,1,13,65,78,34,2015-03-06 18:51:41,2015-03-06 09:43:33
ec8a896eb54f326f65b4103307a50475424d9a03...f8c65c1f97b364a8e90267e66193cf20aa60ca6e,1,12,2,14,7,2015-03-06 18:51:46,2015-03-06 09:43:34
f8c65c1f97b364a8e90267e66193cf20aa60ca6e...40555000935147f56896e75b919b25f1f2d23aca,3,35,0,35,5,2015-03-06 18:51:48,2015-03-06 09:43:35
9874fca7122563e28d699a911404fc49d2a24f1c...ef2956a5e2445470db93e392d640c664f3104ef8,1,2,2,4,2,2015-02-18 20:29:00,2015-02-18 17:32:20
9874fca7122563e28d699a911404fc49d2a24f1c...5d308512ffde7efa6b5aad9549320b394b79b740,4,0,4,4,4,2015-02-13 21:16:12,2015-02-13 14:47:39
9874fca7122563e28d699a911404fc49d2a24f1c...2879bc3b0c3acc89f0415ac0d0e3946599d9fc88,1,3,2,5,4,2015-02-13 19:31:54,2015-02-13 05:24:45
2879bc3b0c3acc89f0415ac0d0e3946599d9fc88...aab1beb0e1a66d31b0a9896e8c13009dece0aa45,1,10,10,20,2,2015-02-13 19:32:28,2015-02-13 05:24:46
bafc478f1618534fcb85bedc0fa224bd2d462441...ca87dd623d24590c4d48a922effa1d9e1e1fd253,1,1,1,2,1,2013-01-11 16:44:08,2013-01-11 08:06:22
bafc478f1618534fcb85bedc0fa224bd2d462441...9bcbb1c218d075d8b180cfef4c9089f868151e7e,3,17,8,25,12,2012-12-28 23:44:44,2012-12-28 23:29:31
bafc478f1618534fcb85bedc0fa224bd2d462441...14e1a4e1ff70aff36db3f5d2a8b806efd0134d50,2,3,3,6,3,2012-10-18 21:20:49,2012-10-18 14:43:28
bafc478f1618534fcb85bedc0fa224bd2d462441...84adb641545f4b58f9276adf099f840ea2928e44,3,26,6,32,3,2012-10-17 07:33:42,2012-10-17 07:05:51
bafc478f1618534fcb85bedc0fa224bd2d462441...5de7166d46d25fed3b8a181c3842cf4350ecdea4,1,17,6,23,5,2012-10-12 23:06:49,2012-10-12 22:53:46
bafc478f1618534fcb85bedc0fa224bd2d462441...cd6a0b265e4cbfd973e81b5f811e6d8eb4311b9b,1,4,2,6,4,2012-10-05 19:27:35,2012-10-05 04:41:01
cd6a0b265e4cbfd973e81b5f811e6d8eb4311b9b...4742d136e2c8423ce17ccd0ccf161d9f20d49847,1,9,6,15,7,2012-10-05 19:27:48,2012-10-05 04:41:02
bafc478f1618534fcb85bedc0fa224bd2d462441...30462a7483c0acf77fab6364a3f505d16b650f21,1,11,1,12,2,2012-10-05 03:30:27,2012-10-04 17:13:49
bafc478f1618534fcb85bedc0fa224bd2d462441...af9c9f97137dfb3f20a17d76520803c0312fd3e4,3,11,4,15,3,2012-09-25 18:31:48,2012-09-22 11:27:59
bafc478f1618534fcb85bedc0fa224bd2d462441...e5dce96e9e26f8e30291c79fa5647313c64b2150,1,6,0,6,1,2012-09-21 19:14:19,2012-09-21 19:09:42
51f3145c2834c8f1d94c5b7cf3790baf74b9f521...3b0820045a68fa84707768528f3af4520fbf3bf0,1,30,0,30,1,2012-09-12 18:46:31,2012-09-09 06:19:36
3b0820045a68fa84707768528f3af4520fbf3bf0...8db43d2935811319a1d427be4da2723f68516e62,1,15,0,15,1,2012-09-12 18:46:31,2012-09-09 06:19:37
8db43d2935811319a1d427be4da2723f68516e62...07c19e72c5f07ac687e87e49cbb4e128a8b26629,1,2,2,4,2,2012-09-12 18:46:31,2012-09-09 06:19:38
07c19e72c5f07ac687e87e49cbb4e128a8b26629...63c694534bbe93a188ed74396a1a3ace0b24d6ad,2,10,10,20,2,2012-09-12 18:46:31,2012-09-09 06:19:39
63c694534bbe93a188ed74396a1a3ace0b24d6ad...8bee93dd24731a1d2ef7c82d484a893cf68b6572,3,51,60,111,35,2012-09-12 18:46:31,2012-09-09 06:19:40
8bee93dd24731a1d2ef7c82d484a893cf68b6572...382a96711470489ea6e4e277accd3afc46526bfc,1,1,1,2,2,2012-09-12 18:46:31,2012-09-09 06:19:41
382a96711470489ea6e4e277accd3afc46526bfc...4c58f13ba67f9dbe67a351de61703a2db20712cc,2,2,15,17,3,2012-09-12 18:46:31,2012-09-09 06:19:42
4c58f13ba67f9dbe67a351de61703a2db20712cc...4ba159996f6c1b0d6dd0a2a8bd9d6f5b342a4aa5,3,25,15,40,8,2012-09-12 18:46:31,2012-09-09 06:19:43
4ba159996f6c1b0d6dd0a2a8bd9d6f5b342a4aa5...5096e4875303038ffc34af96c28cf2a2b7e103a6,1,4,27,31,7,2012-09-12 18:46:31,2012-09-09 06:19:44
5096e4875303038ffc34af96c28cf2a2b7e103a6...f537cfa7501de5e4dcdac55a95515e9a2ff880e3,1,18,19,37,8,2012-09-12 18:46:31,2012-09-09 06:19:45
f537cfa7501de5e4dcdac55a95515e9a2ff880e3...7418f1a0371fd935de6cbe718bbdd567070e9d17,1,3,3,6,2,2012-09-12 18:46:31,2012-09-09 06:19:46
7418f1a0371fd935de6cbe718bbdd567070e9d17...778e7543d20531bec93d5c9965f32541e78b8e34,2,2,2,4,2,2012-09-12 18:46:32,2012-09-09 06:19:47
778e7543d20531bec93d5c9965f32541e78b8e34...b285668dd23952b96d716aac769c0ed1080d11d3,1,10,11,21,1,2012-09-12 18:46:32,2012-09-09 06:19:48
b285668dd23952b96d716aac769c0ed1080d11d3...5f0fc64513c8cb638e0d6010005d8e86c9dbca3a,2,7,7,14,5,2012-09-12 18:46:32,2012-09-09 06:19:49
5f0fc64513c8cb638e0d6010005d8e86c9dbca3a...65119878548f869270fbc8d382f042cca3a6ad05,1,4,4,8,4,2012-09-16 06:33:58,2012-09-15 16:18:42
2c733fb24c10a9d7aacc51f956bf9b7881980870...cb102b083252b575b18afa8d4b4a4b1bc1ffdf9e,1,1,1,2,1,2012-07-10 03:42:54,2012-07-09 23:53:34
cb102b083252b575b18afa8d4b4a4b1bc1ffdf9e...be21d167b2a819fd2b4991a395e95906b3cb176a,1,1,1,2,1,2012-07-12 20:49:41,2012-07-12 20:46:49
be21d167b2a819fd2b4991a395e95906b3cb176a...44b85e89d70da5ee7fc688d4a9c021f6a419b363,2,13,3,16,3,2012-07-12 21:23:42,2012-07-12 20:51:37
52b9d2cf7fbde061bf0d3336e3a89d7333d5b23d...c4d2539af751ed394ee68c02fe688e75c647c5fe,2,26,0,26,2,2012-01-17 23:15:35,2012-01-17 21:04:31
284e3d280ea84957f5bedcb302848dbdcdbb9a62...87afe9a5ed759668e35513c44eacd2fd393ba658,1,7,5,12,4,2011-12-16 22:39:37,2011-12-16 22:39:37
55752fa8610ebc16a1ebda2bcaf73f82142dde30...c1355b7ffb6573ff7c76aef7d3bab664fb895dc8,5,17,0,17,7,2011-10-21 17:18:37,2011-10-21 07:09:29
ac2604cf5fb9fcf538289a470ecbe345f7f0c220...a14ad109115b29483b6e37d18159d850e2752c72,1,9,10,19,1,2012-06-07 17:09:02,2012-06-06 13:28:24
66f4b98ad9a8218ad97b7b2f1604b205072dda62...aad2a07cfcdc89fd63bf28a2ac2873712fb25e43,1,0,1,1,1,2011-12-05 19:15:45,2011-12-05 07:53:27
88d42af893ba2a5cff01506e623f3543ef78f9ed...795290e528deeb4b0578b366af6b4c0c6773e2c9,1,7,12,19,13,2011-10-19 17:11:42,2011-10-19 07:37:06
5366afaedecf78ba72b819b0dbb60bda3fce2ca0...34c4461ae3b353e8c931565d5527b98ed12e3735,1,12,1,13,3,2011-10-12 19:42:44,2011-10-12 19:42:44
af543833d4e10163af8045859cc081969fa5fcec...b9e63ddddc8928f39db6658bf6428a9b646e5ea5,2,66,6,72,7,2012-02-26 23:18:41,2012-02-25 19:11:16
b9e63ddddc8928f39db6658bf6428a9b646e5ea5...0f1930c58754a821bd51087ca4676e6a69cd4d2b,3,20,12,32,12,2012-02-26 23:32:53,2012-02-25 19:14:54
0f1930c58754a821bd51087ca4676e6a69cd4d2b...cbb08c2e0b41ab162838aa1e83b959bac91151e2,4,5,13,18,6,2012-02-28 19:48:11,2012-02-28 19:06:09
b648557ef1697df8a0db25efd74e280e6b23ce27...50963badbcfe2693d7a51ace3079c6b48ec52f01,1,6,1,7,2,2011-09-06 18:48:21,2011-09-06 18:48:21
e160da7f60e67ee548472d907ede3291bbc2a79e...ea925196f1bd3acaabaeaf384cc694337db97b2b,3,52,13,65,8,2009-12-03 19:37:47,2009-12-03 05:14:05
ea925196f1bd3acaabaeaf384cc694337db97b2b...e4597aae6590cbd6c868c0406ac5521221c4f465,2,30,12,42,5,2009-12-03 19:38:00,2009-12-03 05:14:06
e4597aae6590cbd6c868c0406ac5521221c4f465...904580122b5ac46a9a38e20b9cc032951d9e7982,1,11,7,18,1,2009-12-03 19:38:21,2009-12-03 05:14:07
e160da7f60e67ee548472d907ede3291bbc2a79e...92f676fce7fb1e67cb10c7c7d0b5e7521ff829b4,1,4,2,6,2,2009-12-01 20:26:32,2009-11-30 23:57:27
c0eb604330e1288300d915f25868d1eed88d3038...0def5b6ed4ffbc2cced3206acd6359178f7b8c5d,1,4,4,8,4,2010-01-12 21:18:27,2010-01-09 00:54:39
0def5b6ed4ffbc2cced3206acd6359178f7b8c5d...a8c37a0e011d67e3192834a0fffe17452ea57a08,1,3,2,5,2,2010-01-12 23:48:24,2010-01-07 14:54:10
c0eb604330e1288300d915f25868d1eed88d3038...ebdc302e3e930ec7f3f6e818ecc815a7a5f01781,1,1,1,2,1,2010-01-12 07:16:16,2010-01-12 05:20:55
ebdc302e3e930ec7f3f6e818ecc815a7a5f01781...f1c92c6369511396ab3a409b5c9957066b72f6a3,2,1,3,4,2,2010-01-12 07:16:16,2010-01-12 06:21:18
f1c92c6369511396ab3a409b5c9957066b72f6a3...cc5711424b7ae36276a40c06ede5d95f87ca20f0,2,1,2,3,2,2010-01-12 07:16:16,2010-01-12 06:23:35
cc5711424b7ae36276a40c06ede5d95f87ca20f0...83e41e2e61f535d5b432437d4e8ac89c710fc482,2,8,11,19,4,2010-01-12 09:06:08,2010-01-12 06:26:08
83e41e2e61f535d5b432437d4e8ac89c710fc482...61b97df7d9da21acbd8179e6700f35c8366df9ff,2,1,4,5,2,2010-01-12 09:06:08,2010-01-12 06:27:31
61b97df7d9da21acbd8179e6700f35c8366df9ff...41064ebc4920fadb6afafe5f09865d2558921c00,2,5,5,10,3,2010-01-12 09:06:08,2010-01-12 06:28:45
41064ebc4920fadb6afafe5f09865d2558921c00...87b29e5a5ab02f10505fca567d027b57d2a9314e,2,4,4,8,5,2010-01-12 09:06:08,2010-01-12 06:29:35
87b29e5a5ab02f10505fca567d027b57d2a9314e...5092d3ec21ab335e5908fd8abfe99bbc13812606,1,1,1,2,1,2010-01-12 09:06:08,2010-01-12 06:30:36
5092d3ec21ab335e5908fd8abfe99bbc13812606...758e915b8a220ebe967edf745eb699b30d501993,2,1,2,3,2,2010-01-12 09:06:08,2010-01-12 06:31:06
758e915b8a220ebe967edf745eb699b30d501993...cb58c932a58e704b840ede37c55ce3e59a9e7544,1,1,1,2,1,2010-01-12 09:06:08,2010-01-12 06:31:58
cb58c932a58e704b840ede37c55ce3e59a9e7544...5e133b8cf9b9b7f9483c47d19ffb40e10827ae51,2,1,2,3,2,2010-01-12 09:06:09,2010-01-12 06:32:29
5e133b8cf9b9b7f9483c47d19ffb40e10827ae51...42b3b0061478f262118036286455a8f09a0d3fff,2,0,6,6,2,2010-01-12 09:06:09,2010-01-12 05:11:22
42b3b0061478f262118036286455a8f09a0d3fff...356521ab22fb76e17aa8dc9993ff81fade49e11c,2,0,9,9,2,2010-01-12 09:06:09,2010-01-12 05:17:56
356521ab22fb76e17aa8dc9993ff81fade49e11c...229d8107470ded5e5e6c43cf5daeabf382cce9d1,2,0,8,8,2,2010-01-12 09:06:09,2010-01-12 05:16:26
229d8107470ded5e5e6c43cf5daeabf382cce9d1...c76189875b35ca04d42df915cd902a33fdbcb9b0,2,0,26,26,2,2010-01-18 06:49:36,2010-01-12 05:15:12
c76189875b35ca04d42df915cd902a33fdbcb9b0...64161a6b23920c96485131fb51d82d8ca13b4e1d,2,0,33,33,2,2010-01-18 06:49:36,2010-01-12 05:18:20
64161a6b23920c96485131fb51d82d8ca13b4e1d...837d395a5c0b98ab938d71db8e2b6b9f69ddcc4d,2,8,22,30,2,2010-01-19 01:04:02,2010-01-18 18:06:28
837d395a5c0b98ab938d71db8e2b6b9f69ddcc4d...23418ea95f83177df19bfe18af33650b87ec2a8a,2,1,2,3,2,2010-01-20 22:37:17,2010-01-12 07:52:47
d4c813d47d5c4f821a6947a29e4a480ec6522f44...c32c95916549331a581fadfa749c4322c14ccd78,1,2,2,4,2,2012-03-23 18:22:04,2012-03-23 15:02:43
8ef2794ba8ada6b64afb22ff7b235dce583b9712...f9db19214a15a1c384dd895ccda2a455824179cd,1,4,3,7,1,2012-09-24 19:38:41,2012-09-24 17:41:26
8ef2794ba8ada6b64afb22ff7b235dce583b9712...59bfdfb82a0e51f6e0a40197cd662196406b1bec,1,6,1,7,2,2012-09-21 16:44:11,2012-09-21 05:32:52
59bfdfb82a0e51f6e0a40197cd662196406b1bec...a22e6f85470f47d33ce392a11a5f9e2bb9a5c308,1,24,2,26,5,2012-09-21 16:49:47,2012-09-21 05:34:55
a22e6f85470f47d33ce392a11a5f9e2bb9a5c308...74eb32d3a49c490b0322fb9e4100b5bb08ef7f2a,2,2,2,4,2,2012-09-21 16:50:13,2012-09-21 05:38:46
8e950dab86eafa8f4ea671fab593ca6210bc2e15...e5c52c9898de5f829317729afc0416825531b0d5,2,5,2,7,2,2012-10-14 04:59:13,2012-10-14 00:03:07
e5c52c9898de5f829317729afc0416825531b0d5...96b9e0e313604f77456906ce58db8f366e47f2ab,3,11,2,13,4,2012-10-14 04:59:16,2012-10-14 00:04:02
96b9e0e313604f77456906ce58db8f366e47f2ab...e8ef401cd0ff5d51b148c1b1297dab6ef32227c1,2,12,0,12,2,2012-10-14 17:14:46,2012-10-14 08:53:59
e8ef401cd0ff5d51b148c1b1297dab6ef32227c1...8f2bbe452e2c2917ec3c9a5d1593f26908cab83b,1,3,3,6,3,2012-10-14 17:14:52,2012-10-14 08:46:00
829a1c616967176ccd859c18a6e8ca0dda77f75a...51bbccfd1b4a9e2807413022c56ab05c835164fb,1,13,3,16,5,2012-08-14 22:38:32,2012-08-14 22:15:53
a080558ed77952b2394499531edc324eb2885d67...fed23693ba1a1ea7beb851cd385d458136e91664,1,45,1,46,5,2012-01-26 19:34:40,2012-01-25 23:48:22
fed23693ba1a1ea7beb851cd385d458136e91664...c5665efed2619fae9ec5a57c555c89a91804e886,1,87,7,94,7,2012-01-26 19:34:44,2012-01-25 23:48:23
c5665efed2619fae9ec5a57c555c89a91804e886...3558f32f1f5fdb3d566e39f6e07cd3f97d124da6,1,1,1,2,1,2012-01-26 19:35:40,2012-01-25 23:48:24
3558f32f1f5fdb3d566e39f6e07cd3f97d124da6...e7d7a56796c457b0a96e58e7638950db824b52af,1,4,4,8,4,2012-01-26 19:40:09,2012-01-26 19:40:09
abe199808c6586047fb7255b80e3d17ffc26bf6c...8ced1aa08f9e1798b2b3fec41a0598ef79b477fe,2,8,0,8,2,2012-06-26 18:11:14,2012-06-26 15:06:42
abe199808c6586047fb7255b80e3d17ffc26bf6c...8338f771fe9720766dfcb25b6dca58832e24a0fd,2,12,1,13,2,2012-05-08 17:36:55,2012-05-08 17:22:33
f174a2583c9f42315b60205890fa67a79a1f1669...d956a20a69bc5aca954994ba0a33338ec5b1cc99,1,3,2,5,2,2014-11-07 19:57:57,2014-11-07 19:55:40
f174a2583c9f42315b60205890fa67a79a1f1669...ab03803c02ef6b41ed5086771bab2de4860c96a9,1,6,0,6,2,2014-01-31 17:55:29,2014-01-31 06:25:12
f174a2583c9f42315b60205890fa67a79a1f1669...d020e27fdaeb7d04247cdf5a0ff84d97626d5f5a,1,10,1,11,1,2013-02-24 07:52:39,2013-02-23 16:48:45
d020e27fdaeb7d04247cdf5a0ff84d97626d5f5a...dd281f09b7eab86e4983b37d011cbfb0f593f6b8,1,10,7,17,3,2013-02-26 21:01:34,2013-02-26 20:47:01
dd281f09b7eab86e4983b37d011cbfb0f593f6b8...b174eb42d08eeb32ae7341ff46b05c20d38abc2b,1,54,0,54,1,2013-03-06 21:58:56,2013-03-06 21:36:12
f174a2583c9f42315b60205890fa67a79a1f1669...1e1fe52923a8f582c4f50b41f0dd978d5d7c9bd3,1,7,2,9,6,2013-02-19 00:33:07,2013-02-15 20:32:19
1e1fe52923a8f582c4f50b41f0dd978d5d7c9bd3...b62fb077d5504deadea931fd16075729f39b8f47,1,39,0,39,3,2013-02-20 05:47:22,2013-02-15 20:50:35
b62fb077d5504deadea931fd16075729f39b8f47...e174744ad17a55d4df68cec97bfbf6b0c28e762b,1,19,0,19,2,2013-02-20 05:47:22,2013-02-15 20:59:53
f174a2583c9f42315b60205890fa67a79a1f1669...57d84f8d93a0e0818fc403c5b1a2ba73ce0eca5a,1,1,5,6,6,2012-08-06 17:01:21,2012-08-06 11:27:09
f174a2583c9f42315b60205890fa67a79a1f1669...ee922391864026097a196f97ecb14548ab2bf211,1,0,1,1,1,2012-08-05 19:42:14,2012-08-02 22:25:30
f174a2583c9f42315b60205890fa67a79a1f1669...b31272f704d03258a90b0e83e0f5c8df5c038ae6,1,21,4,25,5,2012-07-02 07:54:19,2012-07-02 07:54:00
f174a2583c9f42315b60205890fa67a79a1f1669...c20f592611c2760a14d37fa1780afd2093159aeb,1,5,7,12,5,2012-06-28 23:09:40,2012-06-27 18:51:15
c20f592611c2760a14d37fa1780afd2093159aeb...3b069b1beba6d851401032260a8030448637ece5,1,11,16,27,4,2012-06-28 23:09:40,2012-06-27 19:05:52
3b069b1beba6d851401032260a8030448637ece5...4682d8521c3ce9d722bd214fd7d5fc92063fdacb,4,55,31,86,10,2012-06-28 23:18:19,2012-06-28 03:14:47
f174a2583c9f42315b60205890fa67a79a1f1669...46284dd1528d7bff53a4ef7c398648da91ea0842,4,51,16,67,15,2012-06-19 20:37:02,2012-06-19 18:24:50
f174a2583c9f42315b60205890fa67a79a1f1669...cbbc935ce0ce51ecb51bea7f841d578297f8b8ae,1,1,1,2,1,2012-06-10 07:49:00,2012-06-10 07:38:03
f174a2583c9f42315b60205890fa67a79a1f1669...fc456751102ededf8405446e70c228836d390f81,1,17,11,28,4,2012-05-20 22:12:22,2012-05-20 14:32:39
fc456751102ededf8405446e70c228836d390f81...2b3873ff34ff937dad729407da4308be6a5bcd66,1,9,6,15,3,2012-05-20 22:12:25,2012-05-20 14:32:54
2b3873ff34ff937dad729407da4308be6a5bcd66...526a858a99ace6698823740374edc3e35b87901a,4,41,3,44,6,2012-05-20 22:25:46,2012-05-20 14:33:07
526a858a99ace6698823740374edc3e35b87901a...ec83061156e18ce600384d3c57f90729a9295488,1,2,5,7,2,2012-05-21 22:02:08,2012-05-21 16:10:09
f174a2583c9f42315b60205890fa67a79a1f1669...49dc2cc2c97cd76435d7f1609f2c573b64efd5b6,1,36,39,75,18,2012-05-08 16:13:00,2012-05-01 11:25:24
f174a2583c9f42315b60205890fa67a79a1f1669...c598c5aa01c9a6a877986ac4a99074fc65445141,1,9,5,14,1,2012-05-07 22:27:56,2012-05-05 10:03:52
f174a2583c9f42315b60205890fa67a79a1f1669...481ed2360295f6f5cea43aabb138eaae52539c1e,1,1,1,2,1,2012-05-07 19:32:10,2012-05-07 19:23:13
f174a2583c9f42315b60205890fa67a79a1f1669...2385f24625cda7cc050996d9966e57be2d4d11a3,1,1,1,2,1,2012-05-07 18:25:04,2012-05-06 18:17:15
f174a2583c9f42315b60205890fa67a79a1f1669...f71db097efa1cdd304bfa2dd6d365592c1866543,1,1,1,2,1,2012-05-01 19:11:11,2012-05-01 17:55:00
f71db097efa1cdd304bfa2dd6d365592c1866543...0754e089c1ffc6a40574eee0564ef98b3acacc26,2,2,2,4,2,2012-05-01 20:32:17,2012-05-01 20:18:18
f174a2583c9f42315b60205890fa67a79a1f1669...3e065308cab1ac0855bf19be8881def74bfcf7fc,2,13,1,14,2,2012-05-01 16:56:37,2012-04-30 20:28:25
3e065308cab1ac0855bf19be8881def74bfcf7fc...fafd38299bb6ff5634de89bcca35f622005d0279,1,16,0,16,1,2012-05-01 17:29:50,2012-05-01 17:29:43
f174a2583c9f42315b60205890fa67a79a1f1669...e65ceb61cd7d3fabedea8cb545f8c210b48552d4,1,8,8,16,7,2012-03-06 22:48:24,2012-03-02 22:34:24
f174a2583c9f42315b60205890fa67a79a1f1669...36612e4daf8b5b5eaf16315aa13c66925f878cd6,2,20,1,21,2,2012-02-28 19:45:31,2012-02-28 18:41:47
f174a2583c9f42315b60205890fa67a79a1f1669...3f6d56de5f99ec5f0667bef4411f2515b253a5b2,2,8,6,14,5,2012-02-07 20:14:40,2012-02-07 19:55:48
f174a2583c9f42315b60205890fa67a79a1f1669...701825de23da2bff6c784d33ff27f75e802abd81,1,1,0,1,1,2012-02-07 16:59:40,2012-02-07 04:05:48
f174a2583c9f42315b60205890fa67a79a1f1669...ca51699961664890fdaabd276af539e6b3514053,1,34,32,66,4,2012-02-06 18:00:42,2012-02-06 08:13:12
ca51699961664890fdaabd276af539e6b3514053...fb630e048c6efabe4d46b1b125fe7348062d38e6,1,5,1,6,2,2012-02-06 18:00:51,2012-02-06 08:13:42
fb630e048c6efabe4d46b1b125fe7348062d38e6...31fd8d72f2eb82c2b6d8d450ee4e13a3925291c3,2,25,10,35,4,2012-02-09 04:44:39,2012-02-06 18:13:27
5238cbf65638d7a097bdb5ca8226f5acbe31f143...c34fe6304c0162c526b74e8639c94d8d026615fd,1,10,3,13,3,2012-02-23 19:10:10,2012-02-23 10:04:34
5238cbf65638d7a097bdb5ca8226f5acbe31f143...d202a513a4d377d3ea319bb1c5c7ae0548a3b581,1,1,1,2,1,2012-02-13 21:25:40,2012-02-13 20:17:14
901c907d83f523a5df0b10c0aafb19c512836624...8f83acf77cd14567dfdeff0e15f2da086109df70,1,5,0,5,1,2012-01-13 07:31:41,2012-01-13 07:31:41
55dcc2ebad1b3ed4a6912f6f401f63cd3c71026f...be4d2920c24ba0be84ceff7e382cce2c5f1ad867,2,15,1,16,2,2012-01-10 22:27:14,2012-01-10 22:27:14
3e6e0edde20f536b28cf1dac04c7376000bfc701...bafe763197cb6535e5b4956ffeaa4e26ebb10651,1,3,3,6,1,2012-01-17 00:26:24,2012-01-16 09:46:07
bafe763197cb6535e5b4956ffeaa4e26ebb10651...7f08c6858ecfdf29f9713cf3a0b3699192f01a94,2,27,7,34,3,2012-01-17 00:26:24,2012-01-16 09:46:08
7f08c6858ecfdf29f9713cf3a0b3699192f01a94...c39852c18dc7efa794bbe20b10ecfe7038409727,1,58,43,101,3,2012-01-17 00:26:25,2012-01-16 09:46:09
c39852c18dc7efa794bbe20b10ecfe7038409727...f034d3549fa34e65ca09ee9ce721dcf43faefd1d,1,24,17,41,2,2012-01-17 00:26:25,2012-01-16 09:46:10
f034d3549fa34e65ca09ee9ce721dcf43faefd1d...960b7d1c62bb8010954890b090546382161ae731,1,25,14,39,3,2012-01-17 00:26:25,2012-01-16 09:46:11
960b7d1c62bb8010954890b090546382161ae731...6f48d39fa4d3e364c81d3cbbbd656c804b9ec873,2,31,28,59,14,2012-01-17 00:26:25,2012-01-16 09:46:12
6f48d39fa4d3e364c81d3cbbbd656c804b9ec873...9e5850460164f49dc9ae47569838084f5572846d,1,16,14,30,7,2012-01-17 00:26:26,2012-01-16 09:46:13
9e5850460164f49dc9ae47569838084f5572846d...920b691fe4da8115f9b79901411c0cc5fff17efe,3,6,21,27,4,2012-01-17 00:26:26,2012-01-16 09:46:14
920b691fe4da8115f9b79901411c0cc5fff17efe...5a7d5b683f869d3e3884a89775241afa515da9e7,4,46,3,49,7,2012-01-17 00:26:26,2012-01-16 09:46:15
5a7d5b683f869d3e3884a89775241afa515da9e7...2857093ba15982d21ff0d5a9fd65294ac895cb67,4,20,16,36,5,2012-01-17 00:26:27,2012-01-16 09:46:16
2857093ba15982d21ff0d5a9fd65294ac895cb67...dad0b3d8e5586ff8c901a6bd643ea9bfe55d75a7,1,2,0,2,2,2012-01-24 00:38:42,2012-01-24 00:34:22
dad0b3d8e5586ff8c901a6bd643ea9bfe55d75a7...9049816140e75d3f7b15264e97e042f5ab0bf392,3,15,12,27,10,2012-01-24 18:05:15,2012-01-24 11:10:38
896a681698489e7e21891076ce932a97468ca4c6...43b82bd9c3a5ad597bbfc0c12a519d4053df01b8,2,9,3,12,3,2012-01-12 00:35:37,2012-01-11 23:31:06
43b82bd9c3a5ad597bbfc0c12a519d4053df01b8...329afb8e976b2605bbc92a6ac8ef63f9a6c98ef1,1,1,1,2,1,2012-01-12 00:35:38,2012-01-11 23:31:07
329afb8e976b2605bbc92a6ac8ef63f9a6c98ef1...6ee9a9993fcbe5dae356013c51cfed1e39eeaf01,1,2,1,3,1,2012-01-12 00:35:38,2012-01-11 23:31:08
6ee9a9993fcbe5dae356013c51cfed1e39eeaf01...2ea09b5ace46bf8292afe9c2b83b4a6580218bdf,1,2,2,4,2,2012-01-12 00:35:38,2012-01-11 23:31:09
2ea09b5ace46bf8292afe9c2b83b4a6580218bdf...42d8c2799062bafc538d511a0262f76e23c99421,2,392,0,392,2,2012-01-12 00:35:39,2012-01-11 23:31:10
8f41c07f90da5e314cbc428f1e3e936563f7f39d...b323c6451d9cae4f289d2600ce6d609dbfde40f7,1,1,1,2,1,2011-10-31 19:31:42,2011-10-31 14:07:27
10b2a48113b8ab6b8f48229eb40fc3637ce025ae...0f77dea9a80302b3b9acd1097fa3f2315d8aef0f,3,4,2,6,4,2011-10-31 01:44:28,2011-10-24 16:02:09
0f77dea9a80302b3b9acd1097fa3f2315d8aef0f...f0bd664977b25e68c1230a533dd644706cff3ae2,1,13,6,19,5,2011-10-31 01:45:16,2011-10-24 16:02:10
f0bd664977b25e68c1230a533dd644706cff3ae2...c09cd77ea2fe3580b33918a99fe138d239ac2aaf,4,31,55,86,21,2011-10-31 01:45:21,2011-10-24 16:02:11
c09cd77ea2fe3580b33918a99fe138d239ac2aaf...2d52ea93a7ca451b967f180e0ea0d32404749a66,1,1,1,2,1,2011-11-01 17:02:11,2011-11-01 11:56:21
10b2a48113b8ab6b8f48229eb40fc3637ce025ae...debed2a6291a29fd7b0e96f63fbf0142ed3280eb,2,31,51,82,20,2011-10-26 22:25:59,2011-10-24 21:59:14
debed2a6291a29fd7b0e96f63fbf0142ed3280eb...ee7825b58cd423ea63a215c59fc2b7c7a2878af5,1,1,1,2,1,2011-10-26 22:25:59,2011-10-25 18:00:04
96b8d93a539f3a9f43f0fc38214db8753cac3c2e...0074d18dc0d816f9842d3e0e1cd0b26341715b37,1,5,1,6,2,2011-12-20 21:22:41,2011-12-20 21:20:56
96b8d93a539f3a9f43f0fc38214db8753cac3c2e...ba3c69a9ee1894de397b60d3b548383e13ef49e3,7,95,13,108,31,2011-11-13 06:27:37,2011-10-06 00:23:20
16f5bfcf65b46260f3a4fc66769e8b5cfd18a11a...27c0f768843b6d844674f1fb8dc2676d830b56e3,2,2,2,4,2,2011-10-09 20:28:04,2011-09-11 19:39:32
111ee18c31f9bac9436426399355facc79238566...1816bf26eccc0452d5db144f53020879c111c0dc,1,3,3,6,1,2011-08-30 17:15:04,2011-08-30 08:27:35
b704a8b3fd1d5a2eeeeadcef48c962db2c84b0af...381f0d3bd917fa94309214ebe6990c3174a46f4f,1,1,1,2,1,2011-08-31 00:07:09,2011-08-29 20:09:25
b704a8b3fd1d5a2eeeeadcef48c962db2c84b0af...88d78911accc2b6c44732a1b6f6e9540c519d463,1,31,1,32,3,2011-08-04 22:37:38,2011-08-04 12:01:03
88d78911accc2b6c44732a1b6f6e9540c519d463...6021be866f904914e901d55f07adee980335d07d,1,134,134,268,29,2011-08-05 17:01:30,2011-08-05 11:31:30
6021be866f904914e901d55f07adee980335d07d...eef12a9a7782bfe12f1ef870aa73143622be2ac1,1,18,9,27,9,2011-08-05 17:04:44,2011-08-05 11:31:31
eef12a9a7782bfe12f1ef870aa73143622be2ac1...43b8ff4b149bb3e17271608380b4a73c2e290b77,1,8,10,18,6,2011-08-05 17:13:21,2011-08-05 17:09:23
43b8ff4b149bb3e17271608380b4a73c2e290b77...24c512803dadf61b2f7f8965735b7c3a03f6147e,4,40,3,43,5,2011-08-09 17:26:18,2011-08-09 02:11:54
7ca97f6ecc66f1d70ca126edd33b6a3065c914f7...9aa7c16f5ec96de9b5fe7b272832fbb061d1fee2,1,8,11,19,6,2011-08-29 16:49:42,2011-08-29 09:32:23
8499644ea7af87c02f9b878f162aa6facbd5b8a7...a47a645e7057f28441f0f4b259db11171158553a,1,0,32,32,1,2011-08-17 17:39:47,2011-08-17 12:22:13
9db19414582fdb154384ff1ca457cbf9095fef48...0f891e7d7eb54f9dca93dc3d462eb38082a3460f,3,88,75,163,5,2011-05-08 19:55:34,2011-05-08 19:55:34
9db19414582fdb154384ff1ca457cbf9095fef48...5e31075a19acdd242996c83728b3c8e965af0d7b,1,2,1,3,1,2011-04-13 18:02:49,2011-04-10 15:39:14
5e31075a19acdd242996c83728b3c8e965af0d7b...0353a0c4ec91cf2d0a8e209025aa2e1909d05f19,8,11,14,25,13,2011-04-13 18:59:11,2011-04-13 15:39:40
67f8d5b87d8ec3dcdb311f31b534332b74c93142...b0fa280751a8a3e7cee093a7fdc3656490abf984,1,7,0,7,1,2012-02-27 23:36:08,2012-02-27 23:36:08
7c0be4da5cab4efd89ee6583f7009d648a75a725...e9e921981d10554a325f4a1e67e920947e0e4800,1,3,3,6,3,2010-02-20 03:03:24,2010-02-15 12:33:06
6d69b6f6ac27ab6f71a10da34b813ca25fd2a358...690b61f5f13db05aa4ad0efc422bd01aef3c1367,1,0,2,2,1,2007-09-29 08:40:19,2007-09-27 10:51:18
690b61f5f13db05aa4ad0efc422bd01aef3c1367...b315c5c08139c0d3c1e4867a305334e29da01d07,13,48,47,95,36,2007-09-29 09:13:33,2007-09-27 10:58:23
b315c5c08139c0d3c1e4867a305334e29da01d07...387e7e19d7eb5444be8da8e99ed7491989dc1cbb,5,14,31,45,11,2007-09-30 04:26:10,2007-09-27 13:25:55
387e7e19d7eb5444be8da8e99ed7491989dc1cbb...9a76adebd6dfe144c3643e7e877fff2b41be5c8e,1,11,16,27,10,2007-09-30 04:39:29,2007-09-27 11:33:19
a17ba31b0b75365e1245e494d46abae4afc57480...586801650824f0f7b62c34a206b6a60ffbcd8be0,2,18,9,27,8,2007-09-27 08:19:42,2007-09-18 00:06:44
586801650824f0f7b62c34a206b6a60ffbcd8be0...d8b7db0abfd0c74478964f5a9b08ad141f4f7f82,2,27,5,32,5,2007-09-27 08:29:56,2007-09-18 00:06:47
8419d2ee9ba8b375186a5c1019df8dfbce610aba...b78281f7215c0236da6bd5c04ec5e500c83fd101,1,2,0,2,1,2007-09-14 19:12:32,2007-09-14 19:12:32
b78281f7215c0236da6bd5c04ec5e500c83fd101...0024a54923a12f8c05ce4290f5ebefab0cce4336,3,19,3,22,4,2007-09-14 19:12:57,2007-09-14 17:39:48
0024a54923a12f8c05ce4290f5ebefab0cce4336...42b5f8693eddbbd486579fb2304db1bc7282ac26,1,3,2,5,2,2007-09-14 19:17:11,2007-09-14 18:38:02
42b5f8693eddbbd486579fb2304db1bc7282ac26...43b98acc23306fd7fff888477937063361a09593,2,11,2,13,4,2007-09-14 21:30:05,2007-09-14 08:29:04
43b98acc23306fd7fff888477937063361a09593...7c8b5eaf225db0b6b502126fc16f8f6814c38d24,1,1,1,2,1,2007-09-14 21:51:08,2007-09-14 21:51:08
9346b4e1ad2d03541f18b38f7e9fb7ad0ca6434e...ce0cbad7727457854d631a6314d9aee7c837cb65,1,48,42,90,11,2007-09-18 09:58:13,2007-09-17 03:28:20
ce0cbad7727457854d631a6314d9aee7c837cb65...77c11e064c5daadeb42e79b7fc6b28857e9b6bb6,1,26,17,43,3,2007-09-18 09:58:20,2007-09-17 03:28:29
77c11e064c5daadeb42e79b7fc6b28857e9b6bb6...53271411e7c4d9b92cc5aa1cc02492e9a3593d23,1,7,11,18,8,2007-09-18 09:58:23,2007-09-17 03:28:36
53271411e7c4d9b92cc5aa1cc02492e9a3593d23...7f8cfadf218c8b28caf52b1490fb8b881945b0ea,1,38,0,38,1,2007-09-18 10:14:16,2007-09-18 07:26:01
7f8cfadf218c8b28caf52b1490fb8b881945b0ea...e3490268120946cfae737ab3a884b082e962209d,1,64,0,64,1,2007-09-18 10:14:18,2007-09-18 07:26:27
e3490268120946cfae737ab3a884b082e962209d...76bf8d0e0ad0840395471fd862bd2cdad095345d,1,4,2,6,2,2007-09-18 21:56:55,2007-09-16 17:07:38
76bf8d0e0ad0840395471fd862bd2cdad095345d...d28840461d9cebd79f1ec30a4117661b41e2c9a3,1,14,58,72,36,2007-09-18 21:58:24,2007-09-17 20:56:44
e92ea62425fb89713bc47241af29a79f5f191cc6...17437d45becdc373b171092e09a7853e6b286084,1,5,2,7,3,2007-08-27 00:36:10,2007-08-27 00:36:10
17437d45becdc373b171092e09a7853e6b286084...7d479624d47a3deff1245a70521180c57b4ff3c1,1,0,3,3,1,2007-08-27 08:38:25,2007-08-25 22:18:47
7d479624d47a3deff1245a70521180c57b4ff3c1...625727162964b918f7f734a2523cb7c60f78a7be,1,0,7,7,1,2007-08-27 08:38:35,2007-08-27 05:54:32
625727162964b918f7f734a2523cb7c60f78a7be...2b9232cc23a86f650cc1b93a35cce6ad59a8d782,1,36,7,43,4,2007-08-28 05:05:19,2007-08-28 05:05:19
2b9232cc23a86f650cc1b93a35cce6ad59a8d782...ac076c29ae8d57b72abe27f573061ea7b2eeed57,1,11,10,21,9,2007-08-28 05:36:43,2007-08-27 11:37:33
ac076c29ae8d57b72abe27f573061ea7b2eeed57...6adcca3fe84e6859fc62df6c4ab916192ca02795,3,177,5,182,4,2007-08-28 05:36:43,2007-08-27 07:58:06
6adcca3fe84e6859fc62df6c4ab916192ca02795...9277d60233a1829742aa2d9d20ddbfc3b2b7acde,2,5,2,7,2,2007-08-28 05:44:41,2007-08-28 05:41:23
9277d60233a1829742aa2d9d20ddbfc3b2b7acde...a005085240ef77ac0dde8eb08e27c6ef868d4bab,2,97,15,112,8,2007-08-28 06:48:28,2007-08-16 06:19:55
93969438dca50c7f0039fcf35e7ab82776d4122f...a4882c27f8b3793d94b03fd503a0c67ad9772cf6,2,44,16,60,6,2007-08-15 21:21:23,2007-08-15 21:12:14
a4882c27f8b3793d94b03fd503a0c67ad9772cf6...2ed2c222dfe372385dc562fb5dc246d5595c1eae,2,18,4,22,5,2007-08-15 21:28:34,2007-08-15 17:01:43
2ed2c222dfe372385dc562fb5dc246d5595c1eae...b13ef4916ac5a25cc5897f85ba0b4c5953cff609,3,32,2,34,3,2007-08-15 22:01:20,2007-08-15 22:01:20
047d94d505c9837a60c28e121de65471dadce74b...0b883ab30c869c4f22a19e49aedc1604d335cd91,1,12,6,18,6,2007-09-09 03:06:26,2007-09-07 17:16:59
0b883ab30c869c4f22a19e49aedc1604d335cd91...cff93397ab185898fd93b6a260cc6f3068c4ac30,1,2,0,2,1,2007-09-09 03:47:10,2007-09-09 03:47:00
cff93397ab185898fd93b6a260cc6f3068c4ac30...c63fe3b2dc90120a4bdba7194f92efc2f3c342ed,1,3,3,6,2,2007-09-09 09:03:12,2007-09-09 03:05:43
507d6aa5bf2fb9f56d0c7f70d4ff3b8177da9d8e...8280bbebd1ecc4633b969a439ed4ca653d1bc958,1,0,4,4,1,2015-03-05 20:35:36,2015-03-02 09:29:51
8280bbebd1ecc4633b969a439ed4ca653d1bc958...706d5f816fbcb1299c19f4d41bea60f1e229165e,1,9,9,18,6,2015-03-05 20:35:36,2015-03-02 09:29:52
706d5f816fbcb1299c19f4d41bea60f1e229165e...074336e5ed4ff10577f22c6812e092e3f6607405,1,6,9,15,4,2015-03-05 20:35:36,2015-03-02 09:29:53
074336e5ed4ff10577f22c6812e092e3f6607405...5a6f47077b31be45bfadd6cef3b8b1a79ad57de5,1,9,5,14,3,2015-03-05 20:35:36,2015-03-03 11:43:14
5a6f47077b31be45bfadd6cef3b8b1a79ad57de5...fe2a18165c97d3e0937bb99fda449e1f64e5c867,2,88,64,152,17,2015-03-05 20:35:36,2015-03-03 11:43:15
fe2a18165c97d3e0937bb99fda449e1f64e5c867...5e6f003ca8aed546d50a4f3fbf1e011186047bc0,2,14,4,18,6,2015-03-05 20:35:37,2015-03-03 11:43:16
5e6f003ca8aed546d50a4f3fbf1e011186047bc0...423c688b855c328ecda0b6a79c4b1af78d09a10c,1,5,2,7,2,2015-03-05 20:35:37,2015-03-03 11:43:17
d0ef5a7e427d18657b8d53223adc1d7132d6ab79...a62eafb0aaf3fa8265744954d6f0c2c7c7f97682,1,33,3,36,7,2011-03-15 22:17:54,2011-03-15 22:17:54
f70f736bcbb22cfe434eaf20089d9713b991ee31...5d2c3b01604a170c52262bf2751c55053d6bd8c1,2,7,4,11,4,2011-03-02 20:26:18,2011-03-01 13:21:05
6e97fccf0c77b15c86e25558d69ce54422ebcf92...f674bb80784683f65c20264ce20afdd0a7669ffd,1,7,2,9,1,2011-10-21 21:38:22,2011-10-08 14:54:35
f674bb80784683f65c20264ce20afdd0a7669ffd...a31e62629a1408bca540f505f2dc4ab8a9999f5d,1,70,45,115,46,2011-10-21 21:38:22,2011-10-15 12:57:23
a31e62629a1408bca540f505f2dc4ab8a9999f5d...abf05987de7b61972e85392ca2f1a4fc25046e57,1,2,4,6,2,2011-10-21 21:38:23,2011-10-08 14:54:37
abf05987de7b61972e85392ca2f1a4fc25046e57...d8c0453e1a81db03880a9f237675d82cdc290d2c,1,7,7,14,2,2011-10-21 21:38:23,2011-10-08 14:54:38
d8c0453e1a81db03880a9f237675d82cdc290d2c...fb772cca2bd38e97a3b23d5b241a8961156b681b,1,21,8,29,1,2011-10-21 21:38:23,2011-10-08 14:54:39
fb772cca2bd38e97a3b23d5b241a8961156b681b...d79bcf2cf21ddb8c3fcbd95bafa431f872d47a96,1,5,8,13,2,2011-10-21 21:38:23,2011-10-08 14:54:40
d79bcf2cf21ddb8c3fcbd95bafa431f872d47a96...48058f5df49fb9005418a7d025b374988908c0b5,1,4,9,13,1,2011-10-21 21:38:23,2011-10-08 14:54:41
48058f5df49fb9005418a7d025b374988908c0b5...d51a8ecd5fedb6fd09a14fc1b07f8922d6963743,1,4,0,4,1,2011-10-21 21:38:23,2011-10-08 14:54:42
d51a8ecd5fedb6fd09a14fc1b07f8922d6963743...6486ca6d77eaf4109b26b70da0b3a0158868e22f,1,2,20,22,6,2011-10-21 21:38:23,2011-10-08 14:54:43
f2cfc9c81ea2fe72ea0ac57d63e71e10e8b0af94...ffd31f661d5c5dddc091750ca86cfaa5d9d04b38,1,57,95,152,10,2011-03-25 16:20:33,2011-03-25 09:34:18
ffd31f661d5c5dddc091750ca86cfaa5d9d04b38...f0096c06bcdeb7aa6ae8a749ddc9d6d4a2c381d1,9,62,29,91,26,2011-03-25 16:20:33,2011-03-25 09:34:19
f0096c06bcdeb7aa6ae8a749ddc9d6d4a2c381d1...97d0b74a49f0c81c3f9673c1a17721ac0624c3df,3,33,50,83,14,2011-03-25 16:20:33,2011-03-25 09:34:20
97d0b74a49f0c81c3f9673c1a17721ac0624c3df...33e0f62ba981ebfdcab8c9fb6d2935712a7b9d41,5,9,8,17,7,2011-04-05 16:30:36,2011-04-05 16:30:36
276e017f2f632e9bd954bd5a6b794fe0865a5f37...06316234accdcb6608506aed6600cd60ff5c5c8e,2,2,2,4,2,2011-03-16 19:56:23,2011-03-16 07:02:42
5a48d24012fa39cdd02c1cb614db2e62d445e2ce...6d4bb3833c3d2114d9c4e6d028e961c3fba8b8b3,1,63,56,119,5,2011-09-09 21:57:53,2011-09-01 22:43:35
6d4bb3833c3d2114d9c4e6d028e961c3fba8b8b3...f0e278b1b7a2c0ecbecf644a18c1383dc426db30,1,36,14,50,12,2011-09-09 22:07:56,2011-09-02 23:22:47
f0e278b1b7a2c0ecbecf644a18c1383dc426db30...f96400cb467af82e21acb3034dd214f4c8be11d0,4,85,65,150,6,2011-09-09 22:19:02,2011-09-02 23:33:22
f96400cb467af82e21acb3034dd214f4c8be11d0...52fed6e1ce07250ada3d2d0128015f131e3ad6c1,1,43,0,43,3,2011-09-09 22:19:05,2011-09-02 23:52:08
5a48d24012fa39cdd02c1cb614db2e62d445e2ce...6b67e0dc068d1bfd07686071b70f60078380666f,1,63,56,119,5,2011-09-01 22:46:13,2011-09-01 22:43:35
0b9deecf625677cf44058a42c2abd7add5167e81...358e460eebd3c19f228f02461b5f161ea48b0a98,1,9,5,14,3,2011-05-27 17:44:02,2011-05-27 12:36:40
358e460eebd3c19f228f02461b5f161ea48b0a98...808e1db231195af31075d1e0f9e4f6026a96d06a,3,39,5,44,15,2011-05-27 17:44:34,2011-05-27 12:36:41
808e1db231195af31075d1e0f9e4f6026a96d06a...86e1ce96d77fbfb2af74cabc05c1e8cf85742efc,1,3,0,3,1,2011-05-27 17:44:37,2011-05-27 12:36:42
86e1ce96d77fbfb2af74cabc05c1e8cf85742efc...e5f85df87e8f1adb40288265ef54a16128691688,2,29,2,31,4,2011-05-28 04:50:39,2011-05-28 04:50:39
9ee3d3774316f6a60c0618aa7a64fc7a59a8f338...e454a83fa2640166aba77ef3fe2bfb81949895b8,1,21,2,23,7,2011-10-21 23:05:42,2011-10-21 18:46:12
0dc691a4f3dcb67dd948eb97efcf7098059988c1...2c9c8ee2de3fc6af5a28cbeec15edcf9fe43537c,2,14,0,14,2,2011-09-22 20:30:57,2011-09-22 19:47:04
2c9c8ee2de3fc6af5a28cbeec15edcf9fe43537c...0bc69881a611c582f3b89a475882161d83c56494,2,19,0,19,2,2011-09-22 20:30:59,2011-09-22 19:47:05
25e5e2bf85c8a2c2c8945935267539940c11020d...d2b17b3220cbd75b1c8e2aa6cfdc5c121749c97d,7,231,0,231,10,2011-08-21 06:03:52,2011-08-19 22:08:47
324bc2a7ee1cffbf959652a54f4d3d59a1173104...be3fa9125e708348c7baf04ebe9507a72a9d1800,2,2,2,4,2,2011-10-31 02:14:24,2011-10-31 02:14:24
27af01d552331eacf1ed2671b2b4b6ad4c268106...c5aa90682f82fe0dabdc0280be93568d52efddfc,1,7,3,10,5,2011-09-26 18:38:14,2011-09-25 13:39:08
c5aa90682f82fe0dabdc0280be93568d52efddfc...81b568c839376a10cd5fe29db0b8a72f537fa36a,2,8,0,8,2,2011-10-03 18:58:18,2011-10-02 04:56:28
841d81180e6754b18559220087decf01f504b203...e0adb84cc65a399629fbb1b2d0e5764330bf4f39,1,7,4,11,1,2011-03-08 22:44:07,2011-03-08 20:51:37
e0adb84cc65a399629fbb1b2d0e5764330bf4f39...d0f7dcbf424e1739437ffe477d87088ca6cb3432,1,18,8,26,3,2011-03-09 05:35:22,2011-03-09 00:58:19
841d81180e6754b18559220087decf01f504b203...190767f6c15edef430498a10356cb6d573934e7a,2,3,1,4,2,2011-03-08 19:59:43,2011-03-08 08:31:25
190767f6c15edef430498a10356cb6d573934e7a...f98fd4367542b507c18b6aeb4ac0c824dec4b7b3,2,160,160,320,5,2011-03-09 23:15:52,2011-03-08 08:31:26
9d158601b3cb9753825e21441c88d31297b97be5...f5ea3f2bb30bf912d0021ef6a77e772ccdb4f8fd,1,4,5,9,3,2011-04-29 22:25:03,2011-04-29 22:12:32
f5ea3f2bb30bf912d0021ef6a77e772ccdb4f8fd...f3217e2b1791580ce6499b800e93989d312f9718,1,36,0,36,1,2011-04-29 22:26:41,2011-04-29 19:41:16
f3217e2b1791580ce6499b800e93989d312f9718...9dce832354502a04e724c5776e60fc6189182307,1,8,8,16,6,2011-04-29 22:27:59,2011-04-06 21:12:34
9dce832354502a04e724c5776e60fc6189182307...933e44d3a040c41a1e45d53a416edd107cc3ae0a,2,7,4,11,4,2011-04-29 22:27:59,2011-04-06 21:20:57
933e44d3a040c41a1e45d53a416edd107cc3ae0a...0bf9fc0cd28bf8e983a5280676fcaeb826403516,1,1,1,2,1,2011-05-08 20:43:04,2011-05-08 20:43:04
d98f24cd9d8d8ee20b65d22ec6b78da04b48de85...c4e4644e17e0fad4a6ffedba22b739cf1b1ac3fc,1,6,4,10,1,2011-03-21 17:23:45,2011-03-21 13:14:22
c4e4644e17e0fad4a6ffedba22b739cf1b1ac3fc...b5f306fbe1bf1a75341f85b84358d25870b010f3,1,3,3,6,1,2011-03-22 21:31:21,2011-03-22 18:42:25
a62bbf8f01c6b19cd1a5cf92a98f612176aa2b67...6288e3e180c0b911e6f7062f1e744a25568f7d22,1,1,1,2,1,2011-02-28 21:25:12,2011-02-28 21:16:59
92a684b916edf9e0f4f7962865e62ff71a988445...33e92e47c5b3eaa66d375cb94c3cfd1a0946bf93,1,23,23,46,21,2011-03-10 07:52:52,2011-02-22 23:41:24
33e92e47c5b3eaa66d375cb94c3cfd1a0946bf93...3e5dd7e960953ad03790309c48406a8aa43cb026,2,10,4,14,2,2011-03-10 07:52:52,2011-02-22 23:41:25
3e5dd7e960953ad03790309c48406a8aa43cb026...e84d7b74c6e59fac20209c4759791f39afc0e25b,1,27,27,54,24,2011-03-10 07:52:52,2011-02-22 23:41:26
e84d7b74c6e59fac20209c4759791f39afc0e25b...3781fcce05c16dcb0714c817ecfabbe8e1ffe62c,1,6,3,9,1,2011-03-10 07:52:52,2011-02-22 23:41:27
3781fcce05c16dcb0714c817ecfabbe8e1ffe62c...5cde59895f6c12fa479154ab111644de40f6a05a,2,3,3,6,3,2011-03-10 07:52:52,2011-02-22 23:41:28
5cde59895f6c12fa479154ab111644de40f6a05a...990ac4be0ad68e78c042d4caa532c410991420f5,1,18,18,36,17,2011-03-10 07:52:53,2011-02-22 23:41:29
990ac4be0ad68e78c042d4caa532c410991420f5...439fb8296d0a08c09653a45c0f44757c6b9c99b2,3,33,17,50,8,2011-03-10 07:52:53,2011-02-22 23:41:30
439fb8296d0a08c09653a45c0f44757c6b9c99b2...48168851cffcd14e01d3a10473a02ca4b4479402,2,7,3,10,2,2011-03-10 07:52:53,2011-02-22 23:41:31
48168851cffcd14e01d3a10473a02ca4b4479402...475c73eb8c65fe7b4cb55f05aeb9eee547e4a359,2,2,2,4,2,2011-03-10 07:52:53,2011-02-22 23:41:32
475c73eb8c65fe7b4cb55f05aeb9eee547e4a359...ed2a808d683419f9daade78b737d070bd13c4d7f,1,1,1,2,1,2011-03-10 07:52:53,2011-02-22 23:41:33
ed2a808d683419f9daade78b737d070bd13c4d7f...49df4b0298ea87ec737221c35ac74f8e6ee108c9,1,28,28,56,25,2011-03-10 07:52:53,2011-02-22 23:41:34
49df4b0298ea87ec737221c35ac74f8e6ee108c9...2852e1dd5d21a9b43f27801181d9d875efa02598,1,2,1,3,1,2011-03-10 07:52:53,2011-02-22 23:41:35
2852e1dd5d21a9b43f27801181d9d875efa02598...8af42b0f7773bff2529f6c8990bb3d872b8270d5,2,2,2,4,2,2011-03-10 07:52:53,2011-02-22 23:41:36
8af42b0f7773bff2529f6c8990bb3d872b8270d5...a5760906e78adeab2ae8f404528c4ce10d046f5c,2,4,4,8,4,2011-03-10 07:52:53,2011-02-22 23:41:37
a5760906e78adeab2ae8f404528c4ce10d046f5c...409fa556ce5c7e680d773d4bb01ca2c3162a9e9d,2,2,2,4,2,2011-03-10 07:52:53,2011-02-22 23:41:38
409fa556ce5c7e680d773d4bb01ca2c3162a9e9d...e8a8a4d76b1a609b343a174212655c5e07e00b50,1,34,34,68,34,2011-03-10 07:52:53,2011-02-22 23:41:39
e8a8a4d76b1a609b343a174212655c5e07e00b50...9f97ab08c236927cdaa5b47204f97588f006c61e,1,8,6,14,2,2011-03-10 07:52:53,2011-02-22 23:41:40
9f97ab08c236927cdaa5b47204f97588f006c61e...983ca75ecb945f86f286861bb4649c7bfd63a35c,1,1,1,2,1,2011-03-10 07:52:53,2011-02-22 23:41:41
983ca75ecb945f86f286861bb4649c7bfd63a35c...9398cc4bd44a08a0f6a69b01b2051b94bd2f994d,2,6,6,12,6,2011-03-10 07:52:53,2011-02-22 23:41:42
9398cc4bd44a08a0f6a69b01b2051b94bd2f994d...08eaa4be0332e6f9f8732fbb99272b4bbf3ea3de,1,8,6,14,3,2011-03-10 07:52:54,2011-02-22 23:41:43
08eaa4be0332e6f9f8732fbb99272b4bbf3ea3de...8a6179bcb6022c433ac87a01393155d64166eb7b,1,59,59,118,59,2011-03-10 07:52:54,2011-02-22 23:41:44
8a6179bcb6022c433ac87a01393155d64166eb7b...9c227655b02c8f84e319a57bb8dd7cff63e3fbf8,2,5,5,10,5,2011-03-10 07:52:54,2011-02-22 23:41:45
9c227655b02c8f84e319a57bb8dd7cff63e3fbf8...fe8165cd4f201cbdc7e675a3227bd5a157f57181,2,8,8,16,6,2011-03-10 07:52:54,2011-02-22 23:41:46
fe8165cd4f201cbdc7e675a3227bd5a157f57181...7f5673d7030a4792319917ece0484d8379aa811f,2,10,4,14,4,2011-03-10 07:52:54,2011-02-22 23:41:47
7f5673d7030a4792319917ece0484d8379aa811f...0b430a17ae88e56703270af7e29f845ffc7a891c,3,26,18,44,14,2011-03-10 07:52:54,2011-02-22 23:41:48
0b430a17ae88e56703270af7e29f845ffc7a891c...fc88e316e7c628cf51fcc2fe732f34e2e6e15216,1,6,6,12,6,2011-03-10 07:52:54,2011-02-22 23:41:49
fc88e316e7c628cf51fcc2fe732f34e2e6e15216...54214529b5e47a9580747a152aa646132d1d7911,1,9,9,18,9,2011-03-10 07:52:54,2011-02-22 23:41:50
54214529b5e47a9580747a152aa646132d1d7911...bd4a51fc254bbf492e08afab5a8853cf10c15fbe,1,23,23,46,21,2011-03-10 07:52:54,2011-02-22 23:41:51
bd4a51fc254bbf492e08afab5a8853cf10c15fbe...502681cd7dcf87e067eba61da176388467606a2c,2,42,18,60,14,2011-03-10 07:52:54,2011-02-22 23:41:52
502681cd7dcf87e067eba61da176388467606a2c...f7b3742a6b60d39adbf02258cfc72cb5b9ca8ad5,1,5,5,10,5,2011-03-10 07:52:54,2011-02-22 23:41:53
f7b3742a6b60d39adbf02258cfc72cb5b9ca8ad5...321a153c5a85320505e6eee9acd3f87b79cd873a,1,3,3,6,1,2011-03-10 07:52:54,2011-02-22 23:41:54
321a153c5a85320505e6eee9acd3f87b79cd873a...2fc5f9f189512b82f2154658079e9c3889d4c136,1,16,16,32,16,2011-03-10 07:52:54,2011-02-22 23:41:55
2fc5f9f189512b82f2154658079e9c3889d4c136...e4fe4ba57ae32a5a1334db4206412e12333754a3,2,2,2,4,2,2011-03-10 07:52:55,2011-02-22 23:41:56
e4fe4ba57ae32a5a1334db4206412e12333754a3...5c5f1d7ce116b945ad74b4ae67ae36a2ddeb610c,1,31,31,62,31,2011-03-10 07:52:55,2011-02-22 23:41:57
5c5f1d7ce116b945ad74b4ae67ae36a2ddeb610c...f338cb83a0328b9fe4ec37dff0d4dcc3b8f3cde9,2,4,4,8,4,2011-03-10 07:52:55,2011-02-22 23:41:58
f338cb83a0328b9fe4ec37dff0d4dcc3b8f3cde9...bacec4784598ca35b9be7635cbb630ef59367b6b,3,86,68,154,59,2011-03-10 07:52:55,2011-02-22 23:41:59
bacec4784598ca35b9be7635cbb630ef59367b6b...2ceb61e0a030eddd46cc62e4d9a0fbf2d16faad1,2,5,2,7,2,2011-03-10 07:52:55,2011-02-22 23:42:00
2ceb61e0a030eddd46cc62e4d9a0fbf2d16faad1...2ce216eeda0ed3daf7dbcefe9758a5153c6f9d5a,1,1,1,2,1,2011-03-10 07:52:55,2011-02-22 23:42:01
2ce216eeda0ed3daf7dbcefe9758a5153c6f9d5a...157efde10f34344f0970ca71f33dd5ae1c29b6f5,2,2,2,4,2,2011-03-10 07:52:55,2011-02-22 23:42:02
157efde10f34344f0970ca71f33dd5ae1c29b6f5...431b049e1bfcef5eb8165e4167b53f9717f8a526,1,8,8,16,8,2011-03-10 07:52:55,2011-02-22 23:42:03
431b049e1bfcef5eb8165e4167b53f9717f8a526...a7d5629fe0580bd3e154206388371f5b8fc832db,1,8,8,16,8,2011-03-10 07:52:56,2011-02-22 23:42:04
a7d5629fe0580bd3e154206388371f5b8fc832db...b9b537f7dcd90c125d4902e1eafebc8a151c6a05,1,11,11,22,11,2011-03-10 07:52:56,2011-02-22 23:42:05
b9b537f7dcd90c125d4902e1eafebc8a151c6a05...b50a64e81875944985f84df9324c7624776d6cf8,1,13,13,26,13,2011-03-10 07:52:56,2011-02-22 23:42:06
b50a64e81875944985f84df9324c7624776d6cf8...8b2a57b6c8711b7189184e4670d378d8418f7214,1,7,7,14,4,2011-03-10 07:52:56,2011-02-22 23:42:07
8b2a57b6c8711b7189184e4670d378d8418f7214...4d3cd970ee00afe095878d39299f08832934f685,2,2,2,4,2,2011-03-10 07:52:56,2011-02-22 23:42:08
4d3cd970ee00afe095878d39299f08832934f685...d08ebf9972ec890bf1ebea802bb2590784a1199c,1,30,30,60,30,2011-03-10 07:52:56,2011-02-22 23:42:09
d08ebf9972ec890bf1ebea802bb2590784a1199c...7fbff25a539128f9940c03c9e975aad955f7e92a,2,4,3,7,4,2011-03-10 07:52:56,2011-02-22 23:42:10
7fbff25a539128f9940c03c9e975aad955f7e92a...8352d29e00a307698a3438ce4c094827c6f5dcaf,1,19,19,38,14,2011-03-10 07:52:56,2011-02-22 23:42:11
8352d29e00a307698a3438ce4c094827c6f5dcaf...b32227e770f6c8ade19d340118a478f8b1a8659d,3,8,5,13,7,2011-03-10 07:52:56,2011-02-22 23:42:12
b32227e770f6c8ade19d340118a478f8b1a8659d...355ec7a1303af862a76961603ea2a2a11a0d204c,4,119,104,223,99,2011-03-10 07:52:56,2011-02-22 23:42:13
355ec7a1303af862a76961603ea2a2a11a0d204c...8ec9bc0dd5852e5468db576b0cba39f9179d4610,2,10,10,20,7,2011-03-10 07:52:56,2011-02-22 23:42:14
8ec9bc0dd5852e5468db576b0cba39f9179d4610...98f5e24b9020578e4526eb1cc9588871350e5c01,1,6,6,12,6,2011-03-10 07:52:56,2011-02-22 23:42:15
98f5e24b9020578e4526eb1cc9588871350e5c01...919a4ce0c110a22c00aa854aa16638786b143feb,2,11,11,22,11,2011-03-10 07:52:56,2011-02-22 23:42:16
919a4ce0c110a22c00aa854aa16638786b143feb...b3b298afcbcb5cf5b497928fc9bcd17624112233,2,6,3,9,2,2011-03-10 07:52:56,2011-02-22 23:42:17
b3b298afcbcb5cf5b497928fc9bcd17624112233...d2b044bee5c174647003056e4ba23207e9b26ca6,2,3,3,6,3,2011-03-10 07:52:57,2011-02-22 23:42:18
d2b044bee5c174647003056e4ba23207e9b26ca6...788a3755df6deadde49fd4bf4edf212b33f1363d,1,7,7,14,6,2011-03-10 07:52:57,2011-02-22 23:42:19
788a3755df6deadde49fd4bf4edf212b33f1363d...c7c4efacf1ea100ac1cd5c2f33d1b6d342b39325,1,3,3,6,3,2011-03-10 07:52:57,2011-02-22 23:42:20
c7c4efacf1ea100ac1cd5c2f33d1b6d342b39325...2da57add287c9a5b26e348c35947d6de369e77da,3,15,15,30,15,2011-03-10 07:52:57,2011-02-22 23:42:21
2da57add287c9a5b26e348c35947d6de369e77da...a66f9b2afde8ae0d6bd8991e6a8f848904c8bdde,1,8,3,11,1,2011-03-10 07:52:57,2011-02-22 23:42:22
a66f9b2afde8ae0d6bd8991e6a8f848904c8bdde...e41f1cb36b71485715941c2abe67d3e184baf061,2,19,19,38,16,2011-03-10 07:52:57,2011-02-22 23:42:23
e41f1cb36b71485715941c2abe67d3e184baf061...fea6128baec24fcfe9433a34a06bd9d6e6298bab,1,5,5,10,4,2011-03-10 07:52:57,2011-02-22 23:42:24
fea6128baec24fcfe9433a34a06bd9d6e6298bab...f6908ae86e90a49c3346ba3097f7b80d070e38a3,1,7,7,14,1,2011-03-10 07:52:57,2011-02-22 23:42:25
f6908ae86e90a49c3346ba3097f7b80d070e38a3...caeba0ef153574d0240020228e0c48807b665a83,1,53,53,106,50,2011-03-10 07:52:57,2011-02-22 23:42:26
caeba0ef153574d0240020228e0c48807b665a83...e3bd758335ccb2d46ddde628bf391d5155f87730,1,4,2,6,1,2011-03-10 07:52:57,2011-02-22 23:42:27
e3bd758335ccb2d46ddde628bf391d5155f87730...f30f71ce7aecd86823f7a2d93f56c212bac8f510,1,23,23,46,23,2011-03-10 07:52:57,2011-02-22 23:42:28
f30f71ce7aecd86823f7a2d93f56c212bac8f510...d3ee177e5059c81e0e73be091741f60ebfbce520,2,14,6,20,2,2011-03-10 07:52:57,2011-02-22 23:42:29
d3ee177e5059c81e0e73be091741f60ebfbce520...b9c993e017715e07615df30091b0fe5f556df13d,1,5,2,7,2,2011-03-10 07:52:57,2011-02-22 23:42:30
b9c993e017715e07615df30091b0fe5f556df13d...cb6aeb22ace0e20c19ba14fc4540e426a1a37880,2,4,3,7,2,2011-03-10 07:52:57,2011-02-22 23:42:31
cb6aeb22ace0e20c19ba14fc4540e426a1a37880...ab8b53bbf1bd0cc078fe1f9772f9328fad59a203,1,4,4,8,4,2011-03-10 07:52:58,2011-02-22 23:42:32
6eab5f2f14806cf6a7b665d96766a59c13a41f4b...833abdc9327f60dff771273095074ae734513ab6,3,39,7,46,5,2012-04-18 00:13:45,2012-02-13 11:48:56
833abdc9327f60dff771273095074ae734513ab6...4c57bd27402353f135250af91d1cc2646db73df0,1,28,23,51,25,2012-04-18 00:14:19,2012-04-16 23:15:13
4c57bd27402353f135250af91d1cc2646db73df0...b5d887f90692515a6e9c99e7683533d12df3ade2,1,27,13,40,8,2012-04-18 00:14:19,2012-04-17 18:31:10
b5d887f90692515a6e9c99e7683533d12df3ade2...e78cbf8cbb61edfbdef5d33262f9b8cf02a3afca,4,43,28,71,21,2012-04-18 00:15:05,2012-04-17 19:22:26
e78cbf8cbb61edfbdef5d33262f9b8cf02a3afca...5802f81b1438fdbfab340c4e752e2be457c4a065,2,149,10,159,10,2012-04-19 05:50:28,2012-04-19 02:49:08
6eab5f2f14806cf6a7b665d96766a59c13a41f4b...6da618d5c2ae95f08c9a24d0cce2d5d93b60cfbe,1,2,1,3,2,2012-04-17 15:25:44,2012-04-16 22:08:49
6da618d5c2ae95f08c9a24d0cce2d5d93b60cfbe...0997adaa74dfe07cee3180c3a6fd91949fb4e3d8,2,41,3,44,4,2012-04-17 15:26:00,2012-04-16 22:08:50
6eab5f2f14806cf6a7b665d96766a59c13a41f4b...48e510b6a29b1066016cbbee75c0b196174a88d4,1,2,0,2,2,2012-04-16 17:10:25,2012-04-16 15:20:02
48e510b6a29b1066016cbbee75c0b196174a88d4...875b91b35d2517773495e8404f31fde8c5cbd27d,1,17,23,40,9,2012-04-26 16:13:29,2012-04-25 19:37:38
6eab5f2f14806cf6a7b665d96766a59c13a41f4b...ed3c400c6aba78fac5e5e502c89c4e8304d5ce5f,1,2,2,4,1,2012-04-14 23:31:02,2012-04-14 12:37:29
6eab5f2f14806cf6a7b665d96766a59c13a41f4b...a6801adc5249c847a596a0d36ffce2a649bc4ade,1,3,3,6,2,2012-04-14 23:26:57,2012-04-13 16:25:16
fa678feb7ca12e306e2eaeb0078028505ab3318a...fc5877a6231aca01b63ddfd507bc1180078c09e2,8,16,16,32,16,2012-03-13 21:26:27,2012-03-13 04:54:05
fc5877a6231aca01b63ddfd507bc1180078c09e2...e7a8ac3875ef2a6fe10af7f16d034a2b8f218af3,1,17,10,27,7,2012-03-13 21:26:31,2012-03-13 04:58:59
e7a8ac3875ef2a6fe10af7f16d034a2b8f218af3...ef7db1933b6d4ae466a1b248a98c7ed9d1d65a41,1,180,167,347,17,2012-03-13 21:26:32,2012-03-13 04:59:52
ef7db1933b6d4ae466a1b248a98c7ed9d1d65a41...2593633f5a7e1ddc02cd5f8256d02a53324e4cf6,1,22,8,30,6,2012-03-13 21:26:32,2012-03-13 05:00:36
2593633f5a7e1ddc02cd5f8256d02a53324e4cf6...1145211456580530ab01ef713adae4812d5758b2,1,19,7,26,3,2012-03-13 21:26:32,2012-03-13 05:01:32
1145211456580530ab01ef713adae4812d5758b2...2983c0e22a5b6a56b8f5d7bb2dd2a3a0e26ac005,1,23,6,29,3,2012-03-13 21:26:32,2012-03-13 05:02:19
2983c0e22a5b6a56b8f5d7bb2dd2a3a0e26ac005...6dd88832e77ad7c0c7f82522d3741b5b7bf62fbd,8,94,62,156,20,2012-03-13 21:26:33,2012-03-13 05:05:54
fa678feb7ca12e306e2eaeb0078028505ab3318a...6c15a1c63634005a0f8fb15696e154cc54b0a359,2,4,4,8,2,2012-03-13 19:21:04,2012-03-13 18:38:27
5fb41b883a5d0f9cbc4c6c693e6d84a8a5cee17e...204f01a2f734fddab95b09123b04b1305620e7b6,6,40,7,47,8,2011-04-11 17:11:17,2011-04-10 22:48:50
204f01a2f734fddab95b09123b04b1305620e7b6...0133dab75d8b15c559aa9df66134d72dce0e0476,3,25,5,30,7,2011-04-11 17:12:24,2011-04-10 22:48:51
0133dab75d8b15c559aa9df66134d72dce0e0476...2ff3a80334115797b8446909655e536f43900bc5,4,21,5,26,8,2011-04-11 18:16:15,2011-04-10 22:48:52
2ff3a80334115797b8446909655e536f43900bc5...2ca86714703f81f9dd5dfb31f8d97a8a0089634d,1,1,1,2,1,2011-04-12 18:29:34,2011-04-12 09:24:34
5fb41b883a5d0f9cbc4c6c693e6d84a8a5cee17e...26488f5922061f924b9ffe6cc83404113124d9e0,1,10,0,10,1,2011-04-06 22:17:06,2011-04-06 18:46:48
26488f5922061f924b9ffe6cc83404113124d9e0...19299a84f7f71b1ddf0b30732776dd5b351f2f24,2,63,62,125,2,2011-04-06 22:19:53,2011-04-06 18:46:49
19299a84f7f71b1ddf0b30732776dd5b351f2f24...90b94c26f7ae5241aa1d17c7076c103d9896b534,1,28,0,28,1,2011-04-06 22:22:17,2011-04-06 18:46:49
90b94c26f7ae5241aa1d17c7076c103d9896b534...48672b3dc70e8f70291d974f0eb54cbac7f498e0,1,8,6,14,2,2011-04-06 22:24:10,2011-04-06 18:46:50
03276d94bcdb7d463a029936933898948c0669ac...79c461d5b1139afa3d3997c7ef9ee521562b2a1a,6,27,29,56,16,2010-11-24 23:13:58,2010-11-19 17:54:24
03276d94bcdb7d463a029936933898948c0669ac...dc01f59d21fca9ade97f1433ca4cee17b5ce59a7,2,47,1,48,8,2010-11-24 23:01:24,2010-11-22 08:16:02
03276d94bcdb7d463a029936933898948c0669ac...b3e5bce1aa88721dd4565089960997836ce66add,2,47,25,72,7,2010-11-24 22:48:52,2010-11-18 05:02:48
03276d94bcdb7d463a029936933898948c0669ac...38a94bb6bae683ba5a92969e63f1d3f2cbf41ac0,2,25,0,25,3,2010-11-23 20:17:03,2010-11-23 03:16:30
03276d94bcdb7d463a029936933898948c0669ac...7baf9c4b70784920e05f9be6614084ef8f64674d,3,9,0,9,4,2010-11-23 20:15:43,2010-11-22 20:21:01
03276d94bcdb7d463a029936933898948c0669ac...d313c1cfe446ae3839c022ed017194d8248c6bd5,1,53,2,55,8,2010-11-18 00:43:14,2010-11-18 00:43:05
60aa9cf8f370b69eb7feaad2e1cbcd04280bc799...15431ca651050ba315fa4e2e74527f6d115e706c,1,1,0,1,1,2010-11-13 00:03:27,2010-11-11 18:08:23
60aa9cf8f370b69eb7feaad2e1cbcd04280bc799...0188f6b3c191eb5277e9ebab3b9079f923dbd283,1,2,1,3,1,2010-11-13 00:00:45,2010-11-11 13:03:22
60aa9cf8f370b69eb7feaad2e1cbcd04280bc799...0b803a6cc679e5448330ddb3ed3ace3cd66f1b31,1,4,2,6,2,2010-11-11 18:54:57,2010-11-10 18:57:39
0b803a6cc679e5448330ddb3ed3ace3cd66f1b31...6f02a5a33a3983597992e94c7b826021acc8a9d9,1,19,5,24,3,2010-11-11 18:57:16,2010-11-10 19:00:48
60aa9cf8f370b69eb7feaad2e1cbcd04280bc799...f772c34ce09a49eb553240eb672bf0cc2dbcb10a,1,0,4,4,1,2010-11-10 17:38:36,2010-11-10 07:14:26
1bb28d87e1d8897db662f48455d369860758fbdd...549ad6d2f3a7090d6f73f8ebacd5d1db7a0cf90f,1,8,8,16,3,2010-11-30 01:08:22,2010-11-28 19:39:45
549ad6d2f3a7090d6f73f8ebacd5d1db7a0cf90f...60d5985dab5d3c5a283f060414b903778adfd09a,2,23,3,26,6,2011-01-04 21:31:03,2010-12-29 21:55:34
1bb28d87e1d8897db662f48455d369860758fbdd...07cd7265274ba6aed2589e6b22eae7d413640037,1,3,3,6,3,2010-10-21 22:44:53,2010-10-21 14:49:47
1bb28d87e1d8897db662f48455d369860758fbdd...1f2baa78c61bc99fe82bc62fc6d5a8d307984f3d,2,30,3,33,3,2010-10-21 22:43:24,2010-10-21 14:45:44
a598ded1e2e9cc9f4ce93d091808b475839e6867...e0ca364551fcde3b3d825f93f4a4d44d7ab9eb35,1,21,13,34,3,2011-06-22 18:44:09,2011-06-22 15:28:52
e0ca364551fcde3b3d825f93f4a4d44d7ab9eb35...16f20725bbcb7abbbc11e740050197b7fe8f843a,1,199,182,381,3,2011-06-22 18:44:33,2011-06-22 15:28:53
16f20725bbcb7abbbc11e740050197b7fe8f843a...882541b87d8f7bedca824228a8ad14aed69c904e,1,16,13,29,6,2011-06-22 18:52:28,2011-06-22 15:28:54
882541b87d8f7bedca824228a8ad14aed69c904e...1ae05be4aa448163a381e131396fd52dcf6f83eb,1,26,12,38,11,2011-06-22 18:53:37,2011-06-22 15:28:55
a598ded1e2e9cc9f4ce93d091808b475839e6867...4f8303905eafaa04fd08a20a08a81436aea2d4b9,1,8,4,12,1,2011-06-22 18:40:32,2011-06-22 15:33:02
2cfceefaca16d64baecf0ba9bcd4e05229d9c31b...701ecdf16b3941ad1928520414942776e695308d,1,5,1,6,2,2012-11-16 18:55:09,2012-11-11 14:35:53
701ecdf16b3941ad1928520414942776e695308d...43ea081235dfebdd34ad16e873105dabdec075fb,1,13,14,27,7,2012-11-16 18:57:52,2012-11-11 14:35:54
43ea081235dfebdd34ad16e873105dabdec075fb...a1be444d099d059982dfcc6b58c286591a3322d8,1,3,6,9,6,2012-11-16 18:58:24,2012-11-11 14:35:55
a1be444d099d059982dfcc6b58c286591a3322d8...2fbaf81381f4c80b5d8a97277374426f019fbc4a,1,14,17,31,10,2012-11-16 19:01:56,2012-11-11 14:35:56
2fbaf81381f4c80b5d8a97277374426f019fbc4a...e461523892440f378dd7d872cac9fc6094c6492c,1,28,50,78,12,2012-11-16 19:16:12,2012-11-11 14:35:57
e461523892440f378dd7d872cac9fc6094c6492c...173930330ad039d8c09b821001abd95d040a2832,1,5,10,15,3,2012-11-16 19:18:53,2012-11-11 14:35:58
2cfceefaca16d64baecf0ba9bcd4e05229d9c31b...6c323322682abed3bb2a3904596b529ebccddb1c,2,29,0,29,3,2012-10-29 08:01:00,2012-10-22 20:56:34
2cfceefaca16d64baecf0ba9bcd4e05229d9c31b...db699a8a1f2c8063620efae41e66786c11a31d8f,6,125,112,237,8,2012-10-29 07:08:30,2012-10-26 15:53:49
db699a8a1f2c8063620efae41e66786c11a31d8f...c43cb38612192fa45bf7ed981a98bc4ddb86ce75,2,38,39,77,2,2012-10-29 07:08:30,2012-10-26 15:53:50
c43cb38612192fa45bf7ed981a98bc4ddb86ce75...efc7df454e9ec8b730fb2293c8549cec43de6bfa,4,14,14,28,4,2012-10-29 07:08:30,2012-10-26 15:53:51
efc7df454e9ec8b730fb2293c8549cec43de6bfa...4914c9629c046f7f5abf4109ad756040f9ebe2bf,7,52,53,105,8,2012-10-29 07:08:30,2012-10-26 15:53:52
4914c9629c046f7f5abf4109ad756040f9ebe2bf...f5d942e1ede7ce5e74537d3021df9fdc179a8377,4,350,333,683,5,2012-10-29 07:08:30,2012-10-26 15:53:53
f5d942e1ede7ce5e74537d3021df9fdc179a8377...f8eb3036d0cc1838cc6865884b1648ff50a4f804,1,83,77,160,66,2012-10-29 07:08:30,2012-10-26 15:53:54
f8eb3036d0cc1838cc6865884b1648ff50a4f804...745f7a8cacae55df3e00507344d8db2a31eb57e8,3,952,948,1900,7,2012-10-29 07:40:29,2012-10-26 15:53:55
39f2e017203695b9da2ad35589b0e58bcac6fdc8...3083301ead459a45059af3ee85fb51d5d737a74d,1,2,2,4,2,2012-09-20 21:20:09,2012-09-20 21:20:09
b81401c1de0e0fec39f8643ce7a794fda083f7a1...188923f0d1c8148415b3173986cd1e21871c947e,3,6,6,12,5,2012-10-12 16:42:31,2012-10-12 06:22:49
c70c09b6fc9339cba64d5ddd4698a2a3ef754dcd...7687ae98e0b7e9ae12b1ef1c0c3cce0b609a633f,1,32,28,60,5,2012-08-17 20:26:20,2012-08-17 19:48:52
2d1ccebae41541946ddd7e32f291f3c8983feea9...3cd9d1b2f4471211a9c620d6ea8fe736745c3f5b,2,1,3,4,3,2012-07-16 16:37:29,2012-07-16 11:39:54
f623ca1cae600e97cb0b38131fdd33e4fb669cf8...c214538416ee55b951b77b0628b61370bc4d5de4,4,199,6,205,14,2012-06-13 22:25:44,2012-06-12 08:05:12
bf5cf766af62e4ee34b1217c6351c6fc48eaf255...6d62c983f7d91565a15e49955b3ed94ae7c73434,1,1,1,2,1,2012-02-13 10:28:54,2011-12-20 23:40:47
6d62c983f7d91565a15e49955b3ed94ae7c73434...d24fbca7a5dcce2eb5e41266dd1be111b47a730c,3,1,133,134,3,2012-02-13 10:29:07,2011-12-23 17:08:18
d24fbca7a5dcce2eb5e41266dd1be111b47a730c...1f5ad6b1a7538d6d489ba97c46455efc0bc3266e,6,10,10,20,8,2012-02-13 10:29:15,2012-02-12 01:05:12
12766861cdf10fbbfda1023fd65aaf864eb8136a...60df071c6cce6ee3f92f62042da11c62fe113817,3,501,10,511,10,2012-02-23 21:25:35,2012-02-23 07:51:30
69204d0ab18d28d07ee2c8c9b50bbf5bd80343ab...733137496aee6b74e49bd74d342efce8a3d2e95e,1,7,6,13,4,2012-01-26 19:09:08,2012-01-25 22:20:03
733137496aee6b74e49bd74d342efce8a3d2e95e...f15026b514a9fd7eac31313466345c9fae649afc,1,8,0,8,2,2012-01-26 22:03:51,2012-01-25 01:37:02
f15026b514a9fd7eac31313466345c9fae649afc...634a5f265ad729b91266de65272e2b5a35d05b1c,1,5,1,6,1,2012-01-27 05:51:29,2012-01-27 05:48:33
634a5f265ad729b91266de65272e2b5a35d05b1c...828ea97de486c1693d6e4f2c7347acb50235a85d,2,6,1,7,2,2012-01-27 19:31:02,2012-01-27 19:31:02
2a16315031cf478601ea150f7861d4f86b1350a2...9918285fb10d81af9021dae99c5f4de88ded497c,1,4,14,18,4,2010-07-07 18:19:42,2010-07-07 18:19:42
6ed7ddaadba9217b794aecf6d74a2e455daf7a96...18076502cb282482f3cd75d766e1478cc3fccc29,1,3,3,6,3,2010-06-25 18:12:27,2010-06-25 14:56:02
18076502cb282482f3cd75d766e1478cc3fccc29...46a958b3daa1da336683ec82d7f321d0f51b39c8,8,174,13,187,14,2010-06-25 18:30:25,2010-06-25 14:56:47
0d4dbcd35e89a549055e34daf410e4579571b984...3cae7e5b2b9c73aca6a7729bc34c1ce6638fa43a,3,146,0,146,10,2010-06-18 15:47:32,2010-06-17 20:10:39
0d4dbcd35e89a549055e34daf410e4579571b984...74e42ce122bfcbd2e1a06395b80d6a4b44580148,2,6,6,12,2,2010-06-13 17:05:02,2010-06-13 03:32:51
0d4dbcd35e89a549055e34daf410e4579571b984...643cb5f7c99e77a4a3e97213dd226a7dc2650c02,2,13,6,19,7,2010-06-13 16:42:38,2010-06-12 16:05:12
92a75a391e66cfc278cf59741e484efd80c02176...a788d7d58bfbd2772b7ad5d788d8f7f885a651e1,2,12,8,20,5,2010-06-11 20:17:57,2010-06-07 15:23:36
a788d7d58bfbd2772b7ad5d788d8f7f885a651e1...3b8a12e8f8c2f4b200e228bc2aa71741c529553c,1,72,13,85,17,2010-06-18 16:41:01,2010-06-15 13:58:48
3b8a12e8f8c2f4b200e228bc2aa71741c529553c...37d29e1051ef8406d21f8b284a659080fcfe3f72,1,80,0,80,1,2010-06-18 16:41:29,2010-06-07 15:23:38
92a75a391e66cfc278cf59741e484efd80c02176...19b9b0b220be08025d4db9a1c85e21637bf8fd95,1,1,0,1,1,2010-06-10 14:56:11,2010-06-10 08:59:52
19b9b0b220be08025d4db9a1c85e21637bf8fd95...7d82b06d2be1b872a1debf79fadf0585afc70b69,1,29,0,29,3,2010-06-11 16:01:07,2010-06-08 11:34:12
3f1c70f717da3c9ec6ae3744593c7f9f3729aad7...ee0d7bf92507f7c968736a490813e8d9cd7792b1,1,2,0,2,1,2011-08-30 19:27:01,2011-08-30 00:47:36
452c6d506b1a6dcf24d4ceaa592afc39c1c1a60e...a4941a81c8a67abad2000b044ecad71ceff9d695,1,1,1,2,1,2010-08-22 06:17:35,2010-08-15 08:43:20
452c6d506b1a6dcf24d4ceaa592afc39c1c1a60e...39f75d26e235798681394e46625716c187a4ee3e,1,1,1,2,1,2010-08-13 18:01:51,2010-08-13 17:36:01
39f75d26e235798681394e46625716c187a4ee3e...44c48a909ae3d49afcaedb2b2cd042d1e329ee93,4,27,16,43,9,2010-08-13 19:17:45,2010-08-13 19:17:45
44c48a909ae3d49afcaedb2b2cd042d1e329ee93...65113121a50cd765033d51204213c817832c59cf,1,13,1,14,2,2010-08-16 02:20:11,2010-08-15 10:16:25
c8b296450e5148c576697ea4709072b7855aacd5...b167cffb6b38a092e8f9e0e396c1931ee1dc8b7d,2,65,29,94,9,2010-06-05 16:14:13,2010-06-03 13:36:31
b167cffb6b38a092e8f9e0e396c1931ee1dc8b7d...efad1a5615e80637dcb38c8eaa1e35c03b24169f,2,45,42,87,32,2010-06-05 16:14:31,2010-06-03 13:39:18
c8b296450e5148c576697ea4709072b7855aacd5...29609e682226acbdaa3340145792b5bd7a1ef5a8,1,6,1,7,3,2010-05-25 17:49:54,2010-05-25 06:07:25
c8b296450e5148c576697ea4709072b7855aacd5...4e1f87959c76455f0092a7c82aee78df60533ae5,1,2,4,6,2,2010-05-25 16:28:51,2010-05-22 12:21:27
4e1f87959c76455f0092a7c82aee78df60533ae5...e8f30160007d976746d880dab73b805435e04149,1,1,1,2,1,2010-05-25 16:48:37,2010-05-24 08:51:17
e8f30160007d976746d880dab73b805435e04149...bd7440fe1b22ff47daba1990653994e8a7128054,1,2,1,3,1,2010-05-25 16:48:49,2010-05-24 08:50:44
bd7440fe1b22ff47daba1990653994e8a7128054...e498257d650529812ffe1872b3cd62e2bd604287,1,21,19,40,5,2010-05-25 17:50:58,2010-05-25 08:30:13
c8b296450e5148c576697ea4709072b7855aacd5...560fb6a183e1cdbc2948b06cc60bba07f79804a6,1,16,14,30,1,2010-05-25 16:21:28,2010-05-22 06:59:42
c8b296450e5148c576697ea4709072b7855aacd5...75f6929a3669dd0b3123b6b3cd51ec09d0b234c4,1,1,1,2,1,2010-05-20 23:12:46,2010-05-20 18:57:54
75f6929a3669dd0b3123b6b3cd51ec09d0b234c4...ec47a33fd2c3b679c3d8cbd440752414adb56ce9,1,0,1,1,1,2010-05-20 23:13:10,2009-07-20 20:15:07
76c82f90abde8820461e042c6654673f1147881d...d28790dc31ca1bcdca7254a6b9381b6c84e91271,1,11,0,11,1,2011-07-06 18:10:11,2011-07-06 15:13:30
76c82f90abde8820461e042c6654673f1147881d...6b445773b78544032262b897c9aa3b5bd4405dd3,1,4,4,8,4,2011-07-01 23:17:29,2011-07-01 23:11:16
76c82f90abde8820461e042c6654673f1147881d...b792c067872a6b4ec6545dc4375a7084626cb0fa,2,6,2,8,3,2011-07-01 18:22:09,2011-07-01 06:06:08
2548183badb98d62079beea62f9d2e1f47e99902...395c73560b3716a1f74124826b80ab7ec47d7cd8,1,1,1,2,1,2011-11-01 22:29:18,2011-11-01 22:21:06
468224e580aeb55bd85b37b86f32baada3d17f1e...add416a6c05b580e005726f318463698d746384d,1,1,1,2,1,2012-07-25 22:37:05,2012-07-25 21:57:30
468224e580aeb55bd85b37b86f32baada3d17f1e...4a43d374fcbdea26b3596592a497a1c16f90b9e6,2,3,1,4,2,2011-10-03 18:04:34,2011-10-01 15:56:08
4a43d374fcbdea26b3596592a497a1c16f90b9e6...353f5657a8263bf4159d7e0450fb891df5e2b4c6,1,8,5,13,3,2011-10-03 18:15:27,2011-10-01 16:01:12
353f5657a8263bf4159d7e0450fb891df5e2b4c6...5be7859962585589f374f8467f3252bfcfa10fd0,1,3,5,8,2,2011-10-03 18:15:31,2011-10-01 16:02:36
5be7859962585589f374f8467f3252bfcfa10fd0...1062141928aaa1d272be8ce007d371168e8daef6,1,12,13,25,4,2011-10-03 18:15:32,2011-10-01 16:09:36
1062141928aaa1d272be8ce007d371168e8daef6...86a0a408b900eecc9d0d4a1eb8ae223181e96679,5,19,14,33,7,2011-10-03 18:15:34,2011-10-01 16:16:08
6859de45a94ec0e88703250d9d4df64a09042333...163ed566db7fd0f286413040e368324a59c642f9,1,79,0,79,1,2011-09-14 18:44:05,2011-09-13 21:57:34
163ed566db7fd0f286413040e368324a59c642f9...7878b07c0d86d05fa505f2464557c69addcc2c05,1,2,3,5,1,2011-09-14 18:44:05,2011-09-13 21:57:47
7878b07c0d86d05fa505f2464557c69addcc2c05...c1189caeaf726e6c16c8bca7da8bf0b243da478d,5,125,35,160,12,2011-09-14 18:56:36,2011-09-13 21:57:57
c1189caeaf726e6c16c8bca7da8bf0b243da478d...37e8161a04360d01edd0611135f5eae8e6a08224,2,28,3,31,5,2011-09-14 18:56:49,2011-09-13 21:58:08
37e8161a04360d01edd0611135f5eae8e6a08224...8a534b612410b9746ef33af9e4631fc18bd77621,1,11,37,48,11,2011-09-14 18:56:57,2011-09-13 21:58:14
8a534b612410b9746ef33af9e4631fc18bd77621...7bf0b01750e975f8a4df925ac75efa7f984bf393,1,8,19,27,7,2011-09-14 18:57:25,2011-09-13 21:58:19
7bf0b01750e975f8a4df925ac75efa7f984bf393...5d40a179855a39ae9e8ac22e1874720f2b98a91c,1,8,10,18,6,2011-09-14 18:57:33,2011-09-13 21:58:25
8702fee6171abb2e353499fa0cecba90ad5f277f...740a8fc2249cf7d8b39ab50a25bbf86554158ae7,3,7,2,9,4,2011-09-12 17:33:40,2011-09-12 17:33:03
06bb643b72cc6c67d7c0ac9b8d923463bae68822...b4fd94064de5cec7a45883684225b600d36208d9,1,16,17,33,10,2011-08-26 20:35:31,2011-08-19 14:50:05
b4fd94064de5cec7a45883684225b600d36208d9...10b98fa5b3fab4a4ba46f31b58f8da703b465b68,1,1,1,2,1,2011-09-18 20:55:56,2011-09-17 11:57:43
10b98fa5b3fab4a4ba46f31b58f8da703b465b68...894642f68d3160db9116ca350da83c4a78cff8f2,1,53,44,97,41,2011-09-18 20:56:58,2011-09-17 11:57:44
894642f68d3160db9116ca350da83c4a78cff8f2...baf18fc261ca475343fe3cb9cd2c0dded4bc1bb7,7,34,14,48,13,2011-09-18 21:11:40,2011-09-17 11:57:45
3400c222d9a2dfe8a63684fd47ad5ee7f5d6c4c4...826603d11813e56452dca52c9509e7a3d6a9b900,1,24,1,25,5,2011-08-29 04:49:35,2011-08-29 04:49:35
6486a84cb8e69ddf03b2139db3d968400e05f5b3...2738bc3f09fa1baa3e664a6389394ca51e4fd376,1,2,0,2,1,2011-08-31 17:03:51,2011-08-31 04:48:46
5de89d3abfca98b0dfd0280d28576940c913d60d...eac2d83247ea0a265d923518c26873bb12c33778,2,8,1,9,3,2012-01-06 20:51:09,2012-01-06 20:48:17
37576c14439a4dfa43bec5a5c953fea1cc436bbf...214a5f2e0c86843c5f86494583792cbf3eaf89de,1,0,0,0,0,2013-08-05 16:46:47,2013-08-03 17:26:31
214a5f2e0c86843c5f86494583792cbf3eaf89de...0ed45a1cd6571ed89a09791730a9089e932b7c1f,1,2,2,4,2,2013-08-05 16:47:11,2013-08-05 16:47:11
6c52ec8a9ab48b50fc8bf9559467d5a4cf7eee3b...4cd675565647b2ccacdd6c93841b4ff06c32b16a,1,2,4,6,2,2011-12-20 19:15:16,2011-12-20 08:24:21
eb3b8d7658331f4ec5f115d7407393d845644f5e...7c766e57e8214ee3cef6e215eaf8e2b3b56767e3,3,136,24,160,11,2011-12-05 22:43:22,2011-12-05 00:22:45
0abc0260fa3419de649fcc1444e3d256a17ca6c7...2bb10fe51eae9bf205513b6a1f9197d4599a8c03,1,1,1,2,1,2006-10-23 20:19:18,2006-10-23 16:26:39
2bb10fe51eae9bf205513b6a1f9197d4599a8c03...0cc6d3464a1944e930cfb12ba030eb1581323845,2,20,0,20,2,2006-10-23 20:19:49,2006-10-23 16:42:14
0cc6d3464a1944e930cfb12ba030eb1581323845...810799ecab6f9164401416988d9d79270315ba18,1,2,1,3,1,2006-10-23 21:31:52,2006-10-23 13:59:48
810799ecab6f9164401416988d9d79270315ba18...67aef034551aed0cc417e8b758a59b9978c4f3f1,1,1,1,2,1,2006-10-23 21:33:54,2006-10-23 20:22:25
67aef034551aed0cc417e8b758a59b9978c4f3f1...83543a24c316de60b886cd98272fde2bcc99d558,1,5,1,6,3,2006-10-24 01:26:05,2006-10-24 01:26:05
83543a24c316de60b886cd98272fde2bcc99d558...a153adf683d2b6e22c7e892ed8a161b140156186,1,1,2,3,2,2006-10-24 02:21:05,2006-10-24 00:39:14
019298015bb7c826b72f2573047b7221b0921fd3...36889a5078767be8cc0189c10d235dda327c6a30,5,1,28,29,6,2006-10-27 21:29:55,2006-10-27 21:29:55
36889a5078767be8cc0189c10d235dda327c6a30...887a612fef942dd3e7dae452e2dc582738b0fb41,1,2,6,8,1,2006-10-28 00:15:41,2006-10-26 12:41:25
407e1d6e127357a0fbe1a9f91ee616a2b7ec29db...bed006fbddf919eed81cf62954e0332a395bf035,2,28,0,28,2,2006-11-03 08:24:07,2006-11-01 22:06:20
bed006fbddf919eed81cf62954e0332a395bf035...fc04c412d8d2412e97bb2a664a1746e333dfd9ae,4,91,21,112,10,2006-11-03 08:24:07,2006-11-01 22:06:21
fc04c412d8d2412e97bb2a664a1746e333dfd9ae...920ccbfc3bedd384f3073c342c64fbd028a4ee3a,1,2,2,4,2,2006-11-03 08:24:07,2006-11-01 22:06:22
920ccbfc3bedd384f3073c342c64fbd028a4ee3a...da093d37506f034bfb14e6de26cce9c14b1a1216,5,106,100,206,9,2006-11-03 08:24:07,2006-11-01 22:06:23
da093d37506f034bfb14e6de26cce9c14b1a1216...9ca4a201eaf0c58dbc7184cb2d5ab01c48cb7447,1,10,7,17,2,2006-11-03 08:24:07,2006-11-01 22:06:24
9ca4a201eaf0c58dbc7184cb2d5ab01c48cb7447...576162a45f35e157427300066b0ff566ff698a0f,4,116,39,155,18,2006-11-03 08:24:07,2006-11-01 22:06:25
6255ef08ae746bdad34851297a989ad6f36f6a21...8a078c3f72002af9bf79dc884fe321e3e48930fc,1,28,0,28,3,2006-11-04 09:50:13,2006-11-03 16:41:23
8a078c3f72002af9bf79dc884fe321e3e48930fc...b8ee51815ad0520b0340c2a594dee1f8de9c7c8a,1,10,0,10,2,2006-11-04 09:50:22,2006-11-03 16:41:46
b8ee51815ad0520b0340c2a594dee1f8de9c7c8a...2ac2b19601cd8db8660a8d55647079f1ff4885b1,1,2,1,3,1,2006-11-04 09:50:26,2006-11-03 16:42:17
2ac2b19601cd8db8660a8d55647079f1ff4885b1...2379d61fa6355bc7a8cc8b5dce87a7d4a9505c76,1,2,1,3,2,2006-11-04 09:50:35,2006-11-03 16:42:43
2379d61fa6355bc7a8cc8b5dce87a7d4a9505c76...6768d6b8477db41a1cfdbd1d81ac8c5131c58e1d,1,2,0,2,1,2006-11-04 09:51:35,2006-11-03 05:11:45
82cc8d839bbfd3d13f308145bdae4c9622de57e2...c74390e4a1d78e718de72e5615b7352aeec03979,3,39,91,130,3,2006-11-05 19:26:21,2006-11-05 19:26:21
c74390e4a1d78e718de72e5615b7352aeec03979...144d33dec97405889e302c2391300ee04aad7714,1,4,0,4,4,2006-11-05 21:36:29,2006-11-05 11:20:02
144d33dec97405889e302c2391300ee04aad7714...76c3eb51ede4619116ef980aa34d087c97c25cbc,1,2,0,2,2,2006-11-05 21:36:30,2006-11-05 11:20:25
76c3eb51ede4619116ef980aa34d087c97c25cbc...56fc25f21e280c4f3816e989b34d08d7d7cc59fc,1,21,5,26,4,2006-11-05 21:36:32,2006-11-05 11:21:03
56fc25f21e280c4f3816e989b34d08d7d7cc59fc...873537fadc9bdc35726d1c69c46926c7f5c49dd2,1,70,53,123,28,2006-11-05 21:36:33,2006-11-05 11:21:57
873537fadc9bdc35726d1c69c46926c7f5c49dd2...e5d5b21fdf0ec0aebbfaca814a15d15a718544a2,1,8,3,11,3,2006-11-05 21:36:36,2006-11-05 11:24:56
e5d5b21fdf0ec0aebbfaca814a15d15a718544a2...a79c6551a315b26f2461dd9734defce88014b77b,1,7,7,14,5,2006-11-05 21:36:38,2006-11-05 11:25:25
a79c6551a315b26f2461dd9734defce88014b77b...d28f7cb93537554e069667602a7624952e06df50,2,60,0,60,3,2006-11-06 16:43:34,2006-11-06 08:28:52
dc8302d27439b38cb3042b2d1c1106d8ef99e3f2...a74e60a0f59899c612053b6fe0f0f62652118151,1,1,1,2,1,2006-11-12 02:30:31,2006-11-12 02:22:31
0eaf22f4c4bba89457e733264e71343368712793...65cdb5f1658c4911b3f17a2e99332e5397c52240,1,256,0,256,1,2006-08-10 22:07:11,2006-08-10 20:00:26
ca9e3b124f6313187da641b5cd55100c4ade6a9a...5bb1cda5f73988963e7470f3cd75a380751f6d99,8,11,10,21,10,2006-08-11 23:06:34,2006-08-11 12:01:45
5bb1cda5f73988963e7470f3cd75a380751f6d99...17a10f3709c211769c9fada79bd1608aa64f6080,1,4,41,45,6,2006-08-11 23:16:40,2006-08-11 11:34:07
17a10f3709c211769c9fada79bd1608aa64f6080...308906fa6e98132cab839a4f42701386fba368ef,1,4,1,5,2,2006-08-11 23:21:51,2006-08-11 18:11:29
308906fa6e98132cab839a4f42701386fba368ef...c8769f76d992ed391d169cd71be009ca17727271,1,3,8,11,3,2006-08-12 01:52:43,2006-08-12 01:47:50
cc46a74398e6a542d61d8fa0b197b7dedcd7f301...bdf1c06dc17bdd6d54602544235aa3482ab67c9b,3,59,11,70,8,2007-02-12 00:45:56,2007-02-12 00:45:56
bdf1c06dc17bdd6d54602544235aa3482ab67c9b...c73461567e5bb32d9dc7ffe2b1cdbf736cb86bfc,1,7,0,7,1,2007-02-12 00:50:50,2007-02-12 00:50:50
c73461567e5bb32d9dc7ffe2b1cdbf736cb86bfc...c6ec3b13b81d59272e41d5316689c65dd4cc2e63,1,1,0,1,1,2007-02-12 00:55:22,2007-02-12 00:55:22
cc46a74398e6a542d61d8fa0b197b7dedcd7f301...471efb09aaa266e75e499829fc31a59337ef4a96,1,4,4,8,4,2007-02-10 06:43:02,2007-02-10 06:18:19
471efb09aaa266e75e499829fc31a59337ef4a96...f3dd015c9147e3116fc1941d96f4dad38386b1db,1,8,1,9,2,2007-02-11 06:46:30,2007-02-11 00:33:57
f3dd015c9147e3116fc1941d96f4dad38386b1db...dfd42a3c6281275b518f10938dcd858558cd82e3,2,16,0,16,2,2007-02-11 06:46:34,2007-02-11 00:33:58
dfd42a3c6281275b518f10938dcd858558cd82e3...7774284ac733fac7a23bff058c949723953ece34,1,1,1,2,1,2007-02-11 06:48:18,2007-02-11 05:07:12
7774284ac733fac7a23bff058c949723953ece34...b4f020c5d0850ff2b6227abebc5ce72cffe8e1c1,1,3,3,6,1,2007-02-11 06:48:57,2007-02-10 18:12:01
b4f020c5d0850ff2b6227abebc5ce72cffe8e1c1...4f75b115d7b997c72f65ae1edc337914ea610b47,1,2,2,4,1,2007-02-11 20:42:01,2007-02-11 13:29:58
4f75b115d7b997c72f65ae1edc337914ea610b47...1187d7564d67b532df402050711cb494ceaec2f9,1,7,6,13,7,2007-02-11 20:44:09,2007-02-11 15:54:40
1187d7564d67b532df402050711cb494ceaec2f9...b9f441646c5c8abb92dc110d28decdfe2c9720b2,1,4,27,31,2,2007-02-11 20:47:22,2007-02-10 14:36:47
b9f441646c5c8abb92dc110d28decdfe2c9720b2...0d26a64ece4d2692463a7bcb5235b75ee2f35ec0,1,12,5,17,7,2007-02-11 20:53:05,2007-02-10 14:37:48
0d26a64ece4d2692463a7bcb5235b75ee2f35ec0...e5bfbf9b3ee57292aea95313e8659d26f90f8cc5,1,27,7,34,3,2007-02-11 21:08:10,2007-02-10 14:39:00
e5bfbf9b3ee57292aea95313e8659d26f90f8cc5...788743240e7076a285e226ca230385e041d66db5,1,66,0,66,1,2007-02-11 21:28:42,2007-02-11 21:28:42
788743240e7076a285e226ca230385e041d66db5...602598fd5d8f64028f84d2772725c5e3414a112f,1,6,5,11,4,2007-02-11 21:47:55,2007-02-09 03:22:24
602598fd5d8f64028f84d2772725c5e3414a112f...d4144612958c255d273ad1bd1fe33f03c0f67ada,1,4,0,4,1,2007-02-11 22:07:47,2007-02-09 10:23:23
ecea1ed5fe18a00bfca546d20de8ed8759c35ff6...fa1b4d2ace9bbd7edbcbf9bd41f2cc4f7f6b616e,1,17,20,37,8,2007-02-07 18:43:56,2007-02-07 18:42:08
fa1b4d2ace9bbd7edbcbf9bd41f2cc4f7f6b616e...a4f7112fdee6877af4595927858ff4550f2d9c07,1,1,2,3,2,2007-02-07 18:56:38,2007-02-07 18:56:38
a4f7112fdee6877af4595927858ff4550f2d9c07...abd4e22269e97f3d650277335a111e9bae32f8cb,1,3,4,7,2,2007-02-07 19:58:07,2007-02-07 19:49:56
abd4e22269e97f3d650277335a111e9bae32f8cb...81f915e7f1e274f13499c9713929fd20fa59e3a3,1,1,0,1,1,2007-02-07 22:30:47,2007-02-07 22:30:47
81f915e7f1e274f13499c9713929fd20fa59e3a3...5c553ea2de0e21cb843eaf49b1820f9e395c76a3,1,1,1,2,1,2007-02-07 22:31:46,2007-02-07 22:31:21
5c553ea2de0e21cb843eaf49b1820f9e395c76a3...d48744d1a80031003f9354a79131fca6bff6fa73,1,3,0,3,1,2007-02-08 07:41:43,2007-02-08 07:41:43
d48744d1a80031003f9354a79131fca6bff6fa73...ed35dece2776b0b83d7a35c84ab961668ec11ef4,1,29,1,30,1,2007-02-08 07:54:25,2007-02-07 22:57:43
ed35dece2776b0b83d7a35c84ab961668ec11ef4...66e788bc7fd1888cb4834a48006128a6217f88af,2,4,1,5,2,2007-02-08 23:22:21,2007-02-08 23:22:21
66e788bc7fd1888cb4834a48006128a6217f88af...67dad687ad15d26d8e26f4d27874af0bc0965ce2,4,25,6,31,10,2007-02-08 23:23:52,2007-02-08 13:57:08
67dad687ad15d26d8e26f4d27874af0bc0965ce2...cf39f54efc6ac45f9ef5319103a94d5afa75910e,4,58,10,68,9,2007-02-08 23:35:24,2007-02-08 17:51:56
ba988a83f0cfdafdcfdc7ed44253840ea83578fb...366bfcb68f4d98a43faaf17893a1aa0a7a9e2c58,4,72,35,107,17,2006-12-05 00:33:51,2006-12-04 16:13:39
366bfcb68f4d98a43faaf17893a1aa0a7a9e2c58...6c96753df9db7f790a2ac4d95ec2a868394cd5ff,1,157,76,233,11,2006-12-10 00:56:34,2006-12-09 05:48:07
6c96753df9db7f790a2ac4d95ec2a868394cd5ff...158d0577891441c01457bbcaf45585d3b50f5d75,1,1,11,12,2,2006-12-10 22:50:40,2006-12-10 06:32:43
ba988a83f0cfdafdcfdc7ed44253840ea83578fb...c7c24889bb694f93a12f41a28fab26d30e571c17,2,4,5,9,4,2006-12-05 00:30:54,2006-12-03 18:25:34
c7c24889bb694f93a12f41a28fab26d30e571c17...8ebe185bbf3f1f4f59bcc61e3d1849a76f6af983,1,16,0,16,1,2006-12-05 00:30:54,2006-12-03 16:24:41
8042ed1cebd37419ff38f540482355c0f1d30936...f953831e030d3ece7346bdb5c4fde4fde43c925e,2,26,30,56,7,2006-12-13 05:55:37,2006-12-13 03:05:39
eab90210be73a7edc043a285340f8dc8973b9f07...02c9e93547d4c21635beb30895ebb6e37f67833c,1,0,10,10,1,2006-12-14 10:45:23,2006-12-14 10:40:21
8336afa563fbeff35e531396273065161181f04c...c6b4fa96cbb65036b36e19b4dd61c7030e457327,1,1,1,2,1,2006-12-20 00:32:18,2006-12-19 22:58:20
c6b4fa96cbb65036b36e19b4dd61c7030e457327...5caf92322303a0942e0cee5a93cb24f2d8d44022,1,1,1,2,1,2006-12-20 05:33:24,2006-12-20 02:26:48
5caf92322303a0942e0cee5a93cb24f2d8d44022...c17f9f12a4a8d224e5cff6bcfa6191450f90fa0b,2,0,8,8,2,2006-12-20 05:33:35,2006-12-20 03:25:13
c17f9f12a4a8d224e5cff6bcfa6191450f90fa0b...fc1905bb9340304fb5980841fca24638028c1c5e,1,13,6,19,5,2006-12-20 06:30:59,2006-12-20 05:55:27
fc1905bb9340304fb5980841fca24638028c1c5e...313ce8cee665447e4476d7e8985b270346a8e5a1,1,9,2,11,5,2006-12-20 06:49:59,2006-12-19 12:08:54
313ce8cee665447e4476d7e8985b270346a8e5a1...6d2fa7f1b489c65e677c18eda5c144dbc5d614ab,1,14,13,27,9,2006-12-20 08:42:10,2006-12-19 15:53:08
6d2fa7f1b489c65e677c18eda5c144dbc5d614ab...85023577a8f4b540aa64aa37f6f44578c0c305a3,72,42,201,243,89,2006-12-20 17:51:35,2006-12-19 22:34:12
85023577a8f4b540aa64aa37f6f44578c0c305a3...08a19d873c16aa6127bf4c40cf99a9dd19558a0c,2,3,3,6,3,2006-12-20 18:46:34,2006-12-20 18:34:05
8336afa563fbeff35e531396273065161181f04c...5cde71d64aff03d305099b4d239552679ecfaab6,4,587,0,587,5,2006-12-19 00:28:45,2006-12-11 04:55:50
5cde71d64aff03d305099b4d239552679ecfaab6...835b2aeba74d64e21bba50f31a7c2a16acf24af7,1,242,8,250,14,2006-12-19 00:28:45,2006-12-12 01:09:26
835b2aeba74d64e21bba50f31a7c2a16acf24af7...6a5ad23de6aa95b35d90d631062e5a353e59d3f2,2,119,2,121,4,2006-12-25 09:30:55,2006-12-25 09:30:55
8336afa563fbeff35e531396273065161181f04c...4c10a5caa7d5e481a2acefbae71b694ab7e57108,1,31,2,33,8,2006-12-19 00:28:19,2006-12-18 22:04:38
8336afa563fbeff35e531396273065161181f04c...f3d985c38090b77e46dcc00d42574b9ba49bdc22,1,28,13,41,12,2006-12-19 00:28:12,2006-12-18 07:58:16
f3d985c38090b77e46dcc00d42574b9ba49bdc22...b8e9a00d40839a76928c54366a1c46ad54d7fd5d,1,39,18,57,12,2006-12-19 00:28:12,2006-12-18 22:42:16
8336afa563fbeff35e531396273065161181f04c...74d20040cafdced657efbf49795183d209a3a07b,11,36,26,62,23,2006-12-19 00:21:54,2006-12-18 23:27:43
74d20040cafdced657efbf49795183d209a3a07b...171e800b374c98dd703e906bd9955b2b0410cabe,11,26,36,62,23,2006-12-19 09:14:35,2006-12-19 09:14:35
171e800b374c98dd703e906bd9955b2b0410cabe...8683a45d66967b0969516a2b72cdbf136c2064a2,2,7,3,10,3,2006-12-19 09:14:59,2006-12-19 08:18:09
9a5e4075a4b54581821584386e5e184a57f06d18...ded9f40059b185cd88569aa349784f140418f400,2,11,4,15,6,2007-01-08 11:01:16,2007-01-08 06:43:39
ded9f40059b185cd88569aa349784f140418f400...eec84962108d073d9cc8fdc54ec973a97355ee0f,1,8,0,8,1,2007-01-08 11:01:32,2007-01-08 06:53:03
eec84962108d073d9cc8fdc54ec973a97355ee0f...4083c2fce86c777415a3bc0d5813bcb73f676f98,1,11,5,16,6,2007-01-08 11:01:35,2007-01-08 08:08:46
9a5e4075a4b54581821584386e5e184a57f06d18...510c5a8ee392fd2ab954b676bae486b53f444013,2,5,3,8,4,2007-01-08 05:36:35,2007-01-07 09:35:34
510c5a8ee392fd2ab954b676bae486b53f444013...7d1864ce67d83485cf5cbc8c90fc170ee884ef16,5,21,6,27,8,2007-01-08 05:36:35,2007-01-07 10:00:28
7d1864ce67d83485cf5cbc8c90fc170ee884ef16...4b441f47cefe7f4861167a151a395606e1a16745,2,13,4,17,3,2007-01-08 05:36:35,2007-01-07 10:17:52
4b441f47cefe7f4861167a151a395606e1a16745...7eff28a9b42cb0d3aad932338b2e645fc6ed8fa9,11,25,4,29,15,2007-01-10 23:03:09,2006-12-31 04:32:38
244a70e608204a515c214a11c43f3ecf7642533a...16157b8074926348a9ee191ce6b50c8e1656161c,1,2,0,2,1,2007-01-05 21:31:43,2007-01-05 21:31:43
16157b8074926348a9ee191ce6b50c8e1656161c...21afc41c363cdfbc33285291d92635741163e6a1,1,3,3,6,2,2007-01-06 10:17:06,2007-01-06 10:16:07
21afc41c363cdfbc33285291d92635741163e6a1...f08b3b0e2e9ad87767d80ff03b013c686e08ba4b,1,3,4,7,3,2007-01-06 18:37:14,2007-01-05 22:30:22
f08b3b0e2e9ad87767d80ff03b013c686e08ba4b...1170e8026ae507c510619fceff969b1cf2900a28,1,3,3,6,2,2007-01-06 18:40:54,2007-01-06 01:52:20
1170e8026ae507c510619fceff969b1cf2900a28...f9e8a43a007e81b564516576550a505967389942,1,1,1,2,1,2007-01-06 18:42:49,2007-01-06 03:14:04
f9e8a43a007e81b564516576550a505967389942...e6d7b2f62e52c95c47b078f786705ef9ff8f43c2,1,1,3,4,3,2007-01-06 18:44:40,2007-01-06 10:19:44
e6d7b2f62e52c95c47b078f786705ef9ff8f43c2...cdc0873a78771926b18d9331e04f466ded1b98f2,1,1,1,2,1,2007-01-06 18:44:51,2007-01-06 10:20:57
cdc0873a78771926b18d9331e04f466ded1b98f2...f281e3a1c5948b7dbe2fb47731376506ba3c8c38,1,3,0,3,1,2007-01-06 18:44:59,2007-01-06 10:40:06
f281e3a1c5948b7dbe2fb47731376506ba3c8c38...9fa77a51a49b16fa8886643d7f6346eb0a0601c5,1,11,8,19,3,2007-01-06 18:45:13,2007-01-06 13:46:47
9fa77a51a49b16fa8886643d7f6346eb0a0601c5...40006ea039b8d72cf6dce5816a50c8ba266833ee,2,34,8,42,8,2007-01-07 06:47:58,2007-01-07 00:17:19
40006ea039b8d72cf6dce5816a50c8ba266833ee...09c3a408da1d02a3ea1119694b5deaeb14c20d65,1,4,0,4,4,2007-01-07 06:48:09,2007-01-07 00:22:10
09c3a408da1d02a3ea1119694b5deaeb14c20d65...2eff14259ea4035dc5f8a18f5998e88dd4da207e,1,18,15,33,4,2007-01-07 06:48:21,2007-01-07 01:53:40
2eff14259ea4035dc5f8a18f5998e88dd4da207e...84dee6bbc9eb6dd8e613414ed0271d8290549e89,1,10,6,16,5,2007-01-07 06:48:41,2007-01-07 03:38:38
84dee6bbc9eb6dd8e613414ed0271d8290549e89...fffe694d607ea683b5d08ee99a46d9b06cb74006,1,1,1,2,1,2007-01-07 06:48:48,2007-01-07 06:25:55
fffe694d607ea683b5d08ee99a46d9b06cb74006...62e4f26f3d55bd66989d9b953988de18ba393417,1,5,1,6,4,2007-01-07 06:52:49,2007-01-07 01:52:23
62e4f26f3d55bd66989d9b953988de18ba393417...2e1951f6eddfa070916a0e678aa508f73d92aa50,1,3,3,6,2,2007-01-07 06:52:52,2007-01-07 01:52:24
2e1951f6eddfa070916a0e678aa508f73d92aa50...66399eff86555fce52dc7b54829f02e4bb2424b7,1,3,1,4,2,2007-01-07 06:52:54,2007-01-07 01:52:25
66399eff86555fce52dc7b54829f02e4bb2424b7...ac8b0cd1cd61f74b76261df17a15ada87f437269,1,1,1,2,1,2007-01-07 06:52:55,2007-01-07 01:52:26
ac8b0cd1cd61f74b76261df17a15ada87f437269...13e86efbeae5994a85cc482b3964db7298c5c6ea,1,2,2,4,2,2007-01-07 06:53:08,2007-01-07 01:52:27
244a70e608204a515c214a11c43f3ecf7642533a...e194cd1e0e08611462eb9c5a731a7a3d797f9252,2,278,1,279,2,2007-01-05 07:22:39,2007-01-03 20:13:04
6f9872582246b9b8ee4bdc9f6a563b409aab1ecb...d2a9a87b8a98e3b3797c6c1e5aa2269f36c2b47a,1,184,18,202,32,2006-12-13 01:07:04,2006-12-12 22:47:00
d2a9a87b8a98e3b3797c6c1e5aa2269f36c2b47a...dd31da2fdc199132c9fd42023aea5b33672d73cc,2,10,7,17,8,2006-12-13 01:07:05,2006-12-12 22:47:01
dd31da2fdc199132c9fd42023aea5b33672d73cc...6fda05aebe6e36bfe87113f85b6e70f2b9b73e42,1,1,1,2,1,2006-12-13 01:07:05,2006-12-12 22:47:02
6fda05aebe6e36bfe87113f85b6e70f2b9b73e42...c93be3b539da06e2d89d613448dfadf83c48de53,1,70,0,70,1,2006-12-13 01:07:05,2006-12-13 00:36:16
6f9872582246b9b8ee4bdc9f6a563b409aab1ecb...a1158caeadec4d48b185068f4120d85423de5970,1,87,5,92,10,2006-12-12 08:56:25,2006-12-12 06:41:52
a1158caeadec4d48b185068f4120d85423de5970...753f96a455534ad60b670376fb3d89179281e541,1,2,2,4,1,2006-12-13 18:55:21,2006-12-13 18:55:21
6f9872582246b9b8ee4bdc9f6a563b409aab1ecb...9aa1757382002655cb72bad6a163ff430e08c962,1,1,2,3,1,2006-12-12 08:55:20,2006-12-11 17:09:58
9aa1757382002655cb72bad6a163ff430e08c962...e33fba4c5a33bce748d2c8a1c7a38b78a1fd2cda,1,34,8,42,6,2006-12-12 08:55:22,2006-12-10 12:25:46
e33fba4c5a33bce748d2c8a1c7a38b78a1fd2cda...ca94601c8fcc4ddda4b48f05c748b3d52c54809c,1,48,0,48,2,2006-12-12 08:55:23,2006-12-10 12:25:47
ca94601c8fcc4ddda4b48f05c748b3d52c54809c...3bf9d57051845cee996f73b5402a07cbeda84c88,1,51,1,52,2,2006-12-12 08:55:25,2006-12-10 12:25:48
3bf9d57051845cee996f73b5402a07cbeda84c88...bfe2191f79aa4e74eafc709ea41cc0999c9f5be5,1,5,7,12,2,2006-12-12 08:55:26,2006-12-10 12:25:49
bfe2191f79aa4e74eafc709ea41cc0999c9f5be5...549ab4a30703012ff3a12b5455d319216805a8db,1,15,7,22,4,2006-12-16 20:03:22,2006-12-15 16:53:45
549ab4a30703012ff3a12b5455d319216805a8db...5fce278ef313d3b43a5df5bd0494ad23dc313d22,1,2,1,3,1,2006-12-16 20:03:22,2006-12-15 22:49:12
5fce278ef313d3b43a5df5bd0494ad23dc313d22...c9d193dffbeaf0f106e712879c3ce3d2a4846157,1,29,9,38,3,2006-12-16 20:03:22,2006-12-15 20:57:16
6f9872582246b9b8ee4bdc9f6a563b409aab1ecb...bfddbc5e1e68373ba96441ca228236667912265c,1,4,1,5,1,2006-12-11 22:17:19,2006-12-10 21:50:59
6f9872582246b9b8ee4bdc9f6a563b409aab1ecb...e86ad71fe5f53ae4434566bd09ea4256090e5a3a,2,145,166,311,23,2006-12-11 22:16:54,2006-12-10 23:30:06
a68de9592e4565a2cf3e14b3bc9c9cd57d7306d5...8b42f5ae545d494463e72430fd81a0c0c558c881,1,1,1,2,1,2006-02-24 11:14:34,2006-02-24 08:32:32
8b42f5ae545d494463e72430fd81a0c0c558c881...20d23f554d6cd40ffa0d41ccc9416bca867667e0,1,1,1,2,1,2006-02-24 11:14:44,2006-02-24 08:38:35
20d23f554d6cd40ffa0d41ccc9416bca867667e0...43f72af1bc754f164071140a073d35dad21d2e4e,1,2,2,4,1,2006-02-25 00:16:10,2006-02-25 00:16:10
43f72af1bc754f164071140a073d35dad21d2e4e...1e3584053d56157549c01114f9550d1db7014a3e,1,5,2,7,1,2006-02-25 00:16:34,2006-02-24 22:02:34
1e3584053d56157549c01114f9550d1db7014a3e...6ee9240f63f1756cf23a63aa188cfcdf255a5d55,1,4,0,4,4,2006-02-25 00:16:39,2006-02-24 22:51:15
6ee9240f63f1756cf23a63aa188cfcdf255a5d55...9e4f522da7da8bf5f9018927c82b12e6b02b9058,1,21,27,48,7,2006-02-25 01:27:39,2006-02-24 16:19:54
2b74cffa9179eed274be2a38c59b7e323c813737...5aa44d50f41214d573fa76095dd4410dd6c46f13,1,1,4,5,2,2006-03-02 05:32:00,2006-03-02 04:29:53
5aa44d50f41214d573fa76095dd4410dd6c46f13...e5971d7d138879c071643e4e08fceb4d0ae354ac,1,6,0,6,1,2006-03-02 05:32:17,2006-03-02 05:23:37
e5971d7d138879c071643e4e08fceb4d0ae354ac...7c3ecb65eec9ff2c39c781958bf50ed6541e1332,1,89,0,89,1,2006-03-02 05:32:20,2006-03-02 05:23:37
7c3ecb65eec9ff2c39c781958bf50ed6541e1332...009315499e789d241998fcc5add1f109af8ba0e6,1,3,2,5,2,2006-03-02 05:33:27,2006-03-02 04:24:30
2b74cffa9179eed274be2a38c59b7e323c813737...c8c4f220256eb6065e571793f4687c19eb7c6417,1,26,7,33,6,2006-03-02 01:44:58,2006-03-02 00:58:57
e7da347520486ce33bb77d241b574787c0ec18e8...61e56c8823afd2c5a753a4969330ead0ba850c66,1,2,18,20,3,2006-04-23 08:00:24,2006-04-23 08:00:24
cb303a949f0a6eaa32125b6a52acb9476f71632f...7fcceed7a024f5e2868c123c4ace5b7894ea3423,1,131,59,190,26,2006-04-27 09:21:49,2006-04-27 09:21:49
7fcceed7a024f5e2868c123c4ace5b7894ea3423...f8b28a4078a29cbf93cac6f9edd8d5c203777313,1,358,20,378,22,2006-04-30 23:50:57,2006-04-30 23:50:57
f8b28a4078a29cbf93cac6f9edd8d5c203777313...da7c24dd9c75d014780179f8eb843968919e4c46,1,343,221,564,138,2006-05-02 01:15:29,2006-05-02 01:15:29
da7c24dd9c75d014780179f8eb843968919e4c46...89b11d3ba5132e44cc04826c297a34e31788d0ab,1,29,62,91,9,2006-05-02 09:55:31,2006-05-02 09:55:31
89b11d3ba5132e44cc04826c297a34e31788d0ab...098dd8a34b43ea1317527ca1a3354aae9f3704b5,1,196,51,247,42,2006-05-02 23:32:53,2006-05-02 23:32:53
fc9957b0052df6a8248420395bc9febd66194252...8e4402592574d630cdb5ab4f55a1b7131802ff72,23,102,69,171,76,2006-04-04 07:11:19,2006-04-02 12:44:09
8e4402592574d630cdb5ab4f55a1b7131802ff72...90321c106ca6e36c0e884ca677c9a52dea47bdde,10,18,37,55,18,2006-04-04 07:11:19,2006-04-03 18:30:46
fc9957b0052df6a8248420395bc9febd66194252...ca557afff9f7dad7a8739cd193ac0730d872e282,4,63,25,88,22,2006-04-04 07:11:09,2006-04-04 01:47:55
16139f9035137ccd81e1e9a9dc203fbede6997a0...4890f62bc02929b174ff5fa0e3656ea3d40f0e57,2,9,5,14,5,2006-02-12 12:59:25,2006-02-11 20:39:11
16139f9035137ccd81e1e9a9dc203fbede6997a0...7162dff3dde6fb0a2829fbc8e641fc6d1e7e76ec,2,37,8,45,6,2006-02-12 08:26:54,2006-02-12 03:14:48
16139f9035137ccd81e1e9a9dc203fbede6997a0...6932c78cb4485380a8ff63575a47a58a4e308bfd,2,3,3,6,3,2006-02-12 07:18:33,2006-02-12 00:43:30
ac44f3e7c05390531004d567481004c96d1b262c...7d6fb370bc98e5d4723103dda0829b00c79da213,2,4,1,5,2,2005-12-26 16:59:21,2005-12-24 12:12:43
7d6fb370bc98e5d4723103dda0829b00c79da213...7e4a2a848377241b8fb4f624d1151bbf2f8d5814,6,39,19,58,10,2005-12-27 01:23:59,2005-12-26 20:34:56
7e4a2a848377241b8fb4f624d1151bbf2f8d5814...c97451ce0985e7fc6515cde84a9ad527727b69ea,1,7,1,8,5,2005-12-27 02:23:41,2005-12-27 02:23:41
c97451ce0985e7fc6515cde84a9ad527727b69ea...975b31dc6e12fba8f7b067ddbe32230995e05400,2,86,1,87,2,2005-12-27 02:33:27,2005-12-26 21:31:42
2414721b194453f058079d897d13c4e377f92dc6...457f06d68e427bbf4f1a921877441a622a05e5c4,4,36,1,37,8,2005-12-24 08:21:10,2005-12-22 22:13:56
457f06d68e427bbf4f1a921877441a622a05e5c4...af6e277c5eddbcf82582b4bbd3e50b36aa61a20a,1,22,10,32,13,2005-12-24 08:21:10,2005-12-22 22:19:37
af6e277c5eddbcf82582b4bbd3e50b36aa61a20a...b74ed497350844c3c9fc77c68de3843392086e9b,1,18,0,18,1,2005-12-24 08:21:11,2005-12-23 23:27:18
a489352e3d1d861237729385f9afc5950bcfa6a0...13956670a7baf4b3b794a2cc799bd501753f1746,1,9,2,11,2,2005-11-10 02:54:14,2005-11-10 02:54:14
13956670a7baf4b3b794a2cc799bd501753f1746...a1c292958f9968565f4048a17196d99fd16fc7ca,1,14,2,16,2,2005-11-10 02:56:29,2005-11-08 10:00:31
bfadbeddd1b54af8ab08a6c556c43c756ec85588...7872e0556746c70e49c5558d271d35b1fbfb1680,1,1,1,2,1,2005-10-21 04:26:31,2005-10-20 07:52:32
7872e0556746c70e49c5558d271d35b1fbfb1680...2c674191d507647b4c34486619189d7c6f5dbab9,1,1,0,1,1,2005-10-21 05:31:56,2005-10-21 05:31:56
2c674191d507647b4c34486619189d7c6f5dbab9...4eba0f3763e2f4bbf614c99ae3a5b299e8d61aff,2,5,2,7,4,2005-10-21 05:32:07,2005-10-20 15:13:24
4eba0f3763e2f4bbf614c99ae3a5b299e8d61aff...adc3dbca1aed4e8b25dd9b77463bbe87f7e86b94,1,9,1,10,3,2005-10-21 05:32:07,2005-10-21 01:57:39
adc3dbca1aed4e8b25dd9b77463bbe87f7e86b94...a08b6505942c3c7137f8fb7516a2d5bc54153997,1,4,0,4,1,2005-10-21 05:32:07,2005-10-21 00:16:30
a08b6505942c3c7137f8fb7516a2d5bc54153997...42e2cba20466e50825c55d2642da72bf4f088040,3,54,1,55,3,2005-10-21 05:32:07,2005-10-21 00:28:42
42e2cba20466e50825c55d2642da72bf4f088040...baa720f501a1e8e81fcc6813e28e0ed01d6ca6dd,1,49,10,59,4,2005-10-21 05:32:07,2005-10-21 05:14:14
baa720f501a1e8e81fcc6813e28e0ed01d6ca6dd...2707da9c081f0ec5ada43de1006abaf6a674984c,1,20,2,22,4,2005-10-21 05:32:08,2005-10-21 00:28:45
2707da9c081f0ec5ada43de1006abaf6a674984c...54e31a205c63d8bc8cd3dcf6956f81d3b968ea48,1,1,1,2,1,2005-10-21 05:46:03,2005-10-21 01:34:58
d06b689a933f6d2130f8afdf1ac0ddb83eeb59ab...94fa447ace56bc6514bdd66cafe8f56f0e3ce936,1,47,8,55,3,2005-10-12 05:05:09,2005-10-11 06:22:02
94fa447ace56bc6514bdd66cafe8f56f0e3ce936...221e743c037fc1f9a729adc760546d23df9544a7,1,18,5,23,7,2005-10-12 05:05:09,2005-10-11 06:22:02
221e743c037fc1f9a729adc760546d23df9544a7...a1451104ac2aa97f2e74818787ff54e29b2a77e5,1,2,2,4,3,2005-10-13 01:31:41,2005-10-13 01:31:41
a1451104ac2aa97f2e74818787ff54e29b2a77e5...9cf6d3357aaaaa89dd86cc156221b7b604e9358c,5,517,1,518,5,2005-10-13 01:32:02,2005-10-12 19:01:31
9cf6d3357aaaaa89dd86cc156221b7b604e9358c...84c8d8aec535e1d92c5acc36e84ac8e00f6e0e7a,2,23,6,29,13,2005-10-13 01:32:02,2005-10-12 23:54:19
84c8d8aec535e1d92c5acc36e84ac8e00f6e0e7a...11dcec07a4815b7a37e009df1e8007d7ec08becf,1,179,9,188,8,2005-10-13 01:32:03,2005-10-13 01:12:27
11dcec07a4815b7a37e009df1e8007d7ec08becf...64c381bf740a0a698fe7556fbb346b700b934f7c,2,10,2,12,5,2005-10-13 01:32:03,2005-10-13 01:12:27
64c381bf740a0a698fe7556fbb346b700b934f7c...35613ba4ba967ff408f1b32275f4ebcd51c98097,1,0,3,3,2,2005-10-13 17:01:57,2005-10-13 17:01:57
35613ba4ba967ff408f1b32275f4ebcd51c98097...8af12741ee0e35f43b3180b435cd33642c183e97,2,96,1,97,2,2005-10-13 17:47:42,2005-10-13 17:47:42
8af12741ee0e35f43b3180b435cd33642c183e97...73319032c8d2b2c73138d5caee1d2838fe1305d2,1,12,8,20,2,2005-10-13 18:46:43,2005-10-13 18:46:43
73319032c8d2b2c73138d5caee1d2838fe1305d2...9d835df246e81a6a03e3f633280c45e683e4c673,3,10,8,18,10,2005-10-13 22:38:28,2005-10-13 22:38:28
9d835df246e81a6a03e3f633280c45e683e4c673...64560374cc6c3ebe595540f3425b2b38036cf253,1,21,3,24,5,2005-10-13 22:38:28,2005-10-13 22:38:28
64560374cc6c3ebe595540f3425b2b38036cf253...f7aac2eac96b637755c89c2405a41749c8f6033a,1,5,1,6,3,2005-10-13 22:38:29,2005-10-13 22:38:29
f7aac2eac96b637755c89c2405a41749c8f6033a...603d874587c1b6126c4415d1ca91cfc799fe9043,1,63,36,99,7,2005-10-14 06:18:46,2005-10-14 06:18:46
603d874587c1b6126c4415d1ca91cfc799fe9043...01eea6f355f35098cc5038e94622e30ed31a9267,2,4,0,4,4,2005-10-15 00:13:49,2005-10-15 00:13:49
01eea6f355f35098cc5038e94622e30ed31a9267...c05186cc38ca4605bff1f275619d7d0faeaf2fa5,1,4,0,4,1,2005-10-15 00:14:56,2005-10-15 00:14:56
c05186cc38ca4605bff1f275619d7d0faeaf2fa5...e70ec8632ca0968e4738a66235361937eb4162a9,1,1,1,2,1,2005-10-15 00:15:11,2005-10-15 00:15:11
e70ec8632ca0968e4738a66235361937eb4162a9...bc8f26527064e8bd9123c293741a0a3762b8a64e,1,36,7,43,15,2005-10-15 00:15:46,2005-10-13 17:49:53
bc8f26527064e8bd9123c293741a0a3762b8a64e...d402d5566fdf226697a386dfb9858e5d954e9b91,1,88,21,109,11,2005-10-15 00:16:01,2005-10-15 00:16:01
d402d5566fdf226697a386dfb9858e5d954e9b91...4546738b58a0134eef154231b07d60fc174d56e3,16,51,14,65,16,2005-10-15 00:17:27,2005-10-13 18:03:18
4546738b58a0134eef154231b07d60fc174d56e3...7baa3e8694d823ce9731172c700bf0d780ae283e,1,44,16,60,13,2005-10-15 18:10:46,2005-10-15 18:10:46
7baa3e8694d823ce9731172c700bf0d780ae283e...f80376c5976143a1788ecc4f7ca86ac0ec8b9874,1,3,1,4,1,2005-10-15 18:13:55,2005-10-15 18:13:55
b71d01ef3cb9dfc41b32f360c2b10403b37c0e7a...25785195eebcd700e854e1bcc89f8d5e711523e2,1,2,2,4,1,2005-10-17 20:34:42,2005-10-17 20:34:42
fb8024b414b417d85ce215eba3dd23c188500c15...899460f336254a128602b86ca48433a983dced72,1,2,1,3,2,2005-10-10 04:58:02,2005-10-10 04:58:02
899460f336254a128602b86ca48433a983dced72...5fb41e8abf29a4c24b8e9e95277cfad349a4d1da,1,1,0,1,1,2005-10-10 18:51:11,2005-10-10 18:51:11
5fb41e8abf29a4c24b8e9e95277cfad349a4d1da...d52920e397918fdba0b0ac0bc46633fab807e681,1,4,4,8,4,2005-10-10 20:58:52,2005-10-10 20:58:52
d52920e397918fdba0b0ac0bc46633fab807e681...d9c74a808e988146edd1f4ae463285554cb024bd,1,2,2,4,2,2005-10-10 21:14:06,2005-10-10 21:14:06
d9c74a808e988146edd1f4ae463285554cb024bd...18e410f1eaaf8e3e82dca9f124782b099ead7612,1,3,0,3,1,2005-10-10 21:14:22,2005-10-10 21:14:22
343d35c9166cf1713eb2787c3506fd2663466262...af61c6e008c39ee9f61af33bb48850230f503443,1,5,7,12,6,2005-09-20 22:04:19,2005-09-19 22:16:03
343d35c9166cf1713eb2787c3506fd2663466262...dc4393cba333c92873671a37e72efaf41bfa4697,2,7,1,8,2,2005-09-20 02:50:09,2005-09-20 02:50:09
832cf74c0792a58c9c28e32a8fe5dbb694f0cce6...07e23839459465c1319c7ce91afaf01d3e31a97e,1,5,6,11,4,2014-01-07 22:31:10,2014-01-07 22:10:15
07e23839459465c1319c7ce91afaf01d3e31a97e...648027c4c85bbfdcf0663ff51e55425aefac14a9,1,1,0,1,1,2014-01-07 22:31:52,2014-01-07 22:10:35
648027c4c85bbfdcf0663ff51e55425aefac14a9...a42fcd15d82b6660377749064e0ad25742ccc6f7,1,3,0,3,3,2014-03-13 18:56:17,2014-03-12 20:05:43
a42fcd15d82b6660377749064e0ad25742ccc6f7...4c30d50402c17d2569151820b92cea110ad1d240,1,6,0,6,3,2014-03-13 18:56:29,2014-03-12 20:06:17
e54c1f2d2533c5406abeb8e3e0cf78c68ca9c21e...52c02f658ec07dc32fb43524c9b32b1ea0954f27,1,1,1,2,1,2014-01-31 17:07:17,2014-01-30 16:42:32
efa8fd7ee8eb36df55b3549f6009f000347a796d...a2aed08b4152921d5651e42c09c8945a259e3443,1,11,16,27,4,2014-02-24 22:35:09,2014-01-16 04:10:22
a2aed08b4152921d5651e42c09c8945a259e3443...9adfc1cfa7e4b0081e988cc37f31f5e56be8f339,1,6,0,6,1,2014-02-24 22:35:44,2014-01-16 04:10:23
9adfc1cfa7e4b0081e988cc37f31f5e56be8f339...23d25e48f5ead73c9ce233986f90791abec9f1e8,4,110,27,137,15,2014-02-24 22:35:48,2014-01-26 20:45:15
b6c2a0d45d4165dfd326bd7a28e66d9cedb8ae84...c8e1ee4f2c8e28b7eef824248f09ba37599593d7,2,7,0,7,2,2014-06-04 18:02:55,2014-06-04 07:11:11
00eda23228acb68c85a76f977f4e59f82189ce3f...125f81461db82e29d03fa788e4a897e6ab7d1ded,3,15,1,16,5,2014-03-31 17:26:24,2014-03-16 13:35:03
125f81461db82e29d03fa788e4a897e6ab7d1ded...8640d496823b0aa1d35523b98d8b3f21b54004cd,2,2,2,4,2,2014-03-31 17:31:43,2014-03-16 13:35:00
00eda23228acb68c85a76f977f4e59f82189ce3f...6453f7b34864c1a639cc367f576476ee3be1456f,2,8,0,8,2,2014-03-20 19:38:00,2014-03-17 19:16:05
00eda23228acb68c85a76f977f4e59f82189ce3f...cba5e28426a5c9728d883171e4e5e287ab17136a,1,1,0,1,1,2014-03-17 22:19:52,2014-03-17 19:59:47
00eda23228acb68c85a76f977f4e59f82189ce3f...657673f125008da1ef92d2054c9536722c42f73b,1,16,3,19,4,2014-03-17 22:01:25,2014-03-15 02:26:21
657673f125008da1ef92d2054c9536722c42f73b...78d2214eb4d10ea1e30dd7e69a4e6d73d9f66164,1,3,8,11,3,2014-03-17 22:01:27,2014-03-15 02:26:58
e94ea162db4b5a8c0f385c8181cf48ade7653e7d...be961c292f1d36097afa1690df68cf90f655c855,1,1,1,2,1,2014-01-31 22:16:06,2014-01-31 22:16:06
8c2cfa55446f542454eb4acc7f49d1747e425c94...e6aaa393478bf3ee9f4cde8d82cd258c034cd335,1,1,1,2,1,2014-07-22 17:10:57,2014-07-21 23:00:35
8c2cfa55446f542454eb4acc7f49d1747e425c94...2869b3e5dabdd78b336455ad493951badd35279e,1,2,1,3,2,2014-07-21 16:38:07,2014-07-20 08:00:41
c2f7b1026e33e308782fcb1b60e3d7af107fdc18...aecf567cbfb6ab46e82f7f5df36fb6a2dd5bee69,4,36,4,40,9,2014-07-07 19:30:34,2014-07-06 04:06:56
aecf567cbfb6ab46e82f7f5df36fb6a2dd5bee69...969dd8c612b3b22c4080ffd4448cef4accbf428b,1,2,2,4,3,2014-07-08 17:35:11,2014-07-08 00:33:43
969dd8c612b3b22c4080ffd4448cef4accbf428b...59a8adb6fb4ed27868e7144f4531b1bfd065a9c6,1,23,3,26,2,2014-07-11 15:09:16,2014-07-11 00:31:25
59a8adb6fb4ed27868e7144f4531b1bfd065a9c6...9c4d6c0297b7d6167bf330853139b0515b351b89,2,119,16,135,20,2014-07-14 19:34:51,2014-07-13 20:28:19
9c4d6c0297b7d6167bf330853139b0515b351b89...4ed115e9c545fb27a5b80c751b2c04ec7ecc4d97,2,14,1,15,5,2014-09-03 17:21:33,2014-09-02 21:16:20
c2f7b1026e33e308782fcb1b60e3d7af107fdc18...e7c730530065fb2f366ecbcb1e71d7f7346b6a25,3,36,39,75,24,2014-07-07 18:22:42,2014-07-04 22:41:46
bf80b8a6d8da756324e5d2d113f405d44aaac379...786a89d3477c339676ed36d5d2d7507251344952,1,9,0,9,2,2014-06-20 20:22:55,2014-06-20 20:22:55
cc291953df19aa4a97bee3590e708dc1fc557500...bccce0f8099fac6bcc80914726ddf43ca544b3c1,1,14,7,21,6,2014-04-23 07:01:52,2014-04-21 06:02:03
bccce0f8099fac6bcc80914726ddf43ca544b3c1...dd75553b357d4483d2b58a9e1ac86352f3d2e103,1,8,1,9,1,2014-04-23 07:02:15,2014-04-22 14:39:10
cc291953df19aa4a97bee3590e708dc1fc557500...8b2f86a76146ebbd4ac4f9c2182b3f7bda4492ff,1,2,1,3,2,2014-04-21 18:47:33,2014-04-20 18:59:23
8b2f86a76146ebbd4ac4f9c2182b3f7bda4492ff...03e9010c66adfe5e1693eae039e6754d925b7bf4,3,43,0,43,9,2014-04-21 18:47:33,2014-04-20 18:59:24
03e9010c66adfe5e1693eae039e6754d925b7bf4...d98c81538015630603fd20f6e08e960555a38c52,2,11,4,15,4,2014-04-21 18:47:33,2014-04-20 18:59:25
d98c81538015630603fd20f6e08e960555a38c52...9193f742350d1b97e32b0687d1577dc2b2a0d713,2,18,1,19,2,2014-04-21 18:47:33,2014-04-20 18:59:26
9193f742350d1b97e32b0687d1577dc2b2a0d713...4ee1b225b99f155cc9372397b5e120c2c0eee2bf,3,31,3,34,7,2014-04-21 18:47:34,2014-04-20 18:59:27
4ee1b225b99f155cc9372397b5e120c2c0eee2bf...60ed26438c909fd273528e67b399ee6ca4028e1e,2,25,0,25,3,2014-04-21 18:47:34,2014-04-20 18:59:28
60ed26438c909fd273528e67b399ee6ca4028e1e...f3d0376356756c55a85a3d745858a42c26956e74,2,21,11,32,6,2014-04-21 18:47:34,2014-04-20 18:59:29
f3d0376356756c55a85a3d745858a42c26956e74...e143ef4f6b08e0f948180f28ad3ba77c9a2e0a61,1,0,4,4,2,2014-04-21 18:47:34,2014-04-20 18:59:30
cc291953df19aa4a97bee3590e708dc1fc557500...ec9fa62a10dc5c4d99f3b35f129fa964e23dfaa8,1,4,0,4,1,2014-04-21 17:33:20,2014-04-19 21:47:14
cc291953df19aa4a97bee3590e708dc1fc557500...fe191fcaa58cb785c804465a0da9bcba9fd9e822,20,131,153,284,81,2014-04-19 11:30:13,2013-10-11 12:57:07
cc291953df19aa4a97bee3590e708dc1fc557500...5e078fcd83b32abb447c9567da439fe3741dae1a,1,1264,1263,2527,1102,2014-04-19 04:55:29,2014-04-19 04:53:28
360f852d249f365009b63cab70b50d6f5b5c65e7...4d7ad08f6a3ff172eba464d0037a85ecce00fd0c,1,9,0,9,1,2014-04-08 19:08:34,2014-04-08 19:08:34
3097b687bea8817b4b0afd84db8c4b1079cea92f...2f91649a9ba7c590be4f1ce66521b21e305fb7bc,2,39,1,40,2,2014-04-03 20:40:00,2014-04-03 20:37:29
9526473f110338d23524ea663eb282a36c7fe4f3...cee0c2750bb5f1b38f15ef961517e03c2e39c9ec,4,63,3,66,5,2014-03-18 21:16:16,2014-03-18 21:06:49
5f95c9f850b19b368c43ae399cc831b17a26a5ac...ac9afcc31cd1f7c00c2747132e5f512173613fd9,2,27,0,27,2,2014-06-10 20:09:00,2014-04-27 18:15:47
ac9afcc31cd1f7c00c2747132e5f512173613fd9...bb98b01ee8c5c6f66a6d70aa453b70184dd3d96f,1,3,4,7,3,2014-06-10 20:09:05,2014-05-05 23:51:43
bb98b01ee8c5c6f66a6d70aa453b70184dd3d96f...30e12b924b57b15e707f1749f2e5af15f1c7fe09,2,91,20,111,19,2014-06-10 20:09:24,2014-04-27 18:15:44
30e12b924b57b15e707f1749f2e5af15f1c7fe09...8f2514e95fe142954d1dd4408cc7cb413a275844,1,91,11,102,6,2014-06-10 20:09:39,2014-04-27 18:15:51
5f95c9f850b19b368c43ae399cc831b17a26a5ac...4d4813a52f3722854a54bab046f4abfec13ef6ae,2,9,1,10,2,2014-05-08 21:43:49,2014-04-26 23:10:40
5f95c9f850b19b368c43ae399cc831b17a26a5ac...39539495acb24abfb4dee551e3e9f2e696be7abf,3,17,18,35,14,2014-04-16 16:29:41,2014-03-25 13:41:41
5f95c9f850b19b368c43ae399cc831b17a26a5ac...d813ab970db8b57b70bdd1b7e5feddec1c3fd84e,1,4,5,9,1,2014-04-09 17:14:05,2014-04-07 19:39:41
5f95c9f850b19b368c43ae399cc831b17a26a5ac...b513f71f6043c05c3918e670b332dfa7ec6b2661,5,249,56,305,54,2014-04-07 18:57:11,2014-04-07 15:20:40
5f95c9f850b19b368c43ae399cc831b17a26a5ac...1d2f393ac9bfb4c20f14d6ead7bb4c56e766ab77,4,92,6,98,9,2014-04-07 17:32:20,2014-04-05 16:59:03
1d2f393ac9bfb4c20f14d6ead7bb4c56e766ab77...c215d3d2826c882feb819e5743287ec74d9ff693,2,17,3,20,2,2014-04-07 17:42:35,2014-04-05 16:59:36
5f95c9f850b19b368c43ae399cc831b17a26a5ac...b9d56b5dd9a8819c900725b8618f8bd994a5054f,2,12,0,12,3,2014-04-02 17:40:43,2014-04-02 08:09:54
5f95c9f850b19b368c43ae399cc831b17a26a5ac...e25c070cb5c85ac3abe787373563a31c8893a669,1,1,1,2,1,2014-03-31 18:54:27,2014-03-30 11:08:21
e25c070cb5c85ac3abe787373563a31c8893a669...9ff8ff310b71ab79ffb0ecaa004dec65cec31a45,2,2,2,4,2,2014-03-31 18:55:41,2014-03-30 02:01:54
9ff8ff310b71ab79ffb0ecaa004dec65cec31a45...20d1c6528c76242581e89c271679d35884d916dc,5,4,19,23,10,2014-03-31 20:01:19,2014-03-30 11:08:23
5f95c9f850b19b368c43ae399cc831b17a26a5ac...1f26ce615ab4b74cdd018e5d543138c2d188c3d8,1,3,3,6,1,2014-03-31 18:50:15,2014-03-29 15:39:00
1f26ce615ab4b74cdd018e5d543138c2d188c3d8...11b53902513c6d59f59594845ce53fe761f0894c,2,2,4,6,2,2014-03-31 18:53:24,2014-03-29 15:39:01
5f95c9f850b19b368c43ae399cc831b17a26a5ac...b0f7c7cf865e6b14ccf90f34b6fde0d08af6b50b,1,25,39,64,23,2014-03-24 17:58:11,2014-03-22 17:15:51
b0f7c7cf865e6b14ccf90f34b6fde0d08af6b50b...57b6dc76f28544737b5aa6bddafa2ee5f42047d1,1,42,58,100,3,2014-03-24 22:11:44,2014-03-22 17:15:52
57b6dc76f28544737b5aa6bddafa2ee5f42047d1...e7880fcd41dd4424a79efb0a939f1c008c5519c0,1,14,12,26,3,2014-03-24 22:12:42,2014-03-22 17:15:53
e7880fcd41dd4424a79efb0a939f1c008c5519c0...65a3402f427e76e50e540dbfbe2317d5c66a537d,1,4,14,18,1,2014-03-24 22:12:44,2014-03-22 17:15:54
65a3402f427e76e50e540dbfbe2317d5c66a537d...31a8189ad1a0ab6e933cdafb560c513632028d59,1,4,9,13,1,2014-03-24 22:12:44,2014-03-22 17:15:55
31a8189ad1a0ab6e933cdafb560c513632028d59...218c45a45c4e1c3b09a1b6b2bc6e6ed457e38a9f,2,9,1,10,2,2014-03-24 22:12:45,2014-03-22 17:15:56
218c45a45c4e1c3b09a1b6b2bc6e6ed457e38a9f...63b52afaa88bf89c781fe11c6803ff1dcc47d424,1,7,37,44,6,2014-03-24 22:12:45,2014-03-22 17:15:57
63b52afaa88bf89c781fe11c6803ff1dcc47d424...3753bd1f69d3b17e0369390fb8960ae3b7855b70,1,38,41,79,2,2014-03-24 22:13:10,2014-03-22 17:15:58
3753bd1f69d3b17e0369390fb8960ae3b7855b70...542b2aa2c9afba71febb248edb3083ff9cacf065,1,1,2,3,2,2014-03-24 22:13:17,2014-03-22 17:15:59
542b2aa2c9afba71febb248edb3083ff9cacf065...e4aab50475c1d384e016c6ac6548635f1ddcd3fe,1,2,5,7,2,2014-03-24 22:13:17,2014-03-22 17:16:00
5f95c9f850b19b368c43ae399cc831b17a26a5ac...3064b13053ebf8e629da3024e33550c53f64dfd2,1,2,2,4,2,2014-03-23 20:41:38,2014-03-11 22:37:33
5f95c9f850b19b368c43ae399cc831b17a26a5ac...407e07f2a6f55e605fda9e90cb622887269f68b5,1,1,1,2,1,2014-03-21 21:47:50,2014-03-21 21:07:13
407e07f2a6f55e605fda9e90cb622887269f68b5...abf8f9860248d8c213600974742f18dadaa8fbb5,1,1,1,2,1,2014-03-21 21:48:07,2014-03-21 21:07:14
abf8f9860248d8c213600974742f18dadaa8fbb5...bfa7d01413bd02b5b3675ef0e96f764064a13ce8,2,72,6,78,4,2014-03-21 22:00:51,2014-03-21 21:07:15
bfa7d01413bd02b5b3675ef0e96f764064a13ce8...2d08413ba1ce0a1940e97a5a8af5faf40ab8d178,6,44,88,132,8,2014-03-21 22:02:19,2014-03-21 21:07:16
2d08413ba1ce0a1940e97a5a8af5faf40ab8d178...dd4dc5c574c0849fef6855d9efdfae5dc9369f2d,2,8,4,12,2,2014-03-21 22:02:36,2014-03-21 21:07:17
dd4dc5c574c0849fef6855d9efdfae5dc9369f2d...f1b75fbaf1380e00668f775f27ba8dd52b78a081,4,58,24,82,7,2014-03-21 22:02:57,2014-03-21 21:07:18
f1b75fbaf1380e00668f775f27ba8dd52b78a081...ad5070fb363b1e7ee7e1df83a17f4e8e1eb607a0,1,14,38,52,7,2014-03-21 22:03:28,2014-03-21 21:07:19
ad5070fb363b1e7ee7e1df83a17f4e8e1eb607a0...02907a08ccfbdf0a9a48259fd7e9a234f3c123b3,9,55,0,55,9,2014-03-21 22:03:29,2014-03-21 21:07:20
02907a08ccfbdf0a9a48259fd7e9a234f3c123b3...9cc444f0570b196f1c51664ce2de1d8e1dee6046,12,66,0,66,12,2014-03-21 22:03:31,2014-03-21 21:07:21
9cc444f0570b196f1c51664ce2de1d8e1dee6046...8a2e8da367f7175465118510b474ad365161d6b1,13,3,17,20,13,2014-03-21 22:03:32,2014-03-21 21:07:22
5f95c9f850b19b368c43ae399cc831b17a26a5ac...36dc827bc9d17f80ed4f326de21247a5d1341fbc,1,8,2,10,1,2014-03-20 17:59:55,2014-03-20 13:33:49
5f95c9f850b19b368c43ae399cc831b17a26a5ac...ab58289eff9d305a8f911c8b7bd5b4e84a693563,1,3,3,6,3,2014-03-19 21:10:54,2014-03-19 19:43:53
5f95c9f850b19b368c43ae399cc831b17a26a5ac...512477b175288a429aaf4071dc9fe94f17f0e4ee,12,42,152,194,34,2014-03-19 19:55:57,2014-03-18 18:54:05
5f95c9f850b19b368c43ae399cc831b17a26a5ac...9daf0ef065bfef4fb9dcc1710a39a8177695c84f,1,3,3,6,3,2014-03-19 18:49:35,2014-03-19 15:58:21
9daf0ef065bfef4fb9dcc1710a39a8177695c84f...fd3aeeab0d41474af86e41d207196abbb7bf78f6,1,2,1,3,2,2014-03-19 18:49:39,2014-03-19 15:58:22
5f95c9f850b19b368c43ae399cc831b17a26a5ac...4f4074077fb0c3a2facc61b333337d024aeeebbf,2,21,0,21,2,2014-03-19 17:52:51,2014-03-19 11:02:15
5f95c9f850b19b368c43ae399cc831b17a26a5ac...de42180f6a645491c7ca8683ff2d5060f85f0c51,1,2,2,4,2,2014-03-13 20:00:30,2014-03-13 04:45:50
de42180f6a645491c7ca8683ff2d5060f85f0c51...2d820a61dfd50d50cafab47f75a507f3e6657e9b,1,13,11,24,9,2014-03-19 22:34:56,2014-03-13 04:45:51
5f95c9f850b19b368c43ae399cc831b17a26a5ac...d52cb5761a0e92e6051ea92edc7ae96fb6dca78f,1,17,18,35,15,2014-03-12 21:07:30,2014-03-12 20:51:22
d52cb5761a0e92e6051ea92edc7ae96fb6dca78f...335e8250124aea055cbe4fb8a2268fa9e2f34439,1,15,7,22,2,2014-03-12 21:08:05,2013-12-19 19:43:19
335e8250124aea055cbe4fb8a2268fa9e2f34439...8f17f5b22ae54ecc3dfdafe33d7697e1bf3949f6,1,47,19,66,4,2014-03-12 21:08:05,2013-12-19 19:43:19
8f17f5b22ae54ecc3dfdafe33d7697e1bf3949f6...c7cb333f60db9b8313da75c2075a3619202e905d,3,13,15,28,11,2014-03-12 21:08:05,2014-03-12 20:43:51
5f95c9f850b19b368c43ae399cc831b17a26a5ac...9afad7a1e6363ed249a5cfcc95a35900ae4970cb,1,29,29,58,19,2014-03-11 22:05:26,2014-03-11 21:07:58
9afad7a1e6363ed249a5cfcc95a35900ae4970cb...f76d947ae13ca66790a305a58764ae50ea7442d9,2,17,2,19,2,2014-03-11 22:05:28,2014-03-11 21:15:49
5f95c9f850b19b368c43ae399cc831b17a26a5ac...3219bad94422084184987c9660361f3245d69f04,1,1,1,2,1,2014-03-11 20:57:39,2014-03-10 18:49:31
3219bad94422084184987c9660361f3245d69f04...b7ae14148fc44223b4ffaff5ccbf3227a0af8f3c,1,2,2,4,2,2014-03-11 20:57:43,2014-03-10 18:49:32
b7ae14148fc44223b4ffaff5ccbf3227a0af8f3c...91c9c8692056c0553c6ea9239ccd46f7f3dbd877,1,34,0,34,1,2014-03-18 18:24:39,2014-03-18 10:00:52
91c9c8692056c0553c6ea9239ccd46f7f3dbd877...15048f8a9ace23df67161746ca76b4f46114deee,9,80,32,112,22,2014-03-18 18:25:12,2014-03-18 10:00:53
15048f8a9ace23df67161746ca76b4f46114deee...0a3beb0e2e29ca7a3c33a10112424650706edb5f,1,1,1,2,1,2014-03-18 18:25:38,2014-03-18 10:00:54
0a3beb0e2e29ca7a3c33a10112424650706edb5f...1fc4f97d570c97471202ff561c7e3697e2faee6a,1,21,6,27,6,2014-03-18 18:26:06,2014-03-18 10:00:55
1fc4f97d570c97471202ff561c7e3697e2faee6a...b549be0da7ff9075c0b3de14c1d5d03583ca8d2d,1,1,0,1,1,2014-03-18 18:26:12,2014-03-18 10:00:56
5f95c9f850b19b368c43ae399cc831b17a26a5ac...2c5495f7b60d6ddcd6a411b48d2f6dbc4a24717a,9,34,59,93,29,2014-03-10 15:35:30,2014-03-08 06:48:31
5f95c9f850b19b368c43ae399cc831b17a26a5ac...b0bc1365c29ea3328329ad45aba9e86cd7575af6,1,6,0,6,1,2014-03-07 20:52:02,2014-03-07 20:07:35
5f95c9f850b19b368c43ae399cc831b17a26a5ac...95052d1f2db7103b4ff8d44591fc614419ae6eb2,1,10,0,10,1,2014-03-06 21:53:06,2014-03-05 07:31:55
95052d1f2db7103b4ff8d44591fc614419ae6eb2...303d1d0bd660b56d25ac6016c085bb3856b08203,1,9,9,18,8,2014-03-06 21:54:17,2014-02-28 06:43:33
5f95c9f850b19b368c43ae399cc831b17a26a5ac...f7ade3d36bdffe79c12b563154028f700bb8ed3d,1,30,19,49,4,2014-03-05 21:23:26,2014-03-05 19:03:21
f7ade3d36bdffe79c12b563154028f700bb8ed3d...471fd3fe410ad95ef11270a865203482ce4bca7d,1,24,14,38,9,2014-03-05 21:23:26,2014-03-05 19:03:43
471fd3fe410ad95ef11270a865203482ce4bca7d...ba928c13d75172799f5f06f922e5c2f3232cf114,4,80,2,82,5,2014-03-05 21:23:27,2014-03-05 19:04:54
5f95c9f850b19b368c43ae399cc831b17a26a5ac...e650d0643b43c5681d7ef213aa070ea406eabf0a,2,8,0,8,2,2014-03-05 20:24:01,2014-03-05 19:28:38
5f95c9f850b19b368c43ae399cc831b17a26a5ac...16216b6ab1073b7aaa8225c32208758e6ea16629,1,2,2,4,2,2014-03-05 14:10:24,2014-03-03 14:55:53
5f95c9f850b19b368c43ae399cc831b17a26a5ac...147972b1a67425aefb949630d3b97d547f561654,1,6,8,14,4,2014-03-04 21:26:42,2014-03-04 21:06:30
5f95c9f850b19b368c43ae399cc831b17a26a5ac...ba399c46d9d3930871480ec24518b1541bfdbab3,1,5,2,7,1,2014-03-03 23:38:14,2014-03-03 23:22:15
5f95c9f850b19b368c43ae399cc831b17a26a5ac...25e194070975d4410775e6db0165f4b3b9132bd3,1,3,6,9,1,2014-03-03 22:44:11,2014-03-03 22:31:49
25e194070975d4410775e6db0165f4b3b9132bd3...5cbbe13a9f16e7ddebd186dbf1dddb16185b968f,1,1,5,6,1,2014-03-03 22:44:48,2014-03-03 22:31:50
5cbbe13a9f16e7ddebd186dbf1dddb16185b968f...bcc7a03285a2f0173a2d8afcc951c6dc0fc4eda8,1,1,5,6,1,2014-03-03 22:45:35,2014-03-03 22:31:51
bcc7a03285a2f0173a2d8afcc951c6dc0fc4eda8...d6e82b575a7dc16be03f67fc3c4b648bc18df09f,1,2,6,8,1,2014-03-03 22:47:07,2014-03-03 22:31:52
d6e82b575a7dc16be03f67fc3c4b648bc18df09f...4c960a432cac32a76764c5970e323c294153cec7,1,2,10,12,2,2014-03-03 22:48:39,2014-03-03 22:31:53
4c960a432cac32a76764c5970e323c294153cec7...337ce247e35b88e8413ab80b43d9ce47729c8136,1,2,10,12,2,2014-03-03 22:49:02,2014-03-03 22:31:54
337ce247e35b88e8413ab80b43d9ce47729c8136...104fb26a1e4570d56c7c0a514397ed18e9610b3d,1,1,4,5,1,2014-03-03 22:49:12,2014-03-03 22:31:55
104fb26a1e4570d56c7c0a514397ed18e9610b3d...72004b4310ecc41c87b4bd6357642c6c5cfe9077,1,2,6,8,1,2014-03-03 22:49:17,2014-03-03 22:31:56
72004b4310ecc41c87b4bd6357642c6c5cfe9077...6647cc2626b34493e937db13e6590ee8aad0c109,1,2,10,12,2,2014-03-03 22:53:57,2014-03-03 22:31:57
6647cc2626b34493e937db13e6590ee8aad0c109...9af49f822bc1e4f00b356e052f666ae7714a0399,1,1,4,5,1,2014-03-03 22:54:29,2014-03-03 22:31:58
9af49f822bc1e4f00b356e052f666ae7714a0399...3a7fa03db97eddec274af2ef22d96fc6f486f7c0,1,1,6,7,1,2014-03-03 22:54:37,2014-03-03 22:31:59
3a7fa03db97eddec274af2ef22d96fc6f486f7c0...66d9f38bc72b4415046704697f3d3898afbce73a,1,1,4,5,1,2014-03-03 22:54:45,2014-03-03 22:32:00
66d9f38bc72b4415046704697f3d3898afbce73a...999f566013cf4102c07b0cdbffba419eadc7b368,1,1,5,6,1,2014-03-03 22:54:54,2014-03-03 22:32:01
999f566013cf4102c07b0cdbffba419eadc7b368...c7353967ca8ede681e9f8fbac98a650450631990,1,1,6,7,1,2014-03-03 22:54:58,2014-03-03 22:32:02
5f95c9f850b19b368c43ae399cc831b17a26a5ac...187e290a98ebac7ce393685ea64ad2ba5d5c2dc2,1,12,6,18,6,2014-03-03 20:26:08,2014-03-01 02:50:55
5f95c9f850b19b368c43ae399cc831b17a26a5ac...69897bc2b8b49c09190cce065c027612b21c2d97,2,30,1,31,2,2014-02-28 17:55:35,2014-02-28 10:01:29
69897bc2b8b49c09190cce065c027612b21c2d97...7671b63211712e5163ed46d4c93d0b75680c886c,4,33,2,35,7,2014-02-28 17:55:37,2014-02-28 10:04:19
5f95c9f850b19b368c43ae399cc831b17a26a5ac...9ef176b55c373ba087b2d84e77b5713578891927,6,211,5,216,17,2014-02-27 22:04:05,2014-02-27 12:56:52
5f95c9f850b19b368c43ae399cc831b17a26a5ac...0cc77c386cea7afebb54a5e7263ca37569ecfe7a,1,7,17,24,5,2014-02-27 20:04:23,2014-02-27 10:56:31
0cc77c386cea7afebb54a5e7263ca37569ecfe7a...0179c945fce361c56b465e8a3f0fdf0962a816a1,5,40,37,77,14,2014-02-27 20:07:13,2014-02-27 11:25:20
0179c945fce361c56b465e8a3f0fdf0962a816a1...7839632167bc6ceef20f28bd046f7001493b070f,1,2,2,4,4,2014-03-17 22:03:32,2014-03-15 03:47:06
5f95c9f850b19b368c43ae399cc831b17a26a5ac...0a9136f32758a785fe552adc58bba5824f85e5b7,1,9,15,24,3,2014-02-27 18:55:27,2014-02-26 18:49:22
5f95c9f850b19b368c43ae399cc831b17a26a5ac...0e3d40c60d9ae14ddc9f525ce4db3cbc0bde5278,1,5,0,5,1,2014-02-24 21:23:57,2014-02-24 20:38:29
5f95c9f850b19b368c43ae399cc831b17a26a5ac...136347d718320c56030e3b7a3437259e99c4c41b,3,74,1,75,4,2014-02-24 17:48:40,2014-02-23 20:49:57
136347d718320c56030e3b7a3437259e99c4c41b...5d9fc888b485caa1b6a95f2cb583dc26ab7e8d13,4,20,0,20,5,2014-02-24 21:33:17,2014-02-23 20:49:58
5d9fc888b485caa1b6a95f2cb583dc26ab7e8d13...3c09d6845d253f9d8a75f3a36278c69e01b073e9,3,57,9,66,7,2014-02-24 21:33:17,2014-02-23 20:49:59
5f95c9f850b19b368c43ae399cc831b17a26a5ac...9cbcc2a7ca5b09ff57b52b7f6e422228f6cfd451,1,36,0,36,2,2014-02-24 17:16:53,2014-02-21 19:16:54
5f95c9f850b19b368c43ae399cc831b17a26a5ac...ce375864759f14498126e1f5e630058b6656d187,1,11,6,17,7,2014-02-24 17:09:38,2014-02-21 16:32:03
ce375864759f14498126e1f5e630058b6656d187...1b1005d1b5da02483a9d275f5df522d4d298cc36,1,12,4,16,3,2014-02-24 17:09:56,2014-02-21 16:32:04
1b1005d1b5da02483a9d275f5df522d4d298cc36...30d6c6eabfefed330bebbed9126fe21bf349fd6b,3,11,17,28,15,2014-02-24 17:10:22,2014-02-21 16:32:05
30d6c6eabfefed330bebbed9126fe21bf349fd6b...d40d535b892bf6991811f94ee91f459fc3ea2648,2,78,14,92,14,2014-02-25 00:01:11,2014-02-21 16:32:06
5f95c9f850b19b368c43ae399cc831b17a26a5ac...754dbc43f078625f38c7908f19dc71a0c617ec85,8,13,12,25,13,2014-02-24 17:08:37,2014-02-21 12:50:18
5f95c9f850b19b368c43ae399cc831b17a26a5ac...afc711b8e1ee89626f0dddf0ef01fb73168d47ca,12,24,14,38,14,2014-02-20 22:16:55,2014-02-18 11:24:55
afc711b8e1ee89626f0dddf0ef01fb73168d47ca...1f91e79cf61eaa7cb26eb0aa1e257b7681c4c328,2,20,0,20,4,2014-02-28 21:17:56,2014-02-28 16:29:16
1f91e79cf61eaa7cb26eb0aa1e257b7681c4c328...33bef7ea256e620c579aeff0e672b0becc79c75c,2,35,1,36,8,2014-02-28 21:18:09,2014-02-28 16:29:17
5f95c9f850b19b368c43ae399cc831b17a26a5ac...eb07894fe036566acccb71420ab79ccb9c9e2d66,14,20,17,37,16,2014-02-20 22:15:46,2014-02-15 02:01:46
eb07894fe036566acccb71420ab79ccb9c9e2d66...ff8802283f78e02ccd5d450ccf0ac434bc6258c7,1,0,73,73,2,2014-02-20 22:15:58,2014-02-15 02:01:47
ff8802283f78e02ccd5d450ccf0ac434bc6258c7...70a8fc999d9f0afbc793b21bbb911ecde4e24367,6,0,91,91,20,2014-02-20 22:16:11,2014-02-15 02:01:48
70a8fc999d9f0afbc793b21bbb911ecde4e24367...2c0a1bd616f6d81905c4e8b98e8c9f2d7324924c,2,0,578,578,2,2014-02-20 22:16:25,2014-02-15 02:01:49
5f95c9f850b19b368c43ae399cc831b17a26a5ac...2df85669d16703714968572937ebb67a31241ca3,6,9,9,18,7,2014-02-20 22:14:58,2014-02-18 21:42:22
5f95c9f850b19b368c43ae399cc831b17a26a5ac...46a7471f0e20af9d2efcc4a14c76d537e1551ac9,2,6,1,7,2,2014-02-20 17:50:14,2014-02-17 14:25:13
5f95c9f850b19b368c43ae399cc831b17a26a5ac...d14d42440d8370f8fe5016a6e212d101745f70cc,2,22,4,26,7,2014-02-19 00:12:09,2014-02-18 22:58:52
d14d42440d8370f8fe5016a6e212d101745f70cc...6aea9f0fdd2f013e9b63137727c73da02d42a1be,1,9,9,18,9,2014-02-19 00:12:11,2014-02-18 22:58:53
6aea9f0fdd2f013e9b63137727c73da02d42a1be...c8985ce05360857733738561dd6cdf964470cbdf,3,47,49,96,35,2014-02-19 00:12:13,2014-02-18 22:58:54
c8985ce05360857733738561dd6cdf964470cbdf...3caec73b5568341c5d8f303692423a8e9fb0cb39,5,69,17,86,16,2014-02-19 00:12:14,2014-02-18 22:58:55
5f95c9f850b19b368c43ae399cc831b17a26a5ac...aa012e906542dbc533dbc5bafe1c4e0a47bdc59e,1,1,1,2,1,2014-02-18 23:51:29,2014-02-16 16:06:02
aa012e906542dbc533dbc5bafe1c4e0a47bdc59e...df5213b70d29e65aaff17d2577e42787e5a272bb,1,1,1,2,1,2014-02-18 23:51:33,2014-02-16 16:06:03
df5213b70d29e65aaff17d2577e42787e5a272bb...a68a67dea399f15305b059aa36c007cfdde2890e,1,2,2,4,1,2014-02-18 23:51:40,2014-02-16 16:06:04
a68a67dea399f15305b059aa36c007cfdde2890e...d954828d45efbd4b53576e86066657e87391318d,1,2,1,3,1,2014-02-18 23:51:56,2014-02-16 16:06:05
d954828d45efbd4b53576e86066657e87391318d...78368f2c1ad342719ccf1e719bd5126ca6c7b68b,1,3,1,4,2,2014-02-19 00:00:53,2014-02-19 00:00:53
5f95c9f850b19b368c43ae399cc831b17a26a5ac...beed336c3e35acfd7aad9033eb9294e42b9530af,3,25,13,38,6,2014-02-18 23:50:57,2014-02-18 10:34:20
5f95c9f850b19b368c43ae399cc831b17a26a5ac...983dc69748f6cbdaca62e4655136553b077d3d0c,1,1,1,2,1,2014-02-18 23:50:36,2014-02-17 12:15:30
983dc69748f6cbdaca62e4655136553b077d3d0c...fcef9312a4ad3d94bfa2d02c41e46eb6adcde9b1,2,13,7,20,4,2014-02-18 23:50:40,2014-02-17 12:15:31
fcef9312a4ad3d94bfa2d02c41e46eb6adcde9b1...75df1f434f8cfdac1c8eeacae259ab375c01385b,3,34,4,38,9,2014-02-25 17:35:20,2014-02-17 12:15:32
5f95c9f850b19b368c43ae399cc831b17a26a5ac...8f72011f1c4a626ed1c1e826661d42274f465e29,1,0,2,2,1,2014-02-18 23:10:47,2014-02-15 17:24:50
a15d4af4497d147bfdb672e121b67db335ec1c21...617ce965aa3e5d44d0292c9094ee692f161a55d0,2,22,6,28,10,2014-06-10 20:32:37,2010-07-31 00:04:01
617ce965aa3e5d44d0292c9094ee692f161a55d0...143e615270bd17dcef0d8e5751dacc496eff687d,1,26,24,50,10,2014-06-10 20:32:44,2010-07-31 00:04:02
143e615270bd17dcef0d8e5751dacc496eff687d...1edeb9abf5828e317999b4ebe8b7472c494341f2,1,66,0,66,4,2014-06-10 20:32:50,2010-07-31 00:04:03
1edeb9abf5828e317999b4ebe8b7472c494341f2...1c950a594c40db7a946616cbc6cc5f9e25926a20,2,189,0,189,2,2014-06-10 20:32:59,2011-11-25 20:05:06
1c950a594c40db7a946616cbc6cc5f9e25926a20...eac14f8909d986a38d9eab4a7f926af41dd64a4f,3,273,149,422,54,2014-06-10 20:32:59,2012-01-14 21:24:19
eac14f8909d986a38d9eab4a7f926af41dd64a4f...fcd428f4a952a19d7553a9447fd4fa3c3584c6e6,2,70,46,116,13,2014-06-10 20:32:59,2012-03-01 20:53:54
fcd428f4a952a19d7553a9447fd4fa3c3584c6e6...51822653f58e6b9b6119f560ff864813fbde81ba,1,7,18,25,5,2014-06-16 17:56:19,2014-06-13 22:09:06
12188a82990da099e2f3cf3d37aa4e0362122478...34d5217584ee4722d0c0b07ed6c8f1f01ad157c3,4,20,3,23,5,2014-05-30 17:13:41,2014-05-28 22:50:22
b28aeab4ec1df28f3be3cb62ff4b85e5332d8d13...10e1feebb454d99eb6644cc53b94255f40e6fe9c,3,37,71,108,22,2014-05-20 00:09:57,2014-05-14 19:06:35
10e1feebb454d99eb6644cc53b94255f40e6fe9c...03110863517c4a7aa37a10f14a9ad8be49eeca59,2,6,0,6,2,2014-05-20 00:10:03,2014-05-13 21:29:56
03110863517c4a7aa37a10f14a9ad8be49eeca59...896ba14d653c43bd7a43b6b291e941ab60855c04,1,19,0,19,1,2014-05-20 00:10:03,2014-05-15 21:58:16
b28aeab4ec1df28f3be3cb62ff4b85e5332d8d13...1c3c8410ef02750b8be84cea32ffee8f70918ae9,1,2755,2278,5033,2237,2014-05-11 14:09:01,2014-01-29 13:08:40
7f4ba4b6e3ba7075ca6b379ba23fd3088cbe69a8...47092c10671da906ae626634dc83beb29ce76a9d,5,26,20,46,24,2015-02-26 20:19:21,2015-01-15 08:54:22
2a39bdb9a163f9f4ad11599dbeca87445eecb7d8...9ab698f4000a736864c41f57fbae1e021ac27799,3,321,300,621,4,2015-03-17 23:05:12,2015-03-17 23:05:12
82b7e651990dce7016a903cb020e3dc0eba2ecfe...7a9409cb0104466eba32162f5bc4e5ab46130f02,1,7,0,7,2,2015-03-10 20:53:49,2015-03-10 20:53:49
8004647a217c26f708bce2aa26ed94a4a0ed575d...aaba0ab46273b2c0d540a24ad4fb7a1a55e7f5e1,1,3,0,3,1,2015-03-02 20:48:23,2015-03-02 13:08:09
9a8c2b67cd5a51666f2c0ce3fbbdb08b97b79b3d...b6160d950c9ef168d0f7d7c9b2812f280e5b88fb,2,22,2,24,3,2015-01-12 23:10:46,2015-01-05 09:58:55
9a8c2b67cd5a51666f2c0ce3fbbdb08b97b79b3d...d89ad9c1b8878c54dd46725bd3c01e53b46f748a,1,1,0,1,1,2015-01-07 18:42:53,2015-01-07 12:40:31
9a8c2b67cd5a51666f2c0ce3fbbdb08b97b79b3d...bcfe6f327d7a3ec64aca60beef377f5ada0c9b96,1,9,4,13,1,2015-01-07 18:39:49,2015-01-06 19:01:00
9a8c2b67cd5a51666f2c0ce3fbbdb08b97b79b3d...e66dc0cc4b1a625acc7200f69e0261c77fb1f0a6,1,2,2,4,1,2015-01-06 19:30:42,2015-01-06 10:34:18
9a8c2b67cd5a51666f2c0ce3fbbdb08b97b79b3d...9fb7b57f8272a38747d49fe8ecee2e20bb887570,1,196,195,391,3,2014-12-29 18:52:43,2014-12-24 09:43:12
9fb7b57f8272a38747d49fe8ecee2e20bb887570...0bbc971ab59d5630f974e12cee7aef6189e23c45,1,0,3,3,1,2014-12-29 18:54:20,2014-12-24 09:43:13
0bbc971ab59d5630f974e12cee7aef6189e23c45...66e28e93bb817791cff837df9df0469962e47618,1,3,3,6,3,2014-12-29 18:54:42,2014-12-24 09:43:14
66e28e93bb817791cff837df9df0469962e47618...052b2551adf308e663dbb3fda9ab0347e18dd42b,1,12,0,12,1,2014-12-29 18:56:14,2014-12-24 09:43:15
052b2551adf308e663dbb3fda9ab0347e18dd42b...74c4de58329567b1927370db20278d1284f30a14,2,9,9,18,9,2014-12-29 18:58:45,2014-12-24 09:43:16
b594c975c7e865be23477989d7f36157ad437dc7...024d34cb0813e098c5c0e4ccdacb6a461d34cb6b,1,43,67,110,15,2014-02-25 20:52:28,2014-01-22 20:32:30
024d34cb0813e098c5c0e4ccdacb6a461d34cb6b...dc2eacc58c1118ad68b9d6973033a60b6ed9be1f,1,29,21,50,13,2014-02-25 20:52:59,2014-01-22 23:23:48
dc2eacc58c1118ad68b9d6973033a60b6ed9be1f...4b14ec878a206e87520378b9e1e43aef469bc646,1,8,0,8,1,2014-02-25 20:53:40,2014-01-29 23:08:05
4b14ec878a206e87520378b9e1e43aef469bc646...28ad685f70f93133f2c872e4b1ea2a8f87eaebb5,1,8,8,16,7,2014-02-25 20:54:45,2014-01-23 22:23:43
28ad685f70f93133f2c872e4b1ea2a8f87eaebb5...5aae66bd998429959d89c5bedf0bd8175a2b3f33,2,10,2,12,4,2014-02-25 21:45:38,2014-02-25 21:44:46
5aae66bd998429959d89c5bedf0bd8175a2b3f33...ec445074e0ac4d6003acd21c512c43c8fdb8be86,1,49,6,55,5,2014-03-13 21:22:20,2014-03-12 18:04:11
b594c975c7e865be23477989d7f36157ad437dc7...586aa7863141ad07fd6eb45349a3cb62fdcd28ea,2,110,105,215,63,2014-01-27 17:02:02,2014-01-26 12:57:19
586aa7863141ad07fd6eb45349a3cb62fdcd28ea...43cc5ce9eaa96a4aa93e089a38e0ee1dc732df5c,1,6,3,9,4,2014-01-27 17:04:32,2014-01-27 17:04:32
43cc5ce9eaa96a4aa93e089a38e0ee1dc732df5c...9c96c7f3aa12afbc8e859b930bdb9d9b22080470,1,22,23,45,16,2014-01-27 17:06:26,2014-01-26 12:56:17
b594c975c7e865be23477989d7f36157ad437dc7...816900746839faaa1e346dde32abbce64ccbb3e5,6,0,40,40,6,2014-01-27 16:34:34,2014-01-26 23:43:49
dbc96a77a4e699e356a54f85a93ac29a27c0780e...9c3c367b265d0844c5d3c03c7d0b737b92db731c,1,29,29,58,32,2013-07-15 17:45:33,2013-07-15 17:33:21
c13a5aca5da4e94e69d5432aeeafd123221c79e3...d4d39bc32db51928b190c3128ced6194b81b3a99,1,69,47,116,8,2012-09-15 04:37:51,2012-09-15 04:37:51
682ce8bb37414afe87515123fc6c26f21dd35b15...3a34c2bf6267a5198e926943f68023ad80c34d3d,1,8,7,15,5,2012-09-11 17:24:39,2012-09-11 15:45:29
3a34c2bf6267a5198e926943f68023ad80c34d3d...40bfbde9da5c6cbc85f49a755f27162dc966fd89,2,76,117,193,69,2012-09-11 17:24:39,2012-09-11 15:45:30
31e0100e89c3f7c05bd7fdf54e084b2039d398ec...293ab15eea341ffe8705bac99136f2e3a286db5f,5,550,15,565,18,2012-09-29 18:33:31,2012-09-26 18:21:13
31e0100e89c3f7c05bd7fdf54e084b2039d398ec...a2b4994c826b40b42f395824dcadc082df77959b,1,21,16,37,15,2012-08-29 18:26:07,2012-08-29 13:55:22
a2b4994c826b40b42f395824dcadc082df77959b...e51e30577a9056f5ae7195c694a00ee71200a9d5,1,35,33,68,30,2012-08-29 18:26:09,2012-08-29 13:55:23
e51e30577a9056f5ae7195c694a00ee71200a9d5...b6312c27a06f31625d915d44531d5e728ffd8d63,1,112,77,189,16,2012-09-11 18:49:31,2012-08-30 12:45:50
d5c771e23430e22e63ffe3a9fd8192ee9f7b727a...2b533592900ecebeb69e2dd1b70744433700ff2d,1,0,61,61,1,2012-07-11 20:48:57,2012-07-11 20:48:57
8d8136c37a98bfb545f46990e3854df3414c3528...70969f775d28d7d7dc1f0688f71741f6260d442b,1,0,2,2,2,2012-06-25 17:06:09,2012-06-24 21:37:34
70969f775d28d7d7dc1f0688f71741f6260d442b...4c8a9db6f7dd9e10b5ce9bfbcd5faa82a8c86ce3,1,1,1,2,1,2012-06-25 18:09:35,2012-06-25 10:56:59
0e18bef7e62d6fffd09c394381056ec7a4a79840...21cf32279120799a766d22416be7d82d9ecfbd04,6,158,21,179,21,2012-06-25 16:05:55,2012-06-22 09:03:23
21cf32279120799a766d22416be7d82d9ecfbd04...dc79687e0b70805894d1b4432cef7164ae86e033,4,41,3,44,6,2012-06-25 16:06:15,2012-06-22 09:03:24
dc79687e0b70805894d1b4432cef7164ae86e033...684e40f657ae004d60dfa833567bec4a409d78f9,4,44,8,52,5,2012-06-25 16:06:15,2012-06-22 09:03:25
684e40f657ae004d60dfa833567bec4a409d78f9...0e8593dc5b812df00400347e88f5707225fe831e,3,33,5,38,3,2012-06-25 16:06:15,2012-06-22 09:03:26
9bea2b5896701cf952f75c8f6756656cd3c40af0...7594112513f4b893cacb3db70d54a47e1f65d72c,2,927,703,1630,702,2012-06-14 12:20:15,2012-06-14 12:14:31
9bea2b5896701cf952f75c8f6756656cd3c40af0...1dad5c14f993dcd2d38ce7eb7ecedb624732d692,1,2,0,2,1,2012-06-13 17:24:46,2012-06-13 08:11:29
9bea2b5896701cf952f75c8f6756656cd3c40af0...a3428205e6d74542d6441baaa29d1cb1d1064d95,24,41,41,82,37,2012-06-12 16:30:41,2012-06-11 19:01:53
a3428205e6d74542d6441baaa29d1cb1d1064d95...770bf6c5e2830add4b59d3dbf9929e62ed4d6fb7,1,2,0,2,1,2012-06-25 04:56:13,2012-06-25 04:42:11
770bf6c5e2830add4b59d3dbf9929e62ed4d6fb7...7096b6486e40f509ee53448596b3cdb86360ad3e,24,41,41,82,37,2012-06-25 04:56:13,2012-06-12 16:49:59
7096b6486e40f509ee53448596b3cdb86360ad3e...ad78585eeebd8d5ac596ad4f06f549734ce9d870,1,22,3,25,2,2012-06-25 04:56:13,2012-06-12 16:44:56
a735b79c6357ad5ccc202c29d31b561ad14c75b0...cd07cc53125fb2ca77a644831d4e5d9517bb7a05,1,8,13,21,4,2012-05-11 18:40:43,2012-05-11 18:40:43
7e2010537e96d0a1144520222f20ba1dc3d61441...5430bb283b478991a979437a79e10dcbb6f20e28,2,17,1,18,3,2013-06-25 20:55:03,2013-06-24 21:35:04
7e2010537e96d0a1144520222f20ba1dc3d61441...ea709800302ecae8c2fbb03af01e36b7f9b4d042,2,8,1,9,3,2013-04-23 23:29:07,2013-04-23 22:51:14
7e2010537e96d0a1144520222f20ba1dc3d61441...70d26c6e76d91c04ec53001a21f405b9883e3e3f,1,2,1,3,1,2013-04-16 18:17:48,2013-04-16 09:57:45
7e2010537e96d0a1144520222f20ba1dc3d61441...928734d99370e2478e3b3881e5b0aa79745ac27c,1,7,2,9,1,2013-03-27 04:07:42,2013-03-17 14:09:27
7e2010537e96d0a1144520222f20ba1dc3d61441...57165db00309e756d6d22b097a2fd6cc14055d14,1,2,0,2,1,2013-03-20 19:53:26,2013-03-19 16:17:22
7e2010537e96d0a1144520222f20ba1dc3d61441...3f21fb99ab5335146617f21b885dc41afc7943d6,3,0,15,15,3,2013-03-19 16:10:15,2013-03-19 10:43:14
7e2010537e96d0a1144520222f20ba1dc3d61441...3aba2fddcbff6ba611c05eabeb4a8561c119275f,1,23,7,30,10,2013-03-19 15:40:19,2013-03-19 13:01:15
3aba2fddcbff6ba611c05eabeb4a8561c119275f...8f82aad4e7baf32942eb2087a882e0f8646b2da8,1,3,1,4,2,2013-03-19 15:40:47,2013-03-19 14:16:41
7e2010537e96d0a1144520222f20ba1dc3d61441...75a95490474ab6e991cbbbd10d980498a9109648,4,26,5,31,7,2013-03-17 19:49:03,2013-03-17 08:22:36
75a95490474ab6e991cbbbd10d980498a9109648...f7892d181752187513f10b13f2272fa46c9c8422,3,3,9,12,4,2013-03-17 19:52:14,2013-03-17 08:23:31
f7892d181752187513f10b13f2272fa46c9c8422...03a8eddfd1bd7cdce0b2361753691f53c00e5ba6,2,50,8,58,3,2013-03-17 19:52:20,2013-03-17 08:23:46
03a8eddfd1bd7cdce0b2361753691f53c00e5ba6...c29c46fa2e21e608ce2e603649af5bf38e7969c2,3,67,6,73,8,2013-03-18 15:06:28,2013-03-18 11:37:32
7e2010537e96d0a1144520222f20ba1dc3d61441...772e47cd673e048adb0f7b663617ec70e0cfe598,1,4,3,7,2,2013-03-14 16:39:09,2013-03-07 16:36:03
772e47cd673e048adb0f7b663617ec70e0cfe598...f612a67eac32d73d781503d39077371977d46eae,1,3,2,5,1,2013-03-14 16:39:36,2013-03-09 23:46:00
7e2010537e96d0a1144520222f20ba1dc3d61441...9a7a183bd216fc7f824460e1f6d27886938a6152,1,30,29,59,2,2013-03-08 21:59:57,2013-03-08 18:36:43
9a7a183bd216fc7f824460e1f6d27886938a6152...7ae07c1bd7bdab0bf0b36190c94e761cc593a890,1,1,3,4,2,2013-03-08 22:00:16,2013-03-08 18:45:25
7ae07c1bd7bdab0bf0b36190c94e761cc593a890...98f85ff4b65b565bae0592ded494d67045cbd3bf,3,106,48,154,18,2013-03-08 22:00:22,2013-03-08 21:27:37
7e2010537e96d0a1144520222f20ba1dc3d61441...71ba6b10f81ac8afcb0ba376f6691afe1269467c,1,1,1,2,2,2013-03-07 21:33:56,2013-03-07 00:56:35
71ba6b10f81ac8afcb0ba376f6691afe1269467c...a02ffe0e1a19c9594af3e81f4e04b46eabe4755a,1,4,4,8,2,2013-03-08 18:06:53,2013-03-08 18:01:26
7e2010537e96d0a1144520222f20ba1dc3d61441...5c680be113ec8aca49ddfbe93a9f43684d3d261e,1,18,2,20,2,2013-02-25 21:17:22,2013-02-25 20:31:00
7e2010537e96d0a1144520222f20ba1dc3d61441...3b130ade45c70af63c7692387b65f161770a8ccc,2,11,4,15,2,2013-02-25 20:16:08,2013-02-25 19:30:19
7e2010537e96d0a1144520222f20ba1dc3d61441...3d0e75f2f7a9ae9329154dc85bf5af5c5482f3ea,1,2,2,4,1,2013-02-23 06:24:10,2013-02-23 06:24:10
7e2010537e96d0a1144520222f20ba1dc3d61441...712c6adaeece262121c185a55e83a5074e2a8ea6,1,7,10,17,5,2013-02-22 21:18:22,2013-02-22 21:01:18
7e2010537e96d0a1144520222f20ba1dc3d61441...d9be2485e284d9d73b071b2946fff0b19f97aaa7,1,4,3,7,1,2013-02-14 18:54:58,2013-02-08 17:04:20
7e2010537e96d0a1144520222f20ba1dc3d61441...c787a454524b0c59cb7ca42f09d106554e0224b8,1,6,1,7,6,2013-02-11 16:40:34,2013-02-11 08:35:04
7e2010537e96d0a1144520222f20ba1dc3d61441...59cf706b2381d99b39c4d1daf62da9eeccf0ec13,1,1,1,2,1,2013-02-08 21:10:06,2013-02-08 01:16:24
59cf706b2381d99b39c4d1daf62da9eeccf0ec13...2a9ccfff5553b8ab28eb5a172738cc9f3afadcd5,1,1,1,2,1,2013-02-10 19:35:50,2013-02-10 01:21:25
7e2010537e96d0a1144520222f20ba1dc3d61441...d8cf908cb6012cd4dc3d1089a849daf646150c2e,2,1,8,9,3,2013-02-04 00:31:01,2013-02-03 01:58:49
d8cf908cb6012cd4dc3d1089a849daf646150c2e...c09d62f5635928ab20909cb650b621f7520b56fb,1,1,1,2,1,2013-02-12 23:02:13,2013-02-12 23:02:13
c09d62f5635928ab20909cb650b621f7520b56fb...b4eead95e0c207e4f0492298d795674da119f684,1,1,0,1,1,2013-03-05 16:56:25,2013-03-05 12:43:25
7e2010537e96d0a1144520222f20ba1dc3d61441...afcb6ac83d8854f8cc271bb4e933836c9d4f1d3b,1,6,4,10,2,2013-02-03 21:47:43,2013-02-03 14:37:11
7e2010537e96d0a1144520222f20ba1dc3d61441...776670519823b5c49ff4107dc9f77706fa37bb76,1,7,14,21,4,2013-02-03 21:08:18,2013-02-03 21:08:18
776670519823b5c49ff4107dc9f77706fa37bb76...edbc00e76d29213010db947d8d7bff3baab12a35,1,24,0,24,1,2013-02-05 21:54:30,2013-02-05 21:39:49
7e2010537e96d0a1144520222f20ba1dc3d61441...fc1c5415d69dd7997d20b5a9bdb204d3ee12ed08,1,2,1,3,1,2013-02-03 02:14:45,2013-02-02 21:25:11
7e2010537e96d0a1144520222f20ba1dc3d61441...69789347134b4b04411ae22f6eb516552b6ac365,1,3,2,5,2,2013-02-02 02:09:33,2011-11-18 23:23:24
7e2010537e96d0a1144520222f20ba1dc3d61441...939296c4a42b0eb22542f0fe2e50b53993489eff,1,6,2,8,5,2013-02-01 22:11:50,2013-01-31 02:01:05
7e2010537e96d0a1144520222f20ba1dc3d61441...fa23348e95a3a98ca42a4b74e8f17fb52b95ded8,1,2,1,3,1,2013-02-01 01:00:56,2013-01-31 20:50:38
7e2010537e96d0a1144520222f20ba1dc3d61441...75135b23f66afd362c864939ecd0d6871a87d769,1,4,4,8,2,2013-01-30 16:59:56,2013-01-28 01:18:13
7e2010537e96d0a1144520222f20ba1dc3d61441...131b8fcbfbea0acee8d78a8f9b2b3fee4285aee5,1,5,0,5,2,2013-01-27 03:25:38,2013-01-26 22:40:38
131b8fcbfbea0acee8d78a8f9b2b3fee4285aee5...b495697b8228fdf7cde426ff99fc5ffe7e43d343,1,3,0,3,1,2013-01-27 03:37:30,2013-01-26 22:40:43
7e2010537e96d0a1144520222f20ba1dc3d61441...dc342a25d1b48cb53448fe0e5dde578edce3122c,1,5,1,6,4,2013-01-25 18:41:49,2013-01-24 23:21:46
7e2010537e96d0a1144520222f20ba1dc3d61441...004c0be766f57ffbf5538aeb3edfd3c650f6ceae,1,1,1,2,1,2013-01-22 01:13:16,2013-01-21 16:45:43
004c0be766f57ffbf5538aeb3edfd3c650f6ceae...4084475b204f5fe564eca19d445a1d4cd08ae73a,1,1,1,2,1,2013-01-22 01:13:35,2013-01-21 16:46:15
4084475b204f5fe564eca19d445a1d4cd08ae73a...336e2e27bd46636823dfdbf6471e579bec56595f,1,15,33,48,15,2013-01-22 01:13:51,2013-01-21 16:46:31
7e2010537e96d0a1144520222f20ba1dc3d61441...7811aabbe71e02c1c676a02d57356c80bd94f598,1,1,0,1,1,2013-01-17 20:47:27,2013-01-16 17:29:14
7e2010537e96d0a1144520222f20ba1dc3d61441...b1f809d0aecd9b0853d728dbc3d4c4e44e235785,1,6,0,6,1,2013-01-15 21:08:45,2013-01-15 20:56:21
7e2010537e96d0a1144520222f20ba1dc3d61441...95b63f1ebb1d2b1ae34238cac331dd1e6e437975,1,2,0,2,1,2013-01-11 03:13:17,2013-01-11 03:09:59
7e2010537e96d0a1144520222f20ba1dc3d61441...9a6dcb37bd13f6c6001181a90b0811ca56f154b0,1,3,13,16,1,2013-01-10 22:58:54,2013-01-10 20:54:27
7e2010537e96d0a1144520222f20ba1dc3d61441...be33414b186b3a7abbc1e37a0aa36b6b4d0d0e74,1,2,2,4,2,2013-01-10 18:18:51,2013-01-10 12:29:58
7e2010537e96d0a1144520222f20ba1dc3d61441...6293ded348a918e5644d286dcd8b05044097c27d,1,2,0,2,1,2013-01-08 17:28:00,2013-01-08 11:32:36
7e2010537e96d0a1144520222f20ba1dc3d61441...6310071abfdf7a925b41a131d518d7636daa7259,1,5,5,10,5,2013-01-07 07:48:12,2013-01-07 01:34:58
7e2010537e96d0a1144520222f20ba1dc3d61441...5ea2c847c5938e9868f15a273869e54c6ed4c79c,1,2,5,7,2,2013-01-06 19:35:26,2013-01-06 15:20:57
7e2010537e96d0a1144520222f20ba1dc3d61441...122650457a619a6572c358ba9605a798ac771274,1,8,2,10,1,2013-01-02 17:47:28,2013-01-02 08:25:44
7e2010537e96d0a1144520222f20ba1dc3d61441...721ac4edde75723ef8dbbb68989bda89fbf6fc66,2,81,21,102,11,2013-01-02 00:24:45,2012-12-30 14:39:00
721ac4edde75723ef8dbbb68989bda89fbf6fc66...eb8c5b872ef144add4ac89f85bcddc974ac7114d,1,146,0,146,1,2013-01-02 00:24:48,2012-12-30 14:39:01
eb8c5b872ef144add4ac89f85bcddc974ac7114d...a45fb697f13bb789aca930ce786cf416ef1ecd0e,1,3,6,9,2,2013-01-07 19:06:29,2013-01-06 22:09:39
7e2010537e96d0a1144520222f20ba1dc3d61441...ded6aa6bdaeca5dbeb2b8811ab5d9ec419847b00,1,1,1,2,1,2013-01-01 20:43:02,2013-01-01 13:54:44
ded6aa6bdaeca5dbeb2b8811ab5d9ec419847b00...b5fb4770ad132f1e3458dae61b132e335898dc9e,1,3,4,7,1,2013-01-01 23:48:20,2013-01-01 20:46:15
7e2010537e96d0a1144520222f20ba1dc3d61441...a5ba2cbe1443b7fe7b2977e07dbe7c08435e71b4,1,6,0,6,1,2013-01-01 20:13:43,2013-01-01 09:30:53
a5ba2cbe1443b7fe7b2977e07dbe7c08435e71b4...4b5553b5f31c99f5c0a770d4bab2175fa89dd53a,1,1,1,2,1,2013-01-03 15:43:12,2013-01-03 14:03:08
4b5553b5f31c99f5c0a770d4bab2175fa89dd53a...e216cc48daccf69c6de0c7fbb96c56f99197ca4c,1,21,0,21,1,2013-01-03 15:43:26,2013-01-03 14:03:09
e216cc48daccf69c6de0c7fbb96c56f99197ca4c...20b630aae924e35c24ee3d082362c36bee1c97b3,2,23,12,35,3,2013-01-03 15:44:07,2013-01-03 14:03:10
20b630aae924e35c24ee3d082362c36bee1c97b3...5ee29aefac94d4ed11fc5101c89697f39057abb5,2,23,3,26,5,2013-01-03 17:01:38,2013-01-03 16:16:37
7e2010537e96d0a1144520222f20ba1dc3d61441...b3f1280ec740d8012d18e870a50a5ff76c4e3c42,1,4,1,5,2,2012-12-21 16:10:22,2012-12-21 08:04:49
7e2010537e96d0a1144520222f20ba1dc3d61441...686b2de0ceb2c5a1fb6c8822a8aceb8a05e2fc76,1,1,1,2,1,2012-12-20 21:07:22,2012-12-20 21:03:36
7e2010537e96d0a1144520222f20ba1dc3d61441...f7be59b4770a8a8b76c1d0612db409ce7e8d11f2,1,1,1,2,1,2012-12-18 21:02:33,2012-12-18 20:51:35
7e2010537e96d0a1144520222f20ba1dc3d61441...bd52900df474cfbc67c89e3a2fb30e7ed2df8e78,1,7,2,9,3,2012-12-18 19:35:28,2012-12-18 19:35:28
7e2010537e96d0a1144520222f20ba1dc3d61441...dbc3904ebc604bf5b818d9840b79228aacdd1343,1,2,6,8,1,2012-12-16 07:04:21,2012-12-16 04:15:25
dbc3904ebc604bf5b818d9840b79228aacdd1343...386cc8b031611497186a8c89be0f980a54786525,1,10,5,15,7,2012-12-16 07:04:22,2012-12-16 04:15:26
386cc8b031611497186a8c89be0f980a54786525...3cf773e4264ecc6e9f603a24aeb72cc68b372f96,2,24,7,31,11,2012-12-16 07:04:22,2012-12-16 04:15:27
3cf773e4264ecc6e9f603a24aeb72cc68b372f96...eec3e7e406867487036cf447fe8fa18740824b2f,2,32,2,34,6,2012-12-16 07:04:22,2012-12-16 04:15:28
7e2010537e96d0a1144520222f20ba1dc3d61441...5d34a4359d51b44483a1e62dc8a1f6ec686c8b6f,2,26,0,26,4,2012-11-28 18:41:08,2012-11-28 02:27:37
5d34a4359d51b44483a1e62dc8a1f6ec686c8b6f...5c17f51270e1b384e03fb9c16b5a0040b115ae8c,2,20,0,20,4,2012-11-28 21:52:54,2012-11-28 21:35:29
7e2010537e96d0a1144520222f20ba1dc3d61441...f10e3864dc3b0ba0051148f9b2b555df11fc337a,1,1,1,2,1,2012-11-20 20:13:09,2012-11-11 10:13:57
7e2010537e96d0a1144520222f20ba1dc3d61441...cd163d4b4e190d5e5131962c1b8f84601d4736d4,1,15,0,15,3,2012-11-16 02:04:54,2012-11-15 01:45:52
7e2010537e96d0a1144520222f20ba1dc3d61441...0f0ecf68b31303de7cb428554e27d433fe62180e,2,16,0,16,2,2012-11-12 21:34:53,2012-11-12 21:34:28
7e2010537e96d0a1144520222f20ba1dc3d61441...e70528862f0f67fdb6bd67d8819d5b01156eacdc,1,6,2,8,2,2012-11-08 19:11:53,2012-11-05 04:31:01
7e2010537e96d0a1144520222f20ba1dc3d61441...048b3991924a0666a2ab4f381caac8d62962de38,1,8,9,17,2,2012-11-08 17:59:23,2012-11-04 17:45:55
7e2010537e96d0a1144520222f20ba1dc3d61441...6b2bf41e6c1c9742c5ad5b5920f48a7b23aa6a50,2,20,1,21,2,2012-11-08 17:46:14,2012-11-04 22:04:02
7e2010537e96d0a1144520222f20ba1dc3d61441...a3a4391abfeb664d8239b232bbee32b2163c10bd,1,1,1,2,1,2012-11-08 16:32:38,2012-11-06 10:29:01
7e2010537e96d0a1144520222f20ba1dc3d61441...0e18bcd5e937b9e5857892e7f5c80c3c5b1da5d4,6,12,4,16,6,2012-11-04 13:10:33,2012-10-19 05:41:56
7e2010537e96d0a1144520222f20ba1dc3d61441...7349afd20e3b0ce3da6f192f593390472acec9d3,3,15,6,21,5,2012-11-02 15:38:29,2012-10-30 09:50:42
7e2010537e96d0a1144520222f20ba1dc3d61441...ae45320c40e255362b39f6ff609f759927fbd096,1,5,0,5,1,2012-11-02 11:49:28,2012-11-02 10:39:30
7e2010537e96d0a1144520222f20ba1dc3d61441...098bbdc31c8dc66e2c7a1a531625502be512b016,1,5,1,6,2,2012-10-29 08:16:49,2012-10-21 19:46:37
7e2010537e96d0a1144520222f20ba1dc3d61441...58ca9ad4d68951f5f04f7c2399be55590dcf6a59,1,2,2,4,2,2012-10-29 07:24:57,2012-10-26 19:13:54
58ca9ad4d68951f5f04f7c2399be55590dcf6a59...e15bec0ec3b763449e418c12a5f2e128560c556d,1,1,3,4,3,2012-10-29 07:25:50,2012-10-28 21:37:16
7e2010537e96d0a1144520222f20ba1dc3d61441...02e8ca0e50abc15596db1fa93bda29bbd91007a7,1,21,19,40,13,2012-10-29 06:52:41,2012-10-28 16:50:54
7e2010537e96d0a1144520222f20ba1dc3d61441...3a599b832b27eca70bb2956a5a127fc35e0cb233,1,4,4,8,2,2012-10-29 06:27:13,2012-10-28 20:12:46
7e2010537e96d0a1144520222f20ba1dc3d61441...d505865be5c7d72abb74318940e8c4c52aa0db5f,1,4,4,8,3,2012-10-29 05:37:07,2012-10-28 14:13:27
7e2010537e96d0a1144520222f20ba1dc3d61441...b1c2f57db326c43ec286855b396fb16b4890cf2d,2,14,2,16,3,2012-10-28 11:59:44,2012-10-28 11:40:00
7e2010537e96d0a1144520222f20ba1dc3d61441...e342acc678219ff5451998a6b79aa018fb69533b,1,1,1,2,1,2012-10-28 11:50:24,2012-10-26 16:18:24
7e2010537e96d0a1144520222f20ba1dc3d61441...3174bc5ccfea34717a8dac2175c1951239a4985d,1,1,1,2,1,2012-10-28 11:50:18,2012-10-27 22:49:55
7e2010537e96d0a1144520222f20ba1dc3d61441...835460bba9fa36aa8e3ef1291cc317085ef6e681,1,0,1,1,1,2012-10-26 14:32:31,2012-10-25 04:52:52
7e2010537e96d0a1144520222f20ba1dc3d61441...bc22b27749fa46762dd493501bedf333847f0fcd,1,7,0,7,1,2012-10-26 13:32:53,2012-10-23 10:33:26
7e2010537e96d0a1144520222f20ba1dc3d61441...49aeead2aecd6713765f5099d9c990bca4d877ef,1,2,2,4,2,2012-10-25 10:59:17,2012-10-24 15:34:27
7e2010537e96d0a1144520222f20ba1dc3d61441...11fbe18e9e36b28642b41ecfbc9156eff08ce92c,1,6,0,6,1,2012-10-25 10:56:39,2012-10-21 20:52:37
7e2010537e96d0a1144520222f20ba1dc3d61441...a6d3bde5afc5d742af0d7b1f2725b760dca165cb,4,6,6,12,6,2012-10-25 10:55:46,2012-10-23 11:34:05
7e2010537e96d0a1144520222f20ba1dc3d61441...7202b81ffccf89605ce2726ff9d63202b5f1da7f,1,12,0,12,1,2012-10-19 21:15:17,2012-10-19 21:04:20
42e55a5f5709642cb7a56ecad8b706341f0eb38a...fb2c984148a344781833b25361154619230d9dd4,6,361,7,368,14,2012-10-17 05:23:18,2012-10-17 03:53:29
fb2c984148a344781833b25361154619230d9dd4...c2b3af0537e0b2c7624913b0f26191e992beb12c,1,13,4,17,5,2012-11-04 13:02:41,2012-11-04 12:25:36
42e55a5f5709642cb7a56ecad8b706341f0eb38a...2f65494d84fa9d250595e6c02d9e977c512cc09c,2,23,17,40,6,2012-10-16 18:51:03,2012-10-16 00:21:50
8b56a4702209a6054bd1eb89e9d63abfd6f4cf2e...2808f6abc238ab038020681d43eaec7c0335efaa,2,47,1,48,2,2012-11-19 03:47:19,2012-11-19 03:47:19
b0b00a3ee43b4813eb85728a482500f6422499fd...10643d4ec3b9c5898d93d1c20e98b2ff1906bf79,4,19,24,43,18,2012-12-02 09:37:20,2012-11-30 01:41:33
10643d4ec3b9c5898d93d1c20e98b2ff1906bf79...b24e6047a8da3cddfd686e6a9157ed4bac28ed4f,5,25,0,25,8,2012-12-02 09:39:50,2012-11-30 01:41:34
b24e6047a8da3cddfd686e6a9157ed4bac28ed4f...ffe81ef2ac5bcf83b9ab792e4d05ec95744a2fb6,2,12,7,19,4,2012-12-02 09:43:28,2012-11-30 01:41:35
ffe81ef2ac5bcf83b9ab792e4d05ec95744a2fb6...8c5f6f717d136c5a0e9d6d3879bf2a7bdeb42154,3,12,5,17,4,2012-12-02 09:44:15,2012-11-30 01:41:36
8c5f6f717d136c5a0e9d6d3879bf2a7bdeb42154...dbfeddb12e5bb540ed3c852eebda3df9117bd150,9,62,13,75,16,2012-12-02 09:44:34,2012-11-30 01:41:37
dbfeddb12e5bb540ed3c852eebda3df9117bd150...40eff1799983b958d6dbe09fb499ad505bcf6f8d,3,35,7,42,5,2012-12-02 09:44:49,2012-11-30 01:41:38
40eff1799983b958d6dbe09fb499ad505bcf6f8d...80054cf9d53aad76631797d76ce33a56c855c61a,1,5,0,5,1,2012-12-02 09:45:13,2012-11-30 01:41:39
80054cf9d53aad76631797d76ce33a56c855c61a...a272b2896dcfd2758e97e0f35cb14df4436d7101,1,17,15,32,7,2012-12-03 16:02:33,2012-11-30 01:41:40
a272b2896dcfd2758e97e0f35cb14df4436d7101...1184564eac8ef6c82da068a31f60aee0d6870265,4,10,7,17,8,2012-12-03 16:04:08,2012-12-03 03:27:50
1184564eac8ef6c82da068a31f60aee0d6870265...b450568209c8ae270d26ee7fda2e4687ad8a5327,4,11,2,13,6,2012-12-03 16:04:09,2012-12-03 03:27:51
b0b00a3ee43b4813eb85728a482500f6422499fd...8cac13dccbf78005f1579bf22dbac1bfe27e1572,2,3,9,12,5,2012-11-26 19:32:24,2012-11-24 11:16:19
b0b00a3ee43b4813eb85728a482500f6422499fd...bdccd3c1fb261dc6d4aaf9fae446eea7136b76e2,2,52,1,53,4,2012-11-16 01:47:24,2012-11-15 00:33:25
bdccd3c1fb261dc6d4aaf9fae446eea7136b76e2...09feffb633d9e27fa2f3b96ff7c367baa3164ce0,2,7,11,18,3,2012-11-16 01:47:24,2012-11-15 00:33:40
09feffb633d9e27fa2f3b96ff7c367baa3164ce0...452802309c422ce71f1c038357ee0775af5fb3eb,2,5,5,10,2,2012-11-16 01:47:24,2012-11-15 00:34:05
452802309c422ce71f1c038357ee0775af5fb3eb...d6991ceedc6a6fbcc2184f8328eb1b4c88b55267,3,29,10,39,12,2012-11-16 01:47:24,2012-11-15 00:34:13
d6991ceedc6a6fbcc2184f8328eb1b4c88b55267...879ed7539357cf54e1c14f1c203eacd74469ff4c,1,49,0,49,1,2012-11-28 18:49:13,2012-11-28 18:26:43
b0b00a3ee43b4813eb85728a482500f6422499fd...9dfc36841b3f1a2669f0513676cc4d72ef1220a1,2,20,6,26,6,2012-11-13 13:34:14,2012-11-13 10:34:11
b0b00a3ee43b4813eb85728a482500f6422499fd...380a4d927bff693c42fc6b22c3547bdcaac4bdc3,2,11,0,11,4,2012-11-12 20:47:50,2012-11-12 00:17:20
380a4d927bff693c42fc6b22c3547bdcaac4bdc3...9fca6cffc05321445b59c91e8f8d308f41588b53,2,4,4,8,3,2012-11-19 04:02:40,2012-11-18 21:16:52
3b73c7d1c8a3e76c6e15a294bd5c3e2a04efa7ea...5d417842efeafb6e109db7574196901c4e95d273,3,21,16,37,7,2012-12-31 22:25:57,2012-12-31 22:24:22
4881616c1a4fa7b19ca2c722ef0b3d48316ac8ef...24a62db7bbcbd8083bd0070ecd434205489629ed,1,4,1,5,1,2012-12-12 19:58:17,2012-12-12 18:06:24
34e8d9982a6b564aa5a563c992e5c40340d66e3e...587e0a164a1b31da9fcb35a5e040e537a254fcca,1,31,0,31,4,2013-09-18 18:55:59,2013-09-18 18:55:59
86ef7b37f921dccff6d940fb17005e0906a2bf3e...cc1b258e2aaba8cbb34aa7dca72a3a4a5a07014f,1,241,89,330,42,2013-01-03 22:43:56,2012-11-27 23:41:07
cc1b258e2aaba8cbb34aa7dca72a3a4a5a07014f...ab05d7c7361afa123e63767da7c1f85e66d0028f,1,15,3,18,7,2013-01-04 06:59:47,2013-01-04 06:56:12
ab05d7c7361afa123e63767da7c1f85e66d0028f...e510f2d610b30013675c9b08bae92a9cfc4b5907,1,6,5,11,3,2013-01-25 20:34:43,2013-01-25 20:33:57
86ef7b37f921dccff6d940fb17005e0906a2bf3e...4047fecf714e8ffdc4ae199f9cd3ee2d50b0259c,1,2,0,2,1,2012-11-28 20:01:16,2012-11-28 18:27:02
86ef7b37f921dccff6d940fb17005e0906a2bf3e...b48990e7382a94bc6762ee7b88467d5d5a70fcb0,1,14,2,16,3,2012-11-28 06:39:08,2012-11-27 23:52:27
86ef7b37f921dccff6d940fb17005e0906a2bf3e...e0a52279304a67d6e13c5a5b4165dd09f6ba61aa,1,11,1,12,1,2012-11-28 06:33:50,2012-11-27 23:28:51
be7baf913a1c8e57fd871ebed17b47bec7687a9d...719125c522bbcdbdb4c5c36c914a8c1bce5e00d4,1,3,37,40,7,2013-01-15 20:59:51,2013-01-15 08:06:19
719125c522bbcdbdb4c5c36c914a8c1bce5e00d4...cbc607614d5b1be0a1a039a5b777ed751708ef7f,1,7,11,18,7,2013-01-15 20:59:51,2013-01-15 08:06:20
cbc607614d5b1be0a1a039a5b777ed751708ef7f...75b24bdf3cc422f2714f90fe995a6782ac517bc6,1,0,5,5,1,2013-01-15 20:59:51,2013-01-15 08:06:21
75b24bdf3cc422f2714f90fe995a6782ac517bc6...2fbd21174605281b263781ba6944a4354e4ee0eb,1,0,11,11,2,2013-01-15 20:59:51,2013-01-15 08:06:22
2fbd21174605281b263781ba6944a4354e4ee0eb...e6de37513969a42160647056db8580902d9614d8,1,0,26,26,5,2013-01-15 20:59:51,2013-01-15 08:06:23
e6de37513969a42160647056db8580902d9614d8...1efee7ffce56da48ac0cecfe2e66f0f6f2b15dd6,1,13,12,25,5,2013-01-15 22:50:19,2013-01-15 08:06:24
1efee7ffce56da48ac0cecfe2e66f0f6f2b15dd6...81b38947c17d319204a1292d28c8608c7fc25319,1,2,7,9,3,2013-01-15 22:50:22,2013-01-15 08:06:25
81b38947c17d319204a1292d28c8608c7fc25319...15f4ad19d686f2b5cd6908b3dbad6d250518b177,1,3,36,39,4,2013-01-15 22:50:22,2013-01-15 08:06:26
15f4ad19d686f2b5cd6908b3dbad6d250518b177...3648b4d996be3e89d53a9beefc448c7129e3a49f,1,9,66,75,17,2013-01-15 22:50:22,2013-01-15 08:06:27
3648b4d996be3e89d53a9beefc448c7129e3a49f...c197454da64bc9a4cb6fa992a603460f590633dc,1,0,2,2,2,2013-01-15 22:50:23,2013-01-15 08:06:28
c197454da64bc9a4cb6fa992a603460f590633dc...fe47e1df2431c0d5a98195df45a8a49a1fb0a91a,1,9,10,19,10,2013-01-15 22:50:23,2013-01-15 08:06:29
fe47e1df2431c0d5a98195df45a8a49a1fb0a91a...9a08cbb7cd22c0cfd3bb85b9ac6b374c3b701d42,1,0,1,1,1,2013-01-15 22:50:23,2013-01-15 08:06:30
9a08cbb7cd22c0cfd3bb85b9ac6b374c3b701d42...636fd66bc18d7563b9260485a9974da67a805514,1,7,11,18,6,2013-01-15 22:50:23,2013-01-15 08:06:31
636fd66bc18d7563b9260485a9974da67a805514...3691031cb33922ce49448518aa06e33eded3368e,1,23,29,52,6,2013-01-15 22:50:23,2013-01-15 08:06:32
a9064b25c016e3ac69a724962f794c4dc46fdba5...8f8af9f4d1535d84e75cb3686f4b54725ea1e19f,1,10,1,11,3,2012-11-28 21:49:10,2012-11-28 21:49:10
491e3075a29a0475984098a85cdbbb185d5a1e33...552755a88b3b4c28166336a0f4ffac08cf43fb89,1,3,2,5,2,2012-12-04 15:57:30,2012-12-04 09:15:03
5956732ebb4fe38d2fb0574004efabf76a8b2d10...ed9fe755130891fc878bb2433204faffb534697b,3,16,3,19,4,2012-11-26 02:40:34,2012-11-26 02:40:34
15470c604d7675dbe444165469f76e931a2edc8e...f94c3251e1400c3cf349f7f84fea4db66b540113,1,32,1,33,3,2012-11-29 21:57:09,2012-11-29 21:57:09
03a0fb0ccf48c831060c2243f830b6a12cd8fdf3...ce4c4d4ec3df274349f20431c61ed85cea038026,2,28,1,29,4,2013-03-17 06:30:08,2013-03-15 02:26:08
03a0fb0ccf48c831060c2243f830b6a12cd8fdf3...c73592812d36ccc7eccfd0489177970d246fa522,3,10,0,10,3,2013-03-17 05:57:29,2013-03-17 03:28:06
03a0fb0ccf48c831060c2243f830b6a12cd8fdf3...ea738e2da113567a430f3ab175d1759d26557e51,1,13,16,29,3,2013-03-17 05:23:04,2013-03-16 15:58:28
ea738e2da113567a430f3ab175d1759d26557e51...b2981d06226ab0fdabf9110c3be7104110b307ae,1,14,18,32,9,2013-03-17 07:10:51,2013-03-16 18:29:31
b2981d06226ab0fdabf9110c3be7104110b307ae...47e329ef7c46de8ccdc8c4e40333579264a83c21,1,4,4,8,1,2013-03-17 07:10:59,2013-03-16 18:51:43
03a0fb0ccf48c831060c2243f830b6a12cd8fdf3...3ae851e6fbb4e99fa7281d18a5c6f95a3fb6d998,2,13,1,14,2,2013-03-13 17:35:15,2013-03-12 23:13:41
cde47b9dce8b7d2411d972d20585ba4b2f8f6767...aadb70a5594222cac215f9590017f05d5d0f31b2,1,1,1,2,1,2013-03-07 21:14:39,2013-03-07 21:14:39
3755b53af779ce75fa3ea4581a0e6525bc67278d...b6679e768f39f718b7f2983d1958f5fb1121f356,1,3,3,6,2,2013-07-23 18:37:46,2013-07-23 14:28:04
b6679e768f39f718b7f2983d1958f5fb1121f356...58960978462e66c3dbc53b274988e7f27e7c74e2,1,8,0,8,1,2013-07-23 19:06:58,2013-07-23 14:28:05
58960978462e66c3dbc53b274988e7f27e7c74e2...99780b0a4ab22c903516601bb3634e6477d7f1c1,1,5,0,5,1,2013-07-23 19:08:15,2013-07-23 14:28:07
99780b0a4ab22c903516601bb3634e6477d7f1c1...f8395edc6f5c59a92adcf42ea20a01872ec22700,2,4,1,5,2,2013-07-23 19:09:14,2013-07-23 14:28:06
f8395edc6f5c59a92adcf42ea20a01872ec22700...df6308eb82bc9d2074b35387583548b8b153433d,2,2,1,3,2,2013-07-23 19:09:48,2013-07-23 14:28:08
4d0d0c3c59800e07d899e53121902833e3fd0cc7...ac751a0b4332268ad9ba69c7dd48768dbdbd25c8,2,35,30,65,5,2013-03-04 03:43:54,2013-03-04 00:03:37
5bf72ed2e7ef82d5ef7a35c978dc72576fdb0efc...9caaf23ef00b99e50857f6c110073d64d022dbd7,1,722,601,1323,555,2013-02-14 06:51:38,2013-02-14 06:49:45
9caaf23ef00b99e50857f6c110073d64d022dbd7...77c8e5432112d0ed554c9dda7408eba90a5c4f5f,1,795,647,1442,585,2013-02-17 01:43:34,2013-02-17 01:42:47
77c8e5432112d0ed554c9dda7408eba90a5c4f5f...a77c07d9747fdba7aef22374a91d4b6aaf2f7b2f,1,767,625,1392,563,2013-02-18 01:52:33,2013-02-14 09:47:45
5bf72ed2e7ef82d5ef7a35c978dc72576fdb0efc...61564ca5bf29bb8039b865514a7593fc7b6c5440,1,1,2,3,1,2013-02-13 20:30:43,2013-02-13 15:57:48
5bf72ed2e7ef82d5ef7a35c978dc72576fdb0efc...66cb5d4420e6a25d0e9a325a2cf3a3a1acc37449,1,8,3,11,2,2013-02-13 16:06:57,2013-02-13 11:01:58
66cb5d4420e6a25d0e9a325a2cf3a3a1acc37449...58978e822c5a6bacba19641626e1907139f5d99b,1,40,0,40,1,2013-02-13 21:54:58,2013-02-13 20:58:18
58978e822c5a6bacba19641626e1907139f5d99b...dc7e7bced41b3a362a94cb1670ff183459d8d3a8,1,37,1,38,2,2013-02-13 21:56:01,2013-02-13 20:58:19
2532d891a4aab003a5ce19f04509fd8549754485...4b796951ffca7c0aa9e05d62d6d16a3c689b7f25,1,6,11,17,1,2013-07-15 17:49:42,2013-07-11 11:25:52
6f3c0ef93742b250d513b5562c08f0350dbda72e...9d1c2255dc091e0df28bff57b0ea02b310b3787b,2,5148,0,5148,2,2012-05-30 11:30:24,2012-05-29 21:03:51
9d1c2255dc091e0df28bff57b0ea02b310b3787b...774cfe0c524531ad4bbdd78590d2ccf1fabc05c0,2,5176,0,5176,2,2012-05-31 04:31:05,2012-05-06 02:42:49
774cfe0c524531ad4bbdd78590d2ccf1fabc05c0...db484bad1010d0dddf56e6b941755d6bd977f75b,1,2011,1823,3834,1600,2012-05-31 04:31:05,2012-05-31 02:16:38
db484bad1010d0dddf56e6b941755d6bd977f75b...8ada95983c532d902907a14892f77967e514120b,1,1923,399,2322,323,2012-05-31 08:34:51,2012-05-21 01:35:47
8ada95983c532d902907a14892f77967e514120b...81809b9984e782f1c48e1b3c823484d54d28dbb2,1,447,473,920,481,2012-06-01 09:42:18,2012-05-30 04:19:47
81809b9984e782f1c48e1b3c823484d54d28dbb2...5ae481e0ad61f3cdf0b0f6bc3f57bae23574db16,1,42,10,52,35,2012-06-01 09:43:38,2012-05-31 09:35:59
adc7052bb6e737cec0c6702f8dde259540eab672...aa3bb87176d42f1782c5030fa41e6e62492551c0,1,1,1,2,1,2012-05-21 01:48:10,2012-05-18 16:46:01
c9018b0305a56436c85b292edbeacff04b0ebb5d...cf2ba13ac6a7589fde5b7e888fedb2e7299e423a,2,79,6,85,10,2012-05-29 17:50:56,2012-05-26 10:28:01
4acf8e85dc088c42843221348e9c039d9bd23ecc...befc5ed3799cb6fcbaa7de03e7fa1760e846853c,2,24,18,42,3,2012-05-25 19:19:45,2012-05-25 19:19:45
c5e5f6030573b5433284b4e6b4342ab7204f20e1...964ad928d65b8bdf15bee4a662629824a0b3a0e7,1,64,3,67,4,2010-03-02 20:14:20,2010-03-02 00:04:57
964ad928d65b8bdf15bee4a662629824a0b3a0e7...9be3614eff36271d5f1cd460a568a219902cb044,2,21,6,27,4,2010-03-02 20:14:44,2010-03-01 21:51:34
3c8f6c8c4f00414e66076c2c97c834d01f828491...1123c67ceee2f310b08ab5d67b076ef04ab59bfc,2,43,0,43,2,2010-02-07 23:53:54,2010-02-07 04:44:15
2d0d706e5fd08b751a19562974ae0b76d9db03a1...8b187e6b0e114055071a9ae8f56b9a2a24bfaf8f,1,1,1,2,1,2010-01-22 06:02:28,2010-01-22 05:55:15
8b187e6b0e114055071a9ae8f56b9a2a24bfaf8f...55b6745d633b9501576eb02183da0b0fb1cee964,4,4,4,8,6,2010-01-22 06:04:42,2010-01-22 04:21:55
55b6745d633b9501576eb02183da0b0fb1cee964...dedc0ec5d778214528dae3bddf60d77cfcde4bd4,4,4,4,8,6,2010-01-22 06:06:12,2010-01-22 04:31:25
dedc0ec5d778214528dae3bddf60d77cfcde4bd4...07c073206798483c9916d492dfc6faf7400a50ad,1,0,2,2,1,2010-01-22 18:01:06,2010-01-22 11:47:59
07c073206798483c9916d492dfc6faf7400a50ad...0ecace728f8e48b87f81433b053d7f277f22e674,4,5,6,11,7,2010-01-22 18:01:21,2010-01-22 15:29:21
0ecace728f8e48b87f81433b053d7f277f22e674...112dd5146589ecb76d52bf349bd51dbe2936e936,4,4,6,10,6,2010-01-22 18:01:33,2010-01-22 15:34:44
112dd5146589ecb76d52bf349bd51dbe2936e936...b53258182bf90b4fb922a20d164a02e6f0e9afd1,4,4,5,9,7,2010-01-22 18:02:16,2010-01-22 15:38:03
b53258182bf90b4fb922a20d164a02e6f0e9afd1...377d0276ca7446ce9fb2f6987b1e6b4ba9e7cf29,4,5,7,12,8,2010-01-22 18:07:14,2010-01-22 15:42:14
377d0276ca7446ce9fb2f6987b1e6b4ba9e7cf29...3bb7256281bb1d291bb705a57dc3f30b26b7c127,7,16,15,31,15,2010-01-22 18:10:27,2010-01-22 15:55:19
3bb7256281bb1d291bb705a57dc3f30b26b7c127...8cddaeec0d40e68202a6afae5d09024ac1b5db9c,1,1,1,2,1,2010-01-22 21:18:14,2010-01-22 09:22:29
8cddaeec0d40e68202a6afae5d09024ac1b5db9c...30c9e919b6ef33b0427a3ad784ed9e951ea48648,1,1,1,2,1,2010-01-22 21:18:38,2010-01-22 09:22:30
30c9e919b6ef33b0427a3ad784ed9e951ea48648...af82559b435aa2a18f38a4f47a93729c8dc543d3,2,19,4,23,2,2010-01-22 22:31:30,2010-01-22 22:17:06
af82559b435aa2a18f38a4f47a93729c8dc543d3...74cf9bdda693e4c7b9443dea6a30d52f55f16517,1,5,3,8,2,2010-01-22 23:55:49,2010-01-22 20:00:47
74cf9bdda693e4c7b9443dea6a30d52f55f16517...4cacc621f80bbd878a320a664dff1440a9358785,1,2,1,3,1,2010-01-22 23:57:45,2010-01-22 16:36:36
a99c5e5921fcb4fd003fd3424be4db649393731f...8a93f9576a705753845ffa9fc5eb62c1d7fdd4a1,1,2,0,2,1,2012-03-20 20:30:30,2012-03-16 14:48:33
c5212b87dafb3f559ceb898bd9b40bfc3cd0ad68...07de4eba60cdf1b24f297ce2b2816d3403323352,2,23,2,25,9,2010-07-20 23:52:53,2010-07-20 19:35:56
07de4eba60cdf1b24f297ce2b2816d3403323352...2c76c3fecee688f88440db4167813cc25efd0388,1,16,0,16,1,2010-07-20 23:53:28,2010-07-20 19:36:21
c5212b87dafb3f559ceb898bd9b40bfc3cd0ad68...ce14e0b264b31dd02a0c9d1688bceb6579d052fa,11,26,26,52,25,2010-07-20 23:47:17,2010-07-20 23:18:34
1b79d1c2a8a90419238f7213870ab1dc465082fe...109988f2cb00f78b746d05c40b8a8960bbb12ff8,1,1,2,3,1,2010-07-15 18:59:37,2010-07-15 07:29:01
109988f2cb00f78b746d05c40b8a8960bbb12ff8...47dc5d5fda291bc399da54648ca27e8df4ddfd2c,1,3,0,3,1,2010-07-15 18:59:57,2010-07-15 07:41:55
47dc5d5fda291bc399da54648ca27e8df4ddfd2c...0ad0a61f05fe521a63ade9bfafd2f589fba0df33,1,9,0,9,1,2010-07-15 19:00:50,2010-07-15 07:51:19
1b79d1c2a8a90419238f7213870ab1dc465082fe...3ca399d40ae024a1eaf5c8f71c9cf13da3198cf3,2,3,3,6,3,2010-07-14 20:04:25,2010-07-14 17:18:11
1b79d1c2a8a90419238f7213870ab1dc465082fe...f32e9852d40e26da0c042ca35bf07fa456c9832b,1,257,0,257,1,2010-07-14 19:55:15,2010-07-14 17:04:06
f32e9852d40e26da0c042ca35bf07fa456c9832b...21baa6e0c56d229866c02c4b42b8b53af648d853,2,5,4,9,5,2010-07-14 19:56:49,2010-07-14 17:04:07
609eb9f7ff2af45d52ea90c0678a442d46aaa163...47e67d479b305bbec996b2422e2776fb7c39be27,1,3,10,13,2,2010-07-12 14:52:52,2010-07-12 10:32:18
47e67d479b305bbec996b2422e2776fb7c39be27...637ab29b86533c7ce65a615fd445d163a2c57dc9,1,2,2,4,2,2010-07-12 14:53:08,2010-07-12 10:33:49
806e5c8682c8621b19529c21899dcb14a1035d11...35eabd1579726d594e84fc8328a5c87693dd065a,4,32,3,35,5,2010-01-20 20:44:59,2010-01-20 20:44:59
80eac928ae11d4e417feddcc6a1ec373cf41e14f...6ceeaee7ea5bb754c76ce93c5b289f72d69fdb92,1,1,0,1,1,2010-03-13 05:55:38,2010-03-12 17:04:25
6ceeaee7ea5bb754c76ce93c5b289f72d69fdb92...894a9d333e9e2015cad00d95250b7c5d3acea8b6,14,437,30,467,40,2010-03-13 05:55:39,2010-03-12 17:04:26
894a9d333e9e2015cad00d95250b7c5d3acea8b6...c0fc6869112e07cda2faff73670480df0d82d530,1,34,0,34,1,2010-03-13 05:55:39,2010-03-12 17:04:27
c0fc6869112e07cda2faff73670480df0d82d530...6f6bee3ba9260137f27bdcad2f8d0fac026f2b6d,3,92,1,93,6,2010-03-13 05:55:39,2010-03-12 17:04:28
6f6bee3ba9260137f27bdcad2f8d0fac026f2b6d...96e19488f1e8f3964f5f329248852864b4ee4541,3,45,0,45,7,2010-03-13 05:55:39,2010-03-12 17:04:29
96e19488f1e8f3964f5f329248852864b4ee4541...b079feed64238558fa24ba8ade892d84628a05ac,2,146,1,147,12,2010-03-13 05:55:39,2010-03-12 17:04:30
b079feed64238558fa24ba8ade892d84628a05ac...160baa0d9cbdfcdb6251aa5ede77c59c0d53edfd,5,127,2,129,10,2010-03-13 05:55:39,2010-03-12 17:04:31
160baa0d9cbdfcdb6251aa5ede77c59c0d53edfd...6956f858f6237d426fa422949033e3c558104802,8,385,8,393,18,2010-03-13 05:55:39,2010-03-12 17:04:32
6956f858f6237d426fa422949033e3c558104802...eb2151bb8938a8e2af86e3ed34243af7b1c95786,5,50,1,51,6,2010-03-13 05:55:40,2010-03-12 17:04:33
eb2151bb8938a8e2af86e3ed34243af7b1c95786...6360d343af9acf7366be6ff89740f5077e12277b,2,18,0,18,2,2010-03-13 05:55:40,2010-03-12 17:04:34
6360d343af9acf7366be6ff89740f5077e12277b...dcf783a26110ab99f2052e378ee76c3542a4b9e9,2,21,0,21,4,2010-03-13 05:55:40,2010-03-12 17:04:35
dcf783a26110ab99f2052e378ee76c3542a4b9e9...7f710ea98262c7d81006c16c727796d9e6aeaa81,3,6,0,6,5,2010-03-13 05:55:40,2010-03-12 17:04:36
7f710ea98262c7d81006c16c727796d9e6aeaa81...66d681998411e8e5034080d5267a5e0f6cdc0c17,1,14,0,14,1,2010-03-13 05:55:40,2010-03-12 17:04:37
6c0efa2ac07f275c1edd11ae6646a647d7f19f36...ade2ca0ca9f8335be300d5538e1ca9cb3594ae64,1,1,1,2,1,2009-10-28 06:45:41,2009-10-27 11:23:33
aab748636dbbd6412af6f4996c2791eba4246c0c...7c3baa9abf0abe15f068d95688bbc27e73a69042,1,3,3,6,2,2009-10-28 17:42:17,2009-09-04 10:22:36
3ed0b11e7e9a8a35956d2c8c39c51c8d8f5eac23...66bcb6a68f8759ab7a7b5ca47085ab1c1402062e,1,0,35,35,1,2009-10-21 18:27:48,2009-10-21 11:35:15
66bcb6a68f8759ab7a7b5ca47085ab1c1402062e...814a9bfee93d6b7beefa4a6079d1acf4d4166724,1,4,0,4,1,2009-10-21 18:27:50,2009-10-21 11:35:16
814a9bfee93d6b7beefa4a6079d1acf4d4166724...975457f185acd7c1f96ccff67cd5dc8dcb7908a0,1,10,0,10,1,2009-10-21 21:07:44,2009-10-21 21:06:21
3c1ca015281e90541a7baf092448556ec6c588a0...93cf50a412e3ed988cbce07e2ba3a80841d3884b,1,11,1,12,2,2009-10-28 07:36:43,2009-10-17 09:33:38
93cf50a412e3ed988cbce07e2ba3a80841d3884b...f7ad96cfaaec3b32458ca69d44c50d1397d11d38,1,8,2,10,3,2009-10-28 17:59:40,2009-10-28 09:45:38
f7ad96cfaaec3b32458ca69d44c50d1397d11d38...c1e01b0c5106451770ae77a62f52acfe814c3326,2,83,1,84,3,2009-10-28 18:03:01,2009-10-28 17:13:44
3c1ca015281e90541a7baf092448556ec6c588a0...c591d5f311e0c2c0708b91bf5e05bd1c36da658a,1,177,177,354,4,2009-10-28 06:03:58,2009-10-27 01:10:24
f5bf1b5f6b43f5ed9263f4cecd0faf58c5a7322f...2f312e8851035a85f431911075383265f1519c04,3,36,2,38,5,2011-05-04 22:47:40,2011-05-04 22:47:40
e49ca974d6ff2dda1ff4ee39e7cc33af33d1eb2a...c8cba79181abc139d7cba364bf868875426fc2c1,2,23,3,26,8,2009-12-22 19:51:17,2009-12-22 18:51:41
a1bb8f45f1590f812badceea0b7c120074ec3e85...94058a90cf3e10122037cd80ea48d3d52be5efd9,2,1,7,8,2,2009-12-16 20:50:33,2009-12-16 20:50:33
94058a90cf3e10122037cd80ea48d3d52be5efd9...a5b80d92632a2d76325d4b6e6161022171a9fee4,2,58,11,69,6,2009-12-19 22:07:24,2009-12-19 21:49:00
a5b80d92632a2d76325d4b6e6161022171a9fee4...8eca03c86134c3f73eb8f16899165a3bd2014376,1,1,1,2,1,2009-12-20 07:06:20,2009-12-20 07:05:57
153559a964f436aeb909e3b7e86ceaa998aeed68...92f9e273e86d505e4c2a28bc053eb514ca2cc552,2,9,1,10,2,2010-02-09 05:52:44,2010-02-09 03:48:13
529f8c6ea6c13d85178d4ed10ed60ed8fd6f6c19...80d93611c55fec171e0d9aba98db079952f9d7aa,2,10,4,14,4,2009-12-10 00:21:36,2009-12-10 00:21:36
aa031314bf8189a15290d5bd0d85fa2a0307ceb7...968d70723ae1e352bde2f7171d18484186838d9f,1,20,13,33,3,2009-12-07 08:27:57,2009-12-07 08:20:09
968d70723ae1e352bde2f7171d18484186838d9f...441947f6d7533e7567f8ad02fafbf36c22a5ddf9,2,15,15,30,13,2009-12-07 21:02:35,2009-12-07 18:26:57
441947f6d7533e7567f8ad02fafbf36c22a5ddf9...47b7012024fcd5a24d2c294542f1de951dbde6e8,1,53,1,54,2,2010-01-07 23:37:33,2009-12-07 18:35:42
d58f927c481646fc6c75b3bfc6368cb0096d074d...9858b87fbb990659ea98f1bc77c2e0283cdcaa4a,1,1,1,2,1,2009-11-14 23:34:37,2009-11-11 04:49:07
4f366275189c06ec26c01ee5ace2f3831b2aa46a...ec7fc0b1a46c5a352532ea3f29c5663752fd8ac6,2,20,2,22,3,2009-11-27 03:02:24,2009-11-25 10:56:54
d629c40b0b8b63b0c8b33d52dcba0ed202d898d7...9deec58ad842fe9f2a2a221952e1eb351d3637e9,1,1,1,2,1,2009-11-11 04:45:23,2009-11-11 04:45:23
d629c40b0b8b63b0c8b33d52dcba0ed202d898d7...f01d74960363736caaf4d98d39555e99bdc72c25,1,2,1,3,3,2009-11-10 19:02:27,2009-11-09 15:05:00
bb471bf74fdff4e6e93e39677e9dab36e716b6f1...466d1f151a8a0bfde63f0fa5aba91bb8e0efe946,1,5,1,6,2,2009-11-10 18:38:13,2009-11-10 18:11:51
bb471bf74fdff4e6e93e39677e9dab36e716b6f1...fe9a215214acd2cf9132aec70e0758786a6e3e8b,4,0,3,3,3,2009-11-10 01:08:44,2009-11-09 15:04:41
fe9a215214acd2cf9132aec70e0758786a6e3e8b...9c855c31786b9e879ef4cd3b8b5aa97bc4bcf8ec,1,7,0,7,1,2009-11-10 01:08:44,2009-11-09 15:04:42
9c855c31786b9e879ef4cd3b8b5aa97bc4bcf8ec...fef34270f209eb5d2cde01b8175b24d96d1cff21,1,3,0,3,1,2009-11-10 01:08:44,2009-11-09 15:04:43
fef34270f209eb5d2cde01b8175b24d96d1cff21...6e9daeffec0213fa1cee76ad9d899fe492409f46,1,1,1,2,1,2009-11-10 01:08:44,2009-11-09 15:04:44
6e9daeffec0213fa1cee76ad9d899fe492409f46...20c7e3d5cfcc0834fd5d38200e94d15a103ab271,1,6,0,6,2,2009-11-10 01:08:45,2009-11-09 15:04:45
20c7e3d5cfcc0834fd5d38200e94d15a103ab271...e62b393505616c3ce313f6dac5060d9e1cde8e42,2,9,4,13,5,2009-11-10 01:08:53,2009-11-09 15:04:46
e62b393505616c3ce313f6dac5060d9e1cde8e42...aeda85a81547b05c36939defb420e5f02bf05e51,1,3,0,3,1,2009-11-10 19:06:56,2009-11-09 15:04:48
aeda85a81547b05c36939defb420e5f02bf05e51...71a04a8b52b8a89addd31da5b2272d572fdc7e40,1,3,0,3,1,2009-11-10 19:06:56,2009-11-09 15:04:49
71a04a8b52b8a89addd31da5b2272d572fdc7e40...e9dd085d93fb6695f1d28572b48374ef818cf9c3,1,6,0,6,2,2009-11-10 19:06:57,2009-11-09 15:04:50
e9dd085d93fb6695f1d28572b48374ef818cf9c3...9a2861e32a147d89f22961bd7d3257b8776de4d2,1,5,0,5,2,2009-11-10 19:06:57,2009-11-09 15:04:51
9a2861e32a147d89f22961bd7d3257b8776de4d2...aa481d38b059a093829bbe0745e29244a896c499,1,2,0,2,1,2009-11-10 19:06:57,2009-11-09 15:04:52
aa481d38b059a093829bbe0745e29244a896c499...ae5bdda36cddeb837dc43804966bc99baa385772,1,12,0,12,1,2009-11-10 19:06:57,2009-11-09 15:04:53
ae5bdda36cddeb837dc43804966bc99baa385772...7006b5beceb296e7e853806622204b2b55649fc5,1,10,0,10,2,2009-11-10 19:06:57,2009-11-09 15:04:54
7006b5beceb296e7e853806622204b2b55649fc5...03c5c10263fb0d80151d108a4c61253e1d0a8de6,1,5,0,5,2,2009-11-10 19:06:57,2009-11-09 15:04:55
03c5c10263fb0d80151d108a4c61253e1d0a8de6...1507301204180a17f915b929fc8377e69aef979d,1,1,1,2,1,2009-11-10 19:06:57,2009-11-09 15:04:56
1507301204180a17f915b929fc8377e69aef979d...4751f11224600ab25adb0a200fec55a734bc2936,1,3,1,4,2,2009-11-10 19:06:57,2009-11-09 15:04:57
bb471bf74fdff4e6e93e39677e9dab36e716b6f1...69a9cd31b18008cbacfb35406a1bfa17fc1f352a,3,1364,0,1364,3,2009-11-09 02:29:08,2009-11-08 15:09:47
9504f3d3d2e62cb6fba9e7c61c6fe69dec9053a4...66b2ed09c2f0f212c5cd5c095c1f1052ecbb9491,8,82,1,83,10,2010-01-21 03:57:02,2010-01-20 21:59:36
66b2ed09c2f0f212c5cd5c095c1f1052ecbb9491...7dccadf363f9d9ff564ad34117266b2d557a2bc8,3,7,4,11,4,2010-01-21 22:57:41,2010-01-21 22:57:41
02f55e660ccbd2fa1e3b2c686200f0037568f854...cc3046271d6b832f0fd6d3f704c5f9f653d2b682,1,2,1,3,1,2013-01-19 11:24:12,2013-01-17 22:07:31
02f55e660ccbd2fa1e3b2c686200f0037568f854...cbbe50db7691cd9d7d261ebc5c5ffec55f93127d,1,14,17,31,5,2013-01-18 23:48:49,2013-01-18 23:48:49
cbbe50db7691cd9d7d261ebc5c5ffec55f93127d...3f1da57fffdcfb48bd8b85da347f310b955245d7,1,11,17,28,6,2013-01-29 05:05:51,2013-01-29 04:45:43
3f1da57fffdcfb48bd8b85da347f310b955245d7...daebaa78137d59693a808c1f0bdec0ecb40fc12e,7,146,1,147,18,2013-02-07 21:48:47,2013-01-19 00:08:30
35484d4acd69ac9e482c1c0ee4c5014744dfc63f...045e3884bc432aff651659dc60059d1e8c2f86ea,1,6,5,11,5,2013-01-30 17:01:49,2013-01-28 01:18:16
045e3884bc432aff651659dc60059d1e8c2f86ea...de90ff81f3bba50776b934842112eeb6e69a0d23,1,9,7,16,1,2013-02-01 00:37:16,2013-01-31 06:45:46
de90ff81f3bba50776b934842112eeb6e69a0d23...d040350813986e0f4bb3aeb977077975c1552606,3,41,3,44,7,2013-02-01 00:37:24,2013-01-31 06:46:11
be5c9fb9049ed470e7005f159bb923a5f4de1309...04deccda112881f87bb514445aa2e539f77f6095,2,78,7,85,10,2013-02-11 21:11:45,2013-02-11 20:59:58
90d0b8a9f015c21b8f4a00a88838cd7bda5750e9...77d07f51dfe1aaf2212e4fd13cca2a44beb3e996,1,12,0,12,2,2013-01-14 16:21:35,2013-01-14 16:21:35
1017c1abcb6d733e1de83eb5a1cf7e1bf4ad6aca...ea115a0d43d176f873855f9a7372376161dd8e65,2,6,7,13,4,2012-03-05 05:19:41,2012-03-04 21:14:30
ea115a0d43d176f873855f9a7372376161dd8e65...d75219b4a8a9c44520ddca234cde992498383b89,2,38,0,38,3,2012-03-05 05:20:27,2012-03-04 21:15:08
d75219b4a8a9c44520ddca234cde992498383b89...69c3051780d6cacfe242563296160634dc667a90,2,23,24,47,5,2012-03-05 05:22:35,2012-03-04 21:15:36
69c3051780d6cacfe242563296160634dc667a90...4dce7d9b408b2935b85721b54a2010eda7ec1be9,1,3,0,3,1,2012-03-05 05:22:46,2012-03-04 21:16:19
997a1946a55cafb992c4ba8e5e0795aa73f5a4a9...0de1633783685e9fb1943551217cdda7edbd245b,7,20,20,40,20,2011-10-27 18:08:26,2011-10-24 06:36:09
0de1633783685e9fb1943551217cdda7edbd245b...5fb8c05f2e5da483898019f7abc0e52e07bc0c50,1,7,3,10,2,2011-10-27 18:24:01,2011-10-27 18:18:40
5fb8c05f2e5da483898019f7abc0e52e07bc0c50...02cb67530e62e77d437cd68b4bb4307ab752b6a0,1,25,25,50,4,2011-10-27 18:27:57,2011-10-24 06:36:11
02cb67530e62e77d437cd68b4bb4307ab752b6a0...d688cf07b15b664a2164c3d92bcb5e8265400a2b,6,56,44,100,31,2011-10-27 18:38:24,2011-10-24 06:36:10
d190a0875ff0f33d60a4d7265f2098b35d162f68...a946ef55f779cfbc9a33f79012ff4d4ed680b5c3,1,1,1,2,1,2011-09-11 21:43:14,2011-09-11 19:25:48
a946ef55f779cfbc9a33f79012ff4d4ed680b5c3...3254310863d6964f5b750a373b9e5598ce529381,1,7,8,15,8,2011-09-11 21:43:33,2011-09-11 19:26:53
bc7a96a8965d4ce0651689301e1702a942dfb9f0...53b742522c3ae56726e679b50feede849ec46362,1,1,2,3,1,2011-10-09 19:57:04,2011-10-09 09:17:07
bc7a96a8965d4ce0651689301e1702a942dfb9f0...f61bd9c68a4ed81afcc1fbbf5b956e781d88b434,1,24,1,25,3,2011-08-19 17:52:16,2011-08-19 09:14:45
09ffc706e48f93ed622a9a61704b2f767666b30d...f5799e05c0e7fbee32ca32995c7c4a627eeff469,1,1,1,2,1,2011-05-26 22:04:05,2011-05-26 20:52:04
09ffc706e48f93ed622a9a61704b2f767666b30d...7a45c313964e293f45384ca0a2ae1d326c83a061,1,2,2,4,2,2011-05-26 21:50:24,2011-05-26 20:46:56
09ffc706e48f93ed622a9a61704b2f767666b30d...56d7c27af1f8aa7519f165f6c022732e64db3716,1,4,2,6,1,2011-05-26 20:54:18,2011-05-26 16:30:27
2b0b64ee850e72b9a88c821c418b1620fccf2092...6051561a6cc8d715ce6243c26712448f6e32fe4e,1,1,2,3,2,2011-06-01 20:54:17,2011-04-29 09:42:41
5df3e2b3ca5ebe8123927a81d682993ad597a584...b3cfc4066d87476726e8711a8b5fc3b721aba41c,1,4,4,8,4,2011-07-06 18:12:01,2011-07-05 17:54:21
b3cfc4066d87476726e8711a8b5fc3b721aba41c...a1bea2c1fc5e5243e873919248940dd5fff593a4,6,89,2,91,12,2011-07-06 18:19:24,2011-07-05 17:54:44
a1bea2c1fc5e5243e873919248940dd5fff593a4...6b01ecfe22f0b6ccb9665cd8d85d78a381fecffc,2,47,13,60,16,2011-07-11 16:35:38,2011-07-08 23:13:32
6b01ecfe22f0b6ccb9665cd8d85d78a381fecffc...d49483f0ca1be0994c4f20fe1804d36a28013676,7,101,5,106,9,2011-07-11 16:35:46,2011-07-08 23:14:10
5df3e2b3ca5ebe8123927a81d682993ad597a584...2c9078d05bf2200c9671e0b292638d42e7e4fd71,2,4,3,7,3,2011-05-25 21:32:02,2011-05-25 20:07:51
2c9078d05bf2200c9671e0b292638d42e7e4fd71...ea5070c91f23e41a88dec48d2f8d96444c2d647a,12,198,140,338,150,2011-05-25 22:04:25,2011-05-25 20:10:41
5df3e2b3ca5ebe8123927a81d682993ad597a584...55601c6a4598f3b37e8269beff3275d6592053dd,1,31,0,31,1,2011-05-24 22:57:03,2011-05-24 19:45:27
55601c6a4598f3b37e8269beff3275d6592053dd...600a6a68c0c744fdb801f863291e4d60696dfeb7,1,2,2,4,2,2011-05-25 16:35:59,2011-05-25 09:55:43
600a6a68c0c744fdb801f863291e4d60696dfeb7...f612a71cc901e34f5cf154e6605b7251744f6b95,1,20,8,28,2,2011-05-25 19:36:43,2011-05-25 16:35:26
c3f6163b0b6e2cfae1422050c9607db1130cded0...ff7f089ed1064b6a10e958bf405f828226262424,2,371,9,380,29,2011-04-13 19:21:45,2011-04-13 10:00:48
c3f6163b0b6e2cfae1422050c9607db1130cded0...12a296bca3d07875d4c3db0e8e24fbaa86ca97b3,2,26,3,29,7,2011-04-09 22:43:35,2011-04-08 14:57:54
12a296bca3d07875d4c3db0e8e24fbaa86ca97b3...f5549afd5d6c5492176b6fa21769c59bfe8e1d70,1,5,0,5,3,2011-04-09 22:43:35,2011-04-04 19:09:08
c3f6163b0b6e2cfae1422050c9607db1130cded0...4e8115fff135a09f75020083f51722e7e35eb6e9,1,6,3,9,1,2011-04-07 22:57:57,2011-04-07 22:57:57
e3f67d30b20e49d8fc3eefe819808cba7998b060...105e47339794ec2c862338d7a25df77b7d72385e,2,43,4,47,2,2010-01-26 21:49:50,2010-01-26 21:48:28
e3f67d30b20e49d8fc3eefe819808cba7998b060...24072c0256a520408575416fe8706667b576ff99,1,8,1,9,2,2010-01-26 18:44:10,2010-01-26 17:48:36
24072c0256a520408575416fe8706667b576ff99...9524cf29930b4f91d68ad1384d7f984393a54c15,12,52,52,104,38,2010-01-26 23:16:54,2010-01-26 23:08:31
9524cf29930b4f91d68ad1384d7f984393a54c15...3fa7c3da379bb47a0e7a52ffc13cb366add880a2,1,3,3,6,3,2010-01-27 03:16:02,2010-01-27 00:29:30
5b594f457afcf2cdddb3c79de8bcc571c775aa55...8cb5775b2b9885708c3f646a1e273de1ac778a88,1,4,0,4,2,2011-08-30 18:14:24,2011-08-30 13:45:38
14e1a4e1ff70aff36db3f5d2a8b806efd0134d50...5b59708268c82262fb13fb8681663dd158b030bd,2,26,3,29,2,2012-12-11 18:01:44,2012-12-11 05:59:21
5b59708268c82262fb13fb8681663dd158b030bd...e0db1765c3bb108b55ebf82b4e5962f9d1f5e5b7,2,8,9,17,9,2012-12-11 18:05:17,2012-12-11 05:59:22
14e1a4e1ff70aff36db3f5d2a8b806efd0134d50...7a76e68a177720da65e7d9cfa49d702a55e2d9de,2,35,27,62,6,2012-10-18 21:23:12,2012-10-18 14:43:29
7a76e68a177720da65e7d9cfa49d702a55e2d9de...94f6cdf693c10eaec5a7fcc4f0b5cb1e0ea80f1b,2,51,33,84,9,2012-10-18 21:23:19,2012-10-18 14:43:30
94f6cdf693c10eaec5a7fcc4f0b5cb1e0ea80f1b...f9b7204b6d10a1429271fde8cbcdee56beb0e035,1,13,12,25,4,2012-10-18 21:23:29,2012-10-18 14:43:31
f9b7204b6d10a1429271fde8cbcdee56beb0e035...0fcec2ce5467740eb613da6a977deca3e7e866ba,3,72,12,84,14,2012-10-18 21:23:34,2012-10-18 14:43:32
0fcec2ce5467740eb613da6a977deca3e7e866ba...41dd00bad3d7614be7e8a41ed3f31878af86758b,2,33,18,51,17,2012-10-18 21:24:16,2012-10-18 14:43:33
41dd00bad3d7614be7e8a41ed3f31878af86758b...25dc8dad3a7c9f5426f549701e22eec1f894fec8,1,66,32,98,23,2012-10-18 21:24:42,2012-10-18 14:43:34
84adb641545f4b58f9276adf099f840ea2928e44...a83b2b578c04a2abe33a586ec9c64e75ef5bc819,1,3,1,4,2,2012-12-10 16:23:53,2012-12-10 14:42:27
e5dce96e9e26f8e30291c79fa5647313c64b2150...aebbcf57972961c221c75dee039a17be8cfae1ad,1,2,0,2,1,2012-09-21 20:49:18,2012-09-21 20:49:18
aebbcf57972961c221c75dee039a17be8cfae1ad...3d1aa56671e7f33740dcd2cf0642d5ce09bd6a95,1,5,1,6,4,2012-09-21 20:52:25,2012-09-21 20:52:25
65119878548f869270fbc8d382f042cca3a6ad05...1959bf6430fda685c46241f220f521a01f9469b7,1,4,3,7,2,2012-09-18 18:41:06,2012-09-17 15:21:07
7bdb74868cf51245bce6ab033a1588e312e87310...edfbbf7eead3001f8c4273220d043890421d7b73,5,10,10,20,8,2012-07-15 05:32:28,2012-07-14 22:20:36
25f745fbec0e92a29e33aa85413c2bf7762608bf...8debf696380cad2283b4cfaea78962b8d5923149,1,2,2,4,2,2011-10-27 19:02:02,2011-10-27 16:46:53
87afe9a5ed759668e35513c44eacd2fd393ba658...8496f568739626c86cb9d82e57fc0b55cb4c0849,1,50,10,60,8,2011-12-19 04:40:41,2011-12-16 23:44:18
2a6291e97a219e660ae7c75f44a55f8c2a331c40...157a2824017a01f58a873e6e571ddc95668aae34,2,56,1,57,2,2012-06-21 21:51:39,2012-06-21 21:51:39
34c4461ae3b353e8c931565d5527b98ed12e3735...72251b7de6daf2cd7916e3aad46df0047e5a5d2b,1,51,0,51,1,2011-10-13 17:16:59,2011-10-13 12:59:04
72251b7de6daf2cd7916e3aad46df0047e5a5d2b...80988783c8c417c5e914256b43ed3604cc8fa4c3,4,11,5,16,5,2011-10-13 17:18:16,2011-10-13 12:59:05
50963badbcfe2693d7a51ace3079c6b48ec52f01...9684e44a07495ad6ff0fa57f1d0cb7479b72e453,1,52,19,71,6,2011-09-12 23:40:06,2011-09-08 19:17:09
50963badbcfe2693d7a51ace3079c6b48ec52f01...d4e58965ff3ab069526d551fe4873ab4963e3500,1,6,7,13,4,2011-09-07 18:18:18,2011-09-07 18:18:18
d4e58965ff3ab069526d551fe4873ab4963e3500...3793ac56b4c4f9bf0bddc306a0cec21118683728,1,26,26,52,24,2011-09-07 23:29:18,2011-09-07 11:54:11
5f35dfef25e03ba394fc54d1ef75a4fde1c9ee12...99621af877fcc33d2f374cde1e55bacbaefeef17,1,30,0,30,5,2013-01-10 22:36:23,2013-01-10 22:36:23
51bbccfd1b4a9e2807413022c56ab05c835164fb...618374930ab0de78c3994a633ca5f26e286810cf,1,4,2,6,2,2012-09-06 23:18:12,2012-09-06 18:31:11
147d071816c7011d24c195a9d6fca251ad312532...d1ba7a4cb77b64993a56b06c1497d1ab78094cc4,2,28,1,29,2,2012-02-16 22:26:32,2012-02-16 22:26:32
aa47ec99d1ef979bbf5eca93c0152dd0e636b605...624d3519c9adda89de57e54de5e502474d871974,1,40,1,41,4,2012-02-13 06:58:36,2012-02-13 06:58:36
e174744ad17a55d4df68cec97bfbf6b0c28e762b...698a1ec4d52e90d611c233a12147daf261168bc6,1,11,0,11,1,2013-02-21 06:01:50,2013-02-21 00:02:42
110c511dbeff65f7ae92216cf1d976a9093d911f...d909e0761c234b28aac77566368c1ee5451a856a,1,3,0,3,1,2012-03-06 19:53:29,2012-03-06 13:15:02
f2120eb4db3e3e3f9a336eb04fdc2319d7421536...2ff14e31bd8c91356d54b7bac064e7cc615e56b3,1,1,1,2,1,2012-02-06 08:00:54,2012-01-30 19:29:33
2ff14e31bd8c91356d54b7bac064e7cc615e56b3...2d1abfa8eeeb168bdd5d05302c1a57f30973711e,2,20,1,21,2,2012-02-06 08:03:18,2012-02-06 08:03:18
8f83acf77cd14567dfdeff0e15f2da086109df70...5c8eeb83dbba11d7e41758b7a8dcb2da6a2025ba,2,10,0,10,2,2012-01-18 23:44:02,2012-01-15 10:03:27
5c8eeb83dbba11d7e41758b7a8dcb2da6a2025ba...00653435488f5ed86c5d6dc411fa14fa56f5e3bc,2,5,1,6,2,2012-01-18 23:46:31,2012-01-18 23:46:31
5a6a9394814273e88124a5576c0be6d37a1262cc...ab8a78084b7159d99dae2905e1a3ff04c1500a6d,1,5,0,5,1,2012-01-13 07:33:29,2012-01-13 07:33:29
be4d2920c24ba0be84ceff7e382cce2c5f1ad867...4397c6535ea314b3412d6a0658ecf44241d07df1,1,3,3,6,1,2012-01-12 02:02:55,2012-01-11 09:20:14
4397c6535ea314b3412d6a0658ecf44241d07df1...37495eef4c6071fa124911753cfca3690ea4bf96,1,7,0,7,1,2012-01-12 02:04:08,2012-01-11 09:21:10
0074d18dc0d816f9842d3e0e1cd0b26341715b37...f8246281af9adb0fdddbcc90d2e19cb5cd5217e5,4,50,9,59,10,2012-01-23 22:34:55,2012-01-11 06:44:45
ba3c69a9ee1894de397b60d3b548383e13ef49e3...f0551693ccba62b179e774d128a9934d9f7c06ba,1,5,5,10,1,2013-10-14 19:45:22,2013-10-14 17:04:36
ba3c69a9ee1894de397b60d3b548383e13ef49e3...9aab1b511892b7af86c037b49ff80ec5b4b2c191,2,17,3,20,3,2012-07-17 20:05:13,2012-07-17 20:05:13
ba3c69a9ee1894de397b60d3b548383e13ef49e3...0c37f1fce6cb7997dbb2703d35eef0dfd86c5070,5,88,0,88,7,2011-11-13 06:27:38,2011-10-18 22:53:23
0c37f1fce6cb7997dbb2703d35eef0dfd86c5070...247503f28fe25e400df6542cf72ade7c5b6cfacf,1,71,0,71,1,2011-11-13 06:27:38,2011-10-20 00:15:05
247503f28fe25e400df6542cf72ade7c5b6cfacf...f6667c5ee8148af28cc97049695f60f5105b3061,1,86,0,86,5,2011-11-13 06:27:38,2011-10-22 04:06:02
f6667c5ee8148af28cc97049695f60f5105b3061...0c5e70f041bfda8b3899d13694a9093b41fafa19,3,24,6,30,10,2011-11-29 20:30:02,2011-11-29 20:29:48
24c512803dadf61b2f7f8965735b7c3a03f6147e...1acf11717f01b542e099544796f00df567a66e90,1,2,1,3,1,2011-09-21 11:55:15,2011-09-21 05:17:24
a47a645e7057f28441f0f4b259db11171158553a...212ad944209a928dbf79faa124de77be5c84532e,1,2,2,4,2,2011-08-18 21:01:48,2011-08-18 05:00:47
212ad944209a928dbf79faa124de77be5c84532e...d960c47a881c613a71b1b7c8aab3a06fd91ca70a,1,18,0,18,1,2011-08-18 21:08:54,2011-08-18 05:01:15
d960c47a881c613a71b1b7c8aab3a06fd91ca70a...8d68a6d59378760c6bd5c7e0af75fe71c6ed78e7,1,18,21,39,16,2011-08-18 21:12:46,2011-08-18 05:02:06
8d68a6d59378760c6bd5c7e0af75fe71c6ed78e7...2e6c012e10fd866eb3259de3a929e0296daabbaf,2,12,7,19,4,2011-08-18 21:17:12,2011-08-18 05:02:29
2e6c012e10fd866eb3259de3a929e0296daabbaf...f1c9626105d5e4962a5ccaa4620114d03f32ad02,7,29,34,63,27,2011-08-18 21:35:53,2011-08-18 05:03:12
f1c9626105d5e4962a5ccaa4620114d03f32ad02...e269eb7946d0a4ba6a4e175133b5479446ac04a5,9,27,29,56,16,2011-08-18 21:48:29,2011-08-18 05:03:48
e269eb7946d0a4ba6a4e175133b5479446ac04a5...daa0c3d9717624a62ce669252be832db12658ec0,11,59,19,78,21,2011-08-19 22:51:34,2011-08-18 05:04:23
daa0c3d9717624a62ce669252be832db12658ec0...c659f55b31bb928688afd4ddfd94f8bea978ff1a,1,3,2,5,3,2011-08-19 22:51:37,2011-08-18 05:04:56
c659f55b31bb928688afd4ddfd94f8bea978ff1a...3e1dd17a8958cc5fe47a7ca01c9da8f6fae9cb0b,3,16,3,19,6,2011-08-19 22:51:38,2011-08-18 05:05:08
3e1dd17a8958cc5fe47a7ca01c9da8f6fae9cb0b...c9bfb953489e559d513c1627150aa16f8d42d6c5,9,6,44,50,17,2011-08-19 22:51:38,2011-08-18 05:05:35
a47a645e7057f28441f0f4b259db11171158553a...ec099546a9afdb73b6bf39d5d684e6fb207e2a7f,1,2,0,2,1,2011-08-18 19:25:54,2011-08-18 13:36:03
395f65d438b13fb1fded88a330dc06c3b0951046...cf13f6ca40529a33b66c5e1e7cc69947974b3648,3,38,2,40,3,2011-07-07 00:00:46,2011-07-07 00:00:46
6c4c9bdc981180e94b06ba3a29a59288601361a4...865d370c4daf21e3d6dd48708fc4b716b63d795c,2,3,3,6,3,2011-04-13 21:02:00,2011-04-13 21:01:03
b0fa280751a8a3e7cee093a7fdc3656490abf984...03b05c7db5473329f433c5a3b87965d6fa0f691f,1,8,0,8,2,2012-08-15 18:00:39,2012-08-15 17:06:01
b0fa280751a8a3e7cee093a7fdc3656490abf984...e0a4aae865862549c5f2a65016d4d264843e7914,2,12,7,19,3,2012-03-01 16:22:24,2012-03-01 10:59:45
6ab4ae2b415c375170309c2b7ace0e4daa8d0215...50546b15ed1df25837f8b291e6fa5bbcdb84635e,5,6,6,12,5,2014-03-06 22:03:12,2014-03-03 09:39:59
916034b93ce45bdedfb1c5cef270e6eba2a26fea...d4d5ab4727edd1758157dd0b61c1ff3b7deabfcd,3,21,2,23,3,2011-11-09 00:37:00,2011-11-09 00:37:00
e9e921981d10554a325f4a1e67e920947e0e4800...4551d03541e5eec411bb367f7967ff933d176df4,1,8,8,16,6,2010-02-20 05:56:19,2010-02-20 00:18:44
4551d03541e5eec411bb367f7967ff933d176df4...b39c3612eb443e77bd04d645578e1155988c6dde,1,2,3,5,1,2010-02-20 16:38:21,2010-02-16 08:44:08
e9e921981d10554a325f4a1e67e920947e0e4800...470b452628d80e89ee869b6b86af6c536ba0b24d,2,2,3,5,2,2010-02-20 05:55:33,2010-02-20 05:55:33
cc61ae82ec581f6cf1a38a45aaef894f085ccb16...f94bf44041f621bad3c99e02476540f4a120a90e,1,1,1,2,1,2007-10-04 00:42:52,2007-10-04 00:42:52
f94bf44041f621bad3c99e02476540f4a120a90e...9ff74e95da5605778bdc7567ae63d70c96e6bed4,1,48,16,64,4,2007-10-04 00:54:34,2007-09-28 17:24:19
9ff74e95da5605778bdc7567ae63d70c96e6bed4...58ba4f6ac828606fc206cfd5cec412a6974c91a1,1,1,0,1,1,2007-10-04 08:35:01,2007-10-04 08:35:01
58ba4f6ac828606fc206cfd5cec412a6974c91a1...2f27f8509edfe55f267ce9207dc42c12d4809a84,1,4,4,8,4,2007-10-16 00:26:01,2007-10-04 13:32:53
2f27f8509edfe55f267ce9207dc42c12d4809a84...edb0e04e819c7cde709d10e03f398d12692259f7,1,11,1,12,2,2007-10-16 00:50:05,2007-10-11 00:59:19
edb0e04e819c7cde709d10e03f398d12692259f7...729f50453cb54e136567b89ba6aecab60f0257c6,1,1,7,8,4,2007-10-16 00:50:05,2007-10-11 01:00:27
729f50453cb54e136567b89ba6aecab60f0257c6...a2a9150bf06bdab419016003fa1bc04905d0f4fb,2,9,2,11,4,2007-10-16 01:09:15,2007-10-06 14:24:42
a2a9150bf06bdab419016003fa1bc04905d0f4fb...0c696fe7f490fd3a85e405becf6323993dfb471d,1,26,1,27,5,2007-10-16 01:25:42,2007-10-09 14:33:25
0c696fe7f490fd3a85e405becf6323993dfb471d...fdfeb87c14e36d4c49b4481d01cd8bc103ba95f1,1,9,1,10,1,2007-10-16 01:26:42,2007-10-11 21:49:21
fdfeb87c14e36d4c49b4481d01cd8bc103ba95f1...24ccd8b88ee578d8ea1d2a9a7be9ec4cf225fe73,1,31,22,53,5,2007-10-16 01:27:41,2007-10-05 07:20:49
24ccd8b88ee578d8ea1d2a9a7be9ec4cf225fe73...602015e0e6ec5d3d79b71b0d5e2583fd015417e6,1,23,0,23,1,2007-10-16 01:28:48,2007-10-06 18:57:19
602015e0e6ec5d3d79b71b0d5e2583fd015417e6...7c0d741a3e8db662419cc841e3068b2a8880a109,1,11,3,14,7,2007-10-16 01:30:00,2007-10-06 21:16:51
7c0d741a3e8db662419cc841e3068b2a8880a109...a9834f58335b81f48e137beb33afb5bb799cdae8,1,1,0,1,1,2007-10-16 01:30:31,2007-10-09 14:16:09
a9834f58335b81f48e137beb33afb5bb799cdae8...14b45b66e7f75341040c9797af60fb9318c8b047,1,3,1,4,1,2007-10-16 01:36:19,2007-10-06 17:29:48
14b45b66e7f75341040c9797af60fb9318c8b047...425b78e886e80f3c9f845edebfb199719a8f2d87,2,41,1,42,3,2007-10-16 01:36:19,2007-10-06 17:29:49
425b78e886e80f3c9f845edebfb199719a8f2d87...90d16ec032b20f9f1146f3aceca12165aba3b6d6,1,10,7,17,6,2007-10-16 01:38:09,2007-10-05 08:11:59
90d16ec032b20f9f1146f3aceca12165aba3b6d6...a63103ae4f02f8890d381de352dbfc6cba0b646f,2,23,13,36,9,2007-10-16 02:02:52,2007-10-11 19:32:26
a63103ae4f02f8890d381de352dbfc6cba0b646f...11f2441f05ace25f1dae833a804761f1ca7d5cbb,3,22,3,25,7,2007-10-16 02:02:52,2007-10-11 19:32:27
11f2441f05ace25f1dae833a804761f1ca7d5cbb...2ef8ac1b2a2d310642b8ae4dbec4b8173b4b1213,1,10,10,20,10,2007-10-16 02:11:01,2007-10-09 21:05:30
2ef8ac1b2a2d310642b8ae4dbec4b8173b4b1213...06ada1529ce46e84aaef4e5608c1101c1c7ec73f,10,27,26,53,23,2007-10-16 02:11:02,2007-10-09 21:00:03
06ada1529ce46e84aaef4e5608c1101c1c7ec73f...2c619db8845e6259995ccb4f666e5bbc636c9e14,1,2,2,4,1,2007-10-16 02:11:02,2007-10-09 21:01:05
2c619db8845e6259995ccb4f666e5bbc636c9e14...477ff5b71aca9a3d05c8f83182eeb98d7a8f92ee,1,1,1,2,1,2007-10-16 02:11:02,2007-10-09 21:02:19
477ff5b71aca9a3d05c8f83182eeb98d7a8f92ee...b6cbca38287668095c0025fcf33b126f5efb9071,2,6,6,12,6,2007-10-16 02:11:03,2007-10-09 21:03:11
b6cbca38287668095c0025fcf33b126f5efb9071...c90161586c174f740950ed56a748702ea3d9d6a1,1,4,4,8,3,2007-10-16 02:11:03,2007-10-09 21:03:55
c90161586c174f740950ed56a748702ea3d9d6a1...03618b9df84a0e94e36fdb27060e605e85b956e9,1,4,3,7,3,2007-10-16 02:11:54,2007-10-09 16:04:42
7c8b5eaf225db0b6b502126fc16f8f6814c38d24...971aa71fc695e0b56ffe2172543a126d20b16842,1,12,5,17,6,2007-09-16 02:13:31,2007-08-31 02:49:33
971aa71fc695e0b56ffe2172543a126d20b16842...f2327c6c52d4d523312dc32c143d2c29131ea24e,1,32,23,55,2,2007-09-16 02:13:31,2007-08-31 03:07:05
f2327c6c52d4d523312dc32c143d2c29131ea24e...036f81997c3ed144236a2aa7bb546df1a87f0c81,1,10,6,16,3,2007-09-16 02:13:31,2007-08-31 03:10:05
036f81997c3ed144236a2aa7bb546df1a87f0c81...1c6045fffa55ee314717e26756182562e45976e6,1,24,9,33,8,2007-09-16 02:17:05,2007-09-03 15:27:56
1c6045fffa55ee314717e26756182562e45976e6...1c097891e49042cf7ee4628a58836625fb65016d,1,55,49,104,3,2007-09-16 02:17:23,2007-09-03 16:59:55
1c097891e49042cf7ee4628a58836625fb65016d...513d419c5989b8aaeec1cb1ed356519370079dc1,1,41,41,82,8,2007-09-16 02:17:23,2007-09-01 03:26:38
513d419c5989b8aaeec1cb1ed356519370079dc1...1bbf1c7900337a646b6ca65c8b3505e784012f39,1,197,140,337,12,2007-09-16 02:17:23,2007-06-10 19:15:08
1bbf1c7900337a646b6ca65c8b3505e784012f39...09eff7b0f7c1f55f8714f19c5d87bbd92ddee453,1,147,148,295,2,2007-09-16 02:17:23,2007-09-09 02:13:53
09eff7b0f7c1f55f8714f19c5d87bbd92ddee453...9644ffdd65f10970d54ab56ae128cde6f3fe1b96,1,2,2,4,1,2007-09-16 02:17:23,2007-09-09 02:27:18
9644ffdd65f10970d54ab56ae128cde6f3fe1b96...ecd95b536e37e0a816d8c9832e04f61c3f1d4423,1,16,13,29,3,2007-09-16 02:17:23,2007-09-03 03:28:49
ecd95b536e37e0a816d8c9832e04f61c3f1d4423...40dac517ee09e2d0d5ae7b4f904f29b36fa82ef2,3,54,597,651,4,2007-09-16 02:17:24,2007-09-03 04:01:19
40dac517ee09e2d0d5ae7b4f904f29b36fa82ef2...a85fecafe63b49f89e0c055db6fb24b057db88c6,1,10,22,32,5,2007-09-16 02:17:24,2007-09-03 14:34:27
7c8b5eaf225db0b6b502126fc16f8f6814c38d24...e598c5177e439271e8bd81ef2a689a3ab0db80e6,1,1,1,2,1,2007-09-15 23:33:22,2007-09-15 23:32:23
e598c5177e439271e8bd81ef2a689a3ab0db80e6...023756f4eb71bfa37e17b0bdbf4b9fcbbba95466,2,15,0,15,2,2007-09-15 23:34:11,2007-09-15 17:39:52
7c8b5eaf225db0b6b502126fc16f8f6814c38d24...d99ebf081797dbb43ff618ff59f4c607b0acf045,2,80,14,94,7,2007-09-14 22:16:43,2007-09-14 07:31:00
89df580d0a2e97b0c7c072d87e5e815534deed56...611360443ef4d9e2f4def1e2c97727dd04e0d244,1,38,0,38,3,2007-09-19 00:41:25,2007-06-05 23:25:23
611360443ef4d9e2f4def1e2c97727dd04e0d244...1b4cbb5d5880091b1f4980e7a3f5cac276352bee,1,6,0,6,2,2007-09-19 00:41:25,2007-07-07 15:22:43
1b4cbb5d5880091b1f4980e7a3f5cac276352bee...683b56791b4e8a29ff9bc98c7faff69d7854d845,2,104,6,110,5,2007-09-24 05:29:12,2007-09-24 05:29:12
89df580d0a2e97b0c7c072d87e5e815534deed56...7a98869935a3682b5ff9679c92bf9bc12f87d8c5,3,31,21,52,14,2007-09-19 00:41:18,2007-09-17 22:34:06
89df580d0a2e97b0c7c072d87e5e815534deed56...46232915d5ac84fb033ad395bbf161c9645c42c9,3,81,0,81,3,2007-09-19 00:40:24,2007-09-11 16:59:03
46232915d5ac84fb033ad395bbf161c9645c42c9...af6fb4c822a5a65c7671d810127171759dff38f6,2,215,1,216,2,2007-09-19 00:40:24,2007-09-11 16:59:04
a005085240ef77ac0dde8eb08e27c6ef868d4bab...ce312affa1487b2b3857da7de5cca35d35f3baa7,1,2,2,4,2,2007-08-29 04:14:46,2007-08-28 14:05:43
ce312affa1487b2b3857da7de5cca35d35f3baa7...b39c53e662b97108ee1bda72076630d9d0e56211,1,3,3,6,3,2007-08-29 04:15:25,2007-08-28 22:41:23
b39c53e662b97108ee1bda72076630d9d0e56211...9d5fc59d120e2779ebe9ad0c947363785f1856b8,1,3,3,6,1,2007-08-29 04:16:57,2007-08-28 22:41:28
9d5fc59d120e2779ebe9ad0c947363785f1856b8...0c783f66df9470ec789825ca3df8fb2922c3c8bd,1,6,5,11,4,2007-08-29 04:47:08,2007-08-29 04:47:08
a005085240ef77ac0dde8eb08e27c6ef868d4bab...170c04383bca07fb5a32227474dfd58f29258d25,3,3,4,7,5,2007-08-28 07:10:21,2007-08-27 08:33:49
170c04383bca07fb5a32227474dfd58f29258d25...8a1d076e21810f5bc7e9ef10d84f7ca9637b89af,2,32,10,42,7,2007-08-28 07:38:48,2007-08-28 07:38:48
b13ef4916ac5a25cc5897f85ba0b4c5953cff609...464a8a7a15fc70efbcf56c4569f0f7275a9c76fe,1,18,45,63,4,2007-08-26 14:35:16,2007-05-25 00:28:14
464a8a7a15fc70efbcf56c4569f0f7275a9c76fe...a5f90f31302eb47cb1aa2f12447376ff9332abef,1,3,7,10,2,2007-08-26 14:35:16,2007-06-06 22:41:43
a5f90f31302eb47cb1aa2f12447376ff9332abef...a2ef9d633f67edc227b00209d5b72ec388388877,1,5,5,10,2,2007-08-26 14:35:16,2007-08-19 02:16:24
a2ef9d633f67edc227b00209d5b72ec388388877...e2618ff42716dd7cbc7a353670f46f357c5fb4c5,1,20,25,45,2,2007-08-26 14:35:17,2007-08-19 15:14:21
e2618ff42716dd7cbc7a353670f46f357c5fb4c5...d5821de2e29a3a207a2c5188f73b7d1f6d52fc34,1,1,1,2,1,2007-08-26 14:35:17,2007-08-20 15:12:09
d5821de2e29a3a207a2c5188f73b7d1f6d52fc34...a115daff12d8d26975ff15a4278a212df2c8c70b,1,8,6,14,2,2007-08-26 14:35:17,2007-08-08 15:34:28
c63fe3b2dc90120a4bdba7194f92efc2f3c342ed...2d19f8e921a1cdc562783814747819b0d5a12641,1,10,5,15,1,2007-09-09 23:47:22,2007-09-09 19:04:45
2d19f8e921a1cdc562783814747819b0d5a12641...4ed1a190d09c7d6a248038edb11addda77af7550,1,1,0,1,1,2007-09-09 23:47:26,2007-09-09 19:09:07
4ed1a190d09c7d6a248038edb11addda77af7550...3b9dfde3d636aeb961318d41b3ab59f72414d010,1,18,3,21,5,2007-09-10 00:39:42,2007-09-10 00:13:10
3b9dfde3d636aeb961318d41b3ab59f72414d010...8938410189315979255c1dfcc3c0b7a4bf9953e5,1,5,1,6,1,2007-09-10 00:39:47,2007-09-10 00:38:05
537d99033749591245ddd36f7317fd6b8555d803...84a7e35eea97388ba5ca458808119650818c2fd2,3,49,7,56,9,2011-03-30 20:13:52,2011-03-30 00:02:55
06ff44951a233c2e3dee4f072430ac68306f9bf0...1c40c36b9acbb55726ea0fcf98714a85e159e45f,1,43,30,73,9,2011-04-14 18:55:50,2011-04-14 14:28:30
06ff44951a233c2e3dee4f072430ac68306f9bf0...fd5858b49bd0672d96026a9cff690c2b8730cb0c,1,0,1,1,1,2011-04-14 16:19:51,2011-04-14 07:17:26
fd5858b49bd0672d96026a9cff690c2b8730cb0c...e3b02bc9533007f9e7aa9d7738a0f92c952dcff6,2,5,1,6,2,2011-04-14 17:47:18,2011-04-14 17:38:13
e3b02bc9533007f9e7aa9d7738a0f92c952dcff6...810cae53e0f622d6804f063c04a83dbc3a11b7ca,1,2,1,3,1,2011-04-14 19:24:02,2011-04-14 18:04:57
33e0f62ba981ebfdcab8c9fb6d2935712a7b9d41...145f86a00925b126412387c5ce072ab13cd4df03,1,7,7,14,5,2011-05-13 05:35:47,2011-05-12 08:37:22
6b67e0dc068d1bfd07686071b70f60078380666f...9516a598e3ecf39667a35ab2c5aa6cf88e9f7717,1,9,4,13,3,2011-10-07 23:15:02,2011-10-07 07:40:22
be3fa9125e708348c7baf04ebe9507a72a9d1800...0e7e30f5606b48a4c6d34bc99c6d680bb76d3fbc,1,2,2,4,2,2011-11-01 20:05:33,2011-10-31 22:37:12
be3fa9125e708348c7baf04ebe9507a72a9d1800...cfc755d30e2f9d92f19af10ba2d810281aa94c99,1,6,7,13,2,2011-11-01 03:05:57,2011-10-31 19:12:42
cfc755d30e2f9d92f19af10ba2d810281aa94c99...7b05949be007952c5f7708aac50e731534740574,1,1,0,1,1,2011-11-01 03:06:03,2011-10-31 19:12:43
7b05949be007952c5f7708aac50e731534740574...439fbb807259ad52f1af86ca5e5c98b5f189a246,12,0,12,12,12,2011-11-01 03:06:06,2011-10-31 19:12:44
be3fa9125e708348c7baf04ebe9507a72a9d1800...20a864cd835d5d3f559c3cddf5ac5c259bd61171,1,37,30,67,8,2011-10-31 22:22:55,2011-10-30 23:36:20
20a864cd835d5d3f559c3cddf5ac5c259bd61171...f1310cf5e70ad54aa61c18f5740439c67be3df32,1,67,47,114,5,2011-10-31 22:22:55,2011-10-30 23:36:21
f1310cf5e70ad54aa61c18f5740439c67be3df32...6ba1eb51b94c4777d84e4c9c868096735b1e16dd,2,122,11,133,16,2011-10-31 22:22:56,2011-10-30 23:36:22
6ba1eb51b94c4777d84e4c9c868096735b1e16dd...970fac5e24966d7e296cd044de6a6d0ba585c8c5,2,42,10,52,3,2011-10-31 22:22:57,2011-10-30 23:36:23
970fac5e24966d7e296cd044de6a6d0ba585c8c5...e4bd10b2cd30e91cfbfb59d9f1876cc1977515a2,1,47,0,47,1,2011-10-31 22:22:57,2011-10-30 23:36:24
e4bd10b2cd30e91cfbfb59d9f1876cc1977515a2...1e706eccd4051f0ff52d54aaf199496cc951a7bb,1,25,1,26,2,2011-10-31 22:22:58,2011-10-30 23:36:25
1e706eccd4051f0ff52d54aaf199496cc951a7bb...d0e6e29ee618c730c4428a52b7eb0be54c6af17a,1,8,8,16,5,2011-10-31 22:22:58,2011-10-30 23:36:26
d0e6e29ee618c730c4428a52b7eb0be54c6af17a...6ae683c0f4298a25e845d3018bccd346663ad9bb,1,23,0,23,3,2011-10-31 22:22:58,2011-10-30 23:36:27
d0f7dcbf424e1739437ffe477d87088ca6cb3432...251df09be3af658404f5f5f670a013d5806645d4,5,26,1,27,5,2011-03-09 22:28:24,2011-03-09 20:52:15
d0f7dcbf424e1739437ffe477d87088ca6cb3432...22817b400cefe320b89065ee4c7a6864957e1f00,1,3,3,6,3,2011-03-09 19:54:56,2011-03-08 13:16:09
22817b400cefe320b89065ee4c7a6864957e1f00...621c39de223f80d7014c39c5791db8b2b066fa18,1,12,0,12,1,2011-03-09 20:22:15,2011-03-08 13:16:10
621c39de223f80d7014c39c5791db8b2b066fa18...494489a5bd241337fa94331c038976f2a042265e,1,1,1,2,1,2011-03-09 20:32:00,2011-03-09 20:03:48
494489a5bd241337fa94331c038976f2a042265e...681186ae3ab340dd684b1d9e09b457baeb2331f9,1,1,1,2,1,2011-03-09 20:53:13,2011-03-09 20:25:09
f98fd4367542b507c18b6aeb4ac0c824dec4b7b3...3add01bbf14c5f2cb94523ee638c22c8157f0d2b,1,2,2,4,1,2011-04-01 22:14:38,2011-04-01 18:04:46
b5f306fbe1bf1a75341f85b84358d25870b010f3...2b1e17237b0b14855ad8337ec001d6d1fd7cca61,1,4,2,6,1,2011-03-25 20:27:05,2011-03-25 19:20:49
2b1e17237b0b14855ad8337ec001d6d1fd7cca61...78bc46675353e4833a59e0f4dfa47d57a9c1a46b,2,8,1,9,3,2011-03-26 00:56:14,2011-03-26 00:56:14
cdc34664d4bb86063062dd63183dfb6b9ebf4772...08c8d5581363998fda2803da2620d47fe8b50f0d,1,13,10,23,6,2011-03-21 05:24:24,2011-03-21 05:24:24
79efeae69d843af575fb27696f5263fe76c570a6...8ced9c90a28f6abc80dc5ad4cf7921c2322c0bb0,4,27,3,30,5,2012-03-26 19:29:25,2012-03-26 19:23:34
6288e3e180c0b911e6f7062f1e744a25568f7d22...4f5de755a7931c5e15f4e7fc3d501588aa9ff88d,2,12,1,13,3,2011-03-07 06:56:50,2010-11-20 19:25:28
4f5de755a7931c5e15f4e7fc3d501588aa9ff88d...5a38b186d3ac5840d6ae78511d6dccab8367f242,1,23,10,33,12,2011-03-07 06:56:50,2010-12-10 10:28:06
5a38b186d3ac5840d6ae78511d6dccab8367f242...e75316de5340e0ba3ac75937c59fa2c9d6ab48d7,3,13,22,35,8,2011-03-07 06:56:50,2010-12-10 06:53:54
e75316de5340e0ba3ac75937c59fa2c9d6ab48d7...efc749b48f729992d838484d652ba24f5291ee28,2,6,0,6,2,2011-03-07 07:32:51,2010-10-11 02:51:21
f47ff5afe4208488c6f977b497b81acdce941afc...eb2c67ccbd5c6c5b7c73752dca2526bcce022b9e,1,7,1,8,1,2012-03-23 21:40:39,2012-03-23 21:40:39
eb2c67ccbd5c6c5b7c73752dca2526bcce022b9e...c16df57c5a778ef14ede7ad202c74146269d61ac,2,18,2,20,5,2012-03-23 22:11:24,2012-03-23 21:50:23
b9f0662bb044fdff755771271e9659d0c6dce240...bf505158d0292eed441fff1bc9157da19645ee91,3,32,3,35,8,2012-05-02 04:18:44,2012-05-02 04:18:44
b2bab5b338b30d45e338c8df3c15e6483d6bb11e...d0f1ea6003d97e63110fa7d50bb07f546a909b6e,3,16,2,18,4,2012-04-26 17:23:15,2012-04-26 17:23:15
875b91b35d2517773495e8404f31fde8c5cbd27d...f3999e03274df6b98a98a32912f5e171d6eea35f,2,25,0,25,5,2012-05-16 18:17:45,2012-05-16 14:28:31
f3999e03274df6b98a98a32912f5e171d6eea35f...176a33542eddc6e319bfef4ca726813ce0b9af55,1,2,2,4,1,2012-05-16 18:18:06,2012-05-16 14:50:31
fdec2eb8ebbf995a77e2ab9971565c792b52944a...46e358158109200abde4de0a044a415c80c9bce5,1,11,11,22,3,2012-04-27 15:01:33,2012-04-26 21:00:39
fdec2eb8ebbf995a77e2ab9971565c792b52944a...94a35b1aea88f1ad882cdd111e01410fb6d3eb46,2,31,1,32,5,2012-04-26 04:19:06,2012-04-26 01:47:14
fdec2eb8ebbf995a77e2ab9971565c792b52944a...75e0dffef009bb06072e44d38555373639d94986,1,4,2,6,2,2012-04-25 23:41:37,2012-04-24 17:50:05
fdec2eb8ebbf995a77e2ab9971565c792b52944a...7fb8e163bdfdc5ffb69b98f3f05ef0dbade4e677,2,20,0,20,4,2012-04-24 21:54:24,2012-04-22 20:30:58
fdec2eb8ebbf995a77e2ab9971565c792b52944a...51120683ec8664c8b34b8541a0518a4902ee9d94,1,1,1,2,1,2012-04-19 20:48:01,2012-04-18 21:07:25
fdec2eb8ebbf995a77e2ab9971565c792b52944a...76642ccec813a1cc2ca1bf9539abeb5f17764808,2,6,6,12,6,2012-04-14 23:16:55,2012-04-14 04:45:31
76642ccec813a1cc2ca1bf9539abeb5f17764808...b1f5b7839c3bce2accda8b70e03ccc62ad778dd9,1,1,1,2,1,2012-04-14 23:17:08,2012-04-14 04:46:18
b1f5b7839c3bce2accda8b70e03ccc62ad778dd9...948065a4837f006c5c84ee1288cf15f1a56d93f2,1,1,1,2,1,2012-04-14 23:17:12,2012-04-14 04:48:13
ca2b71a00b47e47990b3a196c9ae26ac6b19e287...e5056c05ecd2bdaceaa95e12e9e94b1584ec59c8,2,8,8,16,3,2012-04-03 16:30:58,2012-04-03 16:25:49
6c15a1c63634005a0f8fb15696e154cc54b0a359...5d86861c925f15676a14b54062725eb11a85ffbc,1,6,0,6,1,2012-03-28 17:20:33,2012-03-28 16:55:21
0987145dd3d11373270c1e0cfbd449f2c6c834c9...3f94ff755e266520ba2f6007d557395c33d30fdc,1,46,65,111,9,2012-03-23 18:46:25,2012-03-22 19:52:16
3f94ff755e266520ba2f6007d557395c33d30fdc...850896042a42c1c16912a3981ca844e2cbcd14d4,2,17,3,20,4,2012-03-23 18:46:25,2012-03-22 19:52:17
850896042a42c1c16912a3981ca844e2cbcd14d4...283607694c1248a8e1ff4cda48aa5d1eb1287733,1,5,4,9,5,2012-03-23 18:46:26,2012-03-22 19:52:18
283607694c1248a8e1ff4cda48aa5d1eb1287733...db607087d0f1256b745b9a878623060d775f1817,1,0,4,4,2,2012-03-23 18:46:26,2012-03-22 19:52:19
db607087d0f1256b745b9a878623060d775f1817...11bf87076a686dbfe696dd21333486cab55e6fbb,1,1,10,11,2,2012-03-23 18:46:26,2012-03-22 19:52:20
11bf87076a686dbfe696dd21333486cab55e6fbb...e9653615fafcbac6109da99fac4fa66b0b432048,1,2,7,9,2,2012-03-23 18:46:26,2012-03-22 19:52:21
e9653615fafcbac6109da99fac4fa66b0b432048...7e0abcec103b3649943b236881cf88e8fd6cf3a4,4,303,27,330,17,2012-04-23 18:59:34,2012-04-23 18:23:41
7e0abcec103b3649943b236881cf88e8fd6cf3a4...bf73fc212a159210398b6d46ed5e9101c650e7db,3,64,7,71,10,2012-04-23 19:00:42,2012-03-29 13:39:18
0987145dd3d11373270c1e0cfbd449f2c6c834c9...bc62ca13c03a7f73b7091c26093c552776b749ee,1,10,1,11,3,2012-03-16 15:42:22,2012-03-16 15:42:22
d90b16ed421eb51fc4d7c6bda5f3332cc2e3aece...a2c01b55ff71ee20c49c4e6d088e14b6e80dd930,1,17,12,29,13,2012-03-16 12:32:59,2012-03-16 12:28:05
a2c01b55ff71ee20c49c4e6d088e14b6e80dd930...dac1de7de5f13d5bd2b69c8580ae213f166f16c5,1,17,12,29,13,2012-03-16 14:35:58,2012-03-16 14:35:58
dac1de7de5f13d5bd2b69c8580ae213f166f16c5...0e641b1f95d93ffb7447d78df5cc98f92451997c,1,23,18,41,18,2012-03-27 08:09:03,2012-03-15 09:47:06
0e641b1f95d93ffb7447d78df5cc98f92451997c...90e6ef53203e5567aadda2f76b69a40251987a07,1,252,250,502,247,2012-03-27 08:09:03,2012-03-27 06:46:11
90e6ef53203e5567aadda2f76b69a40251987a07...3601b1d3593cbe856ea79fa554233b7d6fe52b2e,1,1,0,1,1,2012-03-27 09:11:34,2012-03-27 09:11:34
b8de3f4b8c1e01ddbaf9a482e2bd2ef80da39d55...4eeb1de1c3855968bcd2d58b223fd187ae510d73,1,3,1,4,1,2012-03-12 21:57:37,2012-03-12 21:47:19
75f49651a1b947e2eadd2c831b30892c0f4565c8...471dcfdbb23ad423168d928335bc36217f9e311d,1,2,1,3,2,2012-03-21 17:02:39,2011-09-01 13:47:31
b3e5bce1aa88721dd4565089960997836ce66add...1f05d07c456e23c0827efbbb3e738afc9f3152e7,2,365,6,371,11,2010-11-24 22:48:54,2010-11-18 05:03:51
1f05d07c456e23c0827efbbb3e738afc9f3152e7...5c28a8b054cb69a37638b0261fc370422c8fab58,4,9,5,14,6,2010-11-24 22:51:42,2010-11-20 00:46:06
5c28a8b054cb69a37638b0261fc370422c8fab58...1d13e9f600986b7ced8db37a9a9c4967ee7ff9d5,2,166,7,173,8,2010-11-24 22:51:42,2010-11-20 00:46:22
1d13e9f600986b7ced8db37a9a9c4967ee7ff9d5...da3e217447390d52363989474a5e33bd298ff3ad,1,11,12,23,11,2010-11-24 22:51:42,2010-11-20 00:46:54
da3e217447390d52363989474a5e33bd298ff3ad...d6e81a03153810f122f1b8ec3635fd84c5429f69,1,5,4,9,5,2010-11-24 22:51:42,2010-11-20 00:47:41
d6e81a03153810f122f1b8ec3635fd84c5429f69...462e1f51a5648ce9d7ca26d44ed86327c454889a,1,8,8,16,6,2010-11-24 22:51:43,2010-11-20 00:48:51
462e1f51a5648ce9d7ca26d44ed86327c454889a...5af8fae2df03d1888dbf315da29d1cdaa6214f57,1,8,3,11,2,2010-11-24 22:51:43,2010-11-20 00:49:17
5af8fae2df03d1888dbf315da29d1cdaa6214f57...6ee4a9be48ee714ddacf313a7073dabdd6c6ee11,1,7,6,13,2,2010-11-24 22:51:43,2010-11-20 00:49:55
6ee4a9be48ee714ddacf313a7073dabdd6c6ee11...08c39b5c44449cb649ac32274e27be8046e373d4,3,12,20,32,10,2010-11-24 22:51:43,2010-11-20 00:51:50
08c39b5c44449cb649ac32274e27be8046e373d4...1c7bb316169c700df0d1711555564f86c9cb9366,1,18,22,40,6,2010-11-24 22:51:43,2010-11-20 00:52:28
1c7bb316169c700df0d1711555564f86c9cb9366...414e569e453a49171b1f3db613f88378324104e8,2,25,2,27,4,2010-11-24 22:52:47,2010-11-20 00:52:59
414e569e453a49171b1f3db613f88378324104e8...c7dbf35e91cffbc326078d0c0470662f6422150d,2,35,4,39,4,2010-11-24 22:52:51,2010-11-20 00:53:34
c7dbf35e91cffbc326078d0c0470662f6422150d...3f3e676d6e6c1d445181107770670368e0ad3160,1,0,8,8,8,2010-11-24 22:53:58,2010-11-20 00:53:54
3f3e676d6e6c1d445181107770670368e0ad3160...2a48afe1c256db6273a4ff99eaddc5c18dc46ffd,1,19,14,33,3,2010-11-24 22:53:58,2010-11-20 00:54:20
2a48afe1c256db6273a4ff99eaddc5c18dc46ffd...6263c06d49abdf5e5defdf528c3ff67bf948ac9b,1,19,11,30,4,2010-11-24 22:53:58,2010-11-20 00:54:45
6263c06d49abdf5e5defdf528c3ff67bf948ac9b...6b01b67658e2905b550739f1aee56a00911ca13c,2,144,12,156,11,2010-11-24 22:53:59,2010-11-20 00:57:46
6b01b67658e2905b550739f1aee56a00911ca13c...9e8c532108b9078812f23c53a2df3509e7ce71bf,2,59,1,60,2,2010-12-08 00:04:56,2010-12-06 22:19:32
0188f6b3c191eb5277e9ebab3b9079f923dbd283...2977ffbbe134e0fe9bc8aa3643e2d40111643c23,1,12,13,25,5,2010-11-29 21:34:15,2010-11-27 06:22:16
2977ffbbe134e0fe9bc8aa3643e2d40111643c23...0fd0e2417d383168b6a510f78c754298435a89ce,3,14,5,19,3,2010-11-29 21:34:55,2010-11-26 18:17:44
0fd0e2417d383168b6a510f78c754298435a89ce...2431afbf1b3b986245242218b909cd9f055ba65b,2,74,9,83,13,2010-11-29 21:35:12,2010-11-27 06:24:04
2431afbf1b3b986245242218b909cd9f055ba65b...9037026d34907c0c94e3ab46f96068fa57da6ebc,3,155,20,175,8,2010-12-01 01:28:09,2010-11-26 18:17:46
9037026d34907c0c94e3ab46f96068fa57da6ebc...9e082734b3a7c2685c1593dae8dca1e73568d51c,1,0,7,7,1,2010-12-01 01:30:28,2010-11-26 18:17:47
f772c34ce09a49eb553240eb672bf0cc2dbcb10a...3cf8fe1d26edd7c4cce6593d70212970f8b0bbc0,4,40,0,40,8,2010-11-17 21:07:43,2010-11-14 01:51:14
3cf8fe1d26edd7c4cce6593d70212970f8b0bbc0...f39f72d8cf03b61407f64460eba3357ec532280e,2,12,2,14,6,2010-11-17 21:07:43,2010-11-14 01:51:15
f772c34ce09a49eb553240eb672bf0cc2dbcb10a...b2be2f6aeaa8f4af602679e5571d2e916a259d91,2,23,2,25,4,2010-11-17 18:59:23,2010-11-17 17:00:45
f772c34ce09a49eb553240eb672bf0cc2dbcb10a...f1037448e29104cdad73b93cb961e3b40e08e925,1,12,14,26,2,2010-11-16 17:29:37,2010-11-10 20:27:13
f1037448e29104cdad73b93cb961e3b40e08e925...ed296fe88dc8790f25a3546f1688dd40f8cbf2d1,1,41,0,41,1,2010-11-16 17:50:25,2010-11-12 04:24:56
ed296fe88dc8790f25a3546f1688dd40f8cbf2d1...71567e3287cbd1c06e311579d43a7d8cc0648722,1,2,2,4,2,2010-11-16 18:22:37,2010-11-15 10:12:44
71567e3287cbd1c06e311579d43a7d8cc0648722...6a6c54bafed84220bcd09b19b40c104d1ff687cc,1,2,0,2,1,2010-11-17 21:16:48,2010-11-12 08:48:58
6a6c54bafed84220bcd09b19b40c104d1ff687cc...11fe3f73cce13b759a728b0a9ac95e745470f251,1,8,6,14,1,2010-11-17 21:17:46,2010-11-12 18:55:58
f772c34ce09a49eb553240eb672bf0cc2dbcb10a...71fc224fe8af9202eb60c98a128150fd0ae23090,1,21,0,21,1,2010-11-11 21:30:55,2010-11-11 21:28:57
4f8303905eafaa04fd08a20a08a81436aea2d4b9...eb637e138289dc5b96bea5b192cbaff93623d1dc,1,6,6,12,6,2011-06-23 14:58:20,2011-06-23 08:12:04
eb637e138289dc5b96bea5b192cbaff93623d1dc...0aceb220972413e73157cb46a8a52e0f6034d54c,1,10,9,19,7,2011-06-23 16:15:28,2011-06-23 15:33:05
0aceb220972413e73157cb46a8a52e0f6034d54c...a0a7e9e511faa86663148557d0f5b0597767d25a,1,6,3,9,1,2011-06-23 22:38:14,2011-06-23 16:31:19
a0a7e9e511faa86663148557d0f5b0597767d25a...0abcfbff4ddaf08e5aa2524f28a7035095b6d0c9,1,3,4,7,3,2011-06-23 22:38:18,2011-06-23 16:35:10
0abcfbff4ddaf08e5aa2524f28a7035095b6d0c9...487b04411d625ff912543e4313a3343db62429e4,1,8,8,16,1,2011-06-23 22:39:24,2011-06-23 16:38:48
487b04411d625ff912543e4313a3343db62429e4...deaef1e94734a61407c73637e0e9718f914c3a62,1,5,4,9,2,2011-06-23 22:39:28,2011-06-23 16:47:28
deaef1e94734a61407c73637e0e9718f914c3a62...67393c5dc99eb61e76d2ea4df3dae49e8e93828d,1,2,2,4,1,2011-06-23 22:39:28,2011-06-23 16:48:49
188923f0d1c8148415b3173986cd1e21871c947e...abf8df869c79ee6fa021b117e60683fe149131d8,1,8,7,15,3,2012-10-12 16:45:13,2012-10-12 07:35:33
abf8df869c79ee6fa021b117e60683fe149131d8...1960897ebc5a899a8e4ec3c2afc1d2325574fe41,3,4,7,11,5,2012-10-12 16:45:15,2012-10-12 07:35:59
73eb89e75949e7bc52515223a051aee0b986bbec...9a8eea9604ade731c3d0ff10136f2ae81b2a13c8,1,29,1,30,2,2012-09-10 22:30:46,2012-09-10 22:30:46
57c054c5d0e72d5665322a4bebb7f380390edde5...8228a23b35f6bd34a87d4d839d06e7c18ae9e750,1,15,0,15,2,2012-07-05 06:48:37,2012-07-05 06:48:37
d065f687452a666c74f353306bb14debe48e40d3...ba998d33e22d6fce4445af5834dc227609672501,1,24,1,25,5,2012-02-23 21:38:50,2012-02-23 21:38:50
d47553665833935157292a71248278a40e32c320...58ebd9865d2bb9d42842fbac5a1c4eae49e92859,1,1,1,2,1,2012-01-27 19:58:56,2012-01-27 19:58:56
828ea97de486c1693d6e4f2c7347acb50235a85d...22f0dcd9634a818a0c83f23ea1a48f2d620c0546,1,2,0,2,1,2013-01-06 06:56:36,2013-01-05 22:49:54
828ea97de486c1693d6e4f2c7347acb50235a85d...6a2abdc12516cd3801bceef4ccfba399c962a074,2,76,46,122,27,2012-08-25 06:11:05,2012-08-25 05:48:55
828ea97de486c1693d6e4f2c7347acb50235a85d...c2a7f5d43843d16850a460e7f202affb0d24dc48,2,3,3,6,3,2012-08-07 21:30:52,2012-08-07 20:07:38
828ea97de486c1693d6e4f2c7347acb50235a85d...d7236c4395a0c8742871a72d920f789b5bd4abf6,2,12,1,13,2,2012-06-18 22:13:16,2012-06-18 18:18:20
d7236c4395a0c8742871a72d920f789b5bd4abf6...023e37c37780d6a56f2870a979c8eb3a9ee9a44d,7,33,10,43,12,2012-06-18 22:21:42,2012-06-18 18:18:21
828ea97de486c1693d6e4f2c7347acb50235a85d...a1b475eeb40dc29246d4ce7465474479639769d0,1,2,2,4,2,2012-06-18 21:59:56,2012-06-18 18:30:15
a1b475eeb40dc29246d4ce7465474479639769d0...f01cc14c3c70cfd820114505d2ddc153c28f6f89,2,19,18,37,4,2012-07-02 18:22:57,2012-07-02 17:19:35
f01cc14c3c70cfd820114505d2ddc153c28f6f89...8c135ea260a84ef71899c8bd23bb39425288f9fe,3,20,15,35,6,2012-07-03 17:22:37,2012-07-02 18:01:25
8c135ea260a84ef71899c8bd23bb39425288f9fe...249c8f4a164c8502f8274c505a48b9c686f458d0,3,6,15,21,7,2012-07-03 17:24:11,2012-07-02 19:56:44
249c8f4a164c8502f8274c505a48b9c686f458d0...274ac009f4613a14d2114259e40c6b523d9b7160,1,7,0,7,1,2012-07-03 17:24:15,2012-06-18 18:41:03
274ac009f4613a14d2114259e40c6b523d9b7160...1b27c2f01af398706acf554794644daaf6bc8835,1,8,8,16,5,2012-07-03 17:24:15,2012-06-18 18:50:36
1b27c2f01af398706acf554794644daaf6bc8835...f703e6ea5e3bc7ff39b3ef6d3a21208fb63dfabd,1,55,46,101,3,2012-07-03 17:24:15,2012-06-18 20:10:38
f703e6ea5e3bc7ff39b3ef6d3a21208fb63dfabd...1703f9aa0b87d52278489029d538ef1a4aa37432,1,22,22,44,18,2012-07-03 17:24:15,2012-06-21 05:35:43
1703f9aa0b87d52278489029d538ef1a4aa37432...a78fafe74a4f8c416c35ca07b3ba28375475ae96,1,112,60,172,20,2012-07-03 17:24:15,2012-06-21 05:07:36
a78fafe74a4f8c416c35ca07b3ba28375475ae96...c005e98612c3ba896415cfa56df67ae8b240cc85,1,1,1,2,1,2012-07-03 18:17:17,2012-07-03 18:01:03
c005e98612c3ba896415cfa56df67ae8b240cc85...37c00e5590605c9d3ba76b6c9d7a94ac0356f703,2,6,3,9,5,2012-07-03 18:17:59,2012-06-18 18:32:03
37c00e5590605c9d3ba76b6c9d7a94ac0356f703...aa1dec9ef6ff184792520eb4539af1555c01604c,2,10,0,10,3,2012-07-03 18:17:59,2012-06-21 06:03:09
aa1dec9ef6ff184792520eb4539af1555c01604c...6269b6b676310d9fa2560da49be618372b39acf4,2,257,1,258,3,2012-07-09 23:42:22,2012-06-18 20:45:56
6269b6b676310d9fa2560da49be618372b39acf4...e48ba200be908f02a3fb30adcbb8000b7100cb32,1,8,8,16,8,2012-07-09 23:42:22,2012-07-02 16:46:50
e48ba200be908f02a3fb30adcbb8000b7100cb32...e2643617d75e53e5a69278f8d7382553d1c14cf0,3,30,5,35,9,2012-07-09 23:42:22,2012-07-02 17:00:40
e2643617d75e53e5a69278f8d7382553d1c14cf0...33bd598c3902c40c5a10a68aeaa3004484239258,4,18,13,31,13,2012-07-09 23:42:22,2012-07-02 17:32:11
33bd598c3902c40c5a10a68aeaa3004484239258...cd74e4733db3e2353077bdc7021caa70bed2a483,5,25,7,32,8,2012-07-09 23:42:22,2012-07-02 19:04:52
cd74e4733db3e2353077bdc7021caa70bed2a483...8e676e8ba567eccee1510b90ec2e0364dcc2f3b4,3,10,8,18,8,2012-07-09 23:42:22,2012-07-02 19:33:52
8e676e8ba567eccee1510b90ec2e0364dcc2f3b4...d5f6b1d756a29255efedee3cb6e8526aedcfeb00,4,15,3,18,9,2012-07-09 23:42:22,2012-07-02 19:43:05
d5f6b1d756a29255efedee3cb6e8526aedcfeb00...daba53aeaf6565b4bbdd6783c659480453ec3c5e,3,76,5,81,8,2012-07-09 23:42:22,2012-07-03 06:35:05
daba53aeaf6565b4bbdd6783c659480453ec3c5e...da3ac0c14993c5e8e41875cc3ead32be71647a7a,2,2,2,4,2,2012-07-09 23:42:22,2012-07-03 17:01:22
da3ac0c14993c5e8e41875cc3ead32be71647a7a...75f5ac04a2984fcf1e4d167047bfb63c5f385d44,2,6,6,12,5,2012-07-09 23:42:22,2012-07-03 17:03:38
75f5ac04a2984fcf1e4d167047bfb63c5f385d44...13243c2c7a758bb6510ba26d0372f384b5f422ce,2,9,3,12,4,2012-07-09 23:42:23,2012-07-03 17:04:22
13243c2c7a758bb6510ba26d0372f384b5f422ce...c036c4c5e426cc7ee8070038607edf06ef1d661e,2,3,3,6,3,2012-07-09 23:42:23,2012-07-03 20:45:12
c036c4c5e426cc7ee8070038607edf06ef1d661e...957d74062c1f0e92368aeda335e27d2d61f584f6,5,78,9,87,12,2012-07-09 23:42:23,2012-07-03 21:21:59
957d74062c1f0e92368aeda335e27d2d61f584f6...4c654f5f278ef4729497d1f3e3897acc030ff0b7,1,1,1,2,1,2012-07-11 23:30:49,2012-07-11 23:30:28
4c654f5f278ef4729497d1f3e3897acc030ff0b7...31ffd0c0c1255cb7e9ba76192a70ae294faf95bf,1,3,3,6,2,2012-07-13 19:43:43,2012-07-13 19:43:43
828ea97de486c1693d6e4f2c7347acb50235a85d...0db71e0fa94c1857f98890928098e8f4c8ac6f26,5,138,0,138,7,2012-04-11 15:50:53,2012-03-31 22:10:11
0db71e0fa94c1857f98890928098e8f4c8ac6f26...46905893b20ac2a044c06a0eecc12425a8405e69,1,23,6,29,3,2012-04-11 15:50:54,2012-03-31 22:10:39
46905893b20ac2a044c06a0eecc12425a8405e69...fbc08ea177f8284d10c62ad39de51edb21af88b0,3,19,1,20,4,2012-04-11 15:50:54,2012-03-31 22:11:01
fbc08ea177f8284d10c62ad39de51edb21af88b0...7365c95d2d67cbbb74c2040918d2ecde06231d93,4,19,11,30,4,2012-04-17 18:07:01,2012-04-17 18:07:01
828ea97de486c1693d6e4f2c7347acb50235a85d...1696d72321492c05bebd1e823de0708c13ec7d72,2,6,4,10,6,2012-04-05 23:22:48,2012-04-05 17:48:46
1696d72321492c05bebd1e823de0708c13ec7d72...38f865c27d1f2560afb48efd2b7b105c1278c4b5,4,80,3,83,6,2012-04-05 23:24:13,2012-03-30 07:52:18
828ea97de486c1693d6e4f2c7347acb50235a85d...078b895fefdca94995862a4cc8644198b00a89bf,3,52,1,53,5,2012-04-02 20:47:15,2012-04-02 15:13:48
828ea97de486c1693d6e4f2c7347acb50235a85d...4e0ce4dfea869cfe383149a3db5a430f0579c3f4,1,4,2,6,2,2012-03-31 18:14:26,2012-03-31 08:42:34
4e0ce4dfea869cfe383149a3db5a430f0579c3f4...5b58619aa011c2047e7b67ca28630d8a2e72ca1f,3,18,0,18,4,2012-04-10 21:50:27,2012-03-31 08:44:53
828ea97de486c1693d6e4f2c7347acb50235a85d...c65dc351f0ae184f69cbc0b6555ff19aacb70e01,1,2,0,2,2,2012-03-30 18:07:43,2012-03-30 18:04:08
c65dc351f0ae184f69cbc0b6555ff19aacb70e01...010c7dbcbe2e55c1dcc85f23fbe55be6d7e931f0,2,8,0,8,3,2012-03-30 18:30:59,2012-03-30 18:30:59
010c7dbcbe2e55c1dcc85f23fbe55be6d7e931f0...b2eda9bdfbacdd3bb52da2ebcb468415cf153940,2,47,19,66,6,2012-03-30 19:20:00,2012-03-30 19:14:33
b2eda9bdfbacdd3bb52da2ebcb468415cf153940...b0ad5e27803cd599e629b1a64b74ac4bffb3962d,1,5,5,10,1,2012-04-01 22:20:38,2012-03-31 19:28:15
b0ad5e27803cd599e629b1a64b74ac4bffb3962d...1f08c2c8258cb09d4e78b8c3ff7e45a570f957ea,1,8,5,13,1,2012-04-03 23:41:21,2012-04-03 23:41:21
828ea97de486c1693d6e4f2c7347acb50235a85d...a2c25061aa2cfa2f60d092a5b7bc9c00c4beca90,1,9,1,10,2,2012-03-08 22:03:07,2012-03-08 20:07:20
828ea97de486c1693d6e4f2c7347acb50235a85d...a8356d43e3602fb65a9ae57a5cf1ca98a75f5cc3,1,12,8,20,2,2012-02-20 08:01:53,2012-02-18 19:38:04
828ea97de486c1693d6e4f2c7347acb50235a85d...b5225286b226759262c0637058528af03226fba6,3,16,0,16,4,2012-02-13 08:11:01,2012-02-12 16:23:36
828ea97de486c1693d6e4f2c7347acb50235a85d...1a191a22959b367e2867d78f89a363fdf69afe3b,1,1,1,2,1,2012-02-10 20:53:55,2012-02-10 02:13:30
1a191a22959b367e2867d78f89a363fdf69afe3b...43ccdf56ec5c92478361a0eb94b91c535fd4d2bd,1,15,0,15,3,2012-02-10 20:56:29,2012-02-10 02:13:31
828ea97de486c1693d6e4f2c7347acb50235a85d...ae7706b9ac98e3c412d799c910de604347ffce5d,3,93,2,95,11,2012-02-09 03:59:41,2012-02-08 23:03:43
ae7706b9ac98e3c412d799c910de604347ffce5d...0975a5020ef050a9fd5b518cbd601e5ee43ddbcf,1,1,1,2,1,2012-02-13 19:12:36,2012-02-13 18:24:41
828ea97de486c1693d6e4f2c7347acb50235a85d...e859c69b26528a55bd64f4eee2ed06fad999d862,5,19,20,39,18,2012-02-08 00:35:43,2012-01-16 02:36:46
828ea97de486c1693d6e4f2c7347acb50235a85d...cf0ff02a38b5b97091301224475d81923f3c298f,1,6,3,9,3,2012-02-06 23:52:51,2012-02-02 19:26:15
cf0ff02a38b5b97091301224475d81923f3c298f...d79f81adfe02a3f0eaf8deba5fb81dd220b72aae,1,2,37,39,2,2012-02-06 23:53:31,2012-02-02 09:05:29
d79f81adfe02a3f0eaf8deba5fb81dd220b72aae...583e4d579d36894ccdc1f4fb4a6dd24c9274c5f8,1,3,16,19,3,2012-02-06 23:53:33,2012-02-02 19:48:08
828ea97de486c1693d6e4f2c7347acb50235a85d...9c3c22e2bf6cf05297556936666c8578e160c366,1,101,0,101,1,2012-02-06 22:18:21,2012-02-06 09:53:46
9c3c22e2bf6cf05297556936666c8578e160c366...d7be1f142fd3e9ea812143e4281c84341ef5534d,1,8,7,15,3,2012-02-17 15:52:41,2012-02-17 08:18:38
d7be1f142fd3e9ea812143e4281c84341ef5534d...27370b1170fbd5859e9d88e91be9108e04b6725e,1,1,1,2,1,2012-02-17 15:52:41,2012-02-16 08:02:18
27370b1170fbd5859e9d88e91be9108e04b6725e...839de2527258879aa21ae7ad425353f06dbb4717,1,4,3,7,1,2012-02-17 15:52:41,2012-02-16 08:03:52
839de2527258879aa21ae7ad425353f06dbb4717...0a5f57592728e7667d9e60e309f6270db9fdb67b,1,7,13,20,4,2012-02-17 15:52:41,2012-02-16 08:04:05
0a5f57592728e7667d9e60e309f6270db9fdb67b...42bd39b57fee80a9fd136f89c7728e640d13964a,2,14,7,21,6,2012-02-17 15:52:41,2012-02-16 08:04:25
42bd39b57fee80a9fd136f89c7728e640d13964a...c9b5e2a57d2a69e0c6183758445da2f230b5a9f0,3,27,4,31,6,2012-02-17 15:58:07,2012-02-16 08:05:56
c9b5e2a57d2a69e0c6183758445da2f230b5a9f0...270a34438b0776c072268838a8e8aa786494cfee,2,60,24,84,24,2012-02-17 15:58:54,2012-02-16 08:07:32
270a34438b0776c072268838a8e8aa786494cfee...4a7bb5ba950f08d1e46c4bd2e8b1c903b4d024c8,2,3,9,12,5,2012-02-17 15:58:54,2012-02-16 08:09:32
4a7bb5ba950f08d1e46c4bd2e8b1c903b4d024c8...9b25a0b52e09400719366f0a33d0d0da98bbf7b0,7,292,14,306,27,2012-02-17 15:59:55,2012-02-06 09:54:04
828ea97de486c1693d6e4f2c7347acb50235a85d...f2d713fc3e8e0b7be89584f04b421808aa99c403,2,48,22,70,7,2012-02-06 08:15:12,2012-02-06 06:00:17
f2d713fc3e8e0b7be89584f04b421808aa99c403...e60ec75948f197b82f867e31b74bb89323e6581f,1,4,2,6,3,2012-02-09 19:47:54,2012-02-09 08:22:26
828ea97de486c1693d6e4f2c7347acb50235a85d...b5c9f1c1b0ed9c91463b9f46a7c9dff3efc53773,2,15,1,16,3,2012-02-06 00:30:26,2012-02-06 00:22:12
828ea97de486c1693d6e4f2c7347acb50235a85d...7f814632f5d4d7af9f4225ece6039dbc44e03079,69,168,118,286,118,2012-02-04 07:19:42,2012-02-01 12:55:07
828ea97de486c1693d6e4f2c7347acb50235a85d...3a9f58c00a4fd0bee8f1b01abcd2656190979518,1,1,0,1,1,2012-02-04 07:06:30,2012-02-03 21:49:07
828ea97de486c1693d6e4f2c7347acb50235a85d...840c519d7e7ae4651a7b5a0954f7aa53eebc29b6,1,9,0,9,2,2012-02-04 07:01:07,2012-02-04 06:29:01
828ea97de486c1693d6e4f2c7347acb50235a85d...31b49d9b653803e7c7fd18b21c8bdd86e3421668,1,1,2,3,2,2012-02-03 22:37:02,2012-02-03 22:14:11
31b49d9b653803e7c7fd18b21c8bdd86e3421668...84d72733fc8cb90ac7fef04bb114da1e14d8b147,1,17,7,24,8,2012-02-03 22:37:04,2012-02-03 22:16:02
828ea97de486c1693d6e4f2c7347acb50235a85d...84d9e2d50ca9fbcf34e31cb74797fc182187c7b5,1,8,8,16,8,2012-02-03 21:03:08,2012-02-03 12:44:54
828ea97de486c1693d6e4f2c7347acb50235a85d...78db6ea9dc1a872f9d07a36fe7aec700a5c963b9,3,13,11,24,13,2012-02-02 18:36:07,2012-02-02 08:18:29
78db6ea9dc1a872f9d07a36fe7aec700a5c963b9...b3aeb285d0ac1dcb4d578a61a68e08646f96501f,3,29,23,52,10,2012-02-02 18:36:07,2012-02-02 08:18:41
b3aeb285d0ac1dcb4d578a61a68e08646f96501f...e1327023ea22c3bf57e7d28596da356043f073fc,2,186,34,220,32,2012-02-02 18:36:07,2012-02-02 08:19:28
e1327023ea22c3bf57e7d28596da356043f073fc...8f24a6323ece9be1bf1a04b4b5856112438337f2,1,23,119,142,22,2012-02-02 18:36:08,2012-02-02 08:19:37
8f24a6323ece9be1bf1a04b4b5856112438337f2...c876d6da88d9bf1f3377d4eed66fc7705e31c30e,3,3,4,7,4,2012-02-02 18:36:08,2012-02-02 08:20:10
c876d6da88d9bf1f3377d4eed66fc7705e31c30e...94ad9d9e075d3f7802cf56641ebb342d43fb46e3,2,20,6,26,6,2012-02-02 18:36:08,2012-02-02 08:20:43
94ad9d9e075d3f7802cf56641ebb342d43fb46e3...41b59bfcb16abb738e5c95c95fb462e717d47d4d,3,39,2,41,5,2012-02-02 18:36:08,2012-02-02 08:21:02
41b59bfcb16abb738e5c95c95fb462e717d47d4d...08265798e1ff6abc1b0aaff31c1471f83bd51425,1,3,3,6,2,2012-02-02 18:36:08,2012-02-02 08:21:11
08265798e1ff6abc1b0aaff31c1471f83bd51425...9dd5245c1043dd18fd7b3f44b9e51eef7e4b58d8,1,6,4,10,4,2012-02-02 18:36:08,2012-02-02 08:24:28
828ea97de486c1693d6e4f2c7347acb50235a85d...be39de2b262bfcd440ed81b4de33711eb8a37cf4,1,3,3,6,3,2012-02-01 23:46:24,2012-02-01 17:20:30
be39de2b262bfcd440ed81b4de33711eb8a37cf4...8a5b749428d39a0e85fb0f76306b88945cb5c6e0,1,21,11,32,3,2012-02-02 02:09:17,2012-02-02 02:02:23
828ea97de486c1693d6e4f2c7347acb50235a85d...95099731bf2c79ccf5870655e36caa4215f0ced0,1,35,26,61,4,2012-02-01 22:12:41,2012-02-01 13:48:54
95099731bf2c79ccf5870655e36caa4215f0ced0...c01f51cc750dbd76e50919bf4e3b94e1b47d2e23,1,13,14,27,6,2012-02-01 22:12:42,2012-02-01 13:48:55
828ea97de486c1693d6e4f2c7347acb50235a85d...6a301345a545ce5faf1a054d6c9bf1558dd46b0d,2,5,1,6,2,2012-02-01 21:03:46,2012-02-01 15:17:18
6a301345a545ce5faf1a054d6c9bf1558dd46b0d...3a2ec52e99deabbf000cb576ccde73a12934bf60,2,5,14,19,3,2012-02-01 21:04:11,2012-02-01 15:17:19
3a2ec52e99deabbf000cb576ccde73a12934bf60...99fb6e04cb6e2789378968ec9903cc1e6e103d1d,1,139,176,315,10,2012-02-01 21:05:00,2012-02-01 15:17:20
828ea97de486c1693d6e4f2c7347acb50235a85d...4c7cd177148c0ae018e1f1d1c037d296d50d3562,1,6,4,10,3,2012-02-01 20:52:33,2012-01-30 20:05:47
4c7cd177148c0ae018e1f1d1c037d296d50d3562...348a6589e016669a3cf2d71c612e32dde9ef6f27,1,6,1,7,3,2012-02-01 20:52:49,2012-01-30 20:06:38
348a6589e016669a3cf2d71c612e32dde9ef6f27...19d2d23998bba7c7f0ee87451ddbbf8906381939,1,25,6,31,9,2012-02-01 20:52:49,2012-01-30 20:07:37
19d2d23998bba7c7f0ee87451ddbbf8906381939...56efd9d2524694717adf5405fccad90e2791ebfa,1,4,2,6,2,2012-02-01 20:52:49,2012-01-30 20:09:00
56efd9d2524694717adf5405fccad90e2791ebfa...40efa22309458546a3ea861689034acf9fbf9d1a,1,14,0,14,2,2012-02-01 20:52:49,2012-01-30 20:09:43
40efa22309458546a3ea861689034acf9fbf9d1a...4426ba2919697d57ab8b6335ca63b2c14e4e6339,1,4,1,5,1,2012-02-01 20:52:50,2012-01-30 20:10:23
4426ba2919697d57ab8b6335ca63b2c14e4e6339...a1e1b2d77b9fc5866d12bf984214b15f1dccf4a8,2,28,6,34,4,2012-02-01 20:52:50,2012-01-31 00:20:54
a1e1b2d77b9fc5866d12bf984214b15f1dccf4a8...abc0c9d2d7312c4b153ba1b2b9cd8ba0696f1b04,1,13,5,18,3,2012-02-01 20:52:50,2012-01-31 00:20:55
828ea97de486c1693d6e4f2c7347acb50235a85d...f26af3fcbcbd27392b8c94b1e4eb6e671b2466ab,1,10,0,10,3,2012-01-31 20:04:38,2012-01-30 20:25:30
828ea97de486c1693d6e4f2c7347acb50235a85d...48c07d868419f1597e87dcb4743a0a9f5828daa9,1,1,1,2,1,2012-01-29 21:30:58,2012-01-29 12:55:33
9918285fb10d81af9021dae99c5f4de88ded497c...bcefed419aee75ff1c358dc0794c55b07d87dbc9,1,42,47,89,6,2010-07-12 06:14:17,2010-07-11 04:20:25
9918285fb10d81af9021dae99c5f4de88ded497c...5e5ffa091bc272f5034a8e3f2bf9fbb0bd79086c,1,1,1,2,1,2010-07-09 23:28:46,2010-07-09 20:27:49
9918285fb10d81af9021dae99c5f4de88ded497c...4ded69169b02f08eb3e097bdf068d3061c049e91,1,9,6,15,4,2010-07-09 00:00:09,2010-07-08 02:14:31
9918285fb10d81af9021dae99c5f4de88ded497c...08fd28bb08a33b419cb91935659635cd053c880b,1,1,1,2,1,2010-07-08 20:35:42,2010-07-08 19:16:35
08fd28bb08a33b419cb91935659635cd053c880b...4ecb79386d2f45f3b439b397ac4aa592e1f4e9c8,1,25,21,46,5,2010-07-08 20:57:53,2010-07-08 13:36:02
4ecb79386d2f45f3b439b397ac4aa592e1f4e9c8...e8344e866655cfae1f870d7e8d5046c1bdf08adf,7,17,18,35,18,2010-07-09 00:53:12,2010-07-08 01:16:06
e8344e866655cfae1f870d7e8d5046c1bdf08adf...e13f38a33ed181b937c85fd9adf6bce755f69d00,1,1,2,3,1,2010-07-09 01:09:14,2010-07-08 15:12:34
78db709ae59da26de76264b79df3a7dc4d87e65c...0bad611b1ebacf170976a10690bd0169f8d372bf,3,127,32,159,34,2010-07-07 16:48:21,2010-07-07 13:39:11
0bad611b1ebacf170976a10690bd0169f8d372bf...9ef6aeb09ffe0650ca86dca53de93fd85333b02d,4,58,14,72,20,2010-07-07 16:48:33,2010-07-07 13:39:12
9ef6aeb09ffe0650ca86dca53de93fd85333b02d...68d03e4a6e448aa557f52adef92595ac4d6cd4bd,4,291,9,300,10,2010-07-07 16:48:45,2010-07-07 13:39:13
78db709ae59da26de76264b79df3a7dc4d87e65c...0cc4da303641611e8d9cc431e7b4d3f1a6a0dc86,1,1,1,2,1,2010-07-07 16:13:17,2010-07-06 23:34:20
78db709ae59da26de76264b79df3a7dc4d87e65c...be7c6d467e8cc4104e1a15e8ff2d7b207624c685,2,38,0,38,3,2010-07-07 16:11:37,2010-07-06 23:29:19
74e42ce122bfcbd2e1a06395b80d6a4b44580148...64abcc48447a976884e74a1efd866a21e06ddeec,1,2,2,4,2,2010-06-18 15:49:03,2010-06-17 23:47:31
74e42ce122bfcbd2e1a06395b80d6a4b44580148...e0a9110176e3b17414b1b38fae8febd0791eaa0c,1,4,4,8,2,2010-06-14 03:18:23,2010-06-13 18:49:47
3499cb1ae7b97ce8f67879156e2014e31dd985b6...ad709ea985b527adb546f4c841fbd480f2c6bdfd,1,1,1,2,1,2010-06-13 17:03:04,2010-06-12 22:35:59
3499cb1ae7b97ce8f67879156e2014e31dd985b6...f69c501832ecd6880602c55565508e70c3a013d5,5,61,0,61,8,2010-06-12 16:39:06,2010-06-10 11:47:23
f69c501832ecd6880602c55565508e70c3a013d5...6d158cba282f22fa1548af1188f78042fed30aed,1,143,1,144,5,2010-06-24 17:02:45,2010-06-17 21:32:02
37d29e1051ef8406d21f8b284a659080fcfe3f72...573285e55265ccedab5507c47ebd4357f360093f,2,37,5,42,9,2010-06-18 16:41:29,2010-06-09 17:02:06
573285e55265ccedab5507c47ebd4357f360093f...e5fba602e59292c8c383a7a587897b5f7cbd5c78,3,40,8,48,11,2010-06-18 19:57:21,2010-06-15 15:50:28
e5fba602e59292c8c383a7a587897b5f7cbd5c78...34bb92eca4259b3db8cb9bfad5fcac4ff2be139b,1,70,0,70,1,2010-06-18 19:57:47,2010-06-09 17:02:09
34bb92eca4259b3db8cb9bfad5fcac4ff2be139b...9f77fe022425360dced8b1f19275852e89d2351c,1,8,2,10,3,2010-06-24 20:10:59,2010-06-24 12:56:55
e498257d650529812ffe1872b3cd62e2bd604287...490544b1282416a033dc25481db205248ac0bfc8,2,17,4,21,7,2010-05-28 22:02:50,2010-05-22 11:13:05
490544b1282416a033dc25481db205248ac0bfc8...ff9c0825cfb1840238b6019dddb52763ed96fc82,1,1,0,1,1,2010-05-28 22:05:53,2010-05-26 08:46:41
e498257d650529812ffe1872b3cd62e2bd604287...6d2f208c3dd39493f4d45ea67c55a1b7fe06626a,1,3,1,4,1,2010-05-27 14:12:07,2010-05-23 18:05:40
d28790dc31ca1bcdca7254a6b9381b6c84e91271...3beb4fc461e72f0b93ae233dcc1cece0046b8eb8,2,54,3,57,3,2011-08-17 23:51:49,2011-08-17 10:42:58
d28790dc31ca1bcdca7254a6b9381b6c84e91271...8b5900751a5f19257dc9570dd195aaac46528599,1,2,2,4,2,2011-07-19 20:43:34,2011-07-16 21:55:52
8b5900751a5f19257dc9570dd195aaac46528599...6e8e67f3071ecdc139f6a77f90afee50b5ec1664,1,2,0,2,1,2011-07-20 22:51:55,2011-07-16 18:23:51
6e8e67f3071ecdc139f6a77f90afee50b5ec1664...0dc310e8608c05f40be3390607f301ffc4284e6d,1,3,2,5,1,2011-07-21 19:54:55,2011-07-21 15:10:52
d28790dc31ca1bcdca7254a6b9381b6c84e91271...b5967f820c9774285ec4380e77d5356c3cd6eb99,8,13,13,26,11,2011-07-19 19:04:47,2011-07-19 17:21:47
d28790dc31ca1bcdca7254a6b9381b6c84e91271...63a995b657dab9c1021f56dfe17804d2ad07577e,1,11,14,25,4,2011-07-14 16:19:03,2011-07-12 16:28:34
d28790dc31ca1bcdca7254a6b9381b6c84e91271...5960bc9d63c2cd9dc7eb9d44f470d516579f1bd6,2,11,7,18,5,2011-07-14 05:03:12,2011-07-14 03:47:06
d28790dc31ca1bcdca7254a6b9381b6c84e91271...ff00b682f203eb39876b57404916b4c54b6032c6,3,18,2,20,3,2011-07-14 04:39:18,2011-07-14 04:36:29
d28790dc31ca1bcdca7254a6b9381b6c84e91271...823e0ded8a319425496967dcb284e7e3ce2b6c29,1,12,0,12,2,2011-07-08 15:59:44,2011-07-08 10:08:49
b792c067872a6b4ec6545dc4375a7084626cb0fa...afc1692fefe0dc357d9ff5353ab77d14b26d7ab9,1,16,0,16,1,2011-08-26 17:45:04,2011-08-26 14:05:11
afc1692fefe0dc357d9ff5353ab77d14b26d7ab9...c97eff5a95d57a9561b7c7429e7fcc5d0e3a7f5d,2,21,10,31,13,2011-08-29 05:47:41,2011-08-28 14:54:29
c97eff5a95d57a9561b7c7429e7fcc5d0e3a7f5d...171edcbb49df30bbe96cc7f7204549df22c1beee,2,10,5,15,10,2011-08-29 05:48:14,2011-08-28 14:54:30
171edcbb49df30bbe96cc7f7204549df22c1beee...cddd127b9afe3aa516aafdc38e9a8778f1340e0d,4,53,5,58,10,2011-08-29 05:56:05,2011-08-28 14:54:31
cddd127b9afe3aa516aafdc38e9a8778f1340e0d...d8d33736b53fb0bef68ca30a64bf7f9ecd872115,3,46,5,51,12,2011-08-29 05:58:00,2011-08-28 14:54:32
d8d33736b53fb0bef68ca30a64bf7f9ecd872115...7b787599e4f45784c36e82030d0f6bae72817bfc,3,10,7,17,6,2011-09-08 21:11:35,2011-09-08 21:09:50
7b787599e4f45784c36e82030d0f6bae72817bfc...376eb14a05f693378047eee36a10035c122f0261,1,25,25,50,20,2011-09-13 17:11:39,2011-09-13 16:13:58
740a8fc2249cf7d8b39ab50a25bbf86554158ae7...e622f41dcd97861796c7529712170f9eae07dc56,2,2,2,4,2,2011-09-20 00:41:49,2011-09-19 23:40:52
740a8fc2249cf7d8b39ab50a25bbf86554158ae7...5347a50fec066845e5dfa34a53cbec1ea347641d,1,1,3,4,1,2011-09-15 23:58:55,2011-09-01 21:53:07
826603d11813e56452dca52c9509e7a3d6a9b900...b4fc8d6ac638723e4f4452752f8fb41efe1ec356,1,129,30,159,3,2011-08-30 04:25:57,2011-08-30 03:56:08
b4fc8d6ac638723e4f4452752f8fb41efe1ec356...960e3114963dbb290c12f7a4d19c5776584d43ff,1,21,1,22,2,2011-09-01 22:51:48,2011-09-01 16:49:37
960e3114963dbb290c12f7a4d19c5776584d43ff...9609dc9ddcb1a79112eb45c88244cdbb622bd5bc,3,45,0,45,3,2011-09-01 22:52:02,2011-09-01 16:49:38
eac2d83247ea0a265d923518c26873bb12c33778...afe19ff7b55129d988e421ae1e0df4ec9659787a,2,69,0,69,8,2012-01-08 23:06:35,2012-01-07 11:42:43
eac2d83247ea0a265d923518c26873bb12c33778...f47182c852601c045f62bd7f669360a920516311,4,38,13,51,14,2012-01-08 22:26:28,2012-01-08 21:06:19
f47182c852601c045f62bd7f669360a920516311...c207e34f7733df04342e1c0f449f6d3cae501e33,5,40,6,46,14,2012-01-08 22:27:28,2012-01-08 21:06:20
c207e34f7733df04342e1c0f449f6d3cae501e33...d336572f57e398318a0f6c51cc760d5be9872cc2,1,1,1,2,2,2012-01-08 22:27:29,2012-01-08 21:06:21
8daff716ad6caee55e04e5550137cd3bd83b9822...b6555d731e0828c356247a7836bdbd6e31c7a639,3,17,2,19,7,2012-05-11 18:25:28,2012-05-11 18:25:28
0364bb135e285d4118b69979ade3078fab50e08a...12a29b1a50d47594eb3a29003e3f1eb540580aaa,2,568,549,1117,3,2012-02-17 16:11:29,2012-02-17 10:25:08
12a29b1a50d47594eb3a29003e3f1eb540580aaa...342e9ef2d9ecc802191ef62a51f4e7db2ede41b1,12,774,5,779,21,2012-02-17 16:21:22,2012-02-17 10:25:09
342e9ef2d9ecc802191ef62a51f4e7db2ede41b1...134593c8ca1866bfbb0c63506f350ce9868fd7e5,1,23,0,23,1,2012-02-17 16:21:34,2012-02-17 10:25:10
0364bb135e285d4118b69979ade3078fab50e08a...36daaaca0046542f4d5576ad5766ac55f43e3fc3,3,92,14,106,14,2012-02-17 15:37:08,2012-02-17 01:19:03
a153adf683d2b6e22c7e892ed8a161b140156186...2eb10ac7b51c8bb2257e5e2dea85929675de3fd1,1,2,1,3,1,2006-10-24 21:38:46,2006-10-24 20:00:37
2eb10ac7b51c8bb2257e5e2dea85929675de3fd1...9ffd652a385298f3565fdc3f0d0424001a376539,1,6,3,9,2,2006-10-24 22:15:51,2006-10-24 09:50:37
9ffd652a385298f3565fdc3f0d0424001a376539...04d24455ceb0129195f60af6b62981542433ecf7,1,5,0,5,1,2006-10-24 22:16:38,2006-10-24 08:29:27
04d24455ceb0129195f60af6b62981542433ecf7...a4e3bddc760c19321b00b2a660c02af9d2e97d0d,1,6,6,12,3,2006-10-25 07:58:33,2006-10-25 06:55:46
a4e3bddc760c19321b00b2a660c02af9d2e97d0d...ddaf73141c03aeaab5e8cf5fadaf8b7ebad7955b,1,2,1,3,2,2006-10-25 18:26:48,2006-10-25 10:03:06
ddaf73141c03aeaab5e8cf5fadaf8b7ebad7955b...d47107d8104167dfe65c1743e81fa670b33f7870,1,3,0,3,1,2006-10-25 18:33:08,2006-10-25 18:33:08
d47107d8104167dfe65c1743e81fa670b33f7870...6e7d76baee08d0cd131d443c347c8a4bcd1004db,2,5,4,9,2,2006-10-25 19:56:37,2006-10-25 06:14:30
6e7d76baee08d0cd131d443c347c8a4bcd1004db...70da769a4607dbbc4efc490287ead98175cf622b,1,1,2,3,1,2006-10-25 19:57:33,2006-10-25 00:28:55
887a612fef942dd3e7dae452e2dc582738b0fb41...367dce2a5b80da055a0d776fe830e6f19b81bd1d,1,27,2,29,3,2006-10-28 20:36:39,2006-10-28 12:12:20
367dce2a5b80da055a0d776fe830e6f19b81bd1d...ba7545adab83e6bea43353937eabb467bcb7d4f7,1,5,1,6,1,2006-10-28 21:23:34,2006-10-28 17:30:05
ba7545adab83e6bea43353937eabb467bcb7d4f7...1dc5e55f2d2cab9ca24dc435dc2bc4f466f15ade,2,5,2,7,3,2006-10-28 21:25:41,2006-10-28 21:25:41
1dc5e55f2d2cab9ca24dc435dc2bc4f466f15ade...c60c56cc70dbf2acb4d15e3ea4f95d09020acc82,1,18,18,36,2,2006-10-28 21:26:00,2006-10-28 17:43:40
c60c56cc70dbf2acb4d15e3ea4f95d09020acc82...151602df00b8e5c5b4a8193f59a94b85f9b5aebc,1,45,4,49,2,2006-10-28 21:26:00,2006-10-22 22:37:56
151602df00b8e5c5b4a8193f59a94b85f9b5aebc...ce4231ffa80da1888a668cc7c33f5349800ab4a3,2,2,2,4,2,2006-10-29 20:36:27,2006-10-29 20:09:40
ce4231ffa80da1888a668cc7c33f5349800ab4a3...b1f33d626501c3e080b324e182f1da76f49b5bf9,1,182,182,364,2,2006-10-29 20:36:40,2006-10-29 20:09:48
b1f33d626501c3e080b324e182f1da76f49b5bf9...9c572b21dd090a1e5c5bb397053bf8043ffe7fb4,1,5,2,7,1,2006-10-29 20:41:38,2006-10-29 19:31:38
9c572b21dd090a1e5c5bb397053bf8043ffe7fb4...6dcfa306f2b67b733a7eb2d7ded1bc9987809edb,2,8,3,11,2,2006-10-29 20:45:23,2006-10-29 19:31:39
887a612fef942dd3e7dae452e2dc582738b0fb41...ed93b449c5e13a70beb7f0ae02fb6da95e42a805,3,69,4,73,6,2006-10-28 00:16:39,2006-10-09 05:48:06
ed93b449c5e13a70beb7f0ae02fb6da95e42a805...9926ba98a4a77e012ea9121abee42608fe1564b6,1,1,1,2,1,2006-10-28 00:16:40,2006-10-23 07:36:22
9926ba98a4a77e012ea9121abee42608fe1564b6...9fe0d87da36ce4a61359a4d5c2ea2547e29b4d04,1,13,12,25,4,2006-10-28 00:16:40,2006-10-23 07:46:15
9fe0d87da36ce4a61359a4d5c2ea2547e29b4d04...65ac6e9c3f47807cb603af07a6a9e1a43bc119ae,1,20,21,41,13,2006-10-28 00:16:40,2006-10-27 21:08:14
65ac6e9c3f47807cb603af07a6a9e1a43bc119ae...5b329a5f5e3625cdc204e3d274c89646816f384c,1,142,23,165,26,2006-10-28 00:16:40,2006-10-27 23:07:02
2a54323ce5241992c272c90ebf2be14eaac873eb...e267c2f6f0784e242883b7d3fe5f36ef63d6950d,1,1,1,2,1,2006-11-15 06:11:26,2006-11-15 06:11:26
65cdb5f1658c4911b3f17a2e99332e5397c52240...f59a59e22f0005d799fe1d40e0c1f7e5c1f68b76,3,177,7,184,9,2006-08-10 22:28:57,2006-07-28 21:56:15
c8769f76d992ed391d169cd71be009ca17727271...a69a165fb43c88ab5c2adc2fe33b065ff537177c,1,11,14,25,5,2006-08-12 06:55:21,2006-08-12 06:21:41
c8769f76d992ed391d169cd71be009ca17727271...0d042fecf2f4130717d198f9cc2d792e72370bda,3,85,13,98,23,2006-08-12 02:08:10,2006-08-11 07:44:42
b578e509d3d346513efda14606886a55174e5181...c5c3fc9851e6c89f8616729552d9b8a8dfea5555,1,1,1,2,1,2007-02-12 06:03:55,2007-02-12 06:03:55
c5c3fc9851e6c89f8616729552d9b8a8dfea5555...2092a1fefdacf9839332202fa62165e2ac91c899,2,6,8,14,4,2007-02-12 06:05:36,2007-02-12 06:05:36
2092a1fefdacf9839332202fa62165e2ac91c899...4853534e180c237331cb8395fe87ff6e09bbcf21,1,131,0,131,1,2007-02-12 06:29:12,2007-02-12 06:29:12
8ebe185bbf3f1f4f59bcc61e3d1849a76f6af983...3a9f1a55eec9cc508abccda6a3fee795b812d66d,1,5,0,5,1,2006-12-06 17:52:57,2006-12-06 12:27:40
3a9f1a55eec9cc508abccda6a3fee795b812d66d...4003a58e415e5f51a3becac0079505b72299a7bc,1,12,7,19,4,2006-12-06 17:53:33,2006-12-06 17:19:50
8ebe185bbf3f1f4f59bcc61e3d1849a76f6af983...c976d415e5352886f0650f8e2edba81866c38587,5,250,26,276,17,2006-12-06 07:50:57,2006-11-28 14:47:40
8ebe185bbf3f1f4f59bcc61e3d1849a76f6af983...f8a9d4287277ed15d3f0d61004f4510c59f1f392,6,119,15,134,24,2006-12-06 07:25:52,2006-12-05 00:00:46
f8a9d4287277ed15d3f0d61004f4510c59f1f392...1127148089234a6f84754f2f0ec36cbbcae06fa9,2,4,3,7,3,2006-12-06 07:25:52,2006-12-05 00:07:57
1127148089234a6f84754f2f0ec36cbbcae06fa9...22f741dab7cc93f00f7cf96cd65d7481677cd855,2,16,2,18,3,2006-12-06 07:44:23,2006-12-06 07:44:23
02c9e93547d4c21635beb30895ebb6e37f67833c...5d7eeee2ac64e277e47ce2cdabd1af0d2501a96f,3,115,9,124,9,2006-12-14 10:56:24,2006-12-14 10:31:05
02c9e93547d4c21635beb30895ebb6e37f67833c...4da9028578ffaaf8985e1436e2e1cf16bd3b9023,1,6,0,6,2,2006-12-14 10:45:51,2006-12-14 08:36:23
4da9028578ffaaf8985e1436e2e1cf16bd3b9023...a81c311f23a5fadd6c1da38d46781644cd9db6e8,1,7,0,7,2,2006-12-14 10:45:51,2006-12-14 08:40:15
a81c311f23a5fadd6c1da38d46781644cd9db6e8...2ce633b928f78224a37308f45810e76fefe8df56,1,47,22,69,3,2006-12-14 10:45:51,2006-12-14 09:19:19
54851157acf707eb953eada2a84830897dde5c1d...93b0d86aafdd3e00de2c3c6ebb3c109b4571e1c4,1,5,0,5,1,2006-12-20 21:41:00,2006-12-20 21:06:46
93b0d86aafdd3e00de2c3c6ebb3c109b4571e1c4...1d182bd5f4ec17f2f44ac0ee0d1bf6a25e98761e,1,1,1,2,1,2006-12-20 21:45:55,2006-12-20 21:45:55
54851157acf707eb953eada2a84830897dde5c1d...d5db6c9ee79cfa1794d75847b8376430f08b203f,4,89,14,103,10,2006-12-20 19:26:11,2006-12-20 02:25:32
5fed4668153c9ca6e44ec84a0976089f515705aa...75c384efb52d0e3eb1e8c2f53668b4066fe6a8d6,2,3,5,8,3,2006-12-19 09:50:37,2006-12-19 09:50:37
75c384efb52d0e3eb1e8c2f53668b4066fe6a8d6...d4ebc36c5ee964592303c59260417b758d024c31,6,16,12,28,13,2006-12-19 09:51:51,2006-12-19 09:28:15
d4ebc36c5ee964592303c59260417b758d024c31...4363dfbe3d2f3fe3a4bd0fa7e9b22a14532c6cdb,2,4,10,14,4,2006-12-19 09:53:02,2006-12-19 00:39:07
4083c2fce86c777415a3bc0d5813bcb73f676f98...d677db86d9fa98b063846ed461312eb04fe23ba5,1,1,1,2,1,2007-01-08 22:45:54,2007-01-08 11:45:44
d677db86d9fa98b063846ed461312eb04fe23ba5...521f9c4def9430526bfdfffdb8ed4c2f4166bece,1,1,1,2,1,2007-01-08 22:45:59,2007-01-08 19:23:13
521f9c4def9430526bfdfffdb8ed4c2f4166bece...d84029b6738197fa409861597934b29bbebad262,2,21,6,27,5,2007-01-08 22:45:59,2007-01-08 21:59:15
d84029b6738197fa409861597934b29bbebad262...0f018baba654347b5ce746253b99d59707f80184,3,13,7,20,7,2007-01-08 22:46:00,2007-01-08 22:40:33
0f018baba654347b5ce746253b99d59707f80184...e08140568a131bcd26e64a0bc8188040847be998,4,48,35,83,13,2007-01-08 23:44:47,2007-01-08 15:57:52
e08140568a131bcd26e64a0bc8188040847be998...93d26e4cb9cec2eb8abb4f37e6dda2c86fcceeac,17,57,39,96,29,2007-01-08 23:44:47,2007-01-08 15:58:08
93d26e4cb9cec2eb8abb4f37e6dda2c86fcceeac...93822c2239a336e5cb583549071c59202ef6c5b2,20,74,89,163,41,2007-01-08 23:44:47,2007-01-08 15:58:23
93822c2239a336e5cb583549071c59202ef6c5b2...480c9e521bdc0b6f7e90d3901d4ffc1f57f57a5e,1,77,29,106,19,2007-01-08 23:44:47,2007-01-08 15:58:38
4083c2fce86c777415a3bc0d5813bcb73f676f98...bda324cf6158672b91a478036731d332c1a14cac,1,11,2,13,2,2007-01-08 11:02:10,2007-01-03 09:09:34
bda324cf6158672b91a478036731d332c1a14cac...0016a48251abefed11efc919703d980a21c95f2c,1,24,7,31,6,2007-01-08 11:02:11,2007-01-03 20:10:10
0016a48251abefed11efc919703d980a21c95f2c...c847f537125ceab3425205721fdaaa834e6d8a83,5,50,23,73,17,2007-01-08 11:02:11,2007-01-02 07:31:08
c847f537125ceab3425205721fdaaa834e6d8a83...648861040f2c5fd001a5edcfbb05813505bbb8f1,1,8,3,11,3,2007-01-08 11:02:11,2007-01-08 10:19:38
648861040f2c5fd001a5edcfbb05813505bbb8f1...73c838e4c9437a0c41082c32a3a832aa385460a9,1,12,9,21,5,2007-01-08 11:02:11,2007-01-08 10:08:47
73c838e4c9437a0c41082c32a3a832aa385460a9...ead80606d47ed94aad958ee660f62cde00bb6018,1,18,0,18,2,2007-01-08 11:02:11,2007-01-08 10:42:30
ead80606d47ed94aad958ee660f62cde00bb6018...8d78b5af2376be533ed11b53b292bdf0f2e6173b,2,2,2,4,2,2007-01-08 11:02:11,2007-01-08 10:44:55
8d78b5af2376be533ed11b53b292bdf0f2e6173b...75b364dfe28cf1700ac4f519ff7d3e42505e17a6,1,7,7,14,2,2007-01-10 01:44:59,2007-01-10 01:37:50
75b364dfe28cf1700ac4f519ff7d3e42505e17a6...bfbbb8f8cf8250718ffd028efe179557d29ae72d,1,25,11,36,5,2007-01-10 04:40:39,2007-01-10 04:39:09
e861ce1692fa9809f3e7b898804f8ddaf7cd8975...80dbae03b010b1e5c6e0e4f475578d6cadaadecf,1,67,11,78,11,2007-01-12 02:05:53,2007-01-10 11:39:47
80dbae03b010b1e5c6e0e4f475578d6cadaadecf...94d23673e37160ee99ec1b1cd23ff3b7a79f7226,2,6,3,9,6,2007-01-12 02:05:53,2007-01-11 06:36:16
94d23673e37160ee99ec1b1cd23ff3b7a79f7226...ba70de01bb0c8a08135b63ace183bd3f4b149d9e,1,1,1,2,1,2007-01-12 02:22:48,2007-01-12 02:22:48
ba70de01bb0c8a08135b63ace183bd3f4b149d9e...9bbaa6cc6848b68b8bef681c2a22b57bbec3e914,1,12,6,18,3,2007-01-12 03:56:43,2007-01-12 03:56:43
9bbaa6cc6848b68b8bef681c2a22b57bbec3e914...d34cf19b8987ae0f0806e257edf877238d044747,2,4,36,40,4,2007-01-12 05:02:58,2007-01-12 04:23:00
d34cf19b8987ae0f0806e257edf877238d044747...4494c656e2e29c468c48c9c2b20595342056e9dc,1,8,14,22,4,2007-01-12 05:05:34,2007-01-12 04:37:38
4494c656e2e29c468c48c9c2b20595342056e9dc...fc41be3b2e2eb2135e560077fc705dab7aade5f0,1,2,6,8,1,2007-01-12 08:09:07,2007-01-12 07:49:35
fc41be3b2e2eb2135e560077fc705dab7aade5f0...397dfe67c71fdd673bb108b9c6103e4a5e750edb,1,2,1,3,1,2007-01-12 08:13:34,2007-01-12 06:45:38
397dfe67c71fdd673bb108b9c6103e4a5e750edb...1cf716a21901e0e91db0510d18b212f34cea9e41,1,3,6,9,2,2007-01-12 20:05:58,2007-01-12 20:05:58
1cf716a21901e0e91db0510d18b212f34cea9e41...120b0dfbed148461c4e1349d12a1b7913545260e,1,5,1,6,1,2007-01-12 20:26:39,2007-01-12 20:24:16
120b0dfbed148461c4e1349d12a1b7913545260e...5c94f87e6b17cab5d3b87998d6c907745cb6f5a4,29,42,45,87,41,2007-01-12 21:36:16,2007-01-12 21:01:46
5c94f87e6b17cab5d3b87998d6c907745cb6f5a4...f215f27013e785ac11bf1190d0c03ba870faf080,1,1,1,2,1,2007-01-12 22:13:53,2007-01-12 22:13:53
f215f27013e785ac11bf1190d0c03ba870faf080...b60daf0515889ca75f88f1d4d49a6a9c4117ba36,3,22,9,31,12,2007-01-12 23:10:29,2007-01-12 23:00:13
13e86efbeae5994a85cc482b3964db7298c5c6ea...d19fbc3c171aa71a79b2ff0b654e3064c91628b8,4,1774,1,1775,5,2007-01-08 01:33:06,2007-01-08 00:23:49
d19fbc3c171aa71a79b2ff0b654e3064c91628b8...6bd9b6822f7647cb3275cf151ca92c6d6e9423aa,1,28,3,31,3,2007-01-08 03:58:14,2007-01-08 03:58:14
6bd9b6822f7647cb3275cf151ca92c6d6e9423aa...4c63ff452ff04cd13819bf05f30e0df55b50510f,1,157,4,161,4,2007-01-08 04:57:41,2007-01-08 04:57:41
4c63ff452ff04cd13819bf05f30e0df55b50510f...e9c0390a9251714f4f4b54b4e3dddb2e65d18fa8,1,16,1,17,2,2007-01-09 02:59:42,2007-01-09 02:59:42
e9c0390a9251714f4f4b54b4e3dddb2e65d18fa8...b684f830cc071c99ede9861c84e3b1e54549f6c7,1,123,120,243,18,2007-01-09 04:42:36,2007-01-09 04:42:36
b684f830cc071c99ede9861c84e3b1e54549f6c7...d5cd5de495654ec2454e8c37829c5e1c9f49b66a,1,54,14,68,7,2007-01-09 05:18:09,2007-01-09 05:18:09
d5cd5de495654ec2454e8c37829c5e1c9f49b66a...aec053bb0a1fb000622f51df22b2f18553a10efd,1,57,2,59,4,2007-01-11 04:17:00,2007-01-11 04:17:00
aec053bb0a1fb000622f51df22b2f18553a10efd...eb6ae7f4ad565d56501e9e20a8bac5c579d50f84,1,26,10,36,11,2007-01-11 04:18:08,2007-01-11 02:11:53
eb6ae7f4ad565d56501e9e20a8bac5c579d50f84...01997b4a256ed7ef96ede527a92eeeecc243a927,1,10,23,33,3,2007-01-11 04:23:37,2007-01-11 04:23:37
01997b4a256ed7ef96ede527a92eeeecc243a927...f1d2b47794bc0425f817b9015ad738f2cfb7f3f3,1,2,2,4,2,2007-01-11 17:44:08,2007-01-11 17:44:08
f1d2b47794bc0425f817b9015ad738f2cfb7f3f3...69f7ad730a21eb7e8aeb22b2ee76856dff2b7bd2,1,22,9,31,3,2007-01-14 21:29:40,2007-01-14 21:29:40
13e86efbeae5994a85cc482b3964db7298c5c6ea...e9c8409900fc84cd7721117c98dfe01acd535aa2,4,15,8,23,8,2007-01-07 06:57:42,2007-01-05 09:25:18
e9c8409900fc84cd7721117c98dfe01acd535aa2...bc8c0294c6ab673e465a8b564e22b1b9c2a2ea50,1,4,2,6,1,2007-01-07 06:57:42,2007-01-05 09:38:56
13e86efbeae5994a85cc482b3964db7298c5c6ea...24304816141d16aacdc63612797faa1426222ef7,1,18,15,33,17,2007-01-07 06:57:34,2007-01-06 10:16:10
24304816141d16aacdc63612797faa1426222ef7...ca4f293fb492efdd2b984b992796b075c30e230d,1,9,2,11,4,2007-01-07 06:57:34,2007-01-06 10:16:14
ca4f293fb492efdd2b984b992796b075c30e230d...94421474e068c2f0a7bef3d658216a0f1e75b906,4,208,193,401,9,2007-01-07 06:57:34,2007-01-06 10:16:17
94421474e068c2f0a7bef3d658216a0f1e75b906...1389d9ddaa68a4cbf5018d88f971b9bbb7aaa3c9,2,314,21,335,19,2007-01-07 06:57:34,2007-01-06 10:16:19
1389d9ddaa68a4cbf5018d88f971b9bbb7aaa3c9...cd1f9c36beeafd3dea4672494a98e1ed39ae63f1,1,54,23,77,12,2007-01-07 06:57:34,2007-01-07 06:32:41
fa2376f3c89ae59f33e50e0e5769dec2652e9568...c53d696bcc2894b0df277e617740b15bac794df9,1,9,1,10,2,2006-12-13 01:26:23,2006-12-13 00:45:00
9e4f522da7da8bf5f9018927c82b12e6b02b9058...1509bd9e69b916ca7f04a89fc03662e03e2ba312,1,4,2,6,1,2006-02-25 01:27:46,2006-02-24 16:27:51
c8c4f220256eb6065e571793f4687c19eb7c6417...ec58db15a9e1d3377170c9839e509074a8202735,1,24,3,27,3,2006-03-02 05:41:58,2006-03-02 05:42:01
1c7fee5d0857d809fe5d93a1d56968e44296ce55...8588452ceb78b1da17652ba03f9942ef740e07ea,1,1,1,2,1,2006-03-05 08:57:01,2006-03-05 04:36:28
8588452ceb78b1da17652ba03f9942ef740e07ea...46444f514bf5a1df17885283634256a86fa11196,4,4,4,8,4,2006-03-05 08:57:37,2006-03-05 06:20:07
61e56c8823afd2c5a753a4969330ead0ba850c66...a970fcf249534ca21ad721b289402c135722a24c,1,14,0,14,3,2006-04-25 12:44:47,2006-04-18 21:53:07
1a17ee22a2fbd85a893ab36fd53168d03554c2dd...e6bfaf3e33beba9431490a4f5c7a9753986554c4,2,2,2,4,2,2006-04-17 03:42:37,2006-04-17 03:17:38
3ffe0c245f290d55b32bed8b4ae04d00983df690...ae5d8470f6b8e1abdef19bf033472c63fb72b735,1,23,1,24,2,2006-04-05 21:07:21,2006-04-05 20:28:28
ae5d8470f6b8e1abdef19bf033472c63fb72b735...6cbd5d7d79f5751828397558e7c3611b048565fb,1,5,4,9,4,2006-04-05 22:46:54,2006-04-05 22:25:17
098dd8a34b43ea1317527ca1a3354aae9f3704b5...b09344891010330dcdd26b90453e7e31c780612e,1,4,1,5,2,2006-05-14 23:56:08,2006-05-14 23:56:08
af8c28e145a3ba28515f3cb34bbcd345693b3480...5b766ea9014b4121cb72f424633b6bf9a97308a0,1,91,0,91,1,2006-02-12 13:02:42,2006-02-12 12:00:52
975b31dc6e12fba8f7b067ddbe32230995e05400...08337a97a2756cd89ab611444f37d67250d3c05b,1,5,2,7,3,2005-12-27 18:49:25,2005-12-27 08:19:05
08337a97a2756cd89ab611444f37d67250d3c05b...8eafa3da62297eb91741321281fd3fb2a4236e97,1,1,1,2,1,2005-12-27 19:08:57,2005-12-27 18:51:23
8eafa3da62297eb91741321281fd3fb2a4236e97...e9add360074068eac974c5a69f91ae78a30606e9,2,2,2,4,2,2005-12-27 19:08:57,2005-12-27 19:06:43
e9add360074068eac974c5a69f91ae78a30606e9...36cd2cc7d949e1cc39104307fe904c47fe6d5526,1,1,1,2,1,2005-12-27 19:52:51,2005-12-27 19:52:51
36de72aa9dc3b7daf8cf2770c840f39bb0d2ae70...908e5310b958619559d34b0b6da122f058faa47e,2,120,1,121,2,2005-12-28 01:57:27,2005-12-24 21:50:45
908e5310b958619559d34b0b6da122f058faa47e...635d413430d5419cfd0ac18e2318cf46c1984750,1,11,4,15,3,2005-12-28 01:57:27,2005-12-27 22:36:49
635d413430d5419cfd0ac18e2318cf46c1984750...4cdf78bf964912698ab33579977f21a3e0b832ed,1,2,1,3,1,2005-12-28 01:57:27,2005-12-27 22:49:22
4cdf78bf964912698ab33579977f21a3e0b832ed...2d9e7c9f908d0a025970a5592d47def3d77e77a9,1,27,6,33,7,2005-12-28 01:57:27,2005-12-27 22:40:17
2d9e7c9f908d0a025970a5592d47def3d77e77a9...64deb858b0c71f485d186e91cd00cf8b6ec64087,1,25,9,34,10,2005-12-28 01:57:27,2005-12-28 00:09:37
64deb858b0c71f485d186e91cd00cf8b6ec64087...c06818e20a88f58294de0a948a437c7c32c382fe,2,82,0,82,2,2005-12-28 01:57:28,2005-12-28 00:10:56
c06818e20a88f58294de0a948a437c7c32c382fe...9b88fcef7dd6327cc3aba3927e56fef6f6c4d628,3,34,5,39,7,2005-12-28 01:57:28,2005-12-27 22:40:17
9b88fcef7dd6327cc3aba3927e56fef6f6c4d628...cfee10a773be0f8d0024f2567164c910d4213244,3,148,39,187,48,2005-12-28 02:04:14,2005-12-26 07:18:37
a1c292958f9968565f4048a17196d99fd16fc7ca...14df4c41885ea19c9ce263111c6de994a4028601,1,3,2,5,3,2005-11-10 23:57:09,2005-11-10 19:03:08
14df4c41885ea19c9ce263111c6de994a4028601...ad7db62113368279a1b6994790bf30925fabea33,1,1,1,2,1,2005-11-10 23:57:21,2005-11-10 19:55:13
ad7db62113368279a1b6994790bf30925fabea33...66c9ec25553ce7332c46e2017b9c4d7c26310fff,3,4,2,6,3,2005-11-10 23:57:56,2005-11-10 13:12:19
66c9ec25553ce7332c46e2017b9c4d7c26310fff...605607cc622478fb2e8dfcab2ff16f54b0995599,1,1,1,2,1,2005-11-11 08:37:34,2005-11-11 01:46:20
605607cc622478fb2e8dfcab2ff16f54b0995599...e3e291fc07b49b74bb655ca854bdb19e849e044c,3,3,3,6,3,2005-11-11 08:37:34,2005-11-11 07:34:08
e3e291fc07b49b74bb655ca854bdb19e849e044c...ff56fe1ca7f43087fd84588af87179c2959d0cb3,2,31,7,38,7,2005-11-11 08:42:52,2005-11-10 06:15:27
ff56fe1ca7f43087fd84588af87179c2959d0cb3...17cf939724a244a56e687559fae062a3e6207145,1,20,5,25,5,2005-11-11 08:50:24,2005-11-10 06:37:14
17cf939724a244a56e687559fae062a3e6207145...601c978c1bc9f6742c18932cb9d4a6910934f785,2,12,2,14,5,2005-11-11 09:13:05,2005-11-10 05:30:12
601c978c1bc9f6742c18932cb9d4a6910934f785...0e9ab02da77fcf59fdb7d8201d3c5546cd346e63,1,2,2,4,2,2005-11-11 09:15:00,2005-11-11 05:19:04
0e9ab02da77fcf59fdb7d8201d3c5546cd346e63...f84f9d38ebd809ecab89d2d4926c3ff6bc3c60f5,1,5,0,5,1,2005-11-11 09:15:26,2005-11-11 05:00:57
f84f9d38ebd809ecab89d2d4926c3ff6bc3c60f5...0867b0125a7b0ed02c7850486393c56ae8a719e3,1,39,11,50,20,2005-11-11 09:24:31,2005-11-11 09:10:29
0867b0125a7b0ed02c7850486393c56ae8a719e3...0879aa28708dcdfa255fff631781e5178755498e,2,9,5,14,4,2005-11-11 09:34:26,2005-11-10 11:58:08
0879aa28708dcdfa255fff631781e5178755498e...7f10f7c4e4943fefbc8b8310d1d1d7753f5e3aff,1,2,1,3,1,2005-11-11 09:34:27,2005-11-10 11:58:08
7f10f7c4e4943fefbc8b8310d1d1d7753f5e3aff...592ee97d8fffa2318960074057e044709163abf7,1,1,1,2,1,2005-11-11 17:33:47,2005-11-11 17:31:38
60d64db4614b1007ca37c228923ec1964d5ad394...27dedf0c3b78d1072fb5449149421284f9e5297b,46,895,257,1152,146,2005-11-17 05:32:44,2005-11-17 05:32:44
4ae22d96fe9248dac4f26b1fc91154ba5e879799...f1a906a387a2155069e02b09c33dabd6d058ede5,1,20,6,26,5,2005-10-22 02:20:17,2005-10-21 19:06:10
f1a906a387a2155069e02b09c33dabd6d058ede5...f7eb290fa0620cebc033e80216c74ab9d1573a6c,1,29,16,45,15,2005-10-22 02:20:18,2005-10-21 19:06:20
f7eb290fa0620cebc033e80216c74ab9d1573a6c...7b9ae53ea3680f5b0d17a2dd40b39a17f1fcc5cf,1,13,2,15,4,2005-10-22 02:20:18,2005-10-21 19:06:27
7b9ae53ea3680f5b0d17a2dd40b39a17f1fcc5cf...05625af32e7b246fee0cecae933e5707496e4b24,1,1,1,2,1,2005-10-22 03:57:34,2005-10-22 03:57:34
05625af32e7b246fee0cecae933e5707496e4b24...6b32884a09e4b51e60819351200a5b10d9dc053b,1,2,2,4,1,2005-10-22 09:28:27,2005-10-22 09:28:27
6b32884a09e4b51e60819351200a5b10d9dc053b...4f692b19788364ed0bd65983579edcd6e5444f2b,1,17,11,28,7,2005-10-22 11:45:15,2005-10-22 11:45:15
4f692b19788364ed0bd65983579edcd6e5444f2b...ac1b3d1248f36b26c2eab55022b9a54bde36b1ee,5,317,269,586,19,2005-10-23 05:49:51,2005-10-21 04:05:05
ac1b3d1248f36b26c2eab55022b9a54bde36b1ee...cf4845441c3931731643859dc80a79e52bcd3e0f,1,125,4,129,11,2005-10-23 05:49:52,2005-10-21 04:25:09
cf4845441c3931731643859dc80a79e52bcd3e0f...1b9e059d3503f935bb3eebb073cfb0f0401e2adf,1,63,5,68,9,2005-10-23 05:49:52,2005-10-21 23:40:54
f51248eb482a7a0feacb04d02119c94d35845975...03feddd6e8e779086ac2d131ded325f8e5601653,6,103,38,141,12,2005-10-15 18:23:39,2005-10-14 01:57:39
03feddd6e8e779086ac2d131ded325f8e5601653...d8a1deecc6ef37728b951eaba051deb7e0a38af8,3,16,0,16,3,2005-10-15 18:23:39,2005-10-14 01:57:39
d8a1deecc6ef37728b951eaba051deb7e0a38af8...1a7141ff28e217312da4b289127875905c6ec479,6,12,6,18,7,2005-10-15 18:23:40,2005-10-14 01:57:40
1a7141ff28e217312da4b289127875905c6ec479...5385f52da80be0d01fda45be586eb186c2be83ee,1,83,0,83,4,2005-10-15 18:23:40,2005-10-14 01:57:40
5385f52da80be0d01fda45be586eb186c2be83ee...f6b42a81fd97a55dec0766685aac722a838a11a6,3,16,0,16,6,2005-10-15 18:23:41,2005-10-14 01:57:40
f6b42a81fd97a55dec0766685aac722a838a11a6...f5dce80611ed865d2d5d1e76c2c3ae64bf99fe99,1,17,15,32,13,2005-10-16 07:01:08,2005-10-16 07:01:08
f5dce80611ed865d2d5d1e76c2c3ae64bf99fe99...c09a69a83e3edcc634f17cdc7b4c71b91f3228ce,1,5,1,6,1,2005-10-16 07:24:34,2005-10-16 07:24:34
c09a69a83e3edcc634f17cdc7b4c71b91f3228ce...6abf5c0c6fb2ad9bb24444171d306262a8c8f4a2,1,1,0,1,1,2005-10-16 07:25:26,2005-10-16 07:25:26
82ed2bcd920d73d218e94c95178be6a61ec7ed54...c99ec048bf386ed2b28086cb3756af2dc91fc3d2,4,10,4,14,5,2005-10-18 04:52:10,2005-10-18 00:46:35
c99ec048bf386ed2b28086cb3756af2dc91fc3d2...844ac7f81874f7acf22a15ffd985048d930c8341,1,44,6,50,8,2005-10-19 06:52:08,2005-10-19 06:52:08
844ac7f81874f7acf22a15ffd985048d930c8341...e51fd86ab320a2b8457653ba06d9f4ce9e92b4b1,1,57,21,78,12,2005-10-19 07:01:01,2005-10-19 07:01:01
e51fd86ab320a2b8457653ba06d9f4ce9e92b4b1...0910e8cab828b53fd7188a93c0476cab0af81cdc,1,5,0,5,1,2005-10-19 07:01:01,2005-10-19 07:01:01
0910e8cab828b53fd7188a93c0476cab0af81cdc...acfcb8dfa451bf9701fdba72c7b6fb9b591a6890,1,62,2,64,6,2005-10-19 07:01:01,2005-10-19 07:01:01
acfcb8dfa451bf9701fdba72c7b6fb9b591a6890...750a09a7de63c92868cff41a3151eac320c77fa0,1,1,1,2,1,2005-10-19 07:01:02,2005-10-19 07:01:02
750a09a7de63c92868cff41a3151eac320c77fa0...c9ed27b9e8372822219780705128cf37bd25e26b,2,7,1,8,2,2005-10-19 09:31:27,2005-10-19 09:31:27
c9ed27b9e8372822219780705128cf37bd25e26b...b7080d851630606815a399a162c5b20f2907f9e0,2,59,7,66,19,2005-10-19 21:44:43,2005-10-19 21:44:43
b7080d851630606815a399a162c5b20f2907f9e0...147a1ab03599c21c9e5972739c460fd2635c0c02,1,1,1,2,1,2005-10-21 05:56:34,2005-10-21 01:34:58
18e410f1eaaf8e3e82dca9f124782b099ead7612...df73e9c62a9f0e6cdf20f095b99abf32c8e65c75,1,4,1,5,1,2005-10-12 04:57:04,2005-10-12 04:57:04
af61c6e008c39ee9f61af33bb48850230f503443...09d920831edba17fe983269a9d0d85e592dd4bb3,1,24,5,29,8,2005-09-21 09:47:16,2005-09-21 09:46:32
09d920831edba17fe983269a9d0d85e592dd4bb3...b163512d4eb36ee946908b682c7863658c5a8db4,1,5,3,8,2,2005-09-21 19:29:59,2005-09-21 19:29:59
af61c6e008c39ee9f61af33bb48850230f503443...d1c2e113c5b6bb580bb345fc9bc56e0b8712d070,2,23,2,25,3,2005-09-20 22:07:51,2005-09-19 10:10:14
d1c2e113c5b6bb580bb345fc9bc56e0b8712d070...a7154e916c6fab01dfb67629dae8c4430daff669,95,213,213,426,204,2005-09-20 22:07:52,2005-09-19 10:10:51
a7154e916c6fab01dfb67629dae8c4430daff669...f318dd229f9df88470de8541916d48c9380e2e35,2,12,2,14,3,2005-09-20 22:07:52,2005-09-19 18:33:14
f318dd229f9df88470de8541916d48c9380e2e35...e9bacb4f6a6f0aae7270acb257977f9ee0bbd6db,1,35,4,39,2,2005-09-20 22:07:52,2005-09-19 23:06:56
e9bacb4f6a6f0aae7270acb257977f9ee0bbd6db...1991b223c05d45d2a915842990b2a7c4819dcbcf,1,7,0,7,1,2005-09-20 22:07:53,2005-09-19 21:49:50
1991b223c05d45d2a915842990b2a7c4819dcbcf...b0391890d25d9e7ca8f7df2199292df68ead8093,6,140,78,218,25,2005-09-20 22:07:53,2005-09-19 22:11:15
b0391890d25d9e7ca8f7df2199292df68ead8093...2a39064c65e70a3e763c4dff5553cd2af3d10211,2,4,4,8,4,2005-09-20 22:07:54,2005-09-19 22:53:50
2a39064c65e70a3e763c4dff5553cd2af3d10211...89d844d084f14bc9506f63cd3c9aa44b21b49067,2,5,3,8,2,2005-09-20 22:07:54,2005-09-20 06:52:33
89d844d084f14bc9506f63cd3c9aa44b21b49067...f1f0d0889e5557bc467490fdbd53f7b912503a33,1,48,34,82,17,2005-09-20 22:07:55,2005-09-20 18:56:05
f1f0d0889e5557bc467490fdbd53f7b912503a33...7c6ef2f2142f0a4c22b5505d95553cac17867a21,4,308,12,320,7,2005-09-21 01:10:00,2005-09-20 16:27:13
7c6ef2f2142f0a4c22b5505d95553cac17867a21...c1babb1d65e034a058c14379eabec8eb374757ca,1,41,0,41,3,2005-09-21 01:10:32,2005-09-20 21:13:24
c1babb1d65e034a058c14379eabec8eb374757ca...27cfe2e2dcbfc4f6c6288ed4eafd077e232c2ab1,1,7,1,8,5,2005-09-21 01:11:34,2005-09-21 00:55:46
27cfe2e2dcbfc4f6c6288ed4eafd077e232c2ab1...f887564ab72e107bcdee3ba83c91e2bb4ae13ca7,1,33,7,40,3,2005-09-21 01:16:27,2005-09-17 06:38:59
f887564ab72e107bcdee3ba83c91e2bb4ae13ca7...63f1aa6c72c46928f1b6959437aed4becbc42ff3,2,86,11,97,7,2005-09-21 01:16:27,2005-09-19 07:03:47
63f1aa6c72c46928f1b6959437aed4becbc42ff3...6f60300b5408323f6b73b471b45e539fa49a6a76,1,103,1,104,2,2005-09-21 07:37:17,2005-09-21 01:21:10
6f60300b5408323f6b73b471b45e539fa49a6a76...28ad81f58ea25b915a400dab908f93373f9f63de,1,3,0,3,1,2005-09-21 08:11:32,2005-09-21 07:58:32
9f25c7bd5cf2bd6ae8e4775a4fd1a19f3eda10ea...089f20dce19711d34f5383ee289a9b1fbd3f3307,1,3,0,3,1,2005-09-21 07:58:32,2005-09-21 07:58:32
23d25e48f5ead73c9ce233986f90791abec9f1e8...7c15fe92acf267f7538d8f4bece33d6bc8409cd7,1,1,1,2,1,2014-03-27 22:01:42,2014-03-27 21:06:20
23d25e48f5ead73c9ce233986f90791abec9f1e8...893a9764dc5e6d5d3432a47f595ffffade1edd9c,2,11,2,13,3,2014-02-28 23:34:36,2014-02-28 22:41:11
23d25e48f5ead73c9ce233986f90791abec9f1e8...9937e65d8835ee6c026892de48f993d7a524a00f,1,10,0,10,1,2014-02-24 22:35:52,2014-01-26 20:45:16
07d406b742b577a39d7cbdacd76d0dde021ff788...48059e405028ebf8a09c5a9aede89dfb460cce98,1,1,9,10,1,2013-12-09 21:05:20,2013-12-08 12:47:25
48059e405028ebf8a09c5a9aede89dfb460cce98...ad8261d21221d27638c75f47b39892db6f7972f6,3,33,2,35,8,2013-12-10 18:56:30,2013-12-09 23:16:16
c8e1ee4f2c8e28b7eef824248f09ba37599593d7...7ac92f64ddb735052993640d26aad4cd7886b183,1,1,1,2,1,2014-09-11 17:38:02,2014-09-11 15:19:51
be961c292f1d36097afa1690df68cf90f655c855...3bb486e4397415e1855e5edbf28d8e50c3d45265,8,1,8,9,8,2014-02-10 18:20:45,2014-02-10 14:39:48
be961c292f1d36097afa1690df68cf90f655c855...b4b313f94ab06fabe78fa91b3f2ebbc7ef08b012,5,50,15,65,15,2014-02-06 00:44:51,2014-02-04 02:20:09
be961c292f1d36097afa1690df68cf90f655c855...791303284cb3ede61729e33112d6923df406161f,1,4,8,12,1,2014-02-05 18:48:14,2014-02-05 16:57:09
791303284cb3ede61729e33112d6923df406161f...0b707c3319f37f2ec3700638d62f3199af40c138,1,1,14,15,1,2014-02-05 18:49:07,2014-02-05 16:57:10
0b707c3319f37f2ec3700638d62f3199af40c138...7bc4ec01dde22be0156d64ef77db7364a11cb859,1,2,24,26,5,2014-02-05 18:50:36,2014-02-05 16:57:11
7bc4ec01dde22be0156d64ef77db7364a11cb859...6275c91c08f16f9d9aefea39ab7dab8560f50512,1,1,11,12,3,2014-02-05 18:51:16,2014-02-05 16:57:12
6275c91c08f16f9d9aefea39ab7dab8560f50512...7146e66f0861c720f9b32dc9d80ab80495a33e43,2,2,2,4,2,2014-02-24 22:43:29,2014-02-06 11:36:31
be961c292f1d36097afa1690df68cf90f655c855...d57b24b60b30ba6aa3fb3448fb784841b97265ef,1,17,12,29,12,2014-02-01 00:07:02,2014-02-01 00:07:02
e6aaa393478bf3ee9f4cde8d82cd258c034cd335...eeff891ac756fd97a05476446f15269b714ce4cc,1,1,1,2,1,2014-10-07 18:08:06,2014-10-04 16:27:16
e6aaa393478bf3ee9f4cde8d82cd258c034cd335...eb6c403500dd0b0d78b7b00d7ed0bf6b5daccc4e,1,14,13,27,2,2014-10-01 20:34:53,2014-10-01 10:16:17
eb6c403500dd0b0d78b7b00d7ed0bf6b5daccc4e...9d1b9aa9e10da398f430bc619b361d83bee6df7d,1,1,1,2,1,2014-10-01 20:34:54,2014-10-01 10:18:15
9d1b9aa9e10da398f430bc619b361d83bee6df7d...107efbeb2409ac3fb01560a42067c8cc506aa249,1,0,4,4,2,2014-10-01 20:34:56,2014-10-01 10:21:57
e6aaa393478bf3ee9f4cde8d82cd258c034cd335...8c3419bdbd5b49892c28ef32af80e0d570e5d7a5,1,1,0,1,1,2014-09-22 19:46:15,2014-09-21 20:38:17
e6aaa393478bf3ee9f4cde8d82cd258c034cd335...634c42da2282cfc718c72da85efff870cfe5f253,1,1,1,2,1,2014-09-22 19:42:24,2014-09-21 15:02:57
e6aaa393478bf3ee9f4cde8d82cd258c034cd335...d07235a027e0c7ed2fee1aeb3bee8a858bf5ca58,4,12,7,19,4,2014-09-08 18:26:45,2014-09-07 07:03:32
d07235a027e0c7ed2fee1aeb3bee8a858bf5ca58...415792edf51b2f87a58a942016a24a2e86a4218b,3,6,13,19,5,2014-09-08 18:26:48,2014-09-07 07:06:42
e6aaa393478bf3ee9f4cde8d82cd258c034cd335...ab791dd1383536405b8c68ffcf84246b3b0a9812,1,31,2,33,7,2014-08-29 21:50:43,2014-08-29 20:57:47
e6aaa393478bf3ee9f4cde8d82cd258c034cd335...0ecd180a27eab7c576feddc6f2be0626a1e0630b,1,2,10,12,1,2014-08-13 17:32:08,2014-08-12 23:59:31
0ecd180a27eab7c576feddc6f2be0626a1e0630b...6c1db1b38886f70165cb9f5822b1a2e99a2c331b,1,4,8,12,4,2014-08-13 17:32:12,2014-08-13 00:00:45
6c1db1b38886f70165cb9f5822b1a2e99a2c331b...6a143aa2b23b97fa8363e2f4fd16f23b4c5b104d,2,23,5,28,6,2014-08-25 22:17:34,2014-08-13 00:03:18
e6aaa393478bf3ee9f4cde8d82cd258c034cd335...13b081257a6c996e6c62316be1d1a6f615514ed2,1,6,11,17,3,2014-08-13 16:50:58,2014-08-12 21:21:27
e6aaa393478bf3ee9f4cde8d82cd258c034cd335...201087422d3c7ed5550f1cc15c8713a6605dd8b5,1,1,1,2,1,2014-08-12 18:01:44,2014-08-10 21:33:25
e6aaa393478bf3ee9f4cde8d82cd258c034cd335...2c8544ab91812c264666c9feb335ce3091fa29c1,2,6,3,9,2,2014-08-07 22:35:25,2014-08-02 08:39:06
e6aaa393478bf3ee9f4cde8d82cd258c034cd335...a127b3f24d3a4f97fe53a3495d615a29b7ab8737,1,3,4,7,3,2014-08-05 18:51:37,2014-08-05 02:56:50
e6aaa393478bf3ee9f4cde8d82cd258c034cd335...a789ca70e7a5b02973b116d21674acd795238f99,3,26,2,28,7,2014-08-05 17:09:17,2014-08-04 22:40:19
e6aaa393478bf3ee9f4cde8d82cd258c034cd335...10f343ea814f5c18a0913997904ee11cd9b7da24,2,7,2,9,3,2014-08-04 18:39:11,2014-08-03 03:02:03
e6aaa393478bf3ee9f4cde8d82cd258c034cd335...2147fa7e19befc10fd21032786b87cdca817b57c,1,1,1,2,1,2014-07-31 17:17:37,2014-07-31 15:06:28
cd989a97ec5bdb612693fbbed98b7adeb52a83a0...405869d0d5e5c943af08c0a0b32989843b001b66,1,1,1,2,1,2014-07-23 18:26:52,2014-07-23 12:32:09
405869d0d5e5c943af08c0a0b32989843b001b66...98b12a4b9ab319be5bd3dcd003069e8720b8e7a5,1,1,0,1,1,2014-07-23 18:27:05,2014-07-23 12:32:10
98b12a4b9ab319be5bd3dcd003069e8720b8e7a5...740c281d21ef5b27f6f1b942a4f2fc20f51e8c7e,4,21,3,24,5,2014-07-23 18:33:16,2014-07-23 18:33:16
d9037eae7e67680016b92e2113e4ab4878660345...fb46e0c54535d009b173a1c9758b9c192dc3efff,1,31,1,32,7,2014-07-16 18:47:32,2014-07-16 18:47:32
4ed115e9c545fb27a5b80c751b2c04ec7ecc4d97...c8db708d5d865a2085230687689868520863abe1,1,1,1,2,1,2014-09-30 18:53:23,2014-09-30 17:42:03
e7c730530065fb2f366ecbcb1e71d7f7346b6a25...2a608391509dc5ea50c9b88e5b98dae6694d7011,2,2,2,4,2,2014-07-13 17:12:37,2014-07-11 23:02:34
64d845477b555a06ce469860861691d003335e9c...95acfc2479967ba5f3e2ddfee1fa2eb89b386c4f,1,1,1,2,1,2014-07-02 19:52:55,2014-07-02 18:24:05
786a89d3477c339676ed36d5d2d7507251344952...7cefd3431a02adeb3a12d1da931b7a44045ebe0d,1,19,19,38,19,2014-06-24 18:52:47,2014-06-24 18:52:47
75866e60453c0c2a19f4de1bef56da34119bee3b...0953113bb5687f42bcdfc3d20dd3a125784ad383,1,87,0,87,10,2014-06-06 18:42:05,2014-06-06 18:42:05
aeaa7e2784b8253e1557e6b41350b6e3c7fa49a2...779792a5f24bb4e8049c4f88ad752e70d4a8a080,1,12,3,15,3,2014-04-21 18:54:29,2014-04-21 18:54:29
5e078fcd83b32abb447c9567da439fe3741dae1a...22338062078aef8c75fb799a85c9d993984f34bd,1,1409,1340,2749,1113,2014-04-22 19:41:16,2014-02-26 20:27:14
5e078fcd83b32abb447c9567da439fe3741dae1a...15fbbed790d703a61205d5a77cc63035d8489705,1,1458,1385,2843,1153,2014-04-20 08:22:26,2014-04-20 08:22:26
15fbbed790d703a61205d5a77cc63035d8489705...d372b5cf6ee2d26bd9cfeb05a55d5fec028e30a3,1,1391,1319,2710,1107,2014-04-22 09:26:02,2014-04-22 09:26:02
cee0c2750bb5f1b38f15ef961517e03c2e39c9ec...a58088abe2011b6f486de8acd54432f6d9bcecfc,25,43,44,87,31,2014-03-31 22:16:22,2014-03-31 22:11:44
a58088abe2011b6f486de8acd54432f6d9bcecfc...e34b272344c1e7eb640dcce5990a75460240daed,2,3,3,6,2,2014-03-31 22:17:56,2014-03-31 22:11:45
e34b272344c1e7eb640dcce5990a75460240daed...01689909eb9f8366583c44b325d8d9ba259a2538,20,26,27,53,21,2014-03-31 22:29:27,2014-03-31 22:11:46
01689909eb9f8366583c44b325d8d9ba259a2538...235e8d591480d7e1378c27fe65c5529625d4b5be,12,16,16,32,14,2014-03-31 22:29:33,2014-03-31 22:11:47
cee0c2750bb5f1b38f15ef961517e03c2e39c9ec...4b623d80f73528a632576990ca51e34c333d5dd6,1,1,1,2,1,2014-03-28 20:37:16,2014-03-28 20:08:02
cee0c2750bb5f1b38f15ef961517e03c2e39c9ec...da8daa367b7dfe4337252810f6be0c0c31aa93c2,2,2,1,3,2,2014-03-27 19:05:14,2014-03-27 07:34:27
3c9e56b75c4a9a6832d94a00f079ea68e8a281ca...0bc85abb7aa9b24b093253018801a0fb43d01122,3,23,2,25,4,2014-04-09 19:04:34,2014-04-09 19:04:34
d813ab970db8b57b70bdd1b7e5feddec1c3fd84e...08460345b5a221c0076a48c6be875d64b78b6015,1,18,23,41,3,2014-05-12 17:20:46,2014-05-09 21:51:38
08460345b5a221c0076a48c6be875d64b78b6015...9c94389c3ee02df891100b894c1790a524268d91,5,329,59,388,7,2014-05-12 17:38:01,2014-05-09 21:51:44
940bf249fea072c2e66c1c9ddacfa536c0f9b6dd...3f0c02a1c018ddaced5c97b58f550b2ad17dd0a9,1,11,0,11,2,2014-04-16 20:43:26,2014-04-16 20:43:26
53c98cc718dd4edf6a102f596910de772285d66c...d393d140b5656e608b332c00ea3b14f9a060d604,1,29,0,29,2,2014-03-25 19:01:39,2014-03-25 19:01:39
512477b175288a429aaf4071dc9fe94f17f0e4ee...a6ca9dfa5cd025353afe21aa4432b3b3663ebef2,1,2,2,4,2,2014-03-21 21:10:30,2014-03-20 23:13:21
a6ca9dfa5cd025353afe21aa4432b3b3663ebef2...35de3ac1db323976b88949839ff8b2135513e257,1,0,1,1,1,2014-03-21 21:11:09,2014-03-20 23:13:36
35de3ac1db323976b88949839ff8b2135513e257...221bf985063737240124fe15c328cd125e9d048e,3,0,17,17,16,2014-03-21 21:11:11,2014-03-20 23:14:33
221bf985063737240124fe15c328cd125e9d048e...3cc6a6f0f7519733deeebe17d7a19a53e9c02028,2,5,5,10,3,2014-03-21 21:24:40,2014-03-20 23:15:24
3cc6a6f0f7519733deeebe17d7a19a53e9c02028...551a3e60d1cb9dca37a3a789cf1a4b94074ce6c5,1,4,4,8,2,2014-03-21 21:26:22,2014-03-20 23:15:54
551a3e60d1cb9dca37a3a789cf1a4b94074ce6c5...f7e87141011fc55f8267ea76d3cc016ee87f9053,5,17,18,35,14,2014-03-21 21:26:55,2014-03-20 23:17:01
f7e87141011fc55f8267ea76d3cc016ee87f9053...3d06c5f19daf6710d99b6e4c7c0d097c8ce528fc,1,2,2,4,1,2014-03-21 21:27:52,2014-03-20 23:17:15
3d06c5f19daf6710d99b6e4c7c0d097c8ce528fc...633734d4a13ace930b34c83d37b4e8a22ccf5a3b,1,18,18,36,16,2014-03-21 21:27:58,2014-03-20 23:17:35
633734d4a13ace930b34c83d37b4e8a22ccf5a3b...2a472410cbb481c56ee207dbda2ee99d158c0f48,1,4,7,11,6,2014-03-21 21:28:03,2014-03-20 23:18:12
2a472410cbb481c56ee207dbda2ee99d158c0f48...0981140fcc2fe33c37da87802b95e01af2a94add,1,11,27,38,3,2014-03-21 21:28:05,2014-03-20 23:19:50
0981140fcc2fe33c37da87802b95e01af2a94add...99e1c7367f34ecc69ce46263309610b66d027d88,1,22,39,61,8,2014-03-21 21:35:08,2014-03-20 23:21:25
99e1c7367f34ecc69ce46263309610b66d027d88...410c3428ed42bc0978e2917236e95cd5f860864f,1,9,47,56,9,2014-03-21 21:35:13,2014-03-20 23:23:06
40adf520a306220ebaedee72528efd1d0c4840ce...96e67c86f817b4fbd492b12f57dae4bd821571ba,1,27,0,27,2,2014-03-28 20:56:29,2014-03-28 20:56:29
6f6be80ef15f09d7a5330a6cee03ab5fe3d12979...a35104faa205cbdd12ca253ca8b2440b0abeb532,1,11,0,11,2,2014-03-18 21:33:34,2014-03-18 21:33:34
16216b6ab1073b7aaa8225c32208758e6ea16629...c45a18e88f47fc9b23f8e8e7b14a030434917a66,1,10,11,21,7,2014-03-18 19:47:29,2014-03-15 11:14:40
16216b6ab1073b7aaa8225c32208758e6ea16629...47be06602656ee9cac860f675d2c8d1f0deabdbe,1,1,1,2,1,2014-03-17 19:24:14,2014-03-14 23:56:43
47be06602656ee9cac860f675d2c8d1f0deabdbe...cb1aefda53aac7c5e8bda58ed86f0682730b330b,1,2,2,4,2,2014-03-18 18:48:00,2014-03-18 00:14:11
16216b6ab1073b7aaa8225c32208758e6ea16629...b790e0f67cd97f29b72cb9007632b0329e5eebec,4,37,9,46,10,2014-03-11 20:32:10,2014-03-11 12:59:46
51822653f58e6b9b6119f560ff864813fbde81ba...570f1e6e1a7145efb4e80da9c711fcbc319f6b17,1,3,2,5,3,2014-06-16 17:56:47,2012-05-29 02:21:39
570f1e6e1a7145efb4e80da9c711fcbc319f6b17...3e66e47b1b1baef859be79a12091fdbdd82492a8,1,8,15,23,9,2014-06-16 17:56:47,2011-11-25 20:33:17
3e66e47b1b1baef859be79a12091fdbdd82492a8...58aa3d2a69ded1f48a1c9c63176384d02925c9d6,1,1,1,2,1,2014-06-16 17:56:47,2011-01-07 17:04:16
58aa3d2a69ded1f48a1c9c63176384d02925c9d6...5901dc6613fcb5e4a4c49e09992a13a4840edb48,1,6,0,6,1,2014-06-16 17:56:47,2011-01-07 18:52:20
5901dc6613fcb5e4a4c49e09992a13a4840edb48...99c3c76d97164dba2cdd288281a0121de46f11e3,1,14,4,18,6,2014-06-16 17:56:47,2011-01-16 17:27:53
99c3c76d97164dba2cdd288281a0121de46f11e3...3f046148d92e1aa6c0872a6f11f39a4a5740f939,1,40,2,42,2,2014-06-16 17:56:47,2011-01-16 17:28:27
34d5217584ee4722d0c0b07ed6c8f1f01ad157c3...37943e4c3867323593699d5458d2d7925fdf32fc,1,0,2,2,1,2014-07-10 17:53:00,2014-07-09 21:45:43
37943e4c3867323593699d5458d2d7925fdf32fc...b725b270d1474819d46161909416ef73ba2170ff,1,5,5,10,5,2014-07-10 17:53:47,2014-07-09 21:47:05
b725b270d1474819d46161909416ef73ba2170ff...cdaa4e98ca56586f78a455bd624457248347a56d,1,4,4,8,4,2014-07-10 17:54:22,2014-07-09 21:47:20
34d5217584ee4722d0c0b07ed6c8f1f01ad157c3...60a5f5fc791d6c133732238736ef0961df600296,1,1,1,2,1,2014-06-23 21:31:35,2014-06-23 21:27:36
34d5217584ee4722d0c0b07ed6c8f1f01ad157c3...95104c7e257652b82aed089494def344e3938928,2,18,2,20,5,2014-06-16 20:29:16,2014-06-16 00:01:25
00a5b79466f79a2df6e0f42806adefbe4891c40b...b2c851a8e67da752d8a5dbde5a9dae6e3428a4c9,11,87,4360,4447,37,2014-05-20 21:48:11,2014-05-20 21:18:11
b2c851a8e67da752d8a5dbde5a9dae6e3428a4c9...3054c66bd465175656ab16c0fa9de79284898223,1,37,36,73,28,2014-05-20 21:51:06,2014-05-17 03:30:34
3054c66bd465175656ab16c0fa9de79284898223...8ced8e40ac07c1b13b2edbb459d37b9b2d7275d6,1,1,1,2,1,2014-05-20 21:51:11,2014-05-20 19:07:35
5defdf12cc805b9c2192fc0c76aeb838005728a9...82edd396632501b3dd1901d0f3ae5aa72759b5fb,1,25,0,25,3,2014-04-03 20:40:59,2014-04-03 20:40:59
82edd396632501b3dd1901d0f3ae5aa72759b5fb...e4eef26d985177e4bdd32bf58b6ae40e7ae67289,1,0,1,1,1,2014-04-04 18:57:38,2014-04-03 07:34:03
e4eef26d985177e4bdd32bf58b6ae40e7ae67289...4e49d95ece7e023106349875df05fed0601920a5,1,1,1,2,1,2014-04-07 22:37:12,2014-04-07 13:19:11
648d9c182723862228065686f2c32c4b6bdcdf5e...b4f86a4ce85e4e370a67455de6586a02f158a789,2,7,2,9,2,2014-05-02 20:15:52,2014-05-02 20:15:52
ec445074e0ac4d6003acd21c512c43c8fdb8be86...d952cbb1908b54c6a04f37c8b0924a49cdb5997d,2,13,1,14,2,2014-05-16 17:18:25,2014-05-16 17:18:25
9c3c367b265d0844c5d3c03c7d0b737b92db731c...76053e77efb3097cfb4cdaf2eb76ce4ee65ff58b,1,1,1,2,1,2013-07-18 00:55:05,2013-07-17 19:54:25
9c3c367b265d0844c5d3c03c7d0b737b92db731c...001b0976afe6f41bff46aa3eaad0285b641a50ea,1,1,1,2,1,2013-07-17 19:58:36,2013-07-16 00:10:36
91d0cd9a6e7ec15af5b1b3796a040400d992b46b...1c03999bef32edabd3db6479279b3ef90cc635ca,1,7,1,8,1,2012-11-20 18:16:14,2012-11-20 18:16:14
d4d39bc32db51928b190c3128ced6194b81b3a99...7dd9ab0c8b3ca7ae03d54e741e7a554c192ef02f,1,2,1,3,1,2012-09-17 05:05:07,2012-09-16 16:06:11
7dd9ab0c8b3ca7ae03d54e741e7a554c192ef02f...2ce4fee8785f5c3cc7955fcc9dff8d516f8c95f7,1,3,2,5,1,2012-09-17 17:23:21,2012-09-17 14:22:15
2ce4fee8785f5c3cc7955fcc9dff8d516f8c95f7...6108b04b708f6aa5d4a9349a240b5261fdab0cdf,1,2,2,4,2,2012-09-17 19:31:57,2012-09-17 01:21:55
6108b04b708f6aa5d4a9349a240b5261fdab0cdf...d9fcff2f498d398132cc9a14f7402e77ff1c5991,1,1,1,2,1,2012-09-17 20:45:32,2012-09-17 11:38:51
d9fcff2f498d398132cc9a14f7402e77ff1c5991...5805853f228acafe1d45edeef780cd1b00b952aa,1,3,2,5,1,2012-09-17 21:27:55,2012-09-17 17:06:18
293ab15eea341ffe8705bac99136f2e3a286db5f...3469c7ebbf41fe5fc684583dc84973b95289a6a2,1,15,15,30,2,2012-11-14 21:49:53,2012-11-14 18:49:04
2b533592900ecebeb69e2dd1b70744433700ff2d...b72a1904aefb9e27014a11790f3af4dc90b38e8d,1,19,20,39,4,2012-07-13 20:51:29,2012-07-13 07:50:23
4c8a9db6f7dd9e10b5ce9bfbcd5faa82a8c86ce3...08a94a145c3231c0fa36469682591a3c45222271,2,88,28,116,5,2012-08-21 23:10:53,2012-06-28 18:24:14
4c8a9db6f7dd9e10b5ce9bfbcd5faa82a8c86ce3...89a852efb911c260d3f7b56ef8382a0725cc931b,1,10,1,11,3,2012-06-28 21:37:26,2012-06-28 06:58:02
89a852efb911c260d3f7b56ef8382a0725cc931b...86272b4ffeb38fb4fb1da3603bba1094fab3731b,1,5,3,8,1,2012-06-28 21:37:26,2012-06-28 06:58:03
4c8a9db6f7dd9e10b5ce9bfbcd5faa82a8c86ce3...f89f35a9d41535b3e8ebe500489634e623ae8d83,1,32,6,38,4,2012-06-28 04:06:12,2012-06-28 02:48:07
f89f35a9d41535b3e8ebe500489634e623ae8d83...23bd0c99f7b789077c40ae5384dd0054ef5c00ac,3,3,3,6,3,2012-06-28 04:06:34,2012-06-27 12:00:55
23bd0c99f7b789077c40ae5384dd0054ef5c00ac...08c5eb7ac0167e5932f2456df3dcebd0712d63a9,4,17,21,38,9,2012-06-28 04:06:34,2012-06-27 12:00:56
08c5eb7ac0167e5932f2456df3dcebd0712d63a9...c88015a411307e71338a56df70c0decfc635689e,1,4,0,4,1,2012-06-28 04:06:34,2012-06-27 12:00:57
c88015a411307e71338a56df70c0decfc635689e...a64f732eb9b22d6260d1c89253a47d6b1a5a3faa,1,3,3,6,3,2012-06-28 04:06:35,2012-06-27 12:00:58
a64f732eb9b22d6260d1c89253a47d6b1a5a3faa...4256397aca2b55dfaefbe7639520fbcc34ca93ca,1,2,1,3,1,2012-06-28 04:06:35,2012-06-27 12:00:59
4256397aca2b55dfaefbe7639520fbcc34ca93ca...f69b3a93ca8a0f2fb9a9075df943172e2aa5c718,1,2,2,4,2,2012-06-28 04:06:35,2012-06-27 12:01:00
f69b3a93ca8a0f2fb9a9075df943172e2aa5c718...23a2666c2e402b2425a6abe910c04cebbea25e31,3,3,2,5,3,2012-06-28 04:06:35,2012-06-27 12:01:01
23a2666c2e402b2425a6abe910c04cebbea25e31...9b6513ac6fde1552a9a3d606be704eb5ded43ac0,4,506,397,903,6,2012-06-28 04:06:35,2012-06-27 12:01:02
9b6513ac6fde1552a9a3d606be704eb5ded43ac0...a0327c0edc7ada60ae2af5ec8daa5dcfcacd095d,1,7,3,10,1,2012-06-28 04:06:35,2012-06-27 12:01:03
4c8a9db6f7dd9e10b5ce9bfbcd5faa82a8c86ce3...c0f86547c522906da7538c0d2b7b0de608499c23,2,10,2,12,4,2012-06-26 21:23:03,2012-06-26 18:19:32
0e8593dc5b812df00400347e88f5707225fe831e...e3ebc35b1695e9ac6e9b5978cd4e9ffb7b15f657,2,14,6,20,5,2012-07-16 16:59:06,2012-07-12 12:04:20
fd378070c8171ba33a9b1aeca37085e6dfbff35b...e30b2feb1b50c2d14d32dc3e6e41f7b20a677ff2,8,163,52,215,21,2012-06-25 18:55:51,2012-06-24 11:39:59
e30b2feb1b50c2d14d32dc3e6e41f7b20a677ff2...2d6dc182b8fa171a6b283ce6e8e75a35e13ea67a,6,54,9,63,25,2012-06-25 18:56:24,2012-06-24 11:40:00
2d6dc182b8fa171a6b283ce6e8e75a35e13ea67a...a7271ad1dccaf1a1875992520204debb37ed78bb,1,94,12,106,5,2012-06-25 18:56:24,2012-06-24 11:40:01
ad78585eeebd8d5ac596ad4f06f549734ce9d870...3c8f12c96ca09af2a0a9df9fbb9ffd25985ff597,1,22,23,45,5,2012-06-25 05:01:35,2012-06-25 05:01:35
cd07cc53125fb2ca77a644831d4e5d9517bb7a05...bcb2b0044b3baedf7857613ec069f300c364680c,2,22,16,38,11,2012-05-22 16:07:52,2012-05-21 23:09:43
bcb2b0044b3baedf7857613ec069f300c364680c...5cb2194aba3c6828cec3e4ec75d78f49165e2eab,1,1,1,2,1,2012-05-22 16:07:52,2012-05-21 23:09:47
5cb2194aba3c6828cec3e4ec75d78f49165e2eab...e21ab1340a1a22f017e9c3e4fc0deb9f4de36917,1,4,4,8,4,2012-05-22 16:07:52,2012-05-21 23:09:51
e21ab1340a1a22f017e9c3e4fc0deb9f4de36917...9597921b6c173d90359e2cfa4c2e36de8d1554e6,3,23,23,46,4,2012-05-22 16:07:53,2012-05-21 23:09:54
9597921b6c173d90359e2cfa4c2e36de8d1554e6...2d4b4fcebdd4fb8c8cd2664b390e3bbb82370155,3,4,6,10,4,2012-05-22 16:07:53,2012-05-21 23:09:57
2d4b4fcebdd4fb8c8cd2664b390e3bbb82370155...132f4b6ccb470cb209167b7806c68805ba4dc600,1,4,0,4,1,2012-05-22 16:07:53,2012-05-21 23:10:02
132f4b6ccb470cb209167b7806c68805ba4dc600...43ae9f47ab8a7762d914e91d6f57b79126986640,1,2,8,10,2,2012-05-22 16:07:53,2012-05-21 23:10:08
43ae9f47ab8a7762d914e91d6f57b79126986640...b9f0ac1710ed1d2dc865ab40893720e9a242e362,2,6,10,16,4,2012-05-22 16:07:54,2012-05-21 23:10:11
b9f0ac1710ed1d2dc865ab40893720e9a242e362...060d4bb3d6c0f4ca3b85f089708b07447224bc91,1,1,3,4,1,2012-05-22 16:08:14,2012-05-21 23:10:14
060d4bb3d6c0f4ca3b85f089708b07447224bc91...8587ead78ad3d2af760270b21035ffe48fde3e7b,3,39,73,112,34,2012-05-22 16:08:20,2012-05-21 23:10:17
8587ead78ad3d2af760270b21035ffe48fde3e7b...2f70587502b6b5a8cfda5a3eff54392f48e2db8d,5,20,25,45,7,2012-05-22 16:08:20,2012-05-21 23:10:20
2f70587502b6b5a8cfda5a3eff54392f48e2db8d...f8254d321cc42a6d47abf79b0f93d16e28432df3,1,4,9,13,4,2012-05-22 16:08:46,2012-05-21 23:10:23
f8254d321cc42a6d47abf79b0f93d16e28432df3...c96f0c8d0a9f1eeabb2ea49cb7ede954a64bd540,1,15,28,43,11,2012-05-22 16:08:48,2012-05-21 23:10:26
c96f0c8d0a9f1eeabb2ea49cb7ede954a64bd540...be641abdb544f00adb7ae6fdab41f9bd5453e206,1,4,1,5,3,2012-05-22 16:08:49,2012-05-21 23:10:29
be641abdb544f00adb7ae6fdab41f9bd5453e206...a21c2f94fb6e74ebddb5c78cf6b5f68983646530,3,20,38,58,12,2012-05-22 16:08:50,2012-05-21 23:10:32
a21c2f94fb6e74ebddb5c78cf6b5f68983646530...b00f6cfcd7232d90c4625c42eb9694d4ed2dc615,1,1,1,2,1,2012-05-25 00:16:34,2012-05-24 23:26:32
b00f6cfcd7232d90c4625c42eb9694d4ed2dc615...359b27add341878a13c6a8b85849b75b78246c7e,1,9,6,15,3,2012-05-25 00:16:40,2012-05-24 23:26:50
359b27add341878a13c6a8b85849b75b78246c7e...c15e1987aec562107bd8e4a9fdeebf6d27d0e53a,2,10,5,15,6,2012-05-25 00:16:40,2012-05-24 23:27:24
c15e1987aec562107bd8e4a9fdeebf6d27d0e53a...c73f384f92dcb0d7111533ed21f6c2dc9fcc323b,1,2,1,3,1,2012-05-25 00:16:41,2012-05-24 23:28:25
c73f384f92dcb0d7111533ed21f6c2dc9fcc323b...f9bc573fdaeaf8621008f3f49aaaa64869791691,9,14,15,29,14,2012-05-25 00:16:41,2012-05-24 23:28:40
f9bc573fdaeaf8621008f3f49aaaa64869791691...8c5b1ae1b26a7512eb29e75391b8b24c0d0439e7,1,6,0,6,1,2012-05-25 03:50:05,2012-05-24 23:32:37
8c5b1ae1b26a7512eb29e75391b8b24c0d0439e7...59f9b8a9a95cbcf4f6a5123cac04dc5073a8d0cc,1,1,1,2,1,2012-05-25 03:50:19,2012-05-24 23:32:52
cd07cc53125fb2ca77a644831d4e5d9517bb7a05...6b179adfe93d13c2f993668cd12eec52860486ac,2,34,38,72,5,2012-05-14 17:33:33,2012-05-14 15:35:18
98f85ff4b65b565bae0592ded494d67045cbd3bf...e4ca819abff48af8e4a10059c88b3b1533b9f994,1,1,1,2,1,2013-03-24 06:50:50,2013-03-23 17:16:46
d9be2485e284d9d73b071b2946fff0b19f97aaa7...50995edda69b4d6d84452a392f0e1fa86280ac2c,1,1,1,2,1,2013-02-18 20:43:00,2013-02-18 20:43:00
fc1c5415d69dd7997d20b5a9bdb204d3ee12ed08...55d9bf0aa8428463da2d810024ab32d176be4d65,1,2,0,2,2,2013-02-19 23:27:08,2013-02-19 11:23:29
122650457a619a6572c358ba9605a798ac771274...7f1b69763272f9d07e612309f53190da0c97ca70,1,8,6,14,3,2013-02-21 07:56:05,2013-02-21 06:26:14
0e18bcd5e937b9e5857892e7f5c80c3c5b1da5d4...ec008076dbe6acde42ce9ff796f72ca7c3edd5bf,1,4,12,16,3,2012-12-10 20:50:10,2012-12-10 20:50:10
b1c2f57db326c43ec286855b396fb16b4890cf2d...8fa4b09fb14339c5d62e65a88fde8b220cb1591b,1,3,2,5,2,2012-10-28 12:48:09,2012-10-28 12:34:06
8fa4b09fb14339c5d62e65a88fde8b220cb1591b...ef90ab66e8eaa863777a8d383c5af2ff43a426d2,2,51,17,68,9,2012-10-28 12:48:17,2012-10-28 12:27:12
870987dec752fe2a6752f7813fe1892b5e1a8d32...7632cd274464d693c3821205f72a54cda2b7d83b,1,58,7,65,9,2013-03-25 21:08:00,2013-03-25 21:08:00
b450568209c8ae270d26ee7fda2e4687ad8a5327...256b9d70a497534338f0c22101cb6566ab3f1665,3,7,58,65,7,2013-01-16 21:03:57,2013-01-16 21:02:27
3b16b3702ac3da91cee3f74fdf8620289e0e8f14...59defcc36839d549a2db94b7569025ea3b4ec01a,1,28,0,28,1,2012-11-28 20:23:24,2012-11-28 20:06:26
9fca6cffc05321445b59c91e8f8d308f41588b53...49a370d73a5d4de7674bca87db8efc134beb7255,1,4,0,4,1,2013-01-06 21:36:46,2013-01-06 19:56:33
5d417842efeafb6e109db7574196901c4e95d273...8240943bd75f1f19a40a0d4634afcab2eadd23d9,1,1,1,2,1,2013-07-06 06:14:37,2013-07-05 08:42:17
5d417842efeafb6e109db7574196901c4e95d273...77c72780edfa5e3858423366fc91699724793b39,2,26,1,27,2,2013-03-21 22:47:38,2013-03-21 21:57:48
5d417842efeafb6e109db7574196901c4e95d273...5482920919f5ff14b1e4b01cf81eab17c32c2734,4,545,0,545,4,2013-02-25 21:46:14,2013-02-25 15:49:15
5d417842efeafb6e109db7574196901c4e95d273...c082196575e13dd5960031f213b20e2df989ca18,3,25,2,27,5,2013-02-11 19:29:45,2013-02-09 06:31:09
5d417842efeafb6e109db7574196901c4e95d273...144797d7209565f1d377aaf1f157ea30eff5e04c,1,0,55,55,54,2013-02-05 23:19:35,2013-02-05 04:06:01
144797d7209565f1d377aaf1f157ea30eff5e04c...a5b8e28e4eb5762c9da68b56efdf45d6c885bd56,2,20,5,25,3,2013-02-05 23:22:12,2013-02-05 04:06:02
a5b8e28e4eb5762c9da68b56efdf45d6c885bd56...10a49587fabde88c0afbc80a99d97fae91811f5f,1,9,3,12,3,2013-02-05 23:22:36,2013-02-05 04:06:03
10a49587fabde88c0afbc80a99d97fae91811f5f...111dc0eea07d4843a9ed86e4069b899224a4489b,2,8,1,9,3,2013-02-05 23:23:05,2013-02-05 04:06:04
111dc0eea07d4843a9ed86e4069b899224a4489b...d86848228f46fad4c20bdf0bdcca124061dc56b2,1,2,2,4,2,2013-02-05 23:23:19,2013-02-05 04:06:05
d86848228f46fad4c20bdf0bdcca124061dc56b2...8165be064e51112f74ea06e48c2e09e13097335a,1,1,0,1,1,2013-02-05 23:23:41,2013-02-05 04:06:06
5d417842efeafb6e109db7574196901c4e95d273...8bf671946da23b39b7b6b18fe99cfa011ec21a11,1,10,1,11,2,2013-01-27 03:01:46,2013-01-26 01:15:57
8bf671946da23b39b7b6b18fe99cfa011ec21a11...81ed7b9581f7eafb334824264abb492d85a5ffb8,1,11,3,14,1,2013-02-02 02:06:03,2013-02-01 20:16:30
5d417842efeafb6e109db7574196901c4e95d273...598354c0ad4198daff279c34a96f42e4d91fb4e6,2,3,2,5,2,2013-01-27 03:00:03,2013-01-26 19:14:32
598354c0ad4198daff279c34a96f42e4d91fb4e6...a235e85cc8bc308a7dbf414f6594a9d309f13289,3,31,9,40,7,2013-01-27 03:00:10,2013-01-26 19:14:33
a235e85cc8bc308a7dbf414f6594a9d309f13289...2e4f04fae6810161c17bf456124b364ad927c499,1,3,2,5,1,2013-01-30 19:17:59,2013-01-30 19:17:59
5d417842efeafb6e109db7574196901c4e95d273...831d57a0f52c4c1bb8b9561a82b3006474595c84,2,2,2,4,2,2013-01-08 17:37:05,2013-01-08 15:47:37
5d417842efeafb6e109db7574196901c4e95d273...92f1c042432aa20244bcfbd426c4d8bcb1d56fdb,1,21,12,33,5,2013-01-07 19:51:26,2013-01-07 19:07:10
5d417842efeafb6e109db7574196901c4e95d273...81127d74c4367b383b6949846a4ccbd185012734,1,1,0,1,1,2013-01-03 16:03:46,2013-01-03 07:17:51
5d417842efeafb6e109db7574196901c4e95d273...c7ce70ace9794a8f0b4774d803536a7ecdf318de,2,33,2,35,5,2013-01-03 00:06:42,2013-01-02 23:20:19
24a62db7bbcbd8083bd0070ecd434205489629ed...94bc671a1f2e8610de475c2494d2763355a99f65,3,76,9,85,7,2012-12-18 06:07:23,2012-12-08 20:04:39
22d33a20f9327deeec2243b4c18b8f77989e9552...2d242fb3fc19fc9ba046accdd9210be8b9913f64,1,10,0,10,2,2012-11-21 21:32:58,2012-11-21 21:23:18
894610af58244e46d1479acfa527483f30e896ec...3e293fba627e254b2c7d196bb7563c6c9d2e6f8a,1,10,1,11,2,2013-01-03 18:33:22,2013-01-03 18:33:22
9432c6aaa5d58d433b6e3e139998733d2e87d946...92ab409055f6f8e379a7a0af731dbad7e1d43af0,2,51,1,52,2,2013-10-17 22:50:45,2013-10-17 22:50:45
b7973fbbc3f8f72df352f4ef1a2ff325db92c36f...88ce00c378f709937c74a97037aa2692b883d683,1,26,0,26,1,2012-12-12 05:46:49,2012-12-11 18:58:15
88ce00c378f709937c74a97037aa2692b883d683...06b1abb5bd38b3cb1972907b059c7f95a197a7a5,5,84,2,86,10,2012-12-19 17:40:01,2012-12-19 16:03:32
06b1abb5bd38b3cb1972907b059c7f95a197a7a5...b928922727d6691a3bdc28160f93f25712c565f6,3,7,0,7,3,2012-12-19 17:40:51,2012-12-19 16:03:33
b7973fbbc3f8f72df352f4ef1a2ff325db92c36f...f829a9eae6adc7e1d02fa28787e43fccaf98c0cc,1,31,31,62,2,2012-12-07 21:54:14,2012-11-27 23:03:21
f829a9eae6adc7e1d02fa28787e43fccaf98c0cc...b4b106e5a5afacb45cea08d18a241b3d7d609d91,1,42,3,45,4,2012-12-07 21:54:15,2012-11-27 23:03:22
b4b106e5a5afacb45cea08d18a241b3d7d609d91...b20c457a391a4061a238de6feaa010e9ea5fc4e9,1,3,3,6,1,2012-12-07 21:54:15,2012-11-27 23:03:23
b20c457a391a4061a238de6feaa010e9ea5fc4e9...0673bb28d0b96393e526030c96e7dbfac2fc33a2,1,56,78,134,10,2012-12-07 21:54:15,2012-11-27 23:03:24
0673bb28d0b96393e526030c96e7dbfac2fc33a2...754cb1aeba75008730d223d856a28986c3c12726,1,16,5,21,4,2012-12-07 21:54:15,2012-11-27 23:03:25
754cb1aeba75008730d223d856a28986c3c12726...9ec8bcda6031d2c75fb8b06b26bcf9414e9448f6,1,12,5,17,5,2012-12-07 21:54:15,2012-11-27 23:03:26
c86223b2721b934e8450c88c86bac5f061eaa27c...a923c314aa55ed5d5fba431d5db34e442a017a09,1,15,5,20,8,2013-02-07 23:25:06,2013-02-07 23:25:06
fb4c62235fee8008d99ef55c4adcb1f7ea9508a3...fa2364ec3457cc107e47d617779f1ffa23647ca4,7,18,17,35,12,2012-12-10 07:05:27,2012-12-06 23:08:01
fa2364ec3457cc107e47d617779f1ffa23647ca4...b13112fa160f44fb0d795cdd992015c9f5a3d72a,1,1,2,3,1,2012-12-26 22:44:47,2012-12-06 23:41:04
b13112fa160f44fb0d795cdd992015c9f5a3d72a...3b8ff51b708e52e4ae2b8f266d25c187c3152820,1,0,3,3,2,2012-12-26 22:45:12,2012-12-06 23:53:41
3b8ff51b708e52e4ae2b8f266d25c187c3152820...8dd15c6a909c059c6fd4f4dd914dbf932617ea57,2,66,4,70,10,2012-12-26 22:46:15,2012-12-07 00:15:45
8dd15c6a909c059c6fd4f4dd914dbf932617ea57...35ffe7583108ab236dcf81226690388491d9962f,2,42,34,76,14,2012-12-26 22:46:15,2012-12-13 23:51:29
90ae9f259eb55adf54bec6442fe9e2fe223ef80c...ee26a6e2b87905ac605c27841f607cb3379ca678,2,14,12,26,8,2012-12-03 17:49:51,2012-12-03 17:49:51
ed9fe755130891fc878bb2433204faffb534697b...cad06d4d78b52b99d451063db2e6d08c34697d32,1,1,1,2,1,2012-11-26 18:31:11,2012-11-22 03:19:57
cad06d4d78b52b99d451063db2e6d08c34697d32...d1eded46fa5ed350ff52654103623090101b3ba6,1,1,1,2,1,2012-11-26 21:27:45,2012-11-26 19:21:54
2f2c7e12524e337dff7dae9df7b431c81f150136...3a189da601e676a997cbb06b53da02cac364b2ff,1,39,3,42,8,2012-11-20 18:46:29,2012-11-20 18:46:29
f07f4134ae44d7556509e246316482709d193f67...a859d3ee57acee1ca9fbb37e763814f83d11e7bd,1,19,0,19,1,2012-12-07 22:16:38,2012-12-07 22:16:38
f94c3251e1400c3cf349f7f84fea4db66b540113...cf419828064d4f22a2c3134e7b46a7719462b1dc,5,198,3,201,10,2013-03-04 22:48:02,2013-03-04 21:20:24
f94c3251e1400c3cf349f7f84fea4db66b540113...f4f549892ac686a9adcf3cb72bee1a11c0566c88,1,5,2,7,1,2012-12-04 16:00:29,2012-12-04 08:10:37
f4f549892ac686a9adcf3cb72bee1a11c0566c88...176478a8bd028a3877d2be49a1e7a49386c095ce,2,72,10,82,8,2012-12-04 16:00:58,2012-12-04 08:10:38
176478a8bd028a3877d2be49a1e7a49386c095ce...9df92e6369138764ce7bd44edbb307d98e9d72fd,1,25,18,43,3,2012-12-04 16:01:59,2012-12-04 08:10:39
9df92e6369138764ce7bd44edbb307d98e9d72fd...67fe7356538c714da9da6061abe99209452260d7,1,18,11,29,8,2012-12-04 16:02:55,2012-12-04 08:10:40
67fe7356538c714da9da6061abe99209452260d7...afb43561b81b435216b5b8c59fdaa48255e662fb,1,60,9,69,6,2012-12-04 16:03:08,2012-12-04 08:10:41
afb43561b81b435216b5b8c59fdaa48255e662fb...f7a4cea25e3ee1c8f27777bc4293dca0210fa573,2,0,17,17,2,2012-12-04 16:03:42,2012-12-04 08:10:42
f94c3251e1400c3cf349f7f84fea4db66b540113...f9472e359e070fb3fb7d48a730468538764e308f,1,32,14,46,13,2012-11-30 04:41:47,2012-11-30 04:41:47
f9472e359e070fb3fb7d48a730468538764e308f...77cc392d6d60c5d22930174904adae182502b8a9,1,43,20,63,19,2012-11-30 06:43:11,2012-11-30 06:43:11
47e329ef7c46de8ccdc8c4e40333579264a83c21...617cf93182279eec554dda03f44ac6a250e183aa,1,4,0,4,1,2013-03-17 22:38:23,2013-03-17 22:17:09
47e329ef7c46de8ccdc8c4e40333579264a83c21...f9b54e2630f4c839fbc4195693d66e790b09371b,1,3,3,6,3,2013-03-17 22:28:10,2013-03-17 08:33:12
f9b54e2630f4c839fbc4195693d66e790b09371b...30b939c33ad5b8a9dfbe3fe5aafc36d89c40409f,1,10,6,16,4,2013-03-17 22:28:15,2013-03-17 08:38:57
ce432cac30f98b291be609a0fc974042a2156f55...239222f587ed06f96d90dd71c66d80a2b1e3dc9f,2,6,1,7,2,2013-03-13 18:28:08,2013-03-13 18:28:08
6beb484f25c9b11baf0edef4bc9cbfa7e3261df6...2bba2f0e6542d541e9f27653d8c9d5fc8d0e679c,1,8,14,22,13,2013-03-26 20:16:11,2013-03-26 20:01:27
aadb70a5594222cac215f9590017f05d5d0f31b2...3e714cdbab0387984e918aac2ad460abbd0ba1c9,1,34,26,60,3,2013-03-08 22:14:27,2013-03-08 22:14:27
aadb70a5594222cac215f9590017f05d5d0f31b2...47543d161ebe550c412d99aaa6b9e7e5ae88fab5,1,5,0,5,1,2013-03-08 09:46:03,2013-03-07 11:28:14
47543d161ebe550c412d99aaa6b9e7e5ae88fab5...eae6cf5aa8ae2d8a90a99bbe4aeb01c29e01fd02,1,1,1,2,1,2013-03-08 09:53:57,2013-03-08 09:46:41
aadb70a5594222cac215f9590017f05d5d0f31b2...9e7b8efb9d8fde168fee2c12c57903bbb93fd115,1,14,0,14,1,2013-03-08 00:00:49,2013-03-07 23:19:15
9e7b8efb9d8fde168fee2c12c57903bbb93fd115...89773db3e8ee4fd8f37b3051b6cd202e7bacb56a,1,27,0,27,1,2013-03-11 22:02:59,2013-03-11 21:45:28
89773db3e8ee4fd8f37b3051b6cd202e7bacb56a...bbd848633eb0a26ccd7306cb76964ab41cff6b83,2,23,8,31,3,2013-03-11 22:03:11,2013-03-11 21:45:29
efc5e5ef8e467ebbdd4f93c23f2269b907fcdc15...d3a486c47d920efc183645766d762fd697c42088,1,0,1,1,1,2013-07-24 14:53:25,2013-07-24 14:53:25
ed73fe56428eecd2b635473f6a517a183c4713a3...3bf65f9e62d25089ca50eb348844d21cdbb53019,1,7,0,7,2,2013-07-18 01:02:12,2013-07-17 21:25:27
3bf65f9e62d25089ca50eb348844d21cdbb53019...e37f39c134c3621f26fdcdbc22a6b2e4e00de2e5,3,127,112,239,5,2013-07-18 01:02:21,2013-07-17 21:25:28
e37f39c134c3621f26fdcdbc22a6b2e4e00de2e5...03e15fc0b61450d6d7388e7514a67e1a9e7b72bd,1,101,3,104,2,2013-07-18 01:02:22,2013-07-17 21:25:29
03e15fc0b61450d6d7388e7514a67e1a9e7b72bd...5a9830cb718ce13fcbad39384dd365bb895a1b21,1,46,2,48,4,2013-07-18 01:02:22,2013-07-17 21:25:30
5a9830cb718ce13fcbad39384dd365bb895a1b21...e6d2b9f6e7670e64e1d79b95205fe2fb32f990c2,1,2,1,3,1,2013-07-18 01:02:22,2013-07-17 21:25:31
e6d2b9f6e7670e64e1d79b95205fe2fb32f990c2...df83d5cf6759541d6f3d94b29a91fd0d3e5dbcd5,1,5,2,7,1,2013-07-18 01:02:22,2013-07-17 21:25:32
ed73fe56428eecd2b635473f6a517a183c4713a3...b2edae0ab6d8188d6cd912ba5c8d1f2086c2cb9a,1,53,0,53,4,2013-06-02 23:02:21,2013-06-02 23:02:21
b2edae0ab6d8188d6cd912ba5c8d1f2086c2cb9a...1fee89cedd3f797ae792379475fab3e4183de17e,1,2,2,4,1,2013-06-03 17:01:03,2013-05-30 13:46:35
7799588faa2a8071da8ef047c87f9a1520fb8903...c6898ebf219424775160f28855964b103dd880b4,1,3,3,6,1,2013-03-11 14:57:35,2013-03-11 08:01:32
7799588faa2a8071da8ef047c87f9a1520fb8903...5cae93566027c1d148c9f6625aed484a7096a980,1,12,10,22,2,2013-03-07 19:16:54,2013-03-07 10:13:15
7799588faa2a8071da8ef047c87f9a1520fb8903...ed1ddafa601763c23bec74d1f44f9968689b9d8f,1,2,2,4,2,2013-03-05 04:41:45,2013-03-05 04:41:45
ed1ddafa601763c23bec74d1f44f9968689b9d8f...b6eab8bdaad0f1714ed1676799034c05bada2189,1,4,4,8,3,2013-03-05 08:18:25,2013-03-05 08:18:25
b6eab8bdaad0f1714ed1676799034c05bada2189...3fef5536a05735ebf6e4be4bb18920d16c84a7bd,1,10,10,20,8,2013-03-06 06:57:17,2013-03-06 06:57:17
3fef5536a05735ebf6e4be4bb18920d16c84a7bd...79d0f373379d4b2e9bad16e3071bd3d16e7842a0,1,9,7,16,5,2013-03-06 18:26:29,2013-03-05 05:32:41
79d0f373379d4b2e9bad16e3071bd3d16e7842a0...a7409dfbc1c0d7e0c62f704a03a61bf669e90ae9,1,4,4,8,3,2013-03-07 00:46:19,2013-03-05 05:09:55
ec3ae6ec46ed48383ae40643990f169b65a563cc...46bc4039a9cbba2af764e624d43ea0cb6e302dd5,1,579,558,1137,502,2013-01-25 04:43:19,2013-01-25 04:33:58
ec3ae6ec46ed48383ae40643990f169b65a563cc...1b67bef25606471817d9b0a61a923568de0daac8,2,3,3,6,3,2013-01-24 10:21:23,2013-01-24 00:23:44
1b67bef25606471817d9b0a61a923568de0daac8...bc93ceb7c5ec959ad275f575a3c49ff491337a8b,2,22,23,45,3,2013-01-24 10:21:23,2013-01-21 01:22:02
aa3bb87176d42f1782c5030fa41e6e62492551c0...fe0435011cfc5f0c15bbd4548ce0015f5b8ad430,7,860,0,860,7,2012-05-30 20:50:45,2012-05-29 21:52:00
aa3bb87176d42f1782c5030fa41e6e62492551c0...681b07de11c9463f6d93639d9fff9eccd8629eb4,1,30,11,41,12,2012-05-23 16:08:54,2012-05-23 14:09:46
681b07de11c9463f6d93639d9fff9eccd8629eb4...9ec2dde9f3008ed3822c8e7510ab710bdb613873,2,49,8,57,17,2012-05-23 16:08:54,2012-05-23 14:09:47
9ec2dde9f3008ed3822c8e7510ab710bdb613873...8a2e163ccd03a12696cbf7518c0b742d313b6f02,1,24,3,27,7,2012-05-23 16:08:55,2012-05-23 14:09:48
8a2e163ccd03a12696cbf7518c0b742d313b6f02...4614043c8fd8972bcde4fbfce7a8d25dd6d206fd,2,82,5,87,8,2012-05-24 17:37:48,2012-05-24 13:55:44
aa3bb87176d42f1782c5030fa41e6e62492551c0...40ad937d47d6649a022f12f463ee39e83b1d9663,1,7,6,13,6,2012-05-22 20:32:21,2012-05-22 18:50:39
40ad937d47d6649a022f12f463ee39e83b1d9663...b9146f517a312fed42d12b32e3ee3bd99944121d,1,10,8,18,8,2012-05-22 20:32:24,2012-05-22 18:50:52
b9146f517a312fed42d12b32e3ee3bd99944121d...dd02e72852280d73bfd845703476b230475b2776,1,4,9,13,7,2012-05-22 20:32:26,2012-05-22 18:50:58
dd02e72852280d73bfd845703476b230475b2776...e1980c9d23c22ecfbcadbe91d304ba778b84b457,1,23,9,32,3,2012-05-22 21:28:03,2012-05-22 21:03:29
aa3bb87176d42f1782c5030fa41e6e62492551c0...443596850f464c768624e6b6477acadc2aa35e8f,1,9,1,10,3,2012-05-22 20:31:03,2012-05-21 22:17:02
443596850f464c768624e6b6477acadc2aa35e8f...7db8d5370f070ab983e1bc3569380b8aca899c6d,1,6,15,21,1,2012-05-22 20:31:03,2012-05-21 22:17:20
7db8d5370f070ab983e1bc3569380b8aca899c6d...ed81c76bc3a9440e37b3512c9c2b742c6ca92c6f,2,24,0,24,3,2012-05-22 20:31:03,2012-05-21 22:19:28
ed81c76bc3a9440e37b3512c9c2b742c6ca92c6f...9e8e704f0bc14da325aa63f639c6dc782c81e26f,1,2,0,2,1,2012-05-22 20:31:03,2012-05-21 22:19:51
9e8e704f0bc14da325aa63f639c6dc782c81e26f...a0de28805dceaca86a6f7bedfd3e8c227b781d9d,1,13,6,19,5,2012-05-22 20:31:03,2012-05-21 22:23:29
a0de28805dceaca86a6f7bedfd3e8c227b781d9d...3d2a33e57faa84be3ab83a80c8b75dad3e747054,1,1,1,2,2,2012-05-24 17:02:37,2012-05-24 06:04:51
befc5ed3799cb6fcbaa7de03e7fa1760e846853c...a5a46eb90f530c731084a57783ca9fdbf1a52163,1,3,3,6,3,2012-06-13 17:47:21,2012-06-13 17:42:25
befc5ed3799cb6fcbaa7de03e7fa1760e846853c...1cc8af044cad37b5f7df85b177f6aa979aa3215a,2,16,1,17,5,2012-06-06 21:14:13,2012-06-06 20:28:16
befc5ed3799cb6fcbaa7de03e7fa1760e846853c...c1c259e225cf39c7353c673ad2c7c84450d909c1,1,4,3,7,4,2012-05-29 20:52:23,2012-05-28 19:46:58
befc5ed3799cb6fcbaa7de03e7fa1760e846853c...8a6dae108eadbd2882296981e03fd8e251d42f56,1,1,0,1,1,2012-05-29 18:44:14,2012-05-24 13:57:26
befc5ed3799cb6fcbaa7de03e7fa1760e846853c...c41494f8c89c330cc9bd4629cdc3c428803e76bc,1,1,1,2,1,2012-05-29 18:12:59,2012-05-27 16:02:58
befc5ed3799cb6fcbaa7de03e7fa1760e846853c...35a94d44afd5d46bd9675d74925bac73a9839066,1,48,48,96,3,2012-05-29 17:58:54,2012-05-26 12:31:12
35a94d44afd5d46bd9675d74925bac73a9839066...fcd631ed84d61147b7cc8996cde533f8a8d1fca0,1,16,16,32,3,2012-06-07 18:33:37,2012-06-07 07:53:35
fcd631ed84d61147b7cc8996cde533f8a8d1fca0...f9f6e2ce26e25661245a6faaf0b254524c1bfbd4,2,25,14,39,11,2012-06-07 18:33:38,2012-06-07 07:53:36
befc5ed3799cb6fcbaa7de03e7fa1760e846853c...c102f4cf729a65b3520dbb17b52aa0c4fe4d4b29,3,204,144,348,4,2012-05-29 00:17:59,2012-05-28 00:39:01
c102f4cf729a65b3520dbb17b52aa0c4fe4d4b29...72827aa468b467157643bb3689c8786e86e4a58c,1,25,25,50,19,2012-05-29 00:17:59,2012-05-28 07:00:46
72827aa468b467157643bb3689c8786e86e4a58c...a6180325e885e2226d68144000e8bb18a906a2a6,3,605,505,1110,6,2012-05-29 00:17:59,2012-05-28 07:03:58
3bd8de57279492e34d4e4525c7498651a027f3d9...71f1a216e74460ac9c36bc892ec215336b928e2e,1,6,1,7,3,2010-02-06 00:36:56,2010-02-06 00:36:56
71f1a216e74460ac9c36bc892ec215336b928e2e...6448e0ce44295c5168628a658614f2915cc3cd1f,1,8,1,9,2,2010-02-06 05:12:06,2010-02-06 05:00:40
2c76c3fecee688f88440db4167813cc25efd0388...bdab6a59cf078a3cf50d36afa439814f7eb96f3e,1,1,1,2,1,2010-09-06 23:56:51,2010-09-06 23:32:55
5f7baac1e34440d3805ef488c97af748f3c20640...460d562eab00070dfeb54f6ecbf803ad14aed4a5,1,2,2,4,2,2010-07-20 18:37:26,2010-07-20 15:24:47
460d562eab00070dfeb54f6ecbf803ad14aed4a5...77b5be2abab69a69618dd40a6ca8b754388b8216,2,2,2,4,2,2010-07-20 18:37:45,2010-07-20 18:27:55
53b304224a561b5fd4ae35cedc0a978d91d4b1da...bb59b7fffc84eb4cd6591df5a15adb5eaf7218d7,1,6,6,12,3,2010-07-19 15:11:04,2010-07-18 18:23:22
bb59b7fffc84eb4cd6591df5a15adb5eaf7218d7...7b8cd49d5cc5aeb3723be616993bfc7fc847c34f,1,33,26,59,8,2010-07-19 15:11:33,2010-07-18 18:23:23
7b8cd49d5cc5aeb3723be616993bfc7fc847c34f...28bb4b276af31af07163b28cd790b51f7c15c4b6,1,109,107,216,2,2010-07-19 16:10:24,2010-07-18 18:23:24
28bb4b276af31af07163b28cd790b51f7c15c4b6...8bb95bbca774506b15a1ca3b7ae233118956e45e,1,23,23,46,2,2010-07-19 16:12:07,2010-07-18 18:23:25
8bb95bbca774506b15a1ca3b7ae233118956e45e...6e90f7b8df5d9557e0204f047f2d47bd89d99588,1,13,13,26,2,2010-07-19 16:12:42,2010-07-18 18:23:26
53b304224a561b5fd4ae35cedc0a978d91d4b1da...b03e7b7d76e79de14e76df5d4e2ee727f4522a95,1,32,2,34,6,2010-07-16 22:34:12,2010-07-16 19:16:23
53b304224a561b5fd4ae35cedc0a978d91d4b1da...7b53b92fdb22b90d2be558db84c725641c4ad170,2,54,23,77,13,2010-07-16 22:20:58,2010-07-13 23:28:12
7b53b92fdb22b90d2be558db84c725641c4ad170...5df16453d4da41e5a36de536acf9acc8aab98041,1,27,25,52,4,2010-07-16 22:21:52,2010-07-13 23:28:13
5df16453d4da41e5a36de536acf9acc8aab98041...3b2c5b6df4be14cac6b36cf0db0468efa1f42916,1,5,12,17,3,2010-07-16 22:22:00,2010-07-13 23:28:14
3b2c5b6df4be14cac6b36cf0db0468efa1f42916...f29b5e06b3bdbe3c66a01db8ee67e3c87ae55705,2,11,10,21,4,2010-07-16 22:26:03,2010-07-13 23:28:15
f29b5e06b3bdbe3c66a01db8ee67e3c87ae55705...6bc83cdd0b9c7eab365e10d46d1e2acdb769728a,1,17,5,22,6,2010-07-23 22:07:39,2010-07-21 04:25:02
6bc83cdd0b9c7eab365e10d46d1e2acdb769728a...130ab8ab9c64b59b367c08a041200b6b75758b91,4,30,21,51,14,2010-08-16 02:12:00,2010-08-11 08:36:07
130ab8ab9c64b59b367c08a041200b6b75758b91...2a41dfb03b93c3e5b7d1deca537276aed063a044,1,9,0,9,1,2010-08-16 02:12:05,2010-08-11 08:36:41
2a41dfb03b93c3e5b7d1deca537276aed063a044...981ff5c37ae20687c98d98c8689d5e89016026d2,1,5,2,7,1,2010-08-16 02:12:07,2010-08-11 08:37:24
981ff5c37ae20687c98d98c8689d5e89016026d2...314eeb6e483350cc7ef0bee0498ff24a12346495,3,34,26,60,12,2010-08-16 02:12:08,2010-08-11 08:37:51
314eeb6e483350cc7ef0bee0498ff24a12346495...997b688769f8d3ea539990ab53d6a44a46a2b2b4,1,5,5,10,5,2010-08-18 20:20:56,2010-08-18 14:36:44
53b304224a561b5fd4ae35cedc0a978d91d4b1da...e605164d1da51087882a468bcf3f5d36d3a9d4ba,4,147,0,147,4,2010-07-16 20:21:47,2010-07-15 16:25:39
53b304224a561b5fd4ae35cedc0a978d91d4b1da...9644c0616374f8c621b10793b1732b26a0482820,2,7,8,15,8,2010-07-15 22:35:12,2010-07-15 16:22:57
0ad0a61f05fe521a63ade9bfafd2f589fba0df33...4087a02e452aafd0e9a6c3471c40fe76d6aafbe4,2,17,1,18,5,2010-07-19 18:12:15,2010-07-17 17:00:50
4087a02e452aafd0e9a6c3471c40fe76d6aafbe4...7f40ab0916efd56943f55fde71d917433284fef8,3,14,1,15,4,2010-07-19 18:12:22,2010-07-17 17:00:51
0ad0a61f05fe521a63ade9bfafd2f589fba0df33...d1cc4621eda62222fbc929a7f65c89b6be678c2e,1,10,0,10,1,2010-07-19 16:16:09,2010-07-18 01:46:48
d1cc4621eda62222fbc929a7f65c89b6be678c2e...c173dad58787a7f11a526dbcdaa5a2fe9ff1c87f,1,0,3,3,2,2010-07-19 18:13:52,2010-07-19 16:26:12
449aeb10d5d28083199f82c444b55a03c545e956...dd1e5b313a0aef5d22cd9909c14e4b1b6dcbea79,4,47,8,55,16,2010-07-14 15:47:29,2010-07-14 11:59:57
449aeb10d5d28083199f82c444b55a03c545e956...c7d1d1b1329a104d2f7fe6307da4344288bc8e01,1,2,1,3,1,2010-07-14 14:57:08,2010-07-13 09:02:00
449aeb10d5d28083199f82c444b55a03c545e956...6bdc17d9a69bdd736901b115841479f5782a510e,2,12,12,24,3,2010-07-13 23:32:30,2010-07-13 21:23:38
6bdc17d9a69bdd736901b115841479f5782a510e...1e3d4119d21df2812584a09a18d35414efbc1336,2,43,11,54,12,2010-07-13 23:33:02,2010-07-13 21:23:39
637ab29b86533c7ce65a615fd445d163a2c57dc9...108da0db1277fc2f4820d0a47c02b2c63111f7a5,5,47,6,53,9,2010-07-12 22:13:54,2010-07-09 22:18:38
35eabd1579726d594e84fc8328a5c87693dd065a...65d41d48a4e4e795d64dd7842a44d693b741bf31,1,1,1,2,1,2010-01-29 17:52:21,2010-01-29 10:28:44
35eabd1579726d594e84fc8328a5c87693dd065a...93cfa7c7a85efbdb00daade4ad0afc11bd2fdf37,4,86,10,96,28,2010-01-26 21:51:41,2010-01-26 19:58:00
93cfa7c7a85efbdb00daade4ad0afc11bd2fdf37...a5e10acbb946305ca42f510cdb196d171020238e,1,2,2,4,2,2010-01-27 18:53:09,2010-01-27 18:53:09
a5e10acbb946305ca42f510cdb196d171020238e...6c647af3060b8dd20da0e0b21dcd0eb95ec70841,1,2,2,4,1,2010-01-27 18:54:30,2010-01-27 18:54:22
35eabd1579726d594e84fc8328a5c87693dd065a...5bf9219d01b16444b316fe764b58d15bd9265f74,2,12,4,16,3,2010-01-26 20:57:53,2010-01-26 18:24:12
5bf9219d01b16444b316fe764b58d15bd9265f74...222083a1585c058fd2bbcb76db1ea824ee3df17f,1,1,2,3,1,2010-01-26 20:57:59,2010-01-26 18:24:13
222083a1585c058fd2bbcb76db1ea824ee3df17f...3aee68aa68e80856de26340b707148d8f8d5b82e,1,1,2,3,2,2010-01-26 21:00:10,2010-01-26 18:24:14
3aee68aa68e80856de26340b707148d8f8d5b82e...4ab07e4d1076a1b94b91d58913daeb20eb1c0e2d,1,1,2,3,1,2010-01-26 21:00:16,2010-01-26 18:24:15
35eabd1579726d594e84fc8328a5c87693dd065a...f9acaeae880feb87ae52e719aab930bf1f3e8413,1,1,1,2,1,2010-01-26 20:54:18,2010-01-26 14:47:16
35eabd1579726d594e84fc8328a5c87693dd065a...e8dbd76d57806fd1305612d56d56a4cc7665c599,1,30,4,34,3,2010-01-26 18:52:52,2010-01-26 18:24:41
e8dbd76d57806fd1305612d56d56a4cc7665c599...9aa5053d9ffc7fade885b58a34175b4907b1a4f8,1,8,2,10,3,2010-01-26 18:52:52,2010-01-26 18:24:42
66d681998411e8e5034080d5267a5e0f6cdc0c17...74884b524e7e12b3419264d3180de785a9e39fa5,2,394,166,560,39,2010-03-13 06:09:18,2010-02-27 08:59:22
7c3baa9abf0abe15f068d95688bbc27e73a69042...492cf3f72f9d8a0308cc42a9ffc00ef782c88a20,1,13,4,17,4,2009-10-30 21:46:17,2009-10-29 21:29:35
492cf3f72f9d8a0308cc42a9ffc00ef782c88a20...f740cc25298e2a0eb7c561c40854ed568c7de657,1,1,1,2,1,2009-10-30 22:12:00,2009-10-30 15:04:53
f740cc25298e2a0eb7c561c40854ed568c7de657...ebc9d420566de32dbadada5a4f700db2d974853c,1,4,2,6,2,2009-10-30 22:15:36,2009-10-30 22:15:36
ebc9d420566de32dbadada5a4f700db2d974853c...d52dc4b10b2f78dc24ea05e88ddc25ee0f46491e,1,6,1,7,2,2009-10-30 22:18:11,2009-10-29 08:10:30
975457f185acd7c1f96ccff67cd5dc8dcb7908a0...024ab976fffdc1d78b6d0b15e261b52f3a5d594b,2,3,1,4,2,2009-10-23 19:00:41,2009-10-23 18:42:39
c1e01b0c5106451770ae77a62f52acfe814c3326...e5138436ddd4b5f75c1e910f6b844e4fcf91343d,2,10,1,11,2,2009-11-07 07:17:26,2009-11-07 07:06:06
2f312e8851035a85f431911075383265f1519c04...2d9932cf67a886c8f356603b9ffd81832cc1850f,1,2,0,2,1,2011-05-05 16:32:28,2011-05-05 06:40:17
2d9932cf67a886c8f356603b9ffd81832cc1850f...9fee24cac87078ae48b5a74ecafaca751f5edfd6,1,2,2,4,2,2011-05-05 17:18:18,2011-05-05 09:13:38
c8cba79181abc139d7cba364bf868875426fc2c1...8db751a8f953bf1a571e1fd825d1a4219e65b501,1,5,5,10,5,2010-01-15 05:51:06,2010-01-14 04:44:19
c8cba79181abc139d7cba364bf868875426fc2c1...cf6e7ba1c4c29fda3f16bfd4a4f1995ed45082d5,1,2,4,6,2,2009-12-31 20:40:34,2009-12-31 11:48:41
b6b9f83ea19de3a98ca8466977aac2dc0bc03626...ab0964d951e4ea88f9ea2cbb88388c1bcd4ae911,2,9,8,17,4,2009-12-20 20:15:02,2009-12-20 20:15:02
ab0964d951e4ea88f9ea2cbb88388c1bcd4ae911...577e9fcad2c8968846b365226b89778050496a78,1,5,1,6,1,2009-12-21 10:32:39,2009-12-21 10:06:04
577e9fcad2c8968846b365226b89778050496a78...af57b41d41d4b1f85dceac57015539e3e0306859,1,2,0,2,1,2009-12-21 10:32:41,2009-12-21 10:21:33
af57b41d41d4b1f85dceac57015539e3e0306859...1d144aa25edbb4dcda88abbaef8f336108b8d788,3,860,172,1032,93,2009-12-21 10:32:46,2009-12-19 16:20:30
1d144aa25edbb4dcda88abbaef8f336108b8d788...7d944c3399c4145293d599e1ddc76d1ac0c1e118,1,54,37,91,4,2009-12-21 10:32:48,2009-12-19 11:55:13
7d944c3399c4145293d599e1ddc76d1ac0c1e118...33973a5b179278c563624fcb45c223f03031b242,2,4,10,14,3,2009-12-21 10:32:50,2009-12-19 16:22:42
33973a5b179278c563624fcb45c223f03031b242...ea020cbd6aeb769d95e5c2dbffee4c81d6f92796,1,48,4,52,8,2009-12-21 10:32:52,2009-12-19 16:25:31
ea020cbd6aeb769d95e5c2dbffee4c81d6f92796...7a955a5365d9ebd5e12c12ed926b2b51b61c02ee,2,66,25,91,6,2009-12-21 10:32:53,2009-12-19 16:26:26
7a955a5365d9ebd5e12c12ed926b2b51b61c02ee...063681d72e60e80cd14576037728b395ed42e330,1,0,6,6,1,2009-12-21 22:33:50,2009-12-21 22:22:54
063681d72e60e80cd14576037728b395ed42e330...0fe19753f26e2747f48d1ec6a1761006d75c2d71,1,2,1,3,1,2009-12-22 20:15:40,2009-12-22 20:15:40
92f9e273e86d505e4c2a28bc053eb514ca2cc552...33f0ea42e12d3f54ef8ff53580649885c1503d05,1,4,2,6,2,2010-02-10 21:42:29,2010-02-09 18:06:33
80d93611c55fec171e0d9aba98db079952f9d7aa...0a043b1fe5615a1182aceda29da65faebaf6e970,1,3,1,4,2,2009-12-11 02:45:34,2009-12-10 14:01:10
ec7fc0b1a46c5a352532ea3f29c5663752fd8ac6...db9bc00e2be37c68589a345112e22dc37743fc5e,1,1,1,2,1,2009-11-30 16:47:54,2009-11-30 13:27:52
db9bc00e2be37c68589a345112e22dc37743fc5e...3c652d16713c27d0abb2003d83a237f7d47ef569,2,2,2,4,2,2009-12-01 20:09:46,2009-12-01 09:19:05
3c652d16713c27d0abb2003d83a237f7d47ef569...af6fbf9f814b3ee23b4b6d632131095c0278ae44,1,3,3,6,2,2009-12-01 20:10:09,2009-12-01 19:27:34
9deec58ad842fe9f2a2a221952e1eb351d3637e9...46ada61ef1950eb19eae8647b5ac13adb3e14dd2,1,4,4,8,1,2009-11-14 08:26:37,2009-11-14 01:45:46
1a507b9cf75bcb2de2391c584539e0ff202549bf...616f86d71325da1ce692f8e878fe066758f88554,1,12,6,18,5,2009-11-10 19:11:21,2009-11-09 15:04:59
616f86d71325da1ce692f8e878fe066758f88554...548d3464dc446db58a8fc8f7a8cc6cfb2d683faa,1,4,2,6,3,2009-11-10 19:59:51,2009-11-09 10:47:34
548d3464dc446db58a8fc8f7a8cc6cfb2d683faa...99caeed05d3e89176d352104a2b70a77aa7e5d81,8,36,15,51,12,2009-11-10 20:00:21,2009-11-09 15:05:01
99caeed05d3e89176d352104a2b70a77aa7e5d81...64b1cb74f8312c0a43ce32f51097172efc69355a,2,14,4,18,6,2009-11-10 20:00:21,2009-11-09 15:05:02
64b1cb74f8312c0a43ce32f51097172efc69355a...0874f46e711393b61f6375ab9e2cd4a0c2b812e9,1,1,1,2,1,2009-11-10 20:00:21,2009-11-09 15:05:03
0874f46e711393b61f6375ab9e2cd4a0c2b812e9...d74bb308fa9e49e0a5b9a0792e6079bbc0c8aea8,1,2,2,4,1,2009-11-10 20:00:21,2009-11-09 15:05:04
8f376a50ec6a125d4ac6786688cbfa5340dd59c0...703e6e76a14825e5b0c960d525f34e607154b4f7,1,16,2,18,3,2010-01-21 23:01:37,2010-01-21 14:41:00
703e6e76a14825e5b0c960d525f34e607154b4f7...19c6a4f8369f37c0df1fb57008a891eb6a6dc4bb,1,4,4,8,3,2010-01-22 01:02:30,2010-01-22 00:38:56
cea1e2e94c0574d5eb475c43d8c39cc950dc1b28...74f3267b0cbb9a1026fab3234c4bfefd971fbf9f,2,14,1,15,2,2013-01-21 01:26:04,2013-01-21 01:26:04
57ff1703d72db1cf33f985dcebfb03fdaab758dc...f3500825257b441134bd99b08bab3b6fd1cb4f51,3,23,2,25,6,2013-02-07 23:21:10,2013-02-07 23:21:10
264238f7bd160fd4d0949ca27856875910509aaa...bbc6f64b4eca0b792060ae8b8ccb58526dbbc076,1,8,0,8,1,2013-01-18 19:26:11,2013-01-18 19:26:11
4c2c5537c361760a71d2eec88cc56bd61ca74db0...f51a757fafc1e1ca9565381a13109932acd81dba,1,25,9,34,13,2013-02-04 18:44:26,2013-02-04 18:44:26
daebaa78137d59693a808c1f0bdec0ecb40fc12e...def249911ad0e36a40a0603fc42b7e9cf0b21546,1,12,17,29,6,2013-02-07 21:53:59,2013-01-29 20:58:50
def249911ad0e36a40a0603fc42b7e9cf0b21546...f2db854d24f32de7b03dde5a7d7134f5e31100b9,5,89,53,142,36,2013-02-07 21:53:59,2013-01-29 22:02:15
f2db854d24f32de7b03dde5a7d7134f5e31100b9...390eb36b0a9cbaa5051040c762b986ddd4b3848f,2,26,7,33,13,2013-02-07 21:56:52,2013-01-29 05:49:57
390eb36b0a9cbaa5051040c762b986ddd4b3848f...6e7b66eebd18c11f58a9790b8f071618a1bb5b2c,4,67,2,69,9,2013-02-07 22:07:53,2013-01-29 22:02:15
4cb8a83bb852010de8dc0887a54204a581536866...31e6a4e6131ae2b7afd6bd0ba7919bf246e6c474,1,13,14,27,2,2013-02-18 23:33:31,2013-02-18 22:59:03
31e6a4e6131ae2b7afd6bd0ba7919bf246e6c474...ce209d0c72677cce41c61bfc30a82f468df804ed,1,14,2,16,2,2013-02-18 23:59:33,2013-02-18 23:59:33
d040350813986e0f4bb3aeb977077975c1552606...8efb8899cfe866dddb3659b9e0a94232161db65e,2,48,0,48,6,2013-02-23 19:53:21,2013-02-23 12:22:27
d688cf07b15b664a2164c3d92bcb5e8265400a2b...c3a47ca9a78a59e88bb95ffe72fdafb289c0511b,1,4,4,8,4,2012-10-19 20:14:41,2012-10-19 17:14:42
d688cf07b15b664a2164c3d92bcb5e8265400a2b...9c6bebd14233af291ffb8dde2975b06c76e9ce5f,1,2,2,4,2,2011-10-27 18:38:24,2011-10-24 06:36:12
9c6bebd14233af291ffb8dde2975b06c76e9ce5f...ea4f9685cb432caf357ad8af56a91877b6d04663,1,2,1,3,1,2011-10-27 18:42:57,2011-10-27 18:42:57
d49483f0ca1be0994c4f20fe1804d36a28013676...4c1be38b4a236403a329187acb70591a7fd92150,1,7,0,7,1,2011-09-16 16:20:23,2011-09-16 00:09:41
d49483f0ca1be0994c4f20fe1804d36a28013676...bf7930caa0da2fbd6def59a54608ac494c272197,1,85,0,85,1,2011-07-21 21:10:42,2011-07-21 20:10:54
f612a71cc901e34f5cf154e6605b7251744f6b95...f23101bf9f29d1404fa8ab1cdab619c335cb7f17,2,4,4,8,4,2011-05-25 20:34:17,2011-05-25 19:43:59
e3fa2465518b9a7c4d714edcf9b28bb4138cbaa6...642f85faab27adec13eced36cd7e7548311f6c87,1,1,1,2,1,2011-04-11 17:33:51,2011-04-07 18:41:48
642f85faab27adec13eced36cd7e7548311f6c87...ff46a49afadc92bf16ab1ec2dab6d31487de23cb,1,2,1,3,1,2011-04-11 17:34:50,2011-04-10 19:37:01
225f78c817755bebff91629cc525a258cf60eaea...75df714487fd5d40b370f2d0f993f347d0170599,1,1,1,2,1,2010-01-26 16:08:54,2010-01-26 15:47:25
75df714487fd5d40b370f2d0f993f347d0170599...beeb4564bb7133fd12e6811a701686982b10cc2f,1,25,24,49,5,2010-01-26 16:08:55,2010-01-26 15:49:33
beeb4564bb7133fd12e6811a701686982b10cc2f...30248886ce89e5467ce734908775ed90b9138e99,1,2,0,2,1,2010-01-26 16:08:55,2010-01-26 15:51:24
30248886ce89e5467ce734908775ed90b9138e99...c373991375a4903dbb9bea69e2ce11ce819253e2,1,7,2,9,3,2010-01-26 16:08:55,2010-01-26 15:52:11
c373991375a4903dbb9bea69e2ce11ce819253e2...dfea575017ddc2ae7c9e8dcb978f4557f07715d3,2,45,5,50,8,2010-01-26 16:08:55,2010-01-26 15:52:49
73481593800a4aa17eb6a3d8c5740485735d3686...75ed918bda00a0786bab7de3d220765226fe3f1e,1,54,15,69,7,2012-12-12 05:49:25,2012-12-11 21:36:57
68bdfd7cdc634693320486c06400b60abe92302b...692663303f67371a2e4af4e3d353b042f754c036,1,3,2,5,1,2012-10-15 21:57:16,2012-10-15 06:24:34
692663303f67371a2e4af4e3d353b042f754c036...593cb8802eb43b17e6344790278cea7e6ec68b43,1,24,13,37,2,2012-10-15 21:57:16,2012-10-15 06:24:35
593cb8802eb43b17e6344790278cea7e6ec68b43...a3ea4d7199870595eb3a264c4b41e725b4417bc2,2,7,1,8,2,2012-10-15 21:57:16,2012-10-15 06:24:36
a3ea4d7199870595eb3a264c4b41e725b4417bc2...b559263216146b3f452c35ea1b12937d5533c89e,1,53,32,85,4,2012-10-15 21:57:16,2012-10-15 06:24:37
b559263216146b3f452c35ea1b12937d5533c89e...84460eec8dcc82417840bf4be2eb0c13d14b1c94,2,50,23,73,11,2012-10-15 21:57:16,2012-10-15 06:24:38
84460eec8dcc82417840bf4be2eb0c13d14b1c94...82dce998c2028b6ee96691921b7037a6e182ec89,5,64,32,96,14,2012-10-15 21:57:17,2012-10-15 06:24:39
4daf6fc837f7cc84335958b9d9e8a29e41b4ee8e...58d4203aa617293d1dc3746a1ea33d84eb766e0f,1,19,3,22,4,2012-02-13 19:46:47,2012-02-13 19:46:47
ee8d52f83985ba897dab2829823fbcfe40083cf6...b6b3b6a01f357922ccd14f2615accc9bd39fc194,1,22,1,23,2,2012-02-10 22:16:32,2012-02-10 22:15:38
9684e44a07495ad6ff0fa57f1d0cb7479b72e453...e6bcd979684d5a050bcb5d642e761e0ea350c6ec,1,1,1,2,1,2011-09-12 23:40:06,2011-09-07 20:56:38
e6bcd979684d5a050bcb5d642e761e0ea350c6ec...29753cddc8007ac63754855d026fe5eca8897d04,6,17,14,31,7,2011-09-12 23:41:53,2011-09-09 18:54:58
3793ac56b4c4f9bf0bddc306a0cec21118683728...d4e85a1afe0a3310a3c8336c2824775901cc27d7,2,18,1,19,3,2011-10-05 20:45:16,2011-09-23 13:38:36
d4e85a1afe0a3310a3c8336c2824775901cc27d7...f9b1a5b9b8aab5d544666ca2aa227528f00484f1,1,9,0,9,3,2011-10-05 20:45:29,2011-09-15 21:10:22
f9b1a5b9b8aab5d544666ca2aa227528f00484f1...e4ed6105ec4a8507d4bd9f6355647fa911e4731f,3,152,21,173,18,2011-10-05 20:45:29,2011-09-15 21:10:23
e4ed6105ec4a8507d4bd9f6355647fa911e4731f...9224b73be03845a99f8171c57dc282f806b70f4c,1,6,9,15,6,2011-10-05 20:45:29,2011-09-15 21:10:24
9224b73be03845a99f8171c57dc282f806b70f4c...8d9c50105f908b2adde4b7c77537cf95f19cd893,20,69,126,195,51,2011-10-05 20:45:29,2011-09-15 21:10:25
8d9c50105f908b2adde4b7c77537cf95f19cd893...49295d4e3fb58c6179b7434cd87805f86cb1f7b7,1,55,40,95,8,2011-10-05 20:45:29,2011-09-15 21:10:26
49295d4e3fb58c6179b7434cd87805f86cb1f7b7...7e9d2fe96060957d90870d2fac9b85608423e277,3,7,9,16,6,2011-10-05 20:45:30,2011-09-15 21:10:27
7e9d2fe96060957d90870d2fac9b85608423e277...7f748c7cb2317800dcdb311c3e75a086ae0d1600,1,10,9,19,8,2011-10-05 20:45:30,2011-09-15 21:10:28
7f748c7cb2317800dcdb311c3e75a086ae0d1600...a5e4ec063afea050d09773f0aa5dcb95a82a31ec,1,7,9,16,4,2011-10-05 20:45:30,2011-09-15 21:10:29
a5e4ec063afea050d09773f0aa5dcb95a82a31ec...a40e6fb67a4aed2d5ffde5792bf7f1996d9666e1,5,49,28,77,23,2011-10-05 20:45:30,2011-09-15 21:10:30
a40e6fb67a4aed2d5ffde5792bf7f1996d9666e1...7bb2bf8e5cc47f7731c9c012ecc943b14f99ee5a,1,2,0,2,1,2011-10-05 20:45:30,2011-09-15 21:10:31
7bb2bf8e5cc47f7731c9c012ecc943b14f99ee5a...b54cb795970628714a3a9fa0f4a73cd117b0207f,1,2,2,4,1,2011-10-05 20:45:30,2011-09-15 21:10:32
b54cb795970628714a3a9fa0f4a73cd117b0207f...1f58a0383857e5328e3e4d248d6c4a3485098679,1,2,1,3,1,2011-10-05 20:45:30,2011-09-15 21:10:33
1f58a0383857e5328e3e4d248d6c4a3485098679...287750507d3859ff65a7b0baac5ba1fdf30e9604,1,10,10,20,4,2011-10-05 20:45:30,2011-09-15 21:10:34
287750507d3859ff65a7b0baac5ba1fdf30e9604...c224ca7f66bf88bf933d05ecbc163b5bbb152098,1,34,13,47,5,2011-10-05 20:45:30,2011-09-15 21:10:35
c224ca7f66bf88bf933d05ecbc163b5bbb152098...313fb010da4343eca22ee48a2cc18048d999de53,1,5,0,5,1,2011-10-05 20:45:31,2011-09-15 21:10:36
313fb010da4343eca22ee48a2cc18048d999de53...c28cce55e0ea1d674ccc89cadadac0bfef511384,2,3,3,6,3,2011-10-05 20:45:31,2011-09-15 21:10:37
c28cce55e0ea1d674ccc89cadadac0bfef511384...d51b720fca4ee5418952a90f785317592a7a1242,1,4,2,6,1,2011-10-05 20:45:31,2011-09-15 21:10:38
d51b720fca4ee5418952a90f785317592a7a1242...8384d78886eca05cae2a4c1bccaee379d76c1e06,1,3,0,3,1,2011-10-05 20:45:31,2011-09-15 21:10:39
8384d78886eca05cae2a4c1bccaee379d76c1e06...629cd3ac6d081b43c8cdb045845be1fedbc89615,1,4,2,6,4,2011-10-05 20:45:31,2011-09-15 21:10:40
629cd3ac6d081b43c8cdb045845be1fedbc89615...f989fea0e0b47873de62a355f4766f03a88fb01b,1,2,1,3,1,2011-10-05 20:45:31,2011-09-15 21:10:41
f989fea0e0b47873de62a355f4766f03a88fb01b...7cb368421f62318f2c0f0e19a83ca34c201aebaa,2,33,13,46,2,2011-10-05 20:45:31,2011-09-15 21:10:42
7cb368421f62318f2c0f0e19a83ca34c201aebaa...dce4bab6567de7c458b334e029e3dedcab5f2648,2,19,5,24,6,2011-10-05 20:45:31,2011-09-15 21:10:43
b61f55be0060ab47b154d979f919dd969f29d314...5976753e732186d7f8a5c6af55a8ce3e2d2b677b,1,29,0,29,1,2012-09-17 23:00:39,2012-09-17 23:00:39
d1ba7a4cb77b64993a56b06c1497d1ab78094cc4...fc8fcd27e67ad06689a823dd83a929624e359cc1,2,41,1,42,3,2012-02-20 06:21:35,2012-02-15 16:37:06
fc8fcd27e67ad06689a823dd83a929624e359cc1...233054d114b0d68cf58d18f4c7ddd7723c08b24f,1,3,0,3,1,2012-02-20 08:14:00,2012-02-20 08:14:00
d1ba7a4cb77b64993a56b06c1497d1ab78094cc4...3d1f148c3381de410a9b02a05bde05cd0fb17a0c,2,24,2,26,5,2012-02-17 18:11:05,2012-02-17 18:11:05
6f5e880c68099b185e60b2492c75e506e16d8292...bcc0a3ea38a42a64878e11c5244ef2fcc967e05d,10,127,0,127,11,2012-03-30 15:57:49,2012-03-29 07:21:21
bcc0a3ea38a42a64878e11c5244ef2fcc967e05d...a762e51ef2a39b0c326a1529dbe7f4cb303960db,3,35,15,50,12,2012-03-30 15:58:31,2012-03-29 07:21:23
a762e51ef2a39b0c326a1529dbe7f4cb303960db...eb21c732d6b642a8f33abd69071a95de01d5061b,7,179,6,185,10,2012-03-30 16:02:55,2012-03-29 07:21:24
6f5e880c68099b185e60b2492c75e506e16d8292...2b21008d3c43d41588e84b45907bb8c2e86278f6,1,3,0,3,1,2012-02-13 23:57:06,2012-02-13 22:28:10
2b21008d3c43d41588e84b45907bb8c2e86278f6...097128d1bce7194702f336e30c5e228aa8ba774f,1,26,2,28,3,2012-02-13 23:57:06,2012-02-13 22:32:47
097128d1bce7194702f336e30c5e228aa8ba774f...6463fd7ed189f4100e1102062f29b969384f1436,1,14,8,22,6,2012-02-13 23:57:06,2012-02-13 22:33:10
6463fd7ed189f4100e1102062f29b969384f1436...34d9819e0a387be6d49cffe67458036450d6d0d5,2,52,34,86,6,2012-02-13 23:57:06,2012-02-13 22:36:36
34d9819e0a387be6d49cffe67458036450d6d0d5...a0b676aaee29446388cd57fc555a740f9d26eea3,1,93,0,93,1,2012-02-13 23:57:07,2012-02-13 22:37:33
b76a9e164854a7a87a2f21859f05b132ee5b83d9...40a0f842daca9ebcb0e0f286b9af74c05ae4a1ae,1,4,0,4,1,2013-04-01 16:23:05,2013-04-01 16:23:05
0ee7198f457c8ea031b09b528cfd88f0f0e630d8...dff9f8835f2f2820c4e7109d242cb06b39f7d065,4,15,3,18,5,2013-02-20 05:54:22,2013-02-19 05:48:05
b700086d840ceaee339f9f031be72b34e237f84f...8d141a1d562abb31f27f599dbf6e10a6c06ed73e,4,57,3,60,5,2012-07-11 19:59:41,2012-07-11 19:55:38
dc813f664d779330c392500a0f3b4d53893dc7ae...42325fb2e078377a3914bf1d80160f22cb1f78d6,2,47,1,48,2,2012-05-07 20:24:32,2012-05-07 20:24:13
a95750c4e8f78eb89c277abd41f05be58715314f...90020e3bcd2108baecc79144319c86ad865c8c5e,3,14,2,16,6,2012-02-14 17:53:38,2012-02-14 17:53:38
d909e0761c234b28aac77566368c1ee5451a856a...97afde15f58728138f8e178b2acb7c72473f7d96,1,1,1,2,1,2012-04-26 15:08:07,2012-04-26 05:53:59
97afde15f58728138f8e178b2acb7c72473f7d96...8258858493ad3504630c3bfa7dfde61df811994a,4,18,3,21,5,2012-04-26 16:41:52,2012-04-26 16:41:52
d909e0761c234b28aac77566368c1ee5451a856a...aea69a016f5bda67c359e43a3cbfabe923ad0f5a,1,3,2,5,2,2012-03-20 19:08:30,2012-03-20 08:05:34
aea69a016f5bda67c359e43a3cbfabe923ad0f5a...b18e97ceb938362c0be62997ba333d4ad36226e4,1,6,0,6,1,2012-03-20 19:30:56,2012-03-20 08:05:34
b18e97ceb938362c0be62997ba333d4ad36226e4...e2c59667ed0a495998b911628de5389a0ee9a728,1,290,0,290,1,2012-03-20 19:31:07,2012-03-20 08:05:34
d909e0761c234b28aac77566368c1ee5451a856a...4b340593551217904d794cc0a8db55db89b5b066,2,40,4,44,7,2012-03-12 16:39:06,2012-03-09 21:57:54
d0482e88a735787f7bb33ef4783be0e7f6a70946...0f871cf56e83d13116b021295688e57f26bbf93d,3,42,8,50,4,2012-02-28 22:29:37,2012-02-28 22:20:53
0f871cf56e83d13116b021295688e57f26bbf93d...accccde483c3cfd55ef55037e8802ca0baaee5a1,4,128,2,130,6,2012-02-29 00:15:29,2012-02-21 09:02:46
accccde483c3cfd55ef55037e8802ca0baaee5a1...f1589d100796c58615033dde10c1c6446b814357,2,3,3,6,2,2012-03-05 05:17:25,2012-03-04 19:10:57
d0482e88a735787f7bb33ef4783be0e7f6a70946...39cb6445d9bf5794723bb656499168c3d1b31774,1,1,0,1,1,2012-02-26 22:31:26,2012-02-24 23:42:42
39cb6445d9bf5794723bb656499168c3d1b31774...ad687b447a87efaf61c39075da2ef81b85715186,1,7,4,11,1,2012-02-27 00:32:37,2012-02-25 04:31:22
ad687b447a87efaf61c39075da2ef81b85715186...f0c5793b37a53992611968ab4a1d62a0e3edc2dd,2,11,1,12,2,2012-02-27 00:32:54,2012-02-25 17:34:26
f0c5793b37a53992611968ab4a1d62a0e3edc2dd...fba4f1259db8e5dc47b1c8e6e344c61f7eb4a9df,1,1,1,2,1,2012-02-27 00:34:03,2012-02-25 09:24:28
fba4f1259db8e5dc47b1c8e6e344c61f7eb4a9df...c524ceb12f65e2ad4fc68c9d5b39f6e4b6b5c17b,3,21,2,23,3,2012-02-27 00:40:20,2012-02-27 00:40:20
d0482e88a735787f7bb33ef4783be0e7f6a70946...92ac3197e4859ba8c19e3e7f7b8cf5dc38e4669d,2,20,2,22,6,2012-02-24 22:11:27,2012-02-24 22:02:37
92ac3197e4859ba8c19e3e7f7b8cf5dc38e4669d...4c3b57b98bccfdb740b8f1d0ca574dd51deacfad,1,10,2,12,3,2012-02-24 22:12:19,2012-02-24 22:05:03
4c3b57b98bccfdb740b8f1d0ca574dd51deacfad...4f22b1015d4203ccdf2b66f27ee5946504342ace,2,95,5,100,3,2012-02-24 22:18:20,2012-02-24 22:10:17
d0482e88a735787f7bb33ef4783be0e7f6a70946...4056afbcf2d3ee3e9df2788656f3197cc363a2ee,1,7,4,11,2,2012-02-23 05:55:06,2012-02-23 05:55:06
4056afbcf2d3ee3e9df2788656f3197cc363a2ee...a61ba26a4725d4a93297305315587b92324baf0b,1,15,0,15,2,2012-02-27 07:02:59,2012-02-27 07:00:47
d0482e88a735787f7bb33ef4783be0e7f6a70946...5e8617f560968567c285bc2e9b0674f8f9d535cb,3,19,19,38,5,2012-02-23 02:58:16,2012-02-22 19:34:22
5e8617f560968567c285bc2e9b0674f8f9d535cb...bc2fed496baa54ae99dede7da23dec938adbf0eb,2,24,7,31,7,2012-02-23 17:36:44,2012-02-22 19:34:23
bc2fed496baa54ae99dede7da23dec938adbf0eb...1c5f93b9a69f4c1c3d09853243562b9ae3bf79a6,1,17,1,18,2,2012-02-23 21:52:11,2012-02-23 09:42:21
1c5f93b9a69f4c1c3d09853243562b9ae3bf79a6...8a557bb77fc009b00f7952f0d3d6ebd33079f70e,1,8,25,33,11,2012-02-23 21:53:27,2012-02-23 09:42:23
d0482e88a735787f7bb33ef4783be0e7f6a70946...690b29758289ac81062159c178b6d917f06e9862,1,11,11,22,3,2012-02-22 23:56:27,2012-02-22 22:27:07
d0482e88a735787f7bb33ef4783be0e7f6a70946...6424c2ad12cf6c3feb533fab9c4dded7514d0f4c,1,5,0,5,3,2012-02-21 20:48:09,2012-02-20 20:53:37
d0482e88a735787f7bb33ef4783be0e7f6a70946...2eeeef24ff5a6538f41f5fe44f3a4e7f6e36e7e5,1,20,7,27,4,2012-02-14 22:21:49,2012-02-14 21:49:11
d0482e88a735787f7bb33ef4783be0e7f6a70946...ad6c3739a33586ba15a8c5c245dcd59e8a31cef1,3,38,22,60,4,2012-02-13 23:08:47,2012-02-12 14:12:32
d0482e88a735787f7bb33ef4783be0e7f6a70946...ef7e93d90866e91bba5ff7f274c49dc44427a8ff,2,35,11,46,9,2012-02-13 21:29:08,2012-02-13 20:17:12
d0482e88a735787f7bb33ef4783be0e7f6a70946...cb8da70547af5cd5c8e03be5a236971951e81277,2,28,2,30,3,2012-02-13 20:49:15,2012-02-13 20:17:11
d0482e88a735787f7bb33ef4783be0e7f6a70946...ace5e97ecdf6a6ad8fd4ba443486fbe0058eb37a,1,3,0,3,1,2012-02-09 22:31:48,2012-02-08 10:59:04
9d3d78435f2735b74afc74e9c5a735c27c026d33...e3f55e07076f88ec01a49dcfb7c2ac56658145a4,1,1,4,5,1,2012-01-05 21:02:26,2012-01-04 20:43:02
e3f55e07076f88ec01a49dcfb7c2ac56658145a4...c871a1d17b8433d98df59b03da5538f10c4ae52c,4,36,8,44,8,2012-01-05 21:02:26,2012-01-05 18:54:14
c871a1d17b8433d98df59b03da5538f10c4ae52c...c6b3ec41e2efdd9e05118c2e99ad70f0e0629873,1,16,12,28,3,2012-01-05 21:02:26,2012-01-04 21:48:45
c6b3ec41e2efdd9e05118c2e99ad70f0e0629873...824958e50b250e957998626a21763603ca30e832,1,75,1,76,3,2012-01-05 21:02:27,2012-01-04 21:51:28
824958e50b250e957998626a21763603ca30e832...d041ffa55a69cb6cdc3b160dc181c7e59b3bd4bb,1,12,0,12,2,2012-01-05 21:02:27,2012-01-05 00:23:12
110f415ce87730db48baae086b8c5f1344451bf4...b75a6ca7f3ab793e61b3229d29dceb7a4ec07cbc,1,8,0,8,1,2013-10-14 19:48:06,2013-10-12 00:45:46
b75a6ca7f3ab793e61b3229d29dceb7a4ec07cbc...0b4dc66169da5040951c6f575978c4b962934f94,1,1,1,2,1,2013-10-14 23:00:37,2013-10-06 20:48:29
0b4dc66169da5040951c6f575978c4b962934f94...ce1e8462070868bd83f9bc79f90f62d6927f8332,1,1,1,2,1,2013-10-14 23:10:50,2013-10-06 20:49:18
ce1e8462070868bd83f9bc79f90f62d6927f8332...ec145c9c2ef0ddf0ca8b57b968054f4db9de63b3,1,2,0,2,2,2013-10-14 23:16:00,2013-10-06 20:50:00
c9bfb953489e559d513c1627150aa16f8d42d6c5...787570c7cddea7ffe3cb2e52c8af169bb17ba29b,2,10,1,11,2,2011-09-12 18:43:58,2011-09-12 17:46:41
c9bfb953489e559d513c1627150aa16f8d42d6c5...92058e4d3e032714da6d2df5fa1fe2cf612979a5,2,38,0,38,2,2011-08-19 22:52:25,2011-08-18 22:01:32
ec099546a9afdb73b6bf39d5d684e6fb207e2a7f...885b797a4abe1fdfe7c4273caa34207d6e5e4760,1,1,1,2,1,2011-08-22 17:07:07,2011-08-22 10:33:52
ec099546a9afdb73b6bf39d5d684e6fb207e2a7f...e9d4f7405b6ab399ef0ea62a796c646de676555d,2,15,1,16,2,2011-08-19 18:01:36,2011-08-19 11:45:43
c81e2c61b387b7fc3ef8c303f0f8ac76411b465d...072dda68eafdefe56f9305c547771367353cf89d,2,35,1,36,2,2013-04-03 16:12:11,2013-04-03 16:12:11
4d8b32a2e1758236c4c1b714f179892e3bce982c...60e199c4d577514ed810b4ed0b6072fb3dbab903,1,6,11,17,3,2011-04-18 21:14:53,2011-04-18 21:14:53
e0a4aae865862549c5f2a65016d4d264843e7914...70eb130768d17c33b9efbf60d7953cf6a57daecb,1,1,1,2,1,2012-03-02 17:33:29,2012-02-29 19:13:22
25a7850a106ed0f27b88b8ce0b89fd326120dff4...9ba604a9e474142c0fa1cd03830e2281cde5e66d,1,5,0,5,1,2012-04-11 18:08:43,2012-04-11 05:49:46
9ba604a9e474142c0fa1cd03830e2281cde5e66d...5272f75587abb4cb396059ecbf1a6130bb2e69d3,1,75,53,128,8,2012-05-07 22:45:03,2012-05-06 12:31:54
5272f75587abb4cb396059ecbf1a6130bb2e69d3...b8a2486f1524947f232f657e9f2ebf44e3e7a243,4,244,12,256,28,2012-05-07 22:48:15,2012-05-06 12:31:55
b8a2486f1524947f232f657e9f2ebf44e3e7a243...b038a61020573b1be6e5fc5b2be4485b63a9cbf1,1,5,0,5,1,2012-05-07 22:48:19,2012-05-06 12:31:56
d4d5ab4727edd1758157dd0b61c1ff3b7deabfcd...487da9cdf4fc4e3735cede5a31c2ac7be18b50b2,1,3,2,5,3,2011-11-18 18:45:33,2011-11-18 10:02:02
b39c3612eb443e77bd04d645578e1155988c6dde...16758621d5a4a78eed7c183b60bf7ebaeaf305c5,1,2,1,3,1,2010-02-23 21:11:28,2010-02-23 20:11:12
16758621d5a4a78eed7c183b60bf7ebaeaf305c5...689b8c290db9d5880699dd3538134daffc1c55d0,1,6,3,9,3,2010-02-23 22:24:43,2010-02-23 20:11:53
689b8c290db9d5880699dd3538134daffc1c55d0...29b67543d3060a08bee601dbad91dd400e833052,1,1,2,3,2,2010-02-23 22:26:29,2010-02-22 14:35:46
b39c3612eb443e77bd04d645578e1155988c6dde...21da42621489df7824f1fce7180702a9aa540707,1,4,5,9,2,2010-02-20 17:24:19,2010-02-19 03:29:30
21da42621489df7824f1fce7180702a9aa540707...3909f14f62fe81d65e62a2fe6b0e3a8c1661d422,1,3,3,6,2,2010-02-24 23:41:27,2010-02-24 23:41:27
3909f14f62fe81d65e62a2fe6b0e3a8c1661d422...18879bc52668123d75f0e03e27d5e731bf9b40ee,1,2,2,4,1,2010-02-25 03:10:22,2010-02-25 00:11:23
d55e7c3acf72413563e695a19f7f66efac442064...2858028e1ab6c79f39ec0057d2034bcbe9f47cf9,1,1,1,2,1,2007-10-16 04:59:17,2007-10-15 17:48:27
2858028e1ab6c79f39ec0057d2034bcbe9f47cf9...5040beff0bacac79b305fbfa4df71e99c2f13ed8,1,21,0,21,1,2007-10-16 05:18:37,2007-10-15 17:51:30
5040beff0bacac79b305fbfa4df71e99c2f13ed8...ff9054627c40082ad4a1cf16afebb140fcda41a2,1,24,1,25,2,2007-10-16 05:18:43,2007-10-15 04:47:30
ff9054627c40082ad4a1cf16afebb140fcda41a2...9de6d079200a50c0a61a5489e74419cb73993184,1,0,5,5,1,2007-10-16 05:19:25,2007-10-15 22:32:45
9de6d079200a50c0a61a5489e74419cb73993184...fd499bcc9d749db7c2108802701f6a1195e4a958,1,43,44,87,6,2007-10-17 00:33:13,2007-10-15 07:19:12
fd499bcc9d749db7c2108802701f6a1195e4a958...54f0db79ca11d08a448e45cfcb6e4304c6d16014,1,2,2,4,2,2007-10-17 02:48:20,2007-10-16 08:08:14
f3caeb9ac2ea13cf113183540f32fbc4c0468ed5...ece7b74903007cee8d280573647243d46a6f3a95,2,39,2,41,3,2007-09-17 01:20:10,2007-09-17 00:24:57
ece7b74903007cee8d280573647243d46a6f3a95...d7416ecac8508367a8ac35ab74ef09b7707d0c4b,1,10,3,13,3,2007-09-17 09:18:44,2007-09-16 22:49:00
077d6f72c7db84d2b6b3db879e3d68ab60482d43...17ed158021ead9cb056f692fc35ff3fcde96a747,1,3,3,6,2,2007-09-20 07:10:48,2007-09-20 05:23:01
077d6f72c7db84d2b6b3db879e3d68ab60482d43...45c1741235a1fbd54484fa1c67ea68569dcfa23e,4,40,39,79,21,2007-09-19 10:22:29,2007-09-11 03:02:28
45c1741235a1fbd54484fa1c67ea68569dcfa23e...fc57b6aaa5bc59ecbe0c052b98196a93b35760a5,4,36,7,43,9,2007-09-19 10:22:30,2007-09-11 03:02:34
fc57b6aaa5bc59ecbe0c052b98196a93b35760a5...fbdeef948bbc085124f9634d5108940dce5fc688,8,4,677,681,12,2007-09-19 10:22:30,2007-09-11 03:02:40
fbdeef948bbc085124f9634d5108940dce5fc688...30ae764b1e11f10b5fca723a876a0f3de3ca11ab,9,271,230,501,119,2007-09-19 10:22:30,2007-09-11 03:02:45
30ae764b1e11f10b5fca723a876a0f3de3ca11ab...0012ba2108aa42947dedf19f3db2de73a67cc4f5,2,6,0,6,2,2007-09-19 10:22:30,2007-09-11 03:02:51
0012ba2108aa42947dedf19f3db2de73a67cc4f5...cf818348f1ab577d2ecb5d11a00a1d4122435ece,2,164,11,175,11,2007-09-19 10:22:30,2007-09-11 03:02:56
cf818348f1ab577d2ecb5d11a00a1d4122435ece...2d4177c01c238071777db5b1fbd8a14efb62ce02,5,86,22,108,19,2007-09-19 10:22:30,2007-09-11 03:03:00
2d4177c01c238071777db5b1fbd8a14efb62ce02...9b288516ee63cea91dd9d102edcdf112caea4c75,4,280,62,342,19,2007-09-19 10:22:30,2007-09-11 03:03:04
9b288516ee63cea91dd9d102edcdf112caea4c75...d71ab17470ab2011c7cb398b75385bb0d0c4bdb4,2,148,1,149,9,2007-09-19 10:22:30,2007-09-11 03:03:08
d71ab17470ab2011c7cb398b75385bb0d0c4bdb4...c29727d5241be0fee2265fbbe65d1b275b01dc1c,2,302,3,305,18,2007-09-19 10:22:30,2007-09-11 03:03:11
c29727d5241be0fee2265fbbe65d1b275b01dc1c...30415d50cccef0ec22bb4a6d58138760b142758d,4,375,360,735,8,2007-09-19 10:22:30,2007-09-11 03:03:15
30415d50cccef0ec22bb4a6d58138760b142758d...c7a8a16239c6bdbb4041dd8a8773ae055d3cccf8,1,51,1,52,5,2007-09-19 10:22:30,2007-09-11 03:03:21
c7a8a16239c6bdbb4041dd8a8773ae055d3cccf8...b888d61c8308027433df9c243fa551f42db1c76a,17,571,15,586,17,2007-09-19 10:22:30,2007-09-11 03:03:25
b888d61c8308027433df9c243fa551f42db1c76a...1aad91f5a715af92892aea7764beb829938ab111,1,1,1,2,1,2007-09-19 10:22:30,2007-09-14 07:31:07
1aad91f5a715af92892aea7764beb829938ab111...4ad1eada9774a1f340beb4fdf78f1735534741bb,1,1,1,2,1,2007-09-19 10:22:30,2007-09-14 07:31:09
4ad1eada9774a1f340beb4fdf78f1735534741bb...133296f00cd441b5525ccc3e82ee13cbfc62d246,2,0,11,11,2,2007-09-19 10:22:30,2007-09-14 07:31:11
133296f00cd441b5525ccc3e82ee13cbfc62d246...f1ae391e17be638a14c7505598b73430dbf328f1,1,0,20,20,3,2007-09-19 10:22:30,2007-09-14 07:31:13
f1ae391e17be638a14c7505598b73430dbf328f1...7a2bff45937a60d846abf3ccb42015539aedcb40,1,3,8,11,4,2007-09-19 10:22:30,2007-09-14 07:31:18
7a2bff45937a60d846abf3ccb42015539aedcb40...425b1393139d99d89c7a95906686d9b041f2ee3d,3,27,39,66,22,2007-09-19 10:22:30,2007-09-14 07:31:21
425b1393139d99d89c7a95906686d9b041f2ee3d...106764e6515dd0fb9fda8bb8cab523932ae903b3,3,29,22,51,5,2007-09-19 10:22:30,2007-09-14 07:31:16
106764e6515dd0fb9fda8bb8cab523932ae903b3...1788c39cd0742439b9bedc28bc10bc4d105b6c0f,5,44,13,57,21,2007-09-19 10:22:30,2007-09-14 07:31:23
1788c39cd0742439b9bedc28bc10bc4d105b6c0f...e4022ed2c85825f238661e3e532b0bb108b5e318,1,16,1,17,3,2007-09-19 10:22:31,2007-09-14 07:31:25
e4022ed2c85825f238661e3e532b0bb108b5e318...e8a37b89f7c4fd4a10104a1c4d6021a707f70613,1,0,1,1,1,2007-09-19 10:22:31,2007-09-14 22:59:53
e8a37b89f7c4fd4a10104a1c4d6021a707f70613...e4cd6c7a20bfc776086817671d58e09060a8079a,1,5,2,7,3,2007-09-19 10:22:31,2007-09-14 22:57:11
e4cd6c7a20bfc776086817671d58e09060a8079a...3278cd0a39c30c6c3082fc5feed0f9bd98b5f628,1,5,2,7,4,2007-09-19 10:22:31,2007-09-15 07:23:00
3278cd0a39c30c6c3082fc5feed0f9bd98b5f628...b6abb48a152879259ab59f6e470e62b59562d712,1,1,1,2,1,2007-09-19 10:22:31,2007-09-15 07:23:04
b6abb48a152879259ab59f6e470e62b59562d712...8eb554ae628d2504922912fb5f046741da4654fc,1,10,17,27,7,2007-09-19 10:22:31,2007-09-15 07:23:07
8eb554ae628d2504922912fb5f046741da4654fc...be6042cfa59358b733b6f9ba05bcbc317998d9fe,1,1,1,2,1,2007-09-19 10:22:31,2007-09-15 07:23:10
be6042cfa59358b733b6f9ba05bcbc317998d9fe...e5f4e214636f9c9bd36c2897634108d5ad5587a1,4,20,11,31,10,2007-09-19 10:22:31,2007-09-15 07:23:14
e5f4e214636f9c9bd36c2897634108d5ad5587a1...b3abdd9d216c578383b66bb10b95edb3380640e7,1,2,1,3,1,2007-09-19 10:22:31,2007-09-16 06:31:26
b3abdd9d216c578383b66bb10b95edb3380640e7...ad23603c3af77b47f65382ea22b30d1ecccaab6f,1,0,4,4,1,2007-09-19 10:22:31,2007-09-16 06:32:11
ad23603c3af77b47f65382ea22b30d1ecccaab6f...f38395905b3d49bd68e0c01ca2310bf3387e1063,1,0,2,2,1,2007-09-19 10:22:31,2007-09-16 06:32:17
f38395905b3d49bd68e0c01ca2310bf3387e1063...27e13374bf1864eb8aea44cca3afd81eedb007aa,1,1,2,3,1,2007-09-19 10:22:31,2007-09-18 08:54:48
27e13374bf1864eb8aea44cca3afd81eedb007aa...d8b3a2bf189a9e7fea76454157b77fa71c9abc05,1,1,2,3,1,2007-09-19 10:22:31,2007-09-18 08:54:51
d8b3a2bf189a9e7fea76454157b77fa71c9abc05...85682c1903a4ae776b0bf2d30d9ecd1e19689131,11,51,23,74,21,2007-09-19 10:22:31,2007-09-18 08:54:53
85682c1903a4ae776b0bf2d30d9ecd1e19689131...ab865e6eec1f40938604b1c28a32525c1fdc7227,2,17,12,29,5,2007-09-19 10:22:31,2007-09-18 08:54:57
ab865e6eec1f40938604b1c28a32525c1fdc7227...bbaf4584286657582a92d5bb4038a5a06654ebb1,1,6,6,12,3,2007-09-19 10:22:31,2007-09-18 08:55:00
bbaf4584286657582a92d5bb4038a5a06654ebb1...28b91f8ad9e4791b5c35ca6bffbb78725b4e5bbf,5,26,26,52,18,2007-09-19 10:22:31,2007-09-19 04:49:27
28b91f8ad9e4791b5c35ca6bffbb78725b4e5bbf...824d5776c3f275c644c71b8c7e254bd2d7b08071,3,30,51,81,22,2007-09-19 10:22:31,2007-09-19 04:49:31
824d5776c3f275c644c71b8c7e254bd2d7b08071...fa74052922cf39e5a39ad7178d1b13c2da9b4519,3,55,74,129,50,2007-09-19 10:22:31,2007-09-19 04:49:35
fa74052922cf39e5a39ad7178d1b13c2da9b4519...50ab5fd3fc16fbe01170059977533fa2c7c4d448,3,13,18,31,11,2007-09-19 10:22:31,2007-09-19 04:49:39
50ab5fd3fc16fbe01170059977533fa2c7c4d448...f4e95765b042f3e31a8902e78a5101768b33e445,1,8,0,8,3,2007-09-19 10:22:31,2007-09-19 04:49:42
f4e95765b042f3e31a8902e78a5101768b33e445...009c5bcd24da3cd2670962e405585e31d662487d,1,3,3,6,3,2007-09-25 06:25:15,2007-09-25 04:13:14
009c5bcd24da3cd2670962e405585e31d662487d...7dfee372b08f653c2709c90bea986e4ed608f410,1,3,6,9,2,2007-09-25 06:25:19,2007-09-25 04:13:19
7dfee372b08f653c2709c90bea986e4ed608f410...4491e62ae932d5774f628d1bd3be663c11058a73,1,4,1,5,2,2007-09-25 06:25:26,2007-09-25 04:13:25
4491e62ae932d5774f628d1bd3be663c11058a73...cfb8f898a883e2fb2fd5ecec0fe83662b64f1373,1,1,1,2,1,2007-09-30 05:11:52,2007-09-28 23:34:17
cfb8f898a883e2fb2fd5ecec0fe83662b64f1373...90446a0009d9c9c0a06c512f0836e0d30f78d2d0,2,3,3,6,3,2007-09-30 06:54:37,2007-09-28 08:46:13
90446a0009d9c9c0a06c512f0836e0d30f78d2d0...7155b727c9baae9ef6d7829370aefc09c4ab64e2,3,55,45,100,6,2007-09-30 07:04:39,2007-09-28 15:28:54
7155b727c9baae9ef6d7829370aefc09c4ab64e2...cd547b4886c5338a70eb8a674bfc40eac5cab3d9,2,362,1,363,3,2007-10-01 09:09:25,2007-09-30 23:59:39
cd547b4886c5338a70eb8a674bfc40eac5cab3d9...2b5a06edca8f7237aad6464b349b79772024d2a2,3,7,7,14,7,2007-10-03 04:12:01,2007-10-03 02:49:15
2b5a06edca8f7237aad6464b349b79772024d2a2...2467a4fa03ff849fcf2f6a93b89057aebd49c62b,3,33,0,33,3,2007-10-16 00:28:06,2007-10-08 04:25:07
2467a4fa03ff849fcf2f6a93b89057aebd49c62b...8f70a7657a9b459d6a4a3bcb1628c0fa6a6c22e0,1,2,1,3,1,2007-10-16 00:40:50,2007-10-12 20:40:04
8f70a7657a9b459d6a4a3bcb1628c0fa6a6c22e0...f539d0d6c1f0b4431c0711e290d1f5a7205ed6e6,1,12,0,12,1,2007-10-16 00:40:51,2007-10-09 08:51:07
f539d0d6c1f0b4431c0711e290d1f5a7205ed6e6...ccfc02a30057a5fa7376e1fc8e8c3fe5478556f4,2,10,19,29,10,2007-10-16 01:59:40,2007-10-15 13:52:25
04b508f22b34e1b7461ab6414e1612547d87f08e...2f6a3823700cbfda236c2c1f023c43601adae9af,1,10,7,17,1,2007-08-29 04:58:53,2007-08-29 04:58:53
2f6a3823700cbfda236c2c1f023c43601adae9af...1ff55ff27b819c1fd9c0d2e153974f2c1924a875,1,18,9,27,9,2007-08-29 07:08:32,2007-08-27 09:50:12
1ff55ff27b819c1fd9c0d2e153974f2c1924a875...d37a8de01839f890e441998d06ef2937c0f7d3fe,1,1,1,2,1,2007-08-29 07:08:47,2007-08-17 15:48:53
d37a8de01839f890e441998d06ef2937c0f7d3fe...99c7ff35257886df349eafd7a370a1d530d731ec,1,15,3,18,4,2007-08-29 07:11:27,2007-08-29 07:11:27
99c7ff35257886df349eafd7a370a1d530d731ec...bdd7379566cf7b1f1c9bfe42e794c8f1821971f7,1,34,2,36,4,2007-08-29 10:32:12,2007-08-29 10:32:12
8938410189315979255c1dfcc3c0b7a4bf9953e5...63c4024ff080430004967fa27b8af8fe243e2ea3,1,1,1,2,1,2007-09-11 22:57:18,2007-09-11 17:37:45
5f51ccd2598977694d383e9059e89cafb9ae1214...93716a62c07561467a5c6fb0e14c4897cf264e7e,1,6,6,12,6,2007-09-10 04:40:46,2007-09-10 04:40:46
93716a62c07561467a5c6fb0e14c4897cf264e7e...66c75a5c9f7434d857d836440dc1c3046c59b5f3,3,60,19,79,8,2007-09-10 05:54:16,2007-09-10 05:54:16
a91df69cbb5ced7837525106ff57ff349180770b...8a42c9850177cc91e9f38779e8aca89682a02975,2,126,3,129,4,2011-04-07 00:08:46,2011-04-06 23:11:56
8a42c9850177cc91e9f38779e8aca89682a02975...2f6c9760debfb4705f6efb5862e2b3a23b2b951c,3,18,8,26,7,2011-04-08 23:19:48,2011-04-08 23:18:46
2f6c9760debfb4705f6efb5862e2b3a23b2b951c...d0546e2d488b1ba185c430b638619ab1d91af509,2,32,6,38,9,2011-04-08 23:20:16,2011-04-07 03:56:19
d0546e2d488b1ba185c430b638619ab1d91af509...6d9429271013898df103f7e77ed0736cdfab01b8,2,6,32,38,9,2011-05-10 17:23:41,2011-05-10 17:23:41
6d9429271013898df103f7e77ed0736cdfab01b8...b060ce7de42b357af013909039da3f08a68f3c0b,1,0,3,3,1,2011-05-10 19:07:12,2011-05-10 19:07:12
b060ce7de42b357af013909039da3f08a68f3c0b...7c5f3cc4a5680e23b8aa378ed9b655a1779ee881,1,1,7,8,1,2011-05-10 19:11:01,2011-05-10 04:34:04
7c5f3cc4a5680e23b8aa378ed9b655a1779ee881...9619617d33c83ad873539384b3cbfd564053be76,1,1,1,2,1,2011-05-10 19:36:06,2011-05-10 18:10:30
9619617d33c83ad873539384b3cbfd564053be76...2e83b66c32c1d482575fd8caed80680a2f69c5f1,3,14,13,27,13,2011-05-10 19:37:54,2011-05-10 19:02:54
2e83b66c32c1d482575fd8caed80680a2f69c5f1...0e539dca51c298ca2ee102e0ca118797f2da99eb,1,11,2,13,1,2011-05-10 19:38:06,2011-05-10 19:05:01
0e539dca51c298ca2ee102e0ca118797f2da99eb...6fd09f537c7a1b0a92587aa6f00ef7302a546a1e,3,93,0,93,3,2011-05-10 19:42:59,2011-05-08 11:08:26
a91df69cbb5ced7837525106ff57ff349180770b...f85a6f0bbba92f4a671189fec8fec3af773736ca,1,1,1,2,1,2011-03-22 07:44:47,2011-03-21 09:25:06
a91df69cbb5ced7837525106ff57ff349180770b...493dd6ed5b46659d7e20aaef00f97e279ce1c4cb,1,34,0,34,3,2011-03-20 20:32:44,2011-03-20 09:04:16
493dd6ed5b46659d7e20aaef00f97e279ce1c4cb...5c08dc48a8cf987c3a14006b5a82651e9b3f5423,2,26,0,26,3,2011-03-20 20:32:45,2011-03-20 09:09:18
5c08dc48a8cf987c3a14006b5a82651e9b3f5423...0be240cc65c2230d0c9732dbe0e2490a9331ea32,1,4,1,5,1,2011-03-20 20:32:47,2011-03-20 09:19:01
1c40c36b9acbb55726ea0fcf98714a85e159e45f...01771a8e2b9f697d1ae4e3d20d9ab86a4aa9e633,1,2,0,2,1,2011-05-28 19:25:24,2011-05-28 19:25:24
810cae53e0f622d6804f063c04a83dbc3a11b7ca...ccc2fcf54cd6cfa9f15c110d064e10aa8d71ddb1,1,7,0,7,1,2011-04-19 18:29:45,2011-04-19 12:24:27
810cae53e0f622d6804f063c04a83dbc3a11b7ca...bea7d16e8b8248602ea033b188f862699af4b977,1,4,3,7,1,2011-04-15 20:53:00,2011-04-15 17:53:51
810cae53e0f622d6804f063c04a83dbc3a11b7ca...e0d48279d5a96bc02edac72c1d28fc38aed37c15,1,58,0,58,1,2011-04-15 20:24:53,2011-04-15 02:22:02
810cae53e0f622d6804f063c04a83dbc3a11b7ca...5729482429725c4688c678701ca5197eaf367a07,2,7,2,9,3,2011-04-15 17:13:52,2011-04-15 08:34:03
5729482429725c4688c678701ca5197eaf367a07...ded7e0491b78e3e8384bcd9f63918c52785c4cd6,1,16,12,28,3,2011-04-15 17:16:24,2011-04-15 08:38:55
06c0f42f94272980e367db82092fa1b702afc625...96dbe93da541cb930bacd4e2df0a95e41d4c6441,1,9,0,9,2,2011-05-15 23:11:55,2011-05-15 23:11:55
681186ae3ab340dd684b1d9e09b457baeb2331f9...ea2c69ed4728070be1d2ee953a6948398b859150,5,1,21,22,5,2011-03-11 06:41:14,2011-03-11 06:41:14
78bc46675353e4833a59e0f4dfa47d57a9c1a46b...9b125da490990ae4d08dd1517dc38b188b874fa8,3,36,3,39,5,2011-03-29 00:01:15,2011-03-26 09:04:24
9b125da490990ae4d08dd1517dc38b188b874fa8...b892913d51795ee66d825bedd23e5c4ffe85ebb2,2,6,50,56,3,2011-03-29 00:02:57,2011-03-26 09:04:25
78bc46675353e4833a59e0f4dfa47d57a9c1a46b...7d6cb10b84d9931aacf1914db192cbeaaa88443d,2,2,1,3,2,2011-03-28 21:02:12,2011-03-28 18:11:55
7d6cb10b84d9931aacf1914db192cbeaaa88443d...f1723ee6b370c3d0cfaaea9d02188175a8d85af6,1,18,18,36,11,2011-03-28 21:14:45,2011-03-28 15:11:49
08c8d5581363998fda2803da2620d47fe8b50f0d...c2e86addb86689306b992065328ec52aa2479658,35,43,48,91,43,2011-03-22 17:16:54,2011-03-22 07:51:05
08c8d5581363998fda2803da2620d47fe8b50f0d...52d269da7ec66338e733aaf839ce5b8ad6709337,1,1,1,2,1,2011-03-21 17:23:02,2011-03-21 09:45:03
8ced9c90a28f6abc80dc5ad4cf7921c2322c0bb0...e32a4581bcbf1cf43cd5069a0d19df07542d612a,3,37,13,50,9,2012-03-30 16:13:02,2012-03-30 07:01:30
8ced9c90a28f6abc80dc5ad4cf7921c2322c0bb0...b8939b2b3abaa99c18bf57251cd2828b89ac38c5,1,3,1,4,1,2012-03-30 16:06:04,2012-03-29 07:21:22
8ced9c90a28f6abc80dc5ad4cf7921c2322c0bb0...f9a482e62b079cdf9e80889011b6f41f3c17f0c2,4,8,6,14,8,2012-03-27 04:32:43,2012-03-26 23:51:01
f9a482e62b079cdf9e80889011b6f41f3c17f0c2...d65ddf1984d66e978f0a11e7a4ea2d4eb20193c7,2,15,6,21,7,2012-03-27 04:32:43,2012-03-26 23:51:06
efc749b48f729992d838484d652ba24f5291ee28...93b709c79eea6231b7d75a6817245a416b4f8fb5,2,4,4,8,3,2011-03-22 21:32:09,2010-10-11 02:46:24
93b709c79eea6231b7d75a6817245a416b4f8fb5...d234f54b2f82067699f36593188e687fc7dc321a,3,10,8,18,5,2011-03-22 21:39:54,2010-10-11 02:44:21
d234f54b2f82067699f36593188e687fc7dc321a...26557fc1b37480d184a32de025b060aa1aa231db,2,11,10,21,6,2011-03-22 21:40:26,2010-12-28 10:26:17
26557fc1b37480d184a32de025b060aa1aa231db...c9d1c8ba059577e64fb2213cb0c5f3c4619c7519,2,37,5,42,10,2011-03-22 21:41:09,2010-12-28 10:30:54
efc749b48f729992d838484d652ba24f5291ee28...41529bbce407fbf1a925cfbc7c1aa30064f66ae7,5,109,52,161,45,2011-03-07 07:43:57,2011-03-05 02:30:23
41529bbce407fbf1a925cfbc7c1aa30064f66ae7...d38f84484f21e7e509ff009d3a17167c9c09f893,1,1,1,2,1,2011-03-07 07:43:57,2010-12-10 10:21:35
d38f84484f21e7e509ff009d3a17167c9c09f893...78e1a3ff236af3afaf1ba9db92985df42141cb0e,1,1,0,1,1,2011-03-07 07:43:57,2010-12-10 00:57:13
78e1a3ff236af3afaf1ba9db92985df42141cb0e...7e11902c995715836dec140eb55cfef1d24334bb,3,28,7,35,10,2011-03-07 07:43:57,2011-01-05 03:53:33
7e11902c995715836dec140eb55cfef1d24334bb...723b7a2789d66c1365390cc9b9213e34ab8513d7,7,184,340,524,44,2011-03-07 07:43:58,2010-12-10 10:00:55
723b7a2789d66c1365390cc9b9213e34ab8513d7...e43581120843f6f55f411af470faf806e052ad9d,4,112,1,113,5,2011-03-07 07:43:58,2010-12-11 16:59:31
e43581120843f6f55f411af470faf806e052ad9d...1ae469b06c50aade4781931ca1587453082f57eb,1,9,10,19,3,2011-03-07 07:43:58,2010-12-11 23:08:51
1ae469b06c50aade4781931ca1587453082f57eb...dd3f42ad793b5334d506a451addcefd0054c27bb,1,1,1,2,1,2011-03-07 07:43:58,2010-12-12 02:41:38
b476064544b9a64d062acc5e3c6be831ebb721cb...e9e8c8090e579da5b5f6d2437ecf271568d127ff,1,13,12,25,2,2012-03-26 19:03:38,2012-03-26 16:42:24
e9e8c8090e579da5b5f6d2437ecf271568d127ff...99cccefbe0927027e69ba7ba96317eba42cec3cb,1,14,12,26,9,2012-03-26 19:03:39,2012-03-26 16:42:25
99cccefbe0927027e69ba7ba96317eba42cec3cb...5b2d131419817c5f5996da0e284e906400c083ef,1,87,89,176,15,2012-03-26 19:03:40,2012-03-26 16:42:26
d0f1ea6003d97e63110fa7d50bb07f546a909b6e...0e901d24fd70630ffed5411e6217c2dfce9c8da6,1,1,1,2,1,2013-01-02 00:27:27,2012-12-30 11:52:53
d0f1ea6003d97e63110fa7d50bb07f546a909b6e...7bc0911d037f0a144d8c227f58693da0c9c77b2a,1,1,1,2,1,2012-10-11 17:40:36,2012-10-11 17:40:36
d0f1ea6003d97e63110fa7d50bb07f546a909b6e...9d55b2e12f82b344709b0f2981eaf142b0b1f7a8,1,0,11,11,4,2012-10-01 00:29:27,2012-09-30 22:10:48
d0f1ea6003d97e63110fa7d50bb07f546a909b6e...a944af1d86e6171d68ed2a3aa67b1d68f00e1fe8,3,35,7,42,6,2012-09-09 04:27:19,2012-09-09 04:27:19
a944af1d86e6171d68ed2a3aa67b1d68f00e1fe8...155a4b712efd3d917c228d155ec57ec2c09d7ac0,3,3,3,6,3,2012-09-09 04:28:55,2012-09-09 04:28:55
155a4b712efd3d917c228d155ec57ec2c09d7ac0...e0e2065f74500119d5e12524992273de362acd30,1,4,3,7,3,2012-09-12 09:01:52,2012-09-12 09:01:52
d0f1ea6003d97e63110fa7d50bb07f546a909b6e...2303cad242a6ccc4745d7994ecc0425bd8513a0d,2,6,1,7,2,2012-09-07 17:58:35,2012-09-07 06:41:19
d0f1ea6003d97e63110fa7d50bb07f546a909b6e...c91841594c2f08bec0c8b2d46da27add18fb4854,4,27,0,27,4,2012-09-03 01:57:21,2012-09-01 17:46:54
d0f1ea6003d97e63110fa7d50bb07f546a909b6e...a20efee9cfcf9c68bb01d0aa82ffc7903d88bab4,7,21,18,39,15,2012-08-28 01:36:39,2012-08-27 21:46:01
a20efee9cfcf9c68bb01d0aa82ffc7903d88bab4...5d55915c7a58e59d913b0cfc38a6f49514068cd2,1,1,7,8,2,2012-08-28 01:36:39,2012-08-27 22:16:38
5d55915c7a58e59d913b0cfc38a6f49514068cd2...6571225137b1ba270b49a0dfc6a30aab6f4b86ba,1,1,2,3,2,2012-08-28 01:36:39,2012-08-27 22:21:37
6571225137b1ba270b49a0dfc6a30aab6f4b86ba...b0f9e9eeef0ed4f21fc9bfa92f1314e3112d5cc1,1,4,1,5,1,2012-08-28 15:37:07,2012-08-23 14:20:41
b0f9e9eeef0ed4f21fc9bfa92f1314e3112d5cc1...da1f515641f4853a6b7c4710392796ed08efaa6f,1,28,19,47,4,2012-08-31 00:25:57,2012-08-30 21:39:03
da1f515641f4853a6b7c4710392796ed08efaa6f...6440fdbab430bc10fdac37e86ae25607c93d3903,1,7,10,17,3,2012-08-31 00:25:57,2012-08-30 22:04:13
6440fdbab430bc10fdac37e86ae25607c93d3903...94f0ced0d08c8f835992b82224231b9353490e0c,1,58,21,79,5,2012-08-31 00:25:57,2012-08-30 22:35:39
94f0ced0d08c8f835992b82224231b9353490e0c...5907cda1b2e0bd7dc5c26466f60b9cbb60288cc5,2,50,0,50,8,2012-08-31 18:45:33,2012-08-30 21:52:20
5907cda1b2e0bd7dc5c26466f60b9cbb60288cc5...f37d3c755209234acfc2ca280027ebdab8e9ea8a,1,18,38,56,5,2012-08-31 18:45:36,2012-08-31 06:20:40
d0f1ea6003d97e63110fa7d50bb07f546a909b6e...45aaf0310f2b85d9c3264d1703c82cd5085aaf24,1,3,3,6,3,2012-08-26 18:40:08,2012-08-26 18:40:08
d0f1ea6003d97e63110fa7d50bb07f546a909b6e...912072d53a6f257fbbfd8a103e14248ae2382b6d,1,10,0,10,1,2012-08-21 21:42:11,2012-08-21 07:46:06
912072d53a6f257fbbfd8a103e14248ae2382b6d...3b51222ceceed022f45193db19c57cf53f0164df,2,4,2,6,2,2012-08-21 21:42:12,2012-08-21 07:47:26
d0f1ea6003d97e63110fa7d50bb07f546a909b6e...d0714cc87b9ac0a5c9b900ed90e63bfec02577c8,1,1,1,2,1,2012-08-18 20:44:58,2012-08-18 17:32:10
d0714cc87b9ac0a5c9b900ed90e63bfec02577c8...d1e1fe7569835901090b936f984117b15df43bec,1,1,1,2,1,2012-08-18 23:39:35,2012-08-18 23:35:09
d0f1ea6003d97e63110fa7d50bb07f546a909b6e...79dc2d0b0250b4a90dfc83ae69c116e08c9df0a3,1,38,0,38,3,2012-08-17 17:56:19,2012-07-10 22:52:27
79dc2d0b0250b4a90dfc83ae69c116e08c9df0a3...743bf6d8b07f0c5717bf5c37b8b50ae9de619c83,2,2,1,3,2,2012-08-17 17:59:17,2012-07-10 22:52:28
d0f1ea6003d97e63110fa7d50bb07f546a909b6e...3f0350ccd5378520d472fd5e5a8a9fb21db50762,1,24,7,31,4,2012-08-15 20:04:20,2012-08-15 20:02:48
d0f1ea6003d97e63110fa7d50bb07f546a909b6e...785063e02bb249ef3a39db88575fe626b310d4a7,1,4,0,4,2,2012-08-08 21:36:33,2012-08-08 19:08:17
d0f1ea6003d97e63110fa7d50bb07f546a909b6e...2c3fd4bbb42b586b016319d2009a05fe5b878533,1,35,0,35,1,2012-08-07 05:29:30,2012-08-07 05:01:48
2c3fd4bbb42b586b016319d2009a05fe5b878533...4b7f2fa4c6c2c4675ab00474d419fa356afdfa71,2,3,2,5,2,2012-08-07 05:31:10,2012-08-07 05:31:10
d0f1ea6003d97e63110fa7d50bb07f546a909b6e...831e61f80fab2d3f9ba1773e657803dcf8b16432,7,27,16,43,14,2012-08-06 21:04:16,2012-08-06 20:36:47
d0f1ea6003d97e63110fa7d50bb07f546a909b6e...f633ea2c736a2a38e92fcf61e90c8adadc5c504d,1,1,18,19,2,2012-08-03 19:13:43,2012-08-03 12:16:25
d0f1ea6003d97e63110fa7d50bb07f546a909b6e...28452655af988094792483a51d188c58137760cd,13,16,32,48,17,2012-08-03 19:11:07,2012-08-03 12:16:24
d0f1ea6003d97e63110fa7d50bb07f546a909b6e...b622d4d11d27fd290f7732c6a65f40c054796c1f,2,19,4,23,3,2012-07-31 22:05:53,2012-07-30 19:25:40
d0f1ea6003d97e63110fa7d50bb07f546a909b6e...4ca945389f508b1c204db1eefc9be78d69bae929,1,0,11,11,1,2012-07-30 01:08:50,2012-07-28 18:50:49
d0f1ea6003d97e63110fa7d50bb07f546a909b6e...cb2912c324477f0d92618ac258c43b2692e870c4,1,1,1,2,1,2012-07-30 01:02:51,2012-07-28 15:46:36
d0f1ea6003d97e63110fa7d50bb07f546a909b6e...e54501004abbd20fa8d813c1e5b82c3b50bb9361,14,135,32,167,44,2012-07-29 22:04:32,2012-07-28 15:03:01
e54501004abbd20fa8d813c1e5b82c3b50bb9361...4337b5856f88f18da47c176e3cbc95a35627044c,2,21,0,21,2,2012-07-29 22:13:36,2012-07-28 15:05:24
d0f1ea6003d97e63110fa7d50bb07f546a909b6e...f20f3878ac95e254ec6fd22b63cfb6eda67e5ded,1,1,1,2,1,2012-07-23 20:27:21,2012-07-23 18:50:35
d0f1ea6003d97e63110fa7d50bb07f546a909b6e...447b99c8b1102746054644acd268f4c1b115a9f8,1,1,1,2,1,2012-07-23 20:10:43,2012-07-23 18:48:57
d0f1ea6003d97e63110fa7d50bb07f546a909b6e...1015cc4225542ba69cf1627a743978f304a29c71,1,1,1,2,1,2012-07-23 04:30:26,2012-07-22 23:47:26
d0f1ea6003d97e63110fa7d50bb07f546a909b6e...bd8c1a9b49933c766587c65de70a0b8ff518801f,2,24,3,27,4,2012-07-18 05:51:11,2012-07-18 05:08:59
bd8c1a9b49933c766587c65de70a0b8ff518801f...c12f82ae631eb07d0ee6a61003754d103025a0b3,1,40,0,40,2,2012-07-19 17:17:05,2012-07-19 11:49:38
d0f1ea6003d97e63110fa7d50bb07f546a909b6e...14bf2d58bc3b202da3ca34cfdf72392889135411,2,8,0,8,2,2012-07-13 23:02:48,2012-07-13 15:51:30
d0f1ea6003d97e63110fa7d50bb07f546a909b6e...45d4fdc2dc74c657a9c2e95bf04aed539fdcb0a4,1,1,1,2,1,2012-07-09 20:22:29,2012-07-07 21:50:30
45d4fdc2dc74c657a9c2e95bf04aed539fdcb0a4...fd9563385f34c888408cf4f8683b1745ca2cf77a,1,1,1,2,1,2012-07-09 23:27:49,2012-07-09 23:27:49
fd9563385f34c888408cf4f8683b1745ca2cf77a...6ff2b729debc07fce5c5c1226f9fee9ea59cd7ab,1,1,1,2,1,2012-07-10 06:47:26,2012-07-10 06:37:22
d0f1ea6003d97e63110fa7d50bb07f546a909b6e...d9a93575722d9ea918f090892b06618ddf0d1d65,2,16,1,17,2,2012-07-09 19:43:58,2012-07-09 18:53:26
d0f1ea6003d97e63110fa7d50bb07f546a909b6e...a9c7a8a8bef30bbbf87e0d4c0e64d50c676f70ed,1,4,1,5,3,2012-05-22 19:53:42,2012-05-22 04:52:17
d0f1ea6003d97e63110fa7d50bb07f546a909b6e...c51a351a6bcc64ad8cb2ed5a6ebde54b8d50eef1,1,5,12,17,1,2012-05-18 18:26:10,2012-05-18 05:15:17
c51a351a6bcc64ad8cb2ed5a6ebde54b8d50eef1...bf38245be8f481ac1c08a98951b7fd00bbfc15ea,1,2,2,4,2,2012-05-18 18:26:18,2012-05-18 05:18:11
d0f1ea6003d97e63110fa7d50bb07f546a909b6e...5e73633dbf8a62190611f6eb438a1a2eaaffa919,4,39,2,41,5,2012-05-14 18:56:42,2012-05-14 16:24:45
d0f1ea6003d97e63110fa7d50bb07f546a909b6e...70de5e65e8c947626ab9aa2aeb790fd969951bc2,1,11,1,12,6,2012-05-04 17:24:13,2012-05-02 22:12:10
edf141218e4e4ecca3a8ab0c8fa9eafe381b3838...036dbbfb2d9127dcef3d742b99ac8677006f6d33,1,59,58,117,7,2012-05-08 08:51:07,2012-05-07 19:18:26
036dbbfb2d9127dcef3d742b99ac8677006f6d33...3207a3a29179c247d1ee9552511123e426845acb,3,24,24,48,24,2012-05-08 08:51:07,2012-05-07 19:44:44
edf141218e4e4ecca3a8ab0c8fa9eafe381b3838...41925d5802d62c67bb40d41a98a7922b5a2d2e6e,1,3,1,4,3,2012-05-07 18:11:05,2012-05-06 15:58:38
edf141218e4e4ecca3a8ab0c8fa9eafe381b3838...41e6229db4abaf08ca277115f9ac800cdc7591d6,1,2,4,6,2,2012-05-07 17:15:41,2012-05-01 18:42:56
75e0dffef009bb06072e44d38555373639d94986...5710be46d88ea548159e7493973b5488e6d2799f,2,15,5,20,5,2012-04-25 23:42:34,2012-04-24 17:39:15
5710be46d88ea548159e7493973b5488e6d2799f...0ebe7827b6f00797ab850e8ebc28f0fa22f1df55,2,18,6,24,6,2012-04-26 18:24:40,2012-04-26 16:45:44
e5056c05ecd2bdaceaa95e12e9e94b1584ec59c8...e681a93a98bf2ab1ef672ed70c81f0c0fbea68b5,1,1,0,1,1,2012-04-06 17:15:11,2012-04-06 12:22:30
e681a93a98bf2ab1ef672ed70c81f0c0fbea68b5...e8dde3e5f9ddb7cf95a6ff3cea6cf07c3a2db80d,3,19,11,30,5,2012-04-06 17:47:58,2012-04-06 17:47:58
e5056c05ecd2bdaceaa95e12e9e94b1584ec59c8...d2c1898571a6a2324593e92163e8754880e0c1fb,3,40,0,40,4,2012-04-03 23:24:44,2012-04-03 22:53:08
d2c1898571a6a2324593e92163e8754880e0c1fb...db3b313c84522d89ac358187a7f6928dfcfb1e7d,2,54,48,102,5,2012-04-03 23:24:45,2012-04-03 22:53:09
db3b313c84522d89ac358187a7f6928dfcfb1e7d...d60c49c2d7f683cd24a738533846cd3e34f2073e,1,32,12,44,4,2012-04-03 23:24:45,2012-04-03 22:53:10
d60c49c2d7f683cd24a738533846cd3e34f2073e...936f53d055c9a336e9ad89ad06c4efd56e5896e8,1,6,3,9,5,2012-04-03 23:24:45,2012-04-03 22:53:11
936f53d055c9a336e9ad89ad06c4efd56e5896e8...0136bac9b8a449cdf2179ad0242e079262b0aeea,1,4,2,6,2,2012-04-03 23:24:45,2012-04-03 22:53:12
0136bac9b8a449cdf2179ad0242e079262b0aeea...3fc22b53313ff035da145b2cb59e587ff3868654,1,25,19,44,2,2012-04-03 23:24:46,2012-04-03 22:53:13
3fc22b53313ff035da145b2cb59e587ff3868654...f136f7bfe816b46ebabf5439f8e55f37097ca353,1,17,9,26,4,2012-04-03 23:24:46,2012-04-03 22:53:14
f136f7bfe816b46ebabf5439f8e55f37097ca353...6c9cd161d9d1bee349b1389d661282c92da098bc,1,51,7,58,10,2012-04-03 23:24:46,2012-04-03 22:53:15
6c9cd161d9d1bee349b1389d661282c92da098bc...9d227781b688707f64ee1703a1156b0c83247c33,2,58,10,68,15,2012-04-04 16:57:49,2012-04-04 16:12:43
9d227781b688707f64ee1703a1156b0c83247c33...69dec66b2f6ab5c8138cca37e74bd405c541318a,2,19,1,20,5,2012-04-04 16:57:50,2012-04-04 16:37:02
69dec66b2f6ab5c8138cca37e74bd405c541318a...9170c7ab2889a295de49458d7bd37d82f1556cd6,1,1,0,1,1,2012-04-27 23:03:29,2012-04-27 22:58:13
9170c7ab2889a295de49458d7bd37d82f1556cd6...afd7bd22209c53ae4d3c73dd4bc4b225ec55e10a,1,13,0,13,2,2012-04-27 23:03:31,2012-04-27 23:02:45
f524129737d9ba3e685c31bacde844ec1db1fea9...e1c3643ff78610d2e6b42c206cd5ed33a9353285,1,4,2,6,2,2012-03-30 16:07:26,2012-03-29 12:45:47
e1c3643ff78610d2e6b42c206cd5ed33a9353285...b7d565ea4c2bd6d0c79e512eeca77beb15736f80,2,55,29,84,5,2012-03-30 16:08:52,2012-03-29 12:45:48
b7d565ea4c2bd6d0c79e512eeca77beb15736f80...8745db63ca65c28221229df3d945cb10045c29dc,2,43,0,43,4,2012-03-30 16:09:59,2012-03-29 12:45:49
f524129737d9ba3e685c31bacde844ec1db1fea9...d50b2c73b6ffcdc9a55efa38542d02773df44407,1,11,0,11,1,2012-03-19 16:41:34,2012-03-17 03:54:37
9a4c97eb8923879f240c35c778eeb52ac7e9476e...42e52e358be1da6e3500a8d0d930ed08a8dd3715,1,28,10,38,11,2012-03-08 21:08:54,2012-03-08 21:08:26
42e52e358be1da6e3500a8d0d930ed08a8dd3715...745950ce0e7e984158a00cd52c5811918d1f3495,1,1,1,2,1,2012-03-09 10:07:23,2012-03-09 09:52:54
59012e20f8461e51d9f7de1c6ebf05ee7a46b2c2...a7793a749115ead3b8f7447ce1e96572ea5d8ea3,8,9,9,18,9,2012-03-28 15:47:23,2012-03-28 08:41:54
a7793a749115ead3b8f7447ce1e96572ea5d8ea3...65c2b2b509796965b9a584e4d92fec2afc4470cd,4,4,4,8,4,2012-03-28 18:18:35,2012-03-28 08:45:36
65c2b2b509796965b9a584e4d92fec2afc4470cd...455cf268dbaf227bdbd5e9fbf96525452bcfe44f,2,11,11,22,4,2012-03-28 18:18:42,2012-03-28 17:51:00
b2be2f6aeaa8f4af602679e5571d2e916a259d91...db6195efab70aa3aca1cc8e39855f2cd58e0287b,1,3,5,8,2,2010-12-19 18:46:08,2010-12-19 03:36:41
b2be2f6aeaa8f4af602679e5571d2e916a259d91...9bad7233699e1fcf58e75f1e163499ec24680826,3,52,10,62,6,2010-11-17 19:37:06,2010-11-17 17:04:12
5d268edff8a271fe68f525e8d382a13b96c71a81...1c7d402b3e1e9d7e50abfbfb18c88bc79be468ea,1,2,2,4,2,2010-11-17 21:26:38,2010-11-15 06:42:44
1960897ebc5a899a8e4ec3c2afc1d2325574fe41...df126e108b899da133a980e900df39dfe57fcd59,1,7,7,14,7,2012-10-31 11:45:08,2012-10-31 11:20:15
df126e108b899da133a980e900df39dfe57fcd59...2e736fd5e94c6fa44ba95d81a5b0ae407b968b78,3,32,1,33,4,2012-10-31 11:45:13,2012-10-31 11:29:16
8228a23b35f6bd34a87d4d839d06e7c18ae9e750...68c4f6a57759233ef4586f27d424721c6c1c0ea7,2,3,3,6,3,2012-07-09 02:49:34,2012-07-06 16:07:30
ba998d33e22d6fce4445af5834dc227609672501...b082687cbac951d31bdea346404db5d0b99a0b73,1,1,0,1,1,2012-04-27 16:26:37,2012-04-27 09:25:25
ba998d33e22d6fce4445af5834dc227609672501...c6a13b2c86b71cb25011094ff2dee3d7769991a2,5,20,17,37,12,2012-02-28 22:55:39,2012-02-28 22:55:39
58ebd9865d2bb9d42842fbac5a1c4eae49e92859...173223aa62519033e547937c692f5540f59d9025,1,7,7,14,6,2012-02-02 18:53:18,2012-02-02 10:59:23
173223aa62519033e547937c692f5540f59d9025...150f75467cdd6eaf581d22175bb377399c62893a,3,26,14,40,14,2012-02-02 19:03:30,2012-02-02 11:03:16
150f75467cdd6eaf581d22175bb377399c62893a...3f790003a356284d92beff6965985917e58b6707,1,3,3,6,3,2012-02-02 19:05:18,2012-02-02 11:06:01
58ebd9865d2bb9d42842fbac5a1c4eae49e92859...ce8ebcdaf31dd56955635808bba1a6df50601563,1,7,7,14,6,2012-02-02 11:28:51,2012-02-02 09:57:23
ce8ebcdaf31dd56955635808bba1a6df50601563...2d54b9ea8b99df7b448f64a7847f7f3879964e12,3,26,14,40,14,2012-02-02 11:33:13,2012-02-02 10:19:35
2d54b9ea8b99df7b448f64a7847f7f3879964e12...5b8bf02930674a5c2cba42d919ba3c0c96bf58e4,1,3,3,6,3,2012-02-02 11:33:37,2012-02-02 10:28:02
5b8bf02930674a5c2cba42d919ba3c0c96bf58e4...3b8a3051733e754dad587e5a73fba7f367c7e0db,7,0,16,16,8,2012-07-06 04:26:51,2012-05-31 14:41:30
3b8a3051733e754dad587e5a73fba7f367c7e0db...4a5de8dd79879d737e172a5d7e4196c6bf99e57d,1,1,1,2,1,2012-07-06 04:26:52,2012-05-31 14:41:25
4a5de8dd79879d737e172a5d7e4196c6bf99e57d...4a1613194af218afb99be0e14af449e86852d06e,1,4,4,8,4,2012-07-06 04:26:52,2012-05-31 14:41:26
4a1613194af218afb99be0e14af449e86852d06e...d8d8708bd6a56818ee3a85007e36a8ff201f9512,1,1,1,2,1,2012-07-06 04:26:52,2012-05-31 14:41:27
d8d8708bd6a56818ee3a85007e36a8ff201f9512...53153e8382966e35362d072ba17ba5887e3c0851,1,1,1,2,1,2012-07-06 04:26:52,2012-05-31 14:41:28
53153e8382966e35362d072ba17ba5887e3c0851...6a0b4438afc22551533dccc221bdf802ee4ed5ee,1,2,2,4,2,2012-07-06 04:26:53,2012-05-31 14:41:29
6a0b4438afc22551533dccc221bdf802ee4ed5ee...c68038effed2f1031848330cca46e85fc79e3ab2,1,1,1,2,1,2012-07-06 04:26:53,2012-05-31 14:41:29
c68038effed2f1031848330cca46e85fc79e3ab2...96a60a87098534b74e3b98e636ec65daea9823a7,1,3,2,5,3,2012-07-06 04:26:53,2012-07-06 03:21:09
96a60a87098534b74e3b98e636ec65daea9823a7...e32b79cb3211992505d68c421a3f66b29590d72c,1,18,15,33,11,2012-07-06 04:26:53,2012-07-06 03:47:47
31ffd0c0c1255cb7e9ba76192a70ae294faf95bf...2c57f7c9a2ae0190c0abe050197f2da6b56ef414,1,22,10,32,12,2013-07-02 04:54:27,2013-07-02 04:49:09
2c57f7c9a2ae0190c0abe050197f2da6b56ef414...94d75d1ed5c03b3c0191221f8e3960d808ba7e23,1,1,1,2,1,2013-07-02 04:54:45,2013-07-02 04:54:45
ba8e6326f16748d67fbeda65ffde4729760c64f0...89b5f1d9c5e64c9e232fa1ebe0ea407c8773b79a,3,29,27,56,3,2012-04-25 21:51:17,2012-04-25 20:35:27
89b5f1d9c5e64c9e232fa1ebe0ea407c8773b79a...2e7da8e9f436f58730c087144763d3e45b6572c4,1,2,2,4,3,2012-04-25 21:51:19,2012-04-25 20:35:41
2e7da8e9f436f58730c087144763d3e45b6572c4...a81a7fbc1a423b112158c2d8647ee80caba108ef,2,0,16,16,2,2012-04-25 21:51:21,2012-04-25 20:35:54
38f865c27d1f2560afb48efd2b7b105c1278c4b5...a78550831a42db6896e598cd2a8bfb441a958fc8,1,2,0,2,1,2012-07-31 19:51:30,2012-07-31 19:51:30
078b895fefdca94995862a4cc8644198b00a89bf...9d19c6ea52755edec9b8e6d5b838b712fc7e97f6,1,4,3,7,3,2012-05-22 19:57:19,2012-05-21 07:59:56
9d19c6ea52755edec9b8e6d5b838b712fc7e97f6...4cc00fcf5daf63648b7fd9382ca3e02033a0e1ec,1,7,5,12,4,2012-05-22 19:57:19,2012-05-21 07:59:57
4cc00fcf5daf63648b7fd9382ca3e02033a0e1ec...ff22ff9909a09d775c740f31443f96edd5b5e006,1,55,58,113,3,2012-05-22 19:57:20,2012-05-21 07:59:58
ff22ff9909a09d775c740f31443f96edd5b5e006...57e6fc69588ea5e1b6a151d60f2cf9fa636251c1,1,10,13,23,5,2012-05-22 19:57:20,2012-05-21 07:59:59
078b895fefdca94995862a4cc8644198b00a89bf...8150749da19a3e17623fc40320454afe89e04ca4,1,13,5,18,13,2012-04-10 21:49:18,2012-04-02 15:14:44
8150749da19a3e17623fc40320454afe89e04ca4...b2a9f4da645365d20ffac85cf2a6b0898258fcdc,1,66,0,66,1,2012-04-10 21:49:18,2012-04-02 15:16:24
b2a9f4da645365d20ffac85cf2a6b0898258fcdc...7103d2543ad138bd9df672cdc94cc070dd7417d8,1,31,0,31,1,2012-04-10 21:49:18,2012-04-02 15:17:03
76bdcf0ee31afc020df104a4997ffae2a72ca302...b3a769dc355b32c95783dc07f59e4dfebdd8bdc7,1,40,24,64,11,2012-02-20 08:29:40,2012-02-20 08:29:40
b5c9f1c1b0ed9c91463b9f46a7c9dff3efc53773...3adab6f3a7793253b22a4a7aae34221d19e0236a,2,19,3,22,5,2012-02-09 21:30:52,2012-02-09 21:30:52
7f814632f5d4d7af9f4225ece6039dbc44e03079...8212333012fa4e95373269526e4a702be7bb2d4b,1,1,1,2,1,2012-07-26 17:48:02,2012-07-26 12:52:36
840c519d7e7ae4651a7b5a0954f7aa53eebc29b6...c2d17ba3db0d2b14daf04e69a8c5ec73b023c1fe,2,52,4,56,5,2012-02-06 01:28:03,2012-02-06 01:13:36
840c519d7e7ae4651a7b5a0954f7aa53eebc29b6...3d9f5b674fb53cc931e0f676f1599050bd69f696,1,2,6,8,4,2012-02-04 07:01:55,2012-02-04 06:30:18
abc0c9d2d7312c4b153ba1b2b9cd8ba0696f1b04...f4212089c27e74689c33ec455f1c85470b7b8292,1,1,1,2,1,2012-02-13 06:11:31,2012-02-12 15:21:30
e1fd529f2f89fe64f65754fd425ce088733bd145...c2d53586ddfdde1ff625fe58299dc81db5e6f408,2,21,1,22,2,2011-09-12 05:33:27,2011-09-12 05:08:56
54fcb21b899eefc299c4ad94d2f2e229c72d3be5...edac1883dc5fbadbc2d7d7cf975ed347eaef0702,1,16,1,17,5,2010-06-29 00:42:18,2010-06-29 00:42:18
e0a9110176e3b17414b1b38fae8febd0791eaa0c...42f9852f3c7476b5608ad297443e6d459516f8c0,1,13,13,26,3,2010-06-16 19:13:12,2010-06-15 23:02:03
e0a9110176e3b17414b1b38fae8febd0791eaa0c...43c23251f924db4188cf74361cb7cc3257accce3,2,17,6,23,5,2010-06-16 17:00:58,2010-06-16 07:12:40
e0a9110176e3b17414b1b38fae8febd0791eaa0c...ef7a8e3b9575a6dc60e2d9e35008914a9eaabfff,1,1,1,2,1,2010-06-15 14:50:39,2010-06-14 23:40:05
cf4403a01070f03e5c5cc65b52c1351d20ff4e91...492b10766f499b60bdc867c253f36d274ac51538,1,11,1,12,4,2010-06-27 19:16:06,2010-06-27 19:01:12
284daf29026c519729747bd2051829f0f958473c...a452d148d10a89ae502bc4755c191ab323227ce5,2,10,3,13,3,2011-08-26 04:00:46,2011-08-26 04:00:46
0dc310e8608c05f40be3390607f301ffc4284e6d...d04520e3446acdcbdf1d30c812aa31d6a003c171,2,20,37,57,10,2011-07-22 20:54:57,2011-07-22 16:12:23
0dc310e8608c05f40be3390607f301ffc4284e6d...df6b0cad5f2d2f1984d1538de03e1e8ac87a78a2,1,1,1,2,1,2011-07-22 17:38:59,2011-07-22 01:33:15
df6b0cad5f2d2f1984d1538de03e1e8ac87a78a2...b421812b487da44b01773ef38789db1122bec61a,1,8,3,11,1,2011-07-22 20:58:35,2011-07-13 17:10:53
ff00b682f203eb39876b57404916b4c54b6032c6...fe549c21fc3d99b9ff66f03d192f955400c80191,1,1,25,26,3,2011-07-14 04:58:15,2011-07-14 01:42:32
fe549c21fc3d99b9ff66f03d192f955400c80191...bf979c07c728b9d4f2691a023b3f358610808789,1,19,28,47,11,2011-07-14 04:58:21,2011-07-14 01:57:42
81a5bdd9c52d476edcbf5368d1242ab5a92f5e3f...5738c9c21e53356ab5020912116e7f82fd2d428f,1,1,1,2,1,2011-09-12 17:44:32,2011-09-12 17:44:32
afe19ff7b55129d988e421ae1e0df4ec9659787a...bdee397d7c2345d467548ef9446a2a63b72c5449,1,7,6,13,2,2012-09-11 17:30:31,2012-09-11 14:32:47
afe19ff7b55129d988e421ae1e0df4ec9659787a...10c6cddd928b24ac6030a172c6c7b46efb32aedc,3,3,1,4,3,2012-01-08 23:07:20,2012-01-08 20:41:09
db8d6646786a9aa3242dc9eafbcef2e9f77ba7ab...5ad3e16a6f075deff3cddd6d12ae89fafb0c718d,1,25,0,25,4,2012-05-10 17:45:42,2012-05-10 17:45:42
b6555d731e0828c356247a7836bdbd6e31c7a639...79135e4c229ff02d9315fc2ac822b1316eb3e877,1,2,2,4,2,2012-05-14 16:24:52,2012-05-11 23:44:53
79135e4c229ff02d9315fc2ac822b1316eb3e877...cb2df369804e9633f21f00be5ffb1a581955c956,1,3,3,6,1,2012-05-14 18:14:07,2012-05-14 17:32:08
b0d66b5110faaeb395610ba43b6eb70a18ab5e25...14b289bdf7c31176dc525cbe81173ec636598782,1,26,8,34,6,2012-02-23 20:49:37,2012-02-23 15:54:46
14b289bdf7c31176dc525cbe81173ec636598782...2e3291ae1dc7790aa08c1eeb476fbf1c6d3a1ed9,1,25,8,33,9,2012-02-23 20:52:16,2012-02-23 15:54:47
2e3291ae1dc7790aa08c1eeb476fbf1c6d3a1ed9...07b257f94035133376538c54620b43a14e28dcd3,1,7,2,9,3,2012-02-23 20:53:03,2012-02-23 15:54:48
b0d66b5110faaeb395610ba43b6eb70a18ab5e25...b1d8b1f3f17c7550beeff267356bab89e10c6381,1,10,9,19,9,2012-02-22 23:58:10,2012-02-22 22:43:38
b1d8b1f3f17c7550beeff267356bab89e10c6381...db70a04cbb343a58e7be93e7f581d049cf901b26,1,30,29,59,9,2012-02-23 00:01:50,2012-02-22 22:43:39
db70a04cbb343a58e7be93e7f581d049cf901b26...676552464a871564835e1cb9d0484277b1b75e79,1,9,5,14,2,2012-02-23 00:08:05,2012-02-22 22:43:40
676552464a871564835e1cb9d0484277b1b75e79...6ddba5e241ebe484d53e3573c72386f487e25697,7,60,5,65,13,2012-02-23 02:17:39,2012-02-22 22:43:41
70da769a4607dbbc4efc490287ead98175cf622b...84ab7b6fc7e190ac1c1d0bc5b7c48befa42eff3c,1,1,1,2,1,2006-10-25 21:38:24,2006-10-25 21:38:24
6dcfa306f2b67b733a7eb2d7ded1bc9987809edb...79a65697be00f3b53430930078a7d34b591d5070,2,4,4,8,4,2006-10-31 01:44:27,2006-10-31 01:44:27
79a65697be00f3b53430930078a7d34b591d5070...6fb75bed5c4a6ce099a24e581ea327e9de3ab8b0,4,16,4,20,6,2006-10-31 03:35:16,2006-10-30 22:35:18
6dcfa306f2b67b733a7eb2d7ded1bc9987809edb...d4ff6d92c3d7020233a9b4990a3545ee54a5c033,1,19,1,20,2,2006-10-29 20:46:21,2006-10-29 09:37:11
d4ff6d92c3d7020233a9b4990a3545ee54a5c033...ce8590748b918687abc4c7cd2d432dd23f07ae40,1,17,10,27,3,2006-10-29 20:46:21,2006-10-29 09:37:54
d0a75a179e0e872c47d4a25350565a8c7c04dd0b...231f240b63bd6cb1313e8952448b3d5b9d2fdf26,2,27,9,36,4,2006-11-08 00:05:37,2006-11-07 15:51:23
e267c2f6f0784e242883b7d3fe5f36ef63d6950d...0a3881d4cfee5c4ee3991a1b14a10333355958f1,1,6,0,6,2,2006-11-15 18:23:47,2006-11-15 16:27:54
0a3881d4cfee5c4ee3991a1b14a10333355958f1...897643cc79cb8c05694c98a4fb0560c78952db3e,1,5,0,5,1,2006-11-15 20:01:30,2006-11-15 18:46:10
897643cc79cb8c05694c98a4fb0560c78952db3e...bf7e1472df65c948581e2fecd494eccfaa40b9d9,1,5,1,6,1,2006-11-15 20:01:44,2006-11-15 18:54:10
bf7e1472df65c948581e2fecd494eccfaa40b9d9...faa1bbfdd2c7d2f6cf556ee3f0d54cad42b08c61,1,1,1,2,1,2006-11-15 20:49:27,2006-11-15 20:37:50
faa1bbfdd2c7d2f6cf556ee3f0d54cad42b08c61...efe4abd14c75834d30e3e521b3597eb07ea9271b,1,10,0,10,1,2006-11-15 20:50:29,2006-11-15 20:15:44
efe4abd14c75834d30e3e521b3597eb07ea9271b...73fbd33cce281f116852d02963935f2ae90acc76,1,1,1,2,1,2006-11-15 22:57:47,2006-11-15 22:57:47
73fbd33cce281f116852d02963935f2ae90acc76...d09e79cb1c474b3bb323356e6d1072922ab7ccb2,2,47,2,49,5,2006-11-17 07:45:48,2006-11-16 19:47:22
d09e79cb1c474b3bb323356e6d1072922ab7ccb2...6b1f8c32b1a602734f14b9cf8a9f59a767752677,1,2,0,2,1,2006-11-17 07:45:57,2006-11-17 06:57:20
e267c2f6f0784e242883b7d3fe5f36ef63d6950d...ef58d9587ebad999b3decfcf369ba3b4ff72b121,1,5,1,6,1,2006-11-15 06:23:18,2006-11-15 06:23:18
c976d415e5352886f0650f8e2edba81866c38587...b0eab01a4824d9b6bcf23b51881fdc94ab3d38ec,1,0,8,8,2,2011-10-12 16:52:55,2011-10-12 16:42:26
c976d415e5352886f0650f8e2edba81866c38587...16c2bfbb449a90db00a46984d7dd7f735caa1d56,2,8,1,9,2,2006-12-06 07:50:57,2006-11-29 20:44:56
16c2bfbb449a90db00a46984d7dd7f735caa1d56...678d0f4cbfa7a3b529c6e894f2977bef6a2d3e4c,3,10,10,20,9,2006-12-06 07:50:57,2006-11-30 02:16:56
1576f5f7b2addd648a41fb5cfbcd2e6d632b7461...1510fea781cb0517eeba8c378964f7bc4f9577ab,2,28,3,31,8,2006-12-16 06:11:19,2006-12-14 11:15:57
1510fea781cb0517eeba8c378964f7bc4f9577ab...ebd124c6783da5e064963611ee17741cd173f6b5,9,84,29,113,24,2006-12-16 06:29:54,2006-12-15 04:15:44
ebd124c6783da5e064963611ee17741cd173f6b5...ef0a89a604acb7fc2e3c08566641b95b23d87fd6,4,17,10,27,12,2006-12-16 06:31:00,2006-12-15 05:44:58
ef0a89a604acb7fc2e3c08566641b95b23d87fd6...0bee59186976b1d9e6b2dd77332480c9480131d5,5,21,4,25,5,2006-12-16 06:31:01,2006-12-14 22:41:17
0bee59186976b1d9e6b2dd77332480c9480131d5...3a79347862f9864e580af2b9daeebac28be9c7a6,1,2,0,2,1,2006-12-16 06:31:01,2006-12-15 07:03:03
3a79347862f9864e580af2b9daeebac28be9c7a6...9013192449ed1148da4805e33a2644fca92dd1c7,1,21,3,24,4,2006-12-16 06:31:01,2006-12-15 07:20:03
9013192449ed1148da4805e33a2644fca92dd1c7...89c4afe0d011b71d0bbcd9ad43f367f6a0dc3d83,3,27,3,30,7,2006-12-16 06:31:01,2006-12-15 12:39:04
89c4afe0d011b71d0bbcd9ad43f367f6a0dc3d83...e697e4cd1fc492e312a396211bafc629d6297ebd,1,3,3,6,3,2006-12-16 06:31:01,2006-12-15 12:39:33
e697e4cd1fc492e312a396211bafc629d6297ebd...aeb80c70ec2baebbf107de0ea5293984798ddd24,2,7,6,13,5,2006-12-16 06:31:01,2006-12-16 02:53:09
aeb80c70ec2baebbf107de0ea5293984798ddd24...82dca84871637ac9812c0dec27f56d07cfba524c,4,13,12,25,10,2006-12-16 06:31:01,2006-12-16 02:53:13
d4ada4876d5ab7b271857917231f6006f2160bca...756bbf548dbef5b738c50ce6517f5c63ab929373,1,74,17,91,3,2006-12-25 18:40:43,2006-12-24 14:31:42
756bbf548dbef5b738c50ce6517f5c63ab929373...208b2dff95bb48682c351099023a1cbb0e1edf26,1,6,5,11,5,2006-12-25 18:40:43,2006-12-24 14:31:43
208b2dff95bb48682c351099023a1cbb0e1edf26...190d7fdcf325bb444fa806f09ebbb403a4ae4ee6,1,12,22,34,12,2006-12-25 18:40:43,2006-12-24 14:31:44
190d7fdcf325bb444fa806f09ebbb403a4ae4ee6...719dad28c599dc2e2917c3cb0e44152fd92bf133,1,14,11,25,6,2006-12-25 18:40:43,2006-12-24 14:31:45
719dad28c599dc2e2917c3cb0e44152fd92bf133...5ad66088d1166bf91cf2890682f4582049756539,1,9,14,23,8,2006-12-25 18:40:43,2006-12-24 14:31:46
5ad66088d1166bf91cf2890682f4582049756539...b6093a5c02f6dd16dadcc0e9caa1e0e76216f929,1,7,11,18,4,2006-12-25 18:40:44,2006-12-24 14:31:47
b6093a5c02f6dd16dadcc0e9caa1e0e76216f929...a8b983bfea9daa255fd32dfc6b39e809733e4c5a,1,9,18,27,9,2006-12-25 18:40:44,2006-12-24 14:31:48
a8b983bfea9daa255fd32dfc6b39e809733e4c5a...f47efbb7ab735fc49d8d93f9ed1c087c5da09c23,1,1,23,24,2,2006-12-25 18:40:44,2006-12-24 14:31:49
d4ada4876d5ab7b271857917231f6006f2160bca...e813d50e35653bdb0ce3329f99d1be7fc1c36de5,2,39,16,55,8,2006-12-25 11:29:08,2006-12-25 11:09:52
e813d50e35653bdb0ce3329f99d1be7fc1c36de5...9f95069beb507f496c8d3005defbaa27318f5347,1,103,20,123,13,2006-12-25 11:29:08,2006-12-25 11:11:00
9f95069beb507f496c8d3005defbaa27318f5347...467e1b5383c214e9562b2dc575ac027c54aa4fba,1,74,4,78,4,2006-12-25 11:29:08,2006-12-25 11:11:17
467e1b5383c214e9562b2dc575ac027c54aa4fba...08d22488a65fde7d570bd4ea57626f5352b9b064,1,27,24,51,8,2006-12-25 11:29:08,2006-12-25 11:23:45
08d22488a65fde7d570bd4ea57626f5352b9b064...4888c534099012d71d24051deb5b14319747bd1a,2,16,9,25,7,2006-12-25 11:29:08,2006-12-25 11:11:34
4888c534099012d71d24051deb5b14319747bd1a...e23ca9e1f95a756bfe598568be9d03059db1dad2,2,18,4,22,4,2006-12-25 11:29:08,2006-12-25 11:13:45
e23ca9e1f95a756bfe598568be9d03059db1dad2...1e423f56558e74a3a94c653108f64f0305199b9a,1,3,0,3,1,2006-12-25 18:38:35,2006-12-25 18:38:35
1e423f56558e74a3a94c653108f64f0305199b9a...6a1ad32519898a8fa4400e081c2d61fd3af42e2c,2,35,7,42,10,2006-12-26 01:46:38,2006-12-26 01:46:38
63c4b4c5c1335cca263d7a9ab4e6cfe5fd03dfec...ce0545455a09113a8ece8f80c87ec61110569940,1,2,2,4,2,2006-12-20 22:41:54,2006-12-20 22:41:54
c326246accf36bc070b326773df2b9ec1c336037...041e69c9984972c51cbf21a70b0327d83dee41db,1,76,0,76,1,2007-01-09 05:42:37,2007-01-09 04:28:51
041e69c9984972c51cbf21a70b0327d83dee41db...49fb940e4025f36953cd938576ec8306335c6cd0,1,8,1,9,2,2007-01-09 05:44:07,2007-01-09 02:10:32
49fb940e4025f36953cd938576ec8306335c6cd0...3486595bf1671cabb6fa22d276db2907eefbf9b6,1,4,1,5,2,2007-01-09 05:45:13,2007-01-09 02:10:41
3486595bf1671cabb6fa22d276db2907eefbf9b6...3f43d72392b6c0477debd7edbd49bae9b7f41e60,1,0,284,284,1,2007-01-09 05:52:38,2007-01-09 05:52:38
3f43d72392b6c0477debd7edbd49bae9b7f41e60...baee1e91ed41cd369ca3ddd63615b64feaa0286f,1,2,0,2,2,2007-01-09 05:53:23,2007-01-09 05:27:33
baee1e91ed41cd369ca3ddd63615b64feaa0286f...cdd4fb15cf06ec1de588bee4576509857d8e2cb4,2,31,0,31,4,2007-01-09 06:00:18,2007-01-09 05:27:41
cdd4fb15cf06ec1de588bee4576509857d8e2cb4...1295228d1fdda17c2ef62e712649c962c3da5eb7,1,4,2,6,4,2007-01-09 07:10:49,2007-01-09 07:10:49
b60daf0515889ca75f88f1d4d49a6a9c4117ba36...e66191f4837f2d18bb70ceaf3cad4eb52cc4000c,2,4,2,6,3,2007-01-13 18:03:04,2007-01-13 10:47:53
e66191f4837f2d18bb70ceaf3cad4eb52cc4000c...c03f77573ac4db7f549948c4c0de4fa3c9eb545c,1,6,1,7,1,2007-01-13 18:03:44,2007-01-13 11:55:21
b60daf0515889ca75f88f1d4d49a6a9c4117ba36...9fde9401a9c3974a407f302d60a1b75e8787f715,1,11,0,11,1,2007-01-13 00:54:38,2007-01-12 20:44:08
9fde9401a9c3974a407f302d60a1b75e8787f715...514c09fdcfef6385f1a61ee52344794356c99986,4,11,29,40,9,2007-01-13 00:54:38,2007-01-12 20:49:05
514c09fdcfef6385f1a61ee52344794356c99986...533b70390e540de4e0faed4823ee561c8368e5ec,4,12,2,14,10,2007-01-13 00:54:38,2007-01-12 20:52:03
67583917e9a2a85605c1123a62c8883593e7e889...2f99710cfe2aacce077c510f93b51edd9ba16a0d,1,23,17,40,7,2007-01-15 03:43:47,2007-01-15 03:43:47
2f99710cfe2aacce077c510f93b51edd9ba16a0d...ef89f701a0c214fa2967e921f8d3891e25cf3125,1,200,2,202,3,2007-01-21 02:41:48,2007-01-21 02:41:48
ef89f701a0c214fa2967e921f8d3891e25cf3125...e4add70cd4ce287c9866f7eec5f1e42245e6f846,1,22,8,30,3,2007-01-22 03:02:34,2007-01-22 03:02:34
e4add70cd4ce287c9866f7eec5f1e42245e6f846...fe4b3e591bdfe580cfc716653dd5ac2105d23f8a,1,3,0,3,1,2007-01-22 03:14:39,2007-01-22 03:14:39
fe4b3e591bdfe580cfc716653dd5ac2105d23f8a...f60b964249fb38fea7906559875c600665a2d991,1,19,27,46,7,2007-01-22 03:31:07,2007-01-22 03:31:07
f60b964249fb38fea7906559875c600665a2d991...17217090cf92e094f711359d92196e8129e3281c,1,3,5,8,2,2007-01-22 04:03:36,2007-01-22 04:03:36
17217090cf92e094f711359d92196e8129e3281c...11e016a32c1ac5535a9a248e23bc9a7e1f6c43d2,1,21,0,21,1,2007-01-26 05:17:12,2007-01-26 05:17:12
11e016a32c1ac5535a9a248e23bc9a7e1f6c43d2...b181d57ff40d94799a595045718039dc9d4320f7,1,954,204,1158,28,2007-01-27 06:12:19,2007-01-27 06:03:07
b181d57ff40d94799a595045718039dc9d4320f7...21dcb3b7abfb9e06914a36d1afbc768de6db5f1f,1,118,6,124,2,2007-01-29 04:29:19,2007-01-29 04:29:19
21dcb3b7abfb9e06914a36d1afbc768de6db5f1f...04e50e94570cc2e71abe0451723fbd89e4893c5f,1,8,8,16,6,2007-01-29 04:31:47,2007-01-29 04:31:47
04e50e94570cc2e71abe0451723fbd89e4893c5f...9d13bda3fffc948c0b2576f08a33ac7f547fe9b3,1,9,9,18,9,2007-01-29 04:50:22,2007-01-29 04:50:22
9d13bda3fffc948c0b2576f08a33ac7f547fe9b3...fc90c536dc5f29a89402e5f5411a3283c644b864,1,7,3,10,2,2007-01-29 05:17:51,2007-01-29 05:17:51
fc90c536dc5f29a89402e5f5411a3283c644b864...988b27d3f5ca06e0ae8fd48acaf90f33cfac4304,1,1,1,2,1,2007-01-29 05:33:57,2007-01-29 05:33:57
988b27d3f5ca06e0ae8fd48acaf90f33cfac4304...61b41790c4d6abccf86c87f7ae312da8adbac3dd,1,1,1,2,1,2007-01-29 05:45:33,2007-01-29 05:45:33
61b41790c4d6abccf86c87f7ae312da8adbac3dd...559e4d7a0d2e98e887ac93c78631d3eeef378716,1,78,15,93,3,2007-01-29 06:31:35,2007-01-29 06:31:35
559e4d7a0d2e98e887ac93c78631d3eeef378716...1191ee1824aca8f817e531db6b779a11e7fe3c28,1,59,56,115,11,2007-01-29 06:33:55,2007-01-29 06:33:55
1191ee1824aca8f817e531db6b779a11e7fe3c28...9a241220fd19c93a89501bfef51ce4ec79a79033,1,6,9,15,3,2007-01-29 06:43:33,2007-01-29 06:43:33
9a241220fd19c93a89501bfef51ce4ec79a79033...4a7979ca829530c4e5661d553449b0b073a50db3,1,28,2,30,3,2007-01-29 07:00:35,2007-01-29 06:55:33
4a7979ca829530c4e5661d553449b0b073a50db3...d55ae921ce33dc989b6b77317f25a5aa58d406fe,1,5,5,10,4,2007-01-29 07:16:45,2007-01-29 07:16:45
d55ae921ce33dc989b6b77317f25a5aa58d406fe...036be17e0a6fe38beed3a163a4a944b5ed3d7b7b,1,2,2,4,2,2007-01-29 07:18:53,2007-01-29 07:16:46
036be17e0a6fe38beed3a163a4a944b5ed3d7b7b...a8cd1402f039d5e130a32a32a56fd29fbd46c1e8,1,4,1,5,2,2007-01-30 17:43:36,2007-01-30 17:43:36
a8cd1402f039d5e130a32a32a56fd29fbd46c1e8...0b375ab0a511568fe2c80aede9a297b640212d35,1,3,1,4,2,2007-01-30 17:48:48,2007-01-30 17:48:48
c53d696bcc2894b0df277e617740b15bac794df9...25fb62905890d7860f742b4f2215fdf754ae7fee,1,9,6,15,3,2006-12-13 09:11:05,2006-12-13 08:59:58
25fb62905890d7860f742b4f2215fdf754ae7fee...a159ca0cb7e0acdd37cb066327dcb020d95602d0,6,15,12,27,15,2006-12-13 09:47:36,2006-12-13 09:13:28
f0b0af1b04f558b684cae2a3b805ca4bab84d45f...8fcf1ad9c68e15d881194c8544e7c11d33529c2b,1,1,1,2,1,2006-02-25 06:17:20,2006-02-23 22:42:39
5343cf1082c93e41515acbc36a4a9c8c5995d4ac...cc5c59a30ccba8b9eac503271661af9b95edb0af,1,30,47,77,11,2006-03-02 05:51:00,2006-02-22 01:45:36
cc5c59a30ccba8b9eac503271661af9b95edb0af...5bb86b82ba18dd2eb736c4f5565f9c920f815b8f,1,56,13,69,11,2006-03-02 05:51:14,2006-02-28 04:09:55
5bb86b82ba18dd2eb736c4f5565f9c920f815b8f...38fd0721d0a2a1a723bc28fc0817e3571987b1ef,6,40,21,61,20,2006-03-02 05:53:22,2006-02-28 04:38:28
46444f514bf5a1df17885283634256a86fa11196...b30cc0daaf8e5c179356e0d9ec9e081464956c7e,1,60,25,85,11,2006-03-05 10:22:53,2006-03-05 10:11:00
b30cc0daaf8e5c179356e0d9ec9e081464956c7e...4a5d6939509f9aeef600ea17643caef4c898b12f,1,5,1,6,2,2006-03-05 10:32:13,2006-03-05 09:36:33
4a5d6939509f9aeef600ea17643caef4c898b12f...9201c707426b3dc0c894775416f576c25c008d46,10,44,39,83,35,2006-03-05 10:47:29,2006-03-05 10:47:29
46444f514bf5a1df17885283634256a86fa11196...de84f99c12d1819479116685393afb1ebe99810b,7,371,27,398,36,2006-03-05 08:58:13,2006-03-05 08:24:15
e6bfaf3e33beba9431490a4f5c7a9753986554c4...360204c324ca9178e2bcb4d75f3986201f8ac7e1,1,1,1,2,1,2006-04-17 21:17:50,2006-04-17 11:41:49
e6bfaf3e33beba9431490a4f5c7a9753986554c4...1b65a5aa449e2ea99a68f5d13c5521d0dc64dfd1,4,36,10,46,8,2006-04-17 05:05:38,2006-04-17 01:12:49
ad0b46bf4a8ac931687341234bf61fd9c41880a2...f0853837d6ee69dccfa59222a0e869de94bdddc6,1,13,2,15,3,2006-04-09 03:32:40,2006-04-08 05:34:11
f0853837d6ee69dccfa59222a0e869de94bdddc6...a041d94f29d76d53ff3cc4169b99c6eefea8639d,1,3,2,5,3,2006-04-09 03:32:40,2006-04-09 02:45:39
a041d94f29d76d53ff3cc4169b99c6eefea8639d...fc5807190ef700d01e25968f48438736f18ae3dc,1,10,4,14,6,2006-04-09 03:32:41,2006-04-09 03:17:46
fc5807190ef700d01e25968f48438736f18ae3dc...0ed49a3ed9ab9747f7916c928d50aa0bf4d2c81d,1,3,2,5,3,2006-04-09 06:35:22,2006-04-08 15:27:20
6cbd5d7d79f5751828397558e7c3611b048565fb...ba3c93743a8151e3663e1fda6b3cb165d8373ddf,1,1,0,1,1,2006-04-06 01:21:17,2006-04-06 01:21:17
6cbd5d7d79f5751828397558e7c3611b048565fb...38035cf4a51c48cccf6c5e3977130261bc0c03a7,1,56,21,77,14,2006-04-05 22:47:17,2006-04-05 22:31:12
b09344891010330dcdd26b90453e7e31c780612e...e72ee5ebc8de90ad6de8f9318f75ebd45b2ca001,1,1,0,1,1,2006-05-19 23:58:49,2006-05-19 23:58:49
b09344891010330dcdd26b90453e7e31c780612e...908c35850a9aed6efd1a6a616e594a28467230fa,1,298,67,365,48,2006-05-19 23:38:11,2006-05-19 23:38:11
3d990f110c2e5b8df83f6ab3ef83497f43c7fd47...060729dd7e4e7d366f09d2e13d796f05ec1734a9,2,6,2,8,3,2006-05-03 21:19:01,2006-05-03 10:53:19
060729dd7e4e7d366f09d2e13d796f05ec1734a9...c8c893c62b0d9997e7dfe7bd5f636ddbf29ef619,1,16,2,18,3,2006-05-03 21:19:02,2006-05-03 14:59:00
c8c893c62b0d9997e7dfe7bd5f636ddbf29ef619...095acb8a2ac86c003d89886c5df7706c44912196,1,3,2,5,2,2006-05-03 23:32:28,2006-05-03 22:53:37
095acb8a2ac86c003d89886c5df7706c44912196...899707dac0c4a29b5b05a88a0017639508d48e7f,1,5,5,10,5,2006-05-04 00:09:36,2006-05-03 21:28:46
3d990f110c2e5b8df83f6ab3ef83497f43c7fd47...9f0bb90d161edf8c43f5261d12bf83f14eb02ff4,6,17,11,28,8,2006-05-03 03:09:56,2006-05-02 07:40:24
3d990f110c2e5b8df83f6ab3ef83497f43c7fd47...2fa9a0fb31cbf01e8318a02c3e222d7fd3fd0a83,3,60,8,68,14,2006-05-03 03:09:54,2006-05-02 12:22:48
2fa9a0fb31cbf01e8318a02c3e222d7fd3fd0a83...e098c6f82a28efe1488c7eb1bed4e92f76dd2afd,1,20,26,46,12,2006-05-03 04:06:56,2006-05-03 04:06:56
810e1523753553968aac827f57e0e24fc9af6546...7fa8ddd6e283f120938e379c980624798561c32d,1,1,1,2,1,2006-04-04 21:36:22,2006-04-04 18:01:30
7fa8ddd6e283f120938e379c980624798561c32d...20fc9bc5e4fdd4b1f7fd98fbd2e91879f945d7e1,2,5,0,5,2,2006-04-04 21:42:47,2006-04-04 17:11:29
810e1523753553968aac827f57e0e24fc9af6546...d01d8c6782850c18d62676dae3c72ad73be1e52e,4,57,16,73,16,2006-04-04 20:44:15,2006-03-29 00:16:33
3d9c54d7b39faab35f0b30459fe4e2c7f32124b8...fc4c4cd21c783b6dc387002c6e018d26f7405e9f,1,1,1,2,1,2006-04-04 21:52:53,2006-04-04 21:52:53
5b766ea9014b4121cb72f424633b6bf9a97308a0...070879ca93a7d358086f4c8aff4553493dcb9210,4,47,32,79,13,2006-02-12 13:12:39,2006-02-12 01:57:57
070879ca93a7d358086f4c8aff4553493dcb9210...2b796360acbdf3186ab9a5dcb84fe416eda4ffd5,1,4,2,6,3,2006-02-12 13:12:39,2006-02-12 02:51:19
2b796360acbdf3186ab9a5dcb84fe416eda4ffd5...d7ee090d0d425606c599327c01fcbcdb60f6b090,1,1,1,2,1,2006-02-12 19:24:50,2006-02-12 19:24:50
d7ee090d0d425606c599327c01fcbcdb60f6b090...ef1af9d9afe2f402ad60b054ac529c03c4b79299,1,1,1,2,1,2006-02-12 19:36:17,2006-02-12 18:03:16
ef1af9d9afe2f402ad60b054ac529c03c4b79299...0dbc4e89bb3ddaaa4230f91d5f59b08f3d33e91b,2,3,2,5,2,2006-02-12 19:36:19,2006-02-12 18:05:34
36cd2cc7d949e1cc39104307fe904c47fe6d5526...f1ec72ba1e52783179a7da7defaab0458c895617,1,7,7,14,2,2005-12-28 19:09:53,2005-12-28 11:25:38
f1ec72ba1e52783179a7da7defaab0458c895617...89438677abaae1a8ffc3c0905f3355a590da7bf4,17,20,20,40,20,2005-12-29 09:32:56,2005-12-29 09:20:06
89438677abaae1a8ffc3c0905f3355a590da7bf4...82f9d58a397e18e824eb0e16ee141e92fbd8d20b,7,7,7,14,7,2005-12-29 09:32:56,2005-12-29 09:30:08
82f9d58a397e18e824eb0e16ee141e92fbd8d20b...4e7a2eccc21c9029180585e43b3b941d0bdf8b3b,1,6,0,6,3,2005-12-29 09:33:40,2005-12-29 09:31:26
4e7a2eccc21c9029180585e43b3b941d0bdf8b3b...8b32572c74172dfc1b3c86f2940deb8f384b1bc4,1,14,2,16,3,2006-01-06 01:22:31,2005-12-31 17:30:25
8b32572c74172dfc1b3c86f2940deb8f384b1bc4...0a15217184f20649c0ab19b24363e35112a91beb,1,8,8,16,5,2006-01-06 01:22:37,2006-01-05 00:31:02
0a15217184f20649c0ab19b24363e35112a91beb...b73cebf437252660cea670c27dcdedc422e1bff9,1,1,1,2,1,2006-01-06 01:22:43,2006-01-05 03:33:55
b73cebf437252660cea670c27dcdedc422e1bff9...7f272ca80c1dbb8157e204a821365448eaec52ea,1,1,1,2,1,2006-01-06 01:22:45,2006-01-05 08:56:37
7f272ca80c1dbb8157e204a821365448eaec52ea...781411ed46400f95c45c5ca103769288025b39d6,2,2,2,4,2,2006-01-06 01:22:47,2006-01-05 08:58:06
781411ed46400f95c45c5ca103769288025b39d6...d9e08be9d5b632aed84d4ee870543babafe6614b,1,2,1,3,1,2006-01-06 01:22:49,2006-01-05 09:00:12
d9e08be9d5b632aed84d4ee870543babafe6614b...88fb958baa1066af23348c44a78b812be2344088,1,12,5,17,5,2006-01-06 01:22:51,2006-01-05 11:43:34
88fb958baa1066af23348c44a78b812be2344088...b6ae5409ea446365c328561dc17311111058ec26,1,1,1,2,1,2006-01-06 01:23:16,2006-01-05 11:44:59
b6ae5409ea446365c328561dc17311111058ec26...50b4e0c178777a27164eb67676593255a9cbd035,1,2,1,3,1,2006-01-06 01:23:21,2006-01-05 11:44:18
50b4e0c178777a27164eb67676593255a9cbd035...31f883d1b8439b36d17ca79cf5eac992fb461f5a,1,2,2,4,2,2006-01-06 01:23:41,2006-01-05 11:46:16
31f883d1b8439b36d17ca79cf5eac992fb461f5a...e58b97af31779a4db84877082ef619f0e3bd1d6c,1,8,0,8,1,2006-01-06 01:23:44,2006-01-05 11:55:03
e58b97af31779a4db84877082ef619f0e3bd1d6c...b484ef28fbdc3e2ac242c37507eee5ace90f3915,2,22,7,29,2,2006-01-06 01:23:46,2006-01-05 11:55:58
b484ef28fbdc3e2ac242c37507eee5ace90f3915...10ae7d86c170554bc815ec460a83b608715063c1,1,1,0,1,1,2006-01-06 01:24:42,2006-01-05 16:38:58
10ae7d86c170554bc815ec460a83b608715063c1...2ccd2027b012f481018b9a95929fa8df6ce1d33f,1,1,1,2,1,2006-01-06 01:24:47,2006-01-05 11:57:36
2ccd2027b012f481018b9a95929fa8df6ce1d33f...6ff0b1c56c451445f7dc45b652a4dc60213eac19,1,1,1,2,1,2006-01-06 01:24:51,2006-01-05 11:52:07
6ff0b1c56c451445f7dc45b652a4dc60213eac19...353ce81597e831969ac37d6991346f8c39c1488e,16,49,34,83,22,2006-01-06 02:44:28,2005-12-31 17:37:15
353ce81597e831969ac37d6991346f8c39c1488e...81214e4ddf2f0114ce7756a014dc533340fcb3f9,1,14,5,19,1,2006-01-06 03:42:12,2006-01-06 03:42:12
81214e4ddf2f0114ce7756a014dc533340fcb3f9...aa66c7ec77d474b737da607d6cb2d07f56628def,2,2,0,2,2,2006-01-06 04:02:33,2006-01-06 03:50:37
aa66c7ec77d474b737da607d6cb2d07f56628def...6ce183216d6c4b234d4515c21a864615cd278d0b,1,6,3,9,2,2006-01-06 04:14:40,2006-01-06 04:14:40
6ce183216d6c4b234d4515c21a864615cd278d0b...2961e0ee8b3c49853f2da4b485d4e3851e973e9d,1,4,2,6,1,2006-01-06 04:28:14,2006-01-01 21:25:47
2961e0ee8b3c49853f2da4b485d4e3851e973e9d...2ed8e622bf6b718d4808e1dd2e564247f9931dde,1,3,3,6,3,2006-01-06 04:28:19,2006-01-01 21:32:53
2ed8e622bf6b718d4808e1dd2e564247f9931dde...da6bf70ebf7d485e3643ba3569962a4c08e37906,1,5,0,5,1,2006-01-06 04:28:52,2006-01-03 09:53:54
da6bf70ebf7d485e3643ba3569962a4c08e37906...c1fe2fe4fe685e0587c3949f953aab726de88994,1,1,1,2,1,2006-01-06 04:29:52,2006-01-03 14:38:15
592ee97d8fffa2318960074057e044709163abf7...9ce7028531fd7ce1ca8d75a5c4f9a941ef79c9d4,1,2,2,4,3,2005-11-11 18:52:38,2005-11-10 07:36:15
9ce7028531fd7ce1ca8d75a5c4f9a941ef79c9d4...6b209d473378cc25708ab9839d0edd493afc1e8f,1,53,11,64,11,2005-11-11 18:52:38,2005-11-10 23:47:58
6b209d473378cc25708ab9839d0edd493afc1e8f...4bc51db0feb4a93a285d6333f206cad77c83ed57,1,2,2,4,2,2005-11-11 18:52:39,2005-11-11 02:27:44
592ee97d8fffa2318960074057e044709163abf7...ed9a540b2b351ea305e26bb0d9028f21c976b67c,1,77,1,78,5,2005-11-11 18:52:30,2005-11-11 01:21:54
ed9a540b2b351ea305e26bb0d9028f21c976b67c...9e5f4a5539fe0e6ed31f26f34f1832a729facf4b,1,43,34,77,2,2005-11-11 18:52:31,2005-11-11 06:41:44
9e5f4a5539fe0e6ed31f26f34f1832a729facf4b...53de71f88b0d5a55892c19b412688548f5797f0b,1,59,0,59,1,2005-11-11 18:52:31,2005-11-11 09:00:52
8ac3a61f59173d4a9a328518be83a25df610a5ef...e2029eb963bab6efeff48a7e1ded93842a257717,1,6,3,9,1,2005-10-23 18:49:25,2005-10-21 16:18:46
e2029eb963bab6efeff48a7e1ded93842a257717...1114b26e8f2d06912d855c631e51a4ee8a06c4e2,3,237,1,238,3,2005-10-24 00:25:08,2005-10-23 16:15:34
1114b26e8f2d06912d855c631e51a4ee8a06c4e2...7744f3b8882812d4ff3e75a3c84763895f5d9cdf,1,1,1,2,1,2005-10-24 10:23:46,2005-10-22 17:22:58
7744f3b8882812d4ff3e75a3c84763895f5d9cdf...38cc7ab8144e111b47ac0ad3fcf6cb70d546e473,1,1,1,2,1,2005-10-24 22:11:47,2005-10-24 22:11:47
38cc7ab8144e111b47ac0ad3fcf6cb70d546e473...35eb2d36418a25f9e956b116a622d8d99f4abad9,4,106,2,108,6,2005-10-24 22:12:41,2005-10-23 21:30:45
35eb2d36418a25f9e956b116a622d8d99f4abad9...794f9fe7db30e2aff8f8f0543c6d18bf579cdbc2,1,20,5,25,5,2005-10-24 22:13:36,2005-10-23 01:36:06
794f9fe7db30e2aff8f8f0543c6d18bf579cdbc2...0f8fdc3958ad0cb7c740b76189f98307eebcd64b,1,15,22,37,6,2005-10-24 22:13:37,2005-10-23 01:37:45
0f8fdc3958ad0cb7c740b76189f98307eebcd64b...69779a562a171d9b70bbb17b89e076bd6b16ae6c,1,119,32,151,8,2005-10-24 22:13:37,2005-10-23 01:39:08
69779a562a171d9b70bbb17b89e076bd6b16ae6c...40a10462498bdd23d4e49f02867b8be50eb78704,2,41,14,55,12,2005-10-24 22:13:37,2005-10-23 01:40:13
40a10462498bdd23d4e49f02867b8be50eb78704...7efc8e43508b415e2540dbcb79521bde16c51e0c,1,3,1,4,1,2005-10-24 22:13:38,2005-10-23 10:02:18
7efc8e43508b415e2540dbcb79521bde16c51e0c...af2d3aa4d84fd3475d9b676f669eab3c4227189f,3,72,196,268,27,2005-10-25 21:55:24,2005-10-25 21:55:24
af2d3aa4d84fd3475d9b676f669eab3c4227189f...979e32fa1483a32faa4ec331e29b357e5eb5ef25,1,2,2,4,2,2005-10-26 00:37:59,2005-10-25 23:29:09
979e32fa1483a32faa4ec331e29b357e5eb5ef25...05ff5649a4fd90c3c80f507165bbaf07dc0dbe8e,1,11,1,12,2,2005-10-26 05:50:49,2005-10-25 12:20:45
05ff5649a4fd90c3c80f507165bbaf07dc0dbe8e...d43367af55d8f67508000291b22e96c0a6b072dd,2,38,0,38,2,2005-10-26 05:51:13,2005-10-25 21:43:30
d43367af55d8f67508000291b22e96c0a6b072dd...f6ab5bb265ac821d9aab3755059eeadb615f512b,1,5,0,5,2,2005-10-26 05:51:18,2005-10-25 15:26:25
f6ab5bb265ac821d9aab3755059eeadb615f512b...8548ea8ded0d7025f2540ce8d4648dbf76065d3a,1,18,0,18,6,2005-10-26 05:51:39,2005-10-25 22:03:21
8548ea8ded0d7025f2540ce8d4648dbf76065d3a...129adf4d668d04c875bfd7207ba60547b066d5af,1,43,8,51,6,2005-10-26 05:53:24,2005-10-25 18:50:46
129adf4d668d04c875bfd7207ba60547b066d5af...271440e3b65f0c599e19fdd6bc07aeccc16699fb,2,14,8,22,3,2005-10-26 06:35:37,2005-10-26 06:35:37
271440e3b65f0c599e19fdd6bc07aeccc16699fb...f89ad67fb054bead054bc92b4d0d4d007248b611,1,8,5,13,3,2005-10-26 06:43:59,2005-10-26 06:43:59
f89ad67fb054bead054bc92b4d0d4d007248b611...303958dc42d451aead0e1b9cf7b9836831a05f4b,1,7,5,12,3,2005-10-26 06:46:15,2005-10-25 23:40:31
303958dc42d451aead0e1b9cf7b9836831a05f4b...9e48b389990c0201487e58f3bac32734a59a7e89,2,5,2,7,4,2005-10-26 06:49:43,2005-10-25 23:41:20
9e48b389990c0201487e58f3bac32734a59a7e89...565ebbf79f61873042c22a7126d002c104e056f4,1,27,4,31,7,2005-10-26 06:53:28,2005-10-25 01:59:18
565ebbf79f61873042c22a7126d002c104e056f4...b5c367f75c2990650119749a1add5216871ca47a,1,8,7,15,2,2005-10-26 18:52:19,2005-10-26 14:18:56
b5c367f75c2990650119749a1add5216871ca47a...7ebb6fcafed2a3d47390e6f47ff20a98fe451409,1,14,13,27,1,2005-10-26 18:58:24,2005-10-26 17:27:36
7ebb6fcafed2a3d47390e6f47ff20a98fe451409...f3123c4ab3d3698262e59561ac084de45b10365a,4,112,12,124,6,2005-10-26 19:37:49,2005-10-22 08:28:13
f3123c4ab3d3698262e59561ac084de45b10365a...bd321bcc51e95f644ac5335abe673afcbcaade62,3,313,1,314,3,2005-10-26 23:31:58,2005-10-26 13:10:20
df73e9c62a9f0e6cdf20f095b99abf32c8e65c75...257380896fa4d11f6b6d7773f18c153001a95b60,1,1,1,2,1,2005-10-13 17:01:38,2005-10-13 17:01:38
257380896fa4d11f6b6d7773f18c153001a95b60...2ae6c706749b44f05917fcd04037f545d16fb345,2,212,19,231,19,2005-10-13 18:36:37,2005-10-13 18:36:37
2ae6c706749b44f05917fcd04037f545d16fb345...5990efb0c4f6d1a19c4702bf50ef8cc5ac902a78,1,8,6,14,2,2005-10-13 18:57:05,2005-10-13 18:57:05
b163512d4eb36ee946908b682c7863658c5a8db4...bc7ccfd2d7342bf81d344c4215a17ebbb64d9212,2,5,3,8,2,2005-09-23 04:43:19,2005-09-20 06:52:33
bc7ccfd2d7342bf81d344c4215a17ebbb64d9212...80077f071614ef1775472eb54d59c071e15d5784,1,10,13,23,9,2005-09-23 04:52:10,2005-09-21 16:33:54
80077f071614ef1775472eb54d59c071e15d5784...a82d07e5e61a9aef38d70277a5b27588a939c5ce,1,5,0,5,2,2005-09-23 04:52:11,2005-09-21 16:33:59
a82d07e5e61a9aef38d70277a5b27588a939c5ce...754ac00e710386ab575843225768d4885c11c8c4,1,1,6,7,3,2005-09-23 04:52:11,2005-09-21 16:34:04
754ac00e710386ab575843225768d4885c11c8c4...51d8faf8608aa8d2f6a8c4b3c1b712adb0d39325,1,1,3,4,3,2005-09-23 04:52:11,2005-09-21 16:34:09
51d8faf8608aa8d2f6a8c4b3c1b712adb0d39325...7b64d06b2e74612a0970c8563845cb9ee34724af,1,5,8,13,4,2005-09-23 04:52:11,2005-09-21 16:34:14
7b64d06b2e74612a0970c8563845cb9ee34724af...2449696bcd8b458ae604c35898ecab7271b97b40,1,0,2,2,1,2005-09-23 04:52:11,2005-09-21 16:34:19
2449696bcd8b458ae604c35898ecab7271b97b40...24451c31032d4ea3e7750b5f9c61e9c9f1657449,1,3,3,6,1,2005-09-23 04:52:11,2005-09-21 16:34:24
24451c31032d4ea3e7750b5f9c61e9c9f1657449...2c08b3638339f9b73128c41a4882e115222608a3,1,0,1,1,1,2005-09-23 04:52:12,2005-09-21 16:34:29
0493a3fd5204a36bc961a8611770ddb9ec1ed8ed...e8d2a6d483a6f556a509fc8debdb9391a5fa2630,1,10,13,23,9,2005-09-21 19:32:31,2005-09-21 16:33:54
e8d2a6d483a6f556a509fc8debdb9391a5fa2630...f9cff269122432c4de47341f16c1661c7492d398,1,5,0,5,2,2005-09-21 19:32:32,2005-09-21 16:33:59
f9cff269122432c4de47341f16c1661c7492d398...125beb1e27c2f496a04b90b6079753c2baf49c31,1,1,6,7,3,2005-09-21 19:32:32,2005-09-21 16:34:04
125beb1e27c2f496a04b90b6079753c2baf49c31...c5c0f452f5d123db7a78b46f9f1734967243ad68,1,1,3,4,3,2005-09-21 19:32:32,2005-09-21 16:34:09
c5c0f452f5d123db7a78b46f9f1734967243ad68...5de0bfffbc3e32ca3574987a350b984d4a899f2e,1,5,8,13,4,2005-09-21 19:32:32,2005-09-21 16:34:14
5de0bfffbc3e32ca3574987a350b984d4a899f2e...a85988d292152cd758026d542dff16cc9c6020a6,1,0,2,2,1,2005-09-21 19:32:32,2005-09-21 16:34:19
a85988d292152cd758026d542dff16cc9c6020a6...478dbeec9936e4556a9232f1fd908ffe2a96a723,1,3,3,6,1,2005-09-21 19:32:33,2005-09-21 16:34:24
478dbeec9936e4556a9232f1fd908ffe2a96a723...4041483e5a3d2010e038ec686ef1638cde659f0b,1,0,1,1,1,2005-09-21 19:32:33,2005-09-21 16:34:29
4041483e5a3d2010e038ec686ef1638cde659f0b...b91fb518cc5c5f316ba149ceedff5ee194f44ebf,2,11,86,97,7,2005-09-21 20:59:54,2005-09-21 20:59:54
b91fb518cc5c5f316ba149ceedff5ee194f44ebf...acfadcfb48e34fdc441e9cffbb385fce9693b363,1,7,33,40,3,2005-09-21 21:01:56,2005-09-21 21:01:56
acfadcfb48e34fdc441e9cffbb385fce9693b363...01c6ad29bd1b647d4fd1acea54e374c740ec3c10,1,14,10,24,4,2005-09-22 08:53:36,2005-09-21 22:50:28
01c6ad29bd1b647d4fd1acea54e374c740ec3c10...0fe51391a80919870f94ddb442df234bb2223f3b,5,1,117,118,5,2005-09-22 08:54:12,2005-09-17 05:21:36
0fe51391a80919870f94ddb442df234bb2223f3b...9dcc829fe13b7c843a1df6c38479d5b8b8c7d20f,6,3,235,238,7,2005-09-22 08:54:12,2005-09-17 05:30:55
9dcc829fe13b7c843a1df6c38479d5b8b8c7d20f...5cfcd07c931e6029a77f9393309f7d0ec7cdc118,11,2,415,417,15,2005-09-22 08:54:13,2005-09-21 06:24:39
5cfcd07c931e6029a77f9393309f7d0ec7cdc118...f8ff0c0641a14770a2214fffbd4271b1ea3a0d61,1,90,4,94,11,2005-09-23 01:00:28,2005-09-22 09:25:28
f8ff0c0641a14770a2214fffbd4271b1ea3a0d61...c8b48ba4767ff9da19ef4f41f8d870f11742d833,4,99,24,123,8,2005-09-23 01:09:07,2005-09-22 07:55:22
c8b48ba4767ff9da19ef4f41f8d870f11742d833...d154dcc8b62ff609a0a3b271e1665c53df5c06a5,1,2,2,4,1,2005-09-23 01:31:14,2005-09-22 15:51:57
d6179f56f82252dca6443e736915a2cf45cdf9f3...990f856a62a24bfd56bac1f5e4581381369e4ede,2,7,1,8,2,2005-09-23 04:53:33,2005-09-23 04:53:33
ad8261d21221d27638c75f47b39892db6f7972f6...bb3f45838b859c8b17a53a24579a304333868cc8,2,12,3,15,4,2014-01-09 23:05:26,2014-01-09 19:47:34
9a597edc831038b8c449bd3e527ca2976e4e55a6...0ae0e882b2dd8048e2096138561f0b2ab0cad454,1,9,0,9,1,2014-07-10 20:31:55,2014-06-16 12:55:57
9a597edc831038b8c449bd3e527ca2976e4e55a6...526d56e07200483fc93be9c2dfee81bb87713c9b,1,3,3,6,3,2014-06-17 20:39:12,2014-06-16 23:59:59
526d56e07200483fc93be9c2dfee81bb87713c9b...7b1732c11605f84b809bd120401df49866c27141,1,6,6,12,2,2014-06-17 20:39:52,2014-06-17 00:03:43
7b1732c11605f84b809bd120401df49866c27141...4baf839fe0e71dca3f26198b7a4faab439fa2ef6,1,13,0,13,2,2014-06-17 20:41:28,2014-06-17 00:05:54
4baf839fe0e71dca3f26198b7a4faab439fa2ef6...06ca0f45a063f7186cce96a58a5fb6bef16ec204,1,40,0,40,1,2014-06-17 20:41:39,2014-06-17 00:06:24
06ca0f45a063f7186cce96a58a5fb6bef16ec204...aa4b78d483a918ebee810993e420b4697b0de4d3,2,8,0,8,2,2014-06-17 20:41:41,2014-06-17 00:07:07
aa4b78d483a918ebee810993e420b4697b0de4d3...958b2eb26c82f9d99d1fb4d3270601d0a18eaf38,2,6,6,12,2,2014-06-25 22:01:06,2014-06-25 21:42:17
9a597edc831038b8c449bd3e527ca2976e4e55a6...04953bc888e648dc22c172ffa74de1b2a08a209a,1,1,1,2,1,2014-06-16 19:00:43,2014-06-14 19:09:29
3bb486e4397415e1855e5edbf28d8e50c3d45265...c44132fcf383cf668d3764c6b7ad28ff034ee981,2,1,2,3,2,2014-02-10 19:19:39,2014-02-10 19:16:38
3bb486e4397415e1855e5edbf28d8e50c3d45265...a87679339c0abb67b0be8b8b1cc10483f28df038,4,0,0,0,0,2014-02-10 18:21:06,2014-02-06 15:10:34
a87679339c0abb67b0be8b8b1cc10483f28df038...32752e966d3370f6b411b42fe3a301bbd46d3eae,1,2,1,3,1,2014-02-10 18:21:33,2014-02-06 15:10:36
32752e966d3370f6b411b42fe3a301bbd46d3eae...087e347f2672b9a950d6da56179ca44eb7ded834,1,6,0,6,1,2014-02-10 18:21:33,2014-02-06 15:10:37
087e347f2672b9a950d6da56179ca44eb7ded834...c9cd60f6fa064595e4c1a8a84b9a15cc016a09e1,1,12,0,12,1,2014-02-10 18:21:33,2014-02-06 15:10:38
c9cd60f6fa064595e4c1a8a84b9a15cc016a09e1...ff62eca7d1f9716e36550adedc6e8edc35ff9a15,2,32,1,33,2,2014-02-10 18:21:33,2014-02-06 15:10:39
ff62eca7d1f9716e36550adedc6e8edc35ff9a15...0232852b06cb000a3b1f5f48676c8b4d084f18ea,2,82,57,139,2,2014-02-13 18:10:00,2014-02-13 13:21:14
2171c0c36fb1edbacf17c14490cbe935269dcd04...c7b8cf49850c59d5583d81a30dd7d1f1d18748bf,1,11,7,18,6,2014-02-05 22:14:00,2014-01-31 23:14:05
7146e66f0861c720f9b32dc9d80ab80495a33e43...1df4320fa25d3784b035936b35725460d46f1ca0,2,46,19,65,8,2014-02-24 22:44:57,2014-01-20 16:20:38
1df4320fa25d3784b035936b35725460d46f1ca0...91921ceff60ccf7a9e80749eb28fabfb8399d371,1,21,0,21,1,2014-02-24 22:44:57,2014-01-20 16:20:39
91921ceff60ccf7a9e80749eb28fabfb8399d371...8518ff8fabc43aa96f1d8c8cd3de7f399d51d11e,1,73,21,94,9,2014-02-24 22:44:57,2014-01-20 16:20:40
8518ff8fabc43aa96f1d8c8cd3de7f399d51d11e...af82c7880f1a3df1655092da11c80603260384a0,3,9,24,33,10,2014-02-24 22:44:57,2014-01-20 16:20:41
af82c7880f1a3df1655092da11c80603260384a0...7b1004b0ba6637e8c299ee8f927de5426139495c,1,12,22,34,10,2014-02-24 22:44:57,2014-01-28 21:55:59
7b1004b0ba6637e8c299ee8f927de5426139495c...fce135c4ffc87f85e1c3b5c57a6d9e1abdbd074d,1,106,0,106,1,2014-02-24 22:44:57,2014-02-03 09:08:49
d57b24b60b30ba6aa3fb3448fb784841b97265ef...8620ed578bec1ec6f56b209e096ea4b4ee572397,1,61,62,123,52,2014-02-03 00:49:47,2014-02-03 00:49:47
d57b24b60b30ba6aa3fb3448fb784841b97265ef...b6c0df8948a2acc1f87d1c30f9ba2cc208bdc346,1,18,13,31,12,2014-02-02 16:22:21,2014-02-02 16:22:21
d57b24b60b30ba6aa3fb3448fb784841b97265ef...893fcc3e4df7e0de0cbc2c4d039ec26feb283196,1,35,23,58,18,2014-02-02 13:38:05,2014-02-02 13:36:32
eeff891ac756fd97a05476446f15269b714ce4cc...e5e73ff20b5a750b9622438fd877f4e4a4c3519b,2,66,11,77,6,2014-12-05 19:11:35,2014-12-05 01:28:54
e5e73ff20b5a750b9622438fd877f4e4a4c3519b...69216bf72be2be4f8aa932324b3145d3f395cdc6,1,1,1,2,1,2014-12-05 19:11:52,2014-12-05 01:32:44
eeff891ac756fd97a05476446f15269b714ce4cc...608758d5cecaca1628af6225effee44ae476e5e1,1,1,0,1,1,2014-12-04 22:18:30,2014-11-18 23:16:55
eeff891ac756fd97a05476446f15269b714ce4cc...54cc5d29a0590c47c6f32d15c867c0199fdd672a,1,2,1,3,1,2014-11-24 17:43:29,2014-11-24 17:43:29
54cc5d29a0590c47c6f32d15c867c0199fdd672a...53de742470bdf160a8412d7a2e9c30545db63fac,1,2,1,3,1,2014-11-24 17:47:07,2014-11-24 17:47:07
eeff891ac756fd97a05476446f15269b714ce4cc...eedc4be54f41c49000b628a48c4926451986f121,1,1,1,2,1,2014-11-18 19:19:16,2014-11-18 17:57:46
eeff891ac756fd97a05476446f15269b714ce4cc...a16cc8b24710b7426468ac0dc3194170e6113385,1,2,0,2,1,2014-11-17 21:34:07,2014-11-17 20:12:41
eeff891ac756fd97a05476446f15269b714ce4cc...bcd46becbc115f8a1a9bfe3f83efa462547aa231,1,1,1,2,1,2014-11-17 17:26:24,2014-11-17 00:38:26
eeff891ac756fd97a05476446f15269b714ce4cc...c5326bd62b7e168ba1339dacb7ee812d0fe98c7c,2,35,0,35,3,2014-11-13 22:35:41,2014-11-13 18:30:34
eeff891ac756fd97a05476446f15269b714ce4cc...faa8fac1ec03a5ac2b69ee686651a92d65d542c0,1,1,1,2,1,2014-11-13 18:39:24,2014-11-12 23:18:39
eeff891ac756fd97a05476446f15269b714ce4cc...251e7dad517bd369387c4dedfe77b380f025e0f3,1,4,0,4,1,2014-11-04 21:18:35,2014-11-04 20:01:12
eeff891ac756fd97a05476446f15269b714ce4cc...79a77109d3d0d364910ff7fa8c605c554dc4c3e0,4,123,9,132,10,2014-10-28 17:33:50,2014-10-27 18:23:05
eeff891ac756fd97a05476446f15269b714ce4cc...e7f224f7800b17304ebc37079c883f04f99a8eef,1,1,0,1,1,2014-10-27 19:09:36,2014-10-24 15:23:32
eeff891ac756fd97a05476446f15269b714ce4cc...08e3ce5a20d738746b2a7700be6d3954bf01a2b9,1,2,2,4,2,2014-10-24 18:28:30,2014-10-24 18:27:22
08e3ce5a20d738746b2a7700be6d3954bf01a2b9...75c961b767ec061696634c1079dbe5f1a9e10f93,3,26,28,54,6,2014-10-24 18:34:59,2014-10-24 18:34:59
75c961b767ec061696634c1079dbe5f1a9e10f93...073bd75e177aa9f1fc42b152a38e251c7156dfe0,1,33,26,59,2,2014-10-28 19:44:09,2014-10-28 19:44:09
073bd75e177aa9f1fc42b152a38e251c7156dfe0...261f315bebfa9af2d09f20211960100ff06f87cb,3,69,29,98,13,2014-10-28 21:04:28,2014-10-28 20:04:38
eeff891ac756fd97a05476446f15269b714ce4cc...6936b5859c47b826437218fbfc0e2bc0935f7136,3,11,3,14,4,2014-10-23 23:17:09,2014-10-23 17:02:02
eeff891ac756fd97a05476446f15269b714ce4cc...fca416a41e90be0102b48949522ff0d2dc258c53,1,7,11,18,2,2014-10-09 22:06:08,2014-10-09 20:45:21
13b081257a6c996e6c62316be1d1a6f615514ed2...db7879438f0a3d7607555cf166b42ed1083272b6,1,0,1,1,1,2014-10-07 17:49:57,2014-10-04 08:41:13
b16665e832642602b28b9abf5da3a2c53b97d6ca...7b69fcb181941fafda99a5ffd25cea1f685d7e70,1,1,1,2,1,2014-08-04 21:05:06,2014-08-04 21:05:06
d31f3ad23dd1aee3c3e1015a43b02b995c01a9a1...38d905bf585999367a24fa27645ece6fe996d6f0,4,110,0,110,4,2014-10-01 20:32:10,2014-10-01 15:00:33
38d905bf585999367a24fa27645ece6fe996d6f0...0eb0fb889e2e7e063e7dd8cbee38af106aa195f6,2,20,2,22,2,2014-10-01 20:32:19,2014-10-01 15:02:37
d31f3ad23dd1aee3c3e1015a43b02b995c01a9a1...f51a48ec3aacaa01357c891c79dfc45aae0efeff,1,19,12,31,4,2014-09-29 16:30:04,2014-09-18 19:03:25
d31f3ad23dd1aee3c3e1015a43b02b995c01a9a1...ed22b4173bd8d6dbce6236480bd30a63dd54834e,2,108,3,111,11,2014-09-22 19:04:29,2014-09-21 03:55:06
d31f3ad23dd1aee3c3e1015a43b02b995c01a9a1...2e770fe47ef9c0b20bc687e37f3eb50f1bf919d0,3,29,8,37,9,2014-09-10 16:40:53,2014-08-29 20:31:46
2e770fe47ef9c0b20bc687e37f3eb50f1bf919d0...30d1038d1bd538bf2f8abfb5f5dccf80327a26c9,2,58,1,59,3,2014-09-12 17:45:49,2014-09-12 03:38:30
d31f3ad23dd1aee3c3e1015a43b02b995c01a9a1...5d146f7a0f43c9e5e3f5b5508e482c6390cc25d2,1,1,1,2,1,2014-08-28 22:13:55,2014-08-27 20:46:56
d31f3ad23dd1aee3c3e1015a43b02b995c01a9a1...662174d299a2221016a8756d35d485b576ebcec2,3,17,14,31,5,2014-08-26 17:33:01,2014-08-26 10:23:36
662174d299a2221016a8756d35d485b576ebcec2...2608c24940c80bf379937e4cefee75e2db79e008,3,10,5,15,7,2014-08-26 17:34:26,2014-08-26 10:23:54
2608c24940c80bf379937e4cefee75e2db79e008...2e3dfb216991974b60fdb1933eb3331e03383e61,2,2,2,4,2,2014-08-27 14:44:27,2014-08-26 10:24:20
d31f3ad23dd1aee3c3e1015a43b02b995c01a9a1...e8d1dfe639f71dc957c30c1eaa82a3ef0010cd8e,1,2,1,3,2,2014-08-25 17:27:52,2014-08-21 18:30:29
e8d1dfe639f71dc957c30c1eaa82a3ef0010cd8e...3bc7a05b1a78b850da94ca85267ca279489ce70f,1,4,2,6,3,2014-08-25 17:28:14,2014-08-21 18:30:24
d31f3ad23dd1aee3c3e1015a43b02b995c01a9a1...6c71f8b0d3d39beffe050f92f33a25dc30dffca3,1,3,1,4,1,2014-08-22 18:19:47,2014-08-22 15:19:11
d31f3ad23dd1aee3c3e1015a43b02b995c01a9a1...ccad42d4836e2bb4d1843eccd94f58f0189abb1d,2,51,0,51,2,2014-08-10 18:16:20,2014-08-09 17:43:29
d31f3ad23dd1aee3c3e1015a43b02b995c01a9a1...288c67caf64af111aeb7c45cb8b6ba586a61c724,2,43,1,44,2,2014-08-07 21:37:28,2014-08-06 18:35:25
d31f3ad23dd1aee3c3e1015a43b02b995c01a9a1...94204bf505c290ffbe86e55f8aaee23be66164e0,1,1,0,1,1,2014-08-07 19:29:09,2014-08-07 17:13:37
d31f3ad23dd1aee3c3e1015a43b02b995c01a9a1...d487b0ba50884fb1fd1767ac8c9adc58066ad999,2,36,22,58,5,2014-08-07 19:17:07,2014-08-06 21:26:24
d487b0ba50884fb1fd1767ac8c9adc58066ad999...3ee2ad14c6a6823d16eeda2aa48496d4b6e16f70,1,43,38,81,2,2014-08-07 19:23:50,2014-08-06 20:11:17
3ee2ad14c6a6823d16eeda2aa48496d4b6e16f70...477a08af04c227064860ce99197c501037f7f39c,2,17,3,20,2,2014-08-07 19:23:55,2014-08-06 20:09:05
d31f3ad23dd1aee3c3e1015a43b02b995c01a9a1...a26bc613a64ac2c7ee69a50675e61b004a26382d,1,3,1,4,1,2014-08-04 19:12:25,2014-08-04 14:41:15
996b0fdbb4ff63bfd880b3901f054139c95611cf...3c8687a73eeffc21f5a0b3916d38e46ff985933d,4,457,0,457,9,2014-07-29 21:29:56,2014-07-28 10:10:38
3c8687a73eeffc21f5a0b3916d38e46ff985933d...4c715ebb96acc77008e9cbebc381738611c6006f,4,344,0,344,4,2014-07-29 21:33:36,2014-07-28 10:10:39
740c281d21ef5b27f6f1b942a4f2fc20f51e8c7e...8c3f3f28cb8c946867365292abfc2c33a5707d3e,1,29,18,47,8,2014-07-28 17:14:33,2014-07-13 06:41:41
8c3f3f28cb8c946867365292abfc2c33a5707d3e...52604d71443315c82d3a5eb008d601daf8bad05b,1,27,11,38,2,2014-07-28 17:14:33,2014-07-13 06:41:51
52604d71443315c82d3a5eb008d601daf8bad05b...fe24d396e1b8d2eedbc07f626af3dcd2b14e6012,8,13,12,25,14,2014-07-28 17:14:33,2014-07-13 06:41:55
fe24d396e1b8d2eedbc07f626af3dcd2b14e6012...fe0444b50b400a2c0b6263e8bd6ba464fea0ed4f,1,0,2,2,1,2014-07-28 17:14:33,2014-07-13 06:42:00
fe0444b50b400a2c0b6263e8bd6ba464fea0ed4f...c4ad00f8ccb59a0ae0735e8e32b203d4bd835616,7,25,43,68,10,2014-07-28 17:14:33,2014-07-13 06:42:03
c4ad00f8ccb59a0ae0735e8e32b203d4bd835616...5de7f500c13c8158696a68d86da1030313ddaf69,2,8,2,10,4,2014-07-28 17:14:33,2014-07-13 06:42:08
5de7f500c13c8158696a68d86da1030313ddaf69...34dfe197a93763ec9c5d25eec499777cbb32b6fd,1,2,0,2,1,2014-07-28 17:14:34,2014-07-13 06:42:12
34dfe197a93763ec9c5d25eec499777cbb32b6fd...b794ebeac9151af4a9136ef28a22a06c2afb17cc,1,1,3,4,1,2014-07-28 17:14:34,2014-07-13 06:42:17
740c281d21ef5b27f6f1b942a4f2fc20f51e8c7e...9830534e40bd15231357965441d4fe02a6a4810e,3,30,4,34,5,2014-07-25 19:23:06,2014-07-25 19:11:34
9830534e40bd15231357965441d4fe02a6a4810e...06b2d87244d74a6b084a08677dfd66d58b94ebfa,1,6,4,10,1,2014-07-25 19:23:08,2014-07-25 19:11:35
06b2d87244d74a6b084a08677dfd66d58b94ebfa...8b27ff7eacc3bafcb12afcd6bbc99cdb8d718a26,1,33,2,35,3,2014-07-25 19:37:45,2014-07-25 19:11:36
f2c9f21369931c2e4254e49d8f3b3fac5ba8a60b...f38aa83f9a20765d4617c46283a13684597512e6,1,13,12,25,2,2014-07-17 18:17:13,2014-07-17 07:09:32
f2c9f21369931c2e4254e49d8f3b3fac5ba8a60b...398dd4bd039680ba98497fbedffa415a43583c16,1,3,0,3,3,2014-07-17 17:48:09,2014-07-10 12:48:26
8061ae8b4618d69a67ff6cfb687d7044964d4b04...225ea22046a1193bd934a8ea308fa4a7788c9796,1,29,18,47,8,2014-07-14 01:59:04,2014-07-13 06:41:41
225ea22046a1193bd934a8ea308fa4a7788c9796...600e2a69df6dfde134aba0ca88cfe1bd2c88ecbb,1,27,11,38,2,2014-07-14 01:59:04,2014-07-13 06:41:51
600e2a69df6dfde134aba0ca88cfe1bd2c88ecbb...d36f51c13b54a872cdaf08a1765a23afab26ae51,8,13,12,25,14,2014-07-14 01:59:05,2014-07-13 06:41:55
d36f51c13b54a872cdaf08a1765a23afab26ae51...5af01caa08700e389d49a81be15c7413abd4aa69,1,0,2,2,1,2014-07-14 01:59:05,2014-07-13 06:42:00
5af01caa08700e389d49a81be15c7413abd4aa69...8ff226a9d5ee065fe52752e6032f63cb6e4beccb,7,25,43,68,10,2014-07-14 01:59:05,2014-07-13 06:42:03
8ff226a9d5ee065fe52752e6032f63cb6e4beccb...94d5a22cf651174f91d40a140593628a04fdacf3,2,8,2,10,4,2014-07-14 01:59:05,2014-07-13 06:42:08
94d5a22cf651174f91d40a140593628a04fdacf3...d66bebcbcfa46d72bb5008e1d211c0ea87200d86,1,2,0,2,1,2014-07-14 01:59:05,2014-07-13 06:42:12
d66bebcbcfa46d72bb5008e1d211c0ea87200d86...fa96082617e07d988103854fb96c5e92b7587e72,1,1,3,4,1,2014-07-14 01:59:05,2014-07-13 06:42:17
2e931843adb7ce59b5d9bc76f72edff7805980a9...ebc5da3208824e25a89672a3b91bd13629b215fe,3,22,2,24,4,2014-07-16 18:19:56,2014-07-16 18:19:56
779c99fd68dcdaff7d996a1985914154a36a272c...da86971c2a88b71ed76d8c2f146ddac6dd86f896,1,22,0,22,5,2014-07-10 18:37:30,2014-07-10 18:37:30
cbf4e024ad021501f2c1824b8ae5f7b887a652f1...8693e1cc2f0778954eb8aef5af9d98ac7b0c7dbb,2,14,1,15,2,2014-07-10 18:15:10,2014-07-10 18:15:10
565301e41670825ceedf75220f2918ae76831240...2ca0b197b89e1dad0166f60622f087296764dc42,1,2,0,2,2,2014-10-07 19:00:48,2014-10-04 23:20:38
565301e41670825ceedf75220f2918ae76831240...e3f1da982e4f14e7146964cb25a5011a3f41e84a,10,69,75,144,42,2014-10-07 18:09:16,2014-10-04 18:54:50
565301e41670825ceedf75220f2918ae76831240...e197c21807dacadc8305250baa0b9228819189d4,4,6,6,12,6,2014-10-01 20:38:38,2014-10-01 10:28:05
e197c21807dacadc8305250baa0b9228819189d4...a5e48669a2bb45e3a2a6daf30635270b90056085,1,167,54,221,5,2014-10-01 20:38:38,2014-10-01 10:28:06
a5e48669a2bb45e3a2a6daf30635270b90056085...419f0c0f681b76d720699977abe03d29e22db554,2,6,2,8,3,2014-10-01 20:38:39,2014-10-01 10:28:07
419f0c0f681b76d720699977abe03d29e22db554...5527d5349b42aeb2ea36edfd2d55016f22fefc08,1,1,1,2,2,2014-10-01 20:38:39,2014-10-01 10:28:08
5527d5349b42aeb2ea36edfd2d55016f22fefc08...9085f8e279146a31ea8bbd102b6c97f5cb22dcdc,1,7,6,13,1,2014-10-01 20:38:40,2014-10-01 10:28:09
9085f8e279146a31ea8bbd102b6c97f5cb22dcdc...26f5d3b65fa1b40be570a67f1aaca0e2f085d568,1,1,2,3,1,2014-10-01 20:38:41,2014-10-01 10:28:10
26f5d3b65fa1b40be570a67f1aaca0e2f085d568...41dd4ffaf99532d8344c90a5b1a060ac1f73b232,1,1,0,1,1,2014-10-01 20:38:41,2014-10-01 10:28:11
41dd4ffaf99532d8344c90a5b1a060ac1f73b232...ebb8e380e98e83f32c1cc04200d3749ab4c0b90a,1,2,2,4,2,2014-10-01 20:38:42,2014-10-01 10:28:12
ebb8e380e98e83f32c1cc04200d3749ab4c0b90a...04e57d4d32541bc5dba553a31f09aa2ee456bdad,1,16,9,25,3,2014-10-01 20:43:50,2014-10-01 10:28:13
04e57d4d32541bc5dba553a31f09aa2ee456bdad...0a06f148373285822baf5f3e83696732a556a2d1,1,42,0,42,1,2014-10-01 20:45:11,2014-10-01 10:28:14
0a06f148373285822baf5f3e83696732a556a2d1...7108ad232fc7a4c889e82b40c52125adc9796ff5,3,14,8,22,8,2014-10-01 20:45:11,2014-10-01 10:28:15
7108ad232fc7a4c889e82b40c52125adc9796ff5...91f1f1918430f1ee6f9923d949e1543c49f63204,1,9,6,15,1,2014-10-01 20:45:11,2014-10-01 10:28:16
91f1f1918430f1ee6f9923d949e1543c49f63204...35ff08be099b36d0be855040a296f985d25dfd0a,1,2,2,4,1,2014-10-01 20:45:12,2014-10-01 10:28:17
35ff08be099b36d0be855040a296f985d25dfd0a...e31e949b9f9b5e6dcff42e2242cf1a6fb3686b91,1,11,12,23,2,2014-10-01 20:45:12,2014-10-01 10:28:18
e31e949b9f9b5e6dcff42e2242cf1a6fb3686b91...a1754bcce98fa57b9374440c2717ec1159ed8ffb,1,2,6,8,1,2014-10-01 20:45:12,2014-10-01 10:28:19
a1754bcce98fa57b9374440c2717ec1159ed8ffb...4f4713df94e2f3d3adbd39b8fce571e2bd69185e,1,5,3,8,3,2014-10-01 20:45:13,2014-10-01 10:28:20
4f4713df94e2f3d3adbd39b8fce571e2bd69185e...8a1c7533e2ee468a505656abab364780b15004fc,2,5,1,6,2,2014-10-01 20:45:13,2014-10-01 10:28:21
8a1c7533e2ee468a505656abab364780b15004fc...8e86c155d2962f5dff83c9d0d88b836bf040c1fa,2,22,13,35,5,2014-10-01 20:45:13,2014-10-01 10:28:22
8e86c155d2962f5dff83c9d0d88b836bf040c1fa...1b1648f46bcb638f558e9cbd2d0e89066c89c44e,1,6,1,7,2,2014-10-01 20:45:14,2014-10-01 10:28:23
1b1648f46bcb638f558e9cbd2d0e89066c89c44e...d75145acf6d17eb9b0f9d7d8856e523038081311,1,14,6,20,5,2014-10-01 20:45:14,2014-10-01 10:28:24
d75145acf6d17eb9b0f9d7d8856e523038081311...32c3ec258e8b12ba29ce591b09a300621dba9b3a,1,1,3,4,2,2014-10-01 20:48:59,2014-10-01 10:28:25
32c3ec258e8b12ba29ce591b09a300621dba9b3a...e831855ecc6783bfe4b681017349c623fc2fe8c8,1,1,0,1,1,2014-10-01 20:48:59,2014-10-01 10:28:26
e831855ecc6783bfe4b681017349c623fc2fe8c8...707103fdfd0c03511fa547d9b80638d8160f1a88,3,28,11,39,13,2014-10-01 20:48:59,2014-10-01 10:28:27
707103fdfd0c03511fa547d9b80638d8160f1a88...2091c5062c6fd928e1ad3e7c059243e597cb8bbf,2,4,4,8,3,2014-10-01 20:49:00,2014-10-01 10:28:28
2091c5062c6fd928e1ad3e7c059243e597cb8bbf...1fef4b5041e0144e476ffcc8c559bf06fa80340c,1,0,1,1,1,2014-10-01 20:49:00,2014-10-01 10:28:29
1fef4b5041e0144e476ffcc8c559bf06fa80340c...daccee387a7f3e4ca332649d5311b032a71892e2,1,7,7,14,7,2014-10-01 20:49:01,2014-10-01 10:28:30
daccee387a7f3e4ca332649d5311b032a71892e2...3e88e8fc085bbfad142d51a07ef918b9b5ca1d72,1,7,5,12,3,2014-10-01 20:49:01,2014-10-01 10:28:31
3e88e8fc085bbfad142d51a07ef918b9b5ca1d72...cf6950d3bfe1447ac04867b1f5654a2fc9c5db96,8,47,52,99,35,2014-10-01 20:50:01,2014-10-01 10:28:32
cf6950d3bfe1447ac04867b1f5654a2fc9c5db96...5025d8450a4c8bf9d22a202433072bee780b9b72,1,12,21,33,9,2014-10-01 20:51:29,2014-10-01 10:28:33
5025d8450a4c8bf9d22a202433072bee780b9b72...6cad805332e3c3a60993f062afd8d896920689ab,1,22,35,57,13,2014-10-01 20:51:29,2014-10-01 10:28:34
6cad805332e3c3a60993f062afd8d896920689ab...0c0d6e8601a1cfb8ebbdadb6a25a9f6fadc91359,1,16,22,38,9,2014-10-01 20:51:30,2014-10-01 10:28:35
0c0d6e8601a1cfb8ebbdadb6a25a9f6fadc91359...751bacedaa507b7b6d10b2c1f48e019a01a8fa6e,4,50,38,88,17,2014-10-01 20:52:06,2014-10-01 10:28:36
751bacedaa507b7b6d10b2c1f48e019a01a8fa6e...47ba4662bfd755829edd24428cf2e4bc492d70a6,4,5,5,10,5,2014-10-01 20:53:28,2014-10-01 10:28:37
47ba4662bfd755829edd24428cf2e4bc492d70a6...316683bd37608e31cc3f5e932c4e5c7dde1b39f0,1,5,5,10,4,2014-10-01 20:53:53,2014-10-01 10:28:38
316683bd37608e31cc3f5e932c4e5c7dde1b39f0...ec38b4e482e96e62762452cab5714e55abdb48c3,4,16,3,19,4,2014-10-01 20:53:54,2014-10-01 10:28:39
ec38b4e482e96e62762452cab5714e55abdb48c3...4d423a3e62c7ab0b04c4bd84995c32daff3b24c3,1,8,1,9,4,2014-10-01 20:53:54,2014-10-01 10:28:40
4d423a3e62c7ab0b04c4bd84995c32daff3b24c3...216aab1e3d8eef088dc9785febce24a110e9f835,2,8,8,16,2,2014-10-01 20:54:31,2014-10-01 10:28:41
216aab1e3d8eef088dc9785febce24a110e9f835...697cc8efd944a32ca472337cd6640004c474b788,35,118,83,201,41,2014-10-01 20:56:14,2014-10-01 10:28:42
07768e03b5a5efc9d768d6afc6246d2ec345cace...50f84e34a1b0bb893327043cb0c491e02ced9ff5,1,29,2,31,5,2014-06-09 18:39:43,2014-06-09 18:39:43
0953113bb5687f42bcdfc3d20dd3a125784ad383...01e57b5d91b0c9f2ac93708c5c2cbcd4731ddd34,4,15,6,21,4,2014-06-23 22:50:29,2014-06-23 07:05:47
01e57b5d91b0c9f2ac93708c5c2cbcd4731ddd34...71c214c840782a67801fc8dbf5fe8a4f4fc62d01,3,4,0,4,4,2014-06-23 22:50:30,2014-06-23 07:05:48
71c214c840782a67801fc8dbf5fe8a4f4fc62d01...d07b00b7f31d0cb6675b4bdba269ce7f087ddd24,6,125,0,125,6,2014-06-23 22:50:31,2014-06-23 07:05:49
d07b00b7f31d0cb6675b4bdba269ce7f087ddd24...0f109c92b07eb13ffc675a7e98e9cfc3fee42994,1,2,2,4,2,2014-06-23 22:50:31,2014-06-23 07:05:50
0f109c92b07eb13ffc675a7e98e9cfc3fee42994...8e92c2cf37038a3b3bb82724f018e4d0ab1180ff,1,19,1,20,7,2014-06-23 22:50:31,2014-06-23 07:05:51
0953113bb5687f42bcdfc3d20dd3a125784ad383...4eaeb3264e1f86b99ba7732d9f69039a5805c435,1,1,1,2,1,2014-06-09 21:47:06,2014-06-06 14:55:44
4eaeb3264e1f86b99ba7732d9f69039a5805c435...cb9d69ad638fe34d214cf9cb2850e38be6e6d639,1,1,1,2,1,2014-06-09 21:47:06,2014-06-06 14:55:45
cb9d69ad638fe34d214cf9cb2850e38be6e6d639...0783df5d2603c97a481be839bdc65088787dde1b,1,2,2,4,2,2014-06-09 21:47:06,2014-06-06 14:55:46
0783df5d2603c97a481be839bdc65088787dde1b...57b74cdaba2aaaee7d29838a7e6f3ed5581b1992,1,2,2,4,2,2014-06-09 21:47:06,2014-06-06 14:55:47
57b74cdaba2aaaee7d29838a7e6f3ed5581b1992...cd4de93f2e34ded30bd6b7a7352b45650ad81a83,1,2,2,4,1,2014-06-09 21:47:06,2014-06-06 14:55:48
cd4de93f2e34ded30bd6b7a7352b45650ad81a83...6f34b79de15f92b53d050598b04444e8421d7b7d,1,1,1,2,1,2014-06-09 21:47:06,2014-06-06 14:55:49
6f34b79de15f92b53d050598b04444e8421d7b7d...c82af12a1bde56fd7c3b984688ef7fe9f4c44b6e,1,1,1,2,1,2014-06-09 21:47:07,2014-06-06 14:55:50
c82af12a1bde56fd7c3b984688ef7fe9f4c44b6e...1cb493739540bd196848a59f9b7765b0622f725c,1,2,2,4,2,2014-06-09 21:47:07,2014-06-06 14:55:51
1cb493739540bd196848a59f9b7765b0622f725c...e425f6ad4d14d49fee09712af0aa6f56037e7dd7,1,1,1,2,1,2014-06-09 21:47:07,2014-06-06 14:55:52
e425f6ad4d14d49fee09712af0aa6f56037e7dd7...ce5dadb6165c58f6a3a121a9373e6d3ae23b35b4,1,1,1,2,1,2014-06-09 22:53:41,2014-06-06 14:55:54
ce5dadb6165c58f6a3a121a9373e6d3ae23b35b4...fbaff7a26225e4e3b9088aae83c9febcd8bb6825,1,3,3,6,3,2014-06-09 22:53:41,2014-06-06 14:55:55
fbaff7a26225e4e3b9088aae83c9febcd8bb6825...66e1fe7db670bdb03cc7271db11c4934a5684592,1,4,4,8,4,2014-06-09 22:53:41,2014-06-06 14:55:56
66e1fe7db670bdb03cc7271db11c4934a5684592...4399345d5e491b6c432f6b3b12aabca5609d19ce,1,1,1,2,1,2014-06-09 22:53:41,2014-06-06 14:55:57
4399345d5e491b6c432f6b3b12aabca5609d19ce...d0b30a3d4d486040a8a72f60e00b51fe1a3c16ba,1,1,1,2,1,2014-06-09 22:53:41,2014-06-06 14:55:58
d0b30a3d4d486040a8a72f60e00b51fe1a3c16ba...7281f366120722c0aa6bac46936a153efcd74662,1,4,4,8,4,2014-06-09 22:53:41,2014-06-06 14:55:59
7281f366120722c0aa6bac46936a153efcd74662...754b574cf937a04bc0052395c2e6066d427e2798,1,1,1,2,1,2014-06-09 22:53:41,2014-06-06 14:56:00
754b574cf937a04bc0052395c2e6066d427e2798...795fcb0e5eafacdb038652f538af922e956cf5fe,1,2,2,4,2,2014-06-09 22:53:41,2014-06-06 14:56:01
795fcb0e5eafacdb038652f538af922e956cf5fe...0cfe6fd252ee0898d832823bdab66d3cc986f3df,1,2,2,4,2,2014-06-09 22:53:42,2014-06-06 14:56:02
0cfe6fd252ee0898d832823bdab66d3cc986f3df...496eeeb19b9c4adf743bf9acdc25d814e9c58a4e,1,20,12,32,12,2014-06-19 20:30:03,2014-06-10 12:28:33
496eeeb19b9c4adf743bf9acdc25d814e9c58a4e...6a0662304d85ffa288c960f688eb9704954ea8ee,1,8,8,16,7,2014-06-19 20:30:03,2014-06-10 15:33:39
89080fcd9aa22ed888bd0e8e11016f4697ded7ad...f07243fe1644552ef88a05cc8bb22c9757639065,1,2,1,3,1,2014-07-31 18:45:09,2014-07-31 08:14:30
f07243fe1644552ef88a05cc8bb22c9757639065...e0d8e3084f47189916e3b1d7bf138a4ab6227798,1,31,50,81,15,2014-08-25 22:21:05,2014-08-01 08:15:52
779792a5f24bb4e8049c4f88ad752e70d4a8a080...5e3b4fce4293d89ea79433527e6d55f4bcd42bbd,1,4,0,4,4,2014-06-06 20:47:54,2014-04-30 09:50:42
5e3b4fce4293d89ea79433527e6d55f4bcd42bbd...ef2ac68def0fd8a10e4df06706e7276ff63a58f2,2,71,5,76,6,2014-06-06 20:48:00,2014-04-30 09:50:43
ef2ac68def0fd8a10e4df06706e7276ff63a58f2...0445e6f0a1223b5d40542627607207a87a416b5b,3,537,8,545,10,2014-06-06 20:48:00,2014-04-30 09:50:44
0445e6f0a1223b5d40542627607207a87a416b5b...7e28c16fdbdf3dc8a4e2a588a008e171982ec069,1,57,51,108,6,2014-06-06 20:48:00,2014-05-20 23:33:46
779792a5f24bb4e8049c4f88ad752e70d4a8a080...cbc60b67201e083a4970c8731c5382a575357e36,2,101,15,116,8,2014-04-25 16:35:20,2014-04-24 12:24:39
779792a5f24bb4e8049c4f88ad752e70d4a8a080...1c4ea83902e2a64472ccf99ced4ea773ad3dd8aa,2,11,1,12,4,2014-04-23 22:22:53,2014-04-23 14:34:28
1c4ea83902e2a64472ccf99ced4ea773ad3dd8aa...9742fb7e53b2f3bd85b5f01e563aee2cad7e77b8,2,25,1,26,2,2014-04-23 22:22:54,2014-04-23 14:34:29
779792a5f24bb4e8049c4f88ad752e70d4a8a080...7bbc458b44873d0027261562327a20ebd6a97733,2,7,4,11,5,2014-04-23 16:42:28,2014-04-22 11:16:22
779792a5f24bb4e8049c4f88ad752e70d4a8a080...a01f7f2ba0e73ffbee0fa1ec9a5a78f276cc173d,2,3,4,7,2,2014-04-22 19:53:59,2014-04-21 00:17:33
779792a5f24bb4e8049c4f88ad752e70d4a8a080...4ecc63d7f982aa65038048bcdaf49e99b428b028,1,11,3,14,3,2014-04-22 19:49:46,2014-04-21 00:17:34
4ecc63d7f982aa65038048bcdaf49e99b428b028...c15bb0cad73e4dad52a6d4869a254baf3a689b6a,1,5,3,8,2,2014-04-24 18:29:05,2014-04-23 17:07:20
937ca166454306e4a6de24d137101ebf62fff8bb...6c94aba5fa77ec8dcc607fd760e69d8f03b38b44,1,1392,1313,2705,1094,2014-04-23 05:00:08,2014-03-13 04:41:34
6c94aba5fa77ec8dcc607fd760e69d8f03b38b44...3957310734284092233864d888e5da33b5ccff70,1,1,1,2,1,2014-04-29 04:11:09,2014-04-12 19:39:10
3957310734284092233864d888e5da33b5ccff70...74c17bb84b839e2547937df8821aed07c94618eb,1,1425,1340,2765,1120,2014-04-29 04:12:25,2014-04-01 18:25:20
74c17bb84b839e2547937df8821aed07c94618eb...94f94fcbf2b1009da358fbe06edffbd206d9fa7a,1,2,2,4,2,2014-04-29 04:12:31,2014-04-25 20:16:43
62bfd831bc21c3dce06b82e30ee44eaa2ae674ad...341e7e8eda3dbeb6867f4f8f45b671201b807de5,4,119,3,122,5,2014-06-25 19:21:11,2014-06-25 19:21:11
2d1a5a5856692d839531b8963188b3bdc13f4efa...7bf272cc042f41d1c16dfdd0d4893e61622e6dde,1,11,17,28,7,2014-04-08 19:11:17,2014-04-08 19:11:17
0bc85abb7aa9b24b093253018801a0fb43d01122...d78f340ed6250dfe8de6e039acc56a013bcf3637,1,4,4,8,4,2014-05-07 21:25:25,2013-08-29 22:03:10
0bc85abb7aa9b24b093253018801a0fb43d01122...ae352c7f37ef2098e03ee86bc7fd75b210b17683,2,59,0,59,2,2014-05-07 20:53:10,2014-05-02 00:21:09
ae352c7f37ef2098e03ee86bc7fd75b210b17683...baa37bff9a845471754d3f47957d58a6ccc30058,2,3,2,5,2,2014-05-08 21:34:00,2014-05-08 17:23:34
0bc85abb7aa9b24b093253018801a0fb43d01122...26ecfe3e2041fe651c9682ebb73911777290ac62,1,1,3,4,1,2014-05-07 17:40:01,2014-05-07 03:00:37
0bc85abb7aa9b24b093253018801a0fb43d01122...87fe5df3653cf20b6bf9854bea42e4016c7d4688,3,7,3,10,3,2014-05-06 22:30:38,2014-05-06 15:14:42
87fe5df3653cf20b6bf9854bea42e4016c7d4688...ff0a80af724e81dbad6a269847523e39c2e7e479,3,3,3,6,3,2014-05-06 22:30:40,2014-05-06 15:17:50
0bc85abb7aa9b24b093253018801a0fb43d01122...daa22c6f8da466bd7a438f1bc27375fd737ffcf3,2,26,0,26,4,2014-05-06 19:23:58,2014-05-06 00:17:14
0bc85abb7aa9b24b093253018801a0fb43d01122...1d39dbecc2e55c2f723e2c2af43072891317dde9,1,8,5,13,1,2014-04-30 18:28:21,2014-04-29 19:21:34
0bc85abb7aa9b24b093253018801a0fb43d01122...750b2e4785e5956122b3c565af65eb1929714fba,1,10,0,10,1,2014-04-29 16:59:44,2014-04-28 16:16:31
0bc85abb7aa9b24b093253018801a0fb43d01122...76e7c8a7ed58250bb74cf55618a81baed1797eca,1,1,1,2,1,2014-04-29 16:55:38,2012-05-16 13:52:49
0bc85abb7aa9b24b093253018801a0fb43d01122...c0459ca4dc47edf5d63850a34a5f67febd966f3d,1,1,1,2,1,2014-04-28 23:03:22,2014-04-21 20:46:22
0bc85abb7aa9b24b093253018801a0fb43d01122...7c147b77d34f072c40b912fafba499727921fa6e,3,14,2,16,5,2014-04-22 19:49:07,2014-04-21 00:24:20
0bc85abb7aa9b24b093253018801a0fb43d01122...27bd38d4e5a44da233a9e7d01c6a518aba355297,1,1,1,2,1,2014-04-22 19:37:02,2014-04-22 00:47:56
0bc85abb7aa9b24b093253018801a0fb43d01122...82fbf269b9994d172719b2d456db5ef8453b323d,1,16,16,32,9,2014-04-21 17:29:50,2014-04-19 19:17:06
0bc85abb7aa9b24b093253018801a0fb43d01122...784f4b6f33afb439a3d95e5751731a88df545889,1,1,1,2,1,2014-04-17 18:01:26,2014-02-11 16:23:02
0bc85abb7aa9b24b093253018801a0fb43d01122...9f50d32b9c20cc94b9882484ca9704af332a5622,3,45,0,45,6,2014-04-17 17:13:29,2014-04-11 08:28:17
9f50d32b9c20cc94b9882484ca9704af332a5622...8cd65967fe0084574fcee278a5f9ff3d14047c4f,1,1,10,11,3,2014-04-17 17:15:27,2014-04-11 08:28:18
0bc85abb7aa9b24b093253018801a0fb43d01122...cb005c1fdf814d3b65b5b43f5f4fa25aa1bcdf46,1,14,2,16,3,2014-04-16 18:51:16,2014-04-16 08:08:18
cb005c1fdf814d3b65b5b43f5f4fa25aa1bcdf46...f24ecf5998a6c913ea6111dc0650c91165149264,1,1,1,2,1,2014-04-23 16:37:38,2014-04-23 16:37:38
0bc85abb7aa9b24b093253018801a0fb43d01122...fe45cfb518f7cb313051986e03c402bc206e55af,2,4,2,6,2,2014-04-09 21:20:47,2014-04-09 18:50:00
fe45cfb518f7cb313051986e03c402bc206e55af...867bf7b490d6a4bd19b6f9ff7d30af654e9df276,1,1,0,1,1,2014-04-09 21:20:48,2014-04-09 18:50:01
867bf7b490d6a4bd19b6f9ff7d30af654e9df276...5ff569908dd6e174c2d81df8e25ecc8af34fc5a8,1,2,2,4,2,2014-04-09 21:20:48,2014-04-09 18:50:02
5ff569908dd6e174c2d81df8e25ecc8af34fc5a8...62210887f783d942ddfa918b3974b42311d3ef9d,2,26,0,26,3,2014-04-09 21:20:48,2014-04-09 18:50:03
62210887f783d942ddfa918b3974b42311d3ef9d...7569accf41d28a3ede684ef96bf6edece5f06ce9,1,1,1,2,1,2014-04-14 20:25:28,2014-04-11 23:24:05
9c94389c3ee02df891100b894c1790a524268d91...a67c821dedf04683d65f2909c193617ca227cc02,1,42,7,49,19,2014-06-18 17:53:45,2014-06-17 19:56:08
3f0c02a1c018ddaced5c97b58f550b2ad17dd0a9...651ab9f553a1fd8bb847bd42922dacb14f8ec77f,1,4,0,4,2,2014-04-17 19:54:15,2014-04-16 18:56:52
651ab9f553a1fd8bb847bd42922dacb14f8ec77f...55a5c8d72b03ad3727b89900069a1d58664fe5e4,1,4,4,8,2,2014-04-17 19:57:13,2014-04-16 18:56:53
3f0c02a1c018ddaced5c97b58f550b2ad17dd0a9...fcaed04df693685dfece4a48cc8780c9a5adde0b,1,1,1,2,2,2014-04-17 18:03:28,2014-04-17 05:37:17
fcaed04df693685dfece4a48cc8780c9a5adde0b...d1d96a82bbe302f552364d1629958b7d7247fd8f,1,0,8,8,2,2014-04-17 18:09:56,2014-04-17 05:37:19
d1d96a82bbe302f552364d1629958b7d7247fd8f...47fbfded53d46ef73c5f5c150d6e6e7602a7f66f,2,4,6,10,2,2014-04-17 18:09:56,2014-04-17 05:37:18
47fbfded53d46ef73c5f5c150d6e6e7602a7f66f...cbcfd4e3ea9db3125619591b942f56d0a8f3ef48,1,10,0,10,1,2014-04-18 17:48:49,2014-04-18 17:48:08
d393d140b5656e608b332c00ea3b14f9a060d604...b09d8552bd04b17c20f89b73e09206719f9e7b84,1,2,2,4,1,2014-03-25 20:42:52,2014-03-25 17:22:22
b09d8552bd04b17c20f89b73e09206719f9e7b84...75ee3d7078fbcc3b87a3ae5e0cf42f46256c5da4,1,15,15,30,11,2014-03-25 20:43:32,2014-03-25 17:22:22
cb9cd515ee2ed8feb806d904461368df011d75a5...81e776d92bb19a4fab12dcc537adfd543468d7d0,1,18,0,18,3,2014-07-09 18:54:17,2014-07-09 18:54:17
bce14aa132e0064d9a9b1c7ad98e71e22c6e0272...8f92c7755ef2e2802e24eeb3a7de1727045950c0,1,0,2,2,2,2014-06-12 19:15:49,2014-06-11 08:47:45
bce14aa132e0064d9a9b1c7ad98e71e22c6e0272...3ffefb54c0515308ceafb6ba071567d9fd379498,9,29,22,51,18,2014-06-12 17:29:41,2014-06-10 21:36:52
3ffefb54c0515308ceafb6ba071567d9fd379498...e6dfcd6767a58816dacec0df39515803b267fbe6,2,3,8,11,5,2014-06-12 17:29:42,2014-06-10 21:38:38
e6dfcd6767a58816dacec0df39515803b267fbe6...c335d74d349d201cb7627aa7233638d2953a4b02,1,7,6,13,2,2014-06-12 17:29:42,2014-06-10 21:38:47
c335d74d349d201cb7627aa7233638d2953a4b02...969eba6341a5af8ac52c67e26462548ed05e23e3,2,10,4,14,5,2014-06-12 17:29:42,2014-06-10 21:39:04
969eba6341a5af8ac52c67e26462548ed05e23e3...10322a0aaf84382d8901f9ab59e59c39f0c035bb,2,2,2,4,2,2014-06-12 17:29:42,2014-06-10 21:39:11
10322a0aaf84382d8901f9ab59e59c39f0c035bb...b000c59b0c80fc187e5e0e48dc9396cd60576c4e,5,23,16,39,11,2014-06-12 17:29:43,2014-06-10 21:39:30
b000c59b0c80fc187e5e0e48dc9396cd60576c4e...d74a4e57d2703e841deed994752b948a768f31ec,1,5,40,45,9,2014-06-12 17:29:43,2014-06-10 21:39:35
d74a4e57d2703e841deed994752b948a768f31ec...0fb370da9ca972f9571530f95c0dacb31368c280,6,30,9,39,7,2014-06-13 19:07:47,2014-06-12 22:05:37
0fb370da9ca972f9571530f95c0dacb31368c280...66c2827ea4deb24ff541e30a5b6239ad5e9f6801,4,14,3,17,5,2014-06-13 19:08:17,2014-06-10 21:40:14
66c2827ea4deb24ff541e30a5b6239ad5e9f6801...152ff1ccebd822fd97f27d2a6c3fa2058f088fd8,2,49,0,49,2,2014-06-13 19:08:17,2014-06-10 21:40:39
152ff1ccebd822fd97f27d2a6c3fa2058f088fd8...a97934d8205772ffd2a528a9e970af7dec725012,3,3,3,6,3,2014-06-13 19:08:17,2014-06-10 21:40:46
a97934d8205772ffd2a528a9e970af7dec725012...ba41c1c93fd9109eae954f75a8cb8e32c3e29530,2,7,27,34,7,2014-06-13 19:08:17,2014-06-10 21:41:02
ba41c1c93fd9109eae954f75a8cb8e32c3e29530...b66103c3baa593a39b8b0751213b9fce60e94de4,6,16,35,51,14,2014-06-13 19:08:17,2014-06-10 21:41:39
b66103c3baa593a39b8b0751213b9fce60e94de4...bc6b8fc1300ef79c4b4c3c2a79bb3c1e2e032963,7,33,9,42,18,2014-06-13 19:08:17,2014-06-10 21:41:51
bc6b8fc1300ef79c4b4c3c2a79bb3c1e2e032963...80cdaba569600154d91819d2e252f6b7dd9cff73,1,12,0,12,1,2014-06-13 19:08:17,2014-06-10 21:42:51
80cdaba569600154d91819d2e252f6b7dd9cff73...c1b3c71f4b4571abb2b2a457122fd100dc9f7eb0,2,13,8,21,7,2014-06-13 19:08:17,2014-06-10 21:43:02
c1b3c71f4b4571abb2b2a457122fd100dc9f7eb0...8597ea3afea067b39ba7d4adae7ec6c1ee0e7c91,16,68,38,106,34,2014-06-13 19:09:38,2014-06-10 21:44:13
8597ea3afea067b39ba7d4adae7ec6c1ee0e7c91...218aa3a6162b80696a82b8745daa38fa826985ae,3,12,19,31,10,2014-06-13 19:10:13,2014-06-13 06:32:11
bce14aa132e0064d9a9b1c7ad98e71e22c6e0272...1d94c403fd52eddd2c4d6c0123f64c56a79bfca7,2,2,1,3,3,2014-06-09 22:10:52,2011-01-07 16:34:33
1d94c403fd52eddd2c4d6c0123f64c56a79bfca7...b0601e6564061aa21699ee0a523e969c228cb1b4,1,1,4,5,1,2014-06-09 22:10:53,2011-01-07 16:38:25
b0601e6564061aa21699ee0a523e969c228cb1b4...fa9abe95bec0e12322baae3511678ccfeb97eebc,1,1,1,2,2,2014-06-09 22:10:53,2011-01-07 16:43:14
fa9abe95bec0e12322baae3511678ccfeb97eebc...a8248f4a8dfc43177bbbcd9b874fc4e0cbf6b322,1,1,2,3,1,2014-06-09 22:10:53,2011-01-07 16:47:41
a8248f4a8dfc43177bbbcd9b874fc4e0cbf6b322...d8890ce72609b3f7a002ed38b4ed832b6a97fc5c,1,54,59,113,16,2014-06-09 22:10:53,2011-01-07 16:57:02
bce14aa132e0064d9a9b1c7ad98e71e22c6e0272...43dee070eb8faa400f24a9fee08e64d2d18224c2,1,1,1,2,1,2014-06-09 21:55:43,2014-06-09 15:04:36
bce14aa132e0064d9a9b1c7ad98e71e22c6e0272...97ea0d1043715f8fa2ee4a833195519c0be4e046,1,5,5,10,4,2014-06-09 21:54:52,2014-06-09 03:32:03
bce14aa132e0064d9a9b1c7ad98e71e22c6e0272...50e19a83585bd1aeae6aa01d31e5f783b7ef8b1b,3,3,3,6,3,2014-06-09 21:38:12,2014-06-06 17:24:48
bce14aa132e0064d9a9b1c7ad98e71e22c6e0272...dce6818d104282bd6172de50165ee75a24465b8d,1,0,5,5,1,2014-06-05 18:56:01,2014-06-05 05:18:18
bce14aa132e0064d9a9b1c7ad98e71e22c6e0272...e61a6c1d8272f9d7bdc861ed28bfac5fb7e33556,2,42,15,57,2,2014-06-02 22:48:48,2014-06-02 22:36:56
bce14aa132e0064d9a9b1c7ad98e71e22c6e0272...fb79947487b628ec82bc0ad46a08629539a59091,1,2,2,4,1,2014-06-02 20:51:22,2014-06-01 11:07:21
8ced8e40ac07c1b13b2edbb459d37b9b2d7275d6...c6076e2b4aaebd4a49b01255fe8c67405704aa72,1,7,2,9,1,2014-05-21 21:27:48,2014-05-21 21:07:51
c6076e2b4aaebd4a49b01255fe8c67405704aa72...7022650f61ff7d7c9297db4a04f4e93ae14e1750,4,86,0,86,8,2014-05-27 19:38:32,2014-05-24 04:08:14
8ced8e40ac07c1b13b2edbb459d37b9b2d7275d6...06ab60c06606613f238f3154cb27cb22d9723967,19,47,47,94,45,2014-05-21 20:57:10,2014-05-21 18:52:26
8ced8e40ac07c1b13b2edbb459d37b9b2d7275d6...4a28f169ad29ba452e0e7bea2583914c10c58322,1,5,9,14,3,2014-05-21 18:50:35,2014-05-21 18:50:35
6308767f0bb58116cb405e1f4f77f5dfc1589920...50b54fd72a8776d628365c7760bc922902d29d11,2,7,4,11,3,2014-05-19 20:37:07,2014-05-17 01:52:22
50b54fd72a8776d628365c7760bc922902d29d11...84c9dc2c5a2d34351a06554af32501d4f99990e9,6,66,0,66,8,2014-05-19 20:37:25,2014-05-17 01:52:23
6308767f0bb58116cb405e1f4f77f5dfc1589920...496a69802bc4035d5dc26c8d97144d8ae30e52c4,1,11,3,14,3,2014-05-19 18:24:46,2014-05-19 15:28:16
496a69802bc4035d5dc26c8d97144d8ae30e52c4...ee3efaf66c7599340a5deb030ee6969b6d7d39aa,4,39,27,66,25,2014-05-21 18:10:06,2014-05-21 13:20:04
ee3efaf66c7599340a5deb030ee6969b6d7d39aa...c82134a9f39427139a26cd67b7c2fd13b2e8c357,1,13,39,52,13,2014-05-21 18:10:10,2014-05-21 13:20:05
c82134a9f39427139a26cd67b7c2fd13b2e8c357...d928d81051fc8475c7845526b255cb8e80b39f12,2,213,2,215,19,2014-05-21 18:11:50,2014-05-21 13:20:06
d928d81051fc8475c7845526b255cb8e80b39f12...7d509878b845a2a895cc880b833a016a06199981,3,13,8,21,10,2014-05-21 18:13:30,2014-05-21 13:20:07
6308767f0bb58116cb405e1f4f77f5dfc1589920...a6e888397ce46f9252ca89af46f3f6aaf18baf9b,1,21,21,42,20,2014-05-17 17:08:59,2014-05-06 21:29:57
6308767f0bb58116cb405e1f4f77f5dfc1589920...c460c0ecdca46be85f6d9c845f9df7ce0e45c3c2,3,18,1,19,7,2014-05-15 16:49:09,2014-05-15 08:33:26
c460c0ecdca46be85f6d9c845f9df7ce0e45c3c2...5eb7f7ead8537420fde3eb344640096fc330bc16,1,13,30,43,5,2014-05-15 16:49:10,2014-05-15 08:33:40
5eb7f7ead8537420fde3eb344640096fc330bc16...1823bea10fceb371c7876e598d2413c85890cafc,1,10,18,28,12,2014-05-15 16:49:10,2014-05-15 08:34:09
1823bea10fceb371c7876e598d2413c85890cafc...e0ab2ac6c553cbba5d0275cfd35beb3351cae034,1,3,6,9,3,2014-05-15 16:49:11,2014-05-15 08:34:18
e0ab2ac6c553cbba5d0275cfd35beb3351cae034...2aeae40a754ed8296df95df263e694ad4eab3a49,1,10,16,26,3,2014-05-15 16:49:11,2014-05-15 08:34:44
2aeae40a754ed8296df95df263e694ad4eab3a49...173fd1a1a44b89a204eb1289e4ff1f9d733e0cf1,1,3,6,9,5,2014-05-15 16:49:11,2014-05-15 08:35:06
173fd1a1a44b89a204eb1289e4ff1f9d733e0cf1...ff857e4ee8680af3988aff3383b1158f396a6fb2,3,0,30,30,3,2014-05-15 16:49:12,2014-05-15 08:41:03
b4f86a4ce85e4e370a67455de6586a02f158a789...0678b649a19586daa5ec45344376187b91dd7328,2,217,0,217,2,2014-05-28 20:35:43,2014-05-09 06:08:41
b4f86a4ce85e4e370a67455de6586a02f158a789...20c4fbf97de63262a1a8fa7757134d625b9d7a26,1,52,41,93,6,2014-05-12 20:42:52,2014-05-09 02:36:50
b4f86a4ce85e4e370a67455de6586a02f158a789...502b0a1ad145a7d77733008946c833ba7d3d100d,2,0,288,288,2,2014-05-09 20:30:17,2014-05-09 20:12:46
b4f86a4ce85e4e370a67455de6586a02f158a789...7d445f518ef3b38a26166d1ee5a4074f15bc7cd1,1,0,22,22,1,2014-05-09 18:17:21,2014-05-09 02:23:50
b4f86a4ce85e4e370a67455de6586a02f158a789...80dad719fb4bd8090b70da0e6f61ac22a6ff8754,1,7,7,14,6,2014-05-07 06:06:37,2014-05-07 06:06:37
b4f86a4ce85e4e370a67455de6586a02f158a789...1c65d3b9d3987e9350859bc5c56a944287707d1f,1,5,5,10,5,2014-05-07 00:05:34,2014-05-03 19:08:50
b4f86a4ce85e4e370a67455de6586a02f158a789...4874f544f1574a55d787339a6455f524768c1b5d,2,2,2,4,2,2014-05-06 22:32:21,2014-05-04 17:13:57
b4f86a4ce85e4e370a67455de6586a02f158a789...3330311c91124ff0f42996b02335d45bf7c75a31,1,0,1,1,1,2014-05-06 19:20:31,2014-05-06 12:41:45
3330311c91124ff0f42996b02335d45bf7c75a31...8e2a5ccad11bc21eb72499133bc884024e299983,1,8,3,11,4,2014-05-06 22:35:31,2014-05-06 12:41:46
8e2a5ccad11bc21eb72499133bc884024e299983...2c45009b734beed92414fd7249faa0b009432a1b,1,3,3,6,2,2014-05-06 22:35:41,2014-05-06 12:41:47
2c45009b734beed92414fd7249faa0b009432a1b...c7abbb986387470512080b162574c99cd7991aa7,1,8,5,13,4,2014-05-06 22:35:52,2014-05-06 12:41:48
c7abbb986387470512080b162574c99cd7991aa7...602efc4f90295369763cc58b47c3c6532a070fe9,1,4,3,7,2,2014-05-06 22:36:17,2014-05-06 12:41:49
602efc4f90295369763cc58b47c3c6532a070fe9...6f1871fe0f7d9bddfbe199cceeb255cf8edbaab3,1,2,1,3,2,2014-05-13 19:33:26,2014-05-13 04:08:58
b4f86a4ce85e4e370a67455de6586a02f158a789...4701026352ada1ebc36532272ca1e12897b1de11,1,16,17,33,9,2014-05-02 21:12:27,2014-05-02 01:06:57
4701026352ada1ebc36532272ca1e12897b1de11...d1053246554d176173893a5283dc0c0fb563ed03,2,9,2,11,2,2014-05-02 21:13:00,2014-05-02 01:07:22
d1053246554d176173893a5283dc0c0fb563ed03...b7242b8c9e4b3c57a07c2a76d0337389605aadcc,4,37,0,37,11,2014-05-02 21:14:21,2014-05-02 01:10:01
b7242b8c9e4b3c57a07c2a76d0337389605aadcc...14ac2864dcd566a025e449ab9db6b5dc57744a32,2,35,4,39,4,2014-05-02 21:15:22,2014-05-02 01:12:42
d952cbb1908b54c6a04f37c8b0924a49cdb5997d...644edd02c192bcdb0419dd40ce95cf41fe8fd446,1,1,1,2,1,2014-06-02 18:05:33,2014-06-02 07:06:56
001b0976afe6f41bff46aa3eaad0285b641a50ea...f66450ae94f28a565226c3e443df5433722c5672,9,2,200,202,11,2013-07-18 17:44:17,2013-06-22 19:42:47
1c03999bef32edabd3db6479279b3ef90cc635ca...4db42b38231b350138dd6b9c67af34e028006380,1,1,1,2,1,2012-11-25 06:35:48,2012-11-23 14:02:22
5805853f228acafe1d45edeef780cd1b00b952aa...2006f0adaee036145b4261b942d944adb18647ed,2,9,10,19,2,2012-09-18 21:22:19,2012-09-17 17:06:19
5805853f228acafe1d45edeef780cd1b00b952aa...ecfe1ea96fde1fa5756ad04f717fd2960ead988a,2,15,0,15,2,2012-09-18 20:27:45,2012-09-18 11:15:26
5805853f228acafe1d45edeef780cd1b00b952aa...8093ae8854a50edf44e47c0390d3021ffd07bc00,1,9,10,19,3,2012-09-18 19:51:58,2012-09-18 15:55:08
3469c7ebbf41fe5fc684583dc84973b95289a6a2...53e4c5dcab33d2718476867b865da9679bd2c24a,2,32,0,32,2,2012-11-24 02:35:15,2012-11-22 22:32:26
f697a27aa6ecb2c8db7679ec5d403cf3b69f6afb...2a4dd9333b667de30b33e032c5a1e8f0738c8548,1,43,0,43,3,2012-07-09 16:49:44,2012-07-09 16:49:37
a0327c0edc7ada60ae2af5ec8daa5dcfcacd095d...84cb00036fb59cf0ff305dcc27551f0519b5098c,2,38,24,62,7,2012-07-06 06:23:28,2012-07-04 13:40:19
84cb00036fb59cf0ff305dcc27551f0519b5098c...8e9497c2e742f25dc25f85d0382833a0b79dfa8f,2,34,16,50,13,2012-07-12 23:31:34,2012-07-12 23:29:00
a0327c0edc7ada60ae2af5ec8daa5dcfcacd095d...c47178d4f0d7331a75f8e0625fd2facd1b5fee4e,1,66,78,144,8,2012-07-06 06:21:58,2012-07-04 13:34:18
c47178d4f0d7331a75f8e0625fd2facd1b5fee4e...798d598080a68deb4958d69adacee409a23b467b,2,13,5,18,2,2012-07-06 06:22:00,2012-07-04 13:34:19
798d598080a68deb4958d69adacee409a23b467b...f19cb0a0e80e094970cfa854dc3da60c927830eb,2,195,6,201,6,2012-07-06 06:22:02,2012-07-04 13:34:20
e3ebc35b1695e9ac6e9b5978cd4e9ffb7b15f657...5adf84ebb375eeee998edef9a2b5aaa05df677d0,1,1,0,1,1,2012-07-24 15:59:07,2012-07-24 11:53:05
5adf84ebb375eeee998edef9a2b5aaa05df677d0...f0c1c15c41bdcdaf71c69355ac83789466820879,2,13,5,18,2,2012-07-24 15:59:07,2012-07-24 11:53:57
f0c1c15c41bdcdaf71c69355ac83789466820879...6283a376c47e7ca3327e563143c1ceda39ae25ac,2,8,1,9,2,2012-07-24 15:59:07,2012-07-24 12:26:51
6283a376c47e7ca3327e563143c1ceda39ae25ac...22ae029a1e0631570a2db5d030e5755f9be96eee,1,26,0,26,3,2012-07-24 15:59:07,2012-07-24 12:27:10
a7271ad1dccaf1a1875992520204debb37ed78bb...2da7830d5c3b0779fed6ac16008a6e380a99dd2e,1,1,6,7,2,2012-07-09 01:44:43,2012-07-08 16:18:28
a7271ad1dccaf1a1875992520204debb37ed78bb...28c24bd7253c3c7a4f3134c5bae4d039b9838e87,1,2,2,4,1,2012-06-27 21:18:01,2012-06-27 09:10:16
28c24bd7253c3c7a4f3134c5bae4d039b9838e87...721a533f8c9b152b4510569b3b486437d179c773,1,2,3,5,3,2012-06-27 21:18:02,2012-06-27 09:10:17
721a533f8c9b152b4510569b3b486437d179c773...b3d985959869d3f2fb1901639326eb64c2e3f726,1,90,8,98,10,2012-06-27 21:18:02,2012-06-27 09:10:18
b3d985959869d3f2fb1901639326eb64c2e3f726...9cb74f3666c86b9d53c661b21d6373eabdbfc796,1,62,44,106,5,2012-06-27 21:18:03,2012-06-27 09:10:19
9cb74f3666c86b9d53c661b21d6373eabdbfc796...6a9e55b0fc5df408c4399b56820aab4db3cadeda,1,249,8,257,14,2012-06-27 21:23:52,2012-06-27 14:21:29
6a9e55b0fc5df408c4399b56820aab4db3cadeda...6df7e0df0912fe88862287bf9871c50dafe722e6,1,61,79,140,29,2012-07-05 06:59:16,2012-07-04 12:53:36
8cc5223495332f0454aff8e382adbb434c065942...d1ca788fcd34962a65924843ef1d0c773d565030,1,27,1,28,3,2012-04-20 22:58:40,2012-04-20 22:58:40
6b179adfe93d13c2f993668cd12eec52860486ac...7f02f3d7ecdda983f229b16f80e7c494fb2d3510,2,6,6,12,5,2012-05-20 21:47:54,2012-05-19 02:41:34
7f02f3d7ecdda983f229b16f80e7c494fb2d3510...b0a4b2d2570974f2050b5d43828dd8146505753e,1,12,0,12,1,2012-05-20 21:48:28,2012-05-19 02:41:35
07e03d466531397f9a78534ccac98b61bbafbdd6...92758dd2a2de94c90c0697ef0e8174c3543a47f9,4,23,3,26,5,2013-05-09 20:31:17,2013-05-09 19:37:53
f4df84de629baf0857634ee103a24c86a607bfe2...3a3101c62ecfbde184934f590bab5d84d7ae64a0,1,1,0,1,1,2013-04-04 20:03:34,2013-04-04 20:03:34
cdd76db373c23bbd637c76a605b3e7f571500103...8b87cfd000c7c98f58279cff698f6e8c7892c059,2,32,37,69,12,2013-03-17 05:10:32,2013-03-16 02:12:36
7c1017d2d56112b88be2b6fa6d2a57a12ee2ffb4...e39c695d871d877a621e39cef7e5bd208bb7b157,1,6,3,9,1,2013-03-26 14:53:13,2013-03-21 23:06:40
17e45f8e41ed127f07b529068113c9f7e44cf6db...7b6e784d70142a23b8ee031b9190e30b9d4d6845,1,12,0,12,2,2013-02-15 20:24:54,2013-02-15 20:24:54
b36ab1abd3f908a996f13c8eebe597d9b43b868b...2f19ada7f8a5bb768816cf7334f65ae0ab03c8a7,1,24,0,24,5,2013-02-06 00:20:16,2013-02-06 00:20:16
cd9c038ac93d65e1f3a9491e873e2d0bc5db73d6...7a0d8db36e1256fd2ac9fa6b97b947e536c2202b,2,38,1,39,2,2013-02-25 16:26:25,2013-02-25 16:15:40
20a599e2c18dd5b491257d7f8aeb2d2f02221595...67dabab05820d97df175c724123b1232ff8d051d,1,2,2,4,1,2013-02-19 17:29:13,2013-02-19 04:17:04
67dabab05820d97df175c724123b1232ff8d051d...5b012c80a165236dde57c386fd62465e9137b2ce,1,11,3,14,4,2013-02-19 17:30:23,2013-02-19 04:17:05
5b012c80a165236dde57c386fd62465e9137b2ce...a24a41ea9a928ccde2db074ab0835c4817223c9d,2,4,2,6,3,2013-02-19 17:30:50,2013-02-19 04:17:06
a24a41ea9a928ccde2db074ab0835c4817223c9d...46fbf7536404257a68fd4ea5d92a3bcb3f7b5848,1,19,10,29,1,2013-02-19 20:36:06,2013-02-19 18:14:13
20a599e2c18dd5b491257d7f8aeb2d2f02221595...235537a07ef569feec628fd1da6730b63eafdc9b,1,125,100,225,101,2013-02-19 05:36:11,2013-02-19 05:36:11
235537a07ef569feec628fd1da6730b63eafdc9b...63af42fe30d961fa91481041c12b7bd9b8bb8295,1,128,106,234,104,2013-02-19 06:52:24,2013-02-19 06:52:24
63af42fe30d961fa91481041c12b7bd9b8bb8295...1415174ad584aa658cafa3e4e1d5780e4fffa0ee,1,765,620,1385,561,2013-02-19 09:23:54,2013-02-18 22:01:07
1415174ad584aa658cafa3e4e1d5780e4fffa0ee...2afd3ef7286124d5ffb5029020633e38d213bfd5,1,130,101,231,101,2013-02-19 09:26:36,2013-02-19 09:26:36
2afd3ef7286124d5ffb5029020633e38d213bfd5...c527acebc2071975dffbccf33f4a1c8adfc6f45f,1,143,112,255,112,2013-02-20 00:17:58,2013-02-20 00:16:44
d3c0f7773feae66f5744cb33d0b074f0ef0c18a7...bcd45b4085f9269a536c8fb1963ac8380bfac0e8,1,41,1,42,8,2013-02-01 20:52:08,2013-02-01 20:52:08
a77133e383d98db5a5bed03e808e922b0e9d0655...53cdd4e1b2017a7580d0c4b7f530f0678985c8dc,2,13,1,14,3,2013-01-28 19:17:54,2013-01-28 19:17:54
d9f85f50ca35d7ed1b35e2990a0082b94f1e1370...d3c1472fe35e2575508d80415565822ee2211df5,2,7,1,8,3,2013-02-27 15:38:32,2013-02-27 10:20:21
2cd14f690818be8a11e997e565ec0a534ee37f1f...44fe83502edf5391bb3a5997cab01794b4568062,1,53,11,64,7,2013-01-09 18:19:49,2013-01-09 18:19:49
c2999adcd5a7577ac445c4a9e6dd69d4b12a3664...d658835c19678419341d8f48d5f4e8962778405c,1,46,0,46,1,2012-12-27 23:38:26,2012-11-30 07:16:30
d658835c19678419341d8f48d5f4e8962778405c...91583a6a8517afd76a78720d8c060d8ad9f03784,1,21,3,24,3,2012-12-27 23:38:26,2012-11-30 07:16:30
91583a6a8517afd76a78720d8c060d8ad9f03784...197a80d7d97e5c84e6b8889397aea1cd1d896be5,1,12,3,15,2,2012-12-27 23:38:26,2012-11-30 07:16:30
197a80d7d97e5c84e6b8889397aea1cd1d896be5...008c208c2c54f7bb97bfb7bc5dc606a4eb0d6837,1,6,0,6,1,2012-12-27 23:38:26,2012-11-23 07:29:38
c2999adcd5a7577ac445c4a9e6dd69d4b12a3664...0b830ac52137f0f0a8f17e4caee5db7f0dee1ecc,2,6,6,12,2,2012-12-27 23:21:46,2012-11-13 15:42:44
c2999adcd5a7577ac445c4a9e6dd69d4b12a3664...8666df02dae889105b2d54aa08795aea1fbfa8c7,1,2,1,3,2,2012-12-25 01:42:07,2012-12-25 01:09:49
1d05d1ded0d9bc3ededcb3a54b0419e1b9d2b2d7...93341d805f35cc699c5fc59f852328c9e752272c,2,16,1,17,2,2012-11-28 21:40:02,2012-11-28 21:40:02
f07e5551a845b45076bf5c45118e16efa69610c4...13274526c1fc62fd0f15fe2bc188843982f38ec9,1,3,4,7,3,2012-12-02 10:04:50,2012-11-30 22:40:50
13274526c1fc62fd0f15fe2bc188843982f38ec9...f42ca31d8d209a43342ea345a52fc0bd43d71cc8,1,9,1,10,2,2012-12-02 10:05:41,2012-11-30 22:41:04
f42ca31d8d209a43342ea345a52fc0bd43d71cc8...913ef36093eac3ec78b5fb155cc2beb5843b1ce5,1,8,1,9,3,2012-12-02 10:06:04,2012-11-30 22:41:26
913ef36093eac3ec78b5fb155cc2beb5843b1ce5...a2767c5c91ebda3c083419c80a7f64248c5ec175,1,2,1,3,1,2012-12-02 10:06:43,2012-11-30 22:41:38
a2767c5c91ebda3c083419c80a7f64248c5ec175...1250857c6c2695020bce6669a4ff43d57a507d91,1,4,1,5,3,2012-12-02 10:07:08,2012-11-30 22:41:50
f07e5551a845b45076bf5c45118e16efa69610c4...bee118ec048911cfacdd65ad1ea2bdd6e25a6254,1,352,0,352,1,2012-11-28 17:39:11,2012-11-11 14:19:52
bee118ec048911cfacdd65ad1ea2bdd6e25a6254...f04977168f520a50b51794c17b443e256a61b4ec,1,295,0,295,16,2012-11-28 17:39:11,2012-11-11 14:19:53
f04977168f520a50b51794c17b443e256a61b4ec...dc2177c21c249460bf9c809ac248ca588bc3b988,1,24,2,26,4,2012-11-28 17:39:11,2012-11-11 14:19:54
dc2177c21c249460bf9c809ac248ca588bc3b988...adec972e5299b66a78cd30d4cdf54c5597a9560b,1,2,0,2,1,2012-12-13 23:55:41,2012-11-11 14:19:55
adec972e5299b66a78cd30d4cdf54c5597a9560b...77b71edfb5f110f32a0071e72c1b6a3277e4222b,1,111,0,111,1,2013-01-03 04:06:59,2012-11-11 14:19:56
77b71edfb5f110f32a0071e72c1b6a3277e4222b...bdeeb809d75b71bc9bdc3ed1b4ebc64e3d965840,2,59,11,70,7,2013-01-03 04:06:59,2012-11-11 14:19:57
bdeeb809d75b71bc9bdc3ed1b4ebc64e3d965840...7edea5c958196f2af13655c8aa2444f80b27bb4c,1,43,17,60,16,2013-01-03 04:06:59,2012-11-11 14:19:58
7edea5c958196f2af13655c8aa2444f80b27bb4c...570e7ecd4a69609641a64eded872c166a37ef9c0,1,9,5,14,5,2013-01-03 04:06:59,2012-11-28 01:01:34
570e7ecd4a69609641a64eded872c166a37ef9c0...073c3ffa582a4d449b7088108a1e302c9169063b,1,28,20,48,6,2013-01-03 04:07:00,2012-11-28 01:01:35
f07e5551a845b45076bf5c45118e16efa69610c4...af507944a22a3dabe2041fe629b2178abb5c642f,1,5,2,7,5,2012-11-21 19:55:59,2012-11-05 23:50:47
f07e5551a845b45076bf5c45118e16efa69610c4...22bc70fdf90edec98012806891f1a132fcd93575,2,6,6,12,2,2012-11-19 03:18:13,2012-11-13 15:42:44
22bc70fdf90edec98012806891f1a132fcd93575...c47ef57caaa2b17d32b343fbe652f33b31c81362,4,65,6,71,9,2012-11-19 03:18:13,2012-11-13 15:42:45
c47ef57caaa2b17d32b343fbe652f33b31c81362...d9c552f17a28e5ab1b72135038d4888ea02651ea,2,21,6,27,6,2012-11-19 03:18:13,2012-11-13 15:42:46
d9c552f17a28e5ab1b72135038d4888ea02651ea...4e215131d2543a28a065c5161438c315316f9961,3,6,6,12,6,2012-11-19 03:18:13,2012-11-13 15:42:47
f07e5551a845b45076bf5c45118e16efa69610c4...6eac50d8274ef0acbbaec4f79e2876405ba8dcee,1,18,24,42,8,2012-11-08 17:06:53,2012-11-05 08:41:22
6eac50d8274ef0acbbaec4f79e2876405ba8dcee...c595016402620ba93e79064f6e3bc9e09981e680,1,5,5,10,5,2012-11-08 17:06:53,2012-11-05 08:41:23
ef90ab66e8eaa863777a8d383c5af2ff43a426d2...bc6158981b547db3d3eb754213467fed97109d57,1,14,9,23,6,2013-04-05 03:33:19,2013-04-04 20:20:29
bc6158981b547db3d3eb754213467fed97109d57...7cdb9b42c359000b1d3d604f847598afd015b7c7,1,10,20,30,7,2013-04-05 03:33:19,2013-04-05 00:08:47
7cdb9b42c359000b1d3d604f847598afd015b7c7...a8f6109428b868611c0a59e6894e2b6b38c34e1b,2,36,4,40,4,2013-04-05 17:30:44,2013-04-05 13:16:30
a8f6109428b868611c0a59e6894e2b6b38c34e1b...ebb722625805a0e98b5b8c062b79abd8eca1f639,1,6,1,7,3,2013-04-05 17:31:09,2013-04-05 03:40:31
ebb722625805a0e98b5b8c062b79abd8eca1f639...88ff684dd54f2a4793387f7162357005a4777ff2,1,7,5,12,2,2013-04-05 17:31:09,2013-04-05 04:03:21
88ff684dd54f2a4793387f7162357005a4777ff2...61690bf4a1ad499a673995b92cd8ab51104a431c,1,49,69,118,11,2013-04-05 17:31:09,2013-04-05 05:28:10
7632cd274464d693c3821205f72a54cda2b7d83b...45d4bdae5906cfe6b7cb1ba1cec82fd80381e07e,1,2,0,2,1,2013-03-27 20:46:47,2013-03-25 20:16:50
45d4bdae5906cfe6b7cb1ba1cec82fd80381e07e...f54fac53786808130c82936e59be16000deba04a,1,4,0,4,1,2013-03-27 20:46:55,2013-03-25 20:17:17
f54fac53786808130c82936e59be16000deba04a...42e7e2a53492ed1772b7b5d8b328f8d0a66f8b33,1,1,1,2,1,2013-03-27 20:46:58,2013-03-25 20:18:16
42e7e2a53492ed1772b7b5d8b328f8d0a66f8b33...692f0bc7ae0cb818bf3c757d509773d6f2e48c68,1,1,1,2,1,2013-03-27 20:47:02,2013-03-25 20:21:14
692f0bc7ae0cb818bf3c757d509773d6f2e48c68...7b6257b0d45f562629ac660cb1845c8a2aac7df1,1,34,0,34,1,2013-03-27 20:47:06,2013-03-25 20:21:34
7b6257b0d45f562629ac660cb1845c8a2aac7df1...d9c31e14d0aafdd45a382d01fcfd66c65a5f4b95,2,34,7,41,4,2013-03-27 20:47:09,2013-03-25 21:49:36
d9c31e14d0aafdd45a382d01fcfd66c65a5f4b95...0e15ad9b730a1516f8a786523266707c4d26f5ab,1,41,0,41,2,2013-03-27 20:47:11,2013-03-25 20:22:29
0e15ad9b730a1516f8a786523266707c4d26f5ab...0aac7bb287645dd72ad8ad6b805128b8ff7f111f,3,4,3,7,3,2013-03-27 20:47:15,2013-03-25 20:23:59
0aac7bb287645dd72ad8ad6b805128b8ff7f111f...0433ad128c59f233046b3f8a68246ca3a8a77af8,3,28,8,36,5,2013-03-27 20:47:18,2013-03-25 20:26:27
0433ad128c59f233046b3f8a68246ca3a8a77af8...d3b34622f699ff14646de4ec1b1ab9afb0bcb056,2,28,1,29,5,2013-03-29 22:20:55,2013-03-26 22:22:09
256b9d70a497534338f0c22101cb6566ab3f1665...5ece083fc7ffd60d38b9abf7797fbf00decd2bcc,3,8,14,22,8,2013-01-24 22:37:17,2013-01-22 04:24:07
5ece083fc7ffd60d38b9abf7797fbf00decd2bcc...0f4d498dbecbc1b6da66f926df3bc12446bd44dd,1,11,16,27,2,2013-01-24 22:37:22,2013-01-23 21:14:48
0f4d498dbecbc1b6da66f926df3bc12446bd44dd...75e5c0dc5529aed42122b3a774e6b17383e51b66,11,93,4,97,18,2013-01-24 22:37:23,2013-01-23 21:55:30
75e5c0dc5529aed42122b3a774e6b17383e51b66...b4cf8db27502f613fcff3fd871c8e31d23f49c7d,1,1,2,3,1,2013-01-25 07:28:50,2013-01-25 05:09:00
5482920919f5ff14b1e4b01cf81eab17c32c2734...506524aea503688a91f5b48fe53f630f26734177,1,3,1,4,1,2013-10-08 20:56:36,2013-10-08 20:02:02
94bc671a1f2e8610de475c2494d2763355a99f65...711536bd4ba791adfd506583927a8f6c8f821e24,1,7,0,7,1,2013-01-15 16:17:23,2013-01-15 13:35:24
711536bd4ba791adfd506583927a8f6c8f821e24...9db9eecfe5c2490d17c0d4bd5452e4cb1d0948c5,1,18,27,45,6,2013-01-16 19:08:55,2013-01-16 06:02:38
2d242fb3fc19fc9ba046accdd9210be8b9913f64...fe52cd621feeab72f6cc7e0e1555cbf36d890c24,1,641,583,1224,550,2012-11-23 06:29:02,2012-11-23 06:29:02
fe52cd621feeab72f6cc7e0e1555cbf36d890c24...131fa518f10521b4a534863331decbfef2875f24,1,799,798,1597,725,2012-11-23 06:31:12,2012-10-31 01:19:59
3e293fba627e254b2c7d196bb7563c6c9d2e6f8a...2f9ae5fc4443afc6fbdeafcc20e1e3e27bbd7a19,1,1,1,2,1,2013-01-05 06:28:41,2013-01-05 00:04:22
2f9ae5fc4443afc6fbdeafcc20e1e3e27bbd7a19...f10b7fcca6f7ae63b8c1b65ea520f226869836e7,1,1,1,2,1,2013-01-05 06:28:41,2013-01-05 00:06:09
f10b7fcca6f7ae63b8c1b65ea520f226869836e7...0a42ac033115c752fd984373e4a70f10aee1a65f,1,5,5,10,5,2013-01-05 06:28:41,2013-01-05 00:08:26
0a42ac033115c752fd984373e4a70f10aee1a65f...93912fdd5e253166287e1ef7ed4b26ea6f8e906d,1,1,1,2,1,2013-01-05 06:28:41,2013-01-05 00:09:15
93912fdd5e253166287e1ef7ed4b26ea6f8e906d...f3258d3d95cc9e0a3fe6255df8b72b444545c0aa,1,6,6,12,6,2013-01-05 06:28:41,2013-01-05 00:10:18
f3258d3d95cc9e0a3fe6255df8b72b444545c0aa...43eb92021058d899a8027128a11326310551c7cf,1,1,0,1,1,2013-01-05 06:28:41,2013-01-05 00:17:10
43eb92021058d899a8027128a11326310551c7cf...ae74f7d2895121b0931c575173e81a35e8893995,1,2,2,4,2,2013-01-05 06:28:41,2013-01-05 00:19:19
ae74f7d2895121b0931c575173e81a35e8893995...a1c54d7b8d07143044a52a7d90f4ea87d52708c7,1,1,0,1,1,2013-01-05 06:28:41,2013-01-05 00:22:26
a1c54d7b8d07143044a52a7d90f4ea87d52708c7...e2a83b21d1aa749766e7823707a85235456a763a,1,1,0,1,1,2013-01-05 06:28:41,2013-01-05 00:24:32
e2a83b21d1aa749766e7823707a85235456a763a...c9704aa7aba9c31a6cb099bb9fa4b7cf8a79d680,1,1,0,1,1,2013-04-03 17:02:40,2013-01-16 02:05:06
c9704aa7aba9c31a6cb099bb9fa4b7cf8a79d680...bd7ac5990ca77b9a294ffb3bd0b6143b17bb35bd,1,1,0,1,1,2013-04-03 17:02:40,2013-01-16 02:05:07
bd7ac5990ca77b9a294ffb3bd0b6143b17bb35bd...ac47a22a7a3c01d38b39c6896a1965ac0b9c473d,1,1,0,1,1,2013-04-03 17:02:40,2013-01-16 02:05:08
3e293fba627e254b2c7d196bb7563c6c9d2e6f8a...e1b6dbb554ece7c32a73c0d8fe63c99bcec70229,2,540,542,1082,3,2013-01-03 22:15:17,2013-01-03 21:05:41
92ab409055f6f8e379a7a0af731dbad7e1d43af0...5f737ac91bd869e65bff401ad1108581ac504e22,1,5,1,6,2,2013-10-18 19:47:33,2013-10-14 23:41:05
b928922727d6691a3bdc28160f93f25712c565f6...15d64936d4be1e11085e21de6615742298276ab6,1,1,1,2,1,2014-03-27 21:58:37,2014-03-27 21:06:20
bad27f4151fc2ba2fe583a5361f568cd1a881cc9...9cd67bd2efe98968531cb15cb0d32abdc79e06c1,1,2,0,2,1,2012-11-29 16:47:51,2012-11-29 08:20:57
a923c314aa55ed5d5fba431d5db34e442a017a09...0bdaa12169bca5d69f2c58f96cc92d51280e9e26,1,15,5,20,1,2013-02-08 18:36:48,2013-02-08 03:48:25
0bdaa12169bca5d69f2c58f96cc92d51280e9e26...d90906a90265fa1df34a7f155fe41b1393679fc4,1,14,16,30,4,2013-02-13 15:42:05,2013-02-13 09:13:17
d90906a90265fa1df34a7f155fe41b1393679fc4...543c5caa6c93bb3d42545aeef334c6a175384db8,5,124,4,128,12,2013-02-15 16:13:13,2013-02-15 12:07:10
543c5caa6c93bb3d42545aeef334c6a175384db8...1a20dd49f8c4e6c62080f267ca77b357cb61be8e,2,14,6,20,7,2013-02-15 17:02:34,2013-02-13 09:13:19
a923c314aa55ed5d5fba431d5db34e442a017a09...4c06b41888ab827b91e7ad7b7067889916847233,1,32,3,35,1,2013-02-08 18:02:31,2013-02-08 17:31:16
4c06b41888ab827b91e7ad7b7067889916847233...1986768f9ce991f5502a9436a8570217b567f14b,3,11,40,51,6,2013-02-08 18:02:32,2013-02-08 17:31:17
35ffe7583108ab236dcf81226690388491d9962f...a60521bc6099ce89d05ef2160d2e3c30a106fda7,1,1,1,2,1,2013-01-22 18:47:47,2013-01-22 16:47:47
ee26a6e2b87905ac605c27841f607cb3379ca678...7cad29d5584c76d6a83e39248a9acb8f07760f8e,1,46,0,46,1,2012-12-05 22:39:55,2012-11-30 07:16:30
7cad29d5584c76d6a83e39248a9acb8f07760f8e...92166fd7b4538029d60ceb1ce2065f85b8186a70,1,21,3,24,3,2012-12-05 22:39:55,2012-11-30 07:16:30
92166fd7b4538029d60ceb1ce2065f85b8186a70...0d35bfe1beb7e6254742b2c1d0fb002abdfab8e9,1,12,3,15,2,2012-12-05 22:39:55,2012-11-30 07:16:30
0d35bfe1beb7e6254742b2c1d0fb002abdfab8e9...dd465ce66f685baee2c93e33ca39acafc139c46c,1,6,0,6,1,2012-12-05 22:39:55,2012-11-23 07:29:38
d1eded46fa5ed350ff52654103623090101b3ba6...6b6e063c44dd830bf9d146a91a7df51c0af94f23,1,2,1,3,1,2012-11-27 17:12:58,2012-11-27 01:37:34
d1eded46fa5ed350ff52654103623090101b3ba6...5963c0367f00df0e5eeb761f1ef77a33c8f54c40,2,32,0,32,2,2012-11-26 21:30:08,2012-11-25 11:08:34
5963c0367f00df0e5eeb761f1ef77a33c8f54c40...37141f27d8e0689fe465d8498656ee6543de3ea5,1,1,22,23,1,2012-11-26 21:30:52,2012-11-25 11:08:35
37141f27d8e0689fe465d8498656ee6543de3ea5...32a8569ecf211cc2ba98333daa10b1a6e783ae87,1,6,1,7,5,2012-11-26 21:32:06,2012-11-25 11:08:36
32a8569ecf211cc2ba98333daa10b1a6e783ae87...3a34e62684b6dc0edf1301eb2259132ffc233c48,1,9,14,23,9,2012-11-26 21:32:13,2012-11-25 11:08:37
3a34e62684b6dc0edf1301eb2259132ffc233c48...6360bee4cd902bdea5db5826821edffd6f367d89,1,7,2,9,2,2012-11-26 21:32:14,2012-11-25 11:08:38
6360bee4cd902bdea5db5826821edffd6f367d89...f035ab620520dbf286d3303194f10a489d7c7f56,1,47,45,92,29,2012-11-29 21:42:11,2012-11-25 11:08:39
f035ab620520dbf286d3303194f10a489d7c7f56...3c64063558d57735384d3c547c0138aca7dfd3b8,1,4,19,23,4,2012-11-29 21:43:04,2012-11-25 11:08:40
3c64063558d57735384d3c547c0138aca7dfd3b8...118a68f9ddbca6ffd87ab6e32b60771143d9d014,1,13,20,33,3,2012-12-02 09:21:58,2012-11-25 11:08:41
3a189da601e676a997cbb06b53da02cac364b2ff...5d3698ffb4ccf8b842814559007e011fc409650b,2,18,0,18,2,2012-11-26 19:05:12,2012-11-24 03:17:01
5d3698ffb4ccf8b842814559007e011fc409650b...3b705268f54af35146d0b0f0562b8598521b8ced,2,2,2,4,2,2012-11-26 19:05:12,2012-11-24 03:17:02
3b705268f54af35146d0b0f0562b8598521b8ced...24a1ea5360faef3c6b742e15a72825877c57eb28,1,2,2,4,2,2012-11-26 19:05:12,2012-11-24 03:17:03
24a1ea5360faef3c6b742e15a72825877c57eb28...d0ac3ffd9da8d1c3e629129030f74e1927faf575,4,9,9,18,9,2012-11-29 20:18:44,2012-11-28 22:11:00
d0ac3ffd9da8d1c3e629129030f74e1927faf575...fc407f9821840041757975045c4a1ca01effa27a,3,204,1,205,3,2012-11-29 20:18:45,2012-11-28 22:11:01
fc407f9821840041757975045c4a1ca01effa27a...984f37681c937be0c7c1135e86141a83920edcc1,2,21,32,53,11,2012-11-29 20:18:45,2012-11-28 22:11:02
984f37681c937be0c7c1135e86141a83920edcc1...0803d35940954ebfd33820bffa7a8ab9951ff143,1,0,13,13,1,2012-11-29 20:18:45,2012-11-28 22:11:03
0803d35940954ebfd33820bffa7a8ab9951ff143...3808b8515bc777f63348c3f4053314742c59ac51,1,29,34,63,23,2012-11-29 20:18:45,2012-11-28 22:11:04
3808b8515bc777f63348c3f4053314742c59ac51...ee10fbf90c74c14ae16a27f4bce8a2dd1704c9cb,2,78,12,90,7,2012-11-29 20:18:45,2012-11-28 22:11:05
ee10fbf90c74c14ae16a27f4bce8a2dd1704c9cb...93b5cf9cd12a0b9491559429969b351daa3638a5,1,13,0,13,2,2012-11-29 20:18:45,2012-11-28 22:11:06
93b5cf9cd12a0b9491559429969b351daa3638a5...1d3f9a30938e12b8ef7b807df7565b40b743d421,1,3,1,4,2,2012-11-29 20:18:45,2012-11-28 22:11:07
1d3f9a30938e12b8ef7b807df7565b40b743d421...2d242de4fd76e31031ee36e7307ab1386e2bce7d,1,1,1,2,1,2012-11-29 20:18:45,2012-11-28 22:11:08
2d242de4fd76e31031ee36e7307ab1386e2bce7d...9ff10fc86989940eb2c016511c293bc0ac50e6f6,1,3,3,6,3,2012-11-29 20:18:45,2012-11-28 22:11:09
9ff10fc86989940eb2c016511c293bc0ac50e6f6...49266e8a11cffa1bb41217021470e33d26109bb2,3,45,4,49,6,2012-12-03 17:52:08,2012-11-28 22:23:59
49266e8a11cffa1bb41217021470e33d26109bb2...f28e7c904ac82b0c5e43805529e7d5296fa4d13b,3,30,15,45,5,2012-12-03 17:57:16,2012-11-28 22:24:00
a859d3ee57acee1ca9fbb37e763814f83d11e7bd...393050c32b58dceef8706d389abe3793fbac51ae,1,5,2,7,1,2012-12-10 21:27:16,2012-12-07 22:31:52
a859d3ee57acee1ca9fbb37e763814f83d11e7bd...ac046c0e8cf0bee52634701d4efa9e9ce2d7718e,1,1,2,3,1,2012-12-09 08:33:04,2012-12-07 17:54:50
ac046c0e8cf0bee52634701d4efa9e9ce2d7718e...5badfdcf8852cf3afe2bde17ec2a11cde8cfc2e9,1,1,1,2,1,2012-12-10 16:18:25,2012-12-10 07:22:34
5badfdcf8852cf3afe2bde17ec2a11cde8cfc2e9...3e53891f85c58b4adb016a429a1f3b7fae78ca03,2,3,2,5,3,2012-12-10 21:05:47,2012-12-10 21:05:47
cf419828064d4f22a2c3134e7b46a7719462b1dc...7b294bf4948931a915cee2d5a692235e9b9c0e27,2,20,7,27,16,2013-04-01 20:05:54,2013-04-01 19:02:00
77cc392d6d60c5d22930174904adae182502b8a9...6d0e699ddb4df9792cec4958f93ce6003d104b2c,1,4031,570,4601,482,2012-12-06 06:31:52,2012-09-16 11:15:34
6d0e699ddb4df9792cec4958f93ce6003d104b2c...df264e4e52c20b808a8e91b7f030da62a29c0265,1,943,853,1796,763,2012-12-06 06:32:39,2012-12-02 15:57:38
77cc392d6d60c5d22930174904adae182502b8a9...bf3e8fe0c718b64b7e88bd3d74564c54f923aaed,1,37,16,53,15,2012-11-30 09:51:14,2012-11-30 09:51:14
239222f587ed06f96d90dd71c66d80a2b1e3dc9f...3f3d0cea61aba6ac2fef16736ef55e04bb735e02,3,179,6,185,7,2013-07-18 00:52:28,2013-07-17 00:05:14
239222f587ed06f96d90dd71c66d80a2b1e3dc9f...ace33bf991f8f6643e58a3642962ed244ba36b5b,1,12,2,14,1,2013-07-17 19:30:58,2013-07-17 17:28:11
239222f587ed06f96d90dd71c66d80a2b1e3dc9f...800531a8668710b5fa02b81360116f508888b58c,1,6,6,12,5,2013-07-12 06:07:55,2013-07-12 06:05:48
800531a8668710b5fa02b81360116f508888b58c...94a55e4e9f15dbcd827ae0e6feeb951c66416366,1,4,4,8,3,2013-07-12 06:07:55,2013-07-12 05:56:24
94a55e4e9f15dbcd827ae0e6feeb951c66416366...d6dcb92a1d462ef3f5739f4fd9b2000ba998f944,1,1,1,2,1,2013-07-12 06:07:55,2013-07-12 06:07:02
d6dcb92a1d462ef3f5739f4fd9b2000ba998f944...f7cd8c50b9ab83e084e8f52653ecc8d90665eef2,2,18,5,23,4,2013-07-12 06:10:22,2013-07-12 06:02:40
239222f587ed06f96d90dd71c66d80a2b1e3dc9f...e828908aa97ce0441b0c00a640b314c041fbd9e2,1,7,0,7,1,2013-06-02 20:47:54,2013-06-01 17:24:41
e828908aa97ce0441b0c00a640b314c041fbd9e2...04422c74c88e2d5d78210bad65e95b223a18fd8e,1,1,1,2,1,2013-06-06 17:22:52,2013-06-06 06:34:41
239222f587ed06f96d90dd71c66d80a2b1e3dc9f...f0c73200e86b6166596f45ce32b7f04291074182,1,13,0,13,1,2013-06-02 19:31:17,2013-06-01 11:02:00
239222f587ed06f96d90dd71c66d80a2b1e3dc9f...798c35fcd8a71a094ca68ac05d81e08c5ac8166d,4,44,2,46,8,2013-05-29 18:31:36,2013-05-29 12:12:42
239222f587ed06f96d90dd71c66d80a2b1e3dc9f...6c642a878688adf46b226903858b53e2d31ac5c3,4,27,0,27,5,2013-05-17 19:16:30,2013-05-10 22:24:57
239222f587ed06f96d90dd71c66d80a2b1e3dc9f...60003340cda05f5ecd79ee8522b21eda038b994b,4,18,2,20,4,2013-05-07 15:32:14,2013-05-04 02:19:33
239222f587ed06f96d90dd71c66d80a2b1e3dc9f...6f4dd60d0713980cf976f569eb83850f9a28fe3c,1,14,1,15,1,2013-05-07 05:31:42,2013-05-07 05:31:10
239222f587ed06f96d90dd71c66d80a2b1e3dc9f...9927ebed1966be260afb3579781d5b4a9ee4a029,2,21,3,24,4,2013-04-07 16:28:29,2013-04-07 15:25:43
9927ebed1966be260afb3579781d5b4a9ee4a029...89c3bbd808b352a9f4047523b81b72f22eefb868,1,8,4,12,2,2013-04-07 16:30:39,2013-04-07 15:25:44
239222f587ed06f96d90dd71c66d80a2b1e3dc9f...790d96c02344eeff41344731d85fb7b22af1d947,1,84,51,135,9,2013-03-25 22:48:18,2013-03-25 18:07:39
790d96c02344eeff41344731d85fb7b22af1d947...84dd81c12622119e7f1d3eaf2047b910352b36bb,1,32,13,45,8,2013-03-27 20:24:43,2013-03-27 20:03:41
84dd81c12622119e7f1d3eaf2047b910352b36bb...abe601bba52ee6b0bf89d282aa1c3ef5fd89cbb0,1,150,81,231,11,2013-03-27 20:25:16,2013-03-27 20:03:42
239222f587ed06f96d90dd71c66d80a2b1e3dc9f...3c695523384855dffba49aec7f0a77e555ced822,1,10,17,27,7,2013-03-19 18:07:25,2013-03-18 23:12:11
3c695523384855dffba49aec7f0a77e555ced822...848575d833ca0d9d47db372348576f3b98bd19b7,1,51,63,114,17,2013-03-19 18:07:26,2013-03-18 23:13:41
848575d833ca0d9d47db372348576f3b98bd19b7...5bd81c73156a623edc9dff42c26469732f49aa89,1,4,11,15,2,2013-03-19 18:07:27,2013-03-18 23:14:26
239222f587ed06f96d90dd71c66d80a2b1e3dc9f...fa04ae0be8cca1291a60bc8a393f9c52d2582089,2,161,7,168,11,2013-03-14 21:43:34,2013-03-14 21:03:14
c75aa630b2f7c9a6cbdaa3333daa1b128b3b8a01...7bf7a92f69f8b0af7169af390e53397698fcfa95,1,16,0,16,1,2013-03-14 15:24:12,2013-03-14 06:44:04
2bba2f0e6542d541e9f27653d8c9d5fc8d0e679c...6005dbb9bf21d10b209f7924e305bd04b9ab56d2,1,3,0,3,2,2013-03-27 20:57:12,2013-03-27 15:13:39
2bba2f0e6542d541e9f27653d8c9d5fc8d0e679c...3747c015704399dea1aa7ae6569a507e5727e20b,1,1,1,2,1,2013-03-27 04:28:04,2013-03-26 21:24:38
b771d8d7cf9dd9d5901e68526be471722870a9f8...19534ee8a7616922082a23db5f9bf0e7dc0e6fd4,1,35,0,35,1,2013-04-03 16:29:14,2013-04-03 16:29:14
1762224ddb599ab14ca26cedafec39dee9b92fe5...a8787c5c1c51f4bdb610526175442a23eea7c467,2,8,0,8,2,2014-11-04 20:47:35,2014-11-04 20:33:37
df83d5cf6759541d6f3d94b29a91fd0d3e5dbcd5...3a4fc21a293c2426899df6a8f4a4cf77b3a0642d,1,2,2,4,1,2013-08-05 17:43:28,2013-08-05 15:21:17
5cae93566027c1d148c9f6625aed484a7096a980...300c0a2209b753da1075770f7b696b1814c010f7,1,11,11,22,3,2013-03-09 06:21:13,2013-03-09 06:21:13
300c0a2209b753da1075770f7b696b1814c010f7...45c45e300bcbe493a39533bb04f6bd548e8a3f19,3,59,6,65,8,2013-03-09 07:26:56,2011-04-19 19:18:20
45c45e300bcbe493a39533bb04f6bd548e8a3f19...d226b14d47311d74e2d55059a54594c3fe474b25,1,38,26,64,13,2013-04-18 00:42:48,2013-04-17 19:32:21
d226b14d47311d74e2d55059a54594c3fe474b25...ccc663bc24a3925b818df0ce97a5ba47e221f383,1,14,7,21,2,2013-04-22 04:04:35,2013-04-22 04:04:35
25396a535b7bed60d8993f5fe9df64839e0e1e96...1252f8b29faf3a1a45a995ae72d1d8c8ee67ad36,2,30,1,31,2,2013-03-25 20:51:13,2013-03-25 20:51:13
bbb80494e0d6e679f3e6b33bfe827b86880cb290...7746f2e319a636cb5be8c1d6ac603585e613562b,1,610,572,1182,514,2013-01-25 07:01:23,2013-01-25 07:01:23
7746f2e319a636cb5be8c1d6ac603585e613562b...eec16a65eee90be80be6aac487bfdffdccd9b0d5,1,601,563,1164,505,2013-01-27 21:38:51,2013-01-27 21:38:51
eec16a65eee90be80be6aac487bfdffdccd9b0d5...07432cef2c14389a591e368a779eae9d46d882bc,2,2123,2136,4259,1920,2013-02-08 16:57:24,2013-01-30 09:23:08
07432cef2c14389a591e368a779eae9d46d882bc...cad5d269090a1d6226fbc9a509666ba2454b0350,1,722,650,1372,559,2013-02-08 19:43:30,2013-01-27 12:43:46
cad5d269090a1d6226fbc9a509666ba2454b0350...d4c655271932cd8999a2d8634bde24602c591fe7,1,9,9,18,9,2013-02-08 19:43:30,2013-01-28 17:24:14
d4c655271932cd8999a2d8634bde24602c591fe7...1bbe7c3c124c435b45f87a71516211f5252086f7,1,8,8,16,8,2013-02-08 19:43:30,2013-01-28 18:24:42
4614043c8fd8972bcde4fbfce7a8d25dd6d206fd...f8b090386bb5af172ea95f16ad6274e02222d2c1,1,13,10,23,2,2012-07-10 23:45:00,2012-07-04 07:12:14
e1980c9d23c22ecfbcadbe91d304ba778b84b457...c971ddfdcd319fb5cad95aa7047c54ebe6a22d1a,1,4,6,10,2,2013-01-16 17:48:36,2013-01-16 01:08:16
1cc8af044cad37b5f7df85b177f6aa979aa3215a...d0408c0c8cd636233f01c0bda9ad71161609297c,1,3,3,6,2,2012-06-22 18:06:08,2012-06-22 12:48:46
0680f745ac3322bd99653c3cbc1cd765ee0db5c0...9197a10c7188a74356384a7ce46e05104ac68240,1,10,7,17,1,2012-05-30 16:51:14,2012-05-30 11:09:08
9197a10c7188a74356384a7ce46e05104ac68240...189260b190be845f0e24ede93f9ac539627d72fa,3,18,6,24,6,2012-05-30 16:51:22,2012-05-30 11:10:16
0680f745ac3322bd99653c3cbc1cd765ee0db5c0...b2478aa0858811c29061ed32c2686468b89d7296,1,2,4,6,2,2012-05-30 16:07:04,2012-05-30 10:18:29
04bf4483eab68301f44b912b3364db6d07542c72...6d0d465e20b8c11924bc4e75563324771d0e0d63,1,1,0,1,1,2010-02-06 17:51:43,2010-02-06 08:37:53
6d0d465e20b8c11924bc4e75563324771d0e0d63...ab35469de0d2d2ba4be58fd0231687ddc9cc3cdc,1,2,9,11,3,2010-02-06 18:33:07,2010-02-06 14:50:03
77b5be2abab69a69618dd40a6ca8b754388b8216...bdcaa325b47fcacfecb781a28801aafc249ba288,1,4,4,8,2,2010-07-21 18:52:26,2010-07-21 00:01:01
bdcaa325b47fcacfecb781a28801aafc249ba288...b1edaf669d483e983f1849ce804baa178387e9a9,3,40,8,48,8,2010-07-21 18:54:34,2010-07-20 21:55:31
b1edaf669d483e983f1849ce804baa178387e9a9...6e6842e36f8c6c12ae0ddd7db98cd900b25bb8dc,2,11,49,60,11,2010-07-21 19:54:48,2010-07-21 19:47:48
6e6842e36f8c6c12ae0ddd7db98cd900b25bb8dc...64fdc08dac6694d1e754580e7acb82dfa4988bb9,3,10,9,19,5,2010-07-21 19:55:50,2010-07-21 19:55:50
77b5be2abab69a69618dd40a6ca8b754388b8216...6b677a28ffded042da18e3aefbb01d28e4a1b11b,9,18,16,34,15,2010-07-20 23:59:17,2010-07-19 21:17:17
b03e7b7d76e79de14e76df5d4e2ee727f4522a95...53cad69105e524deb014fe2ddec1d5804636d182,1,31,16,47,7,2010-09-10 16:37:51,2010-09-10 16:09:39
e605164d1da51087882a468bcf3f5d36d3a9d4ba...199f5498741f3792e49c211f27333a426d2b11aa,2,2,2,4,2,2010-08-03 13:49:20,2010-07-29 05:36:19
199f5498741f3792e49c211f27333a426d2b11aa...755a605d6eef787af0e7310fa968cc62749294a6,1,1,0,1,1,2010-08-03 13:49:22,2010-07-29 05:36:20
e605164d1da51087882a468bcf3f5d36d3a9d4ba...7ea3ddf818dbd59ae8002e98f56e60742746db45,2,2,2,4,2,2010-07-16 20:25:01,2010-07-16 09:37:44
c173dad58787a7f11a526dbcdaa5a2fe9ff1c87f...3c9d0414ed2db0167e6c828b547be8fc9f88fccc,1,2,0,2,1,2010-07-20 16:17:39,2010-07-20 04:46:21
3c9d0414ed2db0167e6c828b547be8fc9f88fccc...971ecbd1f8d1468951274d01103f80dd7d32d110,1,8,0,8,1,2010-07-20 18:26:39,2010-07-20 17:17:12
d52dc4b10b2f78dc24ea05e88ddc25ee0f46491e...754571261a87064434441dc7978153df52a874e7,1,1,0,1,1,2009-11-02 03:01:05,2009-11-01 23:09:05
d52dc4b10b2f78dc24ea05e88ddc25ee0f46491e...1e380ddcd29f1e25bfb58b7068fdafb038c8dd9a,1,4,0,4,2,2009-10-31 21:28:18,2009-10-31 06:36:03
cd0f8e6d63d3e2744d7d3b2329238be7d064a8ea...f2a37151d4624906e34a9bcafb2ad79d0e8cb7ec,1,8,1,9,2,2009-11-18 05:39:58,2009-11-18 01:42:21
f2a37151d4624906e34a9bcafb2ad79d0e8cb7ec...fb0cc87ec0f1e9c13b27ea2c89127991d44ed3d3,4,51,29,80,7,2009-11-18 05:45:44,2009-11-18 01:42:22
fb0cc87ec0f1e9c13b27ea2c89127991d44ed3d3...0a4da29dd806bca41cc615961d034b5a5fc30ff7,1,9,4,13,5,2009-11-18 05:45:44,2009-11-18 01:42:23
0a4da29dd806bca41cc615961d034b5a5fc30ff7...3714831189b32591ffe33c08e209a9a61c25a2f6,4,50,11,61,14,2009-11-18 05:45:44,2009-11-18 01:42:24
3714831189b32591ffe33c08e209a9a61c25a2f6...c578f51d52fe75e71d75566c2c216af989b65e6e,4,14,1,15,5,2009-11-18 05:45:44,2009-11-18 01:42:25
c578f51d52fe75e71d75566c2c216af989b65e6e...87422439d100f020cadb63b5da8495e5fbfb8fa3,1,10,0,10,1,2009-11-18 05:45:44,2009-11-18 01:42:26
87422439d100f020cadb63b5da8495e5fbfb8fa3...e65e91ed4af5ed9c5c810a2cd77b8648a0287e66,2,62,0,62,6,2009-11-18 05:45:44,2009-11-18 01:42:27
e65e91ed4af5ed9c5c810a2cd77b8648a0287e66...72ff894308d4f6eb9f081167377857f7a3268bca,4,80,2,82,13,2009-11-18 05:45:44,2009-11-18 01:42:28
72ff894308d4f6eb9f081167377857f7a3268bca...b962dbdc806510a4572a5574245d825a414231ab,1,4,0,4,3,2009-11-18 05:45:44,2009-11-18 01:42:29
b962dbdc806510a4572a5574245d825a414231ab...f8ec916731ef8d81eefc5db61e3405dade65d821,2,25,1,26,3,2009-11-18 05:45:44,2009-11-18 01:42:30
f8ec916731ef8d81eefc5db61e3405dade65d821...d4e1b47a922576e6af98cd84913471a6d3096ac0,3,17,0,17,9,2009-11-18 05:45:45,2009-11-18 01:42:31
d4e1b47a922576e6af98cd84913471a6d3096ac0...2fe40b63001844f9a884ac9cb49cabd5e183b62f,9,989,0,989,11,2009-11-24 23:50:20,2009-11-18 01:42:32
2fe40b63001844f9a884ac9cb49cabd5e183b62f...53970b92d9dc883669f3a9b79b5e39e73931b331,1,3,2,5,2,2009-12-04 00:00:20,2009-12-03 23:31:44
cd0f8e6d63d3e2744d7d3b2329238be7d064a8ea...eab58f1e8e5ef86b5075ce6dfcd6d3f1b3b888b3,1,1,1,2,1,2009-10-31 02:15:38,2009-10-31 01:24:04
eab58f1e8e5ef86b5075ce6dfcd6d3f1b3b888b3...d33738d7d3ed42a956c74d0125eb2b3abda451b7,4,24,14,38,12,2009-11-13 20:15:28,2009-11-11 23:56:07
d33738d7d3ed42a956c74d0125eb2b3abda451b7...c27b39252ff713db414b8dbbfb263d0468031fab,2,2,2,4,2,2009-11-13 20:16:30,2009-11-11 23:57:36
c27b39252ff713db414b8dbbfb263d0468031fab...44fcb4977cbae67f4698306ccfe982420ceebcbf,4,36,3,39,9,2009-11-13 20:17:00,2009-11-12 00:01:27
44fcb4977cbae67f4698306ccfe982420ceebcbf...6361824589bc2d32989a9a33f985d09a368436a3,4,32,3,35,8,2009-11-13 20:20:47,2009-10-31 01:41:27
6361824589bc2d32989a9a33f985d09a368436a3...b4479f074760a788dd4e353b8c86a7d735afc53e,8,16,29,45,9,2009-11-13 20:20:50,2009-10-31 01:42:34
b4479f074760a788dd4e353b8c86a7d735afc53e...dec543e62dbc47be0c06805330a20f7fa9f699a3,2,6,5,11,2,2009-11-13 20:20:52,2009-10-31 01:43:19
dec543e62dbc47be0c06805330a20f7fa9f699a3...8f4b576ad14943a7b14cb8937eb321b7bfd91ee7,3,47,13,60,10,2009-11-13 20:20:54,2009-10-31 01:44:41
8f4b576ad14943a7b14cb8937eb321b7bfd91ee7...a3d023d0a3783612053f2149e784b43befceccad,2,16,1,17,4,2009-11-13 20:20:56,2009-10-31 01:45:34
cd0f8e6d63d3e2744d7d3b2329238be7d064a8ea...134748353b2a71a34f899c9b1326ccf7ae082412,4,61,3,64,14,2009-10-30 23:02:26,2009-10-29 22:08:31
cd0f8e6d63d3e2744d7d3b2329238be7d064a8ea...0fcabdeb52b79775173d009ccc179db104dfbb66,1,10,0,10,1,2009-10-30 16:37:48,2009-10-19 16:37:05
0fcabdeb52b79775173d009ccc179db104dfbb66...3fe9747b94ca81d29894debdb371cff3b1d89af1,1,4,0,4,4,2009-10-30 16:37:50,2009-10-19 16:40:47
3fe9747b94ca81d29894debdb371cff3b1d89af1...0cc5691a8b05a7eabdeef520c94b1bb3bcac7874,1,0,1,1,1,2009-10-30 21:36:06,2009-10-30 17:20:28
0cc5691a8b05a7eabdeef520c94b1bb3bcac7874...ab3d175f87767c377cd65a06d96c50a316a28e30,2,0,0,0,0,2009-10-30 22:02:50,2009-10-29 15:26:20
ab3d175f87767c377cd65a06d96c50a316a28e30...15c6bf0df4d9f060b5cae7a9a899dc3601c54353,2,4,2,6,2,2009-10-30 22:03:10,2009-10-30 20:10:17
cd0f8e6d63d3e2744d7d3b2329238be7d064a8ea...c8998b4823cbccd6bd49c2034e242ae7d5873eae,5,19,6,25,7,2009-10-28 23:48:20,2009-10-28 21:39:32
cd0f8e6d63d3e2744d7d3b2329238be7d064a8ea...4d23660e79dbbb7e2ae37cb7193166d085a78502,1,12,4,16,4,2009-10-28 23:45:24,2009-10-28 22:10:06
9fee24cac87078ae48b5a74ecafaca751f5edfd6...4cce4ef2d5b2a3be1ddb17e9aa12b3307900b41d,1,3,3,6,3,2011-05-06 04:21:24,2011-05-05 18:56:00
9fee24cac87078ae48b5a74ecafaca751f5edfd6...8fe6177ac640ca36814ad3394d4e86b4ce8e29e3,1,2,3,5,2,2011-05-05 18:28:52,2011-05-05 18:28:52
6304c4068e034c5bb780b755cf518010027a1734...6f9752d2e29ecbd5d9489e57bfcd28fb030cba97,1,16,1,17,3,2010-01-19 02:16:15,2010-01-19 02:16:15
129a5a6deacfe6ffb32291fcd96e0d1567f780b2...150d38c4f3733b38c2c212469afa162a55e0e99d,1,2,1,3,1,2009-12-23 19:58:05,2009-12-23 06:40:18
150d38c4f3733b38c2c212469afa162a55e0e99d...b7f44fdf27c1f5dfee099c504a55b62674e7567b,1,40,0,40,1,2009-12-23 19:58:05,2009-12-23 17:54:11
b7f44fdf27c1f5dfee099c504a55b62674e7567b...902f235378cb2b2f6dd5dd664b9630c95321f0ae,3,6,4,10,3,2009-12-23 20:23:11,2009-12-23 19:58:52
33f0ea42e12d3f54ef8ff53580649885c1503d05...8324b977aef3d2301f170e23f498b50e11302575,1,2,0,2,1,2010-02-16 05:46:01,2010-02-16 04:10:45
8324b977aef3d2301f170e23f498b50e11302575...460ccd0e19774fd5e4f69de5a454068c686ac5a6,2,14,2,16,4,2010-02-16 05:46:27,2010-02-15 16:05:46
460ccd0e19774fd5e4f69de5a454068c686ac5a6...003c6abdb27c367747847a76b0a7890d67c794be,1,1,2,3,1,2010-02-16 17:03:58,2010-02-16 07:03:16
af6fbf9f814b3ee23b4b6d632131095c0278ae44...76bf488e61b8a87191a1779b79820545e64ef275,1,1,1,2,1,2009-12-02 18:01:59,2009-12-02 17:59:35
76bf488e61b8a87191a1779b79820545e64ef275...ce9d823b9141756b5e60aa6c62653adb08e7213b,2,10,11,21,6,2009-12-02 18:02:08,2009-12-02 18:00:58
19c6a4f8369f37c0df1fb57008a891eb6a6dc4bb...288123f01cb1b835edbf6e2e188159c2ff858aca,2,36,9,45,4,2010-01-22 23:34:56,2010-01-22 03:05:19
b401a12a2c49d3f3e81e356782d9ca49aaa97faa...2b26e0e18907132eaac2a8163de0cac552217082,1,1,1,2,1,2010-02-05 21:01:45,2010-02-05 19:58:50
74f3267b0cbb9a1026fab3234c4bfefd971fbf9f...b344bb19358bcf8cf62c28ce205fdfd8acfa6b6b,1,1,1,2,1,2013-01-22 00:26:26,2013-01-21 16:22:06
f3500825257b441134bd99b08bab3b6fd1cb4f51...ddd2369c5c8b98060cf8fccb27684c2be1cd8935,1,1,1,2,1,2013-02-10 22:18:57,2013-02-10 15:10:36
ddd2369c5c8b98060cf8fccb27684c2be1cd8935...de3f2c7b46ee814ea6a7e59c6cf6cad80be6dcca,1,3,3,6,3,2013-02-11 04:39:20,2013-02-10 15:10:37
de3f2c7b46ee814ea6a7e59c6cf6cad80be6dcca...da2c7b3dc512675fae02abdf9449d48850aefb88,1,1,1,2,1,2013-02-11 04:39:25,2013-02-10 15:10:39
da2c7b3dc512675fae02abdf9449d48850aefb88...901fd180c9d19025bafefc34e131125628169bdd,1,6,12,18,1,2013-02-11 04:39:26,2013-02-10 15:10:27
f3500825257b441134bd99b08bab3b6fd1cb4f51...68868ff57348b7ae351890b3599949422d2e6001,3,31,12,43,9,2013-02-09 22:01:28,2013-02-09 21:46:56
68868ff57348b7ae351890b3599949422d2e6001...75f7b5dfc47a9c764207559934b1c550423a243a,1,3,3,6,2,2013-02-09 22:34:18,2013-02-09 21:46:57
75f7b5dfc47a9c764207559934b1c550423a243a...48c916285753907b71a0ef663576f01ee260095c,1,4,1,5,2,2013-02-09 22:41:49,2013-02-09 21:46:58
f51a757fafc1e1ca9565381a13109932acd81dba...63cdcfa40f5791dd233c574f633e56e4058e5f8e,1,12,11,23,6,2013-02-04 23:23:35,2013-02-04 23:21:18
57a011197e9cbf2b7d63302ce9e53db30021d773...fe73786b482f11e7a37a269c95d222a384fc5a39,1,7,0,7,2,2013-01-21 01:28:13,2013-01-21 01:28:13
df1ef917c6d7c8db99ab3fe99ebe35ed96a5d25a...dcb11cca50992339af744e25ca5d0f94b478d3b9,3,17,2,19,4,2013-10-28 17:21:29,2013-10-28 17:21:29
ff46a49afadc92bf16ab1ec2dab6d31487de23cb...250087f2e5da8c066cf260c513478f19fa942c72,1,10,6,16,8,2011-04-12 19:49:11,2011-04-12 15:35:38
250087f2e5da8c066cf260c513478f19fa942c72...b781cfaf426ee2d31c0d1bf838d399513ee31679,1,4,1,5,2,2011-04-12 19:50:32,2011-04-12 15:51:37
ff46a49afadc92bf16ab1ec2dab6d31487de23cb...650ed9db74188654656afcd38b1d7672161cb90b,1,1,1,2,1,2011-04-12 07:12:53,2011-04-10 19:34:03
650ed9db74188654656afcd38b1d7672161cb90b...c7f426d4bc38982fe4e64bf3ed4673ddb03c3374,1,4,4,8,4,2011-04-12 07:12:53,2011-04-10 19:34:04
c7f426d4bc38982fe4e64bf3ed4673ddb03c3374...f68f1801726eb64d139dfb7d7858a470aef595f2,1,3,3,6,2,2011-04-12 07:12:53,2011-04-10 19:34:05
f68f1801726eb64d139dfb7d7858a470aef595f2...d3e1ddfd390da8ed6fd275821802eec64c2f74ac,1,1,1,2,1,2011-04-12 07:12:53,2011-04-10 19:34:06
d3e1ddfd390da8ed6fd275821802eec64c2f74ac...20fc73e3b0bb2b115d88e54514db13ffaf11b025,1,3,3,6,3,2011-04-12 07:12:53,2011-04-10 19:34:07
20fc73e3b0bb2b115d88e54514db13ffaf11b025...f06f08b78c1c8be7039bd94c5f1fb305812fda34,2,27,6,33,6,2011-04-12 07:20:28,2011-04-10 19:34:08
f06f08b78c1c8be7039bd94c5f1fb305812fda34...2c050e017a5e7727a7448620d872d46ba22675e9,2,10,7,17,7,2011-04-12 17:46:29,2011-04-10 19:34:02
2c050e017a5e7727a7448620d872d46ba22675e9...cabdee2c5ed55aa42784b37c1249829fca9d71b8,2,44,57,101,17,2011-04-12 18:23:23,2011-04-12 18:23:23
cabdee2c5ed55aa42784b37c1249829fca9d71b8...33d56fa0768951caec5217a6ed8b04cfbf1bce4e,1,1,1,2,1,2011-04-13 22:52:47,2011-04-12 23:29:19
33d56fa0768951caec5217a6ed8b04cfbf1bce4e...c36f94123bb16d412fc0f7c49d655bfe4259c4b6,2,4,4,8,3,2011-04-13 22:52:47,2011-04-12 22:50:55
c36f94123bb16d412fc0f7c49d655bfe4259c4b6...127df8c6cfd42ea666df9221d208b33b712d9994,2,23,5,28,4,2011-04-13 22:52:47,2011-04-12 22:57:08
127df8c6cfd42ea666df9221d208b33b712d9994...d3bd0425b21b84fbc554b24b4315bfcbc2d7a5bf,2,8,9,17,3,2011-04-13 22:52:47,2011-04-12 23:12:47
d3bd0425b21b84fbc554b24b4315bfcbc2d7a5bf...f2c8c8007c43b75e6a461137364a3ec65108afbc,4,21,19,40,17,2011-04-13 22:52:47,2011-04-12 23:20:32
f2c8c8007c43b75e6a461137364a3ec65108afbc...fff1bb3a349687e262ba4fcf5f333af07be9d149,3,6,6,12,6,2011-04-13 22:52:47,2011-04-12 23:23:01
fff1bb3a349687e262ba4fcf5f333af07be9d149...68b2a0055c9936235fac6559de783f39fb790318,3,13,13,26,11,2011-04-13 22:52:47,2011-04-12 23:27:11
68b2a0055c9936235fac6559de783f39fb790318...b3e1900a740156586b00c62f8fe67aafb1ce346d,6,15,17,32,13,2011-04-13 22:52:47,2011-04-12 23:33:39
b3e1900a740156586b00c62f8fe67aafb1ce346d...476cca692c76a9a771fd59e62a2ce76cf4092e87,2,8,8,16,8,2011-04-13 22:52:47,2011-04-12 23:36:18
476cca692c76a9a771fd59e62a2ce76cf4092e87...69382976aafae713c72d40b80f8900699c35bc76,1,7,7,14,7,2011-04-13 22:52:47,2011-04-12 23:39:14
69382976aafae713c72d40b80f8900699c35bc76...29853c82424d291f93cf8e45ee2815b85f8a4df3,1,5,5,10,5,2011-04-13 22:52:47,2011-04-12 23:48:35
29853c82424d291f93cf8e45ee2815b85f8a4df3...32177ba663134879776441be6da03a3bfab2e968,1,4,3,7,1,2011-04-13 23:17:29,2011-04-13 23:17:29
32177ba663134879776441be6da03a3bfab2e968...f79ce8dbe570f337bd638ee53c12ae9761c73c73,1,31,41,72,28,2011-04-13 23:17:50,2011-04-13 23:17:50
f79ce8dbe570f337bd638ee53c12ae9761c73c73...7a23d2d28a1fcdb9e52101eacaa87af02a148b21,1,28,28,56,28,2011-04-14 20:37:54,2011-04-14 20:37:54
7a23d2d28a1fcdb9e52101eacaa87af02a148b21...cc6658e7b4baad88ea30b0a1c8d4857f6253c2b0,1,102,120,222,78,2011-04-14 21:24:02,2011-04-14 20:56:14
cc6658e7b4baad88ea30b0a1c8d4857f6253c2b0...c9ea118e75b1b8f8cc744e372576b4cf63594e0d,4,10,19,29,7,2011-04-14 21:36:14,2011-04-14 21:36:14
ff46a49afadc92bf16ab1ec2dab6d31487de23cb...f228d1f006241e4085a432799356ebd7b1e86108,1,6,5,11,5,2011-04-11 17:35:25,2011-04-07 18:22:18
f228d1f006241e4085a432799356ebd7b1e86108...2ad9d4cb18bc8debcc9da253425f7a598f40cee2,1,1,1,2,1,2011-04-11 17:35:25,2011-04-07 18:23:40
2ad9d4cb18bc8debcc9da253425f7a598f40cee2...d27da38a19d0c21702a012689f256b83545f2e7f,1,2,2,4,2,2011-04-11 17:35:25,2011-04-07 18:24:57
d27da38a19d0c21702a012689f256b83545f2e7f...c8f1444d9e708e3994c74c180194c43bf1588b65,2,2,3,5,2,2011-04-11 17:35:25,2011-04-07 18:26:23
c8f1444d9e708e3994c74c180194c43bf1588b65...1e0f8c41ac157c54a33f2ee0afb7d96f5156ed0d,4,10,2,12,5,2011-04-11 17:35:25,2011-04-07 18:31:24
1e0f8c41ac157c54a33f2ee0afb7d96f5156ed0d...0bcd9ae85d7e05e78a10a69a2ebe98dcde130937,1,28,17,45,14,2011-04-22 17:03:47,2011-04-21 19:14:42
0bcd9ae85d7e05e78a10a69a2ebe98dcde130937...c51477229ee4c7846d40a447860b5bf94aa1103d,2,3,2,5,3,2011-04-22 17:04:27,2011-04-07 18:49:33
dfea575017ddc2ae7c9e8dcb978f4557f07715d3...435bd2ae8e8658d73b3101cf9a78eb5f7ccb03d5,1,1,1,2,1,2011-09-11 20:50:44,2011-09-11 19:40:18
dfea575017ddc2ae7c9e8dcb978f4557f07715d3...1b22c99c14b30f0add6f108a5883f003a2d81e01,1,16,12,28,6,2010-01-27 08:41:36,2010-01-26 15:54:23
1b22c99c14b30f0add6f108a5883f003a2d81e01...f2fabbf76e458010852ac7ced30594c8ab96b9fd,1,80,15,95,13,2010-01-27 08:47:43,2010-01-26 15:57:15
f2fabbf76e458010852ac7ced30594c8ab96b9fd...ec5e0bb860bf98008d51b8235d19ed3407141295,1,3,3,6,3,2010-01-31 22:08:50,2010-01-31 21:23:53
ec5e0bb860bf98008d51b8235d19ed3407141295...010acc151981ebfb0e369ffdeaef63803c58ef2b,1,1,1,2,2,2010-01-31 22:08:55,2010-01-31 21:37:25
010acc151981ebfb0e369ffdeaef63803c58ef2b...5b8805e75cd54439e2b0208e9512420794bc1ecd,1,1,2,3,2,2010-02-28 18:58:50,2010-02-28 09:11:55
75ed918bda00a0786bab7de3d220765226fe3f1e...7c8ce308d383ce6888f69e39f0d32322600c2cc2,1,40,34,74,3,2012-12-12 19:09:37,2012-12-12 10:59:45
7c8ce308d383ce6888f69e39f0d32322600c2cc2...086109006f695166daf2934417a20681b0c94ab8,5,129,2,131,8,2012-12-12 19:12:35,2012-12-12 11:04:04
086109006f695166daf2934417a20681b0c94ab8...938a60d64fc91fd7d646ed33fad527b724d1e534,1,21,11,32,8,2012-12-12 19:14:09,2012-12-12 11:18:02
938a60d64fc91fd7d646ed33fad527b724d1e534...d5422b0c0ba9948166115f1b178c34ee65fc3057,2,3,2,5,2,2012-12-13 18:19:26,2012-12-13 13:08:12
d5422b0c0ba9948166115f1b178c34ee65fc3057...8c473cecfd8835c2bdf34b323e1b2de620099c04,3,35,3,38,4,2012-12-13 18:22:13,2012-12-13 13:04:47
82dce998c2028b6ee96691921b7037a6e182ec89...712efb1a42c8012e5d49f288bf7307e2da09d646,1,1,1,2,1,2013-01-15 18:02:08,2013-01-15 02:49:26
82dce998c2028b6ee96691921b7037a6e182ec89...f1a7082f2a05b6b187fad9c661e2c872f8b477f5,1,6,6,12,6,2012-12-28 20:07:45,2012-12-27 02:32:20
f1a7082f2a05b6b187fad9c661e2c872f8b477f5...95a68344afcaf229765921c70458ee76add342dc,3,37,6,43,10,2012-12-28 20:07:45,2012-12-27 02:32:21
95a68344afcaf229765921c70458ee76add342dc...840fc334e98e89e28039f85c3eff0caab5f20eb3,2,7,7,14,6,2012-12-28 20:07:45,2012-12-27 02:32:22
840fc334e98e89e28039f85c3eff0caab5f20eb3...9013089c4a841bf17bcc8e2510a86ceecac29ffd,5,6,6,12,5,2012-12-28 20:07:45,2012-12-27 02:32:23
9013089c4a841bf17bcc8e2510a86ceecac29ffd...0795805053ad89a24954684fca2e69fea2bf50b9,3,13,10,23,6,2012-12-28 20:07:46,2012-12-27 02:32:24
0795805053ad89a24954684fca2e69fea2bf50b9...6d24e7a807922a5fbf1aa4d42f66e4f0a0aaa141,3,8,8,16,7,2012-12-28 20:07:46,2012-12-27 02:32:25
6d24e7a807922a5fbf1aa4d42f66e4f0a0aaa141...578cd7c3eae11e552bbc34b29f35e273a455988e,1,28,9,37,7,2012-12-28 20:07:46,2012-12-27 02:32:26
578cd7c3eae11e552bbc34b29f35e273a455988e...f4cd69a67469eff90bee8e31529ca4e03c1afdf2,1,29,9,38,4,2012-12-28 20:07:46,2012-12-27 02:32:27
f4cd69a67469eff90bee8e31529ca4e03c1afdf2...a35341a86ecf354d46cf326ed9e0ffbceb54309d,2,41,9,50,10,2012-12-28 20:07:46,2012-12-27 02:32:28
a35341a86ecf354d46cf326ed9e0ffbceb54309d...f61988125130ac091bfb69bda5d62b0ad8f054c4,3,7,3,10,3,2012-12-28 20:07:47,2012-12-27 02:32:29
82dce998c2028b6ee96691921b7037a6e182ec89...ca5ab7d1e813435bbf4ba0615a2adf0cdc35960e,2,2,2,4,2,2012-10-15 21:58:16,2012-10-15 06:25:50
ca5ab7d1e813435bbf4ba0615a2adf0cdc35960e...1c149ab2ddc4a6d253e76d90067ea0fff2880ded,2,21,5,26,7,2012-10-15 21:58:16,2012-10-15 06:25:51
1c149ab2ddc4a6d253e76d90067ea0fff2880ded...5230f605e1afd4e3824aae069a5f1bead6f1647f,3,539,0,539,3,2012-10-15 21:58:17,2012-10-15 06:25:52
5230f605e1afd4e3824aae069a5f1bead6f1647f...b0e0287626d6257dd45df5502a07efd15a7255bc,2,10,156,166,14,2012-10-15 21:58:17,2012-10-15 06:25:53
b0e0287626d6257dd45df5502a07efd15a7255bc...327f2f3ebb2310653e78244293f6f34b28571142,1,146,146,292,10,2012-10-15 21:58:17,2012-10-15 06:25:54
327f2f3ebb2310653e78244293f6f34b28571142...feabcc173b7a5f55c2b1ec78f230276c63ae4d36,6,210,166,376,8,2012-10-15 21:58:17,2012-10-15 06:25:55
feabcc173b7a5f55c2b1ec78f230276c63ae4d36...f1cf7b798305787d5d1272c13ead207e3e04a183,1,43,43,86,16,2012-10-15 21:58:18,2012-10-15 06:25:56
f1cf7b798305787d5d1272c13ead207e3e04a183...3ae5396cf719000039c5d0d35f9bf934f647b030,2,14,11,25,12,2012-10-15 21:58:18,2012-10-15 06:25:57
3ae5396cf719000039c5d0d35f9bf934f647b030...9b4edc0a49abd4b5c6505c63c8fa40d527df6ae8,3,8,20,28,8,2012-10-15 21:58:18,2012-10-15 06:25:58
9b4edc0a49abd4b5c6505c63c8fa40d527df6ae8...164bf83af6466e03b306b9d63dcf7d36dda2bdae,1,2,0,2,1,2012-10-15 21:58:18,2012-10-15 06:25:59
164bf83af6466e03b306b9d63dcf7d36dda2bdae...40bbee0ab07d0ee4f21b11d597c878245c1b05a6,3,16,8,24,6,2012-10-15 21:58:18,2012-10-15 06:26:00
40bbee0ab07d0ee4f21b11d597c878245c1b05a6...4c251e5cb5c245ee3bb98c7cedbe944df93e45f4,2,19,1,20,3,2012-10-15 21:58:18,2012-10-15 06:26:01
4c251e5cb5c245ee3bb98c7cedbe944df93e45f4...237ec6e40d4fd1a0190c4ffde6d18278abc5853a,4,77,1,78,5,2012-10-15 21:58:19,2012-10-15 06:26:02
237ec6e40d4fd1a0190c4ffde6d18278abc5853a...ef49841ddf98ed1eb40c60153072fa1a91fc2f18,2,13,5,18,4,2012-11-20 20:09:13,2012-11-20 07:02:39
ef49841ddf98ed1eb40c60153072fa1a91fc2f18...d5d80e12bd755197352bdb0e9b2291c896946abd,1,3,3,6,1,2012-12-16 06:26:58,2012-12-15 19:19:18
d5d80e12bd755197352bdb0e9b2291c896946abd...3a078dec3327fb68faa7c800040f89db3e38e6e5,2,3,2,5,3,2013-01-01 23:31:18,2013-01-01 02:44:02
3a078dec3327fb68faa7c800040f89db3e38e6e5...889316d2528e93cb79f3e6fdd92cea4ccaab4a54,1,2,1,3,1,2013-01-01 23:32:36,2013-01-01 02:44:03
889316d2528e93cb79f3e6fdd92cea4ccaab4a54...b6a3d3353f799c8c5afedb2da4df6e7cdc5d00c9,1,9,9,18,8,2013-01-01 23:32:36,2013-01-01 02:44:04
58d4203aa617293d1dc3746a1ea33d84eb766e0f...ec7ff5ba272b565ed093a98dc13dd5cd26aeac92,3,16,15,31,4,2012-02-15 00:16:19,2012-02-12 14:16:20
58d4203aa617293d1dc3746a1ea33d84eb766e0f...01fdc21f6e90f56fc5a49cbba751d9ead19b2f03,7,28,21,49,17,2012-02-13 21:06:53,2012-02-13 20:17:15
b6b3b6a01f357922ccd14f2615accc9bd39fc194...dce37b66fb02aba3a38aebbb668e38118bb7dab4,3,3431,2,3433,3,2012-02-15 03:17:10,2012-02-13 06:37:59
dce37b66fb02aba3a38aebbb668e38118bb7dab4...c04f5ac3047a4a69e1b92d173568e32f63747b82,1,3611,0,3611,1,2012-02-15 03:20:22,2012-02-13 06:41:59
c04f5ac3047a4a69e1b92d173568e32f63747b82...d4a8e00b32b6fa5b2ec21c65ef7a692f74a0e016,1,1,1,2,1,2012-02-27 15:18:45,2012-02-02 08:40:12
d4a8e00b32b6fa5b2ec21c65ef7a692f74a0e016...0ad9e96d2e2f42f4d2ce7cd612bf741913242bc0,1,1,1,2,1,2012-02-27 15:36:53,2012-02-02 08:43:01
b6b3b6a01f357922ccd14f2615accc9bd39fc194...acede2ebc939f312058ab7aa15e9ede71029ee85,1,31,3,34,4,2012-02-13 03:50:39,2012-02-11 06:20:55
acede2ebc939f312058ab7aa15e9ede71029ee85...5b05795c4cdf39348c18e40c12e70bd00a7192e5,1,20,19,39,5,2012-02-13 03:50:39,2012-02-11 06:20:56
5b05795c4cdf39348c18e40c12e70bd00a7192e5...65385ef7d457d740eddae2c4179064b8e13ac777,1,5,5,10,5,2012-02-13 03:50:39,2012-02-11 06:20:57
65385ef7d457d740eddae2c4179064b8e13ac777...c41a802fe9593db67f458bde9f15f51fdf3f4f1a,1,1,6,7,2,2012-02-13 03:50:39,2012-02-11 06:20:58
c41a802fe9593db67f458bde9f15f51fdf3f4f1a...f2576591320f6296d341fa14bd50ba6918ced864,2,7,1,8,3,2012-02-13 03:50:39,2012-02-11 06:20:59
f2576591320f6296d341fa14bd50ba6918ced864...a1287f7540d2a27fcde26b356dc176c5dbb4f4e2,1,0,12,12,3,2012-02-13 03:50:39,2012-02-11 06:21:00
a1287f7540d2a27fcde26b356dc176c5dbb4f4e2...cf6672edb1eb90ef7f79d37eca08c93a662802a8,2,1,30,31,5,2012-02-13 03:50:39,2012-02-11 06:21:01
2fa91bd3919f1654d69b43d8c808d7b277c688f5...222433ee4b57750174875ce6b252d10c009a1fa9,1,21,12,33,5,2012-03-02 19:49:41,2012-03-02 05:08:07
dce4bab6567de7c458b334e029e3dedcab5f2648...42afe62df449021fcb501f9df09f8ecfaa764d25,1,52,36,88,10,2011-10-13 23:05:22,2011-10-13 08:06:20
dce4bab6567de7c458b334e029e3dedcab5f2648...ff74f7f1187cbf1b46e85ed1bde1f194991f919c,2,85,85,170,2,2011-10-12 17:35:38,2011-10-12 17:35:38
ff74f7f1187cbf1b46e85ed1bde1f194991f919c...98ac34b2b1968e16fbf7f6122a53b73c6caaff49,2,9,9,18,5,2011-10-19 20:58:15,2011-10-19 20:45:50
98ac34b2b1968e16fbf7f6122a53b73c6caaff49...55956350024f0706294001cb50d513cf0fa038a1,1,11,7,18,8,2011-10-19 20:58:15,2011-10-19 20:55:49
b1bcfbe34439ff6d1a04d0bddb01eebe4df418a5...27187817e4527696e513afcbec7e0503a89ec93a,1,2,2,4,1,2012-04-19 20:33:40,2012-04-19 20:05:26
b1bcfbe34439ff6d1a04d0bddb01eebe4df418a5...059a500d25162370afef6a7afe8a4e61f40eb2f3,1,1,0,1,1,2012-04-11 20:11:55,2012-04-11 20:08:08
b1bcfbe34439ff6d1a04d0bddb01eebe4df418a5...a6754cda4362d129738d42d2683d07d433379e99,2,31,1,32,3,2012-04-09 22:08:18,2012-04-07 10:20:53
233054d114b0d68cf58d18f4c7ddd7723c08b24f...f24a595f72e52b3519067cfb0f05652aabf1e144,1,1,1,2,1,2012-02-21 20:38:07,2012-02-20 12:17:53
dff9f8835f2f2820c4e7109d242cb06b39f7d065...4f021b34f2d5b775690f63796a2973753660c8a8,2,2,2,4,2,2013-02-25 15:31:28,2013-02-25 05:27:20
dff9f8835f2f2820c4e7109d242cb06b39f7d065...52291497d1ea112137237e6c719e832599eab526,1,3,2,5,1,2013-02-25 06:24:48,2013-02-25 05:29:01
dff9f8835f2f2820c4e7109d242cb06b39f7d065...48dfe969fc703f1f77f8944bbef033e58b815634,3,8,7,15,4,2013-02-25 06:23:32,2013-02-25 05:34:14
dff9f8835f2f2820c4e7109d242cb06b39f7d065...0414acc3651a8e3ad938336b596e3de85e5d5d33,1,5,3,8,1,2013-02-24 08:13:11,2013-02-23 15:27:39
dff9f8835f2f2820c4e7109d242cb06b39f7d065...b04d930bbcd1dc7cbb4524063ec339a8feb3cc12,1,1,1,2,1,2013-02-24 07:49:33,2013-02-23 18:10:41
dff9f8835f2f2820c4e7109d242cb06b39f7d065...300e39f6aa974cebf09b5983b923a2bea23146ee,1,3,3,6,2,2013-02-22 20:47:14,2013-02-22 12:09:23
300e39f6aa974cebf09b5983b923a2bea23146ee...b82a7b5bbc1c86d5f6d4198f694b213360dc2485,1,1,1,2,1,2013-02-22 20:48:41,2013-02-22 12:09:24
b82a7b5bbc1c86d5f6d4198f694b213360dc2485...647d87947f8248df5608f621ece8b1dc875fa859,1,9,1,10,1,2013-02-23 21:18:27,2013-02-23 02:29:31
8d141a1d562abb31f27f599dbf6e10a6c06ed73e...1358bb496fb182d8047a039f09c3859364cea2b4,1,20,15,35,10,2012-07-11 22:36:14,2012-07-11 22:12:03
1358bb496fb182d8047a039f09c3859364cea2b4...bb84e67c82af3a6678f193159f56d2244c5529dc,1,1,1,2,1,2012-07-11 22:36:33,2012-07-11 22:12:21
bb84e67c82af3a6678f193159f56d2244c5529dc...4a2b716e220f0f5369c386d7257b87399d424a3f,1,2,2,4,2,2012-07-16 20:49:29,2012-07-16 20:43:58
4a2b716e220f0f5369c386d7257b87399d424a3f...4220afd7238c94f33bde55cf3fd6c84275eebe9a,1,2,1,3,1,2012-07-16 20:49:58,2012-07-16 20:44:30
4220afd7238c94f33bde55cf3fd6c84275eebe9a...216f25f65fe20a93d4c8264b335718a8888d007e,1,2,2,4,2,2012-07-16 20:50:28,2012-07-16 20:45:10
216f25f65fe20a93d4c8264b335718a8888d007e...3e9cdf7fca90acd6efd380a2ed0d6801f33a46b7,1,34,34,68,9,2012-07-16 20:50:50,2012-07-16 20:45:40
3e9cdf7fca90acd6efd380a2ed0d6801f33a46b7...66fd93ee060a1e7f831316f6c81e57f43c5578ba,1,1,1,2,1,2012-07-16 20:51:10,2012-07-16 20:46:56
66fd93ee060a1e7f831316f6c81e57f43c5578ba...c7c0a2503fef1c8746dd4ce074de51fd6b215aa5,1,2,14,16,2,2012-07-16 20:51:25,2012-07-16 20:47:22
0626fae6afc9c6976aead4237691fb3568dd5c68...6a6d72b199fda7189b772640ca35ceb13708332d,3,28,2,30,4,2012-06-01 20:23:11,2012-06-01 20:05:27
42325fb2e078377a3914bf1d80160f22cb1f78d6...7795e424c6e61e6458b700b70a4b231c6cec297d,1,98,94,192,87,2012-05-08 07:49:57,2012-05-08 07:49:57
57f75f31311d380a3ccfbfe7f483253591cf0c87...ead8eb8c1092ce2d94d70872946829a7a946ae9d,1,27,0,27,4,2012-03-05 06:21:30,2012-03-05 06:21:30
90020e3bcd2108baecc79144319c86ad865c8c5e...fd49e56af68fbdc19a4dc72ca1cf811a239df595,2,11,2,13,3,2012-02-17 16:25:30,2012-02-15 15:36:41
8258858493ad3504630c3bfa7dfde61df811994a...38475f972ce1cadf309982420a09bfc9c610a14a,1,1,1,2,1,2012-05-31 19:42:53,2012-05-31 14:10:44
8258858493ad3504630c3bfa7dfde61df811994a...7904af1c10d2feb2f6d1dcb22454d93168a88c49,1,45,0,45,2,2012-05-04 16:39:14,2012-05-04 05:23:14
7904af1c10d2feb2f6d1dcb22454d93168a88c49...f026c7563a249da9279e664fed16fcd5f55c62db,5,7,2,9,5,2012-05-04 16:39:14,2012-05-04 05:25:18
f026c7563a249da9279e664fed16fcd5f55c62db...a763126b5c0120057908e939a0ff7cc95f899f69,1,12,3,15,7,2012-05-04 16:39:14,2012-05-04 05:26:26
a763126b5c0120057908e939a0ff7cc95f899f69...794151e9b595ddc2700c0801caabfd27be763e12,2,10,1,11,2,2012-05-04 16:39:14,2012-05-04 05:27:25
794151e9b595ddc2700c0801caabfd27be763e12...55ccf85a524f6a2d8cb5582d80a2927ff11dfb64,5,15,17,32,12,2012-05-07 21:18:06,2012-05-07 21:11:32
e521850bfd4aa79632c99293a39dad56bcaa4143...d21c463d558a1450c2560869193f279fc7ddba4a,1,4,4,8,3,2012-03-15 22:23:17,2012-03-15 21:57:02
e521850bfd4aa79632c99293a39dad56bcaa4143...3e7a1df84d1eba94530d5bf62caa215f5d3e78d3,1,12,7,19,6,2012-03-08 22:40:44,2012-03-08 21:08:50
e521850bfd4aa79632c99293a39dad56bcaa4143...6fe53908f954b5683ca08d3745be1d76dd665483,1,23,4,27,7,2012-03-07 22:56:08,2012-03-07 22:21:25
6fe53908f954b5683ca08d3745be1d76dd665483...a604ddef737c79f4df9a943ff316e87b7c8a1de8,1,19,14,33,2,2012-03-27 22:39:31,2012-03-27 22:10:01
a604ddef737c79f4df9a943ff316e87b7c8a1de8...2901bbe5be41af3161fe99dede505833f26ff2bf,1,39,26,65,23,2012-03-27 22:40:36,2012-03-21 22:18:18
2901bbe5be41af3161fe99dede505833f26ff2bf...5c8774330f5cc7a5e9a4f9e016e06bea6814d8b5,1,1,1,2,2,2012-03-27 22:40:39,2012-03-27 22:14:48
5c8774330f5cc7a5e9a4f9e016e06bea6814d8b5...8192a2fafcd69fe1cad2fe84c99b03c63393c117,1,1,0,1,1,2012-03-27 22:41:22,2012-03-21 22:21:32
8192a2fafcd69fe1cad2fe84c99b03c63393c117...9d16c2d51412c3ebf06f88faddde3610d6e21892,1,15,9,24,5,2012-03-29 06:27:00,2012-03-29 06:22:22
9d16c2d51412c3ebf06f88faddde3610d6e21892...c2066a3edad39a0fb6e894418e6602a4f7916e82,1,0,1,1,1,2012-04-11 21:38:31,2012-04-11 21:38:31
c2066a3edad39a0fb6e894418e6602a4f7916e82...26693ba81ccffd46fc9e01bc3346fd74f555a31a,1,7,7,14,7,2012-04-11 21:41:42,2012-04-11 21:41:42
26693ba81ccffd46fc9e01bc3346fd74f555a31a...92737a2201f75460dad195474a728dcf8ed79804,1,51,2,53,11,2012-04-11 21:43:48,2012-04-11 21:43:48
c524ceb12f65e2ad4fc68c9d5b39f6e4b6b5c17b...e34bb2e7fd59b3855411123d77cdad0345a25f8b,1,6,6,12,4,2012-02-28 21:17:14,2012-02-28 15:35:48
c524ceb12f65e2ad4fc68c9d5b39f6e4b6b5c17b...6c41e97557d94df7085e3c0cff247305c9401968,2,8,0,8,2,2012-02-27 19:35:33,2012-02-27 15:11:53
8a557bb77fc009b00f7952f0d3d6ebd33079f70e...61821aaa12ed698f2e94bb15fea958c598e4f231,1,10,14,24,3,2012-03-01 22:25:57,2012-03-01 21:40:48
61821aaa12ed698f2e94bb15fea958c598e4f231...aa9828561e562a0b9ca559be4225de679b8e8be3,1,10,8,18,1,2012-03-01 22:34:14,2012-03-01 21:40:49
aa9828561e562a0b9ca559be4225de679b8e8be3...efe4be12490ab684786c48135731c4d2648bbecc,2,16,1,17,2,2012-03-01 22:34:42,2012-03-01 21:40:51
cb8da70547af5cd5c8e03be5a236971951e81277...8ba8fe049feb9207dd3543c339da955336e5df8f,2,1,12,13,4,2012-02-28 18:47:28,2012-02-28 13:59:59
8ba8fe049feb9207dd3543c339da955336e5df8f...989937221a95cd6c3a829da043162e18e0371b1e,2,17,13,30,13,2012-02-28 18:47:30,2012-02-28 14:00:00
d899cf559b6a93006993752e7a89d13606380227...c572f491e545f3fe76a966e418139fc9755a910f,3,9,3,12,6,2012-01-18 23:51:00,2012-01-18 23:51:00
787570c7cddea7ffe3cb2e52c8af169bb17ba29b...e810715528eda01914d2df82628872e8df9929d5,1,4,4,8,4,2011-09-19 20:14:32,2011-09-19 19:15:45
92058e4d3e032714da6d2df5fa1fe2cf612979a5...0d16451943ec4f17ea1503a12549531bb278788a,1,17,56,73,18,2011-12-14 17:46:33,2011-12-14 08:22:03
885b797a4abe1fdfe7c4273caa34207d6e5e4760...3d3d282146e13f2d7f055ad056956fd8e5d7ed29,1,27,31,58,8,2011-08-24 04:35:47,2011-08-24 00:32:35
3d3d282146e13f2d7f055ad056956fd8e5d7ed29...a6c786fce8da4143ea8bb3ab41ce8531192c5126,2,7,0,7,2,2011-08-24 04:36:20,2011-08-24 00:29:51
885b797a4abe1fdfe7c4273caa34207d6e5e4760...1be9d84b2ed18c2b2e2d6a459d2b6d48d5ab86e5,1,81,0,81,1,2011-08-22 22:01:14,2011-08-22 20:36:45
072dda68eafdefe56f9305c547771367353cf89d...0e9b327227fb8f7c1e3a5bbaef19e25b4dfd6764,1,1,1,2,1,2013-04-07 15:41:34,2013-04-07 08:48:30
072dda68eafdefe56f9305c547771367353cf89d...cbfd124c22b3d42cfc40d7de2205e3d7b7b96fe7,1,1,0,1,1,2013-04-03 23:14:19,2013-04-03 19:54:33
60e199c4d577514ed810b4ed0b6072fb3dbab903...c0f19bf3b9c42036722396ee26d2c173d6abf761,2,25,0,25,3,2011-04-20 17:08:54,2011-04-20 10:35:08
c0f19bf3b9c42036722396ee26d2c173d6abf761...a111eb7808bfdb90286e54b9ccdaea4f3bec3102,1,9,6,15,3,2011-04-20 17:09:26,2011-04-20 10:40:05
ed44fd045a8a4bcf7f30a47e4fc6aba761faaf78...57756161eed50f2b52c9e32b01f6388814a09943,2,60,44,104,2,2011-04-15 20:28:03,2011-04-15 02:24:01
57756161eed50f2b52c9e32b01f6388814a09943...dc53151f02ce05f21641895f08808ff7caa9854f,2,84,80,164,2,2011-04-15 20:28:03,2011-04-15 02:28:06
dc53151f02ce05f21641895f08808ff7caa9854f...967ab8efd7f294c05b57db600c4e548d7c4f8b2f,2,18,20,38,3,2011-04-15 20:28:03,2011-04-15 02:32:55
967ab8efd7f294c05b57db600c4e548d7c4f8b2f...36c10e6d7543f9f35295df0113b0c250ad421eb4,4,61,55,116,9,2011-04-15 20:28:03,2011-04-15 02:33:57
36c10e6d7543f9f35295df0113b0c250ad421eb4...b895960516ef3edf66b5200019e2851e1a779053,1,14,4,18,3,2011-04-19 18:31:39,2011-04-18 06:31:16
70eb130768d17c33b9efbf60d7953cf6a57daecb...15438d5a56acfd08545a11630821179334eb6979,2,28,2,30,4,2012-03-03 07:56:28,2012-03-03 02:31:15
70eb130768d17c33b9efbf60d7953cf6a57daecb...661bfd13b49db0affebbdda5ac478ebe67634947,1,5,4,9,1,2012-03-02 22:41:06,2012-03-02 18:48:36
508d1244dc8d38188c70e98207efa8a97d16b47c...1d4ac88d674b5d226db5348e6cd45f64273261d2,1,184,121,305,107,2012-02-28 04:24:20,2012-02-28 04:24:20
317efa63fc457d1a726902ddf97298c201df627c...ca5e9495607c2abb4b665b75d3d96a457fa4c5dd,3,13,0,13,6,2007-10-17 05:23:33,2007-10-17 03:45:25
2e13e5d89252ceef606a0a7be32dbf5bea7e5aca...18184f79dbf70e157399ba2288f7045582fd61c6,1,5,3,8,3,2007-10-16 04:25:56,2007-10-16 04:25:34
18184f79dbf70e157399ba2288f7045582fd61c6...ee020f3598f0dc86a939fb8597845594bf664898,1,19,10,29,3,2007-10-16 04:28:32,2007-10-16 04:28:32
ee020f3598f0dc86a939fb8597845594bf664898...fe5d1d3eb42e6cf3dca93b2277be9464b026fcf2,3,16,4,20,8,2007-10-16 04:36:35,2007-10-16 04:35:22
fe5d1d3eb42e6cf3dca93b2277be9464b026fcf2...da0204df587ae76cd291bc7e495fc60d873c2f20,3,17,3,20,4,2007-10-16 05:24:18,2007-10-11 00:47:55
da0204df587ae76cd291bc7e495fc60d873c2f20...cfa5b2b7faa1a620ec6599a63fa5b9b45bd62b57,1,3,3,6,2,2007-10-19 07:47:07,2007-10-19 04:54:59
cfa5b2b7faa1a620ec6599a63fa5b9b45bd62b57...ca5bb5d5390e4ec709ca3e11c451c58a836d4ee6,3,21,0,21,6,2007-10-21 02:52:21,2007-10-20 20:03:49
d7416ecac8508367a8ac35ab74ef09b7707d0c4b...be510cfef3d8344007bd34128ca6eb799b714c8c,1,11,4,15,3,2007-09-18 05:02:19,2007-09-18 04:18:20
a017f27dcbe6b4f9c8760ccc8a7e248c680b6a23...64586e75af3c84844b80652575a8b63a9612b24a,3,103,1,104,9,2007-09-18 06:57:35,2007-09-12 23:04:22
64586e75af3c84844b80652575a8b63a9612b24a...cba8d4896187abedd9c35936504b7254a2ecbd91,2,14,3,17,4,2007-09-18 06:57:35,2007-09-14 23:53:58
cba8d4896187abedd9c35936504b7254a2ecbd91...7a461b5a33239cfba3bbf0a1deef544c7f1dcfeb,1,8,1,9,2,2007-09-18 06:57:35,2007-09-14 23:59:04
17ed158021ead9cb056f692fc35ff3fcde96a747...400e58b74e701398bd7e51bd3f102f31cc45ee93,1,1,2,3,1,2007-09-21 09:42:16,2007-09-21 02:02:33
400e58b74e701398bd7e51bd3f102f31cc45ee93...d99c74e2913ab098953bd5b422b95f39e2dcfb55,1,1,0,1,1,2007-09-21 09:42:16,2007-09-21 02:02:34
d99c74e2913ab098953bd5b422b95f39e2dcfb55...ffab62681cf420abb87aabf3fd2fc96e000877e4,1,4,2,6,1,2007-09-21 09:42:16,2007-09-21 03:27:01
e4b2890773706d0340371571914f8f24036840e6...bc12651b08fe295ac5647208f9b3f946145cc9b1,1,21,0,21,3,2007-09-24 08:12:16,2007-09-24 08:12:16
bdd7379566cf7b1f1c9bfe42e794c8f1821971f7...c6056fbc614100f971d01bbff5dc4a7e8eaa9bcb,1,1,1,2,1,2012-07-16 16:39:24,2012-07-16 11:50:31
bdd7379566cf7b1f1c9bfe42e794c8f1821971f7...7d37b5bf4eda8b2dcca371fb4b5ebd50fed64d67,1,1,0,1,1,2007-08-29 20:19:41,2007-08-29 14:15:34
63c4024ff080430004967fa27b8af8fe243e2ea3...e7034d66ecd9c16ae8bd8d331fc41efc48e925f1,1,12,0,12,1,2007-09-13 23:04:14,2007-09-13 23:04:14
c8dd7f62e8b335681099cdcec2b01aeaad646813...146d73a365c3a1c2e61e646a929a5168ffb2810c,1,10,1,11,1,2007-09-12 20:47:06,2007-09-12 20:47:06
146d73a365c3a1c2e61e646a929a5168ffb2810c...a9813cb51d4f64e93e2a028a2b749d70e378a8a0,2,5,5,10,5,2007-09-12 20:51:54,2007-09-12 20:02:35
a9813cb51d4f64e93e2a028a2b749d70e378a8a0...262360f3aa11291816d63fb6d23851db1ae5ff27,1,9,0,9,1,2007-09-12 21:05:16,2007-09-12 21:03:27
9ce57f12280eb6a95043e28ad68ff2b6c70c09ad...5b509df0c3b54c1b64ae3de871b2f150a524abb0,1,17,0,17,5,2014-10-29 17:18:31,2014-10-29 17:18:31
25197ebe7f813407b028a2c304ff8ee58da40a16...93e7d672fcac8bdc16ae7276bc5942889aa3f179,1,14,0,14,1,2011-05-11 22:23:25,2011-05-11 22:23:25
93e7d672fcac8bdc16ae7276bc5942889aa3f179...650af7ae8bdf92bd92df20152b6d1ad7eb014169,1,6,2,8,1,2011-05-13 05:32:24,2011-05-12 08:21:33
650af7ae8bdf92bd92df20152b6d1ad7eb014169...488201c87e284ae06323b534c31e354811fb0d51,1,2,2,4,2,2011-05-18 04:04:59,2011-05-17 17:43:10
ccc2fcf54cd6cfa9f15c110d064e10aa8d71ddb1...4fec83045bdc53ed9d3ff71ed099e3e6992b5c56,3,6,2,8,3,2011-04-19 18:45:38,2011-04-19 18:45:38
ccc2fcf54cd6cfa9f15c110d064e10aa8d71ddb1...fd91d260f2b1aeface2369a758d5b6a142bd9691,1,7,9,16,4,2011-04-19 18:35:53,2011-04-19 09:06:46
96dbe93da541cb930bacd4e2df0a95e41d4c6441...43d532e6ba3450a84cad007062b8ac429d7a8ac3,1,2,2,4,2,2011-05-16 23:35:08,2011-05-16 18:23:35
96dbe93da541cb930bacd4e2df0a95e41d4c6441...161807349aa1ee853880a5c6e39c53f55b10077d,1,10,2,12,3,2011-05-16 20:00:30,2011-05-12 11:09:46
161807349aa1ee853880a5c6e39c53f55b10077d...fad2652673247203014e2c57622a5ffe0eb5ad93,1,1,3,4,2,2011-05-16 20:01:45,2011-05-12 11:09:55
fad2652673247203014e2c57622a5ffe0eb5ad93...e9fe74cba4ed4577dcc02f61094c611a1c216fee,1,25,2,27,2,2011-05-16 20:05:03,2011-05-12 11:10:07
ea2c69ed4728070be1d2ee953a6948398b859150...36cfda15527d4eb50c84256307e3cb46578f975e,4,106,32,138,6,2011-03-17 23:18:47,2011-03-11 19:32:53
36cfda15527d4eb50c84256307e3cb46578f975e...e52d719266a06a8553043cb5616d9b4ce4abd27a,2,13,1,14,4,2011-03-17 23:18:55,2011-03-11 19:53:52
ea2c69ed4728070be1d2ee953a6948398b859150...23a32ffe803237b64651cbd104585d04b8fe33d6,1,1,1,2,1,2011-03-17 21:53:10,2011-03-16 08:14:33
23a32ffe803237b64651cbd104585d04b8fe33d6...3ba2e8653c88d220b0b22f35260477bb0afa7d7b,1,5,6,11,4,2011-03-17 21:54:11,2011-03-16 08:18:49
ea2c69ed4728070be1d2ee953a6948398b859150...c9b6782a08a728908bac8dc51def3607b3daa2a9,2,2,2,4,2,2011-03-16 19:31:32,2011-03-16 06:59:10
c9b6782a08a728908bac8dc51def3607b3daa2a9...c6c8d0b797e33ce1f22d50b46d9c6eba91ed2cbc,1,10,8,18,1,2011-03-16 19:44:59,2011-03-16 07:00:49
c6c8d0b797e33ce1f22d50b46d9c6eba91ed2cbc...9cba13ca5d233a4e1a7068f3f5ed5836a081dcc0,17,44,88,132,43,2011-03-16 19:49:02,2011-03-16 07:08:34
9cba13ca5d233a4e1a7068f3f5ed5836a081dcc0...6e0332ec3ea74e635258a30d360bd2e00a51730e,1,27,21,48,2,2011-03-16 19:52:15,2011-03-16 07:10:14
6e0332ec3ea74e635258a30d360bd2e00a51730e...a3a32e7f083cdd3b8e68419d2f012b5561a9ccde,1,18,16,34,2,2011-03-16 19:54:44,2011-03-16 07:12:48
a3a32e7f083cdd3b8e68419d2f012b5561a9ccde...808a95dcad957ce00dc6fde7cf7f53ca32200c34,1,61,42,103,6,2011-03-16 19:55:49,2011-03-16 07:14:11
808a95dcad957ce00dc6fde7cf7f53ca32200c34...b406a2d3e30b1930ea3dc812bd1c4422ae135d14,1,6,0,6,1,2011-03-16 20:19:56,2011-03-16 11:46:01
b406a2d3e30b1930ea3dc812bd1c4422ae135d14...1d679de58e886e134c5569c542667a08f0faedd6,1,4,0,4,1,2011-03-16 20:51:22,2011-03-16 16:06:17
1d679de58e886e134c5569c542667a08f0faedd6...6affdbe677c4b2b8547bd9aa471464dd31a94a1c,1,1,1,2,1,2011-03-16 23:18:58,2011-03-16 22:34:13
ea2c69ed4728070be1d2ee953a6948398b859150...26b59b4812c81de09aa450ebbdf2bb0ea71c0dfd,1,2,1,3,2,2011-03-14 07:28:37,2011-03-12 08:57:46
26b59b4812c81de09aa450ebbdf2bb0ea71c0dfd...6eaf92f3d08180da4a6bd40035919a7e07ffed5a,1,19,0,19,1,2011-03-21 04:45:11,2011-03-14 19:19:36
f1723ee6b370c3d0cfaaea9d02188175a8d85af6...90cff968b3757061914f83b85a8d58cb9f29e72a,1,3,3,6,2,2011-03-29 08:13:36,2011-03-26 18:46:34
c2e86addb86689306b992065328ec52aa2479658...e7c3a59c22b28002d7cab3a4a0807fdc0d2388c9,1,1,3,4,2,2011-03-22 21:29:06,2011-03-22 21:17:30
e7c3a59c22b28002d7cab3a4a0807fdc0d2388c9...9d8a5a50b7e30d85aff3deac2a6994bf0178983d,1,29,18,47,4,2011-03-22 21:29:07,2011-01-06 21:50:04
9d8a5a50b7e30d85aff3deac2a6994bf0178983d...e88d6bc6f90059f6e87f6d51eba83ec15e4eecc9,1,12,11,23,11,2011-03-22 21:29:07,2011-01-06 21:50:05
e88d6bc6f90059f6e87f6d51eba83ec15e4eecc9...f31027c99cb2ec4eb7ad8d1ebc7f0e20fef4bd1d,7,112,10,122,21,2011-03-22 21:29:07,2011-01-06 21:50:06
c2e86addb86689306b992065328ec52aa2479658...c0aa335c95974caebcc972cd63a11e6ff73b1612,7,5,19,24,14,2011-03-22 18:43:27,2011-03-22 12:50:08
ee459baa5ce0a144e013a4995fd5be96bbecd05e...fae9d761c78cba1039854b51df6c2f7360e59cba,1,7,21,28,5,2012-03-26 19:38:34,2012-03-26 19:38:34
fae9d761c78cba1039854b51df6c2f7360e59cba...b1d645b58ac6c96ffdc8d9a01f0b44a10deb43f9,1,1,1,2,1,2012-03-27 14:56:57,2012-03-27 06:22:02
c9d1c8ba059577e64fb2213cb0c5f3c4619c7519...044ad2906a5e4b805bc8c8d121466d8ff94ecbfb,1,43,19,62,13,2011-03-22 23:09:02,2010-12-13 08:13:24
044ad2906a5e4b805bc8c8d121466d8ff94ecbfb...90c0a3cfe390208c86144bf97ec8fa5610febe0f,1,59,50,109,15,2011-03-22 23:09:05,2010-12-13 08:56:01
c9d1c8ba059577e64fb2213cb0c5f3c4619c7519...dce33c9c18e2987da1fe8ade67d27057bcb80a67,1,8,20,28,12,2011-03-22 21:41:36,2011-03-21 23:49:50
dce33c9c18e2987da1fe8ade67d27057bcb80a67...7c5817d3ba111bb71a5d7e3c8526e0925f96c92d,5,43,30,73,22,2011-03-22 23:01:48,2011-03-22 22:52:17
dd3f42ad793b5334d506a451addcefd0054c27bb...43155cfe1415f5547791613a5de6399112ba3560,3,6,24,30,7,2011-03-26 06:00:05,2010-12-13 06:09:31
f37d3c755209234acfc2ca280027ebdab8e9ea8a...d866924a080215dd276c510abf255a8929b55643,1,5,0,5,3,2012-10-04 22:49:39,2012-10-04 22:37:15
4337b5856f88f18da47c176e3cbc95a35627044c...056f34bbcdda2f7f85858ed8414afbed99686758,1,4,7,11,3,2013-10-16 19:01:53,2013-10-16 00:48:57
4337b5856f88f18da47c176e3cbc95a35627044c...c479d14a80743b1cb86d77695607f4c81f7d8797,2,33,1,34,6,2012-07-29 22:14:08,2012-07-28 15:06:29
14bf2d58bc3b202da3ca34cfdf72392889135411...a312a271b92fe74f5954adbb824987b040926c4c,1,2,2,4,1,2012-08-22 16:59:52,2012-08-22 14:48:03
3207a3a29179c247d1ee9552511123e426845acb...e858af6d501954af07fa3bb7d2cca40b638c75a6,1,8,0,8,3,2012-06-08 15:14:22,2012-06-08 10:18:30
3207a3a29179c247d1ee9552511123e426845acb...a5985237878481af5fbca349d0d1ad7d6b2d2bcb,2,13,3,16,3,2012-05-08 08:51:08,2012-05-07 21:02:18
a5985237878481af5fbca349d0d1ad7d6b2d2bcb...d4a6bf1fb64d904e210fbf7c5b330b06438a5bd5,5,16,11,27,13,2012-05-08 08:51:08,2012-05-07 21:09:04
fca9249b86411718a66835fe5107219b49c1767f...6a4a4822298866ec3386a46d9d8f933b80e3a359,1,4,24,28,3,2012-05-14 19:20:46,2012-05-14 19:20:46
e8dde3e5f9ddb7cf95a6ff3cea6cf07c3a2db80d...60f26f634875b8fd2e8172ecf8c81d885c3d82f7,1,4,2,6,3,2012-05-20 21:19:18,2012-05-02 15:31:52
e8dde3e5f9ddb7cf95a6ff3cea6cf07c3a2db80d...f94920993a0a1ba7916618e2ab458d5d4fb21e94,1,16,5,21,5,2012-05-04 19:42:25,2012-05-04 18:13:14
f94920993a0a1ba7916618e2ab458d5d4fb21e94...5d8863954f077d2c262d5cc4fc669947ff23d6d5,2,8,7,15,7,2012-05-04 19:42:27,2012-05-04 18:14:48
e8dde3e5f9ddb7cf95a6ff3cea6cf07c3a2db80d...4c0a89fcde219df8db8fdb9635ef2ef40d002a6e,3,18,1,19,5,2012-04-30 00:46:32,2012-04-25 12:00:36
e8dde3e5f9ddb7cf95a6ff3cea6cf07c3a2db80d...05880b02221dc8da136e9febfa7853ad822b1ee1,1,54,34,88,11,2012-04-20 20:38:51,2012-04-20 06:25:09
e8dde3e5f9ddb7cf95a6ff3cea6cf07c3a2db80d...be39048a7385157e4b7baabd3e64fe186b428ea1,1,4,0,4,1,2012-04-18 20:06:19,2012-04-17 18:48:39
e8dde3e5f9ddb7cf95a6ff3cea6cf07c3a2db80d...64394e3ae9194836ffd4068006bbdd5ad9810a4b,1,82,79,161,68,2012-04-18 20:05:33,2012-04-17 18:00:58
e8dde3e5f9ddb7cf95a6ff3cea6cf07c3a2db80d...90110d7645e5035ea59bc5c72fac4e11ad55a6ef,1,4,3,7,1,2012-04-18 20:00:57,2012-04-17 18:00:04
e8dde3e5f9ddb7cf95a6ff3cea6cf07c3a2db80d...8c188c74e3f04ab75a42d43375a011f286cb1b66,1,74,4,78,13,2012-04-16 18:23:25,2012-04-16 10:44:49
8c188c74e3f04ab75a42d43375a011f286cb1b66...5e71a84a2da8f5dd32c13392854eab4d448c8085,2,4,0,4,4,2012-04-16 18:28:30,2012-04-16 10:44:50
5e71a84a2da8f5dd32c13392854eab4d448c8085...3f1451326a09a4e36c10feff65685daef1d29c32,1,1,1,2,1,2012-04-16 18:28:39,2012-04-16 10:44:51
3f1451326a09a4e36c10feff65685daef1d29c32...36dcc02c52cb60c751338591dbb3bf4d9cf5a753,1,25,9,34,5,2012-04-16 18:31:46,2012-04-16 10:44:52
36dcc02c52cb60c751338591dbb3bf4d9cf5a753...da79161db6dcb0643ab805e5cf78d7e4e34ce993,1,28,0,28,1,2012-04-18 23:07:22,2012-04-18 21:09:33
da79161db6dcb0643ab805e5cf78d7e4e34ce993...678c5741118729dc9072182bd368e0a3402dd4f1,2,12,8,20,6,2012-04-18 23:08:11,2012-04-18 21:12:18
e8dde3e5f9ddb7cf95a6ff3cea6cf07c3a2db80d...1b4aee94aaffd5e6fdf3020434b3fa6f0c5cfb2b,1,78,3,81,5,2012-04-15 21:23:05,2012-04-14 07:54:31
1b4aee94aaffd5e6fdf3020434b3fa6f0c5cfb2b...9884e67f9d9b511592b981572cfbb30cc50aec61,2,10,6,16,3,2012-04-15 21:24:36,2012-04-14 07:54:32
9884e67f9d9b511592b981572cfbb30cc50aec61...bb0dab5d617219d7efe8815cadef6d98c4bc3df8,2,5,2,7,3,2012-04-15 21:25:19,2012-04-14 07:54:33
bb0dab5d617219d7efe8815cadef6d98c4bc3df8...17c82211ec2d29a6e7221948cba8dae9074dc5a6,2,9,4,13,4,2012-04-15 21:25:34,2012-04-14 07:54:34
17c82211ec2d29a6e7221948cba8dae9074dc5a6...647202889397e775c294234ebd3df8b2c4473f0f,2,9,9,18,9,2012-04-15 21:26:08,2012-04-14 07:54:35
e8dde3e5f9ddb7cf95a6ff3cea6cf07c3a2db80d...6d5b93f29f5362b9b84954d87684705227984f9e,3,19,11,30,5,2012-04-15 20:33:31,2012-04-14 19:04:48
e8dde3e5f9ddb7cf95a6ff3cea6cf07c3a2db80d...2565b43bd2634ffd6bda06236d664288aeb8eb6a,1,13,9,22,9,2012-04-15 20:28:02,2012-04-12 23:11:36
e8dde3e5f9ddb7cf95a6ff3cea6cf07c3a2db80d...d57e490af31dff940052a5929fe05947c7ad03ad,1,39,3,42,4,2012-04-15 20:21:51,2012-04-11 21:25:01
e8dde3e5f9ddb7cf95a6ff3cea6cf07c3a2db80d...df478b744cee9821eb2abbe2202d262b87a34289,4,17,2,19,6,2012-04-11 20:46:08,2012-04-11 20:21:53
df478b744cee9821eb2abbe2202d262b87a34289...b27cfb0d8d4cbb6d079c70ffeadac9c0dcfff250,4,102,13,115,18,2012-04-24 21:52:12,2012-04-20 14:36:15
b27cfb0d8d4cbb6d079c70ffeadac9c0dcfff250...bedfe86ce6ccee90e2cbecbf8d72e06219a2768a,1,24,1,25,2,2012-04-24 21:52:13,2012-04-20 14:36:16
bedfe86ce6ccee90e2cbecbf8d72e06219a2768a...90e1818f9a06015159712e204dd90868e0a6c421,4,55,8,63,13,2012-04-24 22:24:14,2012-04-20 14:36:17
e8dde3e5f9ddb7cf95a6ff3cea6cf07c3a2db80d...7e52f5660e542cf801e8fc6902a30cc572c13736,4,61,11,72,11,2012-04-11 18:09:49,2012-04-07 10:30:09
7e52f5660e542cf801e8fc6902a30cc572c13736...fd93d2e60ea66fc3796904ff53ead3ef4755b137,2,2,3,5,2,2012-04-18 23:16:16,2012-04-18 21:08:49
fd93d2e60ea66fc3796904ff53ead3ef4755b137...d15bbe1379a12e2d9a5f18f7dc96b38afafc6c5d,3,17,0,17,3,2012-04-18 23:16:38,2012-04-18 21:10:05
d15bbe1379a12e2d9a5f18f7dc96b38afafc6c5d...234587fc87b156dc20461fc61353beeb904b43bc,1,33,45,78,15,2012-04-18 23:17:42,2012-04-18 21:10:19
e8dde3e5f9ddb7cf95a6ff3cea6cf07c3a2db80d...3fb0459bc89bebb07e0603ce3ce92dbbc8a39ea4,19,65,74,139,63,2012-04-11 16:32:20,2012-04-11 11:24:01
e8dde3e5f9ddb7cf95a6ff3cea6cf07c3a2db80d...bc5fd6d3c29f1a734ebd202573b39c1f66c41744,1,256,253,509,22,2012-04-10 22:51:47,2012-04-10 05:30:13
bc5fd6d3c29f1a734ebd202573b39c1f66c41744...429213e47039e6c60dd7ffcf4b32bf5bb3515690,1,7,6,13,5,2012-04-10 22:51:52,2012-04-10 05:30:14
429213e47039e6c60dd7ffcf4b32bf5bb3515690...c36b5bc2e44c7e53a4c078056f1c40c155d8a87e,1,23,10,33,2,2012-04-10 22:51:52,2012-04-10 05:30:15
c36b5bc2e44c7e53a4c078056f1c40c155d8a87e...b3fd060f9e60f842b46183067f1a76fa6a5358b1,1,53,29,82,3,2012-04-10 22:51:52,2012-04-10 05:30:16
b3fd060f9e60f842b46183067f1a76fa6a5358b1...d66da478f26df3114af1177fa5614035439178ed,1,61,33,94,7,2012-04-10 22:53:28,2012-04-10 05:30:17
d66da478f26df3114af1177fa5614035439178ed...5a4d4947318d638f39a47be253d83460a10e65ef,1,37,25,62,4,2012-04-10 22:54:54,2012-04-10 05:30:19
5a4d4947318d638f39a47be253d83460a10e65ef...732134edab1f20a8ce2ef3812a819a2216e9eb88,1,7,2,9,3,2012-04-10 22:54:58,2012-04-10 05:30:21
732134edab1f20a8ce2ef3812a819a2216e9eb88...dac529e44fb9e8c0ee4628c0f947db8890950317,1,2,2,4,2,2012-04-10 22:54:58,2012-04-10 05:30:22
dac529e44fb9e8c0ee4628c0f947db8890950317...593f1bb82fcf3a02b7984a21988596136917e5dc,1,19,13,32,12,2012-04-10 22:54:58,2012-04-10 05:30:23
593f1bb82fcf3a02b7984a21988596136917e5dc...d3177275ed8e7dcb258a4496bf7b9317edfb9700,1,97,98,195,53,2012-04-10 22:54:59,2012-04-10 05:30:24
d3177275ed8e7dcb258a4496bf7b9317edfb9700...81a79d8e27f6dd5908ae9ba122833574b7475151,1,11,10,21,4,2012-04-10 22:55:50,2012-04-10 05:30:25
81a79d8e27f6dd5908ae9ba122833574b7475151...432ad41e60cedb87ceec446ab034d46a53f5f9d8,2,232,49,281,29,2012-04-10 22:55:55,2012-04-10 05:30:26
432ad41e60cedb87ceec446ab034d46a53f5f9d8...933ac036d29e65e1b3d71332d9ade8edd1e8a89b,1,28,7,35,1,2012-04-10 22:55:55,2012-04-10 05:30:27
e8dde3e5f9ddb7cf95a6ff3cea6cf07c3a2db80d...3c863e247e594d56cd6a333365d1029ddf271610,1,127,115,242,116,2012-04-10 22:04:30,2012-04-10 22:04:30
3c863e247e594d56cd6a333365d1029ddf271610...a48313d8b7167065968699a6d3a7fe29db1e1528,1,3503,0,3503,1,2012-04-12 00:03:12,2012-04-10 16:50:59
a48313d8b7167065968699a6d3a7fe29db1e1528...36cbbde3bf9e1b8a928263a6f135d550ab9ba6a1,1,4,0,4,1,2012-04-12 00:03:30,2012-04-11 00:11:12
36cbbde3bf9e1b8a928263a6f135d550ab9ba6a1...01b127cdc5d596a3022d834d82f883822c7f166b,2,3508,0,3508,2,2012-04-28 00:25:48,2012-04-26 06:59:41
e8dde3e5f9ddb7cf95a6ff3cea6cf07c3a2db80d...c2df7585efcced5833891938fe01c24c9fb36dd7,1,1,1,2,1,2012-04-10 19:27:54,2012-04-10 19:10:26
c2df7585efcced5833891938fe01c24c9fb36dd7...a961d1f1ea2e3aaef0ff3e75920d1cd830d9b423,1,3,3,6,3,2012-04-10 19:28:20,2012-04-10 19:07:34
e8dde3e5f9ddb7cf95a6ff3cea6cf07c3a2db80d...658219f1c75e25adbe530a3b681ba3d2332caca6,2,3,1,4,2,2012-04-10 16:25:35,2012-04-09 13:27:56
e8dde3e5f9ddb7cf95a6ff3cea6cf07c3a2db80d...5a9681f46aa9e152f32e76d7ade9d4c11313f99a,1,15,10,25,10,2012-04-10 16:12:11,2012-04-10 09:53:39
5a9681f46aa9e152f32e76d7ade9d4c11313f99a...dfa1725a3ec57098637b698ffc2b2e2459acc518,2,7,5,12,6,2012-04-10 16:12:13,2012-04-10 09:53:40
dfa1725a3ec57098637b698ffc2b2e2459acc518...aa0834a04e1d9d3ab81ecd4a4a138233e6e234ed,1,3,3,6,3,2012-04-14 23:04:24,2012-04-13 06:18:35
aa0834a04e1d9d3ab81ecd4a4a138233e6e234ed...6f4c347ca1d3102d77e2dd36b6bc8ab12de6045b,1,11,2,13,3,2012-04-14 23:04:25,2012-04-13 06:19:25
e8dde3e5f9ddb7cf95a6ff3cea6cf07c3a2db80d...6942efcfa9f3083e7c7863348fa5bb1350412595,2,124,0,124,6,2012-04-10 00:03:25,2012-04-06 21:01:23
6942efcfa9f3083e7c7863348fa5bb1350412595...6f1af028ce0654ef6233dff06701a989d5703bc4,1,23,29,52,3,2012-05-01 19:19:06,2012-05-01 10:23:20
e8dde3e5f9ddb7cf95a6ff3cea6cf07c3a2db80d...b6f930576469052af87e96b549c37630b56aab93,9,25,15,40,12,2012-04-09 21:59:40,2012-04-09 00:18:00
b6f930576469052af87e96b549c37630b56aab93...9dcb9f24f8f97c5d0d3224791506161dfeac5a69,1,7,7,14,5,2012-04-09 21:59:40,2012-04-09 00:18:01
9dcb9f24f8f97c5d0d3224791506161dfeac5a69...6ab1d76c3cf96aac77a75565dfaa0cf64aa100a1,12,182,184,366,177,2012-04-09 22:00:33,2012-04-09 00:18:02
e8dde3e5f9ddb7cf95a6ff3cea6cf07c3a2db80d...c5bc42b9b7bfa8dc2e769c4549572265af259d12,1,3,2,5,2,2012-04-09 21:49:32,2012-04-09 20:08:02
afd7bd22209c53ae4d3c73dd4bc4b225ec55e10a...4a6385fe555f810e8168399df673d00addffb721,1,3,2,5,1,2012-12-13 18:12:25,2012-12-13 01:14:47
745950ce0e7e984158a00cd52c5811918d1f3495...ac06116d44ae3738e7ad0f711074186e006a1eb5,1,1,1,2,1,2012-03-12 21:41:15,2012-03-12 21:41:15
455cf268dbaf227bdbd5e9fbf96525452bcfe44f...ce61fb968f9b86f5d889eeb7b80da8ec3d6bfb9b,1,8,5,13,2,2012-04-11 21:26:01,2012-04-11 21:18:37
ce61fb968f9b86f5d889eeb7b80da8ec3d6bfb9b...cbbea3dfc1a1cfe382e58488c389471b4ab21876,1,3,0,3,1,2012-04-11 21:26:01,2012-04-11 21:18:38
cbbea3dfc1a1cfe382e58488c389471b4ab21876...9768a9d884ee293548c0435df7645fd82d8d942e,1,7,4,11,4,2012-04-11 21:26:01,2012-04-11 21:18:39
9768a9d884ee293548c0435df7645fd82d8d942e...d21102c9ffd6beb0408693b6f1b633f8e494c921,1,51,45,96,2,2012-04-11 21:26:01,2012-04-11 21:18:40
d21102c9ffd6beb0408693b6f1b633f8e494c921...44185f93f46af7077585ef7ccf5339334a4ab487,1,39,16,55,7,2012-04-11 21:26:01,2012-04-11 21:18:41
44185f93f46af7077585ef7ccf5339334a4ab487...f4a81026508a48a129bd936aef2c75ac1f1cdd97,1,18,19,37,10,2012-04-11 21:26:02,2012-04-11 21:18:42
f4a81026508a48a129bd936aef2c75ac1f1cdd97...5fb6ddf67afb3d0dc9b1fce64543f20b28a81b4b,2,103,12,115,9,2012-04-11 21:26:02,2012-04-11 21:18:43
5fb6ddf67afb3d0dc9b1fce64543f20b28a81b4b...51ef7a6e80013c9131c8751fca7c11b0b4bfba85,1,42,13,55,12,2012-04-11 21:26:02,2012-04-11 21:18:44
455cf268dbaf227bdbd5e9fbf96525452bcfe44f...b3e34dddc0d385dbcf6ea28bd8d4f5cba9c06f04,2,12,1,13,3,2012-04-04 00:24:20,2012-03-31 01:33:21
455cf268dbaf227bdbd5e9fbf96525452bcfe44f...7e238ab7bae2d70bea8d84750897fb1cbc1bdf4d,1,19,19,38,19,2012-03-30 09:02:12,2012-03-30 02:55:34
7e238ab7bae2d70bea8d84750897fb1cbc1bdf4d...833662295e6b9515617f96323d6821bcb6662cf0,2,3587,0,3587,2,2012-04-02 01:46:11,2012-03-31 15:51:45
833662295e6b9515617f96323d6821bcb6662cf0...18ac610272659f3159dd7eb3405638c4c31ca180,2,3497,0,3497,2,2012-04-02 12:20:54,2012-04-02 12:14:08
455cf268dbaf227bdbd5e9fbf96525452bcfe44f...b3065bdc03dd91561e35f91896aec8c64667d1a9,1,0,2,2,1,2012-03-28 22:19:17,2012-03-28 20:18:37
1c7d402b3e1e9d7e50abfbfb18c88bc79be468ea...2bcd9ec5018ad259e5b6803dccf0c7bc121bd9ea,1,1,1,2,1,2010-11-26 22:50:44,2010-11-25 08:21:02
2bcd9ec5018ad259e5b6803dccf0c7bc121bd9ea...6cfc028641246939ee52a6720d4d3c4b63ccb515,1,13,1,14,2,2010-11-26 22:50:45,2010-11-25 08:21:03
6cfc028641246939ee52a6720d4d3c4b63ccb515...1966d9f37b94fa506bfa43961fb111084aaa2c45,5,12,9,21,7,2010-11-26 22:50:45,2010-11-25 08:21:04
1966d9f37b94fa506bfa43961fb111084aaa2c45...3793a309018eac83de7e4a3d39440d236660665c,2,8,0,8,2,2010-11-26 22:50:45,2010-11-25 08:21:05
3793a309018eac83de7e4a3d39440d236660665c...cf688cc27329c478eb9ec9be56144198e4a2025a,1,1,3,4,1,2010-11-26 22:50:45,2010-11-25 08:21:06
cf688cc27329c478eb9ec9be56144198e4a2025a...0fdadc501ee42c530946731718dfdd710f4005d3,1,4,0,4,1,2010-11-26 22:50:45,2010-11-25 08:21:07
0fdadc501ee42c530946731718dfdd710f4005d3...dfc2dcd9acf95794788f9471028485c2d2cc78ef,1,10,2,12,1,2010-11-26 22:50:46,2010-11-25 08:21:08
dfc2dcd9acf95794788f9471028485c2d2cc78ef...1462d1af69247af5fa2b43f7b4fe61ec3c71b55a,1,2,13,15,4,2010-11-26 22:50:46,2010-11-25 08:21:09
1462d1af69247af5fa2b43f7b4fe61ec3c71b55a...6f5185bd2d87dff587e4900aa022f6f9bd088f20,1,5,11,16,4,2010-11-26 22:50:46,2010-11-25 08:21:10
1c7d402b3e1e9d7e50abfbfb18c88bc79be468ea...729ec9e23a13a0610a19a24901d0ab5e2bc44a12,2,22,9,31,2,2010-11-24 00:23:10,2010-11-21 11:11:21
1c7d402b3e1e9d7e50abfbfb18c88bc79be468ea...e93368d26ebcf69698b8454afb85c9c84bd54363,1,3,1,4,3,2010-11-24 00:08:01,2010-11-23 19:53:08
e93368d26ebcf69698b8454afb85c9c84bd54363...83acaaec12fcf33e605f441216ecc91c81b90449,1,1,1,2,1,2010-11-24 18:10:35,2010-11-20 23:06:05
83acaaec12fcf33e605f441216ecc91c81b90449...401857c4c641a73e7fb78d26a9c2ad6eb316b739,1,1,1,2,1,2010-11-24 20:23:48,2010-11-24 20:03:53
2e736fd5e94c6fa44ba95d81a5b0ae407b968b78...377115493a9f3700f9b71de9ac86464b8bfd3fa2,1,1,1,2,1,2012-11-21 19:54:32,2012-11-21 19:08:51
b082687cbac951d31bdea346404db5d0b99a0b73...7e29b8254f08af820b2f0c3770836638ffe517ab,12,391,0,391,14,2012-04-27 16:26:37,2012-04-21 04:44:32
7e29b8254f08af820b2f0c3770836638ffe517ab...88e8f908f2b0c56f9ccf8134d8ff9f689af9cc84,1,1,1,2,1,2012-04-27 16:26:38,2012-04-13 10:54:34
88e8f908f2b0c56f9ccf8134d8ff9f689af9cc84...077539d734cdc4b0a3d2ea87fc487fa5c21d0311,4,206,0,206,7,2012-04-27 16:26:38,2012-04-13 10:54:35
077539d734cdc4b0a3d2ea87fc487fa5c21d0311...f78b1c5f8237d68fffe7c04d22bf93f2ad0bc730,1,3,2,5,2,2012-04-27 16:26:38,2012-04-27 09:25:25
f78b1c5f8237d68fffe7c04d22bf93f2ad0bc730...3f8eccbe166ecff79a986b7ce87df4963cc873b2,4,137,1,138,14,2012-04-27 16:26:38,2012-04-13 10:54:36
3f8eccbe166ecff79a986b7ce87df4963cc873b2...dbfae689690bead0e49130b149c869834795cf81,3,30,38,68,14,2012-04-27 16:26:38,2012-04-13 10:54:37
dbfae689690bead0e49130b149c869834795cf81...ebe31ef2ed539ec93f87c6705852f29347410b48,5,119,5,124,13,2012-04-27 16:26:38,2012-04-13 10:54:38
ebe31ef2ed539ec93f87c6705852f29347410b48...323d0530918f015fa28572f4477723b607bce000,7,70,3,73,16,2012-04-27 16:26:38,2012-04-13 10:54:39
323d0530918f015fa28572f4477723b607bce000...b27004eb32139977f8fa5c01eb235535661f9201,2,72,0,72,3,2012-04-27 16:26:38,2012-04-13 10:54:40
b27004eb32139977f8fa5c01eb235535661f9201...d96e3c150f2b4508f2e7d23ce9183d5b807c2155,5,82,4,86,10,2012-04-27 16:26:39,2012-04-13 10:54:41
c6a13b2c86b71cb25011094ff2dee3d7769991a2...9dad83be45003940968656cf7ea037851b0e7bfe,1,1,3,4,1,2012-10-02 22:08:16,2012-10-02 22:08:16
80809062452a65146d73ae483415acbc737fabf1...2b34e486bc0ce1aabaa024ca97e8b005d9bc53ed,1,1,1,2,1,2012-02-27 01:46:00,2012-02-25 08:16:09
8c1ba2131436f7412b3aa8642ea507cc171af5c4...868d662399786462f87df45c3d68bd5390311a6e,2,51,1,52,2,2012-04-26 17:53:55,2012-04-26 17:40:08
b3a769dc355b32c95783dc07f59e4dfebdd8bdc7...7b151f492d4453a9269a74b4d5b6f3ec1a6681e4,1,1,1,2,1,2012-02-21 21:37:31,2011-11-03 18:33:30
7b151f492d4453a9269a74b4d5b6f3ec1a6681e4...b380e3a79211f59adf6761968ff76c8d6535f72e,1,1,1,2,1,2012-02-21 21:37:31,2012-02-12 00:23:05
b380e3a79211f59adf6761968ff76c8d6535f72e...83cf21f9852f22f5a46a48e3b636ecc6403a717e,1,1,2,3,1,2012-02-21 21:37:31,2012-02-12 00:23:06
83cf21f9852f22f5a46a48e3b636ecc6403a717e...6aa17fc69bce19bcd412cf4b950e797767c87012,1,11,7,18,6,2012-02-21 21:37:31,2011-12-19 08:11:05
6aa17fc69bce19bcd412cf4b950e797767c87012...5ec514bd2f9b18463886df372ea1412fc61467de,1,1,1,2,1,2012-02-21 21:37:31,2012-02-09 20:52:22
5ec514bd2f9b18463886df372ea1412fc61467de...379862ec5a413e636d977a6ea3d618f0b3eafceb,2,44,32,76,26,2012-02-21 21:37:31,2012-02-20 14:17:54
fd6abd0c65b38897da64ef883ed1934d2b2b1a3a...8580830084c8917ac41d18e39dba276b237f598e,1,6,2,8,3,2012-02-13 03:24:47,2012-02-11 18:21:03
5639786f3017711d2e38d2a02714afd0c30d7a37...a7fab08b6e18b63c1fa6be5047205caa88766773,1,1,1,2,1,2012-02-16 20:33:50,2012-02-15 20:36:58
a7fab08b6e18b63c1fa6be5047205caa88766773...68e4b552a1b82343bcefa5d68fa344314b150cc8,1,3,3,6,2,2012-02-16 21:01:31,2012-02-14 23:54:21
86faaf90b34570da938432f5c9847af7592bf8be...93741e4a915fc33a00e6facff88cd27565d10f82,2,93,0,93,6,2012-08-15 18:01:55,2012-08-14 18:37:51
edac1883dc5fbadbc2d7d7cf975ed347eaef0702...3183286238f7b0b4f491963ffc05bb47b35e487d,1,3,3,6,3,2010-06-29 16:31:48,2010-06-28 22:46:22
3183286238f7b0b4f491963ffc05bb47b35e487d...a1463920565c67646507dc573d3f5280fa4cdcf3,2,4,11,15,4,2010-06-29 16:59:56,2010-06-29 16:59:56
492b10766f499b60bdc867c253f36d274ac51538...f217f0e86dc7bacc5dc127982eaadca758b558ce,8,143,2,145,13,2010-07-02 22:43:15,2010-07-02 19:20:47
f217f0e86dc7bacc5dc127982eaadca758b558ce...331a1838b26c3032bec27b66307a9de9b3b11509,2,50,3,53,3,2010-07-02 22:44:34,2010-07-02 19:20:48
492b10766f499b60bdc867c253f36d274ac51538...3c7406d4b595c9e8c8dfcff2739bab9412add5a3,1,54,18,72,17,2010-06-28 17:31:17,2010-06-26 19:23:02
3c7406d4b595c9e8c8dfcff2739bab9412add5a3...8f81449e885ab2b9bac09b5b835314d26f107b3f,1,84,52,136,6,2010-06-28 17:31:17,2010-06-26 19:24:50
8f81449e885ab2b9bac09b5b835314d26f107b3f...bce2c9ae9ff458b6090953ab9f639255f757a104,1,26,0,26,5,2010-06-28 17:31:17,2010-06-26 19:25:37
bce2c9ae9ff458b6090953ab9f639255f757a104...73e25e7cc80e175b5c94678188333e42107fa16e,2,47,13,60,12,2010-06-28 17:31:17,2010-06-26 19:26:37
73e25e7cc80e175b5c94678188333e42107fa16e...030149a4dcd584f6b47221f5b087d081e582d790,2,38,12,50,4,2010-07-14 23:07:34,2010-07-14 22:55:12
492b10766f499b60bdc867c253f36d274ac51538...078e9bce1e8e2484d33d7400ae02c10954fd93ac,1,1,0,1,1,2010-06-28 04:59:32,2010-06-23 19:47:02
a452d148d10a89ae502bc4755c191ab323227ce5...37d3e85912ea13cb1d59022e2bc2ea8cf8bf4876,6,27,28,55,4,2011-09-08 20:50:58,2011-09-07 17:42:39
37d3e85912ea13cb1d59022e2bc2ea8cf8bf4876...7140c22c8e98042053d5ff63c8514f5cdf1cb6ed,1,20,0,20,2,2011-09-08 20:51:15,2011-09-07 17:43:28
7140c22c8e98042053d5ff63c8514f5cdf1cb6ed...7ec0f31eec66b854a2ca856538723dea5f1c0ab7,1,29,25,54,10,2011-09-08 20:51:32,2011-09-07 17:44:07
7ec0f31eec66b854a2ca856538723dea5f1c0ab7...7f6e275bc003e04fca63ae1058bb665078f72d7e,2,45,5,50,4,2011-09-08 20:52:00,2011-09-07 17:44:56
7f6e275bc003e04fca63ae1058bb665078f72d7e...e2b239722a5806521016835f86e6c29c630a0e60,4,96,11,107,22,2011-09-08 20:56:19,2011-09-07 17:46:08
a452d148d10a89ae502bc4755c191ab323227ce5...428c995c4e697457842d00ccab6595e51b088a44,2,763,0,763,2,2011-09-01 22:52:55,2011-09-01 16:54:55
428c995c4e697457842d00ccab6595e51b088a44...93f0d33818e94464a581209b4a102dac59db202a,1,33,2,35,7,2011-09-01 22:52:57,2011-09-01 16:54:56
93f0d33818e94464a581209b4a102dac59db202a...ac86ec0f5e2dbd0d46fb000db1a65f1d2173a02d,1,1,2,3,2,2011-09-27 18:25:02,2011-09-27 17:54:58
ac86ec0f5e2dbd0d46fb000db1a65f1d2173a02d...3c1ed90ec3973404ffcff99103faa5b863889f98,1,37,6,43,8,2011-09-27 18:25:02,2011-09-27 17:54:59
3c1ed90ec3973404ffcff99103faa5b863889f98...fd47d7b94dba1a6f3e38815d364200907ebd68f3,1,10,7,17,1,2011-09-27 18:25:03,2011-09-27 17:55:00
fd47d7b94dba1a6f3e38815d364200907ebd68f3...1d6abac9d573d7a40d3e631253b67a7cb07e0d05,1,3,0,3,3,2011-09-28 22:20:23,2011-09-28 13:48:01
82c41a9bfc843aa2a6e286bcb917b0436714ebd4...db9bdfbeb044f73a01f6325f4ad61413666a2ce0,1,7,0,7,2,2013-10-18 20:53:52,2013-10-18 20:53:05
b421812b487da44b01773ef38789db1122bec61a...2579e1d2936ad4e385ef21e5c346d9853d7faa01,1,13,1,14,3,2011-07-24 18:55:14,2011-07-24 13:35:54
5ec8217eb6c89974fda94808a310aa651577b25d...d45b7f40b30833b0fff87a734044f465a26f40c9,1,1,1,2,1,2011-09-23 22:21:01,2011-09-23 22:21:01
5738c9c21e53356ab5020912116e7f82fd2d428f...97410b27e91593c4096bb16abbace783895a1f62,1,11,13,24,9,2011-10-06 20:54:31,2011-10-06 18:22:21
97410b27e91593c4096bb16abbace783895a1f62...040a655116c9755bbf30acd22c34eecb2f502c6d,7,8,8,16,8,2011-10-06 20:54:32,2011-10-06 18:22:22
040a655116c9755bbf30acd22c34eecb2f502c6d...0d0ff65cea5424a202510fa4e28a461d36032276,1,5,1,6,1,2011-10-06 20:54:32,2011-10-06 18:22:23
0d0ff65cea5424a202510fa4e28a461d36032276...64589a03a8ffb3eb4fb2ff8f416ff638a9aaa439,5,9,13,22,7,2011-10-06 20:54:32,2011-10-06 18:22:24
64589a03a8ffb3eb4fb2ff8f416ff638a9aaa439...6eba6210d9824445c29b75f9c618abbec5184afd,2,61,3,64,6,2011-10-11 16:43:05,2011-10-11 15:53:31
5738c9c21e53356ab5020912116e7f82fd2d428f...0866786b80aa921576ab4e7474c91207111f970f,1,13,1,14,2,2011-09-16 16:22:47,2011-09-16 12:41:57
5738c9c21e53356ab5020912116e7f82fd2d428f...1e5814f3def08452aef4caa703f074ba7d167867,4,742,0,742,7,2011-09-13 08:12:13,2011-09-07 17:36:05
10c6cddd928b24ac6030a172c6c7b46efb32aedc...71039fb9d562731ed700ef072b6fcb18e2478361,2,201,0,201,2,2012-01-08 23:07:40,2012-01-07 11:42:45
71039fb9d562731ed700ef072b6fcb18e2478361...f6a34cfbb4314105c4dadd88eb42da26aef44dfd,1,3,3,6,3,2012-01-08 23:08:03,2012-01-07 11:42:46
f6a34cfbb4314105c4dadd88eb42da26aef44dfd...561b133c2c29ccf5e2aeaa5d6b1da3835e660db8,1,17,1,18,4,2012-01-08 23:08:11,2012-01-07 11:42:47
5ad3e16a6f075deff3cddd6d12ae89fafb0c718d...e6a1c43aafa8b221e05e57132549dcb3cd7866cf,2,6,6,12,4,2012-05-11 15:39:33,2012-05-10 18:59:04
e147e9693ace9f7c6dafd4095d3cde80d047e787...72d5e74e991937e24afb943eee74ca929e7f00ab,1,55,16,71,7,2012-02-21 23:16:34,2012-02-21 23:16:34
07b257f94035133376538c54620b43a14e28dcd3...337da8d2b0b8a8a86f0aa969bba2756126d6c090,1,41,0,41,1,2012-02-27 06:02:54,2012-02-27 01:55:19
337da8d2b0b8a8a86f0aa969bba2756126d6c090...07a40062aebc184f5aa1d6750fe80ab6fe120cc8,1,3,1,4,1,2012-02-27 06:02:56,2012-02-27 01:55:20
07a40062aebc184f5aa1d6750fe80ab6fe120cc8...5fb3cf23170f7dc43568d0234c338d67372c97cc,1,6,2,8,1,2012-02-27 06:02:57,2012-02-27 01:55:21
5fb3cf23170f7dc43568d0234c338d67372c97cc...e607b79fb14f2196f7ea46d2115f21c548972e78,1,47,5,52,6,2012-02-27 06:02:58,2012-02-27 01:55:22
d365a432271d2f6384cda9c37fb2fe463bdc2850...135dadef712f0c4cf884940e751024c831937904,2,72,8,80,5,2012-04-05 20:35:57,2012-03-30 23:07:12
84ab7b6fc7e190ac1c1d0bc5b7c48befa42eff3c...119550af0c9f3cdd920e8d0e04b68b40b8485fdc,1,12,31,43,11,2006-10-26 03:01:57,2006-10-26 02:43:47
119550af0c9f3cdd920e8d0e04b68b40b8485fdc...d9c04ba3ddd0945ef18657a2a373c5edfe86ef7c,2,4,6,10,4,2006-10-26 05:35:20,2006-10-26 04:33:07
d9c04ba3ddd0945ef18657a2a373c5edfe86ef7c...0074aba1c0d3b073c635fdc1d5754dc6a6b6b7b9,1,68,8,76,7,2006-10-26 07:15:01,2006-10-26 03:44:49
0074aba1c0d3b073c635fdc1d5754dc6a6b6b7b9...0ac3056850394723c9b407754b44d3d37f1dcc3f,1,21,4,25,4,2006-10-26 08:15:42,2006-10-26 08:15:42
83877f8d92b2050eb668dc3351277e57779a8f05...ec1e46897329317d7a9996264d7e999f9a68e307,1,25,4,29,7,2006-11-01 01:20:58,2006-10-25 22:50:26
83877f8d92b2050eb668dc3351277e57779a8f05...38c5afa87e24756f0465e24c2b7018de62e4bfc1,1,8,3,11,4,2006-10-31 03:39:12,2006-10-30 16:25:36
38c5afa87e24756f0465e24c2b7018de62e4bfc1...bcc785f611dc6084be75999a3b6bafcc950e21d6,1,11,1,12,3,2006-10-31 03:39:12,2006-10-30 16:28:59
6b1f8c32b1a602734f14b9cf8a9f59a767752677...f8290630cb900fc5581e91a4cc055d2fba121db0,1,2,2,4,2,2006-11-18 19:09:46,2006-11-18 02:56:52
f8290630cb900fc5581e91a4cc055d2fba121db0...f847c07b9ac82ff3d0da0efb3bed75bc17489a17,1,1,1,2,1,2006-11-18 19:09:55,2006-11-18 05:05:11
f847c07b9ac82ff3d0da0efb3bed75bc17489a17...a6e8a7677055e092424db42c044774bc6dbd74f6,2,2,2,4,2,2006-11-18 19:40:00,2006-11-18 12:07:06
a6e8a7677055e092424db42c044774bc6dbd74f6...38f4d138ee101f3f238ffd43fac76f5b951516c1,1,1,1,2,1,2006-11-18 19:40:07,2006-11-18 12:06:56
38f4d138ee101f3f238ffd43fac76f5b951516c1...3dad11bfdb9363bade57ca2caadef1883767e9d3,1,5,2,7,2,2006-11-18 19:40:11,2006-11-18 12:07:09
3dad11bfdb9363bade57ca2caadef1883767e9d3...fd931411c0635ca5e7968bd2981457056b49062b,3,73,1,74,3,2006-11-18 22:04:45,2006-11-18 14:15:49
fd931411c0635ca5e7968bd2981457056b49062b...e3d457fb59f71dd40d24c82f48625a24492907d4,2,16,5,21,3,2006-11-18 22:04:51,2006-11-18 19:44:08
e3d457fb59f71dd40d24c82f48625a24492907d4...198a4f4ff0694cb5b906278fc1c2b6e7db4d2737,1,14,3,17,1,2006-11-19 00:29:46,2006-11-18 23:30:15
198a4f4ff0694cb5b906278fc1c2b6e7db4d2737...6c96c0f1940b0247530d21b10042d16bf1e7b769,2,19,2,21,3,2006-11-20 02:44:23,2006-11-19 05:39:17
6c96c0f1940b0247530d21b10042d16bf1e7b769...ef06b91804ff5a626e265c6d9080bbc0e7924e88,1,19,19,38,3,2006-11-20 02:44:29,2006-11-19 06:13:33
6b1f8c32b1a602734f14b9cf8a9f59a767752677...e9195b584f6ad49b637b56be0705a7362a95d692,1,3,1,4,1,2006-11-17 08:09:52,2006-11-15 06:18:31
82dca84871637ac9812c0dec27f56d07cfba524c...a990999e0df3d0518a2fef60feb1ec269e36ada6,1,1,1,2,1,2006-12-16 07:50:27,2006-12-14 15:25:23
a990999e0df3d0518a2fef60feb1ec269e36ada6...a2e88b35808a8c0334f169c9cbb2301764fb9e5a,1,1,1,2,1,2006-12-16 07:51:22,2006-12-14 14:17:53
a2e88b35808a8c0334f169c9cbb2301764fb9e5a...9abaa7f033283f84ba8372192f9d4a165fb09ce4,2,95,0,95,2,2006-12-16 13:15:28,2006-12-16 11:22:18
9abaa7f033283f84ba8372192f9d4a165fb09ce4...b1bfcae438adb485bb66e2f59396373809e346e6,1,17,9,26,2,2006-12-16 20:31:45,2006-12-16 20:31:45
82dca84871637ac9812c0dec27f56d07cfba524c...aef4e921a01350600071bf18fc2706b8fca55e47,1,135,193,328,92,2006-12-16 06:39:47,2006-12-15 18:59:54
aef4e921a01350600071bf18fc2706b8fca55e47...b9c8518722687fae6182162f9a244915ba94db02,7,51,882,933,43,2006-12-16 13:17:17,2006-12-16 07:58:07
b9c8518722687fae6182162f9a244915ba94db02...3289e86e1eb4f38b5c8dfd2f44b4486d2755d6d6,5,29,29,58,24,2006-12-16 13:17:56,2006-12-16 07:58:08
5b85143ba548c6c0c35df5e606ee3568c55ca0da...c902c9a608c1b727160d6fbb04fa363d9418cd00,1,2,0,2,2,2006-12-21 01:59:22,2006-12-21 01:32:21
c902c9a608c1b727160d6fbb04fa363d9418cd00...7dda22e3174dd6e4b8b2f60fb0ad1e8f1be912ad,1,8,5,13,5,2006-12-21 04:36:42,2006-12-21 04:18:07
7dda22e3174dd6e4b8b2f60fb0ad1e8f1be912ad...caba139d432c420f853c352987cf29cefafc2b84,1,1,1,2,1,2006-12-22 04:33:06,2006-12-22 02:20:55
caba139d432c420f853c352987cf29cefafc2b84...64646d11773774193093df96020d3fcb0df4a270,2,3,3,6,3,2006-12-22 04:33:49,2006-12-22 02:30:17
64646d11773774193093df96020d3fcb0df4a270...9e11554917d391c18e043bc0b38ee0377e69568e,1,1,2,3,1,2006-12-22 06:12:42,2006-12-22 06:10:56
9e11554917d391c18e043bc0b38ee0377e69568e...f79c73ce9ce5d8bd1b4abaf3fc384aa8daa169ef,2,16,1,17,3,2006-12-22 06:44:04,2006-12-21 14:13:02
f79c73ce9ce5d8bd1b4abaf3fc384aa8daa169ef...95f2fb7d9f84779bf036bb748e245c91bc572840,1,6,1,7,1,2006-12-22 06:47:49,2006-12-21 14:26:35
5b85143ba548c6c0c35df5e606ee3568c55ca0da...2ff81662c2fb2679f841c09a28bd80c0a63011ac,2,29,0,29,2,2006-12-21 01:22:10,2006-12-18 09:18:16
2ff81662c2fb2679f841c09a28bd80c0a63011ac...55dd55263b6d27aa8daa77bd69f5ea990b66c7a1,2,38,0,38,4,2006-12-21 01:22:10,2006-12-18 09:36:16
55dd55263b6d27aa8daa77bd69f5ea990b66c7a1...63049292e083faf80e033eba4fa43efdbac3acad,3,52,9,61,7,2006-12-21 01:22:10,2006-12-19 01:25:28
63049292e083faf80e033eba4fa43efdbac3acad...e29cb53a8b6aa1256221207b14a1c8ef72f69d9f,1,9,3,12,4,2006-12-21 01:22:10,2006-12-19 06:07:45
e29cb53a8b6aa1256221207b14a1c8ef72f69d9f...2ecd2bbcbe5335c1d9209b6ce28513e4e9d3491b,3,19,20,39,4,2006-12-21 01:22:10,2006-12-19 08:14:04
2ecd2bbcbe5335c1d9209b6ce28513e4e9d3491b...4264dc15e198bf9e9a2bb4ee897dd8e3eaabca47,4,178,0,178,4,2006-12-21 01:22:10,2006-12-19 08:23:12
1295228d1fdda17c2ef62e712649c962c3da5eb7...883d60fa97c6397450fb129634054e0a6101baac,6,44,24,68,16,2007-01-09 11:04:04,2007-01-08 00:59:54
c03f77573ac4db7f549948c4c0de4fa3c9eb545c...696b1b507f8ff9e80a2edc4eced59ca8cdda920e,1,2,1,3,1,2007-01-13 20:26:13,2007-01-13 20:26:13
c03f77573ac4db7f549948c4c0de4fa3c9eb545c...f7e68b2967182f14547125d1369f37ad4d83187e,1,55,27,82,21,2007-01-13 18:10:20,2007-01-13 01:32:38
f7e68b2967182f14547125d1369f37ad4d83187e...a731ec5eb827767e0f054641ab1eacc632113c59,3,162,0,162,3,2007-01-13 18:10:20,2007-01-13 09:20:53
a731ec5eb827767e0f054641ab1eacc632113c59...5ac2715f2eaacc7c76ac03680a0d7a16a30946f2,2,15,6,21,7,2007-01-13 21:33:07,2007-01-13 21:33:07
5ac2715f2eaacc7c76ac03680a0d7a16a30946f2...c34c6008bcf2c66e17a97acc89be1144a6216f3f,1,137,36,173,11,2007-01-13 21:34:44,2007-01-13 21:34:44
9299c4f147bcff603eef187eb04fe38153571d30...c0b4a003e4477b78d42441b8c2eec463467f313c,1,3,0,3,1,2007-01-31 22:53:51,2007-01-31 22:53:51
c0b4a003e4477b78d42441b8c2eec463467f313c...bfcd4ca3da81922b170d5179212e243309ec4c88,1,1,1,2,1,2007-01-31 23:41:45,2007-01-31 23:41:27
bfcd4ca3da81922b170d5179212e243309ec4c88...8c4e4ef0f575cd60fb4bb6a70305fcb0ed85da6a,1,1,1,2,1,2007-01-31 23:41:49,2007-01-31 23:06:21
8c4e4ef0f575cd60fb4bb6a70305fcb0ed85da6a...e4b0e4ab8ee68df0fa99100640ed5cb54b736141,1,8,2,10,3,2007-02-01 09:10:15,2007-02-01 09:08:41
e4b0e4ab8ee68df0fa99100640ed5cb54b736141...92cf95696f0837b555d90fe6ef0ffd2b8348b4d0,1,1,1,2,1,2007-02-02 05:34:54,2007-02-01 17:30:28
92cf95696f0837b555d90fe6ef0ffd2b8348b4d0...6124aee5d903150a649a75bf51a68b4bdfd67140,2,18,10,28,10,2007-02-02 05:36:47,2007-02-01 17:31:26
6124aee5d903150a649a75bf51a68b4bdfd67140...08f1675059c09b7ee0b8ed16bc059472d07bb9e5,1,1,1,2,1,2007-02-02 05:47:34,2007-02-02 05:47:34
08f1675059c09b7ee0b8ed16bc059472d07bb9e5...fe55851624bbdb4f08e17e27ef8197ed610ac586,1,15,1,16,2,2007-02-02 05:48:26,2007-02-01 17:33:23
fe55851624bbdb4f08e17e27ef8197ed610ac586...11cf8801d7d58cc1532f11a827ce130c10d149be,1,11,6,17,5,2007-02-02 05:49:28,2007-02-01 22:29:33
11cf8801d7d58cc1532f11a827ce130c10d149be...d271fd5311da7e475b02ef11507155fa912f0553,1,8,0,8,1,2007-02-02 05:50:16,2007-02-01 23:07:24
d271fd5311da7e475b02ef11507155fa912f0553...1e5db3075ae1f22cbffc273321e94b60d5f23927,1,4,0,4,1,2007-02-02 05:50:46,2007-02-01 23:21:49
1e5db3075ae1f22cbffc273321e94b60d5f23927...22600a2515cc92f66fd76f2aae05637697c713b9,1,5,5,10,5,2007-02-02 05:51:36,2007-02-01 21:12:26
22600a2515cc92f66fd76f2aae05637697c713b9...7a8c9ec1a95a368c5f32d430058d67109feccfee,1,23,20,43,9,2007-02-02 06:03:42,2007-02-02 05:05:55
7a8c9ec1a95a368c5f32d430058d67109feccfee...859607dfe04260d55f5901974fdd660aebc427fa,2,43,1,44,6,2007-02-02 06:06:36,2007-02-02 05:06:08
859607dfe04260d55f5901974fdd660aebc427fa...625e9421df6317a015abeb8d51c6dbb937d99880,1,1,2,3,1,2007-02-02 06:21:19,2007-02-01 20:52:22
625e9421df6317a015abeb8d51c6dbb937d99880...54a15a8df269315adf7110a87391bd5bef7e90f0,1,4,1,5,2,2007-02-02 06:22:51,2007-02-01 20:52:27
54a15a8df269315adf7110a87391bd5bef7e90f0...072db2789c21314cfbf43215186341d0b2b47523,1,16,15,31,14,2007-02-02 06:24:17,2007-02-01 20:52:33
072db2789c21314cfbf43215186341d0b2b47523...c715f783696346ff325dbdb88a5db69825f0d672,1,12,0,12,1,2007-02-02 06:27:47,2007-02-01 20:52:38
c715f783696346ff325dbdb88a5db69825f0d672...aacd404e775ad73188ae9157041d7cc530d5625c,2,8,6,14,7,2007-02-02 06:45:04,2007-02-02 06:25:30
aacd404e775ad73188ae9157041d7cc530d5625c...b6936205e73c058784288d21d1937e5bba26b91b,1,2,1,3,1,2007-02-03 05:18:59,2007-02-02 13:10:25
b6936205e73c058784288d21d1937e5bba26b91b...0d18e41e008e9ac1f371d090e2e1b85481221796,1,2,3,5,2,2007-02-03 05:18:59,2007-02-02 23:56:08
0d18e41e008e9ac1f371d090e2e1b85481221796...3cf8b462d2dbe78233bba5c0765ecaa2c6b6cd99,1,16,1,17,2,2007-02-03 05:33:18,2007-02-02 08:00:03
3cf8b462d2dbe78233bba5c0765ecaa2c6b6cd99...953202a3fd68f84210cfe9bf102c534ac3ee40e4,1,18,18,36,2,2007-02-03 06:19:17,2007-02-03 06:19:17
953202a3fd68f84210cfe9bf102c534ac3ee40e4...bf3478de973607ebe5b7689fa76e05c3f344aabd,1,7,8,15,4,2007-02-03 06:55:07,2007-02-03 06:55:07
bf3478de973607ebe5b7689fa76e05c3f344aabd...505739f6c0c67b7426ffbc723734c794b0a810d9,1,2,2,4,1,2007-02-03 07:17:34,2007-02-03 07:17:34
505739f6c0c67b7426ffbc723734c794b0a810d9...5f856dd47dacb30fb9f605b4b7e1fa577ada7d26,1,8,2,10,5,2007-02-03 20:54:49,2007-01-19 19:51:29
1349f8771310987dd07b679a512e46e1b17e2b8d...8371234ecaaf6e14fe3f2082a855eff1bbd79ae9,2,98,1,99,2,2006-12-13 17:13:21,2006-12-13 10:42:44
8371234ecaaf6e14fe3f2082a855eff1bbd79ae9...0c4e95d083f77de03a64b65f5633ed0ba082a26e,1,8,1,9,1,2006-12-13 17:33:08,2006-12-13 17:32:40
0c4e95d083f77de03a64b65f5633ed0ba082a26e...7ef0435088f41165ece95b6f226d3c15438505a5,1,14,0,14,1,2006-12-13 17:41:18,2006-12-13 08:58:28
7ef0435088f41165ece95b6f226d3c15438505a5...411fb8baa6862b76f7bdd9fc0d5844855a4db589,1,30,5,35,1,2006-12-13 18:04:01,2006-12-13 18:03:39
411fb8baa6862b76f7bdd9fc0d5844855a4db589...37adac765a469f8f8495e2befe7afeda65a2b272,2,22,1,23,3,2006-12-13 18:30:11,2006-12-13 18:30:11
1349f8771310987dd07b679a512e46e1b17e2b8d...f2dd1c9adfe961ea611545b018bc67e5d83ee3db,2,3,5,8,4,2006-12-13 10:03:11,2006-12-13 09:33:43
8fcf1ad9c68e15d881194c8544e7c11d33529c2b...9d7f73d43fa49d0d2f5a8cfcce9d659e8ad2d265,1,1,0,1,1,2006-02-25 20:03:18,2006-02-25 11:20:13
9d7f73d43fa49d0d2f5a8cfcce9d659e8ad2d265...87475f4dfce96b040fffbaefda9a4daa789786b2,1,113,37,150,26,2006-02-26 22:43:55,2006-02-26 01:48:33
87475f4dfce96b040fffbaefda9a4daa789786b2...6b3e21d6031e1e8df8b01cba5ab7374c4b721257,1,44,29,73,30,2006-02-26 22:45:05,2006-02-26 03:02:05
6b3e21d6031e1e8df8b01cba5ab7374c4b721257...f60d46911dd0c0526339b039ced8772773bd3dea,1,42,1,43,3,2006-02-26 22:45:22,2006-02-26 21:09:12
f60d46911dd0c0526339b039ced8772773bd3dea...8f22562c6bfa413c621517dd654b58ed39e98045,2,32,0,32,4,2006-02-26 22:55:13,2006-02-26 10:22:27
8f22562c6bfa413c621517dd654b58ed39e98045...e17512f3de13b6af24672822b703ee54aa057582,1,27,3,30,6,2006-02-26 23:02:45,2006-02-26 10:22:27
e17512f3de13b6af24672822b703ee54aa057582...3c0b7511cdadd04690208d9772fdbd6a86496229,1,1,1,2,1,2006-02-26 23:04:59,2006-02-26 10:22:27
3c0b7511cdadd04690208d9772fdbd6a86496229...962554c616e30991553c8497ed1e7c2a415fa84d,6,7,7,14,7,2006-02-26 23:06:45,2006-02-26 15:13:46
962554c616e30991553c8497ed1e7c2a415fa84d...231af8322ac5313243bc1e8beac8dfd9ff95051d,1,116,37,153,14,2006-02-26 23:10:37,2006-02-26 20:34:51
0cd5da56fa1287a368bb7e0d0e1379591d13f239...0b8b051cd50cb423476ab7a8aa5853dc601b721d,1,4,1,5,2,2006-03-03 00:42:39,2006-03-02 22:38:44
0b8b051cd50cb423476ab7a8aa5853dc601b721d...d320a5437f8304cf9ea3ee1898e49d643e005738,1,18,1,19,4,2006-03-03 01:16:08,2006-03-03 01:14:00
d320a5437f8304cf9ea3ee1898e49d643e005738...b4019f045646b1770a80394da876b8a7c6b8ca7b,1,39,4,43,9,2006-03-03 05:08:33,2006-03-03 05:04:05
b4019f045646b1770a80394da876b8a7c6b8ca7b...b8310152bc5622e4d449e3113ba4edec8fd08087,1,2,0,2,2,2006-03-03 05:13:24,2006-03-03 05:13:24
9201c707426b3dc0c894775416f576c25c008d46...0aee3d6d4e2ba3278ad0f789fc7c0a9742fc5a07,2,2,0,2,2,2006-03-05 19:26:18,2006-03-05 12:25:43
0aee3d6d4e2ba3278ad0f789fc7c0a9742fc5a07...8911db70f8b84b2e96b328eeca9e5d7701c22479,2,21,0,21,2,2006-03-05 19:32:49,2006-03-05 16:14:31
8911db70f8b84b2e96b328eeca9e5d7701c22479...872d001f7f576b2d32f6278dc265d6449787b714,2,6,0,6,2,2006-03-05 21:33:13,2006-03-05 21:18:19
872d001f7f576b2d32f6278dc265d6449787b714...ea5ed3abce724725360be88663cec1add7547d46,1,11,7,18,9,2006-03-05 21:35:41,2006-03-05 17:53:52
ea5ed3abce724725360be88663cec1add7547d46...ea4c7f9bf69e781dd0cd88d2bccb2bf5cc15c9a7,2,148,18,166,17,2006-03-05 22:49:58,2006-03-05 11:03:51
ea4c7f9bf69e781dd0cd88d2bccb2bf5cc15c9a7...a0fb95e3199810268cfe88c7c4ff0d9958e07062,2,4,6,10,3,2006-03-06 00:02:44,2006-03-05 22:46:36
a0fb95e3199810268cfe88c7c4ff0d9958e07062...cfea8e077b9a8956080688ab40e9efd812c2a0c5,2,20,5,25,3,2006-03-06 00:02:44,2006-03-05 22:48:01
cfea8e077b9a8956080688ab40e9efd812c2a0c5...8752d11d60e8f48b6e242e7f504c8e8fd7eabb92,3,97,83,180,3,2006-03-06 00:02:44,2006-03-05 11:13:34
8752d11d60e8f48b6e242e7f504c8e8fd7eabb92...604c86d15bb319a1e93ba218fca48ce1c500ae52,1,1,1,2,1,2006-03-06 00:02:44,2006-03-05 22:43:56
604c86d15bb319a1e93ba218fca48ce1c500ae52...bd494fc76be09ab61f8285f1299e2474b0554a81,8,10,10,20,8,2006-03-06 01:02:02,2006-03-06 00:00:48
bd494fc76be09ab61f8285f1299e2474b0554a81...5fcab3d7db9bb29f3897a593da69d6ae83a405ef,1,4,2,6,4,2006-03-06 06:01:28,2006-03-06 02:43:53
5fcab3d7db9bb29f3897a593da69d6ae83a405ef...92a903acfd0904e6dd6d18112428429938783d19,1,44,37,81,9,2006-03-06 06:09:15,2006-03-06 06:07:37
92a903acfd0904e6dd6d18112428429938783d19...8ad02bc9649b0a69a0c09a23bd177a070b57af7d,2,2,2,4,2,2006-03-06 06:10:26,2006-03-06 06:10:26
8ad02bc9649b0a69a0c09a23bd177a070b57af7d...ce5b6e711148d035478fcb18773a0abcef302d7e,1,9,0,9,1,2006-03-06 06:37:15,2006-03-06 06:37:15
9201c707426b3dc0c894775416f576c25c008d46...473ab1659bc6b2483544e404661e4349dc249355,1,19,1,20,6,2006-03-05 19:22:01,2006-03-05 19:20:12
0ed49a3ed9ab9747f7916c928d50aa0bf4d2c81d...a13ba129cdc66b60eef177696084ff80034069b7,1,16,9,25,4,2006-04-09 18:11:19,2006-04-09 13:43:17
a13ba129cdc66b60eef177696084ff80034069b7...77882f60d9df2fd410ba7d732b01738315643c05,5,11,81,92,11,2006-04-10 22:57:24,2006-04-10 22:57:24
0ed49a3ed9ab9747f7916c928d50aa0bf4d2c81d...5f1c3f07b7f4a8436c7773b8e7a04998190c125e,4,224,204,428,22,2006-04-09 08:35:13,2006-04-09 08:11:11
5f1c3f07b7f4a8436c7773b8e7a04998190c125e...52b70d56bd23811003a72866cc23a0a44b9da1b7,1,31,1,32,7,2006-04-09 08:59:03,2006-04-09 08:59:03
0ed49a3ed9ab9747f7916c928d50aa0bf4d2c81d...3381c790e5ca04326d26e1dd9ff482961c6e425b,4,18,18,36,12,2006-04-09 06:37:21,2006-04-09 00:05:58
ba3c93743a8151e3663e1fda6b3cb165d8373ddf...454a35b847abe22885855fac79bde5c46ba48afe,1,60,0,60,1,2006-04-06 03:48:40,2006-04-06 03:32:19
454a35b847abe22885855fac79bde5c46ba48afe...b116b297a80b54632256eb89dd22ea2b140de622,1,466,0,466,1,2006-04-07 09:06:18,2006-03-03 01:19:29
b116b297a80b54632256eb89dd22ea2b140de622...9760662f1a7a06516ca249a73e5c1a6fb6c0e26e,1,111,0,111,1,2006-04-07 09:07:40,2006-04-07 09:07:40
e72ee5ebc8de90ad6de8f9318f75ebd45b2ca001...f1b8629453f6a0aeaee7072af7d900f3054a9aca,1,14,12,26,14,2006-05-20 10:15:28,2006-05-15 15:13:14
f1b8629453f6a0aeaee7072af7d900f3054a9aca...8974c6f93e62cd4b6ffe93562a6569b8920a89a3,1,26,26,52,25,2006-05-26 12:25:26,2006-05-24 07:57:40
8974c6f93e62cd4b6ffe93562a6569b8920a89a3...b5e096337c5516fece2c21d813c8534ac541f2a0,1,1,1,2,1,2006-05-26 12:25:26,2006-05-26 07:07:15
b5e096337c5516fece2c21d813c8534ac541f2a0...e54be9e30ffb8ab21fe9ef740991940f4d00e79c,1,8,8,16,6,2006-05-26 12:34:30,2006-05-26 12:34:30
6d80f3ce78e13cc91bedf509d6520151ec1b0df5...63b791912112a0f8cbd793a943bc40c88cad6e51,1,66,5,71,15,2006-05-20 11:31:52,2006-05-20 11:31:52
63b791912112a0f8cbd793a943bc40c88cad6e51...45a9d5054d69f0c662b6a28e60934f63fa4ee9ef,1,38,26,64,18,2006-05-20 12:56:27,2006-05-20 12:56:27
45a9d5054d69f0c662b6a28e60934f63fa4ee9ef...3ea06f9f7e10463ee52b7ed8cbe3b2728c9e662e,1,101,6,107,10,2006-05-24 00:16:03,2006-05-24 00:16:03
3ea06f9f7e10463ee52b7ed8cbe3b2728c9e662e...1902c2705e41da499fd7ed964e747cf48a0745dd,1,69,19,88,11,2006-05-25 11:25:13,2006-05-25 11:25:13
1902c2705e41da499fd7ed964e747cf48a0745dd...60f7a7dc4904ba4baab44b70e2675a01e6172f54,1,59,309,368,30,2006-05-26 00:43:47,2006-05-26 00:43:47
60f7a7dc4904ba4baab44b70e2675a01e6172f54...5864c08f897425ff186fcab00ecc81166e783bd5,1,2,3,5,3,2006-05-26 12:22:48,2006-05-26 12:22:48
5864c08f897425ff186fcab00ecc81166e783bd5...164ff275adf2e212ef21632c21eef191a1c7420d,1,150,2,152,10,2006-05-29 09:50:02,2006-05-29 09:50:02
164ff275adf2e212ef21632c21eef191a1c7420d...4e7d677949e8ee7617e42f10c1ddf5cd2adee3a1,1,144,52,196,36,2006-05-30 11:33:07,2006-05-30 11:33:07
935e714204fe167aa6172a733e7131ee5b4577f4...dcb3450fd8785d76dd3d25aa49be66190aa5e7f3,3,7,10,17,8,2006-05-04 05:06:45,2006-05-04 00:21:08
e098c6f82a28efe1488c7eb1bed4e92f76dd2afd...8f5ff31f8e74ac2f72c3c415beb2639bc36f7cb7,1,26,24,50,4,2006-05-03 23:26:29,2006-05-03 12:41:03
d01d8c6782850c18d62676dae3c72ad73be1e52e...46b8dec038be1125153e9fc816a1e1f0a9d2de77,1,2,2,4,2,2006-04-05 00:14:06,2006-04-04 23:01:03
fc4c4cd21c783b6dc387002c6e018d26f7405e9f...42277bc81ce2f4450fe08239e4db34516f879c1d,1,1,5,6,1,2006-04-05 00:13:25,2006-03-30 12:06:15
fc4c4cd21c783b6dc387002c6e018d26f7405e9f...f23fc773a2acce9966ac7fa267818d5be55667fa,1,136,102,238,23,2006-04-04 21:53:43,2006-04-04 01:53:15
0dbc4e89bb3ddaaa4230f91d5f59b08f3d33e91b...024701f1d88d79f3777bf45c82437f40a80b6eaa,1,6,4,10,4,2006-02-12 21:01:54,2006-02-12 21:01:54
024701f1d88d79f3777bf45c82437f40a80b6eaa...c5e09c1fbec5dc1c15bcfe21e1a600f9e4b4e419,1,2,1,3,1,2006-02-12 21:05:53,2006-02-12 21:05:53
c1fe2fe4fe685e0587c3949f953aab726de88994...576cfc86fc321688aec0bc7359fb1097e5717631,1,10,2,12,1,2006-01-06 22:27:47,2006-01-06 20:54:41
576cfc86fc321688aec0bc7359fb1097e5717631...34c99da2a4324e9b4a9d3f59e8cd7114090bd22a,1,1,0,1,1,2006-01-06 22:27:47,2006-01-06 20:52:27
34c99da2a4324e9b4a9d3f59e8cd7114090bd22a...476e801111698ac5df6821f389c81abc017fc0c9,1,2,0,2,1,2006-01-07 02:53:16,2006-01-07 02:53:16
476e801111698ac5df6821f389c81abc017fc0c9...7d0e65b892ff0adf2ba6626bbe7cdfc723a8b702,16,0,441,441,17,2006-01-07 03:18:12,2006-01-07 03:18:12
7d0e65b892ff0adf2ba6626bbe7cdfc723a8b702...3be7098ce444395959c856de1eb9312550193aac,1,1,2,3,1,2006-01-07 08:29:48,2006-01-07 08:29:48
3be7098ce444395959c856de1eb9312550193aac...8f1d2e6f49ee51ac062ab38337a6a70dd1998def,10,21,12,33,18,2006-01-07 18:51:06,2006-01-07 09:33:54
8f1d2e6f49ee51ac062ab38337a6a70dd1998def...3ac0ebbba4d2d47ca2f4a674afead830f76ca256,1,1,1,2,1,2006-01-07 23:11:11,2006-01-07 23:11:11
3ac0ebbba4d2d47ca2f4a674afead830f76ca256...36071af305d1491087661b8ad60ef57bf4d19394,1,1,1,2,1,2006-01-08 02:13:44,2006-01-08 00:38:43
36071af305d1491087661b8ad60ef57bf4d19394...5f815e5922eb31c5826e5f5f21e83d1f6f338ed1,1,4,2,6,1,2006-01-08 02:17:38,2006-01-08 00:39:16
5f815e5922eb31c5826e5f5f21e83d1f6f338ed1...013049c985e4095106e545559c17bc594d56468d,1,1,0,1,1,2006-01-08 04:45:11,2006-01-08 04:45:11
013049c985e4095106e545559c17bc594d56468d...6f2eacfeb2c67a7e05f98df2288d7893d3368c8e,1,4,1,5,2,2006-01-08 05:26:30,2006-01-08 05:26:30
5df466c507ee2dd81c2e9002c3fedf3536cde0dc...026351a03507dc3a2e89e068c01234dc55914df2,1,1,1,2,1,2006-01-06 05:02:01,2005-12-30 16:23:17
026351a03507dc3a2e89e068c01234dc55914df2...03febf99bc77001af6709ee1c17d3dc5e71e8990,2,169,124,293,14,2006-01-08 05:33:51,2006-01-07 08:48:04
03febf99bc77001af6709ee1c17d3dc5e71e8990...9518eb262980d5048ef71e4450ef2cf78d7df6b5,1,22,0,22,4,2006-01-08 05:34:02,2006-01-04 21:31:25
9518eb262980d5048ef71e4450ef2cf78d7df6b5...657907e76e298cac31845dadda2c71b431d9e712,1,5,8,13,4,2006-01-08 05:34:02,2006-01-07 22:32:09
657907e76e298cac31845dadda2c71b431d9e712...0907fedbeea12aa78a66b9d765b0e618a180b6ff,1,3,2,5,3,2006-01-08 05:34:02,2006-01-07 22:31:56
0907fedbeea12aa78a66b9d765b0e618a180b6ff...9eafb7bad1a1982f1c01f4c7394fe7bc8e6ea3ae,1,2,2,4,2,2006-01-08 05:34:03,2006-01-07 22:32:07
9eafb7bad1a1982f1c01f4c7394fe7bc8e6ea3ae...78c2cff61f87d43c1f4ef5a03547f093c4c6e0c9,1,28,6,34,6,2006-01-08 05:34:03,2006-01-07 22:17:58
78c2cff61f87d43c1f4ef5a03547f093c4c6e0c9...f8f9c73c7d835ec1e5b665c66623aed49fcd4888,3,17,1,18,4,2006-01-08 05:43:01,2006-01-08 02:52:42
f8f9c73c7d835ec1e5b665c66623aed49fcd4888...b21c31c9a5edfd90d6f85481517f979352da4eed,2,30,2,32,6,2006-01-08 05:43:02,2005-12-23 01:27:40
b21c31c9a5edfd90d6f85481517f979352da4eed...77f1055ca7728d3ac1e7d3ce9f29c0c6d4f842c5,1,13,7,20,5,2006-01-08 08:54:30,2006-01-08 00:40:33
77f1055ca7728d3ac1e7d3ce9f29c0c6d4f842c5...b91db2707a4a3c48982c5fa052cf7ee3da8616cf,1,53,0,53,1,2006-01-08 08:54:31,2006-01-08 00:38:15
b91db2707a4a3c48982c5fa052cf7ee3da8616cf...e77f489edf3865dbcfd329461355523bb3c21075,1,53,0,53,1,2006-01-08 20:33:13,2006-01-08 00:39:48
631ba3090714a9786457dd39da8ed50925715432...3cab3594e9cfd5e98cbcb819b1bed91a7b3a974b,1,12,0,12,1,2005-11-11 19:27:03,2005-11-11 19:27:03
3cab3594e9cfd5e98cbcb819b1bed91a7b3a974b...5f3aa197ac03eabbc45046cd3b9dbcfbda0426d9,17,71,71,142,68,2005-11-11 23:12:29,2005-11-11 01:12:27
5f3aa197ac03eabbc45046cd3b9dbcfbda0426d9...46e651743ae5c0938c4ff076a0453ecc9611a520,1,69,61,130,31,2005-11-12 05:14:34,2005-11-11 23:53:07
46e651743ae5c0938c4ff076a0453ecc9611a520...857f26d2f41e16170e48076758d974820af685ff,2,7,0,7,2,2005-11-12 05:14:36,2005-11-11 23:54:55
857f26d2f41e16170e48076758d974820af685ff...e9af60c88bbd152ad04640ddb93dc927fc7a10b6,1,2,2,4,2,2005-11-12 05:14:39,2005-11-11 23:55:36
e9af60c88bbd152ad04640ddb93dc927fc7a10b6...6fd72e39af8a69615d32c3fd4d5fe0788f54a2ea,1,2,2,4,2,2005-11-12 05:14:46,2005-11-12 00:49:59
6fd72e39af8a69615d32c3fd4d5fe0788f54a2ea...f7d24bbefb06c40f7738f471dda561ab45496d24,1,16,4,20,3,2005-11-12 05:18:17,2005-11-08 06:03:46
f7d24bbefb06c40f7738f471dda561ab45496d24...cb93c19365760d939f05d9a3c2ef4499f0d5ce16,2,13,4,17,7,2005-11-12 05:18:17,2005-11-10 04:38:33
cb93c19365760d939f05d9a3c2ef4499f0d5ce16...e433705dd4dc52c45e5d82b615f07b5a4b27f185,2,8,2,10,3,2005-11-12 05:18:18,2005-11-10 04:53:54
e433705dd4dc52c45e5d82b615f07b5a4b27f185...fd66dbf5297a4badec8c2accf8a0f9bd72e3f693,1,6,0,6,2,2005-11-12 05:18:18,2005-11-11 03:30:23
fd66dbf5297a4badec8c2accf8a0f9bd72e3f693...c283ab21c1b8198fe2297cca678aa2fa3dd76e75,3,581,1,582,4,2005-11-12 05:19:10,2005-11-09 01:22:40
c283ab21c1b8198fe2297cca678aa2fa3dd76e75...2a444781b1a9de1eb8e2cd24eea36a0f635519fe,1,47,0,47,1,2005-11-12 05:19:10,2005-11-09 01:23:55
2a444781b1a9de1eb8e2cd24eea36a0f635519fe...523114820233f87b663513ee0bf52a6f7fdd9cfc,1,1,0,1,1,2005-11-12 05:19:10,2005-11-09 01:24:51
523114820233f87b663513ee0bf52a6f7fdd9cfc...b4ad3552de8b3231b55f5ee32ee2178202708118,1,12,18,30,3,2005-11-12 05:19:11,2005-11-09 01:25:48
b4ad3552de8b3231b55f5ee32ee2178202708118...9bc0f32c77b755b8d77d215cc47fafff53cad6f5,5,13,11,24,11,2005-11-12 05:19:11,2005-11-09 23:16:13
9bc0f32c77b755b8d77d215cc47fafff53cad6f5...1c3039e8f1eb01766cff976793c8f439095967f6,3,106,62,168,39,2005-11-12 05:19:11,2005-11-11 00:25:04
1c3039e8f1eb01766cff976793c8f439095967f6...d7b1a1ddbece22c99d52ea45bdecefdb9f17a613,1,11,0,11,1,2005-11-12 05:19:11,2005-11-11 18:41:53
d7b1a1ddbece22c99d52ea45bdecefdb9f17a613...04e7ca1a1bd05e733236734bd7078b4cde1f7ce5,4,106,1,107,4,2005-11-12 05:52:20,2005-11-07 23:15:34
04e7ca1a1bd05e733236734bd7078b4cde1f7ce5...07203659d0dae619f78773d3caea6b58907a1ba5,2,5,5,10,3,2005-11-12 05:52:21,2005-11-11 03:16:26
07203659d0dae619f78773d3caea6b58907a1ba5...e6bd23911efd0a2bd756c77d9e7ba6576eb739a1,2,3,3,6,3,2005-11-12 06:16:59,2005-11-12 06:16:59
e6bd23911efd0a2bd756c77d9e7ba6576eb739a1...7765e7ebda7e273bca34e87110be899447068b58,1,1,0,1,1,2005-11-12 06:28:03,2005-11-12 06:28:03
bd321bcc51e95f644ac5335abe673afcbcaade62...7b34c2fae0d2875b35ad1cc0e416b9c2b9b02b1f,2,19,8,27,8,2005-10-26 23:49:38,2005-10-25 22:24:55
7b34c2fae0d2875b35ad1cc0e416b9c2b9b02b1f...19a7e7151d0dfd22619daabbaa72a24715fae0ca,1,14,12,26,10,2005-10-26 23:49:38,2005-10-26 15:18:13
bd321bcc51e95f644ac5335abe673afcbcaade62...e24317b4d093e4b148996172d0b749f09a0e6f2e,1,37,0,37,1,2005-10-26 23:48:26,2005-10-25 23:43:03
02b54b3dfd5c1aa039acd73b5a1c77f382c506b3...a1c7a69047e88244ed321b5aa2a8bcbba5a869c2,2,7,1,8,2,2005-10-23 09:04:01,2005-10-23 09:04:01
5990efb0c4f6d1a19c4702bf50ef8cc5ac902a78...15fad5f4d750da31fbc004e6dd4c78fc0f20aca4,1,7,0,7,1,2005-10-16 06:49:27,2005-10-16 06:49:27
2c08b3638339f9b73128c41a4882e115222608a3...9f92f15f897fa1a943bcec324032cc4ca1f73ecf,1,13,1,14,2,2005-09-23 07:53:02,2005-09-23 07:53:02
a61399b5fb7f4b04d60f42b253cb0f684bcdd286...25a67553ea8b5c8c750adf21f39a901009750553,1,5,4,9,1,2005-09-24 18:38:04,2005-09-24 18:19:07
25a67553ea8b5c8c750adf21f39a901009750553...00d8bbd3c4bba72a6dfd48c2c0c9cbaa000f13c2,2,7,1,8,2,2005-09-24 18:38:43,2005-09-24 18:38:43
bb3f45838b859c8b17a53a24579a304333868cc8...ffc2b483dee43c2687088d4c73d7532fda855050,1,1,1,2,1,2014-01-17 20:03:32,2014-01-17 20:00:20
0232852b06cb000a3b1f5f48676c8b4d084f18ea...afa53fe5d17f5ccf4bce9e3525d83696805098af,2,100,59,159,2,2014-05-30 18:13:45,2014-05-30 17:36:21
fce135c4ffc87f85e1c3b5c57a6d9e1abdbd074d...e09867f0605702c2d4e65b99e178cdaa215a7370,2,45,1,46,3,2014-08-20 20:38:37,2014-08-20 02:14:30
fce135c4ffc87f85e1c3b5c57a6d9e1abdbd074d...51af1886c73f12b1e020db1aa03525e2d74bed93,1,14,10,24,3,2014-02-24 22:46:11,2014-02-03 12:47:19
51af1886c73f12b1e020db1aa03525e2d74bed93...eeb3f32868862609b475122f3e0c2ef7c0dd3e79,1,53,27,80,5,2014-02-24 22:46:11,2014-02-03 12:47:20
eeb3f32868862609b475122f3e0c2ef7c0dd3e79...e197c2b650316f62e6dfee4fadcb4198a03b8325,1,5,10,15,2,2014-02-24 22:46:11,2014-02-03 12:47:17
e197c2b650316f62e6dfee4fadcb4198a03b8325...e906612121bc9d436a3a64cd03be0537654e800c,1,8,9,17,5,2014-02-24 22:46:11,2014-02-03 12:47:18
e906612121bc9d436a3a64cd03be0537654e800c...7e9003c1497d01f2e75a5f3df7303643fb2432c3,1,3,32,35,3,2014-03-04 21:33:47,2014-02-24 16:21:37
7e9003c1497d01f2e75a5f3df7303643fb2432c3...d00e980c224d4b65972dda4474fbd9294bdb185f,1,82,30,112,15,2014-03-20 22:03:24,2014-02-24 16:21:38
d00e980c224d4b65972dda4474fbd9294bdb185f...5dfb2bbd8d2e2e48aa3ad6c6a8f437bbe5d2a7fb,1,14,8,22,5,2014-03-20 22:04:31,2014-02-24 16:21:39
5dfb2bbd8d2e2e48aa3ad6c6a8f437bbe5d2a7fb...903bba68abb8153f181d854e9a7075b893f1303f,1,12,16,28,7,2014-03-20 22:04:31,2014-02-24 16:21:40
903bba68abb8153f181d854e9a7075b893f1303f...9bc0619655dfd183eb5d0d47b4d63a511acd5c64,1,9,6,15,3,2014-03-20 22:04:32,2014-02-24 16:21:41
9bc0619655dfd183eb5d0d47b4d63a511acd5c64...5acabd84a6656a4f568f0e934cc9e1b344ed39d4,1,0,3,3,1,2014-03-20 22:04:32,2014-02-24 16:21:42
5acabd84a6656a4f568f0e934cc9e1b344ed39d4...1a27a1545230a5a19a3c05ed41efb8530d2fd2cd,1,6,11,17,2,2014-03-20 22:04:32,2014-02-24 16:21:43
1a27a1545230a5a19a3c05ed41efb8530d2fd2cd...6ca844e9f5ca93efd0a1323a9c9aaa882c0043e8,1,14,12,26,3,2014-03-26 21:25:11,2014-02-24 16:21:44
6ca844e9f5ca93efd0a1323a9c9aaa882c0043e8...ad6f3cc7d2eaec5247b39e9dca8e55a0f98123e7,2,2,4,6,2,2014-03-26 21:30:47,2014-02-24 16:21:45
ad6f3cc7d2eaec5247b39e9dca8e55a0f98123e7...52894e70951518e44c064cef2561aed38202fd36,1,28,32,60,15,2014-03-27 18:49:35,2014-03-27 14:24:38
52894e70951518e44c064cef2561aed38202fd36...b9081a657446ac2c5e2129de183edb41d4b4f4fb,1,6,2,8,2,2014-03-27 18:50:29,2014-03-27 14:21:29
b9081a657446ac2c5e2129de183edb41d4b4f4fb...12cd81743dc4645ef909b0c38582f5714c9a8ff7,1,19,19,38,14,2014-03-27 18:52:35,2014-03-27 14:22:07
12cd81743dc4645ef909b0c38582f5714c9a8ff7...61f76a3612db199a9eb9090c2605d8fc35ffc41c,4,30,2,32,12,2014-03-27 18:54:01,2014-03-27 14:22:50
61f76a3612db199a9eb9090c2605d8fc35ffc41c...72441af7c4e3bde33cdf7edafcf09c227d5d5296,4,465,64,529,46,2014-04-07 21:40:46,2014-04-06 21:46:26
72441af7c4e3bde33cdf7edafcf09c227d5d5296...7195fbfaf5a539b8e8358097e02b63991e78a565,2,84,5,89,7,2014-04-07 21:41:49,2014-02-24 16:21:51
7195fbfaf5a539b8e8358097e02b63991e78a565...22f4c27e68f448d5fce316a73ea3f7bab6aa1268,2,1,0,1,1,2014-04-09 17:08:35,2014-04-09 12:48:27
afa41284a258a529d8691ea83c964f16964ddbb6...8376b58d1c82789d042eb4b30ab03cfdb67ab68f,1,6,2,8,2,2014-02-03 02:53:18,2014-02-02 12:46:58
8376b58d1c82789d042eb4b30ab03cfdb67ab68f...98b2761d5efaf559d67e7ed5694f3a2bddf3e868,1,29,28,57,26,2014-02-06 15:15:33,2014-02-02 12:46:58
216d29ef257e48f95bc14765d5da17e7854a3109...8c3845892363abf3fb5cf2fe61bc455554f50c68,3,49,46,95,3,2014-11-10 17:59:19,2014-11-09 09:23:41
8c3845892363abf3fb5cf2fe61bc455554f50c68...61cfef4ca4bdacbb90866fa8fd0e0f0b16b2cafc,2,27,7,34,10,2014-11-10 18:00:02,2014-11-09 09:23:42
61cfef4ca4bdacbb90866fa8fd0e0f0b16b2cafc...3d24a7267dd9b57b864d119a533bdfdfaccd9161,1,31,1,32,2,2014-11-10 18:00:07,2014-11-09 09:23:43
6936b5859c47b826437218fbfc0e2bc0935f7136...f2b4f0a23b400f5760deb9251296d79eba83ab78,1,3,3,6,2,2015-02-15 23:38:09,2015-02-15 20:42:59
f2b4f0a23b400f5760deb9251296d79eba83ab78...2c0ab4d49d294aa9127ce5616d2d6c4d12be8e74,1,2,2,4,1,2015-02-15 23:38:09,2015-02-15 21:35:19
2c0ab4d49d294aa9127ce5616d2d6c4d12be8e74...bb8db1b5538a455a0892312b25d73d51f2650429,1,1,1,2,1,2015-02-15 23:38:10,2015-02-15 21:35:19
bb8db1b5538a455a0892312b25d73d51f2650429...459b8d22e544b3876a2270ee7290c289a39ebbb2,7,433,26,459,19,2015-02-15 23:38:10,2015-02-15 21:44:24
459b8d22e544b3876a2270ee7290c289a39ebbb2...bd9150b7e5f34d7148b02ca2eed96270c7744049,1,1,1,2,1,2015-02-15 23:38:16,2015-02-15 21:47:36
bd9150b7e5f34d7148b02ca2eed96270c7744049...db7b9e3ad39a4135072a1fd619b76d1c1093b501,1,126,160,286,1,2015-02-15 23:38:16,2015-02-15 22:21:04
db7b9e3ad39a4135072a1fd619b76d1c1093b501...817d03e10552c03fce7483df5034d72f883b2fab,1,3,1,4,1,2015-02-23 19:45:39,2015-02-23 18:14:47
9181365b856a63f8c5486ad0fe48f1cd60852da3...ccadb25f730de775660c82695c5fcf9169f0aae7,1,8,10,18,2,2014-12-09 22:23:29,2014-12-06 15:04:30
ccadb25f730de775660c82695c5fcf9169f0aae7...936d2c9301e41a84a374b98f92777e00d321a2ea,1,0,4,4,2,2014-12-09 22:24:14,2014-12-09 11:13:00
26d058738963f23826d77017e82842331af0bae6...0bf7dd652cd7b7d3900e6aed73a97cf2c4978fee,1,12,0,12,2,2014-09-29 19:44:43,2014-09-29 19:44:43
7b69fcb181941fafda99a5ffd25cea1f685d7e70...6e1ccacbedf084971f095816f4450c4b607607c5,1,5,6,11,5,2014-08-08 20:17:40,2014-08-08 17:29:14
6e1ccacbedf084971f095816f4450c4b607607c5...ddeab3aea3c81783b13ff7091552c205d0884675,1,28,21,49,3,2014-08-08 20:17:40,2014-08-08 17:29:15
ddeab3aea3c81783b13ff7091552c205d0884675...86d387af3763e44f8ebdf91e74c37cc002495625,1,5,5,10,5,2014-08-08 20:17:41,2014-08-08 17:29:16
86d387af3763e44f8ebdf91e74c37cc002495625...c165d1f5ca82bca5e79a1a797d847ca5458ea9c8,1,6,6,12,1,2014-08-08 20:17:41,2014-08-08 17:29:17
c165d1f5ca82bca5e79a1a797d847ca5458ea9c8...4dde849a20267153aa86ffeb1476cd5886d0fc57,1,2,2,4,1,2014-08-08 20:17:41,2014-08-08 17:29:18
4dde849a20267153aa86ffeb1476cd5886d0fc57...8994fbf3ec97d408e2bceefad0328c5951a3de14,1,2,3,5,1,2014-08-08 20:17:42,2014-08-08 17:29:19
8994fbf3ec97d408e2bceefad0328c5951a3de14...64de2e10a0acdcf9558317cca77ed3c5622d7a49,1,2,0,2,2,2014-08-08 20:17:42,2014-08-08 17:29:20
7b69fcb181941fafda99a5ffd25cea1f685d7e70...663d096c2488b5c46ca5a2994712a0cde6a93c5a,3,3,3,6,3,2014-08-07 16:43:21,2014-08-07 14:27:12
7b69fcb181941fafda99a5ffd25cea1f685d7e70...f54d3c6d7c34399f8385939b938b24ac6402424a,1,0,6,6,1,2014-08-05 18:45:09,2014-08-05 18:44:23
f54d3c6d7c34399f8385939b938b24ac6402424a...5261ec5d5df745612a971bf6cb080ef82bab207c,1,53,55,108,32,2014-08-07 16:44:05,2014-08-05 16:50:45
4c715ebb96acc77008e9cbebc381738611c6006f...dc05179b5a8a6dcc9a25de461d43fb5edfc93c46,1,2,2,4,2,2014-10-13 22:25:42,2014-10-13 22:25:38
4c715ebb96acc77008e9cbebc381738611c6006f...8262aaa2835d71b0cdf44e68712703a452761328,1,10,10,20,10,2014-08-07 18:37:44,2014-08-07 11:59:12
8262aaa2835d71b0cdf44e68712703a452761328...b3b3f60bb672d23b9db1582395a1d29561cb79ef,1,11,1,12,3,2014-08-07 18:38:32,2014-08-07 11:59:13
b3b3f60bb672d23b9db1582395a1d29561cb79ef...3df8fd625fba33a6525f61c85de39afb746db9bd,2,19,2,21,4,2014-08-07 18:38:50,2014-08-07 11:59:14
3df8fd625fba33a6525f61c85de39afb746db9bd...aace4385027b0366f43961a94c8ed95ac9b3bd53,3,16,7,23,4,2014-08-07 18:40:17,2014-08-07 11:59:15
aace4385027b0366f43961a94c8ed95ac9b3bd53...5a80e97c827e9d73884dbe4119bf97f6dd84b237,3,53,2,55,6,2014-08-07 18:40:25,2014-08-07 11:59:16
5a80e97c827e9d73884dbe4119bf97f6dd84b237...155ef25f12329258c06b8875b5e372abec2d348d,3,68,9,77,12,2014-08-07 18:41:10,2014-08-07 11:59:17
155ef25f12329258c06b8875b5e372abec2d348d...79e9ce21fa728edef5b7db12710ae24e091b8f9f,1,11,0,11,1,2014-08-07 18:41:18,2014-08-07 11:59:18
79e9ce21fa728edef5b7db12710ae24e091b8f9f...8a7b034d6d451491dbcfaebc3d4ed4f08c756822,2,20,0,20,3,2014-08-07 18:41:20,2014-08-07 11:59:19
528396a463e4030e19f150e8fddd8d911063e77e...0eff86e4f440fedf26f02f4c3b1a3ead8bfbe6f8,1,4,0,4,2,2014-07-21 19:13:03,2014-07-21 19:13:03
5d7c37a130833d8e612f6b83f017ffe51a1a6833...d299e9e550c1bf8640907fdba1f03cc585ee71df,1,10,0,10,1,2014-07-28 18:31:32,2014-07-28 18:01:57
398dd4bd039680ba98497fbedffa415a43583c16...642c7fab1d3bbd2e4542bcb9f874bda16e3e84b6,1,1352,962,2314,1117,2014-08-03 10:11:46,2014-06-27 12:04:51
642c7fab1d3bbd2e4542bcb9f874bda16e3e84b6...c099f8c7ed61dbf3881b01ab2cedcec36a2b7bf9,1,1348,1252,2600,1212,2014-08-03 10:14:03,2014-08-03 08:16:24
398dd4bd039680ba98497fbedffa415a43583c16...da33a97998f6d6206c08bd72a527f5b8e6e26d33,1,7,1,8,2,2014-07-21 17:39:48,2014-07-19 16:08:57
398dd4bd039680ba98497fbedffa415a43583c16...a7220fba73737d3ea790ed56e5a777b815687aca,1,1,1,2,1,2014-07-17 20:39:02,2014-07-17 15:37:00
a7220fba73737d3ea790ed56e5a777b815687aca...480cd53014325865901c9adc3791446bfd4cf4f0,1,5,2,7,2,2014-07-21 16:39:19,2014-07-19 19:37:19
480cd53014325865901c9adc3791446bfd4cf4f0...32f4cb6cee9295fe68211581fec22c546808b436,3,18,15,33,12,2014-07-21 16:39:57,2014-07-17 15:37:02
32f4cb6cee9295fe68211581fec22c546808b436...5212f91deb03056480cb01d60d27a107dc7cf680,1,2,2,4,2,2014-07-21 16:39:57,2014-07-17 15:37:03
5212f91deb03056480cb01d60d27a107dc7cf680...44cf1c0ef1989eb5cfcaec203b427ddeac2ecaa8,1,13,4,17,3,2014-07-21 16:39:57,2014-07-17 15:37:04
44cf1c0ef1989eb5cfcaec203b427ddeac2ecaa8...e8d08871c97cf8e932ded11ef1659d5d14e4b36a,1,12,0,12,2,2014-07-21 16:39:57,2014-07-17 15:37:05
ebc5da3208824e25a89672a3b91bd13629b215fe...f22a76e9110e8e31efa3781b1a3cf2b4565d9e8a,3,26,0,26,3,2014-07-28 20:48:07,2014-07-28 18:24:29
f22a76e9110e8e31efa3781b1a3cf2b4565d9e8a...d13a0a97e097c6a601bafc529a716477cc94dc20,1,7,7,14,7,2014-07-28 20:49:02,2014-07-28 18:25:40
d13a0a97e097c6a601bafc529a716477cc94dc20...7333ed1788b4f2b162a35003044d77a716732a1f,1,44,43,87,34,2014-08-26 18:06:04,2014-07-28 18:26:40
7333ed1788b4f2b162a35003044d77a716732a1f...251277acdf8c8dee59bdd0e9e7b7e3502226cf9d,1,5,4,9,3,2014-08-26 18:06:04,2014-07-28 18:27:34
251277acdf8c8dee59bdd0e9e7b7e3502226cf9d...2fdb9ce0673b9197214e0fc12a47a8b335561cd8,1,25,44,69,16,2014-08-26 18:06:05,2014-07-28 18:28:30
2fdb9ce0673b9197214e0fc12a47a8b335561cd8...aa14e980fff55e090dd42174ab4f37fe4b3dfa1e,2,9,0,9,2,2014-08-26 18:06:05,2014-07-28 18:29:50
aa14e980fff55e090dd42174ab4f37fe4b3dfa1e...56b9f6e738af6f5238f57a29e96103cf61e3f8cd,5,26,22,48,15,2014-08-26 18:06:06,2014-07-28 18:30:39
56b9f6e738af6f5238f57a29e96103cf61e3f8cd...4d3ab44d26c47d100cec39d0ef9ed9746eb7e454,2,6,6,12,3,2014-08-26 18:06:06,2014-07-28 18:31:57
4d3ab44d26c47d100cec39d0ef9ed9746eb7e454...679eebe24d4c2120f8c01fb4524fcc489718fc9c,4,37,42,79,6,2014-08-26 18:06:06,2014-07-28 18:33:55
679eebe24d4c2120f8c01fb4524fcc489718fc9c...9610decf4dc6b9352b81c67e3b03e5bb47fc8427,1,1,5,6,1,2014-08-26 18:06:06,2014-07-28 18:34:42
ebc5da3208824e25a89672a3b91bd13629b215fe...51a60f5bfbaf1ee7c7a2d2b73eca4f042f7af8cb,4,4,8,12,4,2014-07-21 17:30:21,2014-07-19 13:56:26
51a60f5bfbaf1ee7c7a2d2b73eca4f042f7af8cb...5c0b13f85ab3a5326508b854768eb70c8829cda4,6,6,19,25,7,2014-07-21 17:37:02,2014-07-19 15:35:34
ebc5da3208824e25a89672a3b91bd13629b215fe...e7e0f26eb64de205acaac63da89f47aab78ba229,3,3,6,9,3,2014-07-16 20:06:41,2014-07-15 23:02:38
66f467c3e6aa9c1e28eaf7b71cea5e452fc104e8...85faec9d3acd8bb20e26e2d3386f7d3708d02fca,2,160,56,216,52,2014-07-15 18:19:08,2012-03-15 17:21:28
85faec9d3acd8bb20e26e2d3386f7d3708d02fca...0217569bb2db23b8686f67b0f4dda7e517dec6fd,2,11,21,32,8,2014-07-15 18:19:09,2012-01-14 21:01:09
66f467c3e6aa9c1e28eaf7b71cea5e452fc104e8...6d63baa47883315033474fc06196330e3a5ca4e0,1,25,24,49,13,2014-07-15 18:02:53,2014-07-14 05:42:50
6d63baa47883315033474fc06196330e3a5ca4e0...e8f91e3df82a33b7e0b59c935cc4af892068baa2,2,17,6,23,10,2014-07-15 18:02:54,2014-07-14 05:51:59
e8f91e3df82a33b7e0b59c935cc4af892068baa2...73f43f220f0276012de50c84413fd61bf6aa307b,1,19,23,42,11,2014-07-15 18:02:56,2014-07-14 05:53:54
73f43f220f0276012de50c84413fd61bf6aa307b...f0e802ca200b1296495d2ee5c55cd8f8083486bc,1,1,0,1,1,2014-07-15 18:27:08,2014-07-14 05:40:22
66f467c3e6aa9c1e28eaf7b71cea5e452fc104e8...3d15f536a7f5215eddae20214fb8eaeeb6baaf27,1,1,0,1,1,2014-07-15 15:05:03,2014-07-15 13:40:24
66f467c3e6aa9c1e28eaf7b71cea5e452fc104e8...d961baa84689afdd0fe6b81f68b06481d83ce249,1,6,6,12,4,2014-07-14 22:24:34,2014-07-14 09:47:11
d961baa84689afdd0fe6b81f68b06481d83ce249...709359c85cf366df68a1cabf9d68978c05c541c5,1,22,20,42,2,2014-07-14 22:24:34,2014-07-14 09:48:03
709359c85cf366df68a1cabf9d68978c05c541c5...aceb9429b37a4a36e91f9eeb60e7ba488f73604b,2,29,20,49,14,2014-07-14 22:24:34,2014-07-14 09:50:22
afc344c4ad77f1e7e27eced7f7726bf29ffe22b2...6acbf0330082999fdd39f2200a39c1af44fa7e22,1,1480,1342,2822,1290,2014-08-04 08:42:40,2014-08-04 08:23:15
697cc8efd944a32ca472337cd6640004c474b788...013870cd2cb1b0d6719a7a9123e126a62426520b,3,68,16,84,18,2014-10-01 21:08:10,2014-10-01 11:14:47
013870cd2cb1b0d6719a7a9123e126a62426520b...f70f0565b3a905ba90af3446475afec2e8aa0d2a,1,2,19,21,5,2014-10-01 21:20:22,2014-10-01 11:14:48
f70f0565b3a905ba90af3446475afec2e8aa0d2a...6e578a31e6662c69107eb4587d1024dd9f38cc3c,1,1,4,5,2,2014-10-01 21:20:25,2014-10-01 11:14:49
6a0662304d85ffa288c960f688eb9704954ea8ee...e832f7374b66d6d8a25eaab31f87c1ab3cc2d207,1,8,2,10,2,2014-07-25 19:44:22,2014-07-25 19:44:18
7e1a5381b0048572e72971af41e13a85804d48d9...cb682f8cfe63ecd0da08a526f404d295e51e3ab1,1,80,0,80,11,2014-06-16 19:39:35,2014-06-16 19:39:35
cbc60b67201e083a4970c8731c5382a575357e36...b9a1907899a2a00e94092207bb5de4d864408806,1,2,2,4,2,2014-09-23 22:41:38,2014-09-23 22:41:38
7e76a2f97546444fe7a2af18825450e29c3622a4...a08e803d76dff22d8c2b428a725be247425963af,1,3,3,6,3,2014-05-06 16:52:12,2011-01-07 16:20:21
7e76a2f97546444fe7a2af18825450e29c3622a4...dd30800bcd236233c82da80bba0d00956a246260,1,8,0,8,1,2014-05-02 20:24:57,2014-04-30 21:23:26
dd30800bcd236233c82da80bba0d00956a246260...79fc3ca1232099fd21e5bdef14c1b6fe1d2dbc1c,1,11,1,12,1,2014-05-02 20:24:57,2014-04-30 21:24:08
79fc3ca1232099fd21e5bdef14c1b6fe1d2dbc1c...6a49909b52b48592234da6a53bfe74ea34c302c6,1,8,0,8,1,2014-05-02 20:24:57,2014-04-30 21:24:24
6a49909b52b48592234da6a53bfe74ea34c302c6...9dbe780174892a35d6f1e19495c13b9edb9d88fd,1,11,0,11,1,2014-05-02 20:24:57,2014-04-30 21:24:52
9dbe780174892a35d6f1e19495c13b9edb9d88fd...6117a3d4946e35c7d4a38c0b443891c81808a838,1,11,3,14,1,2014-05-02 20:24:57,2014-04-30 21:25:11
6117a3d4946e35c7d4a38c0b443891c81808a838...691d0dd0a9c901286c2a0a28c30ec4d13bcd2032,1,1,1,2,1,2014-05-02 20:26:07,2014-04-30 21:25:47
691d0dd0a9c901286c2a0a28c30ec4d13bcd2032...5db9ab82b94fab16e69b0228aaf1e972520bd04a,1,27,0,27,1,2014-05-02 20:44:46,2014-04-30 21:26:23
5db9ab82b94fab16e69b0228aaf1e972520bd04a...f26443da0449c459dab8b91d963bd91dd4335657,1,55,0,55,1,2014-05-02 21:08:16,2014-05-02 20:42:39
f26443da0449c459dab8b91d963bd91dd4335657...897f964c0dce8e7cc2cc53bb19b83cadce106773,1,13,0,13,1,2014-05-20 18:19:43,2014-05-20 18:12:02
7e76a2f97546444fe7a2af18825450e29c3622a4...3cf6bb34063406e107f51aa52db67d65839f5e58,1,24,9,33,4,2014-05-02 19:31:59,2014-05-02 07:55:29
3cf6bb34063406e107f51aa52db67d65839f5e58...839fa9c500c7771d15831e2bcf77697cd70620f9,1,7,7,14,2,2014-05-02 19:36:10,2014-05-02 19:36:10
839fa9c500c7771d15831e2bcf77697cd70620f9...9c65ee15ee11c9b9d2fc9d7306fb1e238b35d0c1,1,1,1,2,1,2014-05-30 18:48:28,2014-05-30 15:22:40
341e7e8eda3dbeb6867f4f8f45b671201b807de5...79bc4ef3686bc6795aa79a1d4aa6d3060a2cbd93,2,18,1,19,2,2014-07-01 15:30:41,2014-06-30 21:20:27
341e7e8eda3dbeb6867f4f8f45b671201b807de5...880fb8de67af3aeeae5a59ba5ce84ad3d0cf1dda,1,16,26,42,12,2014-06-30 20:43:16,2014-06-30 16:55:52
880fb8de67af3aeeae5a59ba5ce84ad3d0cf1dda...35480f0b23f2c1824109ddae24392a70d19c6b9c,1,27,0,27,1,2014-06-30 20:43:16,2014-06-30 16:57:51
35480f0b23f2c1824109ddae24392a70d19c6b9c...f52a35fd63cc6d570083cedc15576d01c0968d98,2,6,10,16,3,2014-06-30 20:43:16,2014-06-30 16:58:08
f52a35fd63cc6d570083cedc15576d01c0968d98...2975c770ca609ea5afc80631c4ac9087c527b6fd,6,12,19,31,10,2014-06-30 20:43:16,2014-06-30 16:58:25
2975c770ca609ea5afc80631c4ac9087c527b6fd...26936bfd9bde1ec46901bea3e53d4fb9ae1b4a4c,4,14,15,29,12,2014-06-30 20:43:17,2014-06-30 16:58:51
26936bfd9bde1ec46901bea3e53d4fb9ae1b4a4c...592ce20820ac36dd868dfd1e61b1aeb3cd3f902a,1,14,15,29,6,2014-06-30 20:43:17,2014-06-30 16:59:10
592ce20820ac36dd868dfd1e61b1aeb3cd3f902a...6dda4e60f2c3c309de6e3fe1b86a47846a86dabf,1,9,0,9,1,2014-06-30 20:43:32,2014-06-30 17:01:51
6dda4e60f2c3c309de6e3fe1b86a47846a86dabf...d6cd00c76866a6412e0c13da91a022acdd187a47,1,3,4,7,1,2014-06-30 20:43:32,2014-06-30 17:02:05
d6cd00c76866a6412e0c13da91a022acdd187a47...47bf4b0fc52f3ad5823185a85f5f82325787c84b,1,7,2,9,3,2014-06-30 20:43:32,2014-06-30 17:04:03
341e7e8eda3dbeb6867f4f8f45b671201b807de5...85dd6bf4911dc6d08857c234fe3c135abeed2c44,1,4,5,9,5,2014-06-30 06:41:02,2014-06-29 20:47:00
85dd6bf4911dc6d08857c234fe3c135abeed2c44...10761eb6812bfe46c50360685916ae14859a2b85,1,1,3,4,3,2014-06-30 06:41:04,2014-06-29 20:55:44
68773ac915580e88016c34ce1269730382b501d4...61a64fff4f710f43826c8446d3fd8f3ae78c0411,1,23,12,35,7,2014-04-15 20:01:49,2014-04-15 10:40:30
61a64fff4f710f43826c8446d3fd8f3ae78c0411...d5067112db68fcc8c7b13c769c896b17480cb5b0,1,13,3,16,2,2014-04-15 20:01:51,2014-04-15 10:40:31
68773ac915580e88016c34ce1269730382b501d4...4a1b59c85f99b4ed046ae8066e7dea1d8621a986,1,2,7,9,2,2014-04-14 20:48:17,2014-04-12 20:33:28
4a1b59c85f99b4ed046ae8066e7dea1d8621a986...5931b33e202856aa0046b493c3aacdd16be7d8f3,1,14,7,21,7,2014-04-14 20:48:33,2014-04-12 20:33:29
5931b33e202856aa0046b493c3aacdd16be7d8f3...0551a06c22543d4ff1aecbdf6b419760b1b10bff,1,11,7,18,6,2014-04-14 20:51:37,2014-04-12 20:33:30
0551a06c22543d4ff1aecbdf6b419760b1b10bff...852e54bc0f8c7a478bf1f3a13b45fdfc6604aba7,1,12,12,24,4,2014-04-14 21:03:33,2014-04-12 20:33:31
852e54bc0f8c7a478bf1f3a13b45fdfc6604aba7...3994e64d77d644df0f290f8bf5210ff0cb0adde2,2,30,3,33,4,2014-04-14 21:03:33,2014-04-12 20:33:32
3994e64d77d644df0f290f8bf5210ff0cb0adde2...3667a5b67423ff727569628e903146d970b74095,1,4,7,11,2,2014-04-21 17:41:38,2014-04-20 18:43:37
68773ac915580e88016c34ce1269730382b501d4...59d3924fbb300ebfe05f9079bcfe29d0a3f30661,1,14,7,21,5,2014-04-14 20:27:23,2014-04-11 23:32:25
68773ac915580e88016c34ce1269730382b501d4...880111c11befaaf070e8ea1021bf11b4fb58c461,2,2,0,2,2,2014-04-09 21:22:18,2014-04-09 18:50:04
baa37bff9a845471754d3f47957d58a6ccc30058...decd3c0c28906cd53072ae534e0e23b4e7879371,1,1,1,2,1,2014-12-01 02:13:42,2014-11-28 16:57:18
daa22c6f8da466bd7a438f1bc27375fd737ffcf3...2569d23915471f1727e5945c513b8be299eefa0c,1,4,4,8,2,2014-07-16 20:05:21,2014-07-15 22:54:30
82fbf269b9994d172719b2d456db5ef8453b323d...ae049c955c8858899467f6c5c0259c48a5294385,1,5,9,14,5,2014-04-21 17:30:33,2014-04-19 19:17:25
ae049c955c8858899467f6c5c0259c48a5294385...89294d143d42db2540ec587d0bce20c6c7718051,2,4,7,11,4,2014-04-21 17:31:36,2014-04-19 19:19:19
89294d143d42db2540ec587d0bce20c6c7718051...5b88caa417ab221c8f8576332fba8d41dd3986d7,1,0,1,1,1,2014-04-21 17:31:51,2014-04-19 19:19:30
5b88caa417ab221c8f8576332fba8d41dd3986d7...0d4217d92e3043e23a8960519a51cc7a36ed8914,1,3,5,8,3,2014-04-21 17:32:07,2014-04-19 19:20:46
0d4217d92e3043e23a8960519a51cc7a36ed8914...f3efe78782b36d68dc71a4f48a7bd3381c6b5669,1,15,11,26,2,2014-04-21 17:32:19,2014-04-19 19:22:25
75ee3d7078fbcc3b87a3ae5e0cf42f46256c5da4...f25f5e61a7c1a22dd85413d61db639e7c01268f4,1,6,6,12,5,2014-04-17 18:14:57,2014-04-16 17:29:45
f25f5e61a7c1a22dd85413d61db639e7c01268f4...2c4a050bc60bf7a0633aa1460a8538d18df67848,1,3,3,6,3,2014-04-17 18:14:58,2014-04-16 17:29:46
2c4a050bc60bf7a0633aa1460a8538d18df67848...844cb24f28afd4febcfc1ddc44f9de47130acf4b,1,4,4,8,4,2014-04-17 18:14:58,2014-04-16 17:29:47
844cb24f28afd4febcfc1ddc44f9de47130acf4b...add77e8400252ef59441770a96379dcad797b649,1,10,10,20,9,2014-04-17 18:14:58,2014-04-16 17:29:48
add77e8400252ef59441770a96379dcad797b649...346b54dbc92bb3c928d326da9d8addf5eb50acce,1,5,5,10,4,2014-04-17 18:14:59,2014-04-16 17:29:49
346b54dbc92bb3c928d326da9d8addf5eb50acce...3e867415170ed73511291fb2dd47bac3c4d51f3a,1,3,3,6,3,2014-04-17 18:14:59,2014-04-16 17:29:50
3e867415170ed73511291fb2dd47bac3c4d51f3a...1b3cddd28834ef7c32f2049054c9179c68a381f6,1,2,2,4,2,2014-04-17 18:14:59,2014-04-16 17:29:51
1b3cddd28834ef7c32f2049054c9179c68a381f6...34da37cc4230affae93483f6c51fca6beb6e6c64,1,2,2,4,2,2014-04-17 18:14:59,2014-04-16 17:29:52
34da37cc4230affae93483f6c51fca6beb6e6c64...ddbac79de939d5a85860f6cc250c239fbfff439a,1,1,1,2,1,2014-04-17 18:15:00,2014-04-16 17:29:53
ddbac79de939d5a85860f6cc250c239fbfff439a...6aeb30eb9fb59f97dd59cc0b580f95a0b98bbe48,1,1,1,2,1,2014-04-17 18:15:00,2014-04-16 17:29:54
6aeb30eb9fb59f97dd59cc0b580f95a0b98bbe48...fb6644a32fa06ff2698ecc66f4008d2afdf0b9c7,1,1,1,2,1,2014-04-17 18:15:00,2014-04-16 17:29:55
fb6644a32fa06ff2698ecc66f4008d2afdf0b9c7...b352891021d74528f668306d0882633cc0673a89,1,1,1,2,1,2014-04-17 18:15:00,2014-04-16 17:29:56
b352891021d74528f668306d0882633cc0673a89...c9b92706af6441ba91fec314b6aac7f105e61b22,1,7,7,14,2,2014-04-17 18:15:01,2014-04-16 17:29:57
c9b92706af6441ba91fec314b6aac7f105e61b22...bd368a9baf5a42e2076ef4c8a35312ccab171452,1,2,2,4,1,2014-04-17 18:15:01,2014-04-16 17:29:58
81e776d92bb19a4fab12dcc537adfd543468d7d0...e992d1eb39033206dd44143ff28214b837c3d89f,4,5,5,10,5,2014-07-10 21:06:45,2014-07-10 08:52:21
e992d1eb39033206dd44143ff28214b837c3d89f...294b2680cd89234618e329e090b68dc69cc41a37,3,3,3,6,3,2014-07-10 21:06:46,2014-07-10 08:54:24
294b2680cd89234618e329e090b68dc69cc41a37...910a09a7350a556f7f367680294fca8d05ddc5f5,1,4,6,10,3,2014-07-10 21:07:16,2014-07-10 09:41:40
910a09a7350a556f7f367680294fca8d05ddc5f5...cb979dbd8fead65e579442c25b620fdc401227b1,1,1,6,7,1,2014-07-10 21:07:22,2014-07-10 09:47:47
cb979dbd8fead65e579442c25b620fdc401227b1...9d02150cf4d833935161ef265e4dc03807caa800,1,6,16,22,6,2014-07-10 21:10:27,2014-07-10 09:48:26
e61a6c1d8272f9d7bdc861ed28bfac5fb7e33556...97c1364be6b27a6faf046d6d4240a4ebd550ae9f,1,8,6,14,1,2014-06-13 20:29:03,2014-06-13 20:23:58
4a28f169ad29ba452e0e7bea2583914c10c58322...38de156a05a4421103e93d43b36e9967e63fb707,1,1,1,2,1,2014-06-02 18:02:27,2014-05-28 03:12:15
4a28f169ad29ba452e0e7bea2583914c10c58322...e156455ea49124c140a67623f22a393db62d5d98,2,6,1,7,2,2014-05-28 18:04:19,2014-05-28 18:04:19
4a28f169ad29ba452e0e7bea2583914c10c58322...3c735e0776e11951631c6b7a181c655f5742011b,2,8,9,17,5,2014-05-28 17:40:06,2014-05-28 02:23:32
4a28f169ad29ba452e0e7bea2583914c10c58322...edd2d8466523094c9b14762e402b0de15d68fec0,1,1,1,2,1,2014-05-27 21:00:43,2014-05-26 15:33:43
edd2d8466523094c9b14762e402b0de15d68fec0...380694544d3e5e882c0f62be372c666911c405b2,1,4,4,8,4,2014-05-27 21:00:43,2014-05-26 15:33:44
380694544d3e5e882c0f62be372c666911c405b2...c4a7b0092bbe39a6b05ddd65a6b3e45565203367,1,1,1,2,1,2014-05-27 21:00:43,2014-05-26 15:33:45
c4a7b0092bbe39a6b05ddd65a6b3e45565203367...f1064f6bc897fe35830c2ecee08f8dd27caf763c,1,2,2,4,2,2014-05-27 21:00:44,2014-05-26 15:33:46
f1064f6bc897fe35830c2ecee08f8dd27caf763c...1a4927c5c54f737353323fd7bcd2045ee0985e1a,1,1,1,2,1,2014-05-27 21:02:03,2014-05-26 15:33:47
1a4927c5c54f737353323fd7bcd2045ee0985e1a...f3d51ffde88323fd4a5c18ac19a47cf571f62ae4,1,1,1,2,1,2014-05-27 21:02:45,2014-05-26 15:33:50
f3d51ffde88323fd4a5c18ac19a47cf571f62ae4...3345c0f5b98be4e2b567bc22dc200395468cabd6,1,1,1,2,1,2014-05-27 21:02:45,2014-05-26 15:33:51
3345c0f5b98be4e2b567bc22dc200395468cabd6...65bbf082c27bcc4544511b642fb311e5f3c21722,1,3,3,6,3,2014-05-27 21:02:45,2014-05-26 15:33:52
65bbf082c27bcc4544511b642fb311e5f3c21722...48d547fb381b311fd327f84f1dff11228303c872,1,1,1,2,1,2014-05-27 21:02:45,2014-05-26 15:33:53
48d547fb381b311fd327f84f1dff11228303c872...8e1aa2f792b78f2528157428c7932ffa9adcbea6,1,4,4,8,4,2014-05-27 21:02:45,2014-05-26 15:33:54
8e1aa2f792b78f2528157428c7932ffa9adcbea6...da7a478bc055bd5fdbdf1895367c803d528cf579,1,1,1,2,1,2014-05-27 21:02:45,2014-05-26 15:33:55
da7a478bc055bd5fdbdf1895367c803d528cf579...92e25b6b5b66320e73ace921f3db816ef4243d1b,1,1,1,2,1,2014-05-27 21:02:45,2014-05-26 15:33:56
4a28f169ad29ba452e0e7bea2583914c10c58322...f8ee1f02da6182a3242306a52c5ae7a39547b37e,1,11,1,12,1,2014-05-27 19:57:19,2014-05-27 01:18:10
4a28f169ad29ba452e0e7bea2583914c10c58322...01730a3bb46806899e61d4d2d8d3677c5d64ffde,1,17,18,35,8,2014-05-27 19:44:33,2014-05-25 19:24:54
4a28f169ad29ba452e0e7bea2583914c10c58322...b4073bb387ef303c9ac3c044f46d6a8ae6e190f0,2,28,24,52,5,2014-05-27 19:35:15,2014-05-24 17:40:35
4a28f169ad29ba452e0e7bea2583914c10c58322...6d2b06f02b9c69351a55a2cad0cfab33ecb6ee6f,1,1,0,1,1,2014-05-27 19:27:36,2014-05-22 13:58:37
6d2b06f02b9c69351a55a2cad0cfab33ecb6ee6f...8fee8726470bd63db6c396ea6208ea487eaa8fab,1,4,1,5,2,2014-05-27 19:27:50,2014-05-22 13:58:38
4a28f169ad29ba452e0e7bea2583914c10c58322...ffb20ce125f0ffe59002b1258b06c26747b69b7b,4,13,7,20,5,2014-05-23 21:09:58,2014-05-23 20:03:47
4a28f169ad29ba452e0e7bea2583914c10c58322...e2a0ccc01fab1770bd3b2767481137c6f728e5ab,1,1,0,1,1,2014-05-23 19:41:48,2014-05-22 09:28:50
e2a0ccc01fab1770bd3b2767481137c6f728e5ab...c7db2d16474874b21aad9141e6856f836f719643,2,5,2,7,3,2014-05-23 19:41:50,2014-05-22 09:28:56
c7db2d16474874b21aad9141e6856f836f719643...dbcf2bd3dec1244fdbafb3ec7312ed14d83c0025,4,32,0,32,5,2014-05-23 19:43:51,2014-05-22 09:29:03
dbcf2bd3dec1244fdbafb3ec7312ed14d83c0025...bf197fd7eebcb3579dd659af35822ce88adc66c8,4,48,5,53,7,2014-05-27 16:57:00,2014-05-22 09:29:47
bf197fd7eebcb3579dd659af35822ce88adc66c8...e31316263af98c4583be39b469f3152a23eba91d,2,57,4,61,9,2014-05-27 16:59:19,2014-05-22 09:30:05
e31316263af98c4583be39b469f3152a23eba91d...d4241f52d1a19bf464d63cbc4cd67fcc6a3af01d,3,23,0,23,4,2014-05-27 16:59:21,2014-05-22 09:30:14
d4241f52d1a19bf464d63cbc4cd67fcc6a3af01d...fc1b774c72990f0ff92370316412b19fd72baa77,3,19,7,26,11,2014-05-27 16:59:22,2014-05-22 09:30:29
fc1b774c72990f0ff92370316412b19fd72baa77...c553fd1c1ef76688b6200e66a825b530b0b02140,1,3,0,3,1,2014-05-27 16:59:22,2014-05-22 09:36:12
4a28f169ad29ba452e0e7bea2583914c10c58322...b07bdd3472886cbdd412ee3e7489273522c43133,1,6,4,10,2,2014-05-23 18:56:15,2014-05-23 10:28:43
b07bdd3472886cbdd412ee3e7489273522c43133...c9e768bb77762765f739fffb5c09d0888f3de20e,3,21,3,24,9,2014-05-27 19:30:42,2014-05-23 10:29:45
c9e768bb77762765f739fffb5c09d0888f3de20e...e6bea66db6229a0975ebba510a1d2827bf09cb7f,3,25,2,27,9,2014-05-27 19:30:47,2014-05-23 10:30:25
14ac2864dcd566a025e449ab9db6b5dc57744a32...fac908389d4571ab5004872a54e50349272b63fc,1,14,9,23,3,2014-12-11 23:34:35,2014-12-10 15:42:10
fac908389d4571ab5004872a54e50349272b63fc...c83a5099c89b83d7678764856f6b6cbf87a69ff0,1,5,21,26,3,2014-12-11 23:34:37,2014-12-10 15:43:42
30f7ad08e69561e638a0e95345b74aa2806331dc...b72c6161f1f34985e4a13f8c4c9ba9e55b3d1496,1,16,0,16,3,2013-07-18 20:00:08,2013-07-18 19:57:38
d6cbf2fa7a51229d992c9c8d51eb635eccdd6067...1e88f7a277c4cf96a425ffa66e30177b858bc965,1,6,6,12,6,2013-08-05 17:17:35,2013-08-02 23:22:08
1e88f7a277c4cf96a425ffa66e30177b858bc965...3109bdb0d157afbd01c412d6f3fb1c86d8b7adde,1,4,4,8,4,2013-08-05 17:17:36,2013-08-02 23:23:38
3109bdb0d157afbd01c412d6f3fb1c86d8b7adde...53a7296e7ebab82d23983fd5506a2bf5ee5d2d0c,1,3,0,3,1,2013-08-05 17:17:38,2008-12-11 20:27:21
7e5ad06f689b13fb1fc484da2bf1a03b603d66c2...51f11d69b16ab6614b79b3b4c12d35ca2b450a22,1,16,0,16,3,2013-07-01 19:46:41,2013-07-01 19:46:41
8093ae8854a50edf44e47c0390d3021ffd07bc00...bee3eb079d10bd309c75c39efa1e50fbb70931d4,1,5,2,7,1,2013-02-26 17:34:51,2013-02-21 20:22:50
bee3eb079d10bd309c75c39efa1e50fbb70931d4...21b6e4f24c74755d700d59edd47d5b88ff56ea5d,1,20,0,20,1,2013-02-26 17:34:51,2013-02-21 20:23:38
8093ae8854a50edf44e47c0390d3021ffd07bc00...01f7d7f19f585e40af399acc307200d4b6acad25,1,4,2,6,1,2012-09-18 20:35:56,2012-09-16 10:57:58
6df7e0df0912fe88862287bf9871c50dafe722e6...5ef6ad178521d146ccef84c8f4d2993d5c77c7e6,7,620,0,620,7,2012-07-06 19:20:45,2012-07-06 10:03:04
5ef6ad178521d146ccef84c8f4d2993d5c77c7e6...8435b289890739600436b6c902156fc073752ffb,6,556,0,556,7,2012-07-06 19:20:45,2012-07-06 10:03:05
8435b289890739600436b6c902156fc073752ffb...c24ff30f965b3d94fcee5817b4a33bfc0cb6352a,1,257,0,257,1,2012-07-06 19:20:45,2012-07-06 10:03:06
c24ff30f965b3d94fcee5817b4a33bfc0cb6352a...36840225df08e962156b0df25662e1cfa240f9dd,2,168,0,168,2,2012-07-06 19:20:46,2012-07-06 10:03:07
36840225df08e962156b0df25662e1cfa240f9dd...a3a96a1308a1a11736dd65300295f17cddda4c03,1,301,0,301,1,2012-07-06 19:20:46,2012-07-06 10:03:08
a3a96a1308a1a11736dd65300295f17cddda4c03...eb63bfaadf8d4f43c19c0384c45a9718acd85e66,3,21,1,22,5,2012-07-06 19:20:46,2012-07-06 10:03:09
eb63bfaadf8d4f43c19c0384c45a9718acd85e66...64137fd1cfb46db999f9e4740d7a0983da6264fb,1,198,0,198,1,2012-07-06 19:20:46,2012-07-06 10:03:10
64137fd1cfb46db999f9e4740d7a0983da6264fb...b1ede9a9f232b1416d1487bba3f69a8e88ec75ee,1,5,3,8,3,2012-07-06 19:20:46,2012-07-06 10:03:11
b1ede9a9f232b1416d1487bba3f69a8e88ec75ee...4465b6d6101173481eb5a4b7de6bda97ea03dc19,1,11,6,17,7,2012-07-06 19:20:46,2012-07-06 10:03:12
4465b6d6101173481eb5a4b7de6bda97ea03dc19...312fa9aa122631a307d81c4ca226647e7c001ee8,1,13,3,16,4,2012-07-06 19:20:46,2012-07-06 10:03:13
312fa9aa122631a307d81c4ca226647e7c001ee8...5a29217dda0625707a46f527d17489c0bff0c2c9,2,110,21,131,13,2012-07-06 19:20:46,2012-07-06 10:03:14
5a29217dda0625707a46f527d17489c0bff0c2c9...ff0bfd754d621ae267861441f7b525dff1b0ab27,1,8,0,8,1,2012-07-06 19:20:46,2012-07-06 10:03:15
d1ca788fcd34962a65924843ef1d0c773d565030...185c0874b1adea696b47d2fb78aca9a282a86abb,1,15,3,18,3,2012-04-24 19:11:58,2012-04-24 07:50:00
185c0874b1adea696b47d2fb78aca9a282a86abb...628ab0ea1046800b9520c07d809db886b1ec3693,1,0,1,1,1,2012-04-24 19:11:58,2012-04-24 07:50:01
628ab0ea1046800b9520c07d809db886b1ec3693...321e75c5dc6d6abc76e2349000e93c809ddfcdab,1,27,7,34,5,2012-04-24 19:11:58,2012-04-24 07:50:02
321e75c5dc6d6abc76e2349000e93c809ddfcdab...b55e67752242b449a4577c05341fd6b2fea4d310,5,98,5,103,10,2012-04-24 22:22:16,2012-04-24 07:50:03
b55e67752242b449a4577c05341fd6b2fea4d310...aecff47da67af69dae4e53749277ca2728e31e36,1,14,16,30,5,2012-04-24 22:22:17,2012-04-24 07:50:04
aecff47da67af69dae4e53749277ca2728e31e36...67804c2731f9028ac246f7cea6fd9652386bab33,1,6,2,8,2,2012-04-24 22:22:17,2012-04-24 07:50:05
67804c2731f9028ac246f7cea6fd9652386bab33...f4d80d2639f8ef55c99c3b035c0312969acc7f01,1,4,4,8,2,2012-04-24 22:22:17,2012-04-24 19:21:12
d1ca788fcd34962a65924843ef1d0c773d565030...1b8b2e4dc8fe2e4289ac47ffe55582f1afb67f0c,1,31,17,48,5,2012-04-23 17:39:20,2012-04-23 12:30:21
1b8b2e4dc8fe2e4289ac47ffe55582f1afb67f0c...9a0a30aa4b92a69f63275680820b81c7e34629c9,2,40,0,40,3,2012-04-24 21:55:48,2012-04-23 12:30:22
9a0a30aa4b92a69f63275680820b81c7e34629c9...7d29afd43cac38a332ef9fc176d11ec38d2569d4,3,62,46,108,25,2012-04-24 21:55:48,2012-04-23 12:30:23
7d29afd43cac38a332ef9fc176d11ec38d2569d4...9665627d8cc6f0263f0019e92c67a38223804b57,5,47,38,85,30,2012-04-24 21:55:48,2012-04-23 12:30:24
9665627d8cc6f0263f0019e92c67a38223804b57...18986d5377f19e069afffa6689d507b22f1d6c71,3,5,4,9,3,2012-04-24 21:55:48,2012-04-23 12:30:25
18986d5377f19e069afffa6689d507b22f1d6c71...bb16d5dd30452660e609705252c65aa493bd59e2,1,121,106,227,77,2012-04-24 21:55:48,2012-04-23 12:30:26
bb16d5dd30452660e609705252c65aa493bd59e2...3638eb431bad28aa2bce0ad80ccb6458c97840d3,1,91,83,174,68,2012-04-24 21:55:48,2012-04-23 12:30:27
3638eb431bad28aa2bce0ad80ccb6458c97840d3...5613e8117d4c2093e1abfc10f9ccbe173a1b405f,1,20,12,32,9,2012-04-24 21:55:48,2012-04-23 12:30:28
5613e8117d4c2093e1abfc10f9ccbe173a1b405f...c2b97ecf5109c238fae9051615e413897f347584,1,68,57,125,52,2012-04-24 21:55:48,2012-04-23 12:30:29
c2b97ecf5109c238fae9051615e413897f347584...8a1e7eac689c53f15d986e8525484ca9bd640553,1,21,17,38,15,2012-04-24 21:55:48,2012-04-23 12:30:30
8a1e7eac689c53f15d986e8525484ca9bd640553...4470ef94973cf40bb83864d480cee1e064053879,3,5,16,21,5,2012-04-25 17:30:11,2012-04-25 11:21:53
a8f49338955c4c6b593d6018518c6e0ce9d3059d...f27e7654de8ff609bf5c48e35f2d27ef1ff3676e,1,20,53,73,30,2012-05-29 20:22:13,2012-05-26 03:42:53
b0a4b2d2570974f2050b5d43828dd8146505753e...93b291e07169b3787a39d4cccd3e4f9730b029d2,2,8,8,16,7,2012-06-13 17:23:54,2012-06-13 08:08:50
2a407d7443b0ff2832f0bad0db0dd5b1858fde8d...b75cdfaa882a00f2274e74b21c1a9927d184ed29,2,9,19,28,20,2013-04-26 22:45:09,2013-04-26 22:45:09
92758dd2a2de94c90c0697ef0e8174c3543a47f9...be706c6f4f99ec04c4104bda8820513276af8129,1,0,1,1,1,2013-05-29 19:54:39,2013-05-26 19:11:35
92758dd2a2de94c90c0697ef0e8174c3543a47f9...0aa0321212d6b817783616af4ba1353a46b82179,1,18,8,26,3,2013-05-29 17:00:32,2013-05-29 12:06:29
92758dd2a2de94c90c0697ef0e8174c3543a47f9...b1d04bfcf84cc3464d0bdf62b02443d0d55e3f2b,1,1,1,2,1,2013-05-28 22:15:29,2013-05-28 19:36:44
92758dd2a2de94c90c0697ef0e8174c3543a47f9...25206778aac776fc6cc4887653fdae476c7a9b5a,2,23,4,27,5,2013-05-28 21:33:01,2013-05-25 21:43:34
92758dd2a2de94c90c0697ef0e8174c3543a47f9...4c32e361f6b5fcce037ebfff8b6e42622b3fe509,1,1,1,2,1,2013-05-24 17:55:37,2013-05-24 15:44:03
92758dd2a2de94c90c0697ef0e8174c3543a47f9...90d32d1ffa36390177990cb92e4e2a68c5ec4092,1,6,1,7,2,2013-05-23 17:39:12,2013-05-23 13:34:11
92758dd2a2de94c90c0697ef0e8174c3543a47f9...d0583da838afbc5e039b9f0cbbb9b1fb3aa1f1ae,1,4,3,7,3,2013-05-22 17:14:01,2013-05-22 07:40:39
92758dd2a2de94c90c0697ef0e8174c3543a47f9...b3d6e6e7075967659dc2f5064b4829902cca67da,1,6,6,12,2,2013-05-20 22:50:44,2013-05-20 05:01:20
92758dd2a2de94c90c0697ef0e8174c3543a47f9...66fa1b2c354f79ed48f5986ee700ccb2d167ccbf,1,2,1,3,2,2013-05-16 23:40:00,2013-05-16 22:26:00
92758dd2a2de94c90c0697ef0e8174c3543a47f9...b8612b4da45087d256a0ce339bc65611fb6586f5,1,5,0,5,2,2013-05-15 18:02:19,2013-05-15 17:00:55
b8612b4da45087d256a0ce339bc65611fb6586f5...4c7f1819b3c142ace98269a556bc929c80e7c9fd,3,8,7,15,3,2013-06-10 17:55:42,2013-06-10 14:26:09
92758dd2a2de94c90c0697ef0e8174c3543a47f9...5e2c7cd2c124da05d1807d5ffe61b2771bb755ee,1,6,2,8,2,2013-05-12 22:51:47,2013-05-12 22:50:59
92758dd2a2de94c90c0697ef0e8174c3543a47f9...48bc1755b654cbcc3a48476995d2421580ddd2a5,1,4,2,6,1,2013-05-10 19:13:08,2013-05-07 17:39:46
3a3101c62ecfbde184934f590bab5d84d7ae64a0...bd4ca09d4cddc226ece1bb5b40a74ba281f3e00e,1,3,3,6,2,2013-04-04 21:49:39,2013-04-04 20:41:41
bd4ca09d4cddc226ece1bb5b40a74ba281f3e00e...a749c0bbef068af339ea1ac8843f8ca307b3dd35,1,2,1,3,1,2013-04-04 21:49:56,2013-04-04 20:41:42
b442731638f55b3a556b13986087103112748b10...cc3e4eba723570bf77902c017611ee02bb86c8b3,1,28,2,30,5,2013-04-01 16:24:56,2013-04-01 16:13:31
8b87cfd000c7c98f58279cff698f6e8c7892c059...66ec904b4e5779c2ffd68d3bb8071cc15b2287c7,1,1,1,2,1,2015-01-28 20:42:44,2015-01-28 17:57:35
8b87cfd000c7c98f58279cff698f6e8c7892c059...b9691db4f90164b3de2c2ea7e82ea545f2056f52,2,24,18,42,13,2013-03-17 05:11:02,2013-03-13 11:42:50
b9691db4f90164b3de2c2ea7e82ea545f2056f52...3b691cccb02e660002a7ff414ad21ddac932dc6c,1,20,19,39,4,2013-03-17 05:11:02,2013-03-13 11:42:51
3b691cccb02e660002a7ff414ad21ddac932dc6c...b397ea4863a143e97cb9da76c6c18cc555537d64,4,125,26,151,33,2013-03-17 05:11:02,2013-03-13 11:42:52
b397ea4863a143e97cb9da76c6c18cc555537d64...c8183cd2851965665655738fc399c44f546d5b79,3,29,5,34,6,2013-03-17 05:11:02,2013-03-13 11:42:53
c8183cd2851965665655738fc399c44f546d5b79...6deab24d8832e3cb2f554b827af521b094a2b32d,4,4,4,8,4,2013-03-24 05:29:15,2013-03-23 03:52:44
e39c695d871d877a621e39cef7e5bd208bb7b157...38ef8a76e7c8c3e1be6e6ae96cfccc4191e9eac8,1,1,1,2,1,2013-03-27 16:30:54,2013-03-27 11:04:51
38ef8a76e7c8c3e1be6e6ae96cfccc4191e9eac8...6bf6366cc6ac3de57ddb77e653d246aba333973d,1,2,0,2,1,2013-03-27 16:32:02,2013-03-27 14:19:35
6bf6366cc6ac3de57ddb77e653d246aba333973d...187c00c6c58ba8916a37011b56cb0cb8f2dd1805,1,1,1,2,1,2013-03-27 17:00:50,2013-03-27 15:58:50
4d5dcd976d533779a968fee0350c70f4e05ae5a5...7b9a41987aea4f5eb4afe1ff84302b5c5fa4e77a,1,33,0,33,2,2013-03-19 19:30:28,2013-03-19 19:30:25
7b6e784d70142a23b8ee031b9190e30b9d4d6845...af14b5cf1bec831f90fb5d4136e0205de802b01b,1,1,1,2,1,2013-02-17 22:34:38,2013-02-16 05:47:43
af14b5cf1bec831f90fb5d4136e0205de802b01b...9e5a86f204b5aa9819f4ac7d269fdeae64bec8a3,1,1,1,2,1,2013-02-20 06:58:26,2013-02-20 05:35:26
9e5a86f204b5aa9819f4ac7d269fdeae64bec8a3...e42360c48eebc633b1536904839a1a073780ad8a,1,168,198,366,45,2013-02-21 04:38:23,2013-02-21 04:03:47
e42360c48eebc633b1536904839a1a073780ad8a...f469e8404a625067fd3442c816771ac3ad9055ff,1,2,2,4,2,2013-02-21 23:43:58,2013-02-21 23:32:52
2f19ada7f8a5bb768816cf7334f65ae0ab03c8a7...1bc760aeb784701a702c0a306d464834e96b1f3d,1,1,1,2,1,2013-02-07 18:37:13,2013-02-07 14:01:17
1bc760aeb784701a702c0a306d464834e96b1f3d...8a2cc51b6ff335d8e5abf2d8f7be33412e4b9158,1,1,1,2,1,2013-02-07 18:37:32,2013-02-07 14:01:18
8a2cc51b6ff335d8e5abf2d8f7be33412e4b9158...1323dba6afad29d3cd07e9da85b947bfc2b912de,1,11,19,30,8,2013-02-12 21:11:55,2013-02-12 14:02:30
1323dba6afad29d3cd07e9da85b947bfc2b912de...f4c0035de660f5be4d78b0ba0aa8a7863b89c72f,1,14,1,15,2,2013-02-12 21:15:11,2013-02-12 14:02:31
f4c0035de660f5be4d78b0ba0aa8a7863b89c72f...52dce6d036f1f3859062c475127e498ab3d261b9,1,151,0,151,2,2013-02-27 15:43:58,2013-02-12 14:02:32
52dce6d036f1f3859062c475127e498ab3d261b9...4d31a44a08365b90ff28c5e87e187363e10c2a31,2,45,30,75,4,2013-02-27 17:46:03,2013-02-12 14:02:33
7a0d8db36e1256fd2ac9fa6b97b947e536c2202b...31e54bb94a8acb0fa4fa5099bc455ea8355db621,1,1,1,2,1,2013-02-27 15:31:01,2013-02-27 00:41:34
7a0d8db36e1256fd2ac9fa6b97b947e536c2202b...971f85388f958f5e1b6ceac9973813102ed5a499,1,21,15,36,9,2013-02-25 20:37:04,2013-02-24 19:55:01
b3600c36286517cda38df976946557ce3e87bd82...0b54366cddfc2ad7549b1ab01fe2d5f993d1ab58,1,3,3,6,3,2013-02-24 21:31:05,2013-02-24 00:50:09
0b54366cddfc2ad7549b1ab01fe2d5f993d1ab58...1ca6e587c93bfce9d7b2ef1a98eecb7ce99b38f8,1,1,1,2,1,2013-02-24 21:31:05,2013-02-24 00:50:10
1ca6e587c93bfce9d7b2ef1a98eecb7ce99b38f8...8d8bbc3644aedf1a189ded0d866311e5a0da1ec8,1,1,1,2,1,2013-02-24 21:31:06,2013-02-24 00:50:11
8d8bbc3644aedf1a189ded0d866311e5a0da1ec8...e5a1518ef40aea657aec64c1507553bde6fac105,1,1,1,2,1,2013-02-24 21:31:06,2013-02-24 00:50:12
e5a1518ef40aea657aec64c1507553bde6fac105...165c4b136573405f3d9c3af56a5e67acb058990b,1,1,1,2,1,2013-02-24 21:31:06,2013-02-24 00:50:13
165c4b136573405f3d9c3af56a5e67acb058990b...4c0df34f9906d7c3f73e278d1b02d6899cd79dbd,1,1,1,2,1,2013-02-24 21:31:07,2013-02-24 00:50:14
4c0df34f9906d7c3f73e278d1b02d6899cd79dbd...ce7f3ca89afa7a0fc6f73db44361c8ae2dc31757,1,1,1,2,1,2013-02-24 21:31:07,2013-02-24 00:50:15
ce7f3ca89afa7a0fc6f73db44361c8ae2dc31757...d2bb624c26a449ff3ac557f3fd5a4bfa30f7b367,1,1,1,2,1,2013-02-24 21:31:07,2013-02-24 00:50:16
d2bb624c26a449ff3ac557f3fd5a4bfa30f7b367...c358ed756e6a6c6f762b453dd3698fa06bbb9664,3,3,3,6,3,2013-02-24 21:31:08,2013-02-24 00:50:17
c358ed756e6a6c6f762b453dd3698fa06bbb9664...dd3a4ad95f5d10d8756fdf337004bb41b230b0fe,3,3,3,6,3,2013-02-24 21:31:08,2013-02-24 00:50:18
dd3a4ad95f5d10d8756fdf337004bb41b230b0fe...61a7aaccf40a65840f5017901c8f4c19253c395a,1,2,2,4,1,2013-02-24 21:31:08,2013-02-24 00:50:19
61a7aaccf40a65840f5017901c8f4c19253c395a...e257f0551fdf9351dc3f8796ef3ca11b255b8a04,1,49,49,98,5,2013-02-24 21:31:08,2013-02-24 00:50:20
e257f0551fdf9351dc3f8796ef3ca11b255b8a04...beb5ab184ca2dfbc5a68693761bd7dc8f7044150,2,2,2,4,2,2013-02-24 21:31:09,2013-02-24 00:50:21
beb5ab184ca2dfbc5a68693761bd7dc8f7044150...00eae5ef13ed1d470b1f709d51245ee49197019a,1,1,1,2,1,2013-02-24 21:31:09,2013-02-24 00:50:22
00eae5ef13ed1d470b1f709d51245ee49197019a...9a8a84c319e51eb25bfc0ee44d064617c310aa9e,1,1,1,2,1,2013-02-24 21:31:09,2013-02-24 00:50:23
9a8a84c319e51eb25bfc0ee44d064617c310aa9e...1a2ba8b90fa74a01684b45a7beb88329c4b7793c,1,2,2,4,2,2013-02-24 21:31:10,2013-02-24 00:50:24
1a2ba8b90fa74a01684b45a7beb88329c4b7793c...0b670abd974f50f3bf675d30c093cb7309151ac0,1,2,2,4,2,2013-02-25 05:30:03,2013-02-24 22:48:38
0b670abd974f50f3bf675d30c093cb7309151ac0...b978403aed7f2df46bc4c8a63314959d8982e0ac,5,5,5,10,5,2013-02-25 05:30:10,2013-02-24 22:48:39
b978403aed7f2df46bc4c8a63314959d8982e0ac...f86cad716424019308d9b992468dbed1762dd8a4,1,4,4,8,4,2013-02-25 05:30:15,2013-02-24 22:48:40
f86cad716424019308d9b992468dbed1762dd8a4...ebffb3d03cceabf8d89a62435a4cdf3a22b68b5f,1,1,1,2,1,2013-02-25 05:30:18,2013-02-24 22:48:41
98b57f977456ca2b991353b27181945d54ef9da2...4dac0679feaebbf6545daec14480cf6b94cb74ed,2,10,14,24,14,2013-02-25 17:03:26,2013-02-25 16:39:23
390ac27a18d6d64b050bc331592af2dac919d7d1...42f50f8d0150605ab4da32d283cef2df0bcb51ab,2,29,1,30,2,2013-02-04 18:21:10,2013-02-04 18:21:10
bcd45b4085f9269a536c8fb1963ac8380bfac0e8...0722c805d616eb644a868a995b891470f9e5e30d,3,142,41,183,65,2013-02-05 16:21:02,2013-02-03 05:53:27
0fdd7f5d73feffafb089ef25595dfd2dabe9d403...08c0e7fd4aa2aff0adb4a3fffd6c8ba0dc1dfb3a,1,12,30,42,30,2013-01-28 19:19:59,2013-01-28 19:19:59
53cdd4e1b2017a7580d0c4b7f530f0678985c8dc...33b29fd12c04fb599ff3d2a3235bb187710a9080,1,7,8,15,1,2013-01-29 19:17:44,2013-01-29 19:10:58
53cdd4e1b2017a7580d0c4b7f530f0678985c8dc...574855814f97bf0dc37133574fa3fa2a5a44555d,1,2,2,4,2,2013-01-29 02:58:50,2013-01-28 23:41:32
d3c1472fe35e2575508d80415565822ee2211df5...c3c2e1a09b84dc932d90fa09d1632e5efa34c940,3,34,28,62,11,2013-03-17 05:07:02,2013-03-15 22:21:51
44fe83502edf5391bb3a5997cab01794b4568062...eff80a9fd990de3605063050dae32f969ef18ba8,20,284,78,362,45,2013-01-16 20:48:22,2013-01-16 19:18:48
44fe83502edf5391bb3a5997cab01794b4568062...10746a361689aaa1aa98b8d4e7fb3b8463391864,1,1,15,16,6,2013-01-15 17:38:06,2013-01-15 05:47:33
10746a361689aaa1aa98b8d4e7fb3b8463391864...d94c5e2fa24dce13a3dc1ba178f381cb09bb0853,3,16,12,28,10,2013-01-15 17:38:07,2013-01-15 05:47:34
d94c5e2fa24dce13a3dc1ba178f381cb09bb0853...18648e89e78662e3a6a9a38adfca3e6001cfaf85,1,10,17,27,7,2013-01-15 17:38:07,2013-01-15 05:47:35
18648e89e78662e3a6a9a38adfca3e6001cfaf85...4f4ad3d938beafd785c319664348268bbef11a00,1,4,2,6,2,2013-01-15 17:38:07,2013-01-15 05:47:36
4f4ad3d938beafd785c319664348268bbef11a00...39ea722d829ddc5bb253fbe12333d768965f4fe7,1,38,32,70,6,2013-01-15 17:38:07,2013-01-15 05:47:37
39ea722d829ddc5bb253fbe12333d768965f4fe7...dca48cf520933c028f807f65175c29482a209f23,1,16,17,33,11,2013-01-15 17:38:07,2013-01-15 05:47:38
dca48cf520933c028f807f65175c29482a209f23...7bca0e451b8e502fa882b458d6fc825da80034cb,1,23,16,39,5,2013-01-15 17:38:07,2013-01-15 05:47:39
7bca0e451b8e502fa882b458d6fc825da80034cb...352f58a57ba3050adbdc2dcdcd3839e584f1431b,1,6,8,14,2,2013-01-15 17:38:07,2013-01-15 05:47:40
352f58a57ba3050adbdc2dcdcd3839e584f1431b...b7099a06e8ffe61a06d3e32632e832e59f23bd4d,1,10,11,21,7,2013-01-15 17:38:07,2013-01-15 05:47:41
b7099a06e8ffe61a06d3e32632e832e59f23bd4d...1ca38f85860b33ddc79b1494baf29aecde8616cd,1,3,5,8,2,2013-01-15 17:38:07,2013-01-15 05:47:42
1ca38f85860b33ddc79b1494baf29aecde8616cd...b489097e1dbff7764e35ee260f8397d62a70fbb5,1,3,10,13,2,2013-01-15 17:38:08,2013-01-15 05:47:43
b489097e1dbff7764e35ee260f8397d62a70fbb5...bf883f3006f719ba1ade0180f1764f42cc20b529,1,9,9,18,5,2013-01-15 17:38:08,2013-01-15 05:47:44
bf883f3006f719ba1ade0180f1764f42cc20b529...01a19dfc1ac53011deef492b21e52bf7840cef49,1,18,16,34,5,2013-01-15 17:38:08,2013-01-15 05:47:45
01a19dfc1ac53011deef492b21e52bf7840cef49...bc41bf422e15209860bfc6c898dbd3cd89d5da34,1,5,9,14,2,2013-01-15 17:38:08,2013-01-15 05:47:46
bc41bf422e15209860bfc6c898dbd3cd89d5da34...3bbf2f20f62ec6aa7998d9f7acc942ded6639870,1,18,24,42,5,2013-01-15 17:38:08,2013-01-15 05:47:47
3bbf2f20f62ec6aa7998d9f7acc942ded6639870...7637df131ec9939b737ca284874478cb5c899348,1,5,9,14,2,2013-01-15 17:38:08,2013-01-15 05:47:48
7637df131ec9939b737ca284874478cb5c899348...2f328c3d2e88230a236e3d84d2bd6de59aea578d,2,35,21,56,8,2013-01-15 17:38:08,2013-01-15 05:47:49
2f328c3d2e88230a236e3d84d2bd6de59aea578d...166ec2e96e31bac913f44823dadd6c732d353172,2,62,6,68,7,2013-01-15 17:38:08,2013-01-15 05:47:50
166ec2e96e31bac913f44823dadd6c732d353172...3fde386a40f38dbaa684c17603e71909b862d021,1,1,1,2,1,2013-01-15 17:38:08,2013-01-15 05:47:51
3fde386a40f38dbaa684c17603e71909b862d021...bf44142f5464e913d99f9544787e59fc630f6cc9,2,11,11,22,8,2013-01-16 20:50:23,2013-01-16 18:00:35
44fe83502edf5391bb3a5997cab01794b4568062...51fb3a3dfa4ffeeb210fb0e7d6f631503a5a1dfb,5,97,9,106,14,2013-01-10 19:45:02,2013-01-10 17:45:59
2b05d9f917488f27bbd5592f0927d3a754ad0eb5...6ecc01f26cc38841c8d0c89f24a260067b462f30,1,4,1,5,1,2012-12-27 23:40:09,2012-12-12 18:06:24
6ecc01f26cc38841c8d0c89f24a260067b462f30...15999998fbda60552742275570947431b57108ae,4,18,3,21,5,2012-12-27 23:57:20,2012-12-27 23:57:20
b10c4add03044b7be358ff7231b9ec50016ded4b...b3cf6f3b8d21b32d88313fc709442b78300975db,1,1,1,2,1,2012-12-22 19:48:47,2012-12-22 19:48:47
be95387af2820b039d81d121ac2a74fdf9238073...e8a1f5a2ae53805986b1b965e036450bdfc0c460,1,14,0,14,3,2012-11-26 02:52:42,2012-11-26 02:52:42
93341d805f35cc699c5fc59f852328c9e752272c...462d97daf69951f968f16b6271de9db34f7dd13c,2,39,3,42,5,2012-11-29 19:16:33,2012-11-29 17:00:55
462d97daf69951f968f16b6271de9db34f7dd13c...7c65b2ebb72fcf9b563be3367a088256757343a6,1,6,2,8,1,2012-11-29 19:49:51,2012-11-29 19:11:32
0a1b59eb86e36d7581bcaaa5665162dda65fe356...6cf9614df676dec3b5c14ecc98f917e450a80fef,1,31,31,62,2,2012-12-27 23:30:14,2012-11-27 23:03:21
1250857c6c2695020bce6669a4ff43d57a507d91...0398fc349627a8a55ec4727bfb85fb7fad1f4ff0,1,1,1,2,1,2013-01-06 06:47:27,2013-01-05 14:52:29
61690bf4a1ad499a673995b92cd8ab51104a431c...3bdb5b9f1fe964dc9ac4aa29b7b80b1e89ba84dc,1,4,7,11,2,2013-07-07 17:24:11,2013-07-06 13:53:27
8e8c8817cd3e61d974e02f7276ded1f4cb97d8f3...086cb911533d6f4233e84c93b08da289ecc8a229,1,4,1,5,5,2012-12-18 19:26:24,2012-12-18 19:26:24
d3b34622f699ff14646de4ec1b1ab9afb0bcb056...85064630fcca70eae2ca28807b1770a833c3545f,1,1,1,2,1,2013-04-28 18:57:35,2013-04-27 18:39:04
1e155359bf58d7063f75bdb218987aedf62ad550...22bbddeafe5d5285def3dda76b300efd1363db1e,1,3,1,4,1,2013-10-13 21:28:27,2013-10-13 14:07:49
22bbddeafe5d5285def3dda76b300efd1363db1e...c5f424fd014488bd8a92b97f52bfe47823bc2128,3,18,2,20,3,2013-10-13 23:00:57,2013-10-12 22:29:35
1e155359bf58d7063f75bdb218987aedf62ad550...59c222052801a55bb40a78378ea19c6b7c4ec45d,1,5,5,10,5,2013-10-11 17:35:46,2013-10-11 17:35:46
59c222052801a55bb40a78378ea19c6b7c4ec45d...bffd8098705ffcfeb267951dcdd4e49dd188a7bb,3,12,6,18,9,2013-10-11 17:42:45,2013-10-11 15:58:37
1e155359bf58d7063f75bdb218987aedf62ad550...b0afc02649285febd6155c1c64d2383b856c1c0e,1,7,7,14,1,2013-10-09 19:49:55,2013-10-09 14:35:11
9db9eecfe5c2490d17c0d4bd5452e4cb1d0948c5...bd2f371d34b495ebbc4689604cfc34a825c47d2b,1,10,9,19,8,2013-03-26 18:09:01,2013-03-26 17:28:07
bd2f371d34b495ebbc4689604cfc34a825c47d2b...dc09e9ec43c09cdf803cc4f39f1fcb8ebcf80eb1,1,4,4,8,4,2013-03-29 04:47:06,2013-03-28 21:49:13
dc09e9ec43c09cdf803cc4f39f1fcb8ebcf80eb1...0b6e56dfe6c7f75c2a02cc0cf8731c9e62b6d3d1,1,36,4,40,5,2013-03-29 04:48:12,2013-03-28 21:47:28
0b6e56dfe6c7f75c2a02cc0cf8731c9e62b6d3d1...982ac87316a1cf5126888157bdcbfa32268ebe47,1,1,0,1,1,2013-03-29 04:48:18,2013-03-28 21:47:47
982ac87316a1cf5126888157bdcbfa32268ebe47...ab3aebc15c13d083013591777688cecbcb703fb2,1,12,1,13,3,2013-03-29 04:48:18,2013-03-28 21:48:21
ab3aebc15c13d083013591777688cecbcb703fb2...efa5f82540ac0ea75ac185324a78fa230befa050,1,27,0,27,2,2013-03-29 04:48:27,2013-03-28 21:50:04
790c83cda92f95f1b4b91e2ddc056a52a99a055d...68539758579b3bd1f07fb9e1d800e7875db76c5c,1,7,0,7,1,2012-12-15 18:48:06,2012-12-15 17:46:43
790c83cda92f95f1b4b91e2ddc056a52a99a055d...bfae342c973b0be3c9e99d3d86ed2e6b152b4a6b,1,3,1,4,2,2012-12-15 18:43:11,2012-12-14 22:11:44
131fa518f10521b4a534863331decbfef2875f24...dcc52a0449c7ee10690e23152e63b9798f8a332f,1,896,834,1730,750,2012-11-24 00:37:35,2012-11-24 00:37:35
131fa518f10521b4a534863331decbfef2875f24...647d5183b8dc36b38d19c7a3f388108f245b11d3,1,657,589,1246,550,2012-11-23 07:59:11,2012-11-23 07:59:11
ac47a22a7a3c01d38b39c6896a1965ac0b9c473d...b2ed944af79041b4da151a432064c3b1c1b82fc5,5,25,48,73,20,2013-06-18 19:36:00,2013-01-05 00:02:29
5f737ac91bd869e65bff401ad1108581ac504e22...fd356f6aa8bb75ebef56fbc61caf7e02517fa6d3,1,8,5,13,3,2013-10-24 21:58:37,2013-10-24 01:55:35
5f737ac91bd869e65bff401ad1108581ac504e22...113626537711e290af46548683e02ae0a2f51b6f,1,6,0,6,2,2013-10-23 16:45:53,2013-10-23 15:44:11
5f737ac91bd869e65bff401ad1108581ac504e22...37cb1dd671e5e22cee363f98637a5a58f16be054,2,8,0,8,3,2013-10-23 16:07:09,2013-10-22 13:36:02
5f737ac91bd869e65bff401ad1108581ac504e22...26a07309a6e195fc2d0adc89dcc06f3994ae7603,1,22,84,106,11,2013-10-22 20:28:50,2013-10-19 21:06:07
26a07309a6e195fc2d0adc89dcc06f3994ae7603...633fe50ab7d718dc92b3f3e988296a9aa501af78,1,12,15,27,11,2013-10-22 20:28:52,2013-10-19 21:06:08
5f737ac91bd869e65bff401ad1108581ac504e22...3c123fb8b8f44cb3fbfa266758d0750689be801d,1,13,13,26,4,2013-10-22 20:27:02,2013-10-21 19:36:06
5f737ac91bd869e65bff401ad1108581ac504e22...744db23c2d4399ff345a0ef6f2407c9a494d91dd,1,83,24,107,13,2013-10-22 18:23:31,2013-10-20 16:57:41
902f2f4f0a0bcc6c8d63ad4cd6b75b7eb9d65a72...32238aeb730fda0f66ccc6ec2f1e342af8b9fd04,1,43,2,45,4,2013-01-06 08:17:24,2013-01-06 08:17:24
77b598b438e51d45229fe945e2139a7789a150bc...3b13af9d6cfab0d66cae386cbdc924030ad7a1e8,1,5,5,10,5,2012-11-27 17:47:42,2012-11-26 13:54:28
3b13af9d6cfab0d66cae386cbdc924030ad7a1e8...20fa53855e5479e9903047ba18cc247fd4519db4,1,7,7,14,10,2012-12-02 09:58:40,2012-11-30 11:37:34
20fa53855e5479e9903047ba18cc247fd4519db4...2934975f2df4ab7fd93c0f7a2fff80414d090547,1,12,12,24,1,2012-12-02 10:02:05,2012-11-30 11:37:35
2934975f2df4ab7fd93c0f7a2fff80414d090547...a1549f9b85b4277115941160ba5e897f6784db26,1,229,230,459,116,2012-12-02 10:02:15,2012-11-30 11:37:36
3e53891f85c58b4adb016a429a1f3b7fae78ca03...50b03b04c06f44be0d09bcc2b56723e8de985d9a,1,9,0,9,1,2012-12-11 23:36:13,2012-12-11 23:20:24
3e53891f85c58b4adb016a429a1f3b7fae78ca03...f8fb971eace6ed6fb0f350ade8af6fdd3599272d,2,54,1,55,3,2012-12-11 22:53:32,2012-12-11 21:00:52
3e53891f85c58b4adb016a429a1f3b7fae78ca03...28dae1812bc70f06079cb7d3fd4cdbfa9e59cbeb,1,21,14,35,3,2012-12-11 18:08:00,2012-12-11 10:56:07
5a2c11b6dbecff69336324d73e73b7315053734f...00704e4ba527c7e6a36db9b37d59c719310d878c,1,2,2,4,1,2012-12-07 23:15:59,2012-12-07 23:15:59
00704e4ba527c7e6a36db9b37d59c719310d878c...816f290752cb43c88e31ea1a9e06ec84d559add3,2,5,23,28,23,2012-12-07 23:17:21,2012-12-07 22:18:55
816f290752cb43c88e31ea1a9e06ec84d559add3...dd6fc7ca91f79f9cee70943e64c4a4d4569ca4dd,3,30,30,60,23,2012-12-10 16:35:56,2012-12-09 10:36:17
1c71541ddd51968ca2957063b00da42941d13d98...4db34cc134978012cf3f1b07de981a0418ed1523,1,4,6,10,2,2013-03-21 21:06:19,2013-03-21 11:08:17
4db34cc134978012cf3f1b07de981a0418ed1523...cbfd5e1cbb539b82a34195efd0edde20d45a6439,2,2,2,4,2,2013-03-21 21:06:38,2013-03-21 11:10:28
cbfd5e1cbb539b82a34195efd0edde20d45a6439...c5d5c9a9a3e31b7749e1f7ddfc8825b935eda1eb,1,1,1,2,1,2013-03-21 21:06:44,2013-03-21 11:13:33
c5d5c9a9a3e31b7749e1f7ddfc8825b935eda1eb...25043d8aea7859497c12cb035e6688f76e32ac13,1,3,2,5,3,2013-03-21 21:06:48,2013-03-21 15:45:00
25043d8aea7859497c12cb035e6688f76e32ac13...3aa99df802020f73981d1169c05375d5e2b49cc9,1,2,1,3,2,2013-03-21 21:06:49,2013-03-21 15:44:39
3aa99df802020f73981d1169c05375d5e2b49cc9...b8527d5fa61f4401c38e5992b154d7a323aacbf0,1,4,1,5,2,2013-03-21 21:06:49,2013-03-21 11:05:28
b8527d5fa61f4401c38e5992b154d7a323aacbf0...c9fc4415e2c7d7673cdad34d41114ede3435a395,1,1,1,2,1,2013-03-21 21:06:49,2013-03-21 19:53:38
1c71541ddd51968ca2957063b00da42941d13d98...0d158ebb92c1302d987304fa7b717ba4d72aecdf,1,244,233,477,19,2013-03-20 20:42:49,2013-03-20 12:30:12
1c71541ddd51968ca2957063b00da42941d13d98...048d4d98b35e78c44d93b8009f7b11823660e007,3,55,2,57,3,2013-03-18 22:01:19,2013-03-18 22:01:19
60003340cda05f5ecd79ee8522b21eda038b994b...8d3d28f5dba94a15a79975e4adc909c295c80d80,2,46,2,48,4,2013-09-27 21:47:49,2013-09-27 13:48:13
6f4dd60d0713980cf976f569eb83850f9a28fe3c...c1b5d738bf9228db56f64149f96961b3aaf529a9,1,1,14,15,1,2013-05-07 05:32:58,2013-05-07 05:32:58
89c3bbd808b352a9f4047523b81b72f22eefb868...16a794de889ecc11ccbcd5ecf998a128d6dbfa97,1,3,3,6,2,2013-04-18 16:56:37,2013-04-18 06:42:25
abe601bba52ee6b0bf89d282aa1c3ef5fd89cbb0...019d1e65f5bc715a40b1cd77852af0a649753c56,1,4,0,4,1,2014-02-24 17:07:12,2014-02-20 23:47:47
abe601bba52ee6b0bf89d282aa1c3ef5fd89cbb0...756a042600a3e234e7f1eae92c84d395c6833c6d,1,0,1,1,1,2013-04-30 22:43:48,2013-04-30 12:53:06
fa04ae0be8cca1291a60bc8a393f9c52d2582089...99d3206010ba1fcc9311cbe8376c0b5e78f4a136,2,320,64,384,24,2013-03-25 21:52:33,2013-03-23 17:23:28
7bf7a92f69f8b0af7169af390e53397698fcfa95...e24afab09137d785f07e62aee8936b548436d21f,1,36,33,69,4,2013-03-20 14:41:42,2013-03-19 22:45:26
e24afab09137d785f07e62aee8936b548436d21f...c9f35b8b5013c1aa5977c678b844757a1f61dd5f,1,3,1,4,1,2013-04-03 18:34:18,2013-03-11 08:01:33
c9f35b8b5013c1aa5977c678b844757a1f61dd5f...16d41d42184a4c82d2cd8c41e9eef9784cf437b1,1,5,0,5,2,2013-04-03 18:34:22,2013-03-19 22:45:52
16d41d42184a4c82d2cd8c41e9eef9784cf437b1...71c7b0538f8f037e49a04f415a6fbf0bba2c85ad,2,38,4,42,10,2013-04-03 18:34:22,2013-03-19 22:50:50
71c7b0538f8f037e49a04f415a6fbf0bba2c85ad...9df84e94ed16dfaeb50350d7e8ec36eee3fc213e,1,16,5,21,5,2013-04-03 18:34:22,2013-03-19 22:51:34
19534ee8a7616922082a23db5f9bf0e7dc0e6fd4...6130f86deabe15c78d966b3588f47dbd653ec4fa,3,63,4,67,8,2013-04-10 01:06:44,2013-04-10 00:55:08
19534ee8a7616922082a23db5f9bf0e7dc0e6fd4...9b924eee98332225f63c36c5d9673c47e0a8b769,1,1,1,2,1,2013-04-04 16:54:38,2013-04-04 07:56:03
f5206f1239a2f193aed16bac1c3b8cf71dfbce39...f350cf9ea5058ca0ad9e02033616d574c59ee064,1,25,7,32,1,2013-08-05 18:54:30,2013-07-31 08:15:35
f350cf9ea5058ca0ad9e02033616d574c59ee064...580b4f3acf076f5f3346206d3c54912ffc663d86,1,22,0,22,2,2013-08-05 18:54:31,2013-07-31 08:15:36
580b4f3acf076f5f3346206d3c54912ffc663d86...a8fa8eca3f38ab89ad116575d0a5c47cdd03a7e9,1,72,0,72,1,2013-08-05 18:54:31,2013-07-31 08:15:37
a8fa8eca3f38ab89ad116575d0a5c47cdd03a7e9...164a9cf4303d4a8e5c969e057adf9d700468ddc5,2,6,6,12,6,2013-08-05 18:54:31,2013-07-31 08:15:38
164a9cf4303d4a8e5c969e057adf9d700468ddc5...25fb8ee4450b3366bf1e9536a5585341d35b7b20,1,30,0,30,1,2013-08-05 18:54:31,2013-07-31 08:15:39
25fb8ee4450b3366bf1e9536a5585341d35b7b20...449f5c751c22a12de48c273395540a42460795eb,1,0,13,13,1,2013-08-05 18:54:31,2013-07-31 08:15:40
449f5c751c22a12de48c273395540a42460795eb...63828b844d17d66d18c19375c559ab8678693f97,2,3,3,6,3,2013-08-05 18:54:32,2013-07-31 08:15:41
63828b844d17d66d18c19375c559ab8678693f97...dedb9129d472671c608c7adab5bc5e773e651336,1,8,0,8,2,2013-08-05 18:54:32,2013-07-31 08:15:42
dedb9129d472671c608c7adab5bc5e773e651336...abba35395f859600cca1c04f1eab633963a8646e,2,4,2,6,3,2013-08-05 18:54:32,2013-07-31 08:15:43
abba35395f859600cca1c04f1eab633963a8646e...82cd7e5d3e56c173769bc5fba91e0c6415e208f0,1,8,0,8,2,2013-08-05 18:54:32,2013-07-31 08:15:44
82cd7e5d3e56c173769bc5fba91e0c6415e208f0...5d57cac6ae7c661d430dcc7dd2e44c994bf797be,2,3,3,6,3,2013-08-05 18:54:32,2013-07-31 08:15:45
b5c26758639cd934780620d4dd16854c8fdf8c34...0a2623269ff2996c453667a4abc12fbbbf2194b1,1,0,1,1,1,2013-06-04 09:01:34,2011-11-23 09:41:01
0a2623269ff2996c453667a4abc12fbbbf2194b1...ca35487192c449dc0b22a46af4ec75914a8d4383,1,1,0,1,1,2013-06-04 09:02:27,2012-01-05 22:41:41
ca35487192c449dc0b22a46af4ec75914a8d4383...fb99070303e8e8af4438c0bad76d459af80d3bba,1,1,0,1,1,2013-06-04 09:02:41,2012-05-28 07:46:54
fb99070303e8e8af4438c0bad76d459af80d3bba...ce39c2e04ced177747d02de83f61989dcbcca44e,4,32,1,33,7,2013-06-04 09:11:08,2012-05-23 23:56:24
ce39c2e04ced177747d02de83f61989dcbcca44e...2be50eae75ef1d6c83a0546ebe7309f368b5824f,1,1,1,2,1,2013-06-04 09:11:34,2012-05-31 17:53:45
2be50eae75ef1d6c83a0546ebe7309f368b5824f...bbc284d6ecaa1974c142e95272e866287694ca17,1,1,1,2,1,2013-06-04 09:11:46,2012-06-01 22:29:33
bbc284d6ecaa1974c142e95272e866287694ca17...65db0443710f59a1c05a85688cdccc215ff48333,1,1,0,1,1,2013-06-04 09:12:32,2012-06-21 11:24:14
f4ccd9f1bd00325a52199be008af7230b4b8f5ab...3bbbf18d711eb8fe3390580963c1a071e03cbb38,1,39,0,39,1,2013-03-26 20:14:20,2013-03-26 19:53:49
328455fc588d8b5a9357f9b1c053cfffc8577e15...7b592fadf1e23b10b913e0771b9f711770597266,1,76,0,76,4,2013-03-21 22:29:42,2013-03-21 22:29:42
b2478aa0858811c29061ed32c2686468b89d7296...f50b565a0f3af5a4045d0e713ac43e3f0de3aa9a,1,12,4,16,1,2012-06-01 14:43:10,2012-05-31 11:20:42
b2478aa0858811c29061ed32c2686468b89d7296...bf1712621178340e0f15cb060afc8e650ae72faf,4,0,23,23,9,2012-05-30 16:22:43,2012-05-30 10:22:42
bf1712621178340e0f15cb060afc8e650ae72faf...a3d05510ceb442fd6987eb284bb25d1f38535469,1,0,9,9,1,2012-05-30 16:24:28,2012-05-30 10:22:58
ab35469de0d2d2ba4be58fd0231687ddc9cc3cdc...d2d66f15b620c8e96219cfe339f32e77bfaf69b4,1,1,1,2,1,2010-02-06 18:52:14,2010-02-01 12:43:45
d2d66f15b620c8e96219cfe339f32e77bfaf69b4...8424981934c415bd20643de9cc932bd348dfb115,2,21,2,23,8,2010-02-06 18:55:03,2010-02-01 13:39:03
ab35469de0d2d2ba4be58fd0231687ddc9cc3cdc...717c3972dafa9d792a331b98a09d3cee88c17618,2,3,3,6,3,2010-02-06 18:39:20,2010-02-06 09:35:19
717c3972dafa9d792a331b98a09d3cee88c17618...59332d13b2b23840452180368914921bffe9bfbc,3,93,1,94,9,2010-02-13 23:07:14,2010-02-06 18:40:08
64fdc08dac6694d1e754580e7acb82dfa4988bb9...6df42ab98480dcac473ca7d701cfca4a0051d0c1,6,95,5,100,17,2010-09-01 19:19:36,2010-08-31 22:42:43
64fdc08dac6694d1e754580e7acb82dfa4988bb9...d3e7da8979f6ee3edd88fe53241095921d578285,5,14,1,15,6,2010-08-31 17:49:02,2010-08-30 13:38:38
d3e7da8979f6ee3edd88fe53241095921d578285...90e87b017f93fc606e2d6956766b32e56b4a9a2e,2,2,4,6,2,2010-08-31 17:49:17,2010-08-30 13:39:38
90e87b017f93fc606e2d6956766b32e56b4a9a2e...453842c9b81c6bb1328b0dfc351745615004a77f,2,12,2,14,2,2010-08-31 17:49:30,2010-08-30 13:40:29
64fdc08dac6694d1e754580e7acb82dfa4988bb9...0f5cdf653b8be5b8fad3fb2a3eaecfb9da80d215,2,11,2,13,2,2010-08-27 23:46:26,2010-08-27 20:31:47
64fdc08dac6694d1e754580e7acb82dfa4988bb9...e6eedc31d5c3d448d000eecb678ce891a4800b54,1,5,4,9,1,2010-08-24 17:46:11,2010-08-24 04:52:42
e6eedc31d5c3d448d000eecb678ce891a4800b54...eedce784a7492faa370fd96e372c948cba087965,1,4,5,9,3,2010-08-24 17:46:14,2010-08-24 04:52:43
eedce784a7492faa370fd96e372c948cba087965...9c46c054ae426cf1d064f651615ce699d038d276,2,20,0,20,2,2010-08-24 17:46:15,2010-08-24 04:52:44
9c46c054ae426cf1d064f651615ce699d038d276...ba9eab7bfdcb83ad67f4714507599f378a91b17a,1,2,2,4,1,2010-08-31 16:49:23,2010-08-31 14:49:19
64fdc08dac6694d1e754580e7acb82dfa4988bb9...2b64fc894dada0916558fd0bfd19c50631f978cb,3,58,4,62,11,2010-08-24 16:53:46,2010-08-23 19:16:00
2b64fc894dada0916558fd0bfd19c50631f978cb...655e8d9c92121b1d84fda91b73c4a0daa638cbf8,3,25,1,26,3,2010-08-24 16:54:00,2010-08-24 06:41:14
64fdc08dac6694d1e754580e7acb82dfa4988bb9...ef763129d105ff2b0501da7cd2ff71e99c89b477,1,124,0,124,2,2010-08-22 06:51:21,2010-08-21 04:46:22
ef763129d105ff2b0501da7cd2ff71e99c89b477...b0f0ecd97924ee775e7f3b29366133448f4f8e15,1,9,0,9,1,2010-08-22 06:51:21,2010-08-21 04:48:05
b0f0ecd97924ee775e7f3b29366133448f4f8e15...064ed100b2b3530c4b8c4534aa663d2455b735da,1,3,35,38,4,2010-08-22 06:51:21,2010-08-21 04:08:58
064ed100b2b3530c4b8c4534aa663d2455b735da...92e39e44542b34923294fbb45069b8140d19976d,1,3,28,31,2,2010-08-22 06:51:21,2010-08-21 04:08:59
92e39e44542b34923294fbb45069b8140d19976d...f276872d89c19c07a4035bc41e4b26523dd3b003,1,8,4,12,2,2010-08-22 06:51:21,2010-08-21 04:09:00
f276872d89c19c07a4035bc41e4b26523dd3b003...fb433dc912ffb64364571750bedde988f29e736b,1,7,10,17,4,2010-08-22 06:51:21,2010-08-21 04:09:01
fb433dc912ffb64364571750bedde988f29e736b...a9bf09e19d9ca35e67cd6c5a145fd0e778af82f0,1,2,12,14,2,2010-08-22 06:51:22,2010-08-21 04:09:02
a9bf09e19d9ca35e67cd6c5a145fd0e778af82f0...daf7a0c00039ace8ec965316a0bf8354eb973795,1,112,0,112,1,2010-08-22 06:51:22,2010-08-21 04:09:03
daf7a0c00039ace8ec965316a0bf8354eb973795...b0c6bf4a873d5e178f59aa400d994c2bf58f3bd7,1,11,5,16,4,2010-08-22 06:51:22,2010-08-21 04:09:04
b0c6bf4a873d5e178f59aa400d994c2bf58f3bd7...8d66bb05870d4bc46e9951958f78fc71ffac449b,1,18,18,36,5,2010-08-31 16:50:07,2010-08-31 14:49:20
64fdc08dac6694d1e754580e7acb82dfa4988bb9...bb7306b5a350fd2143347be3d9b7d8588567d715,2,70,33,103,9,2010-08-22 06:04:22,2010-08-19 01:46:46
bb7306b5a350fd2143347be3d9b7d8588567d715...c51c0da2225d65ec1984d40bacbc3f43a0bfa178,19,213,0,213,19,2010-08-22 06:04:25,2010-08-19 01:48:03
c51c0da2225d65ec1984d40bacbc3f43a0bfa178...5a12c8864b9485351547a45fc759dde30dd1d870,2,181,16,197,12,2010-08-22 06:04:29,2010-08-19 01:50:14
64fdc08dac6694d1e754580e7acb82dfa4988bb9...af3147147f39274bd0d47faca196f84c4e9ec68d,2,7,3,10,4,2010-08-20 21:09:04,2010-08-20 15:25:09
64fdc08dac6694d1e754580e7acb82dfa4988bb9...d18f76dccff1fc56221846926edb4542d88f60e0,6,11180,5105,16285,74,2010-08-18 21:06:48,2010-08-17 09:24:38
d18f76dccff1fc56221846926edb4542d88f60e0...a997bf423d4baac5b2286edccd1cef897108397f,2,7,0,7,2,2010-08-18 21:06:54,2010-08-17 09:24:39
a997bf423d4baac5b2286edccd1cef897108397f...de831726decd9c2fcaf7c71136560cf6f5c38a59,1,2,5,7,1,2010-08-18 21:06:54,2010-08-17 09:24:40
de831726decd9c2fcaf7c71136560cf6f5c38a59...b50f37098fcf7efb097c01daa3d60df8b9704025,2,3,1,4,4,2010-08-19 20:00:44,2010-08-19 18:30:01
b50f37098fcf7efb097c01daa3d60df8b9704025...178b33157aba98e34f641408105be54f42cbe5bc,2,55,69,124,16,2010-08-19 22:46:06,2010-08-19 22:31:30
178b33157aba98e34f641408105be54f42cbe5bc...7e36de5859afd77976b7583b2012c238b1ffbb7c,1,1,1,2,1,2010-08-19 22:46:47,2010-08-17 09:24:41
7e36de5859afd77976b7583b2012c238b1ffbb7c...a1e3b669faf7a157f31507213a098076ff1dad7e,2,22,0,22,2,2010-08-19 22:46:47,2010-08-17 09:24:42
a1e3b669faf7a157f31507213a098076ff1dad7e...231682469b2a6de21a30dbd1dc3d9b3bb8b62e0a,1,1,1,2,1,2010-08-22 16:44:45,2010-08-22 16:44:45
231682469b2a6de21a30dbd1dc3d9b3bb8b62e0a...ce518bbd6c891f1b9e172b8cb9212c05d731c18e,1,5,6,11,4,2010-08-26 16:25:53,2010-08-26 07:58:26
64fdc08dac6694d1e754580e7acb82dfa4988bb9...b81f925f709a10b37fb4fcd03629b55bc890a478,2,13,5,18,4,2010-08-18 21:02:02,2010-08-17 06:52:48
b81f925f709a10b37fb4fcd03629b55bc890a478...4c0734578f3eee3fe6282014257edfcd7084174b,1,101,187,288,19,2010-08-18 21:02:02,2010-08-17 06:53:56
4c0734578f3eee3fe6282014257edfcd7084174b...df516fb55891ae57676515d437d0e2cb3c8ad429,1,29,29,58,29,2010-08-18 21:02:03,2010-08-17 06:54:59
df516fb55891ae57676515d437d0e2cb3c8ad429...ff372c7851f36bfe0e113e23d247cb9033e79559,1,7,1,8,2,2010-08-18 21:02:03,2010-08-17 06:56:13
ff372c7851f36bfe0e113e23d247cb9033e79559...94d63ce2abfd8de9dc3c928383270ec6ca3605bb,1,21,0,21,1,2010-08-18 21:02:03,2010-08-17 06:56:46
94d63ce2abfd8de9dc3c928383270ec6ca3605bb...9cbdd76e097b01fa434dec9fdbe73b9cb6361e26,1,160,143,303,18,2010-08-18 21:02:03,2010-08-17 06:57:12
9cbdd76e097b01fa434dec9fdbe73b9cb6361e26...d834c96a0eba93de78aa8252f6fcca39d18343d5,1,120,160,280,44,2010-08-18 21:02:03,2010-08-17 06:57:40
d834c96a0eba93de78aa8252f6fcca39d18343d5...1846e9edf6b9c8b8e84b96eab8753a1420b6b28d,1,6,0,6,1,2010-08-18 21:02:03,2010-08-17 06:59:55
1846e9edf6b9c8b8e84b96eab8753a1420b6b28d...aa8f98c1bfcf162e0bd23d20c34857940f2c2256,3,46,10,56,11,2010-08-18 21:02:03,2010-08-17 07:01:15
aa8f98c1bfcf162e0bd23d20c34857940f2c2256...a1e0ad78b784fd7c47c7bc2847f4813aca4cebaf,3,62,7,69,15,2010-08-18 21:02:03,2010-08-17 07:01:54
a1e0ad78b784fd7c47c7bc2847f4813aca4cebaf...2102440c17f990fcb5c9269459c39c6312e80d1c,3,55,4,59,8,2010-08-18 21:02:04,2010-08-17 23:00:34
2102440c17f990fcb5c9269459c39c6312e80d1c...22e0560a70f4b5bfbbf571647e03fa154a6d6bd1,1,4,0,4,1,2010-08-18 21:02:04,2010-08-17 07:03:07
22e0560a70f4b5bfbbf571647e03fa154a6d6bd1...64048d670b4810125493ff0a2bab88cb12344e7f,1,1,1,2,1,2010-08-18 21:02:04,2010-08-17 07:03:36
64048d670b4810125493ff0a2bab88cb12344e7f...6239af1c6c272eeb2b15359ff0dc25d769d5ac78,1,3,0,3,1,2010-08-18 21:02:04,2010-08-17 07:03:58
6239af1c6c272eeb2b15359ff0dc25d769d5ac78...13dd255e4abb95895aaef72e2b93564be90cb49c,1,19,8,27,4,2010-08-18 21:02:04,2010-08-17 07:04:43
13dd255e4abb95895aaef72e2b93564be90cb49c...5d75a52b3a8870c3c1b27c5d791da5c9267e1fb5,1,7,1,8,4,2010-08-18 21:02:04,2010-08-17 07:05:10
5d75a52b3a8870c3c1b27c5d791da5c9267e1fb5...e69dccf8cd4576be804597b2960aa7d0020a65db,1,6,2,8,2,2010-08-18 21:02:04,2010-08-17 07:05:32
e69dccf8cd4576be804597b2960aa7d0020a65db...f5d3a6f575b12af88561ad5a3b1fc8f866f49056,1,5,0,5,2,2010-08-18 21:02:04,2010-08-17 07:06:06
f5d3a6f575b12af88561ad5a3b1fc8f866f49056...eeb70b6769ad484989c8708a85fef112726a35e1,1,10,4,14,2,2010-08-18 21:02:05,2010-08-17 07:06:56
eeb70b6769ad484989c8708a85fef112726a35e1...d9a680acf68caef16b5f316ed7917d8160d3578a,1,3,3,6,3,2010-08-18 21:02:05,2010-08-17 07:09:58
d9a680acf68caef16b5f316ed7917d8160d3578a...f07df52489c78c33c5c5c1bd973038283c401582,1,15,2,17,6,2010-08-18 21:02:05,2010-08-17 07:10:17
f07df52489c78c33c5c5c1bd973038283c401582...2a70fa4f1e377bc68bcabdc1a550e9970acccda7,1,10,2,12,2,2010-08-18 21:02:05,2010-08-17 07:11:03
2a70fa4f1e377bc68bcabdc1a550e9970acccda7...c2c9a87d4f5a643ef93db7c39fc01c4965bf67a3,1,4,2,6,3,2010-08-18 21:02:05,2010-08-17 07:11:30
c2c9a87d4f5a643ef93db7c39fc01c4965bf67a3...fdc4408a8980392f2cc30dc125906a61edf170ec,1,5,2,7,4,2010-08-18 21:02:05,2010-08-17 07:13:40
64fdc08dac6694d1e754580e7acb82dfa4988bb9...0b9dca434f5d9208a26f47f7ec11453f1cfdfae8,2,5,1,6,3,2010-08-18 20:54:30,2010-08-18 15:58:33
64fdc08dac6694d1e754580e7acb82dfa4988bb9...34597c1f5a77c710dae33092cb8a7cb01c6b21c1,1,7,0,7,1,2010-08-17 01:31:37,2010-08-15 07:20:43
64fdc08dac6694d1e754580e7acb82dfa4988bb9...b221207db9950cb0993a30f38540ff235a0af64e,3,19,1,20,3,2010-08-17 01:28:27,2010-08-16 17:01:02
64fdc08dac6694d1e754580e7acb82dfa4988bb9...6209036c7843f4095c04b5ecc13199cc4eccaf3f,1,40,26,66,8,2010-08-16 03:09:27,2010-08-16 01:08:46
6209036c7843f4095c04b5ecc13199cc4eccaf3f...52b48ef1e40fc2b996e3d3f9cad3d096482d8e49,2,34,3,37,6,2010-08-16 03:09:48,2010-08-16 01:11:06
52b48ef1e40fc2b996e3d3f9cad3d096482d8e49...0e1b50152bfc12d2d286af17993f6356171e9ce5,1,4,4,8,4,2010-08-24 16:56:34,2010-08-23 20:15:47
64fdc08dac6694d1e754580e7acb82dfa4988bb9...ed36854651303dd18156786fc096de611f43912c,4,56,7,63,5,2010-08-15 02:24:23,2010-08-11 22:57:20
64fdc08dac6694d1e754580e7acb82dfa4988bb9...fa57f717cd679fd808845e21d6e51a277b76a15d,1,1,1,2,1,2010-08-13 04:55:17,2010-08-03 10:30:11
64fdc08dac6694d1e754580e7acb82dfa4988bb9...2dbc887eaa6fbd787edfc9472b86b0faeb54e2ae,1,42,2,44,5,2010-08-12 22:16:15,2010-07-29 00:31:01
2dbc887eaa6fbd787edfc9472b86b0faeb54e2ae...e69164ddb9d6092a94915bb984749d48f598cea8,1,68,8,76,5,2010-08-12 22:16:31,2010-07-28 07:43:03
e69164ddb9d6092a94915bb984749d48f598cea8...54baefda8c0bbee461a4cd68dca970d92fddced0,3,46,0,46,3,2010-08-12 22:16:31,2010-07-28 07:43:04
54baefda8c0bbee461a4cd68dca970d92fddced0...70256a3a6780a9fd181edf0bf0e762eb56637c9c,2,22,13,35,4,2010-08-24 17:47:21,2010-08-24 05:36:51
64fdc08dac6694d1e754580e7acb82dfa4988bb9...b1d1058cc348a985a6209f920fab0db592dc83de,3,18,2,20,6,2010-08-11 21:07:31,2010-08-11 20:40:38
64fdc08dac6694d1e754580e7acb82dfa4988bb9...08353ebbab2dfdee50a6daa616ec8b6483cb07c8,6,46,52,98,26,2010-08-11 17:36:00,2010-08-11 08:38:04
08353ebbab2dfdee50a6daa616ec8b6483cb07c8...23cbf11b5c08c6d0ab0fd0d6f2dc5a32ca31c745,5,31,16,47,10,2010-08-11 17:36:03,2010-08-11 08:38:05
23cbf11b5c08c6d0ab0fd0d6f2dc5a32ca31c745...08402b0409bc501deb97cf4388a78ee9f87092c6,3,51,32,83,25,2010-08-11 17:36:05,2010-08-11 08:38:06
08402b0409bc501deb97cf4388a78ee9f87092c6...e6c111b4c092c0dd24c541b9721f5bc04641dcb0,11,123,17,140,28,2010-08-11 17:36:06,2010-08-11 08:38:07
e6c111b4c092c0dd24c541b9721f5bc04641dcb0...e935e62a0fd26ff1f29a98a4ca8fa693f42357a2,1,125,0,125,1,2010-08-11 17:36:08,2010-08-11 08:38:08
64fdc08dac6694d1e754580e7acb82dfa4988bb9...cd035b1cef39811fd3116aa07d99395960ec947a,4,122,3,125,9,2010-08-11 17:21:34,2010-08-10 15:17:51
cd035b1cef39811fd3116aa07d99395960ec947a...2caf20c52b7f646d0a7481c25415c48d687773b2,4,51,12,63,10,2010-08-11 17:21:36,2010-08-10 15:17:52
64fdc08dac6694d1e754580e7acb82dfa4988bb9...59efba64ac144a8838a35ae687b8c5bb6cd43363,1,4,1,5,2,2010-08-11 16:57:43,2010-08-10 03:28:07
59efba64ac144a8838a35ae687b8c5bb6cd43363...1ce584b05843dfa8b0fe31ed3d75bddf1c29c4e0,1,6,1,7,3,2010-08-11 16:58:18,2010-08-10 03:33:44
1ce584b05843dfa8b0fe31ed3d75bddf1c29c4e0...b6b56aceb85fe05dc681ac7ee1249e6b6e26e957,1,3,1,4,2,2010-08-11 16:58:38,2010-08-10 03:32:11
64fdc08dac6694d1e754580e7acb82dfa4988bb9...ad9ac6db5d58de08d0497b9184e86926377c20dd,4,18,4,22,7,2010-08-11 16:36:23,2010-08-07 05:13:39
64fdc08dac6694d1e754580e7acb82dfa4988bb9...aee9c7d6540fe6f66fbbe7be420caa26ae0fa2d9,11,297,20,317,44,2010-08-09 16:01:52,2010-08-05 22:39:25
aee9c7d6540fe6f66fbbe7be420caa26ae0fa2d9...302ad7a9930a34413418b6436f96826070367647,13,209,10,219,41,2010-08-09 16:11:44,2010-08-05 22:40:48
302ad7a9930a34413418b6436f96826070367647...be4f2b408e5a00d123a0ecb04b0c6c48be71dfa1,3,15,2,17,6,2010-08-09 16:11:50,2010-08-05 08:49:55
be4f2b408e5a00d123a0ecb04b0c6c48be71dfa1...90e14525f22c2980d4375dcb5d79e6d5da293a78,2,19,3,22,8,2010-08-09 16:11:50,2010-08-05 23:27:15
64fdc08dac6694d1e754580e7acb82dfa4988bb9...dea007fb4c8170ea007b577698c7b44df6c318b9,5,95,23,118,14,2010-08-06 16:14:22,2010-08-05 08:22:52
dea007fb4c8170ea007b577698c7b44df6c318b9...4d7f7a4ae7cf6caeab6aedc798b6528a4fb88829,1,35,27,62,2,2010-08-06 16:14:28,2010-08-05 08:22:53
4d7f7a4ae7cf6caeab6aedc798b6528a4fb88829...1e57208ef0e48d1d852679a72d3128da333d028d,1,23,5,28,3,2010-08-06 16:14:36,2010-08-05 08:22:54
1e57208ef0e48d1d852679a72d3128da333d028d...7d7b86f75f01cd4a491dbf0170ba36806dacb1c5,2,53,28,81,11,2010-08-06 16:14:44,2010-08-05 08:22:55
7d7b86f75f01cd4a491dbf0170ba36806dacb1c5...5adba90d941cdce2aa32ff5b6f562daebef8c2e4,2,11,2,13,5,2010-08-06 16:14:50,2010-08-05 08:22:56
64fdc08dac6694d1e754580e7acb82dfa4988bb9...57210a678a8bedd222bf4478eeb0a664d9dd5369,1,5,2,7,4,2010-08-04 19:01:10,2010-08-04 01:59:23
64fdc08dac6694d1e754580e7acb82dfa4988bb9...93ce190cd16b4c5ff16cc000eb75bd6e6c3238ac,3,39,1,40,5,2010-08-03 22:14:20,2010-07-28 22:04:29
64fdc08dac6694d1e754580e7acb82dfa4988bb9...3f8fc184c0e2cdc90002cf9a5c11353fe623df23,1,54,11,65,7,2010-08-02 22:48:18,2010-08-02 21:39:30
64fdc08dac6694d1e754580e7acb82dfa4988bb9...7f425db9146b7ec8c67edfd8b49218cc110151ed,1,4,4,8,4,2010-08-02 18:47:07,2010-07-31 03:01:59
64fdc08dac6694d1e754580e7acb82dfa4988bb9...40919c483a28f34d43fbef2a84a294b3554caffd,1,6,0,6,1,2010-07-26 05:33:23,2010-07-23 17:50:44
40919c483a28f34d43fbef2a84a294b3554caffd...76d079aa561a74d2c290d5ab7e3b69549ff325cb,1,6,3,9,2,2010-07-26 05:33:34,2010-07-23 17:50:45
64fdc08dac6694d1e754580e7acb82dfa4988bb9...fc688759b95e6888bb1dc4c4d00d27dca4e59ddb,1,310,173,483,6,2010-07-26 05:07:58,2010-07-24 11:16:35
fc688759b95e6888bb1dc4c4d00d27dca4e59ddb...9f41a91a7d100055fbd527f35b8cddae0bd91cac,1,141,0,141,1,2010-07-26 05:08:02,2010-07-24 11:18:38
9f41a91a7d100055fbd527f35b8cddae0bd91cac...e4e303479b62e474c52ee1f9edd265d7333117d9,1,37,32,69,2,2010-07-26 05:08:13,2010-07-24 11:19:44
e4e303479b62e474c52ee1f9edd265d7333117d9...93a00542eaeb40c31b4de2497f5413a2fc0f36f4,1,13,7,20,2,2010-07-26 05:09:11,2010-07-24 11:20:15
93a00542eaeb40c31b4de2497f5413a2fc0f36f4...68698da540acb0c891b810396d704fef3643c576,1,21,13,34,2,2010-07-26 05:12:47,2010-07-24 11:25:32
68698da540acb0c891b810396d704fef3643c576...f161edebb64f08bfc615fd9c28ebae3333255e2e,1,12,9,21,2,2010-07-26 05:12:50,2010-07-24 11:26:41
f161edebb64f08bfc615fd9c28ebae3333255e2e...60c98d1e80a65c9a893733f7bceda463ef3cb6f7,1,14,11,25,4,2010-07-26 05:12:51,2010-07-24 11:27:58
60c98d1e80a65c9a893733f7bceda463ef3cb6f7...60f20d4bb4f56ae90967d810ffb042e9f76b310d,1,2,1,3,1,2010-08-04 18:21:14,2010-07-30 18:31:22
60f20d4bb4f56ae90967d810ffb042e9f76b310d...8fc0ae80f6938e409e0efa45d6d504c6137744e3,2,3,1,4,2,2010-08-04 18:21:44,2010-07-24 11:29:41
8fc0ae80f6938e409e0efa45d6d504c6137744e3...3f8099fce7779631fe8827a8979d7b57629a36de,1,5,19,24,2,2010-08-04 18:21:44,2010-07-24 11:30:49
64fdc08dac6694d1e754580e7acb82dfa4988bb9...730220de8be669257287e9a1f5dde349ace5426a,2,14,7,21,6,2010-07-26 04:57:23,2010-07-24 14:49:04
64fdc08dac6694d1e754580e7acb82dfa4988bb9...800f11040dec4efc4d94206869d9004b23dd700a,2,136,108,244,42,2010-07-23 21:42:36,2010-07-23 17:03:07
800f11040dec4efc4d94206869d9004b23dd700a...5d274859444260142a77b844ab616f07bf80aaa5,1,47,1,48,24,2010-07-23 21:43:24,2010-07-23 17:04:01
5d274859444260142a77b844ab616f07bf80aaa5...18cdf802ca6e2772b5901f786f59de3843299b1c,2,47,2,49,4,2010-07-23 21:44:38,2008-11-10 23:49:03
18cdf802ca6e2772b5901f786f59de3843299b1c...e877a4c11a947789a8b88234e458164ea16675bd,1,92,90,182,18,2010-07-23 21:45:15,2010-07-23 17:05:24
e877a4c11a947789a8b88234e458164ea16675bd...840b3ca758a42cb1481259521126ba2b02a5447a,2,24,2,26,3,2010-07-23 21:46:28,2008-11-11 00:15:49
64fdc08dac6694d1e754580e7acb82dfa4988bb9...1849f01b5b6b442c131d9b88bf39bb8671058a98,1,1,1,2,1,2010-07-23 18:10:21,2010-06-30 02:44:58
1849f01b5b6b442c131d9b88bf39bb8671058a98...2989f516d54a8d453edefbfe955459d7944aedb5,1,5,2,7,3,2010-07-23 18:13:47,2010-06-30 02:44:59
2989f516d54a8d453edefbfe955459d7944aedb5...4bdf85995b5d21fdb085a480d529c8da0314189e,1,14,5,19,4,2010-07-23 18:16:05,2010-06-30 12:29:08
971ecbd1f8d1468951274d01103f80dd7d32d110...2c048a3038fd4d94e150fbc1dfd2242325ca7db6,2,20,2,22,3,2010-07-23 23:08:14,2010-07-22 13:18:29
2c048a3038fd4d94e150fbc1dfd2242325ca7db6...11af2aaed657d10dea083f5d5cb7f93bb96a7b70,3,24,12,36,4,2010-07-23 23:09:28,2010-07-22 13:18:30
11af2aaed657d10dea083f5d5cb7f93bb96a7b70...dfe7effe7d873015c8624d438b98671083c12e27,1,5,5,10,5,2010-07-23 23:10:58,2010-07-22 13:18:31
dfe7effe7d873015c8624d438b98671083c12e27...56ff37941eb76d3f0097884715ca8b391788a3c9,1,5,8,13,2,2010-07-23 23:12:47,2010-07-22 13:18:33
56ff37941eb76d3f0097884715ca8b391788a3c9...49b7120ef1c915439b01f23f30ddfe64565ec9cc,1,4,10,14,1,2010-07-23 23:12:47,2010-07-22 13:18:34
49b7120ef1c915439b01f23f30ddfe64565ec9cc...ad98a58b3d7a151dca59364b72097b6b875a56f6,1,7,15,22,4,2010-07-23 23:12:48,2010-07-22 13:18:35
53970b92d9dc883669f3a9b79b5e39e73931b331...ac10a85785baee56bb4a04ad5f847d15ffba0893,2,4,3,7,4,2009-12-07 08:41:51,2009-12-07 05:32:50
a3d023d0a3783612053f2149e784b43befceccad...0ce142c944181236f99ea3f7fc72712f3e43d2e2,1,4,1,5,2,2010-03-25 10:07:31,2010-03-22 16:12:53
8fe6177ac640ca36814ad3394d4e86b4ce8e29e3...4c007ae8351a0a2beba57e2930ed21aed141e51e,1,1,1,2,1,2011-05-06 05:14:15,2011-05-06 04:16:17
6f9752d2e29ecbd5d9489e57bfcd28fb030cba97...6329bade6632a9df4b37dd3a7f8d641eed74bbf5,1,5,3,8,2,2010-01-19 20:50:48,2010-01-19 15:13:33
902f235378cb2b2f6dd5dd664b9630c95321f0ae...4da5af3151301d25a25d60a90b8275eaca13de86,2,45,52,97,11,2011-05-11 21:43:56,2011-05-11 21:01:19
902f235378cb2b2f6dd5dd664b9630c95321f0ae...0974c117ff4e17e8b6300519cae0fbc67d34adaa,1,12,9,21,8,2010-04-17 18:30:21,2010-04-17 17:41:08
902f235378cb2b2f6dd5dd664b9630c95321f0ae...b4ca1db968eb57d9cd869337bffa254e0b2c83bd,1,56,40,96,9,2010-04-07 18:09:12,2010-04-07 18:09:12
902f235378cb2b2f6dd5dd664b9630c95321f0ae...67d176300c0a79d5cf65402c641fcec7c5388f29,1,39,1,40,3,2010-02-12 19:21:28,2010-02-12 11:36:12
902f235378cb2b2f6dd5dd664b9630c95321f0ae...158620872737067e4a74ca7aed5302af8debb714,2,14,2,16,4,2010-01-18 18:32:05,2010-01-17 02:05:10
902f235378cb2b2f6dd5dd664b9630c95321f0ae...52eb5173ac0a84c4cd4545176871a7dd8a4da91f,1,8,0,8,1,2010-01-17 00:46:40,2010-01-16 18:05:38
902f235378cb2b2f6dd5dd664b9630c95321f0ae...0a0416a34a7ef5c64f4e0226371e4cab8c1ba982,5,18,1,19,5,2010-01-14 17:24:42,2010-01-13 17:35:31
0a0416a34a7ef5c64f4e0226371e4cab8c1ba982...361df5df77255321b2ca409d892b4c24b7b0441d,3,19,0,19,3,2010-01-14 17:25:15,2010-01-13 17:36:42
361df5df77255321b2ca409d892b4c24b7b0441d...49ff9a7a02266a1b96e2236bc8f8d95e4b9507dd,2,42,4,46,8,2010-01-14 17:25:28,2010-01-13 17:39:51
49ff9a7a02266a1b96e2236bc8f8d95e4b9507dd...b706fcfe93262e485976ed2bc648b779cc47981f,4,11,2,13,5,2010-01-14 17:25:58,2010-01-13 20:17:08
b706fcfe93262e485976ed2bc648b779cc47981f...fc6f19fe2b49928dcb4d2dfac88ca38a47d64cde,1,1,1,2,2,2010-01-17 08:57:51,2010-01-17 08:57:51
fc6f19fe2b49928dcb4d2dfac88ca38a47d64cde...1a893064d7b403625896a2c8bdab39f0f7db61d5,3,8,2,10,4,2010-01-17 21:59:36,2010-01-17 21:59:36
902f235378cb2b2f6dd5dd664b9630c95321f0ae...81d2caefedefa40557baf7af846580f35de3f995,1,1,0,1,1,2010-01-13 20:12:52,2010-01-12 20:09:54
902f235378cb2b2f6dd5dd664b9630c95321f0ae...28fb84382b0eb728534dbe2972bbfec3f3d83dd9,3,109,3,112,7,2010-01-12 22:00:58,2009-09-10 15:25:57
28fb84382b0eb728534dbe2972bbfec3f3d83dd9...69add8e6d20989babdb128cf63decc10c418fcfa,1,41,0,41,1,2010-01-20 09:10:58,2010-01-20 09:08:48
69add8e6d20989babdb128cf63decc10c418fcfa...ae0ba8e20a2fb57299381ba2daa7c6d1863320d0,2,77,45,122,11,2010-01-20 09:21:47,2010-01-20 07:17:11
902f235378cb2b2f6dd5dd664b9630c95321f0ae...d38a30df7dd54c5c6883af1de1a03ec7d523cee5,9,93,13,106,17,2010-01-12 21:17:08,2010-01-12 09:54:44
902f235378cb2b2f6dd5dd664b9630c95321f0ae...eb80042c6a631aee74bd0d1b1dd845784e9788cd,1,1,0,1,1,2010-01-12 03:55:33,2010-01-11 10:41:01
902f235378cb2b2f6dd5dd664b9630c95321f0ae...c5e558a80ad27774b9984258a31fbf46a1d7c152,2,19,2,21,2,2010-01-12 03:50:51,2010-01-11 02:59:54
902f235378cb2b2f6dd5dd664b9630c95321f0ae...7cceca5cccdcf1f0f9caa80b82d26fcff65e6fdf,2,9,0,9,2,2010-01-12 03:47:35,2010-01-11 22:33:48
7cceca5cccdcf1f0f9caa80b82d26fcff65e6fdf...91dc602de9579fe8dc29814819904e2b5a4e92e1,1,5,14,19,1,2010-01-12 03:47:52,2010-01-11 22:34:34
902f235378cb2b2f6dd5dd664b9630c95321f0ae...8b2bd7cdacf71260dbc954316af2bed8e076c182,4,55,2,57,11,2010-01-06 09:16:50,2009-12-28 21:49:00
8b2bd7cdacf71260dbc954316af2bed8e076c182...43015774c3a697abf8efee28e36238fc78cf45d1,1,10,11,21,5,2010-01-06 09:16:54,2010-01-02 21:38:05
43015774c3a697abf8efee28e36238fc78cf45d1...04481adffe7d4d969d7067d7a6d6e5e46e44f1c8,3,173,147,320,5,2010-01-06 09:18:32,2010-01-02 21:38:06
04481adffe7d4d969d7067d7a6d6e5e46e44f1c8...fd0a8c2e6428acb883bf4707de54b3e026c57455,2,25,6,31,9,2010-01-06 09:18:37,2010-01-02 21:43:59
fd0a8c2e6428acb883bf4707de54b3e026c57455...e8189ee90e65094dd46a9e4ee6455d9efa90fa76,1,10,5,15,8,2010-01-16 05:05:35,2010-01-15 06:44:02
902f235378cb2b2f6dd5dd664b9630c95321f0ae...0d344738dc55a75bddbcd9a08ea9a7b401f1aa63,1,24,6,30,4,2010-01-06 09:07:07,2010-01-02 22:04:25
902f235378cb2b2f6dd5dd664b9630c95321f0ae...cd3c095caa6f61b4a2952e7ea167938c5b69bc3d,9,6,18,24,9,2010-01-04 05:17:16,2009-09-20 18:10:14
cd3c095caa6f61b4a2952e7ea167938c5b69bc3d...934f930b3144d03cacd16bc5117ef2afe3b1d04d,1,102,0,102,1,2010-01-04 07:18:39,2009-09-20 18:49:56
934f930b3144d03cacd16bc5117ef2afe3b1d04d...1ee26571e97c64bccecfd26d1a1c1c631412a1b7,3,237,46,283,18,2010-01-04 07:21:32,2009-09-19 21:07:14
1ee26571e97c64bccecfd26d1a1c1c631412a1b7...cee2d6ae6379e7c76e602d55ccc1d4babc1979c0,2,9,6,15,5,2010-01-04 07:25:13,2009-10-11 20:38:11
cee2d6ae6379e7c76e602d55ccc1d4babc1979c0...da165f470ede6540873d33cb8bc2ff8e13c60520,4,173,65,238,29,2010-01-07 22:59:54,2010-01-07 22:59:54
da165f470ede6540873d33cb8bc2ff8e13c60520...730f72840cc50c523fe4cdd796ea2d2fc4571a28,5,140,7,147,13,2010-01-07 23:00:14,2009-09-20 07:03:39
730f72840cc50c523fe4cdd796ea2d2fc4571a28...ba655da537a999670c7b21e0446e774a1f9733ea,3,72,0,72,7,2010-01-07 23:00:14,2009-09-14 09:22:00
902f235378cb2b2f6dd5dd664b9630c95321f0ae...23218bbd2ea7f919b93245489e544a55165ec466,1,2,1,3,2,2010-01-03 08:29:10,2009-12-23 05:27:13
23218bbd2ea7f919b93245489e544a55165ec466...4cefa495ca91ad833084ebf3f73c77997920ae9b,3,33,1,34,7,2010-01-03 08:29:35,2009-12-23 05:27:14
4cefa495ca91ad833084ebf3f73c77997920ae9b...db367136605868f5971d42501a48820ccdcb8b08,1,1,4,5,4,2010-01-10 06:41:28,2010-01-10 04:02:40
db367136605868f5971d42501a48820ccdcb8b08...61ed71dcff8448b0700ef032aa1f962649306624,2,4,14,18,4,2010-01-10 06:41:29,2010-01-10 04:02:41
61ed71dcff8448b0700ef032aa1f962649306624...1c6f5b52b7b13bbc6cf404cb5ef9e64fda37655c,4,50,8,58,7,2010-01-10 06:41:30,2010-01-10 04:02:42
1c6f5b52b7b13bbc6cf404cb5ef9e64fda37655c...3bdfd44309822d4a2c49d381999ad5cc7e61ed5f,1,4,0,4,1,2010-01-10 06:41:31,2010-01-10 04:02:43
3bdfd44309822d4a2c49d381999ad5cc7e61ed5f...a9e11220c2656cc5d7baac4d0735c04f9be46438,1,5,8,13,7,2010-01-15 23:04:20,2010-01-15 22:03:42
a9e11220c2656cc5d7baac4d0735c04f9be46438...f47f1e2ce8b4022113120b32decb4436341dc3aa,3,24,8,32,9,2010-01-15 23:04:31,2010-01-15 22:03:43
f47f1e2ce8b4022113120b32decb4436341dc3aa...9f3d54d193d9edcf443c9dd62789af5e8e47635c,2,14,2,16,5,2010-01-15 23:04:45,2010-01-15 22:03:44
9f3d54d193d9edcf443c9dd62789af5e8e47635c...c8a5672ea5cf593708b29f8279bd651c16047c6e,2,2,2,4,2,2010-01-16 05:40:08,2010-01-16 03:10:03
902f235378cb2b2f6dd5dd664b9630c95321f0ae...8dba1e634af1d973a47fca616a63e7062a256790,2,49,0,49,6,2010-01-02 01:53:46,2009-12-30 10:53:16
8dba1e634af1d973a47fca616a63e7062a256790...fa7151a61edf585abdbb3d2831e7992bf3925671,1,2,1,3,1,2010-01-06 07:40:43,2010-01-01 22:14:06
fa7151a61edf585abdbb3d2831e7992bf3925671...ac0ba18df0c58decfb128336bab51a172c77abc0,4,10,12,22,9,2010-01-06 07:41:50,2009-12-30 10:53:57
ac0ba18df0c58decfb128336bab51a172c77abc0...f445644fd28d31a828731a618e9a9c79be89efd2,1,10,8,18,2,2010-01-06 07:41:50,2009-12-30 10:55:36
f445644fd28d31a828731a618e9a9c79be89efd2...bac8037081735a49bccdc3b3b1457129f9bcc451,1,2,19,21,2,2010-01-06 07:41:51,2009-12-30 10:56:16
bac8037081735a49bccdc3b3b1457129f9bcc451...41a457e4f814a0e514548b3178e7692129f0fcfe,3,3,2,5,3,2010-01-06 07:41:51,2009-12-30 11:01:09
41a457e4f814a0e514548b3178e7692129f0fcfe...7ed7fac45a696ba6343707c7c8f4b268f309be32,1,1,1,2,1,2010-01-06 07:41:51,2009-12-30 11:03:35
7ed7fac45a696ba6343707c7c8f4b268f309be32...6396258368b76d432090c81096755dc1fbc89551,2,2,2,4,2,2010-01-06 07:41:51,2010-01-01 22:15:18
902f235378cb2b2f6dd5dd664b9630c95321f0ae...1349484e341a3ec2ba02a86c8fbd97ea9dc8c756,3,58,4,62,10,2009-12-31 20:19:38,2009-12-30 16:51:53
902f235378cb2b2f6dd5dd664b9630c95321f0ae...8e4c4e7dc322bf6a2cf468152ea71eff26ebc034,1,16,0,16,2,2009-12-31 20:15:01,2009-12-07 11:11:44
902f235378cb2b2f6dd5dd664b9630c95321f0ae...03bd0d601ea842b2db5bd40a1f7f036989f9b517,2,36,1,37,4,2009-12-30 22:08:09,2009-12-30 19:35:31
902f235378cb2b2f6dd5dd664b9630c95321f0ae...f517f1f2e9c9e3abe0fde1b3c9a7bb20fdb5ba55,3,53,3,56,7,2009-12-30 22:01:55,2009-12-30 19:57:42
902f235378cb2b2f6dd5dd664b9630c95321f0ae...2b06b0a02f8d0aa01c8ff19b72c9292afd7a84fe,1,4,0,4,1,2009-12-30 09:09:43,2009-12-30 05:54:44
2b06b0a02f8d0aa01c8ff19b72c9292afd7a84fe...4086010c7c83d907321ae1357569dfcc01710cb6,1,66,0,66,1,2009-12-30 09:09:45,2009-12-30 05:54:45
4086010c7c83d907321ae1357569dfcc01710cb6...c93966906f5d578d06eee0ead8745e608a6e18cf,1,159,0,159,1,2009-12-30 09:09:46,2009-12-30 05:54:46
c93966906f5d578d06eee0ead8745e608a6e18cf...d0f379c2dcf7198d373b3c64444019bed2e24336,3,38,17,55,12,2010-01-03 23:59:14,2009-12-30 05:54:47
d0f379c2dcf7198d373b3c64444019bed2e24336...e11d7b5969704cd5ce39d053414d905bb203886b,5,49,20,69,19,2010-01-04 00:01:05,2010-01-01 07:04:04
e11d7b5969704cd5ce39d053414d905bb203886b...bf96c931994382d99e4e4d55f7b22b6779787a9d,1,1,1,2,1,2010-01-04 08:02:08,2010-01-04 08:02:00
bf96c931994382d99e4e4d55f7b22b6779787a9d...397d596f84209d0e9d17621ce56b5432bc98d368,1,29,6,35,2,2010-01-05 07:37:47,2010-01-05 05:58:30
397d596f84209d0e9d17621ce56b5432bc98d368...d7eed8cbef2d15e87e9002f5e3ce08830b40b292,1,113,0,113,1,2010-01-10 07:38:43,2010-01-08 04:45:10
902f235378cb2b2f6dd5dd664b9630c95321f0ae...d5f53d6d6f20bbd1ec5507824eb213463554b36a,1,24,1,25,2,2009-12-30 08:47:00,2009-12-12 15:00:41
902f235378cb2b2f6dd5dd664b9630c95321f0ae...486a3d716427ac81594fe63d4e9cae64703dbc56,4,4,4,8,4,2009-12-29 02:49:18,2009-12-25 17:12:03
486a3d716427ac81594fe63d4e9cae64703dbc56...488c316334bd9e4e75d4852a50b834298b8cf64d,1,6,3,9,2,2009-12-29 02:49:19,2009-12-25 17:12:04
488c316334bd9e4e75d4852a50b834298b8cf64d...65273bfb9b6991138d298527d971e82e28fe678e,1,3,1,4,2,2009-12-29 02:49:19,2009-12-25 17:12:05
65273bfb9b6991138d298527d971e82e28fe678e...5a518ad4679c91f0d0afd38fcc3cbf04e8699c46,3,11,3,14,7,2009-12-29 02:49:19,2009-12-25 17:12:06
902f235378cb2b2f6dd5dd664b9630c95321f0ae...5717b47c59b0d01d9820dd6d4073d7428d9d4c6e,1,1,0,1,1,2009-12-26 22:12:34,2009-12-26 17:01:07
902f235378cb2b2f6dd5dd664b9630c95321f0ae...15caa41053c465aeabb1a0d2d3d3c12d701bc62d,1,1,1,2,1,2009-12-26 21:59:31,2009-12-26 21:53:45
15caa41053c465aeabb1a0d2d3d3c12d701bc62d...eca4460eeb18b895cb6ca590490073f75fd010a6,1,28,28,56,11,2009-12-26 21:59:34,2009-12-26 21:53:17
902f235378cb2b2f6dd5dd664b9630c95321f0ae...be6ff8196d9890c1875a75b96320b863dd1fe815,1,2,3,5,2,2009-12-26 01:10:10,2009-12-18 06:23:54
be6ff8196d9890c1875a75b96320b863dd1fe815...cfc5789ada444423232fa1533f401b5972eb3f6c,8,160,1,161,19,2009-12-26 01:10:10,2009-12-25 08:30:51
cfc5789ada444423232fa1533f401b5972eb3f6c...9d9a2f4aba3650093bad952cd89e276cde4ed074,2,130,1,131,9,2009-12-26 01:10:10,2009-12-25 18:08:04
9d9a2f4aba3650093bad952cd89e276cde4ed074...4a39f79d3482cd844443b4ef9a8ef9b3d72faa5b,2,17,0,17,3,2009-12-26 01:10:10,2009-12-25 18:31:26
4a39f79d3482cd844443b4ef9a8ef9b3d72faa5b...4421a8235783d0664faa9a1d45be114fd7ad8206,5,77,0,77,6,2009-12-26 01:10:10,2009-12-25 19:57:11
4421a8235783d0664faa9a1d45be114fd7ad8206...8aa38563b22c84b06ea1fff9638cc1f44fda726f,3,20,1,21,3,2009-12-26 01:10:10,2009-12-25 21:40:02
8aa38563b22c84b06ea1fff9638cc1f44fda726f...d58ee6dbf67614ef4854e0d8af8188cd84ae5107,1,10,9,19,10,2009-12-26 01:10:10,2009-12-25 21:55:29
d58ee6dbf67614ef4854e0d8af8188cd84ae5107...27d6b08536838fff0e3568a57cc622ca1c39bf01,1,76,35,111,8,2010-01-11 02:03:21,2009-12-25 22:34:53
27d6b08536838fff0e3568a57cc622ca1c39bf01...dea4562bf5d1c27cd6c01b9cb65c3a8b8ee99a69,4,161,0,161,6,2010-01-11 02:10:36,2009-12-25 23:51:32
003c6abdb27c367747847a76b0a7890d67c794be...8024d5961bf885245d8febcb189a8c71bb46b29f,1,1,1,2,1,2010-03-05 06:02:44,2010-03-04 12:08:28
003c6abdb27c367747847a76b0a7890d67c794be...8f69f72fca989b3ba080aab1dc24bfd1709ce83a,2,11,0,11,2,2010-03-01 09:04:35,2010-02-28 22:19:09
003c6abdb27c367747847a76b0a7890d67c794be...e1327ed5fbaca0af44db89d60c33b641e2f21ee1,2,31,1,32,3,2010-02-23 03:23:49,2010-02-23 01:05:44
ce9d823b9141756b5e60aa6c62653adb08e7213b...995fc2f7e17fab8dd59f31f25870a0823cdb6f27,1,33,15,48,8,2009-12-03 18:04:27,2009-11-27 14:17:05
ce9d823b9141756b5e60aa6c62653adb08e7213b...28044baba6d268d91057398ffa041ee1b931a5e0,2,33,1,34,2,2009-12-02 18:29:00,2009-12-02 18:29:00
2b26e0e18907132eaac2a8163de0cac552217082...fe12d8e84f745303d64757307e9a6a81a6608018,2,26,18,44,8,2010-02-07 23:40:27,2010-02-07 23:30:20
2b26e0e18907132eaac2a8163de0cac552217082...4f41b611481bad08319966f7787fc7c4c7bfaa52,3,10,2,12,5,2010-02-06 04:57:16,2010-02-05 20:57:37
4f41b611481bad08319966f7787fc7c4c7bfaa52...ae6a5609c025d9ac79e54a3a052704e25d885314,7,131,37,168,33,2010-02-06 04:57:22,2010-02-05 20:57:38
ae6a5609c025d9ac79e54a3a052704e25d885314...0c499ea60fda716198c76f2d5febe3998d302afb,1,50,16,66,17,2010-02-06 04:57:24,2010-02-05 20:57:39
0c499ea60fda716198c76f2d5febe3998d302afb...185c04e041fb33191c5828339381fd8c4058a43a,1,8,10,18,5,2010-02-06 04:57:25,2010-02-05 20:57:40
185c04e041fb33191c5828339381fd8c4058a43a...38a81b4e82ebf57549f2fa082b329c36dffc0b18,1,22,8,30,9,2010-02-06 04:57:26,2010-02-05 20:57:41
b344bb19358bcf8cf62c28ce205fdfd8acfa6b6b...0fa2eb530fb748774c5b2f309a471cf048b8d9d9,2,47,4,51,5,2013-01-28 18:31:35,2013-01-28 09:16:33
b344bb19358bcf8cf62c28ce205fdfd8acfa6b6b...5047822347f8d7ad453ad0ea5cbff542569fb7a6,2,34,2,36,5,2013-01-24 23:08:37,2013-01-24 23:08:37
b344bb19358bcf8cf62c28ce205fdfd8acfa6b6b...8b66f7857d470f50a2a24d9b12ed8eec2781cad2,1,21,20,41,20,2013-01-24 20:31:29,2013-01-24 09:10:26
b344bb19358bcf8cf62c28ce205fdfd8acfa6b6b...1187ec99b93aefc3bfb6e360d285245745e1e390,1,6,0,6,1,2013-01-24 20:14:00,2013-01-24 19:18:45
901fd180c9d19025bafefc34e131125628169bdd...cdd9b3c96cc4a01bbc5f2f778e75028ea67a5f91,1,49,13,62,4,2013-03-10 04:59:27,2013-03-09 21:55:37
cdd9b3c96cc4a01bbc5f2f778e75028ea67a5f91...35297089e550c30e6d0f6db2adca5d44d254a7ed,2,33,0,33,3,2013-03-10 07:21:35,2013-03-09 22:00:11
901fd180c9d19025bafefc34e131125628169bdd...d32805dce7bdc45a3e4045e999fc5d56e3b46a82,3,8,8,16,8,2013-02-12 18:05:38,2013-02-12 09:24:44
901fd180c9d19025bafefc34e131125628169bdd...b141a47801d6fb2d68ec48adfe7597ec3ce49c0d,1,4,1,5,2,2013-02-11 23:19:30,2013-02-11 23:13:48
fe73786b482f11e7a37a269c95d222a384fc5a39...c5e366b1f8dd72d7516cf0029fd4bb1a7ec616a9,1,42,0,42,2,2013-02-06 22:02:03,2013-02-06 19:49:01
fe73786b482f11e7a37a269c95d222a384fc5a39...48a8c26c625a4d3631c4f614bceb38933e741408,28,53,48,101,47,2013-02-01 21:53:25,2013-01-21 19:16:20
48a8c26c625a4d3631c4f614bceb38933e741408...2de9b71138171dca7279db3b3fe67e868c76d921,128,902,902,1804,849,2013-02-01 21:53:33,2013-01-21 19:17:53
2de9b71138171dca7279db3b3fe67e868c76d921...0859c969db9d1250cbdb14d34efa1d17209ff45b,1,5,3,8,1,2013-02-01 21:53:33,2013-02-01 18:07:56
0859c969db9d1250cbdb14d34efa1d17209ff45b...19b4d3d4ff40c5418460fb61b0013713211b427b,1,4,0,4,1,2013-02-01 21:53:33,2013-02-01 18:11:24
19b4d3d4ff40c5418460fb61b0013713211b427b...7a7d05b62e7d438582395d3d149ecbbebbaa6062,1,18,6,24,1,2013-02-01 21:54:46,2013-02-01 19:26:35
7a7d05b62e7d438582395d3d149ecbbebbaa6062...afeef30c34116ddc4a091d497f5ac8f4cdde7c65,1,2,2,4,2,2013-02-01 21:54:46,2013-02-01 18:08:56
fe73786b482f11e7a37a269c95d222a384fc5a39...9ef43dd7ad3427f579285e100cc78de124213815,1,14,0,14,1,2013-01-30 20:49:28,2013-01-30 20:47:32
fe73786b482f11e7a37a269c95d222a384fc5a39...4db86e8b6e8002b3113341ad742bf2fd94d4df50,2,23,3,26,3,2013-01-22 00:57:24,2013-01-21 13:00:48
4db86e8b6e8002b3113341ad742bf2fd94d4df50...0b0ecaac2ad984599923999d6d4c32e6111bb73f,1,2,0,2,1,2013-01-22 00:57:38,2013-01-21 13:00:49
dcb11cca50992339af744e25ca5d0f94b478d3b9...d619cfc7490481652833dff820e04263869c8861,1,1,2,3,1,2013-10-30 17:39:42,2013-10-21 17:54:12
dcb11cca50992339af744e25ca5d0f94b478d3b9...f8fc0ee314d0e0c993d2edac8848a4cfe72c771f,1,11,4,15,2,2013-10-28 19:32:18,2013-10-28 19:22:16
f61988125130ac091bfb69bda5d62b0ad8f054c4...c082df24539329c2e75395cf378f0a3fe187c028,6,86,39,125,34,2013-01-06 22:25:06,2013-01-06 16:58:03
c082df24539329c2e75395cf378f0a3fe187c028...c04318e46aae79b8b8df059e2118519d83dfee12,4,44,12,56,22,2013-01-06 22:26:37,2013-01-06 16:58:04
c04318e46aae79b8b8df059e2118519d83dfee12...270be8160493eb25ee43eb7db8dda2504343dc65,3,33,0,33,3,2013-01-06 22:26:37,2013-01-06 16:58:05
270be8160493eb25ee43eb7db8dda2504343dc65...52ed1894b04e7664feaee85c0f14360b415a755c,2,32,12,44,3,2013-01-06 22:26:37,2013-01-06 16:58:06
52ed1894b04e7664feaee85c0f14360b415a755c...f8a1113b47ab6ab329116325a0a78c68efc22485,1,3,3,6,3,2013-01-06 22:26:37,2013-01-06 16:58:07
f8a1113b47ab6ab329116325a0a78c68efc22485...6f525e7100061fb0dbc2d9230cc9948c7c5b2978,4,67,33,100,6,2013-01-06 22:26:37,2013-01-06 16:58:08
6f525e7100061fb0dbc2d9230cc9948c7c5b2978...4b78d7bccdda25290ab6c04bf45d835b4fdfab45,3,13,12,25,8,2013-01-06 22:26:37,2013-01-06 16:58:09
4b78d7bccdda25290ab6c04bf45d835b4fdfab45...9d67b61f739a1a898bc8c9960047ebff0e9c9d09,3,38,18,56,4,2013-01-06 22:26:37,2013-01-06 16:58:10
9d67b61f739a1a898bc8c9960047ebff0e9c9d09...512aaf9453cecfa57dddc61aec2132b936b2ff70,3,19,4,23,4,2013-01-06 22:26:37,2013-01-06 16:58:11
512aaf9453cecfa57dddc61aec2132b936b2ff70...1794e6e0972bec862a29b637e4c4262fa76e97a8,1,19,0,19,1,2013-01-06 22:26:37,2013-01-06 16:58:12
1794e6e0972bec862a29b637e4c4262fa76e97a8...368aa52952deb631b38a89837c4abbb00c5261c1,11,905,3,908,11,2013-01-06 22:26:38,2013-01-06 16:58:13
368aa52952deb631b38a89837c4abbb00c5261c1...6f53feac95f35d470789348c051f6cee93449642,1,7,2,9,1,2013-01-10 22:47:35,2013-01-10 21:24:52
6f53feac95f35d470789348c051f6cee93449642...72aeb18772deeb386da7dd8997b969877bd29e41,2,13,8,21,10,2013-01-16 17:43:35,2013-01-16 13:25:58
b6a3d3353f799c8c5afedb2da4df6e7cdc5d00c9...9b3497cab9986883ff2499722f8758795afa34b7,4,62,55,117,45,2013-01-01 23:32:36,2013-01-01 02:44:05
9b3497cab9986883ff2499722f8758795afa34b7...0c528168dadd4209de0213a16ff811a89ee3f206,1,6,7,13,6,2013-01-01 23:32:36,2013-01-01 02:44:06
0c528168dadd4209de0213a16ff811a89ee3f206...c41244e702fd4fc1039f39a3915ae1e5f165bbf3,5,42,7,49,10,2013-01-01 23:32:37,2013-01-01 02:44:07
c41244e702fd4fc1039f39a3915ae1e5f165bbf3...1b25892636d2f250eb2163301440ee8c8c1ac944,1,73,0,73,2,2013-01-01 23:32:37,2013-01-01 02:44:08
1b25892636d2f250eb2163301440ee8c8c1ac944...46983441ae17b34abee2954b87efeeefbe0768b3,2,20,0,20,3,2013-01-01 23:32:37,2013-01-01 02:44:09
46983441ae17b34abee2954b87efeeefbe0768b3...6f1a31f0aae6dbd5414b81fb6c0f4ff087146fc5,2,31,0,31,3,2013-01-01 23:32:37,2013-01-01 02:44:10
6f1a31f0aae6dbd5414b81fb6c0f4ff087146fc5...cebcab189aa7727af5027f0215e798bbe66f2815,3,22,0,22,6,2013-01-01 23:32:37,2013-01-01 02:44:11
cfd10568b0529c74a9ab1f5baa1c7e285f898105...0d6cf2471f426dd2b742e2285aad78381738be96,1,15,0,15,2,2013-10-28 17:53:03,2013-10-28 17:52:07
01fdc21f6e90f56fc5a49cbba751d9ead19b2f03...8d32e60dbe5185ffdb20bd805b3936ebbcde463a,1,3,0,3,1,2012-05-01 16:40:28,2012-05-01 08:41:42
8d32e60dbe5185ffdb20bd805b3936ebbcde463a...391b1f2003c425773c01799969368a517375b1a4,2,13,2,15,4,2012-05-01 16:40:30,2012-05-01 08:42:24
391b1f2003c425773c01799969368a517375b1a4...e304aeba20d6f26cb95c022704440a36ef309075,1,25,2,27,3,2012-05-01 16:41:13,2012-05-01 08:43:08
222433ee4b57750174875ce6b252d10c009a1fa9...284a126c3ef3dfedede9bc64df4cf3a24600dea5,1,21,0,21,1,2012-03-05 17:31:47,2012-03-05 14:28:07
222433ee4b57750174875ce6b252d10c009a1fa9...3c02396adc0d8836bccc4fbc95edbb3ca8c1f508,4,24,29,53,9,2012-03-05 07:00:57,2012-03-04 04:41:26
222433ee4b57750174875ce6b252d10c009a1fa9...b22939a2860604bec718cfd751e930f3a8afd1cc,1,1,1,2,1,2012-03-02 23:55:09,2012-03-02 22:50:01
b22939a2860604bec718cfd751e930f3a8afd1cc...38916c5b4740f6db09dc140a84bb470dfb582366,2,12,0,12,2,2012-03-05 02:28:59,2012-03-03 11:00:29
222433ee4b57750174875ce6b252d10c009a1fa9...dd6139971a18e25a5089c0f96dc80e454683ef0b,1,3,1,4,2,2012-03-02 22:40:14,2012-03-02 13:55:57
aba5f57c8fbb04abc5d286310969c1f767793930...d9f5ef7a4a760d58f1f824f9fb8c12ef0371d3a9,4,27,3,30,5,2012-04-26 17:14:45,2012-04-26 16:59:22
adc3a81ce21754595d6263c78f3ceac5b9bb30d9...5bed9f6a61e693fd667b8bdc1d4dd591f2a1377a,2,27,1,28,2,2012-05-14 18:47:20,2012-05-14 18:47:20
660e20f5c72ba363c08f0d3fca60c9680f296c40...62ed0728fe52312f270760187b3280bc51b6c2f0,2,18,1,19,2,2012-02-27 01:08:59,2012-02-27 01:08:59
5e69491bf2a1be730ff73c2ce4c0ebd1f9e412c9...d5fdae67379778502ca8b3b3186ce4692d912e30,1,47,44,91,5,2012-04-25 17:43:20,2012-04-24 22:45:07
d5fdae67379778502ca8b3b3186ce4692d912e30...72b64b44e77112b93e7b046e54c62a01e69cef3d,1,26,28,54,9,2012-05-03 20:15:09,2012-04-24 22:45:08
72b64b44e77112b93e7b046e54c62a01e69cef3d...66a3d20b8f8566581e8aa46e35555f353074f232,1,10,10,20,7,2012-05-03 20:15:09,2012-04-24 22:45:09
66a3d20b8f8566581e8aa46e35555f353074f232...abc390989f1086aa3a8620a81f87622a78cf393b,1,7,7,14,6,2012-05-03 20:15:09,2012-04-24 22:45:10
abc390989f1086aa3a8620a81f87622a78cf393b...f348ac923c9f834c3cdc434e6266872cf5710b71,1,24,10,34,3,2012-05-03 20:15:09,2012-04-24 22:45:11
f348ac923c9f834c3cdc434e6266872cf5710b71...9f2fb4a3737c86e245ce365f6ad8f901ad397d6f,1,8,4,12,4,2012-05-03 20:15:09,2012-04-24 22:45:12
9f2fb4a3737c86e245ce365f6ad8f901ad397d6f...93c603fcb7bfbe3d4bfb108463166b850de638f3,1,35,35,70,7,2012-05-03 20:15:09,2012-04-24 22:45:13
93c603fcb7bfbe3d4bfb108463166b850de638f3...989c0e5d02b1844b44e5ea2ff61a2cbd2f054a25,1,31,29,60,11,2012-05-03 20:15:35,2012-04-24 22:45:14
989c0e5d02b1844b44e5ea2ff61a2cbd2f054a25...144e7090045a703c8f5d140474f202ba4f38ac9a,1,5,3,8,4,2012-05-03 20:15:35,2012-04-26 22:26:59
144e7090045a703c8f5d140474f202ba4f38ac9a...5fa0441844b1d23e6a2a3c369651dc8c13712ef6,1,10,9,19,2,2012-05-03 20:15:35,2012-04-26 22:27:00
5fa0441844b1d23e6a2a3c369651dc8c13712ef6...d12229f532dc88024c249fb3e2ca0ac921cc14a9,1,19,18,37,11,2012-05-03 20:15:35,2012-04-26 22:27:01
d12229f532dc88024c249fb3e2ca0ac921cc14a9...1900b976a4a3d06c22d57031efece81947539337,1,7,7,14,3,2012-05-03 20:15:36,2012-04-26 22:27:02
1900b976a4a3d06c22d57031efece81947539337...d7826d5427724d878e52bce49139f96187527fc3,1,25,15,40,13,2012-05-03 20:15:36,2012-04-26 22:27:03
d7826d5427724d878e52bce49139f96187527fc3...3f3aa1bc6215fad0d31d1eae5f4c599c6847a02f,1,10,11,21,7,2012-05-03 20:15:36,2012-04-26 22:27:04
3f3aa1bc6215fad0d31d1eae5f4c599c6847a02f...f006c42a11d5e97f5abc07b23f353ca64d5180e2,1,11,4,15,7,2012-05-03 20:15:36,2012-04-26 22:27:05
f006c42a11d5e97f5abc07b23f353ca64d5180e2...423a1afc0bc48bb5520d518b521ecf9d79f59bb3,1,4,4,8,4,2012-05-03 20:15:36,2012-04-26 22:27:06
423a1afc0bc48bb5520d518b521ecf9d79f59bb3...28e6a34e254a1ee5fc3d106e4a6117fd02254589,1,96,29,125,18,2012-05-03 20:15:36,2012-04-26 22:27:07
28e6a34e254a1ee5fc3d106e4a6117fd02254589...663c1295d8a6a591a805692d311e1d709e3193e2,1,3,1,4,2,2012-05-04 16:17:50,2012-05-03 22:12:54
5609586f652269186d74a4661600dcbd00b1322a...bd444cadb53ce9030fe79f2cdb1570e1a49d4877,1,6,40,46,5,2012-02-21 23:29:29,2012-02-21 23:29:29
7795e424c6e61e6458b700b70a4b231c6cec297d...7eba50468643107ec96d63d7bb267edf60ec6d59,1,2,2,4,2,2012-05-08 16:47:04,2012-05-02 17:27:03
7eba50468643107ec96d63d7bb267edf60ec6d59...f6e1224d6b898013ec8390b8f489a505ddb618b5,1,11,11,22,11,2012-05-08 17:15:41,2012-05-02 13:49:25
f6e1224d6b898013ec8390b8f489a505ddb618b5...b41597d3d529fe401c554c1379fed7b71fcfc9e8,1,13,13,26,13,2012-05-08 17:15:52,2012-05-02 13:49:26
b41597d3d529fe401c554c1379fed7b71fcfc9e8...232f61300b4b18493203d0609702903c933a1603,1,44,55,99,38,2012-05-08 17:16:07,2012-05-02 13:49:27
232f61300b4b18493203d0609702903c933a1603...9bdd868744401593baf7a872bd0986ab3b2e6acc,1,3,0,3,1,2012-05-08 17:16:14,2012-05-04 18:47:35
9bdd868744401593baf7a872bd0986ab3b2e6acc...1ef3ab1648eb55e3e8426b44cc2592c4ee528b14,1,12,12,24,12,2012-05-08 17:16:14,2012-05-04 16:27:54
1ef3ab1648eb55e3e8426b44cc2592c4ee528b14...080d4221396ec31bd8e9e5adadd19d8e8ed37c67,1,23,23,46,20,2012-05-08 17:16:14,2012-05-04 16:59:53
080d4221396ec31bd8e9e5adadd19d8e8ed37c67...b9f3b4c1ba0eb82340c49f2630f297f0f0e3cf3c,1,129,125,254,113,2012-05-08 17:19:30,2012-05-04 18:28:08
b9f3b4c1ba0eb82340c49f2630f297f0f0e3cf3c...90d25380df43dd4495e5f936e0152cbe4dc37d92,1,9,8,17,8,2012-05-08 17:19:35,2012-05-04 18:54:44
90d25380df43dd4495e5f936e0152cbe4dc37d92...1ec31a33e2956027cc7ecd5c17f66585f2ee1356,1,148,130,278,111,2012-05-08 17:19:36,2012-05-08 17:03:30
ead8eb8c1092ce2d94d70872946829a7a946ae9d...418a1435f19b8105de2ee94b54cc2962bc9b5f03,2,134,7,141,20,2012-03-14 03:44:29,2012-03-13 17:00:00
ead8eb8c1092ce2d94d70872946829a7a946ae9d...a8ea1b7a5580bc4377818fb6718d55d4b735dae8,1,1,1,2,1,2012-03-05 17:36:09,2012-03-05 13:48:49
80a3f53424b2e3d6d7b9463dbd3faa888ced947f...0dbe6592ccbd1a394a69a52074e3729d546fe952,1,2,2,4,1,2012-03-06 20:32:24,2012-03-06 14:50:37
bb8cbe7861546a0646d38d7cd49dc245001ec5c5...69f4e08f535d4e5a035069a64d1ebaea7be55d83,2,3,2,5,3,2012-03-05 22:29:07,2012-03-05 22:29:07
db65f0fc3b1e16d5cc4ebf00f5af56c91546d839...31c2373d39558f98222a1fd8b83ed74ccaa87161,1,182,0,182,1,2012-03-01 17:12:02,2012-03-01 12:26:38
31c2373d39558f98222a1fd8b83ed74ccaa87161...af9fedc12873bf331019a502ed1fc944fa986713,3,16,3,19,6,2012-03-01 17:13:06,2012-03-01 12:26:39
af9fedc12873bf331019a502ed1fc944fa986713...666c92a229de10f8bbfc33cf6f92aad8733f0002,2,4,2,6,3,2012-03-01 17:13:53,2012-03-01 12:26:40
666c92a229de10f8bbfc33cf6f92aad8733f0002...5e0ec15eb131075d0c3e61b33bcc7931bbc8bc08,2,3,2,5,3,2012-03-01 17:14:00,2012-03-01 12:26:41
5e0ec15eb131075d0c3e61b33bcc7931bbc8bc08...7a7159ace6c93ea6c55086dfc7ba7533a3e3c07d,2,5,4,9,5,2012-03-01 17:14:16,2012-03-01 12:26:42
7a7159ace6c93ea6c55086dfc7ba7533a3e3c07d...1b058bc30df5f79fe7449cacd8ae7128944327f7,3,76,44,120,23,2012-03-01 17:14:58,2012-03-01 12:26:43
1b058bc30df5f79fe7449cacd8ae7128944327f7...c4432d5511f2897b56cd921632c86c1e2ca78159,1,19,0,19,1,2012-03-01 17:15:12,2012-03-01 12:26:44
c4432d5511f2897b56cd921632c86c1e2ca78159...969fe57b844a514747c1d5d66e0698dc53ed473d,4,30,2,32,10,2012-03-01 17:15:47,2012-03-01 12:26:45
969fe57b844a514747c1d5d66e0698dc53ed473d...df44483a5dde62f4b49c80fd90d7fe12ddcfb084,8,32,8,40,11,2012-03-01 17:15:58,2012-03-01 12:26:46
507fba2b98a85fab42a89d93240d2e09d6245d26...3724cc7c58df709cffbf6cc0701d1ca6fa5a5ba2,1,35,6,41,7,2012-02-27 07:11:10,2012-02-27 07:11:10
559357b508847df5a5736ed7130f6bccab52d044...26e4266f2fee3454370885ff480b38d045ca1731,2,1,1,2,1,2011-09-16 21:06:19,2011-09-16 19:55:03
1be9d84b2ed18c2b2e2d6a459d2b6d48d5ab86e5...55c4a673070f40f2ef12d0be269e95f1df6825a9,6,56,24,80,8,2011-08-22 23:00:36,2011-08-20 21:49:48
55c4a673070f40f2ef12d0be269e95f1df6825a9...587a9ee7da348f5e6696720d770d0e0da597827c,2,10,1,11,2,2011-08-22 23:03:43,2011-08-20 21:49:49
4bbb830a35c5134b612a990f04ee16678ec0c674...2137ce01f83d254e4917c107901a5a04f61e8c16,3,8,2,10,4,2013-04-07 15:58:30,2013-04-07 15:58:30
0e73bb4dfc15472d0671c37fe03d577cd0af2380...6ceb270ce6f65cf4bc2a22830f96e0cc838b3fec,3,4,9,13,5,2011-04-19 18:51:00,2011-04-19 18:51:00
661bfd13b49db0affebbdda5ac478ebe67634947...fe6c64ab0b2b568755a6686c0a435fa95ef619bb,1,4,23,27,21,2012-03-03 06:26:34,2012-03-03 02:15:34
fe6c64ab0b2b568755a6686c0a435fa95ef619bb...78ed1d2d63390694cb6c451896086fb7338f75b6,1,4,1,5,2,2012-03-03 07:06:08,2012-03-03 00:37:35
78ed1d2d63390694cb6c451896086fb7338f75b6...b2c8c6d944722f9a4f27370f4e89d13f61243302,1,4,3,7,1,2012-03-05 05:11:06,2012-03-04 16:50:43
661bfd13b49db0affebbdda5ac478ebe67634947...1b5b2b641adb1735086a58f4a77c72ba34c87231,1,289,274,563,35,2012-03-02 23:19:59,2012-03-02 09:08:28
1d4ac88d674b5d226db5348e6cd45f64273261d2...7ac1c0adeb52de2995187cf6c61cfb5853666eda,1,181,121,302,107,2012-02-28 04:24:54,2012-02-28 04:24:54
4340a813d007b592534de664d152d66417dbe809...f31dfa604c83fd998f7b57942a7bac4defc8c435,1,1,0,1,1,2007-11-01 22:37:34,2007-11-01 14:01:58
ca5e9495607c2abb4b665b75d3d96a457fa4c5dd...ee1d8ee0f0f3faaa72f5c4886e61befaf7915718,1,3,0,3,1,2010-05-01 19:40:12,2010-04-30 16:30:31
ca5e9495607c2abb4b665b75d3d96a457fa4c5dd...01bdab84e31763a98206c31cf99b9dc3cb221356,1,45,20,65,4,2007-10-17 06:47:36,2007-10-16 14:36:48
01bdab84e31763a98206c31cf99b9dc3cb221356...d05ddec51e4e23923f8f6c633f0a125c9a27a391,2,52,3,55,7,2007-10-17 06:47:36,2007-10-16 14:36:49
d05ddec51e4e23923f8f6c633f0a125c9a27a391...151534515682695348a8172f399f4bf025154a5f,2,80,0,80,4,2007-10-17 06:47:37,2007-10-16 14:36:50
151534515682695348a8172f399f4bf025154a5f...51e057cf808eb1c277da08f42d0ccd611ea315cc,2,38,1,39,4,2007-10-17 06:47:37,2007-10-16 14:36:51
51e057cf808eb1c277da08f42d0ccd611ea315cc...207f1a75e7e4d14286aeed107af7c56dc811797b,1,21,21,42,21,2007-10-17 06:47:37,2007-10-16 14:36:52
ca5bb5d5390e4ec709ca3e11c451c58a836d4ee6...98158e9cfd2808613f305bf587ce697762c884bb,7,33,43,76,30,2007-10-21 05:30:39,2007-10-19 19:47:53
98158e9cfd2808613f305bf587ce697762c884bb...f364cb88238bbb468b0e076c53a055bcb8603b60,1,48,55,103,10,2007-10-21 05:30:39,2007-10-19 19:47:54
f364cb88238bbb468b0e076c53a055bcb8603b60...dc1bfdcd1a8af81885f1831c5e6dcfe5cf61372e,1,7,23,30,5,2007-10-21 05:30:39,2007-10-19 19:47:55
dc1bfdcd1a8af81885f1831c5e6dcfe5cf61372e...d5535ec75ce1cdf57ef52b57c58c548121ce99ba,1,3,35,38,3,2007-10-21 05:30:40,2007-10-19 19:47:56
d5535ec75ce1cdf57ef52b57c58c548121ce99ba...477822c35dbf3d5f16fce1425638e761e60ede3d,1,16,40,56,8,2007-10-21 05:30:40,2007-10-19 19:47:57
477822c35dbf3d5f16fce1425638e761e60ede3d...f3b33f1d220056243d3c1da154d3859410630189,2,25,2,27,6,2007-10-21 05:30:40,2007-10-19 19:47:58
f3b33f1d220056243d3c1da154d3859410630189...cc41fa8da9b9e9d23221d3be47a80409a89732d4,1,44,61,105,18,2007-10-21 05:30:40,2007-10-19 19:47:59
cc41fa8da9b9e9d23221d3be47a80409a89732d4...2d22c208304156892fd6674e0055a3212c1e2d2e,2,65,8,73,7,2007-10-21 05:30:41,2007-10-19 19:48:00
2d22c208304156892fd6674e0055a3212c1e2d2e...088fab5fc48ebb8b476c3b32dd25df3aa4236f94,1,18,21,39,12,2007-10-21 05:30:41,2007-10-19 19:48:01
088fab5fc48ebb8b476c3b32dd25df3aa4236f94...80ccaa78a8b95ad3b4f6e24dc35a9aa3cae5fd86,1,37,33,70,3,2007-10-21 05:30:41,2007-10-19 19:48:02
80ccaa78a8b95ad3b4f6e24dc35a9aa3cae5fd86...21edd3f197df80e9493233a3b9849b61764ebf46,1,18,28,46,14,2007-10-21 05:30:42,2007-10-19 19:48:03
21edd3f197df80e9493233a3b9849b61764ebf46...a0ae35ae2d92cc706f902227cb0f34e2a2f0fd50,1,6,1,7,1,2007-10-21 05:30:42,2007-10-19 19:48:04
a0ae35ae2d92cc706f902227cb0f34e2a2f0fd50...7683b6e81fa0f1f55d4974d69fb87c7c7b6b394e,1,3,4,7,4,2007-10-21 05:30:42,2007-10-19 19:48:05
7683b6e81fa0f1f55d4974d69fb87c7c7b6b394e...546bb5823249678bc6ad11e65661d896ed83448a,1,28,33,61,14,2007-10-21 05:30:42,2007-10-19 19:48:06
7a461b5a33239cfba3bbf0a1deef544c7f1dcfeb...bf1ee636780f3fcaf358827168fa8a0e26c598e2,1,1,1,2,1,2007-09-18 21:00:20,2007-09-18 09:29:09
bf1ee636780f3fcaf358827168fa8a0e26c598e2...5c633a4cbeb95fc86c9b3e6126749cf34a2691b5,3,14,4,18,5,2007-09-18 21:00:20,2007-09-18 08:15:34
5c633a4cbeb95fc86c9b3e6126749cf34a2691b5...3d845d77639a8f91b9774b830d1a2d986a791489,1,1,1,2,1,2007-09-18 21:09:12,2007-09-18 10:12:58
3d845d77639a8f91b9774b830d1a2d986a791489...cd894ee9adf0c026b74761d7b1c0d8dabe4ff4e1,1,5,2,7,2,2007-09-18 22:19:47,2007-09-18 22:19:47
cd894ee9adf0c026b74761d7b1c0d8dabe4ff4e1...bd43098c26cca4e831405d6114df5ad911550124,1,6,5,11,1,2007-09-19 00:07:45,2007-09-18 23:50:42
bd43098c26cca4e831405d6114df5ad911550124...8ae674952c8f301034e8ae9dceff38dda740623b,1,4,4,8,2,2007-09-19 00:38:52,2007-09-18 12:26:09
4f337e24662f07513fd6e8388f27f13dbe44cadc...a85d1b69172f397e815e1ce02db41e4b82b86162,1,344,0,344,1,2007-09-24 00:14:03,2007-09-23 22:51:40
a85d1b69172f397e815e1ce02db41e4b82b86162...2ae4fd7695abcf2ab36f3fe984cc4ca44559635f,1,1,1,2,1,2007-09-24 00:14:03,2007-09-23 22:51:41
2ae4fd7695abcf2ab36f3fe984cc4ca44559635f...d38eb710d92864b0b1f7cd36f17e273e3d8c735c,1,14,6,20,3,2007-09-24 00:14:03,2007-09-23 22:51:42
d38eb710d92864b0b1f7cd36f17e273e3d8c735c...aec7b362ad07e1a2c58051c8db653dabffee8960,4,85,0,85,5,2007-09-24 00:14:03,2007-09-23 22:51:43
aec7b362ad07e1a2c58051c8db653dabffee8960...d08af0ad745869a4fe36bc8df4f9804edfb74eb9,3,36,2,38,6,2007-09-24 00:14:03,2007-09-23 22:51:44
d08af0ad745869a4fe36bc8df4f9804edfb74eb9...d66424c4ac661c69640765260235452499d80378,3,45,6,51,8,2007-09-24 00:14:03,2007-09-23 22:51:45
41ef95aea7c8d8a337af693b601511e099cc468f...2ecb5ea2ad375017eedf73bd0130fa9ca33010d2,6,1,4,5,4,2007-09-26 00:34:12,2007-09-25 14:03:46
2ecb5ea2ad375017eedf73bd0130fa9ca33010d2...df3a02f6125f7ac82b6e81e3e32cd7ca3c7905ee,1,6,0,6,3,2007-09-26 00:35:16,2007-09-25 06:36:38
df3a02f6125f7ac82b6e81e3e32cd7ca3c7905ee...be6ff208d8248c3f282df14fdf3c08db57e92007,2,24,7,31,8,2007-09-26 00:46:43,2007-09-25 15:42:36
be6ff208d8248c3f282df14fdf3c08db57e92007...376ccb8cbb453343998e734d8a1ce79f57a4e092,1,30,18,48,24,2007-09-26 00:46:50,2007-09-25 15:42:51
376ccb8cbb453343998e734d8a1ce79f57a4e092...dad4e32c4658f12a6eaa2decead5d77678911d95,1,2,2,4,1,2007-09-26 00:46:54,2007-09-25 15:43:04
dad4e32c4658f12a6eaa2decead5d77678911d95...ae830ed7f50377e64b774ce87441ff4538f04ad7,1,8,2,10,2,2007-09-26 00:49:40,2007-09-25 15:43:44
ae830ed7f50377e64b774ce87441ff4538f04ad7...5166810b1e16b22e342f2181a3535e70c6e7a119,1,4,4,8,4,2007-09-26 07:39:09,2007-09-26 01:30:13
41ef95aea7c8d8a337af693b601511e099cc468f...f31a522a2d64a5c7d83047e9234e1722ef63985e,2,50,6,56,5,2007-09-25 07:31:12,2007-09-24 02:19:42
f5f6cb87defc4b7e8ba6cc6e82f616bef47ea6b0...039bc64e886716593d59910694a6c8ed5b72c515,7,25,34,59,14,2007-11-14 23:08:04,2007-11-14 08:05:00
f5f6cb87defc4b7e8ba6cc6e82f616bef47ea6b0...26d744526c12c1e3166d5a1338d4787c88a0f871,1,0,6,6,5,2007-11-14 22:46:18,2007-11-12 00:57:56
26d744526c12c1e3166d5a1338d4787c88a0f871...15f80a539bddfbd5e0661714756576edb2053e35,1,0,1,1,1,2007-11-14 22:46:18,2007-11-12 00:57:57
9656153b87d47b34986f2d77eef9199c24cbf9f6...93e23fea2d7538ac24e35b50984dbbbb84d89f9a,1,20,0,20,2,2007-08-30 06:12:38,2007-08-30 06:12:38
93e23fea2d7538ac24e35b50984dbbbb84d89f9a...7d3c82a7610ac9ba11a26e1e594e48e0ebef629a,2,2,2,4,2,2007-08-31 00:18:22,2007-08-30 21:12:44
7d3c82a7610ac9ba11a26e1e594e48e0ebef629a...8dabdfcc1bca58884eb161ab1d9b9416da1090c8,1,50,35,85,40,2007-08-31 01:46:37,2007-08-30 21:48:24
8dabdfcc1bca58884eb161ab1d9b9416da1090c8...fa8fe28c60e18063ebccbc3b4810f72740daf3c6,1,2,0,2,1,2007-08-31 02:14:31,2007-08-31 02:14:31
fa8fe28c60e18063ebccbc3b4810f72740daf3c6...26a65dea3e818c2bf019ee57ce1833021a2054d5,1,7,1,8,1,2007-08-31 02:15:33,2007-08-30 17:10:41
26a65dea3e818c2bf019ee57ce1833021a2054d5...5433235daec11550973f1e290f069ce0c27f53ab,1,6,1,7,2,2007-08-31 02:15:39,2007-08-30 17:10:42
5433235daec11550973f1e290f069ce0c27f53ab...55ced83d8aca98277c6a495932c57e6c3c45930b,1,1,1,2,1,2007-08-31 02:17:42,2007-08-31 02:17:42
55ced83d8aca98277c6a495932c57e6c3c45930b...9e2d57a04ac42c7450e78668ee7037b35d56f7c3,1,8,4,12,4,2007-08-31 02:18:31,2007-08-30 01:17:17
9e2d57a04ac42c7450e78668ee7037b35d56f7c3...608403d7a522adb3f8c0244956a332ed1b286668,1,5,1,6,1,2007-08-31 02:22:02,2007-08-30 01:56:56
608403d7a522adb3f8c0244956a332ed1b286668...75d244990364e322e87e2549846b17252f440627,1,15,0,15,1,2007-08-31 07:25:04,2007-08-31 07:25:04
75d244990364e322e87e2549846b17252f440627...a65f2005a6819d154172b01842eb39bd306a22cd,1,2,1,3,1,2007-08-31 07:26:41,2007-08-31 05:58:26
a65f2005a6819d154172b01842eb39bd306a22cd...e340d7d3fa1c5b9a6e7af2e3ee3d526064e56bea,1,13,1,14,2,2007-08-31 07:36:43,2007-08-31 07:35:36
e340d7d3fa1c5b9a6e7af2e3ee3d526064e56bea...88e21dc7461dca1ebc70d8579bcc9246364511ee,1,58,0,58,5,2007-09-01 03:47:01,2007-09-01 03:47:01
88e21dc7461dca1ebc70d8579bcc9246364511ee...082036688f528d28ef5b63d9491a0ec0d701f68a,1,18,14,32,7,2007-09-01 06:22:51,2007-08-31 16:42:33
082036688f528d28ef5b63d9491a0ec0d701f68a...f0fd889d7ff02efe8ee4a25ae2380db47c128682,1,38,1,39,2,2007-09-01 06:22:51,2007-08-31 17:10:21
f0fd889d7ff02efe8ee4a25ae2380db47c128682...7e0f1704b837355d833d84d18a3811d145867b97,3,25,13,38,5,2007-09-01 06:22:51,2007-08-31 19:05:36
7e0f1704b837355d833d84d18a3811d145867b97...f95eef15f2f8a336b9a42749f5458c841a5a5d63,3,42,14,56,6,2007-09-01 06:22:51,2007-08-31 19:06:27
f95eef15f2f8a336b9a42749f5458c841a5a5d63...eeebd8d8c5ab63494abe200b30a840aa99ee7412,1,2,2,4,2,2007-09-01 06:22:51,2007-08-31 21:29:49
eeebd8d8c5ab63494abe200b30a840aa99ee7412...751eb39590a1325e761a84bedd5ca2660d2d3497,2,62,28,90,7,2007-09-01 06:22:51,2007-09-01 01:16:12
751eb39590a1325e761a84bedd5ca2660d2d3497...18e32b5b7af4175f852469159d004a2a8de64658,2,11,20,31,14,2007-09-01 06:24:16,2007-09-01 05:10:09
18e32b5b7af4175f852469159d004a2a8de64658...aecbf914c43ab76e055fa8a25b12456ae74d91bc,4,45,7,52,7,2007-09-01 06:30:14,2007-08-31 20:13:42
aecbf914c43ab76e055fa8a25b12456ae74d91bc...7afa845edc09d2818af5fe67a0eb45ec579d1260,2,52,5,57,6,2007-09-01 09:23:05,2007-09-01 07:25:27
7afa845edc09d2818af5fe67a0eb45ec579d1260...c7965afd3dac7b9b6c1d4da27d3757e7d41aa060,2,2,5,7,4,2007-09-01 09:35:30,2007-09-01 09:17:28
c7965afd3dac7b9b6c1d4da27d3757e7d41aa060...2e7766655abd0312a6bf4db6a6ff141e7e4ac8b6,2,32,2,34,6,2007-09-01 10:35:29,2007-09-01 09:36:31
2e7766655abd0312a6bf4db6a6ff141e7e4ac8b6...f368f5a6bc11855ab11013bc0c550bfc0868c140,2,14,14,28,3,2007-09-01 11:06:13,2007-09-01 11:01:54
f368f5a6bc11855ab11013bc0c550bfc0868c140...947ad2e1de787deda69b40c7047436c37dc040c7,2,3,2,5,2,2007-09-01 11:09:51,2007-09-01 11:09:51
947ad2e1de787deda69b40c7047436c37dc040c7...a94eda65d37149e81356b6a263ce03015d3f5d73,1,2,2,4,2,2007-09-01 17:36:56,2007-09-01 12:11:10
e7034d66ecd9c16ae8bd8d331fc41efc48e925f1...afe2098ddd3e21d1d1afc428d3c8d91f37b01692,2,182,11,193,2,2007-09-13 23:07:46,2007-09-13 23:07:46
afe2098ddd3e21d1d1afc428d3c8d91f37b01692...042f53c569c92b40e63c6993c8998d2aac22e383,1,27,1,28,5,2007-09-14 00:02:39,2007-09-13 23:50:35
042f53c569c92b40e63c6993c8998d2aac22e383...55bad4f096b1f18eec94169c864c39bf0abda1db,1,1,1,2,1,2007-09-14 00:08:53,2007-09-14 00:08:53
bcef9b6327a7d0a01b9207a9cf0aa2783e12fb41...6acef043581d69597860f3343ec2691c72b0803c,2,2,2,4,2,2011-03-31 20:58:47,2011-03-31 20:58:16
488201c87e284ae06323b534c31e354811fb0d51...038e2e5656b13058bc9596ef44647e190e96e493,1,6,6,12,2,2011-06-07 15:32:14,2011-06-07 09:49:44
4fec83045bdc53ed9d3ff71ed099e3e6992b5c56...a7941795b1eb720f3bf3df2f4c68d58dd0fba7e1,2,10,0,10,2,2011-05-18 21:24:48,2011-05-18 20:24:37
4fec83045bdc53ed9d3ff71ed099e3e6992b5c56...2910bf56a4ffc13c398fb04ba32910cb3b724091,1,10,9,19,2,2011-04-28 20:54:12,2011-04-28 19:27:51
2910bf56a4ffc13c398fb04ba32910cb3b724091...410ee20bde21b014c7655ea4f19d4ca66486df22,1,9,10,19,2,2011-05-09 22:12:13,2011-05-09 22:12:13
410ee20bde21b014c7655ea4f19d4ca66486df22...9fb1e6984201892b6dfb7e1a9195e2544a5af754,1,9,9,18,4,2011-05-09 22:13:03,2011-05-09 08:24:55
4fec83045bdc53ed9d3ff71ed099e3e6992b5c56...c192f9c865dbdae48c0400d717581d34cd315fb8,2,32,2,34,4,2011-04-28 16:56:55,2011-04-28 04:35:55
4fec83045bdc53ed9d3ff71ed099e3e6992b5c56...4d03c18a3ea18138c24d379ccc25e219a36ca1ef,2,102,1,103,3,2011-04-26 22:07:02,2011-04-08 22:40:36
90cff968b3757061914f83b85a8d58cb9f29e72a...13fc2c1877a50dde5ea43e2f37420ebfb2f7dad1,1,5,0,5,1,2011-03-30 20:47:51,2011-03-30 19:52:52
13fc2c1877a50dde5ea43e2f37420ebfb2f7dad1...a9f5a3558dcf83440c60ae5a2e2b56c80d65bb0b,3,129,19,148,10,2011-03-30 20:47:53,2011-03-30 19:53:19
a9f5a3558dcf83440c60ae5a2e2b56c80d65bb0b...099024861021830f9d4c7db4c64c844bf9d5ebd9,2,7,5,12,4,2011-03-30 20:47:54,2011-03-30 19:53:39
90cff968b3757061914f83b85a8d58cb9f29e72a...9ecd3ada6dd7fe80109c48c48f30164c066d37ad,1,2,1,3,1,2011-03-30 18:42:08,2011-03-30 08:48:40
9ecd3ada6dd7fe80109c48c48f30164c066d37ad...2f8ee02c49ea2a8b32c22979a65eb81b859bb883,1,3,3,6,1,2011-03-30 18:43:15,2011-03-30 09:00:06
2f8ee02c49ea2a8b32c22979a65eb81b859bb883...18b19e443b2a3cf2572c99d0136de81ca7c67bdd,1,1,1,2,1,2011-03-30 18:44:59,2011-03-30 10:22:32
18b19e443b2a3cf2572c99d0136de81ca7c67bdd...63d329459370b09637d49a430f63d3ecd2bc3f25,1,4,5,9,3,2011-03-30 18:59:52,2011-02-22 17:15:00
63d329459370b09637d49a430f63d3ecd2bc3f25...e0390119b249252a633875e4327c8a6463e4b6cb,1,1,36,37,1,2011-03-30 19:02:50,2011-02-15 23:12:04
e0390119b249252a633875e4327c8a6463e4b6cb...4b705f4052432906f0acbb22b25254eb3917e36c,1,6,5,11,1,2011-03-30 19:22:05,2011-03-30 19:22:05
4b705f4052432906f0acbb22b25254eb3917e36c...806e0aba2e5d976233703e6ff517af10329e4048,1,2,2,4,2,2011-03-30 19:29:39,2011-03-30 08:52:23
90c0a3cfe390208c86144bf97ec8fa5610febe0f...f1602054e3a45e195edf814681e8f5ba88851623,1,5,2,7,2,2011-03-22 23:09:05,2010-12-14 00:06:43
c479d14a80743b1cb86d77695607f4c81f7d8797...b018ff60857ee7d79e3c4a8772bac08656a2a3c6,1,17,8,25,1,2013-11-04 18:13:27,2012-12-29 20:51:54
b018ff60857ee7d79e3c4a8772bac08656a2a3c6...76da5b1d22a7f0e3e34a780df91717e6269e84b4,2,89,89,178,10,2013-11-04 18:13:45,2013-11-01 21:55:17
76da5b1d22a7f0e3e34a780df91717e6269e84b4...77b43cac9feac1079f3643988cfadee63e4365f7,1,15,0,15,1,2013-11-04 18:13:45,2013-11-01 22:04:08
69e82602b9a5a01bc225d9b4e7a65a9daba506cb...26e5c5d09334d157bd04f794f16f6e338d50c752,2,16,5,21,4,2012-05-25 18:28:43,2012-05-25 18:28:43
e858af6d501954af07fa3bb7d2cca40b638c75a6...77effefefdf95c2f08afdb5d05e947657204ccd8,1,3,4,7,2,2012-11-02 13:22:02,2012-11-02 12:26:47
6a4a4822298866ec3386a46d9d8f933b80e3a359...b64e1f58158d1d1a8eafabbbf002a1a3c1d72929,2,5,1,6,4,2012-05-17 02:21:43,2012-05-15 08:45:50
b64e1f58158d1d1a8eafabbbf002a1a3c1d72929...2b26b65f9abc77c4af87626452005a73edda0c8f,1,19,20,39,4,2012-05-17 09:35:18,2012-05-17 03:20:43
4c0a89fcde219df8db8fdb9635ef2ef40d002a6e...53ec551c87c731c5c4171e943842998bdfb5548e,1,1,1,2,2,2014-01-28 19:59:47,2014-01-28 01:36:12
53ec551c87c731c5c4171e943842998bdfb5548e...67beb600563cf28186f44450e528df1ec4d524fd,1,5,1,6,2,2014-01-28 19:59:49,2014-01-28 01:37:30
be39048a7385157e4b7baabd3e64fe186b428ea1...10587ce6dfb479cf4930657e173b673031deaa06,1,21,20,41,3,2012-05-16 17:44:04,2012-05-16 17:36:01
d4958d30f851a70905b291ee9b996232e8db48e2...bafa16e53c8845f3d3b7713dcbef8a5c841cadad,1,4,2,6,2,2012-04-27 16:28:10,2012-04-27 09:25:25
90e1818f9a06015159712e204dd90868e0a6c421...4b580061b350ae9d27ab7c3936a45828a33624c6,1,11,3,14,1,2012-05-03 22:41:35,2012-05-03 12:10:22
933ac036d29e65e1b3d71332d9ade8edd1e8a89b...654ad400c27653a138b028cdd35a09b0c69c7ef0,1,6,0,6,1,2012-05-24 19:16:06,2012-05-24 12:16:50
6f1af028ce0654ef6233dff06701a989d5703bc4...9322ce21eeb4ad92d0cdd37d0d62a69368042fec,1,5,3,8,1,2012-05-22 21:39:49,2012-05-22 20:36:25
9322ce21eeb4ad92d0cdd37d0d62a69368042fec...7e356a979459092d10450e66d8512381e89c2570,1,7,1,8,1,2012-05-23 16:10:03,2012-05-22 20:36:39
7e356a979459092d10450e66d8512381e89c2570...8072766cc6756e9218ea7c9433b097b696329407,1,5,13,18,1,2012-05-23 16:10:17,2012-05-22 20:36:57
6ab1d76c3cf96aac77a75565dfaa0cf64aa100a1...9e826dfd57cb6f8d2a2f78c42b8153724dc2ea0e,1,52,0,52,1,2012-05-29 17:45:59,2012-05-26 09:56:04
9e826dfd57cb6f8d2a2f78c42b8153724dc2ea0e...ad71f6617e7605315a225a1fce5e6e6a12042d04,1,54,0,54,1,2012-05-29 17:46:00,2012-05-26 09:56:05
ad71f6617e7605315a225a1fce5e6e6a12042d04...5d5c556ac41268935e99aacb09c90a31f18d876b,1,1,3,4,2,2012-05-29 17:46:00,2012-05-26 09:56:06
6ab1d76c3cf96aac77a75565dfaa0cf64aa100a1...7bbaf11f356c7ae731ed33e157f1fbe1a75aa6f0,1,2,2,4,2,2012-04-11 18:04:51,2012-04-11 15:21:23
7bbaf11f356c7ae731ed33e157f1fbe1a75aa6f0...06804c76e8f7a61c7c9473decdf9b210d3238e9d,3,468,39,507,26,2012-04-11 18:04:53,2012-04-11 15:21:24
06804c76e8f7a61c7c9473decdf9b210d3238e9d...c8942a223d41adab336946913f28cf8691ee479a,3,23,25,48,14,2012-04-24 21:17:39,2012-04-11 15:21:24
c8942a223d41adab336946913f28cf8691ee479a...1e3e7180a1bc0c7af7ad8ccaa45467f6ee92f2bd,1,1,0,1,1,2012-04-24 21:22:19,2012-04-24 08:33:20
1e3e7180a1bc0c7af7ad8ccaa45467f6ee92f2bd...f95ceaf04aa304cff1bf0bc76e8fed3fea5d0484,1,1,1,2,1,2012-04-24 21:22:21,2012-04-24 08:33:21
f95ceaf04aa304cff1bf0bc76e8fed3fea5d0484...6a10b6aa1e7b9bb114e525edb67b7650b46f333e,2,14,28,42,18,2012-04-24 21:22:23,2012-04-24 08:33:23
6a10b6aa1e7b9bb114e525edb67b7650b46f333e...00855b656bf883c607a4adcd5bc7a76711e4b3a3,1,1,1,2,1,2012-04-25 15:19:26,2012-04-25 08:16:54
d973dc01cc904ae046f6b40911aaf340c04cfdc7...0e2d57fd50f61e668be3180bc8f25991ea88aa8c,2,12,4,16,5,2012-03-14 22:47:45,2012-03-14 22:38:47
b3e34dddc0d385dbcf6ea28bd8d4f5cba9c06f04...776297548e27d18edbd582a3cda599bb619668a9,1,4,0,4,2,2012-04-17 15:51:54,2012-04-17 07:03:21
eb40e51597eb2cd36fcd4a3e56c9ecaa109ddefc...911011aacc78dfa8ac81a5e631cb86bb69fd66e1,1,76,3,79,5,2013-07-11 20:25:18,2013-07-11 20:25:18
868d662399786462f87df45c3d68bd5390311a6e...53876fcf3fdc1c46c26fc3a191e74a06e633d5b2,1,1,1,2,1,2012-04-30 19:50:38,2012-04-30 19:46:30
868d662399786462f87df45c3d68bd5390311a6e...6cf378f0cbe7c7f944637892caeb9058c90a185a,53,192,194,386,164,2012-04-26 20:19:06,2012-04-26 08:51:57
675fff45a71b89b8ee2a595d945614764fbee347...2ab5ca80f05f6924d7ec1d4c294422a189a792f7,1,9,5,14,5,2012-02-22 05:10:33,2012-02-22 05:10:33
2ab5ca80f05f6924d7ec1d4c294422a189a792f7...41799aa20904ff532ceb4f3ed95ba13e164dfc7a,1,1,1,2,1,2012-02-22 19:18:19,2012-02-22 19:16:05
a1463920565c67646507dc573d3f5280fa4cdcf3...ded2d47668c8e865465a7ad69665696f9b56f24b,1,7,2,9,1,2010-07-13 00:34:46,2010-07-12 23:42:03
ded2d47668c8e865465a7ad69665696f9b56f24b...7d7ff15b39abfa9e73b6475f189006a74dc26376,3,34,9,43,8,2010-07-14 16:26:57,2010-07-12 23:42:04
a1463920565c67646507dc573d3f5280fa4cdcf3...ba2b4d7c592266539dfea2eed964fe50f5cc12c2,1,4,4,8,4,2010-07-05 18:21:00,2010-07-02 18:50:28
ba2b4d7c592266539dfea2eed964fe50f5cc12c2...49a43f5468b5dbf41236a59a663e593e5432db15,1,3,3,6,2,2010-07-07 04:18:21,2010-07-06 21:56:51
a1463920565c67646507dc573d3f5280fa4cdcf3...66bd8ab899d442926ad45d63cd5ad63ab5bb81b2,1,7,0,7,1,2010-07-02 17:41:20,2010-06-30 20:41:27
66bd8ab899d442926ad45d63cd5ad63ab5bb81b2...2c64034491e302fa12ac86365dd872d9a75dc855,1,6,1,7,2,2010-07-05 18:51:20,2010-07-05 13:15:20
2c64034491e302fa12ac86365dd872d9a75dc855...6b097788f88a29d6e171af7a9e87117cf992e833,2,9,5,14,4,2010-07-05 18:54:50,2010-07-04 10:48:35
331a1838b26c3032bec27b66307a9de9b3b11509...422af49c2fe707c5e7bff1e4a8250232401154b0,1,1,1,2,1,2014-09-23 18:29:20,2014-09-21 20:49:46
422af49c2fe707c5e7bff1e4a8250232401154b0...040b2ac978366215bfc27be5e110a2f0170e6864,1,0,4,4,1,2014-09-23 18:31:41,2014-09-23 14:55:50
331a1838b26c3032bec27b66307a9de9b3b11509...43dd2332853b2460a5252b0f43d8de3c5b545b9a,1,20,7,27,4,2010-07-02 22:45:18,2010-07-02 19:20:49
43dd2332853b2460a5252b0f43d8de3c5b545b9a...18acb30ee458a4a413d987215af41b4a76643f5d,1,44,8,52,18,2010-08-06 16:20:00,2010-08-05 11:09:33
18acb30ee458a4a413d987215af41b4a76643f5d...d347cee4deda2e740f3c9e0046a86b46debdaeb8,1,41,0,41,1,2010-08-06 16:20:00,2010-08-05 11:11:12
d347cee4deda2e740f3c9e0046a86b46debdaeb8...beeeb45493332f38de2a3b58120c5bebb5863577,1,49,1,50,8,2010-08-06 16:20:00,2010-08-05 11:13:04
beeeb45493332f38de2a3b58120c5bebb5863577...3e7589b7b3ff7a7aa93bec39c40603e370c51317,1,5,4,9,4,2010-08-06 16:20:00,2010-08-05 11:13:49
3e7589b7b3ff7a7aa93bec39c40603e370c51317...1bc0ab7cd13af796b4ba1a5fc3ede9e92078aee4,2,3,1,4,3,2010-08-06 16:20:00,2010-08-05 11:15:32
1bc0ab7cd13af796b4ba1a5fc3ede9e92078aee4...24d113ec11d9948cedee4ba4687d0775e36b65f9,1,70,0,70,1,2010-08-06 16:20:01,2010-08-05 11:16:51
24d113ec11d9948cedee4ba4687d0775e36b65f9...73cf7f713da4fc797e2393a9e490ad4ec9466c53,4,28,9,37,9,2010-08-06 16:20:01,2010-08-05 11:17:38
73cf7f713da4fc797e2393a9e490ad4ec9466c53...18b037a5b61532cba7f19efdb2e75c258d87d3d7,5,19,8,27,11,2010-08-06 16:20:01,2010-08-05 11:24:58
18b037a5b61532cba7f19efdb2e75c258d87d3d7...f7314882c26b34c4c1039b65b1c8e6b380d30674,1,180,125,305,57,2010-08-06 16:20:02,2010-08-05 11:25:34
f7314882c26b34c4c1039b65b1c8e6b380d30674...672d1b789bc041be6aa18dcce066e6b556d6b787,2,119,24,143,10,2010-08-06 16:20:02,2010-08-05 11:28:37
672d1b789bc041be6aa18dcce066e6b556d6b787...ff8ba59e7b015ba96d6a3271000f16aa71dc4a6f,1,5,6,11,5,2010-08-06 16:20:02,2010-08-05 11:30:26
ff8ba59e7b015ba96d6a3271000f16aa71dc4a6f...7610fa57e63b0acc0a66717fc2d85755634db591,8,45,8,53,13,2010-08-06 16:20:02,2010-08-05 11:32:41
1d6abac9d573d7a40d3e631253b67a7cb07e0d05...9fb79503e683c1bff810a78a47c939708af5f6b7,1,4,0,4,1,2011-10-20 17:17:14,2011-10-20 17:04:59
046180ad9dd36f739f22b1d05b17b23b8c96ce49...2141c474d0dd7cddf224780644e64bc7fa493f07,1,4,0,4,1,2013-10-17 22:57:12,2013-10-17 22:57:12
2579e1d2936ad4e385ef21e5c346d9853d7faa01...90a6c7d443058e8ad3eb36d21f4ede99addbca61,6,38,9,47,16,2011-08-01 01:45:41,2011-07-30 12:10:14
90a6c7d443058e8ad3eb36d21f4ede99addbca61...0d086b8e33820d7cf87386a912e2939c59822f35,1,1,1,2,1,2011-08-08 19:31:01,2011-08-08 19:31:01
2579e1d2936ad4e385ef21e5c346d9853d7faa01...14569cd810ad35a66ca7867505e0b2dd202ab95f,1,7,0,7,1,2011-08-01 01:39:19,2011-07-28 21:38:03
2579e1d2936ad4e385ef21e5c346d9853d7faa01...3bc4181fde899e02aff89f7c0a47f18d37311cb3,3,27,8,35,8,2011-08-01 01:27:07,2011-07-27 21:32:34
3bc4181fde899e02aff89f7c0a47f18d37311cb3...fc1b56f054a79400c4e72cb1aab97ba2605cbd83,1,6,9,15,4,2011-08-01 23:21:55,2011-08-01 17:59:21
2579e1d2936ad4e385ef21e5c346d9853d7faa01...e44b6df90cfd6ccbf35c3d147ff5a0e4e22fb17a,1,3,2,5,1,2011-08-01 01:23:49,2011-07-26 12:27:57
e44b6df90cfd6ccbf35c3d147ff5a0e4e22fb17a...dd008b3b11286804bc7880bac10c34a76355fe92,1,4,2,6,1,2011-08-01 01:40:34,2011-07-30 15:05:54
dd008b3b11286804bc7880bac10c34a76355fe92...d5b66299040969706dd675c021f4336a26a6cc82,1,13,2,15,2,2011-08-01 01:42:38,2011-07-30 03:55:05
2579e1d2936ad4e385ef21e5c346d9853d7faa01...7e60407f7a36bd1f7fd505f9aa9580a837fbb190,2,11,4,15,5,2011-07-28 19:48:26,2011-07-26 21:39:03
260eb7e38966bdad79aae2e125c9a07b19abd0f8...a22a9477fcd64a58fafc75d12320cda2c3ce9dbb,1,3,1,4,1,2012-03-14 22:19:55,2012-03-14 16:38:02
a22a9477fcd64a58fafc75d12320cda2c3ce9dbb...c5770f79068fb1317c1fd19da7e7bfcc075132f3,1,4,7,11,1,2012-03-14 22:20:21,2012-03-14 16:38:03
c5770f79068fb1317c1fd19da7e7bfcc075132f3...e33e01d07703d0c2c662c30e745dc93b543641c0,1,8,4,12,1,2012-03-14 22:20:25,2012-03-14 16:38:04
e33e01d07703d0c2c662c30e745dc93b543641c0...97549084f660c43fe4b6dc34bf60afef4948b432,1,9,15,24,4,2012-03-14 22:22:08,2012-03-14 16:38:05
97549084f660c43fe4b6dc34bf60afef4948b432...bfe392e3674770e8a0312d4945b0a5f2c9007eab,1,3,4,7,2,2012-03-14 22:22:38,2012-03-14 16:38:06
72d5e74e991937e24afb943eee74ca929e7f00ab...176158cabd2d369151a4122c59ed8afab0ca236c,1,0,12,12,1,2012-02-22 21:57:05,2012-02-22 08:58:12
176158cabd2d369151a4122c59ed8afab0ca236c...514a529d253d263672e5a855775382608f7fdfc1,1,4,4,8,2,2012-02-22 21:57:38,2012-02-22 08:58:13
0ac3056850394723c9b407754b44d3d37f1dcc3f...fb8e23fae2ac9af831260079b14eabad316f3769,1,4,2,6,1,2006-10-27 01:34:18,2006-10-26 20:21:02
0ac3056850394723c9b407754b44d3d37f1dcc3f...d5f6a01af0658bc0ec5f068d81ba321be94526d5,2,46,8,54,9,2006-10-26 08:18:49,2006-10-26 07:05:04
ef06b91804ff5a626e265c6d9080bbc0e7924e88...69945602f95710f16ab4a5f8edfee38dc65555fa,1,3,0,3,1,2006-11-21 19:40:18,2006-11-21 18:55:20
ef06b91804ff5a626e265c6d9080bbc0e7924e88...b8ec59234ba2c1833e29eece9ed87f7a471cbae2,6,307,235,542,7,2006-11-20 06:59:05,2006-10-22 11:23:31
b8ec59234ba2c1833e29eece9ed87f7a471cbae2...72019cdefeb6b8fd7e8bff37b9c087302a45e29e,1,9,7,16,1,2006-11-20 06:59:05,2006-11-19 16:28:25
72019cdefeb6b8fd7e8bff37b9c087302a45e29e...d8e812502f1c72f5ef542de7eb05874e27f2b086,2,79,42,121,4,2006-11-20 06:59:05,2006-11-19 16:28:51
d8e812502f1c72f5ef542de7eb05874e27f2b086...549652361b7fea5a5e9046571c9f0bc4a7d5d6ef,1,7,1,8,3,2006-11-20 06:59:05,2006-11-19 16:29:14
549652361b7fea5a5e9046571c9f0bc4a7d5d6ef...6d6ab6104a5055b9f66cc9a80d55d2ef59d0763c,1,9,6,15,6,2006-11-21 22:31:15,2006-11-21 20:12:06
6d6ab6104a5055b9f66cc9a80d55d2ef59d0763c...ac60c94d74ff3341a5175ca865fd52a0a0189146,1,5,3,8,2,2006-11-21 22:31:34,2006-11-21 20:49:45
ac60c94d74ff3341a5175ca865fd52a0a0189146...c95044d4f3c98b52f16e32cfe09f3ff988a80d2a,1,9,4,13,2,2006-11-25 08:01:27,2006-11-25 08:01:27
c95044d4f3c98b52f16e32cfe09f3ff988a80d2a...7595e2ee6ef9b35ebc8dc45543723e1d89765ce3,2,24,2,26,5,2006-11-25 08:07:54,2006-11-25 08:07:54
ef06b91804ff5a626e265c6d9080bbc0e7924e88...cf0adba7885342e1bbcf0689fece9d13e39784b4,4,117,20,137,21,2006-11-20 02:45:44,2006-11-19 21:22:44
cf0adba7885342e1bbcf0689fece9d13e39784b4...f4204ab9f6a192cdb9a68150e031d7183688bfeb,4,77,55,132,30,2006-11-22 07:37:35,2006-11-22 07:36:35
b1bfcae438adb485bb66e2f59396373809e346e6...790fa0e297b41b9e8c98a77b58004c58408e5f7a,1,1,1,2,1,2006-12-17 09:14:43,2006-12-17 00:23:02
790fa0e297b41b9e8c98a77b58004c58408e5f7a...c33ab0dd100d91d417b5ed3378acbf3310c07cec,1,1,1,2,1,2006-12-17 09:14:43,2006-12-17 09:09:41
c33ab0dd100d91d417b5ed3378acbf3310c07cec...81a361be3b12f393d402c5da63191c11c18ea6a9,2,10,1,11,2,2006-12-17 09:14:44,2006-12-17 01:39:06
81a361be3b12f393d402c5da63191c11c18ea6a9...a7f196a74650e45ce240754e2caa483752651063,3,18,0,18,3,2006-12-17 09:14:44,2006-12-17 08:15:14
a7f196a74650e45ce240754e2caa483752651063...38477d9e6055e3572b465ec3f8e716164111683d,1,2,2,4,2,2006-12-17 09:14:44,2006-12-17 08:46:35
38477d9e6055e3572b465ec3f8e716164111683d...c0e9232e43446d3bfa7844d36e64e087b8709090,1,9,0,9,2,2006-12-17 18:31:11,2006-12-17 14:50:12
c0e9232e43446d3bfa7844d36e64e087b8709090...ee6002aa429272871733b8fbc99a9e6df3e150f5,1,8,8,16,2,2006-12-17 18:33:24,2006-12-17 18:33:24
b1bfcae438adb485bb66e2f59396373809e346e6...0667fcfb6271e9e1ea032a0e3a7d74c9d6a5fa8a,4,126,1,127,5,2006-12-16 21:28:20,2006-12-16 14:14:14
0667fcfb6271e9e1ea032a0e3a7d74c9d6a5fa8a...dc81c58cd6b791a3db23f1d1acb5f7d38d1ff086,2,16,0,16,3,2006-12-16 21:38:44,2006-12-16 14:15:02
b1bfcae438adb485bb66e2f59396373809e346e6...61dde8f91672ab362f3cfd3af8d6d09d448d4ffe,1,30,17,47,6,2006-12-16 21:01:41,2006-12-16 09:14:39
61dde8f91672ab362f3cfd3af8d6d09d448d4ffe...a71fb0a1412c82405f078fb536797d3f5de68d53,1,2,1,3,1,2006-12-16 21:01:41,2006-12-16 09:36:32
a71fb0a1412c82405f078fb536797d3f5de68d53...3dd3d5b0e20a74a82a7e684d63d9af86a983fbf6,1,4,4,8,4,2006-12-16 21:01:41,2006-12-16 09:41:51
3dd3d5b0e20a74a82a7e684d63d9af86a983fbf6...63085fabbdeaad9eb8b29d39d0998c704e6cd232,2,13,60,73,8,2006-12-16 21:01:41,2006-12-16 09:53:10
d2bafe5c320c1204b264dc25392a3fc35ed57153...d5e86da89155b462c30a59bc724037fb111d3894,1,1,1,2,1,2006-12-26 02:39:54,2006-12-26 02:14:12
d5e86da89155b462c30a59bc724037fb111d3894...2cf0223ba48ae51af03de486e119fd7a36e1b0ee,1,37,0,37,1,2006-12-26 05:41:11,2006-12-26 04:25:44
2cf0223ba48ae51af03de486e119fd7a36e1b0ee...abc8ab19ae72e811335c847166228362035b22c0,1,5,0,5,2,2006-12-26 08:11:50,2006-12-26 08:11:50
abc8ab19ae72e811335c847166228362035b22c0...2f89543eaf98400d72498078d762c10e240c0657,2,6,3,9,2,2006-12-26 08:15:26,2006-12-26 08:15:26
2f89543eaf98400d72498078d762c10e240c0657...6934dec89538e054823aadcce08af040bc8dcf79,1,9,3,12,4,2006-12-26 08:21:01,2006-12-26 08:21:01
27e4dd8de76bdd60c88003e0f27cee8ad26c5cd6...d41cb273d313a21979b05dba57d0c6b565b28ba6,1,9,2,11,2,2006-12-22 06:56:25,2006-12-22 06:39:09
d41cb273d313a21979b05dba57d0c6b565b28ba6...a01c9c28a576fbf3cd7caa4423dae4858a5ae6f5,1,1,1,2,1,2006-12-22 06:56:26,2006-12-22 06:51:42
a01c9c28a576fbf3cd7caa4423dae4858a5ae6f5...51dcaa9686d9ff591e9d051e6090d8529bc263a5,1,12,12,24,11,2006-12-22 06:59:34,2006-12-22 00:48:12
51dcaa9686d9ff591e9d051e6090d8529bc263a5...fa39b6b5b11f9b580c515a7b4a8e4eb8eaa79b75,2,21,0,21,6,2006-12-22 06:59:34,2006-12-22 00:48:32
90cee090a0d7f950130d50df123551e43843e679...71b03b42c637d884295b48d4f5d830a5f5f3578b,1,20,10,30,5,2006-12-22 07:01:57,2006-12-22 00:49:06
71b03b42c637d884295b48d4f5d830a5f5f3578b...8d8b9f6252271899708b32fbce4cd2541af9545a,1,40,3,43,4,2006-12-22 08:46:33,2006-12-22 08:46:33
8d8b9f6252271899708b32fbce4cd2541af9545a...58748293f6fa450c6db89a78bd20aae7bf708d3b,1,5,5,10,2,2006-12-23 07:42:30,2006-12-23 07:42:30
58748293f6fa450c6db89a78bd20aae7bf708d3b...7dc269230761e32e663d9cd0b6f4c316466a490d,1,1,0,1,1,2006-12-26 20:12:57,2006-12-26 19:08:08
240897e908e48e8f8c8d5555522afe255b3b734b...2740b2b8539a322bc73f46c45c569503900c5dc1,1,0,1,1,1,2007-01-09 22:07:59,2007-01-09 22:07:59
2740b2b8539a322bc73f46c45c569503900c5dc1...d93b7d1c30c9716953392ec6590686301de0cc25,1,8,1,9,3,2007-01-09 22:08:41,2007-01-09 16:11:47
d93b7d1c30c9716953392ec6590686301de0cc25...d234b21c6966ee1d2dc4b5dcd9dca73a102bc442,1,13,2,15,1,2007-01-10 00:05:00,2007-01-09 20:25:46
d234b21c6966ee1d2dc4b5dcd9dca73a102bc442...3fe71f3a6f4454e845d4c7aec3e4bddd9a872b15,1,1,1,2,1,2007-01-10 00:14:41,2007-01-09 20:26:52
3fe71f3a6f4454e845d4c7aec3e4bddd9a872b15...03d311eda2d8c2d23855b9d3e904c7648925ab56,1,13,5,18,2,2007-01-10 00:15:07,2007-01-09 20:27:40
03d311eda2d8c2d23855b9d3e904c7648925ab56...0bdb28c9ccd85b1c606664154b6f6d39a4c315fd,1,4,3,7,3,2007-01-10 00:23:39,2007-01-09 23:07:43
0bdb28c9ccd85b1c606664154b6f6d39a4c315fd...6900679c2f6d937a5a6ef616869c8887690ad19d,3,30,0,30,4,2007-01-10 00:40:40,2007-01-09 21:04:12
6900679c2f6d937a5a6ef616869c8887690ad19d...cec21ca7cfd5d8fd19ea87e15f14dce6ee3b3859,1,6,59,65,7,2007-01-10 01:08:09,2007-01-10 00:20:17
cec21ca7cfd5d8fd19ea87e15f14dce6ee3b3859...1c23d794bfa3b9f3e03b18bb7e542615a924dbe3,2,4,0,4,3,2007-01-10 01:54:25,2007-01-10 01:04:52
ccd14e569dcfe1a83b33f84fad8cfed68676ef5d...2a3a3c247e7f1f257e9c6762e48b98f08a30011a,2,16,11,27,8,2007-01-10 22:29:21,2007-01-10 22:25:03
696b1b507f8ff9e80a2edc4eced59ca8cdda920e...dcbc7bbe393d6bfee0ac36cc97fbc51ebf112ed6,1,1,1,2,1,2007-01-14 02:48:10,2007-01-14 02:23:55
dcbc7bbe393d6bfee0ac36cc97fbc51ebf112ed6...38434f2eed45f42ed706d07564079c23ee686511,1,1,1,2,1,2007-01-14 08:40:12,2007-01-14 08:22:47
38434f2eed45f42ed706d07564079c23ee686511...e6e2bd6201d32342df7a713c847161ab296885ea,3,4,15,19,4,2007-01-14 08:42:41,2007-01-14 06:01:49
f4b6c6b90fdce12d69e4ad80ff6082405ec8cfb8...63889639bbb47399b5ede784b1afe48679d52bb2,1,7,9,16,9,2007-01-14 20:20:39,2007-01-14 05:28:33
63889639bbb47399b5ede784b1afe48679d52bb2...8c3275abcacb83ea3f4c4f4ceb2376799fc282bd,2,69,38,107,35,2007-01-14 20:20:39,2007-01-14 05:28:48
8c3275abcacb83ea3f4c4f4ceb2376799fc282bd...66a155bc129b12f1f13be8e3f20e57db5ace0e6f,1,39,1,40,7,2007-01-14 20:20:39,2007-01-14 05:28:53
66a155bc129b12f1f13be8e3f20e57db5ace0e6f...3f6ee2d15ab4be8690c17c0af0338b8495f6f706,1,66,7,73,11,2007-01-14 20:20:39,2007-01-14 05:28:58
3f6ee2d15ab4be8690c17c0af0338b8495f6f706...89f40be294363ce4d14ed6931a65561a4e8e9140,1,18,18,36,17,2007-01-14 20:20:39,2007-01-14 08:11:28
89f40be294363ce4d14ed6931a65561a4e8e9140...adb7ba6b116c0ec26e058b9b41a5a528d123323f,1,1,1,2,1,2007-01-15 02:23:22,2007-01-15 02:23:22
adb7ba6b116c0ec26e058b9b41a5a528d123323f...c14261eaa297504799e3b21ecbd751edbae912c0,5,29,49,78,25,2007-01-15 05:12:14,2007-01-15 03:44:18
c14261eaa297504799e3b21ecbd751edbae912c0...dccd0c2abdb958daf6f168ba925b67441dc6be61,1,13,11,24,4,2007-01-15 05:17:27,2007-01-13 22:27:52
dccd0c2abdb958daf6f168ba925b67441dc6be61...c3e3cd4bf8c94cc2f4fa8d8f7751553037e06004,1,17,12,29,9,2007-01-15 05:17:27,2007-01-13 22:28:16
c3e3cd4bf8c94cc2f4fa8d8f7751553037e06004...910c0d7b5ea09d55f769062abd9b9fe3af904a23,1,20,7,27,4,2007-01-15 05:17:27,2007-01-13 22:29:00
910c0d7b5ea09d55f769062abd9b9fe3af904a23...8713ab307940c37906631efb8ef96be37963f81c,2,106,49,155,22,2007-01-15 05:17:27,2007-01-13 22:30:53
8713ab307940c37906631efb8ef96be37963f81c...5312ab11fbf7bac28b671510ac3734a3e604d9fa,1,97,0,97,1,2007-01-15 05:17:27,2007-01-14 02:37:32
5312ab11fbf7bac28b671510ac3734a3e604d9fa...cf69fd49ec815780080dc6a4ee237eee5ffe8745,1,25,12,37,9,2007-01-15 05:17:27,2007-01-14 09:37:44
cf69fd49ec815780080dc6a4ee237eee5ffe8745...e7eb50347bba54ab52f9740a3bbb6e833bdadf6e,1,12,64,76,10,2007-01-15 05:17:27,2007-01-15 03:16:55
e7eb50347bba54ab52f9740a3bbb6e833bdadf6e...5fe3acc43ddb30c61f0adc922f1f08ccc117d2c1,2,2,11,13,3,2007-01-15 05:31:30,2007-01-15 05:31:30
5fe3acc43ddb30c61f0adc922f1f08ccc117d2c1...acb4441e0dabaaa666ecae11fdafc27c3691e763,2,74,17,91,5,2007-01-15 06:00:34,2007-01-15 06:00:02
acb4441e0dabaaa666ecae11fdafc27c3691e763...6e2931a8ed887bd75ed68085a7e04bc88574d69e,1,6,0,6,1,2007-01-15 07:17:32,2007-01-15 06:41:22
5f856dd47dacb30fb9f605b4b7e1fa577ada7d26...936db184f0b51c07aba5e6a8f79352045f887632,1,1,1,2,1,2010-04-10 03:40:54,2010-04-09 12:38:18
5f856dd47dacb30fb9f605b4b7e1fa577ada7d26...23913dc713a4f5b5228258919769ff1ab0a74a2b,2,4,1,5,3,2007-02-03 23:17:49,2007-01-20 01:12:11
23913dc713a4f5b5228258919769ff1ab0a74a2b...a9d1836b100d988bb292086eeab1ab826b3959f1,1,3,3,6,1,2007-02-04 00:30:52,2007-02-03 06:40:49
a9d1836b100d988bb292086eeab1ab826b3959f1...3b0f5e88ee039e96822d7d0127a59d78936c222f,1,30,4,34,7,2007-02-04 00:31:11,2007-02-03 20:37:54
3b0f5e88ee039e96822d7d0127a59d78936c222f...9673a0b182fdb39e6a00e2cbdcfacee769201053,1,1,1,2,1,2007-02-04 05:35:22,2007-02-04 03:01:04
9673a0b182fdb39e6a00e2cbdcfacee769201053...0f3908758947b2279f5d2d4a294653d76a62d468,1,19,4,23,5,2007-02-04 05:49:49,2007-02-04 04:02:59
0f3908758947b2279f5d2d4a294653d76a62d468...3dff5379bf1e3fda5e5a84ca5813b0c0cfd51be7,27,41,41,82,39,2007-02-04 05:49:54,2007-02-04 04:49:16
3dff5379bf1e3fda5e5a84ca5813b0c0cfd51be7...183d79724f6c442f74309dd04c89d3cb48ded628,2,43,1,44,4,2007-02-04 06:04:28,2007-02-04 05:45:54
183d79724f6c442f74309dd04c89d3cb48ded628...8d0fc48f27304ac1bc7abf802ec53fe66fedb15a,1,2,0,2,1,2007-02-04 06:04:34,2007-02-04 05:45:47
ac5f7c62c2d59cdad0813fcd8c999db96a4fc9e4...8676eb43133cebe5121b8426f0e67f32c5cdefaa,1,80,58,138,16,2006-02-27 00:21:27,2006-02-26 23:51:24
8676eb43133cebe5121b8426f0e67f32c5cdefaa...525c0d713c101cf795980aec3baa08f49ec7147f,1,4,4,8,1,2006-02-27 05:34:41,2006-02-26 05:11:24
525c0d713c101cf795980aec3baa08f49ec7147f...4802426ddbf518f30f53cc572d619495ab52e4f7,1,13,7,20,7,2006-02-27 05:34:42,2006-02-26 05:11:27
4802426ddbf518f30f53cc572d619495ab52e4f7...c55f3fff35ac34e6d1f0f686e27029612775e51d,2,64,4,68,9,2006-02-27 05:34:42,2006-02-26 05:11:29
ac5f7c62c2d59cdad0813fcd8c999db96a4fc9e4...ae563542bf10fa8c33abd2a354e4b28aca4264d7,6,464,357,821,48,2006-02-26 23:33:27,2006-02-26 00:19:46
b8310152bc5622e4d449e3113ba4edec8fd08087...501c7372c73c980eed042c90e3518c2ab816c846,1,5,2,7,4,2006-03-03 06:56:27,2006-03-03 03:38:03
501c7372c73c980eed042c90e3518c2ab816c846...e74ee784c7daf560044dad4a06fae66732ed414b,1,5,5,10,5,2006-03-03 06:56:28,2006-03-03 03:57:03
df45467ec98aa1c532196732c96a62589223353e...5398fed96699b5321678fdace86b6d4c62a155fb,1,5,2,7,4,2006-03-03 03:38:03,2006-03-03 03:38:03
5398fed96699b5321678fdace86b6d4c62a155fb...cfcbd3427e67056a00ec832645b057eaf33888d9,1,5,5,10,5,2006-03-03 03:57:03,2006-03-03 03:57:03
ce5b6e711148d035478fcb18773a0abcef302d7e...690e307f54b4aa84349b89e8552b25e7495f1cd6,1,2,2,4,2,2006-03-06 08:32:50,2006-03-06 08:32:50
690e307f54b4aa84349b89e8552b25e7495f1cd6...1242642c468a7bcc335a676273eae4ced8a55f04,1,19,0,19,1,2006-03-06 08:41:17,2006-03-06 08:41:17
ce5b6e711148d035478fcb18773a0abcef302d7e...e920b5655719bee9c98a3d7d3b05ac6e8cf9d176,1,10,0,10,1,2006-03-06 06:38:12,2006-03-05 23:13:36
473ab1659bc6b2483544e404661e4349dc249355...70ca1a3f854be0d3b429e66f1484f9ca73a79828,1,11,27,38,5,2006-03-06 11:03:56,2006-03-05 19:22:57
2dcdb4c69737185f0b0e9fe08ba52b95b84f13da...a541211ef4136eb7464c4466d20b60b8580efc44,2,8,25,33,6,2006-03-08 01:00:45,2006-03-07 09:08:34
a541211ef4136eb7464c4466d20b60b8580efc44...aa1dbc9897822c8acb284b35c40da60f3debca91,2,727,335,1062,99,2006-03-08 01:03:21,2006-03-08 00:13:20
aa1dbc9897822c8acb284b35c40da60f3debca91...f067a13745fbeae1aa357876348a00e5edd0a629,2,12,1,13,3,2006-03-08 01:06:10,2006-03-06 05:23:30
6feba7cb744d5a19472ea0bf5b337ad8a32acf80...da2a95b2a86e8b140d6c5413ea4307e395884135,1,14,4,18,7,2006-04-17 22:05:33,2006-04-17 15:14:47
da2a95b2a86e8b140d6c5413ea4307e395884135...310f8b5b6d17d805cb9a59a20ba747d5f093604a,1,2,10,12,4,2006-04-17 22:06:16,2006-04-17 15:14:47
310f8b5b6d17d805cb9a59a20ba747d5f093604a...ecc13e73cf96cb14e2403be6538593a167d7ea23,1,0,2,2,1,2006-04-17 22:06:25,2006-04-17 15:14:48
ecc13e73cf96cb14e2403be6538593a167d7ea23...dafc88b136b508c1c08129b756b6ba23b7c9d341,1,28,11,39,12,2006-04-17 22:06:37,2006-04-17 15:14:48
dafc88b136b508c1c08129b756b6ba23b7c9d341...bb996614de4fddfa73286479f3c6a901107a2629,1,1,3,4,2,2006-04-17 22:06:40,2006-04-17 15:14:48
bb996614de4fddfa73286479f3c6a901107a2629...2855d58079cd56361879cc03f7c769409bb445e5,1,4,2,6,3,2006-04-18 00:46:07,2006-04-18 00:46:07
5910e997754e0a03f25457965bd9faf80f2f9854...91730800e975e208364261a691cbf28c5afe3bce,1,8,3,11,5,2006-04-11 00:52:17,2006-04-11 00:37:58
91730800e975e208364261a691cbf28c5afe3bce...944e3a88fe9fa767a9e0100661026992755ab917,1,3,3,6,3,2006-04-11 02:40:59,2006-04-11 00:37:58
9760662f1a7a06516ca249a73e5c1a6fb6c0e26e...e67c66251a41653e3698580410121c9afc46cd1a,1,10,5,15,2,2006-04-07 09:11:33,2006-04-07 06:06:09
9760662f1a7a06516ca249a73e5c1a6fb6c0e26e...5c51c98502bc885f6eda5046de00cdb3c976cad6,1,14,1,15,4,2006-04-07 09:09:18,2006-04-07 04:32:36
9760662f1a7a06516ca249a73e5c1a6fb6c0e26e...5379a5c5ee45d1380240a47573c7571de92626bb,1,236,48,284,17,2006-04-07 09:08:38,2006-04-06 06:24:57
96535e615db869f096686b0ce8e79e30dec7ad25...b8ab2e177a7dacc37af933ec382ef9ea929127ee,1,247,23,270,24,2006-06-03 09:11:13,2006-06-03 09:11:13
b8ab2e177a7dacc37af933ec382ef9ea929127ee...ef030b8547eaeea1ef992310536b0b637e0c9431,1,43,11,54,17,2006-06-04 01:50:38,2006-06-04 01:50:38
42277bc81ce2f4450fe08239e4db34516f879c1d...8d9fbe57b3acf756a9325884d11f004ef6f7e884,2,284,1,285,11,2006-04-05 01:06:35,2006-04-04 12:33:18
f23fc773a2acce9966ac7fa267818d5be55667fa...d9ea73e0564c7db8d791fe6b03c976ce57c9b079,4,84,46,130,11,2006-04-05 09:09:58,2006-04-05 09:03:58
c5e09c1fbec5dc1c15bcfe21e1a600f9e4b4e419...4bbdfab766782dc06ac496730e3a578bd35d67c5,1,1,1,2,1,2006-02-12 21:13:33,2006-02-12 21:13:12
4bbdfab766782dc06ac496730e3a578bd35d67c5...bd9ca0baff88107e26915cdaaf9821dc70a187e3,1,1,1,2,1,2006-02-12 21:14:53,2006-02-12 21:14:53
c5e09c1fbec5dc1c15bcfe21e1a600f9e4b4e419...810255fd12536d296597a0366f514bf65c2e10f6,1,14,3,17,4,2006-02-12 21:07:02,2006-02-12 16:06:14
6f2eacfeb2c67a7e05f98df2288d7893d3368c8e...d5a6aafc90a14382120727e4e81ee1a380e8b194,1,11,0,11,1,2006-01-11 00:02:54,2006-01-10 21:26:46
5a2282de13c4da13f979185e652c8a08e2481fd1...181129d24c83bfcbaa438579c5d3cd2531755232,2,11,3,14,3,2006-01-10 04:22:26,2006-01-10 02:07:01
181129d24c83bfcbaa438579c5d3cd2531755232...eb858c60d7850fc2ed2f69397f0560e707de324d,1,9,0,9,1,2006-01-10 06:59:58,2006-01-09 22:25:10
7765e7ebda7e273bca34e87110be899447068b58...acc075a8ad5ee798c170fc2276e1c840a03b5fa4,1,117,61,178,19,2005-11-13 07:43:11,2005-11-12 17:11:32
acc075a8ad5ee798c170fc2276e1c840a03b5fa4...54a9ba0d44c37c43670087793bfeb1b54d718cdb,1,2,0,2,1,2005-11-13 07:43:11,2005-11-12 17:38:28
54a9ba0d44c37c43670087793bfeb1b54d718cdb...8614e92323bff2319ca92b0718e3044e3b3b1f79,1,2,2,4,2,2005-11-13 09:32:21,2005-11-13 04:56:55
8614e92323bff2319ca92b0718e3044e3b3b1f79...ba1dbb61ea1dc6995ce8ff32e109110c1d5aa304,1,17,3,20,5,2005-11-13 09:33:26,2005-11-13 04:58:02
ba1dbb61ea1dc6995ce8ff32e109110c1d5aa304...ac0b86dadf243305810199096f0b35acd518abc1,2,7,1,8,2,2005-11-13 09:57:33,2005-11-13 09:57:33
ac0b86dadf243305810199096f0b35acd518abc1...abacbe4166bcf9d62f430a4a75de2e82df3799b1,1,8,7,15,2,2005-11-13 10:00:36,2005-11-12 16:33:24
abacbe4166bcf9d62f430a4a75de2e82df3799b1...0086e2c854e3af3209915e4ec2f933bcef400050,5,7,7,14,7,2005-11-13 10:07:02,2005-11-13 10:07:02
7765e7ebda7e273bca34e87110be899447068b58...ceae78b438d2e5ca035aec9b067643ca79ed4ccd,1,1,1,2,1,2005-11-12 22:15:50,2005-11-12 22:15:50
ceae78b438d2e5ca035aec9b067643ca79ed4ccd...4b1ca25e429a67de4828c029b053dea637732722,1,6,1,7,2,2005-11-14 07:31:00,2005-11-14 07:31:00
15fad5f4d750da31fbc004e6dd4c78fc0f20aca4...a65a686f4967ecba0759289d0e918f652980e8a2,1,61,48,109,6,2005-10-18 00:32:12,2005-10-18 00:32:12
a65a686f4967ecba0759289d0e918f652980e8a2...fd25c82a80533da035d42a5ac229ec5c5b332411,1,7,13,20,6,2005-10-18 00:38:09,2005-10-18 00:38:09
9f92f15f897fa1a943bcec324032cc4ca1f73ecf...e20b134d72dd02b51d81144fe082c55da31b27cd,1,4,0,4,1,2005-09-23 21:02:57,2005-09-23 21:02:57
e20b134d72dd02b51d81144fe082c55da31b27cd...ff8489cb0ad4274315fecffc1fb187b7951a51b5,1,4,1,5,2,2005-09-23 21:28:40,2005-09-23 10:06:04
ff8489cb0ad4274315fecffc1fb187b7951a51b5...a95cb6fb6b247cf90bd0b1a8bf989a0b42ada775,1,1,0,1,1,2005-09-23 21:30:42,2005-09-23 12:28:13
a95cb6fb6b247cf90bd0b1a8bf989a0b42ada775...d35bbe0b2e3765639c23978783a5319dfad33992,1,1,0,1,1,2005-09-23 21:30:45,2005-09-23 12:28:18
d35bbe0b2e3765639c23978783a5319dfad33992...8be707de55e473a5d850a1fcdc6e30589a37d548,1,3,0,3,2,2005-09-23 21:30:45,2005-09-23 12:28:23
8be707de55e473a5d850a1fcdc6e30589a37d548...1a951815ddaa4e4b570cc67e204f45e9a12841e0,1,4,2,6,2,2005-09-23 21:30:45,2005-09-23 12:28:28
1a951815ddaa4e4b570cc67e204f45e9a12841e0...e2b77f026a251a47ebdf634107e76f7b457087af,1,11,3,14,1,2005-09-23 21:30:45,2005-09-23 12:28:33
e2b77f026a251a47ebdf634107e76f7b457087af...628cd5430fdf71a75c02af88ab7b557d29687db5,1,12,5,17,8,2005-09-23 21:30:46,2005-09-23 12:28:38
628cd5430fdf71a75c02af88ab7b557d29687db5...e433b071fed7dbdf91437b489e261b86288542d8,1,5,5,10,4,2005-09-24 01:07:42,2005-09-23 23:30:50
e433b071fed7dbdf91437b489e261b86288542d8...dc56bc034176d76ce95e9ba7636e3551d51dc897,1,4,20,24,3,2005-09-24 01:43:53,2005-09-24 01:43:53
348c4c66dacb1810a9bcd592e72f98a465233488...1bedd4ca2130c3b8c6d9a68cbbaa29e053269a66,1,1,1,2,1,2005-09-24 06:26:55,2005-09-24 06:26:55
1bedd4ca2130c3b8c6d9a68cbbaa29e053269a66...e558e33b7bdb4a7c633bedd1606f7dd7ef912933,1,5,4,9,1,2005-09-24 18:19:07,2005-09-24 18:19:07
e558e33b7bdb4a7c633bedd1606f7dd7ef912933...b5cf3c8b7767e5f2c8b0df718ef91ccfc36c61fe,1,4,1,5,2,2005-09-24 18:20:43,2005-09-24 14:12:58
b5cf3c8b7767e5f2c8b0df718ef91ccfc36c61fe...9048fe1c50499d562dcf73094f173b12bdb084c4,2,32,8,40,12,2005-09-24 18:20:45,2005-09-24 14:13:01
9048fe1c50499d562dcf73094f173b12bdb084c4...da38641d7c1bd64f86bdd9e1f66fbff1cbb4f3b6,1,3,3,6,3,2005-09-24 18:20:45,2005-09-24 14:13:03
da38641d7c1bd64f86bdd9e1f66fbff1cbb4f3b6...6d9bbc50a3c57394261605f10942ce3af61e5e36,1,11,1,12,3,2005-09-24 18:26:22,2005-09-19 14:11:19
6d9bbc50a3c57394261605f10942ce3af61e5e36...229a7ed7ab3111b99fe6fb05c50c6687ae64c2b1,3,34,22,56,14,2005-09-24 18:26:22,2005-09-23 17:41:40
229a7ed7ab3111b99fe6fb05c50c6687ae64c2b1...d66189e2c937867e295aa348068b49498ae1b5ab,1,1,1,2,1,2005-09-24 21:58:57,2005-09-24 21:58:57
d66189e2c937867e295aa348068b49498ae1b5ab...c3bc895c81b6ec6906be7e6739edb4a50eecf6e9,1,4,2,6,2,2005-09-24 22:02:35,2005-09-24 22:02:35
c3bc895c81b6ec6906be7e6739edb4a50eecf6e9...7061f5c2c5fdde49a952db9dfe09bcfd8b8f9794,1,39,10,49,10,2005-09-25 05:05:55,2005-09-25 03:50:04
7061f5c2c5fdde49a952db9dfe09bcfd8b8f9794...cf408cb4a002855a9ffb58009c5f40da7f68b55e,2,6,4,10,3,2005-09-25 06:42:34,2005-09-25 06:42:34
cf408cb4a002855a9ffb58009c5f40da7f68b55e...a55797672d7c532173a3d01629ecdf42deecd16a,1,2,2,4,2,2005-09-25 06:48:29,2005-09-25 06:48:29
cfd8aefd4babcca5adbb724fb213ea3c8b1153c8...d5bc7eecbbb0b9f6122708bf5cd62f78ebdaafd8,2,7,1,8,2,2005-09-25 07:41:15,2005-09-25 07:36:26
967f8c918465312cc6cc1bcbcfacafcf95152bd8...f7f91086a376ba53f8270ea80b7bbbd8274c3c2d,2,40,0,40,2,2014-08-12 19:17:19,2014-08-12 04:34:53
4109c28e055dba27d73cefb956bea5e611f66ec0...8d30d8a89aa9bf8dfb477cb127af58448bbe9b96,1,104,0,104,1,2014-08-29 17:30:14,2014-08-29 11:53:36
8d30d8a89aa9bf8dfb477cb127af58448bbe9b96...2668d692eb1af63097628447f2e0c783b1a45e2e,2,7,3,10,4,2014-08-29 17:31:14,2014-08-29 11:53:37
4109c28e055dba27d73cefb956bea5e611f66ec0...26be19ba8d8d2e7e3e288b395e7156d5b7af5140,5,153,2,155,12,2014-08-26 19:58:02,2014-08-21 12:21:20
76f8611a5fb7e81c1bada0fb190d573a66fc03f6...5c31acfbe22cebdf1a04723b58cdb358e377632a,3,64,37,101,9,2015-03-02 22:59:55,2015-03-02 22:57:58
76f8611a5fb7e81c1bada0fb190d573a66fc03f6...a8bec7abcc78db991026ed20e16edf46141d6a77,1,1,0,1,1,2014-12-15 18:12:20,2014-12-15 16:35:27
76f8611a5fb7e81c1bada0fb190d573a66fc03f6...11f70a7e29ff7167e89aad186d763a4b017e48d9,1,19,11,30,5,2014-12-15 17:06:39,2014-12-14 15:59:46
11f70a7e29ff7167e89aad186d763a4b017e48d9...ab47e2a583917ecef5da269cc640f8359c8467ac,2,23,10,33,3,2014-12-15 17:06:40,2014-12-14 15:59:47
76f8611a5fb7e81c1bada0fb190d573a66fc03f6...1f32ecffd864ea5b339883f94463b0b69f4aeb35,2,9,1,10,2,2014-11-18 18:10:54,2014-11-18 13:50:24
76f8611a5fb7e81c1bada0fb190d573a66fc03f6...72549dfd5d33424fbf557b0078503687780a3a53,2,41,1,42,3,2014-11-04 20:13:46,2014-11-04 13:11:19
72549dfd5d33424fbf557b0078503687780a3a53...9233887cce8eaebd8469315622b84bd26910351f,2,36,2,38,3,2014-11-04 20:18:44,2014-11-04 13:24:53
76f8611a5fb7e81c1bada0fb190d573a66fc03f6...d76c9e95b435b660f8f1b3e01d3c2f934e2ec441,1,1,1,2,1,2014-10-30 19:51:10,2014-10-30 19:01:11
d76c9e95b435b660f8f1b3e01d3c2f934e2ec441...2ce406ccb85c4546b6d19309a6101b37c7bd952e,11,38,22,60,18,2014-10-30 19:51:10,2014-10-30 19:20:44
76f8611a5fb7e81c1bada0fb190d573a66fc03f6...03e11a715bffb0715ebcc9d6370aac7b968b3a4a,1,1,1,2,2,2014-10-21 18:22:00,2014-10-21 11:38:06
76f8611a5fb7e81c1bada0fb190d573a66fc03f6...7544b2e2da7170be8ccf04e1a3b64409c3d9eeec,1,1,1,2,1,2014-10-19 22:47:20,2014-10-17 21:39:00
76f8611a5fb7e81c1bada0fb190d573a66fc03f6...21134714787a02a37da15424d72c0119b2b8ed71,2,10,0,10,2,2014-10-19 22:08:38,2014-10-17 01:11:43
76f8611a5fb7e81c1bada0fb190d573a66fc03f6...4750f4b962b4f09b03fcdde86684cf60c6f6e46a,1,2,2,4,2,2014-10-16 20:12:34,2014-10-16 06:54:47
76f8611a5fb7e81c1bada0fb190d573a66fc03f6...74578618a0b0d291d214779748edfbafdecb4ae3,1,459,459,918,18,2014-10-15 20:47:51,2014-10-15 08:35:17
74578618a0b0d291d214779748edfbafdecb4ae3...4756c05741164a0889212f1e8151ff081b75bba2,1,2,8,10,3,2014-10-15 20:48:15,2014-10-15 08:35:18
76f8611a5fb7e81c1bada0fb190d573a66fc03f6...05e73682cd28eeaf6d949badefd85b94244fca3f,2,41,11,52,3,2014-10-14 22:12:07,2014-10-14 21:42:04
76f8611a5fb7e81c1bada0fb190d573a66fc03f6...64a7e92f28e9bc053cf68d9b2e9ce4fb40e60e98,1,8,10,18,8,2014-10-13 18:50:20,2014-10-11 11:00:16
f655651e09b9fa7bf8ff13f1b4a5b16c7956e4cf...85f083786fe37f280ca30fc0b74498b22b322c6d,3,54,2,56,3,2014-09-02 20:30:13,2014-09-02 20:30:13
764c739c16dc4877df312f71b50914c44edfc9ce...f82887f29010e1ec88ec1930a99ddc56b6438452,1,1,1,2,1,2014-08-08 20:52:16,2014-08-08 20:52:16
46c8f859b7eebe962d99c8547b0c908bbf8ecf0f...80b616d04b8f5a15b5d5587d67baf6e2e28c9f87,4,24,3,27,5,2014-09-30 05:15:00,2014-09-30 05:15:00
346fad5bb335e18813b04c63afda39d6c8e5554b...0c72b98f31bf6eabd75be565a08ffcf0d8e74b1f,1,42,3,45,6,2014-09-09 20:06:26,2014-09-09 20:06:26
5dcdc7809ea419cd792baf1cfa484261e883cd51...ce1d3a93a6405b8a0313491df3099919ed3d150f,1,42,1,43,5,2014-09-11 18:19:47,2014-09-11 18:19:47
b8f7239058e6f7c8bb68bd4276ff797d83e03229...349cb5096397d9d1da33f2d046fa7e192e6214e7,4,48,3,51,5,2014-09-19 21:21:31,2014-09-19 21:21:31
8a7b034d6d451491dbcfaebc3d4ed4f08c756822...8939d32d818180cfd64c9eed7ad97bf2601d8f5f,1,4,22,26,3,2014-08-07 20:33:25,2014-08-07 16:21:16
8939d32d818180cfd64c9eed7ad97bf2601d8f5f...6881f0ccb4365d1beb1673f740952064d204bd50,1,12,19,31,6,2014-08-07 20:33:26,2014-08-07 16:21:17
6881f0ccb4365d1beb1673f740952064d204bd50...b27a5720996172fbb2cc809f88f4eea09b5bbc42,1,3,11,14,3,2014-08-07 20:33:26,2014-08-07 16:21:18
b27a5720996172fbb2cc809f88f4eea09b5bbc42...95790ff60d35e6a9e212fa0f9ffedaabddd1182c,1,3,9,12,2,2014-08-07 20:33:27,2014-08-07 16:21:19
95790ff60d35e6a9e212fa0f9ffedaabddd1182c...f44af51d1380d2bab18dad64e9c0bbe171c72486,1,8,27,35,4,2014-08-07 20:33:27,2014-08-07 16:21:20
f44af51d1380d2bab18dad64e9c0bbe171c72486...633e5ad326934401ef6cb128c3213386d0ebaf7a,1,12,31,43,8,2014-08-07 20:33:27,2014-08-07 16:21:21
633e5ad326934401ef6cb128c3213386d0ebaf7a...5801d3b41680a4499350754d8e00f5c8c09d790e,1,20,31,51,8,2014-08-07 20:33:28,2014-08-07 16:21:22
5801d3b41680a4499350754d8e00f5c8c09d790e...586f414a89d13fc0ea38121528c863f3726bc18b,1,13,27,40,6,2014-08-07 20:33:28,2014-08-07 16:21:23
586f414a89d13fc0ea38121528c863f3726bc18b...ef7e1d0cdac8f55290f60c78dca00bfb84e7a925,1,26,34,60,6,2014-08-07 20:33:28,2014-08-07 16:21:24
ef7e1d0cdac8f55290f60c78dca00bfb84e7a925...111791559e69011a6d55f053393d154a1840b4f5,1,6,19,25,2,2014-08-07 20:33:29,2014-08-07 16:21:25
111791559e69011a6d55f053393d154a1840b4f5...540b0f497701fca2749de86c58bc16f44fcb30b5,1,7,20,27,3,2014-08-07 20:33:29,2014-08-07 17:56:42
540b0f497701fca2749de86c58bc16f44fcb30b5...536900e5b24f8341bcaf2a26371fcd3ca417eef9,1,21,23,44,9,2014-08-13 19:36:02,2014-08-13 12:22:56
536900e5b24f8341bcaf2a26371fcd3ca417eef9...6ea358f784a5d8823565a8574d8ed914e51096f4,1,6,17,23,3,2014-08-13 19:36:21,2014-08-13 12:43:04
6ea358f784a5d8823565a8574d8ed914e51096f4...0e7bcb1b00179113c0cccb8f2f4768d41cf6fff2,1,6,16,22,3,2014-08-13 19:37:41,2014-08-13 08:22:01
0e7bcb1b00179113c0cccb8f2f4768d41cf6fff2...b35b10d463fbc274a2edd006f6f5ab46e66a4722,1,5,7,12,3,2014-08-13 19:37:47,2014-08-13 08:22:02
d299e9e550c1bf8640907fdba1f03cc585ee71df...97d6e799aaa5048a3a5f57c11b5685be0a5a5a52,1,30,1,31,1,2014-07-30 19:16:07,2014-07-28 10:42:26
d299e9e550c1bf8640907fdba1f03cc585ee71df...d8b396e17ecfe28b39b5f4470f791c434cce40ec,1,1,0,1,1,2014-07-30 18:32:12,2014-07-30 09:45:11
d8b396e17ecfe28b39b5f4470f791c434cce40ec...32f56600bb6ac6fc57183e79d2c1515dfa56672f,4,9,3,12,5,2014-07-30 21:19:53,2014-07-30 21:19:53
d299e9e550c1bf8640907fdba1f03cc585ee71df...2d186c8be5bea10640927e0822bd9e1c7a2e01ea,1,4,4,8,5,2014-07-28 23:17:12,2014-07-28 18:42:05
da33a97998f6d6206c08bd72a527f5b8e6e26d33...960160b061a29a4a4ae637e035c3892da72326ac,1,4,1,5,2,2014-08-18 17:20:36,2014-08-17 07:07:32
e8d08871c97cf8e932ded11ef1659d5d14e4b36a...f57a8715bc5f50234dd1f756b3b26a0b81c3784c,15,56,60,116,48,2014-07-21 22:42:34,2014-07-21 22:09:27
f57a8715bc5f50234dd1f756b3b26a0b81c3784c...b0562224c93aca5addd994e37cd851b7a5de44b8,2,9,9,18,9,2014-07-21 22:42:34,2014-07-21 22:20:36
5c0b13f85ab3a5326508b854768eb70c8829cda4...3a224ff2bbb8a3782d6db67426aa8bc09063ab08,1,5,0,5,1,2014-07-22 20:21:07,2014-07-22 18:24:56
3a224ff2bbb8a3782d6db67426aa8bc09063ab08...9e8a6a9433d2e750779a90663e2e9dca8a8c5c71,1,1,0,1,1,2014-07-22 20:23:39,2014-07-22 18:24:57
9e8a6a9433d2e750779a90663e2e9dca8a8c5c71...aaf7253f84477d4be9b56072804e53c3098aaa90,1,21,1,22,3,2014-07-22 20:30:30,2014-07-22 18:24:58
0217569bb2db23b8686f67b0f4dda7e517dec6fd...e6ce2be2d7a70dfa3241f70ae236da4a63625ef8,4,13,7,20,6,2014-07-15 18:19:11,2013-09-02 14:44:54
e6ce2be2d7a70dfa3241f70ae236da4a63625ef8...9ae1afa5e659dc61602e8f50fe469c21a9704319,1,3,20,23,4,2014-07-17 17:54:14,2014-07-17 15:37:54
9ae1afa5e659dc61602e8f50fe469c21a9704319...7eb2619c5cce7034cca1cdd07a090cbe648a3911,1,14,11,25,10,2014-07-21 16:32:48,2014-07-17 15:37:55
7eb2619c5cce7034cca1cdd07a090cbe648a3911...b729f98fa50b10cfba7cbf3f37a0ac255e1fbdcd,2,17,0,17,4,2014-07-21 16:32:48,2014-07-17 15:37:56
b729f98fa50b10cfba7cbf3f37a0ac255e1fbdcd...e96942e821dec273b884fec378cc2a97a7f5d689,3,7,6,13,6,2014-07-21 16:32:49,2014-07-17 15:37:57
e96942e821dec273b884fec378cc2a97a7f5d689...38d2750126f326c21b06d63e7c21b05d3a6b74f7,1,1,2,3,1,2014-07-21 16:32:49,2014-07-17 15:37:58
38d2750126f326c21b06d63e7c21b05d3a6b74f7...26c7b21ab107bea5d7c308fa5c286af54dfd8cec,1,7,7,14,7,2014-07-21 16:32:49,2014-07-17 15:37:59
26c7b21ab107bea5d7c308fa5c286af54dfd8cec...df0e998c31a6d91b905b1ad5b3ff89435ba29313,1,32,23,55,2,2014-07-21 16:32:49,2014-07-17 15:38:00
df0e998c31a6d91b905b1ad5b3ff89435ba29313...77734da241f97607eea8f2bb55e0e19937e918d4,3,30,64,94,22,2014-07-21 16:32:49,2014-07-17 15:38:01
77734da241f97607eea8f2bb55e0e19937e918d4...f279242d5e3f17e01e1d70010c4f072798899a47,1,35,27,62,17,2014-07-21 16:32:49,2014-07-17 15:38:02
f279242d5e3f17e01e1d70010c4f072798899a47...6f1c189cadd7c18c03138070324af02563c0b0d1,1,28,15,43,6,2014-07-21 16:32:50,2014-07-17 15:38:03
6f1c189cadd7c18c03138070324af02563c0b0d1...343ff06da7d83f40892b10a3b653c7d0e6cb526c,1,65,39,104,13,2014-07-21 16:32:50,2014-07-17 15:38:04
343ff06da7d83f40892b10a3b653c7d0e6cb526c...6dc715439b8e9ec85d6412750665431dd6a5afc6,1,12,13,25,3,2014-07-21 16:32:50,2014-07-17 15:38:05
6dc715439b8e9ec85d6412750665431dd6a5afc6...baea068d677fae92d7903e984cf93bbd5195a000,1,4,0,4,1,2014-07-21 16:32:50,2014-07-17 15:38:06
3d15f536a7f5215eddae20214fb8eaeeb6baaf27...3ed3f5fe85ac3fa7f94ccaab59408a20db8c7a41,3,13,0,13,3,2014-07-21 17:23:36,2014-07-18 09:18:59
3ed3f5fe85ac3fa7f94ccaab59408a20db8c7a41...f93d7c6fa0548e95ca2795d900671a87c1a88ea3,4,6,15,21,5,2014-07-21 17:23:44,2014-07-18 09:19:00
3d15f536a7f5215eddae20214fb8eaeeb6baaf27...e0a064a10749a8039f28e9bd3de0ffb5cf99e678,1,3,0,3,1,2014-07-16 17:42:49,2014-07-15 22:53:27
3d15f536a7f5215eddae20214fb8eaeeb6baaf27...b6266dc88b1fcc91d084cc9c65e0b0805cf59d55,1,11,4,15,4,2014-07-15 22:05:02,2014-07-15 19:14:02
b6266dc88b1fcc91d084cc9c65e0b0805cf59d55...1e0dacdbdb751caa5936b6d1510f5e8db4d1ed5f,4,32,6,38,8,2014-07-16 20:07:40,2014-07-16 19:23:49
6acbf0330082999fdd39f2200a39c1af44fa7e22...dc4a1ba99c968d71ebe27c05c5a600e6df74e408,1,1493,1342,2835,1290,2014-08-05 12:49:51,2014-08-05 12:49:51
6acbf0330082999fdd39f2200a39c1af44fa7e22...8d388239fdbc4db2945669c18a6e8c781e4f41ce,1,1503,1350,2853,1297,2014-08-05 00:35:56,2014-08-05 00:35:56
6acbf0330082999fdd39f2200a39c1af44fa7e22...aafbee8c4b73f02ceac3eb066586620c2f720c43,1,601,549,1150,517,2014-08-04 18:30:38,2014-08-03 10:04:51
cb682f8cfe63ecd0da08a526f404d295e51e3ab1...026bd1d3e27a9e9b8f6b0098644c5753a2a1e355,2,8,15,23,6,2014-07-14 18:54:40,2014-06-20 14:42:42
026bd1d3e27a9e9b8f6b0098644c5753a2a1e355...33f9fc593247322ddea5515f548a06cf34d12c2f,3,3,4,7,4,2014-07-14 18:54:40,2014-06-20 14:42:43
33f9fc593247322ddea5515f548a06cf34d12c2f...f1c9350ad784eca97184b73973fad353baa99a1d,2,8,6,14,6,2014-07-14 18:54:40,2014-06-20 14:42:44
f1c9350ad784eca97184b73973fad353baa99a1d...1b07255c95cdf2f7dbe7989a734248f60799f506,1,3,0,3,1,2014-07-14 18:54:40,2014-06-20 14:42:45
1b07255c95cdf2f7dbe7989a734248f60799f506...995f8746bc421a537e12622770a90be2205cd26f,3,10,3,13,5,2014-07-14 18:54:40,2014-06-20 14:42:46
995f8746bc421a537e12622770a90be2205cd26f...6af926e8bcab15b42faeee9f2fe1c69b5fea1b15,2,14,10,24,8,2014-07-14 18:54:40,2014-06-20 14:42:47
6af926e8bcab15b42faeee9f2fe1c69b5fea1b15...447ff1bf0acf9a1d7d2dc3aed032c209f105fb8a,3,14,5,19,7,2014-07-14 18:54:41,2014-06-20 14:42:48
447ff1bf0acf9a1d7d2dc3aed032c209f105fb8a...60bca085c893f1866829b55bfee63888943cfe14,3,19,8,27,9,2014-07-14 18:54:41,2014-06-20 14:42:49
60bca085c893f1866829b55bfee63888943cfe14...bd3b02daec241651231f63b3fd8ee2a8ea1dac68,2,22,9,31,5,2014-07-14 18:54:41,2014-06-20 14:42:50
bd3b02daec241651231f63b3fd8ee2a8ea1dac68...835e3c992fd453d172466be29283b55a792cac76,2,9,1,10,6,2014-07-14 18:54:41,2014-06-20 14:42:51
835e3c992fd453d172466be29283b55a792cac76...470a91ef75d61d102c9cb655a7b8ea1555337d2d,1,4,1,5,4,2014-07-14 18:54:41,2014-06-20 14:42:52
470a91ef75d61d102c9cb655a7b8ea1555337d2d...d3f665550588d19d6d6c9f9064aa3d4685afdf4d,2,10,1,11,6,2014-07-14 18:54:41,2014-06-20 14:42:53
d3f665550588d19d6d6c9f9064aa3d4685afdf4d...76d70dc0c63fe89958308f249136864aec5cdf03,2,16,5,21,10,2014-07-14 18:54:42,2014-06-20 14:42:54
76d70dc0c63fe89958308f249136864aec5cdf03...dc615de8610c807633c63313937056bf45df0b8f,1,23,5,28,8,2014-07-14 18:54:42,2014-06-20 14:42:55
dc615de8610c807633c63313937056bf45df0b8f...038d005129467a514189e8cc1321022f71f6a51e,1,5,1,6,3,2014-07-14 18:54:42,2014-06-20 14:42:56
038d005129467a514189e8cc1321022f71f6a51e...c1703d7634a61b4d08d77fa0d9ca7e7ad92c3cb8,1,6,3,9,4,2014-07-14 18:54:42,2014-06-20 14:42:57
c1703d7634a61b4d08d77fa0d9ca7e7ad92c3cb8...8bcd37482e95b47119f3a8f03a1c8ce5815594a3,1,5,5,10,5,2014-07-14 18:54:42,2014-06-20 14:42:58
8bcd37482e95b47119f3a8f03a1c8ce5815594a3...01319837c53050109c60e6740dfa9462327161f0,3,9,19,28,8,2014-07-14 18:54:42,2014-06-20 14:42:59
01319837c53050109c60e6740dfa9462327161f0...8e34800e5bce1dc6f1ab5520a4c866a2a73639de,3,28,16,44,10,2014-07-14 18:54:42,2014-06-20 14:43:00
cb682f8cfe63ecd0da08a526f404d295e51e3ab1...0be7d9b73d21443e216454564dd4df8d2a227789,1,11,0,11,1,2014-06-20 17:20:42,2014-06-19 20:12:23
0be7d9b73d21443e216454564dd4df8d2a227789...42639d2317ac8b15aae3e28468b7c86e0eb89800,1,640,0,640,1,2014-07-14 19:06:15,2014-07-01 21:24:14
42639d2317ac8b15aae3e28468b7c86e0eb89800...d78ecca5206c65aff55573029b9fa2dd9c9cf4e1,1,5,0,5,2,2014-07-14 19:06:15,2014-06-15 16:58:44
d78ecca5206c65aff55573029b9fa2dd9c9cf4e1...558643e1d67496e72540c61b90d1f38067323fbf,1,20,0,20,1,2014-07-14 19:06:15,2014-06-15 16:59:20
558643e1d67496e72540c61b90d1f38067323fbf...48294e1ddb4e31531d3025da0a6bed54cc4b72ac,1,12,0,12,1,2014-07-14 19:06:15,2014-06-15 16:59:51
48294e1ddb4e31531d3025da0a6bed54cc4b72ac...8ef85694a5f45dd22ea9d433066dcfad6b7ab73f,1,14,0,14,1,2014-07-14 19:06:15,2014-06-15 17:00:28
8ef85694a5f45dd22ea9d433066dcfad6b7ab73f...8f8ba56b5b6321b07eba29bb7ae6a94b5ae0d34a,1,32,0,32,1,2014-07-14 19:06:15,2014-06-19 20:12:48
8f8ba56b5b6321b07eba29bb7ae6a94b5ae0d34a...663ed39a889dae8beee2fc6953607f7660a5cddf,2,40,3,43,4,2014-07-14 19:06:15,2014-06-15 17:01:41
663ed39a889dae8beee2fc6953607f7660a5cddf...c7e69168cf9215f50c42666c7e0dbb1f21c69e20,1,46,0,46,1,2014-07-14 19:06:16,2014-06-19 20:12:51
c7e69168cf9215f50c42666c7e0dbb1f21c69e20...921f50b48e2d5283bbd3c5ea2c64ad7407a2bc1c,1,45,0,45,1,2014-07-14 19:06:16,2014-06-15 17:02:47
921f50b48e2d5283bbd3c5ea2c64ad7407a2bc1c...283f56a40bd9538d7277bb866526d5cae4494eec,2,25,3,28,4,2014-07-14 19:06:16,2014-06-15 17:03:18
283f56a40bd9538d7277bb866526d5cae4494eec...23e2f388c7da3cfe72c880e662dafb0c2965abba,1,21,0,21,1,2014-07-14 19:06:16,2014-06-15 17:03:53
23e2f388c7da3cfe72c880e662dafb0c2965abba...da7fe3fb6d810507bef586e76a01bb34758d4472,2,42,5,47,6,2014-07-14 19:06:16,2014-06-19 20:12:54
da7fe3fb6d810507bef586e76a01bb34758d4472...1621c99c79875d6537edc59b6c2b4c2038a97b20,1,32,0,32,1,2014-07-14 19:06:16,2014-06-19 20:12:56
cb682f8cfe63ecd0da08a526f404d295e51e3ab1...be99ec97c8a1f94e723c6cc5331eff921ae49ed3,1,1,1,2,1,2014-06-20 17:08:10,2014-06-20 02:06:43
be99ec97c8a1f94e723c6cc5331eff921ae49ed3...ccdd4a0f3c7c550526a980e93156f25a956497bc,5,15,34,49,8,2014-06-20 17:12:14,2014-06-20 02:06:44
cb682f8cfe63ecd0da08a526f404d295e51e3ab1...30a0ddb705678d512185e359831479a6b3567147,2,28,0,28,2,2014-06-19 19:25:17,2014-06-18 20:01:34
30a0ddb705678d512185e359831479a6b3567147...fa3f60b783b42e0d07c667a8f582c3df12791cec,2,7,16,23,6,2014-06-19 19:25:17,2014-06-18 20:02:13
fa3f60b783b42e0d07c667a8f582c3df12791cec...95244ae3dd49b3eed4dbfe09299b9d8847622218,3,4,10,14,5,2014-06-19 22:20:53,2014-06-19 21:19:43
95244ae3dd49b3eed4dbfe09299b9d8847622218...283101869bea8feb5d58f6ea1b568e9b197526d3,6,18,41,59,16,2014-06-19 22:20:54,2014-06-19 21:24:33
283101869bea8feb5d58f6ea1b568e9b197526d3...b2724c87872aaec55dd7e5529aa029c3108b43a5,5,6,23,29,6,2014-06-19 22:20:54,2014-06-19 21:26:56
b2724c87872aaec55dd7e5529aa029c3108b43a5...a0279e1865c7ce7417c0134e2ab32b20531f502a,1,4,8,12,2,2014-06-19 22:20:55,2014-06-19 21:28:00
a0279e1865c7ce7417c0134e2ab32b20531f502a...3bdd55228b1b76a2c37143636966f333e3782888,1,2,7,9,2,2014-06-19 22:20:55,2014-06-19 21:28:20
3bdd55228b1b76a2c37143636966f333e3782888...5c1753b198a96ed6abaf6c09db4623df703005a6,1,13,29,42,5,2014-06-19 22:20:55,2014-06-19 21:29:31
5c1753b198a96ed6abaf6c09db4623df703005a6...f33206992de994424036a7d9912a968ab9829e6e,1,9,9,18,5,2014-06-19 22:20:56,2014-06-19 21:29:48
f33206992de994424036a7d9912a968ab9829e6e...45bc131dd3e1eb6edd903957cf9d42f37ad02181,1,26,15,41,3,2014-06-19 22:20:56,2014-06-19 21:30:26
45bc131dd3e1eb6edd903957cf9d42f37ad02181...cb6c38d5cce7d8d48a57346b332a68cea1489df1,1,9,9,18,2,2014-06-25 17:33:27,2014-06-24 20:58:15
cb682f8cfe63ecd0da08a526f404d295e51e3ab1...9e1a5ebe52d84c35eee18a896ad1b8bab53cadbf,1,10,10,20,10,2014-06-18 21:56:17,2014-06-18 19:41:50
9e1a5ebe52d84c35eee18a896ad1b8bab53cadbf...1055a890f04784d7ea7cdaca8d30479e685d8643,1,7,7,14,6,2014-06-18 21:56:24,2014-06-18 19:41:58
1055a890f04784d7ea7cdaca8d30479e685d8643...c0264180d74510669bcec9bb5ff12a145c685b8e,1,1,1,2,1,2014-06-18 21:56:54,2014-06-18 19:42:14
c0264180d74510669bcec9bb5ff12a145c685b8e...cf4fff579e02d8585d59f6c8739534b7b0d617dd,18,73,58,131,35,2014-06-20 17:44:43,2014-06-18 19:44:19
cf4fff579e02d8585d59f6c8739534b7b0d617dd...ce2ecf29241ca90655da37918044cbbaff48a2bd,1,3,2,5,2,2014-06-20 17:44:44,2014-06-18 19:45:34
ce2ecf29241ca90655da37918044cbbaff48a2bd...ff45c0d4a316d620d118ec628dd8e78597a23321,1,8,5,13,4,2014-06-20 17:44:44,2014-06-18 19:46:15
ff45c0d4a316d620d118ec628dd8e78597a23321...21a2d4ada52132e6b0b67f8e28aa4bcda416f7f2,1,7,7,14,4,2014-06-20 17:44:44,2014-06-18 19:47:17
21a2d4ada52132e6b0b67f8e28aa4bcda416f7f2...ae021d87911da4328157273df24779892cb51277,11,149,131,280,81,2014-06-20 17:44:45,2014-06-18 19:47:50
ae021d87911da4328157273df24779892cb51277...95b567c7c3cf6b85d74b79424cdfbd40a7dee7c9,10,44,54,98,34,2014-06-20 17:44:45,2014-06-18 19:48:29
95b567c7c3cf6b85d74b79424cdfbd40a7dee7c9...97313bef2a16eb8b3d40830204c20c34ba9d6554,1,51,72,123,44,2014-06-20 17:44:45,2014-06-18 19:49:12
97313bef2a16eb8b3d40830204c20c34ba9d6554...d12c24d2a96f8f9aeb100b800d8fb217f28a6a2a,1,6,5,11,2,2014-06-20 17:45:18,2014-06-18 19:49:44
d12c24d2a96f8f9aeb100b800d8fb217f28a6a2a...0539cc0038ff3411da1fea342b7d6615643bff5b,1,2,1,3,1,2014-06-20 17:45:19,2014-06-18 19:51:17
0539cc0038ff3411da1fea342b7d6615643bff5b...e814c39c2fe7cc915ba70c0aa6f03156a28920fc,1,7,13,20,11,2014-06-20 17:45:19,2014-06-18 19:51:57
e814c39c2fe7cc915ba70c0aa6f03156a28920fc...82e56767aa9334bb0c4cfe81964a576778b93d6e,1,9,6,15,5,2014-06-20 17:45:19,2014-06-18 19:56:03
82e56767aa9334bb0c4cfe81964a576778b93d6e...6d87780399e1196932cd5ea72f84aa90224e7402,1,2,2,4,1,2014-06-20 17:45:19,2014-06-18 19:56:48
6d87780399e1196932cd5ea72f84aa90224e7402...de8118e153c5e527263086605e437ccca5d4f1ef,2,6,8,14,8,2014-06-20 17:45:19,2014-06-18 19:57:17
de8118e153c5e527263086605e437ccca5d4f1ef...59a642f8ac42c6cd11f63175689aa21b27ce1a6a,1,1,5,6,2,2014-06-20 17:45:19,2014-06-19 05:22:46
59a642f8ac42c6cd11f63175689aa21b27ce1a6a...67a31f612830e79fe768ac886ed9ef7eadd8fb10,1,23,15,38,7,2014-06-20 17:45:19,2014-06-19 21:58:10
cb682f8cfe63ecd0da08a526f404d295e51e3ab1...5991a55c545bca32fc4f5e69ee58de86563a93fa,2,19,11,30,3,2014-06-17 16:37:47,2014-06-11 07:56:49
5991a55c545bca32fc4f5e69ee58de86563a93fa...4a3b0b25f182727876bfb01748b2d00dd43f9ad7,2,12,12,24,9,2014-06-17 16:37:47,2014-06-11 07:57:23
4a3b0b25f182727876bfb01748b2d00dd43f9ad7...0d0424272f85afb5262613829cf1f48f994cebc7,1,0,1,1,1,2014-06-17 16:37:47,2014-06-11 07:57:59
0d0424272f85afb5262613829cf1f48f994cebc7...6aa3085702cc7a436c12f4c4396958281df1da44,6,78,59,137,34,2014-07-14 04:24:23,2014-07-12 00:00:06
6aa3085702cc7a436c12f4c4396958281df1da44...eb9250dfd5fbd7c9f95d0d3134006cd19a0c9099,1,34,16,50,2,2014-07-14 04:25:18,2014-07-12 00:00:53
eb9250dfd5fbd7c9f95d0d3134006cd19a0c9099...67dc598ec42ea25cda94ed8d283396c4ab385f50,2,6,28,34,5,2014-07-14 04:25:18,2014-07-12 00:01:38
67dc598ec42ea25cda94ed8d283396c4ab385f50...c69dfd24db21be54ec5a17bb3e07c81f4e96861a,2,34,15,49,11,2014-07-14 04:25:18,2014-07-12 00:02:18
c69dfd24db21be54ec5a17bb3e07c81f4e96861a...124647c4b007eff04144d75042d9d95f63e303f7,2,10,0,10,3,2014-07-14 04:25:19,2014-07-12 00:03:01
124647c4b007eff04144d75042d9d95f63e303f7...b72be02cfb402bbd6abac07af7231613cd37d594,1,9,1,10,2,2014-07-14 04:25:19,2014-07-12 00:03:50
b72be02cfb402bbd6abac07af7231613cd37d594...66f66c596fa2b4e7d4c00575a5731d33ab28d4ed,2,26,22,48,15,2014-07-14 04:25:19,2014-07-12 00:04:29
66f66c596fa2b4e7d4c00575a5731d33ab28d4ed...e05bed960d3bf3bcfd0f27ab882df3da93e118ed,3,126,12,138,18,2014-07-14 04:25:20,2014-07-12 00:05:03
e05bed960d3bf3bcfd0f27ab882df3da93e118ed...148d6771bf5e00aa1d7fa2221507a3dfe4c1e37f,4,91,0,91,5,2014-07-14 04:25:20,2014-07-12 00:05:42
148d6771bf5e00aa1d7fa2221507a3dfe4c1e37f...09b2c1c769a69d3ff03ee7913fa50fa05b4f5a46,2,65,0,65,6,2014-07-14 04:25:20,2014-07-12 00:06:28
09b2c1c769a69d3ff03ee7913fa50fa05b4f5a46...578da0391a7958510b960eaf1ef30d13e791554e,4,30,0,30,4,2014-07-14 04:25:21,2014-07-12 00:07:01
578da0391a7958510b960eaf1ef30d13e791554e...132d41e69a460f1bb72ba9eb41c513c42d9a8532,1,3,11,14,3,2014-07-14 04:25:21,2014-07-12 00:07:36
132d41e69a460f1bb72ba9eb41c513c42d9a8532...83d26fa724ef2efbeb332fa3dc92b00c0e579f28,1,38,37,75,10,2014-07-14 04:25:21,2014-07-12 00:08:11
83d26fa724ef2efbeb332fa3dc92b00c0e579f28...c7d3f8cb48d754371343c5a48cf392135bb4d77b,1,97,0,97,1,2014-07-14 04:25:21,2014-07-12 00:08:48
14ce98d7e9f4cb84bc7edd41bd29abf0fa901490...79dcccc503ac228630ecf15dcf8e1d9455daef2d,3,88,2,90,3,2014-06-03 19:09:13,2014-06-03 19:08:37
897f964c0dce8e7cc2cc53bb19b83cadce106773...412cb2ec1302364aba862b183210249c2ca7d44e,1,8,3,11,1,2015-01-15 23:42:50,2015-01-15 23:20:09
d5067112db68fcc8c7b13c769c896b17480cb5b0...f3f11fa6a5cee5a90b3ca6a66a25a2beff6996a7,1,28,13,41,5,2014-04-28 21:29:14,2014-04-28 21:01:23
59d3924fbb300ebfe05f9079bcfe29d0a3f30661...9dd70e0a0d17aa66c2d95a05952dec05db156fe3,1,1,1,2,1,2014-12-12 23:13:37,2014-12-12 21:59:56
59d3924fbb300ebfe05f9079bcfe29d0a3f30661...66ab301c165b5ba6395b7bcc7cf35a7592f9f46f,1,8,8,16,5,2014-05-13 18:52:51,2014-05-13 13:21:19
bd368a9baf5a42e2076ef4c8a35312ccab171452...9bfeaa0bcf2d7150836b583196e18f973c3be17f,1,1,1,2,1,2014-04-23 22:17:01,2014-04-23 13:43:53
9bfeaa0bcf2d7150836b583196e18f973c3be17f...0eca37c63a1e03e4f33366157eb406c8182bf0e9,1,3,3,6,3,2014-04-23 22:17:01,2014-04-23 13:43:54
0eca37c63a1e03e4f33366157eb406c8182bf0e9...5c00acdd25b0b214e511fa35faaff8595467c480,1,1,1,2,1,2014-04-23 22:17:01,2014-04-23 13:43:55
5c00acdd25b0b214e511fa35faaff8595467c480...faf58f4ee6a5599c3b8790b770d6e1736174b7a3,1,7,7,14,3,2014-04-23 22:17:01,2014-04-23 13:43:56
faf58f4ee6a5599c3b8790b770d6e1736174b7a3...eadf619cd434135bdfa598566376b3e3dbf9f2b5,1,1,1,2,1,2014-04-23 22:17:02,2014-04-23 13:43:58
eadf619cd434135bdfa598566376b3e3dbf9f2b5...f257482c9ccbb27e70f190da6a8152469b0fed1b,1,2,2,4,2,2014-04-23 22:17:02,2014-04-23 13:43:59
f257482c9ccbb27e70f190da6a8152469b0fed1b...728fc79c0016fd7133c32f1d193d0a243e552257,1,4,4,8,3,2014-04-23 22:17:02,2014-04-23 13:44:00
728fc79c0016fd7133c32f1d193d0a243e552257...d0ea45bfc7129304016b24bdb18523b927d0ab17,1,1,1,2,1,2014-04-23 22:17:02,2014-04-23 13:44:01
d0ea45bfc7129304016b24bdb18523b927d0ab17...9e5878fbede57c0499133adf73844261849cd7b2,1,3,3,6,3,2014-04-23 22:17:02,2014-04-23 13:44:02
9e5878fbede57c0499133adf73844261849cd7b2...5a4352024ae71613186730e3a3ab670f43904ad6,1,1,1,2,1,2014-04-23 22:17:02,2014-04-23 13:44:03
5a4352024ae71613186730e3a3ab670f43904ad6...03db917867bfd27c7a1f8e5b713d7bd7d3f6370e,1,1,1,2,1,2014-04-23 22:17:03,2014-04-23 13:44:04
03db917867bfd27c7a1f8e5b713d7bd7d3f6370e...be194d53c0ce38ab3e040c6be249550fab4e8e1c,1,1,1,2,1,2014-04-23 22:17:03,2014-04-23 13:44:05
be194d53c0ce38ab3e040c6be249550fab4e8e1c...4717659144984c7fbfd2c01a2c22f342756e2abd,1,1,1,2,1,2014-04-23 22:17:03,2014-04-23 13:44:06
4717659144984c7fbfd2c01a2c22f342756e2abd...88619b3ee4bd21254d3306b12f47be3f0d9ad04b,1,6,6,12,6,2014-04-29 19:44:22,2014-04-28 12:57:24
88619b3ee4bd21254d3306b12f47be3f0d9ad04b...8fc5593c53218d19c7a0bac34debeaf6328e4f62,1,2,2,4,2,2014-04-29 19:44:23,2014-04-28 12:57:25
8fc5593c53218d19c7a0bac34debeaf6328e4f62...def226bdbb53d32f6c3f6bb66cfe1810089033df,1,21,21,42,12,2014-04-29 19:44:24,2014-04-28 12:57:26
def226bdbb53d32f6c3f6bb66cfe1810089033df...0bf6414996d5acbefaaf808ec417c45661981bd0,1,19,19,38,11,2014-04-29 19:44:25,2014-04-28 12:57:27
0bf6414996d5acbefaaf808ec417c45661981bd0...8deeab4a2413868b44fda4a0d0c56d2a7c45c6be,1,10,10,20,5,2014-04-29 19:44:27,2014-04-28 12:57:28
8deeab4a2413868b44fda4a0d0c56d2a7c45c6be...4d713567f9e79f738e7b309ad0222e1517871f9c,1,10,10,20,2,2014-04-29 19:44:28,2014-04-28 12:57:29
4d713567f9e79f738e7b309ad0222e1517871f9c...dd64267fe2151b1ea3f19b5745d0fa8321995381,1,1,1,2,1,2014-04-29 19:44:29,2014-04-28 12:57:30
dd64267fe2151b1ea3f19b5745d0fa8321995381...86e30432177470f50be4207da2cc0422f86a24f7,1,2,2,4,2,2014-04-29 19:44:30,2014-04-28 12:57:31
86e30432177470f50be4207da2cc0422f86a24f7...142efa3e43e9c61cb5b97dbe69d36ca090d683d5,1,9,9,18,9,2014-04-29 19:44:32,2014-04-28 12:57:32
142efa3e43e9c61cb5b97dbe69d36ca090d683d5...9b3bc877f0b01826beaa3ef00b5e3b2c49fb09cc,1,5,5,10,5,2014-04-29 19:44:33,2014-04-28 12:57:33
9b3bc877f0b01826beaa3ef00b5e3b2c49fb09cc...7f311eb54ba45e1bcdda0900da891e4652614b30,1,1,1,2,1,2014-04-29 19:44:35,2014-04-28 12:57:34
7f311eb54ba45e1bcdda0900da891e4652614b30...77317c0c5c24e799a397b7d32080a9490fc23b11,1,4,4,8,4,2014-04-29 19:44:36,2014-04-28 12:57:35
77317c0c5c24e799a397b7d32080a9490fc23b11...c9e454ccef2f572ce532e29b9d1317c02764545e,1,11,11,22,10,2014-04-29 19:44:37,2014-04-28 12:57:36
c9e454ccef2f572ce532e29b9d1317c02764545e...714c71b2b1531f7e1099d17ab8ae03fa21f4b88c,1,2,2,4,2,2014-04-29 19:44:39,2014-04-28 12:57:37
714c71b2b1531f7e1099d17ab8ae03fa21f4b88c...cba1262100df44bdb2cd5a00741562afb3eeb9fd,1,2,2,4,1,2014-04-30 18:08:03,2014-04-30 16:22:54
cba1262100df44bdb2cd5a00741562afb3eeb9fd...a4cf6b4b91835c1d8d13ebb5cf3ce9241e181f1b,1,8,8,16,4,2014-04-30 18:08:04,2014-04-30 16:22:55
a4cf6b4b91835c1d8d13ebb5cf3ce9241e181f1b...e1d6b55d5db4c1ad305b5ac6e4f1bb4bea3c1bee,1,1,1,2,1,2014-04-30 18:08:04,2014-04-30 16:22:56
e1d6b55d5db4c1ad305b5ac6e4f1bb4bea3c1bee...38b2e5d12cbe681bff8f31cf10e3de8bd6f6db52,1,2,2,4,2,2014-04-30 18:08:05,2014-04-30 16:22:57
38b2e5d12cbe681bff8f31cf10e3de8bd6f6db52...e6ce6f4c7a8bcb2a77e664d0dfc42ee9c2d164d0,1,8,8,16,4,2014-04-30 18:08:05,2014-04-30 16:22:58
e6ce6f4c7a8bcb2a77e664d0dfc42ee9c2d164d0...4ff03347ec945542e288a6a020bdd8153c915592,1,3,3,6,2,2014-04-30 18:08:06,2014-04-30 16:22:59
4ff03347ec945542e288a6a020bdd8153c915592...54835fc57ea16ed19d1689b37073806537f14cf7,1,5,5,10,5,2014-04-30 18:08:06,2014-04-30 16:23:00
54835fc57ea16ed19d1689b37073806537f14cf7...20cb28baf9d03c779f590baa475610788bc6eabf,1,1,1,2,1,2014-04-30 18:08:07,2014-04-30 16:23:01
20cb28baf9d03c779f590baa475610788bc6eabf...7c0c51baa4855c76a71820fb279c2ca1580d374b,1,1,1,2,1,2014-04-30 18:08:07,2014-04-30 16:23:02
7c0c51baa4855c76a71820fb279c2ca1580d374b...274447aa6bbe84c4e65607f48df18380766d24fe,1,1,1,2,1,2014-04-30 18:08:08,2014-04-30 16:23:03
274447aa6bbe84c4e65607f48df18380766d24fe...991a9c3af984eb28b31f8642c97fd9ddb29cadc4,1,6,6,12,6,2014-04-30 18:08:08,2014-04-30 16:23:04
991a9c3af984eb28b31f8642c97fd9ddb29cadc4...6003eb13c69516dfedc9466aeb8c3a32a054c286,1,1,1,2,1,2014-04-30 18:08:09,2014-04-30 16:23:05
6003eb13c69516dfedc9466aeb8c3a32a054c286...ce21ccfae0729fd73b54f3ae4935fc7769343561,1,2,2,4,1,2014-04-30 18:08:09,2014-04-30 16:23:06
ce21ccfae0729fd73b54f3ae4935fc7769343561...f5efd5196cf2d7931785f663b219b40fd204e1b1,1,3,3,6,3,2014-04-30 18:08:10,2014-04-30 16:23:07
9d02150cf4d833935161ef265e4dc03807caa800...cedc61a99804db99f9a658c3cccd5c2786a28501,3,10,10,20,10,2014-07-17 20:33:52,2014-07-16 23:38:18
cedc61a99804db99f9a658c3cccd5c2786a28501...4bbaa1eb6fb4a520069e53ec5afa977a316a5d36,5,6,42,48,9,2014-07-17 20:36:25,2014-07-16 23:52:09
4bbaa1eb6fb4a520069e53ec5afa977a316a5d36...d1d094564ac818a79465f249ca765ab7ef97d443,1,4,11,15,5,2014-07-17 22:09:24,2014-07-16 21:57:47
d1d094564ac818a79465f249ca765ab7ef97d443...e929f515faaa44deed9057cdbaf8e44b3d855333,1,8,20,28,5,2014-07-18 18:15:23,2014-07-18 15:12:34
e929f515faaa44deed9057cdbaf8e44b3d855333...14576df044be25b00d43aa24057d3abe4b9fd6f5,1,1,1,2,1,2014-07-18 19:14:47,2014-07-18 16:00:51
14576df044be25b00d43aa24057d3abe4b9fd6f5...92859f3a7906cf1a1d398307ba21a062984550d6,1,5,10,15,5,2014-07-18 19:14:47,2014-07-17 23:27:41
92859f3a7906cf1a1d398307ba21a062984550d6...1cefa143250ad8c60e2a3db6c18278f7bed508f5,1,7,9,16,5,2014-07-18 19:50:03,2014-07-18 15:20:19
e156455ea49124c140a67623f22a393db62d5d98...00a6fa0720283b93eb011adcfea850fe21345548,2,34,6,40,7,2014-12-01 02:11:25,2014-11-27 03:43:06
e156455ea49124c140a67623f22a393db62d5d98...d51428bf17e9f17071836350299e256cac2d503a,1,2,2,4,2,2014-07-24 20:57:49,2014-07-24 04:40:43
d51428bf17e9f17071836350299e256cac2d503a...28b3563241ac13733781fb0bada37f776a39f43d,3,5,1,6,4,2014-07-24 20:57:49,2014-07-24 04:41:11
28b3563241ac13733781fb0bada37f776a39f43d...def0697167d0b3fb3c9cc1a2fcbac56e540aae48,1,3,2,5,3,2014-07-24 20:57:50,2014-07-24 04:41:30
def0697167d0b3fb3c9cc1a2fcbac56e540aae48...649409b7bccdcd6d6e5273b2b7340cea05f77736,1,5,5,10,1,2014-07-24 20:57:50,2014-07-24 04:42:39
649409b7bccdcd6d6e5273b2b7340cea05f77736...31bb6d37f992128eca3707d4f58ec61425742e81,1,1,1,2,1,2014-07-24 20:57:50,2014-07-24 04:43:23
e156455ea49124c140a67623f22a393db62d5d98...29aa0b2061712c83ec5eb5c1556436b1218035ba,1,10,18,28,3,2014-06-13 21:52:16,2014-06-13 19:53:03
29aa0b2061712c83ec5eb5c1556436b1218035ba...60d85e110b520ee5c6839380e5bb3d6e38571a74,1,7,13,20,7,2014-06-13 21:52:50,2014-06-13 19:54:59
e156455ea49124c140a67623f22a393db62d5d98...56f24e80f0af4dd3591c8f143183b59cf9a34620,2,37,0,37,3,2014-06-13 20:37:43,2014-06-12 18:49:29
e156455ea49124c140a67623f22a393db62d5d98...c0562611c525bb3c564b79c345fc7e4f9e799e54,2,51,6,57,8,2014-06-10 19:00:53,2014-06-08 09:37:10
e156455ea49124c140a67623f22a393db62d5d98...acb3d22264fd3736f95f71aa38e1d6fa01f5e9e1,2,4,2,6,2,2014-06-06 20:49:19,2014-06-03 09:13:18
e156455ea49124c140a67623f22a393db62d5d98...b93e6e36637bed9d80f9ffa786ea78044fde6bac,5,28,22,50,23,2014-06-04 18:14:25,2014-06-04 15:57:52
e156455ea49124c140a67623f22a393db62d5d98...4207ed285f31ad3e04f08254237c0c1a1609642b,2,105,107,212,6,2014-06-03 18:09:32,2014-06-03 16:09:59
e156455ea49124c140a67623f22a393db62d5d98...299e29870b777818ab84a508c901a4ef924f6fd4,2,3,3,6,3,2014-06-03 17:06:53,2014-06-02 16:43:00
e156455ea49124c140a67623f22a393db62d5d98...1571586648da4e2d759bce1146d5585c91aca8d6,1,2,0,2,1,2014-05-30 20:47:24,2014-05-29 22:19:40
e156455ea49124c140a67623f22a393db62d5d98...532845604de9b3fe7c651fe2546f20043b8cd7c1,1,13,11,24,4,2014-05-30 18:04:37,2014-05-29 19:36:47
532845604de9b3fe7c651fe2546f20043b8cd7c1...366a0184e550200bf80fb76217b8655b54b1fd6c,1,21,8,29,4,2014-06-02 18:21:12,2014-06-02 15:21:47
366a0184e550200bf80fb76217b8655b54b1fd6c...f471dbc5feeefd3a761f311d3efa7b1a987bcb13,1,9,9,18,1,2014-06-02 18:21:51,2014-05-29 19:53:28
f471dbc5feeefd3a761f311d3efa7b1a987bcb13...3630654956b75b10ae19211599e08257cd4c3f8d,1,0,13,13,1,2014-06-02 18:21:54,2014-05-29 19:55:50
3630654956b75b10ae19211599e08257cd4c3f8d...5d59a32fa1b579f5dd8ef1449bd3f1945f235915,1,12,7,19,5,2014-06-04 22:29:38,2014-05-29 20:07:44
5d59a32fa1b579f5dd8ef1449bd3f1945f235915...b8bdaa97a6447a1a1f9e635e6e2212858fdfe572,1,1,0,1,1,2014-06-04 22:29:38,2014-05-29 20:28:21
b8bdaa97a6447a1a1f9e635e6e2212858fdfe572...5cc3268720bd64f7dcc11843060fcebbe84f1a39,1,3,13,16,2,2014-06-04 22:29:38,2014-05-29 20:22:01
5cc3268720bd64f7dcc11843060fcebbe84f1a39...fcb14b0c8d7a732b1d26b5fda18f730851a76eed,1,45,0,45,1,2014-06-05 21:59:07,2014-05-29 21:24:23
fcb14b0c8d7a732b1d26b5fda18f730851a76eed...c5558f80c3a34f411022f1bc67f8364556ca3922,4,81,3,84,9,2014-06-05 22:13:12,2014-05-29 22:21:31
c5558f80c3a34f411022f1bc67f8364556ca3922...db4e4113ea33ece52c5988f9b9f7c0559c802602,2,16,6,22,2,2014-06-12 16:59:13,2014-06-11 14:24:04
e156455ea49124c140a67623f22a393db62d5d98...d7172825321369cb951dd7bbfc0c12dc4ecbe518,1,0,28,28,2,2014-05-30 16:46:19,2014-05-30 01:34:19
b4073bb387ef303c9ac3c044f46d6a8ae6e190f0...e2a892ee05ae5d9675881beb6dd5f90ca4677b0d,1,6,6,12,6,2014-06-13 18:04:04,2014-06-11 13:09:59
c553fd1c1ef76688b6200e66a825b530b0b02140...f34a655d4d1e25f314cd5760e2a39bec28950aa1,3,11,2,13,4,2014-06-17 22:25:00,2014-06-17 22:11:53
e3d44930318ed3746fe6da51913602d4fad8daaf...92f63d2b055fea3070108fe5015b8158e1c923db,1,2,0,2,1,2013-07-22 05:03:09,2013-07-19 23:08:28
92f63d2b055fea3070108fe5015b8158e1c923db...103d530f775d513ff9ebc148a9b54a8677a01790,1,1,1,2,2,2013-07-22 05:03:09,2013-07-19 23:08:29
103d530f775d513ff9ebc148a9b54a8677a01790...f593ef77792c36eeb1b92ed3661ed284502afdfb,1,4,4,8,2,2013-07-22 05:03:09,2013-07-19 23:08:30
f593ef77792c36eeb1b92ed3661ed284502afdfb...c28facd216b501d41ca76f040d0ce7749075aba0,1,0,1,1,1,2013-07-22 05:03:31,2013-07-19 23:08:27
8c4e4ec3ff053331c845331645a437b01b1f0de6...ad9c2e22cade795cf5f3ad3dbd9cf33d2012af77,2,26,3,29,3,2013-07-05 04:52:15,2013-07-04 17:02:12
8c4e4ec3ff053331c845331645a437b01b1f0de6...10f2fbff6859a22327d04f9eb0c1a38995ff48b1,2,17,9,26,11,2013-07-03 19:10:57,2013-07-03 07:07:48
10f2fbff6859a22327d04f9eb0c1a38995ff48b1...a90804752f6ab2b911882d47fafb6c2b78f447c3,7,128,0,128,14,2013-07-03 19:11:04,2013-07-03 07:08:22
8c4e4ec3ff053331c845331645a437b01b1f0de6...0e7c41c0cd14b0d748ce624e49800b63f9b27991,1,2,2,4,2,2013-07-03 19:10:13,2013-07-03 09:14:19
f4d80d2639f8ef55c99c3b035c0312969acc7f01...f2c2c90103eaff6f39a289c15b9dbc06efaaf2a8,2,31,3,34,4,2012-06-25 04:22:57,2012-06-24 11:01:37
b75cdfaa882a00f2274e74b21c1a9927d184ed29...7358a672b2c9df7473961e66e18714963b2bc107,1,2,2,4,1,2013-05-22 22:40:43,2013-05-22 22:27:53
b75cdfaa882a00f2274e74b21c1a9927d184ed29...380395d094b49834c3ec804407853fd6e81de702,9,15,14,29,15,2013-05-08 19:14:35,2013-05-02 19:26:08
380395d094b49834c3ec804407853fd6e81de702...83ff1da3e81824eebf0425ad9200248ea7205c35,3,0,13,13,5,2013-05-08 19:15:44,2013-05-02 19:29:04
b75cdfaa882a00f2274e74b21c1a9927d184ed29...af04fa2a78af3f4dc07bdc3e3018ccf3baa88c20,2,2,3,5,2,2013-04-29 05:33:53,2013-04-29 05:32:04
af04fa2a78af3f4dc07bdc3e3018ccf3baa88c20...71d5f938910120275484aac0b2e1c27cdf8b5cf3,1,14,0,14,1,2013-05-02 17:05:52,2013-05-02 14:56:07
b75cdfaa882a00f2274e74b21c1a9927d184ed29...5b62e6374aabb20297b22bdd72952ff582b2198b,1,3,3,6,3,2013-04-28 19:24:18,2013-04-27 18:43:05
5b62e6374aabb20297b22bdd72952ff582b2198b...4fc8fb48e978b8563493d04069c2507b7fb0064a,1,2,1,3,2,2013-04-28 19:24:40,2013-04-27 18:44:08
4fc8fb48e978b8563493d04069c2507b7fb0064a...241c957d899fe829bf5754e8589e357ce9496783,3,4,3,7,3,2013-04-28 19:24:48,2013-04-27 18:45:02
241c957d899fe829bf5754e8589e357ce9496783...eec7fd8bc54eacf96d0988741a0d988f374c4db9,1,4,0,4,1,2013-04-28 19:26:09,2013-04-27 18:46:17
eec7fd8bc54eacf96d0988741a0d988f374c4db9...ec535cc27e6c4f5e0b1d157e04f5511f166ecd9d,1,0,1,1,1,2013-04-28 19:26:38,2013-04-27 19:15:38
ec535cc27e6c4f5e0b1d157e04f5511f166ecd9d...9c3b051f931af9e3bcc765a4c83426e3be7de7f1,1,1,1,2,1,2013-04-28 19:26:45,2013-04-27 19:16:28
9c3b051f931af9e3bcc765a4c83426e3be7de7f1...1c31596a4b029e51cef1c520f32a3ecfbdea3c0a,1,1,1,2,1,2013-04-28 19:27:04,2013-04-27 19:17:14
1c31596a4b029e51cef1c520f32a3ecfbdea3c0a...15b7f601fc976f7a112035fb0e91869eabe61c26,1,2,2,4,1,2013-04-28 19:27:08,2013-04-27 19:18:03
15b7f601fc976f7a112035fb0e91869eabe61c26...657b35f4bef7d25831607882ed7f1f2ced378eb7,2,10,3,13,3,2013-04-28 19:27:11,2013-04-27 19:18:55
657b35f4bef7d25831607882ed7f1f2ced378eb7...84d32bf7678259c08406571cd6ce4b7a6724dcba,10,16,15,31,15,2013-04-28 19:32:08,2013-04-27 19:19:47
b75cdfaa882a00f2274e74b21c1a9927d184ed29...ea573521828162b998389fbfc45d47f413b016fe,1,2,1,3,2,2013-04-27 23:09:47,2013-04-27 20:17:44
b75cdfaa882a00f2274e74b21c1a9927d184ed29...ddf07bddef9aac37cf54ef744452f2a9ad4e312e,1,68,0,68,1,2013-04-27 21:32:28,2013-04-27 20:09:59
ddf07bddef9aac37cf54ef744452f2a9ad4e312e...f03efba4c0a7046ceb51ec4b57f7413fe6e931eb,1,9,0,9,1,2013-04-27 21:32:28,2013-04-27 20:10:00
f03efba4c0a7046ceb51ec4b57f7413fe6e931eb...9ab8d18322657db8bbe0cdf3b0dc19b479a3d4e5,1,0,2,2,1,2013-04-27 21:32:28,2013-04-27 20:10:01
9ab8d18322657db8bbe0cdf3b0dc19b479a3d4e5...0afe8e9e98b0b066105e03476f7c8f4c14bc1c15,1,1,1,2,1,2013-04-27 21:32:28,2013-04-27 20:10:02
0afe8e9e98b0b066105e03476f7c8f4c14bc1c15...f825972c38ba5a8e0309a552b401ad55aeaaaf36,1,16,55,71,7,2013-04-27 21:32:29,2013-04-27 20:10:03
f825972c38ba5a8e0309a552b401ad55aeaaaf36...fda54ef1aa66b54031a37c72a463ef15d6411912,1,3,6,9,3,2013-04-27 21:32:29,2013-04-27 20:10:04
fda54ef1aa66b54031a37c72a463ef15d6411912...3ffa4df4b2a26768938fc6bf1ed0640885b2bdf1,1,7,36,43,5,2013-04-27 21:32:29,2013-04-27 20:10:05
3ffa4df4b2a26768938fc6bf1ed0640885b2bdf1...fbe451182ed1a6830b9c46b12899fd9f20381ad4,1,1,1,2,1,2013-04-27 21:32:29,2013-04-27 20:10:06
fbe451182ed1a6830b9c46b12899fd9f20381ad4...c29e317994d1077fe3ac9cdeae5a5b35ffaa3440,1,8,20,28,3,2013-04-27 21:32:29,2013-04-27 20:10:07
b75cdfaa882a00f2274e74b21c1a9927d184ed29...808d3d717e86be597aa94d4a26f82a0ba5a53c22,4,19,121,140,19,2013-04-26 23:09:21,2013-03-19 22:53:17
b1d04bfcf84cc3464d0bdf62b02443d0d55e3f2b...3ea59412e83065b38b52cb8d7b8432e0f516de6c,1,0,0,0,0,2013-06-11 18:22:00,2013-06-11 12:14:56
3ea59412e83065b38b52cb8d7b8432e0f516de6c...b3b8ceb48b7d75631a8638f1dc6ccdf7f1b53888,1,1,1,2,1,2013-06-11 21:23:31,2013-06-08 12:17:49
b1d04bfcf84cc3464d0bdf62b02443d0d55e3f2b...ca8d148daf3014577222c2562ca2c8170a866aa4,9,65,53,118,49,2013-06-09 23:45:14,2013-06-09 18:29:20
b1d04bfcf84cc3464d0bdf62b02443d0d55e3f2b...dbea72a8c05d12c7dfd6a35376e62b21d5a655b5,1,1,1,2,1,2013-06-03 19:51:53,2013-05-30 20:00:22
b1d04bfcf84cc3464d0bdf62b02443d0d55e3f2b...5adcf2c69989884ad6c51df0f9ad5e68f6a3f650,1,43,0,43,1,2013-06-03 16:21:24,2013-05-30 07:11:13
5adcf2c69989884ad6c51df0f9ad5e68f6a3f650...5e3ee39df2be5712dbff5a7cbca94d35ea56990c,1,1,1,2,1,2013-06-05 19:26:43,2013-06-05 18:10:55
5e3ee39df2be5712dbff5a7cbca94d35ea56990c...d6ee44568c876f7644f23d7f4319f7689348de76,1,3,1,4,2,2013-06-05 19:26:56,2013-06-05 18:10:57
d6ee44568c876f7644f23d7f4319f7689348de76...da18759e86bb1a7ee718c79a0c6cb15fbcbdf3c2,1,15,8,23,10,2013-06-05 19:26:58,2013-06-05 18:11:00
da18759e86bb1a7ee718c79a0c6cb15fbcbdf3c2...dd29f0b4dcc4e5411adeb310d6cd14a5a626b22c,1,20,0,20,2,2013-06-05 19:26:59,2013-06-05 18:11:02
dd29f0b4dcc4e5411adeb310d6cd14a5a626b22c...4b45bcf7b141baf49c7290925b4fa5a40e47b610,1,5,0,5,1,2013-06-05 19:27:00,2013-06-05 18:11:04
4b45bcf7b141baf49c7290925b4fa5a40e47b610...14952666d18e5256e1796633e5a927891e77a8de,1,5,0,5,1,2013-06-05 19:27:01,2013-06-05 18:11:08
4c7f1819b3c142ace98269a556bc929c80e7c9fd...7f3b8c628eaea8ccbe83f605b00d629553b70b42,1,1,0,1,1,2013-07-19 18:20:28,2013-07-18 22:58:04
b387c77b12953d543bf5efc3825b5be26d753f9c...ca4b5de28bad7d50b882794124ca4e57044a1cba,1,28,14,42,3,2013-07-12 16:34:57,2013-05-11 13:18:52
ca4b5de28bad7d50b882794124ca4e57044a1cba...dbb9a8125542be4d57bc71b6d5baf81c7409a68b,1,13,16,29,4,2013-07-12 16:34:57,2013-05-11 13:19:29
dbb9a8125542be4d57bc71b6d5baf81c7409a68b...4d8dd1494e9f3af2e9738edaca40ada096f7bf10,1,43,21,64,20,2013-07-12 16:34:57,2013-07-11 22:44:39
4d8dd1494e9f3af2e9738edaca40ada096f7bf10...1bc888193e1044db317a45b9a4c8d2b87b998f40,5,193,7,200,27,2013-07-12 16:34:57,2013-07-11 22:46:47
1bc888193e1044db317a45b9a4c8d2b87b998f40...b2dc09455a9ed5521c2e84fc67d8dacf2c28c39f,1,8,2,10,5,2013-07-12 16:34:58,2013-07-11 22:48:30
b387c77b12953d543bf5efc3825b5be26d753f9c...eb7976e7dddf70f0f4a7d05e3d86a33bf163abf2,2,1,3,4,2,2013-05-15 19:30:36,2013-05-14 04:36:24
eb7976e7dddf70f0f4a7d05e3d86a33bf163abf2...557399e9bd2d2e8d13fac2ca9dbe4d6aa811e23c,1,9,15,24,2,2013-05-15 19:31:54,2013-05-14 04:36:25
557399e9bd2d2e8d13fac2ca9dbe4d6aa811e23c...679e87c02bf02b34fe4dba5bd09e17269223c96f,2,1,1,2,2,2013-05-15 19:33:15,2013-05-14 04:36:26
679e87c02bf02b34fe4dba5bd09e17269223c96f...760ee1c70a4dbbc792a4bb31731576d8648d24f4,1,13,11,24,3,2013-05-15 19:33:39,2013-05-14 04:36:27
760ee1c70a4dbbc792a4bb31731576d8648d24f4...637333673a156898087e87f551a6eb1f9405e39d,1,1,1,2,1,2013-05-15 19:35:51,2013-05-14 04:36:28
637333673a156898087e87f551a6eb1f9405e39d...06f42133550725d360c9b6acc3b3fa223fee6c47,1,1,1,2,1,2013-05-15 19:40:16,2013-05-14 04:36:29
06f42133550725d360c9b6acc3b3fa223fee6c47...9ed920a680ca1999714f287672a31fa862f95e3f,1,2,1,3,1,2013-05-15 19:40:59,2013-05-14 04:36:30
9ed920a680ca1999714f287672a31fa862f95e3f...24317ef32ac3111ed00792f9b2921dc19dd28fe2,1,3,0,3,1,2013-05-15 19:41:13,2013-05-14 04:36:31
b387c77b12953d543bf5efc3825b5be26d753f9c...51f8c814d5603a917a91a47019875bbe707675bb,1,10,0,10,4,2013-05-12 22:23:47,2013-05-11 16:14:03
51f8c814d5603a917a91a47019875bbe707675bb...4ab90e7a5c46ce929ae8b3b7bbb5b276f2f60e0d,1,8,3,11,1,2013-05-12 22:23:47,2013-05-11 16:14:25
4ab90e7a5c46ce929ae8b3b7bbb5b276f2f60e0d...900f2814b8da951a450f5762dabb1b248dd77abc,2,48,23,71,14,2013-05-12 22:23:48,2013-05-11 16:15:59
900f2814b8da951a450f5762dabb1b248dd77abc...f269048754f3b835f4f7287c5a132714a059efce,3,21,5,26,7,2013-05-12 22:23:48,2013-05-11 16:16:52
f269048754f3b835f4f7287c5a132714a059efce...823c6d56a83f3eec657a94581c23c5b7682bdaf4,2,17,1,18,2,2013-05-28 15:13:14,2013-05-27 16:33:09
b387c77b12953d543bf5efc3825b5be26d753f9c...29de20504e9790785fe1698300755323f74972aa,1,1,0,1,1,2013-05-11 17:41:26,2013-05-11 08:22:26
29de20504e9790785fe1698300755323f74972aa...4dcd7732db071c8e1e0466b98eaf9501f7fe1a7e,1,8,0,8,2,2013-05-20 18:15:53,2013-05-19 10:23:34
4dcd7732db071c8e1e0466b98eaf9501f7fe1a7e...61067954ce166e8a6fbcd109376fe2d9681ca333,1,6,0,6,2,2013-05-20 18:15:56,2013-05-19 10:23:35
61067954ce166e8a6fbcd109376fe2d9681ca333...be4c828b761a7c65edcff75b008051b6d027e64a,1,10,0,10,2,2013-05-21 20:26:37,2013-05-19 10:23:36
b387c77b12953d543bf5efc3825b5be26d753f9c...0781aa4766ed88d620ea060c7d775ca806ebfa93,1,4,0,4,2,2013-05-11 17:28:54,2013-05-03 12:35:11
0781aa4766ed88d620ea060c7d775ca806ebfa93...6035d6aad8ca11954c0d7821f6f3e7c047039c8f,5,93,38,131,16,2013-05-28 15:06:08,2013-05-26 01:16:15
631bc94e67383b66da190550866566f09d32f299...fd4fab894f564d04e0e3fb60659e6babfc4e3d81,1,1,2,3,1,2013-04-01 14:45:30,2013-03-31 08:00:15
fd4fab894f564d04e0e3fb60659e6babfc4e3d81...952af3511c5dc7b7efd4c374d8b56d2c11d09d07,3,34,16,50,9,2013-04-01 14:45:37,2013-03-31 08:00:16
952af3511c5dc7b7efd4c374d8b56d2c11d09d07...95d9d5ec75d3549f00cac29cd33be899cfb4693a,2,7,0,7,2,2013-04-01 14:45:41,2013-03-31 08:00:17
95d9d5ec75d3549f00cac29cd33be899cfb4693a...eeb69131ed7f3cb7a191d5bf0e3ce8fdd726a539,1,3,0,3,1,2013-04-01 14:45:45,2013-03-31 08:37:25
631bc94e67383b66da190550866566f09d32f299...d1520c4b1a6105356c7a2def6b90239057270598,2,4,2,6,2,2013-04-01 02:58:02,2013-03-31 01:27:44
631bc94e67383b66da190550866566f09d32f299...53ca053b3062e985f6270570b42471fbeb2dd6a5,1,35,0,35,1,2013-03-29 22:13:53,2013-03-29 19:51:55
631bc94e67383b66da190550866566f09d32f299...bf341b902ea1346373886f4eb4352a06b7b4cdfd,1,15,15,30,2,2013-03-29 19:38:41,2013-03-29 11:28:32
bf341b902ea1346373886f4eb4352a06b7b4cdfd...67aa147af7c699348ba8c3afe9f7ee88aa043cd0,2,101,14,115,11,2013-03-29 22:16:04,2013-03-29 22:07:39
67aa147af7c699348ba8c3afe9f7ee88aa043cd0...472353a579b3c3fd645ea4f0aac582317e488775,1,17,27,44,8,2013-03-29 22:16:40,2013-03-29 11:28:34
472353a579b3c3fd645ea4f0aac582317e488775...3caf5a93d8ccbffaccfbae3fe814325682cc95f4,1,1,1,2,1,2013-03-29 22:16:40,2013-03-29 11:28:35
3caf5a93d8ccbffaccfbae3fe814325682cc95f4...e01afdb74b395e63a6ee8feb8cb3a6ee470e2085,1,19,8,27,5,2013-03-29 22:16:40,2013-03-29 11:28:36
6466fbbeef67ec398f6f5d5b5da5d6f107a647b2...5bda18c186e455f8e65f976d3bf333ab1f4b5b53,3,8,2,10,4,2013-04-07 22:27:23,2013-04-07 22:27:23
bfd70c53b38f03a4e788fb84518c09f67b7514c2...0f33a0677d6d93b3f6d8fb7d1df62f30eb7b73a9,3,11,4,15,9,2013-04-05 18:28:10,2013-04-05 16:12:08
cc3e4eba723570bf77902c017611ee02bb86c8b3...a57ad51d1ae136e704a004c7d5c6307b4ce19c63,1,5,5,10,6,2013-04-11 17:46:46,2013-04-11 12:22:57
a57ad51d1ae136e704a004c7d5c6307b4ce19c63...e1219e45bdcb3f6b298bdee21fe07ddfa38778ef,1,4,0,4,1,2013-04-11 17:46:46,2013-04-11 12:22:58
e1219e45bdcb3f6b298bdee21fe07ddfa38778ef...031873f8f1661c4e712b8b181c50508c6eff2b08,1,1,0,1,1,2013-04-11 17:46:46,2013-04-11 12:22:59
031873f8f1661c4e712b8b181c50508c6eff2b08...15a8d901dd38cdc10d6b17d718e20e8ba91c66d1,1,2,2,4,2,2013-04-11 17:46:46,2013-04-11 12:23:00
15a8d901dd38cdc10d6b17d718e20e8ba91c66d1...8120014e2ba0e65748c8a3c1642bed0891be851d,3,9,0,9,4,2013-04-11 17:46:46,2013-04-11 12:23:01
8120014e2ba0e65748c8a3c1642bed0891be851d...71c6c95c310b0389f07fdbe40db6f068c1fa95a5,2,3,5,8,4,2013-04-11 17:46:46,2013-04-11 12:23:02
71c6c95c310b0389f07fdbe40db6f068c1fa95a5...25027b983eb82b95316f362e03a207b49b033b00,1,1,0,1,1,2013-04-11 17:46:46,2013-04-11 12:23:03
25027b983eb82b95316f362e03a207b49b033b00...f04f489f6b91213a1a6c4f7e88c8c83d43a68eeb,1,25,14,39,3,2013-04-11 17:46:47,2013-04-11 12:23:04
f04f489f6b91213a1a6c4f7e88c8c83d43a68eeb...0ff1b61770f42921d68b488f0ec3756d5477bc78,1,12,8,20,8,2013-04-11 17:46:47,2013-04-11 12:23:05
0ff1b61770f42921d68b488f0ec3756d5477bc78...d7314b3acffbce985a90e594cfa5046d9b94f39e,1,5,0,5,1,2013-04-11 17:46:47,2013-04-11 12:23:06
d7314b3acffbce985a90e594cfa5046d9b94f39e...7a6c1859b69c287a1962c718d93bc8412448e7f8,1,5,1,6,1,2013-04-11 17:46:47,2013-04-11 12:23:07
7a6c1859b69c287a1962c718d93bc8412448e7f8...11dc88f49c1dc177132fb724d46c80ae8e6a2e99,1,4,0,4,1,2013-04-11 17:46:47,2013-04-11 12:23:08
11dc88f49c1dc177132fb724d46c80ae8e6a2e99...b0c3db860cac2215f07deeb9e91cbd2597fe41d0,1,9,2,11,5,2013-04-11 17:46:47,2013-04-11 12:23:09
b0c3db860cac2215f07deeb9e91cbd2597fe41d0...cbf6237c2ba989794815f980af1d26860840daf6,1,9,3,12,3,2013-04-11 17:46:47,2013-04-11 12:23:10
cbf6237c2ba989794815f980af1d26860840daf6...6181b9a63ceccce9aff29b14f3872f2c3d187d45,1,35,0,35,1,2013-04-11 17:46:47,2013-04-11 12:23:11
6181b9a63ceccce9aff29b14f3872f2c3d187d45...b3ab6fd1ac692397b43559385ac4a57c45ce83ec,1,2,1,3,1,2013-04-11 17:46:47,2013-04-11 12:23:12
b3ab6fd1ac692397b43559385ac4a57c45ce83ec...2e8e813232d33bb7454cc56edb4b5336b7c89ccd,1,9,0,9,2,2013-04-11 17:46:47,2013-04-11 12:23:13
2e8e813232d33bb7454cc56edb4b5336b7c89ccd...2594a79ea9d34053384d514afd5dcaaaeed15480,1,7,1,8,5,2013-04-11 17:46:47,2013-04-11 12:23:14
2594a79ea9d34053384d514afd5dcaaaeed15480...7b21ec24a54c412d3a4f1d5d5d32370876ec5327,1,3,0,3,1,2013-04-11 17:46:48,2013-04-11 12:23:15
7b21ec24a54c412d3a4f1d5d5d32370876ec5327...20c4b59c352529bda3f5d44baba5e393badc2ee8,1,8,2,10,3,2013-04-11 17:46:48,2013-04-11 12:23:16
20c4b59c352529bda3f5d44baba5e393badc2ee8...9a57988b3fac79e0458515a555392d00b759cf4c,2,7,2,9,4,2013-04-11 17:46:48,2013-04-11 12:23:17
cc3e4eba723570bf77902c017611ee02bb86c8b3...afeb525980e2a7d2f01e4611f61080fbeac18411,1,1,1,2,1,2013-04-04 16:35:00,2013-04-04 15:36:16
afeb525980e2a7d2f01e4611f61080fbeac18411...e4f0e34c8968183119e5028ed77f3e3a6079e3cb,1,1,0,1,1,2013-04-04 16:35:20,2013-04-04 15:36:17
e4f0e34c8968183119e5028ed77f3e3a6079e3cb...c0e1ba4e1792184964614987d67f9accfeb2cb84,1,0,14,14,1,2013-04-04 16:35:42,2013-04-04 15:36:18
c0e1ba4e1792184964614987d67f9accfeb2cb84...091e051e883a3b710430b11fea06e5ea735ec9dd,1,0,1,1,1,2013-04-04 16:35:51,2013-04-04 15:36:19
cc3e4eba723570bf77902c017611ee02bb86c8b3...db4ef4496e7a99809f7caa52e8821320e5cca7bc,3,81,0,81,5,2013-04-02 21:22:55,2013-04-02 14:20:21
db4ef4496e7a99809f7caa52e8821320e5cca7bc...87e139c0ad32b72ad989fe7d69381f1146250f7a,3,11,5,16,8,2013-04-02 21:22:56,2013-04-02 14:20:22
cc3e4eba723570bf77902c017611ee02bb86c8b3...b4b634352de7de5f824eb4cf1ccb2a656f801adc,1,2,3,5,1,2013-04-02 17:41:41,2013-04-02 07:40:29
b4b634352de7de5f824eb4cf1ccb2a656f801adc...2ead7a674d7f1c0b2b47bdd567755a741f86c255,1,12,1,13,1,2013-04-02 17:41:42,2013-04-02 07:40:30
2ead7a674d7f1c0b2b47bdd567755a741f86c255...2e433b7895798d2936d9708da9f99bd190cd39fc,1,145,137,282,115,2013-04-02 17:41:42,2013-04-02 07:40:31
2e433b7895798d2936d9708da9f99bd190cd39fc...f24f715e05399cba19cb9455fdd7d8a9806fe61b,3,23,5,28,7,2013-04-02 17:41:42,2013-04-02 07:40:32
f24f715e05399cba19cb9455fdd7d8a9806fe61b...224c2171637ee71c36cb6b0ed314d14216725d6f,3,29,3,32,5,2013-04-02 17:41:42,2013-04-02 07:40:33
224c2171637ee71c36cb6b0ed314d14216725d6f...9f765ce62fd2d5159a3dc7f73abe30a3fbef08f7,3,34,4,38,4,2013-04-02 17:41:43,2013-04-02 07:40:34
187c00c6c58ba8916a37011b56cb0cb8f2dd1805...aacecc3b36a6cd4d2707e3f1cbd7bb4122477c64,2,13,23,36,7,2013-04-08 17:50:52,2013-04-07 21:07:51
187c00c6c58ba8916a37011b56cb0cb8f2dd1805...3322ad428446b2d54e95b50fc70abc1ece1f4069,1,1,1,2,1,2013-03-28 15:53:47,2013-03-27 22:53:50
7b9a41987aea4f5eb4afe1ff84302b5c5fa4e77a...b34a912989624de37f859b4d70d9eab4cfe285dd,1,7,7,14,2,2013-03-21 15:09:35,2013-03-21 02:40:17
6f0c33666300ccf95eb4b4e723e07a3c588d12db...8d44277d91989ad2b37d4908096bd5256d6390c4,1,5,1,6,2,2013-02-27 18:09:59,2013-02-27 18:09:59
4dac0679feaebbf6545daec14480cf6b94cb74ed...13a23199195bb29d7f9e64baaa35c1718a92c556,5,0,80,80,7,2013-02-26 17:16:58,2013-02-26 16:58:38
4dac0679feaebbf6545daec14480cf6b94cb74ed...3b12f46ab382b280effa15a925b6195abaebf0a3,1,5,2,7,3,2013-02-26 16:42:24,2013-01-09 11:49:26
3b12f46ab382b280effa15a925b6195abaebf0a3...8b2d219a3d6db49c8c3c0a5b620af33d6a40a974,1,70,129,199,36,2013-02-26 16:42:46,2013-01-10 10:52:12
4dac0679feaebbf6545daec14480cf6b94cb74ed...48cc7c1b24ea5c9bf59ad98bd308b5fd5b3802d1,1,767,618,1385,561,2013-02-26 06:38:34,2013-02-14 17:27:00
48cc7c1b24ea5c9bf59ad98bd308b5fd5b3802d1...a295fe616f162de5f1640fe95d0060554e12e12a,1,145,109,254,107,2013-02-26 06:38:34,2013-02-19 16:59:28
a295fe616f162de5f1640fe95d0060554e12e12a...5e93cd307bdb98809bb0aa3bfb2c0306131f3654,1,9,9,18,9,2013-02-26 06:38:34,2013-02-23 16:47:32
4dac0679feaebbf6545daec14480cf6b94cb74ed...1249d8ad1c1b2d6fb42aabcaada2c0792d52232d,1,144,142,286,106,2013-02-25 23:40:54,2013-02-25 22:53:00
4dac0679feaebbf6545daec14480cf6b94cb74ed...e6e87516f569c2344f760287aec66f70da856c6d,1,1,1,2,1,2013-02-25 22:23:43,2013-02-25 21:51:16
e6e87516f569c2344f760287aec66f70da856c6d...e1033da6af80b77d720ba7df9b8d3439666582e4,1,8,2,10,1,2013-02-25 22:29:12,2013-02-25 21:53:40
4dac0679feaebbf6545daec14480cf6b94cb74ed...41f2999180f5a58f2a4214d896359c1587c9024f,2,3,1,4,2,2013-02-25 20:39:56,2013-01-31 18:28:35
41f2999180f5a58f2a4214d896359c1587c9024f...4ab7527458a908b51891cbaa6bc0da9b711ebd19,1,2,0,2,1,2013-02-25 20:39:59,2013-01-31 18:30:14
4ab7527458a908b51891cbaa6bc0da9b711ebd19...93e38ed0c5a632d7b785357a309ac83e4df066fa,1,3,0,3,1,2013-02-25 20:40:03,2013-01-31 18:31:30
93e38ed0c5a632d7b785357a309ac83e4df066fa...d0f9dbb9e29b8dc289ae3b8028586a99fdb0d194,3,3,2,5,3,2013-02-25 20:40:34,2013-01-31 18:32:55
d0f9dbb9e29b8dc289ae3b8028586a99fdb0d194...e0492c5be123ca264a5477e3481a8a765fe9ae99,1,1,0,1,1,2013-02-25 20:40:51,2013-01-31 18:33:57
42f50f8d0150605ab4da32d283cef2df0bcb51ab...a48ec2415882ae15b8593185d6f9ab2f69555a9d,1,10,0,10,1,2013-02-07 20:54:26,2013-02-07 20:15:23
a48ec2415882ae15b8593185d6f9ab2f69555a9d...3bf25c23cd68dd9e99e54bf5443aebbb4a40b7d6,1,1,1,2,1,2013-02-12 19:42:07,2013-02-07 20:15:24
3bf25c23cd68dd9e99e54bf5443aebbb4a40b7d6...32b367e4441f8566f200459149d1aaee8fafc867,1,4,2,6,2,2013-02-12 19:42:07,2013-02-07 20:15:25
32b367e4441f8566f200459149d1aaee8fafc867...f192223447746a503bf664135a0e537d15876ebe,2,13,0,13,2,2013-02-12 19:42:07,2013-02-07 20:15:26
f192223447746a503bf664135a0e537d15876ebe...30997bb8f11bd6e63a582c3b4e029ca47868ad8d,1,20,95,115,21,2013-02-12 19:42:07,2013-02-07 20:15:27
30997bb8f11bd6e63a582c3b4e029ca47868ad8d...41ee2ad6cbebab0429248a14ec4e02afddd60dbe,1,30,17,47,23,2013-02-12 19:42:07,2013-02-07 20:15:28
c3c2e1a09b84dc932d90fa09d1632e5efa34c940...7f49036f282ab345b5c60f36707175ab687d7e52,1,2,2,4,2,2013-04-22 16:49:04,2013-04-22 16:18:40
eff80a9fd990de3605063050dae32f969ef18ba8...180bad3d10fe3a7f6d6c990956a888dd0562bef1,2,58,40,98,20,2013-02-12 20:01:42,2013-02-11 23:08:04
51fb3a3dfa4ffeeb210fb0e7d6f631503a5a1dfb...24e099f475692059dc2cb0c1c0d1a74a3fde8ac6,1,16,8,24,4,2013-02-23 08:00:16,2013-02-22 23:13:00
15999998fbda60552742275570947431b57108ae...c4a7bce1b5d1ad18482a87cb80a6bddabb925f62,1,30,22,52,4,2014-02-06 18:16:27,2014-02-06 18:16:27
c4a7bce1b5d1ad18482a87cb80a6bddabb925f62...cdbf623254fc281e42eb41e700ae785813983960,2,13,0,13,2,2014-02-06 18:19:33,2014-02-06 18:19:33
15999998fbda60552742275570947431b57108ae...895c5ba3c1c927c68e581ebb0e13d9a123e477ab,2,45,22,67,7,2013-10-15 23:17:09,2013-09-19 21:20:34
15999998fbda60552742275570947431b57108ae...4b363749552960f2692614a131adfac37b271178,1,0,6,6,1,2013-08-23 19:09:31,2013-08-23 14:25:02
15999998fbda60552742275570947431b57108ae...e92527c97cfa26bf6e42381cf1b7035950c36e69,1,1,1,2,1,2013-08-20 18:20:53,2013-08-20 09:15:26
15999998fbda60552742275570947431b57108ae...c17592a7a2420a61c4c407f4cf635f196f1254f3,1,22,3,25,7,2013-07-29 15:17:06,2013-07-26 23:39:28
15999998fbda60552742275570947431b57108ae...29d55538b78fa8d916b99aef9a4b1e376df2dac0,1,11,0,11,1,2013-07-29 15:03:33,2013-07-26 19:06:02
15999998fbda60552742275570947431b57108ae...9a621ad085c646a0146cc073fcc8dc49b89f574a,1,1,1,2,1,2013-07-24 22:57:01,2013-07-24 08:01:21
9a621ad085c646a0146cc073fcc8dc49b89f574a...9354b9a4f05f3a5e6dd63438befb54dbe69295f8,1,2,2,4,1,2013-07-24 22:57:01,2013-07-24 08:01:59
9354b9a4f05f3a5e6dd63438befb54dbe69295f8...af608260f6e0970a59b66cc819d35b8faa15ce13,1,16,1,17,2,2013-07-24 22:57:01,2013-07-24 08:03:13
af608260f6e0970a59b66cc819d35b8faa15ce13...69fb96037fed30e7206f5ebab3d17f7989166120,1,11,1,12,2,2013-07-24 22:57:01,2013-07-24 08:03:43
69fb96037fed30e7206f5ebab3d17f7989166120...4acbe91a82fa89d2d6f8839e891928e790ed867f,1,7,0,7,1,2013-07-26 15:33:38,2013-07-26 11:01:54
15999998fbda60552742275570947431b57108ae...8e92e8f2422a5805916e5e14c6bebfd82467e044,1,3,4,7,4,2013-07-18 01:10:51,2013-07-17 22:09:42
15999998fbda60552742275570947431b57108ae...2fbd4f92fa0d6d59d01cf1b9c800d428cd95143d,1,6,4,10,3,2013-07-07 17:29:28,2013-07-06 19:48:52
15999998fbda60552742275570947431b57108ae...9eb4754d7682aa10c6dcbcc503a50a716d9cfc8a,1,1,1,2,1,2013-06-07 15:22:37,2013-06-07 15:09:51
15999998fbda60552742275570947431b57108ae...a758a3499ff72111ef5f7066a9f21059c0d63d48,1,1,3,4,1,2013-06-03 17:20:43,2013-05-31 01:11:41
15999998fbda60552742275570947431b57108ae...582eb8536bfc93e403b008e2d660a6f246a2ff46,1,1,1,2,1,2013-06-03 17:10:25,2013-05-30 13:56:18
582eb8536bfc93e403b008e2d660a6f246a2ff46...c4aa3167fe9dd0b94594c20d8b3673929fcb217d,1,2,2,4,2,2013-06-03 17:10:38,2013-05-30 13:56:19
15999998fbda60552742275570947431b57108ae...aac385717a62bfa6889151d191e08b9725587912,2,53,2,55,2,2013-05-15 19:02:04,2013-05-15 17:42:14
15999998fbda60552742275570947431b57108ae...9a414486d9f0325c3663210471e4673ed0cd862c,1,12,2,14,3,2013-05-02 15:36:50,2013-05-01 20:34:50
15999998fbda60552742275570947431b57108ae...eafc2dd59f4d28d4a01deb24df588fd7a29990d8,1,1,1,2,1,2013-04-29 08:10:26,2013-04-29 08:09:57
15999998fbda60552742275570947431b57108ae...aaa07e3eee6f42d0adeac826dfb52d5ade26defc,1,8,9,17,7,2013-04-07 01:57:15,2013-04-05 21:15:50
15999998fbda60552742275570947431b57108ae...aa7b8c657e407a10cbee728264ec48be16ea4e3d,1,9,8,17,1,2013-04-05 14:40:39,2013-04-03 13:07:21
15999998fbda60552742275570947431b57108ae...7b96d8880252d70c334857f80ef54009133dbaf3,1,2,2,4,2,2013-04-03 19:49:14,2013-04-03 19:17:55
15999998fbda60552742275570947431b57108ae...e7b00c57640fa2bf11e4218b588f51cc5a9a754e,1,3,0,3,1,2013-04-03 19:48:02,2013-04-03 19:24:05
15999998fbda60552742275570947431b57108ae...97276019bb20829c97528b53dc453a37177c35bb,2,17,2,19,4,2013-04-02 20:34:55,2013-04-02 14:22:19
15999998fbda60552742275570947431b57108ae...53d8afafbbf455d24b0a94e4114709a4d495d460,2,16,2,18,4,2013-04-02 20:00:41,2013-04-01 21:36:36
53d8afafbbf455d24b0a94e4114709a4d495d460...b9e31f59478eeae3e4230308f6fc06713c6fc547,2,20,8,28,7,2013-04-04 19:27:28,2013-04-04 18:41:43
15999998fbda60552742275570947431b57108ae...c19d1b4e840535c5fc27077194e8ac219c02644c,2,14,1,15,2,2013-03-22 23:15:48,2013-03-22 18:38:19
15999998fbda60552742275570947431b57108ae...250b3c6c992b3cb04e756eb33bed99442fc55193,4,39,9,48,9,2013-03-22 18:16:01,2013-03-22 18:10:03
250b3c6c992b3cb04e756eb33bed99442fc55193...329b26e0b4b2574960ee703eccdb0a7126a60505,1,4,0,4,1,2013-03-29 20:38:28,2013-03-29 20:38:28
15999998fbda60552742275570947431b57108ae...2d1495fe449de98df3b0feb5ce508c5f6418d3fa,1,13,0,13,1,2013-03-19 17:59:07,2013-03-19 16:55:34
2d1495fe449de98df3b0feb5ce508c5f6418d3fa...9a94dba012b6b892c97d6eaf10d26f256d8dbfde,1,29,32,61,16,2013-04-01 19:33:52,2013-04-01 19:33:52
9a94dba012b6b892c97d6eaf10d26f256d8dbfde...a38d3d76b6d1c70b566633e1629aa3b0e856810e,1,39,0,39,1,2013-04-01 19:51:50,2013-04-01 19:51:50
15999998fbda60552742275570947431b57108ae...5823eb2b28696bf0eb25f6ca35b303447869f85c,1,10,4,14,3,2013-03-15 19:24:56,2013-03-15 16:53:48
5823eb2b28696bf0eb25f6ca35b303447869f85c...6a38ef2ced55f0a8a7967581934e40f79e1d8733,8,36,0,36,12,2013-03-17 04:44:58,2013-03-13 12:59:16
15999998fbda60552742275570947431b57108ae...6cd3c0532772749bcf6c4688f34c8ecc65ecb655,4,77,25,102,9,2013-03-09 19:11:19,2013-03-07 10:55:07
15999998fbda60552742275570947431b57108ae...cfe1348da60b75f6093f8fb6741630b06693e57a,1,14,9,23,5,2013-03-08 17:55:08,2013-03-08 17:44:33
15999998fbda60552742275570947431b57108ae...2092678cd5265e40dfb2b8e3adc8f2075faeece4,4,166,62,228,26,2013-02-28 07:29:04,2013-02-27 23:57:48
15999998fbda60552742275570947431b57108ae...4dcb167fc3536db0e78c50f239cd3a19afd383fa,7,58,4,62,10,2013-01-11 17:09:30,2013-01-11 09:05:46
4dcb167fc3536db0e78c50f239cd3a19afd383fa...682c7d2f1a2d1a5443777237450505738af2ff1a,2,26,7,33,11,2013-01-11 17:10:57,2013-01-11 09:05:47
682c7d2f1a2d1a5443777237450505738af2ff1a...cfb70e1fa506e79f337e716ed4813c6caa428644,1,1,1,2,1,2013-01-11 17:11:10,2013-01-11 09:05:48
15999998fbda60552742275570947431b57108ae...ac00128298583bcdd42bffc767393868821b6af6,3,10,8,18,8,2013-01-07 07:37:40,2013-01-06 17:47:57
ac00128298583bcdd42bffc767393868821b6af6...25d3d323633dbf3b8e8fbe209c9054196a202cf7,2,10,14,24,4,2013-01-07 16:47:51,2013-01-06 17:49:00
25d3d323633dbf3b8e8fbe209c9054196a202cf7...e9882c80cda6decc2381ecbdd1f99ad6e49b4662,2,119,69,188,5,2013-01-07 16:47:55,2013-01-06 17:51:34
e9882c80cda6decc2381ecbdd1f99ad6e49b4662...55292ea25dca1f3273b4e59aa37ee66cae4aa343,2,19,7,26,3,2013-01-07 16:47:55,2013-01-06 17:59:39
15999998fbda60552742275570947431b57108ae...fdb042449b2b2e163736864207290793a5fa7aa6,1,3,5,8,4,2013-01-06 19:13:14,2013-01-06 12:01:53
15999998fbda60552742275570947431b57108ae...3e4141d08c8dc1964d53c2ce13de8876d29e6436,2,17,2,19,2,2013-01-03 17:10:11,2013-01-02 18:42:50
15999998fbda60552742275570947431b57108ae...6f4e5059a06ced70456c2523e4fd85db5ffcdc45,1,14,10,24,7,2013-01-02 00:40:34,2013-01-01 21:40:37
15999998fbda60552742275570947431b57108ae...adcc42e68d0f5e18f2e81249b797a5b5457366d4,1,2,8,10,1,2013-01-01 22:35:22,2013-01-01 22:35:22
adcc42e68d0f5e18f2e81249b797a5b5457366d4...e6da8ee8d84fe0ea6dc99ac625d7e0e07246f39d,1,24,0,24,2,2013-01-01 22:37:56,2013-01-01 22:37:56
e6da8ee8d84fe0ea6dc99ac625d7e0e07246f39d...7d5bf87ba37f9e3387bfd55dfe808301adb6a939,1,61,76,137,9,2013-01-02 17:31:09,2013-01-01 23:19:00
7d5bf87ba37f9e3387bfd55dfe808301adb6a939...92a865e7362de69991cc6373229801408203eb1b,1,6,2,8,2,2013-01-02 17:31:54,2013-01-02 17:31:54
15999998fbda60552742275570947431b57108ae...d16ece20112c9418916bca87bbed0ff68b2169e9,1,6,6,12,6,2012-12-28 23:11:48,2012-12-28 23:03:06
15999998fbda60552742275570947431b57108ae...95f95c99f60360e841d19f3b24584aa0023c0586,1,2,4,6,2,2012-12-28 19:35:32,2012-12-28 16:20:25
b3cf6f3b8d21b32d88313fc709442b78300975db...12a097fc42d40c504a542228b28e8128e0ee2742,1,242,242,484,193,2013-01-07 17:33:35,2012-12-26 15:46:52
b3cf6f3b8d21b32d88313fc709442b78300975db...5d77298d084f01a854c8aecc1709acf53d956ef8,7,15,40,55,13,2012-12-23 03:06:35,2012-12-21 19:10:10
5d77298d084f01a854c8aecc1709acf53d956ef8...334ae397452170dacfcd8e69e4a41f6a64f54eec,3,29,8,37,7,2012-12-23 18:40:37,2012-12-21 19:10:11
e8a1f5a2ae53805986b1b965e036450bdfc0c460...fa1727fb210bd8d0079af124222420d46fb70f81,1,6,4,10,5,2013-02-12 19:07:53,2013-02-12 10:17:28
fa1727fb210bd8d0079af124222420d46fb70f81...9b1515220912b4e436145babf0b5887ecbfb0ac4,1,0,6,6,2,2013-02-12 19:08:45,2013-02-12 10:17:29
9b1515220912b4e436145babf0b5887ecbfb0ac4...4c9941943bebbe23039254cdda576ecd97e1d397,1,4,4,8,4,2013-02-12 19:08:54,2013-02-12 10:17:30
4c9941943bebbe23039254cdda576ecd97e1d397...f2b9a7555bb7791fa8d137da033b403d16af5085,1,111,0,111,1,2013-02-12 19:08:59,2013-02-12 10:17:31
f2b9a7555bb7791fa8d137da033b403d16af5085...cd650a4eee148dadb0943f415e88c210f18e70df,2,92,14,106,13,2013-02-12 19:09:40,2013-02-12 10:17:32
cd650a4eee148dadb0943f415e88c210f18e70df...2cdccad1600171e3c53e2e9c22e1675389a9d61a,1,5,1,6,2,2013-02-12 19:14:33,2013-02-12 10:17:33
2cdccad1600171e3c53e2e9c22e1675389a9d61a...b971e04f54e73a5a2af54ad62540273bb90ee7bb,2,118,63,181,7,2013-02-12 19:15:43,2013-02-12 10:17:34
b971e04f54e73a5a2af54ad62540273bb90ee7bb...bab4d1097c8be7d688a53b992232063dbf300fd4,4,50,17,67,15,2013-02-12 19:17:10,2013-02-12 10:17:35
bab4d1097c8be7d688a53b992232063dbf300fd4...33f2f9ab4e5c343b21a9e602456e7facabd609a0,1,13,2,15,1,2013-02-12 19:19:34,2013-02-12 10:33:42
33f2f9ab4e5c343b21a9e602456e7facabd609a0...79133a66f79e70dab88f9f0558dd029bf02f2ac9,1,241,0,241,1,2013-02-12 19:27:57,2013-02-12 10:17:37
79133a66f79e70dab88f9f0558dd029bf02f2ac9...5289c56a72efc6e5e4409c7a3802fc54aea09340,3,15,17,32,12,2013-02-12 19:29:56,2013-02-12 10:17:38
5289c56a72efc6e5e4409c7a3802fc54aea09340...959a26231f53b9cc7da40d36c550aef193647731,2,27,95,122,7,2013-02-12 19:30:21,2013-02-12 10:17:39
959a26231f53b9cc7da40d36c550aef193647731...8c613fd5efa1c3bbd48845ed91c533192e699c08,2,37,2,39,4,2013-02-23 08:03:00,2013-02-22 22:05:27
e8a1f5a2ae53805986b1b965e036450bdfc0c460...f7d8e3d01f46ecfa5b4bc8c13640831d97a78236,1,1,1,2,1,2012-11-26 17:34:28,2012-11-22 15:58:54
e8a1f5a2ae53805986b1b965e036450bdfc0c460...831a488b76e0fcad68c6d1c7aaf9f086199e1738,1,4,0,4,1,2012-11-26 16:16:36,2012-11-22 18:12:08
831a488b76e0fcad68c6d1c7aaf9f086199e1738...95c0d4b68a0fcba3adf45ce3a8f1edf99a9030a1,1,5,5,10,2,2012-11-26 16:22:04,2012-11-22 18:12:09
95c0d4b68a0fcba3adf45ce3a8f1edf99a9030a1...e43122556912b02ec00746c4b528d7408da9a70f,1,39,13,52,11,2012-11-26 23:49:05,2012-11-22 18:12:10
e43122556912b02ec00746c4b528d7408da9a70f...5c80afed02e1a5ffa4c164e8810aca8c8d655701,1,10,2,12,1,2012-11-26 23:49:12,2012-11-22 18:12:11
5c80afed02e1a5ffa4c164e8810aca8c8d655701...d0e98107bac36af7526fdb5c080ce9dfb56161ce,1,6,3,9,3,2012-11-26 23:49:12,2012-11-22 18:12:12
0398fc349627a8a55ec4727bfb85fb7fad1f4ff0...709ca730f8e093005cc882bfb86c0ca9c83d345b,4,5,7,12,4,2013-01-06 19:09:18,2013-01-05 14:49:49
086cb911533d6f4233e84c93b08da289ecc8a229...854dfda8be946b6d2a7cbbf2cd85628c92ddfb64,1,1,1,2,1,2012-12-23 04:26:56,2012-12-22 18:34:27
086cb911533d6f4233e84c93b08da289ecc8a229...f228dade3df3b5ab6b6ef0fa3d8fbcf19b9adabc,1,1,0,1,1,2012-12-23 04:21:26,2012-12-22 14:45:40
f228dade3df3b5ab6b6ef0fa3d8fbcf19b9adabc...248a8849fa649e7404192cec00635026604a6750,1,1,1,2,1,2012-12-23 04:21:48,2012-12-22 14:46:02
086cb911533d6f4233e84c93b08da289ecc8a229...75e9a405d4a3fdf9d84282c5fac065257887fd96,1,1,0,1,1,2012-12-21 18:19:40,2012-12-21 16:31:19
086cb911533d6f4233e84c93b08da289ecc8a229...38104ca6b98180efc6bdb6a56c1fcc3910e29d68,1,12,12,24,3,2012-12-19 18:20:59,2012-12-19 16:54:25
086cb911533d6f4233e84c93b08da289ecc8a229...7b90363099e55835885052e7c0512d2af7fdc035,1,4,2,6,2,2012-12-19 15:44:20,2012-12-19 06:44:56
7b90363099e55835885052e7c0512d2af7fdc035...2060ed50e76bfc89e2421cffbb56694e9d803593,1,1,1,2,1,2012-12-19 15:44:29,2012-12-19 04:57:13
2060ed50e76bfc89e2421cffbb56694e9d803593...27f6342f615a4e3fc4dcab5cef2b6bc9ca574ce6,1,3,3,6,3,2012-12-19 15:45:13,2012-12-19 03:13:30
c5f424fd014488bd8a92b97f52bfe47823bc2128...1f6806cf2da84e30d162ca3aee15d16db4f1daef,1,6,1,7,4,2013-10-14 17:24:34,2013-10-10 14:40:39
c5f424fd014488bd8a92b97f52bfe47823bc2128...04c1ee576accad4d0a04f168b86992aba0a6727d,2,35,4,39,4,2013-10-14 05:35:19,2013-10-13 11:52:05
bfae342c973b0be3c9e99d3d86ed2e6b152b4a6b...fef11965da875c105c40f1a9550af1f5e34a6e62,1,7,7,14,7,2012-12-15 18:46:47,2012-12-15 08:29:07
bfae342c973b0be3c9e99d3d86ed2e6b152b4a6b...e208f9cc7574f5980faba498d0aa30b4defeb34f,2,12,0,12,2,2012-12-15 18:45:58,2012-12-15 17:37:36
e208f9cc7574f5980faba498d0aa30b4defeb34f...a469a1019352b8efc4bd7003b0bd59eb60fc428c,4,17,9,26,5,2012-12-15 18:45:59,2012-12-15 17:42:10
54a3c67375384a38eae946b7996d226dbd9c26d4...0b1985050e512d6e0a5fff084ecc7c2232596065,1,1,0,1,1,2014-01-13 17:35:45,2014-01-08 10:47:56
fd356f6aa8bb75ebef56fbc61caf7e02517fa6d3...f63272a35e03a9895c468d1a698dabaa4c3d9273,1,16,16,32,7,2014-03-13 17:56:50,2014-03-13 09:19:07
f63272a35e03a9895c468d1a698dabaa4c3d9273...2f29e0c6fa5d312c4e0675b0dd23d3126b9f55fa,1,17,17,34,9,2014-03-13 17:57:48,2014-03-13 09:19:08
fd356f6aa8bb75ebef56fbc61caf7e02517fa6d3...af2a651d2ecb3967244c9a44a5813a0cf9977df5,3,10,1,11,3,2013-10-24 21:59:39,2013-10-23 17:52:42
50b03b04c06f44be0d09bcc2b56723e8de985d9a...75940a001acb0c09abea8ac71ed1568ab125c795,1,1,0,1,1,2012-12-13 18:54:01,2012-12-13 17:57:19
75940a001acb0c09abea8ac71ed1568ab125c795...bdd478d620034dc6517aea940f5dc6b88f780c04,1,3,3,6,3,2012-12-13 19:13:44,2012-12-13 13:36:30
50b03b04c06f44be0d09bcc2b56723e8de985d9a...055e57876698f44e917152187e7850d8f7e7e0b5,1,10,0,10,9,2012-12-12 19:09:11,2012-12-12 11:36:35
055e57876698f44e917152187e7850d8f7e7e0b5...32d979eaf5a9bbe770aa27e1a8cfed1eeb0969e1,1,1,1,2,1,2012-12-12 19:09:11,2012-12-12 11:38:06
32d979eaf5a9bbe770aa27e1a8cfed1eeb0969e1...c4878fd924c922d12fdfe4e97e4559679342c583,1,1,0,1,1,2012-12-12 19:09:11,2012-12-12 11:38:26
c4878fd924c922d12fdfe4e97e4559679342c583...0e230644273ba903d6bc57bdf6db82acf4fad4d3,1,6,0,6,1,2012-12-12 19:09:11,2012-12-12 11:41:04
0e230644273ba903d6bc57bdf6db82acf4fad4d3...53474eb92ff0571e0b1eacd88d638692b96a2018,1,64,32,96,6,2012-12-12 19:09:11,2012-12-12 11:41:41
7e0651a6302b50db4bac1e65da61c4036cc64d2a...8dd5afc926acb9829ebf56e9b78826a5242cd638,2,17,4,21,11,2013-01-07 23:59:32,2013-01-07 20:24:55
8dd5afc926acb9829ebf56e9b78826a5242cd638...3c020bd528d5dc320b82bd787670edfe6695f097,3,52,78,130,22,2013-01-07 23:59:32,2013-01-05 21:26:38
3c020bd528d5dc320b82bd787670edfe6695f097...388c7f8a275a40697cee2eec5fb124ae8457bf77,1,59,16,75,5,2013-01-10 20:32:35,2013-01-05 21:26:39
388c7f8a275a40697cee2eec5fb124ae8457bf77...ea02ffa38571084007eb7c63f650d0011e44a3dd,5,126,144,270,55,2013-01-10 20:33:08,2013-01-05 21:26:40
ea02ffa38571084007eb7c63f650d0011e44a3dd...0e2913b042825cb3ff6798245f9224f41183d159,3,3,0,3,3,2013-01-10 20:33:08,2013-01-05 21:26:41
0e2913b042825cb3ff6798245f9224f41183d159...dffd325f379b825ca449e1592fa9fb31eddf1780,1,37,21,58,14,2013-01-10 20:33:08,2013-01-05 21:26:42
dffd325f379b825ca449e1592fa9fb31eddf1780...ea57bc0d41b03cc1528be5fafa5eb8bfd4f773cb,2,13,1,14,5,2013-01-10 20:33:08,2013-01-05 21:26:43
ea57bc0d41b03cc1528be5fafa5eb8bfd4f773cb...d20743433e5889319a82c26beb5789e708c450a2,1,14,0,14,1,2013-01-10 20:33:08,2013-01-05 21:26:44
d20743433e5889319a82c26beb5789e708c450a2...d72fbe8111fbd3083d7063078c96eed27098490c,2,72,0,72,5,2013-01-10 20:33:08,2013-01-05 21:26:45
d72fbe8111fbd3083d7063078c96eed27098490c...e6bb5f78fb351c89a80826befda3c8f06f91f249,3,35,0,35,6,2013-01-10 20:33:09,2013-01-05 21:26:46
e6bb5f78fb351c89a80826befda3c8f06f91f249...df874fa82ef06c8c438b9a19c56c0b5eb089c012,1,1,1,2,1,2013-01-10 20:33:09,2013-01-08 08:02:49
7e0651a6302b50db4bac1e65da61c4036cc64d2a...8e679e08a6e12e183aeb068a2ff5d75599d6433d,1,4,1,5,1,2012-12-12 06:10:22,2012-12-11 20:34:51
c9fc4415e2c7d7673cdad34d41114ede3435a395...04fe1184fd0611bf26785b365dd344b8f7d72861,1,2,1,3,1,2013-03-25 19:51:50,2013-03-25 19:51:50
c9fc4415e2c7d7673cdad34d41114ede3435a395...55adef06506b27c3f8d9e16c77bdf4e2e83678e9,1,1,2,3,1,2013-03-25 15:50:53,2013-03-24 21:06:03
55adef06506b27c3f8d9e16c77bdf4e2e83678e9...aac6c2f4bcea6bd371ef8b25edb991673a14d5b3,1,1,2,3,1,2013-03-25 15:50:53,2013-03-24 21:06:04
aac6c2f4bcea6bd371ef8b25edb991673a14d5b3...ff73aa405fdbaa1073b4ada09ba3c151a255d826,1,3,4,7,3,2013-03-25 15:50:53,2013-03-24 21:06:05
ff73aa405fdbaa1073b4ada09ba3c151a255d826...90e76b7029d02314b6f8f8470788874fc44fa621,1,8,20,28,11,2013-03-25 15:50:53,2013-03-24 21:06:06
90e76b7029d02314b6f8f8470788874fc44fa621...9d6aa64dc32b5f1b87c480eaffb8b4bb9aa10c64,1,4,8,12,3,2013-03-25 15:50:53,2013-03-24 21:06:07
9d6aa64dc32b5f1b87c480eaffb8b4bb9aa10c64...8677b777a57e1d843d4aef2d5a12f3cd9ccb7609,1,1,2,3,1,2013-03-25 15:50:53,2013-03-24 21:06:08
8677b777a57e1d843d4aef2d5a12f3cd9ccb7609...22179b307894a6e14f33459b43cd485a03ac4add,1,2,4,6,3,2013-03-25 15:50:53,2013-03-24 21:06:09
22179b307894a6e14f33459b43cd485a03ac4add...c63659dd9638d756a07de13230703406a59b81a0,1,16,30,46,19,2013-03-25 15:50:54,2013-03-24 21:06:11
c63659dd9638d756a07de13230703406a59b81a0...5d76ef25d9fedd46c9409af00953c7e8d31ce2ae,1,1,2,3,1,2013-03-25 15:50:54,2013-03-24 21:06:13
5d76ef25d9fedd46c9409af00953c7e8d31ce2ae...464be6307c898ff314c723626b5ee61387dab9b4,1,3,5,8,3,2013-03-25 15:50:54,2013-03-24 21:06:10
464be6307c898ff314c723626b5ee61387dab9b4...e023a31de6acdc53c006efe231acc5257740d3b0,1,6,26,32,11,2013-03-25 15:50:54,2013-03-24 21:06:14
e023a31de6acdc53c006efe231acc5257740d3b0...cee683b72eac1a1ac0fcbaabf5256a5f0aff07f7,1,26,34,60,26,2013-03-25 15:50:54,2013-03-24 21:06:12
cee683b72eac1a1ac0fcbaabf5256a5f0aff07f7...790f2827378ef99ce1e7dd9b1d3ce42d222d26bd,1,3,3,6,1,2013-03-28 15:16:07,2013-03-28 12:40:19
c9fc4415e2c7d7673cdad34d41114ede3435a395...837154978e94586027e9684ecfbdfd4178c1c8aa,1,6,7,13,6,2013-03-22 21:09:55,2013-03-22 16:19:56
837154978e94586027e9684ecfbdfd4178c1c8aa...d8febde370aa464a5208cf094f306343e4ecb6dc,1,28,40,68,8,2013-03-25 16:00:30,2013-03-24 22:46:28
c9fc4415e2c7d7673cdad34d41114ede3435a395...bb9f2aecf0e212702cdb66e58b16e8e470e596cf,1,3,0,3,1,2013-03-21 21:17:32,2013-03-21 21:17:32
45acb7592825b1faa59ea09247bb88b8e91849e3...2847cae835fa70f00e6e2286fbfa5595cb2247d0,1,6,6,12,3,2013-06-14 15:27:09,2013-06-14 08:28:05
ee6e5843c11ca5cba0d5ce964325a3b529299e0d...25fba78d36be6297bb17aed5f3e21ed850ce3e03,4,19,6,25,5,2013-07-12 17:09:56,2013-07-12 06:20:05
25fba78d36be6297bb17aed5f3e21ed850ce3e03...f2f57e31f671983ef4d6272c082f9fb06daa3429,1,10,10,20,7,2013-07-12 17:10:03,2013-07-12 06:21:22
f2f57e31f671983ef4d6272c082f9fb06daa3429...052fe5eaca92cac810cdb7f89bd8860fc2d5f0e1,1,43,5,48,6,2013-07-12 17:10:04,2013-07-12 06:30:48
052fe5eaca92cac810cdb7f89bd8860fc2d5f0e1...90191d37ab08f7c6810fa22804dedb23bade02a1,1,53,40,93,9,2013-07-12 17:13:23,2013-07-12 06:31:57
90191d37ab08f7c6810fa22804dedb23bade02a1...412916ee131cf8b0aaac96313ce8686aebe3a47a,1,16,9,25,6,2013-07-12 17:14:06,2013-07-12 06:32:25
412916ee131cf8b0aaac96313ce8686aebe3a47a...5b0864070e1e64683e49464c77a72f3c528c8f71,4,19,11,30,15,2013-07-12 17:16:36,2013-07-12 06:34:57
5b0864070e1e64683e49464c77a72f3c528c8f71...23c339c0f262aad2515e48c33ec8f35d476d2ddc,1,22,27,49,15,2013-07-12 17:29:27,2013-07-12 06:37:53
23c339c0f262aad2515e48c33ec8f35d476d2ddc...d099b7173dabdeeb1f339151ac2169b3a91bf631,2,2,2,4,2,2013-07-18 23:43:47,2013-07-18 20:25:50
c6c4250eb605a502e1b5128d224561cf71272798...43d11f4492ebafdabd3fb0c9bcab49d2731e4676,2,12,1,13,2,2013-06-30 22:36:03,2013-06-30 22:36:03
7c2e8fc68469d374c8fd460a9342449642b4c8bc...7d3ccdffb5d28970dd7a4d177cfcca690ccd0c22,1,1,1,2,1,2013-05-03 22:23:45,2013-05-03 22:23:45
a15696bb46848b1cc815aae142b9cae562ac1c97...7ece7ee6079682bb2bb968b61a62fcb233df4005,1,21,6,27,8,2013-04-12 00:41:14,2013-04-11 23:03:55
de91daf5e6c9346a54ec8afd331017470d280b12...0df7b8e55c3b193f2b2f60f7cac1ebb2ce04cd9e,1,2,0,2,1,2013-04-26 21:55:20,2013-04-26 20:44:35
66bea733f3e08e4aacacedcc7b6e46d202bdc7f8...961c5129d53554d4d71003899fab8dda846d7c2a,1,11,0,11,2,2013-04-02 22:14:26,2013-04-02 22:14:26
8617715cc09b7422fe31189f9476f6ade73ede70...ffb6d7d5c99e4097e512def20b0133b7ee900953,4,93,78,171,13,2013-04-01 02:15:11,2013-03-31 16:00:14
ffb6d7d5c99e4097e512def20b0133b7ee900953...f8aae8d0efccd268babd482f10709b4f86a9f32e,1,12,5,17,3,2013-04-01 02:16:15,2013-03-31 16:01:34
f8aae8d0efccd268babd482f10709b4f86a9f32e...efed0022492b81bf59d29193c4ffe96492dd9e9b,4,98,3,101,8,2013-04-01 02:23:59,2013-03-31 16:02:24
efed0022492b81bf59d29193c4ffe96492dd9e9b...eb307ae7bb78ccde4e2ac69f302ccf8834883628,10,29,12,41,8,2013-04-01 05:38:49,2013-03-31 16:02:46
eb307ae7bb78ccde4e2ac69f302ccf8834883628...e290c4b944f109aff26cc3db4ae0aec92f3cc126,2,4,1,5,2,2013-04-01 05:38:53,2013-03-31 16:03:22
9b924eee98332225f63c36c5d9673c47e0a8b769...9a6728d4d14a08791861a63b7567ee0b50e59f70,3,27,2,29,3,2013-04-04 19:28:47,2013-04-04 19:03:35
9a6728d4d14a08791861a63b7567ee0b50e59f70...96ec8ee92aad52b6556e87d0166a7b9c4cd7c324,1,12,0,12,1,2013-04-04 19:28:53,2013-04-04 19:03:58
96ec8ee92aad52b6556e87d0166a7b9c4cd7c324...03415ca8db28e67ca04e04126b42f38a90c825de,1,28,0,28,1,2013-04-05 04:54:07,2013-04-05 00:00:09
260dba5d4934b2bb9604d0dcd1d3d8e4fb40bd43...8d994db46ecd3efa1adbd401f8969f8de25fbb20,1,31,10,41,13,2013-04-03 16:44:50,2013-04-03 16:43:47
fb5657082148297b61fbca7e64d51c1e7870309a...64948ad77534f035311fd3e1086477661c8f63b1,2,8,1,9,2,2013-08-08 21:03:21,2013-08-08 20:58:34
fb5657082148297b61fbca7e64d51c1e7870309a...b9ccf55e064e2fc7df9773850ba7a23e2abf4ca7,1,72,0,72,1,2013-08-07 23:24:30,2013-08-07 15:18:10
b9ccf55e064e2fc7df9773850ba7a23e2abf4ca7...af23445925464b74b5f038271b6cfeaeb217481f,1,11,11,22,8,2013-08-07 23:24:30,2013-08-07 22:38:45
af23445925464b74b5f038271b6cfeaeb217481f...db5723c6283d9a8dff3397c432af80cf5e2f7766,1,26,20,46,3,2013-08-07 23:24:30,2013-08-07 21:43:20
db5723c6283d9a8dff3397c432af80cf5e2f7766...069d50320257b76504921a7bc77696a6d858bfec,1,9,5,14,2,2013-08-07 23:24:30,2013-08-07 22:14:45
069d50320257b76504921a7bc77696a6d858bfec...b26ed4305f9e7043133e52990897afbbf1808d6d,3,21,0,21,6,2013-08-07 23:24:30,2013-08-07 22:47:18
b26ed4305f9e7043133e52990897afbbf1808d6d...0f73f8bd7974fcf7f9e4608875323c96c6159829,1,1,1,2,1,2013-08-28 23:55:23,2013-08-28 18:56:17
fb5657082148297b61fbca7e64d51c1e7870309a...89b0230a20e435c02effafd3de16bb105d652505,2,14,1,15,2,2013-08-07 15:49:49,2013-08-07 09:26:05
fb5657082148297b61fbca7e64d51c1e7870309a...b8ecf239d08041f1c56266328bbdff15fe04782a,1,174,161,335,159,2013-08-06 06:13:23,2013-08-06 06:13:23
b8ecf239d08041f1c56266328bbdff15fe04782a...85ef881f6ca35bd8a356416c137d800a36b42f52,1,187,169,356,166,2013-08-06 07:34:48,2013-08-06 07:34:48
85ef881f6ca35bd8a356416c137d800a36b42f52...b18943845c71bf4792436c541e342361e2483249,1,182,164,346,161,2013-08-06 09:22:16,2013-08-06 06:49:18
b18943845c71bf4792436c541e342361e2483249...aa4e5fe40f8c0d36083a91438ad88494f3d6e48e,1,1844,1521,3365,1341,2013-08-06 11:44:17,2013-08-06 11:41:48
aa4e5fe40f8c0d36083a91438ad88494f3d6e48e...b5c0a216f84e1f82e1e214b3c29b5916c2668674,1,1,1,2,1,2013-08-08 15:55:25,2013-06-05 20:59:44
b5c0a216f84e1f82e1e214b3c29b5916c2668674...eb5accfece37330cc133b9585f8b773aacea56d1,1,909,922,1831,827,2013-08-08 15:55:25,2013-05-29 16:03:39
eb5accfece37330cc133b9585f8b773aacea56d1...770c73ffc98f3cdef7bd83a107770ce85f653fc1,1,1954,1638,3592,1420,2013-08-09 04:53:35,2013-07-26 15:48:46
770c73ffc98f3cdef7bd83a107770ce85f653fc1...4402f301555feeada2de68c4576aa15acfe40b46,1,243,188,431,184,2013-08-09 04:53:44,2013-08-06 17:54:29
5d57cac6ae7c661d430dcc7dd2e44c994bf797be...1e159833c732d332eefd75d92bee22cf029ca84f,1,2,1,3,1,2013-08-06 21:25:22,2013-08-06 13:59:34
1e159833c732d332eefd75d92bee22cf029ca84f...0ddd47193c225a9f7a658682d4e859771b45ab84,3,3,8,11,7,2013-08-06 21:26:26,2013-08-06 13:59:35
0ddd47193c225a9f7a658682d4e859771b45ab84...c0babbe6953a8a085f270e98e9a94d2a6f3a381b,2,17,5,22,6,2013-08-06 21:27:20,2013-08-06 13:59:36
c0babbe6953a8a085f270e98e9a94d2a6f3a381b...753935749f21b10b306bc81559bba2912a7128a6,1,3,14,17,2,2013-08-06 21:28:09,2013-08-06 13:59:37
753935749f21b10b306bc81559bba2912a7128a6...58dbfa2e59a11b3dd060d69788af4c3decc7ee22,1,47,32,79,7,2013-08-06 21:29:35,2013-08-06 13:59:38
58dbfa2e59a11b3dd060d69788af4c3decc7ee22...91b5494e18965e51c924ca55aaa27e94ebd82dd2,1,32,0,32,1,2013-08-06 21:33:45,2013-08-06 13:59:39
91b5494e18965e51c924ca55aaa27e94ebd82dd2...5bd9b79a2017daad1d600978b75c714eef74cac0,2,12,6,18,4,2013-08-06 21:34:43,2013-08-06 13:59:40
5bd9b79a2017daad1d600978b75c714eef74cac0...815834e9aa6148b7815b9aea7db5d44640a4383a,4,32,7,39,10,2013-08-06 21:36:34,2013-08-06 13:59:41
815834e9aa6148b7815b9aea7db5d44640a4383a...52f4d1264854485bfd50afeeed1933a3f9e05c96,2,24,1,25,5,2013-08-06 21:44:25,2013-08-06 13:59:42
52f4d1264854485bfd50afeeed1933a3f9e05c96...3e0d79dbe3064cf065b6518520dd1489406200a9,1,12,3,15,7,2013-08-06 21:46:12,2013-08-06 13:59:43
3e0d79dbe3064cf065b6518520dd1489406200a9...0bc2cdd5507ea4acad06c6d872245e4a3fd2a4b6,1,3,1,4,1,2013-08-06 21:46:28,2013-08-06 13:59:44
0bc2cdd5507ea4acad06c6d872245e4a3fd2a4b6...a6ac5f9864958f65269d8d58a049324403b039fd,3,30,2,32,4,2013-08-06 21:47:04,2013-08-06 13:59:45
a6ac5f9864958f65269d8d58a049324403b039fd...1ce761a524e34f2d629759cb57c67d13acbe4a7a,4,25,7,32,8,2013-08-06 21:47:34,2013-08-06 13:59:46
1ce761a524e34f2d629759cb57c67d13acbe4a7a...215e76c7ff8be46b8206c45aed3b6ec29069d4fc,4,26,2,28,6,2013-08-06 21:48:02,2013-08-06 13:59:47
215e76c7ff8be46b8206c45aed3b6ec29069d4fc...9527604f7d6490fd4ce0809fe8fc8a600e03710d,1,12,0,12,1,2013-08-06 21:48:29,2013-08-06 13:59:48
9527604f7d6490fd4ce0809fe8fc8a600e03710d...5ce922a014f78684a96c3d03a51decf0d21fa58d,2,13,10,23,8,2013-08-06 21:48:55,2013-08-06 13:59:49
fd6d822e847f88d016cb608d6b76a3914f372c66...3d88f83db212b6ac70eac68cd5f3a6461ed3194f,1,22,0,22,3,2013-04-22 18:18:43,2013-04-22 18:18:43
7b592fadf1e23b10b913e0771b9f711770597266...be537e43ca8c6e38a3cf7024b28d6daf54611132,1,2,2,4,1,2013-03-29 22:24:31,2013-03-25 10:13:18
7b592fadf1e23b10b913e0771b9f711770597266...e721c1544f9166e8f08a7f8c0e6178ea3a45e255,5,80,8,88,16,2013-03-27 15:53:15,2013-03-27 05:58:21
7b592fadf1e23b10b913e0771b9f711770597266...df45cb3ea31eee8ad1c763d1b8a35da87366017f,2,7,2,9,3,2013-03-25 22:01:22,2013-03-25 21:00:07
7b592fadf1e23b10b913e0771b9f711770597266...0117c2f043183fb99e9b046b0df7d64c1b296624,4,36,3,39,10,2013-03-25 21:57:33,2013-03-23 12:40:29
59332d13b2b23840452180368914921bffe9bfbc...ac1d33dd0205c52fb168ddaa53b40aeb6f1ea7b5,1,3,2,5,1,2011-09-15 19:17:56,2011-09-15 18:26:02
ac1d33dd0205c52fb168ddaa53b40aeb6f1ea7b5...a9e643668aa932d93528fffa573a13a28eb54556,2,1,2,3,3,2011-09-15 19:27:40,2011-09-15 18:26:03
8d66bb05870d4bc46e9951958f78fc71ffac449b...1ae96444104c2bd9c653658fef79ef543559ad27,1,1,1,2,1,2011-08-30 17:06:19,2011-08-30 00:06:07
fdc4408a8980392f2cc30dc125906a61edf170ec...1876166aaab56056083e6a61de4423d130d4dcc6,3,24,27,51,9,2010-09-09 18:39:20,2010-09-08 17:59:53
1876166aaab56056083e6a61de4423d130d4dcc6...96e9420cd357728949571b42eb0249881ae3a78e,4,37,24,61,19,2010-09-09 18:39:20,2010-09-08 17:59:54
96e9420cd357728949571b42eb0249881ae3a78e...bda3b8ff1735aecfb5265ed781548eab238d7a14,4,21,14,35,4,2010-09-09 18:39:23,2010-09-08 17:59:55
bda3b8ff1735aecfb5265ed781548eab238d7a14...b928cbf120a8f6d1d435849fb1fcf1c64489dc4c,1,48,0,48,1,2010-09-09 18:39:25,2010-09-08 17:59:56
b928cbf120a8f6d1d435849fb1fcf1c64489dc4c...bd2549ca6b0b2d897e073bbaa34c1fee46acd8f0,1,43,0,43,1,2010-09-09 18:39:26,2010-09-08 17:59:57
1666246b702379275fe87cbbbf6111a74d00d825...9f29fe9a779e55e7387577cd7f712de0b13b5cd6,1,13,3,16,6,2010-08-27 17:43:59,2010-08-27 05:36:13
e935e62a0fd26ff1f29a98a4ca8fa693f42357a2...dc1166e685dc54946ea4600e962e56a965962ec2,6,54,54,108,8,2010-09-03 16:31:28,2010-09-02 11:57:33
dc1166e685dc54946ea4600e962e56a965962ec2...e294030fe89efcdd92430b60cf9568ffbe7317a8,5,8,5,13,6,2010-09-03 16:31:41,2010-09-02 11:57:34
e294030fe89efcdd92430b60cf9568ffbe7317a8...5e65ee35ddd306d6e6c86efc1c95315942f87811,4,3,9,12,5,2010-09-03 16:31:51,2010-09-02 16:08:15
5e65ee35ddd306d6e6c86efc1c95315942f87811...c5978a507ca20b12008724f78237784193fb9489,1,10,2,12,2,2010-09-03 16:31:59,2010-09-03 15:25:33
2caf20c52b7f646d0a7481c25415c48d687773b2...172b6428d06ff4eb0812f087a497d50b6c878fe1,2,35,1,36,3,2010-11-15 17:27:33,2010-11-14 22:07:49
2caf20c52b7f646d0a7481c25415c48d687773b2...2d6ca6ef55226185b6a093f7fac27f5fecd51fe6,1,14,9,23,6,2010-08-13 21:19:12,2010-08-13 20:47:34
2d6ca6ef55226185b6a093f7fac27f5fecd51fe6...d1c3b10f7ced34a607c50de8b5c271ce9cf764ea,1,2,2,4,2,2010-08-13 21:21:22,2010-08-13 20:47:35
90e14525f22c2980d4375dcb5d79e6d5da293a78...175f6e59f6c74d5f8c80fe3a6678915cc5d35cb6,1,12,4,16,7,2010-08-25 20:12:04,2010-08-25 10:34:57
175f6e59f6c74d5f8c80fe3a6678915cc5d35cb6...62ed0096423b098f9736f5397edad8aa7bf50210,2,9,1,10,2,2010-08-30 07:37:30,2010-08-28 14:49:25
62ed0096423b098f9736f5397edad8aa7bf50210...23b4c7bcc58431beaf9c870a2d6b2ad4fb088a9f,2,21,0,21,3,2010-08-30 07:37:37,2010-08-28 14:50:07
3f8099fce7779631fe8827a8979d7b57629a36de...98937bef1bf1c8eea90c209c601d4338a43a3479,1,25,18,43,4,2010-08-04 18:21:44,2010-07-24 12:11:58
4c007ae8351a0a2beba57e2930ed21aed141e51e...ebe8621fd798a568ae33eb6a665cb3c758dd3816,1,2,2,4,2,2011-05-13 16:57:16,2011-05-13 16:43:29
4c007ae8351a0a2beba57e2930ed21aed141e51e...8b1ae678a33e2d1ccf3080977b692a59acad9b50,3,25,1,26,5,2011-05-11 18:20:28,2011-05-08 10:31:02
6329bade6632a9df4b37dd3a7f8d641eed74bbf5...ab6854515ee2280f187fbc2ab08f9e9115438f3e,1,6,4,10,2,2010-01-20 01:10:35,2010-01-20 01:10:35
b4ca1db968eb57d9cd869337bffa254e0b2c83bd...eb523a8d795e31e84cc8af5c43b913ed0cd073b1,2,18,2,20,5,2010-04-14 20:14:27,2010-04-14 20:12:34
eb523a8d795e31e84cc8af5c43b913ed0cd073b1...713c79e84bb148b8166d866755d155f64b270ac9,2,15,7,22,10,2010-04-18 01:20:23,2010-04-14 22:09:57
713c79e84bb148b8166d866755d155f64b270ac9...03cb91b18cc7f9c19c053c97711f592cebddb5f4,1,59,10,69,8,2010-04-18 01:23:19,2010-04-09 20:20:02
d7eed8cbef2d15e87e9002f5e3ce08830b40b292...6f53c3b21e3899716caccc2f88a1186ca7fa0f60,1,10,10,20,3,2010-01-16 16:54:36,2010-01-16 09:20:26
d828fdb8d79b1d06b3015d9a45da24ac3f887484...685c568a7ac73794bcc367fddae129c8fcaf1d2e,2,16,1,17,2,2009-12-26 22:20:09,2009-12-26 22:20:09
685c568a7ac73794bcc367fddae129c8fcaf1d2e...21a0d9b42d9cc9560c66fb3cfa82a2a449de8b39,1,1,0,1,1,2009-12-26 22:32:36,2009-12-26 22:32:36
dea4562bf5d1c27cd6c01b9cb65c3a8b8ee99a69...7fb0eaa289576a1dcd7751015ba791f1bce778a9,9,19,14,33,12,2010-01-17 04:39:59,2010-01-17 04:39:59
28044baba6d268d91057398ffa041ee1b931a5e0...a479a564dc33bdbc102f2af81ab71ef3e1eae492,1,4,0,4,1,2009-12-03 02:45:09,2009-12-03 02:45:09
b30ccd757354ea09b41e4359b0a5ab429d12f02e...63d04a78043c61c52ae437fa6106e7029b466bbf,1,1,0,1,1,2010-01-28 20:36:12,2010-01-22 10:54:51
b30ccd757354ea09b41e4359b0a5ab429d12f02e...21528abc3612e3dae0c195b81848dd9aa18d2a02,1,20,3,23,10,2010-01-26 16:07:33,2010-01-26 15:44:47
21528abc3612e3dae0c195b81848dd9aa18d2a02...daa99a917293d962ce565a04a09b0de08e32b8ba,1,16,16,32,5,2010-01-26 16:07:34,2010-01-26 15:45:54
daa99a917293d962ce565a04a09b0de08e32b8ba...7a1894e3039bc554e2a193c895b2ab5300b7f823,1,1,2,3,2,2010-01-26 16:07:34,2010-01-26 15:46:16
7a1894e3039bc554e2a193c895b2ab5300b7f823...066ddda6cdf2652a85430a979dbf1cd65fbfad0f,1,1,1,2,1,2010-01-26 16:07:34,2010-01-26 15:46:37
066ddda6cdf2652a85430a979dbf1cd65fbfad0f...3e6577b45e755b53c9cccb24d75916fa3f2e1916,1,1,1,2,1,2010-01-26 16:07:34,2010-01-26 15:46:59
38a81b4e82ebf57549f2fa082b329c36dffc0b18...09c9957cf77106ca6b49127d5df20080922c81a4,1,4,0,4,2,2011-04-25 22:13:24,2011-04-25 21:04:10
38a81b4e82ebf57549f2fa082b329c36dffc0b18...6d525d389fbef814b11e41f196e6656f2e95f412,2,70,17,87,13,2010-02-06 04:57:27,2010-02-05 20:57:42
e9abef6289706f77186ed852d579c7b222f06502...07fd82d3a7639a6c88d4342be36e74e4496bde58,1,109,96,205,91,2013-01-23 19:46:24,2013-01-21 18:35:12
e9abef6289706f77186ed852d579c7b222f06502...c08e4d5b5cfa9f692cb8c81e5e9615e330f299c2,5,28,10,38,9,2013-01-22 17:33:16,2013-01-22 07:49:22
d32805dce7bdc45a3e4045e999fc5d56e3b46a82...e9b4908302c659251a47ce440676cb3b0d65b8af,1,10,5,15,4,2013-02-18 08:48:30,2013-02-18 00:15:53
e9b4908302c659251a47ce440676cb3b0d65b8af...d1471e061657c2e437076947e0e51a3c32adfa60,1,7,0,7,1,2013-02-18 08:48:37,2013-02-18 00:15:55
d1471e061657c2e437076947e0e51a3c32adfa60...47adb8ac7c550bc89e7eae743dcc8940c2549edf,1,13,27,40,9,2013-02-18 08:48:42,2013-02-18 00:15:56
47adb8ac7c550bc89e7eae743dcc8940c2549edf...632cc3e6b687c48998223eb49fc465bcb3a9c1d2,1,13,5,18,2,2013-02-18 08:48:47,2013-02-18 00:15:58
632cc3e6b687c48998223eb49fc465bcb3a9c1d2...7ed1690c343dc16dfd5a5493589cbf74d503c238,1,12,3,15,2,2013-02-18 08:48:52,2013-02-18 00:16:01
d32805dce7bdc45a3e4045e999fc5d56e3b46a82...c0179c0d33b0fc3c8ad30246eece220e0442fb6e,1,5,6,11,3,2013-02-15 17:05:55,2013-02-14 15:36:54
d32805dce7bdc45a3e4045e999fc5d56e3b46a82...b60b7566c04e5f54c0e40229c1716d99d834ab68,1,11,2,13,7,2013-02-14 17:27:40,2013-02-14 16:04:42
b60b7566c04e5f54c0e40229c1716d99d834ab68...1315093f99f327ff498ae6c8afcc42651bbddebc,1,11,14,25,1,2013-02-14 17:29:30,2013-02-14 16:04:43
1315093f99f327ff498ae6c8afcc42651bbddebc...9cc4ac8ff1ae84f9435f2c7de3f7ab796103adba,6,13,10,23,10,2013-02-14 17:30:04,2013-02-14 16:04:44
9cc4ac8ff1ae84f9435f2c7de3f7ab796103adba...4a868fd655a72c2663d9519363162db467baccb2,1,9,5,14,8,2013-02-14 17:30:22,2013-02-14 16:04:45
4a868fd655a72c2663d9519363162db467baccb2...0174eeaa736226a0bea19e9bf88c270d61aa9cce,2,9,1,10,4,2013-02-14 17:30:36,2013-02-14 16:04:46
d619cfc7490481652833dff820e04263869c8861...8447dc890488a953ab190e8826bc9dd175b28df9,1,3,3,6,2,2013-11-07 18:49:52,2013-11-07 16:30:47
d619cfc7490481652833dff820e04263869c8861...4ef8d1dd03d3b8adf81b4b81b2231128e3591f36,2,15,6,21,4,2013-11-06 19:03:33,2013-11-06 18:00:57
8f98074c6a4667325605b043ca0ae6fe3f019c78...298caa7e9e2a813e6d80cf77c64f87ae04c731ff,3,99,2,101,3,2013-01-02 18:56:08,2013-01-02 18:44:12
72aeb18772deeb386da7dd8997b969877bd29e41...6866654627fbf10387f3b5e83d9079d8a7f4b378,1,10,0,10,1,2013-02-19 17:37:39,2013-02-19 14:06:22
6866654627fbf10387f3b5e83d9079d8a7f4b378...c19387e79947de9307af06ce92a83eaf786153b7,3,8,3,11,5,2013-02-19 22:00:12,2013-02-19 19:56:44
0d6cf2471f426dd2b742e2285aad78381738be96...a0e0ec9f7dd2ad46459cf98b7465b007fb15258b,2,12,4,16,5,2013-10-29 19:44:39,2013-10-29 01:22:07
a0e0ec9f7dd2ad46459cf98b7465b007fb15258b...94221d22036f36e10680c0a1e7eafb4bceeb1248,28,50,50,100,46,2013-10-29 19:45:15,2013-10-29 01:23:03
284a126c3ef3dfedede9bc64df4cf3a24600dea5...79e0fe634865462551cf3fcad25c9a595652e925,1,3,2,5,1,2012-03-15 20:53:39,2012-03-15 16:28:26
dd6139971a18e25a5089c0f96dc80e454683ef0b...1c2dbf2095beb5227d963a1541e356bd2e834dff,1,2,0,2,2,2015-02-03 21:53:17,2015-02-03 17:30:08
d9f5ef7a4a760d58f1f824f9fb8c12ef0371d3a9...5c08c1f23ad512fbcd06f4ee9bcf8818e17a2627,1,2,2,4,1,2012-10-19 23:12:45,2012-05-04 22:35:18
d9f5ef7a4a760d58f1f824f9fb8c12ef0371d3a9...ff59f6da840bb58058fef06721a2646daae50509,2,3,1,4,2,2012-06-28 02:53:04,2012-06-27 21:58:01
d9f5ef7a4a760d58f1f824f9fb8c12ef0371d3a9...b0082b9d5918e3548c987303a19de0d69bbcabaa,1,91,0,91,1,2012-06-19 21:14:17,2012-06-19 20:04:57
b0082b9d5918e3548c987303a19de0d69bbcabaa...c5941f1aac071addc1c9b0781c323b588c542420,2,5,2,7,3,2012-06-19 21:15:57,2012-06-19 21:15:57
d9f5ef7a4a760d58f1f824f9fb8c12ef0371d3a9...42939f1a244451ed3b9dcb2d2e3eea2bcb08f6c2,1,1,0,1,1,2012-06-15 17:41:37,2012-06-15 14:33:15
42939f1a244451ed3b9dcb2d2e3eea2bcb08f6c2...b98878edefd284927748aa2ce9ff090fa43c2c8a,1,12,1,13,2,2012-06-15 17:56:13,2012-06-15 14:33:16
d9f5ef7a4a760d58f1f824f9fb8c12ef0371d3a9...070bad6d0ca61b23611661eb4f05ddd548d42afd,1,1,1,2,1,2012-06-04 22:35:22,2012-06-04 16:42:44
d9f5ef7a4a760d58f1f824f9fb8c12ef0371d3a9...eb41775ecc031cd8e38aebbd26826d74922a0db9,3,59,6,65,7,2012-06-03 23:05:42,2012-06-01 18:28:00
eb41775ecc031cd8e38aebbd26826d74922a0db9...93921b07e985de38f7af6689d81e5c7dfb3f8aa0,1,18,0,18,3,2012-06-03 23:08:25,2012-06-01 19:22:09
93921b07e985de38f7af6689d81e5c7dfb3f8aa0...782cd4c0f6e0fef5147cb738009dde6e778f4932,3,30,15,45,12,2012-06-06 04:22:36,2012-06-06 04:17:52
782cd4c0f6e0fef5147cb738009dde6e778f4932...eb69934bbd1200a318422c0d127c043d6b8457e1,1,5,1,6,3,2012-06-06 04:44:22,2012-06-06 04:44:22
eb69934bbd1200a318422c0d127c043d6b8457e1...589570dbe7d291e73defea367babb5400a87e9f0,2,11,1,12,4,2012-06-06 05:21:42,2012-06-06 05:21:42
589570dbe7d291e73defea367babb5400a87e9f0...0d316f0ceff1c416c25327f40bc5fbdded98a01a,2,1,2,3,2,2012-06-06 05:26:12,2012-06-06 05:26:12
e22a81ca54448fb49847ff72be0a8859bcc015ae...aa39b858a35d99135e1403575a358b97d26ff466,1,27,0,27,4,2012-04-23 20:30:22,2012-04-23 20:30:22
aa39b858a35d99135e1403575a358b97d26ff466...037a98cd3f3efe85c6f56c4338002e4b2c7afa09,1,9,6,15,4,2012-04-24 09:42:08,2012-04-02 13:29:32
037a98cd3f3efe85c6f56c4338002e4b2c7afa09...6ade9bdadaf61565ee4e2ab47f66baaf41a20ecf,1,5,0,5,1,2012-04-24 09:42:08,2012-04-02 13:52:34
6ade9bdadaf61565ee4e2ab47f66baaf41a20ecf...8c3a534c506bceb4981266e0c5db2918bb067da8,1,1,1,2,1,2012-04-24 09:42:08,2012-04-23 16:26:56
0b9f4b63a0c1ff351415a1f41dfcbc2461c65e74...b741611c062db33dcd2ab41ec589cb659c465ebc,1,108,96,204,87,2012-05-14 22:36:36,2012-05-14 22:36:36
62ed0728fe52312f270760187b3280bc51b6c2f0...c48be8b759725d7c9ce327ac6f32bb572fdc5ce1,1,0,1,1,1,2012-02-27 19:01:15,2012-02-27 18:34:09
c48be8b759725d7c9ce327ac6f32bb572fdc5ce1...64baa4153b836646ecf6885482f4fc46e04a90db,1,3,3,6,3,2012-02-27 19:01:16,2012-02-27 18:34:10
64baa4153b836646ecf6885482f4fc46e04a90db...48f359bfafa7db4c399fa13f17ccfea7c35f333b,1,7,0,7,1,2012-02-27 20:41:13,2012-02-24 23:12:57
48f359bfafa7db4c399fa13f17ccfea7c35f333b...860f70f9f4206379361fd5af84c8fde31984b418,1,5,0,5,1,2012-02-27 23:10:23,2012-02-24 23:12:58
663c1295d8a6a591a805692d311e1d709e3193e2...27b5587c7610515832cf39cd0c3792e7655bdd9a,1,7,2,9,1,2012-05-20 22:10:49,2012-05-20 06:49:32
bd444cadb53ce9030fe79f2cdb1570e1a49d4877...1252bbe1c685450ec76ac750e8b0c2e0b762f93f,2,292,0,292,2,2012-02-27 20:37:10,2012-02-24 19:48:57
1ec31a33e2956027cc7ecd5c17f66585f2ee1356...2f64542f9c2f6082dd5aa7d8d13886cdc965d175,1,98,94,192,87,2012-05-12 06:56:06,2012-05-08 08:14:32
418a1435f19b8105de2ee94b54cc2962bc9b5f03...9830a9ca50ae269aa8858df596e32506c97cdd26,2,20,20,40,11,2012-06-06 21:46:35,2012-06-06 21:24:28
0dbe6592ccbd1a394a69a52074e3729d546fe952...c844a8035617a602015d74ce329ee88f9b003bf9,2,11,4,15,6,2012-03-15 18:12:25,2012-03-15 14:58:54
0dbe6592ccbd1a394a69a52074e3729d546fe952...4b340cfab9c7a18e39bc531d6a6ffaffdf95f62d,3,104,44,148,13,2012-03-11 10:56:50,2012-03-11 09:25:43
0dbe6592ccbd1a394a69a52074e3729d546fe952...3e9c6a08c8a99349a2969f5e2c37b77a6bac9b8c,1,10,1,11,1,2012-03-10 21:25:41,2012-03-10 12:29:34
3e9c6a08c8a99349a2969f5e2c37b77a6bac9b8c...5eb660ecd1965c67be0051c46b8e8a56b28ff5b2,1,5,2,7,4,2012-03-16 16:15:28,2012-03-10 12:29:35
0dbe6592ccbd1a394a69a52074e3729d546fe952...d34e70d6b89b33c398403e872c0dd751d44c7844,2,3,3,6,4,2012-03-07 18:24:33,2012-03-06 09:18:41
69f4e08f535d4e5a035069a64d1ebaea7be55d83...97e5954bdcf46c76e4a8147172ff7c5a4f633e0d,1,1,1,2,1,2012-04-10 23:36:18,2012-04-10 18:55:58
97e5954bdcf46c76e4a8147172ff7c5a4f633e0d...6ff264ee05cc8fd6b2c796623eadb8662444a458,1,16,9,25,5,2012-04-10 23:36:23,2012-03-06 19:37:23
69f4e08f535d4e5a035069a64d1ebaea7be55d83...9b9f46f5c12cd7fbb4f194a2533bea1edef573fb,1,23,14,37,3,2012-03-09 22:29:37,2012-03-07 23:36:59
69f4e08f535d4e5a035069a64d1ebaea7be55d83...3ea2232d8d273af2cac9bb57b9af80cfe6fa4b22,1,6,6,12,4,2012-03-06 19:40:54,2012-03-06 09:32:43
3ea2232d8d273af2cac9bb57b9af80cfe6fa4b22...ebab98942069400b12aa357c95e3e8f7a4f26bab,1,1,1,2,1,2012-03-06 19:43:22,2012-03-06 09:32:44
ebab98942069400b12aa357c95e3e8f7a4f26bab...f36ed6db699673bcfb010ab7343bacd5537eb679,1,3,2,5,1,2012-03-06 19:43:23,2012-03-06 09:32:45
3724cc7c58df709cffbf6cc0701d1ca6fa5a5ba2...42b00599be684e20462c431a718f86c2b6fce575,2,14,4,18,7,2012-02-27 23:58:36,2012-02-27 22:10:38
3724cc7c58df709cffbf6cc0701d1ca6fa5a5ba2...3ddf9228b4996ffd3aef8b119535e89051ba592b,1,4,0,4,1,2012-02-27 18:29:24,2012-02-27 16:22:53
3ddf9228b4996ffd3aef8b119535e89051ba592b...d29d787cd6c0e70891596c61533c1f811425d2d6,1,23,0,23,2,2012-02-27 20:21:51,2012-02-27 16:45:49
d29d787cd6c0e70891596c61533c1f811425d2d6...ff3d656b7ce98bf5c408a1432f88bd6b8ead2d8c,1,2,0,2,1,2012-02-27 20:24:09,2012-02-27 17:40:14
c103e9529c8a95b5acf4747cfe06b2f6adedab71...167a5800cb707ed489c3cb88174ee21e95a610ae,2,2,2,4,2,2011-09-18 22:41:34,2011-09-18 22:41:34
587a9ee7da348f5e6696720d770d0e0da597827c...fa79937675600ad5dda5031c532097a0461d843e,5,39,12,51,11,2011-09-17 04:47:47,2011-09-16 23:28:38
2137ce01f83d254e4917c107901a5a04f61e8c16...714d25868f156e0969eb8a47e6a1bf3df9c17a5d,1,7,0,7,1,2013-04-12 17:29:06,2013-04-12 16:08:31
2137ce01f83d254e4917c107901a5a04f61e8c16...06cb843fea195ea99391c4daf8018a13ec99c75e,1,3,1,4,1,2013-04-12 16:14:01,2013-04-12 05:56:24
06cb843fea195ea99391c4daf8018a13ec99c75e...04a74b6cfa5ef4870263f84ac94a488d9f2ef14a,1,2,2,4,2,2013-04-12 16:48:46,2013-04-12 14:05:55
2137ce01f83d254e4917c107901a5a04f61e8c16...5446e33f35d6b27b6b760a59a6ded33fbd555190,2,11,1,12,2,2013-04-07 21:45:56,2013-04-07 11:53:15
6ceb270ce6f65cf4bc2a22830f96e0cc838b3fec...ec014eac0e9e6f30cbbca616090fa2ecf74797e7,2,6,1,7,2,2011-04-24 06:36:32,2011-04-24 06:36:32
6ceb270ce6f65cf4bc2a22830f96e0cc838b3fec...f6aca0dc4d6b7ed9bf2bff399e3fcb47eafdce4b,1,59,64,123,4,2011-04-21 17:56:28,2011-04-21 10:45:07
f6aca0dc4d6b7ed9bf2bff399e3fcb47eafdce4b...0fc63ec4e7291361b59e12433e5c07117951cf19,2,63,1,64,5,2011-04-21 17:56:39,2011-04-21 10:48:24
71eb87890af00dcd9904c3166b45befa9c5aa024...61bc0753f149f204ddb5414ca98dc3d4f1876456,1,4,4,8,4,2012-02-29 16:23:14,2012-02-29 12:53:26
71eb87890af00dcd9904c3166b45befa9c5aa024...271ce198cd01f1e0de77bbd04cca66b0648e59bd,2,94,22,116,16,2012-02-29 08:10:30,2012-02-29 08:10:30
271ce198cd01f1e0de77bbd04cca66b0648e59bd...75b182aee702aa82bec81c542788eb9149a68fa0,2,16,10,26,6,2012-03-02 04:50:49,2012-03-02 02:29:53
207f1a75e7e4d14286aeed107af7c56dc811797b...130faabe48fd988c1eb078ef467a44e124a00a40,1,4,0,4,1,2007-10-18 05:10:56,2007-10-18 04:41:43
207f1a75e7e4d14286aeed107af7c56dc811797b...42e18fbf5f94dd6bd303bf702e030a29fa39d6c4,6,39,50,89,34,2007-10-17 06:54:55,2007-10-17 01:55:45
42e18fbf5f94dd6bd303bf702e030a29fa39d6c4...ed1902ef5c6a30942def50809b52e41fbdcdf13f,1,17,2,19,2,2007-10-17 06:54:56,2007-10-17 01:55:46
ed1902ef5c6a30942def50809b52e41fbdcdf13f...2f8b89472cec19a530cb697c4ee20e0ddfd747f6,1,1,1,2,1,2007-10-17 06:54:56,2007-10-17 01:55:47
2f8b89472cec19a530cb697c4ee20e0ddfd747f6...7ba502c47bda21d060844863991083f4c319d436,2,29,23,52,11,2007-10-17 06:54:56,2007-10-17 01:55:48
7ba502c47bda21d060844863991083f4c319d436...4049b9cfc082affc6365539138f6f5c546bb5685,4,8,7,15,6,2007-10-17 06:54:57,2007-10-17 01:55:49
4049b9cfc082affc6365539138f6f5c546bb5685...c85228ed8f31eb739e19cf8abcff84fad44c1258,1,4,0,4,1,2007-10-17 06:54:57,2007-10-17 01:55:50
c85228ed8f31eb739e19cf8abcff84fad44c1258...9c60a966f2c3784cdff31aa6ad9f2086df64d5ba,1,1,1,2,1,2007-10-19 03:34:09,2007-10-19 00:42:20
9c60a966f2c3784cdff31aa6ad9f2086df64d5ba...b5d72f0a4cd3cce945ca0d37e4fa0ebbfcdcdb52,1,11,4,15,6,2007-10-19 04:28:44,2007-10-19 04:08:37
b5d72f0a4cd3cce945ca0d37e4fa0ebbfcdcdb52...0e30404370c24047c5fa54b2a6c43e53629c916b,1,0,3,3,1,2007-10-19 05:01:40,2007-10-19 05:01:40
0e30404370c24047c5fa54b2a6c43e53629c916b...0e549137966feb016927a827fb6e359aec8264a3,1,3,2,5,2,2007-10-30 23:08:40,2007-10-30 18:57:31
0e549137966feb016927a827fb6e359aec8264a3...dc6a0757c4f966dd124bd85be2adad5a0b7b2167,7,57,45,102,35,2007-10-30 23:08:40,2007-10-30 18:57:32
dc6a0757c4f966dd124bd85be2adad5a0b7b2167...4d4fcc5451d9d653bebcc8afa18543cb426abeed,5,20,38,58,19,2007-10-30 23:08:40,2007-10-30 18:57:33
4d4fcc5451d9d653bebcc8afa18543cb426abeed...cf84d51c43fa05cce416bfa3f5db3ad70773abdf,2,77,4,81,10,2007-10-30 23:08:40,2007-10-30 18:57:34
cf84d51c43fa05cce416bfa3f5db3ad70773abdf...29e63ed3f6962cd96f7153e9f492f36797d25c33,1,5,1,6,2,2007-10-30 23:08:40,2007-10-30 18:57:35
29e63ed3f6962cd96f7153e9f492f36797d25c33...74b6792f7b2d4b410459cf96977a2007ddea8675,1,10,0,10,1,2007-10-30 23:08:40,2007-10-30 19:41:13
74b6792f7b2d4b410459cf96977a2007ddea8675...2a128d63dc140e8daeaf68659d9263b7389b7d1b,3,13,1,14,8,2007-10-30 23:08:40,2007-10-30 21:06:21
2a128d63dc140e8daeaf68659d9263b7389b7d1b...93ff3f6a5311ebb6347b817d1c57c94dbbe4de73,1,1,2,3,2,2007-11-01 22:22:32,2007-11-01 20:59:55
93ff3f6a5311ebb6347b817d1c57c94dbbe4de73...3e935d19822db08cc0dedd8764135771ffd6ec7b,1,3,0,3,1,2007-11-01 22:22:32,2007-11-01 20:59:56
3e935d19822db08cc0dedd8764135771ffd6ec7b...81f6654a47075a345ba63a394921f77fc87b6500,1,26,3,29,5,2007-11-01 22:22:32,2007-11-01 20:59:57
207f1a75e7e4d14286aeed107af7c56dc811797b...552cecc21447efe9d5f9a86d55b5e428d56a0c53,3,90,0,90,7,2007-10-17 06:54:51,2007-10-17 01:50:45
552cecc21447efe9d5f9a86d55b5e428d56a0c53...cb97cc9fef60ea2ff1ce51cf575314c04488dbfd,1,1,1,2,1,2008-01-05 01:22:24,2008-01-05 01:11:37
d90a7fda355c251b8ffdd79617fb083c18245ec2...c2e6b6d0d1e97c5bc2db24388e247bef62faf917,1,1,0,1,1,2007-10-26 22:28:09,2007-10-26 07:59:12
c2e6b6d0d1e97c5bc2db24388e247bef62faf917...4a21d13db4acb112bf210ab6febeed3269b28483,1,1,1,2,1,2007-10-27 06:16:51,2007-10-26 10:48:41
d90a7fda355c251b8ffdd79617fb083c18245ec2...55db1df0c86b0fded61731647a8f1cd6e7dc9b04,1,45,17,62,10,2007-10-25 05:44:14,2007-10-24 20:03:38
55db1df0c86b0fded61731647a8f1cd6e7dc9b04...1ece127467c1d65062f17777b1eedcd84fd9ea69,1,4,1,5,3,2007-10-25 05:44:14,2007-10-24 20:03:39
8ae674952c8f301034e8ae9dceff38dda740623b...806ea701ce3624aa6a89648b6ca5d858703398cb,3,60,2,62,3,2007-09-19 10:11:28,2007-09-19 10:11:28
5166810b1e16b22e342f2181a3535e70c6e7a119...44b2476a1278c87d6985993b5e6fd45f1e5f08f2,2,31,7,38,10,2007-09-26 20:27:45,2007-09-26 00:27:54
5166810b1e16b22e342f2181a3535e70c6e7a119...55246aac6717e86c14f31391ac903ed810d1a9a0,6,11,16,27,15,2007-09-26 07:40:47,2007-09-25 14:38:46
5166810b1e16b22e342f2181a3535e70c6e7a119...a5a3878ba7a0da5ee4331f6064d6b50aadbb10ff,3,11,4,15,6,2007-09-26 07:40:32,2007-09-25 19:29:42
039bc64e886716593d59910694a6c8ed5b72c515...549799b4a1741fe765fff2c91808b4524ea2d7fb,2,0,15,15,2,2007-11-16 05:16:51,2007-11-15 16:33:44
549799b4a1741fe765fff2c91808b4524ea2d7fb...a777e9ca54b5801266486a16dc0d25c82b38014d,4,0,6,6,4,2007-11-16 05:23:47,2007-11-15 22:19:11
a777e9ca54b5801266486a16dc0d25c82b38014d...8e7b07c8a776c401ff5c4adb593f423a754d198c,3,13,6,19,5,2007-11-16 06:24:10,2007-11-15 07:04:30
8e7b07c8a776c401ff5c4adb593f423a754d198c...c1a95fa629b837fd291ca0e1428604710a2bc1dd,3,25,1,26,6,2007-11-16 06:44:17,2007-11-15 13:19:29
c1a95fa629b837fd291ca0e1428604710a2bc1dd...41a7aa588f449d3b139480b102f510abc5ef7f85,2,28,2,30,6,2007-11-16 09:16:22,2007-11-16 09:15:41
039bc64e886716593d59910694a6c8ed5b72c515...63405283c3c6c55cca465ba21128ec1b354ee799,1,18,16,34,10,2007-11-14 23:18:39,2007-11-13 20:04:56
63405283c3c6c55cca465ba21128ec1b354ee799...41ec097aea91b4be038b1c4bbbe1bcb9d4e7aa53,1,4,2,6,2,2007-11-14 23:18:39,2007-11-13 20:04:57
41ec097aea91b4be038b1c4bbbe1bcb9d4e7aa53...8ed2fca458d085f12c3c6808ef4ddab6aa40ef14,1,23,2,25,9,2007-11-14 23:18:39,2007-11-13 20:04:58
8ed2fca458d085f12c3c6808ef4ddab6aa40ef14...25482a3c0cc127fc5065552fe09e4709f32a2701,1,7,0,7,1,2007-11-14 23:18:39,2007-11-13 20:04:59
25482a3c0cc127fc5065552fe09e4709f32a2701...85dadc389468211a2fc0006ce8ea524490d417f5,1,4,4,8,4,2007-11-14 23:18:39,2007-11-13 20:05:00
85dadc389468211a2fc0006ce8ea524490d417f5...80bbe72b76ab91628b493b55ed74f6eec8432fed,3,2,3,5,3,2007-11-14 23:18:39,2007-11-13 20:05:01
80bbe72b76ab91628b493b55ed74f6eec8432fed...2488df84a28b5eaae5495a59e390b51874d60a03,1,1,1,2,1,2007-11-14 23:18:39,2007-11-13 20:05:02
2488df84a28b5eaae5495a59e390b51874d60a03...4723ee992cba052dc735b7d2b6f43aad26d9150a,2,11,7,18,9,2007-11-14 23:18:39,2007-11-13 20:05:03
4723ee992cba052dc735b7d2b6f43aad26d9150a...a47d181380e70cba4e6f641e9485d202a0735c5a,1,13,3,16,3,2007-11-14 23:18:39,2007-11-13 20:05:04
a47d181380e70cba4e6f641e9485d202a0735c5a...506b17b136ba8ee29098c2ee26b94f527cea9ebc,4,14,5,19,7,2007-11-14 23:18:39,2007-11-13 20:05:05
506b17b136ba8ee29098c2ee26b94f527cea9ebc...7f0e39faa2929541f61039be96d3f40f74207585,1,12,1,13,2,2007-11-14 23:18:39,2007-11-13 20:05:06
7f0e39faa2929541f61039be96d3f40f74207585...5f9ffff308845e2439670ec3cb2c12f4865cf430,1,2,7,9,7,2007-11-16 05:18:07,2007-11-15 17:24:17
5f9ffff308845e2439670ec3cb2c12f4865cf430...1f759eeede0597580be8ce26305550350e3c017a,1,16,26,42,7,2007-11-18 04:27:29,2007-11-17 22:09:28
8256c6e0107a51b2714f2e068b693025e4ddcae8...ca8c8c56860e93de4fc3acc9d66b2269a9ccc2f1,1,1,1,2,1,2007-12-02 07:38:35,2007-12-02 07:38:35
ca8c8c56860e93de4fc3acc9d66b2269a9ccc2f1...79d30668ab5c5e029c89c8aa2e466d2320658f5a,5,141,163,304,12,2007-12-02 07:48:28,2007-12-02 07:39:19
79d30668ab5c5e029c89c8aa2e466d2320658f5a...1c46ab1fada6eb449336a624995293cdd74f2b08,1,98,86,184,46,2007-12-02 07:49:44,2007-12-02 07:45:31
55bad4f096b1f18eec94169c864c39bf0abda1db...3849bfba84fb5b0e9d46920f62105b4e1dd97e63,3,18,9,27,8,2007-09-17 03:12:19,2007-09-17 03:12:19
4baba57f8d7bfee85ca1e521e1f6069923504799...c8c4854bec30b03b8e3a56a9b5e52ff358210140,8,43,43,86,42,2007-09-14 00:43:26,2007-09-13 13:19:05
c8c4854bec30b03b8e3a56a9b5e52ff358210140...bba060462c8732a5cb46ea00165198a9579517ae,1,1,3,4,1,2007-09-14 00:52:47,2007-09-14 00:52:34
bba060462c8732a5cb46ea00165198a9579517ae...31bb1d1b2d1e893836b0d2b091fed9e39ee84853,9,34,30,64,31,2007-09-14 05:51:18,2007-09-14 05:50:09
6acef043581d69597860f3343ec2691c72b0803c...83456b13528c47be1ee08924f31cca565b92342f,1,52,52,104,33,2011-04-01 22:06:54,2011-04-01 09:27:40
83456b13528c47be1ee08924f31cca565b92342f...61e508d9738a0f5f9daa1553e71a412c43ecc0f4,1,51,35,86,25,2011-04-01 22:08:32,2011-04-01 09:27:41
61e508d9738a0f5f9daa1553e71a412c43ecc0f4...b62c76973091481ffaebbeb8fd6c1c542c760a2b,1,35,35,70,29,2011-04-04 23:43:57,2011-04-04 15:27:05
6acef043581d69597860f3343ec2691c72b0803c...55f9d7a75c90ca98f7d7be32e9bdca5a789d1257,3,42,2,44,6,2011-04-01 19:53:18,2011-04-01 10:26:00
9fb1e6984201892b6dfb7e1a9195e2544a5af754...5937b792f057c9e678a7914bf477ff8909033ea1,1,1,0,1,1,2011-05-27 20:58:31,2011-05-05 01:50:45
099024861021830f9d4c7db4c64c844bf9d5ebd9...3eafdc961fa6c44d40382be6a55b62b7e6edb248,2,24,2,26,3,2011-05-26 18:38:18,2011-05-26 15:11:00
806e0aba2e5d976233703e6ff517af10329e4048...2352570bf43368f3d3931f7b24bb7fd44e68eef3,1,1,1,2,1,2011-03-31 02:33:41,2011-03-31 02:33:33
806e0aba2e5d976233703e6ff517af10329e4048...313ee0d69f58c2bf2f4e0a62b812c9d08a39b240,3,83,9,92,9,2011-03-31 00:34:08,2011-03-30 05:20:02
41b9dd9d4f2f32f8450af59c30f3a7a2fc5a8cc7...e7d04ee147dcbe6af1fa1d2147466696e2be31bc,2,37,14,51,8,2011-03-26 05:15:10,2011-03-26 05:15:10
e7d04ee147dcbe6af1fa1d2147466696e2be31bc...7e2fe3a9fc816391b322ad9b3f2adf9342631db6,5,17,48,65,23,2011-03-26 05:17:35,2011-03-25 04:09:19
7e2fe3a9fc816391b322ad9b3f2adf9342631db6...4c3169b03ec567ac43edcfc08ffdab119e0ebe94,1,10,10,20,6,2011-03-26 05:41:38,2011-03-25 04:10:00
4c3169b03ec567ac43edcfc08ffdab119e0ebe94...195b7ca6f229455da61f9f6b6e56a6558fb0e8ee,6,94,13,107,11,2011-03-26 05:49:37,2011-03-26 05:49:37
fa6c4bceabdb7bc4bf8946c4887f08e9765f5ff6...030879718f696b67fe1c958ab0a238971773ac96,5,62,62,124,46,2011-03-22 23:32:58,2010-12-13 05:41:12
030879718f696b67fe1c958ab0a238971773ac96...28c5d9ed2a2bc562bc8c50092f52f58b3aa08039,7,4,224,228,10,2011-03-22 23:32:58,2010-12-13 10:17:36
28c5d9ed2a2bc562bc8c50092f52f58b3aa08039...5db348dbd51cdeac711521d1fa7258785e72d202,7,2,445,447,9,2011-03-22 23:34:44,2010-12-13 10:23:17
5db348dbd51cdeac711521d1fa7258785e72d202...cba3546a43c64e2078664dbb6469aadf6bc473d3,5,1,260,261,7,2011-03-22 23:39:53,2010-12-13 10:26:43
26e5c5d09334d157bd04f794f16f6e338d50c752...682853e687ff0106bea25bdb5e9d60d9657cecb3,1,22,7,29,7,2012-06-01 19:38:19,2012-06-01 19:38:19
a8bd582d3079e506c525fe1b735d6ea405576bff...c4649188e9140c960cec54798b153382fb4d6191,1,6,0,6,1,2012-05-25 00:37:29,2012-05-25 00:37:29
d81c7d1f84bed577c96aafc75700cf164152ad55...933297211e88b80d2a26d89c359158eb7c37ca9d,1,246,226,472,215,2012-05-14 22:43:03,2012-05-14 22:43:03
4b580061b350ae9d27ab7c3936a45828a33624c6...ac2b0e8fb77d02f480af3f45a44cb9ea611008a4,2,75,28,103,8,2012-05-30 00:14:41,2012-05-30 00:14:41
b240ea25a97d1b96acc4d0f5ae0dbcbe9e0af860...df3ef6fb98a276fa62bbcf129d40307b00253588,1,96,83,179,83,2012-04-28 12:35:24,2012-04-28 12:35:24
df3ef6fb98a276fa62bbcf129d40307b00253588...73a60cd252a417a14092791ad0ff33aa6f62f616,1,100,84,184,84,2012-04-28 14:53:41,2012-04-28 14:42:41
00855b656bf883c607a4adcd5bc7a76711e4b3a3...e71f6a53e269ffc9c8acd4d4eb563ea230f3e8de,1,20,0,20,1,2012-05-11 21:21:38,2012-05-11 06:25:16
e71f6a53e269ffc9c8acd4d4eb563ea230f3e8de...05a3cec501e2a602ddb4333eec1e70219f0a8f53,1,1,1,2,1,2012-05-11 21:21:38,2012-05-11 06:25:17
05a3cec501e2a602ddb4333eec1e70219f0a8f53...06dcd152a81ccff5464c34ed95306196763c9e65,1,2,2,4,2,2012-05-11 21:21:39,2012-05-11 06:25:18
0e2d57fd50f61e668be3180bc8f25991ea88aa8c...f25950f3475e263ed6c8f0797bb058ba6444f85e,7,99,12,111,15,2012-03-20 04:42:06,2012-03-20 04:31:33
911011aacc78dfa8ac81a5e631cb86bb69fd66e1...94b410bba864fed964ef2177278432c89d402adc,1,110,25,135,41,2013-07-12 19:53:02,2013-07-12 19:21:21
94b410bba864fed964ef2177278432c89d402adc...f4f49e2258a250507baaa2c977a9fd7993ac07ad,1,35,7,42,21,2013-07-15 14:41:53,2013-07-14 10:14:59
f4f49e2258a250507baaa2c977a9fd7993ac07ad...c07a6bc57255a2d00b41333f570b64cc36c70cfb,1,7,3,10,5,2013-07-18 01:11:27,2013-07-17 20:16:31
911011aacc78dfa8ac81a5e631cb86bb69fd66e1...dacd2bcc414e0b7aac36aaa400da0a743c4741cc,1,7,5,12,1,2013-07-12 19:03:28,2013-07-12 05:37:42
f1f1b96e99fa064ed9f0da263d4b4eb0407b3ceb...d46f476cb26f647e4571b5ccfba516d30ee06c63,1,1,1,2,1,2012-02-23 20:48:26,2012-02-23 19:24:44
6b097788f88a29d6e171af7a9e87117cf992e833...b4cf0f1784362fb4aa2383d8d5d829caa92ca3a0,1,3,1,4,2,2010-07-06 06:27:41,2010-07-06 03:11:17
7610fa57e63b0acc0a66717fc2d85755634db591...635a7bb1d807390bedfc1147d2052e8423bcd1e0,4,26,31,57,5,2010-08-26 16:05:02,2010-08-26 05:47:58
635a7bb1d807390bedfc1147d2052e8423bcd1e0...712516bcacacd45b4825ec649f15c3573f6fb42a,7,104,66,170,34,2010-08-26 16:18:51,2010-08-26 05:49:53
712516bcacacd45b4825ec649f15c3573f6fb42a...58a1ece478c6038a7eb0b6e494d563bd5e6d5978,6,14,0,14,7,2010-08-26 16:20:03,2010-08-26 05:50:45
58a1ece478c6038a7eb0b6e494d563bd5e6d5978...4e5dd044c62f2a82de083e7cd46cad7b0d3465ae,3,207,0,207,3,2010-08-27 17:08:50,2010-08-26 05:51:47
2141c474d0dd7cddf224780644e64bc7fa493f07...bc8d6b9b904350c72017a3c92fdacbfba5b1be3f,1,1,24,25,1,2013-11-07 18:28:26,2013-11-07 14:33:43
bc8d6b9b904350c72017a3c92fdacbfba5b1be3f...6a364ced497e407ab3ffb2554d4ef2c78f801832,6,1117,0,1117,8,2013-11-18 21:03:51,2013-11-14 19:17:54
d5b66299040969706dd675c021f4336a26a6cc82...0f64bfa9567f697d6152ef9ea937d4b573029a08,6,88,10,98,13,2011-08-11 20:04:16,2011-08-01 21:19:58
d5b66299040969706dd675c021f4336a26a6cc82...c98d1e4148ec32cac3318ca96dd262d27b9f8a03,1,1,1,2,1,2011-08-01 23:05:44,2011-07-29 07:19:26
d5b66299040969706dd675c021f4336a26a6cc82...402e8a6d9af392536c10f749275588ded78bca31,1,26,12,38,13,2011-08-01 22:34:22,2011-08-01 20:49:21
d5b66299040969706dd675c021f4336a26a6cc82...bf01d4a334c621abdc76a5bdeac252296d9b23cb,1,1,2,3,1,2011-08-01 17:52:34,2011-08-01 11:20:42
d5b66299040969706dd675c021f4336a26a6cc82...e08afecd7fe04b519b72f136c4a24b151c748f49,1,1,1,2,1,2011-08-01 17:47:36,2011-08-01 11:16:09
514a529d253d263672e5a855775382608f7fdfc1...78f4c9f62549fdd9a52550449c4e3148e7e0900d,2,3,2,5,3,2012-02-23 01:48:01,2012-02-23 01:48:01
514a529d253d263672e5a855775382608f7fdfc1...f1c6ffe684464e7f8765030b226be108cb9c2d53,1,9,3,12,5,2012-02-22 21:59:55,2012-02-22 08:58:10
f1c6ffe684464e7f8765030b226be108cb9c2d53...6e8c755fd3fd2efab0e2dcdc16c8a17a61efa760,1,10,12,22,9,2012-02-22 21:59:58,2012-02-22 08:58:11
b8b52907e386d064fb0303c08215d7b117d50ee9...4a92a1721483d6a109cf0993843b20159f8d3387,1,11,34,45,4,2012-03-05 07:38:02,2012-03-05 07:38:02
4a92a1721483d6a109cf0993843b20159f8d3387...a8747a1098324c418d2d1de2b563f8e3155dc32f,1,1,1,2,1,2012-03-05 19:32:19,2012-03-05 19:32:08
ac1a1f9927b01df6c50a1e29d92c6e79e2daadff...a8ebdb90f9e7017aa47c7824c91dfb0dd231ac85,1,17,2,19,2,2006-10-27 01:53:18,2006-10-26 21:32:41
a8ebdb90f9e7017aa47c7824c91dfb0dd231ac85...e2b1d1ccdd2ef4db41819bb0d242b808cfe6c422,1,5,0,5,2,2006-10-27 09:10:41,2006-10-27 04:59:18
e2b1d1ccdd2ef4db41819bb0d242b808cfe6c422...f8a5da6d94baa0a90e7b383932911661bb551e1c,2,14,0,14,2,2006-10-27 09:10:52,2006-10-27 05:00:57
f8a5da6d94baa0a90e7b383932911661bb551e1c...d6b7e0b98f8d0f84e3b2614b33b52402fefb5735,1,1,1,2,1,2006-10-27 09:12:56,2006-10-26 10:26:44
d5f6a01af0658bc0ec5f068d81ba321be94526d5...7a8ac59f2f1fdac71fdffe53eebdca382118585f,1,5,1,6,1,2006-10-26 09:05:05,2006-10-26 09:05:05
7a8ac59f2f1fdac71fdffe53eebdca382118585f...44152787bcb4fd003d1f5b8c2a7591445cee8f20,1,3,3,6,3,2006-10-26 09:05:59,2006-10-26 09:05:59
69945602f95710f16ab4a5f8edfee38dc65555fa...aa9098611fb53e4e9d33757102f96145946811f4,1,1,1,2,1,2006-11-22 00:57:55,2006-11-21 22:19:28
aa9098611fb53e4e9d33757102f96145946811f4...594270635732d6320d6e6d7fa127679ae90ef5b1,1,1,1,2,1,2006-11-22 03:01:29,2006-11-20 20:29:41
69945602f95710f16ab4a5f8edfee38dc65555fa...04408c3578300ac7cc1b1530bbaec54de299b200,1,2,1,3,1,2006-11-21 22:35:40,2006-11-18 22:35:38
04408c3578300ac7cc1b1530bbaec54de299b200...6d55f05576851aedc7c53f7438c1d505c22ee78f,1,136,99,235,16,2006-11-21 22:35:40,2006-11-18 22:35:39
6d55f05576851aedc7c53f7438c1d505c22ee78f...9954f772eb73593d9e660e3b2c3f90341b03a087,1,2,0,2,2,2006-11-21 22:35:40,2006-11-18 22:35:41
9954f772eb73593d9e660e3b2c3f90341b03a087...59e3b14e08bf309baa692bf251b2cedcde131308,2,35,1,36,10,2006-11-21 22:35:40,2006-11-18 22:35:40
59e3b14e08bf309baa692bf251b2cedcde131308...bd5d1e42fb8edffa4e35d1257f648d586b2d054c,1,2,1,3,1,2006-11-21 22:35:41,2006-11-19 14:05:21
bd5d1e42fb8edffa4e35d1257f648d586b2d054c...af6feeb229110a0fa77a179c2655fca08e72f879,1,210,45,255,24,2006-11-21 22:35:41,2006-11-19 14:05:22
af6feeb229110a0fa77a179c2655fca08e72f879...897d1d2e2a36d433c49d6246cd38133a540adddc,1,21,21,42,9,2006-11-21 22:35:41,2006-11-19 21:51:39
ee6002aa429272871733b8fbc99a9e6df3e150f5...ed9f7c954c26ec6d517bdca3d8e4b895278d1b2b,2,62,10,72,8,2006-12-18 01:57:19,2006-12-18 01:57:19
ed9f7c954c26ec6d517bdca3d8e4b895278d1b2b...26cdd1e7c7a21b6d71ebc201fc2472a6a68f5ce4,1,17,0,17,1,2006-12-18 02:26:53,2006-12-18 02:08:52
ee6002aa429272871733b8fbc99a9e6df3e150f5...7e3fe904ef9b1ce9cb9a3ddc03d85508bcc48df2,1,30,5,35,6,2006-12-17 18:35:53,2006-12-14 23:58:56
ee6002aa429272871733b8fbc99a9e6df3e150f5...577ed5c20b4ca374626c104f90c88550cf415067,4,21,6,27,9,2006-12-17 18:35:28,2006-10-23 00:32:47
577ed5c20b4ca374626c104f90c88550cf415067...74bd9029732db28b2fff50de0a190229c6033e02,4,28,10,38,7,2006-12-17 18:35:28,2006-12-16 23:31:25
74bd9029732db28b2fff50de0a190229c6033e02...5761231975ceffa531d86d9bab0f9a9a370674f6,2,11,3,14,5,2006-12-17 18:35:28,2006-12-17 00:07:20
5761231975ceffa531d86d9bab0f9a9a370674f6...8dce82356221df894a1b0dd5a4189ad3169a5069,2,3,11,14,5,2006-12-19 10:28:16,2006-12-19 10:28:16
6934dec89538e054823aadcce08af040bc8dcf79...7948d7744dfc19d25b6cde1091460fa68733c3d7,1,1,1,2,2,2006-12-26 20:14:39,2006-12-26 20:14:18
7948d7744dfc19d25b6cde1091460fa68733c3d7...59f3e254801648322b2d5cd073ca0cc5009aa2de,1,4,0,4,1,2006-12-26 20:25:34,2006-12-21 09:24:17
59f3e254801648322b2d5cd073ca0cc5009aa2de...39ed7c181b7a8f5e28cffcaca9369e6ebc74a055,1,127,131,258,16,2006-12-27 00:45:19,2006-12-27 00:27:37
39ed7c181b7a8f5e28cffcaca9369e6ebc74a055...c3a41037ed5fa113c8eb0f67a1cc17654f7ce5b1,1,3,3,6,3,2006-12-27 00:45:22,2006-12-27 00:27:38
c3a41037ed5fa113c8eb0f67a1cc17654f7ce5b1...268b827d9883e77f395a63e4afa10ebbac10bfcf,1,48,41,89,27,2006-12-27 07:47:33,2006-12-27 06:42:33
6934dec89538e054823aadcce08af040bc8dcf79...b45974a655e0e41441e5db64c091000171435096,3,69,30,99,6,2006-12-26 08:22:39,2006-12-24 07:36:55
b45974a655e0e41441e5db64c091000171435096...4b2bced55948422198dad92dcbf4b5b98913f1e7,1,9,2,11,4,2006-12-26 08:22:39,2006-12-24 07:53:02
4b2bced55948422198dad92dcbf4b5b98913f1e7...52883fbd767f8a79a6f98a08907d0a9f6ba1ece1,3,76,5,81,8,2006-12-26 08:52:13,2006-12-25 19:48:35
52883fbd767f8a79a6f98a08907d0a9f6ba1ece1...d2c11a38c476bdfa3dd2387a0d933b8c00e4dfe3,15,160,23,183,24,2006-12-28 00:41:33,2006-12-28 00:41:33
d2c11a38c476bdfa3dd2387a0d933b8c00e4dfe3...46e35a6cb9914ebb839249ecf2154c48b044c5cd,2,5,5,10,5,2006-12-28 01:38:02,2006-12-28 01:38:02
46e35a6cb9914ebb839249ecf2154c48b044c5cd...7255ff0446217ad723dad6088504a18f6afb15db,1,11,0,11,1,2006-12-29 01:36:35,2006-12-29 01:36:35
fa39b6b5b11f9b580c515a7b4a8e4eb8eaa79b75...2295e8d0c4cec41fbe257ddb957516a7c1a139df,1,3,0,3,1,2006-12-22 07:49:13,2006-12-22 07:49:13
2295e8d0c4cec41fbe257ddb957516a7c1a139df...228e2eb67e9f15983519f472cc1566a3dd857f9c,2,2,1,3,2,2006-12-22 23:21:55,2006-12-22 23:21:55
228e2eb67e9f15983519f472cc1566a3dd857f9c...fb8696d9d82e78fe829fdd95ff9ff10fdfa52ef9,1,0,7,7,1,2006-12-22 23:25:21,2006-12-22 23:25:21
fb8696d9d82e78fe829fdd95ff9ff10fdfa52ef9...ea560e6d64374ec1f6c163c276319a3da21a1345,1,7,27,34,6,2006-12-22 23:37:48,2006-12-22 23:37:48
ea560e6d64374ec1f6c163c276319a3da21a1345...95ca1c6cb76ae01528f70c5ed437a79887a60775,1,1,1,2,1,2006-12-23 06:46:11,2006-12-23 06:46:11
95ca1c6cb76ae01528f70c5ed437a79887a60775...a6782bc572530be6f7d799f18d3e79dd6a406294,1,0,2,2,2,2006-12-23 06:48:46,2006-12-23 06:48:46
a6782bc572530be6f7d799f18d3e79dd6a406294...40f656cd0214355df4c29aea315bfc2e9d983516,2,0,9,9,3,2006-12-23 07:13:28,2006-12-23 06:18:03
40f656cd0214355df4c29aea315bfc2e9d983516...4de0f9f9b6ed1731de00b67952504e5a783f54a4,1,3,2,5,1,2006-12-23 07:14:43,2006-12-22 13:56:15
4de0f9f9b6ed1731de00b67952504e5a783f54a4...4b1552238ec3b8b711f60b2b65265a751a40f5ff,1,1,1,2,1,2006-12-23 07:14:58,2006-12-23 05:59:24
4b1552238ec3b8b711f60b2b65265a751a40f5ff...c321f00d09f56dcf2f149757a2a337f3732f3097,1,4,2,6,1,2006-12-23 07:17:20,2006-12-22 13:56:25
c321f00d09f56dcf2f149757a2a337f3732f3097...f49006b0c79bb74bc500a9a3a883e929fa0f803e,2,32,18,50,11,2006-12-23 07:18:07,2006-12-22 13:58:39
f49006b0c79bb74bc500a9a3a883e929fa0f803e...aaca9675a494fb42e7caa182ecb89c1951cafefa,1,1,0,1,1,2006-12-23 07:18:13,2006-12-22 19:38:12
aaca9675a494fb42e7caa182ecb89c1951cafefa...0ff5ec70c7d4fb5f176da5e05897c316fda82584,1,2,1,3,2,2006-12-23 07:18:15,2006-12-22 19:38:13
0ff5ec70c7d4fb5f176da5e05897c316fda82584...3fcf06be5d02de15992d11482cfae82dc058261b,1,3,1,4,2,2006-12-23 07:18:16,2006-12-22 19:38:14
3fcf06be5d02de15992d11482cfae82dc058261b...a979d1289be6a3999d7e89bf0359ebf28075fc6b,1,3,3,6,3,2006-12-23 07:18:18,2006-12-22 19:38:15
a979d1289be6a3999d7e89bf0359ebf28075fc6b...0a5761746ca046d546da6afc2b0079706a6629e0,1,5,2,7,1,2006-12-23 07:18:36,2006-12-22 20:06:54
0a5761746ca046d546da6afc2b0079706a6629e0...8e574fb542eaf7f41d5416b2cf65b5c2e93829d6,1,10,10,20,3,2006-12-23 07:18:40,2006-12-23 03:35:14
8e574fb542eaf7f41d5416b2cf65b5c2e93829d6...9d032c725034e7c072f8c1a3e11855594c2fc0af,1,3,0,3,1,2006-12-23 07:18:41,2006-12-23 03:35:15
9d032c725034e7c072f8c1a3e11855594c2fc0af...6be935115b4a3bfa9062875a569d4a018ac372e2,1,13,0,13,3,2006-12-23 07:18:42,2006-12-23 03:35:16
fa39b6b5b11f9b580c515a7b4a8e4eb8eaa79b75...7cab5883ffd643916d0322a1d3360a79ccf6f653,3,22,18,40,5,2006-12-22 07:10:14,2006-12-20 16:37:07
7cab5883ffd643916d0322a1d3360a79ccf6f653...ad8e72cba8e8dee8fccf11d98f197a44b5e3c10a,1,154,0,154,1,2006-12-22 07:10:14,2006-12-21 09:21:28
ad8e72cba8e8dee8fccf11d98f197a44b5e3c10a...658f3650273abd6888c964b9fb1291c603306df8,4,409,1,410,5,2006-12-22 07:10:14,2006-12-20 16:39:41
e8b4029f990907e24fac0e7772ee19ee6dd55c1c...ae72f685418b79bbd67e1017c5b1ac7d731c042e,2,5,2,7,4,2006-12-27 09:05:00,2006-12-27 09:04:03
1c23d794bfa3b9f3e03b18bb7e542615a924dbe3...3cf167ba4bac1be5f52acae0a582d907121982b2,1,1,1,2,1,2007-01-10 05:16:45,2007-01-10 05:16:45
3cf167ba4bac1be5f52acae0a582d907121982b2...62c89c662fc6220522adc009aa95b1392350ed20,2,9,8,17,3,2007-01-10 05:20:39,2007-01-10 05:20:01
62c89c662fc6220522adc009aa95b1392350ed20...bb1091a47516f898b757f897b8b398c84343a4e1,4,21,18,39,7,2007-01-10 05:32:49,2007-01-10 05:31:36
bb1091a47516f898b757f897b8b398c84343a4e1...e05db0fd4f31dde7005f075a84f96b360d05984b,1,11,4,15,3,2007-01-10 06:43:58,2007-01-10 04:07:11
e05db0fd4f31dde7005f075a84f96b360d05984b...8c599c749f2f5aaf477db1327b97461f9fa3f62a,1,1,0,1,1,2007-01-10 16:26:50,2007-01-10 11:36:29
8c599c749f2f5aaf477db1327b97461f9fa3f62a...9a0eaf83eab5f53db0ba6a514c4d4cf16e846f30,4,6,3,9,7,2007-01-10 16:27:01,2007-01-10 11:36:36
9a0eaf83eab5f53db0ba6a514c4d4cf16e846f30...1b510aa442d992b9983282abfad5743ac0e9be54,1,2,0,2,1,2007-01-10 16:31:29,2007-01-10 12:22:50
1b510aa442d992b9983282abfad5743ac0e9be54...c2cb959fe7c7e5736cead7edf2b69be7e072a543,1,1,0,1,1,2007-01-10 21:38:03,2007-01-10 17:56:41
c2cb959fe7c7e5736cead7edf2b69be7e072a543...374c59056a0719fe1244280cdb6fdce48672f441,1,10,0,10,2,2007-01-10 21:39:16,2007-01-10 21:36:39
374c59056a0719fe1244280cdb6fdce48672f441...6fc301bbf68decbda369402a11ef215391bdd533,1,9,3,12,4,2007-01-10 21:56:02,2007-01-10 20:24:54
1c23d794bfa3b9f3e03b18bb7e542615a924dbe3...71dfbf224ff980f4085f75868dc409118418731e,4,8,8,16,10,2007-01-10 01:57:03,2007-01-09 08:50:02
71dfbf224ff980f4085f75868dc409118418731e...03840fc32d783be6750bf7e41a89687b8c3053eb,4,10,7,17,6,2007-01-10 01:57:03,2007-01-09 07:22:31
2a3a3c247e7f1f257e9c6762e48b98f08a30011a...2cdf9509df66358f83a577caf83dc06e3161ec3c,1,1,1,2,1,2007-01-11 20:25:16,2007-01-11 20:25:16
2cdf9509df66358f83a577caf83dc06e3161ec3c...d145144c3ba050a1a8c8296f337b77a18500af00,2,115,90,205,4,2007-01-11 20:58:10,2007-01-11 20:58:10
d145144c3ba050a1a8c8296f337b77a18500af00...f6aa66cb959393b6605a3288a3080d92d0983d78,1,6,7,13,2,2007-01-11 21:19:18,2007-01-11 21:04:11
f6aa66cb959393b6605a3288a3080d92d0983d78...d1b2ddc8638357987ff3a658fe233ffa5ff2acee,1,1,1,2,1,2007-01-11 21:19:31,2007-01-11 21:15:51
d1b2ddc8638357987ff3a658fe233ffa5ff2acee...93c1e07947e83f13fa8f1c89cb4897b5c71459ff,1,24,19,43,6,2007-01-11 21:19:31,2007-01-11 21:16:26
93c1e07947e83f13fa8f1c89cb4897b5c71459ff...9130ac1e1966adb9922e64f645730d0d45383495,2,3,1,4,2,2007-01-11 22:44:17,2007-01-11 22:09:31
9130ac1e1966adb9922e64f645730d0d45383495...3b97fee23df7ec78eea77151fcc0885ec3191950,2,10,0,10,5,2007-01-11 22:49:45,2007-01-11 21:43:40
3b97fee23df7ec78eea77151fcc0885ec3191950...646ac22bdf7f7011bb4c77647053416e892ce64d,1,5,1,6,2,2007-01-11 22:58:47,2007-01-11 22:58:47
646ac22bdf7f7011bb4c77647053416e892ce64d...4d229653ab5eda48f7b7c83cb2a876b48a41ffd4,1,16,3,19,4,2007-01-11 23:34:41,2007-01-11 23:34:41
2a3a3c247e7f1f257e9c6762e48b98f08a30011a...c82d7117a1f499b43e21e0a4589a080edadaf706,1,23,17,40,2,2007-01-10 23:57:44,2006-12-28 07:35:34
2a3a3c247e7f1f257e9c6762e48b98f08a30011a...f5184380f08c814535e7bda374e403596eef90a3,1,2,5,7,3,2007-01-10 22:45:20,2007-01-04 10:22:47
f5184380f08c814535e7bda374e403596eef90a3...8b944b5678efcbbbedfd555e5eef1500dc6074d1,1,46,123,169,31,2007-01-10 22:45:20,2007-01-10 19:20:58
38ebbacd93eb547b3608b64a2efc60fd79e1ea85...15261e3b33de3b49cc0a7d1b36b8685e02931ad7,2,2,2,4,2,2007-01-15 22:43:03,2007-01-15 22:43:03
15261e3b33de3b49cc0a7d1b36b8685e02931ad7...a0f4280f9e5decd384fe5cc9e30414b901aeb478,3,40,8,48,10,2007-01-15 23:35:07,2007-01-15 21:56:05
a0f4280f9e5decd384fe5cc9e30414b901aeb478...a74b1706c89c5e966c64316575e0b33dd21b8128,2,15,2,17,2,2007-01-15 23:37:22,2007-01-15 22:25:33
a74b1706c89c5e966c64316575e0b33dd21b8128...5ab9cc86ae7a3410d34d3d251877057103945513,3,3,1,4,3,2007-01-16 02:57:48,2007-01-16 01:31:49
5ab9cc86ae7a3410d34d3d251877057103945513...fb9522062c89da61f5ccbaa1d063e0754463176f,1,5,2,7,3,2007-01-16 06:22:24,2007-01-16 01:34:49
fb9522062c89da61f5ccbaa1d063e0754463176f...2aad957a519b354e248da8c76ee0d3997083dde6,6,7,7,14,7,2007-01-16 06:23:21,2007-01-16 01:31:29
2aad957a519b354e248da8c76ee0d3997083dde6...d9e74d5745127a5d483788c264fe0d4332868d67,1,6,1,7,1,2007-01-16 06:27:05,2007-01-16 01:30:59
d9e74d5745127a5d483788c264fe0d4332868d67...6f729591d1f9c52bd1cdd0601b4cc1afc028fbf9,1,22,15,37,16,2007-01-16 06:30:42,2007-01-16 04:15:55
6f729591d1f9c52bd1cdd0601b4cc1afc028fbf9...5214f7704474553d8d933d8055db410106d8581e,1,7,1,8,2,2007-01-16 19:33:38,2007-01-16 15:02:02
5214f7704474553d8d933d8055db410106d8581e...dc36f26525a5f94fbb1dddc3ae342e6bc638258c,1,13,1,14,2,2007-01-16 19:46:03,2007-01-16 19:46:03
dc36f26525a5f94fbb1dddc3ae342e6bc638258c...a9877f83e0da46efcbc552bd439acee2dcc499d0,2,5,9,14,4,2007-01-16 19:50:29,2007-01-16 19:50:29
a9877f83e0da46efcbc552bd439acee2dcc499d0...8bef62049b46038334ed6f065fdac27758070a5e,1,4,0,4,1,2007-01-16 21:43:50,2007-01-16 21:10:54
8bef62049b46038334ed6f065fdac27758070a5e...8b616f24ea5f18a13bd274f9dd9a1a42e6c4b223,1,13,13,26,11,2007-01-17 00:23:31,2007-01-17 00:09:12
8b616f24ea5f18a13bd274f9dd9a1a42e6c4b223...c1ff284a702c487e4a6f4966b69adff83cd5cf37,1,24,19,43,9,2007-01-17 00:23:58,2007-01-17 00:10:14
c1ff284a702c487e4a6f4966b69adff83cd5cf37...7905ba626e14c32d09a412c168931486ceedb6ec,1,0,5,5,1,2007-01-17 00:36:54,2007-01-17 00:36:54
7905ba626e14c32d09a412c168931486ceedb6ec...c1a4278ee3f99ca9db94bd032b047b3d19ac6e5f,2,36,10,46,8,2007-01-17 05:32:06,2007-01-17 04:46:39
c1a4278ee3f99ca9db94bd032b047b3d19ac6e5f...5ea5621f89f0fe7d9a13c862cc738eb3588b8ddd,1,6,1,7,1,2007-01-17 06:45:35,2007-01-17 06:45:35
5ea5621f89f0fe7d9a13c862cc738eb3588b8ddd...276bc2caab78a4493b35f8d582dd8eeff4866615,1,2,2,4,2,2007-01-17 06:46:57,2007-01-17 06:28:02
276bc2caab78a4493b35f8d582dd8eeff4866615...936f32d3de468db8daf853155ddd5c6b191af60c,1,6,0,6,1,2007-01-17 06:53:28,2007-01-17 06:53:28
936f32d3de468db8daf853155ddd5c6b191af60c...e30b217ba41081f5f11206ca3dfb987725315304,1,19,1,20,2,2007-01-17 09:07:27,2007-01-17 09:07:27
e30b217ba41081f5f11206ca3dfb987725315304...79d5b81fee8fa3213276b8c287a18c7ed2aefdb9,2,2,2,4,2,2007-01-17 09:08:30,2007-01-17 09:08:30
79d5b81fee8fa3213276b8c287a18c7ed2aefdb9...e54155750876ac81ff8be945903177e833f457a9,1,12,2,14,4,2007-01-17 09:09:41,2007-01-17 09:09:41
e54155750876ac81ff8be945903177e833f457a9...0f2ba25d54b143e08bdb7b24316c3dbad6fef558,1,1,1,2,1,2007-01-17 09:10:26,2007-01-17 09:10:13
0f2ba25d54b143e08bdb7b24316c3dbad6fef558...31fcd63c4a0c07f110c6adc600da2671bc566f36,1,9,0,9,1,2007-01-17 09:11:01,2007-01-17 09:11:01
31fcd63c4a0c07f110c6adc600da2671bc566f36...705517266794f94b7956f29ace0d7cc1caa89c39,1,1,1,2,1,2007-01-17 09:11:56,2007-01-17 09:11:56
705517266794f94b7956f29ace0d7cc1caa89c39...850844e28f728625ba96b7880a0a264a5578e4c6,1,45,8,53,1,2007-01-17 09:13:05,2007-01-17 09:13:05
850844e28f728625ba96b7880a0a264a5578e4c6...23bfbb815d7d71ff20c014f4610732597f0a75db,12,15,15,30,14,2007-01-17 16:44:32,2007-01-17 15:32:41
23bfbb815d7d71ff20c014f4610732597f0a75db...5e1a2e8c61b31410fd0c2e5a67c45bf6b373f4c3,2,58,2,60,3,2007-01-17 18:43:50,2007-01-17 18:43:50
5e1a2e8c61b31410fd0c2e5a67c45bf6b373f4c3...df59afe3eb121e89195e246105dd53de0ec396ab,2,5,4,9,4,2007-01-17 18:52:36,2007-01-17 18:52:36
df59afe3eb121e89195e246105dd53de0ec396ab...428ddc5de64684ad37d20c563544f17993a4d58d,2,20,0,20,3,2007-01-17 18:53:31,2007-01-17 18:53:31
428ddc5de64684ad37d20c563544f17993a4d58d...24a0fd02c9d0d0e415841a76e509d66785502c54,1,1,1,2,1,2007-01-17 18:54:18,2007-01-17 18:54:18
24a0fd02c9d0d0e415841a76e509d66785502c54...2aa73a8fa23d9f5b9048816f9884f65a2d24215a,1,9,0,9,1,2007-01-17 18:54:58,2007-01-17 18:54:58
2aa73a8fa23d9f5b9048816f9884f65a2d24215a...03eeaeaea57485e288dfecc37b120b074d6e92de,2,32,4,36,10,2007-01-17 20:03:26,2007-01-17 19:12:03
03eeaeaea57485e288dfecc37b120b074d6e92de...d7fb91c69dc347c53b0d9830b13fdadf217a78f1,1,5,1,6,1,2007-01-17 20:03:50,2007-01-17 19:13:02
d7fb91c69dc347c53b0d9830b13fdadf217a78f1...556b6600b25713054430b1dcaa731120eefbbd5b,4,618,582,1200,8,2007-01-17 20:03:50,2007-01-17 18:04:39
556b6600b25713054430b1dcaa731120eefbbd5b...475abf1b6386c7583d0c852767c8b1e439c1de37,1,2,0,2,1,2007-01-17 21:00:23,2007-01-17 21:00:23
475abf1b6386c7583d0c852767c8b1e439c1de37...5cb545fa22fa590617c872e47568279218788d4b,5,13,1,14,5,2007-01-17 21:03:29,2007-01-17 21:03:29
5cb545fa22fa590617c872e47568279218788d4b...42f62db90575601680739116c833ad0c76bcc85d,1,4,1,5,2,2007-01-17 21:04:15,2007-01-17 21:04:15
42f62db90575601680739116c833ad0c76bcc85d...de3820f5e486a9cb6debe414ef63f77d2ef83b62,1,4,2,6,2,2007-01-17 21:06:32,2007-01-17 21:06:32
de3820f5e486a9cb6debe414ef63f77d2ef83b62...ee53aff486d380986e549ea93a5d68e7b7607293,1,8,0,8,1,2007-01-18 04:45:15,2007-01-18 02:08:04
ee53aff486d380986e549ea93a5d68e7b7607293...41a5564e054043945e365c580abab724e12744ff,7,17,1,18,7,2007-01-18 04:45:41,2007-01-18 02:08:09
41a5564e054043945e365c580abab724e12744ff...df1b059d8dd5c16edaa98d7da842b2a32c01e526,2,42,3,45,4,2007-01-18 04:51:45,2007-01-18 01:43:57
df1b059d8dd5c16edaa98d7da842b2a32c01e526...7c496280104e02cb2a02dbbe0caf3510e0e87e42,2,10,2,12,2,2007-01-18 07:48:20,2007-01-17 21:35:13
7c496280104e02cb2a02dbbe0caf3510e0e87e42...c261e4385e826a4e7f9cf69618fa0b6e39defad2,7,13,1,14,13,2007-01-18 07:48:20,2007-01-17 21:51:44
c261e4385e826a4e7f9cf69618fa0b6e39defad2...e47f306d4bf964def1a0b29e8f7cea419471dffd,1,3,0,3,1,2007-01-18 07:48:20,2007-01-17 22:32:52
e47f306d4bf964def1a0b29e8f7cea419471dffd...917a8f891f1ceeb48609f99ba3b32e022ac766f9,3,9,10,19,7,2007-01-18 07:48:20,2007-01-17 23:03:39
917a8f891f1ceeb48609f99ba3b32e022ac766f9...bb7910319412aea9fecc3625dfcae23da84ee5f1,2,4,3,7,2,2007-01-18 22:11:50,2007-01-17 08:07:23
bb7910319412aea9fecc3625dfcae23da84ee5f1...b18b00a6612a8da12cb14c232a6ab4184cd262dd,3,7,7,14,7,2007-01-18 22:11:50,2007-01-18 07:17:28
b18b00a6612a8da12cb14c232a6ab4184cd262dd...4700951298ec75283c71e3daa9b18007adc195a2,1,12,12,24,4,2007-01-18 22:17:54,2007-01-18 10:18:51
4700951298ec75283c71e3daa9b18007adc195a2...a5cd09f993c0dd96f0c70fd1266f7c58b4f52446,1,1,1,2,1,2007-01-18 22:22:24,2007-01-18 11:15:13
a5cd09f993c0dd96f0c70fd1266f7c58b4f52446...cc75ad6762209ff6055c30b822bce22b105eb7d9,1,8,0,8,2,2007-01-18 22:29:42,2007-01-18 11:27:35
cc75ad6762209ff6055c30b822bce22b105eb7d9...bd67f09f6d635a4ad5281e7c3488d9b824891c36,1,1,1,2,1,2007-01-18 22:30:05,2007-01-18 16:11:13
bd67f09f6d635a4ad5281e7c3488d9b824891c36...377e81392f9c76b8d60499a42256efafc1992309,7,393,387,780,13,2007-01-18 23:03:13,2007-01-18 23:03:13
377e81392f9c76b8d60499a42256efafc1992309...c3f0baacadbd7b5710052213a2ec3cdd5b77bb6e,63,132,143,275,120,2007-01-18 23:53:37,2007-01-18 23:53:37
c3f0baacadbd7b5710052213a2ec3cdd5b77bb6e...72fe6a59890870ed9c3e9e1e6381fc0d7ba75fe4,9,196,379,575,11,2007-01-19 00:18:29,2007-01-19 00:02:13
72fe6a59890870ed9c3e9e1e6381fc0d7ba75fe4...2266bf27b354a08522406eff916898b6300ddfa0,1,4,3,7,4,2007-01-19 07:25:54,2007-01-19 07:25:54
2266bf27b354a08522406eff916898b6300ddfa0...cb48cb585f3bed37467565ed35889726568a442d,1,5,3,8,4,2007-01-19 08:41:37,2007-01-19 08:39:32
cb48cb585f3bed37467565ed35889726568a442d...be93fc088f3c6f78c3dd1b10544287129d066512,1,1,1,2,1,2007-01-19 19:33:27,2007-01-19 19:33:27
be93fc088f3c6f78c3dd1b10544287129d066512...89bf207758530fd151895680f7236ce626feea9c,3,86,48,134,29,2007-01-20 01:53:39,2007-01-19 06:32:38
89bf207758530fd151895680f7236ce626feea9c...18bd8821cace2f830e34574df6df30e072d0ed40,6,33,13,46,14,2007-01-20 01:54:32,2007-01-19 12:43:00
18bd8821cace2f830e34574df6df30e072d0ed40...060aafc11fb6140f1b33326f03e70dad5762a624,2,15,0,15,4,2007-01-20 01:54:33,2007-01-19 12:46:16
060aafc11fb6140f1b33326f03e70dad5762a624...d23842fd53e61f32c189a6ec902c4133abf29878,4,32,18,50,18,2007-01-20 01:54:33,2007-01-19 12:49:27
d23842fd53e61f32c189a6ec902c4133abf29878...6f71686e0bac2337cdaf9057893a16a47e7d1033,2,11,0,11,2,2007-01-20 01:55:14,2007-01-20 01:25:37
6f71686e0bac2337cdaf9057893a16a47e7d1033...e86eb6668ee0c574ba0b6c2c94564d4159a6fcc7,2,26,14,40,6,2007-01-20 01:57:53,2007-01-19 09:15:15
e86eb6668ee0c574ba0b6c2c94564d4159a6fcc7...16d7cc90dd6e68a170362ae6f0fbfbc504fd246b,4,52,13,65,10,2007-01-20 01:57:53,2007-01-19 09:19:05
16d7cc90dd6e68a170362ae6f0fbfbc504fd246b...76a44c5c0b25b1dbde56d17353d5b0821b7c6981,3,109,33,142,24,2007-01-20 01:57:53,2007-01-19 09:20:23
76a44c5c0b25b1dbde56d17353d5b0821b7c6981...b15af07928cf8aaf405407ec94fca4a9202edbc2,1,11,4,15,5,2007-01-20 06:51:49,2007-01-20 06:51:49
b15af07928cf8aaf405407ec94fca4a9202edbc2...da8f070cee6795594e4ac2af9f1e11cf9a7d3649,1,2,3,5,3,2007-01-21 02:57:47,2007-01-20 21:21:38
da8f070cee6795594e4ac2af9f1e11cf9a7d3649...16bfefeebcac375ff51652eb8b866b7b65cb4905,1,1,1,2,1,2007-01-21 03:02:03,2007-01-21 02:57:06
16bfefeebcac375ff51652eb8b866b7b65cb4905...cd554bb1733feb98ecee647176d0328cab53c2b7,1,1,1,2,1,2007-01-21 03:05:20,2007-01-21 01:17:19
cd554bb1733feb98ecee647176d0328cab53c2b7...06f6228a90c50618f0a9793c9e9695be15f93ae2,1,0,1,1,1,2007-01-21 03:10:26,2007-01-20 07:52:06
06f6228a90c50618f0a9793c9e9695be15f93ae2...68025633e352264898de44ec4856552d9a3abece,3,56,0,56,6,2007-01-21 03:10:26,2007-01-20 02:09:34
68025633e352264898de44ec4856552d9a3abece...453c1e857534f90b88367f96fc8ca1e7841f9400,2,19,10,29,4,2007-01-21 03:19:12,2007-01-20 18:47:41
453c1e857534f90b88367f96fc8ca1e7841f9400...11a6ddb2c8a81815ee9d5411638487ee99770a0b,1,1,1,2,1,2007-01-21 03:19:12,2007-01-20 18:51:37
11a6ddb2c8a81815ee9d5411638487ee99770a0b...bcf316187699c5e97bf47c1b8a00c844bf809fbc,1,6,2,8,1,2007-01-21 05:31:00,2007-01-21 03:11:29
bcf316187699c5e97bf47c1b8a00c844bf809fbc...8860fd42fcf5a7853f7d7c2198793183320293ff,6,263,1,264,10,2007-01-21 05:32:31,2007-01-11 10:47:48
8860fd42fcf5a7853f7d7c2198793183320293ff...db055e65d20b20f8f32eb85ee1a2417d3b95c1c7,1,3,0,3,1,2007-01-21 05:32:31,2007-01-20 02:28:19
db055e65d20b20f8f32eb85ee1a2417d3b95c1c7...911cedc95c2990b75f010d0d7bdbbc5911831708,1,15,0,15,1,2007-01-21 05:32:31,2007-01-20 07:21:32
911cedc95c2990b75f010d0d7bdbbc5911831708...53645a3a62977d5efd96ca9f3654985802212a9d,2,2,1,3,2,2007-01-21 05:32:31,2007-01-20 08:47:34
53645a3a62977d5efd96ca9f3654985802212a9d...4d12a471230625da73be464f5a20b7480a6b8ecb,4,28,14,42,6,2007-01-21 05:32:31,2007-01-20 08:51:41
4d12a471230625da73be464f5a20b7480a6b8ecb...40ab7c33cd6dfdf887ed15baee1325ee445eced7,1,1,1,2,1,2007-01-21 05:32:31,2007-01-20 09:49:15
40ab7c33cd6dfdf887ed15baee1325ee445eced7...a6c730644b7e1d35bd0d26962dbc978aa47d1863,1,5,2,7,1,2007-01-21 06:58:42,2007-01-20 21:28:16
a6c730644b7e1d35bd0d26962dbc978aa47d1863...9b088c4e394df84232cfd37aea78349a495b09c1,6,48,12,60,20,2007-01-21 07:29:49,2007-01-19 10:49:35
9b088c4e394df84232cfd37aea78349a495b09c1...eaf6459e4d482af51429f9464125621b805eb5fd,1,1,1,2,1,2007-01-21 07:44:55,2007-01-21 07:44:55
8d0fc48f27304ac1bc7abf802ec53fe66fedb15a...9f4cc6f76b8a15a89b85a43e0c0016a64d368709,1,3,3,6,3,2007-02-04 08:18:41,2007-02-04 07:38:17
9f4cc6f76b8a15a89b85a43e0c0016a64d368709...2e3a430a9a976ec9324b33fef41dfeb55353a1ae,1,3,20,23,7,2007-02-04 08:18:41,2007-02-04 07:38:21
2e3a430a9a976ec9324b33fef41dfeb55353a1ae...8435b548480a6b6d110fd2f59b3139f25ffb392e,1,16,0,16,4,2007-02-04 08:18:41,2007-02-04 07:38:23
8435b548480a6b6d110fd2f59b3139f25ffb392e...72e5e989b8c22dc6dd2b4f889d5d0dabf698b387,1,20,6,26,2,2007-02-04 08:18:41,2007-02-04 07:38:27
72e5e989b8c22dc6dd2b4f889d5d0dabf698b387...a925c6f165a3374ff4a69d7c991ead2d9fa90b98,1,17,1,18,12,2007-02-04 08:18:41,2007-02-04 07:38:30
a925c6f165a3374ff4a69d7c991ead2d9fa90b98...78d4d6a2815f20607336fcb238ba23efc00e1b0a,1,82,38,120,25,2007-02-04 08:18:41,2007-02-04 07:38:37
78d4d6a2815f20607336fcb238ba23efc00e1b0a...b3391775e87bed073b93a0a534169a794eceebd7,1,91,99,190,64,2007-02-04 08:18:41,2007-02-04 07:38:43
b3391775e87bed073b93a0a534169a794eceebd7...ec8048913217d8ff6e54950a0cb8ab2e739a1d1f,1,3,1,4,3,2007-02-04 08:18:41,2007-02-04 07:38:47
ec8048913217d8ff6e54950a0cb8ab2e739a1d1f...1f7d1a53fed40608e76200f941e6689b53752747,2,67,2,69,4,2007-02-04 11:28:15,2007-02-04 11:25:12
1f7d1a53fed40608e76200f941e6689b53752747...6e2e1cfb81a6a6de9fc074bd26bed8a45f73251f,1,2,0,2,1,2007-02-04 19:43:45,2007-02-04 16:16:39
c55f3fff35ac34e6d1f0f686e27029612775e51d...e70c6b35749c316f6e97099bd6bdac895c9d6f68,1,6,4,10,5,2006-02-27 19:01:05,2006-02-27 12:52:50
e70c6b35749c316f6e97099bd6bdac895c9d6f68...6baf0484efcd29bb5e58ccd5ea0379481d4a83f4,1,2,2,4,2,2006-02-27 19:01:22,2006-02-27 12:52:52
6baf0484efcd29bb5e58ccd5ea0379481d4a83f4...f891cb3fd6b3c2871c1a15e122366e412428204c,1,6,1,7,2,2006-02-27 19:01:47,2006-02-27 13:09:56
f891cb3fd6b3c2871c1a15e122366e412428204c...68d55b83a58a68fc1c9cef63f0deccbff3251096,1,14,6,20,8,2006-02-27 19:01:54,2006-02-27 15:55:13
68d55b83a58a68fc1c9cef63f0deccbff3251096...c447f10f999a7d137aef62f76d765fbc7d24f48a,1,11,11,22,8,2006-02-27 19:01:58,2006-02-27 17:12:07
c447f10f999a7d137aef62f76d765fbc7d24f48a...b705ba43c6202e3a64fbc28aa7b6b2adff7435ac,1,8,1,9,2,2006-02-27 20:55:16,2006-02-27 19:04:02
b705ba43c6202e3a64fbc28aa7b6b2adff7435ac...7be737680fbb3dbce4f7ad1bc179a661532cd026,1,1,1,2,1,2006-02-27 23:27:51,2006-02-27 20:55:45
c55f3fff35ac34e6d1f0f686e27029612775e51d...19bfcd5a14e647763e5ecc247ba24790f56721f3,1,33,0,33,3,2006-02-27 05:54:14,2006-02-26 17:29:00
19bfcd5a14e647763e5ecc247ba24790f56721f3...b5767dd6605364002a96a9d039cd1f010707b4f6,1,54,23,77,15,2006-02-27 05:54:14,2006-02-27 02:13:25
c55f3fff35ac34e6d1f0f686e27029612775e51d...36610b24f1a1821eee95243663631c1295c202ed,2,32,4,36,7,2006-02-27 05:34:42,2006-02-26 05:11:31
ae563542bf10fa8c33abd2a354e4b28aca4264d7...d9cfb964c7a59a39711da12e56563e10aa388331,1,3,5,8,4,2006-02-27 05:19:14,2006-02-27 05:19:14
2486927d2ec9cc05ed7589540d103382d3751c10...2beb3cdd18225be657849790ed845c4d367b760a,3,78,39,117,37,2006-03-02 08:01:36,2006-03-02 05:58:31
e74ee784c7daf560044dad4a06fae66732ed414b...fd8fc4ade5c8973b3dca264cc0c26b091982870b,1,10,0,10,2,2006-03-03 07:06:04,2006-03-02 20:23:17
fd8fc4ade5c8973b3dca264cc0c26b091982870b...d5dddccaa0c61c67340efca36237dfa06eccef1c,1,2,1,3,1,2006-03-03 07:06:47,2006-03-02 11:43:51
d5dddccaa0c61c67340efca36237dfa06eccef1c...9645da330f10c539a7e8ade6d787c72870812846,1,1,1,2,1,2006-03-03 07:07:01,2006-03-02 11:47:39
9645da330f10c539a7e8ade6d787c72870812846...c7569b1e0009e0187ce9f87f23699eaa8576b6ee,2,2,0,2,2,2006-03-03 07:07:34,2006-03-02 16:10:49
c7569b1e0009e0187ce9f87f23699eaa8576b6ee...a41c175d6f3e903844131b6dc39da986248c7585,1,3,1,4,2,2006-03-03 07:07:42,2006-03-02 17:21:33
a41c175d6f3e903844131b6dc39da986248c7585...69f0d91e49dbf3c3942bae125c07ad17f6027f83,2,54,1,55,7,2006-03-03 19:27:10,2006-03-03 09:20:07
69f0d91e49dbf3c3942bae125c07ad17f6027f83...ac8e0b910c722249b4d21dcf99eea2335f48dfe7,1,17,10,27,11,2006-03-03 19:27:14,2006-03-03 09:20:07
ac8e0b910c722249b4d21dcf99eea2335f48dfe7...df746c5a81ebe7d7292fe4d1f672d02a5fa6efeb,1,3,0,3,1,2006-03-03 19:27:18,2006-03-03 09:20:08
df746c5a81ebe7d7292fe4d1f672d02a5fa6efeb...a9612be245dbb642240e8f20c7215186f1d58b6a,1,32,8,40,6,2006-03-03 19:27:20,2006-03-03 09:20:08
a9612be245dbb642240e8f20c7215186f1d58b6a...eeb0abe0477dd638f52ef82795338edcb49efa2f,1,35,30,65,8,2006-03-03 19:27:22,2006-03-03 09:20:08
eeb0abe0477dd638f52ef82795338edcb49efa2f...7f60b228601becaa0bca2017521e1f27d5af70b1,1,3,3,6,2,2006-03-03 19:27:25,2006-03-03 09:20:09
7f60b228601becaa0bca2017521e1f27d5af70b1...1ca72aef45191016e2108855607c9e03b8c93528,1,12,15,27,13,2006-03-03 19:27:27,2006-03-03 09:20:09
1ca72aef45191016e2108855607c9e03b8c93528...6f0783cf9473feaaadf2ebc59167f84f0b1172bd,1,11,8,19,2,2006-03-03 19:27:29,2006-03-03 09:20:09
6f0783cf9473feaaadf2ebc59167f84f0b1172bd...448c81b495a8867297ad491a186371d9dda80515,2,31,15,46,9,2006-03-03 19:27:30,2006-03-03 09:20:09
448c81b495a8867297ad491a186371d9dda80515...8e69b31e0da6e5a540a3ca2ca16d59f3411385bc,1,1,1,2,1,2006-03-03 19:28:12,2006-03-03 09:28:48
8e69b31e0da6e5a540a3ca2ca16d59f3411385bc...90924d55c5fc4205b2d41821a3288d478aa661a0,2,24,2,26,5,2006-03-03 19:28:28,2006-03-03 16:23:32
90924d55c5fc4205b2d41821a3288d478aa661a0...d51fac53108b1822ba6b3ff8dd2cd242b40eaac5,1,17,6,23,4,2006-03-03 19:28:33,2006-03-03 10:20:18
d51fac53108b1822ba6b3ff8dd2cd242b40eaac5...f794c23466c2230b15ebf7ec30e06a390d1832a4,1,6,14,20,3,2006-03-03 22:34:40,2006-03-03 22:34:40
f794c23466c2230b15ebf7ec30e06a390d1832a4...ce4c8b24a1efcf155c076d54a7e239251504f669,1,11,4,15,1,2006-03-03 23:07:12,2006-03-03 21:35:48
1242642c468a7bcc335a676273eae4ced8a55f04...00333ca35c5986e44d4cd4fd59433200d916f77e,1,6,2,8,4,2006-03-07 01:04:07,2006-03-06 13:10:21
00333ca35c5986e44d4cd4fd59433200d916f77e...19bb732728e0e58790b7045250ed47d4831fade5,1,45,7,52,9,2006-03-07 01:04:53,2006-03-06 13:12:12
f067a13745fbeae1aa357876348a00e5edd0a629...bbe60241ae9f16c9356592e3fbaa709b6b848c4a,1,1,1,2,1,2006-03-09 02:27:15,2006-03-09 01:56:07
bbe60241ae9f16c9356592e3fbaa709b6b848c4a...3d99a7f4fab41bb057d62c87cb596069a5aba106,1,1,1,2,1,2006-03-09 09:35:07,2006-03-08 18:19:19
3d99a7f4fab41bb057d62c87cb596069a5aba106...c13c6bf758457a3e7293b2adf63cc47aec8d83ef,1,71,30,101,12,2006-03-09 09:35:14,2006-03-08 19:32:50
c13c6bf758457a3e7293b2adf63cc47aec8d83ef...d2c4af73738229e2b7c640f818f56f17d1d9edf8,1,13,11,24,2,2006-03-09 09:49:07,2006-03-09 04:04:36
d2c4af73738229e2b7c640f818f56f17d1d9edf8...1d52aba8397723235e6007d0ee38126714af113e,2,75,20,95,17,2006-03-09 18:04:58,2006-03-09 11:48:47
1d52aba8397723235e6007d0ee38126714af113e...7317ed906a17c91593f38831412379d4429528db,2,11,13,24,2,2006-03-09 18:10:18,2006-03-09 11:50:34
7317ed906a17c91593f38831412379d4429528db...779b14462523616cf84ea96690a983605fec2cdc,1,1,1,2,1,2006-03-09 18:10:30,2006-03-09 11:52:48
779b14462523616cf84ea96690a983605fec2cdc...5001422d30109b3c4471fd2d744e0a78a103c9d8,3,3,3,6,3,2006-03-09 19:43:58,2006-03-09 16:24:37
5001422d30109b3c4471fd2d744e0a78a103c9d8...7bd7f2804d84258a5cd1e76c610496f6beaa4cdf,53,53,53,106,53,2006-03-09 19:44:11,2006-03-09 16:24:50
7bd7f2804d84258a5cd1e76c610496f6beaa4cdf...b4f2a6ac9263d6e9bf3bf9c8abe607cd6def0ee8,5,5,7,12,6,2006-03-09 19:58:05,2006-03-09 19:58:05
b4f2a6ac9263d6e9bf3bf9c8abe607cd6def0ee8...a87cd02ce02e97083eb76eb8b9bfeb2e46800fd7,5,96,18,114,16,2006-03-09 20:03:14,2006-03-09 16:24:19
a87cd02ce02e97083eb76eb8b9bfeb2e46800fd7...f61c2c970c08653ade940fce678c7591abcfcde4,1,3,3,6,2,2006-03-09 20:59:16,2006-03-09 20:59:16
2855d58079cd56361879cc03f7c769409bb445e5...08ddd4f7649ccf8b9f61c903de420bfd0a8a602e,1,16,2,18,3,2006-04-18 09:26:52,2006-04-17 10:58:39
08ddd4f7649ccf8b9f61c903de420bfd0a8a602e...f56ef54174598d5362d0446c5a560cb5892537c2,3,10,5,15,3,2006-04-18 18:29:33,2006-04-18 18:29:33
f56ef54174598d5362d0446c5a560cb5892537c2...8f2b72a93666afe63ab39b279bbd4088bd5463ca,4,92,1,93,4,2006-04-18 19:06:55,2006-03-06 05:24:44
8f2b72a93666afe63ab39b279bbd4088bd5463ca...4baff50551545e2b6825973ec37bcaf03edb95fe,1,1,1,2,1,2006-04-18 20:15:18,2006-04-18 20:15:18
944e3a88fe9fa767a9e0100661026992755ab917...f94fbbee902802b317bd95150e1a7ae8be166c13,1,3,2,5,3,2006-04-11 18:29:36,2006-04-11 18:29:36
f94fbbee902802b317bd95150e1a7ae8be166c13...40d88d4fa3b13c0e7fe8eca23ff6d27e790bada2,1,4,0,4,1,2006-04-11 18:42:26,2006-04-11 18:42:26
944e3a88fe9fa767a9e0100661026992755ab917...86ff1d2012cc5e074d54c0823154019b99ca03f0,3,61,33,94,14,2006-04-11 02:44:18,2006-04-11 00:36:53
944e3a88fe9fa767a9e0100661026992755ab917...474958871394365ee7807d88217c3d75269161a6,2,112,19,131,20,2006-04-11 02:44:08,2006-04-10 09:33:06
6d46a23bf6e009487166f044b8c759aa734b8f90...a8baa7b9f5c8e338c09d63097f14372aca68e13f,4,32,24,56,15,2006-04-10 23:45:19,2006-04-10 23:39:11
a8baa7b9f5c8e338c09d63097f14372aca68e13f...477f2b41310c4b1040a9e7f72720b9c39d82caf9,1,12,1,13,8,2006-04-10 23:45:19,2006-04-10 23:40:40
477f2b41310c4b1040a9e7f72720b9c39d82caf9...c4e05b1a2290c605e68e6dac5e2a580e6d4080b7,6,34,23,57,21,2006-04-11 02:17:31,2006-04-11 01:14:54
ef030b8547eaeea1ef992310536b0b637e0c9431...2d71bcccc81e3569d97dd1314c3ca0f080f4a70f,1,17,1,18,4,2006-06-06 23:19:45,2006-06-06 23:19:45
12d81ce59846e17676c5534257ca2f1783829d63...c3b831bd84320374834f9984c118cb4fc7050ebc,4,132,1,133,4,2006-04-05 09:51:27,2006-04-05 06:00:48
8d9fbe57b3acf756a9325884d11f004ef6f7e884...459a21bd35675e140e19569e8b5c62c7fc4eee5b,1,3,1,4,2,2006-04-05 19:49:56,2006-04-05 14:22:40
d9ea73e0564c7db8d791fe6b03c976ce57c9b079...c1e335a43fb4c2f422b4d78693b2344114209632,3,49,46,95,3,2006-04-05 19:22:35,2006-04-05 19:22:35
bd9ca0baff88107e26915cdaaf9821dc70a187e3...64491e1ea95acde1aa77db539ba498593a0fcbc5,1,27,7,34,5,2006-02-13 08:32:10,2006-02-13 08:26:14
64491e1ea95acde1aa77db539ba498593a0fcbc5...41ac06c7a308bb23c55c066d150754492c2da1b6,1,1,1,2,1,2006-02-14 05:52:10,2006-02-14 05:52:10
41ac06c7a308bb23c55c066d150754492c2da1b6...4631c0035dc26ffab3a3832a5d9e9f55245f00f7,1,1,0,1,1,2006-02-14 05:55:27,2006-02-14 05:25:38
4631c0035dc26ffab3a3832a5d9e9f55245f00f7...365463851303f74eb5e5be7101811f215602fcd9,1,1,1,2,1,2006-02-14 06:13:22,2006-02-13 23:15:14
bd9ca0baff88107e26915cdaaf9821dc70a187e3...a985d595ada7914e217cbec75470f2950d41505b,2,19,3,22,9,2006-02-13 08:32:01,2006-02-13 07:57:09
a985d595ada7914e217cbec75470f2950d41505b...da140f8bbf0a84b567898332759895111c37444f,2,9,2,11,5,2006-02-13 08:32:10,2006-02-13 08:05:15
bd9ca0baff88107e26915cdaaf9821dc70a187e3...9a111c91b01455ee1ea9f33c60da7ad50d460a7b,2,159,0,159,2,2006-02-13 08:17:33,2006-02-13 07:17:04
bd9ca0baff88107e26915cdaaf9821dc70a187e3...4170a19587280eeb3663a47a6fd993910de78076,2,14,12,26,5,2006-02-13 07:55:07,2006-02-13 07:55:07
d5a6aafc90a14382120727e4e81ee1a380e8b194...a94d9948da539fdafc26c74afb335b2fe9f8f21d,1,8,1,9,2,2006-01-11 21:36:45,2006-01-11 21:36:45
a94d9948da539fdafc26c74afb335b2fe9f8f21d...2c817df25d54b557d6cac0800cacfd0a255cd56d,2,7,6,13,5,2006-01-11 22:47:20,2006-01-11 22:20:09
2c817df25d54b557d6cac0800cacfd0a255cd56d...87758f975b04233ba058750f7ea8ce63bb67297f,1,1,1,2,1,2006-01-11 23:36:07,2006-01-11 08:20:25
87758f975b04233ba058750f7ea8ce63bb67297f...c2bc6e404d75a3a68da5eefa47fa867569bc3339,1,3,3,6,1,2006-01-13 06:03:11,2006-01-13 03:08:37
c2bc6e404d75a3a68da5eefa47fa867569bc3339...cb95bf488b4363b51bd0aebc877a928858e51545,1,3,1,4,1,2006-01-13 20:59:21,2006-01-13 20:59:21
cb95bf488b4363b51bd0aebc877a928858e51545...a0dfb48af73a98ceb60629f2bbc4ebf1393ba0af,1,26,1,27,2,2006-01-13 21:17:55,2006-01-13 21:17:55
eb858c60d7850fc2ed2f69397f0560e707de324d...5a25b4a66e05376c629669ee7321c1ce7f6a47fb,1,1,0,1,1,2006-01-11 08:36:03,2006-01-11 06:40:33
5a25b4a66e05376c629669ee7321c1ce7f6a47fb...8c23b6fae2e5cd8475885b015f0bb992d19921db,1,3,2,5,2,2006-01-11 21:41:25,2006-01-11 21:41:25
eb858c60d7850fc2ed2f69397f0560e707de324d...c2bdd6afe29589980e66855d574907240cb9c62a,1,31,1,32,5,2006-01-10 07:49:46,2006-01-09 21:29:23
6d5410d65137dc76a504b550872614170e2d98b3...94d2331770b08dc28faf1d950a546a0feb953323,1,20,9,29,11,2005-11-14 08:26:49,2005-11-13 09:46:13
94d2331770b08dc28faf1d950a546a0feb953323...b0c698a6e41c47ef3e036367e58a0cf2639c1f0d,1,2,2,4,2,2005-11-14 08:50:17,2005-11-13 14:03:31
b0c698a6e41c47ef3e036367e58a0cf2639c1f0d...1331df878113037aabc496860b49ed14a762517c,5,1,107,108,5,2005-11-14 08:50:18,2005-11-13 14:08:00
4b1ca25e429a67de4828c029b053dea637732722...0f3f5e3f69020f8d08a9ca7b097cb225b933dafb,1,1,1,2,1,2005-11-14 16:41:31,2005-11-14 16:41:31
fd25c82a80533da035d42a5ac229ec5c5b332411...a935c3972749095e7ea6c341e539a94de705ecfd,1,2,2,4,2,2005-10-21 06:19:36,2005-10-21 06:19:36
dc56bc034176d76ce95e9ba7636e3551d51dc897...c9fc748f84857a237f47deb91f87499e82865c83,1,1,1,2,1,2005-09-24 22:09:48,2005-09-24 22:09:48
c9fc748f84857a237f47deb91f87499e82865c83...fbaf834de12efb43dea8d2679a040462e9d3d03d,1,14,1,15,1,2005-09-25 06:33:02,2005-09-25 06:33:02
dbc37438687e110697574d175e4eca5f9cbeae81...6b5ee137e56af8093391411389dd4b18416707ec,11,252,366,618,107,2005-09-25 06:50:43,2005-09-21 07:00:47
6b5ee137e56af8093391411389dd4b18416707ec...8082d8d3050e3fdd7b0f13c7a7b3ad68af7f478a,5,34,20,54,13,2005-09-25 06:50:44,2005-09-21 07:18:27
8082d8d3050e3fdd7b0f13c7a7b3ad68af7f478a...946f5f7c245a0f9398417be5946795cfebfd1c62,3,17,11,28,8,2005-09-25 06:50:44,2005-09-21 07:20:06
946f5f7c245a0f9398417be5946795cfebfd1c62...0bed18998ae6c0cec1485e6295be16a4fcebc7a7,1,9,3,12,2,2005-09-25 23:08:53,2005-09-25 14:48:24
0bed18998ae6c0cec1485e6295be16a4fcebc7a7...8cc01e5019e0dc9a86bba4cba414b46627fe0424,1,4,3,7,4,2005-09-25 23:08:54,2005-09-25 14:49:02
8cc01e5019e0dc9a86bba4cba414b46627fe0424...66bf85a462893f9df7e516a5f334dbba08122617,2,112,0,112,2,2005-09-25 23:18:25,2005-09-25 18:43:05
66bf85a462893f9df7e516a5f334dbba08122617...152da3dfcf2c16d7c240a0dbdcb8a3ae1d332d81,1,22,4,26,5,2005-09-26 02:25:09,2005-09-25 23:28:51
96db324a73fdada6fbe7b63221986f8f18cc63b0...89a0ead82970a2d9fe2f408b6793ccd3177cb2d1,1,1,0,1,1,2014-09-25 18:25:30,2014-09-05 16:30:49
89a0ead82970a2d9fe2f408b6793ccd3177cb2d1...f51ccda810f953dad28790ea3ef4ce3bfb787b8f,1,7,7,14,7,2014-09-25 18:25:55,2014-09-20 15:51:53
f51ccda810f953dad28790ea3ef4ce3bfb787b8f...061540fcf7a4dba5392462bc5b07d6c12d3afc61,1,43,43,86,43,2014-09-25 18:26:27,2014-09-23 12:00:52
96db324a73fdada6fbe7b63221986f8f18cc63b0...9271095cc5571e306d709ebf8eb7f0a388254d9d,5,35,11,46,12,2014-09-18 22:15:21,2014-09-18 20:53:53
96db324a73fdada6fbe7b63221986f8f18cc63b0...7559a1be8a0afb10df41d25e4cf4c5285a5faef1,2,44,0,44,3,2014-09-18 17:38:49,2014-09-18 16:57:09
7559a1be8a0afb10df41d25e4cf4c5285a5faef1...4e6d207c45e6f5c13b38c4a200f0d3339f88ad34,2,8,3,11,4,2014-09-22 20:41:52,2014-09-22 18:24:34
96db324a73fdada6fbe7b63221986f8f18cc63b0...ec7dbd145bd8ea27d958dcb16e19b5f0ef3fd643,2,19,0,19,4,2014-09-16 22:11:58,2014-09-12 22:48:07
96db324a73fdada6fbe7b63221986f8f18cc63b0...f5e3c0b9d050ebdaf96d3910b01b01695e3ea1a2,2,26,5,31,8,2014-09-16 18:11:58,2014-09-14 07:35:06
96db324a73fdada6fbe7b63221986f8f18cc63b0...2da1f36671c3e3e28eba6a56d92249b6671c07d3,6,65,1,66,7,2014-09-16 18:05:46,2014-09-14 01:30:38
2da1f36671c3e3e28eba6a56d92249b6671c07d3...85de86a16bd853708658eb13689d913bc377ae3e,1,2,1,3,2,2014-09-22 20:46:43,2014-09-21 09:13:58
96db324a73fdada6fbe7b63221986f8f18cc63b0...1c4b6604126781361fe89d88ace70f53079fbab5,9,7,8,15,12,2014-09-15 19:05:14,2014-09-14 07:40:45
96db324a73fdada6fbe7b63221986f8f18cc63b0...f978a99faf5e657c6292d66aa4c237c934c8f883,1,1,0,1,1,2014-09-15 19:02:43,2014-09-14 05:33:35
96db324a73fdada6fbe7b63221986f8f18cc63b0...3b2c5413c90bafe0763b527b01da83712c856cf6,1,2,2,4,2,2014-09-15 19:00:52,2014-09-13 14:20:22
96db324a73fdada6fbe7b63221986f8f18cc63b0...1cc2c772dd4dc5f9396a229e2727ca28ef25c33b,1,1,0,1,1,2014-09-15 18:37:43,2014-09-13 20:16:53
1cc2c772dd4dc5f9396a229e2727ca28ef25c33b...d38379ece9216735ecc0ffd76c4c4e3da217daec,1,71,45,116,10,2014-09-15 18:38:13,2014-09-13 20:19:20
d38379ece9216735ecc0ffd76c4c4e3da217daec...3907a4078a89cffde2e2e0e61a3bd41efba96c49,1,9,0,9,2,2014-09-15 18:39:54,2014-09-13 20:19:38
3907a4078a89cffde2e2e0e61a3bd41efba96c49...4489a480fdfe53e1ca78eabdab2dee00376814a3,1,6,17,23,3,2014-09-15 18:39:58,2014-09-13 07:28:01
96db324a73fdada6fbe7b63221986f8f18cc63b0...3424a02252270c40963304672ce93d75c4cdf544,1,1,1,2,1,2014-09-15 18:29:46,2014-09-14 22:40:53
3424a02252270c40963304672ce93d75c4cdf544...e4a590efa2d49e6eb4dccfa41a477703493417f3,1,5,5,10,5,2014-09-15 18:29:54,2014-09-14 22:07:10
96db324a73fdada6fbe7b63221986f8f18cc63b0...f9f3851b4d2cb17bb4ec2d2b00514b1b2d5df456,1,1,1,2,1,2014-09-12 21:21:16,2014-09-12 19:47:34
96db324a73fdada6fbe7b63221986f8f18cc63b0...cbe73331812ed0ac3c3b680ab3aab4e6d22a98ad,2,120,33,153,12,2014-09-12 19:48:54,2014-09-10 11:11:55
96db324a73fdada6fbe7b63221986f8f18cc63b0...693eb02a5e152668dacc7c6ff0f1c63d70c0a82a,2,2,2,4,2,2014-09-03 21:35:37,2014-08-30 06:54:23
96db324a73fdada6fbe7b63221986f8f18cc63b0...c40fdd01dd120c8c63da5e830ccdeb1518434bd6,2,25,0,25,2,2014-09-03 17:47:44,2014-09-03 16:14:10
96db324a73fdada6fbe7b63221986f8f18cc63b0...ad5fe3771b50f3862130d150b5cc8bb316ef6f1c,8,10,10,20,10,2014-09-02 19:00:30,2014-08-30 19:56:01
96db324a73fdada6fbe7b63221986f8f18cc63b0...24d36f1472794ba95ddc81ba8afb45fe30d1f35c,7,10,9,19,7,2014-09-02 18:33:32,2014-08-31 20:11:31
96db324a73fdada6fbe7b63221986f8f18cc63b0...57065289a9ef2fc962ec7f82f9771b45eba8dba1,1,6,12,18,7,2014-09-02 18:02:58,2014-08-30 21:40:34
96db324a73fdada6fbe7b63221986f8f18cc63b0...59b8263a6dc3946b62101a9cc9c603a5486cee09,1,6,9,15,4,2014-09-02 17:57:14,2014-08-30 15:55:45
96db324a73fdada6fbe7b63221986f8f18cc63b0...37007c3a87f3d78f533533f96a0d49bd0d520671,1,1,5,6,2,2014-09-02 17:56:43,2014-08-30 16:07:05
96db324a73fdada6fbe7b63221986f8f18cc63b0...be0b3f822b6375028b25f62894056e63cb7c3ce4,1,6,10,16,7,2014-09-02 17:36:42,2014-08-30 09:46:54
be0b3f822b6375028b25f62894056e63cb7c3ce4...d773144417b1a87b4529144ab0530ecfea103754,1,5,6,11,2,2014-09-02 17:37:24,2014-08-30 09:47:19
1f32ecffd864ea5b339883f94463b0b69f4aeb35...c7bf68d6b4b538f86e530f6b01eca7ff432ffbbb,1,2,0,2,1,2014-11-21 19:06:25,2014-11-21 09:34:54
9233887cce8eaebd8469315622b84bd26910351f...aae828b911e7c0285f10476d42758101825b9add,1,18,18,36,10,2014-11-10 17:38:53,2014-11-09 01:59:18
4756c05741164a0889212f1e8151ff081b75bba2...d7d300ea598b8a192f73cee15c7c3c7fcb556888,1,3,5,8,3,2014-10-16 19:03:21,2014-10-16 05:30:04
d7d300ea598b8a192f73cee15c7c3c7fcb556888...9e8f8dea46b52682b3fca67d8602c694c10013e1,1,18,12,30,9,2014-10-16 19:04:05,2014-10-15 08:35:21
4756c05741164a0889212f1e8151ff081b75bba2...f9e43085bb95034a36a223f4eba75174b096179c,1,9,11,20,9,2014-10-15 20:49:11,2014-10-15 08:35:20
f9e43085bb95034a36a223f4eba75174b096179c...76ee96a9b6f75e7d1c01e68ade72194179aa512d,1,18,12,30,9,2014-10-15 21:09:15,2014-10-15 08:35:21
76ee96a9b6f75e7d1c01e68ade72194179aa512d...9c66cd3bd0a70b2cf56589a4df2cf63814270635,1,11,5,16,1,2014-10-15 21:10:52,2014-10-10 08:19:47
9c66cd3bd0a70b2cf56589a4df2cf63814270635...1c7e2d23e4f22f1599570d9c5d0cc2f4156b5b74,1,6,2,8,2,2014-10-15 21:12:20,2014-10-11 08:39:36
1c7e2d23e4f22f1599570d9c5d0cc2f4156b5b74...7bfb7c357cd33a9f3a72d65b0df96e054d2a9f06,1,4,1,5,3,2014-10-15 21:12:20,2014-10-11 08:39:37
7bfb7c357cd33a9f3a72d65b0df96e054d2a9f06...4fb4b02d98310f4f859f7d52f57f36d49198be5c,2,5,5,10,3,2014-10-15 21:12:20,2014-10-11 08:39:38
3c2dc76f015b4d52ef02a08c59a4546d00b475e1...f4694a8c088106bb5a137407ffa9c8a0fe871566,1,5,4,9,1,2014-10-28 16:59:41,2014-10-24 07:43:27
3c2dc76f015b4d52ef02a08c59a4546d00b475e1...d55aeb7687448189327ad058096b55431da5ea42,2,8,1,9,2,2014-10-27 21:13:59,2014-10-27 21:13:15
3c2dc76f015b4d52ef02a08c59a4546d00b475e1...f51140c2470b50bcaff63b850f5e258c23d5853d,1,1,1,2,1,2014-10-27 18:48:37,2014-10-26 17:33:12
f51140c2470b50bcaff63b850f5e258c23d5853d...48a031af3cc555e0eb9d30b96f2e0943de7c44ae,1,2,2,4,1,2014-10-27 18:49:18,2014-10-26 17:33:53
48a031af3cc555e0eb9d30b96f2e0943de7c44ae...bfb0e6fcd2826a869383b766712131a07a8059b0,1,4,0,4,1,2014-10-27 18:51:12,2014-10-26 17:34:26
3c2dc76f015b4d52ef02a08c59a4546d00b475e1...25098690a0151ba29ec1c728d783366c1899624d,2,10,1,11,2,2014-10-27 18:17:56,2014-10-26 08:09:20
25098690a0151ba29ec1c728d783366c1899624d...2b52123fcf840686b69e10807fd0f985ec4167f3,4,75,0,75,7,2014-10-28 17:36:57,2014-10-27 01:15:42
3c2dc76f015b4d52ef02a08c59a4546d00b475e1...f13f9b0eab8ec4880be0e4423ebdcfdbcd41eeb6,4,28,27,55,4,2014-10-21 18:25:30,2014-10-20 22:49:36
3c2dc76f015b4d52ef02a08c59a4546d00b475e1...dc76c7f783694557b08f01d99793979c482aee1f,1,1,0,1,1,2014-10-21 18:01:18,2014-10-21 01:50:44
dc76c7f783694557b08f01d99793979c482aee1f...8b148bf085fdcbacc42db5966467bd382962f27c,1,1,0,1,1,2014-10-21 18:01:27,2014-10-21 01:50:45
3c2dc76f015b4d52ef02a08c59a4546d00b475e1...ecdab4126793194e7181afa967deaf8e805a09b9,1,19,6,25,2,2014-10-20 03:47:40,2014-10-17 21:40:23
3c2dc76f015b4d52ef02a08c59a4546d00b475e1...7c45cee6bb3a9727d88fd8ea9c681d49fd29220e,1,2,2,4,2,2014-10-20 03:45:16,2014-10-19 14:17:15
3c2dc76f015b4d52ef02a08c59a4546d00b475e1...b12d04503b0aba1f2d68b164b348cbf94bbe570b,2,16,2,18,4,2014-10-16 18:58:11,2014-10-16 04:45:14
3c2dc76f015b4d52ef02a08c59a4546d00b475e1...fb1d6dabce69bce3f28a7f442da990ef8df872ac,3,46,2,48,8,2014-10-15 21:34:45,2014-10-14 19:38:52
67de23ddb1ed5471e302f6a84fae7a9037a0d980...41ca19b6a6ca5ad6fea246bd400717c16b80b32c,3,6,6,12,4,2014-08-13 20:12:06,2014-08-13 19:30:11
67de23ddb1ed5471e302f6a84fae7a9037a0d980...eac0ccc2cd0022546b5037a5aabef8ec687bb60a,1,1,1,2,1,2014-08-11 17:48:06,2014-08-10 02:29:29
eac0ccc2cd0022546b5037a5aabef8ec687bb60a...ad1a19d0e7cdd69fd4902b80ab691d43b102e3e2,1,16,18,34,1,2014-08-11 17:48:07,2014-08-10 02:29:30
ad1a19d0e7cdd69fd4902b80ab691d43b102e3e2...3af05a6d0da3addbcc050f3b1a1ac379e6c4025c,1,22,14,36,2,2014-09-03 21:59:40,2014-08-10 02:29:31
3af05a6d0da3addbcc050f3b1a1ac379e6c4025c...42de4b169c5de9d3f22eb1f988aa5b69447951b2,1,8,16,24,1,2014-09-03 21:59:43,2014-08-10 02:29:32
42de4b169c5de9d3f22eb1f988aa5b69447951b2...e2b6cfa02e29c4a8f91ede15026b5eaa790de329,1,25,17,42,3,2014-09-03 21:59:43,2014-08-10 02:29:33
e2b6cfa02e29c4a8f91ede15026b5eaa790de329...b46b15dea01a898888fac977aeed6055a761c3ca,1,23,30,53,4,2014-09-03 22:06:52,2014-08-10 02:29:34
b46b15dea01a898888fac977aeed6055a761c3ca...dcadc8b80609f6857ab35163a8a6e08cdaf35b8f,1,3,4,7,1,2014-09-03 22:06:59,2014-08-10 02:29:35
dcadc8b80609f6857ab35163a8a6e08cdaf35b8f...4f1bbd23af48e875420a22fa5fa23542f17d6e4d,1,2,2,4,2,2014-09-03 22:06:59,2014-08-10 02:29:36
f0d89001750a27c1c447b2eb3149b998521fa52c...63a45136a329bab550425c3142db6071434d935e,1,13,0,13,3,2014-10-08 20:08:55,2014-10-08 20:08:55
80b616d04b8f5a15b5d5587d67baf6e2e28c9f87...8852117a603c5ed5131233a80453db37c0958871,5,21,22,43,21,2014-10-14 18:01:05,2014-10-07 19:16:57
8852117a603c5ed5131233a80453db37c0958871...f6c5a2968c103621adf6928a29e4895361eaa23b,11,26,28,54,18,2014-10-14 18:01:21,2014-10-07 19:33:09
80b616d04b8f5a15b5d5587d67baf6e2e28c9f87...64045940af0539f15335d7664908e74d1febc439,1,10,7,17,8,2014-10-07 17:48:09,2014-10-03 22:40:24
85e70c31ef347ddc84584f65e8ff2b8881cfe6c9...97b8860c071898d9e162678ea1035a8ced2f8b1f,1,51,12,63,14,2014-09-19 21:25:09,2014-09-19 18:51:14
0c72b98f31bf6eabd75be565a08ffcf0d8e74b1f...fe8e3b71805cd13d139b62fa5a0c75387568c9ea,2,11,3,14,5,2014-09-10 20:52:13,2014-09-10 13:52:44
fe8e3b71805cd13d139b62fa5a0c75387568c9ea...90a398bbd72477d5d228818db5665fdfcf13431b,5,31,16,47,15,2014-09-10 20:54:21,2014-09-10 13:52:51
90a398bbd72477d5d228818db5665fdfcf13431b...4d0d89755e82c40df88cf94d84031978f8eac827,1,23,0,23,2,2014-09-11 17:44:01,2014-09-11 14:26:33
4d0d89755e82c40df88cf94d84031978f8eac827...cec097be3a98be3773ddadf6824de03b849758d7,1,85,1,86,3,2014-09-11 17:44:26,2014-09-11 14:26:38
cec097be3a98be3773ddadf6824de03b849758d7...90e3e5f0574480cb873cca1c7b968dd1516c05d2,1,19,0,19,1,2014-09-11 21:19:09,2014-09-11 14:26:41
90e3e5f0574480cb873cca1c7b968dd1516c05d2...f99b7af661f89865f918e52223a3bdaf312a0de0,1,19,0,19,1,2014-09-12 18:04:13,2014-09-12 08:08:16
0c72b98f31bf6eabd75be565a08ffcf0d8e74b1f...9540ce5030853ffbb7e11c30aa59a5e45095d32c,3,33,23,56,10,2014-09-10 17:58:32,2014-09-10 10:03:52
ce1d3a93a6405b8a0313491df3099919ed3d150f...9385b5d7065351104c7bfd3d1e53a28207b8b7ed,2,70,0,70,2,2014-10-13 20:55:26,2014-10-13 18:16:23
9385b5d7065351104c7bfd3d1e53a28207b8b7ed...4103818d20a4aa8f2473bff3cc8e2f9048d9c310,1,210,0,210,1,2014-10-13 20:55:26,2014-10-13 18:16:24
4103818d20a4aa8f2473bff3cc8e2f9048d9c310...46a0613f00f2cf6a61d04fa49131fcbe3afaad07,1,185,0,185,1,2014-10-13 20:55:26,2014-10-13 18:16:25
46a0613f00f2cf6a61d04fa49131fcbe3afaad07...f0a90b4edff44af9a3cb3c30ff8e656a59581a2f,1,112,0,112,2,2014-10-13 20:55:27,2014-10-13 18:16:26
f0a90b4edff44af9a3cb3c30ff8e656a59581a2f...2013d8505da95d355e610c08473f2e0b45645bf9,1,123,0,123,2,2014-10-13 20:55:27,2014-10-13 18:16:27
2013d8505da95d355e610c08473f2e0b45645bf9...b1d78d77bfbf026e8222c02f1009767a466de0b1,2,75,0,75,4,2014-10-13 20:55:27,2014-10-13 18:16:28
b1d78d77bfbf026e8222c02f1009767a466de0b1...6634f05454662b62e1f34766d3684b99fb53ad66,5,48,0,48,5,2014-10-13 20:55:27,2014-10-13 18:16:29
6634f05454662b62e1f34766d3684b99fb53ad66...76bed78a5829392d4e4dcf21b899d372dd71f408,1,738,0,738,1,2014-10-13 20:59:45,2014-10-13 18:16:30
76bed78a5829392d4e4dcf21b899d372dd71f408...85039fb6e4e7123958a40a22ef40e25bcb29f9c0,1,84,1,85,12,2014-10-13 20:59:48,2014-10-13 18:16:31
85039fb6e4e7123958a40a22ef40e25bcb29f9c0...b9384ff34e18890c6b5aab91669094f0a3b411ae,1,125,0,125,1,2014-10-13 20:59:48,2014-10-13 18:16:32
b9384ff34e18890c6b5aab91669094f0a3b411ae...dfd66ddf5aa9aacc06ed38a9ee2cc15a4f2d4896,2,315,0,315,2,2014-10-13 20:59:49,2014-10-13 18:16:33
ce1d3a93a6405b8a0313491df3099919ed3d150f...3ac22f82edec108986b2627fcd6f2a8039617a23,2,5,0,5,2,2014-09-18 16:13:38,2014-09-16 18:56:48
3ac22f82edec108986b2627fcd6f2a8039617a23...2756ca4347cbda05b16954cd7f445c216b935e76,26,40,70,110,31,2014-09-18 16:13:42,2014-09-16 18:56:57
ce1d3a93a6405b8a0313491df3099919ed3d150f...785a1c82587ca6e796595e63508ad6b32104d16c,1,3,1,4,1,2014-09-14 08:08:24,2014-07-24 16:25:59
785a1c82587ca6e796595e63508ad6b32104d16c...4950eed520ce3dbb786e33fe8a8dc48e492998b4,2,63,6,69,6,2014-09-14 08:08:24,2014-08-03 01:44:08
4950eed520ce3dbb786e33fe8a8dc48e492998b4...26bb3c10ef9a8fcd50cae12af13c677c5a17f0dd,1,0,15,15,1,2014-09-14 08:08:24,2014-09-05 03:46:25
26bb3c10ef9a8fcd50cae12af13c677c5a17f0dd...a831a3fd86bb7280020d650d52cce4af9e161c46,2,4,2,6,3,2014-09-14 08:08:24,2014-09-07 08:35:19
a831a3fd86bb7280020d650d52cce4af9e161c46...30d45f798d1a4b14759cd977b68be4476d66ea17,1,11,7,18,2,2014-09-14 08:08:54,2014-09-14 07:38:29
ce1d3a93a6405b8a0313491df3099919ed3d150f...1a947ba3a3eebea80be6a6d1000614884807bc8b,1,1,1,2,1,2014-09-11 22:26:35,2014-09-11 20:35:30
ce1d3a93a6405b8a0313491df3099919ed3d150f...b64a98460682366d7533ea251d26026b85bb39cb,1,23,29,52,6,2014-09-11 19:23:42,2014-09-11 19:19:54
b64a98460682366d7533ea251d26026b85bb39cb...17b787f6031d72619e4e2982ea84f47fe161cb30,1,15,17,32,14,2014-09-11 19:48:01,2014-09-11 19:44:05
17b787f6031d72619e4e2982ea84f47fe161cb30...5ba9a93b39bef057be54ecf7933386a582981625,1,36,9,45,11,2014-09-11 21:23:51,2014-09-11 20:14:51
3dcacd7797082cb8e6f3c10970e18dd843433e3a...49f1cb93a2f11845cfa2723611a729d3d7f02f0d,2,23,1,24,6,2014-07-27 22:22:22,2014-07-27 22:22:22
32f56600bb6ac6fc57183e79d2c1515dfa56672f...af465af8deda8ad685f7704a2dc787845eb317ed,2,15,3,18,7,2014-09-04 18:00:28,2014-09-03 19:42:37
32f56600bb6ac6fc57183e79d2c1515dfa56672f...c254516737c2c1e6ef8ce49d798cebb06fd6d3ee,1,2,2,4,1,2014-09-03 19:23:10,2014-09-03 15:00:41
32f56600bb6ac6fc57183e79d2c1515dfa56672f...15999d0be8179fb7a2e6eafb931d25ed65df50aa,1,18,0,18,2,2014-08-29 17:05:14,2014-08-29 08:54:41
15999d0be8179fb7a2e6eafb931d25ed65df50aa...0344d93ced82a5e492d0e2a555047346445d2495,1,0,1,1,1,2014-08-29 17:05:53,2014-08-27 19:48:12
32f56600bb6ac6fc57183e79d2c1515dfa56672f...0fa7f01635aa0356823d5cbb5109f61b0f307e4b,1,2,1,3,1,2014-08-25 19:21:17,2014-08-23 05:26:51
32f56600bb6ac6fc57183e79d2c1515dfa56672f...3c078b9c860c7c1dbe8782aa1f79877354cbc602,1,7,4,11,4,2014-08-25 19:20:24,2014-08-23 05:27:41
3c078b9c860c7c1dbe8782aa1f79877354cbc602...c252785982c268e5c969900c677322744d09f52e,1,6,4,10,4,2014-08-25 19:20:57,2014-08-23 05:32:37
32f56600bb6ac6fc57183e79d2c1515dfa56672f...afd11d3ebcfb18c29840dfa68be32c5215810a77,2,9,1,10,2,2014-08-25 19:19:50,2014-08-23 05:27:07
32f56600bb6ac6fc57183e79d2c1515dfa56672f...dddecc5b7fdeefb2550296540b849bd2eaac230c,1,1,1,2,1,2014-08-21 20:09:06,2014-08-20 12:27:10
32f56600bb6ac6fc57183e79d2c1515dfa56672f...c8466645edd1413c7efed824f5bddac457eb77f9,3,22,2,24,3,2014-08-18 17:45:59,2014-08-18 10:17:57
c8466645edd1413c7efed824f5bddac457eb77f9...c1063be2a3e14ac042db4fe9b9bcea8f2768886a,3,21,7,28,7,2014-09-11 23:33:54,2014-08-19 06:20:00
32f56600bb6ac6fc57183e79d2c1515dfa56672f...faa3807cfe95bace6eaa9e8775520fab713c27d0,1,5,1,6,2,2014-08-18 17:11:42,2014-08-13 17:31:24
faa3807cfe95bace6eaa9e8775520fab713c27d0...8837eb47f27665450c898affc39816c48edacd80,1,2,4,6,1,2014-08-21 17:53:55,2014-08-17 07:35:53
32f56600bb6ac6fc57183e79d2c1515dfa56672f...9c7a0beee093908e26c11e689e391f95410d35c2,1,1,0,1,1,2014-08-15 16:50:18,2014-08-15 07:46:11
9c7a0beee093908e26c11e689e391f95410d35c2...9eeff2f6810d4f962aa78ddf43193fba26d9451a,1,4,0,4,1,2014-08-15 18:04:59,2014-08-15 17:02:46
32f56600bb6ac6fc57183e79d2c1515dfa56672f...2d26d533a012f7475e13657d7fc829a6ba01db73,1,2,5,7,1,2014-08-12 20:37:45,2014-08-11 20:22:48
32f56600bb6ac6fc57183e79d2c1515dfa56672f...81c3ce3cdce8dffb913243f5b2cc09d9fb966e6c,3,7,3,10,3,2014-08-12 18:00:33,2014-08-10 21:33:26
32f56600bb6ac6fc57183e79d2c1515dfa56672f...430875969a5229c1d306e4cc5acc8c8afe2b50a3,2,10,0,10,2,2014-08-11 18:52:22,2014-08-10 07:05:21
32f56600bb6ac6fc57183e79d2c1515dfa56672f...2f50babef18db3ca90b0b75f54d9c36d7a9142b3,1,3,3,6,3,2014-08-10 23:40:54,2014-08-10 19:43:33
2f50babef18db3ca90b0b75f54d9c36d7a9142b3...50b6773287503cb76d1f4020245bbd119c410961,1,2,0,2,1,2014-08-10 23:41:14,2014-08-10 13:57:56
583b61c1af1bac12d6b48b2583ad508b5ab9964c...ae18165fbbf5e15ab2371d09f79cd12ee403c51e,1,1,1,2,1,2014-07-30 19:30:02,2014-07-29 17:53:40
ae18165fbbf5e15ab2371d09f79cd12ee403c51e...c75e7ad28a34081ca6e7e53c0551fa6c99b208b0,1,2,2,4,2,2014-07-30 19:30:06,2014-07-29 17:54:46
c75e7ad28a34081ca6e7e53c0551fa6c99b208b0...b9c7d6e4330e3dcdb3b3e5f013e5667e47555c95,4,11,3,14,5,2014-07-30 19:30:08,2014-07-29 17:56:48
583b61c1af1bac12d6b48b2583ad508b5ab9964c...d0da003d5b1e65f6e52920e42582f43b357782ee,2,49,17,66,9,2014-07-30 18:29:33,2014-07-29 14:43:39
6f92e5ff3cdc813de8ef5327fd4bad492fb7d6c9...cd78cea29d5476c6178cd49c08d10566f5bf0d4f,1,2,1,3,2,2014-07-10 20:04:34,2014-07-09 19:34:12
cd78cea29d5476c6178cd49c08d10566f5bf0d4f...00f6991d4bb35e76836d4ce8f2eaab3e4e3b20a7,1,1,1,2,1,2014-07-10 20:04:42,2014-07-09 19:34:42
6f92e5ff3cdc813de8ef5327fd4bad492fb7d6c9...4602f1a4346c881289011810c5f76886ca0e2d0c,1,2,6,8,2,2014-07-08 18:01:50,2014-07-08 16:21:05
4602f1a4346c881289011810c5f76886ca0e2d0c...72c779457cd72928e36f2bc43c3ff7f3ae7b77c3,1,1,3,4,1,2014-07-08 18:01:53,2014-07-08 16:23:37
6f92e5ff3cdc813de8ef5327fd4bad492fb7d6c9...063da62b02aeafe58fdacce0ea48c0761b06df60,3,22,11,33,6,2014-07-07 22:32:21,2014-07-07 06:35:37
6f92e5ff3cdc813de8ef5327fd4bad492fb7d6c9...21711ca4b2a387b587c90e0ad8a98170e4b006e4,2,8,16,24,2,2014-07-07 21:10:13,2014-07-05 19:35:01
6f92e5ff3cdc813de8ef5327fd4bad492fb7d6c9...0be314c20742cd62cd6e8fcfbcc4535fb2a99675,1,2,2,4,2,2014-07-07 21:01:11,2014-07-04 23:43:48
0be314c20742cd62cd6e8fcfbcc4535fb2a99675...8cd7ebc89e025f1d5bc4b247497e4cfd7fd8ec0f,1,2,0,2,2,2014-07-07 21:01:14,2014-07-04 23:43:49
8cd7ebc89e025f1d5bc4b247497e4cfd7fd8ec0f...5d7fd6d06feb29acc9e6304a75b4e26eb23491c4,1,1,0,1,1,2014-07-08 17:56:37,2014-07-08 06:35:10
5d7fd6d06feb29acc9e6304a75b4e26eb23491c4...066dd2632acf11a348ff209b79f42c1a87a71fbb,2,29,6,35,6,2014-07-08 17:56:47,2014-07-08 06:35:11
6f92e5ff3cdc813de8ef5327fd4bad492fb7d6c9...039dc71a7cb824300e242f8abc0fcb19dac93641,8,29,40,69,14,2014-07-07 20:56:24,2014-07-02 22:20:20
039dc71a7cb824300e242f8abc0fcb19dac93641...aa420c48eaea5c89946b8753363d09955300133f,1,12,4,16,2,2014-07-07 20:56:31,2014-07-02 22:21:21
aa420c48eaea5c89946b8753363d09955300133f...ab73a9d119240b0b908ccb9edd19b8e536ce29b9,6,31,18,49,10,2014-07-07 20:56:35,2014-07-02 22:22:11
ab73a9d119240b0b908ccb9edd19b8e536ce29b9...7b64d42d22206d9995a8f0cb3b515e623cac4702,5,88,0,88,5,2014-07-07 20:56:38,2014-07-02 22:22:54
0d9cb2d14e4f26c122ab2532b4ceb3e757fb87b7...aa0ba07a026db61af7d95057dd3eb8b6c819dd06,1,5,3,8,2,2014-07-30 21:25:14,2014-07-30 21:25:14
b9e343e6402ab74dac9134f0550ec4ffcd4f6f2a...f7fbc357f863ecc5323f3fcf2fc9cbf2aa2a8587,1,1518,1353,2871,1299,2014-08-07 07:07:18,2014-08-05 17:23:50
f7fbc357f863ecc5323f3fcf2fc9cbf2aa2a8587...0082d82183b42c19fe7db1531279ff6d3f86c3fe,1,10951,0,10951,1,2014-08-23 02:10:22,2014-08-23 02:10:22
0082d82183b42c19fe7db1531279ff6d3f86c3fe...47abf17be5db745f0d41ec5257c341b8893f43fe,1,4,0,4,1,2014-08-23 02:10:30,2014-08-23 02:10:30
47abf17be5db745f0d41ec5257c341b8893f43fe...795b9ff872bbcd4bae3a8c80eaee7f12557e6830,1,2,2,4,2,2014-08-23 17:17:38,2014-06-11 16:10:45
795b9ff872bbcd4bae3a8c80eaee7f12557e6830...869951babc24fef5c5cd58f86baefc25b6ed3765,1,3,3,6,3,2014-08-23 17:17:38,2014-06-12 18:15:55
597072314c18d0dbebc54ca5db0ad038d297d92a...369a70fc7712801f708fc70b7be575cee32dd407,1,14,2,16,5,2014-06-25 19:32:23,2014-06-25 19:32:23
8e34800e5bce1dc6f1ab5520a4c866a2a73639de...b416af5bcdca3ac8426220f09efbfca2f1bec6e0,3,56,14,70,10,2014-09-03 17:04:07,2014-04-16 22:26:44
b416af5bcdca3ac8426220f09efbfca2f1bec6e0...8c8bdc0d3582e42c13815a191344b1aa3e06c792,3,22,11,33,7,2014-09-03 17:04:08,2014-04-16 22:27:45
8c8bdc0d3582e42c13815a191344b1aa3e06c792...93a644ea9d3702cc1cc62c0d413f81f8e46fabe7,3,6,3,9,4,2014-09-03 17:04:08,2014-05-19 17:42:34
93a644ea9d3702cc1cc62c0d413f81f8e46fabe7...2bdc785fd7f699669a582f7a83f5b81192d24d88,1,33,1,34,8,2014-09-03 17:04:09,2014-04-29 19:06:19
2bdc785fd7f699669a582f7a83f5b81192d24d88...e5074bfe8cb895a060720a7cbb3f2ed4fd8cf710,1,10,6,16,4,2014-09-03 17:04:10,2014-04-16 22:30:41
e5074bfe8cb895a060720a7cbb3f2ed4fd8cf710...867c2fac0aef75d8c883010780eb163e82aaa266,1,8,6,14,3,2014-09-03 17:04:10,2014-04-16 22:32:29
867c2fac0aef75d8c883010780eb163e82aaa266...c0fe1ed0841868989c088681e1263f248629e92f,1,12,13,25,7,2014-09-03 17:04:11,2014-04-16 22:34:19
c0fe1ed0841868989c088681e1263f248629e92f...d668d16ca7f6c31ee60cb4cc061dd1b62ea658de,1,18,8,26,5,2014-09-03 17:04:12,2014-04-16 22:37:45
d668d16ca7f6c31ee60cb4cc061dd1b62ea658de...de7e86f522ea806ef40b3c9557e040d4109e55fb,1,15,10,25,7,2014-09-03 17:04:12,2014-04-16 23:21:13
de7e86f522ea806ef40b3c9557e040d4109e55fb...d43f990fac72264c1553beb7dbc6e8e795083d42,1,17,14,31,4,2014-09-03 17:04:13,2014-04-16 23:21:53
d43f990fac72264c1553beb7dbc6e8e795083d42...b4d75ac1d152bbab44b0777a4cc0c48db75f6024,1,26,4,30,2,2014-09-03 17:04:13,2014-04-24 23:36:55
b4d75ac1d152bbab44b0777a4cc0c48db75f6024...6629ea2d4a5faa0a84367f6d4aedba53cb0f26b4,1,16,9,25,4,2014-09-03 17:04:14,2014-04-28 21:36:15
6629ea2d4a5faa0a84367f6d4aedba53cb0f26b4...3f09ba754367fcc0ddad94e22385d80b5f317584,1,23,6,29,4,2014-09-03 17:04:14,2014-04-28 22:23:58
3f09ba754367fcc0ddad94e22385d80b5f317584...b6b10bb44c31b5a830c1636c7eb8b122f9b67858,1,40,30,70,12,2014-09-03 17:04:15,2014-04-17 18:31:06
b6b10bb44c31b5a830c1636c7eb8b122f9b67858...88b680ae8d7a8f88409eff0c4cd2f12acf07155f,2,5,8,13,3,2014-09-03 17:04:15,2014-04-28 22:38:47
88b680ae8d7a8f88409eff0c4cd2f12acf07155f...45421e24e8322184a35a32a9072f04afabe33880,1,6,24,30,2,2014-09-03 17:04:16,2014-04-29 19:14:47
45421e24e8322184a35a32a9072f04afabe33880...04ad6223ec1163163c4f39308149bee852ee245f,1,8,26,34,3,2014-09-03 17:04:17,2014-04-29 20:42:07
04ad6223ec1163163c4f39308149bee852ee245f...cba12021c3c932e42de838d0fc05d60b93790599,1,5,10,15,3,2014-09-03 17:04:17,2014-04-29 22:45:52
cba12021c3c932e42de838d0fc05d60b93790599...029cdb4ab21c49a916efd68eaf2d2431c7fab7c7,2,32,9,41,8,2014-09-03 17:04:18,2014-04-30 16:03:36
029cdb4ab21c49a916efd68eaf2d2431c7fab7c7...7521cc4611a783f4a8174bd0fcec5f4a47357ac1,1,14,21,35,4,2014-09-03 17:04:18,2014-04-30 16:22:45
7521cc4611a783f4a8174bd0fcec5f4a47357ac1...ab5ac95725f7a4f36f72be48f340a84e46996e90,1,10,1,11,10,2014-09-03 17:04:19,2014-09-02 21:10:52
ab5ac95725f7a4f36f72be48f340a84e46996e90...88499b296b5f62338d7fa4019c7b5f9012b4ab88,1,15,12,27,12,2014-09-03 17:04:19,2014-09-02 21:11:21
67a31f612830e79fe768ac886ed9ef7eadd8fb10...ce856044681331d19b867426726db7edd12f1713,1,5,9,14,4,2014-07-10 17:56:50,2014-07-10 04:07:32
c7d3f8cb48d754371343c5a48cf392135bb4d77b...792a646a194deb146de72022cf92882fe2fde8b9,1,1,1,2,1,2014-09-08 18:08:04,2014-09-06 20:53:03
1697bf30df3ec6c28b180bc290d7d11d2fe97562...35936f8fc38a214cc7d2595070641d39a541dfb1,2,6,1,7,2,2014-04-25 17:03:41,2014-04-25 17:03:41
79dcccc503ac228630ecf15dcf8e1d9455daef2d...dde8a902c774268628015705a7767f61af18b865,2,44,29,73,7,2014-06-05 22:24:50,2014-06-04 03:38:10
d8779e1e2536bdd024254af14d2c046bba2bbb01...b3275838d969b7ecb91aae584226fccbeb046aca,4,13,8,21,6,2014-05-07 20:41:04,2014-04-30 07:35:25
d8779e1e2536bdd024254af14d2c046bba2bbb01...3bb55e8aa86f054c081c372b227f723e3aad14c7,1,2,9,11,1,2014-05-06 22:33:39,2014-04-30 08:58:06
3bb55e8aa86f054c081c372b227f723e3aad14c7...10f5b034b6aaff706c4776b3cc0ee993c33e8f43,1,9,0,9,2,2014-05-06 22:33:58,2014-04-30 08:58:07
d8779e1e2536bdd024254af14d2c046bba2bbb01...b2feb643097a1ec0cbe79fc161f604b6265c049b,1,14,50,64,8,2014-04-30 18:00:15,2014-04-30 17:58:10
d8779e1e2536bdd024254af14d2c046bba2bbb01...a0a2f7d79c953b012adcfb0be3f9a60d5efbf644,2,3,3,6,3,2014-04-29 19:43:15,2014-04-28 10:55:22
a0a2f7d79c953b012adcfb0be3f9a60d5efbf644...16fc2b7a9ca54b12b06bb3d677db65e5e64638c5,1,0,1,1,1,2014-04-29 19:43:16,2014-04-28 10:55:23
16fc2b7a9ca54b12b06bb3d677db65e5e64638c5...33c297aacc0ce0f945198fbcdf48fbf2fd27d01b,1,1,1,2,1,2014-04-29 19:43:16,2014-04-28 10:55:24
33c297aacc0ce0f945198fbcdf48fbf2fd27d01b...03b86647722f11ccc321cd7279aa49b811d17cc2,20,86,93,179,65,2014-06-13 18:49:10,2014-06-13 12:19:23
03b86647722f11ccc321cd7279aa49b811d17cc2...626f35c89332059980251f7cdf8e94bc49d68834,3,20,21,41,5,2014-06-13 18:49:38,2014-06-13 12:19:24
626f35c89332059980251f7cdf8e94bc49d68834...ce51bf09f8f0de70673b7cbdbc0e0df0b07e1def,2,2,2,4,2,2014-06-13 18:49:38,2014-06-13 12:19:25
ce51bf09f8f0de70673b7cbdbc0e0df0b07e1def...ad837d9ef9d555ab5077767c8672ff48c6cb562b,1,2,0,2,1,2014-06-13 18:49:38,2014-06-13 12:19:26
ad837d9ef9d555ab5077767c8672ff48c6cb562b...e636a7b4d0304608fe063ffcbbaf99e46f23dbea,4,15,9,24,11,2014-06-13 18:49:38,2014-06-13 12:19:27
e636a7b4d0304608fe063ffcbbaf99e46f23dbea...782a5ff9cec21b6a4f1f09c80d646b27fb100559,1,3,3,6,3,2014-06-13 18:49:38,2014-06-13 12:19:28
782a5ff9cec21b6a4f1f09c80d646b27fb100559...6c306a34eef49beb3db5500f6f29190c799ace4b,2,2,1,3,2,2014-06-13 18:49:38,2014-06-13 12:19:29
6c306a34eef49beb3db5500f6f29190c799ace4b...a5c446f11693b94194f32bad85df050fa1cde9af,1,6,2,8,3,2014-06-13 18:49:39,2014-06-13 12:19:30
a5c446f11693b94194f32bad85df050fa1cde9af...a5400efe29fdaabbe5266d11d255b2ef5a4c3a66,7,20,12,32,13,2014-06-13 18:49:39,2014-06-13 12:19:31
a5400efe29fdaabbe5266d11d255b2ef5a4c3a66...d0cfc3e866a77eed98ab2caf41a39a87837950e6,5,18,24,42,12,2014-06-13 18:49:39,2014-06-13 12:19:32
d0cfc3e866a77eed98ab2caf41a39a87837950e6...e6c286e8b2d0748cfaa670f6738db0c232427cd3,4,8,7,15,5,2014-06-13 18:49:39,2014-06-13 12:19:33
e6c286e8b2d0748cfaa670f6738db0c232427cd3...d4a2024aef90fa5dd2b0e5027f9340719ff20748,6,11,3,14,10,2014-06-13 18:49:39,2014-06-13 12:19:34
d4a2024aef90fa5dd2b0e5027f9340719ff20748...e93021b20a73af8ff51f9ddd8c98f44fd103f360,3,6,2,8,6,2014-06-13 18:49:39,2014-06-13 12:19:35
e93021b20a73af8ff51f9ddd8c98f44fd103f360...5fc2fc8fa22312efca46ed5321fa1d3b4d537a72,8,253,5,258,26,2014-06-13 18:49:39,2014-06-13 12:19:36
5fc2fc8fa22312efca46ed5321fa1d3b4d537a72...e0cf0d7de28ee90e1668049e32802a8dbbcc2950,1,2,1,3,1,2014-06-13 18:49:40,2014-06-13 12:19:37
e0cf0d7de28ee90e1668049e32802a8dbbcc2950...045113a53e9e4b2c157040a1b53306d7c932c455,3,21,6,27,8,2014-06-13 18:49:40,2014-06-13 12:19:38
045113a53e9e4b2c157040a1b53306d7c932c455...078a58e825d14987df82af9d19c00ddc8eb82481,7,30,2,32,12,2014-06-13 18:49:40,2014-06-13 12:19:39
078a58e825d14987df82af9d19c00ddc8eb82481...96a1d8d34c16be8fc5acd7ceb4d34573d8e2a76b,2,103,2,105,8,2014-06-13 18:49:40,2014-06-13 12:19:40
96a1d8d34c16be8fc5acd7ceb4d34573d8e2a76b...76b07b37a3fff15ce4852bd070a610b651c42e77,3,84,4,88,8,2014-06-13 18:49:40,2014-06-13 12:19:41
76b07b37a3fff15ce4852bd070a610b651c42e77...ce7c614bceedf0c0169dd5b02cae3e33ee45acdd,3,4,1,5,3,2014-06-13 18:49:41,2014-06-13 12:19:42
ce7c614bceedf0c0169dd5b02cae3e33ee45acdd...b3c96fb158f05152336f167076f5d81d23c3a5e5,3,23,2,25,10,2014-06-13 18:49:41,2014-06-13 12:19:43
b3c96fb158f05152336f167076f5d81d23c3a5e5...c18b80a0e86c4529146e3947454159627f1419a7,5,114,6,120,16,2014-06-13 18:49:41,2014-06-13 12:19:44
c18b80a0e86c4529146e3947454159627f1419a7...a0a967568e8de5306d1889583c4dad0ff937f5ef,1,10,3,13,3,2014-06-13 18:49:41,2014-06-13 12:19:45
a0a967568e8de5306d1889583c4dad0ff937f5ef...a76295da784501f74803053606112f62ccff3828,2,14,0,14,3,2014-06-13 18:49:41,2014-06-13 12:19:46
a76295da784501f74803053606112f62ccff3828...5165dd598a402b25301ea41fa5e0d9a72ad78393,1,2,1,3,1,2014-06-13 18:49:41,2014-06-13 12:19:47
5165dd598a402b25301ea41fa5e0d9a72ad78393...5a092ceb6b285e8377add13d460850668fd0d13c,1,9,0,9,1,2014-06-13 18:49:41,2014-06-13 12:19:48
5a092ceb6b285e8377add13d460850668fd0d13c...d6e3c181bc94e3f540c403eef0515c5eed74fc16,1,9,1,10,3,2014-06-13 18:49:42,2014-06-13 12:19:49
d6e3c181bc94e3f540c403eef0515c5eed74fc16...5b0a78c1c0e15e97133784b342384cdefa17f6fc,1,2,0,2,1,2014-06-13 18:49:42,2014-06-13 12:19:50
5b0a78c1c0e15e97133784b342384cdefa17f6fc...3e52f70b1505956bf91cb7b107e526d1c67da0a6,6,233,2,235,6,2014-06-13 18:49:42,2014-06-13 12:19:51
d8779e1e2536bdd024254af14d2c046bba2bbb01...3f495f67bc4ec744ac60f6e7bec0924022670998,1,6,8,14,4,2014-04-29 19:38:32,2014-04-26 20:00:54
3f495f67bc4ec744ac60f6e7bec0924022670998...70c7bd6dafc83eee7bf76d33d12027224d80f20d,1,25,24,49,12,2014-04-29 19:38:32,2014-04-26 20:00:55
70c7bd6dafc83eee7bf76d33d12027224d80f20d...479bd75751d81b6f3ffc29fcece56f9a200493a1,1,18,8,26,4,2014-04-29 19:38:33,2014-04-26 20:00:56
479bd75751d81b6f3ffc29fcece56f9a200493a1...b892bb45eacb484be281a992bef66ea723210717,1,111,1,112,6,2014-04-29 19:38:33,2014-04-26 20:00:57
b892bb45eacb484be281a992bef66ea723210717...f22166b5fee7dc3deaf44dda31d1b5d7ac1fdfd8,1,3,0,3,1,2014-05-19 20:39:53,2014-05-17 12:16:34
f22166b5fee7dc3deaf44dda31d1b5d7ac1fdfd8...b6e38840921ac4a0fe07e10e632f66736745da10,1,20,11,31,3,2014-05-19 20:39:53,2014-05-17 12:16:35
b6e38840921ac4a0fe07e10e632f66736745da10...24790835738dc098fa6becedc44aac0341b7d5af,1,4,1,5,2,2014-05-19 20:39:53,2014-05-17 12:16:36
24790835738dc098fa6becedc44aac0341b7d5af...85f98fc037ae026596c5d3b5d71fbfaa9144f210,1,27,0,27,1,2014-05-19 20:39:53,2014-05-17 12:16:37
85f98fc037ae026596c5d3b5d71fbfaa9144f210...ab77c309b633ab3afc16e91cbff307c39599d048,1,1,0,1,1,2014-05-19 20:39:54,2014-05-17 12:16:38
ab77c309b633ab3afc16e91cbff307c39599d048...4e4b125c239a78f3a8fe82e47d1f89fef510980c,1,15,1,16,4,2014-05-19 20:39:54,2014-05-17 12:16:39
d8779e1e2536bdd024254af14d2c046bba2bbb01...f515c904fb4d1b95bb8b94cb00fb6b5768cf0ed4,2,28,0,28,6,2014-04-29 18:27:41,2014-04-29 05:41:16
f515c904fb4d1b95bb8b94cb00fb6b5768cf0ed4...8ccc4e42604636a38114fafa976ea9e25a578094,1,45,0,45,1,2014-04-29 19:01:04,2014-04-29 05:41:18
8ccc4e42604636a38114fafa976ea9e25a578094...35ec002cf7921ca76b3dc8bdac5e03a4bb1463c6,1,1,1,2,1,2014-06-10 15:39:06,2014-06-10 04:07:59
a90804752f6ab2b911882d47fafb6c2b78f447c3...662cc30cd048f2ccd7ba8d1540e0768ae264c0dd,4,49,1,50,4,2013-09-20 18:09:51,2013-09-20 10:16:28
84d32bf7678259c08406571cd6ce4b7a6724dcba...f1e2a48d18a458d0431df8fef041bee857adb860,1,3,0,3,1,2013-07-21 22:09:56,2013-07-21 19:54:08
b3b8ceb48b7d75631a8638f1dc6ccdf7f1b53888...4b9ced278cbfd57402c3e9875f4ddf1c31438af8,1,3,3,6,2,2013-06-23 07:35:50,2013-06-19 01:55:22
b3b8ceb48b7d75631a8638f1dc6ccdf7f1b53888...9f48f2bd9ae8db8cdce3a8e2c9b6dc33b2a55ee1,1,2,2,4,1,2013-06-20 22:51:25,2013-06-20 22:36:31
9f48f2bd9ae8db8cdce3a8e2c9b6dc33b2a55ee1...b4dc085a8dc2ec2fb5f6366fa672222b807ed655,2,37,1,38,3,2013-06-20 22:51:35,2013-06-20 22:38:28
b3b8ceb48b7d75631a8638f1dc6ccdf7f1b53888...f7e604ed390cec7b20471f9c03bbc507ebfe41c0,3,3,3,6,3,2013-06-19 18:31:33,2013-06-19 05:37:24
b3b8ceb48b7d75631a8638f1dc6ccdf7f1b53888...c3e2d18996e4ef92f37bf56b2fefe2124d26659e,3,49,3,52,3,2013-06-19 17:54:00,2013-06-19 17:54:00
b3b8ceb48b7d75631a8638f1dc6ccdf7f1b53888...0442743810c6f6c14386a5a9d6bf8e4d69adbc51,1,2,0,2,2,2013-06-14 17:27:54,2013-06-09 08:07:59
0442743810c6f6c14386a5a9d6bf8e4d69adbc51...a8adcc4730339c69d173ea4f10c06d7af4a456b4,1,9,0,9,1,2013-06-14 17:28:16,2013-06-09 08:08:22
a8adcc4730339c69d173ea4f10c06d7af4a456b4...bb3f7ccadb5270e060cfbbb44f9c80a8c65cc449,1,3,0,3,1,2013-06-14 17:29:01,2013-06-09 08:08:45
bb3f7ccadb5270e060cfbbb44f9c80a8c65cc449...296f0b3ea9b904982780522215a9c71d4a7bd02c,1,3,0,3,1,2013-06-14 17:29:04,2013-06-09 08:09:32
296f0b3ea9b904982780522215a9c71d4a7bd02c...5bdc47eb55aabef3720039181fc360499081a29f,1,4,3,7,2,2013-06-21 20:58:06,2013-06-21 18:12:51
14952666d18e5256e1796633e5a927891e77a8de...f07075c297d8a9b58b693176b6ae73dbabcdb103,1,14,0,14,1,2013-06-20 18:25:46,2013-06-18 12:49:29
f07075c297d8a9b58b693176b6ae73dbabcdb103...4cb46bddeb7d21241f8ac5e46eb3d1cee468ea14,2,4,3,7,4,2013-06-20 18:27:03,2013-06-18 12:49:26
a717d9e1d3a8b0b3ab32ece2d2fa88de3a2f2a6f...fada522129c59755f8616f33adad49604db919d8,1,1,1,2,1,2013-05-29 22:21:15,2013-05-29 22:21:15
bf9923171e299fec694153c68f06bfc1650e412d...ecb9f3e73366d020dc97f60c7529c3703aa778e0,1,37,2,39,5,2013-06-05 22:40:37,2013-06-05 22:14:02
680ed3eeb6d6edd4095be43451fb1f73de17927b...de3a5c6da194928868b5eee4a9c4d538b4194727,1,1,1,2,1,2013-05-17 19:19:20,2013-05-17 19:19:20
b2dc09455a9ed5521c2e84fc67d8dacf2c28c39f...49d6cfa5c2874d78360dc4b16558bb45b5f8e003,1,16,16,32,10,2013-08-27 04:39:57,2013-08-26 21:57:18
0c2b1cf812be6e7e35bed0844b37e412cd232b6b...203439b2840c4c384060df2fa192994e4b6740ed,2,62,0,62,4,2013-06-26 16:30:26,2013-06-25 15:53:42
203439b2840c4c384060df2fa192994e4b6740ed...e02ca72f70ed8f0268a81f72cb3230c72e538e77,5,111,51,162,18,2013-06-26 16:59:00,2013-06-25 15:53:43
e02ca72f70ed8f0268a81f72cb3230c72e538e77...ad66df2df14991e7436474d266cc6db823e6ae78,2,9,55,64,5,2013-06-26 18:13:50,2013-06-25 15:53:44
ad66df2df14991e7436474d266cc6db823e6ae78...39598f9983f759b5e38b9e762c695bad6c89a1b3,6,24,29,53,22,2013-06-26 18:16:48,2013-06-25 15:53:45
39598f9983f759b5e38b9e762c695bad6c89a1b3...e9a820cefde2170840fbcdf7c4b74369988869dc,3,10,13,23,8,2013-06-26 18:22:06,2013-06-25 15:53:46
e9a820cefde2170840fbcdf7c4b74369988869dc...396049e5fb62ea921379d02133e1ff00cc47bb3f,1,45,19,64,14,2013-06-26 18:25:11,2013-06-25 15:53:47
396049e5fb62ea921379d02133e1ff00cc47bb3f...17696002086e8c6b9e998543d212e707c7d511ab,2,60,7,67,10,2013-06-26 18:25:11,2013-06-25 15:53:48
17696002086e8c6b9e998543d212e707c7d511ab...1b8fd46732fc2e4e8300c11057a7fa9a8c2bc1b4,2,44,9,53,12,2013-06-26 18:25:11,2013-06-25 15:53:49
1b8fd46732fc2e4e8300c11057a7fa9a8c2bc1b4...7a9b0b802ecf5a09502b46de27c07ff05f55b247,2,81,9,90,10,2013-06-26 18:25:11,2013-06-25 15:53:50
7a9b0b802ecf5a09502b46de27c07ff05f55b247...9f93e4611f72577306e369a64d0a4da847be9751,1,427,29,456,11,2013-06-26 18:25:11,2013-06-25 15:53:51
0c2b1cf812be6e7e35bed0844b37e412cd232b6b...4f4e7e9b62b0e38dec2ea58b66f766a825539c3d,1,3,0,3,1,2013-05-16 16:29:26,2013-05-16 10:04:05
4f4e7e9b62b0e38dec2ea58b66f766a825539c3d...3244eb9b5a6f0b5a06d20c06dbb34739fa3b043a,1,6,2,8,2,2013-05-16 19:01:31,2013-05-15 22:28:39
3244eb9b5a6f0b5a06d20c06dbb34739fa3b043a...629b60a77d0bca1358af666605548acc4dcc5841,1,0,3,3,1,2013-05-16 22:54:18,2013-05-16 12:43:15
9249175291a00f4984f87107119a3e11e0a092a6...8d97506e4b972f11ab918bfaaebe036111b249dc,1,1,1,2,1,2013-05-11 19:51:19,2013-05-11 13:25:52
be4c828b761a7c65edcff75b008051b6d027e64a...3ef2bcad02efd6219f4ce599754c15e63b6af0dc,4,98,14,112,4,2013-07-30 15:53:24,2013-07-30 01:28:30
3ef2bcad02efd6219f4ce599754c15e63b6af0dc...c984938f9c454255012086e1203504dc243a59bd,1,3,1,4,2,2013-08-05 17:47:00,2013-08-05 15:59:22
c984938f9c454255012086e1203504dc243a59bd...f2be034c6918e7f5d42da5ad1cf9d3ef51c25a77,1,10,10,20,2,2013-08-05 18:01:09,2013-08-05 15:59:23
6035d6aad8ca11954c0d7821f6f3e7c047039c8f...4727f671b834a565343ed1af613654ba4d6ececc,1,5,5,10,5,2013-09-18 18:11:53,2013-09-18 13:41:18
6035d6aad8ca11954c0d7821f6f3e7c047039c8f...920734b069b269937b25a692d21c1623cbaec4b0,1,1,2,3,1,2013-05-28 15:07:03,2013-05-26 01:16:16
920734b069b269937b25a692d21c1623cbaec4b0...c6807a40dcd29f7e5ad1e2f4fc44f1729c9afa11,9,94,15,109,36,2013-05-28 15:07:20,2013-05-26 01:16:17
9526aa461f6c6900cb892a6fe248150ad436c0d5...d2949c7b3c8a2f0d2cb5c61d99017a1a85a46264,1,27,1,28,3,2013-04-19 20:53:44,2013-04-19 20:53:44
5bda18c186e455f8e65f976d3bf333ab1f4b5b53...3ba40b45d8db66c72ed38aa36afac1cd48c05534,1,5,5,10,5,2013-04-11 23:07:22,2013-04-11 18:53:22
5bda18c186e455f8e65f976d3bf333ab1f4b5b53...fdae191003381b1e2026422ffbd580ba39f1ab91,1,9,0,9,1,2013-04-11 14:33:07,2013-04-11 03:32:11
fdae191003381b1e2026422ffbd580ba39f1ab91...3813a33de5f9e8224eb2bd2ebae167b3bb00ef73,1,55,0,55,1,2013-04-11 14:33:21,2013-04-11 03:36:13
5bda18c186e455f8e65f976d3bf333ab1f4b5b53...13cb3bb7e6e69fbd82db460f1d23ccb2111e8b63,1,4,1,5,1,2013-04-09 22:12:28,2013-04-09 21:48:36
13cb3bb7e6e69fbd82db460f1d23ccb2111e8b63...59a7714c8909f1a925a7faa4f3015f015c087ee5,1,3,1,4,2,2013-04-12 00:38:45,2013-04-10 17:49:57
59a7714c8909f1a925a7faa4f3015f015c087ee5...200732744a32a378b636da4d840aeb410adfb2ad,4,10,16,26,4,2013-04-12 00:39:05,2013-04-11 02:07:04
200732744a32a378b636da4d840aeb410adfb2ad...3a51467b94306e77c1b69b374bac33b6672bc177,2,3,3,6,3,2013-04-12 00:39:05,2013-04-13 16:47:21
aacecc3b36a6cd4d2707e3f1cbd7bb4122477c64...ab5f42422d7e025c3151d91cc5ec0d20b9a80922,2,14,1,15,2,2013-04-28 18:53:41,2013-04-27 13:40:33
3322ad428446b2d54e95b50fc70abc1ece1f4069...dd686cd4b127248bd99b9337fe537626ff902d37,1,6,0,6,1,2013-04-03 15:33:56,2013-04-03 14:27:14
3322ad428446b2d54e95b50fc70abc1ece1f4069...ed1ca6025f965360e42ece66dcbc78bf0c2099a9,1,2,0,2,1,2013-03-31 22:19:52,2013-03-31 22:19:52
ed1ca6025f965360e42ece66dcbc78bf0c2099a9...a6a3f2cc0761a347e8796280a1544e2a0d08cb51,2,8,1,9,3,2013-03-31 22:57:42,2013-03-31 22:24:12
d011ab4312a8ddabd143567fa9706b8e9fb9c0a4...9a82efd0d2a2727507bd908d7f0545437fcc0ff6,1,3,0,3,1,2013-03-27 17:57:57,2013-03-27 17:57:57
8d44277d91989ad2b37d4908096bd5256d6390c4...5e2485846dacb5acd3b6cd084e246c7c9a6d5a13,1,1,1,2,1,2013-03-01 18:19:22,2013-03-01 17:23:57
8d44277d91989ad2b37d4908096bd5256d6390c4...46e1d6eb4dcdd2952149fae214aeaa32f29c8df5,1,20,21,41,9,2013-02-28 21:53:00,2013-02-28 21:53:00
a1d68bea891118bdaecb6dd77610e6daf2f7d53d...02339dd5295d7add78ab409300b985e5888af0ee,1,9,0,9,3,2013-02-14 18:43:07,2013-02-14 18:43:07
02339dd5295d7add78ab409300b985e5888af0ee...30784198b766b19a639c199e4365f2a805fc08c6,1,1,1,2,1,2013-02-14 23:51:43,2013-02-14 23:51:43
895c5ba3c1c927c68e581ebb0e13d9a123e477ab...2ac5e4470b7a17303b10ba539d8aa84e870bade9,2,23,8,31,6,2014-01-15 23:48:58,2014-01-15 23:38:01
2ac5e4470b7a17303b10ba539d8aa84e870bade9...a74352867e689d50ee9c368f24d4a64392e27a35,2,13,6,19,7,2014-01-15 23:53:51,2014-01-15 20:26:13
35f5eaa2eedcd7145ee59ff5ff2cb48e71270b81...1158826394e162c5d45a4043ea86b04b24215555,2,56,5,61,12,2013-07-30 19:23:31,2013-07-30 19:06:01
1158826394e162c5d45a4043ea86b04b24215555...e6b722db099f435f21ce72b18f0d61dc3c778f1f,1,12,15,27,10,2013-07-30 19:31:27,2013-07-30 19:31:27
c7e2be6e881e82bc877f2561ed5735defe4e37bd...e7a3c902a6720253097d2ae27e79d3c830e96142,1,77,78,155,49,2013-05-01 22:25:24,2013-04-29 19:15:04
e7a3c902a6720253097d2ae27e79d3c830e96142...de0977d528055bac8a3ae666652f16bf39363ddc,1,16,3,19,3,2013-05-01 22:32:24,2013-05-01 22:32:24
aa7b8c657e407a10cbee728264ec48be16ea4e3d...1d77d249f9b0605ed21ca751c5dfb8550efcdfa3,1,16,3,19,1,2013-04-05 17:42:58,2013-04-05 15:19:41
6a38ef2ced55f0a8a7967581934e40f79e1d8733...62901179cfbb86e31a4bed098cee9734a701912b,1,4,8,12,1,2013-04-12 15:11:20,2013-04-12 03:53:01
f7d8e3d01f46ecfa5b4bc8c13640831d97a78236...29ed5489af4e2d4ecae0ecb005037df1169c9ff8,1,99,0,99,1,2012-11-26 21:43:21,2012-11-26 05:35:57
f7d8e3d01f46ecfa5b4bc8c13640831d97a78236...18fa13d0b34b6243d3679ea78325ee33ee4d0989,1,26,9,35,3,2012-11-26 18:59:08,2012-11-23 22:35:34
18fa13d0b34b6243d3679ea78325ee33ee4d0989...249da4c0dcd0534f416e2d5da0a9923c6068e492,2,55,1,56,3,2012-11-26 18:59:57,2012-11-23 22:35:35
249da4c0dcd0534f416e2d5da0a9923c6068e492...78189bead3f5fde22ae651d66208a0e0a375a819,2,43,8,51,4,2012-11-26 19:00:34,2012-11-23 22:35:36
78189bead3f5fde22ae651d66208a0e0a375a819...e6777fde8d0ede84202ed1cc5ec0a175e0e52ab0,1,12,0,12,1,2012-11-26 19:00:49,2012-11-23 22:35:37
e6777fde8d0ede84202ed1cc5ec0a175e0e52ab0...a4e9054cfbd869f96720e5ba4ce4d3a50e17141e,1,1,1,2,1,2012-11-26 19:01:04,2012-11-23 22:35:38
a4e9054cfbd869f96720e5ba4ce4d3a50e17141e...73350fb6aa7d0caf6c0e3ab06b73771b282de39d,1,0,1,1,1,2012-11-26 19:01:31,2012-11-23 22:35:39
fb1c85d2e9777f620ba39e4c2552873bfb4b47f0...0da7a53a76b48ea1b2ee6ebe7bd7fbcd7d5c3f9d,1,7,0,7,1,2013-07-12 19:04:44,2013-07-12 17:49:34
252f922b1919db3bcfdc07bbedff7d3c42172959...18499ba694711c02a5bc729b7f8e362dd760b10a,1,0,1,1,1,2012-12-19 18:24:23,2012-12-19 18:15:25
98aa2eabf047d673447b72f4b4ac6cae6aae3a16...3def06e625099907fb44c519611188904b6937a2,1,1,1,2,1,2013-07-19 18:15:17,2013-07-18 21:35:26
3def06e625099907fb44c519611188904b6937a2...1f976bd03f26b70dfbb26b3f9478df09709db966,1,1,1,2,1,2013-07-19 18:15:17,2013-07-18 21:35:27
1f976bd03f26b70dfbb26b3f9478df09709db966...f893b7420cdf085dfde809d4ea97cb8c03b81c94,2,16,1,17,2,2013-07-19 18:15:17,2013-07-19 17:59:36
fef11965da875c105c40f1a9550af1f5e34a6e62...81670e9bfcd8a24410cf16f4362c720f950f61d4,2,8,2,10,2,2012-12-21 18:35:53,2012-12-21 18:05:28
fef11965da875c105c40f1a9550af1f5e34a6e62...2e900297dbb9d5bd086ea56eed07027374759791,2,7,1,8,3,2012-12-15 19:19:02,2012-12-15 19:19:02
a469a1019352b8efc4bd7003b0bd59eb60fc428c...9798f7e5f948b2586c33d850f6a00d4fc0537d75,1,5,5,10,2,2013-02-08 16:22:28,2013-02-08 15:09:28
a469a1019352b8efc4bd7003b0bd59eb60fc428c...5ded807f7c0be10ecbb31555e5d10dee553752d6,3,3,3,6,3,2013-01-16 20:47:46,2013-01-16 18:09:29
bdd478d620034dc6517aea940f5dc6b88f780c04...f538a91e3c58bb0882be895eec099e51a74dfac4,1,125,29,154,11,2013-01-14 16:55:36,2013-01-10 22:53:46
bdd478d620034dc6517aea940f5dc6b88f780c04...e1cdf63316348332e4e267aeaab5b510beae0227,1,33,10,43,4,2012-12-18 19:04:52,2012-12-17 06:45:01
e1cdf63316348332e4e267aeaab5b510beae0227...00bb4378c788a6bd6e4fdbca1f9f70ec8c2fe30c,1,8,0,8,1,2012-12-18 19:07:44,2012-12-17 06:45:02
bdd478d620034dc6517aea940f5dc6b88f780c04...8f26aa44afab5455c911c9e15dd610758113d21c,2,1,15,16,4,2012-12-18 17:08:41,2012-12-18 15:26:37
8f26aa44afab5455c911c9e15dd610758113d21c...96a4647fca54031974cd6ad1971e85848a5269fd,2,15,2,17,4,2012-12-19 00:12:04,2012-12-18 15:26:38
96a4647fca54031974cd6ad1971e85848a5269fd...1a59d881dee5c3cd691c522b27b6f6a88fa31326,1,5,5,10,5,2012-12-19 00:12:21,2012-12-18 15:26:39
bdd478d620034dc6517aea940f5dc6b88f780c04...31d66aa4084cb292b15cfdcd6ff73f22f45ab9af,1,5,1,6,1,2012-12-18 16:46:15,2012-12-18 10:47:09
bdd478d620034dc6517aea940f5dc6b88f780c04...2581ad5e85f6443b0d2cf6898793662aec47ef10,1,4,4,8,2,2012-12-18 01:28:19,2012-12-17 22:56:23
2581ad5e85f6443b0d2cf6898793662aec47ef10...30825178fb72e3664bd1bda7c02c62e300e2e5ce,5,72,4,76,9,2012-12-18 01:30:04,2012-12-17 22:56:49
bdd478d620034dc6517aea940f5dc6b88f780c04...38ecf3a35d4255368a24ca255daf0b1ea433f1e3,2,45,20,65,3,2012-12-18 01:21:22,2012-12-18 00:28:45
38ecf3a35d4255368a24ca255daf0b1ea433f1e3...8f3cab2b4d7b6da8b69eea730e5774dcb208c50f,1,5,2,7,2,2012-12-18 01:21:24,2012-12-18 00:28:47
8f3cab2b4d7b6da8b69eea730e5774dcb208c50f...e9263e458055ab361a7292adc800d3e62b47b39f,2,24,20,44,12,2012-12-18 01:21:26,2012-12-18 00:28:48
bdd478d620034dc6517aea940f5dc6b88f780c04...6a5b6498837e43d1904f12eed9d47b47250680f1,1,8,0,8,1,2012-12-17 02:30:50,2012-12-16 19:35:59
6a5b6498837e43d1904f12eed9d47b47250680f1...a26fd033af23389cd6e17d078007aaec61b5c9c1,2,8,13,21,2,2012-12-17 02:30:53,2012-12-16 19:36:00
bdd478d620034dc6517aea940f5dc6b88f780c04...f430ed8b9991769073bf3095702f8e8801b365fc,3,3,3,6,3,2012-12-17 01:59:07,2012-12-16 14:00:29
bdd478d620034dc6517aea940f5dc6b88f780c04...a041c9c752c9294da695fcad909779b4c55dab53,1,0,2,2,1,2012-12-16 19:57:41,2012-12-16 08:42:49
bdd478d620034dc6517aea940f5dc6b88f780c04...779d7e93773a0dcf918dc77023511fdc68161bd8,1,3,1,4,1,2012-12-16 06:22:53,2012-12-14 15:37:47
779d7e93773a0dcf918dc77023511fdc68161bd8...71ce415dc088f19a0b8d6c8567dfdd6d851842b2,1,2,3,5,1,2012-12-16 06:24:10,2012-12-16 06:24:10
bdd478d620034dc6517aea940f5dc6b88f780c04...6ede720529b00115abe46b8ab524bf06c58047e2,3,13,0,13,5,2012-12-15 18:13:23,2012-12-14 19:56:58
6ede720529b00115abe46b8ab524bf06c58047e2...110d6985463886ecc53dbafe32e626704ec612cb,2,11,0,11,2,2012-12-15 18:15:45,2012-12-14 19:56:59
110d6985463886ecc53dbafe32e626704ec612cb...b3e103dabeb01555f8766b74de73493f7a6ba048,3,14,1,15,5,2012-12-15 18:17:39,2012-12-14 19:57:01
b3e103dabeb01555f8766b74de73493f7a6ba048...b2d05e0653f29a75b57260c4d963d560ad65691b,3,6,10,16,4,2012-12-20 02:57:46,2012-12-18 17:35:33
bdd478d620034dc6517aea940f5dc6b88f780c04...f0cb2f137c6e399bab1be92c7cc8e3e08bd36c4f,1,5,8,13,1,2012-12-14 00:19:45,2012-12-14 00:19:45
7cd895e59e6a3322551b6c0b1cbe6b6aeb85f06e...21ccebec0dd1d7e624ea2f22af6ac93686daf34f,1,12,0,12,2,2013-04-05 21:19:57,2013-04-05 21:19:57
a46221e9adcf3deb88c4fc904859205bf87f784c...f2de0b97935da2ba3ccb627457e5fa3fc4e11287,1,4,0,4,1,2013-04-16 22:01:30,2013-04-16 20:33:25
a46221e9adcf3deb88c4fc904859205bf87f784c...79de45588c2d90591a2bc0fcf28964bce642fd71,1,1,10,11,3,2013-04-15 18:04:52,2013-04-15 17:46:56
79de45588c2d90591a2bc0fcf28964bce642fd71...3ab501209b46e83a377ac5a781a8f2fef7f4f30c,1,10,10,20,6,2013-04-15 18:06:15,2013-04-15 17:47:50
3ab501209b46e83a377ac5a781a8f2fef7f4f30c...d5fa1f1a69f578831179b77893aac480b986e875,31,68,68,136,62,2013-04-15 18:08:37,2013-04-15 17:49:04
d5fa1f1a69f578831179b77893aac480b986e875...57148ebb30fd7ed72acf7b3fc6f59d7cf2d94643,1,10,23,33,6,2013-04-15 18:10:36,2013-04-15 17:50:07
a46221e9adcf3deb88c4fc904859205bf87f784c...4698c8feb1bb56497215e0c10003dd046df352fa,5,22,15,37,13,2013-04-15 14:26:50,2013-04-12 21:03:18
a46221e9adcf3deb88c4fc904859205bf87f784c...0d2f7d1c5ef20a6872ce1eacb054c576bb048057,1,5,8,13,1,2013-04-15 14:25:46,2013-04-12 22:20:48
0d2f7d1c5ef20a6872ce1eacb054c576bb048057...1a39b7278712dbdaa27de303c670134e750c345d,1,7,0,7,1,2013-04-17 22:18:12,2013-04-16 22:26:00
a46221e9adcf3deb88c4fc904859205bf87f784c...38b074de80759c95fec20b0dbc30614caccdfd24,1,4,4,8,4,2013-04-15 06:30:21,2013-04-14 16:34:56
38b074de80759c95fec20b0dbc30614caccdfd24...002d4ce8aa40644698721d59691d38f1df702f4b,1,5,5,10,1,2013-04-15 06:30:57,2013-04-14 19:38:21
a46221e9adcf3deb88c4fc904859205bf87f784c...96c4f4a370591b4796628abe18f27f0133b21954,2,51,10,61,15,2013-04-14 04:50:54,2013-04-09 06:52:56
96c4f4a370591b4796628abe18f27f0133b21954...66eb375d3d334efa3f467775a5f2a647c131c4b1,1,41,19,60,13,2013-04-14 05:15:42,2013-04-13 06:25:49
66eb375d3d334efa3f467775a5f2a647c131c4b1...a84b794ad0622103cae98639d7176b2451dc6f92,2,112,58,170,12,2013-06-07 17:02:12,2013-04-13 18:56:41
d099b7173dabdeeb1f339151ac2169b3a91bf631...062aeee8aa426468817c5bea96d781289b272ced,3,3,34,37,6,2013-08-02 16:29:30,2013-08-02 16:29:30
43d11f4492ebafdabd3fb0c9bcab49d2731e4676...296fa99334ff9fc0ca1ea01bce5f53d7ae248d5f,1,2,0,2,1,2013-07-01 16:52:25,2013-07-01 16:20:35
296fa99334ff9fc0ca1ea01bce5f53d7ae248d5f...f66d000b0d7d6d3c858f3aacd9a67d4809ac8011,1,3,3,6,1,2013-07-01 16:53:00,2013-07-01 16:20:36
7d3ccdffb5d28970dd7a4d177cfcca690ccd0c22...c30754f188a4f1bcd35d81d898086fea33524bd6,1,3,1,4,2,2013-05-13 06:20:07,2013-05-12 11:56:35
c30754f188a4f1bcd35d81d898086fea33524bd6...1224f3d0f1b47fc640e76b053f25d91e3ca84bcf,1,1,1,2,1,2013-05-13 06:20:07,2013-05-12 11:56:36
1224f3d0f1b47fc640e76b053f25d91e3ca84bcf...f5f758a5df470352ed46863288551f25fe9c7ea7,1,7,0,7,1,2013-05-13 06:20:07,2013-05-12 11:56:37
f5f758a5df470352ed46863288551f25fe9c7ea7...a1549e1049439386b9fd643fae236ad3ba649650,2,11,6,17,5,2013-05-13 06:20:07,2013-05-12 11:56:38
a1549e1049439386b9fd643fae236ad3ba649650...15d4bf2e1e4f9853a17a86eb923b55d41da22d54,1,5,4,9,6,2013-05-13 06:20:07,2013-05-12 11:56:39
7d3ccdffb5d28970dd7a4d177cfcca690ccd0c22...1bc6d022b731e4cf69de42fea75c5f6366d2dbae,1,2,4,6,1,2013-05-08 04:46:11,2013-05-07 21:55:01
1bc6d022b731e4cf69de42fea75c5f6366d2dbae...c8a81e90acda9da55bae627928e80b04e98980fc,1,23,16,39,5,2013-05-08 16:15:37,2013-05-07 21:55:02
c8a81e90acda9da55bae627928e80b04e98980fc...89d5dd4e2f47186687d70223847cec8ec3fb16dd,1,1,1,2,1,2013-05-08 16:15:37,2013-05-07 21:55:03
89d5dd4e2f47186687d70223847cec8ec3fb16dd...f58dc19e571bea9b7b079041198c21ec15ac3cea,1,8,0,8,5,2013-05-08 16:15:37,2013-05-07 21:55:04
f58dc19e571bea9b7b079041198c21ec15ac3cea...723b74ee3e09bfb19b43218da19c52f805bb69ae,1,13,0,13,1,2013-05-08 16:15:37,2013-05-07 21:55:05
723b74ee3e09bfb19b43218da19c52f805bb69ae...1ef2d8dacc992b98444170ea9ee17de417433146,1,1,1,2,1,2013-05-08 16:15:37,2013-05-07 21:55:06
1ef2d8dacc992b98444170ea9ee17de417433146...b5f769a0d71bc3f13f916db849ef6b4768359c4e,1,2,3,5,3,2013-05-08 16:15:37,2013-05-07 21:55:07
b5f769a0d71bc3f13f916db849ef6b4768359c4e...e883a057a9da3c738dd6f6e2f1aa9498885ae1e8,1,1,1,2,1,2013-05-08 16:15:37,2013-05-07 21:55:09
e883a057a9da3c738dd6f6e2f1aa9498885ae1e8...128fd54daeff23fbef0d0b7ec1a31f38d0803f63,1,19,11,30,6,2013-05-08 19:13:04,2013-05-07 21:55:10
128fd54daeff23fbef0d0b7ec1a31f38d0803f63...83d16bc7bec92ea3f705f559c5a13589cb7c1f92,1,4,5,9,2,2013-05-08 19:13:12,2013-05-07 21:55:11
83d16bc7bec92ea3f705f559c5a13589cb7c1f92...7a0a49a7ca787433255280b66e7652b56f7beb6e,1,23,19,42,2,2013-05-08 19:13:12,2013-05-07 22:04:30
7a0a49a7ca787433255280b66e7652b56f7beb6e...cdfd94837b27c220f70f032b596ea993d195488f,5,28,0,28,7,2013-05-08 19:13:12,2013-05-07 22:04:31
cdfd94837b27c220f70f032b596ea993d195488f...1f27e7d56b65fdc232a5a2a4de2ee97ff5eb176b,1,7,5,12,2,2013-05-08 19:13:12,2013-04-30 21:49:11
7d3ccdffb5d28970dd7a4d177cfcca690ccd0c22...e6812cfa9aba69a8c9d83b0710291b27bff0f7a3,1,9,6,15,4,2013-05-07 14:03:01,2013-05-05 22:38:53
e6812cfa9aba69a8c9d83b0710291b27bff0f7a3...47bd9bf82daeac71b28a5a697ecc44e70b205e18,1,6,1,7,2,2013-05-07 14:03:01,2013-05-05 22:38:54
47bd9bf82daeac71b28a5a697ecc44e70b205e18...45c5d4a56bc3ef3b5088a07bdab12cef8163e61d,2,2,2,4,2,2013-05-07 23:20:40,2013-05-05 22:38:52
e2af9e361b1d7452492baa073790b19292f9c038...7655fa7fa9f58503f21e2354f4a12fd949efa712,1,6,1,7,2,2013-04-12 17:43:20,2013-04-10 09:08:18
7655fa7fa9f58503f21e2354f4a12fd949efa712...cdbff7d6ad3c1c3e8c9dbd1cbd5c43fa240982be,1,2,1,3,2,2013-04-12 17:44:53,2013-04-10 06:57:51
cdbff7d6ad3c1c3e8c9dbd1cbd5c43fa240982be...0285118e593833be90b3f025d70dde432c1859e7,1,0,21,21,19,2013-04-12 17:45:53,2013-04-10 06:57:52
0285118e593833be90b3f025d70dde432c1859e7...1ce23aad3446c8a423cd4ec4de1b91361cdf4a85,1,8,5,13,4,2013-04-15 06:18:58,2013-04-10 06:57:53
1ce23aad3446c8a423cd4ec4de1b91361cdf4a85...43369a22588373b987d427a937b761bb04817e4d,1,60,0,60,2,2013-04-15 06:18:58,2013-04-10 06:57:54
43369a22588373b987d427a937b761bb04817e4d...7d13e0a3afbc9d2f58a32ec27391a947e58e382c,2,13,8,21,6,2013-04-15 06:18:58,2013-04-10 06:57:55
7d13e0a3afbc9d2f58a32ec27391a947e58e382c...b4cfbc969cd910992a08b12dc612d19323668e09,1,11,15,26,2,2013-04-15 06:18:58,2013-04-10 06:57:56
b4cfbc969cd910992a08b12dc612d19323668e09...ddc996d767025a4ffcb52a813d32a5095f357e44,1,4,4,8,2,2013-04-15 06:18:58,2013-04-10 06:57:57
961c5129d53554d4d71003899fab8dda846d7c2a...15f7d4943807a50e01d2fd85bcdbd44361808dd2,1,7,1,8,3,2013-04-03 00:58:24,2013-04-02 22:39:49
15f7d4943807a50e01d2fd85bcdbd44361808dd2...65f98358c0ca5917604d3eb59b80ce14f72c2c7c,1,8,2,10,4,2013-04-03 01:01:31,2013-04-02 22:39:50
65f98358c0ca5917604d3eb59b80ce14f72c2c7c...002b726a400a1dea16c0b59ae61527a1e55799fb,1,33,3,36,2,2013-04-03 01:09:30,2013-04-02 22:39:51
002b726a400a1dea16c0b59ae61527a1e55799fb...73903d0bcb00518e508f412a1d5c482b5094587e,1,3,1,4,1,2013-04-03 01:11:08,2013-04-02 22:39:48
73903d0bcb00518e508f412a1d5c482b5094587e...a133737b809a6556f087e590e862e8f29561710a,1,21,7,28,6,2013-04-03 14:43:29,2013-04-02 22:39:52
961c5129d53554d4d71003899fab8dda846d7c2a...8a3e5ecdaa9fc45d7af58eb95bba0f39ca625a8d,1,12,0,12,1,2013-04-02 23:14:06,2013-04-02 19:02:53
8a3e5ecdaa9fc45d7af58eb95bba0f39ca625a8d...e2b6aa5f1b85d5f49f0cf280162cf216e55e1eba,1,5,2,7,3,2013-04-02 23:14:08,2013-04-02 19:03:55
e2b6aa5f1b85d5f49f0cf280162cf216e55e1eba...a5e91c722cceb667ad05a13f9fde150cc1dbe9aa,1,6,1,7,3,2013-04-02 23:14:10,2013-04-02 19:04:27
a5e91c722cceb667ad05a13f9fde150cc1dbe9aa...1a15d00bb910de0a86981f0d75836feac71d1fe0,1,5,5,10,5,2013-04-02 23:14:12,2013-04-02 19:04:51
1a15d00bb910de0a86981f0d75836feac71d1fe0...caa2036b3b4105bfe34f01115e4fb34b78a4db86,3,20,2,22,6,2013-04-02 23:14:13,2013-04-02 19:05:12
0f3d66c6dc0c6915888fbf928de0ae22739abc70...c17b651f1919a43f458f909d05c92d5f099ccc8b,1,20,0,20,3,2013-04-07 21:40:26,2013-04-07 21:40:26
64948ad77534f035311fd3e1086477661c8f63b1...627a8b8dcda6b6fd3946b2b5964c9154c410f518,4,47,37,84,4,2013-08-13 16:01:52,2013-08-09 17:28:53
627a8b8dcda6b6fd3946b2b5964c9154c410f518...52f425e1a9ab8b0ae572d06fe2a1b428f741ef4a,1,7,33,40,5,2013-08-13 16:01:54,2013-08-09 20:01:48
64948ad77534f035311fd3e1086477661c8f63b1...c189c4f2c42083b329605fb7b0583b29b73da086,1,2,2,4,2,2013-08-09 19:05:16,2013-08-08 18:31:44
c189c4f2c42083b329605fb7b0583b29b73da086...3b0c18af5c545c93bf33b53d467b887e9733c0c6,1,1,1,2,1,2013-08-09 19:07:36,2013-08-08 22:11:53
3b0c18af5c545c93bf33b53d467b887e9733c0c6...f8aae0b51743d5e5f35292caee41e5215b0e5bad,1,17,21,38,6,2013-08-09 19:14:02,2013-08-08 17:52:41
b48493e937bb46d352336e2918e37120fe1d352d...52f0856a7bf06cf278ce1404a5d80070f327eee1,1,6,5,11,1,2013-08-12 06:16:59,2013-08-09 22:38:03
52f0856a7bf06cf278ce1404a5d80070f327eee1...3baacc5cc6e4c2ed6184a7c5d9e10299999498dd,1,12,0,12,1,2013-08-12 06:17:10,2013-08-09 22:38:04
b48493e937bb46d352336e2918e37120fe1d352d...33f66b25e1880db9d5b2f665b42d5e867d118b38,1,1,1,2,1,2013-08-09 22:33:02,2013-08-09 17:13:07
5ce922a014f78684a96c3d03a51decf0d21fa58d...9ae9ca1f95ccd3b4c1d62d856eb8b48fdff7c2d5,1,2,3,5,2,2013-08-13 16:08:58,2013-08-09 21:39:54
9ae9ca1f95ccd3b4c1d62d856eb8b48fdff7c2d5...db8cae7e6035dd56970c88ac9e34bce1baa0f665,1,20,5,25,7,2013-08-13 16:09:01,2013-08-09 21:39:55
db8cae7e6035dd56970c88ac9e34bce1baa0f665...4c70cfbfbc2da8d0e4f94b73e37b4020704a498b,1,5,6,11,3,2013-08-13 16:09:03,2013-08-09 21:39:56
118f60ee06612083ff4f1810424e80a3e896f73e...f989cac9581ee423457c02f67d6bf31348ae6b56,2,30,0,30,2,2013-04-23 16:09:44,2013-04-22 21:02:29
118f60ee06612083ff4f1810424e80a3e896f73e...3473ecd7ffc97d45ebed7374e129da16eb4e1357,2,2,2,4,2,2013-04-22 22:25:53,2013-04-22 21:55:09
3473ecd7ffc97d45ebed7374e129da16eb4e1357...e5ea5e7547fbb042b6d2ed04b73ff92d7543f672,1,2,0,2,1,2013-04-22 22:25:53,2013-04-22 21:55:10
e5ea5e7547fbb042b6d2ed04b73ff92d7543f672...846cc77676df59d3f7962de95851ff498e273432,1,5,4,9,3,2013-04-22 22:25:53,2013-04-22 21:55:11
846cc77676df59d3f7962de95851ff498e273432...7e31e1fea5c827f392babacef1c8783313eb19c9,1,4,0,4,1,2013-04-22 22:25:53,2013-04-22 21:55:12
7e31e1fea5c827f392babacef1c8783313eb19c9...aeebca0bd280a67003545d36f1886bfdcd9318fe,1,8,3,11,2,2013-04-22 22:25:53,2013-04-22 21:55:13
aeebca0bd280a67003545d36f1886bfdcd9318fe...299789c22c9676f6fed77716c7a177e49940d389,1,7,3,10,5,2013-04-22 22:25:54,2013-04-22 21:55:14
299789c22c9676f6fed77716c7a177e49940d389...68d4f4f3e952f63d256dd11b1336a3782d8c1226,1,32,1,33,2,2013-04-22 22:25:54,2013-04-22 21:55:15
68d4f4f3e952f63d256dd11b1336a3782d8c1226...e1760f8c2c355dffeade3c271c4ae875e2659dae,1,4,2,6,2,2013-04-22 22:25:54,2013-04-22 21:55:16
e1760f8c2c355dffeade3c271c4ae875e2659dae...a2f7b6f8a9775df0994a161f5e9e103b60886dc7,1,3,1,4,1,2013-04-22 22:25:54,2013-04-22 21:55:17
a2f7b6f8a9775df0994a161f5e9e103b60886dc7...a2e462c5b50c6072e478d434b3892c9f7155a084,2,12,6,18,7,2013-04-22 22:25:54,2013-04-22 21:55:18
a2e462c5b50c6072e478d434b3892c9f7155a084...891122266fc6836cb8a8ebf77d75aa6c9306a04c,1,7,1,8,2,2013-04-22 22:25:55,2013-04-22 21:55:19
891122266fc6836cb8a8ebf77d75aa6c9306a04c...7c0580586f04eaccce75a3cf6659209b015ce04c,1,3,0,3,1,2013-04-22 22:25:55,2013-04-22 21:55:20
7c0580586f04eaccce75a3cf6659209b015ce04c...b0f6c5835dd298106a286cac83abe4e8cee02567,1,17,8,25,11,2013-04-22 22:25:55,2013-04-22 21:55:21
b0f6c5835dd298106a286cac83abe4e8cee02567...1a2636c297675735639c3cfee2ed15520fd678c9,1,2,1,3,2,2013-04-22 22:25:55,2013-04-22 21:55:22
1a2636c297675735639c3cfee2ed15520fd678c9...97253a233226b577da7c030a1f5ffe7445a25bbe,1,33,8,41,6,2013-04-22 22:33:32,2013-04-22 21:55:23
97253a233226b577da7c030a1f5ffe7445a25bbe...160695949a074ae252a4d458a8e135fea3245681,1,4,0,4,1,2013-04-22 22:33:37,2013-04-22 21:55:24
118f60ee06612083ff4f1810424e80a3e896f73e...9f60f49b9222f9200e688a64cd80610305b03cc5,2,17,4,21,6,2013-04-22 20:34:31,2013-04-22 20:29:20
9f60f49b9222f9200e688a64cd80610305b03cc5...4c7114308ea12de7b69a3b282881398212dec8dd,1,6,6,12,2,2013-04-22 20:36:51,2013-04-22 20:36:51
0117c2f043183fb99e9b046b0df7d64c1b296624...3a429d3b8d03c98fbc775eb34a54b7b2bd74e02b,2,8,22,30,6,2013-04-05 19:37:55,2013-03-30 09:53:32
3a429d3b8d03c98fbc775eb34a54b7b2bd74e02b...cbe43b847379e8d3db6aab2913b29b730fa5ca45,1,23,19,42,8,2013-04-05 19:39:38,2013-03-30 09:53:47
07b83b5d98a8b7230f3ebafeb4ecf2916c011db9...6cb0c883052118c35e424af7a311c66be9b366e1,1,1,1,2,1,2013-09-10 15:49:22,2013-09-08 20:54:34
8051a030617cf7d083568cca223bdaa15052c33f...011fe9814f7be7df7212229fa4f8393e03829cb7,1,3,3,6,1,2010-02-28 18:39:27,2010-02-27 04:52:13
011fe9814f7be7df7212229fa4f8393e03829cb7...60cfeb8e95d859bf250804c7981e8481e297c3b6,1,1,1,2,1,2010-02-28 18:39:28,2010-02-27 04:52:14
60cfeb8e95d859bf250804c7981e8481e297c3b6...77555854be6e7fbce07c9ded30ea859b54699be0,3,13,5,18,8,2010-02-28 18:39:30,2010-02-27 04:52:15
77555854be6e7fbce07c9ded30ea859b54699be0...fbe4f447ec60ffa760cfb586708ddbddee789733,1,50,0,50,1,2010-02-28 18:39:31,2010-02-27 04:52:16
fbe4f447ec60ffa760cfb586708ddbddee789733...c296134d038fe6d836fe3848e0b342d920933683,1,3,3,6,3,2010-03-12 05:53:07,2010-03-12 05:51:57
8051a030617cf7d083568cca223bdaa15052c33f...88d9d45d071379e81e585faa95e4f28414d7d973,4,32,3,35,5,2010-02-12 19:32:23,2010-02-10 01:11:49
88d9d45d071379e81e585faa95e4f28414d7d973...126f431ab61b250deab2b46f933a5bcd35a71c6b,4,381,0,381,4,2010-03-09 09:11:18,2010-03-09 05:11:40
126f431ab61b250deab2b46f933a5bcd35a71c6b...32962c9bd5149005b163dff230670872eb99286a,5,44,16,60,24,2010-03-09 09:11:18,2010-03-09 06:58:09
32962c9bd5149005b163dff230670872eb99286a...b44900599710c700c1bf164d3753eb7f8eb6c18a,6,62,8,70,12,2010-03-09 09:11:18,2010-03-09 07:27:25
b44900599710c700c1bf164d3753eb7f8eb6c18a...2bf6587349e31b582dae47954b1a334052230e28,4,134,3,137,6,2010-03-09 09:11:19,2010-03-09 08:22:54
8051a030617cf7d083568cca223bdaa15052c33f...6e359978e9792a83e8b45c0b76c3974518d2c738,1,4,4,8,2,2010-02-12 06:10:57,2010-02-11 21:06:01
6e359978e9792a83e8b45c0b76c3974518d2c738...dd9314cc2a2f353bf9438db14cbbf02a1c219bda,1,2,8,10,2,2010-02-12 06:11:01,2010-02-11 21:06:43
dd9314cc2a2f353bf9438db14cbbf02a1c219bda...08565bdb4b5d1da597ed8b90d1a23729f7c006d0,1,4,4,8,4,2010-02-12 06:11:03,2010-02-11 21:07:06
08565bdb4b5d1da597ed8b90d1a23729f7c006d0...97915544f84132b210a336d5877fafd7cb104abe,1,7,7,14,7,2010-02-12 06:11:04,2010-02-11 21:08:15
97915544f84132b210a336d5877fafd7cb104abe...4d128884fbcce6c7effc729e1c52f06ce17037ee,1,6,4,10,3,2010-02-12 06:11:12,2010-02-11 21:19:37
8051a030617cf7d083568cca223bdaa15052c33f...720c9f7bda20d8f307745772374647c1a2076b3d,2,10,12,22,4,2010-02-08 18:56:21,2010-02-08 15:39:01
a9e643668aa932d93528fffa573a13a28eb54556...0a93fb8a9cc6fa1bf7dba6b498cba3f57f5017a1,3,65,9,74,17,2011-10-05 01:33:45,2011-09-27 20:43:12
ebe8621fd798a568ae33eb6a665cb3c758dd3816...0e18a5b428920bdde28318d3b8e9d6d987729698,1,1,15,16,2,2014-12-16 18:58:13,2014-12-16 03:58:07
7fb0eaa289576a1dcd7751015ba791f1bce778a9...426c27b7c0a415cec451d8fd369ecd5a86adf85e,1,3,1,4,1,2010-04-11 01:35:59,2010-04-06 12:46:42
426c27b7c0a415cec451d8fd369ecd5a86adf85e...969f9d73228f233aff071a0d07ba28afdb79dbc4,2,7,1,8,4,2010-04-11 01:36:00,2010-04-06 12:46:43
969f9d73228f233aff071a0d07ba28afdb79dbc4...ec775c41dc4bb7382ebbbb61ede59e63846b3644,2,29,12,41,13,2010-04-11 01:36:00,2010-04-06 12:46:44
7fb0eaa289576a1dcd7751015ba791f1bce778a9...00f8f97d30be7992c16bc466532cb591e00314bf,6,17,12,29,14,2010-01-17 05:33:13,2010-01-17 05:01:28
00f8f97d30be7992c16bc466532cb591e00314bf...9914cf468941067b4f3deb9c69c11af3f5b45ccc,2,18,8,26,13,2010-01-17 07:45:29,2010-01-17 05:30:18
9914cf468941067b4f3deb9c69c11af3f5b45ccc...15b4f7a68d8c3c8ee28424415b203f61202d65d1,2,9,11,20,9,2010-01-17 07:45:33,2010-01-17 05:45:40
15b4f7a68d8c3c8ee28424415b203f61202d65d1...88533f6d64ae898e5f94fa22fa9b5fd43fe3e16e,1,1,4,5,3,2010-01-17 07:45:33,2010-01-16 06:50:01
88533f6d64ae898e5f94fa22fa9b5fd43fe3e16e...23a64c9e771e3caf19cf2ee9a32c8942ddde4a81,1,34,25,59,19,2010-01-17 07:46:12,2010-01-16 06:37:32
23a64c9e771e3caf19cf2ee9a32c8942ddde4a81...191f24171718e894cb5ba806bc45861ebac95e96,1,44,10,54,13,2010-01-17 10:01:34,2010-01-17 07:06:45
191f24171718e894cb5ba806bc45861ebac95e96...8588567c96490b8d236b1bc13f9bcb0dfa118efe,3,20,2,22,5,2010-01-17 10:01:43,2010-01-17 07:28:46
a479a564dc33bdbc102f2af81ab71ef3e1eae492...8dd35c7121696851f837a5d8b17adaa99daf83ef,1,5,2,7,2,2009-12-03 08:06:52,2009-12-03 08:06:52
8dd35c7121696851f837a5d8b17adaa99daf83ef...eefe19fbfc93b359afe43aa1645eb5591a502f15,2,3,2,5,3,2009-12-03 08:08:16,2009-12-03 08:08:16
63d04a78043c61c52ae437fa6106e7029b466bbf...5eef828bc03649ba11acc05c983d72823c27f0bb,5,227,20,247,24,2010-02-01 20:09:47,2010-02-01 17:27:35
09c9957cf77106ca6b49127d5df20080922c81a4...e07fd15b1295393ddf954b9fdd0c3a961e5509c5,1,2,1,3,2,2011-05-05 20:45:31,2011-05-05 06:18:45
6d525d389fbef814b11e41f196e6656f2e95f412...6b3fa7e7d13a3c8fddba43ad6e8acb314d1985ac,1,29,29,58,18,2010-02-10 03:25:36,2010-02-10 02:01:29
6b3fa7e7d13a3c8fddba43ad6e8acb314d1985ac...466dbc42f58623d4341d6b1171b5cc13e2b700df,2,52,15,67,16,2010-02-10 17:51:07,2010-02-10 17:34:12
7ed1690c343dc16dfd5a5493589cbf74d503c238...6c26bf4d4e4b1f40dcd067f8ce0c76f64eab9f47,1,69,46,115,15,2013-02-19 20:56:11,2013-02-19 10:05:00
6c26bf4d4e4b1f40dcd067f8ce0c76f64eab9f47...ae6ef554c8c785f96fce482e33cc78080aafc43f,1,5,9,14,2,2013-02-19 20:56:30,2013-02-19 10:05:01
ae6ef554c8c785f96fce482e33cc78080aafc43f...9148673377367db48183a33dcc53c828df397bfc,1,3,1,4,1,2013-02-19 20:56:30,2013-02-19 10:05:02
8447dc890488a953ab190e8826bc9dd175b28df9...59856de171397c355923ee6cd6debae89385c824,1,17,2,19,2,2013-12-09 18:55:48,2013-11-07 21:36:29
c8c82b1ba3fd03b3de4d2c6c760b75726f519cb8...75301a45887dfaab2f1458a2a56f7ed9b8f474ce,2,5,4,9,5,2013-04-26 22:20:26,2013-04-26 21:12:31
75301a45887dfaab2f1458a2a56f7ed9b8f474ce...23df5e40f01ec75fd8f1032dcd34a945e8ce51c0,1,0,4,4,1,2013-04-26 22:20:26,2013-04-26 21:12:32
23df5e40f01ec75fd8f1032dcd34a945e8ce51c0...d6bb9136c93baddf0ee5052638591bd881b19f77,1,6,0,6,4,2013-04-26 22:20:26,2013-04-26 21:12:33
d6bb9136c93baddf0ee5052638591bd881b19f77...aa9384566161a242ad0ca2563e613736edf38fe9,1,13,3,16,5,2013-04-26 22:20:27,2013-04-26 21:12:34
aa9384566161a242ad0ca2563e613736edf38fe9...6134caf2c10b9cd0df431fdefcf145984aeb80e3,1,2,2,4,2,2013-04-26 22:20:27,2013-04-26 21:12:35
6134caf2c10b9cd0df431fdefcf145984aeb80e3...d82c912c430d63456350ae39ea6d1fa7ba88006d,1,12,1,13,3,2013-04-26 22:20:27,2013-04-26 21:12:36
d82c912c430d63456350ae39ea6d1fa7ba88006d...4d74cd4725da4b575baf2dc20ebee18d49885c4e,1,3,0,3,2,2013-04-26 22:20:27,2013-04-26 21:12:37
4d74cd4725da4b575baf2dc20ebee18d49885c4e...877ee9cc7eec7f1cf43d726f6a92c20fdfe83ca9,1,4,0,4,1,2013-04-26 22:20:27,2013-04-26 21:12:38
c19387e79947de9307af06ce92a83eaf786153b7...eef39f8124ba6045bdc1ae6e665d3d65e28385ab,1,1,15,16,2,2013-04-11 18:01:58,2013-04-11 12:05:09
eef39f8124ba6045bdc1ae6e665d3d65e28385ab...ae3caf4c912429c8e9755f2e10d2f0a7f6279c36,3,134,49,183,37,2013-04-11 18:01:58,2013-04-11 12:05:10
ae3caf4c912429c8e9755f2e10d2f0a7f6279c36...0006d85c3a2fcbd803ed46cf283fab4e4fae3a7f,1,21,20,41,15,2013-04-11 18:01:58,2013-04-11 12:05:11
0006d85c3a2fcbd803ed46cf283fab4e4fae3a7f...0c8e8c080b08632d6dbee33d093b5df648196b49,2,28,15,43,6,2013-04-11 18:01:59,2013-04-11 12:05:12
0c8e8c080b08632d6dbee33d093b5df648196b49...f1ed7fea7974218db15155f3b8d2e29d3fe0971c,3,13,2,15,3,2013-04-11 18:11:36,2013-04-11 12:05:13
f1ed7fea7974218db15155f3b8d2e29d3fe0971c...b96114edb36e16d214af1e7945a1d19b8a5e1686,1,17,21,38,1,2013-04-29 23:08:33,2013-04-29 22:55:25
b741611c062db33dcd2ab41ec589cb659c465ebc...eff6d3a9e388b3d38165ddce42cb86de4cccddab,1,121,99,220,85,2012-05-15 04:07:00,2012-05-15 03:53:26
eff6d3a9e388b3d38165ddce42cb86de4cccddab...042e9f94a71977b471e230f0c637699b0a7ca3d3,1,127,101,228,85,2012-05-15 17:09:02,2012-05-15 17:00:40
c844a8035617a602015d74ce329ee88f9b003bf9...ae2f203ef7be7b33ff5ec61646c8662363eccd62,2,43,11,54,17,2012-03-15 18:25:34,2012-03-15 08:04:12
c844a8035617a602015d74ce329ee88f9b003bf9...01bfec8e52dcfa2da47b54b3c89c3181ae09b9a9,1,19,0,19,1,2012-03-15 18:13:23,2012-03-12 14:57:12
01bfec8e52dcfa2da47b54b3c89c3181ae09b9a9...a0be62c100897573ef1575ec0d5e8b215e9dcafe,2,31,21,52,15,2012-03-15 18:13:23,2012-03-12 14:57:13
a0be62c100897573ef1575ec0d5e8b215e9dcafe...dabba590aa0e94a8deb6f0e827144697895bcfe8,2,13,8,21,7,2012-03-15 18:13:23,2012-03-15 14:58:56
4b340cfab9c7a18e39bc531d6a6ffaffdf95f62d...c9b4e9e5b6587ea433cd93c3c99f8720ff2fdad2,1,4,2,6,1,2012-05-22 19:50:29,2012-05-22 05:45:08
4b340cfab9c7a18e39bc531d6a6ffaffdf95f62d...d9955fd60fa79da1e7310a55c30e2d87c227d6f9,2,8,1,9,2,2012-05-22 18:24:11,2012-05-22 06:12:20
4b340cfab9c7a18e39bc531d6a6ffaffdf95f62d...04861982e553289c923b2f9ef829ef33206c9bc4,1,18,0,18,1,2012-03-11 21:06:08,2012-03-11 10:51:32
04861982e553289c923b2f9ef829ef33206c9bc4...7dfe8ad6006c105989e4e8cfb196aa4ecda3c21d,2,20,4,24,6,2012-03-11 21:07:22,2012-03-11 10:12:10
2980b0de1b387e4f9a63c50ca741271990c849d5...47a02ff2ca821c52268197dd5fa46cd60a2e94bc,3,62,48,110,6,2012-03-07 17:07:37,2012-03-07 10:54:15
47a02ff2ca821c52268197dd5fa46cd60a2e94bc...d41489a6424308dc9a0409bc2f6845aa08bd4f7d,2,60,5,65,7,2012-03-07 17:07:37,2012-03-07 10:54:16
d41489a6424308dc9a0409bc2f6845aa08bd4f7d...00c8fd493afbd1620febf2b895fb2365f76d5875,2,27,2,29,5,2012-03-07 17:07:38,2012-03-07 10:54:17
00c8fd493afbd1620febf2b895fb2365f76d5875...090ea12671b2971b1c613f0a3d2657e8cdd35134,2,51,2,53,4,2012-03-07 17:07:38,2012-03-07 10:54:18
090ea12671b2971b1c613f0a3d2657e8cdd35134...74775a09b166fb85f5dce816548e337f11124c6b,2,21,15,36,6,2012-03-07 17:07:38,2012-03-07 10:54:19
74775a09b166fb85f5dce816548e337f11124c6b...6f7f3beb2d19ab772729fc599d4a92ebf9140c5f,1,2,6,8,3,2012-03-07 17:07:39,2012-03-07 10:54:20
6f7f3beb2d19ab772729fc599d4a92ebf9140c5f...da591a7f4bbe1a208cc5f955523506eb857c45ca,2,2,1,3,2,2012-03-07 17:07:39,2012-03-07 10:54:21
2980b0de1b387e4f9a63c50ca741271990c849d5...85551232b56e763ecfcc7222e0858bac4e962c80,1,29,0,29,1,2012-03-06 19:48:11,2012-03-06 13:15:01
167a5800cb707ed489c3cb88174ee21e95a610ae...b2b3e9c2d623359ed680a5eef850ef2fd313b73c,3,29,4,33,6,2011-09-22 23:38:22,2011-09-22 21:44:20
b2b3e9c2d623359ed680a5eef850ef2fd313b73c...78cec75747995a8613a8f27625aeaa4ec4b19651,1,22,46,68,24,2011-09-22 23:39:28,2011-09-22 23:34:05
167a5800cb707ed489c3cb88174ee21e95a610ae...f7d650c06ea3242cbf0e6ae2820d5b839ab97cd5,4,6,6,12,6,2011-09-21 21:26:38,2011-09-20 20:25:57
04a74b6cfa5ef4870263f84ac94a488d9f2ef14a...62e91efafd2030b7dc33ac6450b4e9a316e6ecc6,1,1,1,2,1,2013-07-03 18:48:15,2013-07-03 18:27:39
04a74b6cfa5ef4870263f84ac94a488d9f2ef14a...a94cf2cb7e77c27ce5c3d648e37c1aa75cd5e56e,1,9,3,12,1,2013-06-19 17:00:26,2013-06-19 02:43:49
04a74b6cfa5ef4870263f84ac94a488d9f2ef14a...09b7e2204a8e41307192c800162e438ec09ddd2c,9,20,21,41,14,2013-06-18 18:05:51,2013-06-18 17:44:58
04a74b6cfa5ef4870263f84ac94a488d9f2ef14a...d7747bd5bcba5eaeda690d7d5897462580f3c0e4,1,7,7,14,3,2013-06-18 16:33:12,2013-06-18 14:58:50
04a74b6cfa5ef4870263f84ac94a488d9f2ef14a...76b80cdf17807ba4a773562df2218980ffa27e4f,1,2,2,4,1,2013-06-18 16:19:19,2013-06-18 08:42:55
04a74b6cfa5ef4870263f84ac94a488d9f2ef14a...70495b556f5685afe0e41988e42d48b2331d77a0,1,9,0,9,1,2013-06-18 14:35:48,2013-06-17 17:52:41
04a74b6cfa5ef4870263f84ac94a488d9f2ef14a...560d4b86abc547dfb10b116ab99c800d68ae8849,1,9,0,9,1,2013-06-17 20:27:49,2013-06-17 13:31:31
04a74b6cfa5ef4870263f84ac94a488d9f2ef14a...05a950630e67f3acf7a349b579d28eebe9143a72,1,1,1,2,1,2013-06-17 20:09:17,2013-06-15 23:01:11
04a74b6cfa5ef4870263f84ac94a488d9f2ef14a...d77fd050ab8579558d3e8e4e5467a9300546ef2c,1,1,1,2,2,2013-06-17 19:59:50,2013-06-15 21:35:02
04a74b6cfa5ef4870263f84ac94a488d9f2ef14a...46ec510ac088ac2669e617a4c8c35e6218dabecc,2,17,0,17,3,2013-05-28 18:26:24,2013-05-27 22:49:57
04a74b6cfa5ef4870263f84ac94a488d9f2ef14a...49ecfa13fe6fb9ccb7c4771126872515340c328b,1,4,1,5,2,2013-04-19 21:43:24,2013-04-19 21:24:29
04a74b6cfa5ef4870263f84ac94a488d9f2ef14a...3d27b9b005f26b107227fc18b6648df329daee97,3,30,7,37,5,2013-04-17 23:03:56,2013-04-17 22:38:08
3d27b9b005f26b107227fc18b6648df329daee97...61929404df24325b8bebedbd70d55d21142de9dd,2,10,4,14,3,2013-04-18 16:30:15,2013-04-18 07:46:34
61929404df24325b8bebedbd70d55d21142de9dd...8a09e6c5f9010ac7159ef39a03b9a36bf233eaca,1,2,0,2,1,2013-04-18 16:30:28,2013-04-18 07:46:35
8a09e6c5f9010ac7159ef39a03b9a36bf233eaca...27ec394a9701675762f02e9af464be2c297c6cf1,4,16,2,18,5,2013-04-25 18:42:10,2013-04-25 18:13:49
04a74b6cfa5ef4870263f84ac94a488d9f2ef14a...29fb37b272debaf4f5f6eb7cf476de9274492930,3,35,34,69,5,2013-04-17 16:49:11,2013-04-13 13:28:30
29fb37b272debaf4f5f6eb7cf476de9274492930...ff36682505dfb580172306fe1b265b860f89bcea,3,6,4,10,5,2013-04-17 16:51:47,2013-04-13 13:28:31
ff36682505dfb580172306fe1b265b860f89bcea...4982fd78f61db69504f91151f94fce9914d610b6,1,2,25,27,5,2013-04-17 16:52:33,2013-04-13 13:28:32
04a74b6cfa5ef4870263f84ac94a488d9f2ef14a...c19a490e37181de8fa94ae1074af4b9f9a518f95,2,15,6,21,9,2013-04-16 22:02:46,2013-04-16 19:46:22
c19a490e37181de8fa94ae1074af4b9f9a518f95...1ece66bc9e5433dff008786daba9918f3e2a6525,1,11,0,11,4,2013-04-16 22:02:48,2013-04-16 19:50:07
ec014eac0e9e6f30cbbca616090fa2ecf74797e7...fbbccd0a10f314d9cce4427a4135efd051610880,1,35,23,58,7,2011-12-06 22:17:01,2011-12-05 18:58:23
fbbccd0a10f314d9cce4427a4135efd051610880...3d0b05176f0539b8d71e712016c367768fc046d5,1,47,0,47,1,2011-12-12 05:26:57,2011-12-07 07:01:28
3d0b05176f0539b8d71e712016c367768fc046d5...335c6e403d862913846661638af6e184055f6db5,1,1,1,2,1,2011-12-15 18:10:11,2011-12-15 18:10:11
ec014eac0e9e6f30cbbca616090fa2ecf74797e7...3623dc0310cc72242ed78e134a24fdd05d5179e8,1,1,1,2,1,2011-10-06 22:12:31,2011-10-06 18:40:31
ec014eac0e9e6f30cbbca616090fa2ecf74797e7...f8e49e132c717df25f741f4af9ce1c79e1d74fb1,1,2,6,8,1,2011-10-06 22:11:49,2011-10-06 18:40:29
f8e49e132c717df25f741f4af9ce1c79e1d74fb1...77653abd988fb333f7b155e23a3bcea6042505bc,1,3,2,5,2,2011-10-06 22:11:50,2011-10-06 18:40:30
ec014eac0e9e6f30cbbca616090fa2ecf74797e7...908aaceb92c4fcc983c395350d4a188778ae500d,1,2,0,2,1,2011-10-05 16:27:29,2011-10-03 11:01:59
ec014eac0e9e6f30cbbca616090fa2ecf74797e7...6cdf0223fe4a9ccae543fece8b5e78a626ccdf89,1,8,1,9,1,2011-10-05 02:11:50,2011-10-04 23:20:19
ec014eac0e9e6f30cbbca616090fa2ecf74797e7...6de96915c0b12870e0cf2204fd060fb0735da728,1,2,2,4,2,2011-09-29 01:24:36,2011-09-09 02:02:45
6de96915c0b12870e0cf2204fd060fb0735da728...1b74092373898a53885cfb7e89aa54f9329a92d3,1,2,2,4,1,2011-09-29 01:26:12,2011-09-09 02:02:46
ec014eac0e9e6f30cbbca616090fa2ecf74797e7...be042aff24c8a17565934874f5d2eebd77ab2562,4,10,5,15,6,2011-09-19 18:07:21,2011-09-18 23:52:32
ec014eac0e9e6f30cbbca616090fa2ecf74797e7...52fd972d5922c95b44e49cd736f67d495a0175f1,1,8,0,8,2,2011-05-10 20:08:51,2011-05-10 12:20:39
ec014eac0e9e6f30cbbca616090fa2ecf74797e7...4f0accd638b8d27c44066e7a866315ca67cb07ec,1,18,8,26,9,2011-05-10 15:45:37,2011-05-09 23:36:36
ec014eac0e9e6f30cbbca616090fa2ecf74797e7...ff2e2cd58420438a95257caa6008b885e781d576,1,1,1,2,1,2011-05-08 18:52:05,2011-05-07 12:45:20
ff2e2cd58420438a95257caa6008b885e781d576...f09f1d35b5ea0637d8a3733cd246cb6bfb05b22a,1,0,26,26,1,2011-05-08 18:52:57,2011-05-07 12:45:21
ec014eac0e9e6f30cbbca616090fa2ecf74797e7...73151df0cf3b324fc5f8980774601794c4b88204,2,91,93,184,15,2011-05-06 21:42:06,2011-05-06 20:58:52
73151df0cf3b324fc5f8980774601794c4b88204...3fc0dbf00ba5191c6aa7090a19fb9324ca348077,1,1,0,1,1,2011-05-06 22:29:01,2011-05-06 21:00:21
ec014eac0e9e6f30cbbca616090fa2ecf74797e7...31be5d87a2aa2c40f021f37d9a5408e59804fd7f,1,3,2,5,1,2011-05-05 19:43:06,2011-05-02 13:44:28
31be5d87a2aa2c40f021f37d9a5408e59804fd7f...c105356ed4636167b96526cd41e2cbaca051432c,1,5,1,6,2,2011-05-05 19:43:11,2011-05-05 18:48:45
c105356ed4636167b96526cd41e2cbaca051432c...f2808a50a62755739a775ed008f01a9a5a053938,1,5,4,9,4,2011-05-05 19:43:11,2011-05-05 18:48:47
f2808a50a62755739a775ed008f01a9a5a053938...a31538e273bbca23951fa70a0324ac49214d0f10,1,4,3,7,3,2011-05-05 20:31:11,2011-05-05 18:48:48
a31538e273bbca23951fa70a0324ac49214d0f10...6086ff65dfcf48237bdac6c64a85bef5d34d5b4e,1,4,3,7,2,2011-05-05 20:31:22,2011-05-05 19:58:18
ec014eac0e9e6f30cbbca616090fa2ecf74797e7...d2355d76150316104b89443065e62a71342c36be,1,1,1,2,1,2011-05-05 15:34:04,2011-05-04 22:00:17
d2355d76150316104b89443065e62a71342c36be...5a69eaf5541b8449ede74f148d395abd0acbf20f,1,1,1,2,1,2011-05-05 15:34:13,2011-05-04 22:00:18
5a69eaf5541b8449ede74f148d395abd0acbf20f...97e777842260a5339bb5272a35ebeaeaae554937,1,15,8,23,3,2011-05-05 15:38:12,2011-05-04 22:00:19
97e777842260a5339bb5272a35ebeaeaae554937...8997da3820a0f55d156f43f3bb71856580df160d,1,1,1,2,1,2011-05-09 23:28:16,2011-05-09 21:52:03
8997da3820a0f55d156f43f3bb71856580df160d...a30c148aa7ec6583dbdb38fa6601df3cf4f5a660,1,16,9,25,3,2011-05-09 23:28:53,2011-05-09 21:52:04
a30c148aa7ec6583dbdb38fa6601df3cf4f5a660...63e7e9d8b6483fed555ebed1c79a4820b2ba2558,6,107,1,108,13,2011-05-09 23:29:33,2011-05-09 21:52:05
63e7e9d8b6483fed555ebed1c79a4820b2ba2558...a119f91e57f23f89b1f9170613d517d62a91c97d,2,41,0,41,3,2011-05-09 23:29:46,2011-05-09 21:52:06
a119f91e57f23f89b1f9170613d517d62a91c97d...8f852ce613650b0cccf02adecbc18865d8e21fb6,3,44,0,44,4,2011-05-09 23:29:54,2011-05-09 21:52:07
8f852ce613650b0cccf02adecbc18865d8e21fb6...258a6188496fe5131203905b6cd596af69312247,2,19,1,20,3,2011-05-09 23:29:55,2011-05-09 21:52:08
258a6188496fe5131203905b6cd596af69312247...cca2c172e0c37eff8e743b63016b6bc604b38a7d,1,43,13,56,5,2011-05-10 05:53:16,2011-05-10 01:48:36
cca2c172e0c37eff8e743b63016b6bc604b38a7d...dd0a21ede0998ec790c37865c7dc119814ac7745,1,0,16,16,1,2011-05-16 07:10:14,2011-05-16 07:10:14
dd0a21ede0998ec790c37865c7dc119814ac7745...a80dff25152f43e8a9a688943cb5f67d2ad76fc4,1,1,0,1,1,2011-05-16 07:11:53,2011-05-16 07:11:53
a80dff25152f43e8a9a688943cb5f67d2ad76fc4...f556e4af2790bc8f0918093bd2b3053c7d2898dc,1,85,0,85,5,2011-05-23 18:57:08,2011-05-22 11:37:28
f556e4af2790bc8f0918093bd2b3053c7d2898dc...d0042abe14b3aece87595d365d6eba84c3e53327,1,26,32,58,11,2011-05-30 06:58:50,2011-05-26 22:43:59
ec014eac0e9e6f30cbbca616090fa2ecf74797e7...f2dd8c3799ddbd7df63a89a9043916f8545a70a3,3,19,3,22,5,2011-05-02 04:50:04,2011-05-01 08:16:25
f2dd8c3799ddbd7df63a89a9043916f8545a70a3...239b5ed9c9b7b7f219b05c8d71e29db7b970eb48,1,6,6,12,3,2011-05-02 15:49:32,2011-05-02 06:07:45
ec014eac0e9e6f30cbbca616090fa2ecf74797e7...0a0ec7bd66786bcc2204f299f6c993db19d1f53c,1,3,6,9,1,2011-05-01 22:56:05,2011-05-01 22:16:02
ec014eac0e9e6f30cbbca616090fa2ecf74797e7...a1dd7e16ad6df793fc393d6df8e9082261a0ce42,1,1,1,2,1,2011-04-29 18:34:32,2011-04-29 18:23:24
ec014eac0e9e6f30cbbca616090fa2ecf74797e7...9b01f0038b63ccdf697b2387f4fcd4b03bd249d5,3,13,3,16,4,2011-04-29 18:09:42,2011-04-21 22:07:36
9b01f0038b63ccdf697b2387f4fcd4b03bd249d5...c01bd5a29f38e4e9fd5c03f3e1e84b88c392dd6f,1,2,1,3,1,2011-05-05 16:24:21,2011-05-05 04:43:37
ec014eac0e9e6f30cbbca616090fa2ecf74797e7...6999c54029b42ea996c2fff4fa37303f79b9d8c2,2,30,12,42,4,2011-04-27 18:25:47,2011-04-27 07:38:27
ec014eac0e9e6f30cbbca616090fa2ecf74797e7...7141efab2481214fcab8fb853207b343435fcad4,1,2,5,7,2,2011-04-27 17:52:15,2011-04-27 17:24:50
ec014eac0e9e6f30cbbca616090fa2ecf74797e7...0daed41791373a5530c2b33e09b134ce8820e0c2,1,11,0,11,1,2011-04-27 17:49:59,2011-04-27 08:36:26
0daed41791373a5530c2b33e09b134ce8820e0c2...7cf16a14f5c070f7b14cf28023769450133172ae,3,21,1,22,4,2011-04-27 17:50:05,2011-04-27 08:36:27
ec014eac0e9e6f30cbbca616090fa2ecf74797e7...b5a49471f0a0b243468b09db349968e9a27b7334,1,8,8,16,4,2011-04-27 17:48:20,2011-04-27 03:23:35
ec014eac0e9e6f30cbbca616090fa2ecf74797e7...0c8c385ef188bf76b6edcda87a7cc9bc05596fa3,1,1,1,2,1,2011-04-26 20:14:02,2011-04-26 01:32:00
ec014eac0e9e6f30cbbca616090fa2ecf74797e7...b388e14b89f0a82b8067b3922a93cf2d1b013ff0,4,40,3,43,6,2011-04-26 20:13:20,2011-04-26 08:24:29
ec014eac0e9e6f30cbbca616090fa2ecf74797e7...12d30657d411979af3ab9ca7139b5290340e4abb,1,1,1,2,1,2011-04-26 18:48:34,2011-04-25 21:36:15
12d30657d411979af3ab9ca7139b5290340e4abb...c88d18fff82c66526136f7b2aebe578238841190,1,11,11,22,2,2011-04-26 18:48:43,2011-04-26 11:34:18
c88d18fff82c66526136f7b2aebe578238841190...7733b279339f46d8a2c119ab2ff8d14f76adf2ad,1,4,4,8,2,2011-04-26 18:48:48,2011-04-26 11:34:19
ec014eac0e9e6f30cbbca616090fa2ecf74797e7...72942a617cb1f6e1844a7391d030c15acd2ca052,1,9,8,17,6,2011-04-26 18:45:56,2011-04-26 10:33:26
ec014eac0e9e6f30cbbca616090fa2ecf74797e7...3ea2cfd488ed70e03d8d6f10e601784926db8008,3,254,38,292,19,2011-04-26 18:10:46,2011-04-21 19:50:23
3ea2cfd488ed70e03d8d6f10e601784926db8008...ecdba36da6143bc00ade66b655bcff910f3e93b3,1,14,5,19,3,2011-05-09 23:26:51,2011-05-07 10:19:43
ecdba36da6143bc00ade66b655bcff910f3e93b3...848de9c3831f7e476ea58e3ee426aa63fb8f6870,3,79,2,81,8,2011-05-13 19:59:13,2011-05-13 19:46:00
61bc0753f149f204ddb5414ca98dc3d4f1876456...8ea38f47bbabf00c17ff8964c722e413ed37444e,1,2,2,4,2,2012-03-02 08:09:21,2012-02-28 17:57:24
8ea38f47bbabf00c17ff8964c722e413ed37444e...70fc47bf564260ccf22ebff4ea97941aaae751eb,1,3,3,6,2,2012-03-02 08:18:22,2012-02-28 17:58:30
70fc47bf564260ccf22ebff4ea97941aaae751eb...a9ce45430b380b982de6f6cf24a96849e4d2feed,1,3,2,5,2,2012-03-02 08:28:10,2012-02-28 18:03:39
a9ce45430b380b982de6f6cf24a96849e4d2feed...1b150dc96fc11f5d3a8a1442bd364035e38bb549,1,2,2,4,1,2012-03-02 08:37:15,2012-02-28 18:08:22
1b150dc96fc11f5d3a8a1442bd364035e38bb549...2d0dc4746444a1d9fea40332d97ad39a995daaba,1,9,6,15,7,2012-03-02 08:50:35,2012-02-28 18:18:52
2d0dc4746444a1d9fea40332d97ad39a995daaba...aa9565f7ccfeee2df9f4d950f1a2822befd0244b,1,3,3,6,3,2012-03-05 05:33:43,2012-03-05 05:16:27
3e4bb087a18435b12eb82116e93af2887578e816...47ec79430dc6a60336bebdc0a45fb9f15129d0c7,1,1,1,2,1,2007-11-02 09:05:18,2007-11-02 02:38:22
3e4bb087a18435b12eb82116e93af2887578e816...b43b0a3c5c313619397b2f81d5a4acad2c3cb4a9,1,45,4,49,4,2007-11-02 09:01:32,2007-11-02 03:43:13
b43b0a3c5c313619397b2f81d5a4acad2c3cb4a9...c65b670e858a0fc010c8b8bb3cbf064bb22e1839,1,44,0,44,7,2007-11-02 09:01:32,2007-11-02 03:43:14
3e4bb087a18435b12eb82116e93af2887578e816...f88a545a94cb474d370ef97dd3694d09b6ac90c1,3,15,0,15,5,2007-11-02 08:58:40,2007-11-01 22:57:45
3e4bb087a18435b12eb82116e93af2887578e816...4d00bda2aa9dd8cd6ec4015832b80eb1273d46d7,3,28,0,28,4,2007-11-02 08:32:02,2007-11-02 03:26:04
4d00bda2aa9dd8cd6ec4015832b80eb1273d46d7...79814f425c00129dbdbdc3c99d04af52ccc58254,1,6,6,12,5,2007-11-02 08:41:04,2007-11-02 03:43:24
3e4bb087a18435b12eb82116e93af2887578e816...9d3014566302ad0d3d378b0a1653959b3118066d,1,10,7,17,6,2007-11-02 00:34:41,2007-11-01 11:38:08
9d3014566302ad0d3d378b0a1653959b3118066d...6aa6f92fda47cc4ee5f599895e8a5a327fb6f9ab,1,3,2,5,3,2007-11-02 00:34:50,2007-11-01 11:38:09
6aa6f92fda47cc4ee5f599895e8a5a327fb6f9ab...fa9aff463da42feea68228ca51685cd9f4403e92,1,0,1,1,1,2007-11-02 08:30:35,2007-11-01 13:23:16
fa9aff463da42feea68228ca51685cd9f4403e92...1cad283a71d0ade2d86758dac90b51972a7a73c6,1,9,0,9,1,2007-11-02 08:30:35,2007-11-01 12:06:27
1cad283a71d0ade2d86758dac90b51972a7a73c6...7afd77bfc1b6881fd9e476274d3f08b793c292ed,1,15,29,44,14,2007-11-02 08:30:35,2007-11-01 12:06:28
7afd77bfc1b6881fd9e476274d3f08b793c292ed...a3823e5ad75498774a32850f44e8254b0e1c0901,1,11,18,29,9,2007-11-02 08:30:35,2007-11-01 12:06:29
a3823e5ad75498774a32850f44e8254b0e1c0901...e9c34c233f2e838c334f6e8a807ebc6a988e9509,1,23,0,23,1,2007-11-03 01:27:35,2007-11-02 23:41:18
e9c34c233f2e838c334f6e8a807ebc6a988e9509...b201927ac8a4544baa067f5c5c7c7f2d6780e29a,1,108,7,115,3,2007-11-03 01:27:35,2007-11-02 23:41:19
b201927ac8a4544baa067f5c5c7c7f2d6780e29a...0e121a2cd42d28bc4034feedf8a13c5a91f85bd3,1,8,2,10,2,2007-11-03 01:27:36,2007-11-02 23:41:20
3e4bb087a18435b12eb82116e93af2887578e816...648ee5500920b49a5ee5822076104b9304ec97c8,2,44,17,61,12,2007-11-02 00:19:36,2007-10-31 22:12:20
3e4bb087a18435b12eb82116e93af2887578e816...4593fb84051d39f65cec81958e91056986e4682f,7,24,9,33,11,2007-11-02 00:18:39,2007-10-31 21:55:17
4593fb84051d39f65cec81958e91056986e4682f...aacb8f10a70c07dfe1461684f098313f0edb371f,1,42,0,42,1,2007-11-03 00:55:42,2007-11-03 00:55:31
c5d236c70e043edd1033e1a132f2a594195bfd57...8f353ee57a2f79697f8dea80ad3174998586bc75,1,1,0,1,1,2007-10-18 05:41:29,2007-10-17 10:57:47
50f3ac29cbadbf7e0ff099b493b00cfa4129e1e0...3c386aa3380b698396d522f1132343ced482ff42,1,21,3,24,3,2008-02-23 06:57:34,2008-02-22 21:08:59
3c386aa3380b698396d522f1132343ced482ff42...2b81fab2885256501d0bba6e16e516addb667bf3,1,11,1,12,7,2008-02-23 06:57:38,2008-02-22 18:56:50
2b81fab2885256501d0bba6e16e516addb667bf3...435fc8523fd3a625acfeebffe433f1f7516ab9e2,2,8,2,10,3,2008-02-23 06:57:38,2008-02-22 18:57:30
435fc8523fd3a625acfeebffe433f1f7516ab9e2...55f105653715356fe0b2392445a6f394b891402c,1,16,1,17,6,2008-02-23 06:57:38,2008-02-22 19:04:12
55f105653715356fe0b2392445a6f394b891402c...e25d5f9c82ef6a676de616bd28751cdfbcd53b15,2,33,2,35,5,2008-02-23 06:58:55,2008-02-22 19:04:54
e25d5f9c82ef6a676de616bd28751cdfbcd53b15...bd56ff54f710d463a6858bdc7ef6245f9ef30f42,2,16,2,18,4,2008-02-23 06:59:11,2008-02-22 22:52:50
dc2715554eae139ac6babbce1f973f83a7a4fedc...15387e32ff5116b82d3fe53df55b8c87eec83e01,1,4,0,4,2,2007-10-27 06:17:19,2007-10-26 04:13:50
806ea701ce3624aa6a89648b6ca5d858703398cb...fc74ecc12cd339c6d8abd1c363733e67eb50945c,1,11,7,18,7,2007-09-23 16:57:54,2007-09-10 02:07:02
fc74ecc12cd339c6d8abd1c363733e67eb50945c...38a457baae8202e43b092dbb71dca736f6e45600,1,202,0,202,1,2007-09-23 16:59:14,2007-09-20 00:34:14
806ea701ce3624aa6a89648b6ca5d858703398cb...8fceacee676ba9595a4dfdbe7b9726781bfd3ef9,1,1,1,2,1,2007-09-21 19:53:08,2007-09-21 19:52:30
8fceacee676ba9595a4dfdbe7b9726781bfd3ef9...1e6ab5de4fc4ae2902a09f18fe43249c4d012a35,1,4,4,8,2,2007-09-21 19:54:11,2007-09-21 13:43:44
1e6ab5de4fc4ae2902a09f18fe43249c4d012a35...9c2d28c74e374174de01901238159b63a96a04ba,1,1,1,2,1,2007-09-21 19:54:24,2007-09-21 14:37:18
9c2d28c74e374174de01901238159b63a96a04ba...b9fc6ea9efdc988d851666d45d80076839d9c225,1,9,1,10,2,2007-09-22 22:41:50,2007-09-19 20:12:48
b9fc6ea9efdc988d851666d45d80076839d9c225...822f7c7349d61f6075961ce42c1bd1a85cf999e5,19,23,23,46,22,2007-09-23 23:12:00,2007-09-23 20:42:08
822f7c7349d61f6075961ce42c1bd1a85cf999e5...b019304886c2f5d702988e8f8bd86a1b621183c6,1,1,1,2,1,2007-09-24 00:07:10,2007-09-22 01:48:45
2a858ee95134926a0ccccb9a78db06bcb0bd65d0...f8babc4dabebebd9e95537df6da0408c1c178615,1,4,4,8,4,2007-09-30 06:15:50,2007-09-29 02:32:11
2a858ee95134926a0ccccb9a78db06bcb0bd65d0...1abbe475ff17349839f72a024cf665b8ec86473f,3,100,0,100,4,2007-09-30 04:11:21,2007-09-26 21:31:01
2a858ee95134926a0ccccb9a78db06bcb0bd65d0...1f088191015968436e7cc6423827b0c26f3427ea,1,1,5,6,5,2007-09-30 03:45:33,2007-09-30 03:45:33
1f088191015968436e7cc6423827b0c26f3427ea...076d7aa5d406fea1a5dedff5e2c54e2716528222,1,1,1,2,1,2007-10-01 07:27:51,2007-10-01 07:27:51
2a858ee95134926a0ccccb9a78db06bcb0bd65d0...856665f827c31ace3f19e672f8911f7f15f2a0e2,3,22,16,38,3,2007-09-30 03:31:59,2007-09-28 14:17:31
856665f827c31ace3f19e672f8911f7f15f2a0e2...b64265ca8da17d30561febf62a13990a2dc96d2f,1,10,1,11,1,2007-09-30 03:31:59,2007-09-28 14:17:39
b64265ca8da17d30561febf62a13990a2dc96d2f...d392e712a844e6ce029aa901902e08a3da82f89d,2,26,7,33,7,2007-09-30 03:31:59,2007-09-28 14:17:45
d392e712a844e6ce029aa901902e08a3da82f89d...070f6918d148f6bac8f5cc829c53fd28be018697,1,1,1,2,1,2007-10-02 21:31:37,2007-10-02 21:31:37
070f6918d148f6bac8f5cc829c53fd28be018697...96b2d4fa927c5055adc5b1d08f10a5d7352e2989,1,151,0,151,1,2007-10-03 08:34:25,2007-10-02 11:02:57
41a7aa588f449d3b139480b102f510abc5ef7f85...41337e22f0513c8a0ed603e30feb1fecaeb1649e,1,55,0,55,1,2007-11-17 21:28:21,2007-11-17 20:47:16
41337e22f0513c8a0ed603e30feb1fecaeb1649e...3caf320ba8fc8277b5875fe306efbfa333b92487,1,3,0,3,1,2007-11-17 21:28:21,2007-11-14 00:52:02
3caf320ba8fc8277b5875fe306efbfa333b92487...fede44b2e18c1e5985197913e8dcf5753f4eb99e,2,15,1,16,2,2007-11-17 21:28:21,2007-11-11 06:10:33
fede44b2e18c1e5985197913e8dcf5753f4eb99e...60f3ff12573e411476f7a32ab13bbb9b8063c8f7,2,7,7,14,7,2007-11-17 21:28:21,2007-11-11 06:10:34
60f3ff12573e411476f7a32ab13bbb9b8063c8f7...111947ef8cd3071faadb527c20047efd4330138a,2,110,19,129,13,2007-11-17 21:28:21,2007-11-12 06:56:52
111947ef8cd3071faadb527c20047efd4330138a...826a93398df54d4f3874f8851da29878c14b1a88,1,1,1,2,1,2007-11-17 21:39:47,2007-11-13 21:47:26
41a7aa588f449d3b139480b102f510abc5ef7f85...947a604b01a8e81b3d0341d38fbf891289f3c0bb,2,19,1,20,2,2007-11-16 09:35:58,2007-11-15 07:18:07
947a604b01a8e81b3d0341d38fbf891289f3c0bb...e23cb8c0cc0fb9f18e7e7106e2eec692a7b10044,1,2,3,5,2,2007-11-16 09:35:58,2007-11-15 08:39:57
e23cb8c0cc0fb9f18e7e7106e2eec692a7b10044...3d7cd64cb493e3e30e4398c7b6cd66ee38cb4418,1,1,1,2,1,2007-11-16 09:35:58,2007-11-15 08:42:04
3d7cd64cb493e3e30e4398c7b6cd66ee38cb4418...0bee49c6abf18082a01f5d1a2106608456fb7d5a,1,2,3,5,2,2007-11-16 09:35:58,2007-11-15 08:47:53
0bee49c6abf18082a01f5d1a2106608456fb7d5a...e3f062bfd412adafb7ed6a8f24a3ec89d39211fc,1,2,2,4,1,2007-11-17 18:24:25,2007-11-17 13:35:25
e3f062bfd412adafb7ed6a8f24a3ec89d39211fc...6459c7c6786aa9bda0c7a095c9db66c36da0e5f0,1,2,5,7,4,2007-11-19 00:35:55,2007-11-18 15:34:03
6459c7c6786aa9bda0c7a095c9db66c36da0e5f0...fce0499fad13815d936c1068b7a064030f543b3d,2,30,1,31,3,2007-11-20 09:01:46,2007-11-20 05:39:53
41a7aa588f449d3b139480b102f510abc5ef7f85...38f9f5ec41803558b4ccefc9db08fac5696aff8d,1,13,2,15,2,2007-11-16 09:32:59,2007-11-15 09:38:45
1c46ab1fada6eb449336a624995293cdd74f2b08...f1fe8f5c1eb30c3b1e13c425216253045f6ba2d1,1,2,0,2,1,2007-12-02 10:32:36,2007-11-26 12:42:06
1c46ab1fada6eb449336a624995293cdd74f2b08...b45563a229f5150271837cf487a91ddd8224fbd3,5,104,14,118,8,2007-12-02 10:24:46,2007-12-01 06:22:38
b45563a229f5150271837cf487a91ddd8224fbd3...f714fb846b421c7d7addd4e1b706302ba272423d,1,1,0,1,1,2007-12-03 06:58:37,2007-12-03 06:58:37
3849bfba84fb5b0e9d46920f62105b4e1dd97e63...ae0754ac9a24afa2693246222fc078fe9c133b3a,1,1,1,2,1,2007-09-20 16:59:45,2007-09-18 22:33:34
2352570bf43368f3d3931f7b24bb7fd44e68eef3...ef803fd4b09bca707c7c27669a2789bb050b488c,1,15,6,21,5,2011-04-01 21:42:25,2011-04-01 09:20:31
ef803fd4b09bca707c7c27669a2789bb050b488c...21d2616a7181472ae43e33d762a2733827cff9e9,1,18,0,18,1,2011-04-01 21:42:29,2011-04-01 09:20:32
21d2616a7181472ae43e33d762a2733827cff9e9...4b56cf58a9ee684d47e01d815eccd75252d61da5,2,3,8,11,3,2011-04-01 21:42:31,2011-04-01 09:20:33
2352570bf43368f3d3931f7b24bb7fd44e68eef3...6cb0186a41335f5e82d1e91abf4ce70938d0a020,1,1,1,2,1,2011-04-01 19:17:45,2011-04-01 14:46:27
2352570bf43368f3d3931f7b24bb7fd44e68eef3...0235017eafa8dfc3a7353b7091ad5109d0beb7a5,2,8,1,9,2,2011-04-01 18:16:21,2011-04-01 08:29:16
195b7ca6f229455da61f9f6b6e56a6558fb0e8ee...41e6b91f01bc9bb7e1679542a8cce9bd4252fd2e,1,2,1,3,1,2011-03-27 17:21:12,2011-03-27 17:19:14
e9f3f8b6f4141dae526e9792ba6dede7aa038622...7a75e661c5cef9fcd7c84fe0fb22672a57d6373e,5,227,11,238,17,2011-05-26 07:28:04,2011-03-19 07:20:54
c4649188e9140c960cec54798b153382fb4d6191...ec84e069afd7845b1d6bb37d2aaefa913b0e0141,1,1,3,4,1,2012-05-25 18:22:02,2012-05-25 18:12:04
ec84e069afd7845b1d6bb37d2aaefa913b0e0141...a3347b988a338e95b7f3b11eda776ac0d7b84dd0,1,5,3,8,2,2012-05-25 18:24:08,2012-05-25 16:02:03
ac2b0e8fb77d02f480af3f45a44cb9ea611008a4...2b5ba7b04631a457165531405710e8a303757b01,1,8,0,8,1,2012-06-27 21:02:51,2012-06-27 16:22:01
73a60cd252a417a14092791ad0ff33aa6f62f616...720e309bf6a5d46e1a6d5ee929d24869a329b838,1,984,717,1701,811,2012-05-01 14:28:58,2012-04-30 15:55:16
f25950f3475e263ed6c8f0797bb058ba6444f85e...1d2c14df1605a05118524b2382402d689f69d737,1,1,1,2,1,2013-01-31 16:09:53,2013-01-31 12:22:51
f25950f3475e263ed6c8f0797bb058ba6444f85e...e339aa92ae2db194a3d5738cb3aee6d8b3bf7b10,2,3,4,7,3,2012-03-26 19:59:04,2012-03-26 19:51:50
e339aa92ae2db194a3d5738cb3aee6d8b3bf7b10...0aff719f489771c5e52259394d011c51317b118f,2,2,2,4,2,2012-04-12 20:48:52,2012-04-12 17:56:28
c07a6bc57255a2d00b41333f570b64cc36c70cfb...78910462ce3aff76ebcfe3a1e6d559c99e14d1fe,1,4,0,4,3,2013-07-24 23:04:37,2013-07-24 17:55:18
b4cf0f1784362fb4aa2383d8d5d829caa92ca3a0...d5f5d0a9443c3892cdf9665ed8e0f9004706ed65,1,11,5,16,3,2010-07-07 04:53:11,2010-07-07 04:53:11
b4cf0f1784362fb4aa2383d8d5d829caa92ca3a0...d66ee046fc8597af62daeb890b15d5799c786b0d,1,2,2,4,2,2010-07-06 15:42:15,2010-07-06 07:54:33
d66ee046fc8597af62daeb890b15d5799c786b0d...420432d4342e214c15f063a630a883072d4e5779,1,1,1,2,1,2010-07-07 04:28:55,2010-07-06 19:34:31
4e5dd044c62f2a82de083e7cd46cad7b0d3465ae...10ae7526bebb505ddddba01f76ec97d5f7b5e0e5,5,16,3,19,8,2010-09-29 20:15:56,2010-09-27 23:58:25
10ae7526bebb505ddddba01f76ec97d5f7b5e0e5...37ab5156ae31ec81e3489406f23be6936a2a370c,2,25,3,28,7,2010-09-29 20:18:04,2010-09-27 23:58:26
6a364ced497e407ab3ffb2554d4ef2c78f801832...3b9a2b07ef411d9f0066db2a5d98ff5a1f6669a5,1,1,1,2,1,2014-12-09 21:50:15,2014-12-09 09:48:36
6a364ced497e407ab3ffb2554d4ef2c78f801832...29d8a834b5fcb1de057ed8563339b104e0251717,1,24,29,53,10,2013-11-18 21:04:22,2013-11-14 19:18:35
29d8a834b5fcb1de057ed8563339b104e0251717...48f6407ffec1db18f5ef3316f0d761965bb17f1e,1,49,49,98,6,2013-11-18 21:04:22,2013-11-14 19:19:04
48f6407ffec1db18f5ef3316f0d761965bb17f1e...7c85f8acb2282e3ed108c46b59fd5daa78bf17db,1,20,55,75,20,2013-11-18 21:04:23,2013-11-14 19:19:34
7c85f8acb2282e3ed108c46b59fd5daa78bf17db...f79d9c581437d8f48e10506e62c34b9718c7f3f7,1,13,35,48,13,2013-11-18 21:04:23,2013-11-14 19:20:26
f79d9c581437d8f48e10506e62c34b9718c7f3f7...e05881a4577cedca4d7456b3cb1f8bbd6f480df2,2,20,60,80,15,2013-11-18 21:04:23,2013-11-14 19:20:58
e05881a4577cedca4d7456b3cb1f8bbd6f480df2...1c8cca190a1029d16450e61fbc4ce6f85a867f30,1,8,7,15,2,2013-11-18 21:04:24,2013-11-14 19:21:26
1c8cca190a1029d16450e61fbc4ce6f85a867f30...8b013788a14b96b8d20b1f6bc76a42f9733aefad,3,13,20,33,14,2013-11-18 21:04:24,2013-11-14 19:21:58
8b013788a14b96b8d20b1f6bc76a42f9733aefad...419a597f6408d5b5cffe3e278258f58b47d15ad3,4,26,30,56,14,2013-11-18 21:04:24,2013-11-14 19:22:27
419a597f6408d5b5cffe3e278258f58b47d15ad3...efc684245b81ae0fb8f0afbd06dc1c3101c4e5a0,6,0,299,299,9,2013-11-18 21:04:25,2013-11-14 19:23:12
efc684245b81ae0fb8f0afbd06dc1c3101c4e5a0...e837af61345344448346afef79d53a5ff95bb0b3,1,1,1,2,1,2013-11-18 21:04:25,2013-11-14 19:23:42
e837af61345344448346afef79d53a5ff95bb0b3...6bb69077b74b792ddef66e372c86e66dea8e449b,1,15,21,36,16,2013-11-18 21:04:25,2013-11-14 19:24:08
6bb69077b74b792ddef66e372c86e66dea8e449b...5699d17ee0949e6c01311a03dcfce485fcdd9b1a,4,16,6,22,13,2013-11-18 21:04:25,2013-11-14 19:24:37
5699d17ee0949e6c01311a03dcfce485fcdd9b1a...f7988c15ad6801383384ee56970a52f4e485f0cb,1,1,0,1,1,2014-02-24 22:33:29,2013-12-14 02:05:26
f7988c15ad6801383384ee56970a52f4e485f0cb...e8fa59b9081d90299aa5b41412bf93e8856a612b,1,1,2,3,2,2014-02-24 22:33:46,2013-12-14 02:06:40
e8fa59b9081d90299aa5b41412bf93e8856a612b...b6aad994737458177ddf68939719f90e7909f656,2,2,2,4,2,2014-02-24 23:26:30,2013-12-18 13:41:27
b6aad994737458177ddf68939719f90e7909f656...7b359ea6b3333a87fd3fa8b84913f2b75ed244ad,2,1,10,11,4,2014-02-24 23:26:33,2014-01-02 21:57:12
0f64bfa9567f697d6152ef9ea937d4b573029a08...385ceec1cb46f8a476fa11ffc853dedba512fd52,1,12,10,22,2,2011-08-29 05:19:27,2011-08-28 07:34:56
1421fd9df4f1e3ed232bd1c683c6e264a464a41e...817bac35f24166e8b306ecef5283ed721068f113,1,7,6,13,2,2011-08-11 19:27:27,2011-08-11 17:51:45
817bac35f24166e8b306ecef5283ed721068f113...322bb6e12f713900dcac7cac59c00a167f70f2c3,3,78,1,79,8,2011-08-11 19:27:30,2011-08-11 17:51:46
1421fd9df4f1e3ed232bd1c683c6e264a464a41e...1f275b7c4caebf8ca5c002458f0f1b7994548a97,2,4,2,6,3,2011-08-11 19:18:02,2011-08-11 09:15:37
1f275b7c4caebf8ca5c002458f0f1b7994548a97...068762846634dff73a18d71188736e0ded03a1cc,5,155,150,305,7,2011-08-11 19:18:02,2011-08-11 09:15:38
78f4c9f62549fdd9a52550449c4e3148e7e0900d...8c80ff362f1f4e586a37fba8e6dc83eee67aa2b5,1,5,0,5,1,2012-02-23 19:20:15,2012-02-23 19:20:15
8c80ff362f1f4e586a37fba8e6dc83eee67aa2b5...07f050c9996cbda2af8d42996ebd349dcdb4c28d,1,6,4,10,1,2012-02-23 19:35:59,2012-02-23 12:52:06
d6b7e0b98f8d0f84e3b2614b33b52402fefb5735...4903161fb8c74bc583b21d7ffe7abaf223df4253,2,7,0,7,5,2006-10-30 23:29:53,2006-10-30 23:29:53
4903161fb8c74bc583b21d7ffe7abaf223df4253...8d63d95f297446fe110ea76d350ae15676e2ed54,1,1,1,2,1,2006-10-31 00:07:54,2006-10-31 00:07:54
8d63d95f297446fe110ea76d350ae15676e2ed54...173a9cbe7031bc3574b3f41cb2d2375cf959ff2a,1,1,1,2,1,2006-10-31 01:39:17,2006-10-31 01:39:17
173a9cbe7031bc3574b3f41cb2d2375cf959ff2a...744f498522d2255cf0ce967298c3d87b4727d1a4,1,6,8,14,3,2006-10-31 01:47:36,2006-10-31 01:37:49
744f498522d2255cf0ce967298c3d87b4727d1a4...9dad9d2e5b322835c87e1653268d892a95ee0f1f,1,1,1,2,1,2006-10-31 02:58:03,2006-10-31 02:58:03
594270635732d6320d6e6d7fa127679ae90ef5b1...5d1faf8791fa85ba9be2282900d4f704c7790648,5,83,15,98,5,2006-11-23 00:06:32,2006-11-21 23:49:15
5d1faf8791fa85ba9be2282900d4f704c7790648...2bbaaed9eefa92e8a17e74ec5f9b87ecdc7a5949,3,18,8,26,6,2006-11-23 00:36:49,2006-11-23 00:33:32
2bbaaed9eefa92e8a17e74ec5f9b87ecdc7a5949...e945f95157c2c515e763ade874931fc1eb671a0b,1,1,1,2,1,2006-11-23 00:57:34,2006-11-23 00:57:34
e945f95157c2c515e763ade874931fc1eb671a0b...0ea865ce7af4b2b6ee85dc52b5fad84260e27871,1,18,6,24,8,2006-11-23 22:20:32,2006-11-23 22:02:37
0ea865ce7af4b2b6ee85dc52b5fad84260e27871...48d044b5fe7ae553f05186db46b5cb4708afceb4,1,7,0,7,1,2006-11-23 23:17:43,2006-11-23 22:54:03
48d044b5fe7ae553f05186db46b5cb4708afceb4...e70dc780a4325138ddfae6786c1eb3ec06233de6,1,10,4,14,3,2006-11-23 23:17:45,2006-11-23 22:54:04
e70dc780a4325138ddfae6786c1eb3ec06233de6...4769489a412fb0decbd73ce59a6756985d0d6bc4,1,1,1,2,1,2006-11-23 23:17:46,2006-11-23 22:54:05
594270635732d6320d6e6d7fa127679ae90ef5b1...1a9eb3b9d50367bee8fe85022684d812816fe531,1,17,3,20,3,2006-11-22 05:27:51,2006-09-22 23:17:58
594270635732d6320d6e6d7fa127679ae90ef5b1...bfcc921430423828233dadfe274802ae68900f6e,2,89,25,114,23,2006-11-22 05:26:12,2006-11-21 19:31:24
594270635732d6320d6e6d7fa127679ae90ef5b1...7cdbff14d4823c3a3d64c2011ab0b23f794efef8,14,10,2497,2507,36,2006-11-22 04:55:39,2006-11-20 08:49:31
7cdbff14d4823c3a3d64c2011ab0b23f794efef8...17bcdad3b7baa3b12c662663372f1e3cd560dd8e,2,67,12,79,9,2006-11-22 04:55:40,2006-11-20 09:06:09
17bcdad3b7baa3b12c662663372f1e3cd560dd8e...8092c7f6af044836abf83ed26d542327a4b95c08,1,18,0,18,1,2006-11-22 05:18:07,2006-11-22 05:13:28
8092c7f6af044836abf83ed26d542327a4b95c08...51901e96bf592877f7b266d0d9c6cb83b363edce,1,3,3,6,3,2006-11-27 06:16:31,2006-11-27 06:16:31
51901e96bf592877f7b266d0d9c6cb83b363edce...c1751616381b6e8c8eae311107b5969a0233a6d8,1,1,1,2,1,2006-11-27 06:19:42,2006-11-27 06:19:42
594270635732d6320d6e6d7fa127679ae90ef5b1...21f88ac84a024fcc73a22547e51509aa1459ab03,1,7,1,8,2,2006-11-22 03:02:08,2006-11-02 11:12:26
21f88ac84a024fcc73a22547e51509aa1459ab03...ac1471b39f1413046d4e338d898a93e403cbd3e5,1,4,3,7,2,2006-11-24 10:54:37,2006-11-24 10:54:37
6be935115b4a3bfa9062875a569d4a018ac372e2...6538d1ef31fc2989e4dd0422a31a170a7d560b02,3,37,0,37,4,2006-12-23 17:22:30,2006-12-23 16:26:09
6538d1ef31fc2989e4dd0422a31a170a7d560b02...8dbc0fcef4912f7814b7822324b3c1943e55865b,1,103,45,148,11,2006-12-23 17:30:36,2006-12-23 14:57:12
8dbc0fcef4912f7814b7822324b3c1943e55865b...d6779124b90ef5c00697815b04c9f75fd3756586,2,7,7,14,4,2006-12-24 08:16:56,2006-12-24 05:45:37
d6779124b90ef5c00697815b04c9f75fd3756586...8e554429e8a9dbb5dba6b8aeca66fc27c0bb5538,1,5,14,19,6,2006-12-24 08:29:43,2006-12-24 05:45:47
8e554429e8a9dbb5dba6b8aeca66fc27c0bb5538...9e83266525aad5c6210b9a21be9b1c6996d5544f,4,303,4,307,9,2006-12-24 08:32:49,2006-12-22 21:06:08
6be935115b4a3bfa9062875a569d4a018ac372e2...d9606e85cdf26b738786b5e5289bf8335656e95e,1,2,2,4,1,2006-12-23 09:08:02,2006-12-23 08:44:00
d9606e85cdf26b738786b5e5289bf8335656e95e...e0ec18192db8a5f80705a81dfaa1caa3e6c48c1a,3,21,4,25,7,2006-12-23 09:29:37,2006-12-23 08:44:47
ae72f685418b79bbd67e1017c5b1ac7d731c042e...48c3242450fe5fb18e6890812c000ed5c6291a98,3,29,2,31,5,2006-12-27 09:33:24,2006-12-27 09:24:05
48c3242450fe5fb18e6890812c000ed5c6291a98...4aec56d12ba66a321ce8a6db2ab60f81be5ccfc5,4,94,2,96,7,2006-12-27 09:47:57,2006-12-27 09:47:57
eaf6459e4d482af51429f9464125621b805eb5fd...1bb914603a0f151669de2c31671f6c878c5eb79f,1,2,2,4,1,2007-01-22 05:24:49,2007-01-22 05:24:05
1bb914603a0f151669de2c31671f6c878c5eb79f...026aa93818a536c819a94aae5bbefe1b6251fe0e,6,12,48,60,20,2007-01-22 05:29:57,2007-01-22 05:29:44
026aa93818a536c819a94aae5bbefe1b6251fe0e...ec587fde0a76780931c7ac32474c8c000aa45134,2,2,1,3,2,2007-01-22 05:51:01,2007-01-22 01:10:51
ec587fde0a76780931c7ac32474c8c000aa45134...f43117a6c134f3b7873983eae0df1cc14b270ff1,2,2,2,4,2,2007-01-22 06:22:23,2007-01-22 06:22:23
f43117a6c134f3b7873983eae0df1cc14b270ff1...a0022eebf345a4515c7d148c303911010b1fa834,2,5,1,6,2,2007-01-22 06:23:58,2007-01-22 06:23:58
a0022eebf345a4515c7d148c303911010b1fa834...e3ff4b244726f89620201e3295f097cf00b6b502,2,32,3,35,5,2007-01-22 07:28:28,2007-01-22 07:28:28
e3ff4b244726f89620201e3295f097cf00b6b502...18af29f247f79b6fb61335f98a21daea67f5632f,1,95,38,133,3,2007-01-22 07:35:47,2007-01-22 06:26:41
18af29f247f79b6fb61335f98a21daea67f5632f...d3b1785f3fe681f6837a6110008af98003f675d3,1,4,3,7,2,2007-01-22 17:44:25,2007-01-22 16:14:56
d3b1785f3fe681f6837a6110008af98003f675d3...bed118d6bb6dee92180469466dfa265265678dd4,1,7,1,8,1,2007-01-22 17:44:26,2007-01-22 16:16:05
bed118d6bb6dee92180469466dfa265265678dd4...67e4baf82679e6362d950f6a80a9a261cf266555,1,1,1,2,1,2007-01-22 17:44:26,2007-01-22 14:58:03
67e4baf82679e6362d950f6a80a9a261cf266555...bf3f67ba718393fb2b5fd5d4fc861029d4578a8a,1,1,1,2,1,2007-01-22 20:20:14,2007-01-22 20:20:14
bf3f67ba718393fb2b5fd5d4fc861029d4578a8a...e136f33b5ff9b2293a61073295b0294fad8e6e42,1,69,7,76,3,2007-01-22 20:54:02,2007-01-22 15:25:47
e136f33b5ff9b2293a61073295b0294fad8e6e42...8276c0070f8f8959ab4b6ec458fa0740e9abda9e,1,9,10,19,6,2007-01-22 21:11:46,2007-01-22 20:29:45
8276c0070f8f8959ab4b6ec458fa0740e9abda9e...cea70cf881290741da59c2e36050c723e6c9309d,1,1,1,2,1,2007-01-22 21:15:50,2007-01-22 20:25:30
cea70cf881290741da59c2e36050c723e6c9309d...5e207b4bf837f0ac4e76a925b1c5cb23326de492,1,2,0,2,2,2007-01-23 00:25:15,2007-01-23 00:25:15
5e207b4bf837f0ac4e76a925b1c5cb23326de492...83e24dce148fd384cbfb01cf718ec32618f6d8b3,1,10,9,19,2,2007-01-23 03:40:57,2007-01-22 21:03:31
83e24dce148fd384cbfb01cf718ec32618f6d8b3...90f70a910ac77cab7bc1b9a6c4b233add98a58c7,1,1,1,2,1,2007-01-23 03:46:19,2007-01-23 03:38:28
90f70a910ac77cab7bc1b9a6c4b233add98a58c7...222664e74dec10303bfa0c99e88f31563fdc6952,1,2,2,4,2,2007-01-23 04:40:26,2007-01-23 03:21:15
222664e74dec10303bfa0c99e88f31563fdc6952...c9a899256920b3266bb29f9d22bf6b9ab1b5a377,1,0,3,3,1,2007-01-23 05:39:03,2007-01-23 05:39:03
c9a899256920b3266bb29f9d22bf6b9ab1b5a377...d7ebd53d371153f7a61c0fe9f384c9662b751bf6,2,32,11,43,3,2007-01-24 00:58:13,2007-01-24 00:51:22
d7ebd53d371153f7a61c0fe9f384c9662b751bf6...83cd10a05688e6429f9e65cffbe90683e9487800,1,20,0,20,1,2007-01-24 01:35:48,2007-01-23 12:37:25
83cd10a05688e6429f9e65cffbe90683e9487800...e955ae957c401cb541f23d46af66c9b3d5b8ffe9,1,1,1,2,1,2007-01-24 23:08:31,2007-01-24 14:04:37
e955ae957c401cb541f23d46af66c9b3d5b8ffe9...084ae0a7bd8a13dea7731dd7b6bf37f08c1cfc77,4,9,6,15,6,2007-01-24 23:13:47,2007-01-24 14:05:16
084ae0a7bd8a13dea7731dd7b6bf37f08c1cfc77...eda95d9969d9fbd23a80c2261299098f16bea611,1,2,2,4,2,2007-01-24 23:29:07,2007-01-24 23:29:07
eda95d9969d9fbd23a80c2261299098f16bea611...191453f66449537da29e9fc156f7a981845ea8f6,1,2,2,4,1,2007-01-24 23:30:37,2007-01-24 14:14:33
191453f66449537da29e9fc156f7a981845ea8f6...497171e765b7b4f903d21379bee050380e539cf3,2,5,5,10,4,2007-01-24 23:32:52,2007-01-24 19:54:46
497171e765b7b4f903d21379bee050380e539cf3...27dca07fb77f6f5851e3a8de54f86c803358caa4,4,26,12,38,14,2007-01-25 00:12:15,2007-01-23 08:20:17
27dca07fb77f6f5851e3a8de54f86c803358caa4...ae1dffcb28ee89a23f8d2747be65e17c8eab1690,3,15,6,21,5,2007-01-25 00:12:15,2007-01-23 08:51:53
ae1dffcb28ee89a23f8d2747be65e17c8eab1690...196055c2dbbd8ee41b4afb1c2d035d0c05c963b8,1,3,1,4,1,2007-01-25 01:33:25,2007-01-23 15:51:18
196055c2dbbd8ee41b4afb1c2d035d0c05c963b8...a69e542989d0aa1576a4b6820454b9b0d2636796,3,40,12,52,5,2007-01-25 02:08:02,2007-01-23 05:55:18
a69e542989d0aa1576a4b6820454b9b0d2636796...9e10fd1ac0bb50202138efb9291568160dacd7ab,1,59,32,91,9,2007-01-25 02:08:02,2007-01-23 06:37:33
9e10fd1ac0bb50202138efb9291568160dacd7ab...af7cf268f0bf8d4216f9c11d1cb0082cb3550f61,3,29,15,44,9,2007-01-25 02:08:02,2007-01-25 00:47:24
af7cf268f0bf8d4216f9c11d1cb0082cb3550f61...e28714c527339a477fca226765163b9361d94285,4,35,10,45,10,2007-01-25 02:08:02,2007-01-25 01:02:15
e28714c527339a477fca226765163b9361d94285...5dee29ac0fc95999a42c5cbac767724a9ff73cfa,3,24,1,25,4,2007-01-25 07:06:30,2007-01-25 04:45:39
5dee29ac0fc95999a42c5cbac767724a9ff73cfa...535514f1f3cd32dfe2cb4c70e97b41ea868d1134,1,3,3,6,3,2007-01-25 07:38:55,2007-01-22 10:56:27
535514f1f3cd32dfe2cb4c70e97b41ea868d1134...1b555932cdb7f75239623573cd2ff25fa98ab4e4,2,12,1,13,2,2007-01-26 03:16:07,2007-01-26 00:51:21
1b555932cdb7f75239623573cd2ff25fa98ab4e4...fd73423f01361f112dbb9972ebce8eabae7dd8b1,1,26,1,27,2,2007-01-26 03:27:03,2007-01-25 23:41:23
fd73423f01361f112dbb9972ebce8eabae7dd8b1...cb280e107523e5263f390db715234700355a63b9,5,13,22,35,8,2007-01-26 05:16:58,2007-01-26 03:05:01
cb280e107523e5263f390db715234700355a63b9...e1b161161d253a9e7e4cf21cd2ab5b82a4b85273,1,2,0,2,1,2007-01-26 05:17:19,2007-01-26 04:48:58
e1b161161d253a9e7e4cf21cd2ab5b82a4b85273...ae9c6ffe3039fc4d0a89eb253800b3ca58830bb2,1,8,1,9,3,2007-01-26 06:03:16,2007-01-26 05:50:49
ae9c6ffe3039fc4d0a89eb253800b3ca58830bb2...a9eefb3bfc66b7f5dba86ebf57b05e32c33eb9e5,1,109,0,109,1,2007-01-26 06:03:37,2007-01-26 05:55:34
a9eefb3bfc66b7f5dba86ebf57b05e32c33eb9e5...df373ea99a1cf3056a72bad1d66f0e62f3b41c20,1,13,4,17,6,2007-01-26 06:31:10,2007-01-26 06:14:45
df373ea99a1cf3056a72bad1d66f0e62f3b41c20...af67e91c39aff2d955e9c325c6c4e843d5faef60,1,12,1,13,2,2007-01-26 08:02:51,2007-01-26 06:51:49
af67e91c39aff2d955e9c325c6c4e843d5faef60...007e2ba65902b484fc65a313e54594a009841740,1,1,1,2,1,2007-01-26 08:03:23,2007-01-25 21:11:40
007e2ba65902b484fc65a313e54594a009841740...8a8169c0398ff9996216381d7688c2ba2d007050,1,1,2,3,2,2007-01-26 08:08:48,2007-01-25 17:40:03
8a8169c0398ff9996216381d7688c2ba2d007050...8ac65937d032ad3e4bda1d7d6a8b924a65a01fb4,2,23,18,41,5,2007-01-26 10:26:04,2007-01-26 10:26:04
8ac65937d032ad3e4bda1d7d6a8b924a65a01fb4...7f9acb2a16473e5ba6d44231d2fc844ca8bb9817,2,3,1,4,3,2007-01-26 23:38:21,2007-01-26 23:09:02
7f9acb2a16473e5ba6d44231d2fc844ca8bb9817...40d6dc0f9d4045d237f8334224777922789c6d04,1,8,24,32,2,2007-01-26 23:38:27,2007-01-26 10:57:50
40d6dc0f9d4045d237f8334224777922789c6d04...8a56da29628997289aa8ec888ba85889962393e4,1,5,1,6,1,2007-01-27 01:00:57,2007-01-27 01:00:57
8a56da29628997289aa8ec888ba85889962393e4...d848804a895254583095b5c23ebb5d5f5a8891a3,1,1,1,2,1,2007-01-27 01:39:03,2007-01-27 01:39:03
d848804a895254583095b5c23ebb5d5f5a8891a3...eb3204dfbb71626f83a95d2ab24569226a39c601,1,3,3,6,1,2007-01-27 06:38:00,2007-01-26 16:50:06
eb3204dfbb71626f83a95d2ab24569226a39c601...f127404c45eff139037834a6464b68fbe1798e16,1,6,3,9,2,2007-01-27 06:38:52,2007-01-26 14:28:55
f127404c45eff139037834a6464b68fbe1798e16...d67778eccdf778f0fc252aaade8a47c23bfebbd6,3,21,2,23,4,2007-01-27 21:46:59,2007-01-26 14:13:46
d67778eccdf778f0fc252aaade8a47c23bfebbd6...16507fcf0a9991976815972faa253d77804d6f35,2,6,1,7,2,2007-01-27 21:46:59,2007-01-27 13:21:53
16507fcf0a9991976815972faa253d77804d6f35...903b45fe1808f72e712a118bf115b9dc07d02420,2,7,2,9,3,2007-01-28 09:54:42,2007-01-28 03:40:36
903b45fe1808f72e712a118bf115b9dc07d02420...01754769ab9bf9ff2fe2b12590e7ee2c7c3448ca,13,35,28,63,19,2007-01-28 09:58:50,2007-01-28 08:50:53
01754769ab9bf9ff2fe2b12590e7ee2c7c3448ca...717d1462ba0ebc430775eccaae65eb9b8234eb32,1,107,66,173,7,2007-01-28 10:04:48,2007-01-28 09:34:06
717d1462ba0ebc430775eccaae65eb9b8234eb32...46e5e69d5f2e8ae87a29953531a3d1bd7cb0292f,1,10,5,15,4,2007-01-28 10:04:48,2007-01-28 09:42:31
46e5e69d5f2e8ae87a29953531a3d1bd7cb0292f...237fb6ca7cbe45f88523ad367d0d703a039dff2d,1,3,2,5,1,2007-01-28 10:08:51,2007-01-25 17:39:54
237fb6ca7cbe45f88523ad367d0d703a039dff2d...1891261ed3ed52022ae5322b4db338f9d5112909,1,22,9,31,6,2007-01-28 10:08:51,2007-01-27 07:24:07
1891261ed3ed52022ae5322b4db338f9d5112909...1b600e659abc7e409c9d830e332d3cef01062c1c,1,41,1,42,3,2007-01-28 10:08:51,2007-01-27 06:54:21
eaf6459e4d482af51429f9464125621b805eb5fd...9c5e66e97da8cadcc45a278c4e39a7d25674d4ff,3,45,1,46,5,2007-01-21 07:46:53,2007-01-20 22:04:02
d1f289c5aa52bb77dc4959fb21cef032d954869f...756373da254dbe8bd03bd83ec658d3f015fee958,1,2,6,8,1,2007-02-05 00:58:30,2007-02-04 00:23:38
756373da254dbe8bd03bd83ec658d3f015fee958...11dbe9e88016f3894eda79c7437f6c3bf79e155e,1,9,0,9,1,2007-02-05 01:05:16,2007-02-03 22:38:59
11dbe9e88016f3894eda79c7437f6c3bf79e155e...798123af21e1660cb606ab730ce721f354957719,2,5,4,9,4,2007-02-05 01:50:14,2007-02-05 01:50:14
798123af21e1660cb606ab730ce721f354957719...133f081057a99957d6d34aa1c4fec61e5c5d22d8,1,14,0,14,2,2007-02-05 21:38:02,2007-02-05 01:30:58
133f081057a99957d6d34aa1c4fec61e5c5d22d8...69057cf39f87ecfe7446b14aa7df87ccf19b1151,1,1,1,2,1,2007-02-05 21:48:59,2007-02-05 19:58:47
69057cf39f87ecfe7446b14aa7df87ccf19b1151...ea81fcc5762c56b13d1ad04d62b161d782c591f1,1,25,2,27,3,2007-02-05 21:48:59,2007-02-05 20:21:06
ea81fcc5762c56b13d1ad04d62b161d782c591f1...d8a9fea5ea44a4068cc95de9368798ae3cee74ee,1,8,0,8,4,2007-02-05 21:49:00,2007-02-05 20:44:22
d8a9fea5ea44a4068cc95de9368798ae3cee74ee...983591c31e2529fbba8dd2d69dce5ab446584921,1,1,0,1,1,2007-02-05 21:49:00,2007-02-05 20:44:24
983591c31e2529fbba8dd2d69dce5ab446584921...b26c87488fa89e444972c486326eecca5b2132c7,1,14,0,14,3,2007-02-05 21:49:00,2007-02-05 20:44:28
b26c87488fa89e444972c486326eecca5b2132c7...e459415c9c3c8e855998dd0247f23d32a0dca4ff,1,1,0,1,1,2007-02-05 21:49:00,2007-02-05 20:44:30
e459415c9c3c8e855998dd0247f23d32a0dca4ff...1b71eb35ddb20057a266b05258de24d350ed5ba5,1,1,1,2,1,2007-02-05 21:49:00,2007-02-05 20:44:32
1b71eb35ddb20057a266b05258de24d350ed5ba5...b2e69f6299b5a46840600176679b94843cf63a8d,1,31,0,31,3,2007-02-05 21:49:00,2007-02-05 20:44:37
b2e69f6299b5a46840600176679b94843cf63a8d...041794188ff4f7a0b3ada8058d174a0c114da78b,1,3,3,6,3,2007-02-05 21:49:00,2007-01-30 10:23:38
041794188ff4f7a0b3ada8058d174a0c114da78b...3fb624521e059c6c3caef470a9ff03f72b86036c,1,20,3,23,5,2007-02-05 21:49:00,2007-01-30 07:56:50
3fb624521e059c6c3caef470a9ff03f72b86036c...98d47d4ccf76725e7833c1bbda1da82f7648925f,3,262,0,262,3,2007-02-05 21:52:45,2007-01-12 21:57:03
98d47d4ccf76725e7833c1bbda1da82f7648925f...6d9ba67b0fc2f18c1d7a65514edbdcdf86429c1c,4,19,4,23,9,2007-02-05 22:02:16,2007-01-23 12:30:20
6d9ba67b0fc2f18c1d7a65514edbdcdf86429c1c...4c55068683ac2e9765ba6e112d2227e50fefae87,1,1,0,1,1,2007-02-05 22:03:27,2007-02-05 22:03:27
4c55068683ac2e9765ba6e112d2227e50fefae87...ca28370a3567c14841c594b89fd62449abc166e6,2,7,4,11,5,2007-02-05 22:10:01,2007-02-01 10:43:39
ca28370a3567c14841c594b89fd62449abc166e6...28389d45fb2161d4dcdc1bbfabbcc2fb135914c6,1,180,0,180,1,2007-02-05 22:22:28,2007-02-05 22:22:28
28389d45fb2161d4dcdc1bbfabbcc2fb135914c6...1cfe77333f274c9ba9879c2eb61057a790eb050f,3,228,26,254,21,2007-02-05 22:55:11,2007-01-30 09:11:08
1cfe77333f274c9ba9879c2eb61057a790eb050f...d66b37bb19ff7a347ba4ccbcdc11b00772518b57,2,58,0,58,3,2007-02-05 22:55:11,2007-02-05 05:42:38
d66b37bb19ff7a347ba4ccbcdc11b00772518b57...005f85d9ae95c44d8c6ecf61364642fbcaf49dd2,2,2,2,4,2,2007-02-05 22:55:11,2007-02-05 05:49:05
005f85d9ae95c44d8c6ecf61364642fbcaf49dd2...06e75a72372d0466e110002a7504fefebe0e9c52,2,9,2,11,3,2007-02-05 23:04:01,2007-02-05 23:04:01
06e75a72372d0466e110002a7504fefebe0e9c52...b6f5da1e0f4eeb59798b320f97d27f83d19f89df,1,48,6,54,5,2007-02-05 23:41:59,2007-02-02 07:30:03
b6f5da1e0f4eeb59798b320f97d27f83d19f89df...35ce862279f68a4798889adcdd90a1698a2c102f,1,12,0,12,2,2007-02-05 23:42:36,2007-01-24 19:21:10
35ce862279f68a4798889adcdd90a1698a2c102f...8188e73b17c570517ac3bac742810f1b2e5c420d,1,1,1,2,1,2007-02-06 00:56:13,2007-02-06 00:53:12
d77ee72662a821d66ae218056f0103eb24d8d4b4...f2eba66d4d1a664f40bcfd45e0b8a2670df222b3,1,36,26,62,6,2007-02-04 07:06:27,2007-02-04 02:49:16
f2eba66d4d1a664f40bcfd45e0b8a2670df222b3...dc9195ac7830bdf08ee847ef6a385c0b8f673d69,1,2,15,17,2,2007-02-04 07:06:27,2007-02-04 02:50:39
dc9195ac7830bdf08ee847ef6a385c0b8f673d69...632ac9fd12a2d4ff2c1a1fcd63492ce24315221f,2,9,4,13,4,2007-02-04 07:34:22,2007-02-04 07:31:47
f3a4ec48e402a7b49d410bdcb23470e9723788b0...3abe217a5bd1aefa748d53c08704b2a8a622307c,1,11,8,19,3,2006-02-28 19:02:02,2006-02-28 13:41:08
3abe217a5bd1aefa748d53c08704b2a8a622307c...0852694ba432aafff5d7619e3acc30f30f2339b7,1,15,12,27,5,2006-02-28 19:02:08,2006-02-28 13:42:18
0852694ba432aafff5d7619e3acc30f30f2339b7...d82343b93860348215db0c7267bc051e5f80aefa,1,3,0,3,1,2006-02-28 19:02:10,2006-02-28 14:40:28
d82343b93860348215db0c7267bc051e5f80aefa...e3601e8bb76e46745d4919c3f30b1dddae040eb2,1,8,4,12,2,2006-02-28 19:02:13,2006-02-28 14:03:48
e3601e8bb76e46745d4919c3f30b1dddae040eb2...aeecd23ae2785a0462d42191974e9d9a8e439fbe,1,4,0,4,1,2006-03-01 04:19:47,2006-03-01 04:19:47
b5767dd6605364002a96a9d039cd1f010707b4f6...fc96b7c9ba5034a408d508c663a96a15b8f8729c,1,45,8,53,6,2006-02-27 22:16:30,2006-02-27 22:16:30
fc96b7c9ba5034a408d508c663a96a15b8f8729c...2ae1c53b51ff78b13cc8abf8e9798a12140b7638,3,51,24,75,12,2006-02-27 22:47:45,2006-02-27 22:47:45
36610b24f1a1821eee95243663631c1295c202ed...80804d0af8f5bfa8ce87b5ef72cd2c5eb64c8f40,2,3,3,6,3,2006-02-27 23:27:21,2006-02-27 23:08:15
d9cfb964c7a59a39711da12e56563e10aa388331...d9a83684c473e04c61f0060c4926d20f8183f7b6,3,22,22,44,18,2006-02-27 19:10:16,2006-02-27 16:54:36
2beb3cdd18225be657849790ed845c4d367b760a...8273c79ae2e6b782dba3dccb815b386cc83e4294,4,40,4,44,7,2006-03-02 08:52:59,2006-03-02 08:45:48
8273c79ae2e6b782dba3dccb815b386cc83e4294...afaa8d66ab542de0c3f6d00aaacdf0ecfa78ff33,2,15,2,17,3,2006-03-02 09:11:05,2006-03-02 09:11:05
afaa8d66ab542de0c3f6d00aaacdf0ecfa78ff33...ec579767e719278c4a98a038da41a4cb7344e505,1,9,1,10,2,2006-03-02 09:11:31,2006-03-02 09:11:31
ec579767e719278c4a98a038da41a4cb7344e505...d920e18f53b94389562280c6920bf4e095129ea3,1,7,2,9,5,2006-03-02 09:50:09,2006-03-02 09:50:09
ce4c8b24a1efcf155c076d54a7e239251504f669...c6d4217ebc15aea283050d816f3c616eebb9f477,1,1,1,2,1,2006-03-03 23:09:04,2006-03-02 23:27:31
ea75cb7284f79250bebb6dd48c6161b0f1b4c1c6...c982647310fc5acd0bd6ebc408e70470447b387f,1,4,0,4,2,2006-03-15 17:10:41,2006-03-15 16:59:52
f61c2c970c08653ade940fce678c7591abcfcde4...180b0d7483711120e28289ff7d9fa346eddd5cb7,2,2,2,4,2,2006-03-10 02:13:19,2006-02-11 11:26:30
180b0d7483711120e28289ff7d9fa346eddd5cb7...a15a44ef6e4f6d5ec040cc2e69d2753531556947,1,4,1,5,2,2006-03-10 06:01:00,2006-03-10 04:47:24
a15a44ef6e4f6d5ec040cc2e69d2753531556947...96ce6d2607449a439ee30644465507eb5a6e1938,1,9,0,9,1,2006-03-10 06:01:10,2006-03-10 04:47:59
96ce6d2607449a439ee30644465507eb5a6e1938...eb0e0024b746a8ab6596928c792e002217ef334b,1,1,1,2,1,2006-03-10 06:51:21,2006-03-10 06:51:21
eb0e0024b746a8ab6596928c792e002217ef334b...f3219fbbba32b5100430c17468524b776eb869d6,1,14,6,20,5,2006-03-11 05:59:37,2006-03-11 05:59:37
f3219fbbba32b5100430c17468524b776eb869d6...2d0048e681dafa8f48593088fb6c2630c3186c96,1,1,0,1,1,2006-03-11 06:07:23,2006-03-11 06:05:47
2d0048e681dafa8f48593088fb6c2630c3186c96...f2561fda364ad984ef1441a80c90b0ee04f1a7c4,3,1362,1,1363,4,2006-03-11 06:09:24,2006-03-10 05:32:50
f61c2c970c08653ade940fce678c7591abcfcde4...7aaa715d0abb12067504af08919197a67a68aca7,2,9,26,35,12,2006-03-09 21:10:31,2006-03-09 09:44:19
4baff50551545e2b6825973ec37bcaf03edb95fe...e5e9b56528294e9455d22d1abb21ad32f098a1be,1,1,1,2,1,2012-03-26 04:35:52,2012-03-24 15:18:46
4baff50551545e2b6825973ec37bcaf03edb95fe...8d6e10327dff232cc253a5753c43fb414fed4e00,1,4,3,7,2,2006-04-18 21:44:58,2006-04-18 21:26:43
8d6e10327dff232cc253a5753c43fb414fed4e00...23edecbc9a5566ac5aa8fb251fbcf8bb83694837,1,20,1,21,4,2006-04-19 00:56:53,2006-04-19 00:19:48
a906ce6aa78ac8febf466b46c6fae029137cd506...a0a01958d7c059b1535b79a80dc37181b25bb677,1,1,1,2,1,2006-04-08 01:02:40,2006-04-08 01:02:40
40d88d4fa3b13c0e7fe8eca23ff6d27e790bada2...5ca64e488fcf4574fd1b52f7d523d9f31fbead4f,1,0,48,48,1,2006-04-11 23:35:39,2006-04-11 23:35:39
5ca64e488fcf4574fd1b52f7d523d9f31fbead4f...684958ae6162c593bd90ba893271ffb2381c3c44,1,2,2,4,2,2006-04-12 18:31:23,2006-04-12 18:31:23
684958ae6162c593bd90ba893271ffb2381c3c44...475443c8489d9167b944367d8ec8bfef77bee0a5,1,12,5,17,3,2006-04-12 18:45:18,2006-04-12 18:45:18
475443c8489d9167b944367d8ec8bfef77bee0a5...f4ee3eb68906f079dea45de4f1bbb03d68189eb3,1,8,3,11,7,2006-04-12 20:10:27,2006-04-12 20:10:27
40d88d4fa3b13c0e7fe8eca23ff6d27e790bada2...8a470ebfa1226724321b2df2c3e464c8e3600aa1,1,29,11,40,11,2006-04-11 19:06:27,2006-04-11 10:13:29
8a470ebfa1226724321b2df2c3e464c8e3600aa1...740659519e0b30bc6b64f00ba69825294c40db07,1,21,28,49,18,2006-04-11 21:31:31,2006-04-11 21:31:31
40d88d4fa3b13c0e7fe8eca23ff6d27e790bada2...ef9e58c826a4fcaa13457cd8177518163f82972a,2,7,7,14,7,2006-04-11 18:45:37,2006-04-11 16:37:58
86ff1d2012cc5e074d54c0823154019b99ca03f0...5c91da25d7da304d98c8808968f474f9fb7ac4db,2,5,0,5,2,2006-04-11 18:16:51,2006-04-11 11:22:17
5c91da25d7da304d98c8808968f474f9fb7ac4db...90c1b08c7dc5be890e697237f67a188da235ffc8,2,2,0,2,2,2006-04-11 18:17:50,2006-04-11 11:30:46
31262627109476c529418132e0820687003fb1fe...637cdd9d1d997fca34a1fc668fed1311e30fe95f,1,18,6,24,6,2006-06-02 18:09:38,2006-06-02 15:32:23
637cdd9d1d997fca34a1fc668fed1311e30fe95f...86f7780c0b77b3c162f85d499189f9d1f0b296df,1,6,0,6,1,2006-06-02 18:09:44,2006-06-02 16:49:32
2d71bcccc81e3569d97dd1314c3ca0f080f4a70f...2e1ded44f709ddc95c5e8a87e0d98127979115fe,1,18,0,18,1,2006-06-11 23:37:44,2006-06-11 16:50:47
0e84fb06a1022f99c96cfcd728e7bf029ef0b5e3...b266b123cd3124497a1d006cb126033ce458a85c,1,2,4,6,3,2006-06-04 07:10:48,2006-06-04 07:10:48
5892fc6504dd23d7cf9415afb13bae8a61d6c70e...5edbcd8d778d81254d2c8a4229c76c6fa7880407,1,2,2,4,2,2006-05-05 00:28:14,2006-05-04 21:18:14
5edbcd8d778d81254d2c8a4229c76c6fa7880407...fb335158d5a93349e16bc0985e75e93bb9fcd5eb,1,0,4,4,1,2006-05-05 00:38:41,2006-05-05 00:38:41
fb335158d5a93349e16bc0985e75e93bb9fcd5eb...ac4c758adcf52b913b82d481626b0f8648e95475,3,6,6,12,4,2006-05-05 09:50:11,2006-05-05 09:35:58
ac4c758adcf52b913b82d481626b0f8648e95475...81c5a0e6e5135384a7316b9689a5b0baaf1a2752,2,38,13,51,7,2006-05-05 21:18:41,2006-05-05 19:35:39
81c5a0e6e5135384a7316b9689a5b0baaf1a2752...88521450fc4cca1f96d9179ee4f2cbe51da3359c,1,1,1,2,1,2006-05-05 21:19:11,2006-05-05 19:35:40
88521450fc4cca1f96d9179ee4f2cbe51da3359c...2b5f3ed3166ea7d93f4138bb2b6c849851ba86ac,6,10,6,16,9,2006-05-05 21:21:18,2006-05-05 19:05:10
2b5f3ed3166ea7d93f4138bb2b6c849851ba86ac...e994004f93a481414b9065ac24edd0807d1c311e,12,13,13,26,13,2006-05-05 21:21:52,2006-05-05 19:05:24
e994004f93a481414b9065ac24edd0807d1c311e...ae0b219c8e32aa8f34401252d845916b136a467b,1,10,3,13,1,2006-05-05 21:22:32,2006-05-05 19:05:36
ae0b219c8e32aa8f34401252d845916b136a467b...81ae43cdc4ec4bfba1638aa9786e08322d10b72c,1,14,5,19,1,2006-05-05 21:23:08,2006-05-05 19:06:07
5892fc6504dd23d7cf9415afb13bae8a61d6c70e...73136b2e8a8ee024320c5ac6a0f14f912432bf03,1,24,4,28,7,2006-05-04 07:07:06,2006-05-03 13:20:21
73136b2e8a8ee024320c5ac6a0f14f912432bf03...a4a6e4ab32648631204398691f4066719dea1029,1,35,0,35,1,2006-05-04 07:07:06,2006-05-03 13:27:26
c1e335a43fb4c2f422b4d78693b2344114209632...f2f880f53707f83244c4659b6440224137aa0efa,1,67,93,160,18,2006-04-05 21:25:25,2006-04-05 19:23:29
365463851303f74eb5e5be7101811f215602fcd9...713a11fceb662f275b5e1294acc6f38674834941,1,5,4,9,6,2006-02-14 07:07:04,2006-02-14 07:07:04
713a11fceb662f275b5e1294acc6f38674834941...9ece7169a434d69a942b71dc49f507da37bbdbc3,1,2,0,2,1,2006-02-14 09:11:42,2006-02-14 09:11:42
a0dfb48af73a98ceb60629f2bbc4ebf1393ba0af...ee3d299e93450586d12f099913261ec22849365a,1,1,1,2,1,2006-01-16 05:08:42,2006-01-16 05:08:42
cfa6d70bd4a24fd9915880112cf1af41a616579c...0f76f52621a6d760127cf2a508e09287766219b6,2,7,1,8,3,2006-01-11 06:10:37,2006-01-11 01:50:19
0f76f52621a6d760127cf2a508e09287766219b6...4c34a2c555f8064d45e655e45fd40d7e2b203d6e,1,22,16,38,11,2006-01-11 21:58:32,2006-01-11 21:57:42
4c34a2c555f8064d45e655e45fd40d7e2b203d6e...4dc00021f784697e6d196ec285c8689d0777c533,1,5,1,6,3,2006-01-13 05:51:23,2006-01-13 05:42:25
4dc00021f784697e6d196ec285c8689d0777c533...c884dd9a54fcde71ea125c86e6b6ab92acbbc7cf,1,7,7,14,2,2006-01-13 09:40:16,2006-01-13 09:37:09
c884dd9a54fcde71ea125c86e6b6ab92acbbc7cf...77cb17e940c806a4cc811bfd66187277b729a1e7,12,176,62,238,42,2006-01-14 00:49:01,2006-01-11 02:12:17
77cb17e940c806a4cc811bfd66187277b729a1e7...b42934d611054400de86e559577b421677b3f1ae,1,7,8,15,6,2006-01-14 00:49:02,2006-01-13 05:37:17
b6ebac9e4316cd5d35c2c24f83f1eb51ce17beb9...d4072c9722d1ef28abe8ef0eb0b244017fff3f42,1,11,4,15,5,2005-11-14 22:16:37,2005-11-14 16:53:42
d4072c9722d1ef28abe8ef0eb0b244017fff3f42...2ed02887bda74871bad64f1be36fb4f60d07706e,1,3,2,5,3,2005-11-14 22:16:38,2005-11-14 18:01:26
2ed02887bda74871bad64f1be36fb4f60d07706e...9add69b1b1f76db874ed899c46fbe0b252aa3c23,1,4,3,7,3,2005-11-15 01:15:07,2005-11-15 01:15:07
9add69b1b1f76db874ed899c46fbe0b252aa3c23...b2309b70197f9067cb32a620465a9b3477d8f0c3,2,6,2,8,3,2005-11-15 01:15:32,2005-11-14 23:20:01
b2309b70197f9067cb32a620465a9b3477d8f0c3...2db0bfbc04478d9fb42f58ff50ad4123a2a9ddde,3,15,5,20,7,2005-11-15 01:15:32,2005-11-14 23:20:01
2db0bfbc04478d9fb42f58ff50ad4123a2a9ddde...7acab8f16785151f9b6d9bbd8a9b0a8b76b26fba,2,2,2,4,2,2005-11-15 01:15:32,2005-11-14 23:20:01
7acab8f16785151f9b6d9bbd8a9b0a8b76b26fba...08db81a9f1e4072790f0257f5398e8408e3d6816,3,14,4,18,4,2005-11-15 01:15:32,2005-11-14 22:10:59
08db81a9f1e4072790f0257f5398e8408e3d6816...d7bba815753bf8c31886fcf6bb89c9e6250674a5,1,15,15,30,13,2005-11-15 02:15:30,2005-11-15 02:15:30
a935c3972749095e7ea6c341e539a94de705ecfd...79778e4696502884cdf2b12348ad7300b64fcf6e,1,1,1,2,1,2005-10-23 08:19:48,2005-10-23 08:18:42
152da3dfcf2c16d7c240a0dbdcb8a3ae1d332d81...4ae95682694a1cd05ee2029fe241ad90d43c8c0e,1,67,5,72,8,2005-09-27 02:10:55,2005-09-27 02:10:55
4ae95682694a1cd05ee2029fe241ad90d43c8c0e...47888f0f3188c39e13e02ad8442c5e785d2ebcdd,1,2,0,2,1,2005-09-27 15:49:40,2005-09-27 15:49:40
152da3dfcf2c16d7c240a0dbdcb8a3ae1d332d81...036a72d8fa25d9c56c19ae4c761401a58c43b8f6,1,15,6,21,5,2005-09-27 01:04:17,2005-09-27 00:17:09
036a72d8fa25d9c56c19ae4c761401a58c43b8f6...a935824036dc2c5a8ef1980a4b05a12228712754,1,50,18,68,13,2005-09-27 01:04:17,2005-09-23 07:43:04
a935824036dc2c5a8ef1980a4b05a12228712754...e2f5f6ef6795c880a2f13ea472b96704b4a4ca94,2,4,12,16,3,2005-09-27 01:04:17,2005-09-25 05:52:32
e2f5f6ef6795c880a2f13ea472b96704b4a4ca94...deca7e8c591608c9ffd0bf0aaf10b379da9f6d6e,2,13,4,17,5,2005-09-27 01:04:17,2005-09-25 07:12:06
deca7e8c591608c9ffd0bf0aaf10b379da9f6d6e...0b7a9fc971712308712fedbba404f7b448e37d45,1,1,1,2,1,2005-09-27 01:04:17,2005-09-26 02:49:49
62b553cdd6cd41d60b3e0c6fe4a85a951712df97...6433d569753e8d33d3f7beca16a65f2fc481aade,1,1,1,2,1,2014-09-29 23:13:58,2014-09-28 07:50:26
62b553cdd6cd41d60b3e0c6fe4a85a951712df97...c049216fdf8cbbe93edf107800519739f4bcf56d,1,1,3,4,2,2014-09-29 16:06:52,2014-09-29 07:02:07
4489a480fdfe53e1ca78eabdab2dee00376814a3...d05c77cca2a6768ca03e95bcdd7358eb6af85c1a,1,1,0,1,1,2015-01-06 19:20:45,2015-01-06 03:49:43
d05c77cca2a6768ca03e95bcdd7358eb6af85c1a...d91175b2128aeae00ed10cd7e8216a60ca66e06b,2,11,1,12,2,2015-01-06 21:46:52,2015-01-06 03:50:49
9e8f8dea46b52682b3fca67d8602c694c10013e1...eab335c46d6677ff50e9fe94352150641bc05507,1,11,5,16,1,2014-10-16 19:07:48,2014-10-10 08:19:47
2b52123fcf840686b69e10807fd0f985ec4167f3...99474b6340dbcbe58f6c256fdee231cbadb060f4,2,6,0,6,2,2014-11-14 21:40:38,2014-11-14 21:33:55
41ca19b6a6ca5ad6fea246bd400717c16b80b32c...f8bb1d94311b7438e7e9831b51ffb047b7ae65d7,2,53,16,69,11,2014-08-18 17:15:08,2014-08-16 03:08:02
f8bb1d94311b7438e7e9831b51ffb047b7ae65d7...735efde838b68747e737e863427a4843a8efaddb,2,9,1,10,2,2014-08-18 17:15:19,2014-08-16 03:08:03
735efde838b68747e737e863427a4843a8efaddb...8e5dd3d654ebb9e86e06b9ef5ca86bd6ebf44de1,3,13,9,22,9,2014-08-18 17:16:35,2014-08-16 03:08:04
8e5dd3d654ebb9e86e06b9ef5ca86bd6ebf44de1...6bf3b813486b4528feca39d599c256f662defc14,5,27,11,38,9,2014-08-18 17:16:45,2014-08-16 03:08:05
6bf3b813486b4528feca39d599c256f662defc14...1aaf69e669b7fd67073d3024b386ac25ac77d0f8,2,23,0,23,2,2014-08-18 17:16:55,2014-08-16 03:08:06
41ca19b6a6ca5ad6fea246bd400717c16b80b32c...6c4ab27f2378ce67940b4496365043119d7ffff2,2,6,1,7,2,2014-08-15 22:09:12,2014-08-15 22:09:12
63a45136a329bab550425c3142db6071434d935e...c9a5172fdf073e090111950d3d42c4f9ef144ffd,3,3,3,6,3,2014-10-13 20:35:18,2014-10-11 23:37:33
c9a5172fdf073e090111950d3d42c4f9ef144ffd...f8a48affbb8829190fe3aa8a1092d5762fd921b1,1,2,2,4,2,2014-10-13 20:35:37,2014-10-11 23:37:34
63a45136a329bab550425c3142db6071434d935e...e0e21283b60da5d5d9d5f95f9f2a73189fa978f1,1,3,0,3,1,2014-10-13 19:33:30,2014-10-11 14:42:07
e0e21283b60da5d5d9d5f95f9f2a73189fa978f1...0c45d258ec35c1ef51523dd45e4518bd8a09258c,2,8,2,10,3,2014-10-13 19:53:46,2014-10-13 19:46:14
0c45d258ec35c1ef51523dd45e4518bd8a09258c...0f4b6db3baeff8de53769b38f439408abd5a42f7,4,47,10,57,8,2014-10-19 22:38:30,2014-10-18 12:31:15
63a45136a329bab550425c3142db6071434d935e...f1dd90bd193637eeef772890c37afe3529a665d0,1,23,23,46,21,2014-10-13 18:27:07,2014-10-10 06:07:00
f1dd90bd193637eeef772890c37afe3529a665d0...8ad16524183baf196d1db82b99ef52d05ca438e9,2,17,8,25,9,2014-10-13 18:27:40,2014-10-10 06:11:14
8ad16524183baf196d1db82b99ef52d05ca438e9...a136f6d8ff290ab486c85cd12d1a9a47d53b432d,2,44,4,48,5,2014-10-13 22:39:57,2014-10-10 06:47:27
97b8860c071898d9e162678ea1035a8ced2f8b1f...07bfa575c1ce741d0e33580c336596d3407129b6,1,5,12,17,3,2014-09-22 19:40:27,2014-09-21 08:23:37
97b8860c071898d9e162678ea1035a8ced2f8b1f...0176e7a71f2c722effde0ed22db3682400010911,1,4,13,17,2,2014-09-22 19:39:57,2014-09-20 18:29:53
f99b7af661f89865f918e52223a3bdaf312a0de0...7add441984063d2c34fa8de252b8ceb803e7981a,2,8,3,11,2,2014-12-09 19:54:25,2014-12-08 05:48:13
7add441984063d2c34fa8de252b8ceb803e7981a...a1e920a0a7747f0820e62b22b67fd36fb1d74607,2,3,3,6,3,2014-12-09 19:56:37,2014-12-08 14:17:55
dfd66ddf5aa9aacc06ed38a9ee2cc15a4f2d4896...2887103b35b3b40025ca5060713dfb1e1c8c3b20,1,4,2,6,1,2014-11-10 17:43:16,2014-11-09 09:23:39
2887103b35b3b40025ca5060713dfb1e1c8c3b20...d52adf1f328162a9513940913ced044d24c0212f,1,6,2,8,1,2014-11-10 17:43:59,2014-11-09 09:23:40
30d45f798d1a4b14759cd977b68be4476d66ea17...8376a704419813c9af1d056cbd36b9ff6744c8bc,2,48,14,62,9,2014-09-18 16:21:16,2014-09-18 10:49:43
30d45f798d1a4b14759cd977b68be4476d66ea17...56625df74c969885c0c735203283bb1ebe1897ec,1,1,0,1,1,2014-09-15 22:34:31,2014-09-15 19:07:39
56625df74c969885c0c735203283bb1ebe1897ec...2892dfeec3f98f7e65a2746d271471d2c3c4af57,1,5,5,10,5,2014-09-16 18:13:10,2014-09-16 03:24:08
2892dfeec3f98f7e65a2746d271471d2c3c4af57...c41a87dd80cd32cfd6e2d670153a9b69dc627f71,6,58,16,74,16,2014-09-19 17:46:15,2014-09-19 03:45:37
c41a87dd80cd32cfd6e2d670153a9b69dc627f71...1956dfa818e376c5d62adc16d77f5b5cacf923f8,1,7,6,13,6,2014-09-19 17:51:59,2014-09-16 03:24:10
49f1cb93a2f11845cfa2723611a729d3d7f02f0d...fe05e196c5047dacf6c233ed07bb366996b9b05d,1,1472,1332,2804,1286,2014-08-04 06:51:24,2014-08-04 06:51:24
49f1cb93a2f11845cfa2723611a729d3d7f02f0d...dad2e7f4bf6e2f01bf2b589490441343a0f8f6f7,2,5,13,18,4,2014-07-28 17:41:16,2014-07-28 17:41:16
dad2e7f4bf6e2f01bf2b589490441343a0f8f6f7...5e6502288d713cfa673c456a040ad0841db11dfa,4,18,250,268,15,2014-07-28 17:41:53,2014-07-28 17:41:53
5e6502288d713cfa673c456a040ad0841db11dfa...919eb8acea61fc461e69e2383e6290b4c3991c96,1,1,0,1,1,2014-07-28 17:42:39,2014-07-28 15:48:11
2d26d533a012f7475e13657d7fc829a6ba01db73...95c68267ff84c02a97d0f2c18b4b4fbfee7a7fca,1,1,1,2,1,2014-09-16 18:27:12,2014-08-29 13:51:46
aa544bfbc6eb11e4f0471f3144d3e3ac75c0e4a9...3bfcb95fa84d8bacb01a990c5bdb16df13462279,1,3,2,5,2,2014-09-15 20:23:18,2014-08-15 20:53:46
3bfcb95fa84d8bacb01a990c5bdb16df13462279...0e3c339bb69670b39161838de17f440480e1358a,1,14,12,26,3,2014-09-15 20:23:18,2014-08-15 21:11:33
0e3c339bb69670b39161838de17f440480e1358a...c09b71ccc45f4be3acca5e809a18a000cae09faf,1,5,3,8,1,2014-09-15 20:23:18,2014-08-15 21:26:17
c09b71ccc45f4be3acca5e809a18a000cae09faf...39895c74d809962bf76a6d720618df30f4bac8b1,1,29,21,50,3,2014-09-15 20:23:18,2014-08-15 21:28:28
39895c74d809962bf76a6d720618df30f4bac8b1...621b0599fda143aff7fbf2bca7479997a06a5d11,1,10,5,15,3,2014-09-15 20:23:19,2014-08-12 22:04:17
621b0599fda143aff7fbf2bca7479997a06a5d11...e40671a3d9115f2c0cea614d8b5d265150f44c24,1,21,15,36,3,2014-09-15 20:23:19,2014-08-12 22:40:00
e40671a3d9115f2c0cea614d8b5d265150f44c24...64de20a1265b676f9cc0e5f46379a017560fa333,1,1,3,4,2,2014-09-15 20:23:19,2014-08-15 18:30:36
64de20a1265b676f9cc0e5f46379a017560fa333...887f3533fd764722ffb6e4ea34c01ad9256f0186,1,13,8,21,6,2014-09-15 20:23:19,2014-08-15 18:37:01
887f3533fd764722ffb6e4ea34c01ad9256f0186...52d2ae582e84c6d4ace8ab7e021808915148816a,1,14,8,22,2,2014-09-15 20:23:19,2014-09-04 19:13:32
52d2ae582e84c6d4ace8ab7e021808915148816a...ab2b0c908aa1d1643fb15ffca4b943c3add9b945,1,3,4,7,4,2014-09-15 20:23:19,2014-08-15 19:23:51
ab2b0c908aa1d1643fb15ffca4b943c3add9b945...b783aa71c096032c02a20f9a41c5f42ce7b914c4,1,30,19,49,3,2014-09-15 20:23:19,2014-08-15 19:29:42
b783aa71c096032c02a20f9a41c5f42ce7b914c4...c67072b90bdc56501483e0ba96d0d833e86362c3,1,4,3,7,3,2014-09-15 20:23:20,2014-08-19 20:02:19
c67072b90bdc56501483e0ba96d0d833e86362c3...a50e7ca3215492b16d96221cf762dbe71ed99722,3,47,41,88,4,2014-09-15 20:23:20,2014-08-14 22:31:13
a50e7ca3215492b16d96221cf762dbe71ed99722...d7c67668fe10184736bdfe953ed8dcbfdb57e0c2,4,22,21,43,6,2014-09-15 20:23:20,2014-08-19 20:18:07
d7c67668fe10184736bdfe953ed8dcbfdb57e0c2...e543b3f6fee9f910573d53ddfc0750cd2bf88972,1,2,2,4,2,2014-09-15 20:23:20,2014-08-19 21:23:55
e543b3f6fee9f910573d53ddfc0750cd2bf88972...a85b377d0419a9dfaca8af2320cc33b051cbed04,10,253,2,255,25,2014-09-15 20:23:20,2014-09-12 18:17:07
a85b377d0419a9dfaca8af2320cc33b051cbed04...d05b9618ce42e85936176537f939a4eb85d4d65e,3,66,7,73,12,2014-09-15 20:23:28,2014-08-14 22:59:21
d05b9618ce42e85936176537f939a4eb85d4d65e...20a7558f31e44e26ddbb8aa55bfd9316a6b67f82,2,21,5,26,5,2014-09-15 20:23:28,2014-08-18 20:46:58
20a7558f31e44e26ddbb8aa55bfd9316a6b67f82...4adf569dea052dac88121d822e11c249986b3398,4,69,4,73,9,2014-09-15 20:23:28,2014-08-18 21:38:45
4adf569dea052dac88121d822e11c249986b3398...9be89160e7382a88e56a02bcf38f4694dd6542d6,4,13,0,13,5,2014-09-15 20:23:28,2014-08-23 01:15:24
9be89160e7382a88e56a02bcf38f4694dd6542d6...b89363e4a5277038629491f8765c0598f366326c,7,187,29,216,28,2014-09-17 21:27:40,2014-08-21 23:45:30
b89363e4a5277038629491f8765c0598f366326c...0ea47f9d3307bdb1cd9364acd3e4a463b244bba2,6,63,3,66,11,2014-09-17 21:58:04,2014-09-15 21:59:00
0ea47f9d3307bdb1cd9364acd3e4a463b244bba2...5732373daacf9486a0db9741cf0de4e7a41b08b3,4,112,12,124,22,2014-09-17 22:19:54,2014-09-05 17:46:04
5732373daacf9486a0db9741cf0de4e7a41b08b3...6f5ef44e0d8933621fcd50127518557013002313,1,2,2,4,2,2014-09-25 18:12:57,2014-09-25 15:02:20
063da62b02aeafe58fdacce0ea48c0761b06df60...1c2828c194bf4bc9dba2cc1f12cd0687263af94b,1,24,24,48,14,2014-07-07 22:33:17,2014-07-07 06:35:30
1c2828c194bf4bc9dba2cc1f12cd0687263af94b...4228e8bc989c6cac1c47faece720faa06531281f,1,73,1,74,6,2014-07-21 19:04:23,2014-07-19 15:01:08
4228e8bc989c6cac1c47faece720faa06531281f...adf8e5423891fa9bd04fcb0489ffb5da7025ec07,1,44,1,45,3,2014-07-21 19:04:40,2014-07-19 15:01:09
adf8e5423891fa9bd04fcb0489ffb5da7025ec07...78024c4e31d04cd2bdc0d734ede2d24bb33c72ef,1,8,0,8,2,2014-07-21 19:05:47,2014-07-19 15:01:10
78024c4e31d04cd2bdc0d734ede2d24bb33c72ef...b0ab2b71d0baa845e6920a3146df65f5cd296ea0,2,31,1,32,2,2014-07-21 19:05:53,2014-07-19 15:01:11
b0ab2b71d0baa845e6920a3146df65f5cd296ea0...0b05ab6f1bfa045f460ad5c40d87ef8c2965bf56,3,41,0,41,3,2014-07-21 19:05:58,2014-07-19 15:01:12
0b05ab6f1bfa045f460ad5c40d87ef8c2965bf56...60e2f5a5af6e605a8de48d2cd1b21c690a84ae75,1,24,0,24,2,2014-07-21 19:06:20,2014-07-19 15:01:13
60e2f5a5af6e605a8de48d2cd1b21c690a84ae75...25a05a8cae263ca55e75d31336d09c8d9bc90be3,1,47,0,47,3,2014-07-21 19:06:49,2014-07-19 15:01:14
25a05a8cae263ca55e75d31336d09c8d9bc90be3...3fa102590758594e3df45c58caba945894a608e5,1,22,0,22,1,2014-07-21 19:07:04,2014-07-19 15:01:15
066dd2632acf11a348ff209b79f42c1a87a71fbb...93b5393611e9e1892e2eaea9b844c505172ac460,1,5,1,6,1,2014-08-19 16:59:22,2014-08-19 06:12:03
869951babc24fef5c5cd58f86baefc25b6ed3765...d35ea4dec69fd247c0b2bb02dd768abf4272d377,1,1513,1359,2872,1298,2014-08-29 05:07:59,2014-06-20 15:22:48
d35ea4dec69fd247c0b2bb02dd768abf4272d377...782ac539ea6fd069ede52917f047ffa9a81947e5,1,2,0,2,1,2014-08-29 05:08:17,2014-08-26 16:54:30
ce856044681331d19b867426726db7edd12f1713...dc662d449f56cb969025db4fe54fa3374777495c,1,20,20,40,4,2014-07-13 17:05:39,2014-07-11 22:55:46
dc662d449f56cb969025db4fe54fa3374777495c...b150794dafb0a7a1c5caba6fdf7d517a1a15cb59,4,95,19,114,13,2014-07-17 16:22:20,2014-07-16 21:48:02
35936f8fc38a214cc7d2595070641d39a541dfb1...791643a865ac15a381e629a35f252293911b0fb0,1,26,19,45,7,2014-04-29 17:16:46,2014-04-29 03:00:04
35936f8fc38a214cc7d2595070641d39a541dfb1...7e6ac6e4391caa0fc379cb699013d503380e4214,1,567,298,865,118,2014-04-28 21:38:15,2014-04-25 23:56:49
dde8a902c774268628015705a7767f61af18b865...745224e04a03e4544c58d5d38d3c54f67100f8eb,4,250,18,268,15,2014-06-18 17:57:18,2014-06-18 05:54:42
3e52f70b1505956bf91cb7b107e526d1c67da0a6...f2667a83304a9fa4910240b64f9d3b1c640e6743,1,1,1,2,1,2014-12-11 22:24:37,2014-12-08 13:42:15
3e52f70b1505956bf91cb7b107e526d1c67da0a6...93dcaea22674864f931be3fe6050671d335dc5b0,2,11,0,11,2,2014-07-14 20:05:37,2014-07-14 17:29:58
4e4b125c239a78f3a8fe82e47d1f89fef510980c...3cc9d87710b20c86252809e068fe309f6bb7ecc2,1,3,3,6,1,2014-06-25 22:26:46,2014-06-24 09:43:07
3cc9d87710b20c86252809e068fe309f6bb7ecc2...28bf9429ef2e1534be8d3a59ad236834be542b86,2,0,3,3,2,2014-06-25 22:27:24,2014-06-24 09:45:46
28bf9429ef2e1534be8d3a59ad236834be542b86...36857e0026f5a7855f941a955bf7014408a816dd,1,5,3,8,2,2014-06-25 22:28:01,2014-06-24 09:46:05
91fc159745eccb0830c9719642d07617c8100b41...a75f9f053d459fb35a52fd223677812099fa6476,1,10,1,11,2,2013-06-27 21:32:59,2013-06-27 21:32:59
00480a1e9ccd44f257c09c45c185c9c8825a3078...882e78c7f9c284408640347a4b1910ea73537a10,1,23,0,23,3,2013-06-06 21:42:56,2013-06-06 21:42:56
f59bebb78edb26e4f66c2754bc4d168c5d4ebb4a...6897a64b652d83e477389ec1a248b47b8d821db6,1,1,0,1,1,2013-08-30 16:56:30,2013-08-30 10:40:30
f59bebb78edb26e4f66c2754bc4d168c5d4ebb4a...97d01f2a8880702c84a20632a6748671bcbaf8d5,1,14,16,30,1,2013-08-29 19:03:08,2013-08-28 20:26:12
f59bebb78edb26e4f66c2754bc4d168c5d4ebb4a...87c9a140d212b2bf7f785136bb38a1a908bb391b,1,2,2,4,1,2013-08-26 05:31:07,2013-08-23 08:29:20
f59bebb78edb26e4f66c2754bc4d168c5d4ebb4a...4b05440283350ec3b01afabe847d9ce5cf4cbdb7,2,16,0,16,3,2013-08-19 20:47:56,2013-08-19 16:26:56
f59bebb78edb26e4f66c2754bc4d168c5d4ebb4a...64a99eb4760de2ce2f0c04e146c0a55c34f50f20,3,78,1,79,7,2013-08-09 16:10:05,2013-08-08 11:05:38
f59bebb78edb26e4f66c2754bc4d168c5d4ebb4a...88d0db55579cd2173ce641849066da8b897b58da,1,78,1,79,2,2013-08-02 15:53:54,2013-08-02 05:36:33
88d0db55579cd2173ce641849066da8b897b58da...7c3ecb32541d767518bf78633603f94fefdac8cf,3,9,16,25,10,2013-08-02 16:27:26,2013-07-31 19:51:37
f59bebb78edb26e4f66c2754bc4d168c5d4ebb4a...19c3c5fdcb35b66b792534c5dc4e8d87a3952d2a,3,7,7,14,7,2013-07-29 16:56:58,2013-07-27 12:11:33
f59bebb78edb26e4f66c2754bc4d168c5d4ebb4a...97669eed109f5dea7dffe771d8f6aba4acf84b27,3,4,2,6,4,2013-07-18 23:44:40,2013-07-18 21:44:57
f59bebb78edb26e4f66c2754bc4d168c5d4ebb4a...949226fe77beb1027bd5ac7be56fe002236d6cad,1,4,2,6,3,2013-07-17 21:19:24,2013-07-17 21:19:24
949226fe77beb1027bd5ac7be56fe002236d6cad...08578fa13eeec7079101f7ac52208aec83d54c62,1,13,16,29,3,2013-07-17 22:09:34,2013-07-17 22:09:34
08578fa13eeec7079101f7ac52208aec83d54c62...1ecc1cbd3a7642c4f517d086d7b45d6341172dfe,2,60,8,68,10,2013-07-17 23:23:34,2013-07-17 22:05:46
1ecc1cbd3a7642c4f517d086d7b45d6341172dfe...bf142ec4346385553918bc53f203b205091aa362,1,1,1,2,1,2013-07-17 23:24:14,2013-07-17 22:27:19
bf142ec4346385553918bc53f203b205091aa362...7f2ea5f0f2fb056314092cce23202096ca70f076,1,28,1,29,3,2013-07-18 00:17:39,2013-07-17 23:19:19
7f2ea5f0f2fb056314092cce23202096ca70f076...95a7c546b02a962b9e458f7fd2d0ed9b657c0ca6,4,18,7,25,9,2013-07-19 22:20:47,2013-07-18 00:18:32
f59bebb78edb26e4f66c2754bc4d168c5d4ebb4a...5d9cfa29d27156cc9a00c75eaa31b831107ed0b9,1,1,1,2,1,2013-07-15 16:45:11,2013-07-14 21:35:46
5d9cfa29d27156cc9a00c75eaa31b831107ed0b9...70a0cc9e5c62f7b8ce0acc693e10a9e080f187ef,1,0,1,1,1,2013-07-15 16:45:21,2013-07-14 21:35:47
70a0cc9e5c62f7b8ce0acc693e10a9e080f187ef...d3c9cf32ca3b088fda54e7be311860f1f06fb11e,1,1,3,4,1,2013-07-15 16:45:21,2013-07-14 21:35:49
f2b4626d9e78e00d2168a8470633d6c7f5331a13...c0add3073a5bd0e295cdaea76e5c9b7805f8a047,1,1,1,2,1,2013-06-21 15:52:16,2013-06-18 19:24:05
f2b4626d9e78e00d2168a8470633d6c7f5331a13...692cfd6b2b467db00f39a7bae89a7743b5b57575,1,21,21,42,6,2013-06-17 20:11:21,2013-06-16 17:13:00
692cfd6b2b467db00f39a7bae89a7743b5b57575...e21db2c6ad136a723bed389feb3298b5b4ee1ae4,1,1,1,2,2,2013-06-17 20:11:56,2013-06-16 17:13:01
f2b4626d9e78e00d2168a8470633d6c7f5331a13...50b72ede0592b16cb62e1b92d52bdccc4cee9b20,1,1,1,2,1,2013-06-14 21:56:08,2013-06-14 21:51:01
50b72ede0592b16cb62e1b92d52bdccc4cee9b20...1ee886c1f08f4dd672a342b7811191b02291a597,2,37,1,38,3,2013-06-14 21:56:09,2013-06-14 21:53:34
f2b4626d9e78e00d2168a8470633d6c7f5331a13...0b437a18bdd188794cec8855e2a413921d08b6e8,3,6,6,12,5,2013-06-13 21:47:07,2013-06-13 18:19:44
f2b4626d9e78e00d2168a8470633d6c7f5331a13...10a3fb00ebbf19d5c22a0aa9ccd7803fe5367329,1,19,25,44,5,2013-06-13 21:45:38,2013-06-13 18:19:28
fada522129c59755f8616f33adad49604db919d8...4b8f772ce4df667583243e434ca0548d5b84b3a6,1,1,1,2,1,2013-06-03 17:14:48,2013-05-30 13:56:21
de3a5c6da194928868b5eee4a9c4d538b4194727...eff714bddafd3d49cde0eac6ae670970da024fb4,1,12,0,12,1,2013-05-20 22:05:47,2011-12-20 01:23:50
eff714bddafd3d49cde0eac6ae670970da024fb4...7d82b4af1cefe55b825f524f250cd0002dbba4ab,1,14,5,19,3,2013-05-20 22:05:47,2011-12-20 01:24:30
7d82b4af1cefe55b825f524f250cd0002dbba4ab...f4f4c7fc00e8acf91150c717cf005fc36c1dd120,3,71,1,72,7,2013-05-20 22:05:54,2013-05-15 20:14:43
de3a5c6da194928868b5eee4a9c4d538b4194727...5dbe064d8cf37142f8c76f73ae0866286a8fb018,1,4,0,4,1,2013-05-20 18:18:43,2013-05-19 11:53:48
de3a5c6da194928868b5eee4a9c4d538b4194727...e00dd1e9485c50f202cc97dfae19d510e108b565,3,16,1,17,6,2013-05-20 18:09:03,2013-05-17 20:56:18
9f93e4611f72577306e369a64d0a4da847be9751...8687f7776de7b7a266690af070f1674aecdbfb78,1,1,1,2,1,2014-08-18 16:36:56,2014-08-16 11:16:56
9f93e4611f72577306e369a64d0a4da847be9751...d1239264f2786d7ea15543b980c6bf6afbc4701a,1,68,0,68,3,2013-06-26 18:25:11,2013-06-25 15:53:52
d1239264f2786d7ea15543b980c6bf6afbc4701a...c1f1d24aa5c72821096e2a31aaf4175329ca0260,1,39,0,39,3,2013-06-26 18:25:11,2013-06-25 15:53:53
c1f1d24aa5c72821096e2a31aaf4175329ca0260...96a799b6d1d4a63dccfe8b5dcabd2d738fa6c26e,1,36,0,36,3,2013-06-26 18:25:11,2013-06-25 15:53:54
96a799b6d1d4a63dccfe8b5dcabd2d738fa6c26e...c0be6b4c8a1d16a92efad00d73683075cf2da60d,1,63,2,65,2,2013-06-26 18:25:11,2013-06-25 15:53:55
c0be6b4c8a1d16a92efad00d73683075cf2da60d...db627fd568410499c47d764937c3d7a10bbadffa,1,439,0,439,1,2013-06-26 18:25:11,2013-06-25 15:53:56
db627fd568410499c47d764937c3d7a10bbadffa...abd4284bc62127a2db69c8c81501a56bb29284c8,2,28,21,49,12,2013-06-26 18:25:12,2013-06-25 15:53:57
629b60a77d0bca1358af666605548acc4dcc5841...a70ae5873d601bccef9d27afa254b0ea3844b607,1,2,0,2,1,2013-05-17 17:59:08,2013-05-17 10:32:28
a70ae5873d601bccef9d27afa254b0ea3844b607...31eb360b43ec351b97adcf67e07fb748da574aaa,1,4,2,6,3,2013-05-17 18:43:36,2013-05-17 17:10:19
31eb360b43ec351b97adcf67e07fb748da574aaa...1f197a1de497db8898c9920fab77533dab34a03c,2,13,0,13,2,2013-05-17 18:46:53,2013-05-17 18:26:08
629b60a77d0bca1358af666605548acc4dcc5841...15a54fb8095502217fce7c7c6dd14e9066b62ebe,1,4,3,7,4,2013-05-17 17:01:17,2013-05-17 08:55:46
15a54fb8095502217fce7c7c6dd14e9066b62ebe...18562ad1a007234aded1e78f73d4b2f53a02fd0b,1,43,36,79,2,2013-05-17 17:01:23,2013-05-17 08:55:47
18562ad1a007234aded1e78f73d4b2f53a02fd0b...9678696c4ad0d269f933de001daa78c54a2b8868,1,39,1,40,2,2013-05-17 17:01:28,2013-05-17 08:55:48
8d97506e4b972f11ab918bfaaebe036111b249dc...f659031c1ceb979d423161541a8a3763bfd7c96c,1,20,1,21,3,2013-05-13 16:00:41,2013-05-13 15:00:46
f659031c1ceb979d423161541a8a3763bfd7c96c...a765499a0884375c47c78d0d1e2926e875074427,3,19,1,20,5,2013-05-16 18:45:34,2013-05-13 15:00:47
6653aa9ecd955faccb0ace6f2d8c374b8ea7daaa...94b540479aba44cfe64c7a5e051dc490179cefff,1,1,1,2,1,2013-06-28 17:49:26,2013-06-28 17:19:42
94b540479aba44cfe64c7a5e051dc490179cefff...3a461832c5ca4f140e41fdc34f86c90868aea33b,3,8,2,10,4,2013-06-28 21:56:30,2013-06-28 21:56:30
c6807a40dcd29f7e5ad1e2f4fc44f1729c9afa11...9ba380481cc3a5ae7706763d71cf8844917ed804,5,47,1,48,15,2013-07-23 19:18:18,2013-07-21 08:18:05
d2949c7b3c8a2f0d2cb5c61d99017a1a85a46264...399e4a1c560ae8caf338e13a73851089c384230a,1,99,0,99,1,2013-04-21 22:14:40,2013-04-21 21:51:59
399e4a1c560ae8caf338e13a73851089c384230a...ec2764ee8fb9a37cc92e0a1bce3b49ae2de0ffbc,1,69,1,70,3,2013-04-21 22:14:40,2013-04-21 21:52:00
ec2764ee8fb9a37cc92e0a1bce3b49ae2de0ffbc...fa83a33b22283e465aafdacc53ad0fddea55bdf4,3,28,26,54,13,2013-04-21 22:14:41,2013-04-21 21:52:01
fa83a33b22283e465aafdacc53ad0fddea55bdf4...9c9cd39a0c9bc1f14e9dfc29ad98475794dda6b8,1,4,4,8,2,2013-04-21 22:14:41,2013-04-21 21:52:02
9c9cd39a0c9bc1f14e9dfc29ad98475794dda6b8...88a9f72fe0f2ae3243b3d7a53dddf856cde48aca,1,1,0,1,1,2013-04-21 22:14:41,2013-04-21 21:52:03
88a9f72fe0f2ae3243b3d7a53dddf856cde48aca...983b17d4bbedd426d4fdd8a95df4dcd292c1a695,1,1,1,2,1,2013-04-21 22:14:41,2013-04-21 21:52:04
983b17d4bbedd426d4fdd8a95df4dcd292c1a695...41c21f22d0fc06f1f22489621980396aea9f7a62,3,18,3,21,4,2013-04-21 22:14:42,2013-04-21 21:52:05
41c21f22d0fc06f1f22489621980396aea9f7a62...229177aaea295a3f804f98494d7bcde9c088fc0a,1,7,6,13,1,2013-04-21 22:14:42,2013-04-21 21:52:06
3813a33de5f9e8224eb2bd2ebae167b3bb00ef73...5df05146d5cb94628a3dfc53063c802ee1152cec,1,1,1,2,1,2014-04-09 18:43:56,2014-04-09 18:17:38
3813a33de5f9e8224eb2bd2ebae167b3bb00ef73...b0808819e5806f5ff01ffcc34db2796d180ad0d9,3,72,8,80,5,2013-04-14 05:27:06,2013-04-13 03:33:36
52a3e011c779456e63b6274af0024eeb92dd7888...81d340d40af506eda3182190b6132575547fa4c5,3,40,1,41,4,2013-04-11 15:50:10,2013-04-10 21:15:52
81d340d40af506eda3182190b6132575547fa4c5...c096955c5bb8e20186cc7c07d4d12b77ddcd01c6,2,5,5,10,5,2013-04-11 16:00:54,2013-04-10 21:16:03
c096955c5bb8e20186cc7c07d4d12b77ddcd01c6...5034fdea3017304fa37e50b3bd40c392503ebfd2,2,15,0,15,2,2013-04-11 16:04:39,2013-04-11 00:07:11
5034fdea3017304fa37e50b3bd40c392503ebfd2...7a43c55415a224039a41684cbadd5b94be6f1a8e,3,3,18,21,3,2013-04-18 06:27:03,2013-04-18 04:14:28
7a43c55415a224039a41684cbadd5b94be6f1a8e...bb0a5cc9dc574e1dda4ee6bcb1e0f166d29dcd65,1,5,5,10,1,2013-04-18 06:27:03,2013-04-18 04:14:29
bb0a5cc9dc574e1dda4ee6bcb1e0f166d29dcd65...21610d820b97583a8f4e3e7f4a48716c8e32fd92,3,8,7,15,5,2013-04-18 06:27:03,2013-04-18 04:14:30
21610d820b97583a8f4e3e7f4a48716c8e32fd92...a93b4a09acfed0e2a006770d0196c74968e65c25,2,6,2,8,3,2013-04-18 06:27:03,2013-04-18 04:14:31
a93b4a09acfed0e2a006770d0196c74968e65c25...9c51558cfb6ffe104da45d324194d9f1ebf9bc65,1,3,5,8,3,2013-04-18 06:27:03,2013-04-18 04:14:32
9c51558cfb6ffe104da45d324194d9f1ebf9bc65...664059fb624467975da5c9a4bf6053c83126eaa7,2,31,4,35,8,2013-04-18 06:27:03,2013-04-18 04:14:33
664059fb624467975da5c9a4bf6053c83126eaa7...1afe6e404453586a1095ce0f3f7e899e62ab237f,1,3,1,4,1,2013-04-25 17:18:37,2013-04-25 17:18:37
52a3e011c779456e63b6274af0024eeb92dd7888...0658569eb03e743ef46abd06abd9d0d81d53e72c,1,1,1,2,1,2013-04-09 03:57:43,2013-04-08 22:46:39
0658569eb03e743ef46abd06abd9d0d81d53e72c...b552b56df2c13885a67ca9ec9f76c21d3b7e2cde,2,25,2,27,4,2013-04-09 22:40:00,2013-04-09 22:22:00
52a3e011c779456e63b6274af0024eeb92dd7888...d6e1466095b54b613acd2ecfd6b72d06b07d2dc3,1,1,1,2,1,2013-04-08 23:25:50,2013-04-08 15:53:42
52a3e011c779456e63b6274af0024eeb92dd7888...0290bf1250533442aa870d303e56745388d562c2,2,11,28,39,8,2013-04-08 20:10:27,2013-04-08 20:10:27
0290bf1250533442aa870d303e56745388d562c2...5ff4fc649e18c02bc475ec5785a985ac5f6e0688,2,19,9,28,11,2013-04-08 21:09:31,2013-04-08 18:36:38
5ff4fc649e18c02bc475ec5785a985ac5f6e0688...fa7285dc3dce8bd01fd8c665b032603ed55348e5,1,16,9,25,5,2013-04-08 21:17:07,2013-04-08 18:36:39
ab5f42422d7e025c3151d91cc5ec0d20b9a80922...94883b4302118fe6ea50028d02bb453c9af38b66,2,56,1,57,2,2013-05-07 05:17:00,2013-05-06 15:20:54
a6a3f2cc0761a347e8796280a1544e2a0d08cb51...2db60670ba0c6dcaa42ed420f337851eea800bbc,1,15,4,19,3,2013-04-02 15:41:17,2013-03-30 06:44:25
5e950c2199448d44388f7ca25c837fe7650da93c...622bc9309155b05af1a0d85bfb643bf6280eba35,1,3,3,6,3,2013-04-01 04:30:09,2013-04-01 01:40:40
622bc9309155b05af1a0d85bfb643bf6280eba35...9b39703920b2d64985abcc1348b169d8fa658c24,1,6,4,10,4,2013-04-01 04:30:27,2013-04-01 01:40:41
9b39703920b2d64985abcc1348b169d8fa658c24...a47eab03f613fa55b9e690d5354e95bc165dceee,1,1,1,2,1,2013-04-01 04:30:27,2013-04-01 01:40:42
5e950c2199448d44388f7ca25c837fe7650da93c...3ee4452837a1f99088517b25938d5c85aac4a583,1,2,0,2,1,2013-04-01 02:07:26,2013-03-31 00:30:48
5e950c2199448d44388f7ca25c837fe7650da93c...0a34594c8340f5cf246592ec08d330901ea8951e,1,1,0,1,1,2013-03-30 06:46:55,2013-03-26 19:09:44
0a34594c8340f5cf246592ec08d330901ea8951e...803a777942b0b1c91890c2f97d4f10972cf2881e,1,1,1,2,1,2013-03-30 06:47:00,2013-03-26 19:20:11
9a82efd0d2a2727507bd908d7f0545437fcc0ff6...c68c408a7a53736ae087a68ad0ce2cf7c4cab0a2,1,3,3,6,2,2013-03-28 20:53:27,2013-03-28 15:39:39
9a82efd0d2a2727507bd908d7f0545437fcc0ff6...d1b9b76734d2ec31d41ba6e7beddab7c880dff85,1,10,3,13,4,2013-03-28 14:45:21,2013-03-28 08:19:34
1d38c6971dd1a4b054d90b7ae4c9de5400b9d818...8b1bd024154f0ee0d71a6befe9bbd96462e76abc,2,7,4,11,2,2013-03-01 20:24:45,2013-03-01 20:06:17
8b1bd024154f0ee0d71a6befe9bbd96462e76abc...e6363a4992637267ef212d7c709ede17d4122e0d,3,9,2,11,4,2013-03-01 21:15:29,2013-03-01 21:15:29
e6b722db099f435f21ce72b18f0d61dc3c778f1f...4741edd549decfccc016fa4775b349fe94fdf4e5,7,19,25,44,12,2013-08-05 18:32:17,2013-08-03 11:51:18
4741edd549decfccc016fa4775b349fe94fdf4e5...d5d09d475440c24016ec52a0bcc8477d9a7b5c71,39,227,227,454,121,2013-08-05 18:32:19,2013-08-03 11:51:19
281ff456fe94e043e3f65f224683b42b5667cd85...31fe4057b17847a15d1fbe9f1a5521c942fa8ade,1,5,0,5,1,2013-07-22 06:03:19,2013-07-22 06:02:53
7ebb906ddd69628fc9874b1266257ae2256b8f14...54219a4d89bac94c98f19f4eb5d1e18eb9499232,4,78,5,83,5,2013-05-29 22:19:12,2013-05-29 22:19:12
5234b41f68ca1ab788513fdc059f9f2e01fd3f6e...4bc444eb64173f770c1d1dba2ed3db393c2a9b18,3,27,0,27,5,2013-04-12 15:52:23,2013-04-07 19:10:39
0da7a53a76b48ea1b2ee6ebe7bd7fbcd7d5c3f9d...5fee4df7f43e52eed19da3529bc50735c6dcd58e,1,2,9,11,5,2013-07-15 17:56:06,2013-07-14 08:35:24
5fee4df7f43e52eed19da3529bc50735c6dcd58e...64acde94efd2906c3e20560c31c2957ac0b242c4,13,182,169,351,15,2013-07-15 17:56:06,2013-07-14 08:35:25
64acde94efd2906c3e20560c31c2957ac0b242c4...f01d9820e768e7eb9eab4ad9a55a62317e0b23ad,1,3,3,6,3,2013-07-15 17:56:06,2013-07-14 08:35:26
f01d9820e768e7eb9eab4ad9a55a62317e0b23ad...e4d92cdcd9450af7ae4c40de2b7c5c27a1faa138,3,16,6,22,7,2013-07-15 17:56:06,2013-07-14 08:35:27
e4d92cdcd9450af7ae4c40de2b7c5c27a1faa138...87323bdace47c3d464a783f48b16617720e8eeee,5,163,41,204,21,2013-07-15 17:56:06,2013-07-14 08:35:28
87323bdace47c3d464a783f48b16617720e8eeee...d2ce1331953e9f4306e00f5edf3a6ce6e3330e9e,3,4,0,4,4,2013-07-15 17:56:06,2013-07-14 08:35:29
d2ce1331953e9f4306e00f5edf3a6ce6e3330e9e...fc12261fea778cabd08dec707169cb88ecdbc647,2,16,1,17,4,2013-07-15 17:56:06,2013-07-14 08:35:30
fc12261fea778cabd08dec707169cb88ecdbc647...0fdc2ae5125b61e5cfe0cd49b064d8367994e61b,4,17,8,25,6,2013-07-15 17:56:06,2013-07-14 08:35:31
0fdc2ae5125b61e5cfe0cd49b064d8367994e61b...6330a171996abbec7dac48788de851aea7d0a18f,7,25,10,35,11,2013-07-15 17:56:06,2013-07-14 08:35:32
6330a171996abbec7dac48788de851aea7d0a18f...b69bb3fc271911317c12fd6ecce6fe1e0301a2b3,2,11,0,11,2,2013-07-15 17:56:06,2013-07-14 08:35:33
b69bb3fc271911317c12fd6ecce6fe1e0301a2b3...8745024422d4b38d8bf93d342b7b173f57cbceaa,2,36,0,36,3,2013-07-15 17:56:06,2013-07-14 08:35:34
8745024422d4b38d8bf93d342b7b173f57cbceaa...dad2586a6b30da902d5f1979221eccc474425a7a,2,12,1,13,2,2013-07-15 17:56:07,2013-07-14 08:35:35
dad2586a6b30da902d5f1979221eccc474425a7a...8f4f8f4579fe8cc630e118cc736de2b8d5cf8e34,6,51,0,51,6,2013-07-15 17:56:07,2013-07-14 08:35:36
8f4f8f4579fe8cc630e118cc736de2b8d5cf8e34...893d839970c0f966bee17cdf63895a62e670e0ca,1,10,7,17,6,2013-07-15 17:56:07,2013-07-14 08:35:37
893d839970c0f966bee17cdf63895a62e670e0ca...6654c8894effaf12ae73a2a6e5bc72433f4a3479,1,9,9,18,7,2013-07-15 17:56:07,2013-07-14 08:35:38
6654c8894effaf12ae73a2a6e5bc72433f4a3479...15b55ae06a208dea4d10125d9655a84f5b62d781,3,13,14,27,13,2013-07-15 17:56:07,2013-07-14 08:35:39
15b55ae06a208dea4d10125d9655a84f5b62d781...01a10b0af9f84069f7c96cb4c94e1417cb7139c1,3,13,8,21,9,2013-07-15 17:56:07,2013-07-14 08:35:40
01a10b0af9f84069f7c96cb4c94e1417cb7139c1...817b345aeb47eb2dfeccbdbf99442359283434c2,1,21,13,34,11,2013-07-15 17:56:07,2013-07-14 08:35:41
817b345aeb47eb2dfeccbdbf99442359283434c2...29211a93c14011f3eff2cf2706a809f1b8160fb5,1,12,12,24,9,2013-07-15 17:56:07,2013-07-14 08:35:42
29211a93c14011f3eff2cf2706a809f1b8160fb5...9e06d6ed7667b9564702f3bcda954748cb8afe0e,1,13,33,46,10,2013-07-15 17:56:07,2013-07-14 08:35:43
9e06d6ed7667b9564702f3bcda954748cb8afe0e...f3e743a0d972e8ed3367d74c1152ff66f7cde416,2,14,9,23,9,2013-07-15 17:56:07,2013-07-14 08:35:44
f3e743a0d972e8ed3367d74c1152ff66f7cde416...931eab64ad24a742182c4e946a1138e677a8bd4e,4,32,18,50,16,2013-07-15 17:56:07,2013-07-14 08:35:45
931eab64ad24a742182c4e946a1138e677a8bd4e...5a76aff1a6f112cc2888b63ee97ade679e6e3e01,2,45,101,146,17,2013-07-15 17:56:08,2013-07-14 08:35:46
5a76aff1a6f112cc2888b63ee97ade679e6e3e01...f8144c9fcff09597670ac7bf69d5cde4af5f206c,1,16,10,26,10,2013-07-15 17:56:08,2013-07-14 08:35:47
f8144c9fcff09597670ac7bf69d5cde4af5f206c...78a951432d0f2e16d8b7bd09cb9665315b7a3d16,1,1,1,2,1,2013-07-15 17:56:08,2013-07-14 08:35:48
78a951432d0f2e16d8b7bd09cb9665315b7a3d16...5ab2a2dabd6e13cd6830ff4f12f232dc79278e29,7,19,17,36,18,2013-07-15 17:56:08,2013-07-14 08:35:49
5ab2a2dabd6e13cd6830ff4f12f232dc79278e29...480ca6449ed0981311b8aef2fbaa89d024b881ee,4,19,26,45,12,2013-07-15 17:56:08,2013-07-14 08:35:50
480ca6449ed0981311b8aef2fbaa89d024b881ee...5ab06518a71a8bd128a2aea38ddb537870d3ea2b,3,4,4,8,4,2013-07-15 17:56:08,2013-07-14 08:35:51
5ab06518a71a8bd128a2aea38ddb537870d3ea2b...18e4f4059936dd35dfe929f502101ca371af856c,3,6,9,15,6,2013-07-15 17:56:08,2013-07-14 08:35:52
18e4f4059936dd35dfe929f502101ca371af856c...17ddc66e702a82671744d1dc5ee59272bd220da6,4,19,18,37,17,2013-07-15 17:56:08,2013-07-14 08:35:53
17ddc66e702a82671744d1dc5ee59272bd220da6...9b2d61499b4ff9ded3e1f3d535912ce04c21d72e,5,13,13,26,11,2013-07-15 17:56:08,2013-07-14 08:35:54
9b2d61499b4ff9ded3e1f3d535912ce04c21d72e...7327d3d1b70bfde70840aa8970fe70de6ef1be16,7,20,12,32,14,2013-07-15 17:56:08,2013-07-14 08:35:55
7327d3d1b70bfde70840aa8970fe70de6ef1be16...3efe8e43813c859b78796b985a4fc06c2c153fb4,3,9,6,15,6,2013-07-15 17:56:08,2013-07-14 08:35:56
3efe8e43813c859b78796b985a4fc06c2c153fb4...827f4d6c218448d58f934c0980b6366407261b74,4,17,18,35,13,2013-07-15 17:56:09,2013-07-14 08:35:57
827f4d6c218448d58f934c0980b6366407261b74...bd1928df1d1cc6a10a7b275694d3504d9a041fae,7,22,32,54,22,2013-07-15 17:56:09,2013-07-14 08:35:58
bd1928df1d1cc6a10a7b275694d3504d9a041fae...9a0872744315da67db3c81eb9270751e31fcc8f5,10,21,81,102,19,2013-07-15 17:56:09,2013-07-14 08:35:59
9a0872744315da67db3c81eb9270751e31fcc8f5...84b8b5d1fa244bc591291a3cf18bf0fa9976ad17,6,25,140,165,20,2013-07-15 17:56:09,2013-07-14 08:36:00
84b8b5d1fa244bc591291a3cf18bf0fa9976ad17...61588ccf78373f5211ecdc56d53f0e17d04283fe,1,2,2,4,2,2013-07-15 17:56:09,2013-07-14 08:36:01
61588ccf78373f5211ecdc56d53f0e17d04283fe...b3920bbdc51fc360bde70e7c19088acfe44b9c4b,4,7,7,14,7,2013-07-15 17:56:09,2013-07-14 08:36:02
b3920bbdc51fc360bde70e7c19088acfe44b9c4b...645a29c40a12a4ade1b041dce246ae241c502a64,5,54,10,64,20,2013-07-15 17:56:09,2013-07-14 08:36:03
645a29c40a12a4ade1b041dce246ae241c502a64...233c3e6c59945650e5919893a4f090824f06e889,1,36,5,41,7,2013-07-15 17:56:09,2013-07-14 08:36:04
233c3e6c59945650e5919893a4f090824f06e889...341003e715c9a7c0332d3f8f08c2f3696a057565,3,6,12,18,6,2013-07-15 17:56:09,2013-07-14 08:36:05
341003e715c9a7c0332d3f8f08c2f3696a057565...5c6933d201fab183a9779dca0fe43bf2f1eca098,9,64,15,79,19,2013-07-15 17:56:09,2013-07-14 08:36:06
5c6933d201fab183a9779dca0fe43bf2f1eca098...a16bf9dd745a9e43e46d745d850db49358430e46,3,9,3,12,3,2013-07-15 17:56:09,2013-07-14 08:36:07
a16bf9dd745a9e43e46d745d850db49358430e46...bd30c2e48432c692f9e77d3529c9cf25117066bb,12,198,31,229,32,2013-07-15 17:56:10,2013-07-14 08:36:08
bd30c2e48432c692f9e77d3529c9cf25117066bb...93d935371654faf2956a4c37c1ca46f3195ee832,11,257,28,285,38,2013-07-15 19:14:38,2013-07-14 08:36:09
93d935371654faf2956a4c37c1ca46f3195ee832...db6a6adabfb57d8a4dcd0491a7b7e2168dac60c1,1,6,0,6,1,2013-07-17 19:47:59,2013-07-17 13:22:16
db6a6adabfb57d8a4dcd0491a7b7e2168dac60c1...4838c81fabc2bab7ff5cd95135060d9a580ad742,1,0,1,1,1,2013-07-23 18:33:03,2013-07-23 09:19:22
0da7a53a76b48ea1b2ee6ebe7bd7fbcd7d5c3f9d...27b6e17a6d84a18861f05fd7c684ab443bf15244,1,13,12,25,1,2013-07-15 16:51:16,2013-07-14 16:21:14
27b6e17a6d84a18861f05fd7c684ab443bf15244...b1d5a570fc0176c77a52896e3b59174baa95e8bf,1,2,4,6,2,2013-07-15 16:52:52,2013-07-14 16:21:15
b1d5a570fc0176c77a52896e3b59174baa95e8bf...7b3742fa466401574a2ff380d5d121b2ac5cea45,1,3,3,6,3,2013-07-15 16:52:57,2013-07-14 16:21:16
0da7a53a76b48ea1b2ee6ebe7bd7fbcd7d5c3f9d...5333f2afc4f5c6365845b25ffc22a91379b84c58,1,5,7,12,1,2013-07-15 15:35:32,2013-07-15 15:31:52
4208fa5ce44a746edb582898dfa49b2bfa84dbcc...283b365e4521082ab37d93762bb2f049dc38bee8,1,4,2,6,2,2013-01-08 21:18:49,2013-01-08 20:23:01
ecd3e2f42504f035620376343db1a4cbafe5db92...2d3ac9ad67b7038e1046dad3b1a273ba29282f31,1,3,3,6,3,2012-12-19 15:46:44,2012-12-19 02:47:50
2d3ac9ad67b7038e1046dad3b1a273ba29282f31...5a029666858d11e66eb689bba1c6435e8b9d0979,1,7,3,10,1,2012-12-19 15:46:59,2012-12-19 04:41:15
18499ba694711c02a5bc729b7f8e362dd760b10a...a33faf2827bfc7baea5d83ef1be8fe659a963355,8,44,3,47,9,2012-12-28 19:35:04,2012-12-28 16:40:59
18499ba694711c02a5bc729b7f8e362dd760b10a...950b5680bdacd3eaa4a528f4dc2d5652f1beb88d,1,13,14,27,7,2012-12-27 02:13:15,2012-12-27 00:45:29
18499ba694711c02a5bc729b7f8e362dd760b10a...823ab40fd4adc5bf5b5c66b6d189deae34d2a138,5,107,6,113,16,2012-12-19 22:58:59,2012-12-19 22:37:30
f893b7420cdf085dfde809d4ea97cb8c03b81c94...7c8ce4ed32aec3b86a271c2661ad9dfb0084c3f9,1,20,3,23,2,2013-07-21 22:34:10,2013-07-18 23:04:53
f893b7420cdf085dfde809d4ea97cb8c03b81c94...76b623584cee2421b84e12050b7ee53b0c08ee89,1,10,0,10,1,2013-07-20 04:32:33,2013-07-20 03:57:01
2e900297dbb9d5bd086ea56eed07027374759791...fea16b47b603e7e4fa7fca198bd49229c0e5da3d,1,240,15,255,17,2013-01-11 21:22:15,2013-01-11 18:48:43
5ded807f7c0be10ecbb31555e5d10dee553752d6...3ce3ffb840a1dfa7fcbafa9309fab37478605d08,2,4,2,6,2,2013-02-25 15:35:55,2013-02-03 14:37:09
e03a5010b3fc17a1d559ae0fdbcdad63af8e30c9...ca462804c68b5ac0936242d4938fc9273b00180d,1,13,0,13,1,2013-10-23 20:34:39,2013-10-23 20:34:39
30825178fb72e3664bd1bda7c02c62e300e2e5ce...8a692d277795e426167d76d652cf86656c9c162e,1,4,4,8,4,2013-01-14 17:59:27,2013-01-14 16:34:56
b2d05e0653f29a75b57260c4d963d560ad65691b...9dacffc04009529b37c94de9a26420f640cf3f59,1,1,2,3,2,2012-12-20 03:00:00,2012-12-18 22:03:54
9dacffc04009529b37c94de9a26420f640cf3f59...40036bedb90aa25757c14a748a34a631c547e1d1,2,26,1,27,5,2012-12-20 03:00:00,2012-12-18 22:03:55
21ccebec0dd1d7e624ea2f22af6ac93686daf34f...402596aafa45ef371611bb795bdf8daa2bdb9286,3,8,5,13,5,2013-04-07 07:42:29,2013-04-07 07:10:27
402596aafa45ef371611bb795bdf8daa2bdb9286...80d35ca0aaeca654562974be6ea528e22bc76e8c,2,9,18,27,3,2013-04-07 20:32:41,2013-04-07 17:46:20
80d35ca0aaeca654562974be6ea528e22bc76e8c...427a8ec5e75f4450620e5df3e1f1071f48c7772c,1,16,17,33,5,2013-04-07 20:33:45,2013-04-07 17:46:21
427a8ec5e75f4450620e5df3e1f1071f48c7772c...aa089cd9abc5332cddebc60c21f797fffd1ab471,1,7,7,14,4,2013-04-07 20:34:26,2013-04-07 17:46:22
aa089cd9abc5332cddebc60c21f797fffd1ab471...2a4c26076c3c99300a51439702791c17e7d21e6c,4,62,8,70,11,2013-04-07 20:37:47,2013-04-07 17:46:23
2a4c26076c3c99300a51439702791c17e7d21e6c...d7ddad012b1badaf96075e880d546ef3525f23ff,1,35,36,71,9,2013-04-07 20:39:17,2013-04-07 17:46:24
d7ddad012b1badaf96075e880d546ef3525f23ff...0597ffa5ecff1b83f384357ab88afaf21838caa2,1,2,2,4,1,2013-04-15 03:01:07,2013-04-14 22:27:04
21ccebec0dd1d7e624ea2f22af6ac93686daf34f...82447e33610396a03f481cb26f39a5d7dc6eb193,2,31,1,32,2,2013-04-07 07:39:26,2013-04-06 03:49:17
82447e33610396a03f481cb26f39a5d7dc6eb193...bc51f7c3e2858052dcf8774bcffa217415b457c2,1,2,2,4,2,2013-04-07 07:39:26,2013-04-06 03:49:18
bc51f7c3e2858052dcf8774bcffa217415b457c2...9d9d698c43aa11d96e9beaf84d77dbceb7460fdd,2,21,1,22,2,2013-04-07 07:39:27,2013-04-06 03:49:19
9d9d698c43aa11d96e9beaf84d77dbceb7460fdd...f00f2511d97efd01d75eb1f769366ccc50a01dc9,1,1,2,3,2,2013-04-07 07:39:27,2013-04-06 03:49:20
f00f2511d97efd01d75eb1f769366ccc50a01dc9...8954441ac7468cf3659f70747d390ed7c9f070d5,1,4,0,4,2,2013-04-07 07:39:27,2013-04-06 03:49:21
8954441ac7468cf3659f70747d390ed7c9f070d5...5445b24e22eea96995f4015e4dadb120ff277c1e,2,27,2,29,3,2013-04-07 07:39:27,2013-04-06 03:49:22
5445b24e22eea96995f4015e4dadb120ff277c1e...6ff8d4e7487c0f48e568b7fd95fa02515a426c1a,2,37,0,37,3,2013-04-07 07:39:28,2013-04-06 03:49:23
21ccebec0dd1d7e624ea2f22af6ac93686daf34f...6d052d78d74e581dd93dd6328d3c214f469e34d7,2,38,0,38,4,2013-04-07 01:56:41,2013-04-05 22:14:06
6d052d78d74e581dd93dd6328d3c214f469e34d7...426e70d4a11ce3b4f70636d57c6a0ab16ae08a00,1,32,1,33,5,2013-04-07 01:56:42,2013-04-05 22:17:23
426e70d4a11ce3b4f70636d57c6a0ab16ae08a00...110bcdc3d0ea9f0042f24a4c0319dede36dfe7f9,1,2,1,3,1,2013-04-07 01:56:42,2013-04-05 22:17:40
110bcdc3d0ea9f0042f24a4c0319dede36dfe7f9...cfa0f4040dd1885fbcdd3d306c1defe22d0fee00,1,2,4,6,1,2013-04-07 01:56:43,2013-04-05 22:20:43
cfa0f4040dd1885fbcdd3d306c1defe22d0fee00...d5ccbe4dfb43d95d1d04252490fcd200e6aa5759,1,2,2,4,2,2013-04-07 01:56:43,2013-04-05 22:21:14
d5ccbe4dfb43d95d1d04252490fcd200e6aa5759...67d2a7b5c502496b0c5acd25a5e0ffa766b61745,4,8,12,20,7,2013-04-07 01:56:44,2013-04-05 22:21:34
67d2a7b5c502496b0c5acd25a5e0ffa766b61745...39a570f26c953e8277a6a26c00da657b240dcdd4,1,1,1,2,1,2013-04-07 01:56:45,2013-04-05 22:22:01
39a570f26c953e8277a6a26c00da657b240dcdd4...de89f0b25a42238948787421c0253228c006f7fa,1,1,2,3,1,2013-04-07 01:56:45,2013-04-05 22:22:15
de89f0b25a42238948787421c0253228c006f7fa...4df13f69e9facbd09a2b06478e8c40082cda7ce6,3,1,11,12,3,2013-04-07 01:56:46,2013-04-05 22:22:31
c5926ac37772e766ff320c61641ad3b935643242...1468a5839309033feb2e58943babdd48b8e2d151,1,25,1,26,4,2013-04-18 19:03:09,2013-04-18 19:02:42
f2de0b97935da2ba3ccb627457e5fa3fc4e11287...845241d5446c6c4be70fcaa9f7b605e7c6760181,1,2,1,3,2,2013-04-18 06:41:25,2013-04-18 06:06:31
f2de0b97935da2ba3ccb627457e5fa3fc4e11287...9cfa5126a0bdb47bc9c6d5feb76bb0fbfd40785b,2,1,75,76,4,2013-04-17 21:48:45,2013-04-17 21:00:48
9cfa5126a0bdb47bc9c6d5feb76bb0fbfd40785b...9dbe7c3d7f4424cf0c27c2d4efabf72e58fa76b9,2,66,21,87,15,2013-04-17 21:50:36,2013-04-17 18:33:35
9dbe7c3d7f4424cf0c27c2d4efabf72e58fa76b9...de5abe9fe91a496d019d62abefe23df9d72fad30,1,8,3,11,2,2013-04-17 21:50:45,2013-04-17 18:33:54
a84b794ad0622103cae98639d7176b2451dc6f92...d7a1d629c3be95f8c2ddd1973b9dae9dd893048f,1,6,7,13,4,2013-07-29 15:44:29,2013-07-27 19:00:07
a84b794ad0622103cae98639d7176b2451dc6f92...08f704f294e4a3525b405c2cb1f4ee85e73fd92c,6,38,20,58,22,2013-06-11 22:15:21,2013-06-06 23:07:14
08f704f294e4a3525b405c2cb1f4ee85e73fd92c...b4b594a3154078430b04fad4f6ffbed9c7274be5,6,209,0,209,8,2013-06-11 22:15:21,2013-06-07 02:13:50
b4b594a3154078430b04fad4f6ffbed9c7274be5...da24b1044f7dc85cda52d6423f5a794a7074fbf8,3,60,31,91,18,2013-06-11 22:15:21,2013-06-07 04:58:12
da24b1044f7dc85cda52d6423f5a794a7074fbf8...81c6b38b67019eff48e8e5c324bb77f6c796c0b5,4,83,1,84,9,2013-06-11 22:15:21,2013-06-07 17:35:54
81c6b38b67019eff48e8e5c324bb77f6c796c0b5...50e5a252225137f0fbb18a0ff72a0ae052e09d24,1,40,47,87,23,2013-06-21 17:16:01,2013-06-21 17:12:48
50e5a252225137f0fbb18a0ff72a0ae052e09d24...841dc6935ea0f2ecfc778501edc66dc2c828d333,3,80,76,156,9,2013-06-21 18:15:32,2013-06-21 17:29:59
841dc6935ea0f2ecfc778501edc66dc2c828d333...b9f80fdaea3a35fa156807e42e52d875bf6ad301,1,22,0,22,1,2013-06-21 18:16:31,2013-06-21 17:52:06
b9f80fdaea3a35fa156807e42e52d875bf6ad301...11667316d0dc455131b3898fdd29fe080b5ae4e0,2,34,26,60,2,2013-06-21 18:16:31,2013-06-21 18:03:32
11667316d0dc455131b3898fdd29fe080b5ae4e0...aff2e7c0677d882690213d7ddea4a868f8b18325,1,24,2,26,2,2013-06-21 18:16:31,2013-06-21 18:08:02
caa7d79f1f7c9940acfaf161b9b84bbf81980d95...924f6c3d3931ea782b0f9abee7b8012fe8e5e0fb,1,19,19,38,7,2013-04-12 21:58:08,2013-04-12 21:18:20
a8624d39689d574c17fb44339e4ffebfb0432413...879070e650d30ac8451b20b5851fad423552cfed,1,48,1,49,5,2013-06-11 20:50:12,2013-06-11 20:50:12
062aeee8aa426468817c5bea96d781289b272ced...97be04077f9ed7ef6ca781cc85d5a0ed36530c04,3,55,5,60,8,2013-08-05 16:30:48,2013-08-02 11:59:07
f66d000b0d7d6d3c858f3aacd9a67d4809ac8011...d6ac1d2120573a9dab5a9502fd1cb1a8e4ad58b5,6,17,14,31,8,2013-07-03 20:27:15,2013-07-03 09:12:34
7a3187eb788854ed3a20fee30b27e68430f753b7...226ad3482ac506af0eadd04e732dda556fda80e4,8,119,0,119,8,2013-07-13 17:19:37,2013-07-13 00:53:10
226ad3482ac506af0eadd04e732dda556fda80e4...cb5c9521f1e41aa536c2cf64d689e647d035bb90,1,43,0,43,2,2013-07-13 17:20:28,2013-07-13 00:53:11
7a3187eb788854ed3a20fee30b27e68430f753b7...a54841e96b78203598dea6b31b9618f40f107e7b,2,42,25,67,18,2013-07-02 20:08:42,2013-07-02 14:47:57
7a3187eb788854ed3a20fee30b27e68430f753b7...776009d1b2bcfbd001767758fea0c2ff0e74383d,1,2,1,3,2,2013-06-30 22:58:25,2013-06-22 11:25:17
776009d1b2bcfbd001767758fea0c2ff0e74383d...66fb37d0c62ef49c9d3506b10d2d7f5b33008484,2,2,0,2,2,2013-06-30 22:59:10,2013-06-22 11:25:18
15d4bf2e1e4f9853a17a86eb923b55d41da22d54...99855ddf4bd319cd06a0524e755ab1c1b7d39f3b,1,10,1,11,3,2013-09-09 15:46:16,2013-09-09 08:53:15
15d4bf2e1e4f9853a17a86eb923b55d41da22d54...01a1e6465fea95c2b4303ed6c9bd14b276456f2d,1,2,3,5,3,2013-05-13 06:20:08,2013-05-12 11:56:40
01a1e6465fea95c2b4303ed6c9bd14b276456f2d...587947750bd73544a6a99811f0ddfd64e1ff1445,4,208,3,211,11,2013-05-29 17:34:54,2013-05-12 11:56:41
a133737b809a6556f087e590e862e8f29561710a...3561e605bc571cf28da3f90df259e9304815c5eb,1,7,7,14,1,2013-04-12 16:49:00,2013-04-12 13:51:42
caa2036b3b4105bfe34f01115e4fb34b78a4db86...bc554df8c90e3592e8cd70460032b524fb6f03bc,1,27,27,54,15,2013-04-16 04:05:21,2013-04-16 03:37:50
96cb27a9d2db3c01b8e296a0fbc1da1da09d1412...66713ef3b00933755cdeff1ae823dda7b5843640,4,135,11,146,12,2013-09-04 19:45:48,2013-08-13 03:43:42
96cb27a9d2db3c01b8e296a0fbc1da1da09d1412...31cd82752585b95e9682008d454fad7769c1f037,1,63,2,65,64,2013-08-26 06:43:28,2013-08-24 00:10:40
31cd82752585b95e9682008d454fad7769c1f037...66ae9a57b887fce227b566b32bd47d2c37ada461,1,24,0,24,1,2013-08-26 06:43:39,2013-08-24 00:10:41
66ae9a57b887fce227b566b32bd47d2c37ada461...75c69766554c4b34ede65502d481dd7beb7f3388,2,31,1,32,5,2013-08-26 06:43:40,2013-08-24 00:10:42
96cb27a9d2db3c01b8e296a0fbc1da1da09d1412...f7c815c3eede201def87a643fdcad09a9af3e3e7,3,26,4,30,6,2013-08-13 17:32:26,2013-08-12 13:55:55
96cb27a9d2db3c01b8e296a0fbc1da1da09d1412...8ed205a380a3ec5e92fb8ae69f5cb20b6cbaa636,1,1,0,1,1,2013-08-13 16:52:22,2013-08-13 13:32:19
96cb27a9d2db3c01b8e296a0fbc1da1da09d1412...1292df11e8063442f911b2a4d0f7213f117d54d7,1,6,2,8,2,2013-08-12 17:10:46,2013-08-08 13:17:38
96cb27a9d2db3c01b8e296a0fbc1da1da09d1412...799460316b87c2b0f26c3c0fcd99ae153f9f7358,1,2,1,3,1,2013-08-12 06:19:08,2013-08-10 20:15:12
799460316b87c2b0f26c3c0fcd99ae153f9f7358...9d57c4a6977997aa8150b333fbe2b88988e392d3,1,59,164,223,22,2013-09-03 21:19:20,2013-08-30 10:02:06
96cb27a9d2db3c01b8e296a0fbc1da1da09d1412...6b388fca90524df65ea71549051f936b8dc9e4b0,1,9668,0,9668,1,2013-08-11 15:14:58,2013-07-01 20:19:04
6b388fca90524df65ea71549051f936b8dc9e4b0...1b5f46f15917fc938c219732fe5ec6a45748f1f7,1,4,0,4,1,2013-08-11 15:14:58,2013-08-09 22:30:55
3b30ba55e4c14c6939a201e87d3542e157e2b318...8fc9f0227e8ea0461abfd3dc01cf1a51cca0f87f,1,4,0,4,1,2013-09-18 05:16:22,2013-09-18 02:52:05
4c7114308ea12de7b69a3b282881398212dec8dd...fdc97abd4a8b04781356dc561b4ba5a634f9854f,2,15,46,61,9,2013-04-23 04:06:06,2013-04-22 21:30:22
3daafe9403c65b39f133f3aa4a6dbbcd372e9db1...9c559d5b86389de2449cd3cd5d53afa14936a6df,1,50,0,50,3,2013-07-22 18:34:10,2013-07-22 18:34:10
0a93fb8a9cc6fa1bf7dba6b498cba3f57f5017a1...92e61831fb2c8d5b874405906510230fd0f10998,1,1,1,2,1,2011-10-16 03:25:21,2011-10-15 18:36:22
0622f79d8e7e91efc5870afe0ce134e1cee9f9f0...f5e025a9d5b35e24768475f6890b836ce0d5ed15,1,15,8,23,3,2009-12-29 15:57:54,2009-12-29 07:48:41
8588567c96490b8d236b1bc13f9bcb0dfa118efe...a757c646ee78ae21c9e8ac66dcc52e361c15c7d2,2,33,14,47,13,2010-03-25 02:35:34,2010-03-25 02:21:32
eefe19fbfc93b359afe43aa1645eb5591a502f15...59a0a0bd579087cce9f7baf6627e5add5a538097,1,7,0,7,2,2009-12-03 19:23:03,2009-12-03 19:12:32
e07fd15b1295393ddf954b9fdd0c3a961e5509c5...61432146ad707e969664c0151364e2d8da9fb157,1,2,2,4,2,2011-05-16 23:19:49,2011-05-16 23:19:49
b96114edb36e16d214af1e7945a1d19b8a5e1686...4783e7ea83e39f19e0ef03372fd721f159d1f1de,1,10,2,12,5,2013-07-12 16:24:29,2013-07-12 10:35:23
042e9f94a71977b471e230f0c637699b0a7ca3d3...3f0812f68d7d4b7f11a850d4c895b168b9490b7c,1,289,247,536,222,2012-05-29 08:28:34,2012-05-29 08:28:34
042e9f94a71977b471e230f0c637699b0a7ca3d3...27ccd8d1a3ccb539d1d97302e1f500b6d20eb781,1,1,0,1,1,2012-05-20 21:54:07,2012-05-19 13:14:16
27ccd8d1a3ccb539d1d97302e1f500b6d20eb781...cb8ad289c6b3f774e6e4431a08eb585eadbb8dad,3,4,4,8,4,2012-05-20 21:58:38,2012-05-20 13:28:26
62e91efafd2030b7dc33ac6450b4e9a316e6ecc6...1d999ddd1daa6da2779d21b293ea9b275780bff8,4,17,21,38,6,2013-07-17 19:50:34,2013-07-16 09:27:36
1d999ddd1daa6da2779d21b293ea9b275780bff8...a11c39646c14600d588ca55fcfe3c244b66047c7,1,7,0,7,1,2013-07-17 19:52:16,2013-07-16 09:27:37
62e91efafd2030b7dc33ac6450b4e9a316e6ecc6...a2cb86c1524b7af20e609ca8d3db0b60b5c1d575,1,1,1,2,1,2013-07-12 17:30:08,2013-07-12 08:58:35
a2cb86c1524b7af20e609ca8d3db0b60b5c1d575...a77f106c7837faf6a712ea3ac720f5c4fa2feb07,1,4,1,5,1,2013-07-12 17:30:09,2013-07-12 08:58:36
62e91efafd2030b7dc33ac6450b4e9a316e6ecc6...3087b615abac487a5f52d31c10bc48f2c769654b,1,4,2,6,1,2013-07-07 18:17:50,2013-07-07 12:43:16
27ec394a9701675762f02e9af464be2c297c6cf1...89df9c84e478b7e6055a93cf45cf37027d25b3e4,2,24,1,25,4,2013-05-01 22:33:09,2013-04-14 12:54:16
89df9c84e478b7e6055a93cf45cf37027d25b3e4...6c6f58dfd26c0643e38d7ea754b6d4173573a1f6,1,12,0,12,2,2013-05-01 22:33:09,2013-04-14 12:54:17
6c6f58dfd26c0643e38d7ea754b6d4173573a1f6...fcce17039cb94e6490a65a846b2375081785ce9b,1,14,1,15,3,2013-05-01 22:33:09,2013-04-22 19:52:11
fcce17039cb94e6490a65a846b2375081785ce9b...7d76fdc8299639096ace153aef0f0b96dcc5b308,1,9,0,9,1,2013-05-01 22:33:09,2013-04-22 19:52:12
7d76fdc8299639096ace153aef0f0b96dcc5b308...3feb4f0cfb7597a98d6e650abc8e9a1a9a0d65b5,1,5,2,7,2,2013-05-01 22:33:09,2013-04-22 19:52:13
3feb4f0cfb7597a98d6e650abc8e9a1a9a0d65b5...b830f6c66b2fd635d9cfa318d047917ea987a719,1,0,7,7,1,2013-05-01 22:33:09,2013-04-22 19:52:14
b830f6c66b2fd635d9cfa318d047917ea987a719...63331581aba9537a83d2e9fe21ffab305d9f8ad6,1,9,11,20,5,2013-05-01 22:33:09,2013-04-22 19:52:15
63331581aba9537a83d2e9fe21ffab305d9f8ad6...f361baeb71fbe9e6fe02f53243673e194265c4cc,1,2,3,5,2,2013-05-01 22:33:09,2013-04-22 19:52:16
f361baeb71fbe9e6fe02f53243673e194265c4cc...7618fd808aab2b7232abea04f1e7d8aa0ca2a476,1,5,3,8,1,2013-05-01 22:33:09,2013-04-22 19:52:17
7618fd808aab2b7232abea04f1e7d8aa0ca2a476...662428f4e98a740800659081910ef8b1ef3940fa,1,20,8,28,2,2013-05-01 22:33:10,2013-04-22 19:52:18
662428f4e98a740800659081910ef8b1ef3940fa...cb2ae1c418eae2cf2c632ca78a14861ff5f3da68,1,30,20,50,4,2013-05-01 22:33:10,2013-04-22 19:52:19
cb2ae1c418eae2cf2c632ca78a14861ff5f3da68...68cf87034402500f0c5dfb8d618b98b4e09895a7,1,24,8,32,7,2013-05-01 22:33:10,2013-04-22 19:52:20
68cf87034402500f0c5dfb8d618b98b4e09895a7...2312a7932080f17c2847ec3ce5dddbc65c2e0b41,2,12,1,13,3,2013-05-01 22:33:10,2013-04-22 19:52:21
2312a7932080f17c2847ec3ce5dddbc65c2e0b41...9a489f3c17d6c974b18c47cf406404ca2a721c87,1,49,14,63,5,2013-05-01 22:33:10,2013-04-22 19:52:22
9a489f3c17d6c974b18c47cf406404ca2a721c87...624cac351478be90bf02a753f9de3e7dc80ca300,1,83,61,144,36,2013-05-01 22:33:10,2013-04-22 19:52:23
624cac351478be90bf02a753f9de3e7dc80ca300...0a0b8d1531feced259223314238aa43cb8ca2ce4,1,33,0,33,1,2013-05-01 22:33:10,2013-04-22 19:52:24
0a0b8d1531feced259223314238aa43cb8ca2ce4...ab292bc4f30dd29d3d111b040b9e982f20b9ceb7,2,36,3,39,2,2013-05-01 22:33:10,2013-04-22 19:52:25
ab292bc4f30dd29d3d111b040b9e982f20b9ceb7...9fc0a64806aa72ca7ef1c20468ffcef5c86978b8,1,18,12,30,9,2013-05-01 22:33:10,2013-04-22 19:52:26
9fc0a64806aa72ca7ef1c20468ffcef5c86978b8...506a760db8c3fd510d7ebe70c189672f185ee108,1,68,16,84,9,2013-05-01 22:33:10,2013-04-22 19:52:27
506a760db8c3fd510d7ebe70c189672f185ee108...c995de61cd218f7ce5119d340ac7d8282b2e2d73,1,9,0,9,1,2013-05-01 22:33:10,2013-04-22 19:52:28
c995de61cd218f7ce5119d340ac7d8282b2e2d73...694b7a1999fa331e00ed9297f3b6b01f7da7a104,2,24,1,25,5,2013-05-01 22:33:10,2013-04-22 19:52:29
694b7a1999fa331e00ed9297f3b6b01f7da7a104...fec3137ffcc49d58e6388b1c61da902b031e01ca,1,30,16,46,4,2013-05-01 22:33:10,2013-04-22 19:52:30
fec3137ffcc49d58e6388b1c61da902b031e01ca...0c0c0bd25e4bea1fb1f48e8bca3ce9b68d69ee93,1,2,2,4,2,2013-05-01 22:33:10,2013-04-22 19:52:31
0c0c0bd25e4bea1fb1f48e8bca3ce9b68d69ee93...32d462cea80cd52b2c3fa0d538aba7fcf079ba77,7,159,170,329,8,2013-05-01 22:33:11,2013-04-22 19:52:32
32d462cea80cd52b2c3fa0d538aba7fcf079ba77...3b4ae6d5023095114692d1e2e1a213611fec9314,1,7,7,14,7,2013-05-01 22:33:11,2013-04-22 19:52:33
3b4ae6d5023095114692d1e2e1a213611fec9314...d9470330379f5899dd117b7c720e67d278fed9e2,1,4,6,10,4,2013-05-01 22:33:11,2013-04-22 19:52:34
d9470330379f5899dd117b7c720e67d278fed9e2...12e77559ec4bf863d3703a25ab79298d5ff89b3b,1,15,14,29,10,2013-05-01 22:33:11,2013-04-22 19:52:35
12e77559ec4bf863d3703a25ab79298d5ff89b3b...8d3725b96fa6878fabe5ec715ff7b9f263481ea1,1,2,9,11,2,2013-05-01 22:33:11,2013-04-22 19:52:36
8d3725b96fa6878fabe5ec715ff7b9f263481ea1...f85354b5c7b800912743927f4abba022444163fd,1,23,16,39,8,2013-05-01 22:33:11,2013-04-22 19:52:37
f85354b5c7b800912743927f4abba022444163fd...0f29920f1e0ce00aaf867fdd9ad2174011179f47,1,8,25,33,8,2013-05-01 22:33:11,2013-04-22 19:52:38
0f29920f1e0ce00aaf867fdd9ad2174011179f47...b2a8226d6360fc6e19af134236b3dd11f9d2040e,1,5,6,11,2,2013-05-01 22:33:11,2013-04-22 19:52:39
b2a8226d6360fc6e19af134236b3dd11f9d2040e...65cf102bb09804929261e1f6cbd2ff5e0af9f301,1,14,15,29,14,2013-05-01 22:33:11,2013-04-22 19:52:40
65cf102bb09804929261e1f6cbd2ff5e0af9f301...9da31cb027aa5dac3d4914a88faa8830f0578c88,1,31,29,60,20,2013-05-01 22:33:11,2013-04-22 19:52:41
7f20008d14e3eececdc90c75d3a86ee6c250cb67...e1c3bf496f494e60e781c8dd0ec3d799ea48722c,10,13,13,26,13,2013-04-12 19:00:52,2013-04-11 22:36:10
e1c3bf496f494e60e781c8dd0ec3d799ea48722c...2582ab18e4b6bf7e56f7931a65b5f2e05e37c18a,4,14,14,28,14,2013-04-12 19:13:05,2013-04-11 22:36:10
2582ab18e4b6bf7e56f7931a65b5f2e05e37c18a...d0008b3c667d3496cc1c27161fcbcd7e40aa9d02,1,1,1,2,1,2013-04-12 19:23:12,2013-04-11 22:36:10
d0008b3c667d3496cc1c27161fcbcd7e40aa9d02...7323513d287d00fe2b40d659fb49042fb027e749,1,1,1,2,1,2013-04-12 19:23:20,2013-04-11 22:36:10
7323513d287d00fe2b40d659fb49042fb027e749...ce9171cd63dc64bd6cfcbb09df630774b2b2a99c,3,6,6,12,6,2013-04-12 19:23:44,2013-04-11 22:36:10
ce9171cd63dc64bd6cfcbb09df630774b2b2a99c...4283b8e4085726330fe1e7927e527ffa8d37f79a,1,3,3,6,3,2013-04-12 19:23:58,2013-04-11 22:36:10
4283b8e4085726330fe1e7927e527ffa8d37f79a...0f7b4c2e77a353f027b9c9869b588145fb036520,1,1,1,2,1,2013-04-12 19:24:04,2013-04-11 22:36:10
0f7b4c2e77a353f027b9c9869b588145fb036520...2fec81cbe5a9867bac65bb0aa9e2605a9de68c4d,1,2,2,4,2,2013-04-12 19:25:08,2013-04-11 22:36:10
2fec81cbe5a9867bac65bb0aa9e2605a9de68c4d...41ccfdd9c931ee71b09f38f4eb19cf44a8e4381d,24,33,33,66,33,2013-04-12 20:38:40,2013-04-11 22:36:10
335c6e403d862913846661638af6e184055f6db5...5cd7fadc076880c48a27fd4e5e70844f127ceb99,1,3,1,4,1,2011-12-20 21:24:02,2011-12-20 20:37:45
77653abd988fb333f7b155e23a3bcea6042505bc...a8f89bfa999dde7fa801ffc29bc89a1f053849e6,1,2,4,6,2,2011-10-10 17:00:13,2011-10-08 01:06:34
a8f89bfa999dde7fa801ffc29bc89a1f053849e6...e67d71e559724eacb6a799f8be42058da52a8580,1,4,14,18,4,2011-10-10 17:02:55,2011-10-08 01:09:34
f09f1d35b5ea0637d8a3733cd246cb6bfb05b22a...9a86dd571058a511e60af35206a31017d873e54a,6,269,206,475,13,2011-05-24 18:22:44,2011-04-28 19:04:01
6086ff65dfcf48237bdac6c64a85bef5d34d5b4e...1020d08786c1413d488845f9175d01c0ea073a6c,2,30,9,39,4,2011-05-08 19:28:30,2011-05-07 05:59:59
1020d08786c1413d488845f9175d01c0ea073a6c...587ac8c9d4b4a9e054dddb4779f6206fde5950ef,1,6,4,10,1,2011-05-10 00:02:08,2011-05-09 23:53:00
587ac8c9d4b4a9e054dddb4779f6206fde5950ef...e41fcfe955cb8080bf8f0e16352d3131d1f01ac8,2,3,4,7,3,2011-05-10 00:02:33,2011-05-07 06:00:00
e41fcfe955cb8080bf8f0e16352d3131d1f01ac8...b4bd466820ee272fccfefff1d23d64c7826d1d07,4,27,16,43,12,2011-05-10 00:02:33,2011-05-07 17:58:07
b4bd466820ee272fccfefff1d23d64c7826d1d07...e6b57a8a4ec6c7522facafe30409ecd2d6b181ba,1,4,3,7,1,2011-05-10 00:02:33,2011-05-07 17:59:04
e6b57a8a4ec6c7522facafe30409ecd2d6b181ba...02a481fc6aef5d8a52f900448657d1cbe7c963ef,1,10,0,10,1,2011-05-10 20:04:00,2011-05-10 19:12:31
d0042abe14b3aece87595d365d6eba84c3e53327...93d5e0c2087916941934b1e55c979c52f5af3f20,1,3,3,6,1,2011-06-20 21:49:34,2011-06-20 21:49:34
7cf16a14f5c070f7b14cf28023769450133172ae...1f5d271f5e8f7b1e2a5b296ff43ca4087eb08244,2,21,0,21,2,2011-05-26 22:05:33,2011-05-26 03:37:12
1f5d271f5e8f7b1e2a5b296ff43ca4087eb08244...26b052515d1714918a7da4bfcdaaca37dc4db2e0,1,1,9,10,2,2011-05-26 22:05:52,2011-05-26 03:37:13
26b052515d1714918a7da4bfcdaaca37dc4db2e0...f9ad901fd31991837c9648bbee8ac18b39aa0891,1,7,0,7,3,2011-05-26 22:05:52,2011-05-26 06:21:01
f9ad901fd31991837c9648bbee8ac18b39aa0891...c35ec8c901a2391c4652ab1acdff04c9d67b1543,1,33,0,33,1,2011-06-02 16:14:44,2011-06-02 09:26:25
140dd77a5cb2e61dcb942e245a2474fae95e42a5...c2015b3ae0d52ccae33ee00c2b25b8402c66bdf0,2,8,1,9,2,2007-11-04 23:16:59,2007-11-04 20:26:22
c2015b3ae0d52ccae33ee00c2b25b8402c66bdf0...93fc05eb9ef505a05d9ce9415177697449afc8ad,3,724,719,1443,5,2007-11-05 19:52:14,2007-11-04 19:15:06
93fc05eb9ef505a05d9ce9415177697449afc8ad...378c4832ef7271a389913f5533611a06415ac5a6,1,36,52,88,8,2007-11-05 21:27:35,2007-11-05 03:35:37
378c4832ef7271a389913f5533611a06415ac5a6...ae3e76c2991ddd5fd72cff22cd39d5d297e63504,1,105,0,105,2,2007-11-05 21:42:35,2007-11-05 04:28:12
ae3e76c2991ddd5fd72cff22cd39d5d297e63504...9f12bec4386fc96e5b617268822cbb75e4c76101,1,4,4,8,4,2007-11-05 23:04:57,2007-11-04 15:31:26
9f12bec4386fc96e5b617268822cbb75e4c76101...0aab4abdd4e6461d61ce6cf1392e1d31c4d1573a,1,1,1,2,1,2007-11-06 00:39:00,2007-11-06 00:39:00
0aab4abdd4e6461d61ce6cf1392e1d31c4d1573a...9b3beb581216fc89972e926574b9d3b243d5e4f4,1,35,2,37,2,2007-11-06 02:47:01,2007-11-05 12:03:22
9b3beb581216fc89972e926574b9d3b243d5e4f4...a1f611d5d03d7849f4d7f47f5bd39b5c44808bb5,1,4,4,8,2,2007-11-06 05:09:39,2007-11-04 08:02:21
140dd77a5cb2e61dcb942e245a2474fae95e42a5...49604a4d62d9055dbfc06472e7ef20d8a6114123,3,32,5,37,10,2007-11-04 09:26:30,2007-11-04 03:38:24
49604a4d62d9055dbfc06472e7ef20d8a6114123...e90ecb68178b41357f40b058aa760c2338974c13,1,106,0,106,1,2007-11-04 09:26:30,2007-11-04 05:50:23
e90ecb68178b41357f40b058aa760c2338974c13...6eea60f85e92901cfe6ad7ab75e4a070215aedf7,1,2,1,3,2,2007-11-06 02:52:16,2007-11-05 23:04:24
140dd77a5cb2e61dcb942e245a2474fae95e42a5...ebe8fa738dcf6911fe520adce0cfa0cb26dee5e2,1,37,14,51,10,2007-11-04 08:56:53,2007-11-04 04:22:42
ebe8fa738dcf6911fe520adce0cfa0cb26dee5e2...0d8aafd25271c8d1cf185019437e21362edc1bc7,1,1,1,2,1,2007-11-05 20:53:14,2007-11-05 01:07:29
0d8aafd25271c8d1cf185019437e21362edc1bc7...218558af599c01e5dec17a7399d9188a76c50203,5,29,28,57,23,2007-11-05 20:53:14,2007-11-05 03:15:41
218558af599c01e5dec17a7399d9188a76c50203...9ef4272bea94b022aa84372c06e211bccd5f8a54,1,19,14,33,8,2007-11-05 20:53:14,2007-11-04 23:05:45
9ef4272bea94b022aa84372c06e211bccd5f8a54...ec640ed1cf1d62730555705ec18b785c43e81f62,2,5,15,20,5,2007-11-05 20:55:33,2007-11-05 03:54:50
ec640ed1cf1d62730555705ec18b785c43e81f62...53ed7b5a5d7a0ad2ffafd4a4ba4a7861f5db624e,1,39,25,64,10,2007-11-08 00:48:40,2007-11-06 21:30:28
53ed7b5a5d7a0ad2ffafd4a4ba4a7861f5db624e...a984a06a07cdd0a843eb6107ad56e346d99ac840,3,19,11,30,12,2007-11-08 23:43:41,2007-11-08 20:45:41
140dd77a5cb2e61dcb942e245a2474fae95e42a5...23c17d4a4a0e1fc9a5fa347f1fc6be3cf477e543,4,55,126,181,28,2007-11-04 08:54:20,2007-11-02 20:32:58
23c17d4a4a0e1fc9a5fa347f1fc6be3cf477e543...cdcefbc971d8fcdd293750af7571d4c715f86964,3,93,0,93,9,2007-11-04 08:54:20,2007-11-03 18:11:10
cdcefbc971d8fcdd293750af7571d4c715f86964...252a7c02354a3e2825cfde3c5053a04acc07be9c,3,119,40,159,15,2007-11-05 22:28:53,2007-11-04 20:12:05
252a7c02354a3e2825cfde3c5053a04acc07be9c...53b2c823f6e862e0c83a4a25bab43e8c32e9c289,5,35,26,61,19,2007-11-06 02:19:28,2007-11-05 21:22:34
53b2c823f6e862e0c83a4a25bab43e8c32e9c289...7dc0fe3be5c949e83e96a1b829be0e72eafffb47,5,22,22,44,20,2007-11-14 11:59:37,2007-11-13 07:16:08
f830d45b9fdb04a5d79c25bb3a3d891d8d3b58e9...059f13045aab9e22a3db2d53ee6abe4a08c4582c,1,2,2,4,1,2008-03-03 09:20:59,2008-03-02 20:58:48
059f13045aab9e22a3db2d53ee6abe4a08c4582c...cf2756ae19e04a7c465ee7bb3b9b8ed4f7e45f28,1,9,0,9,1,2008-03-03 09:20:59,2008-03-02 20:58:50
cf2756ae19e04a7c465ee7bb3b9b8ed4f7e45f28...b683c08082d73484596dcf1236449228d4a9eb98,1,45,1,46,1,2008-03-03 09:20:59,2008-03-02 20:58:51
d633f702a007ecdd19cfd884c6da90f51156ca63...505f297989f4b1fc4c5cb5d0c94e783e385f8d6d,1,1,2,3,2,2007-10-27 06:18:05,2007-10-25 18:16:50
505f297989f4b1fc4c5cb5d0c94e783e385f8d6d...cb1491b6bff20748532c9e50afc7f9d6896167a8,1,56,34,90,6,2007-10-27 06:18:05,2007-10-25 18:17:55
cb1491b6bff20748532c9e50afc7f9d6896167a8...9fb88419ba85e641006c80db53620423f37f1c93,3,19,14,33,10,2007-10-27 06:18:05,2007-10-25 18:19:10
9fb88419ba85e641006c80db53620423f37f1c93...644797119d7a3b7a043a51a9cccd8758f8451f91,3,35,75,110,20,2007-10-27 06:18:06,2007-10-25 18:20:56
644797119d7a3b7a043a51a9cccd8758f8451f91...9027f53cb5051bf83a0254e7f8aeb5d1a206de0b,4,303,65,368,10,2007-10-27 06:18:06,2007-10-25 18:23:26
9027f53cb5051bf83a0254e7f8aeb5d1a206de0b...17559a643ecef94834d930790498c6babe3e89a8,1,6,6,12,2,2007-10-27 06:18:06,2007-10-25 18:24:47
17559a643ecef94834d930790498c6babe3e89a8...81ac051d6ac9deef9a34de496fb981469aae77f0,1,14,13,27,4,2007-10-27 06:18:06,2007-10-26 23:51:28
81ac051d6ac9deef9a34de496fb981469aae77f0...42899ac898f2b539fc762c8452da2c981ccbd815,1,18,14,32,5,2007-10-27 06:18:06,2007-10-26 23:56:34
15eda0202aa3c63fa7b8f9f72df86f4e50eb1d2b...85d81a757e495fe74d8a403f813d3748e832c112,1,1,1,2,1,2007-09-25 06:01:42,2007-09-24 20:33:38
85d81a757e495fe74d8a403f813d3748e832c112...e883932f7dc83ea69a990cba656464d5315f3300,1,1,1,2,1,2007-09-25 07:30:16,2007-09-25 06:42:16
e883932f7dc83ea69a990cba656464d5315f3300...d1637a07f684acd80007723f94c4da9649d85525,1,10,6,16,3,2007-09-25 07:30:19,2007-09-25 06:48:59
15eda0202aa3c63fa7b8f9f72df86f4e50eb1d2b...5d17d765ca754f3e9d87110394a0a397ea7ac2cf,1,12,11,23,13,2007-09-25 06:00:52,2007-09-24 10:57:40
15eda0202aa3c63fa7b8f9f72df86f4e50eb1d2b...711fa74266ebfaf58ee0cd79988748fbaa752538,1,1,35,36,3,2007-09-24 06:04:16,2007-09-08 19:49:11
711fa74266ebfaf58ee0cd79988748fbaa752538...3ef408aefe937fe76559e9b41602cddc0ac8af8c,1,1,1,2,1,2007-09-24 06:12:22,2007-09-08 19:54:28
2af89f12c666634e92cd79a6c1af6acc34104c34...6982ccecaf32ebf8adfcb66b4225da3b46255621,1,3,3,6,4,2007-09-30 06:34:19,2007-09-30 06:34:19
6982ccecaf32ebf8adfcb66b4225da3b46255621...fe50eef59b049588b7dc9b5e02707084f0516b7f,1,1,1,2,2,2007-09-30 06:36:02,2007-09-29 23:39:54
fe50eef59b049588b7dc9b5e02707084f0516b7f...b9b7bab4b6190ef879bb72c7fabf879fd9ca852f,1,28,12,40,4,2007-09-30 06:44:05,2007-09-29 09:58:08
b9b7bab4b6190ef879bb72c7fabf879fd9ca852f...9f5599b9829615379353f676369018c47296e1a1,1,41,29,70,25,2007-09-30 06:44:05,2007-09-29 09:58:39
9f5599b9829615379353f676369018c47296e1a1...0365d885ad17031de27440fec3553675d02aa4c3,1,16,2,18,3,2007-09-30 06:44:05,2007-09-29 09:59:07
0365d885ad17031de27440fec3553675d02aa4c3...72dc52bfe6c56e37f290dd2c428d82686d6647df,1,11,17,28,3,2007-09-30 06:44:06,2007-09-29 09:59:32
72dc52bfe6c56e37f290dd2c428d82686d6647df...326df26d3349ee2f4d63b737ba318d6e6fafccd9,1,1,0,1,1,2007-10-01 00:32:25,2007-10-01 00:32:25
de61e42b539ffbd28d2a2ba827bb0eb79767057b...dd8b883ab9d9a18c5ec8157765244316b2490618,1,3,3,6,1,2007-10-19 02:23:50,2007-10-19 01:12:11
dd8b883ab9d9a18c5ec8157765244316b2490618...08fbb136f7440eac96f4e4396316aff36526f299,1,2,1,3,1,2007-10-19 02:29:25,2007-10-19 02:01:11
08fbb136f7440eac96f4e4396316aff36526f299...d7e56dbc4f60f6bd238e8612783541d89f006fb7,1,17,12,29,1,2007-10-19 02:29:25,2007-10-19 02:05:10
de61e42b539ffbd28d2a2ba827bb0eb79767057b...e3fa2c761fdc490494e8e0855bcee4d7e58ada6a,2,60,43,103,20,2007-10-18 07:46:24,2007-10-17 17:16:11
e3fa2c761fdc490494e8e0855bcee4d7e58ada6a...ca8e6b7a55bfeccbd08182205102d44874f787b6,2,12,2,14,3,2007-10-18 07:46:24,2007-10-17 17:16:12
ca8e6b7a55bfeccbd08182205102d44874f787b6...d279fc1a76bf9bfeedded1a1c8ebcfc8779f5b10,1,1,1,2,1,2007-10-18 23:59:58,2007-10-18 10:25:34
de61e42b539ffbd28d2a2ba827bb0eb79767057b...889a50e909dba5f4416049afc5eeae601fe133bc,1,13,13,26,7,2007-10-18 07:46:04,2007-10-17 09:31:35
de61e42b539ffbd28d2a2ba827bb0eb79767057b...334f4831e5a779d42e521b770a26eae1ecb27e86,1,34,16,50,3,2007-10-18 07:45:59,2007-10-18 06:19:15
334f4831e5a779d42e521b770a26eae1ecb27e86...09fba7a59d38d1cafaf33eadaf1d409c4113b30c,1,28,0,28,1,2007-10-18 07:46:00,2007-10-18 06:17:46
f1a82fe9a3de780fb2f1fe054d692294544f01e7...e502c2c31fbe1a39b964102ead7237ab3246753d,1,3,3,6,1,2007-11-17 08:57:05,2007-11-16 11:28:57
e502c2c31fbe1a39b964102ead7237ab3246753d...347989f4ea9f7ced91c482e4d77cc50ed31d2f50,2,7,0,7,3,2007-11-17 08:57:05,2007-11-16 18:43:16
347989f4ea9f7ced91c482e4d77cc50ed31d2f50...eb9d2b91cf12b92ab45855702965f3bc384462f9,1,12,2,14,2,2007-11-17 08:57:05,2007-11-16 22:02:08
eb9d2b91cf12b92ab45855702965f3bc384462f9...dee1b1ea9e1b0b889d9c53c2501e7f6250703341,1,30,2,32,4,2007-11-17 08:57:57,2007-11-17 05:47:59
ada59fcd3230e661bc1110702a2fb4ef76371bc1...6e9e0327b7d7f384d8a223b4bc40330ef3e7fb61,1,2,2,4,2,2007-12-02 22:38:40,2007-12-02 22:38:40
6e9e0327b7d7f384d8a223b4bc40330ef3e7fb61...683befa1788a216ac31f68bb6e8ae906fd511ab2,1,9,7,16,6,2007-12-03 02:51:09,2007-12-03 02:34:05
683befa1788a216ac31f68bb6e8ae906fd511ab2...61fd2552d89a15b005d36bab99e7172e1c85878b,1,197,18,215,11,2007-12-03 03:07:17,2007-12-02 23:22:02
ae0754ac9a24afa2693246222fc078fe9c133b3a...183a1d1496921e16d316ac523146385af39fcdb0,1,5,1,6,1,2007-09-22 01:58:37,2007-09-21 14:58:02
183a1d1496921e16d316ac523146385af39fcdb0...299077fb40eac1e128b7bc09d5d992960e6f11c2,1,1,1,2,1,2007-09-22 01:58:37,2007-09-21 15:08:50
299077fb40eac1e128b7bc09d5d992960e6f11c2...2fe167b67a479b19e52b974f9518436565e6793b,1,31,3,34,2,2007-09-22 01:58:38,2007-09-21 15:44:23
e7deec6c72f06b6e953cc1cf24653da4f69bcfd4...d4278b51e362e7a0f0e7922db47552f8c6726986,1,4,4,8,4,2007-09-20 17:03:43,2007-09-20 17:03:43
d4278b51e362e7a0f0e7922db47552f8c6726986...2f7c9a7f310dae23989b4acd49514abc58334e5b,2,23,14,37,8,2007-09-21 03:16:53,2007-09-21 01:25:34
41e6b91f01bc9bb7e1679542a8cce9bd4252fd2e...4c502d68666acba7a83379c7abd971aafee91cf8,1,6,2,8,2,2011-03-29 07:14:23,2011-03-29 03:08:20
4c502d68666acba7a83379c7abd971aafee91cf8...9e113988d3d95f1595e2c33f704defeb2cbcc5d6,1,2,1,3,1,2011-03-29 19:47:02,2011-03-29 17:31:30
9e113988d3d95f1595e2c33f704defeb2cbcc5d6...a892a2ddfefca2e25d595bb685c8853d023fde0a,1,6,6,12,4,2011-03-30 04:18:27,2011-03-30 03:30:17
41e6b91f01bc9bb7e1679542a8cce9bd4252fd2e...3371f9b3fb13a508c447e484618b9b5e2b9e45a7,1,44,16,60,3,2011-03-27 20:46:34,2011-03-27 18:13:22
3371f9b3fb13a508c447e484618b9b5e2b9e45a7...9d2f5ddfe56fcc228a36dd079f0897e0f474eb4e,4,98,0,98,5,2011-03-28 01:23:32,2011-01-03 03:54:58
9d2f5ddfe56fcc228a36dd079f0897e0f474eb4e...896e4bfcec4f6b489aba2197f60a59bc7f45a8ac,2,4,4,8,3,2011-03-28 03:37:05,2011-01-03 03:37:36
896e4bfcec4f6b489aba2197f60a59bc7f45a8ac...ddcc8c5b469d2564dbacd629a873e7703f2dbd83,5,133,8,141,7,2011-03-28 03:41:38,2010-12-25 11:11:32
ddcc8c5b469d2564dbacd629a873e7703f2dbd83...252712111fad127db365e3dd764309fe5658679a,2,142,6,148,9,2011-03-28 03:42:53,2010-10-13 09:21:43
252712111fad127db365e3dd764309fe5658679a...bcd254621f9a98794cdc32906db10af7135824c4,2,37,0,37,3,2011-03-28 03:50:01,2010-10-13 09:30:37
bcd254621f9a98794cdc32906db10af7135824c4...fc4ae43b2cbd53da6ac2a0047fb4e53175921696,2,47,11,58,9,2011-03-28 03:51:00,2010-10-13 09:35:59
fc4ae43b2cbd53da6ac2a0047fb4e53175921696...ef2ac77e9f8f4819f75cf52721567463e60a805c,2,10,2,12,5,2011-03-28 04:02:05,2010-10-13 09:38:01
ef2ac77e9f8f4819f75cf52721567463e60a805c...ec71aa2e1f229b90092e6678ac7c2dca3d15b5f3,2,139,7,146,13,2011-03-28 04:27:55,2010-10-13 09:39:44
ec71aa2e1f229b90092e6678ac7c2dca3d15b5f3...4c9b93ed7644a7a7c72bdd8105d88a9ebb8e3e74,2,4,3,7,3,2011-03-28 04:28:02,2010-10-13 09:48:07
4c9b93ed7644a7a7c72bdd8105d88a9ebb8e3e74...d3f131b57ec0e69a37bca882fa6bf39aa4c1c387,2,68,2,70,7,2011-03-28 04:28:27,2010-10-13 09:50:07
d3f131b57ec0e69a37bca882fa6bf39aa4c1c387...c846e4107876936bed7177a811559bd74a72dcd8,2,58,5,63,11,2011-03-28 05:33:48,2010-10-13 09:58:30
157415a9a9589a1e8af28e68c6664d39c34877af...abe27c0cbd97bf6a693004ddb411392ed596a853,1,14,1,15,5,2011-06-15 07:32:50,2011-05-27 10:18:33
abe27c0cbd97bf6a693004ddb411392ed596a853...3ac10b2e3fd6d858621f796160d251ad34affc20,2,46,9,55,9,2011-06-15 07:32:50,2011-05-27 10:44:27
2b5ba7b04631a457165531405710e8a303757b01...25428403448602a19116dc271f000a3735c6779b,1,17,1,18,1,2012-08-09 17:10:45,2012-08-09 15:39:51
78910462ce3aff76ebcfe3a1e6d559c99e14d1fe...487e5707852cca03f924ea4dcfbcad1030db58d8,1,3,0,3,1,2013-08-05 15:27:42,2013-08-03 11:54:03
420432d4342e214c15f063a630a883072d4e5779...765c22588d9e410bf0100c4991b1945134da6959,1,15,6,21,5,2010-07-07 16:17:00,2010-07-07 07:47:20
7b359ea6b3333a87fd3fa8b84913f2b75ed244ad...c2538fd6ba16c18b4b0921ca8252e56e94af1449,1,0,1,1,1,2014-05-19 17:31:36,2014-05-17 11:08:55
07f050c9996cbda2af8d42996ebd349dcdb4c28d...a93d33ee7bf2f1cd41f94470e9e44e0fc9307046,3,34,4,38,5,2012-02-27 00:14:20,2012-02-26 01:06:24
a93d33ee7bf2f1cd41f94470e9e44e0fc9307046...543987bd475abae502939eb3db9c6879fde09c88,2,185,43,228,8,2012-02-27 00:14:29,2012-02-26 01:06:25
543987bd475abae502939eb3db9c6879fde09c88...8d93a5ac68d12a01681a0c2a8d2f799da5cb9fa9,1,1,1,2,1,2012-02-27 00:19:22,2012-02-26 15:37:26
8d93a5ac68d12a01681a0c2a8d2f799da5cb9fa9...09ccbd34f4fe37a682a10b23d86f915b2a8a9c28,1,15,9,24,7,2012-02-27 00:20:18,2012-02-26 15:37:27
9dad9d2e5b322835c87e1653268d892a95ee0f1f...91c23e48d0666a673dd14760bb00f6d59234d9d9,1,3,1,4,2,2006-10-31 23:56:58,2006-10-31 23:56:58
91c23e48d0666a673dd14760bb00f6d59234d9d9...e23ed9a8b4769fcba0944cf121d366ec7db7fe3b,1,2,3,5,1,2006-11-01 23:09:39,2006-11-01 22:34:47
4769489a412fb0decbd73ce59a6756985d0d6bc4...f73da29fa2be2f4bbda86e006b743b8121bdbf19,1,1,1,2,1,2006-11-24 06:51:41,2006-11-23 10:05:17
4769489a412fb0decbd73ce59a6756985d0d6bc4...28b8e61fc63b6776a91e8afd03c7171fbf0779b0,1,8,5,13,4,2006-11-24 00:54:54,2006-11-23 05:57:14
28b8e61fc63b6776a91e8afd03c7171fbf0779b0...2986c02217f98809d8990e7679edf0f5d99f904d,1,13,15,28,2,2006-11-24 00:54:54,2006-11-23 06:24:09
2986c02217f98809d8990e7679edf0f5d99f904d...5677882be721be5e2706a546d90804da8d8d0bd5,1,35,0,35,2,2006-11-24 00:54:54,2006-11-23 07:15:00
e0fd1e3841ebe24aa1d1a6c1ebbb1673f1201927...aa2706463fdeb51d6f9d0e267113b251888cf7f5,1,19,6,25,5,2013-11-01 15:14:52,2013-11-01 15:14:52
e036c90a913889dfa8097ebe73b619370e0c6f32...80c797764a6b6a373f0f1f47d7f56b0d950418a9,1,6,2,8,1,2006-12-24 10:18:57,2006-12-24 09:59:53
4aec56d12ba66a321ce8a6db2ab60f81be5ccfc5...2ef580550460f377af895b09f5870424c0cff8fa,1,2,3,5,2,2006-12-27 22:18:57,2006-12-27 14:16:21
2ef580550460f377af895b09f5870424c0cff8fa...ccdfdea08db398fca1580a970c0d283affa5343f,1,5,5,10,5,2006-12-27 22:21:50,2006-12-27 14:22:21
ccdfdea08db398fca1580a970c0d283affa5343f...87ac1390d9ac2ab5e495b543caee12221a773fb7,1,2,2,4,1,2006-12-27 23:12:31,2006-12-27 23:12:31
4aec56d12ba66a321ce8a6db2ab60f81be5ccfc5...30f610b7b09a579aeba343317114bf18b4fd92bf,5,84,1,85,5,2006-12-27 09:53:03,2006-12-27 07:17:59
30f610b7b09a579aeba343317114bf18b4fd92bf...8f57b0a0fbfc0a6289bbf126f10ae041f0b508aa,1,6,3,9,4,2006-12-27 10:00:30,2006-12-27 10:00:30
8f57b0a0fbfc0a6289bbf126f10ae041f0b508aa...a3c11db9ecf5c2a1ec1b25ba809cecb3747750d4,1,1,1,2,1,2006-12-27 22:23:21,2006-12-27 22:23:21
1b600e659abc7e409c9d830e332d3cef01062c1c...4f0219a4c76a2ce963cf355f90f18c9c59036bca,2,4,1,5,2,2007-01-28 19:00:57,2007-01-28 14:25:55
4f0219a4c76a2ce963cf355f90f18c9c59036bca...c3e821c6366571ee6a2775977340d8935a1ce143,1,1,1,2,1,2007-01-28 19:04:44,2007-01-28 14:55:03
c3e821c6366571ee6a2775977340d8935a1ce143...4f193f20a3d1884cc7b6c2a662783a3df8fe5d9b,1,16,10,26,2,2007-01-28 19:06:59,2007-01-28 15:17:36
4f193f20a3d1884cc7b6c2a662783a3df8fe5d9b...57e7a0a49496fa3c2b2514b6a23ad661ecb428a6,1,46,1,47,3,2007-01-28 20:26:21,2007-01-28 20:21:53
57e7a0a49496fa3c2b2514b6a23ad661ecb428a6...4b3b1e1e488fe83a8a889ff26cf88355692b6a8c,1,7,0,7,2,2007-01-28 20:31:56,2007-01-21 19:04:13
4b3b1e1e488fe83a8a889ff26cf88355692b6a8c...cace16fdcb5d1a3518f92e04c65e78f06b0cd051,2,128,0,128,2,2007-01-28 20:53:26,2007-01-28 20:53:26
cace16fdcb5d1a3518f92e04c65e78f06b0cd051...5558e55c06a1e897f3064f0c8a343d5c9858f6b2,4,47,2,49,7,2007-01-28 21:00:26,2007-01-28 07:39:13
5558e55c06a1e897f3064f0c8a343d5c9858f6b2...a69aba6af3e96f8021c194691a851e78febd70bf,1,1,1,2,1,2007-01-28 22:35:50,2007-01-26 08:58:48
a69aba6af3e96f8021c194691a851e78febd70bf...829a686f1b50ba96cac2d88494fa339efe0c0862,1,268,72,340,11,2007-01-28 22:38:11,2007-01-26 09:01:04
829a686f1b50ba96cac2d88494fa339efe0c0862...e0d10e1c63bc52b37bbec99b07deee794058d9b4,58,460,439,899,192,2007-01-29 00:16:53,2007-01-29 00:16:53
e0d10e1c63bc52b37bbec99b07deee794058d9b4...df391b192d285646fe80ca4d3cfe3c0a3beb5989,15,159,140,299,21,2007-01-29 00:33:58,2007-01-29 00:33:58
df391b192d285646fe80ca4d3cfe3c0a3beb5989...a2f9fe92ebfdf9b5c458642fa0bf32b17433c6c1,2,4,4,8,3,2007-01-29 08:57:07,2007-01-29 08:57:07
a2f9fe92ebfdf9b5c458642fa0bf32b17433c6c1...def2747d0e0b62e326564631fa5441bd1f270ee9,1,23,44,67,2,2007-01-29 09:05:01,2007-01-29 08:09:25
def2747d0e0b62e326564631fa5441bd1f270ee9...dbaa06a2b0f58b7bf1d337380eb61fa4064c1b15,1,4,1,5,2,2007-01-29 09:06:27,2007-01-29 09:06:27
dbaa06a2b0f58b7bf1d337380eb61fa4064c1b15...b4dfefe00f7035140b7a10e855a665c1347cacd6,4,5,2,7,5,2007-01-29 17:36:21,2007-01-29 15:48:06
b4dfefe00f7035140b7a10e855a665c1347cacd6...1732a1fd942f00b9a77a47acc09df0cd62c770bd,1,255,38,293,71,2007-01-30 03:41:21,2007-01-30 01:36:22
1732a1fd942f00b9a77a47acc09df0cd62c770bd...f8306418a687b0aa617b29232763fd2c195215ba,1,2,0,2,1,2007-01-30 10:30:25,2007-01-24 15:03:42
f8306418a687b0aa617b29232763fd2c195215ba...3740b04f6c1dd485a8e717ed6d8c516cedc27063,1,1,1,2,1,2007-01-30 10:30:25,2007-01-30 10:22:37
3740b04f6c1dd485a8e717ed6d8c516cedc27063...153e98d263a825c905f2ef4277b29d1fd5e09b42,1,1,1,2,1,2007-01-30 10:30:25,2007-01-30 09:36:24
153e98d263a825c905f2ef4277b29d1fd5e09b42...73a2acc0a09829f887fdf2dbcfba217102227932,1,2,1,3,1,2007-01-30 10:32:28,2007-01-30 07:56:49
1b600e659abc7e409c9d830e332d3cef01062c1c...9a13f0b71b887af42c3be854344f185c6dfa1d0d,3,26,25,51,23,2007-01-28 10:16:46,2007-01-26 22:26:05
9a13f0b71b887af42c3be854344f185c6dfa1d0d...1655707c9ec56847945854f8645ed64f74159e99,2,3,0,3,3,2007-01-28 10:16:46,2007-01-26 22:26:06
1655707c9ec56847945854f8645ed64f74159e99...bd104db164d7f2a714aa0f1cdf89fd89fee6c00a,1,5,2,7,2,2007-01-28 10:16:46,2007-01-26 22:26:07
bd104db164d7f2a714aa0f1cdf89fd89fee6c00a...e1dde3d06c7caa242dd4b419aebb9a9b7fee2d48,1,3,2,5,1,2007-01-28 10:16:46,2007-01-26 22:26:08
e1dde3d06c7caa242dd4b419aebb9a9b7fee2d48...41b625b047ad5c537ca312d2f07c86bdd783a7b0,1,47,47,94,2,2007-01-28 10:16:46,2007-01-26 22:26:09
41b625b047ad5c537ca312d2f07c86bdd783a7b0...8b5157e40718a2ee1d645c342d93df4e66335479,6,35,8,43,13,2007-01-28 10:16:46,2007-01-26 22:26:10
8b5157e40718a2ee1d645c342d93df4e66335479...47fc52e2876ed3a54cd4b77e0b0c4875fa3317b8,1,11,9,20,10,2007-01-28 10:16:46,2007-01-27 01:49:00
47fc52e2876ed3a54cd4b77e0b0c4875fa3317b8...a7e4fbf990290f955da1319ab605a59f85d3c3e2,1,1,1,2,1,2007-01-28 10:16:46,2007-01-26 22:26:11
a7e4fbf990290f955da1319ab605a59f85d3c3e2...eb8381c88518b10d683a29deea1d43ed671f14ec,5,67,9,76,10,2007-02-03 19:57:18,2007-02-03 18:25:43
8188e73b17c570517ac3bac742810f1b2e5c420d...c5650b0840ef1630ab9e67e9e314fb73ca112cdc,1,1,1,2,1,2007-02-06 03:09:40,2007-02-05 04:52:02
c5650b0840ef1630ab9e67e9e314fb73ca112cdc...88293c675c0c15c8247de32e903f4302bac63027,1,28,0,28,3,2007-02-06 03:09:40,2007-02-05 04:52:08
88293c675c0c15c8247de32e903f4302bac63027...d46ae3f09a8c7b531e1110d46a2f8cdcfa853b11,1,82,32,114,5,2007-02-06 08:46:56,2007-02-06 07:01:14
d46ae3f09a8c7b531e1110d46a2f8cdcfa853b11...c8f80d4dc89eddd4b343cb82ca8a75cfa41f800e,1,1,1,2,1,2007-02-06 09:09:32,2007-02-06 09:09:32
c8f80d4dc89eddd4b343cb82ca8a75cfa41f800e...e68989a739d8b1c5effb898d1ac78d27ca9d313a,2,7,4,11,5,2007-02-06 09:52:04,2007-02-06 09:52:04
e68989a739d8b1c5effb898d1ac78d27ca9d313a...4ef40cdbe8661586053acbde34c8f89883b6f94a,1,1,1,2,1,2007-02-06 21:58:03,2007-02-06 17:28:32
4ef40cdbe8661586053acbde34c8f89883b6f94a...0b2958a8b431b8c7f27bc34fdbe400cb204ede06,1,2,1,3,1,2007-02-06 22:09:03,2007-02-06 19:08:55
0b2958a8b431b8c7f27bc34fdbe400cb204ede06...a7fd83b0b06c518c90b59836264cf93efce0795f,2,0,198,198,2,2007-02-07 00:33:16,2007-02-07 00:33:16
8188e73b17c570517ac3bac742810f1b2e5c420d...32364b3a191041f330bbe334de934458bbae9f10,1,4,4,8,4,2007-02-06 01:14:14,2007-02-01 13:44:46
32364b3a191041f330bbe334de934458bbae9f10...3468e71f452701b3eff6a2aeb826bbe0cdad8270,1,150,126,276,50,2007-02-06 01:14:15,2007-02-01 13:46:38
3468e71f452701b3eff6a2aeb826bbe0cdad8270...0f57a31b4c7f8784b70535681a669b7746f38f1c,1,2,2,4,2,2007-02-06 01:14:15,2007-01-30 05:53:28
aeecd23ae2785a0462d42191974e9d9a8e439fbe...ee75d4cd310a2d45b641f4524565bea6fd1d1ecc,1,24,0,24,1,2006-03-01 09:10:26,2006-02-23 23:20:51
ee75d4cd310a2d45b641f4524565bea6fd1d1ecc...7172aabb4b5a6d0345b3c57f2f7ededece81b9b7,1,21,3,24,6,2006-03-01 09:10:26,2006-03-01 06:30:35
7172aabb4b5a6d0345b3c57f2f7ededece81b9b7...858cbfbabe4ede5f5eba32041eb7448319e53e2a,1,20,0,20,1,2006-03-01 09:10:27,2006-03-01 07:03:58
aeecd23ae2785a0462d42191974e9d9a8e439fbe...65416758cd83772f2f3c69f1bd1f501608e64745,5,61,40,101,11,2006-03-01 04:20:04,2006-03-01 00:01:36
2ae1c53b51ff78b13cc8abf8e9798a12140b7638...621603b76afe00471613ce92b78376fc57f21234,1,6,2,8,3,2006-02-28 01:34:26,2006-02-28 01:07:16
621603b76afe00471613ce92b78376fc57f21234...f21d6726150ec4219e94ea605f27a4cd58eb3d99,1,11,0,11,3,2006-02-28 09:12:52,2006-02-28 09:12:52
80804d0af8f5bfa8ce87b5ef72cd2c5eb64c8f40...d3cac2c95a1600c9269c821153cbad681b66a8d2,2,25,5,30,6,2006-02-27 23:27:24,2006-02-27 23:08:19
d9a83684c473e04c61f0060c4926d20f8183f7b6...a4a88b2bab3b6fb0b30f63418701f42388e0fe0a,3,266,251,517,19,2006-02-28 22:49:29,2006-02-28 19:24:00
a4a88b2bab3b6fb0b30f63418701f42388e0fe0a...f67b45f862d17b54037b9b59eefc385624d1fa83,3,52,1,53,3,2006-02-28 22:49:32,2006-02-28 19:26:21
f67b45f862d17b54037b9b59eefc385624d1fa83...70b006b9712b57741ec1320b15aef2f8b1d6a905,2,25,1,26,4,2006-02-28 22:49:34,2006-02-28 19:30:19
70b006b9712b57741ec1320b15aef2f8b1d6a905...765ac8ec469f110e88376e4fac05d0ed475bcb28,11,82,1299,1381,38,2006-03-01 09:45:50,2006-02-28 23:07:20
be972922d034e4b007e0f644a7285266863f2cbc...6be32d4791126da12e0eade17362ae8ad3f13971,1,56,17,73,5,2006-03-04 05:37:31,2006-03-04 04:47:29
6be32d4791126da12e0eade17362ae8ad3f13971...cdb6760e6f4ba956604d715df191b6f442238d5d,1,14,1,15,2,2006-03-04 06:28:04,2006-03-04 04:47:22
c982647310fc5acd0bd6ebc408e70470447b387f...c8e2db00f9622af6e5f640443dfbe63bb1af39e0,1,3,7,10,3,2006-03-16 00:14:33,2006-03-15 22:51:41
c8e2db00f9622af6e5f640443dfbe63bb1af39e0...6169858d19b0ee01a549d83f222c097549968d66,1,2,2,4,2,2006-03-16 00:14:54,2006-03-15 23:35:06
f2561fda364ad984ef1441a80c90b0ee04f1a7c4...aa2577a9c3bd5559bd580feca6edec4d70254adc,1,0,1,1,1,2011-11-23 21:28:06,2011-11-23 20:32:37
f2561fda364ad984ef1441a80c90b0ee04f1a7c4...be767c91724275c4534965c0d25c452b76057602,1,1,1,2,1,2006-03-11 08:03:30,2006-03-11 07:39:28
be767c91724275c4534965c0d25c452b76057602...8e7f9035b8271469747e3745aa7e095e12f74e5e,1,1,1,2,1,2006-03-11 10:00:35,2006-03-11 08:55:50
8e7f9035b8271469747e3745aa7e095e12f74e5e...42efbf6d8a5b4902c55a2f6e96034625c056ba1f,1,2,2,4,2,2006-03-12 01:44:10,2006-03-12 01:44:10
42efbf6d8a5b4902c55a2f6e96034625c056ba1f...2d33501689989616a2dc003ca80fafa60b1ed5da,1,1,0,1,1,2006-03-12 11:28:20,2006-03-12 10:55:53
f2561fda364ad984ef1441a80c90b0ee04f1a7c4...5241bfe6d1593ad775dd79a5f598f66f479968b5,1,5,8,13,5,2006-03-11 07:01:45,2006-03-11 04:17:55
5241bfe6d1593ad775dd79a5f598f66f479968b5...baa7b67d091acf4c666e79e386712bd5ea79326c,3,49,20,69,44,2006-03-11 07:01:48,2006-03-11 04:18:01
baa7b67d091acf4c666e79e386712bd5ea79326c...3030baa7f06e65d6de2d612d7edb94d22f27d239,1,106,137,243,25,2006-03-11 07:01:50,2006-03-11 04:18:08
3030baa7f06e65d6de2d612d7edb94d22f27d239...512d632cf25c7c8c32fe4d7eb96aff9d24fa247d,1,76,73,149,28,2006-03-11 07:01:52,2006-03-11 04:18:12
512d632cf25c7c8c32fe4d7eb96aff9d24fa247d...197e8951abd2ebf2c70d0847bb0b38b16b92175b,1,536,11,547,26,2006-03-11 07:01:54,2006-03-11 04:18:18
197e8951abd2ebf2c70d0847bb0b38b16b92175b...1a703cba6dac85936a5026587a90dcb827d00088,1,33,24,57,23,2006-03-11 07:01:56,2006-03-11 04:18:33
f2561fda364ad984ef1441a80c90b0ee04f1a7c4...687b8be8bb75b97e917dc744f91890270913041d,3,20,6,26,9,2006-03-11 06:31:20,2006-03-10 12:19:07
f2561fda364ad984ef1441a80c90b0ee04f1a7c4...6b6dcfc297722f5a5324c4cb22f45adccd4c84ef,2,44,12,56,13,2006-03-11 06:11:14,2006-03-10 09:21:37
6b6dcfc297722f5a5324c4cb22f45adccd4c84ef...8efdc326c9681e814d79e8da6097c187388dc0c4,3,75,47,122,33,2006-03-11 06:22:00,2006-03-10 09:21:39
8efdc326c9681e814d79e8da6097c187388dc0c4...27e7304567c92c9771efa7a8b787c487391a5fcd,1,199,40,239,22,2006-03-11 06:22:20,2006-03-10 09:21:41
23edecbc9a5566ac5aa8fb251fbcf8bb83694837...50ac7408018209a2829b7948119270fec7e14ec8,1,1,1,2,1,2006-04-19 22:37:36,2006-04-19 21:54:27
50ac7408018209a2829b7948119270fec7e14ec8...61c2bcbd11e3b66a328b3850c01592e5dc1c67bb,1,3,0,3,1,2006-04-19 22:37:40,2006-04-19 21:58:24
740659519e0b30bc6b64f00ba69825294c40db07...8bc7574b6332ef45645c6e0917e9d59919b277ef,1,2,2,4,1,2006-04-12 20:23:50,2006-04-12 20:23:50
86f7780c0b77b3c162f85d499189f9d1f0b296df...ea5aeb07e9ad92743eaaf216360340b70d4c3bbd,1,4,1,5,1,2006-06-04 06:44:40,2006-06-04 06:44:40
ea5aeb07e9ad92743eaaf216360340b70d4c3bbd...895f10c3b596ef955c7f252717e5b4668530c569,4,8,6,14,7,2006-06-04 06:45:30,2006-06-03 16:45:43
895f10c3b596ef955c7f252717e5b4668530c569...abda1ef590d94a5e15e7ce3b685b5c092a790cfa,28,47,47,94,47,2006-06-04 06:54:55,2006-06-03 20:27:26
86f7780c0b77b3c162f85d499189f9d1f0b296df...2052d146f60eaeeef50cb4d437e4a25051f8d8c3,1,35,34,69,11,2006-06-03 01:17:08,2006-05-31 14:14:08
2e1ded44f709ddc95c5e8a87e0d98127979115fe...f8a2c0d14f5326e157b12ec549b864ddb492621d,1,101,23,124,27,2006-07-05 12:56:37,2006-07-05 12:56:37
f8a2c0d14f5326e157b12ec549b864ddb492621d...8a48571ce52e5182ea32ed168e298882f8c470b3,1,22,5,27,9,2006-07-06 00:21:23,2006-07-06 00:21:23
7fb23e6083dbefa8eb4c554d8b2cd5a6292b2df4...17cf250aff26d3baa6b311a3404f1a932e16cf17,1,2,1,3,2,2006-06-07 18:49:08,2006-06-07 18:05:43
17cf250aff26d3baa6b311a3404f1a932e16cf17...3742506578dda5de2fe97e403f04150a85ffef17,10,14,13,27,12,2006-06-07 18:49:35,2006-06-07 12:56:45
3742506578dda5de2fe97e403f04150a85ffef17...34925d35ff278c7377e0cf3fce0227d5eceffeb5,3,76,1,77,5,2006-06-07 18:49:35,2006-06-07 18:15:10
34925d35ff278c7377e0cf3fce0227d5eceffeb5...74237d6236d7e32f69469ff26df3f3bb3875f523,3,24,4,28,4,2006-06-07 19:37:46,2006-06-07 18:32:33
74237d6236d7e32f69469ff26df3f3bb3875f523...9dc2164ab390a49b91f4866a85a076a5c5251986,1,1,1,2,1,2006-06-07 19:37:46,2006-06-07 19:27:53
9dc2164ab390a49b91f4866a85a076a5c5251986...4514ad4fb77b3c68f69133c22b9c0d3b88ff058f,2,11,0,11,2,2006-06-07 19:37:46,2006-06-07 18:43:50
4514ad4fb77b3c68f69133c22b9c0d3b88ff058f...fd7e9fb7ae206a64b87c7faecfc88716e98a7577,1,7,4,11,4,2006-06-07 19:48:34,2006-06-07 19:46:55
fd7e9fb7ae206a64b87c7faecfc88716e98a7577...4269822012ccdcdccf8c2685ac37aa3fb2b1f876,1,1,1,2,1,2006-06-07 23:29:36,2006-06-07 23:29:36
4269822012ccdcdccf8c2685ac37aa3fb2b1f876...b8936cf0605fbcc01cf9f0426e1e078d26f4bde1,1,9,9,18,4,2006-06-07 23:32:35,2006-06-07 23:15:05
b8936cf0605fbcc01cf9f0426e1e078d26f4bde1...0fc8573d4b039f54f3c8a70f756cfe63f8129f7b,1,31,18,49,12,2006-06-07 23:32:50,2006-06-07 22:28:34
0fc8573d4b039f54f3c8a70f756cfe63f8129f7b...99b41c84a53bf8bb09f06adeb0e3ded503afe706,1,4,3,7,1,2006-06-08 00:25:21,2006-06-08 00:25:21
188a634fec006a37489163b4bd36321d0a0ade77...86118bcb463e3f34b3df21d550335a40586dfb66,1,5,0,5,2,2006-05-05 22:24:12,2006-05-05 10:20:44
f2f880f53707f83244c4659b6440224137aa0efa...a0fd31463b8b391ff940e97706ba064608feb1e1,3,8,7,15,5,2006-04-07 05:29:55,2006-04-07 05:29:55
a0fd31463b8b391ff940e97706ba064608feb1e1...5040f17eba15504bad66b14a645bddd9b015ebb7,3,127,60,187,14,2006-04-07 08:59:51,2006-04-07 06:58:51
6a9b87972f27edfe53da4ce016adf4c0cd42f5e6...e646c9c8c0aa995eac284ea0a2117add19c4461c,1,71,18,89,14,2006-02-15 00:10:49,2006-02-14 22:42:05
6a9b87972f27edfe53da4ce016adf4c0cd42f5e6...0a48a344c6a886fee7f4e6d88e8ac5d5317ad8eb,2,8,3,11,5,2006-02-14 09:30:43,2006-02-14 02:43:34
9ece7169a434d69a942b71dc49f507da37bbdbc3...504fe714fe642b375992bb913075bee0d0bc1bbd,1,4,2,6,1,2006-02-15 00:05:57,2006-02-15 00:05:57
9ece7169a434d69a942b71dc49f507da37bbdbc3...bba319b5cecacaccef85ce3c4cf9e3593532e328,2,53,17,70,17,2006-02-14 22:48:22,2006-02-14 20:40:20
ee3d299e93450586d12f099913261ec22849365a...e93ec6f9d8dd122557d54505129f7860b9301503,1,1,15,16,4,2006-01-20 02:29:11,2006-01-19 04:26:14
e93ec6f9d8dd122557d54505129f7860b9301503...e921fb82cf6fb4a5f138ec9d27bc37c658336a8c,1,0,3,3,1,2006-01-20 02:29:43,2006-01-18 23:24:04
429608fc365d4e6e0db9dee72a0b103dce578722...19205acfc29b6d39b5643a7f9a2448f89df14355,1,27,1,28,1,2006-01-14 00:52:37,2006-01-12 07:07:27
19205acfc29b6d39b5643a7f9a2448f89df14355...1be0659efca4a1f69c851f95563e930d70d8baf2,2,107,29,136,17,2006-01-14 00:52:37,2006-01-12 22:04:36
1be0659efca4a1f69c851f95563e930d70d8baf2...9e9b26751a5ca7a257b3e1cfb319fe3e4efc663c,1,21,0,21,4,2006-01-14 00:53:35,2006-01-12 23:29:12
7cb038a692ec0bdc0f442380678e8e87e26d4e68...181dc776956b4d265891ac70514ed214e4b7564a,2,8,5,13,4,2006-01-16 06:15:37,2006-01-16 06:15:37
d7bba815753bf8c31886fcf6bb89c9e6250674a5...8b649e27dd26608098605ded691b497ffa032500,2,37,13,50,14,2005-11-15 08:07:46,2005-11-15 06:12:17
8b649e27dd26608098605ded691b497ffa032500...bce8230d5d897a738cc004954df71f50a40295db,2,4,3,7,4,2005-11-15 08:19:32,2005-11-14 16:41:01
bce8230d5d897a738cc004954df71f50a40295db...313c4714c5ec1673805b952ba79d910a42e8937c,1,14,2,16,9,2005-11-15 08:34:50,2005-11-11 23:55:16
313c4714c5ec1673805b952ba79d910a42e8937c...cd0a781c386b197e63a30104bead39420eada7ca,7,14,13,27,10,2005-11-15 09:31:04,2005-11-15 09:31:04
cd0a781c386b197e63a30104bead39420eada7ca...a52e4ef877f693a69710145f56d867365a755f91,1,1,1,2,1,2005-11-15 19:42:28,2005-11-15 12:29:18
a52e4ef877f693a69710145f56d867365a755f91...545f229a4b43212e683ac63e5aa740324ac7799e,1,7,0,7,2,2005-11-15 19:42:28,2005-11-15 16:07:15
545f229a4b43212e683ac63e5aa740324ac7799e...4a4e6fd74f7d4564ed43eaaf59b6bd70c1959f1a,7,116,42,158,26,2005-11-15 19:42:29,2005-11-15 16:08:08
4a4e6fd74f7d4564ed43eaaf59b6bd70c1959f1a...f8348be3be8493a62110a09ab0343213990b416b,5,14,4,18,5,2005-11-15 19:42:29,2005-11-15 18:24:19
f8348be3be8493a62110a09ab0343213990b416b...3299c6f6a8a384453d025ffa117c5d8b35ba1972,5,16,5,21,8,2005-11-15 23:08:27,2005-11-15 20:48:08
3299c6f6a8a384453d025ffa117c5d8b35ba1972...c0bbbb1ba93154e31f05eab69fee70006fe7acb2,1,1,1,2,1,2005-11-15 23:08:28,2005-11-15 20:51:02
c0bbbb1ba93154e31f05eab69fee70006fe7acb2...8e49d50388211a0f3e7286f6ee600bf7736f4814,3,237,88,325,7,2005-11-16 00:02:57,2005-11-15 23:31:25
8e49d50388211a0f3e7286f6ee600bf7736f4814...cb22bc44474686f1e0d1ad991732ccd634498729,1,28,7,35,3,2005-11-16 00:02:59,2005-11-15 23:31:25
cb22bc44474686f1e0d1ad991732ccd634498729...97fc6c5fbacc2181319bbd7e2faa8ac04476f862,2,28,2,30,3,2005-11-16 00:03:00,2005-11-15 23:31:25
97fc6c5fbacc2181319bbd7e2faa8ac04476f862...1a41e743c6270a24daca7309ef3d9ef74543d8ae,1,15,32,47,2,2005-11-16 05:19:56,2005-11-15 21:24:02
1a41e743c6270a24daca7309ef3d9ef74543d8ae...a0fa2a10b401aa4c8b13d176a5e3e3b7c455208f,1,2,0,2,1,2005-11-16 06:10:58,2005-11-16 01:44:50
a0fa2a10b401aa4c8b13d176a5e3e3b7c455208f...ad4f4daae80cb00000aca76e1528add6daf8f033,1,4,2,6,2,2005-11-16 06:10:59,2005-11-16 02:33:44
ad4f4daae80cb00000aca76e1528add6daf8f033...7dbc2c0402d728a206d4f1bc59729bf3a5cc4455,1,98,56,154,22,2005-11-16 07:13:30,2005-11-16 07:13:30
7dbc2c0402d728a206d4f1bc59729bf3a5cc4455...c0c35d5e419f3bf215103b1e26359aca288c2113,1,4,0,4,1,2005-11-16 21:17:46,2005-11-16 17:38:46
c0c35d5e419f3bf215103b1e26359aca288c2113...8366a10ab21f22deb7ea4a9dbd02effcd279318c,3,13,8,21,5,2005-11-16 21:19:18,2005-11-16 18:27:28
8366a10ab21f22deb7ea4a9dbd02effcd279318c...565cb991147d7bf7945ed50d9d5e1e84ade35572,1,1,1,2,1,2005-11-16 21:19:37,2005-11-16 19:06:03
565cb991147d7bf7945ed50d9d5e1e84ade35572...0ff2ce9d8a305038c0c116cd1e3b478a9f5b81c1,1,2,2,4,2,2005-11-16 21:20:58,2005-11-14 16:45:05
0ff2ce9d8a305038c0c116cd1e3b478a9f5b81c1...ebdbfa8b556c9b4cebf27cb5f9364c9c19274620,1,1,1,2,1,2005-11-16 21:20:58,2005-11-14 16:41:43
ebdbfa8b556c9b4cebf27cb5f9364c9c19274620...8b3fbeef395295c0d2de61265632ed30eda7bf0a,1,1,1,2,1,2005-11-16 21:20:59,2005-11-14 16:42:36
8b3fbeef395295c0d2de61265632ed30eda7bf0a...5b4525eb8b6a4a131d0cc10075165829f754dcc2,1,2,2,4,2,2005-11-16 21:20:59,2005-11-14 16:43:51
5b4525eb8b6a4a131d0cc10075165829f754dcc2...92927ed0aac56a86f85049215791fcd106af4b62,2,85,4,89,3,2005-11-16 22:12:56,2005-11-16 22:12:56
92927ed0aac56a86f85049215791fcd106af4b62...0c15cc921a54a2cd5f0758041fe9fdd715a493e8,1,53,12,65,11,2005-11-17 00:19:11,2005-11-16 08:19:32
0c15cc921a54a2cd5f0758041fe9fdd715a493e8...011f4274bbb14e44035586f2ede695d584b8cfd2,3,101,7,108,12,2005-11-17 00:20:40,2005-11-15 01:37:05
011f4274bbb14e44035586f2ede695d584b8cfd2...80b1e511d74ac2942043f912d850cb6b85b44689,3,16,7,23,10,2005-11-17 00:20:40,2005-11-15 01:53:22
80b1e511d74ac2942043f912d850cb6b85b44689...fbba222f5de21aafa566430a8ae7cf6f4ab163b1,1,39,10,49,11,2005-11-17 00:20:41,2005-11-16 23:52:45
fbba222f5de21aafa566430a8ae7cf6f4ab163b1...a8883288fa1240996a9c5715e060a88a03796fe0,1,6,2,8,6,2005-11-17 04:34:26,2005-11-16 23:38:29
a9583afc1df1df10d60d2b81fd4b0976bc67ca4e...992cb20688033dfa3cf8ceff29ac655f1a0ad6d9,1,151,109,260,42,2014-10-10 22:59:40,2014-10-10 21:25:35
992cb20688033dfa3cf8ceff29ac655f1a0ad6d9...5a568ea05094da4507170ff91fc528a0113dc8be,1,2,1,3,2,2014-10-10 22:59:41,2014-10-10 21:25:36
5a568ea05094da4507170ff91fc528a0113dc8be...673151a9bb56ec97fab66746e3aecef78fddb9b8,12,32,21,53,17,2014-10-10 23:02:26,2014-10-10 21:25:37
eab335c46d6677ff50e9fe94352150641bc05507...8f0cb41da26c1e20cfbcfded030d6539464b132e,2,37,4,41,4,2014-10-16 19:09:51,2014-10-11 17:04:45
8f0cb41da26c1e20cfbcfded030d6539464b132e...688684eba436c021eaddab1725093bb953cf260d,1,23,0,23,1,2014-10-16 19:09:51,2014-10-15 08:35:19
6c4ab27f2378ce67940b4496365043119d7ffff2...073281e2aea7177e27de8a46c5463e2f83833412,1,10,7,17,7,2014-11-13 20:57:28,2014-11-13 11:04:52
073281e2aea7177e27de8a46c5463e2f83833412...d37239536ce960af9292fdf297e7c277303e95be,2,5,2,7,3,2014-11-13 22:40:47,2014-11-13 21:43:31
6c4ab27f2378ce67940b4496365043119d7ffff2...466fb6742d7fb7d3e6994b2d0d8db83a8786ebcf,8,45,7,52,12,2014-08-29 19:37:02,2014-08-29 16:58:42
6c4ab27f2378ce67940b4496365043119d7ffff2...981ff520b7487886c773910d6309ec327efba3ea,1,1,1,2,1,2014-08-29 17:38:07,2014-08-29 16:42:33
981ff520b7487886c773910d6309ec327efba3ea...6441090cf234b88c2fdbb9cd754714108fd57755,1,8,0,8,1,2014-08-29 17:39:39,2014-08-29 16:42:34
6441090cf234b88c2fdbb9cd754714108fd57755...a6fd4fb55d255ae14dc3ced5eae6247b4a9d86ea,1,6,0,6,1,2014-08-29 17:45:32,2014-08-29 16:42:35
6c4ab27f2378ce67940b4496365043119d7ffff2...da011cb0e77a6d2f7c424c5b7dbf482df4723a11,1,51,9,60,6,2014-08-28 22:41:28,2014-08-28 17:00:49
6c4ab27f2378ce67940b4496365043119d7ffff2...91e70e00ac3e72eb81e10273b48d884553e7d01d,2,2,3,5,2,2014-08-28 17:29:53,2014-08-28 09:46:58
6c4ab27f2378ce67940b4496365043119d7ffff2...a8722750985a53cc502a66ae3d68a9e42c7fdb98,3,407,11,418,20,2014-08-27 17:42:16,2014-08-27 17:01:28
a8722750985a53cc502a66ae3d68a9e42c7fdb98...75d3d6573ee809f35dd87ee4569e49b068ab4731,1,59,4,63,2,2014-08-28 17:32:52,2014-08-28 12:32:58
6c4ab27f2378ce67940b4496365043119d7ffff2...fe6eb7f2c506190c817407accf27834005a57f2b,3,39,27,66,6,2014-08-27 17:25:28,2014-08-27 07:56:01
fe6eb7f2c506190c817407accf27834005a57f2b...6876618ceaafddba625ed823679d99de0e79d111,1,1,1,2,1,2014-08-27 17:30:42,2014-08-27 07:56:31
6876618ceaafddba625ed823679d99de0e79d111...ea5517f04b08bdb40eca72888220bd6a90d3cf17,1,8,14,22,3,2014-08-27 17:31:13,2014-08-27 07:56:55
ea5517f04b08bdb40eca72888220bd6a90d3cf17...c33ddc2e33d51da9391a81206a1d9e4a92d97d10,6,45,48,93,35,2014-08-27 17:32:56,2014-08-27 07:57:08
c33ddc2e33d51da9391a81206a1d9e4a92d97d10...f0f9662ae9d1c7f58a95397d1c6d5f31760b14be,1,21,28,49,7,2014-08-29 17:33:28,2014-08-27 07:57:28
f0f9662ae9d1c7f58a95397d1c6d5f31760b14be...f4ef51739343f80c7cb0467244925b3725d65730,1,27,13,40,10,2014-08-29 17:33:28,2014-08-27 07:57:56
6c4ab27f2378ce67940b4496365043119d7ffff2...1f31963e9214e5907bc00908100d3a2902ab35dc,1,1,1,2,1,2014-08-25 19:23:01,2014-08-22 04:32:08
1f31963e9214e5907bc00908100d3a2902ab35dc...d85b0dff7297fb43a57a0c1e697417bb7723247c,1,8,132,140,6,2014-08-25 21:03:07,2014-08-25 20:00:42
d85b0dff7297fb43a57a0c1e697417bb7723247c...14821f88224b7e6641070fb4971674971886f1ed,1,0,59,59,7,2014-08-26 19:56:31,2014-08-22 04:33:16
6c4ab27f2378ce67940b4496365043119d7ffff2...7ce7c7607b14248b1a3ae7cdd1c079eb3b6efa09,2,3,4,7,3,2014-08-21 22:27:20,2014-08-21 16:05:08
7ce7c7607b14248b1a3ae7cdd1c079eb3b6efa09...23b0c4782e5f9357e6189253021053a4404ddf4e,2,17,0,17,3,2014-08-28 17:24:54,2014-08-26 15:23:21
23b0c4782e5f9357e6189253021053a4404ddf4e...9927d9627fe01d780e754a02cf9adc36e084c587,2,9,8,17,3,2014-08-28 17:25:04,2014-08-26 15:23:22
9927d9627fe01d780e754a02cf9adc36e084c587...02710228dd79d9f9c6fa180233491639b603c06d,1,17,1,18,2,2014-08-28 17:25:14,2014-08-26 15:23:23
02710228dd79d9f9c6fa180233491639b603c06d...b29763aa9bcbb99a59aec3820e30ff1864cfa765,2,8,21,29,8,2014-08-28 17:25:14,2014-08-26 15:23:24
b29763aa9bcbb99a59aec3820e30ff1864cfa765...9035d75a2be9d80d82676504d69553245017f6d4,4,99,12,111,18,2014-08-28 17:25:15,2014-08-26 15:23:25
9035d75a2be9d80d82676504d69553245017f6d4...9079ab7cb6768fa04e086303f90be043b423cca4,1,9,4,13,5,2014-09-22 19:40:55,2014-09-21 10:03:26
6c4ab27f2378ce67940b4496365043119d7ffff2...d3180279322c7450a47decf8833de47f444ca93f,40,60,107,167,105,2014-08-20 16:53:37,2014-08-19 19:09:35
d3180279322c7450a47decf8833de47f444ca93f...483bbd4e4ce8a5c717cd47d732893317a14c965a,5,20,6,26,8,2014-08-20 16:54:58,2014-08-19 19:10:48
483bbd4e4ce8a5c717cd47d732893317a14c965a...41e9bad75e05245859c013dadefc63166b9175c9,1,1,3,4,1,2014-08-20 16:55:41,2014-08-19 19:11:00
41e9bad75e05245859c013dadefc63166b9175c9...1f87293d78a4b2bd9265bac49b14a6f1111918b8,1,8,16,24,2,2014-08-20 16:56:12,2014-08-19 19:11:43
6c4ab27f2378ce67940b4496365043119d7ffff2...1991006cb9c84ec11de8a5ebf9e419f0ac1f00d0,1,4,4,8,2,2014-08-18 17:14:08,2014-08-16 01:19:27
1991006cb9c84ec11de8a5ebf9e419f0ac1f00d0...6fceed3bea59d747c160972c67663e8b8c281229,1,2,0,2,1,2014-08-18 17:14:19,2014-08-16 01:19:28
6c4ab27f2378ce67940b4496365043119d7ffff2...f9dc5d65ca31cb79893e1296efe37727bf58f3f3,1,2,3,5,3,2014-08-18 17:12:16,2014-08-13 17:30:43
f9dc5d65ca31cb79893e1296efe37727bf58f3f3...3918057164a8060082b828c0ac1ce25ad6a86d38,1,5,5,10,6,2014-08-20 19:13:44,2014-08-19 21:27:11
3918057164a8060082b828c0ac1ce25ad6a86d38...ba9b9e124276e5d27ecf0e7701df1dedab6375c8,1,2,2,4,2,2014-09-02 19:26:23,2014-08-30 16:14:24
f8a48affbb8829190fe3aa8a1092d5762fd921b1...7d61547db85df0bb16683ee191805b3646920e00,1,11,7,18,8,2014-10-15 20:44:07,2014-10-11 23:37:35
7d61547db85df0bb16683ee191805b3646920e00...773ee47c2b9c691d9758b2bea6cac10e3f0c4e12,1,39,0,39,1,2014-10-15 20:44:08,2014-10-11 23:37:36
773ee47c2b9c691d9758b2bea6cac10e3f0c4e12...da8a3664b133926435e4de1c1d6a9008dd5b741b,1,11,11,22,8,2014-10-27 18:52:27,2014-10-27 00:13:42
da8a3664b133926435e4de1c1d6a9008dd5b741b...c6c3e0db842c0c3649de27edd28f8a6975bee105,1,0,39,39,1,2014-10-27 18:52:29,2014-10-27 00:13:43
a136f6d8ff290ab486c85cd12d1a9a47d53b432d...fe1b22686f26bed3047294cc4552e50ce58fa954,2,9,5,14,4,2014-10-16 17:10:35,2014-10-15 22:33:13
fe1b22686f26bed3047294cc4552e50ce58fa954...50a71776ab14c63c72c86e3ce1529052bcb2634a,2,5,5,10,3,2014-10-16 17:10:36,2014-10-15 22:34:05
50a71776ab14c63c72c86e3ce1529052bcb2634a...68f492359e29bbdf633201406d0646deee2b298c,1,12,4,16,3,2014-10-16 17:10:36,2014-10-15 22:34:19
68f492359e29bbdf633201406d0646deee2b298c...46be823124bb6a6ff0e06dc19c327b599ed97c72,3,17,6,23,3,2014-10-16 17:10:37,2014-10-15 22:34:34
46be823124bb6a6ff0e06dc19c327b599ed97c72...1da1e07c835e900337714cfad6c32a8dc0b36ac3,1,7,7,14,6,2014-10-16 17:10:37,2014-10-15 22:35:12
40e94ca19adf00caa3d19a199b9b0a6079d12a3a...b659605da66ffd513ae60e767495899507e8dfcb,1,19,0,19,1,2014-09-12 18:05:15,2014-09-11 21:16:36
6f5ef44e0d8933621fcd50127518557013002313...31a8aa1ee84f4fba7597b0fa2e99f94596c079bb,1,1,1,2,1,2014-11-17 16:57:07,2014-11-15 13:27:21
6f5ef44e0d8933621fcd50127518557013002313...b9459019bbb7b864cf59fa307953834996ab4dbe,2,56,1,57,3,2014-10-24 17:50:05,2014-10-22 14:57:49
745224e04a03e4544c58d5d38d3c54f67100f8eb...6d17dc1dd3909a9e8a5a915a6ff15d4c64c58290,1,2,1,3,2,2014-07-07 18:05:43,2014-07-05 19:00:59
6d17dc1dd3909a9e8a5a915a6ff15d4c64c58290...a8d9fea772ca49c23ca3ee3d7625b9d1ed94f87f,1,11,4,15,2,2014-07-08 19:56:39,2014-07-04 20:24:01
7fe683480124239ec0ab555c9b529e4c54707d7b...b0cdb4dafc8531f16c3e0e0327bc03ca96dad9fe,1,61,61,122,25,2014-07-08 19:40:37,2014-06-29 06:34:22
b0cdb4dafc8531f16c3e0e0327bc03ca96dad9fe...343151dcbdf63a4f12b1a0108708280dc3883af6,1,265,0,265,1,2014-07-08 19:40:40,2014-06-29 06:34:54
7fe683480124239ec0ab555c9b529e4c54707d7b...6d49de414f9dc7a94503a3798dd745971669cebe,1,3,3,6,2,2014-06-30 21:07:48,2014-06-28 22:04:45
6d49de414f9dc7a94503a3798dd745971669cebe...ba311807f8408761a48d4cd596259ca30a4375f2,2,87,2,89,5,2014-06-30 21:07:58,2014-06-28 22:04:46
7fe683480124239ec0ab555c9b529e4c54707d7b...94c0cc8f72835abe59fdcce34d8401a7c54a2af7,1,1,1,2,1,2014-06-30 20:39:23,2014-06-27 12:11:39
36857e0026f5a7855f941a955bf7014408a816dd...2deda629c2ab7228790fb7561e66515a9bdcf7b6,2,29,10,39,13,2014-06-25 22:28:28,2014-06-24 09:46:31
ebeea528709abf5ee0a0f3e8ad706f7bacc36c05...26c986e118523fda4624cec8d14bb8a4a09fdd08,2,21,6,27,7,2013-07-01 21:23:24,2013-07-01 21:00:32
26c986e118523fda4624cec8d14bb8a4a09fdd08...a73653130edd6a8977106d45a8092c09040f9132,3,40,2,42,7,2013-07-01 21:23:24,2013-06-28 15:05:32
f8abaebab3fe1a1b873f9636ea410ac4007c8fa8...682961c162ce60b25749e02a0c4de44dc7dda917,1,1,2,3,1,2013-08-20 20:00:51,2013-08-20 16:59:02
682961c162ce60b25749e02a0c4de44dc7dda917...1201f0a76cbc006566532577c1cc9123412ecdab,1,2,1,3,2,2013-08-20 20:00:57,2013-08-20 16:59:03
1201f0a76cbc006566532577c1cc9123412ecdab...860ccc605da1d40c0331113eb552151fa925002e,1,1,1,2,1,2013-08-20 20:00:57,2013-08-20 16:59:44
860ccc605da1d40c0331113eb552151fa925002e...af52bd5f58eed99608b4681df91ba0e1beeb81d5,1,2,2,4,1,2013-08-20 20:00:57,2013-08-20 16:59:54
f8abaebab3fe1a1b873f9636ea410ac4007c8fa8...9c5e6c802cde9881785b7f1b3278b97be4aabd82,29,93,85,178,82,2013-07-09 16:12:48,2013-07-09 15:29:00
f8abaebab3fe1a1b873f9636ea410ac4007c8fa8...47a59185369b8905ad3a4012688cba92fd2ac1ff,15,87,70,157,16,2013-07-08 21:34:24,2013-07-08 20:56:53
47a59185369b8905ad3a4012688cba92fd2ac1ff...ab22d2eb83c1810043bfa07dd142594580e093be,1,3,3,6,2,2013-07-09 05:19:15,2013-07-08 21:50:27
ab22d2eb83c1810043bfa07dd142594580e093be...28f5d176110d2ed768a0a49159993c7a02d8cb15,5,168,11,179,10,2013-07-23 05:02:55,2013-07-08 22:34:36
28f5d176110d2ed768a0a49159993c7a02d8cb15...91048a9537a4716c84934e4f8ed114a20606d3ff,6,87,0,87,9,2013-07-23 05:18:19,2013-07-09 18:01:06
91048a9537a4716c84934e4f8ed114a20606d3ff...631b5ef219c41027c144218e25075062b91f9471,6,54,13,67,16,2013-07-23 05:33:21,2013-07-08 21:42:40
631b5ef219c41027c144218e25075062b91f9471...d887cc184d49f5e8982c1db433996fae26fb20c0,1,189,0,189,1,2013-07-23 05:42:12,2013-07-09 19:09:28
d887cc184d49f5e8982c1db433996fae26fb20c0...e69fa70f486f437788feef71f8b83c286ae5e701,1,16,0,16,1,2013-08-01 18:10:36,2013-08-01 18:05:02
e69fa70f486f437788feef71f8b83c286ae5e701...77aa93481d1b12372a70959de58917ff815b3bc6,1,1,1,2,1,2013-08-02 23:07:45,2013-08-02 23:06:29
77aa93481d1b12372a70959de58917ff815b3bc6...05c1eb10348f159908becc7a6ed6bbcdab24c893,4,40,5,45,15,2013-08-02 23:11:06,2013-08-02 22:14:50
6897a64b652d83e477389ec1a248b47b8d821db6...e45bda876ae2e39ac1e11ba1609f2c363ad4959a,1,2,2,4,2,2013-09-05 17:50:49,2013-09-05 15:12:45
d5d0a23dbb5cb2adf5bfe23e7af48a2330b40de9...89b1b47b0acc9012e137f84a92eacdacfde29dea,1,4,0,4,1,2013-09-12 21:42:47,2013-09-12 21:42:47
64a99eb4760de2ce2f0c04e146c0a55c34f50f20...4c5baf0273ae3382dbaca81fee0331cada5899ea,2,29,0,29,5,2013-10-18 19:45:24,2013-10-16 23:11:46
95a7c546b02a962b9e458f7fd2d0ed9b657c0ca6...c48f6816f03bfb2a09067a4fcfb4698a2192f6f9,4,0,21,21,6,2013-07-19 22:22:29,2013-07-18 17:36:51
c0add3073a5bd0e295cdaea76e5c9b7805f8a047...20618016df1255a2adebe900af7d66f88ef7a33b,1,3,0,3,1,2013-06-26 20:55:37,2013-06-26 05:53:59
c0add3073a5bd0e295cdaea76e5c9b7805f8a047...5e62cc14c36fa1d10a057ebe6fd2bba504422573,1,17,3,20,5,2013-06-26 15:51:43,2013-06-25 15:54:36
c0add3073a5bd0e295cdaea76e5c9b7805f8a047...cc2f6b686575e2b7664d22d1266fc55197bc7e81,2,9,3,12,4,2013-06-21 16:05:15,2013-06-21 07:24:32
4d1c565e1fb4e76c391448cdf85fe7c132bbb390...47f534bf92300c2e48c39999bc89e941ebc5d0c8,1,35,21,56,3,2013-06-19 17:23:03,2013-06-19 06:36:26
47f534bf92300c2e48c39999bc89e941ebc5d0c8...2884c06ae78e569a513701c2d43f4ed79bd252ce,1,13,9,22,2,2013-06-19 17:23:03,2013-06-19 06:36:27
2884c06ae78e569a513701c2d43f4ed79bd252ce...fcb7c76274570e74fd9a9ac429095b07c2f34c64,1,24,4,28,3,2013-06-19 17:23:04,2013-06-19 06:36:28
4d1c565e1fb4e76c391448cdf85fe7c132bbb390...9926f66fbd4392c9c7c05fae83e80bc12e0be889,1,2,2,4,2,2013-06-12 20:38:48,2013-06-05 18:31:27
bdff0e3a374617dce784f801b97500d9ba2e4705...0dbd81251dbc516bb3bf07862c369fc582a4e5e0,1,17,0,17,3,2013-06-16 05:12:52,2013-06-16 05:12:52
bdff0e3a374617dce784f801b97500d9ba2e4705...3e3d5fd276d636e24e97e5ee361dc940ee490137,2,13,10,23,8,2013-06-14 18:09:49,2013-06-14 10:19:11
bdff0e3a374617dce784f801b97500d9ba2e4705...6567dc05a34948b959864b12fcd59a35543273f7,2,22,0,22,2,2013-06-14 16:40:30,2013-06-14 13:17:50
6567dc05a34948b959864b12fcd59a35543273f7...bac1ddd0f86bc5955c24f89e402de80d2844efb5,1,12,0,12,1,2013-06-14 16:41:03,2013-06-14 13:17:51
bac1ddd0f86bc5955c24f89e402de80d2844efb5...2e6e276decde2a9f04fc29bce734a49d3ba8f484,3,4,4,8,4,2013-06-14 16:41:18,2013-06-14 13:17:52
bdff0e3a374617dce784f801b97500d9ba2e4705...05d4c7b1c46b7a6cbc8f4c0403a6e208aea1c63c,1,1,1,2,1,2013-06-14 16:02:15,2013-06-14 13:50:09
05d4c7b1c46b7a6cbc8f4c0403a6e208aea1c63c...668eec6f74b69f3a376edb5a32c4d0d2cc127e72,1,1,2,3,2,2013-06-14 16:02:15,2013-06-14 13:50:10
668eec6f74b69f3a376edb5a32c4d0d2cc127e72...6a504a3f45ed2de1922ea486851b49e14eac6108,1,3,3,6,2,2013-06-14 16:02:15,2013-06-14 13:50:11
6a504a3f45ed2de1922ea486851b49e14eac6108...1aff8c627baf7f313820b5e5629266b48a6e4576,1,18,0,18,18,2013-06-14 16:02:16,2013-06-14 13:50:12
1aff8c627baf7f313820b5e5629266b48a6e4576...0afd29e2d353e58cad5b7ad90705e829d5815d45,1,3,3,6,2,2013-06-14 16:02:16,2013-06-14 13:50:13
0afd29e2d353e58cad5b7ad90705e829d5815d45...81f6a7a43d8c0b1310ffc2df6f9e8d607799249c,1,8,6,14,5,2013-06-14 16:02:16,2013-06-14 13:50:14
81f6a7a43d8c0b1310ffc2df6f9e8d607799249c...6c2fbe25fb8883da7925567a582dacda679e29dc,1,2,1,3,1,2013-06-14 16:02:16,2013-06-14 13:50:15
6c2fbe25fb8883da7925567a582dacda679e29dc...eb96b750394a78d9317f0a9224689f1ef50f04ec,1,3,3,6,3,2013-06-14 16:02:16,2013-06-14 13:50:16
eb96b750394a78d9317f0a9224689f1ef50f04ec...1149957368ef29b6a05ad5cf93f6c62352136bcd,1,1,1,2,1,2013-06-14 16:02:16,2013-06-14 13:50:17
1149957368ef29b6a05ad5cf93f6c62352136bcd...857f21a3c12667cc1f5b6ebcfff9aa550217e189,1,3,3,6,3,2013-06-14 16:02:16,2013-06-14 13:50:18
857f21a3c12667cc1f5b6ebcfff9aa550217e189...6b825a46229daffc6f70b37cb7a21193214f508b,1,1,1,2,1,2013-06-14 16:02:16,2013-06-14 13:50:19
6b825a46229daffc6f70b37cb7a21193214f508b...477d4d4235490065a718764fd241d77edd6904cd,1,1,1,2,1,2013-06-14 16:02:16,2013-06-14 13:50:20
477d4d4235490065a718764fd241d77edd6904cd...8a43b36ac225304f31730465c9c8e8ba77695a7d,1,13,13,26,13,2013-06-14 16:02:16,2013-06-14 13:50:21
8a43b36ac225304f31730465c9c8e8ba77695a7d...8f04f7ddd35331821666f7892c86956b6752de90,1,3,3,6,3,2013-06-14 16:02:17,2013-06-14 13:50:22
8f04f7ddd35331821666f7892c86956b6752de90...267055f8609ff3e3134765395569b87269699c0a,1,4,4,8,4,2013-06-14 16:02:17,2013-06-14 13:50:23
267055f8609ff3e3134765395569b87269699c0a...3eb4ee99fb2acad118861a27a2c4dddbf1735d8c,1,0,1,1,1,2013-06-14 16:02:17,2013-06-14 13:50:24
3eb4ee99fb2acad118861a27a2c4dddbf1735d8c...b835baf65c10c2511a0bb9600b09ac3c7a53e818,1,4,4,8,2,2013-06-14 16:02:17,2013-06-14 13:50:25
b835baf65c10c2511a0bb9600b09ac3c7a53e818...4f1b7883bc9b614f3a91eff7aa46cfdc85156ceb,1,4,1,5,1,2013-06-14 16:02:17,2013-06-14 13:50:26
4f1b7883bc9b614f3a91eff7aa46cfdc85156ceb...ee25ff2c978799519b7705ce1f1d786618ead8d8,1,2,1,3,1,2013-06-14 16:02:17,2013-06-14 13:50:27
ee25ff2c978799519b7705ce1f1d786618ead8d8...42e91929ae4c4eb8c5d74d6d72d9ff31111828d0,1,0,1,1,1,2013-06-14 16:02:17,2013-06-14 13:50:28
42e91929ae4c4eb8c5d74d6d72d9ff31111828d0...6a316beeeecc76d19ff60fda62e00a7e2e041137,1,32,24,56,3,2013-06-14 16:02:17,2013-06-14 13:50:29
6a316beeeecc76d19ff60fda62e00a7e2e041137...86e95ef2d4803c0fd2cac1afdd66c702ee2bafc1,1,119,120,239,97,2013-06-14 16:02:17,2013-06-14 13:50:30
86e95ef2d4803c0fd2cac1afdd66c702ee2bafc1...e83d36b66fc578d8aa965be15037bc1155f163cd,1,95,95,190,65,2013-06-14 16:02:18,2013-06-14 13:50:31
e83d36b66fc578d8aa965be15037bc1155f163cd...b8b4e1b385f058695e7860748d959cb01eecc330,1,6,6,12,6,2013-06-14 16:02:18,2013-06-14 13:50:32
b8b4e1b385f058695e7860748d959cb01eecc330...aeb95eeaff625dc9d5450e180a6e7a7e024efd23,1,10,8,18,9,2013-06-14 16:02:18,2013-06-14 13:50:33
aeb95eeaff625dc9d5450e180a6e7a7e024efd23...fed56c06ae86f671e3319c6d60130ed4802137f1,1,14,6,20,5,2013-06-14 16:02:18,2013-06-14 13:50:34
fed56c06ae86f671e3319c6d60130ed4802137f1...7c475837936cdf92054194e19a990d8563b1a058,1,2,2,4,2,2013-06-14 16:02:18,2013-06-14 13:50:35
7c475837936cdf92054194e19a990d8563b1a058...d49a038451e86a207eee6b8f0fb2a022410900cc,1,4,4,8,4,2013-06-14 16:02:18,2013-06-14 13:50:36
d49a038451e86a207eee6b8f0fb2a022410900cc...b5cda5b3132a56e87caad5d8a541f09733f1ed33,1,28,0,28,1,2013-06-14 16:02:18,2013-06-14 13:50:37
b5cda5b3132a56e87caad5d8a541f09733f1ed33...e3e7d34513a8802ab936bf9047f142c9aa1a6e5a,1,2,0,2,1,2013-06-14 16:02:18,2013-06-14 13:50:38
e3e7d34513a8802ab936bf9047f142c9aa1a6e5a...d8e7c67e13e0687ba01ea53522db2615ea897f96,1,7,3,10,3,2013-06-14 16:02:18,2013-06-14 13:50:39
4b8f772ce4df667583243e434ca0548d5b84b3a6...f445500e4dd79ad0c4f6cf1c4949f01f155142f7,1,3,0,3,1,2013-06-04 20:36:54,2013-06-04 16:50:12
9134a460e3ebfc93790e98d74b3cda2bcca8eb8b...17bf4ff3cd3d7fd4b252b81417df8be1b3b2b128,2,12,16,28,7,2013-05-22 19:46:02,2013-05-22 10:39:54
17bf4ff3cd3d7fd4b252b81417df8be1b3b2b128...305ebea06d5e633e3d648c798b5e6bb2b9abf361,1,10,1,11,2,2013-06-02 19:05:36,2013-05-22 10:39:55
9134a460e3ebfc93790e98d74b3cda2bcca8eb8b...67c9c782dae17822266783f8b5e15d73e7c91c65,1,4,2,6,2,2013-05-21 16:53:59,2013-05-21 01:02:45
67c9c782dae17822266783f8b5e15d73e7c91c65...21457f5719b894a5997d66ff098b375bc2404260,1,5,0,5,1,2013-05-21 16:54:05,2013-05-21 01:32:04
9134a460e3ebfc93790e98d74b3cda2bcca8eb8b...737044517f403c1080886a674845fad9c42d6bc0,1,1,1,2,1,2013-05-21 16:28:45,2013-05-21 00:33:03
737044517f403c1080886a674845fad9c42d6bc0...92c4369907533d942385311cb72d9852a86290d5,1,1,1,2,1,2013-05-21 16:33:21,2013-05-21 03:47:52
92c4369907533d942385311cb72d9852a86290d5...5e49f30c85ecacec98631462fa73f1148a01637c,1,3,3,6,2,2013-05-21 16:33:24,2013-05-21 03:47:53
9134a460e3ebfc93790e98d74b3cda2bcca8eb8b...6912ea952bf5d1b2d21d5935d6b726bab02d8bf6,1,1,1,2,1,2013-05-21 16:24:17,2013-05-20 20:24:34
5dbe064d8cf37142f8c76f73ae0866286a8fb018...c420df7b9bbfcf352a3602c78e8476f18098bb43,1,6,32,38,2,2013-05-20 22:31:10,2013-05-20 09:58:24
c420df7b9bbfcf352a3602c78e8476f18098bb43...1355241bf58b325ec9bedc2768d28dd20355c50e,2,4,4,8,4,2013-05-20 22:31:45,2013-05-20 09:58:25
1355241bf58b325ec9bedc2768d28dd20355c50e...deb9c8ed858e431008695fa265e8b20f547192bc,1,22,13,35,3,2013-05-20 22:31:45,2013-05-20 09:58:26
deb9c8ed858e431008695fa265e8b20f547192bc...03d9bc564b3e87a2cdf4d511c8707a2de54ee6c6,1,12,12,24,2,2013-05-20 22:31:45,2013-05-20 09:58:27
03d9bc564b3e87a2cdf4d511c8707a2de54ee6c6...0a00ee58446e3a74e480057059a877da9c857346,1,8,23,31,3,2013-05-20 22:31:45,2013-05-20 09:58:28
0a00ee58446e3a74e480057059a877da9c857346...9bf1ac41d215f9b1c026fe585a38ffa0555a5670,2,46,0,46,3,2013-05-20 22:31:46,2013-05-20 09:58:29
abd4284bc62127a2db69c8c81501a56bb29284c8...309422e033bc2e25a3a80d1336993a75b7daaf33,1,1,1,2,1,2013-07-25 02:16:13,2013-07-23 22:22:43
309422e033bc2e25a3a80d1336993a75b7daaf33...60838613054f43d63086b0f4a7596baaee9e20c5,2,90,30,120,7,2013-07-25 02:16:51,2013-07-24 02:22:04
a765499a0884375c47c78d0d1e2926e875074427...83f0412f3fff3b4108e7f05c30f3e861d148f5f2,1,1,1,2,1,2013-05-16 18:51:08,2013-05-16 15:32:27
83f0412f3fff3b4108e7f05c30f3e861d148f5f2...c72424b1b5d511a346742dba62bec93a719ef1c8,1,19,0,19,2,2013-05-16 18:51:08,2013-05-16 15:32:28
c72424b1b5d511a346742dba62bec93a719ef1c8...abdea96efdade975246cce0674fa2cfb8a7cc148,1,184,0,184,1,2013-05-16 18:51:08,2013-05-16 15:32:29
abdea96efdade975246cce0674fa2cfb8a7cc148...e16f434ab66993c58690db9b68c9506b344916f7,1,21,9,30,5,2013-05-16 18:51:08,2013-05-16 15:32:30
e16f434ab66993c58690db9b68c9506b344916f7...53e38358c8ad5bef1a71e3dac4331014120165cc,1,19,19,38,13,2013-05-16 18:51:08,2013-05-16 15:32:31
53e38358c8ad5bef1a71e3dac4331014120165cc...617f50cbfded66e2b314fc5ae550bf94854bc55e,1,1,2,3,1,2013-05-16 18:51:08,2013-05-16 15:32:32
617f50cbfded66e2b314fc5ae550bf94854bc55e...e32db66d7a6b2ba1569ef5e316d869c40a8fac3b,1,2,2,4,1,2013-05-16 18:51:09,2013-05-16 15:32:33
e32db66d7a6b2ba1569ef5e316d869c40a8fac3b...d0af663e42abfcd5be6f7c3db21a29e521aa4ca2,5,229,47,276,42,2013-05-16 18:51:09,2013-05-16 15:32:34
d0af663e42abfcd5be6f7c3db21a29e521aa4ca2...d5d2fc8b1a2afdd086b194b2a834e896367d6713,1,23,6,29,5,2013-05-16 18:51:09,2013-05-16 15:32:35
d5d2fc8b1a2afdd086b194b2a834e896367d6713...9c129eab99f16d7bb174b35573e68ae6a5d02efe,3,73,3,76,5,2013-05-16 18:51:09,2013-05-16 15:32:36
9c129eab99f16d7bb174b35573e68ae6a5d02efe...143f1eafdb0d326b1a8e3d15bf59a497b9440bf1,3,47,15,62,13,2013-05-16 18:51:09,2013-05-16 15:32:37
143f1eafdb0d326b1a8e3d15bf59a497b9440bf1...7f34a46ff57121910c9ad697c2809a2d01ed1673,2,18,19,37,12,2013-05-16 18:51:10,2013-05-16 15:32:38
7f34a46ff57121910c9ad697c2809a2d01ed1673...4d826608e9610851d29440ca290e54b701921608,3,164,27,191,27,2013-05-16 18:51:10,2013-05-16 15:32:39
4d826608e9610851d29440ca290e54b701921608...bf3418b08bac89902a5f6c70f8695f148df99828,2,17,9,26,5,2013-05-16 18:51:10,2013-05-16 15:32:40
bf3418b08bac89902a5f6c70f8695f148df99828...141efdba57b1769fc60ff9a3925afbc6af398faf,2,7,7,14,4,2013-05-16 18:51:10,2013-05-16 15:32:41
f74455ab216bdc4f21a733f75ddd6974634c5df1...ab84621754e9c6f05279b42e51b445baac28a8ea,2,9,4,13,3,2013-05-13 18:09:42,2013-05-13 18:09:42
3a461832c5ca4f140e41fdc34f86c90868aea33b...5155c7f37a7422cd14884ee9a7e8e2a79508aea2,1,2,2,4,2,2013-06-30 19:31:26,2013-06-30 10:45:25
5155c7f37a7422cd14884ee9a7e8e2a79508aea2...5a87e92232c5468ff8d9a7139dd02a7969c8bbf6,1,1,1,2,1,2013-06-30 19:34:14,2013-06-30 12:05:28
229177aaea295a3f804f98494d7bcde9c088fc0a...5a517b1c4c94b329aab97b452e5d8e04449f9252,1,3,3,6,3,2013-09-09 18:02:29,2013-09-08 20:58:11
5a517b1c4c94b329aab97b452e5d8e04449f9252...81f339dc3d7f4f1dcec01f8d74be922e882ffc82,1,2,1,3,2,2013-09-09 18:02:52,2013-09-08 20:58:12
81f339dc3d7f4f1dcec01f8d74be922e882ffc82...fef0e991aa51481f047473e79a8f4d61f56dd60f,1,4,2,6,2,2013-09-09 18:03:01,2013-09-08 20:58:13
fef0e991aa51481f047473e79a8f4d61f56dd60f...62d94a3aa6cc0f43f150af1d5549ca5f7b25fe0b,1,34,0,34,1,2013-09-09 18:03:10,2013-09-08 20:58:14
62d94a3aa6cc0f43f150af1d5549ca5f7b25fe0b...1d7358c5245cd7e290146ccf96407dc8a805f314,2,2,3,5,2,2013-09-09 18:03:20,2013-09-08 20:58:15
1d7358c5245cd7e290146ccf96407dc8a805f314...b0f49ff13033621af06af742e3615fe905833562,1,1,0,1,1,2013-09-17 17:18:13,2013-09-14 07:36:24
1afe6e404453586a1095ce0f3f7e899e62ab237f...d6ae7b2d366da8d90aa90cabfd54d285c24b5a86,1,1,1,2,1,2013-05-10 17:11:37,2013-05-10 12:08:29
d6ae7b2d366da8d90aa90cabfd54d285c24b5a86...126aac5cf3b5696481aafe840f8f596653087d8b,3,21,2,23,3,2013-05-10 20:28:31,2013-05-10 12:08:30
1afe6e404453586a1095ce0f3f7e899e62ab237f...752db4254c940bb6ceeb96a265b50830b4cb10b3,1,7,6,13,4,2013-04-27 20:52:03,2013-04-27 19:13:13
752db4254c940bb6ceeb96a265b50830b4cb10b3...85d501ce63d3c3b1331f9e51252c128c95e0adf1,1,9,4,13,4,2013-04-28 22:20:24,2013-04-25 10:59:41
85d501ce63d3c3b1331f9e51252c128c95e0adf1...709a957d9493cbdd457d02bfada067c9b3ccc253,4,2,5,7,3,2013-04-28 22:22:53,2013-04-26 23:30:40
fa7285dc3dce8bd01fd8c665b032603ed55348e5...21246dbb9e0af278bc671e32e45a6cae4ad38b6f,2,24,0,24,3,2013-04-11 16:54:25,2013-04-11 13:06:52
fa7285dc3dce8bd01fd8c665b032603ed55348e5...079b546a2940a84989893254a318c8414e13a13e,4,40,28,68,10,2013-04-10 19:58:33,2013-04-10 19:03:23
079b546a2940a84989893254a318c8414e13a13e...1918225d2fce49c830b41b8c7907229638ae2825,2,46,12,58,13,2013-04-10 20:27:26,2013-04-10 19:03:24
fa7285dc3dce8bd01fd8c665b032603ed55348e5...c138af56da491151be8991ecc0b4e8ae34f4407c,1,999,805,1804,777,2013-04-10 07:19:54,2013-04-10 07:19:54
803a777942b0b1c91890c2f97d4f10972cf2881e...862ae6cd67ff79c0ec6629e78ea4cb24a1ae3db1,1,11,6,17,3,2013-04-01 14:37:34,2013-04-01 13:06:27
e6363a4992637267ef212d7c709ede17d4122e0d...80659ff47bb0268af18925478053a82842a264a5,1,0,3,3,1,2013-03-07 19:38:33,2013-03-07 01:23:43
e6363a4992637267ef212d7c709ede17d4122e0d...e895cb5135d7fbff8037ce83302aff12ee83667c,2,14,6,20,6,2013-03-05 21:39:45,2013-03-05 19:42:20
e895cb5135d7fbff8037ce83302aff12ee83667c...4c4b27e8cefdd88d76590c5fd786d1d43fb6f898,2,19,6,25,9,2013-03-05 21:39:46,2013-03-04 18:16:42
4c4b27e8cefdd88d76590c5fd786d1d43fb6f898...557899ff6b4093ebffba71e916f7241b36b59068,1,1,2,3,1,2013-03-05 21:39:46,2013-03-05 19:56:03
557899ff6b4093ebffba71e916f7241b36b59068...c2aba155da10b8bc9f867d2f0ac0e63cc8dae1a4,7,186,2,188,9,2013-03-05 21:39:46,2013-03-04 20:09:50
e6363a4992637267ef212d7c709ede17d4122e0d...e8e92e05ab3b9cda6ae3d5ddf1a83834dca7857b,1,1,1,2,1,2013-03-05 20:49:59,2013-03-05 20:44:42
e6363a4992637267ef212d7c709ede17d4122e0d...703e8e65c8e3781642ae609117818c42496adf24,1,0,3,3,1,2013-03-04 23:01:11,2013-03-04 22:36:33
e6363a4992637267ef212d7c709ede17d4122e0d...75bf5e60e8c09075af1e4cd0d68a6d73fdf92c42,2,20,14,34,11,2013-03-04 03:46:54,2013-03-02 19:44:59
c8686e510fa56d3e8349ec3ca83215a107d47d45...8dc84fdc48a79c70682e6c361a82d0f3e1db9a03,2,2,2,4,2,2013-07-31 22:20:07,2013-07-31 20:23:31
d5d09d475440c24016ec52a0bcc8477d9a7b5c71...16e57aec7f672fabe38fa0e4d39252eb9c7a1563,1,22,16,38,5,2013-10-23 23:25:20,2013-10-23 23:10:25
16e57aec7f672fabe38fa0e4d39252eb9c7a1563...d96855ff517560650c62eca51a8bb78263f6a3ef,3,173,2,175,10,2013-10-29 20:06:08,2013-10-23 23:47:32
d5d09d475440c24016ec52a0bcc8477d9a7b5c71...b7df098c6db078f60ac8f8e07ac0c5e320b7a86c,2,3,3,6,3,2013-08-05 18:32:19,2013-08-03 11:51:20
b7df098c6db078f60ac8f8e07ac0c5e320b7a86c...f90220755064c74e1e98d49814cb93a4ce0d0ca1,1,5,7,12,3,2013-08-05 18:32:19,2013-08-03 11:51:21
f90220755064c74e1e98d49814cb93a4ce0d0ca1...05efb7b7575dd60a5997a0f7616d0cc222c5dbf8,3,4,3,7,3,2013-08-07 15:30:30,2013-08-07 07:32:25
05efb7b7575dd60a5997a0f7616d0cc222c5dbf8...c83e8c1768b1dbce98a3161aec175a42858d4795,1,1,1,2,1,2013-08-07 15:30:55,2013-08-03 11:51:23
c83e8c1768b1dbce98a3161aec175a42858d4795...21e047dcadaffc09cfc958e9014e84bf2237bfe8,1,3,3,6,1,2013-08-07 15:36:58,2013-08-03 11:51:24
21e047dcadaffc09cfc958e9014e84bf2237bfe8...5d4d1440ba992fe27b00f8a56862543bb27561e2,1,1,1,2,1,2013-08-07 15:37:02,2013-08-03 11:51:25
5d4d1440ba992fe27b00f8a56862543bb27561e2...84d83f642a680f72f8e81313d605e61bf9efa38f,1,15,47,62,9,2013-08-07 15:37:12,2013-08-03 11:51:26
31fe4057b17847a15d1fbe9f1a5521c942fa8ade...68889b416d5b6a5cf7d280a428281d635fe9b292,1,13,15,28,3,2013-07-22 17:43:20,2013-07-21 12:49:26
68889b416d5b6a5cf7d280a428281d635fe9b292...49c639139cdcae2a50d19bfea227a9f24812e84d,1,64,40,104,12,2013-07-22 17:43:21,2013-07-21 12:49:27
31fe4057b17847a15d1fbe9f1a5521c942fa8ade...efe6de6e4018f5d23bab68053bfd297e7f398425,3,4,4,8,3,2013-07-22 17:11:18,2013-07-22 08:02:17
efe6de6e4018f5d23bab68053bfd297e7f398425...117eea7eaaeb5ecb77d9b7cebdb40b4e85f37374,2,3,2,5,3,2013-07-22 18:21:34,2013-07-22 18:21:34
4efd16543fe1c0871742dbd33d6adc2acfd11c3c...81a199bb1cd483321962a7bfe5db33980bbf0f01,1,15,0,15,2,2013-07-03 22:43:41,2013-07-03 22:43:41
4838c81fabc2bab7ff5cd95135060d9a580ad742...bc341c8b61f7f55920798f809a296f3e4dd84e39,1,3,1,4,1,2013-09-05 19:25:19,2013-09-05 03:40:38
bc341c8b61f7f55920798f809a296f3e4dd84e39...625c3304e200f9bdc05626be1397311faa4962ba,2,1,14,15,2,2013-09-05 19:25:22,2013-09-05 03:40:39
4838c81fabc2bab7ff5cd95135060d9a580ad742...11502468287fdd62a22c43766881d21ab4fcf31c,2,86,47,133,4,2013-07-30 20:52:53,2013-07-30 19:49:25
11502468287fdd62a22c43766881d21ab4fcf31c...a88c915de9886fe17005a5daff4900ced0ea76ad,5,73,5,78,11,2013-07-30 20:52:53,2013-07-30 19:50:03
a88c915de9886fe17005a5daff4900ced0ea76ad...5fee995244e13fd59500425d49038b00499396f8,2,53,0,53,4,2013-07-30 21:39:56,2013-07-30 19:50:34
5fee995244e13fd59500425d49038b00499396f8...0656781fadca17cc51fb1c30f265c251ebe12819,5,121,1,122,10,2013-08-06 21:10:35,2013-08-06 19:15:11
0656781fadca17cc51fb1c30f265c251ebe12819...95c16418f0375e2fc325f32c3d7578fba9cfd7ef,7,154,25,179,26,2013-08-06 21:11:00,2013-08-06 19:15:25
950b5680bdacd3eaa4a528f4dc2d5652f1beb88d...d272c8497c2a38ecc9608f8580f7dc3587168168,1,1,1,2,1,2013-02-10 19:40:52,2013-02-10 01:21:25
823ab40fd4adc5bf5b5c66b6d189deae34d2a138...6af95e8cbe431480e4504e7848c66c523beda2a4,1,7,1,8,1,2013-01-06 19:29:31,2013-01-06 14:07:43
01449e314f383861f053786129120abdbeac3198...72f7507710b548f62ff8ac6a4e666fe5c004fbd2,1,2,2,4,2,2013-04-29 16:57:44,2013-04-29 12:49:40
72f7507710b548f62ff8ac6a4e666fe5c004fbd2...7e6a0cc47da79dd22c0338aee8750fda92ced5d9,1,5,0,5,2,2013-04-29 16:57:47,2013-04-29 12:49:41
fea16b47b603e7e4fa7fca198bd49229c0e5da3d...926eb7ba4c52fbfee9fba86c16bb6c374857190e,1,9,0,9,1,2013-03-05 16:54:03,2013-03-05 08:43:55
fea16b47b603e7e4fa7fca198bd49229c0e5da3d...c6929ff239e2bd94fc52f6a3c4db3d5c5c5b0e8d,1,12,0,12,1,2013-02-04 02:59:34,2013-02-02 19:43:25
ca462804c68b5ac0936242d4938fc9273b00180d...01e8d327a9d647c1e891920365c5f6b4f595d5e9,1,1,1,2,1,2013-10-30 19:19:57,2013-10-26 18:48:46
ca462804c68b5ac0936242d4938fc9273b00180d...b2476a60bd92d89d85f16c3b614da54db2ebee1b,1,3,1,4,1,2013-10-28 16:50:34,2013-10-27 11:35:43
ca462804c68b5ac0936242d4938fc9273b00180d...3fc0dca9ceb653798377591018c81324f4d84032,1,1,1,2,2,2013-10-28 16:07:01,2013-10-26 22:34:30
3fc0dca9ceb653798377591018c81324f4d84032...3fa366668a2cfee9abfa62701b5176acb316f169,1,1,1,2,1,2013-10-28 16:18:25,2013-10-27 09:56:33
ca462804c68b5ac0936242d4938fc9273b00180d...746593bdcaf86827e016c97e091442d6a227de0f,2,0,15,15,2,2013-10-28 15:55:56,2013-10-26 17:03:01
746593bdcaf86827e016c97e091442d6a227de0f...84471a12130a40a050ce502c49f1faba97651add,2,0,6,6,2,2013-10-28 15:56:06,2013-10-26 17:03:02
6ff8d4e7487c0f48e568b7fd95fa02515a426c1a...fbd3f0e53ca9b88709ceadea48d9383c7ffa9382,1,5,5,10,2,2013-04-25 22:34:37,2013-04-25 11:25:37
6ff8d4e7487c0f48e568b7fd95fa02515a426c1a...c4458ecdc565fb63cc3247bd1e2d7525d9d6d2fa,2,9,4,13,7,2013-04-07 07:40:23,2013-04-06 17:04:31
c4458ecdc565fb63cc3247bd1e2d7525d9d6d2fa...9e7673ed7ff656738fdc02d1c529d363aaa98002,1,2,2,4,1,2013-04-07 07:40:48,2013-04-06 18:13:41
4df13f69e9facbd09a2b06478e8c40082cda7ce6...b793acf14ce99a02f04de579233e104d2bc5515e,1,1,1,2,2,2013-04-16 17:13:46,2013-04-16 00:30:38
7a011aac0ef32e1b4835284c3ca6360729d7b83b...4a9a4f0ec1daaccb88cdf507375ca64696dfe167,3,21,2,23,4,2013-04-26 19:59:36,2013-04-26 18:30:08
1468a5839309033feb2e58943babdd48b8e2d151...4bd52d0956f5ba2a922968057cabd77a98f6da5c,1,24,0,24,2,2013-05-10 17:23:51,2013-05-10 15:10:10
4bd52d0956f5ba2a922968057cabd77a98f6da5c...6c374008b1a4e3b66469168aace47003e9771e2d,4,19,3,22,7,2013-05-10 17:24:17,2013-05-10 15:10:11
6c374008b1a4e3b66469168aace47003e9771e2d...083b99310978c6768d8e954c9bab1d3692a515a1,2,25,6,31,6,2013-05-10 17:25:43,2013-05-10 15:10:12
083b99310978c6768d8e954c9bab1d3692a515a1...3ac21617b0f56dd76be3bbaa663bf0fff7f3095d,2,13,25,38,9,2013-05-10 17:27:16,2013-05-10 15:10:13
3ac21617b0f56dd76be3bbaa663bf0fff7f3095d...97f6a9c975bb14688b60a5134069159b4cae1a07,1,31,0,31,1,2013-05-10 17:27:28,2013-05-10 15:10:14
97f6a9c975bb14688b60a5134069159b4cae1a07...335ec3bf411ae6606b58885deb281192c86651c6,5,102,16,118,11,2013-05-10 17:27:31,2013-05-10 15:10:15
335ec3bf411ae6606b58885deb281192c86651c6...afa15f3cd8f4cbf9572138329be374ff8566b10a,4,29,16,45,13,2013-05-10 17:27:34,2013-05-10 15:10:16
1468a5839309033feb2e58943babdd48b8e2d151...5a10d236583f4a674e8fd969c877844c0a9ccb17,5,16,7,23,11,2013-04-18 23:28:27,2013-04-18 23:08:40
5a10d236583f4a674e8fd969c877844c0a9ccb17...0940a76db621e87fe7bf569e7e2e7d703d4be592,1,7,6,13,6,2013-04-18 23:28:27,2013-04-18 23:08:41
0940a76db621e87fe7bf569e7e2e7d703d4be592...d2ea4afb03d0f44284b73bbca7fd4d98168b0230,1,12,6,18,6,2013-04-18 23:28:27,2013-04-18 23:08:42
d2ea4afb03d0f44284b73bbca7fd4d98168b0230...9d3f002f21f78576f3c31ae94ce78de54e305c95,4,39,38,77,16,2013-04-18 23:28:27,2013-04-18 23:08:43
9d3f002f21f78576f3c31ae94ce78de54e305c95...4247fe79567fed2c9f896e2cc20246d71d8a33a2,1,14,14,28,2,2013-04-18 23:28:27,2013-04-18 23:08:44
4247fe79567fed2c9f896e2cc20246d71d8a33a2...2bc1e7ecba1fcd73112d5e6703bdc28fb4da530a,2,15,6,21,4,2013-04-18 23:28:28,2013-04-18 23:08:45
2bc1e7ecba1fcd73112d5e6703bdc28fb4da530a...b782bbab94e3618aea352907caa77321b487b918,3,24,7,31,8,2013-04-18 23:28:28,2013-04-18 23:08:46
b782bbab94e3618aea352907caa77321b487b918...7e77df39bf20f04b266f394a64c2fca54c1e5db0,2,28,8,36,10,2013-04-18 23:28:28,2013-04-18 23:08:47
7e77df39bf20f04b266f394a64c2fca54c1e5db0...fcabc2d91cd5f2c9b92e461907d0155265ec0633,1,39,32,71,2,2013-04-18 23:28:28,2013-04-18 23:08:48
fcabc2d91cd5f2c9b92e461907d0155265ec0633...a95f067e3fc2b7c50c69680ac10bef528b160446,2,25,4,29,9,2013-04-18 23:28:28,2013-04-18 23:08:49
a95f067e3fc2b7c50c69680ac10bef528b160446...a57523428b4c08795e793356e12afc3de812f84a,3,246,1,247,9,2013-04-18 23:28:29,2013-04-18 23:08:50
a57523428b4c08795e793356e12afc3de812f84a...a7f01c6b4ddf9f2f6bdcb23fc7afb56695807cba,5,140,5,145,10,2013-04-18 23:28:29,2013-04-18 23:08:51
a7f01c6b4ddf9f2f6bdcb23fc7afb56695807cba...1640632b4f3f69775f04e9e40dfd2fd912e0f458,5,54,2,56,7,2013-04-18 23:28:29,2013-04-18 23:08:52
845241d5446c6c4be70fcaa9f7b605e7c6760181...dfb44106cdad20d4cf251b31cff154525a291326,1,1,3,4,1,2013-04-22 01:53:59,2013-04-21 08:17:05
845241d5446c6c4be70fcaa9f7b605e7c6760181...24b6132e571bf2e27536d42022f8c0733034d880,1,1,1,2,1,2013-04-22 01:01:37,2013-04-21 22:00:16
845241d5446c6c4be70fcaa9f7b605e7c6760181...be6f72245232c9b3ccc19d3d233cf16b09ce0bff,1,0,4,4,1,2013-04-21 19:25:09,2013-04-21 08:50:46
be6f72245232c9b3ccc19d3d233cf16b09ce0bff...3a4dc48623793aad5770f0360eca8eb83f943657,1,4,2,6,2,2013-04-22 06:10:09,2013-04-22 05:30:26
3a4dc48623793aad5770f0360eca8eb83f943657...a682187e190598514fcbd092acace251e9fd633e,1,7,7,14,2,2013-04-22 06:10:20,2013-04-22 05:30:27
a682187e190598514fcbd092acace251e9fd633e...21a40b90e9189aa3f3fbae1ca7a4bad55028ed03,1,9,7,16,2,2013-04-22 06:10:40,2013-04-22 05:30:28
21a40b90e9189aa3f3fbae1ca7a4bad55028ed03...00200e9ea090cbf68c33e8d00c2976ee49972fdd,1,2,2,4,1,2013-04-22 06:10:51,2013-04-22 05:30:29
00200e9ea090cbf68c33e8d00c2976ee49972fdd...46b2a46dd90f60b99faba8ee7c49c88cb58e0d8a,1,17,2,19,2,2013-04-22 06:11:02,2013-04-22 05:30:30
46b2a46dd90f60b99faba8ee7c49c88cb58e0d8a...e495afcd74ae703db9b396cd46ffc0da368e3905,1,1,1,2,1,2013-04-22 15:00:47,2013-04-22 07:20:44
e495afcd74ae703db9b396cd46ffc0da368e3905...0942d519ada52c9cf831ecd3c562539be939d19e,1,1,3,4,1,2013-04-22 15:00:54,2013-04-22 05:30:31
de5abe9fe91a496d019d62abefe23df9d72fad30...30e77bcb5008d1947c721fb084e21eeaa591c45e,1,2,11,13,3,2013-04-25 22:02:51,2013-04-25 19:40:25
30e77bcb5008d1947c721fb084e21eeaa591c45e...97a17e7721dd026dbc4213608d4c61a9351ae527,1,3,4,7,3,2013-04-25 22:02:53,2013-04-25 19:41:57
97a17e7721dd026dbc4213608d4c61a9351ae527...a0511b3934287d0dbffdb28ff6f00a220f794e06,1,9,20,29,9,2013-04-25 22:02:54,2013-04-25 19:43:56
76f9bc9f53a7bc72950d8ee88e88bf41903fab74...3e7bb5da9f58a8b0d066d1511ab95b5df2f8c6b1,2,26,1,27,2,2013-04-22 18:32:58,2013-04-22 18:32:58
b1c418e155a86a1a6104c20e5424d847e516c8d7...a45406585b0a42e38e580baf47b0daf631c5e454,1,3,1,4,3,2013-06-10 19:34:03,2013-06-10 05:48:17
a45406585b0a42e38e580baf47b0daf631c5e454...362de916c06521205276acb7f51c99f47db94727,4,22,2,24,4,2013-06-10 19:34:42,2013-06-10 00:16:20
534f0e0996c0a5a0bea5bae8ae088a80a929932b...16445242edd7e90dc564b657043d2a5efca68cb0,1,2,1,3,2,2013-07-02 19:03:34,2013-07-02 06:16:23
16445242edd7e90dc564b657043d2a5efca68cb0...727377ff65f8b38990d4aa13fc6979d9a8cd6756,2,3,1,4,2,2013-07-02 19:03:50,2013-07-02 06:21:48
727377ff65f8b38990d4aa13fc6979d9a8cd6756...099327b55275ddad678c27c7501e1babed078aef,1,6,7,13,7,2013-07-02 19:05:46,2013-07-02 06:24:21
924f6c3d3931ea782b0f9abee7b8012fe8e5e0fb...dbda21fa87c1c5495c2f8ced4c40d7dbfa1cdcc2,2,30,9,39,12,2013-04-15 18:04:44,2013-04-15 02:37:49
cb5c9521f1e41aa536c2cf64d689e647d035bb90...4d06402b1b29259bd475e5473c4478f58e9376a1,1,127,0,127,1,2013-07-21 22:12:30,2013-07-21 10:52:38
4d06402b1b29259bd475e5473c4478f58e9376a1...8e7c4a82ec25ee92bcb81de8bb8c4a27876d6edc,1,32,6,38,7,2013-07-21 22:13:16,2013-07-21 10:52:39
8e7c4a82ec25ee92bcb81de8bb8c4a27876d6edc...ccf6b45aff3f89016cf1a3e39a37e73e72c3e0f6,1,18,1,19,2,2013-07-21 22:13:42,2013-07-21 10:52:40
ccf6b45aff3f89016cf1a3e39a37e73e72c3e0f6...7c6d6ff8f122b10d6214c4f53e3179996dee2f9a,1,18,0,18,2,2013-07-21 22:14:43,2013-07-21 10:52:41
7c6d6ff8f122b10d6214c4f53e3179996dee2f9a...acb01a359bc2fe3f1ddfb1eb9daa60b8c83e5153,1,94,0,94,1,2013-07-21 22:15:20,2013-07-21 10:52:42
a54841e96b78203598dea6b31b9618f40f107e7b...6d2d43dc9d98ffc385066fbb46c587b6426bf0ac,1,1,1,2,1,2013-07-23 17:08:40,2013-07-23 17:08:40
587947750bd73544a6a99811f0ddfd64e1ff1445...2be43516dd23fde3c0096429b9711638a33581dc,1,3,1,4,2,2013-06-17 16:21:52,2013-06-15 13:13:22
2be43516dd23fde3c0096429b9711638a33581dc...aa7e722dfee957e89476d0467427a5a32d0040f7,1,1,1,2,1,2013-06-17 16:21:59,2013-06-15 13:13:23
aa7e722dfee957e89476d0467427a5a32d0040f7...0719f300870cb573dcb526c7ab0cdffc5ee54324,1,1,4,5,1,2013-06-17 16:22:12,2013-06-15 13:13:24
0719f300870cb573dcb526c7ab0cdffc5ee54324...bd514cada4bb1a396a58d408c3ec08526a8be742,3,67,6,73,6,2013-06-17 18:43:13,2013-06-15 13:13:25
bd514cada4bb1a396a58d408c3ec08526a8be742...20351bb06bf4d32ef3d1a6849d01636f6593339f,1,2,5,7,1,2013-06-17 18:43:24,2013-06-15 13:13:26
587947750bd73544a6a99811f0ddfd64e1ff1445...b141f3c9d3220e1e63ca2195df85c392d475baaf,2,23,0,23,2,2013-06-17 15:59:48,2013-06-15 12:43:11
b141f3c9d3220e1e63ca2195df85c392d475baaf...61e0eb9de268cab90ea2563957b4c74c77e82b48,1,17,17,34,17,2013-06-17 15:59:53,2013-06-15 12:43:12
587947750bd73544a6a99811f0ddfd64e1ff1445...dc8ca9123a5b8aa21d8e987875aa2112871f4afa,1,2,0,2,1,2013-06-13 22:29:44,2013-06-13 16:06:11
dc8ca9123a5b8aa21d8e987875aa2112871f4afa...af2f0ebcbdb164043d6ad72c81c6ce5cdadf63b5,2,12,0,12,2,2013-06-13 22:30:02,2013-06-13 16:06:12
af2f0ebcbdb164043d6ad72c81c6ce5cdadf63b5...96e2b99ed56c8433cc4aa03f32d2ef2a22748fc0,2,12,0,12,2,2013-06-13 22:31:06,2013-06-13 16:06:13
85e7e81ccfcec98972e341ab81b0109084b84906...560bb7a7a146fddad3394dc913f1469d477d26a9,2,36,0,36,2,2013-04-15 19:33:58,2013-04-15 19:05:19
560bb7a7a146fddad3394dc913f1469d477d26a9...289ff5598fc4947fe0e6cfeb6db652e64894151c,2,28,3,31,3,2013-04-15 19:33:58,2013-04-15 19:06:30
289ff5598fc4947fe0e6cfeb6db652e64894151c...0104c9e7816e30701e4fdd9143889faacfa0eefa,2,28,7,35,4,2013-04-15 19:33:58,2013-04-15 19:07:16
0104c9e7816e30701e4fdd9143889faacfa0eefa...184d2a8e964d721c20775026308fcf63d57c0b4d,3,26,5,31,5,2013-04-15 19:33:59,2013-04-15 19:08:02
184d2a8e964d721c20775026308fcf63d57c0b4d...c94ab010266776c85b588473260ed048d1e654ff,2,27,4,31,5,2013-04-15 19:33:59,2013-04-15 19:08:42
c94ab010266776c85b588473260ed048d1e654ff...be8a84c526691667fc04a8241d93a3de1de298ab,2,22,0,22,4,2013-04-15 19:33:59,2013-04-15 19:09:25
be8a84c526691667fc04a8241d93a3de1de298ab...5bd8e2d894be3a27e9b32b062ff224cc2396b69c,4,66,11,77,9,2013-04-15 19:34:00,2013-04-15 19:10:05
5bd8e2d894be3a27e9b32b062ff224cc2396b69c...46aa2f95d2fa79164fb0f5ad79bdd1d26fe689ea,1,22,14,36,3,2013-04-15 19:34:00,2013-04-15 19:11:02
46aa2f95d2fa79164fb0f5ad79bdd1d26fe689ea...6cd5c582dcf8e6b960079247ac9d0dbace856458,1,72,72,144,2,2013-04-15 19:34:00,2013-04-15 19:11:37
6cd5c582dcf8e6b960079247ac9d0dbace856458...95c6f27164b58152efcfb5aaf6164030f10d9459,2,46,67,113,12,2013-04-15 19:34:00,2013-04-15 19:12:14
95c6f27164b58152efcfb5aaf6164030f10d9459...b07bc8c8c3c492d657a8bedf04ff939763ea8222,7,16,116,132,29,2013-04-15 19:34:01,2013-04-15 19:12:57
b07bc8c8c3c492d657a8bedf04ff939763ea8222...8aaf8d7728e8ac50cbf6bcad05b6e896d4e69e0b,1,11,27,38,4,2013-04-15 19:34:01,2013-04-15 19:13:35
8aaf8d7728e8ac50cbf6bcad05b6e896d4e69e0b...defd7c7b3717394ee05b454172bf7b1e747af6ae,1,72,74,146,28,2013-04-15 19:34:01,2013-04-15 19:14:22
defd7c7b3717394ee05b454172bf7b1e747af6ae...0aaf62b6e018484bad9cea47dc00644d57b7ad49,5,41,22,63,12,2013-04-15 19:36:42,2013-04-15 19:15:03
85e7e81ccfcec98972e341ab81b0109084b84906...a7f8b8ac945b32d00086c6e3d2fe7b0d00924442,2,25,1,26,2,2013-04-15 16:05:42,2013-04-13 15:22:57
85e7e81ccfcec98972e341ab81b0109084b84906...cd16c59bfa216b7e153f357ccfa89d2a567b8c00,3,19,5,24,6,2013-04-15 16:02:25,2013-04-14 10:57:06
cd16c59bfa216b7e153f357ccfa89d2a567b8c00...b8bd826f3a4196bc80a3c957503b421709b401ab,2,12,1,13,4,2013-04-15 16:03:16,2013-04-14 10:57:07
b8bd826f3a4196bc80a3c957503b421709b401ab...0d957a4df5248b53c4160babdcfa0cefba848c93,4,21,2,23,6,2013-04-15 16:04:43,2013-04-14 10:57:08
85e7e81ccfcec98972e341ab81b0109084b84906...08d595dc1cdf6f0d8e6022a69c4fcdd2fba628cf,5,40,1,41,7,2013-04-15 15:54:45,2013-04-12 23:12:08
ebb9d1968ae2bb4268c030b07dccf0761975af8d...a0d3f1090d90c895b785a6729ed2a2af25335a39,2,51,1,52,2,2013-09-18 19:08:09,2013-09-18 19:08:09
8ed205a380a3ec5e92fb8ae69f5cb20b6cbaa636...8987cda9e1e1c36e5d0a9be6d371697e50773856,1,9,1,10,2,2013-08-29 19:07:24,2013-08-29 18:58:21
8987cda9e1e1c36e5d0a9be6d371697e50773856...597b831afb25303218ac60115ac86dd8879e3ce3,4,22,2,24,6,2013-09-03 18:57:53,2013-09-03 15:45:14
597b831afb25303218ac60115ac86dd8879e3ce3...aa38dc68ea423cddee527b3e2c1d85949783d6b9,1,3,0,3,1,2013-09-03 18:58:12,2013-09-02 07:19:47
aa38dc68ea423cddee527b3e2c1d85949783d6b9...f19f5e60f618481a8ddb329a95a5edeecf218a29,1,0,1,1,1,2013-09-03 18:58:17,2013-09-02 07:19:48
eaaec50fcd705b10f59e1104e22914f844eaf4de...425df881e08bed7a8fcc9a23f452cff792f9ec6c,1,1,1,2,1,2013-08-13 18:10:18,2013-08-13 18:10:18
0bde8c0c1e53e2b2001f4ced58d3e66865758cea...53d00b39ce00073ab6b450488acc3f532a223e8f,7,90,3,93,14,2013-08-01 17:25:48,2013-07-31 20:13:20
53d00b39ce00073ab6b450488acc3f532a223e8f...838f9a15667cfefa9e645c26627ce81ce7599915,2,47,3,50,6,2013-08-05 15:27:00,2013-08-03 10:36:15
0bde8c0c1e53e2b2001f4ced58d3e66865758cea...1114fc023772001bb7053789461c69b0c3c994e3,6,8,8,16,8,2013-07-22 23:06:48,2013-07-22 21:02:23
1114fc023772001bb7053789461c69b0c3c994e3...17b83d71d52a5eb6a621be22daa624414d3ee514,7,7,7,14,7,2013-07-22 23:06:48,2013-07-22 21:02:23
17b83d71d52a5eb6a621be22daa624414d3ee514...749f763dbbe4dbcc4082f02bf98bfc1a09427c6f,9,23,23,46,22,2013-07-22 23:06:49,2013-07-22 21:02:23
b0b3a241e2ca1ba5b928a128b6dcafb990df6e75...63cb8215997fa7bef4319339060869a8c9cee8aa,1,14,0,14,1,2009-12-31 22:46:08,2009-12-30 14:51:22
63cb8215997fa7bef4319339060869a8c9cee8aa...74fbd1182a8300dd0a1d788120813b6d5b9e5cb6,2,6,6,12,4,2009-12-31 22:46:08,2009-12-30 15:03:48
61432146ad707e969664c0151364e2d8da9fb157...5cbf8246d2e68470648d123e356665fca9ffca73,1,15,13,28,8,2011-05-16 23:20:01,2011-05-16 06:46:07
5cbf8246d2e68470648d123e356665fca9ffca73...7ffe853b106680720ddec999e1daf5c186997a1f,2,7,1,8,3,2011-05-16 23:20:01,2011-05-16 06:52:11
7ffe853b106680720ddec999e1daf5c186997a1f...a1a3fd1f40a67165b849a2a1210ff3a7a2cbcdd6,1,2,0,2,1,2011-05-16 23:20:01,2011-05-16 06:52:57
a1a3fd1f40a67165b849a2a1210ff3a7a2cbcdd6...c7730e6f5f5757ac278319f33b94c32458e21f12,1,43,0,43,1,2011-05-18 19:52:00,2011-05-18 08:57:44
cb8ad289c6b3f774e6e4431a08eb585eadbb8dad...17a9ac7d6b5f27eb5f8efee324e88db2b6ec9bd6,1,5,2,7,2,2012-05-24 17:35:40,2012-05-23 17:36:53
a77f106c7837faf6a712ea3ac720f5c4fa2feb07...253b27f1c9a24fd86884a0e202a64f11e162c125,1,4,0,4,1,2013-08-06 18:12:46,2013-08-03 00:27:23
2f1ef15070a8664d3194d164f20283d78571e51c...d0cf51e9401b6486aaecfea5dc3b01c3bb00f271,1,5,1,6,4,2013-07-18 01:19:16,2013-07-15 15:24:17
9a86dd571058a511e60af35206a31017d873e54a...2b07ff3ffa04a3d52bb4aec9df9f8b6378e2f2a7,1,4,4,8,2,2011-09-27 16:34:37,2011-09-27 09:51:00
9a86dd571058a511e60af35206a31017d873e54a...e2895de4d8efef52e835731aaaaa9467e2110e62,2,19,15,34,13,2011-05-24 18:22:44,2011-04-28 19:04:02
e2895de4d8efef52e835731aaaaa9467e2110e62...4dfa207eec44e0d8869c4978cf3d9861aaf40091,1,11,3,14,5,2011-05-24 18:22:44,2011-04-28 19:04:03
4dfa207eec44e0d8869c4978cf3d9861aaf40091...54b1479a770b240d71bbd000fb40e470987bac59,3,162,51,213,3,2011-05-24 18:22:44,2011-04-28 19:04:04
54b1479a770b240d71bbd000fb40e470987bac59...fcce886bfb4671c4c17a3f99cb7caf0f7ab94e16,2,115,0,115,2,2011-05-24 18:22:44,2011-04-28 19:04:05
fcce886bfb4671c4c17a3f99cb7caf0f7ab94e16...1cae3ee70dd9e389a83c494fbc95aa63c01128a1,1,51,0,51,1,2011-05-24 18:22:45,2011-04-28 19:04:06
1cae3ee70dd9e389a83c494fbc95aa63c01128a1...256b7b4883231ae9c7f24f2cb4170f61e00704e1,1,22,23,45,9,2011-05-24 18:22:45,2011-04-28 19:04:07
256b7b4883231ae9c7f24f2cb4170f61e00704e1...ce71b07632c71c2e6f4732abd3db6d59fb1bb924,1,3,5,8,4,2011-05-24 18:22:45,2011-04-28 19:04:08
ce71b07632c71c2e6f4732abd3db6d59fb1bb924...291e52bd19877dc8fdd77079ba4c4326f114c461,4,84,3,87,6,2011-05-24 18:22:45,2011-04-28 19:04:09
291e52bd19877dc8fdd77079ba4c4326f114c461...2ae8da2552f43802476676bb86b037e9028b7a7c,4,345,16,361,14,2011-05-24 18:22:45,2011-04-28 19:04:10
2ae8da2552f43802476676bb86b037e9028b7a7c...2e987f92408f5ddd20246d7d9553b57d90767d54,1,31,8,39,4,2011-05-24 18:22:45,2011-04-28 19:04:11
34d87985d5bfd5df5fae1a3fd38fea5a65be6310...505a138cbd5c45d890d180383c8bd808ee8105aa,1,13,27,40,6,2011-05-04 23:02:17,2011-05-04 23:02:17
fe61935007b6803ce116e233316e4ff51de02be6...3891f390eafa4bec95088f16f8f481553c535b78,1,2,2,4,2,2007-11-08 00:19:07,2007-11-07 22:20:22
3891f390eafa4bec95088f16f8f481553c535b78...b5786c828304c7dcf42742729374d04f30ac1a09,1,1,1,2,1,2007-11-08 00:45:31,2007-11-06 13:48:07
b5786c828304c7dcf42742729374d04f30ac1a09...15a2f530111f32d66eb0c25527e540b5e09804ad,1,107,92,199,33,2007-11-08 00:45:31,2007-11-06 13:48:34
15a2f530111f32d66eb0c25527e540b5e09804ad...e7509ee388480046a685f885431291f484de66de,1,5,3,8,5,2007-11-08 00:45:31,2007-11-06 13:49:30
e7509ee388480046a685f885431291f484de66de...fc8b5f0307d5477cb4a52d3b54ff098f8ea34c8e,3,9,0,9,3,2007-11-08 01:12:53,2007-11-08 00:41:22
fc8b5f0307d5477cb4a52d3b54ff098f8ea34c8e...3c307bfbe8f8f9223c9b3cef8fdf2fabd05cda6d,1,3,3,6,3,2007-11-08 01:21:41,2007-11-06 20:12:45
3c307bfbe8f8f9223c9b3cef8fdf2fabd05cda6d...620bb245b945531bb6e08016d5f28caf9e797786,2,4,4,8,4,2007-11-08 01:23:04,2007-11-07 07:34:12
620bb245b945531bb6e08016d5f28caf9e797786...e1f14cce694602ca879bea03d143add1c18dff52,1,6,7,13,3,2007-11-08 01:25:47,2007-11-03 13:08:05
fe61935007b6803ce116e233316e4ff51de02be6...521b53e5c7ee23a137e903d99108f81d44cca5ec,2,15,6,21,7,2007-11-06 08:18:39,2007-11-04 09:37:20
fe61935007b6803ce116e233316e4ff51de02be6...21d4783538662143ef52ed6967c948ab27586232,2,200,2,202,6,2007-11-06 06:48:13,2007-11-04 10:30:53
21d4783538662143ef52ed6967c948ab27586232...bac199b7b17cd12286a7d5393f4789574c2e1dc4,1,30,18,48,2,2007-11-06 06:48:13,2007-11-04 10:30:54
bac199b7b17cd12286a7d5393f4789574c2e1dc4...27c0d1c7f51dd0b31c8a6283df7a23bdb7de8957,1,21,18,39,6,2007-11-06 06:48:13,2007-11-04 10:30:55
27c0d1c7f51dd0b31c8a6283df7a23bdb7de8957...943625998b43ae7b7a4faf840951f0cefb28dc33,1,56,45,101,15,2007-11-06 06:48:13,2007-11-04 10:30:56
943625998b43ae7b7a4faf840951f0cefb28dc33...78443d90491c1b82afdffc3d5d2ab8c1a58928b5,1,49,45,94,5,2007-11-06 06:48:13,2007-11-04 10:30:57
78443d90491c1b82afdffc3d5d2ab8c1a58928b5...b0bf1d8b7952d6119b0737b80873c987fdc75e55,1,54,72,126,7,2007-11-06 06:48:13,2007-11-04 10:30:58
b0bf1d8b7952d6119b0737b80873c987fdc75e55...c2db2e0ef1df6ea2d0aeca1df347c7143a1a2e1c,1,30,44,74,6,2007-11-06 06:48:13,2007-11-04 10:30:59
c2db2e0ef1df6ea2d0aeca1df347c7143a1a2e1c...00df3bed2bf77ad31094e6d064d2c4f069086b41,1,49,50,99,14,2007-11-06 06:48:13,2007-11-04 10:31:00
00df3bed2bf77ad31094e6d064d2c4f069086b41...e01fbf1a8f185bf6722e828286862a4122269ef7,1,16,23,39,8,2007-11-06 06:48:13,2007-11-04 10:31:01
e01fbf1a8f185bf6722e828286862a4122269ef7...5715d0bb60dd90b03519cc436310f3cabe5b9b2a,1,19,5,24,2,2007-11-06 06:48:13,2007-11-04 10:31:02
5715d0bb60dd90b03519cc436310f3cabe5b9b2a...8f321a39257a06db014a3b6ae5dce839821cdb16,11,11,0,11,11,2007-11-06 09:50:02,2007-11-06 09:50:02
8f321a39257a06db014a3b6ae5dce839821cdb16...5410a02ab9e6a1987147724f8ea65e6a077b3832,2,3,3,6,3,2007-11-06 20:23:14,2007-11-06 20:23:14
5410a02ab9e6a1987147724f8ea65e6a077b3832...dfdd7e6686833ab3c0d9af412809a5455b9573de,1,1,1,2,1,2007-11-06 21:07:48,2007-11-06 20:33:58
dfdd7e6686833ab3c0d9af412809a5455b9573de...cbea86fd149f5d4aabdff06f87bc766d414b160e,1,6,5,11,1,2007-11-08 07:10:10,2007-11-08 07:04:38
cbea86fd149f5d4aabdff06f87bc766d414b160e...e817e3e8579742312534f20c0946cd3c562cfa7c,2,9,6,15,3,2007-11-08 09:49:01,2007-11-08 09:32:11
e817e3e8579742312534f20c0946cd3c562cfa7c...66006c63e7c2470e7365a06ea85a03489769cf62,1,1,1,2,1,2007-11-09 07:11:10,2007-11-09 07:04:31
66006c63e7c2470e7365a06ea85a03489769cf62...9e384b4589cfba8fa057e0e124cdd4f6cc92fc66,1,1,1,2,2,2007-11-13 02:34:19,2007-11-12 12:07:40
fe61935007b6803ce116e233316e4ff51de02be6...59f0f2f33a420e9a14bb8cef20d38f508f0d098e,3,13,8,21,3,2007-11-06 06:47:57,2007-11-03 11:23:11
59f0f2f33a420e9a14bb8cef20d38f508f0d098e...7d8ae93292e2cd862359f02879a0c954faf8afa8,1,2,5,7,1,2007-11-06 06:47:57,2007-11-03 11:23:12
7d8ae93292e2cd862359f02879a0c954faf8afa8...271bb08735435b859464c22506ba512f003a4191,2,4,1,5,2,2007-11-06 06:47:57,2007-11-03 11:23:13
271bb08735435b859464c22506ba512f003a4191...1981820be20538d7a70f86c5ddbe379566fd5ff2,1,1,0,1,1,2007-11-06 06:47:57,2007-11-03 12:22:55
fe61935007b6803ce116e233316e4ff51de02be6...bab8118aff7581364eb5c74472fe7ab4f45f4a12,1,35,3,38,4,2007-11-06 06:47:43,2007-11-04 00:11:14
bab8118aff7581364eb5c74472fe7ab4f45f4a12...4d8b1dc850bafdf2304a525a768fbfc7aa5361ae,1,16,0,16,1,2007-11-06 06:47:43,2007-11-04 00:11:15
fe61935007b6803ce116e233316e4ff51de02be6...4c324c00501c2da41987498f8c966b022306b244,2,151,114,265,18,2007-11-06 06:47:28,2007-11-04 19:46:48
fe61935007b6803ce116e233316e4ff51de02be6...cdf4a751fa728273030651a769f9f45212ff50c9,2,17,20,37,2,2007-11-06 06:47:22,2007-11-03 14:33:01
cdf4a751fa728273030651a769f9f45212ff50c9...620a6cd42ed5ea94684b22714181bf03871733dd,2,39,24,63,14,2007-11-06 06:47:22,2007-11-03 15:21:21
fe61935007b6803ce116e233316e4ff51de02be6...243e0614e0f8783599b20106b50eee56d0a17332,3,35,12,47,6,2007-11-06 06:46:45,2007-11-05 13:15:21
e3d6d56f1c2097f13a427e158638e5e0918e5705...00ae82895e7f30e52ff12edc1076409c7c53d99e,3,14,9,23,5,2007-11-04 04:29:18,2007-11-03 02:39:44
00ae82895e7f30e52ff12edc1076409c7c53d99e...4b7bbdd14c6b926fbb0dbd203ce02e150b308694,1,1,1,2,1,2007-11-04 04:37:30,2007-11-04 02:26:54
4b7bbdd14c6b926fbb0dbd203ce02e150b308694...aa807bc2663d69d6adb1d823231ba4b6d30d4860,1,1,1,2,1,2007-11-04 04:39:12,2007-11-03 18:53:34
aa807bc2663d69d6adb1d823231ba4b6d30d4860...19391c371cec06da6cca45dbe3c212bd479cc48c,2,5,2,7,3,2007-11-04 04:44:13,2007-11-01 14:21:39
19391c371cec06da6cca45dbe3c212bd479cc48c...2e7a9785c27f00a8f7a06edc1d4c9b2f3fa2eeb9,2,25,6,31,9,2007-11-04 04:44:57,2007-11-03 13:12:17
e3d6d56f1c2097f13a427e158638e5e0918e5705...4577370e9bfeca8652880b99b8499f76d18865ba,9,57,33,90,38,2007-11-03 05:40:43,2007-10-30 01:05:40
4577370e9bfeca8652880b99b8499f76d18865ba...18f7c51cf921f7db021e012499456120f3f095a9,4,30,30,60,12,2007-11-03 05:40:44,2007-10-30 01:05:43
18f7c51cf921f7db021e012499456120f3f095a9...96249c04c07f00485a3ed1052ff10b27ab147fc5,5,64,37,101,31,2007-11-03 05:40:44,2007-10-30 02:03:39
e3d6d56f1c2097f13a427e158638e5e0918e5705...165f390250874b32ed8158150fe49d574297c9f9,1,60,54,114,20,2007-11-03 05:36:31,2007-11-03 05:32:48
e3d6d56f1c2097f13a427e158638e5e0918e5705...a9cc857ada7c57069ff00eed8d0addcf55849f39,4,70,5,75,6,2007-11-03 00:58:08,2007-11-02 07:24:27
a9cc857ada7c57069ff00eed8d0addcf55849f39...459fa6d0fe6a45b8b120463b56a68e943e3a8101,3,14,2,16,4,2007-11-03 00:58:09,2007-10-03 01:00:27
459fa6d0fe6a45b8b120463b56a68e943e3a8101...49e703afda0e4e67050fcc8e05b175987c83391c,1,76,0,76,1,2007-11-03 00:58:09,2007-11-03 00:46:55
49e703afda0e4e67050fcc8e05b175987c83391c...81bf96bb2ecb8c869cc365a7fee2c4d2e937a43c,1,91,57,148,46,2007-11-23 19:51:39,2007-11-23 10:37:03
81bf96bb2ecb8c869cc365a7fee2c4d2e937a43c...d5a4164140c52a2d267d90e2413d1fe4a326a386,2,181,18,199,12,2007-11-25 00:47:08,2007-11-24 04:14:20
d5a4164140c52a2d267d90e2413d1fe4a326a386...91af7ae54f2a0af453c3a5ac612ed613b38b4fdf,3,38,17,55,7,2007-11-25 00:47:08,2007-11-24 19:57:41
91af7ae54f2a0af453c3a5ac612ed613b38b4fdf...cf1b7869f0c571bbd4f72a4355d9aca558baa0da,10,233,74,307,42,2007-12-06 08:45:30,2007-12-06 08:14:14
d33046c1ed2182a4f73b741e47ab28b1570805c5...ba51795c5fc32a507df9f91ffeae21893e9e7633,1,2,1,3,2,2008-03-08 06:35:34,2008-03-08 06:12:13
85b00455057c19a993eeaee2606af550b8d4de10...7791ecbc62b792b3eaa6d722b6dadcea4d0f322d,4,64,9,73,13,2007-10-27 06:28:28,2007-10-23 20:33:26
7791ecbc62b792b3eaa6d722b6dadcea4d0f322d...6232b3438d127def8cc0612e45422347578c6102,1,123,0,123,1,2007-11-03 00:27:39,2007-11-03 00:25:24
85b00455057c19a993eeaee2606af550b8d4de10...50e62a8e703b78fbe59d5f98b1bb36464570a815,3,88,15,103,21,2007-10-27 06:27:23,2007-10-22 05:47:56
50e62a8e703b78fbe59d5f98b1bb36464570a815...3ac9f612cbbb146743c0734c707e6cb512c43aa4,1,16,0,16,2,2007-10-27 06:27:23,2007-10-22 05:48:11
3ac9f612cbbb146743c0734c707e6cb512c43aa4...8fe26f4481f274a6c752a6c13ac5da0460dbd1b6,1,8,9,17,9,2007-10-27 06:27:23,2007-10-22 05:48:23
8fe26f4481f274a6c752a6c13ac5da0460dbd1b6...97e1c51e15d94f523c67a499ecb633b0e20324cb,2,190,6,196,14,2007-10-27 06:27:23,2007-10-22 05:48:36
97e1c51e15d94f523c67a499ecb633b0e20324cb...55624f9af49733ca6ae4abc3cd21e0f9a4f9f486,1,20,26,46,12,2007-10-27 06:27:24,2007-10-24 05:01:05
55624f9af49733ca6ae4abc3cd21e0f9a4f9f486...737c74ee4219a81ebb616262579f63ce2a3f9698,1,14,33,47,10,2007-10-27 06:27:24,2007-10-24 05:01:13
737c74ee4219a81ebb616262579f63ce2a3f9698...155fc795b9c613af79781ebec5fd8eda084e1636,1,31,51,82,10,2007-10-27 06:27:24,2007-10-24 05:01:21
155fc795b9c613af79781ebec5fd8eda084e1636...c39ce91827e6f8c9e2cbfb482f90fe6f58d4d573,1,17,2,19,2,2007-10-27 06:27:24,2007-10-22 05:49:23
c39ce91827e6f8c9e2cbfb482f90fe6f58d4d573...37f9fd0dde454db08d342e5ce7625e012507bb9b,1,7,0,7,1,2007-10-27 06:27:24,2007-10-22 05:49:39
37f9fd0dde454db08d342e5ce7625e012507bb9b...71b0251cdd2cc35a983e21d4e71285db56d2a519,3,57,4,61,5,2007-10-27 06:27:24,2007-10-26 03:39:37
71b0251cdd2cc35a983e21d4e71285db56d2a519...6ca8b977e4f678050db8fcb0eec2091dd44a2bd0,1,3,3,6,3,2007-10-29 20:13:01,2007-10-29 04:31:52
9f4c4eb0e16d1e21eaaf5cab5591c3491456cd14...4e0da76318c44436286eeeca2b711d82c1098493,1,1,2,3,3,2007-11-18 17:45:20,2007-11-16 18:59:58
fd200790dc518f297bfd538a53e232802904f1de...29cc0ef1ab946bc593dbe3a1e71d7b3efa42e0c4,1,1,1,2,1,2007-11-25 00:46:42,2007-11-24 04:13:41
29cc0ef1ab946bc593dbe3a1e71d7b3efa42e0c4...87194d26d9b4aae6bf6d224cdc1a19c9f4de9acc,2,2,3,5,2,2007-11-25 01:41:18,2007-11-25 01:41:18
2fe167b67a479b19e52b974f9518436565e6793b...501e4c6f23378aca2ce14ba4bc3eebeccb92e8d7,1,20,0,20,2,2007-10-03 04:14:18,2007-10-02 16:24:44
501e4c6f23378aca2ce14ba4bc3eebeccb92e8d7...906ab7f6c03764423adef6c0e4d77442405adc23,1,8,2,10,2,2007-10-03 04:16:04,2007-10-02 16:27:32
f31c14b30b49f76330e6e7c192865e0230dec8c9...a4bee597134aee9883adba1e79be926a92f80367,1,94,94,188,6,2007-09-22 05:32:00,2007-09-21 07:41:51
a4bee597134aee9883adba1e79be926a92f80367...ab08b3630414dfb867825c4a5828438e1c69199d,2,841,3,844,2,2007-09-23 08:57:31,2007-09-22 07:47:43
ab08b3630414dfb867825c4a5828438e1c69199d...fbc8a93cd5b03bf15a3ebef6c0a512d2da3df7c4,1,48,30,78,16,2007-09-23 09:25:13,2007-09-23 09:25:13
fbc8a93cd5b03bf15a3ebef6c0a512d2da3df7c4...354e114d7461c5f7f6bd4e0fb6d880bdd15a7823,1,1,0,1,1,2007-09-24 02:29:24,2007-09-24 02:29:18
354e114d7461c5f7f6bd4e0fb6d880bdd15a7823...40f86af01b061fbbd1e46d125280073322bf9f33,1,1,4,5,1,2007-09-25 01:48:38,2007-09-24 12:26:07
40f86af01b061fbbd1e46d125280073322bf9f33...81d4d3dddc5e96aea45a2623c9b1840491348b92,1,25,5,30,7,2007-09-25 01:48:38,2007-09-24 12:40:44
81d4d3dddc5e96aea45a2623c9b1840491348b92...85f77eadcc1d6e5a62079ab86988ffe95e9421d5,1,26,0,26,1,2007-09-25 01:48:39,2007-09-24 12:50:58
85f77eadcc1d6e5a62079ab86988ffe95e9421d5...cd38c86fd8e8fbbc1d83b80f7d96cf19d8266196,2,113,1,114,3,2007-09-25 03:25:08,2007-09-25 03:24:12
cd38c86fd8e8fbbc1d83b80f7d96cf19d8266196...6f2d73ec0cb6d5937bb4a62a222f942e4f886d6e,1,4,1,5,4,2007-09-26 18:06:08,2007-09-26 18:05:54
6f2d73ec0cb6d5937bb4a62a222f942e4f886d6e...59213f60b7a3085732f76736e1826869994abf1a,1,2,8,10,3,2007-09-26 18:16:45,2007-09-26 18:16:45
59213f60b7a3085732f76736e1826869994abf1a...a7cb8f583ff6ef01c23b1694f30e9004271264f9,1,41,22,63,11,2007-09-26 18:59:09,2007-09-26 18:59:09
a7cb8f583ff6ef01c23b1694f30e9004271264f9...96225dbe966fdbf00ef1a3a1dd801534953c9919,9,47,19,66,15,2007-09-26 19:31:42,2007-09-26 19:31:42
96225dbe966fdbf00ef1a3a1dd801534953c9919...cbf13d9e0c4fc7ac4f2f52f88cff94f1fc311971,1,1,1,2,1,2007-09-28 02:12:49,2007-09-27 12:53:25
cbf13d9e0c4fc7ac4f2f52f88cff94f1fc311971...1bdd8a153528b539fdaed23c18e87a374b1f3ff8,3,6,0,6,3,2007-09-28 02:15:54,2007-09-27 04:18:29
1bdd8a153528b539fdaed23c18e87a374b1f3ff8...72a8e81d457a1ee1283817d03d8e28303c2b4e7e,5,129,21,150,27,2007-09-28 02:17:00,2007-09-27 06:30:51
72a8e81d457a1ee1283817d03d8e28303c2b4e7e...0b2bc460fc69d2aa4f5af743b2b2317088e53949,1,4,3,7,3,2007-09-28 02:17:01,2007-09-27 06:15:29
a892a2ddfefca2e25d595bb685c8853d023fde0a...6908e999468d7eb531a1609cee37673c5d3ca04f,1,2,104,106,4,2011-03-30 18:56:09,2011-03-30 08:11:41
c846e4107876936bed7177a811559bd74a72dcd8...b747e5675db5e26292c942146a25e1c26440c5f7,1,32,22,54,3,2011-06-15 07:13:48,2011-05-27 09:28:46
b747e5675db5e26292c942146a25e1c26440c5f7...fbdd4f6fb477885e4bf81658e02c3542a861c695,3,5,2,7,4,2011-06-15 07:15:22,2011-05-27 09:07:44
e3ed67a3d55aca54bdbdabaa57f73d73a0af0fe6...c5bcbcdcfa1e2a1977497cb3a342c0365c8d78d6,1,1,0,1,1,2011-06-23 15:04:36,2011-06-23 11:33:58
3ac10b2e3fd6d858621f796160d251ad34affc20...c5f1fbe7bc6b29f3343a168461ee70816ddebec2,1,0,12,12,3,2011-06-21 10:02:57,2011-06-20 08:22:47
487e5707852cca03f924ea4dcfbcad1030db58d8...182be0d397cec4ec7f649978653f48c497d43d72,1,7,2,9,6,2013-08-09 21:20:38,2013-08-09 18:18:24
e23ed9a8b4769fcba0944cf121d366ec7db7fe3b...866cae0db4af936ec6f9eb6362e50db2a1a2f792,1,1,2,3,1,2006-11-03 02:02:17,2006-11-03 02:02:17
866cae0db4af936ec6f9eb6362e50db2a1a2f792...44b27ec9604b0310c4d24a283319b933a86da67d,1,2,2,4,2,2006-11-03 02:03:31,2006-11-02 11:12:44
44b27ec9604b0310c4d24a283319b933a86da67d...ba158a32b9e237912ebe7dfe7bd56e2c531cb062,1,1,0,1,1,2006-11-03 02:03:47,2006-11-02 11:11:56
f73da29fa2be2f4bbda86e006b743b8121bdbf19...ab3bb800b46cf66249ead9e13c22cbc48d790c9a,1,5,5,10,2,2006-11-29 06:32:23,2006-11-29 06:29:18
f73da29fa2be2f4bbda86e006b743b8121bdbf19...29561ad0adadf4884858c209bb22b41d8d9a66ba,1,42,5,47,6,2006-11-24 06:52:52,2006-11-24 05:52:18
29561ad0adadf4884858c209bb22b41d8d9a66ba...7182135189d1942d8538a0d0c17fc79f5cb82c71,2,25,13,38,10,2006-11-24 06:53:06,2006-11-23 22:58:35
7182135189d1942d8538a0d0c17fc79f5cb82c71...73bcf53342f16a66ae4e02ed50a08bd34d846bfb,1,49,5,54,3,2006-11-24 10:21:29,2006-11-22 22:26:57
73bcf53342f16a66ae4e02ed50a08bd34d846bfb...30d055aa1e45b4740edc3bfbff77fa5d65e106ff,1,148,8,156,6,2006-11-24 10:23:22,2006-11-24 09:38:04
aa2706463fdeb51d6f9d0e267113b251888cf7f5...710eb3e22cfe5fb84f41a3ef1d3a91b5cf5d3463,1,20,20,40,7,2013-12-04 23:33:20,2013-11-28 19:53:47
710eb3e22cfe5fb84f41a3ef1d3a91b5cf5d3463...2171f3d2aa1412a744545c07b28003a7ff4af5df,1,99,1,100,2,2013-12-04 23:47:50,2013-11-28 19:48:22
2171f3d2aa1412a744545c07b28003a7ff4af5df...d98d109979760bed1909fbf5e56cbb6239980095,1,1,6,7,4,2013-12-09 22:54:47,2013-11-28 19:48:45
d98d109979760bed1909fbf5e56cbb6239980095...cabc3c12e40f5556bb4de934ab783d53e908e401,1,53,27,80,8,2013-12-09 22:54:47,2013-11-28 19:49:01
cabc3c12e40f5556bb4de934ab783d53e908e401...5610b7c0c6957cf0b236b6fac087c1f4dc209376,4,41,3,44,9,2013-12-09 22:54:47,2013-11-28 19:49:17
5610b7c0c6957cf0b236b6fac087c1f4dc209376...854aeb7beb85a7a3f05fc11daea7c8d2fed3a22c,1,59,0,59,1,2013-12-09 22:54:47,2013-11-28 19:49:29
854aeb7beb85a7a3f05fc11daea7c8d2fed3a22c...6a59974869c0a6e9399101bc02223b4c00a8aff2,3,33,17,50,11,2013-12-09 22:54:47,2013-11-28 19:49:38
6a59974869c0a6e9399101bc02223b4c00a8aff2...83b058752707a6ba4af51ebc98c47913bc7d2d25,3,17,49,66,24,2013-12-09 22:54:47,2013-11-28 19:49:54
83b058752707a6ba4af51ebc98c47913bc7d2d25...c59ab2e52a64abd7fded97e0983a9b7f3d0508a0,5,48,37,85,20,2013-12-09 22:54:48,2013-11-28 19:50:03
c59ab2e52a64abd7fded97e0983a9b7f3d0508a0...a2036d7e00ad8aa16ba010a80078e10f0e4568a3,1,50,58,108,10,2013-12-09 22:54:48,2013-11-28 19:50:15
aa2706463fdeb51d6f9d0e267113b251888cf7f5...727b9576eb4a2006c4a9cdbe9e405370abb0dea3,1,1463,1201,2664,1143,2013-11-02 00:08:26,2013-11-02 00:08:26
727b9576eb4a2006c4a9cdbe9e405370abb0dea3...44bb9364e2c468afb9b6b05207201e33da445acd,1,1562,1276,2838,1198,2013-11-02 06:21:55,2013-11-02 06:21:55
44bb9364e2c468afb9b6b05207201e33da445acd...903147923e16d595bd78ec78f6940ba5d82f80e7,1,1508,1270,2778,1162,2013-11-03 06:09:08,2013-09-17 15:37:05
7c20b8234af2962ea4d5ce930ec0308c33f6f654...45c9a7583c68ad5d150f40162dab65800124caf2,1,2,1,3,2,2006-12-28 08:57:11,2006-12-27 22:59:51
45c9a7583c68ad5d150f40162dab65800124caf2...b1f5f64fc831eb9f90bd07dc708279a921410bb2,1,4,0,4,1,2006-12-28 08:57:31,2006-12-27 23:00:52
b1f5f64fc831eb9f90bd07dc708279a921410bb2...f94741324e26af42093a89e955ff9a923abff951,7,30,41,71,31,2006-12-28 09:05:15,2006-12-28 07:34:48
f94741324e26af42093a89e955ff9a923abff951...42ea5a5784a60d1e9280d81619779edd870c2fcc,1,2,1,3,2,2006-12-28 09:05:45,2006-12-28 07:34:52
42ea5a5784a60d1e9280d81619779edd870c2fcc...0bb733c91cb472a1a5b62381ff4037c6fb124e38,1,10,1,11,3,2006-12-28 09:07:32,2006-12-28 07:34:56
0bb733c91cb472a1a5b62381ff4037c6fb124e38...bf699582fd7be26f7809858941fa831380e5bce7,1,1,1,2,1,2006-12-28 09:07:37,2006-12-28 07:35:01
bf699582fd7be26f7809858941fa831380e5bce7...de811948baa689382ad191c1c95e8be51a92c4fe,1,14,2,16,2,2006-12-28 09:07:51,2006-12-28 07:35:05
de811948baa689382ad191c1c95e8be51a92c4fe...6b5a795bf586aa019bbb11ffe9f2fc315ba9765e,1,0,18,18,2,2006-12-28 09:08:06,2006-12-28 07:35:11
7c20b8234af2962ea4d5ce930ec0308c33f6f654...500ebb0196e3b14183171b8c492b3f5f9fa0bf02,1,1,1,2,1,2006-12-28 00:44:30,2006-12-27 21:59:26
7c20b8234af2962ea4d5ce930ec0308c33f6f654...bbfc63dd78037a3f94c3f342384caee1037d09ab,1,16,6,22,8,2006-12-28 00:44:23,2006-12-27 22:17:35
73a2acc0a09829f887fdf2dbcfba217102227932...63460f285ce2330b0a5fc926961c3ca444ed7eb2,1,4,3,7,2,2007-01-31 05:03:11,2007-01-31 05:03:11
63460f285ce2330b0a5fc926961c3ca444ed7eb2...d117452a801af081ebaf2c516e2d715eacf37601,1,3,3,6,1,2007-01-31 21:09:57,2007-01-31 19:10:37
d117452a801af081ebaf2c516e2d715eacf37601...76f8a302c73d7fe26b2034ab4d1dde64de39c8df,1,2,0,2,1,2007-01-31 21:09:58,2007-01-31 07:24:44
76f8a302c73d7fe26b2034ab4d1dde64de39c8df...4a91a1f37e8813bf3b7de00de5b3a7ab1df89451,3,3,3,6,3,2007-01-31 21:09:58,2007-01-30 18:11:49
4a91a1f37e8813bf3b7de00de5b3a7ab1df89451...9ebe6cf953123ce904fe6930991694e3a3c79c17,1,6,2,8,3,2007-01-31 21:14:32,2007-01-31 13:34:17
9ebe6cf953123ce904fe6930991694e3a3c79c17...6e598c326dc4217c387fd797d182dc2ac0a0fc03,1,2,1,3,1,2007-01-31 21:16:52,2007-01-31 16:12:03
6e598c326dc4217c387fd797d182dc2ac0a0fc03...84a978f11870824dae45c7d0fa612a10f64b3fff,1,7,5,12,3,2007-01-31 21:30:54,2007-01-31 21:30:54
84a978f11870824dae45c7d0fa612a10f64b3fff...8933364da105104b77c3a199b6cd4c4bdc30297c,1,3,1,4,1,2007-01-31 21:32:38,2007-01-30 07:56:51
8933364da105104b77c3a199b6cd4c4bdc30297c...1a91ebf917448bcd79d2f9383d898c94ba4953ad,1,8,8,16,3,2007-01-31 22:21:48,2007-01-31 22:21:48
1a91ebf917448bcd79d2f9383d898c94ba4953ad...3c23d66fc30e8805a2b66708acd3f0da921085ba,1,6,0,6,2,2007-01-31 22:25:52,2007-01-31 22:25:52
858cbfbabe4ede5f5eba32041eb7448319e53e2a...9debe63d10e476b96ff550d550df344a68b240e8,2,59,2,61,9,2006-03-01 09:15:31,2006-03-01 02:43:33
858cbfbabe4ede5f5eba32041eb7448319e53e2a...c401cb48e77459a4ccad76888ad31bef252facc5,1,7,2,9,3,2006-03-01 09:15:12,2006-02-28 21:16:01
65416758cd83772f2f3c69f1bd1f501608e64745...e29e1147e485654d90a0ea0fd5fb7151bb194265,1,113,28,141,5,2006-03-01 04:20:04,2006-03-01 04:16:41
f21d6726150ec4219e94ea605f27a4cd58eb3d99...8c31cb822f387d7bc51b51cbacd08d62faed4faa,1,9,4,13,6,2006-03-01 06:34:57,2006-03-01 04:26:25
765ac8ec469f110e88376e4fac05d0ed475bcb28...fd751667a21b8fb9ece9bf7df10ac04e72be13b0,1,20,0,20,1,2006-03-01 11:16:34,2006-03-01 08:12:37
fd751667a21b8fb9ece9bf7df10ac04e72be13b0...7ae0b0cb65f069b657155abcb6aa6780b93ce881,3,72,4,76,6,2006-03-01 11:16:34,2006-03-01 08:58:56
8bc63c9ad43a2d5aa033341c60bdef717f704f65...91a6bf468230d63c414a21adeef94f1242eaaaab,1,34,0,34,4,2006-03-04 07:30:04,2006-03-04 07:30:04
91a6bf468230d63c414a21adeef94f1242eaaaab...ed19f367220a50e4e2a5c1a00b03c14eafcaba89,1,97,0,97,1,2006-03-04 07:29:56,2006-03-04 06:42:09
6169858d19b0ee01a549d83f222c097549968d66...88a8b7955666ed8fa5924fadbb3bb58984eaa6af,1,30,5,35,5,2006-03-17 22:09:10,2006-03-17 21:49:28
88a8b7955666ed8fa5924fadbb3bb58984eaa6af...53dc4636275c966bb0781709fd0dded1cced4458,1,6,0,6,3,2006-03-17 22:09:18,2006-03-17 21:49:31
2d33501689989616a2dc003ca80fafa60b1ed5da...8c3222079a9aca6622c6098a9157e59dddb1cfff,1,1,1,2,1,2006-03-12 19:50:23,2006-03-12 14:00:30
687b8be8bb75b97e917dc744f91890270913041d...dfeff66ed9a3931d60f3cd600ad8c14b5cc3d9e5,2,166,36,202,29,2006-03-20 08:21:10,2006-03-20 08:21:10
36932eab772dc621e79d615fda425ecf87e6d74e...71459c193d04870076efa0a387c317390b53e3e2,1,1,1,2,1,2006-04-26 06:11:17,2006-04-26 06:11:17
36932eab772dc621e79d615fda425ecf87e6d74e...992793c832acfd98107068d90b886643f0344d04,2,23,8,31,9,2006-04-26 00:26:16,2006-04-26 00:26:16
36932eab772dc621e79d615fda425ecf87e6d74e...de791f15a1b01e63f3c870c8497c594c47452fab,2,18,2,20,6,2006-04-25 05:29:33,2006-04-24 22:59:25
de791f15a1b01e63f3c870c8497c594c47452fab...e1cbc46d12a0524fd5e710cbfaf3f178fc3da504,2,5,4,9,4,2006-04-25 05:29:36,2006-04-24 22:59:30
36932eab772dc621e79d615fda425ecf87e6d74e...08abe669c05521499149dbf84fedefb04a8fa34d,3,155,92,247,32,2006-04-25 05:27:33,2006-04-25 03:07:47
61c2bcbd11e3b66a328b3850c01592e5dc1c67bb...6a74642c500118164ec331da93ef29b1163301bc,2,16,7,23,6,2006-04-20 09:51:12,2006-04-20 08:20:56
85e6326cc3e7c272566c60a39741f84391830d49...ccb365047a1081455b767867f0887e7b4334f9d8,1,5,3,8,4,2006-04-19 17:31:23,2006-04-19 17:05:12
ccb365047a1081455b767867f0887e7b4334f9d8...1aec7917dc52901c6df301ddc8fea70f5ce0db09,1,0,2,2,1,2006-04-19 18:09:22,2006-04-19 17:20:49
1aec7917dc52901c6df301ddc8fea70f5ce0db09...ba580aeafb52921025de1efe1c50db34393f9907,2,1,1,2,1,2006-04-19 22:38:14,2006-04-19 22:12:02
24735cfc500feb2a8dba9f140080ab3476363d28...4262c1b0c38613a8c5ae729bd4d3f18f0df3ec44,1,1,0,1,1,2006-04-19 04:08:06,2006-04-19 03:31:41
24735cfc500feb2a8dba9f140080ab3476363d28...3eefc189172b88dece6fb6d479b3ed13cc483dbc,4,89,13,102,23,2006-04-18 23:45:27,2006-04-18 23:45:27
24735cfc500feb2a8dba9f140080ab3476363d28...0032d548db56eac9ea09b4ba05843365f6325b85,1,1,1,2,1,2006-04-18 21:39:28,2006-04-18 13:11:06
02376287ffd8b37ea7622fd4b61d654855112e75...c16e30c0884549d48a73d7f2ebbbb470a0e1576b,3,93,0,93,9,2006-04-13 07:21:06,2006-04-13 07:09:54
c16e30c0884549d48a73d7f2ebbbb470a0e1576b...8c989ec5288021e07c265882f86ac3999b44c142,1,20,0,20,1,2006-04-13 07:21:47,2006-04-13 07:17:19
8c989ec5288021e07c265882f86ac3999b44c142...d53352422b5f2ac3cfb86f5f363d6f167824ac52,1,1,1,2,1,2006-04-13 07:26:21,2006-04-13 07:26:21
d53352422b5f2ac3cfb86f5f363d6f167824ac52...f43ba60e2c3bec4925eee229fa0f420dd1296f0c,1,2,0,2,1,2006-04-13 18:26:56,2006-04-13 17:01:02
f43ba60e2c3bec4925eee229fa0f420dd1296f0c...2283645b85dc91ca958b05066511083255a8612a,1,15,3,18,3,2006-04-13 18:57:57,2006-04-13 18:57:57
2283645b85dc91ca958b05066511083255a8612a...f327dbced25a3c6fcc0b84d2d6adffa9343b09f0,9,30,30,60,23,2006-04-13 23:45:48,2006-04-13 22:01:24
bf41bf2db71ac4bb03248bb0fe18cbb718af497a...b0d6e64629aeba96e837972c0fda5e61eebb7ab1,1,14,10,24,8,2006-06-04 06:57:41,2006-06-03 08:49:31
8a48571ce52e5182ea32ed168e298882f8c470b3...e1a7c81f6a8c5a96a3d07632514f85d9470c3a82,1,5,7,12,7,2006-07-17 15:52:14,2006-07-17 15:52:14
e1a7c81f6a8c5a96a3d07632514f85d9470c3a82...cec7bece83a42918457819b526c49c7d55f795c5,1,85,47,132,16,2006-08-01 23:38:10,2006-08-01 23:38:10
cec7bece83a42918457819b526c49c7d55f795c5...d6ac1a86e932fdb48705b9b1b6e2849aaea9ad24,1,80,0,80,3,2006-08-01 23:41:04,2006-08-01 23:41:04
d6ac1a86e932fdb48705b9b1b6e2849aaea9ad24...10299152ca10107a4570764286e129572ed2f3c3,1,118,0,118,6,2006-08-01 23:52:01,2006-08-01 23:52:01
10299152ca10107a4570764286e129572ed2f3c3...53cda8d97e6ee53cc8defa8c7226f0b3093eb12a,1,2,2,4,2,2006-08-02 09:43:34,2006-08-02 09:43:34
53cda8d97e6ee53cc8defa8c7226f0b3093eb12a...ca6d8f58a15b9db621dd2b905a04d06bdff44bf8,1,210,43,253,26,2006-08-06 11:08:05,2006-08-06 11:08:05
ca6d8f58a15b9db621dd2b905a04d06bdff44bf8...ceadfe90c64b293a653bcbbce83283d2665d7cf9,1,77,0,77,2,2006-08-08 10:55:36,2006-08-08 10:55:36
ceadfe90c64b293a653bcbbce83283d2665d7cf9...d1e46756d312f65613863a41c256d852fcde330c,1,34,24,58,9,2006-08-16 10:02:32,2006-08-16 10:02:32
d1e46756d312f65613863a41c256d852fcde330c...561d038ab8adb2bab5ba368b88e620be18c4811b,1,6,2,8,4,2006-08-28 12:41:09,2006-08-28 12:41:09
99b41c84a53bf8bb09f06adeb0e3ded503afe706...b86bec6c4ff7909246e68a4495dcaaeede3907e9,1,14,2,16,2,2006-06-08 03:19:00,2006-06-08 03:16:30
86118bcb463e3f34b3df21d550335a40586dfb66...09895c1fa02f77acb2bde3d7e9da675eeb1271cf,1,8,3,11,3,2006-05-06 00:50:06,2006-05-06 00:50:06
09895c1fa02f77acb2bde3d7e9da675eeb1271cf...dc46da2286cf0d42e1e5ebbd272c201dbc3a626a,1,11,2,13,4,2006-05-06 05:40:45,2006-05-06 05:38:06
dc46da2286cf0d42e1e5ebbd272c201dbc3a626a...fb69a760cc9103d1f8341a3c8ea09bd15a8a412d,1,12,7,19,7,2006-05-06 05:53:56,2006-05-06 05:53:56
86118bcb463e3f34b3df21d550335a40586dfb66...051308f6e9cebeb76b8fb4f52b7e9e7ce064445c,4,275,68,343,30,2006-05-05 22:24:32,2006-05-04 23:51:44
051308f6e9cebeb76b8fb4f52b7e9e7ce064445c...0660626caff6ac3745cd7b7908a2ca540141a2ec,5,304,96,400,33,2006-05-05 22:24:32,2006-05-05 09:41:53
288c0384505e6c25cc1a162242919a0485d50a74...845ae27bf8161063d7e2e1ca2a76b05bf5d07192,1,4,1,5,3,2006-05-21 01:22:11,2006-05-19 21:02:34
845ae27bf8161063d7e2e1ca2a76b05bf5d07192...8824689884a5673f803d77cda499f83b84145a06,2,115,1,116,8,2006-05-21 08:16:09,2006-05-20 21:43:13
288c0384505e6c25cc1a162242919a0485d50a74...217542640ed219c980fff2b3c307c4520120f20f,5,142,6,148,11,2006-05-20 00:48:34,2006-05-19 01:46:44
e8a1a11d4e0036a4205dbed533c135b51cd87218...6becd7da8786555fbd2aeeb9669d37dc810f2658,1,1,1,2,1,2006-02-15 09:10:13,2006-02-15 09:10:13
504fe714fe642b375992bb913075bee0d0bc1bbd...6c5c62f3401dc8f4b567af46582c112f6a859b5e,2,8,1,9,2,2006-02-16 03:14:01,2006-02-15 11:37:30
6c5c62f3401dc8f4b567af46582c112f6a859b5e...babfaf8dee0baa09c56d1a2ec5623b60d900518b,1,10,3,13,4,2006-02-16 03:14:04,2006-02-15 19:22:11
e921fb82cf6fb4a5f138ec9d27bc37c658336a8c...1ecc18e4fc0c91e9cab1aafbedb0eebdebaa8dd3,1,3,6,9,3,2006-01-27 22:44:07,2006-01-27 22:44:07
fec9ebf16c948bcb4a8b88d0173ee63584bcde76...42301e34a2736b091738d4ca6a23fd90bd1f1837,2,21,13,34,8,2006-01-16 07:59:12,2006-01-16 07:27:34
42301e34a2736b091738d4ca6a23fd90bd1f1837...5c7d3c9507f74a6f5c3f44915c42ee9ec22c1211,1,1,1,2,1,2006-01-16 08:58:45,2006-01-16 08:58:45
9e9b26751a5ca7a257b3e1cfb319fe3e4efc663c...54f9734ec84a351395bfdd332fee3f0e7006c1da,1,23,1,24,3,2006-01-15 08:04:23,2006-01-11 08:09:16
54f9734ec84a351395bfdd332fee3f0e7006c1da...ebedc3195258a6382f58c8c6b54b21db922440af,5,64,49,113,21,2006-01-15 08:04:23,2006-01-11 22:02:38
ebedc3195258a6382f58c8c6b54b21db922440af...1aa68d67358be1ee20da57b0c3bd1f9863fe41a4,2,46,16,62,10,2006-01-15 08:04:23,2006-01-11 08:16:42
9e9b26751a5ca7a257b3e1cfb319fe3e4efc663c...98efc8f3d890a0c671b7e2000e43b2e0a96b9a73,1,14,6,20,4,2006-01-15 01:21:38,2006-01-14 00:45:42
9e9b26751a5ca7a257b3e1cfb319fe3e4efc663c...36383a3df37116f6022b5a0f7331fb19337c4730,1,74,67,141,11,2006-01-15 01:21:34,2006-01-13 23:56:44
9e9b26751a5ca7a257b3e1cfb319fe3e4efc663c...8a1a120c55a67c3193e136a06826585711717399,2,63,27,90,25,2006-01-15 00:00:32,2006-01-15 00:00:32
9e9b26751a5ca7a257b3e1cfb319fe3e4efc663c...980d8ce551784b76e05077946b8a4f2ac6c5305d,1,3,0,3,1,2006-01-14 21:18:28,2006-01-14 20:31:18
181dc776956b4d265891ac70514ed214e4b7564a...d37fd03222ad6b38aa6e237f5f191238c0544850,1,10,3,13,3,2006-01-29 22:52:16,2006-01-29 22:52:16
d37fd03222ad6b38aa6e237f5f191238c0544850...4353f386166d74fd96cb552900fc22f6df211c21,1,10,5,15,1,2006-01-29 23:00:42,2006-01-29 12:16:08
4353f386166d74fd96cb552900fc22f6df211c21...075dd8ee5417899c9f41b90f0dceecdf85433468,2,6,3,9,4,2006-01-29 23:00:46,2006-01-29 14:02:51
075dd8ee5417899c9f41b90f0dceecdf85433468...f0fff36e82bc8cc12be58a0585106ee720c4dc98,1,4,4,8,1,2006-01-30 01:54:43,2006-01-30 01:40:50
a8883288fa1240996a9c5715e060a88a03796fe0...3c07b1d19491aa9acb9f8e86486f0b80f976edf9,3,126,14,140,6,2005-11-17 07:54:37,2005-11-15 03:29:06
3c07b1d19491aa9acb9f8e86486f0b80f976edf9...f30c95dd76800fbd66fb66180d67c09bab678282,1,3,0,3,1,2005-11-17 07:54:37,2005-11-15 08:07:04
a8883288fa1240996a9c5715e060a88a03796fe0...a7fb51d3d4d303d61831b2fe5127a088b050e60b,1,28,27,55,13,2005-11-17 07:29:35,2005-11-12 09:25:33
a7fb51d3d4d303d61831b2fe5127a088b050e60b...9b626e752eebcc49acab19085947e67b5e61e39f,1,7,1,8,1,2005-11-17 07:29:35,2005-11-12 09:27:21
9b626e752eebcc49acab19085947e67b5e61e39f...22ff00fc8bde65414653ed139fd13d90f00fe662,1,54,11,65,6,2005-11-17 07:29:36,2005-11-12 09:29:20
22ff00fc8bde65414653ed139fd13d90f00fe662...fee3365fe13f36fdd432b1ede9980062cf744663,1,17,6,23,4,2005-11-17 08:20:45,2005-11-17 08:20:45
673151a9bb56ec97fab66746e3aecef78fddb9b8...366c8d4ca383466184edd4de75214233368f1efa,1,1,1,2,1,2014-11-17 17:27:47,2014-11-17 00:49:00
1f87293d78a4b2bd9265bac49b14a6f1111918b8...96ef1bdc654932cf2707a1b70a9502842a1014f7,1,1,1,2,1,2014-10-28 22:25:25,2014-10-28 22:09:53
1da1e07c835e900337714cfad6c32a8dc0b36ac3...d64ea0f83bd7e676778f833c57f969a94518a28d,1,5,0,5,1,2015-01-13 18:03:30,2015-01-13 01:57:37
d64ea0f83bd7e676778f833c57f969a94518a28d...444069078687fc00586824a21eff9758fc4d0625,1,5,10,15,6,2015-01-13 18:03:38,2015-01-13 01:58:15
444069078687fc00586824a21eff9758fc4d0625...eaa541eb59aefa2c5e9e160c36a259d372c25711,1,3,9,12,2,2015-01-13 18:03:40,2015-01-13 01:58:33
eaa541eb59aefa2c5e9e160c36a259d372c25711...8c53f0719b04e0b6328c2e175e3c5d2dc8a0c282,7,9,10,19,7,2015-01-13 18:05:48,2015-01-13 01:59:09
8c53f0719b04e0b6328c2e175e3c5d2dc8a0c282...a46442f1675722eb68238b329a4a285f03f41dda,1,7,5,12,6,2015-01-13 18:05:53,2015-01-13 01:59:26
1da1e07c835e900337714cfad6c32a8dc0b36ac3...5f78a431ab222189b11a9233a5902db61aa32976,1,17,113,130,4,2014-10-16 17:10:38,2014-10-15 22:37:28
5f78a431ab222189b11a9233a5902db61aa32976...718ccc9731c4e98b123436c22c1cccf2beed5e29,3,4,25,29,6,2014-10-16 17:10:38,2014-10-15 22:38:31
718ccc9731c4e98b123436c22c1cccf2beed5e29...27e1e22d5ee3005f228b67ea94b5af29547b54fe,3,143,61,204,9,2014-10-16 17:10:39,2014-10-15 22:38:55
27e1e22d5ee3005f228b67ea94b5af29547b54fe...3725427945657da052f2f833f5fd4616c949be3e,1,6,1,7,2,2014-10-16 17:10:40,2014-10-15 22:40:37
3725427945657da052f2f833f5fd4616c949be3e...0d3b729680e9cab0f567122e796dab2bc9bc8cfb,1,23,46,69,8,2014-10-16 17:10:40,2014-10-15 22:40:53
0d3b729680e9cab0f567122e796dab2bc9bc8cfb...cac05d4dfd148071462939a61ecd44cf932a0b02,1,1,1,2,1,2014-10-16 17:10:41,2014-10-15 22:40:58
cac05d4dfd148071462939a61ecd44cf932a0b02...4a1e693a30c816fa5293c5f9e83e1e98ee87584e,1,30,71,101,7,2014-10-16 17:10:41,2014-10-15 22:41:11
4a1e693a30c816fa5293c5f9e83e1e98ee87584e...660c889e46d185dc98ba78963528826728b0a55d,2,73,0,73,2,2014-10-16 17:10:41,2014-10-15 22:41:21
660c889e46d185dc98ba78963528826728b0a55d...d3038d22f91aad9620bd8e6fc43fc67c16219738,5,204,3,207,7,2014-10-16 17:10:42,2014-10-15 22:41:35
d3038d22f91aad9620bd8e6fc43fc67c16219738...d0d46abc167d18fdbdbf2ece8ca6df704517c62f,1,12,5,17,3,2014-10-16 17:10:42,2014-10-15 22:41:53
d0d46abc167d18fdbdbf2ece8ca6df704517c62f...abcb86553d3ec4afffa4e3963089dffe0559740e,4,98,40,138,16,2014-10-16 17:10:43,2014-10-15 22:42:09
abcb86553d3ec4afffa4e3963089dffe0559740e...33d4221c79c89844bed6b9558cc2bc497251ef70,2,71,7,78,9,2014-10-16 17:10:43,2014-10-15 22:42:22
33d4221c79c89844bed6b9558cc2bc497251ef70...9e0c3c4fcdf3775a9e0256ee231efa4698297a0e,3,15,20,35,11,2014-10-16 17:10:44,2014-10-15 22:42:57
9e0c3c4fcdf3775a9e0256ee231efa4698297a0e...207394908e9465d0169608725aeaa5bb355086e0,2,32,9,41,13,2014-10-19 22:06:31,2014-10-15 22:43:19
207394908e9465d0169608725aeaa5bb355086e0...458a7e508c57afb6bbd4177fead21c63a0a20131,1,13,0,13,1,2014-10-19 22:07:06,2014-10-17 00:03:41
458a7e508c57afb6bbd4177fead21c63a0a20131...41d018d146f03f7b9320c7492d7cbde5df9f68a1,1,4,0,4,1,2014-10-19 22:07:07,2014-10-15 22:43:28
41d018d146f03f7b9320c7492d7cbde5df9f68a1...4fe10219bca6b010e2103116c653928992d5141b,4,80,0,80,7,2014-10-19 22:07:07,2014-10-17 00:44:23
5d7f49dc79edf476a0b9266ea5f076b723eca6ec...d29e9c89dbbf0876145dc88615b99308cab5f187,1,21,0,21,3,2014-09-26 21:59:32,2014-09-26 21:51:23
b9459019bbb7b864cf59fa307953834996ab4dbe...5d222c099e38bcf329af544ec42ad3dd0644741c,1,2,2,4,2,2014-10-28 21:55:15,2014-10-28 20:27:54
343151dcbdf63a4f12b1a0108708280dc3883af6...f6975a6b119128de1c5a89e6cd64f75ed1de2177,1,120,100,220,28,2014-08-28 18:18:55,2014-08-16 20:16:58
f6975a6b119128de1c5a89e6cd64f75ed1de2177...5491e9e29eef60bd6337de81e9283e67941618e5,2,23,0,23,2,2014-09-02 19:09:40,2014-08-30 21:38:59
5491e9e29eef60bd6337de81e9283e67941618e5...5f4e02e5173c64b5b760f35283c4b0094bb85881,2,35,20,55,5,2014-09-02 19:09:40,2014-08-30 21:39:07
9e8a901e6b9130ccec149c987e15e55b017a7b29...c490a6079021a3343ca5b042b37258858fdefbfc,2,10,2,12,4,2013-07-25 02:29:07,2013-07-25 02:29:07
05c1eb10348f159908becc7a6ed6bbcdab24c893...42aa29ee12bbc769567c4c8ed694566511ef2e39,1,1,1,2,1,2013-09-20 18:18:09,2013-09-20 10:25:00
77eb44b8ed601a17a5ec9b1fb8c4c53ba10aaa56...2c4842023205b4b2cf7eac973cd7dc2fca263327,1,5,2,7,4,2013-06-18 14:25:06,2013-06-18 01:40:49
2c4842023205b4b2cf7eac973cd7dc2fca263327...9d58c4a3e3ce3a40262b7ff3cc39ce3b9a93d527,1,2,2,4,2,2013-06-18 16:16:58,2013-06-18 01:40:50
e45bda876ae2e39ac1e11ba1609f2c363ad4959a...7d9a2819415663ee5f0676d06cdbb1368fdc02c7,1,21,0,21,1,2014-02-24 18:12:58,2014-02-24 07:36:22
7d9a2819415663ee5f0676d06cdbb1368fdc02c7...d4b8de0420ffcc7a654ddc6c69a96d3c1b25b4fa,2,20,6,26,5,2014-02-24 18:12:58,2014-02-24 07:39:04
d4b8de0420ffcc7a654ddc6c69a96d3c1b25b4fa...7ca36d9398a85e7974d04f8fbd2c6adb088290e1,3,19,1,20,3,2014-02-24 18:12:58,2014-02-24 07:39:45
7ca36d9398a85e7974d04f8fbd2c6adb088290e1...1dca155fe3fac29e847d2d8ff1087d892a129a9c,2,24,2,26,2,2014-02-24 18:12:58,2014-02-24 07:46:37
1dca155fe3fac29e847d2d8ff1087d892a129a9c...2b15846dbfb31df10a69a4d56ae944a01563bc07,2,12,2,14,2,2014-02-24 18:12:58,2014-02-24 07:49:05
2b15846dbfb31df10a69a4d56ae944a01563bc07...3f419d45ef0dfc33dc301d9ae4737043c091291a,1,2,2,4,2,2014-03-07 19:53:29,2014-03-07 17:15:01
e45bda876ae2e39ac1e11ba1609f2c363ad4959a...fcb06a8d54e29d12bb8160b978ce78331c95a1bf,4,5,5,10,5,2013-10-29 19:41:17,2013-10-29 01:19:59
e45bda876ae2e39ac1e11ba1609f2c363ad4959a...339c17bc7690b5436ac61c996cede3d52c85b50d,1,2,2,4,2,2013-10-18 19:48:48,2013-10-16 08:28:50
e45bda876ae2e39ac1e11ba1609f2c363ad4959a...9247be05cf686dc98dd504f8f9fb0f07da1a29d1,1,4,2,6,2,2013-09-12 15:44:44,2013-09-12 00:30:01
e5be297279e8ee8c503eb59da21ab17edc40e748...182d7dc46b23b4a20985c93ea3a6ba3e6f267ff6,2,22,0,22,2,2013-09-09 18:17:11,2013-09-05 14:57:23
b3e7d24ca19d841eb2c5c7fce7919ebb5d370a6f...db5360f3f4966c4586d072bd1440880773185b81,2,34,24,58,5,2013-09-17 17:07:13,2013-09-17 07:06:14
db5360f3f4966c4586d072bd1440880773185b81...ebbd7439b1b7cce0e8c68fe3e220d71cc58dd980,3,9,9,18,9,2013-09-17 17:07:37,2013-09-17 07:06:15
ebbd7439b1b7cce0e8c68fe3e220d71cc58dd980...d28eec267374c476de490bff736a627da94575c5,3,8,7,15,8,2013-09-17 17:08:07,2013-09-17 07:06:16
d28eec267374c476de490bff736a627da94575c5...de372b1b46d91ffdcd6eb6e324cb8b586c99c539,1,3,15,18,1,2013-09-17 17:08:27,2013-09-17 07:06:17
b3e7d24ca19d841eb2c5c7fce7919ebb5d370a6f...431260cc8dda69336ced159c39d10007c9584e58,1,4,0,4,1,2013-09-13 22:29:59,2013-09-13 21:23:17
431260cc8dda69336ced159c39d10007c9584e58...b85ecea625cb990ce9f02793a69fb339bb467e6c,1,4,2,6,2,2013-09-13 22:30:01,2013-09-13 21:23:16
b85ecea625cb990ce9f02793a69fb339bb467e6c...08f8d5d0c062e425d5ba08c57b94e47cc7543112,1,4,4,8,1,2013-10-15 21:58:21,2013-10-15 21:57:42
12dd2f69337e29254e743aa6fb3b04937f302209...6ca0f80b6c4d17843a9773d5fd909395f786731d,2,4,3,7,4,2013-10-30 20:54:15,2013-10-26 17:43:54
3e7a5b489e45ae8a3a0b222893d58b172d883136...9b9439afd8e08a2370d008af2836198ff9008179,1,440,373,813,73,2013-06-23 07:08:25,2013-06-22 07:58:08
9b9439afd8e08a2370d008af2836198ff9008179...294547f5647688c6ee565811f9762a34e521e746,1,2,1,3,1,2013-06-23 07:14:15,2013-06-22 07:58:09
294547f5647688c6ee565811f9762a34e521e746...fe3c1956e2289f083cf6777b3ff22fe628c92951,1,2,2,4,2,2013-06-23 07:14:33,2013-06-22 07:58:10
fe3c1956e2289f083cf6777b3ff22fe628c92951...55cfde251b4bee36f64f2067cccc4ba346aaf1b0,1,4,19,23,6,2013-06-23 07:33:57,2013-06-22 07:58:12
55cfde251b4bee36f64f2067cccc4ba346aaf1b0...1f9a5e905e56502097eb9097a6ea2e9b9cb2e168,1,18,4,22,5,2013-06-23 07:33:57,2013-06-22 07:58:13
1f9a5e905e56502097eb9097a6ea2e9b9cb2e168...6077d3629964d0ba03798a82fd69b745574142ed,1,0,1,1,1,2013-06-23 07:33:58,2013-06-22 07:58:15
6077d3629964d0ba03798a82fd69b745574142ed...88e36141d0b3025637960f45c08033c949ae26fb,1,3,3,6,1,2013-06-23 07:33:58,2013-06-22 07:58:16
88e36141d0b3025637960f45c08033c949ae26fb...f0779aef8e9178a8abbadba2eed6b80d8d67e94d,1,2,2,4,1,2013-06-23 07:33:58,2013-06-22 07:58:17
f0779aef8e9178a8abbadba2eed6b80d8d67e94d...f0f249d18617848f98aee0b9b9bb90cfb2ecdb68,1,14,2,16,3,2013-06-23 07:33:58,2013-06-22 07:58:18
3e7a5b489e45ae8a3a0b222893d58b172d883136...8c8fc53c7d3daf07f690c1d88ce45849663e6fa4,1,0,7,7,1,2013-06-23 06:34:54,2013-06-22 14:46:24
8c8fc53c7d3daf07f690c1d88ce45849663e6fa4...f22a6543d17d615068652d0f94397f558158d91a,1,4,4,8,1,2013-06-23 06:35:00,2013-06-22 14:46:25
f22a6543d17d615068652d0f94397f558158d91a...34a25d4c9004fd17ce8cbd648d29600caccfd9b6,2,32,19,51,8,2013-06-23 06:35:17,2013-06-22 14:46:26
34a25d4c9004fd17ce8cbd648d29600caccfd9b6...283efb010806d26967a1865d81d6538507c04acf,5,11,11,22,7,2013-06-23 06:36:48,2013-06-22 14:46:27
8ff80a2f0514080a741c19532a094f1fa79dc8e2...1f3a412dfaf2d12583e3286c6d20b403da8cc963,1,4,0,4,1,2013-06-23 21:55:45,2013-06-23 21:55:45
0c36f3a198fab35c694a1e38c57227989c98e48e...21ff9151e811059f5576ca906c519ee5bb5b925e,1,18,1,19,4,2013-06-20 23:13:41,2013-06-20 23:13:41
21ff9151e811059f5576ca906c519ee5bb5b925e...266f1fdfa99f5d29ca7ce455966e7960c00a82e4,2,2,4,6,2,2013-06-21 16:03:53,2013-06-21 07:05:39
fb7dfaa710da6f9ebb854f70ffc1c78668a1e70c...3cb8a5ff1756f11fe60b9c6ed3f9fe593e9c6d62,1,0,2,2,2,2013-06-20 02:11:34,2013-06-19 11:11:39
3cb8a5ff1756f11fe60b9c6ed3f9fe593e9c6d62...87a70e4ce8bb3bdbb3048a5eb837f6b5b2eff8f9,1,44,28,72,4,2013-06-24 03:50:34,2013-06-19 11:11:40
87a70e4ce8bb3bdbb3048a5eb837f6b5b2eff8f9...ed2b18292bfeedc98c9e2b6bd8a35d8001dab2fc,2,38,15,53,11,2013-06-24 17:16:49,2013-06-19 11:11:41
ed2b18292bfeedc98c9e2b6bd8a35d8001dab2fc...396243fa479cd27bef1ced2ea5a9e4cf20f85a4b,1,4,2,6,4,2013-06-24 17:18:41,2013-06-19 11:11:43
396243fa479cd27bef1ced2ea5a9e4cf20f85a4b...6e1696b7c46f02310a882b4e761a29d3a0cf278f,1,57,0,57,2,2013-06-24 17:19:25,2013-06-19 11:11:44
fb7dfaa710da6f9ebb854f70ffc1c78668a1e70c...eb4be1cbe2e50c9bfaa09839564723de257869fc,1,8,3,11,4,2013-06-19 18:03:22,2013-06-19 07:37:09
fb7dfaa710da6f9ebb854f70ffc1c78668a1e70c...b545cd15af873fe15e692daaa6e804b191b451cc,1,2,2,4,4,2013-06-17 20:26:42,2013-06-17 09:55:36
f445500e4dd79ad0c4f6cf1c4949f01f155142f7...26f8f32a2039a0e4568fb7d3682be19b94a9dd7f,1,3,0,3,1,2013-06-09 20:45:32,2013-06-09 11:11:36
26f8f32a2039a0e4568fb7d3682be19b94a9dd7f...467b8fe1bb900832f51281fe954d9134b545d6dd,1,2,3,5,1,2013-06-09 20:46:45,2013-06-09 16:33:45
6bf931a54fd66826f28d2808b7ad822024764d41...e78095c3d05712b9479211bcc7faa1d8e9bf2723,1,1,1,2,1,2013-07-24 15:45:49,2013-01-18 19:24:01
88f90f8286e9e456ea332e00f87ad39892103544...e2652c0bcfdeee88f416c6e2c34163545ea30047,2,55,1,56,2,2013-06-27 21:48:14,2013-06-27 21:48:14
5e49f30c85ecacec98631462fa73f1148a01637c...219a0f33cae0f164f4353b2171ecd4c08d5b7ced,1,4,2,6,3,2013-05-28 16:25:00,2013-05-25 09:08:00
219a0f33cae0f164f4353b2171ecd4c08d5b7ced...b87dbcc89940edbf92cbab381001542a7cac3627,1,2,2,4,2,2013-05-28 16:25:00,2013-05-25 09:08:01
b87dbcc89940edbf92cbab381001542a7cac3627...df835d3a0c013b9ef912172663c7c58dad87164d,1,5,1,6,2,2013-05-28 16:25:00,2013-05-25 09:08:02
df835d3a0c013b9ef912172663c7c58dad87164d...91de344d7696ba8d7b92b7c503fdc0d3961e8cd2,1,10,9,19,6,2013-05-28 16:25:00,2013-05-25 09:08:03
91de344d7696ba8d7b92b7c503fdc0d3961e8cd2...33055fa823eff9f4fddb858856f9b9a8d85316fc,1,18,19,37,9,2013-05-28 16:25:00,2013-05-25 09:08:04
33055fa823eff9f4fddb858856f9b9a8d85316fc...026f09e79689f99f573b8399443e8c4ffa84a794,1,4,4,8,2,2013-05-28 16:25:00,2013-05-25 09:08:05
026f09e79689f99f573b8399443e8c4ffa84a794...5b1e14eab3109c1d33e27b00ee18f8f9f60e779c,1,4,5,9,5,2013-05-28 16:25:01,2013-05-25 09:08:06
5b1e14eab3109c1d33e27b00ee18f8f9f60e779c...ff5f5f268fd36b6db059c06d124305866ecaa6ce,2,35,17,52,13,2013-05-28 16:25:01,2013-05-25 09:08:07
ff5f5f268fd36b6db059c06d124305866ecaa6ce...aeb4a51ef82c71c9a65d11f77aeedb53bea0e983,2,27,0,27,2,2013-05-28 16:25:01,2013-05-25 09:08:08
aeb4a51ef82c71c9a65d11f77aeedb53bea0e983...be6754c67f5aff02e9528116d06890391524f48e,1,15,17,32,3,2013-05-28 16:25:01,2013-05-25 09:08:09
be6754c67f5aff02e9528116d06890391524f48e...1506510c170d23b8f769757dc81904f334c40281,2,26,12,38,5,2013-05-28 16:25:01,2013-05-25 09:08:10
1506510c170d23b8f769757dc81904f334c40281...16aa3bfc9b9dc587d02f29d8e54810480cf955e4,1,1,1,2,1,2013-05-28 16:25:01,2013-05-25 09:08:11
16aa3bfc9b9dc587d02f29d8e54810480cf955e4...3826902d25febf61274925d6f12cc7471ba3c38f,1,1,2,3,2,2013-05-28 16:25:01,2013-05-25 09:08:12
3826902d25febf61274925d6f12cc7471ba3c38f...5de0c0155c824803a7ee39326b09eeb93e9ec899,1,1,2,3,1,2013-05-28 16:25:01,2013-05-25 09:08:13
5de0c0155c824803a7ee39326b09eeb93e9ec899...31faeb2088ef35d0108ad81df3550513d6cec798,4,35,7,42,9,2013-06-02 22:28:46,2013-05-25 09:08:14
31faeb2088ef35d0108ad81df3550513d6cec798...6f64a16faff0189d54cf30854483493574476c6e,1,3,3,6,2,2013-06-02 22:28:46,2013-05-25 09:08:15
6f64a16faff0189d54cf30854483493574476c6e...5b87d8d3f53c1dfb54027123af612488abc85006,1,9,5,14,4,2013-06-02 22:28:47,2013-05-25 09:08:16
5b87d8d3f53c1dfb54027123af612488abc85006...f83918edcb6fbcd1c5d8378c11e57edcc47bd232,1,4,3,7,3,2013-06-02 22:28:47,2013-05-25 09:08:17
f83918edcb6fbcd1c5d8378c11e57edcc47bd232...1d811dbd04afc9fd4e59d1a1a2c090abb835d55f,1,2,2,4,1,2013-06-02 22:28:47,2013-05-25 09:08:18
1d811dbd04afc9fd4e59d1a1a2c090abb835d55f...3e4ca43fd0ea0f6a150de3be096b52954d64f523,1,2,2,4,2,2013-06-02 22:28:47,2013-05-25 09:08:19
3e4ca43fd0ea0f6a150de3be096b52954d64f523...d235e994f893fddd7808a4f5af879fd718563649,1,3,3,6,2,2013-06-02 22:28:47,2013-05-25 09:08:20
d235e994f893fddd7808a4f5af879fd718563649...8c46bf904fe95105faaa1823332c91d2802182c2,1,4,0,4,2,2013-06-02 22:28:47,2013-05-25 09:08:21
8c46bf904fe95105faaa1823332c91d2802182c2...66ce0366285f73c340f04a21b3d8be898d7bf5a7,1,1,1,2,1,2013-06-02 22:28:47,2013-05-25 09:08:22
66ce0366285f73c340f04a21b3d8be898d7bf5a7...bf42772e38db8e758aa28a045e8cba88096a9fcc,1,3,2,5,2,2013-06-02 22:28:47,2013-05-25 09:08:23
bf42772e38db8e758aa28a045e8cba88096a9fcc...4f78c24c63bf0b035afc02372727a3b5897d9835,1,16,6,22,2,2013-06-02 22:28:47,2013-05-25 09:08:24
5e49f30c85ecacec98631462fa73f1148a01637c...edca4152560522a431a51fc0a06147fc680b5b18,1,11,11,22,7,2013-05-24 18:34:46,2013-05-24 18:34:46
5e49f30c85ecacec98631462fa73f1148a01637c...02a607260fdbaed7717935df68fb76b1a6e577c0,4,5,5,10,5,2013-05-21 18:59:44,2013-05-17 21:10:07
02a607260fdbaed7717935df68fb76b1a6e577c0...0c27c12d21c6af3163ac4253c815e62c6bdd37f3,1,4,3,7,3,2013-05-21 18:59:48,2013-05-17 21:10:08
0c27c12d21c6af3163ac4253c815e62c6bdd37f3...cf08a7e15fd473bc9853227f537f6fe5c6512370,1,2,2,4,2,2013-05-28 14:59:18,2013-05-25 02:29:17
cf08a7e15fd473bc9853227f537f6fe5c6512370...294ff7b233c3066041320b339f515af8ad58854f,1,2,2,4,2,2013-05-28 14:59:18,2013-05-25 02:29:18
294ff7b233c3066041320b339f515af8ad58854f...4080ac81e5435ce0d1acbe08916190a7513aae2b,2,318,318,636,51,2013-05-28 14:59:19,2013-05-25 02:29:19
4080ac81e5435ce0d1acbe08916190a7513aae2b...dde67d794c2600fee74aef289332257742f28cfa,2,66,34,100,33,2013-05-28 14:59:19,2013-05-25 02:29:20
dde67d794c2600fee74aef289332257742f28cfa...531594e5aad738fa46cfad417bcef0fbd1520fbd,4,31,45,76,27,2013-05-28 14:59:19,2013-05-25 02:29:21
531594e5aad738fa46cfad417bcef0fbd1520fbd...5f5e92fb7954c0bd258563541fed394bc5f88544,4,19,19,38,19,2013-05-28 14:59:19,2013-05-25 02:29:22
5f5e92fb7954c0bd258563541fed394bc5f88544...f6f00b46aed220517df3c9808f81ea7ca9576643,2,2,4,6,4,2013-05-28 14:59:19,2013-05-25 02:29:23
f6f00b46aed220517df3c9808f81ea7ca9576643...cab3829d2b29b9cd750afd0e342d6f3cae359639,1,1,5,6,1,2013-05-28 14:59:19,2013-05-25 02:29:24
cab3829d2b29b9cd750afd0e342d6f3cae359639...6796d49ed01c214d4eeb5b9f2ffd2a49b54a7207,1,20,15,35,6,2013-05-28 14:59:20,2013-05-25 02:29:25
6796d49ed01c214d4eeb5b9f2ffd2a49b54a7207...52036431ff630ba9de9430fb6982a6869473d002,1,17,13,30,15,2013-05-28 14:59:20,2013-05-25 02:29:26
52036431ff630ba9de9430fb6982a6869473d002...e936a5d4842e9bbfeaf5792efc0db5965bf9e7ee,1,7,3,10,2,2013-05-28 14:59:29,2013-05-25 02:29:27
e936a5d4842e9bbfeaf5792efc0db5965bf9e7ee...c43c06b1869c40e2a95a23f6b87dc38861e9d776,1,13,3,16,5,2013-05-28 14:59:29,2013-05-25 02:29:28
c43c06b1869c40e2a95a23f6b87dc38861e9d776...93ae203495ded111bb0206fb50e54d0812df1cd5,1,22,20,42,19,2013-05-28 14:59:29,2013-05-25 02:29:29
93ae203495ded111bb0206fb50e54d0812df1cd5...68b161167841c43c138604429f9981cb453aff8a,1,18,4,22,5,2013-05-28 14:59:30,2013-05-25 02:29:30
68b161167841c43c138604429f9981cb453aff8a...9529cce86e508d1910395d7493b7b8706ea7cd37,2,41,0,41,3,2013-05-28 14:59:30,2013-05-25 02:29:31
9529cce86e508d1910395d7493b7b8706ea7cd37...34d75e78f407c85f948dc74806a6505cd1f001ec,1,7,7,14,5,2013-05-28 14:59:30,2013-05-25 02:29:32
34d75e78f407c85f948dc74806a6505cd1f001ec...63f54cf216944e8cadd7c762e624b0a7b1d0c3a2,1,4,5,9,3,2013-05-28 14:59:30,2013-05-25 02:29:33
63f54cf216944e8cadd7c762e624b0a7b1d0c3a2...91347ea3e17b853155f9cab31f0c2a28143284ed,4,26,52,78,17,2013-05-28 14:59:30,2013-05-25 02:29:34
91347ea3e17b853155f9cab31f0c2a28143284ed...9f36d61e7b63618cc7931f948b7b57cdcd11bd7a,1,67,1,68,3,2013-05-28 14:59:31,2013-05-25 02:29:35
9f36d61e7b63618cc7931f948b7b57cdcd11bd7a...0067ecc82b2dbef64d3768484eb6a1b4ca2c27d2,1,5,12,17,4,2013-05-28 14:59:31,2013-05-25 02:29:36
0067ecc82b2dbef64d3768484eb6a1b4ca2c27d2...b082b4f94ff1a82ce42223f7a46c9423e99c48e9,1,7,1,8,2,2013-05-28 14:59:56,2013-05-25 02:29:37
b082b4f94ff1a82ce42223f7a46c9423e99c48e9...731ce6cf75d304bc14c1ee0ad45e5846f5db6834,1,17,0,17,2,2013-05-28 14:59:56,2013-05-25 02:29:38
731ce6cf75d304bc14c1ee0ad45e5846f5db6834...e6e803be79123dff163900c5a55e556cf6d6c9c0,2,39,1,40,2,2013-05-28 14:59:57,2013-05-25 02:29:39
e6e803be79123dff163900c5a55e556cf6d6c9c0...e14432f798d6575b5c8269982758c0916a5f13c5,1,30,0,30,2,2013-05-28 14:59:57,2013-05-25 02:29:40
e14432f798d6575b5c8269982758c0916a5f13c5...1a810864e87b78c08295acca124eb66b8cf2a973,1,23,0,23,1,2013-05-28 15:00:13,2013-05-25 02:29:41
1a810864e87b78c08295acca124eb66b8cf2a973...747b61c6a66b5af279fdc1f919e9519045ed097a,1,29,0,29,1,2013-05-28 15:00:35,2013-05-25 02:29:42
747b61c6a66b5af279fdc1f919e9519045ed097a...ad22b92a810bd793e4a357d0230beefb865e929e,1,15,0,15,1,2013-05-28 15:01:49,2013-05-25 02:29:43
ad22b92a810bd793e4a357d0230beefb865e929e...d2c76330286c8bd604f9fbbb7818cecce893b769,1,107,6,113,3,2013-05-28 15:02:03,2013-05-25 02:29:44
d2c76330286c8bd604f9fbbb7818cecce893b769...0bf9ee5720c6d98be8bee93ab3e1a80451de767c,1,24,0,24,1,2013-05-28 15:02:03,2013-05-25 02:29:45
0bf9ee5720c6d98be8bee93ab3e1a80451de767c...aaadca28b6148c262385c258c761e166eff6fbeb,1,19,31,50,4,2013-05-28 15:02:04,2013-05-25 02:29:46
aaadca28b6148c262385c258c761e166eff6fbeb...dfcef29f2f32046f3edbcaee47a03d94bc237eb8,1,2,1,3,1,2013-05-28 15:02:04,2013-05-25 02:29:47
dfcef29f2f32046f3edbcaee47a03d94bc237eb8...d226945471d6c2d5ec6b42bdac78a4e6518c1be9,1,7,2,9,6,2013-05-28 15:02:04,2013-05-25 02:29:48
d226945471d6c2d5ec6b42bdac78a4e6518c1be9...4f37bdbdb6229931c464b99eb9f6e198de01d0a7,1,42,2,44,3,2013-05-28 15:02:04,2013-05-25 02:29:49
4f37bdbdb6229931c464b99eb9f6e198de01d0a7...19a8cefc44b216db5cf8faf790d197c85db6395e,1,49,3,52,6,2013-05-28 15:02:04,2013-05-25 02:29:50
19a8cefc44b216db5cf8faf790d197c85db6395e...883d7be110968c0d319dfa7c595c640e616da9c5,2,24,16,40,15,2013-05-28 15:02:05,2013-05-25 02:29:51
883d7be110968c0d319dfa7c595c640e616da9c5...d3c460b5b43ab67de894c9d3b6d6ce20f3f00070,2,25,1,26,3,2013-05-28 15:02:05,2013-05-25 02:29:52
d3c460b5b43ab67de894c9d3b6d6ce20f3f00070...611024e606c8019d348ab1821a1fbb1898384a25,1,4,8,12,3,2013-05-28 15:02:05,2013-05-25 02:29:53
611024e606c8019d348ab1821a1fbb1898384a25...c2f7a82032bff3f516aa7d029506aed096a01e0b,1,6,3,9,1,2013-05-28 15:02:05,2013-05-25 02:29:54
c2f7a82032bff3f516aa7d029506aed096a01e0b...b688911a789e4eb1cfb97e1a59df0b14817b9d1a,2,10,11,21,5,2013-05-28 15:02:05,2013-05-25 02:29:55
b688911a789e4eb1cfb97e1a59df0b14817b9d1a...d462469b4dd724b162a6ef29d0907eb133a5d56e,1,14,4,18,2,2013-05-28 15:02:05,2013-05-25 02:29:56
d462469b4dd724b162a6ef29d0907eb133a5d56e...66f46aa14fa48e5d17885b46e80250e155c255e3,1,2,2,4,2,2013-05-28 15:02:23,2013-05-25 02:29:57
66f46aa14fa48e5d17885b46e80250e155c255e3...2b02a40587a4a8b7f8bd0542b57c61ec97d0ef2a,1,11,4,15,3,2013-05-28 15:02:24,2013-05-25 02:29:58
2b02a40587a4a8b7f8bd0542b57c61ec97d0ef2a...42cbbcc73b312e2306f051f89702799546aa7953,1,49,17,66,4,2013-05-28 15:02:24,2013-05-25 02:29:59
42cbbcc73b312e2306f051f89702799546aa7953...8316d18da324f44b93faf36cddbf19411b53d101,2,9,3,12,3,2013-05-28 15:02:24,2013-05-25 02:30:00
8316d18da324f44b93faf36cddbf19411b53d101...ab64bc9d21957d2ab30cd4a5e5359fb3f9155704,1,4,7,11,3,2013-05-28 15:02:24,2013-05-25 02:30:01
ab64bc9d21957d2ab30cd4a5e5359fb3f9155704...ba091c200d88b27a0bd9027f24a7250f196fc304,2,109,1,110,8,2013-05-28 15:02:24,2013-05-25 02:30:02
ba091c200d88b27a0bd9027f24a7250f196fc304...e3751a1763112b301f2269dd268190900d7ddd29,2,65,2,67,10,2013-05-28 15:02:24,2013-05-25 02:30:03
e3751a1763112b301f2269dd268190900d7ddd29...c9eaef125bbecd60a8b328d58e66306d5db1357a,2,50,13,63,10,2013-05-28 15:02:25,2013-05-25 02:30:04
2ea3df68e881405940596b8c299921f681f8c22c...3361a548dbedde96d75bd4134e9ab9e6d82774dd,1,2,2,4,2,2013-09-12 18:00:51,2013-09-10 22:55:35
2ea3df68e881405940596b8c299921f681f8c22c...26776c9737a6b5b0e7aab142aef6ba856d8b46ca,1,8,6,14,3,2013-09-11 19:32:01,2013-09-11 17:05:17
60838613054f43d63086b0f4a7596baaee9e20c5...f85f7947c38359c05b9df28fafe769fde9341326,1,2,2,4,1,2013-08-28 19:51:46,2013-08-28 01:28:32
ab84621754e9c6f05279b42e51b445baac28a8ea...6a3ac18ba3150a7e089c0c6b6648b364c71f87c9,1,7,0,7,1,2013-05-14 22:51:00,2013-05-14 04:20:27
ab84621754e9c6f05279b42e51b445baac28a8ea...0c38a95ec83f7adb5fc1b7a5133a2ac2668cdd4a,1,5,3,8,4,2013-05-13 22:23:47,2013-05-13 21:27:25
0c38a95ec83f7adb5fc1b7a5133a2ac2668cdd4a...dcbe7f1ab8b96b3875ae820d71c1364ee3bd99f5,1,6,3,9,5,2013-05-13 22:24:46,2013-05-13 21:27:26
dcbe7f1ab8b96b3875ae820d71c1364ee3bd99f5...c14cc77c1126c04b35ce0ea16989af50af6cebc1,1,1,1,2,1,2013-05-13 22:25:10,2013-05-13 21:27:27
c14cc77c1126c04b35ce0ea16989af50af6cebc1...5ce4367d644060821a264e00f7e2e98e35dd2d59,1,1,1,2,1,2013-05-13 22:25:25,2013-05-13 21:27:28
21246dbb9e0af278bc671e32e45a6cae4ad38b6f...7c0b0d8deae040969d78eb141d899e225f1577e6,1,3,3,6,2,2013-05-09 20:29:53,2013-05-09 20:27:49
c138af56da491151be8991ecc0b4e8ae34f4407c...25d1d7e1c36ac81a3730ff8583c0e7cf8574b3b0,1,1047,822,1869,781,2013-04-11 10:58:56,2013-04-11 10:58:56
c138af56da491151be8991ecc0b4e8ae34f4407c...7db011eb203ca39908aeae99e0d8de56cec35cf2,1,1059,825,1884,786,2013-04-11 07:23:02,2013-04-11 07:23:02
3b892dc8280b3abfd10e97e1bacc8acf580980b8...435f39a3e8f9dc1aab786347d4a92aee3ecef56a,2,49,4,53,3,2013-05-08 05:38:40,2013-05-07 23:39:35
435f39a3e8f9dc1aab786347d4a92aee3ecef56a...0df860383e81f8613fc1d45b7d921f0d51f54f76,1,0,1,1,1,2013-05-08 05:42:20,2013-05-07 23:45:15
0df860383e81f8613fc1d45b7d921f0d51f54f76...9b795193a6a7e963db62d9cd8e86752a40940520,1,3,2,5,1,2013-05-08 05:50:05,2013-05-08 05:50:05
437ce600fb2cd89817ecf9b57274a529904d1df0...02a110ad435a6ccda648f09f94e546dfd7bdd0ac,3,37,15,52,7,2013-09-26 22:01:41,2013-09-26 22:01:41
8dc84fdc48a79c70682e6c361a82d0f3e1db9a03...42e0fae98e592c296aa5726c9dfd41ef255d1299,2,22,1,23,2,2013-08-01 20:13:52,2013-08-01 18:49:54
a86a8b9752d5abb7d0e6cd69017170e826d41fb5...57e4c1783f056ce2d50a732c0fccff2a1fe99563,1,44,0,44,4,2013-09-04 19:41:05,2013-09-04 19:41:05
117eea7eaaeb5ecb77d9b7cebdb40b4e85f37374...e6604c3537e8b60d6cbc821e7d356924c0a0e809,2,2,2,4,2,2013-08-05 15:19:47,2013-08-02 22:16:40
e6604c3537e8b60d6cbc821e7d356924c0a0e809...5104d21fbdf7c7bda341d4f0ff406fb66dce839d,1,1,1,2,1,2013-08-05 15:47:06,2013-08-02 18:40:07
5104d21fbdf7c7bda341d4f0ff406fb66dce839d...0bf5ce4ef27dd24461d7b7b8049058bf80301ddf,1,1,1,2,1,2013-08-05 16:39:01,2013-08-03 14:37:15
117eea7eaaeb5ecb77d9b7cebdb40b4e85f37374...09c5ae5a503b0293205c7e6d63a739bd8d0529dc,1,1,1,2,1,2013-07-29 19:15:27,2013-07-28 16:59:42
117eea7eaaeb5ecb77d9b7cebdb40b4e85f37374...5ff0c0e8752f8613ff1143fe909b1797ad338a83,1,14,12,26,8,2013-07-26 15:55:18,2013-07-26 10:42:02
117eea7eaaeb5ecb77d9b7cebdb40b4e85f37374...1611eed6e5071acd24b97933ac0d845db87ec7df,1,1,1,2,1,2013-07-23 19:17:23,2013-07-20 16:33:20
81a199bb1cd483321962a7bfe5db33980bbf0f01...9443605b5d795122276b2c35887c9460148e2166,1,8,1,9,1,2013-07-05 07:06:22,2013-07-04 22:04:30
81a199bb1cd483321962a7bfe5db33980bbf0f01...28110d4bfc613d875231d3d7788500d876136ffc,2,30,5,35,7,2013-07-05 04:45:18,2013-07-04 17:19:43
28110d4bfc613d875231d3d7788500d876136ffc...e82bd6cc70db28dab8d0434e4033013adcd0abfa,2,22,6,28,7,2013-07-05 04:48:45,2013-07-04 17:20:34
e82bd6cc70db28dab8d0434e4033013adcd0abfa...81050ac604e27395509b5bffe80692a14d6ad3cd,2,23,2,25,2,2013-07-09 16:01:24,2013-07-09 11:16:33
81a199bb1cd483321962a7bfe5db33980bbf0f01...1a741bf73f898e6deb396dcc8b8d2d162798e616,1,4,2,6,2,2013-07-05 04:40:37,2013-07-04 22:04:52
81a199bb1cd483321962a7bfe5db33980bbf0f01...531c8dd4fb18e653d6170d367e4b23c3164d5ce0,2,0,19,19,2,2013-07-04 05:47:53,2013-06-28 15:46:19
625c3304e200f9bdc05626be1397311faa4962ba...c8556c6213cf6dca63f29f98ad9d074f6c5f8233,3,19,2,21,3,2013-10-22 17:49:43,2013-10-19 02:41:24
7e6a0cc47da79dd22c0338aee8750fda92ced5d9...c80f4c77633df44c5c8418056d2266f35978d172,1,1,7,8,5,2013-05-01 05:06:46,2013-05-01 01:09:53
c80f4c77633df44c5c8418056d2266f35978d172...181662080098e77a0fd814ffe84be605a058b5d1,1,5,3,8,3,2013-05-01 05:06:46,2013-05-01 01:09:54
181662080098e77a0fd814ffe84be605a058b5d1...aa12a431f3bb96fa01cd1efa97eb1273d9a00c0e,1,1,1,2,2,2013-05-01 05:06:46,2013-05-01 01:09:55
aa12a431f3bb96fa01cd1efa97eb1273d9a00c0e...715d64fe99885a37c38aff75eebfaf42b669d914,1,5,1,6,2,2013-05-01 05:06:46,2013-05-01 01:09:56
715d64fe99885a37c38aff75eebfaf42b669d914...f38dfc4c32507de2f7cf05350fe8b34fd4edd45d,2,57,8,65,13,2013-05-01 05:06:46,2013-05-01 01:09:57
f38dfc4c32507de2f7cf05350fe8b34fd4edd45d...38e7167e9bdc57262c7298912c4bf9df4d68f6fe,1,7,1,8,2,2013-05-01 05:06:47,2013-05-01 01:09:58
38e7167e9bdc57262c7298912c4bf9df4d68f6fe...b25df87fad2b12349a55146d5c87625109a58221,1,13,4,17,4,2013-05-01 05:06:47,2013-05-01 01:09:59
b25df87fad2b12349a55146d5c87625109a58221...5df4fad31902ba449e25c22f490526e8022a692c,1,18,17,35,16,2013-05-01 05:06:47,2013-05-01 01:10:00
5df4fad31902ba449e25c22f490526e8022a692c...95b0c60831148ca929e31b214ab3d29537ba20c9,2,138,56,194,28,2013-05-01 05:06:47,2013-05-01 01:10:01
95b0c60831148ca929e31b214ab3d29537ba20c9...42b48ef25d8c77f839d4a2d4cec9b65379ece63e,1,1,0,1,1,2013-05-01 05:06:47,2013-05-01 01:10:02
42b48ef25d8c77f839d4a2d4cec9b65379ece63e...c95c35f4b8908fcda713c09eba4e55aac2c39be6,1,15,7,22,4,2013-05-01 05:06:47,2013-05-01 01:10:03
c95c35f4b8908fcda713c09eba4e55aac2c39be6...3f6e7c0af18b5362d5d7b847d2b92ce38e72e030,1,13,2,15,3,2013-05-01 05:06:47,2013-05-01 01:10:04
3f6e7c0af18b5362d5d7b847d2b92ce38e72e030...850dd25c9a245da0e6b23c36cf9f45d6ee08b237,1,20,5,25,2,2013-05-01 05:06:47,2013-05-01 01:10:05
850dd25c9a245da0e6b23c36cf9f45d6ee08b237...248663c4ff931f1f42fb7f8233d0ae23f80c7835,1,18,2,20,5,2013-05-01 05:06:47,2013-05-01 01:10:06
248663c4ff931f1f42fb7f8233d0ae23f80c7835...a39769995050f5fe1d4907514caf9eb32ef6185a,1,13,7,20,5,2013-05-01 05:06:47,2013-05-01 01:10:07
a39769995050f5fe1d4907514caf9eb32ef6185a...38cecbdf52a081b732726180ad5e182d15117914,1,3,2,5,2,2013-05-01 05:06:47,2013-05-01 01:10:08
38cecbdf52a081b732726180ad5e182d15117914...747c9a377fb73aa30f6b4dca958e3b121f88bb66,1,3,3,6,3,2013-05-01 05:06:47,2013-05-01 01:10:09
747c9a377fb73aa30f6b4dca958e3b121f88bb66...d421c02b4144df9b0448e321930ee6a604cdd3fc,1,16,12,28,10,2013-05-01 05:06:47,2013-05-01 01:10:10
d421c02b4144df9b0448e321930ee6a604cdd3fc...081811216e99fe0396d74d8a2bd6dd3d119dccde,1,2,2,4,2,2013-05-06 16:18:52,2013-05-04 00:31:06
081811216e99fe0396d74d8a2bd6dd3d119dccde...4c00819910706aa8ae450292085e47e52c333440,1,23,15,38,3,2013-05-07 01:19:55,2013-05-04 00:31:07
7e6a0cc47da79dd22c0338aee8750fda92ced5d9...c6bc7d435b98d9dd491334cf4e46507c6fff2670,1,670,505,1175,458,2013-04-30 00:31:19,2013-04-30 00:31:19
ea21efc74082da9453167773b658ea2439ab9bca...3d092bfc6f2d9a998967979f926c661e9762601c,1,4,0,4,1,2013-10-23 20:37:27,2013-10-23 20:37:27
926eb7ba4c52fbfee9fba86c16bb6c374857190e...35ba83ccf6f83d1278b3bff56db75be9c59fee69,1,11,5,16,2,2013-03-11 17:22:56,2013-03-11 12:21:27
4a9a4f0ec1daaccb88cdf507375ca64696dfe167...6a776acabf1f83846e03acb0ccc4d14d0be5ab69,1,0,38,38,1,2013-04-28 21:04:41,2013-04-26 17:58:24
6a776acabf1f83846e03acb0ccc4d14d0be5ab69...240ae2b8c96c3b9836d516de36dacd65bea9c4a2,1,6,6,12,2,2013-04-28 21:46:52,2013-04-27 22:00:07
4a9a4f0ec1daaccb88cdf507375ca64696dfe167...54bb9015c817728371b48e908257fdf6a078eb60,1,10,3,13,5,2013-04-27 20:41:31,2013-04-26 18:55:52
54bb9015c817728371b48e908257fdf6a078eb60...2d14e13c56a407eea6084ff2d5713a8d23d337f5,3,11,4,15,4,2013-04-29 18:26:23,2013-04-29 18:16:21
2d14e13c56a407eea6084ff2d5713a8d23d337f5...b3e0c4ed07e9f76e501c67c3677776e4f257d274,1,1,1,2,1,2013-05-06 15:20:28,2013-05-06 12:35:46
1640632b4f3f69775f04e9e40dfd2fd912e0f458...980419b99306b326d44d740a95f3401e169ad943,1,2,2,4,1,2013-04-28 19:09:37,2013-04-27 19:43:36
3e7bb5da9f58a8b0d066d1511ab95b5df2f8c6b1...b71dc3e1a04666fae4a4e282973d9b5a122a997c,3,31,9,40,12,2013-04-25 16:59:34,2013-04-25 09:28:54
3e7bb5da9f58a8b0d066d1511ab95b5df2f8c6b1...abf5f8723cc65c499eb6b65b07bd935f43525b24,1,27,0,27,1,2013-04-24 20:12:48,2013-04-24 13:54:35
abf5f8723cc65c499eb6b65b07bd935f43525b24...2d2e3d25595c1bcd2259db5eb7604f196d35949f,2,2,2,4,2,2013-04-24 20:12:51,2013-04-24 13:54:36
2d2e3d25595c1bcd2259db5eb7604f196d35949f...b17dd3f9d6b1657b3fbfb40a863fc2dce5f54798,2,5,10,15,3,2013-04-24 20:13:21,2013-04-24 13:54:37
3e7bb5da9f58a8b0d066d1511ab95b5df2f8c6b1...2130bf3ca9a0ce6ea8bebaa5e3abbecb48b02c09,1,2,2,4,2,2013-04-24 16:48:01,2013-04-22 15:57:37
2130bf3ca9a0ce6ea8bebaa5e3abbecb48b02c09...7612e61e33981f48f212f6aefe3550ac724d6208,1,0,7,7,1,2013-04-24 23:05:07,2013-04-24 20:49:06
362de916c06521205276acb7f51c99f47db94727...77a6815d7d5be7031324788f9935587bdb00de60,1,77,63,140,30,2013-06-26 18:33:00,2013-06-26 10:19:46
77a6815d7d5be7031324788f9935587bdb00de60...375775bb1289a0b78f26b8ec08627fd133920ab9,1,5,3,8,4,2013-06-26 18:33:00,2013-06-26 10:19:47
375775bb1289a0b78f26b8ec08627fd133920ab9...a742f2a0a7e57bb7d3f55cb8312c3f4cc4dc68fb,1,26,22,48,10,2013-06-26 18:33:00,2013-06-26 10:19:48
a742f2a0a7e57bb7d3f55cb8312c3f4cc4dc68fb...de6029a2d7734a93a9e27b9c4471862a47dd8123,4,199,97,296,91,2013-06-26 18:40:27,2013-06-26 10:19:49
de6029a2d7734a93a9e27b9c4471862a47dd8123...ecaee8050cec23eb4cf082512e907e3e52c20b57,9,35,28,63,34,2013-06-26 18:40:31,2013-06-26 10:19:50
ecaee8050cec23eb4cf082512e907e3e52c20b57...7c37521487332fd700e2fa58bd2547d275e4f4d2,1,2,2,4,2,2013-07-01 19:28:06,2013-07-01 18:59:59
7c37521487332fd700e2fa58bd2547d275e4f4d2...14332bccc1d88e89fa8950b92c034432e1585bd4,4,18,18,36,14,2013-07-05 07:05:00,2013-07-04 12:45:46
14332bccc1d88e89fa8950b92c034432e1585bd4...f3445f781f95ca4a7d59028aa7b7457fa925f577,1,53,53,106,39,2013-07-05 18:35:39,2013-07-05 12:01:47
f3445f781f95ca4a7d59028aa7b7457fa925f577...17cc2ef1c5f160056f5ca8cf4bd795ddd9b76bd3,3,16,25,41,9,2013-07-05 18:40:18,2013-07-05 12:01:48
17cc2ef1c5f160056f5ca8cf4bd795ddd9b76bd3...0fe6df3ce8e6373536d1a9016cac9126a1aed0da,1,28,13,41,8,2013-07-05 18:43:28,2013-07-05 12:01:49
0fe6df3ce8e6373536d1a9016cac9126a1aed0da...37eb772ef3a5da0b28d3759373d714b349306ea4,1,10,16,26,8,2013-07-05 18:54:53,2013-07-05 12:01:50
9ae54a1ddebbbc8f3f12116f3ad9fd6dcf74bf02...6a907786af835ac15962be53f1492f23e044f479,1,1,1,2,1,2013-07-23 18:35:18,2013-07-23 13:16:04
76689ab83b65636a01dd34ecfb9c1382aa6e959a...9832cb9d4dc969fbfacfd1f8940fcbdec18bb930,1,14,4,18,4,2013-06-24 20:53:56,2013-06-24 20:53:03
96e2b99ed56c8433cc4aa03f32d2ef2a22748fc0...ac1998deddbb5b59c80f2a3d902e18b31fe9cc50,1,1,1,2,1,2013-07-29 17:32:03,2013-07-29 04:24:43
0aaf62b6e018484bad9cea47dc00644d57b7ad49...c3c327deeaf018e727a27f5ae88e140ff7a48595,2,21,0,21,2,2013-06-02 21:54:38,2013-05-29 20:32:36
f2be2a51f2bb168042fcacf7476736da25571ead...992c38644a4b001bdc89b5b5008fc5f6674ed5b7,3,88,2,90,3,2013-08-30 17:16:16,2013-08-30 17:16:16
a0d3f1090d90c895b785a6729ed2a2af25335a39...1d905f74fd2b05dcbc768acbb5426dc11fb00f6f,2,35,2,37,3,2013-09-24 19:42:21,2013-09-24 19:32:30
425df881e08bed7a8fcc9a23f452cff792f9ec6c...f2e087395b78d5828af400072c1b621e1a373be4,4,142,48,190,34,2013-08-26 16:05:22,2013-08-26 07:02:48
f2e087395b78d5828af400072c1b621e1a373be4...f223459bec106bbe211a01321e48c050a9cad25e,3,42,9,51,9,2013-08-26 16:07:53,2013-08-26 07:02:49
425df881e08bed7a8fcc9a23f452cff792f9ec6c...c1ebd90c832e28ff27654c21f9985aebe986352d,3,2,40,42,7,2013-08-14 16:53:43,2013-08-14 16:53:43
c1ebd90c832e28ff27654c21f9985aebe986352d...2c2b6646c2723459dbd334c7ced6f77ffb0d596e,5,0,28,28,7,2013-08-14 22:04:24,2013-08-14 17:57:24
425df881e08bed7a8fcc9a23f452cff792f9ec6c...e28f7641592c5b907df2f084112fa22a31500810,1,3,1,4,2,2013-08-13 21:37:30,2013-08-13 18:27:58
749f763dbbe4dbcc4082f02bf98bfc1a09427c6f...98e023dea40a0eca8a61c037dfc59aaf27f003a4,20,23,23,46,23,2013-07-29 19:32:25,2013-07-29 08:18:21
9bfff3ae5fdf1dcd0705056f7f9a42e81548797e...dc89689e86c991c3ebb4d0b6c0cce223ea8e6e47,1,1,1,2,1,2010-01-02 18:40:55,2010-01-02 16:35:32
17a9ac7d6b5f27eb5f8efee324e88db2b6ec9bd6...e9fc64c60a71a190016a9e9bcb81195a0fa0d9f4,1,2,2,4,2,2012-05-24 18:29:07,2012-05-24 06:12:24
2e987f92408f5ddd20246d7d9553b57d90767d54...4510165934eba7be94dea822e2fb1cfa89e70ca3,1,3,18,21,8,2011-05-27 18:00:35,2011-05-27 13:49:59
4510165934eba7be94dea822e2fb1cfa89e70ca3...e8dd0e4063da6d0eecef1a6db99534e41f74b32e,1,4,9,13,4,2011-05-27 18:00:39,2011-05-27 13:50:00
e8dd0e4063da6d0eecef1a6db99534e41f74b32e...42ab5d40deb6dff37705ce5aa16ac69d859a04e1,1,40,15,55,15,2011-05-27 18:00:42,2011-05-27 13:50:01
40e2524da9f9fb2806a66a694b9aee722ea3ef0a...fb6e4e1f3f048898677f3cf177bfcaf60123bd5c,2,1,2,3,3,2007-11-12 01:04:59,2007-11-08 07:03:06
40e2524da9f9fb2806a66a694b9aee722ea3ef0a...4307234a4ea64ec56d017cfa737f986f4afcbf2a,1,3,3,6,1,2007-11-12 01:00:07,2007-11-09 00:36:06
4307234a4ea64ec56d017cfa737f986f4afcbf2a...fed1b5cac0cc3ae324dc004181a276ea16589951,1,82,0,82,1,2007-11-12 01:00:08,2007-11-09 09:12:28
40e2524da9f9fb2806a66a694b9aee722ea3ef0a...db7244bd5be12e389badb9cec621dbbcfa11f59a,3,59,18,77,21,2007-11-12 00:54:15,2007-11-07 10:20:27
db7244bd5be12e389badb9cec621dbbcfa11f59a...d11d44faee3334755b2b66618494cd901d226d6f,1,16,28,44,8,2007-11-12 00:54:15,2007-11-07 10:20:28
d11d44faee3334755b2b66618494cd901d226d6f...9fac800cae287256cea0512f5c5effae7a7aa784,1,10,9,19,4,2007-11-12 00:54:15,2007-11-07 10:20:29
9fac800cae287256cea0512f5c5effae7a7aa784...68dce6e941af73be34bccfe2be335b7887955ee5,1,3,9,12,4,2007-11-12 00:54:15,2007-11-07 10:20:30
68dce6e941af73be34bccfe2be335b7887955ee5...8f67f8aefb1b751073f8b36fae8be8f72eb93f4a,15,155,149,304,111,2007-11-12 00:54:15,2007-11-10 19:05:14
8f67f8aefb1b751073f8b36fae8be8f72eb93f4a...d054680c7d245b71ebba0dd030fd13dce213559a,1,63,53,116,8,2007-11-12 00:54:15,2007-11-07 10:20:32
96249c04c07f00485a3ed1052ff10b27ab147fc5...f76734902bba47afff622068524a0c38f642d769,1,64,17,81,10,2007-11-05 21:24:18,2007-11-05 05:11:15
f76734902bba47afff622068524a0c38f642d769...3b70da2b17dc5b7df644701a96a141d8f7c5ea15,1,0,4,4,2,2007-11-05 21:24:18,2007-11-05 05:11:41
3b70da2b17dc5b7df644701a96a141d8f7c5ea15...b50fa2bd061c3bb21f2918849ece43ac9ca2c504,1,2,1,3,1,2007-11-05 21:24:18,2007-11-05 05:12:18
b50fa2bd061c3bb21f2918849ece43ac9ca2c504...6738c8194286fa0017f72cb57628dcae9ec07b27,2,45,2,47,2,2007-11-08 09:43:34,2007-11-08 09:38:12
96249c04c07f00485a3ed1052ff10b27ab147fc5...40cb4fab720807f8525fb125e6c4ddc802ee8ed1,1,10,41,51,3,2007-11-03 05:40:44,2007-10-30 02:03:42
40cb4fab720807f8525fb125e6c4ddc802ee8ed1...8951d7c1f1ae38f34617b6c2490bf65e73e371f7,5,9,9,18,11,2007-11-05 20:25:42,2007-11-04 20:51:17
8951d7c1f1ae38f34617b6c2490bf65e73e371f7...7c2c6ee7e0259d591acb3d9841cf5417e6b7a8eb,2,57,1,58,3,2007-11-07 06:51:04,2007-11-07 01:29:20
4eb39e9bcccc54eb23af8a7e2676c63e5bf32866...bb4e3527b5d59a2db406dfa6519927a97d61770d,1,0,1,1,1,2007-12-09 10:24:51,2007-12-09 10:14:39
bb4e3527b5d59a2db406dfa6519927a97d61770d...cc2d6b88f99cb9e00102a509f6069168ff84f08e,1,0,7,7,1,2007-12-09 10:39:53,2007-12-09 08:21:34
cc2d6b88f99cb9e00102a509f6069168ff84f08e...ace72086bbe1cd59bc15a0e5b043bdb98335af00,1,3,2,5,2,2007-12-09 20:18:37,2007-12-09 17:17:28
ace72086bbe1cd59bc15a0e5b043bdb98335af00...cc3530e8f3f512dd407f64caf2c9916cb26afbc2,2,14,32,46,10,2007-12-09 20:18:42,2007-12-09 17:04:57
cc3530e8f3f512dd407f64caf2c9916cb26afbc2...3d3c4f5d767b33cdaa7557ab009ab1194ff4a8a3,1,21,18,39,8,2007-12-09 20:18:42,2007-12-09 20:16:55
3d3c4f5d767b33cdaa7557ab009ab1194ff4a8a3...80f86605baaa37f962755ccd771eb879a9c43865,1,175,43,218,9,2007-12-10 08:05:52,2007-12-10 07:33:26
80f86605baaa37f962755ccd771eb879a9c43865...cf7e147cce9248e34b2e926d813c975c539aeaa6,1,57,33,90,7,2007-12-10 08:05:52,2007-12-10 07:42:45
cf7e147cce9248e34b2e926d813c975c539aeaa6...591aa2536fdbc4090ba8d4ca512d4ee7df4bf05d,1,19,6,25,5,2007-12-10 08:08:05,2007-12-10 08:07:18
071a8877662974f588dfc0b1ac7df2764b7e0337...9ad7c5ae8ae4625bfe32d910b0b480cfea9819e0,3,33,18,51,13,2007-10-28 21:06:39,2007-10-27 06:09:48
9ad7c5ae8ae4625bfe32d910b0b480cfea9819e0...3697c5f37a8b7b15d0a3be51d05147654a951115,1,1,1,2,1,2007-10-28 21:08:28,2007-10-28 10:05:11
3697c5f37a8b7b15d0a3be51d05147654a951115...6df023884b87ef140829d78b67fab90a7f9b1211,1,1,1,2,1,2007-10-28 21:08:28,2007-10-28 10:05:45
6df023884b87ef140829d78b67fab90a7f9b1211...2f6e86a86fb9830c0c3205a317f6205f156cfacc,1,5,2,7,2,2007-10-28 21:08:28,2007-10-28 10:06:27
2f6e86a86fb9830c0c3205a317f6205f156cfacc...d53a35020d380c199b010c9884ab15995f8e982b,1,1,0,1,1,2007-10-28 21:08:28,2007-10-28 10:07:14
d53a35020d380c199b010c9884ab15995f8e982b...3b27428b9d3d8dc1c3f00da0ab94a1c7555a9265,1,10,16,26,7,2007-10-29 18:39:42,2007-10-29 07:00:32
3b27428b9d3d8dc1c3f00da0ab94a1c7555a9265...8371d8fd094548c1d02b8583fdbff8204a725ffc,1,4,1,5,2,2007-10-29 19:53:50,2007-10-27 16:53:29
d3f3ab264fa2c332fc451a5f97e25fc5c0551f1a...6dd14366d9478fdb3b459e1b39e384deb5f38f9f,1,42,12,54,4,2007-09-26 00:30:12,2007-09-25 12:44:38
6dd14366d9478fdb3b459e1b39e384deb5f38f9f...2dbbc45730cd85e311a1bff38a07148a423a4f1e,1,0,11,11,1,2007-09-26 00:37:31,2007-09-25 13:05:28
2dbbc45730cd85e311a1bff38a07148a423a4f1e...4d84aff356d9c6d86a8d621ee577283ed70e145e,1,4,5,9,1,2007-09-26 00:37:35,2007-09-25 13:05:29
4d84aff356d9c6d86a8d621ee577283ed70e145e...b06743925c3022ffbbd459431531709df13bbf38,2,2,2,4,2,2007-09-26 06:38:42,2007-09-26 04:12:46
b06743925c3022ffbbd459431531709df13bbf38...bce92405aebf217a4738bab0df89516910818e68,1,2,1,3,1,2007-09-26 06:39:01,2007-09-26 05:02:28
bce92405aebf217a4738bab0df89516910818e68...102c2338da0b0954a04742f5cbe307fa6b49f225,3,26,24,50,3,2007-09-26 20:42:10,2007-09-11 03:17:28
102c2338da0b0954a04742f5cbe307fa6b49f225...26b28007689d27a921ea90e5a29fc8eb74b0d297,3,31,21,52,14,2007-09-26 20:42:10,2007-09-17 22:34:06
7840ce6cb24a9d65152d45e08f5d7cf7dc97a2e3...209471493afbf30d5c1fc80feadfc4836b86dc42,1,4,0,4,1,2007-10-20 15:12:02,2007-09-13 20:10:18
209471493afbf30d5c1fc80feadfc4836b86dc42...d9a5f25b67951eb68e80d872611542b58ce5aa33,1,11,1,12,4,2007-10-20 15:12:16,2007-10-16 05:15:06
d9a5f25b67951eb68e80d872611542b58ce5aa33...43db492a8eb701dd157f88ae9ca38d366c280761,1,3,2,5,2,2007-10-21 02:29:36,2007-10-20 07:21:34
4a44b9ea51ef5183245c23473a33714a62ed224d...41d8a5f0f7db6e1d92f925234eb8c55d2d34a5af,1,4,4,8,2,2007-11-18 23:22:51,2007-11-18 23:22:51
5d3d1cacc139194672a6a184509bb620a19b2497...ea55960518bb104020c02aa2f64b33f93d1775e7,1,12,1,13,4,2007-11-19 00:24:14,2007-11-19 00:24:14
c4316674c48708ca62876470c615101ab8fee2e0...92b7ba16b7605f70cac845d4a8d0162392ac0223,1,34,4,38,7,2007-11-25 03:54:25,2007-11-25 01:42:36
92b7ba16b7605f70cac845d4a8d0162392ac0223...757f58ed380a17225e8de9f461083a21d0a2c97c,1,1,13,14,3,2007-11-25 23:56:55,2007-11-25 23:15:48
757f58ed380a17225e8de9f461083a21d0a2c97c...84ef033832af9e0be886214c70b2006b08630072,3,5,5,10,5,2007-11-26 00:53:32,2007-11-21 20:59:14
906ab7f6c03764423adef6c0e4d77442405adc23...96f11953c0b0b9b0a0c75fb98bdf239dce5ff582,1,1,0,1,1,2007-10-08 00:15:27,2007-10-06 13:27:22
e73bfa7709b108575e6ea73d6e97fc3efd967b38...1952aa1d5735ccbedd832620e43db3e03fc77088,1,10,0,10,5,2007-10-03 04:21:50,2007-10-02 16:52:22
182be0d397cec4ec7f649978653f48c497d43d72...10813e0d3c72671e24407ef4bd43b74f60445089,1,13,1,14,6,2013-08-13 17:47:44,2013-08-12 07:58:11
10813e0d3c72671e24407ef4bd43b74f60445089...cdb6b5ac67a48e6d25eb44dd2d632b60cfc7b743,1,3,1,4,2,2013-08-13 17:49:06,2013-08-12 08:12:09
ba158a32b9e237912ebe7dfe7bd56e2c531cb062...6f9f3b263b1c86889d6fae0d50c75be0f3227003,1,6,2,8,3,2006-11-04 10:35:17,2006-11-04 10:28:53
ab3bb800b46cf66249ead9e13c22cbc48d790c9a...6bee4e408c097a4f0c4a091f13dacabe7c766025,1,1,0,1,1,2006-11-29 18:33:25,2006-11-15 21:52:25
6bee4e408c097a4f0c4a091f13dacabe7c766025...665892307013bccacb35dd619ae6951c7b209379,1,24,5,29,6,2006-11-29 18:34:18,2006-11-29 08:17:01
665892307013bccacb35dd619ae6951c7b209379...eb07fd59acae0f043b9fac2a8a1cb427036c6f71,1,6,0,6,1,2006-11-29 18:34:20,2006-11-29 08:25:40
a2036d7e00ad8aa16ba010a80078e10f0e4568a3...c049b61d42bbdbe5bf938c0fc13ad09970a945df,1,1,1,2,1,2014-03-13 17:54:21,2014-03-13 11:45:31
903147923e16d595bd78ec78f6940ba5d82f80e7...1f32de1e14a9e11385afcdfd66c0cab8a3933177,1,1499,1217,2716,1141,2013-11-09 18:08:23,2013-07-02 12:09:37
903147923e16d595bd78ec78f6940ba5d82f80e7...eadd122b5e88727b3499ea10fcc695f534354be8,1,1513,1230,2743,1159,2013-11-08 22:27:57,2013-11-01 14:35:08
e29e1147e485654d90a0ea0fd5fb7151bb194265...1706306a54cfb5f1bf65f2b054aab2a5a7dba8e7,1,8,12,20,2,2006-03-03 06:12:33,2006-03-03 06:11:25
c40610422e1157e71dbc3c1a2f9e19bbe117962f...fc675b8cd5ac102651c322e05d27c4fa7609f7a6,1,485,365,850,48,2006-03-02 23:10:39,2006-03-02 21:28:17
7ae0b0cb65f069b657155abcb6aa6780b93ce881...64bc6e3db54ef9e2accfdb8e6c8168f789946fcb,2,16,14,30,2,2006-03-02 23:24:01,2006-03-02 23:24:01
53dc4636275c966bb0781709fd0dded1cced4458...55258b5c20d3647f44e1bb3c69e39966b2c07619,1,3,0,3,1,2006-03-18 04:42:28,2006-03-18 00:21:39
55258b5c20d3647f44e1bb3c69e39966b2c07619...dd1811199ed01280f882f9907e743153b4a2c937,1,7,3,10,4,2006-03-18 04:42:30,2006-03-18 00:24:37
dd1811199ed01280f882f9907e743153b4a2c937...81ea3ce2ace4d8b76dbfe2aa6b4199472115a115,1,13,5,18,3,2006-03-18 04:42:31,2006-03-18 00:24:49
81ea3ce2ace4d8b76dbfe2aa6b4199472115a115...228382aee45ec7f17db220e9099b46347ba2e1c7,1,3,3,6,3,2006-03-18 04:42:33,2006-03-18 00:25:30
228382aee45ec7f17db220e9099b46347ba2e1c7...5bfc4f23bca0a89e50853b2bdaa6d0118045a9f6,1,4,0,4,1,2006-03-18 04:42:35,2006-03-18 00:25:09
5bfc4f23bca0a89e50853b2bdaa6d0118045a9f6...beb8e1343745e99988b84b05d257ef3171f127be,1,1,1,2,1,2006-03-18 04:42:36,2006-03-18 00:25:46
beb8e1343745e99988b84b05d257ef3171f127be...71bb10336fa79ff667f4753668aaa72b6ebfc689,1,13,10,23,6,2006-03-18 04:42:38,2006-03-18 00:26:01
71bb10336fa79ff667f4753668aaa72b6ebfc689...5a1fb2ca92caaa7ae9044ab81dc102f59d17b97a,1,16,1,17,2,2006-03-18 04:42:39,2006-03-18 03:45:07
53dc4636275c966bb0781709fd0dded1cced4458...a9698bb22fb7b66e5882c3a5e7b2b8b53ea03f90,1,1,0,1,1,2006-03-17 22:10:36,2006-03-17 06:04:18
53dc4636275c966bb0781709fd0dded1cced4458...cb85bfe5dfd7504dfee43ae49a76edb92e8d8eb0,2,25,3,28,6,2006-03-17 22:10:24,2006-03-07 13:52:02
cb85bfe5dfd7504dfee43ae49a76edb92e8d8eb0...ad0cae4cb9364b02b74b17f98f818a8e07372693,2,24,4,28,7,2006-03-17 22:10:24,2006-03-07 19:59:17
53dc4636275c966bb0781709fd0dded1cced4458...8a5f2eac5271ba1efed353c0c0a992d6471a8d05,1,17,1,18,3,2006-03-17 22:10:16,2006-03-17 22:08:39
8c3222079a9aca6622c6098a9157e59dddb1cfff...a41e109c4bcd56537fc3801623b1aa0dd4e06f1c,1,8,3,11,1,2006-03-12 21:39:31,2006-03-12 21:39:31
dfeff66ed9a3931d60f3cd600ad8c14b5cc3d9e5...47874d6d9a7f49ade6388df049597f03365961ca,1,31,19,50,15,2006-03-21 08:14:13,2006-03-21 08:14:13
e9b5b75ca87f45292de8ecde5d4d0512ac9542cd...fdeb6bf55b7c578ce1735092c6dfbf6968cbee5c,1,21,0,21,1,2006-04-26 09:27:59,2006-04-26 09:27:59
fdeb6bf55b7c578ce1735092c6dfbf6968cbee5c...2d86d2c6fcbd62696447fe3dbfac664e6c82b0ce,1,1,1,2,1,2006-04-26 10:12:58,2006-04-26 10:12:58
2d86d2c6fcbd62696447fe3dbfac664e6c82b0ce...3496277a561307c3d31d2085347af8eb4c667c36,1,1,1,2,1,2006-04-26 10:18:51,2006-04-26 10:18:51
e9b5b75ca87f45292de8ecde5d4d0512ac9542cd...710158e3ca3f45a30e08a50dadf427fe95311b9c,1,14,4,18,5,2006-04-26 06:40:09,2006-04-26 06:40:09
e1cbc46d12a0524fd5e710cbfaf3f178fc3da504...5348b6e7f4f07b75b2ea23a3c8fee62919fa254c,1,8,8,16,8,2006-04-26 06:59:28,2006-04-26 06:59:28
08abe669c05521499149dbf84fedefb04a8fa34d...f6c7081aa97aa67baa06390a1ef36088c33bf010,1,41,37,78,19,2006-04-27 04:23:03,2006-04-27 03:58:00
6a74642c500118164ec331da93ef29b1163301bc...f527cb8c38964a90b1b13485f2ad46b72960d387,1,1,1,2,1,2006-04-21 06:36:22,2006-04-21 06:36:22
f527cb8c38964a90b1b13485f2ad46b72960d387...d598075e52634665bd25a80b085e300d338d21f5,1,3,1,4,2,2006-04-21 06:41:24,2006-03-27 11:26:01
d598075e52634665bd25a80b085e300d338d21f5...757319309ac26d136d6f21a40c81fb53073c5dc9,1,7,5,12,5,2006-04-21 07:09:28,2006-04-21 07:06:58
757319309ac26d136d6f21a40c81fb53073c5dc9...0dec30b9788b12fdae5d5b69fc366a28bb688d80,1,1,1,2,1,2006-04-21 07:45:10,2006-04-20 21:25:37
4262c1b0c38613a8c5ae729bd4d3f18f0df3ec44...5119602a99f46aaa7b3bb2a0f5085b1df46b54ec,1,66,1,67,4,2006-04-19 04:52:41,2006-04-18 23:45:16
3eefc189172b88dece6fb6d479b3ed13cc483dbc...4c4b158b8f31a19f724a84b11fa538bfbf465d32,1,1,1,2,1,2006-04-19 22:16:08,2006-04-19 22:16:08
f327dbced25a3c6fcc0b84d2d6adffa9343b09f0...dfdcb558ecf93c0e09b8dab89cff4839e8c95e36,2,3,3,6,3,2006-04-14 02:05:38,2006-04-14 02:05:38
f327dbced25a3c6fcc0b84d2d6adffa9343b09f0...295ba2fb894be23cd1d1b0b34186e694b8e36076,2,110,5,115,7,2006-04-13 23:48:45,2006-04-13 23:45:13
f327dbced25a3c6fcc0b84d2d6adffa9343b09f0...d75f7952ef56408baa03ff82ded52b9289249d5a,4,226,7,233,18,2006-04-13 23:48:24,2006-04-13 22:15:30
d75f7952ef56408baa03ff82ded52b9289249d5a...ece634d1478a9f1bf19eed8a6b7dee305fadd46e,1,5,5,10,5,2006-04-13 23:50:02,2006-04-13 23:09:48
561d038ab8adb2bab5ba368b88e620be18c4811b...67c22874cf82edae9b5c5f0a47c432d08d7ad426,1,15,0,15,2,2006-10-19 00:10:11,2006-09-27 03:32:19
b86bec6c4ff7909246e68a4495dcaaeede3907e9...fb6a9f93d39e4e5fdb83673a927f71a34e9fb7c0,1,8,3,11,4,2006-06-08 07:37:41,2006-06-08 06:50:09
fb6a9f93d39e4e5fdb83673a927f71a34e9fb7c0...c9bc159d7f41e2916830b05529c1ce06a81d975f,3,12,2,14,5,2006-06-08 18:57:00,2006-06-08 18:14:47
c9bc159d7f41e2916830b05529c1ce06a81d975f...2048bb00ee3937808ce9f0c8f59d71a9b46ab56f,1,10,5,15,1,2006-06-08 23:19:37,2006-06-08 08:17:01
2048bb00ee3937808ce9f0c8f59d71a9b46ab56f...7612a1efdb0c0806b43db10ce784707aae874340,1,10,7,17,4,2006-06-09 04:11:25,2006-06-09 04:11:25
fb69a760cc9103d1f8341a3c8ea09bd15a8a412d...6f81bf16a91c4db5a02b81cbade89e73ca4d49b4,1,3,1,4,2,2006-05-06 21:03:09,2006-05-06 18:14:02
6f81bf16a91c4db5a02b81cbade89e73ca4d49b4...bd886fd3ea49b726493255d4adf5d20b31681713,1,31,0,31,1,2006-05-06 21:03:13,2006-05-06 19:43:43
fb69a760cc9103d1f8341a3c8ea09bd15a8a412d...83e77a25dc194933c0fb7908ab6d9fb84a5045e2,3,131,4,135,8,2006-05-06 05:57:27,2006-05-06 00:40:47
83e77a25dc194933c0fb7908ab6d9fb84a5045e2...22293b9c41778bb60f3b07355e1b8e421a503702,2,13,2,15,4,2006-05-06 06:11:29,2006-05-06 06:09:05
0660626caff6ac3745cd7b7908a2ca540141a2ec...42d0ee8302c361a0e3bde7bc59858eda94bc13a4,2,85,0,85,1,2006-05-06 07:15:54,2006-05-06 07:15:54
8824689884a5673f803d77cda499f83b84145a06...2b1f4247ab5881cfde1d35ca3e3c48b7de8f449c,2,7,1,8,2,2006-05-21 09:05:41,2006-05-21 01:54:46
2b1f4247ab5881cfde1d35ca3e3c48b7de8f449c...87a56cd3b1dfb651076fbdc6d3591a32d1286a03,1,2,0,2,1,2006-05-21 09:07:43,2006-05-21 02:03:14
87a56cd3b1dfb651076fbdc6d3591a32d1286a03...9e848163eda686093f689c25cfa9937ed2a9fdf8,1,1,1,2,1,2006-05-21 10:01:59,2006-05-21 10:01:59
9e848163eda686093f689c25cfa9937ed2a9fdf8...fbd01abf50488d8ed94c36bdd5bfc2a4ddafb8a2,1,1,1,2,1,2006-05-21 23:40:45,2006-05-21 20:45:46
fbd01abf50488d8ed94c36bdd5bfc2a4ddafb8a2...6ba68ab2884e6c1db942e3bff63d4aa0bf354094,2,203,0,203,2,2006-05-21 23:44:36,2006-05-21 21:37:00
6ba68ab2884e6c1db942e3bff63d4aa0bf354094...67e6e5c4e79895b34d0d47ef71e1d882f06fb6f7,1,6,6,12,6,2006-05-22 00:15:19,2006-05-21 20:52:34
67e6e5c4e79895b34d0d47ef71e1d882f06fb6f7...f1fe3846e4236a05879d7f84b11ae8ea64dd8d0d,1,112,53,165,24,2006-05-22 00:15:40,2006-05-21 20:54:05
f1fe3846e4236a05879d7f84b11ae8ea64dd8d0d...e31952da5c52a4c1e028de634204c6bc2504771f,3,414,6,420,4,2006-05-22 00:15:43,2006-05-21 23:49:34
e31952da5c52a4c1e028de634204c6bc2504771f...d5e3d60c200b214e36eacfb3de21044a7efd1971,1,2,2,4,2,2006-05-22 00:37:25,2006-05-22 00:37:25
6becd7da8786555fbd2aeeb9669d37dc810f2658...f8f135c9bae74f846a92e1f1f1fea8308802ace5,3,5,5,10,5,2006-02-15 21:03:27,2006-02-15 20:47:43
6becd7da8786555fbd2aeeb9669d37dc810f2658...45e48120bb591b9ef156026ae7498ebd6a144962,1,11,0,11,1,2006-02-15 09:56:55,2006-02-15 09:05:59
babfaf8dee0baa09c56d1a2ec5623b60d900518b...41ff7a1076e9282535f77ddfb4e23a95354009fd,1,4,0,4,2,2006-02-18 00:16:49,2006-02-17 21:33:24
41ff7a1076e9282535f77ddfb4e23a95354009fd...eedf8f97e58bbf4717705900379f2d63134047f9,1,17,6,23,2,2006-02-18 00:16:53,2006-02-17 21:33:26
eedf8f97e58bbf4717705900379f2d63134047f9...b5b16990f8b074bd0481ced047b8f8bf66eee6dc,2,6,1,7,3,2006-02-18 00:20:51,2006-02-18 00:14:52
b5b16990f8b074bd0481ced047b8f8bf66eee6dc...44de0da4f908b6600647673e1236b0ca504a9c15,1,3,3,6,2,2006-02-18 01:33:11,2006-02-18 01:10:53
44de0da4f908b6600647673e1236b0ca504a9c15...735d80b3bf1be9513d030e61af1ef6512cec015a,1,8,0,8,1,2006-02-18 01:33:12,2006-02-18 01:11:36
949964c4af740015c53cb7630fea8795e0f710a0...2fabd217330ea6a5b5082e9e86b169e3401de889,2,4,6,10,4,2006-01-20 07:14:31,2005-11-15 05:59:50
2fabd217330ea6a5b5082e9e86b169e3401de889...e7555785f4edcf4988c53305349e3f525216e2cb,1,1,1,2,1,2006-01-20 07:24:34,2006-01-20 06:47:39
e7555785f4edcf4988c53305349e3f525216e2cb...abb9ae95f4e65911561b40ab9f38a27e5677ca7d,1,9,1,10,2,2006-01-20 21:34:12,2006-01-20 19:00:18
abb9ae95f4e65911561b40ab9f38a27e5677ca7d...e72c9f5c5482b8b83dc57ed369b0fce4f823a1f2,1,4,8,12,3,2006-01-21 20:22:02,2006-01-21 19:06:19
e72c9f5c5482b8b83dc57ed369b0fce4f823a1f2...8e76c79f4a1e66ed8e371d1232e879f45141dce1,1,3,8,11,1,2006-01-21 20:36:12,2006-01-21 20:36:12
8e76c79f4a1e66ed8e371d1232e879f45141dce1...8278ac2f4a50a8aca0dca490d2b8b99b11e266e1,2,5,5,10,3,2006-01-22 03:11:51,2006-01-21 23:54:11
8278ac2f4a50a8aca0dca490d2b8b99b11e266e1...a325957062b19b49ad75569c59771787c83c350d,1,4,0,4,1,2006-01-22 03:12:03,2006-01-22 00:22:30
a325957062b19b49ad75569c59771787c83c350d...eff351c957975055643f2e1359652ab3aac30256,1,26,2,28,2,2006-01-22 03:24:55,2006-01-21 23:54:12
eff351c957975055643f2e1359652ab3aac30256...bdc37f5a817543fc5eaf16dd6f30dd7b821adc70,1,11,1,12,2,2006-01-22 03:33:22,2006-01-20 01:13:32
bdc37f5a817543fc5eaf16dd6f30dd7b821adc70...35a730f01c6caba93d452fa938e7d93ffcc4cf25,2,17,2,19,6,2006-01-22 03:33:22,2006-01-20 01:13:51
35a730f01c6caba93d452fa938e7d93ffcc4cf25...63be37b06fa873348c3de0becea201796bc88610,2,8,1,9,4,2006-01-22 03:33:22,2006-01-20 01:13:57
63be37b06fa873348c3de0becea201796bc88610...5df9140c92349a807952628a04ee94b65c5bead5,1,1,1,2,1,2006-01-22 03:33:22,2006-01-20 21:17:59
5df9140c92349a807952628a04ee94b65c5bead5...0bdd79af62e8621359af08f0afca0ce977348ac7,1,4,0,4,1,2006-01-22 03:33:22,2006-01-20 21:33:20
0bdd79af62e8621359af08f0afca0ce977348ac7...5b2bcc7b2d546c636f79490655b3347acc91d17f,2,36,13,49,12,2006-01-22 03:34:11,2006-01-20 23:00:12
5b2bcc7b2d546c636f79490655b3347acc91d17f...927a503cd07718ea0f700052043f383253904a56,2,2107,1703,3810,103,2006-01-23 05:52:33,2006-01-23 04:57:25
927a503cd07718ea0f700052043f383253904a56...76b927f19f207b3f71b1c675bd75680aaedcb001,1,20,0,20,1,2006-01-23 06:05:54,2006-01-22 21:32:45
76b927f19f207b3f71b1c675bd75680aaedcb001...dcc6e28f70574bf3756752f114b5119c5cb43375,3,5,3,8,4,2006-01-23 06:43:59,2006-01-23 06:43:59
dcc6e28f70574bf3756752f114b5119c5cb43375...8a3ee7c31469b5418a556a87cbac74509ded1cac,1,65,6,71,6,2006-01-25 01:27:33,2006-01-04 16:17:59
8a3ee7c31469b5418a556a87cbac74509ded1cac...41e79c955969c916c0691c31422b5004db7e4025,1,1,1,2,1,2006-01-25 01:38:06,2006-01-25 01:37:01
41e79c955969c916c0691c31422b5004db7e4025...941c9449999192e2d338ee204f4153e30ae43829,3,8,4,12,5,2006-01-25 07:16:31,2006-01-25 06:52:22
d425142e2a045a9dd7879d028ec68bd748df48a3...ffd97f3a35d8394773409f17d58156b32ca911cf,2,70,6,76,7,2006-01-16 05:13:22,2006-01-12 23:38:59
ffd97f3a35d8394773409f17d58156b32ca911cf...8cd162114990a4b36aeefc672dedc597c2eacbf0,1,20,9,29,5,2006-01-16 05:13:22,2006-01-15 11:30:30
a575603af20a795584d79b32c30bda10fcae5d3f...3200d1aee0c22a34d075aafefe3e92f4f7d08840,1,18,6,24,1,2005-11-18 05:14:29,2005-11-18 04:46:29
3200d1aee0c22a34d075aafefe3e92f4f7d08840...d2ac1cd263d1856938b5223ef96d8b1eb7db4ccd,1,1,1,2,1,2005-11-18 05:28:39,2005-11-17 15:40:22
d2ac1cd263d1856938b5223ef96d8b1eb7db4ccd...0adb3358f6538aaa9006f4068d6757cd506afcdd,1,3,3,6,3,2005-11-18 05:28:45,2005-11-17 14:34:47
0adb3358f6538aaa9006f4068d6757cd506afcdd...751a71e2b5f3667ab7ffffccad3e2b58726eb1c9,1,48,12,60,10,2005-11-18 05:29:12,2005-11-17 13:11:56
751a71e2b5f3667ab7ffffccad3e2b58726eb1c9...6b7b0427728fe31ee2d9375a36f1c27974432979,1,17,1,18,2,2005-11-18 06:34:50,2005-11-17 20:36:30
6b7b0427728fe31ee2d9375a36f1c27974432979...087b6742fcab74f7a53626b98969bed27d288e2b,2,30,14,44,13,2005-11-18 06:36:31,2005-11-17 00:46:24
4fe10219bca6b010e2103116c653928992d5141b...3cab02de5087447e1c48ada03a0db0fffc89e920,1,7,5,12,4,2015-01-23 23:06:24,2015-01-23 19:49:05
4fe10219bca6b010e2103116c653928992d5141b...1be111d88f526130dcf3b7c7ad0f5df17c6d2bae,1,1,51,52,2,2014-10-19 22:07:07,2014-10-17 00:44:30
1be111d88f526130dcf3b7c7ad0f5df17c6d2bae...edfbb2aa538148b38ee0ba6d62c95b7edda5d817,1,10,10,20,9,2014-10-19 22:07:07,2014-10-17 00:44:35
edfbb2aa538148b38ee0ba6d62c95b7edda5d817...c90f9e13abae630551ada3e895633bdc2cf4e080,3,22,0,22,5,2014-10-19 22:07:07,2014-10-17 00:44:49
c90f9e13abae630551ada3e895633bdc2cf4e080...b1e757f36377df1f2a6c165ebf171b09a8ad957b,1,2,0,2,1,2014-10-19 22:07:07,2014-10-17 00:44:54
b1e757f36377df1f2a6c165ebf171b09a8ad957b...d7702be1e1c003a9a26ab60bb302c32b398e033d,2,0,15,15,2,2014-10-19 22:27:24,2014-10-18 21:36:12
d7702be1e1c003a9a26ab60bb302c32b398e033d...189a1222493f73977291f57d0f2030e982aff282,2,1,7,8,2,2014-10-19 22:28:30,2014-10-19 02:03:19
5d222c099e38bcf329af544ec42ad3dd0644741c...45917f0f994aee78dccf2a41000b48fc23db1a0b,1,1,1,2,1,2015-02-12 20:31:28,2015-02-12 10:10:01
c490a6079021a3343ca5b042b37258858fdefbfc...28b3cffcecb0ad70b4b77eb6edfa89d027a5ab9c,1,1676,1396,3072,1321,2013-07-26 06:40:28,2013-07-26 00:56:45
28b3cffcecb0ad70b4b77eb6edfa89d027a5ab9c...e06dc12a835a662797a291b7455196f2bd11efc8,1,1876,1507,3383,1376,2013-07-27 02:54:25,2013-07-27 01:46:06
e06dc12a835a662797a291b7455196f2bd11efc8...2e8451e8602380a8a129f21da6364f3ea879e6a9,1,1851,1449,3300,1333,2013-08-03 06:14:07,2013-07-26 06:00:02
c490a6079021a3343ca5b042b37258858fdefbfc...8f6a3e5d71fa1800c3f330bab2b6b6399ec7aea7,1,0,2,2,1,2013-07-25 23:06:23,2013-07-25 20:01:00
d9857bfd4de097d662d40481664ef30577f120f5...6cb5728c43f34a7348e128b44b80d00b9417cb19,3,38,1,39,3,2013-07-03 17:15:15,2013-07-03 09:02:02
3f419d45ef0dfc33dc301d9ae4737043c091291a...6654754779d2a90af91a9c6b93d7e4e7ee16cfab,4,45,0,45,5,2014-04-01 21:39:04,2014-04-01 21:28:42
6654754779d2a90af91a9c6b93d7e4e7ee16cfab...f80d1f95f0adf9909f42eb9e74546963daa4b0c1,1,2,4,6,2,2014-04-01 21:40:05,2014-04-01 07:43:06
69490f345943f6f6d7ae52e0e9c870e8b48a5dea...e78e6967f3f3f28fd66c1dfe52544788e0cd0236,1,6,3,9,1,2014-01-14 21:56:56,2014-01-14 02:58:49
69490f345943f6f6d7ae52e0e9c870e8b48a5dea...eaa6c987e68c78a2d537480c5b06c42177f9c286,1,9,2,11,1,2013-11-27 19:05:58,2013-11-27 00:28:39
69490f345943f6f6d7ae52e0e9c870e8b48a5dea...a047fafc7866cc4087201e284dc1f53e8f9a32d5,2,76,23,99,8,2013-10-18 19:56:06,2013-10-18 09:25:57
a047fafc7866cc4087201e284dc1f53e8f9a32d5...bca39695343ecb113b30c72a3b2e0cb7e73757d8,2,22,5,27,4,2013-10-18 19:57:16,2013-10-18 09:25:58
182d7dc46b23b4a20985c93ea3a6ba3e6f267ff6...d644c5502fc576904a07fab35f43540fa9f2e7c2,2,14,2,16,3,2013-10-10 22:33:46,2013-10-10 16:41:17
898bbe9664bf99bea6dcd4d03b2480f0f79b404b...95c62fb9ea35fab9706792e858ce66967501eb00,1,6,1,7,3,2013-10-30 17:47:37,2013-10-29 16:30:37
1f3a412dfaf2d12583e3286c6d20b403da8cc963...1572e18e60e0702561d1d59d140615ab7ff54295,1,254,0,254,2,2013-06-26 19:57:35,2013-06-26 03:05:13
1572e18e60e0702561d1d59d140615ab7ff54295...7fe9031920be5c98a7e58eea6be34442390392ec,1,26,59,85,17,2013-06-26 20:02:57,2013-06-26 03:05:14
7fe9031920be5c98a7e58eea6be34442390392ec...f3bd62d02ff189c42d404f9a0b347499e016cc23,1,1,114,115,2,2013-06-26 20:03:01,2013-06-26 03:05:15
f3bd62d02ff189c42d404f9a0b347499e016cc23...15981f4eec9c6a7c12b9c0fbe98e68228c46edb7,2,5,5,10,6,2013-06-26 20:03:01,2013-06-26 03:05:16
15981f4eec9c6a7c12b9c0fbe98e68228c46edb7...cf4cac4cfc13326920bdbf3d51236e2065f5ba2f,1,15,11,26,7,2013-06-26 20:03:01,2013-06-26 03:05:17
1f3a412dfaf2d12583e3286c6d20b403da8cc963...908a0e6b98e5a7c4b299b3643823bdefb4fa512e,3,0,76,76,3,2013-06-24 15:18:07,2013-06-24 15:18:07
1f3a412dfaf2d12583e3286c6d20b403da8cc963...4fe00b4f0ab148de78db18790955d5e381377b14,1,116,116,232,99,2013-06-23 23:50:42,2013-06-17 20:34:16
4fe00b4f0ab148de78db18790955d5e381377b14...7412290cc4b5aa0efc205f81e4775dd7df9ea9d5,1,5,7,12,2,2013-06-23 23:50:42,2012-08-24 18:03:58
7412290cc4b5aa0efc205f81e4775dd7df9ea9d5...c9a102e81ffedde3fed4b88199ea13a3a5ee5f5d,2,134,128,262,3,2013-06-24 15:21:55,2013-06-17 18:31:51
c9a102e81ffedde3fed4b88199ea13a3a5ee5f5d...868dc1acecdb8b661e415c6c5f09db5370b35fa7,1,9,0,9,1,2013-06-24 15:22:09,2012-08-24 17:52:48
868dc1acecdb8b661e415c6c5f09db5370b35fa7...e8f21caf94287d838cfffe8301b28fdc45480ac8,2,3,2,5,2,2013-06-24 15:22:09,2013-06-23 23:55:42
e8f21caf94287d838cfffe8301b28fdc45480ac8...96ea404757ac3f97335277062a7d7c6e8975cc4f,1,101,100,201,17,2013-06-24 15:22:09,2011-09-05 18:53:37
96ea404757ac3f97335277062a7d7c6e8975cc4f...511ad159049fc64a13ef3e9565cc9634acb6404b,2,1,27,28,3,2013-06-24 15:22:09,2013-06-17 21:55:16
511ad159049fc64a13ef3e9565cc9634acb6404b...b91b935f04e8dcb1cc9f247627fbd0346ce949f4,1,6,6,12,3,2013-06-24 15:22:09,2011-03-31 22:25:16
b91b935f04e8dcb1cc9f247627fbd0346ce949f4...3a43c4b5bd19528229ef36b28d648d5ac98f15f1,1,33,18,51,2,2013-06-24 15:22:10,2011-03-31 21:41:18
3a43c4b5bd19528229ef36b28d648d5ac98f15f1...efaa0c153297f551a42fd1e21f28f51f4924f316,1,13,5,18,4,2013-06-24 15:22:10,2013-06-17 20:58:42
efaa0c153297f551a42fd1e21f28f51f4924f316...e3e0b9378b6e51ea50c023d92d4d2a1f4d4cc676,2,20,4,24,4,2013-06-24 16:03:30,2013-06-24 00:16:02
e3e0b9378b6e51ea50c023d92d4d2a1f4d4cc676...0f37c125814afc8ad2fa43fecd8b200216ebfab5,1,1,1,2,1,2013-06-24 16:03:37,2013-06-24 10:49:19
0f37c125814afc8ad2fa43fecd8b200216ebfab5...dd0b72cbd9e64c782a31c6acfca2ba9cf2ffb266,2,4,2,6,2,2013-06-24 16:03:37,2011-04-01 15:47:37
dd0b72cbd9e64c782a31c6acfca2ba9cf2ffb266...14d7649748265fe9fe991439ca6ae0c9db7a27ab,1,1,1,2,1,2013-06-24 16:03:37,2011-08-12 12:17:12
14d7649748265fe9fe991439ca6ae0c9db7a27ab...69a8141a5d81925b7e08cb228535e9ea4a7a02e3,1,5,1,6,1,2013-06-24 16:03:37,2013-06-17 19:42:55
69a8141a5d81925b7e08cb228535e9ea4a7a02e3...a694258457e51f20e92854075914c8d3a4593367,1,5,5,10,1,2013-06-24 16:03:37,2013-06-24 00:28:02
ede63a195c53d31207d694258bd8bc740dbc87a7...7b40d3963835699e138d21f6040a60c07e797853,1,50,12,62,14,2013-06-20 22:50:16,2013-06-20 08:37:43
7b40d3963835699e138d21f6040a60c07e797853...267f9a8cc8192e120a6476fc55590e288e08b459,1,34,14,48,12,2013-06-20 22:50:17,2013-06-20 08:37:44
267f9a8cc8192e120a6476fc55590e288e08b459...2fff7812902abd0afe05ae1e9ef334fcd26f0389,1,26,6,32,7,2013-06-20 22:50:17,2013-06-20 08:37:45
2fff7812902abd0afe05ae1e9ef334fcd26f0389...9f69d297703bff37c5506276c2565c721347e03f,3,98,21,119,19,2013-06-20 22:50:17,2013-06-20 08:37:46
9f69d297703bff37c5506276c2565c721347e03f...5f5e2a8868e2b5792bf467799339e3288282e91e,1,36,3,39,6,2013-06-20 22:50:17,2013-06-20 08:37:47
5f5e2a8868e2b5792bf467799339e3288282e91e...8baf2bb99a22f8265a26d97f706a27e39911f69e,1,4,1,5,3,2013-06-20 22:50:17,2013-06-20 08:37:48
8baf2bb99a22f8265a26d97f706a27e39911f69e...4f6b83e3708943c3b3f4ac911da7d0c30019c20a,1,7,1,8,4,2013-06-20 22:50:17,2013-06-20 08:37:49
4f6b83e3708943c3b3f4ac911da7d0c30019c20a...c21d39d7c7eb07eed0be301a72856bff65201256,3,116,80,196,19,2013-06-20 22:50:17,2013-06-20 08:37:50
c21d39d7c7eb07eed0be301a72856bff65201256...38612532240ecbe1b12e54ca859fed8410ae6de1,2,57,0,57,2,2013-06-20 22:50:17,2013-06-20 08:37:51
38612532240ecbe1b12e54ca859fed8410ae6de1...ca9199300eb0d485f5e03961bbbd9aff3484a1fa,1,16,5,21,6,2013-06-20 22:50:17,2013-06-20 08:37:52
ca9199300eb0d485f5e03961bbbd9aff3484a1fa...98eeb09e8acb6cbe0b0da3b1772b6676fe6d167f,1,35,4,39,5,2013-06-20 22:50:17,2013-06-20 08:37:53
edca4152560522a431a51fc0a06147fc680b5b18...cd4f09e38341bdd17cf008ea57863e4b10ac176b,2,20,2,22,3,2013-09-18 21:41:19,2013-09-18 21:14:00
edca4152560522a431a51fc0a06147fc680b5b18...05e95155a10fab3d3c495076e51b2ce79fa26cf3,2,35,1,36,6,2013-09-09 18:14:37,2013-09-08 09:01:31
05e95155a10fab3d3c495076e51b2ce79fa26cf3...115dedd72223e101181363f4e6053b4c937fdc37,2,2,2,4,2,2013-09-09 18:15:17,2013-09-08 09:02:06
edca4152560522a431a51fc0a06147fc680b5b18...f7466e94375b3be27f229c78873f0acf8301c0a5,1,1,1,2,1,2013-08-18 19:56:23,2013-08-16 21:22:37
edca4152560522a431a51fc0a06147fc680b5b18...712610274211dc6cd7c83c5ccf88db5a75af8c25,1,5,6,11,6,2013-08-15 19:08:45,2013-08-15 19:08:45
712610274211dc6cd7c83c5ccf88db5a75af8c25...2eac2a4cc4bdc8d77b31204bc20751cb56f0d575,3,31,3,34,4,2013-08-15 20:50:34,2013-08-15 19:13:46
2eac2a4cc4bdc8d77b31204bc20751cb56f0d575...3c56875176390eee7d81795294124ce90189d876,1,9,3,12,9,2013-08-15 21:16:00,2013-08-15 20:51:09
3c56875176390eee7d81795294124ce90189d876...680be044d98b3b703bc33d546a987c19b3779aeb,2,24,9,33,3,2013-08-23 23:26:59,2013-08-23 23:26:59
edca4152560522a431a51fc0a06147fc680b5b18...3f4ccd2b0be476dfc3b556c71797712332bae00c,1,1,2,3,1,2013-07-31 19:09:13,2013-07-12 18:52:47
3f4ccd2b0be476dfc3b556c71797712332bae00c...3402a8dc485db5ad1df1557ab672b7e25048bc08,2,504,0,504,2,2013-07-31 21:57:57,2013-07-31 20:52:00
3402a8dc485db5ad1df1557ab672b7e25048bc08...836b6fb5a56338dc28165284875b257ccfd6c224,2,85,0,85,2,2013-07-31 21:58:42,2013-07-31 17:42:01
836b6fb5a56338dc28165284875b257ccfd6c224...6a56993b2ec7082521cf14f98ab9fb5a5def4b13,19,309,1,310,24,2013-08-05 23:02:03,2013-08-05 20:20:36
6a56993b2ec7082521cf14f98ab9fb5a5def4b13...d9b9169b3419edb0fa7a787ec1641ee75397f2a4,1,21,21,42,8,2013-08-05 23:02:28,2013-07-29 21:23:16
d9b9169b3419edb0fa7a787ec1641ee75397f2a4...d4770964d5058a679ebfc051acceb7968a831f84,3,152,0,152,10,2013-08-05 23:02:28,2013-07-31 18:14:59
d4770964d5058a679ebfc051acceb7968a831f84...6667a6ac20747eb56eb2c03c39aceaf6aebbae3c,2,4,4,8,4,2013-08-09 16:20:38,2013-08-09 04:41:44
edca4152560522a431a51fc0a06147fc680b5b18...a04f8196a8f067b6c36415a0d934a46465140c34,1,5,6,11,5,2013-07-19 22:29:41,2013-07-19 20:26:32
edca4152560522a431a51fc0a06147fc680b5b18...4a81bfa1d97ed5d1952f5b94dd7eeedddc21d457,1,2,2,4,1,2013-07-18 23:23:46,2013-07-18 16:53:25
4a81bfa1d97ed5d1952f5b94dd7eeedddc21d457...8c3ca72623121684e39be085588b9ef7c6306caa,1,1,1,2,1,2013-07-18 23:23:51,2013-07-18 16:53:55
edca4152560522a431a51fc0a06147fc680b5b18...737c5a9cde708d6995c765b7c2e95033edd0a896,5,130,5,135,13,2013-07-18 22:59:46,2013-07-13 09:36:24
edca4152560522a431a51fc0a06147fc680b5b18...8ade9b140f099540bcdec5bcf660faaf05b5e3ee,1,9,9,18,3,2013-07-18 00:50:56,2013-07-16 08:05:35
8ade9b140f099540bcdec5bcf660faaf05b5e3ee...d09cd15d19de23aca532a85f6d27a71b2baceb3f,3,14,1,15,3,2013-07-18 00:50:56,2013-07-16 08:05:36
d09cd15d19de23aca532a85f6d27a71b2baceb3f...71482d389d0b214d2cfc2adf788ba1011a7dcb18,2,35,11,46,6,2013-07-18 00:50:56,2013-07-16 08:05:37
71482d389d0b214d2cfc2adf788ba1011a7dcb18...0791ab02c2e81e3d3c6815ce36085072d2c4cb4d,1,9,0,9,1,2013-07-18 00:50:56,2013-07-16 08:05:38
0791ab02c2e81e3d3c6815ce36085072d2c4cb4d...7b02c834638f6bea4cf14e4981702103b478ff4d,2,5,4,9,2,2013-07-18 00:50:56,2013-07-16 08:05:39
7b02c834638f6bea4cf14e4981702103b478ff4d...4ba258b7e1020e8e3f321ca2df01e34cd71bee88,1,4,4,8,4,2013-07-18 00:50:56,2013-07-16 08:05:40
edca4152560522a431a51fc0a06147fc680b5b18...bc501f69fc6d697968d472afbabe6af97a758b12,6,3398,0,3398,6,2013-07-15 19:59:48,2013-07-14 08:09:02
bc501f69fc6d697968d472afbabe6af97a758b12...1d25e7746d0a795afc16b4dac2da697ae660d987,1,13,4,17,1,2013-07-23 04:20:28,2013-07-14 08:09:03
edca4152560522a431a51fc0a06147fc680b5b18...109025b4e1c836fb62752f69f24e8f11403760d5,1,9,0,9,1,2013-07-15 15:09:04,2013-07-15 06:54:05
109025b4e1c836fb62752f69f24e8f11403760d5...8c3811510e2a90f765edbb6dc7f81b0737592c0a,2,2,2,4,2,2013-07-15 15:16:00,2013-07-15 06:54:06
8c3811510e2a90f765edbb6dc7f81b0737592c0a...3aff56ddbebfdb314f123e9a076403459d6a0767,1,9,0,9,1,2013-07-15 15:16:32,2013-07-15 06:54:07
3aff56ddbebfdb314f123e9a076403459d6a0767...97e751be7928d17c177b2fe65fb9bacf6ee35643,2,9,13,22,5,2013-07-15 15:17:20,2013-07-15 06:54:08
97e751be7928d17c177b2fe65fb9bacf6ee35643...c10be0c6acfe671adf0ed1b3387de45d126f8ab7,1,1,1,2,1,2013-07-15 15:18:04,2013-07-15 06:54:09
c10be0c6acfe671adf0ed1b3387de45d126f8ab7...0939a242fe95fd2c2a2a4094d827e144382de3d7,1,1,1,2,1,2013-07-15 15:19:56,2013-07-15 06:54:10
0939a242fe95fd2c2a2a4094d827e144382de3d7...a8002a5f0ee19e2a513483e763b8b4a7cdcaa48d,1,3,3,6,2,2013-07-15 15:20:11,2013-07-15 06:54:11
a8002a5f0ee19e2a513483e763b8b4a7cdcaa48d...fbfba7ade0dde36d8911973b1dac248b81ce1375,1,9,6,15,7,2013-07-15 15:20:32,2013-07-15 06:54:12
fbfba7ade0dde36d8911973b1dac248b81ce1375...bd23794552a9d344ddda9fac20d7ee9b7607f6b1,1,27,15,42,11,2013-07-15 15:23:39,2013-07-15 06:54:13
edca4152560522a431a51fc0a06147fc680b5b18...4621085b7eb2f4cffe16d508988ff9b4a874b4ef,4,5,1,6,5,2013-07-10 05:23:04,2013-07-10 00:18:40
4621085b7eb2f4cffe16d508988ff9b4a874b4ef...eccb614924c9067eeceffa503e4da3683f1c8b6b,4,5,0,5,5,2013-07-10 05:23:09,2013-07-10 00:19:12
eccb614924c9067eeceffa503e4da3683f1c8b6b...8dd0ee823f1829a3aa228c3c73e31de5c89b5317,1,4,4,8,1,2013-07-10 05:23:11,2013-07-10 00:23:28
8dd0ee823f1829a3aa228c3c73e31de5c89b5317...9fe3edc47f1f17a53272671c572c90ba71eb4f74,5,12,5,17,6,2013-07-19 16:26:15,2013-07-18 20:02:12
edca4152560522a431a51fc0a06147fc680b5b18...f1bd15ab1553de76f297b8566b5779c43e3bfe2a,1,25,2,27,9,2013-07-08 16:04:31,2013-07-08 08:58:39
edca4152560522a431a51fc0a06147fc680b5b18...125a05fd0b45416558923b753f6418c24208d443,2,14,5,19,4,2013-07-08 15:00:21,2013-07-08 07:30:41
edca4152560522a431a51fc0a06147fc680b5b18...4e63dcc86cc77ec86a8d35ff752603a4b44d44a7,1,31,2,33,3,2013-07-07 22:43:02,2013-07-07 04:20:48
4e63dcc86cc77ec86a8d35ff752603a4b44d44a7...8ac251b66b952b0eddfa4e5bbf08a3c0ae7dbc0b,1,4,2,6,2,2013-07-07 22:43:03,2013-07-07 04:20:49
8ac251b66b952b0eddfa4e5bbf08a3c0ae7dbc0b...9c0810732c50106d1a93866ca3fa1285e07778f1,1,1,1,2,1,2013-07-19 03:31:43,2013-07-19 00:16:16
edca4152560522a431a51fc0a06147fc680b5b18...fc6c4e96f13fe595fc8991d91c56f2abbe67dc89,1,6,6,12,3,2013-07-07 20:35:48,2013-07-07 19:02:14
fc6c4e96f13fe595fc8991d91c56f2abbe67dc89...153d7265ef1277c1c9971780ad035a530e305f78,2,2,2,4,2,2013-07-08 19:44:01,2013-07-07 19:02:15
edca4152560522a431a51fc0a06147fc680b5b18...7da9800fff189b93b46bb5e8763b75101264d940,1,12,8,20,3,2013-07-07 20:34:31,2013-07-07 19:49:56
edca4152560522a431a51fc0a06147fc680b5b18...7c07385d902f6d8c177d533dc2faa36ef4a52a66,2,2,2,4,2,2013-07-07 17:50:13,2013-07-07 10:03:29
7c07385d902f6d8c177d533dc2faa36ef4a52a66...161f00e708874bac646da2ac05c66a18ade2c074,2,17,4,21,8,2013-07-07 17:53:22,2013-07-07 10:04:00
161f00e708874bac646da2ac05c66a18ade2c074...03c893cbf9ad2e9a5be43382bcabdb2af2a49a4a,1,18,43,61,6,2013-07-11 17:37:14,2013-07-10 11:36:43
03c893cbf9ad2e9a5be43382bcabdb2af2a49a4a...98e2092b5027fde9dbe68cb49a196ad2184c02c3,1,28,13,41,6,2013-07-11 17:37:16,2013-07-10 11:38:24
98e2092b5027fde9dbe68cb49a196ad2184c02c3...b71bd48017981f7257d8c0a5096825321b4fb49b,1,38,18,56,12,2013-07-11 17:39:13,2013-07-10 11:38:58
b71bd48017981f7257d8c0a5096825321b4fb49b...93d2a607ba05fba31442941d0425019120993846,3,142,26,168,21,2013-07-12 16:18:12,2013-07-10 11:45:47
93d2a607ba05fba31442941d0425019120993846...a4ac1061783d25db4253309d2b58b9c2b89401d7,2,24,0,24,4,2013-07-12 16:18:42,2013-07-10 11:46:25
a4ac1061783d25db4253309d2b58b9c2b89401d7...c334b87b30c1464a1ab563fe1fb8de5eaf0e5bac,3,34,3,37,6,2013-07-12 16:18:42,2013-07-11 20:45:59
c334b87b30c1464a1ab563fe1fb8de5eaf0e5bac...012b32bb46459f96509669c2f5be0a93a95a2b43,1,4,4,8,3,2013-07-12 16:18:42,2013-07-10 11:50:26
012b32bb46459f96509669c2f5be0a93a95a2b43...8b8dfd5132ce91f632b5303c39cda2dfe30790f1,1,95,5,100,3,2013-07-12 16:20:54,2013-07-11 12:16:00
edca4152560522a431a51fc0a06147fc680b5b18...275cd184d52b5b81cb89e4ec33e540fb2ae61c1f,4,61,12,73,13,2013-07-03 17:33:32,2013-07-02 21:42:56
edca4152560522a431a51fc0a06147fc680b5b18...4fb5166ab5e1b83ee6211ac77d76173f881ebfdb,3,41,0,41,3,2013-06-24 17:25:49,2013-06-11 13:34:04
4fb5166ab5e1b83ee6211ac77d76173f881ebfdb...ec85d0700faac679ec27eeacad2bcaa6d9bc8322,3,35,0,35,3,2013-06-24 17:25:49,2013-06-11 13:34:05
ec85d0700faac679ec27eeacad2bcaa6d9bc8322...f0915cbaf476d63f72c284057680809ed24fbe0d,1,1,0,1,1,2013-06-24 17:25:49,2013-06-24 12:45:12
f0915cbaf476d63f72c284057680809ed24fbe0d...84b4202d804c7faec76f3eab22744b6288c63481,3,61,22,83,15,2013-06-24 19:49:53,2013-06-24 18:41:40
edca4152560522a431a51fc0a06147fc680b5b18...aca70610b6dea395995790c2eda58535d4cbe12e,1,65,0,65,3,2013-06-23 21:22:28,2013-06-23 14:58:19
aca70610b6dea395995790c2eda58535d4cbe12e...adefdba536623e23af5d808eea9ec3eba5c55dd6,1,2,0,2,1,2013-06-23 21:22:28,2013-06-23 14:58:20
adefdba536623e23af5d808eea9ec3eba5c55dd6...e0eb6b9720db743993d9374e366cb6b7664f0a6d,2,24,15,39,10,2013-06-23 21:22:28,2013-06-23 14:58:21
e0eb6b9720db743993d9374e366cb6b7664f0a6d...62bfa11cc9a8cb0aacbba0aed503e85cdc6ba0a4,2,15,8,23,9,2013-06-23 21:22:28,2013-06-23 14:58:22
edca4152560522a431a51fc0a06147fc680b5b18...36617af7ed594d1928554356d809bd611c642dd2,10,439,8,447,18,2013-06-19 22:17:45,2013-06-19 18:46:07
edca4152560522a431a51fc0a06147fc680b5b18...98c5c4ad01551b7764c9c8d8f67abfa9c5e595fe,2,31,8,39,6,2013-06-18 19:02:02,2013-06-18 12:35:31
edca4152560522a431a51fc0a06147fc680b5b18...8120e421bb832a4fb82807f40f5dae558f004a92,1,40,40,80,24,2013-06-17 20:30:01,2013-06-16 14:18:13
8120e421bb832a4fb82807f40f5dae558f004a92...031129cbe07f34c735ce598b0f9cf68b4fda9023,1,183,133,316,30,2013-06-17 20:30:01,2013-06-16 14:18:14
031129cbe07f34c735ce598b0f9cf68b4fda9023...a82af0543a016e341f1efd689a60617b1029ae00,1,2,2,4,2,2013-06-17 20:30:01,2013-06-16 14:18:15
a82af0543a016e341f1efd689a60617b1029ae00...1ae2e19a32729e21778b74f61794369203b58a1d,1,1,1,2,1,2013-06-17 20:30:01,2013-06-16 14:18:16
1ae2e19a32729e21778b74f61794369203b58a1d...12b9d32790b40bf3ea49134095619700191abf1f,3,131,5,136,9,2013-06-17 20:30:01,2013-06-16 14:18:17
12b9d32790b40bf3ea49134095619700191abf1f...091a6eb0feed820a43663ca63dc2bc0bb247bbae,6,319,35,354,53,2013-06-17 20:30:01,2013-06-16 14:18:18
edca4152560522a431a51fc0a06147fc680b5b18...a57397b0d6709d75ab23145fd4fea5ce65dc1054,1,2,0,2,2,2013-06-17 20:28:45,2013-06-17 09:18:46
a57397b0d6709d75ab23145fd4fea5ce65dc1054...e6a6ddc93a89862319c7876536d79d6d3538de5a,1,24,17,41,3,2013-06-18 18:14:50,2013-06-18 12:25:58
e6a6ddc93a89862319c7876536d79d6d3538de5a...ae75342cff145a326b2213128cca453023521400,2,12,3,15,6,2013-06-18 18:15:14,2013-06-18 12:25:59
ae75342cff145a326b2213128cca453023521400...517cd55fd51ebf4c6c20597055ff191fefe5dda0,2,38,1,39,5,2013-06-23 19:24:05,2013-06-23 18:12:55
517cd55fd51ebf4c6c20597055ff191fefe5dda0...ff09af3fb8f5bede0de523723bbd00d6ef2ab71e,3,60,0,60,6,2013-06-23 19:24:06,2013-06-23 18:12:56
ff09af3fb8f5bede0de523723bbd00d6ef2ab71e...5dfc368f5ec4c448cf3c76908b4c0e77cb4b902a,3,43,1,44,8,2013-06-23 19:24:06,2013-06-23 18:12:57
5dfc368f5ec4c448cf3c76908b4c0e77cb4b902a...e939e15d241e942662b9f88f6127ab470ab0a0b9,1,15,12,27,11,2013-06-23 19:24:06,2013-06-23 18:12:58
e939e15d241e942662b9f88f6127ab470ab0a0b9...ad0e6233320b004f0d686f6887c803e508607bd2,1,84,22,106,11,2013-06-23 19:24:06,2013-06-23 18:12:59
ad0e6233320b004f0d686f6887c803e508607bd2...62a23c9f5823171319bd01a924338dfc8e2c0679,1,2,1,3,2,2013-06-30 01:45:24,2013-06-29 13:38:39
edca4152560522a431a51fc0a06147fc680b5b18...b95e66f507967fdfbf7275a94729fe09aa4b20ca,2,8,4,12,4,2013-06-17 20:16:26,2013-06-17 04:28:26
edca4152560522a431a51fc0a06147fc680b5b18...d2512fc94fe75d8836a6fc965951d8180dbddbe6,1,35,47,82,6,2013-06-17 20:12:55,2013-06-16 17:51:22
edca4152560522a431a51fc0a06147fc680b5b18...46ab7d46ca8ae98411450f077b3023e0b7e03ea9,1,9,1,10,2,2013-06-17 16:56:32,2013-06-17 16:52:25
46ab7d46ca8ae98411450f077b3023e0b7e03ea9...ce23d493b479d754321c9d835039a93e7fde9671,1,0,2,2,2,2013-06-17 16:56:32,2013-06-16 08:45:14
ce23d493b479d754321c9d835039a93e7fde9671...89f2fea49a246e9ac4fa94cb43a7e992a8a4a144,1,34,0,34,1,2013-06-17 16:56:57,2013-06-16 08:45:11
89f2fea49a246e9ac4fa94cb43a7e992a8a4a144...ec5063106449aa8c6623abbdcca862dd1516c920,2,21,21,42,21,2013-06-17 16:59:47,2013-06-16 08:45:15
ec5063106449aa8c6623abbdcca862dd1516c920...3bed291a3b121408b4de83f4fa3cc0f1d98c676e,2,12,7,19,6,2013-06-17 17:05:40,2013-06-16 08:45:16
edca4152560522a431a51fc0a06147fc680b5b18...603d249853981d81d1f8cf561b18d77cb1b55923,2,4,16,20,6,2013-06-17 16:24:47,2013-06-15 23:44:43
edca4152560522a431a51fc0a06147fc680b5b18...74671241fd53df2899d4b4400593afc12e8e1bf7,2,14,1,15,3,2013-06-14 15:04:32,2013-06-14 00:26:02
74671241fd53df2899d4b4400593afc12e8e1bf7...bed947048919d0ed8b8eece38eb18b15f99e313f,1,11,8,19,4,2013-06-20 19:00:57,2013-06-20 14:58:48
edca4152560522a431a51fc0a06147fc680b5b18...914dc0289d1df75cfa744cea8ec84cb529cbc791,2,148,19,167,11,2013-06-12 23:59:50,2013-06-12 08:06:43
edca4152560522a431a51fc0a06147fc680b5b18...2cc0f53b53e7d5456ec45713a201142754d69249,1,5,0,5,2,2013-06-12 20:41:19,2013-06-12 18:44:10
2cc0f53b53e7d5456ec45713a201142754d69249...e5c29097826be86e2f18139491cdf9c830c7fa3e,1,1,1,2,1,2013-06-23 20:39:39,2013-06-23 19:19:05
edca4152560522a431a51fc0a06147fc680b5b18...80a14665b199a0ccacceb095e3a8bfc4f1e8645e,3,7,6,13,7,2013-06-12 17:27:41,2013-06-12 00:12:59
80a14665b199a0ccacceb095e3a8bfc4f1e8645e...49c2470400bbb695b953abeb4e6737be747317af,6,159,146,305,9,2013-06-12 17:34:59,2013-06-12 00:13:00
49c2470400bbb695b953abeb4e6737be747317af...bf9a05ba46a9d464424d22482aaa54abdd28b77d,4,41,41,82,5,2013-06-12 17:38:13,2013-06-12 00:13:01
edca4152560522a431a51fc0a06147fc680b5b18...50e4f757f4adda096239c1ad60499cf606bf2c6f,3,41,0,41,3,2013-06-11 21:38:08,2013-06-11 13:34:04
50e4f757f4adda096239c1ad60499cf606bf2c6f...0e254bbd22ba3f62c0bbf5055c307391a5920eaa,3,35,0,35,3,2013-06-16 05:15:28,2013-06-11 13:34:05
edca4152560522a431a51fc0a06147fc680b5b18...5ada8687995fadea01f755d52ceec58337d003a3,1,15,0,15,2,2013-06-11 21:27:15,2013-06-11 13:38:48
edca4152560522a431a51fc0a06147fc680b5b18...1ecb5ff141f6e54727c746446b52af51016e662c,4,29,0,29,4,2013-06-10 00:03:00,2013-06-09 17:39:17
1ecb5ff141f6e54727c746446b52af51016e662c...a0fc4db01dfa69d836dc6f24218974a674ec29ac,1,3,2,5,1,2013-06-10 00:03:01,2013-06-09 17:39:18
edca4152560522a431a51fc0a06147fc680b5b18...b12ca9631f86adc35b0c03fb5b792cd82c288288,5,19,9,28,8,2013-06-09 23:07:50,2013-06-09 05:22:48
b12ca9631f86adc35b0c03fb5b792cd82c288288...1dd278ce60294aa6b3119a469007949c6fde425a,1,6,0,6,1,2013-06-09 23:16:06,2013-06-09 05:22:49
edca4152560522a431a51fc0a06147fc680b5b18...2aad7cace2253797fe0cd688e20f39ffb66db995,2,94,0,94,2,2013-06-07 16:40:14,2013-06-07 06:11:37
2aad7cace2253797fe0cd688e20f39ffb66db995...5b5e1c7c7875bcaed7e640dd0d33de3dbe87e1bb,2,102,0,102,2,2013-06-07 16:41:11,2013-06-07 06:11:38
5b5e1c7c7875bcaed7e640dd0d33de3dbe87e1bb...00b8be5a4d383be1f4b6d0c083d3d4b10f38444b,2,58,24,82,2,2013-06-07 16:41:42,2013-06-07 06:11:39
00b8be5a4d383be1f4b6d0c083d3d4b10f38444b...6a6bc5bdc4d73d0926bdbd8b65c8959583ba7911,1,129,0,129,1,2013-06-07 16:41:53,2013-06-07 06:11:40
6a6bc5bdc4d73d0926bdbd8b65c8959583ba7911...3f213981e44a9109d053550855dc0ae91d0287c6,5,260,137,397,12,2013-06-07 16:41:59,2013-06-07 06:11:41
3f213981e44a9109d053550855dc0ae91d0287c6...9e2248efdbc0327d1eee19d3b8e825e43f7df81f,1,9,21,30,5,2013-06-07 16:42:20,2013-06-07 06:11:42
9e2248efdbc0327d1eee19d3b8e825e43f7df81f...c9581cc8005d54680512cc6f22255b6847176f2b,2,22,22,44,2,2013-06-07 16:42:50,2013-06-07 06:11:43
c9581cc8005d54680512cc6f22255b6847176f2b...984f78d278dd456b12874da1bdf3763e72db8dae,2,18,18,36,18,2013-06-18 14:40:31,2013-06-18 07:28:07
edca4152560522a431a51fc0a06147fc680b5b18...ca7a5dcfd39bdeb26d74074e78e6966df5e63a6b,1,1,1,2,1,2013-06-07 16:37:16,2013-06-05 04:44:28
edca4152560522a431a51fc0a06147fc680b5b18...6e454b9a31840102807f1eee527ee717bf134102,10,24,23,47,17,2013-06-06 17:29:12,2013-06-05 22:37:39
edca4152560522a431a51fc0a06147fc680b5b18...da608b124c76f8f7dba8a9d8f0bc8174b9744176,1,9,57,66,5,2013-06-05 18:15:24,2013-06-05 10:58:00
edca4152560522a431a51fc0a06147fc680b5b18...c8d1351deb2ccb8634d5c3dd863dd37d0d8c082c,1,9,7,16,3,2013-06-03 18:40:55,2013-05-29 03:56:21
c8d1351deb2ccb8634d5c3dd863dd37d0d8c082c...706728a37c53c3d1c3fc38aa9c9842060d03e9cc,1,4,2,6,1,2013-06-06 18:21:28,2013-06-06 08:58:57
edca4152560522a431a51fc0a06147fc680b5b18...276b22d333d4207928f6cfe3ab7c1898cd509b88,1,2,2,4,2,2013-06-03 17:50:22,2013-05-31 12:12:14
276b22d333d4207928f6cfe3ab7c1898cd509b88...5bc3f0b56779d189aaf7cab7e5d307aa4e7c0887,2,57,26,83,5,2013-06-03 17:53:11,2013-05-31 12:12:15
edca4152560522a431a51fc0a06147fc680b5b18...d8517cc6670d4ba18e9b77a83b2481aec0edbc32,1,1,1,2,1,2013-06-03 17:30:04,2013-06-02 14:03:41
d8517cc6670d4ba18e9b77a83b2481aec0edbc32...5269f7f8c6b293f1568c4f03c14596835e22df31,1,1,1,2,1,2013-06-09 22:56:35,2013-06-02 14:03:42
edca4152560522a431a51fc0a06147fc680b5b18...926e89441fb735bc4ed7d10713a8cd3d3dc44b49,1,4,4,8,4,2013-06-02 23:23:35,2013-06-01 09:34:20
926e89441fb735bc4ed7d10713a8cd3d3dc44b49...cb648689b9456a1131b494065d7888c925265ddd,1,61,62,123,5,2013-06-07 22:00:31,2013-06-07 20:53:26
cb648689b9456a1131b494065d7888c925265ddd...9ce415d972a04df4bfceaad0fab8eaea9a66997e,2,31,0,31,2,2013-06-07 22:01:16,2013-06-07 20:53:27
9ce415d972a04df4bfceaad0fab8eaea9a66997e...889c6f0e4d637223e0517d000eedad39b173d8a2,19,106,110,216,74,2013-06-07 22:01:45,2013-06-07 20:53:28
889c6f0e4d637223e0517d000eedad39b173d8a2...c723a76d4da632f8fbb8e687cea751f6d16b4cb0,1,10,29,39,11,2013-06-07 22:01:48,2013-06-07 20:53:29
c723a76d4da632f8fbb8e687cea751f6d16b4cb0...bba56042e7011a5555cb8b44a84e0d853fa43af5,1,26,36,62,3,2013-06-07 22:01:49,2013-06-07 20:53:30
bba56042e7011a5555cb8b44a84e0d853fa43af5...e40db07f5f4e46dc8678f81b672a0466d4d5b7ad,1,15,27,42,14,2013-06-07 22:01:50,2013-06-07 20:53:31
e40db07f5f4e46dc8678f81b672a0466d4d5b7ad...622f98e272196c9eb00ae4bc7b8710ed72a2c1ad,3,33,36,69,29,2013-06-07 22:01:51,2013-06-07 20:53:32
622f98e272196c9eb00ae4bc7b8710ed72a2c1ad...bfd7804ee3d5285aa8598497995efe3f697ea7fd,1,47,26,73,29,2013-06-07 22:01:52,2013-06-07 20:53:33
bfd7804ee3d5285aa8598497995efe3f697ea7fd...70836a6f8b71a945f074fc796c4241c2183b83a2,1,25,10,35,9,2013-06-07 22:01:53,2013-06-07 20:53:34
edca4152560522a431a51fc0a06147fc680b5b18...e832f5c0968031d687706c97464be21f2da7be21,1,2,8,10,1,2013-06-02 23:11:55,2013-05-29 03:20:48
edca4152560522a431a51fc0a06147fc680b5b18...9721ac90106e1f6c86a2f18d92fc262fe1ffbffc,3,0,628,628,3,2013-06-02 22:42:44,2013-06-02 20:14:07
9721ac90106e1f6c86a2f18d92fc262fe1ffbffc...1af6a877c5aeeb97e8fbacb06992e976e5cdbf83,2,0,164,164,2,2013-06-12 20:35:10,2013-06-12 19:49:56
edca4152560522a431a51fc0a06147fc680b5b18...20d142b48c8f2f50662db095e193836d0a8f5ad1,1,4,2,6,2,2013-06-02 22:31:12,2013-06-02 15:46:51
20d142b48c8f2f50662db095e193836d0a8f5ad1...21a6b9fa4212277d925b789795e83ac96c2aaa01,2,12,10,22,9,2013-06-02 22:31:12,2013-06-02 15:46:52
21a6b9fa4212277d925b789795e83ac96c2aaa01...a33bd4d34def15d12372aeb8c59a7465416f9f66,1,9,3,12,2,2013-06-02 22:31:13,2013-06-02 15:46:53
a33bd4d34def15d12372aeb8c59a7465416f9f66...f2fa35420511cc49e85413a2932a1a2bac88cc1b,1,12,5,17,7,2013-06-02 22:31:13,2013-06-02 15:46:54
f2fa35420511cc49e85413a2932a1a2bac88cc1b...eb9ae4b505bfacc4974a9ef4f4e6996c78d04a4c,3,63,53,116,31,2013-06-02 22:31:14,2013-06-02 15:46:55
eb9ae4b505bfacc4974a9ef4f4e6996c78d04a4c...5828e8352c07753a1f751322800524bf9dff8679,4,26,15,41,11,2013-06-02 22:31:14,2013-06-02 15:46:56
5828e8352c07753a1f751322800524bf9dff8679...5d80ef5a6e727bbecd7d892a5043bae25f7ca5e2,1,10,3,13,1,2013-06-02 22:31:15,2013-06-02 15:46:57
edca4152560522a431a51fc0a06147fc680b5b18...b79c0c3755f3694a3c7ecd3cad18bda011283db7,2,56,6,62,10,2013-06-02 21:13:05,2013-05-30 10:19:10
edca4152560522a431a51fc0a06147fc680b5b18...4917e1edabd6989e229e1a751b4062708cfd6f8e,1,2,2,4,2,2013-06-02 19:26:35,2013-05-30 01:34:44
edca4152560522a431a51fc0a06147fc680b5b18...2f0aaaf9dabd846061a759b53ff4759ec886df62,1,3,1,4,2,2013-05-30 00:03:14,2013-05-29 23:53:28
edca4152560522a431a51fc0a06147fc680b5b18...32eaf1de7f79c4ba09f3de3261c84e52e0a67af5,2,21,7,28,4,2013-05-29 19:50:08,2013-05-29 16:01:23
edca4152560522a431a51fc0a06147fc680b5b18...35ee69c0f6c77f293b66125d334467d9692ef866,1,8,6,14,2,2013-05-29 19:31:10,2013-05-29 19:21:49
35ee69c0f6c77f293b66125d334467d9692ef866...7b2ecd81084adeba701c60da81eec6be478910b8,1,5,0,5,2,2013-05-29 22:34:04,2013-05-29 19:21:50
7b2ecd81084adeba701c60da81eec6be478910b8...0f075b220862e729eb3873a1c1496b923d17c2d4,1,1,1,2,1,2013-05-29 22:34:07,2013-05-29 19:21:51
edca4152560522a431a51fc0a06147fc680b5b18...1306321ebea4d789974f0d58062664cc35c411e8,2,3,1,4,3,2013-05-29 18:27:56,2013-05-29 06:21:28
edca4152560522a431a51fc0a06147fc680b5b18...de56ccf7999ca53370f44f252b780a970d639f9e,1,11,1,12,2,2013-05-28 18:29:47,2013-05-28 02:36:21
edca4152560522a431a51fc0a06147fc680b5b18...b99d22f29a58feeccb1eb129b68a73f974715ee1,2,2,66,68,5,2013-05-28 18:17:15,2013-05-25 03:44:52
edca4152560522a431a51fc0a06147fc680b5b18...af0b4a3b5973ebdf8fcdedcccbc2e8ddb93c8534,3,11,9,20,7,2013-05-28 16:20:54,2013-05-27 11:18:47
edca4152560522a431a51fc0a06147fc680b5b18...7a97ee1d84283d0e59648531678bd69a895c78f5,1,1,2,3,1,2013-05-28 16:03:00,2013-05-28 12:54:27
7a97ee1d84283d0e59648531678bd69a895c78f5...15c7348eb0731f33a65fb08a27979640d44a7a3d,2,9,16,25,9,2013-05-28 16:03:14,2013-05-28 12:54:29
15c7348eb0731f33a65fb08a27979640d44a7a3d...6f87f038972afef0d7d256073ddfd8930e4b909d,1,1,1,2,1,2013-05-28 16:03:20,2013-05-28 12:54:31
edca4152560522a431a51fc0a06147fc680b5b18...99a4fdb950b214de3a0ad0ac255f6a2491f975d4,1,10,8,18,3,2013-05-28 14:43:18,2013-05-25 02:24:19
99a4fdb950b214de3a0ad0ac255f6a2491f975d4...ad44a7209534a6298c85a2a0fe107c56de0c8849,1,1,1,2,1,2013-05-28 14:43:18,2013-05-25 02:24:20
ad44a7209534a6298c85a2a0fe107c56de0c8849...1bf09d4fbf402e42b3a0be2411a9c4feb1ba8d25,1,12,11,23,6,2013-05-28 14:43:18,2013-05-25 02:24:21
1bf09d4fbf402e42b3a0be2411a9c4feb1ba8d25...2ae078e8476639b0dcd559d9b797771e6ffd97ff,1,13,15,28,10,2013-05-28 14:43:18,2013-05-25 02:24:22
2ae078e8476639b0dcd559d9b797771e6ffd97ff...0454c399c9ce75bbdf7d35223845cfc98f51d5d9,1,2,2,4,2,2013-05-28 14:43:18,2013-05-25 02:24:23
0454c399c9ce75bbdf7d35223845cfc98f51d5d9...a8ffc3ade273c5d6b2383450f1b4970c2da89d7d,1,7,7,14,7,2013-05-28 14:43:18,2013-05-25 02:24:24
a8ffc3ade273c5d6b2383450f1b4970c2da89d7d...e56660a73f778546f7c40989d982ac2f21462975,1,26,32,58,7,2013-05-28 14:43:25,2013-05-25 02:24:25
e56660a73f778546f7c40989d982ac2f21462975...85f931d3d5adf9d628aa3a75cfdd2f8f940f3d56,1,4,1,5,1,2013-05-28 14:43:25,2013-05-25 02:24:26
edca4152560522a431a51fc0a06147fc680b5b18...1b0a0f8446090c424ec16e222c15207e3211c6e3,1,3,3,6,2,2013-05-26 21:26:59,2013-05-25 02:41:01
1b0a0f8446090c424ec16e222c15207e3211c6e3...654f23f57c812c2fff8cad51322bac71b1553239,1,4,4,8,4,2013-05-26 21:26:59,2013-05-25 02:41:02
654f23f57c812c2fff8cad51322bac71b1553239...f530aa977823281b819081384c084b98a210e0f5,1,5,5,10,3,2013-05-26 21:27:00,2013-05-25 02:41:03
f530aa977823281b819081384c084b98a210e0f5...4331ea8de2b3e76250e1eec88d568c00bb84f4da,1,10,6,16,5,2013-05-26 21:35:49,2013-05-25 02:41:05
4331ea8de2b3e76250e1eec88d568c00bb84f4da...416fda6917f05b456ae263cb7152892bdf96f47c,1,2,0,2,1,2013-05-26 21:35:49,2013-05-25 02:41:06
c26c472e05cbc480c8a3801d866cfc77e762c0e5...d5b99f35bd9102cf25ffb5d438898fa0c625defd,1,1,1,2,1,2013-09-17 16:44:29,2013-09-15 17:38:21
d2dbd399fa03b37ce797ed6fc609574a7e677079...ae34ac126fa609fb17955b02c685d7de164b4e54,16,0,1815,1815,22,2013-09-09 15:13:07,2013-09-07 16:19:29
d2dbd399fa03b37ce797ed6fc609574a7e677079...bd5424f0d6257b55f7269ee5f009c5ce5eb71c6e,1,21,12,33,15,2013-09-08 18:15:33,2013-09-08 05:47:49
d2dbd399fa03b37ce797ed6fc609574a7e677079...d5ff3b4be5b2e3eee9c4b298f00ed7a4c1c556a4,7,10,10,20,9,2013-09-06 21:49:06,2013-09-06 20:03:22
f85f7947c38359c05b9df28fafe769fde9341326...7ffd18fce1eef2670661c2e7fd0cb3ef0b8b7fb7,2,3,3,6,3,2013-10-14 14:32:53,2013-10-10 20:49:43
f85f7947c38359c05b9df28fafe769fde9341326...daf19a80fa6b7402f8a2efa8f8255b4b5d6b48a9,1,28,28,56,1,2013-10-14 14:00:01,2013-10-14 02:29:38
daf19a80fa6b7402f8a2efa8f8255b4b5d6b48a9...7fbd422162f2b49bc06a29a063f519450165dc86,2,24,0,24,3,2013-10-14 14:00:26,2013-10-14 02:29:39
7fbd422162f2b49bc06a29a063f519450165dc86...41894ae3a315f75ebc924881c6ce9a69d70ce9c0,3,47,4,51,5,2013-10-14 14:00:33,2013-10-14 02:29:40
6a3ac18ba3150a7e089c0c6b6648b364c71f87c9...84cf246670eab56a23ed5554ed084053a0f19f2d,2,19,4,23,5,2013-05-16 19:53:59,2013-05-15 21:32:30
81b4f18fb8f9356477157a3b9f0652d371cba835...6c473a56d26bf596d4314b7c2e4c2bfafbfe757e,1,2,1,3,2,2013-06-07 23:16:06,2013-06-07 22:03:06
6c473a56d26bf596d4314b7c2e4c2bfafbfe757e...7ded0554010f520940704d8588821f1c0e8307ab,1,1,0,1,1,2013-06-07 23:16:43,2013-06-07 22:03:07
7ded0554010f520940704d8588821f1c0e8307ab...21117bfeac37d6000e2d8c0b69a146ff3717f961,1,3,3,6,3,2013-06-09 21:45:12,2013-06-08 22:38:58
81af23f684fb8ee436f6c4ef1ea9da86dddf526a...1003b3a55dcd1f2d8c3e95db5e65c2e55061f3e6,1,1045,822,1867,779,2013-04-12 01:42:58,2013-04-11 09:55:09
1003b3a55dcd1f2d8c3e95db5e65c2e55061f3e6...b94490bd57c049a73e9dc65e78359b19b0211565,1,1062,828,1890,788,2013-04-20 15:31:59,2013-04-11 16:25:45
9b795193a6a7e963db62d9cd8e86752a40940520...0460ed2c93d78c753242f835c441f320f792ac54,20,37,47,84,27,2013-05-17 19:09:21,2013-05-09 01:16:55
9b795193a6a7e963db62d9cd8e86752a40940520...e234ac9d47b6618f7b7338f95f34d0b70782e4cb,2,8,4,12,6,2013-05-09 01:07:39,2013-03-30 22:06:42
e234ac9d47b6618f7b7338f95f34d0b70782e4cb...d301f18160a3b0c3a5f647b9786aefd720d57faf,4,8,0,8,4,2013-05-09 01:07:58,2013-05-05 07:50:33
d301f18160a3b0c3a5f647b9786aefd720d57faf...a7b102302ad9495fb4eb5088ffcb09c44a406c06,5,180,3,183,10,2013-05-09 01:13:36,2013-05-03 23:10:18
9b795193a6a7e963db62d9cd8e86752a40940520...e56181060e1117d458b854c34e63206117dab8b6,2,55,0,55,3,2013-05-08 22:31:54,2013-05-04 00:04:19
e56181060e1117d458b854c34e63206117dab8b6...f3f8af0e54a31ffed242dc36482f82393f596ee5,1,2,1,3,1,2013-05-08 22:34:33,2013-05-04 00:04:20
9b795193a6a7e963db62d9cd8e86752a40940520...2bcf694b1892dca372c6d1d64602a017d7291899,1,5,13,18,2,2013-05-08 18:44:30,2013-05-08 07:37:00
2bcf694b1892dca372c6d1d64602a017d7291899...734b2f0532d847a9f566183982f83ddea8d8d197,1,2,2,4,2,2013-05-08 18:44:32,2013-05-08 07:37:01
734b2f0532d847a9f566183982f83ddea8d8d197...3646b1a5ab47e535a746da10e5461ba70a0b652d,1,19,8,27,5,2013-05-29 19:56:30,2013-05-25 03:31:44
02a110ad435a6ccda648f09f94e546dfd7bdd0ac...0972ccd97cc8f913ea828a1e03ef3652fc1ff514,2,7,0,7,2,2013-10-31 17:05:55,2013-10-31 06:35:31
0972ccd97cc8f913ea828a1e03ef3652fc1ff514...3a347ed70727cdcb447040705b4128304c0244e3,1,13,9,22,9,2013-10-31 17:05:59,2013-10-31 06:36:26
3a347ed70727cdcb447040705b4128304c0244e3...c80d96ca0c3cf948c5062bf6591a46c625620b6d,1,9,2,11,5,2013-10-31 17:13:40,2013-10-31 06:36:51
02a110ad435a6ccda648f09f94e546dfd7bdd0ac...11a6ba1c012e8275c70032fb2e847740a2f61865,1,1,1,2,1,2013-10-15 21:46:31,2013-09-24 05:19:08
02a110ad435a6ccda648f09f94e546dfd7bdd0ac...52ec889d1ab3405796dd4fb4c262f950927a6b71,1,1,1,2,1,2013-10-15 21:20:37,2013-10-15 12:21:11
02a110ad435a6ccda648f09f94e546dfd7bdd0ac...03818a4a94cbe8154eae433892e92d58d215dade,2,22,3,25,4,2013-10-15 17:41:49,2013-10-14 22:45:00
02a110ad435a6ccda648f09f94e546dfd7bdd0ac...a3552aba55b9ed2860b8eb0581c73fc0e996369d,2,11,1,12,3,2013-10-14 19:26:15,2013-10-11 16:49:02
a3552aba55b9ed2860b8eb0581c73fc0e996369d...3991e91063bb701d8ba12199b993a8f121f27f04,1,1,1,2,1,2013-10-15 23:01:22,2013-09-23 19:19:19
02a110ad435a6ccda648f09f94e546dfd7bdd0ac...643069213532b8b035e771afbc4f2c77b79b20e2,1,2,2,4,1,2013-10-14 14:23:40,2013-10-11 19:38:36
643069213532b8b035e771afbc4f2c77b79b20e2...78bef06589dc7570f9b52a6c9fca04d6142cc949,1,4,4,8,2,2013-10-14 14:25:42,2013-10-11 18:24:14
02a110ad435a6ccda648f09f94e546dfd7bdd0ac...3d1fb769b26dbf278a0ef0cf7427aac86a161bb0,1,2,2,4,2,2013-09-30 20:04:31,2013-09-28 08:31:00
3d1fb769b26dbf278a0ef0cf7427aac86a161bb0...132b70a2ed6d952e8142981474b41884ff93b780,1,14,7,21,2,2013-09-30 20:04:45,2013-09-28 08:31:11
132b70a2ed6d952e8142981474b41884ff93b780...1bbcc224ccfdccd99b1221d83150a8ffb8059ffd,4,44,28,72,25,2013-10-01 00:21:59,2013-09-28 08:31:23
1bbcc224ccfdccd99b1221d83150a8ffb8059ffd...2501aff8b7516115c409cb34cc50305cdde40a47,3,11,3,14,8,2013-10-14 23:55:13,2013-09-28 08:31:45
2501aff8b7516115c409cb34cc50305cdde40a47...78868962c03e5bdddad5c5d02c1d5a0c72a7ac26,2,10,0,10,2,2013-10-14 23:55:23,2013-09-28 08:32:02
78868962c03e5bdddad5c5d02c1d5a0c72a7ac26...c93c92f30977adb2eb385a851f9f5e9975da7d5e,2,68,0,68,3,2013-10-14 23:56:47,2013-09-28 08:34:05
c93c92f30977adb2eb385a851f9f5e9975da7d5e...c65d5692cd3434133c2e8f1a20074a261e0267f0,1,7,8,15,8,2013-10-14 23:57:04,2013-09-28 08:35:10
c65d5692cd3434133c2e8f1a20074a261e0267f0...b227bbc43a568b282b5f8cb35e563d00d60b272d,1,19,19,38,16,2013-10-15 00:01:15,2013-09-28 08:35:25
b227bbc43a568b282b5f8cb35e563d00d60b272d...050ef3655c8ea1dc7a2b3b843ca7c45dd94d9c88,4,19,1,20,7,2013-10-15 00:01:34,2013-09-28 08:35:35
050ef3655c8ea1dc7a2b3b843ca7c45dd94d9c88...70900eda4a0ed473ab5a933940285ac3dda698c0,1,1,1,2,1,2013-10-24 21:42:26,2013-10-24 20:17:19
02a110ad435a6ccda648f09f94e546dfd7bdd0ac...159543e8317cd13611dc999efddd3a89c11c1229,1,3,3,6,3,2013-09-27 23:49:18,2013-09-21 15:51:45
159543e8317cd13611dc999efddd3a89c11c1229...e49c8f33ab8e401d5d8f308f83e2a2c756377ef1,1,2,2,4,2,2013-09-27 23:51:27,2013-09-21 15:51:46
02a110ad435a6ccda648f09f94e546dfd7bdd0ac...1c4fb136dbad762c9c4350ee79c3474ae8037587,2,15,1,16,2,2013-09-27 23:06:44,2013-09-27 10:23:55
57e4c1783f056ce2d50a732c0fccff2a1fe99563...8231fa6ae1ef92be73bec5cf0a533a4d8b71d536,3,74,11,85,22,2013-09-12 22:40:29,2013-09-05 16:08:01
0bf5ce4ef27dd24461d7b7b8049058bf80301ddf...a3bc3d070cacf07dbe11b4bfec57554c8bbf1957,1,1,1,2,1,2013-08-09 16:27:44,2013-08-09 09:06:17
81050ac604e27395509b5bffe80692a14d6ad3cd...dc773a67e1a165c8866538fe3e754816b2e27447,1,1,1,2,1,2013-08-05 16:53:38,2013-08-05 16:52:28
531c8dd4fb18e653d6170d367e4b23c3164d5ce0...35035bbf074d1a4c59cd5f99282c12197105da08,3,48,3,51,9,2013-07-18 23:01:30,2013-07-18 16:53:11
531c8dd4fb18e653d6170d367e4b23c3164d5ce0...222b1212c105b46e1672934ecb166fa21d47db3a,1,16,16,32,10,2013-07-09 19:34:16,2013-07-09 05:16:31
531c8dd4fb18e653d6170d367e4b23c3164d5ce0...38678a15a2bf65580573a46e967c1d8d269965ae,1,1,1,2,1,2013-07-08 17:20:59,2013-07-08 15:20:31
38678a15a2bf65580573a46e967c1d8d269965ae...9968ffff0d09b4925f339cceafb5f7e7cd78fb02,1,1,0,1,1,2013-07-08 17:21:33,2013-07-08 15:20:32
c8556c6213cf6dca63f29f98ad9d074f6c5f8233...887c6c18ba84da8d722b1528fe8cdde65d9f9860,2,13,10,23,8,2013-11-20 23:04:51,2013-11-20 01:26:41
fadf96abaa5f42c4bb7b4b5017926779c23d8ef3...bb80ee09974667a1db6bbc5e33574ed869b76a88,1,59,0,59,2,2013-09-09 21:51:42,2013-09-09 21:51:42
c6bc7d435b98d9dd491334cf4e46507c6fff2670...efc90c781054e40e6c4f614320a1f080f99e2123,1,747,543,1290,471,2013-05-01 07:29:03,2013-05-01 07:29:03
c6bc7d435b98d9dd491334cf4e46507c6fff2670...cc7ca63c04fa527026ad918e8c101d5b96cd6dc0,1,731,537,1268,462,2013-04-30 11:30:21,2013-04-30 11:30:21
3d092bfc6f2d9a998967979f926c661e9762601c...b0d12fc9b23a0f656fe3a5dbe2899e85b7e2f5c0,4,8,8,16,6,2013-10-31 22:47:38,2013-10-31 11:08:28
b0d12fc9b23a0f656fe3a5dbe2899e85b7e2f5c0...f8c872127d4c48a6ec02abce34cb059ddeb6402a,3,55,6,61,14,2013-10-31 22:47:41,2013-10-31 11:08:29
3d092bfc6f2d9a998967979f926c661e9762601c...a21455ae664c1a29c157e2bc5ea3abe8e2699eca,1,0,3,3,1,2013-10-31 18:16:40,2013-10-31 09:36:29
a21455ae664c1a29c157e2bc5ea3abe8e2699eca...5a75353fe381b344a33d7a89f7803e4a24d2ddcf,1,5,4,9,4,2013-10-31 18:16:57,2013-10-31 09:36:37
5a75353fe381b344a33d7a89f7803e4a24d2ddcf...510fa6f5188d715050899eee221c739f1c0a8b12,4,40,0,40,7,2013-11-12 21:34:32,2013-11-12 20:56:56
510fa6f5188d715050899eee221c739f1c0a8b12...f9e3c6bebb89de12f2dfdaa1899cb22e9ef32542,1,7,1,8,3,2013-11-12 21:34:48,2013-11-12 20:56:57
f9e3c6bebb89de12f2dfdaa1899cb22e9ef32542...cf31f70c088a314a9d11a4106d2fe1036051890a,1,1,1,2,1,2014-02-24 17:04:17,2014-02-21 09:55:59
cf31f70c088a314a9d11a4106d2fe1036051890a...fdec195f893ac81298b4e108f787172ad0c19a55,1,2,2,4,2,2014-02-24 17:04:27,2013-11-12 20:56:59
fdec195f893ac81298b4e108f787172ad0c19a55...a7cb1276cc263446b19b43d3a7784cbc72f84e28,2,51,2,53,8,2014-02-24 17:04:27,2013-11-12 07:03:28
3d092bfc6f2d9a998967979f926c661e9762601c...4a2d5ae262a6d372d0951da9cee3c7ad2a8dbca6,6,30,4,34,7,2013-10-28 16:57:36,2013-10-26 02:09:20
3d092bfc6f2d9a998967979f926c661e9762601c...90a95301d32bb2f45e37ed08d3a1d1b632706f03,1,4,2,6,2,2013-10-28 16:27:06,2013-10-27 21:26:48
90a95301d32bb2f45e37ed08d3a1d1b632706f03...53039ab15490d8f957f728cbe018e329924ad326,1,18,12,30,3,2013-10-30 17:38:23,2013-10-28 21:43:00
53039ab15490d8f957f728cbe018e329924ad326...05e9d907dd221953c35a2d19420d1f13c63f391e,1,0,1,1,1,2013-11-04 18:11:15,2013-11-04 18:11:15
3d092bfc6f2d9a998967979f926c661e9762601c...ce1a0473e8b5892c27526c0f340b6d440c6f0fff,1,5,5,10,5,2013-10-28 16:00:34,2013-10-26 19:17:14
ce1a0473e8b5892c27526c0f340b6d440c6f0fff...4d715ac05cf5b800a98ce75bbc0cb3ea2dfe70ab,2,67,0,67,2,2013-10-28 16:00:36,2013-10-26 19:17:15
4d715ac05cf5b800a98ce75bbc0cb3ea2dfe70ab...f94ea11cf2b070ef221f0f4c2355a9ee2f340177,3,0,9,9,3,2013-10-28 16:00:38,2013-10-26 19:17:16
3d092bfc6f2d9a998967979f926c661e9762601c...41dfbb2dbe1468bb9bfc0f0cd6677a24e3c6c8b2,2,243,0,243,2,2013-10-25 21:55:30,2013-10-25 07:55:02
3d092bfc6f2d9a998967979f926c661e9762601c...954312a3ff76652a954b730ae69a031f98293a99,1,13,9,22,3,2013-10-25 21:54:17,2013-10-25 06:52:30
954312a3ff76652a954b730ae69a031f98293a99...b3e9ce13320f62e07fcb88a5cdf3c0462c195e95,3,10,7,17,7,2013-10-25 21:54:18,2013-10-25 06:54:06
3d092bfc6f2d9a998967979f926c661e9762601c...e74435a5169b56be901196ad172b4dbda124254d,2,4,4,8,4,2013-10-24 22:44:18,2013-10-24 17:59:49
3d092bfc6f2d9a998967979f926c661e9762601c...2004658b19bf781d446e14e3237f519e80ab0297,1,1,1,2,1,2013-10-24 20:27:45,2013-10-23 15:50:34
2004658b19bf781d446e14e3237f519e80ab0297...d0d06e892a1a7bc6a1dfd76374da09f0170cae2c,1,4,4,8,4,2013-10-24 20:27:45,2013-10-23 15:50:35
d0d06e892a1a7bc6a1dfd76374da09f0170cae2c...68a304d5fed6657e452e8c1571fe9ca93d0a272a,1,4,0,4,2,2013-10-24 20:27:46,2013-10-23 15:50:36
68a304d5fed6657e452e8c1571fe9ca93d0a272a...5b2515f4007ce0fe3d61197905c41eee5a3d06c1,1,10,10,20,1,2013-10-24 20:28:28,2013-10-23 15:50:37
5b2515f4007ce0fe3d61197905c41eee5a3d06c1...f137a45e0db9823d386b18a7a9f5e0fc06c0b67d,1,6,6,12,3,2013-10-24 20:28:44,2013-10-23 15:50:38
f137a45e0db9823d386b18a7a9f5e0fc06c0b67d...a0fbb5a329ea138e02698312f14ac1aea4b9b4c9,1,97,101,198,3,2013-10-30 21:16:33,2013-10-30 05:32:55
a0fbb5a329ea138e02698312f14ac1aea4b9b4c9...f166db26af524278b42caac8f092d8de5e3e9c29,1,7,0,7,1,2013-10-30 21:16:34,2013-10-30 05:32:56
f166db26af524278b42caac8f092d8de5e3e9c29...e31a17f7416a85ee8c3260f8c8b7519ff7ea82b6,1,3,3,6,4,2013-10-30 21:16:34,2013-10-30 05:32:57
e31a17f7416a85ee8c3260f8c8b7519ff7ea82b6...0281c930f17042473e973f39810c8f7c93955d7d,1,32,12,44,9,2013-10-30 21:16:35,2013-10-30 05:32:58
0281c930f17042473e973f39810c8f7c93955d7d...c5a84e92a2fe9e8748e32341c344d7a6c0f52a50,7,78,38,116,29,2013-10-30 21:16:36,2013-10-30 05:32:59
c5a84e92a2fe9e8748e32341c344d7a6c0f52a50...0838bf47b3b37f6ff13b8de183316483958bf3bb,4,30,42,72,11,2013-10-30 21:16:37,2013-10-30 05:33:00
0838bf47b3b37f6ff13b8de183316483958bf3bb...049bff8f0ec722dbd4ca9582df7891c920e41165,1,2,2,4,2,2013-10-30 21:16:40,2013-10-30 05:33:01
049bff8f0ec722dbd4ca9582df7891c920e41165...ce2223fde87c6df2a3d837b188d9509527de7264,1,78,81,159,5,2013-10-30 21:16:40,2013-10-30 05:33:02
ce2223fde87c6df2a3d837b188d9509527de7264...8607590e74814c6c6a352cbd099e2617a69bb2c6,1,17,16,33,11,2013-10-30 21:16:40,2013-10-30 05:33:03
8607590e74814c6c6a352cbd099e2617a69bb2c6...90765fa3e01658ac2fb75a4eb740cee7dad4a2dc,2,5,5,10,3,2013-10-30 21:16:41,2013-10-30 05:33:04
90765fa3e01658ac2fb75a4eb740cee7dad4a2dc...01ca90c2e5e7ffab035c4746d8b7c412fca75874,1,1,4,5,3,2013-10-30 21:16:41,2013-10-30 05:33:05
01ca90c2e5e7ffab035c4746d8b7c412fca75874...37f0dcbdc1585dafd81c393aa750292e8634035d,1,7,7,14,1,2013-10-30 21:16:41,2013-10-30 05:33:06
37f0dcbdc1585dafd81c393aa750292e8634035d...09ea1f8e0e85dd65307b29219ef1f5a3958eb918,1,6,6,12,4,2013-10-30 21:16:41,2013-10-30 05:33:07
09ea1f8e0e85dd65307b29219ef1f5a3958eb918...2071e05ed27df847e300b51aca661a34a765aea3,1,96,0,96,1,2013-10-30 21:16:41,2013-10-30 05:33:08
2071e05ed27df847e300b51aca661a34a765aea3...b9afe6654db2bfb776db933f832e7e03052adf98,3,38,26,64,10,2013-10-30 21:16:41,2013-10-30 05:33:09
b9afe6654db2bfb776db933f832e7e03052adf98...df02ebdac8bdf0edd30e85c9902d177dccfac276,1,10,8,18,2,2013-10-30 21:16:41,2013-10-30 05:33:10
df02ebdac8bdf0edd30e85c9902d177dccfac276...76ea6717fe7dda28966f586e09e02b7b0d5b76cf,1,1,1,2,1,2013-10-30 21:16:42,2013-10-30 05:33:11
76ea6717fe7dda28966f586e09e02b7b0d5b76cf...f096e6e826678c29e4bfde4d9d1ae1df79074ce3,2,31,8,39,6,2013-10-30 21:16:42,2013-10-30 05:33:12
240ae2b8c96c3b9836d516de36dacd65bea9c4a2...1ca6d4bc426435ecb87c6eb7802e83ff0a2f1667,1,8,8,16,1,2013-04-29 16:52:06,2013-04-27 20:34:05
1ca6d4bc426435ecb87c6eb7802e83ff0a2f1667...4911589bd1cdb79e6b8f658d5caebc440a656046,1,119,1,120,4,2013-04-29 16:52:06,2013-04-27 20:34:06
240ae2b8c96c3b9836d516de36dacd65bea9c4a2...de7c201a10857e5d424dbd8db880a6f24ba250f9,1,1,1,2,2,2013-04-29 15:07:22,2013-04-29 12:49:37
de7c201a10857e5d424dbd8db880a6f24ba250f9...2651baaea9f9c607c09f715c7640616e39b5c60d,1,5,0,5,2,2013-04-29 15:07:23,2013-04-29 12:49:38
2651baaea9f9c607c09f715c7640616e39b5c60d...a05490edbf7beb49266b3f4e4524e996428fa41d,1,4,0,4,1,2013-04-29 15:07:23,2013-04-29 12:49:39
e52e6f79ccc372825313890b96007985b8aa6e9c...562af5b0b900539bd7ef481316834e500f571899,1,19,0,19,3,2013-04-23 18:27:15,2013-04-23 18:27:15
6a907786af835ac15962be53f1492f23e044f479...912b2acf2f376e51bee32a486ca42ba4ad764363,4,38,1,39,7,2013-07-30 16:19:04,2013-07-23 22:40:17
912b2acf2f376e51bee32a486ca42ba4ad764363...580cf0a02ee15045a02c8ffefca646bbb0b1e953,1,2,4,6,2,2013-08-05 18:02:53,2013-08-05 15:59:24
9832cb9d4dc969fbfacfd1f8940fcbdec18bb930...e19189060fcfb62410ce8e008720dbb6e7fa0d7b,2,45,3,48,6,2013-07-08 15:55:21,2013-07-04 20:38:54
9832cb9d4dc969fbfacfd1f8940fcbdec18bb930...db2b3b820e2b28da268cc88adff076b396392dfe,2,27,5,32,5,2013-07-02 19:46:30,2013-07-02 08:05:48
9832cb9d4dc969fbfacfd1f8940fcbdec18bb930...22c5b136363c7aa427667876e787db832548a038,4,94,6,100,8,2013-06-27 20:52:41,2013-06-27 19:26:31
22c5b136363c7aa427667876e787db832548a038...a49528155b8a35b34d00d0c2ace528e72c1fef06,1,36,38,74,4,2013-07-01 16:54:00,2013-07-01 16:23:38
9832cb9d4dc969fbfacfd1f8940fcbdec18bb930...15dd5ffb543848c914c2f3dabfedb1816bd2474d,1,1,0,1,1,2013-06-25 22:18:43,2013-06-25 16:39:15
ac1998deddbb5b59c80f2a3d902e18b31fe9cc50...e4244eb3957d478ca05b42d8b56aadb9ab2bc7ae,2,12,3,15,5,2014-05-19 22:36:24,2014-05-19 22:05:20
e4244eb3957d478ca05b42d8b56aadb9ab2bc7ae...ddb5432d2390e1957e473618009ba3d2fbbf29a7,1,15,0,15,1,2014-05-20 18:33:49,2014-05-20 07:49:31
992c38644a4b001bdc89b5b5008fc5f6674ed5b7...f38798f48dc8ed53fe001cc5a0d422f5c56b9d81,1,3,6,9,3,2013-08-31 03:58:43,2013-08-30 21:56:45
f38798f48dc8ed53fe001cc5a0d422f5c56b9d81...82a0672f8ed4c63bf8420cd55f7307d40b9a6594,1,1,1,2,1,2013-08-31 03:58:49,2013-08-30 21:56:46
82a0672f8ed4c63bf8420cd55f7307d40b9a6594...4e83ab3e8d43beaa7a2097a2f34d3b9eb67525bb,1,1,1,2,1,2013-08-31 03:59:04,2013-08-30 21:56:48
4e83ab3e8d43beaa7a2097a2f34d3b9eb67525bb...d521abf8900dc38f88ed8fbb007848fb2a812510,1,5,5,10,5,2013-08-31 03:59:18,2013-08-30 21:56:49
d521abf8900dc38f88ed8fbb007848fb2a812510...b07f7296080b20f5cc2069ce2761cacdd79b3432,1,2,3,5,1,2013-09-08 18:39:30,2013-09-08 15:21:44
4c4d9d9b654db3eecb6e1107e814a737eafce0d6...a194eaddca201163aa756faccd519f056bd3c35e,1,32,0,32,2,2013-09-11 22:05:57,2013-09-11 22:05:57
f223459bec106bbe211a01321e48c050a9cad25e...6b364d48f2e72d6c37115e6aa4fe769a523dd1d4,2,20,12,32,7,2013-11-18 19:24:08,2013-11-14 18:18:01
2c2b6646c2723459dbd334c7ced6f77ffb0d596e...4d06473928ee574910accbde05c19ef2263abdf6,2,1,10,11,3,2013-08-19 17:34:14,2013-08-19 17:34:14
2c2b6646c2723459dbd334c7ced6f77ffb0d596e...a4889e64bf4bf52994923a5bd59092a47bdbc3c6,1,23,0,23,1,2013-08-18 21:41:21,2013-08-17 09:01:58
2c2b6646c2723459dbd334c7ced6f77ffb0d596e...3125fe528b65c1e4a4f5f934d056af342ab5472d,3,58,52,110,6,2013-08-18 20:00:17,2013-08-16 09:52:02
3125fe528b65c1e4a4f5f934d056af342ab5472d...6a3bbb4db409c5417960ffd3f020f75e0cb36f81,1,2,0,2,1,2013-08-28 18:51:17,2013-08-16 09:52:03
6a3bbb4db409c5417960ffd3f020f75e0cb36f81...08ea65ad13faaf24f57732cdc8af3d830d4b367f,2,24,0,24,2,2013-08-28 18:51:54,2013-08-16 09:52:04
08ea65ad13faaf24f57732cdc8af3d830d4b367f...cdab485853b405d6454d4974bdc3825134d85249,2,32,99,131,8,2013-08-28 18:52:11,2013-08-16 09:52:05
cdab485853b405d6454d4974bdc3825134d85249...e76a5fb4593b80cdc9dda66809ae910e86b6ffbe,6,8,9,17,7,2013-08-28 18:54:18,2013-08-16 09:52:06
e76a5fb4593b80cdc9dda66809ae910e86b6ffbe...fbd4a7036dfa71ec89e7c441cef1ac9aaa59a315,1,17,0,17,3,2013-08-28 18:54:18,2013-08-16 09:52:07
fbd4a7036dfa71ec89e7c441cef1ac9aaa59a315...f21d2a786b7fa6e53bb09e6466185b26f7f30d98,1,11,0,11,1,2013-08-28 18:57:28,2013-08-28 16:02:02
d50cb7569cfb6e04ba48900821618d28012f334e...304852fc77847e649c746db95e9c4675c03ee567,1,1,1,2,1,2013-08-01 19:01:53,2013-08-01 19:01:53
dc89689e86c991c3ebb4d0b6c0cce223ea8e6e47...efc266e8aedfd6c5011ea645a85e0744aaecb5d1,1,6,9,15,1,2010-01-10 06:40:52,2010-01-10 02:59:41
efc266e8aedfd6c5011ea645a85e0744aaecb5d1...578b62bfa239caca89e37fca05dcbed5add17699,1,4,4,8,3,2010-01-10 06:41:08,2010-01-10 03:01:21
53d149c54bdedd4cf490943a5478a7826c2379c9...1756fed9ee849c687f92cac30d86d2955d8c94c4,1,2,2,4,1,2007-11-08 22:15:32,2007-11-08 14:02:00
1756fed9ee849c687f92cac30d86d2955d8c94c4...ad7638b2edbad05d5f5581ec76d49094d8ba9237,1,31,2,33,7,2007-11-08 22:17:32,2007-11-08 09:47:39
ad7638b2edbad05d5f5581ec76d49094d8ba9237...5c355059c379a55366bed573d4e65dba4b5a0565,1,0,4,4,1,2007-11-08 22:18:13,2007-11-08 12:11:57
5c355059c379a55366bed573d4e65dba4b5a0565...f3fa1838024dc0f3741d2f9654af92f6a1bb34bd,8,20,10,30,10,2007-11-08 23:35:32,2007-11-08 23:35:32
f3fa1838024dc0f3741d2f9654af92f6a1bb34bd...063036af0832710cfcb1380cc4f9c4597b98cc26,1,2,1,3,1,2007-11-09 08:19:24,2007-11-08 21:48:24
35865ca24500a0d46a012f7a55f39bf36389f7ba...a4e57e75c95c66c32da6b106313bc847110794ba,2,2,7,9,3,2007-11-12 08:18:44,2007-11-12 00:32:51
a4e57e75c95c66c32da6b106313bc847110794ba...cfbe7ab333d68790eb37341e30f040f99cef6af7,2,62,2,64,5,2007-11-12 08:22:49,2007-11-12 07:37:42
cfbe7ab333d68790eb37341e30f040f99cef6af7...f192c5d0fb37a1a89d88e92bb7b21418b57c2129,1,14,10,24,4,2007-11-13 01:49:49,2007-11-12 08:27:35
7666cdedb4e73948690587cda61b256ea2367c56...a3b0079c6a2e6336b061465623b8f2db308a6978,1,1,1,2,1,2007-11-12 01:09:55,2007-11-11 07:29:30
a3b0079c6a2e6336b061465623b8f2db308a6978...b73a4397590df9582dd1c994cac30e55e26b0b1e,2,5,2,7,3,2007-11-12 01:09:55,2007-11-11 07:29:37
b73a4397590df9582dd1c994cac30e55e26b0b1e...27350891de59608d4db689cf0851f7e49158a6e3,2,31,4,35,10,2007-11-12 01:09:55,2007-11-11 07:29:41
27350891de59608d4db689cf0851f7e49158a6e3...4191c35671f6392173221bea3994f8b305f4f3a8,2,100,2,102,6,2007-11-12 01:09:55,2007-11-11 07:29:47
591aa2536fdbc4090ba8d4ca512d4ee7df4bf05d...6e9af863ee76423ec8416ad16140ef5f810783bf,4,16,4,20,6,2007-12-11 08:42:05,2007-12-11 06:27:33
6e9af863ee76423ec8416ad16140ef5f810783bf...cd459e3ffa1b85f3a33c52967b1a7dff43bda29e,1,2,33,35,2,2007-12-11 08:42:07,2007-12-11 06:28:42
591aa2536fdbc4090ba8d4ca512d4ee7df4bf05d...ff72af00f86cbbaaab57c886c70f9799715ca02f,2,10,4,14,3,2007-12-11 08:40:56,2007-12-10 19:22:05
591aa2536fdbc4090ba8d4ca512d4ee7df4bf05d...060610c572b21d00bb09ebbab664c0452c7eac9d,3,218,110,328,51,2007-12-11 05:28:25,2007-12-09 07:27:41
060610c572b21d00bb09ebbab664c0452c7eac9d...66ab84b99cdff3d650c9458aa737916735aebfcc,1,57,14,71,16,2007-12-11 05:28:27,2007-12-09 07:27:42
591aa2536fdbc4090ba8d4ca512d4ee7df4bf05d...e306be5cd058b957850b26e9b5053f1231543ee9,1,1,1,2,1,2007-12-10 18:58:09,2007-12-10 13:40:20
e306be5cd058b957850b26e9b5053f1231543ee9...c07c7bf630efd8ddcd41490036c1eefb01a39f98,1,43,3,46,7,2007-12-10 19:24:56,2007-12-10 03:05:34
c07c7bf630efd8ddcd41490036c1eefb01a39f98...eb9688ff65a3f7fb28ee6488be728fc72e42d5d6,1,10,0,10,1,2007-12-11 01:10:16,2007-12-10 19:19:32
eb9688ff65a3f7fb28ee6488be728fc72e42d5d6...923db42eea6fac743d8c93f0af4904740a445edf,2,22,0,22,2,2007-12-11 08:38:38,2007-12-09 12:57:39
923db42eea6fac743d8c93f0af4904740a445edf...28072a5d303b212695ef8b70f24cfed069ec94b8,2,2,6,8,3,2007-12-11 08:38:46,2007-12-10 09:31:02
28072a5d303b212695ef8b70f24cfed069ec94b8...ace9c2a9dd7c9e54194998fc6b7c677dbb7d0902,1,4,3,7,1,2007-12-11 08:38:46,2007-12-11 05:44:42
ace9c2a9dd7c9e54194998fc6b7c677dbb7d0902...be15f50538afa4bfb912a86fa9d9f141010ad691,2,51,10,61,5,2007-12-11 08:38:46,2007-12-11 04:08:06
be15f50538afa4bfb912a86fa9d9f141010ad691...bf82a15095ed374496c2e98b6b672aa8c8c4d034,1,7,3,10,2,2007-12-11 08:38:46,2007-12-11 05:02:26
bf82a15095ed374496c2e98b6b672aa8c8c4d034...550f8fd01bd57814b7ac8a7fed1709a50d6c6d90,1,4,4,8,3,2007-12-11 17:52:44,2007-12-11 16:36:32
550f8fd01bd57814b7ac8a7fed1709a50d6c6d90...18ff365fcb3b16d6802c04da03ceda3a260c0ab9,1,42,1,43,2,2007-12-11 17:55:21,2007-12-11 12:56:09
18ff365fcb3b16d6802c04da03ceda3a260c0ab9...ef4cffde9cf45a4203be5f78cf8f025f4f694a66,1,2,1,3,1,2007-12-11 19:07:23,2007-12-11 12:53:47
ef4cffde9cf45a4203be5f78cf8f025f4f694a66...7c3c79629547195d13e325ea015ce9f89bf461b5,1,15,2,17,2,2007-12-12 00:05:50,2007-12-12 00:05:50
7c3c79629547195d13e325ea015ce9f89bf461b5...d4110a9726c7cd5cda35b7dd03dc8f85fe3dff0c,1,4,1,5,1,2007-12-12 18:59:22,2007-12-11 06:47:31
d4110a9726c7cd5cda35b7dd03dc8f85fe3dff0c...b0fe0d7258951779b790190b10ca21ffc5573546,1,1,1,2,1,2007-12-12 18:59:22,2007-12-11 22:01:28
b0fe0d7258951779b790190b10ca21ffc5573546...03b69c7606267bc978c69cf88fcd7a8edf8175bc,3,6,1,7,6,2007-12-12 18:59:22,2007-12-11 21:59:55
03b69c7606267bc978c69cf88fcd7a8edf8175bc...472b25709900723a35b404456ae8e28bfc446932,1,9,6,15,9,2007-12-12 18:59:22,2007-12-11 22:50:21
472b25709900723a35b404456ae8e28bfc446932...0ac7903ee3c7c93d2426a4aa4f3732bee73e0365,3,9,10,19,6,2007-12-12 18:59:22,2007-12-12 08:12:01
0ac7903ee3c7c93d2426a4aa4f3732bee73e0365...71a9883db2b60e0d21b730cb9695de69111ab584,1,1,1,2,1,2007-12-12 18:59:22,2007-12-12 08:14:20
71a9883db2b60e0d21b730cb9695de69111ab584...f604652e05073aaef6d83e83b5d6499b55bb6dfd,2,129,32,161,22,2007-12-12 18:59:22,2007-12-12 07:46:30
f604652e05073aaef6d83e83b5d6499b55bb6dfd...86f8c2368523db5ee56c8856748b26c31ebeb0aa,2,19,3,22,3,2007-12-12 19:24:33,2007-12-12 16:22:59
86f8c2368523db5ee56c8856748b26c31ebeb0aa...8d08f2d81a59715a715d48384db18c9b345b8589,1,2,0,2,1,2007-12-12 19:53:29,2007-12-12 19:53:29
5c9afcff1aa048abf95296231d51fa481304a735...bbdfbc4b01b38489a0c171bc70c89e017c759cdc,1,8,8,16,5,2008-03-08 21:22:55,2008-03-08 20:46:34
bbdfbc4b01b38489a0c171bc70c89e017c759cdc...caa99829a24bc4decf86278c3478c88f564a795a,1,22,0,22,1,2008-03-08 21:22:55,2008-03-08 20:47:06
e2b7eaf0ca3897940961d23392d4ff718867ea9f...5072a32382fb65fa7295811575d0f5c09cbe0dc3,1,11,3,14,5,2007-10-29 20:32:52,2007-10-29 08:41:18
5072a32382fb65fa7295811575d0f5c09cbe0dc3...79f3368d9a1bba022f38806b67c25ffffc0e7e92,2,27,2,29,5,2007-10-29 20:33:38,2007-10-29 20:09:01
79f3368d9a1bba022f38806b67c25ffffc0e7e92...68492fc73b7387fa72d09545f5743728c5fdb419,2,50,16,66,14,2007-10-30 00:03:11,2007-10-28 20:27:13
68492fc73b7387fa72d09545f5743728c5fdb419...09149c7809a37a52b38d8d7a0621e2fb8943d8fe,1,4,3,7,3,2007-10-30 03:32:22,2007-10-30 02:35:08
26b28007689d27a921ea90e5a29fc8eb74b0d297...769f39861b73a374f116fcb913e5ff276fe92751,1,4,3,7,2,2007-09-29 00:13:14,2007-09-27 21:41:23
769f39861b73a374f116fcb913e5ff276fe92751...f6e0e559340af6e300b63da061fa05ff07e3d6f6,1,2,2,4,2,2007-09-29 01:23:22,2007-09-29 01:23:22
f6e0e559340af6e300b63da061fa05ff07e3d6f6...208fe3ac7e1fd5be173cae1db4fa776390bc4e7d,1,2,2,4,2,2007-09-29 02:26:05,2007-09-29 02:26:05
26b28007689d27a921ea90e5a29fc8eb74b0d297...9f569fe58f2e9a6547ae75971ebf3910be3d5872,1,4,0,4,1,2007-09-27 23:19:19,2007-09-27 20:30:59
6e863d6d129a1b6a13c66d0bb03f3d43db6c51fe...538dfe7397db62e5c7e8861c272380140969a8b8,4,5,5,10,5,2007-10-21 05:43:27,2007-10-21 04:12:12
ea55960518bb104020c02aa2f64b33f93d1775e7...8d3f1743103daafab20b6c7b34c1690ecc5af837,1,3,2,5,1,2007-11-19 08:11:40,2007-11-19 08:06:31
ea55960518bb104020c02aa2f64b33f93d1775e7...396865859918e9c7bf8ce74aae137c57da134610,2,61,88,149,20,2007-11-19 03:19:20,2007-11-09 13:42:56
396865859918e9c7bf8ce74aae137c57da134610...bd46c9a91261f282546a1a41b5303b041fae1361,2,32,9,41,9,2007-11-23 07:18:09,2007-11-23 07:16:51
bd46c9a91261f282546a1a41b5303b041fae1361...c1a41b9d04d81f1c64754c933ef596045cfb99aa,1,3,0,3,1,2007-11-25 23:47:29,2007-11-25 23:21:42
c1a41b9d04d81f1c64754c933ef596045cfb99aa...10507857fe8c5d8774d016a8542c8dd572271a8a,1,16,0,16,1,2007-11-26 05:23:28,2007-11-26 04:50:58
ea55960518bb104020c02aa2f64b33f93d1775e7...113f10f22f4b3b599e44e192e241e0bace9cc39e,5,158,1,159,5,2007-11-19 03:11:42,2007-11-12 01:48:47
113f10f22f4b3b599e44e192e241e0bace9cc39e...625db1b7530b621f32b0ef1ef502a09a05872f5d,1,9,3,12,4,2007-11-19 03:11:42,2007-11-13 05:13:05
625db1b7530b621f32b0ef1ef502a09a05872f5d...1617adc7a074415413b2f48da72f43d5c6cd74c4,1,5,12,17,3,2007-11-19 03:11:42,2007-11-15 05:00:54
ea55960518bb104020c02aa2f64b33f93d1775e7...62ba5143ec2ab9d4083669b1b1679355e7639cd5,3,32,11,43,6,2007-11-19 03:11:14,2007-11-17 18:51:16
ea55960518bb104020c02aa2f64b33f93d1775e7...47d996a20c3347bb9efbb44e8ed2d615cfdffba3,2,26,0,26,2,2007-11-19 02:39:00,2007-11-11 14:35:07
47d996a20c3347bb9efbb44e8ed2d615cfdffba3...79803322c1d8d2f74e1a53d44f363d878180e0f5,3,29,12,41,5,2007-11-19 02:39:00,2007-11-11 14:01:46
79803322c1d8d2f74e1a53d44f363d878180e0f5...ae36bdcf5147b1b54de852eda111ad76a3040726,3,15,6,21,4,2007-11-19 02:39:01,2007-11-11 14:01:47
ae36bdcf5147b1b54de852eda111ad76a3040726...605b4978a105e2f40a353513f616be7d20f91c15,4,35,21,56,6,2007-11-19 02:39:01,2007-11-11 14:01:48
1ab58e8d6f728cdde0057f7ee88daab3a1c2d06f...e0fda6abd11c567b72f29ec0ee06c541404a9cb7,1,1,1,2,1,2007-11-26 20:32:04,2007-11-26 08:34:48
e0fda6abd11c567b72f29ec0ee06c541404a9cb7...ecf4831d89ba6986249e1bf232b2e2f5f7536223,4,4,4,8,4,2007-11-26 20:32:05,2007-11-25 22:29:03
ecf4831d89ba6986249e1bf232b2e2f5f7536223...aa4f31d5a3923939bf2cb670ecaa4f68025f4bf3,1,2,2,4,2,2007-11-28 04:42:21,2007-11-26 22:04:28
aa4f31d5a3923939bf2cb670ecaa4f68025f4bf3...16ed34ad35d9a991a72b2db420ff95bc260990cc,1,8,6,14,4,2007-11-28 23:19:35,2007-11-28 15:50:38
16ed34ad35d9a991a72b2db420ff95bc260990cc...0673c96db92429d1c6dee528c71b067470b1e8f9,1,0,28,28,1,2007-11-28 23:52:23,2007-11-21 07:19:34
0673c96db92429d1c6dee528c71b067470b1e8f9...9e42d6a1c53dadd409fab11cc76e0eba9ec15365,1,6,4,10,4,2007-11-29 00:03:38,2007-11-21 20:27:19
9e42d6a1c53dadd409fab11cc76e0eba9ec15365...c67bbc55f0310de79647457b1fa2a5d3b1746488,1,3,2,5,2,2007-11-29 00:20:13,2007-11-23 00:20:35
c67bbc55f0310de79647457b1fa2a5d3b1746488...b3a4f8586b4ffa6c896cf0afb2ea49d64faf81ad,1,14,0,14,1,2007-11-29 00:20:31,2007-11-23 01:11:35
96f11953c0b0b9b0a0c75fb98bdf239dce5ff582...8af52d7a83a78c5f3a60d5bd5099a5073655339a,1,1,1,2,1,2007-10-20 05:42:01,2007-10-20 05:42:01
8af52d7a83a78c5f3a60d5bd5099a5073655339a...bea6878be2fb73e50407f93f2bcd71b961510c19,1,4,1,5,1,2007-10-21 00:36:27,2007-10-20 18:16:15
bea6878be2fb73e50407f93f2bcd71b961510c19...bbbadf6e58f72ac6bf739d2a1109cbd872eb1083,1,1,1,2,1,2007-10-21 00:42:01,2007-10-21 00:42:01
b7d68258a34320884735f94f5e7184946b72d065...2ce3755a5591354e5aa011254da859889b9be08e,2,12,2,14,6,2007-10-10 05:19:48,2007-10-05 20:30:32
2ce3755a5591354e5aa011254da859889b9be08e...becfb01553ea50c476013d2c31c93eae119fcf64,1,34,11,45,7,2007-10-10 05:20:04,2007-10-05 20:32:55
becfb01553ea50c476013d2c31c93eae119fcf64...aad2dc27636cac9cebd7605a0a57fa50dfb3378e,1,47,66,113,47,2007-10-10 05:20:20,2007-10-05 20:01:39
aad2dc27636cac9cebd7605a0a57fa50dfb3378e...1d6e05f6bda69c4e066f61a85bfdd6d10ca209c0,1,633,165,798,151,2007-10-10 05:20:31,2007-10-08 19:34:56
b7d68258a34320884735f94f5e7184946b72d065...281fdf6921abb11a90a890c09ccce61453050415,2,44,38,82,3,2007-10-10 05:12:15,2007-10-05 12:35:41
281fdf6921abb11a90a890c09ccce61453050415...68099eeeed161fd1adf0822de1dcb388663fc686,2,80,78,158,2,2007-10-10 05:12:16,2007-10-05 12:38:35
68099eeeed161fd1adf0822de1dcb388663fc686...51e1eadb7cd9c8b1943fdc62fe28535bfc032fc6,1,1,0,1,1,2007-10-10 05:12:16,2007-10-06 00:15:10
51e1eadb7cd9c8b1943fdc62fe28535bfc032fc6...1cad232f92794834c8e70dfc0a1f35431d2c05cd,1,12,42,54,15,2007-10-10 05:12:17,2007-10-08 01:12:31
1cad232f92794834c8e70dfc0a1f35431d2c05cd...6bdf5e5f20c792ad0c5d5ba941d7e637aca86d32,2,45,28,73,14,2007-10-10 05:12:17,2007-10-08 05:23:54
6bdf5e5f20c792ad0c5d5ba941d7e637aca86d32...13824e2df23c18eab28b2b9a8c112276a84dd419,2,13,7,20,3,2007-10-10 05:12:18,2007-10-08 05:39:08
13824e2df23c18eab28b2b9a8c112276a84dd419...c73ce762f091688ce6bcd5470239f7c5d1963800,1,2,2,4,2,2007-10-10 05:12:18,2007-10-05 12:47:23
6f9f3b263b1c86889d6fae0d50c75be0f3227003...bf8675d314ffb0289779a954fdf6ae22f3322d0d,1,1,1,2,1,2006-11-05 07:41:02,2006-11-05 07:27:07
bf8675d314ffb0289779a954fdf6ae22f3322d0d...af8ffbed0fc016e066765706738c45c65493f392,1,2,12,14,6,2006-11-05 07:41:05,2006-11-05 07:28:25
af8ffbed0fc016e066765706738c45c65493f392...6c2f207b2316149ee8dfaf026e4a869ff9ab42f7,2,12,13,25,3,2006-11-05 07:48:36,2006-11-05 05:37:23
eb07fd59acae0f043b9fac2a8a1cb427036c6f71...6173c197c9a23fa8594f18fd2c856407d4af31c1,1,5,5,10,4,2006-12-03 01:25:34,2006-12-03 00:19:31
86fe7c0117c12c21a48784979f9e802ce423a17c...1b12df5262aae78b5fbcdb94e718d19710ce12a5,1,1,1,2,1,2013-11-12 05:31:15,2013-11-02 17:56:14
1b12df5262aae78b5fbcdb94e718d19710ce12a5...1d38363d86d16dee58df15a047d448baee6435ba,1,1498,1216,2714,1141,2013-11-12 05:31:15,2013-11-02 17:58:52
1d38363d86d16dee58df15a047d448baee6435ba...1f6fb7ffc344e59589ac794ce7ae47ae7c2cff42,1,1,1,2,1,2013-11-12 05:31:15,2013-11-08 19:34:35
8a5f2eac5271ba1efed353c0c0a992d6471a8d05...cb9594e28c940d2bbf4d7fb69c337d27155da37a,1,1,0,1,1,2006-03-18 10:05:02,2006-03-18 10:05:02
a41e109c4bcd56537fc3801623b1aa0dd4e06f1c...c348f31ab9d8f695aef405d9981b85c943a5875a,1,9,5,14,2,2006-03-13 01:06:57,2006-03-12 21:39:31
47874d6d9a7f49ade6388df049597f03365961ca...5ceb05f82edc49ad5e6b0ad98d633c124a567309,1,9,3,12,3,2006-03-21 10:02:46,2006-03-21 09:58:26
24e12579fc4d6886d5e62aeab53eefdaeaeaffcd...a248c9614fdd130229fb5f9565abbd77bd1d0cc9,1,3,2,5,2,2006-05-03 22:51:46,2006-05-03 22:51:46
f6c7081aa97aa67baa06390a1ef36088c33bf010...3dc5a9e4cdcc7124c665a050547d1285d86a421f,2,151,35,186,20,2006-04-29 05:41:31,2006-04-29 04:58:05
0dec30b9788b12fdae5d5b69fc366a28bb688d80...34fd1c9ac5845d541e3196983df7f993e751b544,1,2,0,2,2,2006-04-21 20:00:10,2006-04-21 19:25:13
a4d0cced53facb17d777a396aa6b388e97f1d909...44aad15f0d03860884bbe1cc95ff6dfc4badf505,1,68,9,77,10,2006-04-20 06:22:19,2006-04-20 03:41:14
a4d0cced53facb17d777a396aa6b388e97f1d909...ec167793d84ba7b765e1eb71b0257ce7baca2d26,3,149,1,150,3,2006-04-19 23:12:41,2006-04-19 19:51:29
5119602a99f46aaa7b3bb2a0f5085b1df46b54ec...041a7308de3e6af36c5a6cc3412b542f42314f3f,1,10,9,19,10,2006-04-19 18:56:07,2006-04-19 18:56:07
041a7308de3e6af36c5a6cc3412b542f42314f3f...f3ab49db1b88b753fc628d7b241f20f73950e162,1,1,1,2,1,2006-04-19 18:56:53,2006-04-19 18:56:53
f3ab49db1b88b753fc628d7b241f20f73950e162...4dcff634e6294bcd7a40c8a51762b675b35be237,3,52,52,104,3,2006-04-19 21:05:47,2006-04-19 21:05:47
4c4b158b8f31a19f724a84b11fa538bfbf465d32...43885c2a557871aedcbb1a412fc18e98c3dd1dc4,1,1,1,2,1,2006-04-20 19:45:02,2006-04-20 19:45:02
dfdcb558ecf93c0e09b8dab89cff4839e8c95e36...5cf7e21fbc1819de7975b17f4b19cfdc3a057c1d,1,3,1,4,1,2006-04-14 19:41:51,2006-04-14 19:41:51
5cf7e21fbc1819de7975b17f4b19cfdc3a057c1d...e3a125a94d34d22a8ca53e84949a1bb38cd6e425,1,0,15,15,1,2006-04-14 19:48:45,2006-04-14 19:47:10
e3a125a94d34d22a8ca53e84949a1bb38cd6e425...e51c3b50063d52ecd209a6f9846570d660e6310c,1,20,4,24,4,2006-04-14 19:59:09,2006-04-14 19:59:09
e51c3b50063d52ecd209a6f9846570d660e6310c...cad1ed953513c3ef099d524746bb737c2be7b701,1,1,1,2,1,2006-04-14 22:54:51,2006-04-14 22:54:51
cad1ed953513c3ef099d524746bb737c2be7b701...40c2fe003ce2af3ec522f239be274fd1a27422f6,1,5,10,15,1,2006-04-15 04:46:08,2006-04-15 04:20:51
dfdcb558ecf93c0e09b8dab89cff4839e8c95e36...7f732c632ff7a1adc2309257becdc0c1fe76b514,1,14,19,33,8,2006-04-14 05:28:06,2006-04-14 05:28:06
ece634d1478a9f1bf19eed8a6b7dee305fadd46e...84981f9ad963f050abf4fe33ac07d36b4ea90c6d,1,2,2,4,1,2006-04-14 04:35:54,2006-04-14 04:35:54
67c22874cf82edae9b5c5f0a47c432d08d7ad426...3cd204e518ce832402c291be73292baa149d0240,1,10,10,20,6,2006-11-23 10:06:16,2006-11-23 10:06:16
7612a1efdb0c0806b43db10ce784707aae874340...e9b9368168399bf165a0172bb00a67216479c82b,1,1,1,2,1,2006-06-09 22:26:08,2006-06-09 22:26:08
e9b9368168399bf165a0172bb00a67216479c82b...f6407823d1467a6b6d2002878a64dec42df0a361,1,2,2,4,1,2006-06-10 03:37:45,2006-06-10 02:15:09
f6407823d1467a6b6d2002878a64dec42df0a361...138086a72582620e0b3ec0aa60a78da208e89a2a,6,54,29,83,6,2006-06-10 05:15:50,2006-06-10 05:07:23
138086a72582620e0b3ec0aa60a78da208e89a2a...5e3a620cd5f7baaf27198192a614271c6145ec3b,1,2,6,8,3,2006-06-10 08:12:50,2006-06-10 08:12:50
7612a1efdb0c0806b43db10ce784707aae874340...7122f82f56425d942bc5e892ed5e6b3bbd0a6724,1,1,1,2,1,2006-06-09 04:22:33,2006-06-08 21:54:13
bd886fd3ea49b726493255d4adf5d20b31681713...be65e7d9fbd3ae6fc097cedade2afe39805fcf4e,2,5,5,10,5,2006-05-07 04:34:32,2006-05-06 22:02:53
22293b9c41778bb60f3b07355e1b8e421a503702...0cc9e70c4c9adb3e79b4a492f2f989c611d85966,2,6,6,12,6,2006-05-07 04:36:24,2006-05-06 22:02:53
42d0ee8302c361a0e3bde7bc59858eda94bc13a4...addaacab07d91e5ff1f06ada31c9e96c0edd31cd,1,35,29,64,8,2006-05-08 18:05:01,2006-05-08 15:31:11
d5e3d60c200b214e36eacfb3de21044a7efd1971...5e363541d0431b640e4bbbafb2941d1c64fa13c4,1,8,0,8,1,2006-05-22 07:31:02,2006-05-22 07:31:02
d5e3d60c200b214e36eacfb3de21044a7efd1971...81c5cf786581c82a8834726ffef26b7def96bf35,1,7,0,7,2,2006-05-22 00:37:46,2006-05-22 00:15:06
328b710d800dc3786fe2b8595e5553dc4a4af424...698ce6f87e0d6db380f7306e190e8586da184577,9,68,12,80,16,2006-05-21 09:03:09,2006-05-20 13:40:29
698ce6f87e0d6db380f7306e190e8586da184577...685637381a967cd7388495f97b12b7cf177abbb4,3,3,347,350,4,2006-05-21 09:48:21,2006-05-21 09:48:21
93872e07008510340eec951f0d037f7b3a0b8567...3fb3cc69af397ee68774485042d6b48a49417c1a,1,1,0,1,1,2006-05-23 08:31:38,2006-05-23 08:31:38
62a4417b574ce5120882016fd7803b9bccf68a67...711fc8f660be16ae4c4caaf3caa495d12310b5ad,1,956,0,956,1,2006-02-18 18:57:15,2006-02-18 16:50:49
62a4417b574ce5120882016fd7803b9bccf68a67...925f9187697acfdbd7dbfe15e8420e1d3a671433,1,14,0,14,2,2006-02-18 09:24:38,2006-02-18 09:20:06
735d80b3bf1be9513d030e61af1ef6512cec015a...772d8a3b63ff669c285edb8aff0c63b609614933,2,66,0,66,2,2006-02-18 07:52:57,2006-02-17 07:26:16
767e130915015f897fb87b939843b4882212574b...6b94f1e404afc552e5139c4357331843f5be61ad,1,8,0,8,1,2006-01-28 07:05:05,2006-01-28 07:05:05
941c9449999192e2d338ee204f4153e30ae43829...016fb48bc480dde83b57466f59f633cbc5128ae6,1,8,2,10,3,2006-01-25 08:10:14,2006-01-19 20:58:03
941c9449999192e2d338ee204f4153e30ae43829...2c620a1ad1dce1e249d66ce18c7b1cce22d5d64c,2,14,1,15,4,2006-01-25 07:17:26,2006-01-20 18:05:24
2c620a1ad1dce1e249d66ce18c7b1cce22d5d64c...96b086d6181067e9c76f543aaddfc7fcfd02649c,2,13,4,17,8,2006-01-25 07:17:26,2006-01-20 18:38:16
941c9449999192e2d338ee204f4153e30ae43829...87e80c4b5fec421ecd566498b7dd4672f76fdca2,3,17,16,33,14,2006-01-25 07:17:06,2006-01-23 01:24:22
87e80c4b5fec421ecd566498b7dd4672f76fdca2...4fb66a62eeb7bfec115cd0058d7a05ab62fc23e7,2,4,2,6,2,2006-01-25 07:17:06,2006-01-23 01:27:52
4fb66a62eeb7bfec115cd0058d7a05ab62fc23e7...e6489a1bdf6e20371e6cd6497918f1c1198d5f81,1,15,1,16,3,2006-01-25 07:17:06,2006-01-23 01:28:49
36b5b3c65948694d9a92de5a17f2b97c3cd84879...5179c8a54f76dcbdbfc96eed3a4e64a30d8d562d,1,15,4,19,6,2006-01-30 07:25:38,2006-01-30 06:12:41
5179c8a54f76dcbdbfc96eed3a4e64a30d8d562d...d41df15e6913e8f7e1b5d656bb51dc4268232c36,1,33,20,53,15,2006-01-30 07:25:41,2006-01-30 06:12:12
d41df15e6913e8f7e1b5d656bb51dc4268232c36...1506fc34f7585880aeeb12b5fdfe2de4800f9df5,1,21,0,21,2,2006-01-30 07:25:42,2006-01-30 06:34:15
087b6742fcab74f7a53626b98969bed27d288e2b...c3e24a7d461abaacc16c014ee427b37ab0102ca7,1,1,1,2,1,2005-11-18 19:16:09,2005-11-18 19:15:40
c3e24a7d461abaacc16c014ee427b37ab0102ca7...3afd169480f1970baeb54be639a496c71ff1e0a9,1,1,1,2,1,2005-11-18 19:20:34,2005-11-18 16:30:29
3afd169480f1970baeb54be639a496c71ff1e0a9...583122cd1b37d12d6f9fb487302ae07f1b446f03,1,9,5,14,5,2005-11-18 19:21:22,2005-11-18 16:31:55
583122cd1b37d12d6f9fb487302ae07f1b446f03...a8aca418d6484400d6804e22717bd49ca06c28e9,1,49,5,54,4,2005-11-18 19:21:44,2005-11-18 16:56:40
a8aca418d6484400d6804e22717bd49ca06c28e9...2e67a5f449f4026097494569f871d79bf263ab28,1,4,0,4,1,2005-11-18 19:22:27,2005-11-17 19:29:47
2e67a5f449f4026097494569f871d79bf263ab28...0cb022e0525abb831d01bf581906e67257933d38,1,1,0,1,1,2005-11-18 22:25:06,2005-11-18 21:53:24
0cb022e0525abb831d01bf581906e67257933d38...4d16f8de16e4caa278c850f812eef2cde9980b35,1,3,1,4,1,2005-11-18 22:25:10,2005-11-18 22:04:58
4d16f8de16e4caa278c850f812eef2cde9980b35...62af0b532b5ab94d231205db2db444a638a4ce49,1,16,3,19,1,2005-11-18 22:26:31,2005-11-18 20:36:12
62af0b532b5ab94d231205db2db444a638a4ce49...06a45c8cc9fdd271903eb51d712ca9820a0cd799,1,24,13,37,10,2005-11-18 23:34:17,2005-11-18 22:00:55
06a45c8cc9fdd271903eb51d712ca9820a0cd799...9a888b758f48d88d1e83c9765e33d4452710d5a5,1,8,0,8,1,2005-11-18 23:34:19,2005-11-18 22:20:15
9a888b758f48d88d1e83c9765e33d4452710d5a5...f9039f30d56e3815eaab870d8b19c7b94aded8aa,1,4,1,5,2,2005-11-18 23:40:22,2005-11-18 23:40:22
189a1222493f73977291f57d0f2030e982aff282...e6f875e052bb327d43d86b4e8335ebd4746d3e2a,2,30,10,40,9,2015-02-09 22:14:53,2015-02-09 01:13:22
e6f875e052bb327d43d86b4e8335ebd4746d3e2a...b0a4264277b7968741580093e7ea1e366943d297,2,18,3,21,2,2015-02-09 22:14:56,2015-02-09 01:15:39
8f6a3e5d71fa1800c3f330bab2b6b6399ec7aea7...10d0167fef35c7a4e4e3ef9dd448594b62089c5a,3,34,29,63,26,2013-07-30 15:06:27,2013-07-30 08:31:25
10d0167fef35c7a4e4e3ef9dd448594b62089c5a...7da2f28c6b6f2370254d285c836c6c43a4b8e559,1,5,6,11,3,2013-07-30 15:10:35,2013-07-30 08:31:26
7da2f28c6b6f2370254d285c836c6c43a4b8e559...82aae5c1e550ef2244221c9badd69771115053a5,2,0,19,19,2,2013-07-30 15:13:38,2013-07-30 08:31:27
8f6a3e5d71fa1800c3f330bab2b6b6399ec7aea7...8e943c248ac50e7b4743019ff1ed69ac72a48fff,1,1,0,1,1,2013-07-30 14:50:23,2013-07-30 08:16:09
96ffd4ca937616c4a419cb9e2ef80b3156acaf80...9608a190c0344a55b1d106c1cca17b17fe276c86,1,12,7,19,2,2013-07-07 22:32:23,2013-07-07 21:13:41
9608a190c0344a55b1d106c1cca17b17fe276c86...b23e0b9353e38149e791bde0feb1220aa1c8bac1,1,58,1,59,5,2013-07-09 15:14:05,2013-07-07 21:14:22
b23e0b9353e38149e791bde0feb1220aa1c8bac1...45bc950b4330ab675724b5079aa1528acde9f404,1,15,15,30,5,2013-07-09 15:15:28,2013-07-07 21:42:23
45bc950b4330ab675724b5079aa1528acde9f404...118aa4acff6afae733c206df7049ea54f7e0b282,2,28,8,36,4,2013-07-18 22:16:23,2013-07-18 21:11:35
118aa4acff6afae733c206df7049ea54f7e0b282...adfc1857bdb090786fd9d22c1acec39371c76048,3,30,2,32,5,2013-07-18 22:16:23,2013-07-18 21:46:51
079424a2cffa9c5a96c958ec50bb5a865a9305cf...c1182d9297c2486d36bf7a49a31bb3d7c2f98a9b,1,23,0,23,3,2013-06-30 22:45:26,2013-06-30 22:45:26
98eeb09e8acb6cbe0b0da3b1772b6676fe6d167f...5d478f5ca1792e7576ac13aaf75f09099ce99afb,1,6,3,9,2,2013-06-20 22:50:17,2013-06-20 08:37:54
6667a6ac20747eb56eb2c03c39aceaf6aebbae3c...a7f0a0efa5aa2459e284a2aa5a217324bf9d3875,1,5,1,6,3,2013-09-12 22:27:01,2013-09-12 14:15:40
9c0810732c50106d1a93866ca3fa1285e07778f1...73ffac3b38e1a62b922a0eb462f41fced6a18ebf,1,8,0,8,1,2013-09-06 16:44:28,2013-09-03 07:35:29
091a6eb0feed820a43663ca63dc2bc0bb247bbae...dfe338ae139432fd40a0f211b267f98ef85c29ed,1,1,1,2,1,2013-08-09 21:00:54,2013-08-09 20:12:54
62a23c9f5823171319bd01a924338dfc8e2c0679...e66681eb94bf1476e5c7436d777129a56512947f,1,2,1,3,1,2013-07-08 15:22:12,2013-07-08 09:21:22
3bed291a3b121408b4de83f4fa3cc0f1d98c676e...4b03df210f77ac84ebed324c5d031f32872aaf0b,1,6,2,8,2,2013-06-24 05:04:43,2013-06-16 08:45:12
4b03df210f77ac84ebed324c5d031f32872aaf0b...26cd160cb15635afd1c2937a3c15cfb256758323,2,20,1,21,4,2013-06-24 05:16:42,2013-06-16 08:45:13
914dc0289d1df75cfa744cea8ec84cb529cbc791...658ff473cf35217253aa956508ff0e42993711ad,1,20,21,41,3,2013-07-26 06:05:17,2013-07-26 06:05:17
914dc0289d1df75cfa744cea8ec84cb529cbc791...7e30944622573ebdf87beed057b098af7360234c,5,37,1,38,8,2013-06-12 23:59:55,2013-06-12 08:06:44
f6070c395698fed98c2c75fd574b298752252be2...8d8387116ae8c3e73f6184471f0c46edbd2c7601,1,22,0,22,3,2013-09-17 18:43:58,2013-09-17 18:43:58
3991e91063bb701d8ba12199b993a8f121f27f04...6d52bc318bf4953e0ad332b7a200b02cb9fa58bf,1,4,0,4,1,2013-10-28 20:24:56,2013-09-21 02:23:06
3991e91063bb701d8ba12199b993a8f121f27f04...ddeaf7ef0d23519cb810542978da54dd89d6fb73,1,15,21,36,5,2013-10-17 22:05:53,2013-10-16 12:27:16
8de8e40caa8346a536defc9cca63d55137f592f2...6dab2781a1dea0c5dd52ac3bddaed08ec08e8969,4,0,553,553,4,2013-09-26 22:49:36,2013-09-26 20:33:02
6dab2781a1dea0c5dd52ac3bddaed08ec08e8969...9cd755b2fca823eb1b688bd498b0bee007289e6c,1,3,0,3,1,2013-09-28 00:05:02,2013-09-26 13:23:35
9cd755b2fca823eb1b688bd498b0bee007289e6c...568950388be2e47af8bcb0b4a5f02017570b2f33,1,1,1,2,1,2013-09-30 21:34:50,2013-09-28 15:53:05
568950388be2e47af8bcb0b4a5f02017570b2f33...0079d6ebd76f4e3fa261b367b0ec2679c47a479a,1,2,1,3,2,2013-10-03 19:21:19,2013-10-03 19:17:32
a3bc3d070cacf07dbe11b4bfec57554c8bbf1957...487a2b732230608fe7f2cdc46c9f11bd646cb1ac,2,8,5,13,4,2013-09-03 18:14:58,2013-08-31 01:04:14
a3bc3d070cacf07dbe11b4bfec57554c8bbf1957...fd87004e51df835e5833bfe1bff3ad0137d42227,1,1,0,1,1,2013-08-30 21:55:04,2013-08-30 08:37:01
a3bc3d070cacf07dbe11b4bfec57554c8bbf1957...83bd7437ca6acbee0db431fc8ec7cf823d9459ec,3,63,4,67,4,2013-08-29 03:54:43,2013-08-27 20:41:12
a3bc3d070cacf07dbe11b4bfec57554c8bbf1957...f972a1658a30809db113a3c486b1fe95b56633bf,2,24,13,37,7,2013-08-28 19:33:32,2013-08-28 01:41:39
a3bc3d070cacf07dbe11b4bfec57554c8bbf1957...6da8bdcbbfd5ac9c4a92de79d7b4343d5d6bd4c5,2,19,1,20,3,2013-08-26 05:56:03,2013-08-26 02:17:26
a3bc3d070cacf07dbe11b4bfec57554c8bbf1957...54c93cb4afc932ab125a59464bb52e04f9c36575,1,12,3,15,3,2013-08-22 23:39:46,2013-08-22 23:12:42
54c93cb4afc932ab125a59464bb52e04f9c36575...171bdaca698a69c5a43067e4d6d81abfc50f17d6,3,198,0,198,4,2013-08-25 05:31:20,2013-08-24 00:02:25
171bdaca698a69c5a43067e4d6d81abfc50f17d6...3b910d0c5ee3a06ba0463f97ccf59815e7b37e29,2,81,0,81,2,2013-08-25 05:31:47,2013-08-24 00:02:31
3b910d0c5ee3a06ba0463f97ccf59815e7b37e29...b2ef3d9ebb95ce369330d1f09db361aa39c67013,1,18,0,18,1,2013-08-25 05:32:34,2013-08-24 00:02:35
b2ef3d9ebb95ce369330d1f09db361aa39c67013...16c159d75af29b1929af0e2f341d26fce4e1d546,1,7,0,7,1,2013-09-04 17:52:01,2013-09-04 09:01:53
a3bc3d070cacf07dbe11b4bfec57554c8bbf1957...b214eddfb2d57e318a3f5b88da1cafcf19184b4d,2,15,2,17,3,2013-08-22 20:55:28,2013-08-22 20:31:21
b214eddfb2d57e318a3f5b88da1cafcf19184b4d...286bc123cdabed76a1da25a32e97d392b37d51a2,1,9,5,14,1,2013-08-28 22:17:18,2013-08-28 22:17:18
a3bc3d070cacf07dbe11b4bfec57554c8bbf1957...7bca7afeff6f17309545cd2c8431b7228d1151ab,1,1,1,2,1,2013-08-18 20:33:01,2013-08-16 21:44:07
a3bc3d070cacf07dbe11b4bfec57554c8bbf1957...67ed84f3e25db8e81dd905dbe275bbcd37afb543,1,4,1,5,2,2013-08-09 21:19:59,2013-08-09 18:09:32
bb80ee09974667a1db6bbc5e33574ed869b76a88...f8bc2ac3bf2df76ae864041a5496fab6446ad189,1,4,16,20,1,2013-09-13 19:37:35,2013-09-12 19:25:00
f8bc2ac3bf2df76ae864041a5496fab6446ad189...2c63d6eb46da4ef0abc9c040c927818e437d2fcc,2,10,4,14,6,2013-09-13 19:37:35,2013-09-12 19:25:01
bb80ee09974667a1db6bbc5e33574ed869b76a88...bad866a29b0ec560c9bed31e2fe3610b6cf50ae3,1,1,0,1,1,2013-09-11 18:08:52,2013-09-10 23:21:53
bad866a29b0ec560c9bed31e2fe3610b6cf50ae3...61542f7735a71ec0e28744a79828a8cc93aea9c6,1,6,0,6,5,2013-09-11 18:08:52,2013-09-10 23:22:34
61542f7735a71ec0e28744a79828a8cc93aea9c6...a2374f58e86777258c11ed2d7855a28cd4219648,2,11,19,30,5,2013-09-11 18:08:52,2013-09-10 23:23:13
a2374f58e86777258c11ed2d7855a28cd4219648...fa93bb20d72edf9f7635c63d46101edb206d3d6f,3,10,2,12,5,2013-09-11 18:11:06,2013-09-11 16:02:09
fa93bb20d72edf9f7635c63d46101edb206d3d6f...8453c1259a3b6fe89d67b6e783cc535b60f298c1,3,4,2,6,4,2013-09-11 21:50:19,2013-09-11 16:06:31
674c502f52983589c5d6cce051d951be56439af9...a09ab03a5b408aef3e6d21b3ec38d47b148ce067,1,774,554,1328,477,2013-05-07 17:28:19,2013-04-30 05:38:05
a09ab03a5b408aef3e6d21b3ec38d47b148ce067...4dcdc3d8ccfb7e6ae3a2d151b5df59785548a040,1,728,530,1258,460,2013-05-08 00:13:32,2013-04-13 02:02:43
e74435a5169b56be901196ad172b4dbda124254d...1190a1acf800acdcfd7569f87ac1560e2d077414,3,4,10,14,8,2013-12-05 23:40:11,2013-12-05 20:28:07
1190a1acf800acdcfd7569f87ac1560e2d077414...40a4f5a7bf0ffee4fa1fb954b1ebf5daba5bae75,1,1,2,3,1,2013-12-16 19:36:09,2013-12-16 19:19:33
e74435a5169b56be901196ad172b4dbda124254d...92e5c77c3791567e299cc858a7ddfed410e2cec5,2,33,13,46,11,2013-10-24 22:44:45,2013-10-24 18:00:36
92e5c77c3791567e299cc858a7ddfed410e2cec5...2834bc27c16e4ae103768dd6dda530f0e46116af,4,200,135,335,40,2013-10-24 22:44:48,2013-10-24 18:01:06
2834bc27c16e4ae103768dd6dda530f0e46116af...68fb36eb92ff98ec81a066592a07b3f411450a1d,2,22,22,44,4,2013-10-24 22:44:52,2013-10-24 18:01:29
68fb36eb92ff98ec81a066592a07b3f411450a1d...a330de31d18ca08c773c64e3657b3bafd59cf751,2,6,0,6,2,2013-10-24 22:44:52,2013-10-24 18:01:41
a330de31d18ca08c773c64e3657b3bafd59cf751...ec73f5807cd6e6f6d55e716cde80637a1019d67d,2,2,3,5,3,2013-10-24 22:44:52,2013-10-24 18:01:47
ec73f5807cd6e6f6d55e716cde80637a1019d67d...7e3dae494370b5596a6ea76af1191829ce11bce2,1,75,1,76,6,2013-11-18 18:57:42,2013-11-14 12:43:36
7e3dae494370b5596a6ea76af1191829ce11bce2...e1273106f62927e3efdb1cfa107cb1a9f913274c,7,1599,2,1601,9,2013-12-30 20:17:20,2013-11-14 12:43:51
e1273106f62927e3efdb1cfa107cb1a9f913274c...0d4455a3ab070e0477ab80ae641ef19146b7a736,1,131,0,131,1,2013-12-30 20:19:22,2013-11-14 12:44:02
0d4455a3ab070e0477ab80ae641ef19146b7a736...fff42755efc7585378ca562e54828532922371be,4,1353,0,1353,5,2013-12-30 20:19:22,2013-12-21 14:00:01
fff42755efc7585378ca562e54828532922371be...ce2bc42456b88c5f01f7f591cf0cc9db1a5bfc3d,1,78,20,98,13,2013-12-30 20:19:22,2013-12-21 14:00:06
ce2bc42456b88c5f01f7f591cf0cc9db1a5bfc3d...6b8fda2db1d69606954711b606c546c0e4e51680,2,113,0,113,11,2013-12-30 20:19:22,2013-12-21 14:00:09
6b8fda2db1d69606954711b606c546c0e4e51680...aa32939fea9c8934b41efce56015732fa12b8247,3,48,0,48,7,2013-12-30 20:19:22,2013-12-21 14:00:12
aa32939fea9c8934b41efce56015732fa12b8247...7cc8f9710857ed69d34c696330f7fd0367a5a29c,8,711,0,711,19,2013-12-30 20:19:22,2013-12-21 14:00:16
7cc8f9710857ed69d34c696330f7fd0367a5a29c...b328c2166e67a0391a776d075acdfbd74e122e5c,1,4,4,8,4,2013-12-30 20:19:23,2013-12-21 14:00:19
b328c2166e67a0391a776d075acdfbd74e122e5c...42a02d8529953b2a964586fcb4aafe8dd7adffbc,1,11,6,17,6,2013-12-30 20:19:23,2013-12-21 14:00:23
42a02d8529953b2a964586fcb4aafe8dd7adffbc...b77fcd1edca58621627d46af0321a9737b1310f0,1,7,2,9,4,2013-12-30 20:19:23,2013-12-21 14:00:27
b77fcd1edca58621627d46af0321a9737b1310f0...5cf2741c5a55cfb63076ce679e4b5842595125c2,2,16,2,18,7,2013-12-30 20:19:23,2013-12-21 14:00:31
5cf2741c5a55cfb63076ce679e4b5842595125c2...d3d3e4c490c83daeba61ac1f2be5da2396f7411c,1,1,0,1,1,2013-12-30 20:19:23,2013-12-21 14:00:34
d3d3e4c490c83daeba61ac1f2be5da2396f7411c...212f2ffbf0331ceca1a4bc1820ab1ac5c5115e8b,1,138,0,138,1,2013-12-30 20:19:23,2013-12-21 14:00:38
212f2ffbf0331ceca1a4bc1820ab1ac5c5115e8b...bbcefa1f3f8355921137dd7a097b3ee3db66f023,1,56,0,56,1,2013-12-30 20:19:23,2013-12-21 14:00:42
bbcefa1f3f8355921137dd7a097b3ee3db66f023...ae4f07fbccaab6dc93be52c0f34e137dd9fcbcf4,8,91,7,98,17,2013-12-30 20:19:23,2013-12-21 14:00:45
ae4f07fbccaab6dc93be52c0f34e137dd9fcbcf4...1a6d8b91489ad4a7b7d267b46a3e838b004157f1,3,0,13,13,3,2014-01-16 22:33:46,2014-01-15 11:17:48
1a6d8b91489ad4a7b7d267b46a3e838b004157f1...802b123366b5b3b6e18ee9e25a240815d1c97aae,2,32,32,64,2,2014-01-23 22:03:21,2014-01-23 21:23:09
802b123366b5b3b6e18ee9e25a240815d1c97aae...c3d8da571f11b0146e60591c040da399d411c3f2,2,16,32,48,6,2014-01-23 22:03:48,2014-01-23 21:26:42
c3d8da571f11b0146e60591c040da399d411c3f2...a201c20b41a2f0725977bcb89a2a66135d776ba2,1,24,9,33,4,2014-01-23 22:05:05,2014-01-23 21:27:52
a201c20b41a2f0725977bcb89a2a66135d776ba2...6b5b3a27b7faf9d72efec28fa017408daf45cd00,1,3,7,10,2,2014-02-12 19:21:29,2014-02-12 16:48:28
8301b976ed461b5ab3b79a1ce0da1c13728e8149...9a3e36cd67fce2bfcc0726193feee493ccdbf0f6,1,2,2,4,1,2013-05-02 19:03:40,2013-05-02 18:24:15
9a3e36cd67fce2bfcc0726193feee493ccdbf0f6...6606a69f451ebbed5692185938be55aea6e8f49f,1,1,1,2,1,2013-05-03 22:10:05,2013-05-03 21:35:50
8301b976ed461b5ab3b79a1ce0da1c13728e8149...3212d56ce528a86170f7809659f80a8769a5875f,1,2,1,3,1,2013-05-01 17:13:32,2013-05-01 08:25:52
571cdfd4e0a4cc24e215a5d5f0cb24292a9d7929...b120ef3eac677762427631d5ae7372402a80b837,1,1,2,3,2,2013-05-09 18:33:01,2013-05-09 01:16:56
b120ef3eac677762427631d5ae7372402a80b837...e2161bc38514722050b3a9c50a7897c40b6a93cf,1,1,1,2,1,2013-05-09 18:59:39,2013-05-09 09:13:28
e2161bc38514722050b3a9c50a7897c40b6a93cf...abdb9b2e4fd7876ab7138119c4aedca70bc0d250,1,1,1,2,1,2013-05-09 19:18:57,2013-05-09 13:10:48
571cdfd4e0a4cc24e215a5d5f0cb24292a9d7929...b056620f6fe7f05834716109fa79e7880a11bc36,2,15,0,15,2,2013-05-05 18:10:53,2013-05-03 23:41:59
e19189060fcfb62410ce8e008720dbb6e7fa0d7b...3176c59290de8921cd6649dfb59f4d1f1f2c31bf,1,0,1,1,1,2013-11-11 18:13:34,2013-11-09 02:22:39
3176c59290de8921cd6649dfb59f4d1f1f2c31bf...c311741331058f4a3005569fb3f937b92e4521fb,1,3,1,4,1,2013-11-11 22:14:06,2013-11-11 20:45:29
c311741331058f4a3005569fb3f937b92e4521fb...33f918c6752d543e00cbb0c554a13532b5d97366,1,4,2,6,2,2013-11-11 22:14:06,2013-11-11 20:45:50
33f918c6752d543e00cbb0c554a13532b5d97366...c635b050e7a8873f02d739b7a739a03ba4dd8606,1,4,2,6,3,2013-11-11 22:14:07,2013-11-11 20:46:12
e19189060fcfb62410ce8e008720dbb6e7fa0d7b...8bade1e12e2041a21f50009d8baaa11bcb800e8f,2,2,1,3,2,2013-07-08 15:55:34,2013-07-04 20:38:55
8bade1e12e2041a21f50009d8baaa11bcb800e8f...8a7c21514073f25e8262e311c0fa93101da0e6d3,2,20,0,20,2,2013-07-08 15:55:53,2013-07-04 20:38:56
8a7c21514073f25e8262e311c0fa93101da0e6d3...c7956f90844280d477fefb978ebe0682fab006fb,1,2,6,8,1,2013-07-08 15:55:56,2013-07-04 20:38:57
c7956f90844280d477fefb978ebe0682fab006fb...192f7a080469ea3e7a702f04e08ba7e709c0b3c3,2,89,73,162,18,2013-07-08 15:56:00,2013-07-04 20:38:58
192f7a080469ea3e7a702f04e08ba7e709c0b3c3...07a263b9056ac7135ed84d64cabf80c5a6b1972e,2,64,3,67,5,2013-07-08 15:56:08,2013-07-04 20:38:59
07a263b9056ac7135ed84d64cabf80c5a6b1972e...0078a7fa05b3d671739aefba5265da809ea32e55,2,311,2,313,7,2013-07-08 15:56:14,2013-07-04 20:39:00
4d06473928ee574910accbde05c19ef2263abdf6...a1bbc6c0176f1fa2d4aa571cc0183a1f0ff9b285,5,390,1,391,5,2013-09-17 20:34:50,2013-09-15 15:33:20
a1bbc6c0176f1fa2d4aa571cc0183a1f0ff9b285...ffc9329f48cb05ab44592e75e2dac4cfb7951c00,1,2,2,4,2,2013-09-17 20:34:56,2013-09-15 15:33:21
ffc9329f48cb05ab44592e75e2dac4cfb7951c00...0b63c6a5b78f3fdd8c4e4fed4e535e7f4eed4257,1,3,2,5,2,2013-09-17 20:34:57,2013-09-15 15:33:22
4d06473928ee574910accbde05c19ef2263abdf6...7192777d226c5b8653c65112a309c2ebd3d6d5c5,1,22,6,28,5,2013-09-09 18:04:28,2013-09-08 08:29:27
7192777d226c5b8653c65112a309c2ebd3d6d5c5...42d194e95870a9eeea192789226b7d51b1c90c96,1,6,6,12,5,2013-09-09 18:04:29,2013-09-08 08:33:08
42d194e95870a9eeea192789226b7d51b1c90c96...33fdd77e2b8ece3490982f9a35c8669d16879ba8,1,14,4,18,9,2013-09-09 18:06:38,2013-09-08 08:36:42
33fdd77e2b8ece3490982f9a35c8669d16879ba8...2f666581bbc1895cf66a7007fb222026b299deb9,3,16,9,25,8,2013-09-09 18:07:07,2013-09-08 08:38:22
2f666581bbc1895cf66a7007fb222026b299deb9...00160242770aea137ec7154a8e8406feef733926,4,29,3,32,6,2013-09-09 18:12:29,2013-09-08 08:40:02
4d06473928ee574910accbde05c19ef2263abdf6...2be945094ef753a47fa85d54dd472351f77c398c,1,4,4,8,3,2013-09-03 19:46:23,2013-08-17 17:25:42
2be945094ef753a47fa85d54dd472351f77c398c...927b26f87a5654349b87d3217ed8e9360d9ff798,3,27,2,29,4,2013-09-04 20:53:11,2013-09-01 20:06:49
927b26f87a5654349b87d3217ed8e9360d9ff798...bb58b696c6ad810560d361b640580715a90382cb,4,24,5,29,5,2013-09-11 19:20:41,2013-09-11 19:07:15
4d06473928ee574910accbde05c19ef2263abdf6...5d5812f492dbc1adac718a69d225396620b463fd,1,1,1,2,1,2013-08-21 23:38:47,2013-08-21 20:49:31
5d5812f492dbc1adac718a69d225396620b463fd...0ef09702d6b7fbd225d1e7adeca7b32304be529f,1,1,1,2,1,2013-08-21 23:38:50,2013-08-21 20:49:32
0ef09702d6b7fbd225d1e7adeca7b32304be529f...a44aa6930c9f3ce914f135c00a62878f9027f583,1,5,1,6,2,2013-08-22 16:50:16,2013-08-22 01:39:03
4d06473928ee574910accbde05c19ef2263abdf6...a9f739c111898ed879bc077fb3a2f71b9766bba7,2,25,1,26,5,2013-08-21 22:44:15,2013-08-21 18:48:57
4d06473928ee574910accbde05c19ef2263abdf6...0d8beaa5b76e824c9869f0d1f1b19ec7acf4982f,1,2,2,4,2,2013-08-21 22:30:04,2013-08-21 22:30:04
4d06473928ee574910accbde05c19ef2263abdf6...4c6fffe2ae3642fa4576c704e2eb443de1d0f8a1,1,503,0,503,1,2013-08-21 18:37:53,2013-08-21 13:45:13
4d06473928ee574910accbde05c19ef2263abdf6...7800c1ebcc12a7b667a2c76de109a85d272051a0,2,20,20,40,6,2013-08-20 19:29:42,2013-08-18 19:41:51
4d06473928ee574910accbde05c19ef2263abdf6...0b6806b9e45c659d25b87fb5713c920a3081eac8,2,26,0,26,4,2013-08-20 18:10:59,2013-08-20 06:43:54
4d06473928ee574910accbde05c19ef2263abdf6...c9ba31f592ccf23dc2aa78a705a790341ea72cfd,1,1,2,3,1,2013-08-20 17:10:37,2013-08-20 14:18:00
8fb5d44a47dd3657c8be0de5dcf220935b04e98e...2b77029f4ad556b82cdbadf59ae13d41e23b6e7c,1,1,1,2,1,2010-01-12 04:31:48,2010-01-11 15:56:45
2b77029f4ad556b82cdbadf59ae13d41e23b6e7c...fbb9971aca1fef66e622d64418121f6077f05c57,1,0,2,2,1,2010-01-12 08:47:02,2010-01-12 08:22:23
fbb9971aca1fef66e622d64418121f6077f05c57...8efa5f629efb9a8af48619ee90dee02343e0f19d,2,2,2,4,2,2010-01-12 21:09:44,2010-01-12 17:54:04
5d4138a66d265e7ddbe21d44f79bcaa1e9a6b6ff...c238dad407aec1ccf6e364f9c95e10e7f84eac8f,1,24,2,26,3,2007-11-09 08:32:38,2007-11-09 08:32:38
f192c5d0fb37a1a89d88e92bb7b21418b57c2129...71aa2b8f0ee7cb2e60871f327996af21af88a668,1,3,1,4,1,2007-11-13 21:45:11,2007-11-13 21:45:11
71aa2b8f0ee7cb2e60871f327996af21af88a668...f141bd804d2cba4500769934f9d9e7f0f7bcf282,2,6,5,11,4,2007-11-14 10:00:13,2007-11-13 08:22:44
f141bd804d2cba4500769934f9d9e7f0f7bcf282...2f29dac5a902a6be58ffddc598c4e17f79a0d841,1,3,3,6,2,2007-11-14 10:04:46,2007-11-13 18:19:39
2f29dac5a902a6be58ffddc598c4e17f79a0d841...481424e1f100de690849a9f0348fc78f45ab815e,1,2,0,2,1,2007-11-14 10:05:19,2007-11-13 23:16:36
f192c5d0fb37a1a89d88e92bb7b21418b57c2129...6fa92bf3cdbfdd8c9c56ef40a5170a859442b166,1,40,0,40,1,2007-11-13 01:50:31,2007-11-12 21:38:23
6fa92bf3cdbfdd8c9c56ef40a5170a859442b166...ed31df312a30d91c288a4b6e3d031de15284405a,1,2,1,3,1,2007-11-13 01:50:31,2007-11-12 21:39:38
0d9d89f61c58f72d96585a61defb0634873c38ac...28b9d6e548322755bbdb24c28a493862f61b1eba,5,54,19,73,22,2007-11-10 05:14:10,2007-11-09 23:32:10
28b9d6e548322755bbdb24c28a493862f61b1eba...94c89ba662e964c544fdb171dc8dd33f95b97942,3,20,2,22,10,2007-11-10 05:14:10,2007-11-09 23:32:25
94c89ba662e964c544fdb171dc8dd33f95b97942...8e806adb65dc4a0df91a0ebd54b76bb24ff1263e,1,228,0,228,1,2007-11-13 02:22:09,2007-11-09 23:32:41
8e806adb65dc4a0df91a0ebd54b76bb24ff1263e...ff206748158aa54196bde1462ceaf550a5c2440e,1,8,0,8,1,2007-11-13 02:22:14,2007-11-09 23:32:57
7be2b6e02b4f2a1b4812764f65b12cafb11a934e...5cefc33bffd3580d07ca548bc8e2ff38c945c78c,2,66,8,74,7,2007-12-10 09:36:13,2007-12-10 09:15:57
5cefc33bffd3580d07ca548bc8e2ff38c945c78c...78d39f98f3135bc9f7cbef897aeb4a279ca4130e,1,1,1,2,1,2007-12-10 09:36:31,2007-12-10 09:19:31
78d39f98f3135bc9f7cbef897aeb4a279ca4130e...a149a1a44af45352b63e2dadd790616966c220be,2,6,1,7,4,2007-12-10 09:36:31,2007-12-10 09:35:29
a149a1a44af45352b63e2dadd790616966c220be...bf79caffbc5a3587af2360dde67d8d5c3a3a4196,1,1,0,1,1,2007-12-10 19:22:51,2007-12-10 10:29:18
bf79caffbc5a3587af2360dde67d8d5c3a3a4196...50b3555c48db08a4b4e8fe047a4fb550bdca75c5,1,3,3,6,2,2007-12-12 21:31:02,2007-12-12 21:31:02
50b3555c48db08a4b4e8fe047a4fb550bdca75c5...c49d3c8a88916554c5db838c0346b6cf05d60104,1,0,3,3,2,2007-12-12 21:42:12,2007-12-12 21:42:12
c49d3c8a88916554c5db838c0346b6cf05d60104...22c9071728cdc4c5b39e4fc6a33036d967d3a3a5,2,34,24,58,9,2007-12-13 01:41:58,2007-12-13 01:34:30
22c9071728cdc4c5b39e4fc6a33036d967d3a3a5...39bf13f2d6aaec6ff34bf367f2497fc9247c721f,1,8,4,12,4,2007-12-13 01:41:58,2007-12-12 22:00:24
09149c7809a37a52b38d8d7a0621e2fb8943d8fe...fee9832a8dea5d9c98c5c3a4797615d52814df16,6,1,5,6,4,2007-10-31 04:36:29,2007-10-30 14:24:27
09149c7809a37a52b38d8d7a0621e2fb8943d8fe...0cec6db5cfbb109eebb3a50b6213cab2dc68f0c8,1,67,85,152,27,2007-10-30 04:21:51,2007-10-30 00:35:05
09149c7809a37a52b38d8d7a0621e2fb8943d8fe...6b9ff1e3bd089d1bef211ba74c12e056810755b8,1,1,1,2,1,2007-10-30 04:14:11,2007-10-27 07:47:21
09149c7809a37a52b38d8d7a0621e2fb8943d8fe...4a59fd131229968b08af9bdf221c341f54c52983,3,204,2,206,4,2007-10-30 04:03:30,2007-10-14 23:35:37
4a59fd131229968b08af9bdf221c341f54c52983...d7a38c54a6ccbcbcf29d8cf1110b2702c8b3f7f8,2,79,9,88,10,2007-10-30 04:03:30,2007-10-14 23:38:30
d7a38c54a6ccbcbcf29d8cf1110b2702c8b3f7f8...beb474379315654566e78eea8a0e39c66ebcbb8a,4,107,1,108,4,2007-10-30 04:03:30,2007-10-13 16:34:45
beb474379315654566e78eea8a0e39c66ebcbb8a...f389c808b6774fb0a1fc54cf2563a7b3038dd1d4,1,22,25,47,16,2007-10-30 04:03:30,2007-10-13 22:10:51
f389c808b6774fb0a1fc54cf2563a7b3038dd1d4...ffe659f94d793375fca97dd296422fc10c155016,2,53,8,61,10,2007-10-30 04:03:30,2007-10-14 23:45:45
ffe659f94d793375fca97dd296422fc10c155016...0ce865b134f8ccd60f6e584744144b0978a9fdf2,2,32,0,32,2,2007-10-30 04:03:30,2007-10-14 09:05:12
0ce865b134f8ccd60f6e584744144b0978a9fdf2...7f275b91520d31bfbe43ec5a9bbaf8ac6e663ce0,2,60,0,60,5,2007-10-30 04:03:30,2007-10-14 16:54:06
7f275b91520d31bfbe43ec5a9bbaf8ac6e663ce0...f481e22a145ed17e85b68bf8ce2de4b80dfa4323,2,10,1,11,4,2007-10-30 04:03:31,2007-10-15 22:32:38
f481e22a145ed17e85b68bf8ce2de4b80dfa4323...5c46f75437e6764532f46cbaf1e0bedb52f5acb9,1,27,46,73,11,2007-10-30 04:03:31,2007-10-03 21:45:02
5c46f75437e6764532f46cbaf1e0bedb52f5acb9...f09985c265f8ea2195a6d6c3e151813e6890dd7d,1,23,31,54,6,2007-10-30 04:03:31,2007-10-05 19:09:19
f09985c265f8ea2195a6d6c3e151813e6890dd7d...c7a20c117fedd40652d446e58b3eba7e2420fa47,1,35,49,84,21,2007-10-30 04:03:31,2007-10-07 12:19:33
c7a20c117fedd40652d446e58b3eba7e2420fa47...a8dfd5eac40143030d47da6fd87906990d7bf28c,1,52,95,147,8,2007-10-30 04:03:31,2007-10-07 16:26:21
a8dfd5eac40143030d47da6fd87906990d7bf28c...166185be7c730a25308b251508aa8f1a39ea476b,1,29,41,70,10,2007-10-30 04:03:31,2007-10-07 18:54:08
166185be7c730a25308b251508aa8f1a39ea476b...f81037947c518703cefee2ada5a5d7f724191bc6,1,30,37,67,14,2007-10-30 04:03:31,2007-10-07 21:02:29
f81037947c518703cefee2ada5a5d7f724191bc6...89942be6a13f69a34e5e824977b45204c36cf9e8,1,25,40,65,9,2007-10-30 04:03:31,2007-10-07 21:14:43
89942be6a13f69a34e5e824977b45204c36cf9e8...785586142a5ed083b97b7be472c08982ae88fd8f,1,18,34,52,7,2007-10-30 04:03:31,2007-10-07 21:18:23
785586142a5ed083b97b7be472c08982ae88fd8f...c3428da87f625d22b7f0ea1e1fb7028264943da3,2,61,77,138,12,2007-10-30 04:03:31,2007-10-13 18:40:46
c3428da87f625d22b7f0ea1e1fb7028264943da3...e0e6c0961140c0329a9cfccc1d227f3f4bcd4777,5,7,7,14,7,2007-10-30 04:03:31,2007-10-14 14:10:42
e0e6c0961140c0329a9cfccc1d227f3f4bcd4777...5ac0a2063e8f824f6e8ffb4d18de74c55aae7131,1,26,54,80,7,2007-10-30 04:03:31,2007-10-15 20:34:05
5ac0a2063e8f824f6e8ffb4d18de74c55aae7131...833f3abd821434fd9b12d6cea66f04f232479c22,1,15,17,32,6,2007-10-30 04:03:31,2007-10-15 20:38:51
833f3abd821434fd9b12d6cea66f04f232479c22...edefb1a23755505cc9b4e750c292cd236b1e8655,1,25,39,64,10,2007-10-30 04:03:31,2007-10-15 20:57:59
edefb1a23755505cc9b4e750c292cd236b1e8655...b2565ae57376116b9d78369b6eac07e55c6f7851,1,20,27,47,3,2007-10-30 04:03:31,2007-10-15 21:06:02
b2565ae57376116b9d78369b6eac07e55c6f7851...dd46b9b95b853328e7ff1c11b7f5cae68751c79e,1,1,1,2,1,2007-10-30 23:12:18,2007-10-30 19:15:21
dd46b9b95b853328e7ff1c11b7f5cae68751c79e...44c637c8021e44253f0f8cb17391092e08b39e73,1,22,22,44,8,2007-11-02 08:31:06,2007-11-02 01:02:27
09149c7809a37a52b38d8d7a0621e2fb8943d8fe...3d7e2d857a570b1d6368285f95b67994fc95629e,3,8,6,14,5,2007-10-30 03:51:36,2007-10-27 08:36:49
3d7e2d857a570b1d6368285f95b67994fc95629e...edb6ddc53e71f4f959665cbc3180bb21b7ee7634,1,8,6,14,7,2007-10-30 03:51:37,2007-10-27 08:36:50
edb6ddc53e71f4f959665cbc3180bb21b7ee7634...384df83312d24ea4d11adcf4e73921fc192595d2,3,8,8,16,7,2007-10-30 03:51:37,2007-10-27 08:36:51
384df83312d24ea4d11adcf4e73921fc192595d2...0966003c8e8d1528912b10667b903cd981e3a7f6,1,3,15,18,5,2007-10-30 03:51:37,2007-10-27 08:36:52
0966003c8e8d1528912b10667b903cd981e3a7f6...511707d42b3b3e57d9623493092590546ffeae80,3,61,105,166,15,2007-10-30 03:51:37,2007-10-28 11:17:20
511707d42b3b3e57d9623493092590546ffeae80...1eb056905a2956ca9fabd2edcce05c0a29ce64b1,1,120,37,157,15,2007-10-30 03:51:37,2007-10-29 03:30:52
1eb056905a2956ca9fabd2edcce05c0a29ce64b1...e8f5d87056093f40a271f89c2c91d1a7025e2440,1,1,7,8,2,2007-10-30 03:51:37,2007-10-27 08:36:55
d3759c08055d97434714f0b5afb592ddb0a544db...ee8245b54a2e4ea8838d28a7bcce2e07ef887a2c,1,8,0,8,6,2007-09-29 22:40:17,2007-09-26 23:34:59
ee8245b54a2e4ea8838d28a7bcce2e07ef887a2c...b7bb760d5ed4881422673d32f869d140221d3564,1,8,2,10,2,2007-09-29 22:42:32,2007-09-29 16:50:39
b7bb760d5ed4881422673d32f869d140221d3564...552ce11006e39bd07efd79946f180df47aa35b4e,2,38,1,39,2,2007-09-29 23:07:46,2007-09-29 23:07:46
8a37e21dab1103e11630d091c13be21d958221c1...5be507fc955bd14643cac1162cfaa592d0e236ba,1,1,1,2,1,2007-10-21 06:16:57,2007-10-21 04:51:09
5be507fc955bd14643cac1162cfaa592d0e236ba...c32f749fec69f92ce3b076128e6322f8130bd881,4,13,5,18,9,2007-10-22 04:00:40,2007-10-21 09:23:49
c32f749fec69f92ce3b076128e6322f8130bd881...dd8175f83c725619d72d6bbaacf8eaafc158edea,1,6,5,11,1,2007-10-22 05:38:19,2007-10-21 09:36:19
5d1d1c14790cf74eb0d630c4404114206061232d...b7f30e0a972ab90a0f7720a7d6411822eb796ea3,2,39,2,41,3,2007-11-19 08:19:46,2007-11-19 04:14:55
b7f30e0a972ab90a0f7720a7d6411822eb796ea3...59adeef48fcc3ea3e1288ce62260fdd8f46240da,1,7,10,17,2,2007-11-20 07:24:34,2007-11-19 10:37:16
59adeef48fcc3ea3e1288ce62260fdd8f46240da...7ac17529297910c7b4502bdfa543ddec3f943413,1,5,1,6,1,2007-11-20 21:16:09,2007-11-19 11:00:26
7ac17529297910c7b4502bdfa543ddec3f943413...591ebf6595ac7d5e5a21abbfc7501df19a67dc89,2,11,15,26,13,2007-11-20 21:16:15,2007-11-19 13:16:11
591ebf6595ac7d5e5a21abbfc7501df19a67dc89...9d066745708b77ef917565d699d5d193bfb00fbd,2,7,1,8,3,2007-11-20 21:16:15,2007-11-19 13:16:12
9d066745708b77ef917565d699d5d193bfb00fbd...2439755630de90abc9378483e73d3ba54c36ee71,2,21,0,21,6,2007-11-20 21:16:15,2007-11-19 18:47:05
2439755630de90abc9378483e73d3ba54c36ee71...137a0d0ef568f0a2468c8c7f053ef113e295842f,1,3,0,3,3,2007-11-20 21:16:15,2007-11-19 19:48:58
137a0d0ef568f0a2468c8c7f053ef113e295842f...8e9739914972419baad820e76b44d9720ed885c2,1,18,4,22,1,2007-11-20 23:03:56,2007-11-20 20:08:06
d25430c5f88c7e7b4ce24c1b08e409f4345c4eb9...f2dc849e9c5fe363ad089f6c3f2b7b3d79fd6a6f,7,616,0,616,7,2007-12-03 03:22:12,2007-12-02 14:14:13
d25430c5f88c7e7b4ce24c1b08e409f4345c4eb9...804c7174c9d7c81b5215bcd9002f3bd600ecb6e4,2,28,10,38,3,2007-11-30 21:55:49,2007-11-28 08:06:36
804c7174c9d7c81b5215bcd9002f3bd600ecb6e4...0d8135891eb81d06d818a53c479ea3798df96e3a,1,1,1,2,1,2007-11-30 22:15:08,2007-11-23 13:38:50
d25430c5f88c7e7b4ce24c1b08e409f4345c4eb9...686a4a06b679a202430ca81267ad6505e92d839a,1,4,9,13,3,2007-11-29 09:11:46,2007-11-29 09:11:46
686a4a06b679a202430ca81267ad6505e92d839a...63d285c8494d03a08600bb4453fcce077ecdd517,3,72,69,141,21,2007-11-29 10:19:14,2007-11-29 10:17:44
63d285c8494d03a08600bb4453fcce077ecdd517...d6617c7cdebc20fe007e983f70b44a223dd52c28,2,24,7,31,10,2007-11-30 21:10:11,2007-11-22 22:22:23
d6617c7cdebc20fe007e983f70b44a223dd52c28...346d203bc3931c33f2e40093ee9325ab0334b9fe,1,31,0,31,1,2007-11-30 21:52:36,2007-11-23 18:04:52
346d203bc3931c33f2e40093ee9325ab0334b9fe...28391a80a94d2b59d1d21f8264fe5dab91d77249,2,46,3,49,3,2007-11-30 22:59:43,2007-11-29 01:02:53
d25430c5f88c7e7b4ce24c1b08e409f4345c4eb9...ecfe72ff658124ea301ec7b2bb8b987689303685,1,4,1,5,5,2007-11-29 01:57:28,2007-11-22 11:18:10
d25430c5f88c7e7b4ce24c1b08e409f4345c4eb9...57f2b8424ade734550731392e90b8f738d478e02,1,19,13,32,3,2007-11-29 01:33:17,2007-11-26 22:30:28
57f2b8424ade734550731392e90b8f738d478e02...9ce0352258a421b654b5db145a42d07cbaef416c,2,68,3,71,7,2007-11-29 01:33:17,2007-11-28 06:41:05
d25430c5f88c7e7b4ce24c1b08e409f4345c4eb9...cd67e4d46b122b161f2ad7d943e4ae7aa8df6cf5,4,49,1,50,7,2007-11-29 01:32:23,2007-11-28 13:11:07
d25430c5f88c7e7b4ce24c1b08e409f4345c4eb9...3addc94aff0b10730c6b023e1a4a5d677e53d5a7,3,19,13,32,11,2007-11-29 01:23:18,2007-11-28 15:56:11
bbbadf6e58f72ac6bf739d2a1109cbd872eb1083...d4e890e5de1ea7107d8d1b4134ab0144bbf27b8c,1,52,9,61,4,2007-10-23 22:49:27,2007-10-23 20:55:32
3ea16e569abce653e02632995aa32287d2f54360...be700fe30fd17b3f9b600de9110c74035091a007,1,3,0,3,1,2007-10-10 06:26:00,2007-10-06 09:29:02
be700fe30fd17b3f9b600de9110c74035091a007...a16b74e72c1dfb6cdef2c17d564d9857ab386d7d,1,3,0,3,1,2007-10-10 07:47:38,2007-10-10 06:58:58
a16b74e72c1dfb6cdef2c17d564d9857ab386d7d...99fe594d9677d55d773db3ab180310a3d3bf090b,2,36,0,36,7,2007-10-10 07:50:01,2007-10-10 06:58:59
99fe594d9677d55d773db3ab180310a3d3bf090b...57364320bf5a15e849ea627423397eda3f34ebb7,7,4423,1657,6080,1241,2007-10-10 08:11:43,2007-10-10 08:11:43
57364320bf5a15e849ea627423397eda3f34ebb7...4dcf4e0ed44183f846878a3845e8a71b61c34edb,2,429,244,673,237,2007-10-12 04:12:07,2007-10-10 13:04:16
4dcf4e0ed44183f846878a3845e8a71b61c34edb...a0592d3f5746b41c60fee71dd8d2d27b5c813907,1,12,11,23,8,2007-10-12 04:14:33,2007-10-11 00:50:40
a0592d3f5746b41c60fee71dd8d2d27b5c813907...69f85ffaa22c3357cbb5c3c97a621eccbdfa2bb3,1,49,45,94,2,2007-10-12 04:34:04,2007-10-12 04:34:04
69f85ffaa22c3357cbb5c3c97a621eccbdfa2bb3...f00d504a6fcf29944311a497d0eb76f0fe5ef8f0,1,14,21,35,7,2007-10-12 04:42:17,2007-10-12 04:42:17
f00d504a6fcf29944311a497d0eb76f0fe5ef8f0...85f7a94b3c1e4289827f2529d2e8447f3678c619,1,20,0,20,1,2007-10-12 04:54:15,2007-10-12 04:54:15
85f7a94b3c1e4289827f2529d2e8447f3678c619...24f7c64b21bb26aab5b8525c0bac8452e7a7a4c8,2,83,0,83,7,2007-10-12 05:13:55,2007-10-08 06:25:47
24f7c64b21bb26aab5b8525c0bac8452e7a7a4c8...28e86952dd0802315d79f57f666fa2c283d0fbe8,1,34,27,61,8,2007-10-12 05:34:36,2007-10-12 05:34:36
28e86952dd0802315d79f57f666fa2c283d0fbe8...9c1b1b1e45926e6eed57f5bfbb5c3f69e063e5ab,1,49,6,55,11,2007-10-12 05:56:06,2007-10-12 05:56:06
9c1b1b1e45926e6eed57f5bfbb5c3f69e063e5ab...580b73de258635ca392d917cda4341ac5f1a2535,1,6,0,6,3,2007-10-13 03:05:59,2007-10-12 15:15:02
580b73de258635ca392d917cda4341ac5f1a2535...28d1b11a1172ef047a97a901819aac75a8cf75c9,1,2,0,2,1,2007-10-13 03:05:59,2007-10-12 15:04:20
28d1b11a1172ef047a97a901819aac75a8cf75c9...914c4d4dcd96218d33f5fefc9c175ea785972f06,1,6,0,6,3,2007-10-13 03:05:59,2007-10-12 15:13:58
914c4d4dcd96218d33f5fefc9c175ea785972f06...d6db1ad51a5ac8154fcc2413f1eb6142c1a0639a,1,2,2,4,2,2007-10-13 03:06:36,2007-10-12 16:18:02
d6db1ad51a5ac8154fcc2413f1eb6142c1a0639a...51a41ac4efd8bcbcf2aa6e738c42ae4d46d10947,4,84,35,119,17,2007-10-13 03:07:58,2007-10-12 20:11:35
51a41ac4efd8bcbcf2aa6e738c42ae4d46d10947...ba6c761e6287f9987d70ed4d2a609a7ed415a6a5,1,37,7,44,3,2007-10-13 03:07:58,2007-10-12 20:24:20
ba6c761e6287f9987d70ed4d2a609a7ed415a6a5...82dd4e0465282e39962ba8fdb01c42aa665b1999,1,6,2,8,2,2007-10-13 03:07:59,2007-10-12 20:33:45
82dd4e0465282e39962ba8fdb01c42aa665b1999...86215812487930c69e197ef03be31e0b396a04cc,2,3,0,3,2,2007-10-14 02:14:14,2007-10-13 19:41:31
86215812487930c69e197ef03be31e0b396a04cc...a5bb31fb6323b53559b0d15ce2d02a7ba6d74bed,1,4,1,5,1,2007-10-17 07:38:00,2007-10-16 16:55:34
6c2f207b2316149ee8dfaf026e4a869ff9ab42f7...49b8b2926fdcc4322445f0a3bda459e81cd98e9a,1,3,8,11,6,2006-11-06 02:35:08,2006-11-05 22:22:15
49b8b2926fdcc4322445f0a3bda459e81cd98e9a...fe732edee10f9b241c8df9b4ea081a4f33ad3968,1,1,1,2,1,2006-11-06 02:36:36,2006-11-04 20:24:05
fe732edee10f9b241c8df9b4ea081a4f33ad3968...9faed78f59046cb7cef7f132726bf81c5074b08d,1,1,0,1,1,2006-11-06 16:42:02,2006-11-06 10:38:52
9faed78f59046cb7cef7f132726bf81c5074b08d...e52775f43857f377aa2aa69f82ac2d2f26dc6297,1,57,8,65,5,2006-11-06 23:01:14,2006-11-06 18:12:45
6173c197c9a23fa8594f18fd2c856407d4af31c1...aca085e577688108a2480b96a2f7077424a74e4d,2,20,4,24,6,2006-12-04 08:55:12,2006-12-03 19:42:47
aca085e577688108a2480b96a2f7077424a74e4d...562cefbdbfaeb92f91c961c67960a93a7772220c,1,2,1,3,1,2006-12-04 22:24:12,2006-12-04 22:24:12
ce2a34188b70c2d04ffdc1d9d3acc04d7a35c5c6...c06c79667c9514aed00d29bcd80bd0cee7cc5a25,5,149,21,170,18,2006-03-12 11:22:10,2006-03-12 11:22:10
f2fea68a0fc29c6378748853abb01aed1c462a50...486a974acce1bd560ae8edc1895ff91253271675,1,135,0,135,1,2006-03-04 21:45:37,2006-03-04 14:32:19
486a974acce1bd560ae8edc1895ff91253271675...18e3e99e3d0e838608eea7fe452366c4c57ef32e,1,10,4,14,4,2006-03-04 21:45:58,2006-03-04 16:37:42
18e3e99e3d0e838608eea7fe452366c4c57ef32e...a944652c054464ab3a70cead89df170602339512,1,2,1,3,3,2006-03-04 21:46:13,2006-03-04 16:38:05
a944652c054464ab3a70cead89df170602339512...b23761d9ac0851f1af7edde1075f78835f539428,1,8,3,11,3,2006-03-04 21:46:20,2006-03-04 16:38:20
b23761d9ac0851f1af7edde1075f78835f539428...45033ad9e333a8c89e7fe3d6bf75adef043602e7,1,11,5,16,5,2006-03-04 21:46:52,2006-03-04 16:38:41
45033ad9e333a8c89e7fe3d6bf75adef043602e7...a79656e6af627d40d934ba8b73f58b816a9f0ac1,1,54,31,85,14,2006-03-04 21:47:02,2006-03-04 16:38:58
a79656e6af627d40d934ba8b73f58b816a9f0ac1...2eb063c9331d73548e0fe68802e73ccd68a41046,1,1,1,2,1,2006-03-04 21:50:04,2006-03-04 16:35:27
f2fea68a0fc29c6378748853abb01aed1c462a50...f5948cfe673ec65c09b926249cc02ab4451243fa,3,2,84,86,4,2006-03-04 21:26:36,2006-03-04 10:51:19
f5948cfe673ec65c09b926249cc02ab4451243fa...4d0f39cecf93222401a81216e5cf2528e8abc6ae,2,28,21,49,7,2006-03-04 21:26:36,2006-03-04 09:03:53
4d0f39cecf93222401a81216e5cf2528e8abc6ae...ba23bbc8efff19f7ba4c272b6a06a4327a4cf039,1,68,28,96,5,2006-03-04 21:34:50,2006-03-04 11:21:55
8a414ad50cd9edfe6c8f0a6b9b08df4aaa9ccb75...f5ef535ff571d80d230ea4706edad215f1fbc96f,1,2,2,4,2,2006-03-18 10:07:59,2006-03-18 10:07:59
5ceb05f82edc49ad5e6b0ad98d633c124a567309...4c2e98d6ce47aa9fcc1598c68e630f371cd4f8cb,1,2,2,4,2,2006-03-22 08:50:32,2006-03-22 08:23:16
69bcc43eca0f251617e3b5db5df632b24db94e92...9af0b8dbe2fb252262412a11254e2bcc6ffb87bb,1,28,0,28,1,2006-04-27 01:25:15,2006-04-27 01:25:15
69bcc43eca0f251617e3b5db5df632b24db94e92...093b06889104d218e95251176af5cf4aa5dd5cdd,1,12,4,16,4,2006-04-27 00:16:11,2006-04-26 16:10:01
69bcc43eca0f251617e3b5db5df632b24db94e92...031321c654de3c19de45b2dacbdc990b5a694e34,2,97,33,130,22,2006-04-27 00:10:33,2006-04-26 14:49:38
69bcc43eca0f251617e3b5db5df632b24db94e92...ea92f41ff92b2fef54c8da4abb03c8101160a034,3,36,3,39,6,2006-04-27 00:08:44,2006-04-26 22:09:27
50c08d48722149d95f46bcc80a5211ea04b8a809...568907f52051f340dc29a907f67e69260d7d4e7a,1,2,0,2,2,2006-05-07 22:10:48,2006-03-17 00:33:19
568907f52051f340dc29a907f67e69260d7d4e7a...7d90095abe322f72820f334839afb75c23e009ff,1,139,82,221,28,2006-05-07 22:33:36,2006-03-27 03:51:42
7d90095abe322f72820f334839afb75c23e009ff...82000d74642f1c9f55ad4b0516c59d829014839a,1,27,11,38,6,2006-05-07 22:38:31,2006-03-28 01:24:27
3dc5a9e4cdcc7124c665a050547d1285d86a421f...2d08e5dd730680f7f8645a6326ec653435e032df,1,2,3,5,3,2006-05-03 04:32:32,2006-05-03 03:46:51
2d08e5dd730680f7f8645a6326ec653435e032df...06a9f9203570d21f9ef5fe219cdde527dcdf0990,1,27,13,40,6,2006-05-03 04:32:39,2006-05-03 03:31:00
34fd1c9ac5845d541e3196983df7f993e751b544...3e1a70d925b46b9eac1ae523589298ddb6e295af,1,10,2,12,3,2006-04-25 05:22:29,2006-04-25 00:00:03
3e1a70d925b46b9eac1ae523589298ddb6e295af...4ee6bc99133760531dd25013c7a7165b2feed9cd,1,4,1,5,2,2006-04-25 05:26:34,2006-04-24 22:59:28
4ee6bc99133760531dd25013c7a7165b2feed9cd...1ab661ddb7eb564c1c3cb97a512257860a651459,3,198,14,212,12,2006-04-25 05:26:37,2006-04-24 22:59:33
ec167793d84ba7b765e1eb71b0257ce7baca2d26...2bd452d3b9f62ecc3406307cd6a5553856d21ff2,4,128,149,277,7,2006-04-20 06:52:05,2006-04-20 06:52:05
40c2fe003ce2af3ec522f239be274fd1a27422f6...4e1dc640097d4e389f12bcf12f75cdf7e4ceae61,1,2,0,2,1,2006-04-15 04:52:50,2006-04-14 22:57:32
170abc81a0f7bc02702189bacf7eeab74223d922...42b5c78845feb44f1d36eecad4c72336d5c2a9c5,1,1,1,2,1,2006-04-15 06:21:34,2006-04-15 06:21:34
16a4c6ee0d9a3d07d4d0afbbc4e3467e78065eca...4e2e5647f23e2babcb188fd05eececbb261e2f17,2,21,0,21,4,2006-06-04 20:29:36,2006-06-04 18:07:48
4e2e5647f23e2babcb188fd05eececbb261e2f17...eff97e3faeb28f6521851c1b3be1a54a2138f12a,1,1,0,1,1,2006-06-05 19:26:53,2006-06-04 17:48:31
eff97e3faeb28f6521851c1b3be1a54a2138f12a...c51901de1dfd0670e3394157c2909f5036be3ea7,1,23,0,23,1,2006-06-05 19:26:59,2006-06-04 23:53:45
c51901de1dfd0670e3394157c2909f5036be3ea7...53bcf78a023cee565a31c2956d13dba652f9ccf3,1,12,7,19,2,2006-06-05 19:27:03,2006-06-05 02:10:33
53bcf78a023cee565a31c2956d13dba652f9ccf3...2befe6feb99da9fb73b9e8c218b414419ef947ec,1,1,1,2,1,2006-06-05 20:05:49,2006-06-05 19:47:49
2befe6feb99da9fb73b9e8c218b414419ef947ec...87cefaaff958e30204a21757012a46883175c00f,1,2,2,4,2,2006-06-05 21:54:17,2006-06-05 18:44:36
87cefaaff958e30204a21757012a46883175c00f...ce0bd64299ae148ef61a63edcac635de41254cb5,1,19,50,69,12,2006-06-06 00:23:31,2006-06-05 19:03:31
ce0bd64299ae148ef61a63edcac635de41254cb5...441c823e892ba7408e87d26b6e77def5975c1c60,1,11,9,20,5,2006-06-06 00:39:44,2006-06-05 20:02:29
16a4c6ee0d9a3d07d4d0afbbc4e3467e78065eca...e96fd30553bb57a76ad38f703a3fea5b53c45ff9,1,3,6,9,2,2006-06-04 07:00:20,2006-06-03 17:11:48
3cd204e518ce832402c291be73292baa149d0240...6c2833284d84d1128f44dbfd846c81ef93f07a3c,1,1,0,1,1,2007-01-13 05:15:09,2006-12-10 20:31:46
6c2833284d84d1128f44dbfd846c81ef93f07a3c...5024baa43790bf0ea12905b47c8922e3b256ae61,1,1,1,2,1,2007-01-13 05:15:09,2007-01-09 14:30:19
5e3a620cd5f7baaf27198192a614271c6145ec3b...52ba03cbb1c718093946f5254187082bd7b32845,5,29,33,62,6,2006-06-10 18:14:00,2006-06-10 14:13:41
5e3a620cd5f7baaf27198192a614271c6145ec3b...94df2506edd76a886a1044376f8c99349b2f226e,5,47,7,54,9,2006-06-10 08:31:31,2006-06-10 06:09:49
be65e7d9fbd3ae6fc097cedade2afe39805fcf4e...d92f1dc63f0582e7cf8dac54d50a2748119a1ce3,1,1,2,3,1,2006-05-07 22:36:10,2006-05-07 14:50:47
c66b6c067e49c5ec80f1254daef79aa1c7f5ffce...e686eb9870d6b382f0760e3e859e93c8c2dfb31b,2,9,1,10,3,2006-05-06 21:43:33,2006-05-06 20:56:38
5e363541d0431b640e4bbbafb2941d1c64fa13c4...5126f35a54f179d125775e6d18213f76aa7856b3,1,0,1,1,1,2006-05-22 20:42:58,2006-05-22 10:09:14
5126f35a54f179d125775e6d18213f76aa7856b3...884e3134a0002af1f8842768873fe9d041ed9a76,1,1,1,2,1,2006-05-22 22:34:40,2006-05-22 22:34:40
884e3134a0002af1f8842768873fe9d041ed9a76...e3008464e70d25b4926b97b1f86951d7a3cb938d,1,1,1,2,1,2006-05-23 01:00:38,2006-05-23 00:36:34
e3008464e70d25b4926b97b1f86951d7a3cb938d...f803eec51b6fe812c523c8f6474e029163b307e8,1,2,2,4,2,2006-05-23 01:11:52,2006-05-22 19:34:00
f803eec51b6fe812c523c8f6474e029163b307e8...f396f01f11208789875b61e4e0e3239b04f9e38d,1,3,0,3,2,2006-05-23 01:12:27,2006-05-22 12:45:47
f396f01f11208789875b61e4e0e3239b04f9e38d...c4b16f8d7786c2a9655636779ce4e3e89f0df86c,1,3,3,6,3,2006-05-23 01:16:44,2006-05-22 12:45:39
c4b16f8d7786c2a9655636779ce4e3e89f0df86c...1100ac81a90b03e0c037a286569a340decf7489b,1,2,2,4,2,2006-05-23 01:20:46,2006-05-22 04:39:52
1100ac81a90b03e0c037a286569a340decf7489b...7f7e6eacf999cb53771426e561589f721e6c9974,1,8,1,9,1,2006-05-23 01:52:19,2006-05-22 04:42:59
5e363541d0431b640e4bbbafb2941d1c64fa13c4...9546010b7bbc25e037029a7dd83de9c57b7a935c,2,52,16,68,3,2006-05-22 12:32:38,2006-05-11 22:28:44
685637381a967cd7388495f97b12b7cf177abbb4...efbff23609654ac0542d3421d19eea8dbc1f80cd,1,1,1,2,1,2006-05-21 10:16:38,2006-05-21 10:16:38
711fc8f660be16ae4c4caaf3caa495d12310b5ad...2b020455f92ea3c20a78005dd19e7a127bb5b481,1,18,11,29,6,2006-02-19 06:37:02,2006-02-19 06:37:02
925f9187697acfdbd7dbfe15e8420e1d3a671433...749be728d469e9a0acfdc020feff17c2da510083,4,32,29,61,14,2006-02-19 04:31:05,2006-02-19 04:31:05
749be728d469e9a0acfdc020feff17c2da510083...e3b59a44f6705896db80965427a7cf9e2112634b,4,13,1,14,6,2006-02-19 04:51:26,2006-02-19 04:51:26
be97bd1b88003f4a19e2832ee0cc6ac20fcab674...b6e56eca8a4eb74a86e9f2d99aa480c665458aa7,2,10,0,10,6,2006-02-16 09:42:58,2006-02-16 08:38:01
b6e56eca8a4eb74a86e9f2d99aa480c665458aa7...3397f9df53092871de2c33c143f1f4413654c40d,2,978,0,978,2,2006-02-16 09:56:43,2006-02-16 09:24:16
3397f9df53092871de2c33c143f1f4413654c40d...1c6bbbf37be5c2b0fce45a57ecfeea2d9b7a3269,1,3,3,6,3,2006-02-17 09:01:20,2006-02-16 19:47:51
1c6bbbf37be5c2b0fce45a57ecfeea2d9b7a3269...defc649229eef2461ad1c2fea53985b8c10fd3db,1,4,3,7,3,2006-02-17 09:01:24,2006-02-17 02:13:32
defc649229eef2461ad1c2fea53985b8c10fd3db...8cb711c8a5f98c1556b320114d7cc65e498ee2ae,1,992,0,992,1,2006-02-17 10:10:31,2006-02-17 10:10:31
be97bd1b88003f4a19e2832ee0cc6ac20fcab674...492e0759bfe4ff238b80ab80c27291ab99e4512b,2,239,1,240,2,2006-02-16 07:35:40,2006-02-15 02:05:30
492e0759bfe4ff238b80ab80c27291ab99e4512b...01df529722618a78d2acf6159c7b1e65f565cabc,1,30,10,40,6,2006-02-16 07:35:40,2006-02-15 02:33:02
01df529722618a78d2acf6159c7b1e65f565cabc...164dcb97f0cd1accaec4ed40c24881f8e9ae4371,1,67,53,120,14,2006-02-16 07:39:11,2006-02-16 03:25:32
be97bd1b88003f4a19e2832ee0cc6ac20fcab674...4c8725f16abff4be4812d0d07a663250bef3ef0e,5,29,9,38,15,2006-02-16 06:12:06,2006-02-16 06:05:33
772d8a3b63ff669c285edb8aff0c63b609614933...3ff903bfb9e34a02f681f1c95ef7aa3ce4d54d2a,1,13,15,28,6,2006-02-18 19:21:16,2006-02-18 11:49:38
3ff903bfb9e34a02f681f1c95ef7aa3ce4d54d2a...39ba7d54649b35c943b026b54bff40cfa0153f3e,1,5,8,13,5,2006-02-19 00:19:00,2006-02-18 20:44:20
6b94f1e404afc552e5139c4357331843f5be61ad...b33aba518456bee97bde1fef4fe17ab6bf401bbe,1,3,1,4,1,2006-01-28 08:09:58,2006-01-27 01:24:52
6b94f1e404afc552e5139c4357331843f5be61ad...46a6c2620ba421397eec627b8eb18eb530e694fc,5,7,8,15,7,2006-01-28 08:09:38,2006-01-25 09:03:18
46a6c2620ba421397eec627b8eb18eb530e694fc...d50125085a6c4775a77d45a6d294d723f6de8869,1,14,0,14,3,2006-01-28 08:09:38,2006-01-25 09:35:38
d50125085a6c4775a77d45a6d294d723f6de8869...b2d4c56f2f370481c80e478ac323ebb13eece807,5,18,9,27,10,2006-01-28 08:09:38,2006-01-25 10:37:40
b2d4c56f2f370481c80e478ac323ebb13eece807...1dc4fb84b5914621cf59b6b508ad7c9c86c61fa4,1,4,2,6,1,2006-01-28 08:09:39,2006-01-26 08:48:19
1dc4fb84b5914621cf59b6b508ad7c9c86c61fa4...62a604ba1c8f1ebcb135039ab04c9ca6c96b67f4,1,2,2,4,1,2006-01-28 08:09:39,2006-01-27 01:02:07
62a604ba1c8f1ebcb135039ab04c9ca6c96b67f4...3815f423ae39bf774de3c268c6d3e3b72128a4e5,5,10,10,20,10,2006-01-28 08:09:39,2006-01-27 09:54:59
3815f423ae39bf774de3c268c6d3e3b72128a4e5...f2d4227530499db3e273ae84f30adfd4b70791c6,1,26,26,52,8,2006-01-28 08:09:39,2006-01-27 10:17:19
f2d4227530499db3e273ae84f30adfd4b70791c6...6b1ddbdd6e02719ae2be55dc141a176187e5027e,1,6,1,7,2,2006-01-28 08:09:39,2006-01-27 10:19:51
6b94f1e404afc552e5139c4357331843f5be61ad...461cf59f8924f174d7a0dcc3d77f576d93ed29a4,1,78,58,136,23,2006-01-28 08:08:38,2006-01-18 22:47:30
461cf59f8924f174d7a0dcc3d77f576d93ed29a4...93b74bca86f59b8df410b6fd4803b88ee0f304bf,2,5,0,5,3,2006-01-28 08:08:38,2006-01-27 09:39:24
6b94f1e404afc552e5139c4357331843f5be61ad...af3feefa1d057713c2277cc1543d438e60c65306,4,502,7,509,9,2006-01-28 08:08:28,2006-01-24 09:22:04
af3feefa1d057713c2277cc1543d438e60c65306...d8f4790e6fe7a9d94468ea83d1370643604d43e5,3,73,8,81,11,2006-01-28 08:08:28,2006-01-24 09:22:04
d8f4790e6fe7a9d94468ea83d1370643604d43e5...5290a0f8129cc5830390bad3cc6c8034cb23b41c,1,6,11,17,5,2006-01-28 08:08:29,2006-01-25 11:34:10
5290a0f8129cc5830390bad3cc6c8034cb23b41c...e228340961e0f48c6b818251bd4729b2d19647e4,1,2,3,5,3,2006-01-28 08:08:29,2006-01-25 19:55:40
e228340961e0f48c6b818251bd4729b2d19647e4...263eee29e94de935d62c7c4066fcea0ccfbe60b8,1,63,26,89,12,2006-01-28 08:08:29,2006-01-25 21:11:38
263eee29e94de935d62c7c4066fcea0ccfbe60b8...8828cdcb445fc420de9e869d359596ceefce76be,1,30,16,46,15,2006-01-28 08:08:29,2006-01-25 22:26:22
8828cdcb445fc420de9e869d359596ceefce76be...3ec1909fdaa1189a8f9d23f84e33b45d9d7600cd,1,116,27,143,13,2006-01-28 08:08:29,2006-01-26 11:53:01
3ec1909fdaa1189a8f9d23f84e33b45d9d7600cd...ea726d02e9677a66586d7ffebe97f112ab6dab33,3,99,23,122,21,2006-01-28 08:08:29,2006-01-28 08:03:38
92643a27cc2cc7ce55ba2afd6155f94b40e1aa89...d8f6b342ae200b2eb72e2f81afea7fe0d41aec0b,2,8,1,9,4,2006-01-25 22:44:52,2006-01-25 22:00:37
d8f6b342ae200b2eb72e2f81afea7fe0d41aec0b...73e5456ed3eced7a728f933e01c850c2992dbeed,1,1,1,2,1,2006-01-25 22:44:55,2006-01-25 22:02:10
73e5456ed3eced7a728f933e01c850c2992dbeed...205df2796de24320c86528051576dcd4546215f0,1,2,2,4,2,2006-01-25 23:10:22,2006-01-25 23:10:22
205df2796de24320c86528051576dcd4546215f0...fc5be4fdaa063a667d17ae40e4ad130e2177b0f8,1,1,1,2,1,2006-01-25 23:10:35,2006-01-25 20:03:41
fc5be4fdaa063a667d17ae40e4ad130e2177b0f8...5ea06e2014a910240408f74b9dab2128a30fd06c,1,1,1,2,1,2006-01-25 23:10:37,2006-01-25 20:37:51
5ea06e2014a910240408f74b9dab2128a30fd06c...731043fd4d55b1561ebb5a53daa4b9ff6dfac046,4,37,0,37,5,2006-01-25 23:10:39,2006-01-25 20:38:36
731043fd4d55b1561ebb5a53daa4b9ff6dfac046...521698b1538fb3c9bd818ee98f2c17d2c80c9605,5,31,46,77,22,2006-01-26 09:08:29,2006-01-26 06:13:36
521698b1538fb3c9bd818ee98f2c17d2c80c9605...2796a9de31cb12d719c73695334ee873c5213d4a,2,3,4,7,2,2006-01-27 02:11:06,2006-01-27 02:11:06
2796a9de31cb12d719c73695334ee873c5213d4a...a8608db5e925bcdfed88e73e2da0ffa27c466998,1,0,1,1,1,2006-01-27 02:12:58,2006-01-26 11:25:44
a8608db5e925bcdfed88e73e2da0ffa27c466998...e974c9ab03c3c149bfc7da663167c6e59a7659f7,1,1,1,2,1,2006-01-27 02:13:54,2006-01-26 11:26:15
e974c9ab03c3c149bfc7da663167c6e59a7659f7...374dfaa2e39d04a4f1f63d1cb8d322d9db07c73a,1,5,3,8,1,2006-01-27 02:14:02,2006-01-26 16:39:27
374dfaa2e39d04a4f1f63d1cb8d322d9db07c73a...b3bf974cab4569221b5a1249d1a692e7190896f8,1,5,0,5,1,2006-01-27 02:14:40,2006-01-26 18:04:30
1506fc34f7585880aeeb12b5fdfe2de4800f9df5...5207234a68aebf1f7a6494f6197513b00c8a70f3,1,24,26,50,10,2006-01-31 03:08:37,2006-01-29 19:04:59
5207234a68aebf1f7a6494f6197513b00c8a70f3...c3f9281255a24afa47a5a8d8f25cd9f22c2da6da,1,6,35,41,4,2006-01-31 03:08:38,2006-01-29 19:05:20
1506fc34f7585880aeeb12b5fdfe2de4800f9df5...b8bc67cef31453233f1ff6722c0bd3c99df44756,2,163,223,386,15,2006-01-31 03:08:33,2006-01-29 04:31:47
b8bc67cef31453233f1ff6722c0bd3c99df44756...807f900a73739dd2323e2a7f4944318d3d8e2497,1,1,1,2,1,2006-01-31 05:01:25,2006-01-31 05:01:25
f9039f30d56e3815eaab870d8b19c7b94aded8aa...7f59dbbb8f8d479c1d31453eac06ec765436a780,1,16,56,72,6,2005-11-18 23:53:15,2005-11-14 08:41:53
f9039f30d56e3815eaab870d8b19c7b94aded8aa...eb777612f085fc42afd0ac6986ed8062f8b75cbd,1,18,7,25,8,2005-11-18 23:53:12,2005-11-11 19:12:50
7b8315bb593c38ac957486916512e9a5df6df087...128a96c98442524c7f2eeef4757b1e48445f24ce,1,60,0,60,2,2013-09-20 19:42:02,2013-09-20 19:42:02
8d8387116ae8c3e73f6184471f0c46edbd2c7601...ea95c7b8f52471f7ce30379c2b2d7032f2b8c2c9,1,2,2,4,2,2013-09-19 20:05:40,2013-09-18 17:06:08
16c159d75af29b1929af0e2f341d26fce4e1d546...fbc812a6009ebc91f4870c3572821cb4d68184f8,1,4,4,8,1,2013-10-31 17:24:33,2013-10-31 11:51:32
6b5b3a27b7faf9d72efec28fa017408daf45cd00...373c67da1df7fcd33593ca26e6d67f177152b21a,2,15,2,17,4,2014-03-17 22:02:39,2014-03-15 02:38:29
6b5b3a27b7faf9d72efec28fa017408daf45cd00...ee34a2beadb94a9595f09af719e3c09b485ca797,4,44,2,46,9,2014-03-03 20:21:49,2014-03-03 20:04:20
abdb9b2e4fd7876ab7138119c4aedca70bc0d250...ea2d20d4c2216faa8ff4525e9e73b26509405766,1,2,3,5,1,2013-05-09 19:41:31,2013-05-09 13:13:47
abdb9b2e4fd7876ab7138119c4aedca70bc0d250...71a19a37442a8b79c02927e0f7c910f34f88d8aa,1,2,3,5,1,2013-05-09 19:20:40,2013-05-09 13:13:47
71a19a37442a8b79c02927e0f7c910f34f88d8aa...56ee96572a7ec5a6b1a59ccdbbf204af16903d17,2,14,0,14,1,2013-05-09 19:22:31,2013-05-09 13:36:10
0b63c6a5b78f3fdd8c4e4fed4e535e7f4eed4257...35c141768c4c7c486017a2d0cc615b9384b4b672,1,1,1,2,1,2013-10-22 18:17:15,2013-10-18 23:25:22
00160242770aea137ec7154a8e8406feef733926...1562f3be48da0b5303928ee267a0a028a0a63417,1,1,0,1,1,2013-09-19 18:03:38,2013-09-19 07:17:07
0d8beaa5b76e824c9869f0d1f1b19ec7acf4982f...ea16794e4303e79f8acb01a93fb6b1762972ab86,2,18,1,19,5,2013-08-25 05:17:39,2013-08-23 13:48:31
0d8beaa5b76e824c9869f0d1f1b19ec7acf4982f...e230c568c4b9a991e3175e5f65171a566fd8e39c,2,6,1,7,2,2013-08-23 18:49:46,2013-08-23 18:49:46
0b6806b9e45c659d25b87fb5713c920a3081eac8...a983e6ac58094a3b2466ad3be13049ce213f9fc3,1,15,1,16,2,2015-02-12 19:01:11,2015-02-11 21:13:10
0b6806b9e45c659d25b87fb5713c920a3081eac8...a487916dd51cd0e8949c1b739cb0a6a61ee03363,4,0,27,27,5,2013-08-20 18:11:08,2013-08-20 06:43:55
8efa5f629efb9a8af48619ee90dee02343e0f19d...88d50e78c339abd96270d2aad3c91dabbc7a8b1a,2,5,3,8,2,2010-01-15 05:54:23,2010-01-08 18:48:07
88d50e78c339abd96270d2aad3c91dabbc7a8b1a...b9cb07726a7a288244b585939850348f319e5e0c,1,1,1,2,1,2010-01-16 05:20:28,2010-01-14 23:28:59
c238dad407aec1ccf6e364f9c95e10e7f84eac8f...0bf15e743826774c2b76858e274efc4211522ec9,1,11,7,18,5,2007-11-09 09:57:43,2007-11-09 01:21:48
0bf15e743826774c2b76858e274efc4211522ec9...3f7ce648fafead8c9cb5f6f594a0eb220fc12c9c,1,27,3,30,4,2007-11-09 09:57:50,2007-11-09 02:38:27
3f7ce648fafead8c9cb5f6f594a0eb220fc12c9c...6fd7a1efe4f3b91c31017303ea2692b90eff7cdf,4,0,169,169,5,2007-11-09 09:57:54,2007-11-09 01:22:44
6fd7a1efe4f3b91c31017303ea2692b90eff7cdf...2729cadca22dce2b5bb994581c45a6a71daf7998,1,134,0,134,1,2007-11-10 05:16:54,2007-11-09 17:28:19
2729cadca22dce2b5bb994581c45a6a71daf7998...354e6534c1569d0d23937add8e7b55bf87bbaf20,2,9,2,11,3,2007-11-10 05:45:01,2007-11-09 11:34:07
354e6534c1569d0d23937add8e7b55bf87bbaf20...5aa5cd460ccb6b18a1fcd53d566dadf049ceaf63,1,69,0,69,1,2007-11-10 09:49:34,2007-11-10 09:49:34
5aa5cd460ccb6b18a1fcd53d566dadf049ceaf63...2782c9355a97667acfc40a828dbae5c5bc151047,1,15,2,17,4,2007-11-10 10:01:12,2007-11-08 15:10:28
c238dad407aec1ccf6e364f9c95e10e7f84eac8f...6fd2f5e60d4d574ff9e5dd8ce1e229328c785d69,2,57,6,63,13,2007-11-09 09:30:31,2007-11-08 18:19:08
6fd2f5e60d4d574ff9e5dd8ce1e229328c785d69...3f735b66543a2221c218fc522272d62a333ebfec,2,22,1,23,3,2007-11-13 00:23:09,2007-11-12 13:11:46
c238dad407aec1ccf6e364f9c95e10e7f84eac8f...659c69cfef984e7416decc78841877207e9d5914,4,28,6,34,13,2007-11-09 09:30:07,2007-11-09 00:49:36
659c69cfef984e7416decc78841877207e9d5914...cde75e59e1b2d8dd3ba49bc9034692dd06ee3907,3,180,123,303,18,2007-11-09 09:30:07,2007-11-09 00:49:42
cde75e59e1b2d8dd3ba49bc9034692dd06ee3907...f29d59586c2a1666d18776cca5d96752dec0e8a2,1,82,42,124,8,2007-11-11 10:04:46,2007-11-10 11:14:20
f29d59586c2a1666d18776cca5d96752dec0e8a2...91db267ec849279053cf3ac3066c2f2c11db4321,2,8,0,8,2,2007-11-11 10:04:46,2007-11-10 11:16:05
91db267ec849279053cf3ac3066c2f2c11db4321...b9c62321380374d09cc99570cdd1390674532832,1,32,0,32,8,2007-11-11 10:04:46,2007-11-10 11:18:26
b9c62321380374d09cc99570cdd1390674532832...9e79f00f06a5500b30941e6925adda070504e6cf,3,7,23,30,12,2007-11-11 20:10:35,2007-11-10 11:55:48
9e79f00f06a5500b30941e6925adda070504e6cf...726c8ef5a5a129d8157d0043f60fe7195d2cdb77,1,7,1,8,1,2007-11-13 02:16:34,2007-11-12 10:09:05
c238dad407aec1ccf6e364f9c95e10e7f84eac8f...2e458e0575de6478693586d387f71873d280b934,1,2,1,3,1,2007-11-09 09:23:40,2007-11-08 20:15:20
bcd2e266a6270254212603e90186251116d3cd16...8736a8489080509516f5f4cc1cc74de33150f397,3,156,95,251,26,2007-11-17 20:10:50,2007-11-17 12:54:27
8736a8489080509516f5f4cc1cc74de33150f397...1f0e2a1a65477c2b8eb8812e5bf0ad07bf03738e,2,10,13,23,6,2007-11-17 20:10:50,2007-11-17 12:55:15
1f0e2a1a65477c2b8eb8812e5bf0ad07bf03738e...ca74c458a3908314cf29b96f1c43fe2b2597de76,3,71,6,77,14,2007-11-17 20:10:50,2007-11-17 12:56:03
ca74c458a3908314cf29b96f1c43fe2b2597de76...9f8a15c73437abc634f2c43501105b108c51eae8,1,4,4,8,1,2007-11-18 10:23:25,2007-11-18 09:31:37
9f8a15c73437abc634f2c43501105b108c51eae8...cda69f481db510e2a3f0ca8a0f4b54123c799416,3,10,8,18,3,2007-11-18 10:34:34,2007-11-18 07:13:10
cda69f481db510e2a3f0ca8a0f4b54123c799416...2a0fe89a976331cb2163d4f299e38e2cb5010632,2,54,43,97,15,2007-11-18 10:34:52,2007-11-18 07:16:52
2a0fe89a976331cb2163d4f299e38e2cb5010632...73fa0b44ac1ed3b0b34ea6bcdca7d9b76886b903,1,15,1,16,2,2007-11-18 10:35:39,2007-11-18 08:08:22
73fa0b44ac1ed3b0b34ea6bcdca7d9b76886b903...07f507155d01af0fdc8aa179b6a779301168b1eb,1,53,40,93,5,2007-11-21 07:25:31,2007-11-20 11:18:01
467f42cfa1d298dcaab40e06f8dfa8f80ee345f7...1e8df762b38e01685f3aa3613e2d61f73346fcbe,2,17,2,19,4,2007-12-13 01:48:21,2007-12-13 01:48:21
1e8df762b38e01685f3aa3613e2d61f73346fcbe...37d07f8f9841a29cb53a1eda6acd3804c957f0e3,3,8,4,12,7,2007-12-13 04:50:33,2007-12-13 03:09:16
37d07f8f9841a29cb53a1eda6acd3804c957f0e3...9e5d87d49070fe0463040e826824d6ce41beb089,1,3,3,6,3,2007-12-13 17:46:52,2007-12-13 04:36:21
9e5d87d49070fe0463040e826824d6ce41beb089...5ff6aae8951268d8287337b1875bccae267d2b56,1,13,4,17,2,2007-12-13 17:47:48,2007-12-13 06:58:15
5ff6aae8951268d8287337b1875bccae267d2b56...3157dd9e89a71e80673d0bc21b5c0630f3b1fe68,1,3,0,3,3,2007-12-13 17:54:45,2007-12-13 16:27:34
3157dd9e89a71e80673d0bc21b5c0630f3b1fe68...792c1583c8ab94c8cee77ca66685983259d7510e,1,11,0,11,1,2007-12-14 05:19:26,2007-12-14 03:32:36
792c1583c8ab94c8cee77ca66685983259d7510e...c279d7e9869740a6d64b0d1d70f7968af68d2071,8,16,10,26,12,2007-12-14 07:04:26,2007-12-13 21:25:07
c279d7e9869740a6d64b0d1d70f7968af68d2071...913b45f51b151d8e29f86df67d3e10853d831470,1,33,1,34,2,2007-12-14 07:04:26,2007-12-13 22:24:18
552ce11006e39bd07efd79946f180df47aa35b4e...c95c02486c4dd82f8910a8de1cb7c8f9db899995,1,6,1,7,2,2007-09-30 06:14:16,2007-09-26 13:56:19
c95c02486c4dd82f8910a8de1cb7c8f9db899995...6a6eb3d09fcbfae41978fb5223ae03e2d103968b,1,3,4,7,4,2007-09-30 06:14:17,2007-09-26 14:05:01
6a6eb3d09fcbfae41978fb5223ae03e2d103968b...81ab1cb43a872fc527b26388bc7e781c816d723b,3,3,3,6,4,2007-09-30 06:16:08,2007-09-29 23:34:23
81ab1cb43a872fc527b26388bc7e781c816d723b...f4bb20cc99fe18ba0e7dd421f1d95a05c1cbbc93,1,10,4,14,10,2007-09-30 06:32:31,2007-09-30 06:29:43
dd8175f83c725619d72d6bbaacf8eaafc158edea...8d863c98b2f9b0d3777227b85b13b4095dd0f6dc,1,2,1,3,1,2007-10-23 19:10:55,2007-10-23 19:10:55
8d863c98b2f9b0d3777227b85b13b4095dd0f6dc...2db9b49c6c19d3edaa3c20147f7d9f29588433df,2,4,0,4,2,2007-10-25 03:13:07,2007-10-01 12:42:42
dd8175f83c725619d72d6bbaacf8eaafc158edea...b5d21a4b68aa69c7a2b4d2239aaa9ee5a51058a7,1,1,2,3,1,2007-10-22 05:57:50,2007-10-20 22:41:41
b5d21a4b68aa69c7a2b4d2239aaa9ee5a51058a7...a238917ba48c44de8a00e3aee7898d9beb5afcd8,1,1,1,2,1,2007-10-27 06:26:41,2007-10-27 06:26:41
dd8175f83c725619d72d6bbaacf8eaafc158edea...e076a0e71f25430205d0437c177fd12a7018e5ad,1,29,5,34,8,2007-10-22 05:54:12,2007-10-22 00:28:03
e076a0e71f25430205d0437c177fd12a7018e5ad...ce58ec9158fe398dc7142e34cf575d336f408370,1,21,24,45,5,2007-10-25 05:06:57,2007-10-23 01:31:22
ce58ec9158fe398dc7142e34cf575d336f408370...d3cd249565b6457d5845e7396530db7685a970bb,1,3,3,6,3,2007-10-25 05:07:05,2007-10-23 01:31:23
2ce1a1f23fd83d2cab22f87aff1165fb0c7ad450...b9c506f7d9f05a630fa7e31b77a9cf5081d7dbba,1,2,0,2,2,2007-11-21 07:11:00,2007-11-18 08:17:23
b9c506f7d9f05a630fa7e31b77a9cf5081d7dbba...183f84365de7b4b1fe0e15cebce80a95023aa1d6,1,1,1,2,1,2007-11-21 07:27:44,2007-11-21 03:01:19
28391a80a94d2b59d1d21f8264fe5dab91d77249...32d75d29f99cca8e0874b1bdf94ded48b576c906,1,16,9,25,6,2007-11-30 23:49:17,2007-11-29 21:30:13
32d75d29f99cca8e0874b1bdf94ded48b576c906...9ae8fcb36ac9fde8e048a304cc3717f2c7914e78,1,13,0,13,1,2007-11-30 23:49:17,2007-11-30 00:41:09
28391a80a94d2b59d1d21f8264fe5dab91d77249...f01913e4190bed98f918ec575229943a0ee47d83,3,42,2,44,7,2007-11-30 23:47:01,2007-11-29 20:59:55
f4e9996b77415707a20a139463c3e3782e2fa48f...ab0d33c43852b047c2a3e5ae960df9a146363e7c,1,11,4,15,3,2007-10-26 07:08:37,2007-10-23 22:44:55
ab0d33c43852b047c2a3e5ae960df9a146363e7c...f94872dfc18c2670c9eb4ed8528ba45943213f39,1,11,2,13,4,2007-11-01 04:00:30,2007-10-30 11:24:37
f94872dfc18c2670c9eb4ed8528ba45943213f39...9a25ae82dd635957e40e2d29ea5022d25fb6c2b0,1,3,0,3,1,2007-11-01 04:00:31,2007-10-30 11:24:53
9a25ae82dd635957e40e2d29ea5022d25fb6c2b0...95a8b67c2642c576f848005e72126fb25d11286c,1,20,2,22,9,2007-11-01 04:03:24,2007-10-30 11:25:31
95a8b67c2642c576f848005e72126fb25d11286c...efb848666cd45be5bc213785bedc772969fb3da0,1,292,224,516,195,2007-11-01 04:05:06,2007-10-31 21:16:17
efb848666cd45be5bc213785bedc772969fb3da0...76d536b8af3a2cdf6fb86b2f05051a31b7096cbb,1,133,144,277,142,2007-11-01 04:06:43,2007-10-31 14:12:12
76d536b8af3a2cdf6fb86b2f05051a31b7096cbb...6ea10797deb7699c35a2b097938bf02aabc29e45,1,1,1,2,1,2007-11-01 04:17:25,2007-11-01 04:14:01
6ea10797deb7699c35a2b097938bf02aabc29e45...48b8d2b3792339d4dbd37802db8ec797361dd1fe,1,8,1,9,2,2007-11-01 04:31:36,2007-11-01 04:31:36
48b8d2b3792339d4dbd37802db8ec797361dd1fe...cd16a6c9298778265a044e5f9a39b006277b32f2,1,6,1,7,3,2007-11-08 07:22:21,2007-11-08 07:22:21
cd16a6c9298778265a044e5f9a39b006277b32f2...41188dd1a837df08a959b63a2f56357971fa4549,1,1,1,2,1,2007-11-21 07:10:03,2007-11-21 07:10:03
7468c297fa88f0035dc719e996b93b1404eee6e3...07134421fc5765d6c96c548e70e461c290143762,1,38,14,52,6,2007-10-21 05:44:40,2007-10-19 17:59:22
07134421fc5765d6c96c548e70e461c290143762...6dd4b66fdecc2ffdc68758b6c4e059fcaaca512b,2,8,4,12,5,2007-10-21 05:59:42,2007-10-20 19:31:31
6dd4b66fdecc2ffdc68758b6c4e059fcaaca512b...2ee52eb17c26323b3f62538a44510aae75f09d6f,1,15,0,15,4,2007-10-21 06:04:02,2007-10-21 03:40:06
c9dcc7f865fb7891f4f6d068230663eb2cb586a7...fb6cf213a3929744fc89e6a444dcd7d4b2fa3c66,2,8,3,11,5,2007-10-21 00:45:10,2007-10-20 13:30:53
fb6cf213a3929744fc89e6a444dcd7d4b2fa3c66...9d434d50262b00243c6249697ebfa8512042b158,2,238,220,458,190,2007-10-21 00:45:11,2007-10-20 13:31:43
9d434d50262b00243c6249697ebfa8512042b158...c43ff43601201e17be8882ee199542282f1531eb,1,190,141,331,172,2007-10-22 04:03:42,2007-10-20 19:35:53
c43ff43601201e17be8882ee199542282f1531eb...dec2b4aaa87ab2b33d1ad8294872af1f1397ec7e,1,127,235,362,205,2007-10-23 04:28:35,2007-10-22 20:28:48
e52775f43857f377aa2aa69f82ac2d2f26dc6297...0623421b0beb5dc4bbe4eb598275e2a608226dec,1,0,2,2,1,2006-11-07 23:50:06,2006-11-07 10:44:33
562cefbdbfaeb92f91c961c67960a93a7772220c...0fb1eaa8850557249a8d1c43a4f0f3ac5a5f75ce,1,5,3,8,2,2006-12-04 22:24:28,2006-12-04 10:11:39
0fb1eaa8850557249a8d1c43a4f0f3ac5a5f75ce...49ed2bc4660c7cd0592cf21cc514080574d06320,1,2,1,3,1,2006-12-06 18:47:14,2006-12-05 03:44:40
c06c79667c9514aed00d29bcd80bd0cee7cc5a25...2821104db7fabdfac105ae757228b0eac107047c,2,11,6,17,6,2006-03-13 01:26:32,2006-03-13 00:39:51
f5ef535ff571d80d230ea4706edad215f1fbc96f...451d7b47f1ba380b4f8e32b28052fff06eeb8638,1,2,1,3,2,2006-03-18 22:01:37,2006-03-18 10:27:45
451d7b47f1ba380b4f8e32b28052fff06eeb8638...f81e7c626f34658289594386b0273755f47912a2,1,9,2,11,3,2006-03-18 22:01:46,2006-03-18 10:07:12
79f558a5fc1c471e5db926a1272fe930f24784bb...7561d9f54412fcf443ebb28040bad67cd054a986,1,6,3,9,1,2006-03-25 06:23:25,2006-03-25 06:23:25
7561d9f54412fcf443ebb28040bad67cd054a986...6250ad1e7aacbcb9a2a8944e0c664f1e7ec93ef6,3,42,13,55,8,2006-03-25 06:24:02,2006-03-25 03:21:07
6250ad1e7aacbcb9a2a8944e0c664f1e7ec93ef6...6a1640ffc6431d66fa33c8256fd19b5ee0bc1b47,1,0,4,4,1,2006-03-25 06:24:06,2006-03-25 03:27:13
6a1640ffc6431d66fa33c8256fd19b5ee0bc1b47...c150462824008957f568ca7aa05a65b35d860eb9,1,3,1,4,2,2006-03-26 00:34:05,2006-03-25 21:28:28
9af0b8dbe2fb252262412a11254e2bcc6ffb87bb...61678d87c2aad3bd668196993d8c32f298ddf5ff,1,0,1,1,1,2006-04-27 08:59:00,2006-04-27 08:59:00
61678d87c2aad3bd668196993d8c32f298ddf5ff...83aa18eade572679319406d6dc12a81599a4d57e,2,1,1,2,2,2006-04-27 18:45:39,2006-04-27 16:02:54
e7afa1115beb071512ac2b8d6b7487eadbfccc74...497c32136f80aca5f724bf70c2a0f44b63cb79f1,1,1,0,1,1,2006-04-27 05:05:05,2006-04-27 05:05:05
497c32136f80aca5f724bf70c2a0f44b63cb79f1...b34c39cf31e370dad3bcfba29ee8cd023c40fd6b,1,13,4,17,9,2006-04-27 07:34:12,2006-04-27 07:13:34
b34c39cf31e370dad3bcfba29ee8cd023c40fd6b...7927a55d5bde25702dca4fb1a7d6eb7ef61110ba,3,54,3,57,6,2006-04-27 08:33:07,2006-04-27 08:33:07
bd346f105dc6f343eb577e4b25dbc1fa098cff33...9a8b6a0a9d4de3d9c1005b872b9b57a213d3e9f8,1,6,6,12,4,2006-04-28 02:31:46,2006-04-28 02:31:46
e431e4cd7d4f496ceefc374c7c922d8ff1d910bd...b8c59e6ad30697e7313b28ec0f7c7c9f1e4c7b5e,7,0,521,521,8,2006-04-27 19:48:26,2006-04-27 19:48:26
b8c59e6ad30697e7313b28ec0f7c7c9f1e4c7b5e...bc4d7269f9dc021755a54efc868eba8eb820d2fe,1,0,1,1,1,2006-04-27 19:50:01,2006-04-27 19:50:01
1ab661ddb7eb564c1c3cb97a512257860a651459...7d09fbe4ab7f080a8f8f5dcef7e0f3edf5e26019,1,1,1,2,1,2006-04-25 06:07:54,2006-04-18 13:11:06
7d09fbe4ab7f080a8f8f5dcef7e0f3edf5e26019...b176e6ba5bc37466ffcb6c8c0f38c47ec6e9e73a,1,1,1,2,1,2006-04-26 19:16:19,2006-04-26 19:07:42
b176e6ba5bc37466ffcb6c8c0f38c47ec6e9e73a...e23d0b4a4a55cc07e133905f0e9526b3550dd61b,4,29,18,47,8,2006-04-26 19:16:21,2006-04-26 17:15:54
e23d0b4a4a55cc07e133905f0e9526b3550dd61b...5981e09999e90b389a02843671529a0faaf72143,1,5,6,11,3,2006-04-26 23:55:25,2006-04-26 23:55:25
285755127a1ce800ce6a95516a37dd342c57c562...70827b15bfb11f7aea52c6995956be9d149233e1,5,342,305,647,11,2006-04-21 20:14:41,2006-04-21 17:27:34
e64961b0573b0e72bd55eab6d36bd97f859f9516...1af1c2b63db6a413fbeb9b08cd55dcb735d7597d,2,31,9,40,11,2006-04-23 23:57:40,2006-04-23 23:52:08
1af1c2b63db6a413fbeb9b08cd55dcb735d7597d...749864627c2d3c33bbc56d7ba0b5542af698cc40,3,549,1,550,3,2006-04-24 03:18:16,2006-04-23 23:52:20
749864627c2d3c33bbc56d7ba0b5542af698cc40...a52139b47e505e74e23a02f5324485e11dfe4ef9,1,12,125,137,8,2006-04-24 03:18:57,2006-04-23 23:52:35
a52139b47e505e74e23a02f5324485e11dfe4ef9...03ac6e64651e4b5ca0c2164a23b5f345f2c03af4,1,13,3,16,9,2006-04-24 03:19:17,2006-04-23 23:52:52
03ac6e64651e4b5ca0c2164a23b5f345f2c03af4...a6e5642f39db2113785c4f22add7e16d559b8d55,1,21,2,23,11,2006-04-24 07:26:31,2006-04-24 07:23:54
e64961b0573b0e72bd55eab6d36bd97f859f9516...227bdb186f06fa65afb1a0e091b2b191132c29ba,1,16,7,23,9,2006-04-23 07:47:03,2006-04-23 07:01:29
e64961b0573b0e72bd55eab6d36bd97f859f9516...6973dcaee76ef7b7bfcabd2f26e76205aae07858,7,1929,1953,3882,43,2006-04-22 09:37:45,2006-04-22 06:57:45
6973dcaee76ef7b7bfcabd2f26e76205aae07858...e09ad6e1e3308fde346b4b6287d9441363806832,4,231,238,469,16,2006-04-22 09:43:00,2006-04-22 09:43:00
e64961b0573b0e72bd55eab6d36bd97f859f9516...96ab4f4e7a0fac1992a1f27ad2dc1106db09a5de,1,2,1,3,1,2006-04-22 05:24:34,2006-04-22 02:39:04
e64961b0573b0e72bd55eab6d36bd97f859f9516...96afa0764e6b58a38b21befded2c8fd0543fab2a,2,198,0,198,2,2006-04-22 05:24:30,2006-04-12 06:05:14
91efcf60653b2538b05625807293b97c07cb04f4...53f420ef00ca6cc3554084c4c9fb89f50c634f58,1,3,2,5,1,2006-04-22 10:06:13,2006-04-22 10:06:13
42b5c78845feb44f1d36eecad4c72336d5c2a9c5...5069b1cf6177f837830dd3ac402bee4f3d088fa5,1,1,1,2,1,2006-04-15 10:22:00,2006-04-15 10:22:00
42b5c78845feb44f1d36eecad4c72336d5c2a9c5...fd2bbdd2386ea0c558aba95711ef53c4552a6146,7,521,0,521,8,2006-04-15 09:11:52,2006-04-15 08:32:39
afcb536f288f28bb37acf11a5666a219b8f20200...cd2bdc5309461034e5cc58e1d3e87535ed9e093b,6,218,227,445,53,2006-04-15 04:56:55,2006-04-14 23:52:13
cd2bdc5309461034e5cc58e1d3e87535ed9e093b...8e8f998739db6526fe890fabc88c866759bc2ac3,3,7,0,7,4,2006-04-15 05:42:31,2006-04-15 05:19:38
8e8f998739db6526fe890fabc88c866759bc2ac3...8c1f0b44c59530dea8007a9f5b69d0fac6aea3b1,1,4,2,6,1,2006-04-15 05:43:34,2006-04-15 05:43:34
441c823e892ba7408e87d26b6e77def5975c1c60...1d84a60459a32fb1707ff7de4a013b5d9673f55d,2,522,0,522,2,2006-06-06 05:17:26,2006-05-24 22:04:38
1d84a60459a32fb1707ff7de4a013b5d9673f55d...16cee38ae2bff93a4e4c512550fb4ccac035a3a1,1,5,5,10,5,2006-06-06 05:36:21,2006-06-06 05:36:21
441c823e892ba7408e87d26b6e77def5975c1c60...2b11e3170e919866c7f5554dd4089289a1bb6726,1,111,0,111,4,2006-06-06 00:49:17,2006-06-05 17:43:52
2b11e3170e919866c7f5554dd4089289a1bb6726...a025463bc0ec2c894a88f2dfb44cf88ba71bb712,1,14,6,20,5,2006-06-06 01:09:40,2006-06-06 01:09:40
e96fd30553bb57a76ad38f703a3fea5b53c45ff9...ad9c18f5045281ddd109c54451f1b4ebfb0d3567,1,6,4,10,5,2006-06-06 07:05:56,2006-06-06 07:05:56
5024baa43790bf0ea12905b47c8922e3b256ae61...27cb61ca14c05303d8aad2f17136f2e9f0c5fd2b,1,1,1,2,1,2007-02-14 21:54:34,2007-02-14 21:54:34
27cb61ca14c05303d8aad2f17136f2e9f0c5fd2b...40b87ff8777a9827c544bc572d656e8a1a041a39,1,4,4,8,4,2007-02-14 21:57:14,2007-02-01 13:44:46
40b87ff8777a9827c544bc572d656e8a1a041a39...e9937d2a03a426b50a424927fbd0cdfbe2ac2b40,1,150,126,276,50,2007-02-14 21:57:14,2007-02-01 13:46:38
e9937d2a03a426b50a424927fbd0cdfbe2ac2b40...7426eb74694b2f8b3909065edeec35b7a9117b35,1,2,2,4,2,2007-02-14 22:01:59,2007-01-30 05:53:28
7426eb74694b2f8b3909065edeec35b7a9117b35...b6047c5a8166a71e01c6b63ebbb67c6894d95114,1,6,5,11,4,2007-02-14 22:12:53,2007-02-09 03:22:24
b6047c5a8166a71e01c6b63ebbb67c6894d95114...9ca72f4f60269fb6328bc9c4034d19b9479637ea,1,13,10,23,9,2007-02-14 22:13:14,2007-02-13 00:19:34
fd60acaced6de16ebfb66959067e2b29f99a133e...c2f493a4ae159ef99b20be490ae603cd13bab4eb,1,106,72,178,14,2006-05-07 22:41:35,2006-05-07 18:19:21
c2f493a4ae159ef99b20be490ae603cd13bab4eb...dd05ea1799656024a45017238bbd4857b5256370,1,105,0,105,1,2006-05-07 22:41:35,2006-05-07 18:19:47
dd05ea1799656024a45017238bbd4857b5256370...0438402271cccc1711c603b0a7ba3134f1ce30f1,1,1,5,6,1,2006-05-07 22:41:35,2006-05-07 18:19:33
7f7e6eacf999cb53771426e561589f721e6c9974...06918348de86774d0fad19c7076747b8182d1c74,1,6,2,8,4,2006-05-23 07:29:35,2006-05-22 11:38:08
06918348de86774d0fad19c7076747b8182d1c74...4adcea995e97361d0900aaf27c60fad0b03b9ad1,1,5,1,6,2,2006-05-23 07:31:36,2006-05-23 02:28:37
4adcea995e97361d0900aaf27c60fad0b03b9ad1...443f8338b9e248353a7095a1096684f1ed106c66,1,14,3,17,6,2006-05-23 07:36:51,2006-05-22 21:02:06
443f8338b9e248353a7095a1096684f1ed106c66...6a1871e174fee1757713df7a3d776dd3813e7ad8,1,13,23,36,1,2006-05-23 07:41:39,2006-05-23 07:27:45
6a1871e174fee1757713df7a3d776dd3813e7ad8...e73aefe4fdba0d161d9878642c69b40d83a0204c,1,64,86,150,20,2006-05-23 07:50:50,2006-05-23 07:27:46
e73aefe4fdba0d161d9878642c69b40d83a0204c...55cad8429954c7d08d0ce86155e7f9adf2f4c6ad,1,19,17,36,3,2006-05-23 08:16:08,2006-05-23 08:08:58
55cad8429954c7d08d0ce86155e7f9adf2f4c6ad...405053d2d98c613d028795df439de657981e0711,1,1,0,1,1,2006-05-23 08:26:21,2006-05-22 13:46:25
7f7e6eacf999cb53771426e561589f721e6c9974...07001f95a60149619bed62af7ad59052ace7ac92,1,2,2,4,2,2006-05-23 01:52:58,2006-05-20 22:46:33
d177e584255aad351bbbff14aba8e73afc008c75...878ccb26941a15312b6676372e4688d42a73882b,1,3,3,6,3,2006-05-29 02:24:28,2006-05-29 02:24:28
878ccb26941a15312b6676372e4688d42a73882b...7d65848afd42f075f6db0d03da2c9f5a9bac6267,1,18,3,21,4,2006-05-29 02:39:49,2006-05-28 23:16:15
efbff23609654ac0542d3421d19eea8dbc1f80cd...cdd406e389bd6e0b2ad9394340a366c0c5ae27fc,1,72,7,79,7,2006-05-22 04:39:20,2006-05-16 09:29:42
cdd406e389bd6e0b2ad9394340a366c0c5ae27fc...c831da664799eb4dbf082a843c34c66889548768,1,15,2,17,4,2006-05-22 06:55:00,2006-05-22 06:55:00
709a9e5771ddb32995df6a0622e5d643baa4487a...5102349cc075e5452c4a438194aa433599f419bb,1,1,1,2,1,2006-02-19 18:23:17,2006-02-19 18:23:17
709a9e5771ddb32995df6a0622e5d643baa4487a...9a0e6731c632c841cd2de9dec0b9091b2f10c6fd,1,9,0,9,1,2006-02-19 07:42:03,2006-02-19 07:42:03
2b020455f92ea3c20a78005dd19e7a127bb5b481...a15f43312f6962959e8daa33df0cf5357852a4b8,1,1,0,1,1,2006-02-20 05:14:56,2006-02-20 05:14:56
8cb711c8a5f98c1556b320114d7cc65e498ee2ae...b867c7c23a42fbe9f261153a9814a5efbc071a29,2,22,2,24,8,2006-02-17 12:04:39,2006-02-17 12:04:39
b867c7c23a42fbe9f261153a9814a5efbc071a29...0c0fab2da43485f0a07f77d3e2a22124ff0b9d5b,1,44,0,44,1,2006-02-17 21:33:14,2006-02-17 21:33:14
0c0fab2da43485f0a07f77d3e2a22124ff0b9d5b...020e3c1ee6924edbcf61b6e401058fa06ddbd406,1,38,0,38,1,2006-02-17 21:34:13,2006-02-17 12:48:36
020e3c1ee6924edbcf61b6e401058fa06ddbd406...45d2b286acf4a1191e6199c41a034cb0677a0965,1,19,11,30,9,2006-02-18 00:15:26,2006-02-18 00:15:26
8cb711c8a5f98c1556b320114d7cc65e498ee2ae...a49dd05fd047f504a74fb053bb8ddbb9e4bd152b,3,332,58,390,23,2006-02-17 10:11:38,2006-02-16 01:34:29
a49dd05fd047f504a74fb053bb8ddbb9e4bd152b...ca5381d43e8595f592d8d7ecfc9bb0bfa5e52f6d,2,91,32,123,28,2006-02-17 10:11:38,2006-02-16 19:55:51
ca5381d43e8595f592d8d7ecfc9bb0bfa5e52f6d...cec2be76d9789b11c7f955b62dcad4b1050202af,2,16,7,23,6,2006-02-17 10:11:38,2006-02-16 19:57:18
39ba7d54649b35c943b026b54bff40cfa0153f3e...60ace8790f3cfba4fdc16e71e23c4f9c44ce9b44,3,32,1,33,4,2006-02-22 01:33:43,2006-02-21 23:33:49
60ace8790f3cfba4fdc16e71e23c4f9c44ce9b44...fab5de7936f0cc086836a38d2de4374c3df223b4,1,1,1,2,1,2006-02-22 02:13:32,2006-02-22 02:13:32
fab5de7936f0cc086836a38d2de4374c3df223b4...aa064743fa69e2806d5e0af1fab103baa6fa57cd,1,6,0,6,1,2006-02-22 06:11:50,2006-02-22 04:28:50
addafaf92eeb86033da91323d0d3ad7a496dae83...939aabbf7d108b5d6830bf5cd89abc910cc9ff27,1,7,2,9,6,2006-01-28 10:26:18,2006-01-28 10:09:08
939aabbf7d108b5d6830bf5cd89abc910cc9ff27...34801cab72e8262d2585f72f15b62a397f0c6c1a,3,73,3,76,5,2006-01-28 10:26:30,2006-01-28 10:19:22
1a5c3a01aad0d0f5d68ffcc1c33aafca9e253591...50f9a858ada10b3b57691a313a1c78b0bcbe5947,2,9,6,15,6,2006-02-01 00:07:01,2006-01-31 22:10:56
50f9a858ada10b3b57691a313a1c78b0bcbe5947...7ec57556b29c3ed42769c122228ee4621676b642,1,24,23,47,10,2006-02-01 00:07:02,2006-01-31 22:13:40
7ec57556b29c3ed42769c122228ee4621676b642...c8568e139ed2149fbfb7ef9a8d819d5b6b7c554f,3,29,7,36,16,2006-02-01 00:17:24,2006-01-31 19:06:55
c8568e139ed2149fbfb7ef9a8d819d5b6b7c554f...e36f8b6034f9df7e7b0aea912d1c8e850503623e,2,11,3,14,6,2006-02-01 00:22:01,2006-01-31 05:36:24
e36f8b6034f9df7e7b0aea912d1c8e850503623e...3af06987eb3c376e2f1cc6dfa9c9c510b9e228cf,2,25,0,25,2,2006-02-01 00:23:03,2006-01-30 00:26:40
3af06987eb3c376e2f1cc6dfa9c9c510b9e228cf...8233340ce6eb700eb2cd9c0fef4d1705997c499b,2,9,0,9,2,2006-02-01 00:23:03,2006-01-30 00:28:02
8233340ce6eb700eb2cd9c0fef4d1705997c499b...cb754fdf5a742a5479458da84d8f92bce2434ed5,1,5,5,10,5,2006-02-01 02:03:46,2006-02-01 02:00:37
cb754fdf5a742a5479458da84d8f92bce2434ed5...d9e2e12700e403ae5fc11193dd6e91546abd5809,1,16,9,25,5,2006-02-01 22:23:47,2006-02-01 15:53:31
d9e2e12700e403ae5fc11193dd6e91546abd5809...2d497115129bd84790f2c1cc8cf91f1598c9094a,1,1,1,2,1,2006-02-02 03:45:55,2006-02-01 02:03:37
2d497115129bd84790f2c1cc8cf91f1598c9094a...884944239f2ab673cedfaa5e7999d31fd6a46331,1,14,1,15,4,2006-02-02 03:47:26,2006-01-29 23:24:42
884944239f2ab673cedfaa5e7999d31fd6a46331...6a1f79c1f1a54f97f122a86c71837fb1f1408b67,2,4,0,4,2,2006-02-02 03:47:52,2006-01-31 23:40:33
6a1f79c1f1a54f97f122a86c71837fb1f1408b67...3c39e9bdebd68d8d45b3900bc21171642f4c6125,1,37,2,39,2,2006-02-02 10:02:20,2006-02-02 07:29:03
3c39e9bdebd68d8d45b3900bc21171642f4c6125...bf1c32bdec8223785c779779d0a660a099f69a63,1,33,69,102,5,2006-02-02 10:02:20,2006-02-02 08:12:55
bf1c32bdec8223785c779779d0a660a099f69a63...fd4b1d2193640009c9303daa784691fc5e102018,1,18,2,20,2,2006-02-02 10:02:20,2006-02-02 09:28:08
fd4b1d2193640009c9303daa784691fc5e102018...823bcd6edc7f7330714486b228b052953c2f4229,1,13,1,14,2,2006-02-02 13:21:14,2006-02-02 13:21:14
823bcd6edc7f7330714486b228b052953c2f4229...985cb9cc5851ae2f65acf74a8db5077b69cc2a9b,1,1,1,2,1,2006-02-02 19:28:38,2006-02-02 19:28:38
985cb9cc5851ae2f65acf74a8db5077b69cc2a9b...008bb6ea695e14740bfd14bec805cde6219b336e,1,21,10,31,8,2006-02-02 20:30:51,2006-02-02 11:43:20
008bb6ea695e14740bfd14bec805cde6219b336e...97f58b785d6c5c86b52a365b0086b5b098f5ee97,1,4,1,5,1,2006-02-02 20:30:51,2006-02-02 11:43:35
97f58b785d6c5c86b52a365b0086b5b098f5ee97...6bfb27a0c5d742306905ed9c0962ba3c0a091625,1,5,5,10,2,2006-02-03 01:52:19,2006-02-03 01:52:19
6bfb27a0c5d742306905ed9c0962ba3c0a091625...d366c7037679794edff38cdbc422997607aca5f1,1,1,1,2,1,2006-02-03 01:52:50,2006-02-02 16:56:06
d366c7037679794edff38cdbc422997607aca5f1...30d08b34aa268e3bd4c93fa712e2eac66f1a15b3,1,6,3,9,3,2006-02-03 01:52:51,2006-02-02 16:56:06
30d08b34aa268e3bd4c93fa712e2eac66f1a15b3...b469d8b6f7a8dd90527c43f345a1b5cf2e72f666,1,7,1,8,4,2006-02-03 01:53:25,2006-01-31 00:34:29
b469d8b6f7a8dd90527c43f345a1b5cf2e72f666...f16706cc59af32d0255e0a5ec9d04475bc976ede,1,59,11,70,16,2006-02-03 01:53:26,2006-01-31 06:33:15
f16706cc59af32d0255e0a5ec9d04475bc976ede...46dc941246af6e845eb7835afdb8cd20eed835b7,1,65,37,102,26,2006-02-03 01:53:26,2006-02-02 23:17:42
128a96c98442524c7f2eeef4757b1e48445f24ce...60786bd41a575126c0735c55b46e1d0ee2b358cc,1,1,1,2,1,2013-10-10 06:48:10,2013-09-30 14:46:14
60786bd41a575126c0735c55b46e1d0ee2b358cc...9ebeb3392b6dd674d738cfa019364f61ab73b925,1,1,1,2,1,2013-10-10 06:55:23,2013-09-29 23:45:57
9ebeb3392b6dd674d738cfa019364f61ab73b925...e618c3960a07ec411466ee5aa4e87ea091a72b94,1,2,2,4,1,2013-10-10 06:55:48,2013-09-29 23:45:58
e618c3960a07ec411466ee5aa4e87ea091a72b94...6fe7a30aec23eb8082f00b614dde3603b0754646,1,8,8,16,5,2013-10-10 06:56:05,2013-09-29 23:45:59
6fe7a30aec23eb8082f00b614dde3603b0754646...945b9c14ffd3e11c916ee2b2428a0b2be9645829,1,24,4,28,5,2013-10-10 06:56:12,2013-09-29 23:46:00
945b9c14ffd3e11c916ee2b2428a0b2be9645829...7091a2d0bfdea5a8e1c77027d746e06ae384bffa,1,25,10,35,8,2013-10-12 22:30:39,2013-10-11 12:57:05
7091a2d0bfdea5a8e1c77027d746e06ae384bffa...f849bb6b3b4ccc7cc1a68f49d6ff1e9c508fdf17,3,88,2,90,4,2013-10-12 22:30:53,2013-10-11 12:57:06
128a96c98442524c7f2eeef4757b1e48445f24ce...debce6ac2a5e11eae61a524fd6bb414312bb07a8,1,1,1,2,1,2013-09-24 19:18:24,2013-09-24 10:24:46
debce6ac2a5e11eae61a524fd6bb414312bb07a8...af1748b31eb68643f1b8d9d918f43611cf96d257,1,1,1,2,1,2013-09-24 19:26:49,2013-09-24 07:52:56
af1748b31eb68643f1b8d9d918f43611cf96d257...ccba805681b1b3c3ce4f053f20171b04ced2037a,1,1,2,3,1,2013-09-24 22:54:48,2013-09-24 22:33:36
128a96c98442524c7f2eeef4757b1e48445f24ce...e72aefc9ec144a21d78202b53ecd7ce115f5ec2b,1,0,13,13,2,2013-09-23 17:58:07,2013-09-23 05:07:57
e72aefc9ec144a21d78202b53ecd7ce115f5ec2b...083afc0ec0c0b3ec3a06cf96155eb5880f886293,1,0,10,10,1,2013-09-23 17:58:07,2013-09-23 05:07:58
083afc0ec0c0b3ec3a06cf96155eb5880f886293...4bc47cc009b82d89be3276fe5af3b03772e19c80,1,10,10,20,10,2013-10-16 16:34:26,2013-09-23 18:49:04
4bc47cc009b82d89be3276fe5af3b03772e19c80...18fe5add3385a5b41e294881992c1980dcf51ffd,1,9,9,18,9,2013-10-16 16:35:29,2013-09-23 18:49:05
18fe5add3385a5b41e294881992c1980dcf51ffd...7a6d6423c5a66589112f651a394b3a3ec076a7cf,1,1,1,2,1,2013-10-16 16:35:30,2013-09-23 18:49:06
7a6d6423c5a66589112f651a394b3a3ec076a7cf...fb2763746f2a4dcd63a5e4b389f8308e775684d8,1,1,1,2,1,2013-10-16 16:35:30,2013-09-23 18:49:07
fb2763746f2a4dcd63a5e4b389f8308e775684d8...73bbc0796b4ce65bfb1a12b47a0edc27845ecf50,1,1,1,2,1,2013-10-16 16:35:31,2013-09-23 18:49:08
73bbc0796b4ce65bfb1a12b47a0edc27845ecf50...ff55c47d0f737cd33594e864a0e5a5e1d32fdd13,2,5,2,7,3,2013-10-16 16:35:31,2013-09-23 18:49:09
ff55c47d0f737cd33594e864a0e5a5e1d32fdd13...8bb7a54c57d5bd8113886fc04be8d22d10337eef,1,3,11,14,4,2013-10-16 16:35:31,2013-09-23 18:49:10
8bb7a54c57d5bd8113886fc04be8d22d10337eef...9fe3e6cf9e5e3dbf8777dd78dbd27c44cfc4eb85,1,6,15,21,5,2013-10-16 16:35:31,2013-09-23 18:49:11
9fe3e6cf9e5e3dbf8777dd78dbd27c44cfc4eb85...da2727f23c68fb8cbda3cbd03e81141531166585,1,9,3,12,5,2013-10-16 16:35:32,2013-09-23 18:49:12
da2727f23c68fb8cbda3cbd03e81141531166585...68a65f5fe54c2b21bfe16ef3a0b48956ecf5658a,1,16,32,48,11,2013-10-16 16:35:32,2013-09-23 18:49:13
68a65f5fe54c2b21bfe16ef3a0b48956ecf5658a...3006297a0e45417e5988536bf5dbeb65ac7cce8d,1,4,29,33,6,2013-10-16 16:35:32,2013-09-23 18:49:14
3006297a0e45417e5988536bf5dbeb65ac7cce8d...81c57e2c9d99ced72bcc6b9633109dff73a04526,1,9,1,10,3,2013-10-16 16:35:33,2013-09-23 18:49:15
81c57e2c9d99ced72bcc6b9633109dff73a04526...5a3db110533b3b58002a03da837aa38fdc4bfc56,1,58,0,58,2,2013-10-16 16:35:33,2013-09-23 18:49:16
5a3db110533b3b58002a03da837aa38fdc4bfc56...15f7221686eac053902b906c278680b485c865ce,1,39,0,39,1,2013-10-16 16:35:33,2013-09-23 18:49:17
373c67da1df7fcd33593ca26e6d67f177152b21a...2db1a43f41880bb4aeea9dee8a7d13c5ad76db3f,5,44,5,49,8,2014-04-04 20:31:38,2014-03-28 10:00:43
2db1a43f41880bb4aeea9dee8a7d13c5ad76db3f...69e4b3426a608b4965c1cb0c6eab5252d880178b,1,12,1,13,2,2014-04-04 22:29:44,2014-04-02 06:39:17
ee34a2beadb94a9595f09af719e3c09b485ca797...64d3dc94687bf4a8a422ab6d5cffcdb44315d49e,2,2,2,4,2,2014-06-10 20:58:43,2014-06-10 20:08:38
64d3dc94687bf4a8a422ab6d5cffcdb44315d49e...3198b89fb225ef8e0200e9486a48be8068e85d15,2,22,2,24,5,2014-06-10 21:01:08,2014-06-10 20:09:23
3198b89fb225ef8e0200e9486a48be8068e85d15...d078d85bc3cd74bbe1f230feb26cbe28f29d6d25,1,6,6,12,6,2014-06-10 21:01:30,2014-06-10 20:10:07
35c141768c4c7c486017a2d0cc615b9384b4b672...44b96ecaa84b1de72a57e27143bf9aca75f251b9,1,1,1,2,1,2014-01-23 18:34:49,2014-01-23 01:27:52
44b96ecaa84b1de72a57e27143bf9aca75f251b9...aa8bd519dbf044f4b54a365c9c80c6eb9a1ee2ea,1,1,1,2,1,2014-01-23 18:34:51,2014-01-23 01:28:30
aa8bd519dbf044f4b54a365c9c80c6eb9a1ee2ea...b861e235bc68e1c085e48d029579afbeeeec995c,1,11,11,22,9,2014-01-23 18:34:53,2014-01-23 01:30:13
e230c568c4b9a991e3175e5f65171a566fd8e39c...b74cf648036af764a176898763a0ec066a77a92f,2,24,9,33,5,2013-10-30 17:33:46,2013-10-30 06:50:16
e230c568c4b9a991e3175e5f65171a566fd8e39c...7059dccc6c60a872a314b19ac17702065a71d6bd,3,11,3,14,5,2013-10-24 22:43:50,2013-10-24 08:52:36
7059dccc6c60a872a314b19ac17702065a71d6bd...0064053bd76ba385e1b5d51b6175bc17bc507804,4,6,11,17,5,2013-10-24 22:43:50,2013-10-24 08:53:01
0064053bd76ba385e1b5d51b6175bc17bc507804...5e7d4d3e932432131d0f8f4195e0061ecf644865,5,5,7,12,6,2013-10-24 22:43:50,2013-10-24 08:53:19
5e7d4d3e932432131d0f8f4195e0061ecf644865...683ff884cce955cc331929d857fac9d6bd69f46a,2,4,4,8,4,2013-10-24 22:43:50,2013-10-24 08:53:46
683ff884cce955cc331929d857fac9d6bd69f46a...367068e0dd1b7d6b5b4029749b326c6bad172498,2,2,4,6,2,2013-10-24 22:43:51,2013-10-24 08:54:01
367068e0dd1b7d6b5b4029749b326c6bad172498...3c62183929080c17299d5b404eb092e3d53c161a,1,4,4,8,3,2013-10-24 22:43:51,2013-10-24 08:54:53
e230c568c4b9a991e3175e5f65171a566fd8e39c...68b939b2f097b6675c4aaa178655559aa81b25cb,3,11,10,21,10,2013-09-18 20:34:12,2013-09-18 20:05:13
e230c568c4b9a991e3175e5f65171a566fd8e39c...a4dfee06806df64b7a44866f67f15b54567ec722,1,1,0,1,1,2013-09-18 04:45:34,2013-09-18 04:45:34
a4dfee06806df64b7a44866f67f15b54567ec722...a4d695de0dbaf41505cb6db44c6bb8290980398e,1,1,1,2,1,2013-09-18 04:50:02,2013-09-17 23:03:32
a4d695de0dbaf41505cb6db44c6bb8290980398e...7171d8c15f919c760d52f814a0aee1b1253385b1,1,43,5,48,9,2013-09-18 04:50:26,2013-09-17 23:17:33
7171d8c15f919c760d52f814a0aee1b1253385b1...5e7dcad771cb873e278a0571b46910d7c32e2f6c,1,1,0,1,1,2013-09-18 04:51:58,2013-09-17 23:21:33
5e7dcad771cb873e278a0571b46910d7c32e2f6c...5d54cffc36f654721302a717ff12fb317c1b494a,2,2,2,4,3,2013-09-18 04:52:06,2013-09-17 23:29:28
5d54cffc36f654721302a717ff12fb317c1b494a...a45b5f0552eec3c8800edae44e071cf1d647bf96,2,64,11,75,7,2013-09-18 04:58:46,2013-09-18 02:10:31
a45b5f0552eec3c8800edae44e071cf1d647bf96...8b2772220927a67d75948dd8758a406979505623,1,11,0,11,1,2013-09-18 04:58:59,2013-09-06 15:57:53
8b2772220927a67d75948dd8758a406979505623...2ecb573bb3aa9b409e2a74d82bee560ef77b101b,1,1,1,2,1,2013-10-22 18:34:23,2013-10-21 17:54:11
e230c568c4b9a991e3175e5f65171a566fd8e39c...77965f8b29f8311c42a0a770693dd0f8411e84db,1,10,10,20,2,2013-09-13 18:28:33,2013-09-13 11:03:00
e230c568c4b9a991e3175e5f65171a566fd8e39c...de2f95ebed260b5fb31942d6315994829fb6fc63,1,16,2,18,3,2013-09-12 19:05:48,2013-09-12 15:37:08
e230c568c4b9a991e3175e5f65171a566fd8e39c...5c25dfaa794c7bbfa1b4d234b10f94ee371b1db0,1,10,8,18,4,2013-09-12 18:45:03,2013-09-12 10:50:04
5c25dfaa794c7bbfa1b4d234b10f94ee371b1db0...6a964f57e52bb25d9233ff6d38c82a16f21f60aa,3,21,19,40,21,2013-09-12 18:45:10,2013-09-12 10:50:05
6a964f57e52bb25d9233ff6d38c82a16f21f60aa...ea9882bfc4d2850b65eac29ac5152e0d778a744b,1,6,0,6,1,2013-09-12 18:45:41,2013-09-12 10:50:06
e230c568c4b9a991e3175e5f65171a566fd8e39c...9f36c9b7f77f188db47b80ae1118856249beaa15,1,10,12,22,6,2013-09-11 19:25:33,2013-09-10 22:17:12
e230c568c4b9a991e3175e5f65171a566fd8e39c...44e1e4d67d5148c245db362cc48c3cc6c2ec82ca,3,109,2,111,5,2013-09-09 16:33:17,2013-09-09 13:47:43
44e1e4d67d5148c245db362cc48c3cc6c2ec82ca...28a81f8b93897402a8c8c15ee16e67f0c24ac11c,1,8,6,14,2,2013-09-19 17:15:06,2013-09-19 13:18:54
e230c568c4b9a991e3175e5f65171a566fd8e39c...1686e2cc87ff96c38ce4a9f77cd1d617d85f2a6c,1,4,4,8,2,2013-09-06 20:33:17,2013-09-06 17:43:04
1686e2cc87ff96c38ce4a9f77cd1d617d85f2a6c...bb7e32e383d66c290d11174108b2944532905df6,1,14,12,26,5,2013-09-06 20:33:17,2013-09-06 17:43:05
bb7e32e383d66c290d11174108b2944532905df6...3ba7407b8b7b7a75f720641327207d6cfdb163a2,3,32,20,52,5,2013-09-06 20:33:18,2013-09-06 17:43:06
3ba7407b8b7b7a75f720641327207d6cfdb163a2...2556b9962e7c0353d562b7bf70eed11d8f29d0b0,8,114,17,131,27,2013-09-06 20:33:18,2013-09-06 17:43:07
e230c568c4b9a991e3175e5f65171a566fd8e39c...277336a5e0341a5ae06fc330834dfeefe5e85cec,1,10,0,10,2,2013-09-06 20:25:12,2013-09-06 05:10:53
277336a5e0341a5ae06fc330834dfeefe5e85cec...160df71ef53b0ad645391ec7d5525eda33871d09,1,6,3,9,3,2013-09-06 20:25:21,2013-09-06 05:10:54
160df71ef53b0ad645391ec7d5525eda33871d09...3e625c8fec8a2ec49352e8f0a3862ccbfca11d3a,1,13,0,13,1,2013-09-06 20:29:38,2013-09-06 05:10:55
3e625c8fec8a2ec49352e8f0a3862ccbfca11d3a...11aec9556b1facd6272495690bd61995bd83547c,1,6,0,6,1,2013-09-06 20:29:44,2013-09-06 05:10:56
11aec9556b1facd6272495690bd61995bd83547c...b8fcce1e7f7baafba8b6ba0b4e9bec2f27893f43,1,16,0,16,2,2013-09-06 20:29:53,2013-09-06 05:10:57
b8fcce1e7f7baafba8b6ba0b4e9bec2f27893f43...ed0ff80984d37f9f40b1bf209bc86ea2fa8f3783,2,6,3,9,4,2013-09-06 20:32:24,2013-09-06 05:10:58
ed0ff80984d37f9f40b1bf209bc86ea2fa8f3783...b1ecd8cfdfc46bcb3d2c06cf0dbaf6d1ebe41e3c,1,4,4,8,4,2013-09-06 20:32:34,2013-09-06 05:10:59
b1ecd8cfdfc46bcb3d2c06cf0dbaf6d1ebe41e3c...907492534118a88d071676e78fe4bd1427189a37,1,1,0,1,1,2013-09-09 15:16:30,2013-09-08 12:10:44
e230c568c4b9a991e3175e5f65171a566fd8e39c...a316b954efb6d55f83c3950cfc2c7bbe356b5037,3,9,9,18,9,2013-09-04 22:30:03,2013-09-04 22:28:45
a316b954efb6d55f83c3950cfc2c7bbe356b5037...7a96c3864eea4e83b37fc3ab56a43e22243ff3db,2,2,2,4,2,2013-09-05 21:51:17,2013-09-05 21:51:17
e230c568c4b9a991e3175e5f65171a566fd8e39c...36a2a54dbf49b74519f6af1a672c9232e450f5f1,1,1,1,2,1,2013-09-04 22:02:25,2013-09-04 19:04:28
36a2a54dbf49b74519f6af1a672c9232e450f5f1...406fde17da450036acc35316c085e32bbd73ebc1,1,12,0,12,1,2013-09-04 22:02:35,2013-09-04 19:04:29
406fde17da450036acc35316c085e32bbd73ebc1...bb8040f9f9274d739b894230959134584b156ae5,6,8,8,16,8,2013-09-04 22:02:56,2013-09-04 19:04:30
bb8040f9f9274d739b894230959134584b156ae5...a8a5406ab32fccabf8ed08001d50b5373e18ff1a,23,63,63,126,54,2013-09-04 22:03:03,2013-09-04 19:04:31
a8a5406ab32fccabf8ed08001d50b5373e18ff1a...930f302cdbdd8410188fe306341117cd10af3383,1,12,3,15,1,2013-09-04 22:03:49,2013-09-04 19:04:32
930f302cdbdd8410188fe306341117cd10af3383...abdb54a1d26c79692468aaf2c651e85c2a917c15,1,8,4,12,1,2013-09-04 22:03:59,2013-09-04 19:04:33
abdb54a1d26c79692468aaf2c651e85c2a917c15...4b6acde54364d9350779eb470a1677aa78ed5bf4,1,14,4,18,1,2013-09-04 22:04:01,2013-09-04 19:04:34
e230c568c4b9a991e3175e5f65171a566fd8e39c...df17e77c0aacca35eaaac885fe70d97654c07d62,1,1,1,2,1,2013-09-04 17:35:25,2013-09-04 07:24:47
e230c568c4b9a991e3175e5f65171a566fd8e39c...75aa26d34c4a80142512bd980a416b0fb30044c1,3,12,0,12,3,2013-09-03 20:09:17,2013-09-03 19:50:16
75aa26d34c4a80142512bd980a416b0fb30044c1...c969b6a18d1cde3ffb8a5ca5cd45a57052c2cc95,1,4,4,8,4,2013-09-03 20:45:38,2013-09-03 20:27:30
e230c568c4b9a991e3175e5f65171a566fd8e39c...dfb1dc5c336f3fa709e32ce178525768713747f2,1,58,16,74,2,2013-09-03 19:54:43,2013-09-03 17:05:32
dfb1dc5c336f3fa709e32ce178525768713747f2...d8f7681337dd0c7944ba2293a72952110977077d,1,2,2,4,2,2013-09-03 19:54:52,2013-09-03 17:06:18
d8f7681337dd0c7944ba2293a72952110977077d...c812be9d81cf1fc587695d985bced50258b53d31,1,19,14,33,9,2013-09-03 19:55:30,2013-09-03 17:07:15
c812be9d81cf1fc587695d985bced50258b53d31...7495a17363de7397509710344e1c22f0918aceee,1,9,9,18,2,2013-09-03 20:01:40,2013-09-03 17:15:46
e230c568c4b9a991e3175e5f65171a566fd8e39c...1d844ee7bd386347f71b7d49e3be8df690b641b5,1,10,11,21,9,2013-09-03 19:39:17,2013-09-01 07:05:47
1d844ee7bd386347f71b7d49e3be8df690b641b5...3e9b9cb117feb6e3c942aab4c8e756568f4f0f06,1,38,30,68,4,2013-09-03 19:42:25,2013-09-01 07:05:48
e230c568c4b9a991e3175e5f65171a566fd8e39c...140cd84593d8aa794ef9c31b4128cb295cbb04e2,1,2,1,3,1,2013-09-03 19:14:26,2013-08-31 04:31:48
140cd84593d8aa794ef9c31b4128cb295cbb04e2...002ba0376b0836ff36f3ba1d079258ca94e66aca,1,1,1,2,1,2013-09-03 19:14:28,2013-08-31 04:31:49
002ba0376b0836ff36f3ba1d079258ca94e66aca...d0423ddd778a3699694cad326905bc755f7dd0dd,1,4,4,8,4,2013-09-03 19:14:29,2013-08-31 04:31:50
e230c568c4b9a991e3175e5f65171a566fd8e39c...cf99a761d3903dbaf8265f60da9eaee6a15a6fe6,4,9,7,16,8,2013-09-03 18:33:00,2013-09-02 06:34:29
cf99a761d3903dbaf8265f60da9eaee6a15a6fe6...9ba89f484e023827eca6ad44baf69af37dac4db3,5,45,0,45,8,2013-09-12 21:39:34,2013-09-02 06:34:30
e230c568c4b9a991e3175e5f65171a566fd8e39c...ed016612e6956496d5028e41f6414be29c09be4e,1,1,1,2,1,2013-09-03 17:36:12,2013-09-03 07:41:50
e230c568c4b9a991e3175e5f65171a566fd8e39c...e7b432c521b0177e86eaecd2bd16906b9fc53e10,2,51,2,53,12,2013-08-30 23:37:55,2013-08-30 23:37:55
e230c568c4b9a991e3175e5f65171a566fd8e39c...2be778a8ac557931c270fb09fa6b4b3c4ec0729c,1,2,2,4,2,2013-08-30 21:57:27,2013-08-30 18:11:59
2be778a8ac557931c270fb09fa6b4b3c4ec0729c...9bbb0fa1fdc6c413b1f35c26e090515e5d0096aa,11,17,13,30,13,2013-08-30 21:57:28,2013-08-30 18:12:00
9bbb0fa1fdc6c413b1f35c26e090515e5d0096aa...4738a33338b837d4896b5e8d75e777f5e99a25cb,1,24,6,30,5,2013-09-04 18:08:36,2013-09-04 15:22:40
4738a33338b837d4896b5e8d75e777f5e99a25cb...2ddb5d170ac5fa3568efecb001c4ff0af0580c0d,1,17,10,27,4,2013-09-04 18:09:09,2013-09-04 15:22:41
2ddb5d170ac5fa3568efecb001c4ff0af0580c0d...61cee0dbac84160ad4a1bcc2ecdb15761bd284fc,1,24,9,33,9,2013-09-04 18:09:55,2013-09-04 15:22:42
61cee0dbac84160ad4a1bcc2ecdb15761bd284fc...98aee92d5c9e5161a8c11b7666996e4ffffe80ab,2,120,0,120,3,2013-09-04 18:10:28,2013-09-04 15:22:43
98aee92d5c9e5161a8c11b7666996e4ffffe80ab...c750ba9519f7e25a22072578a80ac0eafb423ed1,2,304,2,306,9,2013-09-09 16:54:37,2013-09-09 13:22:32
c750ba9519f7e25a22072578a80ac0eafb423ed1...c6268bc0082e340633b7a785e6c7761cd54063cc,1,632,0,632,1,2013-09-11 17:38:26,2013-09-11 12:46:18
e230c568c4b9a991e3175e5f65171a566fd8e39c...45e8a7487339c0f0ea28244ef06851308d07387c,1,4,1,5,1,2013-08-30 21:53:45,2013-08-30 19:14:13
e230c568c4b9a991e3175e5f65171a566fd8e39c...21860882c8782771e99aa68fab6e365c628ff39d,2,874,718,1592,721,2013-08-30 08:59:29,2013-08-25 09:45:13
e230c568c4b9a991e3175e5f65171a566fd8e39c...a8c0b74718d9986aec758e4a834a2d7363b16f24,2,31,0,31,2,2013-08-29 18:39:45,2013-08-28 21:14:40
a8c0b74718d9986aec758e4a834a2d7363b16f24...a11b0ac9e17459c83d89844761ca0c132b4d324c,1,10,3,13,3,2013-08-29 18:40:51,2013-08-28 19:23:07
a11b0ac9e17459c83d89844761ca0c132b4d324c...0fdc9b093959a6a0037e898744f22c7604278d97,1,0,2,2,1,2013-08-29 18:40:52,2013-08-28 19:23:08
0fdc9b093959a6a0037e898744f22c7604278d97...8493fd14b27861d2f542fff38ea76c91ba2250bd,1,2,2,4,2,2013-08-29 18:40:54,2013-08-28 19:23:09
8493fd14b27861d2f542fff38ea76c91ba2250bd...2a6981833df11d82a956ab17f2284418b6eecafe,1,2,2,4,2,2013-08-29 18:40:55,2013-08-28 19:23:10
2a6981833df11d82a956ab17f2284418b6eecafe...670dda85d652cc1d2574de584fef9d3baeb0969d,2,3,3,6,3,2013-08-29 18:40:56,2013-08-28 19:23:11
670dda85d652cc1d2574de584fef9d3baeb0969d...641a2b5bee4c759c4dd36b5ad9e7f159aca54611,2,2,57,59,31,2013-08-29 18:40:57,2013-08-28 19:23:12
641a2b5bee4c759c4dd36b5ad9e7f159aca54611...c587d655122a287a6796d493d176128f05374156,1,34,1,35,8,2013-08-30 17:37:23,2013-08-29 22:29:50
c587d655122a287a6796d493d176128f05374156...ff867963f01ab9b5f1d27ef2e7b255fcb74281d5,4,248,226,474,204,2013-09-03 17:25:19,2013-08-29 21:10:04
ff867963f01ab9b5f1d27ef2e7b255fcb74281d5...5d21adcbfe5540b89831fef2a2581d54dee4d478,1,20,20,40,14,2013-09-03 17:25:58,2013-08-29 21:20:18
e230c568c4b9a991e3175e5f65171a566fd8e39c...333d7d37b680ca8259cee00aa0b8ac62cb228cd3,1,2,3,5,1,2013-08-27 22:14:41,2013-08-27 17:55:15
333d7d37b680ca8259cee00aa0b8ac62cb228cd3...95f9be556dad9e4a92bbfed30d5ef01a5fd9df3a,1,13,6,19,3,2013-08-27 22:14:42,2013-08-27 17:56:04
95f9be556dad9e4a92bbfed30d5ef01a5fd9df3a...3e65ac49e77283cf505b912c9a2b1bc05b7cd7a0,1,7,9,16,2,2013-08-27 22:14:43,2013-08-27 17:56:50
3e65ac49e77283cf505b912c9a2b1bc05b7cd7a0...a7bdee1122297442ac8eaaecf20db7363d48a14e,1,4,4,8,4,2013-08-27 22:14:43,2013-08-27 17:58:18
a7bdee1122297442ac8eaaecf20db7363d48a14e...ddd4ddef78163a0f01e7a727c69ba8bd4efc07c2,1,10,10,20,8,2013-08-27 22:14:44,2013-08-27 17:59:21
ddd4ddef78163a0f01e7a727c69ba8bd4efc07c2...d39765b12e1e1ab8e8a798466d942bd94063c39f,1,2,8,10,2,2013-08-27 22:14:44,2013-08-27 18:01:17
d39765b12e1e1ab8e8a798466d942bd94063c39f...df47da758e6c7e76f9011f53df1cfdaf3443de1c,1,8,12,20,6,2013-08-27 22:14:44,2013-08-27 18:02:08
df47da758e6c7e76f9011f53df1cfdaf3443de1c...e8e9964de489412aae2c9b8420d2fab8b00e9d12,1,13,14,27,4,2013-08-27 22:14:44,2013-08-27 18:03:09
e8e9964de489412aae2c9b8420d2fab8b00e9d12...e14c86156c86c3f547b5f92b5c9e91ea8b4dbc8c,1,0,2,2,1,2013-08-27 22:14:45,2013-08-27 18:04:08
e14c86156c86c3f547b5f92b5c9e91ea8b4dbc8c...381183fbc6c3fea1264e4fc6c977bf31cdfb812a,1,1,2,3,1,2013-08-27 22:14:45,2013-08-27 18:04:58
381183fbc6c3fea1264e4fc6c977bf31cdfb812a...ddeb817f25fea45dee5456c48d723e56b9f8991b,1,3,9,12,2,2013-08-27 22:14:46,2013-08-27 18:05:50
e230c568c4b9a991e3175e5f65171a566fd8e39c...92b0c8bed0d3f6ed5442e3ffa178413772faa31b,4,4,7,11,4,2013-08-27 14:41:32,2013-08-27 13:50:40
e230c568c4b9a991e3175e5f65171a566fd8e39c...3f36eb43059aef4ec0f40fd8cc7081c0a1a92c31,1,6,0,6,1,2013-08-26 16:31:04,2013-08-26 09:21:39
e230c568c4b9a991e3175e5f65171a566fd8e39c...0bb0c15533c52bfb6f7a5174265869b808faf7ee,1,1,1,2,1,2013-08-25 06:58:43,2013-08-24 04:01:44
0bb0c15533c52bfb6f7a5174265869b808faf7ee...a070221eed679f626fc1cc0e7ea07a1a12ac4626,1,41,35,76,35,2013-08-25 06:58:43,2013-08-24 20:13:32
a070221eed679f626fc1cc0e7ea07a1a12ac4626...c742f870ce29c145db57d7bc922bc0a4850a32a6,1,1,1,2,1,2013-08-25 06:58:44,2013-08-24 04:01:46
c742f870ce29c145db57d7bc922bc0a4850a32a6...95728f74b100a4feabb5c70c0e6d8bed9dc29451,1,24,7,31,6,2013-08-25 06:58:44,2013-08-24 20:34:14
b9cb07726a7a288244b585939850348f319e5e0c...da915939fd7523cd145ba280cc974d46aa792331,2,39,1,40,2,2010-01-19 01:08:59,2010-01-18 21:37:38
a130976b71f36c73fc6279fd02beb1f798d82487...c899a57c28ee7cf251f856b575128de21b5a9a12,2,23,1,24,2,2007-11-10 19:04:24,2007-11-10 16:47:54
c899a57c28ee7cf251f856b575128de21b5a9a12...570f32266943d3a96d7ed64844986d847209364d,1,10,5,15,3,2007-11-10 19:04:56,2007-11-10 14:17:25
570f32266943d3a96d7ed64844986d847209364d...05ee917a6eaa2a32e49221537e4632621d49b076,1,2,2,4,2,2007-11-11 22:37:03,2007-11-11 14:01:43
05ee917a6eaa2a32e49221537e4632621d49b076...1b2486d73789aaed0671e8d5cc60f5624d8e7ce5,3,9,2,11,6,2007-11-11 22:37:03,2007-11-11 14:01:44
fb5fd011482b5aa0b340a4a5bd9192c0efc1edb7...93cbbd7121c34b04576518b663f188c5495d4575,1,2,2,4,2,2007-11-14 20:08:15,2007-11-14 20:08:15
fb5fd011482b5aa0b340a4a5bd9192c0efc1edb7...4d1012c3709e356107d0fb0e3bf5a39e0d5c209d,4,59,3,62,6,2007-11-14 11:44:22,2007-11-11 23:35:23
913b45f51b151d8e29f86df67d3e10853d831470...29ab27f4b505dd6a56ded42ab2797c3e56f810b2,1,2,3,5,2,2007-12-14 20:00:42,2007-12-14 20:00:42
29ab27f4b505dd6a56ded42ab2797c3e56f810b2...71362bd55280bb0f4aa67f89435308a4b26213b5,1,61,33,94,9,2007-12-14 20:03:12,2007-12-14 11:28:14
71362bd55280bb0f4aa67f89435308a4b26213b5...38a5b1d6ed2ba632504be7748e63f1441c93976d,1,23,14,37,4,2007-12-14 20:06:04,2007-12-14 09:15:47
38a5b1d6ed2ba632504be7748e63f1441c93976d...12a6d752fb61b10194b2897defb2b34e09099b12,2,53,0,53,2,2007-12-14 20:06:23,2007-12-14 16:39:09
12a6d752fb61b10194b2897defb2b34e09099b12...1eb1e9eea480059d4fba171e74a4375b8191e3f3,2,18,1,19,2,2007-12-14 23:39:54,2007-12-14 19:57:22
1eb1e9eea480059d4fba171e74a4375b8191e3f3...896c0535afe2f00683f7d4e8171fad7ec156f16f,1,1,1,2,2,2007-12-15 04:34:56,2007-12-15 04:34:56
896c0535afe2f00683f7d4e8171fad7ec156f16f...69ae517541ed5ab7d4fdcd8f82a9b8bd949df347,1,5,5,10,3,2007-12-15 04:39:16,2007-12-15 04:39:16
69ae517541ed5ab7d4fdcd8f82a9b8bd949df347...cb891a5989c41ed479db9eb4b0a69cef8bb98ea8,1,38,53,91,15,2007-12-15 04:42:26,2007-12-14 20:59:58
cb891a5989c41ed479db9eb4b0a69cef8bb98ea8...3b683b91cd78dec027105a2810079eb0b27ab2c0,1,11,2,13,9,2007-12-15 05:31:58,2007-12-14 21:18:00
3b683b91cd78dec027105a2810079eb0b27ab2c0...a096bb18af5b7214d9b87b64ae733d106eb96544,2,6,4,10,4,2007-12-15 05:31:59,2007-12-14 21:18:01
a096bb18af5b7214d9b87b64ae733d106eb96544...c20f290808efb85fbc7a57e7bc6eddeb4a0208a8,1,0,7,7,3,2007-12-15 05:31:59,2007-12-10 21:36:07
c20f290808efb85fbc7a57e7bc6eddeb4a0208a8...02dc534fc6eb8a08c686b7cb2d979545853889d0,1,0,1,1,1,2007-12-15 05:31:59,2007-12-10 21:36:08
02dc534fc6eb8a08c686b7cb2d979545853889d0...e8dc37e0e30dbbed532b7471516d1ba5e6e08f27,3,13,26,39,3,2007-12-15 05:31:59,2007-12-10 21:36:09
e8dc37e0e30dbbed532b7471516d1ba5e6e08f27...028c2976389f70e7349bbfeeef0ed0a000d5e447,5,108,201,309,97,2007-12-15 05:31:59,2007-12-09 19:30:59
028c2976389f70e7349bbfeeef0ed0a000d5e447...3a462bc9ba8cc46dcd5e49ae884968e1921c265f,2,45,28,73,19,2007-12-15 05:31:59,2007-12-10 21:36:11
3a462bc9ba8cc46dcd5e49ae884968e1921c265f...d7e92806cdc5ca78c4db879c68f91c70ff9e1ade,4,89,163,252,8,2007-12-15 05:31:59,2007-12-10 23:08:25
913b45f51b151d8e29f86df67d3e10853d831470...62c64895cfcf3bbf34969a69fa96a631f7d5b14e,8,171,18,189,17,2007-12-14 07:05:42,2007-12-13 20:24:52
62c64895cfcf3bbf34969a69fa96a631f7d5b14e...da31b358fb39b32622c14343ffe157a765f3948b,7,26,28,54,12,2007-12-14 07:40:27,2007-12-14 07:40:27
da31b358fb39b32622c14343ffe157a765f3948b...c1795bb08aae9fb7e4dc1a01e292b85e59b1c640,5,139,164,303,13,2007-12-14 07:43:58,2007-12-13 13:32:29
c1795bb08aae9fb7e4dc1a01e292b85e59b1c640...45e2a4b2b0a07cda05dda08b47906100c4711e4e,2,3,4,7,2,2007-12-14 07:43:58,2007-12-13 13:32:30
45e2a4b2b0a07cda05dda08b47906100c4711e4e...f817546652812ad5f20a8ab4a4a7290a9759ac4e,1,70,20,90,20,2007-12-14 07:53:20,2007-12-13 13:32:31
f817546652812ad5f20a8ab4a4a7290a9759ac4e...420f4f04de9b3790da695918ac168d4115665d92,2,4,4,8,4,2007-12-15 04:51:58,2007-12-14 11:23:43
420f4f04de9b3790da695918ac168d4115665d92...5973a07937f2c64b595c6784b06eb4441c07b5ef,1,29,0,29,1,2007-12-15 04:52:26,2007-12-14 11:23:44
f4bb20cc99fe18ba0e7dd421f1d95a05c1cbbc93...e6dc8d60fbd2c84900a26545c5d360b0e202d95b,1,0,1,1,1,2007-10-01 08:59:22,2007-09-28 14:24:26
e6dc8d60fbd2c84900a26545c5d360b0e202d95b...0bdcac5666170547dc7882cc1d39b0481206074b,1,6,1,7,2,2007-10-01 08:59:29,2007-09-30 22:30:27
0bdcac5666170547dc7882cc1d39b0481206074b...5946d4ba8970f00bb62b2c9e8714264831034043,4,30,8,38,4,2007-10-01 09:07:47,2007-10-01 09:07:47
d794d9e70ebb8c767b04f25c03290ef305cd31ab...f8b6809d52992ad14d035bcf7c8d8cfe00ef45a0,2,27,1,28,2,2007-11-22 07:06:44,2007-11-22 07:06:44
d794d9e70ebb8c767b04f25c03290ef305cd31ab...8d92f24852420c425f3ee499d3c3be01be4dc15c,1,1,0,1,1,2007-11-22 04:11:11,2007-11-21 08:57:33
8d92f24852420c425f3ee499d3c3be01be4dc15c...b2b3ada7fc46f6e43f065718cd64940811cd50b3,1,64,32,96,14,2007-11-22 04:11:11,2007-11-21 06:43:17
b2b3ada7fc46f6e43f065718cd64940811cd50b3...e6fefa926de3fcc1f0424e1b901347379ed51935,3,413,0,413,7,2007-11-22 04:11:11,2007-11-21 19:57:18
e6fefa926de3fcc1f0424e1b901347379ed51935...8b014d7157d29ce76b0f631e19c6e2ce9aeb2366,3,102,3,105,22,2007-11-22 04:11:11,2007-11-21 19:57:19
8b014d7157d29ce76b0f631e19c6e2ce9aeb2366...a5460eb7bb3ccef599adce87a620a3b89c7eb5df,1,23,3,26,3,2007-11-22 04:11:11,2007-11-22 02:20:57
ab7d70766963e1e854a1edcbb0b840242330a7cb...c7015961998a2061ad57a2a83ead009443d912f0,1,42,0,42,1,2007-12-05 05:58:42,2007-12-05 05:58:42
c7015961998a2061ad57a2a83ead009443d912f0...7a4a2e1f797724ce15b059f55ce57eab0e6be807,1,1,0,1,1,2007-12-05 06:03:42,2007-12-01 09:49:22
65c6a4696a760f518c9f262705de030323c11146...f4dd334bff85a203f71b3dfd086d8fd523db41ec,1,18,17,35,2,2007-12-01 07:29:27,2007-11-24 13:47:56
f4dd334bff85a203f71b3dfd086d8fd523db41ec...70ae04e4e8ef49ede31b77ca0e70c641dfff6d01,1,30,7,37,9,2007-12-01 07:32:51,2007-11-22 13:44:42
70ae04e4e8ef49ede31b77ca0e70c641dfff6d01...8d7c4fad3ff6b3f675568adab9ddf77e9fcf8b8a,1,9,14,23,10,2007-12-01 07:32:51,2007-11-22 19:18:00
8d7c4fad3ff6b3f675568adab9ddf77e9fcf8b8a...2d8797921511b141a6d1b2f74f763f5e9197cc40,1,18,0,18,2,2007-12-01 07:32:51,2007-11-19 22:56:15
2d8797921511b141a6d1b2f74f763f5e9197cc40...cec0d5a3bbde60db4589d8e84a36d0ade653472e,1,2,0,2,1,2007-12-01 07:32:51,2007-11-29 19:54:39
afcc4f7767ad8a2daac1c816fad02c890b0d2b99...13aba1e514c1dceee9d731d157bbc261426be351,2,38,3,41,3,2007-12-03 08:25:26,2007-12-03 07:24:50
13aba1e514c1dceee9d731d157bbc261426be351...36863af16e91aebc87696209f4f4780cf4c4059f,3,24,4,28,6,2007-12-03 08:36:49,2007-12-03 08:03:10
36863af16e91aebc87696209f4f4780cf4c4059f...17ef10d0558d9622884e5b5930cee2569e40a4e4,1,3,3,6,1,2007-12-03 21:35:26,2007-12-03 21:35:26
17ef10d0558d9622884e5b5930cee2569e40a4e4...0f6f195b771eb09beda59bb29d3a1c46454085e8,4,53,3,56,4,2007-12-04 06:11:38,2007-12-04 05:44:29
41188dd1a837df08a959b63a2f56357971fa4549...208320de8044acea5f637dd64475c3756d899094,1,1,1,2,1,2007-11-22 21:02:09,2007-11-22 15:20:08
208320de8044acea5f637dd64475c3756d899094...b53a191901db588fe0a2665d2a740e07de2b3e39,2,261,216,477,192,2007-11-22 21:04:10,2007-11-22 10:46:21
b53a191901db588fe0a2665d2a740e07de2b3e39...aa7db347788f7ae52924bd0332a45138bd16986a,1,221,183,404,159,2007-11-27 02:09:47,2007-11-24 09:56:32
aa7db347788f7ae52924bd0332a45138bd16986a...6f4ec3aa29450f4fa5af3cd8f6593d46d80aa909,1,167,141,308,133,2007-11-27 02:09:52,2007-11-24 09:56:42
6f4ec3aa29450f4fa5af3cd8f6593d46d80aa909...54051102004addb6021a527be17b124c00d1482a,1,1,1,2,1,2007-12-03 03:49:36,2007-12-03 01:26:33
54051102004addb6021a527be17b124c00d1482a...74521eee4c9d4c3812b83839d0d98dff72209837,1,6,6,12,6,2007-12-03 04:04:02,2007-12-01 17:05:40
74521eee4c9d4c3812b83839d0d98dff72209837...cbd9ac9a713d678a8409f70434ed3d326d7c5235,1,0,0,0,0,2007-12-03 04:05:10,2007-11-27 15:25:24
cbd9ac9a713d678a8409f70434ed3d326d7c5235...e360bebf713b6b03768c62de8b94ddf9350b0953,1,229,189,418,162,2007-12-05 23:54:10,2007-12-05 09:24:26
e360bebf713b6b03768c62de8b94ddf9350b0953...cfb5e104423b51aefb4d0e21a093bd9373b0af0b,1,362,320,682,268,2007-12-05 23:55:25,2007-12-04 00:28:42
2ee52eb17c26323b3f62538a44510aae75f09d6f...59b2023fbb154bc4671782955daddf8ef3018c93,1,2,1,3,1,2007-10-25 01:47:50,2007-10-24 11:49:51
59b2023fbb154bc4671782955daddf8ef3018c93...d1a2057560b33c926ba481618105edbb65d2c91c,1,1,5,6,2,2007-10-26 23:44:45,2007-10-25 20:17:24
0623421b0beb5dc4bbe4eb598275e2a608226dec...916d081bbaa40617643b09b6dc9c6760993cf6ed,1,12,9,21,4,2006-11-09 17:33:53,2006-11-09 12:52:05
49ed2bc4660c7cd0592cf21cc514080574d06320...4f88d3e0cbf443cd309c2c881209f3366f14023d,1,1,0,1,1,2006-12-07 05:47:19,2006-12-07 03:38:50
2821104db7fabdfac105ae757228b0eac107047c...fc66d213f8b2f13b9ffd643f01de25ddc95e0972,1,8,1,9,2,2006-03-13 04:42:12,2006-03-13 04:32:06
f81e7c626f34658289594386b0273755f47912a2...9de83169d34825d617b7fe92b95c966d9910848d,1,13,16,29,5,2006-03-19 20:30:01,2006-03-19 09:05:22
9de83169d34825d617b7fe92b95c966d9910848d...75a8180d4b6939aca03b2c6320f128469abd5879,1,9,2,11,5,2006-03-19 20:30:07,2006-03-19 09:05:48
75a8180d4b6939aca03b2c6320f128469abd5879...2b1c0ef2e5d103efacb535f32fb142114490dc33,1,11,0,11,2,2006-03-19 20:30:14,2006-03-19 09:06:10
2b1c0ef2e5d103efacb535f32fb142114490dc33...67686d95044e56475669ff1306448e41a794a865,1,10,8,18,2,2006-03-19 21:43:42,2006-03-19 21:43:42
67686d95044e56475669ff1306448e41a794a865...ad52e7708dca3ea5c295867e844d9228d1a96f36,1,1,1,2,1,2006-03-20 00:38:24,2006-03-20 00:18:08
ad52e7708dca3ea5c295867e844d9228d1a96f36...fd662dd500cded4b04b1154dc77cc989a5ddc5b8,1,7,3,10,1,2006-03-20 07:54:45,2006-03-20 07:54:45
c150462824008957f568ca7aa05a65b35d860eb9...03823184247215fba1dd9c9c39659d08dea3bad7,1,63,46,109,27,2006-03-26 05:23:54,2006-03-26 02:52:31
c150462824008957f568ca7aa05a65b35d860eb9...72095d5c3779344de13c47a8b1cb163b2d94126e,1,1,2,3,1,2006-03-26 00:50:57,2006-03-25 10:43:31
72095d5c3779344de13c47a8b1cb163b2d94126e...4bc87a28be020a6bf7387161c65ea3d8e4a0228b,1,40,24,64,7,2006-03-26 01:41:06,2006-03-26 01:20:48
4bc87a28be020a6bf7387161c65ea3d8e4a0228b...a5370b16c34993c1d0f65171d5704244901e005b,1,3,2,5,3,2006-03-26 01:41:22,2006-03-25 11:01:01
a5370b16c34993c1d0f65171d5704244901e005b...567ffeb7722eefab3991cb894c96548b92b57cc2,1,13,3,16,5,2006-03-26 01:41:23,2006-03-26 00:47:12
c150462824008957f568ca7aa05a65b35d860eb9...3443546f6ef57fe28ea5cca232df8e400bfc3883,14,1820,8,1828,20,2006-03-26 00:49:58,2006-03-25 04:13:22
3443546f6ef57fe28ea5cca232df8e400bfc3883...621c53cc082299eaf69e9f2dc0274547c7d87fb0,1,10,2,12,3,2006-03-26 00:49:59,2006-03-25 15:56:03
621c53cc082299eaf69e9f2dc0274547c7d87fb0...3ce8f08944e614813c7dfb212a88b7c4e3b443bc,3,47,12,59,15,2006-03-26 00:50:00,2006-03-25 20:16:17
c150462824008957f568ca7aa05a65b35d860eb9...2c6df2d5d1894d8951895334d80735868c6ac253,1,4,3,7,3,2006-03-26 00:34:37,2006-03-25 22:21:02
2c6df2d5d1894d8951895334d80735868c6ac253...ae64bbc18c80bdad36c53336ba4f724ce128efca,2,155,18,173,6,2006-03-26 00:35:43,2006-03-25 22:21:03
ae64bbc18c80bdad36c53336ba4f724ce128efca...cb0c6df6f5e850875af28b47c5c94482a326293f,1,38,18,56,10,2006-03-26 00:36:54,2006-03-25 22:21:04
cb0c6df6f5e850875af28b47c5c94482a326293f...86da1c567da0421649cb1e8e999311012c764337,1,0,214,214,5,2006-03-26 00:37:08,2006-03-25 22:21:05
86da1c567da0421649cb1e8e999311012c764337...4c691724f175573a2dc4118782744cb0e852ab41,2,24,3,27,3,2006-03-26 00:40:34,2006-03-25 22:21:07
7927a55d5bde25702dca4fb1a7d6eb7ef61110ba...2956dd3bd7bd512aa8fce7e55d5eec1e56df99ab,3,17,7,24,7,2006-04-27 23:21:54,2006-04-27 23:21:54
2956dd3bd7bd512aa8fce7e55d5eec1e56df99ab...d2cb7c6e9303c082b406acc643018f51179e8b35,1,45,11,56,8,2006-04-27 23:22:45,2006-04-27 23:22:45
89719209f48fe7d9694710795b1ec1d5fd7ebfc0...65056021f2d2dcb7a72f05c5d6cbbd79a79b9d40,4,335,1,336,4,2006-04-29 06:20:52,2006-04-29 06:20:52
65056021f2d2dcb7a72f05c5d6cbbd79a79b9d40...0fe7c1de16f71312e6adac4b85bddf0d62a47168,4,79,26,105,20,2006-04-29 08:32:53,2006-04-29 08:24:49
9a8b6a0a9d4de3d9c1005b872b9b57a213d3e9f8...c74320872b445104fe5c265e60785d9d26d94cc5,4,126,1,127,4,2006-04-28 04:35:27,2006-04-27 22:37:18
5981e09999e90b389a02843671529a0faaf72143...55e1805dffeb5d2a8ccd717b2d07ca8887436a69,1,3,3,6,2,2006-04-27 22:42:17,2006-04-27 22:42:01
70827b15bfb11f7aea52c6995956be9d149233e1...08df61713c89be4086b1930ef6b9e46ccf38928d,1,2,0,2,1,2006-04-22 04:56:31,2006-04-22 04:56:13
a6e5642f39db2113785c4f22add7e16d559b8d55...17448209f5441718c69642871c85a80f00d12b43,3,36,0,36,3,2006-04-24 07:26:31,2006-04-24 03:20:25
17448209f5441718c69642871c85a80f00d12b43...dd0c34c46bdda0c20fd92d00516e711a4c9f7837,1,1,1,2,1,2006-04-24 22:12:42,2006-04-24 22:12:42
dd0c34c46bdda0c20fd92d00516e711a4c9f7837...bad68ec92410cf47dd001aa9b95d0f24c5f4bf77,10,147,150,297,57,2006-04-25 04:24:13,2006-04-25 04:18:58
e09ad6e1e3308fde346b4b6287d9441363806832...5c21ac0e7c475c82039ab604ee9d7d8430889346,3,12,6,18,5,2006-04-22 11:03:32,2006-04-22 10:58:04
53f420ef00ca6cc3554084c4c9fb89f50c634f58...2a3870432395e78c82a870bf1a177b8d5b8fbdf0,3,28,5,33,7,2006-05-01 08:44:33,2006-05-01 08:44:33
5069b1cf6177f837830dd3ac402bee4f3d088fa5...6f4780f9dfd3bc6b23f9ea66b3d49577e0a0c2f9,2,3,3,6,3,2006-04-15 21:06:42,2006-04-15 21:02:10
6f4780f9dfd3bc6b23f9ea66b3d49577e0a0c2f9...1cd95087c331e17c44a8b62f0614d55e621dcfd4,1,6,0,6,1,2006-04-16 01:17:46,2006-04-15 18:13:49
1cd95087c331e17c44a8b62f0614d55e621dcfd4...cbdda024049947366804d60bdc5e5fc3ab3ee3a5,1,17,4,21,6,2006-04-16 02:22:48,2006-04-16 01:38:32
cbdda024049947366804d60bdc5e5fc3ab3ee3a5...293532739415d287786a312ec10849723383796e,3,22,1,23,6,2006-04-16 02:30:27,2006-04-15 11:41:18
5069b1cf6177f837830dd3ac402bee4f3d088fa5...f4235f8b2ef875b85ead74ffa199d827f9ee9d8d,3,100,75,175,16,2006-04-15 10:24:33,2006-04-15 10:16:46
fd2bbdd2386ea0c558aba95711ef53c4552a6146...9a305b67f8055503a743e67f628400f094c169ee,3,39,24,63,9,2006-04-17 04:21:46,2006-04-17 04:07:32
9a305b67f8055503a743e67f628400f094c169ee...ca9de6cadfa55c9b00476112e2bb52fe20ab95e0,2,11,1,12,7,2006-04-17 05:03:01,2006-04-17 05:03:01
8c1f0b44c59530dea8007a9f5b69d0fac6aea3b1...6b9c58f4669b3832ed2830f0cb1a307ea6bc6063,5,6,5,11,7,2006-04-16 06:46:36,2006-04-16 06:46:36
6b9c58f4669b3832ed2830f0cb1a307ea6bc6063...7594c4b2d7cc81f806453402aefe1bf71ae6dd53,1,23,59,82,12,2006-04-16 06:48:27,2006-04-16 06:48:27
7594c4b2d7cc81f806453402aefe1bf71ae6dd53...5b84f4d87a1bd58c7540e9ea82ee3673ecddbad5,1,43,19,62,13,2006-04-16 07:07:41,2006-04-16 07:07:41
5b84f4d87a1bd58c7540e9ea82ee3673ecddbad5...ba1d45051e050cbcf68ccccacea86a4b6ecde731,3,24,0,24,5,2006-04-16 07:13:38,2006-04-15 19:09:56
8c1f0b44c59530dea8007a9f5b69d0fac6aea3b1...183df63940bf92ea626af64d0057165b8aad24f6,7,229,229,458,55,2006-04-15 08:59:40,2006-04-15 08:59:40
16cee38ae2bff93a4e4c512550fb4ccac035a3a1...efd0201684c6e9bf663811dc849590b8fe27b8b2,2,17,12,29,6,2006-06-06 21:16:43,2006-06-06 15:46:23
efd0201684c6e9bf663811dc849590b8fe27b8b2...b3ca4e4ebba6915ea534c4b82cfc5d6f10b4c283,2,14,1,15,13,2006-06-06 21:18:00,2006-06-06 16:41:32
b3ca4e4ebba6915ea534c4b82cfc5d6f10b4c283...dd8239f997962d94162790039b008acb6068a242,2,38,35,73,5,2006-06-06 21:26:57,2006-06-06 21:26:57
ad9c18f5045281ddd109c54451f1b4ebfb0d3567...09302e177e8dc789c03d9df3620e12e095b4acfb,1,1,1,2,1,2006-06-06 21:12:46,2006-06-06 21:12:46
9ca72f4f60269fb6328bc9c4034d19b9479637ea...e7a0919115ee15b21a557609c2268e24497c1059,1,2,0,2,2,2007-03-12 09:13:02,2007-02-23 20:36:34
45f75a0167b4a4693f2c6005bf7db231ca91ecc8...393e3b1910221da5a78f7f79a45507b5fde59b77,2,17,5,22,7,2006-05-08 23:40:45,2006-05-08 19:02:44
405053d2d98c613d028795df439de657981e0711...61efa5e300386978dd440716260c94e951a493b4,1,1,1,2,1,2006-05-23 23:30:39,2006-05-23 23:30:39
405053d2d98c613d028795df439de657981e0711...f8128cfb8d5892e76611d024a19c1ecdace9a39e,1,11,11,22,9,2006-05-23 21:00:15,2006-05-23 19:44:11
f8128cfb8d5892e76611d024a19c1ecdace9a39e...3350453014324e375cdca722b50e93cdd78894ed,1,5,7,12,3,2006-05-23 21:01:59,2006-05-23 19:45:37
3350453014324e375cdca722b50e93cdd78894ed...8b4525fb3c6d79bd3a64b8f441237a4095db4e22,1,22,36,58,23,2006-05-23 21:04:47,2006-05-23 19:47:28
8b4525fb3c6d79bd3a64b8f441237a4095db4e22...1f36bee67e604735bc48be7fc731a823e6c5807f,1,1,1,2,1,2006-05-23 21:07:42,2006-05-23 19:49:00
1f36bee67e604735bc48be7fc731a823e6c5807f...f30b20282babcd77bcadef70b4e36e24cd1f6d59,1,17,8,25,5,2006-05-23 21:08:32,2006-05-23 19:53:20
f30b20282babcd77bcadef70b4e36e24cd1f6d59...2dec02b1ecafc47d4031d0a68a94c775a6a9ff9e,1,5,4,9,4,2006-05-23 21:11:03,2006-05-23 19:58:36
405053d2d98c613d028795df439de657981e0711...e7332f96b32bedbc39ff6ff7e845c902056099f5,3,46,20,66,13,2006-05-23 20:38:29,2006-05-23 18:19:04
e7332f96b32bedbc39ff6ff7e845c902056099f5...cfba045930423551ec9936fa15cbea7c04a841cf,1,15,11,26,11,2006-05-23 20:38:29,2006-05-23 18:20:09
405053d2d98c613d028795df439de657981e0711...0864f26421b3c599b462bc867de948d14b268d76,4,8,5,13,7,2006-05-23 20:11:12,2006-05-23 12:15:29
0864f26421b3c599b462bc867de948d14b268d76...aae01bda7f6d3224cf6b2ce0aa9aa668ce35d0b7,4,9,6,15,8,2006-05-23 20:11:12,2006-05-23 12:15:30
aae01bda7f6d3224cf6b2ce0aa9aa668ce35d0b7...56d1398ad305498faf57d6e433f97ad393d7909e,4,10,5,15,7,2006-05-23 20:11:12,2006-05-23 12:15:31
56d1398ad305498faf57d6e433f97ad393d7909e...d147e501f37a596e73a430ce46f125f83e06aa07,4,8,5,13,7,2006-05-23 20:11:12,2006-05-23 12:15:32
d147e501f37a596e73a430ce46f125f83e06aa07...6d96ac18e52aca19ff1087ffa64e2d616cc75c6f,4,9,6,15,8,2006-05-23 20:11:12,2006-05-23 12:15:33
6d96ac18e52aca19ff1087ffa64e2d616cc75c6f...ac6245e31a359200b65bfdd910bba9a0fbe90c11,4,10,5,15,7,2006-05-23 20:11:13,2006-05-23 12:15:34
ac6245e31a359200b65bfdd910bba9a0fbe90c11...51ce34b9923d9b119ac53414584f80e05520abea,4,10,7,17,9,2006-05-23 20:11:13,2006-05-23 12:15:35
51ce34b9923d9b119ac53414584f80e05520abea...e8cc9cd98e2ecd7fd8bb03e725d470405c8e2b94,7,24,11,35,13,2006-05-23 20:11:13,2006-05-23 12:15:36
07001f95a60149619bed62af7ad59052ace7ac92...9094950d738176db2c0d9d7e4e3843c056a5d222,1,6,3,9,5,2006-06-01 01:24:05,2006-05-31 23:25:03
7d65848afd42f075f6db0d03da2c9f5a9bac6267...d2eafb76611670d7573f9409b0c727019fe50e18,6,36,34,70,25,2006-05-29 02:40:18,2006-05-28 22:07:07
d2eafb76611670d7573f9409b0c727019fe50e18...a755dfe45c10ccd9f180d3c267602ad18d127d6a,9,30,29,59,21,2006-05-29 02:40:18,2006-05-28 22:10:04
a755dfe45c10ccd9f180d3c267602ad18d127d6a...2522c13244c13fe3a9f0769ea6294dce08e6596c,1,20,13,33,7,2006-05-29 02:40:18,2006-05-28 22:11:28
2522c13244c13fe3a9f0769ea6294dce08e6596c...097dc3d8c32f4b85bf9701d5e1de98999ac25c1c,9,116,57,173,32,2006-05-29 02:40:18,2006-05-28 22:13:53
0a2586c807fadc4b13a741e693471765870f6bb4...e76abd701419b50937708cfec2f772d33057505e,1,4,7,11,6,2006-05-30 05:00:21,2006-05-30 05:00:21
45d2b286acf4a1191e6199c41a034cb0677a0965...0870321548806e85fbf1433a6e016fa3cc09d524,1,5,6,11,2,2006-02-18 09:22:39,2006-02-18 05:04:47
0870321548806e85fbf1433a6e016fa3cc09d524...c4d133a2b8501f0aded93fea147f0950db076ae1,1,1,1,2,1,2006-02-18 09:22:42,2006-02-18 08:24:50
45d2b286acf4a1191e6199c41a034cb0677a0965...8e1618f9612a78ea09b2a926797c781fe06027c9,1,1,1,2,1,2006-02-18 00:30:57,2006-02-17 14:22:45
8e1618f9612a78ea09b2a926797c781fe06027c9...5b5d4d9e1b31997b3179e6a253d47b7eea03d0fa,2,14,0,14,3,2006-02-18 00:32:41,2006-02-17 14:23:16
5b5d4d9e1b31997b3179e6a253d47b7eea03d0fa...289c4b36e336af5266b86d924ef0aa828e8e4841,1,10,0,10,1,2006-02-18 00:32:43,2006-02-17 14:23:41
cec2be76d9789b11c7f955b62dcad4b1050202af...e4c9327a77bd59e85d4b17a612e78977d68773ee,1,35,8,43,9,2006-02-18 05:48:48,2006-02-18 04:58:45
8cf828b43c3c1ee6d85622d155a1b0639842f66a...83f50539a9b1f18ccf0a4e1b84169eb4a24b3ea4,2,138,1,139,2,2006-02-21 08:50:05,2006-02-21 05:50:01
aa064743fa69e2806d5e0af1fab103baa6fa57cd...26125f6b9be8dac31f56bf3da60dfa0df6dc0b59,1,16,3,19,4,2006-02-22 19:16:38,2006-02-22 19:16:38
26125f6b9be8dac31f56bf3da60dfa0df6dc0b59...3f9ac8d259fb919e001671c5e403e5fceaabf0d8,3,332,58,390,23,2006-02-22 21:14:56,2006-02-16 01:34:29
3f9ac8d259fb919e001671c5e403e5fceaabf0d8...ab7cd7bb8c02dc40ca3a909653e8f56226f9e440,2,91,32,123,28,2006-02-22 21:14:57,2006-02-16 19:55:51
ab7cd7bb8c02dc40ca3a909653e8f56226f9e440...4181bda1567fc749623eac1c81c2b07c882d63b3,2,16,7,23,6,2006-02-22 21:14:57,2006-02-16 19:57:18
4181bda1567fc749623eac1c81c2b07c882d63b3...15b4d577ae2e0117b7b5a4add2217442a8458812,1,35,8,43,9,2006-02-22 21:14:57,2006-02-18 04:58:45
15b4d577ae2e0117b7b5a4add2217442a8458812...2fb4a21074cdd62ecdbb1fd491f743483275e2a4,1,14,0,14,2,2006-02-22 21:14:57,2006-02-18 09:20:06
2fb4a21074cdd62ecdbb1fd491f743483275e2a4...589e4f93c7fc31d73da3d0764c71d939c9332442,4,32,29,61,14,2006-02-22 21:14:57,2006-02-19 04:31:05
589e4f93c7fc31d73da3d0764c71d939c9332442...d64e6b04291e2313343866a6b206caf13313f1f9,4,13,1,14,6,2006-02-22 21:14:57,2006-02-19 04:51:26
d64e6b04291e2313343866a6b206caf13313f1f9...b2504a0d2ff5a51feb516f7732beb9549b5db454,1,25,31,56,16,2006-02-22 21:15:26,2006-02-22 21:00:08
b2504a0d2ff5a51feb516f7732beb9549b5db454...5e8dc750ee56d8c295ecd7478a6bd5d148cb7177,1,16,3,19,6,2006-02-22 22:51:58,2006-02-22 22:41:32
5e8dc750ee56d8c295ecd7478a6bd5d148cb7177...183bdb2cccff792f11fd9e825df67af446aff171,1,33,10,43,7,2006-02-23 00:02:59,2006-02-23 00:02:59
46dc941246af6e845eb7835afdb8cd20eed835b7...c0c74a88f9016dad4665a4f1d446cebb2bdb1968,1,1,1,2,1,2006-02-04 03:41:33,2006-02-04 03:41:33
c0c74a88f9016dad4665a4f1d446cebb2bdb1968...1fda3d557b7c9e19e008c3a3d77f1922341796d7,1,1,1,2,1,2006-02-04 07:33:20,2006-02-03 20:27:02
1fda3d557b7c9e19e008c3a3d77f1922341796d7...8361e1d4d343a33a60145129dcf8c08ec7de84f2,1,4,21,25,4,2006-02-04 07:35:14,2006-02-04 06:50:57
46dc941246af6e845eb7835afdb8cd20eed835b7...0601dbe1784901a43289ff1575d3b8db33a191e1,1,16,23,39,8,2006-02-03 07:49:44,2006-02-03 07:48:36
46dc941246af6e845eb7835afdb8cd20eed835b7...8fcf7f9af5ba629f56f491791ae46ad2e939f3b5,1,10,11,21,11,2006-02-03 01:54:24,2006-02-01 02:15:51
46dc941246af6e845eb7835afdb8cd20eed835b7...f7a3d33f0f93eba4db61819b289df76a32d61b1b,1,4,4,8,5,2006-02-03 01:53:26,2006-02-03 01:43:47
ccba805681b1b3c3ce4f053f20171b04ced2037a...7c801fbc74d4c4687ea6db60e24a67f896767824,1,110,33,143,7,2013-11-27 20:16:49,2013-11-22 16:29:16
69e4b3426a608b4965c1cb0c6eab5252d880178b...68f4e1fc6abd332726dd281c76dd63ce7d13d7a1,1,1,1,2,1,2014-04-22 23:21:16,2014-04-22 22:53:02
d078d85bc3cd74bbe1f230feb26cbe28f29d6d25...15a906c5e99fc34534fd40d61590da142dee71d2,1,0,4,4,1,2014-06-10 21:01:53,2014-06-10 20:19:13
15a906c5e99fc34534fd40d61590da142dee71d2...2bed2d47b4394bd6d4ae4645be9f7424009d3c9c,1,4,5,9,3,2014-06-10 21:04:06,2014-06-10 20:19:38
2bed2d47b4394bd6d4ae4645be9f7424009d3c9c...71d76cb48029c94af022ea9dc9c74b4ba8bcc3a3,5,17,10,27,6,2014-06-10 21:05:19,2014-06-10 20:20:30
71d76cb48029c94af022ea9dc9c74b4ba8bcc3a3...2d0174e38eed8143b1df0584a6c038fdaee5b89b,1,1,1,2,1,2014-06-12 20:53:45,2014-06-11 06:32:45
b861e235bc68e1c085e48d029579afbeeeec995c...9d7fbfd20422cd23fdb346ac8d609b45b4d37001,1,2,2,4,2,2014-02-05 19:58:49,2014-02-02 15:09:56
68b939b2f097b6675c4aaa178655559aa81b25cb...9e10e0b9a01cf2f611f1ef2330e27a0822cf3de6,1,1,2,3,1,2014-06-09 19:06:12,2014-06-05 21:36:21
68b939b2f097b6675c4aaa178655559aa81b25cb...2856cbf0ae604c233e7dc62ba7931a469165ce4f,2,4,3,7,3,2013-09-18 20:34:46,2013-09-18 20:06:50
2856cbf0ae604c233e7dc62ba7931a469165ce4f...643f918d13906cbccdc5ad188767fc7895e30fc1,2,18,16,34,7,2013-09-18 21:36:40,2013-09-18 20:35:13
c4125fccb4c310b440ef6b0d4ed3c8cb651e1afa...360a3261a471ee59760b0743bbb27d3a60849ae2,1,1,2,3,1,2013-10-22 18:38:53,2013-10-21 17:54:12
2556b9962e7c0353d562b7bf70eed11d8f29d0b0...22d55aee2092418db9158589efbd9c8c9092d3fc,1,1,1,2,1,2014-03-21 18:00:46,2014-03-21 14:10:18
2556b9962e7c0353d562b7bf70eed11d8f29d0b0...1c7969c933c08a1a9d5b6fcd728ed95930b5b5ef,3,793,813,1606,76,2013-09-06 20:33:18,2013-09-06 17:43:08
1c7969c933c08a1a9d5b6fcd728ed95930b5b5ef...2f0f7f1ce7431a6484506c8c89d5d4648e6aefd4,2,24,1,25,23,2013-09-06 20:33:19,2013-09-06 17:43:09
2f0f7f1ce7431a6484506c8c89d5d4648e6aefd4...2e582df0e0f1589054674c8ed3391f240a37a6df,1,2,1,3,1,2013-09-17 17:17:33,2013-09-14 04:47:12
e7b432c521b0177e86eaecd2bd16906b9fc53e10...eb077745a4f22183faec93e46e053ccddabcc88b,2,7,0,7,2,2014-06-04 20:41:33,2014-05-30 19:57:25
e7b432c521b0177e86eaecd2bd16906b9fc53e10...574d370b0633a89f7d62ec4eac08228b26eea06f,1,15,0,15,1,2013-11-01 20:09:19,2013-09-02 20:11:26
574d370b0633a89f7d62ec4eac08228b26eea06f...751a2ac6edfbc803b9ed7c48d2d1fc54c97cc64c,1,42,0,42,1,2013-11-01 20:09:23,2013-11-01 18:33:15
751a2ac6edfbc803b9ed7c48d2d1fc54c97cc64c...ff32d3420a550d3811e745af7f2ccc77fb026b7b,2,28,23,51,20,2013-11-01 20:09:24,2013-11-01 19:02:45
ff32d3420a550d3811e745af7f2ccc77fb026b7b...9dc01bf0631b51dfe497d57942a9085e0808e205,3,43,0,43,12,2013-11-01 20:09:45,2013-11-01 19:13:01
21860882c8782771e99aa68fab6e365c628ff39d...8766343faff88c303917944fb771471ec0fdbec1,1,11,11,22,11,2013-09-08 16:37:13,2013-09-08 14:28:36
dfaf75b4698833d820e77e9f42ef93f3b6d3669d...70087cdbd3671f5929689a9b77f414b8297641c2,4,100,12,112,10,2007-12-15 05:58:35,2007-12-15 04:57:28
70087cdbd3671f5929689a9b77f414b8297641c2...5b4617c7490921f3ea871231f71d6baa2288bf93,5,8,9,17,6,2007-12-15 06:04:43,2007-12-15 06:02:57
5b4617c7490921f3ea871231f71d6baa2288bf93...fa4701601a62664a9246a211c5d26f238820737e,4,1,108,109,4,2007-12-15 06:08:25,2007-12-15 06:08:25
fa4701601a62664a9246a211c5d26f238820737e...530e741c726a612d78de21957d531dd2215483b4,27,675,5,680,32,2007-12-15 06:29:38,2007-11-25 07:48:04
530e741c726a612d78de21957d531dd2215483b4...7680087e7c8125e7397aa5761f5c5ddbb02a8326,1,10,1,11,4,2007-12-15 06:30:38,2007-12-15 06:30:38
7680087e7c8125e7397aa5761f5c5ddbb02a8326...52499977350b95ba7166e5c835b09cdbc20a3d02,1,4,5,9,2,2007-12-16 19:53:03,2007-12-16 07:06:14
52499977350b95ba7166e5c835b09cdbc20a3d02...718a087a47cc148f74027a3a26d71994ff71bdd8,1,1,2,3,2,2007-12-16 19:55:48,2007-12-15 11:11:54
718a087a47cc148f74027a3a26d71994ff71bdd8...bf901f8e748144a19d057d9d00582417d480c795,1,8,6,14,5,2007-12-16 19:56:26,2007-12-15 14:40:28
bf901f8e748144a19d057d9d00582417d480c795...dfa7c7d221d05499063f9bf95f507af8a882bfeb,1,11,11,22,3,2007-12-16 19:56:26,2007-12-15 14:41:49
dfa7c7d221d05499063f9bf95f507af8a882bfeb...bc8b95ae4a4b21753e84bbfd28cbcbf1b3f6e0a8,2,26,1,27,2,2007-12-16 19:56:27,2007-12-08 11:30:59
bc8b95ae4a4b21753e84bbfd28cbcbf1b3f6e0a8...6ba78238a824282816944550edc4297dd2808a72,1,3,0,3,2,2007-12-16 20:50:08,2007-12-16 04:53:26
6ba78238a824282816944550edc4297dd2808a72...d7e522cffb2224b91c9c0edde093fbb81a0289b0,5,5,5,10,6,2007-12-16 20:52:40,2007-12-16 07:21:04
d7e522cffb2224b91c9c0edde093fbb81a0289b0...4d9697c7871e513712eb9cfd30611049b10e5132,2,3,3,6,3,2007-12-16 21:07:14,2007-12-16 16:31:37
4d9697c7871e513712eb9cfd30611049b10e5132...1020999a981e0dadedc475c41e33e20fd7832019,1,7,8,15,3,2007-12-16 21:07:20,2007-12-16 16:31:38
1020999a981e0dadedc475c41e33e20fd7832019...954ecd435389916643efeb5b1ade82250170c071,1,9,12,21,10,2007-12-16 21:07:41,2007-12-16 16:31:39
954ecd435389916643efeb5b1ade82250170c071...9afa2d4aa9423ab594c7281cc2360df55498a407,2,19,6,25,7,2007-12-16 21:07:49,2007-12-16 16:31:40
9afa2d4aa9423ab594c7281cc2360df55498a407...ffe568859ba89b4283afc36251561a9be3173bf8,1,16,8,24,7,2007-12-16 21:07:58,2007-12-16 16:31:41
ffe568859ba89b4283afc36251561a9be3173bf8...127f72e6897d6671725dc13db42ab5ee1d086721,1,1,1,2,1,2007-12-16 21:08:03,2007-12-16 16:31:42
127f72e6897d6671725dc13db42ab5ee1d086721...079fe1dae8504c988c50ce41eba78743d3f588e0,2,70,1,71,2,2007-12-16 22:00:30,2007-12-16 21:49:17
079fe1dae8504c988c50ce41eba78743d3f588e0...95f9b92700585eb9afa6978c350dc07ec5769ec6,1,4,4,8,3,2007-12-16 22:03:36,2007-12-16 17:58:01
95f9b92700585eb9afa6978c350dc07ec5769ec6...b90ced0f7da0b8dcdac1aabd8840a23daef25b43,1,1,2,3,1,2007-12-16 22:03:40,2007-12-16 17:58:02
b90ced0f7da0b8dcdac1aabd8840a23daef25b43...1596456309315befb3fd0a985d50a70ed09493e4,1,1,0,1,1,2007-12-16 23:03:58,2007-12-16 23:03:58
1596456309315befb3fd0a985d50a70ed09493e4...3eb2a15eb385749fbfe59b4e37fc754416275760,1,3,0,3,1,2007-12-16 23:05:39,2007-12-16 23:05:39
3eb2a15eb385749fbfe59b4e37fc754416275760...50f22ada523f448986dd6273da14a477cea5a646,1,79,50,129,19,2007-12-17 03:26:12,2007-12-16 19:45:34
50f22ada523f448986dd6273da14a477cea5a646...6fbe42c7ee99b4cafa792b46a16b0158d305fe29,1,2,1,3,1,2007-12-17 06:03:21,2007-12-17 06:03:21
6fbe42c7ee99b4cafa792b46a16b0158d305fe29...68e6a4f80d4bea2d281c30fa2bbcd4968b0ccc4e,1,2,2,4,2,2007-12-18 00:08:40,2007-12-17 19:12:52
68e6a4f80d4bea2d281c30fa2bbcd4968b0ccc4e...3175b0cfc1392de1ff00c01796f85b92df317cc8,11,18,18,36,17,2007-12-18 04:49:18,2007-12-17 22:28:46
3175b0cfc1392de1ff00c01796f85b92df317cc8...5f48741a5a47643bf1b46ba1d23688f2ef8b1216,1,1,1,2,1,2007-12-18 04:49:18,2007-12-17 12:00:43
5f48741a5a47643bf1b46ba1d23688f2ef8b1216...f029427259c97af9ea98358866e1d28974fa4da5,4,5,8,13,5,2007-12-18 04:49:18,2007-12-17 09:08:23
f029427259c97af9ea98358866e1d28974fa4da5...cbe021004fc8762076bf497cc0b259d110b3a753,1,7,0,7,3,2007-12-18 04:49:18,2007-12-17 13:42:20
cbe021004fc8762076bf497cc0b259d110b3a753...77680caadb939cf47fd08447b81faadc7c3bd436,1,11,0,11,2,2007-12-18 04:49:18,2007-12-17 12:21:22
77680caadb939cf47fd08447b81faadc7c3bd436...34454e858d2a648b0a6ce56acd9def84bd2a8712,2,12,1,13,2,2007-12-18 04:49:18,2007-12-17 21:01:25
5946d4ba8970f00bb62b2c9e8714264831034043...63a1f810a6f976a307aaaabdce21082f6d7f20aa,1,2,2,4,1,2007-10-02 06:27:20,2007-10-02 06:14:37
63a1f810a6f976a307aaaabdce21082f6d7f20aa...c8f203255bc7a782e3a54e73d5801009bb7f0319,1,1,0,1,1,2007-10-02 18:48:06,2007-10-02 18:47:58
c8f203255bc7a782e3a54e73d5801009bb7f0319...9e1a2acfb2198e29c90b59eef84eb0370ef9f03f,1,6,4,10,6,2007-10-02 22:12:05,2007-10-02 22:09:41
9e1a2acfb2198e29c90b59eef84eb0370ef9f03f...6ea9c7eb2713d55f9af7522e878e6912972bb889,1,1,1,2,1,2007-10-02 22:26:57,2007-10-02 20:14:30
6ea9c7eb2713d55f9af7522e878e6912972bb889...ac150747d7cc62d53daf9f7c128a0fa88a399f44,1,3,1,4,1,2007-10-03 00:26:40,2007-10-02 23:32:32
ac150747d7cc62d53daf9f7c128a0fa88a399f44...84d176cef65ad23e11643d463c69ad313b728eda,1,15,0,15,1,2007-10-03 00:26:52,2007-10-02 23:33:30
84d176cef65ad23e11643d463c69ad313b728eda...46749204e97290a0bf20e988d0356f0daba99347,1,4,0,4,1,2007-10-03 00:27:00,2007-10-02 23:34:32
46749204e97290a0bf20e988d0356f0daba99347...8fc293cb1e639c9ea555a8e95e3a7801fc1d1be8,1,18,4,22,1,2007-10-03 00:27:48,2007-10-02 23:36:30
8fc293cb1e639c9ea555a8e95e3a7801fc1d1be8...2ff5e18a930ddaf03c77a60e52648e7b8b20fc8d,1,3,0,3,1,2007-10-03 00:35:29,2007-10-02 23:42:29
2ff5e18a930ddaf03c77a60e52648e7b8b20fc8d...eede7b7d110e2c354235d7a3f6c8f1644b5120e5,3,11,4,15,6,2007-10-03 04:02:03,2007-09-25 19:29:42
eede7b7d110e2c354235d7a3f6c8f1644b5120e5...8ae92e63895000ff9b12046325ae381f3c17d414,3,5,5,10,5,2007-10-03 04:02:09,2007-10-03 04:01:03
8ae92e63895000ff9b12046325ae381f3c17d414...96e24abc9f14c83abd1e269e1d5bc1c9e50d3fca,1,1,1,2,1,2007-10-03 04:10:25,2007-10-03 01:49:34
96e24abc9f14c83abd1e269e1d5bc1c9e50d3fca...95af39fcb2d84c8ef2844a9d890e3c67a2e0e1ec,1,2,1,3,1,2007-10-03 06:18:58,2007-10-03 05:44:15
95af39fcb2d84c8ef2844a9d890e3c67a2e0e1ec...54e1abce90ed44d0674772a735ac387ce3e264f2,1,71,0,71,1,2007-10-03 07:53:24,2007-10-03 07:03:53
54e1abce90ed44d0674772a735ac387ce3e264f2...4c75136f7697f76b31641db775163f5c75906ee2,2,18,11,29,6,2007-10-03 09:33:48,2007-10-03 09:33:11
060009b4191c5dcdec858f5ec3d16cad012859df...5f5b611805ed60a303ccbc07ebd9a5bac2dabb92,1,2,1,3,2,2007-11-22 08:50:21,2007-11-21 12:35:05
5f5b611805ed60a303ccbc07ebd9a5bac2dabb92...a7d9da6c972cb7bc79ef47ad7199dfb2a8dcf67f,1,4,2,6,3,2007-11-22 08:51:56,2007-11-21 12:36:38
7a4a2e1f797724ce15b059f55ce57eab0e6be807...21640376a5b3e55557020a4932ba78daffc2d77e,1,1,1,2,1,2007-12-05 19:08:00,2007-12-05 11:28:50
21640376a5b3e55557020a4932ba78daffc2d77e...9e4bbeb95f5c9d046b671070eb35b3aa6f3ec5e6,1,1,2,3,1,2007-12-05 19:34:44,2007-12-05 15:11:24
9e4bbeb95f5c9d046b671070eb35b3aa6f3ec5e6...3b78959ece0212225ae71efbdf2c1a2183e532f5,1,2,2,4,2,2007-12-05 21:16:35,2007-12-05 21:16:35
7a4a2e1f797724ce15b059f55ce57eab0e6be807...272bd3cfd059cf867b979d5c11b0ccce9bcccbb3,4,168,161,329,7,2007-12-05 09:57:40,2007-11-01 14:57:40
7a4a2e1f797724ce15b059f55ce57eab0e6be807...cdf63284de7bd9ca5439c76ecbd820551ae506c8,1,20,7,27,7,2007-12-05 09:06:02,2007-11-23 09:12:54
cdf63284de7bd9ca5439c76ecbd820551ae506c8...394d66d42b81b4879d80984138cb4748d03c6ffb,1,6,0,6,1,2007-12-05 09:15:01,2007-12-05 09:15:01
7a4a2e1f797724ce15b059f55ce57eab0e6be807...83201998730ac5f0b95ac832f3b727da26ab0129,1,46,77,123,17,2007-12-05 07:48:39,2007-12-04 07:25:47
b52e985a4f824128d01220473b04057a4876060d...2221a6757161af1905925c405aded9ff470f70d5,1,57,4,61,8,2007-12-01 21:44:25,2007-12-01 21:13:11
0f6f195b771eb09beda59bb29d3a1c46454085e8...df55c9cbc3ea79c51d5f41a628439283e94a87fd,1,27,8,35,10,2007-12-04 06:15:05,2007-12-02 05:07:40
df55c9cbc3ea79c51d5f41a628439283e94a87fd...45533d2694d480be86112f2da36d555e7373ba24,2,12,2,14,4,2007-12-04 06:16:54,2007-12-04 05:44:29
45533d2694d480be86112f2da36d555e7373ba24...5d6491c7c7536ab930a6e9ce2ec3b5249d4c283f,4,171,17,188,17,2007-12-09 09:19:44,2007-12-02 05:07:55
5d6491c7c7536ab930a6e9ce2ec3b5249d4c283f...d3a866bc8b5604d31638648d671e524cc84fbb26,2,7,2,9,3,2007-12-09 09:19:54,2007-12-02 05:08:00
d3a866bc8b5604d31638648d671e524cc84fbb26...c07a07c588fea82c2426d795a75324b3035c0a71,2,22,2,24,4,2007-12-09 09:19:54,2007-12-05 05:09:40
0f6f195b771eb09beda59bb29d3a1c46454085e8...41650765dea25b7804a9fdf41ce0b7db59816734,3,11,11,22,4,2007-12-04 06:11:53,2007-12-01 17:05:40
41650765dea25b7804a9fdf41ce0b7db59816734...b319ce4c14f7fe0ee469a3f9def1098d84177849,7,12,20,32,12,2007-12-04 06:11:53,2007-12-03 04:51:50
b319ce4c14f7fe0ee469a3f9def1098d84177849...9c5665aa3c938b0e085ca34a8126110edcffa217,2,15,0,15,4,2007-12-04 06:11:53,2007-11-23 00:07:00
9c5665aa3c938b0e085ca34a8126110edcffa217...14c98218845ad2acbd42b8d913503ff6fb3fd2ac,4,18,1,19,5,2007-12-04 07:43:07,2007-12-03 21:48:54
14c98218845ad2acbd42b8d913503ff6fb3fd2ac...ee4bc3715fd8e4598d31dfa7288609cad86a2321,3,8,8,16,7,2007-12-04 07:43:07,2007-12-03 22:44:39
ee4bc3715fd8e4598d31dfa7288609cad86a2321...311db37e707601ef2107d2938c0e0e0ade6e39b5,1,1,0,1,1,2007-12-04 07:43:07,2007-12-04 05:56:09
311db37e707601ef2107d2938c0e0e0ade6e39b5...364d3e65a5da76ac51217e68b55504cd2cd154aa,1,16,3,19,5,2007-12-04 07:43:07,2007-12-03 18:42:39
364d3e65a5da76ac51217e68b55504cd2cd154aa...afc67036de4c6f27234243dded05d7dd9398eea5,1,58,21,79,12,2007-12-04 07:43:07,2007-12-04 07:13:02
cfb5e104423b51aefb4d0e21a093bd9373b0af0b...fba6072ed83bfc3c0e1eb56f11476b06a3b0dfb7,1,21,21,42,3,2007-12-14 06:30:20,2007-12-13 14:39:21
fba6072ed83bfc3c0e1eb56f11476b06a3b0dfb7...a4750dd26671427009cc2c7a6a303f7ad8c39e8a,1,1,0,1,1,2007-12-14 06:51:22,2007-12-14 06:51:22
a4750dd26671427009cc2c7a6a303f7ad8c39e8a...9fe98116a2c7231503e7f5156417c1af84d4a59e,1,4,6,10,2,2007-12-14 06:51:37,2007-12-13 14:02:26
9fe98116a2c7231503e7f5156417c1af84d4a59e...f0e8692a091195c8642923fd410553c293895d75,1,1895,0,1895,1,2007-12-30 02:00:14,2007-12-27 12:34:31
f0e8692a091195c8642923fd410553c293895d75...a6d5888fa1bb24ef34ce36f0e684d13a58eba908,1,1,1,2,1,2007-12-30 02:03:55,2007-12-28 02:15:56
d1a2057560b33c926ba481618105edbb65d2c91c...1c1f79a1e44547d039e7bf94d9aaadd3fae007d1,2,6,4,10,2,2007-10-28 21:16:59,2007-10-28 17:47:30
1c1f79a1e44547d039e7bf94d9aaadd3fae007d1...399f0a8eedeec209c2eb97be6285331087234644,1,2,0,2,2,2007-10-29 18:39:07,2007-10-29 07:00:33
399f0a8eedeec209c2eb97be6285331087234644...7109c889f11b39a2c5a5122e3726be7ffce09faf,1,9,7,16,1,2007-10-29 18:56:57,2007-10-29 18:53:55
7109c889f11b39a2c5a5122e3726be7ffce09faf...f120ae2a8e8cbe1bcbb2b55ebcd2e1eeb9f03ea2,1,1,1,2,1,2007-10-29 19:00:55,2007-10-29 19:00:55
f120ae2a8e8cbe1bcbb2b55ebcd2e1eeb9f03ea2...e720c4382f6c9317a3b495e80c7dfc609a0db5e6,1,21,0,21,1,2007-10-29 19:02:59,2007-10-29 19:02:59
916d081bbaa40617643b09b6dc9c6760993cf6ed...75bd7e374ef35265dfd7c3c1896f4fb91450e50d,1,4,5,9,4,2006-11-09 17:34:27,2006-11-05 05:51:10
75bd7e374ef35265dfd7c3c1896f4fb91450e50d...a35a045874379467395e0909958827ad89afc03d,1,1,1,2,1,2006-11-09 17:34:36,2006-11-05 05:51:11
a35a045874379467395e0909958827ad89afc03d...45bf473a7bc2c40c8aea3d34a0eab7a41e77a8ff,4,102,4,106,12,2006-11-09 17:34:46,2006-11-09 09:19:37
45bf473a7bc2c40c8aea3d34a0eab7a41e77a8ff...a6ec3c1599f990b4f2f3dab2606688639f74d844,1,1,1,2,1,2006-11-09 22:41:16,2006-10-03 16:29:26
4f88d3e0cbf443cd309c2c881209f3366f14023d...d44c92d6ab4ded7a1960bb0b4a1da0c2fc102b89,1,2,2,4,1,2006-12-11 19:32:50,2006-12-11 07:39:32
d44c92d6ab4ded7a1960bb0b4a1da0c2fc102b89...554a2636f7c5125a83bb07194632445467d46c83,1,1,1,2,1,2006-12-11 22:04:43,2006-12-11 18:06:34
554a2636f7c5125a83bb07194632445467d46c83...9abd46a3471c2d58976e06a00e937b03672b98bc,1,1,1,2,1,2006-12-11 22:11:40,2006-12-07 10:17:07
fc66d213f8b2f13b9ffd643f01de25ddc95e0972...90bd932c811f4ecd1d8cbceffdf6a69a5ca838b7,1,5,7,12,5,2006-03-13 07:02:00,2006-03-13 06:26:34
fd662dd500cded4b04b1154dc77cc989a5ddc5b8...bb52807916598301e670963e6cc5f1f5cdca3ad7,1,8,0,8,3,2006-03-20 22:07:59,2006-03-20 22:07:59
bb52807916598301e670963e6cc5f1f5cdca3ad7...3070b603ab349674fd357b1b7f9ba4698f2b86b7,2,29,23,52,4,2006-03-20 22:37:33,2006-03-20 10:41:18
3070b603ab349674fd357b1b7f9ba4698f2b86b7...1fa7a68f4bf1d21bf6693f1d9a416b6a690efe52,1,1,1,2,1,2006-03-20 22:37:59,2006-03-20 13:11:12
1fa7a68f4bf1d21bf6693f1d9a416b6a690efe52...3dfaf7bcfd116ac180df8405e700a20d7159702b,1,218,1,219,8,2006-03-20 22:38:47,2006-03-20 18:31:06
3dfaf7bcfd116ac180df8405e700a20d7159702b...a3c57c9adb2844cebf2048b5ece356f3a091d4f9,1,1,1,2,1,2006-03-20 22:38:58,2006-03-20 19:50:51
a3c57c9adb2844cebf2048b5ece356f3a091d4f9...ac7490506418e3ec495775e432b7040a17449fa9,1,13,1,14,2,2006-03-21 07:31:19,2006-03-21 04:51:16
fd662dd500cded4b04b1154dc77cc989a5ddc5b8...6ea23343ce2962a5c76ed62a29fd17cb30954de2,1,40,27,67,14,2006-03-20 08:50:37,2006-03-18 22:50:53
3ce8f08944e614813c7dfb212a88b7c4e3b443bc...cebff98dbe3fd6177337ae4d440b81ffed797608,1,94,162,256,44,2006-03-26 07:27:01,2006-03-26 07:12:17
d2cb7c6e9303c082b406acc643018f51179e8b35...7bc70a590db6ed3069d52aa38d59938e7955901b,1,1,1,2,1,2006-04-28 05:48:27,2006-04-28 05:48:27
975bf9cf5ad5d440f98f464ae8124609a4835ce1...cc908b82a4a09df555fbc4c32cfbe8b8cffae865,1,7,2,9,2,2006-05-15 05:07:28,2006-05-15 05:07:28
cc908b82a4a09df555fbc4c32cfbe8b8cffae865...994d6c66d360198c16eb483e4f33d412358f30a1,1,48,0,48,2,2006-05-15 05:36:27,2006-05-15 02:13:44
994d6c66d360198c16eb483e4f33d412358f30a1...15739c89fbf508c453da854ec50f313505bbe78f,2,4,7,11,4,2006-05-15 05:37:00,2006-05-15 02:26:56
975bf9cf5ad5d440f98f464ae8124609a4835ce1...76b99b81613abea4cc16e45e1b11dbbec82a4b4d,1,1,1,2,1,2006-05-14 23:48:23,2006-05-14 17:43:50
76b99b81613abea4cc16e45e1b11dbbec82a4b4d...c68998f5b5f43717a27da82fac08a76d6588bae7,1,4,46,50,4,2006-05-14 23:48:33,2006-05-14 18:20:37
975bf9cf5ad5d440f98f464ae8124609a4835ce1...4bbd261bbd941066735e41dff0ade9f50e6fe84d,3,93,2,95,6,2006-05-14 23:28:45,2006-05-14 12:13:49
4bbd261bbd941066735e41dff0ade9f50e6fe84d...9d76812b42009069aa3ff8f29e51b5150aa04e8e,3,3,4,7,3,2006-05-14 23:29:20,2006-05-14 12:16:06
975bf9cf5ad5d440f98f464ae8124609a4835ce1...cc120056a881101326488e3c5c2d3af2ce3a8de6,3,30,13,43,10,2006-05-14 23:28:32,2006-05-14 03:34:08
975bf9cf5ad5d440f98f464ae8124609a4835ce1...ee1e5412a702674d4da95a4aef73a73d2834dcc3,3,53,1,54,6,2006-05-14 23:26:27,2006-05-13 20:23:48
975bf9cf5ad5d440f98f464ae8124609a4835ce1...a62be77f5ebdbbd46d6956dc4d07571835588389,5,48,7,55,12,2006-05-14 23:21:02,2006-05-14 01:43:00
66ae0c7702e68765dad17aa05c5d9255d999216c...5010cb5fcca30269ad25f2eb38b31455af3205d7,4,457,1,458,4,2006-05-01 08:26:46,2006-05-01 06:28:15
66ae0c7702e68765dad17aa05c5d9255d999216c...73b0e5af9daf38734d94ed170f8800481e15567f,1,46,8,54,3,2006-05-01 00:55:34,2006-04-22 00:31:04
66ae0c7702e68765dad17aa05c5d9255d999216c...ea4a19e172e8db52779c06723b1e99cc12f228c9,1,37,0,37,2,2006-05-01 00:55:33,2006-04-30 07:54:29
66ae0c7702e68765dad17aa05c5d9255d999216c...755225de6ce4c7b39137afefb35208d0dbc14d9d,4,259,1,260,4,2006-04-30 07:59:18,2006-04-30 04:22:49
0fe7c1de16f71312e6adac4b85bddf0d62a47168...334b506a3487f762493d3db2d3053114f25590e3,1,1,1,2,1,2006-04-30 07:26:41,2006-04-30 07:26:41
c74320872b445104fe5c265e60785d9d26d94cc5...468eb79ed453017151c1230057986a7a79264395,3,14,34,48,5,2006-05-02 06:06:06,2006-05-02 06:05:39
55e1805dffeb5d2a8ccd717b2d07ca8887436a69...c1d1128bef97ae16a6740538abe5fb81c67ed239,1,7,0,7,1,2006-04-28 09:32:44,2006-04-28 09:32:44
c1d1128bef97ae16a6740538abe5fb81c67ed239...d0ad1653662a214baddc1d1ce669a28b91a3ae76,1,3,0,3,1,2006-04-28 21:28:28,2006-04-28 08:42:28
d0ad1653662a214baddc1d1ce669a28b91a3ae76...fe77bb1a02d5b8dd3915cd27a83b660debaecda4,1,4,3,7,4,2006-04-28 21:29:04,2006-04-28 08:41:19
fe77bb1a02d5b8dd3915cd27a83b660debaecda4...2eaf273d518717c84d748051e05210656f7b7e88,2,40,19,59,13,2006-04-28 21:31:18,2006-04-28 13:15:04
2eaf273d518717c84d748051e05210656f7b7e88...48aeecdcc14684111ddb8ac0ec3bfdc5245ee75e,6,104,108,212,61,2006-04-28 21:31:36,2006-04-28 13:15:05
48aeecdcc14684111ddb8ac0ec3bfdc5245ee75e...776e994af5b85d77424581bda37fb615897063cc,2,17,1,18,2,2006-04-28 21:31:51,2006-04-28 13:15:06
776e994af5b85d77424581bda37fb615897063cc...aa6bf0eb6489d652c5877d65160ed33c857afa74,1,3,4,7,3,2006-04-28 21:31:53,2006-04-28 13:15:03
bad68ec92410cf47dd001aa9b95d0f24c5f4bf77...53dc3f3e8069283924fcb7f1d538e2d1b03ec3bb,1,18,0,18,3,2006-04-25 23:37:08,2006-04-25 23:37:08
53dc3f3e8069283924fcb7f1d538e2d1b03ec3bb...61fa30972c45e73d39c81d27af9eeacbda7531c9,1,66,26,92,17,2006-04-26 00:40:02,2006-04-26 00:40:02
61fa30972c45e73d39c81d27af9eeacbda7531c9...0f8820528e4c2e4b3e1306cfe79998e7124c8d49,1,4,3,7,3,2006-04-26 00:40:24,2006-04-26 00:40:24
2a3870432395e78c82a870bf1a177b8d5b8fbdf0...0377db77da3f66b8a2bd2f8a9391d22f7a576e34,1,71,1,72,7,2006-05-05 20:55:45,2006-05-04 23:16:40
0377db77da3f66b8a2bd2f8a9391d22f7a576e34...81f3a188a3781fa4a818ed27ee83430682a98ec4,1,6,1,7,3,2006-05-05 20:56:01,2006-05-05 01:33:05
81f3a188a3781fa4a818ed27ee83430682a98ec4...2448482b3d5e265dd29fa38c3827565f6f2f31ec,1,34,10,44,10,2006-05-05 21:11:55,2006-05-05 01:33:32
2448482b3d5e265dd29fa38c3827565f6f2f31ec...596524b33d50e47e2375cec9e00aff59f0e8278b,7,25,11,36,16,2006-05-05 21:11:57,2006-05-05 02:30:52
596524b33d50e47e2375cec9e00aff59f0e8278b...8ac80a5701780547404523a84f4b1ae67bfa6823,2,16,5,21,8,2006-05-05 21:11:59,2006-05-05 02:31:29
293532739415d287786a312ec10849723383796e...402461aab17292b78bd36a17bff18e48d544cc9a,1,10,7,17,5,2006-04-16 08:40:04,2006-04-16 02:44:25
f4235f8b2ef875b85ead74ffa199d827f9ee9d8d...d2e38d3bc30d3b1e407cbf9c69424b84244a5f9d,2,6,6,12,7,2006-04-15 11:03:48,2006-04-15 10:54:32
d2e38d3bc30d3b1e407cbf9c69424b84244a5f9d...1fc70b60bfda67205253595ad9dc040019c2efe5,1,32,13,45,11,2006-04-15 11:21:19,2006-04-15 11:15:07
dd8239f997962d94162790039b008acb6068a242...3026402cbc60c003c4bc043368afc619e4d9b3cd,1,2,0,2,1,2006-06-06 23:22:45,2006-06-06 23:15:16
dd8239f997962d94162790039b008acb6068a242...021b6e454944a4fba878651ebf9bfe0a3f6c3077,11,98,95,193,30,2006-06-06 21:30:58,2006-06-06 19:51:49
021b6e454944a4fba878651ebf9bfe0a3f6c3077...c33d5174d692b1861e0b2f656e51b80b2b00a23c,2,11,12,23,10,2006-06-06 21:30:58,2006-06-06 20:54:14
c33d5174d692b1861e0b2f656e51b80b2b00a23c...e5f38ec3c5d8553413501e6141932b8ccc7aceb4,3,18,13,31,13,2006-06-06 21:30:58,2006-06-06 21:04:17
e7a0919115ee15b21a557609c2268e24497c1059...1ce09dd6787c495986c75b37b07ba6bbf19b47da,1,2,2,4,2,2007-03-21 11:02:19,2007-03-19 23:00:37
61efa5e300386978dd440716260c94e951a493b4...62bf0d962963794e9fbcdfdd43419b060d5d245f,1,6,7,13,2,2006-05-23 23:43:12,2006-05-23 20:59:44
62bf0d962963794e9fbcdfdd43419b060d5d245f...304dac15486b6d86d31aea1ca736c2c61f17e902,1,1,1,2,1,2006-05-24 04:37:23,2006-05-24 02:23:40
304dac15486b6d86d31aea1ca736c2c61f17e902...36f5b1f0c800a23b9755a0214c1c3250f34f2486,5,254,60,314,24,2006-05-24 04:37:30,2006-05-24 02:23:41
2dec02b1ecafc47d4031d0a68a94c775a6a9ff9e...ef29c11702594e616cf43bea260515d9f14f17b0,1,24,3,27,3,2006-05-26 07:49:36,2006-05-26 07:46:58
d48f7168619932a389341f1f0c904ab6dc117b5e...f81daefe56b3c97b93a851e1ada14eeca0dea47a,4,8,5,13,7,2006-05-24 20:35:35,2006-05-24 11:08:46
f81daefe56b3c97b93a851e1ada14eeca0dea47a...4d548150ace0816dd5fe678cdbde75b13d5e5249,1,78,61,139,13,2006-05-24 20:36:13,2006-05-24 15:30:54
cd01d9445de1bbca8952c7ee16941f5fa10747f5...22669a045a062c7884735219bc4f5f8a8dd183a2,1,23,19,42,3,2006-05-29 18:31:58,2006-05-29 08:06:48
22669a045a062c7884735219bc4f5f8a8dd183a2...e0c97ca63df2590026fe1f9a76fefba54b291d06,1,7,3,10,3,2006-05-30 02:04:19,2006-05-30 02:01:38
47df096f254ccac5a81da615b3fd25f3cf466bbf...4c068a983150b740c3fcf6a33f342ac923abd3f4,11,112,141,253,58,2006-05-31 06:03:01,2006-05-30 16:45:45
73be17f0b387b2741646498a9a80da677a9e0c7a...a18b63276281708143be7a7828bf106c88a7b307,1,1,1,2,1,2006-02-20 21:32:40,2006-02-20 18:57:25
a18b63276281708143be7a7828bf106c88a7b307...72942938bfd3587a52906890d7123c49ab71fafc,2,15,2,17,4,2006-02-20 21:32:40,2006-02-20 18:57:26
72942938bfd3587a52906890d7123c49ab71fafc...8de010ad2802e0718b36f394322c6f25542612d6,2,11,4,15,3,2006-02-20 21:32:41,2006-02-20 18:57:26
8de010ad2802e0718b36f394322c6f25542612d6...ce6f35190360ef8b8c3611eea61a82fb18b50c6c,1,35,49,84,9,2006-02-20 21:32:41,2006-02-20 18:57:28
ce6f35190360ef8b8c3611eea61a82fb18b50c6c...472ee9e3d6820db00ae76c2d3f9775aa44932e2b,1,2,2,4,2,2006-02-20 21:32:41,2006-02-20 18:57:28
472ee9e3d6820db00ae76c2d3f9775aa44932e2b...bbe0c9b8d82aa98aad2ae7e6554cc0b9e2836363,1,7,0,7,1,2006-02-20 21:32:41,2006-02-20 18:57:28
bbe0c9b8d82aa98aad2ae7e6554cc0b9e2836363...cf52b8f06389189bd32565c5c6adad75ac8a1a62,1,200,60,260,33,2006-02-20 21:32:41,2006-02-20 18:57:28
cf52b8f06389189bd32565c5c6adad75ac8a1a62...96a40b27c99f1f55de1830fb1a39b1050b4b7a18,4,252,0,252,3,2006-02-20 21:32:42,2006-02-20 18:57:29
96a40b27c99f1f55de1830fb1a39b1050b4b7a18...551ce28fe1f2777eee7dd9c02bd44f55f4b32361,1,11,2,13,6,2006-02-20 21:32:42,2006-02-20 18:57:29
73be17f0b387b2741646498a9a80da677a9e0c7a...c649657501bada28794a30102d9c13cc28ca0e5e,2,29,6,35,8,2006-02-20 05:35:55,2006-02-19 11:32:31
289c4b36e336af5266b86d924ef0aa828e8e4841...abb7c7b31c0896bd838bbb6437b310db5a42227a,7,32,1,33,9,2006-02-19 07:16:09,2006-02-18 12:01:18
e4c9327a77bd59e85d4b17a612e78977d68773ee...7a979d99bafae3576d9480007f958eed0c9e0278,1,219,81,300,40,2006-02-20 06:27:39,2006-02-19 22:47:21
7a979d99bafae3576d9480007f958eed0c9e0278...2245be3e7a5a2999ebf7d38e569c98994b0cda31,1,9,1,10,3,2006-02-20 06:28:04,2006-02-19 23:03:49
664368886781b7c070233c002597b84628eec571...69a60af5d0a84c4a7af907eba87f42dd6fb3c6e1,2,56,12,68,8,2006-02-22 01:45:32,2006-02-22 01:10:12
664368886781b7c070233c002597b84628eec571...e15f545155bb4b2cad4475a25cad8fb576d37dee,1,8,6,14,5,2006-02-21 08:55:00,2006-02-20 23:36:28
664368886781b7c070233c002597b84628eec571...cbfb73d73f272f194bafa70d5be1f35abc265c79,2,444,1,445,2,2006-02-21 08:54:34,2006-02-20 23:40:54
183bdb2cccff792f11fd9e825df67af446aff171...6d28644d691fa3967d24d988d51d863f22bbcc63,1,8,2,10,3,2006-02-24 06:14:47,2006-02-24 06:14:47
183bdb2cccff792f11fd9e825df67af446aff171...6dc78e696b8597204b903073da932fc5ed0f419e,1,19,14,33,1,2006-02-23 00:04:08,2006-02-22 21:10:37
2d310d8a018ca1a8d3e4c8a52f60ae5f57f34b31...7334f06ce6c53e161d1c183a5f93a23992b3c440,1,8,0,8,1,2006-02-05 06:16:22,2006-02-05 06:10:32
7334f06ce6c53e161d1c183a5f93a23992b3c440...9523a4c2fcd7bbccbbddb998eef891ae83cf91a3,1,7,5,12,5,2006-02-05 21:44:59,2006-02-05 19:58:34
9523a4c2fcd7bbccbbddb998eef891ae83cf91a3...04fe2a1706b4bd71b604bfe7d7295064440872cf,1,1,38,39,2,2006-02-05 21:45:01,2006-02-04 22:54:01
04fe2a1706b4bd71b604bfe7d7295064440872cf...ec0bdb6f1e8fd772ff9eb920ebcb7dd1afcaf362,1,9,0,9,3,2006-02-05 21:46:19,2006-02-05 19:42:09
ec0bdb6f1e8fd772ff9eb920ebcb7dd1afcaf362...4abd89648eb40384556e2118e74be03325d0b05d,1,8,0,8,1,2006-02-06 00:36:12,2006-02-06 00:36:12
4abd89648eb40384556e2118e74be03325d0b05d...df9892ffce46d1f1bd6fe64aa445be2ffe7346cf,1,2,2,4,2,2006-02-06 00:37:18,2006-02-06 00:37:18
68f4e1fc6abd332726dd281c76dd63ce7d13d7a1...b5007211b6582fc38647ff695b5ac51541ea9de8,4,29,18,47,10,2014-12-01 02:07:34,2014-11-27 05:24:01
bd8ff616c998da8b08bd59b47644408048b3016d...f9c5a80cdf2265f2df7712fad9f1fb7ef68b4768,1,1,1,2,1,2007-12-18 05:59:26,2007-12-18 01:39:57
f9c5a80cdf2265f2df7712fad9f1fb7ef68b4768...f2fdd10ab76feb0e141fc3f9cf4e5efd87f7fcdf,1,1,1,2,1,2007-12-18 09:10:24,2007-12-18 06:12:03
f2fdd10ab76feb0e141fc3f9cf4e5efd87f7fcdf...4808ab8f87551967d61fc4f4164e2f99e2fa4d71,1,0,1,1,1,2007-12-18 09:46:04,2007-12-18 09:46:04
4808ab8f87551967d61fc4f4164e2f99e2fa4d71...02ff62504e12cb1925a59b6956508dc70984c5b4,6,10,10,20,10,2007-12-18 20:00:18,2007-12-18 06:07:36
02ff62504e12cb1925a59b6956508dc70984c5b4...91c3aced4c9b961e162f9acd706f4b03a85aed2c,1,0,5,5,3,2007-12-18 20:00:26,2007-12-18 07:30:47
91c3aced4c9b961e162f9acd706f4b03a85aed2c...e8a3f90994067a154fafcec9bbb18cf7865cd94c,1,1,1,2,1,2007-12-18 20:00:26,2007-12-18 10:03:23
e8a3f90994067a154fafcec9bbb18cf7865cd94c...ce85b053d827e2f7c2ee2683cc09393e4768cc22,1,24,24,48,11,2007-12-18 23:22:28,2007-12-18 15:15:39
ce85b053d827e2f7c2ee2683cc09393e4768cc22...ad94802a7bc599ade73ec0b04c61b2f80b3c1b23,1,39,11,50,5,2007-12-19 08:04:21,2007-12-16 03:08:22
ad94802a7bc599ade73ec0b04c61b2f80b3c1b23...7fc35e0e94782bbbefb920875813519038659930,1,9,3,12,1,2007-12-19 08:17:07,2007-12-19 08:06:45
7fc35e0e94782bbbefb920875813519038659930...540424b263d626aa762757a31ca9b4becc7fb513,1,2,2,4,1,2007-12-19 08:33:15,2007-12-19 08:31:43
540424b263d626aa762757a31ca9b4becc7fb513...56122ed87af181c88e3121795c292689ac574f01,1,31,7,38,6,2007-12-19 22:59:11,2007-12-18 18:01:33
56122ed87af181c88e3121795c292689ac574f01...9d81e03b5ca4e3841d56e6e57ff2b8100202ed6f,1,1,1,2,1,2007-12-19 22:59:18,2007-12-19 09:15:15
9d81e03b5ca4e3841d56e6e57ff2b8100202ed6f...ecaa0cff44577700400903aa47eb0e99a135e423,1,22,0,22,1,2007-12-19 22:59:18,2007-12-19 15:43:50
ecaa0cff44577700400903aa47eb0e99a135e423...c5699693638d0471bf74425238d802d2bc9e8c0f,2,10,6,16,5,2007-12-19 22:59:19,2007-12-19 12:25:27
c5699693638d0471bf74425238d802d2bc9e8c0f...3f7701a4db4c26d37e804dc4cdd6641677ea97e8,1,8,6,14,1,2007-12-19 22:59:19,2007-12-19 17:53:16
3f7701a4db4c26d37e804dc4cdd6641677ea97e8...5909651ea2be69932d9b739b4441ca857ced7660,1,1,1,2,1,2007-12-19 22:59:19,2007-12-19 21:34:27
5909651ea2be69932d9b739b4441ca857ced7660...20b178de7b20a0ebf02b8da3b4791c06fc8e3a63,1,8,1,9,4,2007-12-20 00:58:42,2007-12-18 19:50:28
20b178de7b20a0ebf02b8da3b4791c06fc8e3a63...c5b09feb786f6a2456ec3d8203d0f4d67f09f043,1,2,2,4,2,2007-12-20 01:15:38,2007-12-19 06:41:26
c5b09feb786f6a2456ec3d8203d0f4d67f09f043...dbedf9729bd349c7667630d50728214ed531f74d,1,9,8,17,4,2007-12-20 01:17:27,2007-12-19 06:45:00
dbedf9729bd349c7667630d50728214ed531f74d...74f6b03c5c8fceef416de9f9a18e5d64712b6d96,3,21,10,31,10,2007-12-20 01:24:04,2007-12-20 01:21:04
74f6b03c5c8fceef416de9f9a18e5d64712b6d96...eab9a40b6dd5c1c571b1deb264133db47bb4794d,3,27,8,35,9,2007-12-20 09:10:39,2007-12-18 19:32:14
eab9a40b6dd5c1c571b1deb264133db47bb4794d...885ed372d09f68806b17fc8fd0ac13a46636aeb2,1,123,35,158,11,2007-12-20 09:11:37,2007-12-20 00:21:30
885ed372d09f68806b17fc8fd0ac13a46636aeb2...fbcf1184026197128582369074201c490009b4eb,1,5,1,6,3,2007-12-20 09:11:53,2007-12-20 03:23:03
fbcf1184026197128582369074201c490009b4eb...03270628ed61f56431658eacd335b8f2f8ecc05a,1,3,1,4,2,2007-12-20 09:12:41,2007-12-20 07:12:12
03270628ed61f56431658eacd335b8f2f8ecc05a...5d29275638f48ee442202f0c478d1d8b9d396cc6,1,2,1,3,1,2007-12-20 20:58:06,2007-12-20 20:58:06
5d29275638f48ee442202f0c478d1d8b9d396cc6...cdd859159e7677c466a319e4349c8b3933f8c5d6,1,3,1,4,1,2007-12-21 01:00:27,2007-12-20 11:50:34
cdd859159e7677c466a319e4349c8b3933f8c5d6...6a7f14c4651f9773eb5e7e8111721a979ce2a64c,1,17,16,33,14,2007-12-21 01:04:58,2007-12-20 12:11:25
6a7f14c4651f9773eb5e7e8111721a979ce2a64c...feb7f38b01761a695ecf53f94237251c1d3aa650,1,0,6,6,3,2007-12-21 01:05:31,2007-12-20 13:00:40
feb7f38b01761a695ecf53f94237251c1d3aa650...8a82b133547a93e8bdc08fd199c237f540eb9249,1,6,13,19,5,2007-12-21 01:11:20,2007-12-20 14:05:45
8a82b133547a93e8bdc08fd199c237f540eb9249...d76a585d83aeb6910e7eb10d36b406dc27202675,1,1,1,2,1,2007-12-21 03:07:24,2007-12-20 09:48:09
d76a585d83aeb6910e7eb10d36b406dc27202675...d2f82950a9226ae1102a7a97f03440a4bf8c6c09,1,7,4,11,3,2007-12-21 04:54:23,2007-12-21 04:22:46
d2f82950a9226ae1102a7a97f03440a4bf8c6c09...56c3eb173293d512fa85add94a7d0a3bfc6fe74a,1,2,1,3,1,2007-12-21 21:50:58,2007-12-21 21:50:58
56c3eb173293d512fa85add94a7d0a3bfc6fe74a...78d776a9699cd3e3d368366afaa66dee97e53ac5,2,5,15,20,6,2007-12-22 08:05:02,2007-12-21 10:50:58
78d776a9699cd3e3d368366afaa66dee97e53ac5...0e0278baad8752da6c3b37495f005dc1dd6f799a,1,1,1,2,1,2007-12-22 08:21:30,2007-12-22 00:40:52
0e0278baad8752da6c3b37495f005dc1dd6f799a...77190eb9b881118b78383a483973a85fe79cbf70,1,1,1,2,1,2007-12-22 08:23:17,2007-12-21 15:57:26
77190eb9b881118b78383a483973a85fe79cbf70...5e2de4f9bb666186e4f8ba0c9c5db640fd7a04bd,1,13,1,14,1,2007-12-22 18:26:08,2007-12-22 17:45:10
5e2de4f9bb666186e4f8ba0c9c5db640fd7a04bd...c43a24834a9babd3ddd9c27ccc81174c2cb36859,2,51,51,102,51,2007-12-22 18:26:08,2007-12-21 10:41:41
c43a24834a9babd3ddd9c27ccc81174c2cb36859...2f7ee089dff6e9225dbfca2bdd23efe93e1c0740,3,115,1,116,3,2007-12-22 18:26:08,2007-12-13 10:20:01
2f7ee089dff6e9225dbfca2bdd23efe93e1c0740...97bc00a4909fb73eba8a05dc89fe7914d7123245,1,4,2,6,2,2007-12-22 19:15:22,2007-12-22 17:31:25
97bc00a4909fb73eba8a05dc89fe7914d7123245...cc216827936e40bc2e8886623fd44f55e0674932,1,22,13,35,6,2007-12-22 19:15:38,2007-12-21 10:56:32
4c75136f7697f76b31641db775163f5c75906ee2...99516e35d096f41e7133cacde8fbed8ee9a3ecd0,1,2,2,4,1,2007-10-16 00:15:58,2007-10-08 20:42:41
99516e35d096f41e7133cacde8fbed8ee9a3ecd0...304b5af64f9b5a6b5e9455e2dcab381c568452b6,3,3,3,6,3,2007-10-16 00:24:27,2007-10-09 16:35:22
304b5af64f9b5a6b5e9455e2dcab381c568452b6...a72c874e43e89a879fc4a8998ecd6e5a56667929,1,4,1,5,2,2007-10-16 00:54:42,2007-10-05 20:16:44
a72c874e43e89a879fc4a8998ecd6e5a56667929...7288ed8ebdab54e5aa05400bd840e1348ffdc270,1,5,6,11,4,2007-10-16 01:00:40,2007-10-09 19:29:26
7288ed8ebdab54e5aa05400bd840e1348ffdc270...7b40a4552a0fbdc6ee9a22ce10408d79ca1599af,1,6,10,16,7,2007-10-16 01:00:40,2007-10-09 19:34:17
7b40a4552a0fbdc6ee9a22ce10408d79ca1599af...60fcc2e6ce255da1baa92905c10456981d260fa0,1,14,9,23,3,2007-10-16 01:05:22,2007-10-10 22:14:35
60fcc2e6ce255da1baa92905c10456981d260fa0...1ae14a6b52f8f0506780cd361933f717163ae19b,1,7,2,9,2,2007-10-16 01:07:38,2007-10-12 11:32:51
1ae14a6b52f8f0506780cd361933f717163ae19b...a5d410153736fc5320ad7322e25a6ccf56efcf10,1,4,1,5,2,2007-10-16 01:10:54,2007-10-04 12:26:54
a5d410153736fc5320ad7322e25a6ccf56efcf10...c005c6aa980f5f51e00d1f6a80ae0f009d533627,1,6,1,7,2,2007-10-16 01:10:54,2007-10-04 22:41:11
c005c6aa980f5f51e00d1f6a80ae0f009d533627...922aa807f5fee97fcb2ccd1d1db63b59bdd02128,1,4,1,5,2,2007-10-16 01:12:06,2007-10-04 21:49:19
922aa807f5fee97fcb2ccd1d1db63b59bdd02128...f3d5e463f06c34716a9ce9d946e689377e9fda37,1,2,2,4,2,2007-10-16 01:16:08,2007-10-09 12:59:43
f3d5e463f06c34716a9ce9d946e689377e9fda37...8492f00b4f28471af84d3887096257822c4d2bc9,2,26,1,27,2,2007-10-16 02:29:50,2007-10-16 02:29:50
4c75136f7697f76b31641db775163f5c75906ee2...eb4d0e3f4515e5508fa9c0a695f7a45812a76296,1,30,24,54,8,2007-10-04 07:05:36,2007-10-03 02:28:19
a7d9da6c972cb7bc79ef47ad7199dfb2a8dcf67f...a00a42ae33708caa742d9e9fbf10692cfa42f032,5,32,1,33,5,2007-11-22 22:21:59,2007-11-22 20:19:40
a00a42ae33708caa742d9e9fbf10692cfa42f032...6047a234c5a6aef58c72a35feba326484f07660d,2,10,7,17,4,2007-11-22 23:35:06,2007-11-22 12:30:10
a7d9da6c972cb7bc79ef47ad7199dfb2a8dcf67f...7c0ab4458994aa895855abc4a504cf693ecc0cf1,2,14,11,25,5,2007-11-22 10:53:19,2007-11-22 00:02:52
7c0ab4458994aa895855abc4a504cf693ecc0cf1...4c8416847aa48e2bd60fa26585e32940a1a9c61c,1,11,3,14,4,2007-11-22 10:53:40,2007-11-22 01:36:24
4c8416847aa48e2bd60fa26585e32940a1a9c61c...12db334e75ae291aa69987cbe0feda2b6a64af38,1,7,7,14,2,2007-11-23 02:23:55,2007-11-22 09:47:13
27ee189163070f53a87e033171a45520f70b242e...cec99d8cef12d18c71b277a4cd6963d37b13e901,1,7,7,14,3,2007-12-06 01:50:53,2007-12-06 01:05:17
afc67036de4c6f27234243dded05d7dd9398eea5...dada0c12120d7ef88a63adb4240963a96655f962,1,1,1,2,1,2007-12-04 08:29:32,2007-12-04 08:29:32
dada0c12120d7ef88a63adb4240963a96655f962...4f571479384cf81c4526ae29d8c79843aefd3cd1,2,3,5,8,2,2007-12-04 08:40:55,2007-12-04 08:40:55
4f571479384cf81c4526ae29d8c79843aefd3cd1...0240e21aae9263e961710dccd463d84f1049f597,1,1,1,2,1,2007-12-04 08:47:04,2007-12-04 08:47:04
0240e21aae9263e961710dccd463d84f1049f597...2d324efad6a8f4808c5eec8fd299b79ab80a7ba3,1,8,16,24,7,2007-12-04 09:20:06,2007-12-04 07:25:46
2d324efad6a8f4808c5eec8fd299b79ab80a7ba3...afa75bc8aa1d453d18cc2486ba8fc53e7df92c4d,1,4,4,8,2,2007-12-04 22:35:08,2007-12-02 19:40:43
afa75bc8aa1d453d18cc2486ba8fc53e7df92c4d...dcbcb707c366732c6b328ac6433d888f9915dcc5,1,18,2,20,3,2007-12-04 22:43:05,2007-12-04 01:41:45
dcbcb707c366732c6b328ac6433d888f9915dcc5...e5d3de5c457d1a82c921b9bf2cd9a962970ce30e,1,3,4,7,1,2007-12-04 22:43:21,2007-12-04 08:55:41
e5d3de5c457d1a82c921b9bf2cd9a962970ce30e...5188408057b31a604f00496582aa873054ad6746,2,13,13,26,13,2007-12-04 22:48:45,2007-12-04 22:45:16
5188408057b31a604f00496582aa873054ad6746...f64c81d4282b1dacf2cf095bfb0f7708b99b3ecf,1,9,19,28,1,2007-12-04 23:50:18,2007-12-03 19:11:43
afc67036de4c6f27234243dded05d7dd9398eea5...c680dd8341c2aa429acfc13223220d72b8d2c5c9,1,6,3,9,4,2007-12-04 07:48:09,2007-12-01 02:36:34
a6d5888fa1bb24ef34ce36f0e684d13a58eba908...b3125ad3c10402de680cbdd7945574a1cc30a379,2,6,1,7,3,2008-01-16 05:42:37,2008-01-07 20:48:55
b3125ad3c10402de680cbdd7945574a1cc30a379...898ff9e9b430ab0602d99c2ca6bab7f03b4abb1a,2,24,21,45,20,2008-01-16 05:42:41,2008-01-07 21:00:25
898ff9e9b430ab0602d99c2ca6bab7f03b4abb1a...d4544601513c9ab5a702d7815afcdf13014b06cc,1,3,1,4,1,2008-01-16 05:44:14,2008-01-08 20:21:15
d4544601513c9ab5a702d7815afcdf13014b06cc...10899a84d1536538b250bc90727d858ee50acd20,1,11,11,22,11,2008-01-16 05:50:10,2008-01-12 08:28:57
10899a84d1536538b250bc90727d858ee50acd20...d71b5659c5ff55c52638630c2db0975853df116a,2,9,9,18,9,2008-01-16 05:50:20,2008-01-15 19:41:39
d71b5659c5ff55c52638630c2db0975853df116a...daaa958fcc4f829dbd7dac46c39c15f77507495a,1,1875,0,1875,1,2008-01-16 06:01:19,2008-01-16 05:51:40
daaa958fcc4f829dbd7dac46c39c15f77507495a...d36a8f73a4201ab21a553b5caa5b890b8f1d7213,1,22,28,50,5,2008-01-16 06:14:42,2008-01-16 06:14:42
d36a8f73a4201ab21a553b5caa5b890b8f1d7213...a41e45ea1ccc88b4b13af16434c79ffe65ba978a,1,2,0,2,1,2008-01-16 06:29:39,2008-01-16 06:29:39
a41e45ea1ccc88b4b13af16434c79ffe65ba978a...a1f8f5043cb791aaa7d4c08dc779525551612da0,1,166,0,166,1,2008-01-18 02:35:01,2008-01-16 07:19:34
a1f8f5043cb791aaa7d4c08dc779525551612da0...a02855711310b553c610fe7ef634f4ceb25fe9f6,1,3,2,5,3,2008-01-18 03:58:24,2008-01-18 03:50:23
d9f405931fa3d96b2a80fe5ad8205eea7c443f56...9758ecde9a0be8b9758d0a512c90f8bfc865af4f,2,17,1,18,6,2007-12-07 09:28:05,2007-12-07 09:28:05
9758ecde9a0be8b9758d0a512c90f8bfc865af4f...8e566f24b369836c43d720e4246a152b0e7724c6,2,26,1,27,5,2007-12-08 10:50:54,2007-12-06 18:33:01
8e566f24b369836c43d720e4246a152b0e7724c6...4af756f31b0696ed1ca6ad10dc6d7053477edc16,1,34,39,73,19,2007-12-08 10:53:19,2007-12-07 12:35:10
4af756f31b0696ed1ca6ad10dc6d7053477edc16...235997c90fe8648ac199f9a1ae257e06c145c131,2,27,3,30,4,2007-12-08 10:58:26,2007-12-07 10:25:34
235997c90fe8648ac199f9a1ae257e06c145c131...c3ce3261281d00bcdd59907e76f421034ccb1261,1,3,0,3,1,2007-12-08 11:33:24,2007-12-07 16:57:04
c3ce3261281d00bcdd59907e76f421034ccb1261...46f721c8fee9f1c027f96e2bf987ce6e7d05ab94,6,52,2,54,8,2007-12-08 11:33:24,2007-12-07 21:26:07
46f721c8fee9f1c027f96e2bf987ce6e7d05ab94...2099bca9ed06a4cb7ab0b8ca38bc90df5632ba41,1,13,12,25,4,2007-12-08 11:33:24,2007-12-08 09:00:31
2099bca9ed06a4cb7ab0b8ca38bc90df5632ba41...b7a28f7827ba1043501fe357cbbdff3f2e357143,1,5,5,10,3,2007-12-08 11:38:35,2007-12-08 01:27:52
b7a28f7827ba1043501fe357cbbdff3f2e357143...b904166ccb67d80491fad9d4f5ec42d241975f37,1,21,20,41,14,2007-12-08 11:38:35,2007-12-08 05:00:08
b904166ccb67d80491fad9d4f5ec42d241975f37...384b32c09b3c7e36b4d65ae80fc758d75dba3fc2,1,85,32,117,23,2007-12-08 11:38:36,2007-12-08 05:03:17
384b32c09b3c7e36b4d65ae80fc758d75dba3fc2...fd99b36134a047b8c5ba1230323e7cacc5df330e,1,4,3,7,1,2007-12-08 11:40:12,2007-12-08 01:04:11
fd99b36134a047b8c5ba1230323e7cacc5df330e...1e931cb4d197e30504b6d2cc77b0b045b0167df6,1,62,103,165,14,2007-12-08 19:31:17,2007-12-08 01:07:41
e720c4382f6c9317a3b495e80c7dfc609a0db5e6...562e35c34ced4ca7af024d213737411238dbe0f5,1,1,1,2,1,2007-10-30 18:39:47,2007-10-30 13:53:47
562e35c34ced4ca7af024d213737411238dbe0f5...b6c9fb5100f8cd4081f1c6df5aea7335a11e9659,1,4,1,5,2,2007-10-30 23:21:56,2007-10-30 18:30:43
b6c9fb5100f8cd4081f1c6df5aea7335a11e9659...dee48c3c7ed7f7a32a524e8a492c6bc4e3c1c78d,1,6,5,11,4,2007-10-30 23:33:55,2007-10-30 18:54:11
dee48c3c7ed7f7a32a524e8a492c6bc4e3c1c78d...ba17892ddc85c0ffe8fecd600c29cb38ec7e5587,1,4,4,8,3,2007-10-30 23:35:07,2007-10-30 19:54:02
ba17892ddc85c0ffe8fecd600c29cb38ec7e5587...04bd8e5fea48a00816b461b0fb934627cfd2c45f,1,1,1,2,1,2007-10-30 23:49:27,2007-10-30 19:59:24
04bd8e5fea48a00816b461b0fb934627cfd2c45f...07b45f8c1754a13bca67f70b600bf51ba33cf98d,1,6,0,6,3,2007-10-31 00:27:40,2007-09-25 06:36:38
07b45f8c1754a13bca67f70b600bf51ba33cf98d...3524b282dabd254fc50b186e35ea5c6f612aeb46,1,0,1,1,1,2007-10-31 04:27:15,2007-10-31 02:20:30
3524b282dabd254fc50b186e35ea5c6f612aeb46...2a9c53e03d8293577b5163910f178075725b39dd,1,2,2,4,2,2007-10-31 04:28:44,2007-10-31 02:20:31
2a9c53e03d8293577b5163910f178075725b39dd...f91333d646e690d9a10717c96e166a069b2bb586,1,2,0,2,1,2007-10-31 04:29:28,2007-10-31 02:20:32
f91333d646e690d9a10717c96e166a069b2bb586...0bdb5af7a571ee2bd71550a545632b1cb7f8f8f3,1,7,1,8,2,2007-10-31 04:34:36,2007-10-31 04:32:49
a6ec3c1599f990b4f2f3dab2606688639f74d844...057bc808b4aa2e7795f9bd395e68071301bc0b74,1,1,1,2,1,2006-11-11 22:46:11,2006-11-11 22:45:35
9abd46a3471c2d58976e06a00e937b03672b98bc...59f867400650b39568e4a7f96bd60f3a0072dbda,1,15,12,27,2,2006-12-12 22:48:25,2006-12-12 17:01:47
59f867400650b39568e4a7f96bd60f3a0072dbda...0d7a6e4ef9e2dc458a9a56ab73638d97f4e75d87,1,8,7,15,3,2006-12-13 01:04:40,2006-12-12 17:34:02
90bd932c811f4ecd1d8cbceffdf6a69a5ca838b7...3c7ceba4f1e8be1a536dd0e21bc4f422873d08d2,1,16,18,34,8,2006-03-15 08:37:57,2006-03-15 08:37:57
ac7490506418e3ec495775e432b7040a17449fa9...292839077488d7ccb46bc2cc25b515a1ebd25f8f,1,1,1,2,1,2006-03-21 23:39:44,2006-03-21 23:28:06
292839077488d7ccb46bc2cc25b515a1ebd25f8f...8c9e7947c2a76fb21bda11816c544d50e271156d,1,12,8,20,8,2006-03-21 23:50:18,2006-03-21 23:49:05
8c9e7947c2a76fb21bda11816c544d50e271156d...3103cf9e1e09b0045a60542f24a2a1e4ed7b1237,1,1,1,2,1,2006-03-22 08:21:07,2006-03-22 08:21:07
ac7490506418e3ec495775e432b7040a17449fa9...2f8acdb38e513e4b983209563faf4c1d38c4013e,4,27,3,30,7,2006-03-21 07:34:17,2006-03-21 02:45:47
cebff98dbe3fd6177337ae4d440b81ffed797608...54c261f90fb8aa9a0f12431cce2c2631a119d667,1,3,3,6,2,2006-03-27 03:07:08,2006-03-26 23:14:52
54c261f90fb8aa9a0f12431cce2c2631a119d667...3467fec516e0549cfe7ae3ed8bd981a7e5f528f4,2,3,3,6,2,2006-03-27 07:41:22,2006-03-27 07:41:22
746437d534a1fa84e210427a94972ed0c7f34ee5...cfa24e184a67cc36f414d913cf705d31e70a7a1a,1,2,3,5,2,2006-05-02 19:54:12,2006-05-02 19:54:12
cfa24e184a67cc36f414d913cf705d31e70a7a1a...c1aee1fd8d94da9b3c5d2dc1d4264f7e73a58f80,1,6,6,12,2,2006-05-02 20:23:48,2006-05-02 14:58:37
746437d534a1fa84e210427a94972ed0c7f34ee5...c24fe420d3e2af6e5faabc6ab7f68c18f939582d,1,30,3,33,6,2006-05-02 06:19:13,2006-05-02 00:12:26
746437d534a1fa84e210427a94972ed0c7f34ee5...7b763f7c6536f40090b06c79896a147ba97b0b03,2,3,34,37,5,2006-05-02 06:15:09,2006-05-02 06:14:58
7bc70a590db6ed3069d52aa38d59938e7955901b...0111ea38cbb9db0e4e245dcd5c86198186bab197,1,10,1,11,2,2006-05-02 05:14:03,2006-05-02 01:31:02
0111ea38cbb9db0e4e245dcd5c86198186bab197...cdc08b33ef3da0e963f9956e4a66f67cc3330f83,1,2,0,2,1,2006-05-02 05:15:54,2006-05-02 05:15:54
de1d4fa2a1273e09c32653c7a21602e36223348c...aca7ad7628ce72afbd1d0d99778c9a5c9cac7a7a,1,40,20,60,4,2006-05-15 19:13:57,2006-05-15 09:34:44
aca7ad7628ce72afbd1d0d99778c9a5c9cac7a7a...db3106b274a75d5b9ea7f6fe1030b8528df7389b,1,12,3,15,2,2006-05-15 19:14:22,2006-05-15 09:41:01
de1d4fa2a1273e09c32653c7a21602e36223348c...49e3343c9fe0e134e0a8c1ec0ddeb64ae18ee9fd,1,1,1,2,1,2006-05-15 07:51:51,2006-05-15 04:59:04
c68998f5b5f43717a27da82fac08a76d6588bae7...613f02739a49337592a32936caa04b1590ca1109,1,3,0,3,1,2006-05-15 07:46:57,2006-05-15 07:46:05
a62be77f5ebdbbd46d6956dc4d07571835588389...e6ebb8a3fbef10f50a3f4fe346d3bb47fe8ce07b,1,3,5,8,3,2006-05-15 07:54:31,2006-05-15 00:07:39
5010cb5fcca30269ad25f2eb38b31455af3205d7...e0eb889f8e6597120527b0312874ff4c8448108e,1,62,23,85,13,2006-05-01 19:31:04,2006-05-01 19:27:56
e0eb889f8e6597120527b0312874ff4c8448108e...df0e7aa8644eef5ebc018bf838739e25f3494b6c,1,10,0,10,3,2006-05-01 19:40:17,2006-05-01 19:39:21
df0e7aa8644eef5ebc018bf838739e25f3494b6c...1362671f6a716e1a34abbcab43adfb68c7e2fd3b,1,134,121,255,29,2006-05-01 22:58:29,2006-05-01 22:58:29
73b0e5af9daf38734d94ed170f8800481e15567f...e7cef45fbceab9558adce82a26b96f15af47772c,1,1,0,1,1,2006-05-08 22:44:06,2006-05-08 22:44:06
755225de6ce4c7b39137afefb35208d0dbc14d9d...5c477b972583e96b65ef1613c5d0fb1b90af3d0e,1,21,5,26,7,2006-04-30 22:42:09,2006-04-30 12:05:55
5c477b972583e96b65ef1613c5d0fb1b90af3d0e...7aaf83dafbde7aaa60a1e220e967faaeb28a46f6,1,18,16,34,8,2006-04-30 23:03:27,2006-04-30 23:03:27
334b506a3487f762493d3db2d3053114f25590e3...8ab99476ec2298a43e94949e0bb7aa5125793a28,3,4,77,81,4,2006-05-02 06:07:28,2006-05-02 05:58:18
468eb79ed453017151c1230057986a7a79264395...80fe7d2b54b1aebde6c067694cdbf3ba40ad0c39,1,2,0,2,1,2006-05-03 06:03:15,2006-05-03 06:03:15
aa6bf0eb6489d652c5877d65160ed33c857afa74...262a6ef76a1dde97ab50d79fa5cd6d3f9f125765,1,4,5,9,1,2006-04-30 07:32:25,2006-04-29 15:50:28
402461aab17292b78bd36a17bff18e48d544cc9a...5bc4ce589646faf72c7a77a5d32d9496ccc8d456,1,3,1,4,2,2006-04-16 21:24:56,2006-04-16 21:24:56
402461aab17292b78bd36a17bff18e48d544cc9a...caef71a5354ca162cc5a6914a7a643efbc9ae28a,1,1,1,2,1,2006-04-16 08:46:08,2006-04-16 08:46:08
1fc70b60bfda67205253595ad9dc040019c2efe5...c5ccd8be43df4b916752a176512a9adaf3b94df9,4,23,0,23,6,2006-04-16 01:17:15,2006-04-15 19:09:56
b2934926dd7455de61577c1dfdf4c12d224e7ae0...d4ed9793fd981ea5a35ebaa8e337446bb29f6d55,1,7,13,20,7,2006-04-16 09:42:00,2006-04-16 09:42:00
d4ed9793fd981ea5a35ebaa8e337446bb29f6d55...cb8f64b4e3f263c113b7a2f156af74b810e969ff,3,30,15,45,12,2006-04-16 10:35:38,2006-04-16 10:29:10
9941afc051d953ee5e8fd9a8a27c5cd659ef9552...5ad312bedede83f63de5e69ef5e5ddff46484eae,2,49,20,69,18,2006-06-07 04:44:39,2006-06-07 03:58:41
5ad312bedede83f63de5e69ef5e5ddff46484eae...e8dff6ba8b12db94b728ff4d0ebf65040de92c37,1,1,0,1,1,2006-06-07 05:32:51,2006-06-07 05:22:35
1ce09dd6787c495986c75b37b07ba6bbf19b47da...d59c4b6fb731e5fddb458106b2e18eed1087c507,1,23,6,29,19,2007-04-01 02:47:06,2007-03-27 10:36:12
d59c4b6fb731e5fddb458106b2e18eed1087c507...3a950e9a9cfc2eb4e30cf6e8658dab25196d746e,1,15,8,23,9,2007-04-01 02:47:06,2007-03-27 10:36:59
36f5b1f0c800a23b9755a0214c1c3250f34f2486...fad70686b25c414b6224406d42a4dfb7c4136e85,1,4,1,5,2,2006-05-24 06:45:37,2006-05-23 09:34:23
36f5b1f0c800a23b9755a0214c1c3250f34f2486...1bf1a859ae980a73552c76fe20a5952a763ec81e,1,14,0,14,4,2006-05-24 04:45:09,2006-05-24 02:08:01
1bf1a859ae980a73552c76fe20a5952a763ec81e...cc189c2ca2c725c430f100f61e7c4a6849f93163,1,35,0,35,1,2006-05-24 07:19:20,2006-05-23 21:48:36
cc189c2ca2c725c430f100f61e7c4a6849f93163...65aadb92a1ce9605fa2f412b51de91781a3ef3d6,2,27,6,33,7,2006-05-24 20:23:31,2006-05-24 20:19:50
4d548150ace0816dd5fe678cdbde75b13d5e5249...84c667ff97da2a3864ef7952b9f438d133ce35ef,2,3,20,23,7,2006-05-24 23:42:38,2006-05-24 23:42:38
e0c97ca63df2590026fe1f9a76fefba54b291d06...7872b1889550ce8c1cd452fb18445bd6ea6e8fed,1,3,3,6,3,2006-05-30 06:14:40,2006-05-29 21:11:28
7872b1889550ce8c1cd452fb18445bd6ea6e8fed...2be1bc48ffe04d97ca61e2b7988e6870cd37766b,1,3,1,4,1,2006-05-30 06:14:44,2006-05-29 23:31:32
2be1bc48ffe04d97ca61e2b7988e6870cd37766b...38573864f893653be012dd77c2da77f9ecbb1e02,1,7,1,8,2,2006-05-30 06:14:45,2006-05-29 23:31:33
38573864f893653be012dd77c2da77f9ecbb1e02...62109cd3a8b5fd0a4ea3b7267e633ca713f33fa6,1,2,2,4,1,2006-05-30 06:14:46,2006-05-29 23:31:34
62109cd3a8b5fd0a4ea3b7267e633ca713f33fa6...a746f688f130ea56a6a01dcfd8c51ac42ef1b633,1,1,1,2,1,2006-05-30 06:14:48,2006-05-29 23:31:36
a746f688f130ea56a6a01dcfd8c51ac42ef1b633...3c4c7351c030a18fa94076ffe62f534f890e9602,1,2,1,3,2,2006-05-30 06:14:49,2006-05-30 02:03:45
3c4c7351c030a18fa94076ffe62f534f890e9602...037b048eceafa129903d6327d3565c543f5895bb,1,0,1,1,1,2006-05-30 06:14:50,2006-05-30 02:03:46
037b048eceafa129903d6327d3565c543f5895bb...7484529d7f17d5bff1faefb007d604aba12a0e1b,1,2,2,4,1,2006-05-30 06:14:51,2006-05-29 15:06:32
7484529d7f17d5bff1faefb007d604aba12a0e1b...7ccf79274c03971b8884223b1950077582a7bf8a,1,11,2,13,3,2006-05-30 06:15:36,2006-05-29 19:30:12
7ccf79274c03971b8884223b1950077582a7bf8a...580632458902b440cba41f0a5a1d27192221e1b9,1,8,2,10,5,2006-05-30 06:15:37,2006-05-29 19:30:13
580632458902b440cba41f0a5a1d27192221e1b9...8baf06a03aa2a4554079a2f722af1751f1654ce8,1,6,1,7,2,2006-05-30 06:15:37,2006-05-29 19:30:14
8baf06a03aa2a4554079a2f722af1751f1654ce8...ce903018f1ed0283fdaa3de1ec3ad29fccf25c96,1,34,0,34,1,2006-05-30 06:15:37,2006-05-29 19:30:15
ce903018f1ed0283fdaa3de1ec3ad29fccf25c96...2186d566a6c2dfb2f168ae608bbb2e0e77122d7e,2,17,8,25,5,2006-05-30 07:09:36,2006-05-30 06:53:13
e0c97ca63df2590026fe1f9a76fefba54b291d06...136f2e548a34f1f504b0f062f87ddf33e8d6e83b,6,36,34,70,25,2006-05-30 02:05:02,2006-05-29 19:16:12
136f2e548a34f1f504b0f062f87ddf33e8d6e83b...3a7c352bd0ecac4b4c96c0995d61de9ef8d814f9,9,31,30,61,22,2006-05-30 02:05:06,2006-05-29 19:16:46
3a7c352bd0ecac4b4c96c0995d61de9ef8d814f9...0790a42a502701c7b58e9ad4123e46bf46bbf319,1,20,13,33,7,2006-05-30 02:05:11,2006-05-29 19:17:28
0790a42a502701c7b58e9ad4123e46bf46bbf319...1ccf5a345a6e7974ec0380eed735c2db97e50b4c,1,15,5,20,5,2006-05-30 02:05:14,2006-05-29 19:18:00
1ccf5a345a6e7974ec0380eed735c2db97e50b4c...2d9c58c69d1bab601e67b036d0546e85abcee7eb,9,116,57,173,32,2006-05-30 02:06:59,2006-05-29 19:18:33
2d9c58c69d1bab601e67b036d0546e85abcee7eb...e9a95bef7f9648b3827813906582bb8a6d922d21,1,36,21,57,16,2006-05-30 02:08:21,2006-05-29 19:19:02
e9a95bef7f9648b3827813906582bb8a6d922d21...3bc1eca91e5230739cfb488e63fae35a166a07de,2,1,3,4,4,2006-05-30 02:08:25,2006-05-29 19:19:37
3bc1eca91e5230739cfb488e63fae35a166a07de...f75e53edb38c97c8b21b69d4fc00d5419199ae4b,1,22,9,31,5,2006-05-30 02:08:29,2006-05-29 19:20:14
f75e53edb38c97c8b21b69d4fc00d5419199ae4b...1bc995a3920da4e9143ccf9d34bdabf70ab8a211,1,15,9,24,7,2006-05-30 02:08:33,2006-05-29 19:20:48
1bc995a3920da4e9143ccf9d34bdabf70ab8a211...15b5536ee47c6684806edd7725adbbdede9fb95c,3,44,56,100,5,2006-05-30 02:08:37,2006-05-29 19:21:28
4c068a983150b740c3fcf6a33f342ac923abd3f4...6f9012b62517ca490e4131f24e03ff842527f1b9,1,10,3,13,4,2006-06-02 22:23:47,2006-06-02 22:23:47
551ce28fe1f2777eee7dd9c02bd44f55f4b32361...d37a1ed7f2993a3cb8da0dd0fbcf993ba6579c82,1,3,3,6,3,2006-02-21 03:26:21,2006-02-21 03:26:21
d37a1ed7f2993a3cb8da0dd0fbcf993ba6579c82...0f73e92ab78f1978da22746d3aacdd134b87d013,1,3,2,5,1,2006-02-21 08:28:04,2006-02-21 08:28:04
551ce28fe1f2777eee7dd9c02bd44f55f4b32361...2a86ec46da99e4cd5e6e394d378ba119d8f5069d,1,16,8,24,6,2006-02-20 22:21:10,2006-02-20 22:02:25
2a86ec46da99e4cd5e6e394d378ba119d8f5069d...fedd273b758e6aa844555e4e50ebfce59255e015,1,5,1,6,1,2006-02-20 22:21:15,2006-02-20 22:02:47
fedd273b758e6aa844555e4e50ebfce59255e015...e415907d6c746616f399cf2a4679372dd0cbce83,1,21,16,37,3,2006-02-20 22:23:51,2006-02-20 22:23:51
e415907d6c746616f399cf2a4679372dd0cbce83...7ae0dc015dc38ce937bb2c044ff8b4875678e8af,1,16,4,20,5,2006-02-20 22:24:05,2006-02-20 22:14:15
7ae0dc015dc38ce937bb2c044ff8b4875678e8af...dd27478f092295069b148a4cfcf92fea9a4aab03,1,5,1,6,2,2006-02-20 22:24:06,2006-02-20 22:17:28
551ce28fe1f2777eee7dd9c02bd44f55f4b32361...c65e898754ef68a5520b2791890dda51753d00c6,2,322,0,322,2,2006-02-20 21:35:42,2006-02-20 10:46:09
c649657501bada28794a30102d9c13cc28ca0e5e...eb38cc689e84a8fd01c1856e889fe8d3b4f1bfb4,1,3,1,4,2,2006-02-24 07:44:15,2006-02-24 07:44:15
abb7c7b31c0896bd838bbb6437b310db5a42227a...39c015c556f285106931e0500f301de462b0e46e,2,45,30,75,14,2006-02-19 07:17:01,2006-02-18 11:40:22
39c015c556f285106931e0500f301de462b0e46e...2a3763ef3d26eb38c0a47997b8e5fd2a7c5214cc,1,3,3,6,2,2006-02-20 00:55:38,2006-02-19 20:16:08
2a3763ef3d26eb38c0a47997b8e5fd2a7c5214cc...a348ab702a84983c258e4961a58b1b9502f428c8,1,4,2,6,1,2006-02-20 00:55:38,2006-02-19 20:13:48
2245be3e7a5a2999ebf7d38e569c98994b0cda31...a79a27636098be2b9652f59bd447ac074f741e26,1,4,0,4,3,2006-02-20 08:09:41,2006-02-20 08:09:41
a79a27636098be2b9652f59bd447ac074f741e26...b19696c2e7c3e753777189100b2ac09c9e04080b,3,20,8,28,12,2006-02-20 08:38:39,2006-02-20 08:38:39
00fd12392c8592911e3bb71df09bf3672f7fca04...5508a616631fb41531b638f744bd92c701727014,1,36,0,36,1,2006-02-22 02:18:25,2006-02-17 21:33:28
5508a616631fb41531b638f744bd92c701727014...d0080b3cdab3a309385ad3fb3b4d2f6a08212985,1,1,1,2,1,2006-02-22 02:25:34,2006-02-21 20:56:14
d0080b3cdab3a309385ad3fb3b4d2f6a08212985...c8af25ca0157146de59b992c1f961f1af8465995,3,33,0,33,4,2006-02-22 02:37:36,2006-02-21 20:48:30
c8af25ca0157146de59b992c1f961f1af8465995...5301eee92ceb1c349ea8090a4d8aa3aa70c4abed,1,14,36,50,3,2006-02-22 02:38:11,2006-02-21 10:30:04
5301eee92ceb1c349ea8090a4d8aa3aa70c4abed...d800795613a710fb18353af53730e75185861f41,1,6,4,10,4,2006-02-22 02:38:11,2006-02-21 10:30:10
6d5129ac098e8b9c270efd5fa2695163122a0a46...a204756a45bd357280c156d01858138712493dfa,2,2,0,2,2,2006-02-26 23:16:41,2006-02-26 23:16:41
6dc78e696b8597204b903073da932fc5ed0f419e...edd3ebfe27bf0df113846a3d4616ea538f8c04be,1,1,1,2,1,2006-02-23 11:47:15,2006-02-23 11:25:20
6dc78e696b8597204b903073da932fc5ed0f419e...09a5d72d8e8308fa5505e8c5d4715c0b6a5eabcb,1,3,1,4,2,2006-02-23 03:45:48,2006-02-23 03:45:48
6dc78e696b8597204b903073da932fc5ed0f419e...bd2afde8a38b97391b22afebf15c583fb0fffacb,6,15,13,28,13,2006-02-23 03:10:26,2006-02-23 01:47:10
6dc78e696b8597204b903073da932fc5ed0f419e...744633cbf23d3ed505f96ffc212b30c96b79fb90,3,63,3,66,10,2006-02-23 03:04:06,2006-02-23 03:02:39
df9892ffce46d1f1bd6fe64aa445be2ffe7346cf...2718435b7b746c3c249525b02fbcbad68f5a45f3,2,37,26,63,11,2006-02-06 02:23:53,2006-02-06 01:13:52
df9892ffce46d1f1bd6fe64aa445be2ffe7346cf...363f24c93695d26f5af584e99093689077b1c7dd,1,8,4,12,2,2006-02-06 00:51:01,2006-02-04 07:50:55
363f24c93695d26f5af584e99093689077b1c7dd...1955fabf4194f3629e028778d0081bb2aa16c06c,1,26,1,27,6,2006-02-06 00:51:01,2006-02-03 20:27:04
1955fabf4194f3629e028778d0081bb2aa16c06c...603968d22b19d1b98ff355cc32575a4d9845c151,2,54,10,64,8,2006-02-06 00:51:01,2006-02-05 06:27:29
df9892ffce46d1f1bd6fe64aa445be2ffe7346cf...09db444fdbf647c95de698d243425a7700b91b2f,1,1,1,2,1,2006-02-06 00:49:16,2006-02-01 11:44:28
09db444fdbf647c95de698d243425a7700b91b2f...7b934ec015363dd8881d249838ab3623a2d345fd,1,2,3,5,1,2006-02-06 00:49:16,2006-02-01 11:44:35
7b934ec015363dd8881d249838ab3623a2d345fd...7982d74e1ca846e6ab9b1bfb1fcd9c34e3fd534f,1,3,0,3,1,2006-02-06 00:49:16,2006-02-01 11:44:37
7982d74e1ca846e6ab9b1bfb1fcd9c34e3fd534f...a3f583cbf7929f290a47dc0a952ee6b0faa9d279,1,2,4,6,3,2006-02-06 00:49:17,2006-02-01 11:44:39
df9892ffce46d1f1bd6fe64aa445be2ffe7346cf...80d48ac6231d0d1c16d2b60a0c991d33bad797db,3,19,5,24,6,2006-02-06 00:42:49,2006-02-06 00:42:49
b5007211b6582fc38647ff695b5ac51541ea9de8...bd4e8822da3bf6ce28a0c5f7c1bbf1b6341c0586,1,2,1,3,1,2015-02-04 18:45:31,2015-02-04 08:23:16
cc216827936e40bc2e8886623fd44f55e0674932...7ed0988adc0a3cb3f103c105af387e3ac48eea61,1,3,1,4,2,2007-12-27 01:52:32,2007-12-20 12:20:15
cc216827936e40bc2e8886623fd44f55e0674932...0e545f75169e2c260dfb4445203c23cafdfc76ef,3,41,4,45,4,2007-12-23 07:14:59,2007-12-23 07:14:59
0e545f75169e2c260dfb4445203c23cafdfc76ef...ba4c32bdd506841c3f73cdfce5e9fb6760afd02c,1,10,9,19,1,2007-12-23 18:40:25,2007-12-23 18:37:01
ba4c32bdd506841c3f73cdfce5e9fb6760afd02c...3a969ef1d67e3b3a26c36cfbe94f6dba05d6dc69,1,1,0,1,1,2007-12-24 06:33:07,2007-12-24 03:08:19
3a969ef1d67e3b3a26c36cfbe94f6dba05d6dc69...c8deb5a14686c9c2d0ca1e8f42aec8ed44d16954,2,38,10,48,5,2007-12-26 19:37:45,2007-12-25 07:18:05
c8deb5a14686c9c2d0ca1e8f42aec8ed44d16954...0faf2da7e5ee5c2f472d8a7afaf8616101f34e80,2,78,2,80,2,2007-12-26 19:57:36,2007-12-25 11:06:47
0faf2da7e5ee5c2f472d8a7afaf8616101f34e80...25db465a34ab6fe840011e5d746701186e9e9884,2,16,2,18,3,2007-12-27 00:05:54,2007-12-27 00:04:05
25db465a34ab6fe840011e5d746701186e9e9884...462a15bc82e6adbcb8db5fcc4791ec70a026aa4b,1,31,10,41,7,2007-12-27 00:51:19,2007-12-27 00:51:19
462a15bc82e6adbcb8db5fcc4791ec70a026aa4b...d56250911f4ec074048f4edb34551eaf384172cc,4,27,13,40,6,2007-12-27 01:13:36,2007-12-27 01:13:36
cc216827936e40bc2e8886623fd44f55e0674932...30ffa60377acb443033045a42ffecefdb0921ebb,2,20,5,25,8,2007-12-23 05:13:50,2007-12-21 21:49:54
30ffa60377acb443033045a42ffecefdb0921ebb...a2cf9f445e9074df1a45f5179cef0d4bb8647dd8,2,26,11,37,14,2007-12-26 23:59:31,2007-12-24 11:18:22
cc216827936e40bc2e8886623fd44f55e0674932...7263881253acc4c3af8b3131c60da1554b72f8b2,1,1,1,2,1,2007-12-23 03:45:06,2007-12-23 03:14:33
7263881253acc4c3af8b3131c60da1554b72f8b2...d616a2396456fdb6679efa0c0bee301aeb606ca8,1,4,4,8,3,2007-12-23 03:45:06,2007-12-23 03:22:29
d616a2396456fdb6679efa0c0bee301aeb606ca8...4803466f62777fe3d0b33c8f999ec392f47a5b09,1,6,6,12,6,2007-12-23 03:45:06,2007-12-23 03:25:37
4803466f62777fe3d0b33c8f999ec392f47a5b09...5f0657374344a5d8cf5ce5a9920a08c0be422194,3,114,5,119,11,2007-12-23 03:55:07,2007-12-22 18:46:24
8492f00b4f28471af84d3887096257822c4d2bc9...33c8d38c7879ee9af0365481eecb4b3906da111a,1,2,2,4,2,2007-10-17 00:09:21,2007-10-17 00:09:21
33c8d38c7879ee9af0365481eecb4b3906da111a...dd5c8af176bb935a0b01a7dc2d5e022565c3aac3,2,21,1,22,3,2007-10-17 00:18:04,2007-10-16 23:37:36
dd5c8af176bb935a0b01a7dc2d5e022565c3aac3...7e23b06d5972ebf6377380b2dba97aeea9b7c02d,1,2,1,3,1,2007-10-17 02:01:15,2007-10-16 21:16:05
7e23b06d5972ebf6377380b2dba97aeea9b7c02d...8ef44519a64d3ac863a9a3a6dbdba09ea275c822,1,1,2,3,1,2007-10-17 02:47:51,2007-10-17 02:22:25
8ef44519a64d3ac863a9a3a6dbdba09ea275c822...46eb449cbefac461659c42c4ba4b36de1959e7ca,2,18,1,19,4,2007-10-17 02:47:51,2007-10-17 02:23:10
46eb449cbefac461659c42c4ba4b36de1959e7ca...f5f30699c078be289daaabb61ed69e1f84747a78,1,1,2,3,1,2007-10-17 02:48:03,2007-10-17 01:33:11
f5f30699c078be289daaabb61ed69e1f84747a78...09955207d148c5f3964002b7f3a4e13db3050777,1,15,0,15,3,2007-10-17 03:31:58,2007-10-17 03:31:58
fa30383642c5838bd6d4c903abafcea17568abb1...193f7e98da72f1012515b0389525cf9a6a269849,1,0,0,0,0,2007-11-23 00:52:17,2007-11-23 00:52:17
f64fe7b48104c0da3fa2b9f3d927a7a7fbb0d8ea...324ccbd6a09816af830b22b02bbeb06349141849,1,3,2,5,2,2007-11-25 18:23:10,2007-11-25 18:07:55
324ccbd6a09816af830b22b02bbeb06349141849...3f061887c562b20d3ed3d1f764462cf986a1ad12,3,22,6,28,7,2007-11-25 18:23:13,2007-11-25 18:10:10
3f061887c562b20d3ed3d1f764462cf986a1ad12...b63e99500137c913bd801a2f22b6cf88c63b95c5,3,65,19,84,14,2007-11-25 19:37:55,2007-11-25 13:15:42
b63e99500137c913bd801a2f22b6cf88c63b95c5...280e50c7e5c2c52cbcc452fa5fb254ee580ae39c,2,3,0,3,2,2007-11-28 23:46:46,2007-11-28 18:21:42
280e50c7e5c2c52cbcc452fa5fb254ee580ae39c...14cb50382c9027ca3b8cf8dbc0a26503a40f50c5,1,82,5,87,6,2007-11-30 20:37:40,2007-11-29 12:00:38
14cb50382c9027ca3b8cf8dbc0a26503a40f50c5...633209898b71df4cf4d9296f224294f9fe252f66,1,30,17,47,4,2007-12-02 19:09:22,2007-12-02 13:44:11
633209898b71df4cf4d9296f224294f9fe252f66...7e018be2ada073c92da59eb41442cde22c0c2796,1,30,1,31,3,2007-12-03 09:04:28,2007-12-03 08:09:43
cec99d8cef12d18c71b277a4cd6963d37b13e901...90e0653b1824f27559cbc5c9d1f2a00fdb9400ba,1,1,1,2,1,2007-12-06 15:26:29,2007-12-06 15:26:29
90e0653b1824f27559cbc5c9d1f2a00fdb9400ba...c9ecf4f12aecabfad87507ebd133476ea99fe4cb,2,42,3,45,3,2007-12-06 15:53:20,2007-12-06 12:24:39
c9ecf4f12aecabfad87507ebd133476ea99fe4cb...c6bc40058565fef3ec79840bf5e13ba0962cb3e4,1,1,1,2,1,2007-12-06 15:54:06,2007-12-05 07:01:19
c6bc40058565fef3ec79840bf5e13ba0962cb3e4...c7860507f0b8974359616d7047f76f1723843156,1,4,0,4,1,2007-12-06 17:15:39,2007-12-06 17:15:39
cec99d8cef12d18c71b277a4cd6963d37b13e901...c3d51cd16a8db417b89608a37410cf3bf8a5b137,1,5,4,9,1,2007-12-06 02:43:20,2007-12-05 07:19:13
cec99d8cef12d18c71b277a4cd6963d37b13e901...d871c86935bf16fed541c7df6d1b153ca3c64496,1,31,21,52,10,2007-12-06 02:42:49,2007-12-05 07:55:41
d871c86935bf16fed541c7df6d1b153ca3c64496...d3357ab8730fdd863171b241dea10e316ed7bd05,1,14,0,14,1,2007-12-06 06:47:45,2007-12-06 03:28:06
cec99d8cef12d18c71b277a4cd6963d37b13e901...0f6f5a4022de5904926cd528c681468e3f635256,7,58,7,65,11,2007-12-06 01:57:11,2007-12-06 01:26:11
0f6f5a4022de5904926cd528c681468e3f635256...b4c61ed6d35ea00494f953a27abbc902617972ec,3,146,20,166,15,2007-12-06 01:57:11,2007-12-05 08:50:23
b4c61ed6d35ea00494f953a27abbc902617972ec...69243c2b956d69636ae04c184bc8063a6fab728a,1,16,2,18,5,2007-12-06 07:05:10,2007-12-06 06:12:07
a02855711310b553c610fe7ef634f4ceb25fe9f6...fb0ca475c6ab02eeeb8ca7f2c0558d64301a8800,1,83,31,114,15,2008-01-21 03:45:37,2008-01-20 19:11:52
fb0ca475c6ab02eeeb8ca7f2c0558d64301a8800...c87238e19de70c1066e606df53f4f20f19621acd,1,1,1,2,1,2008-01-21 03:45:37,2008-01-20 19:43:38
c87238e19de70c1066e606df53f4f20f19621acd...ed76cb70f47225fc1a2ba4209b38b89be71adeb6,3,63,46,109,10,2008-01-21 03:45:38,2008-01-20 19:46:59
ed76cb70f47225fc1a2ba4209b38b89be71adeb6...6caaf2daf0ea50ff99009b94f24252b8fa747e64,1,13,13,26,13,2008-01-21 04:03:23,2008-01-21 04:03:23
144126abf99f2eac48e63b7ea85a8f3f99f814db...7ee906694c28ab7281492d5114d2afabd964bd41,1,2,2,4,2,2008-01-05 08:07:51,2008-01-05 06:22:55
7ee906694c28ab7281492d5114d2afabd964bd41...90ed6c0576156d356aa35ee79aaf85825f9566f6,1,6,6,12,6,2008-01-05 08:07:57,2008-01-05 04:06:48
90ed6c0576156d356aa35ee79aaf85825f9566f6...0feb4d1c99ef4188123ff38d702bcbdd483c3702,3,3,3,6,3,2008-01-05 08:07:57,2008-01-05 06:28:13
0feb4d1c99ef4188123ff38d702bcbdd483c3702...e9b20943b7713ed7c051621f97e12713ccf98e1f,1,25,64,89,13,2008-01-05 08:07:57,2008-01-05 06:45:08
e9b20943b7713ed7c051621f97e12713ccf98e1f...e0cd252eb0ba6453acd64762625b004aa4cc162b,1,2,2,4,2,2008-01-05 08:07:57,2008-01-04 18:59:26
e0cd252eb0ba6453acd64762625b004aa4cc162b...d6da3cdeb70e8819f68fe3c91d3457e53ab365d4,1,4,1,5,2,2008-01-05 08:08:49,2008-01-05 07:13:47
d6da3cdeb70e8819f68fe3c91d3457e53ab365d4...7c390d90e8b6322948f45cecc658d62813c0d5ae,1,3,3,6,3,2008-01-05 19:52:17,2008-01-05 08:57:24
7c390d90e8b6322948f45cecc658d62813c0d5ae...3023dc690f98f83b64cc6f2a9cc015bf2b01964a,1,6,1,7,2,2008-01-07 02:41:36,2008-01-05 09:35:54
3023dc690f98f83b64cc6f2a9cc015bf2b01964a...a6d97d49e23382027efff8a8e90e69e0572620c6,2,41,3,44,4,2008-01-07 02:41:43,2008-01-05 20:09:55
a6d97d49e23382027efff8a8e90e69e0572620c6...418fa3a5c9111e675d8fcd3271315c38cdb1f16b,1,3,19,22,1,2008-01-07 02:41:43,2008-01-05 20:18:43
418fa3a5c9111e675d8fcd3271315c38cdb1f16b...5682694a3c1f272f230301f2b11a834a141d1efe,1,1,1,2,1,2008-01-07 02:41:43,2008-01-05 22:32:21
5682694a3c1f272f230301f2b11a834a141d1efe...f7ab5c793707082d41e19093f536cdc0d45d8830,2,22,4,26,5,2008-01-07 02:41:43,2008-01-06 12:21:07
f7ab5c793707082d41e19093f536cdc0d45d8830...4c785e50debe13c4cdc3cfae7c6bc4977f6eef3d,1,2,1,3,1,2008-01-07 02:41:43,2008-01-06 03:09:09
4c785e50debe13c4cdc3cfae7c6bc4977f6eef3d...5f8bee5859a82144fc03feee2cc99288eb923d9d,2,2,2,4,2,2008-01-07 02:41:43,2008-01-06 03:10:35
5f8bee5859a82144fc03feee2cc99288eb923d9d...5162e69732d13dd079919a389a6ace8878aad716,149,603,603,1206,541,2008-01-07 02:41:44,2007-12-29 06:20:38
5162e69732d13dd079919a389a6ace8878aad716...a0393ef67679ea7720290bd45d9d628920df59f3,1,3,2,5,3,2008-01-07 02:41:44,2008-01-06 19:03:10
a0393ef67679ea7720290bd45d9d628920df59f3...50e3d1eeffefc8af58dbcf2ec79978ea375392b4,1,1,5,6,3,2008-01-07 02:41:44,2008-01-06 04:24:09
50e3d1eeffefc8af58dbcf2ec79978ea375392b4...f87e310d2c53f412cf9ba0a04e06c974c17b9062,1,15,24,39,6,2008-01-07 02:41:44,2008-01-04 08:35:21
f87e310d2c53f412cf9ba0a04e06c974c17b9062...47ee06f1224cc355d0d5fffb0a65b831790b2845,1,2,1,3,1,2008-01-07 02:41:44,2008-01-05 09:57:44
47ee06f1224cc355d0d5fffb0a65b831790b2845...64cc1c0909949fa2866ad71ad2d1ab7ccaa673d9,1,8,2,10,4,2008-01-07 02:41:44,2008-01-06 17:21:10
64cc1c0909949fa2866ad71ad2d1ab7ccaa673d9...42616335479fe4852307acdb185e27c09188642c,1,12,1,13,2,2008-01-07 02:41:44,2008-01-06 17:35:02
42616335479fe4852307acdb185e27c09188642c...8b30aa50593b159791fe1478cb5725caaf219d06,1,12,2,14,3,2008-01-07 02:41:44,2008-01-06 11:12:24
8b30aa50593b159791fe1478cb5725caaf219d06...5e3cb7e5038f99d442c484d5839bd6bf02adb58c,1,18,2,20,3,2008-01-07 02:41:44,2008-01-06 11:13:01
5e3cb7e5038f99d442c484d5839bd6bf02adb58c...40f162b04b3d5155a7e41d27c9f52383a5fa5a9f,1,31,3,34,5,2008-01-07 02:41:44,2008-01-06 11:13:36
40f162b04b3d5155a7e41d27c9f52383a5fa5a9f...396ccf1fcb91f31d5060555cbffc35bf24172a35,2,24,6,30,5,2008-01-07 04:27:35,2008-01-07 03:02:22
396ccf1fcb91f31d5060555cbffc35bf24172a35...44b25b872f926ba92bae9ddf2495e7f59d0c96e2,2,54,34,88,18,2008-01-07 04:53:46,2008-01-02 09:49:58
44b25b872f926ba92bae9ddf2495e7f59d0c96e2...23707811c56a7756cbd6188e510f0a486c35c929,2,69,0,69,7,2008-01-07 06:44:44,2008-01-02 09:50:11
23707811c56a7756cbd6188e510f0a486c35c929...b2e62a7dc6ba20a354d7590bf6a1d9264de7efe3,1,13,2,15,4,2008-01-07 06:46:13,2008-01-07 06:20:40
b2e62a7dc6ba20a354d7590bf6a1d9264de7efe3...f1cdcc70dc654a5364871a8712c073a610b6027b,3,5,5,10,5,2008-01-07 22:02:00,2008-01-07 21:43:27
f1cdcc70dc654a5364871a8712c073a610b6027b...7ec43959f779fa75278c204a71acd4572acc9a1e,1,1,1,2,1,2008-01-07 22:02:25,2008-01-07 21:05:22
7ec43959f779fa75278c204a71acd4572acc9a1e...2e8fd7819521b43e89f3baa9c6a95042ed7da4b4,1,5,2,7,1,2008-01-08 05:00:54,2008-01-07 07:37:38
2e8fd7819521b43e89f3baa9c6a95042ed7da4b4...983a9eebdc0a964b2bd2762f5993c139cfe9ee71,1,33,0,33,3,2008-01-08 06:23:58,2008-01-08 03:55:14
1e931cb4d197e30504b6d2cc77b0b045b0167df6...2ea7fe0d2c15a88e7e3131ad5e7e83c7320d8d0c,1,38,6,44,5,2007-12-09 08:55:46,2007-12-09 06:52:59
2ea7fe0d2c15a88e7e3131ad5e7e83c7320d8d0c...6b95655d7d2a5378e409ea0754b9b8d32ed939f8,1,2,1,3,1,2007-12-09 08:55:54,2007-12-08 11:38:07
6b95655d7d2a5378e409ea0754b9b8d32ed939f8...aa6da6cddb65c3889751d0b06a7e3d339e303b1b,1,1,1,2,1,2007-12-09 08:55:54,2007-12-08 11:38:08
aa6da6cddb65c3889751d0b06a7e3d339e303b1b...740001a5780a12972c83c99f25c49c8d8cebdb43,2,7,4,11,3,2007-12-09 08:55:55,2007-12-09 07:23:20
740001a5780a12972c83c99f25c49c8d8cebdb43...264474f29a3f41124f98e955b41ebe4e36d14b53,3,153,1,154,3,2007-12-09 08:55:55,2007-12-08 12:29:47
264474f29a3f41124f98e955b41ebe4e36d14b53...774751a8bc594a5b56039bbdc43c45e3882dd804,8,26,29,55,21,2007-12-09 08:55:55,2007-12-09 01:32:08
1e931cb4d197e30504b6d2cc77b0b045b0167df6...4602c17d8911e14d537f6f87db02faab6e3f5d69,1,12,0,12,3,2007-12-08 19:32:05,2007-12-08 01:19:31
4602c17d8911e14d537f6f87db02faab6e3f5d69...6508bb75f675a09f410ab55b842510d36c373c43,1,5,2,7,2,2007-12-11 17:56:27,2007-12-11 12:33:12
6508bb75f675a09f410ab55b842510d36c373c43...97566ea72ea460576ccaea7b51dd32ab33e1c46c,1,1,1,2,1,2007-12-11 17:57:29,2007-12-11 14:43:51
97566ea72ea460576ccaea7b51dd32ab33e1c46c...3384a2dfc12f0fecd25ecfd6bfa9ee0d82517bf2,5,19,19,38,8,2007-12-12 01:01:31,2007-12-11 18:09:04
0bdb5af7a571ee2bd71550a545632b1cb7f8f8f3...3f2a7ae2c84c921e11041a5edc2522964fc1cce5,2,1,7,8,2,2007-10-31 19:20:05,2007-10-31 19:20:05
057bc808b4aa2e7795f9bd395e68071301bc0b74...e02cd6388f0193706279268a7d9fa57be4cbc997,1,35,28,63,18,2006-11-12 02:26:57,2006-11-10 19:53:41
0d7a6e4ef9e2dc458a9a56ab73638d97f4e75d87...b42a044f5942c64bbc94aa2f4637d8290748e634,1,12,8,20,3,2006-12-13 09:48:44,2006-11-25 06:38:18
b42a044f5942c64bbc94aa2f4637d8290748e634...155bd0ce23144e5c7067965a22646523f1a38b51,1,1,1,2,1,2006-12-13 09:51:35,2006-12-12 22:47:02
3c7ceba4f1e8be1a536dd0e21bc4f422873d08d2...e31c9f241ae5469c820cde2a54987a1075e52a43,1,10,9,19,7,2006-03-15 21:19:27,2006-03-15 08:37:57
3103cf9e1e09b0045a60542f24a2a1e4ed7b1237...b0d08a504bee17dfc46f761e166ff2c20c59a91a,2,10,10,20,2,2006-03-22 19:06:19,2006-03-22 09:53:57
b0d08a504bee17dfc46f761e166ff2c20c59a91a...8a8e623514d79f006d9b83c47248435f20d4be2a,1,10,1,11,3,2006-03-24 07:43:52,2006-03-24 07:43:52
3103cf9e1e09b0045a60542f24a2a1e4ed7b1237...cf46e7b8999f25d5d7f2acd64701a100e403ee03,1,3,1,4,1,2006-03-22 09:09:43,2006-03-22 09:09:43
cf46e7b8999f25d5d7f2acd64701a100e403ee03...8323124afe49353e09d041eb8ed3be4c2477c180,1,7,1,8,1,2006-03-22 09:57:11,2006-03-22 09:57:11
3103cf9e1e09b0045a60542f24a2a1e4ed7b1237...dc68c4fff4cd007d840193ebb11ef1f31a779c75,1,10,1,11,3,2006-03-22 08:22:00,2006-03-22 08:22:00
2f8acdb38e513e4b983209563faf4c1d38c4013e...c51d13692d4e451c755dd7da3521c5db395df192,1,12,11,23,3,2006-03-21 09:42:04,2006-03-21 09:42:04
cdc08b33ef3da0e963f9956e4a66f67cc3330f83...a84faf777075e54f9faf22dbc6345fd756cd0c8d,1,3,4,7,1,2006-05-03 22:33:32,2006-05-03 22:32:54
a84faf777075e54f9faf22dbc6345fd756cd0c8d...c2b9ae43303342a33b2632939f319a3554f3a70c,1,2,0,2,1,2006-05-03 23:07:02,2006-05-03 23:07:02
c2b9ae43303342a33b2632939f319a3554f3a70c...00703e6d6822f81e7b22d079b7e6d9d044f46cf0,1,6,2,8,3,2006-05-03 23:10:45,2006-05-03 23:10:45
cdc08b33ef3da0e963f9956e4a66f67cc3330f83...f4c6f2d328e2f30ad63fdfca26a5e4a11cef35bf,2,75,8,83,12,2006-05-02 05:29:16,2006-01-15 05:46:58
f4c6f2d328e2f30ad63fdfca26a5e4a11cef35bf...6bd20358a9b831b3b545284188871bc844245c25,5,67,6,73,12,2006-05-02 05:29:16,2006-04-26 08:20:50
49e3343c9fe0e134e0a8c1ec0ddeb64ae18ee9fd...04e4888e5a6db847368a95eb986202fa460b2153,1,52,20,72,24,2006-05-16 00:56:53,2006-05-15 22:15:47
04e4888e5a6db847368a95eb986202fa460b2153...b7627278e200d8a80df6ee437b1a01d88f2b4883,1,2,36,38,2,2006-05-16 00:57:01,2006-05-16 00:25:43
613f02739a49337592a32936caa04b1590ca1109...6d6776cb497ea7fbf5fe43912dbe3286f76c9933,1,12,4,16,4,2006-05-15 19:23:04,2006-05-15 15:09:31
1362671f6a716e1a34abbcab43adfb68c7e2fd3b...a24f1e254e9dbea80b8173d72e0f75fec25b38a7,1,1,1,2,1,2006-05-02 08:28:02,2006-05-02 08:28:02
7aaf83dafbde7aaa60a1e220e967faaeb28a46f6...54eb2d3ff91bf7a914b6e1de9cf8f748d6a9ecb4,1,3,2,5,2,2006-05-02 06:40:37,2006-05-02 06:40:37
262a6ef76a1dde97ab50d79fa5cd6d3f9f125765...ced9456a27197fc038fbc5b5ebad87e55f1920d2,1,23,3,26,4,2006-05-02 19:42:12,2006-05-02 12:32:43
ced9456a27197fc038fbc5b5ebad87e55f1920d2...e923effb43fa952f9cb72ffe4c3625fce7655bff,1,8,1,9,2,2006-05-02 21:59:58,2006-05-02 21:44:36
a5c8a98ca7e978c334e956df7ae2165c75c494da...9c7466fa248608ff8a91f8b4dca48dac7dda02d5,1,26,12,38,5,2006-05-25 05:25:49,2006-05-25 03:33:18
9c7466fa248608ff8a91f8b4dca48dac7dda02d5...d7fb7a373a8ea4a8ecf6421be92226bab74f474e,2,32,3,35,3,2006-05-25 05:26:47,2006-05-25 03:34:04
cb8f64b4e3f263c113b7a2f156af74b810e969ff...78fff6ebbafe2d23464a2b059104954bfe8732c7,2,15,4,19,5,2006-04-16 22:34:37,2006-04-16 22:17:23
3a950e9a9cfc2eb4e30cf6e8658dab25196d746e...a8d610a2a39496a83108d95e7899e6b373e80940,1,17,0,17,5,2007-04-19 01:39:12,2007-04-19 01:39:12
f7a3276bab880222e3117f8b8cbef40920dfe884...639ca5497279607665847f2e3a11064441a8f2a6,1,0,5,5,2,2006-05-10 17:53:59,2006-05-10 16:26:08
84c667ff97da2a3864ef7952b9f438d133ce35ef...e686eba41f1d19a5731dd12cabe259fd3c17eed6,1,9,1,10,2,2006-05-25 04:36:14,2006-05-25 04:36:14
e686eba41f1d19a5731dd12cabe259fd3c17eed6...4acdeafe5e0eb3c7ccea0608032346ca6ffbb810,1,1,0,1,1,2006-05-25 05:14:29,2006-05-25 02:48:39
4acdeafe5e0eb3c7ccea0608032346ca6ffbb810...ed90cbf5f681c0144909457be3f4792b47604a5b,1,7,2,9,4,2006-05-25 05:29:23,2006-05-25 01:22:32
c65e898754ef68a5520b2791890dda51753d00c6...4788d11a0d2ff872d25840768b2266e936a0b1fc,1,40,5,45,9,2006-02-22 10:06:42,2006-02-20 15:20:10
eb38cc689e84a8fd01c1856e889fe8d3b4f1bfb4...e646de0d14bac20ef6e156c1742b9e62fb0b9020,1,56,13,69,15,2006-02-24 07:44:42,2006-02-23 06:10:24
a348ab702a84983c258e4961a58b1b9502f428c8...b992933853ccffac85f7e40310167ef7b8f0432e,1,3,3,6,3,2006-02-22 00:48:10,2006-02-21 12:08:21
b19696c2e7c3e753777189100b2ac09c9e04080b...b925410d10fce5e0d4182847f99e8c2df048bde1,1,10,6,16,6,2006-02-23 05:45:45,2006-02-23 05:45:45
a204756a45bd357280c156d01858138712493dfa...a64dd34d8cce018742badb49b87c5c565be655ce,1,4,0,4,1,2006-03-01 12:08:12,2006-03-01 04:19:47
a64dd34d8cce018742badb49b87c5c565be655ce...b9003c06a89a6d78255bb837c921ca03ee27fae6,1,6,4,10,5,2006-03-01 12:09:40,2006-02-27 12:52:50
b9003c06a89a6d78255bb837c921ca03ee27fae6...feffaddce0cec7fd3f749d23e95579b683961002,1,2,2,4,2,2006-03-01 12:09:41,2006-02-27 12:52:52
feffaddce0cec7fd3f749d23e95579b683961002...573464319f70bd54a7c48cfd7bed6a0f6f331f42,1,9,0,9,1,2006-03-01 20:12:53,2006-02-19 07:42:03
573464319f70bd54a7c48cfd7bed6a0f6f331f42...5e6f85f6c1d988d125dfcba16bb43a9a65f9eab3,1,10,6,16,4,2006-03-01 20:13:44,2006-03-01 17:16:36
5e6f85f6c1d988d125dfcba16bb43a9a65f9eab3...9e7c73de0bcd410d12f897b19419dd35accd961e,1,14,12,26,5,2006-03-01 20:13:46,2006-03-01 18:09:23
a204756a45bd357280c156d01858138712493dfa...1187df57c2ee1119b7ef357cacb63d10581256bc,1,33,0,33,3,2006-02-28 01:35:59,2006-02-26 17:29:00
1187df57c2ee1119b7ef357cacb63d10581256bc...5c7b580c94b4217803a116e24a3ad924bfb35f86,1,54,23,77,15,2006-02-28 01:35:59,2006-02-27 02:13:25
5c7b580c94b4217803a116e24a3ad924bfb35f86...59aa256204f74e02579d7586884c73f0db6eb0d6,1,45,8,53,6,2006-02-28 01:35:59,2006-02-27 22:16:30
59aa256204f74e02579d7586884c73f0db6eb0d6...383e20b6144d01286c90c0c82d88f92173a038f6,3,51,24,75,12,2006-02-28 01:36:00,2006-02-27 22:47:45
383e20b6144d01286c90c0c82d88f92173a038f6...5c0d46eb3d5ab9182a2c6d942189671720f80f74,1,6,2,8,3,2006-02-28 01:36:00,2006-02-28 01:07:16
5c0d46eb3d5ab9182a2c6d942189671720f80f74...56248c5a5c77f65fe591dfec3ac413147d227ec4,1,11,0,11,3,2006-02-28 09:17:14,2006-02-28 09:12:52
56248c5a5c77f65fe591dfec3ac413147d227ec4...12cbbdc40b50458b29b76af740ddc0ab1979b322,1,9,4,13,6,2006-03-01 06:38:40,2006-03-01 04:26:25
2718435b7b746c3c249525b02fbcbad68f5a45f3...e3c3a550d4815d34b5674776c36cdd6d8a31ab85,4,7,12,19,10,2006-02-06 06:25:00,2006-02-06 06:25:00
e3c3a550d4815d34b5674776c36cdd6d8a31ab85...45392a648d7449d237ecc2507bc92378bf920bf0,1,39,26,65,12,2006-02-06 07:00:41,2006-02-06 07:00:41
2718435b7b746c3c249525b02fbcbad68f5a45f3...9ad0a9333079359cbce8fd2448eb7478786e1150,1,9,7,16,6,2006-02-06 05:49:42,2006-02-06 05:41:47
49e6be571ecbcc3884bdd2262d974ec9ac051c49...bbff2dce2baf840cca6ddfd79be3c27f93322f47,2,19,2,21,5,2007-12-27 02:16:52,2007-12-27 02:16:52
bbff2dce2baf840cca6ddfd79be3c27f93322f47...c45857019c95ee8ffbf843bdb778ced0cfd4f6fb,1,1,1,2,1,2007-12-28 07:29:53,2007-12-28 07:29:53
c45857019c95ee8ffbf843bdb778ced0cfd4f6fb...3f4bc3e048280a564e85569549a311f716dae277,1,9,0,9,2,2007-12-29 00:11:29,2007-12-28 22:25:39
3f4bc3e048280a564e85569549a311f716dae277...441ed4131b2d735fea08e4f6277c12b13acebd53,1,40,26,66,3,2007-12-29 05:01:24,2007-12-28 21:58:43
441ed4131b2d735fea08e4f6277c12b13acebd53...d6ed263fc7458e97ad032837ffdab6013d039543,1,0,2,2,2,2007-12-30 20:24:13,2007-12-30 17:15:51
d6ed263fc7458e97ad032837ffdab6013d039543...8ad1065e580c03035c583e2d237cc5b76f90cee4,1,4,2,6,3,2007-12-30 20:37:59,2007-12-30 20:37:59
8ad1065e580c03035c583e2d237cc5b76f90cee4...ab11903225270be7001b8c92f6ac4e165eaf4ecf,1,19,10,29,2,2007-12-30 20:51:42,2007-12-30 20:51:42
97d0c52980f0e64f0feed5b31390a32561df0ecf...e25cfae6677423d05a81c0862f58d3319141794c,1,197,0,197,1,2007-12-27 01:38:00,2007-12-27 01:38:00
09955207d148c5f3964002b7f3a4e13db3050777...a2d6b872dbf4e65525c9ba55e820e2ea26011ce1,1,1,1,2,1,2007-10-18 04:59:25,2007-10-17 22:27:51
a2d6b872dbf4e65525c9ba55e820e2ea26011ce1...93a56c2cf7c8b29ca4c5e0740fe1e487324ffc73,1,4,1,5,1,2007-10-18 05:35:33,2007-10-12 11:40:57
93a56c2cf7c8b29ca4c5e0740fe1e487324ffc73...cd8ae20195ae09c06d0854f1ebf92d1f1164c927,2,75,0,75,2,2007-10-18 06:31:30,2007-10-18 06:31:30
cd8ae20195ae09c06d0854f1ebf92d1f1164c927...2a4b5d5a0701a5f9a953883e21a6e3dc71cd5cc7,1,4,2,6,1,2007-10-18 07:02:15,2007-10-17 14:05:47
2a4b5d5a0701a5f9a953883e21a6e3dc71cd5cc7...1aa3d01f870a68dc46a872c83f9cd051f172f9b3,1,8,0,8,3,2007-10-18 07:11:03,2007-10-18 07:11:03
193f7e98da72f1012515b0389525cf9a6a269849...31e7bded608416e3116f9c691a4d4314f10640b6,1,277,0,277,1,2007-11-23 01:41:45,2007-11-22 11:08:39
193f7e98da72f1012515b0389525cf9a6a269849...d63c2fd192271ea2d85c81edfad90aa42fec26ee,1,15,0,15,1,2007-11-23 01:04:56,2007-11-02 15:33:06
d63c2fd192271ea2d85c81edfad90aa42fec26ee...943316e96ca2dad67086af2f945e42467a27ddd6,2,5,1,6,3,2007-11-23 01:05:02,2007-11-02 15:33:08
943316e96ca2dad67086af2f945e42467a27ddd6...f5bbc3225c4b073a7ff3218164a0c820299bc9c6,6,621,9,630,13,2007-11-23 01:05:02,2007-11-08 16:59:00
f5bbc3225c4b073a7ff3218164a0c820299bc9c6...e97c9ad96b60d51b0b3852aaaff146015d01cb62,1,5,12,17,3,2007-11-23 01:05:02,2007-11-08 14:06:52
e97c9ad96b60d51b0b3852aaaff146015d01cb62...741707b1e2261d522a92948ff7d7b897ff00e587,1,8,7,15,2,2007-11-23 01:05:02,2007-11-08 12:15:26
741707b1e2261d522a92948ff7d7b897ff00e587...d37d320386369375b4e5b95b98517503125376f9,1,2,0,2,2,2007-11-23 01:05:03,2007-11-09 16:40:27
d37d320386369375b4e5b95b98517503125376f9...367c98866c340bc9cf5cfa88c3b69f027165fc44,5,146,29,175,28,2007-11-23 01:05:03,2007-11-11 17:35:41
367c98866c340bc9cf5cfa88c3b69f027165fc44...13208572fbe8838fd8835548d7502202d1f7b21d,3,38,14,52,7,2007-11-23 01:05:03,2007-11-11 17:35:58
13208572fbe8838fd8835548d7502202d1f7b21d...2150554b0ed60356d8918b610834c04ad2eecdec,2,5,1,6,3,2007-11-23 01:05:03,2007-11-11 17:36:27
2150554b0ed60356d8918b610834c04ad2eecdec...f9568530c97757d840171c685fd623e1f68bc552,1,20,6,26,6,2007-11-23 01:05:03,2007-11-11 17:36:39
f9568530c97757d840171c685fd623e1f68bc552...129fa606365c172d07a5d98bea9345277f221363,1,1,0,1,1,2007-11-23 01:05:03,2007-11-11 17:36:52
129fa606365c172d07a5d98bea9345277f221363...ef12b50d0cf0123377a6fb96584a287a6c24346b,1,1,0,1,1,2007-11-23 01:05:03,2007-11-12 20:48:22
ef12b50d0cf0123377a6fb96584a287a6c24346b...18abc2dba4973c3c2cff286fac3340e95e0ee474,1,3,5,8,4,2007-11-23 01:05:04,2007-11-14 15:31:53
18abc2dba4973c3c2cff286fac3340e95e0ee474...1200993a1e885fd67d1a1d63da9d2a0e1ee5bcea,1,10,0,10,1,2007-11-23 01:05:04,2007-11-15 14:49:58
1200993a1e885fd67d1a1d63da9d2a0e1ee5bcea...637efc3456576d548ed5b42e70deffca42e7428e,2,3,3,6,3,2007-11-23 01:05:04,2007-11-15 06:27:57
637efc3456576d548ed5b42e70deffca42e7428e...a50f9fc5feb0a8b8afe51e75ae7c7a87446113e3,1,3,4,7,2,2007-11-23 01:05:04,2007-11-18 09:58:16
a50f9fc5feb0a8b8afe51e75ae7c7a87446113e3...bc5d248a9fba11cb78dd0a3a91938d881dec1245,2,5,1,6,4,2007-11-23 01:05:04,2007-11-18 20:01:38
bc5d248a9fba11cb78dd0a3a91938d881dec1245...e06ad5ffb9f8d4207d676fadd675cf1b949ce358,1,1,1,2,1,2007-11-23 01:05:04,2007-11-18 20:21:17
e06ad5ffb9f8d4207d676fadd675cf1b949ce358...ee425e4643aa2d7be72cb4586d7554cecce44d6e,2,58,46,104,14,2007-11-23 01:05:05,2007-11-18 09:13:32
ee425e4643aa2d7be72cb4586d7554cecce44d6e...b6ec1d619fb54642388063a88e2255556cf5de06,3,8,5,13,7,2007-11-23 01:05:05,2007-11-18 09:12:04
b6ec1d619fb54642388063a88e2255556cf5de06...2888605c649ccd423232161186d72c0e6c458a48,1,202,40,242,34,2007-11-23 01:05:05,2007-11-18 09:52:55
2888605c649ccd423232161186d72c0e6c458a48...99a12694582e2148fcd492f1eedaddcfe2a21621,2,23,1,24,4,2007-11-23 01:05:05,2007-11-22 02:54:49
99a12694582e2148fcd492f1eedaddcfe2a21621...b468f0ce4881bf42ffc820b1cddad67dad17fd80,1,92,0,92,1,2007-11-23 07:20:59,2007-11-23 00:21:49
08e1812db1585c450bfe7f41e7106222346c88da...fe4aafba28036237c594e1324f83a388d88ab9db,1,3,1,4,1,2007-12-07 07:22:25,2007-12-06 19:07:03
fe4aafba28036237c594e1324f83a388d88ab9db...0f7a9c9b7bb1f443f8fd0f18cb66933b2f4ec410,2,23,0,23,2,2007-12-07 07:23:42,2007-12-07 01:27:20
6caaf2daf0ea50ff99009b94f24252b8fa747e64...3ddff72e581e5c7477aaeb8b97a17691f7ff55bf,1,2,1,3,1,2008-01-23 04:37:15,2008-01-22 15:40:13
3ddff72e581e5c7477aaeb8b97a17691f7ff55bf...3470adabad8c02be152a8d536d23df692eb386d6,1,3,0,3,1,2008-01-23 04:44:36,2008-01-23 04:44:36
3470adabad8c02be152a8d536d23df692eb386d6...2cd9ad2e71c57b283e8caf03de065bba1dff5f5f,1,22,3,25,1,2008-01-23 04:52:07,2008-01-23 04:52:07
2cd9ad2e71c57b283e8caf03de065bba1dff5f5f...3b8f19a02c3dd6043a7a6bdd65de2d4610c26b81,1,1,1,2,1,2008-01-23 04:56:15,2008-01-23 04:56:15
105c21df14531bf2fd39e05b4c3a9aa31349da06...ce33288ea6b81a2f4f5aecd72177bcc8174562ae,1,6,1,7,3,2008-01-21 01:05:11,2008-01-21 01:04:53
e708af6e587ae0ecb2a6480e3614c5ec4a164106...d8c3794503553c22330f46ed4c0e70a6613d2f65,1,1,1,2,1,2008-01-09 00:15:01,2008-01-08 23:46:18
d8c3794503553c22330f46ed4c0e70a6613d2f65...87e3d812943f3d9c5f9464b0aee83398dd9d028e,1,3,3,6,3,2008-01-09 00:17:44,2008-01-08 13:45:46
87e3d812943f3d9c5f9464b0aee83398dd9d028e...58152a02d99b499c338b633e7fe021b337313bd8,1,12,10,22,8,2008-01-09 00:17:44,2008-01-08 13:46:22
58152a02d99b499c338b633e7fe021b337313bd8...ef40b3efe0764f7b56c2745601690e9cc12428d8,1,13,11,24,4,2008-01-09 00:17:44,2008-01-08 13:49:09
3f2a7ae2c84c921e11041a5edc2522964fc1cce5...1e3a2eb667256716e101707f4da7179da2ba3c65,1,1,1,2,1,2007-11-01 22:14:16,2007-11-01 12:45:33
1e3a2eb667256716e101707f4da7179da2ba3c65...d9d10bb8549ca0353d13298e372c1c87bcc530ef,1,3,3,6,2,2007-11-01 22:14:38,2007-11-01 08:46:02
d9d10bb8549ca0353d13298e372c1c87bcc530ef...8451c565bceaf9c402fadba16d2b9c2dcf71bbc2,1,1,1,2,1,2007-11-01 22:18:45,2007-11-01 13:24:11
8451c565bceaf9c402fadba16d2b9c2dcf71bbc2...136e6316705e9e83cbb09c2a9ac4cb29c3e4662d,1,1,1,2,1,2007-11-01 22:19:43,2007-11-01 14:21:39
3f2a7ae2c84c921e11041a5edc2522964fc1cce5...6b6012e6ca628a00d2e0fa6f686017f9e2d66203,1,10,3,13,3,2007-11-01 06:51:13,2007-10-31 20:55:13
e02cd6388f0193706279268a7d9fa57be4cbc997...bae777db33951468824e6beed6de900e7db6d51f,1,2,2,4,1,2006-11-13 02:50:20,2006-11-12 21:28:43
bae777db33951468824e6beed6de900e7db6d51f...40cf043389ef4cdf3e56e7c4268d6f302e387fa0,1,1,1,2,1,2006-11-13 22:26:41,2006-11-13 13:50:04
40cf043389ef4cdf3e56e7c4268d6f302e387fa0...3d12d0cfbbda0feb6305d6c53f3cf9aae2330c4c,2,24,0,24,2,2006-11-13 22:26:51,2006-11-13 13:50:00
3d12d0cfbbda0feb6305d6c53f3cf9aae2330c4c...fe142b3a4577a6692a39e2386ed649664ad8bd20,4,195,20,215,13,2006-11-13 22:27:38,2006-11-12 15:29:42
155bd0ce23144e5c7067965a22646523f1a38b51...7da41f48c8acea834e8204917fe59da2b975903b,1,2,0,2,1,2006-12-14 10:40:33,2006-12-14 10:07:46
c51d13692d4e451c755dd7da3521c5db395df192...84a9b58c421f9b2d1cc6c195ed441fac48e60392,12,15,3,18,13,2006-03-24 07:41:18,2006-03-24 07:41:18
84a9b58c421f9b2d1cc6c195ed441fac48e60392...1b371f567d9b0094918e128262577b76994eef74,1,1,1,2,1,2006-03-24 07:42:40,2006-03-24 07:42:40
00703e6d6822f81e7b22d079b7e6d9d044f46cf0...6d60bbefdc2a42614069024b0a38db8c2de33967,1,5,0,5,1,2006-05-04 04:17:45,2006-05-04 04:17:45
6bd20358a9b831b3b545284188871bc844245c25...d6970e42a1763b549ccf93558de7f54a78819d7a,1,6,6,12,3,2006-05-17 10:16:27,2006-05-17 10:16:27
b7627278e200d8a80df6ee437b1a01d88f2b4883...d91d4c2c500b17d50359693a406a2c68b65330fe,1,6,4,10,1,2006-05-17 23:56:13,2006-05-17 23:56:13
6d6776cb497ea7fbf5fe43912dbe3286f76c9933...4e8da1958111796d55ad63b229ebd3ae6c54bf87,1,2,5,7,4,2006-05-15 19:31:21,2006-05-15 15:40:05
4e8da1958111796d55ad63b229ebd3ae6c54bf87...ff45715ce50b80ab16ee0d0dc7fff0c47a51959a,2,10,7,17,5,2006-05-15 19:32:13,2006-05-15 17:47:16
a24f1e254e9dbea80b8173d72e0f75fec25b38a7...f462ebb48bf9126335671e878336e3faf3914802,1,22,6,28,4,2006-05-02 22:17:05,2006-05-02 22:17:05
f462ebb48bf9126335671e878336e3faf3914802...f9b9faf6f8a408b7129e2c95234f698da2171f4b,1,51,21,72,11,2006-05-02 22:45:48,2006-05-02 22:40:49
f9b9faf6f8a408b7129e2c95234f698da2171f4b...2c866cf1c2b2f3a289b7f3c21adb4f05af6626e4,1,20,1,21,7,2006-05-02 22:46:32,2006-05-02 22:40:49
2c866cf1c2b2f3a289b7f3c21adb4f05af6626e4...7839a25eab7177024b809fbb3796907e3eed17c1,1,30,0,30,4,2006-05-02 23:08:57,2006-05-02 22:40:49
54eb2d3ff91bf7a914b6e1de9cf8f748d6a9ecb4...97d4df0b29d262df291985aed486e226b43132d0,1,39,0,39,2,2006-05-02 08:03:02,2006-04-30 13:23:48
97d4df0b29d262df291985aed486e226b43132d0...5a223a0d434c874984a0251eca4520ef95718a6d,1,51,4,55,8,2006-05-02 08:03:25,2006-04-30 13:24:03
e923effb43fa952f9cb72ffe4c3625fce7655bff...de5f2bf3612a43af074a98fd1fcdef6a403daf3f,3,4,4,8,3,2006-05-03 21:08:41,2006-05-03 10:51:40
d7fb7a373a8ea4a8ecf6421be92226bab74f474e...99bd0f555823f3c3868561af33d85864a90a7d9a,1,7,4,11,4,2006-05-31 22:23:44,2006-05-31 22:23:44
78fff6ebbafe2d23464a2b059104954bfe8732c7...db89665fbf86d4e0166b2f252a939ed8bf6782fe,1,3,0,3,1,2006-04-17 19:42:36,2006-04-17 19:42:36
db89665fbf86d4e0166b2f252a939ed8bf6782fe...9153983310a169a340bd1023dccafd80b70b05bc,11,151,185,336,69,2006-04-17 22:18:25,2006-04-17 18:59:32
9153983310a169a340bd1023dccafd80b70b05bc...eab144ac49c18d981261c2d0ba964d6380d9f1da,2,17,8,25,6,2006-04-18 04:43:15,2006-04-17 23:59:42
eab144ac49c18d981261c2d0ba964d6380d9f1da...a4d34e2db5565e6b75f79f9d3938aa9151e72e44,1,12,2,14,4,2006-04-18 04:44:33,2006-04-18 00:43:40
a4d34e2db5565e6b75f79f9d3938aa9151e72e44...b073f26b256cded6252bafd34982eb6f69d2a4b6,1,0,2,2,1,2006-04-18 04:47:35,2006-04-18 04:47:35
b073f26b256cded6252bafd34982eb6f69d2a4b6...965f803c323bb72a9dedbbc8f7ba00bbadb6cf58,1,19,5,24,9,2006-04-18 05:53:03,2006-04-18 05:53:03
a8d610a2a39496a83108d95e7899e6b373e80940...696cf493f76b5dfb13d415571742a72034393a4a,1,1,1,2,1,2007-05-22 00:06:39,2007-05-21 23:52:00
696cf493f76b5dfb13d415571742a72034393a4a...60378c0c0996522600dc31864dc60f5ca7d84529,1,23,3,26,11,2007-05-22 00:07:05,2007-05-20 16:12:48
60378c0c0996522600dc31864dc60f5ca7d84529...59ddaf3d19c174ab1547f4d8c0d76c564ddbf440,1,2,1,3,2,2007-05-22 00:07:05,2007-05-20 15:45:49
59ddaf3d19c174ab1547f4d8c0d76c564ddbf440...7e12f1a6291032a311ab592e42fd38f5ec358c0e,1,13,4,17,11,2007-05-22 00:07:05,2007-05-20 15:45:50
7e12f1a6291032a311ab592e42fd38f5ec358c0e...e11f12331552427113bcfd3721008ffc7227aac0,1,890,350,1240,91,2007-06-23 10:55:22,2007-06-16 10:29:25
e11f12331552427113bcfd3721008ffc7227aac0...0a4dd8b855fb5e4997087badbb6291cfc3f57baf,1,24,18,42,4,2007-06-23 10:55:26,2007-06-16 11:21:57
0a4dd8b855fb5e4997087badbb6291cfc3f57baf...3fc4279a144d0c477749fbe5318e570739f569e2,1,12,0,12,6,2007-06-23 10:55:30,2006-09-14 23:45:23
3fc4279a144d0c477749fbe5318e570739f569e2...e507fd4871acc52cc95934d3d5a6faa04d504ec9,1,30,8,38,10,2007-06-23 10:55:34,2007-06-16 11:51:08
e507fd4871acc52cc95934d3d5a6faa04d504ec9...7eb3cb9c683624681541972910328054e9431b43,1,310,253,563,78,2007-06-23 10:55:38,2007-06-17 04:45:00
7eb3cb9c683624681541972910328054e9431b43...43c25074381dea404518318dacd360ed4f2abf3d,1,14,6,20,3,2007-06-23 10:55:43,2006-09-27 00:56:02
43c25074381dea404518318dacd360ed4f2abf3d...00609463979c3a2549c0c917a206345f51975b5d,1,8,1,9,3,2007-06-23 10:55:47,2007-06-17 07:08:35
00609463979c3a2549c0c917a206345f51975b5d...66e46f37de3ed3211a8ae0e8fc09c063bc3a1e08,1,28,48,76,19,2007-06-23 10:55:52,2006-10-14 09:21:02
66e46f37de3ed3211a8ae0e8fc09c063bc3a1e08...322a8cc9b31217c883c42b9babbbdea7f522eeb7,1,297,185,482,53,2007-06-23 10:55:57,2006-10-15 08:03:46
322a8cc9b31217c883c42b9babbbdea7f522eeb7...219ea3a99b9d4253815bcd71fd78eb00665acdbb,1,284,53,337,61,2007-06-23 10:57:39,2006-09-07 00:21:39
219ea3a99b9d4253815bcd71fd78eb00665acdbb...62d3ea65a7f7f01b72db7f318029be0b0ede5a28,1,31,34,65,6,2007-06-23 10:57:55,2006-09-11 00:36:53
62d3ea65a7f7f01b72db7f318029be0b0ede5a28...6a90bff1e83bb25898ead28d7d3f426dfdfdbe71,1,17,29,46,27,2007-06-23 10:58:01,2007-06-17 23:48:23
6a90bff1e83bb25898ead28d7d3f426dfdfdbe71...6fb735aedb25eade3d523053cb05c030a1cc06b3,1,57,5,62,5,2007-06-23 10:58:04,2006-10-19 00:09:06
6fb735aedb25eade3d523053cb05c030a1cc06b3...a2c22362cc2c0bb0451bc8098b3ba0c9353ebe02,1,7,1,8,3,2007-06-23 10:58:06,2006-10-31 04:00:53
a2c22362cc2c0bb0451bc8098b3ba0c9353ebe02...f3326b66bf8d77c19b5ca7ad70e536251c81cccb,1,11,3,14,6,2007-06-23 10:58:09,2007-06-18 12:39:21
f3326b66bf8d77c19b5ca7ad70e536251c81cccb...9396cd385ad47f9ecb440221bbff4514f4378f7f,1,84,51,135,16,2007-06-23 10:58:12,2007-06-23 10:28:15
9396cd385ad47f9ecb440221bbff4514f4378f7f...706d6c3e76fc5f7f988b056015689b489eb8f6b5,1,45,7,52,5,2007-06-26 01:14:06,2007-06-26 01:09:49
ed90cbf5f681c0144909457be3f4792b47604a5b...e49289dfb788ce47af2939621540fa97abe318ae,1,1,1,2,1,2006-05-25 07:18:42,2006-05-24 13:58:28
e49289dfb788ce47af2939621540fa97abe318ae...c53603249c8fc8ee5e12710087e7287eb6dda5f6,2,4,4,8,2,2006-05-26 05:48:45,2006-05-25 12:37:46
c53603249c8fc8ee5e12710087e7287eb6dda5f6...4d599e6bb46d6ef3276425af34922fdbf3aac473,1,2,1,3,1,2006-05-26 05:55:24,2006-05-25 15:22:42
4d599e6bb46d6ef3276425af34922fdbf3aac473...fc36f6a6c9e6d428dafee47f140f943b3e520240,1,20,14,34,11,2006-05-26 05:57:06,2006-05-25 16:52:01
fc36f6a6c9e6d428dafee47f140f943b3e520240...fa0f02dfa15d0d95f8b6d27688bbf8ac940e3354,1,13,3,16,5,2006-05-26 06:19:35,2006-05-25 21:55:11
ed90cbf5f681c0144909457be3f4792b47604a5b...f061e5fdd6a65216976a8bd547b2340e6297217b,1,16,0,16,5,2006-05-25 05:30:56,2006-05-25 04:48:34
481176f752f204316ec570c8ab3fdf0c297b3259...347f1d2608471cbc64f1cf25943f8d6f89256d2c,1,1,1,2,1,2006-05-31 04:46:03,2006-05-27 17:57:29
347f1d2608471cbc64f1cf25943f8d6f89256d2c...d6859901012535b3781e5332923ede51d5977395,1,23,9,32,6,2006-05-31 04:47:29,2006-05-30 14:58:52
d6859901012535b3781e5332923ede51d5977395...2b6016263c984b71b29373fc9354d497cd51947d,1,2,2,4,2,2006-05-31 04:49:01,2006-05-29 00:34:34
2b6016263c984b71b29373fc9354d497cd51947d...1361fa3e49717de9588e6d925073eb6885cedaa3,1,8,3,11,2,2006-05-31 06:09:02,2006-05-29 07:17:18
b925410d10fce5e0d4182847f99e8c2df048bde1...1d6b38cc76c348e2477506ca9759fc241e3d0d46,1,44,16,60,11,2006-02-23 07:07:20,2006-02-23 06:10:24
1d6b38cc76c348e2477506ca9759fc241e3d0d46...b76f6b627802d0a3c8bbf66fba0c090dbe56d509,1,17,4,21,1,2006-02-24 07:04:52,2006-02-24 07:04:52
b76f6b627802d0a3c8bbf66fba0c090dbe56d509...eeef7135fed9b8784627c4c96e125241c06c65e1,1,32,1,33,5,2006-02-24 07:51:01,2006-02-24 07:27:49
e1a0c8b1483b38d32d3870408e03a6c1b340aa15...1142038098810a69e57d88554559e4e6116df177,1,4,2,6,2,2006-03-02 07:20:01,2006-03-02 07:10:00
e1a0c8b1483b38d32d3870408e03a6c1b340aa15...a0f15fa502d4451a1d0041a431f43ff5519536dd,2,125,15,140,7,2006-03-02 01:06:20,2006-03-02 00:43:19
a2c641c4ab66b5bdcb62c36a5f748b9f929d61b8...f22fd75c6a39a72d6bf20786ba889fb73038bec9,1,13,4,17,4,2006-02-06 19:22:07,2006-02-06 19:17:56
f22fd75c6a39a72d6bf20786ba889fb73038bec9...960c7021b3b90f93aa88358435d828e5f4cd1533,1,19,22,41,12,2006-02-06 20:27:33,2006-02-06 20:27:33
960c7021b3b90f93aa88358435d828e5f4cd1533...9843a1f6fdb31eed5db774a6d6f99ab0758642a3,1,17,6,23,4,2006-02-06 20:30:00,2006-02-06 20:30:00
9843a1f6fdb31eed5db774a6d6f99ab0758642a3...2454c962fbe82f23aac4a5d78a0c3b5ffaed83a0,3,48,15,63,20,2006-02-06 21:06:49,2006-02-06 20:53:07
2454c962fbe82f23aac4a5d78a0c3b5ffaed83a0...4462731e0597c31c68466601a5d74b2edb145d6d,1,14,10,24,11,2006-02-07 02:54:08,2006-02-07 02:54:08
4462731e0597c31c68466601a5d74b2edb145d6d...3598a308086d4a41cab1e941df7763f2004e53c5,3,94,81,175,6,2006-02-07 05:14:55,2006-02-05 22:43:47
3598a308086d4a41cab1e941df7763f2004e53c5...85a97d4e10c1ac4b87e856e2efe7bcd53d6868c3,5,26,19,45,19,2006-02-07 05:14:56,2006-02-05 23:29:49
85a97d4e10c1ac4b87e856e2efe7bcd53d6868c3...cc55aaec38ddebd2e6f69fc3895cec393a61956e,1,3,3,6,2,2006-02-07 05:14:57,2006-02-06 00:42:27
cc55aaec38ddebd2e6f69fc3895cec393a61956e...8bc5c04a715ee0746df2bcd7e0924f4119140ad2,1,3,0,3,1,2006-02-07 05:37:53,2006-02-07 05:35:25
8bc5c04a715ee0746df2bcd7e0924f4119140ad2...1b1fdf8c2f935e2195d3ca5c37e578bd9146a82f,3,34,2,36,7,2006-02-07 05:43:27,2006-02-04 06:04:14
1b1fdf8c2f935e2195d3ca5c37e578bd9146a82f...1cb303872ab1ba73fcc52167c61fc4211c843cf5,1,77,2,79,8,2006-02-07 05:52:08,2006-02-04 03:20:16
1cb303872ab1ba73fcc52167c61fc4211c843cf5...8389b52b2a51d5b110b508cc67f0f41f99c30d3f,8,408,2,410,8,2006-02-07 05:53:11,2006-01-29 07:15:24
8389b52b2a51d5b110b508cc67f0f41f99c30d3f...130fcca63fe8e7e087e7419907e018cbbaf434a3,4,354,122,476,39,2006-02-07 07:20:32,2006-02-05 08:07:44
130fcca63fe8e7e087e7419907e018cbbaf434a3...5a798fb57f788692467b1a11416dd5ebff0d31ae,1,73,40,113,21,2006-02-07 07:20:32,2006-02-06 00:08:01
c477553b2f4f621216b25800e121af52e0750087...02e5ba4ae63729c28704280f1b8cfcb205c06960,2,46,5,51,8,2008-01-02 10:28:54,2008-01-01 06:17:34
02e5ba4ae63729c28704280f1b8cfcb205c06960...49b9362fd35d45dc94ea15006c4bb88671b8da7d,2,31,0,31,2,2008-01-02 10:28:54,2007-12-31 07:13:52
49b9362fd35d45dc94ea15006c4bb88671b8da7d...5f7b202a7fa8ffbf076c456106750b2bb7732ba4,2,22,10,32,9,2008-01-02 10:28:54,2008-01-02 06:33:20
5f7b202a7fa8ffbf076c456106750b2bb7732ba4...99a6a97b1bf866d7050e8afb137b4b29507f0caa,1,5,1,6,1,2008-01-02 10:28:54,2007-12-29 19:22:14
99a6a97b1bf866d7050e8afb137b4b29507f0caa...eab827072d1e197eb6ccb6f75e7fe86143735f1e,1,12,2,14,2,2008-01-02 10:28:54,2008-01-02 07:39:21
eab827072d1e197eb6ccb6f75e7fe86143735f1e...7dfa16b9dc89c14c8e351cb70d775a21e87d5c23,1,2,2,4,3,2008-01-02 18:43:54,2008-01-02 18:09:49
7dfa16b9dc89c14c8e351cb70d775a21e87d5c23...321b1842dceb94bbaa00b9f75c7c2fe6bf6fad1c,1,6,3,9,3,2008-01-02 18:44:22,2008-01-02 18:10:03
321b1842dceb94bbaa00b9f75c7c2fe6bf6fad1c...257f3020f69f3222cdefc1d84b148fb35b2c4f5b,3,12,9,21,4,2008-01-02 19:20:09,2008-01-02 19:14:40
257f3020f69f3222cdefc1d84b148fb35b2c4f5b...698a68be7b0df6dd8d0880e0e2167cad8688a6ad,2,11,9,20,3,2008-01-03 09:23:12,2008-01-03 09:23:12
698a68be7b0df6dd8d0880e0e2167cad8688a6ad...790296fd8863d649054096191d33bacbbf5c2115,6,6,6,12,6,2008-01-03 17:15:17,2008-01-03 14:18:07
790296fd8863d649054096191d33bacbbf5c2115...95bf4bd4f7280312571e642339f3571310d0d660,1,15,6,21,8,2008-01-04 03:04:37,2008-01-04 03:04:37
95bf4bd4f7280312571e642339f3571310d0d660...872c930dcb048c1a2b50e6ce881c521dcee15e23,6,6,6,12,6,2008-01-04 20:28:58,2008-01-04 17:37:41
872c930dcb048c1a2b50e6ce881c521dcee15e23...061d6b9a7bfcf88ff3895aa1be8424ae1647cbca,1,2,1,3,1,2008-01-04 23:59:43,2008-01-04 19:37:17
061d6b9a7bfcf88ff3895aa1be8424ae1647cbca...9a1805a8726ee41f25be2e0f2d5f38f1150d38e4,5,10,3,13,5,2008-01-05 00:05:23,2008-01-04 08:59:34
9a1805a8726ee41f25be2e0f2d5f38f1150d38e4...e467193ff3f57171c5c3232b4ba3595970efbfb5,1,8,3,11,3,2008-01-05 00:22:01,2008-01-04 09:16:14
e467193ff3f57171c5c3232b4ba3595970efbfb5...cae6c25a7fdd7a316318c2efdc48e63cce36a68c,1,0,9,9,2,2008-01-05 00:22:07,2008-01-04 09:45:31
cae6c25a7fdd7a316318c2efdc48e63cce36a68c...cf9d58e4f388dc173b86143fbfe0eac114e3ed2f,1,2,2,4,2,2008-01-05 06:01:28,2008-01-04 09:53:32
1aa3d01f870a68dc46a872c83f9cd051f172f9b3...42a32174b600f139b489341b1281fb1bfa14c252,1,1,1,2,1,2007-10-19 00:37:52,2007-10-18 23:24:47
42a32174b600f139b489341b1281fb1bfa14c252...fd0b9594d0c2bb50469bfc1481ea4395b7a76548,1,11,0,11,1,2007-10-19 00:51:16,2007-10-18 16:15:44
fd0b9594d0c2bb50469bfc1481ea4395b7a76548...415e7b877c54440bf92137a7021416efdf0a29b5,1,4,0,4,1,2007-10-19 01:04:44,2007-10-18 17:17:39
415e7b877c54440bf92137a7021416efdf0a29b5...d7b0a09316fe8dcb62ad247dbbb45c3c777667ad,2,11,1,12,3,2007-10-19 01:11:27,2007-10-18 20:02:35
d7b0a09316fe8dcb62ad247dbbb45c3c777667ad...89d750bf6fa025edeb31ad258cdd09a27a5c02fa,1,3,3,6,3,2007-10-19 01:58:39,2007-10-19 01:28:43
89d750bf6fa025edeb31ad258cdd09a27a5c02fa...bbaf63f2f18242484868d6c03d5df9bd071d6deb,1,13,3,16,2,2007-10-19 05:18:29,2007-10-19 05:18:29
31e7bded608416e3116f9c691a4d4314f10640b6...dd3bf0f4a5bab17011e94bfeb808ee64dd2ad040,2,18,2,20,7,2007-11-23 06:11:28,2007-11-19 09:21:44
dd3bf0f4a5bab17011e94bfeb808ee64dd2ad040...694a577519a762d12b8a53e76b6f1dd3ccf25e7d,1,54,3,57,10,2007-11-23 06:11:28,2007-11-07 22:58:09
694a577519a762d12b8a53e76b6f1dd3ccf25e7d...3f7dfe77b71ff0ae78923518ab5ca28b0cf4d786,2,62,0,62,3,2007-11-23 06:11:28,2007-11-19 06:22:00
b468f0ce4881bf42ffc820b1cddad67dad17fd80...8babab95af7c01d9ea75c97ee0df40e5a2170b83,3,10,7,17,5,2007-11-26 17:13:17,2007-11-26 08:59:27
8babab95af7c01d9ea75c97ee0df40e5a2170b83...a98b819183820cf87f1073c36b57883cb05e7049,1,1,1,2,1,2007-11-26 17:14:49,2007-11-26 15:16:08
a98b819183820cf87f1073c36b57883cb05e7049...e475fe16a9b7f36478ee4f304e53d6979e4f1710,1,1,1,2,1,2007-11-28 04:22:33,2007-11-23 20:35:08
e475fe16a9b7f36478ee4f304e53d6979e4f1710...7168624c3530d8c7ee32f930f8fb2ba302b9801f,1,22,0,22,1,2007-11-28 22:03:59,2007-11-28 21:13:08
7168624c3530d8c7ee32f930f8fb2ba302b9801f...b5b644a93adb41bca590a3cdfd9b64ccf3614f50,1,9,10,19,9,2007-12-02 07:50:45,2007-12-02 06:07:03
b5b644a93adb41bca590a3cdfd9b64ccf3614f50...d9ccfe7711a8bf1ed9d9cd87daa9863e0d564b23,3,27,14,41,8,2007-12-03 07:35:46,2007-12-02 21:43:34
d9ccfe7711a8bf1ed9d9cd87daa9863e0d564b23...2f02b25f36bce23e6b65c5112876796a56e084ca,1,10,5,15,5,2007-12-03 07:35:46,2007-12-03 05:02:09
2f02b25f36bce23e6b65c5112876796a56e084ca...69e7491835a0aa4e1a793a7c131783d8bb1cbb2b,2,7,6,13,5,2007-12-03 07:35:46,2007-12-03 05:30:01
69e7491835a0aa4e1a793a7c131783d8bb1cbb2b...9663c3bc6a04b9b4f63a54b820d3edb16aa95e6d,1,10,1,11,2,2007-12-03 07:55:23,2007-12-03 07:55:23
9663c3bc6a04b9b4f63a54b820d3edb16aa95e6d...5241b6bfe2285a6da598a0348c37b77964035bc8,1,3,2,5,3,2007-12-03 08:45:21,2007-12-03 08:03:10
3b8f19a02c3dd6043a7a6bdd65de2d4610c26b81...20a87ecc5861b0e1b76b99549cfaa965b2b27618,2,14,5,19,7,2008-02-12 07:34:45,2008-02-12 02:33:52
3b8f19a02c3dd6043a7a6bdd65de2d4610c26b81...5e6d7768e13088cc0082614fd106b327214fdc6d,5,73,38,111,28,2008-02-04 02:25:29,2008-02-02 09:20:17
5e6d7768e13088cc0082614fd106b327214fdc6d...5f09a37bbb3507a1e66734e9feae915fa6e8cea6,1,89,40,129,24,2008-02-04 02:27:20,2008-02-02 09:18:27
36a189c86e4a4ad75a75f598eedfe2defab3cbf3...23a485e3ee32a9445e1c20bd4fd4b93119cd4f7c,1,10,10,20,10,2008-01-21 04:57:42,2008-01-15 10:35:49
23a485e3ee32a9445e1c20bd4fd4b93119cd4f7c...5c08dbbdf1a2d2565606bb43f7e42a5968fcbdf1,1,116,41,157,11,2008-01-21 04:57:42,2008-01-15 10:48:45
5c08dbbdf1a2d2565606bb43f7e42a5968fcbdf1...a2d93aea25e33468622fbd6d9a6e02f8dd8b3c58,1,28,28,56,22,2008-01-21 04:57:42,2008-01-15 11:13:55
a2d93aea25e33468622fbd6d9a6e02f8dd8b3c58...c4a95c9f4b9c7b4dc8b705d323309263aa154e6a,1,3,2,5,1,2008-01-21 08:57:51,2008-01-21 06:41:27
c4a95c9f4b9c7b4dc8b705d323309263aa154e6a...bb23fdfa6c13b7f9cd5e1dbe0ca2fea31a627c5c,1,29,3,32,5,2008-01-21 09:04:10,2008-01-21 04:36:54
bb23fdfa6c13b7f9cd5e1dbe0ca2fea31a627c5c...7422bac441d6e00cfb8302600ae64512837ab4e3,1,33,0,33,3,2008-01-21 09:04:12,2008-01-21 04:37:01
7422bac441d6e00cfb8302600ae64512837ab4e3...97394ee4304a8d336663df5da23a33efbe1ab46b,1,1,1,2,1,2008-01-22 01:24:12,2008-01-21 19:57:46
97394ee4304a8d336663df5da23a33efbe1ab46b...9288bedafa5a61689d6bef920c707b1ff9fe080a,1,8,4,12,2,2008-01-22 01:24:12,2008-01-21 20:53:25
9288bedafa5a61689d6bef920c707b1ff9fe080a...6fc74703dee571859d8be270f5496f4c9b2ff9c7,1,2,1,3,1,2008-01-22 01:24:12,2008-01-21 16:07:15
6fc74703dee571859d8be270f5496f4c9b2ff9c7...4f5f998fbd64c997ea875d69fd86b6362e04ce9b,3,23,2,25,3,2008-01-22 08:48:29,2008-01-22 01:34:43
4f5f998fbd64c997ea875d69fd86b6362e04ce9b...3b839fd8610b440f072d0c1c0ec00801347f3793,1,4,6,10,2,2008-01-22 09:45:40,2008-01-21 22:37:41
3b839fd8610b440f072d0c1c0ec00801347f3793...28678b4f2f2e449986de4a6fc2dc93b32299ca74,1,8,0,8,1,2008-01-23 18:09:54,2008-01-22 22:12:25
28678b4f2f2e449986de4a6fc2dc93b32299ca74...5a9dd3998fb4c3ddc048cbcab74a8df72bff91b7,1,11,4,15,6,2008-01-23 18:10:11,2008-01-23 17:21:22
ce33288ea6b81a2f4f5aecd72177bcc8174562ae...7a51ed66f653c248993b3c4a61932e47933d835e,21,217,169,386,133,2008-01-21 20:44:31,2008-01-15 00:03:17
f85fd3f0d1213a2b714fddc7a834817aceeca932...13e4760a1649d24519f95ae2375704738b2b219e,1,18,5,23,5,2008-01-09 20:23:59,2008-01-08 16:24:53
13e4760a1649d24519f95ae2375704738b2b219e...fe2128a82608be23def04bf7fe30443553d7d264,1,3,3,6,1,2008-01-09 20:25:24,2008-01-09 16:05:16
fe2128a82608be23def04bf7fe30443553d7d264...08359b0067a2ab9ced6e80d01a9787fa8f4d4639,1,1,1,2,1,2008-01-09 20:25:27,2008-01-09 11:39:54
08359b0067a2ab9ced6e80d01a9787fa8f4d4639...35cda061640c26371d5841099ad30c6968d510b2,1,1,0,1,1,2008-01-09 22:56:49,2008-01-09 06:37:20
35cda061640c26371d5841099ad30c6968d510b2...95693d45ee1c1d4b76cac672636cf31229186a18,2,6,5,11,2,2008-01-10 09:08:11,2008-01-10 08:54:25
95693d45ee1c1d4b76cac672636cf31229186a18...8c3c7b2adbac9d4fce1fcec0ca03cfb6535d5af3,1,1,1,2,1,2008-01-11 07:27:39,2008-01-11 07:26:09
136e6316705e9e83cbb09c2a9ac4cb29c3e4662d...7b55eee77e11da162fb197a79b72af375ed0f1d0,2,2,2,4,2,2007-11-02 22:38:24,2007-11-02 09:10:11
7b55eee77e11da162fb197a79b72af375ed0f1d0...d336fc096b450c01502e99fa17583d5bebf9aa24,3,7,7,14,6,2007-11-02 22:38:24,2007-11-02 17:12:57
d336fc096b450c01502e99fa17583d5bebf9aa24...9e54dc6c12b14c12094c3a0f0b1e437148bbc0bd,2,6,6,12,6,2007-11-02 22:40:20,2007-11-02 15:33:07
136e6316705e9e83cbb09c2a9ac4cb29c3e4662d...9e6c723087def70d001740db48cf042b77a1d9cd,2,13,9,22,5,2007-11-02 00:07:22,2007-10-31 13:59:16
7da41f48c8acea834e8204917fe59da2b975903b...851a911024481f6759bce337b8dc50241070db81,1,1,1,2,1,2006-12-20 19:23:22,2006-12-20 19:23:22
6d60bbefdc2a42614069024b0a38db8c2de33967...b6c4a480b3161effaa3578df91d8cdc83044d7b6,1,2,2,4,1,2006-05-07 20:54:46,2006-05-07 15:42:37
8701ea0f627dcba4bb75570f87df9c93985d397a...e4e23f3a1c7734cdad60ba1274487ee6e2198de3,1,5,3,8,2,2006-05-16 02:05:50,2006-05-16 02:05:50
ff45715ce50b80ab16ee0d0dc7fff0c47a51959a...c3b06a69ffc41b3ac3600628593dd0fdd3988607,1,5,2,7,2,2006-05-16 20:35:46,2006-05-16 20:29:14
7839a25eab7177024b809fbb3796907e3eed17c1...1e3d90e0135274ad89cd8ee0722e2dd043ec0052,1,20,15,35,12,2006-05-03 00:30:07,2006-05-03 00:27:07
5a223a0d434c874984a0251eca4520ef95718a6d...c9889e40858fa8b9265b58519e7281c07f3632c6,1,4,51,55,8,2006-05-02 21:16:46,2006-05-02 21:16:46
de5f2bf3612a43af074a98fd1fcdef6a403daf3f...aa9b1573a5ca93395e8e41651bfc7245f10e0240,1,170,169,339,35,2006-05-04 05:31:43,2006-05-04 04:15:46
aa9b1573a5ca93395e8e41651bfc7245f10e0240...9290cd58c374a73cca989879678dc1ee929cdf2e,2,34,1,35,5,2006-05-04 05:31:50,2006-05-04 04:18:59
9290cd58c374a73cca989879678dc1ee929cdf2e...7abd7117ec57b8c3c2a469db62c7811fdac5c655,1,51,12,63,9,2006-05-04 05:59:30,2006-05-04 04:19:54
965f803c323bb72a9dedbbc8f7ba00bbadb6cf58...3a624b346db02a07b0317743b362d1a15c6c3c18,2,9,2,11,2,2006-04-18 18:43:09,2006-04-18 18:41:28
706d6c3e76fc5f7f988b056015689b489eb8f6b5...6bc9d1e2e75a68a6027d1f78a95c9ddbbe1d1dfd,1,1,1,2,1,2007-06-28 00:08:53,2007-06-27 01:51:35
6bc9d1e2e75a68a6027d1f78a95c9ddbbe1d1dfd...281404ca1db4c921ac162f3c03ae0688d25c5a65,1,1,1,2,1,2007-06-28 00:08:53,2007-06-27 01:51:34
fa0f02dfa15d0d95f8b6d27688bbf8ac940e3354...88a1531435b4cb565d290ed5146352beda52206c,1,3,0,3,1,2006-05-26 08:55:01,2006-05-25 23:42:18
88a1531435b4cb565d290ed5146352beda52206c...add5c8a562fc0e80ad4eb3d1e2a9f9f47df053a6,1,11,2,13,3,2006-05-26 18:30:49,2006-05-26 18:30:49
add5c8a562fc0e80ad4eb3d1e2a9f9f47df053a6...b931aa5a48f9fb3c26a565d5f19866923f13b692,1,1,1,2,1,2006-05-26 18:36:56,2006-05-26 16:59:17
fa0f02dfa15d0d95f8b6d27688bbf8ac940e3354...003d6ddaf41aa5614ac49693d199d1ad5f21fcbf,1,33,18,51,14,2006-05-26 06:53:31,2006-05-26 02:06:15
003d6ddaf41aa5614ac49693d199d1ad5f21fcbf...c7053aa88f80e4983ec45fd39a44d146197c21d0,2,31,34,65,14,2006-05-26 06:53:31,2006-05-26 02:06:16
c7053aa88f80e4983ec45fd39a44d146197c21d0...1010437d515a2740b7c0f3eeecf6af804062a9ff,1,15,15,30,5,2006-05-26 06:53:31,2006-05-26 02:06:17
1010437d515a2740b7c0f3eeecf6af804062a9ff...933e4f090dd39d44279f155f7a7347ff34964d2d,1,3,1,4,1,2006-05-26 06:53:31,2006-05-26 02:06:18
1361fa3e49717de9588e6d925073eb6885cedaa3...6891281cfa1a7c0d70ec76e80c5f87f518cdb160,1,30,7,37,4,2006-05-31 22:40:47,2006-05-29 08:45:49
6891281cfa1a7c0d70ec76e80c5f87f518cdb160...87840620fd77e39a0df91dc8b8db6cfdb5e4845a,1,1,1,2,2,2006-05-31 23:17:15,2006-05-31 22:55:47
1361fa3e49717de9588e6d925073eb6885cedaa3...cf2251b60460e651a5e00afe9ef7c427ad296711,3,52,2,54,8,2006-05-31 22:11:49,2006-05-31 22:11:49
1361fa3e49717de9588e6d925073eb6885cedaa3...65160b8b04f814ab5b2573b32605320ff875f99e,1,9,2,11,2,2006-05-31 21:22:28,2006-05-31 10:32:08
1142038098810a69e57d88554559e4e6116df177...473d404b53488a17458beea81913c1bc5df47a8a,1,6,4,10,2,2006-03-04 05:36:38,2006-03-04 05:34:14
bbaf63f2f18242484868d6c03d5df9bd071d6deb...e7187e4e0fece6c2947fbceff251f3ce69ae0aa8,1,1,1,2,1,2007-10-19 06:18:14,2007-10-19 06:18:14
20a87ecc5861b0e1b76b99549cfaa965b2b27618...2c2a3782c5092f232e71e8d97272b82cdca0664e,1,1,1,2,1,2008-02-20 01:50:29,2008-02-18 08:36:33
88965d198f7cd59b593db19ad7c1d54f5993ac0b...95b002eeb38de89feb7f0cc1a55721b45fd3cf11,4,442,1,443,12,2008-02-12 07:35:18,2008-02-07 07:35:25
cab31fa076253fcfafa7572c24e40f12a1e09ae3...2600973f2c565792b71e3aed62c40efb09e08c6e,2,7,0,7,4,2008-01-24 22:01:28,2008-01-24 18:34:46
2600973f2c565792b71e3aed62c40efb09e08c6e...81cc66a526b4d6c74ab7165d13718263c53210ea,1,11,0,11,1,2008-01-25 05:58:53,2008-01-24 18:35:20
81cc66a526b4d6c74ab7165d13718263c53210ea...3cf3237400f70329525d1085021910b4b76f8670,2,7,0,7,2,2008-01-26 06:26:08,2008-01-25 11:19:41
3cf3237400f70329525d1085021910b4b76f8670...2b0d1033a3af476296af6b5d8f524829c6790c1f,1,7,4,11,1,2008-01-26 06:31:52,2008-01-24 23:10:02
2b0d1033a3af476296af6b5d8f524829c6790c1f...10eb64f5fdaad47ff1973a9c55e7aa87a4524190,2,9,4,13,3,2008-01-26 06:42:36,2008-01-25 10:17:38
10eb64f5fdaad47ff1973a9c55e7aa87a4524190...923e3ec84a4e792ca277aac08e52ec2f9b47a8eb,1,1,1,2,1,2008-01-26 18:52:40,2008-01-26 12:19:02
923e3ec84a4e792ca277aac08e52ec2f9b47a8eb...3a9f0f41db87e197708f84aeb2487bc983f99c9c,3,40,2,42,6,2008-01-26 18:53:31,2008-01-26 11:26:57
3a9f0f41db87e197708f84aeb2487bc983f99c9c...ab8daa183638cea6238ec5949c99fefdcc29bd8c,1,2,0,2,1,2008-01-26 18:59:07,2008-01-26 11:04:30
ab8daa183638cea6238ec5949c99fefdcc29bd8c...7549376587ba5ffea973663f72804072d8f1d5dd,1,4,3,7,2,2008-01-27 01:44:05,2008-01-26 09:54:05
7549376587ba5ffea973663f72804072d8f1d5dd...e509db990b2ecae642efe3cdef4014d57d525f24,2,17,2,19,4,2008-01-27 01:58:18,2008-01-26 09:54:06
e509db990b2ecae642efe3cdef4014d57d525f24...c85c79279df2c8a583d95449d1029baba41f8660,3,33,2,35,5,2008-01-27 02:24:24,2008-01-26 18:04:37
c85c79279df2c8a583d95449d1029baba41f8660...bf5aeb150681ed743d317702eaf123c34b05c311,2,14,13,27,9,2008-01-27 06:48:03,2008-01-27 02:39:41
bf5aeb150681ed743d317702eaf123c34b05c311...c0d4528119c237a9939175adcf0113ee43a20438,1,4,4,8,2,2008-01-28 19:02:59,2008-01-22 03:23:53
c0d4528119c237a9939175adcf0113ee43a20438...752527f51396886c4ca11a14bfcecf2167ed4c40,1,16,0,16,1,2008-01-28 19:04:00,2008-01-28 16:33:28
752527f51396886c4ca11a14bfcecf2167ed4c40...584627b4a6a72a80e51e115d992c731d53acbb4a,1,4,0,4,1,2008-01-29 08:49:23,2008-01-29 06:08:22
584627b4a6a72a80e51e115d992c731d53acbb4a...f7ff09d7188aaa60710aa2e6d0da19b70adac2f1,1,10,0,10,1,2008-01-29 08:49:27,2008-01-29 06:08:29
f7ff09d7188aaa60710aa2e6d0da19b70adac2f1...ab989adf6ab32fb80fd42cc95ed0eacb029258fe,2,11,2,13,3,2008-01-29 08:49:28,2008-01-29 06:08:44
ab989adf6ab32fb80fd42cc95ed0eacb029258fe...7720224cebde08186627ab7bdb06018905d84e30,1,5,6,11,2,2008-01-30 05:23:57,2008-01-29 12:16:02
7720224cebde08186627ab7bdb06018905d84e30...bda3a31cc7982a7ef8ddb5137359d27c3c75ebed,1,38,2,40,3,2008-01-30 05:48:57,2008-01-26 07:53:05
bda3a31cc7982a7ef8ddb5137359d27c3c75ebed...a5d86f7406ecda78b44faf9ab50b7c6e419dba9d,5,8,8,16,8,2008-01-30 06:00:34,2008-01-29 19:38:55
a5d86f7406ecda78b44faf9ab50b7c6e419dba9d...d661146ac2ada526e80dbb6234f8f8da6642ffcb,1,15,2,17,3,2008-01-30 06:01:20,2008-01-29 19:52:32
d661146ac2ada526e80dbb6234f8f8da6642ffcb...c1dcf7ebf222e7c24b89b40bc00a6ca5e9e2eec6,1,1,1,2,1,2008-01-30 07:55:18,2008-01-30 05:37:56
c1dcf7ebf222e7c24b89b40bc00a6ca5e9e2eec6...0eab8ca68ad7bfcbb7c0aff37985116cbbdacd44,1,1,1,2,1,2008-01-30 08:01:27,2008-01-29 22:41:30
0eab8ca68ad7bfcbb7c0aff37985116cbbdacd44...def16e71819833d507a97a645366c569939dce73,1,5,0,5,2,2008-01-30 19:56:12,2008-01-28 21:16:02
def16e71819833d507a97a645366c569939dce73...733f1815abf99fe43eb8a9d6df5e0466751e6ba3,1,4,4,8,4,2008-01-31 01:17:39,2008-01-30 06:21:56
733f1815abf99fe43eb8a9d6df5e0466751e6ba3...c41b439244c51b30c60953192816afc91e552578,2,2,2,4,2,2008-01-31 01:21:02,2008-01-31 00:41:25
c41b439244c51b30c60953192816afc91e552578...0f047f3b47693e8f80a00bcf4af421d9d2fc7efd,1,1,2,3,2,2008-01-31 02:50:25,2008-01-30 19:33:04
0f047f3b47693e8f80a00bcf4af421d9d2fc7efd...c02792edd68897e42c64e250eb5d659291959ebf,1,1,1,2,1,2008-01-31 02:50:41,2008-01-31 02:06:04
c02792edd68897e42c64e250eb5d659291959ebf...bb8eebb94f0acf9a7ec19a1815bff7c9a2d3e427,2,2,2,4,2,2008-01-31 21:51:42,2008-01-31 21:51:42
bb8eebb94f0acf9a7ec19a1815bff7c9a2d3e427...da101b82b6f639c9916ee0596c86d29410093ca5,1,2,2,4,1,2008-01-31 21:59:00,2008-01-31 19:55:57
da101b82b6f639c9916ee0596c86d29410093ca5...0509eb216fef9451845376d8c92ff585994aecd8,1,1,1,2,1,2008-01-31 22:43:54,2008-01-31 21:59:11
0509eb216fef9451845376d8c92ff585994aecd8...7dc46429896d6292d71391ff7e5f95fec1370b51,1,4,3,7,3,2008-02-02 03:08:14,2008-02-02 03:06:56
7dc46429896d6292d71391ff7e5f95fec1370b51...c3c135291a62a01f7fd385f46cde34091767259b,2,6,12,18,7,2008-02-02 03:10:10,2008-02-02 03:10:10
c3c135291a62a01f7fd385f46cde34091767259b...6ce8e44a1eeaa07325f1304f6f392f35f54d29c7,1,5,0,5,1,2008-02-02 04:40:30,2008-02-02 04:40:30
7a51ed66f653c248993b3c4a61932e47933d835e...07cc8ecac0313c571cb9838585b376df86c80563,1,1,1,2,1,2009-12-27 18:41:48,2009-12-27 06:11:21
7a51ed66f653c248993b3c4a61932e47933d835e...7fec10b7f41fa32e71aa6377bd04cd7c6fb419e0,3,46,3,49,4,2008-01-21 20:44:31,2008-01-19 07:42:00
7fec10b7f41fa32e71aa6377bd04cd7c6fb419e0...eadb5831342bb2e756fa05c03642c4aa1929d4f5,3,32,10,42,10,2008-01-21 20:44:31,2008-01-19 07:45:24
eadb5831342bb2e756fa05c03642c4aa1929d4f5...d1f2d7e8ca65504722108e2db710788f66c34c6c,3,138,24,162,14,2008-01-21 21:05:27,2008-01-20 01:27:12
d1f2d7e8ca65504722108e2db710788f66c34c6c...204ce979a5ed6f182e56bea5282c7b4a2d91208a,1,13,79,92,3,2008-01-21 21:09:07,2008-01-20 15:19:56
204ce979a5ed6f182e56bea5282c7b4a2d91208a...077c48df8a72b046a2f562fedffa1c3d3a73a4e2,1,4,3,7,2,2008-01-23 05:24:21,2008-01-23 05:24:21
077c48df8a72b046a2f562fedffa1c3d3a73a4e2...6d91da6d3c170d026f2d7f79bbd7b657a6908cc8,1,8,5,13,3,2008-01-23 05:26:40,2008-01-21 08:44:50
6d91da6d3c170d026f2d7f79bbd7b657a6908cc8...cf558704fb68514a820e3666968967c900e0fd29,3,95,11,106,16,2008-01-23 05:46:30,2008-01-23 02:41:14
cf558704fb68514a820e3666968967c900e0fd29...9cb76b8cdc8ac62a77080595f6443613fd64bab3,2,24,3,27,5,2008-01-23 07:01:13,2008-01-23 07:01:13
887ad79865d862a0a3aef4b59957d7dd95d0507d...80cd9cf9fa06d9f117a4ff200c9537c8350cab68,1,9,6,15,5,2008-01-12 00:06:43,2008-01-11 21:11:13
80cd9cf9fa06d9f117a4ff200c9537c8350cab68...d3c2d9e5ff1b8d9343cf4db6096bd44a264750d4,1,4,3,7,2,2008-01-12 02:06:55,2008-01-11 18:14:19
d3c2d9e5ff1b8d9343cf4db6096bd44a264750d4...a5d7e3a2f180f4dd7a748cb0d4c795770da9db65,1,4,0,4,2,2008-01-12 05:40:25,2008-01-12 05:40:15
a5d7e3a2f180f4dd7a748cb0d4c795770da9db65...145d08248eb6076b4557005fc7b4fc0270a7a780,2,3,3,6,3,2008-01-12 05:40:55,2008-01-12 05:14:39
145d08248eb6076b4557005fc7b4fc0270a7a780...98fa5b68512b9d02d8d47e726bfaec4d33598246,1,12,6,18,3,2008-01-12 18:58:06,2008-01-12 07:13:55
98fa5b68512b9d02d8d47e726bfaec4d33598246...a8db80c22494396a81d2b4b7f4082c369fc0f78d,1,2,2,4,2,2008-01-12 19:10:09,2008-01-12 09:04:32
a8db80c22494396a81d2b4b7f4082c369fc0f78d...fa9dcf80e1048ea996349891a885ac325019fcac,1,28,9,37,4,2008-01-13 08:30:56,2008-01-13 08:30:56
fa9dcf80e1048ea996349891a885ac325019fcac...16335fdd7ace78a8285ba25fd7a81177a48e7c9b,1,0,2,2,1,2008-01-13 23:20:31,2008-01-13 10:38:46
16335fdd7ace78a8285ba25fd7a81177a48e7c9b...22fa97d4e011de82b44fdc83c27e919a996ce1be,1,17,17,34,13,2008-01-14 05:48:20,2008-01-14 04:51:01
22fa97d4e011de82b44fdc83c27e919a996ce1be...cfc44a12fe94e4fa8433cc8e9d90db8d4edf89a7,1,3,3,6,3,2008-01-14 05:48:22,2008-01-14 04:51:10
cfc44a12fe94e4fa8433cc8e9d90db8d4edf89a7...c60b528225d2827fd43d4fe4b082e0188df7a280,1,1,1,2,1,2008-01-14 21:52:27,2008-01-14 21:47:42
c60b528225d2827fd43d4fe4b082e0188df7a280...e87e22d0f22eb262a90e76197465d6cfd9707ea1,1,2,0,2,1,2008-01-14 21:54:24,2008-01-14 21:54:24
e87e22d0f22eb262a90e76197465d6cfd9707ea1...11c57e6a9a0f31f970701a673adaa1826f502fa0,3,7,2,9,3,2008-01-15 00:14:29,2008-01-14 23:10:38
11c57e6a9a0f31f970701a673adaa1826f502fa0...471a5ce5dda5c4315fe0f1d5ad3c642fc1ff540c,2,76,1,77,2,2008-01-15 02:04:51,2008-01-15 00:35:02
471a5ce5dda5c4315fe0f1d5ad3c642fc1ff540c...4e6738778b30a5063579ad4b4ba34e12547f0e7c,1,7,2,9,2,2008-01-15 04:04:02,2008-01-15 04:01:21
4e6738778b30a5063579ad4b4ba34e12547f0e7c...3e34526960d26ea9f3e2000d9e2400136d85086a,1,2,2,4,2,2008-01-16 01:04:21,2008-01-15 20:34:54
3e34526960d26ea9f3e2000d9e2400136d85086a...1bc7c13af9f936aa80893100120b542338a10bf4,1,22,24,46,11,2008-01-16 01:24:29,2008-01-15 01:11:19
1bc7c13af9f936aa80893100120b542338a10bf4...4439751dcbc3ba2fccae70626654f7950a7b298c,1,4,4,8,4,2008-01-16 01:33:53,2008-01-15 20:00:02
4439751dcbc3ba2fccae70626654f7950a7b298c...28624193b2ce622144136d373e136455b6b13967,1,7,2,9,3,2008-01-16 17:10:34,2008-01-16 01:59:12
28624193b2ce622144136d373e136455b6b13967...7c3fd25dcf2a23ed43bae2ba23a46edab4644a9f,1,19,5,24,4,2008-01-16 19:37:34,2008-01-16 00:12:33
7c3fd25dcf2a23ed43bae2ba23a46edab4644a9f...6232f62bc77ba9fc57fa97c61a7678a9f243c3bd,1,8,5,13,4,2008-01-16 19:37:57,2008-01-16 00:34:17
6232f62bc77ba9fc57fa97c61a7678a9f243c3bd...b98525e4bf1c3587bc57ad982d616dbe174c6e23,1,6,6,12,2,2008-01-16 19:37:57,2008-01-16 05:16:05
b98525e4bf1c3587bc57ad982d616dbe174c6e23...9f6fe82233fff26abd1a5315ba7709ccee078ec1,1,1,1,2,1,2008-01-16 19:37:58,2008-01-16 12:46:53
9f6fe82233fff26abd1a5315ba7709ccee078ec1...c3b0dec509fe136c5417422f31898b5a4e2d5e02,2,32,6,38,4,2008-01-16 19:53:35,2008-01-15 23:50:17
c3b0dec509fe136c5417422f31898b5a4e2d5e02...0c0478cac87991bd555e81715e9332d11eecd881,1,60,7,67,3,2008-01-16 20:42:37,2008-01-16 19:00:13
0c0478cac87991bd555e81715e9332d11eecd881...d6cf61bfd4bccffcc8b095f8469dbe749d70abdf,3,35,12,47,12,2008-01-16 23:35:03,2008-01-16 19:05:32
d6cf61bfd4bccffcc8b095f8469dbe749d70abdf...4ed7cd3ab07f7c721daf4241fe1dac306fefd1fb,20,54,45,99,35,2008-01-16 23:35:35,2008-01-16 19:12:46
4ed7cd3ab07f7c721daf4241fe1dac306fefd1fb...b531394d5829b22fd40e38e1d3aa6e97cb5b84ef,1,18,3,21,4,2008-01-16 23:36:10,2008-01-16 19:14:30
b531394d5829b22fd40e38e1d3aa6e97cb5b84ef...fb54abd604080dc2a719934a0a72964a7caf8ff7,1,16,8,24,4,2008-01-18 06:11:42,2008-01-17 16:58:34
fb54abd604080dc2a719934a0a72964a7caf8ff7...c9ced051c3afa6f3da7f59b0dcb92787b2b5c702,3,21,2,23,6,2008-01-18 06:39:20,2008-01-18 03:57:00
c9ced051c3afa6f3da7f59b0dcb92787b2b5c702...5c66d0d4580196094e80c552f141525759a8e249,9,25,20,45,20,2008-01-18 06:52:40,2008-01-18 06:52:40
5c66d0d4580196094e80c552f141525759a8e249...5221ecbc51526da94f2ba0862c3958100592cf0b,1,1,1,2,1,2008-01-18 06:55:25,2008-01-16 22:48:21
5221ecbc51526da94f2ba0862c3958100592cf0b...bfa8fccf477ed2567b035f1c6a3cb2b74ec4ef67,3,9,0,9,3,2008-01-18 07:35:36,2008-01-18 01:03:51
bfa8fccf477ed2567b035f1c6a3cb2b74ec4ef67...472ca780773ac75fa6af881117ce5360957fae2d,1,5,5,10,5,2008-01-18 09:29:38,2008-01-17 15:03:06
472ca780773ac75fa6af881117ce5360957fae2d...181256442ec1b09d0095e009922e109aa0a4af5e,3,85,81,166,3,2008-01-18 20:33:50,2008-01-14 16:36:34
181256442ec1b09d0095e009922e109aa0a4af5e...5a7b1b571e2bf59c65f9e5333414d2e0f7df6952,1,6,3,9,6,2008-01-18 21:19:37,2008-01-18 18:35:49
5a7b1b571e2bf59c65f9e5333414d2e0f7df6952...aa54892f5ada8282643dc7387b33261c7135d784,1,27,28,55,2,2008-01-18 21:29:32,2008-01-18 14:19:36
aa54892f5ada8282643dc7387b33261c7135d784...747bbff9b9583642cd8702b7b559757a6960df00,2,37,0,37,3,2008-01-18 21:33:08,2008-01-18 14:19:48
747bbff9b9583642cd8702b7b559757a6960df00...c764a0c2b6d8c94d90c95fa8170970c85a40665c,2,19,3,22,5,2008-01-18 21:33:57,2008-01-18 14:20:10
c764a0c2b6d8c94d90c95fa8170970c85a40665c...f854824bc50c3a05d7773dce81052f9eb8670d5f,1,4,0,4,1,2008-01-18 21:50:06,2008-01-13 19:02:59
f854824bc50c3a05d7773dce81052f9eb8670d5f...fdcf39e59b98536d2d65b26a59925dc1dea421d4,3,365,376,741,6,2008-01-18 23:09:08,2008-01-18 22:58:57
fdcf39e59b98536d2d65b26a59925dc1dea421d4...233808db1508ae2680987e0bb5abd33668ad76b4,2,2,2,4,2,2008-01-19 19:25:37,2008-01-19 15:23:32
233808db1508ae2680987e0bb5abd33668ad76b4...a3b811a4914cf02bb25662e330a067c1b0ddbc75,1,3,3,6,3,2008-01-20 07:06:02,2008-01-20 06:54:57
a3b811a4914cf02bb25662e330a067c1b0ddbc75...0a61779994aa3de41d57bb85bd88a2f56c7ba7d8,1,20,7,27,10,2008-01-20 19:00:57,2008-01-19 17:35:23
0a61779994aa3de41d57bb85bd88a2f56c7ba7d8...9116de5957423d553fce5857a835284a0527d037,1,8,5,13,4,2008-01-20 23:17:58,2008-01-19 15:22:47
9116de5957423d553fce5857a835284a0527d037...9bdbabade4303bb76d8115cb12470d229d7249e2,1,5,0,5,1,2008-01-20 23:17:58,2008-01-19 15:22:48
9bdbabade4303bb76d8115cb12470d229d7249e2...325ce3959ccee623eb973136f41741ca4e0ca56e,1,9,2,11,3,2008-01-20 23:17:58,2008-01-20 23:00:54
325ce3959ccee623eb973136f41741ca4e0ca56e...3057ded057f17add305cd38fe0b73173e94c540e,2,21,0,21,6,2008-01-20 23:18:34,2008-01-19 15:22:50
bfc07db5756bf7fe227b28daf8e19987819be514...f45e867b1a60a2023c18719888bb52965ade7192,1,13,13,26,7,2007-11-02 23:15:08,2007-10-17 09:31:35
851a911024481f6759bce337b8dc50241070db81...ec722203ee43beed8e4feac84af4307eb68f1ba3,1,14,0,14,1,2006-12-20 21:43:03,2006-12-13 08:58:28
ec722203ee43beed8e4feac84af4307eb68f1ba3...e6d40d65df07059fc655fabe62fa5b575ead7815,1,2,2,4,2,2006-12-22 04:31:14,2006-12-22 02:20:11
b6c4a480b3161effaa3578df91d8cdc83044d7b6...ac58c7b18ecf1c2ef41c848879e8b1838162db54,1,1,1,2,1,2006-05-28 20:31:50,2006-05-28 19:08:08
e9ce27543d29aa23bb4740a241339c6d42674f7d...bbb66c60613fe89c58d7c97a92e067add7056f4d,1,20,3,23,4,2006-05-17 22:51:38,2006-05-17 18:12:22
5c87a8c5602eb09810679dd3e0bcfc7ae1fed111...63dffdf03da65ddf1a02c3215ad15ba109189d42,2,3,64,67,3,2006-05-17 00:21:21,2006-05-16 23:46:31
1e3d90e0135274ad89cd8ee0722e2dd043ec0052...7ed36f56e33bd838d06521a37a916516397e9e8b,1,2,0,2,1,2006-05-04 04:03:25,2006-05-04 04:03:25
7ed36f56e33bd838d06521a37a916516397e9e8b...b8d0f5a00313bc5fb173f77c9a91a94f94a5aa1b,1,44,0,44,7,2006-05-04 04:05:29,2006-05-04 04:05:29
b8d0f5a00313bc5fb173f77c9a91a94f94a5aa1b...e23d2d6b765162902bd8b722e1659f002b97a302,1,20,0,20,5,2006-05-04 04:46:29,2006-05-04 04:46:29
7abd7117ec57b8c3c2a469db62c7811fdac5c655...93ddef3e2dd5f7f3238fad9d52e974d03c7844f2,1,3,2,5,1,2006-05-05 21:33:58,2006-05-05 13:49:15
93ddef3e2dd5f7f3238fad9d52e974d03c7844f2...7ebdba614223f867d3f19963647406df1d0e5ce0,1,6,6,12,2,2006-05-05 21:34:47,2006-05-02 14:58:37
7ebdba614223f867d3f19963647406df1d0e5ce0...e388c7382563b7497397c78bc078d0679dc891a8,6,17,11,28,8,2006-05-05 21:37:08,2006-05-02 07:40:24
281404ca1db4c921ac162f3c03ae0688d25c5a65...4fb0fa197e14c82d64adb292320f9444d7ac46c5,1,185,138,323,43,2007-07-04 09:43:51,2007-07-04 09:43:51
4fb0fa197e14c82d64adb292320f9444d7ac46c5...69c0b5d2408cfe207f2976fc99cbe71208ba83ad,1,2,1,3,1,2007-07-04 11:57:04,2007-07-04 11:57:04
69c0b5d2408cfe207f2976fc99cbe71208ba83ad...d36d385efd89d79c9d1f95ab79849ff1478dc425,1,0,19,19,3,2007-07-04 12:41:19,2007-07-04 12:41:19
d36d385efd89d79c9d1f95ab79849ff1478dc425...096e96b493bfc30687c87b303b93e75864942786,1,3,0,3,1,2007-07-09 09:28:19,2007-07-05 11:33:02
096e96b493bfc30687c87b303b93e75864942786...8c93917d23ec7ef998154a6b2ac91ed1a1bf5e3a,1,2,2,4,2,2007-07-09 12:29:24,2007-07-09 12:29:24
8c93917d23ec7ef998154a6b2ac91ed1a1bf5e3a...c961b228bcab390a1b42d517b6ed5a1edb55efed,1,34,12,46,7,2007-07-09 12:45:47,2007-07-09 12:45:47
c961b228bcab390a1b42d517b6ed5a1edb55efed...cdaee5db165ba8bae8d3b524950e61666fc36a84,1,29,20,49,9,2007-07-12 12:29:49,2007-07-12 12:29:49
b931aa5a48f9fb3c26a565d5f19866923f13b692...63b398a428c5294819a70d9c56879e7fac62a523,1,1,1,2,1,2006-05-28 16:23:29,2006-05-28 16:23:29
63b398a428c5294819a70d9c56879e7fac62a523...c928c67d67f73f6bf8c427a187bc92a6d77bc731,1,10,10,20,10,2006-05-28 16:43:18,2006-05-26 05:41:02
c928c67d67f73f6bf8c427a187bc92a6d77bc731...508d9e372e0e3cfa55a6224eca5e214364fc66b4,1,8,0,8,1,2006-05-28 16:45:16,2006-05-27 19:24:30
508d9e372e0e3cfa55a6224eca5e214364fc66b4...ff4a9ceb971cc9a296bac3a021b945b3c97e4cbe,1,1,1,2,1,2006-05-28 16:46:07,2006-05-27 16:39:31
ff4a9ceb971cc9a296bac3a021b945b3c97e4cbe...0d71b31a5e410972e903952cc467a8856b1f13d1,1,7,0,7,1,2006-05-28 16:46:50,2006-05-27 16:39:33
0d71b31a5e410972e903952cc467a8856b1f13d1...3f0f756b839c5f426fcd85c2b5d09164392b8bf6,1,32,5,37,8,2006-05-28 16:46:57,2006-05-27 16:39:35
3f0f756b839c5f426fcd85c2b5d09164392b8bf6...a57c8bac0021cec21027e25bd797f85b0abf9c81,2,15,4,19,6,2006-05-28 17:14:38,2006-05-28 17:14:38
a57c8bac0021cec21027e25bd797f85b0abf9c81...034016391c475e98c38a9b715cd670b8b2d0c619,2,17,6,23,10,2006-05-28 17:52:38,2006-05-27 10:24:14
034016391c475e98c38a9b715cd670b8b2d0c619...756944350d675bd3c08130df337b776f189ed752,1,7,2,9,2,2006-05-28 17:53:08,2006-05-27 10:25:32
756944350d675bd3c08130df337b776f189ed752...91b452cba9ff4dd92ded61020179a81d4876efe3,1,3,0,3,3,2006-05-28 20:27:51,2006-05-28 18:37:23
cf2251b60460e651a5e00afe9ef7c427ad296711...20ff06805c66826404b154b9309a8581449af2b0,3,26,3,29,8,2006-06-02 14:30:55,2006-06-02 13:21:17
473d404b53488a17458beea81913c1bc5df47a8a...fb7a6531e67333b22967bf5b96ef22a28f3b2552,1,19,8,27,5,2006-04-02 20:41:56,2006-04-02 20:28:27
fb7a6531e67333b22967bf5b96ef22a28f3b2552...da93d12b00425a37e81e227671f13130efcfe93f,1,11,1,12,2,2006-04-02 20:46:27,2006-04-02 20:31:54
e7187e4e0fece6c2947fbceff251f3ce69ae0aa8...5eb73581679abb41dcdf9ad7fa63fa156e078790,2,50,0,50,2,2007-10-20 02:59:10,2007-10-19 09:04:00
5eb73581679abb41dcdf9ad7fa63fa156e078790...1d5bf7fcee6122931bd04c97269d64f8f282ec55,1,1,1,2,1,2007-10-20 03:13:28,2007-10-19 17:24:43
1d5bf7fcee6122931bd04c97269d64f8f282ec55...2005dbe2a4e3eba5ecddb7d3c46339d2bc1241d4,1,1,1,2,1,2007-10-21 01:43:35,2007-10-20 16:15:38
2005dbe2a4e3eba5ecddb7d3c46339d2bc1241d4...0b8293f6776a7fc600c924ca71e4bba81d396409,1,1,1,2,1,2007-10-21 01:49:24,2007-10-20 19:31:46
2c2a3782c5092f232e71e8d97272b82cdca0664e...aba15f7f592c302196401d17a42c772d744555b4,1,11,7,18,5,2008-02-21 04:39:32,2008-02-21 04:37:07
95b002eeb38de89feb7f0cc1a55721b45fd3cf11...765239e9d26561454f125cb3033ff55db5d78ce4,1,1,1,2,1,2008-02-14 06:05:04,2008-02-14 06:05:04
765239e9d26561454f125cb3033ff55db5d78ce4...740b9b9ff4db2c32eb655213b44e3e5249128426,1,1,3,4,1,2008-02-14 06:07:39,2008-02-14 06:07:39
6ce8e44a1eeaa07325f1304f6f392f35f54d29c7...71bda8b923ed1bde7b831c6597af5a80213f6768,1,4,3,7,3,2008-02-03 08:56:35,2008-02-02 14:03:48
71bda8b923ed1bde7b831c6597af5a80213f6768...8a2f87332b847edc7f8fc5f305889c863651ecb5,2,19,1,20,2,2008-02-03 08:56:35,2008-02-03 08:00:09
6ce8e44a1eeaa07325f1304f6f392f35f54d29c7...41ac414ea2bef81af94474cbef25a38868b4788e,48,498,427,925,259,2008-02-02 04:49:34,2008-02-01 09:50:53
41ac414ea2bef81af94474cbef25a38868b4788e...11d54b8b9a78d7236916883c09e165fdc3768f00,1,5,2,7,3,2008-02-03 08:25:37,2008-02-03 08:23:02
11d54b8b9a78d7236916883c09e165fdc3768f00...991c3dc79f21a52209f9f41a52909cbb9462de1a,1,38,0,38,1,2008-02-03 08:25:52,2008-02-03 07:47:22
9cb76b8cdc8ac62a77080595f6443613fd64bab3...203a2fe117070964a5bf7cc940a742cad7a19fca,4,56,41,97,34,2008-02-10 07:16:51,2008-02-07 16:39:48
203a2fe117070964a5bf7cc940a742cad7a19fca...17e464266701bc1453f60a80cd71d8ba55b528e6,2,30,14,44,13,2008-02-10 07:16:51,2008-02-07 16:39:52
17e464266701bc1453f60a80cd71d8ba55b528e6...b05c6dff8aa8af5a03717e8d863b911cede213a0,1,7,7,14,7,2008-02-10 07:16:51,2008-02-07 16:39:56
b05c6dff8aa8af5a03717e8d863b911cede213a0...33ecf7eb6143143711ccaf828134beb2dacbe5c9,1,9,7,16,6,2008-02-10 07:16:51,2008-02-07 16:39:59
33ecf7eb6143143711ccaf828134beb2dacbe5c9...4e7c4571b8b31d6a09de2826361540caa76d3526,2,18,3,21,7,2008-02-10 07:16:51,2008-02-07 16:40:02
4e7c4571b8b31d6a09de2826361540caa76d3526...e1b3a2cad79a8138d18593c6eb3c46906ad2ee42,5,46,22,68,14,2008-02-10 07:16:51,2008-02-07 16:40:05
e1b3a2cad79a8138d18593c6eb3c46906ad2ee42...e496c00348140e73bdd202443df52192f6928541,4,151,137,288,6,2008-02-10 07:16:51,2008-02-07 16:40:08
e496c00348140e73bdd202443df52192f6928541...922d87f92f79d76ee1d9027d4a0f8a0cf36d5340,1,9,9,18,9,2008-02-10 07:16:51,2008-02-07 16:40:11
922d87f92f79d76ee1d9027d4a0f8a0cf36d5340...94a5728cfb593d80164620f8fa7e1ef322ad0025,4,15,26,41,8,2008-02-10 07:16:51,2008-02-07 16:40:13
94a5728cfb593d80164620f8fa7e1ef322ad0025...c369e7b805f927bb87fcf345dd19a55c8b9e6b8e,3,28,6,34,5,2008-02-10 07:16:51,2008-02-07 16:40:16
c369e7b805f927bb87fcf345dd19a55c8b9e6b8e...782c2d65c24066a5d83453efb52763bc34c10f81,6,481,8,489,6,2008-02-16 23:05:02,2008-02-07 16:40:23
f45e867b1a60a2023c18719888bb52965ade7192...a0554224a285b73b87fe1c95dbdff469561b182f,1,1,0,1,1,2007-11-04 04:31:22,2007-11-03 11:55:02
a0554224a285b73b87fe1c95dbdff469561b182f...b92565dc5c505c3d01f3219fb7f61ebc70630a2c,1,3,3,6,2,2007-11-04 04:31:37,2007-11-03 12:22:53
b92565dc5c505c3d01f3219fb7f61ebc70630a2c...ee787400de25ed419f40e70698ba35db475b2d61,1,2,2,4,1,2007-11-04 04:43:58,2007-11-03 14:04:52
62c666a7034a3aed6792280589bb78205781aa68...b67a43bb8f4a8ffb64f26b7351c3b0b90239696a,1,1,1,2,1,2007-11-06 02:57:58,2007-11-06 01:16:47
b67a43bb8f4a8ffb64f26b7351c3b0b90239696a...d8e21ba8967f43b61fc2fd50dd749ff8f0c6592a,2,0,2,2,2,2007-11-06 04:50:38,2007-11-04 14:35:26
e6d40d65df07059fc655fabe62fa5b575ead7815...1084b845d9d77bcb2e8255636358dd0dc35360a5,3,7,2,9,5,2007-01-03 09:22:35,2007-01-02 19:19:05
1084b845d9d77bcb2e8255636358dd0dc35360a5...8977c110b5bbd230c28c727ddb85856067d55cfb,1,15,5,20,6,2007-01-05 06:17:59,2007-01-04 07:09:08
0081e36c9dc3c201e22f12ebebadfff88fa32b91...7c4f59d181d801c6da08aeca74e2ef78efe4cd2b,1,1,1,2,2,2006-05-20 00:23:07,2006-05-20 00:23:07
63dffdf03da65ddf1a02c3215ad15ba109189d42...6cdfd1797486138f50f1929c39e77a2cd1e3e033,1,24,14,38,3,2006-05-17 09:57:57,2006-05-15 00:20:46
63dffdf03da65ddf1a02c3215ad15ba109189d42...518920b764ee9150781e68217181b24d0712748e,2,30,3,33,7,2006-05-17 09:48:13,2006-05-17 09:48:13
63dffdf03da65ddf1a02c3215ad15ba109189d42...453ec4bdf403c2e89892266a0a660c21680d3f9d,4,376,336,712,36,2006-05-17 08:56:40,2006-05-17 02:02:14
453ec4bdf403c2e89892266a0a660c21680d3f9d...b4189aa84873718f80c62846cd53e803b5f72362,3,28,24,52,5,2006-05-17 08:56:55,2006-05-17 02:46:16
b4189aa84873718f80c62846cd53e803b5f72362...0d78153952e70c21e94dc6b7eefcb2ac5337a902,4,231,1,232,4,2006-05-17 18:52:40,2006-05-17 16:33:32
0d78153952e70c21e94dc6b7eefcb2ac5337a902...f25933987f29070e9cd79dfddf03018010e82e80,1,58,19,77,10,2006-05-17 22:27:18,2006-05-17 20:23:19
63dffdf03da65ddf1a02c3215ad15ba109189d42...fcc387db9bc453dc7e07a262873481af2ee9e5c8,5,88,31,119,40,2006-05-17 08:52:48,2006-05-17 08:17:46
e23d2d6b765162902bd8b722e1659f002b97a302...aa8c79ad03264c9e6b184379fb5f4bc34aefe0d6,1,42,19,61,11,2006-05-08 20:28:27,2006-05-08 20:28:27
aa8c79ad03264c9e6b184379fb5f4bc34aefe0d6...1c57119c70332faf206b5c7e2f3639b96a221717,1,62,23,85,7,2006-05-08 20:28:49,2006-05-08 20:28:49
e388c7382563b7497397c78bc078d0679dc891a8...245f1029d674b95d63b5faea2269f98d28b3adb2,1,1,1,2,1,2006-05-07 20:55:36,2006-05-07 17:32:53
245f1029d674b95d63b5faea2269f98d28b3adb2...5d8ee9ceb8912c83336191d32b8898943b8944b8,1,2,0,2,1,2006-05-07 22:31:06,2006-05-07 21:36:12
5d8ee9ceb8912c83336191d32b8898943b8944b8...6fe31e2e4cdb7ed5333107174e23fbf2e226e370,1,5,4,9,1,2006-05-07 22:32:51,2006-05-07 22:32:51
6fe31e2e4cdb7ed5333107174e23fbf2e226e370...cf9dc65368113caa28f2829e2ada5477fbb031ec,2,79,1,80,2,2006-05-07 22:33:43,2006-05-07 18:19:09
cf9dc65368113caa28f2829e2ada5477fbb031ec...178613c737f82489a1e2c387236731541fe19081,1,7,7,14,3,2006-05-07 22:35:50,2006-05-07 18:18:53
cdaee5db165ba8bae8d3b524950e61666fc36a84...6ebedabf2d0f77c2c765ecc5effee1a7e3ffdedb,1,3,3,6,1,2007-07-13 03:45:55,2007-07-13 03:45:55
da93d12b00425a37e81e227671f13130efcfe93f...687dd75c95f9212244b6cf4fe60b40db44de01ba,1,4,3,7,1,2006-04-04 06:42:25,2006-04-04 06:41:09
687dd75c95f9212244b6cf4fe60b40db44de01ba...72fdfb50f721460e4cdff16fbe9c72d4ce6c668c,1,19,9,28,7,2006-04-04 06:42:25,2006-04-02 22:29:34
1cbcefb107776ce2da374697bb4f6e2bd22ff73f...50753d00d691c1ea16bc72446705aee2c128fc2f,1,30,0,30,1,2008-03-09 05:30:05,2008-03-09 04:27:04
aba15f7f592c302196401d17a42c772d744555b4...85ec3e7778c09f5d4f52a29f57c5ecc64070ffd1,1,5,1,6,1,2008-02-22 06:35:23,2008-02-21 17:22:08
85ec3e7778c09f5d4f52a29f57c5ecc64070ffd1...651fbba2d36072b2491bc53628159ff4fb3085dc,1,5,1,6,2,2008-02-22 06:35:44,2008-02-22 00:17:27
651fbba2d36072b2491bc53628159ff4fb3085dc...df4ec4cf6f68d92d2fbf20e808722d242ab2b894,1,11,1,12,1,2008-02-22 06:38:32,2008-02-22 00:27:46
df4ec4cf6f68d92d2fbf20e808722d242ab2b894...3baee1f3bf8e30f0fc67bbb1a49877bf0660fd29,1,4,0,4,4,2008-02-22 06:39:36,2008-02-11 05:53:52
740b9b9ff4db2c32eb655213b44e3e5249128426...b8331e15677b09638545cb398a4ef5b5d38aadf0,2,30,6,36,7,2008-02-17 07:22:07,2008-02-16 20:56:22
b8331e15677b09638545cb398a4ef5b5d38aadf0...c548f8627317780a017546a0a58117c7ee730cea,2,49,25,74,24,2008-02-17 07:23:48,2008-02-16 20:53:23
8a2f87332b847edc7f8fc5f305889c863651ecb5...fe1fa946f5ecc404100fc7dd8df2efc36036e5cc,1,1,1,2,1,2008-02-04 00:01:27,2008-02-02 23:58:06
fe1fa946f5ecc404100fc7dd8df2efc36036e5cc...5ea55edb68f488fad76c007472830cc649e3d320,1,1,1,2,1,2008-02-04 00:02:12,2008-02-02 23:58:07
d8534adac756a71a897b3a433eaea7992a137b71...f3e9512be1c7935b8ca496f3687c6850b32a06f3,1,7,3,10,1,2008-02-03 18:18:33,2007-12-05 17:16:56
f3e9512be1c7935b8ca496f3687c6850b32a06f3...e96e400f67b8478a99f9d2b5d82f08cd21f51a88,1,26,59,85,6,2008-02-03 18:19:05,2008-01-04 13:27:55
e96e400f67b8478a99f9d2b5d82f08cd21f51a88...36ee4ee40e1851442b0b075870cd5de5df6ee2b6,1,5,0,5,1,2008-02-03 18:19:16,2008-01-07 13:21:45
36ee4ee40e1851442b0b075870cd5de5df6ee2b6...af788a6eb510c1df4a3222b0403a088789ca2bac,1,3,11,14,3,2008-02-03 20:59:24,2008-02-03 16:56:12
af788a6eb510c1df4a3222b0403a088789ca2bac...94bc914c5e1e46160f79e743ec369e483bf9f5cd,1,12,0,12,5,2008-02-03 21:00:09,2008-02-03 16:56:18
94bc914c5e1e46160f79e743ec369e483bf9f5cd...147402a2e9e29efe3fe75b5409cc2dd88cef04c7,1,1,1,2,1,2008-02-03 21:00:15,2008-02-02 08:11:44
782c2d65c24066a5d83453efb52763bc34c10f81...c5bcf1f9f6d3429ab9a09e07e28362e7d189005b,1,5,3,8,4,2011-07-06 22:15:02,2011-07-06 22:14:43
782c2d65c24066a5d83453efb52763bc34c10f81...79a1e6b432d7d7ffaf2079d4cf895583502ca923,1,136,0,136,3,2008-02-17 01:17:09,2008-02-17 01:17:09
79a1e6b432d7d7ffaf2079d4cf895583502ca923...b249b552e012824f1bd5026187bf9b895c2132c6,1,1,0,1,1,2008-02-19 03:19:06,2008-02-18 10:20:20
b249b552e012824f1bd5026187bf9b895c2132c6...569012bf91ddb25220483e8912e079ce8a501525,1,7,71,78,7,2008-02-19 08:25:52,2008-02-19 07:52:14
ee787400de25ed419f40e70698ba35db475b2d61...c74d9acf20ba0c69bbd67c5b0bb3bd3c2349cebe,2,100,4,104,6,2007-11-05 20:57:34,2007-11-05 11:21:47
c74d9acf20ba0c69bbd67c5b0bb3bd3c2349cebe...fb159580a1628947f0a088e24cfe6fe4c81d99d0,1,5,0,5,1,2007-11-05 20:58:39,2007-11-05 11:21:48
fb159580a1628947f0a088e24cfe6fe4c81d99d0...c67359be45be74e1056d6293c6bb09ee6d00a54a,1,2,2,4,2,2007-11-06 02:39:18,2007-11-05 09:16:22
ee787400de25ed419f40e70698ba35db475b2d61...562ca192f94496611583688beb3725603ce51f89,4,22,9,31,11,2007-11-04 09:54:41,2007-11-02 00:32:04
ee787400de25ed419f40e70698ba35db475b2d61...1e8a1954519a070e92cb73f756b271664e1cc4d1,1,1,0,1,1,2007-11-04 04:47:13,2007-11-03 13:18:06
1e8a1954519a070e92cb73f756b271664e1cc4d1...138dd1e990cef5ac0176426016ad5e1f8e5dff58,1,10,3,13,4,2007-11-30 23:05:48,2007-11-29 12:21:39
138dd1e990cef5ac0176426016ad5e1f8e5dff58...9459aa77a032621a29d53605542844641cca843a,2,72,12,84,9,2007-12-05 23:06:37,2007-12-05 13:33:32
d8e21ba8967f43b61fc2fd50dd749ff8f0c6592a...f49439e1e16713d8d531e8a0bbc3b0bd7df5a407,1,1,1,2,1,2007-11-07 19:37:15,2007-11-04 12:45:22
f49439e1e16713d8d531e8a0bbc3b0bd7df5a407...6aaa65da20a8f0a4c95834f73f0b20d5dc3aa3c6,1,1,1,2,1,2007-11-07 19:39:37,2007-11-06 10:54:01
6aaa65da20a8f0a4c95834f73f0b20d5dc3aa3c6...6d0618a820a20846d60b665897fcce600f452eec,1,112,0,112,1,2007-11-08 01:05:53,2007-11-08 00:33:19
d8e21ba8967f43b61fc2fd50dd749ff8f0c6592a...34cb704a9b8b45ff3e1342678c5892e1ee6e27f5,1,2,2,4,2,2007-11-06 05:36:31,2007-11-05 19:36:33
34cb704a9b8b45ff3e1342678c5892e1ee6e27f5...9d87442f03c9e3fea7e24e2821fc0342f8efe1d6,1,10,0,10,1,2007-11-13 02:23:32,2007-11-12 15:15:39
8977c110b5bbd230c28c727ddb85856067d55cfb...5a17b54ad5543ddca60a493c613801279cc98a34,1,1,1,2,1,2007-01-09 10:56:43,2007-01-09 10:52:31
5a17b54ad5543ddca60a493c613801279cc98a34...6534141151f7fd4334f62827d9234acf3974ca4d,1,2,1,3,1,2007-01-09 19:50:53,2007-01-09 19:50:53
6cdfd1797486138f50f1929c39e77a2cd1e3e033...70e1a880a3dc3648fbed463044358a4a83116743,1,1,4,5,2,2006-05-18 00:33:52,2006-05-17 09:54:46
518920b764ee9150781e68217181b24d0712748e...e78503db1658ab6650608359cfd8beaf1645239f,2,3,30,33,7,2006-05-17 18:42:14,2006-05-17 18:42:14
f25933987f29070e9cd79dfddf03018010e82e80...c699f9b924d763b762df932769d91e3d053634a8,2,2,58,60,3,2006-05-18 05:27:42,2006-05-18 04:21:04
1c57119c70332faf206b5c7e2f3639b96a221717...5acd64edec37a7d9783af1a2be99772d466e8f02,1,50,26,76,13,2006-05-09 06:55:47,2006-05-09 06:55:47
178613c737f82489a1e2c387236731541fe19081...f8ba655ee4131e5c73c28a4ea854b24ce4058e1e,1,6,12,18,9,2006-05-08 04:27:30,2006-05-08 04:27:30
f8ba655ee4131e5c73c28a4ea854b24ce4058e1e...5d6a9f45e1ba78693cb0fbd5e9724b05d4e30e37,1,1,1,2,2,2006-05-08 17:54:30,2006-05-08 16:46:53
5d6a9f45e1ba78693cb0fbd5e9724b05d4e30e37...afb4ff206967c6b3e481994cc6d0d86139792169,1,4,3,7,1,2006-05-08 20:46:53,2006-05-08 20:46:53
afb4ff206967c6b3e481994cc6d0d86139792169...31fff305bcc6db3b8082eac7fc9e441b27964fea,13,36,25,61,24,2006-05-08 23:25:33,2006-05-08 21:43:38
6ebedabf2d0f77c2c765ecc5effee1a7e3ffdedb...8f4893639129acfc866c71583317090aa2a46eab,1,138,57,195,45,2007-07-13 09:49:37,2007-07-13 09:49:37
8f4893639129acfc866c71583317090aa2a46eab...ef3192b8345ba73c1d7c86ed0a1f318f26d97dc6,1,1,1,2,1,2007-07-22 12:05:30,2007-07-22 12:05:30
ef3192b8345ba73c1d7c86ed0a1f318f26d97dc6...86da5b6c978be1e64ec42c8b08e815a83f02493e,1,1,1,2,1,2007-07-22 12:25:46,2007-07-17 22:42:04
86da5b6c978be1e64ec42c8b08e815a83f02493e...d23d98d3ba21b2a7a1d30be049bfb5d9c0a4e943,1,43,32,75,10,2007-07-22 12:25:46,2007-07-19 04:37:58
d23d98d3ba21b2a7a1d30be049bfb5d9c0a4e943...0eafba1405bf4db29bca0b535477beb3046441bf,1,2,0,2,1,2007-07-23 11:35:03,2007-07-23 11:35:03
0eafba1405bf4db29bca0b535477beb3046441bf...005a2f4e6df7060561817828d4fa4245f87ccadf,1,53,35,88,24,2007-07-26 12:36:39,2007-07-26 12:36:39
72fdfb50f721460e4cdff16fbe9c72d4ce6c668c...fa0cdab537b1ae635b5a64cddd29cddf2dfc4a1b,1,2,2,4,2,2006-04-05 06:00:18,2006-04-05 05:57:15
fa0cdab537b1ae635b5a64cddd29cddf2dfc4a1b...7d6c447145c07bb7d96a9aa17e33838fbe76e405,1,25,19,44,4,2006-04-05 09:48:41,2006-04-05 09:06:49
40aab8119f38c622f58d8e612e7a632eb1f3ded2...ecb879f8772d5970bf1eb3677f9c9ebdd6e116a1,1,2,1,3,2,2008-02-12 03:21:23,2008-02-12 03:21:23
ecb879f8772d5970bf1eb3677f9c9ebdd6e116a1...463e8c766c99c7afe7c4bbd6960d0ef247b60f5b,1,1,0,1,1,2008-02-12 07:14:53,2008-02-12 07:14:53
40aab8119f38c622f58d8e612e7a632eb1f3ded2...cba22528fa897728ebbffb95c05037ec9a20ea7c,3,38,0,38,4,2008-02-12 02:25:10,2008-02-09 02:32:47
50753d00d691c1ea16bc72446705aee2c128fc2f...8ce1f243e5456eab52486b955389be2521dfcca5,2,21,0,21,2,2008-03-11 09:10:43,2008-03-11 08:48:34
50753d00d691c1ea16bc72446705aee2c128fc2f...a5c4f85b1685aeb01f4dac88075f465c71a6c82d,1,4,4,8,4,2008-03-10 23:44:40,2008-03-09 03:10:48
a5c4f85b1685aeb01f4dac88075f465c71a6c82d...1d17b22ebf9d894cef393e3e062f383aad8817e8,1,4,4,8,4,2008-03-10 23:45:20,2008-03-10 15:02:22
1d17b22ebf9d894cef393e3e062f383aad8817e8...3ff1320d4be164e35a685d8d00b6f44084be76e0,1,32,39,71,8,2008-03-10 23:45:20,2008-03-10 15:02:23
3ff1320d4be164e35a685d8d00b6f44084be76e0...88b302f5e2e0a6f6610912df49c473967fe59c89,1,1,1,2,1,2008-03-10 23:45:20,2008-03-10 15:02:24
88b302f5e2e0a6f6610912df49c473967fe59c89...47f6ee283891b757069c82922a88d1393be25dac,1,80,1,81,4,2008-03-10 23:45:40,2008-03-10 15:02:25
47f6ee283891b757069c82922a88d1393be25dac...6753f2aa55280a0fef1cbdcee71c1b529cb0c910,1,0,1,1,1,2008-03-10 23:49:28,2008-03-10 23:49:19
6753f2aa55280a0fef1cbdcee71c1b529cb0c910...51fe120903370ca8bf384c839c8cfb70ee563eb0,1,2,2,4,1,2008-03-10 23:55:07,2008-03-06 21:37:36
51fe120903370ca8bf384c839c8cfb70ee563eb0...ce5a2c956f10f84d8403fc4e94106a6b33a5024a,1,3,0,3,2,2008-03-11 00:00:40,2008-03-06 16:52:37
ce5a2c956f10f84d8403fc4e94106a6b33a5024a...5447aac755e5cfb948c627762b4665801811b026,1,15,7,22,1,2008-03-11 00:02:15,2008-03-05 19:07:49
5447aac755e5cfb948c627762b4665801811b026...702088afc680afef231d4a24bb5890f1d96a2cc9,2,2,4,6,2,2008-03-11 00:38:03,2008-03-10 14:38:33
50753d00d691c1ea16bc72446705aee2c128fc2f...0ab9e1e8cdaefdd33bf24bb0be0ec766483f8bbe,2,36,0,36,2,2008-03-09 08:43:46,2008-03-06 02:25:10
0ab9e1e8cdaefdd33bf24bb0be0ec766483f8bbe...40d934df72eaf244c826d5c26da0896ce7185cb6,3,78,28,106,21,2008-03-09 08:43:47,2008-03-06 02:59:29
40d934df72eaf244c826d5c26da0896ce7185cb6...5803c6f8a2faf8cfbbd046d9ebd682b82bb2b086,3,22,13,35,13,2008-03-09 08:43:47,2008-03-06 03:44:06
5803c6f8a2faf8cfbbd046d9ebd682b82bb2b086...91e4f03604bd089e09154e95294d5d08c805ea49,3,9,4,13,8,2008-03-09 08:43:47,2008-03-06 04:06:18
91e4f03604bd089e09154e95294d5d08c805ea49...01904572a5cf869983fab454f552542f16b1fe1f,1,249,281,530,10,2008-03-09 08:43:47,2008-03-06 04:15:44
01904572a5cf869983fab454f552542f16b1fe1f...bcbe5a515e837873f24dc9a764fa31e3ade45bb5,1,3,0,3,2,2008-03-09 08:43:47,2008-03-06 23:44:48
bcbe5a515e837873f24dc9a764fa31e3ade45bb5...d1f128b0509dce8b492c233b36131f096fd71274,4,16,16,32,15,2008-03-09 08:43:48,2008-03-06 20:46:09
d1f128b0509dce8b492c233b36131f096fd71274...bc052d7f435f8f729127cc4790484865c1a974b9,7,52,39,91,45,2008-03-09 08:43:48,2008-03-06 20:26:14
bc052d7f435f8f729127cc4790484865c1a974b9...34110cd4e394e3f92c01a4709689b384c34645d8,8,102,153,255,78,2008-03-09 09:03:38,2008-03-07 02:12:28
34110cd4e394e3f92c01a4709689b384c34645d8...1caeacc1f2973cecf7919a141adc4759acae94d0,1,1,0,1,1,2008-03-09 09:03:45,2008-03-07 21:48:40
1caeacc1f2973cecf7919a141adc4759acae94d0...542c264b01ac551dca0697d6577ec71ad4c245ab,1,4,3,7,2,2008-03-10 08:26:23,2008-03-10 08:26:23
542c264b01ac551dca0697d6577ec71ad4c245ab...20a16eb33eee99fd3eab00c72f012b98d4eeee76,2,18,2,20,4,2008-03-11 06:51:13,2008-03-11 06:51:13
3baee1f3bf8e30f0fc67bbb1a49877bf0660fd29...094fbbf96415323907e71ec224a0f5d6e585d9d0,1,1,1,2,1,2008-02-28 06:28:45,2008-02-28 06:28:45
f4d93486aea3a3c20ddef409e5bfd8a60efdc512...f57ca1efe5b2e6c7ca7c2a08b0c342e2547c826c,2,11,6,17,5,2008-02-21 05:22:06,2008-02-21 02:48:21
f57ca1efe5b2e6c7ca7c2a08b0c342e2547c826c...dd0962883b239ab265079b666d9a9f5014d60e52,1,7,7,14,6,2008-02-21 05:22:06,2008-02-21 02:52:54
dd0962883b239ab265079b666d9a9f5014d60e52...35d04b3b110f9adcd485c8470d8048394f586018,1,1,1,2,2,2008-02-21 05:22:06,2008-02-21 02:55:43
35d04b3b110f9adcd485c8470d8048394f586018...de83f8cc4cd97c52a0b8a1b1ff4e949129e3a947,1,17,4,21,2,2008-02-21 05:22:06,2008-02-21 03:34:11
de83f8cc4cd97c52a0b8a1b1ff4e949129e3a947...827743b2e893a0e81e9286ef12de4c02486e6c5e,1,25,1,26,3,2008-02-21 05:22:07,2008-02-21 05:17:18
827743b2e893a0e81e9286ef12de4c02486e6c5e...bb760f0257d2445126ee5c1c1b0d59fa8e4c9de8,1,4,0,4,2,2008-02-21 05:22:07,2008-02-21 05:20:50
bb760f0257d2445126ee5c1c1b0d59fa8e4c9de8...afdb4be0fc48da74e8f02fe5ca22777cb2d214ed,1,1,1,2,1,2008-02-22 06:33:07,2008-02-21 14:38:56
aa8d53ec387a7baf72ab5e3a91c35bb5bf20eb4d...3131b713013f06285cad3ffdcc61f417ac4ba158,4,33,7,40,11,2008-02-13 23:59:26,2008-02-09 22:02:07
5ea55edb68f488fad76c007472830cc649e3d320...f1c3239ab5c4d66637822b03db407f87ed068d15,1,2,2,4,1,2008-02-06 07:31:17,2008-02-06 07:03:53
f1c3239ab5c4d66637822b03db407f87ed068d15...a0cf49c16ae37177dcfcefa1149bf09f84721cf5,2,70,1,71,2,2008-02-06 22:02:41,2008-02-06 12:16:08
3023448cef6e85bdc1ce98226f23d63128c5c9a1...d4fe07f14975b87fa26776792a95f411473cfb46,1,3,3,6,2,2008-02-04 00:04:56,2008-02-03 21:22:37
d4fe07f14975b87fa26776792a95f411473cfb46...d0b8c9e561ea427104611bf392598a398c18d7cb,1,8,4,12,4,2008-02-04 00:04:57,2008-02-03 21:22:39
d0b8c9e561ea427104611bf392598a398c18d7cb...7a5375395f8104a8679f9482e0c5faf60e7e9e54,2,4,4,8,2,2008-02-04 06:49:01,2008-02-04 06:37:58
7a5375395f8104a8679f9482e0c5faf60e7e9e54...b1e9efa7c0153fd4e4ffc86c128262e4176e87af,1,16,0,16,1,2008-02-05 04:10:07,2008-02-02 09:37:01
b1e9efa7c0153fd4e4ffc86c128262e4176e87af...4f395eed33816be70181a818cbce4bb7235b83be,1,4,1,5,2,2008-02-05 07:06:19,2008-02-04 13:13:07
4f395eed33816be70181a818cbce4bb7235b83be...7a2078b4b00fb1c5d7b0bf8155778f79377b8f2f,2,20,1,21,4,2008-02-05 08:30:22,2008-02-04 22:01:20
569012bf91ddb25220483e8912e079ce8a501525...b0030db331141bedfaf02f34a83f18712c0ae011,1,64,40,104,15,2008-02-20 23:36:03,2008-02-20 23:05:23
b0030db331141bedfaf02f34a83f18712c0ae011...6010d2d957fb05838cd3ab887ac261752ff8ff87,2,34,1,35,2,2008-02-21 00:07:20,2008-02-20 23:54:54
6010d2d957fb05838cd3ab887ac261752ff8ff87...75ea38df66910dcb9d09f1320ae2787b5bc8211e,1,4,6,10,4,2008-02-21 23:34:23,2008-02-21 15:50:42
75ea38df66910dcb9d09f1320ae2787b5bc8211e...b56fca07d2bac20339d59218ab98de38a9363e77,1,5,5,10,5,2008-02-21 23:46:05,2008-02-21 03:42:53
b56fca07d2bac20339d59218ab98de38a9363e77...1736855c9b59ac787af979a44840a58361cbaf66,3,36,5,41,6,2008-02-23 19:14:56,2008-02-23 19:08:25
1736855c9b59ac787af979a44840a58361cbaf66...52229a29c78df2e48de23ed70ab1934667971d3c,1,1,0,1,1,2008-02-23 23:42:18,2008-02-23 23:37:48
52229a29c78df2e48de23ed70ab1934667971d3c...04c9e11f2cffaf84dd20602f811bf377f6033cb6,1,18,17,35,2,2008-02-24 08:36:31,2008-02-23 23:45:19
569012bf91ddb25220483e8912e079ce8a501525...9ed36cfa35cfbd09c454f12194a91cd50ba284d1,9,98,39,137,28,2008-02-20 05:17:45,2008-02-19 16:24:37
9ed36cfa35cfbd09c454f12194a91cd50ba284d1...572fc81d21b26d856dd3c2cc366b7452a4ed16e4,3,34,32,66,7,2008-02-20 05:22:29,2008-02-19 16:24:38
9d25acc49a98ca82988ad871753a45e41f3c90f5...6326cee51b21d67e1335ead285cb52b83234b2b4,1,6,6,12,1,2007-12-06 00:16:40,2007-12-06 00:13:08
6326cee51b21d67e1335ead285cb52b83234b2b4...f23272f3fd84fd37d97917f37233fbf01deb32b4,1,5,0,5,2,2007-12-06 00:27:17,2007-12-05 07:01:30
6d0618a820a20846d60b665897fcce600f452eec...d50a4bc4e91f03cecc337e5e95dc4c0e0a4054f0,1,22,16,38,9,2007-11-08 09:08:14,2007-11-06 08:54:18
d50a4bc4e91f03cecc337e5e95dc4c0e0a4054f0...b5e960b108b48b3ebd92a3c1b22b13a9edd127dc,2,4,4,8,3,2007-11-08 23:54:58,2007-11-08 21:47:36
b5e960b108b48b3ebd92a3c1b22b13a9edd127dc...4f2e94c0f7685f9c58e67b0651147684efb0f57e,1,1,1,2,1,2007-11-08 23:56:22,2007-11-08 21:48:49
4f2e94c0f7685f9c58e67b0651147684efb0f57e...fbbdbfc3ccff209136c9f94fed8321e5d3d0ca85,1,5,9,14,1,2007-11-09 00:26:23,2007-11-09 00:24:00
fbbdbfc3ccff209136c9f94fed8321e5d3d0ca85...d349a03e7401625a9bb92f403f36923472e498c6,1,1,0,1,1,2007-11-09 00:41:56,2007-11-09 00:41:56
d349a03e7401625a9bb92f403f36923472e498c6...d9c8344b467bb97b8dca8d811c99d4735eca88f2,1,1,1,2,1,2007-11-09 07:55:55,2007-11-08 23:41:39
d9c8344b467bb97b8dca8d811c99d4735eca88f2...9126425df1fefa6b2843a45c8b087b8d87cb1955,1,8,9,17,8,2007-11-09 07:59:27,2007-11-08 23:21:42
9126425df1fefa6b2843a45c8b087b8d87cb1955...13d4e6f7b7a95ae0a41f72317c9844739dcfb6f2,1,4,5,9,3,2007-11-09 07:59:44,2007-11-08 16:40:25
13d4e6f7b7a95ae0a41f72317c9844739dcfb6f2...cb6c162fba3fe3e1333b48c6062c18108c41fb82,1,1,1,2,1,2007-11-09 08:00:09,2007-11-08 18:56:28
cb6c162fba3fe3e1333b48c6062c18108c41fb82...b9217c09386e5313ac6a54cc91cf03149514154b,2,22,1,23,2,2007-11-09 08:17:52,2007-11-09 08:17:26
6d0618a820a20846d60b665897fcce600f452eec...acef41c9db33f2261e46e17cca098df3403dd745,7,23,9,32,11,2007-11-08 02:37:27,2007-10-31 21:55:17
acef41c9db33f2261e46e17cca098df3403dd745...6b945b9beee4cd01a58d875c0f83d018b4830ca0,1,42,0,42,1,2007-11-08 02:37:28,2007-11-03 00:55:31
6d0618a820a20846d60b665897fcce600f452eec...609a2289d76fd9a7dddceabc63d1654fe61e0ffb,4,28,1,29,5,2007-11-08 01:06:14,2007-11-07 03:24:28
18b01f4ff6db66b6419c7501bb303b643638b297...70f75cc96a3c590ac1c54c09c39446626f155ef7,1,4,1,5,1,2006-05-18 07:25:50,2006-05-18 06:58:51
70f75cc96a3c590ac1c54c09c39446626f155ef7...065e0b126f47e0c280da6830956766ff2ea8cf17,1,1,1,2,1,2006-05-18 21:35:37,2006-05-18 21:35:37
065e0b126f47e0c280da6830956766ff2ea8cf17...5fb61b8dcfdf7bcec0793c071813e255d1803859,4,8,5,13,8,2006-05-18 22:46:11,2006-05-18 21:19:20
5fb61b8dcfdf7bcec0793c071813e255d1803859...9370bae2cef351617272aa142fbe4ce039833d13,5,19,20,39,7,2006-05-18 22:51:38,2006-05-18 12:15:55
9370bae2cef351617272aa142fbe4ce039833d13...ff62b7f37899de2faa88cbb5be1f3bcfa246012c,1,2,2,4,1,2006-05-19 03:14:28,2006-05-18 12:23:59
70e1a880a3dc3648fbed463044358a4a83116743...4bd18c43d9a8a8fc1aa598926100f6999953ba48,3,144,148,292,18,2006-05-18 00:36:36,2006-05-17 09:55:02
4bd18c43d9a8a8fc1aa598926100f6999953ba48...5b16b090211f549c501f2cd9e8ea1bd227a575c5,2,38,67,105,6,2006-05-18 00:36:36,2006-05-17 09:55:19
5b16b090211f549c501f2cd9e8ea1bd227a575c5...6de08ae688b9f2426410add155079e04baff33bd,8,210,0,210,11,2006-05-18 00:36:36,2006-05-17 09:55:40
6de08ae688b9f2426410add155079e04baff33bd...d556fae2c0ea063f15ea4c3678fe931cc426f1ca,4,104,17,121,8,2006-05-18 00:36:36,2006-05-17 09:56:09
d556fae2c0ea063f15ea4c3678fe931cc426f1ca...70e34b2dc88e28f09903b85932ea679992da62ff,2,2,1,3,2,2006-05-18 00:36:36,2006-05-17 22:34:48
70e34b2dc88e28f09903b85932ea679992da62ff...e52290428b5b6f55cb7bb7a4624751750241d5aa,2,104,14,118,12,2006-05-19 22:02:32,2006-05-19 07:28:19
e52290428b5b6f55cb7bb7a4624751750241d5aa...c22a7f0fb96d5c742581422452d3d68139b79ad6,1,11,0,11,1,2006-05-19 22:02:38,2006-05-19 07:28:46
c22a7f0fb96d5c742581422452d3d68139b79ad6...732232a123e1e61e38babb1c572722bb8a189ba3,2,4,1,5,4,2006-05-19 22:02:43,2006-05-19 07:29:05
732232a123e1e61e38babb1c572722bb8a189ba3...d0740d92beb019a7b02678e5acea79c0ff67e3ee,6,27,4,31,15,2006-05-19 22:02:52,2006-05-19 07:29:26
d0740d92beb019a7b02678e5acea79c0ff67e3ee...cce91a2caef9296bd4a69e51e48f1d679935d868,3,62,31,93,24,2006-05-19 22:02:55,2006-05-19 07:29:43
cce91a2caef9296bd4a69e51e48f1d679935d868...8fe92775f38621f2855fb94e404b9798cdcd98cc,1,1,1,2,1,2006-05-19 22:02:59,2006-05-19 09:15:28
8fe92775f38621f2855fb94e404b9798cdcd98cc...7792cc2fa1574b66b69a38a816a9b4bdca5c3731,1,1,1,2,1,2006-05-19 22:03:10,2006-05-19 09:15:50
7792cc2fa1574b66b69a38a816a9b4bdca5c3731...67644a4d77f55cd1c960d046079d26719f1e7cd6,5,6,5,11,5,2006-05-19 22:03:21,2006-05-19 09:16:18
67644a4d77f55cd1c960d046079d26719f1e7cd6...3a4b3f269c4ba1eebd5ab7206ee0915667b20cc8,2,19,3,22,8,2006-05-19 22:03:24,2006-05-19 09:16:58
3a4b3f269c4ba1eebd5ab7206ee0915667b20cc8...969d326d6b54573e171c903fdf9fdc6b107c18d1,2,21,5,26,11,2006-05-19 22:03:39,2006-05-19 09:17:16
c699f9b924d763b762df932769d91e3d053634a8...e8f990b4e4b56f214138cc475c19e5a253e9148e,1,1,1,2,1,2006-05-18 08:46:57,2006-05-18 08:29:36
5acd64edec37a7d9783af1a2be99772d466e8f02...c39c4f4746ba4543b532594543d252e2bad62234,1,1,1,2,1,2006-05-10 01:15:21,2006-05-10 01:15:21
c39c4f4746ba4543b532594543d252e2bad62234...02ab1c490dc4827446c851468eb01ecc23b6cc48,1,3,3,6,2,2006-05-10 01:27:56,2006-05-10 01:27:56
02ab1c490dc4827446c851468eb01ecc23b6cc48...07ea91d84f3c7bb075d4716ee40096e3b12a4c86,2,33,5,38,6,2006-05-10 01:29:35,2006-05-10 01:28:41
31fff305bcc6db3b8082eac7fc9e441b27964fea...dbd0f7d3221fbf8e9943a114c11e5b5e5fc0c201,1,9,9,18,6,2006-05-09 08:29:38,2006-05-09 08:08:23
dbd0f7d3221fbf8e9943a114c11e5b5e5fc0c201...28cc4ab4224164971a523e8a6c222b5ab2bae27d,1,1,1,2,1,2006-05-09 13:28:59,2006-05-09 16:14:00
005a2f4e6df7060561817828d4fa4245f87ccadf...3244729aac7515ccda651d40f41cef94517ac089,1,36,0,36,3,2007-07-27 12:30:15,2007-07-27 12:30:15
7d6c447145c07bb7d96a9aa17e33838fbe76e405...8960844a7890b1ac6ad5f8abf58a2a20923dde6d,3,28,9,37,11,2006-04-07 23:31:20,2006-04-07 19:26:10
8960844a7890b1ac6ad5f8abf58a2a20923dde6d...98cf8156078eb5256d77d01786863185a1728140,1,2,2,4,1,2006-04-07 23:48:09,2006-04-07 23:48:09
463e8c766c99c7afe7c4bbd6960d0ef247b60f5b...ab5a4231b0e24566dcd79baeae089b267bc7dc26,1,17,1,18,2,2008-02-13 03:52:26,2008-02-13 03:11:22
ab5a4231b0e24566dcd79baeae089b267bc7dc26...a72375948528935bbd4cb34bf277b49e0114aac3,2,6,7,13,6,2008-02-13 03:57:07,2008-02-11 23:43:41
463e8c766c99c7afe7c4bbd6960d0ef247b60f5b...7df7c019c2a46672c12a11a45600cdc698e03029,2,92,1,93,9,2008-02-12 23:47:43,2008-02-12 21:26:31
7df7c019c2a46672c12a11a45600cdc698e03029...2b0b551d7662a4246ed55b6a7029ba3caa65cf98,1,6,1,7,2,2008-02-25 01:39:10,2008-02-25 01:37:15
5ad9db3d040bf77031958c8f51a0106818119617...77e21533a938b886ed2b8636a75f76870f4805de,1,13,2,15,4,2008-03-14 07:31:06,2008-03-14 04:56:49
77e21533a938b886ed2b8636a75f76870f4805de...1658c6149ac4462c874810c760507040122917e8,2,26,0,26,5,2008-03-14 07:31:06,2008-03-14 04:56:53
094fbbf96415323907e71ec224a0f5d6e585d9d0...21623062ab8e2a81dec56c8007a1d147cef1b5e2,1,5,0,5,1,2008-03-05 07:13:16,2008-02-28 00:29:34
e98d6df75260312e906278705f78f2eee39cc8fc...31e0b2ca81ad985a8768c33c0aba547a51d05277,3,31,3,34,4,2008-02-23 19:31:04,2008-02-23 19:31:04
d5558581d2583d18cdb6823065a8f812085fbc37...969702a9575ada3bcc510ce2e44cb00b8325ecaa,1,6,2,8,3,2008-02-16 08:45:57,2008-02-14 08:36:14
969702a9575ada3bcc510ce2e44cb00b8325ecaa...fbc63ea69487e688a1293227b976b378834550a1,1,13,0,13,1,2008-02-16 08:47:07,2008-02-14 06:34:36
fbc63ea69487e688a1293227b976b378834550a1...3b08e5b8c9130f57a38e51557dbb173b9edda5ba,1,10,0,10,2,2008-02-16 08:47:07,2008-02-14 06:34:40
3b08e5b8c9130f57a38e51557dbb173b9edda5ba...118805b92097e355001bb16687ce252646eab604,1,7,0,7,2,2008-02-16 08:47:07,2008-02-14 06:34:43
118805b92097e355001bb16687ce252646eab604...e7e5170f80431c3d7855e055d9bb6f4e4e6ccc64,1,87,0,87,1,2008-02-16 08:47:08,2008-02-14 06:34:46
a0cf49c16ae37177dcfcefa1149bf09f84721cf5...cf94ccda356cc732a883f16342440330d3f644ec,2,52,3,55,4,2008-02-07 08:04:50,2008-02-07 08:02:08
7a2078b4b00fb1c5d7b0bf8155778f79377b8f2f...6d24ad971c8195b00cd9678fbff7c2aaddb00908,1,58,22,80,13,2008-02-13 23:44:20,2008-01-30 04:54:56
7a2078b4b00fb1c5d7b0bf8155778f79377b8f2f...cd676a513672eeb9663c6d4de276a1c860a4b879,5,105,18,123,32,2008-02-13 22:58:07,2008-02-12 22:26:02
cd676a513672eeb9663c6d4de276a1c860a4b879...c0cb4a067972700f0682fbab13768bcc7dc7a3c3,3,10,3,13,4,2008-02-13 22:59:34,2008-02-13 08:34:39
7a2078b4b00fb1c5d7b0bf8155778f79377b8f2f...43fe901b71f81cdff142048dfc27e492c445d225,3,76,0,76,4,2008-02-07 06:35:28,2008-02-05 21:10:44
7a2078b4b00fb1c5d7b0bf8155778f79377b8f2f...ef5b9d6e2286630bf8afb5bdf1c6e3356f3d50c7,2,6,6,12,2,2008-02-05 09:44:10,2008-02-05 08:17:33
7a2078b4b00fb1c5d7b0bf8155778f79377b8f2f...482cce820554809c02bc639bb33462f9905e4342,3,27,17,44,14,2008-02-05 09:01:45,2008-02-02 06:32:33
482cce820554809c02bc639bb33462f9905e4342...caa87713bca77c441c09282aa5b18b179bcfa90d,2,19,6,25,6,2008-02-05 09:01:47,2008-02-02 06:32:41
caa87713bca77c441c09282aa5b18b179bcfa90d...5884f1fe96b33d9666a78e660042b1e3e5f9f4d9,4,5,5,10,5,2008-02-05 09:01:48,2008-02-02 06:32:53
5884f1fe96b33d9666a78e660042b1e3e5f9f4d9...2e0c290299e381884e4f4a4efb847fc8ecc4647c,1,6,14,20,4,2008-02-05 09:01:49,2008-02-02 06:32:56
2e0c290299e381884e4f4a4efb847fc8ecc4647c...a0685a4f45ac8916212188032f75d4acb4031089,1,3,3,6,3,2008-02-10 07:22:28,2008-02-10 07:22:22
a0685a4f45ac8916212188032f75d4acb4031089...897d39ced4a670dd46df489b25561926dfb011dc,1,1,1,2,2,2008-02-10 07:27:09,2008-02-08 13:33:51
897d39ced4a670dd46df489b25561926dfb011dc...b261ec463a4c117aa7961fd3667ffafe0f9ee986,1,23,4,27,2,2008-02-10 07:42:37,2008-02-09 06:10:57
b261ec463a4c117aa7961fd3667ffafe0f9ee986...193ad4f63c511948050079ddbe8c9b7342bf85a4,1,2,2,4,1,2008-02-10 07:46:07,2008-02-09 06:11:01
193ad4f63c511948050079ddbe8c9b7342bf85a4...8e08689959a78bb4f27e010fbd225b4bf3addadb,1,1,1,2,1,2008-02-11 20:22:18,2008-02-11 15:57:34
8e08689959a78bb4f27e010fbd225b4bf3addadb...cb45f83cbdfcde4333ea5982b3c763e136fc599c,3,86,43,129,5,2008-02-16 08:46:33,2008-02-14 07:01:23
7a2078b4b00fb1c5d7b0bf8155778f79377b8f2f...d6b8fc303b389b026f2bf9918f6f83041488989b,7,98,15,113,19,2008-02-05 08:46:49,2008-01-31 09:17:48
d6b8fc303b389b026f2bf9918f6f83041488989b...6831a88ac03759a8133f10ffd52ad235a081a8a3,4,23,15,38,13,2008-02-05 08:46:49,2008-02-01 04:23:25
7a2078b4b00fb1c5d7b0bf8155778f79377b8f2f...d089ebaad5315325d67db30176df1bbd7754fda9,4,245,45,290,18,2008-02-05 08:44:10,2008-01-29 06:44:27
d089ebaad5315325d67db30176df1bbd7754fda9...097971f5f564dbd832eea774ae0cdcfa03ba35ac,1,1,3,4,1,2008-02-05 08:44:10,2008-02-01 04:07:04
097971f5f564dbd832eea774ae0cdcfa03ba35ac...1abf0950638d4f3279d059a1365da9c253d5718a,2,59,0,59,2,2008-02-05 08:44:10,2008-02-01 11:13:10
1abf0950638d4f3279d059a1365da9c253d5718a...744dacd3f5045240a304e687f3ef7135398e7865,2,43,1,44,4,2008-02-05 08:44:10,2008-02-04 07:59:17
7a2078b4b00fb1c5d7b0bf8155778f79377b8f2f...656482830ddc4a4e2af132fabb118a25190439c2,2,60,7,67,13,2008-02-05 08:42:32,2007-12-26 03:56:29
7a2078b4b00fb1c5d7b0bf8155778f79377b8f2f...ba227857d24029917f1e939647d826037f026205,5,83,48,131,29,2008-02-05 08:40:18,2008-02-04 18:26:23
ba227857d24029917f1e939647d826037f026205...fb32c9172a1f2828d75f5d17d8ceea8ffe692f2a,1,12,8,20,5,2008-02-10 04:12:54,2008-02-10 03:06:57
7a2078b4b00fb1c5d7b0bf8155778f79377b8f2f...45525bd022dda75ec935c9c579e452577dcfd31f,5,79,58,137,9,2008-02-05 08:39:19,2008-01-11 06:49:35
7a2078b4b00fb1c5d7b0bf8155778f79377b8f2f...4e891acf679c0020b61889447f8f412324aeffa9,1,6,1,7,1,2008-02-05 08:39:03,2008-02-04 00:55:21
4e891acf679c0020b61889447f8f412324aeffa9...0b0599402d0e4354c60d192eb926f46577040a29,1,5,4,9,2,2008-02-05 08:39:03,2008-02-04 01:00:16
0b0599402d0e4354c60d192eb926f46577040a29...c11c3b56818bcaf1acea6cb2a9a68fbca644f968,1,12,4,16,1,2008-02-05 08:39:03,2008-02-04 01:02:28
c11c3b56818bcaf1acea6cb2a9a68fbca644f968...a941fb4a43472b7b4419c6f6776749791c4495ef,1,35,0,35,1,2008-02-17 01:33:31,2008-02-10 22:09:52
7a2078b4b00fb1c5d7b0bf8155778f79377b8f2f...c89fb6b19a91add28a111cf257e01cba2c8de69c,1,13,5,18,3,2008-02-05 08:38:41,2008-01-19 08:42:22
c89fb6b19a91add28a111cf257e01cba2c8de69c...fcb77bc57b4d2f63bd4d0c2fd36498f308d28cbe,1,25,24,49,9,2008-02-05 08:38:41,2008-01-19 10:16:16
fcb77bc57b4d2f63bd4d0c2fd36498f308d28cbe...dc41976a3eed1d9c93fdc08c448bab969db4e0ec,1,32,14,46,8,2008-02-05 08:38:41,2008-01-19 09:58:34
dc41976a3eed1d9c93fdc08c448bab969db4e0ec...b94f2eda99646fea71f84ccd895d94b0001d0db6,1,280,123,403,53,2008-02-05 08:38:41,2008-01-27 01:42:49
b94f2eda99646fea71f84ccd895d94b0001d0db6...ecf4c2ec6ba6dc39e72c6b37f2a238e28fec2dc1,1,10,0,10,1,2008-02-05 08:38:41,2008-01-28 11:04:30
ecf4c2ec6ba6dc39e72c6b37f2a238e28fec2dc1...c330fdd42dc57127272534cd2a8dd9569334b219,1,32,25,57,17,2008-02-05 08:38:41,2008-01-29 08:17:55
c330fdd42dc57127272534cd2a8dd9569334b219...61e08ccacbfdc6046ccabdfdb01f7755ed5ad8b1,1,27,28,55,17,2008-02-05 08:38:41,2008-01-30 21:12:25
61e08ccacbfdc6046ccabdfdb01f7755ed5ad8b1...8441a9a84278718e9bfd49112dcc55136cea394f,1,20,18,38,5,2008-02-05 08:38:41,2008-01-30 21:19:58
8441a9a84278718e9bfd49112dcc55136cea394f...42ab241cfacdcbae910d51c06fa2870cc94b0af3,1,18,20,38,15,2008-02-05 08:38:41,2008-01-30 22:27:50
42ab241cfacdcbae910d51c06fa2870cc94b0af3...ee810b715912347775fa06a0d5b16092b4908d66,1,94,94,188,2,2008-02-05 08:38:41,2008-01-30 23:11:23
ee810b715912347775fa06a0d5b16092b4908d66...c607aaa2f05b4dc38a6573f44b6f71db05dd8b39,1,5,3,8,4,2008-02-05 08:38:41,2008-01-30 23:13:37
c607aaa2f05b4dc38a6573f44b6f71db05dd8b39...c1beba5b479a39143ebef96ba10103bbd9a70089,2,231,5,236,9,2008-02-05 08:38:41,2008-01-30 23:24:34
c1beba5b479a39143ebef96ba10103bbd9a70089...b2979ff599a6bcf9dbf5e2ef1e32b81a1b88e115,5,72,6,78,20,2008-02-05 08:38:41,2008-01-15 08:59:05
b2979ff599a6bcf9dbf5e2ef1e32b81a1b88e115...52f3c81a9d41af019ab8f05051c5251f078b12e5,2,60,0,60,2,2008-02-11 23:48:10,2008-02-11 23:32:29
52f3c81a9d41af019ab8f05051c5251f078b12e5...fe3403c3205de44faa926a086b4b99f157fc63fe,3,108,108,216,6,2008-02-24 00:59:16,2008-02-24 00:59:16
7a2078b4b00fb1c5d7b0bf8155778f79377b8f2f...2363d7467dcd60467b3e694b3ba6f859bb226f5c,2,55,9,64,6,2008-02-05 08:36:10,2008-02-04 00:53:56
2363d7467dcd60467b3e694b3ba6f859bb226f5c...874299760708e3bd4d63e9afa8da3fe8a7ddc006,1,23,2,25,2,2008-02-05 08:36:10,2008-02-04 00:53:57
874299760708e3bd4d63e9afa8da3fe8a7ddc006...8a7c56e1591ad5593883bb23fb6c5683a8a1a1a8,1,28,16,44,7,2008-02-05 08:36:10,2008-02-04 00:53:58
f23272f3fd84fd37d97917f37233fbf01deb32b4...8e7425da782cbdff4531d84e0ef4ec7bd3ae23d7,2,2,2,4,2,2007-12-07 07:20:11,2007-12-06 23:36:45
b9217c09386e5313ac6a54cc91cf03149514154b...295dd2ad201c0ebb281563750a13d904bd466e01,1,7,0,7,1,2007-11-10 09:52:54,2007-11-09 11:06:10
b9217c09386e5313ac6a54cc91cf03149514154b...d048a96ee9bec968be0bdc9c43ffce61169545be,1,3,3,6,1,2007-11-10 06:25:36,2007-11-09 19:33:54
ff62b7f37899de2faa88cbb5be1f3bcfa246012c...d3d8f361a8c6beb5647e0d963a1460a505324494,3,162,1,163,3,2006-05-19 05:55:57,2006-05-17 18:44:40
d3d8f361a8c6beb5647e0d963a1460a505324494...d3bd4ee1a5cc771b86f73dd0f4a2bea6f652b20a,2,25,7,32,8,2006-05-19 05:55:57,2006-05-17 20:10:25
ff62b7f37899de2faa88cbb5be1f3bcfa246012c...52db0495dcb88f38590bc00607052fc5758b07d1,2,27,3,30,5,2006-05-19 03:15:45,2006-05-18 10:57:04
8090c08e1e90274d35bbf06238d2933759f3a1bb...c3c8835fbb182d971d71939b9a3ec7c8b86d6caf,4,15,12,27,13,2006-05-19 22:31:20,2006-05-19 10:03:57
c3c8835fbb182d971d71939b9a3ec7c8b86d6caf...405e5b2fe0cf20b0eea41ca892f416c218b49f59,3,129,122,251,11,2006-05-19 22:59:18,2006-05-19 16:56:35
405e5b2fe0cf20b0eea41ca892f416c218b49f59...582af688157607f05447cefce8d91b26eeaee39d,1,7,0,7,1,2006-05-19 23:24:51,2006-05-19 04:19:20
e8f990b4e4b56f214138cc475c19e5a253e9148e...8dcf39c46e2931ca02b18b1ea3a6b21f446d8de8,3,67,64,131,4,2006-05-18 19:07:31,2006-05-18 19:07:31
07ea91d84f3c7bb075d4716ee40096e3b12a4c86...1e2398d7fad308dcc6019709244b40303b51b54d,1,79,0,79,3,2006-05-15 05:33:24,2006-05-15 03:49:15
28cc4ab4224164971a523e8a6c222b5ab2bae27d...d1802851b0c112a065b43e3f83d631f867b7e1ce,1,1,1,2,1,2006-05-10 02:22:25,2006-05-10 02:22:25
3244729aac7515ccda651d40f41cef94517ac089...67a4f1a7f5c778ffa23d1e562feb4cc6d52c9414,1,2,3,5,4,2007-08-12 07:23:47,2007-08-12 07:23:47
67a4f1a7f5c778ffa23d1e562feb4cc6d52c9414...bd441de4df68c4144425b1c18d323fd90f3f9617,1,5,2,7,4,2007-08-12 07:29:55,2007-08-08 01:40:34
bd441de4df68c4144425b1c18d323fd90f3f9617...314c30936f505f70534c619a48d99afb93451cb2,1,25,2,27,2,2007-08-12 07:30:56,2007-08-08 01:40:35
314c30936f505f70534c619a48d99afb93451cb2...062d671f57a422863416ee4c746ef74c1cc45c19,1,1,1,2,1,2007-08-12 07:30:57,2007-07-29 20:28:40
062d671f57a422863416ee4c746ef74c1cc45c19...6c87d60cc6202d4de5ac6d136394602feefeafc6,1,4,1,5,1,2007-08-12 07:30:57,2007-07-29 20:29:45
3244729aac7515ccda651d40f41cef94517ac089...6e8c87070306a757c4d7fd2c55cca3a90fe140c7,1,149,204,353,80,2007-07-31 11:03:06,2007-07-31 11:03:06
6e8c87070306a757c4d7fd2c55cca3a90fe140c7...513a54dc212044596d932dcc9468e0774c1ee2c1,1,27,7,34,5,2007-08-01 12:27:57,2007-08-01 12:27:57
513a54dc212044596d932dcc9468e0774c1ee2c1...e341c06d8140b689001ddc183ec3476c1ede264a,1,36,51,87,12,2007-08-12 02:42:57,2007-08-12 02:42:57
a2de3a17faed90c0a7d35e3f48470549b284c4ec...6d34a2bad11f241e56423511d4a0d62a1f378668,1,15,7,22,10,2008-02-25 02:17:10,2008-02-24 21:03:52
6d34a2bad11f241e56423511d4a0d62a1f378668...8a8bf4690e20a545561249a9b393c1ef3239c03d,1,29,0,29,1,2008-02-25 02:17:46,2008-02-24 21:04:14
8a8bf4690e20a545561249a9b393c1ef3239c03d...8e0fbe671f6a63b885702917bf4e7d7a85c59ab4,1,1,1,2,1,2008-02-25 02:34:34,2008-02-24 23:16:04
8e0fbe671f6a63b885702917bf4e7d7a85c59ab4...99d8ea2c5ce6fc0b06fe8a43e7c0c108ddad853b,1,35,9,44,11,2008-02-25 02:51:46,2008-02-24 13:42:40
1658c6149ac4462c874810c760507040122917e8...2fba8366ed1e77685c83bbb0fa353c11624f0121,1,2,1,3,2,2008-03-15 08:43:56,2008-03-14 17:29:27
2fba8366ed1e77685c83bbb0fa353c11624f0121...c2e357c2fe23ff900de158067ca11e5021e22741,1,13,20,33,11,2008-03-15 08:43:56,2008-03-14 17:29:28
c2e357c2fe23ff900de158067ca11e5021e22741...44617928ae4731b6139d87b978ddbc4860154222,1,6,6,12,4,2008-03-15 08:43:56,2008-03-14 17:29:29
44617928ae4731b6139d87b978ddbc4860154222...ad79c02451295a4b1ce59e60cfc0ca4bd7e3fbdf,1,11,9,20,8,2008-03-15 08:43:56,2008-03-14 17:29:30
1658c6149ac4462c874810c760507040122917e8...c0c77734bf313455364b3be7d3537d40e1138bcc,2,169,140,309,108,2008-03-14 07:42:14,2008-03-10 02:43:39
c0c77734bf313455364b3be7d3537d40e1138bcc...4ba0cb27c1c0c3aa65d28e1891c1f3dca3db5f93,1,2,15,17,3,2008-03-14 07:42:14,2008-03-10 17:58:26
f1a8cc635455a65567d040349327b9ea4adb479b...a1eebfb3a90b6c240afd1a32cfebe6ee5dbd72c5,1,1,1,2,1,2008-03-01 05:22:18,2008-02-29 18:28:19
a1eebfb3a90b6c240afd1a32cfebe6ee5dbd72c5...84989bd820119260c4fcd0dd5ee8a50bc8ff0d2c,1,1,1,2,1,2008-03-01 05:22:22,2008-02-29 17:00:38
31e0b2ca81ad985a8768c33c0aba547a51d05277...6c0f86943e9ebba5aa281772e01559773e0c1234,1,1,1,2,1,2008-02-24 08:51:01,2008-02-24 05:38:04
6c0f86943e9ebba5aa281772e01559773e0c1234...8c87dc77ae45d7277001b1be2c88ea9062e11d72,1,1,1,2,1,2008-02-24 08:52:55,2008-02-24 08:07:19
cf94ccda356cc732a883f16342440330d3f644ec...527270689c364bea9b0630df9bae5e09c2071c1e,1,1,1,2,1,2008-02-10 04:22:23,2008-02-10 04:19:08
b828fef678c21d017f18d2094bfdaac94e5fbf7a...e75201963f6722ad84491c8f17dff8406ec0a198,1,33,4,37,3,2008-02-07 06:47:36,2007-09-30 00:20:45
e75201963f6722ad84491c8f17dff8406ec0a198...09bc098c2db106469f79eae5e4f6a3bc09c0db12,1,23,0,23,3,2008-02-07 06:48:07,2008-02-07 05:23:46
b828fef678c21d017f18d2094bfdaac94e5fbf7a...ab88c36321df647e17d477f19591cf6ca95de7f0,3,24,4,28,6,2008-02-06 22:52:23,2008-02-06 10:11:18
ab88c36321df647e17d477f19591cf6ca95de7f0...8bfa6bd6473b086ab2c5781daa08a7b5417c3d1f,2,7,4,11,3,2008-02-06 22:52:28,2008-02-06 10:11:53
2a5fe2545882721d6841bad11dae0f15b454bf0d...c04a7155a03e5ef089864912769baf9001f64aa9,1,60,23,83,13,2008-04-09 08:25:28,2008-02-13 01:06:58
2a5fe2545882721d6841bad11dae0f15b454bf0d...628522ec1439f414dcb1e71e300eb84a37ad1af9,4,195,3,198,8,2008-04-09 08:23:52,2007-12-29 10:05:47
628522ec1439f414dcb1e71e300eb84a37ad1af9...12ecb01107c4e77d3bccb5be5a0230c4546dafaf,1,26,7,33,3,2008-04-09 08:30:18,2007-12-30 11:13:27
2a5fe2545882721d6841bad11dae0f15b454bf0d...b44ebb19e3234c5dffe9869ceac5408bb44c2e20,5,157,1,158,9,2008-04-09 08:22:50,2008-02-20 22:13:13
b44ebb19e3234c5dffe9869ceac5408bb44c2e20...842abf06f36b5b31050db6406265972e3e1cc189,1,14,3,17,2,2008-04-09 08:22:50,2008-02-20 22:13:14
842abf06f36b5b31050db6406265972e3e1cc189...ba88a1fee476a7895634beb9f33faf7e7b7908af,1,2,2,4,2,2008-04-09 08:22:50,2008-02-20 22:13:15
ba88a1fee476a7895634beb9f33faf7e7b7908af...c48799e560c826905e87c8a8a71effeb0ca5e897,1,1,1,2,1,2008-04-09 08:22:50,2008-02-20 22:13:16
2a5fe2545882721d6841bad11dae0f15b454bf0d...75dc6c7cb879d0018893baf6ba6b49d1f16e1b92,1,10,10,20,1,2008-04-09 08:22:25,2008-03-21 20:14:47
75dc6c7cb879d0018893baf6ba6b49d1f16e1b92...96872bc200c41407607019c1f0fb005840f576a2,5,95,77,172,11,2008-04-09 08:22:25,2008-03-21 20:16:24
96872bc200c41407607019c1f0fb005840f576a2...df292c791ab790340cc9e3577a073bcb9d1900ea,3,8,8,16,6,2008-04-09 08:22:25,2008-03-21 22:53:00
df292c791ab790340cc9e3577a073bcb9d1900ea...cd2fef59edf72a1d9792d9cb72aae1e6f6c7b1d4,4,52,6,58,8,2008-04-09 08:22:25,2008-03-21 22:55:19
cd2fef59edf72a1d9792d9cb72aae1e6f6c7b1d4...0a9b88b7dee70bd36d35b7857640a18ee3adeef1,4,8,1,9,4,2008-04-09 08:22:25,2008-03-21 23:52:46
0a9b88b7dee70bd36d35b7857640a18ee3adeef1...32260ad5dbc3100ebb5e05432198888bfbe600f8,2,27,1,28,3,2008-04-09 08:22:25,2008-03-22 16:35:59
32260ad5dbc3100ebb5e05432198888bfbe600f8...1fa6ead492c81bffdbe336373e5b162d3b5ac6d3,1,7,2,9,4,2008-04-09 08:22:25,2008-03-22 16:48:41
1fa6ead492c81bffdbe336373e5b162d3b5ac6d3...6835550def046bfd52f3e65f248024956a6df62c,1,5,7,12,4,2008-04-09 08:22:25,2008-03-22 20:19:49
6835550def046bfd52f3e65f248024956a6df62c...1102952b45dde09d73445aa2284bcb592362fa23,2,37,1,38,5,2008-04-09 08:22:25,2008-03-22 21:22:44
ef5b9d6e2286630bf8afb5bdf1c6e3356f3d50c7...7deaec9ac7bb42da0ee40da66f663b0d589ce7ee,1,6,4,10,6,2008-02-06 21:50:21,2008-02-04 10:09:00
7deaec9ac7bb42da0ee40da66f663b0d589ce7ee...c586879cdfa4f8181a14e953a9152a4639eef333,1,6,1,7,1,2008-02-06 21:50:21,2008-01-29 09:18:58
c586879cdfa4f8181a14e953a9152a4639eef333...e62a641de17b172ffc4d3a803085c8afbfbec3d1,1,1,1,2,1,2008-02-06 21:50:25,2008-02-03 11:38:46
ef5b9d6e2286630bf8afb5bdf1c6e3356f3d50c7...21e5ad50fc5e7277c74cfbb3cf6502468e840f86,11,189,11,200,18,2008-02-06 21:07:28,2008-02-06 11:25:58
ef5b9d6e2286630bf8afb5bdf1c6e3356f3d50c7...3473f3035d04957ca24d3ccc232f4263b26d6bb8,1,35,26,61,3,2008-02-06 10:26:02,2008-02-05 10:01:44
3473f3035d04957ca24d3ccc232f4263b26d6bb8...406400ce4f69e79b544dd3539a71b85d99331820,2,6,0,6,2,2008-02-06 10:26:02,2008-02-05 10:01:45
406400ce4f69e79b544dd3539a71b85d99331820...ec84bd000a89e657b36136ec927144cd13f26079,2,117,83,200,18,2008-02-06 10:26:02,2008-02-05 10:01:46
ec84bd000a89e657b36136ec927144cd13f26079...8089c85bcba89464b9b2a32fa948ed85eb367e70,6,242,2,244,15,2008-02-06 10:26:55,2008-02-05 07:04:18
3d0a936f63f2f894b3986d96cdd8f2baae96150c...21a2d69b2a14f1b42b18cfd18ff0477bb97eb11f,1,1,1,2,1,2008-02-27 21:17:58,2008-02-22 15:48:53
21a2d69b2a14f1b42b18cfd18ff0477bb97eb11f...77266e96d38bf922a3d8add5bd3dda924aadea05,1,1,0,1,1,2008-02-27 21:18:35,2008-02-25 14:56:28
8e7425da782cbdff4531d84e0ef4ec7bd3ae23d7...6281f394674bf2db861967da6c2215cfc3fc78af,1,8,2,10,2,2007-12-08 22:24:13,2007-12-08 15:48:05
d048a96ee9bec968be0bdc9c43ffce61169545be...a62d6d84c67cebd71e8d88171a2ebe0bf3aca8a0,1,1,1,2,1,2007-11-10 20:47:16,2007-11-10 18:55:27
a62d6d84c67cebd71e8d88171a2ebe0bf3aca8a0...ff350ccf49a800c4c90f817d346fb1bcb96e02e7,1,2,0,2,1,2007-11-11 10:51:53,2007-11-10 20:00:33
ff350ccf49a800c4c90f817d346fb1bcb96e02e7...a91ef6e75b897a255cc17b70014a39e68dd54c7a,1,1,1,2,1,2007-11-11 10:57:13,2007-11-11 04:29:10
d048a96ee9bec968be0bdc9c43ffce61169545be...4bd5b7dacc404e6b733d9ab6744429c5027bb5e1,8,57,34,91,30,2007-11-10 08:24:51,2007-11-10 08:15:03
4bd5b7dacc404e6b733d9ab6744429c5027bb5e1...fb63d7f889cf5df417b731b07952689df7f745c8,4,8,3,11,6,2007-11-10 08:37:39,2007-11-10 02:22:52
fb63d7f889cf5df417b731b07952689df7f745c8...25487bde2ab756a423489fc942b37c1550555b93,1,28,2,30,3,2007-11-12 02:44:16,2007-11-12 02:44:16
b574c8d846dbdbaaad1e96ae365d452bc5cd6d64...78e694787cb89cd008e237b17cdc7f0fa5a15d22,1,32,1,33,3,2007-11-17 05:17:01,2007-11-17 02:44:06
8dcf39c46e2931ca02b18b1ea3a6b21f446d8de8...3c6a370b0ee78114a656acba04fddf306252b9d5,3,84,81,165,4,2006-05-19 23:14:50,2006-05-19 23:07:51
3c6a370b0ee78114a656acba04fddf306252b9d5...d9b814cc97f16daac06566a5340121c446136d22,5,157,73,230,7,2006-05-20 00:28:33,2006-05-19 23:19:34
1e2398d7fad308dcc6019709244b40303b51b54d...ffa0a7ab36c1e8a528e4cc0ff451f5fea68658a8,1,57,8,65,8,2006-05-15 20:28:01,2006-05-15 20:28:01
d1802851b0c112a065b43e3f83d631f867b7e1ce...66561f5a776f2343331fff5b98adff1000622f42,2,2,2,4,2,2006-05-13 17:43:16,2006-05-11 17:36:32
d1802851b0c112a065b43e3f83d631f867b7e1ce...8d7a397aab561d3782f531e733b617e0e211f04a,1,1,1,2,1,2006-05-10 02:23:23,2006-05-10 02:23:23
6c87d60cc6202d4de5ac6d136394602feefeafc6...7b459a1c1cc5401295e3adb12031e39e35712f4a,1,14,10,24,6,2007-08-13 04:52:00,2007-08-13 04:52:00
7b459a1c1cc5401295e3adb12031e39e35712f4a...a69b2d1a8bf335ddbf0929c609b2daa523c7ede0,1,11,13,24,3,2007-08-13 05:02:02,2007-08-13 05:02:02
99d8ea2c5ce6fc0b06fe8a43e7c0c108ddad853b...518120e3487a00148f8001454f1e76e484442a22,3,21,1,22,6,2008-02-26 02:59:20,2008-02-25 09:43:33
99d8ea2c5ce6fc0b06fe8a43e7c0c108ddad853b...b560707a1da841d2430d5d1eaeca0f63ddf4aae7,1,93,0,93,1,2008-02-25 23:48:48,2008-02-24 17:19:09
b560707a1da841d2430d5d1eaeca0f63ddf4aae7...b8d97d07fd5025232cae74cfc9a555abd9ac390e,1,57,16,73,7,2008-02-26 06:20:18,2008-02-25 20:07:57
4698ef555a1706fe322a68a02a21fb1087940ac3...fac4b328874ccf515a42e30173d0e008382ac276,1,2,0,2,1,2008-03-15 06:35:55,2008-03-15 04:20:41
a6828f536119c3288b0be772e3870f1a464d017d...8ff45f2af5b25b7581072ee7896f4285dfc034ea,1,8,8,16,4,2008-03-13 07:57:29,2008-03-03 12:42:47
8ff45f2af5b25b7581072ee7896f4285dfc034ea...67abd417165d1e7716d947949f5e5e27318c8a29,1,2,0,2,1,2008-03-13 07:57:29,2008-03-13 00:03:23
67abd417165d1e7716d947949f5e5e27318c8a29...82cea9ffb1c4677155e3e2996d76542502611370,1,4,1,5,1,2008-03-13 07:57:29,2008-03-13 00:03:24
a6828f536119c3288b0be772e3870f1a464d017d...dbdbfec4413d24f9a423c3e2b86a002489f4acbb,1,1,1,2,1,2008-03-13 06:44:42,2008-03-13 06:11:15
dbdbfec4413d24f9a423c3e2b86a002489f4acbb...25ee9731c137d0a24b0f4879eb0b0cce9b77d5b0,5,73,32,105,10,2008-03-13 06:47:01,2008-03-12 20:55:47
a6828f536119c3288b0be772e3870f1a464d017d...40a7ce64e146c79a966a8494d3a7e85826d7f4e9,4,9,6,15,5,2008-03-13 04:10:00,2008-03-12 21:29:57
40a7ce64e146c79a966a8494d3a7e85826d7f4e9...e8e29c7b5507ed97067391490adbeeca2b1bca34,1,2,2,4,1,2008-03-13 07:57:40,2008-03-12 21:30:10
e8e29c7b5507ed97067391490adbeeca2b1bca34...e85fe4d85bc7654af20ccf8054ab6922665405e5,10,17,17,34,16,2008-03-13 07:57:52,2008-03-12 21:31:06
e85fe4d85bc7654af20ccf8054ab6922665405e5...aadbe44f883859536c5320e0ac1d6ed122c45671,9,42,43,85,27,2008-03-13 07:57:52,2008-03-12 21:32:17
aadbe44f883859536c5320e0ac1d6ed122c45671...b4ce54fc61e7c76e2d7f47c34733f0f0bbb6c4cd,7,20,20,40,18,2008-03-13 07:57:52,2008-03-12 21:34:34
b4ce54fc61e7c76e2d7f47c34733f0f0bbb6c4cd...82ebb0b6ec7470cab96a013d3d719c109003ef83,40,133,115,248,112,2008-03-13 07:57:52,2008-03-12 21:36:36
82ebb0b6ec7470cab96a013d3d719c109003ef83...53a5b443b4b3d5beb102615f402e0e4da5ba9179,2,2,1,3,1,2008-03-13 07:57:53,2008-03-12 21:37:37
53a5b443b4b3d5beb102615f402e0e4da5ba9179...cde2ed25ad764260aaa08a9ed3fbd997723c6b76,1,4,1,5,1,2008-03-13 07:57:53,2008-03-12 21:38:31
cde2ed25ad764260aaa08a9ed3fbd997723c6b76...5f7c643afe8da21c82762f872632d6407530f9e8,2,16,2,18,5,2008-03-13 07:57:53,2008-03-12 21:39:16
5f7c643afe8da21c82762f872632d6407530f9e8...d89c1dfac939623a269f60d4e27e3a2929dca29c,1,1,1,2,1,2008-03-13 07:57:53,2008-03-12 21:41:02
d89c1dfac939623a269f60d4e27e3a2929dca29c...4bf9f27dfb4ed6fd67a9bfc6f80e10b8c6980c85,2,2,1,3,2,2008-03-13 07:57:53,2008-03-12 21:41:39
4bf9f27dfb4ed6fd67a9bfc6f80e10b8c6980c85...32aedd5496f53c08bcef5f7709f6bfece4f40978,1,2,0,2,1,2008-03-13 07:57:53,2008-03-12 21:42:15
32aedd5496f53c08bcef5f7709f6bfece4f40978...462f8caf248178121ef705dd1b6980eb3b846833,1,3,2,5,1,2008-03-13 07:57:53,2008-03-12 21:42:43
462f8caf248178121ef705dd1b6980eb3b846833...aab0abf7ef2c7636e3b37d4a939ae68784b08e06,1,7,4,11,1,2008-03-15 00:53:22,2008-03-15 00:32:33
a6828f536119c3288b0be772e3870f1a464d017d...bd92cd0f74562886e101318eaa4c7a01de1faee5,1,5,7,12,3,2008-03-12 08:55:46,2008-03-12 08:31:01
bd92cd0f74562886e101318eaa4c7a01de1faee5...74ca5e6d7ca9351da4743f7a255069c4f3c55cb3,1,276,148,424,5,2008-03-12 08:55:48,2008-03-12 08:46:26
a6828f536119c3288b0be772e3870f1a464d017d...649499845c274dc15809fe3c9162408c334fec57,1,80,1,81,4,2008-03-12 06:02:01,2008-03-07 07:46:28
649499845c274dc15809fe3c9162408c334fec57...b5578f333595e40cb843461e685c887ad2d01e5c,2,26,10,36,6,2008-03-12 06:02:01,2008-03-07 07:46:55
b5578f333595e40cb843461e685c887ad2d01e5c...69099d6bedb0217d7c35f7202acd6185551d762f,1,113,78,191,7,2008-03-12 06:02:01,2008-03-11 07:51:12
69099d6bedb0217d7c35f7202acd6185551d762f...b8322ea83bc23499a2cef883d051859eb79fef25,2,29,2,31,6,2008-03-13 06:03:35,2008-03-13 05:48:46
b8322ea83bc23499a2cef883d051859eb79fef25...5fb0b3e007d6465af99d08121d46be82c649df5a,1,1,1,2,1,2008-03-13 06:23:27,2008-03-13 06:10:40
5fb0b3e007d6465af99d08121d46be82c649df5a...63f671a4406f33bf689d854596124a40f5b9a22a,1,1,1,2,1,2008-03-14 02:15:30,2008-03-14 02:15:30
891e85a0c08e12d3f6174d8eb10b4ef284c4b01b...79f43f3de8d992f141e1b08ab8f7bce5e66947f9,1,4,4,8,3,2008-03-07 21:29:07,2008-03-06 20:28:07
79f43f3de8d992f141e1b08ab8f7bce5e66947f9...c2116a1783a3d555d41892ae7db0dd0934d4ddf1,1,17,7,24,5,2008-03-07 21:29:07,2008-03-07 03:04:26
c2116a1783a3d555d41892ae7db0dd0934d4ddf1...c8744d6a8b27115503565041566d97c21e722584,1,1,1,2,1,2008-03-07 21:31:30,2008-03-06 21:28:19
f15b75855fe15ac54adc4908f65e8a7572d47c9f...312fd92b069d26dce20f53e8fa4efea04b12e009,1,673,550,1223,515,2008-03-06 04:45:19,2008-01-06 09:47:05
312fd92b069d26dce20f53e8fa4efea04b12e009...c382fdd79548a56fadf8f34d3484cf020eda3966,6,47,16,63,24,2008-03-06 04:47:11,2008-03-05 16:54:22
c382fdd79548a56fadf8f34d3484cf020eda3966...11027d544b4f6aed0b84111a2122224cd201a182,2,3,1,4,3,2008-03-08 01:59:35,2008-03-06 19:38:40
11027d544b4f6aed0b84111a2122224cd201a182...7276607886e99fa3bb5f0ddadb9f0daeb3958d2d,1,1,6,7,2,2008-03-12 05:48:32,2008-03-12 05:29:52
84989bd820119260c4fcd0dd5ee8a50bc8ff0d2c...5c09f321729c2f1ce6718a0cfefa5e647fa808fc,1,2,0,2,1,2008-03-03 04:58:19,2008-03-03 04:08:43
5c09f321729c2f1ce6718a0cfefa5e647fa808fc...fcbcfe707ae23b37d72025a229f31c450fb4d3b3,1,1,1,2,1,2008-03-03 05:25:45,2008-03-03 02:03:18
fcbcfe707ae23b37d72025a229f31c450fb4d3b3...90d0ed96b76ee51f8ae6f32923b92e7b20ba73c0,2,25,8,33,5,2008-03-03 07:15:06,2008-02-28 21:09:30
90d0ed96b76ee51f8ae6f32923b92e7b20ba73c0...0f2d4476c12c15106be20d53c507035e157b66f1,2,25,4,29,5,2008-03-03 07:33:59,2008-03-03 06:30:56
0f2d4476c12c15106be20d53c507035e157b66f1...d3df4271b900c9bf529cf495afeb77fbbf621221,1,21,1,22,3,2008-03-03 07:37:54,2008-03-03 05:49:28
dfb9a34ababeee98a9f241636c1fe6e98c754f7a...a0c14cbb2eebaa86b57ef797d0a03b836a817dd5,2,8,1,9,5,2008-03-01 09:09:06,2008-02-29 21:53:39
a0c14cbb2eebaa86b57ef797d0a03b836a817dd5...c3b088d9daa8294101dbfed4b2db0373ef24d52b,1,1,1,2,2,2008-03-01 09:10:12,2008-03-01 09:10:12
c3b088d9daa8294101dbfed4b2db0373ef24d52b...3ebfe63a82cdad55f4b4401f22be07f04cd438c2,1,59,0,59,1,2008-03-01 09:15:32,2008-02-29 22:08:47
3ebfe63a82cdad55f4b4401f22be07f04cd438c2...ee542ee3fc309fa95622b274c09eefbe394cd108,1,4,3,7,2,2008-03-01 09:30:15,2008-03-01 06:14:31
ee542ee3fc309fa95622b274c09eefbe394cd108...c14918415a36e93a84ed1f58ce079619f84e26fa,1,2,0,2,2,2008-03-01 09:31:18,2008-03-01 06:22:55
8c87dc77ae45d7277001b1be2c88ea9062e11d72...ce4a7bff41c6bb4dc2d578264a429b5e13e89bdc,1,1,1,2,1,2008-02-25 04:09:54,2008-02-25 03:57:29
ce4a7bff41c6bb4dc2d578264a429b5e13e89bdc...ed10d9aa3f771ad343df5aa50d9004945f7a4e56,1,9,0,9,1,2008-02-25 21:05:25,2008-02-25 14:43:53
ed10d9aa3f771ad343df5aa50d9004945f7a4e56...1468bd47833c6ec3c85620d6af1d910e9378f714,5,27,43,70,8,2008-02-25 21:06:49,2008-02-25 19:24:48
1468bd47833c6ec3c85620d6af1d910e9378f714...e103343644188ddddb3678f0568d150ca56f59e3,2,44,1,45,2,2008-02-26 05:40:12,2008-02-26 04:07:39
e103343644188ddddb3678f0568d150ca56f59e3...41e86a377496231709a5fb78df730df7be80b6c9,1,4,2,6,2,2008-02-26 05:43:37,2008-02-26 02:14:31
41e86a377496231709a5fb78df730df7be80b6c9...695ed47228021f7408f58e6174168ea583c448d0,1,3,3,6,1,2008-02-26 05:56:10,2008-02-26 00:45:53
695ed47228021f7408f58e6174168ea583c448d0...81fa145917c40b68a5e2cca6afc6a10cdfdbd25b,1,1,1,2,1,2008-02-26 06:20:08,2008-02-25 22:40:19
923d44aeb7cb6d21eeb459fdc1b58137e37c2b1c...41eb33bd0cbecf1b441ada91ab186ee49fb086cc,1,59,64,123,9,2008-02-25 02:31:49,2008-02-24 22:16:55
41eb33bd0cbecf1b441ada91ab186ee49fb086cc...94351118c0a820002b093598e7fac5bdf3c0291f,4,29,15,44,6,2008-02-25 02:31:49,2008-02-24 22:17:14
94351118c0a820002b093598e7fac5bdf3c0291f...2156435ff22437909cda825f1901dceb198fef19,1,32,1,33,5,2008-02-25 02:31:50,2008-02-24 22:17:37
923d44aeb7cb6d21eeb459fdc1b58137e37c2b1c...b577bb925e745845155c6f51eae841c339ce68f6,2,10,6,16,7,2008-02-25 01:41:33,2008-02-24 01:14:17
923d44aeb7cb6d21eeb459fdc1b58137e37c2b1c...9d561ad324fc8942919981f2c80360e22896989c,1,1,1,2,1,2008-02-23 22:22:01,2008-02-23 21:37:08
9d561ad324fc8942919981f2c80360e22896989c...e85486450eb0407ad0449d0214b97506d452407f,2,8,5,13,3,2008-02-24 18:01:13,2008-02-23 21:36:08
923d44aeb7cb6d21eeb459fdc1b58137e37c2b1c...833e3df17188e48b2d31db0966a4051dad5e03b9,6,69,4,73,11,2008-02-23 20:00:32,2008-02-23 02:11:56
833e3df17188e48b2d31db0966a4051dad5e03b9...6c723f5e6bc579e06a904874f1ceeb8ff2b5a17c,1,3,0,3,1,2008-02-23 20:00:32,2008-02-23 02:12:58
6c723f5e6bc579e06a904874f1ceeb8ff2b5a17c...392b78ca42b6b1a68a77966acab38554c6edab3e,1,0,3,3,1,2008-02-27 07:27:31,2008-02-27 07:27:31
923d44aeb7cb6d21eeb459fdc1b58137e37c2b1c...e72ae28895b22052b7ca2eef36c039ac62671f7d,8,9,11,20,14,2008-02-23 19:59:44,2008-02-16 17:36:38
e72ae28895b22052b7ca2eef36c039ac62671f7d...c20181e3a3e39f2c8874567c219e9edddb84393a,5,49,11,60,19,2008-02-23 19:59:44,2008-02-21 22:42:56
527270689c364bea9b0630df9bae5e09c2071c1e...7a31cc0f96681d6cba54b38bb87daa2440bef448,2,24,0,24,3,2008-02-11 02:42:06,2008-02-11 00:23:03
7a31cc0f96681d6cba54b38bb87daa2440bef448...473d33168be9b0984f6281d5613f3b7b84817e99,1,5,5,10,1,2008-02-11 19:22:01,2008-02-11 19:22:01
473d33168be9b0984f6281d5613f3b7b84817e99...ce32660edc2b83c6fdf550f6869e0b01e255dadb,2,18,2,20,4,2008-02-11 20:04:17,2008-02-10 13:59:50
ce32660edc2b83c6fdf550f6869e0b01e255dadb...0ed50ceb48662e1d2b4e131f1ed79252062547dd,3,13,11,24,7,2008-02-11 20:14:03,2008-02-11 11:27:20
0ed50ceb48662e1d2b4e131f1ed79252062547dd...65ae89bc315753e7bb31e941e77e002003665bc0,1,1,1,2,1,2008-02-11 20:18:53,2008-02-11 13:45:26
65ae89bc315753e7bb31e941e77e002003665bc0...8464010f974245b1e392d34ddbfb914fcf3d8c23,2,71,0,71,3,2008-02-11 20:22:58,2008-02-07 02:55:14
8464010f974245b1e392d34ddbfb914fcf3d8c23...5a95b85566b1700e042fdce6ec2de9ce7b5a8787,1,1,0,1,1,2008-02-11 20:24:27,2008-02-08 09:53:58
5a95b85566b1700e042fdce6ec2de9ce7b5a8787...9c2174350cc0ae0f6bad126e15fe1f9f044117ab,1,11,2,13,4,2008-02-11 20:24:33,2008-02-11 07:26:25
9c2174350cc0ae0f6bad126e15fe1f9f044117ab...e94a45de42cea90f6fbd313cfabb5dd10d49e03c,1,4,1,5,2,2008-02-11 20:51:55,2008-02-04 13:13:07
e94a45de42cea90f6fbd313cfabb5dd10d49e03c...ac3593da8f224d32cd4ffbd43ee7a04c732686dc,2,20,1,21,4,2008-02-11 20:51:55,2008-02-04 22:01:20
ac3593da8f224d32cd4ffbd43ee7a04c732686dc...b26768e25685b4f575ae07a38e5180b9879bd01e,1,3,4,7,3,2008-02-11 20:51:55,2008-02-09 09:41:36
b26768e25685b4f575ae07a38e5180b9879bd01e...cc1816b0d64a2aa3d6c32d642c3b403f8625c484,1,1,1,2,1,2008-02-11 21:11:36,2008-02-09 04:38:22
cc1816b0d64a2aa3d6c32d642c3b403f8625c484...c5e5a2c097240e7d51374eef398d388c5ee5cc9b,1,1,1,2,1,2008-02-11 21:11:36,2008-02-08 14:26:18
c5e5a2c097240e7d51374eef398d388c5ee5cc9b...40ea4ed9032a80c9dba706d6030bd11b08c35f4d,2,10,0,10,2,2008-02-11 21:11:36,2008-02-11 18:41:18
40ea4ed9032a80c9dba706d6030bd11b08c35f4d...a0ed3e6adea2ca69b7f4a76ac771e39cc9fa272e,1,2,0,2,1,2008-02-11 21:11:36,2008-02-11 18:44:49
a0ed3e6adea2ca69b7f4a76ac771e39cc9fa272e...5768c98ab8892ee0ca46e23ed46c4d94e0503e72,1,6,3,9,2,2008-02-11 21:11:36,2008-02-11 18:45:50
5768c98ab8892ee0ca46e23ed46c4d94e0503e72...d865eb2a0d5f121a46dfcc18c78e7f27e0af0fbc,1,2,0,2,1,2008-02-11 21:11:36,2008-02-11 18:46:39
d865eb2a0d5f121a46dfcc18c78e7f27e0af0fbc...f769982d02f70534789593e2bab889c9aa3a641c,1,2,0,2,1,2008-02-11 21:11:36,2008-02-11 18:48:12
f769982d02f70534789593e2bab889c9aa3a641c...995c45279e270811f53b7ff8bf44a07ed3457ddc,1,1,1,2,1,2008-02-11 21:11:36,2008-02-11 18:48:55
995c45279e270811f53b7ff8bf44a07ed3457ddc...4f342b96d15205ec052e400f10121dd7cee39963,1,11,5,16,3,2008-02-11 21:11:36,2008-02-11 18:50:06
4f342b96d15205ec052e400f10121dd7cee39963...4f9c412bf778e091d06cd01376b64cef15e3954c,1,2,0,2,1,2008-02-11 21:11:36,2008-02-11 18:51:03
4f9c412bf778e091d06cd01376b64cef15e3954c...406d95f2d013bd17d79bbcf9438a2f03bd70a78a,1,1,1,2,1,2008-02-11 21:11:36,2008-02-11 18:51:31
406d95f2d013bd17d79bbcf9438a2f03bd70a78a...c64b9ad0fc02134d7271eb841fbdef9bc16660ea,1,2,0,2,1,2008-02-11 21:11:36,2008-02-11 18:52:15
c64b9ad0fc02134d7271eb841fbdef9bc16660ea...a7269e5cb703083efb084ba19bc703ebc915aa5c,1,2,2,4,2,2008-02-11 21:11:36,2008-02-11 18:53:36
a7269e5cb703083efb084ba19bc703ebc915aa5c...64f30e948be5fb2cd2f65e91c0eab5ab4719c636,1,12,2,14,6,2008-02-11 21:11:36,2008-02-11 18:53:56
64f30e948be5fb2cd2f65e91c0eab5ab4719c636...e08404a82d19a60fd60822e8c0d95dd5629e0809,1,2,0,2,1,2008-02-11 21:11:37,2008-02-11 18:56:06
e08404a82d19a60fd60822e8c0d95dd5629e0809...b51b2bb4c3da805727fd43219e3f817475ae52d3,1,2,0,2,1,2008-02-11 21:11:37,2008-02-11 18:56:26
b51b2bb4c3da805727fd43219e3f817475ae52d3...111dd25f3c34ccad101047c32e89d1bb87136f60,1,15,10,25,5,2008-02-11 21:11:37,2008-02-11 18:57:22
111dd25f3c34ccad101047c32e89d1bb87136f60...e098368b5b990eb05cbc60a271ab6d731820e0c2,1,6,5,11,4,2008-02-11 21:11:37,2008-02-11 18:59:17
e098368b5b990eb05cbc60a271ab6d731820e0c2...d2370cc2960d3b0a090c57dfea99209c59b515f7,1,6,3,9,4,2008-02-11 21:11:37,2008-02-11 19:00:10
d2370cc2960d3b0a090c57dfea99209c59b515f7...180483c5c94a37c9fe304dded99d3db56d2d2b38,1,2,0,2,1,2008-02-11 21:11:37,2008-02-11 19:00:32
180483c5c94a37c9fe304dded99d3db56d2d2b38...451d36bb25e1832dbe66b799f6526daa0b637d26,1,2,0,2,1,2008-02-11 21:11:37,2008-02-11 19:00:57
451d36bb25e1832dbe66b799f6526daa0b637d26...3c17c34ac79f58665db73deeb995bc070b7f1a2f,1,4,0,4,1,2008-02-11 21:14:25,2008-02-11 20:04:00
3c17c34ac79f58665db73deeb995bc070b7f1a2f...90f5c1864caf40ac2a0fef6bc771eab3ecc561b6,1,2,3,5,3,2008-02-11 21:14:25,2008-02-11 21:09:16
90f5c1864caf40ac2a0fef6bc771eab3ecc561b6...6c47d0e8f3983cff5bf633cb8e6f7ecfecf48db7,1,15,1,16,8,2008-02-11 21:14:25,2008-02-11 21:10:27
a4cfcb023d09b839670d3e9bf93d28ee5e906582...053d9e432be246a389fb8adaa0c88e7c791f8b21,1,1,1,2,1,2008-02-07 08:39:08,2008-02-04 20:41:43
71349732c53a4c1b64729628b04db7b3c3f7606d...3c5283f8b19aaba3a6105fa486cabe4d0ca48009,1,1,3,4,2,2008-04-12 06:03:50,2008-04-10 11:33:08
3c5283f8b19aaba3a6105fa486cabe4d0ca48009...243a60fbb5e185e2bf3c4bb1c53128b4d04d5879,2,16,3,19,5,2008-04-12 06:03:50,2008-04-11 03:55:21
71349732c53a4c1b64729628b04db7b3c3f7606d...4d4f5ba3ea9d22137f86f1d8e574a667e76e45bf,2,7,1,8,3,2008-04-10 19:40:50,2008-04-09 19:32:06
71349732c53a4c1b64729628b04db7b3c3f7606d...4da45bef56e1547eb6525015ada0fdfc01d8295b,7,42,30,72,15,2008-04-10 10:25:03,2008-04-08 00:11:34
71349732c53a4c1b64729628b04db7b3c3f7606d...c4112bb6bbc83708c7b54deac0928e66b4de2302,1,6,1,7,3,2008-04-10 08:37:12,2008-04-09 15:15:51
71349732c53a4c1b64729628b04db7b3c3f7606d...e5c49826d26e71ea18ff3010ef75edb1849df7ec,1,1,3,4,2,2008-04-10 08:02:59,2008-04-10 00:11:52
7cb97da17da080b88ceb0417108e6a3cb6c6299f...cf5c51efc9fe3b0ef93c7b78005c57b71acaf959,5,83,3,86,6,2008-02-17 09:51:46,2008-02-17 09:18:54
6281f394674bf2db861967da6c2215cfc3fc78af...6851162adf29762cd121555645214468451a3111,1,6,5,11,1,2007-12-17 23:54:28,2007-12-17 12:43:59
6851162adf29762cd121555645214468451a3111...4f3d37035a7c735a3b69f962656819f4ff7e4927,1,5,1,6,3,2007-12-17 23:58:05,2007-12-17 20:51:34
9b2a1821245c0e638f7b5e9da81118743fcc0120...aac5bf0b48c5f23cf482ca7958fa6815fe6502ed,1,1,1,2,1,2007-11-13 21:25:23,2007-11-13 21:05:50
aac5bf0b48c5f23cf482ca7958fa6815fe6502ed...245de36f035f9d549df2b1509787c25648fd611f,1,1,1,2,1,2007-11-13 21:25:51,2007-11-13 20:28:53
245de36f035f9d549df2b1509787c25648fd611f...436e7a74c638bc9de2e585ce3eb0fd4bd6e06115,1,13,7,20,8,2007-11-14 05:57:53,2007-11-14 04:48:42
436e7a74c638bc9de2e585ce3eb0fd4bd6e06115...c05ef93879696638406cad5be54be577a2666d04,1,9,8,17,5,2007-11-14 09:56:32,2007-11-14 07:51:41
c05ef93879696638406cad5be54be577a2666d04...97e9a2216f33d1b6cff312f9535b6cf0d0ba4f16,2,8,4,12,2,2007-11-14 09:58:03,2007-11-12 04:43:00
97e9a2216f33d1b6cff312f9535b6cf0d0ba4f16...065c5ac1688ca5cde826dc87d9791c2eedec7026,1,2,2,4,2,2007-11-14 09:59:12,2007-11-10 13:17:33
065c5ac1688ca5cde826dc87d9791c2eedec7026...cb5c49b9afb5551659c6819aefaa8e4de26a4366,1,1,1,2,1,2007-11-14 09:59:22,2007-11-13 18:17:47
cb5c49b9afb5551659c6819aefaa8e4de26a4366...7f55cf451c9e7c35cad2efcd0bb7bbd7c7ae29ac,3,12,3,15,6,2007-11-14 10:01:54,2007-11-14 09:38:46
7f55cf451c9e7c35cad2efcd0bb7bbd7c7ae29ac...b57321f57b324320bdcf9f453ec4788da166f8f4,2,19,1,20,4,2007-11-14 10:03:29,2007-11-14 09:54:43
a91ef6e75b897a255cc17b70014a39e68dd54c7a...c8cfa3e4a5b1d1d4c870c82d2dbf162f570f0561,2,9,0,9,2,2007-11-12 07:40:32,2007-11-11 18:41:41
c8cfa3e4a5b1d1d4c870c82d2dbf162f570f0561...53e780c8f662bb937dc66a698c34fa2407cff31b,1,1,1,2,1,2007-11-12 07:40:32,2007-11-12 04:07:05
53e780c8f662bb937dc66a698c34fa2407cff31b...a74fa1106dd29390077025e7f176cf6b53eada62,1,1,1,2,1,2007-11-12 07:40:33,2007-11-12 04:37:25
a91ef6e75b897a255cc17b70014a39e68dd54c7a...e70f3202512a022898657047b59b46355be1631b,1,2,3,5,3,2007-11-11 23:50:59,2007-11-11 17:38:11
a91ef6e75b897a255cc17b70014a39e68dd54c7a...859a4dbcadd200ae955fe36d0c4fb3f4bce0e032,2,33,1,34,2,2007-11-11 23:41:07,2007-11-11 12:28:08
78e694787cb89cd008e237b17cdc7f0fa5a15d22...4b87474bc9b620cf07b09130e33963cdaf34c603,1,3,3,6,3,2007-11-18 05:19:55,2007-11-18 05:18:14
4b87474bc9b620cf07b09130e33963cdaf34c603...005e2dfdf299a7d869fa9ec819171fba574f42eb,2,6,10,16,5,2007-11-18 22:00:38,2007-11-18 22:00:38
78e694787cb89cd008e237b17cdc7f0fa5a15d22...8391c60b6e08604e7023a8fff74350d6b35974af,1,1,1,2,1,2007-11-18 01:45:12,2007-11-03 02:54:31
8391c60b6e08604e7023a8fff74350d6b35974af...3fb00282538409daf4d05ce4631a2c3eae235c69,1,66,0,66,1,2007-11-18 23:15:47,2007-11-10 13:49:54
3fb00282538409daf4d05ce4631a2c3eae235c69...5b98d9bca16e19710380d2d03f704de9eb98621d,1,11,4,15,2,2007-11-19 00:22:26,2007-11-19 00:18:27
5b98d9bca16e19710380d2d03f704de9eb98621d...c251005c7a5279166a27d4d06854f0c3d26e8208,2,3,8,11,4,2007-11-19 01:50:57,2007-11-19 01:50:57
78e694787cb89cd008e237b17cdc7f0fa5a15d22...481f0ee60eef2c34b891e5d04b7e6e5a955eedf4,4,59,3,62,6,2007-11-17 06:05:33,2007-11-11 23:35:23
ffa0a7ab36c1e8a528e4cc0ff451f5fea68658a8...f66475199cbf50d9da9db617a280aac3196b2250,1,1,1,2,1,2006-05-16 01:06:18,2006-05-16 00:54:01
66561f5a776f2343331fff5b98adff1000622f42...d9635e9c539465792b1920437b52fa8792a71650,2,2,0,2,2,2006-05-14 23:19:52,2006-05-14 20:34:56
66561f5a776f2343331fff5b98adff1000622f42...618faa1dc7cb5898473861c286391d0a4b043107,1,1,1,2,1,2006-05-13 21:00:15,2006-05-10 02:23:23
618faa1dc7cb5898473861c286391d0a4b043107...bdf0ef0824ecca427ec04ac047ffe4aaf73ace5a,1,3,1,4,2,2006-05-13 21:00:16,2006-05-06 18:14:02
bdf0ef0824ecca427ec04ac047ffe4aaf73ace5a...d14f776402d9f7040cc71ff6e3b992b2e019526a,3,90,20,110,12,2006-05-13 21:00:16,2006-05-09 19:24:02
a69b2d1a8bf335ddbf0929c609b2daa523c7ede0...b1054ac985aebc90c0a78202dab8477b74d7818a,1,2,2,4,2,2007-08-15 00:09:47,2007-08-15 00:09:47
b1054ac985aebc90c0a78202dab8477b74d7818a...890fae7041bb0607f386ac1a996a49530f1cd86f,1,32,2,34,9,2007-08-15 00:13:27,2007-08-12 10:05:46
890fae7041bb0607f386ac1a996a49530f1cd86f...e8b5f4be708a73fd8b6c06a782168d5b04e3e5c1,1,5,2,7,5,2007-08-15 00:15:53,2007-08-14 20:02:04
2db511fdbdbe1c8aab80f4bc13f0df037bce8a33...6eaf40608dfe0c23aa990a8c7d4a135df1af3cab,1,12,5,17,3,2008-02-27 23:38:24,2008-02-27 19:27:53
6eaf40608dfe0c23aa990a8c7d4a135df1af3cab...faa4bc35a05ddb1822f3770cd8c51859e3b929ee,5,218,2,220,6,2008-02-27 23:38:40,2008-02-27 19:28:45
2db511fdbdbe1c8aab80f4bc13f0df037bce8a33...95775e5377960409a1b3ac4082dded7d17e14a46,1,3,3,6,2,2008-02-27 22:01:32,2008-02-27 21:50:44
2db511fdbdbe1c8aab80f4bc13f0df037bce8a33...354081d5a0392a015731a637f026dc885a4ddb0f,1,22,4,26,7,2008-02-27 14:17:05,2008-02-03 18:38:51
354081d5a0392a015731a637f026dc885a4ddb0f...4b61b5c963ad1fd59e858c2bc21b1b48836f04f8,1,0,7,7,3,2008-02-27 15:26:57,2008-02-19 08:12:29
4b61b5c963ad1fd59e858c2bc21b1b48836f04f8...edae1e2f407d0e9c6c92333047bc31b27bfdd58f,1,17,17,34,5,2008-02-27 15:27:03,2008-02-19 08:29:06
edae1e2f407d0e9c6c92333047bc31b27bfdd58f...0e36f2d726d4ce50c3f128bcc168d59ad03e804f,1,11,45,56,9,2008-02-27 15:27:07,2008-02-19 08:33:08
0e36f2d726d4ce50c3f128bcc168d59ad03e804f...4c750c0d8bfd7e75b86d660def012bff17d2bf8e,1,10,41,51,14,2008-02-27 15:27:10,2008-02-19 08:37:16
4c750c0d8bfd7e75b86d660def012bff17d2bf8e...3a70cdfa42199e16d2d047c286431c4274d65b1a,1,42,8,50,9,2008-02-27 15:27:13,2008-02-18 14:22:08
2db511fdbdbe1c8aab80f4bc13f0df037bce8a33...c6fabfafbcebca13cee0047b337b7c7a87e3515e,1,1,1,2,1,2008-02-26 20:24:40,2008-02-26 20:24:40
c6fabfafbcebca13cee0047b337b7c7a87e3515e...dc1c0fffd3723ceebff51053938db5baf26a47f5,3,15,1,16,6,2008-02-27 07:59:49,2008-02-26 12:22:05
dc96bdb9469632fcb29f660d18a96fede99fcea2...970639740c5f57508e42aeacd23823d7cf001659,2,2,2,4,2,2008-03-23 07:11:31,2008-03-23 07:04:48
970639740c5f57508e42aeacd23823d7cf001659...bc6100087cfac0293e6ccbea95a24223b724d072,2,5,2,7,3,2008-03-23 07:22:29,2008-03-23 07:21:48
b75aaa546e0593440d85c77d380c9b53e126ea02...f746bae84e4746a861d9ebed29fd9255e5cd929f,2,27,0,27,6,2008-03-14 05:51:30,2008-03-13 18:59:29
f746bae84e4746a861d9ebed29fd9255e5cd929f...ca885a4fe6444bed840295378848904106c87c85,3,9,8,17,7,2008-03-14 06:56:36,2008-03-14 05:07:18
1f17868b303f762556034db81d02c55de2878e07...1f9ff0de82f0f2990f3d6f06dad1d381158c2a75,2,2,2,4,2,2008-03-15 08:23:26,2008-03-15 08:23:26
deda26b9935bdca8d140006b224a278ec0377a33...29dc13319883f97618de6f03e8ffc5dc810d8786,2,49,2,51,3,2008-03-19 05:17:17,2008-03-17 23:47:18
29dc13319883f97618de6f03e8ffc5dc810d8786...8d14ac945403d6d4b1de9f9fd680247e831c0bfc,1,6,1,7,1,2008-03-19 05:17:22,2008-03-19 04:58:01
8d14ac945403d6d4b1de9f9fd680247e831c0bfc...8a785dc921386dac628a2a04ebe5f48deb7cc1a8,1,35,0,35,1,2008-03-19 05:17:22,2008-03-19 04:59:39
8a785dc921386dac628a2a04ebe5f48deb7cc1a8...c4758d3c9342ea2245ca51f30f1cbf27ecc16ced,2,7,4,11,6,2008-03-19 05:17:22,2008-03-19 05:01:28
c4758d3c9342ea2245ca51f30f1cbf27ecc16ced...971f229c50aeace83d6fd30de1de755f419d4cb8,1,2,2,4,2,2008-03-19 05:18:57,2008-03-17 15:56:27
971f229c50aeace83d6fd30de1de755f419d4cb8...ef00d150e4f9959bf083adf92419b5053ba11584,1,38,9,47,9,2008-03-19 05:18:57,2008-03-18 02:05:23
ef00d150e4f9959bf083adf92419b5053ba11584...1d0a694b8ace7b54256c8c40ca23939c8c9b49fd,1,10,10,20,2,2008-03-19 05:18:57,2008-03-18 02:04:40
1d0a694b8ace7b54256c8c40ca23939c8c9b49fd...7d004199d134c9d465e013064f72dbc04507f6c0,2,38,10,48,7,2008-03-19 08:42:35,2008-03-18 01:56:33
7d004199d134c9d465e013064f72dbc04507f6c0...420e9af498848f9a3994ecb471dc51d5203f51cd,1,16,0,16,3,2008-03-19 08:43:02,2008-03-18 02:15:02
420e9af498848f9a3994ecb471dc51d5203f51cd...02b00e16bb372fd13e1ac440e9fbafd223d43af0,1,7,0,7,1,2008-03-19 08:43:02,2008-03-18 12:26:43
02b00e16bb372fd13e1ac440e9fbafd223d43af0...b14d255ba8362a4debe51dc67d6b98d06fdc36aa,1,3,3,6,2,2008-03-20 00:29:52,2008-03-19 21:53:20
b14d255ba8362a4debe51dc67d6b98d06fdc36aa...05f304526197ac6e27ce1fe2e010eb023472b30b,1,9,2,11,1,2008-03-20 00:30:53,2008-03-19 21:06:11
05f304526197ac6e27ce1fe2e010eb023472b30b...7ccd366779dd0ff042472fd76223267c19b2e498,1,1,0,1,1,2008-03-20 00:31:51,2008-03-19 06:16:28
7ccd366779dd0ff042472fd76223267c19b2e498...a811e4f0f023d88596adbf39674a18d34b2f152d,1,3,0,3,1,2008-03-20 00:32:28,2008-03-19 06:16:29
a811e4f0f023d88596adbf39674a18d34b2f152d...740fdd27f0888d5c80ef6a550734bdc53febd2df,2,14,1,15,2,2008-03-20 00:33:30,2008-03-19 00:27:42
740fdd27f0888d5c80ef6a550734bdc53febd2df...8114da161611d6eb7cc6163aee2f5ba51ccad9f3,2,32,1,33,2,2008-03-21 06:59:12,2008-03-20 20:08:49
8114da161611d6eb7cc6163aee2f5ba51ccad9f3...c8a086929060eef9f0ce9f149d9dc22a6df6b85a,1,6,6,12,5,2008-03-23 00:23:29,2008-03-20 16:54:30
c8a086929060eef9f0ce9f149d9dc22a6df6b85a...bf7c90216df7f6ac84dee7d30e14c954d48f4718,1,12,11,23,6,2008-03-23 00:25:16,2008-03-20 21:30:32
bf7c90216df7f6ac84dee7d30e14c954d48f4718...3644da7214055d2e84223b45dfca42d437fb7ea7,1,23,2,25,2,2008-03-23 00:53:12,2008-03-21 07:27:35
3644da7214055d2e84223b45dfca42d437fb7ea7...9b33fa08b2d9507f8ffefe7649a59d23b4176185,1,8,3,11,3,2008-03-23 06:20:01,2008-03-21 15:25:18
9b33fa08b2d9507f8ffefe7649a59d23b4176185...46220ca100cfbcdd7d80a5ac3326c52a3e98dddb,5,188,49,237,17,2008-03-23 06:46:17,2008-03-21 06:34:37
c8744d6a8b27115503565041566d97c21e722584...5b044ac3879b0950675f0e762f1dccbbb9f4001e,2,34,1,35,2,2008-03-08 21:25:57,2008-03-08 20:25:58
7276607886e99fa3bb5f0ddadb9f0daeb3958d2d...0c87a951c2970ec5fe204c3743b467819ee42a64,1,346,265,611,232,2008-03-13 05:23:22,2008-02-14 12:42:19
0c87a951c2970ec5fe204c3743b467819ee42a64...48ed49f2eb98949c59ad841365709f4cdec52977,1,102,38,140,20,2008-03-13 12:31:10,2008-03-13 12:31:10
48ed49f2eb98949c59ad841365709f4cdec52977...0212242d6697d9e0fd076d7c633b90ecea7691c6,8,2311,1841,4152,1644,2008-03-14 06:36:18,2008-03-14 06:36:18
0212242d6697d9e0fd076d7c633b90ecea7691c6...9065c36ea3945a21813bb3172f024e9bbc5869d2,1,375,290,665,246,2008-03-14 06:36:44,2008-03-14 06:36:44
9065c36ea3945a21813bb3172f024e9bbc5869d2...4f994937c8aa5306a6ef1c5e183dc5e958719243,1,0,2,2,2,2008-03-15 05:00:09,2008-03-14 20:59:52
4f994937c8aa5306a6ef1c5e183dc5e958719243...b79f5ffc9ba628220140c8e2f9daaff650d4e374,1,21,27,48,27,2008-03-15 05:00:57,2008-03-14 22:25:57
b79f5ffc9ba628220140c8e2f9daaff650d4e374...427f48603ef0384bbb5f0de37272ad44c38cae1d,1,9,14,23,14,2008-03-15 05:02:25,2008-03-14 16:28:53
427f48603ef0384bbb5f0de37272ad44c38cae1d...442b3caaee6da96292baf1769b364498af5097fa,2,2,2,4,2,2008-03-15 05:11:08,2008-03-15 05:11:08
442b3caaee6da96292baf1769b364498af5097fa...45e53d17ee0a8c98aab961112f57a4ac6042d877,1,266,291,557,245,2008-03-15 06:22:08,2008-03-14 13:03:21
45e53d17ee0a8c98aab961112f57a4ac6042d877...02a8b27645f2c93b540d553f8a8fa51079d7a3f0,1,277,249,526,229,2008-03-15 06:23:06,2008-03-15 06:22:41
02a8b27645f2c93b540d553f8a8fa51079d7a3f0...477ef326a3d554c0ad0e4a6d828354c5faafe178,1,9,13,22,13,2008-03-16 03:57:28,2008-03-15 11:12:00
477ef326a3d554c0ad0e4a6d828354c5faafe178...739a6d4970836463f5ffc9f56381e4efc9e61914,1,50,12,62,2,2008-03-16 06:06:12,2008-03-15 07:43:34
d3df4271b900c9bf529cf495afeb77fbbf621221...f23d1f76273a59b030ea1028016e6a9fc9679d2c,1,3,11,14,5,2008-03-03 21:36:44,2008-03-03 19:30:16
f23d1f76273a59b030ea1028016e6a9fc9679d2c...e6d1f76ccf9de037c5479acdd9b6211e80145142,2,17,6,23,9,2008-03-03 21:38:30,2008-03-03 09:22:03
e6d1f76ccf9de037c5479acdd9b6211e80145142...81646ad247955a8343b58f05f12157dacabe1e5e,1,2,1,3,1,2008-03-03 21:40:15,2008-03-03 17:52:49
81646ad247955a8343b58f05f12157dacabe1e5e...52dce39762fbec75b2d561e5dedb25b8e51f83eb,1,0,4,4,1,2008-03-04 06:47:14,2008-03-04 06:00:36
c14918415a36e93a84ed1f58ce079619f84e26fa...ff962a3f1900966d008d6f9eaf32095c42322b9d,2,29,16,45,4,2008-03-02 22:07:47,2008-03-02 08:21:38
ff962a3f1900966d008d6f9eaf32095c42322b9d...580d5bffdea56dfae1e745dbda94f326bb161274,4,39,7,46,11,2008-03-02 22:07:47,2008-03-02 10:35:56
c14918415a36e93a84ed1f58ce079619f84e26fa...009c98ee170b36598548cc67c54826544cced108,1,12,0,12,1,2008-03-02 02:18:16,2008-03-02 02:18:16
009c98ee170b36598548cc67c54826544cced108...f32086becc2b46bda0680ef178935546a64ad693,1,1,0,1,1,2008-03-02 03:45:15,2008-03-01 11:39:52
f32086becc2b46bda0680ef178935546a64ad693...48411d2233aec65b612ac2b1f50540ec60f0f568,2,3,4,7,4,2008-03-02 07:52:00,2008-03-01 10:32:14
48411d2233aec65b612ac2b1f50540ec60f0f568...b66fde9a287f64ed81d4d4a1639997ad5eedb432,1,6,7,13,5,2008-03-02 07:52:13,2008-03-02 07:35:32
b66fde9a287f64ed81d4d4a1639997ad5eedb432...2efb3b061709bd204f11d54c177dae89e4af0f67,3,3,11,14,4,2008-03-02 07:52:13,2008-03-02 07:43:32
2efb3b061709bd204f11d54c177dae89e4af0f67...c8c16f2865f7c9c0d59b31ce66d50a4ecae72fd0,1,6,7,13,7,2008-03-02 09:00:30,2008-03-02 08:57:26
c8c16f2865f7c9c0d59b31ce66d50a4ecae72fd0...2b459b483cb264d3e9a39cd7857da2ccab08179f,2,55,5,60,2,2008-03-02 09:08:34,2008-03-02 08:07:59
2b459b483cb264d3e9a39cd7857da2ccab08179f...e371a4c648e72673fcfdf0b45192857dd149e2f5,2,5,1,6,3,2008-03-02 09:58:31,2008-03-02 07:40:33
e371a4c648e72673fcfdf0b45192857dd149e2f5...a3647bee1a91d930c4c3e17e36232b5c4a51533d,1,1,6,7,2,2008-03-02 16:11:44,2008-03-02 10:05:05
a3647bee1a91d930c4c3e17e36232b5c4a51533d...56b6d01d8497436e6b2545482ce2c86e614fc73c,1,2,0,2,2,2008-03-02 21:52:08,2008-03-02 14:11:35
81fa145917c40b68a5e2cca6afc6a10cdfdbd25b...e82447b1dfbda6ecfc101381c1295c444c73c903,1,4,8,12,2,2008-02-27 23:42:05,2008-02-27 07:18:38
81fa145917c40b68a5e2cca6afc6a10cdfdbd25b...9fc6440d783ca773353880aa97c23ed9c640d3c0,7,22,12,34,14,2008-02-27 23:37:57,2008-02-27 20:35:50
81fa145917c40b68a5e2cca6afc6a10cdfdbd25b...22665bbaab799b1f20a23039a5c759cd35d36939,1,5,5,10,2,2008-02-27 22:47:36,2008-02-25 13:25:20
22665bbaab799b1f20a23039a5c759cd35d36939...20632071560ad4915f4e620d3c053e5ee3af80f3,1,8,0,8,1,2008-02-27 22:47:36,2008-02-26 12:00:55
81fa145917c40b68a5e2cca6afc6a10cdfdbd25b...47e83e3cc0b5b5e2402afb34b7617515f905b7a7,1,1,0,1,1,2008-02-27 20:01:33,2008-02-25 14:56:28
81fa145917c40b68a5e2cca6afc6a10cdfdbd25b...2ac8af1619feba08ec2285c0e305489a5cf815c9,1,0,3,3,1,2008-02-27 08:22:39,2008-02-26 22:15:31
dc31cd8fcc20d95a80da5ebe6feaab01539ebe4c...0ae91be0e1fac3ff31675f0ec2c7ebf2bb5c1be6,1,20,5,25,8,2008-02-24 18:01:24,2008-02-24 08:07:22
0ae91be0e1fac3ff31675f0ec2c7ebf2bb5c1be6...feededd05b551a02a95fe2a736e9d5f688b86119,1,17,6,23,4,2008-02-24 18:01:24,2008-02-24 08:07:25
feededd05b551a02a95fe2a736e9d5f688b86119...8a5a1884e93564cb1f46a73184d083a5181d573b,1,5,1,6,3,2008-02-24 18:01:24,2008-02-24 08:07:28
8a5a1884e93564cb1f46a73184d083a5181d573b...2c33f7575452f53382dcf77fdc88a2ea5d46f09d,2,11,2,13,4,2008-02-24 18:01:24,2008-02-24 08:07:31
2c33f7575452f53382dcf77fdc88a2ea5d46f09d...27c578885a0b8f56430c5a24f558e2b45cf04a38,1,4,1,5,1,2008-02-24 18:01:24,2008-02-24 08:07:33
6c47d0e8f3983cff5bf633cb8e6f7ecfecf48db7...346245a1bb6272dd370ba2f7b9bf86d3df5fed9a,1,11,0,11,2,2008-02-13 21:44:17,2008-02-13 11:25:04
346245a1bb6272dd370ba2f7b9bf86d3df5fed9a...18bc76164dbf4f6d54b8fa9c9c29db9ca66c7877,2,108,16,124,7,2008-02-16 09:02:44,2008-02-13 10:50:51
6c47d0e8f3983cff5bf633cb8e6f7ecfecf48db7...75ad235c2e2a751cd9c4c064d19b10a88ff9efcf,1,2,11,13,4,2008-02-13 07:39:03,2008-02-13 07:39:03
75ad235c2e2a751cd9c4c064d19b10a88ff9efcf...8608b334343fd51f13e100f8f1a7a2788c13d6c5,1,2,2,4,1,2008-02-13 19:08:41,2008-02-13 14:31:17
8608b334343fd51f13e100f8f1a7a2788c13d6c5...f454cdc48f31e64ceae2e8d4f4838349de2f5dee,1,1,1,2,1,2008-02-13 20:03:49,2008-02-12 19:50:57
f454cdc48f31e64ceae2e8d4f4838349de2f5dee...04b330551e427f10ac9b3d9057e8451c8bf78fc7,1,3,0,3,1,2008-02-13 20:04:01,2008-02-12 11:28:01
04b330551e427f10ac9b3d9057e8451c8bf78fc7...077b725f0bbe2b6ca2deb569c22a6f0d7a374dd3,2,23,1,24,2,2008-02-13 21:43:02,2008-02-13 21:13:21
077b725f0bbe2b6ca2deb569c22a6f0d7a374dd3...ff58b9aaf8bf4ce7471a21baa502cb9ddaa9873a,2,11,2,13,4,2008-02-13 21:54:58,2008-02-12 05:45:18
ff58b9aaf8bf4ce7471a21baa502cb9ddaa9873a...846688726c388cf7fc92ac5cc9f3576e93847e15,1,7,6,13,1,2008-02-13 22:15:44,2008-02-12 00:12:57
846688726c388cf7fc92ac5cc9f3576e93847e15...9386ecbb1cb0576f67da804f57dd96ffd62bb3c6,1,1,1,2,1,2008-02-13 22:22:54,2008-02-07 09:36:10
9386ecbb1cb0576f67da804f57dd96ffd62bb3c6...d8e87570c32b190af3991d180f37adb8cf5eb99c,1,23,0,23,3,2008-02-13 22:23:32,2008-02-07 05:23:46
053d9e432be246a389fb8adaa0c88e7c791f8b21...c3a670de50589dedf2d9b83305e8bd0ff63a1a60,3,83,108,191,52,2008-02-10 07:57:08,2008-02-09 14:40:19
053d9e432be246a389fb8adaa0c88e7c791f8b21...b59012ef4e7dde1895d988736c7df64f68b1e940,2,9,1,10,4,2008-02-10 07:37:03,2008-02-08 16:38:04
053d9e432be246a389fb8adaa0c88e7c791f8b21...3f3d564aa74e80cb30ead37e4581ee21220b4ac4,1,29,9,38,10,2008-02-08 08:13:18,2008-02-07 12:50:19
3f3d564aa74e80cb30ead37e4581ee21220b4ac4...76127b3a0d7cf359b12be80971f023b6ee07f7f9,1,73,1,74,6,2008-02-08 08:13:18,2008-02-07 12:50:39
76127b3a0d7cf359b12be80971f023b6ee07f7f9...928323af6b761e8b1c33ce98e67c2f56fd1b7997,1,8,0,8,2,2008-02-08 08:13:18,2008-02-07 12:51:20
928323af6b761e8b1c33ce98e67c2f56fd1b7997...0520e2154fb6a7418663bdee839c3448d51b9ae4,1,51,37,88,10,2008-02-08 08:13:18,2008-02-07 12:51:34
0520e2154fb6a7418663bdee839c3448d51b9ae4...201945eeb3b52400e16bb36bf60c56a849c62f32,1,1,1,2,1,2008-02-08 09:26:27,2008-02-06 17:15:12
201945eeb3b52400e16bb36bf60c56a849c62f32...2b84b5a874d3281d15aa0b73426b13597cd02520,4,23,2,25,7,2008-02-10 07:41:34,2008-02-05 14:25:04
2b84b5a874d3281d15aa0b73426b13597cd02520...9fd9279bf60e1c31149000ae309a28d85d2a88e1,1,3,4,7,3,2008-02-10 07:41:42,2008-02-09 09:41:36
4cdda2b895dfb6ba084e3952cbf4274a6a2e0338...a53f2ec617ba36a67bf8794d28d666d45ce374a6,2,10,1,11,5,2008-04-13 01:38:40,2008-04-13 01:33:31
5f0734f4b2f677d9d328b19368ff51c234396480...5909ca92d8b2c6a0534597f52f7733ff61a64d63,2,60,1,61,2,2008-04-20 23:03:40,2008-04-20 23:03:40
2855e70ad11abf7e7f30f975b063bd60d5abdf4f...d177cab0480f9fa172103071203fed1bff95f5c2,3,23,14,37,14,2008-05-11 01:16:30,2008-05-09 16:11:43
d177cab0480f9fa172103071203fed1bff95f5c2...c40641b77b0274186fd1b327d5dc3246f814aaaf,5,61,47,108,23,2008-05-11 01:16:31,2008-05-09 16:21:07
cf5c51efc9fe3b0ef93c7b78005c57b71acaf959...2d31347ba5c56d43d64dfdfe04a924178ee55b75,2,50,72,122,23,2008-02-19 09:04:32,2008-02-19 04:41:41
2d31347ba5c56d43d64dfdfe04a924178ee55b75...55029ae4dac07942437c0c715ea7c8ac60dd3576,4,160,3,163,15,2008-02-25 04:05:29,2008-02-20 18:43:53
55029ae4dac07942437c0c715ea7c8ac60dd3576...844112cac07d6413b9bb42d38527d2f7ca7c7801,2,40,19,59,11,2008-02-25 06:34:13,2008-02-25 06:25:04
cf5c51efc9fe3b0ef93c7b78005c57b71acaf959...7d812145ba7f8df825de618b277186c512d04cfa,1,45,0,45,1,2008-02-19 08:56:46,2008-02-19 03:56:02
7d812145ba7f8df825de618b277186c512d04cfa...e1a37346210da8b165037984e02f750a6a135480,2,15,16,31,7,2008-02-19 08:56:46,2008-02-19 03:56:06
e1a37346210da8b165037984e02f750a6a135480...b02bd65f679024ce25afeddf7e96d6d7aea5fca6,4,102,75,177,10,2008-02-19 08:56:46,2008-02-19 03:56:08
b02bd65f679024ce25afeddf7e96d6d7aea5fca6...a5a27c79b7e77e28462b6d089e827391b67d3e5f,5,314,65,379,21,2008-02-20 05:49:31,2008-02-19 03:56:13
a5a27c79b7e77e28462b6d089e827391b67d3e5f...a8d8173e6c7ff85627377389e40844ec71206f5e,1,34,0,34,1,2008-02-20 05:49:38,2008-02-19 07:40:28
a8d8173e6c7ff85627377389e40844ec71206f5e...7d22708b254d4ec28cd865dc5489d175ee6d65c2,2,7,3,10,4,2008-02-20 05:49:38,2008-02-19 07:40:31
7d22708b254d4ec28cd865dc5489d175ee6d65c2...3ee79d9f59684778151804c02cc6ad155b30efde,2,65,15,80,8,2008-02-20 05:49:38,2008-02-19 07:40:33
3ee79d9f59684778151804c02cc6ad155b30efde...736cc67dd7f4f8004215e24f876178e6f34c191d,3,17,0,17,4,2008-02-20 05:49:38,2008-02-19 07:40:35
736cc67dd7f4f8004215e24f876178e6f34c191d...1ba0836307c463ce6de11868c85aa46c7396dae4,1,4,4,8,4,2008-02-24 01:04:43,2008-02-23 08:41:56
1ba0836307c463ce6de11868c85aa46c7396dae4...552bcac3f9f34833cf546f8c197da4c1985a0b84,2,106,68,174,33,2008-02-26 03:57:06,2008-02-25 23:24:14
552bcac3f9f34833cf546f8c197da4c1985a0b84...2bda2cf4f966ae50d08a32a3839f930c1daac907,1,28,24,52,15,2008-02-26 05:28:32,2008-02-25 23:24:17
cf5c51efc9fe3b0ef93c7b78005c57b71acaf959...f407f14deaa14ebddd0d27238523ced8eca74393,2,56,1,57,3,2008-02-18 08:08:40,2008-02-17 19:07:19
f407f14deaa14ebddd0d27238523ced8eca74393...ee95ec5d58d536243966de6ee810d345074b755e,4,39,5,44,9,2008-02-18 08:10:37,2008-02-17 19:07:40
cf5c51efc9fe3b0ef93c7b78005c57b71acaf959...6b2f2d9805dd22c6f74957e0d76a1d2921b40c16,10,70,9,79,24,2008-02-18 08:00:38,2008-02-18 07:26:03
cf5c51efc9fe3b0ef93c7b78005c57b71acaf959...61b80509e3323c262ed5c45d5340cfa278521a71,1,1,0,1,1,2008-02-17 20:47:01,2008-02-16 19:15:41
61b80509e3323c262ed5c45d5340cfa278521a71...508e84a790bef46881459891748727c490d9a673,1,2,2,4,2,2008-02-18 03:27:40,2008-02-14 12:29:58
508e84a790bef46881459891748727c490d9a673...850b90a51d5ed122cee5c2f3ad4c3e513a05259a,1,2,2,4,1,2008-02-18 03:29:16,2008-02-16 22:07:46
850b90a51d5ed122cee5c2f3ad4c3e513a05259a...c84c483ffdfc45d8143fd6f6620361aba91d1080,1,24,13,37,6,2008-02-18 03:31:11,2008-02-17 17:48:13
6d21667206c4c2b10aad99eca1530a4f17c4e61d...363d59df1a773039d0c69ad8c3109a56bb1b491d,2,37,1,38,5,2008-03-01 09:51:44,2008-02-29 01:44:56
363d59df1a773039d0c69ad8c3109a56bb1b491d...a0ec9d25d9f1c1469ec375169557a1c17d486993,2,3,0,3,2,2008-03-01 09:51:44,2008-02-29 01:45:09
a0ec9d25d9f1c1469ec375169557a1c17d486993...4704640b611dfb275f6a74c9a9be5e309260a71c,1,34,0,34,1,2008-03-01 09:51:44,2008-02-29 01:45:24
4704640b611dfb275f6a74c9a9be5e309260a71c...211c89682eeef310f39022b91e88d07cd5784953,8,556,4,560,9,2008-03-01 09:51:44,2008-02-29 01:45:45
211c89682eeef310f39022b91e88d07cd5784953...4ebc914c880cf724222a6e5097a21a85ed8e5951,2,29,3,32,4,2008-03-01 09:51:44,2008-02-29 01:46:07
4ebc914c880cf724222a6e5097a21a85ed8e5951...6217367859e92aa0bd67f02162d1f53e290e15e8,1,1,0,1,1,2008-03-02 23:33:55,2008-03-02 05:31:59
6217367859e92aa0bd67f02162d1f53e290e15e8...84521ed6f2ccfd8dfe001806f83bb28e6a8934be,2,142,9,151,10,2008-03-05 20:17:39,2008-03-04 11:23:53
84521ed6f2ccfd8dfe001806f83bb28e6a8934be...3b9dcff5df97ab642de48bc1ce781961686081aa,2,6,0,6,2,2008-03-09 05:30:22,2008-03-08 22:40:42
3b9dcff5df97ab642de48bc1ce781961686081aa...3000658f7c15c880f976aac0ade73efd3b1e9790,1,1,0,1,1,2008-03-12 05:13:16,2008-03-09 12:37:55
6d21667206c4c2b10aad99eca1530a4f17c4e61d...3449f8c4cb93a0ec445db22ee7549d0b051446d6,4,167,152,319,11,2008-03-01 09:44:45,2008-02-28 05:25:17
3449f8c4cb93a0ec445db22ee7549d0b051446d6...340814636dde3cbd2e461b12f9ae832d2100766a,1,1,1,2,2,2008-03-01 09:44:45,2008-02-28 05:25:18
340814636dde3cbd2e461b12f9ae832d2100766a...70f5d5d31cbf0ba273083805124ad67135142527,2,10,3,13,8,2008-03-01 09:44:46,2008-02-28 05:25:19
70f5d5d31cbf0ba273083805124ad67135142527...5f4347bba39ddb147b06913ac263fc46954d2d0b,3,7,7,14,5,2008-03-01 09:44:46,2008-02-28 05:25:20
6d21667206c4c2b10aad99eca1530a4f17c4e61d...212945d4a85dfa172ea55ec73b1d830ef2d8582f,1,30,8,38,10,2008-02-28 22:28:15,2008-02-28 06:22:36
6d21667206c4c2b10aad99eca1530a4f17c4e61d...be5f5bf02706357794cdf093ebe603aa82ae52eb,1,1,0,1,1,2008-02-28 02:13:40,2008-02-21 16:21:49
be5f5bf02706357794cdf093ebe603aa82ae52eb...42be5cc61202014d4f1df61f9791067191f9393d,1,0,1,1,1,2008-02-28 06:08:57,2008-02-28 06:08:57
4f3d37035a7c735a3b69f962656819f4ff7e4927...f5530b8833bcaa423cd53d133d3de3fa0173fbf3,2,62,2,64,5,2008-01-07 23:18:37,2007-11-12 07:37:42
f5530b8833bcaa423cd53d133d3de3fa0173fbf3...eee8a1742bf51df33f0f6004774035f57253f944,1,4,0,4,1,2008-01-08 00:25:31,2008-01-07 10:40:40
eee8a1742bf51df33f0f6004774035f57253f944...aadd4efa715f56e0eac5ac459c8ff4933b56d4ce,3,27,2,29,3,2008-01-08 06:41:43,2008-01-08 06:41:43
4f3d37035a7c735a3b69f962656819f4ff7e4927...f18b1c55e5b7478524c15685cd643555fc919f3f,1,1,1,2,1,2007-12-31 16:27:15,2007-12-22 00:57:16
f18b1c55e5b7478524c15685cd643555fc919f3f...57283291b55cdc4ab726231073450d185beb361a,1,1,1,2,1,2007-12-31 16:27:15,2007-12-31 13:31:35
b57321f57b324320bdcf9f453ec4788da166f8f4...8291db6f584076b60efa47d72c604b1949508ef8,1,31,3,34,6,2007-11-17 00:53:54,2007-11-16 10:49:09
8291db6f584076b60efa47d72c604b1949508ef8...2587d6796605273de3a5ec7ba44ee1c1ac2b9302,1,1,1,2,1,2007-11-17 00:55:46,2007-11-16 13:25:10
2587d6796605273de3a5ec7ba44ee1c1ac2b9302...dcf0c16ef1a8c2e468afe686a27a5549fea59798,7,26,34,60,14,2007-11-17 01:05:02,2007-11-17 01:05:02
dcf0c16ef1a8c2e468afe686a27a5549fea59798...0e06cc8b823144be16a9fc1f703126b68d20d3b5,2,28,2,30,6,2007-11-17 01:05:13,2007-11-16 09:15:41
788ea12d43605945cbfe74b4dadda8f75c23a411...f0c4881facabc0aa76f4b51871bd70c45effb508,1,1,1,2,1,2007-11-25 18:38:22,2007-11-25 18:34:27
154c7d0759b6885034bffa7a34d464d703fc8bb3...de1b24609b72920c618a689cfb620ede01640c8a,1,1,1,2,1,2007-11-20 08:14:12,2007-11-19 16:58:50
de1b24609b72920c618a689cfb620ede01640c8a...dec92309417d17cc35196efd018f15981f22b235,1,5,1,6,2,2007-11-20 08:14:12,2007-11-19 16:58:51
dec92309417d17cc35196efd018f15981f22b235...97e92e2cbca3dc850d8b04b30740be8d81c17552,1,11,4,15,2,2007-11-20 08:15:13,2007-11-19 18:25:11
97e92e2cbca3dc850d8b04b30740be8d81c17552...8641ee3dcbae749c42b7cf117ba3050e2cb95a93,1,2,1,3,1,2007-11-21 06:58:53,2007-11-20 12:54:04
d9635e9c539465792b1920437b52fa8792a71650...ec4e69c06af3ecc38b9660b924e460689653487f,1,2,0,2,1,2006-05-14 23:27:03,2006-05-14 03:09:32
e8b5f4be708a73fd8b6c06a782168d5b04e3e5c1...d7b16113a128ff04134cec4a8e241cf9cd0a49a2,1,1,1,2,1,2007-08-17 07:57:31,2007-08-17 07:57:31
d7b16113a128ff04134cec4a8e241cf9cd0a49a2...d1cb298b0b74972cc27c789e4c9ce6f324f25113,1,8,6,14,3,2007-08-17 07:58:45,2007-08-16 12:32:29
d1cb298b0b74972cc27c789e4c9ce6f324f25113...887c996e4698dcb7ee95c48a98f7da2c3bae158b,1,210,2,212,12,2007-08-20 09:36:20,2007-08-20 09:36:20
42b09269fd27afacf2febd59895789c92fd417fe...92ed666fa761554c67c8f883863517870a65376d,1,66,76,142,31,2007-08-22 12:35:28,2007-08-22 12:35:28
92ed666fa761554c67c8f883863517870a65376d...b0cdca996a3717552ee30e8cc2bd157bb32fd213,1,46,38,84,27,2007-08-23 09:35:51,2007-08-23 09:35:51
b0cdca996a3717552ee30e8cc2bd157bb32fd213...97645683bff498e369c1c24ce10e78b51cdaf468,1,55,32,87,16,2007-08-23 12:24:38,2007-08-23 12:24:38
97645683bff498e369c1c24ce10e78b51cdaf468...8f0bc7e95e41673a853a53e17708c6f4f46e6420,1,31,24,55,12,2007-08-24 12:16:42,2007-08-24 12:16:42
8f0bc7e95e41673a853a53e17708c6f4f46e6420...0380081c65c3e8a46caad9aebe8e97ff65510453,1,263,225,488,59,2007-08-29 11:45:21,2007-08-29 11:45:21
0380081c65c3e8a46caad9aebe8e97ff65510453...df904497ecc15382199045bb257250c857f04eca,1,1,1,2,2,2007-08-29 12:03:07,2007-08-29 12:03:07
df904497ecc15382199045bb257250c857f04eca...6eaaccd12846c5957c3433c773ad60b8a4196045,1,2,1,3,2,2007-08-29 12:41:46,2007-08-29 12:41:34
6eaaccd12846c5957c3433c773ad60b8a4196045...5cd15b6b7f87dc61f729ad31a682ffc394560273,1,237,22,259,17,2007-08-30 11:54:17,2007-08-30 11:54:17
5cd15b6b7f87dc61f729ad31a682ffc394560273...f5f3c2e29f51a38261daa91073a3f227d4532325,1,91,36,127,34,2007-09-04 16:19:56,2007-09-04 16:19:56
f5f3c2e29f51a38261daa91073a3f227d4532325...f56782aef4b3d7339461d8f12ff15f6258d9871d,1,9,6,15,10,2007-09-14 23:12:26,2007-09-14 23:04:11
f56782aef4b3d7339461d8f12ff15f6258d9871d...3e6b893f33476e7969c7bd5b8914e8bcc62385e3,1,17,25,42,15,2007-09-14 23:33:39,2007-09-14 23:33:39
3e6b893f33476e7969c7bd5b8914e8bcc62385e3...d372e21613b36d94d595f6627ec603ed11e2fd65,1,2,0,2,1,2007-09-15 02:08:38,2007-09-15 02:08:38
d372e21613b36d94d595f6627ec603ed11e2fd65...687c8765ec996225a01cadc7d91354ae3cfbdf8a,1,220,200,420,49,2007-09-22 02:49:33,2007-09-22 02:49:33
687c8765ec996225a01cadc7d91354ae3cfbdf8a...c73adce219ce52a662d90af1e1762c77ea5c4cb0,1,20,13,33,4,2007-09-27 00:35:05,2007-09-27 00:35:05
c73adce219ce52a662d90af1e1762c77ea5c4cb0...bb3edc8b0473192da11bf7f9e961ea0fcc444c63,1,153,33,186,39,2007-09-27 01:00:25,2007-09-27 01:00:25
bb3edc8b0473192da11bf7f9e961ea0fcc444c63...32f1b3e4a4baa3fe3e1acbb75f8134d822a09d58,1,31,6,37,16,2007-09-28 11:27:39,2007-09-28 11:27:39
32f1b3e4a4baa3fe3e1acbb75f8134d822a09d58...64b5f146fd2252646d23eac925c49ce9cb526de9,1,3,3,6,2,2007-10-04 12:19:24,2007-10-04 12:19:24
64b5f146fd2252646d23eac925c49ce9cb526de9...9c311b3208f25ce70edf0fdbe0f440ecd8e0bda7,1,142,115,257,94,2007-10-04 12:27:13,2007-10-04 12:27:13
9c311b3208f25ce70edf0fdbe0f440ecd8e0bda7...0ed1dd3c77e606156f0f5d1baa59a47f33711787,1,57,25,82,12,2007-10-06 08:27:37,2007-10-06 08:27:37
0ed1dd3c77e606156f0f5d1baa59a47f33711787...9a7558f348772ab3c2fb3d4beda3a3a7af1e843a,1,155,1,156,6,2007-10-06 10:16:06,2007-10-06 10:16:06
9a7558f348772ab3c2fb3d4beda3a3a7af1e843a...308ff3d59df853a21d4e218473974311fb7b3320,1,1,1,2,1,2007-10-06 10:17:59,2007-10-06 10:17:59
308ff3d59df853a21d4e218473974311fb7b3320...8d73b242a53da9ea36800a8ff0f9993e5100ea24,1,6,13,19,10,2007-10-06 10:22:00,2007-10-06 10:22:00
8d73b242a53da9ea36800a8ff0f9993e5100ea24...eb33a67f218b612f6fb1456e19b40a1f97ff02c0,1,2,2,4,4,2007-10-19 09:09:43,2007-10-19 09:09:43
eb33a67f218b612f6fb1456e19b40a1f97ff02c0...a137a90f49e30fdcb24da0f9ff5c21b28d9cb227,1,27,21,48,13,2007-10-23 11:12:49,2007-10-23 11:12:49
a137a90f49e30fdcb24da0f9ff5c21b28d9cb227...4570b7e9d716e939287dea8193b7d2fb82e9f192,1,6,6,12,6,2007-10-23 11:19:06,2007-10-23 11:19:06
dc1c0fffd3723ceebff51053938db5baf26a47f5...311e552e7674be620bd930ddada307c15140c6ac,1,5,5,10,5,2008-02-27 21:21:32,2008-02-26 12:22:06
311e552e7674be620bd930ddada307c15140c6ac...0270cd0eeaff06f6bee1b52d5cdffb1a6e69c15a,1,5,3,8,2,2008-02-27 21:22:11,2008-02-26 12:22:07
0270cd0eeaff06f6bee1b52d5cdffb1a6e69c15a...0e55991987e490a69bc549f6f789b34489c953a7,1,30,14,44,15,2008-02-27 21:24:08,2008-02-26 12:22:08
267123b4299ea2c2f090ef169f9fc5039897cd72...abe549e1791822b3105648452b1f8907f8fdb26a,3,9,2,11,5,2008-03-15 07:49:15,2008-03-14 21:35:24
bc6100087cfac0293e6ccbea95a24223b724d072...313da4f71c6ca89b63fc0f4bc1a8fb123bd981e2,1,3,2,5,1,2008-03-23 17:16:33,2008-03-23 11:35:37
313da4f71c6ca89b63fc0f4bc1a8fb123bd981e2...0c829391cfcdc57172765322575804a7ad5f3116,1,1,1,2,1,2008-03-23 19:02:11,2008-03-24 07:27:28
0c829391cfcdc57172765322575804a7ad5f3116...ec31b0ce983e7e96b8a419dec3c34907b2f8226e,2,7,0,7,3,2008-03-24 00:11:33,2008-03-18 20:52:00
ec31b0ce983e7e96b8a419dec3c34907b2f8226e...995e8df4a9de9cf7c1b98dac922d96dc6606946d,1,7,0,7,3,2008-03-25 05:14:35,2008-03-24 19:43:08
995e8df4a9de9cf7c1b98dac922d96dc6606946d...76ce946294bd17f350c7c0a3927d8986b73ed480,2,7,4,11,2,2008-03-25 07:00:07,2008-03-24 03:06:20
76ce946294bd17f350c7c0a3927d8986b73ed480...5cc8f372509298d13632d8784bc851a587937550,2,20,2,22,4,2008-03-25 07:34:05,2008-03-24 15:14:52
5cc8f372509298d13632d8784bc851a587937550...7d19da46fd108ec463e555cb9fd9efd13b582d4a,1,11,7,18,5,2008-03-26 04:55:38,2008-03-26 04:15:52
bc6100087cfac0293e6ccbea95a24223b724d072...42c8c74c1401352b0f388e47a2c9fcd52171c9d3,3,16,2,18,4,2008-03-23 07:41:54,2008-03-21 15:05:06
739a6d4970836463f5ffc9f56381e4efc9e61914...c91ee2bd61299737c2795bd7b798e17ef0714e47,1,32,8,40,6,2008-04-02 05:33:32,2008-04-01 10:54:03
c91ee2bd61299737c2795bd7b798e17ef0714e47...3d654be48f65545c4d3e35f5d3bbed5489820930,1,1,1,2,1,2008-04-02 06:17:11,2008-04-02 06:17:11
52dce39762fbec75b2d561e5dedb25b8e51f83eb...c1ce83a5b64618a8a4ac313da82c156558cbe259,1,3,2,5,2,2008-03-05 21:28:39,2008-03-05 14:24:10
6b48990354b6380665565f21c3f89d2f7109c459...2d3539e87a75b5f93f9e53bf13a60ef67a28ea62,1,27,1,28,7,2008-03-03 08:05:38,2008-03-03 06:04:59
28b01f4b5c335a27c9f4c6f2017bc0b485ffa324...a50a5c8fa66bf7077c986bcc39b3fdad17931e37,1,4,0,4,1,2008-02-27 19:19:55,2008-02-27 13:13:00
a50a5c8fa66bf7077c986bcc39b3fdad17931e37...0460fb449b18cd95805c1bf97013957ee9b8ff9b,1,4,0,4,1,2008-02-27 19:23:22,2008-02-27 12:50:22
0460fb449b18cd95805c1bf97013957ee9b8ff9b...9057f0a62c8681bcff8460fec80747a6aa5b43c8,1,17,1,18,2,2008-02-27 19:35:05,2008-02-13 03:11:22
9057f0a62c8681bcff8460fec80747a6aa5b43c8...12f0a5ea7dc999bfe06973bf61261fc809c2b2fb,2,6,7,13,6,2008-02-27 19:35:09,2008-02-11 23:43:41
12f0a5ea7dc999bfe06973bf61261fc809c2b2fb...6ecbc851fb30f540e1a25761f221aab963cfe619,2,27,3,30,3,2008-02-27 21:26:14,2008-02-22 00:16:04
6ecbc851fb30f540e1a25761f221aab963cfe619...7a0a34ca6f31c6bb5d24ccc0cdab606736d7a322,1,3,2,5,2,2008-02-27 21:26:24,2008-02-22 18:47:08
7a0a34ca6f31c6bb5d24ccc0cdab606736d7a322...0f497e75f05cdf0c0c1278eaba898cda6f118d71,2,10,6,16,7,2008-02-27 21:26:30,2008-02-24 01:14:17
b23b27eb5dc950081d4f76ae84f10168c4d149bd...aa9c83c2197cafb884face711ab7235790f9f265,2,24,8,32,6,2008-02-21 04:21:39,2008-02-21 01:44:46
aa9c83c2197cafb884face711ab7235790f9f265...9a13ba1bed0e573a7c4523c0c8ed8465c9f341bb,1,2,2,4,2,2008-02-21 04:21:43,2008-02-19 21:29:40
9a13ba1bed0e573a7c4523c0c8ed8465c9f341bb...c1867cea90f8e7ee8e1be3fc07a402dde1b2666d,1,9,2,11,3,2008-02-21 04:21:43,2008-02-21 00:00:32
c1867cea90f8e7ee8e1be3fc07a402dde1b2666d...1bd38e8dcca03e318d6000d62cf74c541945a8ba,1,2,2,4,1,2008-02-21 04:21:43,2008-02-21 00:00:44
1bd38e8dcca03e318d6000d62cf74c541945a8ba...14a5c7c19351a7db56803c9086b133fe131f55f6,1,1,1,2,1,2008-02-21 04:21:43,2008-02-21 00:01:16
14a5c7c19351a7db56803c9086b133fe131f55f6...2cd5dfd240ecb63c77bcb2532664984e3b69ae47,2,4,1,5,3,2008-02-21 04:36:20,2008-02-21 04:28:07
2cd5dfd240ecb63c77bcb2532664984e3b69ae47...f5ed3b30e0091421408a0119fa75148955c4fc6a,2,47,1,48,2,2008-02-21 19:45:22,2008-02-21 19:33:56
f5ed3b30e0091421408a0119fa75148955c4fc6a...0fb7fc751d29cd1099556f71fc7c08158a6a78bc,2,27,3,30,3,2008-02-22 05:25:49,2008-02-22 00:16:04
0fb7fc751d29cd1099556f71fc7c08158a6a78bc...c7fae5fc68974eec9b60750424946a67cc143ad2,2,2,2,4,2,2008-02-22 15:02:40,2008-02-22 08:55:29
c7fae5fc68974eec9b60750424946a67cc143ad2...fd74cb0874126876227a958f6250323a4a4478a5,1,0,3,3,1,2008-02-22 15:02:40,2008-02-22 09:53:09
d8e87570c32b190af3991d180f37adb8cf5eb99c...588071112c7ca14a04d674e4f019572f0bb77326,1,1,1,2,1,2008-02-15 17:37:54,2008-02-15 17:37:54
588071112c7ca14a04d674e4f019572f0bb77326...8ca496e97d100195c9015f4da8ddaad693e91961,1,1,1,2,1,2008-02-15 22:11:28,2008-02-14 05:50:00
8ca496e97d100195c9015f4da8ddaad693e91961...df93e33c8bc8c79751a45d8005c6a92b18d4ba6d,1,11,1,12,2,2008-02-15 22:23:22,2008-02-15 19:14:18
df93e33c8bc8c79751a45d8005c6a92b18d4ba6d...e8b32e061006d1a62e464e7c2a5385ddd0cb4290,1,2,0,2,1,2008-02-16 04:11:51,2008-02-14 06:34:34
e8b32e061006d1a62e464e7c2a5385ddd0cb4290...2c778210f8877e8f5c88715c2d25d1a43d976566,1,2,7,9,1,2008-02-16 05:24:53,2008-02-16 04:59:53
2c778210f8877e8f5c88715c2d25d1a43d976566...ea5105a5e3c6629ee64b499ea918c2b80882fc22,2,13,13,26,4,2008-02-16 05:24:53,2008-02-16 05:00:24
ea5105a5e3c6629ee64b499ea918c2b80882fc22...872da32d80c004c26a19a5d6cb31eb3e7f034094,3,4,8,12,3,2008-02-16 05:24:53,2008-02-16 05:01:11
872da32d80c004c26a19a5d6cb31eb3e7f034094...ee9601e6bef2281e3183e127e1e4e36ed257af7a,3,4,8,12,3,2008-02-16 05:24:53,2008-02-16 05:01:41
ee9601e6bef2281e3183e127e1e4e36ed257af7a...dfb068be8deef2065970b2a7889acc51abf4dd78,3,4,8,12,3,2008-02-16 05:24:54,2008-02-16 05:01:59
dfb068be8deef2065970b2a7889acc51abf4dd78...b20a60d0c0f23384cb4141d75d9a7c90e99c1432,1,2,5,7,2,2008-02-16 05:24:54,2008-02-16 05:02:17
b20a60d0c0f23384cb4141d75d9a7c90e99c1432...87f1b8849bf0094e0b20cd294e1f2b04976ddf41,6,45,1,46,6,2008-02-16 06:16:34,2008-02-15 21:53:36
87f1b8849bf0094e0b20cd294e1f2b04976ddf41...13bf1a99764ea751f6fa75502309d8b91529623a,1,1,1,2,1,2008-02-16 07:01:49,2008-02-15 21:20:44
13bf1a99764ea751f6fa75502309d8b91529623a...0ef617f4b6ea78ad63dd11e90f8c854238176981,2,11,2,13,4,2008-02-16 07:06:57,2008-02-16 04:30:05
04f32cf1b31717bf0b7cbbc00783a4107cc19cfd...6fb5375ede25629c23ba2129b48f143e1942e755,2,28,0,28,3,2008-02-11 21:23:14,2008-02-10 04:51:08
6fb5375ede25629c23ba2129b48f143e1942e755...14f9e128d38f809947d34979a59ee524e350ac6e,3,4,0,4,3,2008-02-11 21:23:15,2008-02-11 03:34:34
14f9e128d38f809947d34979a59ee524e350ac6e...24a2293ad35d567530048f0d2b0d11e0012af26d,1,9,1,10,2,2008-02-11 21:23:15,2008-02-11 15:00:07
a8f6b201aadcadeb9bfe05a66de32878bff800f7...9886ea417b7da9722c95630b5980ac174e04c71c,1,2,6,8,1,2008-02-18 04:54:01,2008-02-17 19:52:50
9886ea417b7da9722c95630b5980ac174e04c71c...affeef12fb2d10317fbcc7a866fbc3603cf16119,5,12,3,15,6,2008-02-18 07:46:55,2008-02-18 07:31:54
affeef12fb2d10317fbcc7a866fbc3603cf16119...24e8a3c946d158c977b67c346c21abc609c63209,1,4,1,5,1,2008-02-18 07:49:33,2008-02-18 07:31:55
24e8a3c946d158c977b67c346c21abc609c63209...3d51e1b5b84bde24f9a19e3cee603f0b57f62001,11,28,14,42,14,2008-02-18 07:51:12,2008-02-18 07:31:56
f43e2fd43b50d5a82a34bb3e4f848cb38bf93b7f...c35b0b5884a12685aa794e00f51bc7dfaa0dd91c,3,80,4,84,8,2008-04-13 19:11:11,2008-04-13 19:11:11
c35b0b5884a12685aa794e00f51bc7dfaa0dd91c...8e4c6aa1ac6e63d2fcee1825e32afbf4cb97206f,1,2,6,8,1,2008-04-15 05:37:47,2008-04-08 08:42:33
f43e2fd43b50d5a82a34bb3e4f848cb38bf93b7f...d0f64dd44d5f708f77380998b2c16bffe1e94050,2,27,2,29,5,2008-04-13 03:00:45,2008-04-12 15:05:31
d0f64dd44d5f708f77380998b2c16bffe1e94050...ac8d5afca6931aa005aff873e4f490ff5050fc76,2,46,0,46,6,2008-04-13 03:00:45,2008-04-12 15:05:32
ac8d5afca6931aa005aff873e4f490ff5050fc76...e5e4a7f23d7df0ec04b6423a90c9b858082a74af,1,134,0,134,1,2008-04-13 03:00:45,2008-04-12 15:05:33
f43e2fd43b50d5a82a34bb3e4f848cb38bf93b7f...e06c43c7959042e5612984b8193700f32f12b2be,1,1,1,2,1,2008-04-13 02:42:17,2008-03-30 16:25:52
e06c43c7959042e5612984b8193700f32f12b2be...8fa29602d4cf8c9ec7d837f7308a9582a8372cb5,1,5,2,7,1,2008-04-13 02:42:17,2008-03-30 19:39:25
f43e2fd43b50d5a82a34bb3e4f848cb38bf93b7f...f35f5603f4f07c939754743b2a6cf61bb3a4694e,2,38,3,41,9,2008-04-13 02:41:29,2008-04-03 09:12:06
f35f5603f4f07c939754743b2a6cf61bb3a4694e...72276a3ecbe6353b83ab37e0ce96cc21c94cf6ee,2,14,0,14,3,2008-04-13 02:41:29,2008-04-04 06:01:47
72276a3ecbe6353b83ab37e0ce96cc21c94cf6ee...f6c07d7d475ffaa67b817beb2635fd73a5e0e962,1,33,23,56,5,2008-04-13 02:41:29,2008-04-03 05:17:53
f6c07d7d475ffaa67b817beb2635fd73a5e0e962...69264f46a193ae9dec5761984b4bae32f4810916,1,61,32,93,13,2008-04-13 02:41:29,2008-04-03 07:56:23
69264f46a193ae9dec5761984b4bae32f4810916...85af7929ee125385c2771fa4eaccfa2f29dc63c9,1,65,16,81,21,2008-04-13 02:41:29,2008-04-03 05:17:53
f43e2fd43b50d5a82a34bb3e4f848cb38bf93b7f...f5a84c372f8f044899dde91f1a415d2bf963377e,3,33,43,76,3,2008-04-13 02:28:18,2008-04-06 01:23:42
f5a84c372f8f044899dde91f1a415d2bf963377e...d8abe148bece83f6c3e5ebe6075aef236322ed74,6,40,21,61,16,2008-04-13 02:28:18,2008-04-06 01:23:43
d8abe148bece83f6c3e5ebe6075aef236322ed74...3e6c0a3fe3dcdbe6621b122a8a498a0d8627b425,3,6,1,7,3,2008-04-13 02:28:18,2008-04-06 01:23:44
3e6c0a3fe3dcdbe6621b122a8a498a0d8627b425...6cd9cfefc505ed5ab5ff435ff9ef338ac8721225,4,75,13,88,17,2008-04-13 02:28:18,2008-04-06 01:23:45
6cd9cfefc505ed5ab5ff435ff9ef338ac8721225...efb779f8873e5aa36be29a4e551186c62c1b580c,5,36,7,43,12,2008-04-13 02:28:18,2008-04-06 01:23:46
5909ca92d8b2c6a0534597f52f7733ff61a64d63...dbe48256b41c1e94d81f2458d7e84b1fdcb47026,1,4,7,11,2,2008-04-22 05:56:16,2008-04-18 13:07:12
dbe48256b41c1e94d81f2458d7e84b1fdcb47026...eae7a75904f9634736ff622be9d1c1e5f5567c27,2,65,64,129,35,2008-04-22 06:18:06,2008-04-17 11:45:52
eae7a75904f9634736ff622be9d1c1e5f5567c27...3903c6189d0d596a0fef47edab437aa047e812fa,1,1,0,1,1,2008-04-22 06:32:09,2008-04-20 19:34:07
3903c6189d0d596a0fef47edab437aa047e812fa...799596a5d06f2abddef75940604d00c4bd8ba849,1,4,4,8,4,2008-04-22 06:33:23,2008-04-20 17:28:44
5909ca92d8b2c6a0534597f52f7733ff61a64d63...84bb2dfd9f4873c9ca19537efe62219b09ec03bf,8,104,36,140,21,2008-04-21 01:49:22,2008-04-17 11:17:20
5909ca92d8b2c6a0534597f52f7733ff61a64d63...e8b404c27e98a8d1b0e123fe80ce19efbdbf73d7,2,18,2,20,7,2008-04-21 01:16:46,2008-04-17 20:24:50
e8b404c27e98a8d1b0e123fe80ce19efbdbf73d7...9a7ea2b1f3484bb2a4bbd0b538e5a38df0356701,1,21,0,21,2,2008-04-21 01:16:46,2008-04-17 22:27:08
9a7ea2b1f3484bb2a4bbd0b538e5a38df0356701...f9fd5210c825dfcd245a2cd38e7b12c03000c33f,1,41,1,42,2,2008-04-21 01:16:46,2008-04-18 16:30:15
867fa20fe929942fba2345adc591e6f5c74f8c11...c904bf392d7621b04c14bb9b2e93c3ed08f7e57b,1,4,1,5,1,2008-05-07 04:34:35,2008-05-05 16:46:42
c904bf392d7621b04c14bb9b2e93c3ed08f7e57b...921177f50fe107a5807baf7e2f63177a86945a60,3,108,69,177,8,2008-05-07 04:46:42,2008-05-07 04:29:28
867fa20fe929942fba2345adc591e6f5c74f8c11...a45d46ba72a8be16eeb30f608620bac7d9296803,1,39,39,78,2,2008-05-06 23:40:32,2008-05-04 16:04:49
a45d46ba72a8be16eeb30f608620bac7d9296803...e83dbe802f24e017f2e3889272a70793c064d984,2,35,3,38,8,2008-05-06 23:43:52,2008-05-04 16:04:50
e83dbe802f24e017f2e3889272a70793c064d984...bb1ae3f6fff19b0a1ab1bb6a815d26d39b9f15e6,6,40,3,43,10,2008-05-06 23:50:17,2008-05-04 16:04:51
c0b48ad777eb8ad42d8d0eafc8f0ee82955b1319...733ee2b7a95f6f4ac03f6f8db4899bcd54d0017e,1,1,0,1,1,2008-03-03 00:07:41,2008-02-28 22:29:54
733ee2b7a95f6f4ac03f6f8db4899bcd54d0017e...34cd62eb91600109378c8121c1fecd924a9af177,2,4,4,8,3,2008-03-03 00:08:37,2008-03-02 23:07:47
b00ac8c729258f7117c74838133d57c40536b48b...6dfbb304be5a5e260321c5f47626582dbe2c62f0,1,1,1,2,1,2008-03-02 23:26:31,2008-03-02 15:57:14
6dfbb304be5a5e260321c5f47626582dbe2c62f0...5d02294c776c46f0d454470c66c16fe9f08fad3d,2,16,6,22,6,2008-03-02 23:27:08,2008-03-02 15:53:04
5d02294c776c46f0d454470c66c16fe9f08fad3d...859c4fbef589841585f8f21cc567b7016681df7a,3,25,2,27,3,2008-03-02 23:27:27,2008-03-02 15:53:39
25c4f61c51a91051dcba3b8bbbac4c61aa69cc19...301e42edc3fa277059be97b3be5b97d86ddc9d9f,1,4,0,4,1,2008-02-29 08:00:29,2008-02-28 16:30:47
301e42edc3fa277059be97b3be5b97d86ddc9d9f...7435982102093179474a128648179a44042d8a1c,2,21,4,25,5,2008-02-29 08:00:29,2008-02-28 21:09:30
dc3e3ea3c838c1ddf7423401b4cf7a7dba528cff...1e72a40de99be24809eba5abdab4c0b00846b9b5,1,14,7,21,4,2007-11-28 23:50:59,2007-11-17 19:51:44
1e72a40de99be24809eba5abdab4c0b00846b9b5...38762c47d6442dc0ce0f45533f9151877c485337,6,11,11,22,11,2007-11-29 00:41:18,2007-11-29 00:15:04
dc3e3ea3c838c1ddf7423401b4cf7a7dba528cff...795c7c0b08fefc7d0f5d0903d8341491350996f0,1,99,0,99,1,2007-11-28 22:14:21,2007-11-28 18:55:46
795c7c0b08fefc7d0f5d0903d8341491350996f0...9da0dabcd9ff71083b6bbc9878c22b12002400dd,2,12,15,27,5,2007-11-28 22:38:06,2007-11-28 18:56:11
9da0dabcd9ff71083b6bbc9878c22b12002400dd...0750d751157addde94f28a7933ed4f914a526eb7,1,9,11,20,5,2007-11-28 22:38:35,2007-11-28 18:56:28
8641ee3dcbae749c42b7cf117ba3050e2cb95a93...c5546e88fe492558313965a49512ce5c71a98dfe,2,21,1,22,5,2007-11-22 23:15:25,2007-11-22 12:24:59
c5546e88fe492558313965a49512ce5c71a98dfe...958e67c0a8b7f12462ad1828ac3b3178181ea4e9,2,0,0,0,0,2007-11-23 00:48:55,2007-11-23 00:48:55
887c996e4698dcb7ee95c48a98f7da2c3bae158b...719c2b9d926bf2be4879015e3620d27d32f007b6,1,2,1,3,2,2007-08-29 12:41:34,2007-08-29 12:41:34
3de07118f0993e6f7bc7ce02276751795d80b877...cca5d946d692fde7ea5408a694cb4b1c97a5a838,1,54,152,206,27,2007-10-27 11:16:56,2007-10-27 11:16:56
660b9c3a4e24ce9a2628f2ec88902e2384d1aade...af05d67939f306a68c5f81ed30f65a82ae025661,8,16,8,24,9,2008-03-26 22:41:35,2008-03-25 21:06:26
af05d67939f306a68c5f81ed30f65a82ae025661...40ae8872a1b8ba117e0365832f6621f968b1221e,1,6,6,12,2,2008-03-26 23:14:52,2008-03-26 17:34:20
40ae8872a1b8ba117e0365832f6621f968b1221e...5b67b8e2d4ed8a152694f4555549fcde5dae77f5,1,4,0,4,1,2008-03-26 23:15:02,2008-03-26 18:05:17
5b67b8e2d4ed8a152694f4555549fcde5dae77f5...8ee002fd3d875027f70729c0674282dc46fc5654,1,1,1,2,1,2008-03-27 19:13:39,2008-03-25 06:07:08
1eaa541f5fbda3fc30085da4f75e99dfae4ec9b3...c817faabd7b0d7c0779ad5b34a4411ba3cdccf2d,1,284,0,284,1,2008-03-16 08:11:07,2008-03-16 06:58:10
c817faabd7b0d7c0779ad5b34a4411ba3cdccf2d...7092882c84269af287646294a151551c59170a64,1,42,9,51,10,2008-03-16 08:15:31,2008-03-16 06:59:29
92aeb994d3195d3601df2e37052d60f9a6738b61...4201bb5f7e408143dc5bf35497cc82bc803fe9fb,2,73,3,76,4,2008-03-12 02:30:33,2008-03-01 10:32:14
4201bb5f7e408143dc5bf35497cc82bc803fe9fb...fc99469a2b786676ffe48d5966d71cea3613b716,2,32,1,33,6,2008-03-12 02:57:56,2008-03-11 09:56:30
fc99469a2b786676ffe48d5966d71cea3613b716...7339eb082343df556c27fb0df5dd36a21714284e,1,3,1,4,1,2008-03-12 04:14:59,2008-03-11 17:40:45
7339eb082343df556c27fb0df5dd36a21714284e...ea14e6c55427f50f78fe47187cd4edb9845943a1,1,2,1,3,1,2008-03-12 04:20:50,2008-03-11 08:00:45
3d654be48f65545c4d3e35f5d3bbed5489820930...54906addfa598640a6492cae1015badefa1ce201,1,4,4,8,2,2008-04-04 01:38:12,2008-04-03 22:06:29
54906addfa598640a6492cae1015badefa1ce201...ccb3b537cc847791c0e28c72ee1f9e6e807f2f6f,1,33,45,78,37,2008-04-05 03:53:50,2008-04-05 02:20:23
ccb3b537cc847791c0e28c72ee1f9e6e807f2f6f...729ffa50f75a025935623bfc58d0932c65f7de2f,1,12,6,18,4,2008-04-05 04:03:19,2008-04-04 21:04:42
27b4070e40a771c41ed581ef1ac98dd43e58ab87...9eb7a50b6ddb27250cf37a28c1d8181c33a733d3,2,13,29,42,6,2008-03-04 11:11:06,2008-03-04 11:11:06
9eb7a50b6ddb27250cf37a28c1d8181c33a733d3...c95b3ad9ea310ec89e31a21edecaaf2c374e2c46,2,7,106,113,16,2008-03-04 11:11:30,2008-03-04 11:11:30
2d3539e87a75b5f93f9e53bf13a60ef67a28ea62...28f9af5d25ec04288d8c501058d83ac76c8be6f4,1,56,5,61,6,2008-03-12 03:07:13,2008-03-11 13:52:15
28f9af5d25ec04288d8c501058d83ac76c8be6f4...1cb639e6b02d8740cd2d4516a34822b43660babc,1,102,0,102,1,2008-03-12 06:20:03,2008-03-11 13:52:16
1cb639e6b02d8740cd2d4516a34822b43660babc...f2dc06a344257df7b9307fc8453af7342409b610,1,19,2,21,6,2008-03-12 06:20:06,2008-03-11 13:52:17
f2dc06a344257df7b9307fc8453af7342409b610...925e7f622d433e1cb2c7556acf8868bb30565a61,1,16,3,19,3,2008-03-12 06:20:06,2008-03-11 13:52:18
925e7f622d433e1cb2c7556acf8868bb30565a61...2da2ddc664538f64c4d8a4ab61ef93b2b77a50d5,1,195,0,195,1,2008-03-12 06:20:06,2008-03-11 13:52:19
2da2ddc664538f64c4d8a4ab61ef93b2b77a50d5...eed35595759a65d51279547af0f2d017dd928fa5,1,1,1,2,1,2008-03-12 08:53:30,2008-03-12 08:30:01
2d3539e87a75b5f93f9e53bf13a60ef67a28ea62...f3ec549481827b10609a43bf504517a0e8063a12,1,10,7,17,6,2008-03-03 09:13:05,2008-03-03 06:31:23
f3ec549481827b10609a43bf504517a0e8063a12...c374b91cf295f437d438a103bfd2cf3fffcce580,1,1,1,2,1,2008-03-03 17:24:17,2008-03-03 17:24:17
c374b91cf295f437d438a103bfd2cf3fffcce580...870cf7d69872ebc925989b400fb4e7031870db5f,1,11,5,16,4,2008-03-03 21:09:20,2008-03-03 21:08:26
870cf7d69872ebc925989b400fb4e7031870db5f...3167d7256505cdeace5293bc67f0d16657a9277e,1,1,1,2,1,2008-03-03 23:54:23,2008-03-03 23:54:23
3167d7256505cdeace5293bc67f0d16657a9277e...be7bae0d4821462c50c5b82633edb372fe971e9e,1,3,1,4,2,2008-03-04 02:26:23,2008-03-04 01:09:31
be7bae0d4821462c50c5b82633edb372fe971e9e...d1b28f512c6d2c7d373c746d8876dbf177ddf114,1,3,0,3,1,2008-03-04 02:26:29,2008-03-04 01:09:35
d1b28f512c6d2c7d373c746d8876dbf177ddf114...3291fe4072ee3ac52fb927a0b504d4440d3bbe5a,1,16,1,17,3,2008-03-04 02:26:40,2008-03-04 01:09:38
3291fe4072ee3ac52fb927a0b504d4440d3bbe5a...4d4c3e1c12df7a76810f72a9012e591516cef03d,1,1,0,1,1,2008-03-04 02:29:51,2008-03-04 02:29:51
4d4c3e1c12df7a76810f72a9012e591516cef03d...a798b2c0f60ed7ae9161a4c4affb6127ff3b2575,1,2,1,3,2,2008-03-04 05:52:04,2008-03-03 23:48:56
a798b2c0f60ed7ae9161a4c4affb6127ff3b2575...30b5940bcd3ed7392795f6a27563013f6f806de4,1,25,20,45,7,2008-03-04 05:53:51,2008-03-03 10:55:48
30b5940bcd3ed7392795f6a27563013f6f806de4...4947cf9cc377b15006f3e649c59edf9bc813af6f,1,40,28,68,5,2008-03-04 06:13:57,2008-03-01 11:12:13
2d3539e87a75b5f93f9e53bf13a60ef67a28ea62...ff655a69df524c71464968f823a4826f2d43d7c6,1,2,3,5,2,2008-03-03 08:05:45,2008-03-03 02:34:36
ff655a69df524c71464968f823a4826f2d43d7c6...7f98428d4beb24b564acbbfa779391467aab6f03,1,2,5,7,3,2008-03-03 08:05:45,2008-03-03 02:34:43
7f98428d4beb24b564acbbfa779391467aab6f03...5aaf7f2afb46621c371564b07225ff5e978fc4b5,1,1,0,1,1,2008-03-03 08:05:45,2008-03-03 02:34:51
5aaf7f2afb46621c371564b07225ff5e978fc4b5...c50b2b47999134a5da1f9a5ccb36855313e44e7d,1,8,8,16,5,2008-03-03 08:05:45,2008-03-03 02:35:00
c50b2b47999134a5da1f9a5ccb36855313e44e7d...49d58fd0770cbb667a0d7532156ced803e482864,1,3,1,4,2,2008-03-03 08:05:45,2008-03-03 02:35:10
49d58fd0770cbb667a0d7532156ced803e482864...49aaddd102aff1f0fc986629f3dc22a872f202ce,1,9,0,9,5,2008-03-03 08:05:45,2008-03-03 02:35:18
49aaddd102aff1f0fc986629f3dc22a872f202ce...767f176a1f11e07b9098f5094dbd9f4033e50504,1,6,0,6,2,2008-03-03 08:05:45,2008-03-03 02:35:25
767f176a1f11e07b9098f5094dbd9f4033e50504...cf7f929a10f141d319d47c68646c88d5911de777,2,137,1,138,3,2008-03-03 08:05:45,2008-03-03 02:35:33
cf7f929a10f141d319d47c68646c88d5911de777...f0a24aa56e49a5cb03101ead0211c7080b96c9f1,3,111,2,113,8,2008-03-05 07:28:14,2008-03-04 03:27:20
f0a24aa56e49a5cb03101ead0211c7080b96c9f1...348e390b17e7a2b0618fbbfe8cdefa3d73ecbea2,4,24,6,30,11,2008-03-05 07:28:14,2008-03-04 03:27:33
348e390b17e7a2b0618fbbfe8cdefa3d73ecbea2...41fa7d2eaeace0c5c23fc75a3d5cc9efbad467a5,4,37,0,37,7,2008-03-05 07:28:15,2008-03-04 03:27:40
972b9a85301e1576c0fb84555396015663a65452...655e8515f279c01f525745d443f509f97cd805ab,2,4,1,5,2,2008-03-08 18:46:10,2008-03-07 20:22:17
655e8515f279c01f525745d443f509f97cd805ab...0bb91d9a6283661c32878f93a601828cac58d2d6,1,6,1,7,2,2008-03-09 03:20:06,2008-03-08 22:04:05
0bb91d9a6283661c32878f93a601828cac58d2d6...6c293d408dbbd0206e80df3ecda7f1620cadaa94,1,1,1,2,1,2008-03-09 03:43:21,2008-03-08 11:30:04
6c293d408dbbd0206e80df3ecda7f1620cadaa94...56d5fe285583b5177ffc65dbe7df636ed5b8cc6b,2,27,7,34,3,2008-03-09 03:43:21,2008-03-09 03:34:47
0f497e75f05cdf0c0c1278eaba898cda6f118d71...b75bb1d695b0958d77b7894fa4a7dbc76167b65a,2,27,1,28,2,2008-02-28 07:37:39,2008-02-28 07:37:39
fd74cb0874126876227a958f6250323a4a4478a5...be8b9063810f0c47f825c47045c7ca137f520edb,1,15,9,24,2,2008-02-22 18:06:58,2008-02-22 16:33:47
fd74cb0874126876227a958f6250323a4a4478a5...8a2f5e5b032ca73e19ad1425b75c63234eb166fa,2,46,1,47,5,2008-02-22 17:32:49,2008-02-21 10:06:47
0ef617f4b6ea78ad63dd11e90f8c854238176981...1fe32cb9d0807e6da468dc7bf96d427b2f38c1c4,2,19,4,23,2,2008-02-16 07:57:26,2008-02-16 07:57:26
1fe32cb9d0807e6da468dc7bf96d427b2f38c1c4...959ba670ad7173bcb73afaca69625a5635f63b8b,2,25,0,25,2,2008-02-16 08:12:56,2008-02-14 17:18:23
0ef617f4b6ea78ad63dd11e90f8c854238176981...add8e8cee5054734cb19d918f83bcee649aab326,1,6,1,7,1,2008-02-16 07:21:56,2008-02-14 23:25:33
add8e8cee5054734cb19d918f83bcee649aab326...1bbeb4c6905b18446485413d98f4b75e56a6830c,1,11,4,15,3,2008-02-16 07:21:56,2008-02-14 23:32:32
1bbeb4c6905b18446485413d98f4b75e56a6830c...7fea9c551436a98edf4ab6840de981f99b7db687,1,1,4,5,3,2008-02-16 07:21:57,2008-02-14 23:26:12
3d51e1b5b84bde24f9a19e3cee603f0b57f62001...525ab63950e324823dd45423104cdcf5e46e2610,4,408,369,777,10,2008-02-18 08:46:13,2007-12-24 08:36:00
525ab63950e324823dd45423104cdcf5e46e2610...8177631547e4d10ae071def07eff83e056092bfa,2,41,19,60,5,2008-02-18 08:51:05,2007-12-24 08:51:01
8bb65883d164843d5bb7475281af09bae18ab22d...02e542206f26cf06817ec2e9ffecf4f416e8e332,2,226,326,552,17,2008-07-08 22:29:40,2008-07-08 13:19:33
02e542206f26cf06817ec2e9ffecf4f416e8e332...5817da01434a24e693ea4d5ba6680d488f5f543f,1,118,102,220,16,2008-07-08 22:40:51,2008-07-08 13:19:34
5817da01434a24e693ea4d5ba6680d488f5f543f...3f8d5204896a85d9268c579fc3e31b22b33fb803,1,38,92,130,14,2008-07-08 22:54:01,2008-07-08 13:19:35
921177f50fe107a5807baf7e2f63177a86945a60...bf7cbb2f043e4a989dacebe381841bcdbd75588b,1,1,1,2,1,2010-02-08 20:12:41,2010-02-08 20:12:41
921177f50fe107a5807baf7e2f63177a86945a60...d84ae0dbd53a29887256c0ea7375ae8524671af9,1,30,0,30,1,2008-05-08 18:37:34,2008-05-08 08:55:02
d84ae0dbd53a29887256c0ea7375ae8524671af9...bac59f19b12af12d59582543fbd77af3f1d06f0c,1,49,0,49,1,2008-05-08 18:37:59,2008-05-07 23:00:54
bac59f19b12af12d59582543fbd77af3f1d06f0c...eb120e699f3faea2d71cd9cb79a8cf4f79ec1d45,1,12,1,13,2,2008-05-09 00:43:01,2008-05-07 17:34:18
eb120e699f3faea2d71cd9cb79a8cf4f79ec1d45...c5445fe0908d0bd8a062e0d29d9dcf4e4962e3c8,1,3,0,3,1,2008-05-09 00:47:25,2008-05-08 07:34:49
34cd62eb91600109378c8121c1fecd924a9af177...da2478dbb000436b79e813ba7f243d6042f26e66,2,44,32,76,11,2008-03-03 08:52:17,2008-03-02 16:51:57
7435982102093179474a128648179a44042d8a1c...00183cbb3d0f60852d7286e766c9b631c0c1f952,1,5,4,9,6,2008-02-29 08:00:29,2008-02-28 16:10:51
00183cbb3d0f60852d7286e766c9b631c0c1f952...39fe578bdcc318308bc5d75efa04bd4bfc3a4f23,1,11,14,25,5,2008-02-29 08:00:29,2008-02-28 17:14:13
39fe578bdcc318308bc5d75efa04bd4bfc3a4f23...419e38337a4ff66ae2968756cc46c1bf77074814,1,47,0,47,1,2008-02-29 08:00:29,2008-02-28 12:36:54
419e38337a4ff66ae2968756cc46c1bf77074814...a5aa930d506689df0f77dded8a3f5aa248b485ee,3,22,3,25,5,2008-02-29 08:00:29,2008-02-28 07:24:25
a5aa930d506689df0f77dded8a3f5aa248b485ee...75336878c795b746b1c67b736c96f5ef8a2b3f02,2,67,15,82,7,2008-02-29 08:00:29,2008-02-28 21:52:44
75336878c795b746b1c67b736c96f5ef8a2b3f02...7cf7f54a65aa1c70e21fe73753f6b0671d129adf,4,10,3,13,7,2008-02-29 08:00:29,2008-02-24 19:40:45
7cf7f54a65aa1c70e21fe73753f6b0671d129adf...97b97c58e609a1cd23b3c2514f41cdb0405870ee,1,82,9,91,9,2008-02-29 08:12:44,2008-02-28 07:39:47
97b97c58e609a1cd23b3c2514f41cdb0405870ee...c6fef0bbea485ff8aec979177ee5c1c568fffc55,2,75,7,82,6,2008-03-01 00:27:25,2008-02-29 19:16:19
38762c47d6442dc0ce0f45533f9151877c485337...fdd7d48d6a09c593a68c983c450443c1e55705e6,1,1,1,2,1,2007-11-30 22:16:52,2007-11-27 12:10:19
a6214fe06eefded4f71012043f35ad805e7dd19c...67d232426b8858b31e54a9b6a5a90916690d1153,2,25,4,29,3,2007-11-30 23:00:31,2007-11-30 22:22:12
67d232426b8858b31e54a9b6a5a90916690d1153...10455d2a955a29db1809be139177e4e298771eb0,9,9,9,18,9,2007-11-30 23:09:40,2007-11-30 11:35:23
958e67c0a8b7f12462ad1828ac3b3178181ea4e9...7a3db75beee75c4e1b5fdae7504bc2ba05c58b14,1,1,1,2,1,2007-11-23 07:25:19,2007-11-23 07:25:19
c8df633b4edfe6915ea3a8651a08d93654c62f24...e88856b485cd73dfc1f3ef8d4c5b52a2f557e8c8,1,3,1,4,1,2006-05-15 20:00:01,2006-05-11 17:35:31
e88856b485cd73dfc1f3ef8d4c5b52a2f557e8c8...f3dd5eae58cf3d0d944604af4c71a7043d5368fd,2,4,7,11,4,2006-05-15 20:00:28,2006-05-15 02:26:56
f3dd5eae58cf3d0d944604af4c71a7043d5368fd...1b9bc5a7b7434d771726011613a00cb202bd9f44,2,2,4,6,4,2006-05-15 20:01:37,2006-05-15 19:52:00
719c2b9d926bf2be4879015e3620d27d32f007b6...0166419a197cea0ceef3aed8c72023deb015ecf4,1,1,1,2,1,2007-10-17 07:44:28,2007-10-16 22:33:04
0166419a197cea0ceef3aed8c72023deb015ecf4...5dd57d512225bb82aa0010b39aaec0085d471eac,1,6,0,6,1,2007-10-20 03:06:33,2007-10-15 09:33:07
5dd57d512225bb82aa0010b39aaec0085d471eac...5e85ec4cd0658232fa8ee13e8cd9da21e0e4973e,1,1,2,3,1,2007-10-20 03:09:27,2007-10-02 14:16:54
5e85ec4cd0658232fa8ee13e8cd9da21e0e4973e...5d7589d4c43e941563dfa2d096e6d6c184191702,1,7,0,7,1,2007-10-20 11:21:03,2007-10-20 11:21:03
5d7589d4c43e941563dfa2d096e6d6c184191702...3ebba3c724f77d149061c62f4414166649c2e56e,1,1,1,2,1,2007-10-20 12:10:52,2007-10-20 12:10:52
3ebba3c724f77d149061c62f4414166649c2e56e...e5ef6f952a13342065d44bab53999e8d8529cc3b,1,5,16,21,5,2007-10-21 02:58:42,2007-10-21 02:58:42
7b3b1515288352149f3ed3b975b650a7f81046ed...7388bcbc5431552718dde5c3259d861d2fa75a12,1,3,3,6,3,2007-10-27 11:31:07,2007-10-27 11:31:07
319a36a5c2da8dd07993caac43b7820bff3b0d37...1768905b51601d5d080168059acd24d13b888a2d,1,4,1,5,2,2008-03-27 20:37:29,2008-03-27 20:37:29
7092882c84269af287646294a151551c59170a64...20fd60bf6a0cbcd77c7b1f5b3b8bda224f896d60,1,18,18,36,18,2008-03-16 21:13:04,2008-03-16 21:13:04
20fd60bf6a0cbcd77c7b1f5b3b8bda224f896d60...198724ad4ef0630892e8dbbab92e92ff4f979075,1,2,0,2,1,2008-03-16 21:24:32,2008-03-16 19:49:09
198724ad4ef0630892e8dbbab92e92ff4f979075...7f8ab8dc07ba4e892d0c2b5e7ac8436f9e845920,2,47,3,50,5,2008-03-16 21:25:53,2008-03-16 18:42:50
7092882c84269af287646294a151551c59170a64...0cb06644a569d92ea8b3b6e81bc8bd786d98920e,1,32,20,52,13,2008-03-16 08:25:24,2008-03-15 20:17:42
ea14e6c55427f50f78fe47187cd4edb9845943a1...7863c612f402268b5978683f44adad3a7a867613,1,2,2,4,2,2008-03-12 16:43:08,2008-02-14 08:22:30
7863c612f402268b5978683f44adad3a7a867613...c36c5b845e1958bad1b69ee42e3da926de4f948b,1,1,1,2,1,2008-03-13 04:03:39,2008-03-12 19:54:21
729ffa50f75a025935623bfc58d0932c65f7de2f...ddc360314544a21638fd0658218bbc37aafedd6f,1,10,4,14,3,2008-04-24 01:34:58,2008-04-24 01:34:58
729ffa50f75a025935623bfc58d0932c65f7de2f...dd70f3dbe48b9e30589c5832e95229b474651d6a,1,2,2,4,1,2008-04-14 23:34:23,2008-04-14 08:51:33
7ae512b7da17e8f8c474fa80fb44b023c6f83882...cfc4ba33e3cc95a30cb808eec1b54b52450c3bdf,1,6,0,6,1,2008-04-02 17:36:31,2008-04-02 17:06:46
c95b3ad9ea310ec89e31a21edecaaf2c374e2c46...c582abae46725504cee9ff91816c979989632f07,1,43,42,85,5,2008-03-05 21:38:34,2008-03-05 08:31:55
c95b3ad9ea310ec89e31a21edecaaf2c374e2c46...d4264ca3233e206ea927bc94befda530683b5836,2,33,22,55,4,2008-03-05 21:37:46,2008-03-05 01:15:02
c95b3ad9ea310ec89e31a21edecaaf2c374e2c46...ce2cf27adc434c11cd1e91bcacf00297efd8cc92,2,11,10,21,3,2008-03-05 20:18:03,2008-03-05 07:35:16
c95b3ad9ea310ec89e31a21edecaaf2c374e2c46...5eee6b28b5fc6be03a89dfa6b6ca502ec49dc2df,1,20,27,47,7,2008-03-05 20:16:27,2008-03-04 22:11:34
c95b3ad9ea310ec89e31a21edecaaf2c374e2c46...79b1138e7894ea048008f6b99908f5cd36e94949,1,0,2,2,1,2008-03-05 18:32:01,2008-03-04 10:02:35
56d5fe285583b5177ffc65dbe7df636ed5b8cc6b...5b10a3c12439b262ccebb528a2db3945e7ebd061,1,2,0,2,1,2008-03-10 08:22:03,2008-03-10 08:22:03
56d5fe285583b5177ffc65dbe7df636ed5b8cc6b...9dd5bded1bdc4f518aeed6a32ad70ccdd182dde5,1,19,3,22,3,2008-03-10 06:45:12,2008-03-08 18:27:09
9dd5bded1bdc4f518aeed6a32ad70ccdd182dde5...18d077c1bf576d51e2ad09e41b22042b8cb5c9f4,1,2,2,4,2,2008-03-13 04:07:19,2008-03-13 04:07:19
b75bb1d695b0958d77b7894fa4a7dbc76167b65a...fbbbc362ab9d3a8d76eb4273e65fb1fb26849d75,1,1,1,2,1,2008-03-01 08:55:38,2008-02-28 10:18:21
fbbbc362ab9d3a8d76eb4273e65fb1fb26849d75...bc434e829c6f1757d2761c50e06a28278dc2f2c7,1,10,5,15,4,2008-03-01 08:55:38,2008-02-28 10:18:22
bc434e829c6f1757d2761c50e06a28278dc2f2c7...3c832a78b15f8ffcb4e6f1f6f6d8b7a607ba5d06,1,5,1,6,2,2008-03-01 08:55:39,2008-02-28 10:18:23
b75bb1d695b0958d77b7894fa4a7dbc76167b65a...a6f13ccf2460a7905e223cd40ff06631294a4189,1,1,1,2,1,2008-02-28 21:35:09,2008-02-28 17:24:42
a6f13ccf2460a7905e223cd40ff06631294a4189...9907721501e19758e64bcce6d3b140316c9307b9,1,3,3,6,3,2008-02-28 21:36:50,2008-02-28 18:44:42
22c430ad8468133fa5ed46d8407d7f4cde2c4a0e...4cd883d724ec36a120263d47058e65c6d1de642f,1,3,2,5,2,2008-02-23 06:52:06,2008-02-22 18:47:08
22c430ad8468133fa5ed46d8407d7f4cde2c4a0e...a22c637124a2f591382d56546136a8e2bb2c2c66,2,12,6,18,5,2008-02-23 05:24:47,2008-02-23 04:37:40
a22c637124a2f591382d56546136a8e2bb2c2c66...d070e3a31bf94de1ef503b155a5e028545f7decc,3,17,16,33,5,2008-02-23 05:24:47,2008-02-23 04:39:21
d070e3a31bf94de1ef503b155a5e028545f7decc...eb7a2f1d50ca8620b087dd2751d0fe2505e7974f,2,18,2,20,4,2008-02-23 05:24:47,2008-02-23 04:41:17
eb7a2f1d50ca8620b087dd2751d0fe2505e7974f...0d2dd191cdfa3f1795c4df60a5cfb0f7e58c097a,1,2,1,3,1,2008-02-23 05:44:46,2008-02-23 00:52:29
22c430ad8468133fa5ed46d8407d7f4cde2c4a0e...8e0f70033b2bd1679a6e5971978fdc3ee09bdb72,17,28,55,83,26,2008-02-22 22:14:40,2008-01-31 17:26:32
959ba670ad7173bcb73afaca69625a5635f63b8b...3983caa531d31b2b95647ae60ac23a0e12385718,1,1,1,2,1,2008-02-16 18:51:46,2008-02-16 18:38:12
3983caa531d31b2b95647ae60ac23a0e12385718...ceb4cacb42d16e098672d395050f9e61345c4a19,1,2,2,4,1,2008-02-16 18:56:24,2008-02-16 16:48:45
ceb4cacb42d16e098672d395050f9e61345c4a19...965053b09a2de5687b9098cb05edc9bfbf1d26b3,1,17,0,17,1,2008-02-16 18:57:05,2008-02-16 16:48:46
ee4f06c0a60d8b17efdd8f6a3332f175f6aafe0e...4d6d6d2d3f778b892f2481969e530ff67ee0aa6c,1,1,7,8,3,2008-02-19 05:53:44,2008-02-18 10:44:19
4d6d6d2d3f778b892f2481969e530ff67ee0aa6c...f019d08ea6d5ae2f83a4b4eb9211108dfab4a672,1,123,0,123,1,2008-02-19 08:27:42,2008-02-19 07:52:11
f019d08ea6d5ae2f83a4b4eb9211108dfab4a672...afa9b620f9432491a453d752e8bf62860d7834c0,1,2,2,4,2,2008-02-20 05:30:44,2008-02-14 08:22:30
afa9b620f9432491a453d752e8bf62860d7834c0...a288394ed3f2ec1feea632ee28fb41d1ad2172bf,1,12,8,20,4,2008-02-20 05:31:33,2008-02-19 19:24:32
a288394ed3f2ec1feea632ee28fb41d1ad2172bf...b9dfe51c96cfc258cb0bc41433853892c35e0beb,1,166,5,171,3,2008-02-20 05:37:36,2008-02-18 19:23:03
a17b1d2f0b3128be6f116bf22b58244b310d27b9...06cbe8550324e0fd2290839bf3b9a92aa53b70ab,7,149,38,187,13,2008-04-17 01:23:54,2008-04-16 08:34:24
3f8d5204896a85d9268c579fc3e31b22b33fb803...76447d235ce2f4ccee7905971a33d3baef252701,1,1,1,2,1,2008-07-09 22:11:51,2008-07-09 20:47:38
76447d235ce2f4ccee7905971a33d3baef252701...14ec9cbdae1991a14aa1cce251e44ea5cfee5ade,1,77,58,135,13,2008-07-09 22:14:07,2008-07-09 21:38:33
14ec9cbdae1991a14aa1cce251e44ea5cfee5ade...6b61ec0564993d2e60f7eb56c0f0fd9c313d5e2c,4,23,23,46,8,2008-07-09 22:14:11,2008-07-09 21:38:34
3f8d5204896a85d9268c579fc3e31b22b33fb803...1cc6985ca7dd3aaab0617ec0fd00d4eb0b424465,2,28,28,56,10,2008-07-09 08:33:24,2008-07-08 10:34:08
1cc6985ca7dd3aaab0617ec0fd00d4eb0b424465...e84fb2ff75f861a708ea5a914883e178a845f4ef,1,8,4,12,2,2008-07-09 08:37:34,2008-07-09 00:31:51
e84fb2ff75f861a708ea5a914883e178a845f4ef...049716b370f2cebdbdeb278eb2a8c4eff8ed0acd,2,57,20,77,10,2008-07-09 09:12:24,2008-07-09 00:55:47
ec845695c4e6d7b689c3eb0b53d1b2ba4803c7ea...2a2ac926547bc4fa91fcd1cb741dd5691ba9b974,3,88,3,91,5,2008-05-03 20:39:51,2008-04-30 17:23:55
2a2ac926547bc4fa91fcd1cb741dd5691ba9b974...50705915eae89eae490dff30fa370ed02e4d6e72,3,3,3,6,3,2008-05-03 20:39:53,2008-04-30 17:24:43
50705915eae89eae490dff30fa370ed02e4d6e72...b8960bbe7bdfc0b232462f916ee8151c83afd16f,3,4,1,5,3,2008-05-03 20:40:43,2008-04-30 17:25:53
4b172de81b878cdc8b10803fd0cd79b3ca66a621...044182ef82f1a371c469a26a6d64c7b823aea764,1,213,39,252,29,2008-05-16 18:49:47,2008-05-15 04:35:46
044182ef82f1a371c469a26a6d64c7b823aea764...8a06a632976ead891115ad9ac9dea7b99c52158e,4,276,22,298,19,2008-05-16 19:00:31,2008-05-15 04:35:47
8a06a632976ead891115ad9ac9dea7b99c52158e...90948a42892779734f77d62f20326c868392fd8f,4,354,25,379,18,2008-05-16 19:05:35,2008-05-15 04:35:48
90948a42892779734f77d62f20326c868392fd8f...b592d88fb21fb3e3216d8eface9b748b2868323b,1,1,1,2,1,2008-05-22 03:57:02,2008-05-22 02:28:43
4b172de81b878cdc8b10803fd0cd79b3ca66a621...50fd9bd8430a957ea6c6674ce6112f375985abbc,3,13,0,13,5,2008-05-15 23:12:40,2008-05-14 17:03:31
50fd9bd8430a957ea6c6674ce6112f375985abbc...5fdeacb0ca3935923ab988c81414c16080db6a32,4,14,0,14,6,2008-05-15 23:12:43,2008-05-14 17:03:45
5fdeacb0ca3935923ab988c81414c16080db6a32...6848d58c60b7af365ce54cf3e3b274a2f9da2e7e,4,105,12,117,9,2008-05-15 23:12:43,2008-05-14 17:03:59
4b172de81b878cdc8b10803fd0cd79b3ca66a621...57e0e3ebd6fac2bf5fe46fd946dae6129b07f474,1,2,1,3,1,2008-05-15 22:19:04,2008-05-14 22:30:43
57e0e3ebd6fac2bf5fe46fd946dae6129b07f474...d775734c40afed216160437c59a45c93bdf28689,3,53,6,59,12,2008-05-15 23:52:31,2008-05-14 14:29:49
eafa29b7cb27fa0e14d9629e66d6866292620113...64c0d71ce91696dfe5beb4b51e3233e56c857290,1,16,19,35,16,2008-05-13 03:40:00,2008-05-12 21:41:04
10455d2a955a29db1809be139177e4e298771eb0...74e3f97be8934b5f37f3e5f44bdb5ce77f82541a,1,1,1,2,1,2007-12-01 19:06:41,2007-12-01 19:06:41
74e3f97be8934b5f37f3e5f44bdb5ce77f82541a...1d557352f18a4b8f73be402674af6bd5bb152ab9,3,47,2,49,3,2007-12-01 19:20:00,2007-12-01 19:20:00
7a3db75beee75c4e1b5fdae7504bc2ba05c58b14...0c4a33b54f3dbb9fa8cd2f5cf0e2a6363849d899,1,12,6,18,3,2007-11-25 19:06:12,2007-11-25 18:53:37
0c4a33b54f3dbb9fa8cd2f5cf0e2a6363849d899...81eb417ad423ef7e8d088d517f89d3bda92f9c06,1,49,9,58,2,2007-11-25 23:14:28,2007-11-25 22:54:19
81eb417ad423ef7e8d088d517f89d3bda92f9c06...7cb192eab0251911e2ca77d4ecceb621dd2d34f5,1,11,9,20,6,2007-11-26 00:01:57,2007-11-26 00:01:57
7cb192eab0251911e2ca77d4ecceb621dd2d34f5...1cdade2c4cb27f648a98d326ef3db523b6afafa7,1,130,1,131,3,2007-11-26 02:13:10,2007-03-04 03:53:37
1b9bc5a7b7434d771726011613a00cb202bd9f44...2aa839614e9d4f8b84803fb4ce633d6a0981675f,1,14,4,18,3,2006-05-16 06:19:46,2006-05-16 05:58:15
2aa839614e9d4f8b84803fb4ce633d6a0981675f...c82a22c39cbc32576f64f5c6b3f24b99ea8149c7,1,6,3,9,2,2006-05-17 00:18:22,2006-05-17 00:18:22
e5ef6f952a13342065d44bab53999e8d8529cc3b...7a39a17a873b818e3a4d121b3a43baf10f68cf61,1,86,10,96,17,2007-10-23 00:15:11,2007-10-23 00:15:11
7a39a17a873b818e3a4d121b3a43baf10f68cf61...94503918e480123d0d4cf03b03153e4d83cdfd4e,1,7,7,14,5,2007-10-23 00:33:38,2007-10-23 00:33:38
94503918e480123d0d4cf03b03153e4d83cdfd4e...bd8f677e1c8349b9128490e2a21e0f573d0bea1d,1,5,1,6,3,2007-10-23 12:37:23,2007-10-23 12:37:23
7388bcbc5431552718dde5c3259d861d2fa75a12...25ec9384844d0cc855cf16672f61cf6b3be9f67d,1,45,0,45,1,2007-12-19 23:19:07,2007-11-07 17:39:08
25ec9384844d0cc855cf16672f61cf6b3be9f67d...663c3aa9c89ae7d7a52308c50bda084f8b4ab337,1,19,0,19,1,2007-12-19 23:19:07,2007-11-07 17:40:59
663c3aa9c89ae7d7a52308c50bda084f8b4ab337...d990cedf9c61269eb71c257b84a4762bbbc196ef,1,201,200,401,162,2007-12-19 23:19:07,2007-11-07 17:42:55
d990cedf9c61269eb71c257b84a4762bbbc196ef...15bc7bae91e69dc1c1f85e6acc740bf57f7b554a,1,703,0,703,1,2007-12-19 23:19:07,2007-11-07 17:44:02
15bc7bae91e69dc1c1f85e6acc740bf57f7b554a...b007ee20dcf742d951009bf947f4883cb7f8070a,1,46,46,92,38,2007-12-19 23:19:07,2007-11-07 17:44:35
b007ee20dcf742d951009bf947f4883cb7f8070a...eadcac921805bc05f5029fc98f2484f52543af0d,1,1,1,2,1,2007-12-19 23:19:07,2007-11-07 17:47:04
7388bcbc5431552718dde5c3259d861d2fa75a12...7fcc92bff4f75b69d61d8d32a5326395c20ff587,1,957,421,1378,177,2007-12-02 23:33:01,2007-12-02 23:33:01
7fcc92bff4f75b69d61d8d32a5326395c20ff587...38dfe939162af50fb09088c4a888b1c719f328cc,1,19,19,38,9,2007-12-06 09:50:31,2007-12-06 09:50:31
38dfe939162af50fb09088c4a888b1c719f328cc...f78e7ab736467a0ae98695a8c661fe46fc93c50f,1,1,1,2,1,2007-12-07 09:50:09,2007-12-07 09:50:09
f78e7ab736467a0ae98695a8c661fe46fc93c50f...9257d8f7616e20d76b2c04cea7cb2fcd7daf68bb,1,113,90,203,42,2007-12-10 23:45:38,2007-12-10 23:45:38
9257d8f7616e20d76b2c04cea7cb2fcd7daf68bb...0c27886e469dcf81ed0ba7b2035e32a823224edc,1,3,2,5,2,2007-12-11 09:09:53,2007-12-11 09:09:53
0c27886e469dcf81ed0ba7b2035e32a823224edc...e5b37ac1ec6f1500a47a320a261933bccbdeb4f7,1,35,24,59,22,2007-12-12 07:13:51,2007-12-12 07:13:51
e5b37ac1ec6f1500a47a320a261933bccbdeb4f7...24f7a667e69262525beba726dded2fb221d9be27,1,39,39,78,25,2007-12-18 22:35:33,2007-12-18 22:35:33
24f7a667e69262525beba726dded2fb221d9be27...f3ea5ede23a2f8a7514583d2665e7a72aad7c9b8,1,130,98,228,30,2007-12-19 23:03:35,2007-12-19 23:03:35
1768905b51601d5d080168059acd24d13b888a2d...38bcd31a5879847d259a75fbcab9a7977ff63f1e,1,7,2,9,2,2008-03-27 23:05:27,2008-03-27 22:17:26
38bcd31a5879847d259a75fbcab9a7977ff63f1e...23b7180fdcd46556038241cd0388eca092fc55e1,1,3,1,4,2,2008-03-27 23:05:27,2008-03-27 22:17:42
23b7180fdcd46556038241cd0388eca092fc55e1...852b921c78ca33606600d7fd45e573a8435dbcb8,1,2,0,2,1,2008-03-27 23:05:27,2008-03-27 22:17:53
852b921c78ca33606600d7fd45e573a8435dbcb8...dded801a7ba8bb91e73cfea2f37242a2aebbc5db,1,32,0,32,1,2008-03-27 23:05:27,2008-03-27 22:18:02
dded801a7ba8bb91e73cfea2f37242a2aebbc5db...e78f69a3f2e580e71a44b91fa99185bc6f92db29,1,35,12,47,12,2008-03-27 23:05:27,2008-03-27 22:18:12
e78f69a3f2e580e71a44b91fa99185bc6f92db29...6e8937a084927867df4d90c75b2619f2b4b0df18,1,18,0,18,1,2008-03-27 23:05:27,2008-03-27 22:18:23
6e8937a084927867df4d90c75b2619f2b4b0df18...c1bc30614ad0a9b63f4f798f0aa71d376a095938,1,12,4,16,3,2008-03-27 23:05:27,2008-03-27 22:18:35
1768905b51601d5d080168059acd24d13b888a2d...1f4a711a05e00db81da552dd990f6ddff4ffb63e,2,11,0,11,3,2008-03-27 20:55:15,2008-03-24 14:02:21
1f4a711a05e00db81da552dd990f6ddff4ffb63e...0c62705a0d9730df027a4e4074a8d9d5293e0b9b,1,34,0,34,1,2008-03-27 20:55:15,2008-03-23 21:34:34
0c62705a0d9730df027a4e4074a8d9d5293e0b9b...629de472b67bdb6b1fbdc72a95e1f569e3b8f02d,1,16,22,38,6,2008-03-27 20:55:15,2008-03-23 20:50:29
629de472b67bdb6b1fbdc72a95e1f569e3b8f02d...fe308f53730f168be65c57c46e5c573b449b3e32,2,14,3,17,2,2008-03-27 22:39:57,2008-03-25 06:20:51
1768905b51601d5d080168059acd24d13b888a2d...17a8b25005bb09b03bee7ddac5412c7d29675eef,4,20,3,23,5,2008-03-27 20:55:10,2008-03-26 18:11:19
17a8b25005bb09b03bee7ddac5412c7d29675eef...26ffcb7690139dd53f5deb4f875895f22bebee4f,1,1,0,1,1,2008-04-05 19:03:01,2008-04-05 16:37:18
1768905b51601d5d080168059acd24d13b888a2d...b717a627629e6886956af54274d507b9711d49e6,2,25,0,25,3,2008-03-27 20:54:56,2008-03-27 07:30:43
b717a627629e6886956af54274d507b9711d49e6...ca7246864b43e9ea1922cc5386225ecd1b3bdd98,2,44,1,45,4,2008-03-27 20:54:57,2008-03-27 07:32:25
c36c5b845e1958bad1b69ee42e3da926de4f948b...e7951290f6f87ac413a3f1e3a870619275453efe,1,2,0,2,1,2008-03-13 07:31:18,2008-03-13 07:13:15
e7951290f6f87ac413a3f1e3a870619275453efe...bb12ac5120b657691b71108cef3e586ba0b76af6,1,8,10,18,1,2008-03-14 05:46:56,2008-03-13 18:32:16
bb12ac5120b657691b71108cef3e586ba0b76af6...1affea4f629537fd48e3bd66de89a6f45d0fcd82,2,62,2,64,3,2008-03-14 06:41:16,2008-03-13 22:47:41
1affea4f629537fd48e3bd66de89a6f45d0fcd82...381b851c9b010147bb1fa83a013b7c8f60419026,2,4,3,7,2,2008-03-14 06:43:56,2008-03-13 15:19:35
ca19404876451ea8be0cc5b3ed561344b5fc80c5...259cd0fddb1dea649d15e9cd5039c55dc30845b0,1,9,17,26,15,2008-05-01 22:13:14,2008-05-01 09:51:47
259cd0fddb1dea649d15e9cd5039c55dc30845b0...fe70225dc730c5af4c491106d1e0226d1c014d1e,3,27,1,28,6,2008-05-09 00:20:27,2008-05-09 00:16:43
fe70225dc730c5af4c491106d1e0226d1c014d1e...76bb40cde0e15e8d0e8493abb0bd18a5d6386ad7,1,1,1,2,1,2008-05-09 00:29:42,2008-05-09 00:29:42
77ad7a49d3cc946487ca759e5361effbcfb03be5...4ed4a347168d6714c6beca7d7702473229c9d8f1,1,2,3,5,3,2008-04-05 23:30:49,2008-04-05 20:13:24
4ed4a347168d6714c6beca7d7702473229c9d8f1...f53423b0e09d0de9584f72ac298bdfdc9e886d73,1,2,0,2,1,2008-04-05 23:31:45,2008-04-05 18:28:53
f53423b0e09d0de9584f72ac298bdfdc9e886d73...ba1333fec3df7496839106ee8730939d100d989d,1,3,2,5,1,2008-04-05 23:51:16,2008-04-05 19:46:49
ba1333fec3df7496839106ee8730939d100d989d...9de328fea951eca9524feaa5eb55762467df6b98,1,15,1,16,2,2008-04-07 00:22:46,2008-04-06 20:51:49
9de328fea951eca9524feaa5eb55762467df6b98...d9e3b7025fdfeb80bb72a10b5d272acfbb5df72a,1,1,1,2,1,2008-04-07 03:01:17,2008-04-06 17:32:24
d9e3b7025fdfeb80bb72a10b5d272acfbb5df72a...f2b3e3c722fed852c59880f4773bc51833229cd3,1,0,4,4,2,2008-04-07 03:02:43,2008-04-06 17:08:50
f2b3e3c722fed852c59880f4773bc51833229cd3...aba201c6e8d9934157b9ba39b8e6b54c2fa7b6e1,1,4,1,5,2,2008-04-07 03:03:09,2008-04-06 16:56:08
eedb9d9eabda4d6a91f2271b8694763d018b0f89...6c41b80153a2e4ee347d0e968ee8d0d9abfc8862,2,5,5,10,4,2008-04-02 18:13:25,2008-04-02 17:42:14
ce2cf27adc434c11cd1e91bcacf00297efd8cc92...81a24b52c164b96d37c8c50799a624e2e8ce8a57,3,11,1,12,4,2008-03-05 20:22:26,2008-03-04 23:15:39
79b1138e7894ea048008f6b99908f5cd36e94949...3b376b0cb8b5d6b7b0d3f3acff6a31f350a7ab04,1,10,1,11,1,2008-03-05 20:10:29,2008-03-04 18:00:58
3b376b0cb8b5d6b7b0d3f3acff6a31f350a7ab04...b9217642ef2db34e2cbeaef8d4439b07a03027cd,1,18,1,19,2,2008-03-05 20:10:29,2008-03-04 18:00:59
79b1138e7894ea048008f6b99908f5cd36e94949...44c36d1ccc9a40bfb31910dfd7e18d59fa8be502,2,19,24,43,12,2008-03-05 20:07:03,2008-02-21 23:30:02
44c36d1ccc9a40bfb31910dfd7e18d59fa8be502...b3ea27e4de24c7006969f493ba6bfbbc5b572d80,1,50,50,100,35,2008-03-05 20:07:03,2008-02-21 23:30:34
b3ea27e4de24c7006969f493ba6bfbbc5b572d80...964473a0429f625d019c69ab55644540174acf85,2,49,4,53,7,2008-03-05 20:07:04,2008-02-21 23:31:12
964473a0429f625d019c69ab55644540174acf85...05e934bb9f7767e13e8a658b0e429a40076a6b35,1,46,0,46,1,2008-03-05 20:07:04,2008-02-21 23:31:56
79b1138e7894ea048008f6b99908f5cd36e94949...5348337a3406a28a2db35fdfba8cb766b0241949,1,4,5,9,2,2008-03-05 20:06:09,2008-03-02 09:05:51
5348337a3406a28a2db35fdfba8cb766b0241949...9225d7be0abab0c3b1325a733aea127b45a18625,4,4,4,8,4,2008-03-05 20:06:09,2008-03-02 09:05:52
9225d7be0abab0c3b1325a733aea127b45a18625...94c22a5e7b4247d7d6453272c4425d81071d2689,3,13,0,13,5,2008-03-05 20:06:09,2008-03-02 09:05:53
79b1138e7894ea048008f6b99908f5cd36e94949...b41860bf28a16ad6015eb0c55dc95602f1235640,2,106,7,113,16,2008-03-05 18:53:11,2008-02-25 21:46:11
b41860bf28a16ad6015eb0c55dc95602f1235640...c0e809e5c027443d6f77714a1c5f8c6233ca0a20,1,48,0,48,1,2008-03-05 18:53:11,2008-03-05 08:14:32
c0e809e5c027443d6f77714a1c5f8c6233ca0a20...f2898cfadc85c763a4b8299ab833a2c733c8467a,2,58,17,75,18,2008-03-05 18:53:11,2008-03-05 07:46:51
f2898cfadc85c763a4b8299ab833a2c733c8467a...20dc0016eebdfabbbffe8fc98364fed855ce59a4,2,29,13,42,6,2008-03-05 19:36:30,2008-02-25 21:46:13
20dc0016eebdfabbbffe8fc98364fed855ce59a4...38a5739dfadd41c9e45bb05ed6fe1559895360cb,1,47,0,47,1,2008-03-07 08:36:56,2008-03-07 07:39:53
79b1138e7894ea048008f6b99908f5cd36e94949...bb034f839a396cf0660024a59bbff61f8ef0c5af,2,95,2,97,5,2008-03-05 18:52:56,2008-03-04 08:25:04
bb034f839a396cf0660024a59bbff61f8ef0c5af...e72c74062c01855372add133fe8dcc0bd22bad20,2,6,14,20,7,2008-03-05 18:52:56,2008-03-04 08:25:05
e72c74062c01855372add133fe8dcc0bd22bad20...3041c324305e2bad59d7372336940846646dd46a,3,21,4,25,6,2008-03-05 18:52:56,2008-03-04 08:25:06
1b56bc9a1545902db64b8bdce48a499900acfe0b...ed0b9d43097349f4d730472673c07f427480e14a,1,2,1,3,2,2008-03-15 00:54:28,2008-03-14 18:01:23
ed0b9d43097349f4d730472673c07f427480e14a...621ff6759414e2a723f61b6d8fc04b9805eb0c20,1,15,13,28,8,2008-03-15 00:59:24,2008-03-14 18:49:40
621ff6759414e2a723f61b6d8fc04b9805eb0c20...ac378633f3cae46d2c88255e53ee38a6206d3777,1,1,1,2,1,2008-03-15 07:05:18,2008-03-15 02:44:13
ac378633f3cae46d2c88255e53ee38a6206d3777...a0b54e7b73415f92225ddf29fe655399bafd4938,1,5,1,6,2,2008-03-15 07:05:18,2008-03-14 21:38:18
965053b09a2de5687b9098cb05edc9bfbf1d26b3...e5fc9a0aea2c3c49829b5cdf499339e5c759706b,5,65,11,76,7,2008-02-17 08:20:38,2008-02-17 06:44:31
e3c58f8b300dbc80b97a31a3a2758de00c5b52ce...f27e55864317611385be4d33b3c53ca787379df9,1,3,4,7,2,2008-02-20 19:25:14,2008-02-19 14:01:53
e3c58f8b300dbc80b97a31a3a2758de00c5b52ce...9f0ea7e8283da126c8e1d5e0c3b39c39200258ad,3,52,10,62,4,2008-02-20 19:06:27,2008-02-20 17:54:05
36c79d2bf893b9957688a6c8c13cc0bf0589e596...b1b359699a24a89f773cccdf35801bc6fc15ade8,2,21,4,25,7,2008-04-27 06:22:17,2008-04-26 11:57:23
b1b359699a24a89f773cccdf35801bc6fc15ade8...498a6e7eaaa8d2641f7cc343e1557e1502437b33,2,2,2,4,2,2008-04-27 20:19:33,2008-04-23 23:04:48
498a6e7eaaa8d2641f7cc343e1557e1502437b33...75ecfce39703e15a9f3d812faa4eb039935c8962,1,2,2,4,2,2008-04-27 20:19:46,2008-04-26 13:19:29
75ecfce39703e15a9f3d812faa4eb039935c8962...07ba53f724b95a817f957b8e943c9e4f545a0949,1,6,1,7,2,2008-04-28 04:38:22,2008-04-27 15:35:10
36c79d2bf893b9957688a6c8c13cc0bf0589e596...3562198b7da7ef6597af27b3a7fcaeee41608999,2,104,25,129,12,2008-04-27 00:48:48,2008-04-20 20:09:48
36c79d2bf893b9957688a6c8c13cc0bf0589e596...88ea8112b4abca416993e2a3145616cd732771c8,1,20,2,22,4,2008-04-27 00:48:17,2008-04-19 21:22:38
36c79d2bf893b9957688a6c8c13cc0bf0589e596...c13b2633f49e3e61b37973204793a4d9ef981175,6,36,27,63,27,2008-04-27 00:36:17,2008-04-26 19:53:09
c13b2633f49e3e61b37973204793a4d9ef981175...be885d96fe0ebed47e637f3b0dd24fc5902f7081,5,43,2,45,9,2008-04-27 00:36:18,2008-04-26 19:53:12
36c79d2bf893b9957688a6c8c13cc0bf0589e596...7b15f872f23855de59bd06b0ebdbbc47b27b781b,1,124,19,143,21,2008-04-26 21:33:39,2008-04-25 06:24:22
7b15f872f23855de59bd06b0ebdbbc47b27b781b...7e8114c0683e6ecfd400a5a798ae7e2fc91249fb,2,13,0,13,2,2008-04-26 21:33:56,2008-04-25 06:24:41
7e8114c0683e6ecfd400a5a798ae7e2fc91249fb...a26a06afed783cb7cf7207c1bcb2d1781d623d1e,1,40,18,58,10,2008-04-26 21:33:56,2008-04-25 06:24:58
a26a06afed783cb7cf7207c1bcb2d1781d623d1e...0bb64009586b7fd674b1c3238f041b61c5d03f91,2,48,5,53,7,2008-04-26 21:34:49,2008-04-25 06:25:35
0bb64009586b7fd674b1c3238f041b61c5d03f91...ac3a4a2694fa8bea477b1a265efd6829de686e5c,1,23,1,24,2,2008-04-26 21:34:49,2008-04-25 06:25:41
36c79d2bf893b9957688a6c8c13cc0bf0589e596...cfd9c27708509457f572373bd8f4eb25dd4a6715,3,23,7,30,7,2008-04-26 21:06:17,2008-04-26 20:14:28
1f8115b113def8ee03701aa87b26c5e8b7c94434...0a02186f924aee1bd69f18ed01f645aa332ce0d1,6,294,1,295,9,2008-05-13 00:16:40,2008-05-10 22:36:29
1f8115b113def8ee03701aa87b26c5e8b7c94434...2455406ab1b0e2b0ad9e5273b9aef6c739d5b8fe,1,7,1,8,3,2008-05-11 18:31:28,2008-05-11 16:16:39
2455406ab1b0e2b0ad9e5273b9aef6c739d5b8fe...1c51c7d7d97acb447050a820dc39d242dc29c5df,1,16,0,16,3,2008-05-11 18:31:37,2008-05-11 16:16:40
1c51c7d7d97acb447050a820dc39d242dc29c5df...b4a299d87ca7a1d39c699ee2af28305e57f3b0ae,1,1,0,1,1,2008-05-11 18:31:46,2008-05-11 16:16:41
b4a299d87ca7a1d39c699ee2af28305e57f3b0ae...8a19aaab6394df2c6138d5b8b1411eb00bfcf442,1,10,0,10,1,2008-05-11 18:31:51,2008-05-11 16:16:42
8a19aaab6394df2c6138d5b8b1411eb00bfcf442...0047dd2fd1fc1980913901c5fa098357482c2842,1,2,0,2,1,2008-05-17 09:43:26,2008-05-15 05:19:54
1f8115b113def8ee03701aa87b26c5e8b7c94434...ccc1297226b184c40459e9d373cc9eebfb7bd898,2,60,5,65,4,2008-05-11 18:24:48,2008-05-10 04:01:55
ccc1297226b184c40459e9d373cc9eebfb7bd898...a37cce3b23afa2c88baa2f1369c585e05bcf4526,1,2,11,13,1,2008-05-11 18:26:02,2008-05-10 04:01:56
a37cce3b23afa2c88baa2f1369c585e05bcf4526...9e7d501990a9c63db264f3185fc311f446196427,1,1,2,3,2,2008-05-11 18:26:07,2008-05-10 04:01:57
9e7d501990a9c63db264f3185fc311f446196427...bbac73117ebed9f02ccae3df45f4baa0c793dab7,2,48,13,61,9,2008-05-14 05:42:33,2008-05-14 05:32:48
bbac73117ebed9f02ccae3df45f4baa0c793dab7...ca11b212eb3e31d6fee12e9974c67dc774c1bc7c,2,45,17,62,11,2008-05-14 05:45:44,2008-05-14 05:33:53
ca11b212eb3e31d6fee12e9974c67dc774c1bc7c...bbefaa1f38a47e06c32612edc2f64a0168cc40b2,1,13,1,14,2,2008-05-16 19:51:34,2008-05-16 02:37:31
1f8115b113def8ee03701aa87b26c5e8b7c94434...737922aa648c43bc6a61170bee5bfd46ff953f32,6,19,27,46,13,2008-05-11 16:04:37,2008-05-10 23:26:58
737922aa648c43bc6a61170bee5bfd46ff953f32...d1a8d0ea5fb2d4d43d0ea8f2fe45ec1fce7ec4bc,3,42,4,46,7,2008-05-11 16:06:39,2008-05-11 00:14:49
d1a8d0ea5fb2d4d43d0ea8f2fe45ec1fce7ec4bc...c998ae9baa1cc5f507646da9850731de634d2ee7,6,294,1,295,9,2008-05-11 16:28:52,2008-05-10 22:36:29
c998ae9baa1cc5f507646da9850731de634d2ee7...37c22a4bf801403f71a5e9674d8e314ce575945e,2,10,1,11,4,2008-05-11 17:12:19,2008-05-09 22:55:43
37c22a4bf801403f71a5e9674d8e314ce575945e...f4e9f786f737e55fd4ea06dbb25b14dd32b872c1,1,2,2,4,2,2008-05-11 17:12:19,2008-05-06 10:53:56
f4e9f786f737e55fd4ea06dbb25b14dd32b872c1...4be403815321976bc2ee4c6677799abb06b153aa,2,55,15,70,8,2008-05-11 17:12:19,2008-05-11 05:11:18
4be403815321976bc2ee4c6677799abb06b153aa...921df15f1d276bdecb7c4e134dff97f4e3adf953,1,114,0,114,1,2008-05-11 18:35:42,2008-05-11 16:27:10
921df15f1d276bdecb7c4e134dff97f4e3adf953...28bfa145e4dedad9b2c81857b77ca13871c77853,2,7,6,13,4,2008-05-11 18:36:07,2008-05-11 16:27:36
28bfa145e4dedad9b2c81857b77ca13871c77853...dfd1b749befcb581d84722caa6a3af56ce6526a5,2,26,24,50,13,2008-05-11 18:51:12,2008-05-11 16:28:25
c7ea453618e41e05a06f05e3ab63d555d0ddd7d9...58949bb18a1610d109e64e997c41696e0dfe97c3,1,4,1,5,2,2008-05-15 08:30:25,2008-05-14 23:22:18
64c0d71ce91696dfe5beb4b51e3233e56c857290...bbf08124e0a87658a76b53a05d67227fa3b4e7b9,5,8,8,16,8,2008-05-14 04:44:48,2008-05-14 04:01:22
bbf08124e0a87658a76b53a05d67227fa3b4e7b9...30684dfaf8cf96e5afc01668acc01acc0ade59db,1,4,4,8,1,2008-05-14 04:45:28,2008-05-13 08:45:32
30684dfaf8cf96e5afc01668acc01acc0ade59db...6d9878cc60ba97fc99aa92f40535644938cad907,1,1,2,3,2,2008-05-14 04:45:28,2008-05-13 08:45:56
6d9878cc60ba97fc99aa92f40535644938cad907...0bdf93cbf0afd568384f237378ba368e751a2f0f,1,9,3,12,3,2008-05-14 04:45:28,2008-05-13 08:46:38
64c0d71ce91696dfe5beb4b51e3233e56c857290...960b8ad1b1824b1b82c2b09a000c2119f97633a0,4,13,9,22,7,2008-05-13 03:54:46,2008-05-12 17:57:45
960b8ad1b1824b1b82c2b09a000c2119f97633a0...7ae02a30e817eda16ea362c6304b6ae28c3a7644,4,37,12,49,16,2008-05-13 03:54:52,2008-05-12 17:58:10
7ae02a30e817eda16ea362c6304b6ae28c3a7644...984b83ef23fdcf6a933f635f182e7bc10130094a,2,15,3,18,6,2008-05-13 03:54:52,2008-05-12 17:58:29
984b83ef23fdcf6a933f635f182e7bc10130094a...89597436450d4665ea8f9f782e71d42539d9f24b,1,22,0,22,1,2008-05-13 04:22:50,2008-05-12 17:58:48
89597436450d4665ea8f9f782e71d42539d9f24b...dad25e4a7c34a3ece1355f84b8c4661438754531,2,31,1,32,3,2008-05-13 04:40:15,2008-05-12 17:59:23
1d557352f18a4b8f73be402674af6bd5bb152ab9...4e596e988abfd7ce0b4456cdbf27baa16fa7aab8,1,12,0,12,1,2007-12-02 18:59:59,2007-12-02 17:22:19
c82a22c39cbc32576f64f5c6b3f24b99ea8149c7...be0c7e069738fbb697b0719f2252107261c9340e,1,1,1,2,1,2006-05-18 05:32:16,2006-05-10 17:37:04
bd8f677e1c8349b9128490e2a21e0f573d0bea1d...74a40c71102ea925b174da15c74afb15b6b82537,1,29,18,47,7,2007-10-24 00:16:56,2007-10-24 00:16:56
eadcac921805bc05f5029fc98f2484f52543af0d...a495e5a9080080dd2a9a02c5b3f27f1d48a3f0cd,1,27,27,54,26,2007-12-31 01:49:13,2007-12-31 01:49:13
00abadb9dd5605b626defe61f271098b0040c76b...fc2a256f4a49732226b742762b628af6a8bd05d8,1,28,21,49,18,2007-12-26 12:03:43,2007-12-26 12:03:43
fc2a256f4a49732226b742762b628af6a8bd05d8...eb5f8c9c00716dd3f55b1f09329309a657c492e0,1,10,3,13,3,2007-12-29 10:13:34,2007-12-29 10:13:34
eb5f8c9c00716dd3f55b1f09329309a657c492e0...31c0eaa8cc10944ebca8aa31fb59f0b77b1b6e77,1,42,13,55,11,2007-12-30 11:41:14,2007-12-30 11:41:14
803d5158123346229d71de53818920efbc88ca0f...90356287e65181caeaa821d7476b8865d26bc588,1,18,2,20,3,2008-03-31 08:03:05,2008-03-31 07:14:14
90356287e65181caeaa821d7476b8865d26bc588...6a589fda2e4759e21d66eb2e6814e32baa14beca,2,2,2,4,2,2008-03-31 08:09:50,2008-03-31 07:14:15
803d5158123346229d71de53818920efbc88ca0f...f3e5ae4f06ae968b710d286280a46b38ae3d36e8,1,15,13,28,9,2008-03-28 15:27:39,2008-03-28 14:40:40
f3e5ae4f06ae968b710d286280a46b38ae3d36e8...67dac28b904cf16e66c904eb61268b694809e4d5,1,1,1,2,1,2008-03-31 05:03:05,2008-03-29 23:37:17
67dac28b904cf16e66c904eb61268b694809e4d5...c20711d29dff054735988c84ad5fe4f382d064cf,1,5,1,6,2,2008-03-31 05:21:06,2008-03-28 06:19:46
803d5158123346229d71de53818920efbc88ca0f...9027efed47ba930382baa8051f451235be12fa63,1,1,1,2,1,2008-03-28 06:51:33,2008-03-16 19:00:21
76bb40cde0e15e8d0e8493abb0bd18a5d6386ad7...16dd62ac4de10c9ae27d29bb1c906ad97ac8908f,1,39,8,47,12,2008-05-20 19:44:46,2008-05-18 17:08:17
16dd62ac4de10c9ae27d29bb1c906ad97ac8908f...7f83aa2d3df0623984e265052f96e7172e3efbeb,1,7,16,23,5,2008-05-22 12:34:00,2008-05-21 20:40:10
7f83aa2d3df0623984e265052f96e7172e3efbeb...95dcfa3633004da0049d3d0fa03f80589cbcaf31,1,2,6,8,2,2008-05-27 01:05:20,2008-05-19 04:01:58
a1c0dca43a3513574e5bebb38989671960cdaf35...f61cc48d289755065813db1fbbd18e6bb0836076,3,113,2,115,5,2008-04-07 07:16:08,2008-04-07 07:08:03
b9217642ef2db34e2cbeaef8d4439b07a03027cd...3296766eb5531ef051ae392114de5d75556f5613,3,7,4,11,6,2008-03-07 08:14:42,2008-03-07 07:18:08
3296766eb5531ef051ae392114de5d75556f5613...971dfa19598324f49bd3a010ca629c91d6a0f758,1,1,5,6,3,2008-03-07 08:14:43,2008-03-07 07:29:40
971dfa19598324f49bd3a010ca629c91d6a0f758...6c53e7ac04ecdb8b2697aea4bb9bec8715209e68,1,0,12,12,1,2008-03-07 08:14:43,2008-03-07 07:31:29
6c53e7ac04ecdb8b2697aea4bb9bec8715209e68...79418599e7221ef10641cf9cc07018c25b4d0310,1,1,10,11,2,2008-03-07 08:14:43,2008-03-07 07:50:51
79418599e7221ef10641cf9cc07018c25b4d0310...a734d0b10bd0f5554abb3acdf11426040cfc4df0,3,48,45,93,4,2008-03-08 05:22:25,2008-03-07 02:30:58
a734d0b10bd0f5554abb3acdf11426040cfc4df0...1fb328947c8e3ace9df7d2d5374e26e2510a4e93,1,14,18,32,14,2008-03-08 05:22:37,2008-03-07 01:13:17
1fb328947c8e3ace9df7d2d5374e26e2510a4e93...5b7570cfb41c34ce585ede3fc1e45fa48febbd8f,1,52,0,52,1,2008-03-08 05:56:56,2008-03-08 05:56:56
b9217642ef2db34e2cbeaef8d4439b07a03027cd...c4582f93a263bea534288e7f7ad8937405964cd4,5,92,0,92,6,2008-03-05 21:12:07,2008-03-05 15:46:13
a0b54e7b73415f92225ddf29fe655399bafd4938...6bf4f1b4c9d78b2061bd5f3bf77bb21112b755be,5,57,16,73,15,2008-03-15 07:06:06,2008-03-15 00:10:09
e5fc9a0aea2c3c49829b5cdf499339e5c759706b...fef3a7cc5593d3951a5f95c92986fb9982c2cc86,2,67,8,75,3,2008-02-20 06:44:20,2008-02-18 17:55:22
e5fc9a0aea2c3c49829b5cdf499339e5c759706b...2b8130c338715936fcda82e734e76e86a33316aa,1,1,1,2,1,2008-02-20 04:44:47,2008-02-19 16:25:01
2b8130c338715936fcda82e734e76e86a33316aa...68d06c5200775ffda91881254ca7a92f27db68ef,1,3,3,6,1,2008-02-20 04:46:10,2008-02-19 16:25:22
68d06c5200775ffda91881254ca7a92f27db68ef...066a5268db8bff70ebd31d7887e060d1463fe57c,1,49,0,49,1,2008-02-20 04:46:15,2008-02-19 16:26:45
066a5268db8bff70ebd31d7887e060d1463fe57c...7c33d3a5116fd72877802288cca6735642bb5d6f,1,39,30,69,17,2008-02-20 06:17:22,2008-02-18 23:11:21
e5fc9a0aea2c3c49829b5cdf499339e5c759706b...50974ec99408b2d814360863e72a5eca613889c8,1,2,1,3,1,2008-02-19 03:20:17,2008-02-18 20:47:52
50974ec99408b2d814360863e72a5eca613889c8...283cdbcf49401cc56169f8f36b7ddc8b8223b2b9,1,2,1,3,1,2008-02-19 03:20:18,2008-02-18 20:47:53
283cdbcf49401cc56169f8f36b7ddc8b8223b2b9...c1ee9013ad5acfff47a36899af7d485f6d60fa83,1,4,0,4,2,2008-02-19 03:20:20,2008-02-18 20:47:54
c1ee9013ad5acfff47a36899af7d485f6d60fa83...c34066358a604e3ccb6afcf5679fa8a84be79936,1,2,1,3,1,2008-02-19 03:25:22,2008-02-18 20:47:55
c34066358a604e3ccb6afcf5679fa8a84be79936...a301b0c8f2627f0c0f4c6fd1015c6140a875d0b4,1,4,0,4,2,2008-02-19 03:25:26,2008-02-18 20:47:56
a301b0c8f2627f0c0f4c6fd1015c6140a875d0b4...172947e645a6c919efb78a246c919d0daaa674f0,1,6,3,9,2,2008-02-19 03:25:26,2008-02-18 20:47:57
172947e645a6c919efb78a246c919d0daaa674f0...cc36934791f3857b62348b6a9e071cdf989a9177,1,2,1,3,1,2008-02-19 03:25:26,2008-02-18 20:47:59
cc36934791f3857b62348b6a9e071cdf989a9177...f7de5a56b75109e1d6651ee2b5bf7f496a5eb18b,1,4,0,4,2,2008-02-19 03:25:26,2008-02-18 20:48:00
f7de5a56b75109e1d6651ee2b5bf7f496a5eb18b...9684afd967f61047bbf1b3a8039adf7d41916b31,1,4,0,4,2,2008-02-19 03:25:26,2008-02-18 20:48:01
9684afd967f61047bbf1b3a8039adf7d41916b31...9786f68bfcc082778aee74159540e341bb239514,1,2,0,2,1,2008-02-19 03:25:26,2008-02-18 20:48:02
9786f68bfcc082778aee74159540e341bb239514...dec38c81657f02624752a65c24d72613316713f5,3,5,4,9,3,2008-02-19 04:49:13,2008-02-18 20:48:03
dec38c81657f02624752a65c24d72613316713f5...f73df331a43a6092af427fd30bb6ce07f313743c,1,4,1,5,2,2008-02-19 04:49:18,2008-02-18 20:47:58
633d1fe9d0f8993c4e0ceb9d166a550344cbe5f9...e8729f5380788855943c69f749eb5e276c3b8310,1,16,0,16,3,2008-04-28 05:22:14,2008-04-27 09:48:30
e8729f5380788855943c69f749eb5e276c3b8310...f0ec47b8e7f46e17e6b6fe1cead728fa24477e43,1,3,3,6,1,2008-04-28 05:24:55,2008-04-27 14:07:24
447d0cca45920bbe409361bb532444f810c75546...356a32a23a2118e12a62fa42876a261feb554b1a,3,4,4,8,3,2008-07-13 23:08:27,2008-07-12 15:47:16
356a32a23a2118e12a62fa42876a261feb554b1a...5352a82bab7422fea53679d56fdef878d51b7968,1,21,5,26,3,2008-07-13 23:08:27,2008-07-12 15:47:31
5352a82bab7422fea53679d56fdef878d51b7968...7970aaf0fb65ad3e9f61d0ede6f211125732495d,1,51,26,77,16,2008-07-13 23:08:27,2008-07-12 15:48:20
7970aaf0fb65ad3e9f61d0ede6f211125732495d...74982056fa47a7c1c060ddaa5e363c57bc6bbacd,1,1,1,2,1,2008-07-13 23:08:27,2008-07-08 23:32:15
1fbb58b4153e90eda08c2b022ee32d90729582e6...a5099bb4178591d9a16d704c74dba34b92f35861,1,4,5,9,3,2008-05-16 19:38:52,2008-05-15 07:42:58
a5099bb4178591d9a16d704c74dba34b92f35861...ed020917147ca733477a0186f3bb1791ec6e5b5c,1,1,1,2,1,2008-05-16 19:39:35,2008-05-15 17:52:22
ed020917147ca733477a0186f3bb1791ec6e5b5c...b30317819dcbcb99a9ef520631e6ab002b6755a0,1,31,31,62,29,2008-05-16 19:40:09,2008-05-15 22:35:56
b30317819dcbcb99a9ef520631e6ab002b6755a0...be4d2c83b68a96285cc05036add4d64d324e52d9,3,25,2,27,6,2008-05-16 20:03:55,2008-05-16 10:23:03
be4d2c83b68a96285cc05036add4d64d324e52d9...d16d5cdf59f44e412525a270885488fccb8e4e30,1,3,1,4,1,2008-05-17 05:05:22,2008-05-16 00:21:43
0bdf93cbf0afd568384f237378ba368e751a2f0f...ef90d6d4208a5130185b04f06e5f90a5f9959fe3,74,176,173,349,167,2008-05-14 19:34:44,2008-05-14 17:46:53
a495e5a9080080dd2a9a02c5b3f27f1d48a3f0cd...b039f0a62d513226352f9bd745374629f8579b0c,1,45,60,105,44,2008-01-06 04:55:39,2008-01-06 04:54:46
33de5c0da8d8ea566ab8e8d91b513a98fceb414a...42a671fc006122159aec06da28045ffee49d3244,1,51,18,69,10,2008-01-01 22:59:39,2008-01-01 22:59:39
42a671fc006122159aec06da28045ffee49d3244...cd2bcae798ac2194f18374dc7dc10de404fd01d0,1,11,4,15,5,2008-01-02 10:44:06,2008-01-02 10:44:06
cd2bcae798ac2194f18374dc7dc10de404fd01d0...c8c9f3d9cc9a21084c9fe4742d0e66b7c988635c,1,28,9,37,4,2008-01-06 02:54:58,2008-01-06 02:54:58
c20711d29dff054735988c84ad5fe4f382d064cf...6301f303d436f226b705380ab97c7c0122374241,1,140,0,140,1,2008-03-31 05:22:09,2008-03-31 00:28:05
6301f303d436f226b705380ab97c7c0122374241...948dd346fd6748f8c2c0ae488759cbbd05a09320,2,56,15,71,23,2008-03-31 05:22:09,2008-03-31 00:29:48
948dd346fd6748f8c2c0ae488759cbbd05a09320...f58dbf23c33e0e79622f4344b48ab5bc9bc360cc,2,14,9,23,8,2008-03-31 05:22:09,2008-03-31 00:30:08
c20711d29dff054735988c84ad5fe4f382d064cf...6aeeffd14447348f3ab4a7d34927d6aff8c0a75c,4,107,31,138,52,2008-03-31 05:21:35,2008-03-27 21:02:14
95dcfa3633004da0049d3d0fa03f80589cbcaf31...8a965b8ee28bedc58641453e13d03f80180320dd,1,27,2,29,4,2008-06-13 21:58:00,2008-06-12 22:12:10
8a965b8ee28bedc58641453e13d03f80180320dd...cead78edef6a2f1339f699cd7d656b6834707b94,1,1,1,2,1,2008-06-21 03:19:52,2008-06-20 14:58:15
cead78edef6a2f1339f699cd7d656b6834707b94...f531e463f0471ce41c51e19074a118482f36910f,1,4,2,6,4,2008-06-25 20:55:10,2008-06-25 10:36:50
f531e463f0471ce41c51e19074a118482f36910f...5821988f97b827f6ba81dfeebff932067c88ba6c,2,95,0,95,5,2008-07-02 05:06:38,2008-06-27 07:22:01
fae09a8084c9b51632726523b477a78dd28d7d7e...1d2375ddfee18bd3effd2c1f98527cc2f8b1df0a,3,7,8,15,4,2008-04-08 04:57:43,2008-04-08 04:57:43
6bf4f1b4c9d78b2061bd5f3bf77bb21112b755be...e637122ef2d3911568d7d016f723cdad61730069,1,1,1,2,1,2008-03-16 08:00:40,2008-03-16 07:50:22
e637122ef2d3911568d7d016f723cdad61730069...81d66500c1e47d19c18d643ef074e0475dc90eb1,2,54,1,55,2,2008-03-16 08:01:57,2008-03-16 06:29:28
7c33d3a5116fd72877802288cca6735642bb5d6f...1ca3d6ed01774eab37e96d9c88b840ea618f97af,1,1,1,2,1,2008-02-20 10:47:54,2008-02-20 05:55:07
1ca3d6ed01774eab37e96d9c88b840ea618f97af...fbd538c262b03d7b096e840a7ef0cdd54c5cea4f,1,4,1,5,2,2008-02-20 19:23:58,2008-02-20 11:31:35
fbd538c262b03d7b096e840a7ef0cdd54c5cea4f...5274ba6907cc12d6e6556ff85cb0e4819bd3f730,2,21,5,26,4,2008-02-20 19:31:17,2008-02-20 15:10:17
5274ba6907cc12d6e6556ff85cb0e4819bd3f730...0ca15e7217285edaa6c93b53165e1250d25f030b,1,2,2,4,1,2008-02-21 00:08:48,2008-02-20 22:29:39
f73df331a43a6092af427fd30bb6ce07f313743c...355885d531568e144ce5c9a2f65792a3aa8b5528,4,117,2,119,5,2008-02-26 07:57:34,2008-02-25 21:46:04
355885d531568e144ce5c9a2f65792a3aa8b5528...271b8d25b25e49b367087440e093e755e5f35aa9,1,71,28,99,12,2008-02-26 07:57:34,2008-02-25 21:46:05
271b8d25b25e49b367087440e093e755e5f35aa9...7914053ba9901be1f1530f46e8e2e6ee6f4ae5b1,11,1,166,167,14,2008-02-26 07:57:35,2008-02-25 21:46:06
7914053ba9901be1f1530f46e8e2e6ee6f4ae5b1...45163382437c3862d3beb88134b7a975a3a26443,3,26,1,27,4,2008-02-26 07:57:35,2008-02-25 21:46:07
45163382437c3862d3beb88134b7a975a3a26443...ba002f3b28ab9febea432d4c415dbe581836d9a0,3,257,235,492,23,2008-02-26 07:57:35,2008-02-25 21:46:08
ba002f3b28ab9febea432d4c415dbe581836d9a0...d6ffc8d784d41977397a49ce5333cfe7db1e9c2c,2,31,0,31,2,2008-02-26 07:57:35,2008-02-25 21:46:09
d6ffc8d784d41977397a49ce5333cfe7db1e9c2c...2add1e6db44c81e19cd4263317b53f3c1339e61b,1,23,0,23,4,2008-02-29 05:54:14,2008-02-25 21:46:10
2add1e6db44c81e19cd4263317b53f3c1339e61b...d5ef408b9afb5b4417f4e7e1593a96302d666650,2,106,7,113,16,2008-02-29 05:55:26,2008-02-25 21:46:11
d5ef408b9afb5b4417f4e7e1593a96302d666650...0153be05ae332b8df9bb21d8d249881323e30725,2,90,1,91,9,2008-02-29 05:56:02,2008-02-25 21:46:12
0153be05ae332b8df9bb21d8d249881323e30725...28f72a0f232dfc71b3be726e7e71d0a6d5f9ebba,2,29,13,42,6,2008-02-29 05:56:12,2008-02-25 21:46:13
f0ec47b8e7f46e17e6b6fe1cead728fa24477e43...fe8928e6e802f8519e133f085783fb664f1a0d6b,2,8,0,8,2,2008-04-30 02:56:25,2008-04-26 21:19:06
fe8928e6e802f8519e133f085783fb664f1a0d6b...5f8b9fcd03af09fd7c55407af1f26833728278c2,1,1,0,1,1,2008-04-30 02:56:26,2008-04-27 12:14:58
5f8b9fcd03af09fd7c55407af1f26833728278c2...33c592ddd55faa96d0f425710da5742339796b89,1,66,0,66,1,2008-04-30 02:56:26,2008-04-29 10:56:47
f0ec47b8e7f46e17e6b6fe1cead728fa24477e43...d9c292e8bbd51c84cb9ecd86cb89b8a1b35a2a82,1,4,6,10,4,2008-04-30 00:47:37,2008-04-27 17:32:46
d9c292e8bbd51c84cb9ecd86cb89b8a1b35a2a82...ad1012ebde8be471098b5d476a98a02c76c8e75a,1,4,4,8,1,2008-05-12 23:24:51,2008-05-12 15:12:36
10ce0209b69cebc32d9bfbe78067c752952425cc...dc6282d2013792c0df625527e12a54e40d07b122,1,38,1,39,6,2008-07-14 05:30:35,2008-07-14 05:30:35
182fb4df9120257c2e6b041dd58eef3de5b530d2...cce8d6fdb4d7170a73763586daf6ac4f6b8fce2c,5,46,15,61,19,2008-05-25 20:21:40,2008-05-16 13:03:30
cce8d6fdb4d7170a73763586daf6ac4f6b8fce2c...9aa23094c281d1333eecb6bb1bd84b1599197d68,4,71,21,92,17,2008-05-25 20:22:18,2008-05-25 08:16:05
9aa23094c281d1333eecb6bb1bd84b1599197d68...edc5594153d7246694c1ec5bdb8ccdaa97bf7daf,1,3,4,7,3,2008-05-25 20:23:57,2008-05-25 08:23:55
182fb4df9120257c2e6b041dd58eef3de5b530d2...2ecbd0a0db0f9d59a5df02a6daeb87e611171fa4,1,3,0,3,2,2008-05-25 18:42:44,2008-05-24 02:24:10
2ecbd0a0db0f9d59a5df02a6daeb87e611171fa4...37a75abc985a25a0612c2c176ed35d438722752d,1,44,13,57,11,2008-05-25 18:43:22,2008-05-24 02:24:11
37a75abc985a25a0612c2c176ed35d438722752d...7528f27dd677bed65d758667a621034b853595b4,6,49,41,90,10,2008-05-25 19:06:52,2008-05-25 07:07:21
7528f27dd677bed65d758667a621034b853595b4...3c68d67b572bce7ff41de463e75ee093e9dd71b7,2,67,14,81,7,2008-05-25 19:16:56,2008-05-24 23:02:04
3c68d67b572bce7ff41de463e75ee093e9dd71b7...4603ec0f960e582a7da7241563d3f235ad7f0d3e,2,58,24,82,5,2008-05-25 19:22:24,2008-05-24 23:02:05
6d2c1c2dc064c40f6c723e0a25b5f813732fdaff...377d9c409ffe0f0d994b929aeb94716139207b9d,1,4,0,4,3,2008-05-17 09:39:30,2008-05-07 08:35:55
6d2c1c2dc064c40f6c723e0a25b5f813732fdaff...88f6dbaf99f43053f86474b28beedd91e77c64d9,1,1,1,2,1,2008-05-17 08:46:47,2008-05-17 08:46:47
88f6dbaf99f43053f86474b28beedd91e77c64d9...5c47f4c6e71e6de08348f837f38a446a2f2b0ed7,1,77,56,133,7,2008-05-17 08:51:31,2008-05-17 08:51:31
5c47f4c6e71e6de08348f837f38a446a2f2b0ed7...032bea55a3fda805382398020657f738b8176729,2,61,15,76,2,2008-05-17 09:57:33,2008-05-17 09:02:44
9bd81e4249a419f9cde8fd68e033e263533f4914...f53bc0953feaebe42ba056cbdbe5e91f930134a5,1,48,1,49,10,2008-05-26 01:28:37,2008-05-26 01:28:37
f53bc0953feaebe42ba056cbdbe5e91f930134a5...37869f40a817d4bf81f05cc62d9d39db7a3dc161,1,1,1,2,1,2008-05-26 03:28:58,2008-05-26 03:19:25
37869f40a817d4bf81f05cc62d9d39db7a3dc161...48ded91674604c9756d53a7e657da0196795136f,2,6,3,9,3,2008-05-26 03:29:07,2008-05-26 03:19:30
48ded91674604c9756d53a7e657da0196795136f...97561fff3263add59ec25207a0c5a635b28ce9b9,1,6,8,14,1,2008-05-26 03:29:30,2008-05-26 02:17:57
97561fff3263add59ec25207a0c5a635b28ce9b9...50b7b2ee99cb98265f847d91159cb3215c6f2379,1,1,0,1,1,2008-05-26 03:29:30,2008-05-26 02:18:01
50b7b2ee99cb98265f847d91159cb3215c6f2379...fa620f1ac8191fa72e54b8b6acc3e424ecfae26e,1,1,0,1,1,2008-05-26 03:29:30,2008-05-26 02:18:05
1af8bca79766198c591d8db58f778a98e96627e2...dee2775a29440ca8a52bb5bd09a6de6cd29f69cc,1,4,0,4,1,2008-05-23 06:03:43,2008-05-21 11:44:43
dee2775a29440ca8a52bb5bd09a6de6cd29f69cc...f9189cf8f2427b10a40b5b3e530e2c893bc64ae9,2,23,0,23,2,2008-05-23 06:05:11,2008-05-21 11:32:16
f9189cf8f2427b10a40b5b3e530e2c893bc64ae9...950ce2e22db4a3c1ff9ad598b46ccb22c517a336,3,13,5,18,8,2008-05-23 06:51:22,2008-05-22 12:50:02
950ce2e22db4a3c1ff9ad598b46ccb22c517a336...dd0ffd5b31a672db90d8b775988d55829e6f5f9f,3,18,1,19,6,2008-05-23 23:05:42,2008-05-22 15:24:07
1af8bca79766198c591d8db58f778a98e96627e2...d3aca58562ee5c4af5266affd942c58dcb9f064d,1,43,0,43,1,2008-05-23 05:01:27,2008-05-22 22:38:46
d3aca58562ee5c4af5266affd942c58dcb9f064d...9d0cd91c4e497192e89177847d1511acea5793cd,2,8,10,18,6,2008-05-23 05:16:45,2008-05-22 22:38:59
9d0cd91c4e497192e89177847d1511acea5793cd...ba963de859e76a63d447345eeb3e134116d02433,2,28,12,40,8,2008-05-23 05:24:16,2008-05-22 22:39:22
ba963de859e76a63d447345eeb3e134116d02433...634f246444e6a1675e351f31362e6a375dc44f70,2,45,47,92,12,2008-05-23 05:45:03,2008-05-22 23:28:57
b039f0a62d513226352f9bd745374629f8579b0c...73c4f228504324364348247534ee9b22e55f4751,1,38,25,63,5,2008-01-09 03:12:18,2008-01-09 03:12:18
73c4f228504324364348247534ee9b22e55f4751...9e8ad094bdd4b7b63d277f9a7c7b55e3019a2bab,1,27,27,54,25,2008-01-09 03:13:22,2008-01-09 03:13:22
9e8ad094bdd4b7b63d277f9a7c7b55e3019a2bab...f0c842681936ffd684aac3f0d8340c99780d5b53,1,3,3,6,3,2008-01-09 03:19:47,2008-01-09 03:19:47
7e92e257af910300df297da2269acf2cbef7d6cc...476ca63dbc659a5333c00cdc8993f2085b86a34f,1,33,40,73,30,2008-01-07 11:16:31,2008-01-07 11:16:31
f58dbf23c33e0e79622f4344b48ab5bc9bc360cc...e85dc0a3c7a3f4f8d5aade83fd340b8df73471cd,1,2,1,3,2,2008-04-02 06:40:02,2008-04-01 04:33:09
e85dc0a3c7a3f4f8d5aade83fd340b8df73471cd...4637e47accc43479bd779a354e839f898ecd1b84,1,1,0,1,1,2008-04-02 06:40:06,2008-04-02 03:47:41
4637e47accc43479bd779a354e839f898ecd1b84...69fe5ef6c7211921a2a7840698bf58a80bab9412,1,3,1,4,2,2008-04-02 07:08:30,2008-04-02 06:49:59
69fe5ef6c7211921a2a7840698bf58a80bab9412...64fb19ba636fc9e892119efc377808b86c919228,1,8,7,15,2,2008-04-02 07:13:43,2008-04-02 06:52:37
f58dbf23c33e0e79622f4344b48ab5bc9bc360cc...1bf6551e42c79a594689a356a9b14759d55f3cf5,3,58,6,64,3,2008-03-31 07:22:58,2008-03-26 15:47:09
f58dbf23c33e0e79622f4344b48ab5bc9bc360cc...e0aaf781f656671694a0aa04d8a665bd4d7956e6,2,176,14,190,19,2008-03-31 05:54:09,2008-03-27 16:16:04
e0aaf781f656671694a0aa04d8a665bd4d7956e6...ba26ab99d4c6c6a8f939f44cf2f2c47f6fd4f0a1,2,86,31,117,22,2008-04-01 05:43:34,2008-03-31 23:25:23
5821988f97b827f6ba81dfeebff932067c88ba6c...af894943cb9dbad1d6892dc983dc6ac0fa6ca8e8,1,7,3,10,1,2008-07-08 04:51:04,2008-07-07 16:50:13
af894943cb9dbad1d6892dc983dc6ac0fa6ca8e8...f049e0944d32715ee8893d290d1c52888216fbe4,1,1,0,1,1,2008-07-13 21:58:40,2008-07-12 14:56:59
1d2375ddfee18bd3effd2c1f98527cc2f8b1df0a...bde30540169dd625cbd862ff6f38bc8224ec081c,1,31,0,31,2,2008-04-09 08:31:13,2008-04-02 19:34:38
bde30540169dd625cbd862ff6f38bc8224ec081c...0b85d92661e215915fcca8fcff8953e4762733e2,1,7,0,7,1,2008-04-09 08:31:13,2008-04-02 19:34:55
0b85d92661e215915fcca8fcff8953e4762733e2...f949844263e866774063511c4538b96068dd8d1b,1,36,0,36,1,2008-04-09 08:31:13,2008-04-02 19:35:11
81d66500c1e47d19c18d643ef074e0475dc90eb1...71a5099b647267d509e43f2c41483ca79af49d9f,1,1,1,2,1,2008-03-26 07:09:17,2008-03-24 07:27:28
0ca15e7217285edaa6c93b53165e1250d25f030b...9ea0980a091b16501d143261eed40072030892e8,1,1,1,2,1,2008-02-22 21:39:20,2008-02-22 19:47:27
68951af30c2ac7f74f0d794a8674ac320a84250a...c8af1de9cfa0a5678ae766777e0f905e60b69fda,1,1,1,2,1,2008-04-30 06:11:57,2008-04-24 00:57:48
c8af1de9cfa0a5678ae766777e0f905e60b69fda...59b0c24daaac3c2203dd8ac2de4dfcad909481a5,2,7,2,9,3,2008-04-30 06:11:57,2008-04-24 18:06:36
59b0c24daaac3c2203dd8ac2de4dfcad909481a5...4fe86488e1a550aa058c081c7e67644dd0f7c98e,1,1,1,2,1,2008-04-30 06:11:57,2008-04-23 21:14:30
4fe86488e1a550aa058c081c7e67644dd0f7c98e...97ad535b01f7c4e960298aabe16979ad92f26d4f,1,2,2,4,2,2008-04-30 06:11:57,2008-04-27 11:31:23
97ad535b01f7c4e960298aabe16979ad92f26d4f...9f1915d3935ea6e5e0a5cc38355a2dc30c4a811f,1,6,0,6,1,2008-04-30 06:11:57,2008-04-28 20:58:35
9f1915d3935ea6e5e0a5cc38355a2dc30c4a811f...0104ca09e3abf48ab26fd0599c4b686fcff60ffc,4,8,6,14,5,2008-04-30 06:11:57,2008-04-27 18:21:58
0104ca09e3abf48ab26fd0599c4b686fcff60ffc...302cc11a32732a0a3f0a7875b1857098e1964929,2,15,3,18,3,2008-04-30 06:11:57,2008-04-28 20:09:20
302cc11a32732a0a3f0a7875b1857098e1964929...8d308b35401b6abebb65aa97a322526ae11d7220,2,22,1,23,3,2008-04-30 06:11:57,2008-04-29 20:45:14
dc6282d2013792c0df625527e12a54e40d07b122...34533004b27df4f34e18d9e26832fcc956a39fca,3,28,39,67,20,2008-07-15 14:08:11,2008-07-15 07:49:40
34533004b27df4f34e18d9e26832fcc956a39fca...671f0707212c929533dc6ec9e032faee328e4602,8,28,26,54,22,2008-07-15 14:17:59,2008-07-14 19:22:12
671f0707212c929533dc6ec9e032faee328e4602...d53fe8187c38a5a160ef2199a899d9c47ec881b9,4,8,10,18,10,2008-07-15 14:18:04,2008-07-15 07:49:38
d53fe8187c38a5a160ef2199a899d9c47ec881b9...562e25abea9f1f2d443053279c009a88d81a592b,4,133,154,287,46,2008-07-15 14:18:04,2008-07-14 19:22:24
562e25abea9f1f2d443053279c009a88d81a592b...1d11d5bb85daf38aa1eb6ecd2387dff862181812,2,23,43,66,12,2008-07-15 14:18:04,2008-07-14 19:22:29
1d11d5bb85daf38aa1eb6ecd2387dff862181812...489e351ea03e78746bad0c0ad4fcf4a63920256d,3,17,31,48,12,2008-07-15 14:18:04,2008-07-14 19:22:05
dc6282d2013792c0df625527e12a54e40d07b122...5d5e88af5cfe614be92bf977aa3ea39d2e8a8db8,1,13,13,26,12,2008-07-15 06:35:31,2008-07-10 18:27:30
5d5e88af5cfe614be92bf977aa3ea39d2e8a8db8...dc29bc8bd243fcd20815c7dddc15dbae30747c28,1,27,1,28,2,2008-07-15 06:35:31,2008-07-10 21:01:57
dc29bc8bd243fcd20815c7dddc15dbae30747c28...63c56022f84ae70dd68763b8eed99bccf58fc98b,2,44,4,48,11,2008-07-15 06:35:31,2008-07-14 15:28:04
63c56022f84ae70dd68763b8eed99bccf58fc98b...8f510bef13e6b0c342a49ee90220d568e56a15d7,1,1,1,2,1,2008-07-15 06:35:31,2008-07-14 16:30:24
8f510bef13e6b0c342a49ee90220d568e56a15d7...ec05df353c594f2afc6509831d3ce145856b0b89,3,48,45,93,10,2008-07-15 06:35:31,2008-07-10 01:05:40
ec05df353c594f2afc6509831d3ce145856b0b89...c2f939170c65173076bbd752bb3c764536b3b09b,1,10,0,10,1,2008-07-15 06:35:32,2008-07-10 01:05:41
c2f939170c65173076bbd752bb3c764536b3b09b...25a1f374f0ff23a4d9191436226ab68f3da5e83a,1,20,0,20,3,2008-07-15 06:35:32,2008-07-14 08:21:02
25a1f374f0ff23a4d9191436226ab68f3da5e83a...ac9391093f54370ff3f06470e24d78b536a12327,3,89,4,93,7,2008-07-15 06:35:32,2008-07-15 01:46:48
dc6282d2013792c0df625527e12a54e40d07b122...324c2c3177ca5b62b12029ce8821542fc29a2733,1,1,3,4,1,2008-07-14 21:05:35,2008-07-14 21:05:35
998b912927281a871e8d379e2b3a4385c775c4fe...633f43e1f774337ce1d8b8cf01c5bbe82b086ef6,1,17,27,44,11,2008-05-25 05:05:06,2008-05-23 22:43:55
633f43e1f774337ce1d8b8cf01c5bbe82b086ef6...0b0b8cd7c2c3df72fc3959805b035e55e1bb1270,1,2,0,2,1,2008-05-25 05:13:19,2008-05-22 23:26:09
0b0b8cd7c2c3df72fc3959805b035e55e1bb1270...b27a23e35d8e532e47661595bda642ef3a7375f1,7,87,24,111,20,2008-05-25 05:28:16,2008-05-24 18:56:44
b27a23e35d8e532e47661595bda642ef3a7375f1...509792b94f71f199838fdeaf0801e215213a6d08,1,1,0,1,1,2008-05-25 20:06:49,2008-05-23 18:29:22
509792b94f71f199838fdeaf0801e215213a6d08...a1292939381507be9489451076d49a5b927e9cc4,1,1,1,2,1,2008-05-25 20:06:55,2008-05-25 18:26:50
a1292939381507be9489451076d49a5b927e9cc4...6a491a176593a9ab3bd7ff24ef12323371671112,1,22,0,22,2,2008-05-25 20:07:24,2008-05-25 18:27:44
998b912927281a871e8d379e2b3a4385c775c4fe...3af828634fa5bdbca1b2061a81df8b3fa73b0d34,50,387,387,774,385,2008-05-24 07:01:56,2008-05-24 05:28:56
3af828634fa5bdbca1b2061a81df8b3fa73b0d34...6304c29d518206b0780291a02f94f435abf82d74,3,38,13,51,9,2008-05-24 07:07:38,2008-05-24 01:15:03
6304c29d518206b0780291a02f94f435abf82d74...0569e9b8cea20d5eedfec66730a9711a0907ab0d,8,283,338,621,16,2008-05-24 07:16:39,2008-05-24 05:28:56
0569e9b8cea20d5eedfec66730a9711a0907ab0d...040366076fa0dc540309531997a987cc6d83a577,1,32,7,39,2,2008-05-27 04:54:23,2008-05-27 04:54:23
040366076fa0dc540309531997a987cc6d83a577...b3fde6ccb1cbdd362dec19e317905f71528b3a53,1,7,0,7,1,2008-05-27 05:35:07,2008-05-27 05:35:07
377d9c409ffe0f0d994b929aeb94716139207b9d...ae299be0e5e610027e6492d48d70c1cbb0e9edd8,6,109,1,110,6,2008-05-23 21:11:20,2008-05-20 06:48:54
ae299be0e5e610027e6492d48d70c1cbb0e9edd8...d553e737897e8edbbc2092bf345fc58b2dae5251,5,13,17,30,8,2008-05-23 21:15:01,2008-05-20 06:49:00
d553e737897e8edbbc2092bf345fc58b2dae5251...0454dd93bfb2334355ec62fff670d8c6cb3570a1,8,282,11,293,14,2008-05-23 21:15:01,2008-05-20 06:49:26
0454dd93bfb2334355ec62fff670d8c6cb3570a1...450f437fb0fe276a6e946c281c768118e39dc9e7,1,1,1,2,2,2008-05-23 21:15:01,2008-05-20 06:49:34
377d9c409ffe0f0d994b929aeb94716139207b9d...38ed1d89f759699de56004b08668e1764613f47b,7,57,23,80,23,2008-05-21 19:04:41,2008-05-21 19:04:34
38ed1d89f759699de56004b08668e1764613f47b...205ffa94be8f6492eef4bdaa3315e7fdc7e64e0b,1,5,15,20,5,2008-05-23 21:47:02,2008-05-22 21:59:42
377d9c409ffe0f0d994b929aeb94716139207b9d...8ccba008ee3e0b0582e64cb23ae4ebf734b9f75b,3,52,14,66,15,2008-05-20 02:30:13,2008-05-17 19:03:49
377d9c409ffe0f0d994b929aeb94716139207b9d...2a028a0cabefed8efcf41499e330adfc20f433f8,1,1,1,2,1,2008-05-19 04:39:22,2008-05-18 15:27:00
2a028a0cabefed8efcf41499e330adfc20f433f8...9231e3a953c0780846dacdcf3928f6658fa4fad0,3,3,3,6,3,2008-05-19 04:39:58,2008-05-18 04:03:03
9231e3a953c0780846dacdcf3928f6658fa4fad0...69239728238c8ec6296d94c4cd7490161f4c89b2,1,15,2,17,3,2008-05-20 05:42:29,2008-05-19 22:47:28
69239728238c8ec6296d94c4cd7490161f4c89b2...4be1fe1b944e568f47efcb9d1beb8639f50b723f,1,4,4,8,2,2008-05-21 16:45:53,2008-05-21 16:25:54
8366b7baae7e5a33f609b07c939a3571653a2314...2d3922dc611e4615bc2a8a151f2e382d44971aed,1,2,1,3,2,2008-05-26 05:43:14,2008-05-26 04:14:09
2d3922dc611e4615bc2a8a151f2e382d44971aed...37a12dda24f7ab250869db7eb00157f78d40c724,1,13,5,18,8,2008-05-26 17:43:39,2008-05-26 13:20:54
37a12dda24f7ab250869db7eb00157f78d40c724...d3d20b846891ebca4f4edf4f0ce6ba6fc73878a7,1,1,0,1,1,2008-05-26 21:56:19,2008-05-26 21:56:19
f0c842681936ffd684aac3f0d8340c99780d5b53...66e15a6b83a0b79232377137cc1710343a81aea4,3,140,1,141,3,2008-01-11 08:51:08,2008-01-09 14:31:09
66e15a6b83a0b79232377137cc1710343a81aea4...55e34436e1da167a2abf276e31ef27d3b1e1208b,1,3,3,6,2,2008-01-11 08:51:13,2008-01-09 21:23:18
55e34436e1da167a2abf276e31ef27d3b1e1208b...7d8856d091d3fd098643acb6157dfed376eddaea,1,220,198,418,198,2008-01-11 08:51:13,2008-01-09 21:21:58
6636b88ea127d2dc88b5d5872e29aec35acd2b6e...5be25a8f8560a88145ea31f0ca530393ee2094da,1,6,3,9,5,2008-01-10 10:44:39,2008-01-10 10:44:39
5be25a8f8560a88145ea31f0ca530393ee2094da...17529cf9bc50e8b2bc0ea930a966b8b47056853e,1,1,1,2,1,2008-01-12 10:46:31,2008-01-12 10:46:31
17529cf9bc50e8b2bc0ea930a966b8b47056853e...3e76608d39302add89a8ba4a259eb1bf2583dc10,1,15,20,35,13,2008-01-13 06:26:30,2008-01-13 06:26:30
3e76608d39302add89a8ba4a259eb1bf2583dc10...46308ea1da6794bef1a99b0b1c892c46dec40146,1,4,1,5,4,2008-01-15 11:16:32,2008-01-15 11:16:32
46308ea1da6794bef1a99b0b1c892c46dec40146...e7297a1c5fd1133134e78a775e8b87d7679fb526,1,1,0,1,1,2008-01-15 11:30:40,2008-01-15 11:30:40
e7297a1c5fd1133134e78a775e8b87d7679fb526...5a7f577dcedeff60e5267fd9efbfb05987a359e4,1,1,1,2,1,2008-01-15 11:45:43,2008-01-15 11:45:36
5a7f577dcedeff60e5267fd9efbfb05987a359e4...b8a938cf78026eedafc202716b27986fdacb86e3,1,59,17,76,25,2008-02-13 11:12:31,2008-02-13 11:12:31
b8a938cf78026eedafc202716b27986fdacb86e3...f1bf4ee6d78209a1c45cca1bf3b38252208434d2,1,18,7,25,8,2008-02-16 11:22:22,2008-02-16 06:47:31
f049e0944d32715ee8893d290d1c52888216fbe4...fbc0e7ac1479b4262f6090098a4f68c3438aa94b,1,2,2,4,2,2008-07-17 01:17:27,2008-07-16 20:12:28
fbc0e7ac1479b4262f6090098a4f68c3438aa94b...57cae87b77c93e8bdfd11293f11f140ff827269a,3,16,8,24,5,2008-07-17 02:09:28,2008-07-16 20:43:48
57cae87b77c93e8bdfd11293f11f140ff827269a...e6131d30c21d2c308571078729dc8d2e1b746285,2,26,4,30,4,2008-07-17 02:09:28,2008-07-16 20:48:08
e6131d30c21d2c308571078729dc8d2e1b746285...a01fe996a2f70b759b4d94bd3e9985a01d514ad7,1,69,0,69,2,2008-07-17 02:09:28,2008-07-16 20:51:20
a01fe996a2f70b759b4d94bd3e9985a01d514ad7...15430be5a1d17b888b45b608daab7573f24cf9f1,1,3,3,6,2,2008-07-25 21:58:31,2008-07-24 13:28:53
15430be5a1d17b888b45b608daab7573f24cf9f1...7838d3fb41ed7d738e2cbdf8e4f40f0367f4f46f,1,1,1,2,1,2008-07-25 22:08:33,2008-07-25 22:08:33
7838d3fb41ed7d738e2cbdf8e4f40f0367f4f46f...fa6b5b3944b74f2ad2430f3dfec517f8f70a6663,1,3,0,3,1,2008-07-26 23:43:08,2008-07-15 21:11:00
fa6b5b3944b74f2ad2430f3dfec517f8f70a6663...c7f7457026dc2f6979842f81cc17098579fec8d8,1,58,3,61,7,2008-07-26 23:43:08,2008-07-17 13:21:51
87fb597d4e3643210e1967d1e3035f28f5b019e5...bf11d4613c647184bb081fa600f5c0ab8c0be909,1,2,2,4,2,2008-07-07 08:06:22,2008-07-02 13:29:50
179c94b24ae87e28328f9b311489417b66bd62c9...f59774add488a6c5fb440a4aaa7255f594b1027d,1,13,15,28,4,2008-04-10 07:30:44,2008-04-10 00:03:49
71a5099b647267d509e43f2c41483ca79af49d9f...525d461528880c3ef1d466017b4cbbb0093dd7a5,1,2,2,4,1,2008-03-26 21:26:52,2008-03-26 00:20:52
525d461528880c3ef1d466017b4cbbb0093dd7a5...90b22907f2d1e0b41d7ac5c281ed20e7c8a27c66,2,19,0,19,2,2008-03-27 20:03:51,2008-03-27 05:31:00
71a5099b647267d509e43f2c41483ca79af49d9f...c091b3d415f95d3e4e62acddb084e211af46acbf,5,214,42,256,21,2008-03-26 07:10:55,2008-03-18 02:05:23
c091b3d415f95d3e4e62acddb084e211af46acbf...472fa4cd33c690dd9b338c02af3ed135666aea43,1,22,6,28,5,2008-03-26 07:50:51,2008-03-25 23:35:28
472fa4cd33c690dd9b338c02af3ed135666aea43...a466637c57b969626344e5998b29fb123569fdc2,65,831,7,838,68,2008-03-26 08:29:54,2008-03-26 08:17:07
e4b9c36ca40a0869ee5fc64aaeabaf2655ef595b...3613f9b4c02c3e3d35f4c6c06e40d5c176e7eb6d,1,13,14,27,9,2008-05-04 01:35:37,2008-05-02 19:11:45
3613f9b4c02c3e3d35f4c6c06e40d5c176e7eb6d...a7de713089082005d14679b694fd3999978fb735,1,9,8,17,8,2008-05-04 01:35:37,2008-05-02 19:11:46
a7de713089082005d14679b694fd3999978fb735...bcd7954e217994fafabe5106e56829c8a2cb7e99,1,1,2,3,2,2008-05-04 01:35:38,2008-05-02 19:11:47
bcd7954e217994fafabe5106e56829c8a2cb7e99...2c5ef824637cffa574bdce7149791a9cb520595e,1,33,31,64,16,2008-05-04 01:35:38,2008-05-02 19:11:48
2c5ef824637cffa574bdce7149791a9cb520595e...30ebb40aa1acdccbebe3a04cfb198b2b6f033afc,1,29,24,53,9,2008-05-04 01:35:38,2008-05-02 19:11:49
30ebb40aa1acdccbebe3a04cfb198b2b6f033afc...ed4a9031ea75858d6f8ec387993e8ff731e29d1a,1,36,1,37,4,2008-05-04 01:35:38,2008-05-02 19:11:50
ed4a9031ea75858d6f8ec387993e8ff731e29d1a...70baf5d41a933c7972375ae2583aad8c8b92633f,1,1,1,2,1,2008-05-04 01:35:38,2008-05-02 19:11:51
e4b9c36ca40a0869ee5fc64aaeabaf2655ef595b...abfa533dea28763040beba3e3d908bbbcf818b3a,1,4,2,6,2,2008-05-01 06:02:41,2008-04-29 21:20:32
abfa533dea28763040beba3e3d908bbbcf818b3a...028656552bc758b192027c25a1143f1c6ca66d64,6,13,25,38,16,2008-05-03 18:48:03,2008-04-29 08:32:59
028656552bc758b192027c25a1143f1c6ca66d64...9b58bfe8f4ea130a4518f6fbe9927fef78093f1b,1,3,4,7,2,2008-05-03 18:50:41,2008-04-29 08:33:00
9b58bfe8f4ea130a4518f6fbe9927fef78093f1b...47458bb9d19236175ea679ab070dfc6ae653ec97,1,5,4,9,1,2008-05-03 20:58:59,2008-05-02 03:30:41
3df6499c227c28310b545edc42cdbd713ee0898a...055767194c15f9b7c39a509daf1a77472c77bed8,1,0,54,54,3,2008-07-15 06:37:42,2008-07-15 05:58:06
3beb56bde63d1a10abc02ffe76c1f98d59ec0874...40672a19042e618019cb4f7ba78ae25e554ce756,1,16,0,16,2,2008-05-28 03:56:22,2008-05-25 16:14:29
40672a19042e618019cb4f7ba78ae25e554ce756...cb418b5a3882007616e00bc17b22e8653613ad5f,1,3,3,6,3,2008-05-28 04:29:01,2008-05-27 07:36:22
cb418b5a3882007616e00bc17b22e8653613ad5f...37b78c25476d752953dc541e46fbb6bd5017edf7,1,3,0,3,1,2008-05-28 04:30:16,2008-05-27 14:28:43
4be1fe1b944e568f47efcb9d1beb8639f50b723f...26ec126a9166be39f79e746a3a8c92205c983820,1,7,0,7,2,2008-05-21 18:20:34,2008-05-20 21:59:32
26ec126a9166be39f79e746a3a8c92205c983820...c3170a83d6fee30c5d10afe33d88867ba0b68218,1,1,3,4,3,2008-05-21 19:54:49,2008-05-12 17:22:56
c3170a83d6fee30c5d10afe33d88867ba0b68218...824b5dc29cfe4f58d052d2d9273b39d34bf018e0,1,25,0,25,1,2008-05-21 19:57:18,2008-05-13 04:51:41
824b5dc29cfe4f58d052d2d9273b39d34bf018e0...325abb7b1a5bf47b53e3ae1b585f11ebd6a9fea9,2,12,1,13,4,2008-05-21 20:07:41,2008-05-08 21:26:55
4be1fe1b944e568f47efcb9d1beb8639f50b723f...28f880241782024ecb212f1641c8dc487124523b,1,5,2,7,3,2008-05-21 17:14:51,2008-05-18 14:57:27
7d8856d091d3fd098643acb6157dfed376eddaea...646f3a149d1cc8a6511a433cd2a51987d7582463,1,1,0,1,1,2008-01-13 21:55:04,2008-01-11 12:39:33
585fb5985dcc5c129cb9f095c73dce88c8aacf77...841ea8244913bd8953fdd43e54d9965f02bebae6,1,5,1,6,4,2008-02-17 23:44:33,2008-02-17 23:44:33
841ea8244913bd8953fdd43e54d9965f02bebae6...f806f0fba8ce62f2c74f21419e2bd1e7ce9e565b,1,55,4,59,6,2008-02-24 01:16:56,2008-02-24 01:16:56
f806f0fba8ce62f2c74f21419e2bd1e7ce9e565b...ac1276ab6eaae8e10e409263370dca21b8772359,1,51,54,105,20,2008-03-02 23:11:08,2008-03-02 23:11:08
ac1276ab6eaae8e10e409263370dca21b8772359...468bcaedbb1589f16955e63b6bfba01c2f53e433,1,22,47,69,13,2008-03-02 23:19:35,2008-03-02 23:19:35
468bcaedbb1589f16955e63b6bfba01c2f53e433...f9e0b6fb60581120b62376ca408dcd45d4bf916f,1,5,5,10,5,2008-03-04 10:14:17,2008-03-04 10:14:17
f9e0b6fb60581120b62376ca408dcd45d4bf916f...c9cfdc9601668841a5909facd43aed72e7a8dee5,1,23,22,45,8,2008-03-04 10:32:38,2008-03-04 10:32:38
c9cfdc9601668841a5909facd43aed72e7a8dee5...d76afb15ada0e9e29cae2d83cd35d9489a042b0c,1,4,1,5,2,2008-03-07 10:19:18,2008-03-07 10:19:18
d76afb15ada0e9e29cae2d83cd35d9489a042b0c...c30acc77fec6b7d793af703c4700f5162db82eb7,1,6,3,9,3,2008-03-07 11:51:55,2008-03-07 11:51:55
c7f7457026dc2f6979842f81cc17098579fec8d8...7e09b1531faa260226e0d4f7c850660b7ccb2f04,1,1,0,1,1,2008-07-27 15:08:09,2008-07-27 06:34:21
7e09b1531faa260226e0d4f7c850660b7ccb2f04...25b8fb1e499d0e198e491d10c7023a5f5589e837,1,14,4,18,7,2008-07-27 15:08:10,2008-07-27 06:35:38
25b8fb1e499d0e198e491d10c7023a5f5589e837...79317e5df184773f3211503be49b8836b712facc,1,9,3,12,4,2008-07-30 05:41:23,2008-07-30 05:36:58
79317e5df184773f3211503be49b8836b712facc...f8f1acf339da302ea912c8dd114042a1ef6f994f,1,4,0,4,2,2008-07-30 05:43:37,2008-07-27 21:23:30
f8f1acf339da302ea912c8dd114042a1ef6f994f...f57ddcc5ecf16d1fff4b6e222352c3220fe8120f,1,1,0,1,1,2008-07-30 05:43:37,2008-07-27 16:49:42
f57ddcc5ecf16d1fff4b6e222352c3220fe8120f...5fc6edab76ea16c5fad7138389c2fcc2076534e7,1,7,4,11,1,2008-07-30 05:43:37,2008-07-27 16:49:43
547905f8cd2a04b3e1117f00025b60f81aa60f47...a271b2a9ceb2f65095cf789d2d7c7e44ca5d95f4,1,2,2,4,2,2008-07-15 14:37:00,2008-07-15 00:20:19
a271b2a9ceb2f65095cf789d2d7c7e44ca5d95f4...1e5aaa6db38964fd6ca679864c0a40f7af01cf1a,2,6,5,11,2,2008-07-15 14:37:00,2008-07-14 18:29:37
1e5aaa6db38964fd6ca679864c0a40f7af01cf1a...b526f8ed4de646bb914da43b60322852febde758,2,12,0,12,3,2008-07-15 14:37:00,2008-07-14 18:08:52
b526f8ed4de646bb914da43b60322852febde758...6c11a5fd465eb64301093de8826c38018b474bde,1,17,1,18,5,2008-07-15 14:38:35,2008-07-15 12:55:55
f59774add488a6c5fb440a4aaa7255f594b1027d...b6309ac2b8bc9794f4e8e9e829ccfa3360f2df49,1,1,1,2,1,2008-04-12 00:35:35,2008-04-10 16:05:21
b6309ac2b8bc9794f4e8e9e829ccfa3360f2df49...a68972c2ad7c3de582abeed03f660e19950ed66f,1,1,1,2,1,2008-04-12 00:35:39,2008-04-10 14:45:29
b88605f6d4b2b1b8dd805da9e91feccb68b4c840...24362a5d3ffc5ef10ccbcd80b258a418a1c792b5,1,10,1,11,3,2008-03-27 20:14:20,2008-03-27 20:14:20
471793f91e4bd61bb809045c7088a30ee1305a19...c697ad143ba1ff58b29e7efe149d244d4b7010a5,4,19,35,54,6,2008-05-04 05:15:25,2008-05-03 13:27:26
588c038ac690e012a00dcace34fb318449f5ec7c...e38953ab00bfb150822d2d92d2dc8e4ce31ef9a4,1,22,0,22,1,2008-07-17 00:24:32,2008-07-16 18:44:12
b71ce7f3f13ebd0e212bdda82b012ee36df4f63f...b2a42f55bc419352b848751b0763b0a2d1198479,2,2,2,4,1,2008-05-28 06:12:29,2008-05-28 06:12:29
b2a42f55bc419352b848751b0763b0a2d1198479...d683a0e00cd4734b4fab704baef1ee76205722be,2,4,4,8,4,2008-05-28 06:35:55,2008-05-28 06:33:22
d683a0e00cd4734b4fab704baef1ee76205722be...6eec46bdda7393f1801df70a44d2e0577760a691,1,5,4,9,4,2008-05-28 17:24:32,2008-05-28 16:47:43
6eec46bdda7393f1801df70a44d2e0577760a691...efb98b44536300f5daed25da3650033a1ce7fdef,2,40,3,43,4,2008-05-28 17:47:12,2008-05-28 15:29:36
efb98b44536300f5daed25da3650033a1ce7fdef...823ea1211ca48afc229c84fcc06f66a87fa78303,1,13,16,29,10,2008-05-28 18:47:58,2008-05-28 16:57:02
823ea1211ca48afc229c84fcc06f66a87fa78303...56ae8df5c7b05ee8982c9447fa31116104dc568f,18,19,19,38,19,2008-05-28 23:59:40,2008-05-28 23:55:27
56ae8df5c7b05ee8982c9447fa31116104dc568f...a7052d3521de1210026bf5a29d57c37ee7800166,1,6,0,6,2,2008-05-29 00:03:46,2008-05-29 00:03:46
a7052d3521de1210026bf5a29d57c37ee7800166...d2b3691b61d516a0ad2bf700a2a5d9113ceff0b1,1,5,2,7,4,2008-05-29 00:38:20,2008-05-28 21:48:57
86d72443215612f66f77dfc57ec9613c8153617c...92371226ac5bee99dc926c982f97d9d2280bd954,1,22,8,30,9,2008-07-07 09:19:46,2008-07-07 08:39:28
646f3a149d1cc8a6511a433cd2a51987d7582463...3d2c998e305fdf9f3d9ecc1ecfbfafe4c65020f1,1,39,39,78,1,2008-02-11 23:05:57,2008-01-15 22:31:49
3d2c998e305fdf9f3d9ecc1ecfbfafe4c65020f1...b9b86007e27d9a06d58feab618a5be1d491ed13e,1,13,0,13,6,2008-02-11 23:05:58,2008-01-17 22:42:55
b9b86007e27d9a06d58feab618a5be1d491ed13e...48750d6a84a7fc08dcd7cb4533c280c00106f9b6,1,1,5,6,1,2008-02-11 23:05:59,2008-02-11 10:57:40
48750d6a84a7fc08dcd7cb4533c280c00106f9b6...1407ade93cc1c58d520c2a0f509152ba27b594e8,1,8,7,15,6,2008-02-13 12:08:38,2008-02-09 22:02:07
92e22ca0a22a916a806d801f8d2f5f26bc92ddc4...3ed31a8120ec78c495206c89cf5d421d9198f847,1,114,77,191,36,2008-04-26 06:00:00,2008-04-26 06:00:00
3ed31a8120ec78c495206c89cf5d421d9198f847...ee66e089c1d4162765a3cec79fd5406e515b0db1,1,210,15,225,20,2008-05-09 00:14:07,2008-05-09 00:14:07
392f1300911120fbaa4b77c737fe13e205726aca...35faca1f99b5bb8a729a4e9718f5577432572332,1,1,1,2,1,2008-07-27 21:14:00,2008-07-26 16:50:35
35faca1f99b5bb8a729a4e9718f5577432572332...cbb504c97437653540dc55430a6f64da9ddd24fd,1,9,0,9,1,2008-07-27 21:14:00,2008-07-26 10:26:56
cbb504c97437653540dc55430a6f64da9ddd24fd...6bb9e51b8ef2f397f9f44cfaeaa120ca0cc741e6,2,7,5,12,3,2008-07-27 21:14:00,2008-07-27 11:12:15
6bb9e51b8ef2f397f9f44cfaeaa120ca0cc741e6...1eb7e2f83472f49fda62cefe1d2d9b4c668c6771,1,39,7,46,8,2008-07-27 21:14:01,2008-07-24 00:07:23
1eb7e2f83472f49fda62cefe1d2d9b4c668c6771...77ef80a83e652d65a26213bc276b33051524998f,1,1,1,2,1,2008-07-27 21:14:01,2008-07-26 04:17:42
77ef80a83e652d65a26213bc276b33051524998f...b890fa33a41c0976171d80590286d2bc8bda3df6,1,1,1,2,1,2008-07-27 21:14:01,2008-07-27 04:53:30
b890fa33a41c0976171d80590286d2bc8bda3df6...ef115e26f7d6859f679d122d6c2300db09015396,1,2,1,3,1,2008-07-27 21:14:01,2008-07-26 23:23:46
ef115e26f7d6859f679d122d6c2300db09015396...47c6ef1c8def9a20b4ff40825456b45f5e63b51f,2,64,18,82,14,2008-07-27 21:14:01,2008-07-27 06:15:51
47c6ef1c8def9a20b4ff40825456b45f5e63b51f...2122f8b963d49a59762e121c2da571c2348dcce3,2,34,0,34,3,2008-07-27 21:14:01,2008-07-26 16:37:56
2122f8b963d49a59762e121c2da571c2348dcce3...346d437aab2496872f477bb759db10a43b5dfb5e,1,2,7,9,3,2008-07-27 21:14:01,2008-07-26 10:27:23
346d437aab2496872f477bb759db10a43b5dfb5e...7950cda782fc313569a8a09be0bfab234689627a,1,13,5,18,2,2008-07-27 21:14:01,2008-07-26 10:27:24
7950cda782fc313569a8a09be0bfab234689627a...b6f637d199fed238179865a38f180fccc37ee8cc,1,15,0,15,2,2008-07-27 21:14:01,2008-07-26 10:27:25
b6f637d199fed238179865a38f180fccc37ee8cc...f5d600e2dd8721d7b9177f1c82fe54822d9f1d62,1,10,2,12,5,2008-07-27 21:14:38,2008-07-27 20:34:14
f5d600e2dd8721d7b9177f1c82fe54822d9f1d62...a08c53a119999df5b76e405195fa6c5e7d4b689f,1,2,4,6,2,2008-07-27 21:49:26,2008-07-27 02:33:00
a08c53a119999df5b76e405195fa6c5e7d4b689f...f6c52fe4e871d1d07cb7d86692ccf8cc4de54579,1,7,9,16,1,2008-07-27 22:05:19,2008-07-16 19:11:08
f6c52fe4e871d1d07cb7d86692ccf8cc4de54579...81dc2307d0ad87a4da2e753a9d1b5586d6456eed,4,80,55,135,12,2008-07-27 22:05:19,2008-07-21 00:25:56
81dc2307d0ad87a4da2e753a9d1b5586d6456eed...8e1db3871c767cb17b5e0eeb7bea8d967821a055,1,18,1,19,5,2008-07-27 22:07:56,2008-07-27 19:37:51
8e1db3871c767cb17b5e0eeb7bea8d967821a055...172035f044ebae283f23e95e3ec4d119dc8057cb,2,28,0,28,2,2008-07-28 06:14:03,2008-07-28 06:02:04
172035f044ebae283f23e95e3ec4d119dc8057cb...e84a063da86cbf4382fbfb6f85e75c2ca2a8b9c7,1,1,1,2,1,2008-07-28 20:09:54,2008-07-28 07:02:48
e84a063da86cbf4382fbfb6f85e75c2ca2a8b9c7...1b65f38c06e277a13fd7bf77d3d70df604912c08,1,4,1,5,1,2008-07-28 20:09:54,2008-07-28 07:05:10
1b65f38c06e277a13fd7bf77d3d70df604912c08...7ddea13af24d72deca06a779b1827a8ea2d6cfe6,1,14,4,18,1,2008-07-29 06:01:57,2008-07-28 09:33:33
7ddea13af24d72deca06a779b1827a8ea2d6cfe6...d2761895144b6fabcbe1f3bd40d6c6798914b518,1,5,4,9,2,2008-07-29 06:02:11,2008-07-28 10:48:44
d2761895144b6fabcbe1f3bd40d6c6798914b518...4933e5ebdefdb88841275132ef358e6649963751,2,7,1,8,3,2008-07-29 06:02:11,2008-07-28 05:50:27
4933e5ebdefdb88841275132ef358e6649963751...108ac313f73499572c69b1b80514661b22a2d62e,1,4,7,11,5,2008-07-29 06:02:11,2008-07-28 05:50:28
108ac313f73499572c69b1b80514661b22a2d62e...c297432d0d245af5505e0f5f99a5267119dd421e,1,1,1,2,1,2008-07-29 06:02:11,2008-07-29 05:26:47
c297432d0d245af5505e0f5f99a5267119dd421e...65c35b2256ecbfaebcf04559fe6070807646afff,1,2,0,2,2,2008-07-29 06:02:12,2008-07-29 05:27:39
65c35b2256ecbfaebcf04559fe6070807646afff...df57accb46695b50e2db94424e9d4ebfed0694c8,1,17,9,26,3,2008-07-29 06:02:12,2008-07-29 05:42:53
df57accb46695b50e2db94424e9d4ebfed0694c8...1ce4790bf5eeceb212f003fffcb36069c0ebb45e,6,19,1,20,6,2008-07-29 06:26:25,2008-07-28 06:31:28
5fc6edab76ea16c5fad7138389c2fcc2076534e7...1e5ed425f3438294e63e65822cab869db30e6c7b,1,70,32,102,14,2008-08-02 21:09:41,2008-08-02 07:54:51
1e5ed425f3438294e63e65822cab869db30e6c7b...1be7bf6e337e9d695e2095c3314dc7afa206afe1,1,277,236,513,208,2008-08-02 21:48:33,2008-08-02 21:48:33
1be7bf6e337e9d695e2095c3314dc7afa206afe1...d049f6c27a2244e12041955e262a404c7faba355,1,283,232,515,209,2008-08-02 23:53:15,2008-08-02 23:46:23
d049f6c27a2244e12041955e262a404c7faba355...6b312253cb6e8b21e74882a3ae0972fac1290244,1,281,246,527,209,2008-08-03 20:49:53,2008-08-03 08:01:50
6b312253cb6e8b21e74882a3ae0972fac1290244...7cce5b2cbc12a73eca3f62a885e9dbad17b250a5,1,284,246,530,211,2008-08-03 20:51:26,2008-05-21 14:09:14
7cce5b2cbc12a73eca3f62a885e9dbad17b250a5...fbbdaa5f425417e7fee83f543b1d03806f034cab,1,11,6,17,3,2008-08-03 20:53:42,2008-08-03 11:12:14
fbbdaa5f425417e7fee83f543b1d03806f034cab...9534c9fb31dfe4c5c367042c97a160c42b1eefdf,1,5,1,6,1,2008-08-05 00:38:17,2008-08-04 20:09:46
6c11a5fd465eb64301093de8826c38018b474bde...28ed6e7b321bee3dd7e4aa9c0ff7da64844136f6,15,66,66,132,54,2008-07-16 01:49:28,2008-07-16 01:33:44
6c11a5fd465eb64301093de8826c38018b474bde...eb46328e18688cdc3e0daaffc15c1bfc717c7527,1,19,2,21,6,2008-07-15 23:38:32,2008-07-15 22:05:20
eb46328e18688cdc3e0daaffc15c1bfc717c7527...1617fe9879c96659107b13cc4957a855e838702d,1,11,5,16,6,2008-07-15 23:38:33,2008-07-15 22:00:58
24362a5d3ffc5ef10ccbcd80b258a418a1c792b5...f8dd64fdbf47ac65c1b8d2ed25b789ae2655f8c8,2,1,7,8,2,2008-03-28 03:36:35,2008-03-28 03:36:35
c697ad143ba1ff58b29e7efe149d244d4b7010a5...b335d3f121536733fff3b71d4270c74a9d6e9e91,1,121,0,121,1,2008-05-06 03:55:52,2008-04-23 19:17:43
b335d3f121536733fff3b71d4270c74a9d6e9e91...9cf71b176cb175589c3ea828f7364893cc45b82f,1,22,16,38,4,2008-05-06 03:57:55,2008-04-23 19:17:44
9cf71b176cb175589c3ea828f7364893cc45b82f...4814dbe830baf5a72d8abbbfcc60eeea478b47c2,1,30,12,42,4,2008-05-06 03:57:55,2008-04-23 19:17:45
4814dbe830baf5a72d8abbbfcc60eeea478b47c2...05d5667fec9650b049f47edd8cca23a43b135365,3,163,7,170,14,2008-05-06 04:17:32,2008-04-23 19:17:46
05d5667fec9650b049f47edd8cca23a43b135365...a8128ed62858063e29edc066b14b8b0fa6257cc2,3,117,38,155,31,2008-05-06 04:18:37,2008-04-23 19:17:47
a8128ed62858063e29edc066b14b8b0fa6257cc2...97e435adad0e0bf30e588b2ad7f206a20c734c06,1,0,0,0,0,2008-05-23 19:06:20,2008-05-23 14:19:36
97e435adad0e0bf30e588b2ad7f206a20c734c06...3ea5a1b33d99b6c4f5e745c0dd017307c58cff31,1,93,27,120,1,2008-05-23 19:06:29,2008-05-23 14:19:37
3ea5a1b33d99b6c4f5e745c0dd017307c58cff31...d8ee4832509dd2d7448a49920f5cba2fc979283d,3,80,2,82,13,2008-05-23 19:06:35,2008-05-23 14:19:38
d8ee4832509dd2d7448a49920f5cba2fc979283d...d1a29af98e61de72841657bcaa86a93b38cda1c2,1,56,0,56,3,2008-05-23 19:06:51,2008-05-23 14:19:39
d1a29af98e61de72841657bcaa86a93b38cda1c2...7182530d8cad5ffc396bed5d37f97cfb14b7e599,1,150,2,152,4,2008-05-23 19:06:58,2008-05-23 14:19:40
7182530d8cad5ffc396bed5d37f97cfb14b7e599...ffe256f9bac8a40ff751a9341a5869d98f72c285,1,20,22,42,10,2008-05-23 19:07:05,2008-05-23 14:19:41
ffe256f9bac8a40ff751a9341a5869d98f72c285...15d8e5651948e3914f4b765d7d1dc1bc2f5c4073,1,46,73,119,12,2008-05-23 19:08:38,2008-05-23 14:19:42
15d8e5651948e3914f4b765d7d1dc1bc2f5c4073...6c41e21d48c369f398ee2e24085e618b55ed916d,1,3,3,6,1,2008-05-23 19:08:42,2008-05-23 14:19:43
c697ad143ba1ff58b29e7efe149d244d4b7010a5...885cf808998c4e6d685c669a44f02b37f6965fd9,4,9,7,16,7,2008-05-06 00:38:22,2008-05-04 10:36:52
885cf808998c4e6d685c669a44f02b37f6965fd9...c12172d2eab91b79b8181b04ab5a5332a96e34a8,4,1206,0,1206,5,2008-05-06 00:56:36,2008-05-04 10:36:53
c12172d2eab91b79b8181b04ab5a5332a96e34a8...7fefda5cc7a5faf7962092367bedb321a634d54d,6,161,16,177,31,2008-05-06 01:46:35,2008-05-04 10:36:54
7fefda5cc7a5faf7962092367bedb321a634d54d...0724cb86c51a230090ef12d6bfe17a67351631a8,1,52,14,66,9,2008-05-06 01:55:39,2008-05-05 07:57:03
c697ad143ba1ff58b29e7efe149d244d4b7010a5...62a64d1a6b8d1efad13f3f2e5310dc0e8f2f1dc7,1,4,0,4,1,2008-05-05 23:53:54,2008-05-04 14:55:11
62a64d1a6b8d1efad13f3f2e5310dc0e8f2f1dc7...c4c66b2669113dd7c36d660b5294066d8435bd0f,1,1,1,2,1,2008-05-05 23:54:16,2008-05-04 22:33:09
c4c66b2669113dd7c36d660b5294066d8435bd0f...da060c67ae5653e5bc59196ff3dbedb7f8faa594,1,6,0,6,1,2008-05-05 23:54:16,2008-05-04 22:33:10
da060c67ae5653e5bc59196ff3dbedb7f8faa594...2b3e60c245684fd68bab36c07fee9888ff24f4b4,1,2,1,3,1,2008-05-06 00:30:23,2008-05-05 09:06:49
c697ad143ba1ff58b29e7efe149d244d4b7010a5...97b88dd58cad9d60427af9a956f90f7803f55db8,2,22,13,35,12,2008-05-05 21:17:00,2008-05-04 05:37:51
97b88dd58cad9d60427af9a956f90f7803f55db8...e5c349ba112fc53832c757cef122297718d3a175,2,7,1,8,2,2008-05-05 21:17:00,2008-05-04 05:37:52
e5c349ba112fc53832c757cef122297718d3a175...065096c2b558af80e670299621ff3ddc6839954c,2,7,3,10,4,2008-05-05 21:17:00,2008-05-04 05:37:53
065096c2b558af80e670299621ff3ddc6839954c...02b35660031e1da4036559fb928589ca8c3844bd,1,16,0,16,1,2008-05-05 21:17:01,2008-05-04 05:37:54
02b35660031e1da4036559fb928589ca8c3844bd...7f0475c308625fb9e4cbbad8dc665983571cc5cf,1,1,4,5,1,2008-05-05 21:17:01,2008-05-04 05:37:55
7f0475c308625fb9e4cbbad8dc665983571cc5cf...b480f5cf1a398586d94aecca5d6c9de646837d14,1,1,1,2,1,2008-05-05 21:17:01,2008-05-04 05:37:56
b480f5cf1a398586d94aecca5d6c9de646837d14...cdf3ec01acb8785b8e61ce6e006c9c4c763de663,1,2,1,3,2,2008-05-05 21:17:01,2008-05-04 05:37:57
cdf3ec01acb8785b8e61ce6e006c9c4c763de663...0e46e704626af5189c9c9ff2c0f348d2205c10f3,10,52,39,91,21,2008-05-05 21:17:01,2008-05-04 05:37:58
0e46e704626af5189c9c9ff2c0f348d2205c10f3...f69e836fab2b634281d92a0d304de4d768e479cc,39,475,469,944,297,2008-05-05 21:37:02,2008-05-04 05:37:59
f69e836fab2b634281d92a0d304de4d768e479cc...4a7aaccd83a4f9eca17ca936b7c297e01840f587,3,6,6,12,5,2008-05-05 21:37:51,2008-05-04 05:38:00
c697ad143ba1ff58b29e7efe149d244d4b7010a5...de451dff15a3404e1c7025ebf72c70e624cf2f5c,1,4,0,4,1,2008-05-05 00:42:29,2008-04-16 01:04:16
de451dff15a3404e1c7025ebf72c70e624cf2f5c...6aa9ba14a0259d86eec2077308358caf891c162a,1,13,1,14,6,2008-05-05 00:42:29,2008-04-16 01:04:17
6aa9ba14a0259d86eec2077308358caf891c162a...9e72732e4b4f93ee74ed794abdd381dddb3f280e,1,6,0,6,1,2008-05-05 00:42:29,2008-04-16 01:04:18
9e72732e4b4f93ee74ed794abdd381dddb3f280e...27554e900dd0e2b91b578f2e01c38b3eba746a77,1,70,0,70,1,2008-05-13 00:09:49,2008-05-13 00:09:49
c697ad143ba1ff58b29e7efe149d244d4b7010a5...2d5c298f91b4b76a8b51b9b66283ef5a872736a0,2,10,10,20,9,2008-05-05 00:41:44,2008-04-17 23:32:22
2d5c298f91b4b76a8b51b9b66283ef5a872736a0...ea3cd5c7c63fadacd66c364ae4b8c6d01e5809b1,2,29,0,29,2,2008-05-05 00:41:44,2008-04-17 23:32:26
ea3cd5c7c63fadacd66c364ae4b8c6d01e5809b1...bef70b22ba63d71c1ae2e070e64ff9863ea1ad14,2,13,0,13,2,2008-05-05 00:41:44,2008-04-17 23:32:30
bef70b22ba63d71c1ae2e070e64ff9863ea1ad14...e0aaa29ff324c40a6428d5cc26867392eedf94ad,3,13,8,21,3,2008-05-05 00:41:44,2008-04-17 23:32:35
e0aaa29ff324c40a6428d5cc26867392eedf94ad...e142a3c61d22c3a3c081cb2c693e4d3725c21522,2,27,0,27,4,2008-05-05 00:41:44,2008-04-27 17:39:24
e142a3c61d22c3a3c081cb2c693e4d3725c21522...19757d80e522e9f04c125ad5977c3a79db99b192,2,21,4,25,5,2008-05-05 00:41:44,2008-04-27 17:39:21
19757d80e522e9f04c125ad5977c3a79db99b192...f225aeb278eb1c8c028cd2ff1fdfe7a45067b8e1,2,108,95,203,27,2008-05-05 00:41:45,2008-04-27 17:39:27
f225aeb278eb1c8c028cd2ff1fdfe7a45067b8e1...8434c2f1afedb936e0ea8c07ce25733013c2f743,5,547,1,548,5,2008-05-05 00:41:45,2008-04-27 17:39:30
8434c2f1afedb936e0ea8c07ce25733013c2f743...a73bc1275bb0939c51c496b1d50c516e6314eab2,2,10,0,10,3,2008-05-15 22:05:00,2008-05-15 09:48:25
a73bc1275bb0939c51c496b1d50c516e6314eab2...689ef4d42e1adf409b632ed5c36beda4852a4720,1,1,0,1,1,2008-05-19 04:38:29,2008-05-18 04:00:01
689ef4d42e1adf409b632ed5c36beda4852a4720...fdabc242f465771116e08d1ea3737fdb7453b2f1,1,7,5,12,3,2008-05-21 18:11:58,2008-05-20 18:15:14
fdabc242f465771116e08d1ea3737fdb7453b2f1...4ba776c231f27e69435d76bac98d033db859cd6f,1,8,1,9,3,2008-05-23 06:33:50,2008-05-22 22:03:08
4ba776c231f27e69435d76bac98d033db859cd6f...fabb01996be9f7c8862ab1a6fdfd83c90be5324a,1,21,0,21,1,2008-05-23 06:35:09,2008-05-22 22:03:05
fabb01996be9f7c8862ab1a6fdfd83c90be5324a...b50c8469cc9a336b22ef37b23711d4547a48bc2b,1,5,0,5,1,2008-05-23 06:35:23,2008-05-22 22:03:00
c697ad143ba1ff58b29e7efe149d244d4b7010a5...a83619d692deeb2565335144078465acb2dd1457,6,116,35,151,23,2008-05-05 00:41:39,2008-04-28 15:32:12
c697ad143ba1ff58b29e7efe149d244d4b7010a5...a5af0e2c550e68b15a38f02ae1d3c3416f8cf276,9,28,13,41,12,2008-05-05 00:41:34,2008-05-02 03:30:47
c697ad143ba1ff58b29e7efe149d244d4b7010a5...7c08a2a6370ea70f16addcbad9096b4510a6b467,1,7,0,7,1,2008-05-05 00:41:27,2008-05-02 13:35:33
7c08a2a6370ea70f16addcbad9096b4510a6b467...27bfd950c19c76dce28a8c8693f4ed8603875d26,2,39,1,40,2,2008-05-05 00:41:27,2008-05-02 13:35:34
27bfd950c19c76dce28a8c8693f4ed8603875d26...1392a377219adfee7cc7532e3c60e51d79ab40b1,2,23,4,27,4,2008-05-05 00:41:27,2008-05-04 00:04:42
1392a377219adfee7cc7532e3c60e51d79ab40b1...451244d724f921eca9ffaf526d45c825f7c6f4eb,1,4,4,8,4,2008-05-05 00:41:27,2008-05-04 00:23:46
451244d724f921eca9ffaf526d45c825f7c6f4eb...050288d52dc5dc3f6c7716007c1069dd9f59feb7,2,3,2,5,2,2008-05-05 00:41:27,2008-05-04 00:24:28
d2b3691b61d516a0ad2bf700a2a5d9113ceff0b1...6241360498eb811d4bb130328b1d13241c5e14b6,1,27,28,55,14,2008-06-02 06:25:38,2008-05-29 21:34:50
d2b3691b61d516a0ad2bf700a2a5d9113ceff0b1...6a15bc0d220cf3b139d80326afa0d70411916aed,1,0,3,3,2,2008-06-01 06:54:10,2008-06-01 03:57:48
6a15bc0d220cf3b139d80326afa0d70411916aed...c175a7ad32ee978baaa6524304e9406684bd1286,2,20,19,39,4,2008-06-01 06:55:15,2008-06-01 03:58:05
c175a7ad32ee978baaa6524304e9406684bd1286...7ad2458fadc6cafe25e23affd6cc46cd6494a42d,1,54,14,68,11,2008-06-01 06:55:50,2008-06-01 04:28:04
d2b3691b61d516a0ad2bf700a2a5d9113ceff0b1...1bd9c648408e3dd79882ab4c23af3b791c9e3c21,1,3,1,4,1,2008-06-01 01:32:17,2008-05-31 21:11:21
d2b3691b61d516a0ad2bf700a2a5d9113ceff0b1...5aa965a0c156c6c6d6d38b82c9361a98ba8ed825,1,5,4,9,4,2008-06-01 01:10:58,2008-06-01 01:10:58
d2b3691b61d516a0ad2bf700a2a5d9113ceff0b1...d3a7b8f5c5ed2a073936e09aa80c8a0b0cf10f5c,1,226,0,226,1,2008-05-31 22:42:12,2008-05-31 22:11:42
d3a7b8f5c5ed2a073936e09aa80c8a0b0cf10f5c...8ec00d0534c28763ed07533920daa47baca0d6a6,2,34,72,106,2,2008-05-31 22:42:12,2008-05-31 22:11:43
d2b3691b61d516a0ad2bf700a2a5d9113ceff0b1...4c81b03e30d13dbc93ea7071438ef2da0acd4189,8,24,6,30,13,2008-05-31 21:46:57,2008-05-30 15:42:16
4c81b03e30d13dbc93ea7071438ef2da0acd4189...54352bb2742cfbe53fa820eab53607a46d349ae4,4,4,6,10,4,2008-05-31 21:49:29,2008-05-30 15:54:46
d2b3691b61d516a0ad2bf700a2a5d9113ceff0b1...b7f685a754fc7ad313ecf7ad717f3ce35195ff33,1,7,4,11,1,2008-05-31 20:09:39,2008-05-30 11:14:24
b7f685a754fc7ad313ecf7ad717f3ce35195ff33...aa9349d449bbf6bd7d28a5279f30a9734f77da8f,1,9,0,9,1,2008-05-31 21:18:20,2008-05-30 12:38:35
aa9349d449bbf6bd7d28a5279f30a9734f77da8f...6ab69bf253848d641fb08348eca10b7cf79fd275,3,0,12,12,3,2008-05-31 21:18:40,2008-05-31 18:28:18
6ab69bf253848d641fb08348eca10b7cf79fd275...c16570c42a748a29031281badd4762dd4e71d3d0,1,59,1,60,2,2008-05-31 21:32:56,2008-05-31 00:18:08
c16570c42a748a29031281badd4762dd4e71d3d0...ad5fa3cc0e115a8b111868af2f727322feb144cb,3,18,0,18,3,2008-05-31 21:33:59,2008-05-29 14:55:53
ad5fa3cc0e115a8b111868af2f727322feb144cb...5812473335161e3d8e5a1e085c5894a247472bdb,2,63,34,97,15,2008-05-31 21:46:24,2008-05-29 17:32:31
5812473335161e3d8e5a1e085c5894a247472bdb...d72ab8c8921f74b64be029235d4d2cdd9dcb87b9,1,1,2,3,2,2008-06-01 21:29:50,2008-05-17 15:07:09
d72ab8c8921f74b64be029235d4d2cdd9dcb87b9...7d45e1468331e6253d087e77d9082026320410f5,2,12,2,14,5,2008-06-01 21:29:50,2008-05-20 03:29:17
7d45e1468331e6253d087e77d9082026320410f5...b7166cce8cf4053d9f21e69505bef8699da68903,1,1,1,2,1,2008-06-01 21:29:50,2008-05-27 08:46:55
b7166cce8cf4053d9f21e69505bef8699da68903...3395908ee481e91bbe3ba054a7419b071b09cdef,1,93,17,110,22,2008-06-01 21:50:52,2008-06-01 20:56:57
3395908ee481e91bbe3ba054a7419b071b09cdef...f1979d6b3fba41fb6ca92290bf8e10d58ede8970,1,8,5,13,3,2008-06-02 04:44:47,2008-06-01 20:56:58
f1979d6b3fba41fb6ca92290bf8e10d58ede8970...58c8dd217384b8d1a464a55a98c665ed108c6b15,1,2,3,5,1,2008-06-02 05:21:05,2008-06-01 20:26:25
58c8dd217384b8d1a464a55a98c665ed108c6b15...497c83314c1a595ef26dd4ea452022b0848d3219,9,75,20,95,20,2008-06-02 05:23:10,2008-05-29 17:21:46
497c83314c1a595ef26dd4ea452022b0848d3219...850d3a7c05b4678af21b126ad30bc60510745ef1,1,7,7,14,3,2008-06-02 05:26:37,2008-06-01 18:15:33
850d3a7c05b4678af21b126ad30bc60510745ef1...32d8050a86f8de0253430b12711354e66a317f29,1,1,1,2,1,2008-06-02 05:28:27,2008-06-01 20:34:47
d2b3691b61d516a0ad2bf700a2a5d9113ceff0b1...74d3b23fe3771c769ccd5c97f6a46682b4061577,3,24,3,27,5,2008-05-29 01:31:19,2008-05-28 18:53:57
d2b3691b61d516a0ad2bf700a2a5d9113ceff0b1...84a5750bc5e5211bd06857e4edb08e332d0e7adf,1,6,3,9,3,2008-05-29 00:38:21,2008-05-28 21:54:02
84a5750bc5e5211bd06857e4edb08e332d0e7adf...6286a08db3d1e718f4be6959d0f380215026800b,1,15,35,50,9,2008-05-30 00:35:10,2008-05-28 21:59:40
6286a08db3d1e718f4be6959d0f380215026800b...2e2b887d1c2c2385825160e587d711ecb5935ef5,1,7,3,10,4,2008-05-30 00:35:21,2008-05-28 22:12:30
2e2b887d1c2c2385825160e587d711ecb5935ef5...291d823e364cb51cab67f0786b809fe038b92aa8,1,18,4,22,5,2008-05-30 00:35:22,2008-05-28 22:26:59
1407ade93cc1c58d520c2a0f509152ba27b594e8...6675ea4240540e3ee3b0dd2f26b1ad86121d22c6,1,2,1,3,2,2008-02-13 23:49:44,2008-02-13 16:27:30
e8a0c69b91747c2934f6ede4fef174b85b59aede...6df7403a98737026daeb77cf5a75e2a491aeac70,1,28,39,67,12,2008-05-11 12:13:02,2008-05-11 12:13:02
6df7403a98737026daeb77cf5a75e2a491aeac70...08ba820fd7d82cd798d271a9ef6caaf83ffed387,1,31,10,41,7,2008-05-12 00:18:38,2008-05-12 00:18:38
1ce4790bf5eeceb212f003fffcb36069c0ebb45e...4fac1d3a98bb86d855b706d7ce6a5069b9f687e8,1,68,42,110,10,2008-07-30 07:15:14,2008-07-25 10:41:26
1ce4790bf5eeceb212f003fffcb36069c0ebb45e...940208a771066229bc6a486f6a058e332b71cfe4,3,63,38,101,24,2008-07-30 06:21:36,2008-07-29 23:16:58
940208a771066229bc6a486f6a058e332b71cfe4...87091b495e8af0daf317c0d0e08ac3ead74a0bb9,1,35,7,42,3,2008-07-30 06:21:36,2008-07-29 23:16:59
87091b495e8af0daf317c0d0e08ac3ead74a0bb9...1b1d78fe77d676bb79a9272ff6f3517697811990,1,46,0,46,1,2008-07-30 06:21:36,2008-07-29 23:17:00
1b1d78fe77d676bb79a9272ff6f3517697811990...dce61e728b89611109e76cbc9fa897fe49d7869d,1,4,0,4,1,2008-07-30 06:21:36,2008-07-29 23:17:01
dce61e728b89611109e76cbc9fa897fe49d7869d...6e4a86d2ed2d798c5462e5e324fefb8614be52a8,1,1,1,2,2,2008-07-31 04:38:18,2008-07-30 22:38:07
6e4a86d2ed2d798c5462e5e324fefb8614be52a8...3d78d1f18f211fd3d3e95977dee85a17a2aeb16c,4,470,465,935,11,2008-08-03 01:06:37,2008-08-02 08:08:38
3d78d1f18f211fd3d3e95977dee85a17a2aeb16c...13613eac5bf886b37cc583462999419f91c98a17,1,1,0,1,1,2008-08-14 06:46:03,2008-08-13 21:32:43
13613eac5bf886b37cc583462999419f91c98a17...131f9a108bba5a8b0bcba072696653ab3199911a,1,11,3,14,1,2008-08-21 05:57:55,2008-08-21 05:07:55
131f9a108bba5a8b0bcba072696653ab3199911a...e596cdddf349b244dca854bf5a7aa9428b48fc50,1,5,2,7,4,2008-08-24 02:23:22,2008-08-24 02:23:22
1ce4790bf5eeceb212f003fffcb36069c0ebb45e...a56bf5850a07e9119cd7e53de1465af432642ef8,1,4,4,8,3,2008-07-30 06:18:04,2008-07-29 19:53:16
a56bf5850a07e9119cd7e53de1465af432642ef8...2c9693bda5f5c726847b4763dd6f82cfdca3e8d7,1,9,8,17,3,2008-07-30 06:18:04,2008-07-29 23:13:38
2c9693bda5f5c726847b4763dd6f82cfdca3e8d7...8cb070a4cfea48f88ada02a87320c3ca63b934cb,1,12,14,26,5,2008-07-30 06:18:04,2008-07-30 01:16:01
8cb070a4cfea48f88ada02a87320c3ca63b934cb...6b2fbaaffc5ec762eae5d23b58b1dc0a88e2275e,10,34,3,37,19,2008-07-30 06:18:15,2008-07-30 05:49:33
6b2fbaaffc5ec762eae5d23b58b1dc0a88e2275e...ae7c5dcef92d46cfc8987fde2c264614fe475bd1,3,81,2,83,6,2008-07-30 06:57:51,2008-07-26 20:52:54
ae7c5dcef92d46cfc8987fde2c264614fe475bd1...bd2574ca69331d33429f8806ce189b2941e490e7,2,5,3,8,5,2008-07-30 07:00:02,2008-07-29 20:12:22
bd2574ca69331d33429f8806ce189b2941e490e7...c70115b4b1a8c197b9b829b1fd15d578a3ffcdc3,1,22,5,27,5,2008-07-30 07:09:22,2008-07-29 08:13:44
1ce4790bf5eeceb212f003fffcb36069c0ebb45e...53eda89b2fe13e974ca85367255f9a5e9ab9171f,2,17,8,25,8,2008-07-30 06:17:35,2008-07-30 05:04:14
53eda89b2fe13e974ca85367255f9a5e9ab9171f...99f1c04be09d73a40ef0a37c6868969d40391196,1,66,11,77,4,2008-07-30 06:17:35,2008-07-30 05:04:43
99f1c04be09d73a40ef0a37c6868969d40391196...a7a66921772ca5e609d283b0b73b8dd446a2a506,1,48,0,48,1,2008-07-30 06:51:41,2008-07-30 06:51:41
a7a66921772ca5e609d283b0b73b8dd446a2a506...c5dc9a28298afb75d2be6b212d420fc89c258aa0,1,2,9,11,2,2008-07-30 07:20:51,2008-07-27 20:47:22
9534c9fb31dfe4c5c367042c97a160c42b1eefdf...1c1fe1005c9dacc05a34eb892ae20ebb1904a33b,1,1,1,2,1,2008-08-10 07:02:08,2008-08-10 07:02:08
731ab1f55e7ba736b24708a63e93a7c8d581a4d6...81b237d5db946b4196225712a37639952787c959,1,3,2,5,1,2008-07-30 07:19:22,2008-07-27 00:46:00
81b237d5db946b4196225712a37639952787c959...9b6bf4d575e216db9240907940e9f6c619877735,1,2,2,4,2,2008-07-30 08:13:26,2008-07-30 08:12:19
9b6bf4d575e216db9240907940e9f6c619877735...5354a56fe70420c147f930e0f7f1decbae685d19,7,9,9,18,8,2008-07-30 18:42:01,2008-07-30 17:48:33
5354a56fe70420c147f930e0f7f1decbae685d19...c4aca9ccda51badb672ab70099863072d1567267,2,15,4,19,12,2008-07-30 19:53:45,2008-07-30 19:53:45
c4aca9ccda51badb672ab70099863072d1567267...0e25790f1d9cbbcac5dc6fbcea3096c3590f45d7,1,21,6,27,3,2008-07-31 04:42:20,2008-07-31 03:22:40
0e25790f1d9cbbcac5dc6fbcea3096c3590f45d7...f448e24e2fe336621306b04b84e947bdd04f7ecc,11,20,20,40,14,2008-07-31 04:42:55,2008-07-30 09:33:43
f448e24e2fe336621306b04b84e947bdd04f7ecc...fdc7c81111a2ca8d97b8b45e260d7a4e737c8766,2,17,13,30,8,2008-07-31 18:20:13,2008-07-31 07:36:09
fdc7c81111a2ca8d97b8b45e260d7a4e737c8766...b3123f9802989d9c8184e2265a6176a6f5aeed71,1,4,0,4,1,2008-07-31 18:22:12,2008-07-31 07:05:22
b3123f9802989d9c8184e2265a6176a6f5aeed71...0fe8c1381043ef64fce1b8372df19046a4b1518e,1,1,1,2,1,2008-07-31 18:35:17,2008-07-31 10:22:23
d6d96f835cace1c108100cf88e216a59debcb937...60e3aba9c3c99c40826c051d384e785935874962,2,5,5,10,4,2008-04-12 22:41:24,2008-04-12 19:32:00
60e3aba9c3c99c40826c051d384e785935874962...51836e9e125f67aa26724154757b4734c08057e4,1,1,1,2,1,2008-04-13 01:34:39,2008-04-13 01:34:39
51836e9e125f67aa26724154757b4734c08057e4...02604e293a3b7d48b0ce4e34149de8dc89c674e5,1,1,1,2,1,2008-04-13 01:57:08,2008-04-13 01:57:08
f8dd64fdbf47ac65c1b8d2ed25b789ae2655f8c8...ee5a317e0130ab2db59db97c644576335530512d,2,29,13,42,4,2008-04-07 02:21:45,2008-04-07 02:21:45
1f8dc671557a7330eaee9c0296bfad669d26a1b8...57cbf72e87fb7ebd29e8758fe47bd57b97c5ab0f,1,13,6,19,7,2008-07-17 01:34:19,2008-07-17 01:34:19
57cbf72e87fb7ebd29e8758fe47bd57b97c5ab0f...3bf0dd1f4e75ee1591169b687ce04dff00ae2e3e,1,1,1,2,1,2008-07-17 01:48:58,2008-07-17 01:48:58
3bf0dd1f4e75ee1591169b687ce04dff00ae2e3e...1e102bf7c83281944ffd9202a7d35c514e4a5644,1,3,4,7,1,2008-07-17 05:42:04,2008-07-17 05:42:04
1e102bf7c83281944ffd9202a7d35c514e4a5644...1b76ead0044c865cc005ea2d8d2aeec526632810,1,3,1,4,1,2008-07-17 18:19:39,2008-07-17 17:01:30
1b76ead0044c865cc005ea2d8d2aeec526632810...72972eb3749daecf328badbc1c1952cb513f34f9,1,19,32,51,10,2008-07-18 05:13:19,2008-07-18 04:30:33
72972eb3749daecf328badbc1c1952cb513f34f9...bb3e4f03be815067814624b1e0b2f6de054519cd,1,4,4,8,4,2008-07-19 18:17:42,2008-07-18 06:18:43
bb3e4f03be815067814624b1e0b2f6de054519cd...78568448239ea09c8a78b72741863be1148c4660,1,3,0,3,1,2008-07-19 18:17:42,2008-07-18 01:04:30
78568448239ea09c8a78b72741863be1148c4660...374488f31d70e6f009abf533a1c0a8077301f18d,1,1,0,1,1,2008-07-19 18:17:42,2008-07-17 17:00:26
374488f31d70e6f009abf533a1c0a8077301f18d...b20171ebf7df3c31cce5cde3efaaf257b4ac2447,1,8,14,22,2,2008-07-19 18:17:43,2008-07-17 17:00:27
b20171ebf7df3c31cce5cde3efaaf257b4ac2447...89a9167fac209649116a6e1b7a39b4f4c974f86b,1,12,0,12,1,2008-07-19 18:17:43,2008-07-17 17:00:29
89a9167fac209649116a6e1b7a39b4f4c974f86b...42f7a2dae8dfb858cce4a685e8e8506d77cbd1cb,1,11,0,11,1,2008-07-19 18:17:43,2008-07-17 17:00:30
42f7a2dae8dfb858cce4a685e8e8506d77cbd1cb...fe77b6959c47e1eaec0c96599b2c5ce7907707ec,1,2,1,3,1,2008-07-19 18:17:43,2008-07-18 07:34:42
fe77b6959c47e1eaec0c96599b2c5ce7907707ec...b8c5db35fc23913d72c52d990d399b8ef66b646f,1,32,29,61,1,2008-07-19 18:17:43,2008-07-19 09:32:45
b8c5db35fc23913d72c52d990d399b8ef66b646f...c09df8a74e8b5e106ad853cbb1e52f36b3663386,3,357,1,358,3,2008-07-19 18:17:43,2008-07-18 07:34:44
c09df8a74e8b5e106ad853cbb1e52f36b3663386...c47f10246ac6413ac6902bd70e45492174fac873,1,47,22,69,2,2008-07-19 18:17:43,2008-07-18 13:40:41
c47f10246ac6413ac6902bd70e45492174fac873...6259ac6628477aa5ebde9bd9e8daaeecca2a74ae,2,17,2,19,3,2008-07-19 18:17:43,2008-07-18 14:11:07
6259ac6628477aa5ebde9bd9e8daaeecca2a74ae...3a176c6cde650f8907b2dbafafb72f6375038613,3,8,5,13,7,2008-07-19 18:17:43,2008-07-18 14:30:32
3a176c6cde650f8907b2dbafafb72f6375038613...8575ea559ec4f0ea8b292bca7b262f221c5aa122,3,0,9,9,5,2008-07-19 18:17:43,2008-07-18 14:30:47
8575ea559ec4f0ea8b292bca7b262f221c5aa122...c0be8aa06b85f3f18fd4c49dfbda14c2943ccda7,1,29,47,76,3,2008-07-19 18:25:27,2008-07-19 18:17:22
c0be8aa06b85f3f18fd4c49dfbda14c2943ccda7...4a3fedd5976ae9175cc418876d17ca568278b426,1,9,0,9,8,2008-07-19 18:25:51,2008-07-19 06:24:26
4a3fedd5976ae9175cc418876d17ca568278b426...03db4525d38119f7778d6e9117f27c47db8466d4,5,227,5,232,8,2008-07-19 18:25:51,2008-07-19 12:21:24
06f60e8edf1eb3a91e1af6f255bf46154168dd86...973a70ea4d9fc98e9ed20c261c5f6c8f1c1df2b0,1,19,15,34,6,2008-06-03 05:45:48,2008-06-02 23:34:48
973a70ea4d9fc98e9ed20c261c5f6c8f1c1df2b0...3fe8dce6fc5b1d0bffba8fdb4e075fcd16cf5619,3,12,4,16,5,2008-06-03 05:52:39,2008-06-02 23:34:53
06f60e8edf1eb3a91e1af6f255bf46154168dd86...3db4723ead0f141540118f622dedac5106b07a8e,1,7,4,11,2,2008-06-03 02:07:12,2008-06-02 22:41:44
3db4723ead0f141540118f622dedac5106b07a8e...f70dda250e33dd17f6fdff17d15287391d8b0952,1,5,8,13,4,2008-06-03 03:36:02,2008-06-02 09:54:41
f70dda250e33dd17f6fdff17d15287391d8b0952...c5833f6e1373e4e6a2c31a0cb6cd9050dc395643,1,1,1,2,1,2008-06-03 03:36:09,2008-05-30 21:43:40
c5833f6e1373e4e6a2c31a0cb6cd9050dc395643...69e66f5500ef6079e3374a6654ef1f6df0c6f360,1,3,4,7,3,2008-06-03 03:36:14,2008-06-02 14:01:40
69e66f5500ef6079e3374a6654ef1f6df0c6f360...67bfc030d7b27c007853776e8028598bdfa2cae0,2,23,0,23,3,2008-06-03 06:55:57,2008-06-03 05:17:42
67bfc030d7b27c007853776e8028598bdfa2cae0...02c17196e323d64b2062eb90b661ff3c65de1a07,1,5,1,6,3,2008-06-03 07:17:22,2008-06-03 07:17:22
02c17196e323d64b2062eb90b661ff3c65de1a07...422b206342047c9290362caeaa10cddbe3f9a23e,1,1,0,1,1,2008-06-03 19:40:12,2008-06-03 18:34:17
422b206342047c9290362caeaa10cddbe3f9a23e...7845944c64de11d87e3b33ed7fa0a0a4b00fa435,1,6,3,9,2,2008-06-04 01:08:08,2008-06-04 01:08:08
7845944c64de11d87e3b33ed7fa0a0a4b00fa435...a3c91e088ead7c47f43efe8da625d190dcef1001,1,18,17,35,1,2008-06-04 01:13:33,2008-06-04 01:10:08
a3c91e088ead7c47f43efe8da625d190dcef1001...70ca472f1f6745563b55cac9aa38bb58f83112ef,1,1,1,2,1,2008-06-04 05:12:08,2008-06-03 22:16:26
70ca472f1f6745563b55cac9aa38bb58f83112ef...adf60f1440aa166615711f5c2ae262db79ba6eb2,1,6,0,6,6,2008-06-04 06:56:56,2008-06-04 06:56:56
adf60f1440aa166615711f5c2ae262db79ba6eb2...de5825cc829a5d535de726eb7e5af45c0a3b88ce,1,3,3,6,2,2008-06-04 19:11:59,2008-06-04 19:10:01
2c95fcf4f92c5d350852ef14aa5140bbe41005b3...e67c9e3952a60dbf380cead5dae1d13fe9703f3c,2,46,6,52,4,2008-07-07 23:35:00,2008-07-07 22:07:53
6675ea4240540e3ee3b0dd2f26b1ad86121d22c6...b9bee11526ec23541ddbbd75716bfd1acc241463,1,10,2,12,2,2008-03-10 05:50:34,2008-03-10 05:50:34
b9bee11526ec23541ddbbd75716bfd1acc241463...2d48085661e3f522904a10603e303dbec046a56f,1,40,10,50,21,2008-03-10 06:39:46,2008-02-21 20:23:31
2d48085661e3f522904a10603e303dbec046a56f...a3a1f57959c38d5034f17b4f5d06ea3eb1a378e9,1,1,1,2,1,2008-03-10 06:40:51,2008-03-03 20:12:47
a3a1f57959c38d5034f17b4f5d06ea3eb1a378e9...95293b58eb2ac31f93266f9e86ea17c0999d75c9,1,14,3,17,7,2008-03-10 06:42:23,2008-03-06 11:49:25
95293b58eb2ac31f93266f9e86ea17c0999d75c9...8809d691ec03f6cb60cb01c8bf00441600d6e757,1,14,6,20,6,2008-03-10 06:42:26,2008-03-08 12:27:23
8809d691ec03f6cb60cb01c8bf00441600d6e757...cb8329aa9a6cc2e009d552b1180ce107cec4eb9d,1,6,1,7,4,2008-03-11 09:22:39,2008-03-10 10:54:56
cb8329aa9a6cc2e009d552b1180ce107cec4eb9d...494d3b8a6c93d88daf4a52dbcc6ab07903f8ed4e,1,1,3,4,2,2008-03-11 11:11:19,2008-03-11 11:11:19
08ba820fd7d82cd798d271a9ef6caaf83ffed387...94503a66c56c935e77a8fbe3622f1f56b7134ccc,1,4,0,4,2,2008-05-18 23:48:45,2008-05-18 23:48:45
94503a66c56c935e77a8fbe3622f1f56b7134ccc...64dc208c117d6a2e97176342969637e5daba6b8d,1,0,0,0,0,2008-05-18 23:49:15,2008-05-17 17:16:31
64dc208c117d6a2e97176342969637e5daba6b8d...94b4a69f758131a6282363e1717235a03c3885ef,1,23,23,46,23,2008-05-20 10:51:06,2008-05-20 10:51:06
94b4a69f758131a6282363e1717235a03c3885ef...a977953326b5bc9556f2648a7327c623e676aaca,1,3,1,4,2,2008-05-22 11:12:19,2008-05-22 11:12:19
a1184d85e8752658f02746982822f43f32316803...8af84dadb142f7321ff0ce8690385e99da8ede2f,7,133,4,137,12,2008-08-31 17:14:58,2008-08-31 13:50:23
8af84dadb142f7321ff0ce8690385e99da8ede2f...f0e90716d47b429284702b75425a247c9fc41adb,2,27,1,28,5,2008-08-31 17:15:13,2008-08-31 13:54:58
a1184d85e8752658f02746982822f43f32316803...1b0f7978ddb9e2ed4437ce68a4b82ab831288a41,1,1,1,2,1,2008-08-29 03:39:43,2008-08-28 08:57:55
1b0f7978ddb9e2ed4437ce68a4b82ab831288a41...63e8aea74e992bd8667e35a0e646110acc1f0d7c,3,10,16,26,11,2008-08-29 04:49:51,2008-08-28 22:47:22
63e8aea74e992bd8667e35a0e646110acc1f0d7c...e321180ed3e22120e30bb350a5adecbe959e1241,4,24,28,52,20,2008-08-29 04:49:55,2008-08-28 17:15:33
e321180ed3e22120e30bb350a5adecbe959e1241...b9f62c0e7d60905d20de552280f91441300197c0,1,0,2,2,1,2008-08-29 04:50:32,2008-08-28 17:17:13
b9f62c0e7d60905d20de552280f91441300197c0...c7371e992b1aa147b640759a7fa89e722e6db8dc,1,1,1,2,1,2008-08-29 04:51:04,2008-08-28 17:17:46
c7371e992b1aa147b640759a7fa89e722e6db8dc...1f08e5ce2435f1d5c78a31c0a783d5bb177cd657,1,20,23,43,7,2008-08-29 04:51:28,2008-08-28 17:19:07
1f08e5ce2435f1d5c78a31c0a783d5bb177cd657...61c5d431deb0437b35c18d268c1957eefd1f4b91,1,1,1,2,2,2008-08-29 04:51:34,2008-08-28 17:19:42
61c5d431deb0437b35c18d268c1957eefd1f4b91...e990501312e22cfa910d88dc7143bc4eb3632ae1,1,6,2,8,1,2008-08-29 07:15:47,2008-08-27 22:36:12
a1184d85e8752658f02746982822f43f32316803...f821d0892173e4e46a71fef4d06995f7a81c9296,2,192,25,217,11,2008-08-28 01:08:04,2008-08-22 03:52:22
f821d0892173e4e46a71fef4d06995f7a81c9296...c9c4e2d5a25bbf637780f9b83e74c2a26fb957f5,2,58,14,72,12,2008-08-28 01:08:06,2008-08-22 03:52:29
c9c4e2d5a25bbf637780f9b83e74c2a26fb957f5...6a54d976f654ef15ce6db7d52c76677dfdd0de6c,1,27,5,32,8,2008-09-06 05:31:43,2008-09-06 05:27:03
1c1fe1005c9dacc05a34eb892ae20ebb1904a33b...186f8aa9082dda98bcd7b56f78d7f859966cd605,1,127,126,253,123,2008-08-13 02:50:03,2008-08-11 21:19:16
186f8aa9082dda98bcd7b56f78d7f859966cd605...f2816b3d34ef93553b14a5fe23c48d092a74901f,1,299,254,553,217,2008-08-13 02:50:03,2008-08-11 21:19:17
2b603260f325b895baa20867bd45c8e251f19b78...43df4f86e035056605ceb757029181d7ddee1e7e,3,41,52,93,18,2008-08-03 20:14:35,2008-08-03 04:39:16
43df4f86e035056605ceb757029181d7ddee1e7e...81014073f22736e9dcb9370475af44e67234622f,1,4,4,8,3,2008-08-03 20:22:57,2008-08-03 14:36:18
81014073f22736e9dcb9370475af44e67234622f...9ae8e008abf2e05dee59142fae068ae1f9004147,2,5,2,7,2,2008-08-03 20:23:15,2008-08-03 14:36:19
9ae8e008abf2e05dee59142fae068ae1f9004147...548601adcc638d96486e0f2a3dd399d4ca215eca,1,53,69,122,8,2008-08-03 20:23:54,2008-08-03 14:36:20
548601adcc638d96486e0f2a3dd399d4ca215eca...39702431500b76425f047209c9e9b2aae7e92b00,3,48,7,55,14,2008-08-03 20:33:06,2008-08-03 14:36:21
39702431500b76425f047209c9e9b2aae7e92b00...4a3d85dcf6722b7e5d16b5b1f69b51e39ad5f1dc,3,44,5,49,10,2008-08-03 20:38:22,2008-08-03 14:36:22
2b603260f325b895baa20867bd45c8e251f19b78...60d30b02fc188da269da094df8bc67139ad6eb04,1,1,1,2,1,2008-08-02 07:33:14,2008-08-01 05:17:13
60d30b02fc188da269da094df8bc67139ad6eb04...6546b5931e5608dfdcd3e4fbf9ebc90ee0982b56,3,160,22,182,7,2008-08-02 07:33:15,2008-07-31 08:17:41
6546b5931e5608dfdcd3e4fbf9ebc90ee0982b56...65347030590bcc251a9ff2ed96487a0f1b9e9fa8,2,95,3,98,3,2008-08-04 00:47:16,2008-08-04 00:47:16
02604e293a3b7d48b0ce4e34149de8dc89c674e5...f669ac0be901e19a8948c9b04af63d23ebae8003,1,2,1,3,1,2008-04-15 06:14:08,2008-04-15 02:48:06
f669ac0be901e19a8948c9b04af63d23ebae8003...f2d0df7148a1b9ee69bd69a365ffcd1965872451,2,8,7,15,6,2008-04-15 06:14:58,2008-04-15 03:14:09
f2d0df7148a1b9ee69bd69a365ffcd1965872451...2b6f0b0a78a713be51149f27c2c1172fe4afc9cd,1,3,2,5,2,2008-04-15 06:14:58,2008-04-13 23:49:38
ee5a317e0130ab2db59db97c644576335530512d...3f36cbbaaf87b67abafa851e2808735553f92b06,3,4,4,8,4,2008-04-10 07:20:31,2008-04-09 11:07:14
3f36cbbaaf87b67abafa851e2808735553f92b06...ac7fa2776c4a839a5a96c13886714774b52844de,3,22,5,27,9,2008-04-10 07:20:38,2008-04-09 21:14:43
ac7fa2776c4a839a5a96c13886714774b52844de...abea85d1e9ee0bd77e41e934534aa5d5cdd0593a,1,6,6,12,2,2008-04-10 07:20:41,2008-04-10 00:08:23
679639904da05f7d84e9215960e76dd0f3353328...09651dd86eb07d1d6f1a2e88fe7b4860891808c1,2,13,5,18,6,2008-07-19 22:52:12,2008-07-19 22:52:12
60727b5800d7791e5b107620cb5b2d344cf97fe9...541fc218e6541ae94b3b1bc9e613f7bc879f6841,1,1,0,1,1,2008-06-04 20:33:25,2008-06-04 18:38:58
541fc218e6541ae94b3b1bc9e613f7bc879f6841...9e3fd4112426416f1eedb811c6ff5bc2a3dcd575,1,1,1,2,1,2008-06-04 21:51:34,2008-06-04 20:50:31
9e3fd4112426416f1eedb811c6ff5bc2a3dcd575...dd613e6b8706f31c01aae622345dbaab3f276262,1,237,2,239,2,2008-06-04 22:02:42,2008-06-04 21:20:05
dd613e6b8706f31c01aae622345dbaab3f276262...7f718e8b46b37a9e1caf58a372938817f04885d9,1,20,9,29,8,2008-06-04 22:05:01,2008-06-03 14:47:10
bed625540a0e1a4ba4da9962ed53c1d83d9bf509...843c81dcf48753629783270677052b4b8211fb06,1,9,9,18,7,2008-07-08 20:00:47,2008-07-08 20:00:30
843c81dcf48753629783270677052b4b8211fb06...ea449615d89888a56f1b62c59de6a2668185d11a,4,4,4,8,4,2008-07-08 20:02:11,2008-07-08 20:02:11
ea449615d89888a56f1b62c59de6a2668185d11a...d1a4489a56e2ceac8e7dc9eb277a9f36fec725c5,2,12,1,13,3,2008-07-08 20:57:27,2008-07-08 04:38:54
d1a4489a56e2ceac8e7dc9eb277a9f36fec725c5...dc0f70541503e9006ac2fe812591b080c169c572,1,1,1,2,1,2008-07-08 23:36:03,2008-07-08 02:37:38
dc0f70541503e9006ac2fe812591b080c169c572...50e6102504cb211b6fe6224e67a9ed982efeb02f,1,1,1,2,1,2008-07-08 23:51:33,2008-07-07 20:41:54
50e6102504cb211b6fe6224e67a9ed982efeb02f...e896912c5edb8f989a2d25e101b2eb14f1a56aa9,1,34,0,34,2,2008-07-08 23:56:07,2008-06-29 00:25:05
e896912c5edb8f989a2d25e101b2eb14f1a56aa9...31a92f6aa47732e93f6685b8d1fd1ac09c1fec44,2,56,5,61,3,2008-07-09 05:46:01,2008-07-08 17:48:04
31a92f6aa47732e93f6685b8d1fd1ac09c1fec44...b5cd2d1e9273beb2ca7e18e671d80a55316fdf2c,1,4,3,7,3,2008-07-09 05:48:10,2008-07-07 21:06:46
b5cd2d1e9273beb2ca7e18e671d80a55316fdf2c...13b5481ed8309ced4b6435bf3956713651ea31d1,2,11,9,20,8,2008-07-09 05:49:42,2008-07-07 19:02:37
13b5481ed8309ced4b6435bf3956713651ea31d1...960862628256ca3272939db7973b030c2b6ba548,1,7,0,7,1,2008-07-09 05:50:14,2008-07-07 19:02:50
960862628256ca3272939db7973b030c2b6ba548...603fb1168218a813f1b0816b1208c5d0c92cf29d,1,1,0,1,1,2008-07-09 05:50:48,2008-07-07 20:22:15
603fb1168218a813f1b0816b1208c5d0c92cf29d...a958d8ed39d020267bc35d67928ecf027f2f0f71,1,9,11,20,1,2008-07-09 06:05:26,2008-07-07 02:10:00
a958d8ed39d020267bc35d67928ecf027f2f0f71...fd11ae0b52b6d059056a32851a916c152befae1a,1,15,5,20,3,2008-07-09 06:05:27,2008-07-07 21:58:58
494d3b8a6c93d88daf4a52dbcc6ab07903f8ed4e...8719f1286eb7ccaeaca301619d0d75e14df769ca,1,4,0,4,2,2008-03-14 09:24:31,2008-03-14 09:24:31
8719f1286eb7ccaeaca301619d0d75e14df769ca...2708d9df59e45bd74bfb71027e1ea7c54a9eecd5,1,890,0,890,1,2008-03-14 09:26:47,2008-03-13 16:46:30
a977953326b5bc9556f2648a7327c623e676aaca...c11ff120f359bd7bd79c425135f85e1dca5ae252,1,30,20,50,21,2008-05-26 00:11:33,2008-05-26 00:11:33
445cac18c015809a7fcb4a570d3c6571b1ddaf7d...5059a427804f9fefaf75dd1aa92cb620ce9219c7,2,6,1,7,3,2008-08-30 04:46:33,2008-08-29 15:00:43
373a273309433d66d56505f0a125434c57fa508d...ea02eef096d4bfcbb83e76cfab0fcb42dbcad35e,3,17,13,30,3,2008-08-17 18:42:10,2008-08-17 18:42:10
f2816b3d34ef93553b14a5fe23c48d092a74901f...55ba8a3474102eb8d638834d2b9bfe58d5014a40,3,3,3,6,3,2008-09-01 19:45:46,2008-08-30 16:45:27
55ba8a3474102eb8d638834d2b9bfe58d5014a40...9dc3793166db8f3b80b909e2cb3ac3c5d0a611d5,1,2,2,4,1,2008-09-01 22:39:11,2008-08-30 21:12:26
f2816b3d34ef93553b14a5fe23c48d092a74901f...e681cb7d6a00b4860c84bf8ca7b8d8dab366c9fc,3,26,1,27,14,2008-08-25 04:36:17,2008-08-22 20:10:27
e681cb7d6a00b4860c84bf8ca7b8d8dab366c9fc...a9c80b83d4bb40e0ff696520de3ef2b0f74ff8c6,3,55,2,57,6,2008-08-25 05:00:01,2008-08-23 08:30:00
a9c80b83d4bb40e0ff696520de3ef2b0f74ff8c6...80fd76bd58070fe9615baf365abf2ff82276e50c,1,38,10,48,4,2008-08-25 05:00:01,2008-08-23 08:30:51
80fd76bd58070fe9615baf365abf2ff82276e50c...823f7cf81dbed741c3a645913d7461e9bc04e0d2,1,61,4,65,3,2008-08-25 05:00:01,2008-08-23 08:31:35
823f7cf81dbed741c3a645913d7461e9bc04e0d2...f7078b40917daa20ea3fa54c7e38766594e4b996,3,14,5,19,8,2008-08-25 05:00:01,2008-08-23 08:32:20
f44bc33c7283c19a86797ffdaafd22a19bbdfbd6...1fc2cbc1d8614c469d28a5a8f11a904f294245af,1,4,4,8,2,2008-08-06 21:00:36,2008-08-05 23:23:08
1fc2cbc1d8614c469d28a5a8f11a904f294245af...1fdf6ee6f81b31b299a8039832f45290faa4583a,1,15,1,16,5,2008-08-06 21:00:36,2008-08-06 19:44:55
372c767610c4e4d7f4832d037ac51a62a59875a3...bc699afcce3c45bb17aaca145d081992ed699a42,4,37,6,43,14,2008-08-02 22:21:59,2008-08-02 19:38:56
bc699afcce3c45bb17aaca145d081992ed699a42...7339479c2b2986891763300e385e71ab6ae56322,1,0,5,5,1,2008-08-02 22:22:10,2008-08-02 04:47:09
7339479c2b2986891763300e385e71ab6ae56322...e49b99a6f5ac9f6638b0e5f938674f031555f374,1,1,0,1,1,2008-08-02 22:22:10,2008-08-02 00:56:53
e49b99a6f5ac9f6638b0e5f938674f031555f374...5cbef01aab58e6d1feb0ea7b80c9111c2b40e561,1,1,1,2,1,2008-08-02 22:35:45,2008-08-02 21:41:48
5cbef01aab58e6d1feb0ea7b80c9111c2b40e561...ad8c1d92600da963692d57c213979e638c357f1a,1,1,0,1,1,2008-08-02 22:38:14,2008-07-31 07:21:48
ad8c1d92600da963692d57c213979e638c357f1a...b50005b79f6c77f9846c3f34ba319675fe489b72,1,6,0,6,1,2008-08-02 22:39:35,2008-08-01 21:00:15
b50005b79f6c77f9846c3f34ba319675fe489b72...807d86945336f676c9f650a6cbae9baa3191aaec,1,1,1,2,1,2008-08-02 22:40:57,2008-08-02 21:56:44
807d86945336f676c9f650a6cbae9baa3191aaec...6612f877cc94e80cd0c7393a8ea6bfea69146b3c,2,15,2,17,4,2008-08-03 21:05:55,2008-08-01 14:01:36
65347030590bcc251a9ff2ed96487a0f1b9e9fa8...498bcd3159ae3711f2beea2ea497cdc09856ee79,3,60,21,81,4,2008-08-30 05:20:51,2008-08-29 19:18:38
498bcd3159ae3711f2beea2ea497cdc09856ee79...9d13dec5499ec31a93dd22db9b0c971133a10613,1,2,2,4,2,2008-08-31 23:34:11,2008-08-31 22:31:37
65347030590bcc251a9ff2ed96487a0f1b9e9fa8...faf0156b278d1a760362cda1d294a88be7608de4,2,38,12,50,13,2008-08-14 22:45:16,2008-08-14 17:59:44
abea85d1e9ee0bd77e41e934534aa5d5cdd0593a...ca593f795994badf7cd543d24d1ed24aabc0d8e1,1,1,1,2,1,2008-04-11 19:25:30,2008-04-09 20:20:10
ca593f795994badf7cd543d24d1ed24aabc0d8e1...d4ba07cac576e87fd194df0853ed523af6c58af1,2,12,1,13,2,2008-04-11 19:54:15,2008-04-10 11:33:09
d4ba07cac576e87fd194df0853ed523af6c58af1...055b66158c984c4e902735ab2a1a188509423f43,1,2,2,4,2,2008-04-12 00:34:05,2008-04-11 20:52:07
055b66158c984c4e902735ab2a1a188509423f43...a710522bfc9ae6e27ce4bea573d1d223af6a6f8e,1,1,0,1,1,2008-04-12 06:01:33,2008-04-10 20:06:52
a710522bfc9ae6e27ce4bea573d1d223af6a6f8e...e3389075c6160c46cf0e2a443deab1966628ed57,2,18,9,27,5,2008-04-12 06:54:45,2008-04-12 05:53:59
09651dd86eb07d1d6f1a2e88fe7b4860891808c1...b0f2ecf5935335ba72f406bfc88634142c5694cd,1,7,0,7,1,2008-07-20 18:24:44,2008-07-17 17:00:28
b0f2ecf5935335ba72f406bfc88634142c5694cd...ec96224e215f1b2f143524afa339564271c11e12,1,0,2,2,2,2008-07-20 18:34:06,2008-07-20 12:12:48
ec96224e215f1b2f143524afa339564271c11e12...74f5b7fba420eb6b807db48d0ee7a000202f8225,2,4,3,7,3,2008-07-20 20:37:26,2008-07-20 12:34:47
74f5b7fba420eb6b807db48d0ee7a000202f8225...c29c1b406eb6edd30c4a7dc11e91370e497e6a5d,1,8,21,29,8,2008-07-20 21:41:49,2008-07-20 12:02:20
c29c1b406eb6edd30c4a7dc11e91370e497e6a5d...107cee507884dc9b3c5d3759e8e50c9c47e2ddcd,1,1,1,2,1,2008-07-20 22:16:50,2008-07-20 20:14:07
09651dd86eb07d1d6f1a2e88fe7b4860891808c1...c972ec04204b6edf4fe7ec0d59a3ce3564378303,1,43,32,75,9,2008-07-20 06:08:58,2008-07-20 02:22:25
c972ec04204b6edf4fe7ec0d59a3ce3564378303...3ba1f114267b19a458df0f1d714dc4010ec9cc56,1,11,2,13,4,2008-07-20 06:08:58,2008-07-20 02:51:11
3ba1f114267b19a458df0f1d714dc4010ec9cc56...340ce9e25f40ef2fead9fcc027844c66737c85dd,1,44,0,44,1,2008-07-20 06:08:58,2008-07-20 03:32:38
340ce9e25f40ef2fead9fcc027844c66737c85dd...da98053aa699b2c462e35b777f4817fc46f111eb,1,7,1,8,2,2008-07-20 06:08:58,2008-07-20 05:34:16
e919cb302e75141c2565106bed2f0b6cb8047570...b7d9681974e61959f10c7b2c1063b7781c5b904e,3,7,0,7,5,2008-06-06 16:22:18,2008-06-05 21:15:36
b7d9681974e61959f10c7b2c1063b7781c5b904e...a0ebe573a516a1530a2c072e513fa7f529781dd0,1,53,11,64,5,2008-06-06 16:23:09,2008-06-05 08:56:19
a0ebe573a516a1530a2c072e513fa7f529781dd0...30eba7bf2caa327b4251d66bf7157dda97512e96,8,68,20,88,16,2008-06-06 18:14:52,2008-06-06 07:07:28
30eba7bf2caa327b4251d66bf7157dda97512e96...9e1f0a85c68323830ea117092c55192b17aa3ac8,140,144,146,290,145,2008-06-06 18:18:28,2008-06-06 07:07:32
9e1f0a85c68323830ea117092c55192b17aa3ac8...1b9a9467f8b9a8da2fe58d10ae16779492aa7737,3,39,2,41,4,2008-06-06 18:23:10,2008-06-06 03:15:19
1b9a9467f8b9a8da2fe58d10ae16779492aa7737...03300c0ac0dfd6098ff65cff518bfffb05ae4194,1,0,14,14,1,2008-06-06 18:56:43,2008-06-05 09:28:13
2708d9df59e45bd74bfb71027e1ea7c54a9eecd5...80dd7b44970dee7d82fa735d2e0b828051f80545,1,3,3,6,3,2008-04-06 03:07:27,2008-03-26 18:45:26
c11ff120f359bd7bd79c425135f85e1dca5ae252...e2f90ee45c8b2d13a6c6b8a9f4bc3dce05408c99,1,25,10,35,4,2008-07-31 10:29:44,2008-07-12 12:09:28
e2f90ee45c8b2d13a6c6b8a9f4bc3dce05408c99...e439e092b8ee5248e92ed4cb4400f9dbed70f689,1,23,16,39,14,2008-07-31 10:29:44,2008-07-13 12:40:47
e439e092b8ee5248e92ed4cb4400f9dbed70f689...b6326e92ef39b37361002bffb1f94645339eec59,1,6,1,7,1,2008-07-31 10:29:44,2008-07-14 20:35:42
b6326e92ef39b37361002bffb1f94645339eec59...7272131b3e49879d3a7bedacad3cdb12ae678ee8,1,2,1,3,2,2008-07-31 10:29:44,2008-07-26 14:48:41
7272131b3e49879d3a7bedacad3cdb12ae678ee8...567c34e0ed8b9219589a6f1bc102996ac9773776,1,24,17,41,11,2008-07-31 10:29:44,2008-07-26 16:13:45
567c34e0ed8b9219589a6f1bc102996ac9773776...835e62aef81b75301129625f5d5df76149862909,1,18,7,25,3,2008-07-31 10:29:44,2008-07-26 16:15:54
835e62aef81b75301129625f5d5df76149862909...12aaf1f64d115ecd8cd7f0dd4f5760f082f1edf7,1,65,41,106,18,2008-08-03 12:45:43,2008-05-24 20:42:30
12aaf1f64d115ecd8cd7f0dd4f5760f082f1edf7...8eacbc1b03da401fbeaf67c4e2db8392692af88d,1,260,232,492,205,2008-08-03 23:17:26,2008-08-03 17:04:21
24fa13cbb7c520f787370b471b4f04652fbb68d5...16805d3e59250769f409480ca3cb739281bc906c,10,58,55,113,53,2008-09-08 21:18:04,2008-09-08 10:02:05
16805d3e59250769f409480ca3cb739281bc906c...1364ff27dc5ecca4c1932d8fa09fe88a7c09fda0,27,174,174,348,149,2008-09-08 21:22:58,2008-09-08 10:02:08
1364ff27dc5ecca4c1932d8fa09fe88a7c09fda0...e705d757bde06c2e523fc5bbbbf62bbb7c2234e9,1,1,1,2,2,2008-09-08 21:23:55,2008-09-08 10:46:55
e705d757bde06c2e523fc5bbbbf62bbb7c2234e9...bfd083b734fe812b347ee71dca416d2bcfa87480,1,1,1,2,1,2008-09-08 21:25:43,2008-09-08 17:56:32
bfd083b734fe812b347ee71dca416d2bcfa87480...10708a994a632c392ab58aa7d11e49b322aa1505,1,2,2,4,1,2008-09-08 21:26:23,2008-09-08 18:29:18
ea02eef096d4bfcbb83e76cfab0fcb42dbcad35e...36c079756f9f3ad0bbbe2097550c62427670146b,1,3,0,3,1,2010-02-20 18:33:11,2010-02-20 11:42:04
ea02eef096d4bfcbb83e76cfab0fcb42dbcad35e...150115aded2e1e0a83db7366f59e4b5bf1aa8135,2,17,1,18,3,2009-03-22 22:26:07,2009-03-22 22:26:07
ea02eef096d4bfcbb83e76cfab0fcb42dbcad35e...aa9ea77de4fffd133b3da1d36a19fd0bd11ad368,1,4,4,8,2,2009-03-18 07:13:03,2009-03-18 07:13:03
ea02eef096d4bfcbb83e76cfab0fcb42dbcad35e...aab3b9a1aa3b7d082088ab014480b5d81c437624,2,34,3,37,4,2009-03-13 00:06:07,2009-03-12 07:02:12
ea02eef096d4bfcbb83e76cfab0fcb42dbcad35e...6b9315d5a14b4d1389cff347fcfcb86624bbf645,2,29,3,32,4,2009-01-05 20:45:38,2009-01-01 20:54:31
6b9315d5a14b4d1389cff347fcfcb86624bbf645...837e5fe95d9d6e597b748d338e45cca231f558fa,2,37,10,47,8,2009-01-05 20:46:35,2009-01-01 20:54:32
837e5fe95d9d6e597b748d338e45cca231f558fa...7b9e3ce0255002075809917e0384cba3a0d18589,1,2,6,8,2,2009-01-05 20:48:43,2009-01-01 20:54:33
ea02eef096d4bfcbb83e76cfab0fcb42dbcad35e...dba9194a49452b5f093b96872e19c91b50e526aa,2,16,1,17,2,2008-08-17 22:44:11,2008-08-17 22:44:11
9dc3793166db8f3b80b909e2cb3ac3c5d0a611d5...ca53c3fdcf69f620331f3822cef36d95b5cf5640,1,11,7,18,3,2008-09-05 04:52:56,2008-09-05 04:46:56
961a628fdd79a30188b0f76be98b3c1db8e13389...700e560341edfe32242b6b5b3b380d6f945ec0e8,1,2,2,4,2,2008-09-05 04:28:48,2008-09-04 09:50:53
700e560341edfe32242b6b5b3b380d6f945ec0e8...042c232535c329f168e8a515588f38a4117954fb,2,190,60,250,8,2008-09-05 04:28:54,2008-08-30 20:55:45
042c232535c329f168e8a515588f38a4117954fb...7e30682ce042fdea1ff2c76226b17d9affe2f9bf,3,260,0,260,4,2008-09-05 04:28:54,2008-08-30 20:56:51
7e30682ce042fdea1ff2c76226b17d9affe2f9bf...617ceee653bd7377f662bfc6d3085f321efab7e4,1,8,0,8,1,2008-09-05 04:28:55,2008-08-30 20:54:19
617ceee653bd7377f662bfc6d3085f321efab7e4...48c74a58b129e7230d74b2fba5c2d29eaa1f11dc,1,27,0,27,3,2008-09-05 04:28:55,2008-08-30 20:59:47
48c74a58b129e7230d74b2fba5c2d29eaa1f11dc...ff515d81faa22f26b611ed7fd06a76d0c300ea39,4,7,3,10,7,2008-09-05 04:28:55,2008-08-30 21:00:49
ff515d81faa22f26b611ed7fd06a76d0c300ea39...29853b901045ff09ac8e5b48a01ebbc96fa4874d,3,109,39,148,10,2008-09-05 04:28:55,2008-08-30 21:02:56
29853b901045ff09ac8e5b48a01ebbc96fa4874d...8056cc4f293b5e2bf0520f085e25b127c2ef3bbf,1,35,9,44,8,2008-09-05 04:28:55,2008-08-30 21:04:10
8056cc4f293b5e2bf0520f085e25b127c2ef3bbf...b2ca414973c3bcd00f2b94538bd9c755387f30a0,1,89,5,94,8,2008-09-05 04:28:55,2008-08-30 21:05:22
1fdf6ee6f81b31b299a8039832f45290faa4583a...ff30fff38c09dac7c1349fb774c55daa8fd92972,1,0,3,3,2,2008-08-09 01:52:20,2008-08-08 05:59:13
ff30fff38c09dac7c1349fb774c55daa8fd92972...e3df89a4b167c2ca0bd2b0a0025fd16c4d3dd651,1,6,1,7,2,2008-08-09 01:52:28,2008-08-08 05:59:18
e3df89a4b167c2ca0bd2b0a0025fd16c4d3dd651...abc5d372ec242fc654dc6780df6ea3d63dc72f2f,2,7,2,9,3,2008-08-09 05:24:28,2008-08-08 11:08:37
abc5d372ec242fc654dc6780df6ea3d63dc72f2f...54514f1f144a0e79b6c39d4a865927a18c17ed17,1,1,1,2,1,2008-08-19 05:43:31,2008-08-18 16:25:40
1fdf6ee6f81b31b299a8039832f45290faa4583a...468386a956c09ff59dd2b8fd681e162b2e167392,2,14,1,15,2,2008-08-08 04:25:27,2008-08-08 02:29:35
468386a956c09ff59dd2b8fd681e162b2e167392...b3bc97cba45e3b97243d31927fbf2343c21b6766,1,5,5,10,2,2008-08-08 10:01:52,2008-08-08 07:52:55
b3bc97cba45e3b97243d31927fbf2343c21b6766...ba24e7457aa1f958370bbb67dfb97e3ec806fd4a,2,15,3,18,6,2008-08-08 20:16:47,2008-08-07 09:06:16
ba24e7457aa1f958370bbb67dfb97e3ec806fd4a...7be73ae94e6dac3d1c41268a13b02ff7203c0631,1,2,2,4,1,2008-08-08 20:17:08,2008-08-06 21:22:00
7be73ae94e6dac3d1c41268a13b02ff7203c0631...c94c8e5ff63728a60494cbbcb28d5045584a997b,1,2,0,2,1,2008-08-08 20:17:25,2008-08-07 19:03:42
c94c8e5ff63728a60494cbbcb28d5045584a997b...b13d44093bac2eb75f37be01f0e369290211472c,1,1,0,1,1,2008-08-08 20:31:27,2008-08-08 20:31:27
b13d44093bac2eb75f37be01f0e369290211472c...5a7ebd4faab1430a6d4daef0636345709139e3b4,1,1,1,2,1,2008-08-08 23:10:39,2008-08-06 15:45:23
5a7ebd4faab1430a6d4daef0636345709139e3b4...6dc4627ef4eb40aeb9b328270b189ca27c061f7a,1,7,1,8,3,2008-08-08 23:15:17,2008-08-07 19:06:26
6dc4627ef4eb40aeb9b328270b189ca27c061f7a...8afa42101d14f8944c1eb7f2e54d4f5300d2bb73,1,16,5,21,3,2008-08-08 23:16:31,2008-08-07 14:16:03
8afa42101d14f8944c1eb7f2e54d4f5300d2bb73...261044e85ddac3de48dc74dd9c416c95147022ad,1,11,3,14,1,2008-08-08 23:19:51,2008-08-07 23:50:31
261044e85ddac3de48dc74dd9c416c95147022ad...b47ddefe02945f8746c642219450245cf83ed130,2,33,8,41,8,2008-08-08 23:23:32,2008-08-08 08:41:56
b47ddefe02945f8746c642219450245cf83ed130...570d35c26dfbc40757da6032cdc96afb58cc0037,4,246,20,266,11,2008-08-08 23:29:56,2008-08-08 08:41:57
570d35c26dfbc40757da6032cdc96afb58cc0037...222566e42cfc339b31db4757800cc387bcd8c20e,1,5,2,7,2,2008-08-08 23:30:12,2008-08-08 08:41:58
222566e42cfc339b31db4757800cc387bcd8c20e...01144f20955bfbb6463c9649d90f411839ad1617,2,3,2,5,3,2008-08-09 01:27:19,2008-08-08 22:37:02
01144f20955bfbb6463c9649d90f411839ad1617...a9fd1383a73878284d4157b20ac7c735e876102e,6,76,7,83,8,2008-08-09 08:26:35,2008-08-09 08:17:24
57b0fc4516249e1aa86169718d148fbf2940dc0c...22537765f51de92115592ac0a15981b8d27ef908,1,3,2,5,2,2008-08-03 21:18:23,2008-07-26 09:41:44
22537765f51de92115592ac0a15981b8d27ef908...2c3766f06adf0ba226a592939971f8ef587e54c1,2,9,0,9,2,2008-08-04 00:55:40,2008-08-04 00:30:03
2c3766f06adf0ba226a592939971f8ef587e54c1...611921654ffb854338ab758009a93c70054fab7f,1,6,2,8,1,2008-08-04 01:13:53,2008-07-30 20:53:55
611921654ffb854338ab758009a93c70054fab7f...7d0b18a4da1be9e738293cc13812757ca47ed109,2,7,7,14,4,2008-08-05 04:46:42,2008-08-04 10:18:40
7d0b18a4da1be9e738293cc13812757ca47ed109...c72e0db1ff686e93478ee21a3e80a9ca73143753,1,24,0,24,2,2008-08-05 04:48:51,2008-08-02 00:56:33
c72e0db1ff686e93478ee21a3e80a9ca73143753...108c2aaf7984081daa6aed6d3947c7c0952216c2,1,1,0,1,1,2008-08-05 04:51:17,2008-08-04 11:38:27
108c2aaf7984081daa6aed6d3947c7c0952216c2...452d36b1f33e10a9492eb2adad357108b26ea381,1,4,4,8,2,2008-08-05 04:51:23,2008-08-04 05:02:47
452d36b1f33e10a9492eb2adad357108b26ea381...9751a32a6b964df11f736f3526bf5453e6b5bc85,1,1,1,2,1,2008-08-05 04:51:53,2008-08-05 02:06:16
9751a32a6b964df11f736f3526bf5453e6b5bc85...25032ccd5f2fc4f51c0804efa45be19513e04c8a,1,2,2,4,2,2008-08-05 04:52:08,2008-08-05 02:11:04
25032ccd5f2fc4f51c0804efa45be19513e04c8a...fba5279db904aa49bb75bb31614571b9b6d75b33,1,1,0,1,1,2008-08-05 04:53:45,2008-08-04 15:30:24
faf0156b278d1a760362cda1d294a88be7608de4...4b7f53da7618e94985c9d9d5081b4bc44c45de2f,2,44,5,49,4,2013-01-17 23:22:48,2013-01-17 22:23:03
faf0156b278d1a760362cda1d294a88be7608de4...53030f8d1199ef9da86e7ddc2b8a659a355e5f69,1,3,1,4,2,2008-08-18 07:37:34,2008-08-18 07:37:34
53030f8d1199ef9da86e7ddc2b8a659a355e5f69...5eac739e05620e491555850d5b513ef60595c016,1,4,1,5,1,2008-08-18 07:39:47,2008-08-14 20:52:36
00b718e02d97c956cade8c1b4cbe29a9d3e92765...d266a988456fcaab9918eae39f5faf8dcb20cb26,1,42,6,48,2,2008-08-13 04:40:20,2008-08-11 23:55:37
5b2eeed1ba36caf71341c1557f2054681c353a14...f34a9416ab9efa13a53a31cabd9061d583aaba7e,1,4,3,7,3,2008-08-13 00:27:46,2008-08-12 08:45:59
464509f790f409d95e0820364ef7296d82942d8c...5e835cac8622373724235d299f1331ac4cf81ccf,2,55,5,60,2,2008-04-16 19:50:48,2008-04-16 19:50:48
e3389075c6160c46cf0e2a443deab1966628ed57...a179a303524c1b81ded1d04930f1edc6b5227c9d,1,2,2,4,2,2008-04-12 22:16:13,2008-04-12 09:17:36
a179a303524c1b81ded1d04930f1edc6b5227c9d...55ef8a4610c4f1077551682a86f9a4e6d498e8e0,2,9,3,12,3,2008-04-12 22:38:20,2008-04-12 22:38:20
55ef8a4610c4f1077551682a86f9a4e6d498e8e0...e80950786c16e642be76976a8926b2846ba0aa4f,1,5,0,5,1,2008-04-12 22:39:07,2008-04-12 09:50:20
fa4946b5532ff911565c882892a715616c22cdec...7df1709c36ff93f56636ab11db612dedb0d2bed0,1,7,3,10,3,2008-07-21 00:17:09,2008-07-20 22:58:13
7df1709c36ff93f56636ab11db612dedb0d2bed0...559e840b74dbbf39633aa68627937a5f7a6d4145,2,38,38,76,2,2008-07-21 00:17:09,2008-07-20 23:13:05
559e840b74dbbf39633aa68627937a5f7a6d4145...d14e7407b34b8c11b407358b9677c283c381a71c,5,9,4,13,7,2008-07-21 00:21:32,2008-07-20 07:21:38
03300c0ac0dfd6098ff65cff518bfffb05ae4194...4bfee30a98783f7987c395e6006a2a6717344c04,5,92,10,102,9,2008-06-09 22:47:36,2008-06-05 08:31:19
4bfee30a98783f7987c395e6006a2a6717344c04...6c2ce048bbfc6fbc2bdd86a3e586cb8881eb2dc2,5,34,6,40,8,2008-06-09 22:48:19,2008-06-05 12:22:56
6c2ce048bbfc6fbc2bdd86a3e586cb8881eb2dc2...d6293d1f2cadcdf45f8ada7847a32b51fa5bf0a6,4,54,0,54,7,2008-06-09 22:48:20,2008-06-05 12:47:50
948e7471e03340307e802e919303256f80273d21...c6955fec546f339b258a1cba0e23618010e5c260,1,7,1,8,2,2008-07-09 21:51:23,2008-07-08 23:18:26
c6955fec546f339b258a1cba0e23618010e5c260...952182b5691452f2b4fb49513c74e856d561f9d2,1,4,4,8,4,2008-07-09 21:51:30,2008-07-08 22:59:25
952182b5691452f2b4fb49513c74e856d561f9d2...607bb3ff885727a099b39e16abd86f17ae502306,1,8,0,8,1,2008-07-09 22:10:03,2008-07-09 20:38:14
607bb3ff885727a099b39e16abd86f17ae502306...9d1ccf5e640bdaeddd01a86b40b4c0980c1ef642,1,3,0,3,1,2008-07-09 22:53:10,2008-07-09 21:39:40
80dd7b44970dee7d82fa735d2e0b828051f80545...f31fa2c0864ba8b1292119fbb3942cdbaa0fb807,1,3,2,5,3,2008-04-27 23:40:50,2008-04-27 23:40:50
f31fa2c0864ba8b1292119fbb3942cdbaa0fb807...cc398a286b4cb5cb76c515588668bab4858a01cf,1,890,0,890,1,2008-05-02 12:32:48,2008-03-25 10:48:22
cc398a286b4cb5cb76c515588668bab4858a01cf...b3449aeafd99fb516144a33cc25a8eb2d0126a84,1,887,0,887,1,2008-05-02 12:35:49,2008-03-14 15:13:17
b3449aeafd99fb516144a33cc25a8eb2d0126a84...dfa65bc28ea4bda04072f02acd0dca8c75e94990,1,3,3,6,1,2008-05-02 12:54:02,2008-04-14 08:27:09
dfa65bc28ea4bda04072f02acd0dca8c75e94990...703232da538a2e3faacc95e7b0c2fa527776f8df,1,338,167,505,164,2008-05-03 07:54:26,2008-05-01 19:38:37
703232da538a2e3faacc95e7b0c2fa527776f8df...81811a74ba48ee4ab88aa98d6e72f499eefec819,1,14,16,30,14,2008-05-03 07:54:31,2008-05-02 19:33:34
81811a74ba48ee4ab88aa98d6e72f499eefec819...5e3502dabb6e95e3d9420e010276f832cb68e396,1,5,1,6,1,2008-05-03 07:57:35,2008-05-02 15:46:20
5e3502dabb6e95e3d9420e010276f832cb68e396...f4c54b3cc4b1bbde34fe957ac03f9862ec970de3,1,25,7,32,10,2008-05-10 03:15:36,2008-05-10 03:15:36
f4c54b3cc4b1bbde34fe957ac03f9862ec970de3...314f5de1a0b91d27cbbb8a400337dd41cf84d511,1,145,2,147,12,2008-05-11 00:50:05,2008-03-24 11:55:36
8eacbc1b03da401fbeaf67c4e2db8392692af88d...df75e86d7307c2fd16d8df1bcbe8d7ccfb7305ff,1,8,6,14,8,2008-08-11 00:13:50,2008-08-09 10:41:50
196821f440d46029f0399a7d97c0cfc78a870244...97fc865bc1cd8aa23ed36c4c53e211e4d0c99626,1,1,1,2,1,2008-06-12 05:18:09,2008-06-12 02:38:38
97fc865bc1cd8aa23ed36c4c53e211e4d0c99626...6bfa3c99292dad8f88b2c8ac22e557421d57fd46,1,2,1,3,1,2008-06-12 21:19:09,2008-06-12 21:19:09
6bfa3c99292dad8f88b2c8ac22e557421d57fd46...5ada3696f6a7c99028ec0f95c629def747373aef,1,1,1,2,1,2008-06-12 21:21:05,2008-06-12 21:21:05
5ada3696f6a7c99028ec0f95c629def747373aef...9501fc894566f4d27a9823407555f3039273162c,1,2,0,2,2,2008-06-12 21:28:53,2008-06-12 14:29:42
9501fc894566f4d27a9823407555f3039273162c...4209752da5a2e327e470493618931a7abbf0a381,1,7,8,15,2,2008-06-12 21:30:51,2008-06-12 21:30:37
4209752da5a2e327e470493618931a7abbf0a381...fe22e5420ee547bac58481ed1a868f4cd39ad128,1,1,1,2,1,2008-06-13 05:20:18,2008-06-11 13:09:19
fe22e5420ee547bac58481ed1a868f4cd39ad128...fa5b4f37e4517c7a422b227f565c9f21bdc8cc65,1,22,0,22,1,2008-06-13 05:22:36,2008-06-12 06:14:28
fa5b4f37e4517c7a422b227f565c9f21bdc8cc65...7b7b4516def229846ae20a43818be7e0b30d4261,2,3,2,5,2,2008-06-13 05:22:55,2008-06-12 22:35:59
7b7b4516def229846ae20a43818be7e0b30d4261...d8933f013a66cc1deadf83a9c24eccb6fee78a35,1,2,0,2,1,2008-06-13 05:42:20,2008-06-13 04:38:55
10708a994a632c392ab58aa7d11e49b322aa1505...90b4a71c493bf24f11b5edee8a519110624a6bea,6,19,20,39,10,2008-09-09 16:27:45,2008-09-09 08:27:07
90b4a71c493bf24f11b5edee8a519110624a6bea...be5908aed35d1c129f1ea38913b230ee1927361b,4,6,4,10,7,2008-09-09 16:27:45,2008-09-09 08:27:08
be5908aed35d1c129f1ea38913b230ee1927361b...40c155ff14c8b313d408f2e51a55c881ce082e4e,5,39,10,49,15,2008-09-09 16:27:46,2008-09-09 08:27:09
40c155ff14c8b313d408f2e51a55c881ce082e4e...d79796bcf05b89774671a75b3285000c43129823,3,50,0,50,6,2008-09-09 16:27:46,2008-09-09 08:27:10
10708a994a632c392ab58aa7d11e49b322aa1505...4886b89f8fde57b76738c96761eecbfbd0b13112,1,13,7,20,2,2008-09-09 15:34:00,2008-09-09 05:10:56
4886b89f8fde57b76738c96761eecbfbd0b13112...e8eec71d6e79c176d34dc8fda8780ed4dee447a2,5,6,6,12,6,2008-09-09 23:28:05,2008-09-09 18:57:10
7df437e56b5a2c5ec7140dd097b517563db4972c...394258190c76dd7944688a3a28931071ec02087d,4,65,6,71,14,2008-08-31 23:22:05,2008-08-21 08:44:53
7df437e56b5a2c5ec7140dd097b517563db4972c...9047ebbc229bf5b99d6c7522293b8cbd1100b747,4,1341,1324,2665,14,2008-08-31 03:46:54,2008-08-12 16:45:14
9047ebbc229bf5b99d6c7522293b8cbd1100b747...73118f89b81f5a3ed1bb56e2517627d56e9ebdfb,3,75,46,121,10,2008-08-31 03:46:54,2008-08-12 20:13:59
73118f89b81f5a3ed1bb56e2517627d56e9ebdfb...8a2fce1895c058945d8e2dbd8cb7456cc7450ad8,4,192,169,361,109,2008-08-31 03:46:54,2008-08-25 14:25:57
8a2fce1895c058945d8e2dbd8cb7456cc7450ad8...18668f5319b079cce29e19817bc352b1413e0908,1,63,29,92,6,2008-08-31 03:47:11,2008-08-28 13:43:00
18668f5319b079cce29e19817bc352b1413e0908...6eb1b437933e075bd84c5cdcf5de95ed4db4820f,1,43,40,83,12,2008-09-03 00:03:01,2008-09-02 21:11:15
6eb1b437933e075bd84c5cdcf5de95ed4db4820f...5033639c951da27fc4d4becbc3e46dc05096ce63,2,13,13,26,11,2008-09-04 02:06:17,2008-09-02 21:30:09
5033639c951da27fc4d4becbc3e46dc05096ce63...b7fa51da9be3cee9e2ca31af4edfec18b8ecbce7,1,67,73,140,49,2008-09-05 05:49:34,2008-09-02 21:53:47
b7fa51da9be3cee9e2ca31af4edfec18b8ecbce7...c7d849243a4be2c60ff48cc42ea8b0518bb7f27f,2,19,19,38,14,2008-09-05 05:50:43,2008-09-03 00:30:03
c7d849243a4be2c60ff48cc42ea8b0518bb7f27f...696ee23cc1817a5064780600374589d3a773a081,2,34,27,61,21,2008-09-05 05:50:43,2008-09-03 17:08:56
696ee23cc1817a5064780600374589d3a773a081...a6f63ae002237c2eb416d4e2cb43227522e4ea9a,1,1,5,6,3,2008-09-05 18:57:54,2008-09-05 17:26:42
a6f63ae002237c2eb416d4e2cb43227522e4ea9a...4271666046b4b3e655eab88821096539099f3b14,2,23,0,23,2,2008-09-07 02:49:51,2008-09-06 16:29:49
dba9194a49452b5f093b96872e19c91b50e526aa...289796dd29dd656734cfd59b657deb943a71cf6a,2,4,3,7,4,2008-08-19 05:05:02,2008-08-14 15:35:42
289796dd29dd656734cfd59b657deb943a71cf6a...da9973c6f9600d90e64aac647f3ed22dfd692f70,1,4,4,8,4,2008-08-19 05:05:44,2008-08-18 14:17:04
da9973c6f9600d90e64aac647f3ed22dfd692f70...26e08a0190cb3354e43bab13ea693a5c826a8fe1,1,6,4,10,5,2008-08-19 06:27:14,2008-08-18 23:17:53
dba9194a49452b5f093b96872e19c91b50e526aa...2ebc02d32a4360da2cf69c2b5f5bfad0716d42b0,2,43,1,44,2,2008-08-17 23:20:31,2008-08-17 22:48:51
ca53c3fdcf69f620331f3822cef36d95b5cf5640...dd87558f58d989e47de09eafefa8d2f2ea4de27d,1,1,1,2,1,2008-09-26 14:07:34,2008-09-25 21:31:22
95b6a2db25c6c3321be33ac17b6b2e54c407652d...a9786bb42ff4fa4b8031ab69215a66cf329d8324,2,29,3,32,6,2008-09-12 15:09:09,2008-09-08 07:18:52
a9786bb42ff4fa4b8031ab69215a66cf329d8324...2fe5b2ee42897a3acc78e5ddaace3775eb2713ca,2,11,0,11,2,2008-09-12 15:09:09,2008-09-08 16:37:11
2fe5b2ee42897a3acc78e5ddaace3775eb2713ca...8b56a18dea33e8b55810b4e561279b118bc1ada8,1,6,6,12,3,2008-09-12 15:38:42,2008-09-12 09:17:38
8b56a18dea33e8b55810b4e561279b118bc1ada8...146ed90f020bb19446020d9b858242f176777797,1,172,21,193,11,2008-09-13 21:24:16,2008-09-13 08:24:47
146ed90f020bb19446020d9b858242f176777797...1e65c6225dea2e15df81f6c91927cb0b8fab443c,2,83,6,89,17,2008-09-24 16:53:01,2008-09-12 18:43:49
1e65c6225dea2e15df81f6c91927cb0b8fab443c...1e02b32e7212d4f5f596a7161dc7c5cb76ac965d,1,56,48,104,6,2008-09-24 16:53:35,2008-09-24 16:48:20
1e02b32e7212d4f5f596a7161dc7c5cb76ac965d...2cd1fd1f6da5243226779acb17be9132d53ec4a9,1,65,0,65,2,2008-09-24 19:43:00,2008-09-24 19:11:53
2cd1fd1f6da5243226779acb17be9132d53ec4a9...1ffca60f0b0395e1e593e64d66e7ed3c47d8517e,4,26,4,30,6,2008-09-24 19:48:31,2008-01-23 05:37:10
1ffca60f0b0395e1e593e64d66e7ed3c47d8517e...696235c6c1c85085fd55ff849663d44c51464e69,1,1,7,8,2,2008-09-24 19:48:31,2008-01-23 05:39:50
696235c6c1c85085fd55ff849663d44c51464e69...72e6b002021e45255f568fc0c885d82de75ae935,5,46,6,52,13,2008-09-24 19:48:32,2008-09-17 21:07:32
72e6b002021e45255f568fc0c885d82de75ae935...50102c5687db83db48b9705e07de16d07cef7cd9,2,142,4,146,8,2008-09-24 19:48:32,2008-09-17 21:07:33
50102c5687db83db48b9705e07de16d07cef7cd9...3fe0162362f80262ed1965f19c1f57f298931c94,3,44,2,46,5,2008-09-24 19:48:32,2008-09-17 21:07:34
3fe0162362f80262ed1965f19c1f57f298931c94...a1c3feb7fac7fe90ff8a05779d7db9cf77e79ae1,1,53,29,82,5,2008-09-24 19:48:32,2008-09-17 21:07:35
a1c3feb7fac7fe90ff8a05779d7db9cf77e79ae1...6fc835a3f36146006bb33362368cf9d314877e51,1,17,0,17,3,2008-09-24 19:48:32,2008-09-17 21:07:36
6fc835a3f36146006bb33362368cf9d314877e51...3e34838caf796e67c057a136d1fdfe1d4286a003,3,70,33,103,35,2008-09-24 19:51:43,2008-09-20 08:19:18
0bb3a0ba9e3cbb283a747e4736bcf7484d076a73...71b9979bc74b66c1cf961d5c74de5c0b3cbf00a4,1,3,3,6,3,2008-08-09 22:11:48,2008-08-09 22:11:48
e28a8670a66125aa29d7a5ea10052c0f6824c2ba...ea3594e04184475226109a21e71c539ff5f139fd,1,21,5,26,7,2008-08-20 23:32:15,2008-08-20 23:32:15
fba5279db904aa49bb75bb31614571b9b6d75b33...806d13b1ccdbdde4bbdfb96902791c4b7ed125f6,2,24,1,25,3,2008-08-05 06:31:23,2008-08-04 07:51:42
806d13b1ccdbdde4bbdfb96902791c4b7ed125f6...725b06050a083474e240a2436121e0a80bb9f175,3,22,3,25,6,2008-08-05 06:31:23,2008-08-04 07:52:37
fcab40a389e99786a8276108cdbc1cda8caf502f...3e5057a8b4499f7b000cd465a3adf6ef22b89f2a,3,77,5,82,10,2008-07-19 22:26:28,2008-07-16 10:39:10
fcab40a389e99786a8276108cdbc1cda8caf502f...9196e825875dce66f6bc95dda01f5833f20bc5e5,1,5,2,7,2,2008-07-17 06:32:33,2008-07-17 03:25:18
fcab40a389e99786a8276108cdbc1cda8caf502f...4de53ce0437e7326908c4a0571ac4ff9b8d5aeff,1,10,16,26,8,2008-07-17 00:56:59,2008-07-16 19:19:27
fcab40a389e99786a8276108cdbc1cda8caf502f...3901a8c86645063c06dd81f12968012cbc697304,1,1,1,2,1,2008-07-16 15:11:15,2008-07-14 09:13:56
3901a8c86645063c06dd81f12968012cbc697304...300072f486797232014b2c8a1655424099508679,1,5,5,10,3,2008-07-16 15:42:52,2008-07-16 15:42:52
300072f486797232014b2c8a1655424099508679...7ba04d9f3741abd5788ff713b6a16351cbf3773a,2,1,3,4,2,2008-07-16 15:50:27,2008-07-16 10:42:10
7ba04d9f3741abd5788ff713b6a16351cbf3773a...cb2a1cc29864e0bce16b3d5e6dbde987aa57cef8,1,1,1,2,1,2008-07-16 15:50:32,2008-07-16 10:42:14
cb2a1cc29864e0bce16b3d5e6dbde987aa57cef8...1121a8786e8851cc9d03cb8142c0ecadd17221f6,1,1,1,2,1,2008-07-16 15:50:36,2008-07-16 10:42:18
1121a8786e8851cc9d03cb8142c0ecadd17221f6...dd33927ccdb92205988ba98bb2bb7df47529cd6d,1,1,1,2,1,2008-07-16 15:59:14,2008-07-16 01:31:28
d0ab520a2599afdfd4d61894863984fc36842b12...24b6177e0261efba063c0b83ae0cdc5993945da9,4,32,6,38,10,2008-04-18 23:31:27,2008-04-13 09:56:54
e80950786c16e642be76976a8926b2846ba0aa4f...2c2d02a6a72ce690df9dafea5e76bd4395d16927,1,17,11,28,5,2008-04-16 05:41:54,2008-04-15 21:44:43
2c2d02a6a72ce690df9dafea5e76bd4395d16927...1da16439bece6b90e1ce033bc50c5316f2c5dac2,1,1,1,2,1,2008-04-16 05:42:08,2008-04-14 15:30:27
1da16439bece6b90e1ce033bc50c5316f2c5dac2...48949a18c852e5119827278c37f791921e640688,1,1,1,2,1,2008-04-16 05:42:19,2008-04-16 02:09:49
48949a18c852e5119827278c37f791921e640688...6a28518ae098fad99ca3774ad7ed17bb681b809b,1,9,1,10,2,2008-04-16 06:53:26,2008-04-15 18:01:36
6a28518ae098fad99ca3774ad7ed17bb681b809b...2e6e3e829f3759823d70e7af511bc04cd05ad0af,1,10,14,24,10,2008-04-16 07:11:04,2008-04-15 19:56:50
2e6e3e829f3759823d70e7af511bc04cd05ad0af...d3e54c88291c2d880ff3a72167c5d3159aed8e97,2,16,5,21,10,2008-04-16 07:11:37,2008-04-14 03:41:45
dceab837557077f70bf082727645925aec443500...218bf69f0b137e0a21cfeeda6ba81947f220401f,1,6,0,6,1,2008-06-07 20:05:34,2008-06-07 20:05:34
df75e86d7307c2fd16d8df1bcbe8d7ccfb7305ff...39816d60e14b4d3be6ab9cf55caf79d7596bdb29,1,20,1,21,7,2008-08-26 10:10:10,2008-08-23 08:27:44
39816d60e14b4d3be6ab9cf55caf79d7596bdb29...77aa0ae8d3599b905ceb25db8cc50d6820efb793,1,23,0,23,2,2008-08-26 10:10:10,2008-08-23 08:29:08
dc92cc20f8dcfefcd5d79e8550736bcc437ea2e4...d88593fa0412a4f0a363860d879e97635c118616,1,0,4,4,4,2008-06-14 05:07:34,2008-06-14 00:16:02
d88593fa0412a4f0a363860d879e97635c118616...43d60d2e59cb466717290984becc8687fc632ca1,1,33,15,48,9,2008-06-14 05:08:30,2008-06-12 21:54:55
43d60d2e59cb466717290984becc8687fc632ca1...6483925999cde47e5108414ac3f57760394ee2d2,2,0,145,145,2,2008-06-14 06:00:51,2008-06-14 06:00:51
6483925999cde47e5108414ac3f57760394ee2d2...65e73dba4a7034e299895bed88a8d3e8ca127a11,1,3,4,7,1,2008-06-14 17:52:57,2008-06-14 07:21:36
65e73dba4a7034e299895bed88a8d3e8ca127a11...8e7e6f39b6895b6623dc0f6053818704899f41a6,1,5,4,9,3,2008-06-14 18:34:00,2008-06-14 17:09:41
a15a435ad394548fb6d22fa69f9a0e6db9752298...5190d73d1e83d6ac982da2a793043c2b012fad40,1,7,7,14,7,2008-09-10 05:59:00,2008-09-09 21:25:24
5190d73d1e83d6ac982da2a793043c2b012fad40...eaa2a6fc84bc02c1356353f7364e976e46133e98,2,41,41,82,36,2008-09-10 05:59:00,2008-09-09 21:25:25
eaa2a6fc84bc02c1356353f7364e976e46133e98...1f77354b024e2f449242f4c3b70111aa5ff608d5,1,8,8,16,1,2008-09-10 05:59:00,2008-09-09 21:25:26
1f77354b024e2f449242f4c3b70111aa5ff608d5...f964732c0560743b666ad4e189a6b148dacf6923,9,13,13,26,13,2008-09-10 05:59:00,2008-09-09 21:25:27
f964732c0560743b666ad4e189a6b148dacf6923...da06a80322a2357b8b5b6ddb8b5648f97ed73e83,1,14,14,28,12,2008-09-10 05:59:01,2008-09-09 21:25:28
7f314565fe20e324e8db1a7c233e43ca4e3683f0...85e72830697a23dd6b1af8b6bfb3c1a7be60dfae,5,9,9,18,8,2008-08-31 23:56:22,2008-08-31 12:09:39
ed520a8f270253f4a779aece1352b10fb9a689de...eb53586ba94087d9750c58d29ff494e5c1a95207,1,3,5,8,3,2008-09-26 15:24:19,2008-09-26 15:21:39
aa72a14a7f648ae47749281002e94cfcf36f39e2...a1b1ae0571f6b57117678aeaa1939d97c992a254,1,21,7,28,5,2009-03-28 07:55:52,2009-03-28 07:55:52
5ab2f7b2ce8c51e8c47a4cc57c30fa7cae239005...3346330d708b9b786b16167cbbd4a3637b3a3517,2,10,7,17,5,2009-04-02 19:34:16,2009-04-02 19:21:57
7d4e3a72fb2d544b4a7cfd75f8626532d78fd726...e986ceb05a118944d2638fba4cd09678c1afa6b3,1,32,3,35,7,2009-03-18 03:26:24,2009-03-18 03:26:24
692be9f365be09160f8baa1d6d521d0f65ec4cf9...5c415311f743ccb11a50f350ff1c385778f049d6,2,18,8,26,7,2009-01-25 20:41:09,2009-01-25 20:41:09
26e08a0190cb3354e43bab13ea693a5c826a8fe1...c8c4450e1949055cb57e32425b125f45f3481742,1,1,1,2,1,2008-08-20 01:08:00,2008-08-19 18:42:04
c8c4450e1949055cb57e32425b125f45f3481742...e9d7d10a7f17fb9cc6a4d37b6fdf27170f4deede,4,25,1,26,4,2008-08-20 02:36:56,2008-08-19 17:28:24
e9d7d10a7f17fb9cc6a4d37b6fdf27170f4deede...c71e917975ecd5fdc4caef245cf18b244213e3f6,1,1,2,3,1,2008-08-20 04:09:30,2008-08-19 18:46:30
c71e917975ecd5fdc4caef245cf18b244213e3f6...c35539eb10b0ab2a180e523f03ff65dc061bd47e,2,12,0,12,2,2008-08-20 20:28:19,2008-08-20 18:47:55
c35539eb10b0ab2a180e523f03ff65dc061bd47e...e276c26b4b65711c27e3ef37e732d41eeae42094,2,13,1,14,3,2008-08-20 20:29:30,2008-08-20 19:29:27
e276c26b4b65711c27e3ef37e732d41eeae42094...54988bdad7dc3f09e40752221c144bf470d73aa7,2,9,8,17,7,2008-08-20 20:30:49,2008-08-20 17:55:33
54988bdad7dc3f09e40752221c144bf470d73aa7...25b3d4d6f39d70c4d46dee48570ae7aeeb4a6b58,1,8,6,14,3,2008-08-20 22:48:52,2008-08-20 21:13:42
25b3d4d6f39d70c4d46dee48570ae7aeeb4a6b58...9ca8f6079cdb199851636c719900472a9745885f,2,11,1,12,3,2008-08-20 22:49:21,2008-08-20 22:09:28
9ca8f6079cdb199851636c719900472a9745885f...71f463773a310de016da20136fd7160685f97faa,1,1,1,2,1,2008-08-20 23:01:45,2008-08-20 15:36:25
71f463773a310de016da20136fd7160685f97faa...3a634dcf51fb0fbb66b5c9287de08c6230c90903,1,9,0,9,1,2008-08-20 23:04:45,2008-08-19 19:50:31
3a634dcf51fb0fbb66b5c9287de08c6230c90903...9b99e641c11044dba661f574f9098d362a3f0ef8,1,18,2,20,2,2008-08-20 23:05:01,2008-08-20 22:19:00
2ebc02d32a4360da2cf69c2b5f5bfad0716d42b0...fdb2a2a600969598fd80f01b009fbbb020d596ab,5,15,11,26,11,2008-08-19 05:37:55,2008-08-18 19:57:16
fdb2a2a600969598fd80f01b009fbbb020d596ab...180964f0b98344f3127d6b8167cec8a07ef663ad,2,11,32,43,10,2008-08-19 05:41:16,2008-08-18 20:01:06
2ebc02d32a4360da2cf69c2b5f5bfad0716d42b0...df0daf8ac0fce4bb98d5aff9295535a1606d2fad,1,2,2,4,2,2008-08-18 00:43:53,2008-08-14 18:02:20
df0daf8ac0fce4bb98d5aff9295535a1606d2fad...6a992e9e1da08af3e36ab90d5f5b7ee8077630ce,1,16,31,47,8,2008-08-18 00:43:53,2008-08-14 18:02:20
6a992e9e1da08af3e36ab90d5f5b7ee8077630ce...695605b5080e1957bd9dab1fed35a7fee9814297,1,23,32,55,8,2008-08-18 00:43:53,2008-08-14 18:02:20
695605b5080e1957bd9dab1fed35a7fee9814297...3bd62c21760f92996569bb9335b399a9545a5c41,2,82,140,222,29,2008-08-18 00:43:53,2008-08-14 18:02:20
3bd62c21760f92996569bb9335b399a9545a5c41...460c201039471d22194ca871290c098bfe6ce6a3,1,34,42,76,11,2008-08-26 05:49:49,2008-08-24 20:27:10
2ebc02d32a4360da2cf69c2b5f5bfad0716d42b0...f5b904db6b02e0ded76732eabe106069a87859fd,1,9,8,17,2,2008-08-18 00:42:02,2008-08-17 04:56:24
f5b904db6b02e0ded76732eabe106069a87859fd...798a94500230e4d2a1a18f005fe9592454fe451b,2,33,0,33,2,2008-08-18 00:42:02,2008-08-16 13:01:23
2ebc02d32a4360da2cf69c2b5f5bfad0716d42b0...9f2b6d2936a7c4bb3155de8efec7b10869ca935e,1,20,6,26,5,2008-08-18 00:41:53,2008-08-17 04:25:40
2ebc02d32a4360da2cf69c2b5f5bfad0716d42b0...19a31f9c1a6b18abd8a7f20d616516afca36a6a3,2,39,2,41,5,2008-08-17 23:29:22,2008-08-10 23:10:04
2ebc02d32a4360da2cf69c2b5f5bfad0716d42b0...ffa9fd957039902c9a08946d82ccb729a34ed68b,1,4,1,5,2,2008-08-17 23:27:17,2008-08-11 22:35:11
2ebc02d32a4360da2cf69c2b5f5bfad0716d42b0...036d17feda327c509c712dd1054a12d067166667,1,9,0,9,2,2008-08-17 23:26:21,2008-08-11 06:46:24
036d17feda327c509c712dd1054a12d067166667...84102a338df08a365ed0336304322adc05bc1581,2,5,5,10,3,2008-08-17 23:26:26,2008-08-11 06:46:25
2ebc02d32a4360da2cf69c2b5f5bfad0716d42b0...90fb46ec83cd837364592ce4d95055a3b6fe89a4,1,4,4,8,2,2008-08-17 23:24:46,2008-08-10 20:22:21
1b118da8bd1878d78589afd9f755b9d52a9579ad...1eff26c0e25652ec60e1f9f1c35fc02c8ad22d98,1,3,0,3,3,2008-09-06 23:16:42,2008-09-04 09:41:22
1eff26c0e25652ec60e1f9f1c35fc02c8ad22d98...aaefbfa66c348a461b3081873ef42819c8b38dac,1,20,3,23,7,2008-09-06 23:18:38,2008-09-06 23:18:31
71b9979bc74b66c1cf961d5c74de5c0b3cbf00a4...a57114c81832a70efda4991131b9b99d1b112ea3,1,19,12,31,4,2008-08-11 08:35:47,2008-08-08 20:48:23
a57114c81832a70efda4991131b9b99d1b112ea3...7cccfaa2809a09cb321a5f1276c5b91a71594527,1,7,3,10,2,2008-08-11 08:35:47,2008-08-10 16:12:53
7cccfaa2809a09cb321a5f1276c5b91a71594527...140b378d07229e3bcef0613e11aa0a04e4db3ecf,2,39,9,48,8,2008-08-11 08:35:47,2008-08-10 16:12:58
140b378d07229e3bcef0613e11aa0a04e4db3ecf...5bf707cde14f60b7a066bdab5dbdefaec1a1d0a9,1,14,0,14,1,2008-08-11 08:35:47,2008-08-10 16:13:04
ea3594e04184475226109a21e71c539ff5f139fd...7c695619868d0b867c87b0bb83303e058e010ac5,1,1,1,2,1,2008-08-21 06:18:53,2008-08-20 02:18:23
7c695619868d0b867c87b0bb83303e058e010ac5...99b120af7081ea9eb03a5f2a605d2bab771cf634,1,3,2,5,2,2008-08-22 06:14:09,2008-08-21 23:54:01
04bb50f45dda9aeb755e943cbc9df264cfc8cbc5...1168d402d2962f56cbc921bbc954d8f2179c8ba7,7,9,9,18,9,2008-08-06 04:21:18,2008-08-05 16:12:05
1168d402d2962f56cbc921bbc954d8f2179c8ba7...bd2d4f96b34ae295413f35eab687d7eff26564ee,1,6,2,8,2,2008-08-06 04:21:19,2008-08-05 07:35:16
bd2d4f96b34ae295413f35eab687d7eff26564ee...d9042a0ac41ebd23e4dac00371a682d964eafee7,1,11,4,15,2,2008-08-06 04:21:19,2008-08-05 07:35:17
d9042a0ac41ebd23e4dac00371a682d964eafee7...80828488cc5b1fd8395a27e272fa5f855c1ae472,1,40,29,69,24,2008-08-06 04:21:19,2008-08-05 07:35:18
80828488cc5b1fd8395a27e272fa5f855c1ae472...3eb11012078e9a2b9f444dbf1aae1f1cdd33fef1,1,26,0,26,2,2008-08-06 04:21:19,2008-08-05 05:50:31
3eb11012078e9a2b9f444dbf1aae1f1cdd33fef1...4181c7e8a7ece0cf117e7ec6bb8bca989e116f7e,1,15,0,15,2,2008-08-06 04:21:19,2008-08-05 05:50:32
4181c7e8a7ece0cf117e7ec6bb8bca989e116f7e...5dad868b26919b03dd78fba182a152224a904d3a,1,19,0,19,2,2008-08-06 04:21:19,2008-08-05 05:50:33
5dad868b26919b03dd78fba182a152224a904d3a...a6c2be244f45432617944e684156556482fb11b6,1,13,0,13,2,2008-08-06 04:21:19,2008-08-05 05:50:34
a6c2be244f45432617944e684156556482fb11b6...95d43780cff575cfffeea881464c77f84f8d7244,2,12,2,14,3,2008-08-06 04:21:19,2008-08-05 05:50:35
95d43780cff575cfffeea881464c77f84f8d7244...b3191ce2d5a77c17e5a236823f2dc7393e440171,1,24,0,24,2,2008-08-06 04:21:19,2008-08-05 05:50:36
b3191ce2d5a77c17e5a236823f2dc7393e440171...b1bc1494edb1775e94a159dea67908b27c29017f,1,21,0,21,2,2008-08-06 04:21:19,2008-08-05 05:50:37
b1bc1494edb1775e94a159dea67908b27c29017f...1127c51cfe09f0d7d26869e7a895190214ce049a,1,13,0,13,2,2008-08-06 04:21:20,2008-08-05 05:50:38
1127c51cfe09f0d7d26869e7a895190214ce049a...3d32a46b247222a97007419fa865efce959b002d,2,5,6,11,3,2008-08-06 04:21:20,2008-08-05 18:01:50
3d32a46b247222a97007419fa865efce959b002d...ddd63e64e4ac7e455dff3e807bf6a6977bb61456,1,8,1,9,3,2008-08-06 04:21:20,2008-08-05 20:08:41
93310a40eb022a0e36e7c618921931d8ffc31fd1...38bd64979a2a3ffa178af801c6a62e6fcd658274,1,5,0,5,5,2008-07-22 07:09:49,2008-07-21 09:23:43
93310a40eb022a0e36e7c618921931d8ffc31fd1...59eb68aa2b4e52aa1d098e0d76c5130864ceff2e,43,43,43,86,43,2008-07-21 19:14:42,2008-07-21 19:14:42
59eb68aa2b4e52aa1d098e0d76c5130864ceff2e...51ef1daa4a0dfaa4d777b2fa949ba051cf800554,13,58,54,112,41,2008-07-22 01:51:47,2008-07-21 10:51:02
51ef1daa4a0dfaa4d777b2fa949ba051cf800554...c455c87c5cd42bbbe586b31cea1143132f3a39e4,28,556,553,1109,232,2008-07-22 02:11:50,2008-07-21 18:03:49
c455c87c5cd42bbbe586b31cea1143132f3a39e4...e57c817d9f8f67d93c9fdea30939c52a2ab44fc4,1,1,1,2,1,2008-07-22 02:17:23,2008-07-21 18:34:06
e57c817d9f8f67d93c9fdea30939c52a2ab44fc4...107623239a0514052ca6431eca18405c76d9d658,1,1,1,2,1,2008-07-22 02:41:17,2008-07-22 02:41:17
107623239a0514052ca6431eca18405c76d9d658...75e1645fbe5e0309fbab8c2bfeaebe2c505e679d,1,1,1,2,1,2008-07-22 02:56:56,2008-07-21 14:12:20
75e1645fbe5e0309fbab8c2bfeaebe2c505e679d...0d4ede9f5493f0e15fb4f799e6a4a25e36c49fd2,1,3,3,6,2,2008-07-22 03:09:12,2008-07-21 13:34:29
0d4ede9f5493f0e15fb4f799e6a4a25e36c49fd2...d5d745f90b929310f3893bb8b3766cc1745140c8,2,8,1,9,2,2008-07-22 04:20:04,2008-07-21 18:30:36
d5d745f90b929310f3893bb8b3766cc1745140c8...c79cc2e59672fa03985f27ecdbea84e06ea5358f,1,1,1,2,1,2008-07-22 04:21:51,2008-06-30 10:08:16
c79cc2e59672fa03985f27ecdbea84e06ea5358f...ac2e28c0a43ced3837fbbcf66fd693244b6c6693,11,190,123,313,17,2008-07-22 04:33:16,2008-07-20 08:33:46
ac2e28c0a43ced3837fbbcf66fd693244b6c6693...1719b5e446f54e4196903ae6ed5f8867a5755bf6,2,24,25,49,6,2008-07-22 05:29:46,2008-07-21 16:10:47
1719b5e446f54e4196903ae6ed5f8867a5755bf6...5d2299de2d9ff01318bc02ea8c7fbf8d3a699ae0,1,1,0,1,1,2008-07-22 05:32:53,2008-07-22 05:32:53
5d2299de2d9ff01318bc02ea8c7fbf8d3a699ae0...d1f63a37caae19314bbd55c9fe3554d2e53537e7,1,1,1,2,2,2008-07-22 05:36:29,2008-07-21 18:15:59
d1f63a37caae19314bbd55c9fe3554d2e53537e7...95f8ebbfc7997b3114d4f09360501324905c4e6d,2,18,5,23,5,2008-07-22 07:06:04,2008-07-21 13:39:06
95f8ebbfc7997b3114d4f09360501324905c4e6d...0dda1d1ec816c613c9c0fd9b55ef0d3b782b84e8,1,2,2,4,2,2008-07-22 22:28:22,2008-07-22 11:09:47
0dda1d1ec816c613c9c0fd9b55ef0d3b782b84e8...8f0359f0a611fef9840218ba61162e9916124e89,2,3,1,4,2,2008-07-23 18:14:47,2008-07-21 21:28:49
8f0359f0a611fef9840218ba61162e9916124e89...2d71bde2d1a8f4e1c06cb8049a794ba4ba35d37d,1,1,1,2,1,2008-07-23 18:33:34,2008-07-22 16:48:57
2d71bde2d1a8f4e1c06cb8049a794ba4ba35d37d...4d175ef71d60086b898e4d871e699794d6a93dbf,1,15,0,15,1,2008-07-23 18:33:40,2008-07-22 17:05:59
4d175ef71d60086b898e4d871e699794d6a93dbf...2b14d07237fb6a52a55e89dde027e40aa627789d,3,12,12,24,12,2008-07-23 18:35:01,2008-07-22 21:17:43
2b14d07237fb6a52a55e89dde027e40aa627789d...9a885fac0d530854f81eb6f4c4e19380ea041047,1,2,2,4,2,2008-07-23 18:35:16,2008-07-22 21:16:25
9a885fac0d530854f81eb6f4c4e19380ea041047...03b9dfb18ba451a2221601b740004befa7614c5b,2,2,2,4,2,2008-07-23 18:35:23,2008-07-22 21:16:54
03b9dfb18ba451a2221601b740004befa7614c5b...09b78bc1fc4e525bc68fa0ce76521457717fe675,1,5,3,8,2,2008-07-23 18:36:31,2008-07-22 21:21:10
09b78bc1fc4e525bc68fa0ce76521457717fe675...c65233fe2c14ca10da847e49b54924c9a49498c5,1,2,1,3,1,2008-07-23 18:36:41,2008-07-22 21:23:31
c65233fe2c14ca10da847e49b54924c9a49498c5...7d90c8ee15d8dcb1450d1ffc2890e5341c963598,1,3,3,6,1,2008-07-23 18:36:56,2008-07-22 21:41:41
7d90c8ee15d8dcb1450d1ffc2890e5341c963598...ce567d1867a02a324615079cdd4badea5d0108a6,1,59,0,59,1,2008-07-23 18:52:21,2008-07-23 00:50:35
ce567d1867a02a324615079cdd4badea5d0108a6...e358f3c31e1ae9f653e9b2a6be69f5df53b4ba7e,3,8,10,18,8,2008-07-23 19:00:21,2008-07-23 00:51:36
e358f3c31e1ae9f653e9b2a6be69f5df53b4ba7e...a8ccc204c5daf4dae4071907499055d2dc9995db,1,1,1,2,1,2008-07-23 19:02:57,2008-07-23 07:46:35
a8ccc204c5daf4dae4071907499055d2dc9995db...c8fe1980b2b8e5c61f05a59d3bf9dedd5afa8faa,2,2,2,4,2,2008-07-23 19:31:37,2008-07-23 16:46:36
c8fe1980b2b8e5c61f05a59d3bf9dedd5afa8faa...47629dcff0fc75d58f9319d221a78934358e4ef8,1,2,2,4,2,2008-07-23 23:57:03,2008-07-23 20:33:44
47629dcff0fc75d58f9319d221a78934358e4ef8...0f31d68030752b0c1e02a1a092c18094a98202f0,1,3,7,10,4,2008-07-23 23:57:03,2008-07-23 21:52:47
0f31d68030752b0c1e02a1a092c18094a98202f0...68067ca1efcbb0408b931e08654a5e32de975ced,1,38,21,59,20,2008-07-23 23:57:04,2008-07-23 22:13:41
68067ca1efcbb0408b931e08654a5e32de975ced...a4661b018d46699fd6a9f59932e60267bae3ca2a,2,26,14,40,4,2008-07-23 23:57:04,2008-07-23 22:15:36
a4661b018d46699fd6a9f59932e60267bae3ca2a...a31c00b00eeadbc4b87ce2d578688e9b369a50fe,2,2,2,4,2,2008-07-23 23:57:09,2008-07-23 00:10:25
a31c00b00eeadbc4b87ce2d578688e9b369a50fe...ea3d988df7b0985fa164c7ace13e4c961c607a22,2,8,8,16,2,2008-07-23 23:57:13,2008-07-23 23:16:05
ea3d988df7b0985fa164c7ace13e4c961c607a22...3b6aeb3cc37c8ef934850fb01e1de48e12cf3aac,1,3,4,7,2,2008-07-23 23:57:14,2008-07-22 20:40:41
4c414e2e09607d53141573710ef6d79db2aa64ae...f01f81505a401f774855ae07dd1be01efde0cfbd,1,33,12,45,11,2008-04-19 05:09:24,2008-04-13 13:38:21
f01f81505a401f774855ae07dd1be01efde0cfbd...5634cf24766f8700804ca55f5e8567c88538a5b0,2,31,3,34,4,2008-04-19 05:10:38,2008-04-13 12:12:15
41a3e3aa9bdaede9ab7afed206428c1b071060d2...66aaa2fc22c8494d9019b241f5d6395a6044a895,3,48,1,49,4,2008-04-20 18:36:53,2008-04-20 18:36:53
d3e54c88291c2d880ff3a72167c5d3159aed8e97...25dc72007706a69c700fc14fef65440b250bf564,1,32,20,52,8,2008-04-16 23:45:23,2008-04-16 23:41:27
25dc72007706a69c700fc14fef65440b250bf564...11dc4e70c33c2fbbff19014035d3bf624da1902c,1,1,2,3,3,2008-04-16 23:46:26,2008-04-16 23:46:26
218bf69f0b137e0a21cfeeda6ba81947f220401f...2d84e9fb6d281ed039bd67aafcdd8516a2b5226e,2,15,2,17,5,2008-06-08 22:07:27,2008-06-08 14:04:33
2d84e9fb6d281ed039bd67aafcdd8516a2b5226e...0a392cb8cb4df41a82ac75e1052587b9a2c6f393,1,34,0,34,1,2008-06-08 22:07:41,2008-06-08 14:04:34
0a392cb8cb4df41a82ac75e1052587b9a2c6f393...f8d5ffc2c7c002cebb8842afcf58cbd4cea481b8,1,8,2,10,4,2008-06-08 22:08:19,2008-06-08 14:04:35
218bf69f0b137e0a21cfeeda6ba81947f220401f...e048a49f96172aecec96a5821a2177cbd49a24ed,1,1,1,2,1,2008-06-08 17:48:01,2008-06-08 14:34:40
e048a49f96172aecec96a5821a2177cbd49a24ed...d633c882db7cc79bf2d33df99cb0d1c2ef28c15d,1,3,26,29,4,2008-06-08 20:46:37,2008-06-07 18:39:20
d633c882db7cc79bf2d33df99cb0d1c2ef28c15d...39468defd306b7fb8ca0d381a2d66216a8eb9095,1,1,7,8,5,2008-06-08 20:46:37,2008-06-07 20:38:37
39468defd306b7fb8ca0d381a2d66216a8eb9095...88b1f0b8094638b1f9533393d1436d8c51fd07d5,1,3,3,6,1,2008-06-08 20:46:37,2008-06-07 16:20:19
88b1f0b8094638b1f9533393d1436d8c51fd07d5...c4a7ff52bda5c2e4cd08074ce4c27dbc0fc5242a,1,4,4,8,2,2008-06-08 20:46:37,2008-06-07 11:06:45
c4a7ff52bda5c2e4cd08074ce4c27dbc0fc5242a...55f409a826cbd574333dbc91d6f7e1e9888d696d,1,14,4,18,4,2008-06-08 20:46:37,2008-06-07 07:19:26
55f409a826cbd574333dbc91d6f7e1e9888d696d...9f7820ae574815e6a5c2a8c361a3c7e788d0930c,1,1,0,1,1,2008-06-08 20:46:38,2008-06-07 07:33:42
9f7820ae574815e6a5c2a8c361a3c7e788d0930c...d1eb35b653ddc1bb3fffde1729a7f10342525049,1,1,1,2,1,2008-06-08 20:46:38,2008-06-07 13:34:36
d1eb35b653ddc1bb3fffde1729a7f10342525049...bc47c29ec18164ba1f05600333457cf6f2432856,1,9,8,17,5,2008-06-08 20:46:38,2008-06-08 01:36:08
bc47c29ec18164ba1f05600333457cf6f2432856...3240240ff427fa2e26a847c7c9fd89e6a4313daa,56,394,210,604,209,2008-06-08 20:46:38,2008-06-08 01:36:09
3240240ff427fa2e26a847c7c9fd89e6a4313daa...459cf2e9857df069269aa733a7ce9df6f00f88ef,4,14,1,15,6,2008-06-08 20:46:38,2008-06-08 01:36:10
459cf2e9857df069269aa733a7ce9df6f00f88ef...a3800f66a64762ad518179dfacf4ac29f9d5a786,1,3,0,3,1,2008-06-08 20:46:38,2008-06-08 01:36:11
a3800f66a64762ad518179dfacf4ac29f9d5a786...eba1351f03060f0c949db044e8a3b36c862c4337,1,7,0,7,1,2008-06-08 20:46:38,2008-06-08 01:36:12
eba1351f03060f0c949db044e8a3b36c862c4337...d4c44443b665ee8e6bd638b5c1b3fa6aa2a1226c,1,8,3,11,3,2008-06-08 20:56:32,2008-06-08 15:26:15
d4c44443b665ee8e6bd638b5c1b3fa6aa2a1226c...457bb452919887ff5e8007d02e93f443fdb6f1e9,2,40,1,41,2,2008-06-08 21:27:46,2008-06-08 20:47:54
77aa0ae8d3599b905ceb25db8cc50d6820efb793...d277e89f87fda01daa1e1a35fc1f7118678faa1f,1,13,5,18,6,2008-09-21 23:11:37,2008-09-21 23:11:37
d277e89f87fda01daa1e1a35fc1f7118678faa1f...b8a640ee1aa45e0f874664417db8a05d5a0d48b0,1,1,1,2,1,2008-09-21 23:13:10,2008-09-08 07:28:16
b8a640ee1aa45e0f874664417db8a05d5a0d48b0...3945d2c05226d6c380a4f1b70f11941a6503a97e,1,9,9,18,9,2008-09-21 23:13:13,2008-09-12 09:39:43
3945d2c05226d6c380a4f1b70f11941a6503a97e...09c7029dfa58748268a6306bfe764456a65a22bf,1,63,11,74,27,2008-10-14 11:25:54,2008-10-13 08:12:31
09c7029dfa58748268a6306bfe764456a65a22bf...4db09304f97b12d7db5d199eebb1f24c74e12d17,1,34,1,35,6,2008-10-14 11:25:54,2008-10-13 08:12:33
4db09304f97b12d7db5d199eebb1f24c74e12d17...39ee47ef0616fb67ffdffca98283272c36deecc9,1,92,59,151,25,2008-10-15 11:23:03,2008-10-15 11:23:03
39ee47ef0616fb67ffdffca98283272c36deecc9...968ce45c9d2765b527d895b6933d20c0d104387c,1,1,1,2,1,2008-10-15 22:57:02,2008-10-15 22:57:02
968ce45c9d2765b527d895b6933d20c0d104387c...63767d5fb8fe236d8fdeba44297ac925701b27a0,1,1,0,1,1,2008-10-15 23:10:30,2008-10-14 20:53:25
63767d5fb8fe236d8fdeba44297ac925701b27a0...f2d0bbbd680b2a11cb42eff9a63d6ff03dd4d0e5,1,98,70,168,9,2008-10-17 11:44:42,2008-10-17 11:44:42
f2d0bbbd680b2a11cb42eff9a63d6ff03dd4d0e5...79056034bece6bf39140554eb48f293053828d4d,5,1037,966,2003,833,2008-10-18 11:23:33,2008-10-18 05:24:46
79056034bece6bf39140554eb48f293053828d4d...d375ef9b1483c3c828d78ce08adae6aae8e19f75,1,77,30,107,22,2008-10-20 23:18:52,2008-10-20 23:18:12
a0d74d160f3d416be8f7fbfd18fee0eebf40d8e0...20a55f4b2ef033dbb4a344e467716e03e13263a4,1,2,2,4,2,2008-08-17 06:21:18,2008-08-16 15:17:42
20a55f4b2ef033dbb4a344e467716e03e13263a4...9b752a6e31f93f2925856a0c0607c2ffc2a93375,1,16,5,21,6,2008-08-17 06:21:18,2008-08-17 04:25:43
9b752a6e31f93f2925856a0c0607c2ffc2a93375...053fd0c1c3da20474c4ff175c56ea4c1d6eeda11,1,9,4,13,5,2008-08-17 06:37:04,2008-08-01 19:50:03
8e7e6f39b6895b6623dc0f6053818704899f41a6...328eb9b32f7babfb182bad8655491aa6265e96eb,1,5,3,8,5,2008-06-14 18:47:55,2008-06-12 23:10:50
328eb9b32f7babfb182bad8655491aa6265e96eb...c8c6a2ecb48d717fe2735bf7790226021380d520,1,15,1,16,1,2008-06-14 18:47:56,2008-06-12 23:10:51
8e7e6f39b6895b6623dc0f6053818704899f41a6...3b2eb186bb738a374d9325b18710b19ec270e55f,4,6,6,12,6,2008-06-14 18:39:16,2008-06-14 07:25:56
3b2eb186bb738a374d9325b18710b19ec270e55f...74f16b0c6fece88f585f9556fa1d3a7406e7a42e,8,131,136,267,13,2008-06-14 18:39:16,2008-06-14 07:26:37
74f16b0c6fece88f585f9556fa1d3a7406e7a42e...44d86e910d61dab4f059d86705599bbb2747b10f,2,7,3,10,2,2008-06-14 18:39:16,2008-06-14 07:27:21
44d86e910d61dab4f059d86705599bbb2747b10f...4d9b53591f64a11da0af4c2b8f11fd4730ce52dd,2,9,8,17,2,2008-06-14 18:39:16,2008-06-14 07:27:45
4d9b53591f64a11da0af4c2b8f11fd4730ce52dd...9197240de82cb5bc45897860e0e93dc7c0b1a08f,1,0,1,1,1,2008-06-14 18:39:16,2008-06-14 07:28:07
da06a80322a2357b8b5b6ddb8b5648f97ed73e83...746c221ad063854e23661f6898c002c8726f5dad,1,24,8,32,6,2008-09-12 06:05:39,2008-09-10 15:54:28
da06a80322a2357b8b5b6ddb8b5648f97ed73e83...ee20a129de6f332da092e93feb2dd5f8330f9bc0,3,10,6,16,6,2008-09-10 22:25:46,2008-09-10 20:10:31
ee20a129de6f332da092e93feb2dd5f8330f9bc0...6bb6b0341af26739ba305b20c62a433f15029049,1,16,51,67,18,2008-09-10 23:11:00,2008-09-10 20:10:32
6bb6b0341af26739ba305b20c62a433f15029049...7a172b0dcb9d8ac2311a5c3f674f711476872e71,1,53,0,53,1,2008-09-10 23:11:05,2008-09-10 20:10:33
106db883b791efb7f39f3b2f8553236ba792a89e...4afbaefffa9095fe1391b4b61289a7dc954e9f7b,2,47,3,50,6,2008-09-03 00:10:37,2008-09-02 19:47:05
59d94bc9c851f9f4086a857bc6277feca6a48824...a8032d12241f2226a6ab98272b12a1d98ca446a5,1,17,10,27,8,2008-09-03 00:05:47,2008-09-02 14:22:20
a8032d12241f2226a6ab98272b12a1d98ca446a5...eede9f42b52b4001ffe844af061315b766682a69,1,8,0,8,1,2008-09-03 00:05:54,2008-09-02 14:22:21
eede9f42b52b4001ffe844af061315b766682a69...5f020f720298ddba537f857a240ffa7debb05f54,1,2,1,3,1,2008-09-03 00:05:56,2008-09-02 14:22:22
15dc66abf02fa22a03d709725bcaeeec4b809834...07ad5a157d5f73941abfc3a511725d32e4c023d4,2,0,19,19,4,2008-09-29 14:30:16,2008-09-25 09:41:04
07ad5a157d5f73941abfc3a511725d32e4c023d4...d317851a7fd07f28890e6dc9bc2269da37c4122e,1,6,1,7,2,2008-09-29 15:22:40,2008-09-23 06:52:16
d317851a7fd07f28890e6dc9bc2269da37c4122e...8252df62187e7fd35543552ffeab1e1eb048b57e,1,2,3,5,3,2008-09-29 15:55:47,2008-09-27 08:39:45
8252df62187e7fd35543552ffeab1e1eb048b57e...c11c7a5db3676258512c4067c5279377811d3ab8,1,52,0,52,1,2008-09-29 16:15:41,2008-09-27 11:44:15
9b8ae93ad92efef59649a3a7c4bed162d2051059...1b23adadf3adcf0074f61a498479a471964ab8c3,1,58,1,59,6,2008-09-03 23:27:59,2008-09-03 23:27:59
e89c6ea9988fc039a17875eb9cbdea245e96ed67...bab39ed371145b83340750101e7ec85167845857,2,26,1,27,4,2009-05-03 22:29:31,2009-05-03 22:20:03
bff82d0cdaf29ec0f8b1f5f166100770c044388f...db12d97542762cdb54d332ea047122f1071132b5,2,29,1,30,2,2009-04-09 06:40:33,2009-04-09 06:40:33
b0085a716770d9d2876edd74c6119c48d9d6f232...4f821012c3feb7c0a36be3849e971fbeff4fbc3b,1,9,6,15,4,2009-03-29 06:00:05,2009-03-29 05:10:08
4f821012c3feb7c0a36be3849e971fbeff4fbc3b...18d5cf908fe89c780872acc8a9f11d061e4556b6,1,3,3,6,3,2009-03-29 22:42:00,2009-03-29 19:34:50
18d5cf908fe89c780872acc8a9f11d061e4556b6...6e1825186bd052fc1f77b7c8c9a31fbb9a67d90c,1,34,32,66,7,2009-03-30 04:41:03,2009-03-29 01:39:10
6e1825186bd052fc1f77b7c8c9a31fbb9a67d90c...c18f75a1e96ff0f028edf94effd10cf56d892f22,1,48,4,52,3,2009-03-30 04:41:28,2009-03-29 01:39:11
3346330d708b9b786b16167cbbd4a3637b3a3517...38b7ccbe8c6615c709a4a69071c46593a1494952,1,2,2,4,2,2009-04-05 07:39:37,2009-04-04 10:35:22
3346330d708b9b786b16167cbbd4a3637b3a3517...f37ae35e73dbc492bd3ca24badb309817ecaaa67,1,74,0,74,1,2009-04-05 07:26:30,2009-04-05 00:46:58
f37ae35e73dbc492bd3ca24badb309817ecaaa67...0eb6574c24241b1e54be1ddff60287544faaf8d8,2,4,3,7,3,2009-04-05 07:26:32,2009-04-05 00:46:59
0eb6574c24241b1e54be1ddff60287544faaf8d8...39d8e271f42e976a61f08a4f7bc2047a682ac532,1,4,13,17,3,2009-04-05 07:26:33,2009-04-05 00:47:00
e986ceb05a118944d2638fba4cd09678c1afa6b3...ec2956df592338ccd789428e9232fe6b709dc2be,1,6,4,10,4,2009-03-19 02:09:35,2009-03-18 17:00:45
ec2956df592338ccd789428e9232fe6b709dc2be...40bac1512b0063ad3e235bca3cb66644ccf7e510,1,1,1,2,1,2009-03-19 02:10:14,2009-03-18 18:05:39
40bac1512b0063ad3e235bca3cb66644ccf7e510...092927c1b01632d030d9d746d36ad6dd02bc3967,1,4,4,8,1,2009-03-19 02:10:19,2009-03-18 18:05:40
092927c1b01632d030d9d746d36ad6dd02bc3967...ba150a3fdce48e4b973db6e153e6b3ffb28a0cea,1,2,1,3,1,2009-03-19 02:10:40,2009-03-18 20:53:27
ba150a3fdce48e4b973db6e153e6b3ffb28a0cea...1c192f3442414a6ce83f9a524806fc26a0861d2d,1,2,1,3,2,2009-03-19 02:11:34,2007-12-06 12:03:38
1c192f3442414a6ce83f9a524806fc26a0861d2d...b130a72b274441bb5d687de93efef4d990c40c0a,4,73,4,77,8,2009-03-19 02:23:04,2009-03-13 15:50:45
b130a72b274441bb5d687de93efef4d990c40c0a...5e75d56f1182c99364c9f5375665c814985f384d,1,7,0,7,1,2009-03-19 02:24:51,2009-03-18 20:53:39
5e75d56f1182c99364c9f5375665c814985f384d...570ccad33e067616865aa9697b90c7b927d6dcf4,2,9,0,9,2,2009-03-19 02:25:01,2009-03-18 20:53:49
e986ceb05a118944d2638fba4cd09678c1afa6b3...7fd3ef1fd73dffdb9b3445893ab579723ce08e74,2,3,3,6,3,2009-03-18 19:35:01,2009-03-06 23:04:09
7fd3ef1fd73dffdb9b3445893ab579723ce08e74...fae74a04d75e820c5150cfb0cb4c044bf4488007,10,15,15,30,15,2009-03-19 20:44:04,2009-03-01 18:52:51
fae74a04d75e820c5150cfb0cb4c044bf4488007...5b46a4285f3588eaa7e53d513025b28f9f5bfec7,3,22,19,41,9,2009-03-19 20:47:14,2009-03-17 21:45:22
5b46a4285f3588eaa7e53d513025b28f9f5bfec7...d5d9de1b10f478b57803f5f2868ed2334c84e09b,1,11,12,23,9,2009-03-19 20:47:14,2009-02-05 19:59:27
d5d9de1b10f478b57803f5f2868ed2334c84e09b...8586f98bd29bd4ad3d0e62a3be4a4d59ff8b27cd,3,5,11,16,10,2009-03-19 20:47:14,2009-02-05 20:20:56
8586f98bd29bd4ad3d0e62a3be4a4d59ff8b27cd...1f553918a8482ea792e8cd4d5d2c75fe60f68aae,7,24,43,67,15,2009-03-19 20:47:14,2009-02-28 20:12:57
1f553918a8482ea792e8cd4d5d2c75fe60f68aae...e2c2407683bf51c30004d2804623f2eb8e831b7a,1,3,3,6,1,2009-03-19 20:47:14,2009-03-11 16:58:32
e2c2407683bf51c30004d2804623f2eb8e831b7a...0aaaef7b0f83ccd97d586b5c951adcb912af2664,2,4,3,7,2,2009-03-19 20:47:14,2009-02-09 09:24:51
0aaaef7b0f83ccd97d586b5c951adcb912af2664...b689ccf6c9eecb9811f60ac69a24cadacf84da44,3,16,15,31,12,2009-03-19 20:47:15,2008-11-17 08:21:30
b689ccf6c9eecb9811f60ac69a24cadacf84da44...a8cbc9ab027dce3d99d0039a02ec9df0f0c7ebb1,1,2,2,4,1,2009-03-19 20:47:15,2009-03-12 19:32:43
5c415311f743ccb11a50f350ff1c385778f049d6...7a0d911f116e437628035d7b07035dbff707a172,2,9,9,18,3,2009-01-26 06:25:20,2009-01-26 06:25:20
7a0d911f116e437628035d7b07035dbff707a172...17507832ca9a5e54e2b65a5e1ad2d17255f1b925,1,13,3,16,3,2009-01-26 06:25:44,2009-01-25 23:45:32
17507832ca9a5e54e2b65a5e1ad2d17255f1b925...803918462e58005d18c0ab63686dbd9e91330dfe,1,12,11,23,4,2009-01-26 06:26:43,2009-01-25 23:45:33
9b99e641c11044dba661f574f9098d362a3f0ef8...4dc1db0bd1fc4eedea1ae8ceeee43cb0ea3322ca,1,1,1,2,1,2008-08-21 02:59:06,2008-08-21 00:34:30
4dc1db0bd1fc4eedea1ae8ceeee43cb0ea3322ca...711521e246ea7d7b9bb10a1607cdd0a6de6a9927,1,5,3,8,4,2008-08-21 06:48:07,2008-08-20 07:30:06
711521e246ea7d7b9bb10a1607cdd0a6de6a9927...a81892dd8c37b6f13793739721b520fee3ce4c2c,1,4,0,4,2,2008-08-21 08:53:44,2008-08-21 01:53:50
c6670b348cb19c74a6d7f6943df4871eb0d8295f...a624eaa7820f4f9814e41e911c665a0aba2fce34,3,56,0,56,5,2008-08-20 01:09:37,2008-08-15 11:39:26
a624eaa7820f4f9814e41e911c665a0aba2fce34...8b1d88e87adcff001a72706bda8dcdefdfb8da67,1,1,1,2,1,2008-08-20 02:33:01,2008-04-01 12:53:51
8b1d88e87adcff001a72706bda8dcdefdfb8da67...6457e58c8fc00ef1c72724dad5f8baf54cfee5a2,1,3,3,6,1,2008-08-20 02:33:12,2008-07-02 07:49:59
c6670b348cb19c74a6d7f6943df4871eb0d8295f...4cfc24afc9ffa4d3f1623be8990eea118e82d4fd,2,1,16,17,4,2008-08-20 01:05:39,2008-08-20 01:05:39
4cfc24afc9ffa4d3f1623be8990eea118e82d4fd...daa0cc9a92c9c2c714aa5f7da6d0ff65b93e0698,4,6,3,9,7,2008-08-20 08:36:10,2008-08-20 01:05:43
5630feaf370e15c01ef8a6aa469bfd656c1d1cd7...7c17205b64a0e668d8a6e59109043bd4f2af3a0c,2,3,0,3,2,2008-08-21 06:53:33,2008-08-20 15:57:07
7c17205b64a0e668d8a6e59109043bd4f2af3a0c...1a1fcf4abeb2ed4ef6075970788711cf62405158,2,5,2,7,4,2008-08-21 06:56:31,2008-08-20 17:49:15
faf1dc7223be9ffddf775916913bb8e22762cdfb...13494ed14c3539b3e36ff47d1d8b65f5a9a3043b,1,1,1,2,1,2008-11-02 06:46:34,2008-10-23 04:30:58
13494ed14c3539b3e36ff47d1d8b65f5a9a3043b...421b488a58fea89ceb55d5b358738e9251d44f5e,1,2,1,3,2,2008-11-02 06:46:40,2008-10-23 04:31:03
421b488a58fea89ceb55d5b358738e9251d44f5e...1442171bc913a9cddae5c6ad0d0a4be3a1ca86e8,1,1,1,2,1,2008-11-02 06:46:53,2008-10-23 04:32:23
1442171bc913a9cddae5c6ad0d0a4be3a1ca86e8...30affa1e9a15e848f77c9c14544dd6dd593559d5,1,7,1,8,1,2008-11-02 06:48:39,2008-10-29 05:17:55
30affa1e9a15e848f77c9c14544dd6dd593559d5...8c178687959732edab8bf91da9ed9f4fbcf7c14e,1,1,2,3,2,2008-11-02 06:48:45,2008-10-31 18:57:10
8c178687959732edab8bf91da9ed9f4fbcf7c14e...4f73e240f98c38e608afe68887639c6e63b1d18f,1,6,0,6,2,2008-11-02 06:48:48,2008-11-01 06:24:55
4f73e240f98c38e608afe68887639c6e63b1d18f...c2163c6aa2343b21ebc73f7e62cbdecc8dba3a42,1,27,0,27,1,2008-11-02 06:48:52,2008-11-01 15:28:18
c2163c6aa2343b21ebc73f7e62cbdecc8dba3a42...1a9016aae5aa8c468bb2d8d5dd16303d5c005869,2,30,1,31,2,2008-11-02 07:14:04,2008-11-02 07:14:04
30ef1d812cc57d128e1d4d666de4e9bb5577e9e3...ed70e4d7db69a66d833d1efe56606213bab807e1,1,2,2,4,2,2008-09-26 14:44:40,2008-09-26 14:44:40
ed70e4d7db69a66d833d1efe56606213bab807e1...d3bcf55d675a255c00d2743c00978e1f42c93572,1,1,9,10,2,2008-09-30 18:40:48,2008-09-24 19:08:01
d3bcf55d675a255c00d2743c00978e1f42c93572...0aea2842d9d556afa4a3e8120e465479ad7368ca,4,17,6,23,7,2008-09-30 18:47:33,2008-09-30 08:12:16
0aea2842d9d556afa4a3e8120e465479ad7368ca...34785f8ccabb12f684352902b7f201135b9ccd51,1,1,0,1,1,2008-09-30 19:59:18,2008-09-30 06:39:29
34785f8ccabb12f684352902b7f201135b9ccd51...3c1c2a00b2cba9dfeee6e2a3c44a0ad52fcff4a8,2,3,3,6,3,2008-09-30 19:59:18,2008-09-24 20:43:59
3c1c2a00b2cba9dfeee6e2a3c44a0ad52fcff4a8...8329bd07250e0b26b76105d299b6153a68c3c404,2,70,70,140,15,2008-09-30 19:59:18,2008-09-24 20:44:00
8329bd07250e0b26b76105d299b6153a68c3c404...ba6485e05d43abf66e6b651a41b1ddc511b0e5eb,3,209,0,209,3,2008-09-30 19:59:18,2008-09-24 20:44:01
ba6485e05d43abf66e6b651a41b1ddc511b0e5eb...0d4044123cb081bd690dece6505ffbcb8476e7ef,1,37,0,37,4,2008-09-30 19:59:18,2008-09-24 20:44:02
0d4044123cb081bd690dece6505ffbcb8476e7ef...adcbd431e7ae3c6356c50fa2559ac06ddb970008,1,2,1,3,2,2008-09-30 19:59:18,2008-09-24 20:44:03
adcbd431e7ae3c6356c50fa2559ac06ddb970008...2db21e709a1345d84178e53079e861232c243bd1,1,7,23,30,4,2008-09-30 19:59:18,2008-09-24 21:57:16
2db21e709a1345d84178e53079e861232c243bd1...afd5424085151990b5ac87da09e5cea76809d7c0,1,18,0,18,2,2008-09-30 19:59:18,2008-09-24 22:05:53
afd5424085151990b5ac87da09e5cea76809d7c0...bb4812bc0ae6e14b422ce3c45504965b523fdf84,1,5,0,5,3,2008-09-30 19:59:18,2008-09-24 22:07:02
bb4812bc0ae6e14b422ce3c45504965b523fdf84...4259568d722d0a46993ad945ffdba0f084448b37,3,4,4,8,4,2008-09-30 19:59:18,2008-09-24 22:12:50
4259568d722d0a46993ad945ffdba0f084448b37...902e2bb5b7473765acc388d051f5c1c7d42015d0,1,8,4,12,4,2008-09-30 19:59:18,2008-09-24 22:12:51
902e2bb5b7473765acc388d051f5c1c7d42015d0...2243ffcc6a445d1953297949e8e944fdc3df6ed7,1,2,1,3,1,2008-09-30 19:59:37,2008-09-24 23:32:47
2243ffcc6a445d1953297949e8e944fdc3df6ed7...0b32cab933e0d3d1e85d4cb86669e33ef478ef66,1,3,3,6,1,2008-09-30 19:59:37,2008-09-24 23:39:13
0b32cab933e0d3d1e85d4cb86669e33ef478ef66...a910898e86be79c580d1e643cdbee8a19a7cd691,1,1,1,2,1,2008-10-10 16:31:58,2008-10-08 08:03:54
a910898e86be79c580d1e643cdbee8a19a7cd691...d4d992562e8c6d27ac584ff0907ff840030a98d9,1,13,6,19,5,2008-10-10 16:33:21,2008-10-03 07:36:52
d4d992562e8c6d27ac584ff0907ff840030a98d9...f10d5b064ae5c9bcd6e353211f128f5c4072ed4f,3,227,3,230,13,2008-10-10 16:33:21,2008-10-03 07:36:53
f10d5b064ae5c9bcd6e353211f128f5c4072ed4f...5c91cb5d0dd06aa5574234a3d651098393adb4fa,1,8,1,9,2,2008-10-10 16:33:21,2008-10-03 07:36:54
5c91cb5d0dd06aa5574234a3d651098393adb4fa...f2df8a5bfb6b766b0362a2cb545d5226a268bf37,1,1,1,2,1,2008-10-10 16:33:21,2008-10-03 08:28:49
f2df8a5bfb6b766b0362a2cb545d5226a268bf37...7f15b0027392155f5b3260bb584ba37126232bf1,1,11,11,22,7,2008-10-10 16:33:21,2008-10-03 11:13:42
7f15b0027392155f5b3260bb584ba37126232bf1...98a6846bb8c5acb55d25d429954ec4ea2f4f320e,2,130,0,130,2,2008-11-01 23:01:23,2008-10-15 09:28:20
98a6846bb8c5acb55d25d429954ec4ea2f4f320e...8c76212529570aed70c46d6f252cb1a4010f3f2e,3,73,0,73,5,2008-11-01 23:01:34,2008-10-15 09:28:21
8c76212529570aed70c46d6f252cb1a4010f3f2e...63aa1d0cb78e8fcf36ea2b8b65750d9a45d59f63,1,0,1,1,1,2008-11-01 23:12:29,2008-10-14 11:48:37
63aa1d0cb78e8fcf36ea2b8b65750d9a45d59f63...9d83c6aa44d2ff68111865b6f72e7321e54a8972,1,233,46,279,27,2008-11-02 01:58:15,2008-10-25 20:51:05
aaefbfa66c348a461b3081873ef42819c8b38dac...5521883490e85f4d973141972cf16f89a79f1979,5,24,2,26,7,2008-09-10 05:55:22,2008-09-08 02:49:25
aaefbfa66c348a461b3081873ef42819c8b38dac...d8bdc49265559786533d7f7377b2c39038dd6309,1,7,5,12,3,2008-09-09 20:32:32,2008-08-22 00:31:50
aaefbfa66c348a461b3081873ef42819c8b38dac...8beb1f33d15af6cdb6bf7d8296fd73eb8df2f152,1,6,2,8,3,2008-09-09 15:37:48,2008-09-08 20:42:48
8beb1f33d15af6cdb6bf7d8296fd73eb8df2f152...c14c3c82da9a46c65008060ad8e6dacef1a24ba9,1,5,1,6,2,2008-09-09 15:57:21,2008-09-09 12:05:26
aaefbfa66c348a461b3081873ef42819c8b38dac...a5ccc5979d210500d00169f98cc8567ea346fcb0,1,10,1,11,1,2008-09-07 16:57:44,2008-02-21 23:10:37
af9552f03082a0cc0cf19d38ae14cc31f1b7fb37...ec3a4ba519c0012d58584d23f407c302e7b80eb6,1,7,2,9,3,2008-09-07 02:39:55,2008-09-07 01:22:00
3b6aeb3cc37c8ef934850fb01e1de48e12cf3aac...2c47789d817aaf745a5ce5d5f79619c634cc8566,2,2,2,4,2,2011-12-18 08:11:54,2011-12-18 05:03:22
3b6aeb3cc37c8ef934850fb01e1de48e12cf3aac...f9bbefc701e319983bb8e13df8d615293c6f386a,1,11,14,25,8,2008-07-23 23:57:14,2008-07-22 22:03:01
f9bbefc701e319983bb8e13df8d615293c6f386a...eb72a51407228c8c7947e762d4f1c320712c9052,1,1,1,2,1,2008-07-23 23:57:14,2008-07-22 22:24:35
eb72a51407228c8c7947e762d4f1c320712c9052...e8a43a132d97165f6e56fa03923a3933cfedde81,1,1,1,2,1,2008-07-23 23:58:09,2008-07-23 20:08:27
e8a43a132d97165f6e56fa03923a3933cfedde81...08c701d4761abf58dce607e84bf41fb280e38a9e,1,15,0,15,2,2008-07-24 00:06:30,2008-07-23 21:21:08
08c701d4761abf58dce607e84bf41fb280e38a9e...2ca880fe54660869bc93a2302efced9ab64511d9,1,17,1,18,2,2008-07-24 00:06:36,2008-07-23 21:36:15
2ca880fe54660869bc93a2302efced9ab64511d9...0c4cd7f4a7aae5527560090aad7ef8dae85f1264,1,1,1,2,1,2008-07-24 01:11:04,2008-07-24 00:22:58
0c4cd7f4a7aae5527560090aad7ef8dae85f1264...186458b11b090835fa793bcdbf6b5552b053276c,4,4,4,8,4,2008-07-24 01:38:14,2008-07-23 23:09:35
66aaa2fc22c8494d9019b241f5d6395a6044a895...37152d831048a0b30600a7b7e7926af2d5bcfab8,1,8,0,8,1,2008-04-22 05:50:21,2008-04-21 18:15:52
37152d831048a0b30600a7b7e7926af2d5bcfab8...f45741390844778f5b286cf6607cd767636e5c57,1,1,0,1,1,2008-04-22 05:52:15,2008-04-20 19:32:47
f45741390844778f5b286cf6607cd767636e5c57...bbd4c307fc315847c975efd4c9aa32eb0e8470fb,1,1,1,2,1,2008-04-22 06:30:11,2008-04-20 21:03:56
bbd4c307fc315847c975efd4c9aa32eb0e8470fb...85d17a123ba59b90744e311e40f80fd8838fbdc5,1,2,2,4,2,2008-04-22 06:30:55,2008-04-20 21:23:38
85d17a123ba59b90744e311e40f80fd8838fbdc5...71bd81ade2973a304889d94426c922cc096019a2,1,2,1,3,2,2008-04-22 06:36:56,2008-04-21 13:44:44
11dc4e70c33c2fbbff19014035d3bf624da1902c...29df2385d09611219c53d07f453794d6146e73a3,1,1,1,2,1,2008-04-18 23:11:40,2008-04-18 23:11:40
457bb452919887ff5e8007d02e93f443fdb6f1e9...2d35d556e27cd3e7f3d2eea04a7f0d7ee8513f8e,3,61,22,83,4,2008-06-09 22:08:26,2008-06-08 15:16:11
457bb452919887ff5e8007d02e93f443fdb6f1e9...3a5b919cf220651b681b5f036bf3bd1c61e36ef2,1,2,99,101,3,2008-06-09 21:56:16,2008-06-06 07:53:32
457bb452919887ff5e8007d02e93f443fdb6f1e9...008d896df5deaa967d4d86306b408333e8ef34c3,6,33,0,33,7,2008-06-09 21:53:46,2008-06-08 16:42:33
457bb452919887ff5e8007d02e93f443fdb6f1e9...4e44ae45fe96c6972c3e5d4aac2a149972429deb,1,1,1,2,1,2008-06-09 20:31:23,2008-06-08 23:03:13
4e44ae45fe96c6972c3e5d4aac2a149972429deb...3c076dbe3cffee3b5cbf34759d627c47a417c145,2,27,6,33,3,2008-06-09 20:46:08,2008-06-09 00:02:21
7eef32d9f4883d983e284f5c508a92833bd89d11...a9a3e82e6d0018ff42ec11fd9560c1ff47add824,2,27,3,30,6,2008-07-10 03:31:44,2008-07-10 02:58:23
d375ef9b1483c3c828d78ce08adae6aae8e19f75...bee866fa6b5a77f65d9915f8778919ef76d9d6c1,1,23,5,28,6,2008-10-21 11:37:36,2008-10-08 07:05:35
bee866fa6b5a77f65d9915f8778919ef76d9d6c1...2df6442f7dc0d6cd5636e6ac413d06f92eb04029,1,4,2,6,4,2008-10-21 11:37:39,2008-10-08 07:05:37
2df6442f7dc0d6cd5636e6ac413d06f92eb04029...7cdc3556d1cec11582ae2a018d4052767c02e1ef,1,146,2,148,15,2008-10-26 11:03:40,2008-10-24 08:13:01
7cdc3556d1cec11582ae2a018d4052767c02e1ef...190ec52c901b1e003f73ad97e88f4626d20a9e4e,1,33,27,60,10,2008-10-27 10:13:37,2008-10-27 10:13:37
190ec52c901b1e003f73ad97e88f4626d20a9e4e...8a8977425e2697029414c3bcf4b627b074934bbc,1,153,7,160,25,2008-10-27 10:36:25,2008-10-27 10:36:25
8a8977425e2697029414c3bcf4b627b074934bbc...e3e901bece93417392faa3dd7833d69271cf74f6,1,12,4,16,7,2008-10-27 11:37:21,2008-10-27 11:37:21
053fd0c1c3da20474c4ff175c56ea4c1d6eeda11...f223824943e23e593b5e9cc647417a4267acc82d,3,7,3,10,5,2008-08-17 08:01:42,2008-08-15 04:20:20
053fd0c1c3da20474c4ff175c56ea4c1d6eeda11...bfdbee98109c5ad2dbbc392e7eed1ae688acc039,51,152,134,286,116,2008-08-17 07:41:52,2008-08-08 09:26:28
053fd0c1c3da20474c4ff175c56ea4c1d6eeda11...b259f09b181c6650253f2ab60f5375d3ff8e3872,1,11,2,13,1,2008-08-17 07:24:21,2008-08-16 17:58:32
053fd0c1c3da20474c4ff175c56ea4c1d6eeda11...16ce2e4c8f9664f8ec5ae2bffed34d093d83a4d3,2,5,0,5,2,2008-08-17 07:22:45,2008-08-17 06:02:08
b994ec142f296c7118823495764151c2a6227e1a...69c61c4fa9a4b38eeb611a86102493394cdeb9cf,2,7,4,11,4,2008-06-14 19:47:31,2008-06-14 09:48:00
69c61c4fa9a4b38eeb611a86102493394cdeb9cf...1d284cbae3abd5fb6f58dd5282ba0e93eb68e6c6,1,4,1,5,1,2008-06-14 19:47:44,2008-06-14 09:48:01
1d284cbae3abd5fb6f58dd5282ba0e93eb68e6c6...66115d363a93b9e7c9b937773c0c30f81b766d45,1,1,1,2,1,2008-06-14 19:48:06,2008-06-14 18:37:59
66115d363a93b9e7c9b937773c0c30f81b766d45...7c1a9e7901a0e75eab8c7fb34d17c09652d47f7f,1,1,1,2,1,2008-06-14 19:53:09,2008-06-14 10:02:22
7c1a9e7901a0e75eab8c7fb34d17c09652d47f7f...9adefee5b5811c57c30cf81804127b59b235538a,1,1,1,2,1,2008-06-14 20:00:01,2008-06-14 18:14:12
9adefee5b5811c57c30cf81804127b59b235538a...5723fe7e3cbbefae78bfb79c46b7716eef76fe52,1,42,41,83,4,2008-06-14 21:39:22,2008-06-14 17:50:12
5723fe7e3cbbefae78bfb79c46b7716eef76fe52...44d1c19ee8ab405108b90ab9c02cd86a014639e8,1,44,26,70,8,2008-06-14 21:39:22,2008-06-14 18:32:37
44d1c19ee8ab405108b90ab9c02cd86a014639e8...c529d75a75adf943f53dd20b8cf3e37438b4e750,1,8,10,18,8,2008-06-14 21:39:22,2008-06-14 18:43:01
c529d75a75adf943f53dd20b8cf3e37438b4e750...52cb2bc28b8336a3f2259bb1c6ad2b99c3caca9c,1,1,1,2,1,2008-06-14 21:39:22,2008-06-14 19:57:18
52cb2bc28b8336a3f2259bb1c6ad2b99c3caca9c...557040618ddca15fbb8d903a737da72df8365a8e,1,4,2,6,1,2008-06-15 20:33:48,2008-06-15 13:39:20
557040618ddca15fbb8d903a737da72df8365a8e...b96317f38ffea4a869aa5e61e435cf61dc72349d,1,0,3,3,1,2008-06-15 20:34:32,2008-06-15 10:13:22
b96317f38ffea4a869aa5e61e435cf61dc72349d...8da1e21231a039889507f4d727882bd0a64e5b95,4,5,5,10,4,2008-06-15 20:35:10,2008-06-15 10:14:12
8da1e21231a039889507f4d727882bd0a64e5b95...d0594be162adb102c6b6d0e701c578054fcb3885,1,8,0,8,1,2008-06-15 20:43:32,2008-06-15 20:43:32
d0594be162adb102c6b6d0e701c578054fcb3885...1d53f90ed97733a36057afab7d63038a5d93a094,1,4,4,8,1,2008-06-15 20:44:44,2008-06-15 10:16:01
1d53f90ed97733a36057afab7d63038a5d93a094...4744d72393defef27fb76f047c2fac53ff6fb9ff,1,4,1,5,2,2008-06-15 20:47:14,2008-06-15 20:47:14
4744d72393defef27fb76f047c2fac53ff6fb9ff...336d09daf288492946f0c51f071da11643f8363d,2,17,0,17,2,2008-06-15 22:54:06,2008-06-15 21:37:42
746c221ad063854e23661f6898c002c8726f5dad...d333ac178547946271afc41885d3ea9914500a47,1,1,1,2,1,2014-09-18 17:17:53,2014-09-17 12:14:39
b281eea75f0ab68e3c9510323c73b78cd3e62814...628b06d7d75588bbe37dfb7ecac19d2694884d66,2,15,3,18,2,2008-09-10 22:00:17,2008-09-10 19:22:35
628b06d7d75588bbe37dfb7ecac19d2694884d66...6fe570de05513bc13ac1e00ab3508ca525b41135,3,13,0,13,4,2008-09-10 22:40:13,2008-09-09 20:44:17
6fe570de05513bc13ac1e00ab3508ca525b41135...414851a42ecd6f104de517f628cfc09465ea7fa5,2,18,3,21,5,2008-09-10 22:41:51,2008-09-10 08:19:34
414851a42ecd6f104de517f628cfc09465ea7fa5...ede4caf6e3204f9d63758d6410d0f124b0caab32,1,1,1,2,1,2008-09-10 22:42:56,2008-09-10 11:03:18
1b23adadf3adcf0074f61a498479a471964ab8c3...5e9bf11c1a3052f01f86d7eb28ae4c5b8d9c7495,1,10,2,12,2,2008-09-05 00:01:41,2008-09-04 21:38:08
5e9bf11c1a3052f01f86d7eb28ae4c5b8d9c7495...cab4feb67db64d3d201145d9748b33d148f96185,3,37,35,72,6,2008-09-05 00:01:41,2008-09-04 21:39:21
cab4feb67db64d3d201145d9748b33d148f96185...3b3d443feb1e7464c81e9a29c9b237cd6fa01fe5,2,22,0,22,4,2008-09-05 00:01:41,2008-09-04 21:40:03
f2ad051fd120714cbe9dcee5d94942e0105bb0aa...76d3cc50b518d1c28d802ad2917063d8a5d34419,1,6,2,8,2,2009-03-30 16:19:37,2009-03-30 10:11:40
76d3cc50b518d1c28d802ad2917063d8a5d34419...01eadafccbeae485503f5373dc60cc5a04877c3b,1,4,9,13,4,2009-03-30 16:20:41,2009-03-30 10:11:41
be18f4b899a94ff51ff3c621822500579cf6df6a...835a3eea3e18695e29b1d4c3adca37d1caaa16ef,1,1,1,2,1,2009-04-05 08:16:31,2009-03-31 15:50:12
8130949bdc9c36f527148205b86a2ffe551cac53...e96f3689ecd95997a2a474c2b7f21b0a67f138b1,1,19,2,21,6,2009-04-02 20:42:24,2009-04-02 20:42:24
eed1fcd76d8893ab687c700e1729faea025ba7a8...d7d9c2d04962b5aec34ec891d82dd74262306c56,3,22,0,22,3,2009-03-28 06:49:50,2009-03-26 16:51:05
eed1fcd76d8893ab687c700e1729faea025ba7a8...57dac0bfe43a68d55e16def58b8ed305e0676d3f,1,9,1,10,2,2009-03-27 08:08:36,2009-03-26 20:53:24
57dac0bfe43a68d55e16def58b8ed305e0676d3f...5e6e2b487e76066d03b4f5809dc6b44b1234519a,2,6,3,9,3,2009-04-01 22:48:30,2009-04-01 21:42:49
eed1fcd76d8893ab687c700e1729faea025ba7a8...c30e9485238bb8e9daa4cbba5deb1f79c8da7dde,3,31,1,32,2,2009-03-27 07:33:19,2009-03-27 06:43:58
c30e9485238bb8e9daa4cbba5deb1f79c8da7dde...ae8d09b8fa138aeb8ec3e20819360241dfb9f0b8,3,46,52,98,10,2009-03-27 07:33:19,2009-03-27 06:43:59
ae8d09b8fa138aeb8ec3e20819360241dfb9f0b8...8fa2b45f3a70a1622c8fc5d35af148da5cab80d1,2,32,5,37,7,2009-03-27 07:33:19,2009-03-27 06:44:00
8fa2b45f3a70a1622c8fc5d35af148da5cab80d1...9d8d13a8c52c55ad4695b659cbffa61e4c3a3774,2,4,4,8,2,2009-03-27 07:33:19,2009-03-27 06:44:01
9d8d13a8c52c55ad4695b659cbffa61e4c3a3774...34c800b8fcbd85c276cb102b3e60d170aa9e55e0,2,13,13,26,2,2009-03-27 07:33:19,2009-03-27 06:44:02
34c800b8fcbd85c276cb102b3e60d170aa9e55e0...dad3211503e2760a0e704b3c617849ba298a76e7,1,2,2,4,2,2009-03-27 07:33:19,2009-03-27 06:44:03
dad3211503e2760a0e704b3c617849ba298a76e7...0c04f5273579da4b8308c125b1eb4b8f888bffab,1,2,1,3,2,2009-03-27 07:33:20,2009-03-27 06:44:04
0c04f5273579da4b8308c125b1eb4b8f888bffab...5121a6d99368906292dfdf7fe0047fb89c4c1969,2,22,1,23,4,2009-03-27 07:33:20,2009-03-27 06:44:05
eed1fcd76d8893ab687c700e1729faea025ba7a8...bb2300976ba1491a54dc2b82819fae68d59d6e53,1,55,29,84,24,2009-03-27 07:28:51,2009-03-27 06:49:38
bb2300976ba1491a54dc2b82819fae68d59d6e53...c6a5ad21e57ce38a0add04a2708ccf02ed17af39,1,7,4,11,3,2009-03-27 07:29:39,2009-03-27 06:49:39
eed1fcd76d8893ab687c700e1729faea025ba7a8...9fe00538c693929d4dec29690fe7660106fe056a,1,1,1,2,1,2009-03-26 16:38:58,2009-03-26 09:39:04
570ccad33e067616865aa9697b90c7b927d6dcf4...cd4371208a0e9f882f6fd4b4dd28d6911848ec79,3,78,6,84,7,2009-03-20 07:57:27,2009-03-20 06:00:43
a8cbc9ab027dce3d99d0039a02ec9df0f0c7ebb1...f17e9fbbe919bc1f4ecaa35a9cb0869a5ec47fc0,1,13,0,13,1,2009-03-19 21:04:25,2009-03-11 20:17:26
f17e9fbbe919bc1f4ecaa35a9cb0869a5ec47fc0...5397ea314f612eaaacfb13d978319afd2c724817,1,3,0,3,1,2009-03-19 21:04:25,2009-03-14 21:21:27
5397ea314f612eaaacfb13d978319afd2c724817...4114156ae959a8ecfea62213df35fd8f778d9c4e,3,7,3,10,4,2009-03-19 21:04:25,2009-03-13 22:35:24
4114156ae959a8ecfea62213df35fd8f778d9c4e...64e61f2d173b0172d9dbaa9667486764224568fb,1,26,2,28,4,2009-03-19 21:04:25,2009-03-04 18:40:27
64e61f2d173b0172d9dbaa9667486764224568fb...a7bb394037e1c32d47d0b04da025bdbe2eb78d66,2,54,5,59,10,2009-03-21 20:09:27,2009-03-01 20:04:46
a7bb394037e1c32d47d0b04da025bdbe2eb78d66...56e78bfb299207213ff170238c34a1dc8fa67c09,1,30,28,58,6,2009-03-22 16:25:47,2009-02-26 22:09:00
56e78bfb299207213ff170238c34a1dc8fa67c09...872f349e7b119fcef7306f5dd7e4492ee3598318,5,42,20,62,20,2009-03-22 16:26:44,2009-02-27 21:20:57
872f349e7b119fcef7306f5dd7e4492ee3598318...18bf879817a725c1312059c91d18c9848acb3dfc,1,5,10,15,6,2009-03-22 16:26:44,2009-02-25 21:34:34
18bf879817a725c1312059c91d18c9848acb3dfc...7b7247b0d7cb6a105d87574642343480707414b3,2,28,31,59,10,2009-03-22 16:26:44,2009-02-24 20:13:39
7b7247b0d7cb6a105d87574642343480707414b3...704a3143d5ba0709727430154ef3dad600aad4de,32,211,76,287,82,2009-03-22 16:26:44,2009-03-04 21:38:24
704a3143d5ba0709727430154ef3dad600aad4de...2718e852e9baf98c128aafc508e85b610decad25,1,83,33,116,5,2009-03-22 16:26:44,2009-03-11 21:15:10
2718e852e9baf98c128aafc508e85b610decad25...ee9fb68c392cc76cf2a56762eb1c0712ae722f08,6,23,19,42,20,2009-03-22 16:26:44,2009-03-13 21:55:27
ee9fb68c392cc76cf2a56762eb1c0712ae722f08...6fd1106aa4f921dd8e80895ed837072adfd665f1,2,3,1,4,3,2009-03-22 16:49:52,2009-03-13 22:00:15
6fd1106aa4f921dd8e80895ed837072adfd665f1...552a26c8c069c582d2572399eb4ac176634a03cb,2,11,11,22,9,2009-03-22 16:52:43,2009-03-16 13:44:56
552a26c8c069c582d2572399eb4ac176634a03cb...a4df22ce49d0457f3dbec5083064f9d24e4d17dd,1,48,49,97,38,2009-03-22 16:52:43,2009-03-16 14:09:23
a4df22ce49d0457f3dbec5083064f9d24e4d17dd...8b02c64a3cb3a494ca5d704e3e05c4a2c45867c7,1,7,0,7,1,2009-03-22 16:52:43,2009-03-20 21:03:33
8b02c64a3cb3a494ca5d704e3e05c4a2c45867c7...28baf82ea359d9f2579fd3a7e7e2e5e2bd5da2a9,1,1,1,2,1,2009-03-23 07:18:02,2009-03-23 06:22:29
899d8dc392494e78040ea13db202de894040bda8...02322e1619dc537dc48650761f6c9bae883612a7,2,127,22,149,6,2009-01-28 07:46:59,2009-01-28 04:21:31
c42b1ad944413ac8978f166dbb98bcd4716ef551...ec74042dc7d81238d2c6d898331ff3b7e12a5d75,1,1,1,2,1,2009-01-26 01:09:58,2009-01-25 12:20:22
5dc1308562ab5991ecada68b06707709bea408c9...3f01ad665493e09aa816d84a872d9874f33a8c16,2,32,1,33,5,2009-01-26 02:55:49,2009-01-23 00:14:58
3f01ad665493e09aa816d84a872d9874f33a8c16...a79ec62d064e32b5c3979a16d215fdb70fe965c0,3,37,1,38,7,2009-01-26 02:56:13,2009-01-24 01:18:02
5dc1308562ab5991ecada68b06707709bea408c9...bf8a40b89eef66bc16902f7ea1a73352b8ba3d18,1,2,1,3,1,2009-01-26 01:01:47,2009-01-25 23:35:52
bf8a40b89eef66bc16902f7ea1a73352b8ba3d18...edc662f929e1a2be3e350bf362cc9aed95f5250a,1,22,11,33,13,2009-01-26 01:01:47,2009-01-25 22:21:40
edc662f929e1a2be3e350bf362cc9aed95f5250a...6076b843a0a15d344f367ac46645eb864085477c,1,13,0,13,1,2009-01-26 01:01:47,2009-01-25 22:21:41
6076b843a0a15d344f367ac46645eb864085477c...242522d9cc9b04c4db3baf7e97135d21401c1827,1,98,0,98,1,2009-01-26 01:09:45,2009-01-25 22:21:42
5dc1308562ab5991ecada68b06707709bea408c9...d456c9fd1e96c21ca32a224ed56ee34252605e34,1,5,4,9,4,2009-01-25 19:25:13,2009-01-25 08:04:15
d456c9fd1e96c21ca32a224ed56ee34252605e34...d6716c026666319824096401cd448b3694732d26,1,1,0,1,1,2009-01-25 19:25:14,2009-01-24 16:17:55
a81892dd8c37b6f13793739721b520fee3ce4c2c...64ca23afda5bd7514115a4457abf37db21b989ac,1,1,0,1,1,2008-08-23 20:05:10,2008-08-23 20:05:10
a81892dd8c37b6f13793739721b520fee3ce4c2c...4b480c6716a7d8e20e7e510827ea81e7939f335a,5,22,1,23,6,2008-08-23 05:00:22,2008-08-22 19:45:53
a81892dd8c37b6f13793739721b520fee3ce4c2c...26463c8f7ca1d54a480ea9baf0d98da2b6454204,1,2,1,3,1,2008-08-22 05:18:21,2008-08-21 14:21:48
26463c8f7ca1d54a480ea9baf0d98da2b6454204...f135aacb5ae30b54bac0dde7462b532d19e4c0d6,1,1,1,2,1,2008-08-22 23:15:21,2008-08-22 17:25:06
f135aacb5ae30b54bac0dde7462b532d19e4c0d6...893d340f2c735dc85b9360556ccd46cc0bf27fc0,1,1,1,2,1,2008-08-23 05:40:13,2008-08-21 21:11:40
893d340f2c735dc85b9360556ccd46cc0bf27fc0...913e0e99b6a6e63af6a062622a1f94bd78fd8052,3,6,2,8,5,2008-08-24 01:09:27,2008-08-23 19:57:30
daa0cc9a92c9c2c714aa5f7da6d0ff65b93e0698...1e7abc593d55bc436ccd98f6815d49b13511baa1,4,3,6,9,7,2008-08-26 05:39:17,2008-08-26 05:39:17
436edc6eae34b5b70371d87239d7883f41b705a2...1352fdbe3b16f30bfad308b737bc79e7b980318a,1,1,0,1,1,2008-08-22 06:16:57,2008-08-21 19:38:23
1352fdbe3b16f30bfad308b737bc79e7b980318a...ea360dd0538d03d25f512efe2f100beb3e7c2130,1,4,1,5,1,2008-08-22 06:30:17,2008-08-21 15:40:44
ea360dd0538d03d25f512efe2f100beb3e7c2130...4be636f42cd75f865204817c307eb1a7b464109c,1,5,0,5,1,2008-08-22 06:37:38,2008-08-21 12:14:18
4be636f42cd75f865204817c307eb1a7b464109c...5a4a088add3bdcbe86ae7e87964ce4025ddbc389,1,1,1,2,1,2008-08-22 06:38:25,2008-08-21 07:49:12
5a4a088add3bdcbe86ae7e87964ce4025ddbc389...a9da1663dfc869141749c768e9e0f52bb48218e3,2,15,5,20,4,2008-08-22 06:39:13,2008-08-21 14:45:11
a9da1663dfc869141749c768e9e0f52bb48218e3...2cb1f36d5098060a4bac182da16ceed3197a57c2,2,28,2,30,4,2008-08-22 07:15:37,2008-08-22 00:16:30
2cb1f36d5098060a4bac182da16ceed3197a57c2...96cda0b1067b4b5a2f87785cc49e1e648d68ae1d,1,2,2,4,2,2008-08-22 07:21:59,2008-08-22 00:31:50
96cda0b1067b4b5a2f87785cc49e1e648d68ae1d...a19a424010970a076a51afb4b378c9edcd908ff9,1,18,18,36,17,2008-08-22 23:51:21,2008-08-22 17:18:44
a19a424010970a076a51afb4b378c9edcd908ff9...9188ed8962ed47c0f41c24eb1317aa07037da545,4,46,17,63,10,2008-08-23 00:18:26,2008-08-21 17:23:20
9188ed8962ed47c0f41c24eb1317aa07037da545...34ad1afa712da208f29d8300b73a6753516564fb,1,18,6,24,2,2008-08-23 00:32:54,2008-08-22 03:32:00
34ad1afa712da208f29d8300b73a6753516564fb...a7b3269c4b9acde052d75b6dc54c8f869b77eb44,1,13,4,17,5,2008-08-23 05:38:21,2008-08-22 07:30:50
9d83c6aa44d2ff68111865b6f72e7321e54a8972...b28ebab294fb13f1bb5cd36ab9774a6dcf50a004,2,23,7,30,9,2008-11-11 17:29:36,2008-11-09 15:36:50
b28ebab294fb13f1bb5cd36ab9774a6dcf50a004...e29c0d10a201a4ce0c71ddb65faadff533ed2a98,2,17,9,26,4,2008-11-11 17:29:36,2008-11-09 15:51:16
e29c0d10a201a4ce0c71ddb65faadff533ed2a98...f75c8b319f5b448d8e7dc589ca581eec852a131e,1,1,1,2,1,2008-11-11 17:29:36,2008-11-09 15:53:09
de813435621b914f2b3e148c6cc94ab0066300c3...ec3e97b84e739946413194c563a12779efda2155,1,5,1,6,1,2008-09-25 15:49:13,2008-08-08 14:12:11
ec3a4ba519c0012d58584d23f407c302e7b80eb6...bb914b14c9d2c1c630512291fe4ca276e69b6e00,1,19,15,34,7,2008-09-07 23:09:56,2008-09-07 22:05:02
bb914b14c9d2c1c630512291fe4ca276e69b6e00...4d6e4c4d34435c777bd844fe5ee0ec1ca06ffa4a,2,11,0,11,11,2008-09-07 23:12:20,2008-09-07 22:05:03
ec3a4ba519c0012d58584d23f407c302e7b80eb6...af9ce1ffc6de9774e90a91f27fb1febd027f74f1,2,5,2,7,4,2008-09-07 22:22:24,2008-09-07 20:15:29
ac39efbdf3d41443c40166b7578b7fb87c2f3b60...2318121babea786390f51796bfce17088c3420ee,1,7,0,7,1,2008-08-12 01:57:03,2008-08-10 18:26:24
2318121babea786390f51796bfce17088c3420ee...b340fa43017437988e233ed4fd8dc00042614071,1,2,2,4,2,2008-08-12 01:57:03,2008-08-10 18:26:25
b340fa43017437988e233ed4fd8dc00042614071...bf9320f1512d7ad4a17a64cfe5a593bba5037b3e,1,7,0,7,1,2008-08-12 01:57:03,2008-08-10 18:26:26
bf9320f1512d7ad4a17a64cfe5a593bba5037b3e...87b611d5fd518e4754e599bc2f348f83db410c56,1,9,9,18,7,2008-08-12 01:57:03,2008-08-10 18:26:27
87b611d5fd518e4754e599bc2f348f83db410c56...21a50753852cb51b120ec9933416daa6cea6d184,1,11,0,11,1,2008-08-12 01:57:04,2008-08-10 18:26:28
21a50753852cb51b120ec9933416daa6cea6d184...ee06427aa6d975c35b63c3cd103ace43fbde062b,1,2,0,2,1,2008-08-12 01:57:04,2008-08-10 18:26:29
ee06427aa6d975c35b63c3cd103ace43fbde062b...155af83491b26d958b147c93620816846343b019,1,3,7,10,3,2008-08-12 01:57:04,2008-08-10 18:26:30
155af83491b26d958b147c93620816846343b019...abcaf07360357cf2e9ce4b34e44adc09bb5587f0,1,23,1,24,1,2008-08-12 01:57:04,2008-08-10 18:26:31
abcaf07360357cf2e9ce4b34e44adc09bb5587f0...3cafb7d8ce63effe6bf477182d431ecb4470eded,1,1,1,2,1,2008-08-12 01:57:04,2008-08-10 18:26:32
3cafb7d8ce63effe6bf477182d431ecb4470eded...bc02acfc769a1ae19772feaa7f03acfaea18a36f,1,16,12,28,2,2008-08-12 01:57:04,2008-08-10 18:26:33
bc02acfc769a1ae19772feaa7f03acfaea18a36f...b87a659635f40b5301c6b18fa5e22c72ca79b830,1,32,0,32,1,2008-08-12 01:57:04,2008-08-10 18:26:34
b87a659635f40b5301c6b18fa5e22c72ca79b830...5b5aa22f00c315021ff58450f18134b20dfd5abd,1,8,0,8,2,2008-08-12 01:57:04,2008-08-10 18:26:35
5b5aa22f00c315021ff58450f18134b20dfd5abd...d9429194f6e30e1f6f46a286217cd88972e1c83b,1,7,0,7,2,2008-08-15 01:14:23,2008-08-14 22:40:38
d9429194f6e30e1f6f46a286217cd88972e1c83b...a7d3ef9d099ab00a19595bc3ca8abdc1fc6ff35d,1,3,3,6,3,2008-08-15 01:14:24,2008-08-14 22:40:39
ac39efbdf3d41443c40166b7578b7fb87c2f3b60...2860b57a87ba7e544d472701c83019d7624e6a2c,1,1,1,2,1,2008-08-11 23:44:54,2008-08-10 15:26:23
2860b57a87ba7e544d472701c83019d7624e6a2c...7dce9918c72148139c3eb7a2a5c66b0df9ed415d,4,21,14,35,6,2008-08-12 00:07:17,2008-08-11 22:34:46
7dce9918c72148139c3eb7a2a5c66b0df9ed415d...d777af86d84f73be50e922b84144d959475ed770,1,1,1,2,1,2008-08-12 00:13:57,2008-08-11 23:55:35
ac39efbdf3d41443c40166b7578b7fb87c2f3b60...aa1a0111cc0e2a12c21ed05c88d8e9872fc166b2,2,47,0,47,3,2008-08-11 23:42:49,2008-08-10 11:48:55
ac39efbdf3d41443c40166b7578b7fb87c2f3b60...bb0ceb6264fa1aea6e68e07cb13cd9a88473febb,3,38,4,42,6,2008-08-11 23:37:28,2008-08-09 14:00:12
186458b11b090835fa793bcdbf6b5552b053276c...0e8316cc16f1a938c36f12f5fcae4a081b6ec6ff,2,28,17,45,4,2008-07-25 06:08:07,2008-07-24 22:41:12
0e8316cc16f1a938c36f12f5fcae4a081b6ec6ff...9944d1a0e4ce741b07248b95fff2f506b5f1729c,1,2,0,2,1,2008-07-25 06:09:09,2008-07-24 12:44:40
71bd81ade2973a304889d94426c922cc096019a2...2498a1ad0b0fc06f1fd40074b9bb55eb3d7ae094,1,9,4,13,2,2008-04-23 04:40:44,2008-04-03 18:26:13
2498a1ad0b0fc06f1fd40074b9bb55eb3d7ae094...34b5cd1fe9f9130b747388a1a968a8d4c9906865,1,5,2,7,1,2008-04-23 04:42:23,2008-04-22 10:41:47
34b5cd1fe9f9130b747388a1a968a8d4c9906865...208641cf850125a23ccca99630ea2caa70953e44,2,3,20,23,4,2008-04-23 04:53:37,2008-04-14 12:17:31
208641cf850125a23ccca99630ea2caa70953e44...491b1b11213c373a3e91004b1ab775d7e52ac1f3,1,13,10,23,4,2008-04-23 06:01:48,2008-04-21 03:31:24
29df2385d09611219c53d07f453794d6146e73a3...82881b38235d0a46a4486dc5dc819c5d0ee3f2c1,2,11,1,12,3,2008-04-23 04:12:37,2008-04-22 18:19:12
82881b38235d0a46a4486dc5dc819c5d0ee3f2c1...8b1f6de854ae95eb3f4225a71aad29ca086cfd2e,1,4,4,8,4,2008-04-23 04:21:08,2008-04-23 01:05:29
8b1f6de854ae95eb3f4225a71aad29ca086cfd2e...75b7dfbdc030cfc6f09a6317444c36c4957a9133,1,2,2,4,2,2008-04-23 04:23:16,2008-04-23 01:06:27
75b7dfbdc030cfc6f09a6317444c36c4957a9133...9231f500c394ede405fcfdca151dd7758ce99ced,1,1,2,3,1,2008-04-23 04:39:10,2008-04-22 10:07:47
9231f500c394ede405fcfdca151dd7758ce99ced...a6f47b2be43fbe70236316edc6c87ad9522c485d,1,2,1,3,1,2008-04-23 04:42:38,2008-04-22 12:23:48
a6f47b2be43fbe70236316edc6c87ad9522c485d...4f7ec7970874d09be162bc7f16415a0ec2d36ae5,1,4,0,4,4,2008-04-23 04:43:58,2008-04-18 13:12:04
a9a3e82e6d0018ff42ec11fd9560c1ff47add824...2de9de5e4ae1353f1552f61cf8cf532e3f1dc5f6,4,15,22,37,4,2008-07-13 21:41:28,2008-07-13 20:31:18
2de9de5e4ae1353f1552f61cf8cf532e3f1dc5f6...868da8d5e329c951f0d0cd049a8f9fecda64d388,1,5,3,8,3,2008-07-13 21:41:28,2008-07-13 20:31:19
868da8d5e329c951f0d0cd049a8f9fecda64d388...4804aabcdbffb41dba96825ca2693ea45830a108,3,38,1,39,4,2008-07-13 21:41:28,2008-07-13 20:31:20
a9a3e82e6d0018ff42ec11fd9560c1ff47add824...9b200fd68c799868c5c1383ef3eb34de7027f467,2,4,4,8,4,2008-07-13 20:59:34,2008-07-13 18:28:24
9b200fd68c799868c5c1383ef3eb34de7027f467...eacd6dc59411964cc025ba8a9897faa1fb1e6bc6,2,76,0,76,5,2008-07-13 21:04:04,2008-07-13 18:29:18
eacd6dc59411964cc025ba8a9897faa1fb1e6bc6...3b6121f69b2a27c3bbff5cc3056c30b15394441b,1,352,405,757,180,2008-07-14 02:10:48,2008-07-13 18:30:12
a9a3e82e6d0018ff42ec11fd9560c1ff47add824...5a26973025bce74782571844c7b8091d1cd7c405,1,1,1,2,1,2008-07-13 20:21:08,2008-07-12 15:47:51
5a26973025bce74782571844c7b8091d1cd7c405...d492b31cafe9aa5ce001b1d48815f4c0bb40d01a,58,247,233,480,210,2008-07-13 20:21:26,2008-07-12 15:47:52
d492b31cafe9aa5ce001b1d48815f4c0bb40d01a...1b1dd23f2d6a707b7077cdf6bc6d4055bd0bfb7d,80,102,101,203,90,2008-07-13 21:12:48,2008-07-13 13:36:15
a9a3e82e6d0018ff42ec11fd9560c1ff47add824...f9dd4bf4e58af0b4828c7e7013080dba59f8a6b9,1,4,0,4,1,2008-07-12 04:14:27,2008-07-11 16:48:16
f9dd4bf4e58af0b4828c7e7013080dba59f8a6b9...c4adea82c5064971ff6d090be8db89c44456186b,1,10,0,10,2,2008-07-12 04:14:34,2008-07-11 16:55:57
c4adea82c5064971ff6d090be8db89c44456186b...fdfd20080239c8564e40498bbaae63c1b87ccdba,1,1,1,2,1,2008-07-12 04:14:44,2008-07-11 16:52:42
a9a3e82e6d0018ff42ec11fd9560c1ff47add824...b6138273188e300dee4d309d2342384ca9eeb186,1,3,3,6,2,2008-07-12 04:13:16,2008-07-11 00:12:03
b6138273188e300dee4d309d2342384ca9eeb186...b9c76ddd27c035f9f562f6fa5edaea71e3d642db,1,1,1,2,1,2008-07-12 04:13:16,2008-07-11 00:12:04
b9c76ddd27c035f9f562f6fa5edaea71e3d642db...6c98c0548aa3433ba64708ca8f08d44cd923f0b7,1,8,4,12,4,2008-07-12 04:13:16,2008-07-11 16:01:29
6c98c0548aa3433ba64708ca8f08d44cd923f0b7...b4f02d3509e8e4da0f115b9515d52daa02621db7,2,10,10,20,3,2008-07-12 04:13:17,2008-07-11 00:12:06
a9a3e82e6d0018ff42ec11fd9560c1ff47add824...99d698f1e703754422f1dd780487ddbff3726dc3,2,33,9,42,14,2008-07-10 07:17:46,2008-07-07 12:42:48
e3e901bece93417392faa3dd7833d69271cf74f6...76f15947af78f526925810487f69fed35f6a7daf,1,21,0,21,12,2008-11-07 11:53:13,2008-11-02 18:59:44
76f15947af78f526925810487f69fed35f6a7daf...84a76f18f0313832ccc9c2f0171ace3da64ffa4f,1,28,18,46,25,2008-11-07 11:53:14,2008-11-02 18:59:45
84a76f18f0313832ccc9c2f0171ace3da64ffa4f...15e350552db1c0e8ede0af4f1f07dbbc9090e420,1,39,1,40,2,2008-11-07 11:53:17,2008-11-02 18:59:47
15e350552db1c0e8ede0af4f1f07dbbc9090e420...887a791f113a09a56bb4916243463481a51d86a4,1,16,9,25,2,2008-11-08 10:37:09,2008-11-08 10:37:09
887a791f113a09a56bb4916243463481a51d86a4...218a900bd8efd0d49f8a0d9491aa4786a998d4f4,1,163,44,207,23,2008-11-08 10:50:55,2008-11-02 18:59:48
e3e901bece93417392faa3dd7833d69271cf74f6...8b07dca18a498c5900edc717d216e841d6c15dc9,1,99,171,270,28,2008-11-02 11:34:47,2008-11-02 11:34:47
8b07dca18a498c5900edc717d216e841d6c15dc9...fc4977e1b989503c6dcfbc527cda2458d63d0400,1,61,3,64,8,2008-11-04 01:57:44,2008-11-04 01:57:44
fc4977e1b989503c6dcfbc527cda2458d63d0400...48a81b7cda1e58d8cc4d9bcadce76bbf1680ab7d,1,17,3,20,3,2008-11-04 10:09:00,2008-11-04 10:09:00
35d2f73b999636c93049b2d7bed1458bcf2f9648...99f0b59954c4682fc3145ba2c49f88ea20b30174,1,1,0,1,1,2008-10-21 06:39:28,2008-10-20 17:31:38
99f0b59954c4682fc3145ba2c49f88ea20b30174...f3f0c5188259182034b2c44d76c7158176e02d37,1,1,1,2,1,2008-10-21 06:39:37,2008-10-20 17:35:31
336d09daf288492946f0c51f071da11643f8363d...3cb22b8efe2cab60dc0ef5e265c414bd826d83ef,1,126,19,145,13,2008-06-29 05:07:00,2008-06-16 06:48:46
3cb22b8efe2cab60dc0ef5e265c414bd826d83ef...60bce2bb8b3cd5ca56f8156cbca16abee151d817,1,11,0,11,1,2008-06-29 05:24:49,2008-06-29 05:24:49
1293c95241531f7f17ddb58739c5c42da46fa78c...90d1c08efcf9c688df207588d9b72178524a62b6,1,125,5,130,2,2008-09-16 04:21:59,2008-09-13 16:11:00
90d1c08efcf9c688df207588d9b72178524a62b6...97c33c658365e0467e931bb8fed67d4f2a8d26f1,3,10,2,12,3,2008-09-16 04:22:58,2008-09-13 16:11:01
97c33c658365e0467e931bb8fed67d4f2a8d26f1...f948dd899210e5a51cd716245affb7c121bf8791,2,365,1,366,2,2008-10-19 21:27:59,2008-10-19 15:20:21
1293c95241531f7f17ddb58739c5c42da46fa78c...f1f15fbfaa841e34ec17edc352202c0a9d034a28,1,4,0,4,2,2008-09-16 04:03:59,2008-09-12 16:22:44
9800c0df412869c7949935b61581b9361fc49bd1...1d4c4986708688c14e72a5b442a3432048aeea79,2,30,26,56,2,2008-09-30 18:48:41,2008-09-29 20:08:14
1d4c4986708688c14e72a5b442a3432048aeea79...79fd4cc749826dd78c6ab3cd225bdb5c92db2de8,2,3,3,6,3,2008-09-30 18:51:16,2008-09-29 20:30:00
79fd4cc749826dd78c6ab3cd225bdb5c92db2de8...c33912ae2463b9e486fb016ffa9d21ff8e62984a,1,7,3,10,2,2008-09-30 19:27:20,2008-09-29 23:36:28
c33912ae2463b9e486fb016ffa9d21ff8e62984a...87539416fd25bfa62122ddf4f7a7b8794d5d5aa2,8,11,11,22,11,2008-09-30 19:39:58,2008-09-30 08:03:55
87539416fd25bfa62122ddf4f7a7b8794d5d5aa2...d3154b44c28affc94a4fbaf26706f075b58733a7,1,3,6,9,3,2008-09-30 20:41:50,2008-09-30 20:28:58
d3154b44c28affc94a4fbaf26706f075b58733a7...416f80a60b209d2ca0326407b801e9fb6ed8fdd7,1,0,2,2,1,2008-09-30 20:49:07,2008-09-29 21:52:01
80d12c23de4fbddfaee2f9bf7fe809f57d02e171...e502f9e7e6ceb8dfbdb94e2675355847740fc28f,1,30,2,32,5,2008-09-07 23:15:49,2008-09-07 23:05:41
e502f9e7e6ceb8dfbdb94e2675355847740fc28f...72c69ebc035efe08aef03866184aa9b344814d93,2,13,12,25,9,2008-09-30 22:16:28,2008-09-30 09:52:50
72c69ebc035efe08aef03866184aa9b344814d93...c85db254d9d3309bb330444385dbb3b7be5100d3,1,10,27,37,4,2008-10-03 00:08:16,2008-10-01 22:31:25
c85db254d9d3309bb330444385dbb3b7be5100d3...b724fd094496625325dae009170445ef12862f96,1,4,2,6,2,2008-10-06 07:04:24,2008-10-04 02:13:49
80d12c23de4fbddfaee2f9bf7fe809f57d02e171...48196afd2827b36ca5768f886f0866b6dfebdd10,1,2,1,3,1,2008-09-07 03:23:32,2008-09-04 03:33:29
80d12c23de4fbddfaee2f9bf7fe809f57d02e171...6ecb1ee28a9479af1d39cfab170b5d93e238c277,2,46,16,62,7,2008-09-07 01:56:44,2008-08-25 08:05:31
80d12c23de4fbddfaee2f9bf7fe809f57d02e171...7d66f21a1bfd2d6ea8b1e234befbcc187111cee6,3,173,7,180,4,2008-09-06 06:06:37,2008-09-05 21:16:23
80d12c23de4fbddfaee2f9bf7fe809f57d02e171...2d0c8accc3fa7de75d7cbe732873ce5a57379020,1,4,3,7,2,2008-09-05 23:58:38,2008-08-31 15:05:09
2d0c8accc3fa7de75d7cbe732873ce5a57379020...214a34d22ec59ec7e1166772f06ecf8799f96c96,1,19,12,31,5,2008-09-05 23:58:38,2008-08-31 15:45:04
214a34d22ec59ec7e1166772f06ecf8799f96c96...8598db935b653c638109aecab3e345c45d53af07,1,13,5,18,2,2008-09-05 23:58:38,2008-08-31 15:47:09
8598db935b653c638109aecab3e345c45d53af07...991255c634500fe51a70aae6a8e7c8d7b73db0cc,1,5,1,6,1,2008-09-05 23:58:38,2008-09-01 02:45:07
991255c634500fe51a70aae6a8e7c8d7b73db0cc...2cb611054a9597a00e9387c77e75d82e78982e60,1,4,4,8,2,2008-09-05 23:58:39,2008-08-31 13:50:59
2cb611054a9597a00e9387c77e75d82e78982e60...c9ab9ee47836b7c3d8a0c23f7b98c5f14da40c39,1,2,2,4,2,2008-09-05 23:58:39,2008-08-26 19:32:32
c9ab9ee47836b7c3d8a0c23f7b98c5f14da40c39...e9a805aa2ac18621853271e33b9aef963bf4e272,1,0,2,2,1,2008-09-05 23:58:39,2008-08-26 19:32:33
e9a805aa2ac18621853271e33b9aef963bf4e272...67214c85af7245a1f75da968334c529ec2610e70,1,22,22,44,22,2008-09-05 23:58:39,2008-08-26 19:32:34
67214c85af7245a1f75da968334c529ec2610e70...8d5100c7a81e7f638241b5af957e05216cd56579,1,4,4,8,1,2008-09-05 23:58:39,2008-08-26 19:32:35
8d5100c7a81e7f638241b5af957e05216cd56579...edde9112abd1ef5f4565468e8a9a500e0c03f900,2,16,3,19,6,2008-09-05 23:58:39,2008-08-26 19:32:36
edde9112abd1ef5f4565468e8a9a500e0c03f900...05427b91f0b5e45688cbea21faf0f2d79ec07b21,2,38,17,55,19,2008-09-05 23:58:39,2008-08-26 19:32:37
05427b91f0b5e45688cbea21faf0f2d79ec07b21...2cf3e3ac02c42cf0ba9299589db644beb395c4c5,1,2,2,4,1,2008-09-05 23:58:39,2008-08-29 13:42:48
2cf3e3ac02c42cf0ba9299589db644beb395c4c5...4457d4f767f0744e7936be449c3d25c507b7591a,1,25,48,73,8,2008-09-05 23:58:39,2008-08-29 13:42:49
4457d4f767f0744e7936be449c3d25c507b7591a...a786091b4a487bc08bbff4864717cf5d8383e983,1,2,4,6,6,2008-09-07 01:53:55,2008-09-07 01:29:12
a786091b4a487bc08bbff4864717cf5d8383e983...7c4d0219cf9ab6a7738a09ad7fec72d5e9f2ac67,2,18,0,18,2,2008-09-07 01:58:59,2008-09-07 01:50:38
80d12c23de4fbddfaee2f9bf7fe809f57d02e171...fd33777b7871eefa440f89ccf7c432895af09c74,3,13,1,14,5,2008-09-05 21:04:26,2008-09-05 19:27:35
3791f77c28f233df121da2f83abf7eefc7b49b69...05e8b3d6f43bd28aef85ec6e7658536510d6f959,1,6,20,26,3,2008-09-20 02:47:48,2008-09-19 22:15:25
f29d669a91b2c8f1c68c1f4fb10f03456a997fa8...658dd48c8572d0db49719cbef6605d384621d87c,1,1,1,2,1,2009-05-10 03:42:19,2009-05-09 21:57:30
658dd48c8572d0db49719cbef6605d384621d87c...53996fe5397ff37c5934bb5e9b23ef5985b3d152,1,2,2,4,2,2009-05-10 03:42:39,2009-05-09 22:11:17
1966af81760aea2966f8f218d442aed5f296b992...3bd1bb327eb4d3e386800897734f9f42b48280ff,2,1,7,8,2,2009-04-12 22:57:58,2009-04-12 22:43:24
796b13781aecce551b8f92049a66646e60f31dce...e37347bba651f051998f23a3701b555f1a194557,1,27,2,29,8,2009-04-09 07:04:55,2009-04-09 07:04:17
01eadafccbeae485503f5373dc60cc5a04877c3b...e892dc713e6b0881320d4c65bff7a49d44752bda,2,7,1,8,2,2009-04-08 05:04:41,2009-04-06 23:24:30
835a3eea3e18695e29b1d4c3adca37d1caaa16ef...714fddf2fc50cd5abb11d75837e6340edb9601f6,2,4,4,8,4,2009-04-08 06:04:45,2009-03-21 09:00:54
e96f3689ecd95997a2a474c2b7f21b0a67f138b1...b92c5f228a9c07fe339c8fd5406069602b6452f6,1,30,26,56,10,2009-04-05 08:52:33,2009-04-03 09:02:37
b92c5f228a9c07fe339c8fd5406069602b6452f6...efa54803cb1dc15923799f94abf82cb0433c2b9b,2,19,5,24,7,2009-04-05 08:52:38,2009-04-03 09:03:44
efa54803cb1dc15923799f94abf82cb0433c2b9b...bed5d42163ec2e2ddde3b1d78d303a4fb39bc0d0,1,8,3,11,5,2009-04-08 04:51:19,2009-04-06 13:41:00
bed5d42163ec2e2ddde3b1d78d303a4fb39bc0d0...9a23ba3375e2afa8045a433a3debce99c373beb2,2,12,0,12,2,2009-04-08 04:51:59,2009-04-06 13:41:01
9a23ba3375e2afa8045a433a3debce99c373beb2...b344e1614b15dfde0ab4dfc175bed1aac39bc264,2,9,3,12,2,2009-04-08 04:52:26,2009-04-06 13:41:02
b344e1614b15dfde0ab4dfc175bed1aac39bc264...27845e9548b7b5b316d89f64546466f2004ee414,1,81,0,81,1,2009-04-09 08:30:06,2009-04-06 20:18:23
e96f3689ecd95997a2a474c2b7f21b0a67f138b1...89a56bfbd3fd855cb0c2a381520e6255de41a55e,5,22,3,25,8,2009-04-05 06:57:59,2009-04-05 02:15:16
e96f3689ecd95997a2a474c2b7f21b0a67f138b1...96beef8c2efaab06f703991ed7802b8cef4c00e3,2,108,0,108,2,2009-04-05 05:57:39,2009-04-04 20:59:26
96beef8c2efaab06f703991ed7802b8cef4c00e3...5289bae17f24805cc8507129e21d794b0b56264c,1,5,88,93,5,2009-04-05 05:57:42,2009-04-04 20:59:31
e96f3689ecd95997a2a474c2b7f21b0a67f138b1...0da43a685aa061f55ed19ea30e1d6220020059a6,2,15,2,17,3,2009-04-05 05:53:32,2009-04-05 03:23:21
0da43a685aa061f55ed19ea30e1d6220020059a6...f3a186ffade15f793ea17713a10e10ec4f26ff11,1,3,3,6,3,2009-04-05 07:25:08,2009-04-04 20:02:26
f3a186ffade15f793ea17713a10e10ec4f26ff11...5dba35912474770d0df45ed801d78c4c9ed5e949,17,0,26,26,26,2009-04-05 07:38:26,2009-04-03 19:31:10
32786093108231ef7d9e403e90b239f67428c3dd...2346431e476ab9f095f0dd2921f63fa071039bb8,4,32,14,46,5,2009-04-01 18:02:42,2009-04-01 08:50:34
9856dd811ee0f256d067b89cbccb58d944aa9c8c...3f7d99282d336824b789a5ccb2523a5d84f9be2e,1,1,1,2,1,2009-03-27 21:26:34,2009-03-18 18:05:56
6066f5ae75ec0feea7745e19e06b95d991d82665...6872f606d9bc9a0ab0b3252bd4175af7732b6135,1,11,5,16,6,2009-03-20 16:33:28,2009-03-20 09:57:50
6872f606d9bc9a0ab0b3252bd4175af7732b6135...e392a852364e375e916c1dd4f87a7584b348410a,1,12,10,22,4,2009-03-20 16:35:21,2009-03-19 22:54:29
e392a852364e375e916c1dd4f87a7584b348410a...8f0246551c3964eeb16d9c9f39845bd53af8bda8,1,5,8,13,1,2009-03-20 16:35:32,2009-03-19 22:27:32
28baf82ea359d9f2579fd3a7e7e2e5e2bd5da2a9...80f0e53d6bdde5d9be016e5cfbb5ff7c0257a00e,1,1,0,1,1,2009-03-25 20:25:53,2009-03-25 11:48:30
80f0e53d6bdde5d9be016e5cfbb5ff7c0257a00e...fb9a2beab2002894fb970cba4e32ebb1c41176b2,2,3,1,4,3,2009-03-25 20:25:57,2009-03-25 12:21:15
02322e1619dc537dc48650761f6c9bae883612a7...4cc8d6c62db1f82b3c98468806d2ee54c7e037ca,2,69,1,70,3,2009-01-29 01:29:33,2009-01-28 22:24:53
02322e1619dc537dc48650761f6c9bae883612a7...a15080e5f43d840717f8e3b68410f26c8cd54db2,1,1,1,2,1,2009-01-29 00:28:15,2009-01-26 07:41:26
02322e1619dc537dc48650761f6c9bae883612a7...967476966513564e9c28847f7a974b8af5093493,1,26,0,26,1,2009-01-28 22:54:58,2009-01-27 09:07:31
967476966513564e9c28847f7a974b8af5093493...94c88edef7a69299e12248b910752f1fc26f12d6,2,5,6,11,6,2009-01-28 22:54:58,2009-01-27 11:42:31
02322e1619dc537dc48650761f6c9bae883612a7...f172f334fde49ce29d0afa21749bf85463a2db9a,1,2,2,4,2,2009-01-28 21:16:30,2009-01-28 07:33:53
f172f334fde49ce29d0afa21749bf85463a2db9a...45c0961c87884a04517b65c0acc6aedeeae2d0c8,1,14,4,18,5,2009-01-28 22:08:57,2009-01-28 07:35:33
45c0961c87884a04517b65c0acc6aedeeae2d0c8...1d64f21d9949ac1dd59fa722160e46181d92854d,1,1,0,1,1,2009-01-28 22:09:35,2009-01-28 07:36:39
1d64f21d9949ac1dd59fa722160e46181d92854d...d8e96fd86d415554a9c2e09ffb929a9e22fdad25,1,13,4,17,3,2009-01-28 22:09:37,2009-01-28 07:38:14
02322e1619dc537dc48650761f6c9bae883612a7...aeeae1b771020f1ac6692f89563e3f8689c704e7,2,44,3,47,5,2009-01-28 19:00:28,2009-01-28 07:19:30
afc72747049af5775ab9def6224dd8082d42a57f...dfb047b9e4f7f66c5322ef642f21fd92b0a975e3,1,7,2,9,1,2009-01-26 08:35:58,2009-01-26 08:32:22
dfb047b9e4f7f66c5322ef642f21fd92b0a975e3...f7d9d04e3be697989c960881f9b0d50f1ea6a6be,1,1,0,1,1,2009-01-26 23:11:37,2009-01-26 19:03:59
f7d9d04e3be697989c960881f9b0d50f1ea6a6be...a6c7a27691bd8b059d39c9bc71b19fb8e614fa54,2,102,2,104,4,2009-01-27 05:23:19,2009-01-26 09:05:22
a6c7a27691bd8b059d39c9bc71b19fb8e614fa54...2d6061537f3f27112f80a6e1047b5c566084ef7d,2,25,5,30,5,2009-01-27 05:33:51,2009-01-27 05:13:00
913e0e99b6a6e63af6a062622a1f94bd78fd8052...5e568f9e3027797842807213ce590140c9daf9ce,2,28,0,28,2,2008-08-24 06:59:20,2008-08-23 19:21:21
913e0e99b6a6e63af6a062622a1f94bd78fd8052...7d770163271db1ec3608d3b2b77e306346e24a4a,1,1,0,1,1,2008-08-24 04:53:35,2008-08-23 22:07:55
7d770163271db1ec3608d3b2b77e306346e24a4a...f5f7e4a18cf656747be8f8447ca304ddf716c742,1,38,31,69,11,2008-08-24 19:00:14,2008-08-24 14:12:23
f5f7e4a18cf656747be8f8447ca304ddf716c742...32818085ee88dd98c48a0838fba3c4673d5e819c,1,5,3,8,1,2008-08-24 19:01:28,2008-08-24 05:38:06
32818085ee88dd98c48a0838fba3c4673d5e819c...ab54cd6c4d54b7d9bf6dccfa7ea54f209ea76601,2,9,3,12,2,2008-08-24 19:04:14,2008-08-24 05:28:32
913e0e99b6a6e63af6a062622a1f94bd78fd8052...446247db78a733f44d2470afb1f1983d28058159,4,32,8,40,9,2008-08-24 01:17:22,2008-08-23 19:56:57
837a156197e7921c256e6189d838963d2999fcb6...27a6ed492b3962d8214a196e57e8969ff9772249,1,1,1,2,1,2008-08-24 23:15:25,2008-08-24 20:23:25
d6096f17d2d5d9ccb453aabf8edc6ee238b166fc...98fcf840af443a0a93b9a6cd1fada5af826383f3,1,2,3,5,2,2008-08-24 19:08:11,2008-08-24 18:46:10
aebd173ffa7a4e67447f0157a14abde7767c54e9...a240de1137bd63a969c6bd56ab5186d7216e28ca,3,27,0,27,5,2008-11-02 08:54:28,2008-11-01 14:42:16
a240de1137bd63a969c6bd56ab5186d7216e28ca...a80732897931c737c01d04289dd1512bd12a4b04,1,3,0,3,1,2008-11-02 08:54:29,2008-11-01 18:44:45
a80732897931c737c01d04289dd1512bd12a4b04...310e0216c80484d429dbdec547ab52a93236eb60,1,0,6,6,3,2008-11-02 08:54:29,2008-10-24 02:44:27
310e0216c80484d429dbdec547ab52a93236eb60...6a509a6f7f38906996ac791449d5bcc2f32eef23,1,27,1,28,8,2008-11-02 08:56:33,2008-11-02 07:36:07
f75c8b319f5b448d8e7dc589ca581eec852a131e...d1f2b362b7937c1ecb0d1b9a21d76b362705b87d,1,22,0,22,1,2008-11-16 21:31:41,2008-11-16 02:42:32
d1f2b362b7937c1ecb0d1b9a21d76b362705b87d...153ad78b5074b37215654b1ccb59e67dc5831883,2,15,9,24,10,2008-11-16 21:33:09,2008-11-16 18:46:47
153ad78b5074b37215654b1ccb59e67dc5831883...7cf4566f48b7f17c68ab215a9ca6ef7792d9d791,2,31,16,47,13,2008-11-16 21:33:09,2008-11-16 18:46:48
7cf4566f48b7f17c68ab215a9ca6ef7792d9d791...0ce76ded1b207063a460f859fe7bfeb6d90b4eb6,3,359,0,359,4,2008-11-16 21:33:09,2008-11-16 18:46:49
0ce76ded1b207063a460f859fe7bfeb6d90b4eb6...67df911ceebb57596b0d3aea405e1d12137bc6f4,2,203,5,208,8,2008-11-16 21:33:09,2008-11-16 18:46:50
67df911ceebb57596b0d3aea405e1d12137bc6f4...b8dfb16d3668c57b1286d854e762368c25a2eaaf,1,42,2,44,3,2008-11-16 21:33:33,2008-11-16 18:46:51
b8dfb16d3668c57b1286d854e762368c25a2eaaf...bd45bd91e6606bea77a02a979a3a48cf058d981d,1,791,285,1076,267,2008-11-16 21:56:55,2008-11-16 21:56:55
bd45bd91e6606bea77a02a979a3a48cf058d981d...941930732fc0bbffbd19e9fa09fe00bc1512a3a7,1,1,1,2,1,2008-11-16 22:02:13,2008-11-13 18:52:52
ea2408bfe18b4f9d1eaa9d8587c5ae6196552cac...aa5735bed459be71473b4fda1a9a026f798acf76,1,1,1,2,1,2008-09-20 02:47:36,2008-09-11 00:40:20
aa5735bed459be71473b4fda1a9a026f798acf76...264e0b9a3c090930eec8dd16ecacf551dc685ac1,2,22,34,56,6,2008-09-20 02:48:30,2008-09-19 20:12:53
264e0b9a3c090930eec8dd16ecacf551dc685ac1...02ed24580eeb03cb6e68967bd55457d9ab978b7c,1,1,1,2,1,2008-09-20 05:05:31,2008-09-19 12:07:26
02ed24580eeb03cb6e68967bd55457d9ab978b7c...597faa00fdf69491c331f748fc62453726354629,1,1,1,2,1,2008-09-20 05:05:42,2008-09-19 13:42:30
597faa00fdf69491c331f748fc62453726354629...8d11fdeaf6735163e4af3fff699293e8250c07c3,2,2,2,4,2,2008-09-20 05:23:14,2008-09-19 13:43:48
8d11fdeaf6735163e4af3fff699293e8250c07c3...cc185a6a8ac24737a26ec4b40cc401c2db8b2e97,2,30,1,31,2,2008-09-20 06:15:13,2008-09-20 06:15:13
7e4ad908721445b073f3b4ecad55bbd78f032cdc...04c6e9e9ca34226db095bbaa1218030f99f0b7c6,2,21,2,23,3,2008-08-12 05:15:28,2008-08-12 05:15:28
99ea66ec479b884a8b5aff3020cf6e6abb9aa09a...b302ddd2f8de2944ed3425d48b1a640fab004d02,1,1,1,2,1,2008-07-25 06:29:38,2008-07-23 11:49:21
b302ddd2f8de2944ed3425d48b1a640fab004d02...c84bb14ce52b6559e0b8e10d554ff9b47149c042,1,2,0,2,1,2008-07-25 06:29:50,2008-07-23 11:49:22
c84bb14ce52b6559e0b8e10d554ff9b47149c042...058fb414804d545cc7dcca1313078d6a7e7bbd37,1,9,4,13,2,2008-07-25 07:08:56,2008-07-22 21:15:41
058fb414804d545cc7dcca1313078d6a7e7bbd37...a2d07d80ec9dfff0e51cac534be7c1642a47f8fb,1,2,1,3,1,2008-07-25 07:26:44,2008-07-24 16:55:25
a2d07d80ec9dfff0e51cac534be7c1642a47f8fb...c921cc92e5ff2ead4dea112b19e555f521cf20b8,1,2,1,3,1,2008-07-25 20:56:21,2008-07-25 07:34:47
65360346309a550185363ef5b846a1202175a4e6...859fdabaede6733c98b1ca8df2fabce000522bf9,2,115,17,132,7,2008-07-25 06:24:00,2008-07-23 10:15:33
d6958a1a32814af69a7571daa45252018c61f969...3ffb58be0a779b47e1e4d3ea584ba301461a3a77,1,15,0,15,1,2008-04-25 04:50:19,2008-04-24 01:28:36
4f7ec7970874d09be162bc7f16415a0ec2d36ae5...edae5f0c20b7e71a717b59873ddb8eeddfa49b86,2,72,2,74,2,2008-04-23 17:02:44,2008-04-23 16:47:17
edae5f0c20b7e71a717b59873ddb8eeddfa49b86...837f3b765840e789b73d3b08b38c0541cf8e324e,1,2,1,3,1,2008-04-23 17:54:43,2008-04-23 13:13:51
837f3b765840e789b73d3b08b38c0541cf8e324e...3ef6a1fe95b0a5aaca21a86651850ef5d62327fa,1,1,13,14,1,2008-04-23 17:56:07,2008-04-23 09:21:45
0bd64f82ba38013799d1d999de5fc3c079bd8014...112db553b0db4c4f2b39e5e3e433b2102be10085,3,173,155,328,3,2008-06-23 01:46:00,2008-06-22 19:19:25
ea81e10ff4e31820407f4cb1b8ebd87de9e51737...69913415655839b3add5d930ebbea1be8a5b60a9,1,23,12,35,7,2008-06-11 06:57:36,2008-06-10 17:21:01
69913415655839b3add5d930ebbea1be8a5b60a9...7da0f3a46daac50782a71e8a6eb12355d49c419d,1,39,37,76,2,2008-06-11 06:57:37,2008-06-10 17:21:44
ea81e10ff4e31820407f4cb1b8ebd87de9e51737...0ecfcb3b700e7e3097a55f015894ad75f1097090,3,41,22,63,9,2008-06-11 05:30:01,2008-06-10 14:51:08
0ecfcb3b700e7e3097a55f015894ad75f1097090...67a7e2d07162dc470f7e3ae1889aad146e5b7917,1,67,34,101,7,2008-06-11 05:43:05,2008-06-10 14:51:21
67a7e2d07162dc470f7e3ae1889aad146e5b7917...8d7679276af861b44e307c9879f6c4774f4944fc,3,37,8,45,7,2008-06-11 06:17:41,2008-06-10 14:51:35
8d7679276af861b44e307c9879f6c4774f4944fc...e7d5a97d5e131925ccae48db94f2069631a8aa41,2,22,2,24,4,2008-06-11 06:18:13,2008-06-10 22:54:49
e7d5a97d5e131925ccae48db94f2069631a8aa41...8b7d4e738ee5489fecb5c4a55d14884b09e0dc6d,1,3,2,5,2,2008-06-12 06:43:25,2008-06-12 06:43:25
ea81e10ff4e31820407f4cb1b8ebd87de9e51737...cdf222f5f0d6f2f22df12e83c4a1f9aae35f3084,1,1,0,1,1,2008-06-10 06:12:48,2008-06-03 11:06:12
cdf222f5f0d6f2f22df12e83c4a1f9aae35f3084...e9039dd35194b7c1cf4ecd479928638166b8458f,1,11,6,17,3,2008-06-11 05:23:18,2008-06-11 01:47:18
e9039dd35194b7c1cf4ecd479928638166b8458f...8c372fb01dcd9da5e0e538943cc173941c03ef2d,1,1,0,1,1,2008-06-11 05:24:01,2008-06-10 12:32:06
99d698f1e703754422f1dd780487ddbff3726dc3...0af0ac7ebbbd2afbc4399d5658e193460b4caaa3,3,5,5,10,5,2008-07-13 08:03:10,2008-07-12 14:56:19
99d698f1e703754422f1dd780487ddbff3726dc3...5b2fd95606cd6d564f96d9d253e7cd19263bc352,6,390,355,745,16,2008-07-10 07:26:29,2008-07-09 12:58:57
dbc4941facba9f43f1b95af254d667425d383d45...cea07cf8dc9b3677e0c50433c0d72bce83adbdc7,1,29,7,36,7,2008-11-13 10:40:39,2008-11-09 10:00:45
cea07cf8dc9b3677e0c50433c0d72bce83adbdc7...e7d640086e0d3eb332542da287c40262c6eae207,1,31,13,44,14,2008-11-13 10:40:41,2008-11-11 20:55:42
e7d640086e0d3eb332542da287c40262c6eae207...590915dab8aaf464f5819c4ccec7941c3490e3ce,1,23,2,25,3,2008-11-13 11:20:25,2008-11-09 15:06:07
590915dab8aaf464f5819c4ccec7941c3490e3ce...d98d50e214643379734ac3ffe891770457f1c419,1,5,2,7,4,2008-11-13 11:39:00,2008-11-13 11:39:00
208f689610e524ce9858f9d28635f7fea51b8d96...d8c2882254f0f30e4f44de593c3b3db6a8fccef9,1,39,7,46,5,2008-10-25 19:25:14,2008-10-21 19:34:50
d8c2882254f0f30e4f44de593c3b3db6a8fccef9...b02bd7a6323a85f9feedd9c8cd7d7401021dfb11,1,30,3,33,3,2008-10-25 19:25:14,2008-10-21 19:34:51
b02bd7a6323a85f9feedd9c8cd7d7401021dfb11...3550ea71f566b6958ffedf1573806d5fe891f344,1,3,3,6,3,2008-10-25 19:25:14,2008-10-21 19:34:52
3550ea71f566b6958ffedf1573806d5fe891f344...b0be3838bb75e8b3be04310cc379142c3ef65703,1,34,2,36,3,2008-10-25 19:25:14,2008-10-21 19:34:53
b0be3838bb75e8b3be04310cc379142c3ef65703...8db49a7f6f272ecb72c75a172e9753f3981488ce,1,24,4,28,4,2008-10-25 19:25:14,2008-10-21 19:34:54
208f689610e524ce9858f9d28635f7fea51b8d96...69cd8f63427c65c65d9cd66bb8c05ca93dc3edef,9,136,14,150,18,2008-10-21 21:09:34,2008-10-21 20:55:57
8b745e3ffdabe6ef110dc064af46b0ba993941e0...f8cca019b9ea9471719505ca6ccf020feb219d98,3,81,5,86,4,2008-09-30 22:34:52,2008-09-29 20:28:57
8b745e3ffdabe6ef110dc064af46b0ba993941e0...d2b0708e1a65953ad93a4adfc27938de0f8df252,2,6,0,6,2,2008-09-30 21:30:06,2008-09-27 08:41:50
d2b0708e1a65953ad93a4adfc27938de0f8df252...444dc90322fcd1e4ea1cb9c6a46372fa28d8ef9d,2,38,38,76,8,2008-09-30 21:30:06,2008-09-27 08:43:01
444dc90322fcd1e4ea1cb9c6a46372fa28d8ef9d...adbc0b6b6e57c11ca49779d01f549260a920a97d,5,150,0,150,6,2008-09-30 21:30:06,2008-09-30 13:53:47
8b745e3ffdabe6ef110dc064af46b0ba993941e0...b35ddf41eeee1465c9c5a34357664d22b929b79a,2,11,4,15,7,2008-09-30 21:30:00,2008-09-29 16:49:52
f4a75a416f62c0494e06cb42a11c7cc70ec9303e...e7881c3594d22eb711654d2febfd577dc4994f34,1,2,2,4,2,2008-10-18 14:20:36,2008-10-05 21:42:35
e7881c3594d22eb711654d2febfd577dc4994f34...be58e70dbadf3cb3f4aa5829d513d886ae8bc460,4,212,224,436,19,2008-10-18 15:02:21,2008-10-05 21:43:21
be58e70dbadf3cb3f4aa5829d513d886ae8bc460...122aa6f9c000d0d286898e2eb7b3504ac6cb9ebd,4,45,38,83,18,2008-10-18 15:02:26,2008-10-05 21:43:36
122aa6f9c000d0d286898e2eb7b3504ac6cb9ebd...9cb92c390cefd3bf3f71bbda12eb04893c861361,3,50,2,52,5,2008-10-18 15:02:55,2008-10-05 21:43:45
7c4d0219cf9ab6a7738a09ad7fec72d5e9f2ac67...f4392df485b197a0797cc503b1e1a71350abfe56,2,17,0,17,5,2008-09-07 04:00:28,2008-09-07 03:18:18
34a5d35bbd6164cfbe08f5f14e359867ce80955b...fe33b333af6e72d74e80da16517cb6d33283c7f7,1,21,1,22,5,2008-09-20 08:01:30,2008-09-20 08:01:30
fe33b333af6e72d74e80da16517cb6d33283c7f7...494202524f76ac0385ae483abf970c4c9c692a77,1,20,0,20,1,2008-09-22 06:50:01,2008-09-22 06:50:01
69fd60a649dbe40390fa47e0ccc7478fcf64f451...a48f5d7153761fabf0b04fdfd1667adf7eeeddbe,3,23,2,25,3,2009-05-03 23:54:14,2009-05-03 23:14:58
3bd1bb327eb4d3e386800897734f9f42b48280ff...cbd3a01ed803778b2377e0148448f7e617bc381a,2,20,1,21,7,2009-04-19 19:35:37,2009-04-10 14:57:01
cbd3a01ed803778b2377e0148448f7e617bc381a...7535e5a16aa7167074ac74ee1342814767a83a82,1,21,43,64,11,2009-04-19 19:35:38,2009-04-16 07:14:15
7535e5a16aa7167074ac74ee1342814767a83a82...cafa56702bc3742a99c39d3b4d1770178720bcc4,1,3,1,4,2,2009-04-19 19:35:38,2009-04-16 16:46:23
3bd1bb327eb4d3e386800897734f9f42b48280ff...9ffb15d52a33444652c136681c0b720547c43cbe,1,26,6,32,2,2009-04-19 19:31:56,2009-03-31 16:45:22
9ffb15d52a33444652c136681c0b720547c43cbe...24cb1bb1984be60addeecaf0bf5d16cd9688e6a7,1,44,0,44,5,2009-04-19 19:31:56,2009-03-31 04:34:14
3bd1bb327eb4d3e386800897734f9f42b48280ff...1092f6b3f8bcdad89169952f2922e1bfb7b23d33,1,16,0,16,1,2009-04-19 19:29:25,2009-03-23 12:53:06
1092f6b3f8bcdad89169952f2922e1bfb7b23d33...38124d8f3120b8e189760376b0a93cad6f3c475a,1,4,2,6,1,2009-04-19 19:29:26,2009-03-23 12:53:07
38124d8f3120b8e189760376b0a93cad6f3c475a...426193c025eb76125a99b3fe143eea50e849f9ca,2,6,3,9,2,2009-04-19 19:29:26,2009-03-23 12:53:08
426193c025eb76125a99b3fe143eea50e849f9ca...aadd44404baab7b1f7234c8815bfd1e6c980cd99,2,6,3,9,4,2009-04-19 19:29:26,2009-03-23 12:53:09
3bd1bb327eb4d3e386800897734f9f42b48280ff...ae57ec223b37556224010db93e71e3ceb2cf257b,1,1,1,2,1,2009-04-16 23:32:17,2009-04-09 09:12:58
e37347bba651f051998f23a3701b555f1a194557...c2abd83fea0c332e907f5bc23bea4eeca091a86b,2,17,4,21,6,2009-04-12 00:53:52,2009-04-06 20:37:59
c2abd83fea0c332e907f5bc23bea4eeca091a86b...6ea420328885603087b3f1df42683c911d1b3f29,1,50,4,54,5,2009-04-12 00:55:04,2009-04-10 20:32:41
6ea420328885603087b3f1df42683c911d1b3f29...0d8bee71af1cda3d13d896c210773216dcf87b7c,3,82,21,103,25,2009-04-12 00:55:37,2009-04-11 17:46:17
0d8bee71af1cda3d13d896c210773216dcf87b7c...88ec205477e18e612ab854f20ef87aa244b8debe,3,9,2,11,4,2009-04-12 00:55:37,2009-04-11 17:46:18
88ec205477e18e612ab854f20ef87aa244b8debe...b6c29915d2efd0d2cb56eca88bd8e6b4999546dc,1,1,1,2,1,2009-04-12 05:21:59,2009-04-09 15:45:39
b6c29915d2efd0d2cb56eca88bd8e6b4999546dc...d3c9634eacdcaa71cbd69a160e6f4e80ddb7ab63,1,1,0,1,1,2009-04-12 05:21:59,2009-04-09 11:29:57
d3c9634eacdcaa71cbd69a160e6f4e80ddb7ab63...519d05be9015871e422cd16ebced620cb01f8b3c,1,34,2,36,5,2009-04-12 05:21:59,2009-04-09 22:25:37
519d05be9015871e422cd16ebced620cb01f8b3c...cced5fbc241f1274ba532040b985f38c15bbf555,1,10,7,17,2,2009-04-12 05:22:00,2009-04-09 18:46:15
cced5fbc241f1274ba532040b985f38c15bbf555...ee7ec2f9ded03700f2b95cc1d4b3d60ed374132a,1,10,6,16,7,2009-04-12 08:35:12,2009-03-22 13:20:44
e37347bba651f051998f23a3701b555f1a194557...79f72b97633d1699f131e798bb9833339ba22f6a,2,4,3,7,2,2009-04-11 18:01:15,2009-04-09 19:58:52
e37347bba651f051998f23a3701b555f1a194557...8f8c6fafd92fd547547bd7735e2d121a20997703,1,2,2,4,2,2009-04-11 18:00:45,2009-04-09 19:40:39
8f8c6fafd92fd547547bd7735e2d121a20997703...0cbcf7ad71559245b59b90a324011fcf0657af8c,1,1,1,2,1,2009-04-18 03:46:43,2009-04-17 20:34:25
442dd42d6d4903640b0dc5561481a77c88dcea90...666e07e69703c3930a60fbb1a74ed9923d293f16,1,26,6,32,2,2009-04-01 19:28:22,2009-03-31 16:45:22
666e07e69703c3930a60fbb1a74ed9923d293f16...494fbfe87ade4658cb5c3a061a5be5d6f6496607,1,44,0,44,5,2009-04-01 19:35:12,2009-03-31 04:34:14
442dd42d6d4903640b0dc5561481a77c88dcea90...e161acd11da05add6575a6931f4ff38a5685dd7d,1,1,1,2,1,2009-04-01 15:57:39,2009-04-01 08:04:44
e161acd11da05add6575a6931f4ff38a5685dd7d...50b5f420fe94399e3da867a0ff0585bc5d3fe86f,1,1,1,2,1,2009-04-01 15:58:55,2009-04-01 11:22:25
442dd42d6d4903640b0dc5561481a77c88dcea90...49750f30767b3eb4683e8d2f4d742354dd5d03d3,2,7,5,12,6,2009-03-31 06:51:20,2009-03-30 18:31:41
f7446fc6bbe9c25f7064ba76b2db4dd67691f7d0...c4c86d238900fb8c99939a9b5003fa622d4dcce7,1,6,3,9,3,2009-04-18 04:28:07,2009-04-16 07:17:12
747f9d30ed706ebd930ef888971fff5638334831...61e6108d94353d932d397e4be498c7e5293723eb,1,25,17,42,1,2009-04-08 07:39:51,2009-04-08 07:24:03
81aa96497686bd31c5a9a3cdf110c2e10c799c03...43acdf243ee8a8fa876bdd6659026fe5ed2d4c24,1,2,1,3,1,2009-04-05 19:04:22,2009-04-05 16:33:38
43acdf243ee8a8fa876bdd6659026fe5ed2d4c24...1d1876e9300c56f399ea2976c5831674cd9818b1,3,24,7,31,6,2009-04-06 07:12:32,2009-04-01 17:51:54
1d1876e9300c56f399ea2976c5831674cd9818b1...5c9c990341bad6b4087c2dd99d28a6cb910749df,1,1,1,2,1,2009-04-06 07:14:55,2009-03-30 10:11:42
5c9c990341bad6b4087c2dd99d28a6cb910749df...6127c0864798111d3524da2bea6188b0048d9fcf,1,74,74,148,68,2009-04-06 07:15:58,2009-04-04 09:38:23
6127c0864798111d3524da2bea6188b0048d9fcf...a3df1e464e110776120e37f467cc0ad3b957a80e,1,12,2,14,4,2009-04-06 07:27:09,2009-04-04 09:38:24
a3df1e464e110776120e37f467cc0ad3b957a80e...a6e5ef7d9cc34199fb6618e1fbb57f3615d002f6,1,25,25,50,22,2009-04-06 07:37:34,2009-04-04 09:38:27
5289bae17f24805cc8507129e21d794b0b56264c...1a7b1f6b9c9a129236c66c392877e8697825470f,1,1,1,2,1,2009-04-06 07:56:27,2009-04-06 07:48:49
dffc13166ba8950b2ddbac2406042751f96841b7...3944ba0cb0ef5119dc9d1708c572855fca88fc43,3,50,0,50,9,2009-04-02 20:04:07,2009-04-01 16:48:24
dffc13166ba8950b2ddbac2406042751f96841b7...3b3637c3f1d752e6e6d559f30cc53bbec18537ef,1,5,3,8,2,2009-04-02 17:46:21,2009-03-31 16:22:13
3b3637c3f1d752e6e6d559f30cc53bbec18537ef...a61c0ffa4474ad6dcec18a5454630371106710f4,2,15,1,16,3,2009-04-02 17:46:21,2009-03-31 16:22:14
8befac5d6f9e994d72efb1ecc59c356414114e7e...d5b0c97d138201c59b30cb759cedabb70b7bae81,1,3,3,6,2,2009-03-25 23:35:52,2009-03-25 21:51:01
d5b0c97d138201c59b30cb759cedabb70b7bae81...98e1a4186acd4b71da1daae5c522cb6ac6d1d904,1,4,3,7,3,2009-03-25 23:36:16,2009-03-25 21:22:13
98e1a4186acd4b71da1daae5c522cb6ac6d1d904...4fa535a179e771cd5a16d5ab05e97e7bb52739ef,3,9,9,18,6,2009-03-26 00:28:33,2009-03-25 18:23:42
4fa535a179e771cd5a16d5ab05e97e7bb52739ef...ebeec7dbc564cb83edd8faee87890c47b6f0da43,2,7,3,10,3,2009-03-26 05:53:45,2009-03-25 23:53:23
78360b576acb0ee47c90552cb3f976a3c6ba4d6a...3aea1a5a899f5ff34f12d0cd6d8e903ddcfeef3a,1,1,1,2,1,2009-03-24 21:42:59,2009-03-24 20:43:02
3aea1a5a899f5ff34f12d0cd6d8e903ddcfeef3a...77813151f983a77f5b5954fb7cb8094198db0567,1,2,2,4,1,2009-03-25 02:17:33,2009-03-23 10:26:49
77813151f983a77f5b5954fb7cb8094198db0567...3f7df3a71a9cbab3c27d84f2410e7d39407f9013,1,2,2,4,2,2009-03-25 02:17:33,2009-03-23 10:26:50
3f7df3a71a9cbab3c27d84f2410e7d39407f9013...e1d37937ac3c15898afdb6117349a30d0eae5e64,1,7,1,8,2,2009-03-25 02:17:33,2009-03-23 10:26:51
e1d37937ac3c15898afdb6117349a30d0eae5e64...7c98213abc2a834f16646b9fe842f6e63c7ddb81,1,34,0,34,2,2009-03-25 02:44:56,2009-03-23 19:53:05
297f6a535cb46d246d47a9ff2473cef4ee1ada27...d04099382b8ac8f6a54a755fa9a06118595d92d9,1,7,7,14,2,2009-01-28 18:31:04,2009-01-28 09:52:26
d04099382b8ac8f6a54a755fa9a06118595d92d9...98ef23b3b106ef8cf4dc0db34e62a39e044cf99b,1,4,8,12,5,2009-01-28 18:53:34,2009-01-28 15:03:10
d2b9dff8a08cc2037a7ba0463e90791f07cb49dd...6ffaecc7d8b2c3c188a2efa5977a6e6605d878d9,2,1,16,17,4,2008-08-30 05:38:41,2008-08-20 01:05:39
fb7092807962af168a76f6d8cbab02150daa0b5a...5760a6b094736e6f59eb32c7abb4cdbb7fca1627,1,11,6,17,4,2008-08-24 21:47:24,2008-08-24 21:47:24
cb138fede603d5b950c72b11382a28e40177a639...cdc7e388da47b66fe11c92ed7698ec233ce70635,1,23,8,31,3,2008-08-27 19:19:47,2008-08-27 07:30:29
27a6ed492b3962d8214a196e57e8969ff9772249...68daa64df2363f848d818dda9fc414511d9330da,2,27,1,28,2,2008-08-27 00:08:13,2008-08-25 02:10:29
27a6ed492b3962d8214a196e57e8969ff9772249...2327f61ecc4e9fbb6dd9fffdec0b043aeaca908f,2,55,2,57,5,2008-08-26 05:48:01,2008-08-24 19:43:37
6a509a6f7f38906996ac791449d5bcc2f32eef23...0e8189e2708bc1da08c77c7e1d960f420b6890a5,4,30,1,31,5,2008-11-02 23:22:15,2008-10-31 15:31:08
0e8189e2708bc1da08c77c7e1d960f420b6890a5...d8f325563d85abcd9816311b3a84093b2d1cda9f,4,6,4,10,5,2008-11-02 23:22:34,2008-10-29 23:02:45
d8f325563d85abcd9816311b3a84093b2d1cda9f...09ded04b7e1f0096bb2fe356b2f5a298296151dd,3,13,11,24,7,2008-11-02 23:22:34,2008-10-29 23:02:46
09ded04b7e1f0096bb2fe356b2f5a298296151dd...3d77d8774fc18216f18efa5c5907f73b22d61604,1,30,6,36,7,2008-11-02 23:22:35,2008-10-29 23:02:47
3d77d8774fc18216f18efa5c5907f73b22d61604...03d660150cbc80cd7d2ec90c3c4e6ce563295e3a,1,17,6,23,6,2008-11-02 23:22:35,2008-10-29 23:02:48
03d660150cbc80cd7d2ec90c3c4e6ce563295e3a...08698b1e32bc414f214b7300b40c30a30d9ecd1c,3,16,7,23,4,2008-11-02 23:22:35,2008-10-29 23:02:49
08698b1e32bc414f214b7300b40c30a30d9ecd1c...64bd76b1de75483dea646c39c390113ffc821299,1,19,9,28,10,2008-11-02 23:22:35,2008-10-29 23:02:50
64bd76b1de75483dea646c39c390113ffc821299...538cf6b6e5f663eea9b777ef12ae58eb0c919480,1,89,7,96,11,2008-11-02 23:22:35,2008-10-29 23:02:51
538cf6b6e5f663eea9b777ef12ae58eb0c919480...59dd9ed18398d96922e345f7987f1245870fb3e5,1,9,3,12,6,2008-11-02 23:22:35,2008-10-29 23:02:52
59dd9ed18398d96922e345f7987f1245870fb3e5...8c1f6f6c5797d1a3fa9ec9d38ae30b4f19e70a3c,1,1,1,2,1,2008-11-09 21:08:38,2008-11-09 21:08:38
8c1f6f6c5797d1a3fa9ec9d38ae30b4f19e70a3c...a2d2c478f325690e1575e14e7d310fd7435d83be,1,1,1,2,1,2008-11-09 21:11:06,2008-11-09 21:11:06
941930732fc0bbffbd19e9fa09fe00bc1512a3a7...0c76ae2278a89dc7d5c44d656f0df9c606d83cd1,1,918,337,1255,279,2008-11-18 00:58:29,2008-11-17 22:11:43
0c76ae2278a89dc7d5c44d656f0df9c606d83cd1...3cf2801c4155b98d05bc25d8f3c589b0e23b5b54,1,834,295,1129,266,2008-11-19 19:17:39,2008-08-26 22:49:54
3cf2801c4155b98d05bc25d8f3c589b0e23b5b54...f6e4110bcd8b34837c9073ddcb76209ac4fb857b,1,839,310,1149,274,2008-11-21 15:07:02,2008-11-21 07:35:53
f6e4110bcd8b34837c9073ddcb76209ac4fb857b...1a93d67ba85a8152d2d5e71b4d3a22b7f18ee6e0,1,827,297,1124,266,2008-11-23 20:53:45,2008-11-23 19:52:20
1a93d67ba85a8152d2d5e71b4d3a22b7f18ee6e0...6249067c614f9c190a5261bb95c5a9a3a41ef039,1,825,294,1119,265,2008-11-26 22:13:30,2008-11-26 10:21:44
cc185a6a8ac24737a26ec4b40cc401c2db8b2e97...79bbc7fb078f8cabe04020c4619be9b571371398,1,8,10,18,6,2008-09-22 16:35:58,2008-09-22 11:03:25
79bbc7fb078f8cabe04020c4619be9b571371398...18309f4c3e00886660f15e18c1aaab2f5bc25715,1,2,2,4,2,2008-09-22 16:36:12,2008-09-22 11:30:08
cc185a6a8ac24737a26ec4b40cc401c2db8b2e97...352eadc40024b141e1295693654ec20cc123844f,2,22,0,22,2,2008-09-22 06:17:06,2008-09-21 18:36:06
04c6e9e9ca34226db095bbaa1218030f99f0b7c6...e41352b24e29eba43d00a3fd117befaef1d594bc,1,123,2,125,3,2008-08-13 03:46:54,2008-08-12 16:00:18
e41352b24e29eba43d00a3fd117befaef1d594bc...0b19138ba3e4c129770565d364df65ec25ca0a8e,1,18,17,35,15,2008-08-13 03:46:54,2008-08-12 16:00:53
0b19138ba3e4c129770565d364df65ec25ca0a8e...510b0945d041752db2f53dda00f1188308e2df4e,1,22,24,46,6,2008-08-13 03:46:54,2008-08-12 16:45:39
04c6e9e9ca34226db095bbaa1218030f99f0b7c6...6e84b712373d343ea3531740d8eb048e84240a39,1,7,3,10,3,2008-08-13 00:27:07,2008-08-12 08:45:57
6e84b712373d343ea3531740d8eb048e84240a39...a0e46390d397e71182e42930b98b6b59a1a84898,2,12,17,29,4,2008-08-13 00:27:17,2008-08-12 08:45:58
04c6e9e9ca34226db095bbaa1218030f99f0b7c6...bd7b371e9c2aeb0aaf228dc1655e8d04fca6f797,1,1,0,1,1,2008-08-12 22:41:08,2008-08-12 19:36:13
bd7b371e9c2aeb0aaf228dc1655e8d04fca6f797...d08ed6d692a79eb2a62410d7e76380fbf25ca793,1,10,3,13,1,2008-08-12 22:41:32,2008-08-12 14:24:25
d08ed6d692a79eb2a62410d7e76380fbf25ca793...23b5beb28fdadbb1d80ebf686a35385609f7a180,2,3,0,3,2,2008-08-12 22:43:55,2008-08-12 14:24:26
23b5beb28fdadbb1d80ebf686a35385609f7a180...70d9895ebcb8d401b569d28f049ad37fcb7b5ade,1,136,17,153,9,2008-08-13 00:54:06,2008-08-11 23:55:36
04c6e9e9ca34226db095bbaa1218030f99f0b7c6...6d6f9cddbe419710a36e778a50a7712ac4ba016f,2,91,4,95,4,2008-08-12 22:39:46,2008-08-12 18:31:06
d9d9e6ee6366fed93a4beff3994bad376f81eabd...d82f33e20dcf068e679eff2a16ecf8fe7b10fb31,3,57,53,110,3,2008-07-26 00:08:34,2008-07-25 16:28:41
d82f33e20dcf068e679eff2a16ecf8fe7b10fb31...7198203ae37c11327c0d01f1e37f3e74381755a9,4,23,15,38,10,2008-07-26 00:09:38,2008-07-25 16:28:42
7198203ae37c11327c0d01f1e37f3e74381755a9...837c8767130ec71089e654f92cf24e8277a3bda5,2,30,0,30,2,2008-07-26 00:10:14,2008-07-25 17:51:51
837c8767130ec71089e654f92cf24e8277a3bda5...09f8d055f9c2af79a72f8d2a2f13698d9bbe6956,1,1,2,3,1,2008-07-26 00:10:20,2008-07-25 18:22:23
09f8d055f9c2af79a72f8d2a2f13698d9bbe6956...d3296e37b61fdd80a8b785270b1d11db34dab2f5,1,4,5,9,2,2008-07-26 00:10:32,2008-07-25 18:37:48
d3296e37b61fdd80a8b785270b1d11db34dab2f5...6e94e6835f397cd2602ca1eb12002e51aa6b0500,4,21,21,42,7,2008-07-26 00:16:12,2008-07-25 10:41:21
6e94e6835f397cd2602ca1eb12002e51aa6b0500...c0885435537e4b93709d2bf39ce36454186057a1,3,137,145,282,7,2008-07-26 00:18:06,2008-07-25 10:41:22
c0885435537e4b93709d2bf39ce36454186057a1...7f4d0511af9d6c93656dda5a683632f5ae5b5278,2,2,4,6,3,2008-07-26 00:20:55,2008-07-25 10:41:23
7f4d0511af9d6c93656dda5a683632f5ae5b5278...f15f736d38d10f5c4f2ca367565019bdfe8e71dd,2,5,7,12,2,2008-07-26 00:21:04,2008-07-25 10:41:24
f15f736d38d10f5c4f2ca367565019bdfe8e71dd...819b2b58246a7927376930e266b4ef8b43096115,1,17,3,20,4,2008-07-26 00:28:40,2008-07-25 10:41:25
819b2b58246a7927376930e266b4ef8b43096115...c70a8d98a528f29bc6d6de7744e1eedd24f2a63d,1,1,0,1,1,2008-07-26 00:41:12,2008-07-21 19:19:50
c70a8d98a528f29bc6d6de7744e1eedd24f2a63d...46beb55988e68da04c2e9d319c71b9b940f0854c,1,10,10,20,2,2008-07-26 00:41:12,2008-07-21 19:19:51
46beb55988e68da04c2e9d319c71b9b940f0854c...e1464ca7bb0d705210ba7198f004b2fb2b807e12,6,16,10,26,13,2008-07-26 00:41:13,2008-07-21 19:19:52
e1464ca7bb0d705210ba7198f004b2fb2b807e12...966c6edd318f2e44dd150103ec2b6b7a53be58f0,2,3,3,6,3,2008-07-26 00:41:13,2008-07-21 19:19:53
966c6edd318f2e44dd150103ec2b6b7a53be58f0...49fa65a7a8185e81c1098815df607042103b0493,2,26,42,68,10,2008-07-26 00:41:13,2008-07-23 19:12:18
49fa65a7a8185e81c1098815df607042103b0493...10c4c881c4d2cb0ece0508e7142e189e68445257,3,37,37,74,3,2008-07-26 00:41:13,2008-07-21 19:19:55
31c6390d40fe12a46c38d7224da61c6771886f2a...f8aae120345f511e59bb008e8de2a8f6e65cf377,2,69,3,72,6,2008-04-25 05:13:24,2008-04-23 09:16:06
f8aae120345f511e59bb008e8de2a8f6e65cf377...1ce89cc4bb18b0e66f7073562d6634f6a9841335,2,11,0,11,2,2008-04-25 05:30:31,2008-04-22 11:11:13
3ef6a1fe95b0a5aaca21a86651850ef5d62327fa...362b0dd523f5162e7c55c76b5d0af7ad830e0e83,1,1,1,2,1,2008-04-28 04:46:51,2008-04-27 00:43:20
e2da671a642d5987d9a08f56b19172767272d9be...3015fa5846c19e79f99c1d6a49fd2510ed9291b8,3,8,8,16,6,2008-06-26 00:21:52,2008-06-25 18:35:13
112db553b0db4c4f2b39e5e3e433b2102be10085...7e7bbcb4b35cbb4bbb5e65cf057c84b16dbd3d39,2,55,30,85,18,2008-06-30 21:51:12,2008-06-23 19:59:37
7e7bbcb4b35cbb4bbb5e65cf057c84b16dbd3d39...ee68b87a62a245fca46374fe5132aec58d802baa,2,26,7,33,8,2008-06-30 21:51:12,2008-06-23 20:28:04
ee68b87a62a245fca46374fe5132aec58d802baa...ff43ec3e2d2f71482fe17ba9ba5f4e8074cc54ee,2,56,39,95,19,2008-06-30 21:51:12,2008-06-23 20:38:58
ff43ec3e2d2f71482fe17ba9ba5f4e8074cc54ee...07fe54db3cdf42500ac2e893b670fd74841afdc4,1,30,13,43,10,2008-06-30 21:51:13,2008-06-23 20:46:36
07fe54db3cdf42500ac2e893b670fd74841afdc4...26141b5b60eea36f1d771312f6cae9e56dbbf760,2,16,0,16,4,2008-06-30 21:51:13,2008-06-23 20:55:11
26141b5b60eea36f1d771312f6cae9e56dbbf760...a32a4eaa36527ab1c9a999357f9edd5e04591a4a,2,2,0,2,2,2008-06-30 21:51:13,2008-06-23 22:31:31
112db553b0db4c4f2b39e5e3e433b2102be10085...f2ab7f82b7bd8f0147f656e7d279236d1bd68921,1,0,1,1,1,2008-06-23 20:01:37,2008-06-23 16:19:23
d98d50e214643379734ac3ffe891770457f1c419...28593d3fa0e667bfccfe48e87a580db7c1a8d769,1,58,59,117,38,2008-11-15 05:23:04,2008-11-13 12:01:46
28593d3fa0e667bfccfe48e87a580db7c1a8d769...2958228430b63f2e38c55519d1f98d8d6d9e23f3,1,11,11,22,14,2008-11-18 08:44:20,2008-11-18 08:44:20
2958228430b63f2e38c55519d1f98d8d6d9e23f3...cdc8429c94e43181ac0bd48225c2af85499d2f5a,1,88,22,110,23,2008-11-18 08:54:14,2008-11-18 08:54:14
cdc8429c94e43181ac0bd48225c2af85499d2f5a...68149a71978564aaef7a5fe956cf1de2864c16d3,1,0,1,1,1,2008-11-18 09:35:39,2008-11-13 20:09:18
8db49a7f6f272ecb72c75a172e9753f3981488ce...5e166843f502536df7e940486721057acf37ec23,1,7,8,15,6,2008-11-02 23:37:55,2008-11-02 09:21:37
5e166843f502536df7e940486721057acf37ec23...1ec2fb5fa37d823d02517263f8e2a78930abd1dd,1,39,0,39,1,2008-11-03 03:20:52,2008-11-02 09:21:38
1ec2fb5fa37d823d02517263f8e2a78930abd1dd...c752a0e00c7f122dbca72552b1bf193e5850a1b1,1,17,0,17,3,2008-11-03 03:23:10,2008-11-02 09:21:39
5f54de5bd07481f6d88e8dbd5551f3356ecbf513...fb32c410087e68d650b31f68e66b3d9cbcce4a56,1,58,0,58,1,2008-06-19 21:38:24,2008-06-19 18:18:03
fb32c410087e68d650b31f68e66b3d9cbcce4a56...b4780d725c673db26692e11c56539381d60ad17c,2,139,0,139,2,2008-06-19 21:38:24,2008-06-19 20:32:49
5f54de5bd07481f6d88e8dbd5551f3356ecbf513...9e18522328dc6ba2cf49b56fa7a54c14ad4df840,1,2,2,4,2,2008-06-17 04:31:17,2008-06-14 01:01:59
9e18522328dc6ba2cf49b56fa7a54c14ad4df840...328a4750b155df9de29cac007c74e2412d244620,1,121,4,125,3,2008-06-17 04:32:22,2008-06-15 12:06:43
328a4750b155df9de29cac007c74e2412d244620...1421c5f274a10f93ce5e8b51c0e1351905f84f4e,1,0,14,14,1,2008-06-17 04:46:47,2008-06-17 00:17:10
1421c5f274a10f93ce5e8b51c0e1351905f84f4e...3bfaf01857ebcefbd38529a73b059dc984ecb5a4,1,2,2,4,2,2008-06-17 05:02:12,2008-06-17 05:02:12
3bfaf01857ebcefbd38529a73b059dc984ecb5a4...79c6dca413094d2df74e7050f1185963b00e9245,2,1,9,10,2,2008-06-17 05:19:00,2008-06-17 05:19:00
79c6dca413094d2df74e7050f1185963b00e9245...516381d50ba7acb66f260461f4d566ab9b6df107,1,14,10,24,5,2008-06-17 23:39:09,2008-06-17 21:46:35
516381d50ba7acb66f260461f4d566ab9b6df107...61fb0b75d138032c7600fe86640897b900f2fd4f,1,0,43,43,1,2008-06-17 23:39:18,2008-06-17 06:25:28
61fb0b75d138032c7600fe86640897b900f2fd4f...1a8fb155cff5b19bc41ee3ac96e34f0f2ad95763,1,1,1,2,1,2008-06-17 23:39:59,2008-06-17 07:23:31
1a8fb155cff5b19bc41ee3ac96e34f0f2ad95763...1d9b26562e12fabd60bb4174b7e6b10f4f4a0ec8,1,1,1,2,1,2008-06-17 23:40:09,2008-06-17 11:43:57
1d9b26562e12fabd60bb4174b7e6b10f4f4a0ec8...8c6b57860d9be5f346c9589a08c9e7c04eeaf99b,1,2,4,6,1,2008-06-17 23:40:09,2008-06-17 16:34:57
8c6b57860d9be5f346c9589a08c9e7c04eeaf99b...9a7bbd1dd1db45b474576ca328aa7056cdd081e0,2,20,22,42,12,2008-06-18 19:39:13,2008-06-16 16:15:02
9a7bbd1dd1db45b474576ca328aa7056cdd081e0...e449f105805ffa49ccf7cf080db897ecf65a1a0f,3,9,7,16,4,2008-06-18 20:09:43,2008-06-18 20:09:43
310237b9698219f58cb9dedd7cd9a3a968e1a196...8776f5d3bb4237d5a7e43dc2aeaf25b5a4ba819d,1,11,2,13,2,2008-10-21 02:34:56,2008-10-21 00:36:25
5e22e21769454857e00bc55be1f2eef8d873ba72...25dfd171d646c38f9344d8e3d8ae0fdf179dd281,1,1,1,2,1,2008-10-03 00:16:50,2008-10-01 20:11:54
25dfd171d646c38f9344d8e3d8ae0fdf179dd281...de056402fd90dbb1dc47756ef7cbcc9d230a5eb8,1,19,0,19,2,2008-10-03 00:19:03,2008-10-01 20:13:02
de056402fd90dbb1dc47756ef7cbcc9d230a5eb8...a476142fe78d4c9b33f07abf3a80bb52f92660b7,1,4,4,8,3,2008-10-03 00:29:48,2008-10-02 14:25:05
a476142fe78d4c9b33f07abf3a80bb52f92660b7...159b3212705f0f98c79a5565c0f9eff07234c1c7,2,2,3,5,3,2008-10-03 00:46:09,2008-10-02 10:14:23
159b3212705f0f98c79a5565c0f9eff07234c1c7...7996ff335e675b229398974f6cbf459843c9bf6d,3,1,10,11,3,2008-10-03 01:02:44,2008-10-02 10:14:25
7996ff335e675b229398974f6cbf459843c9bf6d...0433bcd9f01b9113a02831c13e364c6a89a0047a,2,2,3,5,3,2008-10-03 01:03:35,2008-10-02 10:14:27
0433bcd9f01b9113a02831c13e364c6a89a0047a...c5ae6439d454288a809dd7c916e44ec4a5ae0b3b,2,1,2,3,2,2008-10-03 01:03:35,2008-10-02 10:14:30
c5ae6439d454288a809dd7c916e44ec4a5ae0b3b...120a385afb8ce94b3918d74d4a79ca5938a95304,1,1,1,2,1,2008-10-03 01:03:35,2008-10-02 10:14:33
120a385afb8ce94b3918d74d4a79ca5938a95304...9126f0091f271f090cc030a788219574ab0fea97,24,162,141,303,120,2008-10-03 01:06:56,2008-10-01 18:05:20
5e22e21769454857e00bc55be1f2eef8d873ba72...83caecca2f0805d440099d19011fdedc2b3467a5,4,26,3,29,10,2008-10-01 16:14:54,2008-10-01 16:11:15
5e22e21769454857e00bc55be1f2eef8d873ba72...7ecbad91e94c0552da9c8903e4ed004c4d6744e4,2,17,12,29,9,2008-10-01 15:56:58,2008-09-30 12:58:24
7ecbad91e94c0552da9c8903e4ed004c4d6744e4...180c9f5c299b6ec9fcd77e3346fbdd6874e028a4,1,26,68,94,1,2008-10-01 15:56:58,2008-09-30 12:58:25
180c9f5c299b6ec9fcd77e3346fbdd6874e028a4...73811e662849c17cf9e53e63a35b676d624e032c,1,66,72,138,13,2008-10-01 15:56:58,2008-09-30 12:58:26
73811e662849c17cf9e53e63a35b676d624e032c...dbf5e1e974ff6264b04759a4a3e04966b056e533,2,12,6,18,8,2008-10-01 15:56:58,2008-09-30 12:58:27
dbf5e1e974ff6264b04759a4a3e04966b056e533...c306e071b34b5ed0e5296574af94528953bfb607,1,1,1,2,1,2008-10-01 15:56:58,2008-09-30 12:58:28
c306e071b34b5ed0e5296574af94528953bfb607...3971a9733e3b17f46ab31c5fa28100533f398a3a,1,16,75,91,10,2008-10-01 15:56:58,2008-09-30 12:58:29
3971a9733e3b17f46ab31c5fa28100533f398a3a...4ed62b0316619b70e9dc9868e93c33815ff678d5,1,34,27,61,1,2008-10-01 15:56:58,2008-09-30 12:58:30
4ed62b0316619b70e9dc9868e93c33815ff678d5...917f3e73ec60820608d32016293aa496bdcbdf0e,1,69,50,119,13,2008-10-01 15:56:58,2008-09-30 12:58:31
917f3e73ec60820608d32016293aa496bdcbdf0e...ddc3d4fe84d245b81afddf305b7d92ae1f0bc556,2,6,5,11,5,2008-10-01 15:56:58,2008-09-30 12:58:32
ddc3d4fe84d245b81afddf305b7d92ae1f0bc556...fd3a8dcbbd5972912cad44d7a5571d7606b8739e,1,2,1,3,1,2008-10-03 02:14:47,2008-09-28 04:51:21
5e22e21769454857e00bc55be1f2eef8d873ba72...6b28da672e8828111a8cf3cda9ed760e03140e11,1,20,25,45,6,2008-10-01 15:56:57,2008-09-25 16:48:37
6b28da672e8828111a8cf3cda9ed760e03140e11...f04f27e8b2a62f62d3ba168f1de4e45265830bff,1,2,2,4,2,2008-10-01 15:56:57,2008-09-25 16:48:48
f04f27e8b2a62f62d3ba168f1de4e45265830bff...d627f68fbbe0480337cd56cce442ed8c1efa230e,1,34,1,35,4,2008-10-03 02:00:35,2008-10-02 14:36:52
58e0fa5416c0a91761d904fd097c2ba9e45e3654...3041b98a9d40e5eb1aae9698c7e15c85ff37f344,1,6,1,7,3,2008-10-18 15:30:39,2008-10-18 15:30:39
2f91bcfa9d8d1f443012e3e92092f464f3bb3557...f55527f80223178d1837bae08addc57bed76d236,4,17,2,19,4,2008-10-23 00:16:07,2008-10-21 13:54:19
f55527f80223178d1837bae08addc57bed76d236...20244ea2d09a3f5c3c83133014ca1e1b7b3d0227,3,17,12,29,11,2008-10-23 01:05:38,2008-10-22 07:39:47
20244ea2d09a3f5c3c83133014ca1e1b7b3d0227...759ad19e772a79a2a5ae6b7377d57eb21d29e6a0,1,2,2,4,2,2008-10-23 01:06:34,2008-10-22 19:22:53
666599d798102df2d7b32196cadb7dfb737e0b32...9747deb7e1dc7dae7f772a418feafa08c2d18e9f,1,59,0,59,1,2008-09-22 06:51:12,2008-09-18 21:55:14
9747deb7e1dc7dae7f772a418feafa08c2d18e9f...2beec8973394e29353a9dccee45657870852ba33,2,20,6,26,8,2008-09-22 06:51:13,2008-09-16 01:12:58
213195185c8aa09d6192b85a3f78bf46f19f51a4...aae94ffbc138181777a942ef18daf52606df833d,2,14,0,14,3,2009-05-23 22:45:52,2009-05-23 18:53:10
aae94ffbc138181777a942ef18daf52606df833d...4c8d4c14c6de59bc14d6118724ffee949e8654a7,4,79,0,79,4,2009-05-23 22:45:52,2009-05-23 18:53:11
a48f5d7153761fabf0b04fdfd1667adf7eeeddbe...bf74106a5b4577fd695d15a28ad51537ae7470d8,2,101,5,106,2,2009-05-10 04:05:52,2009-05-09 21:49:59
a48f5d7153761fabf0b04fdfd1667adf7eeeddbe...3db964b551827e25f897cc75ffd8e520ee8b48cd,1,6,6,12,4,2009-05-06 05:08:58,2009-05-05 05:18:42
3db964b551827e25f897cc75ffd8e520ee8b48cd...e77063fccb4c1627bd4656a42a508391d16e7482,1,4,4,8,3,2009-05-06 05:09:02,2009-05-05 05:19:00
e77063fccb4c1627bd4656a42a508391d16e7482...7713e053fd13a09b548cb65d99dfca986064955e,1,4,4,8,1,2009-05-06 05:09:31,2009-05-04 06:46:58
7713e053fd13a09b548cb65d99dfca986064955e...f697b33b015fcb0c90210840eb4ef8e6a18d4bdf,1,3,1,4,2,2009-05-06 05:19:14,2009-04-06 17:26:37
f697b33b015fcb0c90210840eb4ef8e6a18d4bdf...066e596abb2768be1ef3984a55ce39643fbb36e5,1,1,1,2,1,2009-05-06 05:49:02,2009-05-02 14:31:16
066e596abb2768be1ef3984a55ce39643fbb36e5...e88d022af96312e64216bfec31bd6749277c335a,1,1,1,2,1,2009-05-06 05:49:43,2009-04-29 21:27:54
cafa56702bc3742a99c39d3b4d1770178720bcc4...a2fc8d65368a23a8a5f708b36c761c2d0d133ea6,1,1,1,2,1,2009-04-20 10:38:44,2009-04-20 09:42:52
4f26c39806ee69bd68d6ea04b147eb2d877d0172...318b84703135951b69b6d9e58b6fda0790405424,1,0,2,2,2,2009-04-20 00:23:42,2009-04-20 00:17:25
318b84703135951b69b6d9e58b6fda0790405424...1f9b620fdbf27835f54b11008d64c4014b8f4c32,2,10,2,12,4,2009-04-20 00:34:26,2009-04-20 00:34:26
ee7ec2f9ded03700f2b95cc1d4b3d60ed374132a...f79d4c8a0f22d7fd25018be846c7e48127ed3200,2,39,5,44,8,2009-04-13 01:42:15,2009-04-10 00:34:42
ee7ec2f9ded03700f2b95cc1d4b3d60ed374132a...c59cb03a8bfc4b09758b07b23b6fe70a909ff9f4,3,175,4,179,10,2009-04-12 18:56:17,2009-04-08 21:30:24
c59cb03a8bfc4b09758b07b23b6fe70a909ff9f4...7c8224b6a8c16c84938ad7c31cb98e55cb1e8cfd,1,19,7,26,6,2009-04-28 01:23:55,2009-04-27 17:51:42
4f760b74cfaa23222901739cdc62951cc7b8c5b6...77b96d6dbf65f736a63b8a0bb5f810edbf895a09,1,21,13,34,9,2009-04-18 21:47:22,2009-04-18 21:32:02
77b96d6dbf65f736a63b8a0bb5f810edbf895a09...ea10b60c910e4a23483f47f17becc5e58f07ebe9,3,20,3,23,3,2009-04-19 04:37:46,2009-04-19 03:42:07
6f523f6d38e660edc67719fb0953d79cee3b4b1f...54a47493a34fbf25370c526a03c38894d709f3e4,1,2,1,3,2,2009-04-13 00:04:17,2009-04-10 00:34:40
54a47493a34fbf25370c526a03c38894d709f3e4...c965c029330b1f81cc107c5d829e7fd79c61d8ea,2,14,3,17,8,2009-04-13 00:05:55,2009-04-13 00:05:55
91286ca61af404d53d946d6c3388b24f004433d2...5906f54e474c6e8aabb0f6b955d446b509cde06e,1,3,0,3,1,2009-04-01 18:10:06,2009-03-31 16:22:11
5906f54e474c6e8aabb0f6b955d446b509cde06e...dc1460aa8de64f62b4612b6d2546ed7b88050de2,2,4,3,7,4,2009-04-01 18:11:21,2009-03-31 16:22:12
dc1460aa8de64f62b4612b6d2546ed7b88050de2...75fd877e150ecca74f9749bfd6bfa9a6b425ab57,1,11,9,20,6,2009-04-01 22:46:46,2009-04-01 20:24:28
75fd877e150ecca74f9749bfd6bfa9a6b425ab57...5288dd58356e53d61e2b3804fc7d8d23c3a46ab3,1,5,4,9,3,2009-04-01 22:53:36,2009-03-31 15:30:39
5288dd58356e53d61e2b3804fc7d8d23c3a46ab3...0e5e69a355b7bdd1af6ca33ac7ee35299bda368e,1,1,1,2,2,2009-04-02 04:43:03,2009-04-01 22:05:01
a51609a1c1bdbcf87715d5bae08444d7185d49db...67daebfd3b9ba020d677e069000782b9b1e8cf75,2,32,1,33,2,2009-04-18 21:45:29,2009-04-18 21:01:50
c4c86d238900fb8c99939a9b5003fa622d4dcce7...43be7a782e08489062a3b8130cbb7ffbe8807191,1,1,1,2,1,2009-04-18 19:54:45,2009-04-18 11:26:42
6da14ee14f85fe5766780e1cbe8d42d385638e9e...499c29394ce1ead3ebd29b0d3c8014cdb7a32e63,2,29,2,31,11,2009-04-09 05:14:56,2009-04-03 19:32:20
499c29394ce1ead3ebd29b0d3c8014cdb7a32e63...1b19ccd236e3369ac77d74ded207406ffbf9feca,12,48,2,50,13,2009-04-09 05:42:16,2009-04-03 19:33:59
5aaa507b067ca22324c34308cb56bcb64392a5db...951886481668b97485640a1b24fc73fccff0d629,3,93,6,99,14,2009-04-05 08:29:35,2009-03-26 04:55:49
951886481668b97485640a1b24fc73fccff0d629...4eb5b64631d281f3789b052efac53f4c1ec2c1b6,1,9,14,23,3,2009-04-05 08:29:44,2009-04-04 20:59:36
4eb5b64631d281f3789b052efac53f4c1ec2c1b6...1bf072e3661eeef8d9721079a332e804b5678c7e,6,105,0,105,10,2009-04-05 08:29:44,2009-03-26 04:55:54
1bf072e3661eeef8d9721079a332e804b5678c7e...3b437b0dabfdff12d5dd78b9bb55a0be4e2da51c,1,46,9,55,6,2009-04-05 08:29:44,2009-03-26 04:55:59
3b437b0dabfdff12d5dd78b9bb55a0be4e2da51c...23b5f18b50c15155f79618522b5721b880eceb65,1,12,77,89,11,2009-04-05 08:29:44,2009-03-26 04:56:02
23b5f18b50c15155f79618522b5721b880eceb65...b74d7efb108c9d3fd2d057b0c452583552a0577a,1,60,0,60,1,2009-04-05 08:29:45,2009-03-29 09:45:01
b74d7efb108c9d3fd2d057b0c452583552a0577a...37c4c38d7356bf256d0297fdbac78ef8b6807fac,3,13,10,23,10,2009-04-05 08:29:45,2009-03-29 09:55:43
37c4c38d7356bf256d0297fdbac78ef8b6807fac...e89aa6d2f546b2d4f2d88c15ce7e343751d6922f,4,23,25,48,8,2009-04-05 08:29:45,2009-03-30 04:59:59
e89aa6d2f546b2d4f2d88c15ce7e343751d6922f...11c211fa06fc396e8ee8132ef83e2f2763ff6976,5,49,46,95,36,2009-04-08 05:12:38,2009-04-06 19:28:36
11c211fa06fc396e8ee8132ef83e2f2763ff6976...d797257eb280b67dd1f7153a66b03453c0fb927a,3,34,28,62,21,2009-04-08 05:12:41,2009-04-06 20:28:00
d797257eb280b67dd1f7153a66b03453c0fb927a...13858e5770dd218e5318819d3273c916b46cf8e5,3,9,12,21,10,2009-04-08 05:12:44,2009-04-07 03:08:42
fbdc05661d9b732d06c47ccb3d5836d0d1b563e5...4c0fe0af68fdfc2d328992b8cadc953159f0ea30,1,17,17,34,17,2009-04-08 05:07:58,2009-04-07 17:24:32
4c0fe0af68fdfc2d328992b8cadc953159f0ea30...982962ce24c7d614d94f40de54cfcfdf71dcb0d2,1,11,11,22,7,2009-04-08 05:08:13,2009-04-07 17:24:33
fbdc05661d9b732d06c47ccb3d5836d0d1b563e5...3d4ecc0e23b2b2f555e7d33b5623fd4e67cc2ac7,1,7,7,14,6,2009-04-08 05:06:12,2009-04-07 07:05:01
3d4ecc0e23b2b2f555e7d33b5623fd4e67cc2ac7...8db9a4b85d6b0d7424c8a19b77a5baa8529ab64c,1,26,21,47,3,2009-04-08 06:18:14,2009-04-07 07:06:51
8db9a4b85d6b0d7424c8a19b77a5baa8529ab64c...8cae19d987b1bbd43258558f591e39d9d216dcb3,3,41,0,41,12,2009-04-08 06:22:15,2009-04-07 07:09:39
8cae19d987b1bbd43258558f591e39d9d216dcb3...7c2b3029df45a74d0ebd11afcc94259791cfb90d,3,101,104,205,4,2009-04-08 06:22:15,2009-04-07 07:14:20
89fbda24256157cc43848488429fd20cf3bb21ab...ebbc088e13e1bf0dbf8eb08b00519602c176f864,2,24,2,26,5,2009-03-30 08:22:53,2009-03-29 09:44:44
ebbc088e13e1bf0dbf8eb08b00519602c176f864...eaa759b9141f125d7e55a4b08b60497845d3c52e,2,18,0,18,2,2009-03-30 08:22:53,2009-03-29 09:44:52
eaa759b9141f125d7e55a4b08b60497845d3c52e...2a8177b63d39503b182248b04ffcc75e3495754c,2,9,3,12,5,2009-03-30 08:22:53,2009-03-30 03:07:15
2a8177b63d39503b182248b04ffcc75e3495754c...ff62d732d826efcf271cd6c50a41f613af97aff6,1,1,1,2,2,2009-03-30 08:22:54,2009-03-26 04:55:17
ff62d732d826efcf271cd6c50a41f613af97aff6...a2ad79ced25e1b76fabec079549f521e8071ddd1,4,398,387,785,7,2009-03-30 08:22:54,2009-03-26 04:55:24
a2ad79ced25e1b76fabec079549f521e8071ddd1...9996983c9c35353f352ef7c1abd9b3d2fbb21114,1,45,38,83,2,2009-03-30 08:22:54,2009-03-26 04:55:30
9996983c9c35353f352ef7c1abd9b3d2fbb21114...6a17fad73369173ca71d3adf0d4335a0c8137cb9,2,5,2,7,4,2009-03-30 08:22:54,2009-03-26 04:55:35
6a17fad73369173ca71d3adf0d4335a0c8137cb9...7428d754e2dec9e82253d1e02b4df20fab3f3384,2,9,7,16,7,2009-03-30 08:22:54,2009-03-26 04:55:41
89fbda24256157cc43848488429fd20cf3bb21ab...5c928c06e251b651202f94aaac56cacd3f57c484,1,12,0,12,1,2009-03-25 19:12:35,2009-03-25 16:27:28
98ef23b3b106ef8cf4dc0db34e62a39e044cf99b...85b4518f44b1950918c80c32d1ede4731cb78b76,1,9,1,10,2,2009-01-28 21:30:20,2009-01-28 20:43:57
85b4518f44b1950918c80c32d1ede4731cb78b76...1ba68ce23788dfc5cbe3501cb6b1ee95e68cf5a8,1,10,0,10,1,2009-01-28 22:13:54,2009-01-26 11:50:11
1ba68ce23788dfc5cbe3501cb6b1ee95e68cf5a8...ad59a7a359ffa3bf0903f1d35ccfd3910f9bbef2,1,2,0,2,2,2009-01-28 22:13:54,2009-01-26 11:50:12
ad59a7a359ffa3bf0903f1d35ccfd3910f9bbef2...3ac109ae4c513b12959f3661b9d8f86b99f150d0,1,3,1,4,1,2009-01-28 22:13:54,2009-01-26 11:50:13
3ac109ae4c513b12959f3661b9d8f86b99f150d0...0cf31285a0e1a40745eb2a91534f6e6b54df0e2f,1,4,0,4,1,2009-01-28 22:13:54,2009-01-26 11:50:14
0cf31285a0e1a40745eb2a91534f6e6b54df0e2f...2757b54d469783ea9eac3ba366c4ffaa194c990d,1,1,1,2,1,2009-01-28 22:13:54,2009-01-26 11:50:15
2757b54d469783ea9eac3ba366c4ffaa194c990d...cd956c73a2cce6613a6cd19df6ccb9ff1b08f79a,1,19,1,20,1,2009-01-28 22:13:54,2009-01-26 11:50:16
98ef23b3b106ef8cf4dc0db34e62a39e044cf99b...269defdf30a4beb48f230e36f20d00ee40348ab6,3,20,18,38,6,2009-01-28 19:32:27,2009-01-26 14:13:23
269defdf30a4beb48f230e36f20d00ee40348ab6...7fcdb36e29f9a5e779bc9e44cd69f8f69fac9426,3,19,17,36,5,2009-01-28 19:33:03,2009-01-26 14:13:24
7fcdb36e29f9a5e779bc9e44cd69f8f69fac9426...32c35cfb1e9c8523b9d60e5095f1c49ebaef0279,3,146,3,149,11,2009-01-28 19:33:51,2009-01-26 14:13:25
919ab6429aab9af44feea0768feef80f3092e9d3...b59122f86f23007fce374f92de7f6e0a73793026,3,34,2,36,3,2009-02-07 08:51:47,2009-02-07 08:51:47
c0f6f67b3d6c8afb89847b6b7bc187d7bed260eb...08e6710f76165f79cfa3cde9b10bb051fb0d0dc9,4,19,8,27,7,2009-02-01 20:11:15,2009-02-01 17:45:05
08e6710f76165f79cfa3cde9b10bb051fb0d0dc9...e80f97e20c8122f79450e1f40f569df0b52773e9,1,4,6,10,2,2009-02-02 02:33:51,2009-02-01 21:37:45
e80f97e20c8122f79450e1f40f569df0b52773e9...2ea3c17189bf9ca459879129ca190792b5451f05,1,39,26,65,6,2009-02-02 02:54:04,2009-01-30 22:47:01
de8139005f04a4a5ad8a54c771475803594028cd...e1ff064e1bffedb917c491681b7bfd4d66633ef5,1,180,0,180,1,2009-02-04 23:07:49,2009-02-04 10:04:18
e1ff064e1bffedb917c491681b7bfd4d66633ef5...5c7eee03da32ac8ff5e91159670558b0d7fb9b1a,1,2,2,4,2,2009-02-04 23:08:08,2009-01-06 03:14:02
5c7eee03da32ac8ff5e91159670558b0d7fb9b1a...34263de0265a484bf44058819a363bb1e627c0ce,10,11,11,22,10,2009-02-04 23:08:49,2009-01-04 18:39:27
34263de0265a484bf44058819a363bb1e627c0ce...8aa7eebfb3383a32033a4af901142173ec87c830,1,84,48,132,21,2009-02-04 23:16:35,2009-02-04 09:15:29
5760a6b094736e6f59eb32c7abb4cdbb7fca1627...3e073dc561185d5ad2325cb012943020e068801e,1,11,11,22,2,2008-08-26 06:14:39,2008-08-25 15:33:03
5760a6b094736e6f59eb32c7abb4cdbb7fca1627...0843acfd2c32dd8a8594731a0090d0934ccb123b,4,38,24,62,14,2008-08-25 06:28:02,2008-08-25 06:15:05
0843acfd2c32dd8a8594731a0090d0934ccb123b...d47fb8b099d38cde7d3b27b44cc86cd720284d39,1,2,1,3,1,2008-08-26 23:22:00,2008-08-26 17:50:37
d47fb8b099d38cde7d3b27b44cc86cd720284d39...2b8437321901cf1559527090f5a475f4924031e5,3,4,10,14,4,2008-08-26 23:25:30,2008-08-26 17:52:57
2b8437321901cf1559527090f5a475f4924031e5...d0b92a3f6e4d98a38a86cbd86f0e39eea9005958,1,2,0,2,2,2008-08-26 23:25:48,2008-08-26 14:32:42
6249067c614f9c190a5261bb95c5a9a3a41ef039...861c68e3b6a8d10af5517e6750a66407d32105aa,1,27,16,43,6,2008-12-02 15:20:19,2008-12-02 15:15:02
6e13921b4f7adcc7316a76c0c4955b85b1589a65...357af14fc491748c874cd8791a5bcf5e1a426ee8,1,4,4,8,2,2008-11-17 15:33:42,2008-11-17 11:15:49
357af14fc491748c874cd8791a5bcf5e1a426ee8...83b767360a183abf29cb0cc0fd647fb683cff616,1,1,1,2,1,2008-11-17 15:54:07,2008-11-17 15:54:07
83b767360a183abf29cb0cc0fd647fb683cff616...b3d9888792f220f4c1e72953874484a0cf0575fe,1,11,1,12,2,2008-11-17 16:21:31,2008-11-17 15:42:47
b3d9888792f220f4c1e72953874484a0cf0575fe...6e702c245803e3cdf2cad3f1f74aa4d894aa165a,3,12,0,12,4,2008-11-17 16:21:34,2008-11-17 15:43:04
a14f6ca26a1f17a6aa1c4dd8994ca1e1bcbe1729...1e368681bd8c35202b91f8998e07d8bbb3de6c7c,1,6,6,12,6,2008-09-10 18:16:10,2008-09-10 17:32:44
1e368681bd8c35202b91f8998e07d8bbb3de6c7c...836ff95df6de9924cf8cf23515e3779a67a6bdec,2,32,14,46,14,2008-09-10 18:45:22,2008-09-08 16:53:01
836ff95df6de9924cf8cf23515e3779a67a6bdec...971e628384fea14e9c0bf96e1c69b97df6ec540e,1,1,1,2,1,2008-09-10 18:47:06,2008-09-10 15:09:46
971e628384fea14e9c0bf96e1c69b97df6ec540e...3632cfc2487afc41c7c9e939a9d357daca3e5d67,6,10,2,12,4,2008-09-10 20:36:40,2008-09-07 18:45:37
3632cfc2487afc41c7c9e939a9d357daca3e5d67...873358dd2ac3bf2cea9a370d8586378a27a092f2,1,22,2,24,8,2008-09-10 20:38:20,2008-09-10 19:45:02
18309f4c3e00886660f15e18c1aaab2f5bc25715...8b4eb6b6cd65042c6ecb4f06f19c1f2441899ed6,4,5,5,10,5,2008-09-22 19:19:14,2008-09-22 17:20:21
8b4eb6b6cd65042c6ecb4f06f19c1f2441899ed6...db87e3960c5a770db13c9ba9602b5e88848e2d1a,1,12,10,22,9,2008-09-23 08:53:07,2008-09-22 23:34:26
cd0843198fecf9faa6e82f6db15fc9c7ec31d3f4...1883a0d3b7ad7c9de1ac790bda6f1a6181237439,1,3,3,6,2,2008-09-20 06:52:49,2008-09-20 06:52:49
1883a0d3b7ad7c9de1ac790bda6f1a6181237439...3d8dccd74aa29a9019c4e8b52e75a40189e6f5cb,2,11,8,19,6,2008-09-20 07:52:11,2008-09-20 07:52:11
df85f7855da44c730f942b330ada181209d09d7a...ee837244df2e2e4e9171f508f83f353730db9e53,1,1,1,2,1,2008-08-30 20:23:01,2008-08-30 20:08:50
ee837244df2e2e4e9171f508f83f353730db9e53...ed0f47a8c431f27e0bd131ea1cf9cabbd580745b,2,16,4,20,6,2008-08-30 20:23:02,2008-08-30 20:20:31
ed0f47a8c431f27e0bd131ea1cf9cabbd580745b...bbb896d8e10f736bfda8f587c0009c358c9a8599,1,37,3,40,2,2008-08-31 03:30:45,2008-08-30 21:35:15
10c4c881c4d2cb0ece0508e7142e189e68445257...7d092adc8f4f54d18f5737c155d5b21e45e81a74,1,2,1,3,1,2011-07-11 17:52:38,2011-07-09 17:38:08
10c4c881c4d2cb0ece0508e7142e189e68445257...bf74a88244c4fe631535b50ef090541dddf9029d,1,1,0,1,1,2008-07-26 00:41:13,2008-07-21 19:19:56
bf74a88244c4fe631535b50ef090541dddf9029d...35eeef47220c68c92d0f377f5678c42da2232c20,1,12,0,12,1,2008-07-26 00:41:13,2008-07-21 19:19:57
35eeef47220c68c92d0f377f5678c42da2232c20...7b4b59a963c726d30b319a79c1f8243a82d6e12f,1,2,2,4,3,2008-07-26 00:41:13,2008-07-21 19:19:58
7b4b59a963c726d30b319a79c1f8243a82d6e12f...128de6576743901b11f243509753320038e74ba7,2,139,0,139,4,2008-07-26 00:54:19,2008-07-25 15:32:37
128de6576743901b11f243509753320038e74ba7...b0320eaf6a25fbc4adf35d611c27006e6d853aa8,1,9,6,15,6,2008-07-26 00:57:22,2008-07-25 20:49:08
362b0dd523f5162e7c55c76b5d0af7ad830e0e83...861f00e3496fd5cd866a73f11826dfc8822a5195,1,5,2,7,1,2008-04-30 05:22:19,2008-04-30 04:13:58
861f00e3496fd5cd866a73f11826dfc8822a5195...b3bb5f76e6193db102b063187be854ef3842d89b,1,1,1,2,1,2008-04-30 05:45:27,2008-04-30 04:36:14
41e98de4280dbb340e64da0a0129edbda9108ccf...f9a08f618f3aa586a6859283dd2d0cd5a8dc4f96,1,53,33,86,9,2008-06-26 05:41:10,2008-06-25 23:14:31
f9a08f618f3aa586a6859283dd2d0cd5a8dc4f96...de8d95703417a93bb6231f823bb82746f01e8a58,2,106,1,107,2,2008-06-26 07:27:06,2008-06-26 07:13:37
de8d95703417a93bb6231f823bb82746f01e8a58...4c2d5d722c4775c1efd5e63f41ba5b303ec8fb65,1,4,0,4,1,2008-06-26 19:10:42,2008-06-22 18:12:39
4c2d5d722c4775c1efd5e63f41ba5b303ec8fb65...d2bf48d2ad653ee8a052aa460ca5c6ef29dce41d,1,70,17,87,3,2008-06-26 19:13:03,2008-06-26 08:08:41
6b516d984bc72b359a14eeddfddca578cef52297...1f5c74f6cf918d317c73b328dcd4cf6f55c44d8a,4,4,6,10,6,2008-06-24 04:25:20,2008-06-24 01:22:14
1f5c74f6cf918d317c73b328dcd4cf6f55c44d8a...8eca0b47ff1598a6d163df9358c0e0c9bd92d4c8,2,78,16,94,14,2008-06-24 04:29:33,2008-06-24 01:23:39
8eca0b47ff1598a6d163df9358c0e0c9bd92d4c8...29b0d01912cdf291ad2e9f6a4f143ee9e3c01ef9,1,194,0,194,1,2008-06-24 04:29:37,2008-06-24 01:24:28
29b0d01912cdf291ad2e9f6a4f143ee9e3c01ef9...27d69a465d14b516d6a1ba287edc83606f23a5a5,1,15,18,33,9,2008-06-25 00:03:44,2008-06-24 22:58:06
27d69a465d14b516d6a1ba287edc83606f23a5a5...ba2d0f4f35beffbf715ca652d5b36df8c0ad5ceb,1,23,4,27,5,2008-06-25 02:06:06,2008-06-25 02:05:45
ba2d0f4f35beffbf715ca652d5b36df8c0ad5ceb...f98f8cbac01e0d5dbb30660d7ea70af6a1439dfd,12,25,25,50,11,2008-06-25 02:06:22,2008-06-25 01:45:21
f98f8cbac01e0d5dbb30660d7ea70af6a1439dfd...8e21d63b02f1b26f7695ca515e51e4622a995af2,5,39,11,50,8,2008-06-25 06:23:21,2008-06-25 05:41:34
8e21d63b02f1b26f7695ca515e51e4622a995af2...99093238bbf2cd886debf7bdb91478cb405ef66d,3,3,4,7,3,2008-06-25 06:58:57,2008-06-25 03:17:12
99093238bbf2cd886debf7bdb91478cb405ef66d...77d3ecee85dbf354d2059d7ef65d788d90db3efa,6,67,70,137,8,2008-06-25 06:58:57,2008-06-25 03:18:17
77d3ecee85dbf354d2059d7ef65d788d90db3efa...c41a4a9468b0c728e77ec5d97da7bfb63776ac3f,3,38,25,63,8,2008-06-25 06:58:57,2008-06-25 03:19:02
c41a4a9468b0c728e77ec5d97da7bfb63776ac3f...85fe23ed2a5d88463f5362a3e4fdd6f45a0555fd,1,14,0,14,1,2008-06-25 06:58:57,2008-06-25 03:19:44
68149a71978564aaef7a5fe956cf1de2864c16d3...e11601381e384898418c30bd537a9daa1210c300,1,1,1,2,1,2008-11-18 10:40:32,2008-11-18 10:40:32
e19b92becaafb7bee6cab22234c1179af20c12fc...0f4f4d1597219bad74c4fde624321d8a05d1b55e,3,5,5,10,5,2008-08-08 05:41:24,2008-08-07 23:05:25
e449f105805ffa49ccf7cf080db897ecf65a1a0f...f05951fe3ffe461eb9cb715bf7cd08535657f29c,4,5989,0,5989,4,2008-06-22 09:32:33,2007-12-09 14:43:34
f05951fe3ffe461eb9cb715bf7cd08535657f29c...58eda02257a89df6e05f504bdf87e578d90f3b5e,1,4,2,6,3,2008-06-22 09:32:45,2007-12-01 10:10:54
58eda02257a89df6e05f504bdf87e578d90f3b5e...f4626df51f63d53b89ff01de54cbf7558217ea2b,5,244,7,251,13,2008-06-22 09:32:45,2007-12-01 20:24:59
f4626df51f63d53b89ff01de54cbf7558217ea2b...80ba074f4163dc8ee4232d64e73a8521edcadc1d,5,15,5,20,5,2008-06-22 09:32:45,2007-12-03 20:55:57
80ba074f4163dc8ee4232d64e73a8521edcadc1d...4cd148d83f852363363e921c4925e67601654ff6,1,5,8,13,4,2008-06-23 11:22:35,2008-03-01 20:11:14
4cd148d83f852363363e921c4925e67601654ff6...25fe217b86ca40c53e710d776e120dfa0d81f60b,5,67,15,82,21,2008-06-23 11:30:22,2008-03-05 20:51:27
25fe217b86ca40c53e710d776e120dfa0d81f60b...8385abfda533819be9fbec436230ccd7be4bcda8,1,8,4,12,3,2008-06-23 11:30:27,2007-11-30 20:36:00
8385abfda533819be9fbec436230ccd7be4bcda8...23326d14edbd16469453f6c3ecdd98ab90e6efb7,3,21,3,24,5,2008-06-23 11:34:55,2007-12-08 19:57:25
23326d14edbd16469453f6c3ecdd98ab90e6efb7...3e4a1ba07b65506c36f7f40fa76fcee26c400a5c,2,23,0,23,2,2008-06-23 11:38:07,2007-11-15 21:22:47
3e4a1ba07b65506c36f7f40fa76fcee26c400a5c...f7597acac069bbaad8887cb315a4e5420222971a,1,8,0,8,2,2008-06-23 11:38:10,2007-12-01 21:09:17
f7597acac069bbaad8887cb315a4e5420222971a...132a6e903fd912d02392db55c407267103766f19,1,8,0,8,1,2008-06-23 11:38:23,2007-01-23 12:39:09
132a6e903fd912d02392db55c407267103766f19...ea9e98c3a54d3b693367fbb8c87812b17ad95869,2,28,0,28,2,2008-06-23 11:40:18,2007-12-07 21:19:40
ea9e98c3a54d3b693367fbb8c87812b17ad95869...bb5799d6ef3ad7ee70a138b82e67b93e3aaa8017,2,9,5,14,6,2008-06-23 11:40:29,2008-06-23 06:31:41
bb5799d6ef3ad7ee70a138b82e67b93e3aaa8017...a42a0c2e715d6783a6f9b75a8f2c9a48bf499c47,1,14,1,15,1,2008-06-23 11:40:29,2007-12-01 20:51:20
a42a0c2e715d6783a6f9b75a8f2c9a48bf499c47...82f8d969f581c4bd4a782565709466046d962d81,1,1,0,1,1,2008-06-23 11:40:30,2007-03-23 09:57:05
82f8d969f581c4bd4a782565709466046d962d81...6072fc314e87d53bec7266df5b6c3db2c2c82829,2,113,2,115,4,2008-06-23 11:40:30,2007-11-13 09:14:45
6072fc314e87d53bec7266df5b6c3db2c2c82829...f1a4dfb85a432ae338d162179eaac5d50154fbeb,2,187,0,187,2,2008-06-23 11:40:30,2007-12-04 11:38:32
f1a4dfb85a432ae338d162179eaac5d50154fbeb...897bb8cb2c2ce6b73038bd8d4106fde079a09cf6,2,46,4,50,3,2008-06-23 11:40:31,2007-12-07 21:05:36
897bb8cb2c2ce6b73038bd8d4106fde079a09cf6...ba26f296f9ddc694fc42683132bc328dffd777ec,3,153,14,167,5,2008-06-23 11:40:31,2007-12-07 21:08:59
ba26f296f9ddc694fc42683132bc328dffd777ec...6ed807f8432c558ef102c94cb2e8ae4e03c48d4e,1,56,1,57,1,2008-06-26 06:45:07,2007-12-01 21:00:56
6ed807f8432c558ef102c94cb2e8ae4e03c48d4e...be501813d25bedc1a441940f349fb91bd9fa4ef6,2,3,2,5,2,2008-06-26 06:45:08,2007-11-30 21:51:10
be501813d25bedc1a441940f349fb91bd9fa4ef6...618ebe9ff997d27714487c4a4232720be240badc,3,35,1,36,10,2008-06-26 06:45:08,2007-12-08 21:19:14
618ebe9ff997d27714487c4a4232720be240badc...87bddba9924045e39e988d9704714db90abd5619,1,13,0,13,1,2008-06-26 06:45:09,2007-11-30 21:06:30
87bddba9924045e39e988d9704714db90abd5619...746fb8574459798d127e3f9cf782ccb8e31c9e45,2,55,0,55,2,2008-06-26 06:45:09,2007-12-26 12:51:18
746fb8574459798d127e3f9cf782ccb8e31c9e45...7e5d776854e858ae69a4cde9db8de6675ffb5de6,3,199,7,206,7,2008-06-26 06:45:10,2007-11-24 21:49:16
7e5d776854e858ae69a4cde9db8de6675ffb5de6...5411bdc4e4b170a57a61b2d486ab344896c41500,2,141,1,142,3,2008-06-26 06:45:10,2007-09-03 18:40:26
5411bdc4e4b170a57a61b2d486ab344896c41500...7c0ffa1cb753f9b909dfb3bc7a5d5417b8de39c2,2,30,0,30,2,2008-06-26 06:45:11,2007-09-07 11:05:00
7c0ffa1cb753f9b909dfb3bc7a5d5417b8de39c2...fc2ded5b08e071beed974117c0148781b1acc94a,2,41,13,54,12,2008-06-26 06:45:11,2007-11-12 11:52:41
fc2ded5b08e071beed974117c0148781b1acc94a...4ec22a48c0575c8a303cd00b5ef4b3d703fbf8b3,1,7,3,10,4,2008-06-26 06:45:12,2007-04-11 13:26:08
4ec22a48c0575c8a303cd00b5ef4b3d703fbf8b3...6fad004a37432e4378b6cce53eebe8a079104e93,1,29,0,29,2,2008-06-26 06:45:12,2007-04-11 14:02:45
6fad004a37432e4378b6cce53eebe8a079104e93...8512439af25c93942d569d250d49d135d8b7062b,1,2,0,2,1,2008-06-26 06:47:07,2007-11-30 21:28:38
8512439af25c93942d569d250d49d135d8b7062b...0b50b860a505d4a1d6fa595a400f3968333e7128,2,12,5,17,6,2008-06-26 06:47:14,2008-01-01 21:15:21
0b50b860a505d4a1d6fa595a400f3968333e7128...bfdd9ffd2f7376ccb8b9d4c4e39e2e0fe97d6b37,1,38,2,40,7,2008-06-26 06:47:15,2007-12-08 20:28:41
bfdd9ffd2f7376ccb8b9d4c4e39e2e0fe97d6b37...b2f5e2684da060dd821bf90f88df8b6dc9401a40,1,6,1,7,1,2008-06-26 06:47:15,2007-08-17 16:40:36
b2f5e2684da060dd821bf90f88df8b6dc9401a40...cc3b7a9732f940cb0249a12cb3c02e3d83723eb0,1,28,5,33,4,2008-06-26 06:47:16,2008-01-14 13:05:33
cc3b7a9732f940cb0249a12cb3c02e3d83723eb0...6fd6aec44fe79dff61fd37a5fec2456c5458b574,2,16,0,16,2,2008-06-26 06:47:16,2008-06-22 09:35:21
6fd6aec44fe79dff61fd37a5fec2456c5458b574...cd800eecc27ef57cb934f349f116cd7022ec71ed,1,4,0,4,1,2008-06-26 06:47:17,2007-11-17 18:16:53
cd800eecc27ef57cb934f349f116cd7022ec71ed...14086b0a13f5f5ac456cb9ae16a263f92908ae61,1,6,0,6,1,2008-06-26 06:47:17,2007-11-17 19:48:14
e449f105805ffa49ccf7cf080db897ecf65a1a0f...074afaa0cf69e7d49bc00d969f57893c9ddea748,1,105,106,211,79,2008-06-20 00:43:58,2008-06-19 20:03:21
e449f105805ffa49ccf7cf080db897ecf65a1a0f...78d0f5d210bc053d961185be6cfb0e248a0bdda3,2,0,8,8,2,2008-06-20 00:07:22,2008-06-18 23:21:09
78d0f5d210bc053d961185be6cfb0e248a0bdda3...e4bffb5a1d9ab3c9c0ef0541a395d47516480d97,2,1,2,3,2,2008-06-20 00:07:41,2008-06-18 23:21:11
e449f105805ffa49ccf7cf080db897ecf65a1a0f...044bbbcb63281dfdb78344ada2c44c96122dc822,3,20,1,21,4,2008-06-19 23:44:21,2008-06-19 19:34:06
e449f105805ffa49ccf7cf080db897ecf65a1a0f...f28ac70f48aa36f0d6ea1cbaa967b56802549016,4,23,8,31,10,2008-06-19 23:00:38,2007-11-28 16:21:57
f28ac70f48aa36f0d6ea1cbaa967b56802549016...98db51e624f45bcfae0a183ce86e0c1f1814269e,1,1,1,2,1,2008-06-25 04:26:59,2008-06-25 02:58:11
e449f105805ffa49ccf7cf080db897ecf65a1a0f...48ec3e5c073e97c15842ac16523444786b37774e,1,1,0,1,1,2008-06-19 22:53:13,2008-06-15 14:04:20
48ec3e5c073e97c15842ac16523444786b37774e...94e724a741590e741a540075c07a961082e3c80a,4,138,120,258,7,2008-06-19 22:53:13,2008-06-15 14:05:06
94e724a741590e741a540075c07a961082e3c80a...d0d12b476822bb8686ee883bd44b799563069a48,1,6,3,9,1,2008-06-19 22:53:13,2008-06-15 23:16:53
d0d12b476822bb8686ee883bd44b799563069a48...3e8aded20329bef35470eb469281f6b275d19dea,1,6,2,8,2,2008-06-19 22:53:13,2008-06-15 14:06:16
e449f105805ffa49ccf7cf080db897ecf65a1a0f...df6a7ff7ac55d320afa1b8a59393122d6ca0f6c4,3,137,6,143,12,2008-06-19 22:52:53,2008-06-11 11:17:04
e449f105805ffa49ccf7cf080db897ecf65a1a0f...5e2c08c6f0209e94b36d0770abae1a2b571cb0f1,2,6,0,6,2,2008-06-19 21:21:42,2008-06-17 01:29:02
e449f105805ffa49ccf7cf080db897ecf65a1a0f...641dba49bf819dc5f4874a75b206bc7f51dc14e6,1,12,12,24,9,2008-06-19 21:13:55,2008-06-16 23:33:41
e449f105805ffa49ccf7cf080db897ecf65a1a0f...037e98f20241bf013cd007b0924936a29c3cacfa,1,1,1,2,1,2008-06-19 21:13:02,2008-06-18 20:16:08
037e98f20241bf013cd007b0924936a29c3cacfa...20827d99c5ee079d92831474a0b6e66b79757dbd,1,1,0,1,1,2008-06-19 23:02:31,2008-06-19 21:15:53
20827d99c5ee079d92831474a0b6e66b79757dbd...e2007832552ccea9befed9003580c494f09e666e,1,5,1,6,1,2008-06-19 23:07:06,2008-06-19 17:32:02
e2007832552ccea9befed9003580c494f09e666e...3b2bbe9b8584947e33e9149f605149530faa7361,1,2,1,3,2,2008-06-19 23:30:26,2008-06-19 22:41:42
e449f105805ffa49ccf7cf080db897ecf65a1a0f...806e2ad7fe2d94e1ecae904c33b822b3dfac57f6,1,26,16,42,3,2008-06-18 23:50:22,2008-06-18 21:37:18
806e2ad7fe2d94e1ecae904c33b822b3dfac57f6...d1364529d06e5fa3bc054396299944a7a4861776,1,13,4,17,3,2008-06-18 23:50:23,2008-06-18 21:40:35
d1364529d06e5fa3bc054396299944a7a4861776...1141f4925c3f1d7c8cc476b10107209e56909c6d,1,29,11,40,5,2008-06-18 23:50:32,2008-06-18 22:00:11
1141f4925c3f1d7c8cc476b10107209e56909c6d...aafe9fbaf4f1d1f27a6f6e3eb3e246fff81240ef,5,17,1,18,5,2008-06-18 23:50:35,2008-06-18 22:18:44
23abd3f48cb217d1558fa1984bfa8c502717c08f...21188b1eafd3741fda0f7905dc997279a17b50ba,5,25,1,26,7,2008-10-09 18:26:17,2008-10-08 23:40:32
bf8f2ad5f20b8c911d6a84438faa3c994decf71b...52e8370bc7a71366b664ece0a9ec0b79d673a356,1,64,0,64,1,2008-10-03 01:38:37,2008-10-02 09:11:55
3041b98a9d40e5eb1aae9698c7e15c85ff37f344...a6c7db1b1945d656cc0dd559d93c7b2129c65d86,1,83,69,152,6,2008-10-19 21:38:04,2008-10-18 01:17:23
759ad19e772a79a2a5ae6b7377d57eb21d29e6a0...72cf48414071636546eddfbfc828eda81649cb48,1,1,1,2,1,2008-10-26 21:09:47,2008-10-26 04:41:28
72cf48414071636546eddfbfc828eda81649cb48...678852d918e874c99590ba6e857efeef974a3fb9,1,53,13,66,6,2008-10-26 21:09:47,2008-10-26 04:41:52
678852d918e874c99590ba6e857efeef974a3fb9...df5e91fc2c95e051744ec9b9de66869d2b323037,1,118,0,118,1,2008-10-26 21:09:48,2008-10-26 04:42:25
759ad19e772a79a2a5ae6b7377d57eb21d29e6a0...53ffb878a94c3eae7c7f57e05568aedcfb77e57f,2,13,0,13,2,2008-10-24 23:34:01,2008-10-24 05:48:50
53ffb878a94c3eae7c7f57e05568aedcfb77e57f...b8492539f9c078162ee3ae4987ceaa7e7f510c9b,1,7,2,9,2,2008-10-26 21:05:55,2008-10-26 18:07:18
4258c212ca2c3674be4b7e00a19db705eee77a48...c94736a27f89bfc268aed0de7264deecdc136a58,2,80,3,83,2,2009-07-31 02:25:05,2009-07-31 00:38:15
9b7dc7183528d42c46786a0be1acc58d4cd1f47a...959e2e64a594e2fb8de2585078e31b07a8da6fc9,1,3,2,5,2,2009-06-18 16:52:10,2009-06-17 14:26:06
959e2e64a594e2fb8de2585078e31b07a8da6fc9...1b19fa46344f512949270dc88089574950519ea3,1,7,5,12,7,2009-06-18 16:52:28,2009-06-17 10:11:10
13c5833c094e3d889df8e4a4f0ff30bb874c1b14...90f2e6526b3b800af4d10b900167a508b3774b98,1,1,0,1,1,2009-05-16 17:23:26,2009-05-14 06:47:41
90f2e6526b3b800af4d10b900167a508b3774b98...ca156cfcc2dee5a1cee4f96023bb2f8c15a2c48c,1,1,1,2,1,2009-05-16 18:47:10,2009-05-16 09:24:44
ca156cfcc2dee5a1cee4f96023bb2f8c15a2c48c...f044fe2de6f7bbace158853c075a4065f3722265,2,17,0,17,2,2009-05-16 18:47:19,2009-05-16 09:24:45
2a1feb92ee58770670e6b82992d29cbc5d6f04aa...e57cb0158209ece040a4b873064504efd7d2ec0e,2,52,1,53,2,2009-05-26 02:20:39,2009-05-26 02:20:39
235236c83dcff00d9df3910aaf10b74a3929068d...4774780ab196ff4ace780445c06c8e5bfffffc49,2,5,7,12,2,2009-05-13 05:30:29,2009-05-13 05:28:22
3536ae331014c68a25c80b3fb530a19c8dee0f11...226b343cde7624e4f273a45d83009799447c914b,1,48,0,48,14,2009-05-06 05:05:36,2009-05-04 06:25:31
226b343cde7624e4f273a45d83009799447c914b...0aa62fd0414b0e8a6271d1d0dd80e5f640633473,1,45,0,45,8,2009-05-06 05:05:36,2009-05-04 06:25:32
0aa62fd0414b0e8a6271d1d0dd80e5f640633473...9b82d63b5a109112643843a8e6d1a201fdf2ec63,1,4,0,4,1,2009-05-06 05:05:37,2009-05-04 06:25:33
9b82d63b5a109112643843a8e6d1a201fdf2ec63...672c68cbb90921a133ddf71d002342a448b6dd38,1,6,3,9,3,2009-05-06 05:05:37,2009-05-04 06:25:34
672c68cbb90921a133ddf71d002342a448b6dd38...ae616de6d53ef14ba11d2aa32f366086c1435dfa,1,36,3,39,5,2009-05-06 05:05:37,2009-05-04 06:25:35
1f9b620fdbf27835f54b11008d64c4014b8f4c32...1d49f0d1a1b7b2941e56cf8384a7a4267e98150c,1,38,0,38,1,2009-04-20 20:46:55,2009-04-11 15:26:24
1d49f0d1a1b7b2941e56cf8384a7a4267e98150c...e8141fcf54b4e8c2c12300da1ad1bc3573a4e204,2,47,8,55,10,2009-04-20 20:46:58,2009-04-11 19:31:00
e8141fcf54b4e8c2c12300da1ad1bc3573a4e204...f0583867e746985e9d62f57d5ba6ce27b2603447,1,31,3,34,3,2009-04-20 20:47:02,2009-04-18 21:03:57
1f9b620fdbf27835f54b11008d64c4014b8f4c32...7183c09d11ac4b98f1cc78f29dcbd85df5533001,1,1,0,1,1,2009-04-20 20:44:14,2009-04-20 17:44:53
7183c09d11ac4b98f1cc78f29dcbd85df5533001...3ac3cfb8ebd66ff57ba5e316abddc9612e7b485e,1,1,1,2,1,2009-04-20 20:45:02,2009-04-18 14:38:42
1f9b620fdbf27835f54b11008d64c4014b8f4c32...8cc21ce78c2f3781024117047c0650861f890213,1,2,4,6,4,2009-04-20 11:16:40,2009-04-20 10:58:17
8cc21ce78c2f3781024117047c0650861f890213...b9d37a5420446d0db2dc0dc5458a5e50656a4852,4,40,36,76,7,2009-04-20 11:16:41,2009-04-20 10:58:18
b9d37a5420446d0db2dc0dc5458a5e50656a4852...456156dc068b7664c08e35157e17a6440ec68f32,1,5,0,5,2,2009-04-20 11:16:41,2009-04-20 10:58:19
456156dc068b7664c08e35157e17a6440ec68f32...83ae209bf9708bf1b67dbac4a3629a0003af5dbb,1,8,1,9,5,2009-04-20 11:16:42,2009-04-20 10:58:20
66996ecc28f001d3dcc73090717bb8c6e47c0d75...eaf158f8bd7615562e1fa84711ea465f387a3c9d,2,49,19,68,10,2009-04-23 01:32:16,2009-04-21 12:47:01
66996ecc28f001d3dcc73090717bb8c6e47c0d75...47abd85ba06ed7209d1caa3e5ac7cc6b232bece4,3,54,2,56,6,2009-04-21 07:05:21,2009-04-17 08:20:11
c965c029330b1f81cc107c5d829e7fd79c61d8ea...9a7a1e03d5e530cdad98c41c109e3319c008ce69,2,20,1,21,7,2009-04-16 02:41:35,2009-04-10 14:57:01
9a7a1e03d5e530cdad98c41c109e3319c008ce69...0392513fdc7e98f5ca5dff1ad80962c28029267b,1,21,43,64,11,2009-04-16 08:06:52,2009-04-16 07:14:15
0392513fdc7e98f5ca5dff1ad80962c28029267b...595f6948232a2e37df4f63476662cba20ecf9d8d,1,3,1,4,2,2009-04-16 16:55:15,2009-04-16 16:46:23
c965c029330b1f81cc107c5d829e7fd79c61d8ea...d8c81dfcaf3ac4bab0f0f8f54d2c4ae0425abcbf,1,38,0,38,1,2009-04-13 16:48:49,2009-04-11 15:26:24
d8c81dfcaf3ac4bab0f0f8f54d2c4ae0425abcbf...7fac0eef91cf930ef827b00934701fa5543dce76,2,47,8,55,10,2009-04-16 00:47:55,2009-04-11 19:31:00
c965c029330b1f81cc107c5d829e7fd79c61d8ea...f800b65bea1504299747e7be03ee279508a74e1f,1,1,0,1,1,2009-04-13 04:15:59,2009-04-13 04:15:59
d890d3f99635de7963effd1436148112ef7a52b7...2aa3140bc07d7b593efe2d963d8d9b0a9a0cbf05,1,1,1,2,1,2009-04-18 20:40:34,2009-04-18 09:46:06
982962ce24c7d614d94f40de54cfcfdf71dcb0d2...da81688cc5639c9c482a89a4b732737f7aa0d61d,1,2,1,3,1,2009-04-08 05:19:55,2009-04-06 08:31:16
da81688cc5639c9c482a89a4b732737f7aa0d61d...bad42732008cb0c1e77046d716e4446b1545d4d0,2,16,4,20,6,2009-04-08 05:19:55,2009-04-06 08:31:17
bad42732008cb0c1e77046d716e4446b1545d4d0...b98c212a9fd97300a8cf39015b8d693f319fd71c,3,16,5,21,6,2009-04-08 05:19:55,2009-04-06 08:31:18
b98c212a9fd97300a8cf39015b8d693f319fd71c...76ca653842057766773776bffc6a415b39d5a147,1,3,7,10,5,2009-04-08 05:19:55,2009-04-06 08:31:19
76ca653842057766773776bffc6a415b39d5a147...2e8af7e42b15d4f2d573329ea2593a19f45f18d3,1,1,33,34,3,2009-04-08 05:19:55,2009-04-06 08:31:20
2e8af7e42b15d4f2d573329ea2593a19f45f18d3...46ae156d6c8c48d521e4d858ed84d93259cfc61f,1,5,2,7,2,2009-04-08 05:19:55,2009-04-06 08:31:21
46ae156d6c8c48d521e4d858ed84d93259cfc61f...8b7332221db8522fe23bf8cf25d058acea6b9142,2,17,25,42,14,2009-04-08 05:19:55,2009-04-07 08:21:19
8b7332221db8522fe23bf8cf25d058acea6b9142...1c0f3d224eff2ff8ca8442811edb5a6830adba1a,6,14,11,25,10,2009-04-08 05:19:56,2009-04-06 08:31:23
1c0f3d224eff2ff8ca8442811edb5a6830adba1a...afcbc8e7ecb18a3ee542e808f02f5df7d56d5bdc,7,27,4,31,9,2009-04-08 05:19:56,2009-04-07 08:21:20
afcbc8e7ecb18a3ee542e808f02f5df7d56d5bdc...f92f2038a5192ac5fc1bb4f38c49906aa45b3f1e,1,147,0,147,1,2009-04-08 05:19:56,2009-04-07 23:30:53
f92f2038a5192ac5fc1bb4f38c49906aa45b3f1e...a904392eaeee1629c0ac14dae8e579bb8497636a,5,96,6,102,12,2009-04-08 05:19:56,2009-04-07 08:21:22
a904392eaeee1629c0ac14dae8e579bb8497636a...e2dc2de917778a0601564e238c3cd61614f55e5f,1,22,5,27,3,2009-04-08 05:19:56,2009-04-06 08:31:27
e2dc2de917778a0601564e238c3cd61614f55e5f...9a62d72dfa833f98dd0730b3d5136f56d637a5c3,1,8,8,16,6,2009-04-08 05:19:56,2009-04-06 08:31:28
9a62d72dfa833f98dd0730b3d5136f56d637a5c3...21d0ba7ebb0c6b6c6ad844f8a40fff8dd4c0b105,6,458,388,846,14,2009-04-08 07:25:24,2009-04-08 07:17:20
21d0ba7ebb0c6b6c6ad844f8a40fff8dd4c0b105...70af4e9bef988a98061237c78cbd0a71d8de48bb,1,1,1,2,1,2009-04-11 19:20:17,2009-04-10 19:33:57
70af4e9bef988a98061237c78cbd0a71d8de48bb...47d65924a69576bd9f3254f7055de6b37a359596,4,76,70,146,25,2009-04-12 22:19:12,2009-04-12 03:41:56
7c2b3029df45a74d0ebd11afcc94259791cfb90d...a4165851e769ebc32da48904d58f144f2d93e69a,1,1,1,2,1,2013-10-24 22:41:56,2013-10-24 08:45:13
7c2b3029df45a74d0ebd11afcc94259791cfb90d...2d8a7f0b30b4f9ef750ab763aabec117ffe4e749,2,20,7,27,8,2009-04-08 06:22:15,2009-04-07 07:16:56
c0250b6477d2edf58d0a7bc229bfa4f720c1cd58...7ad3c52e2dc8e81aafa615fb8b65ad99b6a62172,1,4,2,6,2,2009-03-22 06:18:53,2009-03-16 18:38:42
7ad3c52e2dc8e81aafa615fb8b65ad99b6a62172...67c176f549daf5530cabbb801de2b5feb0db82f4,1,1,0,1,1,2009-03-22 06:19:27,2009-03-17 09:03:19
67c176f549daf5530cabbb801de2b5feb0db82f4...93467ee660ed1c145fe91ee8928220be6ef9a51c,2,36,1,37,2,2009-03-22 06:21:15,2009-03-22 06:21:15
bd9efbf35424c9436f62768e47f5819c9b5bcf9e...61d86605dd78f0ac9150e1fc9b99d87d2410e37b,1,0,4,4,1,2009-02-04 05:07:11,2009-02-04 05:07:07
61d86605dd78f0ac9150e1fc9b99d87d2410e37b...e656fc97a2be4586bfef25714d588f002d2605a2,1,1,1,2,1,2009-02-04 05:50:47,2009-02-04 05:46:33
8712b3cdb0495f5a56b91cd67e2697412447a886...29a03348a336f28025c824436a713cb9cb01b7a6,3,44,67,111,6,2009-01-29 04:11:21,2009-01-27 22:34:29
29a03348a336f28025c824436a713cb9cb01b7a6...03af0870a0e6d551a31eb830d5c2682b82ae0ac6,1,12,0,12,1,2009-01-29 04:15:36,2009-01-27 22:34:35
03af0870a0e6d551a31eb830d5c2682b82ae0ac6...008849689e04e774aa7b194cd690405761e2383a,2,43,0,43,2,2009-01-29 04:16:37,2009-01-27 22:34:48
008849689e04e774aa7b194cd690405761e2383a...4bd03d15e495086a38470b59447296db4c235cb9,1,35,89,124,11,2009-01-29 04:17:17,2009-01-27 22:34:54
4bd03d15e495086a38470b59447296db4c235cb9...37e5c8f46042510176a71d73c903c44214e09815,1,17,48,65,3,2009-01-29 04:17:27,2009-01-27 22:35:05
37e5c8f46042510176a71d73c903c44214e09815...f7951e1d97aeb7b3ed359faeab5edf9e870ec8a5,1,7,21,28,4,2009-01-29 04:17:46,2009-01-27 22:35:09
b59122f86f23007fce374f92de7f6e0a73793026...6e46cc0d9294d5f4ad0c9a6ffd2d9ca82bce8458,1,1,0,1,1,2009-02-08 20:48:28,2009-02-08 14:54:47
6e46cc0d9294d5f4ad0c9a6ffd2d9ca82bce8458...7e1100e9e939c9178b2aa3969349e9e8d34488bf,2,27,3,30,6,2009-02-09 05:51:25,2009-02-08 00:00:09
2ea3c17189bf9ca459879129ca190792b5451f05...57886bc7fb9413becf4c240320d61bf641600762,1,7,7,14,7,2009-02-02 03:43:37,2008-11-27 04:07:52
57886bc7fb9413becf4c240320d61bf641600762...dd971cc9d6588307447075b2352127a9e24dd3e1,1,27,1,28,3,2009-02-02 03:43:38,2008-11-27 04:07:57
dd971cc9d6588307447075b2352127a9e24dd3e1...ace30ba813ed723534c3b4d223db6eddea417de7,1,28,15,43,5,2009-02-02 03:43:38,2008-11-27 04:08:03
ace30ba813ed723534c3b4d223db6eddea417de7...4404b2e39236e6f9c5bff121fc920d7ec17f7b6d,1,1,1,2,1,2009-02-04 08:52:27,2009-02-02 21:46:28
4404b2e39236e6f9c5bff121fc920d7ec17f7b6d...68c02d7c462e1748578209346f050a587c040139,1,3,0,3,1,2009-02-04 08:52:52,2009-02-02 21:46:29
88ccb9f9745ff1f44bff7c6d6c17ad4b46870706...d551a488169aeb2ac09dba781f2ffbecf3425996,10,147,7,154,14,2009-02-08 20:36:26,2009-02-08 14:34:27
d551a488169aeb2ac09dba781f2ffbecf3425996...cfa1ee6b340172a415049704cd848593392b9064,2,48,4,52,8,2009-02-08 20:36:31,2009-02-08 14:34:28
cfa1ee6b340172a415049704cd848593392b9064...0925ce4d49ef8352617e8f56231bd36802a2f138,3,236,51,287,20,2009-02-08 20:36:38,2009-02-08 14:34:29
88ccb9f9745ff1f44bff7c6d6c17ad4b46870706...0c0ead7e79559013d6f9eea6f7e55d1845c11171,1,2,2,4,2,2009-02-05 08:28:43,2009-02-05 08:04:17
0c0ead7e79559013d6f9eea6f7e55d1845c11171...98bb1ff83c0287e855c7608db1d57fe71d2d6e1b,1,2,2,4,2,2009-02-05 08:29:23,2009-02-05 07:37:24
98bb1ff83c0287e855c7608db1d57fe71d2d6e1b...7233d221ada5d32acabda0bed2d03486b76204fb,1,4,2,6,2,2009-02-05 08:33:40,2009-02-05 06:09:08
3e073dc561185d5ad2325cb012943020e068801e...4e3ae59ef63475411f4c073ba3a1478b1ef73b9a,1,1,1,2,1,2008-08-30 05:37:04,2008-08-28 13:57:32
d0b92a3f6e4d98a38a86cbd86f0e39eea9005958...0c68d386da710940a22712b8f3539f7e73ba1b8f,2,1,1,2,2,2008-08-27 20:33:56,2008-08-27 19:48:00
0c68d386da710940a22712b8f3539f7e73ba1b8f...c67b1fa349cc7b4341b32b9ef1c58a3821ce0830,1,5,0,5,1,2008-08-27 23:14:22,2008-08-27 23:14:22
f6276b788f26c3c148c2d5465a6b03fc09bb785c...02893a8503158823e42ca1d4d59faae691684b54,1,18,7,25,7,2008-11-02 22:35:41,2008-11-02 22:35:41
02893a8503158823e42ca1d4d59faae691684b54...7756ba74c04caf03d47718d581439a48bae7ed73,1,4,0,4,1,2008-11-02 23:51:37,2008-11-02 18:32:46
7756ba74c04caf03d47718d581439a48bae7ed73...a5a323f33cd25829e0dde3939b196cf743d7d9d8,2,17,1,18,2,2008-11-02 23:57:10,2008-11-02 13:37:28
861c68e3b6a8d10af5517e6750a66407d32105aa...95e706b5ec4d9b6832640c717c98fb4c912b54c5,1,16,2,18,3,2008-12-08 16:33:05,2008-12-06 17:21:54
95e706b5ec4d9b6832640c717c98fb4c912b54c5...3ac31e4451ff7c77c7ecbd639e685995e6a8dcc7,2,5,7,12,3,2008-12-08 16:33:05,2008-12-06 17:24:35
3ac31e4451ff7c77c7ecbd639e685995e6a8dcc7...8a3335608540b49df371988bf356952ea9fbef6c,1,95,89,184,89,2008-12-08 16:33:05,2008-12-08 16:32:28
8a3335608540b49df371988bf356952ea9fbef6c...07bba555d431b3d6aed9370fc1748726114d348f,1,239,40,279,42,2008-12-08 16:49:56,2008-12-06 20:22:16
07bba555d431b3d6aed9370fc1748726114d348f...9c996d0c2446cb13fdf7bfc1558ba5b069ec3d17,1,2484,0,2484,1,2008-12-08 17:32:11,2008-12-08 16:36:57
9c996d0c2446cb13fdf7bfc1558ba5b069ec3d17...e882c6e3e724b0edb78f410fa4c699e7819df8ad,1,8,3,11,2,2008-12-09 15:11:20,2008-12-09 03:42:17
e882c6e3e724b0edb78f410fa4c699e7819df8ad...64bcf585417b55fa29801b69c2bdae861b929b6f,1,96,90,186,89,2008-12-09 15:20:08,2008-12-04 17:28:21
64bcf585417b55fa29801b69c2bdae861b929b6f...7f64a661d2db6d316427243d4ed2c60c040d8653,1,117,100,217,99,2008-12-09 15:35:01,2008-12-09 15:26:46
7f64a661d2db6d316427243d4ed2c60c040d8653...93b6d7c191361ac12ba81825dbf56a776b19ea87,1,3,3,6,3,2008-12-10 19:43:15,2008-12-10 08:51:27
93b6d7c191361ac12ba81825dbf56a776b19ea87...b8dc2f5c94b172e6f874718e018d8c868259b93d,1,96,90,186,89,2008-12-10 19:44:03,2008-12-10 14:03:13
b8dc2f5c94b172e6f874718e018d8c868259b93d...d4d1351b96ba8b1accb9fa2965e83d7e302c4ff8,1,0,1,1,1,2008-12-17 15:50:55,2008-12-14 22:12:49
d4d1351b96ba8b1accb9fa2965e83d7e302c4ff8...e612120d232a5ef04dcf22fc92741565ebb4d0c8,1,1,1,2,1,2008-12-18 04:15:17,2008-12-18 04:15:17
47577456bfe61c32df73a7cf4a388f007af3b18f...3c59c50d76cd479caf14cab73fdb09b68597d5e5,1,4,4,8,4,2008-11-18 23:40:02,2008-11-17 20:48:35
3c59c50d76cd479caf14cab73fdb09b68597d5e5...d3f9f9a92eca0dd6379d836a083e823cc5e3eeb6,1,8,10,18,8,2008-11-18 23:41:30,2008-11-17 20:48:36
d3f9f9a92eca0dd6379d836a083e823cc5e3eeb6...da3f78a29cafee487c107a81c442213fa41463f7,1,21,18,39,13,2008-11-18 23:46:42,2008-11-17 20:48:37
da3f78a29cafee487c107a81c442213fa41463f7...c2e6385da53bd3a517332ba2c8d2bd09bdb05396,1,15,0,15,1,2008-11-19 00:09:08,2008-11-17 21:03:59
c2e6385da53bd3a517332ba2c8d2bd09bdb05396...6fc4a7e546d5e2b0ce545f73b5c1829887db2462,1,2,1,3,1,2008-11-19 00:15:12,2008-11-18 22:33:44
47577456bfe61c32df73a7cf4a388f007af3b18f...dbbd56f1031992593f129168006b6c2f8bae13ec,1,6,2,8,2,2008-11-18 23:38:34,2008-11-18 11:04:02
873358dd2ac3bf2cea9a370d8586378a27a092f2...9c101b3e6ff23378447bacd537a3dea57b1eed35,1,2,0,2,1,2008-09-11 08:23:16,2008-09-11 08:14:44
9c101b3e6ff23378447bacd537a3dea57b1eed35...06e75d9ac7d03bb41bb9cd8e236d9dba635d44fd,1,2,0,2,1,2008-09-11 16:44:28,2008-09-11 12:12:16
06e75d9ac7d03bb41bb9cd8e236d9dba635d44fd...b66e00f12a4e0eef7c9f994db5386e066d726778,3,3,3,6,3,2008-09-12 20:19:56,2008-09-12 19:10:26
db87e3960c5a770db13c9ba9602b5e88848e2d1a...dc4179f9a76473176eb473f6f568b0006c823fba,3,14,0,14,3,2008-09-24 15:58:14,2008-09-22 15:06:41
dc4179f9a76473176eb473f6f568b0006c823fba...da65e7c133cd316c9076fbb6b0aeee7bc42a6db8,1,15,2,17,3,2008-09-24 16:24:20,2008-09-23 23:57:09
da65e7c133cd316c9076fbb6b0aeee7bc42a6db8...85cf643f1b17ee5680ae816eb061f569b4e00478,1,2,2,4,1,2008-09-25 00:02:05,2008-09-24 23:10:54
85cf643f1b17ee5680ae816eb061f569b4e00478...7fe4a728a16cf4e873702f8478fa3e28e8ae89ce,1,1,1,2,1,2008-09-25 14:46:59,2008-09-25 08:35:38
7fe4a728a16cf4e873702f8478fa3e28e8ae89ce...93feb4bb14dbd5c89701d6f2b0ab3d83dbc999c5,1,17,1,18,2,2008-09-25 15:27:41,2008-09-25 15:27:41
a38bb0cc0fc98bf868ad48dc11d229addcca586c...f07c3c53f8e7f243730de74918abcc72bd85c2ef,1,2,1,3,1,2008-10-18 15:20:51,2008-10-18 15:20:51
f07c3c53f8e7f243730de74918abcc72bd85c2ef...f430c8e44d0548e844d817fc32be7c38b2b6856c,1,9,1,10,3,2008-10-18 15:26:39,2008-10-18 15:26:39
fc721b699b817e9cb78994c6dd6d86e744bd2112...65f59e2998c7dd87f61b25fa41bba72fd4247901,1,2,2,4,2,2008-08-13 05:46:33,2008-08-13 04:42:22
65f59e2998c7dd87f61b25fa41bba72fd4247901...71d9451e061841ed5acb576652e09df32c700b86,2,18,2,20,5,2008-08-13 22:17:09,2008-08-13 21:41:23
71d9451e061841ed5acb576652e09df32c700b86...a96dc01e21603849cb454a311f18780c2e839f29,2,14,4,18,6,2008-08-13 22:17:10,2008-08-13 21:41:24
a96dc01e21603849cb454a311f18780c2e839f29...8caa3acf3a5f660b6b4c01fe23c05094140795d6,1,1,1,2,1,2008-08-14 01:11:44,2008-08-14 00:48:57
bbb896d8e10f736bfda8f587c0009c358c9a8599...1707adb7f2b75b3204f34475828f301ce05cb384,1,1,1,2,1,2008-08-31 06:35:12,2008-08-29 07:29:42
1707adb7f2b75b3204f34475828f301ce05cb384...e5b5c1d2cf0416b0e597c4b974b0efbd1da54267,2,2,2,4,2,2008-08-31 23:31:58,2008-08-31 16:00:27
e5b5c1d2cf0416b0e597c4b974b0efbd1da54267...14877436871a1e5e38deb64abb884b480ff02567,1,3,0,3,1,2008-08-31 23:32:07,2008-08-31 20:32:43
bbb896d8e10f736bfda8f587c0009c358c9a8599...392809702016cde59d50a7b07e8c27f6d0ec3c3f,3,34,3,37,7,2008-08-31 03:34:45,2008-08-28 02:48:01
b0320eaf6a25fbc4adf35d611c27006e6d853aa8...a0406b94d57e8443a7b31b5412763cac4ddb5d21,1,2,0,2,2,2008-07-26 04:51:29,2008-07-09 21:28:59
a0406b94d57e8443a7b31b5412763cac4ddb5d21...684ec6c63cd92a3755500b3b63f3d5ad9f6828b2,4,156,16,172,24,2008-07-26 04:51:30,2008-07-09 21:29:00
684ec6c63cd92a3755500b3b63f3d5ad9f6828b2...95c539081e8519e00155c284ac7519727bbacc67,1,300,329,629,186,2008-07-26 04:51:30,2008-07-09 21:29:01
95c539081e8519e00155c284ac7519727bbacc67...9f1ad541f95cf6b9024683c8883bfb0ca86f9a3d,1,111,114,225,97,2008-07-26 04:51:30,2008-07-09 23:37:38
9f1ad541f95cf6b9024683c8883bfb0ca86f9a3d...c82b0748e53d51cc999c16f97bc76c25f2b46b12,1,65,12,77,8,2008-07-26 04:51:30,2008-07-09 21:29:02
b0320eaf6a25fbc4adf35d611c27006e6d853aa8...ccf08bc3d06050fbe9b76846f6e2ab6d1cd6bd09,2,3,0,3,2,2008-07-26 04:29:44,2008-07-22 07:12:46
ccf08bc3d06050fbe9b76846f6e2ab6d1cd6bd09...ea27a18ce2bf5860974745c04c24864231029e1d,1,11,44,55,10,2008-07-26 04:29:44,2008-07-22 07:14:12
b0320eaf6a25fbc4adf35d611c27006e6d853aa8...041aee31be378b3b38e3a0913b29970a7f78873b,3,62,57,119,5,2008-07-26 04:14:21,2008-07-21 08:24:17
041aee31be378b3b38e3a0913b29970a7f78873b...1e5f764c93edfd8f6575b6ede769b079a1fc5a21,1,31,12,43,7,2008-07-26 04:14:21,2008-07-23 05:30:40
5736a3747120d6215de4fdfcf45f4a168a8d024e...a2b26acd7afb4d77d8844ccd681e993f25e75205,2,27,0,27,2,2008-04-28 04:47:39,2008-04-23 17:53:47
b3bb5f76e6193db102b063187be854ef3842d89b...a1748890dbfba4286c54fc9a3ce5786dfa25be33,1,2,2,4,2,2008-05-03 19:05:21,2008-04-30 07:47:43
c0f5c69c680395a45294184dcf0923cea530b9af...4c7ba956a32d72bb1e6645e2e3adba92a9024708,1,1,1,2,1,2008-06-27 01:28:55,2008-06-26 18:35:19
4c7ba956a32d72bb1e6645e2e3adba92a9024708...d54467b8c319571b5dc433b1f7e471c4b0f21caf,1,5,5,10,5,2008-06-27 01:30:57,2008-06-26 13:22:19
c0f5c69c680395a45294184dcf0923cea530b9af...5ff10dd602f5926f0f5a73ae7de5866713428aa7,1,9,2,11,2,2008-06-27 01:13:49,2008-06-26 22:34:54
5ff10dd602f5926f0f5a73ae7de5866713428aa7...8f8841e9c8e6a26153b0cf9417c7540cf65ef09f,4,25,16,41,8,2008-06-27 01:13:50,2008-06-26 22:35:21
8f8841e9c8e6a26153b0cf9417c7540cf65ef09f...1ba111d1d6bd90b2c120ceb05418e01ee304cc46,1,11,10,21,8,2008-06-27 05:06:09,2008-06-26 22:36:34
1ba111d1d6bd90b2c120ceb05418e01ee304cc46...877f23ccb88227203f2576abdfb5d1c15925fcb3,4,37,2,39,9,2008-06-27 05:07:26,2008-06-26 22:36:59
877f23ccb88227203f2576abdfb5d1c15925fcb3...049540435fa5f7f583b8f5af257322b17eac7375,2,49,0,49,3,2008-06-27 05:07:54,2008-06-26 22:37:21
049540435fa5f7f583b8f5af257322b17eac7375...03e2b630f05b88da5ff43f194fed25755de44e8b,1,6,58,64,3,2008-06-27 05:08:25,2008-06-26 23:08:05
03e2b630f05b88da5ff43f194fed25755de44e8b...ab20fda99236e38edf5d63f964b6b920b494aacb,1,1,1,2,1,2008-06-29 22:11:50,2008-06-29 20:49:06
85fe23ed2a5d88463f5362a3e4fdd6f45a0555fd...f6bebd121ac531871c4cee576b0baf6814099425,2,40,9,49,11,2008-06-26 05:34:32,2008-06-25 19:42:43
f6bebd121ac531871c4cee576b0baf6814099425...fa835cd5728411bfd8f851e7327e11ad809a59d1,1,3,0,3,1,2008-06-28 23:49:33,2008-06-26 21:03:21
85fe23ed2a5d88463f5362a3e4fdd6f45a0555fd...300913bd448def6fe2f943f534a172259725e7c6,1,5,3,8,2,2008-06-26 05:34:20,2008-06-25 22:44:40
85fe23ed2a5d88463f5362a3e4fdd6f45a0555fd...22c79eab2956d7f47ff2495104583a25208565ac,2,7,7,14,2,2008-06-25 17:56:40,2008-06-25 04:24:53
22c79eab2956d7f47ff2495104583a25208565ac...c0a5e2d477baa9d3ebf7d3303a7d2b5dbc7c2ffe,3,13,4,17,3,2008-06-26 04:30:55,2008-06-25 04:25:53
39a76bdd7de18b2bb2651dcb8136563df41e84f7...aaab7ea3cd6ca0d3758d297f40fa12f7fe8cbd47,1,1,0,1,1,2008-12-01 08:54:16,2008-12-01 08:53:54
aaab7ea3cd6ca0d3758d297f40fa12f7fe8cbd47...3273ebc759ee44fa22026d2882d56010742c6797,1,15,4,19,6,2008-12-01 08:55:19,2008-12-01 07:01:53
e11601381e384898418c30bd537a9daa1210c300...8b39e04f39c287d8c66b24cc4f6c72916831455c,1,4,3,7,3,2008-12-01 22:27:30,2008-12-01 22:02:46
8b39e04f39c287d8c66b24cc4f6c72916831455c...6e7e87c762fb0d8aa21c96c1d2c4596e46f2ab7b,1,1,5,6,1,2008-12-01 22:28:06,2008-12-01 22:17:46
6e7e87c762fb0d8aa21c96c1d2c4596e46f2ab7b...a8833ef5404a07983d8eed0a9582c2e19e437b78,1,43,8,51,8,2008-12-01 22:40:28,2008-10-25 11:25:35
a8833ef5404a07983d8eed0a9582c2e19e437b78...f3413079d6a0d3d3cbeb506e81e647772b857f81,1,3,0,3,3,2008-12-01 22:43:12,2008-12-01 17:30:09
f3413079d6a0d3d3cbeb506e81e647772b857f81...7fb0abb19563d36d8e210198b6c2debbf3362812,1,3,0,3,1,2008-12-01 22:43:12,2008-11-13 20:12:42
e11601381e384898418c30bd537a9daa1210c300...354af6bd69b442d0ce9449961f37d95ef12ba988,1,75,9,84,18,2008-11-23 02:14:23,2008-11-23 02:14:23
168d5bd57b8183f8da0ea30a0d4d3c2422eec4e4...e599e7ff1f89fc3d46a6e3b5fe04976402e12a49,1,33,1,34,8,2008-11-13 06:47:15,2008-11-13 06:47:15
0f4f4d1597219bad74c4fde624321d8a05d1b55e...18a2197e6d1be4b2a4a4b10cac34215fac5be5f9,1,2,2,4,2,2008-08-11 06:11:48,2008-08-10 13:04:34
18a2197e6d1be4b2a4a4b10cac34215fac5be5f9...38881a9066fcb3ce6e0438e6d7b20cce22ece411,1,18,4,22,5,2008-08-11 06:15:44,2008-08-09 23:33:29
38881a9066fcb3ce6e0438e6d7b20cce22ece411...55beff4f536011e5d7f17ae63911f1bb56308feb,2,3,3,6,2,2008-08-11 06:21:25,2008-08-11 06:21:25
55beff4f536011e5d7f17ae63911f1bb56308feb...4f80b27d48fee1c588810f3341ffe5d14558cea2,1,1,1,2,1,2008-08-11 06:56:22,2008-08-10 16:22:14
bb1ab2db08f48add4236a5a9c08aa1a6aa4d5d48...6cbf8b00fb27f5f55f1a5645ba60c451cb090fc1,1,1,0,1,1,2008-07-03 05:41:18,2008-07-02 22:11:31
df6a7ff7ac55d320afa1b8a59393122d6ca0f6c4...43bc2302706af6a3bb9266eea1bcb7071c54c8c6,1,1,1,2,1,2012-06-12 14:25:11,2012-06-12 13:45:16
5e2c08c6f0209e94b36d0770abae1a2b571cb0f1...0a47dc110e042b5bcc63dc94c8d517e67efe9306,1,13,4,17,5,2008-06-24 05:44:42,2007-12-02 06:16:19
0a47dc110e042b5bcc63dc94c8d517e67efe9306...7550be0a2bbf47aaa63c806bb5d7fcb8ab197cf8,2,43,20,63,7,2008-06-24 05:45:41,2007-12-02 06:09:22
3b2bbe9b8584947e33e9149f605149530faa7361...82936f295f803a8f1fbe2d89856e9371baa3536c,1,10,5,15,4,2008-06-23 01:14:17,2008-06-21 23:54:36
82936f295f803a8f1fbe2d89856e9371baa3536c...6422f633216475939f9a6f317e41a164737cbb02,2,13,4,17,4,2008-06-23 01:14:37,2008-06-22 14:39:04
6422f633216475939f9a6f317e41a164737cbb02...224712e521c6d4f740045affa4d1ee1454db10d4,1,202,2,204,2,2008-06-23 01:14:58,2008-06-22 15:04:25
224712e521c6d4f740045affa4d1ee1454db10d4...010a2dacc1acf3305e399ef1eb2e620110b95d5e,2,144,11,155,28,2008-06-23 01:15:18,2008-06-22 15:04:26
3b2bbe9b8584947e33e9149f605149530faa7361...cd5320f25228b4c3bbef2391df2696dca09d3d46,1,10,4,14,5,2008-06-23 01:09:15,2008-06-22 14:07:02
e782e12f89955dfb0be82098af3cfdd8dd0eaf80...3fee1fe87144360a1913eab86af9ad136c810076,1,1,1,2,1,2008-10-12 18:21:29,2008-10-11 00:21:34
3fee1fe87144360a1913eab86af9ad136c810076...616ab43737558b4e589104432a16cf9f331ac457,1,0,79,79,1,2008-10-12 18:31:55,2008-10-12 11:21:48
616ab43737558b4e589104432a16cf9f331ac457...7e7abea96b8140c592a46293f5e33aae0683c7ac,2,5,3,8,4,2008-10-12 19:36:19,2008-10-11 16:39:37
7e7abea96b8140c592a46293f5e33aae0683c7ac...f285a2d7ed6548666989406de8f0e7233eb84368,46,91,197,288,165,2008-10-12 19:36:19,2008-10-09 19:12:12
f285a2d7ed6548666989406de8f0e7233eb84368...b75271d93a9e4be960d53fc4f955802530e0e733,3,31,3,34,4,2008-10-12 19:36:19,2008-10-11 01:56:15
52e8370bc7a71366b664ece0a9ec0b79d673a356...048f2762007d022defceb6850a44bc1bd5ccebf7,3,7,0,7,3,2008-10-06 14:19:36,2008-10-05 02:14:40
52e8370bc7a71366b664ece0a9ec0b79d673a356...cf10f9fdd5e673a163847f0e931ce9731507e03b,4,41,2,43,10,2008-10-03 15:18:45,2008-10-03 12:04:47
52e8370bc7a71366b664ece0a9ec0b79d673a356...668f26fff610605d112fbedffae79917de948893,2,19,0,19,2,2008-10-03 15:01:46,2008-10-03 13:02:31
52e8370bc7a71366b664ece0a9ec0b79d673a356...aed93de428d7d12ee23d84d27265af1e37eb348f,1,109,0,109,8,2008-10-03 14:29:56,2008-10-02 15:13:02
aed93de428d7d12ee23d84d27265af1e37eb348f...42326110b5bb208e0a64e91aeca69a4f0cf5759e,1,10,3,13,4,2008-10-03 14:29:56,2008-10-02 15:17:01
42326110b5bb208e0a64e91aeca69a4f0cf5759e...0d1d154dbe4d16a802c2e357de96e349f04d2f2c,2,14,2,16,4,2008-10-03 14:29:56,2008-10-03 07:29:45
52e8370bc7a71366b664ece0a9ec0b79d673a356...c8ef0383aca38bfedf85a311bbdd30008fcbebcf,1,21,28,49,5,2008-10-03 01:46:02,2008-10-02 12:59:18
c8ef0383aca38bfedf85a311bbdd30008fcbebcf...e5d1a4df56ad5ecffbc510c242d5acc5b15726cc,1,16,21,37,4,2008-10-03 01:46:02,2008-10-02 12:59:19
e5d1a4df56ad5ecffbc510c242d5acc5b15726cc...d249610792c6a42a7d51c2f5790025569f6cb5fd,1,37,31,68,9,2008-10-03 01:46:02,2008-10-02 12:59:20
52e8370bc7a71366b664ece0a9ec0b79d673a356...a5a5a04863036678919705979b9c0f3579fa3710,1,11,1,12,2,2008-10-03 01:45:53,2008-10-01 19:28:26
a4aefee46d48ed2070755aad7c505591000413c5...971e83528d8c545a4453e7b5cd6dc37fd0e9ebcc,1,1,1,2,1,2008-10-19 20:08:14,2008-10-19 16:09:43
971e83528d8c545a4453e7b5cd6dc37fd0e9ebcc...e137a892d88cc40d7c0df45c06c08d144f7b3ce2,1,1,1,2,1,2008-10-19 21:49:38,2008-10-19 00:40:50
e137a892d88cc40d7c0df45c06c08d144f7b3ce2...828e32b82e3e2bb10d6d730d3abe505063b481f6,1,0,3,3,1,2008-10-19 22:32:42,2008-10-19 22:32:35
df5e91fc2c95e051744ec9b9de66869d2b323037...6ecfd91df5ec462aeded967c9ad21912c249f96e,5,7,7,14,7,2008-11-01 04:38:48,2008-10-31 05:09:13
df5e91fc2c95e051744ec9b9de66869d2b323037...04427ac8483f61dcb01a48c78a821f5042c88195,2,38,16,54,10,2008-10-26 21:09:48,2008-10-26 04:44:53
04427ac8483f61dcb01a48c78a821f5042c88195...c7534ef4a12bb44806d522fc8e3961e390f9169b,7,17,27,44,12,2008-10-26 21:09:48,2008-10-26 04:45:55
c7534ef4a12bb44806d522fc8e3961e390f9169b...2675773af893ae81f9b09f18c1f2ec86ca2158e7,2,3,1,4,2,2008-10-26 21:09:48,2008-10-26 04:46:21
2675773af893ae81f9b09f18c1f2ec86ca2158e7...4f672ad6c77bfe73cc5dd4b240fd42303d101d2a,2,17,1,18,3,2008-10-26 21:09:48,2008-10-26 04:49:35
4f672ad6c77bfe73cc5dd4b240fd42303d101d2a...a79b8b6623288f7d5409ad749cc6553976a4f0e8,2,9,0,9,2,2008-10-26 21:09:48,2008-10-26 04:50:02
304d058370a9a797c38ec739c6d39fa45d9ed8e5...797484392a823c66bd846545a43d76aa2c64f5ff,1,13,7,20,6,2008-10-28 16:12:49,2008-10-24 05:54:09
c4275591fbb7d582c397b228e38dbb8419c89330...e2b850b2da711c5cca563f221062bf22c57373bf,1,4,4,8,2,2008-09-24 16:12:07,2008-09-24 09:51:27
e2b850b2da711c5cca563f221062bf22c57373bf...3b9b1163c0a316c50715c6bd7c731b4703f89f55,2,7,2,9,4,2008-09-24 22:49:21,2008-09-24 21:52:39
3b9b1163c0a316c50715c6bd7c731b4703f89f55...697d7f5dad805fd6d9d57e07d5019f97fa9a0d4b,2,3,5,8,4,2008-09-25 15:00:28,2008-09-25 09:41:00
697d7f5dad805fd6d9d57e07d5019f97fa9a0d4b...064bfbde45e5ad70a5f8a2290ff3fbed0b69f326,2,43,54,97,11,2008-09-25 15:00:28,2008-09-25 09:41:08
064bfbde45e5ad70a5f8a2290ff3fbed0b69f326...baede9f803ff7becab815481b004bc983d0422c7,1,8,0,8,1,2008-09-25 15:11:03,2008-09-22 16:08:31
0d5055665ca1e76659ffa96bf972b4b0125ea069...78ed710fcf1a67a40eeca1be1a1bb8e8b7296177,1,4,2,6,4,2009-08-23 20:17:59,2009-08-23 07:51:09
78ed710fcf1a67a40eeca1be1a1bb8e8b7296177...3b5ef0e216d20a49dac223eb985c22c56512dbec,1,49,31,80,9,2009-08-23 21:38:43,2009-08-23 07:57:18
1b19fa46344f512949270dc88089574950519ea3...6b59f51b312f06d9420d34c09fa408c658aac6d2,2,23,23,46,5,2009-11-13 22:39:25,2009-11-11 22:24:42
f5b223abfdc01455d42ed005b4fd9330b06c2967...f5d4c4d0f19084a2d48f55f2f42cac25696a34f5,1,2,1,3,1,2009-05-25 18:23:18,2009-05-25 16:00:10
f5d4c4d0f19084a2d48f55f2f42cac25696a34f5...f475e08edbbabe38bd758fd42f08f646551468d9,1,3,1,4,2,2009-05-25 19:06:54,2009-05-25 10:37:15
f475e08edbbabe38bd758fd42f08f646551468d9...fa250759794ab98e6edfbbf2f6aa2cb912e535eb,1,8,3,11,4,2009-05-25 19:07:07,2009-05-25 10:40:54
fa250759794ab98e6edfbbf2f6aa2cb912e535eb...0e5168fd18f3975d71d3a292b0e0df174bb884d5,2,4,4,8,2,2009-05-25 19:08:15,2009-05-25 10:33:15
9affecbc89538b6fd63f772b6f14047bced9345e...d183663785c0d78f73b31ad43fa57b0742d2a95c,2,18,16,34,8,2009-05-31 05:21:29,2009-05-28 09:40:15
f044fe2de6f7bbace158853c075a4065f3722265...fff02ee666021b67b2272ce4445f7c1f5b26b77c,1,158,97,255,7,2009-05-18 05:41:07,2009-05-16 09:24:46
f044fe2de6f7bbace158853c075a4065f3722265...c646217e1366b0397552fad8c32acb47fbe8977d,1,1,1,2,1,2009-05-16 18:57:17,2009-05-16 10:21:50
c646217e1366b0397552fad8c32acb47fbe8977d...77ebd56dc3d2efaeac87edc990cc1b99f331527c,1,8,8,16,2,2009-05-16 19:51:58,2009-05-16 17:54:45
77ebd56dc3d2efaeac87edc990cc1b99f331527c...8763dbb1b24c260243f69130c734c13563a16db6,1,3,3,6,2,2009-05-17 02:46:31,2009-05-16 18:46:22
8763dbb1b24c260243f69130c734c13563a16db6...ff790b6a4bb7fa3bbccd5ea23cefd89da900aa2e,1,8,7,15,1,2009-05-17 02:46:31,2009-05-10 08:53:19
ff790b6a4bb7fa3bbccd5ea23cefd89da900aa2e...dd42c2f015102626562da05bb290f47862ea06fb,1,13,2,15,2,2009-05-17 02:46:31,2009-05-10 08:56:21
dd42c2f015102626562da05bb290f47862ea06fb...e4b09dad9f65395fd4bb8ab165012a3a6698a75b,1,8,0,8,1,2009-05-17 02:49:25,2009-05-17 02:43:08
e57cb0158209ece040a4b873064504efd7d2ec0e...b7dd2d20fad1036ce7da0b635a8bb14cd4230f1a,1,17,9,26,3,2009-05-29 06:56:19,2009-05-27 19:23:12
e57cb0158209ece040a4b873064504efd7d2ec0e...7b8988e113b44b9a2d806dde6161c133750c14e5,2,18,16,34,8,2009-05-29 06:52:25,2009-05-28 09:40:15
e57cb0158209ece040a4b873064504efd7d2ec0e...54d5cc0e126ed4b6cc4b186efd9faf7b93df570f,2,53,14,67,8,2009-05-29 06:51:03,2009-05-28 23:23:33
e57cb0158209ece040a4b873064504efd7d2ec0e...6a01554e6350123c78de805d820e90f1c56e5fdc,2,14,4,18,3,2009-05-28 06:16:16,2009-05-27 20:13:43
4774780ab196ff4ace780445c06c8e5bfffffc49...f67182bf65b01290a9544e9599ea8255e657e567,1,32,0,32,1,2009-05-17 01:52:03,2009-05-16 03:10:19
f67182bf65b01290a9544e9599ea8255e657e567...7a26e653929025e11e689bc7d98365c9a0107dc9,2,96,2,98,5,2009-05-17 01:52:12,2009-05-16 17:48:23
8146f19762c8fd67f6df3da4ba87a4e5ea880909...6a260f53ad685a51ecf6cd875f44cb2c056d1d18,1,2,2,4,1,2009-05-06 17:51:34,2009-05-06 17:48:26
6a260f53ad685a51ecf6cd875f44cb2c056d1d18...0b05dc2b7e929996afa3f325cce593585f3ec9b3,1,4,4,8,4,2009-05-06 18:48:58,2009-05-06 18:31:42
0b05dc2b7e929996afa3f325cce593585f3ec9b3...723570469f54449e54dcc8bbb8f1dcbaff29d535,1,1,1,2,1,2009-05-06 18:49:05,2009-05-06 18:29:14
723570469f54449e54dcc8bbb8f1dcbaff29d535...325fb151047d668133cd456e78953f1b1aa09114,1,1,1,2,1,2009-05-06 18:49:14,2009-05-06 18:29:15
325fb151047d668133cd456e78953f1b1aa09114...d8b69ecb4c467c044c08e0435bb22ade16ea580f,1,4,1,5,1,2009-05-06 18:50:44,2009-05-06 18:29:16
d8b69ecb4c467c044c08e0435bb22ade16ea580f...9eda0e980a43e6bf5167e1b35f457f970bec7b74,1,0,2,2,1,2009-05-06 23:43:28,2009-05-06 22:56:17
9eda0e980a43e6bf5167e1b35f457f970bec7b74...5e16488edc3cf9d5c30d08fcd9b74525198d6184,1,1,1,2,1,2009-05-06 23:43:29,2009-05-06 22:56:18
5e16488edc3cf9d5c30d08fcd9b74525198d6184...c5ae7cb6d94f37deedd5dcf92a6608ca7d3ce081,1,1,1,2,1,2009-05-07 01:16:26,2009-05-06 14:33:34
c5ae7cb6d94f37deedd5dcf92a6608ca7d3ce081...f01f1099f40f24fe6f7802185340a6fa3a3d4f35,3,4,8,12,4,2009-05-07 01:16:40,2009-05-07 00:13:27
21590d5262f71b336926a9d2cec5b04b0aa6c4a0...ccb4b5391382f4cdb5e5be49036e82e7d837b7af,1,2,2,4,2,2009-04-20 10:42:23,2009-03-31 16:16:36
ccb4b5391382f4cdb5e5be49036e82e7d837b7af...6ac6f87818edfd33fea8ce3c95b47fe00a4e4b91,1,19,2,21,5,2009-04-20 10:42:53,2009-04-03 06:49:59
6ac6f87818edfd33fea8ce3c95b47fe00a4e4b91...34779c535c4e121414197ab08b4b502a22a75433,3,17,1,18,6,2009-04-20 19:14:02,2009-04-20 08:17:00
34779c535c4e121414197ab08b4b502a22a75433...a162e78df082d4f885bda2e51067d9788a7f65e4,1,10,0,10,1,2009-04-20 20:53:03,2009-04-20 11:09:37
a162e78df082d4f885bda2e51067d9788a7f65e4...7c0282bfb9038516b0eeb3b7cb3c1d6ee3cb20de,1,1,1,2,1,2009-04-20 22:55:56,2009-04-17 18:13:29
7c0282bfb9038516b0eeb3b7cb3c1d6ee3cb20de...680ebc01806187b33cab9093c39102468298350f,4,5,5,10,5,2009-04-20 22:56:07,2009-04-17 18:13:28
680ebc01806187b33cab9093c39102468298350f...fe3420b616eba8027b080dc81020b0e0990f4809,1,3,6,9,3,2009-04-21 05:55:56,2009-04-20 22:58:15
83ae209bf9708bf1b67dbac4a3629a0003af5dbb...49d833dc07f28bf67119c4060044fc829a7e044f,2,29,8,37,6,2009-05-12 16:57:21,2009-05-12 16:41:28
f800b65bea1504299747e7be03ee279508a74e1f...55f0566f6d7269a56751333e0943b50237ce6a85,1,1,1,2,1,2009-04-18 03:48:32,2009-04-16 22:16:23
f800b65bea1504299747e7be03ee279508a74e1f...432b128220e8665d361345117201b34fe2fccba8,1,11,11,22,4,2009-04-14 08:52:48,2009-04-13 18:23:45
432b128220e8665d361345117201b34fe2fccba8...3a78d078273f9eeb1f3eea06296b9901d7858d96,1,4,3,7,2,2009-04-14 08:54:25,2009-04-13 18:23:46
3a78d078273f9eeb1f3eea06296b9901d7858d96...dd602bf8ec9b6ef422e5cf8a490c381c0bb037ed,1,3,1,4,1,2009-04-14 08:55:38,2009-04-13 18:23:48
dd602bf8ec9b6ef422e5cf8a490c381c0bb037ed...40e6e8a0c485e618be366f13247fd745ac00b911,1,2,2,4,2,2009-04-14 08:55:58,2009-04-13 18:23:50
40e6e8a0c485e618be366f13247fd745ac00b911...15da10843135490e12efca7f8bc806ae0bcf5c53,1,10,4,14,6,2009-04-14 08:56:23,2009-04-13 18:23:51
15da10843135490e12efca7f8bc806ae0bcf5c53...bec99cfc679b8c754ddd03feeb691b4c054ccc6a,1,0,2,2,1,2009-04-14 08:56:28,2009-04-13 18:23:52
f800b65bea1504299747e7be03ee279508a74e1f...427fc5b8885d269359c8eff187925e3d49f103b4,2,199,48,247,55,2009-04-14 05:41:25,2009-04-13 19:53:41
f800b65bea1504299747e7be03ee279508a74e1f...6e7b3309d356077337b8222683a743c27fa7276c,4,19,7,26,10,2009-04-13 16:36:44,2009-04-13 10:25:46
6e7b3309d356077337b8222683a743c27fa7276c...2bb98169be7b0ac4f70815b4490904c652edae61,3,22,4,26,7,2009-04-13 16:36:52,2009-04-13 10:25:47
2bb98169be7b0ac4f70815b4490904c652edae61...a45d34691ea624e93863e95706eeb1b1909304f3,2,26,2,28,5,2009-04-13 16:42:55,2009-04-13 11:20:26
a45d34691ea624e93863e95706eeb1b1909304f3...45972ffbedf8175555434006595c71a5b0e643f1,1,1,5,6,1,2009-04-18 03:53:19,2009-04-16 08:20:44
f800b65bea1504299747e7be03ee279508a74e1f...70e966477aacf46d4d6cb8c01f8bd9a9ceb5e80f,2,4,2,6,2,2009-04-13 16:01:00,2009-04-13 11:11:16
70e966477aacf46d4d6cb8c01f8bd9a9ceb5e80f...167d7445433bb6dfac6b844b99ae455129326141,2,14,12,26,3,2009-04-13 16:02:18,2009-04-13 11:11:56
167d7445433bb6dfac6b844b99ae455129326141...26d22dc64ad2373eb918f004a1d0ba2649e7e1a5,1,9,19,28,5,2009-04-13 16:04:50,2009-04-13 11:18:52
26d22dc64ad2373eb918f004a1d0ba2649e7e1a5...76cfadfc17e9e9c7da87a6f9a4710c04107ae0cd,1,22,18,40,6,2009-04-13 16:06:34,2009-04-13 11:19:33
76cfadfc17e9e9c7da87a6f9a4710c04107ae0cd...0808723b5065cc2141c2715a2df78882c158d4ef,1,5,5,10,1,2009-04-13 16:08:16,2009-04-13 11:21:04
86e081aea408a4ff34001d6f221cc42e46ebbaa0...f29ac4f1b04c9cf84509e4a80f27f10b4373a446,1,5,1,6,2,2009-04-25 05:59:35,2009-04-25 05:54:40
f29ac4f1b04c9cf84509e4a80f27f10b4373a446...66913284f06da58e2243acfad951a57501b8d813,1,4,4,8,4,2009-04-25 15:54:18,2009-04-24 21:46:15
66913284f06da58e2243acfad951a57501b8d813...84eeb687de7a6c7c42af3fb51b176e0f412a979e,1,1,1,2,1,2009-04-25 15:54:18,2009-04-24 23:18:52
84eeb687de7a6c7c42af3fb51b176e0f412a979e...1ef2d5a640d14e924751adb500224a36d87f9771,1,1,1,2,1,2009-04-25 15:54:18,2009-04-24 23:18:53
1ef2d5a640d14e924751adb500224a36d87f9771...c5fe5b6de94c1dffac697b29920819f08e2c11fc,1,0,6,6,1,2009-04-25 16:29:38,2009-04-25 10:56:52
c5fe5b6de94c1dffac697b29920819f08e2c11fc...926337fe89f99c690b721f00239e298f8b7cad28,1,3,3,6,1,2009-04-25 16:29:38,2009-04-25 15:13:40
926337fe89f99c690b721f00239e298f8b7cad28...911198f6c09e2a60451cf1a295ce4532ff11781c,1,8,5,13,2,2009-04-25 16:29:38,2009-04-25 15:13:41
911198f6c09e2a60451cf1a295ce4532ff11781c...785a9857496ae1b71b168f6d79306ca233ec0cd6,1,4,11,15,2,2009-04-25 16:29:38,2009-04-24 12:16:41
785a9857496ae1b71b168f6d79306ca233ec0cd6...be66a6c43dcba42c56f66a8706721a76098f8e25,6,28,1,29,9,2009-04-25 16:49:21,2009-04-25 09:57:14
e656fc97a2be4586bfef25714d588f002d2605a2...738a94a9f645a5f63fbccaab76d5e43a97e53d78,1,24,2,26,4,2009-02-04 06:07:51,2009-02-03 09:20:54
e656fc97a2be4586bfef25714d588f002d2605a2...4e1be63c3b05fd379b51b611b7e869ff6977d8ab,5,99,3,102,7,2009-02-04 06:00:58,2009-02-03 23:25:59
4e1be63c3b05fd379b51b611b7e869ff6977d8ab...6a7e37c99f733821bd3a17432fa6e4591b63866c,1,26,4,30,3,2009-02-04 06:01:02,2009-02-03 23:26:03
6a7e37c99f733821bd3a17432fa6e4591b63866c...efd92ffd316d03360e1c8a348091e4f50f749d6f,1,15,0,15,2,2009-02-04 06:01:06,2009-02-03 23:26:08
efd92ffd316d03360e1c8a348091e4f50f749d6f...44138559e8b7c89768a2450220b831847059311c,2,24,0,24,3,2009-02-04 06:01:09,2009-02-03 23:26:12
44138559e8b7c89768a2450220b831847059311c...7f6fdea1198cd7599c25cf9435df8540e9378a15,1,4,1,5,1,2009-02-04 06:01:14,2009-02-03 23:26:18
7f6fdea1198cd7599c25cf9435df8540e9378a15...268fac6919ef673094e50e2d944d09f017f5ad33,1,123,0,123,1,2009-02-04 06:01:18,2009-02-03 23:26:22
268fac6919ef673094e50e2d944d09f017f5ad33...3da936523445eb7a74dfe3ab1fe0ce82fac56174,3,7,3,10,4,2009-02-04 06:01:23,2009-02-03 23:26:26
3da936523445eb7a74dfe3ab1fe0ce82fac56174...a6d63b749369f3ba9c6d2f382efd27838604b7db,1,1,3,4,2,2009-02-04 06:01:26,2009-02-03 23:26:31
a6d63b749369f3ba9c6d2f382efd27838604b7db...5caa81d1b4f1b0b9ed73605ab1e4d91ba31a56b4,2,13,2,15,3,2009-02-06 01:48:22,2009-02-05 21:03:00
8c95d3c31b5493ea229808669c811ad9102143fe...a34a9dbbced36999496c52b43460825732d487ba,1,53,12,65,11,2009-01-29 08:57:42,2009-01-29 08:57:42
7e1100e9e939c9178b2aa3969349e9e8d34488bf...bee6ea17a1bab824eba6133eefc3c70b219ec98c,1,1,1,2,1,2011-06-05 17:38:47,2011-06-04 08:43:35
68c02d7c462e1748578209346f050a587c040139...ca6ac7f1357df352fec247dc98a3e6784e6c3fea,2,48,4,52,8,2009-02-06 01:44:10,2009-02-05 08:28:26
ca6ac7f1357df352fec247dc98a3e6784e6c3fea...a301973641f426ab42e5bf9faa6e4da5bd658148,2,22,12,34,13,2009-02-06 01:44:39,2009-02-05 08:28:27
a301973641f426ab42e5bf9faa6e4da5bd658148...748aa689bac2c1dd5d902815b0dec6364d20bf34,1,4,1,5,2,2009-02-07 08:37:36,2009-02-06 19:30:01
0990e7aaaa63ca908dbdfc379af132068e4b066f...c30e5673f9614caebf020f934f435db179bd53d4,1,1,3,4,1,2009-01-26 02:57:26,2009-01-23 18:02:29
c30e5673f9614caebf020f934f435db179bd53d4...277d7e91ae6afbe1b7aa7496320d43fd3f59f7ec,1,2,1,3,1,2009-01-26 06:06:50,2009-01-25 23:32:13
0925ce4d49ef8352617e8f56231bd36802a2f138...74b531f65feaa09b5c3963f788b437a368933730,1,2,3,5,2,2011-11-17 02:00:56,2011-11-17 01:25:06
0925ce4d49ef8352617e8f56231bd36802a2f138...d20d654fe8923a502527547b17fe284d15d6aec9,5,186,51,237,29,2009-02-08 20:36:54,2009-02-08 14:34:30
d20d654fe8923a502527547b17fe284d15d6aec9...7d48e9e6f77d336376c1a554eeff0590f77e1ee1,4,94,84,178,7,2009-02-08 20:38:08,2009-02-08 14:34:31
c67b1fa349cc7b4341b32b9ef1c58a3821ce0830...114ef90854c395145594974c222a004060b2acd1,1,2,1,3,1,2008-08-29 07:14:06,2008-08-28 02:14:02
114ef90854c395145594974c222a004060b2acd1...441bca0bbc6d80a78ce332ef4fa6225155dfbce6,1,8,0,8,2,2008-08-29 07:14:29,2008-08-28 23:19:08
441bca0bbc6d80a78ce332ef4fa6225155dfbce6...29f28151c5ac0ed842e9a00438f1930ee4052757,1,7,0,7,1,2008-08-29 07:14:29,2008-08-28 22:00:28
29f28151c5ac0ed842e9a00438f1930ee4052757...0cfeed2e1d320cc76c434e0bfc26d90065754e46,1,13,0,13,1,2008-08-29 07:14:29,2008-08-27 15:20:35
0cfeed2e1d320cc76c434e0bfc26d90065754e46...d36f8679e94c2a0d4d15d6adcea434634af6d627,6,22,10,32,13,2008-08-29 07:14:29,2008-08-29 00:54:59
d36f8679e94c2a0d4d15d6adcea434634af6d627...53d1589ff6bd336e3ece39e0a963a3d2a537cf96,1,28,1,29,2,2008-08-29 07:14:30,2008-08-28 12:23:52
c67b1fa349cc7b4341b32b9ef1c58a3821ce0830...4f38f6b5bafb1f7f85c7b54d0bb0a0e977cd947c,4,63,3,66,7,2008-08-29 03:50:10,2008-08-28 13:02:12
4f38f6b5bafb1f7f85c7b54d0bb0a0e977cd947c...6577f542b3ab64594c7d7a7db752e96be7234fb0,2,9,1,10,3,2008-08-29 05:46:16,2008-08-28 13:04:30
6577f542b3ab64594c7d7a7db752e96be7234fb0...b6469a81d228bd4b3e3fa62bbaf5fdd25915cd40,1,2,0,2,1,2008-08-29 05:47:17,2008-08-28 13:03:22
b6469a81d228bd4b3e3fa62bbaf5fdd25915cd40...f83eafdd6251af29e259da8becb7610da9f3e933,1,5,0,5,5,2008-08-31 06:35:51,2008-08-30 09:13:58
f83eafdd6251af29e259da8becb7610da9f3e933...bb528633b34ac9c338a7761f3e1d251e0c560ed6,1,2,0,2,1,2008-08-31 06:41:12,2008-08-30 09:15:32
a5a323f33cd25829e0dde3939b196cf743d7d9d8...6fa8342b12aeb3e3895d3b3d8d34d45fa872ac45,1,12,7,19,5,2008-11-04 23:46:39,2008-11-04 23:20:31
6fa8342b12aeb3e3895d3b3d8d34d45fa872ac45...e0e03a731b2d06f42e79a2ff156ef9bd0e5c6c02,1,11,0,11,1,2008-11-04 23:46:47,2008-11-04 23:20:36
a5a323f33cd25829e0dde3939b196cf743d7d9d8...16088d8870b7da6d4dd280be2d1728dd3be346b5,1,2,1,3,1,2008-11-03 04:45:55,2008-11-03 04:45:55
e612120d232a5ef04dcf22fc92741565ebb4d0c8...06569cd5bef7c8e3925bd36870abc083ae7b93f8,1,19,10,29,3,2009-02-01 22:56:54,2009-01-23 21:18:13
06569cd5bef7c8e3925bd36870abc083ae7b93f8...584fa9ccf4b467e7633c100333cadf92e0c07894,1,9,0,9,5,2009-02-08 19:50:11,2009-02-07 16:24:01
584fa9ccf4b467e7633c100333cadf92e0c07894...764369c5ea730894c75f32c2f94a651dd517fc5b,1,2,2,4,2,2009-02-08 19:50:58,2009-02-07 16:43:57
6fc4a7e546d5e2b0ce545f73b5c1829887db2462...32716a2c6c238113c9a5af116e5ab6f3f4ecde8d,1,3,3,6,1,2008-11-25 23:34:25,2008-11-21 00:44:59
32716a2c6c238113c9a5af116e5ab6f3f4ecde8d...b9e125e07e349275b16d177b8ee6bad140da31ab,1,31,27,58,14,2008-11-25 23:34:25,2008-11-21 00:45:00
b9e125e07e349275b16d177b8ee6bad140da31ab...b5ff37ac6ba4543ab3bbaf99d0641ca260567ff2,1,25,20,45,10,2008-11-25 23:34:26,2008-11-21 00:45:01
6fc4a7e546d5e2b0ce545f73b5c1829887db2462...9b864e730bda0e028a85387fa568429724582f22,3,28,0,28,3,2008-11-24 03:55:47,2008-11-22 23:09:30
9b864e730bda0e028a85387fa568429724582f22...ced621b2c15c3d3dd65dd1d7eec984f8546a4673,2,9,13,22,6,2008-11-24 03:55:52,2008-11-22 23:13:00
ced621b2c15c3d3dd65dd1d7eec984f8546a4673...9d7ca667466b9e1a8160d20cce7c06d09213ab6b,1,54,55,109,23,2008-11-24 03:56:06,2008-11-22 23:15:01
9d7ca667466b9e1a8160d20cce7c06d09213ab6b...d433ed0bb49b947e3bb05d6474cf328c75ffa57d,1,2,8,10,4,2008-11-24 03:56:26,2008-11-22 23:19:09
d433ed0bb49b947e3bb05d6474cf328c75ffa57d...a47551c3828f81ec88d5b0b3d05887f1a7a4233a,1,6,10,16,7,2008-11-24 03:56:36,2008-11-22 23:21:52
a47551c3828f81ec88d5b0b3d05887f1a7a4233a...7de1950cb28cee7d6b1e9cdaf22f30ddcdc5bd01,3,0,130,130,3,2008-11-24 03:56:57,2008-11-22 23:16:59
6fc4a7e546d5e2b0ce545f73b5c1829887db2462...f755bb996ba0540d668104d0e2d4e03bb71b560b,1,1,0,1,1,2008-11-24 03:31:05,2008-11-19 11:14:05
f755bb996ba0540d668104d0e2d4e03bb71b560b...3b91c30b763d972c5e133507ccc4b749dc2c6df5,1,1,1,2,1,2008-11-24 03:32:07,2008-11-19 11:14:50
3b91c30b763d972c5e133507ccc4b749dc2c6df5...cbacbf4e55ba53d35567578d8c97fdea6b52e16a,1,1,1,2,1,2008-11-24 03:44:19,2008-11-20 18:56:28
6fc4a7e546d5e2b0ce545f73b5c1829887db2462...13c6bcd49f8151438aa3302b8764c6f8d42441e2,1,1,1,2,1,2008-11-24 03:23:33,2008-11-18 18:53:26
13c6bcd49f8151438aa3302b8764c6f8d42441e2...850fb6ff81a151887043b7edd10681640b0e91c1,1,37,0,37,1,2008-11-24 03:23:34,2008-11-20 13:27:27
6fc4a7e546d5e2b0ce545f73b5c1829887db2462...36d2078ff19c849aef94f045bf2b4fb73a5098e8,1,29,17,46,7,2008-11-21 19:39:02,2008-11-01 19:34:33
36d2078ff19c849aef94f045bf2b4fb73a5098e8...9ddf6d7c105e58d76ea6762d8cc8eebdf463903e,1,26,28,54,23,2008-11-21 19:39:02,2008-11-01 19:42:39
9ddf6d7c105e58d76ea6762d8cc8eebdf463903e...6fb204266cc985284b554e9f9f1894ec8360b2f5,1,7,8,15,4,2008-11-21 19:39:02,2008-08-02 16:04:31
6fb204266cc985284b554e9f9f1894ec8360b2f5...ef5133df7c9d0304ce2fc437abc74c220f49dabd,1,9,8,17,8,2008-11-21 19:39:03,2008-08-02 16:05:58
ef5133df7c9d0304ce2fc437abc74c220f49dabd...db18a182a28f254fa514179dcd49ceb3d95cd9d8,1,7,3,10,4,2008-11-21 19:39:03,2008-08-02 18:35:20
db18a182a28f254fa514179dcd49ceb3d95cd9d8...433ee03f9748a8a5d0e0495bbf4b054ae922103b,1,85,84,169,26,2008-11-21 19:39:33,2008-08-02 18:35:52
433ee03f9748a8a5d0e0495bbf4b054ae922103b...b0a53e9e56d0a501aebc99d3614be413e91613f6,1,7,0,7,3,2008-11-23 10:54:38,2008-08-04 07:30:42
b0a53e9e56d0a501aebc99d3614be413e91613f6...c4e8b72f228b20d3ed6cfba0586364ea8ca431af,1,3,5,8,4,2008-11-23 10:54:41,2008-11-01 19:14:10
c4e8b72f228b20d3ed6cfba0586364ea8ca431af...1905a8666a676f7070ba15c6f56f98bb1da20f7b,1,20,23,43,1,2008-11-23 10:54:42,2008-11-07 13:28:09
ce785c5944847cd108512672021b32f7c381b756...97a7a82f199f165f85fe39a3c318b18c621e6335,2,4,2,6,3,2008-09-12 23:18:47,2008-09-12 23:18:47
93feb4bb14dbd5c89701d6f2b0ab3d83dbc999c5...fee75457fc45e299c2a962bb9c3949f33f176c02,1,11,2,13,1,2008-09-26 14:55:30,2008-09-24 23:21:28
fee75457fc45e299c2a962bb9c3949f33f176c02...41f13af558db1018250ade4d99a51f0b76f65bc8,2,12,3,15,3,2008-09-26 15:05:20,2008-09-25 20:12:45
f430c8e44d0548e844d817fc32be7c38b2b6856c...d8b24b930f5b7150e63d989de39eb71bd37e8e63,1,1,2,3,1,2008-10-19 21:46:33,2008-10-18 18:25:12
f430c8e44d0548e844d817fc32be7c38b2b6856c...09cff066f65361b514dd36b03a822cfb40534f12,1,2,1,3,1,2008-10-19 05:19:52,2008-10-19 04:19:23
4be4680cbb37cd803fa018c736879d936cd45671...fdac6692a0b0eda293f9f1bf4bc49b05b29f3c45,2,2,2,4,2,2008-09-23 08:48:49,2008-09-22 23:26:20
a0653d550524a0263d36fde6a8cf98941dd057ab...7950659dc9ef7f2b50b18010622299c508bfdfc3,1,1,1,2,1,2008-08-15 00:49:12,2008-08-14 17:12:54
7950659dc9ef7f2b50b18010622299c508bfdfc3...f491239170cb1463c7c3cd970862d6de636ba787,1,3,3,6,1,2008-08-15 00:49:12,2008-08-14 17:37:41
f491239170cb1463c7c3cd970862d6de636ba787...b4c72162f6612ce335af79ef19c5ae16f5585e67,1,20,0,20,2,2008-08-15 00:49:12,2008-08-14 22:41:10
b4c72162f6612ce335af79ef19c5ae16f5585e67...5a13c8f6f7ef7463ddaa3dd7144bf66af4fcd9be,1,1,0,1,1,2008-08-15 00:49:12,2008-08-14 22:41:11
5a13c8f6f7ef7463ddaa3dd7144bf66af4fcd9be...8134a003e06b5f216cdc1f14acc70d8cab284cf9,1,4,4,8,2,2008-08-15 08:38:37,2008-08-15 07:32:30
8134a003e06b5f216cdc1f14acc70d8cab284cf9...2946cccfdf2fba591b6af61ad6e658bb927832af,1,5,1,6,1,2008-08-16 09:32:01,2008-08-15 17:59:28
2946cccfdf2fba591b6af61ad6e658bb927832af...cb3a160d604866331fdb0f5078face4ab2a4b49a,3,9,19,28,12,2008-08-16 09:32:36,2008-08-08 23:28:54
cb3a160d604866331fdb0f5078face4ab2a4b49a...0d768f7c8f1b38ba14bbd5a2dfc4d56ae5eb4ad8,1,1,1,2,1,2008-08-16 09:34:23,2008-08-15 15:01:03
0d768f7c8f1b38ba14bbd5a2dfc4d56ae5eb4ad8...a5ab00c5d20cee04ce181bb5a6c3ca5d923744a4,2,17,4,21,5,2008-08-16 09:58:18,2008-08-16 03:27:31
a5ab00c5d20cee04ce181bb5a6c3ca5d923744a4...4370c2d620df93343e52432d92e3a3c031916697,1,5,0,5,1,2008-08-16 09:58:22,2008-08-16 02:14:33
4370c2d620df93343e52432d92e3a3c031916697...c14c8ceb13b299892f286757e22e6af4f6cffab5,1,7,2,9,3,2008-08-16 09:58:22,2008-08-15 19:53:59
a0653d550524a0263d36fde6a8cf98941dd057ab...c99db9d292c5f63c83ae2b441a67121d76553413,5,23,23,46,14,2008-08-14 06:10:23,2008-08-14 05:36:50
c99db9d292c5f63c83ae2b441a67121d76553413...b463776086a12c587f6d91c0347641fb6f7ddd72,2,12,24,36,8,2008-08-14 06:10:23,2008-08-14 05:36:51
b463776086a12c587f6d91c0347641fb6f7ddd72...8a3f524bf2ac534b313a7d8e70cc164cef744949,5,33,39,72,29,2008-08-14 07:30:26,2008-08-14 06:18:22
14877436871a1e5e38deb64abb884b480ff02567...d4040e0a1728035af34fc67907be088ca14d31c1,1,1,1,2,1,2008-09-02 04:58:22,2008-09-01 21:02:09
d4040e0a1728035af34fc67907be088ca14d31c1...9da6f0fff2d6ab4bfad36099b53c911bc498fc2e,1,7,7,14,7,2008-09-02 05:01:33,2008-09-02 01:35:24
9da6f0fff2d6ab4bfad36099b53c911bc498fc2e...f733c70941a79e8d7a05d16fac89294ef0366bda,1,1,1,2,1,2008-09-02 05:02:11,2008-09-02 01:45:01
f733c70941a79e8d7a05d16fac89294ef0366bda...86521acaca0cb9951d9ff5ac4bc2c736035267a0,2,4,4,8,4,2008-09-02 06:27:39,2008-09-01 19:07:33
86521acaca0cb9951d9ff5ac4bc2c736035267a0...62e00b0a9a72337a1ae2818ff3640e07c78db636,1,5,6,11,1,2008-09-02 06:48:45,2008-09-01 00:50:28
62e00b0a9a72337a1ae2818ff3640e07c78db636...db3a95459cb873c302051b4b2b693be5ba248c13,1,1,0,1,1,2008-09-03 00:03:51,2008-09-02 23:49:05
a2b26acd7afb4d77d8844ccd681e993f25e75205...e42251a221e44c0bd8438019da1c307def9a4ca8,1,1,1,2,1,2008-04-28 22:03:28,2008-04-28 21:09:55
e42251a221e44c0bd8438019da1c307def9a4ca8...72269ad9564b700e6aab30338e35b4e6ffea854d,1,4,4,8,2,2008-04-28 23:27:49,2008-04-28 23:27:49
72269ad9564b700e6aab30338e35b4e6ffea854d...7b7f39eae6ab0bbcc68d3c42a5b23595880e528f,1,5,3,8,4,2008-04-29 06:57:47,2008-04-28 20:23:35
a1748890dbfba4286c54fc9a3ce5786dfa25be33...afd899e1b7ef2b55a24834faad228b45ded6320a,1,3,1,4,1,2008-05-08 19:09:42,2008-05-08 17:25:06
afd899e1b7ef2b55a24834faad228b45ded6320a...15ddb6fab24e7cf848f7a91c59f8d96b6a5cd371,1,2,1,3,1,2008-05-08 19:15:30,2008-05-08 18:28:07
30c0312fd182942c10421e77d2b3ec6284cc0468...2d8bed969d5126053abe14ca331d14f287d462f5,1,1,1,2,1,2008-04-30 18:42:05,2008-04-30 18:42:05
d54467b8c319571b5dc433b1f7e471c4b0f21caf...c14b9d1e330a7f68ffd0ad7e22d6148c6097c122,3,101,43,144,14,2008-06-28 08:19:42,2008-06-27 17:43:09
d54467b8c319571b5dc433b1f7e471c4b0f21caf...7a07841c0ba8d791dd4c7363eaf004b4a7d11fb6,2,157,10,167,16,2008-06-28 00:01:02,2008-06-27 18:39:12
d54467b8c319571b5dc433b1f7e471c4b0f21caf...d0658ec6fac6b0a1830dbd2ead38facaff97fda7,1,33,4,37,2,2008-06-27 23:18:10,2008-06-26 05:16:37
d0658ec6fac6b0a1830dbd2ead38facaff97fda7...2dce956e397be8a769624e8693565b8a30056060,1,14,8,22,2,2008-06-28 06:21:45,2008-06-28 04:35:03
2dce956e397be8a769624e8693565b8a30056060...5b8e6f85f971dba8eeac048e7821978bbca14121,6,79,68,147,7,2008-06-28 06:22:00,2008-06-27 20:46:42
5b8e6f85f971dba8eeac048e7821978bbca14121...ef98c5cafb3e799b1568bb843fcd45920dc62f16,1,20,23,43,11,2008-06-28 06:36:59,2008-06-27 12:24:47
ef98c5cafb3e799b1568bb843fcd45920dc62f16...935e247e8c0b2330afaa56e117e7a1c0120e6420,1,1,1,2,1,2008-06-28 17:53:11,2008-06-28 17:13:29
935e247e8c0b2330afaa56e117e7a1c0120e6420...8813df9066427ffe40d1d77d18f20643f396f153,2,0,10,10,4,2008-06-29 03:55:26,2008-06-27 00:17:55
8813df9066427ffe40d1d77d18f20643f396f153...861d1af36ae168353fc352126c0bf2d189c2324a,1,6,6,12,1,2008-06-29 03:55:26,2008-06-27 00:18:48
3273ebc759ee44fa22026d2882d56010742c6797...6d6f9acc5db0dfae94ef22c9ecbcf7df00f84399,2,58,1,59,2,2010-01-06 21:49:41,2010-01-06 20:32:02
3273ebc759ee44fa22026d2882d56010742c6797...2dcb5e1ac87330b20962af9199a345eb378d3705,1,16,16,32,5,2008-12-03 02:03:07,2008-12-01 18:01:42
3273ebc759ee44fa22026d2882d56010742c6797...9e8eceab73e9f6a1e9349b1c14d4db0c035ac1ba,1,18,8,26,8,2008-12-02 23:15:58,2008-12-01 17:30:31
9e8eceab73e9f6a1e9349b1c14d4db0c035ac1ba...1b5b465fbde9515e04bd1e8524a208c92af3555e,1,28,1,29,3,2008-12-10 05:42:44,2008-12-04 02:00:12
7fb0abb19563d36d8e210198b6c2debbf3362812...9712b81a765978d2770b32bb77d25bfbf05d5eb5,1,29,3,32,5,2008-12-06 10:44:05,2008-12-06 10:44:05
9712b81a765978d2770b32bb77d25bfbf05d5eb5...97bed03448d864f38fac34eacf2fa124df526788,1,2,2,4,2,2008-12-21 23:16:17,2008-12-02 01:19:22
97bed03448d864f38fac34eacf2fa124df526788...adcbec13b9bbcb5e4a15de403038ff91d55b7ece,1,10,20,30,5,2008-12-21 23:16:17,2008-12-02 20:42:16
adcbec13b9bbcb5e4a15de403038ff91d55b7ece...da12e59dd6732f2f6dfe6285193dbebe9cd5a91b,1,1,1,2,1,2008-12-21 23:16:17,2008-12-03 12:43:20
da12e59dd6732f2f6dfe6285193dbebe9cd5a91b...968b016a4a910f5f52149831a5d480851e789bc3,1,6,6,12,6,2008-12-21 23:16:18,2008-12-06 19:48:30
968b016a4a910f5f52149831a5d480851e789bc3...48027a918d89bad6735897a2c3da77c0451a038c,1,157,29,186,18,2008-12-21 23:16:18,2008-12-06 19:49:24
48027a918d89bad6735897a2c3da77c0451a038c...61f57cb07d88e06a2027a4a4c571c59d353361a5,1,3,2,5,3,2008-12-21 23:16:18,2008-12-18 09:26:48
61f57cb07d88e06a2027a4a4c571c59d353361a5...e4df519f05ab20eae235968166a17a5a196bc377,1,5,0,5,1,2008-12-21 23:16:18,2008-12-18 07:30:49
fced80080675fe4dc8e3641083dd3742675f4b7b...d93f1713b0ba57b119f2ba2e2beda2ed9cc7349d,1,370,237,607,166,2009-04-30 23:35:09,2009-04-17 00:24:35
d93f1713b0ba57b119f2ba2e2beda2ed9cc7349d...3cb1f9c9820357812a9f17df92008c8838cbc1fc,1,8,2,10,3,2009-05-16 10:17:46,2009-05-12 14:45:06
a0d3ab9c277f1a198ec8e29432c0127d4cf719d2...0eea345111a9b9fea4dd2841b80bc7d62964e812,1,19,19,38,2,2008-11-15 05:30:55,2008-11-13 12:41:13
0eea345111a9b9fea4dd2841b80bc7d62964e812...682b451f84c046aa5b082e89e3db62950cb6261a,3,26,4,30,7,2008-11-15 05:30:55,2008-11-13 12:41:14
682b451f84c046aa5b082e89e3db62950cb6261a...b0169d84df4c09ed7dfcc6aea5aecd177ddda75b,1,43,9,52,16,2008-12-13 04:53:41,2008-12-12 21:48:40
b0169d84df4c09ed7dfcc6aea5aecd177ddda75b...162eba8b43a0e665c8e3439191981412815cc6db,2,13,0,13,3,2008-12-13 04:53:44,2008-12-12 21:48:41
a0d3ab9c277f1a198ec8e29432c0127d4cf719d2...671c9b7e315db89081cc69f83a8f405e4aca37bc,9,122,10,132,14,2008-11-15 03:11:49,2008-11-14 00:36:30
671c9b7e315db89081cc69f83a8f405e4aca37bc...7c4ea599b0d44e46c4f96bf955b62d96126b53ff,1,1,1,2,1,2008-11-17 17:49:12,2008-11-17 17:01:20
a0d3ab9c277f1a198ec8e29432c0127d4cf719d2...7f87aff22c0232a5ce327ea3d2923776936c97f4,7,126,20,146,25,2008-11-15 01:18:32,2008-11-15 00:14:24
7f87aff22c0232a5ce327ea3d2923776936c97f4...c6576f912fc34193a02d7ec587484f7c2ce3fe77,1,2,2,4,2,2008-11-19 00:10:05,2008-11-17 22:09:30
84cdd3c635280c42ae42009c4be020ef2c30ba7c...9f8f132621faedd250fded3e260402623da91a6f,1,13,1,14,5,2008-11-03 00:37:39,2008-11-02 23:21:02
4f80b27d48fee1c588810f3341ffe5d14558cea2...e534735a4cd778ac8172f543869a20894c1022a6,1,1,2,3,1,2008-08-11 21:24:51,2008-08-11 21:24:51
6cbf8b00fb27f5f55f1a5645ba60c451cb090fc1...6991357513bf8bfbb71a4675e271b386cc273476,2,6,9,15,5,2008-07-03 07:34:59,2008-07-03 07:25:23
6cbf8b00fb27f5f55f1a5645ba60c451cb090fc1...6d21bf96b59cbcc818fdc83b654d7fc83dd2c9cd,3,123,88,211,8,2008-07-03 06:32:25,2008-07-02 07:51:18
6d21bf96b59cbcc818fdc83b654d7fc83dd2c9cd...b6975ab59b07e5416b3f9b6f077d3cb50ef5ac7e,1,22,0,22,3,2008-07-03 06:32:25,2008-07-02 07:52:16
b6975ab59b07e5416b3f9b6f077d3cb50ef5ac7e...94fcb730ff665d356689f3d30e20e0fd75c6f62f,1,25,2,27,4,2008-07-03 06:32:25,2008-07-02 07:52:41
94fcb730ff665d356689f3d30e20e0fd75c6f62f...c0234b2ef6a8eaa27d9d93c4c96b36d9e82ebf9c,3,75,0,75,3,2008-07-03 19:14:53,2008-07-03 19:09:48
c0234b2ef6a8eaa27d9d93c4c96b36d9e82ebf9c...926ab840cdc867b54fa93b8e1ece2790315c2456,1,2,3,5,3,2008-07-06 09:54:56,2008-07-06 09:54:56
d3e977b943b3562021b892f1c8f966655785708a...0c3d26d24ab913a8cc6f478d176f5896af28c03c,3,80,0,80,3,2008-06-20 05:40:42,2008-06-19 23:21:33
0c3d26d24ab913a8cc6f478d176f5896af28c03c...66aafad5e43815e5f54634e4ef787cd759388880,1,3,0,3,1,2008-06-20 17:32:47,2008-06-20 13:02:10
66aafad5e43815e5f54634e4ef787cd759388880...ae081f3ebd5f65c453051b2db7b83d2a7c280827,1,3,0,3,1,2008-06-21 07:01:18,2008-06-10 08:34:25
ae081f3ebd5f65c453051b2db7b83d2a7c280827...cdeaf10f7e2754054c7be5d74227c698d2a71890,1,2,1,3,1,2008-06-21 07:01:37,2008-06-20 15:24:20
cdeaf10f7e2754054c7be5d74227c698d2a71890...fbd458a3f6bf2ba94380e2170ebfe2f53c2dec6d,1,28,0,28,1,2008-06-21 07:02:31,2008-06-20 21:10:50
fbd458a3f6bf2ba94380e2170ebfe2f53c2dec6d...73f03627f4f1b0f66b30fa96a25537f3600cce0b,1,2,1,3,1,2008-06-21 07:02:45,2008-06-21 03:25:25
951b09ce363f503d7bbd9dfa01b5a3ea2623c3d8...6998e4db52c6d98670a2cd1e59a7708dc18e2c52,11,38,42,80,32,2008-07-02 00:20:09,2008-06-30 22:01:21
6998e4db52c6d98670a2cd1e59a7708dc18e2c52...3f2d1ee89f6f1978a84ce184084738af4a462db9,1,3,3,6,3,2008-07-02 00:20:09,2008-06-30 22:05:15
3f2d1ee89f6f1978a84ce184084738af4a462db9...3861cd5582d4ae4b41a3bf4c464e780d1725ad4e,2,3,3,6,3,2008-07-02 00:20:09,2008-06-30 22:10:25
3861cd5582d4ae4b41a3bf4c464e780d1725ad4e...963a653fa635c6b07ed399b2fafca2a4d7866a21,1,5,5,10,3,2008-07-02 00:20:09,2008-06-30 22:15:57
963a653fa635c6b07ed399b2fafca2a4d7866a21...46e56e81b3bc91af7071809fbda8dcdec22c4cb1,4,10,10,20,5,2008-07-02 00:20:09,2008-06-30 22:17:07
46e56e81b3bc91af7071809fbda8dcdec22c4cb1...b1889c36d85514e5e70462294c561a02c2edfe2b,131,462,462,924,400,2008-07-02 00:20:15,2008-06-30 06:09:04
b1889c36d85514e5e70462294c561a02c2edfe2b...483bc4f045881b998512ae814d6cf44d0c0cb493,103,510,509,1019,424,2008-07-02 00:20:16,2008-06-30 18:56:34
483bc4f045881b998512ae814d6cf44d0c0cb493...aa0c1f2001e6d4fbc48401147541fcf7c84d7a0e,1,37,1,38,2,2008-07-02 00:29:38,2008-07-01 14:02:40
aa0c1f2001e6d4fbc48401147541fcf7c84d7a0e...e903b4095a097a549bb432748c06b0b0e600b27d,1,25,4,29,6,2008-07-02 00:47:31,2008-07-02 00:21:12
e903b4095a097a549bb432748c06b0b0e600b27d...dc49308450eac06a66f136b6c49e193bef25a168,1,1,1,2,1,2008-07-02 18:54:19,2008-07-02 14:13:35
dc49308450eac06a66f136b6c49e193bef25a168...8cb560fc470ee0d94e188d4e9deb14b0c8ac7a91,1,2,1,3,1,2008-07-02 18:54:22,2008-07-02 17:06:56
010a2dacc1acf3305e399ef1eb2e620110b95d5e...6ff6af62ec70e04676b35260a7f4b9fafc8f0973,1,1,0,1,1,2008-06-23 23:13:38,2008-06-23 21:33:41
6ff6af62ec70e04676b35260a7f4b9fafc8f0973...74b1e1235781bbe5c90b802c1551446a5f5d69f1,2,35,3,38,3,2008-06-24 00:38:08,2008-06-24 00:17:36
5c283eb13c94be6ca974aa722159dc9838d10d97...7c4ed8c83583517e7e6d851c8c01996ca6c803ff,1,11,20,31,3,2008-10-25 19:08:11,2008-10-25 13:30:22
7c4ed8c83583517e7e6d851c8c01996ca6c803ff...9ccd0a88ac3ea13ac2df4630bfd01c02084f965e,5,9,0,9,9,2008-10-25 19:09:31,2008-10-25 13:30:37
9ccd0a88ac3ea13ac2df4630bfd01c02084f965e...ef2e62fe23173586f49a00c6ae953ebbdb0d13ab,4,8,3,11,7,2008-10-25 19:09:31,2008-10-25 13:30:54
ef2e62fe23173586f49a00c6ae953ebbdb0d13ab...86295bb6bac1482d29650d1f77f19d8e7a7cc2fe,2,52,1,53,4,2008-10-25 19:09:31,2008-10-25 13:31:15
86295bb6bac1482d29650d1f77f19d8e7a7cc2fe...cdcab133ea75e0bd5c2279ce6c5718f4af4d9a03,1,52,139,191,15,2008-10-25 19:09:31,2008-10-25 13:31:36
5c283eb13c94be6ca974aa722159dc9838d10d97...a567fdcb016e8e882ec0a1e044c9caac8f70e693,15,298,32,330,31,2008-10-18 14:18:03,2008-10-02 20:55:39
5c283eb13c94be6ca974aa722159dc9838d10d97...33b650308c9be52180c6556b17cb9fc1fba3adf4,1,3,2,5,4,2008-10-18 14:16:38,2008-10-03 10:20:43
5c283eb13c94be6ca974aa722159dc9838d10d97...7e425c4fbbe9affffa822f154d8bb2d0da6699ef,3,13,10,23,6,2008-10-17 18:35:43,2008-10-13 14:39:46
5c283eb13c94be6ca974aa722159dc9838d10d97...7faee6b8de836904227ee98dc3d2c4c75b0ef3a1,2,17,5,22,6,2008-10-13 20:43:24,2008-10-13 04:33:31
5c283eb13c94be6ca974aa722159dc9838d10d97...80bfd76af7ac817d4a4b9b7d54485076897c9a67,1,1,1,2,1,2008-10-13 15:43:04,2008-10-13 09:35:59
5c283eb13c94be6ca974aa722159dc9838d10d97...1b2d297e41dbd12c56646796c3d3bcf190f0d5d4,1,178,137,315,26,2008-10-12 20:53:14,2008-10-10 18:42:26
5c283eb13c94be6ca974aa722159dc9838d10d97...2b11e059ee55ae7fb9913acf84fcc065e3e33287,1,12,7,19,5,2008-10-12 20:22:02,2008-10-11 22:02:32
5c283eb13c94be6ca974aa722159dc9838d10d97...41038c5e1534a6abef21ec4cfc216d13d0ac2fb5,1,24,18,42,2,2008-10-12 20:21:59,2008-10-07 00:14:18
41038c5e1534a6abef21ec4cfc216d13d0ac2fb5...b4666852a06af0c969ad8f1c444d0b48c4451e76,3,89,11,100,13,2008-10-12 20:21:59,2008-10-07 00:16:52
b4666852a06af0c969ad8f1c444d0b48c4451e76...e7108fcb15fadf7042fefc54fadc930e2298a4cb,1,2,1,3,2,2008-10-16 15:44:07,2008-10-15 07:11:52
5c283eb13c94be6ca974aa722159dc9838d10d97...06aaaa0bf70fe37d198893f4e25fa73b6516f8a9,2,95,14,109,17,2008-10-12 20:21:54,2008-10-01 04:04:01
5c283eb13c94be6ca974aa722159dc9838d10d97...9991030c0c97285087e5da86cfdbaf143a8a74cb,1,31,34,65,3,2008-10-12 20:21:51,2008-06-05 05:48:42
9991030c0c97285087e5da86cfdbaf143a8a74cb...96e117099c0e4f7d508eb071f60b6275038f6f37,1,12,30,42,5,2008-10-12 20:21:51,2008-06-05 05:58:40
276328ffb87cefdc515bee5f09916aea6e0244ed...19d4b416f429ac2d3f4c225aaf1af8761bcb03dd,5,5,11,16,7,2008-10-08 14:30:59,2008-10-06 23:39:10
276328ffb87cefdc515bee5f09916aea6e0244ed...5d1e958e2467ef295637844fd85be7a8ab187ef1,2,12,0,12,2,2008-10-06 16:02:47,2008-09-30 23:46:34
276328ffb87cefdc515bee5f09916aea6e0244ed...c44276563f96bba7133e3ee4144b7e0364d499b9,3,31,2,33,8,2008-10-06 16:00:56,2008-10-06 05:14:29
c44276563f96bba7133e3ee4144b7e0364d499b9...fd631d5828ec6b89e86e0568e5e798787fed9bbd,1,4,1,5,2,2008-10-14 23:50:32,2008-10-13 23:17:16
276328ffb87cefdc515bee5f09916aea6e0244ed...5de70efbd9236e44f122348ec2a1c2967d3bfde8,3,128,2,130,8,2008-10-06 16:00:55,2008-10-05 02:35:17
933bb3ae5e6c83288ec7c80c2282984f4927cb48...1689c5de8730ea334535337a341db3c7a21ad002,1,19,9,28,9,2008-11-02 23:39:54,2008-10-26 11:52:19
933bb3ae5e6c83288ec7c80c2282984f4927cb48...0bc3e781deb543ac2042cbd862c035403404c93d,3,12,0,12,3,2008-11-02 08:09:34,2008-10-26 11:52:37
0bc3e781deb543ac2042cbd862c035403404c93d...069bb5765c04645313d79a1eb345a4fb8fe7f06c,1,4,0,4,1,2008-11-02 08:12:35,2008-10-26 11:52:47
069bb5765c04645313d79a1eb345a4fb8fe7f06c...158629b2c9baffd0352306bd8dfa0784c981955d,1,3,1,4,3,2008-11-03 00:41:41,2008-11-02 23:43:20
158629b2c9baffd0352306bd8dfa0784c981955d...20f7a39825e30891056ab00ea620eaffda6aa451,2,17,0,17,2,2008-11-09 19:26:54,2008-11-03 18:14:28
356af64d84076baaf90b0bf8adb7245771264e5a...058412d09748c90be996a70729b961adad084175,1,4,2,6,2,2008-10-27 05:25:09,2008-10-26 22:08:52
66fd74ea5db13e6f095f7c414e9ea4a1aa59cdc7...c985ddf318a8c41c6e1abc8bebd058b31c7413c1,1,6,6,12,6,2009-12-30 03:51:37,2009-12-29 19:09:15
e72263a1f88d39a7e3672bbe15a7524f8a3f520a...607a9e8aaa9b1a18f81ae67e40a5c8a5d1a92577,1,1,1,2,1,2009-08-28 02:59:00,2009-08-27 23:39:38
9619ff14159ab3401636b9883a715b0f20b051df...3cd7388d57db4f4a29949e8de96493fb77059484,1,4,7,11,3,2009-05-25 18:34:02,2009-05-25 10:46:09
0ddbbb66614c7a503442ff863817ccbc68f417ab...0bf8c1f9be55ae9c6a592324582526778e45b8dd,1,5,16,21,6,2009-05-31 22:38:32,2009-05-31 10:36:10
0bf8c1f9be55ae9c6a592324582526778e45b8dd...c4d5359230c4bd427f37662f9d12fdf006b6e6ba,1,1,1,2,1,2009-05-31 22:39:04,2009-05-29 10:21:24
c4d5359230c4bd427f37662f9d12fdf006b6e6ba...ee6b71141f2803bd4d4f6e1a17ef826567dc9644,1,4,6,10,1,2009-05-31 22:39:32,2009-05-29 12:00:36
ee6b71141f2803bd4d4f6e1a17ef826567dc9644...13bd21340888de1fab7d745fc447bb43694a20c5,1,5,0,5,1,2009-05-31 22:40:09,2009-05-31 05:08:02
13bd21340888de1fab7d745fc447bb43694a20c5...6e4f981ffb88c8a9d3d6128314f4dd4f54ffb8a8,2,13,1,14,2,2009-05-31 22:59:16,2009-05-30 21:54:18
e4b09dad9f65395fd4bb8ab165012a3a6698a75b...b867d324ceb7e5c4f14a04c6b55d69498812d24b,2,5,2,7,2,2009-05-17 05:41:18,2009-05-12 01:17:38
b867d324ceb7e5c4f14a04c6b55d69498812d24b...da4b3e8c28b1dc2b856d2555ac7bb47ab712598c,1,1,1,2,1,2009-05-17 05:41:46,2009-05-14 20:05:03
da4b3e8c28b1dc2b856d2555ac7bb47ab712598c...076c32370d8a6ac2fb57b2a55c674942e106f8ab,1,2,2,4,2,2009-05-17 05:46:22,2009-05-17 03:42:43
6a01554e6350123c78de805d820e90f1c56e5fdc...c8c562a238071843c64ea0f3a2c85481606da379,2,7,1,8,3,2009-06-02 02:42:17,2009-06-01 09:20:56
6a01554e6350123c78de805d820e90f1c56e5fdc...6d2bf96e550731499c73731e5623017d193f837f,6,23,29,52,18,2009-06-02 02:41:24,2009-05-31 14:26:48
23807fa0086ae6ad6980a2a1071f23ed1a6dde93...33fd7169ed6658e898b414a66aefaad16b404ec5,1,35,1,36,5,2009-05-26 02:46:17,2009-05-26 02:46:17
7a26e653929025e11e689bc7d98365c9a0107dc9...87ca2eaade70519e0f4509808f662c0bb1dbcadf,1,11,0,11,1,2009-08-15 17:36:29,2009-08-15 12:26:49
87ca2eaade70519e0f4509808f662c0bb1dbcadf...3d792161b1c86632d5331bb30d6b7c6b17261f38,2,5,1,6,2,2009-08-15 17:36:59,2009-08-15 13:56:39
7a26e653929025e11e689bc7d98365c9a0107dc9...32a90233d147bd697b338326bd1fabf9edc3f1fe,1,6,0,6,1,2009-05-25 18:23:30,2009-05-25 12:07:55
4bf1f68ee7a894e7e4936217eec7e6ae5fa4db77...00652369ff285f84e440f5d41d708283e30825d7,1,33,0,33,2,2009-05-13 19:59:06,2009-05-09 01:23:32
00652369ff285f84e440f5d41d708283e30825d7...1a2872595409fbdd5d448730953884ef8d8c6613,1,4,0,4,1,2009-05-13 20:12:22,2009-05-13 15:43:06
1a2872595409fbdd5d448730953884ef8d8c6613...95405ba6cf7adeaa4a066e8a3a1b76b73f7b9341,1,8,2,10,2,2009-05-13 20:13:30,2009-05-13 18:08:53
95405ba6cf7adeaa4a066e8a3a1b76b73f7b9341...39d404d13774fac5ce4b7b180d2b8988eb6fd6c7,1,2,2,4,1,2009-05-17 02:43:29,2009-05-14 12:55:54
39d404d13774fac5ce4b7b180d2b8988eb6fd6c7...8a94bc7bdc54db0d77058e63baf173ff932cba7c,1,29,5,34,5,2009-05-17 02:43:29,2009-05-13 16:32:06
f01f1099f40f24fe6f7802185340a6fa3a3d4f35...3fc0d131c573f6f774e2e4abba9cbda694b08321,2,9,1,10,2,2010-02-19 06:22:22,2010-02-19 05:57:21
f01f1099f40f24fe6f7802185340a6fa3a3d4f35...604e0cb5cbd2ea2e37273e13f99b6572cd82b4c1,1,6,3,9,2,2009-10-12 23:28:42,2009-10-12 05:28:23
f01f1099f40f24fe6f7802185340a6fa3a3d4f35...b5227d80aee5173bfda6aa43a890d03110b0df26,2,32,8,40,3,2009-10-12 23:12:49,2009-10-12 05:11:57
f01f1099f40f24fe6f7802185340a6fa3a3d4f35...4577e483648f50dd80faa401dc1d3eb33ffb627b,5,7,8,15,8,2009-05-14 03:55:48,2009-05-13 21:22:04
4577e483648f50dd80faa401dc1d3eb33ffb627b...de435ac0f633b1f68dba2970cb7fa019171e40fe,2,4,3,7,4,2009-05-14 03:55:49,2009-05-13 21:32:53
f01f1099f40f24fe6f7802185340a6fa3a3d4f35...09caa24facae88e19cce1c12f21dac935cbf0909,2,7,3,10,2,2009-05-14 03:54:57,2009-05-12 22:48:56
f01f1099f40f24fe6f7802185340a6fa3a3d4f35...1c876546bda5dde35d4ae887ad6d24ed16ec953a,2,3,1,4,2,2009-05-10 07:30:28,2009-04-19 09:55:38
1c876546bda5dde35d4ae887ad6d24ed16ec953a...280e65cbd83a867437cef3543d445013ecbfe29a,2,37,28,65,7,2009-05-10 07:30:28,2009-04-19 09:55:43
280e65cbd83a867437cef3543d445013ecbfe29a...2ace9727be2b04ce9fbc5939466da38be7fd8496,1,15,9,24,2,2009-05-10 07:30:28,2009-04-19 09:55:57
2ace9727be2b04ce9fbc5939466da38be7fd8496...ef24c7ca055f03c673c2b67a3a7c92bcc32f62f0,3,115,3,118,10,2009-05-10 07:30:28,2009-04-19 09:56:07
ef24c7ca055f03c673c2b67a3a7c92bcc32f62f0...5a1d31c7e43a54c3a5275266745488de7208d871,1,9,30,39,4,2009-05-10 07:30:28,2009-04-19 09:56:16
5a1d31c7e43a54c3a5275266745488de7208d871...c99f069de2f06b7abe0406c2ff1b46621dbc9398,3,3,25,28,7,2009-05-10 07:30:28,2009-04-21 05:54:09
c99f069de2f06b7abe0406c2ff1b46621dbc9398...38ef7507d1dce87d68f177a6209d716339fee854,2,15,18,33,10,2009-05-10 07:30:28,2009-04-21 05:54:10
38ef7507d1dce87d68f177a6209d716339fee854...503253771e93fd9f29c9f0773223d456677452c4,2,49,1,50,5,2009-05-10 07:30:28,2009-04-25 04:55:26
503253771e93fd9f29c9f0773223d456677452c4...de52f5a806f58c6b73b2e24768530213fab5a635,2,3,14,17,5,2009-05-10 07:30:28,2009-04-24 06:29:00
de52f5a806f58c6b73b2e24768530213fab5a635...47c9739e5e02484de618ca70a592ecd25c05fd1a,1,1,5,6,1,2009-05-10 07:30:29,2009-04-24 06:29:01
47c9739e5e02484de618ca70a592ecd25c05fd1a...6212b1aae9dcc0de1dca1553298c6668579dd184,1,15,10,25,6,2009-05-10 21:30:16,2009-05-09 15:55:38
6212b1aae9dcc0de1dca1553298c6668579dd184...3755ccdb65a3bcaa1d55a6b4ec9c47eab0501baa,1,11,8,19,4,2009-05-10 21:30:19,2009-05-09 15:55:39
3755ccdb65a3bcaa1d55a6b4ec9c47eab0501baa...fad2d31d62277eced9aa7fc187ae3b97e72895bb,1,19,7,26,8,2009-05-10 21:30:22,2009-05-09 15:55:40
fad2d31d62277eced9aa7fc187ae3b97e72895bb...1c953a1f46340a9ca0fc84345e826c9372dee42a,1,29,28,57,11,2009-05-10 21:30:23,2009-05-09 15:55:41
1c953a1f46340a9ca0fc84345e826c9372dee42a...2b020695e4db8dbaee7997090aec08760903291b,1,8,10,18,6,2009-05-10 21:30:26,2009-05-09 15:55:42
2b020695e4db8dbaee7997090aec08760903291b...aaaff9e2d29a68c23a416bcc5f3f382504770bf8,1,12,12,24,9,2009-05-10 21:30:29,2009-05-09 15:55:43
aaaff9e2d29a68c23a416bcc5f3f382504770bf8...1da8c4fc2c85ed99e23d640bddedd8119150a1b8,1,6,2,8,4,2009-05-10 21:30:30,2009-05-09 15:55:44
1da8c4fc2c85ed99e23d640bddedd8119150a1b8...c0537662806f4b3d3ba883d05a48fdf9120893f0,1,130,0,130,3,2009-05-10 21:30:31,2009-05-09 15:55:45
c0537662806f4b3d3ba883d05a48fdf9120893f0...d937d4aca1f10b9202b620a89dc6a5972e9605eb,1,75,0,75,1,2009-05-10 21:30:32,2009-05-09 15:55:46
d937d4aca1f10b9202b620a89dc6a5972e9605eb...0871984d304c9201b85897743eae583cd165106d,4,13,134,147,11,2009-05-10 21:30:33,2009-05-09 15:55:47
f01f1099f40f24fe6f7802185340a6fa3a3d4f35...d92a39590d1126e195f1bbccf182a2cdb79218e7,3,127,6,133,14,2009-05-09 15:27:52,2009-05-04 19:30:01
f01f1099f40f24fe6f7802185340a6fa3a3d4f35...da159c7759418bb14af655968dfa7a98bdcb8661,3,19,0,19,3,2009-05-09 15:25:55,2009-05-07 13:41:27
da159c7759418bb14af655968dfa7a98bdcb8661...fe53bbc9bebb853f97f0da3f63f7fca5774e3f95,2,3,9,12,3,2009-05-09 15:25:55,2009-05-07 13:41:28
f01f1099f40f24fe6f7802185340a6fa3a3d4f35...4481ff048df4c86021d783de6f099909495f04ff,1,3,3,6,2,2009-05-09 15:25:22,2009-05-02 08:57:21
f01f1099f40f24fe6f7802185340a6fa3a3d4f35...ca6b91d29b7ea937b71f62bf00ba7750f3e594ce,2,20,1,21,5,2009-05-09 15:10:15,2009-05-09 08:12:01
f01f1099f40f24fe6f7802185340a6fa3a3d4f35...a4c2e69936df8dd0b071b85664c6cc6a4870dd84,2,4,1,5,3,2009-05-09 08:35:49,2009-05-08 05:32:37
f01f1099f40f24fe6f7802185340a6fa3a3d4f35...6207011ae3fe813159e92762e86f33c9bd42cd7f,2,13,1,14,2,2009-05-09 04:49:14,2009-05-09 04:49:14
0be9bc0f0a45ba667e7aaca14257da772b38e783...ab07ba2a2436cc717b872387320297bb806d35d9,3,62,4,66,11,2009-04-23 01:36:25,2009-04-22 21:41:25
ab07ba2a2436cc717b872387320297bb806d35d9...6123d7196fdd9ac9aed24b4aeed854813fe9a6b1,1,4,1,5,3,2009-04-25 15:47:03,2009-04-25 11:46:14
0be9bc0f0a45ba667e7aaca14257da772b38e783...3a0483281afbb6660aaf86c7b228a523782a4d6a,1,1,1,2,1,2009-04-21 16:49:04,2009-04-21 09:21:59
3a0483281afbb6660aaf86c7b228a523782a4d6a...8fbf879ed75b67417b0e36eb7b03b79611f1f8a0,2,1,6,7,3,2009-04-21 23:33:20,2009-04-21 23:32:18
8fbf879ed75b67417b0e36eb7b03b79611f1f8a0...7b1d6269eebb0701c287d3ed8732384c115d2e1f,1,28,2,30,3,2009-04-23 00:48:22,2009-04-22 21:27:15
7b1d6269eebb0701c287d3ed8732384c115d2e1f...36a31feae23ac45a130fa38b2934a74e4e7156b4,1,2,2,4,1,2009-04-23 00:48:42,2009-04-22 19:52:13
36a31feae23ac45a130fa38b2934a74e4e7156b4...a6c1a3827c934872726bafb35f51f2ad9b9e897f,2,2,2,4,2,2009-04-23 00:49:56,2009-04-22 21:27:59
a6c1a3827c934872726bafb35f51f2ad9b9e897f...e8d1180467da98c53663e462800f793d2341f5a1,1,2,1,3,1,2009-04-23 01:39:21,2009-04-22 07:27:22
e8d1180467da98c53663e462800f793d2341f5a1...4ddef0e67d879bf7e18ce2655b057243d894adc1,1,1,1,2,1,2009-04-23 01:39:57,2009-04-22 15:48:57
4ddef0e67d879bf7e18ce2655b057243d894adc1...bad542f0b1bca3b57e300a21fc7268c1800e6752,1,1,1,2,1,2009-04-23 01:40:33,2009-04-22 15:48:58
bad542f0b1bca3b57e300a21fc7268c1800e6752...3ea3c215c02dc4a4e7d0881c25b2223540960797,20,27,27,54,27,2009-04-23 02:02:12,2009-04-17 18:13:30
3ea3c215c02dc4a4e7d0881c25b2223540960797...b18cc5a3b2f64364d2c7d3560066852728a6c666,4,4,4,8,4,2009-04-23 02:03:39,2009-04-22 21:15:56
b18cc5a3b2f64364d2c7d3560066852728a6c666...7bd93c1c625ce5fa03f0d13d728f34f8ab868991,4,5,5,10,5,2009-04-23 02:05:37,2009-04-23 01:46:02
7bd93c1c625ce5fa03f0d13d728f34f8ab868991...7613ea3595f3a56f0f9d827944775940f1e72ef6,2,9,1,10,2,2009-04-23 02:10:41,2009-04-22 13:41:29
ea0b767c1ea66f687e58a9fcff45a5a518e699c3...ca2cedba70e9356a1a20b0e39acd07ab92fee80e,4,184,6,190,12,2009-04-24 08:20:25,2009-04-23 23:06:38
ca2cedba70e9356a1a20b0e39acd07ab92fee80e...329484256e0fe42676e93669122e7a5a007ef4ed,4,35,27,62,20,2009-06-03 07:04:52,2009-06-03 06:27:06
ea0b767c1ea66f687e58a9fcff45a5a518e699c3...48d3448dd5700f9ea8a142935fd4263ba1fb79c6,1,15,0,15,2,2009-04-23 11:20:12,2009-04-23 09:37:56
48d3448dd5700f9ea8a142935fd4263ba1fb79c6...fd1ff306b7a02f9412f8ed4881dd239d8a4a709a,2,4,4,8,4,2009-04-23 11:20:34,2009-04-23 09:37:57
fd1ff306b7a02f9412f8ed4881dd239d8a4a709a...a12397877146b3fa8f791a4a38987942f35a5e82,1,4,3,7,1,2009-04-23 11:21:22,2009-04-23 09:37:58
a12397877146b3fa8f791a4a38987942f35a5e82...50710ce49b8e66204cc6147345db9c99bb7cfe82,1,19,19,38,7,2009-04-23 19:53:16,2009-04-23 16:16:52
50710ce49b8e66204cc6147345db9c99bb7cfe82...773002a78c69b91a3e5904137c23cae5363d6059,1,17,17,34,10,2009-04-23 19:53:31,2009-04-23 09:38:00
773002a78c69b91a3e5904137c23cae5363d6059...b7ee2266fe2d8593d4c2affdc3361836ce826230,1,6,6,12,2,2009-04-23 19:53:31,2009-04-23 09:38:01
b7ee2266fe2d8593d4c2affdc3361836ce826230...66e35fcb79cad5a2ec2366da956db55da855b20d,1,3,3,6,2,2009-04-23 19:53:32,2009-04-23 09:38:02
66e35fcb79cad5a2ec2366da956db55da855b20d...5be3b17f094d832458238e4d2979cf9ab7118b6f,1,2,0,2,2,2009-04-23 19:53:32,2009-04-23 05:42:28
5be3b17f094d832458238e4d2979cf9ab7118b6f...677fbff88f368ed6ac52438ddbb530166ec1d5d1,1,6,0,6,1,2009-04-24 08:20:35,2009-04-23 19:18:09
677fbff88f368ed6ac52438ddbb530166ec1d5d1...178b513eb78ac8099588c5bed1f1f74f660cf009,1,1,2,3,2,2009-04-24 08:29:13,2009-04-23 13:49:06
178b513eb78ac8099588c5bed1f1f74f660cf009...cd294bc3f3a7b1277551a8c6e0682fdfbe794260,1,1,1,2,1,2009-04-24 08:29:28,2009-04-23 13:49:05
cd294bc3f3a7b1277551a8c6e0682fdfbe794260...a766829458d2ecdc09f42076775ce4d6d4c9d1a8,1,5,0,5,1,2009-04-24 16:24:35,2009-04-24 13:56:14
55f0566f6d7269a56751333e0943b50237ce6a85...aed97c677cdfd1b9bbc9b33b5418ad4a29109082,1,10,1,11,4,2009-04-18 04:26:11,2009-04-16 20:00:44
55f0566f6d7269a56751333e0943b50237ce6a85...ad94657fdb8b177b07d94887e1b5259f590f11a8,1,5,4,9,4,2009-04-18 04:05:49,2009-04-17 22:17:49
ad94657fdb8b177b07d94887e1b5259f590f11a8...4191e80a3e8ee0fa0b8f97f9fba81c3549813fd5,2,11,4,15,6,2009-04-18 04:05:49,2009-04-17 22:17:58
4191e80a3e8ee0fa0b8f97f9fba81c3549813fd5...66985e6629c4325ec6b1508bf4bda907c2a538cb,1,4,2,6,2,2009-04-18 04:05:49,2009-04-17 22:18:01
66985e6629c4325ec6b1508bf4bda907c2a538cb...ba053ea96c252e04729dcd439e3c35d394d69914,4,36,2,38,11,2009-04-18 04:05:49,2009-04-17 22:18:05
ba053ea96c252e04729dcd439e3c35d394d69914...8aece7ff0611846c9f8d6c12566d6ac26d84a184,1,91,0,91,1,2009-04-18 04:05:49,2009-04-17 22:18:10
a2dc04ba159def766ee17db00c60bdbda477955d...f04833ef9f330612a4116401258882b38e95744e,1,12,1,13,4,2009-05-02 05:13:43,2009-05-02 00:18:02
b79376cdf3bd6ee922261776613d085a7b36ffd9...d4b190271549c0b3f036884092b973696a34ea3a,1,1,1,2,1,2009-04-28 18:47:54,2009-04-28 12:28:31
d4b190271549c0b3f036884092b973696a34ea3a...26e47f25402ad51c6cfa1cd784a3431dd00deeb2,1,3,3,6,3,2009-04-28 18:50:18,2009-04-28 12:28:32
26e47f25402ad51c6cfa1cd784a3431dd00deeb2...348df16679cf35b7bba7afea99638e7d81dc3d33,6,30,16,46,9,2009-04-29 23:50:07,2009-04-27 22:32:25
348df16679cf35b7bba7afea99638e7d81dc3d33...2163e3f7786f56d5aaf9eadea6776bb0e38b30a4,1,1,1,2,1,2009-04-29 23:50:10,2009-04-28 20:29:24
2163e3f7786f56d5aaf9eadea6776bb0e38b30a4...d212ca1724b1a3708a3b4cb72c58b20ef442b24f,1,2,0,2,1,2009-04-29 23:50:21,2009-04-29 22:49:47
d212ca1724b1a3708a3b4cb72c58b20ef442b24f...0c44c94309693d0582e91a6744edc2e8eba46ef8,2,9,5,14,3,2009-04-29 23:50:21,2009-04-29 18:08:18
0c44c94309693d0582e91a6744edc2e8eba46ef8...3e8a00ae1d529e61f38f36fdb504902064cf1f5d,1,14,14,28,3,2009-04-29 23:50:21,2009-04-27 13:59:49
be66a6c43dcba42c56f66a8706721a76098f8e25...95110d75d972dfdd317829ae7feaf42d4f14ab25,1,1,1,2,1,2009-04-26 23:20:25,2009-04-26 19:29:13
95110d75d972dfdd317829ae7feaf42d4f14ab25...531e6daa038c68ca8fd5a8b042907a618fb7722d,1,1,0,1,1,2009-04-27 08:06:35,2009-04-27 07:44:58
531e6daa038c68ca8fd5a8b042907a618fb7722d...fe4a9c36a3905d5aefc9740ba1689d3000c2762e,1,1,1,2,1,2009-04-27 08:07:08,2009-04-27 02:36:48
fe4a9c36a3905d5aefc9740ba1689d3000c2762e...9a695fbf388263794ccbd16a342f4e2f8c5d400d,2,2,0,2,2,2009-04-27 16:54:24,2009-04-26 13:49:00
9a695fbf388263794ccbd16a342f4e2f8c5d400d...b9d622e711f0bf0280996bd79ec8509475ae80e5,1,2,2,4,1,2009-04-27 23:33:53,2009-04-27 22:12:31
b9d622e711f0bf0280996bd79ec8509475ae80e5...62f780dcc6a5f1a38d9f8e25234a91d16ab8fbbd,1,1,3,4,2,2009-04-28 05:59:38,2009-04-28 03:34:24
62f780dcc6a5f1a38d9f8e25234a91d16ab8fbbd...47afed5dc17faf10fde18789b17cf6ebff829cf4,1,13,1,14,3,2009-04-28 07:40:00,2009-04-27 14:38:47
be66a6c43dcba42c56f66a8706721a76098f8e25...a408e0e649b79ede7422bf837a31d281e4188cef,1,7,8,15,6,2009-04-26 08:37:47,2009-04-24 22:06:47
a34a9dbbced36999496c52b43460825732d487ba...3d95d92b9a75825b2d9c9bd770d85471b18597f8,2,46,18,64,9,2009-02-03 08:39:18,2009-02-01 01:34:05
a34a9dbbced36999496c52b43460825732d487ba...817d14a87a90481b60a1c28f79f7d838d985a45c,1,27,37,64,7,2009-02-01 01:10:07,2009-01-30 23:51:55
817d14a87a90481b60a1c28f79f7d838d985a45c...dcdb3335c13c018cbc75b49c170080817c123834,1,8,7,15,2,2009-02-03 06:44:41,2009-02-03 06:24:40
dcdb3335c13c018cbc75b49c170080817c123834...223bd9317643f8ccef3447583944e58c13c10db9,1,1,0,1,1,2009-02-04 06:16:24,2009-02-03 13:07:26
223bd9317643f8ccef3447583944e58c13c10db9...2d20b7ebf672c28b18da4558d96f100613e4e4ca,1,2,1,3,1,2009-02-04 06:51:48,2009-02-03 12:39:00
a34a9dbbced36999496c52b43460825732d487ba...499cc56a60b5c90415c74857035579713a07fa1b,1,1,0,1,1,2009-01-31 05:06:27,2009-01-30 01:12:27
499cc56a60b5c90415c74857035579713a07fa1b...c3254aeecf89a620db262480a7c424e7607f1e2a,1,5,0,5,1,2009-01-31 05:08:24,2009-01-31 01:31:50
c3254aeecf89a620db262480a7c424e7607f1e2a...0dbf027ad2fc946cb63330146560962fa5d43d2d,1,76,0,76,1,2009-01-31 05:08:30,2009-01-31 01:31:51
0dbf027ad2fc946cb63330146560962fa5d43d2d...41a4d16e200d24b2435148e974b665429931abc9,1,4,4,8,3,2009-01-31 05:08:49,2009-01-31 01:31:52
41a4d16e200d24b2435148e974b665429931abc9...418566b6fdcc0eb1b5549d0742366aa13a7ff277,2,8,1,9,2,2009-01-31 05:11:24,2009-01-29 16:30:51
418566b6fdcc0eb1b5549d0742366aa13a7ff277...ad8c3477b890dfb125ac5ea8962f945f056674d7,1,2,2,4,2,2009-01-31 05:11:46,2009-01-29 21:58:02
ad8c3477b890dfb125ac5ea8962f945f056674d7...3fe2bf2fa700a6bc37107be97603945fdbeeeab3,1,1,1,2,1,2009-01-31 05:11:50,2009-01-30 16:55:24
3fe2bf2fa700a6bc37107be97603945fdbeeeab3...218289644023e40026150422afef93d7eae45d5c,1,13,25,38,10,2009-01-31 05:11:59,2009-01-30 22:47:00
218289644023e40026150422afef93d7eae45d5c...384770a5e79938b6a7633c5996597ef3211e4a7c,2,12,7,19,7,2009-02-01 01:34:58,2009-01-30 23:19:29
384770a5e79938b6a7633c5996597ef3211e4a7c...99ccabaffa201e867f2073947dcccae3947ec4f1,1,12,19,31,5,2009-02-01 01:35:06,2009-01-31 20:27:56
a34a9dbbced36999496c52b43460825732d487ba...469e2ebf63cbf05455365aa3ed6d43acf6f4e496,2,27,5,32,8,2009-01-31 03:23:22,2009-01-30 08:33:00
469e2ebf63cbf05455365aa3ed6d43acf6f4e496...e15ef669437d8396e0a442719ed54eb1df38366a,2,24,9,33,5,2009-01-31 03:23:22,2009-01-30 08:50:54
bee6ea17a1bab824eba6133eefc3c70b219ec98c...86afbd02c890eca08424174b7d6e583af38b0363,1,9,1,10,1,2011-06-30 18:26:39,2011-06-30 09:39:20
86afbd02c890eca08424174b7d6e583af38b0363...e8c35317172aab9da7afe555da603021a3ae89e5,1,2,1,3,1,2011-06-30 18:26:48,2011-06-30 09:39:21
df487baa30924a36ade38ada4f77379236dcce0f...f6b98e46bdf64454d7c6ab76d617237118799d7b,1,1,1,2,1,2009-02-09 08:06:36,2009-02-08 23:12:43
c19923add0530567ff90e4c4e1bccbc5c0a837f7...621f1b4bcf40f1469fc59202248df35619e33c82,2,58,16,74,16,2009-02-07 19:18:40,2009-02-07 19:06:34
53d1589ff6bd336e3ece39e0a963a3d2a537cf96...146ea068a0434a7423d8b0d77f27ccff0a584ac4,2,32,2,34,3,2008-08-31 04:04:50,2008-08-27 06:13:13
53d1589ff6bd336e3ece39e0a963a3d2a537cf96...a5a818ee4877e4458e8e6741a03ac3b19941d58a,7,70,8,78,18,2008-08-31 03:53:24,2008-08-19 03:08:09
53d1589ff6bd336e3ece39e0a963a3d2a537cf96...f2b25dd81f4ccbf42700bd15feeb2becf10331ab,1,70,51,121,5,2008-08-31 02:41:43,2008-08-28 08:04:00
f2b25dd81f4ccbf42700bd15feeb2becf10331ab...e0af48e49682ea3345f932f6b9e7fa7c5e5e611a,4,135,21,156,44,2008-08-31 02:41:43,2008-08-28 08:10:04
e0af48e49682ea3345f932f6b9e7fa7c5e5e611a...838338cd22c1df53c1460d9239780371a234b242,1,7,7,14,5,2008-08-31 02:41:43,2008-08-29 15:16:30
838338cd22c1df53c1460d9239780371a234b242...83133740d9c81ce4c98cb53b85c8d5b190944f81,2,10,3,13,3,2008-08-31 02:41:43,2008-08-29 15:22:55
83133740d9c81ce4c98cb53b85c8d5b190944f81...cc58d7dfddc842360f6aade1507e1063d8cd0f40,1,13,10,23,10,2008-08-31 02:41:43,2008-08-29 17:12:23
cc58d7dfddc842360f6aade1507e1063d8cd0f40...387c9d49815ef4b1cefda71cf27f199d9fb24083,1,8,2,10,4,2008-08-31 02:41:43,2008-08-29 17:24:45
387c9d49815ef4b1cefda71cf27f199d9fb24083...b541248467fa47979a34e3f1c5bbe3308fbdc4d1,5,47,1,48,6,2008-08-31 02:41:44,2008-08-29 17:49:56
b541248467fa47979a34e3f1c5bbe3308fbdc4d1...c236bcd06138bcbc929b86ad1a513635bf4847b2,2,13,5,18,6,2008-08-31 02:41:44,2008-08-29 17:59:16
53d1589ff6bd336e3ece39e0a963a3d2a537cf96...8fdcf3125465f70c0cad5be5ab192d46e46307c7,2,50,1,51,4,2008-08-30 23:46:25,2008-08-29 20:40:36
53d1589ff6bd336e3ece39e0a963a3d2a537cf96...34baebcee1d66be4cc096a69ba448cd24dcedf21,6,11,11,22,10,2008-08-30 20:50:48,2008-08-30 11:12:53
34baebcee1d66be4cc096a69ba448cd24dcedf21...7e44c93558e7c0b12624d76cf07753d0480ed96a,15,52,52,104,52,2008-08-31 16:39:19,2008-08-31 16:39:19
7e44c93558e7c0b12624d76cf07753d0480ed96a...0cb0e143ffa7d66b7feea0a967b3ac9ae6cd62b0,26,103,103,206,99,2008-09-03 19:41:46,2008-09-03 08:59:27
0cb0e143ffa7d66b7feea0a967b3ac9ae6cd62b0...3604e7c5c6f8d48e221ea5b21ef26fc3e27eff9e,26,130,130,260,107,2008-09-03 21:13:59,2008-09-03 08:59:29
3604e7c5c6f8d48e221ea5b21ef26fc3e27eff9e...d592b3157f70c9dac6288b28c46a64826c0abd18,6,183,183,366,178,2008-09-03 21:51:48,2008-09-03 08:59:31
d592b3157f70c9dac6288b28c46a64826c0abd18...47a528ad24185133867ebb5bb7692db2cb8bef39,18,99,99,198,94,2008-09-03 21:51:48,2008-09-03 08:59:33
53d1589ff6bd336e3ece39e0a963a3d2a537cf96...6ed7f25e95069a900b10f838b15639af3fac05d3,1,12,17,29,10,2008-08-30 04:51:27,2008-08-29 20:07:58
6ed7f25e95069a900b10f838b15639af3fac05d3...abeb40e5aa5b4a39799ae1caad241c8c7708053a,5,66,16,82,16,2008-08-30 04:51:27,2008-08-29 20:07:59
abeb40e5aa5b4a39799ae1caad241c8c7708053a...ac0463ed44e859c84e354cd0ae47d9b5b124e112,2,5,5,10,4,2008-08-30 04:51:27,2008-08-29 20:08:00
ac0463ed44e859c84e354cd0ae47d9b5b124e112...8522148f79c29ef8f63688e7186e458a22333224,1,25,18,43,15,2008-08-30 04:51:28,2008-08-29 20:08:01
8522148f79c29ef8f63688e7186e458a22333224...d35825da6d5570524234e1bfe4ff0f57957b6db3,1,8,3,11,4,2008-08-30 04:51:28,2008-08-29 20:08:02
6a42cfe86c485675987b64690e75d8821567d328...de5d560c99c96e2955fb4d1d8a8fa6b469926292,2,51,1,52,2,2008-09-03 22:39:19,2008-09-03 22:39:19
16088d8870b7da6d4dd280be2d1728dd3be346b5...5bdd8d4a3062ac8f29ec511fecb85049f6ff3ecc,2,11,3,14,6,2008-11-05 22:09:43,2008-11-05 20:55:53
5bdd8d4a3062ac8f29ec511fecb85049f6ff3ecc...16ed2f48be228918af3d1a6c5a6a4fe9b832cb84,2,39,14,53,8,2008-11-05 22:22:10,2008-11-05 20:55:54
764369c5ea730894c75f32c2f94a651dd517fc5b...379f84b8d19b5412aff5b9d6bd7bb1ada37b9353,1,4,0,4,2,2009-03-17 02:57:48,2009-03-13 23:42:37
764369c5ea730894c75f32c2f94a651dd517fc5b...880fa117f197a2c1f41fb16b09cd1e8d6050d6fc,1,1,1,2,1,2009-03-09 23:21:17,2009-03-09 22:09:49
b4955fb611ce407ef0e522862c60ae0472dbfe5e...ecc03c1c6db0917c06415ec3c6e1510217e59805,1,1,1,2,1,2008-12-18 06:00:54,2008-12-18 03:34:56
ecc03c1c6db0917c06415ec3c6e1510217e59805...954597bd198f31e66ac39bea60cfdb8d1ced858c,1,1,0,1,1,2008-12-18 06:01:20,2008-12-17 08:20:25
dcbe0bd0d4f68735e4a8809dc9fc597ce6502a8e...ff3c0ff20e2c0b2c78d2c2da9ce4eb0739ff6ced,1,3,1,4,1,2008-12-02 23:28:36,2008-12-02 22:57:28
ff3c0ff20e2c0b2c78d2c2da9ce4eb0739ff6ced...1a66a489d09e7b8629fa7e4184c78703f4eed335,2,20,3,23,4,2008-12-02 23:29:12,2008-12-02 13:53:47
1a66a489d09e7b8629fa7e4184c78703f4eed335...5413812f0800e5530036671ee55476f2771ab828,2,21,2,23,3,2008-12-02 23:29:12,2008-12-02 13:53:51
5413812f0800e5530036671ee55476f2771ab828...46059cc63259f7a3d408fc1e52e8da9d37dc49ff,4,31,1,32,12,2008-12-02 23:29:12,2008-11-15 12:08:14
46059cc63259f7a3d408fc1e52e8da9d37dc49ff...d404bf0288ac1a2c4276d009c0e1c88519e5a7c9,1,1,0,1,1,2008-12-02 23:29:13,2008-12-01 16:41:50
d404bf0288ac1a2c4276d009c0e1c88519e5a7c9...11920d28da1ac1b65eb4041c1b7355924e5d1366,2,20,0,20,2,2008-12-03 00:13:16,2008-12-02 06:14:55
11920d28da1ac1b65eb4041c1b7355924e5d1366...deb13872becbc5fb49e3ab22dd9feaf4e429a853,1,1,1,2,1,2008-12-03 00:13:16,2008-12-02 08:31:01
ef3b38b445c183b2a07a6360de62908d312ade0f...ee2314f59a4eb8451008d4468fd96bb4e40763dc,1,18,1,19,3,2008-11-26 05:51:05,2008-11-23 21:02:49
f20706220ba788a40b6634255215ccb87accca70...73c427eb99a9bb8a3ade40809194405ddb1fd733,1,6,3,9,2,2008-11-26 17:55:10,2008-11-26 02:55:00
73c427eb99a9bb8a3ade40809194405ddb1fd733...26d6cc555db0144961bcb3537312cc5a7b6d84d1,1,1,1,2,1,2008-11-26 18:09:52,2008-11-26 16:51:01
26d6cc555db0144961bcb3537312cc5a7b6d84d1...c095a1db3095f26092ee2d2a9c606b8b656936af,1,0,11,11,2,2008-11-26 18:47:41,2008-11-26 13:27:10
97a7a82f199f165f85fe39a3c318b18c621e6335...8ee5d73137f355c21e8d4db365ae8d301e067395,5,30,3,33,6,2008-10-13 17:46:03,2008-10-13 09:36:52
8ee5d73137f355c21e8d4db365ae8d301e067395...b0ad11ea165e07308fc02a5091efbe2e2d22237c,2,14,2,16,3,2008-10-17 18:26:20,2008-10-14 22:32:20
97a7a82f199f165f85fe39a3c318b18c621e6335...8409bb3708e1dd7c035617795c49e4ca7e17c56a,1,1,1,2,1,2008-09-16 06:10:23,2008-09-15 16:23:24
8409bb3708e1dd7c035617795c49e4ca7e17c56a...bf55778855c2c95fdc4919a4d42ee68d348b75ef,1,13,10,23,7,2008-09-16 06:11:28,2008-09-15 16:25:22
bf55778855c2c95fdc4919a4d42ee68d348b75ef...f18d244a6356947cf0fb753b43c0d6ac4c7b5637,9,19,19,38,18,2008-09-16 06:11:35,2008-09-13 17:18:36
f18d244a6356947cf0fb753b43c0d6ac4c7b5637...1f5a892e5209be329dda316edb0341066d62e3eb,1,1,1,2,1,2008-09-16 06:11:35,2008-09-13 16:31:31
41f13af558db1018250ade4d99a51f0b76f65bc8...2a79d2f662a5a82a6cfcfd2a0d980e7b1875f320,1,1,1,2,1,2008-09-29 15:13:10,2008-09-29 09:12:04
2a79d2f662a5a82a6cfcfd2a0d980e7b1875f320...b9b378a001d35a64a30a652a45f8084ee2be6cdf,1,7,2,9,3,2008-09-29 15:24:19,2008-09-26 15:33:23
b9b378a001d35a64a30a652a45f8084ee2be6cdf...4a92d1bfb784b09641180d164e7d719080165dc4,2,23,0,23,2,2008-09-29 15:37:07,2008-09-26 22:56:46
4a92d1bfb784b09641180d164e7d719080165dc4...175a494823c1eacd4da9c4a5b90ec0668f7051c0,3,5,49,54,7,2008-09-29 15:37:07,2008-09-26 22:59:14
175a494823c1eacd4da9c4a5b90ec0668f7051c0...94e02e7f3b0504243b364ad04b58332bb1502934,1,1,3,4,1,2008-09-29 15:56:26,2008-09-27 22:24:36
94e02e7f3b0504243b364ad04b58332bb1502934...cbce6c0be30cbaf8c39051f85006d679338a8ddc,1,1,1,2,1,2008-09-29 16:13:20,2008-09-29 16:04:41
09cff066f65361b514dd36b03a822cfb40534f12...5610e3b0315d652d6b8e6535afe0e7e461c8a0a0,1,6,4,10,3,2008-10-20 05:51:17,2008-10-20 05:51:17
db3a95459cb873c302051b4b2b693be5ba248c13...44a68fd526a70f0aaf213143e22f1257f296e724,2,32,3,35,5,2008-09-03 19:32:41,2008-09-03 18:55:55
44a68fd526a70f0aaf213143e22f1257f296e724...bea005e21bf9f4f19d5e2afe538a5ba9123bdbdc,1,4,6,10,2,2008-09-03 19:36:38,2008-09-03 18:07:26
bea005e21bf9f4f19d5e2afe538a5ba9123bdbdc...6b9c42b4daabe3d0471d9f90d2ae472c9d994e1c,1,43,23,66,8,2008-09-03 21:51:10,2008-09-03 19:13:42
6b9c42b4daabe3d0471d9f90d2ae472c9d994e1c...73bae1dc468734bad3ff7d1b8e93e7ac5f9d3dff,3,6,6,12,6,2008-09-03 21:51:19,2008-09-03 08:50:43
15ddb6fab24e7cf848f7a91c59f8d96b6a5cd371...2b36b146fa892a0a326eb2e35a39c9daf58fbe5e,1,1,0,1,1,2008-05-11 17:03:58,2008-05-10 20:52:51
2b36b146fa892a0a326eb2e35a39c9daf58fbe5e...e1645901ed72f82ae55139bbae01eac1bf5899c9,1,1,1,2,1,2008-05-11 17:04:20,2008-05-09 17:12:55
e1645901ed72f82ae55139bbae01eac1bf5899c9...32efcd91c6505ae28f87c0e9a3e2b3c0115017d8,1,2,2,4,1,2008-05-11 17:04:46,2008-05-09 08:05:27
6233a5210ef64ba31bbf0e867e03e9176e0aace9...ee831f7ddfc40e9144208c93e24d20ff0ad69194,3,31,8,39,5,2008-05-06 00:18:20,2008-05-05 07:43:00
ee831f7ddfc40e9144208c93e24d20ff0ad69194...42ba5ee776c00369ca72b76537ae622611a7b545,2,24,2,26,4,2008-05-09 00:50:00,2008-05-07 21:54:28
2d8bed969d5126053abe14ca331d14f287d462f5...278863180a280304d6b7f4ad6f11c1a810463507,1,1,1,2,1,2008-05-04 01:47:18,2008-05-02 14:05:36
8e69d78be3f315ea8c7b96400c0c65763b3e8f00...e46f9c8161a0df4d4b9f8c8a98b1a8c0d9452cfd,1,5,0,5,1,2008-06-30 06:28:44,2008-06-29 20:21:42
e46f9c8161a0df4d4b9f8c8a98b1a8c0d9452cfd...bd870878f81056d4349048842ad774f84461e939,2,2,2,4,2,2008-06-30 06:28:47,2008-06-29 16:10:20
bd870878f81056d4349048842ad774f84461e939...0e047bd14c77859b1a43d477858347f6b233efc0,1,24,16,40,5,2008-06-30 06:28:47,2008-06-29 20:34:26
0e047bd14c77859b1a43d477858347f6b233efc0...f9d800e2074a60a009e7c670e396a379d8c46cc5,1,1,0,1,1,2008-06-30 07:36:39,2008-06-29 20:47:56
c32f76f4d220e5d4d6a599d7a12a50b1e3ceceaf...f26c4940c4c7942a95058d9aaef7b01967085a60,2,154,131,285,12,2008-12-30 08:03:48,2008-12-27 23:03:57
f26c4940c4c7942a95058d9aaef7b01967085a60...64912a67a43dec151906b93f96b07f16e17f71e9,2,31,14,45,4,2009-01-10 06:21:36,2009-01-10 06:21:36
e4df519f05ab20eae235968166a17a5a196bc377...52b8ea934ecd24b52806188b53367aaa6185deb3,1,6,4,10,6,2009-03-01 22:38:17,2009-03-01 22:38:17
eae7d64a2da085d7aed0671149611e417ca794e3...0cc08ff7ddaf4360966bdedf006af041cdf6f7d9,1,26,10,36,13,2009-09-05 12:06:46,2009-09-05 12:06:46
0cc08ff7ddaf4360966bdedf006af041cdf6f7d9...4a3da5d91a4768a8abe6a8c64f1c3a49125a5bcf,1,58,23,81,8,2009-09-07 00:08:21,2009-09-07 00:08:21
4a3da5d91a4768a8abe6a8c64f1c3a49125a5bcf...aa43561ac0c18dd6d200afe3a02e4e6c7e4beeae,1,21,9,30,8,2009-09-10 11:58:40,2009-09-10 11:58:40
3827210b91a7d363ea67bcf0b9c6ee1c91d2f3c5...cca1704897e7fdb182f68d4c48a437c5d7bc5203,1,2,3,5,1,2009-01-02 21:19:40,2009-01-02 18:07:52
e1ca0defd2039aecd7b5a68ed653f8ec40cf509e...a2df1fb2e52a49bf6b17b352581510efd851f337,4,65,0,65,6,2008-11-15 05:38:11,2008-11-13 17:28:49
9f8f132621faedd250fded3e260402623da91a6f...0f3a290b89b89bb5375cf5019b067e4a99f02620,6,14,5,19,10,2008-11-04 08:08:03,2008-10-27 19:51:59
0f3a290b89b89bb5375cf5019b067e4a99f02620...3a5e860815010e362c746aedf7981e9b3b9a69e8,1,9,5,14,7,2008-11-04 08:08:12,2008-11-03 18:45:41
3a5e860815010e362c746aedf7981e9b3b9a69e8...d467a525da28b28a0d8e16a42e121ab638fa7347,3,4,2,6,4,2008-11-04 08:08:19,2008-11-03 19:23:57
d467a525da28b28a0d8e16a42e121ab638fa7347...78892e32616f00bf173496ca0502aff2e523db31,2,28,0,28,4,2008-11-04 08:45:34,2008-11-03 19:25:46
78892e32616f00bf173496ca0502aff2e523db31...30c4d7a76a96cf7a2848b752083364c51b051f30,1,4,0,4,1,2008-11-11 20:55:42,2008-11-10 09:58:15
30c4d7a76a96cf7a2848b752083364c51b051f30...3fcfd662dc84830d25ee966b8d5325806b7c51b2,1,8,0,8,1,2008-11-12 22:23:11,2008-11-10 09:58:17
3fcfd662dc84830d25ee966b8d5325806b7c51b2...7bc2508bfe0f7e8c0371a68f57ac5b7d4fe7e1f0,1,46,2,48,1,2008-11-12 22:28:16,2008-11-12 10:51:28
9f8f132621faedd250fded3e260402623da91a6f...b1a46b70b3dcf139c05160e1420e915358b9f947,3,15,4,19,5,2008-11-03 04:46:52,2008-11-02 17:53:03
b1a46b70b3dcf139c05160e1420e915358b9f947...4471649f44d7a8e4b7b927e43b848bb71b75630d,1,32,9,41,3,2008-11-04 22:43:07,2008-11-04 07:19:53
4471649f44d7a8e4b7b927e43b848bb71b75630d...b0a7d111732f644623253927c9ef2d4f3009e668,1,17,1,18,3,2008-11-04 22:43:16,2008-11-04 07:19:54
e534735a4cd778ac8172f543869a20894c1022a6...e5d3afd78be54fc6e958c7ebad178593fd030441,1,2,1,3,1,2008-08-11 23:48:11,2008-08-11 17:37:46
6991357513bf8bfbb71a4675e271b386cc273476...7bedebcaad351108a8f6eab6a031f2be2c06b613,3,51,6,57,10,2008-07-05 18:22:13,2008-06-27 14:37:15
7bedebcaad351108a8f6eab6a031f2be2c06b613...caf1899699b2255111a3db335553e31f3718c1c9,1,8,7,15,1,2008-07-08 20:59:08,2008-07-08 07:40:56
6991357513bf8bfbb71a4675e271b386cc273476...656b50345239293929ad8c639c5f1941c6b867ad,2,39,1,40,5,2008-07-05 07:39:37,2008-07-03 06:16:05
656b50345239293929ad8c639c5f1941c6b867ad...4a588075c54cd5902e5f4d43b9d6b0c31d0f9769,1,60,0,60,1,2008-07-07 05:58:56,2008-07-06 21:20:10
6991357513bf8bfbb71a4675e271b386cc273476...41872fd573601b123da00294f77d7d4c25db6010,1,16,11,27,12,2008-07-04 08:36:25,2008-07-04 06:43:19
4ace4fc584f48d5b8df957c4462cf5c7c58ab100...2beebd22f4af8788eaf19d811de03191ae6f7c42,5,39,11,50,8,2008-06-25 18:44:15,2008-06-25 05:41:34
2beebd22f4af8788eaf19d811de03191ae6f7c42...df79b9fdb863648fe27771ac373adb665cab066e,1,1,1,2,1,2008-06-25 19:44:32,2008-06-25 08:26:55
df79b9fdb863648fe27771ac373adb665cab066e...e636106c76e0273334940d899de1c928d08b29e8,3,35,6,41,7,2008-06-26 00:13:48,2008-06-26 00:09:40
73f03627f4f1b0f66b30fa96a25537f3600cce0b...8c6cfcddce80381a61a4cc0460ca497a271bfbff,1,10,5,15,4,2008-06-23 01:02:28,2008-06-21 23:54:36
8c6cfcddce80381a61a4cc0460ca497a271bfbff...ab7367929f69c8b0f2f59d89225f211253ff57ef,1,34,9,43,15,2008-06-23 01:02:28,2008-06-21 23:55:50
73f03627f4f1b0f66b30fa96a25537f3600cce0b...9022a495a3c407859560d4ac4a278c0d6ad58837,1,26,31,57,13,2008-06-22 07:44:26,2008-06-22 06:28:58
9022a495a3c407859560d4ac4a278c0d6ad58837...a1b32fdc3d1d05395f186bfa06e92174519dab8d,1,5,0,5,1,2008-06-22 07:54:40,2008-06-22 07:21:28
a1b32fdc3d1d05395f186bfa06e92174519dab8d...51e0d0a67b8d31e92d52e15b577afb079359ec63,1,9,10,19,3,2008-06-22 07:54:40,2008-06-22 07:27:46
51e0d0a67b8d31e92d52e15b577afb079359ec63...7f8365f894d60f240edd356f32e3c1bda994ed41,1,3,3,6,1,2008-06-22 09:03:26,2008-06-22 09:03:26
7f8365f894d60f240edd356f32e3c1bda994ed41...121c813f8d6054dbee25c03301599c0f8d645d7f,3,52,0,52,9,2008-06-22 09:06:58,2008-06-22 09:04:31
8cb560fc470ee0d94e188d4e9deb14b0c8ac7a91...8cbd4310821ea2957d32a36c34fa314cf99ca9f3,1,3,27,30,2,2008-07-02 22:31:12,2008-07-02 21:59:16
8cbd4310821ea2957d32a36c34fa314cf99ca9f3...0beee4c6dec15292415e3d56075c16a76a22af54,1,0,89,89,2,2008-07-02 22:31:29,2008-07-02 21:59:44
0beee4c6dec15292415e3d56075c16a76a22af54...ac083c47ea226b470afab39d975e718a475a3c78,3,187,0,187,7,2008-07-02 22:31:49,2008-07-02 22:00:00
74b1e1235781bbe5c90b802c1551446a5f5d69f1...dfc8f39e4346d000052c39ef7cb6bfe8fdb48c51,2,81,5,86,3,2008-06-26 01:16:36,2008-06-26 01:16:36
74b1e1235781bbe5c90b802c1551446a5f5d69f1...87412ec1f17bc2705595ebabc010d94cb46478b7,1,7,0,7,1,2008-06-25 18:05:26,2008-06-25 16:08:15
a567fdcb016e8e882ec0a1e044c9caac8f70e693...e423ffd8a6f46a14ecbb637d909290bd3579cebd,3,11,3,14,5,2009-01-07 07:18:20,2009-01-06 18:53:32
e423ffd8a6f46a14ecbb637d909290bd3579cebd...c6dbca08ca39d9cd511a36cdd18847b8720f1653,1,7,7,14,2,2009-01-07 07:40:02,2009-01-06 23:56:03
c6dbca08ca39d9cd511a36cdd18847b8720f1653...a324fc45e4d04e3b879cd2d9a603d73ca696b775,1,3,1,4,2,2009-01-07 20:04:38,2009-01-07 11:15:30
769b008e0eaef6876e68c65538f81f841b53cb8e...67faaaba8338cf59c212ce5239eeb223a77acdf0,1,46,7,53,14,2008-10-14 00:05:45,2008-10-14 00:05:45
fe60dff744aa9fc7440de0a521e8be71ec35a059...69530cb0c0d5f08dac9bedff56c164b7370f9931,1,42,11,53,5,2008-11-29 02:41:21,2008-11-29 02:41:21
69530cb0c0d5f08dac9bedff56c164b7370f9931...388b2acd6e649145d4368a10cf4df5f5bbbac2c2,4,7,4,11,5,2008-11-29 03:58:24,2008-11-29 03:55:25
388b2acd6e649145d4368a10cf4df5f5bbbac2c2...331fcb598ec0127fd89c992361bc573dcd3a4a63,5,45,5,50,6,2008-12-01 01:59:19,2008-11-29 03:56:34
c4f6a48969b33e7fec8fce592e38a60849782d2a...749bc58c5eab5b6947d2c01e02d12320005eba99,1,2,4,6,2,2008-10-09 15:55:42,2008-10-09 00:11:24
799fdb4ed0f9443122fdb85f6f73c58cb1de12ec...70d7099916c9621e157c620f9cc7fc982f109c55,1,2,0,2,2,2009-12-30 09:22:27,2009-12-30 09:02:53
891182f9141326fd6833d3651b89860a0b41f153...93197898041fcaf84d8ac84df764cca7bf86b226,2,2,2,4,2,2009-08-28 03:41:48,2009-08-28 03:18:49
456cb4cf3ef6e3dec637b7061b0c834b62eba0f5...40bad52d7d559177e373127f50c7bb3a19d56d85,1,26,14,40,9,2009-06-02 15:11:30,2009-06-02 14:57:39
40bad52d7d559177e373127f50c7bb3a19d56d85...8dc3a47c3edcee923225000e93f8052c50e5a004,1,0,1,1,1,2009-06-03 07:11:15,2009-06-02 21:34:27
8dc3a47c3edcee923225000e93f8052c50e5a004...a9b2d42486ee0b461220bf3895114926d9ddf9be,2,33,8,41,3,2009-06-03 07:49:34,2009-06-03 07:43:22
076c32370d8a6ac2fb57b2a55c674942e106f8ab...5acb3e5012966cc11e54f50e0592b3639bade02c,1,1,1,2,1,2009-05-17 19:05:22,2009-05-17 10:47:02
a9d29038a7acc0d37f801a2a923826a3539f4ae6...3be7e06713462110f0ff15f54f864b5ecf646814,1,6,11,17,1,2009-05-29 07:53:43,2009-05-26 06:15:47
33fd7169ed6658e898b414a66aefaad16b404ec5...0620b39b3b7b1f27bf863d9591fd8146a9a8931d,5,102,0,102,19,2009-06-01 00:56:44,2009-05-31 08:35:50
0620b39b3b7b1f27bf863d9591fd8146a9a8931d...e1c068869216c8c231c1585bbfa9fda42b4756f8,5,37,0,37,7,2009-06-01 00:57:59,2009-05-31 08:35:51
e1c068869216c8c231c1585bbfa9fda42b4756f8...003b33a8ad686ee4a0d0b36635bfd6aba940b24a,4,38,1,39,6,2009-06-01 00:57:59,2009-05-31 08:35:52
33fd7169ed6658e898b414a66aefaad16b404ec5...efc07debaf60f5aa81bef78dc3219962ba88c3b8,1,1,1,2,1,2009-05-29 06:55:14,2009-05-28 02:17:05
efc07debaf60f5aa81bef78dc3219962ba88c3b8...70cf991093d4ab8854de0090aca9cf8d10ebd8f8,1,10,1,11,4,2009-06-06 20:16:46,2009-06-05 23:36:10
70cf991093d4ab8854de0090aca9cf8d10ebd8f8...309dbc82e39ea0b402ea06579fd9246df5cf6a01,2,2,2,4,2,2009-06-06 20:21:05,2009-06-05 23:36:12
309dbc82e39ea0b402ea06579fd9246df5cf6a01...4cb18a49dfd37f9ecabad603d845382863513378,1,14,1,15,1,2009-06-06 20:21:10,2009-06-05 23:36:13
4cb18a49dfd37f9ecabad603d845382863513378...b213019c00740289997f12e5f53b1baae588ac8a,1,1,1,2,1,2009-06-06 20:21:49,2009-06-05 23:36:14
b213019c00740289997f12e5f53b1baae588ac8a...0e0aea5a47b675ab2dca9c77180b8fe9bc6bdeec,2,16,0,16,5,2009-06-06 20:21:51,2009-06-05 23:36:15
0e0aea5a47b675ab2dca9c77180b8fe9bc6bdeec...a7a24ee7e0721db5427e9a5f6906e8531510d607,1,10,0,10,1,2009-06-06 20:21:52,2009-06-05 23:36:16
a7a24ee7e0721db5427e9a5f6906e8531510d607...203ee91fd273ae424deeeee5ddcc7947a4c76ccd,1,1,1,2,1,2009-06-09 04:16:18,2009-06-08 23:53:48
203ee91fd273ae424deeeee5ddcc7947a4c76ccd...61dbb3c4415169194d9351cc4b68dd88788a93c5,2,31,4,35,4,2009-06-10 07:02:20,2009-06-08 16:41:49
61dbb3c4415169194d9351cc4b68dd88788a93c5...8fccb009fa539080a6c4fb18204dfea0be434433,2,10,0,10,2,2009-06-10 07:08:07,2009-06-07 05:40:29
33fd7169ed6658e898b414a66aefaad16b404ec5...a5a6755a1d4707bf2fab7752e5c974ebf63d086a,1,33,4,37,4,2009-05-29 06:04:50,2009-05-27 09:25:16
a5a6755a1d4707bf2fab7752e5c974ebf63d086a...15ced753ac091314941abb28302f7109a9e86b81,1,39,1,40,1,2009-05-29 06:06:34,2009-05-27 21:20:12
15ced753ac091314941abb28302f7109a9e86b81...c574e683b587ee3c302317e4fa9c83cd4605cd82,1,57,0,57,1,2009-05-29 06:07:43,2009-05-27 09:25:18
33fd7169ed6658e898b414a66aefaad16b404ec5...b510df8af2c86d441de87fa4be09f786b5411527,2,61,3,64,4,2009-05-28 07:57:07,2009-05-28 07:56:23
33fd7169ed6658e898b414a66aefaad16b404ec5...94ad2437020038b022ce19b8b8b35f1cc86b16f6,1,51,3,54,4,2009-05-27 05:22:47,2009-05-25 19:13:54
94ad2437020038b022ce19b8b8b35f1cc86b16f6...d7107ca65f79c2d95bc327bee44c09073b4de631,1,11,13,24,3,2009-05-27 07:01:28,2009-05-26 05:56:03
d7107ca65f79c2d95bc327bee44c09073b4de631...3902985a58d5b5f42406f11f1c8b9b87a98c7e3c,1,149,127,276,27,2009-05-27 07:06:12,2009-05-26 06:17:14
b5227d80aee5173bfda6aa43a890d03110b0df26...500348aa6859e436a890f5f5a7e0eeea8ef6c1de,3,20,2,22,4,2009-10-30 21:41:29,2009-10-30 19:05:52
0871984d304c9201b85897743eae583cd165106d...a22347c6c866c94e9e941b1b39d57ea43218af96,1,14,11,25,10,2009-05-18 06:17:35,2009-05-17 15:36:44
a22347c6c866c94e9e941b1b39d57ea43218af96...836a3fd5b0c439642268fd1299cd16729f15e614,2,22,0,22,2,2009-05-18 06:19:32,2009-05-17 15:36:45
836a3fd5b0c439642268fd1299cd16729f15e614...2d938fc7bcf2c8ce314c44955db5a4dd2e9b6adb,2,23,44,67,13,2009-05-18 06:29:17,2009-05-17 15:36:46
4481ff048df4c86021d783de6f099909495f04ff...b6f0621a462e4ff11999c8e2d8279c0ffd3be201,5,27,6,33,8,2009-05-24 18:21:05,2009-05-24 00:24:41
6207011ae3fe813159e92762e86f33c9bd42cd7f...3e1629f5a6c832941cc329c381de8b88ea775cb6,1,1,1,2,1,2009-05-09 06:57:29,2009-05-07 08:08:19
3e1629f5a6c832941cc329c381de8b88ea775cb6...ac9f71cf766ab1affdfc4d4c4b58238bf9c76700,1,3,2,5,2,2009-05-09 07:19:25,2009-05-06 22:57:08
ac9f71cf766ab1affdfc4d4c4b58238bf9c76700...718135e3b6b5317f763477f5b0f408d888d79a8e,1,9,2,11,3,2009-05-09 07:27:39,2009-04-29 21:40:50
718135e3b6b5317f763477f5b0f408d888d79a8e...ec00d6e0038e030cf73182374e21025c2776cb23,1,1,1,2,1,2009-05-09 08:28:08,2009-05-07 12:04:08
6207011ae3fe813159e92762e86f33c9bd42cd7f...5a0e4a2a326966aabb566164a7571291e34adabd,2,60,1,61,2,2009-05-09 04:57:02,2009-05-09 04:56:57
329484256e0fe42676e93669122e7a5a007ef4ed...42b491786260eb17d97ea9fb1c4b70075bca9523,4,86,6,92,11,2009-06-03 07:09:16,2009-06-02 22:59:12
d1c8c0c8c42912eb768a05115c798de50e595f8b...6ffd567bec439e7809ee0966556bd5e72fb78de4,1,1,1,2,1,2009-04-30 01:37:58,2009-04-29 21:27:54
d1c8c0c8c42912eb768a05115c798de50e595f8b...fc71db39e0d75e8a403f36f3fecf4450886cd165,2,22,0,22,2,2009-04-30 01:37:41,2009-04-29 21:21:46
fc71db39e0d75e8a403f36f3fecf4450886cd165...691f1a28bf57618d8b44a193b1d28013c858aba6,23,44,49,93,41,2009-04-30 01:37:41,2009-04-29 21:22:56
691f1a28bf57618d8b44a193b1d28013c858aba6...f6a5f1bb509a3af182fe568135398f1f2be15e5d,1,2,1,3,1,2009-04-30 01:37:42,2009-04-29 21:24:52
b0de55541024a39ece47cf7a1eebdbde08ba978f...389d17677187f5e996022b7b8e0faf800608cb3a,1,1,1,2,1,2009-03-24 23:58:20,2009-03-24 23:10:35
636991be2d2ce8368cd6735473954b1ebfa989bf...46d164b0cd1d5d254047d7573c53e368e42bf5e5,2,36,0,36,3,2009-03-23 04:32:13,2009-03-23 02:14:01
46d164b0cd1d5d254047d7573c53e368e42bf5e5...6df514af9dfb44f104baa9b581e91de22af89b8d,1,33,65,98,13,2009-03-23 04:33:04,2009-03-23 02:14:02
6df514af9dfb44f104baa9b581e91de22af89b8d...cd2ef591c8e753fe5295ac3c6f1dee481f00a185,1,39,28,67,17,2009-03-23 04:37:56,2009-03-23 02:14:03
cd2ef591c8e753fe5295ac3c6f1dee481f00a185...6fa8e6278b210bfa56fcb54ed38d2b485350e7c6,3,26,24,50,4,2009-03-23 04:42:05,2009-03-23 02:14:04
6fa8e6278b210bfa56fcb54ed38d2b485350e7c6...108dab2811701c20d6d6e8d9fe8af88e41d65d77,14,112,44,156,51,2009-03-23 04:45:19,2009-03-23 02:14:05
108dab2811701c20d6d6e8d9fe8af88e41d65d77...747e25050bfef8f3a7c882954b654cf6d97fc63e,2,171,1,172,2,2009-03-23 04:46:02,2009-03-23 02:14:06
747e25050bfef8f3a7c882954b654cf6d97fc63e...b09b868f7fee689483d00bea3d52c0f14a80386c,1,5,10,15,2,2009-03-27 08:10:27,2009-03-27 00:13:01
b09b868f7fee689483d00bea3d52c0f14a80386c...871d21d42e0f782b7cb111beec8c252e9aa627ff,1,4,2,6,2,2009-04-01 18:05:31,2009-03-31 23:24:38
636991be2d2ce8368cd6735473954b1ebfa989bf...26284f9356f4c4d8865db8bb024121311a1f90ff,1,2,1,3,1,2009-03-23 00:13:08,2009-03-22 22:07:33
2d20b7ebf672c28b18da4558d96f100613e4e4ca...dfab7c144eb2f02fc1481173422ecc416a060155,2,18,2,20,5,2009-02-15 08:57:43,2009-02-14 09:52:14
f6b98e46bdf64454d7c6ab76d617237118799d7b...60b458b7d31ff2497ed90cbe9f65444d84882cec,1,24,20,44,10,2009-02-10 04:59:26,2009-02-09 20:54:04
60b458b7d31ff2497ed90cbe9f65444d84882cec...148bc06b9101042342a89454a003998fc0e1ded3,1,24,22,46,9,2009-02-10 04:59:26,2009-02-09 20:54:05
148bc06b9101042342a89454a003998fc0e1ded3...571998921d8fd4ee674545406aabb86987921252,10,23,20,43,18,2009-02-10 04:59:26,2009-02-09 20:54:06
571998921d8fd4ee674545406aabb86987921252...7847892716a3c9a7b8facc076fc056ac425bcfe6,3,67,24,91,7,2009-02-10 04:59:26,2009-02-09 20:54:07
7847892716a3c9a7b8facc076fc056ac425bcfe6...81a9aa60a193f1181149b69920930e15c4e34059,1,14,9,23,4,2009-02-10 04:59:26,2009-02-09 20:54:08
81a9aa60a193f1181149b69920930e15c4e34059...4857c761e35b07c12ff2ef1140e93b071b8ac4e7,1,30,45,75,9,2009-02-10 04:59:26,2009-02-09 20:54:50
4857c761e35b07c12ff2ef1140e93b071b8ac4e7...e4c7292353dbef39feac1c6a60c5cde9140520a6,1,9,3,12,4,2009-02-10 04:59:26,2009-02-09 20:54:51
e4c7292353dbef39feac1c6a60c5cde9140520a6...91fcbcbdcdd845bd43104c5ac0af4c40da15223b,1,1,3,4,1,2009-02-10 04:59:26,2009-02-09 20:54:52
91fcbcbdcdd845bd43104c5ac0af4c40da15223b...7734f04873cfaddd0b148074a633f1f824fd961f,1,23,0,23,6,2009-02-10 04:59:26,2009-02-09 20:54:53
7734f04873cfaddd0b148074a633f1f824fd961f...36419c8ee41cecadf67dfeab2808ff2e5025ca52,3,22,3,25,4,2009-02-19 01:11:21,2009-02-18 22:18:03
36419c8ee41cecadf67dfeab2808ff2e5025ca52...8cd6192e16d8bf590afa1105c840b72106d72941,1,2,2,4,2,2009-02-20 05:27:14,2009-02-19 20:08:28
8cd6192e16d8bf590afa1105c840b72106d72941...fba2f38a2c2cda458e490c18e0afbb12cbd37969,3,65,19,84,16,2009-02-20 05:39:48,2009-02-19 20:08:29
fba2f38a2c2cda458e490c18e0afbb12cbd37969...1dcafcc0e639ecc69b54421bda5f2270ed2601eb,1,1,1,2,1,2009-02-20 05:39:51,2009-02-19 20:08:30
1dcafcc0e639ecc69b54421bda5f2270ed2601eb...e1afca4fd3e7cb4000874e991277f10119de4ad2,2,11,3,14,4,2009-02-24 02:04:20,2009-02-23 18:02:57
e1afca4fd3e7cb4000874e991277f10119de4ad2...c06ff4908bf9ad8bf2448439a3574321c9399b17,5,22,30,52,15,2009-03-08 04:25:16,2009-03-04 17:47:40
c06ff4908bf9ad8bf2448439a3574321c9399b17...110c46a909fe27f5b8aff412a78cb821300fb985,2,3,3,6,3,2009-03-08 21:04:39,2009-03-08 20:51:33
110c46a909fe27f5b8aff412a78cb821300fb985...c567383b1e3205c895b371d42a39fbdf131032ba,2,12,0,12,5,2009-03-08 21:04:41,2009-03-08 20:04:28
c567383b1e3205c895b371d42a39fbdf131032ba...d7371a2d4d308d961d22c12ae9bc3d28cf35f029,1,3,0,3,1,2009-03-08 21:58:04,2009-03-08 21:22:51
d7371a2d4d308d961d22c12ae9bc3d28cf35f029...5bcf109cdf7f7b676600883be8dc7dbf26ddb055,2,3,3,6,2,2009-03-15 19:56:40,2009-03-15 11:38:55
5bcf109cdf7f7b676600883be8dc7dbf26ddb055...381b920b8ac1440962f340cba9030e2dc3130c49,1,0,23,23,6,2009-03-17 19:10:58,2009-03-17 18:20:29
621f1b4bcf40f1469fc59202248df35619e33c82...9aad6cbaef3c459ff4953f5a22bbbc7abfc72800,1,2,1,3,1,2009-02-08 21:06:33,2009-02-08 17:40:39
9aad6cbaef3c459ff4953f5a22bbbc7abfc72800...3021faf6562690658d0b9f9fdd7cbe8c9dd61628,1,2,1,3,1,2009-02-09 05:21:28,2009-02-06 04:40:53
3021faf6562690658d0b9f9fdd7cbe8c9dd61628...3ec7371f63046aa6d8e13ddeb1eaa9cccfbf2aa2,1,12,1,13,2,2009-02-09 05:40:52,2009-02-09 05:40:42
3ec7371f63046aa6d8e13ddeb1eaa9cccfbf2aa2...ffe4da1573835806f1c931fc204264f76618aae2,1,7,7,14,7,2009-02-09 05:42:17,2009-02-07 22:21:49
ffe4da1573835806f1c931fc204264f76618aae2...cf9957875c3a27b6ae4593e1fa9d4dabbde68433,1,1,1,2,1,2009-02-09 06:07:46,2009-02-06 16:05:37
cf9957875c3a27b6ae4593e1fa9d4dabbde68433...a9ee90d7ff9f3854b3096b4abbdc2013708704f5,1,5,5,10,1,2009-02-09 06:07:49,2009-02-06 16:05:38
621f1b4bcf40f1469fc59202248df35619e33c82...3bec8ff99a7792cae67aaeb5892d832478d7f548,2,18,1,19,4,2009-02-08 21:02:34,2009-02-07 21:53:00
3bec8ff99a7792cae67aaeb5892d832478d7f548...4b951b7eb0a4abf7db301bc6dbf8a0cf1b0057d0,1,3,3,6,3,2009-02-22 04:35:43,2009-02-21 00:48:53
4b951b7eb0a4abf7db301bc6dbf8a0cf1b0057d0...414f2e5337b0b78a47f021cb734e9ba4934c0b28,1,3,6,9,3,2009-02-22 04:35:48,2009-02-21 00:48:54
621f1b4bcf40f1469fc59202248df35619e33c82...ccb04f99fe3858bae0f06fc7aeefc4d53fec1352,1,1,1,2,1,2009-02-07 20:50:49,2009-02-06 09:12:41
621f1b4bcf40f1469fc59202248df35619e33c82...f3670a5749d704fe1edee4201f9b23adbf0bf967,2,26,1,27,4,2009-02-07 20:49:50,2009-02-07 13:43:03
f3670a5749d704fe1edee4201f9b23adbf0bf967...496917b721adae11e596cd44b13cb8a49c388de7,2,8,1,9,2,2009-02-07 20:49:58,2009-02-07 13:43:15
621f1b4bcf40f1469fc59202248df35619e33c82...d3bee161fef7820e83b44b899c531228a5546e87,4,32,9,41,4,2009-02-07 20:14:34,2009-01-25 00:52:05
29a1f99b4b81cd28163de1275265234c5ab804b4...0cf8581e330e7140c9f5c94a53d441187c0f8ff9,3,173,5,178,15,2008-08-31 02:57:55,2008-08-30 14:52:24
0cf8581e330e7140c9f5c94a53d441187c0f8ff9...eac5a401512181cd315a1031af2b8a25430e335a,3,72,48,120,13,2008-09-01 03:09:21,2008-09-01 02:32:40
eac5a401512181cd315a1031af2b8a25430e335a...70a3f89733a4cd21631690ba980598fea2249067,1,65,0,65,1,2008-09-01 03:36:32,2008-09-01 03:36:32
70a3f89733a4cd21631690ba980598fea2249067...3407a7a9e67b165902be85b0807e9ea789b3c67d,1,4,4,8,2,2008-09-04 22:14:17,2008-09-04 21:48:48
8fdcf3125465f70c0cad5be5ab192d46e46307c7...db9410990ee41f2b253763621c0023c782ec86e2,3,59,24,83,13,2008-08-31 02:16:12,2008-08-30 14:46:55
db9410990ee41f2b253763621c0023c782ec86e2...38901a48375952ab6c02f22bddfa19ac2bec2c36,3,72,3,75,11,2008-08-31 02:28:45,2008-08-30 14:48:18
47a528ad24185133867ebb5bb7692db2cb8bef39...05207a28818623e417b69f337a9e8604d799d09d,5,14,14,28,12,2008-09-09 15:41:29,2008-09-09 10:28:30
de5d560c99c96e2955fb4d1d8a8fa6b469926292...5f0bdf50c2eb640b4321acb9b34b3cb401f5ddfb,1,5,1,6,1,2008-09-04 05:35:32,2008-09-02 21:10:15
de5d560c99c96e2955fb4d1d8a8fa6b469926292...ff2549dc9af3fffa8a8285418601d9eab94de7b7,1,10,0,10,6,2008-09-04 03:41:47,2008-08-26 17:11:44
ff2549dc9af3fffa8a8285418601d9eab94de7b7...f88d225feb117f0429540da90b2552e198fa2e82,2,7,4,11,5,2008-09-04 05:37:03,2008-09-03 00:28:59
27f64962f1a573126c0e85cb7c83aa75b669ce07...5359fde8a4df60f9a2898dcfd2b4fcda02df4708,1,22,0,22,3,2008-12-01 02:33:20,2008-12-01 02:33:20
832e719d79296f1942a2aca5fb067bc610986fc4...ee5391c73efaf6dea06f769157fa1650d0bdce31,1,4,0,4,2,2008-11-09 05:29:22,2008-09-12 16:22:44
ee5391c73efaf6dea06f769157fa1650d0bdce31...7c181d627c136cbc67ef0f722e74e34017e662f0,1,5,6,11,3,2008-11-09 05:29:22,2008-11-09 01:33:50
379f84b8d19b5412aff5b9d6bd7bb1ada37b9353...e27430e777edeb777cdd02a777e1e3a4608a0b41,1,1,1,2,1,2009-03-20 21:44:28,2009-03-20 07:48:55
c0ceb2c32d40c4bc835597105ba0c0fac4ae36ba...32738edfca29d819939196c65aecc1979ed23aa9,1,6,0,6,1,2008-12-18 17:55:53,2008-12-18 17:11:18
32738edfca29d819939196c65aecc1979ed23aa9...0956a6db7ae3a93c7bce62c1e3a6e0795055ad9f,1,2,1,3,1,2008-12-18 17:58:40,2008-12-18 16:56:51
0956a6db7ae3a93c7bce62c1e3a6e0795055ad9f...ec9f0ea3e6ecf1237223dec8428e7bb73d339320,4,9,11,20,9,2008-12-19 19:55:33,2008-12-19 12:14:52
9b3b7fd8072783e2ec20b3cf622713d39b1c8af4...757c7f60a78004fc3d0ea62f44320d54ef430c10,1,6,6,12,4,2008-12-03 00:54:01,2008-12-02 00:56:09
d5cbdba843cdd61100933a00c3cfecfb71e9761b...8d2dbbac21bbb76af29133331e2a88870d93899d,1,7,7,14,7,2008-12-01 02:15:51,2008-11-29 20:53:41
8d2dbbac21bbb76af29133331e2a88870d93899d...a7c5a283509f6a70753c90393dfad016312b8822,1,23,23,46,23,2008-12-01 02:15:52,2008-11-29 21:02:08
a7c5a283509f6a70753c90393dfad016312b8822...25b2790fff5b7b484f1a2f40fafa4b24db1506a2,1,36,20,56,21,2008-12-01 02:15:52,2008-11-29 21:07:29
1f5a892e5209be329dda316edb0341066d62e3eb...7d20e2189e19f51662353ea853891e00882d29cc,1,15,8,23,2,2008-09-22 16:29:37,2008-09-22 08:57:51
1f5a892e5209be329dda316edb0341066d62e3eb...45e7ca0f0e1042c26d56b578165365c3f70c0121,1,28,27,55,17,2008-09-19 02:58:29,2008-09-18 22:40:48
45e7ca0f0e1042c26d56b578165365c3f70c0121...a013585b20ac757b0e75a72181ffa44674f35235,3,15,12,27,10,2008-09-19 03:06:23,2008-09-18 22:42:48
a013585b20ac757b0e75a72181ffa44674f35235...45d9414fa5599b41578625961b53e18a9b9148c7,3,8,3,11,4,2008-09-19 03:06:31,2008-09-18 22:44:33
1f5a892e5209be329dda316edb0341066d62e3eb...903e09a3ecca8941b32bae08b821545941591348,2,13,2,15,2,2008-09-18 17:49:03,2008-09-18 07:32:37
903e09a3ecca8941b32bae08b821545941591348...dd9da51fe261f723d206fdd5e4874c25937d1b87,2,18,13,31,2,2008-09-19 02:20:34,2008-09-14 21:14:15
dd9da51fe261f723d206fdd5e4874c25937d1b87...ad0a82bae0e08819520ab7442dd3a7eb7532bbe6,3,235,13,248,4,2008-09-19 02:21:40,2008-09-14 21:14:16
ad0a82bae0e08819520ab7442dd3a7eb7532bbe6...61aeeefd296249b4a78421048adbd78d9fab474a,2,17,0,17,5,2008-09-19 02:27:16,2008-09-07 03:18:18
61aeeefd296249b4a78421048adbd78d9fab474a...c882c01ef9c5a82c1282fd1cb094bb8f97472d7d,1,9,9,18,5,2008-09-19 02:44:47,2008-09-17 06:20:39
c882c01ef9c5a82c1282fd1cb094bb8f97472d7d...53c3967647f79f1563d028d442f81cabba451ca6,1,1,1,2,1,2008-09-19 02:48:19,2008-09-05 18:26:29
53c3967647f79f1563d028d442f81cabba451ca6...f1265cc9ff977b497d805245dbd2454e46ef2710,1,46,0,46,1,2008-09-19 02:49:06,2008-09-18 20:01:13
f1265cc9ff977b497d805245dbd2454e46ef2710...b99b5b40cffb5269e4aa38b6b60391b55039e27d,2,3,1,4,2,2008-09-19 02:49:28,2008-09-18 20:01:20
b99b5b40cffb5269e4aa38b6b60391b55039e27d...e32c0a9c38a126c9eb8ff8f2fdc1fb8875400bbe,1,3,1,4,1,2008-09-19 02:51:13,2008-09-18 22:24:46
5610e3b0315d652d6b8e6535afe0e7e461c8a0a0...a672ea6ac5a1b876bc7adfe6534b16fa2a32c94b,2,29,3,32,3,2008-10-21 20:20:03,2008-10-21 01:17:07
a672ea6ac5a1b876bc7adfe6534b16fa2a32c94b...031e6c898f61db1ae0c0be641eac6532c1000d56,1,6,9,15,4,2008-10-21 20:37:42,2008-10-21 20:37:42
32efcd91c6505ae28f87c0e9a3e2b3c0115017d8...b7893cde53eb2834deb16820eccb709d2636b81b,1,4,3,7,1,2008-05-14 18:47:03,2008-05-14 18:30:55
66037991d3fd2ac7e699c7bd21d939b9e397f6a4...c4730f35cc6507bc117a08885d88668fe02b1a7d,3,61,1,62,7,2008-07-02 01:04:28,2008-06-30 23:44:47
c4730f35cc6507bc117a08885d88668fe02b1a7d...8ee4a6c2ec6738cfbc815dc59e44825f2a9b9f15,2,15,4,19,5,2008-07-02 22:28:22,2008-07-02 22:28:22
8ee4a6c2ec6738cfbc815dc59e44825f2a9b9f15...f55638874774acc1e13a046353449ebc8734ab08,3,12,8,20,8,2008-07-07 02:33:08,2008-07-07 01:36:01
66037991d3fd2ac7e699c7bd21d939b9e397f6a4...dc87183189b54441e315d35d48983d80ab085299,5,33,45,78,19,2008-07-01 09:35:49,2008-06-30 07:37:47
66037991d3fd2ac7e699c7bd21d939b9e397f6a4...be612c2318e87a9d32a385c7684459e9e0cd6227,1,72,0,72,1,2008-07-01 07:48:17,2008-06-30 18:50:44
66037991d3fd2ac7e699c7bd21d939b9e397f6a4...0989fe9623dc8d98033f6acdcc0c84ec28571b19,3,55,53,108,3,2008-07-01 05:45:50,2008-06-27 16:21:54
0989fe9623dc8d98033f6acdcc0c84ec28571b19...653194758ee338b7c87d011007c532ed5cf68d45,3,9,8,17,3,2008-07-01 05:45:50,2008-06-27 16:21:55
653194758ee338b7c87d011007c532ed5cf68d45...fbca58373291afa07c5b30ab562d36ce0f6174e0,3,32,19,51,11,2008-07-01 05:45:50,2008-06-27 16:21:56
fbca58373291afa07c5b30ab562d36ce0f6174e0...b2eabcc2539c021ea6cb2d1d2d28c8213986a186,1,129,0,129,1,2008-07-01 05:45:50,2008-06-29 14:51:38
b2eabcc2539c021ea6cb2d1d2d28c8213986a186...e46bbcf6e89e4b1d3d8de1d20d836538ab0f0c85,3,33,24,57,4,2008-07-01 05:45:51,2008-06-27 16:21:58
e46bbcf6e89e4b1d3d8de1d20d836538ab0f0c85...0b9a969e0fbb0a09e9de931cfe27005cbfd6cb7d,2,92,66,158,35,2008-07-01 05:45:51,2008-06-27 16:21:59
0b9a969e0fbb0a09e9de931cfe27005cbfd6cb7d...5240c9d75d8e1b747da427ba6320432d3201168a,2,28,0,28,2,2008-07-01 05:45:51,2008-06-27 16:22:00
5240c9d75d8e1b747da427ba6320432d3201168a...5948e2ae27d936f7737f4d7433ca6c0b879fe4c8,1,52,0,52,1,2008-07-01 05:45:51,2008-06-27 17:06:26
5948e2ae27d936f7737f4d7433ca6c0b879fe4c8...6a938648e1454842157b84408acbb6471ec6745f,1,38,18,56,12,2008-07-01 05:45:51,2008-06-27 16:22:02
6a938648e1454842157b84408acbb6471ec6745f...98cf9c3bd7504d36e6049939bf9cc624f2cf5b9f,2,47,0,47,2,2008-07-01 05:45:51,2008-06-27 16:22:03
98cf9c3bd7504d36e6049939bf9cc624f2cf5b9f...f4022fa33f1b0a63029d1bc3748f01f720151218,1,63,0,63,1,2008-07-01 05:45:51,2008-06-27 16:22:06
f4022fa33f1b0a63029d1bc3748f01f720151218...c1fb35b98aa36ce789c60520028d95e5f9fee43c,1,37,0,37,1,2008-07-07 02:22:49,2008-06-27 16:22:07
c1fb35b98aa36ce789c60520028d95e5f9fee43c...7b9c0a69a5f64fffb5de8b49a96f41ac35b4a84f,2,45,30,75,9,2008-07-07 02:23:00,2008-07-01 02:37:49
7b9c0a69a5f64fffb5de8b49a96f41ac35b4a84f...1c6669351a47c834cceb75d6044a1aae259fc69f,1,7,7,14,5,2008-07-07 02:23:00,2008-07-05 14:23:58
1c6669351a47c834cceb75d6044a1aae259fc69f...1c7b76be7d620bbaf2e6b8417f04012326bbb9df,6,1157,2,1159,6,2008-07-08 00:50:01,2008-07-07 17:24:20
1c7b76be7d620bbaf2e6b8417f04012326bbb9df...4393c2374101fef9053643f9b4ec638b05bd0b26,2,9,0,9,3,2008-07-10 08:05:47,2008-07-10 07:50:59
4393c2374101fef9053643f9b4ec638b05bd0b26...8ec0dd66fa277615fe79ad10096d81edb263d6d1,1,4,0,4,1,2008-07-13 20:49:10,2008-07-12 18:42:10
8ec0dd66fa277615fe79ad10096d81edb263d6d1...3f4d1c639347317788f2c5080f89de53772499ce,1,46,0,46,1,2008-07-13 20:49:31,2008-07-12 22:33:35
3f4d1c639347317788f2c5080f89de53772499ce...3d1dd4728b83e4c08d9fa7aaf2aa946e1012e061,2,12,1,13,2,2008-07-13 20:53:54,2008-07-13 08:13:55
3d1dd4728b83e4c08d9fa7aaf2aa946e1012e061...711f6b295cf463aae07eb76e009faed3d3699623,2,31,2,33,4,2008-07-14 07:09:41,2008-07-14 07:09:41
123ed6590836405acb4a0c38e2e4c1b06b4e49a9...1556ef1e373e2928cd0d4a3630f142a57c1f1813,1,4,4,8,4,2008-12-05 02:45:01,2008-12-04 23:03:28
1556ef1e373e2928cd0d4a3630f142a57c1f1813...a20033796b312390ea8a50917bea623efd6fad97,1,7,7,14,6,2008-12-05 02:45:01,2008-12-04 23:38:27
a20033796b312390ea8a50917bea623efd6fad97...22db240dd1791b32e7f6d25a466c2835bdccb51e,1,7,2,9,4,2008-12-05 02:45:02,2008-12-04 23:38:27
22db240dd1791b32e7f6d25a466c2835bdccb51e...fe6beab7e80565dac81125aa82521f7673905ebc,11,229,0,229,11,2008-12-05 02:45:02,2008-12-05 01:08:48
fe6beab7e80565dac81125aa82521f7673905ebc...9b9f5a2258e6df611d2903d84fd8d41806ce0e00,2,2,3,5,3,2008-12-06 04:02:10,2008-12-05 19:19:43
123ed6590836405acb4a0c38e2e4c1b06b4e49a9...47d32af2338418275ab6b53a737952af22289d97,3,45,15,60,10,2008-12-05 02:05:41,2008-12-05 00:35:48
47d32af2338418275ab6b53a737952af22289d97...7be77de266b5cbcbd28d69a04df6f0b167b87cf6,2,4,3,7,2,2008-12-05 02:05:51,2008-12-05 00:36:46
7be77de266b5cbcbd28d69a04df6f0b167b87cf6...304dcf262e3f8524c909a13cf73a67522be6353b,1,2,1,3,1,2008-12-05 02:05:51,2008-12-05 00:39:14
304dcf262e3f8524c909a13cf73a67522be6353b...7f705dc3686c2b1c77172b6847c1406eb66a20c3,1,9,1,10,1,2008-12-05 02:44:16,2008-12-04 13:37:33
52b8ea934ecd24b52806188b53367aaa6185deb3...681c3290e379e61f9dd762039f140296434d1d9f,1,3,2,5,2,2009-03-23 10:52:57,2009-03-16 10:24:40
681c3290e379e61f9dd762039f140296434d1d9f...37871b735aa427c440590966d4cacaf219a21292,1,20,0,20,1,2009-03-23 10:52:59,2009-03-19 08:54:17
37871b735aa427c440590966d4cacaf219a21292...d38d7d4954601966fe86573bf698c5bd4f37cb64,1,4,1,5,1,2009-03-23 10:53:00,2009-03-19 08:54:18
d38d7d4954601966fe86573bf698c5bd4f37cb64...5fdcbb13904e6447cad9611b9c75943bbbcc7db4,1,50,12,62,14,2009-03-23 11:35:38,2009-03-23 11:17:38
5fdcbb13904e6447cad9611b9c75943bbbcc7db4...b9fdba7ff87d2e032df00508d06e586c17ea8216,1,87,4,91,12,2009-04-08 23:34:46,2009-04-08 23:34:46
b9fdba7ff87d2e032df00508d06e586c17ea8216...010509f2de86d14c1da26eeafffb0864269c1232,1,89,0,89,4,2009-04-09 12:10:20,2009-04-09 12:10:20
010509f2de86d14c1da26eeafffb0864269c1232...9832e4f29b82e0072f40ef73279da3cd09e4a75c,1,3,0,3,1,2009-04-17 12:47:48,2009-03-23 10:37:51
9832e4f29b82e0072f40ef73279da3cd09e4a75c...84b4b832eb39aaf85f9363405123afbaeb1ecb49,1,1,1,2,1,2009-04-17 12:47:48,2009-03-26 20:13:45
84b4b832eb39aaf85f9363405123afbaeb1ecb49...b56e0a9afd63a54e2c51fba56a79b136a4e978f3,1,3,3,6,3,2009-04-17 12:47:48,2009-03-30 19:17:25
b56e0a9afd63a54e2c51fba56a79b136a4e978f3...b6e192dbf73397da0f76252b7e39770150a8763f,1,1,0,1,1,2009-04-17 12:47:48,2009-03-30 12:55:21
b6e192dbf73397da0f76252b7e39770150a8763f...c876dbadc2d44386962296f09a060c3ae69e2029,1,5,0,5,2,2009-04-17 12:47:49,2009-04-14 21:09:53
c876dbadc2d44386962296f09a060c3ae69e2029...b575b2f1f420bf82557beab0f4ec12e5aa832bea,1,2,3,5,1,2009-04-17 12:47:49,2009-04-15 15:54:19
b575b2f1f420bf82557beab0f4ec12e5aa832bea...478afad697e58433f34d69b5fe08511405f23506,1,1,0,1,1,2009-04-17 12:52:15,2009-04-15 16:14:03
478afad697e58433f34d69b5fe08511405f23506...6f63fc18b6197f9a582fbfe23a5c7938fe593951,1,47,19,66,11,2009-04-21 12:22:31,2009-04-21 12:22:31
6f63fc18b6197f9a582fbfe23a5c7938fe593951...ad7ef5b88d5d8ce4434a7df7aa658b451867eec3,1,1085,0,1085,1,2009-04-30 23:34:24,2009-04-27 18:04:27
834caf9a7b0850d5647426bcb7c4dae04d85a922...d5be89d8ad88792a9716fbfdb499d6d852d0eff5,1,5,0,5,1,2008-12-22 02:32:04,2008-12-21 22:17:12
d5be89d8ad88792a9716fbfdb499d6d852d0eff5...b80b5d67999dfa5bb1e7ad8ff50142bb371b3746,1,8,0,8,1,2008-12-22 02:34:49,2008-12-22 00:26:03
7a0ebbf829a327768e6d1c32fe1d092814dce4e8...1924d1bc0dc99cd3460d3551671908cc76c09d3b,1,12,5,17,3,2009-11-14 10:28:26,2009-11-06 23:28:01
1924d1bc0dc99cd3460d3551671908cc76c09d3b...a80e82f6ee79a0b1ad42781af79bc76628ec90e9,1,1,1,2,1,2009-11-19 09:32:45,2009-11-14 13:21:09
ea4f2bd39dcfabb23e86b2f79149c6c4038ff3cd...8c4021abfd170278d1a3431e2777bedd0c01fbb1,1,1,1,2,1,2008-11-16 08:24:41,2008-11-15 18:02:01
e5d3afd78be54fc6e958c7ebad178593fd030441...9612e74342cfd38c0b83230a2c847cd070599a5a,1,2,0,2,2,2008-08-13 05:40:44,2008-08-11 18:46:56
7dde4bb3674da53dd9e33c741bea3fe680690a0d...6cf91492d9cd985e1fa65181d99d6d578d4439dc,6,29,1,30,6,2008-07-05 07:37:44,2008-07-04 19:10:14
6cf91492d9cd985e1fa65181d99d6d578d4439dc...51add76e92c9de9bcad3d421303b45ab488d529e,3,1,83,84,4,2008-07-05 17:43:46,2008-07-05 14:43:51
51add76e92c9de9bcad3d421303b45ab488d529e...9c67c757191b34760bf5f6c1d1426ce1bb01ef08,1,1,1,2,1,2008-07-05 18:24:39,2008-07-03 04:47:05
9c67c757191b34760bf5f6c1d1426ce1bb01ef08...0cafe944e9c1d50e0b4377fbf26f2fc1544d0204,2,2,2,4,2,2008-07-05 18:24:39,2008-07-03 04:54:38
0cafe944e9c1d50e0b4377fbf26f2fc1544d0204...7f9d77f2797cabfc1b5b9bad89a295d4f139120f,3,7,7,14,4,2008-07-05 18:24:39,2008-07-03 05:03:54
7f9d77f2797cabfc1b5b9bad89a295d4f139120f...56992f765d8e5eaa495f46e23f50b17ec1db725f,1,1,1,2,1,2008-07-05 18:24:39,2008-07-03 05:08:12
56992f765d8e5eaa495f46e23f50b17ec1db725f...d69806d198398d11d40e735538eb5f9402ef315f,1,2,2,4,1,2008-07-05 18:24:39,2008-07-03 05:13:45
d69806d198398d11d40e735538eb5f9402ef315f...7a7d4ef69c2c79b10977508794e1bbd62ca9ed2b,2,6,6,12,3,2008-07-05 18:24:39,2008-07-03 05:20:21
7a7d4ef69c2c79b10977508794e1bbd62ca9ed2b...467c0197fd0a49078d05839ee385046cd3707a5b,13,71,71,142,64,2008-07-05 18:24:39,2008-07-03 05:28:15
467c0197fd0a49078d05839ee385046cd3707a5b...877276d4d3018d2810be990c39fa7f59678e960d,1,2,2,4,1,2008-07-05 18:24:39,2008-07-03 05:30:25
877276d4d3018d2810be990c39fa7f59678e960d...04c2407eafa0361439a60fd6240447f3404d014b,2,10,10,20,3,2008-07-05 18:24:39,2008-07-03 05:36:04
04c2407eafa0361439a60fd6240447f3404d014b...0979c106498f21838140313b485f90faf06f454f,6,11,11,22,11,2008-07-05 18:24:39,2008-07-03 05:37:18
0979c106498f21838140313b485f90faf06f454f...ba020ef5eb5fca3d757bd580ff117adaf81ca079,117,712,712,1424,644,2008-07-05 18:24:40,2008-07-03 05:41:41
ba020ef5eb5fca3d757bd580ff117adaf81ca079...42d36bb841eb035eb0f7261f02987893c14e1a02,4,5,5,10,5,2008-07-05 18:24:40,2008-07-03 05:49:55
42d36bb841eb035eb0f7261f02987893c14e1a02...2fd02c92dbb6e575b7e62ea9dfa85ef45ebe58b6,12,24,24,48,22,2008-07-05 18:24:40,2008-07-03 05:55:07
2fd02c92dbb6e575b7e62ea9dfa85ef45ebe58b6...5833d730efb7131bccbcdcab13ba56707629be2c,4,10,10,20,9,2008-07-05 18:24:40,2008-07-03 05:59:09
5833d730efb7131bccbcdcab13ba56707629be2c...db5d6666afb9f315f9c9ac74a5d638f07cf9cbe0,5,7,7,14,6,2008-07-05 18:24:40,2008-07-03 06:06:23
db5d6666afb9f315f9c9ac74a5d638f07cf9cbe0...6e1c23442a0315ad440bb8457703dcf1ad943b96,9,32,21,53,19,2008-07-06 00:26:29,2008-07-03 15:52:09
6e1c23442a0315ad440bb8457703dcf1ad943b96...1fc561d169ac08c411e34a4439894c5201b3d080,3,19,17,36,3,2008-07-06 00:30:58,2008-07-05 21:26:39
e636106c76e0273334940d899de1c928d08b29e8...18374e584ca7a820457c1d83ee99867c216e7b75,2,13,3,16,5,2008-06-26 20:26:25,2008-06-26 20:16:33
67faaaba8338cf59c212ce5239eeb223a77acdf0...eee0184da8457c1dbd4418f95d158917540da094,1,5,1,6,2,2008-10-15 06:38:39,2008-10-15 04:27:12
67faaaba8338cf59c212ce5239eeb223a77acdf0...aef405dd5021f674f86b66cadfe4442b5f79cbfc,1,1,1,2,1,2008-10-14 23:49:13,2008-10-14 20:22:10
aef405dd5021f674f86b66cadfe4442b5f79cbfc...84ed4c5d117d72f02cc918e413b9861a9d2846d7,1,3,0,3,1,2008-10-14 23:50:09,2008-10-14 14:42:45
ae26e7c74970281bd3597c79e44a8b54a927bbe1...3f6aff68896f8490e101eb5c4ad8f0fa5b8b67bb,1,41,0,41,1,2008-12-05 01:59:41,2008-12-04 10:00:24
3f6aff68896f8490e101eb5c4ad8f0fa5b8b67bb...070434d02b96ae0fac0a3364c202136f5eb5a7a9,1,26,0,26,3,2008-12-05 01:59:45,2008-12-04 10:22:40
ae26e7c74970281bd3597c79e44a8b54a927bbe1...d69da76dd0bc352e358c4beb5eb3aae5588c99de,1,1,1,2,1,2008-12-03 22:27:17,2008-12-03 13:26:48
d69da76dd0bc352e358c4beb5eb3aae5588c99de...a86e8c1cfcb576d2d5b3a3499acc48684280dccb,1,1,1,2,1,2008-12-03 22:27:17,2008-12-03 13:26:49
a86e8c1cfcb576d2d5b3a3499acc48684280dccb...2d17985782256d3505791a814b16e4e772fd341f,1,4,4,8,3,2008-12-03 22:27:17,2008-12-03 13:26:50
2d17985782256d3505791a814b16e4e772fd341f...5a92d190211c5f1277ea76752882a5f1104488f8,1,2,2,4,2,2008-12-03 22:27:17,2008-12-03 13:26:51
5a92d190211c5f1277ea76752882a5f1104488f8...30353a40f7ca2f09e61013609f4847461b4544b7,1,3,3,6,3,2008-12-03 22:27:18,2008-12-03 13:26:52
30353a40f7ca2f09e61013609f4847461b4544b7...c76b4c81e79f423c3d50f0cfadcf74de3bee8aea,1,1,0,1,1,2008-12-04 05:29:03,2008-12-04 03:42:03
8cc3fe45c92a2e85400a6ee83c3b3a4a8ca1d6c7...689f03964360114bc1139d82b1f6a0d7b897bbf0,1,13,12,25,7,2009-03-07 20:19:05,2009-03-06 04:56:16
689f03964360114bc1139d82b1f6a0d7b897bbf0...a3c8423901ec4996369b137b46354ddf1cfc0e0e,1,9,3,12,4,2009-03-07 20:19:19,2009-03-07 06:11:29
a3c8423901ec4996369b137b46354ddf1cfc0e0e...e928213fb40c106650dca2632b5e830cfaffb86a,1,23,22,45,9,2009-03-07 20:19:21,2009-03-07 06:11:34
e928213fb40c106650dca2632b5e830cfaffb86a...08fbdb30438fd7087c5abe15840a22fe21094515,2,19,18,37,9,2009-03-07 20:19:24,2009-03-07 06:11:36
08fbdb30438fd7087c5abe15840a22fe21094515...abd2bde78bd994166900290434a2048e660dabed,3,36,11,47,11,2009-03-07 20:19:28,2009-03-07 06:11:39
8cc3fe45c92a2e85400a6ee83c3b3a4a8ca1d6c7...252d560d215581637fcddd7a0a18f89204ecc8d1,1,3,7,10,1,2009-03-07 19:34:53,2009-03-07 12:27:15
252d560d215581637fcddd7a0a18f89204ecc8d1...d7eb527d731e2a71eaa4597417d879a15588d9ee,2,18,17,35,15,2009-03-07 19:34:56,2009-03-07 12:28:40
d7eb527d731e2a71eaa4597417d879a15588d9ee...79212772ce127cc32a67d50eaaa7f1c102ce7d5d,1,10,11,21,8,2009-03-07 19:34:57,2009-03-07 12:30:27
79212772ce127cc32a67d50eaaa7f1c102ce7d5d...7e8f59d577e5615ceff06da0d9dde36a63608d53,5,130,12,142,10,2009-03-07 19:34:59,2009-03-07 12:32:32
7e8f59d577e5615ceff06da0d9dde36a63608d53...a94982ef39e1bb9a6f782b5b6ced22e97d6859b5,3,48,1,49,6,2009-03-07 19:34:59,2009-03-07 12:34:46
a94982ef39e1bb9a6f782b5b6ced22e97d6859b5...747a322bcc4df5f9a371890ffe728741456704c7,1,2,2,4,2,2009-03-09 01:22:44,2009-03-09 01:22:44
747a322bcc4df5f9a371890ffe728741456704c7...6e89ec0f1e716c11bf7fa214b4c7b975ea77c736,1,2,0,2,1,2009-03-18 00:03:33,2009-03-16 02:20:04
8cc3fe45c92a2e85400a6ee83c3b3a4a8ca1d6c7...d0baf91db871fdd129057d7844d17457575698ba,1,60,0,60,2,2009-03-06 09:37:22,2009-03-06 09:37:22
d0baf91db871fdd129057d7844d17457575698ba...d5e31235f2df3d54930c79f46fb7a7e2394899d0,1,1,1,2,1,2009-03-07 20:22:13,2009-03-07 14:37:18
d5e31235f2df3d54930c79f46fb7a7e2394899d0...52d5c3b5b22b6a672ace19f631768a63bb6a2250,1,60,49,109,4,2009-03-08 04:19:45,2009-03-06 04:39:31
52d5c3b5b22b6a672ace19f631768a63bb6a2250...3c7b480a1cf6e1a1c73b4edde5d8cf0ac0c8111c,1,20,18,38,6,2009-03-08 04:23:09,2009-03-06 16:30:44
3c7b480a1cf6e1a1c73b4edde5d8cf0ac0c8111c...0a4e14727f53ba2e8263622ba5de917b2f9d1575,1,56,5,61,9,2009-03-08 04:23:28,2009-03-06 04:39:33
0a4e14727f53ba2e8263622ba5de917b2f9d1575...ca31f0b5c2fe379324920094ef1d242dce062737,1,45,0,45,1,2009-03-08 04:27:48,2009-03-06 09:48:53
ca31f0b5c2fe379324920094ef1d242dce062737...3b167396b416541f7559f3141392d56b93ea049c,1,1,1,2,1,2009-03-08 04:32:07,2009-02-27 18:53:59
3b167396b416541f7559f3141392d56b93ea049c...36adb4abbdf809371b88581c8bf7fe9ea9a5b00a,2,5,1,6,2,2009-03-08 04:36:16,2009-03-07 15:51:33
36adb4abbdf809371b88581c8bf7fe9ea9a5b00a...eb3a9dd3279fe4b05f286665986ebf6d43a6ccc0,8,9,27,36,23,2009-03-08 04:52:17,2009-03-07 20:02:10
eb3a9dd3279fe4b05f286665986ebf6d43a6ccc0...fd13b21f52b499ff6fa951ce27d4b9c9f0653087,4,8,12,20,11,2009-03-08 04:52:23,2009-03-07 20:02:26
fd13b21f52b499ff6fa951ce27d4b9c9f0653087...113106e06c48cc80432fd1be8af912898e8f240e,1,10,20,30,6,2009-03-08 04:52:25,2009-03-07 16:47:21
a1a846a19e854a3b3baff8f55c039846880a2635...6331adb9c4ec36c70dc3ecc6eb46b7dddb36952d,1,8,3,11,2,2008-11-05 20:20:55,2008-11-05 20:20:55
bc9c0248a5cf184756ba562d6c452cace8863517...d2d188d92203997d260e8a21695b85c18b002d8f,1,1,1,2,1,2008-11-09 18:23:37,2008-11-09 14:25:55
bc9c0248a5cf184756ba562d6c452cace8863517...b2dc968e60c94189805228f5d99786bd50189583,1,21,29,50,8,2008-11-09 18:14:57,2008-11-07 22:20:33
b2dc968e60c94189805228f5d99786bd50189583...986e82396ab23b9e5f4eab7183bbf76e7bc756d0,3,105,0,105,8,2008-11-09 18:16:50,2008-11-09 01:49:27
93197898041fcaf84d8ac84df764cca7bf86b226...12d4996622f524e61cbf855b32600150a8c94c02,2,7,3,10,4,2009-09-03 01:39:02,2009-09-02 06:36:47
a9b2d42486ee0b461220bf3895114926d9ddf9be...84201eae771fbb1d774cf1356d89016053e56778,1,5,1,6,2,2009-06-03 18:32:29,2009-06-03 16:19:01
84201eae771fbb1d774cf1356d89016053e56778...6c7f58d6f691c1091b90b0891e94c91e20fd6054,2,6,8,14,4,2009-06-04 05:47:48,2009-06-04 05:42:15
3d09e64ac10aab1ae6ae1ac9cce7a6ebb43f2e50...377829201783b8a648e07af6ce7d747e0f45dc19,51,86,64,150,64,2009-05-25 08:07:25,2009-05-23 18:53:12
377829201783b8a648e07af6ce7d747e0f45dc19...df217ed6430efe444a09fffdafd39720ae3f9864,9,59,33,92,38,2009-05-25 08:07:33,2009-05-23 18:53:13
5acb3e5012966cc11e54f50e0592b3639bade02c...29f25d493c1021a53acf41e5763e732217dd75c3,2,21,9,30,4,2009-05-23 05:46:04,2009-05-21 07:33:17
5acb3e5012966cc11e54f50e0592b3639bade02c...e64c1b0053f2dc4fc5b434a9806b90318bac9592,1,5,2,7,1,2009-05-20 07:06:19,2009-05-18 17:58:11
e64c1b0053f2dc4fc5b434a9806b90318bac9592...fd73ccf27956f24dc0db9acd4ff7d9dcd5e41bfb,1,6,0,6,3,2009-05-21 01:23:06,2009-05-15 18:52:47
fd73ccf27956f24dc0db9acd4ff7d9dcd5e41bfb...8dfb17e1fd7dec1d3a1978eb46743964c481cd08,1,1,1,2,1,2009-05-21 01:35:23,2009-05-18 16:24:30
8dfb17e1fd7dec1d3a1978eb46743964c481cd08...e701fadb9e0e51a6811690d95a53bd1f5b6fad86,1,5,0,5,2,2009-05-21 01:49:20,2009-05-20 21:31:53
b11cf09043f18b368ec0d988f064ea21247c843d...2414b45ce0c56f7744e00e7fef3682a77375701e,1,10,2,12,5,2009-06-04 05:38:17,2009-06-02 18:03:22
c574e683b587ee3c302317e4fa9c83cd4605cd82...0cfd112032017ab68ed576f6bb5258452084ebf1,1,34,0,34,1,2011-08-29 17:21:17,2011-08-29 16:44:06
c574e683b587ee3c302317e4fa9c83cd4605cd82...45d51dc9695a52222fc900e3c7ae8b9ee66c3db7,1,1,1,2,1,2011-08-29 16:51:44,2011-08-29 16:44:07
c574e683b587ee3c302317e4fa9c83cd4605cd82...0cd29a0371838228e2c942058e8829f5d0d4a077,1,13,14,27,7,2009-06-14 00:30:38,2009-05-27 09:25:19
500348aa6859e436a890f5f5a7e0eeea8ef6c1de...75609a0d44d02878e6260a7a4bf2dda5310a9dd9,1,3,2,5,1,2010-09-16 00:30:36,2010-09-15 23:56:48
75609a0d44d02878e6260a7a4bf2dda5310a9dd9...4c608520ed58301de99024e47a0579b058db0a65,1,4,4,8,4,2010-09-16 00:38:50,2010-09-16 00:34:20
2d938fc7bcf2c8ce314c44955db5a4dd2e9b6adb...7a8e3895f68e9ae4e44e521c78fc98768c2a88ec,3,1,23,24,3,2009-05-27 20:45:45,2009-05-27 05:09:40
7a8e3895f68e9ae4e44e521c78fc98768c2a88ec...e22278c0a0784d4285f0e3173794caad4e542658,1,27,3,30,4,2009-05-29 05:39:59,2009-05-28 21:21:16
e22278c0a0784d4285f0e3173794caad4e542658...9af3589e0e42eb289dfdb8bb4031e5bec4923308,3,42,6,48,10,2009-06-06 18:26:56,2009-06-06 04:41:33
9af3589e0e42eb289dfdb8bb4031e5bec4923308...62d0b0daf12239fdb898a0d197dfc49a5e2742b0,1,49,1,50,2,2009-06-06 18:26:56,2009-06-06 04:41:34
62d0b0daf12239fdb898a0d197dfc49a5e2742b0...a66037c9755a2beb49bbd915e6f0dd9b1a732925,1,12,0,12,1,2009-06-06 18:26:56,2009-06-06 04:41:35
ec00d6e0038e030cf73182374e21025c2776cb23...07d7bedda8d18ffbfe5960ce27b73a24c01cac1a,1,1,1,2,1,2009-05-09 15:27:11,2009-04-29 03:21:01
5a0e4a2a326966aabb566164a7571291e34adabd...74fd8728e2abd46a6276f6d48bfc6c9f01d74570,1,5,7,12,6,2009-05-09 08:35:15,2009-05-07 17:11:29
74fd8728e2abd46a6276f6d48bfc6c9f01d74570...be427d758b53343d31debb520c0bc251a62013a9,2,2,1,3,2,2009-05-09 15:32:14,2009-04-28 15:21:20
5a0e4a2a326966aabb566164a7571291e34adabd...7742c65ba5d74f9cbb426f206a88ae04be3f46cd,1,10,0,10,3,2009-05-09 07:31:00,2009-05-08 15:22:30
5a0e4a2a326966aabb566164a7571291e34adabd...2f4b97f91071f5060bf2da482cf8b0d70486d808,5,44,2,46,8,2009-05-09 07:28:53,2009-05-07 19:44:17
1ca20358e769e5bf8f3567a658efe858f8550ff5...57343652a55bdc3e7f3cf8c6def94dac482c72e5,1,63,62,125,11,2009-05-23 05:48:04,2009-05-21 07:33:18
99ddd24ad7753458043016bf1b7d88915aaeb396...91fe2f909154c5cda3b40c68e72c3172a7f137f6,2,6,6,12,6,2009-05-20 07:02:24,2009-05-19 04:34:02
91fe2f909154c5cda3b40c68e72c3172a7f137f6...d00e364de99d51bb76e437820e23cfa820417ec5,1,25,0,25,1,2009-05-20 07:04:37,2009-05-19 20:01:54
99ddd24ad7753458043016bf1b7d88915aaeb396...5ae93dfdccfe9457bdb1f54b33c76359f6c3b861,5,20,20,40,18,2009-05-19 03:53:11,2009-05-18 23:44:38
5ae93dfdccfe9457bdb1f54b33c76359f6c3b861...330db18c0277dcfcf322bb61c688acfb5ddf3867,4,6,6,12,6,2009-05-19 03:53:12,2009-05-18 23:44:39
330db18c0277dcfcf322bb61c688acfb5ddf3867...ed1e3985e445e4cb4558056f8a31c366f2bf2634,1,2,4,6,3,2009-05-19 03:53:14,2009-05-18 23:44:40
ed1e3985e445e4cb4558056f8a31c366f2bf2634...62645006044c7453439f6ad8dafc984441ac54b6,1,1,1,2,1,2009-05-19 03:53:15,2009-05-18 23:44:41
62645006044c7453439f6ad8dafc984441ac54b6...d4ea4e27463576f33866b1c3f0fe41913fb03ef7,1,1,1,2,1,2009-05-19 03:53:16,2009-05-18 23:44:42
d4ea4e27463576f33866b1c3f0fe41913fb03ef7...1e6bca0e8941f3a73d16d1842e2202f85b446c41,1,20,20,40,14,2009-05-19 03:53:17,2009-05-18 23:44:43
1e6bca0e8941f3a73d16d1842e2202f85b446c41...e0d44c50752644fca80f1e78ab7a939135b380e1,1,1,1,2,1,2009-05-19 03:53:18,2009-05-18 23:44:44
e0d44c50752644fca80f1e78ab7a939135b380e1...bf1db7dba50205905cb27ff73586ae3a44b89bca,2,20,20,40,16,2009-05-19 03:53:19,2009-05-18 23:44:45
bf1db7dba50205905cb27ff73586ae3a44b89bca...bdb0a7e4e429860ce9dfe43401dda337dbbd0baa,1,3,3,6,2,2009-05-23 05:40:22,2009-05-22 23:47:05
bdb0a7e4e429860ce9dfe43401dda337dbbd0baa...bb43414b371c663189f4ee32949d82303cac918c,3,15,15,30,8,2009-05-23 05:41:04,2009-05-22 23:47:06
bb43414b371c663189f4ee32949d82303cac918c...ed43bc8c4c30199cfba5e6ce9f8037c8c454cf5c,1,1,1,2,1,2009-05-28 03:24:55,2009-05-28 01:57:45
6ffd567bec439e7809ee0966556bd5e72fb78de4...adfd55d51bff3bfcf17c3cd40d0689fb018c14cf,1,9,2,11,3,2009-04-30 01:38:52,2009-04-29 21:40:50
389d17677187f5e996022b7b8e0faf800608cb3a...5a688fe4706462dfa0a7932ef0c82c335c47e9ab,5,77,20,97,16,2009-03-28 04:51:04,2009-03-25 23:19:36
5a688fe4706462dfa0a7932ef0c82c335c47e9ab...fb8b193670b0c11d118185332efc899d6d01d5f4,5,4,11,15,7,2009-03-28 05:10:58,2009-03-26 15:16:47
fb8b193670b0c11d118185332efc899d6d01d5f4...3be1f18e1b15c28ac6c750ff1a42576fd981d0f5,1,3,2,5,3,2009-03-28 15:01:21,2009-03-28 06:14:39
3be1f18e1b15c28ac6c750ff1a42576fd981d0f5...17e61b82887fb71800b0fcd39ffe89ddf4d2492e,3,19,11,30,7,2009-03-28 15:02:15,2009-03-28 06:21:00
17e61b82887fb71800b0fcd39ffe89ddf4d2492e...1b89eaa4bef44ef84f2af611d5db8727e3be266c,1,2,2,4,1,2009-04-01 18:09:25,2009-03-31 20:36:00
389d17677187f5e996022b7b8e0faf800608cb3a...a8fac795ddaa004835fc688560cf19ca5500ce8d,1,1,1,2,1,2009-03-26 07:24:26,2009-03-26 07:08:09
26284f9356f4c4d8865db8bb024121311a1f90ff...41a5c70f2caf5c22859574f0503afbdb3728a89c,1,16,0,16,1,2009-03-30 02:48:39,2009-03-23 12:53:06
41a5c70f2caf5c22859574f0503afbdb3728a89c...2d07f6d4b728d19d115b89123224268718f34efd,1,4,2,6,1,2009-03-30 02:48:43,2009-03-23 12:53:07
2d07f6d4b728d19d115b89123224268718f34efd...c0582c53bcf4e83bba70e1ad23abbad31f96ebc8,2,6,3,9,2,2009-03-30 02:48:43,2009-03-23 12:53:08
c0582c53bcf4e83bba70e1ad23abbad31f96ebc8...1982467d9229e3c92157f2a41363365dcb866e86,2,6,3,9,4,2009-03-30 02:48:43,2009-03-23 12:53:09
26284f9356f4c4d8865db8bb024121311a1f90ff...ebd15bf0d732db7dec4cfd8bbfa2c7430b6e875c,1,1,1,2,1,2009-03-23 00:41:46,2009-03-21 23:29:27
ebd15bf0d732db7dec4cfd8bbfa2c7430b6e875c...4bca86367bff80ad3c04e282a1aa9ed66db26aa1,1,16,0,16,2,2009-03-23 00:41:57,2009-03-22 18:49:07
4bca86367bff80ad3c04e282a1aa9ed66db26aa1...91408042768c05347c1b9f081a00387ca07b26fe,1,1,0,1,1,2009-03-23 00:42:05,2009-03-22 08:08:48
2d893d6822458ea15ef74e2b8be563945a6296fc...a797b02f3925c4a6324472e2edaf4a58d4ffc097,1,1,6,7,2,2009-03-20 21:41:14,2009-03-11 20:13:38
7a134dbbc9ca7013c09b610351c5ce45dc10cda5...e5887c1bda12b31ea7af0ce798bfdee308e1b176,2,20,1,21,2,2009-02-12 02:44:03,2009-02-12 02:44:03
aff4e8dc217bdde9276e634ea7bf92adf926e573...9e5b80cd87a511f3403b6f88f87ef40844695f6b,1,2,1,3,1,2009-02-11 17:22:16,2009-02-11 17:22:16
414f2e5337b0b78a47f021cb734e9ba4934c0b28...aa387407914a574d41df4d64328498d093337ccd,1,13,4,17,7,2009-02-22 04:35:50,2009-02-21 00:48:55
aa387407914a574d41df4d64328498d093337ccd...b408457f2e167aaf8e7a087b374357f4a74e9680,1,18,14,32,9,2009-02-22 04:36:07,2009-02-21 00:48:56
b408457f2e167aaf8e7a087b374357f4a74e9680...0e854a280a0b064f48ee308ef16283e321a9aa6e,1,18,44,62,10,2009-02-22 04:37:19,2009-02-21 00:48:57
0e854a280a0b064f48ee308ef16283e321a9aa6e...d64ec16c2af4ddcf3985d11d5dc28a15db181de5,1,195,154,349,9,2009-02-22 04:37:37,2009-02-21 00:49:25
d64ec16c2af4ddcf3985d11d5dc28a15db181de5...67052c9dcfb3ab46b18e734ea4a9117eb61fea4e,1,5,0,5,1,2009-02-22 04:37:44,2009-02-21 00:49:26
67052c9dcfb3ab46b18e734ea4a9117eb61fea4e...16c1e939856f6ced97c60beb64936d564d198be3,1,20,12,32,12,2009-02-22 04:37:45,2009-02-21 00:49:27
16c1e939856f6ced97c60beb64936d564d198be3...225a9caf18911bffe2f32e4960c94e51f135182b,1,2,0,2,2,2009-02-22 04:37:47,2009-02-21 00:49:28
225a9caf18911bffe2f32e4960c94e51f135182b...c23873589483eb5dc753190309af8c5821169118,1,5,0,5,1,2009-02-22 04:37:48,2009-02-21 00:49:29
c23873589483eb5dc753190309af8c5821169118...ba048224685e661a4cf4736dcffab5fc60cbc70b,1,1,1,2,1,2009-03-07 19:32:44,2009-03-07 17:14:05
ba048224685e661a4cf4736dcffab5fc60cbc70b...bf71b4b3ee07291e97c4dabfb97e7397eec904e0,3,10,3,13,3,2009-03-17 16:30:00,2009-03-17 09:46:37
f1c8a48a2de69bfc9837c53f2c52ffbe7239dc3e...954cfb5cfd17d57b9b31b19b73efe73199407e07,16,0,506,506,20,2009-02-11 05:32:10,2009-02-11 05:31:33
954cfb5cfd17d57b9b31b19b73efe73199407e07...0ab9a8bbfe2af693444a8c9dd3afddeac08f5274,1,3,2,5,1,2009-02-11 06:24:57,2009-02-09 13:39:30
0ab9a8bbfe2af693444a8c9dd3afddeac08f5274...2f33415563a4e4deb45d88f71fdd8963793b5c0c,1,94,86,180,15,2009-02-11 06:25:25,2009-02-09 21:39:52
2f33415563a4e4deb45d88f71fdd8963793b5c0c...fcb6c0760d14cd8ee284a0acf9f7424878cba5a0,1,8,8,16,16,2009-02-11 06:25:31,2009-02-09 22:00:45
fcb6c0760d14cd8ee284a0acf9f7424878cba5a0...75f3ff2eeaba820b37016f464b6d1078cb6260e2,4,20,23,43,6,2009-02-11 06:25:39,2009-02-10 14:30:35
75f3ff2eeaba820b37016f464b6d1078cb6260e2...8ea7ad694be942350457197357127ed81b2550fe,1,1,1,2,1,2009-02-11 06:25:54,2009-02-10 15:14:13
8ea7ad694be942350457197357127ed81b2550fe...f8948e2fbc7fbd63e81006408965e3e89380bfaa,4,86,18,104,18,2009-02-11 06:26:20,2009-02-09 07:27:10
f8948e2fbc7fbd63e81006408965e3e89380bfaa...057e71384a0eff83236268dcd3ff7ebc7789de74,2,10,2,12,5,2009-02-11 06:26:32,2009-02-09 07:52:01
057e71384a0eff83236268dcd3ff7ebc7789de74...ba19a808aa871f0eb20aaeeb205e086b04b726dc,4,4,4,8,4,2009-02-11 06:26:37,2009-02-11 01:42:04
ba19a808aa871f0eb20aaeeb205e086b04b726dc...747ca2455a8dd4e255358f5f96773f84259408c3,2,74,11,85,12,2009-02-11 06:26:49,2009-02-09 06:31:21
747ca2455a8dd4e255358f5f96773f84259408c3...1b53a076fc3e3dc58e67971df18df0ce973a3ff9,1,2,2,4,1,2009-02-11 06:27:14,2009-02-09 06:19:43
f7a2bdb1f070cd79879671391fa8121ef9930abe...075394e26cd7fb38e08d5f637a5fc825ab0b3fb3,1,26,4,30,6,2009-02-15 09:49:13,2009-02-15 08:15:52
075394e26cd7fb38e08d5f637a5fc825ab0b3fb3...88a667f0630e8b9c7679127d3b9364447727e587,1,2,2,4,2,2009-02-15 19:14:12,2009-02-15 18:18:58
88a667f0630e8b9c7679127d3b9364447727e587...1b7e543a6e2f156536a3cf227f9da1029bba6265,1,1,0,1,1,2009-02-16 02:04:48,2009-02-11 23:14:02
f88d225feb117f0429540da90b2552e198fa2e82...9d865356abc08b253bc15b5fb50471d80c828be1,1,1,1,2,1,2008-09-07 02:09:16,2008-09-07 02:09:16
9d865356abc08b253bc15b5fb50471d80c828be1...df58a8274d6865020682a6739bc59b87a9761991,1,0,10,10,2,2008-09-07 02:15:04,2008-09-02 06:20:26
f88d225feb117f0429540da90b2552e198fa2e82...7ceacdffc5c05f9a763b4cb6ea7cb528004643c3,2,18,4,22,5,2008-09-05 07:57:35,2008-09-05 07:57:35
7ceacdffc5c05f9a763b4cb6ea7cb528004643c3...f22a432b157c5673a1004934a2e6ba77dd55b356,1,5,0,5,1,2008-09-05 08:15:40,2008-09-05 07:29:51
f88d225feb117f0429540da90b2552e198fa2e82...a4d7d2c6dbc9e1294034171c31d87b24cf3b492e,4,114,17,131,14,2008-09-05 05:21:56,2008-09-05 05:15:02
5359fde8a4df60f9a2898dcfd2b4fcda02df4708...25e30fa08e687d584d9dd87d13acf84bb1e1858c,1,0,1,1,1,2008-12-02 23:17:07,2008-12-01 18:50:02
7c181d627c136cbc67ef0f722e74e34017e662f0...323e00fd46afb9293b25ee85f061ce11a2f95ca6,2,22,4,26,5,2008-11-09 18:11:39,2008-11-08 12:03:59
323e00fd46afb9293b25ee85f061ce11a2f95ca6...6514aa36d27165d088dd4a2c3046c635f3ca85be,1,4,4,8,3,2008-11-09 18:19:38,2008-11-09 13:46:35
6514aa36d27165d088dd4a2c3046c635f3ca85be...5bcce8494a2ee09250404b8b086cbd62f9506703,1,3,3,6,3,2008-11-09 18:20:03,2008-11-09 13:53:14
e27430e777edeb777cdd02a777e1e3a4608a0b41...bf516ecaac4d7fca840f55e2534066227aa639be,1,1,1,2,1,2009-03-30 14:06:37,2009-03-29 14:29:23
b0d644b6585d68b5324310982373b6b9b1316f5e...b59f091d803c2842bc7e51595551c04adde8ce82,1,96,96,192,91,2009-03-24 23:16:42,2009-03-24 23:15:38
b59f091d803c2842bc7e51595551c04adde8ce82...966d0778db2e3b11f5fffa2312770ef534263058,13,12,111,123,22,2009-03-24 23:17:30,2009-03-23 23:42:24
efe05b019ca19328d27c07ef32b4698a7f36166f...5832d1a9da78273652c213d8e1535c09dd7dc079,1,1,1,2,1,2008-12-20 03:37:18,2008-12-19 12:14:18
757c7f60a78004fc3d0ea62f44320d54ef430c10...a0fbc87cff6ae80c5b5be84201bc53252533b1fb,2,20,1,21,2,2008-12-03 09:54:24,2008-12-02 02:43:00
757c7f60a78004fc3d0ea62f44320d54ef430c10...24b1f65fed0396497ae42c3c12390370819e8bc4,1,1,0,1,1,2008-12-03 08:30:34,2008-12-03 08:30:34
757c7f60a78004fc3d0ea62f44320d54ef430c10...d937c374ccb987356c1412986c8fb106b8aaef75,2,6,1,7,5,2008-12-03 06:48:58,2008-11-03 18:14:28
7f871c6eccd0b9925310b3f0c60c9ef458e6f109...69f4ce553708ee5ce474faaa9c45312f38aad563,2,14,1,15,2,2008-12-01 06:38:20,2008-12-01 06:38:20
45d9414fa5599b41578625961b53e18a9b9148c7...6a6baf9b4e819a0bbfd70627f966cd7144dd8301,1,17,14,31,1,2008-09-20 06:45:04,2008-09-20 06:45:04
edb7e82f72106add9f2fbaf9d99d9532a72e3f91...4b3729e637fc596f7622bb122242f2241f54957e,1,0,0,0,0,2008-09-30 19:16:59,2008-09-30 13:32:47
4b3729e637fc596f7622bb122242f2241f54957e...2670ddce53b9061edf2fdcd912dd4736b53bb3fe,1,4,4,8,4,2008-09-30 20:57:47,2008-09-29 23:01:34
2670ddce53b9061edf2fdcd912dd4736b53bb3fe...0a1a1c8615ec0049d2d7fcd849cfddd978170752,1,1,1,2,1,2008-09-30 20:58:59,2008-09-29 13:58:18
031e6c898f61db1ae0c0be641eac6532c1000d56...eca35a25a92a1ad725af2a549fc9158488c4cc43,10,55,31,86,20,2008-10-26 21:42:57,2008-10-26 02:33:56
eca35a25a92a1ad725af2a549fc9158488c4cc43...450d4c0f5a966b3f5835107ec4d8c344c8c25908,1,1,1,2,1,2008-10-26 21:43:26,2008-10-26 02:33:57
450d4c0f5a966b3f5835107ec4d8c344c8c25908...569740bdd0533ef5cf032edd6233710161a35725,2,12,3,15,5,2008-10-26 21:44:25,2008-10-26 02:33:58
569740bdd0533ef5cf032edd6233710161a35725...fa58186c9ba50514b36ac5ef192cd7e0bc4d7780,2,17,20,37,6,2008-10-30 20:50:48,2008-10-29 00:05:27
fa58186c9ba50514b36ac5ef192cd7e0bc4d7780...045a476f91a9a308c823a2709977163238baa3fd,2,12,1,13,2,2008-11-01 05:41:55,2008-10-31 23:25:44
031e6c898f61db1ae0c0be641eac6532c1000d56...225f1d0c6af36722e6a52ab0563a19e86e51933d,1,1,1,2,1,2008-10-24 23:20:30,2008-10-23 19:21:34
225f1d0c6af36722e6a52ab0563a19e86e51933d...ddff8563510a2c5c675d488a02e2642306430fc1,3,23,2,25,5,2008-10-26 23:19:59,2008-10-25 15:38:14
ddff8563510a2c5c675d488a02e2642306430fc1...9fe7a643fcc56ca1c17afec5d5f8adca10cabdd1,1,7,2,9,2,2008-10-26 23:20:24,2008-10-26 19:37:06
b7893cde53eb2834deb16820eccb709d2636b81b...74190d2363a1be81b06992bebbff6bd59f943fe7,1,2,2,4,2,2008-05-20 05:46:13,2008-05-19 20:08:33
74190d2363a1be81b06992bebbff6bd59f943fe7...e77b0b5d0fdac411607dbae11ccad87dccd332d3,1,1,1,2,1,2008-05-20 05:47:16,2008-05-19 20:09:06
109440c1bf2a3015cd9253515f07231c4cf9d65a...049c1ad2d6a6f000ff0e31a28fbd9e511b01fd24,1,1,1,2,1,2008-05-28 05:01:31,2008-05-27 08:51:22
049c1ad2d6a6f000ff0e31a28fbd9e511b01fd24...a17171b473e0073f73b429abdf348de92394d6a6,2,3,12,15,3,2008-05-28 05:27:30,2008-05-26 19:09:18
a17171b473e0073f73b429abdf348de92394d6a6...1f684dc01c6a45341e8e47d8393f0ef66fdfc398,1,4,4,8,4,2008-05-28 05:27:30,2008-05-27 23:25:42
1f684dc01c6a45341e8e47d8393f0ef66fdfc398...d5350fd2b3a4721885bf1b3353478970caef268c,1,2,0,2,1,2008-05-28 05:32:47,2008-05-27 08:59:16
d5350fd2b3a4721885bf1b3353478970caef268c...28bc30220f30850a10217d61f73e46d8a541e670,4,17,3,20,5,2008-05-28 05:32:47,2008-05-28 05:20:53
d8af75d76f224eb8311bc3815f36cf126d309277...2dd620286e84e4e76226a3511af6d14755b8c809,1,17,1,18,6,2008-12-06 04:02:55,2008-12-06 04:02:55
ad7ef5b88d5d8ce4434a7df7aa658b451867eec3...5e402e54e7f0d9eaa85987ced8913f2709f2be5c,1,373,307,680,299,2009-05-16 10:35:58,2009-05-12 20:20:23
5e402e54e7f0d9eaa85987ced8913f2709f2be5c...b5cda49040f77334dc08485e3f36ef8c8f2928b4,1,1,1,2,1,2009-05-16 11:08:05,2009-04-28 12:03:54
b5cda49040f77334dc08485e3f36ef8c8f2928b4...a8138733fcf4d9c175b53ab0d0f06a3f7c232286,1,7,1,8,3,2009-05-16 11:08:44,2009-05-16 11:06:01
a8138733fcf4d9c175b53ab0d0f06a3f7c232286...13d40b618a78ce236d103ab14272b07305f2f7c9,1,94,37,131,23,2009-05-16 11:09:08,2009-03-23 17:57:46
13d40b618a78ce236d103ab14272b07305f2f7c9...194bbf6cc8c2f3c14a920c841841d66b7667a848,1,1,1,2,1,2009-05-18 22:57:29,2009-05-18 21:46:01
194bbf6cc8c2f3c14a920c841841d66b7667a848...f687aaa83371f0fd9aa41e62cd74405491ddab78,1,3,1,4,2,2009-05-24 23:46:31,2009-05-21 13:35:40
f687aaa83371f0fd9aa41e62cd74405491ddab78...e0a0199581ea30abb58ba812047657b35f4ee639,1,1,1,2,1,2009-05-24 23:46:31,2009-05-23 09:48:25
e0a0199581ea30abb58ba812047657b35f4ee639...a41ddbb649c72214a4861827eedc7b2eebe0608f,1,2,2,4,2,2009-05-24 23:46:31,2009-05-23 17:31:37
f8c62880ef22b74ea6df47bb349ff0743d2a93f9...2559bff32cc5c49d6e9bf3f773358e96af9e47fd,1,4,4,8,2,2009-03-02 07:58:41,2009-03-01 10:20:03
2559bff32cc5c49d6e9bf3f773358e96af9e47fd...07f5746fb580203f0d38a7828190a51a0c32d884,1,18,18,36,10,2009-03-02 20:34:53,2009-03-02 06:37:41
07f5746fb580203f0d38a7828190a51a0c32d884...a7d64b52da7a843a1113f7e9cc624b4dee0e5f40,2,6,6,12,5,2009-03-02 20:34:54,2009-03-02 06:38:36
a7d64b52da7a843a1113f7e9cc624b4dee0e5f40...1d035f85649cbb0a4fcc3e341f7e854acf9cf3c1,1,13,13,26,11,2009-03-02 20:34:56,2009-03-02 06:42:44
71cbf773df4a339e3534077bc9a0e69875146963...5fdb70983585ccde1540563a8c7458621f7a7407,1,4,4,8,2,2008-12-22 02:45:05,2008-12-21 22:28:25
5fdb70983585ccde1540563a8c7458621f7a7407...f66bc5f928194366ee5eb78ef18a3562fb1bb7cf,3,4,4,8,4,2008-12-22 02:46:41,2008-12-21 23:17:32
f66bc5f928194366ee5eb78ef18a3562fb1bb7cf...779e3a8f8b77f4316bb61a8d67b49462b3893632,1,18,1,19,3,2008-12-22 03:20:21,2008-12-22 03:20:21
779e3a8f8b77f4316bb61a8d67b49462b3893632...c66c0cbc7e55409ac934b7c6e89aa7aafa74ede4,1,17,13,30,3,2008-12-23 02:11:33,2008-12-23 01:09:24
a80e82f6ee79a0b1ad42781af79bc76628ec90e9...c2f2dab971d4e955dbf5a48055ed3cde4a078711,1,4,1,5,2,2009-12-13 23:08:18,2009-12-12 04:52:39
c2f2dab971d4e955dbf5a48055ed3cde4a078711...7e705ec185186e5e4141ebc83003a8d8174c4d35,1,1149,0,1149,1,2010-01-12 10:40:41,2010-01-12 10:40:41
7e705ec185186e5e4141ebc83003a8d8174c4d35...be8e40df7566b838f7ed1840e5c0802097a5e814,1,458,312,770,270,2010-01-12 11:04:46,2009-12-14 13:12:25
be8e40df7566b838f7ed1840e5c0802097a5e814...dfb891e35100cf78873c5cf81ffe778dbe235ef5,1,11,1,12,3,2010-01-12 11:04:46,2010-01-03 14:55:52
dfb891e35100cf78873c5cf81ffe778dbe235ef5...fcacf489577e225d78b290290765775c62c56464,1,1,1,2,1,2010-01-12 11:04:46,2010-01-03 14:56:25
fcacf489577e225d78b290290765775c62c56464...1f2cecfd53137b76d39b2dcd7bcf7e918cd745b3,1,2,0,2,2,2010-01-12 11:20:18,2010-01-05 12:44:54
1f2cecfd53137b76d39b2dcd7bcf7e918cd745b3...0359ba72bb3e8d717ee90849e941bbe87b7fbaff,2,2,2,4,2,2010-01-12 11:20:18,2010-01-09 22:11:12
0359ba72bb3e8d717ee90849e941bbe87b7fbaff...b495f0bad2fb0b185442a352d2de0cc3c1fde63c,1,362,311,673,281,2010-01-29 11:50:29,2010-01-29 11:50:29
b495f0bad2fb0b185442a352d2de0cc3c1fde63c...9f0531261ed38473bb35b07fde1ae7a96fba2073,1,627,265,892,235,2010-01-29 11:51:28,2010-01-29 11:51:28
9f0531261ed38473bb35b07fde1ae7a96fba2073...5cc0f821e46f7201cf997820de352444083c1768,1,1254,0,1254,1,2010-01-29 11:53:44,2010-01-12 13:02:50
5cc0f821e46f7201cf997820de352444083c1768...d70bb6233272c46b53a697bf620ec8dcd2550de3,1,432,309,741,262,2010-01-29 11:55:14,2010-01-29 11:55:14
8ea6ae99b2314ddb24dd9121335b7a5583047f05...df63fbbf46c5ec855132f4c631c32b45f67b42e4,1,2,2,4,1,2009-01-05 18:45:54,2009-01-02 12:15:28
9612e74342cfd38c0b83230a2c847cd070599a5a...ea335b56d44a92b9b8be40b1465d7df65a4f736b,2,9,1,10,2,2008-08-14 00:11:03,2008-08-13 22:34:34
ea335b56d44a92b9b8be40b1465d7df65a4f736b...21926fe885aa6579f7aa0e89fcb6a9064f8aa516,1,4,4,8,4,2008-08-14 01:18:23,2008-08-14 00:49:30
08b51f51e6a4cf2f5ad4b893707f1337a450e499...4e10738a9392ad285aca7d3a19e6775d6b7b513e,1,47,4,51,5,2008-07-06 09:20:24,2008-07-03 11:46:57
08b51f51e6a4cf2f5ad4b893707f1337a450e499...c96a6d36608166f2e1b74e639b34bb5ae8932683,2,2,2,4,2,2008-07-06 06:31:09,2008-07-06 04:10:04
c96a6d36608166f2e1b74e639b34bb5ae8932683...f45ed32c4067eb617e670da3a73348bba4841f3f,1,6,12,18,2,2008-07-06 06:31:42,2008-07-06 04:28:41
f45ed32c4067eb617e670da3a73348bba4841f3f...6376cffaebe40947eea9afb4ae6df05a6ac59ae8,1,1,1,2,1,2008-07-06 06:35:11,2008-07-06 03:15:17
6376cffaebe40947eea9afb4ae6df05a6ac59ae8...2553ede5a9b09260be69de72b60e5038f5452c44,1,4,1,5,1,2008-07-06 06:35:11,2008-07-06 03:15:18
2553ede5a9b09260be69de72b60e5038f5452c44...96f2395951fd81ad49217d49074dfbcf3f0df685,1,10,10,20,10,2008-07-06 06:35:12,2008-07-06 03:15:19
96f2395951fd81ad49217d49074dfbcf3f0df685...af9a01e1c2f6a8814b817eb7f3d78814389a3212,1,1,1,2,1,2008-07-06 06:35:12,2008-07-06 03:15:20
7ac749c96d143ba4f76723959892cbaddbe8ed07...74d817cf8cf68104564cf6c93c1361f66dad1901,1,1,1,2,1,2008-06-28 20:43:21,2008-06-28 16:04:24
74d817cf8cf68104564cf6c93c1361f66dad1901...762656e03e80a77aeca6163597640d4e48eee55c,1,1,1,2,1,2008-06-28 20:43:22,2008-06-28 20:02:47
762656e03e80a77aeca6163597640d4e48eee55c...5b8a94b1db4beba969d8cbb0e6e45033834b5913,1,1,0,1,1,2008-06-29 02:50:56,2008-06-29 01:21:25
5b8a94b1db4beba969d8cbb0e6e45033834b5913...29c70e0b3e3183f86f93500882177d0c74069988,1,4,1,5,2,2008-06-29 02:57:22,2008-06-28 23:33:56
29c70e0b3e3183f86f93500882177d0c74069988...7829f20f5beabe3e21866ae53109a58370571158,1,3,12,15,4,2008-06-29 03:55:45,2008-06-29 03:40:32
7ac749c96d143ba4f76723959892cbaddbe8ed07...6315472eed9ff5f594560ddfd592ea21c665fe96,1,24,12,36,8,2008-06-27 23:22:51,2008-06-27 03:59:50
6315472eed9ff5f594560ddfd592ea21c665fe96...f3cb169bc9822e39a3efe637602b829cb338a213,1,11,4,15,5,2008-06-30 06:47:41,2008-06-27 04:01:41
7ac749c96d143ba4f76723959892cbaddbe8ed07...bc0c0d81561bdbb8cb5e1f3af558390f1a0c86cb,1,2,1,3,1,2008-06-27 23:21:19,2008-06-27 12:56:05
bc0c0d81561bdbb8cb5e1f3af558390f1a0c86cb...5b8063b5b0f56f0da345e8dd7c66d3aced1af673,1,7,0,7,1,2008-06-30 06:16:32,2008-06-27 12:55:23
46dc1b0e332612aa32c139007fa33f4b429de9d1...8009768e89dfe389327654cf9d6868f680ef1f40,1,16,16,32,6,2008-10-18 13:53:46,2008-10-18 08:37:40
8009768e89dfe389327654cf9d6868f680ef1f40...b0b44bc7b26c8c4b4221a377ce6ba174b843cb8d,3,4,8,12,7,2008-10-18 13:53:47,2008-10-18 08:41:33
b0b44bc7b26c8c4b4221a377ce6ba174b843cb8d...59c69c0c656ebce2f7ce870b4913512597a98390,7,18,27,45,16,2008-10-18 13:53:47,2008-10-18 08:44:18
46dc1b0e332612aa32c139007fa33f4b429de9d1...9441b61dc5c3f1f984114ec8bd470dc20c55dfe0,1,58,65,123,19,2008-10-18 13:17:32,2008-10-17 19:57:57
9441b61dc5c3f1f984114ec8bd470dc20c55dfe0...6a87ed972c9c7a4b4378b6e34670d3aa2ac7ccc8,1,39,34,73,12,2008-10-18 13:17:36,2008-10-17 19:57:58
6a87ed972c9c7a4b4378b6e34670d3aa2ac7ccc8...ce3f6dc655392803a59c9b2f2ec9509fd8061b33,1,5,6,11,4,2008-10-20 22:16:23,2008-10-20 20:46:19
ce3f6dc655392803a59c9b2f2ec9509fd8061b33...2b5c208f5bd371ea5527046384f9955dbbceb188,1,65,27,92,9,2008-10-23 01:08:58,2008-10-23 00:59:22
2b5c208f5bd371ea5527046384f9955dbbceb188...9ed19614d4afd86a8d51072ed34c2c44554c3b54,1,3,1,4,2,2008-10-24 05:32:43,2008-10-23 19:05:59
934f788981de941814e821217f32451a5c715d5d...b5ce3a54302cb6e29a02cd8fe4ea55eacea0a86e,2,10,3,13,5,2009-03-08 20:36:09,2009-03-08 18:12:47
b5ce3a54302cb6e29a02cd8fe4ea55eacea0a86e...b92891f9783ae197bb84b90d8404ad08c3875fa1,2,7,4,11,6,2009-03-08 20:36:27,2009-03-08 18:15:08
b92891f9783ae197bb84b90d8404ad08c3875fa1...49b6180252000e37ec47ccb4156240ed625949ed,1,3,0,3,1,2009-03-08 20:36:41,2009-03-08 18:16:58
49b6180252000e37ec47ccb4156240ed625949ed...52e7787609d18af76a8c1befb0a06123fb7ce89e,2,40,81,121,13,2009-03-08 20:37:21,2009-03-08 18:21:53
6331adb9c4ec36c70dc3ecc6eb46b7dddb36952d...9b28d55401a529ff08c709f42f66e765c93b0a20,1,13,2,15,3,2008-11-08 17:28:30,2008-11-08 05:24:33
6331adb9c4ec36c70dc3ecc6eb46b7dddb36952d...19fb896f5b6f3e52370b43e4c9339bcbe4c0f2dd,1,6,2,8,4,2008-11-06 17:26:06,2008-11-02 17:11:13
19fb896f5b6f3e52370b43e4c9339bcbe4c0f2dd...ec26f098a6593bbd9d396fb7ee74368cdd3eeed3,1,1,2,3,1,2008-11-07 00:38:01,2008-11-05 22:15:56
ec26f098a6593bbd9d396fb7ee74368cdd3eeed3...dd7f5f105a1d4d094a96c5e3f251854f81106be0,2,28,1,29,3,2008-11-07 00:38:51,2008-11-05 22:36:23
dd7f5f105a1d4d094a96c5e3f251854f81106be0...dde80d9c23e10592817f0c81e32a99a889a9bb8e,1,6,6,12,6,2008-11-07 00:39:13,2008-11-05 22:10:07
dde80d9c23e10592817f0c81e32a99a889a9bb8e...6abe9c87c78d4925e12e609f4f26447c6a579b9e,1,1,1,2,1,2008-11-09 00:02:32,2008-11-07 22:09:55
6331adb9c4ec36c70dc3ecc6eb46b7dddb36952d...163f3689e94440d1900fbdec4693cfae384be94a,1,3,3,6,3,2008-11-06 08:52:18,2008-10-21 21:12:15
163f3689e94440d1900fbdec4693cfae384be94a...aab57205515d9a74fe20cd51c509f65757b97a66,2,101,3,104,3,2008-11-06 08:52:18,2008-10-30 06:49:26
aab57205515d9a74fe20cd51c509f65757b97a66...6e5121f26e95af02d2bbd6a982e44f16e74a67ce,2,16,5,21,2,2008-11-06 09:39:41,2008-11-06 05:07:39
6331adb9c4ec36c70dc3ecc6eb46b7dddb36952d...bf98421a3363696f3b4c8aedc242bfaadc1ce6f6,3,174,0,174,6,2008-11-05 20:23:48,2008-11-03 18:26:18
bf98421a3363696f3b4c8aedc242bfaadc1ce6f6...89cf4c7004ec329c3171448a154d050c8f75874e,2,10,0,10,5,2008-11-11 22:19:29,2008-11-10 20:43:00
89cf4c7004ec329c3171448a154d050c8f75874e...1dd1239aa33ddd7f159cd183338ef6f71298e29a,2,68,0,68,3,2008-11-12 04:24:18,2008-11-10 20:43:01
1dd1239aa33ddd7f159cd183338ef6f71298e29a...74443f185ed91f3388b0e45838262eb3ec8338aa,1,4,0,4,1,2008-11-12 04:25:49,2008-11-10 20:43:03
a9645b780b698703cd7dee25051d6ce39b0544c6...caf0c3d692a5a4639e48499711271cb279ecd0dc,1,1,3,4,2,2008-11-11 20:19:07,2008-11-10 23:53:59
caf0c3d692a5a4639e48499711271cb279ecd0dc...5df9fcf695a0ba85abfeed68efb3b1c5890068d6,3,57,6,63,14,2008-11-12 04:31:26,2008-11-10 23:54:00
5df9fcf695a0ba85abfeed68efb3b1c5890068d6...8fd5bb7f44b7192a564ebe4f9db376af9fe148ec,2,35,2,37,9,2008-11-12 04:31:29,2008-11-10 23:54:01
8fd5bb7f44b7192a564ebe4f9db376af9fe148ec...beece9dab8e26c98062351536ce0d871a066790e,2,123,73,196,7,2008-11-12 04:31:29,2008-11-10 23:54:02
12d4996622f524e61cbf855b32600150a8c94c02...405923761a8cd12d0047c215b69df9c6aa96723e,1,1,1,2,1,2009-09-03 16:41:56,2009-09-03 11:24:16
6c7f58d6f691c1091b90b0891e94c91e20fd6054...73bb33a94ec67a53e7d805b12ad9264fa25f4f8d,2,10,5,15,6,2009-06-06 20:27:52,2009-06-05 01:33:32
73bb33a94ec67a53e7d805b12ad9264fa25f4f8d...801a011dcf41f0415dee81f0500673e058bdee30,2,8,1,9,4,2009-06-06 20:30:41,2009-06-06 13:11:07
433e972aeb5e485d2f7a7ac605a1c043822e25d9...ceff8e7adeed51024491deb4933f23db760e5641,2,15,23,38,7,2009-06-03 07:49:50,2009-06-03 01:34:01
f9275c68af58e0f65e1557b5109ccbfdbbbc384a...b3f298ab036530274b89a19594a6454bdcf1f760,1,9,3,12,3,2009-06-01 07:41:58,2009-06-01 06:34:46
b3f298ab036530274b89a19594a6454bdcf1f760...1f729dca9334ccadbe78768fc792178f4bb8b6e2,1,1,1,2,1,2009-06-02 05:44:51,2009-06-01 12:14:40
1f729dca9334ccadbe78768fc792178f4bb8b6e2...6e7b5aaf40dac54edcbd7e0a859d26f526ef643e,1,14,7,21,7,2009-06-02 05:44:54,2009-06-01 12:14:41
6e7b5aaf40dac54edcbd7e0a859d26f526ef643e...a5adcbe377de7c8f5d794fce1fe2b23a0bddf758,1,4,2,6,3,2009-06-02 05:45:01,2009-06-01 12:28:25
f9275c68af58e0f65e1557b5109ccbfdbbbc384a...f90cf2b9203e81e3a2b70b15480628e9189b7e60,2,4,1,5,3,2009-06-01 07:07:21,2009-05-31 16:15:15
f90cf2b9203e81e3a2b70b15480628e9189b7e60...900a5d075e8b48025439966dc3863189874bae3b,1,1,1,2,1,2009-06-01 07:08:27,2009-05-31 16:15:16
900a5d075e8b48025439966dc3863189874bae3b...492f70913e11de19bc4cb197b1fe195c645b89c9,1,2,1,3,2,2009-06-01 07:08:54,2009-06-01 06:04:16
492f70913e11de19bc4cb197b1fe195c645b89c9...d9b26333854ce72a05cd077638c41a332f79c779,1,9,0,9,1,2009-06-01 07:10:08,2009-05-31 16:15:18
d9b26333854ce72a05cd077638c41a332f79c779...28a559c0b5aa5bd0d318e06295719b9e677d5035,1,1,0,1,1,2009-06-01 07:20:57,2009-06-01 06:41:45
28a559c0b5aa5bd0d318e06295719b9e677d5035...7b66da2762025fe38ae426bdae5b288a88028e16,1,4,1,5,2,2009-06-01 07:22:01,2009-05-31 16:15:20
7b66da2762025fe38ae426bdae5b288a88028e16...36ad53ffee6ed5b7c277cde660f526fd8ce3d68f,1,6,2,8,4,2009-06-01 07:25:11,2009-05-31 16:15:21
36ad53ffee6ed5b7c277cde660f526fd8ce3d68f...e16c60d9f98c66fd2c9bba64562b3439970c13f8,2,88,0,88,2,2009-06-01 07:25:54,2009-05-31 16:15:22
e16c60d9f98c66fd2c9bba64562b3439970c13f8...f0ed8226c9c65f2a324610258418258229e77fbe,6,7064,0,7064,8,2009-06-01 07:27:39,2009-05-31 16:15:23
f0ed8226c9c65f2a324610258418258229e77fbe...a21077e75f55b4696ada33d7d09f016f4ef16167,2,4,2,6,4,2009-06-08 16:43:37,2009-06-08 14:46:49
a21077e75f55b4696ada33d7d09f016f4ef16167...48c46f1a14b45756b7354bdf2a52be8d93ebfaf3,1,12,2,14,3,2009-06-08 16:44:04,2009-05-31 16:15:25
48c46f1a14b45756b7354bdf2a52be8d93ebfaf3...2ae8239d03c54a3db264be0b8b197b1abd2bde4c,1,1,1,2,1,2009-06-11 21:18:52,2009-06-11 20:52:56
2ae8239d03c54a3db264be0b8b197b1abd2bde4c...021fcd99bdafa43aa2834623d9257a1dea4492c2,1,1,1,2,1,2009-06-11 21:19:10,2009-06-11 20:56:12
f9275c68af58e0f65e1557b5109ccbfdbbbc384a...292687003abcfb68d296c57d7e812b0469f74647,2,6,0,6,2,2009-06-01 00:02:59,2009-01-23 09:06:38
292687003abcfb68d296c57d7e812b0469f74647...680955702990c1d4bfb3c6feed6ae9c6cb5c3c07,4,125,3,128,5,2009-06-01 00:02:59,2009-01-23 09:06:53
680955702990c1d4bfb3c6feed6ae9c6cb5c3c07...f5552aee39d664bb8774c205341abd6db74b38d3,2,12,3,15,3,2009-06-01 00:02:59,2009-01-23 09:07:01
f5552aee39d664bb8774c205341abd6db74b38d3...0e87c36763a384d5bf6fae4bda44fd035c0b75ff,1,5,4,9,4,2009-06-01 00:02:59,2009-01-23 09:07:10
0e87c36763a384d5bf6fae4bda44fd035c0b75ff...a3e826722515ec8abed8ccf29d958eb52d4be3f8,1,75,0,75,1,2009-06-01 00:02:59,2009-01-23 09:07:18
a3e826722515ec8abed8ccf29d958eb52d4be3f8...cc400f50112a58471b992a54b1a05d99a8a82457,2,16,3,19,4,2009-06-01 00:02:59,2009-01-23 09:07:26
cc400f50112a58471b992a54b1a05d99a8a82457...dae556bdb1e2ad6fb5eafe82e975bde01029fca9,9,35,0,35,9,2009-06-01 00:02:59,2009-01-23 09:07:46
dae556bdb1e2ad6fb5eafe82e975bde01029fca9...54b0c1e041e50cc08b1520b7d557770916d0b7ab,5,120,0,120,5,2009-06-01 00:02:59,2009-02-02 05:12:44
54b0c1e041e50cc08b1520b7d557770916d0b7ab...bebdd271ff660d603ad75fef346ad1ff19fca0cb,2,59,1,60,9,2009-06-01 00:03:00,2009-02-02 05:12:53
bebdd271ff660d603ad75fef346ad1ff19fca0cb...451bb210f81c10b60bf90403c9183be26beaaabf,3,13,1,14,3,2009-06-01 00:03:40,2009-02-02 05:12:58
451bb210f81c10b60bf90403c9183be26beaaabf...86af2caa5ac322b1ebda8b4f0aceb9dfafe3e5ba,1,12,6,18,6,2009-06-01 00:03:40,2009-02-02 05:13:06
86af2caa5ac322b1ebda8b4f0aceb9dfafe3e5ba...2aaa84567e37f3c90087b56f9440a1608cac2282,1,1,0,1,1,2009-06-01 00:03:40,2009-04-14 02:01:27
2aaa84567e37f3c90087b56f9440a1608cac2282...0f3a5bfd34bfc9f710d6d7d259ad0a38b37a2334,1,71,0,71,1,2009-06-01 00:03:40,2009-04-13 22:36:59
0f3a5bfd34bfc9f710d6d7d259ad0a38b37a2334...4e65b538acc97dd853e19a1692893f5fd47043e6,1,68,0,68,1,2009-06-01 00:03:40,2009-05-27 05:14:09
e701fadb9e0e51a6811690d95a53bd1f5b6fad86...dbb6a4ada6c6c1065b62313127ff032196e9d232,2,9,1,10,4,2009-05-23 23:29:05,2009-05-23 11:45:26
9831b370b5e50b81faf47d858cd8c6e9e2200204...6096d7598058d920485d206477f4383ba1a862cb,1,6,1,7,1,2009-06-04 05:52:37,2009-06-04 05:52:37
0cfd112032017ab68ed576f6bb5258452084ebf1...5185b9707a768a0ad17de4765c7893f86f4c4a0e,1,1,1,2,1,2013-01-18 20:37:39,2013-01-14 20:59:33
7f5a68ad4d0e00eb2f28405946ec0f2691d7ad81...bedc4279a833dc7f17ea7d1730d9f3e4ff018729,1,2,2,4,1,2009-05-23 08:54:45,2009-05-23 08:04:47
bedc4279a833dc7f17ea7d1730d9f3e4ff018729...352c81114ca436b9e06255f24bf8a7d2fd0a4029,1,3,1,4,3,2009-05-23 08:54:45,2009-05-23 08:04:48
352c81114ca436b9e06255f24bf8a7d2fd0a4029...27e3219f1a78d2d7035565aa7ace882dbc2baa97,1,1,1,2,1,2009-05-23 08:54:45,2009-05-23 08:04:49
27e3219f1a78d2d7035565aa7ace882dbc2baa97...0dbbbc1e26c9979e34031c09c641893123d18450,2,17,0,17,2,2009-05-23 08:54:45,2009-05-23 08:04:50
0dbbbc1e26c9979e34031c09c641893123d18450...b74d779bd90477f6514d0a9be4a75b4c40ed946c,1,3,2,5,1,2009-05-23 08:54:45,2009-05-23 08:04:51
b74d779bd90477f6514d0a9be4a75b4c40ed946c...5ffd3113d4109ae5d3595425af3ff4a781617631,1,4,0,4,1,2009-05-23 17:29:22,2009-05-23 12:26:44
5ffd3113d4109ae5d3595425af3ff4a781617631...7a7eb5173d4e16f0323b2c4078e88fc0a40c38b6,1,31,0,31,3,2009-05-24 17:25:55,2009-05-23 15:31:02
a66037c9755a2beb49bbd915e6f0dd9b1a732925...ebc9529f0358bdb10192fa27bc75f5d4e452ce90,2,41,13,54,7,2009-06-13 17:47:34,2009-06-13 05:21:06
ebc9529f0358bdb10192fa27bc75f5d4e452ce90...32d86ca53195590f8d7df9f5f58683c9a924d5af,1,2,3,5,1,2009-06-13 17:48:59,2009-06-13 11:11:02
6345d7a0d151afc3d2a10ada3ecacf54c3fee2d0...eb127887faa8771f2cf11d6809abfc51eb661e6e,1,16,2,18,3,2009-05-12 09:01:51,2009-05-12 09:01:51
6345d7a0d151afc3d2a10ada3ecacf54c3fee2d0...ad87e4f6f19e78b3f2d7dde3d3ed403db4f79a03,1,12,13,25,7,2009-05-11 04:18:38,2009-05-11 01:21:06
ad87e4f6f19e78b3f2d7dde3d3ed403db4f79a03...dff2b6d4842eef0a03a3c8b3761f72e2b55b609e,1,6,6,12,6,2009-05-11 04:18:49,2009-05-10 00:38:34
dff2b6d4842eef0a03a3c8b3761f72e2b55b609e...34122b57eca747022336f5a3dc1aa80377d1ce56,1,14,11,25,6,2009-05-11 04:19:03,2009-05-11 01:29:40
34122b57eca747022336f5a3dc1aa80377d1ce56...68cedb1fea0bbcd5f7c32ce10e3c346bc6db38c5,1,3,3,6,2,2009-05-11 04:19:13,2009-05-10 00:40:37
68cedb1fea0bbcd5f7c32ce10e3c346bc6db38c5...3278fbc5ce39e0f7bf095ce99912dccbc347b4d7,1,2,2,4,2,2009-05-13 17:33:53,2009-05-11 17:37:28
3278fbc5ce39e0f7bf095ce99912dccbc347b4d7...e8bb4b38dfcbd5ff02ceb5e925d53c1460887df5,1,1,1,2,1,2009-05-13 17:34:11,2009-05-11 17:39:43
e8bb4b38dfcbd5ff02ceb5e925d53c1460887df5...095e914281395f6c0529ce39939d804eb2ccec02,1,4,3,7,1,2009-05-13 17:35:39,2009-05-11 17:42:47
095e914281395f6c0529ce39939d804eb2ccec02...15c54fe7aa9376de2e03045122723ebde09bfeeb,1,2,5,7,2,2009-05-13 17:37:36,2009-05-11 17:45:11
6345d7a0d151afc3d2a10ada3ecacf54c3fee2d0...633e3556ccbcc7e443f5e9194c4a830181696ef0,4,10,12,22,11,2009-05-10 19:41:35,2009-05-10 17:28:18
2f4b97f91071f5060bf2da482cf8b0d70486d808...e0319ff5ed2b7927302389181449dcd029a26622,5,63,1,64,11,2009-05-09 07:29:47,2009-05-07 19:45:08
e0319ff5ed2b7927302389181449dcd029a26622...51a9949eda7421a2dd9cb45b2110d6571ba09bbd,4,42,4,46,8,2009-05-09 07:29:50,2009-05-07 19:45:42
51a9949eda7421a2dd9cb45b2110d6571ba09bbd...1b5fb44ad1131112fcc2b2b082fda61260e31570,1,7,7,14,7,2009-05-09 07:29:53,2009-05-07 19:46:17
1b5fb44ad1131112fcc2b2b082fda61260e31570...3e230fa1b2ba3aa1a207c4399a1b93e41b103dfb,2,194,240,434,9,2009-05-09 07:29:56,2009-05-07 19:46:48
3e230fa1b2ba3aa1a207c4399a1b93e41b103dfb...ff3c7f9a264da41a2cd7b7a28a27f8ad935b81a9,1,10,8,18,8,2009-05-21 01:16:25,2009-05-20 22:05:22
2f4b97f91071f5060bf2da482cf8b0d70486d808...e9008b9a44f46e97f39c424240ade0a6e6429cab,1,1,1,2,1,2009-05-09 07:29:07,2009-05-08 05:01:17
57343652a55bdc3e7f3cf8c6def94dac482c72e5...3af1cae469555485cd3ef003aa2a55bd2a4f544f,2,19,3,22,3,2009-10-04 21:44:34,2009-06-09 06:26:44
86079872238041fa0e2aa6b8a94f7881f88e4316...242a90778bb8740ffa7957b462a2c6a5f0b0278e,1,16,0,16,1,2009-06-06 17:56:27,2009-06-06 08:43:23
242a90778bb8740ffa7957b462a2c6a5f0b0278e...86d99f6d5ce1120b23a2453168165ac45e039411,1,20,0,20,1,2009-06-06 17:56:27,2009-06-06 08:43:24
86d99f6d5ce1120b23a2453168165ac45e039411...4f66250df641362f381faae2aec439850a5a6e41,2,28,13,41,8,2009-06-06 17:56:27,2009-06-06 08:43:27
4f66250df641362f381faae2aec439850a5a6e41...68862a3152691424a146a98ce52308e09faf5bb9,1,2,0,2,2,2009-06-06 17:56:27,2009-06-06 08:43:31
68862a3152691424a146a98ce52308e09faf5bb9...96a4f187353d176d8fa32242875ffdad2ba38a0a,1,8,0,8,1,2009-06-06 17:56:27,2009-06-06 08:43:32
96a4f187353d176d8fa32242875ffdad2ba38a0a...4c42aa1a1359b2571b51c3a3093f29c7b25c54c4,2,79,52,131,39,2009-06-06 17:56:27,2009-06-06 08:43:33
4c42aa1a1359b2571b51c3a3093f29c7b25c54c4...48188c259a7e6c87c20121933287b8c8ca721e3a,1,30,3,33,9,2009-06-06 17:56:27,2009-06-06 08:43:34
48188c259a7e6c87c20121933287b8c8ca721e3a...20cfb3aa710d302829a776d7fbad2b89f71f15b6,2,47,45,92,19,2009-06-06 17:56:27,2009-06-06 08:43:36
20cfb3aa710d302829a776d7fbad2b89f71f15b6...1b1b7b235b040f27952d48ab8811c958a1f6d052,1,2,0,2,1,2009-06-06 17:56:27,2009-06-06 08:43:37
1b1b7b235b040f27952d48ab8811c958a1f6d052...4277c6709d1976ee5cef33b7e415ae0dded87090,1,5,3,8,4,2009-06-06 17:56:27,2009-01-18 08:04:26
4277c6709d1976ee5cef33b7e415ae0dded87090...df005219dd4a4c7c310c1e1ab5946f9ba69cc82d,1,1,0,1,1,2009-06-06 17:56:27,2009-06-06 08:43:40
df005219dd4a4c7c310c1e1ab5946f9ba69cc82d...e917674597cc0b345ad2d6e29fd1a03e1039615a,4,20,20,40,24,2009-06-06 17:56:27,2009-06-06 08:43:41
e917674597cc0b345ad2d6e29fd1a03e1039615a...5ace994f3384726fa993de526fc059d1343a6463,1,9,3,12,3,2009-06-06 17:56:27,2009-06-06 08:43:43
5ace994f3384726fa993de526fc059d1343a6463...e929cd20bb3557833765f95fe0e9143a47f806e7,2,134,0,134,2,2009-06-06 17:56:27,2009-06-06 08:43:53
e929cd20bb3557833765f95fe0e9143a47f806e7...28307b99ddb8e7284793d5ec830af10f130fa287,1,12,22,34,3,2009-06-06 18:03:07,2009-06-06 08:43:54
28307b99ddb8e7284793d5ec830af10f130fa287...0d5896e1cc1cb6145526b6786c7720cfe8231709,1,8,25,33,3,2009-06-06 18:03:10,2009-06-06 08:43:55
0d5896e1cc1cb6145526b6786c7720cfe8231709...446b941a57d96e0c02375534b6b3f6816e7364e5,1,12,19,31,3,2009-06-06 18:03:11,2009-06-06 08:43:57
446b941a57d96e0c02375534b6b3f6816e7364e5...9af5abd9939585bb588d537085138563922c6abe,1,3,17,20,2,2009-06-06 18:03:11,2009-06-06 08:43:58
9af5abd9939585bb588d537085138563922c6abe...b8caac2b8ab6482e7ab59c8ec18f1c3d90e7387d,4,186,345,531,11,2009-06-06 18:03:11,2009-06-06 08:43:59
b8caac2b8ab6482e7ab59c8ec18f1c3d90e7387d...39dc52cf4ff04e9cd4d2562218ad619e23a81efa,1,8,73,81,6,2009-06-06 18:03:11,2009-06-06 08:44:00
39dc52cf4ff04e9cd4d2562218ad619e23a81efa...2264dfa5c4f11e2b0e2740072208186bee361afd,4,167,151,318,34,2009-06-06 18:03:11,2009-06-06 08:44:01
2264dfa5c4f11e2b0e2740072208186bee361afd...5424bc557fc6414660830b470dd45774b8f5f281,4,336,431,767,61,2009-06-06 18:03:11,2009-06-06 08:44:02
d00e364de99d51bb76e437820e23cfa820417ec5...d11b8d342529a8fe2164ceb563ad9213902d3533,3,22,7,29,12,2009-05-20 18:07:07,2009-05-20 18:04:35
d11b8d342529a8fe2164ceb563ad9213902d3533...b87fc96476c4218de044cf77b4c6d10d49aee78a,1,2,0,2,1,2009-05-25 18:35:19,2009-05-20 22:53:57
b87fc96476c4218de044cf77b4c6d10d49aee78a...aceae2ef9261718324bf1853401d5ee9686a54a8,1,32,37,69,10,2009-05-25 18:35:29,2009-05-23 06:06:58
aceae2ef9261718324bf1853401d5ee9686a54a8...b65982b60876c8f5f4d3b2898d5174f4812552b1,5,55,0,55,7,2009-05-25 18:35:29,2009-05-20 22:57:22
b65982b60876c8f5f4d3b2898d5174f4812552b1...a0919ced8a5efe938cf97c74a0f851cbbe00aaf6,2,8,2,10,3,2009-05-25 18:35:29,2009-05-23 06:14:25
75b44066f3ed7cde238cdea1f0bf9e2f1744c820...b74fce16fa51362d4a3875d46e488006c3ad5371,3,23,8,31,12,2009-05-02 05:06:41,2009-05-01 20:56:47
75b44066f3ed7cde238cdea1f0bf9e2f1744c820...4b25d091ba53c758fae0096b8c0662371857b9d9,25,64,64,128,60,2009-05-01 22:17:31,2009-05-01 09:06:36
4b25d091ba53c758fae0096b8c0662371857b9d9...1087aba86b4a687cabf03d4a060d4b51282819d3,1,1,1,2,1,2009-05-01 23:07:29,2009-05-01 20:03:07
1b89eaa4bef44ef84f2af611d5db8727e3be266c...078688213f321ac52c224c1cfa264d686c7264bd,1,8,4,12,4,2009-04-12 20:34:06,2009-04-12 19:22:02
91408042768c05347c1b9f081a00387ca07b26fe...d5c87cb4ffc411fc12dbc261af3ed29633e49fba,1,3,3,6,3,2009-03-24 04:02:21,2009-03-24 01:09:09
d5c87cb4ffc411fc12dbc261af3ed29633e49fba...eca2a8f0236a3b5b2c3afca2643d433a51a205fe,1,7,8,15,5,2009-03-24 04:02:25,2009-03-24 01:09:10
eca2a8f0236a3b5b2c3afca2643d433a51a205fe...f198e218494800787909af0f3985350c3ecc27b2,1,2,2,4,1,2009-03-24 04:02:26,2009-03-24 01:09:11
f198e218494800787909af0f3985350c3ecc27b2...78509d2197ff18d1de02c27a5406328f75b95306,1,1,1,2,1,2009-03-24 04:02:26,2009-03-24 01:09:12
78509d2197ff18d1de02c27a5406328f75b95306...2fd8c0a5dbc614a6a7853558e4af8298acefc96a,1,3,4,7,2,2009-03-24 04:02:26,2009-03-24 01:09:13
2fd8c0a5dbc614a6a7853558e4af8298acefc96a...c36d785da022cb7f7860ed85d78add3f102c4969,1,1,2,3,1,2009-03-24 04:02:27,2009-03-24 01:09:14
c36d785da022cb7f7860ed85d78add3f102c4969...33fa4d3dfe71dec05da35e187433101486f4eac2,1,1,2,3,1,2009-03-24 04:02:27,2009-03-24 01:09:15
33fa4d3dfe71dec05da35e187433101486f4eac2...5620e77e30b72e674a6bec55fd4bfdac2d5a75fd,1,1,1,2,1,2009-03-24 04:02:27,2009-03-24 01:09:16
5620e77e30b72e674a6bec55fd4bfdac2d5a75fd...edbc25c5b377d6fe768cefcc8614cd254a9fc4ff,1,3,5,8,3,2009-03-24 04:02:28,2009-03-24 01:09:17
91408042768c05347c1b9f081a00387ca07b26fe...431b1969fcde69959a23355fba6894fb69c8fa0c,6,11,11,22,11,2009-03-23 06:36:47,2009-03-21 19:51:34
431b1969fcde69959a23355fba6894fb69c8fa0c...a552de75eb01f78046feaf7dc88e5e4833624ad5,6,18,22,40,9,2009-03-23 06:44:08,2009-03-21 20:17:30
a552de75eb01f78046feaf7dc88e5e4833624ad5...a31dca0393fefae894b7a155ae24000107bcc383,2,22,0,22,5,2009-03-23 06:52:06,2009-03-21 21:19:53
a31dca0393fefae894b7a155ae24000107bcc383...03d3aada5a2a68a7acdb6286fd72155f01626e41,1,7,7,14,5,2009-03-23 06:52:11,2009-03-21 20:23:27
03d3aada5a2a68a7acdb6286fd72155f01626e41...a2fab531bbb00ff64335906e22854365be2eb5c7,6,17,17,34,9,2009-03-23 06:52:11,2009-03-21 21:35:51
a2fab531bbb00ff64335906e22854365be2eb5c7...cbdffe4093be77bbb1408e54eead7865dd3bc33f,3,28,7,35,12,2009-03-24 07:53:03,2009-03-21 20:27:31
cbdffe4093be77bbb1408e54eead7865dd3bc33f...3e262b95c50991de12cc5e180b72256561606a19,2,5,0,5,3,2009-03-25 00:02:20,2009-03-24 23:31:01
a9ed6ce0e7057b94809d3c51094ba96fe96fded8...b296e8fce6de6a40a41b5168dfbe735d11255256,3,41,2,43,3,2009-01-29 08:12:52,2009-01-29 08:12:52
ba743d1b0ce0b44c797c0de06c9db2781e4d1fdd...c375e9d04cbcaaca7ae459437d185eda0a4472b4,1,31,2,33,6,2009-02-07 12:48:48,2008-11-23 13:16:22
c375e9d04cbcaaca7ae459437d185eda0a4472b4...811b10c746a63d1818d52c9ecbf247d9a3891597,1,14,0,14,3,2009-02-07 12:48:54,2008-11-23 13:25:50
811b10c746a63d1818d52c9ecbf247d9a3891597...ab69e3e43a12cf02505f3e9e561c49c1fe8a81a6,1,42,0,42,3,2009-02-07 12:48:54,2008-11-23 13:34:48
ab69e3e43a12cf02505f3e9e561c49c1fe8a81a6...a7da5c425970372f75d7cc2c194d5646554f8a32,1,19,19,38,4,2009-02-07 12:48:54,2008-11-23 15:12:45
a7da5c425970372f75d7cc2c194d5646554f8a32...efd49f50fc087df2ad46f194ca848c5335f4cca9,1,1,0,1,1,2009-02-07 12:48:54,2009-01-27 10:59:54
efd49f50fc087df2ad46f194ca848c5335f4cca9...6c4f70d5b2fb8f9275ca85e0927f00b8bc892819,1,15,15,30,8,2009-02-07 13:01:44,2009-02-07 13:01:26
6c4f70d5b2fb8f9275ca85e0927f00b8bc892819...5a7b3bf5275adf86fdd23f8824562b88c8a20e33,1,10,2,12,3,2009-02-07 14:14:22,2009-02-07 13:21:58
5a7b3bf5275adf86fdd23f8824562b88c8a20e33...7851386948dce72c739bcdfe08f069afe4f5ea45,2,1,217,218,2,2009-02-07 14:14:27,2009-02-07 13:24:54
ba743d1b0ce0b44c797c0de06c9db2781e4d1fdd...2c3c395e84409c278bd7b050877c36d04b952056,2,10,23,33,3,2009-02-07 08:45:29,2009-02-07 03:24:28
ba743d1b0ce0b44c797c0de06c9db2781e4d1fdd...31ca3ac30fe3c2583881a74ef346911c8fba478f,2,22,4,26,6,2009-02-07 08:44:49,2009-02-05 22:18:32
e5887c1bda12b31ea7af0ce798bfdee308e1b176...bed5122f23c3584f2bae43e1af2f41fbe939c971,1,1,1,2,1,2009-02-18 18:42:33,2009-02-17 09:25:02
bed5122f23c3584f2bae43e1af2f41fbe939c971...d61027b21f403a74ba16191756d22717a2e95bd4,3,8,0,8,4,2009-02-18 18:55:33,2009-02-18 06:48:06
d61027b21f403a74ba16191756d22717a2e95bd4...91e80b984e0afda37d288e550fb5832d2b71568c,2,3,3,6,2,2009-02-18 19:17:27,2009-02-18 19:17:27
7b73d828f02e885f4e9619ff1a2b43e3d8dcf259...e5f5050ed1481c3bc27658f625a87155aed0984f,1,3,1,4,1,2009-02-11 18:38:53,2009-02-10 16:43:30
e5f5050ed1481c3bc27658f625a87155aed0984f...0ea29cce4d099d2fa6613ec66c080776cfe869d5,2,18,12,30,10,2009-02-12 02:26:52,2009-02-11 21:10:41
1b53a076fc3e3dc58e67971df18df0ce973a3ff9...fa26a401bed5967d6118ac430c5c5f4707c54386,1,2,2,4,2,2009-02-11 19:09:16,2009-02-11 18:03:23
fa26a401bed5967d6118ac430c5c5f4707c54386...ad244d256865c06804afffef32b753239a06119e,1,11,20,31,8,2009-02-11 19:09:16,2009-02-11 18:03:24
ad244d256865c06804afffef32b753239a06119e...e5dd864adfeb8b0176b31a132e972d7f7beff32a,1,22,14,36,3,2009-02-11 19:09:16,2009-02-11 18:03:25
e5dd864adfeb8b0176b31a132e972d7f7beff32a...5c9cc64a4a608ab0bbd5eb5c8e405bfe050be309,1,4,4,8,4,2009-02-11 19:09:17,2009-02-11 18:03:26
5c9cc64a4a608ab0bbd5eb5c8e405bfe050be309...f50edca56c40cbfe48734eacd5d79416ba3649eb,1,8,2,10,3,2009-02-23 23:23:39,2009-02-21 14:48:43
f50edca56c40cbfe48734eacd5d79416ba3649eb...ddb6d010231432ba75cf109aa7cd282912c88d2d,1,6,7,13,3,2009-02-25 05:45:04,2009-02-21 14:48:43
1b53a076fc3e3dc58e67971df18df0ce973a3ff9...4c58a7111d9fb4f62ca041fc73e8aec0a2f9c800,3,38,0,38,5,2009-02-11 10:00:42,2009-02-01 01:31:12
4c58a7111d9fb4f62ca041fc73e8aec0a2f9c800...8e3f9b17a5186c8122eebf5cefdf6062a21f07d9,1,24,16,40,2,2009-02-11 10:00:42,2007-06-26 07:23:59
8e3f9b17a5186c8122eebf5cefdf6062a21f07d9...99366565f1a78f9089c0e505ddaee47b31928f1d,1,3,0,3,1,2009-02-11 10:00:42,2009-02-09 00:33:18
99366565f1a78f9089c0e505ddaee47b31928f1d...8841b37f2f5ce74359e150254dd138602eb418a7,1,6,5,11,5,2009-02-11 10:02:04,2009-02-11 09:56:58
8841b37f2f5ce74359e150254dd138602eb418a7...39111f6b7aeb5a7bc57731a6c8f0c3b8178873c8,2,208,0,208,2,2009-02-11 10:02:04,2009-02-10 22:38:45
1b7e543a6e2f156536a3cf227f9da1029bba6265...901c369af52ffcc8c08457fb5b330eab217a9cfb,1,24,0,24,1,2009-02-20 08:01:57,2009-02-19 11:13:35
901c369af52ffcc8c08457fb5b330eab217a9cfb...85569d7498f3933d96a7604512f8832c73127067,1,8,0,8,1,2009-02-20 08:02:40,2009-02-19 11:13:36
85569d7498f3933d96a7604512f8832c73127067...f37bfb7a4d965e821591c98e66fe7a4e396377b5,2,4,0,4,2,2009-02-20 08:02:48,2009-02-19 11:13:37
f37bfb7a4d965e821591c98e66fe7a4e396377b5...289e162318bbf4b0f90dd70371046e1b20d4c0be,1,148,0,148,1,2009-02-20 08:02:48,2009-02-19 11:13:38
289e162318bbf4b0f90dd70371046e1b20d4c0be...02a6552c28eabb524fcd23e8f5bd36e4f5afa63b,1,67,0,67,1,2009-02-20 08:02:48,2009-02-19 11:13:39
02a6552c28eabb524fcd23e8f5bd36e4f5afa63b...28fd76bd0413e386ce5176cfac0fad7317145b91,2,35,0,35,2,2009-02-20 08:02:48,2009-02-19 11:13:40
28fd76bd0413e386ce5176cfac0fad7317145b91...fcbc6efc7c56973e0a308012d2ae1b42c6b11a33,3,17,0,17,3,2009-02-20 08:02:48,2009-02-19 11:13:41
fcbc6efc7c56973e0a308012d2ae1b42c6b11a33...b26d8d217d8d960cbd9ed1dbf6b3cccfd1a3a4db,1,38,0,38,1,2009-02-20 08:02:48,2009-02-19 11:13:42
1b7e543a6e2f156536a3cf227f9da1029bba6265...8851f4800c15fe91b6a53e9e284787b983226c41,2,52,10,62,10,2009-02-18 18:53:49,2009-02-17 06:43:43
1b7e543a6e2f156536a3cf227f9da1029bba6265...d532ebd5a799fe2c991a96004bf739434e6ecaf4,1,1,0,1,1,2009-02-16 22:51:24,2009-02-15 13:25:11
d532ebd5a799fe2c991a96004bf739434e6ecaf4...4a5856cb249579845e24713225bc1749a9b20482,1,25,6,31,7,2009-02-16 22:53:06,2009-02-14 16:21:53
4a5856cb249579845e24713225bc1749a9b20482...81d3fe9f4871e42ebd1af0221fa091fe5476e2f7,2,26,8,34,6,2009-02-17 00:19:07,2009-02-15 09:18:36
e98c6a168635f3fedadc3963680eba69d2e42324...3cf3b838c7b379824c68ee87799aaaa9028b36cd,1,38,1,39,4,2009-01-14 07:41:32,2009-01-14 07:41:32
5bcce8494a2ee09250404b8b086cbd62f9506703...912f9980d233961c48a225cce2657f165c98c8ae,1,10,1,11,1,2008-11-11 21:12:17,2008-11-11 21:12:17
912f9980d233961c48a225cce2657f165c98c8ae...0a2bb55848c031f431d8507d0083247ece126b8f,1,1,1,2,1,2008-11-11 21:24:00,2008-11-11 15:52:31
0a2bb55848c031f431d8507d0083247ece126b8f...989206f535dcd0f43356ad38e1d54cb833d96fc2,1,1,1,2,1,2008-11-11 21:48:04,2008-11-11 21:09:16
989206f535dcd0f43356ad38e1d54cb833d96fc2...9db56f71b91153f4076a796c80c61f00edd8b700,8,12,12,24,12,2008-11-11 22:43:59,2008-11-10 21:07:52
bf516ecaac4d7fca840f55e2534066227aa639be...8052e788b5e9ae2e2d06b5050fa73394ffe0993a,1,1,0,1,1,2009-04-08 14:38:11,2009-04-06 19:59:28
8052e788b5e9ae2e2d06b5050fa73394ffe0993a...fb25092a88ba889f540beaf9acdb208421ce2a20,2,2,2,4,2,2009-04-08 14:40:58,2009-04-07 15:33:35
122ee5442039fd006911cd964b149c776476ee8d...3eb5682b0b1c16c1b9232f04aff13bd189573b4d,1,29,4,33,4,2009-04-05 19:29:10,2009-04-05 01:48:21
3eb5682b0b1c16c1b9232f04aff13bd189573b4d...f0d4eec99f2367bad77ec46680d7b07d4472d230,1,3,3,6,2,2009-04-05 19:45:40,2009-03-30 18:35:57
f0d4eec99f2367bad77ec46680d7b07d4472d230...c9498339a40566c736a85238c29fd45d63510abe,1,39,4,43,7,2009-04-05 19:58:26,2009-03-30 19:46:17
c9498339a40566c736a85238c29fd45d63510abe...454efb47b6199f70ec7992ea4bf459f193a43bb7,1,1,1,2,1,2009-04-05 20:05:29,2009-03-31 23:55:36
454efb47b6199f70ec7992ea4bf459f193a43bb7...b01d4326040ec6b9d98baba32091c9458fc809d4,1,6,1,7,1,2009-04-05 20:06:24,2009-03-31 23:55:39
5832d1a9da78273652c213d8e1535c09dd7dc079...879ef2485d6ced20845ca626ecb45a9b65aa3a70,9,107,0,107,12,2008-12-21 10:47:21,2008-12-20 12:05:14
879ef2485d6ced20845ca626ecb45a9b65aa3a70...055a5975258f37eecdfcf609a472ab4957a59263,6,179,0,179,6,2008-12-21 10:47:22,2008-12-20 12:05:33
055a5975258f37eecdfcf609a472ab4957a59263...2dd625d022074bb677bdd5caa5146cabaf726123,1,102,11,113,5,2009-01-12 03:17:45,2008-12-20 12:05:47
2dd625d022074bb677bdd5caa5146cabaf726123...009318b1f1db24588d93bc658ea6c6a5324c9c3c,1,98,0,98,1,2009-01-12 03:17:48,2008-12-20 12:06:03
009318b1f1db24588d93bc658ea6c6a5324c9c3c...bb1dff9def343a7d513eea8f4eaa5fd7d5d3fc5f,1,4,6,10,3,2009-01-13 08:14:14,2009-01-12 14:16:04
bb1dff9def343a7d513eea8f4eaa5fd7d5d3fc5f...22a3d060937072b0f197a8084af879c753c68fe7,2,38,7,45,5,2009-01-14 22:54:41,2009-01-13 19:57:16
5832d1a9da78273652c213d8e1535c09dd7dc079...08fc0608657ee91bc85276667804c36a93138c7d,3,136,2,138,3,2008-12-21 09:10:48,2008-12-15 17:34:37
08fc0608657ee91bc85276667804c36a93138c7d...753bc911f489748a837ecb5ea4b5216220b24845,1,6,8,14,5,2008-12-21 09:12:48,2008-12-20 06:19:46
753bc911f489748a837ecb5ea4b5216220b24845...a128a2cdc35cdf0eff7eeb1c21b912209f133633,1,179,0,179,1,2008-12-21 09:48:07,2008-12-20 11:27:02
a128a2cdc35cdf0eff7eeb1c21b912209f133633...8f1482536ad680fcd738158e76e254a534f2e690,1,2,2,4,1,2008-12-21 09:48:23,2008-12-21 01:12:11
8f1482536ad680fcd738158e76e254a534f2e690...c55fae43c4e10e2779e4fb7d70d6f6e4a7645a63,1,7,4,11,3,2008-12-21 09:48:26,2008-12-21 01:28:48
c55fae43c4e10e2779e4fb7d70d6f6e4a7645a63...0693f9ddad3d9af3d3424087557bbddce480ce3f,2,18,0,18,2,2008-12-21 09:56:20,2008-12-19 01:31:57
0693f9ddad3d9af3d3424087557bbddce480ce3f...2f0e7cbbb0703d510a761e2892727e84b3cdcbec,1,1,1,2,1,2008-12-21 09:57:59,2008-12-21 09:57:59
2f0e7cbbb0703d510a761e2892727e84b3cdcbec...b3eae84dc10e452add0e79c7373ceee16f73f7f0,1,1,1,2,1,2008-12-21 10:00:31,2008-12-21 10:00:31
5832d1a9da78273652c213d8e1535c09dd7dc079...03c4829347e26c844e589c61567a77a77c0658a9,1,44,11,55,8,2008-12-21 09:08:37,2008-12-15 10:05:30
03c4829347e26c844e589c61567a77a77c0658a9...f5b49ea6191c2d631d1d70305b25d5db3bf05c92,2,2,3,5,3,2008-12-21 09:08:51,2008-12-15 10:05:31
f5b49ea6191c2d631d1d70305b25d5db3bf05c92...4fb1a19d502f4a2ca47bfb75cce605f3447819e6,2,13,3,16,2,2008-12-24 08:14:08,2008-12-22 21:16:51
8b75d31c945c9361331db8cd554f25a8ea6abc4a...7a38329130f05e00ad73c2794d94b869f16bca2f,1,27,0,27,2,2009-01-18 07:43:31,2009-01-15 00:48:24
7a38329130f05e00ad73c2794d94b869f16bca2f...a83c88525ed6d8d940f8cf7f21e92b189f7844e3,1,19,0,19,1,2009-01-18 07:44:33,2009-01-09 22:14:39
c0a4ae5caf220f97371e8b2c124d50fdd7663cf1...76bac89036abd73a4a32fd494a34dcc3340fef1a,3,5,5,10,5,2008-11-27 09:17:23,2008-11-27 07:32:01
76bac89036abd73a4a32fd494a34dcc3340fef1a...608efb875f89a946d5cb37b2dd4077132618e0e1,1,15,4,19,2,2008-11-28 02:34:30,2008-11-28 00:46:38
6a6baf9b4e819a0bbfd70627f966cd7144dd8301...96d1a8e9d44fd635fad8466dbe0aab6d73495c9f,1,2,2,4,2,2008-09-20 22:30:17,2008-09-20 22:30:12
0a1a1c8615ec0049d2d7fcd849cfddd978170752...5d6b3a9ef80a8bcd77b57ea14d4284b022b95a1f,2,6,6,12,3,2008-10-01 15:18:46,2008-09-30 17:27:10
5d6b3a9ef80a8bcd77b57ea14d4284b022b95a1f...b1524ee0f3a34d76639090c988523550026cc98b,1,6,3,9,2,2008-10-01 15:21:22,2008-09-30 19:57:50
9fe7a643fcc56ca1c17afec5d5f8adca10cabdd1...18378655be4e48360241d81d7bafd9e7aa622560,1,1,1,2,1,2008-10-28 15:56:47,2008-08-24 20:23:25
18378655be4e48360241d81d7bafd9e7aa622560...1df2a1ce806de11d382816644cc971d16aab06b7,1,1,1,2,1,2008-10-28 15:57:08,2008-09-10 11:03:18
1df2a1ce806de11d382816644cc971d16aab06b7...6e381d3aff89e09d13bd855ed6e18b0aa6f1e441,1,1,1,2,1,2008-10-28 15:58:42,2008-10-27 20:06:16
6e381d3aff89e09d13bd855ed6e18b0aa6f1e441...d258b25887f763db96c20d4ec805ae685f55bdd1,1,2,1,3,2,2008-10-30 21:01:00,2008-10-28 17:27:33
d258b25887f763db96c20d4ec805ae685f55bdd1...9b6f84d2c2ff84ac3ef2215b6ea8ee45b6d943cd,1,20,0,20,1,2008-10-31 06:41:28,2008-10-30 10:45:03
9b6f84d2c2ff84ac3ef2215b6ea8ee45b6d943cd...0ea9ca07aa76bef80c066b1a70366cf90caa703d,1,70,21,91,13,2008-10-31 07:19:52,2008-10-30 09:00:29
0ea9ca07aa76bef80c066b1a70366cf90caa703d...111539a3c75c22df7f1bbe242ce2f886b01d2491,1,1,1,2,1,2008-10-31 07:34:41,2008-10-30 10:20:27
111539a3c75c22df7f1bbe242ce2f886b01d2491...41d8cf7d7fd79fe1fd00b04052c49bffaedfd309,1,2,0,2,1,2008-10-31 07:46:27,2008-10-31 00:04:46
41d8cf7d7fd79fe1fd00b04052c49bffaedfd309...2c850f1221efd2441c3794e163ea3918ce31c15b,1,2,2,4,1,2008-10-31 08:07:10,2008-10-30 18:14:33
2c850f1221efd2441c3794e163ea3918ce31c15b...e855bfc0404d3344787541c1bdaa1e8d44398eb3,1,1,1,2,1,2008-10-31 08:22:48,2008-10-31 04:10:25
9fe7a643fcc56ca1c17afec5d5f8adca10cabdd1...108bebeab31881654b7b0f1b5b393a6655d74d3f,2,18,0,18,2,2008-10-27 05:08:58,2008-10-26 21:59:13
108bebeab31881654b7b0f1b5b393a6655d74d3f...94cc355287a7efc3eda76af6ae31f503a1ac098b,1,4,2,6,3,2008-10-27 05:10:28,2008-10-26 22:07:24
94cc355287a7efc3eda76af6ae31f503a1ac098b...9fa03c177ff826b439537072338af958fe01c257,1,2,2,4,1,2008-10-27 05:10:28,2008-10-26 22:08:52
e77b0b5d0fdac411607dbae11ccad87dccd332d3...e00f3790b88ce61f1bdc863011a122b98b43197e,1,12,6,18,6,2008-05-23 22:52:20,2008-05-23 14:13:05
a473445ac256f4a6ca5c66f83f33b85eec0e0c48...e4d594c6bdcb25b996120fe21c901af7a08a7f6d,1,4,0,4,1,2008-05-16 20:13:24,2008-05-16 19:43:50
28bc30220f30850a10217d61f73e46d8a541e670...4ed19a3c178d22fbd424af78b42b65533a8d1ebb,2,27,4,31,4,2008-06-04 20:08:03,2008-06-04 19:06:31
2dd620286e84e4e76226a3511af6d14755b8c809...9872cd6f6c40803db9e784b6287db72e0cb6b5c3,1,68,1,69,8,2008-12-21 09:11:22,2008-12-18 07:13:16
9872cd6f6c40803db9e784b6287db72e0cb6b5c3...2020985464ba0135f717cd14309ac63a8dfda341,1,4,3,7,3,2008-12-21 09:11:28,2008-12-18 07:13:17
2020985464ba0135f717cd14309ac63a8dfda341...a3411f8a2d3acc311991cf2221efa9de81cd03f7,1,14,1,15,3,2008-12-21 09:11:31,2008-12-18 07:13:18
a3411f8a2d3acc311991cf2221efa9de81cd03f7...75bf2cb2983865760464ecec3fa1cd6f9d3719d5,1,28,2,30,6,2008-12-21 09:11:33,2008-12-18 07:13:19
a41ddbb649c72214a4861827eedc7b2eebe0608f...097e11182213afa4166c0fe58bd8135d71b52fb5,1,2,2,4,2,2009-08-13 11:49:09,2009-07-21 08:09:48
097e11182213afa4166c0fe58bd8135d71b52fb5...ffe15297b031814c5cda5d82a6555683c8e80dcc,1,15,3,18,11,2009-08-13 11:49:10,2009-08-03 21:53:36
ffe15297b031814c5cda5d82a6555683c8e80dcc...2b1fbf90aa9c0fb2a1033793728aebf77c11334d,1,1,1,2,1,2009-08-13 11:49:11,2009-08-05 21:15:36
2b1fbf90aa9c0fb2a1033793728aebf77c11334d...9bf3acfadafe9e5961296ff22a1677a9f5afe508,1,6,1,7,2,2009-08-13 11:49:12,2009-08-13 07:25:03
1d035f85649cbb0a4fcc3e341f7e854acf9cf3c1...8d1b9d23a04f43f45bd3b20616936fcdd3021446,1,17,0,17,2,2009-03-04 04:16:49,2009-03-03 16:49:29
8d1b9d23a04f43f45bd3b20616936fcdd3021446...c0bc2eeb1e03593ca816f63deda662da5a25ab83,4,6,6,12,5,2009-03-04 05:40:36,2009-03-03 19:29:20
c0bc2eeb1e03593ca816f63deda662da5a25ab83...5a4aaaf3aa2ef02b6b397206cf222643b68b36c7,1,1,1,2,1,2009-03-04 05:42:44,2009-03-03 19:29:21
5a4aaaf3aa2ef02b6b397206cf222643b68b36c7...a1070d4cbbf1002cc0b01afc3de06382deb0511a,3,4,4,8,4,2009-03-04 05:43:19,2009-03-03 19:29:22
1d035f85649cbb0a4fcc3e341f7e854acf9cf3c1...0e757e30c726d9d8ae82bd9989be3cff5d230288,2,37,0,37,3,2009-03-03 18:56:22,2009-03-03 09:55:31
768c728e7c706ab8d39e0dbf2aa4d1a465930728...8104ebfe8276657ee803cca7eb8665a78cf3ef83,2,9,0,9,2,2008-12-25 03:41:08,2008-12-25 03:41:08
d70bb6233272c46b53a697bf620ec8dcd2550de3...7963791e1f44f3053f47f98628cf1729030eab76,1,1,1,2,1,2010-02-03 21:49:00,2010-02-03 21:49:00
df63fbbf46c5ec855132f4c631c32b45f67b42e4...fb098a942b925296e0e86b6935a4fdda872e2f99,1,2,2,4,2,2009-01-07 03:33:24,2009-01-02 11:34:40
fb098a942b925296e0e86b6935a4fdda872e2f99...ae35785e3a205cea04d228b00461f4906548fcc3,1,5,1,6,1,2009-01-11 01:43:02,2009-01-02 12:49:30
df63fbbf46c5ec855132f4c631c32b45f67b42e4...ea718e65fab17297a8a9dbebf63ae99096e9537a,1,6,15,21,2,2009-01-05 18:52:28,2009-01-02 18:08:43
ea718e65fab17297a8a9dbebf63ae99096e9537a...e89e2ed7c225cf16cffbd9648895528e471e2fb8,1,1,1,2,1,2009-01-05 18:55:27,2008-12-29 15:05:46
44701c67fd1d5d771b440c8646b7b268d4f1402d...f95ebf74296077d5fdccaa2668edc527841db521,2,46,10,56,5,2008-07-07 20:23:42,2008-07-04 15:19:52
44701c67fd1d5d771b440c8646b7b268d4f1402d...22e407951ef2572c1e68a39364fd3c4b649a3495,3,3,1,4,3,2008-07-07 20:12:56,2008-07-07 07:16:38
22e407951ef2572c1e68a39364fd3c4b649a3495...9869099bee332e4c351c3aaa15a74786d85909c7,3,11,2,13,3,2008-07-08 20:13:03,2008-07-08 04:12:22
44701c67fd1d5d771b440c8646b7b268d4f1402d...22568f0a336ac37ae7329c917857b455839d1d09,1,11,2,13,2,2008-07-07 08:31:24,2008-07-05 21:26:40
7829f20f5beabe3e21866ae53109a58370571158...a0d2ceb2769731571cdd195582bfedf90225e712,1,4,1,5,1,2008-06-30 06:47:26,2008-06-30 03:27:45
52e7787609d18af76a8c1befb0a06123fb7ce89e...521537476fe99b97bfcdf1b8f0c579061af5fd3e,5,104,5,109,8,2009-03-17 21:50:21,2009-03-16 15:42:51
52e7787609d18af76a8c1befb0a06123fb7ce89e...9ad7e6ea24739c298d0a9660121de6df0502915a,1,27,0,27,2,2009-03-09 22:24:16,2009-03-09 20:26:56
9ad7e6ea24739c298d0a9660121de6df0502915a...0d260f9a09a2febeb86fdada7224d271a76d2e3c,2,5,1,6,2,2009-03-09 22:32:50,2009-03-09 20:57:38
52e7787609d18af76a8c1befb0a06123fb7ce89e...9162b8640b4e9e199fb92eb6b8a3787f268531d5,1,4,1,5,1,2009-03-09 21:52:12,2009-03-09 18:45:47
8bb4646dae89035695e72a39d6fe1c0f364ea0aa...42fc1139a07b4292d3e5251c591609126664941a,2,2,2,4,2,2008-11-11 22:50:02,2008-11-10 21:07:52
42fc1139a07b4292d3e5251c591609126664941a...7f96e2e25aa008556a4ede7a65de8488eb9890e6,1,7,7,14,7,2008-11-11 22:50:03,2008-11-08 03:22:48
7f96e2e25aa008556a4ede7a65de8488eb9890e6...36bd844658cf244ec2c6756c18673a4b7ed8ec9e,1,4,1,5,2,2008-11-11 22:50:03,2008-11-08 03:22:49
36bd844658cf244ec2c6756c18673a4b7ed8ec9e...2baf1850ceb01dfbee862e30f2a69cf6064e13eb,2,4,2,6,3,2008-11-11 22:55:43,2008-10-29 16:15:36
c5034673fd92b6278e6c9d55683770ec01fafc89...ee27ca4a781844ddbf556ec64daae24d748a7c5a,5,27,8,35,8,2011-11-21 22:42:25,2011-11-17 23:04:22
c5034673fd92b6278e6c9d55683770ec01fafc89...8b124135a97b593d50a90abcec231552b31c7ade,3,41,14,55,11,2010-03-07 20:00:36,2010-02-28 02:56:38
801a011dcf41f0415dee81f0500673e058bdee30...934f82a7d424ea9a8fa0ae83020689d11efc2bff,1,8,0,8,2,2009-06-09 04:18:02,2009-06-09 03:46:38
801a011dcf41f0415dee81f0500673e058bdee30...956d27a872a70f40f98c3f710553ef619959e212,1,6,3,9,1,2009-06-08 22:01:12,2009-06-06 15:16:30
956d27a872a70f40f98c3f710553ef619959e212...3ef67cf250b14b9c62b2bd21e4d0d5339f5f31e5,1,3,1,4,1,2009-06-09 04:18:41,2009-06-08 08:51:22
3ef67cf250b14b9c62b2bd21e4d0d5339f5f31e5...802f9c9cb21321d3ffe7576e01bbe31c51bd4c70,1,1,0,1,1,2009-06-09 04:19:26,2009-06-08 20:34:30
dbb6a4ada6c6c1065b62313127ff032196e9d232...1f5b9cc40e80a8a7902236a26844be138887b1d9,1,2,0,2,1,2009-06-02 05:30:39,2009-06-01 21:53:05
065b0702f748b50e69d67609ace2632ce04b79a1...fe87c92138d91e2002c46b06f8389814436de1cf,1,1,1,2,1,2009-05-21 14:08:58,2009-05-21 02:45:53
065b0702f748b50e69d67609ace2632ce04b79a1...da083d688e41f9a4328fab262f315f9e4fe52a32,29,221,206,427,137,2009-05-21 07:31:07,2009-05-08 08:06:16
da083d688e41f9a4328fab262f315f9e4fe52a32...c69700fe042ad2ecf2904a8b7d8eddc6d52b790b,1,5,1,6,4,2009-05-21 07:31:08,2009-05-06 20:18:52
c69700fe042ad2ecf2904a8b7d8eddc6d52b790b...b6c61778d4fa57904d5b818e0ca04292aa1d0335,1,1,1,2,1,2009-05-21 07:31:08,2009-05-06 20:18:53
b6c61778d4fa57904d5b818e0ca04292aa1d0335...42a5da1806fd6891d4fcc0ad9c0e550c12f75df5,1,1,0,1,1,2009-05-21 07:31:08,2009-05-06 20:19:45
42a5da1806fd6891d4fcc0ad9c0e550c12f75df5...36db1eddf972c88edf402b99e2366ad533635ab8,3,106,3,109,8,2009-05-21 07:56:18,2009-05-15 01:27:15
6096d7598058d920485d206477f4383ba1a862cb...e3a0ca878457ecc70d0065802fcb0c6875c6b671,3,5,12,17,4,2009-06-06 20:25:01,2009-06-04 23:43:56
e3a0ca878457ecc70d0065802fcb0c6875c6b671...34aec9f573af8e6fbe06285d660d9e1a84950e4c,3,21,38,59,8,2009-06-06 20:25:34,2009-06-04 23:43:57
7a7eb5173d4e16f0323b2c4078e88fc0a40c38b6...33eb4dd9fce3b46b6962b46213d6f222bcd0cb3a,1,20,6,26,7,2009-05-24 20:52:13,2009-05-21 12:25:11
633e3556ccbcc7e443f5e9194c4a830181696ef0...1fdee85c8844a2cbfdf2f4c0a9c0964b78beb37e,1,10,10,20,4,2009-05-10 19:41:35,2009-05-10 17:31:56
1fdee85c8844a2cbfdf2f4c0a9c0964b78beb37e...fe0bb5f7bce3dbcc32325c74e693a726d0c2808b,1,42,40,82,3,2009-05-10 19:41:35,2009-05-10 17:41:22
fe0bb5f7bce3dbcc32325c74e693a726d0c2808b...ad87b5dd93f61a046236febf1becc78d0ad6452a,1,8,1,9,2,2009-05-10 19:41:35,2009-05-10 17:45:52
ad87b5dd93f61a046236febf1becc78d0ad6452a...801cfae8fd683761ae268cab8cec08e4b0f5a35b,1,61,0,61,1,2009-05-10 19:41:35,2009-05-10 18:18:59
801cfae8fd683761ae268cab8cec08e4b0f5a35b...1c64e79a622b43cff2d919632393c51f3fcc4f43,2,19,4,23,8,2009-05-11 00:31:01,2009-05-10 18:30:03
1c64e79a622b43cff2d919632393c51f3fcc4f43...e01662bb5da721d65226f4b173858ea3bf0bde30,2,11,4,15,4,2009-05-16 17:25:49,2009-05-14 19:46:03
e01662bb5da721d65226f4b173858ea3bf0bde30...f1cf2d8b1467b5973f249703b31e709eaede97ad,2,40,8,48,7,2009-05-16 17:28:59,2009-05-14 19:51:15
f1cf2d8b1467b5973f249703b31e709eaede97ad...31c8221acb7c7acaea6ce2c680c2985581ce0066,1,33,10,43,4,2009-05-16 17:35:45,2009-05-14 22:49:10
b74fce16fa51362d4a3875d46e488006c3ad5371...16493eb0d0da26f80286b39c7b6900e261744afa,2,12,0,12,12,2009-06-06 17:30:16,2009-06-06 08:43:26
a8816e7bab0354badd915c1da09421a64c982831...503f464090d835ad333f5a55662ca0880c7b1d44,1,6,0,6,1,2009-05-02 06:31:00,2009-05-02 06:31:00
078688213f321ac52c224c1cfa264d686c7264bd...098082fb78768dc3cbe659048c9f47cabdd7e39b,2,15,7,22,3,2009-04-18 19:51:06,2009-04-14 13:15:42
9d5156496d2d32800df52fa372295c16ab2578f0...b8fee3a3884b4a18c2f0b5313255dd180c44ab78,1,9,6,15,4,2009-03-30 02:58:10,2009-03-29 06:10:45
b296e8fce6de6a40a41b5168dfbe735d11255256...8a9391e9440028c03345afa9f21459237a529592,2,20,0,20,2,2009-02-05 00:30:43,2009-01-30 09:41:28
8a9391e9440028c03345afa9f21459237a529592...ffaf9cc0ff0692a0b60cdf1b62e8375706b7865d,1,7,5,12,4,2009-02-05 00:30:45,2009-01-30 09:41:29
b296e8fce6de6a40a41b5168dfbe735d11255256...b229d18a809c169314b7f0d048dc5a7632e8f916,1,2,2,4,2,2009-01-29 09:00:43,2009-01-29 08:30:16
b229d18a809c169314b7f0d048dc5a7632e8f916...afe5d3d516114f08d3c4289682a704f5a7889909,2,44,0,44,2,2009-01-29 09:00:48,2009-01-29 08:33:02
a54a216098db10d551d33123f33667ce8a036510...6f55ee4317681a5639ff364d2f0a352bde064269,2,1,7,8,2,2009-03-15 20:05:05,2009-03-15 20:03:19
91e80b984e0afda37d288e550fb5832d2b71568c...c4ba87a6e2fccbf4d763ed0212a20a784b964ef8,1,13,0,13,1,2009-02-19 06:15:29,2009-02-19 03:51:06
c4ba87a6e2fccbf4d763ed0212a20a784b964ef8...b452cc16d85ea9de7d3f15c83a917b5534a91120,2,8,1,9,2,2009-02-20 07:22:18,2009-02-19 12:34:48
b452cc16d85ea9de7d3f15c83a917b5534a91120...e43a6fd3e94888d76779ad79fb568ed180e5fcdf,3,17,3,20,4,2009-02-20 07:22:57,2009-02-19 12:54:18
30aa4fb15fa408596dea59cdc9f00c94eeaa69f1...209d336ae3923f2c1783a42b12fca50f3bee0802,1,75,30,105,18,2009-02-14 01:02:11,2009-02-13 09:40:18
209d336ae3923f2c1783a42b12fca50f3bee0802...45e2b6140147d7a8b2cd68399e4d52d5d8d7b5be,1,2,0,2,2,2009-02-18 18:25:37,2009-02-18 18:14:59
45e2b6140147d7a8b2cd68399e4d52d5d8d7b5be...66648ad7fed840adef0343a1e0bf5188d32f5569,1,2,2,4,1,2009-02-19 03:59:16,2009-02-19 03:35:45
66648ad7fed840adef0343a1e0bf5188d32f5569...0afc304406196e4470fd2a628c3733e966068d98,1,81,0,81,1,2009-02-19 03:59:21,2009-02-19 03:34:44
30aa4fb15fa408596dea59cdc9f00c94eeaa69f1...0db5260bd033cc357186cc13fe23be9635ad69e7,2,28,2,30,8,2009-02-12 22:48:43,2009-02-12 15:51:55
30aa4fb15fa408596dea59cdc9f00c94eeaa69f1...a8344abe0f70f9fc629ee055d73ffa65fbc58311,2,12,4,16,3,2009-02-12 20:31:52,2009-02-12 13:36:14
a8344abe0f70f9fc629ee055d73ffa65fbc58311...222b1673860bba6c75895ce3e2d1467fb878fa2a,1,2,2,4,2,2009-02-12 21:02:09,2009-02-12 21:02:09
222b1673860bba6c75895ce3e2d1467fb878fa2a...49bde7533681f5e4a80402af465bd7a28556266e,1,5,0,5,1,2009-02-12 23:44:56,2009-02-12 18:01:10
49bde7533681f5e4a80402af465bd7a28556266e...7fe5438516a8121bd67ee0789cb0960b6e922225,1,1,0,1,1,2009-02-13 00:50:28,2009-02-12 10:21:19
7fe5438516a8121bd67ee0789cb0960b6e922225...1a526d483865d85aca3a10c650e85c44ad1f001b,2,41,0,41,3,2009-02-13 01:46:05,2009-02-12 21:17:04
1a526d483865d85aca3a10c650e85c44ad1f001b...5cd12b85fe8ff74f202a158511ead34e8aba584c,2,33,5,38,4,2009-02-13 06:37:35,2009-02-12 06:42:27
30aa4fb15fa408596dea59cdc9f00c94eeaa69f1...1d398a03902aab8ec49197d8827c19f9e2203c98,1,4,0,4,1,2009-02-12 07:51:15,2009-02-12 05:19:41
81d3fe9f4871e42ebd1af0221fa091fe5476e2f7...7c4c97c0ac0cd66861d0c2b8bd7a47ed3c523ea7,9,33,29,62,22,2009-02-18 19:04:19,2009-02-16 12:20:25
7c4c97c0ac0cd66861d0c2b8bd7a47ed3c523ea7...ce8e8804068772a24354ee24641ca65ffa417837,1,120,135,255,8,2009-02-18 19:04:24,2009-02-17 14:27:11
ce8e8804068772a24354ee24641ca65ffa417837...8a3b25da8cdd7f3aa75f18d3245ce83aca90bb1a,1,2,2,4,2,2009-03-08 03:54:05,2009-03-08 01:22:07
8a3b25da8cdd7f3aa75f18d3245ce83aca90bb1a...2fb6d6d6dd1033bfe82d6d327ac270f9cf8943cd,2,15,3,18,6,2009-03-08 03:54:57,2009-03-08 01:27:22
81d3fe9f4871e42ebd1af0221fa091fe5476e2f7...a393777ec9ca7c33cb76efa225ddacc53784c0dd,1,34,15,49,8,2009-02-18 18:41:37,2009-02-16 16:34:56
a393777ec9ca7c33cb76efa225ddacc53784c0dd...bf3c20f6e855521fb92f455a9e70fbe8f107c53d,1,6,1,7,2,2009-02-18 18:41:45,2009-02-16 16:34:57
bf3c20f6e855521fb92f455a9e70fbe8f107c53d...df5d10a32ebc4f2305e13b70e2c01e4fa2cc73f0,2,27,7,34,9,2009-02-18 18:43:21,2009-02-18 13:09:41
df5d10a32ebc4f2305e13b70e2c01e4fa2cc73f0...b94ead75945fe7dbe8fbfeb48070a6b54d02e318,1,1,1,2,1,2009-02-18 18:48:01,2009-02-18 18:48:01
b94ead75945fe7dbe8fbfeb48070a6b54d02e318...51b2ead03c8cdc0ddeeca2fb5db14b7bac584337,2,6,0,6,2,2009-02-18 19:14:04,2009-02-18 13:44:02
51b2ead03c8cdc0ddeeca2fb5db14b7bac584337...88e38808cd52aaed327a82d6a6ffdb8b9da621f2,2,18,6,24,3,2009-02-18 19:15:17,2009-02-18 08:35:36
b32acd21d81ac792cf28d487b960a2f6bb0ef0e2...25a31f814016891c7728fdebca056ef47ca75547,1,9,9,18,8,2009-01-15 17:33:26,2009-01-15 16:02:21
25a31f814016891c7728fdebca056ef47ca75547...50e126e185c196b9b66dcdefb4b05f090d62dd4c,1,6,3,9,2,2009-01-15 17:34:54,2009-01-15 16:02:22
50e126e185c196b9b66dcdefb4b05f090d62dd4c...a42577d4c868141343378824814c058de043e24d,1,15,0,15,12,2009-01-15 17:35:46,2009-01-15 16:02:23
9db56f71b91153f4076a796c80c61f00edd8b700...0b38227f283e208866d3e2ac85bcd947a71f1b17,2,78,3,81,2,2008-11-12 21:54:31,2008-11-12 08:25:52
9db56f71b91153f4076a796c80c61f00edd8b700...0d641f75d1237b34d3cfb411a18c813cfacb4726,1,1,1,2,1,2008-11-12 20:20:31,2008-11-07 12:26:55
0d641f75d1237b34d3cfb411a18c813cfacb4726...fa7b3c2f752a10a5dca9989d4a1c4b93ffa7f943,4,9,3,12,5,2008-11-12 22:16:50,2008-11-12 19:52:35
fa7b3c2f752a10a5dca9989d4a1c4b93ffa7f943...a1e4760fcfece8eb9b556f35a04a521fdee3963c,2,16,2,18,2,2008-11-12 22:55:03,2008-11-12 18:23:58
a1e4760fcfece8eb9b556f35a04a521fdee3963c...c14639f7b14d3d856c7c1f6c097dd1cb9615a5d0,2,22,1,23,2,2008-11-12 23:03:03,2008-11-12 23:03:03
9db56f71b91153f4076a796c80c61f00edd8b700...9245ddd515d0fb5da52da4fd4dfc71460e98db90,1,38,0,38,1,2008-11-12 18:28:06,2008-11-12 17:59:02
9245ddd515d0fb5da52da4fd4dfc71460e98db90...8d25931d6ff47a7fb06512d767d1d416d9bc7733,2,7,1,8,2,2008-11-12 18:28:08,2008-11-12 17:59:03
8d25931d6ff47a7fb06512d767d1d416d9bc7733...e96fb9b8f90f907d720ea6b71c92e30c2b071f4a,2,12,0,12,4,2008-11-12 18:28:10,2008-11-12 17:59:04
e96fb9b8f90f907d720ea6b71c92e30c2b071f4a...dd718365cccfddd7d5992a40296de50e7cabdfc8,2,2,2,4,2,2008-11-12 18:28:12,2008-11-12 17:59:05
dd718365cccfddd7d5992a40296de50e7cabdfc8...f7991d1ed37502c0e98dfa95866dfc1a8b08d834,1,4,7,11,1,2008-11-12 18:28:13,2008-11-12 17:59:06
f7991d1ed37502c0e98dfa95866dfc1a8b08d834...01af249fa15ce63ea69e89e3520022420ecb409c,1,1,11,12,2,2008-11-12 18:28:14,2008-11-12 17:59:07
01af249fa15ce63ea69e89e3520022420ecb409c...3c3df429106770966397086b6d2bced452ec7383,1,19,0,19,1,2008-11-12 18:29:22,2008-11-10 05:59:56
3c3df429106770966397086b6d2bced452ec7383...0f4dc14ac4945448f7309964afeb879d20408e07,2,14,6,20,6,2008-11-12 18:29:22,2008-11-10 05:59:57
0f4dc14ac4945448f7309964afeb879d20408e07...daae06259556246959963947752bde4ee2df7b44,3,5,2,7,3,2008-11-12 18:29:22,2008-11-10 05:59:58
daae06259556246959963947752bde4ee2df7b44...3289b9dec56d34fe05f90c262d11adc0a61e16e7,1,16,0,16,1,2008-11-13 01:29:41,2008-11-13 00:50:26
9db56f71b91153f4076a796c80c61f00edd8b700...18afe101eb2c2f68ba58085515f592148128fba3,3,75,5,80,4,2008-11-11 23:26:40,2008-11-10 21:47:11
4339d5109c847fc938cd8405001ffde4d230c09f...b4c813bc71f83804302f1c896c91dc499adf1922,1,28,1,29,1,2009-04-08 14:42:54,2009-04-06 19:05:55
b4c813bc71f83804302f1c896c91dc499adf1922...c736b4c83b929bdcb3fac2cc9e063258cc75cbe2,1,979,401,1380,347,2009-04-29 15:37:23,2009-04-29 05:56:06
c736b4c83b929bdcb3fac2cc9e063258cc75cbe2...a91be3fcbe92c24e809b1ec85881a6da40a9a340,2,22,19,41,8,2009-05-01 22:04:52,2008-08-16 01:20:09
a83c88525ed6d8d940f8cf7f21e92b189f7844e3...026fa0d5ad9538ca76838070861531c037d7b9ba,3,36,23,59,16,2009-01-26 08:26:05,2009-01-18 12:00:09
026fa0d5ad9538ca76838070861531c037d7b9ba...4dd47c3b867f51211d0dc4474dab0fee5ca614da,3,19,18,37,5,2009-01-26 08:26:05,2009-01-18 12:00:10
4dd47c3b867f51211d0dc4474dab0fee5ca614da...2cd72b0b290e40fb4d6a925ce26603503f01aa09,2,7,4,11,2,2009-01-26 08:26:05,2009-01-18 12:00:11
2cd72b0b290e40fb4d6a925ce26603503f01aa09...2fb3f6db96492b680899f9e40f434eeb4c778a84,16,45,0,45,29,2009-01-26 08:26:05,2009-01-18 12:00:12
2fb3f6db96492b680899f9e40f434eeb4c778a84...8e3462837b0ace04357503a3f58802cc2231df29,1,1,3,4,1,2009-01-26 08:26:05,2009-01-18 12:00:13
8e3462837b0ace04357503a3f58802cc2231df29...35fb0e8633217f602360a9987af51c4b960e7850,2,47,0,47,4,2009-01-26 08:26:05,2009-01-18 12:00:14
35fb0e8633217f602360a9987af51c4b960e7850...25655221745fd27d5da3bda7ad0fe49f2005d776,1,1,3,4,2,2009-01-26 08:26:05,2009-01-18 12:00:15
a83c88525ed6d8d940f8cf7f21e92b189f7844e3...dbc6c74d0858d77e61e092a48d467e725211f8e9,2,140,5,145,8,2009-01-18 23:38:27,2009-01-12 00:51:10
dbc6c74d0858d77e61e092a48d467e725211f8e9...baf5fa8a7fdefc696fb1d79c95ae15a4cc779c1e,2,122,4,126,5,2009-01-18 23:38:28,2009-01-12 00:51:11
baf5fa8a7fdefc696fb1d79c95ae15a4cc779c1e...e82f0d73f02e89a95d9477911774d314f70f1063,3,64,3,67,6,2009-01-18 23:38:28,2009-01-18 04:10:14
e82f0d73f02e89a95d9477911774d314f70f1063...1ef626b4b6c70fc13062faafdccb2f0da7578a29,2,25,3,28,3,2009-01-18 23:38:28,2009-01-18 06:11:44
1ef626b4b6c70fc13062faafdccb2f0da7578a29...b03a71a660d15d76b63d7d3c5205b896f89f34b5,2,131,4,135,16,2009-01-19 02:39:57,2009-01-12 02:23:38
b03a71a660d15d76b63d7d3c5205b896f89f34b5...22ba47f544a233958c73a9260b18c57b431f44b3,1,2,1,3,1,2009-01-19 03:51:44,2009-01-19 02:02:01
a83c88525ed6d8d940f8cf7f21e92b189f7844e3...71ee483abd44b1a69cd2ac005c75d3c885830a5c,1,7,2,9,3,2009-01-18 20:29:32,2009-01-17 21:28:45
96d1a8e9d44fd635fad8466dbe0aab6d73495c9f...e3bf5e43fd9db9391ebc876ef118dbb431853d69,1,11,0,11,2,2008-09-23 02:59:23,2008-09-22 23:19:05
b1524ee0f3a34d76639090c988523550026cc98b...b65910fec21db070ac40521e4b375fca76d27c90,1,7,0,7,1,2008-10-03 00:27:10,2008-09-29 13:07:42
b65910fec21db070ac40521e4b375fca76d27c90...6e2dfb1631b3c40574e6f940498f3889607c3ef8,1,1,0,1,1,2008-10-03 00:27:31,2008-10-02 00:08:47
6e2dfb1631b3c40574e6f940498f3889607c3ef8...2d7a3532c78bace2f3631ab0e594f713dcab9916,1,2,1,3,3,2008-10-03 00:43:18,2008-10-02 14:50:04
2d7a3532c78bace2f3631ab0e594f713dcab9916...9a1fd653b13b6cc136bfa5b9563f629b2af1a6c8,1,49,0,49,1,2008-10-03 00:44:09,2008-10-02 14:52:20
9fa03c177ff826b439537072338af958fe01c257...fe2d7776d5191896e361973f478ca078fa95b324,2,25,0,25,2,2008-10-31 00:00:14,2008-10-27 09:22:21
fe2d7776d5191896e361973f478ca078fa95b324...958a4789e0e74da245175e31bd3b9b354ee0e063,1,5,3,8,4,2008-10-31 00:18:29,2008-10-27 10:11:40
958a4789e0e74da245175e31bd3b9b354ee0e063...aba13e7c0566f578f866504bfcb388a72f7e5079,2,22,4,26,6,2008-10-31 00:30:55,2008-10-27 10:17:51
aba13e7c0566f578f866504bfcb388a72f7e5079...a4f34cbb4cea1f0b0e625b528f269f4b517c64f8,9,12,12,24,12,2008-10-31 00:52:24,2008-10-27 10:22:09
e00f3790b88ce61f1bdc863011a122b98b43197e...5070b49e529e2df30ec2e33073267d281450dde6,1,1,5,6,3,2008-05-26 05:26:24,2008-05-24 23:21:53
008442f5e798e511cc0cd5d9443552b0d107d558...c30f9936b0e5cdced3d9cb859ce0d325ebe9c91d,1,5,2,7,1,2008-05-23 06:21:29,2008-05-22 12:47:19
c30f9936b0e5cdced3d9cb859ce0d325ebe9c91d...3a3e097b866b2785e44c008092884c853fd406cc,1,0,2,2,1,2008-05-23 06:21:30,2008-05-22 19:59:25
3a3e097b866b2785e44c008092884c853fd406cc...26b4d0039d84010bbfab2148395cc86f87b91286,1,1,1,2,1,2008-05-23 06:29:46,2008-05-22 15:24:41
e4d594c6bdcb25b996120fe21c901af7a08a7f6d...18023c20656265364d4d1805f435e8420ab70687,1,1,1,2,1,2008-05-21 20:05:50,2008-03-28 14:09:04
e4d594c6bdcb25b996120fe21c901af7a08a7f6d...0706bd19ef9b41e7519df2c73796ef93484272fd,2,68,0,68,4,2008-05-21 20:05:09,2008-03-28 21:28:33
0706bd19ef9b41e7519df2c73796ef93484272fd...d54eaaa268eb79a51ac11bfa8bbfb456c0b1a1fa,2,32,2,34,4,2008-05-21 20:05:10,2008-03-28 21:29:01
4ed19a3c178d22fbd424af78b42b65533a8d1ebb...81dc223deba84341be9681d7a1a4a183e02e41d6,2,7,1,8,2,2008-12-27 00:37:53,2008-12-26 22:02:01
4ed19a3c178d22fbd424af78b42b65533a8d1ebb...a83123deecfdd5078c2e16166576fb17add194b2,1,6,2,8,2,2008-06-06 04:01:45,2008-06-05 23:31:55
a83123deecfdd5078c2e16166576fb17add194b2...c0f6dc9b20523a569e567d3be4cabbc949c71b43,1,9,8,17,3,2008-06-06 15:39:54,2008-06-05 21:01:38
3a59bb22db24ff90c173ffb462fe67902a213d96...0516cc5cc6ccb3b998ea5613ab178407c31339e3,1,1,22,23,7,2008-12-07 23:14:26,2008-12-07 23:06:38
0516cc5cc6ccb3b998ea5613ab178407c31339e3...0e32126f04f6ad64826d4c145f2a1a9685e0910d,1,6,6,12,4,2008-12-08 01:30:35,2008-12-08 01:30:35
0e32126f04f6ad64826d4c145f2a1a9685e0910d...f371d3ea3ca7933df787230f2eb9b67901bde9d3,1,2,1,3,2,2008-12-08 01:34:14,2008-12-08 01:34:14
9bf3acfadafe9e5961296ff22a1677a9f5afe508...b53bb301f5781b05fb59891128db21a331dca032,1,559,236,795,217,2009-08-13 23:18:01,2009-07-10 07:08:15
a1070d4cbbf1002cc0b01afc3de06382deb0511a...a95148dea1d9546e96adef7c3cad11be80aa30f5,3,6,7,13,3,2009-03-04 07:37:19,2009-03-04 07:02:16
a1070d4cbbf1002cc0b01afc3de06382deb0511a...a9f2c13685ae9040d52d53cd719a18040f1dd123,4,58,31,89,13,2009-03-04 06:58:52,2009-03-04 06:29:55
a9f2c13685ae9040d52d53cd719a18040f1dd123...72f600832f75db626fd9290a21d02d49c92ca9ca,1,17,6,23,1,2009-03-11 05:21:12,2009-03-10 08:20:42
8104ebfe8276657ee803cca7eb8665a78cf3ef83...272459a3b809db19d15131eb5df9dfe939af9c8c,1,2,2,4,2,2009-02-28 22:09:46,2009-02-28 19:56:49
8104ebfe8276657ee803cca7eb8665a78cf3ef83...92b7de93fb7801570ddc3195f03f30b9c201a3bd,5,389,1,390,5,2009-01-07 21:35:44,2009-01-07 17:04:09
92b7de93fb7801570ddc3195f03f30b9c201a3bd...34292bddb861f3cb52a524fdce67234430a744fe,4,174,1,175,4,2009-01-07 21:37:07,2009-01-01 16:39:17
34292bddb861f3cb52a524fdce67234430a744fe...cc545709253fe8440db2648cb5c771e5b126bdb5,1,2,0,2,2,2009-01-07 21:37:07,2009-01-01 16:39:37
8104ebfe8276657ee803cca7eb8665a78cf3ef83...dd6c1360b22ee89cb179e2a1fface98ecbeb7b3e,2,3,3,6,3,2009-01-05 19:46:58,2008-12-30 15:10:24
8104ebfe8276657ee803cca7eb8665a78cf3ef83...2ce53f9b77eb36c6d1286f55fba65f8dc66b2564,2,53,0,53,3,2009-01-05 18:48:32,2009-01-02 18:08:40
8104ebfe8276657ee803cca7eb8665a78cf3ef83...22b3ddd508b022c76bf36bf390691a6f62c996d5,1,1,1,2,1,2009-01-03 22:25:27,2009-01-02 18:08:00
8104ebfe8276657ee803cca7eb8665a78cf3ef83...d8fab0234d6db440a71f38f8538dbdefbbdfd077,1,3,2,5,3,2009-01-03 22:22:50,2009-01-02 22:28:26
d8fab0234d6db440a71f38f8538dbdefbbdfd077...190f53232d1e92a57843df90e889bcfea39620d3,2,126,16,142,14,2009-01-12 07:03:36,2009-01-05 17:35:16
190f53232d1e92a57843df90e889bcfea39620d3...d911d1465d134cbd126e531a544f33b13f4e855a,2,179,31,210,24,2009-01-12 07:04:45,2009-01-02 22:28:28
d911d1465d134cbd126e531a544f33b13f4e855a...be4966210125f558864368a666ebde67bed92151,1,16,5,21,3,2009-01-12 07:09:14,2009-01-02 22:28:29
8104ebfe8276657ee803cca7eb8665a78cf3ef83...280514e1dff3284549175cb0e8edb9b796e8891e,2,11,1,12,2,2009-01-03 22:15:22,2009-01-02 15:40:13
280514e1dff3284549175cb0e8edb9b796e8891e...d500a1ee8fe4424beb7a98e4fa6159677e7569d0,1,9,3,12,2,2009-01-05 19:30:06,2009-01-02 15:40:14
8104ebfe8276657ee803cca7eb8665a78cf3ef83...f29680221124d05581dd2db52a4e7f0fa15fa929,2,16,3,19,6,2009-01-01 12:40:16,2008-12-29 17:45:20
f29680221124d05581dd2db52a4e7f0fa15fa929...3bc52d7a95676bcdeeb61c372b44358daf817baa,2,2,2,4,2,2009-01-05 19:43:28,2009-01-01 21:56:29
8104ebfe8276657ee803cca7eb8665a78cf3ef83...fe73fc1abe785a423fcc51b753d57ffa1485edab,1,3,16,19,5,2009-01-01 11:31:56,2008-12-30 21:01:44
8104ebfe8276657ee803cca7eb8665a78cf3ef83...bd7c6e7fc53691e2c459eaad73bc12006939333e,1,1,0,1,1,2008-12-29 09:06:11,2008-12-28 23:37:25
8104ebfe8276657ee803cca7eb8665a78cf3ef83...e70b9a8bd2e25ced75cff2a2c26aed3f983425f8,1,7,1,8,3,2008-12-27 22:30:41,2008-12-27 08:21:04
e70b9a8bd2e25ced75cff2a2c26aed3f983425f8...57d43466fbb4ffb4106b97593a96d714137dde2a,2,13,1,14,3,2008-12-27 22:30:46,2008-12-27 08:21:03
8104ebfe8276657ee803cca7eb8665a78cf3ef83...78f8fbc9d641096eef495dd877de3438d8a000e0,2,29,1,30,2,2008-12-27 22:25:10,2008-12-27 22:25:10
8104ebfe8276657ee803cca7eb8665a78cf3ef83...3a882d9696ba2ba46adc107b92b4721e59bb60b4,1,33,7,40,2,2008-12-27 21:52:19,2008-12-27 18:23:30
3a882d9696ba2ba46adc107b92b4721e59bb60b4...f83b9ba20973472f64699e1e2707b74da211a89b,1,6,6,12,2,2008-12-27 21:54:00,2008-12-27 08:50:30
8104ebfe8276657ee803cca7eb8665a78cf3ef83...a010966844221ea14f1de26fdab8fe37332ff928,1,15,9,24,2,2008-12-27 20:02:32,2008-12-27 00:32:49
a010966844221ea14f1de26fdab8fe37332ff928...88c44735ab24aea3e669501c4491f7c9ca745ca3,1,24,18,42,3,2008-12-27 20:02:40,2008-12-27 00:39:35
88c44735ab24aea3e669501c4491f7c9ca745ca3...f53bd743ff713f6507f28f8e730ac3e27858ab43,1,34,19,53,13,2008-12-27 20:02:49,2008-12-27 00:49:21
8104ebfe8276657ee803cca7eb8665a78cf3ef83...c569b1fee151e467854ca268997f4f3baaf73564,1,3,1,4,1,2008-12-27 03:07:56,2008-12-26 09:46:25
c569b1fee151e467854ca268997f4f3baaf73564...a583971f15e520c8cb5f9967383903e13c353c86,1,5,13,18,3,2008-12-27 03:08:32,2008-12-26 10:01:57
a583971f15e520c8cb5f9967383903e13c353c86...6720e95b305737fddc776f2904c339a0701e6ae2,1,13,21,34,11,2008-12-27 03:09:56,2008-12-26 10:12:15
6720e95b305737fddc776f2904c339a0701e6ae2...4deba8b7798aac52e33aa8e1c49a8cdc0940ac36,1,5,2,7,1,2008-12-27 03:10:02,2008-12-26 10:17:04
8104ebfe8276657ee803cca7eb8665a78cf3ef83...d4789c60aae4bbc97aaef5cf2e0a9aa0a4df05d2,1,5,0,5,1,2008-12-26 09:04:26,2008-12-26 00:54:23
d4789c60aae4bbc97aaef5cf2e0a9aa0a4df05d2...e1a59774077e21fc9862a968440dd23003345b4a,2,8,2,10,4,2009-01-01 12:43:23,2008-12-31 10:00:50
8104ebfe8276657ee803cca7eb8665a78cf3ef83...36e3b5eafe967cb721f5e2bbaa396f979b8ebd7c,2,28,0,28,2,2008-12-25 07:06:48,2008-12-22 22:10:20
8104ebfe8276657ee803cca7eb8665a78cf3ef83...e1f33efe07b9a520505fccd71bea1292fc9448dd,1,19,6,25,7,2008-12-25 06:57:12,2008-12-23 08:31:15
7963791e1f44f3053f47f98628cf1729030eab76...decd0a1ea594232f3b84831104257a0225be0085,1,3,0,3,2,2010-03-20 09:53:21,2010-02-02 22:11:28
decd0a1ea594232f3b84831104257a0225be0085...75eb2af0e02b9d38742d04929b1c4da46b8d13c9,1,0,12,12,3,2010-03-20 09:53:21,2010-01-13 20:40:18
75eb2af0e02b9d38742d04929b1c4da46b8d13c9...0933b04e5204674784b3ff7bcff68b663e633f8b,1,2,1,3,2,2010-03-20 09:53:21,2010-01-13 20:40:19
0933b04e5204674784b3ff7bcff68b663e633f8b...207ad7b8878caa8b1d09c39ea0754f0192daece5,1,1,0,1,1,2010-03-20 09:53:21,2010-01-13 20:40:20
207ad7b8878caa8b1d09c39ea0754f0192daece5...b9b142ffa218b50dadad091bd660ba801d0ca5d5,1,5,4,9,4,2010-03-20 09:53:21,2010-01-13 20:40:22
b9b142ffa218b50dadad091bd660ba801d0ca5d5...e7feb695bf93d57c1c5fdf9f2acc2039e3fdf850,1,2,0,2,2,2010-03-20 09:53:21,2010-03-06 22:48:38
e7feb695bf93d57c1c5fdf9f2acc2039e3fdf850...5d11f794de3c1a5cd592af008a369a90fa30d2e9,1,2,2,4,4,2010-03-20 09:53:21,2010-03-06 22:58:42
5d11f794de3c1a5cd592af008a369a90fa30d2e9...2e58c944cdaf63a23ebd35c43d31e639e1e23d9f,1,1,0,1,1,2010-03-20 09:53:21,2010-03-12 18:31:47
2e58c944cdaf63a23ebd35c43d31e639e1e23d9f...adab0dabcc95d02c3ab2076f0db5e5f94b30a96d,1,6,0,6,1,2010-03-20 09:53:21,2010-03-12 18:31:48
adab0dabcc95d02c3ab2076f0db5e5f94b30a96d...e7d516b67b02cfc4c18408d2d39118c61345bf6d,9,17,17,34,17,2010-03-20 09:53:21,2010-03-12 18:31:49
e7d516b67b02cfc4c18408d2d39118c61345bf6d...a1d383c5ab90ec19c8a77158f65e5ea7d61fb42c,1,21,8,29,9,2010-04-17 08:53:24,2010-04-09 20:16:42
e89e2ed7c225cf16cffbd9648895528e471e2fb8...d75307084da5f89329de190bb9b4a3196cec1d0e,16,27,27,54,27,2009-01-05 21:01:01,2009-01-04 18:38:41
e89e2ed7c225cf16cffbd9648895528e471e2fb8...a907e1b6ec3038306df68dc1275edad7457bba4b,1,33,20,53,5,2009-01-05 20:54:07,2009-01-04 17:16:01
438d2991eaa17549df67929cd4558d65840c37d7...8a124b82a03240b10c83085559e5988bc92ea7e2,1,1,1,2,1,2009-01-07 06:12:07,2009-01-07 04:23:37
438d2991eaa17549df67929cd4558d65840c37d7...1f7903a371f90f025cfc3b4aa3a0b4a8f8b05b94,2,65,1,66,3,2009-01-02 21:24:12,2009-01-02 10:55:37
a0d2ceb2769731571cdd195582bfedf90225e712...4f3dcc2753ef6c244622334cef94a72682fcd850,1,1,1,2,1,2008-07-02 00:05:42,2008-07-01 09:47:04
4f3dcc2753ef6c244622334cef94a72682fcd850...7ad0f27b925463c5ca6908573ed24ede11a9981f,2,32,1,33,2,2008-07-02 00:09:21,2008-07-02 00:09:21
182c5afa6c00eb8b773fc062bfd2c29f27ea546b...a5a9126bb4d7c2c23b94101dc49bcca33b6b17e8,1,50,20,70,9,2008-07-07 02:10:31,2008-07-03 15:27:24
182c5afa6c00eb8b773fc062bfd2c29f27ea546b...f444e5286ee8986adb0899f85cc292fc2cd7cd04,2,10,12,22,6,2008-07-04 07:37:40,2008-07-04 07:37:40
f444e5286ee8986adb0899f85cc292fc2cd7cd04...2b2828b452bd8b3258de75451f77362decb1dffe,2,0,0,0,0,2008-07-04 08:38:41,2008-07-04 08:38:34
2b2828b452bd8b3258de75451f77362decb1dffe...78e3118685bc2050b4ee9ab754dcd79eb2ed4fb7,2,21,11,32,6,2008-07-04 08:38:41,2008-07-04 08:12:54
521537476fe99b97bfcdf1b8f0c579061af5fd3e...db03b55781f23a9276234faf9a21922ff8c5678d,1,1,1,2,1,2010-02-24 19:16:14,2010-02-24 17:08:53
521537476fe99b97bfcdf1b8f0c579061af5fd3e...665d3e8f057b90d7b43d70db75b9ac5506bd204d,2,30,0,30,3,2009-03-17 21:50:21,2009-03-16 15:42:52
665d3e8f057b90d7b43d70db75b9ac5506bd204d...b2655cdae953d619d488b69b7d49e4204e5682dc,1,1,1,2,1,2009-03-25 22:05:46,2009-03-25 20:14:03
c4994ce953b4f0fdbf80004da24ef845907d7dd8...34df8abaf358c83cc1447d0a81bda7848685a1c9,4,11,14,25,9,2009-03-11 06:23:02,2009-03-10 21:54:17
34df8abaf358c83cc1447d0a81bda7848685a1c9...1897713fbd96229f3581b8e8a5653da917882195,1,15,3,18,3,2009-03-11 06:23:02,2009-03-10 21:58:09
c4994ce953b4f0fdbf80004da24ef845907d7dd8...15112c9599f99487211855db7a7a347f20ad9ed5,1,3,6,9,4,2009-03-11 04:42:58,2009-03-11 02:38:12
15112c9599f99487211855db7a7a347f20ad9ed5...c7cb12b86ca9d0b92fa80045dfa0dd2b64bf71b7,1,16,17,33,12,2009-03-11 05:54:53,2009-03-10 15:06:30
c7cb12b86ca9d0b92fa80045dfa0dd2b64bf71b7...4d5d3984749bfb7e2137fb4bce6ac1ace9286aca,1,1,0,1,1,2009-03-11 06:09:48,2009-03-11 03:23:45
4d5d3984749bfb7e2137fb4bce6ac1ace9286aca...e47eec8fc6efb5ad0574b4862fd8e8e82b6a62fa,1,66,3,69,4,2009-03-11 06:16:52,2009-03-09 18:31:55
e47eec8fc6efb5ad0574b4862fd8e8e82b6a62fa...7d59ceed9d1e4f8f0dc52cebf55219d6d395c9da,1,3,1,4,1,2009-03-11 19:41:56,2009-03-11 11:47:06
c4994ce953b4f0fdbf80004da24ef845907d7dd8...4251ccbd80eff92270503a48d35385516c3d106d,1,21,23,44,21,2009-03-10 01:47:29,2009-03-10 01:47:29
4251ccbd80eff92270503a48d35385516c3d106d...7059cd99fc671f9594b61cee7d10d69704f3ebe2,1,27,42,69,17,2009-03-11 05:31:29,2009-03-10 02:00:30
7059cd99fc671f9594b61cee7d10d69704f3ebe2...c33976cbc6d1895fca5c1683fba678e786ee3e58,1,60,0,60,5,2009-03-11 05:35:31,2009-03-10 06:34:25
c33976cbc6d1895fca5c1683fba678e786ee3e58...750d9305009a0f3fd14c0b5c5e62ae1eb2b18fda,1,1,3,4,1,2009-03-13 05:42:19,2009-03-13 05:34:43
750d9305009a0f3fd14c0b5c5e62ae1eb2b18fda...7b5201a60d8f00e7026a3fc4cfdd7852caa9882f,1,76,76,152,57,2009-03-19 10:03:31,2009-03-18 23:43:53
7b5201a60d8f00e7026a3fc4cfdd7852caa9882f...44d808c238f0817fc3ae7caea8f3b625b6180e37,1,9,1,10,2,2009-03-19 10:28:18,2009-03-18 23:46:41
2baf1850ceb01dfbee862e30f2a69cf6064e13eb...14d9c578961ab834bfb0e26481d0212bc0670883,2,7,3,10,2,2008-11-12 20:52:21,2008-11-12 08:17:52
14d9c578961ab834bfb0e26481d0212bc0670883...c1e255b71964e45cee571819c011fbcaaf18be41,1,3,25,28,4,2008-11-12 20:52:22,2008-11-12 08:21:39
3ff7e178dc5c93e9d5b2738b1738a1a230a1b81a...26c117d05d0714ab688ebcafc8eb68c769152bde,1,2,0,2,1,2009-06-07 08:34:51,2009-06-07 08:34:51
581412cb02cc79c566c9828a9cfbe7847b2c6df2...06f391906a69e410c9a6ca5e13774529a091385d,1,1,2,3,1,2009-05-21 14:33:23,2009-05-21 09:47:07
06f391906a69e410c9a6ca5e13774529a091385d...a80aad7b85fc560451e07792d64ab6cb15a39914,2,3,2,5,3,2009-05-21 15:56:24,2009-05-21 09:32:44
6f55ee4317681a5639ff364d2f0a352bde064269...821d56aa68c38f7390b3171092f7b8b814357194,1,4,1,5,1,2009-03-19 09:47:40,2009-03-03 15:40:41
6f55ee4317681a5639ff364d2f0a352bde064269...3f7cdf32996a9213a3085b182960f5ce2c0a6568,1,4,4,8,4,2009-03-17 07:13:39,2009-03-17 06:16:14
3f7cdf32996a9213a3085b182960f5ce2c0a6568...236425919b6f2904ba34ed85bbde5e33ecc19f46,1,77,77,154,40,2009-03-17 19:08:10,2009-03-17 06:16:15
236425919b6f2904ba34ed85bbde5e33ecc19f46...b89510f024d228ad1c2f0fb4752157c18cc10d82,3,37,38,75,30,2009-03-17 19:08:43,2009-03-17 06:16:16
b89510f024d228ad1c2f0fb4752157c18cc10d82...e5ac1217eb2639df1d39fdcd249a35d99e8a7a8e,1,25,25,50,16,2009-03-17 19:08:43,2009-03-17 06:16:17
e5ac1217eb2639df1d39fdcd249a35d99e8a7a8e...ee9cf14d25267aaed4b1533f92e9e5e74d5a4383,1,9,8,17,7,2009-03-19 08:38:35,2009-03-19 07:00:12
ee9cf14d25267aaed4b1533f92e9e5e74d5a4383...4306bcb4e14ab708f0083bcf0339fa77a4005c05,1,24,20,44,12,2009-03-20 16:34:44,2009-03-20 03:35:34
924189d6a2d13b18fbfdaa1725569957cf628807...7f733de04e69c8ba40158d1da46c4aa121f714b6,9,0,0,0,0,2009-03-14 19:44:20,2009-03-13 12:23:26
7f733de04e69c8ba40158d1da46c4aa121f714b6...8e76bf3fc915ff9c530842123263e7147df207bb,8,4,10,14,10,2009-03-14 20:36:34,2009-03-13 12:51:33
8e76bf3fc915ff9c530842123263e7147df207bb...bba2a7b22fdde7a214516e93d957a950571a2026,1,1,1,2,1,2009-03-14 20:37:00,2009-03-13 16:26:36
924189d6a2d13b18fbfdaa1725569957cf628807...06f33c1735bf76e02f3e2601cde5161e969872a7,3,64,18,82,18,2009-03-14 05:51:43,2009-03-14 04:24:08
06f33c1735bf76e02f3e2601cde5161e969872a7...b997045e01c2f12ac7dc44c487915f8e50da4d4d,1,31,0,31,1,2009-03-20 16:36:16,2009-03-20 09:32:09
25487f8e2ae266936df0f807ae79dca41606e404...4fcc86b07db26da17f17af0fd777cab78fcaaf4c,4,47,0,47,4,2009-02-20 06:45:48,2009-02-19 19:10:49
4fcc86b07db26da17f17af0fd777cab78fcaaf4c...024aa7d8d5114f76e616a0ed8ddcf3b463ff2c14,1,4,29,33,1,2009-02-20 06:47:39,2009-02-19 19:10:53
024aa7d8d5114f76e616a0ed8ddcf3b463ff2c14...7d233dea5f4e299fdac8d6cfb610bcd4d60a82b7,1,5,7,12,1,2009-02-20 06:49:55,2009-02-18 03:00:43
25487f8e2ae266936df0f807ae79dca41606e404...484cf6c3f1169786c45ccda54c9961ef66465c03,1,104,40,144,8,2009-02-20 05:41:57,2009-02-19 21:26:30
484cf6c3f1169786c45ccda54c9961ef66465c03...b079c50e03a812f5c8197b8f38e0a5fe6dd31321,3,19,8,27,7,2009-02-22 04:26:03,2009-02-19 21:26:31
b079c50e03a812f5c8197b8f38e0a5fe6dd31321...2175c10d5ad2769936f5bf5bcca5ea32715a7307,2,21,8,29,8,2009-02-22 04:26:10,2009-02-19 21:26:32
2175c10d5ad2769936f5bf5bcca5ea32715a7307...30984ed2e92651962c6b8bdacf1f84da75d1da95,4,170,5,175,10,2009-02-22 04:26:10,2009-02-19 21:26:33
5cd12b85fe8ff74f202a158511ead34e8aba584c...8415d5c7ef63237f6efab0c9aef0b0fdbcbfda25,3,59,17,76,15,2009-02-14 07:46:28,2009-02-14 07:08:05
8415d5c7ef63237f6efab0c9aef0b0fdbcbfda25...c9717ee97075bb333684fa2f63e9136c5f7d89bf,2,35,3,38,7,2009-02-14 07:46:42,2009-02-14 07:26:12
5cd12b85fe8ff74f202a158511ead34e8aba584c...dc6ebd4cc5028d59146e02e30f7945ee91974e6e,6,35,27,62,12,2009-02-14 01:27:58,2009-02-13 21:53:40
dc6ebd4cc5028d59146e02e30f7945ee91974e6e...74bb2dfbec15ad47242b9a879b5547b6f4a28318,1,16,16,32,12,2009-02-14 01:28:06,2009-02-13 21:53:41
5cd12b85fe8ff74f202a158511ead34e8aba584c...7fcda9201e192413c2e63fe35ce6664dbc81705d,16,19,21,40,21,2009-02-14 01:18:22,2009-02-13 22:10:41
5cd12b85fe8ff74f202a158511ead34e8aba584c...b2f82e05de2512ae4adb63b669f6c1fe6cba3148,1,19,5,24,5,2009-02-14 01:17:47,2009-02-13 22:48:01
5cd12b85fe8ff74f202a158511ead34e8aba584c...901d615c5d74bea20e0c8d7fcdf7585616306b79,1,5,1,6,2,2009-02-13 17:55:45,2009-02-12 15:55:54
901d615c5d74bea20e0c8d7fcdf7585616306b79...4b15b4ab5f9b19caff6d4a910ecc3e1d4f0e13f0,1,0,3,3,2,2009-02-14 02:19:37,2009-02-13 17:33:34
4b15b4ab5f9b19caff6d4a910ecc3e1d4f0e13f0...e9cc02f0e41fd5d2f51e3c3f2b4f8cfa9e434432,2,2,7,9,2,2009-02-14 02:20:44,2009-02-13 18:26:09
7bbd8d6c139f163ee26b8416cd227408888f31c3...a70d4100d027503f441d696cb2bc60c65349d2e9,1,1,1,2,1,2009-01-18 05:43:33,2009-01-16 14:34:47
a70d4100d027503f441d696cb2bc60c65349d2e9...4d2e283a1ecda43de9b5cafea27b68a08dfd5767,1,1,1,2,1,2009-01-19 03:34:31,2009-01-19 03:34:31
7bbd8d6c139f163ee26b8416cd227408888f31c3...ae5a6c3684c378bc32c1f6ecc0e6dc45300c14c1,3,87,2,89,3,2009-01-18 02:36:49,2009-01-17 16:09:53
ae5a6c3684c378bc32c1f6ecc0e6dc45300c14c1...a884d0cb71463c28d0329c593dce1ef9758f6177,2,32,25,57,12,2009-01-18 02:37:02,2009-01-17 16:09:54
a884d0cb71463c28d0329c593dce1ef9758f6177...d18ba22154574390dbff2c060f44b9715477e95a,3,87,3,90,6,2009-01-18 02:37:19,2009-01-17 16:09:55
d18ba22154574390dbff2c060f44b9715477e95a...696acf45f9638b014c7132508de26d1a571c8a33,3,57,0,57,3,2009-01-18 02:37:21,2009-01-17 16:09:56
696acf45f9638b014c7132508de26d1a571c8a33...c2883e62f5b9980e5402431f2261c961354d0f15,2,65,24,89,8,2009-01-19 23:35:21,2009-01-19 08:04:25
c2883e62f5b9980e5402431f2261c961354d0f15...aa9c55b66719c86896d134d35de8c263c078a481,2,25,2,27,7,2009-01-20 00:36:34,2009-01-17 18:08:12
aa9c55b66719c86896d134d35de8c263c078a481...c829774c30e10473d3139edf92a4afe36e8abdc2,1,1,1,2,1,2009-01-20 00:44:17,2009-01-20 00:44:08
c829774c30e10473d3139edf92a4afe36e8abdc2...39765e5941d36f74cec4764d315da0ba5743547c,1,7,3,10,5,2009-01-20 05:58:31,2009-01-20 05:58:31
39765e5941d36f74cec4764d315da0ba5743547c...101d15e09712a0183db99d228d975c62970654cf,3,24,2,26,5,2009-01-20 06:18:29,2009-01-20 06:18:29
101d15e09712a0183db99d228d975c62970654cf...d7c03c1ff98be1d22dd18b70669ffc6fb76b39b3,1,2,6,8,2,2009-01-21 08:42:22,2009-01-21 08:37:38
d7c03c1ff98be1d22dd18b70669ffc6fb76b39b3...73ff1a131b340633b2ec2a0e68490de721448f56,1,0,2,2,1,2009-01-25 08:38:37,2009-01-24 22:23:14
7bbd8d6c139f163ee26b8416cd227408888f31c3...6b89d068bd78b978743e96de7827d8a2a4d9f200,1,4,2,6,2,2009-01-18 02:17:29,2009-01-16 21:42:33
6b89d068bd78b978743e96de7827d8a2a4d9f200...7de931c3c2c7850dd7f26c24fbe9d12d223f55f6,1,0,2,2,2,2009-01-18 02:22:21,2009-01-16 16:01:57
7de931c3c2c7850dd7f26c24fbe9d12d223f55f6...8108513422eac0b0df947ab58f63a6a215faa1ae,1,2,0,2,1,2009-01-18 02:22:46,2009-01-16 16:02:04
8108513422eac0b0df947ab58f63a6a215faa1ae...3d279863dedf6c07eefe307b27fb3a08e519140f,1,4,4,8,3,2009-01-18 02:23:27,2009-01-16 16:02:15
3d279863dedf6c07eefe307b27fb3a08e519140f...5c38ea31f345d08f37685cf4f50c599a7af56bcf,3,418,0,418,3,2009-01-18 05:40:57,2009-01-16 08:00:02
7bbd8d6c139f163ee26b8416cd227408888f31c3...5ef8d77a752884f3c5fad9f143ce5cc72ff1340c,2,10,2,12,3,2009-01-18 02:03:58,2009-01-17 15:32:30
5ef8d77a752884f3c5fad9f143ce5cc72ff1340c...c002922adce90b69ac56a86eeb77b249afa88eb2,3,21,1,22,5,2009-01-18 02:04:24,2009-01-17 15:38:46
c002922adce90b69ac56a86eeb77b249afa88eb2...2c2dc7c82cea66c5030583233c73593e0f5a8fdb,1,21,17,38,12,2009-01-20 05:34:46,2009-01-20 04:30:30
7bbd8d6c139f163ee26b8416cd227408888f31c3...2292ce4785170d5502c4c9ea860bb73c6379f029,1,4,2,6,1,2009-01-18 01:16:16,2009-01-16 19:09:58
2292ce4785170d5502c4c9ea860bb73c6379f029...ae98a0089ff7f7641ed15ddd595797de56eb49f1,7,57,113,170,12,2009-01-18 01:16:24,2009-01-16 19:09:59
ae98a0089ff7f7641ed15ddd595797de56eb49f1...35d5ae679c2a6bc2a5f70f9209844ae8c14ae9e3,1,15,0,15,1,2009-01-18 01:16:34,2009-01-16 19:10:00
35d5ae679c2a6bc2a5f70f9209844ae8c14ae9e3...cf94ca8ea98373d6f5e9caaa764eca89b20bfb63,1,3,3,6,2,2009-01-18 01:16:44,2009-01-16 19:10:01
cf94ca8ea98373d6f5e9caaa764eca89b20bfb63...14e6298f1215da503f0f65b63e13d674dd781868,2,10,10,20,5,2009-01-18 01:57:15,2009-01-17 03:02:55
0fd9d7e66deb7071da2a568b96c94f94ee890908...733070bea9ce28d557f0b0950acc05b3fe6ff6c6,1,13,2,15,3,2008-12-03 07:45:37,2008-11-08 05:24:33
c14639f7b14d3d856c7c1f6c097dd1cb9615a5d0...e9854a767208776f4745922945f0982ef5caab66,1,20,6,26,5,2008-11-13 17:06:58,2008-08-17 04:25:40
3289b9dec56d34fe05f90c262d11adc0a61e16e7...83d0289df6fb4deae100ee3fc37b90683c2e8c9f,3,22,10,32,5,2008-11-15 05:39:10,2008-11-13 20:11:46
a91be3fcbe92c24e809b1ec85881a6da40a9a340...246295bdeb00ec6d533f22937992d1f9a06f8e71,2,29,3,32,7,2009-08-10 15:30:26,2009-07-21 17:32:31
246295bdeb00ec6d533f22937992d1f9a06f8e71...2ee94d141eb86c1e43453664eea7a45b37dbf72f,2,2176,0,2176,2,2009-08-10 15:43:07,2009-06-23 18:35:35
2ee94d141eb86c1e43453664eea7a45b37dbf72f...2112be76508aa5d480a8cefeb634444acefcf598,1,9,7,16,1,2009-08-10 15:47:34,2009-06-15 21:19:56
2112be76508aa5d480a8cefeb634444acefcf598...dd6451f9c7c5a36d3006231b618ac6da06c7c7b4,2,21,1,22,5,2009-08-12 14:41:52,2009-08-11 18:50:00
dd6451f9c7c5a36d3006231b618ac6da06c7c7b4...b350e460daac075a676f6ca449a3b83c9dc37a25,1,16,12,28,8,2009-08-12 15:34:37,2009-08-12 15:24:10
b350e460daac075a676f6ca449a3b83c9dc37a25...af413de47b8b285ffa489df14023180456986c05,1,6,4,10,2,2009-08-27 00:35:16,2009-08-26 20:25:15
af413de47b8b285ffa489df14023180456986c05...118d938812f3fc660f43bad9b546e7dadc3571a9,1,2,2,4,2,2009-08-27 00:42:50,2009-08-27 00:39:45
118d938812f3fc660f43bad9b546e7dadc3571a9...ed7b603381a57f706d758cf5a2f2ce604ef8c825,1,21,0,21,2,2009-09-12 18:35:29,2009-09-08 18:39:33
ed7b603381a57f706d758cf5a2f2ce604ef8c825...cd846aa183a01b8d881122a938f93ba38bc12629,1,1,0,1,1,2009-09-25 23:42:00,2009-09-24 16:56:28
cd846aa183a01b8d881122a938f93ba38bc12629...acb9108c19e40b0477b8c828d1c5054665abbaf4,1,1,1,2,1,2009-10-27 18:25:59,2009-10-16 09:41:26
9003dd40272e556288129272655e654bd33e6fa5...507cfcbd81196e14053bcd25735aaefabd99395d,2,12,13,25,12,2009-01-19 06:44:13,2009-01-19 05:27:19
507cfcbd81196e14053bcd25735aaefabd99395d...28da86a58d7861626eb9d33a1bcfa3e1e79a4d13,1,6,2,8,3,2009-01-19 06:44:17,2009-01-19 05:34:29
28da86a58d7861626eb9d33a1bcfa3e1e79a4d13...47d5a8fa7188cceb90fe50f1561e64381e8530a3,1,2,1,3,2,2009-01-19 23:16:24,2009-01-19 21:17:59
47d5a8fa7188cceb90fe50f1561e64381e8530a3...20bf7292314972d4c418056ad94c28c6363058d7,1,21,15,36,7,2009-01-19 23:21:00,2009-01-19 21:18:00
9a1fd653b13b6cc136bfa5b9563f629b2af1a6c8...5a625b07bbff709037f26be1c393337b6d9e103f,1,9,27,36,9,2008-10-06 06:48:43,2008-10-03 19:34:49
5a625b07bbff709037f26be1c393337b6d9e103f...5209ac4de4192e4ffcd72861517daccf387391e5,1,2,0,2,1,2008-10-06 06:49:55,2008-10-03 16:23:50
5209ac4de4192e4ffcd72861517daccf387391e5...fe8aa148b2cba66fb2643e4df1670c132da5d706,1,2,2,4,1,2008-10-06 07:01:07,2008-10-05 13:53:00
fe8aa148b2cba66fb2643e4df1670c132da5d706...71b989e7dd1dcf891369319cfeda0ed8b6a152e1,2,25,0,25,2,2008-10-06 07:29:28,2008-10-05 19:35:15
71b989e7dd1dcf891369319cfeda0ed8b6a152e1...62525ef78e8aec776f44da525030d76b52f14a57,1,2,7,9,2,2008-10-06 07:37:30,2008-10-05 00:40:36
62525ef78e8aec776f44da525030d76b52f14a57...d09e2cd5516473753cb067e723293fab180e0b1b,2,5,0,5,2,2008-10-06 07:49:57,2008-10-05 02:14:40
d09e2cd5516473753cb067e723293fab180e0b1b...00e5d48a9aef3228496d6f517a272fa095c562fe,1,7,0,7,1,2008-10-06 08:17:05,2008-10-05 13:26:54
00e5d48a9aef3228496d6f517a272fa095c562fe...d70b4a8f4ba79fb83dc95e9483f9fb3feaf578b7,3,148,7,155,5,2008-10-06 08:19:14,2008-10-06 05:14:24
d70b4a8f4ba79fb83dc95e9483f9fb3feaf578b7...e261cf94848d31868c21fb11cade51c30dfcdbe7,1,51,1,52,8,2008-10-06 15:55:00,2008-10-06 15:22:19
9a1fd653b13b6cc136bfa5b9563f629b2af1a6c8...0e214af9c34623979b19bb183bd8e518d749fd63,1,0,1,1,1,2008-10-03 14:51:54,2008-10-03 06:39:36
9a1fd653b13b6cc136bfa5b9563f629b2af1a6c8...7c4188360ac157217046dd99f4d98a4bf17907a8,1,11,6,17,6,2008-10-03 02:23:55,2008-10-03 00:08:21
7c4188360ac157217046dd99f4d98a4bf17907a8...943cea901483c95ee7c83b70191bf7cc8f4f7c21,1,1,1,2,1,2008-10-03 14:43:28,2008-10-03 09:33:20
5070b49e529e2df30ec2e33073267d281450dde6...bc7c73e29cfb38232b5b6b1d1e8d59e7145a9860,1,13,4,17,5,2008-06-26 23:51:23,2007-12-02 06:16:19
bc7c73e29cfb38232b5b6b1d1e8d59e7145a9860...872354dcb3ce5f34f7ddb12d2c89d26a1ea4daf0,3,45,2,47,3,2008-06-27 00:11:21,2008-06-27 00:11:21
77599cc0bbd0a08defc3bfa80ca52d931d8dc786...20bd3b072f93a8a8a4151a08513cfc3622ac963d,2,28,1,29,2,2008-05-26 04:11:24,2008-05-26 04:11:24
c0f6dc9b20523a569e567d3be4cabbc949c71b43...7064ca51b08304d56bf57d2cceb2884f1abf66e5,4,11,3,14,5,2008-06-07 18:45:48,2008-06-07 18:45:48
f371d3ea3ca7933df787230f2eb9b67901bde9d3...4a24bfc22081a6c2771b62d464222f81c470192c,1,1,2,3,2,2008-12-10 06:09:11,2008-12-09 22:46:16
4a24bfc22081a6c2771b62d464222f81c470192c...d2ce10d7b7d67ff8b50ae749ce4c5b1a2b8d133c,1,39,28,67,18,2008-12-10 08:21:05,2008-12-09 22:48:51
d2ce10d7b7d67ff8b50ae749ce4c5b1a2b8d133c...39c19ce2755830dd1dfdabf36e2b0166df3546f8,1,11,5,16,1,2008-12-11 06:59:55,2008-12-11 00:33:29
f371d3ea3ca7933df787230f2eb9b67901bde9d3...b96524f83aa6ba7bd08fb59bb0aa07453a984a8d,1,5,2,7,2,2008-12-08 03:08:15,2008-12-06 01:54:10
b96524f83aa6ba7bd08fb59bb0aa07453a984a8d...63e8dc5b14b8b80c1a0138c73c875bd82b8b027d,1,1,1,2,1,2008-12-08 03:08:23,2008-12-06 01:54:11
63e8dc5b14b8b80c1a0138c73c875bd82b8b027d...5ec11af61d907311e4e1b21e10009b06dc2cf74a,3,4,4,8,7,2008-12-08 03:59:25,2008-12-08 02:54:17
5ec11af61d907311e4e1b21e10009b06dc2cf74a...e10ea8126c27b079e81932ca487747b4961d0604,1,4,0,4,1,2008-12-08 03:59:32,2008-12-08 02:57:01
e10ea8126c27b079e81932ca487747b4961d0604...4586864afee675eb1c617666f806664aef04a02a,2,11,1,12,2,2008-12-08 17:04:36,2008-12-08 13:13:21
4586864afee675eb1c617666f806664aef04a02a...9c0c1b1f28e27bf4ac8a7b13f0b0ed3eaebc8cff,1,3,0,3,1,2008-12-09 01:11:37,2008-12-08 18:29:09
9c0c1b1f28e27bf4ac8a7b13f0b0ed3eaebc8cff...29b802aae6213d02879d21aabac1a8d2e035b583,9,48,49,97,36,2008-12-10 04:57:52,2008-12-09 06:23:51
29b802aae6213d02879d21aabac1a8d2e035b583...75bc9573b0e332c34bc1c3d97306077fda573083,1,10,3,13,1,2008-12-10 05:39:16,2008-12-09 15:41:50
75bc9573b0e332c34bc1c3d97306077fda573083...51ea440637bca30392dded5a75e23f382ce2f23a,2,2,2,4,2,2008-12-10 05:39:23,2008-12-09 17:26:22
51ea440637bca30392dded5a75e23f382ce2f23a...0c01857df57fe8723714e49459e0c061fcaf056b,2,48,1,49,2,2008-12-10 06:14:25,2008-12-09 08:12:28
0c01857df57fe8723714e49459e0c061fcaf056b...3aa1f7ca3779f73164b285c070b71abcdd7397c1,2,59,13,72,11,2008-12-10 06:28:55,2008-12-09 08:13:21
b53bb301f5781b05fb59891128db21a331dca032...c21398be6d7b112fa3a041b4b7d869d9954bf753,1,58,23,81,8,2009-09-10 11:46:28,2009-09-07 00:08:21
c21398be6d7b112fa3a041b4b7d869d9954bf753...9bedb0e185332f9f8fb5e1c18bb5aff9964145a6,1,1,0,1,1,2009-09-21 03:04:48,2009-09-15 09:26:30
a95148dea1d9546e96adef7c3cad11be80aa30f5...3426e34feddf97085615e619d39f8173ff3f9fb4,1,4,0,4,2,2009-05-14 03:35:36,2009-05-11 11:02:18
a95148dea1d9546e96adef7c3cad11be80aa30f5...1be570f4ebb5f3c4e0a56341db166a760829782a,1,14,0,14,2,2009-05-14 03:25:56,2009-05-11 14:42:53
1be570f4ebb5f3c4e0a56341db166a760829782a...57ffc5f85a17416a718d4e7baf71d8356c9c7808,2,3,3,6,3,2009-05-14 16:43:54,2009-05-11 14:42:54
a95148dea1d9546e96adef7c3cad11be80aa30f5...4e218f54b3de6aa8ef7d15020c4507031a519f7d,2,26,3,29,7,2009-03-22 22:03:59,2009-03-21 11:42:52
a95148dea1d9546e96adef7c3cad11be80aa30f5...19de5d6913b9681d2bde533bccc8445c9236a648,1,2,1,3,2,2009-03-05 04:36:24,2009-03-04 17:47:39
a95148dea1d9546e96adef7c3cad11be80aa30f5...f243319c21968c10d37cbb0c7f02127ac5d67d7f,2,7,1,8,2,2009-03-04 08:37:50,2009-03-04 08:37:50
159c88e5ae95c5b02298193c1658fac5919c8012...6d0e674a575421347abe5749e645ca6dc78c8207,7,106,1,107,10,2008-12-29 09:05:21,2008-12-28 18:45:32
159c88e5ae95c5b02298193c1658fac5919c8012...8b30ad01b421213113c64a1d3e46dcd8791d88df,1,4,3,7,2,2008-12-29 08:40:04,2008-12-29 08:03:08
8b30ad01b421213113c64a1d3e46dcd8791d88df...9c6c304d6a01b72d7ce20722b80ca62e01fe8356,2,7,3,10,2,2008-12-29 08:40:10,2008-12-29 08:03:09
f53bd743ff713f6507f28f8e730ac3e27858ab43...cec08717cca468c66eb454c7201fd35f54b48a58,2,8,5,13,4,2009-01-07 06:06:07,2009-01-06 20:41:06
a1d383c5ab90ec19c8a77158f65e5ea7d61fb42c...7defefb134270b6e8ab3e422b343b41a4a383f5d,1,11,4,15,5,2010-05-30 01:54:54,2010-05-20 09:50:41
7defefb134270b6e8ab3e422b343b41a4a383f5d...1cca16eca9094dafe9291eb13ec809e071a0a249,1,303,298,601,294,2010-12-11 22:55:43,2010-09-12 20:17:05
1cca16eca9094dafe9291eb13ec809e071a0a249...ae4e3ff93df4489579400d8af0629cdd4e5a3e67,1,61,3,64,16,2010-12-11 23:46:52,2010-10-16 10:15:10
ae4e3ff93df4489579400d8af0629cdd4e5a3e67...120ea892a001db97c9ee83272e0c666e9825637a,1,1,0,1,1,2010-12-12 04:24:09,2010-11-14 12:21:50
120ea892a001db97c9ee83272e0c666e9825637a...4adcbea06eaedd9235ac879bf0c6fbaefb0442fc,1,1,0,1,1,2010-12-12 04:24:09,2010-11-14 12:22:56
4adcbea06eaedd9235ac879bf0c6fbaefb0442fc...6758ad94405258294918ca5520acf1a3184a78b9,1,1277,0,1277,1,2010-12-14 09:04:11,2010-12-07 22:56:06
718258e256b74622aa55f5ee0cb9cff4cce6bf9f...3e0c4ffdbddf1b3f84e0b8aa70e3b2fff68a56c5,1,1,1,2,1,2009-03-03 07:15:47,2009-03-01 22:45:41
3e0c4ffdbddf1b3f84e0b8aa70e3b2fff68a56c5...aaab4b9fb97c1f638d02be7b8c432a4d57f37c56,1,11,0,11,1,2009-03-12 03:54:42,2009-03-11 22:40:13
718258e256b74622aa55f5ee0cb9cff4cce6bf9f...2478dc84b5fb2617bfab3a8f65f1270de578b94a,1,1,0,1,1,2009-02-28 09:06:05,2009-02-28 07:58:50
2478dc84b5fb2617bfab3a8f65f1270de578b94a...cd673c1f17228d272c4b7f81fbb28bc31cf0cac6,7,33,13,46,14,2009-02-28 09:06:06,2009-02-28 07:15:53
cd673c1f17228d272c4b7f81fbb28bc31cf0cac6...b8431b033f9e60f87a75b864612873307a3e5966,4,12,9,21,11,2009-02-28 09:06:06,2009-02-28 07:30:38
b8431b033f9e60f87a75b864612873307a3e5966...386cb77210cdb09cd808698d21d0e796cd77f26f,4,17,21,38,7,2009-02-28 09:06:06,2009-02-28 07:43:37
386cb77210cdb09cd808698d21d0e796cd77f26f...03a9683d22eca52bc2b2b9b09258a143e76416f6,5,18,51,69,14,2009-02-28 09:06:06,2009-02-28 08:00:21
03a9683d22eca52bc2b2b9b09258a143e76416f6...69e020ae00ebd3f7ae3c2f35acb139361417ef64,5,13,21,34,14,2009-02-28 09:06:06,2009-02-28 08:37:19
718258e256b74622aa55f5ee0cb9cff4cce6bf9f...1b249ffe8dff12849e3e215b46b245daecfadba0,2,66,35,101,9,2009-02-27 08:57:28,2009-02-27 06:31:22
718258e256b74622aa55f5ee0cb9cff4cce6bf9f...6e180cdcecbb3e828aa892925d7ef67abf81ad80,7,72,27,99,13,2009-02-25 22:39:42,2009-02-25 07:11:29
718258e256b74622aa55f5ee0cb9cff4cce6bf9f...27c03aafdf29736f889c56777426066c74fa115d,1,2,1,3,1,2008-12-21 20:04:12,2008-12-21 16:30:22
7ad0f27b925463c5ca6908573ed24ede11a9981f...14d4642e2a472ba4c06e10a3f5623d944b869314,2,3,1,4,2,2008-07-03 04:21:59,2008-07-03 02:32:45
78e3118685bc2050b4ee9ab754dcd79eb2ed4fb7...faf466ffb1b81a6af3946645865b3a38f33cdc11,1,2,2,4,2,2008-07-07 02:20:50,2008-07-06 20:34:21
78e3118685bc2050b4ee9ab754dcd79eb2ed4fb7...2b2da6846370978123935258890a059167dc73bd,1,4,4,8,4,2008-07-05 23:41:11,2008-07-05 00:00:13
2b2da6846370978123935258890a059167dc73bd...a41a32bf1ce74f3be5c1ab398db1a93b89e6a99e,3,14,0,14,3,2008-07-06 00:42:16,2008-07-05 04:43:41
a41a32bf1ce74f3be5c1ab398db1a93b89e6a99e...70cff3ac16e842e465f304e7af3b588840899dc9,1,4,12,16,2,2008-07-06 00:42:24,2008-07-05 05:24:41
70cff3ac16e842e465f304e7af3b588840899dc9...cd8be6c9b64adcb7744aba89bac8ef4261ccacc5,1,9,16,25,5,2008-07-06 00:42:30,2008-07-05 05:24:42
cd8be6c9b64adcb7744aba89bac8ef4261ccacc5...daec808cc61af32de789a31dd5c96001915c3f2d,1,2,6,8,1,2008-07-06 00:42:34,2008-07-05 05:24:43
daec808cc61af32de789a31dd5c96001915c3f2d...7ef8ea7035a3be4a97259e53e8dd3c1b8fd81ac0,1,12,24,36,8,2008-07-06 00:42:46,2008-07-05 05:24:44
7ef8ea7035a3be4a97259e53e8dd3c1b8fd81ac0...984c6e7ec1f7f6278a207b7d6178962f85130d10,1,4,7,11,2,2008-07-06 00:42:54,2008-07-05 05:24:40
984c6e7ec1f7f6278a207b7d6178962f85130d10...8a33dd8b6e29722e86556c178d7c0b963804f0d3,1,17,16,33,2,2008-07-06 01:31:15,2008-07-06 01:14:27
8a33dd8b6e29722e86556c178d7c0b963804f0d3...9b373229506c9f563b2e2f053c3f1d932789fbfd,1,3,1,4,1,2008-07-06 01:32:36,2008-07-06 00:58:50
6cd3729eae8d8945c0482423149163d40afd082c...171d7661eda111d3e35f6e8097a1a3a07b30026c,1,3,1,4,2,2008-11-12 23:04:54,2008-11-12 23:04:54
4deca329f5da1552c8d087975dd5107519cabef7...1324fb6f161ee516eb4c597880847003a42c0c5d,2,4,3,7,3,2008-11-12 21:55:17,2008-11-12 08:23:37
f4f78e668dd40f2d4a5bc119cccb3c34c2675c38...f0cea83f631689331fce73b51f22707e897f7939,2,51,12,63,14,2009-06-10 06:49:31,2009-06-09 23:50:18
f4f78e668dd40f2d4a5bc119cccb3c34c2675c38...9a8531eeba5053281e14ef14e6beb019ce17f07e,1,5,2,7,2,2009-06-10 06:47:49,2009-06-09 16:15:47
9a8531eeba5053281e14ef14e6beb019ce17f07e...cb9d398c3506a6354a1c63d265a4228fcec28fda,1,24,0,24,2,2009-06-10 15:41:03,2009-06-09 08:23:44
f4f78e668dd40f2d4a5bc119cccb3c34c2675c38...203462347fce0eab563fe77640648a7e8ae64d3b,5,37,4,41,12,2009-06-10 06:46:47,2009-06-09 16:01:34
203462347fce0eab563fe77640648a7e8ae64d3b...e1ca424112d5e8923a4a83af0f79eadbff088b69,1,13,0,13,1,2009-06-10 06:46:47,2009-06-09 16:01:35
e1ca424112d5e8923a4a83af0f79eadbff088b69...056724c6240ce79ff5ef4e91191bf7366dadba88,1,4,0,4,1,2009-06-10 06:46:47,2009-06-09 16:01:36
056724c6240ce79ff5ef4e91191bf7366dadba88...857f8c30d79ce15b6110b0df9d3ad87075ca5153,2,22,8,30,6,2009-06-13 17:31:33,2009-06-13 16:29:10
857f8c30d79ce15b6110b0df9d3ad87075ca5153...4a4b4cdaabde477514c4938b60961538e1d2d91f,1,26,5,31,5,2009-06-13 17:38:11,2009-06-13 16:29:11
4a4b4cdaabde477514c4938b60961538e1d2d91f...ce61595ea7eb3df22f6a943a38a273141f1af978,1,2,2,4,2,2009-06-14 20:35:40,2009-06-14 19:46:10
26c117d05d0714ab688ebcafc8eb68c769152bde...b875036e5a2ab569a2123abe9ebfe25258227951,2,13,0,13,2,2009-06-27 18:14:53,2009-06-27 15:58:44
b875036e5a2ab569a2123abe9ebfe25258227951...f8b5a8e13cb4d60c8b630f92a8f07590ef218ec5,1,18,2,20,1,2009-06-27 18:14:53,2009-06-27 15:58:45
f8b5a8e13cb4d60c8b630f92a8f07590ef218ec5...d824cbba02a4061400a0e382f9bd241fbbff34f0,42,117,133,250,105,2009-06-27 18:14:53,2009-06-27 15:58:46
d824cbba02a4061400a0e382f9bd241fbbff34f0...0721c314a5c8fddc877140ab5a333c42c62f780d,30,79,74,153,71,2009-06-27 18:14:53,2009-06-27 15:58:47
26c117d05d0714ab688ebcafc8eb68c769152bde...cb319c36312a16d8af9b635a75404bc0005c5119,1,2,4,6,5,2009-06-07 23:23:04,2009-06-07 11:33:05
cb319c36312a16d8af9b635a75404bc0005c5119...a3a8262bf6e2acbb1b61cc25be073713e183c766,1,9,1,10,2,2009-06-09 07:15:57,2009-06-08 00:25:58
a3a8262bf6e2acbb1b61cc25be073713e183c766...d1fff6fce0e065d1dbb1450146a6f6f79b349229,2,6,6,12,6,2009-06-09 07:15:57,2009-06-07 01:12:31
d1fff6fce0e065d1dbb1450146a6f6f79b349229...e169b974593c27ba7a0d7f63ec0ec40373cb64bb,2,6,4,10,2,2009-06-09 07:15:57,2009-06-07 23:39:15
e169b974593c27ba7a0d7f63ec0ec40373cb64bb...0077138cd9d4f94636184553afd8b33b98d320a1,3,18,45,63,11,2009-06-09 07:15:57,2009-06-08 20:34:29
0077138cd9d4f94636184553afd8b33b98d320a1...4e2715fb9878235cb696f765695eef38078b0b7a,1,6,10,16,5,2009-06-09 07:15:57,2009-06-08 20:34:31
4e2715fb9878235cb696f765695eef38078b0b7a...f39d6ee2aad735641dce90f7e021e6b6862963c6,2,10,10,20,4,2009-06-09 07:18:24,2009-06-08 22:57:06
f39d6ee2aad735641dce90f7e021e6b6862963c6...8513c54b2a4a821336d10fae6e02db70f0876abc,1,2,2,4,2,2009-06-09 07:18:32,2009-06-08 22:57:39
a80aad7b85fc560451e07792d64ab6cb15a39914...30d8080ca76432a60142f6af04e477bfa24b7f4c,1,2,0,2,2,2009-05-23 05:52:00,2009-05-23 01:06:06
30d8080ca76432a60142f6af04e477bfa24b7f4c...a0c0be97d492ea870cb8fb626eaca43b4d9cf34f,1,3,1,4,1,2009-05-23 05:55:31,2009-05-23 05:55:31
a80aad7b85fc560451e07792d64ab6cb15a39914...14afe77486281e411bfadd131e5c8ffc44e22a26,1,2,1,3,2,2009-05-22 16:26:54,2009-05-22 15:35:46
b19293df9e84ed056bc984aa7ef716689b58b0b1...8c7f78823888306c1cceafcf5fd26739eef99ce3,1,8,1,9,2,2009-03-30 20:29:31,2009-03-30 20:29:31
281907574ca420cc9a800190509adbf89bf9a2d1...9273b56278e64dd47b1a96a705ddf46aeaf6afe3,2,16,13,29,3,2009-02-04 05:54:02,2009-02-03 18:27:03
821d56aa68c38f7390b3171092f7b8b814357194...b60df87a6b39b3e9fc2fe81585a8bc55a502dcd3,2,0,3,3,2,2009-03-22 05:45:28,2009-03-22 04:32:43
4306bcb4e14ab708f0083bcf0339fa77a4005c05...a42dea3281898b06be687f6763e1a52b898ac2d8,1,11,11,22,7,2009-03-23 03:58:16,2009-03-23 03:11:10
a42dea3281898b06be687f6763e1a52b898ac2d8...1d52b02696d01f7222419f3379565ba05faf1143,1,43,43,86,25,2009-03-23 03:59:20,2009-03-23 01:00:14
1d52b02696d01f7222419f3379565ba05faf1143...d83a42f34a6c12e4c1a3a18bf6f9036cc4933691,1,9,9,18,5,2009-03-23 04:02:08,2009-03-23 01:00:15
d83a42f34a6c12e4c1a3a18bf6f9036cc4933691...3460a60064652dd79c1017c6701228d3c53ab3a4,1,8,8,16,6,2009-03-23 04:02:38,2009-03-23 01:00:16
3460a60064652dd79c1017c6701228d3c53ab3a4...cd747dc6dcb18f10b90fd8a1f8831b1da3551354,1,20,20,40,14,2009-03-23 04:03:39,2009-03-23 01:00:17
cd747dc6dcb18f10b90fd8a1f8831b1da3551354...19fa5e8c4d62d445b822e0d0d87a4f995e6c863f,1,3,3,6,2,2009-03-26 03:47:29,2009-03-26 03:44:44
de7697808fd8b552479a60fa3b98440d541b42de...8e24cbaeafc7eed709e251fda1673ffea84edfb1,5,8,14,22,12,2009-03-16 01:25:24,2009-03-15 21:01:20
325e9bca373349c028a72a796ebcff0732092759...dcc901bc2926f92558a854430570123b4152451d,1,6,6,12,4,2009-02-28 22:39:33,2009-02-28 21:12:59
8c5b85ce87d15e4db37a6408f03b0eb71dde080e...535bb89320ba949f0d64eda530ba5dec0ec6f188,2,32,28,60,3,2009-02-24 05:56:43,2009-02-23 05:08:10
535bb89320ba949f0d64eda530ba5dec0ec6f188...161261b12b3777bc78ef3fbe84ccf595dd195704,2,11,8,19,8,2009-02-24 05:56:45,2009-02-23 05:08:11
161261b12b3777bc78ef3fbe84ccf595dd195704...cefa318ddbc8565b50ac2eb9b6aab93e26cc0abe,2,46,0,46,2,2009-02-24 05:56:46,2009-02-23 05:08:12
cefa318ddbc8565b50ac2eb9b6aab93e26cc0abe...b225290445210bbdef207e42de21edbf8baa24aa,9,413,0,413,9,2009-02-24 05:56:47,2009-02-23 05:08:13
b225290445210bbdef207e42de21edbf8baa24aa...0dc062122ee114db087c10007fd374f26725dae7,12,921,0,921,12,2009-02-24 05:56:48,2009-02-23 05:08:14
0dc062122ee114db087c10007fd374f26725dae7...9291ccfd27e1e1958b50df7f408996ac22c0776a,4,115,0,115,4,2009-03-21 06:39:17,2009-03-18 17:33:34
9291ccfd27e1e1958b50df7f408996ac22c0776a...3867906b376638cdba6be86755db1d1268ab89c9,4,103,11,114,15,2009-03-21 06:41:01,2009-03-18 17:33:41
3867906b376638cdba6be86755db1d1268ab89c9...0eaadfe625fdb9fe9e469413b5e295f6c2ac46ad,1,0,3,3,3,2009-04-05 08:40:50,2009-04-05 08:40:50
8c5b85ce87d15e4db37a6408f03b0eb71dde080e...21ba0e84356cb73faecc4c5bf30df7b2222961d2,1,16,13,29,13,2009-02-21 12:49:36,2009-02-16 10:39:11
21ba0e84356cb73faecc4c5bf30df7b2222961d2...5b4e44104ea9f933e461ed7d3ce4a05a00d95dbb,1,6,2,8,2,2009-02-21 12:49:44,2009-02-16 10:40:08
5b4e44104ea9f933e461ed7d3ce4a05a00d95dbb...6f3c504b54e93772e875b6210fe69ecbad978e78,1,39,0,39,1,2009-02-21 12:57:53,2009-02-16 10:40:29
8c5b85ce87d15e4db37a6408f03b0eb71dde080e...7dff9b30ea0603fe265f9f7da055fc34f5d57d2f,3,12,2,14,5,2009-02-21 05:45:42,2009-02-20 22:15:22
e9cc02f0e41fd5d2f51e3c3f2b4f8cfa9e434432...c64d84f1452ec56fd1586493a0b0707bf7442c42,2,60,0,60,6,2009-02-15 08:32:57,2009-02-12 14:58:12
e9cc02f0e41fd5d2f51e3c3f2b4f8cfa9e434432...eed6ca7c402cb51ff6cfd3ecf1f1cac788579b5d,1,11,2,13,5,2009-02-15 05:48:37,2009-02-15 04:32:13
eed6ca7c402cb51ff6cfd3ecf1f1cac788579b5d...5012699d9840fe34fe0838ea0d529c2f32f76b82,2,123,74,197,29,2009-02-15 05:48:38,2009-02-15 04:32:14
5012699d9840fe34fe0838ea0d529c2f32f76b82...3531e2703d8e441bfb4a6765459317b3db3f224c,3,169,36,205,18,2009-02-15 05:48:38,2009-02-15 04:32:15
3531e2703d8e441bfb4a6765459317b3db3f224c...afe756c936334a5a374a8e0e8ee70a7f319dd71b,1,11,9,20,3,2009-02-24 06:03:50,2009-02-23 18:51:37
e9cc02f0e41fd5d2f51e3c3f2b4f8cfa9e434432...900569661bbfe5c0e56cf8b9c014a2f594bb174c,3,20,29,49,16,2009-02-15 05:27:35,2009-02-14 22:21:04
e9cc02f0e41fd5d2f51e3c3f2b4f8cfa9e434432...d0268de6d755c72ff375ec95a0cc0dbd99dc31e2,1,41,0,41,1,2009-02-15 05:18:54,2009-02-14 20:56:51
d0268de6d755c72ff375ec95a0cc0dbd99dc31e2...8fb3c00d2ea4dad96fe977f8983ba0376e0c4986,2,9,9,18,4,2009-02-15 05:29:46,2009-02-14 16:16:28
8fb3c00d2ea4dad96fe977f8983ba0376e0c4986...db7fee8758cfe17b0f06ddae7bb4259ed506240c,1,3,3,6,3,2009-02-15 05:29:50,2009-02-14 16:16:29
db7fee8758cfe17b0f06ddae7bb4259ed506240c...48c9ab78f3c7a0cc51e8d17bb7e37a075996c223,1,1,1,2,1,2009-02-15 05:31:16,2009-02-14 16:21:52
e9cc02f0e41fd5d2f51e3c3f2b4f8cfa9e434432...58e9d9d472ff4dbc6cfbf7459878778c739395eb,3,59,8,67,8,2009-02-15 05:14:07,2009-02-14 22:10:10
2ab4de57ea2c423fe8abae5278507106972ef1fe...d551bbaf3af1fad947c704bdeb9cf664b34e38c6,1,2,1,3,1,2008-12-07 10:41:45,2008-12-06 20:50:09
d551bbaf3af1fad947c704bdeb9cf664b34e38c6...e4a80ecf40c9651741def7c4f0b2ca56b42af1a8,1,4,7,11,3,2008-12-07 10:41:55,2008-12-07 00:45:37
e4a80ecf40c9651741def7c4f0b2ca56b42af1a8...bcc6a833032e0830195c1de1b834006a1d0156fe,1,1,0,1,1,2008-12-07 10:52:37,2008-12-07 09:36:36
bcc6a833032e0830195c1de1b834006a1d0156fe...3927bbe9a4d4033551dea39ac1abb9cdc45d822c,1,20,8,28,5,2008-12-07 10:53:45,2008-12-06 19:40:34
3927bbe9a4d4033551dea39ac1abb9cdc45d822c...dbc2fb6b841dd3a72c52a5a161e2362a26fc65f5,3,31,3,34,4,2008-12-07 22:57:57,2008-10-11 01:56:15
dbc2fb6b841dd3a72c52a5a161e2362a26fc65f5...1c2ed59de2d14ad6ee9daa4d4f7254297d9a3830,1,28,15,43,14,2008-12-07 23:11:54,2008-12-07 11:03:16
e9854a767208776f4745922945f0982ef5caab66...d0f19d0471792ace6d440c2789ce42227f07e69e,1,1,1,2,1,2008-11-15 05:41:19,2008-11-13 20:20:37
d0f19d0471792ace6d440c2789ce42227f07e69e...de07767faefc7ee08e1842b07106aaae55a1a6df,2,8,4,12,2,2008-11-15 05:48:10,2008-11-14 12:26:47
de07767faefc7ee08e1842b07106aaae55a1a6df...9e77353e0ea6e9e6d88ad1943570afb526d54a16,1,2,0,2,1,2008-11-15 05:49:42,2008-11-14 17:45:14
acb9108c19e40b0477b8c828d1c5054665abbaf4...c0d153295c6f9140e644aa740f588257aac1f825,1,7,1,8,2,2009-12-05 21:17:51,2009-12-04 21:26:48
c0d153295c6f9140e644aa740f588257aac1f825...88520cadf902c8bc780394e1ddecc726534c3df9,1,10,11,21,8,2009-12-05 21:48:03,2009-09-13 22:20:44
88520cadf902c8bc780394e1ddecc726534c3df9...10852086d4dceee924000ef70388b00704f7b463,1,15,1,16,2,2009-12-05 22:26:59,2008-11-13 19:02:09
10852086d4dceee924000ef70388b00704f7b463...60204ddb99187dd329000864a618e57742372d74,1,5,0,5,1,2009-12-07 15:39:58,2009-12-04 09:28:44
e261cf94848d31868c21fb11cade51c30dfcdbe7...daf6c2edc21ae1f018ef3829294024fc10756c8c,1,4,4,8,4,2008-10-07 18:26:56,2008-10-07 18:15:25
daf6c2edc21ae1f018ef3829294024fc10756c8c...cced48a808620d60e95a1e51254b135a46ddf719,2,18,8,26,2,2008-10-08 14:04:44,2008-10-07 16:08:21
cced48a808620d60e95a1e51254b135a46ddf719...bf07cc58aeb84b1262cc58f571d2f7033474efa7,2,20,6,26,3,2008-10-08 14:15:53,2008-10-07 14:26:20
bf07cc58aeb84b1262cc58f571d2f7033474efa7...0a2c7eea41867ead2b2fb1d5898494c3a72405e5,2,42,2,44,6,2008-10-08 14:18:44,2008-10-07 05:37:48
0a2c7eea41867ead2b2fb1d5898494c3a72405e5...fb7424363643d6049faf3bda399e5e602782b5b7,1,4,1,5,2,2008-10-08 14:38:48,2008-10-06 17:28:41
027b5a4f3e7b7ba8b1f65050f05267c3273bc5f4...875471c510b29f920693834b43a992c99694af58,1,4,18,22,4,2008-10-09 16:09:50,2008-10-02 23:52:11
875471c510b29f920693834b43a992c99694af58...b8ebe08b9a643f432866eb7150c3b20d59b755f2,1,1,1,2,1,2008-10-09 16:21:50,2008-10-08 21:24:16
44c33a5b9603fba7c9556512a72e4e392ba4ae2d...838cd34664422863096f1a089f779bed1f00edf6,3,14,6,20,9,2008-10-10 14:09:30,2008-10-10 02:08:51
838cd34664422863096f1a089f779bed1f00edf6...b8eecafd888d219633f4c29e8b6a90fc21a46dfd,1,2,1,3,2,2008-10-10 15:01:40,2008-10-09 22:07:10
b8eecafd888d219633f4c29e8b6a90fc21a46dfd...ff74126c03a8dfd04e7533573a5c420f2a7112ac,2,13,1,14,3,2008-10-10 15:32:03,2008-10-10 11:42:12
872354dcb3ce5f34f7ddb12d2c89d26a1ea4daf0...dfff4b7aa42de7e7d58caeebe2c6128449f09b76,1,2,36,38,2,2008-12-17 05:54:44,2008-12-17 03:42:02
dfff4b7aa42de7e7d58caeebe2c6128449f09b76...34b146c0f444fc9f83bea3215bd0cd546fc57c33,2,11,1,12,2,2008-12-17 06:06:47,2008-12-17 06:03:29
a2f5be500839bdf75e4721cc68642b821128b7b9...f8fcb57bb45e8d3d8f7921377d6c2503590efc3c,1,2,2,4,1,2008-05-26 22:09:56,2008-05-26 22:09:51
f8fcb57bb45e8d3d8f7921377d6c2503590efc3c...df2740b066b2d6649449f2d8efdd0727647ab57c,1,12,10,22,1,2008-05-27 02:10:03,2008-05-26 13:24:02
7064ca51b08304d56bf57d2cceb2884f1abf66e5...170e095a9cfe31617162e8a9b5063b8bc38af82b,1,0,0,0,0,2008-06-08 17:48:46,2008-06-08 14:40:13
5363d0744e7360beee990d3c2a8c1eb64a23071e...a325a1a70b90a0cef39a258f1471e5770aa66eee,3,22,0,22,8,2008-12-11 03:17:43,2008-12-10 22:44:50
5363d0744e7360beee990d3c2a8c1eb64a23071e...de749a972d3e262de27928785c83c7b286a18df0,1,1,1,2,1,2008-12-10 19:39:07,2008-12-10 19:39:07
de749a972d3e262de27928785c83c7b286a18df0...71fe9451312b159eb4d42a9407c6f9e8b6b26176,1,1,1,2,1,2008-12-10 23:39:00,2008-12-10 22:27:44
71fe9451312b159eb4d42a9407c6f9e8b6b26176...07e62b733fad4236371a8cd6abc32409fb1fb87d,1,6,3,9,2,2008-12-11 03:07:35,2008-12-10 09:25:19
9bedb0e185332f9f8fb5e1c18bb5aff9964145a6...5497f7a23ac11f9b230892220d5ed80263eedd1f,1,14,2,16,7,2009-11-03 11:28:20,2009-10-15 16:51:49
5497f7a23ac11f9b230892220d5ed80263eedd1f...90a77925417646041ac408e591f969d7477be0a9,1,1,1,2,1,2009-11-03 11:28:34,2009-10-27 17:13:42
90a77925417646041ac408e591f969d7477be0a9...5c838d23aa02476cfe91b0eea047b6d5857da770,1,20,1,21,2,2009-11-03 11:28:42,2009-10-28 11:40:45
5c838d23aa02476cfe91b0eea047b6d5857da770...d40bc70ab88ab0d8fde20650c6ca132d3ca3cd2c,1,1245,0,1245,1,2009-11-03 11:28:42,2009-10-29 16:22:26
d40bc70ab88ab0d8fde20650c6ca132d3ca3cd2c...8d849957d81fc0480a52570d66cc3c2a688ecb1b,1,4,4,8,3,2009-11-03 11:28:42,2009-11-02 12:41:00
8d849957d81fc0480a52570d66cc3c2a688ecb1b...51a7e8b654a0f06dde6f66ae89a35297cea09168,1,12,2,14,3,2009-11-14 10:15:01,2009-11-14 10:15:01
51a7e8b654a0f06dde6f66ae89a35297cea09168...70a5fc443acbd1fe69cc21c10190375facabaf93,1,3,0,3,1,2009-11-14 10:19:11,2009-11-03 16:00:12
70a5fc443acbd1fe69cc21c10190375facabaf93...a4390ace1a871d786b33456d6e80728bd2ab3b61,1,3,0,3,1,2009-11-14 10:19:12,2009-11-03 23:21:41
a4390ace1a871d786b33456d6e80728bd2ab3b61...63ea915e163af144ebc82817be154c0e72c08bda,1,270,260,530,246,2009-11-14 10:21:08,2009-11-14 10:21:08
0823ab4783654c82732996efd2710055885f3101...628d5c2b707db207e47c42ca112b182aa171cfaa,2,13,7,20,7,2009-03-04 08:56:51,2009-02-17 03:26:49
628d5c2b707db207e47c42ca112b182aa171cfaa...e752f4bba24afe964eb42d6c2b8bf06cc77c9ce4,1,2,0,2,1,2009-03-04 08:56:51,2009-02-17 02:59:00
e752f4bba24afe964eb42d6c2b8bf06cc77c9ce4...9f199b159580545c39716fd87038f8ff7cd0eace,2,44,3,47,4,2009-03-04 08:56:52,2009-02-21 08:26:01
9f199b159580545c39716fd87038f8ff7cd0eace...28001d0873cfce1ad6a44f1c2deaf9388d953cc3,2,5,3,8,3,2009-03-04 08:56:52,2009-02-19 07:36:00
28001d0873cfce1ad6a44f1c2deaf9388d953cc3...50dffd4ed577ea50b540bad53950ef2b703b5be8,1,10,0,10,3,2009-03-04 08:56:52,2009-02-19 07:36:11
50dffd4ed577ea50b540bad53950ef2b703b5be8...734cd5726cf0f16fcbdc2fc121df23814513c420,1,3,1,4,1,2009-03-04 08:56:52,2009-02-19 07:36:35
734cd5726cf0f16fcbdc2fc121df23814513c420...aec0c1bbfb2d42659bb710bd79f8228ac59e1b0c,3,31,0,31,8,2009-03-04 08:56:52,2009-02-16 17:20:25
aec0c1bbfb2d42659bb710bd79f8228ac59e1b0c...05ac6b34e2c2adda5cb85dd0bdacb47fe5db953e,4,4,4,8,4,2009-03-05 04:37:21,2009-03-04 08:32:29
f243319c21968c10d37cbb0c7f02127ac5d67d7f...bdfd739dac4c109ce360d38d0572d8717a46e795,1,2,2,4,2,2009-03-05 04:35:19,2009-03-04 15:00:44
c123b7c5fb596d93cd015645212c379fc3c381d5...8ca12c0d62c0be4a4987c4a936467ea2a92e915a,9,31,47,78,25,2009-01-11 21:21:57,2009-01-10 12:07:50
8ca12c0d62c0be4a4987c4a936467ea2a92e915a...55892d23981917aefdb387ad7d0429f90cbd446a,4,46,3,49,6,2009-01-11 21:26:29,2009-01-11 12:19:12
c123b7c5fb596d93cd015645212c379fc3c381d5...d3240d935c4b844db71e4570eeedfac4cff73f78,3,50,1,51,8,2009-01-11 01:35:58,2008-10-31 09:12:21
d3240d935c4b844db71e4570eeedfac4cff73f78...c9a114b591e42be3ed8e5e4812dfd1031df79a78,1,1,1,2,1,2009-01-11 01:37:58,2008-12-10 19:39:17
c9a114b591e42be3ed8e5e4812dfd1031df79a78...df3987717f1546719a1bf1828fb3714cd5ca9faa,1,1,0,1,1,2009-01-11 01:37:58,2008-12-10 19:39:18
df3987717f1546719a1bf1828fb3714cd5ca9faa...7eb5bbdb645e04d746bc0edea102744f50a5e529,2,21,4,25,2,2009-01-11 01:45:02,2009-01-09 17:30:05
c123b7c5fb596d93cd015645212c379fc3c381d5...fb62eb7fab97cea880ea7fe4f341a4dfad14ab48,1,7,4,11,4,2009-01-10 05:33:35,2009-01-09 23:08:40
fb62eb7fab97cea880ea7fe4f341a4dfad14ab48...c822255cfc1ac83daeeeee1647e3c775450c830c,2,26,4,30,5,2009-01-10 05:35:56,2009-01-09 23:18:34
a9012e343eee2404a54abcc5bbff9e63f5683029...fb3bb3d1325f1d0a8cdc402a596c9a520b0ccbe6,1,3,2,5,1,2008-12-28 06:34:03,2008-12-27 09:39:31
fb3bb3d1325f1d0a8cdc402a596c9a520b0ccbe6...a9e67c8ccc6958d09c575a3d4837a49d8a2ec7d5,1,4,14,18,8,2008-12-29 09:08:02,2008-12-29 07:03:17
a9e67c8ccc6958d09c575a3d4837a49d8a2ec7d5...936b7057e8401665a2d106e8de018561db6333fe,2,24,1,25,2,2008-12-29 09:17:34,2008-12-29 09:17:34
6758ad94405258294918ca5520acf1a3184a78b9...7add5aff869746ced2b506801176561d4b80e427,1,1,1,2,1,2011-01-19 09:31:21,2011-01-07 00:42:33
7add5aff869746ced2b506801176561d4b80e427...7317a104c4bbaa9bd061f4276297c924ba91a946,1,12,12,24,12,2011-01-19 09:32:28,2011-01-17 21:23:12
7317a104c4bbaa9bd061f4276297c924ba91a946...21ac8a8d0b8d95058e8fc7121ab7e653ab948c9e,1,9,6,15,8,2011-03-09 09:52:38,2011-03-09 09:52:38
21ac8a8d0b8d95058e8fc7121ab7e653ab948c9e...8dd60f5401c6ccfb69de5e8f76c55fa9e92edae5,1,4,3,7,4,2011-03-09 10:05:02,2011-03-01 23:50:50
8dd60f5401c6ccfb69de5e8f76c55fa9e92edae5...b74307f6a551d50e9b1aa121a326d32ff1827a93,1,1,1,2,1,2011-04-09 12:19:38,2011-01-19 19:45:00
2d642a6f8a5d17db21a60865f8970b9231d34e31...2fc647004ac7016128372a85db8245581e493812,2,22,6,28,9,2009-01-07 06:13:43,2009-01-06 20:41:14
141201d124f3663a98e0f362c1af7f5f7b58dabb...47a845bfc3a9e1d378c43c3b3ea4291d5d79eca8,1,3,0,3,1,2009-01-13 01:47:36,2009-01-13 01:19:42
47a845bfc3a9e1d378c43c3b3ea4291d5d79eca8...12dd1112886f18730ee471420619e77783cd5943,1,1,1,2,1,2009-01-13 08:21:31,2009-01-12 23:09:36
141201d124f3663a98e0f362c1af7f5f7b58dabb...9800a754f931d05c2d26da9c1b188ae2c2b80eb4,2,76,4,80,6,2009-01-13 01:00:54,2009-01-12 23:18:02
141201d124f3663a98e0f362c1af7f5f7b58dabb...39c68542fc8d8477f2080c99efedb9dce975abc6,9,99,34,133,32,2009-01-11 10:13:06,2009-01-08 03:54:47
141201d124f3663a98e0f362c1af7f5f7b58dabb...353aaf2fa136d34db64d1e4af12cc12431466a9e,6,114,9,123,7,2009-01-11 01:54:30,2009-01-07 22:43:42
353aaf2fa136d34db64d1e4af12cc12431466a9e...ddfb3696b91e2a2261b79d0828a7a715e3d71c1e,2,5,1,6,2,2009-01-12 23:22:11,2009-01-12 23:22:11
ddfb3696b91e2a2261b79d0828a7a715e3d71c1e...806d5e90440046a7807f757d70acb29573f89524,5,11,1,12,3,2009-01-28 23:12:24,2009-01-13 09:33:48
806d5e90440046a7807f757d70acb29573f89524...c32815f903f50a44006f6d12da11492141e70d73,14,100,0,100,13,2009-01-29 00:23:21,2009-01-12 22:21:04
141201d124f3663a98e0f362c1af7f5f7b58dabb...68c2ec7f43c4dc16833ff58af76ab20e9cdfad17,1,7,0,7,1,2009-01-11 01:40:57,2009-01-10 20:41:33
69e020ae00ebd3f7ae3c2f35acb139361417ef64...92cd872202241a0b80e88dadac5a4db071c8d1fa,1,44,0,44,1,2009-03-20 20:32:33,2009-03-20 03:47:50
92cd872202241a0b80e88dadac5a4db071c8d1fa...171110a4a67f04c28d2ac89385ab88ba051fc780,2,2,6,8,2,2009-03-20 20:32:33,2009-03-20 03:47:51
171110a4a67f04c28d2ac89385ab88ba051fc780...79bc4c715516fdb393d107359327c1e7fbb8bf04,2,3,3,6,3,2009-03-20 20:32:33,2009-03-20 03:47:52
79bc4c715516fdb393d107359327c1e7fbb8bf04...4d6acb70411cd4fe69610cf1b22f186fa01614f7,5,2,31,33,9,2009-03-20 20:32:33,2009-03-20 03:47:54
4d6acb70411cd4fe69610cf1b22f186fa01614f7...869a3d34c1aea92a10bc8eaa994bd55f4b0b04f2,1,17,0,17,1,2009-03-22 04:31:24,2009-03-21 22:25:30
869a3d34c1aea92a10bc8eaa994bd55f4b0b04f2...094085e3362c592c932b41525ed37152ec171192,2,26,2,28,3,2009-03-22 04:58:44,2009-03-21 22:26:11
1b249ffe8dff12849e3e215b46b245daecfadba0...cce074a2760940cb78232ce2201ab5590e274d4a,1,7,1,8,1,2009-02-27 22:30:34,2009-02-27 06:31:22
6e180cdcecbb3e828aa892925d7ef67abf81ad80...2c626e5fa8a46f647b88fb32d7b28d573e8631bf,1,2,1,3,2,2009-02-26 16:40:27,2009-02-26 15:31:52
27c03aafdf29736f889c56777426066c74fa115d...c9a42c4a12cec17e858b76d6c68aa17c12c0aef1,2,65,0,65,3,2009-01-05 18:47:07,2009-01-02 18:08:46
27c03aafdf29736f889c56777426066c74fa115d...3442ea4a75a3c76f65efac71b414584f765e5a99,2,5,1,6,3,2009-01-03 21:34:19,2009-01-03 12:07:32
9b373229506c9f563b2e2f053c3f1d932789fbfd...3ecb171d2b9aca7b09bf112594977d00925893b4,1,1,1,2,1,2008-07-06 06:30:38,2008-07-06 04:10:04
171d7661eda111d3e35f6e8097a1a3a07b30026c...6a004d3f2e531936d6d91324a0610a874f91a867,1,3,3,6,3,2008-11-14 06:33:58,2008-10-21 21:12:15
6a004d3f2e531936d6d91324a0610a874f91a867...16fc08e2d86dad152194829d21bc55b2ef0c8fb1,2,101,3,104,3,2008-11-14 06:33:58,2008-10-30 06:49:26
16fc08e2d86dad152194829d21bc55b2ef0c8fb1...fe4003f6308b88bcc44a989f12e1baddd97f22d4,2,16,5,21,2,2008-11-14 06:33:59,2008-11-06 05:07:39
fe4003f6308b88bcc44a989f12e1baddd97f22d4...bcdd1b4456998256df19ea0347bf4a7fa5410eef,1,10,5,15,5,2008-11-14 06:36:34,2008-11-13 12:04:09
bcdd1b4456998256df19ea0347bf4a7fa5410eef...1b3069a753e2a2a3794db9235ea79747833cad65,1,5,4,9,4,2008-11-14 06:42:45,2008-11-12 16:38:06
cb9d398c3506a6354a1c63d265a4228fcec28fda...30dd916348001e4313708473d91d633d3b14d1b5,1,40,1,41,6,2009-06-18 17:45:05,2009-05-28 03:16:02
30dd916348001e4313708473d91d633d3b14d1b5...754ae192a4390baeb4d00b96e72c69023efb22ee,2,14,1,15,3,2009-06-18 17:51:29,2009-05-28 03:16:03
cb9d398c3506a6354a1c63d265a4228fcec28fda...97af7ff0553ed81bb905dbc0c8b0f9a0c10bfb3d,2,31,5,36,4,2009-06-12 02:49:59,2009-06-11 22:39:18
97af7ff0553ed81bb905dbc0c8b0f9a0c10bfb3d...e9460a66e0d11b718757cd88eb0c927f2b79e1c8,2,21,1,22,5,2009-06-12 02:50:34,2009-06-11 22:39:19
e9460a66e0d11b718757cd88eb0c927f2b79e1c8...62d955fd435273dcd9fffed0c0d83bbe90006a0a,2,0,224,224,3,2009-06-12 02:50:45,2009-06-11 22:39:21
8c7f78823888306c1cceafcf5fd26739eef99ce3...bf637803a799451e7feb596422932dd60f0384e1,1,9,0,9,1,2009-04-01 18:00:54,2009-03-31 00:18:36
bf637803a799451e7feb596422932dd60f0384e1...fd94836923708581ca3f9b5c42a6d600c2f631dc,1,1,1,2,1,2009-04-01 18:05:54,2009-03-31 12:29:23
9273b56278e64dd47b1a96a705ddf46aeaf6afe3...26be15f09db15d2b53a13d0f184d77fb54367f33,1,1,1,2,1,2009-02-06 01:48:04,2009-02-05 18:19:33
2a5643da732b70004920f75efa1ebdc2a6ed1689...5d83f9c19810229bb765ef63864e4f252e83ad61,1,2,2,4,2,2009-03-25 19:15:30,2009-03-25 17:19:46
8e24cbaeafc7eed709e251fda1673ffea84edfb1...b3debd2b0c091990c420f78e074c0c160498e51d,1,113,0,113,1,2009-03-17 16:21:27,2009-01-24 14:04:39
b3debd2b0c091990c420f78e074c0c160498e51d...7be401e069758cc36d335241d9b80f9aeebf58c7,2,22,2,24,3,2009-03-17 16:21:32,2009-01-24 14:04:39
7be401e069758cc36d335241d9b80f9aeebf58c7...d42ec126aa717d00549e387d5a95fd55683c2e2c,1,2,0,2,2,2009-03-17 20:36:24,2009-03-17 16:22:53
d42ec126aa717d00549e387d5a95fd55683c2e2c...d6aba61f88dafc10cfb874b91e7864419fa81fd7,1,24,2,26,2,2009-03-17 21:15:04,2009-03-15 02:32:01
d6aba61f88dafc10cfb874b91e7864419fa81fd7...dcb11263bcdbf31955dd00777392249bf1624226,7,37,37,74,26,2009-03-17 21:16:44,2009-03-15 11:30:52
dcb11263bcdbf31955dd00777392249bf1624226...188c3827c10f5a04588ef7af8b63a7b5dbcc38ed,7,24,24,48,22,2009-03-17 21:25:52,2009-03-16 20:18:42
188c3827c10f5a04588ef7af8b63a7b5dbcc38ed...01d386121758ac72aedd5f268feb763d53fc3cdf,1,6,7,13,2,2009-03-17 21:30:21,2009-03-16 07:44:57
01d386121758ac72aedd5f268feb763d53fc3cdf...50fd6997c60f926efe4b3591f6c0a37568d02185,1,4,2,6,2,2009-03-17 22:10:12,2009-03-16 18:38:42
50fd6997c60f926efe4b3591f6c0a37568d02185...fcfdf797db015e13623645c0be049db679d5daaa,1,2,2,4,1,2009-03-17 22:10:23,2009-03-17 14:06:20
fcfdf797db015e13623645c0be049db679d5daaa...8ad3dae3a76ee42983da89ea9b5d9a4688f58f93,1,1,0,1,1,2009-03-17 22:12:40,2009-03-17 09:03:19
8ad3dae3a76ee42983da89ea9b5d9a4688f58f93...642d0844b9795ca7b1424f4afc8d8c86abd7bf34,1,5,0,5,1,2009-03-17 23:22:06,2009-03-17 17:31:42
8e24cbaeafc7eed709e251fda1673ffea84edfb1...7ee3760e2c8f181f22d4b80afc03309e4f764385,1,1,1,2,1,2009-03-16 19:18:18,2009-03-16 17:03:11
7ee3760e2c8f181f22d4b80afc03309e4f764385...6720721e152aee230387546efac865319f025597,1,10,2,12,1,2009-03-16 19:19:10,2009-03-16 17:03:12
dcc901bc2926f92558a854430570123b4152451d...0d66e95903a5c2567baa61cc7299ce865abe41b1,2,34,0,34,2,2009-03-07 20:21:45,2009-03-07 09:30:51
dcc901bc2926f92558a854430570123b4152451d...ac8463d2b4c0e88011c40985bc519c0e2e2f2278,1,49,0,49,1,2009-03-04 05:46:09,2009-03-03 15:08:20
ac8463d2b4c0e88011c40985bc519c0e2e2f2278...db75ada559dd4de99fedd1fc4f62a9273f032dd3,2,16,7,23,5,2009-03-04 05:46:09,2009-03-03 15:08:21
2d602e9179c7eb1a31a0abf41283c132e26a61af...31653c1abc1ac80206db9efca56ff1969150d8fe,2,59,16,75,10,2009-03-06 06:56:13,2009-02-20 22:51:11
2d602e9179c7eb1a31a0abf41283c132e26a61af...b4b0ba06f8748348039d56ffa5890590dd9776ee,1,6,5,11,3,2009-02-23 23:24:08,2009-02-18 18:12:14
2d602e9179c7eb1a31a0abf41283c132e26a61af...7d9fd459f1f5064b421837e46fe87118a07f6d6c,1,5,1,6,1,2009-02-23 04:30:58,2009-02-19 18:08:04
7d9fd459f1f5064b421837e46fe87118a07f6d6c...83c2fcff214fe89649fcd88e095d9961a36b53dd,3,205,0,205,3,2009-02-23 04:31:08,2009-02-23 04:25:00
83c2fcff214fe89649fcd88e095d9961a36b53dd...0df84059d4127ed06e040998ec0e6ce6f61d3d1f,2,15,1,16,2,2009-02-23 21:50:24,2009-02-23 11:02:53
c64d84f1452ec56fd1586493a0b0707bf7442c42...ace706e2a6213d4252b6862786dd93c71bcbd69f,1,8,7,15,3,2010-02-08 23:08:31,2010-02-06 19:26:35
afe756c936334a5a374a8e0e8ee70a7f319dd71b...c1f2aa45b7bdb82c4378443ae23ad9625e782fe2,3,174,39,213,26,2009-03-03 07:46:53,2009-03-03 04:52:18
7681ed2d2e4ac54bf7d25526d4d130af617d054a...c2aca7c40cff221b23a8b30eb8d4181e965f913d,1,19,0,19,1,2009-03-11 21:37:15,2009-03-11 21:37:15
1c2ed59de2d14ad6ee9daa4d4f7254297d9a3830...553589f7823db530d03b49db42251fbea624041f,2,54,4,58,3,2008-12-09 00:29:34,2008-12-08 13:31:31
553589f7823db530d03b49db42251fbea624041f...aa971cb9bf4105eefb435b9e6f282f019529c35f,1,9,9,18,9,2008-12-10 03:06:15,2008-12-08 02:38:46
9e77353e0ea6e9e6d88ad1943570afb526d54a16...07e77e40ff5d2cb6c7e2c5a68d9748f7811da85e,1,1,1,2,1,2008-11-16 08:15:50,2008-11-16 08:15:43
07e77e40ff5d2cb6c7e2c5a68d9748f7811da85e...4b4e26d21f77d9e90125ca1c8f48592a9cd6f543,1,2,0,2,1,2008-11-16 08:15:50,2008-11-16 08:10:25
60204ddb99187dd329000864a618e57742372d74...54350a2bb48f2d4cf56bd2b8220fad7124d3592c,1,3,4,7,3,2010-01-07 02:20:01,2010-01-06 08:16:38
54350a2bb48f2d4cf56bd2b8220fad7124d3592c...b677c66e299c8754a6093cbd19ce71b0ad2a8a17,1,8,2,10,3,2010-01-07 02:21:11,2009-12-31 13:32:53
b677c66e299c8754a6093cbd19ce71b0ad2a8a17...ea888f84bd6ebb7e944311d95251d28a3b547024,1,18,16,34,5,2010-01-23 22:22:28,2009-12-20 02:02:03
ea888f84bd6ebb7e944311d95251d28a3b547024...3c6a2870274ea629499dfb6a925548caf55ee105,1,4,0,4,3,2010-01-23 22:46:12,2010-01-23 22:37:17
3c6a2870274ea629499dfb6a925548caf55ee105...e27d106ec4b2f68c210703e4bfa3a0a0cf2550a4,1,1,1,2,1,2010-01-23 22:46:12,2010-01-21 12:15:17
e27d106ec4b2f68c210703e4bfa3a0a0cf2550a4...7ec2b69f1ad54db0acee165701c769de33f5ba13,1,3,0,3,1,2010-01-23 22:46:13,2009-12-07 20:35:59
7ec2b69f1ad54db0acee165701c769de33f5ba13...390425bdef450a0eb246552f94ca88a05dc11d06,1,1,0,1,1,2010-01-23 23:00:09,2009-12-08 00:22:42
390425bdef450a0eb246552f94ca88a05dc11d06...87cd09f43e56de5235d09aef3ff5d840419fef49,1,10,0,10,2,2010-01-23 23:14:04,2010-01-23 10:03:36
b6bc8c2309d7667ba5a43cb6417b5b60a358754d...c5ee71fdeda21aef8a65366a3f66aa7cbe58cba0,1,2,2,4,2,2009-01-20 06:38:06,2009-01-19 22:45:16
c5ee71fdeda21aef8a65366a3f66aa7cbe58cba0...f13bfc1be7d25955e3ff5563fb6e35d03a408b4e,1,1,1,2,1,2009-01-20 06:39:15,2009-01-19 23:38:16
f13bfc1be7d25955e3ff5563fb6e35d03a408b4e...bc08fc4e850794c76da367bb628e508e6d41b1eb,1,0,1,1,1,2009-01-20 06:39:19,2009-01-19 23:41:18
bc08fc4e850794c76da367bb628e508e6d41b1eb...35641310afa04aaa0ba5f31be6bdb2cf23ec100f,2,10,10,20,8,2009-01-20 06:39:31,2009-01-19 23:43:26
35641310afa04aaa0ba5f31be6bdb2cf23ec100f...b56c79ccea73fe53af3f3a3cc5ab7f5417fc898d,1,6,4,10,1,2009-01-20 06:39:38,2009-01-20 01:44:03
b56c79ccea73fe53af3f3a3cc5ab7f5417fc898d...a1a587ef7200ef2b091799399ae43abf6572a686,1,9,9,18,9,2009-01-21 08:12:25,2009-01-19 20:34:36
a1a587ef7200ef2b091799399ae43abf6572a686...27a58359c37142e61b1899d195ea096af7fbecf0,1,2,2,4,2,2009-01-21 08:15:34,2009-01-20 11:29:04
fb7424363643d6049faf3bda399e5e602782b5b7...36e40535dcafe230a7f5ef43fea5cf67c1c58f6f,1,2,2,4,2,2008-10-09 15:13:29,2008-10-09 00:07:54
ff74126c03a8dfd04e7533573a5c420f2a7112ac...969c877506cf8cc760c7b251fef6c5b6850bfc19,2,59,0,59,2,2008-10-12 18:09:41,2008-10-12 04:06:11
969c877506cf8cc760c7b251fef6c5b6850bfc19...72d404debaa804fca82fd9cf710fbde48c7305c6,1,1,1,2,1,2008-10-12 20:13:59,2008-10-12 20:13:59
34b146c0f444fc9f83bea3215bd0cd546fc57c33...ed62089c1c32a9bfca2ec61d331a70443647344c,2,43,2,45,3,2009-02-11 09:29:52,2009-02-11 09:27:43
53b22a9e45161004ff3260782abc4ee2a5b3e730...006f31d77f3dd5f813557c2839b39b2aaa22b925,3,13,2,15,3,2008-06-27 00:59:51,2008-06-27 00:16:50
170e095a9cfe31617162e8a9b5063b8bc38af82b...22e801f285eefb9d5887091741e19a2c4f9798bf,1,3,0,3,1,2008-06-09 22:49:44,2008-06-09 20:25:15
170e095a9cfe31617162e8a9b5063b8bc38af82b...eea982843e34da679689f7c53a4874894a225e9f,1,52,0,52,1,2008-06-09 22:37:44,2008-06-09 21:22:37
eea982843e34da679689f7c53a4874894a225e9f...249c61a62d82c22df98cb72ec61c120887b944e1,2,12,1,13,4,2008-06-09 23:11:08,2008-06-09 21:23:16
de0db422782ddaf7754ac5b03fdc6dc5de1a9ae4...a126ed0a01e265d7f3b2972a34e85636e12e6d34,2,4,2,6,2,2008-12-13 04:42:59,2008-12-12 23:20:07
de0db422782ddaf7754ac5b03fdc6dc5de1a9ae4...43cc2b4266cc75f1a5a10e1a805d05e419000573,1,4,1,5,2,2008-12-13 03:47:36,2008-12-11 20:36:47
43cc2b4266cc75f1a5a10e1a805d05e419000573...bf874896240cb00b22cd4f6cbcc143b17cc7fe0e,1,4,0,4,1,2008-12-14 02:55:55,2008-12-13 20:06:40
bf874896240cb00b22cd4f6cbcc143b17cc7fe0e...1415be8f0f86c6d2aa2cb014c3cc32dd92e9c43a,1,1,0,1,1,2008-12-16 05:54:12,2008-12-15 19:44:30
836769e875ecf47e83137a39de5937652e0e861e...a84bde927c0882db78a37d40168e98add63f2307,1,22,0,22,1,2009-03-05 22:50:00,2009-03-05 22:50:00
a84bde927c0882db78a37d40168e98add63f2307...fad5c96756fe9524fcb4e6ab7468368c2fb20fa0,1,17,1,18,3,2009-03-05 23:03:18,2009-03-05 12:36:14
fad5c96756fe9524fcb4e6ab7468368c2fb20fa0...1d4e4cd4a108dc105f6c8e739c69b9261d4e92a5,2,9,4,13,5,2009-03-05 23:08:53,2009-03-05 16:05:12
bdfd739dac4c109ce360d38d0572d8717a46e795...3d2d4f96d240317d898bd05af567bad938e0bda2,1,2,2,4,2,2009-03-07 19:21:41,2009-03-07 12:37:24
3d2d4f96d240317d898bd05af567bad938e0bda2...c2e9364a06df55e70d7652d37bb4d712f6b3bb3e,2,3,2,5,3,2009-03-07 19:22:42,2009-03-07 13:06:49
c2e9364a06df55e70d7652d37bb4d712f6b3bb3e...003f69b282f9cc54da771e1b3e9378aa3f5178cd,1,5,5,10,2,2009-03-07 19:28:53,2009-03-07 17:14:04
003f69b282f9cc54da771e1b3e9378aa3f5178cd...d57f07ebae7e84b356ff2b891adeccf965d2ba11,1,4,0,4,1,2009-03-07 19:33:51,2009-03-07 17:14:06
15624458a9de285fdd8a50cd25bdf83a8c9983b7...abc776f7880c2dc0a4179420366e40ecb99d223f,1,7,5,12,1,2009-01-13 07:36:03,2009-01-13 02:10:26
abc776f7880c2dc0a4179420366e40ecb99d223f...c2c5b27051babdc2a7503d5b9d695b4c7b45c14b,2,5,5,10,3,2009-01-13 08:14:55,2009-01-12 17:42:24
c2c5b27051babdc2a7503d5b9d695b4c7b45c14b...323b9db839cc4e49008666e402aac3264e359423,8,11,11,22,8,2009-01-13 08:18:53,2009-01-12 20:02:07
7eb5bbdb645e04d746bc0edea102744f50a5e529...92604b466344b2157efc42ef3521dac22d7906a2,1,125,40,165,17,2009-01-18 21:54:45,2009-01-18 15:14:50
92604b466344b2157efc42ef3521dac22d7906a2...09c9306658f793f2cad1ed7856b55a7c4e758703,3,63,36,99,16,2009-01-18 21:54:49,2009-01-18 15:14:51
09c9306658f793f2cad1ed7856b55a7c4e758703...bad4a54fa6fe8a9bbdfb5c3e413268eefde69b75,3,60,39,99,24,2009-01-18 21:54:54,2009-01-18 15:14:52
bad4a54fa6fe8a9bbdfb5c3e413268eefde69b75...aeabab5c712d5acae4a2836272d641acbb87b893,2,37,8,45,11,2009-01-18 21:58:31,2009-01-18 15:14:53
aeabab5c712d5acae4a2836272d641acbb87b893...bda6eb0da9b4e4e763b531c83cab9fd9f85934ff,2,9,0,9,2,2009-01-18 21:58:34,2009-01-18 15:14:54
7eb5bbdb645e04d746bc0edea102744f50a5e529...9002ec3ae6299dc7872033ba7f6c3cebf2f2c3c1,1,8,1,9,1,2009-01-11 21:05:33,2009-01-11 11:25:06
c822255cfc1ac83daeeeee1647e3c775450c830c...b4285c71bcc43c4cc9939b8d170aaf8ddb25f09f,3,92,1,93,4,2009-01-18 02:30:23,2009-01-17 15:50:13
b4285c71bcc43c4cc9939b8d170aaf8ddb25f09f...c841aa8b903200f5d7830c7c4ab8d62b5ef44c5c,1,14,18,32,2,2009-01-18 02:30:23,2009-01-17 15:50:29
c841aa8b903200f5d7830c7c4ab8d62b5ef44c5c...8cc32992624ed4140fb136d98675f0f19b20ba09,5,15,8,23,9,2009-01-18 02:30:37,2009-01-17 15:50:34
8cc32992624ed4140fb136d98675f0f19b20ba09...f9b7cce61cbd19c99e89b859b5909f0741111185,4,13,11,24,10,2009-01-18 02:30:41,2009-01-17 15:50:37
936b7057e8401665a2d106e8de018561db6333fe...d99bf51add655b749c5c7f94cecb337c7ef8aadb,1,2,2,4,2,2009-01-01 13:33:35,2008-12-27 19:49:03
936b7057e8401665a2d106e8de018561db6333fe...8e8daf33632d14f01d342b4f89d8afceecdd606b,2,9,3,12,3,2009-01-01 12:51:51,2008-12-30 19:45:11
4f8b8992ef0c009822cdca18d32ddf3a124ee284...8dca683346fcd17684eb6646c486461cae38241e,1,0,0,0,0,2009-01-15 01:00:00,2009-01-15 00:33:19
3ea95d2b0e6fa63e66de24a5084e217102ab9e8a...07b57e90f7c852c4fe212ab1d91058f27469a74b,2,29,0,29,2,2009-01-17 18:42:03,2009-01-17 16:29:42
07b57e90f7c852c4fe212ab1d91058f27469a74b...23c1575f747393f9847874fd1ed72a44557459d1,1,19,21,40,4,2009-01-17 18:42:19,2009-01-17 16:29:43
23c1575f747393f9847874fd1ed72a44557459d1...2e5d2003b28820f88296e47a79eb440ca0295000,2,159,68,227,15,2009-01-17 18:42:41,2009-01-17 16:29:44
2e5d2003b28820f88296e47a79eb440ca0295000...2b6a5417d750d086d1da906e46de2b3ad8df6753,4,118,10,128,17,2009-01-17 18:43:08,2009-01-17 16:29:45
2b6a5417d750d086d1da906e46de2b3ad8df6753...bf82940dbf12f066ba42a2a03a5bb626ba22c067,1,2,1,3,1,2009-01-17 18:43:24,2009-01-17 16:29:46
bf82940dbf12f066ba42a2a03a5bb626ba22c067...c4b252c3d894673968b144d8e10b79ef22c17b0a,1,10,5,15,2,2009-01-17 18:44:13,2009-01-17 16:29:47
c4b252c3d894673968b144d8e10b79ef22c17b0a...80c49c3de2d5a3aa12b0980a65f1163c8aef0c16,6,135,15,150,15,2009-01-17 18:44:21,2009-01-17 16:29:48
80c49c3de2d5a3aa12b0980a65f1163c8aef0c16...98a4d87b87e9846eafd21ba232cc2b7ba3f718fc,4,58,5,63,10,2009-01-21 08:51:12,2009-01-21 03:46:57
98a4d87b87e9846eafd21ba232cc2b7ba3f718fc...ae3b970ac3e21324a95fea75213c2569180d74c6,4,9,9,18,7,2009-01-22 07:52:16,2009-01-21 04:59:54
b74307f6a551d50e9b1aa121a326d32ff1827a93...ef73896b2b596fe07e86829e26839f37e2d7513a,1,1,4,5,2,2011-05-29 04:46:16,2011-01-19 19:46:59
ef73896b2b596fe07e86829e26839f37e2d7513a...f5974d97af06bca1382c585a515c8e1920333eb7,1,4,4,8,4,2011-05-29 04:46:16,2011-01-19 19:47:25
f5974d97af06bca1382c585a515c8e1920333eb7...36242490cd012bcf5148475aaa1a5abb76e4ef66,1,16,1,17,4,2011-05-29 04:51:06,2011-04-19 20:37:09
36242490cd012bcf5148475aaa1a5abb76e4ef66...bb3e86a11946fdd1262e1be7c71065ba6d79d85a,1,2,2,4,2,2011-07-24 05:34:48,2011-07-24 05:34:48
bb3e86a11946fdd1262e1be7c71065ba6d79d85a...c332f44514375fd8e70da2c347b7bb8f2bd240f4,1,10,1,11,3,2011-07-24 05:34:54,2011-04-05 02:14:12
c332f44514375fd8e70da2c347b7bb8f2bd240f4...9b6adf343350891384fef7252eefb404d0fee090,1,2,2,4,2,2011-07-24 05:34:54,2011-04-05 02:14:13
9b6adf343350891384fef7252eefb404d0fee090...0a2a979310c1ebc43d460fd8564981c9b3b99f07,1,2,2,4,2,2011-07-24 05:34:54,2011-04-05 02:14:14
0a2a979310c1ebc43d460fd8564981c9b3b99f07...784b7e2f25ce2a812d6b2dcbe4d3a2ea93484bb4,1,3,2,5,3,2011-07-24 05:34:54,2011-04-05 02:14:15
784b7e2f25ce2a812d6b2dcbe4d3a2ea93484bb4...929f577e0a648dd1c90b92d8a3f6f1899f2fa0e2,1,1,2,3,1,2011-07-24 05:34:54,2011-04-05 02:14:16
929f577e0a648dd1c90b92d8a3f6f1899f2fa0e2...da616db5e56a735ab3028c33b19af5136420dcb9,1,4,2,6,4,2011-07-24 05:34:54,2011-04-05 02:14:17
da616db5e56a735ab3028c33b19af5136420dcb9...86e847bcbf2b7f8700bcb3f3eaf7d08801e0cbab,1,1,14,15,3,2011-07-24 05:34:54,2011-04-05 02:14:18
86e847bcbf2b7f8700bcb3f3eaf7d08801e0cbab...74cb884faa2d4214e349879adda8adc73362d692,1,11,6,17,7,2011-07-24 05:34:54,2011-05-24 02:44:08
74cb884faa2d4214e349879adda8adc73362d692...de665fd3cfee674a62818246dfb158ecf81b2b76,1,6,1,7,2,2011-07-24 05:52:53,2011-07-13 08:30:26
de665fd3cfee674a62818246dfb158ecf81b2b76...811c70fc8369cfeae2f1e843c695c37e3b0c3109,1,6,6,12,2,2011-10-08 07:01:54,2011-09-19 16:49:50
a1eb73d917e15cd97314e0a39cbe857329339a96...82d97da30aba767e5c8406b595274af299858357,1,1,1,2,1,2009-08-28 03:05:10,2009-08-28 02:55:43
12dd1112886f18730ee471420619e77783cd5943...8faea4f3b2f68a6ef168c6ada1627835380a570d,1,2,2,4,1,2009-01-14 06:52:35,2009-01-13 22:41:35
8faea4f3b2f68a6ef168c6ada1627835380a570d...3d1d81eba29d5cfc5b214dc049b743ffbe032ef4,1,4,3,7,3,2009-01-14 06:57:12,2009-01-14 01:37:07
152d70f7287c54135aa93990b462e2d34a39f500...4fc988efe66ea079c926b1f01bf563a946b7797f,1,1,3,4,2,2009-01-12 05:47:26,2009-01-12 03:05:54
152d70f7287c54135aa93990b462e2d34a39f500...3f4b609f5f3146a34eb72e82ab55714328e0bd1a,1,3,0,3,1,2009-01-09 01:30:43,2009-01-08 18:53:01
3f4b609f5f3146a34eb72e82ab55714328e0bd1a...38920dd6d377a82f4c8c51c3451271d6a93c92a8,1,3,0,3,1,2009-01-09 01:32:19,2009-01-08 18:53:05
bb0cebd7d0ac9bf2ddf94fe5579603819c4a1fc7...661763abf6e13eabf0aa1a3eefd364d32da8f4ad,2,5,2,7,3,2009-02-25 22:50:52,2009-02-25 22:50:52
3ecb171d2b9aca7b09bf112594977d00925893b4...77cb7bc23294851e2b64307e33d2a0d97fee9b2d,1,0,1,1,1,2008-07-07 02:25:29,2008-07-06 22:56:49
77cb7bc23294851e2b64307e33d2a0d97fee9b2d...6fc2a25e6215f1b1916a3da93bf7ddace8ba5310,1,1,0,1,1,2008-07-07 05:59:51,2008-07-07 05:26:45
763481787174adfcc247d6044bea330edcb2cc24...bef3894847118ab8c8668ddc90fa238ae9e05baa,2,42,3,45,2,2009-04-02 20:16:42,2009-04-02 13:30:25
745bc77604f56d9253958fbcab81c4a8cd3bf170...f26b5dc9efccc998510505685d6d919b4dd087e7,1,4,4,8,1,2009-02-04 21:06:06,2009-02-04 20:49:35
5d83f9c19810229bb765ef63864e4f252e83ad61...81db4abf84ec7fbebeb08f6ad506138da2e7e4cd,2,1,9,10,2,2009-03-28 07:11:27,2009-03-28 01:57:18
5d83f9c19810229bb765ef63864e4f252e83ad61...2d266f9d623625e0a28fbe3c3615707500e9448f,1,12,9,21,2,2009-03-27 07:38:01,2009-03-26 17:29:25
d43c07b8ee6684a0df8636a0c849605f0ffc066f...10edf37796badc58239eb3e5d1e8e608f6e1473c,1,19,1,20,1,2009-02-25 08:44:43,2009-02-24 05:42:16
d43c07b8ee6684a0df8636a0c849605f0ffc066f...3a4c1a5e212357c3df030b6713c75466694c2e77,2,2,1,3,2,2009-02-25 07:53:36,2009-02-24 09:59:14
3a4c1a5e212357c3df030b6713c75466694c2e77...36407548a2825462a91b456755412a65fd611fc0,2,23,6,29,4,2009-02-25 07:53:38,2009-02-24 09:59:15
36407548a2825462a91b456755412a65fd611fc0...de84accc59baef73f7827d59f0d479521ecad937,2,8,0,8,2,2009-02-25 07:53:40,2009-02-24 09:59:16
de84accc59baef73f7827d59f0d479521ecad937...bb93afd5153948e58d6b09c86e7c106a65dbfb65,1,40,0,40,1,2009-02-25 08:07:17,2009-02-24 21:06:37
bb93afd5153948e58d6b09c86e7c106a65dbfb65...72de29c24f50dccc5f045a7756bb0b47e34a7a8e,1,12,2,14,4,2009-02-27 19:17:44,2009-02-24 13:33:29
d43c07b8ee6684a0df8636a0c849605f0ffc066f...3ca936422212370481850d67cab80b1e517b2d80,1,18,18,36,18,2009-02-25 05:10:57,2009-02-25 03:03:14
d43c07b8ee6684a0df8636a0c849605f0ffc066f...e871784132038a500f3390859da3bbe95b9a0fc2,1,7,1,8,2,2009-02-24 21:45:36,2009-02-24 19:44:49
aa971cb9bf4105eefb435b9e6f282f019529c35f...c74faea19e39ca933492f697596310397175c329,3,33,0,33,3,2008-12-11 01:56:05,2008-12-09 19:26:52
c74faea19e39ca933492f697596310397175c329...04d39759373e5de017e7c17ef4b762ac5ad3afcc,1,31,7,38,8,2008-12-11 08:09:48,2008-12-11 03:44:37
4b4e26d21f77d9e90125ca1c8f48592a9cd6f543...3eb91bfc0d2e0c8c67bd4ec62523deb849919dd9,1,3,3,6,1,2008-11-17 10:27:18,2008-11-17 08:57:19
87cd09f43e56de5235d09aef3ff5d840419fef49...d6db1bbe1151e3acfc6f25258cfa1d48d32dcc89,1,2,0,2,1,2010-01-29 15:58:52,2010-01-29 15:57:48
87cd09f43e56de5235d09aef3ff5d840419fef49...a9ae14a1c50a9b5bd051be629dba0fb04b6fd67a,1,13,4,17,3,2010-01-23 23:14:15,2010-01-23 22:04:12
a9ae14a1c50a9b5bd051be629dba0fb04b6fd67a...25476c63e7d3357f955b44dd6a7c825aba819987,1,110,16,126,12,2010-01-23 23:14:15,2010-01-02 16:58:49
25476c63e7d3357f955b44dd6a7c825aba819987...ff07c3b6210fbebf07ce2820b5a9a95f0583ad8d,2,153,104,257,16,2010-01-23 23:14:15,2009-12-08 00:22:43
ff07c3b6210fbebf07ce2820b5a9a95f0583ad8d...21985a11360fc845b73f8300a8739b7b073f0627,1,28,9,37,13,2010-01-23 23:14:21,2010-01-23 10:03:34
21985a11360fc845b73f8300a8739b7b073f0627...29e5573d1ef67c92314c39e55d26504fee119c04,1,36,7,43,6,2010-01-23 23:14:21,2010-01-23 10:03:35
29e5573d1ef67c92314c39e55d26504fee119c04...3748b03d92c3dcefcc65739f73ae0a1382a7da20,1,4,3,7,4,2010-01-23 23:15:55,2010-01-23 10:03:38
3748b03d92c3dcefcc65739f73ae0a1382a7da20...a9fa11fe5bd5978bb175b3b5663f6477a345d428,1,20,23,43,9,2010-01-24 00:02:16,2010-01-23 23:59:00
a9fa11fe5bd5978bb175b3b5663f6477a345d428...0602de48f74ca0d55db93ce6cdabb1576e41605a,1,1,1,2,1,2010-01-25 15:31:38,2010-01-24 18:54:19
0602de48f74ca0d55db93ce6cdabb1576e41605a...73b3446b829347ed729a8f02002c17bc638d574b,1,0,9,9,1,2010-01-25 15:33:41,2010-01-25 15:33:41
73b3446b829347ed729a8f02002c17bc638d574b...60eb4f1bd085fb8d7dc401f52c9b7115a84124b5,1,302,282,584,246,2010-01-26 23:47:45,2010-01-26 23:47:45
60eb4f1bd085fb8d7dc401f52c9b7115a84124b5...ab2d3b0d7d29bcdfd5c710cd762d90e78d5fc917,1,426,398,824,351,2010-01-28 01:13:47,2010-01-26 21:26:45
ab2d3b0d7d29bcdfd5c710cd762d90e78d5fc917...c80d7be5e1e0d110ea77cd41f658aabe5bcad0d8,26,697,453,1150,334,2010-01-28 01:13:52,2010-01-26 00:05:31
c80d7be5e1e0d110ea77cd41f658aabe5bcad0d8...fe9c06b7c9fc8de11fa4dcde0e5f13c9a2a7b2db,1,324,290,614,249,2010-01-28 15:17:47,2010-01-28 12:57:34
fe9c06b7c9fc8de11fa4dcde0e5f13c9a2a7b2db...cbdaf567c9178268b51a1dca2f0060111cae41e9,1,323,299,622,256,2010-01-28 15:18:29,2009-09-07 16:45:16
cbdaf567c9178268b51a1dca2f0060111cae41e9...831cc7ebb43046c0e5122bc24ab77e2655f3b9b5,1,1,1,2,1,2010-01-28 23:44:41,2010-01-28 21:20:39
72d404debaa804fca82fd9cf710fbde48c7305c6...6c1679254cb6be7b268d1431595e1626bf18792d,1,19,2,21,7,2008-10-13 22:41:36,2008-10-13 22:41:36
22e801f285eefb9d5887091741e19a2c4f9798bf...2feaf4e977c5e7392ef42689b34d60c4d2f40f4f,1,1,1,2,1,2008-06-11 23:21:45,2008-06-11 23:09:48
a126ed0a01e265d7f3b2972a34e85636e12e6d34...76aac715465b7678ca5b834ccbdcb88a3ab8a9f4,2,2,2,4,2,2009-03-22 00:30:51,2009-03-22 00:09:17
9a6682bab5e800465f0a4e44cdf18fe396ff4f6d...7efaeba2a8006bb52712eb90c6fbc736b9632cab,2,35,27,62,15,2009-03-11 06:17:56,2009-03-09 18:44:55
9a6682bab5e800465f0a4e44cdf18fe396ff4f6d...fa685bdf45cbaa997255cc78a23494b995e9769a,3,35,8,43,10,2009-03-11 06:14:20,2009-03-11 05:47:20
fa685bdf45cbaa997255cc78a23494b995e9769a...9326d49412c8c154b43cb7eba2a8692e9703b0f4,1,3,18,21,3,2009-03-16 07:35:09,2009-03-16 07:35:09
9002ec3ae6299dc7872033ba7f6c3cebf2f2c3c1...d28250654f4150f391b0fab6713ecb5748ccfd98,1,6,6,12,1,2009-01-22 06:46:52,2009-01-22 05:57:34
d28250654f4150f391b0fab6713ecb5748ccfd98...479b0ae81c9291a8bb8d7b2347cc58eeaa701304,1,55,52,107,16,2009-01-22 06:46:52,2009-01-22 05:59:56
479b0ae81c9291a8bb8d7b2347cc58eeaa701304...4a16d072723b48699ea162da24eff05eba298834,12,125,19,144,26,2009-01-22 06:46:52,2009-01-22 06:02:35
4a16d072723b48699ea162da24eff05eba298834...57b235a4bc8884a57c6f863605a54b7bfceb0997,8,17,13,30,8,2009-01-22 06:46:53,2009-01-22 06:03:08
57b235a4bc8884a57c6f863605a54b7bfceb0997...a3da8821208d6243dc5530d668f7c8f089814899,1,9,0,9,3,2009-01-22 06:46:53,2009-01-22 06:03:28
a3da8821208d6243dc5530d668f7c8f089814899...0ea8039644968e53d79a8dfbf739c87af4261d46,2,5,5,10,2,2009-01-30 09:14:26,2009-01-30 08:21:01
9002ec3ae6299dc7872033ba7f6c3cebf2f2c3c1...ff7e6aad6d995a52e88cfeaae10cf8a768ff2358,1,11,29,40,20,2009-01-11 23:56:55,2009-01-11 18:36:42
ff7e6aad6d995a52e88cfeaae10cf8a768ff2358...d727f676ad9f03c2b2a11ea68a2c6242ca02fa10,1,94,0,94,1,2009-01-12 00:16:40,2009-01-11 23:44:07
d99bf51add655b749c5c7f94cecb337c7ef8aadb...dcfdbdf08bbe102bd4806f3c92fb0e43f53a623a,1,3,0,3,1,2009-01-03 22:24:15,2009-01-03 03:59:12
dcfdbdf08bbe102bd4806f3c92fb0e43f53a623a...c7719fbe46deae03578c4e19516b9567e98b9f04,2,4,4,8,4,2009-01-05 20:04:02,2009-01-05 15:25:36
c7719fbe46deae03578c4e19516b9567e98b9f04...0ddd93b2717d4da074485d42a08e4d3824580afe,1,1,1,2,1,2009-01-05 20:04:23,2009-01-05 15:25:37
d99bf51add655b749c5c7f94cecb337c7ef8aadb...11b8a41c4569e99a57137cb2db4b642b57171797,1,4,3,7,2,2009-01-01 14:34:58,2008-12-29 00:25:00
8dca683346fcd17684eb6646c486461cae38241e...1c7c1d179e51f163c014353f33b406f5bae13922,1,1,1,2,1,2009-01-15 03:18:37,2009-01-14 14:54:34
1c7c1d179e51f163c014353f33b406f5bae13922...0b50922abffb82c473182b03eb5bb47a978cceac,5,17,51,68,14,2009-01-15 03:18:44,2009-01-14 14:54:35
811c70fc8369cfeae2f1e843c695c37e3b0c3109...3878e636c640763ad12bff7f4dca967c34c530d6,1,12,1,13,3,2012-03-18 23:00:22,2011-11-09 16:28:28
3878e636c640763ad12bff7f4dca967c34c530d6...44acce0befa22bc3af2132540e92da90a3a32286,1,164,100,264,4,2012-03-18 23:04:43,2011-12-13 14:56:49
44acce0befa22bc3af2132540e92da90a3a32286...65bb0bda75f4070a609d266d7231b4ec53d56972,1,27,11,38,4,2012-03-18 23:10:59,2011-12-13 16:50:50
65bb0bda75f4070a609d266d7231b4ec53d56972...6c9e2d1842c8ab6e283df8633b42254fc1e2fcc6,1,5,1,6,2,2012-03-18 23:16:53,2011-12-10 15:08:57
6c9e2d1842c8ab6e283df8633b42254fc1e2fcc6...585c27cb22676a55dea2681dfb768e0970cd6639,1,4,2,6,4,2012-03-18 23:23:43,2010-03-14 22:59:09
585c27cb22676a55dea2681dfb768e0970cd6639...5c9096f74756bdac219b9819060b581fc807e194,1,5,0,5,1,2012-03-18 23:23:43,2012-03-08 12:30:11
5c9096f74756bdac219b9819060b581fc807e194...22387f2395217beaa7228cb02966cf7b61b0c346,1,27,5,32,8,2012-03-19 00:21:08,2012-03-19 00:21:08
22387f2395217beaa7228cb02966cf7b61b0c346...6febdede5acdbab192d955d4e0cd810f3fbee27f,1,29,9,38,6,2012-03-23 11:07:27,2012-03-23 11:07:27
6febdede5acdbab192d955d4e0cd810f3fbee27f...b2b76d10696d945bf19318831b64d009d119e051,1,9,1,10,3,2012-03-24 05:44:12,2011-10-04 20:08:13
82d97da30aba767e5c8406b595274af299858357...153bb839aa0c36bf5c056a0b74b6d4d2fe99c157,1,7,7,14,7,2009-12-30 03:39:27,2009-12-29 08:13:18
153bb839aa0c36bf5c056a0b74b6d4d2fe99c157...e97ca7f41f2b9bbdfc93d103c3f64337bb6dcc20,1,4,2,6,4,2009-12-30 04:15:41,2009-12-29 21:54:49
82d97da30aba767e5c8406b595274af299858357...c970a6fd0142da3740f0205f16f91d3f2ed7e258,1,6,5,11,1,2009-11-27 23:11:47,2009-11-27 23:06:37
82d97da30aba767e5c8406b595274af299858357...ef2035c5e55f852905b012dfb2dd242b4f77da70,2,30,1,31,2,2009-09-04 09:35:24,2009-09-04 08:41:47
ef2035c5e55f852905b012dfb2dd242b4f77da70...efa574438fca4ed328d2e47ecdb6363c50a905ec,2,30,0,30,5,2009-09-04 18:44:40,2009-09-03 21:08:20
efa574438fca4ed328d2e47ecdb6363c50a905ec...92a1747eeab6bc497db748e79ca4f029b1c1dc10,1,15,9,24,3,2009-09-04 18:50:26,2009-09-04 05:26:33
92a1747eeab6bc497db748e79ca4f029b1c1dc10...77b15bbd88e2f48de093ff0e60de6dbc11e3329e,5,54,10,64,10,2009-09-04 18:50:26,2009-09-03 23:02:32
3d1d81eba29d5cfc5b214dc049b743ffbe032ef4...3772923f1429f2888074e698c36c071b864effe3,1,25,0,25,1,2009-01-14 17:29:24,2009-01-14 17:03:21
3772923f1429f2888074e698c36c071b864effe3...be17262d13f5f3df5ee9635b11dad180613e9cbd,2,2,1,3,2,2009-01-14 17:34:22,2009-01-14 17:03:22
688ba09cad80b0821886ad78fec039092306cead...3e5970a41ec0809efb792357af546ffa96568f66,1,1,1,2,1,2009-03-22 17:33:36,2009-03-22 09:15:13
688ba09cad80b0821886ad78fec039092306cead...c90d565a46a664663467557d381417a3153fe26e,1,4,0,4,1,2009-03-22 04:45:14,2009-03-21 22:21:18
48fce9356531469b00bd0e1592d77e8b229316d0...48679e5c2d059b9b198d6f414dd80aa921d23002,2,11,1,12,3,2009-02-28 05:53:09,2009-02-28 03:40:16
48679e5c2d059b9b198d6f414dd80aa921d23002...736e619a1be92fcb6eac0155b51bc93d1dcc3157,1,1,1,2,1,2009-02-28 05:53:43,2009-02-28 03:11:45
736e619a1be92fcb6eac0155b51bc93d1dcc3157...749485f6225455eefd4a2af31e2c98068f20464d,1,1,1,2,1,2009-02-28 19:47:25,2009-02-28 18:42:02
f474c526618d5d1111b585a6344e012fb731d3fe...dfa7a6c579d75037b9dd5c3654a36d31c60f203c,2,18,1,19,5,2009-03-03 07:50:44,2009-03-03 05:37:51
f474c526618d5d1111b585a6344e012fb731d3fe...a9c3821ca2fec065260b4314d61337a7529aba5b,4,60,9,69,10,2009-03-03 07:22:32,2009-03-01 22:11:38
a9c3821ca2fec065260b4314d61337a7529aba5b...a334e1254c0c2d55f20b271872fbac9a6a67218b,1,5,5,10,5,2009-03-03 07:22:54,2009-03-01 21:28:28
f474c526618d5d1111b585a6344e012fb731d3fe...ce163c793d2058056ccc57563c350fd6415397ca,1,8,10,18,2,2009-03-03 02:28:03,2009-03-02 23:00:55
ce163c793d2058056ccc57563c350fd6415397ca...56384e61ead8d41c39bfafb535eedcf67ef4fcc3,1,4,1,5,3,2009-03-03 02:28:06,2009-03-02 23:19:30
661763abf6e13eabf0aa1a3eefd364d32da8f4ad...2591838beece01f98773109a7c6932525be2d144,1,8,3,11,2,2009-02-27 00:20:58,2009-02-26 23:44:40
2591838beece01f98773109a7c6932525be2d144...c767184d8f99404d456b32a2c6c5c41d6db7a847,1,10,3,13,3,2009-02-27 07:06:27,2009-02-26 09:52:53
c767184d8f99404d456b32a2c6c5c41d6db7a847...2d56a136435bd40f9b6b75103eb4d75003154c9f,1,7,0,7,2,2009-02-27 07:06:38,2009-02-26 19:24:29
661763abf6e13eabf0aa1a3eefd364d32da8f4ad...75318a3bad4b7a25f617217891bfbcec26a9161a,2,8,9,17,3,2009-02-26 08:49:44,2009-02-25 08:32:08
75318a3bad4b7a25f617217891bfbcec26a9161a...119c8eeede81489b2ce8b26ae7dcb47290e257eb,3,48,0,48,3,2009-02-26 08:49:44,2009-02-25 08:32:09
6fc2a25e6215f1b1916a3da93bf7ddace8ba5310...2fe403e7452bd6e1e8232445cf5434ce8f1af973,1,2,0,2,1,2008-07-07 19:56:16,2008-07-06 19:28:50
48b6026e17f22aff8931d45a62a7a240533efe72...6a0861a8a3295395238c8126c6e74c66b715c595,1,2,2,4,1,2009-02-25 05:46:31,2009-02-24 08:58:16
6a0861a8a3295395238c8126c6e74c66b715c595...6ab149ea89fe5790630c5750af0e3245a7a5e06e,1,2,2,4,2,2009-02-25 08:49:13,2009-02-24 09:00:06
6ab149ea89fe5790630c5750af0e3245a7a5e06e...149f6ddfb324b677472192d4aa1ddc350cf49e80,1,31,5,36,3,2009-02-25 08:49:53,2009-02-19 17:39:47
149f6ddfb324b677472192d4aa1ddc350cf49e80...a8fdab08e09bf73cbc3159930af41cf3233be853,1,1,1,2,1,2009-02-25 08:49:53,2009-02-25 01:22:20
a8fdab08e09bf73cbc3159930af41cf3233be853...aa98eb3d6581a123852e4e080011acc3a61bc556,1,11,3,14,2,2009-02-25 08:49:54,2009-02-24 20:16:37
aa98eb3d6581a123852e4e080011acc3a61bc556...9ccb3bca5776278aa4c2bd1da41c07edce68dfd1,1,1,1,2,1,2009-02-25 08:49:54,2009-02-24 21:59:03
9ccb3bca5776278aa4c2bd1da41c07edce68dfd1...a9d98a148dd5ed14d9e74a1dfc5ec1ca3632f4f0,1,1,1,2,1,2009-02-25 08:49:54,2009-02-24 21:59:05
a9d98a148dd5ed14d9e74a1dfc5ec1ca3632f4f0...3f74c8e8d8721d093655d7bb00ead078d8324100,1,7,6,13,5,2009-02-25 08:49:54,2009-02-25 07:54:42
3f74c8e8d8721d093655d7bb00ead078d8324100...3dbe1165e9facec3497b3da744b832788a47957e,1,3,3,6,1,2009-02-25 16:33:14,2009-02-25 14:05:17
3dbe1165e9facec3497b3da744b832788a47957e...69707d616fd3acda6ecc47198edeaaa87f2cfcea,2,23,5,28,5,2009-02-25 21:58:57,2009-02-25 08:28:15
64621462deb307ba784aac82b05010f464c67f8e...e068f4f53b22c64f2058c316d858a892a5e24a6e,1,11,0,11,4,2009-03-13 06:23:38,2009-03-12 19:20:06
e068f4f53b22c64f2058c316d858a892a5e24a6e...08df6a3086f4bcd5b224d442f103a7f63a605967,1,87,87,174,2,2009-03-13 06:23:38,2009-03-12 19:20:07
08df6a3086f4bcd5b224d442f103a7f63a605967...918c8120172514704809cbdf889794d8b1345d0a,1,26,0,26,1,2009-03-13 06:23:38,2009-03-12 19:20:08
918c8120172514704809cbdf889794d8b1345d0a...310386f07b5ef3dc337db1be37345fbd8d7a3af8,1,35,1,36,15,2009-03-13 06:23:38,2009-03-12 19:20:09
310386f07b5ef3dc337db1be37345fbd8d7a3af8...29adc8baf997e143d8aeac9a0aeb257539d32e6d,1,1,1,2,1,2009-03-13 06:23:39,2009-03-12 19:20:10
29adc8baf997e143d8aeac9a0aeb257539d32e6d...a8304f7a70832a8e333fcf547589bc9d3bc0ca3c,1,34,14,48,5,2009-03-13 06:23:39,2009-03-12 19:20:11
a8304f7a70832a8e333fcf547589bc9d3bc0ca3c...1973b0d790155b5d8a32a6f7401116fad2205721,1,74,15,89,4,2009-03-13 06:23:39,2009-03-12 19:20:12
64621462deb307ba784aac82b05010f464c67f8e...f4e52f0babdb3ec655a168801e613688a7942839,1,18,1,19,7,2009-03-12 04:47:02,2009-03-12 04:47:02
f4e52f0babdb3ec655a168801e613688a7942839...2464456a6ac9216d59d9e2cf0d86fee072f63cf8,3,32,23,55,23,2009-03-12 04:54:59,2009-03-09 09:12:36
2464456a6ac9216d59d9e2cf0d86fee072f63cf8...3bc427e01342a5a6ae2052d27373f8759c680398,1,9,8,17,4,2009-03-12 04:55:07,2009-03-11 23:00:56
04d39759373e5de017e7c17ef4b762ac5ad3afcc...544ddb045a4bd49da9ffc1d9da80bdc0d71b2518,1,1,1,2,1,2008-12-13 04:39:41,2008-12-12 09:00:41
3eb91bfc0d2e0c8c67bd4ec62523deb849919dd9...283b9532831fc0a86c40ac89e1e713b28dabb241,1,8,0,8,1,2008-11-24 03:54:24,2008-11-22 18:22:48
283b9532831fc0a86c40ac89e1e713b28dabb241...2075ffb58e3a2d46d9e7606010f7f943f2295376,2,3,3,6,3,2008-11-24 03:54:51,2008-11-23 11:55:54
3eb91bfc0d2e0c8c67bd4ec62523deb849919dd9...37a7744ffe31af785571858f7341d588a6c66784,1,6,7,13,1,2008-11-24 03:32:39,2008-11-20 05:11:42
3eb91bfc0d2e0c8c67bd4ec62523deb849919dd9...632f70178784291bd2974e07fdcd2b8e8608f252,1,12,3,15,3,2008-11-24 03:26:42,2008-11-19 16:25:27
d6db1bbe1151e3acfc6f25258cfa1d48d32dcc89...9c898a18ea37aa04a84c3a2d18794cf892862702,1,3,0,3,1,2010-02-08 15:56:55,2010-02-07 21:47:56
e1a3f28b14be2cd794ec867c2f8720ca309475ca...5bf46841c0bdd761a55258923a156ca26ceb1d4f,1,339,314,653,271,2010-02-02 14:59:06,2010-02-02 10:20:21
5bf46841c0bdd761a55258923a156ca26ceb1d4f...89d61592bddda4dfcb90314be9e06479f712bb7f,1,366,320,686,278,2010-02-02 15:34:04,2010-02-02 11:59:34
f873dd5ac22fee648f9097d5a91200b6f4850ae0...f135e72d611ff6faf3d413a85f1620227d9f0705,1,2,2,4,2,2009-01-21 20:23:23,2009-01-21 19:14:55
6c1679254cb6be7b268d1431595e1626bf18792d...4e6d4bc0f0f1388dfcad2af4804b35289ed4ec92,1,26,0,26,1,2008-10-14 23:52:09,2008-10-13 20:54:25
4e6d4bc0f0f1388dfcad2af4804b35289ed4ec92...c82efafcfa741cdddbc68379c1905953f58ef21d,1,5,4,9,2,2008-10-15 00:18:29,2008-10-14 20:30:21
2feaf4e977c5e7392ef42689b34d60c4d2f40f4f...06ff64ae3d8c1d446ff61cff78a8faa3a07bfe24,1,4,0,4,2,2008-06-16 22:22:09,2008-06-16 22:00:02
0959df45253de579598dfc431ba5e370acd0ab8e...7e76aba317b690932c8236311219b0faf97f1571,1,0,5,5,1,2008-12-13 20:09:36,2008-12-13 19:05:34
7e76aba317b690932c8236311219b0faf97f1571...2fad5329f4bc03e2328a2994d336c12a9683d9b2,1,4,3,7,2,2008-12-15 00:41:32,2008-12-14 02:08:22
2fad5329f4bc03e2328a2994d336c12a9683d9b2...390c3480b2bcdc5c254db1a81ff163d7f7061f40,1,51,0,51,1,2008-12-15 00:43:25,2008-12-14 19:44:32
390c3480b2bcdc5c254db1a81ff163d7f7061f40...8befc50c49e8a271fd3cd7fb34258fe88d1dfcad,4,3,8,11,4,2008-12-15 00:43:39,2008-12-14 22:10:52
d727f676ad9f03c2b2a11ea68a2c6242ca02fa10...b47dfe9e9c86be97fc07c4c04e26a303730f76c6,5,58,9,67,11,2009-01-12 10:26:01,2009-01-12 06:21:48
b47dfe9e9c86be97fc07c4c04e26a303730f76c6...17f26a9ee3298dfa0a1df7cd4e5f5f32342e5f62,2,9,1,10,2,2009-01-15 00:29:59,2009-01-15 00:29:59
0ddd93b2717d4da074485d42a08e4d3824580afe...50a4b35245bbdb0cfca5d62bc4295a2b2e4f1e87,1,2,2,4,2,2009-01-06 03:46:19,2009-01-05 02:27:41
914186a5c3dd687ad157dbda1518a58b58797391...eb475bfa05dc77462c02ef403d7be5faadf8e64f,1,23,2,25,3,2009-01-15 06:43:04,2009-01-15 06:43:04
b2b76d10696d945bf19318831b64d009d119e051...28cb707472ad2861f9d994c279a9b6077160522e,1,1,0,1,1,2012-04-02 17:21:08,2012-04-01 22:00:51
28cb707472ad2861f9d994c279a9b6077160522e...39ddf99c1db8b230ec7bdefc6ce3c769d1cf4ab6,1,1,1,2,1,2012-04-02 17:21:10,2012-04-01 22:00:52
e97ca7f41f2b9bbdfc93d103c3f64337bb6dcc20...6e8f993a5a17f71edfd26a026bbc83cbbd3c0638,2,17,15,32,3,2009-12-31 22:52:05,2009-12-30 14:45:31
77b15bbd88e2f48de093ff0e60de6dbc11e3329e...855726395342441808eff5e4e9ad9a2b9254edbc,1,9,2,11,5,2011-09-26 21:07:55,2011-09-26 20:30:30
77b15bbd88e2f48de093ff0e60de6dbc11e3329e...94ea026b358f9fd5395d9344a80f2d5a50e93e1f,2,17,2,19,3,2009-09-04 18:50:26,2009-09-04 09:25:57
94ea026b358f9fd5395d9344a80f2d5a50e93e1f...b8d9c1a66b99ad3ca8069add010dafdd1bc6cab8,1,9,23,32,7,2009-09-04 18:50:26,2009-09-04 06:59:25
b8d9c1a66b99ad3ca8069add010dafdd1bc6cab8...5b5061efd88e1d113a4484369dfab654b43364de,3,10,6,16,5,2009-09-04 18:50:26,2009-09-04 05:30:27
5b5061efd88e1d113a4484369dfab654b43364de...467babf8d059caee9587567452fc8b46505b4e67,2,55,16,71,7,2009-09-04 18:50:27,2009-09-04 06:39:43
467babf8d059caee9587567452fc8b46505b4e67...690ed8436326484fe7e3f4deac4cffd780c7d630,2,36,10,46,9,2009-09-04 18:50:27,2009-09-04 07:41:15
690ed8436326484fe7e3f4deac4cffd780c7d630...aeb84b05ae448596c336807631d9633492b3049a,3,21,12,33,12,2009-09-06 06:14:31,2009-09-06 05:21:17
aeb84b05ae448596c336807631d9633492b3049a...d68fe26f3e03b230ac9bbbcf002a9acdc4bebde9,2,54,22,76,18,2009-09-15 05:18:36,2009-09-15 05:05:57
be17262d13f5f3df5ee9635b11dad180613e9cbd...944019c8b3896ff8d169864096eedc60155c80a4,1,2,0,2,2,2009-01-15 22:22:12,2009-01-15 13:03:17
944019c8b3896ff8d169864096eedc60155c80a4...dc7f55cbe9a544ba7af981c00c52efb2d0283a8f,1,15,0,15,1,2009-01-15 22:22:42,2009-01-15 12:56:15
dc7f55cbe9a544ba7af981c00c52efb2d0283a8f...f8aa1b6902d7a77c26b0ef615c9070bbed4be5c4,1,17,0,17,1,2009-01-15 22:22:53,2009-01-15 12:56:16
9a01387b9714452ebcae431705a288e1a7e099c3...d930508903909ad5e700dd25e3858a1b2d69ed12,1,50,9,59,7,2009-01-23 23:10:24,2009-01-22 16:37:24
d930508903909ad5e700dd25e3858a1b2d69ed12...b80da424a13107c239ed40573fae3d692d19b6cd,4,36,1,37,7,2009-01-24 01:00:12,2009-01-23 00:31:21
9a01387b9714452ebcae431705a288e1a7e099c3...86ac751859033741a120e9e4a91133d075d9d898,2,29,4,33,5,2009-01-23 08:19:49,2009-01-23 00:07:32
3e5970a41ec0809efb792357af546ffa96568f66...720fe22d50a58e3308124ec7f5b0fa6c17be3d22,1,1,1,2,1,2009-03-24 21:37:30,2009-03-24 19:56:12
720fe22d50a58e3308124ec7f5b0fa6c17be3d22...e8bd78c3fcba35b8344ea6bab6218b793e507ea3,1,1,1,2,1,2009-03-24 21:39:20,2009-03-24 19:31:36
dfa7a6c579d75037b9dd5c3654a36d31c60f203c...24c11552cb3bd7ec343c8061c87b07aa7abbad00,1,4,0,4,1,2009-03-22 19:29:47,2009-03-22 18:46:38
119c8eeede81489b2ce8b26ae7dcb47290e257eb...55bc3dc4ccd0f4d1f8612c45c5577500d35bdf18,1,1,1,2,2,2011-10-17 21:00:10,2011-10-17 19:55:47
119c8eeede81489b2ce8b26ae7dcb47290e257eb...5483f79998c5a9705d453a713d11fb7591329ed4,2,3,3,6,3,2009-02-26 08:49:44,2009-02-25 08:32:10
5483f79998c5a9705d453a713d11fb7591329ed4...454e2025a933593fd751475b59cc014887b4df6d,4,31,48,79,11,2009-02-26 08:49:45,2009-02-25 08:32:11
454e2025a933593fd751475b59cc014887b4df6d...ec8452d5a797fca865666f761b785b04212426fc,4,50,99,149,6,2009-02-26 08:49:45,2009-02-25 08:32:12
ec8452d5a797fca865666f761b785b04212426fc...8ef517337dc684a333111b46d88c3217202f48c3,3,49,38,87,5,2009-02-26 08:49:45,2009-02-25 08:32:13
8ef517337dc684a333111b46d88c3217202f48c3...6cb4e6cc0f5b2de1998492b0178eeb0f99d4a800,3,16,32,48,10,2009-02-26 08:49:45,2009-02-25 08:32:14
6cb4e6cc0f5b2de1998492b0178eeb0f99d4a800...7b3db095d53d19e08b27114d8706ff3be6693af7,1,13,5,18,3,2009-02-27 23:08:08,2009-02-27 19:10:04
7b3db095d53d19e08b27114d8706ff3be6693af7...4229f1fa325870d6b24fe2a4c7d2ed5f14c6f771,3,28,17,45,9,2009-02-27 23:08:17,2009-02-27 19:10:05
4229f1fa325870d6b24fe2a4c7d2ed5f14c6f771...cdf690e53b5f5af1ca8679b3f3e47ea198692c18,1,5,2,7,5,2009-02-27 23:19:08,2009-02-25 08:32:16
cdf690e53b5f5af1ca8679b3f3e47ea198692c18...5f48cb95aa0d7311623df76249a1c8a1962550f5,1,4,2,6,3,2009-02-27 23:19:08,2009-02-25 08:32:17
5f48cb95aa0d7311623df76249a1c8a1962550f5...c6f5a7a916b36fc9dd00bb6dce3b68260579abe1,2,15,0,15,2,2009-02-27 23:19:08,2009-02-25 08:32:18
c6f5a7a916b36fc9dd00bb6dce3b68260579abe1...88733235615b24198599b533f9d02578ef739536,1,9,8,17,3,2009-02-27 23:19:08,2009-02-25 08:32:19
88733235615b24198599b533f9d02578ef739536...7b9a5e276cc685788386f1dcbd6a201f9f18da16,1,3,10,13,3,2009-02-27 23:19:08,2009-02-25 08:32:20
7b9a5e276cc685788386f1dcbd6a201f9f18da16...e0cc81e63c7bb603545c90e47d4c6398f6347dfb,1,12,12,24,13,2009-02-27 23:19:08,2009-02-25 08:32:21
e0cc81e63c7bb603545c90e47d4c6398f6347dfb...cca7c97e37719eaee1d31cdaf1e638d19ecd69e4,1,16,17,33,3,2009-02-27 23:19:09,2009-02-25 08:32:22
cca7c97e37719eaee1d31cdaf1e638d19ecd69e4...3bd925636cd11400d1840b39d0d18b640f32bdd2,2,11,6,17,7,2009-02-27 23:19:09,2009-02-25 08:32:23
3bd925636cd11400d1840b39d0d18b640f32bdd2...e61e0cc6b7061d7e791e1c9722b9c4a6d85d629c,2,59,7,66,16,2009-02-27 23:19:09,2009-02-25 08:32:24
e61e0cc6b7061d7e791e1c9722b9c4a6d85d629c...bc14fac825d9728c311aaa9d0aecf4960d4a3103,4,129,3,132,8,2009-02-27 23:19:09,2009-02-25 08:32:25
bc14fac825d9728c311aaa9d0aecf4960d4a3103...fbb074c25352627f650d2ea528ed694e77bece0f,2,19,0,19,2,2009-02-27 23:19:23,2009-02-27 19:10:06
fbb074c25352627f650d2ea528ed694e77bece0f...7ecbbf877c9a0716ccccd25609b01023eecd27c0,2,159,61,220,23,2009-02-27 23:19:42,2009-02-25 08:32:27
7ecbbf877c9a0716ccccd25609b01023eecd27c0...e5dcbfd9ab7028c464909f26f523b85c1de912a2,2,207,24,231,19,2009-02-27 23:19:42,2009-02-25 08:32:28
e5dcbfd9ab7028c464909f26f523b85c1de912a2...8321c56b6bae25a2d70790f452df894be536b32c,1,0,1,1,1,2009-03-08 08:10:33,2009-03-08 08:10:33
30161e73d17f309f9a7566459035b06ec748be7d...0b294c0abf00a9cf7468e0ea62722ae23b0816cc,3,9,3,12,4,2008-07-08 20:05:11,2008-07-08 04:08:02
0b294c0abf00a9cf7468e0ea62722ae23b0816cc...1db4a75c8d18d8827ac710e87219b349558d9196,2,24,3,27,7,2008-07-08 21:47:04,2008-07-08 04:46:06
1db4a75c8d18d8827ac710e87219b349558d9196...d773c6314d5660266313772b3fd8a466c3dbc559,1,30,0,30,10,2008-07-08 23:35:05,2008-07-08 16:56:14
d773c6314d5660266313772b3fd8a466c3dbc559...e9656473342e050494c8ea8416fdfdcf52fd1c93,1,1,2,3,1,2008-07-08 23:37:25,2008-07-08 02:36:40
e9656473342e050494c8ea8416fdfdcf52fd1c93...e09c4e753c337d914f4eb7a05cb5e8bbfc362489,2,43,1,44,2,2008-07-09 06:57:14,2008-07-09 06:57:14
2fe403e7452bd6e1e8232445cf5434ce8f1af973...8852f5d704edc20896a84ca9107978c478a2941b,1,2,0,2,1,2008-07-07 20:16:33,2008-07-07 13:41:34
544ddb045a4bd49da9ffc1d9da80bdc0d71b2518...7bb1fcc6fcc5a2d0164f243fd10f346eb0822ddf,1,87,0,87,1,2008-12-15 10:39:57,2008-12-10 20:12:59
7bb1fcc6fcc5a2d0164f243fd10f346eb0822ddf...c5ab03f26c992e30f355fba129f70db0f290fcd7,2,33,1,34,3,2008-12-15 10:39:57,2008-12-15 03:40:09
544ddb045a4bd49da9ffc1d9da80bdc0d71b2518...d2dadfe890b5da6f65fe061a414b6ec67c5efe9c,2,27,1,28,2,2008-12-15 09:29:44,2008-12-15 08:36:56
d2dadfe890b5da6f65fe061a414b6ec67c5efe9c...a8335024c294db470e16e9df3aaa346bfcfbeacb,1,2,1,3,1,2008-12-15 09:37:15,2008-12-15 08:33:34
a8335024c294db470e16e9df3aaa346bfcfbeacb...87c8a56e4f71cc7e22c16caa4adc2ae17f6aa93d,1,3,1,4,2,2008-12-16 07:04:48,2008-12-15 21:11:40
539eec48f0a101b45c5f150a2bbc067fd85bc96d...16d258332e35dad58c0b22cd4d5c0e63ebb25328,1,1,1,2,1,2008-12-01 02:16:32,2008-11-30 10:54:31
37a7744ffe31af785571858f7341d588a6c66784...b0f34c3d6719903e280545e73ae89f6c2ebe533f,1,48,48,96,10,2008-11-26 19:07:57,2008-11-26 08:26:50
37a7744ffe31af785571858f7341d588a6c66784...61af494ca4e63cdc484ea091617ab5f3974f2f9c,2,25,1,26,5,2008-11-26 17:58:41,2008-11-26 17:58:41
2a9edd03057287cf7d69e5021eda2e0122684c92...13a3d637b2d83fceb432fe7b9e21f8c4d882fa41,1,3,0,3,1,2010-07-10 22:40:59,2010-07-10 22:40:59
13a3d637b2d83fceb432fe7b9e21f8c4d882fa41...b963d11827c79fbd14f5b4438cca8298145192be,1,1,0,1,1,2010-07-10 22:41:54,2010-02-20 13:38:38
b963d11827c79fbd14f5b4438cca8298145192be...2e0cda658e08482b804718bfa0f3e64e7af17ea7,1,1,1,2,1,2010-07-30 08:57:26,2010-02-25 00:14:22
2e0cda658e08482b804718bfa0f3e64e7af17ea7...a197b1e89a1c779e69c5ce8746f13b48158030ac,1,2,2,4,2,2010-07-30 08:57:26,2010-02-27 20:45:51
a197b1e89a1c779e69c5ce8746f13b48158030ac...4c79adc5c05de52a08f5e8a9615c9d6c9fe9a991,1,3,2,5,2,2010-07-30 08:57:26,2010-02-27 20:47:42
4c79adc5c05de52a08f5e8a9615c9d6c9fe9a991...fc17e5e5bdb5b4a36c10c2948b8b8db8a12a4b35,1,2,2,4,2,2010-07-30 09:05:26,2010-02-27 20:48:48
fc17e5e5bdb5b4a36c10c2948b8b8db8a12a4b35...85123549f005ebdfb55a5cbd738c3237aaed6eff,1,8,3,11,3,2010-07-30 09:05:27,2010-03-08 12:43:27
85123549f005ebdfb55a5cbd738c3237aaed6eff...1fbaccad4dd8d6a9a893843c73f3e47c4ba8b717,4,51,4,55,10,2010-07-30 09:05:27,2010-07-30 08:11:02
1fbaccad4dd8d6a9a893843c73f3e47c4ba8b717...9cb268c426ccb2bb836418caad669476b5dd1933,1,1,1,2,1,2010-08-02 11:13:05,2010-08-02 11:13:05
9cb268c426ccb2bb836418caad669476b5dd1933...2810a58dba6d06f4d1816fb06500c117feebd830,1,37,18,55,6,2010-08-02 12:42:45,2010-08-02 12:42:45
c82efafcfa741cdddbc68379c1905953f58ef21d...d1a43f2aa4bfb5aef29e9e1fe1fb9bb18c0e8b65,2,78,13,91,6,2008-10-18 17:00:59,2008-10-15 23:00:06
c82efafcfa741cdddbc68379c1905953f58ef21d...faae853ca622844cbb2982700c43ee9b2d93a2c0,2,174,2,176,6,2008-10-16 16:20:59,2008-10-06 04:26:52
c82efafcfa741cdddbc68379c1905953f58ef21d...6c2a6022dbc5879f5d6c267925408e484be6214a,1,1,1,2,1,2008-10-16 15:20:15,2008-09-19 13:48:08
6c2a6022dbc5879f5d6c267925408e484be6214a...16b26725368f7b80711d9a631029fbb869646f9c,1,2,1,3,1,2008-10-16 15:31:56,2008-10-16 00:58:49
16b26725368f7b80711d9a631029fbb869646f9c...b19d288b4d440c76348b519d06a4ed7b62c93611,1,6,0,6,1,2008-10-16 15:31:56,2008-10-16 00:58:50
b19d288b4d440c76348b519d06a4ed7b62c93611...563d5a2c84fb5daf77dd8bfe569e92566a8fd52b,2,12,2,14,3,2008-10-16 15:31:56,2008-10-01 19:28:26
563d5a2c84fb5daf77dd8bfe569e92566a8fd52b...5782566d7f2847bd94e33fd26c8a961e887ec10a,1,50,0,50,1,2008-10-16 15:40:25,2008-10-15 07:10:58
5782566d7f2847bd94e33fd26c8a961e887ec10a...8ed0a740dd42bd0724aebed6e3b07c4ea2a2d5e8,1,3,0,3,1,2008-10-17 02:37:27,2008-10-17 02:32:14
06ff64ae3d8c1d446ff61cff78a8faa3a07bfe24...4afbcab9898ce63ad641dd0de6e9b69deda44330,1,4,2,6,2,2008-06-17 00:37:21,2008-06-17 00:37:21
8befc50c49e8a271fd3cd7fb34258fe88d1dfcad...cdad8170b223a73dc37197d5ba78a3ac7b824406,1,9,32,41,8,2008-12-16 06:56:19,2008-12-16 06:16:19
39ddf99c1db8b230ec7bdefc6ce3c769d1cf4ab6...a135f214e371311f13807da637d492fd9642a2e3,1,2,2,4,2,2012-04-25 03:44:31,2012-04-07 00:29:38
6e8f993a5a17f71edfd26a026bbc83cbbd3c0638...64da3ae5c188b2b09bc1ed1eedca7e84c1aff940,1,8,2,10,2,2010-01-07 07:51:47,2010-01-07 07:51:47
64da3ae5c188b2b09bc1ed1eedca7e84c1aff940...75b7e16b6ea49d0a0da821373ae5ee3a0ee36f2e,1,1,1,2,1,2010-01-10 06:43:27,2010-01-08 13:39:58
75b7e16b6ea49d0a0da821373ae5ee3a0ee36f2e...b0bec518aa4a90485c411cebc7260425271af949,1,0,2,2,1,2010-01-10 06:43:37,2010-01-08 16:22:18
b0bec518aa4a90485c411cebc7260425271af949...0606c36a73449e76d8f6133253c1eff291ee8c97,1,2,8,10,1,2010-01-10 06:43:47,2010-01-08 13:40:00
d68fe26f3e03b230ac9bbbcf002a9acdc4bebde9...6957eb9a39cc765862e125edeef0dd70f359cff1,1,125,125,250,6,2009-09-15 05:18:49,2009-09-15 01:44:01
f8aa1b6902d7a77c26b0ef615c9070bbed4be5c4...2454ac7b9fbc12db5cca8cd388422360528d7d6f,1,0,1,1,1,2009-01-18 01:57:35,2009-01-16 19:40:05
2454ac7b9fbc12db5cca8cd388422360528d7d6f...996869601594ffefb67238175055922340ced6f8,1,1,1,2,1,2009-01-18 01:57:41,2009-01-16 20:36:06
996869601594ffefb67238175055922340ced6f8...bf474e2402e51843e8230c064da6ccfdf3a8ff54,1,4,1,5,1,2009-01-18 02:01:46,2009-01-16 21:42:33
b80da424a13107c239ed40573fae3d692d19b6cd...0ec7b6c26dad51f690cd985d4a5357634123c4b7,2,24,5,29,4,2009-01-27 09:13:19,2009-01-21 22:57:48
0ec7b6c26dad51f690cd985d4a5357634123c4b7...b9b5078ece4b22c14a36f20bd9dce88d2f350a36,1,51,19,70,14,2009-01-31 18:18:33,2009-01-30 23:20:10
b9b5078ece4b22c14a36f20bd9dce88d2f350a36...ff4a18552aa48f3227e2465072951dacc34aee9b,2,5,6,11,4,2009-01-31 18:28:33,2009-01-30 23:20:11
b80da424a13107c239ed40573fae3d692d19b6cd...fb700cb0679e22900f0d1435641e6cf7c652968b,1,8,10,18,4,2009-01-27 09:11:59,2009-01-23 23:12:45
b80da424a13107c239ed40573fae3d692d19b6cd...b1c7d4aafeda8e6b2bbeac29a3181cbe970b7874,1,39,29,68,15,2009-01-24 05:50:37,2009-01-24 02:00:22
e8bd78c3fcba35b8344ea6bab6218b793e507ea3...63801da88d8638eb6cf26d6305a721ad3731e216,1,2,1,3,1,2009-03-30 02:56:26,2009-03-29 20:42:27
8321c56b6bae25a2d70790f452df894be536b32c...48ef563641d1904f8da2c6fffe700fe6276af8dd,1,16,1,17,2,2009-03-22 17:20:04,2009-03-22 08:59:20
8321c56b6bae25a2d70790f452df894be536b32c...a9c37a72c4fbc8537de294d66b05bdfd7f9a4016,4,13,15,28,4,2009-03-09 22:41:16,2009-03-09 01:06:05
a9c37a72c4fbc8537de294d66b05bdfd7f9a4016...64fcef2daa03f6093b480142c6ab2a4173b0b43e,4,343,92,435,55,2009-03-09 22:41:20,2009-03-09 01:06:07
013942f637e2e0706b5a44e58a9d285bc57c5305...ebcce310f2018b26a21b2926490209f5550620fe,1,2,1,3,1,2008-07-16 22:53:43,2008-07-02 17:06:56
ebcce310f2018b26a21b2926490209f5550620fe...473a189b92b70295157d20fe229d44824061c79f,2,44,1,45,2,2008-07-16 22:55:51,2008-07-16 22:55:51
e09c4e753c337d914f4eb7a05cb5e8bbfc362489...fce87ae53883d22a9912abb2d11a926de747006e,1,24,6,30,8,2008-07-13 20:46:56,2008-07-12 18:00:57
e09c4e753c337d914f4eb7a05cb5e8bbfc362489...ab02dfe533f55535bdb66e05776a4081020322c6,1,16,12,28,5,2008-07-13 18:36:04,2008-07-13 02:37:42
ab02dfe533f55535bdb66e05776a4081020322c6...6c36c9e4eabadecf75f8751b1c1140da2068e2a0,1,0,3,3,1,2008-07-13 23:40:23,2008-07-13 22:06:31
e09c4e753c337d914f4eb7a05cb5e8bbfc362489...e0cbc39768884a1e7edcf2dbf6e6825c4b23485a,2,27,2,29,6,2008-07-12 04:16:37,2008-07-11 23:28:18
e09c4e753c337d914f4eb7a05cb5e8bbfc362489...8c6202d8696d2e3ae016042acd05f6a82763a5e3,2,24,1,25,2,2008-07-12 03:38:30,2008-07-12 01:15:03
8c6202d8696d2e3ae016042acd05f6a82763a5e3...b4958181a9afd0a7a2622d18416f88f9222123f0,2,5,2,7,3,2008-07-12 04:10:13,2008-07-10 21:36:28
e09c4e753c337d914f4eb7a05cb5e8bbfc362489...eac12e2d4d7fb9b388bdc88bf15cd86cbde91dfd,1,1,0,1,1,2008-07-09 21:45:42,2008-07-09 07:10:07
87c8a56e4f71cc7e22c16caa4adc2ae17f6aa93d...04c8ce9c1c803a8dc0f3728f57550f9bc9e605c2,13,25,25,50,23,2008-12-20 03:10:46,2008-12-19 12:14:18
04c8ce9c1c803a8dc0f3728f57550f9bc9e605c2...0e73b3ee6ca95e1db2fe801d2b8544f4c27991df,1,8,3,11,5,2008-12-20 03:10:48,2008-12-19 08:10:10
0e73b3ee6ca95e1db2fe801d2b8544f4c27991df...ce2c3ebbc5a66e0370b3ab5b5611c2c390ddd6c0,1,1,0,1,1,2008-12-20 03:10:58,2008-12-20 01:01:01
ce2c3ebbc5a66e0370b3ab5b5611c2c390ddd6c0...672752470c85c8dc3dd9b49f72063a99f8475b4a,1,3,0,3,1,2008-12-20 03:11:20,2008-12-20 00:52:17
672752470c85c8dc3dd9b49f72063a99f8475b4a...4e46a8d62c551e11e21bd04e059e9ae3cdcfd029,3,42,5,47,7,2008-12-20 03:11:27,2008-12-20 00:00:27
4e46a8d62c551e11e21bd04e059e9ae3cdcfd029...88fbf67b78c7bbe6c94150e7cd05f9398b571c48,2,33,11,44,7,2008-12-20 03:25:06,2008-12-19 22:41:21
5aa3bdd50d4e4f59c41ee6e70ae1e738a3a28cc0...3d51c853df5730212f704a526340a5a059dffeda,1,1,1,2,1,2008-11-27 21:17:58,2008-11-26 18:52:15
5aa3bdd50d4e4f59c41ee6e70ae1e738a3a28cc0...a0178ae2cfd79a1da5d7ddfacadb1e41560bb464,4,4,4,8,4,2008-11-27 09:00:45,2008-11-27 07:32:01
2810a58dba6d06f4d1816fb06500c117feebd830...ea47503d4dc80db54dbb8e568f7a7058ec25bacb,1,7,1,8,1,2010-08-07 23:07:01,2010-08-07 23:07:01
ea47503d4dc80db54dbb8e568f7a7058ec25bacb...780777720a1ded770be7653cee0dc9777f14f07f,1,6,1,7,1,2010-08-07 23:07:43,2010-08-07 23:07:43
780777720a1ded770be7653cee0dc9777f14f07f...62f9a632c819bd53a5b7dbe40409ab086a4bce10,3,10,1,11,4,2010-08-12 20:35:09,2010-08-05 10:05:22
62f9a632c819bd53a5b7dbe40409ab086a4bce10...d5257fb3c1decc1eff296a0ae2afbcaee28d0f2c,2,15,3,18,2,2010-08-12 20:37:32,2010-08-07 19:32:13
d5257fb3c1decc1eff296a0ae2afbcaee28d0f2c...aef0b48ef05b5980d2f3a1e4bc14b70d9688d59b,1,13,6,19,6,2010-08-18 22:19:24,2010-08-18 22:19:24
aef0b48ef05b5980d2f3a1e4bc14b70d9688d59b...421a31e22dc7b130b7ce239f7fbc28e43c9556c3,1,403,399,802,336,2010-09-13 18:25:55,2010-09-12 20:13:29
421a31e22dc7b130b7ce239f7fbc28e43c9556c3...2473543caabe63a9787e7ac42765c8f7169d7197,1,2,2,4,1,2010-09-13 19:41:42,2010-09-13 19:41:42
2473543caabe63a9787e7ac42765c8f7169d7197...00e9de72c8f9b7c048bb56a59be9567d69dc1e01,1,1,1,2,1,2010-09-14 21:42:37,2010-09-14 21:42:37
faae853ca622844cbb2982700c43ee9b2d93a2c0...42f939e4735bc144e1767395e84cffb1bd805a1c,1,135,0,135,1,2008-10-16 16:23:53,2008-10-15 07:44:34
42f939e4735bc144e1767395e84cffb1bd805a1c...72583e6c685a85b9354ee2310cec3d9240df3c0f,1,1,14,15,1,2008-10-16 16:23:53,2008-10-15 07:44:35
72583e6c685a85b9354ee2310cec3d9240df3c0f...bb645071645240a23ede4e93c9425252a0eaaefb,1,10,5,15,2,2008-10-16 16:23:53,2008-10-15 07:44:36
bb645071645240a23ede4e93c9425252a0eaaefb...a4f25e368247108e89e5ee1a02c2f1b6fc31c56f,1,9,5,14,3,2008-10-16 16:23:53,2008-10-15 07:44:37
a4f25e368247108e89e5ee1a02c2f1b6fc31c56f...acc8559aa33b7a1ea49b0841e0759ecf05c6f26e,1,52,25,77,5,2008-10-16 16:23:53,2008-10-15 07:44:38
acc8559aa33b7a1ea49b0841e0759ecf05c6f26e...d80d6bc146232d81f1bb4bc58e5d89263fd228d4,1,2,1,3,2,2008-10-16 16:23:54,2008-10-15 07:44:39
d80d6bc146232d81f1bb4bc58e5d89263fd228d4...80fe82e4eb365773ba6518c4539c9235ea9a8b2e,2,11,2,13,3,2008-10-16 16:23:54,2008-10-15 07:44:40
80fe82e4eb365773ba6518c4539c9235ea9a8b2e...e249044c67d347dcffff247c72a503a9dd592294,1,4,3,7,2,2008-10-21 06:36:31,2008-10-20 23:36:38
e249044c67d347dcffff247c72a503a9dd592294...4c1360f472ca5706a3dd1eed0b88603cb05d0827,1,1,1,2,1,2008-10-22 18:59:30,2008-10-22 18:59:30
8ed0a740dd42bd0724aebed6e3b07c4ea2a2d5e8...51a94af845cb3f797abd638478834721d7295af7,2,11,7,18,2,2008-10-17 21:35:06,2008-10-17 06:37:44
51a94af845cb3f797abd638478834721d7295af7...f5637549a7eb93883839de01399418e10bf81768,1,12,0,12,1,2008-10-19 19:35:04,2008-10-17 22:56:11
f5637549a7eb93883839de01399418e10bf81768...acd3b9eca82e38950f94e4708b528b7dae09a7c8,11,39,23,62,25,2008-10-19 19:35:37,2008-10-17 22:44:39
8ed0a740dd42bd0724aebed6e3b07c4ea2a2d5e8...98fa473887d0bebd38d568bb07232a336a642dcf,5,40,44,84,8,2008-10-17 19:46:59,2008-10-16 15:07:26
8ed0a740dd42bd0724aebed6e3b07c4ea2a2d5e8...72130808173d3dfee85f2a29548fa9fec33a5351,1,1,1,2,1,2008-10-17 18:30:54,2008-10-13 09:35:59
72130808173d3dfee85f2a29548fa9fec33a5351...1fb23e65503b4927fa1d4b59f9fbe27668ce347d,1,5,1,6,2,2008-10-18 13:19:06,2008-10-18 00:37:31
1fb23e65503b4927fa1d4b59f9fbe27668ce347d...3b1eb124932772daee09419a581d418ea2d50045,1,7,7,14,7,2008-10-18 13:20:27,2008-10-18 02:41:18
4afbcab9898ce63ad641dd0de6e9b69deda44330...f49c2c22fef520fd69ff26869c26dc58a834de2c,1,16,0,16,2,2008-06-19 21:14:45,2008-06-10 17:44:43
4afbcab9898ce63ad641dd0de6e9b69deda44330...c86fbe5332abe6b951731940b9a8676ea90a434c,1,5,2,7,5,2008-06-19 06:59:41,2008-06-19 06:59:41
90c3302173c5a02189f5fe9091c0d07f7b7ebe89...025a19298dca1a94e8d39ea28cb57412c12dfbff,1,40,37,77,21,2008-12-16 07:06:17,2008-12-15 17:45:48
025a19298dca1a94e8d39ea28cb57412c12dfbff...98171a07ae74e796a6c78e7c446ac9a5aaf28c07,1,80,7,87,31,2008-12-16 07:06:17,2008-12-15 17:45:49
98171a07ae74e796a6c78e7c446ac9a5aaf28c07...b54dc9fdb993a54bba11df3f247e836158b8c1f0,1,3,37,40,1,2008-12-17 07:31:58,2008-12-17 03:42:02
b54dc9fdb993a54bba11df3f247e836158b8c1f0...4fce51cf415909be84e3a1449900e3fdea775b76,1,2,2,4,2,2008-12-17 08:56:36,2008-12-16 15:48:12
4fce51cf415909be84e3a1449900e3fdea775b76...d1983677f75469d177b0b948f0b66ad3471a26a2,2,4,2,6,2,2008-12-17 08:57:33,2008-12-17 02:59:23
d1983677f75469d177b0b948f0b66ad3471a26a2...53682f0c9e7545c6fa891896a5de4ad441a76147,1,2,0,2,1,2008-12-17 09:16:43,2008-12-17 02:59:36
ebb7bbf769e3785e882dffcce69816b88e0838f5...20642801e44a03362d1809644bf4da6473636529,1,7,3,10,3,2009-01-18 02:19:35,2009-01-17 15:36:26
20642801e44a03362d1809644bf4da6473636529...466ddf90c2f270b973d141f20e912f743743331c,3,11,2,13,4,2009-01-18 02:19:46,2009-01-17 15:11:51
466ddf90c2f270b973d141f20e912f743743331c...8ee09acd8f3c96683ce2b81bb8ac8079f0e8a4fd,1,15,3,18,4,2009-01-18 02:20:00,2009-01-17 15:41:41
a135f214e371311f13807da637d492fd9642a2e3...9b5bdf5913f850d1fc72c4219f794e2de549957f,1,2,1,3,2,2012-09-09 03:25:09,2012-09-08 19:03:13
9b5bdf5913f850d1fc72c4219f794e2de549957f...587277fea3bf3bfc4302480178bd88a277a69f05,1,7,7,14,6,2012-09-09 03:25:09,2012-09-08 19:53:16
a135f214e371311f13807da637d492fd9642a2e3...0ae103574e5411be107c31a3390884f65fbaa0ef,1,5,0,5,1,2012-08-04 09:32:40,2012-05-10 10:13:43
0606c36a73449e76d8f6133253c1eff291ee8c97...1f80c2afb0d826567a9a5a1c3ce76c28883e0e96,1,1,1,2,1,2010-02-25 20:08:22,2010-02-25 10:01:31
6957eb9a39cc765862e125edeef0dd70f359cff1...250f79930d84af54dce15320914ea911d58dd8ca,1,26,7,33,5,2009-09-15 09:40:51,2009-09-15 01:44:01
250f79930d84af54dce15320914ea911d58dd8ca...018cff70462eb59779c96a383531c4440fb35b9c,1,9,7,16,6,2009-09-15 09:41:02,2009-09-15 01:44:01
bf474e2402e51843e8230c064da6ccfdf3a8ff54...3aed2fda6f8233895be0d1142c4c4b407fb692c3,1,1,1,2,1,2009-01-18 06:37:41,2009-01-18 03:46:09
bf474e2402e51843e8230c064da6ccfdf3a8ff54...f0298cf1c6a7b5cc8b79d84a03b0ce07df2d9e6b,3,41,2,43,3,2009-01-18 06:01:37,2009-01-16 12:52:53
f0298cf1c6a7b5cc8b79d84a03b0ce07df2d9e6b...b2a6d1c6868b6d5e7d2b4fa9129341220a1e848a,4,23,1,24,4,2009-01-18 07:00:31,2009-01-18 06:27:08
bf474e2402e51843e8230c064da6ccfdf3a8ff54...72183cb297f614dc2df1c0ed08afac1be27ec35a,2,12,1,13,2,2009-01-18 05:46:50,2009-01-16 15:37:33
63801da88d8638eb6cf26d6305a721ad3731e216...7b60d0d3e4d9bb8995a010b0304ec92d0fdff69c,1,4,4,8,4,2009-03-30 15:59:45,2009-03-30 14:13:45
7b60d0d3e4d9bb8995a010b0304ec92d0fdff69c...abfd5fa8725ef1a0ffddb0d1a768cbbfbc74a972,1,1,0,1,1,2009-03-30 16:00:04,2009-03-30 11:58:21
abfd5fa8725ef1a0ffddb0d1a768cbbfbc74a972...67f1fe5f08d3f6146cf13f8a65ceeab1509581a8,1,6,1,7,2,2009-03-30 16:06:48,2009-02-16 16:34:57
67f1fe5f08d3f6146cf13f8a65ceeab1509581a8...ba7906f2f4c332f814d270d2e16b0010516fc53e,1,2,2,4,2,2009-03-30 16:07:03,2009-03-30 11:27:37
64fcef2daa03f6093b480142c6ab2a4173b0b43e...6828f72ffee0d603b96bcde080ec13504f617669,1,1,2,3,1,2009-03-27 04:01:34,2009-03-27 02:37:53
473a189b92b70295157d20fe229d44824061c79f...6c69207c73aaf63c13105d526453d0bd75f12f34,1,1,1,2,1,2008-07-18 03:50:06,2008-07-17 23:53:55
6c69207c73aaf63c13105d526453d0bd75f12f34...d85fe389594dc1b6f64c0aae7146a6d92399c3a9,1,1,4,5,2,2008-07-18 06:36:16,2008-07-18 05:39:09
d85fe389594dc1b6f64c0aae7146a6d92399c3a9...a70c232e0fcb1a72cec024def0f8b1377f15daf4,1,2,0,2,1,2008-07-18 07:11:40,2008-07-18 07:11:40
6c36c9e4eabadecf75f8751b1c1140da2068e2a0...778306e405b416d8073652c535777f2de5fc68ad,1,9,1,10,2,2008-07-14 00:27:50,2008-07-14 00:22:03
778306e405b416d8073652c535777f2de5fc68ad...db8a9ff03831a26aa8bfad8bb026b90739d684ec,1,25,2,27,4,2008-07-15 06:35:18,2008-07-15 05:52:04
b4958181a9afd0a7a2622d18416f88f9222123f0...e9fe804a8282107084a35d3a64e757daf217b042,7,104,2,106,7,2008-07-14 00:21:15,2008-07-10 21:41:33
b4958181a9afd0a7a2622d18416f88f9222123f0...329636b435a792cb10df8d49b791cdafd6d8189b,1,10,9,19,9,2008-07-12 11:15:56,2008-07-12 11:15:56
329636b435a792cb10df8d49b791cdafd6d8189b...460abee5cd7d0cb06e5f424b1dae793af4e66cbb,1,2,1,3,1,2008-07-13 19:46:18,2008-07-12 15:46:59
460abee5cd7d0cb06e5f424b1dae793af4e66cbb...191a8e32b38c7ff0dd884df7bd323b7a5bd4336c,2,20,9,29,7,2008-07-13 22:23:43,2008-07-13 22:23:43
b21a226a42d609d4d39522e27423e8323f0db71d...8d8163f377829d5f61f6053bd55fdcecaf360d4c,1,8,33,41,7,2008-11-28 02:29:53,2008-11-27 13:35:38
8d8163f377829d5f61f6053bd55fdcecaf360d4c...c07838371b116251b6c4bc62a2ba64109baf74f1,1,1,1,2,1,2008-11-28 02:35:07,2008-11-27 13:35:53
c07838371b116251b6c4bc62a2ba64109baf74f1...1510dbe380a24fdf303a3c0594752cfdc968cb12,1,1,1,2,1,2008-11-28 02:35:28,2008-11-24 06:55:22
1510dbe380a24fdf303a3c0594752cfdc968cb12...65117abc040d95ef9877c3b14a24f4bc6aeaf4cb,1,1,1,2,1,2008-11-28 02:48:53,2008-11-20 18:56:28
65117abc040d95ef9877c3b14a24f4bc6aeaf4cb...35243577ab460d0b97b97948928d47f71dc8e46a,1,1,1,2,1,2008-11-28 03:11:21,2008-11-14 07:19:34
00e9de72c8f9b7c048bb56a59be9567d69dc1e01...ff9db6c79d57c9f8921db39a73772e70ab76a1e3,1,2,0,2,1,2010-10-05 09:58:14,2010-10-05 09:12:00
ff9db6c79d57c9f8921db39a73772e70ab76a1e3...7ae1e727622883c029550e0b99488c6d058a94bc,1,16,10,26,4,2010-10-05 22:39:54,2010-10-05 22:39:54
7ae1e727622883c029550e0b99488c6d058a94bc...c0d2c38d78fc3b55b7f0a2470ca89bed43eb4019,1,2,0,2,2,2010-10-05 22:51:34,2010-10-05 22:51:34
c0d2c38d78fc3b55b7f0a2470ca89bed43eb4019...67112c484b5d460ccceb54f3a32b62e4e6e705f0,1,12,5,17,2,2010-10-07 21:28:45,2010-10-07 21:28:45
67112c484b5d460ccceb54f3a32b62e4e6e705f0...4c56d1ddc03e6370a3afc01a011e6c3e65ff65d3,1,1,1,2,1,2010-10-07 22:00:33,2010-10-07 22:00:33
4c56d1ddc03e6370a3afc01a011e6c3e65ff65d3...38ec8d3e265220fb091b8c5ad6233b502242f866,1,14,5,19,2,2010-10-20 13:29:56,2010-10-20 13:29:56
38ec8d3e265220fb091b8c5ad6233b502242f866...c744086964975eedfb7a6703789219b9749167d6,1,1,0,1,1,2010-10-27 22:37:31,2010-10-27 22:37:31
c744086964975eedfb7a6703789219b9749167d6...8f85599aba6b569de5c559994704a416f52bc031,2,42,2,44,7,2010-10-27 22:47:28,2010-10-22 15:14:38
53682f0c9e7545c6fa891896a5de4ad441a76147...1df27132493171294d0d2b53bd75bb8e131eea2b,1,4,0,4,1,2008-12-17 21:37:14,2008-12-17 21:29:06
53682f0c9e7545c6fa891896a5de4ad441a76147...b11b7e13f48ee283738e21fea9f775cd40ca0562,3,30,4,34,3,2008-12-17 21:36:30,2008-12-17 17:36:40
b11b7e13f48ee283738e21fea9f775cd40ca0562...a60272b38e548f46c5e1d7127cf18a469fefa237,1,8,14,22,6,2008-12-17 21:36:34,2008-12-17 17:47:27
a60272b38e548f46c5e1d7127cf18a469fefa237...b760d3aa74585a96f0ccc4ce0374528a38be5177,1,5,9,14,5,2008-12-17 21:36:34,2008-12-17 17:51:53
b760d3aa74585a96f0ccc4ce0374528a38be5177...cf219d8c68ada1aa2855f4862f15753a32d09641,1,7,9,16,4,2008-12-17 21:36:34,2008-12-17 18:26:13
cf219d8c68ada1aa2855f4862f15753a32d09641...dfab6aaecfe9df67123efc778f6aea4e9814715a,1,4,5,9,2,2008-12-17 21:36:34,2008-12-17 18:31:36
dfab6aaecfe9df67123efc778f6aea4e9814715a...737e31af7ae365d6251bb196e06d18afda9c98a8,1,2,0,2,1,2008-12-17 21:36:34,2008-12-17 20:37:48
737e31af7ae365d6251bb196e06d18afda9c98a8...edfd45d2a0fc85d55479e13e8e3dc7e975a313ce,1,1,4,5,4,2008-12-17 21:36:35,2008-12-17 20:37:53
edfd45d2a0fc85d55479e13e8e3dc7e975a313ce...912342d9d69a30e49491f3fd4d3aa8dc2f6050f3,1,5,5,10,2,2008-12-17 21:36:35,2008-12-17 20:37:58
78f111e12de40e2d9aa8d0774acc287f79862b13...9d3043cf333ee500e476a558acb234b42e43cc62,1,6,1,7,3,2009-01-18 07:04:35,2009-01-18 07:04:35
5be4d354d9031bee65406608bfbdfc0fbc85abdb...b967135d89e8d8461d0590b2d5181781caeac741,1,43,11,54,16,2012-09-23 05:03:18,2012-09-19 18:17:27
b967135d89e8d8461d0590b2d5181781caeac741...c46149942adad1e8869cb795cc044581f2de314a,1,23,3,26,9,2012-09-23 05:03:18,2012-09-22 07:40:24
c46149942adad1e8869cb795cc044581f2de314a...30441a6f2d5459efa8b64332dfc3a95662a1648a,1,4,1,5,2,2012-09-23 05:03:18,2012-09-22 07:40:25
30441a6f2d5459efa8b64332dfc3a95662a1648a...f062e50fe69e01376b6ebf7ade8402b782620ac3,1,11,6,17,4,2012-09-23 06:14:58,2012-09-22 07:46:48
f062e50fe69e01376b6ebf7ade8402b782620ac3...69ecfcd6ebcc42c73be25b876c79ee09d5f2901d,1,6,2,8,2,2012-10-21 22:16:31,2012-10-02 15:04:44
69ecfcd6ebcc42c73be25b876c79ee09d5f2901d...ebb91db8dfcb9733799a7929654b4a0c5eebfbdb,1,1,1,2,1,2012-10-21 22:16:31,2012-10-02 15:04:45
ebb91db8dfcb9733799a7929654b4a0c5eebfbdb...62e9ac5edfd7d9f24482ce767eec4b1ac96db4a4,1,12,4,16,2,2012-10-21 22:21:56,2012-10-07 21:21:14
62e9ac5edfd7d9f24482ce767eec4b1ac96db4a4...ce837c9de5d67919437e1c05789b23c3aca95d4c,1,2,0,2,1,2012-10-21 22:24:46,2012-10-04 20:50:16
ce837c9de5d67919437e1c05789b23c3aca95d4c...978904bf16600dd21888964f3d5cabf02ba39f22,1,6,7,13,3,2012-10-21 22:24:47,2012-10-04 20:50:17
978904bf16600dd21888964f3d5cabf02ba39f22...c0d92c222149c259ee4844bbad99a6bc167e757b,1,352,321,673,295,2012-10-21 22:27:10,2012-10-03 07:16:03
c0d92c222149c259ee4844bbad99a6bc167e757b...d809fb17b00f912112090294ff0257c8a87af56e,1,2,2,4,2,2013-01-01 05:51:03,2013-01-01 05:51:03
d809fb17b00f912112090294ff0257c8a87af56e...d34835c939bbe059e347133b357441e21a7f7840,1,9,3,12,7,2013-01-01 12:08:12,2013-01-01 12:08:12
d34835c939bbe059e347133b357441e21a7f7840...386befb773e2b4a7cc31135f22555e27597392c1,1,44,15,59,5,2013-01-02 04:25:29,2013-01-02 04:25:29
018cff70462eb59779c96a383531c4440fb35b9c...7f7ee2ff2dfbb8435a4b46750f573ef0f7d0b853,1,49,26,75,6,2009-09-15 09:41:03,2009-09-15 01:44:01
3aed2fda6f8233895be0d1142c4c4b407fb692c3...b938f62a208d24f3d6bed260ceb809cd6b3924d7,1,1,1,2,1,2009-01-23 08:17:04,2009-01-22 18:26:25
3aed2fda6f8233895be0d1142c4c4b407fb692c3...885c716f0f039cfe100f5d761e1011085b43fbb8,1,7,2,9,3,2009-01-21 08:14:12,2009-01-20 15:59:57
3aed2fda6f8233895be0d1142c4c4b407fb692c3...537a071f41259c8631284bef28497280cd33db95,1,27,0,27,2,2009-01-20 05:17:38,2009-01-15 00:48:24
ba7906f2f4c332f814d270d2e16b0010516fc53e...5bd27ebb18f2dd745d1226b59b9f863c63c15fb2,1,1,1,2,1,2009-04-01 18:34:02,2009-03-31 16:57:01
fcf74dbfca9738a724995c92f0845e8018e51a0e...4d2646727997c82c04a82ce38e56d76e7b5d268b,2,17,5,22,3,2008-07-19 17:41:17,2008-07-19 16:24:46
4d2646727997c82c04a82ce38e56d76e7b5d268b...a1b6fb04b1c1b581dfac5c13641af8b3ae44810f,1,10,6,16,3,2008-07-19 17:58:01,2008-07-19 17:58:01
191a8e32b38c7ff0dd884df7bd323b7a5bd4336c...8bd867ee0e9714457e5ea973849b0025f3e99efc,2,13,13,26,5,2008-07-16 15:50:07,2008-07-16 12:35:22
8bd867ee0e9714457e5ea973849b0025f3e99efc...df4b3abc941a0f876c3b1f5490e6ea01a4fb62cf,1,1,1,2,1,2008-07-16 15:53:51,2008-07-16 11:35:46
df4b3abc941a0f876c3b1f5490e6ea01a4fb62cf...620e2bb93785ed8eb60846d94fd4753d4817c8ec,1,15,12,27,8,2008-07-16 20:30:34,2008-07-16 15:33:29
620e2bb93785ed8eb60846d94fd4753d4817c8ec...fd55a19eb1d49ae54008d932a65f79cd6fda45c9,5,34,25,59,24,2008-07-16 21:03:24,2008-07-16 14:54:02
fd55a19eb1d49ae54008d932a65f79cd6fda45c9...f66cf96d7c613a8129436a5d76ef7b74ee302436,1,9,6,15,4,2008-07-16 21:05:50,2008-07-16 15:39:55
f66cf96d7c613a8129436a5d76ef7b74ee302436...01941bd54387aee029315d565f0bc1a5b9c5541a,1,6,30,36,1,2008-07-16 21:27:09,2008-07-16 08:33:52
01941bd54387aee029315d565f0bc1a5b9c5541a...1c5fa0a179a76f13a6970a281ad876cff44fd8ee,1,2,0,2,1,2008-07-16 22:13:53,2008-07-16 01:51:49
191a8e32b38c7ff0dd884df7bd323b7a5bd4336c...f41aebd46998c8b6df3733196d55aeb7162b3df6,1,33,27,60,23,2008-07-15 13:27:09,2008-07-14 02:07:44
f41aebd46998c8b6df3733196d55aeb7162b3df6...4a438cabacdbfa71f59dad127d436bbb49a86f35,1,31,3,34,9,2008-07-15 13:30:59,2008-07-14 02:07:45
4a438cabacdbfa71f59dad127d436bbb49a86f35...03993e139cafd04c3783902243328442a5b4aa2c,1,12,6,18,7,2008-07-15 13:36:49,2008-07-14 02:07:46
03993e139cafd04c3783902243328442a5b4aa2c...92392b4a4530056918174988200d7c10286a4acd,1,46,2,48,6,2008-07-15 13:37:44,2008-07-15 04:45:34
8f85599aba6b569de5c559994704a416f52bc031...0e0f450427a915f8569dc3dcc0ce7ee48bba9da9,1,47,47,94,20,2011-02-27 08:47:13,2011-02-26 10:51:14
0e0f450427a915f8569dc3dcc0ce7ee48bba9da9...f3768a6714e667205d68475df37a889abb59d2d5,1,7,0,7,1,2011-02-27 08:47:34,2011-02-26 10:52:17
8f85599aba6b569de5c559994704a416f52bc031...46a0431b996cd19f21e0247c97b1eab2c19698fc,1,10,2,12,3,2010-11-19 09:32:58,2010-11-15 10:00:33
46a0431b996cd19f21e0247c97b1eab2c19698fc...4590307a338b1a4912c7a203c71af8b8995ea885,2,25,7,32,9,2010-11-19 11:25:00,2010-11-16 09:21:52
4590307a338b1a4912c7a203c71af8b8995ea885...1ab862862fb985131ae081ddde4d8f8b7e23c17b,1,1,1,2,1,2010-11-22 21:52:51,2010-11-19 20:43:48
1ab862862fb985131ae081ddde4d8f8b7e23c17b...c7ec31a36e6309be1392ea58948303286665fdd9,1,4,4,8,4,2010-12-06 21:09:53,2010-11-29 08:21:57
c7ec31a36e6309be1392ea58948303286665fdd9...88b21c2a407833a66f9aeb650f5b96c672691ecf,2,9,7,16,8,2010-12-06 22:01:01,2010-12-06 22:01:01
88b21c2a407833a66f9aeb650f5b96c672691ecf...673eb4a01f340e5b0be0776fd05d1e84766182a3,1,11,7,18,1,2010-12-10 15:42:09,2010-12-10 15:41:09
673eb4a01f340e5b0be0776fd05d1e84766182a3...9673abc7cc94be4d89ae9edeeef2910c74660633,1,2,2,4,2,2011-01-24 23:46:25,2011-01-17 21:08:24
9673abc7cc94be4d89ae9edeeef2910c74660633...b6efd40d6c7f07d20b0a7341c473f5fb18e249b4,1,12,12,24,12,2011-01-24 23:46:29,2011-01-17 21:08:28
b6efd40d6c7f07d20b0a7341c473f5fb18e249b4...75e88a592f018904dab4498344b8f0579a0a2cd5,1,307,288,595,247,2011-01-24 23:46:33,2011-01-17 21:08:55
75e88a592f018904dab4498344b8f0579a0a2cd5...073291c476b4edb4d10bbada1e64b471ba153b6b,1,1,1,2,1,2011-01-24 23:46:38,2011-01-19 21:01:32
073291c476b4edb4d10bbada1e64b471ba153b6b...7b3680f162bf27c119e6e0347ee87a9aa7a3ce1b,2,2737,0,2737,2,2011-01-27 16:22:10,2010-12-13 22:28:19
7b3680f162bf27c119e6e0347ee87a9aa7a3ce1b...bf5fe3f33c2296f2a092d8dce4e1dbec171fde02,1,2,2,4,1,2011-01-28 00:16:42,2010-12-09 20:46:21
bf5fe3f33c2296f2a092d8dce4e1dbec171fde02...4a065c8a6f0415da6d778dae83ff88e5385a2f0f,1,2,1,3,1,2011-01-28 00:16:46,2010-12-09 20:46:22
4a065c8a6f0415da6d778dae83ff88e5385a2f0f...7587f4d32f7479a9fa9ae1767708597702a0be5f,3,19,5,24,11,2011-01-28 00:16:50,2010-12-09 20:46:23
7587f4d32f7479a9fa9ae1767708597702a0be5f...c976bbff3c3e46e700adbdc14def8c9432fc925c,1,15,3,18,6,2011-01-28 09:01:17,2010-12-09 20:47:52
c976bbff3c3e46e700adbdc14def8c9432fc925c...ebd143ff999f40996832e9c221c41cb609578cd1,1,2,2,4,2,2011-01-28 09:01:17,2010-12-09 20:47:53
ebd143ff999f40996832e9c221c41cb609578cd1...97b8ee167154b66ec59367d3cc6d6abf5a996440,1,5,3,8,4,2011-01-28 09:01:17,2010-12-09 20:47:54
97b8ee167154b66ec59367d3cc6d6abf5a996440...3c9ae64c81bf6261fa9b19de5b6134e321905838,1,1,2,3,1,2011-01-28 09:01:17,2010-12-09 20:47:55
3c9ae64c81bf6261fa9b19de5b6134e321905838...963ceab57e0743ed76889b93d051dee828eed859,1,4,3,7,2,2011-01-28 09:01:17,2010-12-09 20:47:56
963ceab57e0743ed76889b93d051dee828eed859...6459d7c046e5ab618ffde2d5a04dc83b5f97a600,1,2,1,3,2,2011-01-28 09:01:17,2010-12-09 20:47:57
6459d7c046e5ab618ffde2d5a04dc83b5f97a600...d1c7f8aa666dfc96743782cba452112c7678e9eb,1,9,6,15,3,2011-01-28 09:01:17,2010-12-09 20:47:58
d1c7f8aa666dfc96743782cba452112c7678e9eb...bf59439847369ce8c1169fdf58aca5ca857dc568,1,2,7,9,2,2011-01-28 09:01:17,2010-12-09 20:47:59
bf59439847369ce8c1169fdf58aca5ca857dc568...9e34e62bcbef12d290ecc0854df9117009873a3f,1,3,1,4,1,2011-02-06 22:03:39,2011-02-06 17:01:08
9e34e62bcbef12d290ecc0854df9117009873a3f...fb027e148a1e256e12ecfcfac090f4f06f8d4c58,1,1,0,1,1,2011-02-06 22:20:05,2011-02-06 17:04:27
fb027e148a1e256e12ecfcfac090f4f06f8d4c58...df128139c690233e94ac249cf9d5271ac0d5f13d,1,3,11,14,4,2011-02-06 22:43:35,2011-02-06 17:22:46
df128139c690233e94ac249cf9d5271ac0d5f13d...8b92658206c3fb7d23fdacd626667985bf4c50b4,1,2,2,4,1,2011-02-13 00:47:19,2011-02-12 16:43:44
8b92658206c3fb7d23fdacd626667985bf4c50b4...9d04278a4d0fcd784e7b9998caa94cff6cbdca8a,3,14,1,15,5,2011-02-13 00:47:24,2011-02-12 16:44:58
9d04278a4d0fcd784e7b9998caa94cff6cbdca8a...e8db4035df29edc29815ac9a374d0e3dfb8ef329,1,24,16,40,2,2011-02-14 12:10:54,2011-02-13 13:50:38
e8db4035df29edc29815ac9a374d0e3dfb8ef329...69e21b8392ac74338f3378a63f3db6b9df5249d7,2,74,0,74,5,2011-02-14 12:15:36,2011-02-13 13:57:15
69e21b8392ac74338f3378a63f3db6b9df5249d7...ba44692a2ecedacfc48c28fba642876d49dec90a,1,14,10,24,7,2011-02-15 00:20:36,2011-02-15 00:20:36
ba44692a2ecedacfc48c28fba642876d49dec90a...4bfa2502f7e2dac52d8af46ee5abe0acf848607b,1,2,2,4,2,2011-02-24 00:11:45,2011-02-22 19:28:36
4bfa2502f7e2dac52d8af46ee5abe0acf848607b...4c2519e5a287709e3306449fc05bcdd2aefe8c7b,1,10,12,22,6,2011-02-24 00:11:50,2011-02-22 19:30:21
4c2519e5a287709e3306449fc05bcdd2aefe8c7b...35b6f72feb998add040d95a9c89ff7ecd4d74901,1,19,0,19,1,2011-03-25 08:26:31,2011-02-18 13:42:54
9d3043cf333ee500e476a558acb234b42e43cc62...674a1d2628628aa21c32ef98279f99ba3794a640,1,3,2,5,1,2009-01-20 01:07:23,2009-01-19 17:06:43
9d3043cf333ee500e476a558acb234b42e43cc62...98347fee9bbff2676dff39895f9419b129d92e43,1,3,1,4,1,2009-01-18 22:27:02,2009-01-18 14:36:55
98347fee9bbff2676dff39895f9419b129d92e43...391d186babf9761f73d367c7325bc5c3d4e1495d,1,1,2,3,1,2009-01-18 22:27:03,2009-01-18 14:36:56
391d186babf9761f73d367c7325bc5c3d4e1495d...89edd5a90134fc265940499e33f431b1a7102693,1,2,2,4,1,2009-01-18 22:27:52,2009-01-18 14:36:57
89edd5a90134fc265940499e33f431b1a7102693...69274b6e8791824489eb5cf0a25b7577cd2a77c1,1,2,2,4,1,2009-01-18 22:29:37,2009-01-18 14:36:58
386befb773e2b4a7cc31135f22555e27597392c1...a8b38d95715c4bfacca7ddac67f7eb51a4cf5055,2,16,2,18,5,2013-01-30 10:12:16,2013-01-23 20:00:35
b938f62a208d24f3d6bed260ceb809cd6b3924d7...f265458f6116a0c03200477ae3b839f2a75bf0fa,1,1,1,2,1,2009-01-27 23:16:31,2009-01-27 23:07:46
f265458f6116a0c03200477ae3b839f2a75bf0fa...b8469ad0578d6b84ec92752a5f8df3ca5828af77,1,1,1,2,1,2009-01-27 23:16:41,2009-01-27 23:07:36
b938f62a208d24f3d6bed260ceb809cd6b3924d7...b67b9612e1a90ae093445abeaeff930e9f4cf936,2,98,66,164,16,2009-01-27 08:48:00,2009-01-26 08:08:24
537a071f41259c8631284bef28497280cd33db95...6d12acefd5ac0cd688bcc77470bb1d73859cdab1,2,8,6,14,6,2009-01-20 05:21:58,2009-01-19 18:03:04
5bd27ebb18f2dd745d1226b59b9f863c63c15fb2...e1dc49bcdefd362e129c9ee3a85527b518f9b49d,1,1,1,2,1,2009-04-05 07:08:49,2009-04-04 16:59:55
e1dc49bcdefd362e129c9ee3a85527b518f9b49d...4f6a32f8af9cceaf0c8ccf6d00d2f100dab5a6db,1,2,1,3,1,2009-04-05 07:37:32,2009-04-03 19:28:56
5bd27ebb18f2dd745d1226b59b9f863c63c15fb2...f0946cb826b9b6c01976860fdd9dfd498ce0ec5e,2,17,3,20,3,2009-04-02 02:35:16,2009-03-31 15:05:01
f0946cb826b9b6c01976860fdd9dfd498ce0ec5e...8092bfb6c23776d72ce4b38a3b517c3753c3b9fe,2,12,2,14,2,2009-04-02 02:35:31,2009-04-02 02:34:03
a1b6fb04b1c1b581dfac5c13641af8b3ae44810f...3f1b7b607a81cf56254fcc4ed417cc4344cde2a5,2,90,1,91,2,2008-07-20 07:00:46,2008-07-20 06:25:00
3f1b7b607a81cf56254fcc4ed417cc4344cde2a5...2d9c572578c72bd6691e80a9feed7d631baf007f,1,1,1,2,1,2008-07-20 20:01:26,2008-07-20 19:13:08
fbc9629e2f0cd31ab08638ebbd8f98a323329a5b...1cac41f8eaf00e3e8837bf8aab12fc317a5b8a21,1,1,1,2,1,2011-05-16 09:36:00,2011-05-16 09:36:00
1cac41f8eaf00e3e8837bf8aab12fc317a5b8a21...e34789cc8ba45d5491c007274b41849d3b0b84b7,2,16,0,16,3,2011-05-20 21:49:15,2011-02-15 19:43:54
e34789cc8ba45d5491c007274b41849d3b0b84b7...8c0bf68353ed3394039ca04c01ded39a4f5643ea,1,19,20,39,7,2011-07-11 10:26:46,2011-03-31 15:24:36
8c0bf68353ed3394039ca04c01ded39a4f5643ea...c5c45e1a2ddc28101ad19615ef6f9e0e08822206,1,1,1,2,1,2011-07-11 10:26:47,2011-06-16 12:22:39
c5c45e1a2ddc28101ad19615ef6f9e0e08822206...768e300a508d0e9e685929082a99c885ff384ffc,2,4,4,8,4,2011-07-11 12:55:38,2011-07-11 12:55:38
768e300a508d0e9e685929082a99c885ff384ffc...9a483e5c093bc5fa364e02b7a4aeb26dde99a5e9,2,75,0,75,5,2011-07-19 14:31:24,2011-07-17 01:47:14
9a483e5c093bc5fa364e02b7a4aeb26dde99a5e9...af9a4625fa7aeeb5bc52eed3af7e19579af31f42,2,7,1,8,5,2011-07-19 14:31:29,2011-07-16 16:59:45
af9a4625fa7aeeb5bc52eed3af7e19579af31f42...29776c75d0ed79c544601b1630d532f9e121b9c7,1,0,2,2,2,2011-07-19 14:33:34,2011-07-19 14:33:34
29776c75d0ed79c544601b1630d532f9e121b9c7...856c2d75c64b0e7cfc1a8d84ad5344e8b2354085,1,9,0,9,2,2011-10-06 22:20:16,2011-05-27 15:40:24
856c2d75c64b0e7cfc1a8d84ad5344e8b2354085...e0e0a6c64c5e7fffddc7ab8ef5d17626cf689e47,1,16,6,22,5,2011-10-15 08:13:33,2011-10-13 13:48:12
e0e0a6c64c5e7fffddc7ab8ef5d17626cf689e47...59252107ac24d5efb0d411ef4c2b279aa217cd7d,1,11,2,13,3,2011-10-15 22:13:32,2011-10-13 13:48:14
59252107ac24d5efb0d411ef4c2b279aa217cd7d...81a92e52059b3e2246142650b1282c6f21f49507,1,1,0,1,1,2011-10-15 22:14:13,2011-10-13 13:48:13
81a92e52059b3e2246142650b1282c6f21f49507...843d6597fbacfae02b8af7d6840992c92d0863f8,1,11,4,15,4,2011-10-15 22:14:13,2011-10-13 13:48:15
674a1d2628628aa21c32ef98279f99ba3794a640...950db8798d51cb183c858938263425b367b21dfd,3,8,6,14,6,2009-01-21 08:17:40,2009-01-20 21:08:33
a8b38d95715c4bfacca7ddac67f7eb51a4cf5055...252c52df9d8d34692cb98a001491dd448e705901,1,110,39,149,36,2013-04-01 06:57:23,2013-03-27 13:40:51
252c52df9d8d34692cb98a001491dd448e705901...39c126914b4b7365251f32d34926506c229f090e,1,6,1,7,2,2013-05-11 07:08:41,2013-05-11 07:08:41
39c126914b4b7365251f32d34926506c229f090e...685316c419caf4f4ec2e81e607d3e3ab089e329c,1,1,1,2,1,2013-05-11 07:09:27,2013-04-29 05:20:48
685316c419caf4f4ec2e81e607d3e3ab089e329c...2c8cd905d14e910de2a820178edf99b61f34a0c5,1,7,13,20,3,2013-05-11 07:37:08,2013-04-27 22:01:39
2c8cd905d14e910de2a820178edf99b61f34a0c5...8f3ff9339fd0bdb797e072a1843bc5e9f766e4c6,1,62,0,62,2,2013-05-11 08:31:50,2013-04-27 14:36:13
8f3ff9339fd0bdb797e072a1843bc5e9f766e4c6...c33cb9083ecad2ec7e23b00722096a94e62b17e1,1,4,1,5,2,2013-05-13 11:29:40,2012-06-14 18:34:11
c33cb9083ecad2ec7e23b00722096a94e62b17e1...76bf6ff93e1766b8813f0cdbe9089080010ba646,1,9,0,9,1,2013-05-13 11:29:43,2013-04-24 09:48:27
b8469ad0578d6b84ec92752a5f8df3ca5828af77...915308b187bdaba9ad1c6c3dea7b2b4b200b4796,1,2,1,3,1,2009-01-29 07:40:53,2009-01-29 05:56:34
4f6a32f8af9cceaf0c8ccf6d00d2f100dab5a6db...ce8936c342a15a08029c71fdc92e283e3624bc18,1,2,2,4,1,2009-04-08 04:56:41,2009-04-06 20:45:21
ce8936c342a15a08029c71fdc92e283e3624bc18...39470cf961e584ddb505f51bb9c452ebcfd5c569,1,6,2,8,2,2009-04-08 04:57:12,2009-04-07 12:43:53
39470cf961e584ddb505f51bb9c452ebcfd5c569...20ff3ec28e1dc7b653bfdc7643cb55045d7913fc,2,5,5,10,2,2009-04-08 04:58:25,2009-04-06 15:03:36
2d9c572578c72bd6691e80a9feed7d631baf007f...f5242ebf0dcd858ae9c72f39aed9773696d7283d,1,2,1,3,1,2008-07-23 19:09:47,2008-07-23 10:15:32
843d6597fbacfae02b8af7d6840992c92d0863f8...a8ca786991f7308ef12cb1d54ff5d28137c0feb1,1,1,0,1,1,2011-10-18 08:10:51,2011-10-14 08:19:26
76bf6ff93e1766b8813f0cdbe9089080010ba646...9aa66a040f8d84282ad8435585a2b5c912e3552f,1,338,295,633,289,2013-05-16 23:25:25,2013-05-16 07:14:35
915308b187bdaba9ad1c6c3dea7b2b4b200b4796...c7cddc1a2f365e4f4aea71b700c0b833eb436fee,1,6,3,9,2,2009-01-31 18:39:55,2009-01-31 14:39:10
20ff3ec28e1dc7b653bfdc7643cb55045d7913fc...de551d472ed65fa570d9456e8498348fe4c8e7d8,2,0,3,3,3,2009-04-09 05:58:43,2009-04-08 11:28:54
f5242ebf0dcd858ae9c72f39aed9773696d7283d...8892048d516fffab2000c2b47e006d8d8ebaa8c7,1,1,1,2,1,2008-07-25 16:27:13,2008-07-25 13:06:48
8892048d516fffab2000c2b47e006d8d8ebaa8c7...72de2883bd7d4ceda05f107826c7607c594de965,1,4,0,4,1,2008-07-25 17:46:46,2008-07-24 17:32:00
72de2883bd7d4ceda05f107826c7607c594de965...c30e699fc509f43f459c17d3148e7d866fb9157a,2,1,1,2,2,2008-07-25 18:09:48,2008-07-25 18:09:48
c30e699fc509f43f459c17d3148e7d866fb9157a...bfce5087ee01fdead5cdc52180c8eef22adbbd71,2,10,7,17,7,2008-07-25 19:36:16,2008-07-25 19:35:10
a8ca786991f7308ef12cb1d54ff5d28137c0feb1...b020bbd5a0923ceac688fcec1f760beec00dd5ec,1,1,2,3,1,2011-10-18 08:44:10,2011-10-14 19:25:19
b020bbd5a0923ceac688fcec1f760beec00dd5ec...526aa2b2033048bc90ff40228a60619ca6872e21,1,5,5,10,4,2011-10-18 08:44:10,2011-10-14 19:25:20
526aa2b2033048bc90ff40228a60619ca6872e21...bb196e2619652f02f3459ad9464a18ccdebe3ebf,3,32,1,33,4,2011-10-18 08:44:10,2011-10-14 19:25:21
bb196e2619652f02f3459ad9464a18ccdebe3ebf...99665fc58269cfd608558cc0afbc53824703fc6b,1,2,1,3,1,2011-10-18 08:44:10,2011-10-18 08:32:22
a8ca786991f7308ef12cb1d54ff5d28137c0feb1...12b219f7f95f2d089e49140dcb1c2dd6259ff5cf,1,14,2,16,4,2011-10-18 08:27:28,2011-10-14 08:14:49
12b219f7f95f2d089e49140dcb1c2dd6259ff5cf...0a0243d7333a5c0de107170d02f667c37fb4dc54,1,12,1,13,4,2011-10-18 08:27:28,2011-10-14 08:14:50
0a0243d7333a5c0de107170d02f667c37fb4dc54...e9144d5555133a76addb4829dca0e7a9684e1ed4,1,11,1,12,6,2011-10-18 08:27:28,2011-10-14 08:14:51
e9144d5555133a76addb4829dca0e7a9684e1ed4...1159971baa28ed3a9934cf92f4b22e9d0681bdce,1,60,0,60,8,2011-10-18 08:27:28,2011-10-14 08:14:52
1159971baa28ed3a9934cf92f4b22e9d0681bdce...35927672765f39a045a89d2ef1b392ab3ac61189,3,100,8,108,6,2011-10-19 11:44:39,2011-10-19 11:44:39
35927672765f39a045a89d2ef1b392ab3ac61189...b66f4f7aa750ebebbd5186e1cafeee76df4691f8,1,9,7,16,2,2011-10-19 12:22:33,2011-10-19 12:22:33
b66f4f7aa750ebebbd5186e1cafeee76df4691f8...8eaf24b93bdb49d5adfb2f52f0f14dd01735db37,1,7,3,10,3,2011-10-19 12:29:52,2011-10-19 12:29:52
9aa66a040f8d84282ad8435585a2b5c912e3552f...4399fe337218ebad0c47e9f4edcd83defbb4733d,1,83,13,96,12,2013-10-31 09:03:28,2013-01-02 23:10:31
4399fe337218ebad0c47e9f4edcd83defbb4733d...71846c5caf0b04a3cb8ee098c986f4a59dcea932,1,1,1,2,1,2013-12-01 22:24:20,2013-11-16 17:37:40
71846c5caf0b04a3cb8ee098c986f4a59dcea932...5de460a2cfdd4acbadd41355a5b34dc69e93b89e,1,213,195,408,28,2013-12-01 22:24:20,2013-11-16 17:37:41
5de460a2cfdd4acbadd41355a5b34dc69e93b89e...b449eb2cb34fbdcb5cab7101a527985013818c9b,1,10,1,11,2,2013-12-01 22:24:20,2013-11-16 17:37:42
b449eb2cb34fbdcb5cab7101a527985013818c9b...9403bd02dd96a2f8b1a5802d86e1592d0dcf2358,1,38,0,38,5,2013-12-01 22:24:20,2013-11-16 17:37:43
9403bd02dd96a2f8b1a5802d86e1592d0dcf2358...ce2c58cdaad42b9af6ad243f149c542ea93f8d01,1,8,0,8,1,2013-12-01 22:24:20,2013-11-16 17:37:44
c7cddc1a2f365e4f4aea71b700c0b833eb436fee...bc395643b606ffe7a5c01e2772ae0644c840f368,1,2,0,2,1,2009-02-02 18:58:20,2009-02-02 18:58:20
de551d472ed65fa570d9456e8498348fe4c8e7d8...213152688c85a0e4d591abc1c10b7c279ffefb99,1,2,0,2,1,2009-04-12 21:30:31,2009-04-10 22:20:18
bfce5087ee01fdead5cdc52180c8eef22adbbd71...1e5f7add985dbccc0e811dbb6eff5047d8843118,1,1,1,2,1,2008-08-02 04:10:40,2008-08-02 01:51:21
1e5f7add985dbccc0e811dbb6eff5047d8843118...d65d2b2fb44a8bc0fc917aaca973ab7ad14d13b4,2,28,0,28,2,2008-08-02 05:41:07,2008-07-28 06:02:04
d65d2b2fb44a8bc0fc917aaca973ab7ad14d13b4...b2a56276512885f0c7d159543395769168c9f599,2,64,18,82,14,2008-08-02 05:41:15,2008-07-27 06:15:51
b2a56276512885f0c7d159543395769168c9f599...bbff8aaaf2f2342b97882f93c9e30050918621c0,2,7,5,12,3,2008-08-02 05:45:27,2008-07-27 11:12:15
bbff8aaaf2f2342b97882f93c9e30050918621c0...31f4e768a4b53419a1de9c4006c7b3747fc356eb,2,30,0,30,2,2008-08-02 05:49:25,2008-07-25 17:51:51
31f4e768a4b53419a1de9c4006c7b3747fc356eb...b1264da8637dc991b84e329c2c4958c1332d069f,2,8,8,16,2,2008-08-02 06:00:42,2008-07-23 23:16:05
b1264da8637dc991b84e329c2c4958c1332d069f...11ee57bc4c44763b7ea92c5f583e27a5fbbff76b,3,65,8,73,8,2008-08-02 06:14:22,2008-07-23 00:51:36
11ee57bc4c44763b7ea92c5f583e27a5fbbff76b...734a6ffafb754323a4cde51b61a6099b46d03466,1,2,1,3,1,2008-08-02 06:15:02,2008-07-22 21:23:31
734a6ffafb754323a4cde51b61a6099b46d03466...00332b8152c541fcb8887019bb04dd425739d038,1,1,1,2,2,2008-08-02 06:16:38,2008-07-21 18:15:59
00332b8152c541fcb8887019bb04dd425739d038...61d47feec61c0f7a6cb192bd40f17d45f6bc0560,1,1,1,2,1,2008-08-02 06:21:23,2008-07-21 18:34:06
61d47feec61c0f7a6cb192bd40f17d45f6bc0560...1ceb95c8041cad1c25c73fd08e8c0c7ee28cf704,43,43,43,86,43,2008-08-02 06:21:44,2008-07-21 19:14:42
1ceb95c8041cad1c25c73fd08e8c0c7ee28cf704...69c231f4732e1373f7872dde6dc50ffe62673865,2,6,5,11,2,2008-08-02 06:26:40,2008-07-14 18:29:37
69c231f4732e1373f7872dde6dc50ffe62673865...e12455479651c3444aca9cf550b1e1beed1055a6,2,20,1,21,2,2008-08-02 06:54:01,2008-08-02 06:54:01
ae6ec6124bb96157ca96bc90831b4874e8ad6789...80e66678092700354f8cfc334eab62861d509201,1,7,1,8,2,2011-10-19 13:13:15,2010-11-23 07:37:50
80e66678092700354f8cfc334eab62861d509201...508dee31f3412d8708b7b47c1677b4294c865edb,5,5,0,5,5,2011-10-19 13:26:29,2011-10-19 13:26:29
508dee31f3412d8708b7b47c1677b4294c865edb...f9ace9e63d1ea0ce55b8239971b3c99d32dd4692,1,17,7,24,6,2011-10-21 21:28:23,2011-10-20 19:27:27
f9ace9e63d1ea0ce55b8239971b3c99d32dd4692...ff3f01bba9d67a6f7194bbcf2716e55cc596cce1,1,6,3,9,3,2011-10-21 21:28:27,2011-10-20 19:30:30
ff3f01bba9d67a6f7194bbcf2716e55cc596cce1...95fa862b577711918fe17cadc3b18851cd077a2b,1,8,2,10,1,2011-10-21 22:15:10,2011-10-20 19:32:30
95fa862b577711918fe17cadc3b18851cd077a2b...4198579b0a35edfc17e77ba11be3f801e89205ab,1,1,1,2,1,2011-10-31 08:58:18,2011-10-30 17:18:44
4198579b0a35edfc17e77ba11be3f801e89205ab...9af6413b96c85c9fcd9c34c015cd8fae0219ee04,2,2,1,3,2,2011-11-04 16:16:52,2010-11-19 10:00:49
9af6413b96c85c9fcd9c34c015cd8fae0219ee04...3f2fb173ace1afa7040d31cd3239c6a9cac49006,1,1,1,2,1,2011-11-04 16:16:54,2010-11-19 22:22:20
3f2fb173ace1afa7040d31cd3239c6a9cac49006...54531e7c7aeca965c23e60a6805059826a8de75a,3,3,0,3,3,2011-11-05 00:38:01,2011-01-21 10:59:45
54531e7c7aeca965c23e60a6805059826a8de75a...f49517a862529f8f0898c414113a45f40cc54565,2,2,1,3,2,2011-11-05 00:39:03,2011-10-22 19:39:39
f49517a862529f8f0898c414113a45f40cc54565...d8d166bf0950889743695174e55ea9201e9db9cd,1,3,1,4,1,2011-11-05 00:39:04,2011-10-22 19:39:40
d8d166bf0950889743695174e55ea9201e9db9cd...6f01e20e25f7a164cb27067c690aa49d4cb5178e,1,1,0,1,1,2011-11-30 11:35:28,2011-11-30 11:35:28
6f01e20e25f7a164cb27067c690aa49d4cb5178e...af867683345838f1adc606618e873ae4387a3c81,1,1,1,2,1,2011-11-30 14:37:26,2011-11-29 09:27:17
af867683345838f1adc606618e873ae4387a3c81...215d4fdbaa9d32459cc199667970dc7f63d94982,1,4,1,5,1,2011-12-07 12:48:34,2011-12-07 12:48:04
215d4fdbaa9d32459cc199667970dc7f63d94982...7d076d56757c238aa1b90534cd0d2450528b3580,2,37,11,48,5,2011-12-09 15:14:32,2011-12-09 15:14:32
7d076d56757c238aa1b90534cd0d2450528b3580...942e6baa92846e5628752c65a22bc4957d8de4d0,1,1,1,2,1,2011-12-13 23:44:30,2011-12-13 23:44:30
ce2c58cdaad42b9af6ad243f149c542ea93f8d01...1f3c8726cd0f0fd4868f0e7a929a312937f647da,1,1,1,2,1,2014-01-21 10:57:03,2014-01-18 12:58:51
1f3c8726cd0f0fd4868f0e7a929a312937f647da...45f884c346bf446aa8af38a9e3920c6d4a74c58d,1,1334,0,1334,1,2014-01-21 11:00:29,2014-01-15 11:27:29
45f884c346bf446aa8af38a9e3920c6d4a74c58d...6c626a031abf0e799dc80ab78bf2bb316b7a5140,1,2,2,4,2,2014-01-21 11:02:27,2014-01-21 11:02:27
6c626a031abf0e799dc80ab78bf2bb316b7a5140...c61f3a97b18ec01443440a4be55610929694020d,1,0,0,0,0,2014-01-21 11:14:42,2013-11-25 21:00:10
c61f3a97b18ec01443440a4be55610929694020d...786f15c849916513531862a5f3fb45c0323b61f6,1,28,2,30,2,2014-01-21 11:18:23,2013-12-18 16:04:13
786f15c849916513531862a5f3fb45c0323b61f6...8f86339858c1325645f8eaf6950dfd9d74cc9897,1,30,5,35,5,2014-01-22 11:05:32,2014-01-21 19:10:16
8f86339858c1325645f8eaf6950dfd9d74cc9897...76d64ca6b5d33df59222e44194efbf92469815dc,1,1,1,2,1,2014-01-23 11:06:22,2014-01-23 11:06:22
ce2c58cdaad42b9af6ad243f149c542ea93f8d01...0166027e56cd743fabc93191b525647153519f15,1,1351,0,1351,1,2013-12-14 07:43:04,2013-12-14 07:43:04
bc395643b606ffe7a5c01e2772ae0644c840f368...e1e4389832f32bb6ce029d6a6b110aa9ec768ea8,1,1,1,2,1,2009-02-04 06:04:31,2009-02-04 01:50:15
e1e4389832f32bb6ce029d6a6b110aa9ec768ea8...c9a8abcf9a9997d463a6a05668fd9a90a26df1f2,1,1,1,2,1,2009-02-04 06:09:03,2009-02-04 21:00:40
c9a8abcf9a9997d463a6a05668fd9a90a26df1f2...37fc57a213c5dd7a15dfdf571ce4a58de124cb0f,2,1,1,2,1,2009-02-04 06:11:44,2009-02-04 21:00:41
37fc57a213c5dd7a15dfdf571ce4a58de124cb0f...7a85f6ae88be5937c32a7b61601a40a02c03fb3f,1,1,1,2,1,2009-02-04 06:13:47,2009-02-03 22:41:14
bc395643b606ffe7a5c01e2772ae0644c840f368...e02f1762b257c50124fc528e8b60bf16e8bb7acf,1,5,5,10,4,2009-02-04 05:12:23,2009-02-03 17:51:12
e02f1762b257c50124fc528e8b60bf16e8bb7acf...441adf0ccf571a9fe15658fdfcd856d2aabc01cb,2,53,2,55,5,2009-02-04 16:47:57,2009-02-04 16:06:07
213152688c85a0e4d591abc1c10b7c279ffefb99...8d2dfc49b199c7da6faefd7993630f24bd37fee0,7,48,41,89,32,2009-04-13 00:28:31,2009-04-11 00:27:58
213152688c85a0e4d591abc1c10b7c279ffefb99...c6d8f7635f619f6576dccf17c1f1264d2cc37a2a,1,3,0,3,1,2009-04-12 21:30:40,2009-04-10 06:26:49
e12455479651c3444aca9cf550b1e1beed1055a6...e8b55fab6237b30494aa1905c3209d5bf5494a29,1,41,37,78,4,2008-08-02 18:04:22,2008-08-02 18:04:22
e8b55fab6237b30494aa1905c3209d5bf5494a29...b003c00b7b5e352569061fec0b1e1bd0d0fa8b6a,2,8,4,12,2,2008-08-02 18:07:50,2008-07-31 13:20:34
942e6baa92846e5628752c65a22bc4957d8de4d0...ba5d445b653f874d9e4f2fd97fdd87438f45a70d,1,1,0,1,1,2012-01-22 23:16:03,2012-01-21 17:57:28
ba5d445b653f874d9e4f2fd97fdd87438f45a70d...446f8226ddb4f1d6e5ce14fb8cc22695af08e32b,1,3,1,4,1,2012-03-10 23:16:24,2012-03-09 23:17:22
446f8226ddb4f1d6e5ce14fb8cc22695af08e32b...ef42057deae1aca6c3716019a3672809785f0a96,10,10,10,20,10,2012-03-10 23:25:34,2012-03-06 01:53:23
c4a0483fd5917dfa77024d5b46cb48f62dc32424...ada2ea1695c4200dd9deaef2034cc453c27729f7,1,1,0,1,1,2014-06-15 01:35:50,2014-03-20 08:58:51
ada2ea1695c4200dd9deaef2034cc453c27729f7...4135d36b0c99329eff69686f7a17406053941b5c,1,6,2,8,3,2014-06-15 01:35:50,2014-04-05 20:38:50
4135d36b0c99329eff69686f7a17406053941b5c...019e1630ac16f82fa6322869c8dfc3dee029e7ae,1,23,1,24,1,2014-06-15 01:35:50,2014-05-12 11:25:58
019e1630ac16f82fa6322869c8dfc3dee029e7ae...17f9836c8afc8d4b6d6bb91fd0658df090d75c8f,1,10,3,13,4,2014-06-15 01:35:50,2014-04-08 19:36:08
7a85f6ae88be5937c32a7b61601a40a02c03fb3f...720ec6b870ba913affd0f6c01d5a61b9b2c5aadb,1,1,1,2,1,2009-02-04 19:04:44,2009-02-04 09:32:06
720ec6b870ba913affd0f6c01d5a61b9b2c5aadb...c8ba6b1b199bf00f227e8fdad4adb5a2147c8160,1,8,0,8,1,2009-02-04 19:04:56,2009-02-04 09:32:07
c8ba6b1b199bf00f227e8fdad4adb5a2147c8160...5aed3c6ab834367292bd7a9b0894177a07afd910,2,5,5,10,3,2009-02-04 19:07:42,2009-02-04 09:32:08
8d2dfc49b199c7da6faefd7993630f24bd37fee0...6e7d0efa9058aa61147d9d18b33bd046055584e4,2,33,1,34,2,2011-03-14 19:33:58,2011-03-14 19:29:50
8d2dfc49b199c7da6faefd7993630f24bd37fee0...cf2ab916afa4231f7e9db31796e7c0f712ff6ad1,7,20,14,34,18,2009-04-13 00:28:31,2009-04-11 01:15:26
c6d8f7635f619f6576dccf17c1f1264d2cc37a2a...e0b3cc0dffbc965ffa33155cbdcf8d44716c134c,2,9,2,11,3,2009-04-18 03:59:01,2009-04-17 12:05:11
b003c00b7b5e352569061fec0b1e1bd0d0fa8b6a...7c5b1675a88a52be1822129e4aa915c5531f6700,1,5,7,12,2,2008-08-03 19:48:41,2008-08-03 13:44:33
ef42057deae1aca6c3716019a3672809785f0a96...3c3737deab03cd4b5f42d9b1bf58e186de26e9ec,1,3,3,6,3,2012-06-19 20:31:14,2012-06-19 18:25:39
3c3737deab03cd4b5f42d9b1bf58e186de26e9ec...774b79fbb8947a12996bcc49b3951d14c0395444,1,1,1,2,1,2012-06-19 20:31:14,2012-06-19 18:25:40
774b79fbb8947a12996bcc49b3951d14c0395444...1a8cdacb51ae200c8a209df2e43e2b292680528e,1,14,14,28,14,2012-06-19 20:31:14,2012-06-19 18:25:41
ef42057deae1aca6c3716019a3672809785f0a96...c42939d24e5f48f7bce44771dbe22a879664faa1,1,1,0,1,1,2012-03-25 12:24:14,2012-03-23 17:46:27
c42939d24e5f48f7bce44771dbe22a879664faa1...fda1ba02f3015310c3ac505292640c90bc97b172,1,8,3,11,6,2012-04-19 13:07:39,2012-04-19 10:19:58
17f9836c8afc8d4b6d6bb91fd0658df090d75c8f...c7664f1a8c6d40acf8221ba620a3193dec411f8c,1,9,2,11,2,2014-06-15 01:35:50,2014-06-13 21:13:37
c7664f1a8c6d40acf8221ba620a3193dec411f8c...105b5d3fbb1c00bb0aeaf9d3e0fbe26a7b1993fc,1,2,1,3,1,2014-06-15 01:35:50,2014-06-13 21:43:48
105b5d3fbb1c00bb0aeaf9d3e0fbe26a7b1993fc...ac54a4b7715543a29cf72a49a3dd8add32796e86,1,3,1,4,1,2014-06-27 06:30:39,2014-06-19 02:53:14
ac54a4b7715543a29cf72a49a3dd8add32796e86...bde4a0f9f3035d482a80c32b4a485333b9ed4875,1,6,4,10,6,2014-06-27 06:37:14,2014-06-24 05:19:44
5aed3c6ab834367292bd7a9b0894177a07afd910...ab2fdb3b62589477bde0cd0af8239bee510c3488,1,4,1,5,2,2009-02-05 06:00:49,2009-02-05 04:14:29
e0b3cc0dffbc965ffa33155cbdcf8d44716c134c...32d1776b1341c17b99da862e80ddf151a5b558fe,2,12,1,13,3,2009-04-18 20:06:40,2009-04-18 14:14:02
32d1776b1341c17b99da862e80ddf151a5b558fe...62854410449ec407a363e4bb1dc980a75aa1699d,1,8,8,16,6,2009-04-18 20:39:42,2009-04-18 09:46:06
7c5b1675a88a52be1822129e4aa915c5531f6700...f70f988b11f3ec24df023b105967978410828ea1,4,6,6,12,6,2008-08-05 18:38:11,2008-08-05 16:12:06
f70f988b11f3ec24df023b105967978410828ea1...3be3999849bf993162fc957f47fc99325c324e9c,1,1,1,2,1,2008-08-05 18:40:28,2008-08-05 14:54:42
3be3999849bf993162fc957f47fc99325c324e9c...2b6ca6df2dbe9c23d0adfc1f59678a2d85c560b2,1,5,4,9,2,2008-08-06 01:27:31,2008-08-05 18:27:30
2b6ca6df2dbe9c23d0adfc1f59678a2d85c560b2...2d0f5f3459278475602394a7165bf8919412f4e4,1,13,0,13,3,2008-08-06 04:20:59,2008-08-06 04:20:59
272b9296397af4ad35770dec6c731d1b387654db...44e88ce07838fd20d7187d3031916095ce823255,1,4,0,4,2,2012-09-17 08:23:35,2012-09-14 23:36:41
44e88ce07838fd20d7187d3031916095ce823255...9ef750875abd9cc41d733131a2851b5165fc2197,1,1,1,2,1,2012-09-17 10:53:37,2012-08-18 20:24:00
9ef750875abd9cc41d733131a2851b5165fc2197...5a5e4d2599faf51240e5c8f29645eeb2aedff5c2,1,1,0,1,1,2012-09-17 10:59:05,2012-08-18 20:28:00
5a5e4d2599faf51240e5c8f29645eeb2aedff5c2...e3d06ca93eebaf5e4bf8438255a30fb6c91ab277,1,10,1,11,2,2012-10-17 20:47:49,2012-10-02 16:25:14
e3d06ca93eebaf5e4bf8438255a30fb6c91ab277...df46eda3887da7c31cbc3f278550fc8ef9d1ba7a,1,7,2,9,1,2012-10-17 20:47:50,2012-10-02 16:25:15
df46eda3887da7c31cbc3f278550fc8ef9d1ba7a...f6dd784ed4c1705d465b1238f9a5971f2733e582,1,1,1,2,1,2012-10-17 20:57:29,2012-10-17 20:57:29
bde4a0f9f3035d482a80c32b4a485333b9ed4875...d4ec30b24a8ad076771064ac71dbe5420512cc30,1,12,0,12,3,2014-08-08 06:39:02,2014-07-08 20:45:35
d4ec30b24a8ad076771064ac71dbe5420512cc30...09898e7c3b040086e8addd4ef226548c9dce1460,1,329,323,652,311,2014-08-08 06:39:30,2014-08-03 12:36:43
ab2fdb3b62589477bde0cd0af8239bee510c3488...dd482eeac2524627beee323438dd1fdf34b4f97e,2,9,2,11,5,2009-02-12 19:36:43,2009-02-10 14:20:17
ab2fdb3b62589477bde0cd0af8239bee510c3488...3d20c636af05c44a6ff4df9309c2bca108ee149b,3,9,0,9,3,2009-02-10 23:30:59,2009-02-10 21:36:12
ab2fdb3b62589477bde0cd0af8239bee510c3488...2cd85c40a9f396bb24f7861c832acd52e61c4780,1,6,1,7,4,2009-02-07 20:23:29,2009-02-07 15:08:27
2cd85c40a9f396bb24f7861c832acd52e61c4780...f3cad0ad82e24966bf7bcc8a47670c54c30e4b18,3,88,87,175,4,2009-02-07 20:23:29,2009-02-07 15:08:28
f3cad0ad82e24966bf7bcc8a47670c54c30e4b18...43a7ddb55d82d5c6f0c4d2cbe408a1df71d58ef3,2,9,8,17,5,2009-02-07 20:23:29,2009-02-07 15:08:29
43a7ddb55d82d5c6f0c4d2cbe408a1df71d58ef3...f42302b49333d035a323f5d80fb9562d375b17f1,3,26,30,56,11,2009-02-07 20:23:30,2009-02-07 15:08:30
f42302b49333d035a323f5d80fb9562d375b17f1...f2a782b8ba189b5ed51d18aa3eb93a670c220018,2,6,46,52,5,2009-02-07 20:23:30,2009-02-07 15:08:31
62854410449ec407a363e4bb1dc980a75aa1699d...c2318228ab327999520b2e5dbc9edbd619a73105,1,1,1,2,1,2009-04-23 08:29:00,2009-04-23 07:25:33
2d0f5f3459278475602394a7165bf8919412f4e4...eabbc99a2198d1cae62ce951457e7edc23b5f1a9,1,3,3,6,2,2008-08-06 06:30:11,2008-08-06 05:32:28
eabbc99a2198d1cae62ce951457e7edc23b5f1a9...dbd0f5c7692cce0c5fea535a06622b3a93df9598,6,72,5,77,11,2008-08-06 20:38:18,2008-08-06 18:43:47
dbd0f5c7692cce0c5fea535a06622b3a93df9598...781c1834f5419bdf81bb7f3750170ccd6b809174,3,10,11,21,5,2008-08-06 20:40:53,2008-08-06 19:04:06
f6dd784ed4c1705d465b1238f9a5971f2733e582...552ee61ece4dad7a42012d83a7271e4b5464cb2e,1,1,0,1,1,2012-11-13 23:52:14,2012-11-13 12:30:17
552ee61ece4dad7a42012d83a7271e4b5464cb2e...ab571ef02f5fc0d08bf2dce4e455d324e40fb220,1,1,1,2,1,2012-11-28 21:29:21,2012-11-28 14:49:43
ab571ef02f5fc0d08bf2dce4e455d324e40fb220...9f316463ba00576d6c848bf50194b72246e8f9ab,1,3,3,6,2,2012-12-25 00:21:59,2012-12-18 18:47:20
9f316463ba00576d6c848bf50194b72246e8f9ab...60468d6c893a6ad8795869d979a601e47cb90732,1,2,2,4,2,2013-02-22 20:13:21,2013-02-22 20:13:21
60468d6c893a6ad8795869d979a601e47cb90732...1fcd24d04358ea10c296a414e2b93f3714adca4b,1,9,2,11,1,2013-05-16 22:40:59,2013-05-09 16:30:02
1fcd24d04358ea10c296a414e2b93f3714adca4b...ed05e9f6c027a23ce45bcdbac4196058ed5d0e07,1,3,1,4,1,2013-05-17 09:51:01,2013-05-17 09:51:01
ed05e9f6c027a23ce45bcdbac4196058ed5d0e07...7d2017e7738ace254d0b653ce844d07af8ecf026,1,14,0,14,1,2013-06-07 00:34:42,2013-06-06 08:17:47
7d2017e7738ace254d0b653ce844d07af8ecf026...2f38dd03fcefb7ad3a6db2703eeb6dd9b4fd34b6,1,3,11,14,3,2013-06-07 22:03:29,2013-04-27 13:24:16
2f38dd03fcefb7ad3a6db2703eeb6dd9b4fd34b6...5c37033edf7963616038ff8b980047d5671e168e,1,4,2,6,2,2013-06-15 22:36:27,2013-06-15 22:36:27
5c37033edf7963616038ff8b980047d5671e168e...8a383db4b28059becc3ebfd1b402299e34c3151f,1,1,1,2,1,2013-06-15 22:53:34,2013-06-15 22:53:34
09898e7c3b040086e8addd4ef226548c9dce1460...7b68b0eebf2148808f005b65569a76a83e3482bd,1,1,1,2,1,2014-10-29 22:43:11,2014-10-23 19:30:54
7b68b0eebf2148808f005b65569a76a83e3482bd...4d5e1b1319d27d2381d31dc26bfd16360fe79ab8,1,2,0,2,1,2014-10-29 22:43:15,2014-09-09 07:29:16
4d5e1b1319d27d2381d31dc26bfd16360fe79ab8...9fabefb1f3f658e77eb18afa3f95efe1a0ee8d0d,1,20,68,88,5,2014-10-29 22:43:15,2014-09-14 20:35:57
3d20c636af05c44a6ff4df9309c2bca108ee149b...fa3a0c94dc88567b513e58835e5915f87da40af9,1,1,0,1,1,2009-02-11 18:25:24,2009-02-11 18:15:30
fa3a0c94dc88567b513e58835e5915f87da40af9...784f8affe4dfc8ceec93803d6c22b4b8467a4642,1,1,0,1,1,2009-02-12 02:30:17,2009-02-11 06:03:53
784f8affe4dfc8ceec93803d6c22b4b8467a4642...3e6b1d0abcd58f0b2b106212ce0a0e07a6de342f,1,67,20,87,5,2009-02-12 02:32:16,2009-02-10 20:16:31
c2318228ab327999520b2e5dbc9edbd619a73105...345f6e2cb547007da48ef503f00070cdcca04975,1,1,1,2,1,2009-04-27 16:36:14,2009-04-13 18:10:08
345f6e2cb547007da48ef503f00070cdcca04975...d649048e68f2f5d59f6f961839c9e9772743a505,1,1,1,2,1,2009-04-27 16:36:40,2009-04-13 18:11:21
d649048e68f2f5d59f6f961839c9e9772743a505...c922b01f54c4bebe84daeacf014cfbc8dc68479b,2,10,2,12,5,2009-04-28 00:28:18,2009-04-27 18:10:24
781c1834f5419bdf81bb7f3750170ccd6b809174...fd35e42683113e367eee0bb8ac956dde3d95edde,1,5,8,13,2,2008-08-07 18:39:14,2008-08-07 00:06:30
8a383db4b28059becc3ebfd1b402299e34c3151f...317797bce44f57b0fcdb735a42a6340de09b4257,1,2,0,2,1,2013-08-27 19:06:40,2013-07-21 12:23:48
317797bce44f57b0fcdb735a42a6340de09b4257...a86560453ba8a81527d5d119ea8985a3269af1fa,1,10,2,12,3,2013-08-27 19:06:41,2013-07-10 12:31:13
a86560453ba8a81527d5d119ea8985a3269af1fa...d478056c7dcc2aab690edf0036238e761c789007,2,2,0,2,2,2013-08-27 19:06:42,2013-08-27 10:11:15
d478056c7dcc2aab690edf0036238e761c789007...e632b3c0d37e5f61012dad6bb44c9a2a53a69f67,2,11,4,15,6,2013-08-27 19:06:42,2013-08-21 03:29:13
e632b3c0d37e5f61012dad6bb44c9a2a53a69f67...918dbf5887f68409f9225b8f84f7418c89e79a5f,1,11,5,16,3,2013-08-27 19:06:43,2013-08-21 03:38:40
918dbf5887f68409f9225b8f84f7418c89e79a5f...4394faf6e53e8b91c82332aa4f2b77616350a81b,1,5,1,6,1,2013-09-06 21:42:07,2013-09-04 15:03:48
4394faf6e53e8b91c82332aa4f2b77616350a81b...224cce8f9bb0403ec441ec709d2769adb8f66eb0,1,10,0,10,1,2013-09-12 20:15:19,2013-09-12 20:15:19
224cce8f9bb0403ec441ec709d2769adb8f66eb0...73fd416b291cdd70e30cb889e9ebcf10188d2342,4,5,5,10,5,2013-11-15 20:44:08,2013-11-12 15:17:44
3e6b1d0abcd58f0b2b106212ce0a0e07a6de342f...eb006ccfca019b4e96210310d9f823d050127b22,1,1,1,2,1,2009-02-28 21:10:16,2009-02-28 20:03:54
c922b01f54c4bebe84daeacf014cfbc8dc68479b...7dae8b21c2fe39a59661c709f0dc17090dafa5a4,2,65,12,77,11,2009-04-29 19:49:52,2009-04-29 19:49:52
73fd416b291cdd70e30cb889e9ebcf10188d2342...99337ef22ca013758dd243e06b10c6851b786e87,1,287,0,287,1,2014-01-18 16:32:04,2014-01-15 11:07:55
99337ef22ca013758dd243e06b10c6851b786e87...15a745305f04d4ee0704c37b06891b19020dc7f1,1,29,0,29,1,2014-01-18 16:32:09,2014-01-15 11:07:57
15a745305f04d4ee0704c37b06891b19020dc7f1...1ea11f0e459e55b062d7ffb30c9eb6a10838ebd5,1,2694,0,2694,1,2014-01-18 16:32:13,2014-01-15 11:07:56
1ea11f0e459e55b062d7ffb30c9eb6a10838ebd5...02f6cfbd1628d9e99a241d18d805f3842dc746e7,1,21,11,32,2,2014-01-18 16:51:15,2014-01-14 23:58:09
02f6cfbd1628d9e99a241d18d805f3842dc746e7...c64a0ad385d117c7a4a83771259e021dd196e7cb,2,0,0,0,0,2014-01-18 17:06:41,2013-11-25 21:01:05
c64a0ad385d117c7a4a83771259e021dd196e7cb...1b2c79e63e5afa3cecb3ab4a40cb414dbe6511ce,1,1,1,2,1,2014-01-18 17:29:34,2014-01-18 17:29:34
7dae8b21c2fe39a59661c709f0dc17090dafa5a4...2c5b0115038ab283b346fbb8059b93973ff4c8f2,1,2,2,4,2,2009-05-06 05:04:16,2009-05-04 17:37:30
7dae8b21c2fe39a59661c709f0dc17090dafa5a4...e84dc6df86ce91ecc1e355c323a0e681cb82f801,1,1,1,2,1,2009-05-06 05:02:39,2009-05-05 18:16:14
1b2c79e63e5afa3cecb3ab4a40cb414dbe6511ce...e0db1dd7d4bc87825f0d7d743f1a01b4461a59ff,2,8,1,9,2,2014-06-13 17:27:33,2014-04-08 19:30:51
e0db1dd7d4bc87825f0d7d743f1a01b4461a59ff...3decb8e0ac5d951f0a0cf6e604790b471aef22e1,1,2,2,4,2,2014-06-13 18:03:48,2014-05-17 19:49:05
1b2c79e63e5afa3cecb3ab4a40cb414dbe6511ce...b3f0c5c04ed24d04a3403abf517bec439ebb40e2,1,2,2,4,2,2014-05-19 17:12:45,2014-05-17 19:49:05
2c5b0115038ab283b346fbb8059b93973ff4c8f2...713697b34f1a1f716df97e331fd82782338c2083,1,1,1,2,1,2009-05-10 16:32:29,2009-05-10 16:13:45
713697b34f1a1f716df97e331fd82782338c2083...c98a95eea825ffe66ed690064c80733656506c66,1,2,0,2,1,2009-05-10 16:32:30,2009-05-10 16:14:49
2c5b0115038ab283b346fbb8059b93973ff4c8f2...27d5438d9f4eb2cefc2a989c68f9b42b529b2a12,1,4,4,8,2,2009-05-09 08:39:40,2009-05-08 09:06:15
c98a95eea825ffe66ed690064c80733656506c66...6589ebf107214a9e6db31764e847301f1adebc81,1,2,1,3,2,2009-05-24 18:08:31,2009-05-24 13:16:49
6589ebf107214a9e6db31764e847301f1adebc81...c97038d1cfbd98ea258086c417fe4f0c094596d3,1,32,33,65,16,2009-06-13 19:44:41,2009-06-13 18:20:00
6589ebf107214a9e6db31764e847301f1adebc81...1cd12926cedb340d176db607e087495381032ce2,1,6,0,6,1,2009-05-25 06:46:03,2009-05-25 00:21:13
1cd12926cedb340d176db607e087495381032ce2...5719db91ce5915ee07c50f1afdc94fe34e91529f,2,16,17,33,3,2009-05-25 06:56:34,2009-05-25 00:21:14
c97038d1cfbd98ea258086c417fe4f0c094596d3...90dce51584e908232ff279a6c2949ea9855dddf3,1,4,4,8,4,2009-06-14 20:37:14,2009-06-14 19:47:54
c97038d1cfbd98ea258086c417fe4f0c094596d3...df533f34a31890a43baaf00d03c0a7fa51886bc5,2,59,0,59,2,2009-06-14 00:06:09,2009-06-14 00:06:09
90dce51584e908232ff279a6c2949ea9855dddf3...ccf497de97f9d22e55e9e5ae90b8a65503d48099,1,1,1,2,1,2009-06-21 04:20:51,2009-06-20 11:27:15
ccf497de97f9d22e55e9e5ae90b8a65503d48099...d4900ee48c70114ea3227f922d383de6b273fcde,1,2,2,4,2,2009-06-21 06:45:51,2009-06-21 04:40:45
90dce51584e908232ff279a6c2949ea9855dddf3...ed342fdea0b7fd466ed3257c5e68aa81c391b782,2,15,2,17,3,2009-06-18 19:20:36,2009-06-18 09:17:54
d4900ee48c70114ea3227f922d383de6b273fcde...2e674a9d090f0d9be71c8143ae6c0fba04a160cc,1,8,3,11,4,2009-08-08 03:42:45,2009-08-08 03:12:13
2e674a9d090f0d9be71c8143ae6c0fba04a160cc...262b04fa8dce84596738fd8c0dbff52994388efa,1,19,8,27,7,2009-08-08 03:42:45,2009-08-07 22:36:31
