id,files,locs added,locs removed,locs total,hunks,commit time,author time
4b825dc642cb6eb9a060e54bf8d69288fbee4904...0f43e98ef8c2da8908b1107f75b67cda2572c2c4,1,9,0,9,1,2011-10-08 21:34:49,2011-10-08 21:34:49
0f43e98ef8c2da8908b1107f75b67cda2572c2c4...d3784687943e0bd699d73d82a6bc6cac39689473,317,11347,0,11347,267,2011-10-13 01:00:00,2011-10-13 01:00:00
4b825dc642cb6eb9a060e54bf8d69288fbee4904...93efff945215a4407afcaf0cba15ac601b56df0d,1,9,0,9,1,2011-10-08 21:34:49,2011-10-08 21:34:49
d3784687943e0bd699d73d82a6bc6cac39689473...0541b3f3c5dcd291d144c83d9731c75ee811b4e0,25,233,178,411,52,2011-10-14 22:11:15,2011-10-14 22:11:15
d3784687943e0bd699d73d82a6bc6cac39689473...b21e9afed36db08e025c643b47fab3cecbb12b77,1,2,1,3,1,2011-10-14 06:39:56,2011-10-14 06:39:56
93efff945215a4407afcaf0cba15ac601b56df0d...0f6ebcb694830b763f193a521c038b3d501a7abd,317,11347,0,11347,267,2011-10-13 01:00:00,2011-10-13 01:00:00
93efff945215a4407afcaf0cba15ac601b56df0d...9ba1224867665844b117fa037e1465bb706b3685,307,11053,0,11053,257,2011-10-08 21:36:38,2011-10-08 21:36:38
9ba1224867665844b117fa037e1465bb706b3685...b98a310def241a6fd9c9a9a3e7934c48e498fe81,2,9,1,10,2,2011-10-08 22:18:41,2011-10-08 22:18:41
b98a310def241a6fd9c9a9a3e7934c48e498fe81...b19a04f53caeebf4fe5ec2327cb83e9253dc91bb,2,8,0,8,5,2011-10-08 22:33:36,2011-10-08 21:57:14
b19a04f53caeebf4fe5ec2327cb83e9253dc91bb...e93f1603f53f5d62798cd246222b32ea43729314,3,7,13,20,12,2011-10-08 22:33:36,2011-10-08 22:15:24
e93f1603f53f5d62798cd246222b32ea43729314...819818ad740921c76e551dd602f9d0b59097fff4,1,0,2,2,2,2011-10-08 22:33:36,2011-10-08 22:30:11
819818ad740921c76e551dd602f9d0b59097fff4...9840102651ac84d2eb7824113a544bf4992e0398,7,15,3,18,12,2011-10-09 11:05:31,2011-10-09 11:05:31
9840102651ac84d2eb7824113a544bf4992e0398...67f0c62d0737ceeeb1babc953fbab41438e8d4f2,13,45,9,54,17,2011-10-09 18:15:01,2011-10-09 18:15:01
67f0c62d0737ceeeb1babc953fbab41438e8d4f2...035196e7a8c839ce14e280d0c7230b3ce34076fe,4,12,3,15,9,2011-10-09 19:36:57,2011-10-09 19:36:57
035196e7a8c839ce14e280d0c7230b3ce34076fe...d7ea9052f1ecc5add24ad8b9d0cb06082f28c86f,3,10,7,17,4,2011-10-09 19:55:06,2011-10-09 19:55:06
d7ea9052f1ecc5add24ad8b9d0cb06082f28c86f...ec9e54ea9496ed98b6400b479f50e19b89f3dcb4,7,50,8,58,14,2011-10-09 21:15:28,2011-10-09 21:15:28
ec9e54ea9496ed98b6400b479f50e19b89f3dcb4...ea4ded6e54863820c1913ef9d7e28fc87fab363a,1,1,1,2,1,2011-10-09 21:23:33,2011-10-09 21:23:33
ea4ded6e54863820c1913ef9d7e28fc87fab363a...25c9cbff89878482b1b9a8fa853fc2c426751178,1,73,9,82,3,2011-10-10 08:53:30,2011-10-10 08:53:30
25c9cbff89878482b1b9a8fa853fc2c426751178...162c4b044ee0890e774c30b19d17c0c5988c82d3,3,24,16,40,12,2011-10-10 21:07:40,2011-10-10 21:07:40
162c4b044ee0890e774c30b19d17c0c5988c82d3...9680c64fa880fa5df28db0171552f21513152620,2,13,13,26,7,2011-10-10 21:20:01,2011-10-10 21:20:01
9680c64fa880fa5df28db0171552f21513152620...94cdafe79ae528c6e47ec717836287592cef90a0,2,4,1,5,2,2011-10-11 20:10:55,2011-10-11 20:10:55
94cdafe79ae528c6e47ec717836287592cef90a0...eefe826f83bbbb9f0bc213aea4eae851dd116655,13,131,27,158,12,2011-10-12 13:19:14,2011-10-11 20:00:00
eefe826f83bbbb9f0bc213aea4eae851dd116655...29149848d4be32a1a54d8a663f43f869cecbabc7,1,9,7,16,5,2011-10-13 12:57:26,2011-10-13 12:57:26
29149848d4be32a1a54d8a663f43f869cecbabc7...1697539361e6a3bdf6906ef9a535b5d5d7ea288a,2,4,1,5,2,2011-10-13 13:46:02,2011-10-13 13:46:02
1697539361e6a3bdf6906ef9a535b5d5d7ea288a...d3931bfc062d7932160e35529c5cb45219f695dc,1,1,1,2,1,2011-10-14 11:57:45,2011-10-14 11:57:45
d3931bfc062d7932160e35529c5cb45219f695dc...a18924e954e79f07778da65d5978823d63f98ecf,2,6,5,11,3,2011-10-14 12:22:07,2011-10-14 12:22:07
7b5799a97998b68416f1b6233ce427135c99165a...ef2bf1520489a23ff64224c3e102a03b46243dbf,28,104,37,141,39,2011-10-15 18:39:11,2011-10-15 18:39:11
b21e9afed36db08e025c643b47fab3cecbb12b77...61381c8998fd35c1df3e251ab4e3eddefb2231ea,1,1,1,2,1,2011-10-14 10:48:03,2011-10-14 10:48:03
2cd52b492a65b60723473748912110b24f05b29c...88f1f5bba637b11673ce7a5a5b5361ceab821e0c,1,0,9,9,2,2011-10-14 13:41:35,2011-10-14 13:41:35
88f1f5bba637b11673ce7a5a5b5361ceab821e0c...da0b50f8ec8a310479f646ea250b820f0b88685a,1,0,3,3,2,2011-10-14 13:42:10,2011-10-14 13:42:10
da0b50f8ec8a310479f646ea250b820f0b88685a...4fe65eb4bc4c939788c6b3f010e70cd008705dff,1,6,0,6,1,2011-10-14 13:56:21,2011-10-14 13:56:21
4fe65eb4bc4c939788c6b3f010e70cd008705dff...a136247fea5ef65a697b1551b3d281d97387f3ef,2,2,5,7,3,2011-10-14 14:01:59,2011-10-14 14:01:59
a136247fea5ef65a697b1551b3d281d97387f3ef...6a60365fedffda4ee51e6f717c2b8a57da8f315a,1,3,2,5,2,2011-10-14 14:13:24,2011-10-14 14:13:24
6a60365fedffda4ee51e6f717c2b8a57da8f315a...912a383d9b610701ab515e0a08e588da9648304d,2,0,9,9,4,2011-10-14 14:26:35,2011-10-14 14:26:35
912a383d9b610701ab515e0a08e588da9648304d...fc34fc86c6ac5bfd2312cdd404938cabf4c468d2,5,26,0,26,6,2011-10-14 15:08:25,2011-10-14 15:08:25
fc34fc86c6ac5bfd2312cdd404938cabf4c468d2...2d577cae9d71e8f293b87f5b6de04c3f130ecd22,4,19,17,36,4,2011-10-14 15:33:05,2011-10-14 15:33:05
2d577cae9d71e8f293b87f5b6de04c3f130ecd22...153f6cd86bff0f78abbee07feec6832b73535298,7,36,50,86,22,2011-10-14 16:30:31,2011-10-14 16:30:31
153f6cd86bff0f78abbee07feec6832b73535298...5f8255ac67e26d8d7dc98cff37ecae5eab4ab3cf,4,40,2,42,4,2011-10-14 19:43:25,2011-10-14 19:43:25
5f8255ac67e26d8d7dc98cff37ecae5eab4ab3cf...53421e060a3b96a63206d39205193bfdea0eeaba,7,60,88,148,22,2011-10-14 21:05:41,2011-10-14 21:05:41
53421e060a3b96a63206d39205193bfdea0eeaba...3208b6747d221068082220208fe4d0bda7a0b688,4,3,5,8,4,2011-10-14 21:12:02,2011-10-14 21:12:02
3208b6747d221068082220208fe4d0bda7a0b688...4e063deaa95f6d923420c1548bfb73f9be4131c8,2,6,1,7,2,2011-10-14 21:21:28,2011-10-14 21:21:28
ef2bf1520489a23ff64224c3e102a03b46243dbf...4d37329c732b394dd521a6568be6b7a5b4c3bd68,1,8,5,13,3,2011-10-17 05:53:30,2011-10-17 05:53:30
4d37329c732b394dd521a6568be6b7a5b4c3bd68...a39d0431cb2dec082cd5353f3c212833e49b3490,1,1,1,2,1,2011-10-17 22:35:25,2011-10-17 22:35:25
4e063deaa95f6d923420c1548bfb73f9be4131c8...dd833d28ad91498070b4c72243c57022f4513544,16,59,16,75,19,2011-10-15 16:56:53,2011-10-15 16:56:53
dd833d28ad91498070b4c72243c57022f4513544...df016465cdce1bab78536e7f8faa63f5eace718e,1,1,1,2,1,2011-10-15 17:13:51,2011-10-15 17:13:51
df016465cdce1bab78536e7f8faa63f5eace718e...e6bba9be4f0400471170e9d86f3ef15344416f2f,4,13,1,14,3,2011-10-15 17:41:38,2011-10-15 17:41:38
4e063deaa95f6d923420c1548bfb73f9be4131c8...a9d224d36db59446f944c29a10725a85ebda3c5d,3,8,1,9,4,2011-10-15 15:51:58,2011-10-15 15:51:58
a9d224d36db59446f944c29a10725a85ebda3c5d...29158ea38c74f23ff570c6ac4c90725624cb0dcd,1,9,4,13,1,2011-10-15 15:57:27,2011-10-15 15:57:27
29158ea38c74f23ff570c6ac4c90725624cb0dcd...57baa49bc3c71cc8084d925415e44ad1b8ad73a9,5,9,10,19,8,2011-10-15 16:30:56,2011-10-15 16:30:56
57baa49bc3c71cc8084d925415e44ad1b8ad73a9...876ebbd9ad6f3b3f5ac0774b3005c15d7a7a5d4e,3,3,3,6,3,2011-10-15 16:46:27,2011-10-15 16:46:27
876ebbd9ad6f3b3f5ac0774b3005c15d7a7a5d4e...c37492b5dcd8188bc2f738e7a8994855926a2d83,1,5,4,9,3,2011-10-15 17:37:42,2011-10-15 17:37:42
757ea634665e475bf69c1ec962040a0511ee8aeb...c374eb80ff9fb71d37faffc15714bf98b632d3e5,1,1,1,2,1,2011-10-18 11:13:57,2011-10-18 11:13:57
99777cab2a64a94cc6798a6f1ac562850bc08172...526ad466c86e69c3447c192d8cae8da653556058,1,1,1,2,1,2011-10-15 18:08:38,2011-10-15 18:08:38
526ad466c86e69c3447c192d8cae8da653556058...9265de3d25715aeafd38a4ef41596dca058dc18c,28,366,8,374,33,2011-10-16 21:07:10,2011-10-16 21:07:10
9265de3d25715aeafd38a4ef41596dca058dc18c...bcf55312f7e59704b57f2cc4ef7893f55ffab770,4,10,3,13,4,2011-10-16 21:30:48,2011-10-16 21:30:48
bcf55312f7e59704b57f2cc4ef7893f55ffab770...8c8892460678471db1fce5129a0c2c7dd18f3b38,1,4,2,6,3,2011-10-16 22:14:48,2011-10-16 22:14:48
8c8892460678471db1fce5129a0c2c7dd18f3b38...b08e4074b49acdb00dc9e041dab65a11462a090c,2,18,1,19,6,2011-10-17 08:34:53,2011-10-17 08:34:53
b08e4074b49acdb00dc9e041dab65a11462a090c...783ca8979652085e2708cf3e020f3f83349dedb2,9,74,26,100,21,2011-10-17 10:39:03,2011-10-17 10:39:03
783ca8979652085e2708cf3e020f3f83349dedb2...d03f2687c596b5a2453e0e27918dd0628682a785,4,30,0,30,4,2011-10-17 15:31:21,2011-10-17 15:31:21
d03f2687c596b5a2453e0e27918dd0628682a785...8a8e77d54f558e5f8edf9cbe9076b5189323abf5,2,27,5,32,7,2011-10-17 15:45:31,2011-10-17 15:45:31
8a8e77d54f558e5f8edf9cbe9076b5189323abf5...74a89d9ed6e79d6172ac2638a334bb31b9fea7da,4,17,4,21,6,2011-10-17 16:48:10,2011-10-17 16:48:10
74a89d9ed6e79d6172ac2638a334bb31b9fea7da...2daa6161fd08e18bdf7f1ad0f30a83a58226543e,3,13,1,14,3,2011-10-17 17:05:47,2011-10-17 17:05:47
2daa6161fd08e18bdf7f1ad0f30a83a58226543e...5a5845e4908895ecb8ad60bfc964eaeecdcc43b2,3,10,9,19,3,2011-10-18 08:21:44,2011-10-18 08:21:44
5a5845e4908895ecb8ad60bfc964eaeecdcc43b2...c29b49de668c4f6adc271516242249a9cec6e223,5,69,13,82,7,2011-10-18 11:33:30,2011-10-18 11:33:30
c29b49de668c4f6adc271516242249a9cec6e223...f8e17667142dbb2e8939c3980899cc8088650637,1,0,0,0,0,2011-10-18 11:34:48,2011-10-18 11:34:48
f8e17667142dbb2e8939c3980899cc8088650637...fc177a30f7beeeecf0e97863b8e2293b75928304,1,1,1,2,1,2011-10-18 11:38:57,2011-10-18 11:38:57
fc177a30f7beeeecf0e97863b8e2293b75928304...b0f216ba17434250baf387bb3c5878bce0571306,1,5,1,6,1,2011-10-18 11:55:51,2011-10-18 11:55:51
b0f216ba17434250baf387bb3c5878bce0571306...dbd69d1d0e1c084f79f6955828c1dc4a63a7908c,1,0,2,2,1,2011-10-18 12:02:05,2011-10-18 12:02:05
dbd69d1d0e1c084f79f6955828c1dc4a63a7908c...1a03b17ab5055babaf006c99306f7c27b6e2ddaa,7,120,51,171,14,2011-10-18 14:44:43,2011-10-18 14:44:43
1a03b17ab5055babaf006c99306f7c27b6e2ddaa...f8b5e5f78ebcd7f37a0dbfb299e96d918d9c40fa,2,23,18,41,5,2011-10-18 14:57:01,2011-10-18 14:57:01
f8b5e5f78ebcd7f37a0dbfb299e96d918d9c40fa...85265b1bac7aef97613c96e76bb01a0d27d60a77,1,1,1,2,1,2011-10-18 20:22:04,2011-10-18 20:22:04
3a2b273316fb29d63b489906f85d9b5329377258...6b030fd41d697e327d2935b406cba70b6a460504,83,1090,137,1227,155,2011-10-21 17:04:41,2011-10-21 17:04:41
6b030fd41d697e327d2935b406cba70b6a460504...ba8048d71019b5aaa1f92ee5c3415bfddaa9babb,15,141,147,288,37,2011-10-22 13:07:26,2011-10-22 13:07:26
ba8048d71019b5aaa1f92ee5c3415bfddaa9babb...016012b14598f65aedec6f859bc47da7b7311ae7,10,24,20,44,13,2011-10-24 19:47:53,2011-10-24 19:47:53
016012b14598f65aedec6f859bc47da7b7311ae7...1d69788099f4c28c8b6795cacc9a1ffaa8600ee0,15,99,21,120,25,2011-10-25 16:23:39,2011-10-25 16:23:39
1d69788099f4c28c8b6795cacc9a1ffaa8600ee0...23187d60c4eb3eb2d51459ab18fd16da9caa5b58,1,10,4,14,2,2011-10-25 18:07:39,2011-10-25 18:07:39
85265b1bac7aef97613c96e76bb01a0d27d60a77...69e0ea626540a18866b58944ae230f4278e91ab6,4,39,13,52,13,2011-10-19 13:25:32,2011-10-19 13:25:22
69e0ea626540a18866b58944ae230f4278e91ab6...9ad444f02efbeb30365cdf7f23f9b2f846b45a03,5,31,6,37,11,2011-10-19 17:41:14,2011-10-19 17:41:14
9ad444f02efbeb30365cdf7f23f9b2f846b45a03...59704f481e742710fff32c733047eb84478e505e,10,93,4,97,14,2011-10-19 22:34:05,2011-10-19 22:34:05
b8ca1d62c453fcdb8cb7f65ee793fcd159b4c336...121f6d04faedad570e6ce1d8d7e235b55c2a9048,2,0,0,0,0,2011-11-06 19:12:23,2011-11-06 19:12:23
59704f481e742710fff32c733047eb84478e505e...48924dfeeafbe965ec06797b10010ebd8a5dcfcd,12,89,36,125,24,2011-10-20 16:21:58,2011-10-20 16:21:58
59704f481e742710fff32c733047eb84478e505e...0f0c562de09e325c5689b3db8e646b68322f5515,1,6,1,7,2,2011-10-20 13:48:09,2011-10-20 13:48:09
0955863489ee449389ec08afb498803bc6fbb59e...92f6de03703cb64fb5758c629a83522287af2d19,3,61,20,81,16,2011-10-26 00:15:11,2011-10-26 00:15:11
92f6de03703cb64fb5758c629a83522287af2d19...7d773ecb40c9309d888c5e09814f5fbf7df67a11,2,0,3,3,3,2011-10-26 00:15:59,2011-10-26 00:15:59
7d773ecb40c9309d888c5e09814f5fbf7df67a11...fb01f45890da1883d622b4550af2bf997c029764,3,49,30,79,5,2011-10-26 04:34:02,2011-10-26 04:34:02
fb01f45890da1883d622b4550af2bf997c029764...1beb84161c80eec8c5df2ca3888409143f25a8e0,1,4,1,5,2,2011-10-26 04:44:02,2011-10-26 04:44:02
48924dfeeafbe965ec06797b10010ebd8a5dcfcd...cee932500caf2d903e08f063772c570db4158925,7,58,8,66,8,2011-10-21 12:56:37,2011-10-21 12:56:37
48924dfeeafbe965ec06797b10010ebd8a5dcfcd...c463eeb0908e5c00008073c07e71e06434393342,7,66,37,103,17,2011-10-20 19:00:00,2011-10-20 19:00:00
ce9b8e7b12c61732cc181894e9b4f7dbab1f22a5...ecd462a606b1f9fc36a46daea95d09eddddd9e89,2,29,25,54,10,2011-10-21 19:44:08,2011-10-21 19:44:08
7066444fdabf8f1f151bb590f6513e34ce12a214...4dbed7ca88c2fe8f127deb752f82a5ee9ab4cade,2,38,1,39,3,2011-11-09 14:15:21,2011-11-09 14:15:21
7066444fdabf8f1f151bb590f6513e34ce12a214...1d30877a68291ebd46fd995398394be6e7724141,1,1,1,2,2,2011-11-09 13:29:09,2011-11-09 13:29:09
1beb84161c80eec8c5df2ca3888409143f25a8e0...d64f23e29419c92c36a0f64917563336ed6012e3,5,19,89,108,19,2011-10-27 13:44:29,2011-10-27 13:44:29
1beb84161c80eec8c5df2ca3888409143f25a8e0...e0f4a37f3d9fba676c60d28677dfd1d7c9dfd5ac,1,5,0,5,1,2011-10-26 18:22:42,2011-10-26 18:22:42
dde2879589f8e86fdc614a64512cec971d8d8606...86021a7dc397923afaf09d7602c34182f8064efe,1,7,3,10,1,2011-10-21 13:36:33,2011-10-21 13:36:33
c463eeb0908e5c00008073c07e71e06434393342...b5a5e5a416a33147e99be2e8c07e2bcc7fb7ee6c,3,5,3,8,3,2011-10-21 06:58:28,2011-10-21 06:58:28
b5a5e5a416a33147e99be2e8c07e2bcc7fb7ee6c...a07923a549d53527442967aac9c4baf9596f3c1f,6,55,22,77,11,2011-10-21 11:03:34,2011-10-21 11:03:34
a07923a549d53527442967aac9c4baf9596f3c1f...f2808191893d2d3f158f569627ac6005509ea05b,1,8,9,17,2,2011-10-21 11:25:42,2011-10-21 11:25:42
f2808191893d2d3f158f569627ac6005509ea05b...1477a6c8aaecbde1f2b5903cccb267d632212ee4,7,21,17,38,15,2011-10-21 12:35:42,2011-10-21 12:35:42
c463eeb0908e5c00008073c07e71e06434393342...da48ca58914264cd58cf5e3863e9256d61b00d6a,2,3,1,4,2,2011-10-20 21:52:49,2011-10-20 21:52:49
da48ca58914264cd58cf5e3863e9256d61b00d6a...6d6eefa0e201953818592962b723c3ee4e5d0c5a,1,1,1,2,1,2011-10-22 10:50:02,2011-10-22 10:50:02
6d6eefa0e201953818592962b723c3ee4e5d0c5a...c7ccfb9a9d639ab172beaa319db09b343c65168f,1,1,1,2,1,2011-10-22 11:07:09,2011-10-22 11:07:09
c7ccfb9a9d639ab172beaa319db09b343c65168f...c66c30c821a77309302560667692854b2caabb8d,1,6,1,7,2,2011-10-22 11:08:02,2011-10-20 13:48:09
c66c30c821a77309302560667692854b2caabb8d...977fe7307320ccd7613ea97823b68ab356ebbe60,3,5,3,8,3,2011-10-22 11:08:02,2011-10-21 06:58:28
977fe7307320ccd7613ea97823b68ab356ebbe60...24f04c0a6154c6d5890642fb8a8ec16b44146547,6,55,22,77,11,2011-10-22 11:08:02,2011-10-21 11:03:34
24f04c0a6154c6d5890642fb8a8ec16b44146547...d49645a01348e093b87586b3575e93233d497aea,1,8,9,17,2,2011-10-22 11:08:03,2011-10-21 11:25:42
d49645a01348e093b87586b3575e93233d497aea...b3279b9b5170a19a2aa504eae94a9a8be5908755,7,21,17,38,15,2011-10-22 11:08:03,2011-10-21 12:35:42
b3279b9b5170a19a2aa504eae94a9a8be5908755...9fa4df16ec8f8317c83371c5768c30e276e49ae9,7,58,8,66,8,2011-10-22 11:08:03,2011-10-21 12:56:37
9fa4df16ec8f8317c83371c5768c30e276e49ae9...1c2660729003932183ec6c7973e4ee15192f99d7,1,7,3,10,1,2011-10-22 11:08:03,2011-10-21 13:36:33
1c2660729003932183ec6c7973e4ee15192f99d7...35d24b3928a0905d23e8e33bbc9a89d33fa0a480,5,23,80,103,10,2011-10-22 11:08:03,2011-10-21 17:58:04
35d24b3928a0905d23e8e33bbc9a89d33fa0a480...29e11d1461a5689ff295adb035e38564701ad377,1,2,1,3,1,2011-10-22 11:08:03,2011-10-21 18:14:55
29e11d1461a5689ff295adb035e38564701ad377...1a9531c9a42e380d922de98ad1658e85ac5fbde6,5,59,38,97,9,2011-10-22 11:08:03,2011-10-21 18:40:36
1a9531c9a42e380d922de98ad1658e85ac5fbde6...72d15cc7caf7e457a578d13b496b6b461487f1fc,2,10,2,12,3,2011-10-22 11:08:03,2011-10-21 18:51:55
72d15cc7caf7e457a578d13b496b6b461487f1fc...00290b9214e4dc4688e93c04489a7551da697ee6,2,29,25,54,10,2011-10-22 11:08:03,2011-10-21 19:44:08
c3ad589499edbba4988d5387ecf7719420b35eee...edeb20e95bd26a08b10f211b33fb5bedce9b9957,1,13,2,15,3,2011-10-22 11:48:10,2011-10-22 11:48:10
edeb20e95bd26a08b10f211b33fb5bedce9b9957...61e6751ea676d23f5ef88de6d0bf9c273f785516,2,6,6,12,5,2011-10-23 09:40:33,2011-10-23 07:17:57
61e6751ea676d23f5ef88de6d0bf9c273f785516...5baa5fad0a1c6e2b8790f07f62c088fd505406d9,8,18,14,32,8,2011-10-24 19:38:03,2011-10-24 19:38:03
5baa5fad0a1c6e2b8790f07f62c088fd505406d9...afe98ae74ab13d11908e74ada1d10dccc333228b,7,15,11,26,8,2011-10-25 04:32:02,2011-10-25 04:32:02
afe98ae74ab13d11908e74ada1d10dccc333228b...9afee5ad5298dc4c89ec74c5fda44adfc91de1b2,8,84,10,94,17,2011-10-25 04:34:02,2011-10-25 04:34:02
9afee5ad5298dc4c89ec74c5fda44adfc91de1b2...f6a67fbad5119e3d95e33cfd4f4e4992707d5ba0,1,10,4,14,2,2011-10-25 18:04:31,2011-10-25 18:04:31
6e7e01c779352606d9fb8b65b17bae8d097ba903...4454b6c593e51c5f23a7d391eb6a1f46aaa6bb45,1,6,3,9,3,2011-11-09 15:59:51,2011-11-09 15:59:51
84457708d8704f23de6a974a8dce0995ce0d03ea...e41bc4dd508666fd8e019a4dc12825e23128a00b,1,1,0,1,1,2011-10-27 13:50:35,2011-10-27 13:50:35
e41bc4dd508666fd8e019a4dc12825e23128a00b...5fe736ab2847a5fd7f85363197e3ae0cbfd959e1,1,1,1,2,1,2011-10-27 14:08:40,2011-10-27 14:08:40
5fe736ab2847a5fd7f85363197e3ae0cbfd959e1...9611a27e0ca7e800d978d7355dbfb896f6f6cd2c,4,12,4,16,5,2011-10-27 14:33:20,2011-10-27 14:33:20
9611a27e0ca7e800d978d7355dbfb896f6f6cd2c...f4e7ad7a4b8f188419104995e7b6346149ab31ab,2,2,2,4,2,2011-10-27 14:41:10,2011-10-27 14:41:10
f1e6d9be90c9f02ecbb334900e34f9a2a15c4530...38cdb3eba0d59f7ffc7fdbb4ca808e759fba504b,2,7,3,10,3,2011-10-26 21:23:04,2011-10-26 21:23:04
86021a7dc397923afaf09d7602c34182f8064efe...5b284f6adf4cf17ffb66b32a5afdb2f754d5ad5f,7,61,11,72,11,2011-10-22 04:06:38,2011-10-22 04:06:38
86021a7dc397923afaf09d7602c34182f8064efe...6d0175e1f641415574a8fc48909af2cb3a357882,5,23,80,103,10,2011-10-21 17:58:04,2011-10-21 17:58:04
6d0175e1f641415574a8fc48909af2cb3a357882...32f4dc7cf917d152d703e338219d1c718b97a003,1,2,1,3,1,2011-10-21 18:14:55,2011-10-21 18:14:55
32f4dc7cf917d152d703e338219d1c718b97a003...e7570250afd88934d8435678b5c618d3ac202d17,5,59,38,97,9,2011-10-21 18:40:36,2011-10-21 18:40:36
e7570250afd88934d8435678b5c618d3ac202d17...421b11158d8420b3fe337b63d5686c24b5644c94,2,10,2,12,3,2011-10-21 18:51:55,2011-10-21 18:51:55
f6a67fbad5119e3d95e33cfd4f4e4992707d5ba0...fb40d27d1e8be0b516e3cf101995b54052872f97,2,2,2,4,2,2011-10-28 08:34:30,2011-10-28 08:34:30
f6a67fbad5119e3d95e33cfd4f4e4992707d5ba0...d62200cad430565bd9f80befaf329297120330b5,112,1408,1437,2845,492,2011-10-26 13:46:25,2011-10-26 13:46:25
d62200cad430565bd9f80befaf329297120330b5...3228b62755ed746a88b076c5846ca5d6bdbf94fb,1,1,1,2,1,2011-10-26 17:17:46,2011-10-26 17:17:46
3228b62755ed746a88b076c5846ca5d6bdbf94fb...f1e25f25635c64f1c994d01c90a8e50c8be1f81f,7,5,0,5,3,2011-10-26 17:42:24,2011-10-26 17:42:24
f4e7ad7a4b8f188419104995e7b6346149ab31ab...2258db66c2e8ddccc1716b92f9d9a3a1cb3eff7f,3,11,2,13,4,2011-10-27 15:18:50,2011-10-27 15:18:50
2258db66c2e8ddccc1716b92f9d9a3a1cb3eff7f...56d9761844b2665e9e48d50f15f7ac3a63d60618,5,21,14,35,6,2011-10-27 15:46:30,2011-10-27 15:46:30
56d9761844b2665e9e48d50f15f7ac3a63d60618...a0171813391c8226802621a710798e376fea2f1e,8,60,10,70,12,2011-10-28 09:22:09,2011-10-28 09:22:09
38cdb3eba0d59f7ffc7fdbb4ca808e759fba504b...117d1e90fdef3aaf64901ba18a5ce5bab4c668d8,2,7,1,8,3,2011-10-27 05:20:45,2011-10-27 05:20:45
117d1e90fdef3aaf64901ba18a5ce5bab4c668d8...8e1e17763f169f63dc99c7a0f109fe98c87b4064,5,50,29,79,9,2011-10-27 06:46:21,2011-10-27 06:46:21
8e1e17763f169f63dc99c7a0f109fe98c87b4064...de4e859928d22a44549ebb719bbfd669f630f1b1,2,4,1,5,4,2011-10-27 06:50:14,2011-10-27 06:50:14
de4e859928d22a44549ebb719bbfd669f630f1b1...5e584ee6264962cc60d9074c33141a28b4100607,2,5,5,10,3,2011-10-27 07:11:42,2011-10-27 07:11:42
5e584ee6264962cc60d9074c33141a28b4100607...000c032482dbe2fe882f3b2583fe1a481edf460a,2,3,1,4,2,2011-10-27 07:14:50,2011-10-27 07:14:50
000c032482dbe2fe882f3b2583fe1a481edf460a...325b84545ca09911df0bf80a7233b339aba755ed,2,2,1,3,2,2011-10-27 08:12:12,2011-10-27 08:12:12
325b84545ca09911df0bf80a7233b339aba755ed...01f72bfa83ef05817c2e9898a62ae09919a6d505,2,1,4,5,4,2011-10-27 18:35:16,2011-10-27 18:35:16
01f72bfa83ef05817c2e9898a62ae09919a6d505...b6cdd1c819b4a43cd00dfdc9dbffc1490593a8b5,4,11,1,12,4,2011-10-27 19:25:50,2011-10-27 19:25:50
f1e25f25635c64f1c994d01c90a8e50c8be1f81f...2801589c41c393bd9849c4b86c051a7ebfbfd7d7,1,0,1,1,1,2011-10-27 09:47:06,2011-10-27 09:47:06
2801589c41c393bd9849c4b86c051a7ebfbfd7d7...be364d1004ca80f94d9203b25eca285a623758af,14,16,16,32,8,2011-10-27 09:47:56,2011-10-27 09:47:56
89fa800e28e4b740b9de2e526f0f4354d8310ecb...e92669fb2d60e4bb331e67d9bfd17a5266152a65,2,4,1,5,4,2011-10-27 19:37:17,2011-10-27 19:37:17
e92669fb2d60e4bb331e67d9bfd17a5266152a65...6c7706eb17cff08ba0c3cccc3ebcfc969ae0f6e3,1,1,1,2,1,2011-10-27 19:57:10,2011-10-27 19:57:10
6c7706eb17cff08ba0c3cccc3ebcfc969ae0f6e3...1f3323f9088b897220dc4989ac8da0ef71001ce1,3,6,2,8,3,2011-10-30 13:41:57,2011-10-30 13:41:57
3fa770dd107d01c29741032703c3f69b9ff3f072...1ffb4b98c0405ee4c8bafaf9b67f1fc49493fbbc,12,605,43,648,12,2011-10-28 11:41:39,2011-10-28 11:41:39
1ffb4b98c0405ee4c8bafaf9b67f1fc49493fbbc...487ae906a948e72429c60a1b5abe9508ed516a32,5,71,9,80,9,2011-10-28 12:07:58,2011-10-28 12:07:58
487ae906a948e72429c60a1b5abe9508ed516a32...5d879a06433df6849e8c332e65bafdd8a1948ff0,4,38,19,57,6,2011-10-28 15:25:00,2011-10-28 15:25:00
5d879a06433df6849e8c332e65bafdd8a1948ff0...0dc5364aecc11158d72465231944267f243bab79,2,10,17,27,2,2011-10-28 15:29:52,2011-10-28 15:29:52
0dc5364aecc11158d72465231944267f243bab79...3becd06423ac584ab3f5a70284984dd21ba32697,8,124,163,287,13,2011-10-31 10:11:22,2011-10-31 10:11:22
be364d1004ca80f94d9203b25eca285a623758af...2db09ada72d7c27e494c73da35f09915659a24cd,1,3,0,3,1,2011-10-27 11:14:46,2011-10-27 11:14:46
1f3323f9088b897220dc4989ac8da0ef71001ce1...31280cd4cb733d25f2644788931e498eca86c477,1,1,1,2,1,2011-10-31 09:47:10,2011-10-31 09:47:10
fb33ccd87f742db0a8e6e5d106ebc98d07124e70...9bf39477dec99eacda9443e39a631d5b5a11eef6,4,18,19,37,10,2011-10-31 10:30:53,2011-10-31 10:30:53
9bf39477dec99eacda9443e39a631d5b5a11eef6...d405292388c642117c8300a0a4931fc9a4eb1f66,6,245,66,311,29,2011-11-01 09:00:59,2011-11-01 09:00:59
d405292388c642117c8300a0a4931fc9a4eb1f66...0903932320073e3e5120faae523e00a94709a95a,4,28,25,53,5,2011-11-01 09:22:16,2011-11-01 09:22:16
0903932320073e3e5120faae523e00a94709a95a...84397ce88c09d30e14fef5d8e6a6e559ae0dcb7c,4,29,73,102,10,2011-11-01 10:48:26,2011-11-01 10:48:26
84397ce88c09d30e14fef5d8e6a6e559ae0dcb7c...e8d10b321716154421a0642e4d9f48d00c3aa56b,3,17,4,21,5,2011-11-01 11:17:36,2011-11-01 11:17:36
fd7de95bce9bb9b1e728f56d550660b85085f219...786fe29db4cd884ad0735d7ac2455975aff11ae8,1,1,1,2,2,2011-11-09 18:50:58,2011-11-09 13:29:09
786fe29db4cd884ad0735d7ac2455975aff11ae8...85468fb4ce47633a5996104c87d03eaa2cc0031e,2,38,1,39,3,2011-11-09 18:51:22,2011-11-09 14:15:21
85468fb4ce47633a5996104c87d03eaa2cc0031e...e608eacc4bbbaf7c2b3bd81d3ef8a24da3df03be,1,6,3,9,3,2011-11-09 18:52:20,2011-11-09 15:59:51
e608eacc4bbbaf7c2b3bd81d3ef8a24da3df03be...eb96336de1f8fa44d8c74567ce35c9f8a7069d23,3,30,21,51,5,2011-11-09 19:26:24,2011-11-09 19:26:24
eb96336de1f8fa44d8c74567ce35c9f8a7069d23...9a5f328313a85142af669b6745825e3e2c7b3005,2,19,0,19,2,2011-11-10 07:46:04,2011-11-10 07:46:04
31280cd4cb733d25f2644788931e498eca86c477...3f24f54061c728a75a1928a85e837e182d79f25f,3,5,0,5,4,2011-10-31 12:20:41,2011-10-31 12:20:41
3f24f54061c728a75a1928a85e837e182d79f25f...43c1039957f096c511f33cce05f988d4e108a0ff,1,3,1,4,1,2011-10-31 12:49:38,2011-10-31 12:49:38
43c1039957f096c511f33cce05f988d4e108a0ff...11b70c97e3a49b6e6235f67452d56612fc141542,1,2,4,6,1,2011-10-31 19:21:28,2011-10-31 19:21:28
ded7d08d70348b7ad75699e438a2f91377c20cd7...3e95a6d73bb0817ec6869a5285d2e569d335e91b,2,11,6,17,5,2011-10-31 13:34:22,2011-10-31 13:34:22
babd0557cb5ca874769b5b83fd9298a6efabb2ef...82d16ccfd189f5bdc65090ac7af1d4eef1f1774e,7,104,48,152,12,2011-11-01 20:11:24,2011-11-01 20:11:24
82d16ccfd189f5bdc65090ac7af1d4eef1f1774e...5e12f10c142ca5add14e5c752cf9ef6d88c4dfd8,6,81,41,122,16,2011-11-01 20:51:20,2011-11-01 20:51:20
9a5f328313a85142af669b6745825e3e2c7b3005...f7756b8404046fc0d0db2aa5e2b05c17cf16fba8,1,0,0,0,0,2011-11-10 08:24:11,2011-11-10 08:24:11
267bd6068c7a57316ef357f9385e12fea6c8d69f...485c5199b7ea01b85bdacb15a41bcfb18451597c,7,73,4,77,10,2011-10-31 20:57:16,2011-10-31 20:57:16
5e12f10c142ca5add14e5c752cf9ef6d88c4dfd8...5fb1b9ffe359fd6c13dfb427aa23c985dff87fe1,15,67,20,87,15,2011-11-02 15:21:17,2011-11-02 15:21:17
6376fd357b21b4525824c4340c3261391c77d314...ff0dc87e3d9db87dc9a8bbc24ed3d9bca10b2590,2,4,4,8,4,2011-11-10 21:15:47,2011-11-10 21:15:47
e9b22a2defea153030ab12b1ad15811ccc385580...a6fa80529a3df5e3de8e67f28cf6357d107e365c,1,2,0,2,1,2011-11-01 22:19:29,2011-11-01 22:19:29
83c1194d5220cd0e21569a9b255bf813eab69c86...020e1a8eee37e6a0acba9833f8abb5dfc80eb248,7,115,22,137,14,2011-11-02 20:14:03,2011-11-02 20:14:03
ff0dc87e3d9db87dc9a8bbc24ed3d9bca10b2590...56e449df50089d972a6af3c59f10c78d2ca0902a,2,37,11,48,11,2011-11-10 21:55:55,2011-11-10 21:55:55
ff0dc87e3d9db87dc9a8bbc24ed3d9bca10b2590...e56420aebf4db32cdf878f96e9ba94587156f3bd,2,8,1,9,2,2011-11-10 21:40:46,2011-11-10 21:40:46
020e1a8eee37e6a0acba9833f8abb5dfc80eb248...3abd977822247581465ff6d6df52d2c08e8da508,6,24,6,30,8,2011-11-03 10:56:26,2011-11-03 10:56:26
3abd977822247581465ff6d6df52d2c08e8da508...5c9cb850fcfb7aef6fc595210a11be71c364b2ba,1,1,1,2,1,2011-11-03 11:00:16,2011-11-03 11:00:16
e99b98ab0343cb957b370de927ca8bfa8a7df389...1155f2d1d221be3a04b9eeba9037617915efcdd4,1,2,2,4,2,2011-11-10 21:57:47,2011-11-10 21:57:47
1155f2d1d221be3a04b9eeba9037617915efcdd4...4ecf17cf9a81c6576244cd1bd8f1751ac30dc296,4,4,2,6,4,2011-11-10 22:08:20,2011-11-10 22:08:20
4ecf17cf9a81c6576244cd1bd8f1751ac30dc296...60a9c051db3dc8dfe968932a6163830a6afa142f,1,0,1,1,1,2011-11-10 22:22:04,2011-11-10 22:22:04
60a9c051db3dc8dfe968932a6163830a6afa142f...88466881b8eb2499dd3758e85f261b3281095fd6,2,15,8,23,4,2011-11-10 22:24:44,2011-11-10 22:24:44
88466881b8eb2499dd3758e85f261b3281095fd6...99bd00158c49360cf6193118772396d19111d9a0,2,18,35,53,5,2011-11-10 22:42:34,2011-11-10 22:42:34
5c9cb850fcfb7aef6fc595210a11be71c364b2ba...5f900772c2a5a1bc86d4e60e1d6b6128b609b96e,5,0,5,5,5,2011-11-03 14:36:02,2011-11-03 14:36:02
5f900772c2a5a1bc86d4e60e1d6b6128b609b96e...3ba392b3cb82a655a814e34759e678cdef94fdfa,9,1314,50,1364,14,2011-11-03 16:28:33,2011-11-03 16:28:33
99bd00158c49360cf6193118772396d19111d9a0...e2d0f42adfc71ca1689cc3a7e83c1930ebc05363,1,2,2,4,2,2011-11-10 23:42:01,2011-11-10 23:42:01
99bd00158c49360cf6193118772396d19111d9a0...dab072c1ab609917c3472ae663f1db49af75e56e,4,82,56,138,6,2011-11-10 22:51:33,2011-11-10 22:51:19
dab072c1ab609917c3472ae663f1db49af75e56e...d730e3ef8b1c9bf73f9eeb492968b455fbec319d,4,63,45,108,18,2011-11-10 23:28:26,2011-11-10 23:28:26
3ba392b3cb82a655a814e34759e678cdef94fdfa...5d526717d626c072b6eb522e132cc30d9d96d60b,1,1,1,2,1,2011-11-03 23:16:12,2011-11-03 23:16:12
3ba392b3cb82a655a814e34759e678cdef94fdfa...a9639776d7c52ca63c5ca7b86baf300b1a5e87e8,8,47,32,79,12,2011-11-03 22:37:02,2011-11-03 22:37:02
c0a30b3a0c67d2120a2489a4226b54d92616878f...e5852d41cf9e511c32f89353700eed2d811087b6,1,2,0,2,1,2011-11-11 00:00:22,2011-11-11 00:00:22
d730e3ef8b1c9bf73f9eeb492968b455fbec319d...594451563ccbbc8663884e2d5b6f3ac435a3baf7,4,50,19,69,10,2011-11-11 06:13:43,2011-11-11 06:13:43
5d526717d626c072b6eb522e132cc30d9d96d60b...6977150f04be1bfe365e1cd86e3f8143c34a51bf,6,212,0,212,7,2011-11-04 07:44:43,2011-11-04 07:42:36
6977150f04be1bfe365e1cd86e3f8143c34a51bf...b946da44695c9c8fe8867bb87bcdf801c52177d3,4,37,1,38,7,2011-11-04 08:11:14,2011-11-04 08:11:14
287c3c167b467933b9c3fba976d832bbae18c2b7...687290a00d71540ae809ae9ef172771ce7c46778,3,3,3,6,3,2011-11-04 07:46:58,2011-11-04 07:46:58
22bb925a40c99f76116c1cfcd47f978503b8b5dc...a5058229e4aed71530074b397a1a5f3290f3e4ae,2,2,4,6,3,2011-11-11 07:36:01,2011-11-11 07:36:01
a5058229e4aed71530074b397a1a5f3290f3e4ae...6f915d5a016e97ccb882d2fc8a53f2dc6b492088,1,6,2,8,1,2011-11-11 08:28:06,2011-11-11 08:28:06
6323cdda687283f956c1199f45eeb4340ab83464...1e5aa0effffa60cc5f5a953011cfb40a37b6a862,6,63,0,63,7,2011-11-05 12:57:40,2011-11-05 12:57:40
1e5aa0effffa60cc5f5a953011cfb40a37b6a862...6e08b5cc857b3b218df0b20745ad295e79abc722,10,62,24,86,16,2011-11-05 19:00:05,2011-11-05 19:00:05
6e08b5cc857b3b218df0b20745ad295e79abc722...62112dc0c7eae8d8c8e3d55fc13d3d58b7588899,3,21,16,37,4,2011-11-05 20:16:13,2011-11-05 20:16:13
687290a00d71540ae809ae9ef172771ce7c46778...ca1e3d05796484424057d071b726779537868384,10,110,74,184,19,2011-11-04 13:37:38,2011-11-04 13:37:38
ca1e3d05796484424057d071b726779537868384...8a23682fc5212918c931888bb7b468d167d19c33,11,56,53,109,18,2011-11-04 15:46:51,2011-11-04 15:46:51
8a23682fc5212918c931888bb7b468d167d19c33...2ed5211dad88dc0b0cccb1104ed2180192609950,1,0,10,10,1,2011-11-04 15:59:00,2011-11-04 15:59:00
2ed5211dad88dc0b0cccb1104ed2180192609950...0b0e0225adfc83ed951118b3c3e82167add9fd03,3,3,6,9,3,2011-11-04 16:20:52,2011-11-04 16:20:52
6f915d5a016e97ccb882d2fc8a53f2dc6b492088...a1fff682de99618298883742c8cdc169c03c623f,2,6,1,7,2,2011-11-11 23:30:42,2011-11-11 23:30:42
6f915d5a016e97ccb882d2fc8a53f2dc6b492088...03b9369007b01df74e1032a4eb958419f420d27d,1,1,1,2,1,2011-11-11 15:45:44,2011-11-11 15:45:44
03b9369007b01df74e1032a4eb958419f420d27d...97cf5659aaee3083925fa4f8d30efddb9becd271,2,6,6,12,5,2011-11-11 15:57:16,2011-11-11 15:57:16
97cf5659aaee3083925fa4f8d30efddb9becd271...c092f3972a45e0b83ec80f8ebfc39d488efcab9d,1,3,3,6,2,2011-11-11 16:04:32,2011-11-11 16:04:32
c092f3972a45e0b83ec80f8ebfc39d488efcab9d...49b2fb24bc0a06b41c6ff328f8a8c63b26921c31,6,7,26,33,11,2011-11-11 16:35:51,2011-11-11 16:35:51
49b2fb24bc0a06b41c6ff328f8a8c63b26921c31...d5da9d32b5167cc99073d81548ffb6e95d2cfbe3,1,1,1,2,1,2011-11-11 20:04:18,2011-11-11 20:04:18
0b0e0225adfc83ed951118b3c3e82167add9fd03...586c53ea0594a327b346c6fed38528a1f508c9e1,6,47,15,62,10,2011-11-05 11:59:43,2011-11-05 11:59:43
586c53ea0594a327b346c6fed38528a1f508c9e1...5eecbfdb10f97a216b585e7bddcbbd68f71f6ccc,7,68,14,82,10,2011-11-05 12:26:06,2011-11-05 12:26:06
5eecbfdb10f97a216b585e7bddcbbd68f71f6ccc...31a9d6531dcbfc72babf3da52d17cde61b4bcc04,2,9,22,31,8,2011-11-05 12:45:52,2011-11-05 12:45:52
31a9d6531dcbfc72babf3da52d17cde61b4bcc04...0499759204449a78ead1950c06fbab4dacfa84f2,6,38,58,96,21,2011-11-05 13:31:54,2011-11-05 13:31:54
9d913789803a04b76e0ad2cf5a35971f2218305e...48a1e31010f331db1ec0d7947bfb10b1b3c700ec,3,21,14,35,5,2011-11-12 10:41:34,2011-11-12 10:41:34
48a1e31010f331db1ec0d7947bfb10b1b3c700ec...de09e356934cb90546de7ebf1c4e721a31518235,1,6,4,10,2,2011-11-12 10:42:05,2011-11-12 10:42:05
de09e356934cb90546de7ebf1c4e721a31518235...60f4576d5d5dd42e99f4bfbaf51603d167d1d344,2,2,48,50,3,2011-11-12 10:50:25,2011-11-12 10:50:25
60f4576d5d5dd42e99f4bfbaf51603d167d1d344...ef088725341b2f202b7d33561d12efdf91b7f354,7,135,196,331,27,2011-11-12 11:04:43,2011-11-12 11:04:43
0499759204449a78ead1950c06fbab4dacfa84f2...671e261e900491ae29e118ac12f3ca9328109ab8,4,17,12,29,7,2011-11-06 13:52:23,2011-11-06 13:52:23
ef088725341b2f202b7d33561d12efdf91b7f354...6b66a766d1e534dbfb5735828d9f6d770732a19b,9,308,1,309,12,2011-11-12 22:30:51,2011-11-12 22:30:51
6b66a766d1e534dbfb5735828d9f6d770732a19b...94690bd2c4b30116aeee42fab5f97d5023ac750f,5,48,25,73,8,2011-11-13 11:58:45,2011-11-13 11:58:45
94690bd2c4b30116aeee42fab5f97d5023ac750f...c89682605ff36b9c7659ae204ebd08c7c9c7951c,2,6,8,14,5,2011-11-13 13:12:52,2011-11-13 13:12:52
c89682605ff36b9c7659ae204ebd08c7c9c7951c...dc844f013848ee1fa7721173bda3f3fc0ed0b8ba,2,6,10,16,4,2011-11-13 13:31:18,2011-11-13 13:31:18
ef088725341b2f202b7d33561d12efdf91b7f354...c1c64d985ec66433b9e990c5595997850727d8aa,7,141,221,362,33,2011-11-12 12:45:32,2011-11-12 12:45:32
c1c64d985ec66433b9e990c5595997850727d8aa...4dd5d9c8cce5c596a159277c464026cf0f50f1c4,8,25,7,32,10,2011-11-12 13:18:56,2011-11-12 13:18:56
4dd5d9c8cce5c596a159277c464026cf0f50f1c4...8786aff25a8e68e1dd6c50f3802eadb35908f151,6,45,67,112,9,2011-11-12 14:19:34,2011-11-12 14:19:34
8786aff25a8e68e1dd6c50f3802eadb35908f151...2f790001a029144f7a614d49a123cd1037f6398c,3,4,17,21,3,2011-11-12 14:28:14,2011-11-12 14:28:14
81847a9335722a616362ce7d51cee4fe94afe999...526752479d7a85596259fdee6f55cdefbbc3c1d6,1,17,15,32,2,2011-11-06 18:48:57,2011-11-06 18:48:21
526752479d7a85596259fdee6f55cdefbbc3c1d6...1d1b5186c3cbf85fb8f539b241ced29c314a3ff2,1,1,0,1,1,2011-11-06 19:43:34,2011-11-06 19:43:34
1608c87756c098e1e268580db725d0ff4cce322c...98fcd3b38a06ed889c84f54ab7e829659a5c1ce0,1,17,15,32,2,2011-11-06 18:48:21,2011-11-06 18:48:21
762946995ea9d477f00fea19e5040bf4dd437cb9...6b9f221a278ebe4a78f4f0b4d60f87659785595c,3,16,4,20,6,2011-11-15 09:09:07,2011-11-15 09:09:07
762946995ea9d477f00fea19e5040bf4dd437cb9...e2b4fe353803d4cd16bfd5e7e6796e1eb4a1d8c5,1,2,2,4,2,2011-11-14 08:15:26,2011-11-14 08:15:26
1d1b5186c3cbf85fb8f539b241ced29c314a3ff2...3fe9f3ebe6b89489fb5a022cb8afe6f63d33b529,3,15,5,20,7,2011-11-07 12:12:46,2011-11-07 12:12:46
1d1b5186c3cbf85fb8f539b241ced29c314a3ff2...f87f0201f0e3386d1e0408a217650b545f57029a,4,19,3,22,4,2011-11-06 20:21:48,2011-11-06 20:21:48
f87f0201f0e3386d1e0408a217650b545f57029a...b4868a897284940a3e5e8e6ebcc246f21fb17fbe,2,8,3,11,2,2011-11-06 20:38:08,2011-11-06 20:38:08
b4868a897284940a3e5e8e6ebcc246f21fb17fbe...e29a25662dac63c2f1ef0041eeb7b6fd24d3896e,1,23,23,46,1,2011-11-06 20:53:36,2011-11-06 20:53:36
ac9afe0d14fed7532fa243ff418e8fb52f938507...060a2e225755aedc99a8cdbc5fae8296daa7a958,3,7,2,9,3,2011-11-07 11:40:22,2011-11-07 11:40:22
060a2e225755aedc99a8cdbc5fae8296daa7a958...af7bed2aa5476ca6f359f0b0c67f46151b5db9b9,5,30,6,36,5,2011-11-07 17:48:58,2011-11-07 17:48:58
af7bed2aa5476ca6f359f0b0c67f46151b5db9b9...4a1b70f7b2d55bf26be35a2544e3b8e76bdc0585,3,48,34,82,6,2011-11-07 18:38:54,2011-11-07 18:38:54
bdd7980d7700a0c5d24e939717ab995391319978...ca1817f1ea505a29f6b3bc9fcb25ac84b3eb3568,1,4,0,4,1,2011-11-15 02:36:46,2011-11-15 02:36:46
8d74123d61e83c29b5449773e1c471d2e2aa126f...003bf61258ea20128315076936f09ea198e56bcb,5,19,7,26,11,2011-11-15 07:08:05,2011-11-15 07:08:05
003bf61258ea20128315076936f09ea198e56bcb...7b36b8d130561aa3f953962614e1774fa2603a11,4,23,2,25,5,2011-11-15 07:25:26,2011-11-15 07:25:26
7b36b8d130561aa3f953962614e1774fa2603a11...415eddaf39d7e1ffc4bf009d43a273614224909b,2,2,4,6,3,2011-11-15 08:13:59,2011-11-15 08:13:59
415eddaf39d7e1ffc4bf009d43a273614224909b...368deb5992f27fce9a23629229af4367ba38f901,50,356,413,769,195,2011-11-15 08:34:30,2011-11-15 08:34:30
368deb5992f27fce9a23629229af4367ba38f901...dd64b761c6ef4258212355f9ec776fc1c920daba,5,4,1,5,3,2011-11-15 08:45:15,2011-11-15 08:45:15
dd64b761c6ef4258212355f9ec776fc1c920daba...d63f04ab16dc07b4c82d495f59931610bdb7150b,1,2,4,6,1,2011-11-15 08:55:57,2011-11-15 08:55:57
e29a25662dac63c2f1ef0041eeb7b6fd24d3896e...7ac38b7a1ed401cfac6156f3efaa1bb6d7b67e43,1,4,2,6,1,2011-11-06 21:32:37,2011-11-06 21:32:37
7ac38b7a1ed401cfac6156f3efaa1bb6d7b67e43...06e916743ef3359e1eb098c3c50422ac594fe1c4,5,17,10,27,9,2011-11-06 22:24:09,2011-11-06 22:24:09
444b69ddc2382489dbd01304b605c3be5af75f28...9e3915b25948878d31de78c5ced43e288e0cadfe,1,1,1,2,1,2011-11-07 19:39:24,2011-11-07 19:39:24
9e3915b25948878d31de78c5ced43e288e0cadfe...1fa01cbcc9f8fb5a9dbf5974496d029f1d189cfc,1,1,1,2,1,2011-11-07 22:02:50,2011-11-07 22:02:50
32ca0b8cae4c4c871a0e6fb6add6749e33ec0f46...ed5e19a518ebe62aeb2db87c55a45854df2dcb37,5,33,1,34,5,2011-11-15 13:08:20,2011-11-15 13:08:20
ed5e19a518ebe62aeb2db87c55a45854df2dcb37...37346ead30e6f6c610643bb9a8dfa09a567b02a0,2,15,0,15,2,2011-11-15 13:42:01,2011-11-15 13:42:01
37346ead30e6f6c610643bb9a8dfa09a567b02a0...3538ae85003ead7cd2d425b74426dac2accaa72a,2,6,0,6,2,2011-11-15 13:51:43,2011-11-15 13:51:43
3538ae85003ead7cd2d425b74426dac2accaa72a...91045358a2b0eba6922bdbf9bfc65313e6f167ef,2,102,104,206,2,2011-11-15 14:41:33,2011-11-15 14:41:33
91045358a2b0eba6922bdbf9bfc65313e6f167ef...f294b8d4c3209689dde00326ca6270afa0b4843e,1,3,0,3,1,2011-11-15 15:47:24,2011-11-15 15:47:24
1d85197b08346c99e6015cb25b31f8fd10f4100f...a44e329222516573ae3a9c255801bd057ec2fd36,7,62,139,201,15,2011-11-08 23:56:10,2011-11-08 23:56:10
a44e329222516573ae3a9c255801bd057ec2fd36...b78f6581434b30f18e694e57c7427ad764fc26f4,3,27,21,48,6,2011-11-09 11:37:01,2011-11-09 11:37:01
b78f6581434b30f18e694e57c7427ad764fc26f4...3f70316c5f264948d74eb9080079be4c78f5aaa9,1,1,3,4,2,2011-11-09 13:53:15,2011-11-09 13:53:15
06e916743ef3359e1eb098c3c50422ac594fe1c4...eb5fa8344e573851fa1c84a262de84ab379b0e59,3,19,8,27,9,2011-11-07 18:21:42,2011-11-07 18:21:42
eb5fa8344e573851fa1c84a262de84ab379b0e59...9054f64c530625e5f6f555daf3f9d6a741c177bb,4,41,42,83,8,2011-11-07 18:37:32,2011-11-07 18:37:32
06e916743ef3359e1eb098c3c50422ac594fe1c4...c07d3dfc042fb795322d28523abd9628eccdf8f9,3,53,22,75,7,2011-11-07 15:55:16,2011-11-07 15:55:16
c07d3dfc042fb795322d28523abd9628eccdf8f9...60f083ad619731e1c959aa5ec15a0469a557b0da,4,32,53,85,8,2011-11-07 16:31:05,2011-11-07 16:31:05
60f083ad619731e1c959aa5ec15a0469a557b0da...67b9fa51dcdf3d5954b83f6f162763349d1e662a,4,4,1,5,4,2011-11-07 20:31:51,2011-11-07 20:31:51
f294b8d4c3209689dde00326ca6270afa0b4843e...7b5fd145157e1eae18d2721d75330404acc92963,4,10,14,24,5,2011-11-16 08:32:35,2011-11-16 08:32:35
f294b8d4c3209689dde00326ca6270afa0b4843e...af08ed6b66530b8efc68bf45e1f11599e333b826,16,96,79,175,30,2011-11-16 05:38:53,2011-11-16 05:38:53
af08ed6b66530b8efc68bf45e1f11599e333b826...a7734bba845e1079f7859f95f10be2c5b65cfded,3,20,22,42,14,2011-11-16 05:58:53,2011-11-16 05:58:53
3f70316c5f264948d74eb9080079be4c78f5aaa9...2b04c2a67fb981a1ef3491be4d7775de7f2a221d,4,37,2,39,6,2011-11-11 08:11:27,2011-11-11 08:11:27
2b04c2a67fb981a1ef3491be4d7775de7f2a221d...f295ff84d9597b60c985657aa03fc1ef1e087aa8,4,44,9,53,13,2011-11-11 09:29:58,2011-11-11 09:29:58
f295ff84d9597b60c985657aa03fc1ef1e087aa8...f476c42d00dbea1ddc0736bf991eeb36b9d5dd22,2,10,2,12,3,2011-11-11 09:35:02,2011-11-11 09:35:02
32abaa33f895f154aef126e7ea799aacdf8c6ee8...1c543bdfa8cb5698d173da57b055fd3006e591dc,2,6,4,10,3,2011-11-07 20:48:55,2011-11-07 20:48:55
1c543bdfa8cb5698d173da57b055fd3006e591dc...49bced3a24ec81d782296def8a3e864e781ef9dd,4,28,10,38,8,2011-11-08 17:23:13,2011-11-08 17:23:13
c4a575b70b3ee8a25023dd1b4eb2422c54f6b04d...930455f0655ab5e04a90ee108ad21ffcee31f947,1,2,2,4,1,2011-11-16 20:55:10,2011-11-16 20:55:10
930455f0655ab5e04a90ee108ad21ffcee31f947...459c9ba27d99f78b16107d0f19cc0c51b04a60c5,1,2,1,3,1,2011-11-16 21:13:14,2011-11-16 21:13:14
459c9ba27d99f78b16107d0f19cc0c51b04a60c5...9987ec934c2e0662a43f293799e6a8e09f4121f8,1,1,1,2,1,2011-11-16 21:17:55,2011-11-16 21:17:55
9987ec934c2e0662a43f293799e6a8e09f4121f8...4dee4bdb57c483bffa8d11025dface563d24869c,1,1,2,3,1,2011-11-16 21:22:18,2011-11-16 21:22:18
4dee4bdb57c483bffa8d11025dface563d24869c...c3eac16fe97d33f3296e2c8ce870855345df446d,4,17,4,21,5,2011-11-16 22:19:00,2011-11-16 22:19:00
a7734bba845e1079f7859f95f10be2c5b65cfded...aa02a3b757c1421115c3c7af8e5b60da9278d2be,2,7,1,8,3,2011-11-16 16:43:16,2011-11-16 16:43:16
a7734bba845e1079f7859f95f10be2c5b65cfded...e10fb64dd6092cc4d8f1d2feb24bbc64d5ed27de,3,90,111,201,54,2011-11-16 14:57:37,2011-11-16 14:57:37
ed63d28e7a3d319d10c1477e12ec8f64bdabe3bd...0c19b1afd9001b90b61f60f09338f3f57961ae09,2,4,2,6,2,2011-11-18 19:10:07,2011-11-18 19:10:07
0c19b1afd9001b90b61f60f09338f3f57961ae09...46d7ecacd70d3739c6a5b6953f3f1a13924ffef7,1,1,0,1,1,2011-11-18 19:19:55,2011-11-18 19:19:55
46d7ecacd70d3739c6a5b6953f3f1a13924ffef7...5488f17389e7b7720d02513dabd262af7ac51435,1,1,1,2,1,2011-11-18 20:54:06,2011-11-18 20:54:06
5488f17389e7b7720d02513dabd262af7ac51435...f950d7881c1a8607b47fd4c3e8b75db1bc6c4805,3,45,33,78,6,2011-11-18 20:54:56,2011-11-18 20:54:56
f950d7881c1a8607b47fd4c3e8b75db1bc6c4805...22be0785bdf76987de57fa4f912c5e1b11d40144,3,54,39,93,8,2011-11-18 20:55:13,2011-11-18 20:55:13
22be0785bdf76987de57fa4f912c5e1b11d40144...bc591f929d60c9a1a563bd19b659a05dc393cbb2,1,1,1,2,1,2011-11-18 21:31:06,2011-11-18 21:31:06
bc591f929d60c9a1a563bd19b659a05dc393cbb2...84fc40f198255594c0e2872eff340fdb33d2d72e,2,2,0,2,2,2011-11-18 21:32:26,2011-11-18 21:32:26
84fc40f198255594c0e2872eff340fdb33d2d72e...7c5e83c0c2b0e5ecaff88991b09aecacb34f3776,1,1,1,2,1,2011-11-18 21:33:10,2011-11-18 21:33:10
f0b86c5f1e3f59ceafc684478c7b67bb1e6886f4...bb35ef2f6063c04be8cb0e655049fec7a60f260a,7,29,6,35,10,2011-11-16 17:19:18,2011-11-16 17:19:18
bb35ef2f6063c04be8cb0e655049fec7a60f260a...c2265586448015c07f54887ebb2689440de548fb,1,0,6,6,1,2011-11-16 17:23:09,2011-11-16 17:23:09
c2265586448015c07f54887ebb2689440de548fb...79bcdfb8d7643e26fb93e234eaf3bc83332367dc,1,8,3,11,2,2011-11-16 17:30:17,2011-11-16 17:30:17
baa4fc8c1797bfb73ea5f59588fc0f61640689c5...c359eadf8eab096ef3193bf901b40b84488ca74d,1,1,55,56,1,2011-11-18 13:34:36,2011-11-18 13:34:36
73176c9ead814e7bfe848daf2647f643b0290ef9...cb4006aa8cc00f41e6e16ae9737dd407b37fce11,1,1,1,2,1,2011-11-19 09:22:52,2011-11-19 09:22:52
cb4006aa8cc00f41e6e16ae9737dd407b37fce11...0d3fed60a5b5a1178d50e5329d0fdb93b5c0e4d8,1,1,0,1,1,2011-11-20 18:16:43,2011-11-20 18:16:43
0d3fed60a5b5a1178d50e5329d0fdb93b5c0e4d8...6721ef01f40221171671bea02f7c3477ad209c79,1,4,4,8,3,2011-11-20 18:30:00,2011-11-20 18:30:00
6721ef01f40221171671bea02f7c3477ad209c79...4bf4efe712489090fca4ce14be9cbe7637f4d511,12,120,29,149,20,2011-11-20 20:32:12,2011-11-20 20:32:12
4bf4efe712489090fca4ce14be9cbe7637f4d511...3f35cccfbd9a97bd1291c3b2dd7bdf78e8acc047,2,10,11,21,5,2011-11-21 06:16:10,2011-11-21 06:16:10
3f35cccfbd9a97bd1291c3b2dd7bdf78e8acc047...46bebac9830cebe870dfdb9eadf5ed45cd0f2125,4,43,39,82,7,2011-11-21 07:16:10,2011-11-21 07:16:10
46bebac9830cebe870dfdb9eadf5ed45cd0f2125...31e51dd1162c99bc2a4c710309eb7866be1a9945,28,80,76,156,55,2011-11-21 07:26:10,2011-11-21 07:26:10
31e51dd1162c99bc2a4c710309eb7866be1a9945...6a4f8b997c9aa5866a98554aeb7718fd3b5ebe0e,2,2,2,4,2,2011-11-22 07:55:01,2011-11-22 07:55:01
6a4f8b997c9aa5866a98554aeb7718fd3b5ebe0e...a59b70902143f8f734c00baaa2fb006c073b91d7,4,22,8,30,8,2011-11-22 11:59:20,2011-11-22 11:59:20
a59b70902143f8f734c00baaa2fb006c073b91d7...3f0d8079557e573871cbb1b62e0f90e4e34853f9,6,17,3,20,6,2011-11-22 12:50:47,2011-11-22 12:50:47
3f0d8079557e573871cbb1b62e0f90e4e34853f9...b5d7fb5eed496dbef766390a57fd8eec53f842d0,6,18,15,33,11,2011-11-22 13:14:23,2011-11-22 13:14:23
b5d7fb5eed496dbef766390a57fd8eec53f842d0...78e6dc5fa5821039feef0a16c8cab5d77813440a,1,1,1,2,1,2011-11-22 13:26:53,2011-11-22 13:26:53
78e6dc5fa5821039feef0a16c8cab5d77813440a...3f562027139913f3ee46f8c97b86fc7ef536319f,2,4,3,7,3,2011-11-22 13:33:42,2011-11-22 13:33:42
3f562027139913f3ee46f8c97b86fc7ef536319f...a6b99319381c2d62ec4b92d64805e8de8965859e,1,1,1,2,1,2011-11-22 14:01:53,2011-11-22 14:01:53
a6b99319381c2d62ec4b92d64805e8de8965859e...86829cae50857b5edf74b935380c6f68a19c2282,1,1,1,2,1,2011-11-22 14:03:27,2011-11-22 14:03:27
86829cae50857b5edf74b935380c6f68a19c2282...4451b8df8ad6d4b6d79fbce77687c6c2fd37d0a9,2,2,2,4,2,2011-11-22 17:54:36,2011-11-22 17:54:36
79bcdfb8d7643e26fb93e234eaf3bc83332367dc...07b7ddded3fb769121010171c741cb74397d3830,2,16,1,17,6,2011-11-16 18:05:00,2011-11-16 18:05:00
07b7ddded3fb769121010171c741cb74397d3830...c0dbebb11d7f077d1d203c51b876e06bebea6235,2,52,12,64,4,2011-11-17 19:30:57,2011-11-17 19:30:57
c0dbebb11d7f077d1d203c51b876e06bebea6235...2a874a00dc14b71f2967f137144dd25a14df26c5,1,5,4,9,5,2011-11-17 19:49:02,2011-11-17 19:49:02
2a874a00dc14b71f2967f137144dd25a14df26c5...26bdeb2107d7d55aa89132d9c060421bd377c9f0,1,1,7,8,1,2011-11-18 02:55:08,2011-11-18 02:55:08
4451b8df8ad6d4b6d79fbce77687c6c2fd37d0a9...540d0aa4068e8ff37dab384deead094bd037a13c,1,1,1,2,1,2011-11-22 19:56:22,2011-11-22 19:56:22
540d0aa4068e8ff37dab384deead094bd037a13c...1bcdc0a505831aa332826c0cebe739fee62a732a,1,4,0,4,1,2011-11-22 20:11:49,2011-11-22 20:11:49
1bcdc0a505831aa332826c0cebe739fee62a732a...a4fbe13fce87cb6ff2a27a2574ae25bf1dad145c,1,1,0,1,1,2011-11-22 20:26:07,2011-11-22 20:26:07
4451b8df8ad6d4b6d79fbce77687c6c2fd37d0a9...b56024100d40457a998f83adae3cdc830c997cda,2,2,5,7,2,2011-11-22 17:57:25,2011-11-22 17:57:25
26bdeb2107d7d55aa89132d9c060421bd377c9f0...139c4c2f181719f61e7b27ba23df6c065d795f2a,1,1,0,1,1,2011-11-18 11:48:23,2011-11-18 11:48:23
139c4c2f181719f61e7b27ba23df6c065d795f2a...4281704fb3d93fd641643e0eab1e388254c71f96,1,1,1,2,1,2011-11-18 12:16:59,2011-11-18 12:16:59
26bdeb2107d7d55aa89132d9c060421bd377c9f0...15016ae68dd2e59ce1b12b0be6e9870d16219569,2,2,2,4,2,2011-11-18 06:32:22,2011-11-18 06:32:22
15016ae68dd2e59ce1b12b0be6e9870d16219569...91d5a906f9cd1f120312d1ca72c8e500263c4439,4,63,3,66,4,2011-11-18 06:52:13,2011-11-18 06:52:13
a4fbe13fce87cb6ff2a27a2574ae25bf1dad145c...d61268e4f15502d46a61ee34f27248194c2f3f53,3,7,5,12,7,2011-11-22 21:36:14,2011-11-22 21:36:14
21d566ea76bbdbfd943b946f714eac1cfd94546b...b4c40c212c377ee04bb16065388c24b4bd3ec656,1,0,3,3,1,2011-11-23 20:12:36,2011-11-23 20:12:36
21d566ea76bbdbfd943b946f714eac1cfd94546b...284ba65e8abb892002136ca5d331675d6085d9d1,2,4,4,8,4,2011-11-23 12:27:06,2011-11-23 12:27:06
b4c40c212c377ee04bb16065388c24b4bd3ec656...ee2d3de1a634611a1c660516c955be0d3000904b,7,151,50,201,10,2011-11-24 13:08:20,2011-11-24 13:08:20
ee2d3de1a634611a1c660516c955be0d3000904b...2fbf45b2e04b09e944de9404bd87508e81dbf6da,1,14,8,22,3,2011-11-24 15:15:30,2011-11-24 15:15:30
2fbf45b2e04b09e944de9404bd87508e81dbf6da...b7f4f67b9b6a318f8fdbe2ff48074c3aff1ce73b,1,16,29,45,6,2011-11-24 16:47:27,2011-11-24 16:47:27
b7f4f67b9b6a318f8fdbe2ff48074c3aff1ce73b...4e55cc67f52d420691246dc3a20c75f6f3add912,2,28,64,92,10,2011-11-25 10:41:30,2011-11-25 10:41:30
4e55cc67f52d420691246dc3a20c75f6f3add912...4aad057f23a7d517d090ea3f54a48c693bf1b804,2,5,2,7,2,2011-11-25 10:49:28,2011-11-25 10:49:28
b4c40c212c377ee04bb16065388c24b4bd3ec656...310f0131b21f4420320e6b235969bb1512d25842,1,1,1,2,1,2011-11-24 11:51:32,2011-11-24 11:51:32
5d1a1a92b7b683f9cee421bb08120fc04184a3b8...07fefc9206a9d795fedac9f899ee2e4a4fef154b,1,1,1,2,1,2011-11-25 00:01:58,2011-11-25 00:01:58
a8e4fb61442569e75f00eb5a05faa73d8e484f6f...9b3fabcc9a56fbf1840d04bf3dd42bc693317ec9,2,8,7,15,7,2011-11-25 18:50:27,2011-11-25 18:50:27
9b3fabcc9a56fbf1840d04bf3dd42bc693317ec9...8209a2ff49f119d2aace2e9081bd607895f0a1f4,1,1,3,4,2,2011-11-25 19:56:05,2011-11-25 19:56:05
8209a2ff49f119d2aace2e9081bd607895f0a1f4...367c4f42f0c374e60da73b61a1e5992bfa268343,6,30,9,39,6,2011-11-25 20:18:36,2011-11-25 20:18:36
367c4f42f0c374e60da73b61a1e5992bfa268343...16bd018f08f3da0a9e25855cadf5f0064296642f,1,16,17,33,1,2011-11-25 20:26:44,2011-11-25 20:26:44
16bd018f08f3da0a9e25855cadf5f0064296642f...15fa14f1d62520956f6db156062e7125e6d432f1,12,126,87,213,19,2011-11-25 21:40:12,2011-11-25 21:40:12
15fa14f1d62520956f6db156062e7125e6d432f1...a9928eae4862fe1068bd3f48e8b5ec31d5c09151,1,2,2,4,2,2011-11-25 21:44:02,2011-11-25 21:44:02
a9928eae4862fe1068bd3f48e8b5ec31d5c09151...80c34985c8b56b2ab8f98fb19a889e7e29e47b73,6,0,0,0,0,2011-11-25 21:57:08,2011-11-25 21:57:08
80c34985c8b56b2ab8f98fb19a889e7e29e47b73...0accbaae15926dbc1f8c17a315d58725e7fb7571,5,53,40,93,9,2011-11-25 22:19:14,2011-11-25 22:19:14
0accbaae15926dbc1f8c17a315d58725e7fb7571...ade12da9488bea19d12505c371ead35686a1436e,2,11,1,12,2,2011-11-25 22:24:44,2011-11-25 22:24:44
ade12da9488bea19d12505c371ead35686a1436e...139a332293b9d8c4e5436619036e093483d8347f,1,6,2,8,3,2011-11-25 22:30:51,2011-11-25 22:30:51
139a332293b9d8c4e5436619036e093483d8347f...3aee55352318630d7ed06eb3f70e959409e31e9b,4,80,3,83,5,2011-11-25 23:42:42,2011-11-25 23:42:42
3aee55352318630d7ed06eb3f70e959409e31e9b...814eeb45e6a4d29a18eee1475d0ebcf69528ddc6,1,4,4,8,4,2011-11-26 19:14:50,2011-11-26 19:14:50
814eeb45e6a4d29a18eee1475d0ebcf69528ddc6...32ebd438c20269004b0d0a50751a955c8aa586f8,2,8,7,15,4,2011-11-27 08:36:28,2011-11-27 08:36:28
32ebd438c20269004b0d0a50751a955c8aa586f8...fb8f05ee165b4da8aec0e4adf48992a86052ab04,1,1,1,2,1,2011-11-27 08:37:37,2011-11-27 08:37:37
fb8f05ee165b4da8aec0e4adf48992a86052ab04...8ad1f8a4741522700dc7634e22ae946bbec2c845,3,19,2,21,3,2011-11-27 12:53:12,2011-11-27 12:53:12
8ad1f8a4741522700dc7634e22ae946bbec2c845...39a1b7d3f7569f6450ce44b07d76e56131e21348,1,2,0,2,1,2011-11-27 13:12:48,2011-11-27 13:12:48
8ad1f8a4741522700dc7634e22ae946bbec2c845...cce1231b8e6f8bbdb3f76f228b4d8709ef4e110b,1,3,1,4,1,2011-11-27 13:11:47,2011-11-27 13:11:47
1b2fba08fe83c7075d58cb34ba6ce79dfd527b41...a031813887a203b80006e7fdc3204355fd8d02b7,14,125,97,222,26,2011-11-27 15:35:49,2011-11-27 15:35:49
a031813887a203b80006e7fdc3204355fd8d02b7...224420396877cca13843fda9c69a2f94ffbad0b8,1,0,1,1,1,2011-11-27 15:39:58,2011-11-27 15:39:58
224420396877cca13843fda9c69a2f94ffbad0b8...75fa0632e67b2b91401673b0dd292db4103224c8,2,35,32,67,13,2011-11-28 09:34:11,2011-11-28 09:34:11
75fa0632e67b2b91401673b0dd292db4103224c8...46cbe5418947ab58c919432b9013252ada6a3bc3,5,23,8,31,13,2011-11-28 09:46:41,2011-11-28 09:46:41
224420396877cca13843fda9c69a2f94ffbad0b8...6d460aa2d6b3959593c168eed181516036525393,21,322,37,359,27,2011-11-28 07:39:43,2011-11-28 07:39:43
6d460aa2d6b3959593c168eed181516036525393...6b941cf92ce3accbac5656973d3204becc908f9a,6,58,32,90,16,2011-11-28 18:30:35,2011-11-28 18:30:35
6b941cf92ce3accbac5656973d3204becc908f9a...60c6649a9ac231aabb9361bb8b9a14c60771afb3,3,59,4,63,4,2011-11-28 18:42:32,2011-11-28 18:42:32
60c6649a9ac231aabb9361bb8b9a14c60771afb3...c0e5bc5ee8d6d181304dc7e1b5f960a786c03989,1,18,0,18,1,2011-11-28 18:50:25,2011-11-28 18:50:25
c0e5bc5ee8d6d181304dc7e1b5f960a786c03989...8803fbb593df64a5b8fa43f167548a901fc1a6a0,8,120,22,142,12,2011-11-28 20:16:57,2011-11-28 20:16:57
8803fbb593df64a5b8fa43f167548a901fc1a6a0...fbba17603fc568654a5ff180fae6b8db6108b37b,1,5,0,5,1,2011-11-28 20:38:11,2011-11-28 20:38:11
fbba17603fc568654a5ff180fae6b8db6108b37b...e74ec3c95a68ccdedfcf5a292bee44a4ec043bdb,1,2,0,2,1,2011-11-28 20:43:20,2011-11-28 20:43:20
22ac0cc7ebc6411bdfd4df7e018ca0e1fd63c4c6...bfb0bdbe7282229b9b1eafd5d308f786e689aa09,1,2,2,4,1,2011-11-28 21:14:43,2011-11-28 21:14:43
bfb0bdbe7282229b9b1eafd5d308f786e689aa09...837685d56b4b94df7b2157f4cef8701d3de1059d,1,24,1,25,1,2011-11-28 21:24:08,2011-11-28 21:24:08
837685d56b4b94df7b2157f4cef8701d3de1059d...017dfaee6500b10e30e46db0040672f792f360c5,1,2,2,4,1,2011-11-28 21:29:46,2011-11-28 21:29:46
017dfaee6500b10e30e46db0040672f792f360c5...958497fecbc630297f2d0d5f7b64b484966ae907,2,6,2,8,2,2011-11-28 21:34:24,2011-11-28 21:34:24
958497fecbc630297f2d0d5f7b64b484966ae907...79b64ef4aced8c030b23b2b7c4aa9b1bea192e1b,3,17,2,19,3,2011-11-29 18:06:37,2011-11-29 18:06:37
79b64ef4aced8c030b23b2b7c4aa9b1bea192e1b...f114a4f34970cff2393e4cd1f44add577878681f,3,4,3,7,4,2011-11-29 18:10:48,2011-11-29 18:10:48
f114a4f34970cff2393e4cd1f44add577878681f...12c01d74016c266b6acc798c0c1b68765afb4871,2,3,3,6,3,2011-11-30 07:05:37,2011-11-30 07:05:37
12c01d74016c266b6acc798c0c1b68765afb4871...c34092ebdcb597b0965df4d2c400672e4103e52d,1,1,1,2,1,2011-11-30 19:23:17,2011-11-30 19:23:17
c34092ebdcb597b0965df4d2c400672e4103e52d...6686834c8ddee1bb74265eb696f6e26f8f5e5959,1,1,1,2,1,2011-11-30 19:24:50,2011-11-30 19:24:50
6686834c8ddee1bb74265eb696f6e26f8f5e5959...46e77db0991283e54398c5214e25c48ae8708ec2,2,5,4,9,5,2011-11-30 21:25:39,2011-11-30 21:25:39
46e77db0991283e54398c5214e25c48ae8708ec2...1ce55d161aaac051cb65963c01e94e718a3a46a3,6,8,9,17,6,2011-11-30 21:41:00,2011-11-30 21:41:00
1ce55d161aaac051cb65963c01e94e718a3a46a3...fdc815961c710d4adaab16fe9a125cdba80c9bb4,1,4,4,8,4,2011-11-30 21:52:22,2011-11-30 21:52:22
fdc815961c710d4adaab16fe9a125cdba80c9bb4...b60b7b2e2b6880306d701e6607fe7bf89f4de137,3,33,25,58,6,2011-11-30 22:24:28,2011-11-30 22:24:28
b60b7b2e2b6880306d701e6607fe7bf89f4de137...570f63daaff7ef2b7b05c83714c78755b5d07101,7,133,80,213,15,2011-11-30 23:51:04,2011-11-30 23:51:04
570f63daaff7ef2b7b05c83714c78755b5d07101...c2cfc52e449a7bcd817909ace4ab8926509ee4f2,1,2,2,4,2,2011-11-30 23:51:16,2011-11-30 23:51:16
c2cfc52e449a7bcd817909ace4ab8926509ee4f2...42ba6d04f84b722bc1212378633cd8c05a2c6ded,2,5,3,8,4,2011-12-01 07:59:49,2011-12-01 07:59:49
42ba6d04f84b722bc1212378633cd8c05a2c6ded...6a2c7d80cbfe33cca71c11339f3443d9c6a33069,3,5,2,7,4,2011-12-01 14:16:53,2011-12-01 14:16:53
6a2c7d80cbfe33cca71c11339f3443d9c6a33069...c03bc6e2912b2e63a352e1f7e664b32a95aa9cad,4,36,16,52,17,2011-12-03 23:08:08,2011-12-03 23:08:08
c03bc6e2912b2e63a352e1f7e664b32a95aa9cad...9e089efe5a2defa38cc94347a5051f1cfe91406b,14,200,98,298,20,2011-12-03 23:44:59,2011-12-03 23:44:59
9e089efe5a2defa38cc94347a5051f1cfe91406b...a41d57691d47dce8db788d6cf97031bf1321a792,2,24,4,28,6,2011-12-03 23:52:19,2011-12-03 23:52:19
a41d57691d47dce8db788d6cf97031bf1321a792...03e51c30583908882204d2bfc8c647a7c5bc35ef,5,58,17,75,10,2011-12-04 20:19:49,2011-12-04 20:19:49
03e51c30583908882204d2bfc8c647a7c5bc35ef...8f4a0bd1743875289d5870b7d19ecb6c80016b6c,4,21,20,41,7,2011-12-04 20:34:39,2011-12-04 20:34:39
8f4a0bd1743875289d5870b7d19ecb6c80016b6c...8134fe0efe287f6512b7684d4c654b2d43f3df9d,7,14,8,22,9,2011-12-05 07:23:53,2011-12-05 07:23:53
8134fe0efe287f6512b7684d4c654b2d43f3df9d...bdc658095c6bc7e7a2a49447b404156f3f947fe1,13,58,124,182,35,2011-12-05 07:43:53,2011-12-05 07:43:53
bdc658095c6bc7e7a2a49447b404156f3f947fe1...2d81f4880e7f27c0359d5d5b54822db2441ce6ea,1,9,2,11,2,2011-12-05 17:27:41,2011-12-05 17:27:41
6a2c7d80cbfe33cca71c11339f3443d9c6a33069...da424d9406c1f69394cbaf051841208127e18e00,6,4,4,8,4,2011-12-02 10:57:18,2011-12-02 10:57:18
da424d9406c1f69394cbaf051841208127e18e00...e3402769f341b9787d738aaf03e41d27315cd2ac,1,18,9,27,7,2011-12-05 10:21:44,2011-12-05 10:21:44
e14a0eb8d0d22215d5185e023d4c8e3bbe91168b...3e581984fecca9ddfbed6082d8f6096c5ff48229,4,10,23,33,8,2011-12-05 17:54:53,2011-12-05 17:54:53
3e581984fecca9ddfbed6082d8f6096c5ff48229...415d09be83b565066cacc909b4433e81c4cabef8,1,0,2,2,1,2011-12-05 17:55:43,2011-12-05 17:55:43
415d09be83b565066cacc909b4433e81c4cabef8...e06b39ccd2253ced26c54efe0aabec2bd7390233,3,28,5,33,6,2011-12-05 20:08:21,2011-12-05 20:08:21
e06b39ccd2253ced26c54efe0aabec2bd7390233...1bf775d55d7784af3bf07a756deff8ed80550d39,1,1,1,2,1,2011-12-05 20:20:46,2011-12-05 20:20:46
1bf775d55d7784af3bf07a756deff8ed80550d39...cabde950bf04d1e08333828c378ff4eab34c66e6,7,58,11,69,9,2011-12-05 23:03:05,2011-12-05 23:03:05
cabde950bf04d1e08333828c378ff4eab34c66e6...c78ce746e56ed3c21bed6e16913561288554f6b0,4,10,14,24,4,2011-12-05 23:10:53,2011-12-05 23:10:53
c78ce746e56ed3c21bed6e16913561288554f6b0...5c69f929d38730d077dcaccf335f05cea90c4e21,1,4,0,4,1,2011-12-06 08:50:07,2011-12-06 08:50:07
5c69f929d38730d077dcaccf335f05cea90c4e21...3655b0428a7c817ea07091caf24fc58373997c24,3,3,3,6,3,2011-12-06 20:46:27,2011-12-06 20:46:27
3655b0428a7c817ea07091caf24fc58373997c24...2b68049625706403c9b214820486ff28fb1d19be,1,15,95,110,9,2011-12-06 21:09:19,2011-12-06 21:09:19
2b68049625706403c9b214820486ff28fb1d19be...2ca00bdb3e07e84a87c6d480d8cb896bf6f08ca9,1,5,2,7,3,2011-12-06 21:11:22,2011-12-06 21:11:22
2ca00bdb3e07e84a87c6d480d8cb896bf6f08ca9...cb021e58314791c1c9eb8035ed01349876d246a1,12,106,48,154,31,2011-12-06 23:27:07,2011-12-06 23:27:07
cb021e58314791c1c9eb8035ed01349876d246a1...68154e8fe9d6266f3b1ae00e48530143f87cd138,3,22,13,35,12,2011-12-07 07:48:44,2011-12-07 07:48:44
68154e8fe9d6266f3b1ae00e48530143f87cd138...1b8f082061e3f120ab02b263cb68e3433b028ef6,11,65,81,146,27,2011-12-07 08:04:57,2011-12-07 08:04:57
1b8f082061e3f120ab02b263cb68e3433b028ef6...8a4cd8a28b434d40678f09d2d2798cfb429a3fd7,4,0,53,53,4,2011-12-07 18:46:07,2011-12-07 18:46:07
8a4cd8a28b434d40678f09d2d2798cfb429a3fd7...c7afad31871960070c1db060af34ac0aa55f1683,1,4,4,8,4,2011-12-07 20:39:14,2011-12-07 20:39:14
c7afad31871960070c1db060af34ac0aa55f1683...2552a877df7fdb2c0a17a88479a5e49f315bcbad,2,37,15,52,4,2011-12-07 20:55:09,2011-12-07 20:55:09
2552a877df7fdb2c0a17a88479a5e49f315bcbad...f512418b27dbfa54839bd4deb9ea271316cdd665,14,165,20,185,22,2011-12-07 23:31:06,2011-12-07 23:31:06
f512418b27dbfa54839bd4deb9ea271316cdd665...0783e4cf983d3ac1737a7f8820398e4bdf5f2953,1,2,0,2,1,2011-12-07 23:37:56,2011-12-07 23:37:56
0783e4cf983d3ac1737a7f8820398e4bdf5f2953...1a3af33fce8ce505dca2bf7af071091b2ff058a2,2,0,6,6,2,2011-12-07 23:39:32,2011-12-07 23:39:32
1a3af33fce8ce505dca2bf7af071091b2ff058a2...e4b1f38c272ae8a052d64024867d9bcaa8398ce1,10,90,2,92,11,2011-12-08 00:07:02,2011-12-08 00:07:02
e4b1f38c272ae8a052d64024867d9bcaa8398ce1...0ffed126e27e3b53f8b9c0a40b11206402f02eac,1,2,2,4,2,2011-12-08 00:13:11,2011-12-08 00:13:11
0ffed126e27e3b53f8b9c0a40b11206402f02eac...2b896ea6cc7f125a6a86295f23df165d7ebe4259,1,0,4,4,1,2011-12-08 07:59:15,2011-12-08 07:59:15
2552a877df7fdb2c0a17a88479a5e49f315bcbad...d68ec5e0fb156e56c2e057eefe2e473d72d44c1f,7,18,6,24,10,2011-12-07 21:56:57,2011-12-07 21:56:57
d68ec5e0fb156e56c2e057eefe2e473d72d44c1f...c2789dae34c60eb2fa5f618c3d8a48abce212100,1,1,1,2,1,2011-12-07 22:22:46,2011-12-07 22:22:46
c2789dae34c60eb2fa5f618c3d8a48abce212100...72a13fcc2e847e551fd2a2be4b45000962374c7b,1,6,2,8,1,2011-12-07 22:31:04,2011-12-07 22:31:04
72a13fcc2e847e551fd2a2be4b45000962374c7b...23a1ba7362a13dfcde05d158f2d2237351090730,7,80,27,107,13,2011-12-07 23:35:57,2011-12-07 23:35:57
23a1ba7362a13dfcde05d158f2d2237351090730...2677bc3acb64a2e3a75a743bd9b5426c39decdef,2,4,8,12,2,2011-12-07 23:45:36,2011-12-07 23:45:36
8e0126e9ec676f1ec40bb1a3dcb811e6477fb8c6...4107f2cc2e6d0b93208573f4873305ba0ef4c5de,12,125,51,176,17,2011-12-08 19:17:53,2011-12-08 19:17:53
4107f2cc2e6d0b93208573f4873305ba0ef4c5de...cd779e56e1ce799fc6ec25dc2fbc8a3e0f775ee8,22,189,184,373,34,2011-12-08 20:17:53,2011-12-08 20:17:53
2677bc3acb64a2e3a75a743bd9b5426c39decdef...1c9b9b7a3b0ae2ee60e4cda5d1ac2541c17302f8,4,23,0,23,8,2011-12-12 22:03:38,2011-12-12 22:03:38
1c9b9b7a3b0ae2ee60e4cda5d1ac2541c17302f8...bc0155fbaa1261f348324c1ddf5d1eaba5907f77,5,30,14,44,6,2011-12-13 00:03:26,2011-12-13 00:03:26
bc0155fbaa1261f348324c1ddf5d1eaba5907f77...56fc53e8d870b70ca66332daeb6da39ab0eb5ce7,1,9,2,11,2,2011-12-13 19:39:02,2011-12-13 19:39:02
56fc53e8d870b70ca66332daeb6da39ab0eb5ce7...edab46e9fa5f568b1423c0021e81d30453d7dc1e,14,295,4,299,29,2011-12-14 16:38:52,2011-12-14 16:38:52
edab46e9fa5f568b1423c0021e81d30453d7dc1e...7ffb8fc616a2890cc46924b099c28709e491495e,2,27,1,28,3,2011-12-15 09:33:20,2011-12-15 09:33:20
7ffb8fc616a2890cc46924b099c28709e491495e...be6e52c2f676927a373a2225f22f63120020f8cd,1,1,1,2,1,2011-12-26 09:10:21,2011-12-26 09:10:21
be6e52c2f676927a373a2225f22f63120020f8cd...5ca836048d4f3319d24d2d4580912102eed54618,1,1,1,2,1,2011-12-26 09:12:09,2011-12-26 09:12:09
cd779e56e1ce799fc6ec25dc2fbc8a3e0f775ee8...1b6fb006ca6a57ae381608ff23ab464d7498ee26,1,1,0,1,1,2011-12-11 22:18:51,2011-12-11 22:18:51
cd779e56e1ce799fc6ec25dc2fbc8a3e0f775ee8...8524d194e2b80a9f41e2be55805267a44232bed7,2,1,1,2,2,2011-12-11 00:41:05,2011-12-11 00:41:05
4587ab6ff64a255577e02334fa0492b5edcb80ea...9696dff6e211fa178860d4ead8bc6f98473ea276,1,1,0,1,1,2012-01-23 08:46:59,2012-01-23 08:46:59
66fb3909a564d2e7905f5b720fd55ea61286605e...676fa16cebc6d6773c48a1af88b2316d175c31f2,2,36,55,91,3,2011-12-27 21:49:16,2011-12-27 21:49:16
822c0a506043a2e5ba0a58769b398cfe91d3df47...926f3013c25645543fb1c91f7346585fdcb7a3a6,2,5,5,10,5,2011-12-12 18:13:11,2011-12-12 18:13:11
926f3013c25645543fb1c91f7346585fdcb7a3a6...a3b6a3ed3552cbbdc74971a1261c668d1365412f,1,2,2,4,2,2011-12-12 18:32:35,2011-12-12 18:32:35
822c0a506043a2e5ba0a58769b398cfe91d3df47...f615c877bcb36aa2e4bc399545376671b55f167e,3,3,3,6,4,2011-12-12 16:41:31,2011-12-12 16:41:31
f615c877bcb36aa2e4bc399545376671b55f167e...7b7549bea6ab59676e85460bb9ab83b8403d66f2,2,30,13,43,13,2011-12-12 16:42:07,2011-12-12 16:42:07
822c0a506043a2e5ba0a58769b398cfe91d3df47...f34b1be28102dc77d4659f3113e258afb9dc4951,8,38,31,69,8,2011-12-12 07:38:37,2011-12-12 07:38:37
f34b1be28102dc77d4659f3113e258afb9dc4951...5bc97fbd3f3c9194ece68d6458ee250ca1a9a53b,7,53,13,66,9,2011-12-12 17:22:01,2011-12-12 17:22:01
04a908f6a5c4f8753f0965615d94798286ecc675...8426846d6dd018b16c7193ef1bea4527ea08360b,3,2,4,6,4,2011-12-12 21:17:28,2011-12-12 21:17:28
8426846d6dd018b16c7193ef1bea4527ea08360b...3dc94ba8eb74caa6f4eae29970fe261f51e1942e,4,27,2,29,4,2011-12-12 22:08:15,2011-12-12 22:08:15
4df4b381852ea432659f488aa713aa336e27b89b...faf7c79eb2d0c380b692be413953d206f2984b0b,5,26,16,42,4,2011-12-12 18:08:04,2011-12-12 18:08:04
5bc97fbd3f3c9194ece68d6458ee250ca1a9a53b...e38fa32822a34f8dbb7bb9af6885f30a5f0ce2a7,1,94,0,94,1,2011-12-13 18:17:54,2011-12-13 14:18:36
e38fa32822a34f8dbb7bb9af6885f30a5f0ce2a7...2201ef80200d0a3f896a30fe10aa3a2c71b7bde1,1,0,1,1,1,2011-12-13 18:20:40,2011-12-13 13:49:08
2201ef80200d0a3f896a30fe10aa3a2c71b7bde1...a1cd582c67b10abbda6c2fb2c99d8735138d33db,3,3,3,6,4,2011-12-13 18:20:45,2011-12-12 16:41:31
a1cd582c67b10abbda6c2fb2c99d8735138d33db...a39fb5fc25f2db100115e15cdca1daee80693c94,2,30,13,43,13,2011-12-13 18:20:45,2011-12-12 16:42:07
a39fb5fc25f2db100115e15cdca1daee80693c94...8ee6d21fa1d78b327eab91ff4b3cae8c6146efd9,5,26,16,42,4,2011-12-13 18:20:45,2011-12-12 18:08:04
8ee6d21fa1d78b327eab91ff4b3cae8c6146efd9...2e2e3521074b44d1ad24c6870dcd9abeeac4f38d,2,5,5,10,5,2011-12-13 18:20:45,2011-12-12 18:13:11
2e2e3521074b44d1ad24c6870dcd9abeeac4f38d...5f580ab09c79a54af287cbe209485d89a854f32f,1,2,2,4,2,2011-12-13 18:20:45,2011-12-12 18:32:35
5f580ab09c79a54af287cbe209485d89a854f32f...d5c6f27020e4bd24440c117c06868bdc806819b4,4,9,5,14,4,2011-12-13 18:20:45,2011-12-12 20:12:37
d5c6f27020e4bd24440c117c06868bdc806819b4...4c3a61a760b22687fd670c8b02252b20532419be,1,1,0,1,1,2011-12-13 18:20:46,2011-12-11 22:18:51
4c3a61a760b22687fd670c8b02252b20532419be...3a14432879199f117af8a73098dce6261b0840cc,3,2,4,6,4,2011-12-13 18:20:46,2011-12-12 21:17:28
4e5597b852939d04535cc8453bb288da41654de7...219ac1898095355ad9fc5c9f2ae08d9428b33090,1,24,11,35,4,2012-03-01 15:43:04,2012-03-01 15:43:04
219ac1898095355ad9fc5c9f2ae08d9428b33090...c94159ab089fe964263643ffc7e881ba8cac3f23,6,62,49,111,17,2012-03-01 18:40:32,2012-03-01 18:40:32
c94159ab089fe964263643ffc7e881ba8cac3f23...375ebcabfd2b5c086d0b2602114f7b751c205440,3,38,30,68,4,2012-03-01 18:47:57,2012-03-01 18:47:57
375ebcabfd2b5c086d0b2602114f7b751c205440...ed75afbb1014920f811a33524ba73cf1a7d78dc9,2,3,3,6,3,2012-03-01 19:02:59,2012-03-01 19:02:59
ed75afbb1014920f811a33524ba73cf1a7d78dc9...00028702fc516f799296d10a1d0da960e93a0381,10,64,21,85,18,2012-03-01 19:23:50,2012-03-01 19:23:50
00028702fc516f799296d10a1d0da960e93a0381...5263dd4297e2ba71c40d74dcfb8511fec68e6620,13,153,57,210,20,2012-03-01 20:43:04,2012-03-01 20:43:04
5263dd4297e2ba71c40d74dcfb8511fec68e6620...b603e0dc4517c97e9f7da557c37cfa4cf3cf4353,1,2,2,4,1,2012-03-01 20:56:24,2012-03-01 20:56:24
b603e0dc4517c97e9f7da557c37cfa4cf3cf4353...770f18ac50f1603b6f81794acb30065ab077f80f,1,3,0,3,1,2012-03-02 16:42:28,2012-03-02 16:42:28
770f18ac50f1603b6f81794acb30065ab077f80f...2d162ff9ac129f9c327db3cbd982d9a2c06f4a68,1,1,1,2,1,2012-03-02 20:33:29,2012-03-02 20:33:29
2d162ff9ac129f9c327db3cbd982d9a2c06f4a68...9f1a5f415a306261d7c6b66f3a4ca7f062e914a8,1,1,1,2,1,2012-03-02 20:44:30,2012-03-02 20:44:30
9f1a5f415a306261d7c6b66f3a4ca7f062e914a8...6de7dc1e67a8595c80626e35987a96e190515230,6,111,77,188,14,2012-03-02 22:09:17,2012-03-02 22:09:17
6de7dc1e67a8595c80626e35987a96e190515230...62707bb7301cf7506b4fdae230048e89bc1fd1fd,1,1,1,2,1,2012-03-03 09:23:03,2012-03-03 09:23:03
62707bb7301cf7506b4fdae230048e89bc1fd1fd...d6b051c5be5d7be1519ce31b897c89216715cb53,12,28,121,149,15,2012-03-03 11:03:03,2012-03-03 11:03:03
d6b051c5be5d7be1519ce31b897c89216715cb53...bc6915f24a7f17c3cd61b94cc8c6383e1703ae48,2,54,33,87,5,2012-03-04 01:00:19,2012-03-04 01:00:19
5c6417ce070a8836c4c89dd8d3de1617b24800a4...16a98387c24e095a930b18f65065d0ea26eb6a12,4,5,4,9,4,2012-01-23 19:08:12,2012-01-23 19:08:12
16a98387c24e095a930b18f65065d0ea26eb6a12...ec1a426726529b94e315e0af9c9b64dce6b2a24d,1,3,0,3,3,2012-01-25 13:27:36,2012-01-25 07:13:08
ec1a426726529b94e315e0af9c9b64dce6b2a24d...4647c6fa3a9fbf58a4a2f60d31fc9a1a0633c3df,1,6,1,7,1,2012-01-25 13:27:36,2012-01-25 07:15:08
4647c6fa3a9fbf58a4a2f60d31fc9a1a0633c3df...73efb837913ee0892c3ab92700a61783397ca83a,4,56,96,152,4,2012-01-25 07:16:08,2012-01-25 07:16:08
73efb837913ee0892c3ab92700a61783397ca83a...b4cc04d7e17eeefe6d89bbb72661a43d7d9e3e2e,5,66,83,149,9,2012-01-25 19:10:09,2012-01-25 19:10:09
3dc94ba8eb74caa6f4eae29970fe261f51e1942e...713802fdf317593f1201cf5dd4c34238ffccca0a,1,5,2,7,2,2011-12-13 11:25:58,2011-12-13 11:25:58
3dc94ba8eb74caa6f4eae29970fe261f51e1942e...4e00330bb0361f102bbdf9f969273b919040f8a5,5,76,50,126,7,2011-12-13 08:07:52,2011-12-13 08:07:52
4e00330bb0361f102bbdf9f969273b919040f8a5...18be3e4c17f0df7343f35ceb94454321949505b0,9,105,52,157,22,2011-12-13 18:40:45,2011-12-13 18:40:45
18be3e4c17f0df7343f35ceb94454321949505b0...e8860594a97968e7bb9af4a6abf4fde111d63cc7,6,130,73,203,19,2011-12-13 21:24:31,2011-12-13 21:24:31
faf7c79eb2d0c380b692be413953d206f2984b0b...02e827283d905477e816fbb940d8a4489df94826,4,9,5,14,4,2011-12-12 20:12:37,2011-12-12 20:12:37
faf7c79eb2d0c380b692be413953d206f2984b0b...86f76b11c670425bbab465087f25172378d76147,2,1,0,1,1,2011-12-12 19:47:00,2011-12-12 19:47:00
86f76b11c670425bbab465087f25172378d76147...e74fae147abc7d2ffbf93d363dbbe45b87751f6f,2,2,1,3,1,2011-12-12 19:49:40,2011-12-12 19:49:40
d567b23bf053cee78fb7218cbe6d15d615fea582...60fee48eaa98bf859613160dcad87b8f0908aac6,1,1,1,2,1,2011-12-13 18:25:01,2011-12-13 18:25:01
60fee48eaa98bf859613160dcad87b8f0908aac6...3fd3e1fcdf69e8544b25193a6e2a53716c65096c,1,37,18,55,6,2011-12-15 21:55:53,2011-12-15 21:55:53
bc6915f24a7f17c3cd61b94cc8c6383e1703ae48...eac366a97bf2da64ccd90ef27c1d2ca974ad8310,1,1,1,2,1,2012-03-05 01:38:18,2012-03-05 01:38:18
bc6915f24a7f17c3cd61b94cc8c6383e1703ae48...3fe9d2972f37f408f403a98a3bdde16174163350,2,2,2,4,3,2012-03-04 10:35:15,2012-03-04 10:35:15
3fe9d2972f37f408f403a98a3bdde16174163350...0727edd8a0c68b640b95fabce21472b04a806562,13,82,186,268,37,2012-03-04 13:35:15,2012-03-04 13:35:15
b4cc04d7e17eeefe6d89bbb72661a43d7d9e3e2e...c083df0570d6fa83e6e302feff67ab65db15fe04,12,80,2,82,18,2012-01-28 10:11:21,2012-01-21 18:36:14
c083df0570d6fa83e6e302feff67ab65db15fe04...d885f24f7bff6d15406086fa62e898025f564b8b,5,0,28,28,5,2012-01-28 10:11:21,2012-01-21 18:44:41
d885f24f7bff6d15406086fa62e898025f564b8b...d6a0b8f42881964b9e57ad1dde4918e74aea0ed0,6,37,24,61,6,2012-01-28 13:23:17,2012-01-28 13:23:17
b4cc04d7e17eeefe6d89bbb72661a43d7d9e3e2e...807721df73e061792f72fcd6a5a28082ece80074,1,1,1,2,1,2012-01-26 19:02:59,2012-01-26 19:02:59
b4cc04d7e17eeefe6d89bbb72661a43d7d9e3e2e...15b1b515243dd4a871e2f28da38258cd64b713da,10,147,136,283,12,2012-01-26 07:50:11,2012-01-26 07:50:11
15b1b515243dd4a871e2f28da38258cd64b713da...ee2583e1b5df301cf1124f1c528fe778af8ffb3e,4,13,8,21,10,2012-01-26 07:51:11,2012-01-26 07:51:11
ee2583e1b5df301cf1124f1c528fe778af8ffb3e...fed0da80768a09ca54fc4dd0f9355a0429f2ab34,15,220,333,553,46,2012-01-26 17:25:35,2012-01-26 17:25:35
fed0da80768a09ca54fc4dd0f9355a0429f2ab34...bef29f0797af43e1102579c75b598501555019fd,10,225,500,725,71,2012-01-26 22:13:19,2012-01-26 22:13:19
bef29f0797af43e1102579c75b598501555019fd...d4ad362387d94e78a4722e070d7a267414bff6b2,9,47,47,94,16,2012-01-26 23:46:32,2012-01-26 23:46:32
d4ad362387d94e78a4722e070d7a267414bff6b2...fbdb1da2ab450a49357feb8306dcced6ce61ab50,12,104,171,275,33,2012-01-27 06:57:55,2012-01-27 06:57:55
fbdb1da2ab450a49357feb8306dcced6ce61ab50...4d9c3f3123f43978702c60bb2d87885377b3d837,16,53,63,116,27,2012-01-27 07:19:55,2012-01-27 07:19:55
4d9c3f3123f43978702c60bb2d87885377b3d837...05d76fc4d03f8174f54c601d20392b0bf22fdbf9,10,64,63,127,15,2012-01-27 17:58:10,2012-01-27 17:58:10
05d76fc4d03f8174f54c601d20392b0bf22fdbf9...7f6e41fa028e4293e50edbf9fe2ea6cc19957533,22,951,204,1155,39,2012-01-27 22:51:02,2012-01-27 22:51:02
7f6e41fa028e4293e50edbf9fe2ea6cc19957533...29b5aa2c76924ad9d307bd932bfd4e5674781dcd,14,145,123,268,40,2012-01-27 23:49:14,2012-01-27 23:49:14
29b5aa2c76924ad9d307bd932bfd4e5674781dcd...1afd93ee1a91232a14353c0fdcecd6ee7d4b3402,4,17,62,79,9,2012-01-28 00:08:26,2012-01-28 00:08:26
1afd93ee1a91232a14353c0fdcecd6ee7d4b3402...c7933d7a78433f026bd4344667f6d4b270bfef15,12,106,115,221,27,2012-01-28 09:54:11,2012-01-28 09:54:11
c7933d7a78433f026bd4344667f6d4b270bfef15...089dca4d6c88d06b0dca4307f2e64b186534a2c5,2,11,5,16,2,2012-01-28 10:02:03,2012-01-28 10:02:03
089dca4d6c88d06b0dca4307f2e64b186534a2c5...15b06b01644f31314f3241afbb7a807219f18703,6,68,94,162,12,2012-01-28 10:40:17,2012-01-28 10:40:17
15b06b01644f31314f3241afbb7a807219f18703...0a4222fb9802aa979171920c489a7db11e3f1ff8,26,318,359,677,60,2012-01-28 14:47:55,2012-01-28 14:47:55
0a4222fb9802aa979171920c489a7db11e3f1ff8...d81f0b7845ff80d22d4ee2bc41208730ffc14df7,6,64,62,126,13,2012-01-28 15:21:00,2012-01-28 15:21:00
d81f0b7845ff80d22d4ee2bc41208730ffc14df7...a77c8bf9c3635393064490e752aa99f10bf32722,11,171,140,311,28,2012-01-29 10:04:09,2012-01-29 10:04:09
a77c8bf9c3635393064490e752aa99f10bf32722...97e9774336c1de54d2734304dcb94511682f6613,2,10,5,15,6,2012-01-29 10:45:51,2012-01-29 10:45:51
97e9774336c1de54d2734304dcb94511682f6613...ae5faf0fd32160dd46a7e94e230d241de8ec4e38,11,151,110,261,27,2012-01-29 19:30:03,2012-01-29 19:30:03
ae5faf0fd32160dd46a7e94e230d241de8ec4e38...20721eff1c9a9a8f291d68538f209091b92961b4,4,22,18,40,8,2012-01-29 19:58:31,2012-01-29 19:58:31
20721eff1c9a9a8f291d68538f209091b92961b4...fca1ffb888e506f7ab0551d01321e462c09d5112,32,213,1010,1223,88,2012-01-29 21:59:12,2012-01-29 21:59:12
fca1ffb888e506f7ab0551d01321e462c09d5112...b51252e6cac2e413e6e39b53964a57d1b29ac12f,10,14,24,38,16,2012-01-29 22:43:14,2012-01-29 22:43:14
5d6e79f4b97290829e4c22aecf91e57519107a5c...49b58057091cbe6d9d684d78b1efbc77c578bcd8,1,1,2,3,1,2011-12-27 23:06:55,2011-12-27 23:06:55
49b58057091cbe6d9d684d78b1efbc77c578bcd8...de83c91c2fd8b8f5c7230e2515d6e206331fd37f,2,16,6,22,3,2011-12-27 23:29:53,2011-12-27 23:29:53
de83c91c2fd8b8f5c7230e2515d6e206331fd37f...5b0d6ac873c42b45f6a4bf94384764dc1ff808d5,1,6,2,8,2,2011-12-28 07:07:40,2011-12-28 07:07:40
5b0d6ac873c42b45f6a4bf94384764dc1ff808d5...a6c937a77918f019967862a337dcda7a9ae1a026,1,1,1,2,1,2011-12-28 07:08:40,2011-12-28 07:08:40
a6c937a77918f019967862a337dcda7a9ae1a026...91275f6d86e79d0a8961731568005a40cc8eff8b,1,9,7,16,1,2011-12-28 07:08:50,2011-12-28 07:08:50
91275f6d86e79d0a8961731568005a40cc8eff8b...6e5caa19856a683e5e9ead5cda907cb4119762d6,6,4,0,4,4,2011-12-28 07:18:50,2011-12-28 07:18:50
713802fdf317593f1201cf5dd4c34238ffccca0a...c532dfc1bb3439b82cfc4779b835c5aff0c6b7cf,1,15,15,30,3,2011-12-13 17:51:22,2011-12-13 17:51:22
9edbac5ac88ffa1ec9dad0097226b51e29ebc9ac...a6870dd08f8f274d9a6b899f638c0c26fefaa690,1,2,0,2,1,2012-02-19 09:49:48,2012-02-19 09:49:48
ced572c328507e3d327f23e9673ba33584845501...ad0e02c9dea4dcbc0e39240c6f3d9cc703c8b05b,1,1,0,1,1,2011-12-16 18:12:20,2011-12-16 18:12:20
ced572c328507e3d327f23e9673ba33584845501...f7859ec1ed9061abe467fb9860e9d87514e4b2e1,1,3,3,6,3,2011-12-16 09:59:07,2011-12-16 09:59:07
74f8bc7298f112c2d414c6f71be054adce01012a...cb59aade4e568e6146a966362385ac41af4dc604,12,135,232,367,18,2012-03-05 22:26:40,2012-03-05 22:26:40
cb59aade4e568e6146a966362385ac41af4dc604...eb7bbedb20e57e7ff266dfd0611d4d25b69cde1b,11,82,50,132,17,2012-03-05 22:29:40,2012-03-05 22:29:40
8ebfae9a0770ce1ba5afa121a484f70ab9ce9110...0f83558beae7df5b09befc53526d94d71787310b,1,2,0,2,1,2012-02-05 10:23:14,2012-02-05 10:23:14
0f83558beae7df5b09befc53526d94d71787310b...5a12bee37d39118c177d1b95b8e38e0d16eef559,1,6,3,9,1,2012-02-05 10:26:27,2012-02-05 10:26:27
5a12bee37d39118c177d1b95b8e38e0d16eef559...c90f1d5c8bed09aeb51a11d223025b423b048143,6,49,14,63,8,2012-02-05 10:58:02,2012-02-05 10:58:02
c90f1d5c8bed09aeb51a11d223025b423b048143...2efc1068f05d54fec2d0dc0a08b91b8f2bc9e088,6,19,403,422,12,2012-02-05 11:51:51,2012-02-05 11:51:51
8ebfae9a0770ce1ba5afa121a484f70ab9ce9110...03bf55846bc7daaf897f5c0a16d66325a408f10d,1,1,1,2,1,2012-02-01 10:42:42,2012-02-01 10:42:42
6e5caa19856a683e5e9ead5cda907cb4119762d6...a25a85b9396cbc07bf2bfcd12d3c0a6685df66d6,3,9,11,20,8,2011-12-29 03:52:28,2011-12-29 03:51:33
a25a85b9396cbc07bf2bfcd12d3c0a6685df66d6...78d882623e13f061349ff6237e250970fc48d8a4,1,1,0,1,1,2011-12-29 05:33:25,2011-12-29 05:33:25
6e5caa19856a683e5e9ead5cda907cb4119762d6...c1c903fb955cbee1afe3bd10944d6c218b576b15,12,80,27,107,19,2011-12-28 07:38:50,2011-12-28 07:38:50
c1c903fb955cbee1afe3bd10944d6c218b576b15...0f627a65f43e1b6bfce059bf1750075fb589e583,16,128,53,181,27,2011-12-30 06:54:42,2011-12-30 06:54:42
0f627a65f43e1b6bfce059bf1750075fb589e583...61a2ce41104171b5803164830121df9125668dce,5,33,22,55,6,2011-12-30 19:56:34,2011-12-30 19:56:34
fb72b3c68ebe777907b721c0eeadecaf06baaf70...e4bd6442a951681a7a12fed12591fbcfb51a412c,5,76,50,126,7,2011-12-13 21:56:04,2011-12-13 08:07:52
e4bd6442a951681a7a12fed12591fbcfb51a412c...3a50b6cac992f86981ad43990ace6ea78b422476,9,105,52,157,22,2011-12-13 21:56:04,2011-12-13 18:40:45
3a50b6cac992f86981ad43990ace6ea78b422476...6f32ccf432c8c3c634dbacd3fc3a28d1c59d01e0,6,130,73,203,19,2011-12-13 21:56:04,2011-12-13 21:24:31
6f32ccf432c8c3c634dbacd3fc3a28d1c59d01e0...87d9e0d88c2d3a1587968ba670e263a25c372986,1,42,35,77,4,2011-12-13 21:59:35,2011-12-13 21:59:35
fb72b3c68ebe777907b721c0eeadecaf06baaf70...8187119eb0991062c94b89f1d067251f1788c8cb,1,2,0,2,1,2011-12-13 21:40:29,2011-12-13 21:40:29
7b4f545219d85a74b883134308cb0c0314f01f6d...36b7b5f299d3c7744d069b804c4c9edcc88c1536,2,12,7,19,5,2011-12-15 11:18:33,2011-12-15 11:18:33
7b4f545219d85a74b883134308cb0c0314f01f6d...edece21e229c568b8017aca845f7fd9ca5ee74ee,1,1,1,2,1,2011-12-14 15:24:39,2011-12-14 15:24:39
7b4f545219d85a74b883134308cb0c0314f01f6d...ff1cbbc53272c0d9c862966980cfe52cab931992,2,52,41,93,6,2011-12-14 06:58:35,2011-12-14 06:58:35
a6870dd08f8f274d9a6b899f638c0c26fefaa690...ee45a49c57a362305431cbf004e4590b713c910e,3,3,3,6,3,2012-02-19 10:36:16,2012-02-19 10:36:16
ee45a49c57a362305431cbf004e4590b713c910e...2e83de1924ad3429b812d17498b009a8b924795d,5,30,15,45,14,2012-02-19 14:31:11,2012-02-19 14:31:11
f7859ec1ed9061abe467fb9860e9d87514e4b2e1...7713f7fefb4601b7ddede29d61fbf80e2b2929b8,7,55,28,83,10,2011-12-17 13:58:35,2011-12-17 13:58:35
7713f7fefb4601b7ddede29d61fbf80e2b2929b8...db582b638382f15f7e373fd79b90e4fc0f494a37,3,35,1,36,5,2011-12-17 16:07:28,2011-12-17 16:07:28
db582b638382f15f7e373fd79b90e4fc0f494a37...df5b192e4d864cc8b27976bfc814a5e445ae8e1d,3,40,0,40,4,2011-12-18 13:46:06,2011-12-18 13:46:06
df5b192e4d864cc8b27976bfc814a5e445ae8e1d...32aa2e3f24c1b2d1d3f4fa8cfb6334644492ba2a,4,38,1,39,5,2011-12-18 14:07:47,2011-12-18 14:07:47
32aa2e3f24c1b2d1d3f4fa8cfb6334644492ba2a...a66d9b4c768d9ed2e0096645fb2b4f61c222283d,8,68,34,102,8,2011-12-18 14:09:16,2011-12-18 14:09:16
a66d9b4c768d9ed2e0096645fb2b4f61c222283d...6a0defc3ca2edf40fc58db4662a40f22514c88f6,3,33,2,35,3,2011-12-18 14:29:58,2011-12-18 14:29:58
6a0defc3ca2edf40fc58db4662a40f22514c88f6...c940767f2a5b693ff33904ad0fc7974441ed0b75,1,2,4,6,2,2011-12-18 14:36:30,2011-12-18 14:36:30
c940767f2a5b693ff33904ad0fc7974441ed0b75...839aa7357a6bcfc881ef01cfd37ac618817a16df,1,1,2,3,2,2011-12-18 16:55:32,2011-12-18 16:55:32
f7859ec1ed9061abe467fb9860e9d87514e4b2e1...6db121cbdbf632b30fb8ba78eed763684316c3e5,3,6,6,12,6,2011-12-17 09:18:27,2011-12-17 09:18:27
eb7bbedb20e57e7ff266dfd0611d4d25b69cde1b...1bc0bd32444feb8d571b6d95a2bede2fb67bb951,1,1,1,2,1,2012-03-07 04:26:39,2012-03-07 04:26:39
eb7bbedb20e57e7ff266dfd0611d4d25b69cde1b...a7c8ce6a4d56fdfc38ac0fb034bae51758e5e3e9,2,2,2,4,2,2012-03-06 23:39:07,2012-03-06 23:39:07
eb7bbedb20e57e7ff266dfd0611d4d25b69cde1b...55e72f4cdfc387dbfc472387bed38bae7e75828a,3,32,14,46,13,2012-03-06 17:54:59,2012-03-06 17:54:59
55e72f4cdfc387dbfc472387bed38bae7e75828a...04e9022e5a56c1d4948a307c055dd74215174ccf,1,25,0,25,1,2012-03-07 19:23:09,2012-03-07 19:23:09
78d882623e13f061349ff6237e250970fc48d8a4...5719f02f34339237a2b1faeda30976a404358910,1,0,1,1,1,2011-12-30 10:30:57,2011-12-30 10:30:57
5719f02f34339237a2b1faeda30976a404358910...7279e8c1774f3116dd74ca462447189730f9eff8,3,11,9,20,8,2011-12-30 10:30:57,2011-12-30 10:30:57
78d882623e13f061349ff6237e250970fc48d8a4...e56212949017f3efe47fbd59b0f2860120a41fa8,1,7,1,8,1,2011-12-29 21:42:31,2011-12-29 20:50:26
e33aab0b21e38f4cf7aed8bb6451d737fcefe110...0ae9ac155c2d6d91060e0b0a3d528681aeb0dfe2,6,49,0,49,6,2011-12-30 20:56:13,2011-12-30 20:56:13
0ae9ac155c2d6d91060e0b0a3d528681aeb0dfe2...d8247012b5dd7578a5d9f9922352c7f373d89af4,3,48,1,49,3,2011-12-31 10:52:01,2011-12-31 10:52:01
d8247012b5dd7578a5d9f9922352c7f373d89af4...a667c713128b3dd8dece604e4aae3519ab7e57ed,7,62,5,67,10,2011-12-31 11:12:10,2011-12-31 11:12:10
ca4e2ad135061150bb47ec229bed52a25fa49f75...0bd7f91c6608e7cd72349c89494103aed40be22d,1,4,0,4,2,2011-12-16 14:59:43,2011-12-16 14:51:38
ca4e2ad135061150bb47ec229bed52a25fa49f75...0712e78597e5954ea61def4c0a6836a3d5b5d275,4,67,57,124,7,2011-12-15 06:12:24,2011-12-15 06:12:24
0712e78597e5954ea61def4c0a6836a3d5b5d275...ed3f3a0d4ded937b8c9864b006c15ce8148f35c1,4,17,4,21,3,2011-12-15 06:42:24,2011-12-15 06:42:24
ed3f3a0d4ded937b8c9864b006c15ce8148f35c1...42c46f3720d86857ef256ad368226093f7768ecd,5,65,44,109,11,2011-12-15 07:22:24,2011-12-15 07:22:24
42c46f3720d86857ef256ad368226093f7768ecd...f94d51d765b185c53a98f6541cb5b834117f4024,2,8,14,22,3,2011-12-15 19:42:33,2011-12-15 19:42:33
f94d51d765b185c53a98f6541cb5b834117f4024...d9cfb7985e1f68cfbb5e836034b200b1a2d8e4c1,5,75,4,79,7,2011-12-15 21:04:59,2011-12-15 21:04:59
d9cfb7985e1f68cfbb5e836034b200b1a2d8e4c1...7a9fc480809ce50fd34456ae22100ffbe2bbb776,5,12,13,25,11,2011-12-15 21:21:29,2011-12-15 21:21:29
7a9fc480809ce50fd34456ae22100ffbe2bbb776...ccc9bed89365fd4a13253d2491ab45345f04a5c3,7,83,8,91,16,2011-12-15 21:57:46,2011-12-15 21:57:46
ccc9bed89365fd4a13253d2491ab45345f04a5c3...aafb97634a32723a3650d6e2b16e086d749f4663,1,3,3,6,3,2011-12-15 22:00:28,2011-12-15 22:00:28
aafb97634a32723a3650d6e2b16e086d749f4663...fa3cb28cbed677c5cfed0ec004d8a0e6766b2d41,1,70,25,95,2,2011-12-15 22:41:46,2011-12-15 22:41:46
df27ec29f3e0514ad80da95673b5b02e3fb10125...635d3e09b72232b6e92a38de6cc184147e5bcb41,4,27,13,40,11,2012-02-19 19:30:31,2012-02-19 19:30:31
635d3e09b72232b6e92a38de6cc184147e5bcb41...313d96e42b313a0af5ab50fa233bf43e27118b3f,1,1,1,2,1,2012-02-19 19:34:59,2012-02-19 19:34:59
313d96e42b313a0af5ab50fa233bf43e27118b3f...40ac2ebc2129905cc0831f824dc1c6dc824efc90,1,1,1,2,1,2012-02-20 08:38:03,2012-02-20 08:38:03
40ac2ebc2129905cc0831f824dc1c6dc824efc90...5f4a7c3e04f9511be01234b9f2d7bd0134491b22,22,125,94,219,37,2012-02-20 06:38:03,2012-02-20 06:39:03
5f4a7c3e04f9511be01234b9f2d7bd0134491b22...3a33795f2b060913f6c79ba71ff4768dd5e07ce9,3,15,8,23,7,2012-02-20 17:59:39,2012-02-20 17:59:39
3a33795f2b060913f6c79ba71ff4768dd5e07ce9...22f4c1908d0fc2dbce02e74ed03bf65f028d78d6,1,6,1,7,2,2012-02-20 18:04:03,2012-02-20 18:04:03
22f4c1908d0fc2dbce02e74ed03bf65f028d78d6...6a445b42003007cbb6c06f477c4d7a0b175688c1,4,21,27,48,4,2012-02-20 18:37:37,2012-02-20 18:37:37
6a445b42003007cbb6c06f477c4d7a0b175688c1...29c41e9a0e4407ecd009f4527c5a81c6275a8328,5,14,7,21,8,2012-02-20 19:38:59,2012-02-20 19:38:59
29c41e9a0e4407ecd009f4527c5a81c6275a8328...5c492a7089f72c50dc7ee26181dda99b5af529b3,4,7,5,12,4,2012-02-20 19:50:11,2012-02-20 19:50:11
df27ec29f3e0514ad80da95673b5b02e3fb10125...eacea15a2156200fb363508e1bd92fc48226345b,20,432,0,432,25,2012-02-19 17:50:13,2012-02-19 14:35:31
eacea15a2156200fb363508e1bd92fc48226345b...4c1b8558df1a874716989b8217ab0acf97d6da04,8,35,68,103,21,2012-02-19 17:50:13,2012-02-19 17:05:35
4c1b8558df1a874716989b8217ab0acf97d6da04...57271da6126a2ccf84cf93e7a1833fcbcfcd36ab,5,18,11,29,14,2012-02-19 17:50:13,2012-02-19 17:47:49
57271da6126a2ccf84cf93e7a1833fcbcfcd36ab...12ea84fe46b7175e67ac1c683267214bd6c064f8,1,0,4,4,2,2012-02-19 17:54:00,2012-02-19 17:54:00
12ea84fe46b7175e67ac1c683267214bd6c064f8...40ce6c91311e0dbfdf92bff5b2ef74a2b3361de4,1,0,2,2,1,2012-02-19 17:55:37,2012-02-19 17:55:37
40ce6c91311e0dbfdf92bff5b2ef74a2b3361de4...b565cd1972b32071420c51004ba78b6c22cb5742,1,1,1,2,1,2012-02-19 19:16:29,2012-02-19 19:16:29
b565cd1972b32071420c51004ba78b6c22cb5742...85974948e778f5261cc24a2911bd652a91e950da,7,41,4,45,11,2012-02-19 19:52:05,2012-02-19 19:52:05
85974948e778f5261cc24a2911bd652a91e950da...d68f8401b3f0c3a9b2c887122979e83d95409a69,1,6,1,7,1,2012-02-19 19:56:18,2012-02-19 19:56:18
d68f8401b3f0c3a9b2c887122979e83d95409a69...2e1f119f2288a864ddc1ab49d2a4c47a573b47df,1,1,3,4,1,2012-02-19 20:19:31,2012-02-19 20:19:31
2e1f119f2288a864ddc1ab49d2a4c47a573b47df...bdc42488e9b0d297e0773040e077f414b6605c3d,8,42,7,49,11,2012-02-20 17:16:55,2012-02-20 17:16:55
bdc42488e9b0d297e0773040e077f414b6605c3d...49d58492f210faa11bbd4125ffd6b241356da827,3,41,17,58,12,2012-02-20 18:16:55,2012-02-20 18:16:55
49d58492f210faa11bbd4125ffd6b241356da827...621bfdb4aa6c5ef2b031f7c4fb7753eb80d7a5b5,8,40,260,300,8,2012-02-21 17:18:06,2012-02-21 17:18:06
132177c2b7cf3a241ff76d0154b31c7bea6059fc...10df55e11d976a11eb9ff71ff0c0c399d3f01c64,3,3,3,6,3,2011-12-18 10:10:20,2011-12-18 10:10:20
10df55e11d976a11eb9ff71ff0c0c399d3f01c64...f09e15992fcb92b678b1a06e19801d93a306045c,1,12,5,17,2,2011-12-18 16:09:59,2011-12-18 16:09:59
53ce00f74af1d0ac244b718b157f7f1c876e97a2...723104c45f83937cd87bee87ac16d3dfc6ce4d88,16,222,1,223,16,2011-12-29 19:44:16,2011-12-29 19:44:16
53ce00f74af1d0ac244b718b157f7f1c876e97a2...fbf412eaa0ee68812cdbab9e96f194e03fedd334,1,4,2,6,2,2011-12-25 18:06:18,2011-12-25 18:06:18
54fb0f858949ea3fab68861fe74d05a40cd45cfe...a6c88d4d84a7656c0652bb6d00800a26ead7d26a,1,1,1,2,1,2011-12-19 22:07:05,2011-12-19 22:07:05
54fb0f858949ea3fab68861fe74d05a40cd45cfe...a2d3b211892afefe9fe4ccd041391af45501f4b6,16,147,92,239,25,2011-12-19 21:32:59,2011-12-19 21:32:59
98b484b996dd56f42a2c540cdebbba596d7b69cd...32f04fc345352fce0ddcfe9c1c205e94ce185c35,1,1,1,2,1,2012-03-07 17:41:39,2012-03-07 17:41:39
98b484b996dd56f42a2c540cdebbba596d7b69cd...94befdd502e619313534664393f4c72a24c9ebec,13,98,19,117,25,2012-03-07 08:13:43,2012-03-07 08:13:43
94befdd502e619313534664393f4c72a24c9ebec...57ce7124fc958c70dfc366075a62ad19a4195177,1,1,1,2,1,2012-03-07 08:15:43,2012-03-07 08:15:43
57ce7124fc958c70dfc366075a62ad19a4195177...c9b64974c09cc32065280297570be9f57dfc2b31,2,3,3,6,2,2012-03-07 08:16:43,2012-03-07 08:16:43
911abedf25ab6a6d1a55954e7d75b0f2482c97a4...419368f4f4dfe89afee787ee43ec2f0189de0525,1,1,1,2,1,2012-02-05 17:01:13,2012-02-05 17:01:13
419368f4f4dfe89afee787ee43ec2f0189de0525...96b53a9f599f8fc6e32960fea6a15116e20dfd7a,2,3,3,6,3,2012-02-05 17:12:14,2012-02-05 17:12:14
96b53a9f599f8fc6e32960fea6a15116e20dfd7a...e64a174968fc58929e862f8214e700f26ecaa3c0,7,54,41,95,7,2012-02-05 19:26:04,2012-02-05 19:26:04
e64a174968fc58929e862f8214e700f26ecaa3c0...5134aa971cd0fa3e8b0cab61c6b406581ab593e9,1,1,6,7,2,2012-02-05 23:56:26,2012-02-05 23:56:26
5134aa971cd0fa3e8b0cab61c6b406581ab593e9...da3e34c0fdc4de47e6192b8d75ce60be7d89b6d4,2,20,11,31,3,2012-02-06 00:15:45,2012-02-06 00:15:45
da3e34c0fdc4de47e6192b8d75ce60be7d89b6d4...6c416aaac85fe16cd4900a686714627e9a0fcdbc,9,116,26,142,18,2012-02-06 17:40:32,2012-02-06 17:40:32
6c416aaac85fe16cd4900a686714627e9a0fcdbc...422e43989b0e35f3773c7e91f3d04c0baec0fb14,13,135,61,196,19,2012-02-06 20:32:04,2012-02-06 20:32:04
422e43989b0e35f3773c7e91f3d04c0baec0fb14...3d77183c160c57f51f1908bd57312344e34c8524,1,1,1,2,1,2012-02-07 17:21:16,2012-02-07 17:21:16
7279e8c1774f3116dd74ca462447189730f9eff8...14023c4e5a3241d06a8a021bab1183e4a9742b28,6,9,26,35,14,2011-12-30 13:41:39,2011-12-30 13:41:39
14023c4e5a3241d06a8a021bab1183e4a9742b28...26deb7e0b580ca402ffd93d1991381f580447973,2,3,3,6,6,2011-12-30 14:25:45,2011-12-30 14:25:45
26deb7e0b580ca402ffd93d1991381f580447973...98b5c3647bae81fcc010a6f95dc557b7ea6135f6,1,18,0,18,1,2011-12-30 14:26:13,2011-12-30 14:26:13
98b5c3647bae81fcc010a6f95dc557b7ea6135f6...31f3d6efb3b4b3f4ae5ffd64455cc2e26106a61d,1,1,0,1,1,2011-12-30 14:49:58,2011-12-30 14:49:58
f8ad4d2b422af14d57c2c8d49134ef0ef60a1695...afa7f3a17a3f798fa9ff1776b21b0f19e0e51f0c,1,10,1,11,1,2011-12-29 20:00:50,2011-12-29 20:00:50
afa7f3a17a3f798fa9ff1776b21b0f19e0e51f0c...78edd7469cb9a92ae6fb5c84904d5a9999796936,1,1,1,2,1,2011-12-29 21:08:08,2011-12-29 21:08:08
78edd7469cb9a92ae6fb5c84904d5a9999796936...3a597db7739ee0e1703d9daf9f6a869a97542263,1,1,1,2,1,2011-12-29 21:08:26,2011-12-29 21:08:26
3a597db7739ee0e1703d9daf9f6a869a97542263...753d4cb25e2cc39159963c82e164451f43500ccd,1,2,2,4,2,2011-12-29 21:09:46,2011-12-29 21:09:46
753d4cb25e2cc39159963c82e164451f43500ccd...f7b911d23911fa5fb18332495b18c1f4f820f745,3,4,4,8,4,2011-12-29 21:31:27,2011-12-29 21:31:27
f7b911d23911fa5fb18332495b18c1f4f820f745...b85ae02856a522838898442953157006501dde3e,1,4,2,6,1,2011-12-29 21:46:18,2011-12-29 21:46:18
b85ae02856a522838898442953157006501dde3e...65601ade2b5c7f255cba752baee65ead148af58c,4,83,5,88,4,2011-12-29 22:33:26,2011-12-29 22:33:26
65601ade2b5c7f255cba752baee65ead148af58c...46d212832f3d0a4668732a3434e6732c69f6b571,2,11,1,12,2,2011-12-30 13:14:14,2011-12-30 13:14:14
46d212832f3d0a4668732a3434e6732c69f6b571...c973fce6062f2054d69423cf10eecff8f34bb151,1,1,1,2,1,2011-12-30 13:19:23,2011-12-30 13:19:23
c973fce6062f2054d69423cf10eecff8f34bb151...5b4382e12e060528c42bd3e19f61df88d6316785,3,15,0,15,5,2011-12-30 19:59:59,2011-12-30 19:59:59
5b4382e12e060528c42bd3e19f61df88d6316785...99b8b577e92831d9cfe4f98fca4c6b8017c95a7a,8,35,93,128,23,2011-12-31 14:24:10,2011-12-31 14:24:10
99b8b577e92831d9cfe4f98fca4c6b8017c95a7a...b8b6515f935ffc9a27b7a735514dc39e8c092148,2,10,10,20,10,2011-12-31 17:37:14,2011-12-31 17:37:14
b8b6515f935ffc9a27b7a735514dc39e8c092148...df583bf12d4aa5bdffed6d43aa985e937e08e883,5,6,50,56,8,2011-12-31 17:37:51,2011-12-31 17:37:51
df583bf12d4aa5bdffed6d43aa985e937e08e883...dda6b0ab63eb8080e34b4273cfb6aadb7a29c028,1,0,7,7,1,2011-12-31 17:40:38,2011-12-31 17:40:38
2c1b06a10f3cc182c003516f18699998e5e7a1dc...652258201d7d89b1d71caf817316a2a805d797dc,2,10,1,11,3,2012-01-02 19:32:58,2012-01-02 19:32:58
652258201d7d89b1d71caf817316a2a805d797dc...514f7d897330b92f38bcd8baf5a5a4c199358dfb,1,4,8,12,5,2012-01-02 20:34:49,2012-01-02 20:34:49
2c1b06a10f3cc182c003516f18699998e5e7a1dc...2eb56e3d18bc48a3683a0075962393d9978a2cf3,4,0,18,18,4,2012-01-01 17:37:32,2012-01-01 17:37:32
2eb56e3d18bc48a3683a0075962393d9978a2cf3...188e451c7643477cb22bf00674c90cb35cd7556e,1,1,0,1,1,2012-01-01 17:43:08,2012-01-01 17:43:08
ce8eba89135c901fd4f04f1b2385bdbd23f48766...1c22d4f50f6a89c85b17e6b5351bcf351bf35e27,11,71,32,103,21,2012-02-21 20:04:01,2012-02-21 20:04:01
1c22d4f50f6a89c85b17e6b5351bcf351bf35e27...9803e0885e87c4e578d651bd1b1ce300a03f88a7,3,25,9,34,5,2012-02-21 20:46:34,2012-02-21 20:46:34
9803e0885e87c4e578d651bd1b1ce300a03f88a7...fb17234b055377c95ffe1478df3d8375a1080d5a,1,10,6,16,4,2012-02-21 20:51:18,2012-02-21 20:51:18
fb17234b055377c95ffe1478df3d8375a1080d5a...af82b6773b9b81cdac83afb702565207c00bad87,3,6,3,9,4,2012-02-21 21:09:46,2012-02-21 21:09:46
af82b6773b9b81cdac83afb702565207c00bad87...8c40aab120dbc5507ab9cc8d7ad8e2519d6e9f25,16,51,52,103,41,2012-02-21 22:31:18,2012-02-21 22:31:18
fbf412eaa0ee68812cdbab9e96f194e03fedd334...443e21ed92aee684ce7b6581ac30566787e091a8,2,20,2,22,2,2011-12-26 20:36:20,2011-12-26 20:35:25
443e21ed92aee684ce7b6581ac30566787e091a8...5d9f2e7d1582cce02648c54c373083fc8c1f70c8,1,1,1,2,1,2011-12-26 20:44:04,2011-12-26 20:43:38
5d9f2e7d1582cce02648c54c373083fc8c1f70c8...89a03a3453c988bc15fe837aefaa1c2b2d215ace,3,78,10,88,8,2011-12-26 23:37:27,2011-12-26 22:22:15
89a03a3453c988bc15fe837aefaa1c2b2d215ace...0aef2fe437d5f2e46a2de379610352bb97d65f6c,1,1,1,2,1,2011-12-26 23:40:16,2011-12-26 23:39:42
fbf412eaa0ee68812cdbab9e96f194e03fedd334...c144f9edbc7b76ffb406b0f7c99654324670d278,1,3,3,6,1,2011-12-26 14:07:15,2011-12-26 14:07:15
6d5c9698726e268a9cd392a5782c055031bb1bb9...8a1deea58673b66cd99e06877914ef32b15f3944,2,30,8,38,3,2011-12-20 15:07:55,2011-12-20 14:52:04
6d5c9698726e268a9cd392a5782c055031bb1bb9...cff951912734a5aeea0ebb3e4ca01f704004a466,16,210,107,317,36,2011-12-20 06:24:14,2011-12-20 06:24:14
cff951912734a5aeea0ebb3e4ca01f704004a466...321dbb7bac5b2859cd5f30fdee7a1a2f39e122ae,5,26,64,90,8,2011-12-20 06:29:14,2011-12-20 06:29:14
321dbb7bac5b2859cd5f30fdee7a1a2f39e122ae...f80745b7dbcfa6aa41a37b34ec5a9e461231f7d6,4,13,16,29,7,2011-12-20 06:39:14,2011-12-20 06:39:14
f80745b7dbcfa6aa41a37b34ec5a9e461231f7d6...6bdcaccb460cc349b68f34a24b61c782f9e5b2ac,4,16,13,29,7,2011-12-20 06:49:14,2011-12-20 06:49:14
6bdcaccb460cc349b68f34a24b61c782f9e5b2ac...3d4f524dcb7bc8c3fb10daaf49d1dd8504967706,4,18,5,23,8,2011-12-20 06:59:14,2011-12-20 06:59:14
bed70a93f51cda78e7a4b9adae75d10c3763af30...6c83d9332d3e47e3deee0b4fcc89cdff1dff9152,1,1,1,2,1,2012-03-07 19:35:00,2012-03-07 19:35:00
6c83d9332d3e47e3deee0b4fcc89cdff1dff9152...a9ef0bc343e496b14a44be112cfe9fc81af914f0,6,242,456,698,18,2012-03-07 21:55:46,2012-03-07 21:55:46
a9ef0bc343e496b14a44be112cfe9fc81af914f0...d4ebde937804727040faaabb69422b3763d247a8,2,37,32,69,7,2012-03-07 22:15:31,2012-03-07 22:15:31
3d77183c160c57f51f1908bd57312344e34c8524...4d89322d6785580e9a77e2536b8f2a7db8482664,37,298,333,631,64,2012-02-07 23:00:49,2012-02-07 23:00:49
4d89322d6785580e9a77e2536b8f2a7db8482664...f86df73c1ad49346eba2d80138a93e8cdb6ce406,2,3,6,9,2,2012-02-08 17:18:38,2012-02-08 17:18:38
f86df73c1ad49346eba2d80138a93e8cdb6ce406...bbb0d24d5c6a0874af4473a4c23ab9aa17af455f,1,1,1,2,1,2012-02-08 18:26:31,2012-02-08 18:26:31
bbb0d24d5c6a0874af4473a4c23ab9aa17af455f...fcd92f9d958eab891e4a94ffa8b0aad93012acd0,1,15,10,25,2,2012-02-09 07:51:50,2012-02-09 07:51:50
fcd92f9d958eab891e4a94ffa8b0aad93012acd0...fbd5296e32badf6040fec62b43d27de61c1a65c5,7,32,73,105,7,2012-02-09 07:59:04,2012-02-09 07:59:04
fbd5296e32badf6040fec62b43d27de61c1a65c5...cd567ee40b660a5ff571d882ad1492f68dc07e23,8,50,25,75,17,2012-02-09 07:59:14,2012-02-09 07:59:14
cd567ee40b660a5ff571d882ad1492f68dc07e23...c1fe37690ac1403b687503819ad4b61322fcfadb,3,29,6,35,6,2012-02-09 22:07:49,2012-02-09 22:07:49
3d77183c160c57f51f1908bd57312344e34c8524...e3e9db9509a14032b692597b5134446a5adc137f,1,16,3,19,5,2012-02-07 21:58:51,2012-02-07 21:56:53
e3e9db9509a14032b692597b5134446a5adc137f...f5a16663f0b038aeb397bda19ebdefa6ad873955,1,8,3,11,3,2012-02-07 22:32:20,2012-02-07 22:32:20
e29b7d52fc312877d63b453a928bd151450b3d5e...8d7aaf0e5501c472504467b9252dd5bde14a98c8,1,53,46,99,13,2012-01-03 19:46:53,2012-01-03 19:46:53
cbd78922ee43c0124458e2867071f752cae712f4...1ee69714df3bdeea44ed9a572a922995beef958d,4,1,33,34,7,2012-01-14 19:44:08,2012-01-14 19:44:08
1ee69714df3bdeea44ed9a572a922995beef958d...d95cfc6144864065cfce1cf000b081b09389013e,10,38,29,67,14,2012-01-14 21:46:06,2012-01-14 21:46:06
d95cfc6144864065cfce1cf000b081b09389013e...60af43b98197e8338fdca7b23ebbc188908ee1df,2,19,2,21,4,2012-01-15 10:03:29,2012-01-15 10:03:29
60af43b98197e8338fdca7b23ebbc188908ee1df...bed882e647fbef00305eb1db792c1e3b49849baf,2,9,2,11,3,2012-01-15 10:27:55,2012-01-15 10:27:55
8c40aab120dbc5507ab9cc8d7ad8e2519d6e9f25...6ea87c47f0f8a24ae031c3fff17bc913889ecd00,1,2,2,4,2,2012-02-22 15:04:41,2012-02-22 15:04:41
2f7b67161952fc9ab322eba6878511b5f2dd5cf1...9a2a8612769d472503b367fa35e99f6fb2876704,15,100,66,166,20,2011-12-20 20:47:09,2011-12-20 20:47:09
9a2a8612769d472503b367fa35e99f6fb2876704...f9758c726fb07d3045711c48809c72c09e930447,1,1,1,2,1,2011-12-21 07:48:23,2011-12-21 07:48:23
51f7d949917d46d17646c855944ee26a1e3a2cee...9988282e845f76733b43de15d303ef05d38c44ad,1,58,0,58,1,2012-03-09 18:48:33,2012-03-09 18:48:33
9988282e845f76733b43de15d303ef05d38c44ad...cd06d6edacac73ea798d05754fb47c110d9ae0de,4,82,68,150,12,2012-03-09 19:43:46,2012-03-09 19:43:46
cd06d6edacac73ea798d05754fb47c110d9ae0de...5e1b9360b45a261e2cc6af537ef442a4b14dd615,1,6,4,10,4,2012-03-09 22:47:59,2012-03-09 22:47:59
5e1b9360b45a261e2cc6af537ef442a4b14dd615...620e83d01a48b2f64102232883522f00249a8f5b,2,3,3,6,3,2012-03-10 09:32:43,2012-03-10 09:32:43
620e83d01a48b2f64102232883522f00249a8f5b...10887927afe9b8822a62839008dd3d330fd217cc,1,64,0,64,1,2012-03-10 14:57:43,2012-03-10 14:57:43
10887927afe9b8822a62839008dd3d330fd217cc...f0fd720b4a4a53346704947c3122917783f9143d,2,8,0,8,5,2012-03-10 15:48:29,2012-03-10 15:48:29
f0fd720b4a4a53346704947c3122917783f9143d...bd7359b50e0afac245aa5c15ab633f35a7fbfba3,1,6,2,8,2,2012-03-10 20:59:14,2012-03-10 20:59:01
bd7359b50e0afac245aa5c15ab633f35a7fbfba3...a10ad7183e0edd04646b778954de610cf69bbff8,5,30,5,35,6,2012-03-10 21:41:05,2012-03-10 21:41:05
a10ad7183e0edd04646b778954de610cf69bbff8...4d24c3bb215b4d777d938ffdb7e2a37359bf0460,1,10,8,18,1,2012-03-10 21:57:53,2012-03-10 21:57:53
4d24c3bb215b4d777d938ffdb7e2a37359bf0460...d63339ec2fb772a9cb214a300c0ff6dc684e99b2,1,1,1,2,1,2012-03-11 08:47:30,2012-03-11 08:47:30
d63339ec2fb772a9cb214a300c0ff6dc684e99b2...af0b65ddb84bc3cfee58ecbed90326746823690b,2,20,4,24,5,2012-03-11 09:46:15,2012-03-11 09:46:15
af0b65ddb84bc3cfee58ecbed90326746823690b...529282d9de34830d3069cd35dfe7b417c566dedb,1,1,1,2,1,2012-03-11 15:49:09,2012-03-11 15:49:09
d4ebde937804727040faaabb69422b3763d247a8...fc058605c25ae20272f7dcc60396ffd9279bf89b,1,1,1,2,1,2012-03-09 18:04:26,2012-03-09 18:04:26
d4ebde937804727040faaabb69422b3763d247a8...4a05890c4c2d5ad4710000d0319212365eab6864,1,1,1,2,1,2012-03-08 08:44:26,2012-03-08 08:44:26
adcfeae1614e208a960ab99ba817380856563435...a769204ff489bc750c4931ecdb22ef055eac042a,4,50,16,66,5,2012-02-10 02:59:39,2012-02-10 02:59:39
a769204ff489bc750c4931ecdb22ef055eac042a...cc043f32d8bfa7da5e94061806ae56fc11902d71,39,434,334,768,84,2012-02-11 17:56:18,2012-02-11 17:56:18
cc043f32d8bfa7da5e94061806ae56fc11902d71...bc3735004cb45cec5e0e4fa92710897a910a5957,6,122,117,239,58,2012-02-11 18:34:25,2012-02-11 18:34:25
bc3735004cb45cec5e0e4fa92710897a910a5957...cc1ba255d6c5ffdce87a357ba7ccc397a4f4026b,22,125,82,207,41,2012-02-11 21:22:33,2012-02-11 21:22:33
cc1ba255d6c5ffdce87a357ba7ccc397a4f4026b...9511ec846d39ff57aca6ea2e82da47f04477078c,5,13,4,17,6,2012-02-11 22:29:16,2012-02-11 22:29:16
9511ec846d39ff57aca6ea2e82da47f04477078c...c844723a2404f97421c14ed48bbb8fec9fa8f6b7,11,98,71,169,20,2012-02-12 00:38:38,2012-02-12 00:38:38
c844723a2404f97421c14ed48bbb8fec9fa8f6b7...ec01fa29fbb0c7279faaa20479e0858747c0fdfe,3,29,43,72,13,2012-02-12 11:15:41,2012-02-12 11:15:41
ec01fa29fbb0c7279faaa20479e0858747c0fdfe...c0e622eae2f4b940b8488cf5f5e76d34034ae82a,1,2,2,4,1,2012-02-12 15:34:52,2012-02-12 15:34:52
c0e622eae2f4b940b8488cf5f5e76d34034ae82a...0cd873c2d3724bc373e1d8b9e5b32c01e32c1927,8,11,23,34,11,2012-02-12 15:48:17,2012-02-12 15:48:17
0cd873c2d3724bc373e1d8b9e5b32c01e32c1927...48bc4fc214934160af39958c70f3adb6d7e00b5a,5,22,6,28,5,2012-02-12 17:47:37,2012-02-12 17:47:37
48bc4fc214934160af39958c70f3adb6d7e00b5a...ece9f50fb1076c1efee54b4ab3b161f2cac70046,11,180,66,246,22,2012-02-12 21:52:27,2012-02-12 21:52:27
ece9f50fb1076c1efee54b4ab3b161f2cac70046...7fd29a78fa2c67a7aa01a4d3bb368f4f15a411d3,2,19,5,24,2,2012-02-12 22:12:18,2012-02-12 22:12:18
8d7aaf0e5501c472504467b9252dd5bde14a98c8...ac62036320eb786b1abdb2ad4ceb66dee1cdd309,1,1,1,2,1,2012-01-03 23:21:30,2012-01-03 23:21:30
8d7aaf0e5501c472504467b9252dd5bde14a98c8...2dae0e18e09132c0db32c8646d8d11b30cfcb83f,10,85,4,89,11,2012-01-03 22:42:14,2012-01-03 22:42:14
2dae0e18e09132c0db32c8646d8d11b30cfcb83f...495deea7eb5aa4c8b8e2365a351d1c2eedf1010a,1,1,1,2,1,2012-01-03 23:09:48,2012-01-03 23:09:48
495deea7eb5aa4c8b8e2365a351d1c2eedf1010a...2d3b6375f38ac6e3a14fad93f243c258d74b0331,8,40,7,47,14,2012-01-04 00:07:56,2012-01-04 00:07:56
2d3b6375f38ac6e3a14fad93f243c258d74b0331...57ac5fe99fd7c870f1b408ccebbd01960f514636,5,19,2,21,6,2012-01-08 10:20:24,2012-01-08 10:20:24
57ac5fe99fd7c870f1b408ccebbd01960f514636...473445c76fe6d99243a0e6b0247bc79cc47c3e44,7,64,5,69,8,2012-01-08 11:20:20,2012-01-08 11:20:20
8d7aaf0e5501c472504467b9252dd5bde14a98c8...212f400d678d75068ae1a5c57110f273464e6ec1,5,29,12,41,6,2012-01-03 21:39:03,2012-01-03 21:39:03
21b31a675dd314f987276e64c7c5f7aa9b30f4fb...e0fe17ee4a6961d57bb96f594332a1facf82921f,8,18,19,37,11,2012-01-15 15:59:40,2012-01-15 15:59:40
e0fe17ee4a6961d57bb96f594332a1facf82921f...87f07f68bb12075c8181709fccbfc9829ea30c2a,3,84,60,144,15,2012-01-15 17:42:20,2012-01-15 17:42:20
87f07f68bb12075c8181709fccbfc9829ea30c2a...8cc25ef94e540e8512f0c22eb4a506f812e9982f,6,35,18,53,19,2012-01-15 20:36:32,2012-01-15 20:36:32
9e6d0710e927aa8ea834b8a9ae9f277be617ac7d...2be4fe28587669ba3d0efb129fd8fef77b695cf3,1,2,1,3,1,2012-02-23 16:07:54,2012-02-23 15:47:04
9e6d0710e927aa8ea834b8a9ae9f277be617ac7d...7d279f9302151e3c8f4c5df9c5200a72799409b9,9,73,7,80,14,2012-02-22 05:14:54,2012-02-22 05:14:54
7d279f9302151e3c8f4c5df9c5200a72799409b9...81092c01984a481e312de10a28e3f1a6dda182a3,6,71,41,112,12,2012-02-23 19:04:20,2012-02-23 19:04:20
f9758c726fb07d3045711c48809c72c09e930447...56243c0a63a738bcac2c74852f0a9f3db91ad49c,1,1,1,2,1,2011-12-22 13:09:41,2011-12-22 13:09:41
529282d9de34830d3069cd35dfe7b417c566dedb...34ea7fdb36a9ae5619b1fab54bcdd30c41bec0c9,1,1,1,2,1,2012-03-12 02:02:05,2012-03-12 02:02:05
7fd29a78fa2c67a7aa01a4d3bb368f4f15a411d3...41d439401d3e088ec2f6848d7ad078a213f0e4d7,4,8,8,16,4,2012-02-13 18:40:39,2012-02-13 18:40:39
41d439401d3e088ec2f6848d7ad078a213f0e4d7...3f4eb731dfeca1c36de6a74945170fd6d6efb80b,1,1,1,2,1,2012-02-13 18:41:16,2012-02-12 23:49:38
7fd29a78fa2c67a7aa01a4d3bb368f4f15a411d3...5b40a17333cce79cc18d027673f27ea7506f95b6,2,9,18,27,11,2012-02-13 05:43:58,2012-02-13 05:43:58
5b40a17333cce79cc18d027673f27ea7506f95b6...8569317367067355de4546080035596f4b9d5449,1,2,0,2,1,2012-02-13 08:39:35,2012-02-13 08:39:35
7fd29a78fa2c67a7aa01a4d3bb368f4f15a411d3...ee33eae18d65d0d24c75c0eb771cdd24ebb94c0e,1,1,1,2,1,2012-02-12 23:49:38,2012-02-12 23:49:38
ac62036320eb786b1abdb2ad4ceb66dee1cdd309...10b6cb4d376ebf257f453ff5b036f4a075c08303,1,1,0,1,1,2012-01-04 12:47:57,2012-01-04 12:47:57
ac62036320eb786b1abdb2ad4ceb66dee1cdd309...0ebc610e49b92d92e71aaea1ff664bcda121ff80,10,64,4,68,12,2012-01-04 06:17:41,2012-01-04 06:17:41
0ebc610e49b92d92e71aaea1ff664bcda121ff80...05993f90e0cfc3a0e571b2eaa3b4b182a19e979f,2,2,2,4,2,2012-01-04 06:19:41,2012-01-04 06:19:41
7b0cd969e05995b3792aed76ed15b482ed4381a3...caa5a78863289b7703554f845dabc08ca0d53d2c,1,1,1,2,1,2012-01-08 11:32:35,2012-01-08 11:32:35
caa5a78863289b7703554f845dabc08ca0d53d2c...3c9d7b7077f41ab354dd36c42bdd74345993159a,4,6,1,7,4,2012-01-09 11:30:19,2012-01-09 11:30:19
8cc25ef94e540e8512f0c22eb4a506f812e9982f...0ad83a2172e882d4b7aa189da53a69c13d24ceda,8,441,393,834,24,2012-01-16 19:07:57,2012-01-16 19:07:57
0ad83a2172e882d4b7aa189da53a69c13d24ceda...ffc6ab41e0c5e9fa5f2d0ec6962315dfe5676e5d,1,1,1,2,1,2012-01-17 19:03:20,2012-01-17 19:03:20
ffc6ab41e0c5e9fa5f2d0ec6962315dfe5676e5d...809413d9e758547241530001efa35dececfcf787,17,280,269,549,35,2012-01-17 22:04:27,2012-01-17 22:04:27
809413d9e758547241530001efa35dececfcf787...c9ea5f1316473f5ae33b24b673631f421b90a063,10,41,62,103,19,2012-01-17 22:46:13,2012-01-17 22:46:13
c9ea5f1316473f5ae33b24b673631f421b90a063...b7614c714eda948a2db5d7bf507e61e1e7b457da,3,9,8,17,5,2012-01-17 23:00:40,2012-01-17 23:00:40
b7614c714eda948a2db5d7bf507e61e1e7b457da...ccfae827234a4b8acb86d1944b9b5b7bdd68481a,10,101,63,164,13,2012-01-17 23:19:57,2012-01-17 23:19:57
ccfae827234a4b8acb86d1944b9b5b7bdd68481a...3b5a4fa2fd5cdc72865b7dfde20b1ea8741dd6cc,1,1,1,2,1,2012-01-18 11:47:45,2012-01-18 11:47:45
3b5a4fa2fd5cdc72865b7dfde20b1ea8741dd6cc...15c46555274a14f3a90f0c8139e59cf1e96eccfc,27,88,64,152,31,2012-01-18 20:15:45,2012-01-18 20:15:45
15c46555274a14f3a90f0c8139e59cf1e96eccfc...00d7bfda95087297ea4205946092185d77d1a872,7,55,31,86,6,2012-01-19 07:27:23,2012-01-19 07:27:23
00d7bfda95087297ea4205946092185d77d1a872...5e3b7314bdce32006653536e1ce8dbfa5b5ae288,5,12,18,30,8,2012-01-19 19:00:50,2012-01-19 19:00:50
8cc25ef94e540e8512f0c22eb4a506f812e9982f...ca23f27b5b91e41034a54d48a5421689a6640be7,1,1,0,1,1,2012-01-16 06:36:30,2012-01-16 06:36:30
81092c01984a481e312de10a28e3f1a6dda182a3...75f040fbfe4b5af23ff004ad3207c3976df097a8,2,1,1,2,2,2012-02-24 15:39:14,2012-02-24 15:34:00
81092c01984a481e312de10a28e3f1a6dda182a3...e42fb4fda475370dcb0d8f8f1268bfdc7a0cc437,1,1,1,2,1,2012-02-24 15:27:44,2012-02-24 15:27:44
81092c01984a481e312de10a28e3f1a6dda182a3...215a01f63ccdc085f75a48f6f7ab6f2b15b5852c,15,55,46,101,27,2012-02-24 07:16:06,2012-02-24 07:16:06
215a01f63ccdc085f75a48f6f7ab6f2b15b5852c...d41d8ffb02fa74fd4571603548bd7e401ec99e0c,13,53,15,68,15,2012-02-24 20:19:47,2012-02-24 20:19:47
d41d8ffb02fa74fd4571603548bd7e401ec99e0c...292a41cbe295f16f7148913b31eb0fb91f3251c3,7,26,24,50,9,2012-02-24 20:36:44,2012-02-24 20:36:44
c08c776dae6b9807b50ac943ca153d96ebf68705...89a43543e9c229c223ef4d3031e83dc35e3fd3c5,1,1,1,2,1,2011-12-22 19:52:57,2011-12-22 19:52:57
13062458bf3328688f0bfb8f6a62df46af4ff48e...7a6b7a5c50ee3787c284c8803fdf30dffc10cec1,1,249,0,249,1,2012-03-12 12:47:57,2012-03-12 12:47:57
7a6b7a5c50ee3787c284c8803fdf30dffc10cec1...23bf72dc48e0ace9ff4de6db9316883287fdaaed,1,3,0,3,1,2012-03-12 12:51:21,2012-03-12 12:51:21
23bf72dc48e0ace9ff4de6db9316883287fdaaed...4b4dc9e483521c660da97ce8263a42f45f3dec52,1,59,23,82,18,2012-03-13 18:19:03,2012-03-13 18:19:03
13062458bf3328688f0bfb8f6a62df46af4ff48e...92e2303fb338772b7f779d091d225dc5afe261aa,1,3,1,4,1,2012-03-12 10:57:22,2012-03-12 10:57:22
6473977a2f50f2154452c8a213dfc287f033edd4...ae416a76ff235ad5be5aeb41e8f5d207a9c0d95b,5,76,29,105,9,2012-02-13 22:20:23,2012-02-13 22:20:23
ae416a76ff235ad5be5aeb41e8f5d207a9c0d95b...c062e56b4cc8d0397bb709e4f5e3aa251b63aa90,2,7,4,11,4,2012-02-14 18:00:25,2012-02-14 18:00:25
8a6bdf04c899141ef7fb573b979e5b0d71d5fa51...86eb61d3ed1af9f065d9b68f9cd6db986a2169c3,1,1,1,2,1,2012-01-06 20:04:44,2012-01-06 20:04:44
05993f90e0cfc3a0e571b2eaa3b4b182a19e979f...97ba73157462e8cc18020b0c5056742408737770,7,105,30,135,13,2012-01-04 20:19:41,2012-01-04 20:19:41
3c9d7b7077f41ab354dd36c42bdd74345993159a...eb2a25f733e0ed39788022fbe901cb69967d9878,3,22,3,25,7,2012-01-11 23:14:53,2012-01-11 23:12:49
3c9d7b7077f41ab354dd36c42bdd74345993159a...4e703fa151fa1ee7b65b95690b4c215bf9c7106b,1,1,0,1,1,2012-01-11 17:26:40,2012-01-11 17:26:40
3c9d7b7077f41ab354dd36c42bdd74345993159a...22e7f8ffccb91b9d6565f02dfe8c9ef8e6447b3a,1,1,1,2,1,2012-01-11 15:21:15,2012-01-11 15:21:15
3c9d7b7077f41ab354dd36c42bdd74345993159a...c66bc99fb7d22d005cf0de687b9535f8bef52e23,2,16,14,30,2,2012-01-10 18:06:41,2012-01-10 18:06:41
9b6c9fe25389b2f4c4a3d0ca8f2b30991a4e2c30...fc36df92da61ff11def791023f894da0c8fec0b2,3,2,13,15,3,2012-01-19 19:44:10,2012-01-19 19:44:10
fc36df92da61ff11def791023f894da0c8fec0b2...0aa0cb790373e426766596e0270b90310fd49098,2,5,4,9,4,2012-01-19 20:18:30,2012-01-19 20:18:15
0aa0cb790373e426766596e0270b90310fd49098...744814c509a1dc51bb8756fa15e695e2110dec7c,1,0,1,1,1,2012-01-19 20:23:23,2012-01-19 20:23:23
744814c509a1dc51bb8756fa15e695e2110dec7c...e46dab1ac5770e436b6088cb893060b09f2559b4,2,17,1,18,5,2012-01-19 20:54:22,2012-01-19 20:31:34
e46dab1ac5770e436b6088cb893060b09f2559b4...4b06d82f3dbb84d0a3fc4de837186b93f35fc942,2,7,2,9,3,2012-01-19 20:54:22,2012-01-19 20:54:05
4b06d82f3dbb84d0a3fc4de837186b93f35fc942...fde29a82e66e106ad71b83401ef91bbef0a25082,1,1,1,2,1,2012-01-20 07:48:48,2012-01-20 07:48:48
fde29a82e66e106ad71b83401ef91bbef0a25082...8c46123f9902cfb173e0bdc80c3e111eba1b1841,2,2,2,4,3,2012-01-20 07:49:48,2012-01-20 07:49:48
8c46123f9902cfb173e0bdc80c3e111eba1b1841...3d7b35a37d30365088947de0cf85cc7d4af79162,4,34,11,45,8,2012-01-20 07:51:48,2012-01-20 07:51:48
3d7b35a37d30365088947de0cf85cc7d4af79162...f4e3ec29c46752c68b99fa2eb37cfb12463de9f2,7,84,7,91,14,2012-01-21 12:54:32,2012-01-21 12:54:32
f4e3ec29c46752c68b99fa2eb37cfb12463de9f2...f6f72d4b22ceeddaaf06666e132e06b2bc6b3c22,4,35,34,69,8,2012-01-21 13:22:42,2012-01-21 13:22:42
f6f72d4b22ceeddaaf06666e132e06b2bc6b3c22...fa8c0c78136c1a3bcff2bff042affcfee973c6e1,5,69,1,70,5,2012-01-21 16:06:14,2012-01-21 16:06:14
fa8c0c78136c1a3bcff2bff042affcfee973c6e1...c5a48a6a9017d8e138564624a15427b8929606f3,3,40,39,79,6,2012-01-21 17:03:47,2012-01-21 17:03:47
21c141afb1c53a9180a99d2cca29ffa613eb7e3a...460eeb13b7560b40104044973ff933b1a6dbbcaa,1,1,1,2,1,2012-02-24 20:48:27,2012-02-24 20:48:27
89a43543e9c229c223ef4d3031e83dc35e3fd3c5...c0b47d3245a15b12ebe7a6f4154f35ba91396c3c,5,13,2,15,7,2011-12-24 16:28:20,2011-12-24 16:28:20
d0be70bb22b8dbc2571de446f2841c424e46caa1...b73a33ed4de67167572bb000b369acb991bf8ec2,2,3,3,6,3,2012-03-13 18:57:59,2012-03-13 18:57:59
b73a33ed4de67167572bb000b369acb991bf8ec2...0fe36374d88005379001460a74dc4d6359a35d16,1,9,29,38,5,2012-03-13 19:07:30,2012-03-13 19:07:30
0fe36374d88005379001460a74dc4d6359a35d16...781f5aa6fb25b4aed91f711daefdae4bce8d968b,15,45,36,81,12,2012-03-13 20:17:13,2012-03-13 20:17:13
92e2303fb338772b7f779d091d225dc5afe261aa...3ae93e6f971294160bc8e2879bc18d780439f158,1,2,2,4,2,2012-03-12 12:15:48,2012-03-12 12:15:48
c062e56b4cc8d0397bb709e4f5e3aa251b63aa90...a7bcc2eb5ce47a691e2afa3d5e597eb1710600ca,8,38,9,47,11,2012-02-14 21:48:42,2012-02-14 21:48:42
c062e56b4cc8d0397bb709e4f5e3aa251b63aa90...a9fc97db468df2f1ae539c0b54f3c0b8852d7336,1,4,0,4,1,2012-02-14 20:46:56,2012-02-14 20:46:56
dae9cd2af62ed857f8a4b1a3ae65972fb685659f...26fd3e69c9975f0c382e3f61a2a96e3e3f279a8a,1,3,0,3,1,2012-01-07 11:21:35,2012-01-07 11:21:35
dae9cd2af62ed857f8a4b1a3ae65972fb685659f...09caa7c8add0223dcfa45d7602870d602dffc524,1,6,6,12,6,2012-01-07 11:03:31,2012-01-07 11:03:31
dae9cd2af62ed857f8a4b1a3ae65972fb685659f...97e74c5bde3269d4760b55971e7c06b42679f422,2,19,6,25,4,2012-01-07 10:53:01,2012-01-07 10:53:01
c66bc99fb7d22d005cf0de687b9535f8bef52e23...c8b955a44b1897394d6dda349af2f183a820cc28,15,71,61,132,22,2012-01-11 14:37:34,2012-01-11 07:35:21
c66bc99fb7d22d005cf0de687b9535f8bef52e23...9da4d06a87a302f3f37ca95ba5b6e89cc66c0a82,7,78,2,80,8,2012-01-10 20:08:46,2012-01-10 20:08:46
9da4d06a87a302f3f37ca95ba5b6e89cc66c0a82...99bb4a153dc281c859073e0ddfd7c853e07ffe85,11,55391,12,55403,11,2012-01-11 22:26:01,2012-01-11 22:26:01
99bb4a153dc281c859073e0ddfd7c853e07ffe85...7f92534f767fa20357a11c63f973ae3b79cc5b85,5,6,55309,55315,6,2012-01-11 22:33:54,2012-01-11 22:33:54
c5a48a6a9017d8e138564624a15427b8929606f3...e48a0b8eabf4b54342024ed0d2f755d92f48c935,11,40,29,69,22,2012-01-21 21:17:29,2012-01-21 21:17:29
e48a0b8eabf4b54342024ed0d2f755d92f48c935...3c2b3f3f56dc7a85451ca3ff0d3a91997219c81c,1,1,1,2,1,2012-01-21 21:57:47,2012-01-21 21:57:47
c5a48a6a9017d8e138564624a15427b8929606f3...ac689f8aa35cc06832d553a60d8f5a5050381d77,1,1,0,1,1,2012-01-21 20:32:42,2012-01-21 20:32:42
460eeb13b7560b40104044973ff933b1a6dbbcaa...f403da73f5e62794a0447aca879360494b08f678,2,1,2,3,2,2012-02-26 19:38:45,2012-02-26 19:38:45
460eeb13b7560b40104044973ff933b1a6dbbcaa...0347fe2412eb51d3efeccc35210e9268bc765ac5,1,1,1,2,1,2012-02-25 15:41:58,2012-02-25 15:41:58
460eeb13b7560b40104044973ff933b1a6dbbcaa...2b5c61bdece1f7eb2b901ceea7d364065cdf76ac,1,1,1,2,1,2012-02-25 11:03:44,2012-02-25 11:03:44
781f5aa6fb25b4aed91f711daefdae4bce8d968b...5ba2f01cec7f4322ef89969542fd895cf1523d15,1,18,0,18,18,2012-03-13 22:07:13,2012-03-13 22:07:13
781f5aa6fb25b4aed91f711daefdae4bce8d968b...3676838dc96bbe1c8c7eec7e6ca545c462dfc12d,18,90,41,131,30,2012-03-13 21:54:49,2012-03-13 21:54:49
6dc8c10d051d958f84ed5391e3af4fd516a1194c...0592b6a86442c24a7de79ac4ac1642a5cef1f68f,1,1,1,2,1,2012-03-12 13:39:41,2012-03-12 13:39:41
5ac434a60e7714e1248fd37f741f2a96641d4440...ccfeddec46444867b7d459c332216a5a3645f608,1,1,1,2,1,2012-02-14 21:53:41,2012-02-14 21:53:41
ccfeddec46444867b7d459c332216a5a3645f608...b84b485bbe8f9b39729aede42a9fe437f700e26b,2,18,4,22,4,2012-02-14 22:10:01,2012-02-14 22:10:01
6cf000ff52f34d0dd1afc823985adbe072c23515...77164c7bbbbe4e50093f2d3d6d11da13a36a849d,1,3,0,3,1,2012-01-13 14:40:34,2012-01-13 14:40:34
6cf000ff52f34d0dd1afc823985adbe072c23515...84d1dead668d8b4ecbb4317c0e05fedfa27ebbb9,6,62,83,145,16,2012-01-12 07:04:57,2012-01-12 07:04:57
84d1dead668d8b4ecbb4317c0e05fedfa27ebbb9...74632d6aec4cb8c1ffc34bbecae343779ebdf87b,2,13,6,19,5,2012-01-12 07:08:57,2012-01-12 07:08:57
74632d6aec4cb8c1ffc34bbecae343779ebdf87b...0ba081947deaf773fbc3d62186669c0e9a91e105,5,90,15,105,11,2012-01-12 07:28:57,2012-01-12 07:28:57
0ba081947deaf773fbc3d62186669c0e9a91e105...693ff1c6445e5abd4cf29cf9689d22899239597e,9,44,31,75,18,2012-01-13 21:13:44,2012-01-13 21:13:44
693ff1c6445e5abd4cf29cf9689d22899239597e...458f9c5695596f0e05037fef6cb4f820450e0a96,1,5,1,6,1,2012-01-13 21:24:16,2012-01-13 21:24:16
458f9c5695596f0e05037fef6cb4f820450e0a96...621491c677087aa243f165eab467bfdfbee00be1,1,1,0,1,1,2012-01-13 21:28:58,2012-01-13 21:28:58
621491c677087aa243f165eab467bfdfbee00be1...09b877ef29a0c641457eb986c5b228d003c51c16,7,54,42,96,12,2012-01-14 17:54:41,2012-01-14 17:54:41
44c38b32072d8027f64515c76ee68edfc36a775f...8ad7586aa7ec1aa2c54e38aff0fb7f7ba7ab0aa7,1,4,2,6,2,2012-01-21 22:29:20,2012-01-21 22:29:20
8ad7586aa7ec1aa2c54e38aff0fb7f7ba7ab0aa7...8db72a2844deb6fb95350610b45b2bad50a6a7e2,1,12,2,14,3,2012-01-22 11:00:26,2012-01-22 11:00:26
8db72a2844deb6fb95350610b45b2bad50a6a7e2...2cd5aa694de52536f2f7e42d84c3688c9de2fee8,1,6,4,10,2,2012-01-22 11:13:15,2012-01-22 11:13:15
2cd5aa694de52536f2f7e42d84c3688c9de2fee8...3b91a103e023c1b5d013045ae06def1077a6988e,2,20,23,43,3,2012-01-22 11:21:59,2012-01-22 11:21:59
3b91a103e023c1b5d013045ae06def1077a6988e...611c5a87ab0c083a43785323b09cc47f554c3ba4,5,83,1,84,3,2012-01-22 12:25:43,2012-01-22 12:25:43
611c5a87ab0c083a43785323b09cc47f554c3ba4...98d6492582d232ed86525aa31ccbf280f4cbdaef,2,0,6,6,2,2012-01-22 18:52:06,2012-01-22 18:52:06
1e8b111be85df0db6c8000ef9a710bc0221eae83...065c200c33f68c2bb781e35a43f9dc8138a893b5,8,12,13,25,8,2012-02-26 20:06:40,2012-02-26 20:06:40
065c200c33f68c2bb781e35a43f9dc8138a893b5...3a4b4fb4cde7809f033822a171b9feae19d41fff,9,210,240,450,10,2012-02-26 22:21:53,2012-02-26 22:21:53
3a4b4fb4cde7809f033822a171b9feae19d41fff...f0f14c8eaba69ebddd766498a9d0b0e79becd633,11,496,501,997,20,2012-02-26 22:41:53,2012-02-26 22:41:53
f0f14c8eaba69ebddd766498a9d0b0e79becd633...1e689bfba39525ead225eaf611948cfbe8ac34cf,6,108,78,186,24,2012-02-27 17:05:27,2012-02-27 17:05:27
1e689bfba39525ead225eaf611948cfbe8ac34cf...8470d70da67355c9c009e4401746b1d5410af2e3,1,23,28,51,4,2012-02-27 18:29:27,2012-02-27 18:29:27
8470d70da67355c9c009e4401746b1d5410af2e3...cd5c4bac5042c5469dcdf7e7b2f768d3c6fd7088,1,1,1,2,1,2012-02-27 18:34:55,2012-02-27 18:34:55
cd5c4bac5042c5469dcdf7e7b2f768d3c6fd7088...8716fc78f3c65bbf7bcf7b574febd583bc5d2812,1,2,0,2,1,2012-02-27 18:44:13,2012-02-27 18:44:13
8716fc78f3c65bbf7bcf7b574febd583bc5d2812...bcf03b5de6c33f3869ef70d68cf06e679d1d7f9a,2,2,1,3,2,2012-02-27 18:51:12,2012-02-27 18:51:12
bcf03b5de6c33f3869ef70d68cf06e679d1d7f9a...34e15801845f806e0f0f04aff8ba78962f8a9086,8,157,166,323,43,2012-02-27 22:00:19,2012-02-27 22:00:19
b60804bf10e34703d05a40a2545cf50c992ad459...b27f8fd503e2fec68bd116ffd3c3d5857a84f89b,1,1,0,1,1,2012-03-14 09:39:40,2012-03-14 09:39:40
b27f8fd503e2fec68bd116ffd3c3d5857a84f89b...317963b1ab6dcf6cf7ccd4aaa6f5928128651878,1,2,1,3,1,2012-03-14 10:34:03,2012-03-14 10:34:03
317963b1ab6dcf6cf7ccd4aaa6f5928128651878...ed11ca13e80341ed604198426f4d516618e4d23f,2,8,1,9,2,2012-03-14 10:39:33,2012-03-14 10:39:33
ed11ca13e80341ed604198426f4d516618e4d23f...8d8b82127f2563ee24a7621793b19c9c984c199e,6,81,15,96,16,2012-03-14 13:31:31,2012-03-14 13:31:31
8d8b82127f2563ee24a7621793b19c9c984c199e...2d00f2dfe41e1c3a4606f3e0d4657617b82ccb78,6,52,5,57,9,2012-03-14 22:51:03,2012-03-14 22:51:03
2d00f2dfe41e1c3a4606f3e0d4657617b82ccb78...27e36998143adca9427750fc90caec1271a4e3d0,2,8,6,14,6,2012-03-14 22:56:42,2012-03-14 22:56:42
0592b6a86442c24a7de79ac4ac1642a5cef1f68f...71d6582c9f4a51623f9506648717ea8ac6584d86,2,6,5,11,4,2012-03-12 19:51:57,2012-03-12 19:51:41
0592b6a86442c24a7de79ac4ac1642a5cef1f68f...085da857a06e09602108a220bb4cda7a60150788,1,0,1,1,1,2012-03-12 16:02:57,2012-03-12 16:02:57
b84b485bbe8f9b39729aede42a9fe437f700e26b...4aa2b34e794c39548ef2cc2ff3b3e4139ffb4baa,1,5,0,5,1,2012-02-14 22:21:00,2012-02-14 22:21:00
b84b485bbe8f9b39729aede42a9fe437f700e26b...7b3b140004f0b39f10009a01afb042810ea0e864,1,1,1,2,1,2012-02-14 22:15:15,2012-02-14 22:15:15
98d6492582d232ed86525aa31ccbf280f4cbdaef...7157305d5e1ecbedbc24e4e62bdd8af0aea323c5,8,0,59,59,8,2012-01-23 07:54:47,2012-01-23 07:54:47
34e15801845f806e0f0f04aff8ba78962f8a9086...376bec26de89c3d287560e5fe755deeaffc68d67,16,141,39,180,19,2012-02-28 20:59:36,2012-02-28 20:59:36
376bec26de89c3d287560e5fe755deeaffc68d67...5c2e89b279c7f6e9116f41df94fe23f546e5b792,1,1,1,2,1,2012-02-28 21:01:50,2012-02-28 21:01:50
5c2e89b279c7f6e9116f41df94fe23f546e5b792...a1385d11ac2f89ed80f46c3e0afc9fb08caf2f88,1,3,2,5,1,2012-02-28 21:08:11,2012-02-28 21:08:11
34e15801845f806e0f0f04aff8ba78962f8a9086...c9c292f3502c5d06f30b4851a7d02c968ffb9d26,1,1,1,2,1,2012-02-28 19:31:27,2012-02-28 19:31:27
c9c292f3502c5d06f30b4851a7d02c968ffb9d26...b9e23b906e43dba38f8e8a2d0dc27f7154b75df2,2,2,2,4,2,2012-02-28 19:35:35,2012-02-28 19:35:35
34e15801845f806e0f0f04aff8ba78962f8a9086...a847501fd2ffc1c4becc7d0d352d80168d9b3568,9,75,3,78,9,2012-02-28 13:09:23,2012-02-28 13:09:23
a847501fd2ffc1c4becc7d0d352d80168d9b3568...dcdb2fdfdb5b5429c945b7d8f6fecd0b3a2da32a,12,130,25,155,21,2012-02-28 14:01:14,2012-02-28 14:01:14
dcdb2fdfdb5b5429c945b7d8f6fecd0b3a2da32a...fa07c9d662cd73b751812d0def5f09244d6ee895,5,135,106,241,9,2012-02-28 14:48:15,2012-02-28 14:48:15
27e36998143adca9427750fc90caec1271a4e3d0...cbc56a96ace7f89c1eca260ca0a29ad140d27a99,3,13,4,17,5,2012-03-15 11:03:56,2012-03-15 11:03:56
27e36998143adca9427750fc90caec1271a4e3d0...5a3f23f395eef87bf3457e6474bac82333e71ec8,10,121,28,149,20,2012-03-14 22:57:43,2012-03-14 22:57:43
5a3f23f395eef87bf3457e6474bac82333e71ec8...a4993f16c0239c8615b8d068c6e53415209f8cb1,3,18,4,22,3,2012-03-15 17:39:03,2012-03-15 17:39:03
085da857a06e09602108a220bb4cda7a60150788...d2eb823296b2ad8631e14f3bedc19497ba75b07f,1,1,1,2,1,2012-03-12 19:58:41,2012-03-12 19:58:41
3230577ce0d5eb381cd0aad2fc4a4e9a3687e928...65e4ad31476978e7f1c5cef41eb5a21e6068cbb2,2,5,1,6,2,2012-02-14 22:33:54,2012-02-14 22:33:26
65e4ad31476978e7f1c5cef41eb5a21e6068cbb2...ef396d08fc9af54f0e2c69da27d64e13064e0dfb,3,8,4,12,4,2012-02-14 22:41:51,2012-02-14 22:41:36
93a5b3d811ded5e0dd94b92c5babef4dbeddb902...421451cf0980cdab63869b8b0c4c8f41c61a7fc9,2,5,5,10,3,2012-02-28 21:17:12,2012-02-28 21:17:12
421451cf0980cdab63869b8b0c4c8f41c61a7fc9...85954621a33a5be40baaa07d9cfc1b8a0fc7ebea,2,321,0,321,2,2012-02-28 22:45:38,2012-02-28 22:45:38
85954621a33a5be40baaa07d9cfc1b8a0fc7ebea...0a0710a548b0d1f722c0f58b0fef5bbfc71ef831,16,310,104,414,23,2012-02-29 09:15:58,2012-02-28 18:09:23
796784c7c8d385b72cd1e4b5a8f0885d630586fb...bb164ebf1bd672527a76a6699427cbec728d638b,15,107,11,118,22,2012-02-29 20:38:24,2012-02-29 20:38:24
bb164ebf1bd672527a76a6699427cbec728d638b...25bde28d13cdffda8efa4ecae00985085e6aa565,6,27,13,40,17,2012-02-29 21:04:09,2012-02-29 21:04:09
25bde28d13cdffda8efa4ecae00985085e6aa565...f6f939eeb8e2864564942885e9254ca7670b75e7,1,23,2,25,1,2012-02-29 21:21:23,2012-02-29 21:21:23
f6f939eeb8e2864564942885e9254ca7670b75e7...1924de91c58a429452edd97b181520abd9968bf7,2,6,2,8,2,2012-02-29 21:34:06,2012-02-29 21:34:06
945702a3ea95ab0d39938da5c1c075fd980736f4...f59ec80412e797d42de998ffcfab533f4dfdf991,1,10,0,10,1,2012-03-17 01:40:36,2012-03-17 01:40:36
f59ec80412e797d42de998ffcfab533f4dfdf991...582feb700577fd76bdcfa6a29fd3e2b580a5ca8a,1,7,7,14,1,2012-03-17 01:42:54,2012-03-17 01:42:54
582feb700577fd76bdcfa6a29fd3e2b580a5ca8a...b6fdb8557b938e1c32c9923dfd5847af997ca795,1,2,2,4,2,2012-03-17 02:43:28,2012-03-17 02:43:28
b6fdb8557b938e1c32c9923dfd5847af997ca795...8a9e90dac5d6e8d37a980e62282bd193141640fc,1,1,1,2,1,2012-03-17 02:48:29,2012-03-17 02:48:29
8a9e90dac5d6e8d37a980e62282bd193141640fc...94fd9a6e4713d26bcf8bbfa91b53b84810567d8c,4,15,5,20,6,2012-03-17 03:24:40,2012-03-17 03:24:40
94fd9a6e4713d26bcf8bbfa91b53b84810567d8c...7e2f489017ddf643556fc453efaa1f7906861a30,1,5,0,5,1,2012-03-17 04:17:37,2012-03-17 04:17:37
7e2f489017ddf643556fc453efaa1f7906861a30...4dc13316768ba89cbf1f48dfc3e7bfffd54b5b1d,1,2,2,4,2,2012-03-17 05:09:16,2012-03-17 05:09:16
4dc13316768ba89cbf1f48dfc3e7bfffd54b5b1d...3263f2e1ab94dc1d15965edfd56b7104eb570e3e,1,3,1,4,1,2012-03-17 05:13:36,2012-03-17 05:13:36
3263f2e1ab94dc1d15965edfd56b7104eb570e3e...7712d81f9bb3cdfdf3051ba6fc287ce53b1006b1,1,5,9,14,3,2012-03-17 05:17:04,2012-03-17 05:17:04
7712d81f9bb3cdfdf3051ba6fc287ce53b1006b1...1b96985025f8aa2044ad489aef96886030337831,1,17,11,28,3,2012-03-17 05:22:12,2012-03-17 05:22:12
1b96985025f8aa2044ad489aef96886030337831...c93fda2737a0edc093011b3b81d82eab0a05628c,1,1,0,1,1,2012-03-17 05:24:51,2012-03-17 05:24:51
c93fda2737a0edc093011b3b81d82eab0a05628c...1c2c860c22ee960c1db4e82cb34519425394713b,2,15,2,17,3,2012-03-17 05:46:47,2012-03-17 05:46:47
1c2c860c22ee960c1db4e82cb34519425394713b...aeed7da6d44e46ace9e037acb9e46ac375b8a227,1,1,1,2,1,2012-03-17 05:48:22,2012-03-17 05:48:22
aeed7da6d44e46ace9e037acb9e46ac375b8a227...9cbd1aef20652b136b76b9efeb2564739aa57647,1,1,1,2,1,2012-03-17 06:31:38,2012-03-17 06:31:38
9cbd1aef20652b136b76b9efeb2564739aa57647...2228f1b1ad2d82a40413a0d3042567e5e0c8b051,1,11,0,11,1,2012-03-17 15:49:23,2012-03-17 15:49:23
2228f1b1ad2d82a40413a0d3042567e5e0c8b051...66d64ad4f480091d0a73ac831495071050fa7d0d,2,18,3,21,4,2012-03-17 16:02:48,2012-03-17 16:02:48
66d64ad4f480091d0a73ac831495071050fa7d0d...c43ac3c7212b3f64f8a23c0ec362d98a1f123679,2,2,2,4,2,2012-03-17 16:13:42,2012-03-17 16:13:42
c43ac3c7212b3f64f8a23c0ec362d98a1f123679...550274e136811fff6ecadf51e285d8e850399e75,2,11,7,18,5,2012-03-20 00:32:08,2012-03-20 00:32:08
550274e136811fff6ecadf51e285d8e850399e75...2a7cd2f1b5ed824bafafeb2004746a384be44453,1,2,2,4,1,2012-03-20 00:43:25,2012-03-20 00:43:25
2e2e0522d4777b457edb207758cb18520c6930fe...5fdcbedab4ea8ea42f60af275aff30d29a84d3e8,2,8,3,11,8,2012-03-15 17:49:36,2012-03-15 17:49:36
5fdcbedab4ea8ea42f60af275aff30d29a84d3e8...cf68adda4b77ec9dae63f717f965df887e1b5d9a,1,2,2,4,2,2012-03-15 18:06:26,2012-03-15 18:06:26
cf68adda4b77ec9dae63f717f965df887e1b5d9a...828f84fdb35a61c3de93226c1a6cd5c6be68c263,1,3,3,6,3,2012-03-15 21:01:50,2012-03-15 21:01:50
828f84fdb35a61c3de93226c1a6cd5c6be68c263...7b75f3cfd34820ecdf0eddb7703bdba1e4c23f9f,3,16,1,17,3,2012-03-15 21:32:00,2012-03-15 21:32:00
7b75f3cfd34820ecdf0eddb7703bdba1e4c23f9f...b2c13bdd777838e9837b12e56854e152b8a13f0c,2,13,1,14,2,2012-03-15 21:44:04,2012-03-15 21:44:04
b2c13bdd777838e9837b12e56854e152b8a13f0c...5d2bd5ec3a6d1c9ceb985e0af684f162926b0555,13,127,4,131,13,2012-03-15 23:14:39,2012-03-15 23:14:39
5d2bd5ec3a6d1c9ceb985e0af684f162926b0555...7f76d6cfee7f95e6d89691431540e8d948ca60ec,4,23,3,26,4,2012-03-15 23:31:46,2012-03-15 23:31:46
faaa8a2938ae8e1d13cf42c484a447f22a9579d3...e44ee826ac1cb21d3af54381608c225e0644b79b,12,10,5,15,6,2012-03-12 21:52:10,2012-03-12 21:52:10
ef396d08fc9af54f0e2c69da27d64e13064e0dfb...8d493019c4d2205a1020e6e72ca4f9a92534193f,6,40,50,90,16,2012-02-14 23:15:02,2012-02-14 23:15:02
ef396d08fc9af54f0e2c69da27d64e13064e0dfb...c5a9e3cb1b20c916653f670ff7149169f899ca9d,1,1,1,2,1,2012-02-14 22:43:13,2012-02-14 22:42:46
7f76d6cfee7f95e6d89691431540e8d948ca60ec...f4646f970eb142a531e5f6676515a927dc660549,1,1,1,2,1,2012-03-16 12:58:49,2012-03-16 12:58:49
7f76d6cfee7f95e6d89691431540e8d948ca60ec...e2b39517003bb2045f63c2653471275cbbbc1c10,1,28,0,28,1,2012-03-15 23:32:46,2012-03-15 23:32:46
e2b39517003bb2045f63c2653471275cbbbc1c10...2ec12c9bb81b28add0b1d7404822d8312ed08d77,13,101,70,171,27,2012-03-15 23:45:46,2012-03-15 23:45:46
2ec12c9bb81b28add0b1d7404822d8312ed08d77...341b4414ea0e0b289089f1895e61e0c14051f4d9,4,12,5,17,6,2012-03-16 18:11:03,2012-03-16 18:11:03
98f040a56f7f40613b12aebc2119bdd770ee2648...3a9e5a9357b6b0cac2acdefa203136c9b572e102,1,7,0,7,1,2012-02-15 06:46:09,2012-02-15 06:46:09
3a9e5a9357b6b0cac2acdefa203136c9b572e102...37224dc9c1ee80ba9030b616e2bc87bd96919e09,14,229,53,282,23,2012-02-15 20:02:33,2012-02-15 20:02:33
37224dc9c1ee80ba9030b616e2bc87bd96919e09...dac7c44ab357d703381c2beafd2e04996794fa45,15,164,66,230,28,2012-02-15 21:51:04,2012-02-15 21:51:04
dac7c44ab357d703381c2beafd2e04996794fa45...1c62ec09b0fe8d51e9b375714c560eded1b35d51,18,66,111,177,49,2012-02-16 07:03:55,2012-02-16 07:03:55
1c62ec09b0fe8d51e9b375714c560eded1b35d51...9dfbcc6ef39a4eeba82867cc7a9948f68537553f,1,1,1,2,2,2012-02-16 07:04:55,2012-02-16 07:04:55
9dfbcc6ef39a4eeba82867cc7a9948f68537553f...9a24ccdea1dd4dc82ac7f24c1fa1706a20949898,2,6,2,8,3,2012-02-16 07:04:56,2012-02-16 07:04:56
d87abbe9af31a7183a53062518d3fbc0bdd8d218...724ea16c348bc61cf7cb3dbe362c6f30cff1b2c7,17,121,72,193,32,2012-03-19 20:52:16,2012-03-19 20:52:16
724ea16c348bc61cf7cb3dbe362c6f30cff1b2c7...cadf12c60cc27c5b0b8273c1de4b190a0e88bd7d,9,11,65,76,14,2012-03-19 22:05:35,2012-03-19 22:05:35
9a24ccdea1dd4dc82ac7f24c1fa1706a20949898...94db8a1c334b9ff5a0c28c89cb87ffa882095261,21,192,91,283,44,2012-02-18 12:12:48,2012-02-18 12:12:48
94db8a1c334b9ff5a0c28c89cb87ffa882095261...fa7bd43ab9ac6e5885705aabc036660de5edbe1b,7,388,1,389,8,2012-02-18 12:43:35,2012-02-18 12:43:35
fa7bd43ab9ac6e5885705aabc036660de5edbe1b...3f91da6816150f1e3b9c7747c7402b543f1d681a,19,102,80,182,32,2012-02-18 13:59:01,2012-02-18 13:59:01
9a24ccdea1dd4dc82ac7f24c1fa1706a20949898...2bb2dee057327c81978ed0aa99904bd7ff5e6105,2,6,6,12,3,2012-02-17 17:10:50,2012-02-17 17:10:50
6c40e89853a8211c3108245cd92063da0eb0a46b...46605c9175f6648219e8193904f1af267e98a7ce,3,46,3,49,4,2012-03-24 16:08:42,2012-03-24 16:08:42
46605c9175f6648219e8193904f1af267e98a7ce...194467b8f82dc6ae8a01679276e256efb153856f,2,6,2,8,4,2012-03-24 16:19:20,2012-03-24 16:19:20
194467b8f82dc6ae8a01679276e256efb153856f...b91128cc6a59f687899208f34b8d27fdfc6432ef,2,1,4,5,2,2012-03-24 16:26:25,2012-03-24 16:26:25
b91128cc6a59f687899208f34b8d27fdfc6432ef...fb4c033aeb8317f082045125e492d2afdaf1d01c,1,3,3,6,3,2012-03-24 16:30:04,2012-03-24 16:30:04
fb4c033aeb8317f082045125e492d2afdaf1d01c...e5fa0bb127a5fda436a484a079604fc3b9098a48,2,9,11,20,5,2012-03-24 16:40:21,2012-03-24 16:40:21
e5fa0bb127a5fda436a484a079604fc3b9098a48...597afb7ce23cf3b64903f37b4ab5a77f587c98bf,2,10,2,12,2,2012-03-24 16:53:16,2012-03-24 16:53:16
597afb7ce23cf3b64903f37b4ab5a77f587c98bf...c2c4424ff82a4325129a3d14a4d18099a368050c,2,3,2,5,3,2012-03-24 16:57:01,2012-03-24 16:57:01
c2c4424ff82a4325129a3d14a4d18099a368050c...27244e0c9e1128902615c834cd1fdedc1dbdb4e2,1,1,1,2,1,2012-03-24 17:01:38,2012-03-24 17:01:38
27244e0c9e1128902615c834cd1fdedc1dbdb4e2...a805d3131f7321e6f24a1f986ef1e7704ef9a734,5,16,3,19,4,2012-03-24 17:36:14,2012-03-24 17:36:14
a805d3131f7321e6f24a1f986ef1e7704ef9a734...c359db385295320206973caa499083937ce13bb2,1,0,0,0,0,2012-03-24 17:38:10,2012-03-24 17:38:10
c359db385295320206973caa499083937ce13bb2...d3cb694edbe2fd9cd6cb1e8cb53623cd8919a745,2,1,0,1,1,2012-03-24 17:42:45,2012-03-24 17:42:45
d3cb694edbe2fd9cd6cb1e8cb53623cd8919a745...54dc2d5c3242fc7aa700b0f1961c6801ec48ac9c,1,1,1,2,1,2012-03-24 21:19:26,2012-03-24 21:19:26
54dc2d5c3242fc7aa700b0f1961c6801ec48ac9c...3c9a18a0bfd7f79922325dde353d0fa458dcf9c0,1,2,0,2,1,2012-03-24 21:31:01,2012-03-24 21:31:01
cadf12c60cc27c5b0b8273c1de4b190a0e88bd7d...b57faf9282d7df6cdd62953d474652a0ae2e6896,5,21,9,30,8,2012-03-20 21:59:35,2012-03-20 21:59:35
3f91da6816150f1e3b9c7747c7402b543f1d681a...4748ae8c8ce59135d53fd40ab045bb3e08ac8adb,2,3,3,6,3,2012-02-18 15:37:58,2012-02-18 15:37:58
b1d89f732c356e1b9792558556f65d1993db7f3a...8652cd89897e324b9cb0974a61ff045e68d5c97e,9,80,90,170,31,2012-03-25 16:05:24,2012-03-25 16:05:24
8652cd89897e324b9cb0974a61ff045e68d5c97e...39ea486e1f9701f2a6e91155d2dfd205edd4c94e,9,35,33,68,23,2012-03-25 16:44:29,2012-03-25 16:44:29
b57faf9282d7df6cdd62953d474652a0ae2e6896...8bb4c6de5649f4ecc3970c48c45ec5e207c556c5,1,3,4,7,2,2012-03-21 21:59:12,2012-03-21 21:59:12
b57faf9282d7df6cdd62953d474652a0ae2e6896...2adbb3b3455563a3a7ef2ba4e7f31194df95e0ab,1,1,1,2,1,2012-03-21 12:53:38,2012-03-21 12:53:38
39ea486e1f9701f2a6e91155d2dfd205edd4c94e...73404f6281f46b4dd68e5ebde48a242ed8adacc5,11,18,20,38,16,2012-03-26 09:11:02,2012-03-26 09:11:02
39ea486e1f9701f2a6e91155d2dfd205edd4c94e...dfe9f3674c6e91f34fa6c63f474ff2cc7e8ed535,2,11,1,12,5,2012-03-26 04:40:51,2012-03-26 04:40:51
ce51525ec7e8b4aafd6f2e967a48b72f65c8c3c3...039b6db483fff2aaeaa19a46018232626e6a0eba,2,6,2,8,2,2012-03-21 22:09:53,2012-03-21 22:09:53
f1c534c68eecf68c72ce401e30c3d7d846052885...7d56a51bdcffa2413a68779e4899e8139c1ba4f9,14,41,54,95,17,2012-03-26 18:41:58,2012-03-26 18:41:58
7d56a51bdcffa2413a68779e4899e8139c1ba4f9...788de6f1c8a60e908a584eb251f9c88f5bc8abbd,3,38,20,58,8,2012-03-26 19:41:56,2012-03-26 19:41:56
788de6f1c8a60e908a584eb251f9c88f5bc8abbd...1647f46b1f3e442c94dd58864b564e137f7fa04d,2,35,34,69,4,2012-03-26 20:11:15,2012-03-26 20:11:15
1647f46b1f3e442c94dd58864b564e137f7fa04d...3b4e7b315b598d10cf4c1a19d4a23b9da5ce12bf,1,17,0,17,1,2012-03-27 13:17:23,2012-03-27 13:17:23
039b6db483fff2aaeaa19a46018232626e6a0eba...e6153beda8527c7246565ff7deae93c766d6d2cb,1,5,9,14,1,2012-03-22 13:34:16,2012-03-22 13:34:16
039b6db483fff2aaeaa19a46018232626e6a0eba...6e5999a69b660aa482872743533ed0340994e535,2,29,2,31,3,2012-03-21 22:09:54,2012-03-21 22:09:54
6e5999a69b660aa482872743533ed0340994e535...1fefd7cbd3ef65d34c36f2b4dd8cedb29200c569,2,21,3,24,2,2012-03-21 22:09:55,2012-03-21 22:09:55
1fefd7cbd3ef65d34c36f2b4dd8cedb29200c569...755a894c911d6eb5604b97bee758306c41cd8d4a,20,107,5,112,15,2012-03-21 22:09:56,2012-03-21 22:09:56
755a894c911d6eb5604b97bee758306c41cd8d4a...52d8ed9e4f716f7bf89bc544aa38a810a007f244,6,24,17,41,11,2012-03-21 22:09:57,2012-03-21 22:09:57
52d8ed9e4f716f7bf89bc544aa38a810a007f244...e241d1e6700f88ecd5aef481596fa1cc782841f0,3,10,2,12,3,2012-03-22 18:02:38,2012-03-22 18:02:38
e241d1e6700f88ecd5aef481596fa1cc782841f0...6f2c19320464c928e3dae0373a7af315bf5fb043,1,1,1,2,1,2012-03-22 18:09:47,2012-03-22 18:09:47
6f2c19320464c928e3dae0373a7af315bf5fb043...81da8e46f24913ccf42d3e2644962cbcbc0f9c2e,7,40,24,64,12,2012-03-22 20:28:02,2012-03-22 20:28:02
81da8e46f24913ccf42d3e2644962cbcbc0f9c2e...fa8219e0a753e642a6f1dbdfc010d01ae8a949ee,2,13,11,24,7,2012-03-22 20:57:04,2012-03-22 20:57:04
3b4e7b315b598d10cf4c1a19d4a23b9da5ce12bf...2519ecf686a8821e75a9a5bc271615be04e89059,1,3,3,6,3,2012-03-27 13:42:23,2012-03-27 13:42:23
6af33483fc9050f4990a96495c95da3d94fdf364...255a9e0325471aa270a65201a0b43c77823faf06,1,1,1,2,1,2012-03-23 21:00:05,2012-03-23 21:00:05
6af33483fc9050f4990a96495c95da3d94fdf364...47af1b7fe87ec933ac7e0d9ef8d873fc99a2fad7,1,1,1,2,1,2012-03-23 10:18:18,2012-03-23 10:18:18
fa8219e0a753e642a6f1dbdfc010d01ae8a949ee...34b624147495df4dd1b15c91a640515c693f243d,1,1,1,2,1,2012-04-12 16:05:19,2012-04-12 16:05:19
fa8219e0a753e642a6f1dbdfc010d01ae8a949ee...76ebdd051fde9fc08575b3ea546b7ed63b6f8e46,1,2,1,3,1,2012-04-01 18:15:18,2012-04-01 17:58:40
fa8219e0a753e642a6f1dbdfc010d01ae8a949ee...6e27350aac1ed5616352af343bac2f8eefc7a840,3,19,12,31,3,2012-03-23 15:35:55,2012-03-07 11:16:52
fa8219e0a753e642a6f1dbdfc010d01ae8a949ee...b9b65b8d4e15bc7eec521b27f385ed62fb08d23f,1,1,1,2,1,2012-03-23 14:59:54,2012-02-24 14:35:44
4b96907e7cc7cef55034499c2d5c5d0998637c99...474a42cfbd939f644eb5d900e447dae48142508a,1,14,12,26,2,2012-03-27 13:59:25,2012-03-27 13:59:25
fea64946662a6043ec96c53bf2982d4f51ca4879...1c6df8e075abf87c6911be7ca9a691d48b7d4009,9,139,81,220,22,2012-03-23 23:01:36,2012-03-23 23:01:36
a1d59d8053303a2c96f889aa17bfff7d4a48b857...c530543c1a2db47866f3b695f46b57b043c01d97,4,99,21,120,7,2012-04-14 10:38:12,2012-04-13 22:46:11
c530543c1a2db47866f3b695f46b57b043c01d97...d9ba277ee1f175ef67e1e9358804d0727bf455ce,1,6,0,6,3,2012-04-14 10:38:12,2012-04-13 23:25:01
d9ba277ee1f175ef67e1e9358804d0727bf455ce...ad25dac8b6e7884a333591a6337bd38f3eea0740,2,30,11,41,7,2012-04-14 10:38:12,2012-04-14 09:58:43
a8768ffb9d39596d8e9da77c879007e8e655fb5d...6aabf1157aa94ddd504e8d01a146c98583a1f182,2,2,2,4,2,2012-04-01 19:44:12,2012-04-01 19:44:02
27cd6c758db00bf9eade4c7b5bf4c41ddd48ff85...46906ca9db15b263acf860874832d01f1efce706,3,19,26,45,9,2012-03-27 21:31:14,2012-03-27 21:31:14
474a42cfbd939f644eb5d900e447dae48142508a...442d5dbef2d0ffbb40cc9ea8de708c00011e2712,3,24,20,44,11,2012-03-27 20:04:21,2012-03-27 20:04:21
1c6df8e075abf87c6911be7ca9a691d48b7d4009...51ab128337dc15bb40081fcfb276309342040544,1,1,1,2,1,2012-03-24 07:38:32,2012-03-24 07:38:32
a7ed8276d7d9448f454f7bbfe8b4a3fb305ae446...c0df0cd70c9036c2b3bf11f823d61a3618e6d16a,6,97,98,195,18,2012-04-15 22:10:09,2012-04-15 22:10:09
c0df0cd70c9036c2b3bf11f823d61a3618e6d16a...c9def945d4222eeb8026a0311495259bf99267a1,13,231,109,340,43,2012-04-16 20:33:03,2012-04-16 20:33:03
c9def945d4222eeb8026a0311495259bf99267a1...f1795a491145740235fd36560bf630d1773cf07a,4,76,34,110,11,2012-04-16 21:22:59,2012-04-16 21:22:59
f1795a491145740235fd36560bf630d1773cf07a...3250a024ef82bc6bb89f7c1dafdc824b6e09439b,6,20,8,28,10,2012-04-17 17:27:18,2012-04-17 17:27:18
3250a024ef82bc6bb89f7c1dafdc824b6e09439b...ac7bb206826dc74aea7d6566a49d781521d7c032,1,0,4,4,1,2012-04-17 17:35:27,2012-04-17 17:35:27
ac7bb206826dc74aea7d6566a49d781521d7c032...3b7998e19789e69cb483e05496900b8159c732df,1,5,4,9,5,2012-04-17 18:03:01,2012-04-17 18:03:01
3b7998e19789e69cb483e05496900b8159c732df...5ef3b384291252e4d2394186ec27685b9376eabe,4,29,5,34,7,2012-04-17 19:08:07,2012-04-17 19:08:07
8dc2989665bc6a568fbeba1aec9e9cc8d480fbae...5f31989a0501c12ae609709f8707841ec3fc7e31,4,51,22,73,6,2012-04-14 08:16:11,2012-04-14 08:16:11
5f31989a0501c12ae609709f8707841ec3fc7e31...95fde9bd7a1fb0a902c33f03f641909043df4125,13,37,208,245,23,2012-04-14 08:20:45,2012-04-14 08:20:45
95fde9bd7a1fb0a902c33f03f641909043df4125...86d7b4f152b806b0f53c801a88b7fba016943a94,1,0,26,26,1,2012-04-14 08:36:53,2012-04-14 08:36:53
3ac9c3ad7f0fc4e42e59d0e1fa0bce72dbd9e86b...00dc34e1929e914d1f4f194888d9d94e513fdaa5,11,139,126,265,25,2012-04-01 21:24:45,2012-04-01 21:24:45
bae4efa7cf1ebedc0f74627da599a4cd5e93fd7f...88d9569a33a3c66ed34db45c9b6cf4e04ea0fcf3,7,297,277,574,13,2012-03-28 07:44:51,2012-03-28 07:44:51
88d9569a33a3c66ed34db45c9b6cf4e04ea0fcf3...69ef81404c7a8fba315b28d850fc9cf2da801a84,12,94,79,173,24,2012-03-28 07:46:51,2012-03-28 07:46:51
bae4efa7cf1ebedc0f74627da599a4cd5e93fd7f...d706805c003fd845f64ea1c78c03efd687da7f38,1,27,22,49,13,2012-03-28 07:07:24,2012-03-28 07:07:24
1bb804da7f3b1784dac2a6e9041216da77cb04fe...cfe86765946325dbe419b648889b4e6933f91711,1,44,0,44,1,2012-03-27 20:11:14,2012-03-27 20:11:14
cfe86765946325dbe419b648889b4e6933f91711...671424a8e76e60177b78db291f7f5d202edf1acd,1,1,1,2,1,2012-03-27 20:15:09,2012-03-27 20:15:09
1fd080687dc4e84429e5fd90bb15cc2bd12b1a9d...fd1e7e2b212168b320dbb41abfcf77a5db24a729,1,1,1,2,1,2012-03-24 23:07:21,2012-03-24 23:07:21
5ef3b384291252e4d2394186ec27685b9376eabe...8b5ef3c24fb4aa277239aeade47edaf3114fc831,1,6,6,12,6,2012-04-18 01:34:14,2012-04-18 01:34:14
5ef3b384291252e4d2394186ec27685b9376eabe...4e97ac2e3bd1d76ceb7b2c5f63869fd7575fe3f2,1,2,2,4,2,2012-04-18 00:49:02,2012-04-18 00:49:02
be5359c695ae8f5583da1c5117e075d35e86c362...f1799a239ff6773d94942df23f85639193bff596,1,1,1,2,1,2012-04-02 05:50:37,2012-04-02 05:50:37
f1799a239ff6773d94942df23f85639193bff596...c9db6bb3f2bea55cbb2bf3073cbb2a4c73c104fa,2,17,3,20,3,2012-04-02 16:51:20,2012-04-02 16:51:20
c9db6bb3f2bea55cbb2bf3073cbb2a4c73c104fa...a264ef2f03ac038e894d6a85eab1e7354be94556,1,1,0,1,1,2012-04-02 17:29:39,2012-04-02 17:29:39
a264ef2f03ac038e894d6a85eab1e7354be94556...c40c627a3ba4b282bf42e247dff5eb13aa6ca790,2,58,58,116,6,2012-04-02 18:13:44,2012-04-02 18:13:44
be5359c695ae8f5583da1c5117e075d35e86c362...5d7954b532ad083f8e56b3db459f41dd00078756,1,5,5,10,3,2012-04-01 23:59:56,2012-04-01 23:57:09
ef32e01b4c365858582ba1c400bfba8b1558fd8d...8ee0993fdf783ad12823ff817cd531df0bc363eb,4,78,2,80,6,2012-03-28 19:53:45,2012-03-28 19:53:45
ea818346a941d1a791cb655e543d29ef6c528e12...3f1a004c475a9b2b0257c4390e34e0fcebb3a6ff,1,3,3,6,3,2012-04-19 11:01:58,2012-04-19 11:01:58
c40c627a3ba4b282bf42e247dff5eb13aa6ca790...43f5df21a39e0b9b16738bbd9e4047507bbcc9ef,15,152,120,272,15,2012-04-03 22:02:54,2012-04-03 22:02:54
c40c627a3ba4b282bf42e247dff5eb13aa6ca790...8abaf05aa9dfd936189f4d979fdd07f67afaeb38,1,1,1,2,1,2012-04-03 16:43:07,2012-04-03 16:43:07
8ee0993fdf783ad12823ff817cd531df0bc363eb...25924a9089ae813fe9ec8697f6bd3798377d60fb,2,6,0,6,2,2012-03-31 12:59:06,2012-03-31 12:59:06
8ee0993fdf783ad12823ff817cd531df0bc363eb...c8f2b9cfeb2747b0b6f55405036275abe6380c71,1,19,2,21,5,2012-03-30 12:12:28,2012-03-30 12:12:28
8ee0993fdf783ad12823ff817cd531df0bc363eb...78d620b3b63fdd78b2cd1e4386822f93a701bc42,3,44,1,45,4,2012-03-29 15:03:05,2012-03-29 15:03:05
78d620b3b63fdd78b2cd1e4386822f93a701bc42...cd74f9da91cb1b798a8654f725b502bac256228d,5,61,25,86,21,2012-03-29 21:27:42,2012-03-29 21:27:42
cd74f9da91cb1b798a8654f725b502bac256228d...411d84f385364be987380da5f0216048073609c9,6,83,58,141,27,2012-03-30 05:05:04,2012-03-30 05:05:04
411d84f385364be987380da5f0216048073609c9...3824f9b372fe9451d101eec478440d129fb2d0b2,5,18,9,27,9,2012-03-30 05:15:04,2012-03-30 05:15:04
3824f9b372fe9451d101eec478440d129fb2d0b2...464cd59dff0e543cc367c0d468a70ca590334e42,2,38,0,38,2,2012-03-30 05:25:04,2012-03-30 05:25:04
464cd59dff0e543cc367c0d468a70ca590334e42...90748cf724d4b019c954d316621b04cefd69dbaf,6,31,25,56,18,2012-03-30 17:49:34,2012-03-30 17:49:34
90748cf724d4b019c954d316621b04cefd69dbaf...f145450415ed1e9db10ebcb8e02eb15c6dcffbf1,1,1,1,2,1,2012-03-31 10:48:30,2012-03-31 10:48:30
f145450415ed1e9db10ebcb8e02eb15c6dcffbf1...8269a3a735d6b1195ef0263716845ef3d2ab3327,6,43,10,53,12,2012-04-16 19:08:03,2012-04-16 19:08:03
8269a3a735d6b1195ef0263716845ef3d2ab3327...a8e4f3ed888f27629a5e35174cdb19cb6c751c16,4,25,5,30,6,2012-04-16 20:05:08,2012-04-16 20:05:08
a8e4f3ed888f27629a5e35174cdb19cb6c751c16...5abbada41e101ff832d036d5d1946d6f89fda771,1,13,8,21,1,2012-04-16 20:37:04,2012-04-16 20:37:04
5abbada41e101ff832d036d5d1946d6f89fda771...3a6694b5516f4c5015a7745cf8182e74597b39ad,1,3,1,4,1,2012-04-16 20:49:57,2012-04-16 20:49:57
ac3c23f9337fa8388bac15c3585313de84bcd67b...45b18365d5f409f196a02a4e6e2b77b8ebef909b,1,8,5,13,1,2012-04-19 20:06:45,2012-04-19 20:06:45
45b18365d5f409f196a02a4e6e2b77b8ebef909b...1845429268364e75bffdeb1075de8f1606e157ec,1,2,2,4,2,2012-04-19 20:35:35,2012-04-19 20:35:35
ac3c23f9337fa8388bac15c3585313de84bcd67b...69fd4763d2d239877c46b0fa6be894f1338fc4e3,1,1,1,2,1,2012-04-19 18:24:02,2012-04-19 18:24:02
863e5eb7d679139fde7580d131b40441a2a5d182...8aa5076d68e55a0b0ead7c9b51250d9f3cc739d6,2,16,13,29,5,2012-04-03 22:21:31,2012-04-03 22:21:31
8aa5076d68e55a0b0ead7c9b51250d9f3cc739d6...a951e6f8ae3b8c958c91e3174a596b7afd93fc10,4,36,13,49,14,2012-04-03 23:25:33,2012-04-03 23:25:33
a951e6f8ae3b8c958c91e3174a596b7afd93fc10...11e4709fde69c766ebb18c3277602837955f7317,2,7,1,8,2,2012-04-03 23:49:58,2012-04-03 23:49:58
11e4709fde69c766ebb18c3277602837955f7317...82c8c42aee8d774053198b4fa4d0e4abc7011a70,3,18,24,42,4,2012-04-03 23:49:58,2012-04-03 23:49:58
82c8c42aee8d774053198b4fa4d0e4abc7011a70...911ce0d3e5c97ac5de9badf04623d6ae6436399a,1,7,7,14,7,2012-04-03 23:59:58,2012-04-03 23:59:58
911ce0d3e5c97ac5de9badf04623d6ae6436399a...eb2c1cd2e372b0cd1a5c408fb0abfbf10f77a216,2,0,16,16,2,2012-04-03 23:59:58,2012-04-03 23:59:58
3706a9744d7d2976f53f46e5e0197323fa0670b0...80ddd2c09d9017f49976436982e2b9be5084fc4c,3,29,6,35,6,2012-04-04 22:51:49,2012-04-04 22:51:49
80ddd2c09d9017f49976436982e2b9be5084fc4c...6e2a6d925f9c5446411cb9e7d191575e44760384,2,0,8,8,2,2012-04-04 22:58:23,2012-04-04 22:58:23
6e2a6d925f9c5446411cb9e7d191575e44760384...17a88bb6a21cc8b6125bd2e36c1f62f4bd13300e,1,10,0,10,1,2012-04-05 21:22:48,2012-04-05 21:22:48
17a88bb6a21cc8b6125bd2e36c1f62f4bd13300e...86676476e6a8a23786ccbc927ad24140a47e96af,7,85,53,138,19,2012-04-05 22:00:15,2012-04-05 22:00:15
86676476e6a8a23786ccbc927ad24140a47e96af...b6124979037b4fb86ea416b08ec79b01c848946e,2,1,1,2,1,2012-04-05 22:28:37,2012-04-05 22:28:37
b6124979037b4fb86ea416b08ec79b01c848946e...7909fba592b52ff7b31d7e9aff16f140b15a9d7b,1,2,2,4,1,2012-04-05 22:30:52,2012-04-05 22:30:52
1ed831846d53dac190793fcc9b6d66687b9c7a92...6ed5d9bc1149a25cd61fef6171e4b4a36474149a,1,14,7,21,7,2012-03-31 21:23:34,2012-03-31 21:23:34
1031ca9b685b7717e729ef22c835bb810f19a6f2...2b01c65e50234cfa358c14db6e689444095ca9f9,1,11,0,11,1,2012-03-30 15:30:56,2012-03-30 15:30:56
08994f3f6034eb214de4cda304d8797a51b2397a...7058258a2afbc3335da7568ea2e2f5337bbc00b4,4,16,12,28,5,2012-04-21 09:45:43,2012-04-21 09:45:43
7058258a2afbc3335da7568ea2e2f5337bbc00b4...ae565d24ee6c0d1f26bc47b3419ca2b58474d7a3,1,18,14,32,3,2012-04-21 10:23:44,2012-04-21 10:23:44
60bf502bf15b95c870a8466011a6f91eb18759a9...1d601616a33aaa95e2ac7b21ff041b4a840df33c,6,42,19,61,10,2012-04-20 16:11:49,2012-04-20 16:11:49
1d601616a33aaa95e2ac7b21ff041b4a840df33c...35e21b3402ae934a33b31aa7d6049abaf861f766,5,76,1,77,5,2012-04-20 16:41:49,2012-04-20 16:41:49
35e21b3402ae934a33b31aa7d6049abaf861f766...9ee345750ca43f4e4b0c429ebc913caba9684dcf,1,1,1,2,1,2012-04-20 19:51:57,2012-04-20 19:51:57
eb2c1cd2e372b0cd1a5c408fb0abfbf10f77a216...897da534fa7ab3b2280bfea05c5da4b57e3b8612,9,72,45,117,35,2012-04-04 04:39:04,2012-04-04 04:39:04
7909fba592b52ff7b31d7e9aff16f140b15a9d7b...f30d56494e45d44e44ee96407f86bac04510424e,1,1,1,2,1,2012-04-06 10:00:13,2012-04-06 10:00:13
7909fba592b52ff7b31d7e9aff16f140b15a9d7b...1a3ce182ea98a4ae2b4ce51e9900c2b5be645ed1,1,30,7,37,7,2012-04-06 05:48:58,2012-04-06 05:48:58
ae565d24ee6c0d1f26bc47b3419ca2b58474d7a3...71819dc344a032eb4a7d001c25d096fa959180e6,3,13,2,15,4,2012-04-22 13:01:59,2012-04-22 13:01:59
ae565d24ee6c0d1f26bc47b3419ca2b58474d7a3...dcbb875c46d59c4fba6d3554b87d6d9153791a66,4,36,11,47,12,2012-04-22 12:19:09,2012-04-22 12:19:09
dcbb875c46d59c4fba6d3554b87d6d9153791a66...e5f8397fd4360ad21ba2f7e9abedb2707f33033f,5,52,21,73,7,2012-04-22 13:14:01,2012-04-22 13:14:01
9ee345750ca43f4e4b0c429ebc913caba9684dcf...c851639a75359da7e84290fb2f62642e1d4f05f7,1,1,1,2,1,2012-04-20 21:36:09,2012-04-20 21:36:09
9ee345750ca43f4e4b0c429ebc913caba9684dcf...5b6019f357d01d7871068da15549d19be1a0cf4f,6,21,56,77,10,2012-04-20 21:21:12,2012-04-20 21:21:12
5b6019f357d01d7871068da15549d19be1a0cf4f...9c76bd95402dfb4fa49cca4876c9714f408c5122,5,20,7,27,7,2012-04-20 22:26:22,2012-04-20 22:26:22
9ee345750ca43f4e4b0c429ebc913caba9684dcf...c437e2d7d416dae73efdea248a34b452d912986e,7,30,13,43,13,2012-04-20 21:01:45,2012-04-17 21:02:21
805142a0448d05461ec5f63557e137c58b8aadcf...a6c1201c906bc3b0bfd4151bbc1d738bd46a1c24,1,1,1,2,1,2012-04-06 16:35:48,2012-04-06 16:35:48
8fa22de9acc51af878009c774fb49759e34427df...2fa4aadb8f24dfa24eb56962325df00fdbb3bd04,1,8,5,13,3,2012-04-07 14:30:00,2012-04-07 14:30:00
2fa4aadb8f24dfa24eb56962325df00fdbb3bd04...88974b500f18a9de32f778e407c8d6909095443f,3,49,54,103,15,2012-04-07 20:13:18,2012-04-07 20:13:18
88974b500f18a9de32f778e407c8d6909095443f...667edcdd7534206761fc9524e6eaa17f1c27b815,4,43,7,50,5,2012-04-07 21:18:32,2012-04-07 21:18:32
667edcdd7534206761fc9524e6eaa17f1c27b815...23d950855d6d2524d00b1f0618c008e2529f06a4,28,424,36,460,45,2012-04-08 21:28:58,2012-04-08 21:28:58
23d950855d6d2524d00b1f0618c008e2529f06a4...d98b1833612af09fb405880ef7acd63a4e2a42fa,8,145,48,193,14,2012-04-08 22:01:42,2012-04-08 22:01:42
d98b1833612af09fb405880ef7acd63a4e2a42fa...2bad798e119b41ce075815647a17ddc2dec9befe,2,3,3,6,2,2012-04-08 22:29:15,2012-04-08 22:29:15
2bad798e119b41ce075815647a17ddc2dec9befe...627efddf6343735ed95e49ac9b71d7929c879ea3,37,686,545,1231,99,2012-04-10 05:51:08,2012-04-10 05:51:08
627efddf6343735ed95e49ac9b71d7929c879ea3...2587de74df824b8c81b9d51a3bd47fd246173e29,15,145,61,206,35,2012-04-10 17:06:17,2012-04-10 17:06:17
2587de74df824b8c81b9d51a3bd47fd246173e29...8f22834c4ed08f29d9ab2a5c1be58fc6da62402a,3,3,13,16,3,2012-04-10 17:50:27,2012-04-10 17:50:27
8f22834c4ed08f29d9ab2a5c1be58fc6da62402a...ba3c359fd565b6ccc7ce318b38224f32c0daaf15,7,8,8,16,7,2012-04-10 18:39:04,2012-04-10 18:39:04
ba3c359fd565b6ccc7ce318b38224f32c0daaf15...52f6df7255ed40186bd1a0e92abaaf2b926f3817,1,0,2,2,1,2012-04-10 18:53:30,2012-04-10 18:53:30
511d07c47c9bf3a18bfa276d452c899369432a22...204c66461ed519eb0078be7e8ac8a6cb56834753,1,1,1,2,1,2012-04-22 13:49:45,2012-04-22 13:49:45
204c66461ed519eb0078be7e8ac8a6cb56834753...21f3da23589d50038728393f0badc6255b5762ca,1,6,2,8,1,2012-04-23 07:54:19,2012-04-23 07:54:19
52f6df7255ed40186bd1a0e92abaaf2b926f3817...b7558a2063a35778e226156ff7b5ab41d83be753,6,43,42,85,20,2012-04-11 20:03:56,2012-04-11 20:03:56
b7558a2063a35778e226156ff7b5ab41d83be753...e7add858cf99d11aa6f93cc42c6d00628ca5538c,5,18,5,23,6,2012-04-11 20:32:45,2012-04-11 20:32:45
52f6df7255ed40186bd1a0e92abaaf2b926f3817...51ca0abf1060e86b1f40aada80ed62b9f10833c0,1,6,3,9,3,2012-04-11 17:35:49,2012-04-11 17:35:49
51ca0abf1060e86b1f40aada80ed62b9f10833c0...700eec6672b7eeb3f8e52b802d3e3ecadd08c339,2,9,7,16,2,2012-04-11 19:13:38,2012-04-11 19:13:38
700eec6672b7eeb3f8e52b802d3e3ecadd08c339...42f04bf70c279f941f70c5bba547493d51a28f03,5,10,5,15,5,2012-04-11 19:36:52,2012-04-11 19:36:52
21f3da23589d50038728393f0badc6255b5762ca...c71222ba9e176d1970855c66c3c07d2ffe35ec96,1,1,1,2,1,2012-04-26 11:00:29,2012-04-26 11:00:29
21f3da23589d50038728393f0badc6255b5762ca...d97a9aa4a44ff9f452144fad348fd9d7e3b48260,6,22,4,26,7,2012-04-23 12:32:56,2012-04-23 12:32:56
7c8fbe8f7f8d94f92ddb1a4a32cf72867ab21ba7...8d02d8c0456aa3307ed9074ac1944df7b2c19eb2,2,11,11,22,3,2012-04-20 22:48:03,2012-04-20 22:48:03
8d02d8c0456aa3307ed9074ac1944df7b2c19eb2...9af14e4bda3586d520c576911ecf109879f41aed,2,2,2,4,3,2012-04-21 09:15:17,2012-04-21 09:15:17
740e54c3fc5b3c83e80f4eeb360463a1539d5c7a...088860de4ed3a10b824092c6ab3c47d9f6f27d6a,5,15,6,21,5,2012-04-11 20:50:13,2012-04-11 20:50:13
088860de4ed3a10b824092c6ab3c47d9f6f27d6a...0e62b1cbaae346907e939b5de6fddc588bf20065,1,2,2,4,1,2012-04-11 20:59:53,2012-04-11 20:59:53
0e62b1cbaae346907e939b5de6fddc588bf20065...fb6d4511a05112677e0279ed87a55d3f02e2d49c,7,14,56,70,10,2012-04-11 21:54:07,2012-04-11 21:54:07
d97a9aa4a44ff9f452144fad348fd9d7e3b48260...01bb42ae02a863b4455af06a39d55fdda2e4dfec,1,2,2,4,2,2012-04-23 14:41:15,2012-04-23 14:41:15
fb6d4511a05112677e0279ed87a55d3f02e2d49c...497ee5fbbc781c8a5ffb754de5f8f5a46304aa57,9,60,25,85,25,2012-04-13 05:12:34,2012-04-13 05:12:34
ff8136cda21612e2a5db2bc7c1f7917fc3822091...903f9491ba097909f7d2e66873ff25d1505df07e,1,2,4,6,2,2012-04-26 22:09:23,2012-04-26 22:09:23
af99e4afe18788a536c5e789153235f3ff44f67f...c9af8e757948838cd6e7232dc189debd61e0c799,20,200,117,317,41,2012-04-24 18:49:34,2012-04-24 18:49:34
af99e4afe18788a536c5e789153235f3ff44f67f...b53df221275ba17d63583cd02bb6e3ebd661760c,1,1,1,2,1,2012-04-24 10:43:06,2012-04-24 10:41:20
01bb42ae02a863b4455af06a39d55fdda2e4dfec...03cc55dba6883ba9e5fa9301464523a25b77f164,1,7,7,14,6,2012-04-24 07:42:30,2012-04-24 07:42:30
903f9491ba097909f7d2e66873ff25d1505df07e...c937d06c3c98e9ffce8ec1132203eaff6bf7b231,1,5,2,7,5,2012-04-29 21:23:19,2012-04-29 21:23:19
903f9491ba097909f7d2e66873ff25d1505df07e...35e602f19c83585d64aa2043ed26eeb8cd7b40e2,1,1,1,2,1,2012-04-29 07:39:15,2012-04-29 07:39:15
b5fdacd153977748f16439689487be35c3699e9b...294dfe15ca4002ff2c6c6f2e83e59e042ac973ba,1,19,2,21,6,2012-06-11 20:58:58,2012-06-11 20:06:17
b5fdacd153977748f16439689487be35c3699e9b...2746be6ce3245f2ebc509227cd72f508bfd46830,7,6,13,19,8,2012-04-24 18:47:01,2012-04-24 18:47:01
f72a5d11bd55f54bd20874011de7729f2f31c5bb...7c59722ddcf8abc1f88474253a5977e8ad2fc10a,1,15,2,17,1,2012-04-26 08:55:46,2012-04-26 08:55:46
f18339c26d673c5f8b4c19776036fd42a0de30aa...2176e2c91540d7c642046e9df4040bfd4c37f620,1,1,0,1,1,2012-04-29 21:45:01,2012-04-29 21:45:01
3a2d7a6604372ce1ab98982709c9d851376879da...0e33bf6eb0883259af4b258532b948e5798e7d1d,3,50,45,95,9,2012-06-12 08:31:38,2012-06-12 08:31:38
0e33bf6eb0883259af4b258532b948e5798e7d1d...6fa95a3d34838bf80d4fe69c9605640806d346ac,8,371,470,841,32,2012-06-12 11:58:44,2012-06-12 11:58:44
6fa95a3d34838bf80d4fe69c9605640806d346ac...40af6e1ad2870f9c97a0354d80cd30871a546835,1,9,1,10,2,2012-06-12 13:36:27,2012-06-12 13:36:27
40af6e1ad2870f9c97a0354d80cd30871a546835...e0d1fba15e86771e7ecf820d1bec68aa5c0e9cb1,11,70,11,81,16,2012-06-12 14:43:16,2012-06-12 14:43:16
e0d1fba15e86771e7ecf820d1bec68aa5c0e9cb1...b96af79bb8a312e6870ad62637c0e3372eac32b7,3,57,3,60,4,2012-06-12 18:15:34,2012-06-12 18:15:34
b96af79bb8a312e6870ad62637c0e3372eac32b7...093159a8683c381a9f7aa80073ac94c4ed03e108,5,39,7,46,7,2012-06-12 18:41:46,2012-06-12 18:41:46
093159a8683c381a9f7aa80073ac94c4ed03e108...5f5cd2be1383503a48426bb2adeb127c11ae3d58,2,13,8,21,6,2012-06-12 18:55:10,2012-06-12 18:55:10
5f5cd2be1383503a48426bb2adeb127c11ae3d58...9ef9c58f55e2613910623e66205df402f2a89f14,1,3,2,5,2,2012-06-12 19:04:57,2012-06-12 19:04:57
9ef9c58f55e2613910623e66205df402f2a89f14...edd81a79c5c2a61e565664cfa787185c4e19729b,15,84,101,185,24,2012-06-12 20:13:42,2012-06-12 20:13:42
edd81a79c5c2a61e565664cfa787185c4e19729b...a243253b10244e8a3b62c40b686b52ac61a3adc8,5,96,53,149,18,2012-06-13 06:03:53,2012-06-13 06:03:53
7b7547aa00e3c26637247812a1a5adf169ac4a55...28cb43135ce7691a7b0022cb8fcb719d0e46c810,10,125,85,210,37,2012-04-26 17:43:12,2012-04-26 17:43:12
28cb43135ce7691a7b0022cb8fcb719d0e46c810...43dcc9575aaf406f7979fdc9836fad40ab8c3b72,2,14,4,18,5,2012-04-26 21:53:55,2012-04-26 21:53:55
2176e2c91540d7c642046e9df4040bfd4c37f620...c808295e9ef21105b8d4cc610b6749a0f3e30377,1,1,1,2,1,2012-05-03 10:53:24,2012-05-03 10:53:24
2176e2c91540d7c642046e9df4040bfd4c37f620...edcbe1178c06ad6575d850a9124d6f7e2d8755ad,1,28,6,34,9,2012-05-03 10:44:03,2012-05-03 10:35:46
2176e2c91540d7c642046e9df4040bfd4c37f620...825d2d69af5864bc2ea755b9a267a4a5a3ed5206,1,1,0,1,1,2012-05-03 10:20:27,2012-05-03 10:20:27
825d2d69af5864bc2ea755b9a267a4a5a3ed5206...babb6a1a6b6cc08182d4053cf11266a687d79620,1,1,2,3,2,2012-05-03 12:19:06,2012-05-03 12:19:06
2176e2c91540d7c642046e9df4040bfd4c37f620...b8c69c6f3476be7a467983eb768d9d4264b19736,1,1,1,2,1,2012-04-30 14:33:00,2012-04-30 14:33:00
a243253b10244e8a3b62c40b686b52ac61a3adc8...d1953a26401c0550670fc780a4516b0799238454,1,0,3,3,1,2012-06-13 12:19:02,2012-06-13 12:19:02
d1953a26401c0550670fc780a4516b0799238454...e735763f276b1950e89383b0ef40afc6dffeca32,1,0,13,13,1,2012-06-13 12:22:40,2012-06-13 12:22:40
e735763f276b1950e89383b0ef40afc6dffeca32...51c30d90d407ce779c1b65caa93703eff8c2e95f,1,4,4,8,4,2012-06-13 12:36:51,2012-06-13 12:36:51
12bb1d8f39d655576a98eabd6307cab5103e616c...f20c0793758e87f3886b310f37ff4ba317c794ca,1,1,1,2,1,2012-05-03 19:35:15,2012-05-03 19:35:15
65382133d5f7e9ab683f0b1928d60b93daa13996...e0b709266eb912ba7ce73688a958db06dd420a6f,1,1,1,2,1,2012-05-15 00:19:28,2012-05-15 00:19:28
d143680c644930b1277f0951b0b1242f86f82e8c...36e88b960a32d4f291a32be988488414a44f7d29,9,208,174,382,24,2012-06-13 17:02:30,2012-06-13 17:02:30
36e88b960a32d4f291a32be988488414a44f7d29...f5ee330a13f2b570bbbdb22d6716c66625a2c2a3,2,8,4,12,4,2012-06-14 07:43:45,2012-06-14 07:43:35
f5ee330a13f2b570bbbdb22d6716c66625a2c2a3...72b9c14ebca18b065085f18590e09ccb6137dc6f,1,40,37,77,9,2012-06-14 05:24:10,2012-06-14 05:24:10
72b9c14ebca18b065085f18590e09ccb6137dc6f...a78908c6970f4e29841bb4c470b3ed856b0e66d4,1,1,1,2,1,2012-06-14 09:45:22,2012-06-14 09:45:22
d36454cda5be76f1fc69125691bacfd406532ec4...ff284b2689262424201a538759d019795b60f236,1,0,1,1,1,2012-05-07 10:15:09,2012-05-07 10:15:09
d36454cda5be76f1fc69125691bacfd406532ec4...fbf108262d11bfeefbbd034d4f61eda2ab04d41d,1,2,2,4,2,2012-05-07 02:55:57,2012-05-07 02:55:57
d36454cda5be76f1fc69125691bacfd406532ec4...447fe38479d1baa1e4655ea0f725a8679273e02b,1,1,1,2,1,2012-05-04 11:31:16,2012-05-04 11:31:16
a78908c6970f4e29841bb4c470b3ed856b0e66d4...6ff99fe9457fcfe831fbe3d3a1ef477d9a327330,1,1,1,2,1,2012-06-15 01:51:01,2012-06-15 01:51:01
58640f93aae648e7956263e7cd3425fa72d42b95...82723542880ee261dfd4bc2816b8d97149a18927,1,1,1,2,1,2012-05-09 09:46:42,2012-05-09 09:46:42
45988ad817568c8559104014c77471e6dd2f2999...6f229c4fb223026c7e9022765f62679dcf8d620e,1,1,1,2,1,2012-05-31 13:19:48,2012-05-31 13:19:48
b9ab93e1086b3b6e263bbb056241769e54fc4396...6ace52bb2b0d999d1f185bf74b2954b9ee41dbe4,1,30,4,34,3,2012-06-15 21:07:53,2012-06-15 21:07:53
6ace52bb2b0d999d1f185bf74b2954b9ee41dbe4...f296d27648aaac30794591e33094720d9f029089,2,56,37,93,7,2012-06-18 15:40:14,2012-06-18 15:40:14
b9ab93e1086b3b6e263bbb056241769e54fc4396...482f1a7d19afc6a003e094d7fbb93193f6a742b3,1,4,3,7,1,2012-06-15 15:53:00,2012-06-15 15:53:00
6ff99fe9457fcfe831fbe3d3a1ef477d9a327330...5bbf3ccf0559ac4d8528f48721a2816fa0c72985,37,559,61,620,40,2012-06-15 04:15:28,2012-06-15 04:15:28
5bbf3ccf0559ac4d8528f48721a2816fa0c72985...85b86e6476f5a9810f9c13b3a62c457439305f13,1,1,1,2,1,2012-06-15 16:01:39,2012-06-15 16:01:39
85b86e6476f5a9810f9c13b3a62c457439305f13...781fd1a80c6b65fa8c0cd71001be681e955c4edb,4,97,1,98,4,2012-06-16 09:50:14,2012-06-16 09:50:14
781fd1a80c6b65fa8c0cd71001be681e955c4edb...6745a5e5c1029ed8b226053580583f8eb96c4869,3,29,0,29,3,2012-06-16 10:03:20,2012-06-16 10:03:20
6745a5e5c1029ed8b226053580583f8eb96c4869...8189082e4c48d2181158dcba1791e0cf6dd6ef1c,2,2,3,5,3,2012-06-16 10:20:17,2012-06-16 10:20:17
8189082e4c48d2181158dcba1791e0cf6dd6ef1c...67f445afea81a3581e67d67a6c225868719da755,1,1,1,2,1,2012-06-16 10:31:21,2012-06-16 10:31:21
67f445afea81a3581e67d67a6c225868719da755...e15a2b9695349fca3e8b62883131c8fc6ee37fe7,1,6,5,11,1,2012-06-16 10:45:51,2012-06-16 10:45:51
9e5c016847f99350d3eb5444d58a9e9944294fc6...25b80767bd0b7f715d5e0d77644788e11c3d585c,5,38,32,70,18,2012-05-12 09:01:09,2012-05-12 09:01:09
9e5c016847f99350d3eb5444d58a9e9944294fc6...d50446088c05409604f8daad0879a23b3c5f5e8f,1,47,1,48,1,2012-05-10 22:43:12,2012-05-10 22:43:12
9e5c016847f99350d3eb5444d58a9e9944294fc6...00b4c4571ca0e36ed058dd5aec5da7ed772b16b4,1,2,2,4,1,2012-05-10 21:54:22,2012-05-10 21:54:22
9e5c016847f99350d3eb5444d58a9e9944294fc6...d0eaca919b569b89edd04847172565d5d05180e8,2,59,57,116,37,2012-05-10 21:46:07,2012-05-10 21:46:07
bcfdacf0d438b0b4b78b603593119eb6b964aa8a...a719bfc9313545bbba5ae2479790b8902d98bb3e,4,43,18,61,9,2012-05-31 20:31:17,2012-05-31 20:30:54
a719bfc9313545bbba5ae2479790b8902d98bb3e...17d4cac2080eb0c33d5daa5fc8174377b82bbc00,2,10,0,10,2,2012-05-31 20:36:52,2012-05-31 20:36:52
17d4cac2080eb0c33d5daa5fc8174377b82bbc00...96308f7534562341efcef65e2d4fbec1b211325a,5,36,41,77,10,2012-05-31 21:10:52,2012-05-31 21:10:52
fab42a612e2be3acf5489e86cf003003249a3c4d...7406fb5b124863af0fefd19f303bad9270ab63cc,1,6,1,7,1,2012-05-15 13:46:18,2012-05-15 13:46:18
7406fb5b124863af0fefd19f303bad9270ab63cc...451118f19a90707b465493bd50acf523479bd603,1,1,1,2,1,2012-05-15 13:47:01,2012-05-15 13:47:01
26124e40ef1bd438ae43ae1d27382aa71df81ed1...9a4e5a8bd5db64ef9e7fa2fda45bc8b2222ca202,1,0,1,1,1,2012-06-18 15:51:17,2012-06-18 15:51:17
dbc7ef21d1ff264011d5bd4df2faf4ce6870645c...cd3f55a310546151a82ac48abcfcdc8da2740b7e,2,12,1,13,2,2012-06-17 15:33:13,2012-06-17 15:33:13
cd3f55a310546151a82ac48abcfcdc8da2740b7e...60db88ad347a40a95d3004c69c3f00e215f8472c,1,1,1,2,1,2012-06-17 15:40:00,2012-06-17 15:40:00
60db88ad347a40a95d3004c69c3f00e215f8472c...5ff658a60790a2d08a9b75a07478f03654ec7b3d,2,3,4,7,4,2012-06-17 16:19:01,2012-06-17 16:19:01
5ff658a60790a2d08a9b75a07478f03654ec7b3d...f909e25d1b0e6fec2852631715c0e3886e145477,1,2,1,3,1,2012-06-17 19:00:13,2012-06-17 19:00:13
f909e25d1b0e6fec2852631715c0e3886e145477...6f398a4dcd0f2b52d4467dc5d95bc88888094478,1,1,0,1,1,2012-06-17 19:53:40,2012-06-17 19:53:40
6f398a4dcd0f2b52d4467dc5d95bc88888094478...eb00cb69dd8bf1b0db7d84e4c27076b1b8d23e09,1,0,1,1,1,2012-06-17 20:05:33,2012-06-17 20:05:33
39504aa19be31fa5ef8ea03e9182e6016526b365...e81ba7b2490ae080a5e1bf0a1596f8c4c31d4f22,1,12,0,12,2,2012-05-12 18:17:42,2012-05-12 18:17:42
dd79dba804b3063b9d573e87e4a871211e0a63e2...465a195117138194a51487b8d1c6cd161890e88d,1,13,7,20,2,2012-05-15 01:23:14,2012-05-15 01:23:14
0a3874f6a30d50da170d4cf43abc51a43b696d33...c0fa68572e952fc2b5bb979776a6e6dc29f5b846,1,6,0,6,1,2012-05-12 12:50:57,2012-05-12 12:50:57
0a3874f6a30d50da170d4cf43abc51a43b696d33...6e3db9a501c557126b6c7f5bd3cbf4e4dff64e30,1,1,1,2,1,2012-05-11 22:42:16,2012-05-11 22:42:16
16427f4c40073474ce7563edc70dd1e8e1b22a68...cbea0af2907d9bff641ce3cd215594dfb6a2ab94,2,12,2,14,3,2012-06-01 22:00:29,2012-06-01 22:00:29
81a89f6a834de58ed4da6177778cace6798006a0...6a4ae93f57d891bca6ce6645a178495880e485ef,1,7,0,7,3,2012-05-15 14:50:27,2012-05-15 14:50:27
e27a1d31e03b086122a9dcb7d2adc237862b7861...acdbc1b4c50c854be0be8977940aecfd0c354704,2,2,2,4,2,2012-06-19 10:48:39,2012-06-19 10:48:39
eb00cb69dd8bf1b0db7d84e4c27076b1b8d23e09...22d6dc2b3b1392341c765932b706bd867c66c5f9,9,162,8,170,8,2012-06-18 16:34:09,2012-06-18 16:34:09
22d6dc2b3b1392341c765932b706bd867c66c5f9...2dd17623c9388fb98ae53ba80c904455e0c7f432,5,7,13,20,7,2012-06-18 17:18:14,2012-06-18 17:18:14
2dd17623c9388fb98ae53ba80c904455e0c7f432...034ddb85fe86c1a3e13bda959a732b6bec11bbaa,4,9,5,14,8,2012-06-18 17:50:06,2012-06-18 17:50:06
eb00cb69dd8bf1b0db7d84e4c27076b1b8d23e09...50dabb5452e86bfe056c4e1d54abd2dc7c1a8463,1,30,4,34,3,2012-06-18 15:45:49,2012-06-15 21:07:53
50dabb5452e86bfe056c4e1d54abd2dc7c1a8463...848b5e99fc906d97682a11a4408b3ad0b54e5348,2,56,37,93,7,2012-06-18 15:45:49,2012-06-18 15:40:14
cbea0af2907d9bff641ce3cd215594dfb6a2ab94...3792d624b692752cdfa5c3adc990a6e5200f90b5,1,2,2,4,2,2012-06-03 01:24:59,2012-06-03 01:24:59
3792d624b692752cdfa5c3adc990a6e5200f90b5...c4d40408982184a4bf382d405a7215240bbdd79d,1,1,1,2,1,2012-06-03 09:51:54,2012-06-03 09:51:54
cbea0af2907d9bff641ce3cd215594dfb6a2ab94...2048750029e968883b70f88a079dfe7d1456c2ae,1,1,17,18,2,2012-06-03 01:08:01,2012-06-03 01:08:01
cbea0af2907d9bff641ce3cd215594dfb6a2ab94...fb4b571fa66f985bb9366944f63481c9937b5523,1,4,10,14,4,2012-06-03 00:58:49,2012-06-03 00:58:49
a27ee184284880fcd4bb3958ce12fa8ac6817330...be79c9def9c90e9359f67058befae1d7b914e557,13,46,29,75,22,2012-05-15 16:35:18,2012-05-15 16:35:18
acdbc1b4c50c854be0be8977940aecfd0c354704...77860f3537451c8e565dfd06584ee4044e65572e,1,2,2,4,2,2012-06-19 10:55:01,2012-06-19 10:55:01
77860f3537451c8e565dfd06584ee4044e65572e...19a9cd7f9d23e50609a719724143c34daa517723,1,1,1,2,1,2012-06-19 10:56:09,2012-06-19 10:56:09
034ddb85fe86c1a3e13bda959a732b6bec11bbaa...7484bcfff7fc8e132d94701b3af47f521ce117c5,1,1,1,2,1,2012-06-18 22:32:46,2012-06-18 21:52:16
7484bcfff7fc8e132d94701b3af47f521ce117c5...5b1ede628065ecfdf95552322328b5bb7613753a,2,8,7,15,3,2012-06-18 22:36:25,2012-06-18 22:36:25
5b1ede628065ecfdf95552322328b5bb7613753a...ef1598b4afa94b21db7f38755182a701d03ae44a,3,8,6,14,3,2012-06-20 15:11:17,2012-06-20 15:11:17
a35a12980eacd1d4b1724bbd981455991f29f93d...16b49124be59aa74a35f855fd4e0d75f100051de,5,1,113,114,9,2012-06-03 19:27:34,2012-06-03 19:27:34
16b49124be59aa74a35f855fd4e0d75f100051de...6ee4548c9912b2d52576f9dc06abe8c76074bc50,10,0,21,21,10,2012-06-03 19:32:40,2012-06-03 19:32:40
be79c9def9c90e9359f67058befae1d7b914e557...c7489578e61bf81af085cbd541dbcf68742061b2,4,88,0,88,5,2012-05-16 02:35:53,2012-05-14 18:05:32
c7489578e61bf81af085cbd541dbcf68742061b2...06b45acb8f2491234811a06f01b94af634d58b61,1,194,33,227,13,2012-05-16 02:35:53,2012-05-14 22:03:30
06b45acb8f2491234811a06f01b94af634d58b61...345f176a7458ec1f99a2911988f0c4c0cb4d2704,3,6,6,12,5,2012-05-16 02:35:53,2012-05-15 03:07:36
345f176a7458ec1f99a2911988f0c4c0cb4d2704...dd921053c8ef598bad3c7a16331c296d581f0080,4,14,15,29,8,2012-05-16 02:35:53,2012-05-15 03:27:52
dd921053c8ef598bad3c7a16331c296d581f0080...5fe75649b3e278562b241abadb7d5a62146cff34,3,11,12,23,6,2012-05-16 02:37:33,2012-05-15 03:42:47
5fe75649b3e278562b241abadb7d5a62146cff34...bb22360d1a7548facff3b72b2f9a0e66c6a55bb7,4,14,11,25,8,2012-05-16 02:37:33,2012-05-15 22:48:00
bb22360d1a7548facff3b72b2f9a0e66c6a55bb7...435fd8f0874450f2da480fa72b0f014d3f1fe271,3,9,9,18,6,2012-05-16 02:37:34,2012-05-15 22:50:36
435fd8f0874450f2da480fa72b0f014d3f1fe271...0a9a2c2a0b75ba617611382b6335bf2b7fc68b9f,3,9,9,18,6,2012-05-16 02:37:34,2012-05-15 23:20:15
0a9a2c2a0b75ba617611382b6335bf2b7fc68b9f...41c00a20a97e7ee3764822249d4bedc538c515aa,3,7,8,15,4,2012-05-16 02:37:34,2012-05-15 23:21:12
41c00a20a97e7ee3764822249d4bedc538c515aa...2d124d9496ea2bca71a25a29a4301cc718b5001c,2,8,4,12,5,2012-05-16 02:37:34,2012-05-15 23:25:21
2d124d9496ea2bca71a25a29a4301cc718b5001c...39061af9f8f19d114b48f79a66c22116a52e57be,3,5,8,13,3,2012-05-16 02:37:34,2012-05-15 23:36:48
39061af9f8f19d114b48f79a66c22116a52e57be...e660043d22bd686f6799a46b506a4c2ad53e46fa,3,6,10,16,5,2012-05-16 02:37:34,2012-05-15 23:41:37
e660043d22bd686f6799a46b506a4c2ad53e46fa...991d23e216cc4a847ee5724967ea69f40bb16fe8,1,7,7,14,7,2012-05-16 02:37:34,2012-05-16 02:27:35
25f1a7ec8ab793438c49c933b96cf80ea1d89e51...f33a80a522a712d6404e6de5bed8f86d551ff525,1,74,13,87,6,2012-06-19 13:29:31,2012-06-15 14:37:59
f33a80a522a712d6404e6de5bed8f86d551ff525...efc86f9711240f0fef09ba15ec0fc575a8d7673e,1,2,2,4,2,2012-06-19 13:29:32,2012-06-15 14:38:30
efc86f9711240f0fef09ba15ec0fc575a8d7673e...464ca2a248fc2fd3ddda6209d0a6a1780fd19b18,1,2,2,4,2,2012-06-19 13:29:32,2012-06-19 11:51:54
464ca2a248fc2fd3ddda6209d0a6a1780fd19b18...c31c84f58a8787fa78ee504ea36487264d8b8721,1,1,1,2,1,2012-06-19 13:29:32,2012-06-19 11:55:59
c31c84f58a8787fa78ee504ea36487264d8b8721...163395793b787d86d43c61e6f90a6ce74b988e5c,1,1,1,2,1,2012-06-19 13:29:32,2012-06-19 12:15:13
65c35394ebb5de7619b71949a883b1071bf72b98...581a8223263deab02b4018267ed63ef334eee97f,1,1,1,2,1,2012-06-20 18:00:34,2012-06-20 18:00:34
581a8223263deab02b4018267ed63ef334eee97f...a9c7de8815def87867daf025ff9753aae2615228,2,7,8,15,3,2012-06-20 18:01:00,2012-06-20 18:01:00
a9c7de8815def87867daf025ff9753aae2615228...6507c1085e02d9e59020c38ceff3308374dd1df0,3,6,8,14,3,2012-06-20 18:01:27,2012-06-20 18:01:27
7e0726b1da5c27f958eb940e99e5f8cc3e4a5853...f12ac71bf8c1c876e022f36631ad6c5197712eea,1,1,1,2,1,2012-06-04 14:38:08,2012-06-04 14:38:08
7e0726b1da5c27f958eb940e99e5f8cc3e4a5853...3bd06d55e0c7e0accf9efd2e0d67cf1ae76f7b0d,80,261,296,557,249,2012-06-03 22:37:27,2012-06-03 22:37:27
1b85cbc6d638e8ddbde1ebcb71cb9fc195fb3012...e5bbefc98025b1b9f67b8635807d43f60be55c30,2,3,3,6,3,2012-05-16 13:47:59,2012-05-16 13:34:10
3ca6c960ce39611de215fa2aa1497508de537218...5d39f47c4b2607922094271d1148d5794582fc59,1,1,1,2,1,2012-06-19 20:24:07,2012-06-19 20:24:07
5d39f47c4b2607922094271d1148d5794582fc59...13e7ef4b7d89ab2d2468d2930aa29294395ba451,1,2,2,4,1,2012-06-20 09:14:41,2012-06-20 09:14:41
6507c1085e02d9e59020c38ceff3308374dd1df0...1a05f2f7c9809aa80985c76e8a6d4f662647f150,5,18,2,20,5,2012-06-20 18:29:55,2012-06-20 18:29:55
1a05f2f7c9809aa80985c76e8a6d4f662647f150...d5b41831d141de75b8566a93b490c8b160c73f32,1,1,1,2,1,2012-06-20 20:08:10,2012-06-20 20:08:10
6507c1085e02d9e59020c38ceff3308374dd1df0...f6035552e5d83b36f69e1ac7fa4b40ee5f7ab4fb,2,84,0,84,2,2012-06-20 18:09:46,2012-05-17 21:23:34
f6035552e5d83b36f69e1ac7fa4b40ee5f7ab4fb...2416e3cb19d6a668fc3274b1ae3382f4119dac1d,2,25,5,30,3,2012-06-20 18:09:46,2012-05-20 18:15:13
2416e3cb19d6a668fc3274b1ae3382f4119dac1d...00ec81eacb881fbe0223183737d9c95b801ab01c,2,44,34,78,12,2012-06-20 18:09:46,2012-05-20 18:25:34
00ec81eacb881fbe0223183737d9c95b801ab01c...02924de3e1555bcd89097353ffb7eb552113b42e,2,27,0,27,2,2012-06-20 18:09:46,2012-05-20 18:35:03
02924de3e1555bcd89097353ffb7eb552113b42e...356430c3c0e8aed3f8c9f2e181aaeaeaa4f1d693,4,55,9,64,8,2012-06-20 18:09:46,2012-05-20 19:06:13
356430c3c0e8aed3f8c9f2e181aaeaeaa4f1d693...6617eaaf9b9ff5a76cb2c4150623a685357966d4,6,64,21,85,18,2012-06-20 18:09:46,2012-05-21 17:30:53
6617eaaf9b9ff5a76cb2c4150623a685357966d4...5303cc285a2067b59f1e8b68f707e8dbf90fe59e,6,13,2,15,7,2012-06-20 18:09:46,2012-05-21 20:05:12
5303cc285a2067b59f1e8b68f707e8dbf90fe59e...dfb5da9da339096ad0a8e754f4f42ca2007b5ae6,6,62,30,92,15,2012-06-20 18:09:46,2012-06-12 18:27:03
dfb5da9da339096ad0a8e754f4f42ca2007b5ae6...97ca4f5ddadd9f6880e238e85af00a82dcd8807f,2,19,7,26,7,2012-06-20 18:09:46,2012-06-15 20:23:28
97ca4f5ddadd9f6880e238e85af00a82dcd8807f...88964132edaec721e256449579c032ca731781bc,5,37,10,47,8,2012-06-20 18:09:46,2012-06-20 16:29:10
88964132edaec721e256449579c032ca731781bc...eba61c111d175f298d7c6541f47a6dcdf3e55b7d,1,0,5,5,1,2012-06-20 18:09:46,2012-06-20 17:18:29
eba61c111d175f298d7c6541f47a6dcdf3e55b7d...70c6b48ebc124fba754d940ba11bafadbf86e101,1,1,1,2,1,2012-06-20 18:09:46,2012-06-20 17:48:34
70c6b48ebc124fba754d940ba11bafadbf86e101...65989141dcc58eaa3cecfe98bc97a10075cf4f7e,2,5,3,8,4,2012-06-21 01:23:05,2012-06-21 01:23:05
a0db028c1b2fdc2a96ae5eba4d9c9180f57434d6...3ffb9cbfa930d3105560dbf86cd39d301feb1170,1,3,3,6,2,2012-06-04 18:41:26,2012-06-04 18:41:26
3ffb9cbfa930d3105560dbf86cd39d301feb1170...11f72732a8fea27887f4f9d1d301105abc677305,1,2,2,4,1,2012-06-04 18:45:23,2012-06-04 18:45:23
caa065670ef8d360383d4bf3109483924b7adf38...0dd87789a13f8d841cfcb1a25ee0da5c3eb2dd65,1,1,1,2,1,2012-05-16 15:25:18,2012-05-16 15:25:18
2255dc8f8d388b6df1919f9fc44ecb9ea55de511...316dfbaea8b34336691e7f97ad0c94a21b6f7e57,2,15,8,23,9,2012-06-20 10:45:26,2012-06-20 10:45:26
bbb926f3c49ea32320ec2e000e03a9d45b94197b...5fd2f7158e7ec66555cd58a945e2ae2f4dd76d70,1,1,1,2,1,2012-06-20 21:21:13,2012-06-20 21:21:13
5fd2f7158e7ec66555cd58a945e2ae2f4dd76d70...b64ceadbf273c0b99072b3eb124deb51b7e80f27,1,0,0,0,0,2012-06-21 06:58:18,2012-06-21 06:58:05
b64ceadbf273c0b99072b3eb124deb51b7e80f27...75cf927d3b1f31c7c19ce08d34bce4bf15f21608,10,158,9,167,14,2012-06-21 05:29:53,2012-06-21 05:29:53
75cf927d3b1f31c7c19ce08d34bce4bf15f21608...e0805ec469f50a41b22fe3f1f843e2b1fe818cd0,1,7,0,7,4,2012-06-21 13:43:40,2012-06-21 13:43:40
e0805ec469f50a41b22fe3f1f843e2b1fe818cd0...2d16585eae242d055cc8ff97e5dcab842d3277cd,2,3,2,5,2,2012-06-21 14:23:25,2012-06-21 14:23:25
2d16585eae242d055cc8ff97e5dcab842d3277cd...ed247b3893b8af5bfc266ebc03cc029ca31c800f,1,5,0,5,1,2012-06-21 14:23:51,2012-06-21 14:23:51
ed247b3893b8af5bfc266ebc03cc029ca31c800f...77cf662034a7187fe7e223e6d16b664b7b525d25,7,22,16,38,10,2012-06-21 15:41:22,2012-06-21 15:41:22
77cf662034a7187fe7e223e6d16b664b7b525d25...98a45ce6ee50ced19a22e6a9153bb778de8fa001,2,7,1,8,2,2012-06-21 15:54:57,2012-06-21 15:54:57
98a45ce6ee50ced19a22e6a9153bb778de8fa001...1903f6ade027df0f10ef96b9439495eeda07482c,3,8,0,8,3,2012-06-21 16:05:09,2012-06-21 16:05:09
1903f6ade027df0f10ef96b9439495eeda07482c...b32465712becfbcf83d63b1e6eff7d1483fdabea,3,14,2,16,3,2012-06-21 17:25:23,2012-06-21 17:25:23
55f83385023adf0fc70a54922209388a223dd05f...6d92aa6d12b875b4987666da98658191ae426892,7,9,1,10,3,2012-06-24 07:01:42,2012-06-24 07:01:42
11f72732a8fea27887f4f9d1d301105abc677305...3b41b1839b36b1063674af6acc659e43a97c8c39,4,18,6,24,6,2012-06-04 21:11:07,2012-06-03 18:29:20
3b41b1839b36b1063674af6acc659e43a97c8c39...d6ed9920d68691472fe9f9a9247508573c64bae4,4,9,4,13,4,2012-06-04 21:11:07,2012-06-04 21:08:41
d6ed9920d68691472fe9f9a9247508573c64bae4...2d68e7f4cd0ce60e340891fd2dfa2e479bb173ec,3,67,14,81,7,2012-06-05 16:45:18,2012-06-05 16:45:18
ce2214a1f0f8ecc2cb9acb2d55b7824a8fe0b003...4c503be0f1cb1e092b243308ed83941638ac49c3,1,1,1,2,1,2012-05-17 06:30:24,2012-05-17 06:30:24
316dfbaea8b34336691e7f97ad0c94a21b6f7e57...c3d1f2eb9b5d86208eb738f2cb00f9297b11020c,1,1,1,2,1,2012-06-20 15:16:56,2012-06-20 15:16:56
b32465712becfbcf83d63b1e6eff7d1483fdabea...da5cf9d085e148b44945640cd25eec3f172caf28,3,5,11,16,8,2012-06-22 08:57:05,2012-06-22 08:57:05
da5cf9d085e148b44945640cd25eec3f172caf28...fd44b6b69d5ef3f3f454cfc4fec72d04ddd5586a,1,7,7,14,3,2012-06-22 09:00:09,2012-06-22 09:00:09
6d92aa6d12b875b4987666da98658191ae426892...89d3366e76c73e5d34f6773ece5ba07492a54922,2,17,11,28,5,2012-06-26 07:55:25,2012-06-26 07:55:25
6d92aa6d12b875b4987666da98658191ae426892...4a40f65090fdb6044c106207123a80110e133f99,1,2,2,4,2,2012-06-25 04:54:02,2012-06-25 04:54:02
6d92aa6d12b875b4987666da98658191ae426892...9132d309adda6d848b2b9cdb4d56dda3010f8b68,1,8,0,8,1,2012-06-24 20:26:13,2012-06-24 20:26:13
9132d309adda6d848b2b9cdb4d56dda3010f8b68...56dbfd2af3174a94d0c5ed93a14dd3244370d2f0,1,1,1,2,1,2012-06-24 20:38:29,2012-06-24 20:38:29
56dbfd2af3174a94d0c5ed93a14dd3244370d2f0...bea0583951157cc2d1f8923f5b1bc13837aaa24c,1,6,0,6,1,2012-06-24 20:51:58,2012-06-24 20:51:58
bea0583951157cc2d1f8923f5b1bc13837aaa24c...4426bc1844d4f6d1ebc40dcd3babf1d1b167324b,4,47,12,59,5,2012-06-26 21:59:08,2012-06-26 21:59:08
4426bc1844d4f6d1ebc40dcd3babf1d1b167324b...5ab1856291d845b27f68c41f23ca76c78afcbce1,2,2,2,4,2,2012-06-26 22:55:54,2012-06-26 22:55:54
73692f215a2bcca051fd2d951243e276e91b0978...9546c57fd7b9942c878f460a5ea64cdfb0cad791,1,1,1,2,1,2012-06-05 17:31:09,2012-06-05 17:31:09
2e54ac17c5815814f288a1a9a1b30ba79977699c...0bdcf2e1dccf48e05b5bea822e68165400af83b7,2,226,165,391,132,2012-05-17 16:41:15,2012-05-17 16:41:15
2e54ac17c5815814f288a1a9a1b30ba79977699c...9cd8f7b08296d73532c66f06581ff47dab9720a3,9,135,15,150,12,2012-05-17 16:11:45,2012-05-17 16:11:45
c7542eb801ce0c538c442476e42f1d06d4e40fa9...4ac0160a1184fe4acf86cd07040af78847577e11,4,40,33,73,4,2012-06-20 17:08:18,2012-06-20 17:08:18
fd44b6b69d5ef3f3f454cfc4fec72d04ddd5586a...a21bda5ac99d186dce492e3291990d0761359919,1,2,2,4,2,2012-06-22 10:09:36,2012-06-22 10:09:36
89d3366e76c73e5d34f6773ece5ba07492a54922...cc7369305c4654d15f5a453e80d15b5025205325,1,4,1,5,1,2012-06-29 19:52:38,2012-06-26 16:15:52
89d3366e76c73e5d34f6773ece5ba07492a54922...69ba86e8871c6d3ad118d0162b64f648d33c281a,1,3,3,6,3,2012-06-26 16:17:23,2012-06-26 16:17:23
89d3366e76c73e5d34f6773ece5ba07492a54922...0321a3c9b404b4c1a68a92a5a2bdc4d07ed7a527,10,28,25,53,14,2012-06-26 16:08:44,2012-06-26 16:08:44
3a4aff6934a69917b430f15201a6b1218fd51203...2da45e9cbf8bf0db88274451ba9dc61db50c571d,7,28,11,39,7,2012-06-29 11:46:24,2012-06-29 11:44:55
4c1f435ab78e5d4da3d6aaaf20579be13b662d02...4aca61e8a60cae56a7cceec7d66fd7aa4138c274,4,37,21,58,18,2012-06-28 10:42:58,2012-06-27 09:26:16
4aca61e8a60cae56a7cceec7d66fd7aa4138c274...4ad91d3c1144c406e50c7b33bae684bd6837faf8,5,91,1,92,5,2012-06-28 10:43:41,2012-06-27 11:32:56
4ad91d3c1144c406e50c7b33bae684bd6837faf8...7b5c3cc8be40ee161ae89a06bba6229da1032a0c,3,101,0,101,4,2012-06-28 10:44:20,2012-06-27 12:51:39
7b5c3cc8be40ee161ae89a06bba6229da1032a0c...84a3f8fca4e57422267bdd7e07d4f1b90717fbcc,2,4,5,9,5,2012-06-28 14:02:20,2012-06-28 14:02:20
4c1f435ab78e5d4da3d6aaaf20579be13b662d02...1b1e77c728e575a110e204e142e81bdff2737536,12,93,29,122,16,2012-06-27 18:20:35,2012-06-27 18:20:35
1b1e77c728e575a110e204e142e81bdff2737536...50fdb2e7dffd80265bc604ec8f9071e12f99af30,12,30,65,95,21,2012-06-27 18:30:35,2012-06-27 18:30:35
50fdb2e7dffd80265bc604ec8f9071e12f99af30...5f356d69284850603893b8a82141e44d27eec89e,3,39,20,59,9,2012-06-27 20:13:44,2012-06-27 20:13:44
4c1f435ab78e5d4da3d6aaaf20579be13b662d02...87d2a763e61241ea8f1919c1b0f87d4a23efa5d6,1,4,1,5,2,2012-06-27 17:21:44,2012-06-27 17:21:44
9546c57fd7b9942c878f460a5ea64cdfb0cad791...cfa1b4c7f69e1480bab5cbc4cd81ca40436d0c3a,1,4,4,8,2,2012-06-06 09:46:55,2012-06-06 09:46:55
2b319d0496fb4eee24f78e1817235daf23d52079...02dc25651411d5a60d760265903ebf629959ba59,10,51,20,71,13,2012-05-17 21:23:18,2012-05-17 21:23:18
f48e0cca6d9e0d9c44c797f99959aa8b0dfeb030...193804516b8b0783c850981456e947f888ff51bb,1,1,1,2,1,2012-06-22 19:48:03,2012-06-22 19:39:03
193804516b8b0783c850981456e947f888ff51bb...d92a22c9e627268eca697bbd9b660d8c335df953,1,1,1,2,1,2012-06-22 19:49:03,2012-06-22 19:49:03
d92a22c9e627268eca697bbd9b660d8c335df953...f3edea7ed743dff14f547b7fab2244f3913a10bd,3,2,3,5,3,2012-06-22 20:29:31,2012-06-22 20:29:31
f3edea7ed743dff14f547b7fab2244f3913a10bd...68389588d664100590b1a6ca7eedd50860b7e9bc,1,0,0,0,0,2012-06-22 20:46:57,2012-06-22 20:46:57
68389588d664100590b1a6ca7eedd50860b7e9bc...39fecb554f172a0c8ea00316e612e1d37efc7200,1,1,1,2,1,2012-06-22 20:50:58,2012-06-22 20:50:58
39fecb554f172a0c8ea00316e612e1d37efc7200...65717f7040eafe970b35f1b0dab769e29aaa01e7,1,2,2,4,2,2012-06-23 10:09:06,2012-06-23 10:09:06
65717f7040eafe970b35f1b0dab769e29aaa01e7...1548baa17c190446a462067726817655b4b8c08a,1,1,1,2,1,2012-06-23 10:16:21,2012-06-23 10:16:21
1548baa17c190446a462067726817655b4b8c08a...279c4262f92173ef6d35816db521028a3bdb7f17,1,0,4,4,1,2012-06-23 21:55:23,2012-06-23 21:55:23
279c4262f92173ef6d35816db521028a3bdb7f17...1e1c5b7afe42d6d88997aaa4f4877c37965866a5,2,6,6,12,5,2012-06-23 22:14:45,2012-06-23 22:14:45
d92446df1fdba87101c92c90b1c34eb2f1eebef4...666cdb22792dd955a286b9993d6235b4cdd68b4b,1,1,1,2,1,2012-06-26 16:21:28,2012-06-26 16:20:47
84a3f8fca4e57422267bdd7e07d4f1b90717fbcc...0d67f209fcbabed5831d90561350a8e094c150c4,3,89,53,142,4,2012-06-29 10:46:01,2012-06-29 10:46:01
0d67f209fcbabed5831d90561350a8e094c150c4...1d2c98186014cedc01f04382d507a34a71008ab1,2,2,1,3,2,2012-06-29 10:52:20,2012-06-29 10:52:20
1d2c98186014cedc01f04382d507a34a71008ab1...378dc55d29a97447315c6181f678cf933afbbb78,3,87,0,87,4,2012-06-29 13:34:08,2012-06-29 13:34:08
7ef180608f87fc17f19cd66e91ae34487e5b6564...19d0dc3c042d9a2aa70094778b2f4d2237fbf015,1,5,5,10,3,2012-06-27 21:47:12,2012-06-27 21:47:12
19d0dc3c042d9a2aa70094778b2f4d2237fbf015...a4ae4694a2de17e18f1f68a99f8765c61c09dd19,1,5,2,7,1,2012-06-27 21:54:53,2012-06-27 21:54:53
a4ae4694a2de17e18f1f68a99f8765c61c09dd19...df6b587f3458a55ca21f687fde0272a103b273cd,2,4,1,5,2,2012-06-28 09:24:41,2012-06-28 09:24:41
df6b587f3458a55ca21f687fde0272a103b273cd...335f9d64105fc887e74b22922da58b2edb1bc809,4,28,1,29,4,2012-06-28 09:51:50,2012-06-28 09:51:50
98b841664798d075013fbf132614cc40afc0125e...81f666d8dc968427aa8f94a8f0dccbb5e121c98b,1,1,1,2,1,2012-06-10 09:11:34,2012-06-10 09:11:34
98b841664798d075013fbf132614cc40afc0125e...604725f4f1b59d155f0db6a421f0005fa689db8b,1,3,3,6,3,2012-06-08 08:23:31,2012-06-08 08:23:31
98b841664798d075013fbf132614cc40afc0125e...0a70aca3b177cffccd2e04579712665d10b8fd69,20,531,524,1055,35,2012-06-07 12:44:57,2012-06-07 12:44:57
02dc25651411d5a60d760265903ebf629959ba59...7c154aa46097866aa28dba77ef77f9579f762f90,2,10,5,15,5,2012-05-19 07:33:19,2012-05-18 17:44:35
e1344a08f0a1ced0a858b3b4503c7881276d014b...4c1267e09f8718cd24b7a4701818336cdb45a0bf,7,34,20,54,11,2012-07-28 22:34:51,2012-07-28 22:34:51
4c1267e09f8718cd24b7a4701818336cdb45a0bf...c2817e6f3ad38f6437352749303a3c58abeff717,1,4,6,10,3,2012-07-28 22:40:21,2012-07-28 22:40:21
c2817e6f3ad38f6437352749303a3c58abeff717...c6034af44e47e08f610f18b132b3a69c592d0f91,2,0,2,2,2,2012-07-29 09:51:58,2012-07-29 09:51:58
c6034af44e47e08f610f18b132b3a69c592d0f91...2cf5a9efbc420649f1b2554378782239835a8357,2,2,2,4,2,2012-07-29 17:08:58,2012-07-29 17:08:58
2cf5a9efbc420649f1b2554378782239835a8357...217810433b332a55b9620fcfe016735f33f8637d,3,84,0,84,3,2012-07-29 17:22:48,2012-07-29 17:22:48
666cdb22792dd955a286b9993d6235b4cdd68b4b...f2da12e9608bab186f673397530be9832da8cc00,1,2,0,2,1,2012-07-14 07:09:26,2012-07-14 07:09:26
666cdb22792dd955a286b9993d6235b4cdd68b4b...491d674a969d05d8624676b0aa97ee02d197772d,1,9,9,18,7,2012-07-13 17:26:52,2012-07-13 17:26:52
666cdb22792dd955a286b9993d6235b4cdd68b4b...4a21f090292f05d3bbc017e6cee6b9a653403ac0,1,1,1,2,1,2012-07-10 10:47:30,2012-07-10 10:47:30
666cdb22792dd955a286b9993d6235b4cdd68b4b...7359133798e8cc4fdd6569a11fd20f02110331fc,1,1,1,2,1,2012-07-05 22:25:53,2012-07-05 22:25:53
666cdb22792dd955a286b9993d6235b4cdd68b4b...283bf806766c02c8c66230f4c765070b0ed812fb,2,6,2,8,2,2012-06-26 18:20:05,2012-06-26 18:20:05
283bf806766c02c8c66230f4c765070b0ed812fb...6abc649590cfb110a88e6b2bdd3755c7d8ab6b4e,26,190,142,332,64,2012-06-26 18:23:09,2012-06-26 18:23:09
6abc649590cfb110a88e6b2bdd3755c7d8ab6b4e...88c625e3f718eb2dffcae7e8d2d03a86a51cd309,8,29,17,46,10,2012-06-26 18:47:25,2012-06-26 18:47:25
88c625e3f718eb2dffcae7e8d2d03a86a51cd309...cbca0457f8a9e3b6dfb5fe9f97b1a5c144e80725,3,30,15,45,9,2012-06-26 19:23:49,2012-06-26 19:23:49
cbca0457f8a9e3b6dfb5fe9f97b1a5c144e80725...385ca60a6a60a816e13d71705c75f66af49bc396,3,3,3,6,3,2012-06-26 20:34:23,2012-06-26 20:34:23
385ca60a6a60a816e13d71705c75f66af49bc396...1c8008c154ac4ca60790910a413a42d65c5881bb,1,58,47,105,3,2012-06-26 21:05:47,2012-06-26 21:05:47
666cdb22792dd955a286b9993d6235b4cdd68b4b...0ce7ad57b74053be1525dd04ba444a0174073b3c,1,2,2,4,2,2012-06-26 18:08:13,2012-06-26 18:08:13
666cdb22792dd955a286b9993d6235b4cdd68b4b...9a7cce2fa9ba17711a5dc68c6da25c651846f6d1,1,0,2,2,2,2012-06-26 16:38:35,2012-06-26 16:38:30
378dc55d29a97447315c6181f678cf933afbbb78...fbd559d44f1fc7e37f88844a9260bf7a5e1ba822,5,37,34,71,23,2012-07-04 07:48:00,2012-07-04 07:48:00
fbd559d44f1fc7e37f88844a9260bf7a5e1ba822...61910eb8fa6375dee03dfbf52ce8c74e499ae271,2,59,1,60,5,2012-07-04 09:03:32,2012-07-04 09:03:32
335f9d64105fc887e74b22922da58b2edb1bc809...97d74c2adc71a9144840573d87a796dc46cc2511,4,8,2,10,4,2012-06-29 10:57:33,2012-06-28 22:57:10
335f9d64105fc887e74b22922da58b2edb1bc809...61b85aed59481d0ebbb6aacc74b05f8d1b289703,2,9,0,9,3,2012-06-29 02:52:09,2012-06-29 02:52:09
61b85aed59481d0ebbb6aacc74b05f8d1b289703...86807b8ecc1b6e6e55e297d52bd2c04375d1e3f1,3,42,22,64,18,2012-06-29 03:30:31,2012-06-29 03:30:31
86807b8ecc1b6e6e55e297d52bd2c04375d1e3f1...7f44599ed0ddb1e01395f41e5f4bec869c2238e6,2,28,5,33,2,2012-06-29 07:43:15,2012-06-29 07:43:15
7f44599ed0ddb1e01395f41e5f4bec869c2238e6...8db947bcfe2f3e988c995696f0fd24d9edfdc3b0,1,19,4,23,4,2012-06-29 10:11:37,2012-06-29 10:11:37
8db947bcfe2f3e988c995696f0fd24d9edfdc3b0...1df1daa12ee6ac9a006b86584b8ecd90cea660a7,2,8,8,16,3,2012-06-29 10:49:36,2012-06-29 10:49:36
e0880559bddf6ec1ac964ccc9b6fee2304e1d6c0...9e2ec7ee28a959e8d4bcd98690d987f65415e78d,1,1,1,2,1,2012-06-11 07:43:57,2012-06-11 07:43:57
c7323e8f09302e40c0b13279a7580ba03af188f1...fd99863565b91012173c5550f6b8cc31c5cf695b,1,1,1,2,1,2012-06-08 23:24:33,2012-06-08 23:24:33
c7323e8f09302e40c0b13279a7580ba03af188f1...93f3fedef5bac7b43fdf0445744d92e67d0f3fb2,2,63,61,124,37,2012-06-08 10:28:19,2012-06-08 10:28:19
eb25bfe2b2233761115efa31577d70e9954f66d1...1e4d15b406de131d1260f1477d0077c6f5e93ddd,13,108,92,200,20,2012-05-19 09:25:56,2012-05-19 09:00:46
1e4d15b406de131d1260f1477d0077c6f5e93ddd...860e3ab526bbcccd64aac45fa377c14e78ef345c,7,11,2,13,6,2012-05-19 09:25:56,2012-05-19 09:25:16
217810433b332a55b9620fcfe016735f33f8637d...2cc31a380e1d9939a39bab4ff2c9eac65b610161,1,1,1,2,1,2012-07-30 01:43:07,2012-07-30 01:43:07
2cc31a380e1d9939a39bab4ff2c9eac65b610161...da77cd224731a8da6c94f65495ec1a7d9f5169c0,1,15,1,16,2,2012-07-30 01:47:28,2012-07-30 01:47:28
da77cd224731a8da6c94f65495ec1a7d9f5169c0...4b18f4c485d5da0fdb46326ee86089c596a208f4,1,3,2,5,1,2012-07-30 01:49:43,2012-07-30 01:49:43
4b18f4c485d5da0fdb46326ee86089c596a208f4...6b77d926029104e39a4a01fd247086b79dfb4df8,2,2,2,4,2,2012-07-30 21:42:40,2012-07-30 21:42:40
217810433b332a55b9620fcfe016735f33f8637d...69e41250d1b1eea609ae63f2702d5888396cba9a,5,62,55,117,22,2012-07-27 21:42:44,2012-07-27 21:42:44
69e41250d1b1eea609ae63f2702d5888396cba9a...5926bbac12d5831e1ad90964272b96e152a72e34,11,151,78,229,29,2012-07-31 05:32:49,2012-07-31 05:32:49
b58326afc6f77ccc43d4f250d7a0b8e1987ae068...d3862c0e5739ed09373fea2f52673c8ca1d3cbe4,10,156,183,339,28,2012-07-10 17:16:23,2012-07-10 17:15:33
244a1cad62ad9675a218093dc6fbc07f302a0d9e...2a705c4f40a32b1313952a212e92a5d8c5407fc6,7,58,20,78,13,2012-07-16 05:03:10,2012-07-16 05:03:10
b110c6bc869d49089dc00abef53849765653d49b...990b9217d9a55e26a53d4143d4a3c89123384327,1,1,1,2,1,2012-07-16 12:01:32,2012-07-16 12:01:32
b110c6bc869d49089dc00abef53849765653d49b...2def1c7217556388763dfb860f76e16f9af58571,18,231,170,401,28,2012-06-29 18:55:22,2012-06-29 18:55:22
2def1c7217556388763dfb860f76e16f9af58571...ad3f4922eef56dfc8074727b3abd55a4d69a8eab,1,1,1,2,1,2012-06-29 19:02:22,2012-06-29 19:02:22
ad3f4922eef56dfc8074727b3abd55a4d69a8eab...6a58deb53630de59fc05d2dacd272463901c42d8,24,85,32,117,34,2012-06-30 21:35:24,2012-06-30 21:35:24
6a58deb53630de59fc05d2dacd272463901c42d8...f464d4c9f0254014ef4c982369d0499eff5f90a6,1,6,11,17,6,2012-06-30 22:39:23,2012-06-30 22:39:23
61910eb8fa6375dee03dfbf52ce8c74e499ae271...5f38f67247786988c8fa1d86fe0afdd411360b27,1,6,2,8,3,2012-07-05 13:47:00,2012-07-05 13:47:00
5f38f67247786988c8fa1d86fe0afdd411360b27...f086676b7c02dc9958fa9c7f6135142523f65bfc,3,389,0,389,3,2012-07-05 13:57:45,2012-07-05 13:57:45
f086676b7c02dc9958fa9c7f6135142523f65bfc...efa21573df1f2db9421081d354fdefd2b675e488,1,4,0,4,1,2012-07-05 15:12:09,2012-07-05 15:12:09
efa21573df1f2db9421081d354fdefd2b675e488...4083cfa4de8f437a43ab35c4e854d170a60c4660,1,1,1,2,1,2012-07-05 15:20:01,2012-07-05 15:20:01
1df1daa12ee6ac9a006b86584b8ecd90cea660a7...7888e3ae2985c4abdaeaa7b9dd6617649a19fa3d,1,1,1,2,1,2012-06-29 13:39:40,2012-06-29 13:39:40
7888e3ae2985c4abdaeaa7b9dd6617649a19fa3d...aefe4dc3a2668ec12782f7ac1a245effb60b9339,1,4,1,5,1,2012-06-29 13:40:23,2012-06-29 13:40:23
2e836fa4288253bad9eb999c53103ac5f6581907...58a581782b99b55ea3d516dca8c63511c6fbe3f3,5,11,7,18,7,2012-08-27 18:55:01,2012-08-24 15:35:21
58a581782b99b55ea3d516dca8c63511c6fbe3f3...806695f491a8853a66d6dbde58b9e9d3eee1a72a,1,18,11,29,2,2012-08-27 19:20:13,2012-08-27 19:20:13
806695f491a8853a66d6dbde58b9e9d3eee1a72a...1f1ce5fbd47a8a9966323caf6b5b59672c74007a,1,97,17,114,5,2012-08-27 19:20:26,2012-08-24 15:44:47
2e836fa4288253bad9eb999c53103ac5f6581907...867f46076ed5fe0ce472f77eb17458ed3b317610,1,0,1,1,1,2012-08-25 22:40:01,2012-08-25 22:40:01
4a14db9391611647eee7a071006b119e8f08cdcb...a6dad85d2f94d4e7763eb6b0daefde5f039ece34,11,41,31,72,17,2012-06-11 10:55:38,2012-06-11 05:52:44
a6dad85d2f94d4e7763eb6b0daefde5f039ece34...04bf40a923910f36f306673dbcadf5e2747b03a1,10,172,11,183,9,2012-06-11 17:52:32,2012-06-11 17:52:32
860e3ab526bbcccd64aac45fa377c14e78ef345c...5d24082787944e25df4355fc13cf3dd7274a40ea,3,9,2,11,3,2012-05-19 10:17:34,2012-05-19 10:17:34
860e3ab526bbcccd64aac45fa377c14e78ef345c...8c7c43b94f17f1c8460f0425089dfd5980bbb35f,2,5,5,10,5,2012-05-19 10:12:49,2012-05-19 10:12:49
5867a5c21da4fa17b605d93c4e1cb8e16a885d05...a237c802dadb4e16a665117f3f2c07c4d1d68c1b,2,31,31,62,15,2012-08-11 19:48:55,2012-08-11 19:48:55
a237c802dadb4e16a665117f3f2c07c4d1d68c1b...44f79b2cb11a7e05be19ff0d37bad101290a9492,1,43,5,48,18,2012-08-11 19:59:56,2012-08-11 19:59:56
44f79b2cb11a7e05be19ff0d37bad101290a9492...bb50917a296d198ff1ede52c0abe36009eaf6f3a,1,8,0,8,1,2012-08-11 20:17:18,2012-08-11 20:17:18
bb50917a296d198ff1ede52c0abe36009eaf6f3a...28d903858e1ba491bcb75a5534db9eea1acdeaf0,4,7,10,17,7,2012-08-11 20:33:49,2012-08-11 20:33:49
d63706d72c8a52625bf1e892484261378936e240...00b280c3f9521f3e001b2ffc8a8a52f2a93a69d9,10,144,32,176,18,2012-07-28 00:35:43,2012-07-28 00:35:24
00b280c3f9521f3e001b2ffc8a8a52f2a93a69d9...853ca74620734bb3cfc540e9bf96bfed4f282014,1,7,7,14,5,2012-08-01 12:48:15,2012-08-01 12:48:15
853ca74620734bb3cfc540e9bf96bfed4f282014...058b71edf3eed2aa2f4f664a0731e52c57b157ce,1,1,0,1,1,2012-08-01 12:57:56,2012-08-01 12:57:56
bb7dde0d94de939958063f06465c65e239748cfd...2600e80b412a6e7256fe1f4e3ca32cc5d410b449,1,1,1,2,1,2012-07-11 14:37:34,2012-07-11 14:36:00
2a705c4f40a32b1313952a212e92a5d8c5407fc6...80f2ef2d028b9ba2d18df47ae248caec8a7bfce3,3,19,5,24,5,2012-07-17 05:17:16,2012-07-17 05:17:16
80f2ef2d028b9ba2d18df47ae248caec8a7bfce3...a3bb9ca1fa2e6c3e6a75d416e09cbdcb61fcd1e0,7,22,14,36,11,2012-07-17 05:19:16,2012-07-17 05:19:16
a3bb9ca1fa2e6c3e6a75d416e09cbdcb61fcd1e0...494cd02b38eb2bfbeeb69dec0688a7a1e7ccf50f,4,19,8,27,4,2012-07-17 05:21:16,2012-07-17 05:21:16
494cd02b38eb2bfbeeb69dec0688a7a1e7ccf50f...88033500232f12234a9546aa9b89111bcdbfecef,4,23,5,28,6,2012-07-17 05:23:16,2012-07-17 05:23:16
2a705c4f40a32b1313952a212e92a5d8c5407fc6...f322975c506966e080e58dd3eb0c38b22183415a,2,15,1,16,2,2012-07-16 22:31:28,2012-07-16 22:31:28
72a571724d84d112f98a5543c971e9b3b9da1383...65dc68b35c0ad455336abf33def5d920166f7c83,9,24,14,38,15,2012-07-18 21:25:10,2012-07-12 12:36:33
65dc68b35c0ad455336abf33def5d920166f7c83...c38578428b19b6375f24266ea5f4a98ca290eb58,9,141,77,218,11,2012-07-18 21:25:10,2012-07-12 19:10:34
c38578428b19b6375f24266ea5f4a98ca290eb58...f5908cef19a3cd2c44be02b453fecb568b2c6c8e,9,100,10,110,13,2012-07-18 21:25:10,2012-07-15 12:29:06
f5908cef19a3cd2c44be02b453fecb568b2c6c8e...655418bed2f81651c54988963713769f85d8b5da,8,39,38,77,26,2012-07-18 21:25:10,2012-07-15 14:36:06
655418bed2f81651c54988963713769f85d8b5da...86bd11cbd8796adc31849aa02317604abb1576e2,4,133,3,136,5,2012-07-18 21:25:10,2012-07-18 21:24:37
86bd11cbd8796adc31849aa02317604abb1576e2...d9cd6269e991e187c2acf272240fcb332270a5c4,5,69,74,143,7,2012-07-19 22:01:29,2012-07-19 22:01:29
d9cd6269e991e187c2acf272240fcb332270a5c4...60ee383eb96285d1bc21e7f439306d5eb55048bd,1,2,0,2,1,2012-07-20 09:08:59,2012-07-20 09:08:59
15a03e1d871c9d74508af74abd6705a1c27bb6c7...b3a0ee8e631c3e272c8ce3b60929192d3f7f1f22,2,6,1,7,2,2012-07-02 09:15:23,2012-07-02 09:15:23
3ce629fdedd3d283b9b899541330bb34022300c5...264ee0c5a1809a76f09649ac071fa6933c6da763,6,30,7,37,9,2012-07-04 22:26:23,2012-07-04 22:26:23
aefe4dc3a2668ec12782f7ac1a245effb60b9339...82e2551833e7d9fd704a29a022fee0ac2ba18b2f,1,1,1,2,1,2012-07-02 03:07:21,2012-07-02 03:07:21
82e2551833e7d9fd704a29a022fee0ac2ba18b2f...401340168c4596a872fd5d94ec9d52b33886f45f,3,17,10,27,9,2012-07-02 08:44:45,2012-07-02 08:44:45
04b2864b64a11a347401e1817d1409e9c8b3b50f...7a16572c0a47530939b4f59fb3f3bec490c03aba,1,1,1,2,1,2012-08-28 10:09:10,2012-08-28 10:09:10
04b2864b64a11a347401e1817d1409e9c8b3b50f...c81d4ab4a9101620e06cb401e7267789a6376d36,4,7,2,9,4,2012-08-28 08:57:23,2012-08-28 08:57:23
c81d4ab4a9101620e06cb401e7267789a6376d36...05fa1f167c05c13b269b104de33dc7a38f34e347,1,1,0,1,1,2012-08-28 11:06:05,2012-08-28 11:06:05
05fa1f167c05c13b269b104de33dc7a38f34e347...ffdda12f663d6a634689f7c7b16560bcf792415e,1,1,2,3,1,2012-08-28 12:18:49,2012-08-28 12:18:49
f33cf247b6387a5a0f33a4ccb4867ab2d2f14d4e...fed1c9804744fa20bfda47d269a4b0b566754ba3,1,3,3,6,2,2012-05-20 00:01:13,2012-05-20 00:01:13
f33cf247b6387a5a0f33a4ccb4867ab2d2f14d4e...b7160380ede61731df37f6fa3b2c5debba03fa6b,1,0,236,236,1,2012-05-19 23:15:12,2012-05-19 23:15:12
28d903858e1ba491bcb75a5534db9eea1acdeaf0...b1ea0b3c01f6d68834957a5f88b04329651802cc,4,44,2,46,5,2012-08-13 05:38:00,2012-08-13 05:38:00
b1ea0b3c01f6d68834957a5f88b04329651802cc...5a90d044f7fddf28b4dc3cd541315bce862f2866,4,28,2,30,7,2012-08-14 00:49:18,2012-08-14 00:49:18
5a90d044f7fddf28b4dc3cd541315bce862f2866...feee3838e14c90bc73b97cfa8be3760e52605531,2,7,10,17,2,2012-08-16 22:13:22,2012-08-16 22:13:22
28d903858e1ba491bcb75a5534db9eea1acdeaf0...91a8cd240bc16fe49190d407cb65ccdd2dc52e05,1,2,2,4,2,2012-08-11 23:33:59,2012-08-11 00:13:02
058b71edf3eed2aa2f4f664a0731e52c57b157ce...e1b4e22e5c59b9ef97892515755627857ae87185,2,11,1,12,2,2012-08-01 15:37:12,2012-07-23 23:45:08
e1b4e22e5c59b9ef97892515755627857ae87185...de2770bba98cd568d3c467ce2fd1e218e63c19a7,1,166,0,166,1,2012-08-02 00:26:21,2012-08-02 00:26:21
de2770bba98cd568d3c467ce2fd1e218e63c19a7...8ce390333a7e08c2956d6334f587e1db7668133e,1,68,0,68,1,2012-08-02 00:41:49,2012-08-02 00:41:49
8ce390333a7e08c2956d6334f587e1db7668133e...6873d07f62f51686f71ac7d31a06ae2124062235,2,24,0,24,2,2012-08-02 00:54:01,2012-08-02 00:28:50
6873d07f62f51686f71ac7d31a06ae2124062235...24ec186a8390080a14843c146320d1a33260789e,2,51,0,51,2,2012-08-02 00:54:05,2012-08-02 00:29:15
24ec186a8390080a14843c146320d1a33260789e...0a60b19b2362a9c8d669efbb7212d2a45098f77e,2,0,85,85,2,2012-08-02 00:54:10,2012-08-02 00:29:47
0a60b19b2362a9c8d669efbb7212d2a45098f77e...204964918b4926186026d6d8ff4b8212c280676a,1,241,0,241,1,2012-08-02 00:54:54,2012-08-02 00:30:36
204964918b4926186026d6d8ff4b8212c280676a...eb06dd79f8285c5a375bbbe796d6e92ab7080cab,16,19,18,37,19,2012-08-02 00:54:57,2012-08-02 00:31:45
058b71edf3eed2aa2f4f664a0731e52c57b157ce...e8261313a71fb69adeedc15e15fb572282ceaf06,3,42,15,57,12,2012-07-28 02:43:34,2012-07-28 02:43:34
78af4683b13a5c909cdb910497354f674c5ab54a...b8425cf173841eb2f7ba95141f364241a81a52a8,2,7,6,13,4,2012-07-10 18:26:41,2012-07-10 18:26:01
b8425cf173841eb2f7ba95141f364241a81a52a8...1a2bacfb4b4b8f4d79df0335b4daf1d2cfa16d88,9,206,20,226,20,2012-07-10 19:52:38,2012-07-10 19:52:38
1a2bacfb4b4b8f4d79df0335b4daf1d2cfa16d88...f88a2617e65ecc037d3f885965efcee39745163d,8,53,18,71,16,2012-07-10 20:12:38,2012-07-10 20:12:38
88033500232f12234a9546aa9b89111bcdbfecef...0456ceddb4d56e2090bfd03cf7e6c0bd7a2d8db9,1,1,1,2,1,2012-07-18 10:59:32,2012-07-18 10:59:32
1413c23c502d5a5cbc9b81f553a245103c1d6e50...775418918782d5284000ed0bfea364458c748567,257,1449,1449,2898,1002,2012-08-10 22:25:15,2012-08-10 22:07:50
775418918782d5284000ed0bfea364458c748567...42d3295d3d34100de8d515c47062ae53af657f3d,1,1,1,2,1,2012-08-10 22:38:13,2012-08-10 22:38:13
1413c23c502d5a5cbc9b81f553a245103c1d6e50...15fc0f0c103f41a517c04913efc03e224f5efbac,1,1,1,2,1,2012-08-10 19:23:54,2012-08-10 19:23:54
30eee67726b8cbf261f271a5a272e3c2f1d8b0f2...214fdd2d2f5fdac53d08da780f98edaed877be52,1,1,0,1,1,2012-07-19 09:52:28,2012-07-19 09:52:28
214fdd2d2f5fdac53d08da780f98edaed877be52...14649525971d7351120f659213aad0e40722bc44,9,24,15,39,16,2012-07-19 04:05:57,2012-07-19 04:05:57
3c6daec4b1194f5a2c43fcc5b7e370cd5c8add1e...791208431ccc12bebec81d464b29ca0acc2e731a,3,12,2,14,6,2012-07-20 05:39:34,2012-07-20 05:39:34
3c6daec4b1194f5a2c43fcc5b7e370cd5c8add1e...3063af5adcf1c0331681fbbc13e679de1eb96487,11,132,64,196,15,2012-07-20 05:39:34,2012-07-20 05:39:34
b3a0ee8e631c3e272c8ce3b60929192d3f7f1f22...9b337b8328a65c5e692c90ba1f817184bd054257,25,147,45,192,36,2012-07-02 18:51:48,2012-07-02 18:51:48
9b337b8328a65c5e692c90ba1f817184bd054257...1d543e64300666e2abc5cc8562e6b55458878801,5,32,11,43,11,2012-07-02 18:59:48,2012-07-02 18:59:48
7f207d4a872cb55d302608a2739e94fc59ef1ff1...2abd054b0c3c3f1116840cf51444fc63e49057f6,7,51,28,79,15,2012-07-06 06:50:24,2012-07-06 06:50:24
2abd054b0c3c3f1116840cf51444fc63e49057f6...6533711825c3f197470be041b95e2885bae50bc5,4,15,7,22,9,2012-07-06 07:05:31,2012-07-06 07:05:31
7f207d4a872cb55d302608a2739e94fc59ef1ff1...369df86e710bd876b3d688472cdce987e27640a3,2,1,2,3,2,2012-07-05 18:29:37,2012-07-05 18:29:37
369df86e710bd876b3d688472cdce987e27640a3...d40b9ce26d9df5c9245d9a4f3c07c91dd1706f06,15,66,24,90,22,2012-07-05 18:59:37,2012-07-05 18:59:37
d40b9ce26d9df5c9245d9a4f3c07c91dd1706f06...0a6b64e6a9c5858801a7af2c408416b1c98de471,3,38,19,57,9,2012-07-05 19:59:37,2012-07-05 19:59:37
4e0c2f00d3edcabd24488161933b00d497656bfd...df6a75d52d9a7db6d3bbdb9c3c306a65b4f8a1f2,12,46,35,81,31,2012-07-05 06:35:23,2012-07-05 06:35:23
4fe438ce63b9332e85817ad6c46e4c9321aa39b1...aa708ed961e6c84010b3371cf64359152f08e7a8,3,96,90,186,4,2012-08-28 10:47:13,2012-08-28 10:47:13
aded7056fd3a9830215f41233ef609c0f9a3b862...7cdc5b9e0438c35c83fce739a764cb146d20c004,20,155,88,243,36,2012-08-28 21:04:06,2012-08-28 21:04:06
09831488c9be082f424c774e8eecd3f002dbae37...1b2068eaa91e5002d01a220c65da21dad8ccb071,8,23,8,31,11,2012-05-21 20:17:41,2012-05-21 20:17:41
1b2068eaa91e5002d01a220c65da21dad8ccb071...cc8369144db2147d2956e8dd7d314e9a7dfd4fbb,1,4,0,4,1,2012-05-22 11:57:04,2012-05-22 11:57:04
4ce034ca6526e34d71fb1a483a82be2486237e6b...a64aff2f1c1ddc77b00211489d74fbc23c0c2fa2,20,194,60,254,51,2012-08-17 13:20:55,2012-08-03 15:27:39
a64aff2f1c1ddc77b00211489d74fbc23c0c2fa2...c5ae1549a1d09599734ccaab27e90a8752f1ede6,1,4,0,4,1,2012-08-17 14:32:22,2012-08-17 14:32:22
4ce034ca6526e34d71fb1a483a82be2486237e6b...813814f02ed7bf226782861820570117fa196026,19,755,1123,1878,28,2012-08-17 06:09:11,2012-08-17 06:09:11
813814f02ed7bf226782861820570117fa196026...93401ef9887b297343d5bf33b4fbf39f13090894,4,15,14,29,13,2012-08-17 06:26:59,2012-08-17 06:26:59
93401ef9887b297343d5bf33b4fbf39f13090894...3f9749dd86874c4b6dcbdad7d3cd0dc7406a20b8,6,9,7,16,10,2012-08-18 20:53:58,2012-08-18 20:53:58
3f9749dd86874c4b6dcbdad7d3cd0dc7406a20b8...7530fa9decae2bb3d8622e1a40a080deb831af9f,1,1,1,2,1,2012-08-18 21:08:20,2012-08-18 21:08:20
7530fa9decae2bb3d8622e1a40a080deb831af9f...8eaead6a01739fee37d7b29b78decc2e8a4b89a3,4,11,1,12,4,2012-08-18 21:45:46,2012-08-18 21:45:46
8eaead6a01739fee37d7b29b78decc2e8a4b89a3...05c86fb0fc5b9e90889a96f9de301756ce3d5552,1,1,1,2,1,2012-08-19 07:20:42,2012-08-19 07:20:42
05c86fb0fc5b9e90889a96f9de301756ce3d5552...d4059ac966e26c4f384c53ca14319c56619fef78,3,185,183,368,4,2012-08-19 07:58:10,2012-08-19 07:58:10
d4059ac966e26c4f384c53ca14319c56619fef78...d656cb74f7e1becdb6ed686a7d36da48ab521030,4,14,0,14,6,2012-08-19 08:36:37,2012-08-19 08:36:37
d656cb74f7e1becdb6ed686a7d36da48ab521030...8e3a2def8af612689ddc830a3eab9e463b8bc205,4,0,74,74,4,2012-08-19 08:44:48,2012-08-19 08:44:48
8e3a2def8af612689ddc830a3eab9e463b8bc205...ccdea8b80dc3b7642c5d99e8f5dc8e80ed1e19c2,1,4,4,8,4,2012-08-19 09:14:36,2012-08-19 09:14:36
ccdea8b80dc3b7642c5d99e8f5dc8e80ed1e19c2...b2b88b2ff2a3044efa259d06c630dc903d0851bd,10,63,35,98,22,2012-08-20 19:51:37,2012-08-20 19:51:37
8e6a7a172eec57b56f5b460b3e041480dc8a740a...90c2cd1ee6c6fd018af0fb0dd79e0fb361000668,1,1,1,2,1,2012-08-06 00:31:16,2012-08-06 00:31:16
90c2cd1ee6c6fd018af0fb0dd79e0fb361000668...6f9428b1cd66d9f4ded1f1b1ef38e258e2b97c50,2,7,0,7,2,2012-08-06 00:32:17,2012-08-06 00:32:17
6f9428b1cd66d9f4ded1f1b1ef38e258e2b97c50...9a0b763eece1305437a7410cf9e6debca9a8670b,3,13,4,17,11,2012-08-06 01:16:06,2012-08-06 01:16:06
9a0b763eece1305437a7410cf9e6debca9a8670b...5443021a0e16887d14189f4203aea7f9282a1853,10,34,35,69,25,2012-08-06 03:08:22,2012-08-06 03:08:22
e8261313a71fb69adeedc15e15fb572282ceaf06...9912770c6f0177f496112543064355f79badf94b,1,10,1,11,1,2012-08-02 02:48:46,2012-08-02 02:48:46
f88a2617e65ecc037d3f885965efcee39745163d...a46a172ad99d5b3aba7de7bd49fb0d48f5fd7b65,1,1,1,2,1,2012-07-13 13:10:30,2012-07-13 13:10:30
ac525a74ee2862d0012a443059954288d4634acd...731b6be9c929d9117c322c605a7f53a8319751cd,2,12,4,16,4,2012-08-11 12:59:36,2012-08-11 12:59:36
14649525971d7351120f659213aad0e40722bc44...44ec5579bd73ef1f712e3a116fab5492f19b48ec,1,2,2,4,1,2012-07-19 15:39:02,2012-07-19 15:39:02
9267cb04b0b3fdf127899c4b7e636dc27fac06d3...a2d244ec062f3348f6cd1c5218c6097402c5f562,3,7,10,17,3,2012-07-21 08:04:05,2012-07-21 08:04:05
9267cb04b0b3fdf127899c4b7e636dc27fac06d3...787e5e94acf5e20280416c9fda105ef5b77576b3,1,3,3,6,3,2012-07-20 21:18:42,2012-07-17 23:11:51
caf5b9e5fa562cee2cca9cb484927a190b2bcf8a...a09558921bafcfae91b85af563ee10144c3b7ace,2,64,2,66,4,2012-07-02 20:08:07,2012-07-02 20:08:07
a09558921bafcfae91b85af563ee10144c3b7ace...cecdb0b384d2f6943fab704497e67a744eb553f7,2,71,51,122,4,2012-07-02 20:34:25,2012-07-02 20:34:25
cecdb0b384d2f6943fab704497e67a744eb553f7...00bc0e2577123a87f680eba0372800da64077dcc,1,1,1,2,1,2012-07-02 20:39:38,2012-07-02 20:39:38
00bc0e2577123a87f680eba0372800da64077dcc...e3fed8aaf4b2b9c3a7a0b719acd52408b1d4f90a,1,2,3,5,1,2012-07-04 21:57:12,2012-07-04 21:57:12
caf5b9e5fa562cee2cca9cb484927a190b2bcf8a...ec1b1588ee6469088491d44441ecd5e78ca70608,3,11,11,22,8,2012-07-01 10:11:17,2012-07-01 10:11:17
ec1b1588ee6469088491d44441ecd5e78ca70608...e00390b377d9264ad87eea30fdee8025f2c18eec,1,1,0,1,1,2012-07-01 10:24:47,2012-07-01 10:24:47
6533711825c3f197470be041b95e2885bae50bc5...0833b7ec5ba22ad4949db79443d3157c4edb13f5,1,1,1,2,1,2012-07-06 15:33:08,2012-07-06 15:33:08
0a6b64e6a9c5858801a7af2c408416b1c98de471...0f604e62fb453f2359ebc0438fe7dfaff8e55d10,3,13,21,34,10,2012-07-06 13:36:43,2012-07-06 13:08:17
0f604e62fb453f2359ebc0438fe7dfaff8e55d10...7b33d8cbcab3b0ee5789ec607455ab62130db69f,4,195,0,195,4,2012-07-24 12:19:51,2012-07-24 12:19:51
7b33d8cbcab3b0ee5789ec607455ab62130db69f...024e0348904179a8dea81c01e27a5f014cf57499,2,182,0,182,2,2012-07-24 12:25:01,2012-07-24 12:25:01
0a6b64e6a9c5858801a7af2c408416b1c98de471...31bc2b9495edcdfcc4c70c1e4d7bff715bcd57f5,3,3,3,6,3,2012-07-06 13:42:13,2012-07-06 13:42:13
31bc2b9495edcdfcc4c70c1e4d7bff715bcd57f5...9497b1a76ee84d12613604e37007e94a048b379e,2,17,8,25,5,2012-07-05 20:19:37,2012-07-05 20:19:37
5d88cdd9b82251b70559ba5172c15e333f28ff3c...d6b2b4f06952625da670735724e8c14ac3d7b9c5,1,5,5,10,5,2012-08-28 21:16:33,2012-08-28 21:16:33
d6b2b4f06952625da670735724e8c14ac3d7b9c5...e8e8ca940bd592738f123985a8791dadcc3f75e7,1,1,1,2,1,2012-08-28 21:19:34,2012-08-28 21:19:34
e8e8ca940bd592738f123985a8791dadcc3f75e7...c48c0f95b279e3fdaf0764d48711304beaa8ace8,1,41,39,80,4,2012-08-28 21:33:19,2012-08-28 21:33:19
c48c0f95b279e3fdaf0764d48711304beaa8ace8...b03ee4666bc5dfa3c509768918cbc8a477d24efb,3,14,2,16,4,2012-08-28 21:44:26,2012-08-28 21:44:26
cc8369144db2147d2956e8dd7d314e9a7dfd4fbb...7b6f51efc86fb502280625cf6f746076ee38ac41,1,1,1,2,1,2012-06-02 23:19:36,2012-06-02 23:19:36
cc8369144db2147d2956e8dd7d314e9a7dfd4fbb...eb5749ed392aa375ee6c50e9f6c9a5aabc11820b,2,19,4,23,5,2012-05-26 18:55:53,2012-05-26 18:20:35
eb5749ed392aa375ee6c50e9f6c9a5aabc11820b...39def0dcbb17a3f5883d6cb1965f815b537e5890,3,6,3,9,4,2012-05-26 18:56:11,2012-05-26 18:22:47
39def0dcbb17a3f5883d6cb1965f815b537e5890...48a36851e60249565e0869f88a05b36252c7e893,1,0,4,4,2,2012-05-26 18:56:11,2012-05-26 18:27:29
48a36851e60249565e0869f88a05b36252c7e893...50c2c16a4d8ca52c4abcbef638f5105a9b0d1ee0,2,7,4,11,4,2012-05-26 23:15:06,2012-05-26 23:15:06
50c2c16a4d8ca52c4abcbef638f5105a9b0d1ee0...11f90ae42eeca1c9bcc415d046663efef0941bf0,1,1,1,2,1,2012-05-27 02:19:37,2012-05-27 02:19:27
cc8369144db2147d2956e8dd7d314e9a7dfd4fbb...db048f1f8f91861e8cfd9254f36298bd0884ed29,1,1,1,2,1,2012-05-23 18:45:02,2012-05-23 18:45:02
cc8369144db2147d2956e8dd7d314e9a7dfd4fbb...c5b12fad44237159eca65a7ea5d7948505a3adca,3,3,3,6,3,2012-05-23 03:00:51,2012-05-21 04:00:24
48443d20ca9aa10323c1b81835e519680b10debc...36ffdf36b96a877154f265327d83d022ed27e9e4,1,1,1,2,1,2012-08-24 13:40:44,2012-08-24 13:40:44
36ffdf36b96a877154f265327d83d022ed27e9e4...6d6c7a17ea2d2a61d4f251d6d746ebe9438405ca,3,37,3,40,5,2012-08-31 13:45:50,2012-08-31 13:45:50
6d6c7a17ea2d2a61d4f251d6d746ebe9438405ca...1b0198f1d3fc621b339af0e7fd79a74919856d46,2,2,1,3,2,2012-08-31 14:24:12,2012-08-31 14:24:12
1b0198f1d3fc621b339af0e7fd79a74919856d46...0dd94cd86ec0680432e58f2630a3a35fa84afd73,1,32,37,69,4,2012-08-31 14:44:23,2012-08-31 14:44:23
b2b88b2ff2a3044efa259d06c630dc903d0851bd...eae41ad1df37cec184179df02fce7faa9434cb2a,3,162,36,198,33,2012-09-02 16:29:46,2012-08-26 14:18:13
eae41ad1df37cec184179df02fce7faa9434cb2a...b80dd3d2422b59a1b241ccdae32140ca19f33dc3,215,3838,3357,7195,652,2012-09-02 16:39:50,2012-09-02 16:31:16
b2b88b2ff2a3044efa259d06c630dc903d0851bd...652d955c92937d74bd81b9af4adf3b1549d89876,2,37,13,50,13,2012-08-21 03:04:53,2012-08-21 03:04:53
652d955c92937d74bd81b9af4adf3b1549d89876...c5b13cc9897d9b7175722589e6f0c3b66ded143d,1,18,14,32,15,2012-08-21 03:18:57,2012-08-21 03:18:57
528d125dbbf8aa3bb76addf335f18d1d94cb16ee...28ddc152e932ae64f2a3a2247de8e0f45299da9c,1,0,1,1,1,2012-08-11 21:36:43,2012-08-11 21:36:43
28ddc152e932ae64f2a3a2247de8e0f45299da9c...463644c8827a6015d9a3669e64ff04683d9f1c3d,4,24,40,64,10,2012-08-13 05:32:10,2012-08-13 05:32:10
463644c8827a6015d9a3669e64ff04683d9f1c3d...6ebd360cf2627f874532db6b6fa7f14d4b23984b,7,272,181,453,112,2012-08-13 05:52:10,2012-08-13 05:52:10
72c6be2d1a9794c19fa18148434f821d52e20018...34ba4e135202db79ceb29c738ee476c5f54acf50,4,32,2,34,5,2012-08-02 21:20:09,2012-08-02 21:20:09
3079687b93bb957cdbe857bcb49b7a1834e2004b...6de488259701af4b69282ad105882dba423fb666,18,39,589,628,19,2012-08-03 16:29:54,2012-08-03 16:29:54
6de488259701af4b69282ad105882dba423fb666...b846ac10597d832bd4b03ee65a026fcf4f9480f2,4,57,52,109,4,2012-08-03 16:39:54,2012-08-03 16:39:54
b846ac10597d832bd4b03ee65a026fcf4f9480f2...1281c122c7a4edf2873aad13c22ea09ce6dc57c3,14,115,206,321,7,2012-08-03 16:49:54,2012-08-03 16:49:54
1281c122c7a4edf2873aad13c22ea09ce6dc57c3...9844ddd43f20e84754759688fea39e1a0241bb06,16,80,192,272,18,2012-08-03 16:59:55,2012-08-03 16:59:55
652d28f56bdf7bb2e2f2e2619221535a7bb2ec04...36efa2042cb94571957582c7bd4316a3559696e6,10,72,1,73,10,2012-07-20 00:23:55,2012-07-20 00:09:19
36efa2042cb94571957582c7bd4316a3559696e6...04a85f458214304b8d96a1ea052b40e171a3f2f5,1,1,1,2,1,2012-07-20 17:16:19,2012-07-20 17:16:19
652d28f56bdf7bb2e2f2e2619221535a7bb2ec04...f003abf729570bb3b55a27b18e59c58c8698f5b8,1,1,1,2,1,2012-07-15 20:17:46,2012-07-15 20:17:46
efde86537a157b6b0ebb0227cf434e6898624414...2c32574ac303e180f43cfc2a3d119dd6a7b29b0c,2,12,3,15,3,2012-08-25 20:39:01,2012-08-25 20:39:01
92d98f5a0c28bffd7b070cda190b07ab72667d58...1b95c8bff351f6718ec31ac1de1e48c57bc95d44,2,9,2,11,3,2012-07-25 09:18:30,2012-07-25 09:18:30
1b95c8bff351f6718ec31ac1de1e48c57bc95d44...949b1df930bedace1dbd755aaa4a82e8c451a616,4,29,29,58,29,2012-07-25 09:35:41,2012-07-25 09:35:41
949b1df930bedace1dbd755aaa4a82e8c451a616...f7dd067490fe57505f7226c3b54d3127d2f7fd46,2,6,1,7,4,2012-07-25 11:22:21,2012-07-25 11:22:21
f7dd067490fe57505f7226c3b54d3127d2f7fd46...cb32e0320ab538b465574bb73c7bd3d32db56d3c,2,13,2,15,2,2012-07-25 12:24:28,2012-07-25 12:24:28
860fa1163a5fbdfec2bb01ff2d584351554dee29...a69fc5dd23bd502fd36892a80eec21a4c53891f8,5,10,8,18,8,2012-07-21 07:23:05,2012-07-21 07:23:05
a69fc5dd23bd502fd36892a80eec21a4c53891f8...4261acda90ff4c61326d80cba026ae76e8551f8f,1,5,4,9,2,2012-07-21 07:27:09,2012-07-21 07:27:09
4261acda90ff4c61326d80cba026ae76e8551f8f...9c8a1e651716212cf50a623d98e03b8dbdb2c64a,1,7,38,45,1,2012-07-21 07:32:42,2012-07-21 07:32:42
9c8a1e651716212cf50a623d98e03b8dbdb2c64a...11721b0dbe82c35789be3e4fa8e14663934b2ff5,2,55,0,55,3,2012-07-21 07:47:57,2012-07-21 07:47:57
11721b0dbe82c35789be3e4fa8e14663934b2ff5...8b7e404b5b6944e9c92cc270b2e5d0005781d49d,2,5,1,6,2,2012-07-21 07:53:55,2012-07-21 07:53:55
e00390b377d9264ad87eea30fdee8025f2c18eec...a2eda66b30d737e3ca1a5fc17a7f36416939a41f,12,29,47,76,28,2012-07-02 18:51:48,2012-07-02 18:51:48
9f520a65ba75f21d79d4e599a11b195f6a9a9e52...0daf53b759dd25bea0b3db880d03cc19abe6e2bb,1,2,2,4,2,2012-07-06 15:46:26,2012-07-06 15:46:26
0daf53b759dd25bea0b3db880d03cc19abe6e2bb...6451e837bf2cf11f8956824329ddde0e14171a8e,2,28,10,38,3,2012-07-05 23:16:41,2012-07-05 23:16:41
6451e837bf2cf11f8956824329ddde0e14171a8e...be1b40802dcbfd59ecdd3c7439fc48d6cec97e2b,4,79,0,79,4,2012-07-06 00:05:12,2012-07-06 00:05:12
eca823c1c7cef45cc18c6ab36d2327650c85bfc3...fbb41100db35cf2def2c8b4d896b7015d56bd15b,1,16,4,20,6,2012-07-24 12:52:43,2012-07-24 12:52:43
b03ee4666bc5dfa3c509768918cbc8a477d24efb...a04b919a4c5ef570e46ae94d6d11b09eb893b7cd,2,7,0,7,3,2012-08-29 00:30:50,2012-08-28 05:28:09
a04b919a4c5ef570e46ae94d6d11b09eb893b7cd...4805c64f2a96e8a9ea5a0e94a820d840fa1675e0,4,0,128,128,4,2012-08-29 00:30:50,2012-08-28 05:28:47
4805c64f2a96e8a9ea5a0e94a820d840fa1675e0...c9c1f76e002d899dd6765c4c1630697cc5068f27,8,262,31,293,17,2012-08-29 01:22:49,2012-08-28 05:42:28
c9c1f76e002d899dd6765c4c1630697cc5068f27...0bc909405852135d7f98440193830eba664ea122,2,16,0,16,2,2012-08-29 01:22:49,2012-08-28 10:57:00
0bc909405852135d7f98440193830eba664ea122...77d06454ededc3beef09db709829ccb687ccc045,6,37,95,132,32,2012-08-29 01:22:49,2012-08-28 11:01:27
77d06454ededc3beef09db709829ccb687ccc045...a39cfb54616fe156ba43ac3df2b771c3a11d2879,1,7,22,29,4,2012-08-29 01:22:49,2012-08-29 00:57:54
a39cfb54616fe156ba43ac3df2b771c3a11d2879...a3a63eeb92f5cc660dc3f03e2d7249e4b5f04acf,6,30,30,60,10,2012-08-29 01:22:49,2012-08-29 01:13:22
a3a63eeb92f5cc660dc3f03e2d7249e4b5f04acf...39ff033d1ab536c4e493510ee99e392b5fd25a07,2,7,4,11,2,2012-08-29 01:22:49,2012-08-29 01:15:21
39ff033d1ab536c4e493510ee99e392b5fd25a07...1dda08486b7751a677870486d4b576e6dd6071e7,1,3,17,20,3,2012-08-29 05:55:41,2012-08-29 05:55:41
d72f8db08a46cd03879035932ece2b4295bb3948...020caf1274a32f3d6863f92acd82dded53463be0,1,1,1,2,1,2012-05-27 09:34:25,2012-05-27 09:34:25
020caf1274a32f3d6863f92acd82dded53463be0...baa54629a9e393e339dc0f5f7c95ffe761206923,1,17,0,17,1,2012-05-27 10:22:23,2012-05-27 10:22:23
baa54629a9e393e339dc0f5f7c95ffe761206923...9cd1069a8c0c9193c5867d12419eb5b9852f6411,2,28,20,48,4,2012-05-27 10:39:57,2012-05-27 10:39:57
9cd1069a8c0c9193c5867d12419eb5b9852f6411...2a67879b751b44aab219a23314afe8bcb1ff63ac,1,1,1,2,1,2012-05-27 10:40:43,2012-05-27 10:40:43
2a67879b751b44aab219a23314afe8bcb1ff63ac...b729004a500edf330fe68dbf6e5e6cdcb937b8d4,1,10,0,10,1,2012-05-27 17:52:40,2012-05-27 17:52:40
b729004a500edf330fe68dbf6e5e6cdcb937b8d4...89043d6b891057d756b2f9f518d0eb043ce07a19,2,37,12,49,8,2012-05-28 17:19:54,2012-05-28 17:19:54
db78a63eb16109e08c6f861c6fafc6dc124eb181...ddc7568fec59aa7a068116f692804504d9aa1a1d,10,76,57,133,18,2012-05-24 06:23:52,2012-05-24 06:23:25
ddc7568fec59aa7a068116f692804504d9aa1a1d...8ceb94081ac516ccaed43f0f4841725a4f9fe2db,2,36,1,37,3,2012-05-25 13:38:23,2012-05-25 13:38:23
d2a12e02868da64d80e8c8679abac49300b08012...837a78db2e550a690cc4804675f999c9c1928839,1,2,2,4,1,2012-05-23 09:20:41,2012-05-23 09:20:41
621affecb59b8ce5304370cfd7979fba2b73ff4e...486de8c3f412df3e71c9045faf250941c03c8c00,7,91,69,160,18,2012-09-12 04:48:22,2012-09-12 04:48:22
486de8c3f412df3e71c9045faf250941c03c8c00...fa4150d47d88b85d6027729844480a3e7c71d3cd,9,49,47,96,16,2012-09-12 05:23:20,2012-09-12 05:23:20
fa4150d47d88b85d6027729844480a3e7c71d3cd...048d47e6266b5b078a169f1657d07883e86f169b,4,176,55,231,8,2012-09-12 06:23:16,2012-09-12 06:23:16
366c0065c4302eacbb26ba7292c4c0528dbd33a6...2e7ca8c866179e78866cba1659dee45185911f5a,3,13,11,24,10,2012-08-21 05:20:11,2012-08-21 05:20:11
2e7ca8c866179e78866cba1659dee45185911f5a...c625293b995cf21a1b551cecaac3cb742fcb2e66,7,29,46,75,8,2012-08-21 17:14:06,2012-08-21 17:14:06
c625293b995cf21a1b551cecaac3cb742fcb2e66...64f3682feb90c3eb8dbd4f0cd16ad6057b302a6c,1,0,1,1,1,2012-08-21 17:24:04,2012-08-21 17:24:04
3784f134f1b2a34ce751bba0caf423d2779e604f...3095483e650ae4fc79ff5012117877e5734b75ee,3,11,5,16,5,2012-08-22 02:27:06,2012-08-22 02:20:09
3095483e650ae4fc79ff5012117877e5734b75ee...6baf9c441d7051276b5bfdbe43499d74d3acc65d,1,0,1,1,1,2012-08-22 02:48:15,2012-08-22 02:48:15
6ebd360cf2627f874532db6b6fa7f14d4b23984b...d1d19aecdeb73069357885b91dcc0b9f31cde4ba,1,63,47,110,3,2012-08-14 08:33:41,2012-08-14 06:48:23
d1d19aecdeb73069357885b91dcc0b9f31cde4ba...e31a9dd253d545e3d364a007994a0de6c1c1896c,1,4,7,11,3,2012-08-14 08:33:46,2012-08-14 07:49:55
e31a9dd253d545e3d364a007994a0de6c1c1896c...b039a169462ba0f04402d4f1af127216b65f119d,2,101,59,160,5,2012-08-14 08:37:18,2012-08-14 08:32:19
6ebd360cf2627f874532db6b6fa7f14d4b23984b...0b7e67ad12dff04da6d7825a6125099ef0d21174,2,4,2,6,3,2012-08-14 08:24:27,2012-08-14 08:24:27
6ebd360cf2627f874532db6b6fa7f14d4b23984b...6af38f51453d6a59eb983c13efa1e08303c2ec16,7,8,8,16,8,2012-08-14 01:02:40,2012-08-10 23:47:54
6af38f51453d6a59eb983c13efa1e08303c2ec16...70174a1e1a132f92abd9106fcfe8d596c6d56bf1,5,5,9,14,5,2012-08-14 21:26:38,2012-08-14 21:26:38
34ba4e135202db79ceb29c738ee476c5f54acf50...1ec3bd3f8d237c1afb73d4ad1b7a0c24f9a6887c,3,1356,4,1360,7,2012-08-08 08:12:05,2012-08-07 13:17:29
1ec3bd3f8d237c1afb73d4ad1b7a0c24f9a6887c...9639780359f16d784f22af2a1dbbcd8322ffd6c3,5,18,1341,1359,7,2012-08-10 06:47:48,2012-08-08 09:25:24
34ba4e135202db79ceb29c738ee476c5f54acf50...6171a4d8ebd1602b987bc6d93fd19443696c155b,4,104,99,203,6,2012-08-03 00:28:02,2012-08-03 00:28:02
6171a4d8ebd1602b987bc6d93fd19443696c155b...04bad8257f1aec906e10576c425edcba3d9d8f90,3,18,18,36,5,2012-08-08 08:52:09,2012-08-08 08:52:09
04bad8257f1aec906e10576c425edcba3d9d8f90...a76adfa472d278fe01eed531667becab6a03f53a,1,1,0,1,1,2012-08-09 03:02:55,2012-08-09 03:02:55
a76adfa472d278fe01eed531667becab6a03f53a...8ffb6126a9ccc329e8abc142fa7f0c03184c4f16,2,29,18,47,8,2012-08-09 03:36:55,2012-08-09 03:36:55
8ffb6126a9ccc329e8abc142fa7f0c03184c4f16...839757598bfa92da509ec52d696ed748d3c7b8d7,5,32,2,34,6,2012-08-09 04:34:29,2012-08-09 04:34:29
50831b1db26935178f3fedbbb92adf54dc478c5d...4a437cdf860880e45614f8afaeb6156f1c917f79,1,0,13,13,1,2012-08-02 06:05:00,2012-08-02 06:05:00
4a437cdf860880e45614f8afaeb6156f1c917f79...9b4c41f826151bbad4a3dbb42b892f250f8901b5,1,1,0,1,1,2012-08-02 06:07:01,2012-08-02 06:07:01
9b4c41f826151bbad4a3dbb42b892f250f8901b5...9bf7c1ee319496f5cb7f138ca6c82aa167d02864,1,0,1,1,1,2012-08-04 07:13:54,2012-08-04 07:13:54
9bf7c1ee319496f5cb7f138ca6c82aa167d02864...7dd276817c6459e0fdf6524f1b8e51decd385986,3,9,0,9,5,2012-08-02 06:48:53,2012-08-02 06:48:24
1c60c3d73dfe9b12729a2d5339f12a34f31cf3f4...c120457a6f723167cece9b8cd4bde8197de167f7,1,5,0,5,1,2012-08-02 12:30:22,2012-08-02 12:30:22
61c85332d2ab8545323a897724439526297c8899...0296121f08cd960f5a96686b3bedd75f5651765a,1,0,47,47,1,2012-07-25 18:38:33,2012-07-25 18:38:33
0296121f08cd960f5a96686b3bedd75f5651765a...501ca8e6e83c221487ccc03da906ccda385831c8,2,5,2,7,2,2012-07-25 18:45:53,2012-07-25 18:45:53
501ca8e6e83c221487ccc03da906ccda385831c8...14c97237246f01da60ad73d9efd2c08c45927f09,3,12,8,20,6,2012-07-25 19:08:47,2012-07-25 19:08:47
2c32574ac303e180f43cfc2a3d119dd6a7b29b0c...28cc4de2677d86274665acbd95891ac01960c17c,1,0,0,0,0,2012-08-27 05:43:28,2012-08-27 05:43:28
2c32574ac303e180f43cfc2a3d119dd6a7b29b0c...aaeb37419ac00ed065f1c88f617db5788ada8525,6,78,0,78,6,2012-08-26 21:13:03,2012-08-26 21:13:03
aaeb37419ac00ed065f1c88f617db5788ada8525...3c96d1f0e1fa1264250c0f93fbd0c26a0dbb1330,3,20,3,23,4,2012-08-26 21:32:03,2012-08-26 21:32:03
8b7e404b5b6944e9c92cc270b2e5d0005781d49d...fa5a53f5ed2914052e07ef8fd46879576c978563,4,26,9,35,11,2012-07-29 14:15:52,2012-07-29 14:15:52
fa5a53f5ed2914052e07ef8fd46879576c978563...ad265b9610b474132752da43cf845d82ddf5fd8c,1,6,1,7,2,2012-08-05 09:27:17,2012-08-05 09:27:17
ad265b9610b474132752da43cf845d82ddf5fd8c...335b3ed19791d2bf5aea9c95f46af925ebc80412,1,1,1,2,1,2012-08-20 10:58:03,2012-08-20 10:58:03
8b7e404b5b6944e9c92cc270b2e5d0005781d49d...03a2995e15e69ad1ec73b1c0ecefaf3d2551b0da,2,6,1,7,2,2012-07-28 13:05:25,2012-07-28 12:59:30
8b7e404b5b6944e9c92cc270b2e5d0005781d49d...ec01cbef9452dcbe7a09f1709370a7939f66c542,1,4,2,6,3,2012-07-26 19:30:10,2012-07-22 12:48:23
8b7e404b5b6944e9c92cc270b2e5d0005781d49d...0301ba3315436a2dc466415ab0a3dd4fd7be3931,3,6,1,7,4,2012-07-24 18:41:26,2012-07-24 18:41:26
8b7e404b5b6944e9c92cc270b2e5d0005781d49d...dce6f7beb4db3074d989d57318e3b4c1b7e9bd00,1,1,1,2,1,2012-07-24 10:22:13,2012-07-24 10:22:13
8b7e404b5b6944e9c92cc270b2e5d0005781d49d...ff40b7de7a6451bb9e3bc12a18070bbff13b6a68,1,4,0,4,1,2012-07-21 17:59:55,2012-07-21 17:37:31
ff40b7de7a6451bb9e3bc12a18070bbff13b6a68...34cea1cb632c907ae399df64c60e93a5c716eeca,11,28,19,47,23,2012-07-22 11:08:24,2012-07-22 11:08:24
34cea1cb632c907ae399df64c60e93a5c716eeca...f9877c529eb6864dbf4b21ef6ddd2ab48159f1b3,1,5,5,10,4,2012-07-22 11:08:32,2012-07-22 11:08:32
8b7e404b5b6944e9c92cc270b2e5d0005781d49d...6035ad7e1fe519d0c6a42731790183889e3ba31d,1,1,0,1,1,2012-07-21 14:32:04,2012-07-21 14:30:09
abc360fea3658c24e71c3cdd13da70a4dede3599...00ef16a66c3865e534004d236052f8b13f5a6735,1,5,1,6,1,2012-07-03 15:34:47,2012-07-03 15:34:47
00ef16a66c3865e534004d236052f8b13f5a6735...51f174b97f686397bc7299c16a64fda14d5bc718,2,12,4,16,4,2012-07-03 15:52:48,2012-07-03 15:52:48
be1b40802dcbfd59ecdd3c7439fc48d6cec97e2b...c5b16f0998f0290381808e31b6f58c9d311ba76b,1,1,2,3,1,2012-07-10 07:57:43,2012-07-10 07:57:43
be1b40802dcbfd59ecdd3c7439fc48d6cec97e2b...ba7b85d0d986e7c511aa91bde97b3a992bb5d436,7,48,11,59,12,2012-07-10 04:33:04,2012-07-10 04:33:04
be1b40802dcbfd59ecdd3c7439fc48d6cec97e2b...12b34c8115bbb35524880bca4f21ad0939de4b77,2,199,0,199,2,2012-07-09 22:01:05,2012-07-09 21:45:43
12b34c8115bbb35524880bca4f21ad0939de4b77...4dae41d5dc90473e3c5c08064c25433fecf5abd3,3,26,23,49,18,2012-07-10 14:12:19,2012-07-10 14:12:19
8da05a4ff7cd9cd84e74bd8a017baf59135ee39d...4d65532158fb826b51290e0bbc30f34a1ec21d49,3,47,0,47,3,2012-08-29 06:49:39,2012-08-29 06:49:39
4d65532158fb826b51290e0bbc30f34a1ec21d49...2cb0a62f7d087c77c94c1b561fd2c9e3dd3d2661,2,76,9,85,8,2012-08-29 07:48:17,2012-08-29 07:48:17
2cb0a62f7d087c77c94c1b561fd2c9e3dd3d2661...43cad71f1adbefe462f1c7216c8323c3f36704f4,1,6,10,16,2,2012-08-29 07:50:35,2012-08-29 07:50:35
8da05a4ff7cd9cd84e74bd8a017baf59135ee39d...5afb16e4965e41af420211fa35bff0d2d0a07de7,2,2,1,3,2,2012-08-29 04:13:29,2012-08-29 04:13:29
89043d6b891057d756b2f9f518d0eb043ce07a19...206230a4ecb5c7e1b4de445ccda14814ad5a0232,1,15,11,26,6,2012-05-29 08:16:59,2012-05-29 08:16:59
206230a4ecb5c7e1b4de445ccda14814ad5a0232...e1d1673e74c35fc2d64e71320668d981d634b02a,1,17,10,27,8,2012-05-29 08:17:31,2012-05-29 08:17:31
e1d1673e74c35fc2d64e71320668d981d634b02a...efd9a717c10f1cafd05fb20729eafb61226d9c1d,1,7,3,10,3,2012-05-30 03:44:36,2012-05-30 03:44:36
efd9a717c10f1cafd05fb20729eafb61226d9c1d...c71a76e71a33315977797db3e72be1f76462183f,2,19,4,23,3,2012-05-30 03:47:26,2012-05-30 03:47:26
c71a76e71a33315977797db3e72be1f76462183f...202807c21a61696ad50aadf43781ca15b9deaede,2,3,3,6,3,2012-05-30 03:56:00,2012-05-30 03:56:00
202807c21a61696ad50aadf43781ca15b9deaede...34cc38b6f5942523820ce239b1d5877b0a97e25e,1,2,2,4,2,2012-05-30 03:56:48,2012-05-30 03:56:48
34cc38b6f5942523820ce239b1d5877b0a97e25e...c62715acc920f92ce2f3febf4dc3f838e3097410,2,2,23,25,3,2012-05-30 04:11:03,2012-05-30 04:11:03
c62715acc920f92ce2f3febf4dc3f838e3097410...e851cb07762aa464aae10e8b4b28de87c1a6f925,1,1,1,2,2,2012-05-30 05:40:47,2012-05-30 05:40:47
89043d6b891057d756b2f9f518d0eb043ce07a19...632415567f269a230f2ecd25c18f4639dccf3a7e,2,2,6,8,3,2012-05-28 21:35:50,2012-05-28 21:35:50
632415567f269a230f2ecd25c18f4639dccf3a7e...e4d47d30de823c52e7f565cd2007918bb2858479,1,4,1,5,2,2012-05-28 21:38:15,2012-05-28 21:38:15
8ceb94081ac516ccaed43f0f4841725a4f9fe2db...3272620f724737f4dbb5e8c02f1610946435cd29,20,87,85,172,29,2012-05-26 10:37:49,2012-05-26 10:37:49
8ceb94081ac516ccaed43f0f4841725a4f9fe2db...74d62957b6f3624534d6969e56b6da95978791fd,1,1,1,2,1,2012-05-26 05:35:50,2012-05-26 05:35:50
64f026b254a9492bc22cdbad45ceb4743949f406...acc5302c3fea3f07a654e270f06ebf96fec14c5c,6,67,47,114,12,2012-09-12 15:56:44,2012-09-12 15:56:44
acc5302c3fea3f07a654e270f06ebf96fec14c5c...9329dfbfc59325196fc98bcb15bd47adf8121013,1,3,4,7,1,2012-09-12 16:01:52,2012-09-12 16:01:52
9329dfbfc59325196fc98bcb15bd47adf8121013...4782163c7acd3dc972675df4d6378244a8970450,1,1,1,2,1,2012-09-12 16:06:32,2012-09-12 16:06:32
64f3682feb90c3eb8dbd4f0cd16ad6057b302a6c...9ec4c2d214b045f3fb207edd67055c4ccaebd381,1,5,2,7,1,2012-08-21 21:07:11,2012-08-21 21:07:11
64f3682feb90c3eb8dbd4f0cd16ad6057b302a6c...7fa6a23416e08fe6ac832e60e78bd6fe61f21955,1,5,0,5,1,2012-08-21 17:53:33,2012-08-21 17:53:33
7fa6a23416e08fe6ac832e60e78bd6fe61f21955...f088eaa972ae3bc3beddb85adb98d185ea8a2ddc,6,21,4,25,10,2012-08-21 18:26:56,2012-08-21 18:26:56
d862ebd3b340d46937e0bf37c382fd93056b238e...d1daeba1736ba145fe525ce08a91f29495a3abf1,3,20,2,22,5,2012-08-21 19:45:14,2012-08-21 19:44:49
d1daeba1736ba145fe525ce08a91f29495a3abf1...5c7ed6fa26b47ac71ff6ba04720d85df6d74b200,1,1,1,2,1,2012-08-21 22:15:26,2012-08-21 22:15:26
5c7ed6fa26b47ac71ff6ba04720d85df6d74b200...aa50408ecb5c7355d7cac86f7a59f02ae087714c,15,104,74,178,30,2012-08-22 00:56:53,2012-08-22 00:56:53
0456dd72e26aaba6455e851260426d0156ba159a...65bcc41f3e0a8b678e201e7f3d6a63c5b463fbe3,4,43,11,54,8,2012-08-16 01:06:08,2012-08-16 01:06:08
0456dd72e26aaba6455e851260426d0156ba159a...6641761e5cdde2ae7515a97691ecbafb996fdf4c,2,2,2,4,2,2012-08-15 04:03:13,2012-08-15 04:03:13
0e5dbd1caf10baf7e812ad2eccbadce2f05a3f13...32ae7fb616673a003ba24dcde1ded3bad8ff37d1,2,33,7,40,8,2012-08-23 18:10:06,2012-08-23 18:10:06
839757598bfa92da509ec52d696ed748d3c7b8d7...7a4c95888225bf465187f9a186fb5373e8405a5f,3,5,0,5,3,2012-08-09 01:26:56,2012-08-09 01:26:56
7a4c95888225bf465187f9a186fb5373e8405a5f...f36f0dac9d2a009f29d2253dcd7c66d5a46ffd56,3,52,86,138,13,2012-08-09 01:44:33,2012-08-09 01:40:57
f36f0dac9d2a009f29d2253dcd7c66d5a46ffd56...b7f9b8223e40aa9e4aa8579d9a062df7e2e1d959,3,21,2,23,3,2012-08-09 17:45:12,2012-08-09 17:45:12
839757598bfa92da509ec52d696ed748d3c7b8d7...ac9cec740bc1743d7c2d1f099e2700ce7ac0f586,2,7,1,8,2,2012-08-10 07:49:45,2012-08-10 07:49:45
ac9cec740bc1743d7c2d1f099e2700ce7ac0f586...a8ce107c64c98f547613fd0e5a2b38c360f17fae,4,114,92,206,11,2012-08-09 05:13:29,2012-08-09 05:13:29
a8ce107c64c98f547613fd0e5a2b38c360f17fae...f197fa1fbffae2607c01d323aad1a839e086fbbc,4,2,5,7,5,2012-08-08 14:08:43,2012-08-08 14:08:43
14c97237246f01da60ad73d9efd2c08c45927f09...c27105f8c3dc8b0baec0d36f339dbfc943ff155b,7,28,27,55,10,2012-07-26 11:45:17,2012-07-26 11:45:17
c27105f8c3dc8b0baec0d36f339dbfc943ff155b...18f83016b15a1ad388ccb85a6e0878e7f5f14527,5,55,21,76,8,2012-07-26 13:14:34,2012-07-26 13:14:34
14c97237246f01da60ad73d9efd2c08c45927f09...1127c9849096868eb3762350fc2b4124fd209cab,1,1,1,2,1,2012-07-26 08:47:17,2012-07-26 08:47:17
14c97237246f01da60ad73d9efd2c08c45927f09...cbce4528d0e0aace791ed2d9d16176d29596a615,3,14,16,30,5,2012-07-25 19:11:58,2012-07-22 12:31:42
cbce4528d0e0aace791ed2d9d16176d29596a615...73dabcb35797480075ae872218bfdbd100e48e63,3,4,5,9,3,2012-07-25 19:11:58,2012-07-22 12:33:03
73dabcb35797480075ae872218bfdbd100e48e63...e6bb4f1491e8a2420ff4965dc48ade144d87676e,1,1,2,3,1,2012-07-25 19:11:58,2012-07-22 12:33:31
e6bb4f1491e8a2420ff4965dc48ade144d87676e...0aee7c94d011bb760523f1dfd3bd1e2e31ac0e49,2,8,11,19,2,2012-07-25 19:11:58,2012-07-22 12:37:46
0aee7c94d011bb760523f1dfd3bd1e2e31ac0e49...6fc6833cdbabb44c4a1f3b8f72e99b735e13f134,1,2,2,4,2,2012-07-25 19:11:58,2012-07-22 12:36:22
6fc6833cdbabb44c4a1f3b8f72e99b735e13f134...f6a67ef207612b507b1facb05fc8579c5e3d3f6e,1,6,7,13,1,2012-07-25 19:27:25,2012-07-23 23:22:01
67ef96ea5f721cc620f3e931f05d918c904ec74e...0590aa9d6073e79ba47c4fe5c34318f6889c44d8,7,46,23,69,12,2012-07-27 08:22:05,2012-07-27 08:22:05
e6edaa3b502090f461b58c439ea476da2d37f039...69c4cea65a7ba13469f43914fbdccf592053fec8,5,128,7,135,13,2012-07-31 14:32:44,2012-07-26 14:29:53
69c4cea65a7ba13469f43914fbdccf592053fec8...ce837f3d1bbacd3dc9e9171d66f3cf5ed3317c7f,1,1,1,2,1,2012-07-31 14:34:06,2012-07-31 14:34:06
dce6f7beb4db3074d989d57318e3b4c1b7e9bd00...516a76c9a915e5319b4a53f1eb2c3daedbd5ca2c,1,1,1,2,1,2012-08-01 10:19:20,2012-08-01 10:19:20
51f174b97f686397bc7299c16a64fda14d5bc718...82946c0a2302927eed5e33c4de0ef011f0a41f6e,1,1,1,2,1,2012-07-03 21:21:58,2012-07-03 21:21:58
51f174b97f686397bc7299c16a64fda14d5bc718...031ae7756e11f3aa3c53b81b408abdd762eef42a,9,152,72,224,24,2012-07-03 17:52:48,2012-07-03 17:52:48
5afb16e4965e41af420211fa35bff0d2d0a07de7...adc71b6a6ae06a96aa82052012ae6e61bd3a9cb1,4,10,8,18,8,2012-08-29 04:58:22,2012-08-29 04:58:22
133102a7eb828c1c9fd016851aaca3d9f5d99e7e...fc74627f3c187467fdc3ab8f0af50d044d3dfc26,1,0,0,0,0,2012-05-29 12:11:55,2012-05-29 12:11:55
fc74627f3c187467fdc3ab8f0af50d044d3dfc26...faa0ec7c634bdf394b67366e8f90fb4c5a40542d,2,7,15,22,11,2012-05-29 12:13:41,2012-05-29 12:13:41
faa0ec7c634bdf394b67366e8f90fb4c5a40542d...078b312a31dc27c8b3107d8d9278e13e7b769892,2,1,5,6,6,2012-05-29 12:22:26,2012-05-29 12:22:26
078b312a31dc27c8b3107d8d9278e13e7b769892...475d9f487f7050fcf8e52b319cd938c0949ed515,4,7,8,15,6,2012-05-29 12:35:34,2012-05-29 12:35:34
475d9f487f7050fcf8e52b319cd938c0949ed515...8c7caaa69c8d8cb0b621e5954a19ceb20179985a,5,7,1321,1328,7,2012-05-29 12:50:10,2012-05-29 12:50:10
8c7caaa69c8d8cb0b621e5954a19ceb20179985a...f01994e1f85684e4c880ce0f0030cc729db8748b,1,0,0,0,0,2012-05-29 12:56:48,2012-05-29 12:53:38
f01994e1f85684e4c880ce0f0030cc729db8748b...865cf830c482b120aad70d40ebee595901899b1c,53,21,3171,3192,34,2012-05-29 13:45:18,2012-05-29 13:45:18
865cf830c482b120aad70d40ebee595901899b1c...058d80b3363dd4fc4417ca4f60f76119188a2470,1,0,0,0,0,2012-05-29 13:55:55,2012-05-29 13:55:55
058d80b3363dd4fc4417ca4f60f76119188a2470...7c7761099cae83f59fe5780340e100be890847b2,1,5,5,10,5,2012-05-29 14:16:28,2012-05-29 14:16:28
2cf8010792c3075824ee27d0f037aeb178cbbf7e...f8f6ff065eccc6ede4d35ed87a09bb962b84ca25,4,53,4,57,8,2012-06-01 06:42:02,2012-06-01 06:42:02
f8f6ff065eccc6ede4d35ed87a09bb962b84ca25...cc3c6ad0ef3fed3451513f3f7f19e45ea0b77152,2,16,2,18,4,2012-06-01 13:56:28,2012-06-01 13:56:28
2cf8010792c3075824ee27d0f037aeb178cbbf7e...b826a684c7c66225fa60c4f82ecadea3c8e69b57,1,1,1,2,1,2012-05-30 16:46:09,2012-05-30 16:46:09
b826a684c7c66225fa60c4f82ecadea3c8e69b57...78f4c789b335362804c0536dd1124642feb824d8,4,125,101,226,4,2012-05-30 18:02:30,2012-05-30 18:02:30
c4b779435227f71d8d6a731a8967268797c073ce...d29ec9d7730ea2cf07ccc2e9dc07dd20df5c391c,18,26,19,45,14,2012-05-26 22:12:28,2012-05-26 22:09:44
734a5b7d02aa5fa30db39aefb5df81d1ec25ca7e...adb724f65e5f5056e9e4f489e0399cfa2dbce75a,1,1,1,2,1,2012-09-05 20:22:33,2012-09-05 20:22:33
734a5b7d02aa5fa30db39aefb5df81d1ec25ca7e...cc137bba7905790347418f184c6b02d01af3e225,2,8,5,13,4,2012-09-02 20:44:11,2012-09-02 20:41:21
7ab587a47791e371f5c109c14097a5d1d7776ea5...ed2b53cd1c34c421b23208eeb502a141a6829f9d,2,6,1,7,2,2012-08-23 06:17:18,2012-08-23 06:17:18
1ef1a4ae6e8f91e78e57ccd9d458ed2806f9bf77...74d65bb8238923d04dde6eefc657a40995c8e4ff,1,5,5,10,3,2012-08-25 07:24:21,2012-08-25 07:24:21
1ef1a4ae6e8f91e78e57ccd9d458ed2806f9bf77...6428d4dd63d112e3d1b2c3fa2f751651318a96d4,2,3,0,3,3,2012-08-23 05:15:30,2012-08-23 05:15:30
6428d4dd63d112e3d1b2c3fa2f751651318a96d4...a94b2d1ccfa17f92d2d17f20a23ab86e4456291e,2,3,3,6,3,2012-08-23 05:28:00,2012-08-23 05:28:00
17948951ff0787570972eff925ab4703821238fe...05da3801f53f06fdc529b4f3820af1380039f245,14,231,234,465,162,2012-08-16 06:13:50,2012-08-16 06:13:50
4b2e151fc69db11b1772d234a233be7cf6eac671...f9ab136abdedb1ea1085e4e0a881371d6ad0dffb,1,1,1,2,1,2012-08-24 00:01:30,2012-08-24 00:01:30
f9ab136abdedb1ea1085e4e0a881371d6ad0dffb...4d9197efa819730de6ed4b927dc2c34270be1ec6,1,1,1,2,1,2012-08-24 00:11:37,2012-08-24 00:11:37
4b2e151fc69db11b1772d234a233be7cf6eac671...2c128f3874eabf642ba78775e169177129f10a97,4,0,10,10,5,2012-08-23 23:20:28,2012-08-23 23:20:28
2c128f3874eabf642ba78775e169177129f10a97...4adac4deba315c182820a1fe820fe0d297ae21ab,1,4,1,5,2,2012-08-23 23:21:20,2012-08-23 23:21:20
4adac4deba315c182820a1fe820fe0d297ae21ab...af2e2e29b9b537f6bae752b74280ca7a3819d468,2,0,8,8,6,2012-08-23 23:21:55,2012-08-23 23:21:55
4b2e151fc69db11b1772d234a233be7cf6eac671...e2f19befbcc2c0b347507171ef94047426aba5b0,6,6,5,11,6,2012-08-23 21:04:43,2012-08-23 21:04:43
f69049c282c60aa08a9abf67c3e3c2811abe84db...9a709f76be3a3e8911f404aec6116a848748c943,1,4,0,4,1,2012-07-27 20:57:42,2012-07-27 20:57:42
9a709f76be3a3e8911f404aec6116a848748c943...bc7897180d8cfad0f573137d379fedfa7939ee0f,6,23,9,32,8,2012-07-27 21:27:54,2012-07-27 21:27:54
bc7897180d8cfad0f573137d379fedfa7939ee0f...3caf0aa89a964b8b3dcd21536e5bc274165ed2a2,1,1,1,2,1,2012-07-27 21:40:14,2012-07-27 21:40:14
0590aa9d6073e79ba47c4fe5c34318f6889c44d8...19f7b038cbf3f6097b322eb3e76df3f852f0acd4,1,6,2,8,1,2012-07-27 13:30:36,2012-07-27 13:30:36
0590aa9d6073e79ba47c4fe5c34318f6889c44d8...5cb47b761c0725c4045ff00dbeff63e2f47196ce,1,1,1,2,1,2012-07-27 09:03:30,2012-07-27 09:03:30
adc71b6a6ae06a96aa82052012ae6e61bd3a9cb1...b99372b75679e3c05eed7b81284fc1efc7fa956b,1,1,1,2,1,2012-08-29 11:04:37,2012-08-29 11:04:37
adc71b6a6ae06a96aa82052012ae6e61bd3a9cb1...245806012019b93e210564f76fa2df9da915e274,1,57,0,57,1,2012-08-29 12:31:00,2012-08-29 12:31:00
3643df1f7cbcc3734055b0d710fd21dd4426ca3b...0d77209ea0f13184a8140efeaafa52bc916ec71f,3,10,8,18,8,2012-09-12 22:11:59,2012-09-12 22:11:59
ed2b53cd1c34c421b23208eeb502a141a6829f9d...22ec463764f7fe2b6cf3003450c5eabe2c122d5f,1,16,0,16,1,2012-08-23 09:48:45,2012-08-23 09:48:45
22ec463764f7fe2b6cf3003450c5eabe2c122d5f...2d6a3e6b67ec1c469ac19d2d5e581d8425b229c6,1,10,0,10,1,2012-08-23 09:48:55,2012-08-23 09:48:55
ed2b53cd1c34c421b23208eeb502a141a6829f9d...db4c3e58bca67bf773d9fe3e73acd6b687498334,2,8,4,12,2,2012-08-23 11:24:25,2012-08-23 11:24:25
05da3801f53f06fdc529b4f3820af1380039f245...b0a901fe0165b00ec00c9b8fa32344a413b316bf,3,147,0,147,3,2012-08-16 18:52:42,2012-08-16 18:51:31
b0a901fe0165b00ec00c9b8fa32344a413b316bf...0f1ca8b3e7454a6fa788f8e57607b95f3195e145,2,0,20,20,2,2012-08-22 17:19:55,2012-08-22 17:19:55
0f1ca8b3e7454a6fa788f8e57607b95f3195e145...b838440f15fbc56d0504162fcff376cacf9c8186,2,4,6,10,3,2012-08-22 17:26:09,2012-08-22 17:26:09
52f657aa15e730c686eeb16dc102d2e5ce46d524...b962bcd4a7fbe017430f4f0ea84074088fc8c8b1,1,4,2,6,2,2012-08-21 22:25:11,2012-08-21 22:25:11
b962bcd4a7fbe017430f4f0ea84074088fc8c8b1...4381084af341684240b1a671d368511afcf5774a,1,4,12,16,3,2012-08-24 08:48:30,2012-08-24 08:48:30
4381084af341684240b1a671d368511afcf5774a...a502f67c0b358cc6b391df0c5dca48375c21fcad,1,1,1,2,1,2012-08-24 09:03:48,2012-08-24 09:03:48
ed954ebae24b5f7308e6f5e7250320342f3d9a41...adeeae9f73c9a0cef7a197e10c00361a5f6ed814,2,7,2,9,3,2012-09-01 19:21:28,2012-09-01 19:21:28
adeeae9f73c9a0cef7a197e10c00361a5f6ed814...beb5e1bd6b6656b7c4f412a72c02c3e72ec5253c,3,8,3,11,4,2012-09-01 20:35:04,2012-09-01 20:35:04
ed954ebae24b5f7308e6f5e7250320342f3d9a41...0de5d08e371923871d75fbdc68732c2402006c91,2,2,2,4,2,2012-08-31 23:28:32,2012-08-31 23:28:32
8d192adb382572a210f30cdcd6d42061b5e23353...8a49cdc3b44579e64d50973df1a1d075e2766b97,4,14,4,18,7,2012-08-29 12:45:00,2012-08-29 12:45:00
85def2d62500afdab39956f0bd987340889894c4...d993f666423744d213d7cce063b48e71fa751d43,2,17,6,23,8,2012-09-13 19:20:00,2012-09-13 19:20:00
cc03600b22342a541ab1b4617eaf4d38d6d2d1da...6745812c7236e8d4f463e226feb2e61389c85563,1,4,5,9,4,2012-09-03 10:43:19,2012-09-03 10:43:19
6745812c7236e8d4f463e226feb2e61389c85563...6817a6a2952bc6af74eb239982ed337f90897f98,1,10,0,10,1,2012-09-03 11:22:49,2012-09-03 11:22:49
6817a6a2952bc6af74eb239982ed337f90897f98...76e4d94d432b19d7dd58503c5eac46811630c04a,6,16,5,21,7,2012-09-03 11:46:29,2012-09-03 11:46:29
a502f67c0b358cc6b391df0c5dca48375c21fcad...4a1b42d26c5d35565f121d34527fe4cda0b51bdb,1,47,121,168,26,2012-09-11 02:35:36,2012-09-04 16:44:17
a502f67c0b358cc6b391df0c5dca48375c21fcad...14bd9c9228c50d2a9c5914394603d7ff2b2aa145,1,2,2,4,2,2012-08-24 09:17:05,2012-08-24 09:17:05
beb5e1bd6b6656b7c4f412a72c02c3e72ec5253c...aecbd313bc2792a54bbecf6333fc293cd6b059a4,1,1,1,2,1,2012-09-02 12:25:54,2012-09-02 12:25:54
beb5e1bd6b6656b7c4f412a72c02c3e72ec5253c...877aa5458627d42d03a7f204d02db9d326af006c,1,0,0,0,0,2012-09-02 06:45:18,2012-09-02 02:56:54
877aa5458627d42d03a7f204d02db9d326af006c...8db2a59d0b6959a78ea7be4663dd9a858dff9f98,2,39,8,47,6,2012-09-02 17:40:07,2012-09-02 03:39:28
8db2a59d0b6959a78ea7be4663dd9a858dff9f98...40d619107f9027a33eccc01afa120f7b588e5cf9,2,10,1,11,2,2012-09-02 17:40:14,2012-09-02 03:56:44
40d619107f9027a33eccc01afa120f7b588e5cf9...ef24576fc2239935d2d7b553e7d55674abf4eb4c,1,186,130,316,53,2012-09-02 17:40:14,2012-09-02 06:13:13
b9b63fc36270f6d80ba42e09f34716b12e3277ae...e5adca1b813bf1646a08bbc239acc75a844c366d,2,16,4,20,6,2012-08-29 05:13:38,2012-08-29 05:13:38
3ecc4df4b35080d78f83c5155418339aad40dca8...795cc9b7161b3c2e580075a88d7b53ef95e3f883,1,1,1,2,1,2012-09-14 13:57:25,2012-09-14 13:57:25
4f8a4aa44c90f84480f5cb541d2d79ce11c7f960...5cb9e7eedc24c418bbb3bce2f48a7c585f9cb439,1,1,1,2,1,2012-09-07 06:16:04,2012-09-07 06:16:04
0c5e556922b4c7ff71c6af6255a0f6783e25ca0c...457b0f604fc005cc695627c558a39c9e14f3c6a0,1,8,7,15,5,2012-09-04 08:39:10,2012-09-03 13:04:10
0c5e556922b4c7ff71c6af6255a0f6783e25ca0c...e078a173d6fad0ec79ed252f5e268f060c37508d,3,61,8,69,7,2012-09-03 15:00:24,2012-09-03 15:00:24
0c5e556922b4c7ff71c6af6255a0f6783e25ca0c...c7cfe3d83bfbad2a074cacb5a4ed8a24244f8f26,5,58,66,124,6,2012-09-03 05:15:07,2012-09-03 05:13:51
8d65f51e635ae84dd19b361a2cf9fb1ef2c2014b...d5fcf0f672ffb5457c9b1bc345c4cf72a94af324,1,1,1,2,1,2012-08-24 12:34:27,2012-08-24 12:34:27
d5fcf0f672ffb5457c9b1bc345c4cf72a94af324...fee26c58e22f9150e802b86202e5e5e9a6b2c233,4,113,102,215,5,2012-08-25 16:21:11,2012-08-25 16:21:11
fee26c58e22f9150e802b86202e5e5e9a6b2c233...c05692b7b1194e67b5427ca0a6a4926562abdf6e,6,15,38,53,11,2012-08-25 16:42:34,2012-08-25 16:42:34
c05692b7b1194e67b5427ca0a6a4926562abdf6e...f13bccc14ba915c1d04ac1688f789709267a82a9,1,4,2,6,2,2012-08-25 16:47:00,2012-08-25 16:47:00
14bd9c9228c50d2a9c5914394603d7ff2b2aa145...3dd7703b8083d44c64a03cef6b72d161aed04239,7,81,1,82,9,2012-08-24 10:05:40,2012-08-24 10:05:40
e5adca1b813bf1646a08bbc239acc75a844c366d...8c44789e6fc00a9cdbe3020232ad546941af18b9,2,2,1,3,2,2012-08-29 15:09:41,2012-08-29 15:09:41
e5adca1b813bf1646a08bbc239acc75a844c366d...2c95074a5faec5e5420bfbf87134f5956d427cd1,2,0,12,12,2,2012-08-29 14:44:34,2012-08-29 05:35:48
2c95074a5faec5e5420bfbf87134f5956d427cd1...14daf2e2ba9d75527b5de07d87a9027bd53d607e,1,10,0,10,1,2012-08-29 14:44:34,2012-08-29 05:49:26
14daf2e2ba9d75527b5de07d87a9027bd53d607e...9d4d40deed5ea649511f3aadd45b3da68c7c3217,4,104,66,170,5,2012-08-29 14:44:34,2012-08-29 05:52:19
9d4d40deed5ea649511f3aadd45b3da68c7c3217...9e7d77cece06e48ac0f44ee808976ec6dcbff81d,13,0,212,212,13,2012-08-29 14:44:34,2012-08-29 06:05:08
9e7d77cece06e48ac0f44ee808976ec6dcbff81d...2bdea8651fa3bd82418986ada84828c22d451405,1,14,0,14,1,2012-08-29 14:44:34,2012-08-29 06:21:50
2bdea8651fa3bd82418986ada84828c22d451405...97423a0bed1148f65f9ed2bd8bf540e764d9576c,12,96,50,146,42,2012-08-29 15:36:02,2012-08-29 15:36:02
8f9a450eedc5b5fc13e24788ab67f2de928dd83a...f3ce02b5c944e5956eb7208506ec513623d092d8,3,35,6,41,5,2012-09-24 14:48:10,2012-09-21 16:22:43
f3ce02b5c944e5956eb7208506ec513623d092d8...81ffb0afddfe101910cff3dd51fe27dd85e11f28,1,1,1,2,1,2012-09-25 12:11:31,2012-09-25 12:07:13
81ffb0afddfe101910cff3dd51fe27dd85e11f28...012dc2278c1b7cb3cf4021912fca81c4ccf74b2f,1,1,1,2,1,2012-09-25 14:13:13,2012-09-25 13:29:17
012dc2278c1b7cb3cf4021912fca81c4ccf74b2f...7284c58c5fb54965b078a2ba9e3634479700416d,1,1,0,1,1,2012-09-25 14:13:24,2012-09-25 13:54:07
8f9a450eedc5b5fc13e24788ab67f2de928dd83a...8b6dba749a80fbdf94f1495dda8cf3cdad61a28b,3,13,10,23,6,2012-09-14 19:41:56,2012-09-13 00:12:44
8b6dba749a80fbdf94f1495dda8cf3cdad61a28b...6ffec9a298dd90275ec6b17d1e11554bd31b9f2c,2,13,12,25,7,2012-09-14 19:41:56,2012-09-13 13:43:16
6ffec9a298dd90275ec6b17d1e11554bd31b9f2c...14164017533388dc2a0d0f43e05ee84badbf2223,2,2,3,5,3,2012-09-14 19:41:56,2012-09-13 17:55:57
14164017533388dc2a0d0f43e05ee84badbf2223...e802d00996d6948e29f085d4de9409423e0d91a4,5,134,100,234,36,2012-09-14 19:41:56,2012-09-14 14:52:24
e802d00996d6948e29f085d4de9409423e0d91a4...20e009a40a4fa5d7e5517833e14c16b32b461720,3,4,4,8,5,2012-09-14 19:41:56,2012-09-13 23:21:39
20e009a40a4fa5d7e5517833e14c16b32b461720...653f7ec4fb57f84f471c8f2078c7534b1c085cc9,2,2,2,4,2,2012-09-14 19:41:56,2012-09-13 23:22:09
653f7ec4fb57f84f471c8f2078c7534b1c085cc9...cee230a158e72a973150a17034b58c869f7e9407,2,48,8,56,7,2012-09-14 19:41:56,2012-09-13 23:32:55
cee230a158e72a973150a17034b58c869f7e9407...61eb650db0eb05ee6436d662927cb963ec157b76,8,7,7,14,7,2012-09-14 19:41:56,2012-09-14 02:59:55
61eb650db0eb05ee6436d662927cb963ec157b76...8fb70d924dbb089fdac89125664e3aa73212d8fc,3,2,2,4,2,2012-09-14 19:41:56,2012-09-14 03:00:21
8fb70d924dbb089fdac89125664e3aa73212d8fc...3c02c93f08019a73929de8e812424e581c58c62a,2,17,18,35,2,2012-09-14 19:41:56,2012-09-14 03:05:37
3c02c93f08019a73929de8e812424e581c58c62a...c02e3f2104d9dbb1bca01935fe7c0dfeacf53baf,2,1,1,2,1,2012-09-14 19:41:57,2012-09-14 03:08:40
c02e3f2104d9dbb1bca01935fe7c0dfeacf53baf...29c71f2fb95ba98513ff96939fd4a602b4a3bd6f,3,2,2,4,2,2012-09-14 19:41:57,2012-09-14 03:10:06
29c71f2fb95ba98513ff96939fd4a602b4a3bd6f...4fc66ead4f50f76efb80e119bbedc7514602f57f,4,3,3,6,3,2012-09-14 19:41:57,2012-09-14 03:13:26
4fc66ead4f50f76efb80e119bbedc7514602f57f...dd1b3177c999560818e8bbfb549630234f6ec9f0,2,4,4,8,4,2012-09-14 19:41:57,2012-09-14 03:19:38
dd1b3177c999560818e8bbfb549630234f6ec9f0...c6d71b7b8e5e8dc22da9b8aab392196d1987fd68,3,3,3,6,3,2012-09-14 19:41:57,2012-09-14 03:21:58
c6d71b7b8e5e8dc22da9b8aab392196d1987fd68...a3dbd990682f5f39d9c3e58858faf85b9b0a6179,2,2,1,3,2,2012-09-14 19:41:57,2012-09-14 15:02:09
a3dbd990682f5f39d9c3e58858faf85b9b0a6179...e1ca155c95a41a9adfe984a3e3ba5c777c61acd8,2,4,4,8,2,2012-09-14 19:41:57,2012-09-14 14:57:08
e1ca155c95a41a9adfe984a3e3ba5c777c61acd8...e63d7b6029142d100adca03e11ba0e33d9c2981c,1,0,0,0,0,2012-09-14 19:41:57,2012-09-14 03:56:12
e63d7b6029142d100adca03e11ba0e33d9c2981c...7563abbe49fc16280877be89342d552e0609d57c,3,24,3,27,5,2012-09-14 19:41:57,2012-09-14 15:00:48
7563abbe49fc16280877be89342d552e0609d57c...07eec9c66a910b5a808852f498e1dc9c88b701d2,4,27,11,38,16,2012-09-14 19:41:57,2012-09-14 15:01:34
8f9a450eedc5b5fc13e24788ab67f2de928dd83a...dc37c8aaae29f2340ba3fd0bcda08c937010abde,15,104,68,172,20,2012-09-14 16:13:25,2012-09-14 16:13:25
dc37c8aaae29f2340ba3fd0bcda08c937010abde...759fb518eb28ca59913f1c897b3cc056693709ca,2,23,15,38,12,2012-09-14 15:46:40,2012-09-14 15:46:40
759fb518eb28ca59913f1c897b3cc056693709ca...0d66cf2a38540056b6400c526e62ccc0cbc3144d,1,1,1,2,1,2012-09-14 15:58:16,2012-09-14 15:58:16
0d66cf2a38540056b6400c526e62ccc0cbc3144d...a82977c64843aa177498f1a715121ae6e38bc323,6,49,75,124,28,2012-09-14 22:00:59,2012-09-14 22:00:59
6b3ce96a19b46b1ca59c3d3002981375d0a98379...b73d4419ea458a2824a35563bcd84d519b2a5516,5,22,49,71,6,2012-09-04 06:38:48,2012-09-04 06:38:48
b73d4419ea458a2824a35563bcd84d519b2a5516...4bd30245805bc7814fc24686a418a9c883259800,4,31,34,65,8,2012-09-04 07:29:26,2012-09-04 07:29:26
4bd30245805bc7814fc24686a418a9c883259800...9b9dd3f9bf62e8b116213012b766abcaef3e641e,1,9,11,20,1,2012-09-05 08:44:47,2012-09-05 08:44:47
c7cfe3d83bfbad2a074cacb5a4ed8a24244f8f26...8ca0b75d05b457e4335a6734582ba703404cc9c6,22,97,93,190,53,2012-09-03 18:53:16,2012-09-03 18:53:16
c7cfe3d83bfbad2a074cacb5a4ed8a24244f8f26...1f1c8094fe342feb851c681dcde25459b82faff0,2,12,8,20,6,2012-09-03 17:48:38,2012-09-03 17:48:38
1f1c8094fe342feb851c681dcde25459b82faff0...af63607a5cf245b358acd153279faa3c22c099b0,4,12,14,26,9,2012-09-03 18:46:17,2012-09-03 18:46:17
f13bccc14ba915c1d04ac1688f789709267a82a9...6ff0652e9e807b35d298b63699c71377014800ea,6,72,62,134,12,2012-08-25 17:31:19,2012-08-25 17:31:19
f13bccc14ba915c1d04ac1688f789709267a82a9...852b9c28dd80af4a49336b0ff921a1a863dbc929,3,0,0,0,0,2012-08-25 17:22:45,2012-08-16 03:16:33
852b9c28dd80af4a49336b0ff921a1a863dbc929...fba174e9bc4e4ef5c0c4d6a4282f37e5265b87e2,14,59,93,152,18,2012-08-25 18:19:15,2012-08-23 09:19:40
fba174e9bc4e4ef5c0c4d6a4282f37e5265b87e2...b2a5344a2d68922d5c6cb8de228fb9b41ce3efc4,5,33,3,36,5,2012-08-25 18:19:15,2012-08-25 17:31:50
b2a5344a2d68922d5c6cb8de228fb9b41ce3efc4...232389f4e8ebaffd125985ce63439cea407e85d5,6,191,150,341,50,2012-08-25 18:19:15,2012-08-25 17:43:55
232389f4e8ebaffd125985ce63439cea407e85d5...580ce4f2d85f89e81825c3b5993fd3ee68f4d93a,2,21,20,41,7,2012-08-25 18:19:16,2012-08-25 17:54:38
919cd60216d0216dde73a4e17553a149b41593ff...6d4ae75f544d9819954865c105414a722344336a,1,2,2,4,2,2012-08-24 10:17:19,2012-08-24 10:17:19
8c44789e6fc00a9cdbe3020232ad546941af18b9...dde8ed44553626ec8db9ad97eed95c2d12dc4dc7,2,7,6,13,7,2012-08-29 15:58:33,2012-08-29 15:58:33
b5f9d29f55e1fbf302bd824e2d08c0885caa15d7...dc22dd8aded81f10b8b9fc06f8c423043aa01d0a,1,3,1,4,2,2012-10-03 10:33:31,2012-10-03 10:33:31
caeb65b1892c8a140d8f72f6aafa3f5fd1d3cbc3...9159be3a50e3bc94f30f85d9640eeac212bf0948,5,11,4,15,6,2012-09-15 06:49:21,2012-09-15 06:49:21
9159be3a50e3bc94f30f85d9640eeac212bf0948...348def03449f8f92fc1b568df7ad2fef40343587,1,3,0,3,1,2012-09-15 06:58:16,2012-09-15 06:58:16
137594dd08e739a68af656d697a5b8c6be23854f...09263719d536a3935c4b1d801472126ece28f283,2,22,0,22,2,2012-09-07 10:56:13,2012-09-07 10:56:13
09263719d536a3935c4b1d801472126ece28f283...26552051b7af709ad21497747405714006a14b68,4,24,1,25,5,2012-09-07 13:35:59,2012-09-07 13:35:59
26552051b7af709ad21497747405714006a14b68...c818c93aa7f8102dfd449bf2f1e82b36578e3ac7,2,23,5,28,5,2012-09-07 13:51:37,2012-09-07 13:51:37
c818c93aa7f8102dfd449bf2f1e82b36578e3ac7...b462b0c6ebfea32ba816ee8c30bc5aa4e5049e91,1,1,0,1,1,2012-09-07 13:52:48,2012-09-07 13:52:48
b462b0c6ebfea32ba816ee8c30bc5aa4e5049e91...320250cd7be1bbd6c2140344b8d3270728a84946,1,0,1,1,1,2012-09-07 14:03:38,2012-09-07 14:03:38
137594dd08e739a68af656d697a5b8c6be23854f...79021e674bab1d34609228343fbf3403d9bd9bc6,7,241,186,427,18,2012-09-07 05:16:29,2012-09-07 05:16:29
79021e674bab1d34609228343fbf3403d9bd9bc6...b994a65fc318a91458fa8bb219e7ce07bd893eb5,2,7,5,12,5,2012-09-07 12:36:40,2012-09-07 12:36:40
ed4fbcf6b004bacfe9ad3c99296d543921c477ed...85db51f660c4d861c9adf97ed114d4bd4d14ff7d,1,1,0,1,1,2012-09-07 07:23:45,2012-09-07 07:23:45
97ea04124693c271e060e4697d2d7cfbaadbae4a...12c57a7061d55798e77e79c3cfae293b4d773365,1,2,1,3,2,2012-09-04 09:05:56,2012-09-04 09:03:31
8ca0b75d05b457e4335a6734582ba703404cc9c6...f557686eb2d432f794addbc052331d5d8f0be400,7,31,14,45,11,2012-09-03 19:30:14,2012-09-03 19:30:14
f557686eb2d432f794addbc052331d5d8f0be400...5db2dbdcf110d4a5ff4180ae96ec9131ac9a1723,2,12,3,15,4,2012-09-03 19:57:34,2012-09-03 19:57:34
5db2dbdcf110d4a5ff4180ae96ec9131ac9a1723...b44e9a08d5c0e012d645e75a321c6ea299b4bea1,1,2,0,2,1,2012-09-04 00:38:41,2012-09-04 00:38:41
6ff0652e9e807b35d298b63699c71377014800ea...e0cd807020e0c50e365480133a66dca25efab36f,1,1,1,2,1,2012-08-25 18:48:30,2012-08-25 18:48:30
6d4ae75f544d9819954865c105414a722344336a...0dbde913dcfd8559433ef57a28e84b9e9f266f90,1,4,3,7,1,2012-08-24 23:04:07,2012-08-24 23:04:07
6d4ae75f544d9819954865c105414a722344336a...2b38f51a17464537b9e4110917868bc9c1b1950a,1,2,0,2,2,2012-08-24 22:22:45,2012-08-24 22:22:45
35fbc4d3bbe782bb9e8d84a8a9aff4114ab5aa30...1dd938d20cb51a8068c9b3ab9041068292d97a9b,17,717,1269,1986,27,2012-08-29 18:23:43,2012-08-29 18:23:43
1dd938d20cb51a8068c9b3ab9041068292d97a9b...51558bd57a7021a31d4e60342078e48a3dcb805a,14,101,216,317,41,2012-08-29 19:29:50,2012-08-29 19:29:50
9e80d2d4f79edf81185461a34a50adcd251073f1...2985697af788c33b3d5b4731ec60e9b5055f97b5,1,3,2,5,1,2012-10-03 12:56:41,2012-10-03 12:56:41
0546b9c65f33757dee6e7d0a6f85eb2bdb33453d...296e322bfc896f99b15d0639b25745a22a73e9ce,1,1,1,2,1,2012-09-15 19:52:01,2012-09-15 19:52:01
296e322bfc896f99b15d0639b25745a22a73e9ce...9c117f263646635f03b50cac38db4fb830500642,1,2,2,4,1,2012-09-15 19:53:45,2012-09-15 19:53:45
0546b9c65f33757dee6e7d0a6f85eb2bdb33453d...74cfab692fd9808c1ea6a6cc6f45c348deb4fd72,1,0,0,0,0,2012-09-15 18:26:08,2012-09-15 18:26:08
74cfab692fd9808c1ea6a6cc6f45c348deb4fd72...fa529c789c6d5e6c7c52de73166007e4650a46fa,1,1,1,2,1,2012-09-15 19:23:41,2012-09-15 19:23:41
0546b9c65f33757dee6e7d0a6f85eb2bdb33453d...b8113334a86639b87d5f89cc78e2279a8ae4e38a,5,24,3,27,5,2012-09-15 09:54:46,2012-09-15 09:54:46
b8113334a86639b87d5f89cc78e2279a8ae4e38a...6aebb76b5d05bf7668a8f389a00648fdb405af7d,1,40,3,43,6,2012-09-15 09:55:17,2012-09-15 09:55:17
f78947624133f06712d60197809a269338053c3a...1b83af6eed3a4069a8f66a6785632e6f950e900f,2,3,5,8,3,2012-09-07 17:59:12,2012-09-07 17:59:12
b994a65fc318a91458fa8bb219e7ce07bd893eb5...963746f97847cd106e5f90f830fe9dc0b5ae0102,1,43,28,71,18,2012-09-07 06:15:30,2012-09-07 06:15:30
963746f97847cd106e5f90f830fe9dc0b5ae0102...61c7449321c526fe3c36e899cead1ac11c39c466,3,19,23,42,10,2012-09-07 06:50:35,2012-09-07 06:50:35
61c7449321c526fe3c36e899cead1ac11c39c466...fed6ab2481257e67822825fad1203ed073028a22,4,21,20,41,7,2012-09-07 07:42:41,2012-09-07 07:42:41
fed6ab2481257e67822825fad1203ed073028a22...048117c05dd73acc7d6daff623ee5fdfe85a5d25,2,9,2,11,3,2012-09-07 16:57:13,2012-09-07 16:57:13
048117c05dd73acc7d6daff623ee5fdfe85a5d25...e8f39a0a61c4c91b8a5dc016474b6139a79a52e8,1,22,4,26,4,2012-09-07 17:43:51,2012-09-07 17:43:51
e8f39a0a61c4c91b8a5dc016474b6139a79a52e8...367e17cc84bd432117f283d2e858a29d033e979f,2,5,7,12,3,2012-09-07 17:47:52,2012-09-07 17:47:52
12c57a7061d55798e77e79c3cfae293b4d773365...fc7ac316a084788f91710912e110f1aa70fd5a65,1,36,30,66,29,2012-09-04 09:33:18,2012-09-04 09:26:25
12c57a7061d55798e77e79c3cfae293b4d773365...11ebbb68d8c0db7b23db8b0509f160fc1571e50a,1,0,0,0,0,2012-09-04 09:28:48,2012-09-04 09:24:43
b44e9a08d5c0e012d645e75a321c6ea299b4bea1...6471d8c6521ef7a88f3aa893cc11c1da8077bdc0,1,3,3,6,1,2012-09-04 07:18:26,2012-09-04 07:18:26
b44e9a08d5c0e012d645e75a321c6ea299b4bea1...d29827433d77b9f9353fcae396ca321dd9016771,3,44,27,71,9,2012-09-04 04:20:17,2012-09-04 04:04:36
51558bd57a7021a31d4e60342078e48a3dcb805a...793db070f0fe61c05359f34b34af0dd6f91d129a,3,49,11,60,7,2012-08-30 05:13:36,2012-08-30 05:13:36
793db070f0fe61c05359f34b34af0dd6f91d129a...4e4740285261a098b364e804a906a349731e71a3,4,20,20,40,19,2012-08-30 06:09:42,2012-08-30 06:09:42
4e4740285261a098b364e804a906a349731e71a3...a6026c9c8237020370e5499db5afb7ddab58532f,1,70,0,70,1,2012-08-30 05:41:43,2012-08-30 05:41:43
51558bd57a7021a31d4e60342078e48a3dcb805a...491f63794b40a7ca13de8d30227ad92a1ea04bbe,1,3,2,5,2,2012-08-30 01:11:22,2012-08-30 01:11:22
2985697af788c33b3d5b4731ec60e9b5055f97b5...bd5334abc28ddc17b18df25cfe2fee1240d132a6,1,2,3,5,3,2012-10-04 10:28:58,2012-10-04 10:28:58
dcb17ead95cf83660fd7f88e9c5cc4b6441b07df...caef9ed1121a16ca0cc78715695daaa974271bfd,1,7,0,7,2,2012-09-16 10:39:49,2012-09-16 10:39:49
2aafd7cf4e5dc28c0d4692d4a0b35a714186615b...64e76a87aaddf76c3b3a487c5eb39e4490e4724f,3,22,10,32,4,2012-09-18 06:17:55,2012-09-18 06:17:55
7b50a7c99dbab132bfc2fbabfc3309f13359fd60...130520fa5e9a09c53d3162ce82576f3b3544e158,1,10,8,18,3,2012-09-07 23:09:09,2012-09-07 23:06:17
130520fa5e9a09c53d3162ce82576f3b3544e158...f4a90bc9f3ad4e6e9938736e3815eb84ec299af8,1,23,0,23,1,2012-09-07 23:09:12,2012-09-07 23:08:07
7b50a7c99dbab132bfc2fbabfc3309f13359fd60...5348ee62787a12855d8d917580fdcc8900910386,1,2,2,4,2,2012-09-07 20:14:17,2012-09-07 20:14:17
5348ee62787a12855d8d917580fdcc8900910386...9a4c22d395b96e27f9a1c5ec90b161ddf5815cdd,1,1,1,2,1,2012-09-07 23:11:32,2012-09-07 23:11:32
9a4c22d395b96e27f9a1c5ec90b161ddf5815cdd...ce3fb949398786c9cc9c9d7803b72cb57f661279,2,10,2,12,6,2012-09-07 23:11:44,2012-09-07 22:49:17
ce3fb949398786c9cc9c9d7803b72cb57f661279...d661b893c55577f1b781cf96c211765c4586b945,1,3,0,3,1,2012-09-07 23:58:12,2012-09-07 23:58:12
d6ea70c9b63bbfa8bf0674166657098e90ea5514...874a86f820466b2c9cd384483d862a3d5e2a3ae7,3,8,96,104,8,2012-09-04 16:44:17,2012-09-04 16:44:17
d6ea70c9b63bbfa8bf0674166657098e90ea5514...c1ff89fa2adc4809ea093833464f41ea9af5bc6f,1,0,0,0,0,2012-09-04 15:30:49,2012-09-04 15:30:49
c1ff89fa2adc4809ea093833464f41ea9af5bc6f...7e76610d0a521af73459ffc2ba7b3956ab9da34c,4,18,45,63,7,2012-09-04 16:05:20,2012-09-04 15:36:14
7e76610d0a521af73459ffc2ba7b3956ab9da34c...a4633537737d1ea85c74b2089fa1c82e407c0cfa,4,32,6,38,8,2012-09-04 16:05:21,2012-09-04 15:37:38
a4633537737d1ea85c74b2089fa1c82e407c0cfa...82a399688316caa9d860d93204f5bfc9b7847a16,1,0,23,23,1,2012-09-04 16:05:21,2012-09-04 16:03:40
82a399688316caa9d860d93204f5bfc9b7847a16...0bc4ecfedd1f8580ab861955b0c21605e5a3aadb,2,13,19,32,2,2012-09-04 16:05:21,2012-09-04 16:05:08
c347fd3f880925c1883df798f8d7dc85a57e80d2...4cb03183ac4d9c765111174f0d657997bfb35d45,2,9,11,20,9,2012-09-04 08:48:33,2012-08-14 16:54:25
5b88c1e34cfcf841d14a2a70cf582c87339475c5...cd3d50caf2691116424a8df73939f095814c7ab5,9,113,69,182,45,2012-08-30 06:27:02,2012-08-30 06:26:45
cd3d50caf2691116424a8df73939f095814c7ab5...d246a68a242e28c106ab8916ccdc3ac2643b2d96,2,2,2,4,2,2012-08-30 16:45:05,2012-08-30 16:45:05
d246a68a242e28c106ab8916ccdc3ac2643b2d96...92137b7bebb2b6f9c5225776e3f30d0e5dfab9e6,7,15,8,23,9,2012-08-30 17:00:16,2012-08-30 17:00:16
92137b7bebb2b6f9c5225776e3f30d0e5dfab9e6...4a6596af274c01036aaf9f49a5b38cd678716873,12,281,212,493,39,2012-08-30 18:31:55,2012-08-30 18:31:55
4a6596af274c01036aaf9f49a5b38cd678716873...b9ff0c79b49c24dfcfc8e3188c76a861b2035770,15,96,48,144,27,2012-08-30 19:15:34,2012-08-30 19:15:34
b9ff0c79b49c24dfcfc8e3188c76a861b2035770...5e510ada7a4ca4e8537d9c14ba50cfc9f509f325,3,4,0,4,4,2012-08-30 19:28:45,2012-08-30 19:28:45
5e510ada7a4ca4e8537d9c14ba50cfc9f509f325...c80581e49bc7c144a9353611995d58344831eb40,2,15,1,16,2,2012-08-30 19:45:28,2012-08-30 19:45:28
c80581e49bc7c144a9353611995d58344831eb40...ed8912507dd9abed42c1a0992402341fd46e3d69,2,3,3,6,3,2012-08-30 19:48:01,2012-08-30 19:48:01
ed8912507dd9abed42c1a0992402341fd46e3d69...65abd8b20ab047016e2fc30e5cd1edf5bf4554ea,1,3,5,8,3,2012-08-31 06:05:44,2012-08-31 06:05:44
810d0903f8b8639a6429483a290cbf0fe5a67776...76c4e831932bff2273c38abe1ff37cdb79164c90,4,5,5,10,5,2012-10-04 10:40:40,2012-10-04 10:40:40
76c4e831932bff2273c38abe1ff37cdb79164c90...c6c01e1040a45f2cd3400a5847a58b7bf9b8c5c6,1,1,1,2,1,2012-10-04 10:48:20,2012-10-04 10:48:20
c6c01e1040a45f2cd3400a5847a58b7bf9b8c5c6...73d5e51a2df5757d2eaf4ca9b54d05b48da8e15f,1,1,1,2,1,2012-10-04 10:55:29,2012-10-04 10:55:29
73d5e51a2df5757d2eaf4ca9b54d05b48da8e15f...e25ddca0c462522703af93822863023f4a754390,2,9,9,18,5,2012-10-04 16:31:31,2012-10-04 16:31:31
e25ddca0c462522703af93822863023f4a754390...3606a1488952008426b1be870e62804b22fe8a61,2,6,7,13,3,2012-10-04 18:13:52,2012-10-04 18:13:52
3606a1488952008426b1be870e62804b22fe8a61...58dad2b95463ae0bb0fd21258804f32352f0a6b5,1,0,58,58,1,2012-10-04 18:31:11,2012-10-04 18:30:31
58dad2b95463ae0bb0fd21258804f32352f0a6b5...74213534bc324886451c3f858409fc0d33eecc8c,1,4,4,8,3,2012-10-05 14:01:44,2012-10-05 14:01:44
f963d374080c4a0db69cf9904199bcc5f6424b9f...4f7bd583076076f6c5dcd4e6ec35a014ce5285eb,2,6,1,7,3,2012-10-03 16:51:14,2012-10-03 16:51:14
4f7bd583076076f6c5dcd4e6ec35a014ce5285eb...c626ec3746f0346a4a90ebf6a0860583b79dd250,1,14,0,14,2,2012-10-03 20:46:55,2012-10-03 20:46:55
caef9ed1121a16ca0cc78715695daaa974271bfd...549c4c2202307608773a10d8ce9a7dc978537de4,4,36,52,88,10,2012-09-16 16:51:04,2012-09-16 16:51:04
549c4c2202307608773a10d8ce9a7dc978537de4...b896880eb46c2b8167e2252d3656b5e38e35f6ec,4,8,8,16,8,2012-09-16 17:08:57,2012-09-16 17:08:57
caef9ed1121a16ca0cc78715695daaa974271bfd...4247ccd3401b81f654f2203f4b71f0257fd9c569,1,0,3,3,1,2012-09-16 15:53:36,2012-09-16 15:53:36
4247ccd3401b81f654f2203f4b71f0257fd9c569...465e40d3a663944b5aacf3e53a63158a7812f219,4,12,11,23,7,2012-09-16 16:07:57,2012-09-16 16:07:57
caef9ed1121a16ca0cc78715695daaa974271bfd...c23eb4082948322a1b690e0850c09bfc8df81589,4,106,0,106,4,2012-09-16 14:52:06,2012-09-16 14:52:06
c23eb4082948322a1b690e0850c09bfc8df81589...87d40fd276ade536e0b6b3019e52c2e1844e47ea,4,106,0,106,5,2012-09-16 15:21:59,2012-09-16 15:21:59
caef9ed1121a16ca0cc78715695daaa974271bfd...4f4c401f77522c27df7afdc25eeef39de76e241b,1,1,1,2,1,2012-09-16 11:38:14,2012-09-16 08:05:13
4f4c401f77522c27df7afdc25eeef39de76e241b...94f91146f15c955b02e9f3717b9bf7506019f63d,1,2,2,4,1,2012-09-16 11:38:14,2012-09-16 08:51:26
94f91146f15c955b02e9f3717b9bf7506019f63d...d7eb7970249b662ebcc2673001503a247d7fbe48,1,52,51,103,23,2012-09-16 11:38:14,2012-09-16 11:22:46
d7eb7970249b662ebcc2673001503a247d7fbe48...89069dc5f7714472b106914a27c462755ab01396,1,0,3,3,1,2012-09-16 11:38:14,2012-09-16 11:31:51
89069dc5f7714472b106914a27c462755ab01396...83f24de3520ba1c49544b268253a0665831c2bd5,2,754,0,754,2,2012-09-16 14:06:21,2012-09-16 08:21:46
83f24de3520ba1c49544b268253a0665831c2bd5...925183ed7a8eb392e008764483f59c319e22a59c,9,27,44,71,19,2012-09-16 14:06:29,2012-09-16 11:44:54
925183ed7a8eb392e008764483f59c319e22a59c...a0893b4d58a6162743b325efe0f93b1b957e8a0a,1,1,1,2,1,2012-09-16 14:06:29,2012-08-10 22:44:36
a0893b4d58a6162743b325efe0f93b1b957e8a0a...8cfb197dfcad3aa0c11f7afd34e4c7bfef953d1d,1,0,2,2,1,2012-09-16 14:06:29,2012-08-10 22:51:07
8cfb197dfcad3aa0c11f7afd34e4c7bfef953d1d...95bd93fe1aad3efbe2c8cc7b255a98ddb27d2d35,11,13,20,33,15,2012-09-16 14:07:06,2012-09-16 13:21:20
95bd93fe1aad3efbe2c8cc7b255a98ddb27d2d35...02b24cefc7d48c1a4adb4a3fcd430770022db7b1,1,1,1,2,1,2012-09-16 14:38:01,2012-09-16 14:38:01
02b24cefc7d48c1a4adb4a3fcd430770022db7b1...b24346fa2b246d71b2918e9d3ac3049f7663fb86,1,4,1,5,1,2012-09-16 14:56:32,2012-09-16 14:56:32
b24346fa2b246d71b2918e9d3ac3049f7663fb86...f4b14494ef6abf3d144c28e4af0c20143383e062,2,398,397,795,4,2012-09-16 16:42:52,2012-09-16 16:42:52
560b1ac5f39b87145e0882cad018f12cc8cf27b4...cb2be3ce0ab27ac9aa25f0c3eb59047ad5a0153a,2,13,4,17,5,2012-09-19 18:36:00,2012-09-19 18:36:00
560b1ac5f39b87145e0882cad018f12cc8cf27b4...aaec545a677f08a39a49d40db2e454e57ed72cbe,2,42,10,52,10,2012-09-18 17:50:34,2012-09-18 17:50:34
aaec545a677f08a39a49d40db2e454e57ed72cbe...4ecf23d2ad4f401c94fabeb061cc36c487276d33,1,1,1,2,1,2012-09-18 18:05:33,2012-09-18 18:05:33
7cc4b3f632dbd2ab9c0096e4f5e6fcd0b4c6b071...cc7c6d53966e7501da0af87481b7e7ef2b2025c2,1,10,0,10,1,2012-09-08 10:35:00,2012-09-08 10:35:00
c09d233611e00328f0e8d493a106737f0638d9a2...965b6701abc450b1ac8fb4556367c34f2c8a9889,1,0,1,1,1,2012-09-26 14:01:13,2012-09-26 14:01:13
5ab3e38ecd58d0b90e5bdc430facf52a0b9b7835...d59d2a197e5ffb0231f97b0ef503e12e8d383709,2,0,167,167,2,2012-09-04 17:29:20,2012-09-04 17:29:20
d59d2a197e5ffb0231f97b0ef503e12e8d383709...42032956bd4d51bd954762a6f1192f20d6375885,1,9,10,19,7,2012-09-04 17:50:00,2012-09-04 17:50:00
65abd8b20ab047016e2fc30e5cd1edf5bf4554ea...c1173e27071b83399cd92406b229be7f0eca59f1,2,58,0,58,2,2012-08-31 07:15:37,2012-08-31 07:15:37
c1173e27071b83399cd92406b229be7f0eca59f1...985ecf0f045ce0d8a6fd0524935f12152bfe3918,1,38,0,38,1,2012-08-31 07:25:36,2012-08-31 07:25:36
985ecf0f045ce0d8a6fd0524935f12152bfe3918...b6a0407e7a3ba5bc77f332dbacb9cae3acb11cce,1,3,0,3,1,2012-08-31 07:27:45,2012-08-31 07:27:45
b6a0407e7a3ba5bc77f332dbacb9cae3acb11cce...acac1547a06e120a05010fbe556e5836f35248d0,1,0,23,23,1,2012-08-31 07:28:38,2012-08-31 07:28:38
acac1547a06e120a05010fbe556e5836f35248d0...9811e64d71d050554c952221c4fdaf48ce1f06a6,2,4,4,8,2,2012-08-31 08:11:12,2012-08-31 08:11:12
74213534bc324886451c3f858409fc0d33eecc8c...9e4f3147a0f4b352ba243a03f76daade3dcee056,1,2,1,3,1,2012-10-05 14:23:57,2012-10-05 12:22:01
9e4f3147a0f4b352ba243a03f76daade3dcee056...317c928198aac43d4e00d1645318a373a33974cf,849,5,1,6,2,2012-10-05 14:23:58,2012-10-05 14:13:21
317c928198aac43d4e00d1645318a373a33974cf...72395d7f6edc3ff2a4c01052a2ad085ab310595b,2,1,4,5,2,2012-10-05 14:23:58,2012-10-05 14:22:21
72395d7f6edc3ff2a4c01052a2ad085ab310595b...d2ea858fbf9c1a3097a2c12f3aa0e9537476ce8e,1,0,0,0,0,2012-10-05 14:42:23,2012-10-05 14:42:23
c626ec3746f0346a4a90ebf6a0860583b79dd250...d88332709cfa42d7f1ccd9ab6bc7622b970ef9de,5,16,6,22,8,2012-10-04 07:51:35,2012-10-04 07:51:35
c626ec3746f0346a4a90ebf6a0860583b79dd250...b5328879f5c0131721a3cd71969f7579376d8498,2,20,30,50,2,2012-10-03 23:39:27,2012-10-03 21:01:16
b5328879f5c0131721a3cd71969f7579376d8498...96b4acf5e7e1d73e06b84efd31f1bc433bd79a1c,2,15,13,28,12,2012-10-03 23:39:27,2012-10-03 22:28:50
96b4acf5e7e1d73e06b84efd31f1bc433bd79a1c...37c3474f683be3deac8ba1e90183029d2f49bcdc,1,1,6,7,1,2012-10-03 23:39:27,2012-10-03 22:29:15
37c3474f683be3deac8ba1e90183029d2f49bcdc...a8fad4ff9c1ae5adbe55989a44dad56a6a9b56e6,1,3,5,8,3,2012-10-03 23:39:27,2012-10-03 22:30:27
a8fad4ff9c1ae5adbe55989a44dad56a6a9b56e6...388d72e6bf9c3e72113b8c16d1cc266b41870eb9,6,44,41,85,18,2012-10-03 23:39:27,2012-10-03 22:40:56
388d72e6bf9c3e72113b8c16d1cc266b41870eb9...187e192cdf4470fa07a62aa0720c586b6dde2bde,2,6,12,18,4,2012-10-03 23:39:27,2012-10-03 23:11:39
187e192cdf4470fa07a62aa0720c586b6dde2bde...332fc328a394ec1e6110af872d5cb51c920a4306,2,12,6,18,4,2012-10-04 18:19:25,2012-10-04 18:19:17
b5442eb5643b10a0e6539b1081ccf048d555d38a...aaa916f15c9bde139058888be660705390cc02db,1,8,7,15,5,2012-09-17 10:36:23,2012-09-17 10:36:23
b6c6a5b159beeb63829c72f5d7e2c48b1138705d...c83af0dfe7b82c355eb115a35bfee2a98146b64d,1,2,4,6,1,2012-09-16 19:44:20,2012-09-16 19:44:20
da6b53a80eea25371a976389f70ed5c78ce4c797...2d2a235c06fea4a1dba50da19eb3a98d9ea975a2,1,1,1,2,1,2013-03-05 14:50:37,2013-03-05 14:50:37
4ecf23d2ad4f401c94fabeb061cc36c487276d33...bfed07ee20d5df75e444994912edda48839acbac,1,8,0,8,1,2012-09-19 01:45:09,2012-09-19 01:45:09
bfed07ee20d5df75e444994912edda48839acbac...259ca982da2f2962773ef797fabe6d6641689f5e,2,11,1,12,3,2012-09-19 01:53:27,2012-09-19 01:53:27
cc7c6d53966e7501da0af87481b7e7ef2b2025c2...06c1a8a9ae34e2a4fe7b4f4edb58bacfaf6df5c9,2,21,8,29,4,2012-09-08 14:05:48,2012-09-08 00:08:35
06c1a8a9ae34e2a4fe7b4f4edb58bacfaf6df5c9...a2a0060034171e22962129d53cc74fb7bde54476,6,5,5,10,5,2012-09-08 14:05:48,2012-09-08 00:23:49
a2a0060034171e22962129d53cc74fb7bde54476...2e0d5c2250ad34273a0ad6e207f2717b9a98bd86,2,48,17,65,6,2012-09-08 14:05:48,2012-09-08 00:30:47
2e0d5c2250ad34273a0ad6e207f2717b9a98bd86...7b0c7ae52c299584e810fc4b1a33893ebdbb8ac3,2,34,0,34,2,2012-09-08 14:05:48,2012-09-08 00:37:29
7b0c7ae52c299584e810fc4b1a33893ebdbb8ac3...1271b4ce66d4251f8f038d8d339fbecbab2d0900,5,27,9,36,6,2012-09-08 14:07:44,2012-09-08 01:30:41
1271b4ce66d4251f8f038d8d339fbecbab2d0900...5ca31aa252d67372d9a90cceb61f16721dca3841,1,3,3,6,3,2012-09-08 14:07:51,2012-09-08 14:00:38
5ca31aa252d67372d9a90cceb61f16721dca3841...a5164ea2ed4e809cb4af7a070652ef2a6b19fbf3,5,70,27,97,8,2012-09-08 14:44:56,2012-09-08 14:44:56
a5164ea2ed4e809cb4af7a070652ef2a6b19fbf3...f7c70eaaedd196accbe8e952ddc4738a96b81998,2,66,0,66,3,2012-09-11 14:47:59,2012-09-11 14:47:59
f7c70eaaedd196accbe8e952ddc4738a96b81998...0bfcc574b660108646bd2c99a611163a0c847251,6,17,32,49,7,2012-09-11 14:48:11,2012-09-10 13:27:14
cc7c6d53966e7501da0af87481b7e7ef2b2025c2...8559d9a156819b576127a944dbcce1fe335d68ba,1,1,1,2,1,2012-09-08 11:24:38,2012-09-08 11:24:38
4226458fafc0cd64422c77691a2c802d2347ea2d...2e76342d72fac88e98820f038dce8fa01952fefb,1,1,1,2,1,2012-09-08 09:37:23,2012-09-08 09:37:23
2e76342d72fac88e98820f038dce8fa01952fefb...8a3408180ab51effd516de3c8e85d564aa4dfabd,1,27,27,54,2,2012-09-08 14:40:36,2012-09-08 14:40:36
8a3408180ab51effd516de3c8e85d564aa4dfabd...0d1009af85c1ed6936a568e9bab9e4da28e69a30,1,12,0,12,1,2012-09-08 14:51:28,2012-09-08 14:51:28
0d1009af85c1ed6936a568e9bab9e4da28e69a30...499ff8b441b517902a0daf79600a59cc1830730e,1,9,8,17,5,2012-09-08 16:39:10,2012-09-08 16:39:10
499ff8b441b517902a0daf79600a59cc1830730e...27e443650746ddb7bf63d9a34d4afaa15350521d,1,3,0,3,3,2012-09-08 17:01:08,2012-09-08 17:01:08
16e67fd8be71cfda57ca19250781a9e0f800d619...0261b0c64c9df0a1a6834fa4f31395989244c2a9,3,8,1,9,4,2012-09-26 18:01:54,2012-09-26 18:01:54
0261b0c64c9df0a1a6834fa4f31395989244c2a9...dddb5b5de99e54d31c9ac3bff82210adf3fa7069,1,1,0,1,1,2012-09-26 18:05:04,2012-09-26 18:05:04
42032956bd4d51bd954762a6f1192f20d6375885...761c17f282c51baa6bc8e3ec169bc09dfaa43b83,1,0,4,4,1,2012-09-05 06:20:02,2012-09-05 06:20:02
42032956bd4d51bd954762a6f1192f20d6375885...36738897bf06937056285b0eeabef13928d4d704,1,26,0,26,1,2012-09-05 04:54:00,2012-09-05 03:57:39
36738897bf06937056285b0eeabef13928d4d704...f06d98e907f71dc9b3a4a2da0db1c096b6c07024,3,22,10,32,5,2012-09-05 05:00:07,2012-09-05 05:00:07
f06d98e907f71dc9b3a4a2da0db1c096b6c07024...443e23e61a10f34e9eccc3b6e91803a0996f5050,2,33,7,40,8,2012-09-05 05:01:20,2012-09-05 05:01:20
443e23e61a10f34e9eccc3b6e91803a0996f5050...861a51488a44eac143ac4f44802fdf05fbd8f4c1,1,24,0,24,1,2012-09-05 05:02:30,2012-09-05 05:02:30
861a51488a44eac143ac4f44802fdf05fbd8f4c1...a9f275bc201e666b9f26768aa228aca8250d5a94,1,1,1,2,1,2012-09-05 05:12:44,2012-09-05 05:12:44
a9f275bc201e666b9f26768aa228aca8250d5a94...5e1c63d3f0f0729a1d9d9e19c64b2fef65cc30fb,2,13,11,24,3,2012-09-05 05:13:41,2012-09-05 05:13:41
7ecfaccf143a29f6114ccf0cbe45e015d62a481f...e469084ccca0d976b0dc069aa89e60a41f067837,1,0,2,2,1,2012-10-29 19:34:16,2012-10-29 19:34:16
8c997f319bf857c63972a676ce36a1e9c07f9324...ed5754624e29e063334b7f935a224b08f60657da,1,1,1,2,1,2012-10-07 00:36:20,2012-10-07 00:36:20
8c997f319bf857c63972a676ce36a1e9c07f9324...7c2e67c6604454ab03d4f760794d85036f0c098b,1,1,1,2,1,2012-10-06 06:46:15,2012-10-06 06:46:15
b1b8f9a27bb629d29473529671ec25989ebd3737...0358c2ebdb7e56694872ceac61f820f39fb2c17b,1,30,0,30,1,2012-09-17 17:42:18,2012-09-17 17:42:18
0358c2ebdb7e56694872ceac61f820f39fb2c17b...aeb87d8f1dc9de89e8ff9ff367c8d50e7dc817de,1,3,3,6,3,2012-09-17 18:38:08,2012-09-17 18:38:08
b1b8f9a27bb629d29473529671ec25989ebd3737...9c0f6e87146bd9b55cdf84e546e7645b91f99dda,1,3,3,6,2,2012-09-17 17:18:49,2012-09-17 17:18:49
6d8d32c2448cf4d321b1e3f0916b808532cd7e60...bf625b7c92d5f07516339f53fdf391185df8547c,11,117,71,188,58,2012-09-19 06:14:07,2012-09-19 06:14:07
27e443650746ddb7bf63d9a34d4afaa15350521d...3b5a90bdf654f9715fd15c189d59bd56492bae8c,4,119,0,119,5,2012-09-08 17:51:12,2012-09-08 17:51:12
dddb5b5de99e54d31c9ac3bff82210adf3fa7069...4629cc44d6b7fa7ebdec8ce47bb0825e255d7763,1,2,2,4,2,2012-09-26 18:18:25,2012-09-26 18:06:31
4629cc44d6b7fa7ebdec8ce47bb0825e255d7763...83efcabc829083f11553df0f1eb67a8fbbc3e000,28,100,44,144,38,2012-09-26 18:18:35,2012-09-26 18:17:17
6e5cd8e0810c63e8744c23cdb887fea78ea37fb4...09a86bd4d6dcf89f5e5393145900593bb22f1080,24,36,36,72,36,2012-09-06 08:21:35,2012-09-06 07:50:47
09a86bd4d6dcf89f5e5393145900593bb22f1080...a65ce748430d922ea2967f226eb40039040dc43d,1,1,1,2,1,2012-09-06 08:40:16,2012-09-06 08:40:16
6e5cd8e0810c63e8744c23cdb887fea78ea37fb4...982a4095c193a9256b76ffcc40526e726eac14d1,8,45,32,77,18,2012-09-05 05:56:59,2012-09-05 05:56:59
fc3c0592db4cf6f6139a995ebd0b5078937945ab...a635b9da97b0e104b8ac1a846344ec8a4abd3123,1,0,1,1,1,2012-10-08 12:57:30,2012-10-08 12:57:30
bf625b7c92d5f07516339f53fdf391185df8547c...01974185a1640ed869417131d062b5a2eef620bc,1,1,5,6,1,2012-09-19 16:14:42,2012-09-19 16:14:42
bf625b7c92d5f07516339f53fdf391185df8547c...e3b149fae611d9c66d3e41048970bd78f322cc9c,1,1,1,2,1,2012-09-19 15:27:27,2012-09-19 15:27:27
2e34a6d3c40a60ed689de5d7870fe663b1959e88...6d76e000d07300ab9e8e8c74b90db0abcdc48451,1,3,0,3,3,2012-09-10 13:50:01,2012-09-10 13:50:01
ebd2a5d0ce3877bdd6b47ad9249142dddc7863d9...1c0153682927f72f6b3011db11ddf5a139f9d16a,5,7,7,14,7,2012-09-09 11:28:41,2012-09-09 09:40:22
1c0153682927f72f6b3011db11ddf5a139f9d16a...93daa8c568cff8c59eb77c7a47b72e0266613d5a,1,0,0,0,0,2012-09-09 11:28:41,2012-09-09 09:30:49
93daa8c568cff8c59eb77c7a47b72e0266613d5a...3b89f140905dd1e929d5bf587fa2509866ba5d32,2,84,138,222,2,2012-09-09 11:28:41,2012-09-09 09:59:15
3b89f140905dd1e929d5bf587fa2509866ba5d32...ad1aa517c7052d26e7243f6574b3deacddd0b161,2,16,7,23,9,2012-09-09 11:28:41,2012-09-09 11:08:13
ad1aa517c7052d26e7243f6574b3deacddd0b161...3551df8eb1c1bfe3a4cef532ddab1cbdcdd96a11,1,8,6,14,2,2012-09-09 11:28:41,2012-09-09 11:17:01
3551df8eb1c1bfe3a4cef532ddab1cbdcdd96a11...5dcca7e4806730d4d77eff711a9b91b5a3ca8314,1,0,6,6,1,2012-09-09 11:28:42,2012-09-09 11:17:43
0439387be00bfb862b4454000f805f11fb8cc389...ed26ecae0c3303b5554b033abd6f0a078b7573c0,1,9,11,20,4,2012-09-26 20:32:20,2012-09-16 20:21:46
ed26ecae0c3303b5554b033abd6f0a078b7573c0...5e1ef575df927a1132e8991f7d5dcc2f43217456,1,33,0,33,1,2012-09-26 20:32:20,2012-09-17 14:08:02
5e1ef575df927a1132e8991f7d5dcc2f43217456...bde5088525512643434ab88b491c0ba9ad6e248b,1,59,0,59,1,2012-09-26 20:32:20,2012-09-17 01:14:21
bde5088525512643434ab88b491c0ba9ad6e248b...a21abce94f25d24b48c038e4a36974735a5b7149,1,11,1,12,3,2012-09-26 20:32:20,2012-09-17 14:06:03
a21abce94f25d24b48c038e4a36974735a5b7149...b389247c029b21f5e85abb5896d2cf22230c9cb1,10,43,31,74,15,2012-09-26 20:32:21,2012-09-17 14:06:56
b389247c029b21f5e85abb5896d2cf22230c9cb1...567767bcf2af2c330c46fde820101fcf847e852f,2,103,0,103,2,2012-09-26 20:32:21,2012-09-17 14:44:36
567767bcf2af2c330c46fde820101fcf847e852f...6ddb35bd5e27829609e40b8dd87313a01fb6f293,8,11,0,11,1,2012-09-26 20:32:21,2012-09-17 14:57:13
6ddb35bd5e27829609e40b8dd87313a01fb6f293...2ddb19170624f81ec0cb3da26805a5515878aede,2,1,3,4,2,2012-09-26 20:32:21,2012-09-17 15:10:04
2ddb19170624f81ec0cb3da26805a5515878aede...884eb732977ee785c48a954542e8735cd572e1fe,2,10,27,37,8,2012-09-26 20:32:21,2012-09-17 16:26:29
884eb732977ee785c48a954542e8735cd572e1fe...e33cbb9b4252e2617bcb4c3f850c47aae43e4d83,4,100,3,103,6,2012-09-26 20:32:21,2012-09-17 16:38:59
e33cbb9b4252e2617bcb4c3f850c47aae43e4d83...79a02df92e18137787371468be5c8897ad2f97b0,20,41,36,77,32,2012-09-26 20:32:21,2012-09-17 16:39:57
79a02df92e18137787371468be5c8897ad2f97b0...339dfa32b810b8f15c26c85e692a18a0f47b9fca,3,3,3,6,3,2012-09-26 20:32:21,2012-09-17 17:07:17
339dfa32b810b8f15c26c85e692a18a0f47b9fca...94af622c879681683c84b6537c2adea52c78b2a2,1,0,0,0,0,2012-09-26 20:32:21,2012-09-17 17:32:17
94af622c879681683c84b6537c2adea52c78b2a2...37f0b600bc9a994136791e6838b3228c56f909b2,2,83,58,141,7,2012-09-26 20:32:22,2012-09-17 17:33:04
37f0b600bc9a994136791e6838b3228c56f909b2...39c657930625ddc3ac8a921f01ffc83acadce68f,8,57,27,84,12,2012-09-26 20:32:22,2012-09-17 17:36:13
39c657930625ddc3ac8a921f01ffc83acadce68f...576cec6c67dcc4ee00b8220ca1a45385583e25b2,8,83,65,148,22,2012-09-26 20:32:22,2012-09-17 17:49:57
576cec6c67dcc4ee00b8220ca1a45385583e25b2...398ba6f1bb60f176444dedc7b26188e08b920f54,6,38,73,111,12,2012-09-26 20:32:22,2012-09-17 18:24:31
398ba6f1bb60f176444dedc7b26188e08b920f54...a8ea8d98a4f88a292289ddfedef4358033b68ec0,3,12,15,27,8,2012-09-26 20:32:22,2012-09-20 17:25:28
a8ea8d98a4f88a292289ddfedef4358033b68ec0...a1e68a91205186287f21fb5fd1669acebcd7e79e,6,84,19,103,9,2012-09-26 20:32:22,2012-09-20 17:55:14
a1e68a91205186287f21fb5fd1669acebcd7e79e...5a5d214de499b678802ac12c5c6cbe583a85ae36,6,0,9,9,6,2012-09-26 20:32:22,2012-09-20 18:43:38
5a5d214de499b678802ac12c5c6cbe583a85ae36...169f16fb32091701bcaa962872ea35b5772a1539,6,53,21,74,8,2012-09-26 20:32:22,2012-09-20 19:20:48
169f16fb32091701bcaa962872ea35b5772a1539...3574826920eb958c5e59e86bb79b0773c187abfb,6,19,45,64,10,2012-09-26 20:32:22,2012-09-20 19:32:00
3574826920eb958c5e59e86bb79b0773c187abfb...835be5b1bf25fc0509ef1b1f7f7f2e3a344ff231,1,1,1,2,1,2012-09-26 20:32:22,2012-09-25 22:20:52
835be5b1bf25fc0509ef1b1f7f7f2e3a344ff231...f1c6bd8df3225d33af4d3d032cc98be86317b348,1,2,2,4,1,2012-09-26 20:32:23,2012-09-25 22:21:04
f1c6bd8df3225d33af4d3d032cc98be86317b348...9d394250a8055f31d81e5538cb77f19ea6d0d79b,1,21,0,21,1,2012-09-26 20:32:23,2012-09-25 22:45:13
9d394250a8055f31d81e5538cb77f19ea6d0d79b...c058e3903e01b950d19fe8ce86702f24083c8395,1,4,10,14,5,2012-09-26 20:32:23,2012-09-25 22:45:30
c058e3903e01b950d19fe8ce86702f24083c8395...99d391332fa9a6c11e93bd19295425167661b972,4,17,22,39,6,2012-09-26 20:32:23,2012-09-25 22:46:19
99d391332fa9a6c11e93bd19295425167661b972...1048917232992671b0a01f4c87ed00edfff633e8,8,9,9,18,8,2012-09-26 20:32:23,2012-09-25 22:50:02
1048917232992671b0a01f4c87ed00edfff633e8...33126227af662a454538d5a64762d19165f3c65d,1,0,8,8,2,2012-09-26 20:32:23,2012-09-25 23:16:46
33126227af662a454538d5a64762d19165f3c65d...95f0a4114139d49b3979d6f0e53baa53193a624a,1,4,4,8,2,2012-09-26 20:32:23,2012-09-25 23:17:54
95f0a4114139d49b3979d6f0e53baa53193a624a...3ad931ca9211d2ca0f345f97db00193ee5533dfd,2,25,0,25,2,2012-09-26 20:32:23,2012-09-25 23:22:44
3ad931ca9211d2ca0f345f97db00193ee5533dfd...545dc7e47d627a5ba4b4219880801f26fbb77f4d,3,4,4,8,3,2012-09-26 20:32:23,2012-09-25 23:25:14
545dc7e47d627a5ba4b4219880801f26fbb77f4d...f814da38bf3d86b8ff045ff585c75af4d6755184,1,5,1,6,1,2012-09-26 20:32:23,2012-09-26 00:01:51
f814da38bf3d86b8ff045ff585c75af4d6755184...cada511f8b88671bb8a99600ed314c3beb5a36f4,11,535,7,542,17,2012-09-26 20:32:24,2012-09-26 00:11:57
cada511f8b88671bb8a99600ed314c3beb5a36f4...60ac6a28a2f198427c2d1ad68421aee484e14028,2,12,4,16,3,2012-09-26 20:32:24,2012-09-26 01:18:00
60ac6a28a2f198427c2d1ad68421aee484e14028...adcc6a0b0e08158353627a8a900971aca07429bd,2,39,39,78,2,2012-09-26 20:32:24,2012-09-26 01:18:39
adcc6a0b0e08158353627a8a900971aca07429bd...51c1e499006df02ff3dfc2a781457a01cc77550f,4,18,21,39,12,2012-09-26 20:32:24,2012-09-26 02:07:41
51c1e499006df02ff3dfc2a781457a01cc77550f...6b90f36f5b6ee36dede7cc33c9364ddd34e5ba6b,1,11,46,57,9,2012-09-26 20:32:24,2012-09-26 02:32:54
6b90f36f5b6ee36dede7cc33c9364ddd34e5ba6b...4252ea90c0ab757fce538af1f03ce5f6d48f7814,3,55,2,57,5,2012-09-26 20:32:24,2012-09-26 02:34:29
4252ea90c0ab757fce538af1f03ce5f6d48f7814...8fe63dab52f6e72aaab1141f2af5d72b012064b7,1,2,2,4,2,2012-09-26 20:32:24,2012-09-26 02:41:25
8fe63dab52f6e72aaab1141f2af5d72b012064b7...6cb626ef516a230b2af4e15145488d4c57cd048c,3,13,1,14,5,2012-09-26 20:32:24,2012-09-26 03:10:50
6cb626ef516a230b2af4e15145488d4c57cd048c...b462a133879ca2a202f18f18d8e78a3ffed05c24,7,45,66,111,9,2012-09-26 20:32:24,2012-09-26 03:13:19
b462a133879ca2a202f18f18d8e78a3ffed05c24...86a7864dc78ed9168df889a5994ee7ef80a29476,9,9,9,18,9,2012-09-26 20:32:25,2012-09-26 03:33:42
86a7864dc78ed9168df889a5994ee7ef80a29476...b62d6a1fe28ad040e96fd88604131f357e5e6e9e,2,1,7,8,2,2012-09-26 20:32:25,2012-09-26 03:34:26
b62d6a1fe28ad040e96fd88604131f357e5e6e9e...b6d6663e0e793b2a47f8a25215334f77e2b80baf,1,1,1,2,1,2012-09-26 20:32:25,2012-09-26 03:34:52
b6d6663e0e793b2a47f8a25215334f77e2b80baf...0887dda8e4eba68004e087e12302f3dbf2688790,1,2,2,4,2,2012-09-26 20:32:25,2012-09-26 03:39:28
0887dda8e4eba68004e087e12302f3dbf2688790...275db3c522200b68673c4ea6a16046b3582cda2f,1,3,3,6,2,2012-09-26 20:32:25,2012-09-26 03:39:50
275db3c522200b68673c4ea6a16046b3582cda2f...1799cf3b49dbe243e21f13d51496be7d60d1a73f,1,22,0,22,1,2012-09-26 20:32:25,2012-09-26 03:40:04
1799cf3b49dbe243e21f13d51496be7d60d1a73f...e9bd45060e3c5198124b4cdad08a7a26f5e0408a,1,1,1,2,1,2012-09-26 20:32:25,2012-09-26 03:56:27
e9bd45060e3c5198124b4cdad08a7a26f5e0408a...9f0e80591ab1f3c4967575574fed37754ef2403b,2,9,6,15,8,2012-09-26 20:32:25,2012-09-26 17:21:38
9f0e80591ab1f3c4967575574fed37754ef2403b...cf237f1d32c15e1e9fa128fc9e089a7857495f51,1,2,2,4,2,2012-09-26 20:32:26,2012-09-26 17:21:55
cf237f1d32c15e1e9fa128fc9e089a7857495f51...67fd7432943657f29d3d417445d54bc7c6d46946,1,92,78,170,56,2012-09-26 20:32:26,2012-09-26 17:22:30
67fd7432943657f29d3d417445d54bc7c6d46946...5cea3e576dfc2a0d01a44b647bbd1c14a202d9e3,1,0,7,7,1,2012-09-26 20:32:26,2012-09-26 17:23:19
5cea3e576dfc2a0d01a44b647bbd1c14a202d9e3...2df3b310f9727956c3ce84322928f3360616f5ad,2,11,11,22,10,2012-09-26 20:32:26,2012-09-26 17:34:51
2df3b310f9727956c3ce84322928f3360616f5ad...f8c02f6e39d0a1f752583cc1942bb5e4c53df9c1,2,12,2,14,4,2012-09-26 20:32:26,2012-09-26 17:38:14
f8c02f6e39d0a1f752583cc1942bb5e4c53df9c1...7df25e77ac3cfd279a1b1937e45446574d932a3d,2,12,4,16,6,2012-09-26 20:32:26,2012-09-26 17:43:42
7df25e77ac3cfd279a1b1937e45446574d932a3d...82c3f6260366147803d5f63d575231f77c7e73ce,2,8,10,18,6,2012-09-26 20:32:26,2012-09-26 17:58:50
82c3f6260366147803d5f63d575231f77c7e73ce...afc4a75499b6678a643e6b62f703f8e7e1eb0f0a,11,17,17,34,17,2012-09-26 20:32:26,2012-09-26 18:52:01
afc4a75499b6678a643e6b62f703f8e7e1eb0f0a...aa0c4b77b60acfc85d99e9eacaff25e34b136529,2,34,0,34,3,2012-09-26 20:32:26,2012-09-26 19:06:07
aa0c4b77b60acfc85d99e9eacaff25e34b136529...f064c84019f7414cb9cfa9e49fb735dba7f495df,2,112,0,112,2,2012-09-26 20:32:26,2012-09-26 20:13:23
f064c84019f7414cb9cfa9e49fb735dba7f495df...36f68140d1fcd89ed6bd92ac69cf13c566db63d5,11,61,121,182,39,2012-09-26 20:38:28,2012-09-26 20:14:17
36f68140d1fcd89ed6bd92ac69cf13c566db63d5...8432c9c176d9a5e646fe007a9cd333b31197abeb,1,0,1,1,1,2012-09-26 20:45:00,2012-09-26 20:45:00
8432c9c176d9a5e646fe007a9cd333b31197abeb...d8f7748dea5d43a16babd15dd02dcbc76220da5a,4,50,58,108,5,2012-09-26 21:00:52,2012-09-26 21:00:52
d8f7748dea5d43a16babd15dd02dcbc76220da5a...beb324c1c6518f4ad20039b4122ef6d59ba430c2,2,6,6,12,5,2012-09-27 06:49:00,2012-09-27 06:49:00
beb324c1c6518f4ad20039b4122ef6d59ba430c2...2c8d3c33ff64ac6af5daf125a2f9ef917e55bcfc,1,2,2,4,1,2012-09-27 06:53:42,2012-09-27 06:53:42
0439387be00bfb862b4454000f805f11fb8cc389...078a8f0e662a1626b53bbf7f7c3e2b0599c94810,17,33,101,134,39,2012-09-26 20:27:43,2012-09-25 23:21:37
078a8f0e662a1626b53bbf7f7c3e2b0599c94810...bdf317addc2ae586c76f46ccb1aa8659513baf16,7,12,30,42,13,2012-09-26 20:27:44,2012-09-26 20:24:52
982a4095c193a9256b76ffcc40526e726eac14d1...2680371785bfac1d0b76e5c4e53aa1074f743f84,1,1,1,2,1,2012-09-05 10:05:57,2012-09-05 10:05:57
2680371785bfac1d0b76e5c4e53aa1074f743f84...0b559cdece743269a7087c8206ab2cc587ec15f2,5,11,3,14,7,2012-09-05 11:01:11,2012-09-05 10:14:24
02a29d1db400ed4905db7dca9c8fcfa0712d5a1b...3bf0b4e25b4fa4bc865167542391cbd29e40cb53,1,2,0,2,1,2012-12-23 19:51:27,2012-12-23 19:47:31
3bf0b4e25b4fa4bc865167542391cbd29e40cb53...a9e2fa4c35604da4be37493cf7378e247d84f739,1,3,4,7,4,2012-12-23 19:51:27,2012-12-23 19:47:55
5501955d26596ea1fe86e49f32eb41d57aec8c6e...d47e40929d7892e7469a11016f927412ed283791,1,7,3,10,4,2012-10-08 08:52:08,2012-10-08 08:52:08
d47e40929d7892e7469a11016f927412ed283791...ad5b5d1e51abb02496458989fbff351f57f7fb29,1,0,1,1,1,2012-10-08 08:54:50,2012-10-08 08:54:36
ad5b5d1e51abb02496458989fbff351f57f7fb29...61f12da3a5b84670a0fc8cb5dbb962a365895097,4,29,1,30,4,2012-10-08 09:13:53,2012-10-08 09:13:53
a635b9da97b0e104b8ac1a846344ec8a4abd3123...df7c52489a890ac38491682b4a3399beb7cdbc86,21,258,246,504,78,2012-10-09 00:10:04,2012-10-09 00:10:04
df7c52489a890ac38491682b4a3399beb7cdbc86...a4cd738686659314f0bb9fd13a80845dc2b036ab,7,10,10,20,8,2012-10-09 00:10:16,2012-10-09 00:10:16
a635b9da97b0e104b8ac1a846344ec8a4abd3123...03836cc5917dd4cc1b30bd4e298795162d3609fd,1,13,0,13,1,2012-10-08 20:19:07,2012-10-08 20:19:07
7cce2b1506fc9e1da2d933953e026bb8b9d81ba0...249cb19d96cff52f70f930fbf13ee23ae5d66d3e,5,15,20,35,8,2012-09-18 05:54:17,2012-09-18 05:54:17
d5663e148fdf8d1c767479e62c86c7a2b4db654e...61ffcab60fef2efcd54b8496aa09de79ee999a2c,6,150,0,150,7,2013-03-05 15:38:43,2012-11-14 20:37:52
61ffcab60fef2efcd54b8496aa09de79ee999a2c...47abdc10ca7daceac8206a65166b42409a76b459,3,50,0,50,3,2013-03-06 04:48:40,2013-03-06 04:48:40
d5663e148fdf8d1c767479e62c86c7a2b4db654e...9ba21dd0c4255692594f5d4e9a6efb7b9646c465,1,1,1,2,1,2013-03-05 15:07:12,2013-03-05 15:06:22
9ba21dd0c4255692594f5d4e9a6efb7b9646c465...a99ad3d355f22907b38fad0a5b276e176c3901a7,1,9,7,16,1,2013-03-05 15:15:20,2013-03-05 15:15:20
a99ad3d355f22907b38fad0a5b276e176c3901a7...6beae84ea37e03e68affd2b69fba25f45a4e5386,2,2,1,3,2,2013-03-05 15:28:13,2013-03-05 15:28:13
01974185a1640ed869417131d062b5a2eef620bc...496f88afe10f95a7aa64ea8ab10e57412f827283,3,12,5,17,5,2012-09-19 23:42:26,2012-09-19 23:42:26
496f88afe10f95a7aa64ea8ab10e57412f827283...ba72c6f683fc52a3223c45c5044abf1361e059fd,7,7,7,14,7,2012-09-20 00:21:12,2012-09-20 00:21:12
ba72c6f683fc52a3223c45c5044abf1361e059fd...345c4d2a776c3e30d0c05e5954adbfe4142f3519,1,4,2,6,1,2012-09-20 00:21:35,2012-09-20 00:21:35
c3907bef59c986ce49b922cea6929486ad048970...252d3a0c9d84cef8d939c2c444f8763079eded1e,6,0,6,6,6,2012-09-25 20:38:11,2012-09-25 20:32:20
c3907bef59c986ce49b922cea6929486ad048970...c3efcf7a626ca2621b6fc9977aae8740ed7b10a8,2,23,19,42,5,2012-09-25 10:15:06,2012-09-25 10:14:20
1f5e2658f53b1214cd197ecad544ba2bd2975766...ad3a88cfd34aeed5ed69b4056e393580a686fb09,5,15,11,26,10,2012-08-28 23:03:04,2012-08-28 23:03:04
ad3a88cfd34aeed5ed69b4056e393580a686fb09...a56cec113204130385e0fbc3f2223d81101357ef,3,6,12,18,3,2012-08-28 23:08:39,2012-08-28 23:08:39
19c58becc00982b718f0e11b74129ef2ccce2454...a8870e87e4cc8ce441032dc6aa3dfa6e1812090e,2,13,1,14,3,2012-09-27 08:58:41,2012-09-27 08:58:41
e563e948bb907a26c4a170eaec0f3976fdf11d74...933c5e414600d5e0170213db574ba6431c1444e4,5,5,28,33,13,2012-09-27 11:44:53,2012-09-27 11:44:53
933c5e414600d5e0170213db574ba6431c1444e4...be18397d82ca16fefed7287c8078a9b41bf37c95,22,21,21,42,21,2012-09-27 18:59:42,2012-09-27 18:59:42
19a52197462b9b508af6e90ed3ae55b653d4949e...d480a478c1cb1246e1dad80cc438c5556a3eb33f,847,0,0,0,0,2012-09-05 20:04:41,2012-09-05 20:04:41
d480a478c1cb1246e1dad80cc438c5556a3eb33f...880a233e6d1bcf0dbeb9d1a01fb816b77ed21cc9,1,34,0,34,1,2012-09-05 20:05:20,2012-09-05 20:05:20
880a233e6d1bcf0dbeb9d1a01fb816b77ed21cc9...90f587f4ee854fe14f0f7efcf012dfc1a0666dcd,1,1,34,35,1,2012-09-05 20:06:20,2012-09-05 20:06:03
90f587f4ee854fe14f0f7efcf012dfc1a0666dcd...67a6a0b29b1ca9563244f914bd0eaf0165389efd,1,69,13,82,13,2012-09-05 20:07:39,2012-09-05 20:07:39
67a6a0b29b1ca9563244f914bd0eaf0165389efd...b3bbf53e9bd0d3eb4b947f0e1f01887120e7a2fb,2,7,1,8,2,2012-09-05 20:14:54,2012-09-05 20:14:54
19a52197462b9b508af6e90ed3ae55b653d4949e...8f7360f3901ae27a457f252b1a9a091a857434ee,3,39,0,39,3,2012-09-05 20:01:03,2012-09-05 20:01:03
19a52197462b9b508af6e90ed3ae55b653d4949e...21bfd1e7fc91ce9a1aa34582381c1dec716607f8,3,15,15,30,14,2012-09-05 20:00:10,2012-09-05 20:00:10
a9e2fa4c35604da4be37493cf7378e247d84f739...d9ca1bce7a52709aa9d1aa60940cab69861e09c0,1,4,4,8,4,2012-12-24 15:45:03,2012-12-24 14:47:02
d9ca1bce7a52709aa9d1aa60940cab69861e09c0...0e15270b75df9e882bc41e22a6a120092a629a02,1,1,1,2,2,2012-12-24 15:45:08,2012-12-24 15:41:46
0e15270b75df9e882bc41e22a6a120092a629a02...8ef7b9b6d10bde1f513d678703fc209653087137,1,1,1,2,1,2012-12-24 15:45:10,2012-12-24 14:52:49
26045d7a2ce7f40becd179aa3b4222e2df8f5426...ce1b742b1e61d8726078e0060ba52aa8b9985c1b,4,11,2,13,4,2012-10-09 06:46:20,2012-10-09 06:46:20
ce1b742b1e61d8726078e0060ba52aa8b9985c1b...c348284fedb487474626b3dae9be73311f8382df,1,1,1,2,1,2012-10-09 07:01:07,2012-10-09 07:01:07
dc33f71b181d154c8d9937f777fa16e9cf1d968d...41e53eb98058a0082e0951aa21812b04d745414a,28,225,2,227,29,2012-10-09 08:14:17,2012-10-09 08:14:17
41e53eb98058a0082e0951aa21812b04d745414a...a54a90188b03730c998b7e5a91c85611dfe5e311,1,0,21,21,1,2012-10-09 11:59:58,2012-10-09 11:59:58
df03275eaa2640887e4902a7e8198ed0e2896063...a0aa0212a9286b26457a5b44674f81b26f6bc097,7,1,59,60,8,2012-11-29 03:14:05,2012-11-29 03:14:05
7c408960ce9cf8a20941c99fd64aa5b1f472f9a0...e90277f9b526194bacf740c352e014baa14b1f40,3,29,13,42,5,2013-03-07 08:08:43,2013-03-07 08:08:43
e90277f9b526194bacf740c352e014baa14b1f40...ca9098d8982041ba76402c80c9018beb10836db8,5,37,17,54,9,2013-03-07 09:14:19,2013-03-07 09:14:19
ca9098d8982041ba76402c80c9018beb10836db8...0d66fa89fc34bfe02d2f6a99dbf66dcd921290fe,1,5,0,5,1,2013-03-07 09:45:44,2013-03-07 09:45:44
6beae84ea37e03e68affd2b69fba25f45a4e5386...6224ac064798e28a75bf14c7fcce5b8f2b58fca2,2,16,6,22,9,2013-03-06 07:36:01,2013-03-06 03:59:28
6224ac064798e28a75bf14c7fcce5b8f2b58fca2...bb63459d537fcd658be0638527e33fc1df56a48f,1,3,3,6,3,2013-03-06 07:36:10,2013-03-06 04:42:45
bb63459d537fcd658be0638527e33fc1df56a48f...e7a67a55832aa8d7bf7d52ac07bf2850c9118633,1,0,6,6,1,2013-03-06 07:36:10,2013-03-06 04:53:30
e7a67a55832aa8d7bf7d52ac07bf2850c9118633...83435e3d46355ff53b7241a5ec6e414dfdf152fa,1,2,0,2,2,2013-03-06 07:36:11,2013-03-06 06:17:01
6beae84ea37e03e68affd2b69fba25f45a4e5386...d03af842c5ea0fdc40e709e9b3104c4d723828ab,1,1,1,2,1,2013-03-06 07:12:14,2013-03-06 07:12:14
6beae84ea37e03e68affd2b69fba25f45a4e5386...f411772e3395f569da893dd1fc0fd666dcbb5caa,3,179,0,179,4,2013-03-05 21:23:29,2013-03-05 21:23:29
ae1d9fb46aa2b07ee9836d49862ec4e2c46fbbba...6104942438c14ec7bd21c6cd5bd995272b3faff6,1,3,1,4,2,2012-09-20 06:06:12,2012-09-20 06:06:12
30ee53624ba34ed5def5c0f2d5a95e024cbadd22...83696b127b7822482957a894816b0e3c2daea0b5,8,77,120,197,58,2012-09-26 11:18:10,2012-09-26 11:18:10
c3efcf7a626ca2621b6fc9977aae8740ed7b10a8...6df515a56dd426abd6a65cfeb2a75305c04eed6e,1,8,2,10,1,2012-09-25 11:56:21,2012-09-25 11:56:21
a56cec113204130385e0fbc3f2223d81101357ef...a86bd87afcb8ba8221aa72562a6591139fa763c0,10,78,3,81,13,2012-09-09 20:18:28,2012-09-09 20:18:28
a86bd87afcb8ba8221aa72562a6591139fa763c0...1f240b09ed5f9f5476a863dd2f906398e5a9f0d4,10,75,10,85,17,2012-09-09 21:27:47,2012-09-09 21:27:47
a8870e87e4cc8ce441032dc6aa3dfa6e1812090e...80bfd6a50b409fc86446f40a84cbc2c90e13a304,2,11,12,23,7,2012-09-27 14:00:13,2012-09-27 14:00:13
a8870e87e4cc8ce441032dc6aa3dfa6e1812090e...2a4359a572c123d117988487f9bb29f4ae176ceb,15,86,57,143,43,2012-09-27 09:05:53,2012-09-27 05:36:31
2a4359a572c123d117988487f9bb29f4ae176ceb...841e4fbd08d2d642c127506001a76a973ea3d536,18,107,225,332,75,2012-09-27 09:05:53,2012-09-27 06:20:36
841e4fbd08d2d642c127506001a76a973ea3d536...c7a1779b2215b1815d43c5635e026afeed8da7f4,2,2,2,4,2,2012-09-27 09:55:57,2012-09-27 06:28:10
c7a1779b2215b1815d43c5635e026afeed8da7f4...2088d2eba86878dafaa69e8b908a0db2730451b4,1,2,2,4,2,2012-09-27 09:56:20,2012-09-27 06:32:04
2088d2eba86878dafaa69e8b908a0db2730451b4...a030e4b6645263ae409b37b569eff2600eb98aa8,3,5,19,24,11,2012-09-27 09:56:20,2012-09-27 06:36:55
68f4b59738b43d9d6969528188ec74a87546a29f...9cabe04368024f44881e4269a008156f1629ab86,5,24,0,24,5,2012-09-27 20:23:11,2012-09-27 20:23:11
9cabe04368024f44881e4269a008156f1629ab86...db69836319ebf716b31f52e818605df0816790e0,5,65,43,108,5,2012-09-27 20:52:08,2012-09-27 20:52:08
db69836319ebf716b31f52e818605df0816790e0...7ded8584a57f6f29a704144ae0db21adf8bd0920,2,3,3,6,2,2012-09-27 20:59:41,2012-09-27 20:59:41
8808c5fa8d0102d1cf0641812a029434b0d6ede8...3a63f6f31622c5f96ff167b0c8df1367abbf5eda,1,1,1,2,1,2012-09-06 19:26:55,2012-09-06 19:26:55
3a63f6f31622c5f96ff167b0c8df1367abbf5eda...2faa4bba40909778c1732894faf42a0f00e87cc4,2,11,1,12,2,2012-09-06 19:31:25,2012-09-06 19:31:25
52e99b6eb9a1f0b3e6550dbac02e918c527a5616...e3b1f62c6b1fda0ea711f65c699d5025ab926c9d,1,1,1,2,1,2012-09-05 21:13:25,2012-09-05 21:13:25
e3b1f62c6b1fda0ea711f65c699d5025ab926c9d...94c50545661c21816faf1e143739f60b1058b8e1,1,1,1,2,1,2012-09-05 22:06:02,2012-09-05 22:06:02
94c50545661c21816faf1e143739f60b1058b8e1...cd846ba2b55cd1380febfa174d8cf82ad9e948f7,1,3,4,7,3,2012-09-06 06:52:27,2012-09-06 06:52:27
cd846ba2b55cd1380febfa174d8cf82ad9e948f7...ab057bb5dbf5806365d42371c968290235c555a8,1,1,1,2,1,2012-09-06 07:20:59,2012-09-06 07:20:59
ab057bb5dbf5806365d42371c968290235c555a8...3d3c6674fbea1b9099e80e1fc1768f85ecd3bf14,1,2,2,4,1,2012-09-06 13:32:26,2012-09-06 13:32:26
3d3c6674fbea1b9099e80e1fc1768f85ecd3bf14...2dc0519277417456372d6bde5c47bec895cc497e,2,30,0,30,2,2012-09-06 20:14:42,2012-09-06 20:14:42
2dc0519277417456372d6bde5c47bec895cc497e...909c8c345dff0851e15d81917efe7817c7f89e22,4,111,8,119,11,2012-09-06 20:49:29,2012-09-06 20:49:29
21bfd1e7fc91ce9a1aa34582381c1dec716607f8...e4447de23fa41fd67db31e3ca97dbee7349a026c,13,163,119,282,38,2012-09-06 06:15:51,2012-09-06 06:15:51
21bfd1e7fc91ce9a1aa34582381c1dec716607f8...b78fd0c13088ce2c19d939a26a26e247ca5047ea,3,5,0,5,4,2012-09-05 20:50:03,2012-09-05 20:49:59
b78fd0c13088ce2c19d939a26a26e247ca5047ea...52c521ffe84dac5dc72a299ee1ecf4736a10f07f,4,28,8,36,5,2012-09-05 20:52:49,2012-09-05 20:52:49
52c521ffe84dac5dc72a299ee1ecf4736a10f07f...1814ee0ced59aa3203ce265410ae5a7c83e096aa,2,3,3,6,2,2012-09-05 21:02:23,2012-09-05 21:02:23
8ef7b9b6d10bde1f513d678703fc209653087137...ba24e242d704cc13e7cb0cb218edd6115abdba1d,1,1,1,2,1,2013-01-14 15:28:33,2013-01-14 15:28:33
8ef7b9b6d10bde1f513d678703fc209653087137...80f75b8174f7be9e7d2a8e4d660250a204965ca1,1,1,1,2,1,2012-12-25 11:25:44,2012-12-25 11:25:44
ece30f53ee997ba6eb4d0205a82ba204e3a901e3...9655350c79e33ed765c62f892d65dd8c52284427,1,32,32,64,32,2012-12-23 20:13:57,2012-12-23 00:33:58
9655350c79e33ed765c62f892d65dd8c52284427...224da71177a0e79c436fff530af60260f33ade6c,3,39,63,102,4,2012-12-23 20:13:57,2012-12-23 02:20:13
224da71177a0e79c436fff530af60260f33ade6c...430d3ad45b524943fb3b62890c5a3cdc72e70325,1,31,5,36,5,2012-12-23 20:14:30,2012-12-23 20:14:30
430d3ad45b524943fb3b62890c5a3cdc72e70325...1b6c28b9766aff2075bcd6e8c394ac4b9ed66f96,1,39,35,74,37,2012-12-23 20:15:25,2012-12-23 20:15:25
1b6c28b9766aff2075bcd6e8c394ac4b9ed66f96...31e0fa6572848ee12c05e4e7471c1b3cee426f5f,1,16,12,28,12,2012-12-23 20:16:08,2012-12-23 20:16:08
31e0fa6572848ee12c05e4e7471c1b3cee426f5f...2462949fd598258204a8b6b98c2c91b5eabde847,1,12,9,21,10,2012-12-23 20:16:26,2012-12-23 20:16:26
2462949fd598258204a8b6b98c2c91b5eabde847...d80d4cd92bd3f2bd77b19d44d773e97e981282fb,4,7,7,14,3,2012-12-24 10:37:28,2012-12-24 10:37:28
d80d4cd92bd3f2bd77b19d44d773e97e981282fb...2937f35f9afa51286f563c1a24940ee23a2d7d1b,6,11,12,23,12,2012-12-24 12:24:45,2012-12-24 12:24:45
2937f35f9afa51286f563c1a24940ee23a2d7d1b...efc4cae1b71bfd01e6b95ec3ae8d0376171c1d05,1,92,0,92,1,2012-12-24 12:33:16,2012-12-24 12:33:16
624abdfc72f57da5650e239c8dd20e14f2f9a186...bcdb168709ac03c7a7e00f440dcd47f2538894e3,1,3,4,7,4,2012-10-08 11:17:46,2012-10-08 11:17:46
a54a90188b03730c998b7e5a91c85611dfe5e311...bbd92e57cb5c764baf5fbdb9ccb1a1cd140eeca9,2,16,0,16,2,2012-10-09 12:47:42,2012-10-09 12:47:42
bbd92e57cb5c764baf5fbdb9ccb1a1cd140eeca9...3adfbe3e81697f61775d4d08d8eacde5a13a95c4,2,2,2,4,2,2012-10-09 12:48:20,2012-10-09 12:48:20
3adfbe3e81697f61775d4d08d8eacde5a13a95c4...37e579ce10376ef16f9e9f28b81b0ca788438204,1,42,8,50,1,2012-10-09 12:48:35,2012-10-09 12:48:35
e38e2ce29a2d0ce731bafd5012eae8d21de05d4b...40f18681948d4662812f342700533c1a99991927,2,9,10,19,4,2013-03-06 15:12:28,2013-03-06 15:12:28
d03af842c5ea0fdc40e709e9b3104c4d723828ab...1dd712ddc238d2e6c30be09cb071c8e9b60cfcac,4,177,0,177,4,2013-03-06 15:15:26,2013-03-06 10:33:32
61cfa2a7a6e1d4557b69e17c537656e8a0201ac8...cce35b6d057611d792bdc70022bd7264798527a7,1,1,2,3,1,2013-03-05 21:33:45,2013-03-05 21:33:45
cce35b6d057611d792bdc70022bd7264798527a7...b5ef6d226864d3ea132d2c6e97b74b51f2b64a6f,2,8,18,26,7,2013-03-05 22:43:05,2013-03-05 22:43:05
b5ef6d226864d3ea132d2c6e97b74b51f2b64a6f...39114d259c6e4bd5bb60b18f561d06cc24e8c852,11,36,475,511,78,2013-03-06 23:15:57,2013-03-06 23:15:57
6104942438c14ec7bd21c6cd5bd995272b3faff6...ed899a2f4b50b4370feeea94676502b42383c746,1,2,2,4,2,2012-09-20 08:50:22,2012-09-20 08:50:22
ed899a2f4b50b4370feeea94676502b42383c746...0e524aaea1a98e5f1dff7f7370838116da5ba6f0,3,16,4,20,3,2012-09-20 10:00:18,2012-09-20 10:00:18
0e524aaea1a98e5f1dff7f7370838116da5ba6f0...f33e1e480e9009f8cd3930eef1830877623588c5,2,4,2,6,3,2012-09-20 10:05:07,2012-09-20 10:05:07
f33e1e480e9009f8cd3930eef1830877623588c5...4e1f1e142299209ff50d595528b1e6410c9b7308,1,1,1,2,1,2012-09-20 12:34:07,2012-09-20 12:34:07
4e1f1e142299209ff50d595528b1e6410c9b7308...37817cc31d890f1e79b31ae3d625fbace672451e,1,3,1,4,1,2012-09-20 12:38:34,2012-09-20 12:38:34
37817cc31d890f1e79b31ae3d625fbace672451e...9aafe77e708174aac697a8dcafc99b90e96be36e,6,90,2,92,7,2012-09-20 14:45:07,2012-09-20 14:44:44
80685596d3df23f05f2bd9978c8d8f483e799028...b565f33472d960e37ed41a8a0c09fbbc3ea65f1e,4,27,0,27,8,2012-09-10 06:06:11,2012-09-10 06:06:11
e0d0c1b225e6d693b7a43b09b74f97dd70444433...afecb250a42222aa3ac9b373897582da27e2e49e,1,6,5,11,1,2012-09-27 14:13:26,2012-09-27 14:13:26
afecb250a42222aa3ac9b373897582da27e2e49e...308dfc36b881443dc146b3f9b777c7f7f6475c90,1,1,1,2,1,2012-09-27 16:38:52,2012-09-27 16:38:52
308dfc36b881443dc146b3f9b777c7f7f6475c90...1502be325db6e31558106d7b8dcfd30e99917cc9,1,1,1,2,1,2012-09-27 17:12:11,2012-09-27 17:12:11
7ded8584a57f6f29a704144ae0db21adf8bd0920...1fe45898d7871512bb25b5c314301221420c560b,1,9,5,14,4,2012-09-28 06:53:02,2012-09-28 04:42:31
a595f8944a32fa99ffd85a9c837a76a8dfc0ff7e...bde19c061a73a7756cad4ba02e52187b1eb22fc5,1,4,4,8,3,2012-09-06 20:51:28,2012-09-06 20:51:28
bde19c061a73a7756cad4ba02e52187b1eb22fc5...8f3b1d6ea4c72665e1b0ffbc554727595cbe60b0,1,1,1,2,1,2012-09-06 21:05:23,2012-09-06 21:05:23
e4447de23fa41fd67db31e3ca97dbee7349a026c...c106bb7096e3bb8bada454dcf7794877204f0e34,1,3,8,11,2,2012-09-06 11:03:46,2012-09-06 11:03:46
c106bb7096e3bb8bada454dcf7794877204f0e34...60e18e2636b8ca3e6f25c5a9adaa4118f5a2d3ad,2,8,11,19,2,2012-09-06 11:32:01,2012-09-06 11:32:01
60e18e2636b8ca3e6f25c5a9adaa4118f5a2d3ad...08d9421dd9c291def896c78f703fec933d1c540f,2,10,10,20,2,2012-09-06 11:32:31,2012-09-06 11:32:31
08d9421dd9c291def896c78f703fec933d1c540f...f8b588808ec180c836402395afdc1303b7189abc,2,5,11,16,2,2012-09-06 11:50:01,2012-09-06 11:37:14
f8b588808ec180c836402395afdc1303b7189abc...06acc115ed8e5641932f85568c6d03dcb30c9923,2,6,9,15,2,2012-09-06 11:51:42,2012-09-06 11:51:42
06acc115ed8e5641932f85568c6d03dcb30c9923...e7c2ee57aa40e13aac987fb107794cdc3128ed8a,1,0,8,8,1,2012-09-06 12:06:01,2012-09-06 12:06:01
e7c2ee57aa40e13aac987fb107794cdc3128ed8a...88d394d396f09fe018317443105cd08bd69e1d3f,1,12,13,25,5,2012-09-06 12:44:44,2012-09-06 12:44:44
88d394d396f09fe018317443105cd08bd69e1d3f...66684d6d50e9d8e0ae31db9df6b5bd7626db74ef,2,130,131,261,2,2012-09-06 12:47:13,2012-09-06 12:47:13
e4447de23fa41fd67db31e3ca97dbee7349a026c...b3c8688da33ac2fd79d733fc9992a526c18c2c40,1,14,15,29,11,2012-09-06 06:56:46,2012-08-30 14:51:09
dea86281714336799fb432833a0ca517b509abaa...a87fccc0834aa816289669a0fc7744338e469745,3,45,1,46,6,2012-12-24 18:02:08,2012-12-24 18:01:49
a87fccc0834aa816289669a0fc7744338e469745...4ba24596d31dad64b761cd44d47779f48bf25e28,7,64,18,82,16,2012-12-24 19:18:23,2012-12-24 19:18:23
4ba24596d31dad64b761cd44d47779f48bf25e28...841974077844fe27ae06c59263b75dcf80843975,1,1,1,2,1,2012-12-24 19:24:53,2012-12-24 19:24:53
841974077844fe27ae06c59263b75dcf80843975...0dbb369aced2b445805255b6ce6c003f8bec619a,1,24,299,323,8,2012-12-24 19:25:33,2012-12-24 19:25:33
0dbb369aced2b445805255b6ce6c003f8bec619a...6570843f84674ebba7ff84bc2983c077879ca830,1,1,1,2,1,2012-12-24 19:27:12,2012-12-24 19:27:12
6570843f84674ebba7ff84bc2983c077879ca830...49e73f8ac1f9b9dabc900a56e98a1cc83b40dc49,1,1,1,2,1,2012-12-24 19:29:53,2012-12-24 19:29:53
fa325ce97796a1ae25d64a4ec63bdad6599e98d7...63fe042d97a5430770ec50fc0e8f29c416bd2ec9,3,7,2,9,3,2012-10-09 17:39:06,2012-10-09 17:39:06
63fe042d97a5430770ec50fc0e8f29c416bd2ec9...679d0d6d760b850e27c13f3ce0f812b8b081df7f,15,100,83,183,35,2012-10-09 19:09:46,2012-10-09 19:09:46
a1ffc673b95f4d0e2316d461f1364fa1ee08e9d2...eb1004f7890d25a86beb0ca0a7eca802d9fce665,18,127,53,180,35,2012-11-29 10:39:03,2012-11-29 04:29:11
9c2a6e201388e7e30987a8679ddfa65b9422a38c...d2cec12632079e07ff40876e7c6ecd4c21418dc3,2,52,28,80,6,2013-03-07 12:18:30,2013-03-07 12:18:30
40f18681948d4662812f342700533c1a99991927...4c1538a9465304acc22502f12199d2e2b360cb81,4,33,12,45,8,2013-03-06 15:30:48,2013-03-06 15:30:48
40f18681948d4662812f342700533c1a99991927...4db5ec281ecfa12cfe24b97c06f56f02b709c90d,1,3,3,6,3,2013-03-06 15:20:46,2013-03-06 15:20:46
3374027e3a4e4eb040e59294a9ced9d7886a71e2...ecf53bb9e616b724bafc939d5e74744e774e3fd2,3,3,8,11,5,2013-03-07 14:11:33,2013-03-07 14:11:33
89ce02ea5d299e0c50ba0f2474559cffa948eb6d...08f29c322e9a75718962ead8bf110d13cf581e0a,1,1,1,2,1,2013-03-06 19:10:01,2013-03-06 19:10:01
08f29c322e9a75718962ead8bf110d13cf581e0a...19e9c736e79088dd97f0d7b7d3d77440ed763541,1,11,0,11,2,2013-03-06 19:12:47,2013-03-06 19:12:47
19e9c736e79088dd97f0d7b7d3d77440ed763541...872cf404eb0f57472e50de63f149595bd1ad9ac8,1,1,1,2,1,2013-03-06 19:39:10,2013-03-06 19:39:10
872cf404eb0f57472e50de63f149595bd1ad9ac8...7b38a0de9878b9b0214879e9def32c285e149808,1,0,7,7,1,2013-03-06 19:48:15,2013-03-06 19:48:15
9aafe77e708174aac697a8dcafc99b90e96be36e...a605943d76216f2c5e78178c2b87ed92ff79741f,1,1,1,2,1,2012-09-20 16:11:15,2012-09-20 16:11:15
9aafe77e708174aac697a8dcafc99b90e96be36e...3dd940d4cbd72afed38eba49b557823a6a55eac2,1,3,5,8,2,2012-09-20 15:36:43,2012-09-20 15:36:43
3dd940d4cbd72afed38eba49b557823a6a55eac2...b08d33f6a9a82e04f288fc0a4de6d4a7489795e1,2,4,5,9,5,2012-09-20 15:38:08,2012-09-20 15:38:08
b08d33f6a9a82e04f288fc0a4de6d4a7489795e1...81aeac46d63cd315b6545494cfa41ae163cadc5c,1,12,0,12,2,2012-09-20 15:51:26,2012-09-20 15:51:26
3c132f2e6896c7c1aa787ddc61ae230d9a205700...9270b6c3c7cdb99eef1c99af8274dae5789d9830,6,32,10,42,10,2012-09-26 13:49:20,2012-09-26 13:49:20
b565f33472d960e37ed41a8a0c09fbbc3ea65f1e...a1ba470e4e0ec5ebbcd47755122878df6d19ad0b,3,44,0,44,5,2012-09-10 06:26:35,2012-09-10 06:26:35
a1ba470e4e0ec5ebbcd47755122878df6d19ad0b...8795f67f47880f4ac4c88b627c22f1861cda2bc0,2,21,9,30,11,2012-09-10 06:41:51,2012-09-10 06:41:51
8795f67f47880f4ac4c88b627c22f1861cda2bc0...a839cb427cc158330297fd89fbf40321d41349a4,1,2,2,4,2,2012-09-10 06:43:30,2012-09-10 06:43:30
b565f33472d960e37ed41a8a0c09fbbc3ea65f1e...d6c384c20f3798fffd0481cd758700a27bebd44f,18,22,122,144,36,2012-09-10 06:12:36,2012-09-10 06:09:55
9d9493c8d893195490fe3e1e62e7daa5e1b2e7ba...a79eb8428946152021b6f3a25398c49f2e9e7099,2,21,3,24,5,2012-09-28 13:05:54,2012-09-28 13:05:54
8f3b1d6ea4c72665e1b0ffbc554727595cbe60b0...0eb8a0398197a4a586d83e4e18e7e070f547243f,1,2,0,2,1,2012-09-07 01:01:04,2012-09-07 01:01:04
8f3b1d6ea4c72665e1b0ffbc554727595cbe60b0...34a48d55cc9763fb65c50b80e545c99350ebc6ca,1,3,3,6,1,2012-09-06 21:17:56,2012-09-06 21:17:56
34a48d55cc9763fb65c50b80e545c99350ebc6ca...8fdeb43c36767fc10a0298598fd7452fa609faee,1,4,5,9,2,2012-09-06 21:20:57,2012-09-06 21:20:57
8c1b83cffe934ded9886a85a74447c0dae6c908e...d861023cb9dc71b5943916fdd6011dab32085626,1,4,86,90,1,2012-09-06 14:52:01,2012-09-06 14:52:01
d861023cb9dc71b5943916fdd6011dab32085626...46b9aafc396278a9ce0732d9a877ca01c45dbc0e,1,1,1,2,1,2012-09-06 14:56:33,2012-09-06 14:56:33
6ddacaf9bfe02378e610ce277cd901097dcf6fdd...211c06e4191395d7c23a9a523ef232506d786ab6,3,4,2,6,4,2013-01-15 11:37:20,2013-01-15 11:37:20
211c06e4191395d7c23a9a523ef232506d786ab6...953db8477e301d6cbd9ddf560264da708cd92aba,3,12,8,20,8,2013-01-15 12:28:04,2013-01-15 12:28:04
953db8477e301d6cbd9ddf560264da708cd92aba...2191efd8ec13f32922967a78e76929b57e1617e6,1,1,1,2,1,2013-01-15 13:04:22,2013-01-15 13:04:22
2191efd8ec13f32922967a78e76929b57e1617e6...b059de2ac7ad6f47a39ca124764c8e3e661e76f9,1,2,2,4,2,2013-01-15 13:19:14,2013-01-15 13:19:14
b059de2ac7ad6f47a39ca124764c8e3e661e76f9...752eb2c11d9125d9b7b60bc7719db954ebb1d9a5,3,5,9,14,7,2013-01-15 14:36:35,2013-01-15 14:36:35
752eb2c11d9125d9b7b60bc7719db954ebb1d9a5...cf353bd34f09789ad84493c3d991827bd00ecd1e,2,13,10,23,6,2013-01-15 15:12:53,2013-01-15 15:12:53
cf353bd34f09789ad84493c3d991827bd00ecd1e...cc54c66fd0e402743ce942c19040828e07d1da2f,1,3,4,7,2,2013-01-15 16:20:58,2013-01-15 16:20:58
cc54c66fd0e402743ce942c19040828e07d1da2f...fd522b32579bb37932ab3305870c285a0201dd55,2,9,8,17,2,2013-01-15 17:18:52,2013-01-15 17:18:52
fd522b32579bb37932ab3305870c285a0201dd55...3d57755b70ea6a29316fa0789914d6b060db2979,1,6,19,25,4,2013-01-15 20:54:03,2013-01-15 20:54:03
3d57755b70ea6a29316fa0789914d6b060db2979...c9e6818ab64d7ec9219887174b613fe69791bb92,4,10,1,11,4,2013-01-16 11:30:31,2013-01-16 11:30:31
bda7fe38d0b0e39a408c4eb44374a330c24c3a49...f598cc789789bcde01e3c703d9149204247c0a46,9,54,21,75,19,2013-01-15 09:12:17,2013-01-15 09:12:17
f598cc789789bcde01e3c703d9149204247c0a46...ac983319d3dca597d9a1dcfa46f6acc6ebcfa07a,4,36,38,74,31,2013-01-15 10:42:54,2013-01-15 10:42:54
70ebcf250a067b1118b317f233574ff714841a4f...a934bafd9fcf94b2d96a9b465a051f0a329b72e7,1,1,1,2,1,2012-12-26 12:36:40,2012-12-26 12:36:40
49e73f8ac1f9b9dabc900a56e98a1cc83b40dc49...d41aac629b0a951262542570d002d33d30203725,1,1,1,2,1,2012-12-25 06:43:50,2012-12-25 06:43:50
49e73f8ac1f9b9dabc900a56e98a1cc83b40dc49...c8ba5c2d58b882fd7cd5342a42158bb5f810fd60,7,44,5,49,12,2012-12-25 03:14:05,2012-12-25 03:14:05
c8ba5c2d58b882fd7cd5342a42158bb5f810fd60...c5eba169cdcf0d66cd7c6b34dace639a08949dd9,2,128,33,161,2,2012-12-25 04:14:05,2012-12-25 04:14:05
c5eba169cdcf0d66cd7c6b34dace639a08949dd9...64db738f9de3839090eef6a862581a0e72f6540d,2,3,3,6,2,2012-12-25 13:53:50,2012-12-25 13:53:50
679d0d6d760b850e27c13f3ce0f812b8b081df7f...41afd3bf16b6ceff2b0dab24ce2eeae8056a7577,2,5,2,7,3,2012-10-09 23:58:34,2012-10-09 23:14:58
41afd3bf16b6ceff2b0dab24ce2eeae8056a7577...3e1d52f4b7accb100d8a312236f8fc8005b78a69,1,48,0,48,1,2012-10-09 23:58:34,2012-10-09 23:15:26
3e1d52f4b7accb100d8a312236f8fc8005b78a69...4eb7d82ae7b085049a889b8f4e7d421f05b39d07,1,15,0,15,1,2012-10-09 23:58:34,2012-10-09 23:31:51
4eb7d82ae7b085049a889b8f4e7d421f05b39d07...75e6eb59ecd21735c87eb53eb68d510760580b3f,1,26,0,26,1,2012-10-10 09:17:48,2012-10-09 23:41:14
75e6eb59ecd21735c87eb53eb68d510760580b3f...92ac42a27c1251304f408fdff162999d0577a340,1,40,1,41,3,2012-10-10 09:48:14,2012-10-09 23:41:33
92ac42a27c1251304f408fdff162999d0577a340...8402bca7355c95e60b9d5cfd124a839de60cd50b,1,2,0,2,2,2012-10-10 09:48:30,2012-10-09 23:41:44
679d0d6d760b850e27c13f3ce0f812b8b081df7f...77bde9a0e41e9229357983d258eaea9d7ef67017,2,12,0,12,2,2012-10-09 23:31:36,2012-10-04 21:02:37
77bde9a0e41e9229357983d258eaea9d7ef67017...6dc8c0eac28d826a4a58bcb3cdac070f3de2a10c,3,21,1,22,3,2012-10-09 23:31:36,2012-10-04 22:25:40
679d0d6d760b850e27c13f3ce0f812b8b081df7f...cda5e66d7c190e852b23caca17d90df43d91d75e,5,26,19,45,9,2012-10-09 22:38:59,2012-10-03 23:12:51
cda5e66d7c190e852b23caca17d90df43d91d75e...702133c0e2ff1e9a70263ad9c01985a6279cb2db,2,2,6,8,3,2012-10-09 22:39:03,2012-10-09 22:33:22
679d0d6d760b850e27c13f3ce0f812b8b081df7f...682f62fd4addb38843a9047b9ac47eb5ba94a30e,3,4,4,8,4,2012-10-09 21:06:33,2012-10-09 21:06:33
682f62fd4addb38843a9047b9ac47eb5ba94a30e...eb92813757d8ec14819ddbab6efae7e7cdd403e6,3,6,16,22,3,2012-10-09 22:53:42,2012-10-09 22:53:42
eb92813757d8ec14819ddbab6efae7e7cdd403e6...e4aa5a5c8f9d8a4b556aeba003160017821ed9a3,4,76,46,122,4,2012-10-09 22:53:55,2012-10-09 22:16:52
e4aa5a5c8f9d8a4b556aeba003160017821ed9a3...4d843d2ce1e12525637e2a578896686a4efb9a55,2,3,0,3,3,2012-10-09 22:53:57,2012-10-09 21:54:14
eb1004f7890d25a86beb0ca0a7eca802d9fce665...755e4a470015ad83337943d62a32ede2921eda53,4,104,92,196,7,2012-11-29 11:18:44,2012-11-23 16:26:26
755e4a470015ad83337943d62a32ede2921eda53...84de1b71d1547cc92e0f22a5e00b1f8e90f35a67,26,502,502,1004,301,2012-11-29 11:18:44,2012-11-23 16:33:43
84de1b71d1547cc92e0f22a5e00b1f8e90f35a67...b825582eb16d7983798f3a35746a8352675d3f23,26,240,268,508,183,2012-11-29 11:18:44,2012-11-23 16:51:38
b825582eb16d7983798f3a35746a8352675d3f23...238c214ac9041da65437862115fe772f2d0ea7f3,2,19,12,31,4,2012-11-29 11:18:44,2012-11-24 09:57:22
238c214ac9041da65437862115fe772f2d0ea7f3...81175073a0604633bfec08b95c1ed19d054b48b5,5,13,24,37,11,2012-11-29 11:18:44,2012-11-25 17:30:18
81175073a0604633bfec08b95c1ed19d054b48b5...df0bd0c212a76ed6ce4e0e90b8101a9a164c34fa,3,4,8,12,7,2012-11-29 11:18:44,2012-11-25 18:25:33
df0bd0c212a76ed6ce4e0e90b8101a9a164c34fa...d7e9eda24d26dfe5782e503f3e3d7d523000ce05,6,9,10,19,10,2012-11-29 11:18:44,2012-11-25 19:03:14
d7e9eda24d26dfe5782e503f3e3d7d523000ce05...0f31392712eb17ea95a63f9285359ac11f880855,5,21,19,40,8,2012-11-29 11:18:44,2012-11-27 23:30:26
0f31392712eb17ea95a63f9285359ac11f880855...1481bae55913593145cd594c451cd60194e93d0a,1,4,2,6,2,2012-11-29 14:37:28,2012-11-29 14:37:28
eb1004f7890d25a86beb0ca0a7eca802d9fce665...ff9a2e2a9399bf1d190de7fab2d1d26b70433b19,4,16,8,24,6,2012-11-29 04:49:11,2012-11-29 04:49:11
a7055be1fdecc51afc4e8f0e94267fcd9d9ef0c1...7fb2999c60599d5fe1d3e3fd679a894b27a882b7,1,1,0,1,1,2013-03-08 09:37:00,2013-03-08 09:37:00
ecf53bb9e616b724bafc939d5e74744e774e3fd2...32f1eaaf0f966ccc45635693679bcc8658e71815,3,36,12,48,13,2013-03-07 16:56:11,2013-03-07 16:56:11
7b38a0de9878b9b0214879e9def32c285e149808...67a61c80d161582aefae82a6784356c910940751,3,7,7,14,5,2013-03-06 21:06:12,2013-03-06 21:06:12
7b38a0de9878b9b0214879e9def32c285e149808...9dc46eee8ed31f3955f5a94731ab72e97797523a,4,35,2,37,6,2013-03-06 20:56:48,2013-03-06 20:56:48
a839cb427cc158330297fd89fbf40321d41349a4...decb3abf18314877c7f4fe9241d46936ebe53205,2,11,0,11,5,2012-09-10 07:42:36,2012-09-10 07:42:36
decb3abf18314877c7f4fe9241d46936ebe53205...9f25657ad9b48dab20188bfa51aacbe2e83689e5,1,7,57,64,3,2012-09-10 07:52:43,2012-09-10 07:52:43
9f25657ad9b48dab20188bfa51aacbe2e83689e5...bb75052a904c24d1484fa6ec0ad96839effb8ee3,13,0,721,721,13,2012-09-10 07:53:15,2012-09-10 07:53:15
bb75052a904c24d1484fa6ec0ad96839effb8ee3...d74f54736b8aabb3885648c44d7e253209b8e9e1,9,205,17,222,16,2012-09-10 09:20:12,2012-09-10 08:51:02
d74f54736b8aabb3885648c44d7e253209b8e9e1...7aeb92b8e4bb279346d9dcec7bbca1725cec8eb1,4,114,10,124,5,2012-09-10 09:40:51,2012-09-10 09:40:51
7aeb92b8e4bb279346d9dcec7bbca1725cec8eb1...080bd12e167dceb3274bb488b7be787379d126b4,24,178,20,198,17,2012-09-10 11:27:11,2012-09-10 11:27:11
080bd12e167dceb3274bb488b7be787379d126b4...698500dd786cc931cabeb0f44087c0cd11bd0131,11,345,26,371,23,2012-09-10 12:34:01,2012-09-10 12:34:01
698500dd786cc931cabeb0f44087c0cd11bd0131...b58155113b46690d9390597f9f1feccf44b00989,16,357,24,381,29,2012-09-10 13:35:23,2012-09-10 13:35:23
b58155113b46690d9390597f9f1feccf44b00989...ae9689f8ffdf8a69bd803021d1f57a37aba06e0d,7,3,105,108,13,2012-09-10 13:40:57,2012-09-10 13:40:57
ae9689f8ffdf8a69bd803021d1f57a37aba06e0d...ef4e9c24d3dc870eb194591522dda6ec8dde7192,3,11,10,21,6,2012-09-10 13:43:49,2012-09-10 13:43:49
ef4e9c24d3dc870eb194591522dda6ec8dde7192...79eb5ab396690c613ea6e13c3c941ba1fa80f217,34,270,376,646,71,2012-09-10 15:35:03,2012-09-10 15:35:03
a839cb427cc158330297fd89fbf40321d41349a4...915dac0055cd801c080ebcd37749f4fc6d2d12c4,4,34,13,47,14,2012-09-10 07:41:46,2012-09-10 07:41:46
915dac0055cd801c080ebcd37749f4fc6d2d12c4...a065557208d6076ec869144346e06c7de714389c,2,9,5,14,5,2012-09-10 10:49:00,2012-09-10 10:49:00
a839cb427cc158330297fd89fbf40321d41349a4...e7f483f9f4dffbd675b7fc41b5c2cfd8c7309e0d,1,1,1,2,1,2012-09-10 08:50:07,2012-09-10 08:50:07
5604613025a9fa247144b6ae0f12e3649ef04bda...333f7372c505583ddafa9f22bd93205f7ad3dbc7,1,1,1,2,1,2012-11-19 10:44:28,2012-11-19 10:44:28
5604613025a9fa247144b6ae0f12e3649ef04bda...8d171a8cbcec2748b583b75b2e304634e0ecd348,2,3,1,4,2,2012-09-10 12:40:35,2012-09-10 12:40:35
8d171a8cbcec2748b583b75b2e304634e0ecd348...7e2846fb57ef24dfac0de57f7b086a7415cc44e7,2,2,2,4,2,2012-09-10 15:32:31,2012-09-10 15:32:31
a79eb8428946152021b6f3a25398c49f2e9e7099...236fd1e63bf0fbb4f7880ee3bc975ac89f4d3e99,2,0,4,4,1,2012-09-29 11:06:53,2012-09-29 11:01:13
a79eb8428946152021b6f3a25398c49f2e9e7099...b17bbb238db328b77d8a39479f8a500e54a4bebf,1,3,3,6,2,2012-09-28 23:36:06,2012-09-28 23:36:06
a79eb8428946152021b6f3a25398c49f2e9e7099...93cb01ea9b620762c1641b585de153a686067d4d,1,3,2,5,1,2012-09-28 14:08:13,2012-09-28 14:00:04
46b9aafc396278a9ce0732d9a877ca01c45dbc0e...a87c268f7d3b083534a76065040aa78744c46862,3,50,81,131,13,2012-09-12 12:01:50,2012-09-12 12:01:50
a87c268f7d3b083534a76065040aa78744c46862...b6f249dc1f4b1867f8f16a23b30f65f4be8e7fd7,3,18,12,30,6,2012-09-12 12:11:56,2012-09-12 12:11:56
c4536ae587f67db89ab8310a1b16eed269b4d8df...17ea019f4e43b4fb394544f9d86ab3016f54d28e,2,7,1,8,2,2012-12-26 15:52:15,2012-12-25 22:50:41
17ea019f4e43b4fb394544f9d86ab3016f54d28e...9c574464a6051536ee83a93e8270a7dd9d85da33,7,103,16,119,16,2012-12-26 15:52:15,2012-12-25 22:52:20
9c574464a6051536ee83a93e8270a7dd9d85da33...25c57637807bac79037c4d791979951bf13ed056,7,59,1,60,8,2012-12-26 15:52:15,2012-12-25 22:52:49
25c57637807bac79037c4d791979951bf13ed056...2753cea75a89ef461a1df1c82c09d093ec0bc1bb,1,3,3,6,2,2012-12-26 15:52:15,2012-12-25 23:05:38
2753cea75a89ef461a1df1c82c09d093ec0bc1bb...1e3d238910fedb4c7de15a4c2f3537f0243059e4,3,7,7,14,3,2012-12-26 15:52:15,2012-12-26 10:17:53
1e3d238910fedb4c7de15a4c2f3537f0243059e4...634783feb0131794eb1ed797a8c70e1674f9ba9e,2,2,2,4,2,2012-12-26 15:52:16,2012-12-26 10:22:12
634783feb0131794eb1ed797a8c70e1674f9ba9e...39e7a0eafe52ba8855baa3df1d609c27b2984852,1,3,1,4,1,2012-12-26 15:52:16,2012-12-26 11:15:28
39e7a0eafe52ba8855baa3df1d609c27b2984852...98044f0f143552943b8afad0c8133f236a857adb,3,8,6,14,3,2012-12-26 16:30:11,2012-12-26 16:30:11
98044f0f143552943b8afad0c8133f236a857adb...c8bf5905bf92d2da7d408eee6364dc6e99a17b02,2,2,2,4,2,2012-12-26 16:31:18,2012-12-26 16:31:18
c8bf5905bf92d2da7d408eee6364dc6e99a17b02...655b836b2ac26e7afabeb7faaabb56cf106348d7,2,4,6,10,5,2012-12-26 16:31:47,2012-12-26 16:31:47
64db738f9de3839090eef6a862581a0e72f6540d...3c1022f9b118f004c421f212e55acbe1d4ff3954,3,17,13,30,9,2012-12-25 14:18:22,2012-12-25 14:18:22
3c1022f9b118f004c421f212e55acbe1d4ff3954...4c800342afbd3077e863132006baf19a1d30069a,1,9,8,17,2,2012-12-25 14:24:44,2012-12-25 14:24:44
64db738f9de3839090eef6a862581a0e72f6540d...1be3941f7df3125eb8c11bd200586e4855031a36,1,1,1,2,1,2012-12-25 14:04:58,2012-12-25 14:04:58
dda852a0d5c9e684b82cf20380d2b26da1798ecb...3f72af9994554c66a51cdfb4302e48da0edd043a,4,16,2,18,5,2012-10-10 10:06:30,2012-10-10 10:06:30
3f72af9994554c66a51cdfb4302e48da0edd043a...fb0279f3113f58b1cbdbe04acabe874ac4d231f9,3,15,16,31,4,2012-10-10 10:09:45,2012-10-10 10:09:45
fb0279f3113f58b1cbdbe04acabe874ac4d231f9...81ee69381d9e01997a204b89cdeabf9854138967,3,17,1,18,3,2012-10-10 10:14:48,2012-10-10 10:14:48
83f2a387d68ca055e83ed2cfb61cc329e0bda2d1...9df6f7bfad0b18ddaa9fdda2506a8c8958224a7e,4,26,16,42,10,2012-11-29 15:17:01,2012-11-29 15:17:01
9df6f7bfad0b18ddaa9fdda2506a8c8958224a7e...08fded3fac00b2628e167c21541379784e9d2fa0,8,18,5,23,9,2012-11-29 16:09:27,2012-11-29 16:09:27
08fded3fac00b2628e167c21541379784e9d2fa0...aaa1c94239df831d10489d686d8883b49d601f43,5,66,15,81,5,2012-11-29 17:14:05,2012-11-29 17:14:05
ff9a2e2a9399bf1d190de7fab2d1d26b70433b19...c954f2d98221eadd288b9a4a13c7ca06b92ec9a2,1,2,2,4,1,2012-11-29 15:39:30,2012-11-29 15:38:06
ff9a2e2a9399bf1d190de7fab2d1d26b70433b19...1d889a79fb85a39bf240444b1beaa23efec035c3,4,15,7,22,5,2012-11-29 14:43:09,2012-11-29 14:43:09
bc15713569ece82f368789768ebeaa392f378264...9c709be335d3023dacb7c1140fcd15478c14a307,1,4,4,8,2,2013-03-08 11:14:47,2013-03-08 11:14:47
9c709be335d3023dacb7c1140fcd15478c14a307...8e8372d5ce75713aa1452d7c818724dcbca72e53,5,4,2,6,2,2013-03-09 22:12:25,2013-03-09 22:12:25
9dc46eee8ed31f3955f5a94731ab72e97797523a...2f7f46b25655aa6f2c2a7756663c97ddb4491100,5,39,38,77,9,2013-03-07 06:19:32,2013-03-06 11:31:28
2f7f46b25655aa6f2c2a7756663c97ddb4491100...784aa266bdd38ec560c11bea92fc9b815e2ca456,3,7,5,12,4,2013-03-07 06:19:42,2013-03-06 12:01:40
784aa266bdd38ec560c11bea92fc9b815e2ca456...e03a018d28488260eb6c69741680691426f823a6,5,13,13,26,9,2013-03-07 06:42:30,2013-03-07 06:42:30
e03a018d28488260eb6c69741680691426f823a6...8c5003cf75bf48faf88d7148a241c9e89f623c97,2,20,27,47,10,2013-03-07 08:56:01,2013-03-07 08:56:01
8c5003cf75bf48faf88d7148a241c9e89f623c97...ccc712b1983f49216fc85deb61a7e5efd7790936,1,31,21,52,16,2013-03-07 10:16:51,2013-03-07 10:16:51
ccc712b1983f49216fc85deb61a7e5efd7790936...79cd1ca3043822d5f763b8a1900fd2bea52b0ff0,1,31,34,65,23,2013-03-07 10:52:46,2013-03-07 10:52:46
79cd1ca3043822d5f763b8a1900fd2bea52b0ff0...b7e5f4556ba845cf228eb8cb70f437e2f6792c69,3,40,48,88,11,2013-03-07 12:10:27,2013-03-07 11:36:40
b7e5f4556ba845cf228eb8cb70f437e2f6792c69...c0d312bebe8ba68b842788e4715c5c8a1612bb29,1,47,49,96,4,2013-03-07 12:10:40,2013-03-07 11:47:04
9dc46eee8ed31f3955f5a94731ab72e97797523a...3d662e5ccfc5555e27773e7a7463ddffc1b678da,1,18,11,29,11,2013-03-07 01:06:56,2013-03-07 01:06:56
49fe8fed11d5a8b73e15b507b214ea10b61524a5...25b745271a1db25fc709ae13737b04c1f94cdb95,4,139,78,217,43,2012-09-21 10:23:17,2012-09-21 10:23:17
49fe8fed11d5a8b73e15b507b214ea10b61524a5...4cc169d3cacea7e4325bb5632cc8878a7c3f41fe,4,33,16,49,16,2012-09-21 08:22:53,2012-09-21 08:22:53
4cc169d3cacea7e4325bb5632cc8878a7c3f41fe...10d3a30b255cd85b2cf7af39814fd7418eecd838,10,199,79,278,31,2012-09-21 10:22:30,2012-09-21 10:22:30
3f01ec2d5b7421f05192fc78974a7ff4ba8c8daf...a2f7f48c034bc32fe626980ed88f8789b19b36bd,1,1,1,2,1,2012-09-10 16:50:35,2012-09-10 16:50:35
38c2cfb9adfb57cc23d6a9664f92a5e127a2371f...52d29f5d5996fd5e5bcd203b5e352afee00f74aa,3,20,9,29,10,2012-09-10 06:14:37,2012-09-10 06:13:45
1c08cb404d5e874ae7d79a540e493bbf1f0d3061...5a9071264576e672da998d6d346bc5200ae91153,1,6,5,11,1,2012-09-11 12:35:16,2012-09-11 12:35:16
1c08cb404d5e874ae7d79a540e493bbf1f0d3061...96d4f22e53a6176715f9557fb0707cb166a1dd80,3,4,3,7,3,2012-09-11 11:18:14,2012-09-11 11:18:14
3bcc39b4d3830916ac9af653c397557a7e100ef6...f5a62835bb43a3cae325337b84813225b67e7651,1,1,1,2,1,2012-09-30 10:07:45,2012-09-30 10:07:45
3bcc39b4d3830916ac9af653c397557a7e100ef6...c2303737bacb1053dfbf87bc1a3c4639a52f36f9,1,1,1,2,1,2012-09-29 22:53:04,2012-09-29 22:53:04
c2303737bacb1053dfbf87bc1a3c4639a52f36f9...6135eeaa3e635f53d48297281ed0466622b77161,1,4,1,5,2,2012-09-29 22:53:21,2012-09-29 22:53:21
6135eeaa3e635f53d48297281ed0466622b77161...2022ae69df130542fe2a6ffe51c106e2942c884d,2,2,2,4,2,2012-09-30 13:04:43,2012-09-30 13:04:43
dae56806df563573aa2c5e2be00be57fb12f12d7...e56a47ab19a6d161732a75e19f385b1df4e4821f,1,10,0,10,1,2012-12-27 10:13:18,2012-12-27 10:13:18
e56a47ab19a6d161732a75e19f385b1df4e4821f...4cbb29cfadb243733185cdfaefe34e15dee35260,13,105,59,164,32,2012-12-27 03:14:05,2012-12-27 03:14:05
3de4271846496fae3b16c316252816dca3f3c354...1f3bdd453e8dfb81b97166ede481685d85ea04c6,2,2,2,4,2,2012-12-28 07:29:57,2012-12-28 07:29:57
4c800342afbd3077e863132006baf19a1d30069a...103bb239e52614baf894876d0c40870244f2c377,1,0,4,4,1,2012-12-25 23:29:28,2012-12-25 23:29:28
4c800342afbd3077e863132006baf19a1d30069a...9ff1ec7d8e729d636b838f89c252ffd41bcd90e0,2,9,0,9,3,2012-12-25 22:42:53,2012-12-25 22:42:53
4c800342afbd3077e863132006baf19a1d30069a...a1434ff50b7cc86e1e1a2863366e235da0f77cd7,1,16,0,16,1,2012-12-25 22:14:00,2012-12-25 22:14:00
4a535e17c93dbe0ed8c309633064db6bd27e4061...b2f57409931ddd9bf059e992bc255da93a8192b5,1,50,48,98,12,2012-10-10 12:45:19,2012-10-10 12:45:19
b2f57409931ddd9bf059e992bc255da93a8192b5...2b7fd29b1abb3ab6ca5ece7fe2b093f6672796d6,1,6,0,6,1,2012-10-10 14:17:23,2012-10-10 14:17:23
aaa1c94239df831d10489d686d8883b49d601f43...01eab583d0d16b44554a9790fb502f14ea84faf0,4,94,1,95,5,2012-11-29 20:11:00,2012-11-27 19:43:39
01eab583d0d16b44554a9790fb502f14ea84faf0...9a4974b7603c4df4b9b78970fb96e185ba97c250,1,2,1,3,1,2012-11-29 20:11:00,2012-11-29 19:21:14
9a4974b7603c4df4b9b78970fb96e185ba97c250...1c5aa848ce6141b8679e167171096055dc7f4df3,2,35,2,37,4,2012-11-29 20:11:00,2012-11-29 19:33:41
1c5aa848ce6141b8679e167171096055dc7f4df3...c946bf886c2c07491a4595e93861df02dbf809f4,2,42,0,42,2,2012-11-29 20:11:00,2012-11-29 20:06:24
c946bf886c2c07491a4595e93861df02dbf809f4...961cb285b08aed0281bc9a6e4634388ecc8e914c,2,20,15,35,16,2012-11-29 20:11:01,2012-11-29 20:10:07
961cb285b08aed0281bc9a6e4634388ecc8e914c...658f260e9835800901462e5a5de350ee84fefe8d,2,132,0,132,3,2012-11-29 20:32:05,2012-11-29 20:32:05
658f260e9835800901462e5a5de350ee84fefe8d...24047e1e8dca4baf58e1533e3e7fcfa1e16d159e,1,5,2,7,3,2012-11-29 20:35:16,2012-11-29 20:35:16
a03f318964bc5ffa8ef6d10fdc466cef84ecfe46...c38b9a2f80111f8074f8e6ce36e63d68f519c581,5,46,0,46,5,2012-11-30 11:40:34,2012-11-30 03:14:05
c38b9a2f80111f8074f8e6ce36e63d68f519c581...3c13ef648ba6b8f6c31028c3072e22106f1baf62,1,0,8,8,1,2012-11-30 14:03:10,2012-11-30 14:03:10
3c13ef648ba6b8f6c31028c3072e22106f1baf62...8bf340f568b28e2dc8db050e23fcdfef7643e5be,2,2,2,4,2,2012-11-30 14:47:04,2012-11-30 14:47:04
8bf340f568b28e2dc8db050e23fcdfef7643e5be...eb3e07a509d360922ff52c3634be7770104b0994,13,96,79,175,23,2012-11-30 16:26:17,2012-11-30 16:26:17
eb3e07a509d360922ff52c3634be7770104b0994...c19e766f1edd927b911187052c859b1f1af76eee,2,1,4,5,2,2012-11-30 17:49:51,2012-11-30 17:49:51
8e8372d5ce75713aa1452d7c818724dcbca72e53...ea9b3687db46bf876a6f966e61bfddc1e6d25ef3,21,888,87,975,52,2013-03-10 00:39:51,2013-03-04 03:43:52
ea9b3687db46bf876a6f966e61bfddc1e6d25ef3...1479f1722702c955ed3ee9456107c6a1a7277c7b,5,102,10,112,9,2013-03-10 21:59:20,2013-03-10 21:37:26
1479f1722702c955ed3ee9456107c6a1a7277c7b...f0aa54e0fbce27600aa02a1ee5465e2ab5c18ccc,3,237,0,237,3,2013-03-11 02:10:44,2013-03-11 02:10:44
f0aa54e0fbce27600aa02a1ee5465e2ab5c18ccc...7665b1de7eed4addd7b94786c84e6674710e6377,3,33,1,34,3,2013-03-14 06:31:08,2013-03-14 06:31:08
7665b1de7eed4addd7b94786c84e6674710e6377...6d25484417b14776739eff91e6fa009b2b989cd7,1,1,8,9,1,2013-03-14 06:34:50,2013-03-14 06:34:50
6d25484417b14776739eff91e6fa009b2b989cd7...d69a37e0b7163f5a03fcc58fdb6ec0ed1eb20862,1,2,2,4,1,2013-03-14 07:07:01,2013-03-14 07:07:01
a29c883b5b41a2340207a939cd4b32a0c2fe03ca...11b57d979c42008cabaa49a60b52c1523133b5a8,2,5,1,6,2,2013-03-11 12:35:00,2013-03-11 12:35:00
11b57d979c42008cabaa49a60b52c1523133b5a8...dc3590d61965e128d49f3525a7afe7311e45d580,1,1,1,2,1,2013-03-11 13:47:44,2013-03-11 13:47:44
a29c883b5b41a2340207a939cd4b32a0c2fe03ca...b8f070f0d17f20240376e48aa8dcad23c1d23ece,1,0,0,0,0,2013-03-11 12:32:44,2013-03-11 07:40:58
b8f070f0d17f20240376e48aa8dcad23c1d23ece...197f9abedfd689ba46bd12fa219e43f30996e23a,1,254,379,633,20,2013-03-11 12:41:24,2013-03-11 08:52:27
96c627edd8ed3a74a28200d77d3fc42abe9fb19b...8812d9dee2340ba33d1272ed6ea0736c8eb371d0,5,44,10,54,9,2013-03-10 09:57:14,2013-03-10 09:57:14
8812d9dee2340ba33d1272ed6ea0736c8eb371d0...473efc82b68dcaac61be55466e423fdbbabde710,10,51,29,80,11,2013-03-10 10:16:57,2013-03-10 10:16:57
473efc82b68dcaac61be55466e423fdbbabde710...96fbef60f962e57da5da2d3603e48fadfe959062,5,20,0,20,7,2013-03-10 18:26:27,2013-03-10 18:26:27
96fbef60f962e57da5da2d3603e48fadfe959062...269a9859488e184768ca7d99e562b93b414f87d6,2,3,2,5,2,2013-03-10 18:29:34,2013-03-10 18:29:34
131553627d2e62cea2ea8a342250ca2d2495d8fc...4a072be2d775d5ce59573cfb447ddab940854d54,8,77,102,179,9,2012-09-21 11:34:07,2012-09-21 11:34:07
4a072be2d775d5ce59573cfb447ddab940854d54...b62445813dffec92e85540ed081e4d6e12d58dc0,8,195,212,407,9,2012-09-21 11:49:28,2012-09-21 11:49:28
b62445813dffec92e85540ed081e4d6e12d58dc0...1bae64d7f608e3d68d52fd59755216db6c70f7f4,1,4,0,4,4,2012-09-21 11:53:13,2012-09-21 11:53:13
1bae64d7f608e3d68d52fd59755216db6c70f7f4...130433158981bd4f95121060d75d8fb56c14f80d,1,0,11,11,2,2012-09-21 12:00:20,2012-09-21 12:00:20
130433158981bd4f95121060d75d8fb56c14f80d...4162566e11d9239d82b532e34c503ad1cbfe4d78,3,177,166,343,4,2012-09-21 12:03:50,2012-09-21 12:03:50
4162566e11d9239d82b532e34c503ad1cbfe4d78...bbdb2c3fef5a71802131c08226d7f4dfa18ddd89,1,1,1,2,2,2012-09-21 12:06:36,2012-09-21 12:06:36
52d29f5d5996fd5e5bcd203b5e352afee00f74aa...a3d22297dcd7b547412cf0284a27ef11f90c20ad,1,1,1,2,1,2012-09-10 11:40:20,2012-09-10 11:35:09
4903910390dc746f484d6c1206b00fa17007a665...0523b4265bb19bfff15c6a435dd52ffd6a5683f8,10,86,20,106,17,2012-09-11 20:24:53,2012-09-11 20:24:53
0523b4265bb19bfff15c6a435dd52ffd6a5683f8...d8f6d38d39868426902ffbad9c232b7748a4288f,1,6,1,7,2,2012-09-12 06:05:12,2012-09-12 06:05:12
5c8177ea6a445d8f63840ae62d6f1d3666f5cc2c...433387be358c4307e25f59c8afeb17b4514b35cc,1,0,1,1,1,2012-10-01 12:33:25,2012-10-01 12:33:25
433387be358c4307e25f59c8afeb17b4514b35cc...663dd6fad6e0a992f7ba1ccff4e58de84463abe6,11,43,54,97,16,2012-10-01 13:39:19,2012-10-01 13:39:19
663dd6fad6e0a992f7ba1ccff4e58de84463abe6...69751aac32f505a87a40af638dbf14f69f85315e,5,42,30,72,8,2012-10-01 13:58:13,2012-10-01 13:58:13
69751aac32f505a87a40af638dbf14f69f85315e...b82cb2630c2b2b3fbbda542602eb9383a520778a,4,12,23,35,9,2012-10-02 07:26:24,2012-10-02 07:26:24
b82cb2630c2b2b3fbbda542602eb9383a520778a...025d5e68c879dfbeafd5eec00946e4707abf0900,1,4,4,8,2,2012-10-02 09:27:21,2012-10-02 09:27:21
025d5e68c879dfbeafd5eec00946e4707abf0900...0187ae4e8689f0fc2fd399b65973792395534853,1,2,2,4,2,2012-10-02 09:32:59,2012-10-02 09:32:59
d991ce636b9cda08b50fa216751de0234d36f774...d03964d6ec4351be76ec978fc0481f24c3b623ec,3,71,22,93,16,2012-12-28 03:14:05,2012-12-28 03:14:05
d03964d6ec4351be76ec978fc0481f24c3b623ec...e9394c48ca7aacd9d151519c1da51d18a21b351b,1,8,3,11,2,2012-12-28 03:24:05,2012-12-28 03:24:05
3b1519da477dd0fd4264d180b35109e8ec904e33...5cd823847b37c66d521545180c81d9a92ca0ab57,3,29,14,43,4,2012-12-26 09:23:43,2012-12-26 09:18:38
2b7fd29b1abb3ab6ca5ece7fe2b093f6672796d6...16ceae895e32c2474de04c42307d914bf9a4c304,11,445,102,547,13,2012-10-10 21:59:25,2012-10-09 22:25:29
16ceae895e32c2474de04c42307d914bf9a4c304...d32a5d7eef9e06629e849fb8adbab7a9d584814f,1,5,5,10,2,2012-10-11 15:05:13,2012-10-11 15:05:13
2b7fd29b1abb3ab6ca5ece7fe2b093f6672796d6...ace816354fb098118539640b5d9af392da349396,4,19,5,24,7,2012-10-10 16:43:59,2012-09-04 08:13:56
ace816354fb098118539640b5d9af392da349396...ce6e5f34d59bf6925170584a6579fb4478cd6e50,1,2,2,4,1,2012-10-10 16:43:59,2012-09-04 08:18:30
ce6e5f34d59bf6925170584a6579fb4478cd6e50...7d145adf35b53fae3a512d433f23ee911b4f5d39,2,4,4,8,3,2012-10-10 17:06:34,2012-10-10 17:06:34
7d145adf35b53fae3a512d433f23ee911b4f5d39...bf1554f8c49d8243abadaf0078fbecf3ebdfaf93,2,30,0,30,2,2012-10-10 17:08:36,2012-10-10 17:06:54
2d17d6f1bc4ddfeb001dacbc427fa3dc9af694e4...eb061b9b061a51d5a5610763f94f68a7ef72423a,1,1,1,2,1,2012-11-29 22:26:18,2012-11-29 22:26:18
24047e1e8dca4baf58e1533e3e7fcfa1e16d159e...2a98a060caccd82ec8cd9bcead886142f766c069,2,2,3,5,2,2012-11-29 22:41:24,2012-11-29 22:41:24
2a98a060caccd82ec8cd9bcead886142f766c069...ee6187bd554f6f257600a67f65f8af95cf9afa9a,4,45,3,48,4,2012-11-29 23:52:56,2012-11-29 23:52:56
71ab011a1711db9a1a9ced2c2c92c8427ae6f624...94f04939990400c60be3d345d69d42d0f05e8355,2,1,13,14,2,2013-03-15 15:21:01,2013-03-15 15:21:01
7367f1cfd8f3cd134a0de4d9121c67ec8fd1f477...072883fd08d2c15498ef12f96090ec14529a0bbc,1,1,0,1,1,2013-03-12 09:26:45,2013-03-12 09:26:45
072883fd08d2c15498ef12f96090ec14529a0bbc...23f8f13ea442cc878a2a4fc61b7ff9f492517c27,2,2,2,4,2,2013-03-12 09:41:23,2013-03-12 09:33:27
23f8f13ea442cc878a2a4fc61b7ff9f492517c27...804ae05c58984badf9041509fb01e950d02a71e1,2,27,1,28,3,2013-03-12 09:41:23,2013-03-12 09:40:54
804ae05c58984badf9041509fb01e950d02a71e1...fce22dfa2fe8dd0f551f0a24dae4a52d4096c6f1,3,9,7,16,4,2013-03-12 11:15:14,2013-03-12 11:15:14
7367f1cfd8f3cd134a0de4d9121c67ec8fd1f477...b1e425511fd9f79da5289f1651bb8e9397b384f5,14,108,266,374,15,2013-03-12 08:46:04,2013-03-12 08:46:04
b1e425511fd9f79da5289f1651bb8e9397b384f5...59b36f203274bedf6d455968d49af8fdba5e40ef,6,71,125,196,9,2013-03-12 10:37:53,2013-03-12 10:37:53
59b36f203274bedf6d455968d49af8fdba5e40ef...102695530b673a8cdb4b618ab63f871a0d462f64,1,1,1,2,1,2013-03-12 10:40:49,2013-03-12 10:40:49
102695530b673a8cdb4b618ab63f871a0d462f64...147b93ee3edc60d6abbe10631ba89b607ec3ea48,1,10,0,10,2,2013-03-12 10:53:07,2013-03-12 10:53:07
4afb7b7cb7b42688bea70298c80b4735f59dab22...80bcba4ee25b34052c920d2c8ff58f7a72b44852,4,5,0,5,5,2012-09-23 15:53:48,2012-09-23 15:53:48
80bcba4ee25b34052c920d2c8ff58f7a72b44852...9c75fcbef16e68dd3898545fc5d11b1261de1a26,1,5,0,5,1,2012-09-23 16:52:01,2012-09-23 16:52:01
4afb7b7cb7b42688bea70298c80b4735f59dab22...ad3eefdcb8cf08007c45876afea20109b5984876,2,2,2,4,2,2012-09-22 21:06:30,2012-09-22 21:06:19
4afb7b7cb7b42688bea70298c80b4735f59dab22...2cd0caaf7300d18a565cfe304997b42bca12a947,1,0,0,0,0,2012-09-22 15:20:04,2012-09-22 15:20:04
2cd0caaf7300d18a565cfe304997b42bca12a947...6ddbee5d89b3ea0e5d2a8f2b72416dcb7ab39fe5,4,30,23,53,5,2012-09-22 15:26:22,2012-09-22 15:23:12
4afb7b7cb7b42688bea70298c80b4735f59dab22...6424fc715b14880448407b457215124b9dbde59c,1,1,1,2,1,2012-09-21 19:02:59,2012-09-21 19:02:59
0187ae4e8689f0fc2fd399b65973792395534853...825081174aa70b5cbfe5947ebf268f14702b6211,2,30,0,30,3,2012-10-02 09:46:01,2012-10-02 09:46:01
825081174aa70b5cbfe5947ebf268f14702b6211...705e9f402ed4601e502e51b46a181e3701490321,1,21,0,21,1,2012-10-02 09:52:13,2012-10-02 09:52:13
705e9f402ed4601e502e51b46a181e3701490321...bda0a75581d29cd0afb74a8a34ca69e75ab1c352,1,21,0,21,2,2012-10-02 10:59:22,2012-10-02 10:59:22
13978f33d8469424318139921f316416eccc1b00...a39c910619a70e63c547bf480f4c913d0205e74b,2,25,0,25,2,2013-01-16 14:17:21,2013-01-16 14:17:21
e9394c48ca7aacd9d151519c1da51d18a21b351b...32be082055be3eea8fd543d302ff71d48ce9a426,1,1,1,2,1,2012-12-28 18:56:48,2012-12-28 18:56:48
e9394c48ca7aacd9d151519c1da51d18a21b351b...21e55ca318bb829399c85b10e678b596d6fd414e,7,16,7,23,8,2012-12-28 18:11:28,2012-12-28 18:11:28
e9394c48ca7aacd9d151519c1da51d18a21b351b...b822efb9d165b93c4996b6677acf1cd90606fdb0,1,4,5,9,4,2012-12-28 12:38:43,2012-12-28 12:38:43
12434cb7fda93538003ae6897ce12f49db4b7a9f...9168cd6a00aced5d21c36ab8e8941e6d297e2023,1,1,1,2,1,2012-10-11 13:55:11,2012-10-11 13:55:11
baf94bd732e0e5802a888d95d943c948b7a9e65b...19560a4b5f8087ed0cfeef285c9a03404d15ca60,2,9,3,12,3,2012-10-12 11:37:44,2012-10-12 11:37:44
baf94bd732e0e5802a888d95d943c948b7a9e65b...d1a18d038d12198c433a8d90a14ca6365ece33b4,1,34,0,34,2,2012-10-12 07:30:09,2012-10-12 07:30:09
d1a18d038d12198c433a8d90a14ca6365ece33b4...cfbd0b4f26224d0af9fa1366f7d83036aea2c15d,1,2,0,2,1,2012-10-12 07:31:57,2012-10-12 07:31:57
cfbd0b4f26224d0af9fa1366f7d83036aea2c15d...d0000e5c189534468da41205a1d5ad61f5c26547,1,34,2,36,4,2012-10-12 07:38:15,2012-10-12 07:38:15
d0000e5c189534468da41205a1d5ad61f5c26547...3f2e04254f92269240a4f0e7dbeb55e045563bc6,1,21,2,23,3,2012-10-12 08:00:59,2012-10-12 08:00:59
3f2e04254f92269240a4f0e7dbeb55e045563bc6...96abbf02e3679cd883ea4ad80227f3187791da8a,1,1,2,3,2,2012-10-12 08:30:39,2012-10-12 08:30:39
baf94bd732e0e5802a888d95d943c948b7a9e65b...64008b9ec70d299fb9514365b8853182534fc421,1,25,11,36,6,2012-10-11 23:02:28,2012-10-11 23:02:28
baf94bd732e0e5802a888d95d943c948b7a9e65b...378fe076b6d6bf6d6808a7336a25ebeb3eca7683,2,6,11,17,2,2012-10-11 17:27:58,2012-10-11 17:27:58
c177593e2cf282f09934640bd597e6e3c5f32893...a9a54979150f02690784cbea5d9b697b95249f7c,4,12,19,31,5,2012-12-01 17:40:47,2012-11-29 21:51:51
c177593e2cf282f09934640bd597e6e3c5f32893...24e172597a3e0c1b75e2d96fc8c7f1752f9a6c03,1,2,3,5,2,2012-12-01 11:19:16,2012-12-01 11:19:16
c177593e2cf282f09934640bd597e6e3c5f32893...968c09ae919ce745a158764d49b3aff280324eb5,2,2,3,5,2,2012-12-01 10:03:51,2012-11-29 21:42:22
968c09ae919ce745a158764d49b3aff280324eb5...42ef89c98ab39904d313571ec26c67506cdbab59,2,3,2,5,3,2012-12-01 10:04:44,2012-11-29 22:59:56
42ef89c98ab39904d313571ec26c67506cdbab59...b17e94c37bd5868c44f3aa085bfc3e44e227dc07,1,2,1,3,2,2012-12-01 10:07:57,2012-12-01 10:07:57
b17e94c37bd5868c44f3aa085bfc3e44e227dc07...270a43370a4cd9e5f222ad707f68f42088d5ae06,3,33,0,33,3,2012-12-01 10:20:45,2012-12-01 10:20:45
c177593e2cf282f09934640bd597e6e3c5f32893...35f0566e08f9ab03e01924b13c0a1f339c85fb94,2,3,3,6,3,2012-11-30 21:08:08,2012-11-30 21:08:08
3c050a29a76469b9f256322652f12b8d3cc2bac2...d75cb57f9cc6dc7c8c9893eb39ac0bf7ebee71ad,1,0,1,1,1,2013-03-15 15:35:54,2013-03-15 15:35:54
d75cb57f9cc6dc7c8c9893eb39ac0bf7ebee71ad...fdfc408d87fbeeda099f53ca9ebd348b65ea79b3,2,13,1,14,2,2013-03-15 16:01:03,2013-03-15 16:01:03
6755d9908f95c12fcce422ffcbfc10bda9473104...f1c24f40f9add4aa5ee90b6e3bf1109c4a0d7a2c,1,1,1,2,1,2013-03-12 12:10:20,2013-03-12 12:10:20
f1c24f40f9add4aa5ee90b6e3bf1109c4a0d7a2c...70fc1c5021185b6945932fd9dc27e26b5721caa8,2,2,2,4,2,2013-03-12 12:13:25,2013-03-12 12:13:25
70fc1c5021185b6945932fd9dc27e26b5721caa8...aecb37623e889493c56f22b86e87bc81c6a83cd8,1,1,1,2,1,2013-03-12 12:16:55,2013-03-12 12:16:55
aecb37623e889493c56f22b86e87bc81c6a83cd8...366bc3201329dedb2af5ddc567130b4d8d6832f9,1,4,0,4,1,2013-03-12 16:59:25,2013-03-12 16:59:25
366bc3201329dedb2af5ddc567130b4d8d6832f9...fa9a8c38473a83d2dcc1d015e10a9ff1c020b0d5,13,34,178,212,26,2013-03-13 17:16:36,2013-03-13 17:16:36
fa9a8c38473a83d2dcc1d015e10a9ff1c020b0d5...1587caa3e4d5b87e322612195a3db38212489c83,4,6,6,12,4,2013-03-13 17:24:30,2013-03-13 17:24:30
1587caa3e4d5b87e322612195a3db38212489c83...496b7da7a0cb85dd87fd4360691cc2d7cb50f484,3,5,5,10,5,2013-03-13 19:58:32,2013-03-13 19:58:32
496b7da7a0cb85dd87fd4360691cc2d7cb50f484...963c212b68393cc52959e40fcce672ecd66f303a,1,1,1,2,1,2013-03-13 20:30:33,2013-03-13 20:30:33
963c212b68393cc52959e40fcce672ecd66f303a...d1a5e370f36d246ee9488a9043ea652118302849,1,11,0,11,1,2013-03-13 21:15:39,2013-03-13 21:15:39
8ec956421c5e94bc2a51e30414d85417c10404b8...927d0cc2674d21f470a29e7a10577707172f13c6,1,1,0,1,1,2012-10-08 10:41:25,2012-10-08 10:41:25
8ec956421c5e94bc2a51e30414d85417c10404b8...82425cf358d6abb316dce04dca1567481f57c463,1,2,2,4,2,2012-10-05 15:48:52,2012-10-05 15:48:52
8ec956421c5e94bc2a51e30414d85417c10404b8...a58d3112620a62240c5f98f1cc0111e89de6b543,1,3,1,4,1,2012-09-26 14:02:31,2012-09-26 14:02:31
8ec956421c5e94bc2a51e30414d85417c10404b8...5928388b1c5b41cf11471391b3ec6226167132fd,3,32,5,37,5,2012-09-26 11:20:44,2012-09-26 11:20:44
8ec956421c5e94bc2a51e30414d85417c10404b8...0b8e956f32cac5847029c29a607816b743e52465,4,40,5,45,9,2012-09-24 13:12:44,2012-09-24 09:01:44
0b8e956f32cac5847029c29a607816b743e52465...987e351de7fb6c98094a1c099c717dacb3f1416e,1,1,1,2,1,2012-10-04 08:06:17,2012-10-04 08:06:17
923eb89c1de137e8daeb871e63530070aa70379e...a6f58b9c435e1680f102ae68a8aedea981a52486,2,4,1,5,2,2012-09-24 07:45:55,2012-09-24 07:45:55
923eb89c1de137e8daeb871e63530070aa70379e...c701507b6cf9ab4099d4d5847516436ca35658d8,1,5,1,6,3,2012-09-24 07:06:41,2012-09-24 07:06:41
339555846e2ddc6606bddeb2590a92f5d882e33c...c4883ca225d1f4934cec737769fe22588b2bc8a8,3,19,27,46,14,2012-10-02 13:29:03,2012-10-02 13:29:03
c4883ca225d1f4934cec737769fe22588b2bc8a8...d104df49e743a52b42c63a4ccca6be67bdf775d7,2,3,3,6,3,2012-10-02 13:34:20,2012-10-02 13:34:20
d104df49e743a52b42c63a4ccca6be67bdf775d7...e9c356092bfa1545f4df35f11fb54dc121f825b2,1,1,1,2,1,2012-10-02 15:02:21,2012-10-02 15:02:21
e9c356092bfa1545f4df35f11fb54dc121f825b2...2e1c3c52bc43d08bc01cf3ba5fba377b3236223b,1,1,1,2,1,2012-10-02 15:08:04,2012-10-02 15:08:04
a39c910619a70e63c547bf480f4c913d0205e74b...31e338b8fda71de81edcbfd1a562201c59dfa549,1,1,0,1,1,2013-01-16 15:11:40,2013-01-16 15:11:40
a39c910619a70e63c547bf480f4c913d0205e74b...729088a7af7ef7b585066b408542b54f1a1999c5,6,19,4,23,7,2013-01-16 14:54:01,2013-01-16 14:54:01
151ada7645f112d5cae365a812a1076835100f8a...e37a043df76adff70456ca3aa6a66735fd0c4585,7,72,56,128,25,2012-12-30 11:37:33,2012-12-30 11:37:33
e37a043df76adff70456ca3aa6a66735fd0c4585...a16533a04a3033772bdde2616ce812a3247e6fb5,6,8,6,14,7,2012-12-30 11:50:23,2012-12-30 11:50:23
a16533a04a3033772bdde2616ce812a3247e6fb5...f45345edb33f1129aabb58976ae2e6812387eb7d,2,17,8,25,2,2012-12-30 12:09:43,2012-12-30 12:09:43
f45345edb33f1129aabb58976ae2e6812387eb7d...d075df56d3cfb15a5d11550d86229f5b8001fbe7,4,27,1,28,5,2012-12-30 12:26:19,2012-12-30 12:26:19
d075df56d3cfb15a5d11550d86229f5b8001fbe7...96d49bf04ce77c975fe500f4d961e4a1ffed4c26,589,75674,99966,175640,559,2012-12-30 12:43:00,2012-12-30 12:43:00
96d49bf04ce77c975fe500f4d961e4a1ffed4c26...d863fa6283c80eaf2d549b73bf778b78a94ff89c,2,5,9,14,6,2012-12-30 12:54:08,2012-12-30 12:54:08
d863fa6283c80eaf2d549b73bf778b78a94ff89c...64db5f808baa111e69f2588b5233a212d1343d68,2,9,13,22,6,2012-12-30 13:15:56,2012-12-30 13:15:56
64db5f808baa111e69f2588b5233a212d1343d68...82ae973a9909bd82d75ce493a0a151efa0a98621,11,75,3,78,16,2012-12-30 14:19:31,2012-12-30 14:19:31
837972650c6d33ad4c376cb219289202559d0e48...db3d90cbcb41c5b9a62998b185c90c10f9d03968,1,1,1,2,1,2012-10-12 17:12:35,2012-10-12 17:12:35
837972650c6d33ad4c376cb219289202559d0e48...f6a8e6944984eabb21a3ce9c15d1f14eb87ee06d,4,20,1,21,4,2012-10-12 17:07:23,2012-10-08 15:43:54
f6a8e6944984eabb21a3ce9c15d1f14eb87ee06d...3b5c7b6e9aead85ffaa5d669639e69989da8a5b8,1,1,1,2,1,2012-10-12 17:07:23,2012-10-08 15:54:51
3b5c7b6e9aead85ffaa5d669639e69989da8a5b8...57e2b5ed1adf330f2b1684d3e8aed311087d4304,85,162379,3,162382,87,2012-10-12 17:07:24,2012-10-09 17:11:49
57e2b5ed1adf330f2b1684d3e8aed311087d4304...02c83f122a28edc18e7e2184fa079c28e46375cb,2,21,18,39,6,2012-10-12 17:07:24,2012-10-10 09:41:15
02c83f122a28edc18e7e2184fa079c28e46375cb...e53b47b447b1f1ba8185aa07b8c53102c592ead8,3,30,2,32,4,2012-10-12 17:07:24,2012-10-11 21:15:24
e53b47b447b1f1ba8185aa07b8c53102c592ead8...0b3e9fd2189753ae4007b53c2c588fca741738ef,2,7,6,13,5,2012-10-12 17:07:24,2012-10-12 11:06:12
0b3e9fd2189753ae4007b53c2c588fca741738ef...42bdfd021ba8cc8b634a23e3c5c2ac605f4c602c,4,55,10,65,7,2012-10-12 17:07:24,2012-10-12 14:14:52
42bdfd021ba8cc8b634a23e3c5c2ac605f4c602c...358d7eff7d1f4b7a3150d38d9dbe03fe02491ae2,2,16,0,16,2,2012-10-12 17:07:24,2012-10-12 16:56:06
358d7eff7d1f4b7a3150d38d9dbe03fe02491ae2...2a78ae60eb128cc0590151721d6ee33e06942bf2,1,1,1,2,1,2012-10-12 17:07:24,2012-10-12 16:59:42
2a78ae60eb128cc0590151721d6ee33e06942bf2...47d9732a07ef0aa626efdf745d456bff90fe30f8,2,2,2,4,2,2012-10-12 17:28:06,2012-10-12 17:27:50
47d9732a07ef0aa626efdf745d456bff90fe30f8...809aefb828e0d4b5c06304fcde2dcfced66ab4e9,8,37,19,56,18,2012-10-15 16:51:11,2012-10-15 16:51:11
e9212b0aa2de2a02e6c7b685f3cb5d7f9d3841f0...0323610b72015c274c7292ee69992f75cdcd116c,1,1,1,2,1,2012-12-01 18:31:39,2012-12-01 18:31:39
e117414e44ea5747805b8ff0cba000cd10938cb9...0530e5baaee07dd518811f21b227a46e99d1dc53,3,40,13,53,7,2012-12-02 17:28:23,2012-12-02 17:28:23
0530e5baaee07dd518811f21b227a46e99d1dc53...2d076394aa9e39fc1b6ec58b6cfcf21d0c0345af,1,7,4,11,1,2012-12-03 11:22:28,2012-12-03 11:22:28
2d076394aa9e39fc1b6ec58b6cfcf21d0c0345af...f2a76228f21fb76529f9d42c930fb49ae6e236ec,5,369,755,1124,5,2012-12-01 06:14:05,2012-12-01 06:14:05
f2a76228f21fb76529f9d42c930fb49ae6e236ec...a5105ddf132de139a3b2d684cbe7472bc8df6864,1,5,2,7,3,2012-12-03 12:39:13,2012-12-03 12:39:13
a5105ddf132de139a3b2d684cbe7472bc8df6864...05820516f1940b50a493fe9f702bdb0a57723d19,1,0,12,12,1,2012-12-03 15:38:35,2012-12-03 15:38:35
05820516f1940b50a493fe9f702bdb0a57723d19...8dec24a33ca35cbd9daa6ba38df4fe1e1f9eb2ee,2,14,1,15,3,2012-12-03 15:50:33,2012-12-03 15:50:33
8dec24a33ca35cbd9daa6ba38df4fe1e1f9eb2ee...7b97e3044988e41e65e8186f2dadf87e5837b101,2,47,1,48,11,2012-12-03 16:11:47,2012-12-03 16:11:47
2be5e6d44347dfb6374b4b2c87a953da06d6167d...46bf3a094988327b08c88006c694f0a0a15f7da2,14,95,56,151,34,2012-12-02 11:29:24,2012-12-02 11:29:24
fdfc408d87fbeeda099f53ca9ebd348b65ea79b3...50c05b71b75a3c7f53d84adc4ec898be54e8f9f4,2,4,4,8,4,2013-03-15 16:33:43,2013-03-15 16:33:43
fdfc408d87fbeeda099f53ca9ebd348b65ea79b3...8403e99f280f1d9bb79dbe73f0af16d87972bb7b,1,1,1,2,1,2013-03-15 16:05:02,2013-03-15 16:05:02
d1a5e370f36d246ee9488a9043ea652118302849...1e11e45fa372f093352774a3fa1725ff143ed746,1,1,0,1,1,2013-03-14 07:02:36,2013-03-14 07:02:36
d1a5e370f36d246ee9488a9043ea652118302849...67e2cf88644ae2e9dd65769cc3f88c44c374c8dc,2,5,0,5,3,2013-03-13 21:19:09,2013-03-13 19:36:26
67e2cf88644ae2e9dd65769cc3f88c44c374c8dc...1bba46d66117b4a96d279fd964a45fe673db658c,2,281,0,281,2,2013-03-13 21:19:09,2013-03-13 19:36:53
1bba46d66117b4a96d279fd964a45fe673db658c...163908b393bf69e4accbe22cbba1df50fa491649,1,47,0,47,1,2013-03-13 21:19:09,2013-03-13 19:37:13
163908b393bf69e4accbe22cbba1df50fa491649...bf17d976a7be3404e30a0211c4c9b5ef78bf5104,7,28,2,30,7,2013-03-13 21:19:09,2013-03-13 19:37:50
bf17d976a7be3404e30a0211c4c9b5ef78bf5104...7316055ac8bc8cca651430c37cbe20dcd79e23cd,2,5,2,7,4,2013-03-13 21:19:09,2013-03-13 19:42:14
7316055ac8bc8cca651430c37cbe20dcd79e23cd...bdcaf21ea7b4ffb6b386d6b0e809eff10090fc80,6,12,7,19,6,2013-03-13 21:19:09,2013-03-13 20:32:04
bdcaf21ea7b4ffb6b386d6b0e809eff10090fc80...10f14136f570863c2898f429c936de6c0114206a,1,4,2,6,1,2013-03-13 21:45:47,2013-03-13 21:45:47
10f14136f570863c2898f429c936de6c0114206a...ef05423f47fdd970498d880cf18f282fa0205596,11,234,200,434,65,2013-03-14 08:16:27,2013-03-14 08:16:27
2ff36e74eba44b7a972fdb21774f45a27492e69e...19e8473eb7dd456b64315b1b9e62c780ace98fef,1,3,0,3,1,2012-11-16 13:47:07,2012-11-02 11:26:41
2ff36e74eba44b7a972fdb21774f45a27492e69e...bcd001f2953d7a358be02d74df1b00dace68648f,2,23,36,59,23,2012-10-24 14:45:18,2012-10-24 14:45:18
2ff36e74eba44b7a972fdb21774f45a27492e69e...d75cc7eafd980198e6f7484ded56c148ea96479f,3,11,9,20,5,2012-10-21 13:48:34,2012-10-02 07:54:33
a6f58b9c435e1680f102ae68a8aedea981a52486...d23022c6f68bd78a1d3b63a8bf7551145b1f46fd,11,194,170,364,39,2012-09-24 09:32:51,2012-09-24 09:32:51
d23022c6f68bd78a1d3b63a8bf7551145b1f46fd...6667f3dbf920d9bcf0e6f3218d27c92811f74224,6,38,35,73,13,2012-09-24 10:33:51,2012-09-24 10:33:51
2e1c3c52bc43d08bc01cf3ba5fba377b3236223b...e7608cd6f955c488844f30069af8ca71cb2677c4,1,1,1,2,1,2012-10-02 15:43:35,2012-10-02 15:43:35
e7608cd6f955c488844f30069af8ca71cb2677c4...dc53a4f73229c879e6fc4ce6a37c57520bb5288d,1,1,1,2,1,2012-10-02 15:52:19,2012-10-02 15:52:19
2e1c3c52bc43d08bc01cf3ba5fba377b3236223b...fa3ae24ca7a11f3d87c8838cf05a95dfecfa4c5c,8,116,1,117,13,2012-10-02 15:17:12,2012-10-02 15:17:12
fa3ae24ca7a11f3d87c8838cf05a95dfecfa4c5c...d683ce5c10ee84d9fde153329d08425c7e99941f,3,8,21,29,3,2012-10-02 15:20:46,2012-10-02 15:20:46
d683ce5c10ee84d9fde153329d08425c7e99941f...d6363e935933551b7f9edb4063d0b0fbcea3c824,8,175,1,176,9,2012-10-02 16:01:40,2012-10-02 16:01:40
d6363e935933551b7f9edb4063d0b0fbcea3c824...f9eda9b33a72cae91e51c5733fdf2c0d7b37d149,6,83,26,109,9,2012-10-02 16:37:53,2012-10-02 16:37:53
f9eda9b33a72cae91e51c5733fdf2c0d7b37d149...1b6a3dfec9bdadb8c607bf57e4b6699c4ab3a80b,16,339,27,366,22,2012-10-02 17:42:15,2012-10-02 17:42:15
1b6a3dfec9bdadb8c607bf57e4b6699c4ab3a80b...010ac2b17f1e4bd0e104a90fd8bfc8c7bcb67ac8,1,23,37,60,3,2012-10-02 19:08:30,2012-10-02 19:08:30
010ac2b17f1e4bd0e104a90fd8bfc8c7bcb67ac8...224fb5770ce71061861f5c2bddb01924d668a841,11,26,7,33,12,2012-10-03 09:49:43,2012-10-03 09:49:43
224fb5770ce71061861f5c2bddb01924d668a841...8b76e30656954c2dd95121fff46c4bc6cc81bb74,6,68,13,81,7,2012-10-03 10:42:17,2012-10-03 10:42:17
8b76e30656954c2dd95121fff46c4bc6cc81bb74...ce1b79afa9faa8ffaae7392f9e48273c230753c4,3,9,5,14,5,2012-10-03 11:26:37,2012-10-03 11:26:37
ce1b79afa9faa8ffaae7392f9e48273c230753c4...c8412bc9edbbed7a38cc4880f0d8cbb9091eb1d9,1,3,2,5,2,2012-10-03 12:02:02,2012-10-03 12:02:02
3f252ed19430a5d6a96a77c19ef7652063a1c003...0dd8a26a3a04cc59d13d83c3fbae4b39acddab67,1,2,2,4,1,2013-01-16 16:00:38,2013-01-16 16:00:38
0dd8a26a3a04cc59d13d83c3fbae4b39acddab67...592d626dad76432dc67eff2fa3dc1802a6c691e7,1,1,1,2,1,2013-01-16 16:31:11,2013-01-16 16:31:11
592d626dad76432dc67eff2fa3dc1802a6c691e7...640d51f4b64041a37d302da46c90a4a735a4fe90,2,3,4,7,3,2013-01-16 17:09:49,2013-01-16 17:08:51
640d51f4b64041a37d302da46c90a4a735a4fe90...7635afd0c4872e2552413b17b1a63bae76e62e45,2,11,7,18,8,2013-01-16 21:08:01,2013-01-16 21:08:01
7635afd0c4872e2552413b17b1a63bae76e62e45...16b54178422b5e84e0ddd61a7a44306d7b164707,3,10,1,11,3,2013-01-16 21:39:45,2013-01-16 21:39:45
16b54178422b5e84e0ddd61a7a44306d7b164707...2bc78739a7aa9d7e5109281fc45dbd41a1a576d4,3,36,7,43,6,2013-01-16 21:39:56,2013-01-16 21:37:39
2bc78739a7aa9d7e5109281fc45dbd41a1a576d4...9bc829d3975d70b3a7639a965aa8fbd7ee1f047f,2,10,3,13,5,2013-01-16 22:03:21,2013-01-16 22:03:21
82ae973a9909bd82d75ce493a0a151efa0a98621...0a2ac8371d49123baa5d1f601fc24df15d46965a,1,1,1,2,1,2012-12-30 18:26:09,2012-12-30 18:26:09
82ae973a9909bd82d75ce493a0a151efa0a98621...a54b2e80f80d94bd903df85ac31dc2fd57cd97d0,1,13,9,22,3,2012-12-30 17:54:02,2012-12-30 17:54:02
db3d90cbcb41c5b9a62998b185c90c10f9d03968...e6524a919ee4c92d82518c2520d5c0cabc32eb47,6,50,2,52,9,2012-10-16 19:05:11,2012-10-16 19:05:11
db3d90cbcb41c5b9a62998b185c90c10f9d03968...9588a232428d7045fb3e86ce36a81437a854b160,2,3,2,5,2,2012-10-13 18:37:36,2012-10-13 18:37:36
db3d90cbcb41c5b9a62998b185c90c10f9d03968...8880c06d3bd6fc4dcfe63e82c662988698ad4bcf,1,13,0,13,1,2012-10-13 16:02:01,2012-10-13 16:02:01
8880c06d3bd6fc4dcfe63e82c662988698ad4bcf...757b4bbc5c8f08d8e48e3c98a513570d4b4016d7,2,5,0,5,3,2012-10-13 16:13:28,2012-10-13 16:13:28
db3d90cbcb41c5b9a62998b185c90c10f9d03968...b1461de993daf6d43c8a54482eecacc6bb58df4d,7,39,18,57,15,2012-10-13 14:23:12,2012-10-13 14:23:12
7b97e3044988e41e65e8186f2dadf87e5837b101...fddc0c29aa8d63fce45b450902f27f82dfba5231,7,275,0,275,7,2012-12-03 16:19:33,2012-12-02 12:56:04
9f3a593092bec4eb0542c8217f5ec5bf37c17dbe...699c9cd4999335212678e26d2d86a10e22d0eb29,1,3,2,5,1,2013-03-15 16:50:45,2013-03-15 16:50:45
0e570857957ddb3de09172751101754f95a4cb43...2f6d289f328d75a42bc0f3d52a2c90083010bd69,1,1,1,2,1,2013-03-14 08:20:45,2013-03-14 08:20:45
2f6d289f328d75a42bc0f3d52a2c90083010bd69...cc1dd624aab2f5f85ec121506884965f5353411d,6,123,60,183,14,2013-03-14 09:31:33,2013-03-14 09:31:33
cc1dd624aab2f5f85ec121506884965f5353411d...f4f36f78ddb3d720ad7ae89ecea300c9f48775c7,3,0,20,20,3,2013-03-14 10:37:28,2013-03-14 10:37:28
f4f36f78ddb3d720ad7ae89ecea300c9f48775c7...441d25618809c295349f7dae4e45bfbbc0fb7144,8,84,119,203,13,2013-03-14 10:38:43,2013-03-14 10:38:43
441d25618809c295349f7dae4e45bfbbc0fb7144...4673c853795b294a374cb75a662b18b4d6cfa140,1,1,1,2,1,2013-03-14 10:43:08,2013-03-14 10:43:08
4673c853795b294a374cb75a662b18b4d6cfa140...e84df44ea033dcab315ca2f28186066ae6486ee6,1,10,18,28,3,2013-03-14 11:11:20,2013-03-14 11:11:20
e84df44ea033dcab315ca2f28186066ae6486ee6...88d42c2e1c5ef3d312efbba658d852e638bf8f31,8,15,20,35,9,2013-03-14 11:12:11,2013-03-14 11:12:11
88d42c2e1c5ef3d312efbba658d852e638bf8f31...a8b1f8c0e5307ea71a2ba4790485cab3c4691d30,1,5,3,8,1,2013-03-14 12:02:24,2013-03-14 12:02:24
a8b1f8c0e5307ea71a2ba4790485cab3c4691d30...da3bc14d80ebcd14b89771d7a30cbc6f4d3abbf6,1,1,1,2,1,2013-03-14 12:02:56,2013-03-14 12:02:56
da3bc14d80ebcd14b89771d7a30cbc6f4d3abbf6...d2b882fae5dcb9d4072cff9f1d271d378def26c2,1,3,3,6,1,2013-03-14 15:13:00,2013-03-14 15:13:00
e79ab4bdb92cc645d399a9150f4c7e3b9a5e2e46...a769662f18fde1e590dc49b422853691b9cabc1d,1,1,0,1,1,2013-04-18 10:27:52,2013-04-18 10:27:52
a769662f18fde1e590dc49b422853691b9cabc1d...1af2aeffc8e7a0319026fe7b6a218ffc0c69d872,7,14,13,27,15,2013-04-18 14:28:09,2013-04-18 14:28:09
1af2aeffc8e7a0319026fe7b6a218ffc0c69d872...624ba477c675dc5c27d21643bfd0605a9eb08374,2,12,3,15,3,2013-04-19 06:33:56,2013-04-19 06:33:56
624ba477c675dc5c27d21643bfd0605a9eb08374...3ba36df6c461bccd9f4426bc68f1678a57efe2e4,1,0,68,68,1,2013-04-19 14:22:55,2013-04-19 14:22:55
3ba36df6c461bccd9f4426bc68f1678a57efe2e4...827a0018a998e7100c91fad48df166c67fcf0e1b,1,42,0,42,1,2013-04-19 14:27:30,2013-04-19 14:27:30
827a0018a998e7100c91fad48df166c67fcf0e1b...142fd2c11d434bdd7ff26bef746fb583b2df892a,4,7,12,19,4,2013-04-19 15:09:14,2013-04-19 15:09:14
142fd2c11d434bdd7ff26bef746fb583b2df892a...cb30df19d44edfb3e3a4f73a19a93a739a5441e4,1,1,1,2,1,2013-04-19 15:18:40,2013-04-19 15:18:40
cb30df19d44edfb3e3a4f73a19a93a739a5441e4...65f0ed4d264e7015ac9259d82913876c6e198a5d,4,8,8,16,9,2013-04-19 18:06:53,2013-04-19 18:06:53
65f0ed4d264e7015ac9259d82913876c6e198a5d...1a0082b46b121b2c7bff0211950adc13855d9344,1,14,6,20,2,2013-04-19 18:19:16,2013-04-19 18:19:16
1a0082b46b121b2c7bff0211950adc13855d9344...a908edacacb4d6465b3d4cf4b99f3ecaf08eb8be,2,7,5,12,8,2013-04-19 18:50:37,2013-04-19 18:50:37
a908edacacb4d6465b3d4cf4b99f3ecaf08eb8be...d6cebe348cbd35cd5f7168a810e07c547a0312c1,2,6,1,7,2,2013-04-19 18:57:30,2013-04-19 18:57:30
d6cebe348cbd35cd5f7168a810e07c547a0312c1...a855718341bfc96379127fb8cb583830f1c9c01f,2,41,44,85,4,2013-04-19 19:37:44,2013-04-19 19:37:44
4eef112462e4a9d7d990603896810d0e945e1769...be1dc5544a7840d17657d3d8fcecb0d0fd4401b5,2,2,2,4,2,2012-11-19 13:11:20,2012-11-19 13:11:20
dc53a4f73229c879e6fc4ce6a37c57520bb5288d...38ca52f33b6a6824268f3dc92cf5ca13ad737c20,1,2,2,4,2,2012-10-02 22:56:57,2012-10-02 22:42:39
38ca52f33b6a6824268f3dc92cf5ca13ad737c20...5e3be9cda0e23e2c62a3e3b08791357ce572d998,3,51,10,61,7,2012-10-02 23:00:41,2012-10-02 22:57:13
eea43c9412fcf1ce8de0230524114b2d643a0e0e...76329a46a3aca95f918b72936bcd884de4956ff3,2,14,11,25,9,2013-01-16 22:54:48,2013-01-16 22:54:48
76329a46a3aca95f918b72936bcd884de4956ff3...8f9dec2883060b6a1610d64b9488efe7859963c8,2,28,19,47,19,2013-01-16 23:09:08,2013-01-16 23:09:08
8f9dec2883060b6a1610d64b9488efe7859963c8...9cab79cbe640ba8ec842b2f5103871ae447ab1ab,1,2,2,4,2,2013-01-16 23:43:35,2013-01-16 23:43:35
0a2ac8371d49123baa5d1f601fc24df15d46965a...29baadf0c7f48c63867b839d4f990ff767b6dcc9,1,2,1,3,2,2012-12-31 02:15:31,2012-12-31 02:15:31
29baadf0c7f48c63867b839d4f990ff767b6dcc9...c816dcc10513731f0ef0c1b247fef1ef1287dd7c,2,6,4,10,4,2012-12-31 02:46:28,2012-12-31 02:46:28
c816dcc10513731f0ef0c1b247fef1ef1287dd7c...f4175219fb7a1cb93f7eed54bd6510a85345096e,1,1,1,2,1,2013-01-18 19:14:32,2013-01-18 19:13:38
9df17fa4c57e1025160ec271fb47e509d8bc2dcb...83924495993753e6c503ce539c6533b54af6f86a,1,34,20,54,5,2012-12-31 10:01:05,2012-12-31 10:00:46
83924495993753e6c503ce539c6533b54af6f86a...30d6370719263da531d2405fb561d34e1340f49e,1,16,3,19,2,2012-12-31 15:46:40,2012-12-31 15:46:40
30d6370719263da531d2405fb561d34e1340f49e...e5ff5c28694daee117f22ba3a8c21f38a5f14966,3,7,7,14,7,2012-12-31 16:22:44,2012-12-31 16:22:44
e5ff5c28694daee117f22ba3a8c21f38a5f14966...22ec3fa14cb87fec3655d2666783d439618890c5,2,7,6,13,5,2012-12-31 16:35:38,2012-12-31 16:35:38
22ec3fa14cb87fec3655d2666783d439618890c5...cf3f22cc9961b83dc56fdb49bb6a4a8b8bb732b1,1,15,11,26,5,2012-12-31 17:06:49,2012-12-31 17:06:49
cf3f22cc9961b83dc56fdb49bb6a4a8b8bb732b1...ffe064a2c1cb831258bc1019215f2defe23e7f99,7,16,13,29,11,2012-12-31 17:46:40,2012-12-31 17:46:40
8114d36cafa2bf0b51a337f900eee0d7ad7a84d6...22d0569dbbbaa12f3589717f25c340f8b67df1c7,4,33,34,67,14,2012-11-07 11:56:48,2012-11-07 11:56:48
22d0569dbbbaa12f3589717f25c340f8b67df1c7...d52f06f38013540a9798686aa37c4dad120c3d74,3,2,79,81,4,2012-11-07 12:01:23,2012-11-07 12:01:23
fced9678eae29864a1062a3d977cc611790a1a69...e26acd52b2489dd0ee201a0415fb16f1a0f28f59,1,1,1,2,1,2012-10-14 15:12:38,2012-10-14 15:12:38
e84d90c1e75800bc4186c8360c5a0d331c124517...763022d6983434a00751638e40f4dfb38f6cc5a5,1,3,9,12,2,2012-10-15 22:46:48,2012-10-15 22:46:48
e84d90c1e75800bc4186c8360c5a0d331c124517...2f05ab149110705cf4947de3eff877391c94f9cb,2,13,13,26,10,2012-10-15 21:38:35,2012-10-15 21:38:35
2f05ab149110705cf4947de3eff877391c94f9cb...5cff72ad1e3287c6315619fe67fab15b934d1bc8,2,6,6,12,2,2012-10-15 21:39:49,2012-10-15 20:08:00
5cff72ad1e3287c6315619fe67fab15b934d1bc8...1f4d8eac24a0feb18331fb18c67227d2175c8cd1,2,13,12,25,3,2012-10-15 21:40:02,2012-10-15 18:51:03
1f4d8eac24a0feb18331fb18c67227d2175c8cd1...d060856044655ac76101a8ded51507479b4bc34a,4,28,27,55,6,2012-10-15 21:40:06,2012-10-15 18:56:58
d060856044655ac76101a8ded51507479b4bc34a...d96a807db7ec6294d47c260fe143d826e3502ae1,1,1,1,2,1,2012-10-15 21:40:18,2012-10-15 19:04:26
d96a807db7ec6294d47c260fe143d826e3502ae1...3304262c3da429a5970e08b4cd0e58738b10c8eb,1,1,1,2,1,2012-10-15 21:40:21,2012-10-15 19:04:54
3304262c3da429a5970e08b4cd0e58738b10c8eb...f120e5a89a4bfc71ecd941ca9ad27c948b2d847b,1,1,1,2,1,2012-10-15 21:40:23,2012-10-15 19:23:35
f120e5a89a4bfc71ecd941ca9ad27c948b2d847b...b80a0195987295472ef5267fb1004054e7878d20,1,4,7,11,2,2012-10-15 21:40:56,2012-10-15 21:40:56
b80a0195987295472ef5267fb1004054e7878d20...d40d2dd8090ab1c171791b54d26e65f0573de239,1,9,2,11,3,2012-10-15 21:42:08,2012-10-15 21:42:08
d40d2dd8090ab1c171791b54d26e65f0573de239...536eb8e82893b5c0ae80f47ca24986ea6d9d4a3a,1,0,13,13,1,2012-10-15 21:42:44,2012-10-15 20:54:49
536eb8e82893b5c0ae80f47ca24986ea6d9d4a3a...866b9f6d919c90bf402a05780677a5cdd283d582,5,11,7,18,7,2012-10-15 22:57:15,2012-10-15 22:57:15
63dac843fdad0697c147b3c994500c84bc66f100...fc1c250d404902c9b34ccd28d9cfea7108f80831,1,58,27,85,6,2012-12-03 21:51:55,2012-10-29 14:49:37
fc1c250d404902c9b34ccd28d9cfea7108f80831...b91d6802572eeb152bd86dd68c54ef4151180848,1,4,7,11,3,2012-12-03 21:51:55,2012-10-29 14:50:30
b91d6802572eeb152bd86dd68c54ef4151180848...9b919939a35f9e5606f86a09eafa2a392d40d1a7,9,27,12,39,11,2012-12-03 21:51:55,2012-10-29 14:55:37
9b919939a35f9e5606f86a09eafa2a392d40d1a7...a58385247d06b238296e35c17c9e3f58b3234094,1,35,4,39,4,2012-12-03 21:51:55,2012-10-29 14:56:17
a58385247d06b238296e35c17c9e3f58b3234094...a048c955fda4de68a4e73e3fe2a4861e245926b8,4,29,0,29,4,2012-12-03 21:51:55,2012-10-29 17:24:25
a048c955fda4de68a4e73e3fe2a4861e245926b8...7971383d53cdd30c6d2beddcb4d5289eb7b0c876,1,3,3,6,1,2012-12-03 21:51:55,2012-10-29 19:38:12
7971383d53cdd30c6d2beddcb4d5289eb7b0c876...0b3df2f12849a98c92e53d6d28a43b27c71608bd,3,139,37,176,17,2012-12-03 21:51:55,2012-10-29 21:23:49
0b3df2f12849a98c92e53d6d28a43b27c71608bd...5c2f6d7f050222d2601218a0bec1dadcee5fcfa0,14,270,60,330,30,2012-12-03 21:51:55,2012-12-02 19:53:50
5c2f6d7f050222d2601218a0bec1dadcee5fcfa0...6c6f415cae54be4dae4522e901ed55c9dae04a15,2,3,3,6,2,2012-12-03 21:51:55,2012-10-29 18:37:37
6c6f415cae54be4dae4522e901ed55c9dae04a15...ae067ee322e6702fb5ef0fd4f0cc4d4d5106cbde,7,184,115,299,51,2012-12-03 21:51:56,2012-10-30 02:27:36
ae067ee322e6702fb5ef0fd4f0cc4d4d5106cbde...bd60a4ed40ca52fd23e027de8f30e2f094eb6e5c,3,31,22,53,12,2012-12-03 21:51:56,2012-10-30 20:55:51
bd60a4ed40ca52fd23e027de8f30e2f094eb6e5c...534bd5a268bc3409db1352198222275ff844316d,2,19,13,32,5,2012-12-03 21:51:56,2012-11-16 22:25:07
534bd5a268bc3409db1352198222275ff844316d...3bc507e5c5139c3e43558152675e222dd4b25927,12,12,12,24,10,2012-12-03 21:51:56,2012-11-17 19:24:12
3bc507e5c5139c3e43558152675e222dd4b25927...6d5c29dc2b08531fd82550e2e9e814382f58bb78,3,14,13,27,3,2012-12-03 21:51:56,2012-11-17 19:34:52
6d5c29dc2b08531fd82550e2e9e814382f58bb78...4d2278e7c64548137e1cfb9e4e56f842f15c29cb,2,2,2,4,2,2012-12-03 21:51:56,2012-11-17 21:45:00
4d2278e7c64548137e1cfb9e4e56f842f15c29cb...39834ec6409163e3339ed23ccdc9682932f45c9e,9,68,73,141,18,2012-12-03 21:51:56,2012-11-17 23:41:30
39834ec6409163e3339ed23ccdc9682932f45c9e...06ea1228404e56ee3356739a5e9a935f8d570b05,15,321,283,604,41,2012-12-03 21:51:56,2012-11-20 16:46:55
06ea1228404e56ee3356739a5e9a935f8d570b05...654f10102e051bfcef75add025f6395da58c770d,1,3,3,6,3,2012-12-03 21:51:56,2012-11-20 18:50:12
654f10102e051bfcef75add025f6395da58c770d...e8f10f317faca1c87ad6529e3661afa788cb7896,1,1,0,1,1,2012-12-03 21:51:56,2012-11-20 22:57:01
e8f10f317faca1c87ad6529e3661afa788cb7896...1319373d58c49eb96c1ec176f3057c2c31750b0e,1,1,1,2,1,2012-12-03 21:51:56,2012-11-20 19:26:46
1319373d58c49eb96c1ec176f3057c2c31750b0e...494ae87840bf719e5fb4094781cc1dfc179af463,27,229,197,426,78,2012-12-03 21:51:56,2012-12-02 19:43:39
494ae87840bf719e5fb4094781cc1dfc179af463...d9b15fc17d6d7feb0119fb8c900a0ee4e6f09a3a,3,9,8,17,2,2012-12-03 21:51:56,2012-11-21 22:18:12
d9b15fc17d6d7feb0119fb8c900a0ee4e6f09a3a...fac4e3f2e5ea62ed4b92722f5eb1a650ccccf4b1,1,177,189,366,18,2012-12-03 21:51:56,2012-11-21 23:23:26
fac4e3f2e5ea62ed4b92722f5eb1a650ccccf4b1...918dc873768359cbb7de5e83bc900fb0dacce938,2,17,11,28,2,2012-12-03 21:51:56,2012-11-21 23:42:55
918dc873768359cbb7de5e83bc900fb0dacce938...5d3fb35cd149288ddbab94ffa903c5977ca3da76,4,10,10,20,4,2012-12-03 21:51:56,2012-11-22 01:08:53
5d3fb35cd149288ddbab94ffa903c5977ca3da76...140652e9b019addaf7022e18b6816ecb36eee80c,8,122,107,229,43,2012-12-03 21:51:56,2012-11-22 01:56:42
140652e9b019addaf7022e18b6816ecb36eee80c...c4a7824a8c6487b24379f7f85c26f182bbc1dee9,5,29,4,33,11,2012-12-03 21:51:56,2012-11-22 01:57:22
c4a7824a8c6487b24379f7f85c26f182bbc1dee9...fbd345ea20eaabc58fe84a2cdf3ba960f3a10c24,2,20,7,27,4,2012-12-03 21:51:56,2012-11-22 02:20:41
fbd345ea20eaabc58fe84a2cdf3ba960f3a10c24...6fc10fa2564538bb892090759fdb05604b0e5567,7,178,172,350,40,2012-12-03 21:51:56,2012-12-02 19:47:09
6fc10fa2564538bb892090759fdb05604b0e5567...c20af32ae4adb1ec891e32ea048ae06ef4c7bc5f,7,24,30,54,13,2012-12-03 21:51:57,2012-12-02 22:14:56
c20af32ae4adb1ec891e32ea048ae06ef4c7bc5f...c1ffee4e65601a42c5d40ec5f3ddddb51a93251f,1,6,7,13,1,2012-12-03 21:51:57,2012-12-03 18:33:01
c1ffee4e65601a42c5d40ec5f3ddddb51a93251f...7978f8dd2b62baacb0d045b65282b758a76da118,4,68,21,89,14,2012-12-03 21:51:57,2012-12-03 19:35:09
7978f8dd2b62baacb0d045b65282b758a76da118...4ed8278870640017b93f18b476532824eba70ac2,4,83,112,195,30,2012-12-03 21:51:57,2012-12-03 20:43:17
4ed8278870640017b93f18b476532824eba70ac2...b47173da6a0fea0982d009f91e2c4d042f9b5c37,4,100,89,189,25,2012-12-03 21:51:57,2012-12-03 21:34:50
63dac843fdad0697c147b3c994500c84bc66f100...87e0429fb19426ecd33142a207a39245f719217e,1,1,1,2,1,2012-12-04 08:39:09,2012-12-04 08:39:09
87e0429fb19426ecd33142a207a39245f719217e...7f6bbf06f8d94f7e3830567167332ca2a42c4573,6,48,43,91,9,2012-12-04 09:18:41,2012-12-04 09:18:13
7f6bbf06f8d94f7e3830567167332ca2a42c4573...ba74fa1413d3274f7a3282d7f59046beecb32912,11,101,51,152,18,2012-12-03 18:14:05,2012-12-03 18:14:05
ba74fa1413d3274f7a3282d7f59046beecb32912...d8398921eb34fe7cee59df99ac4fffceca0c19fc,2,2,2,4,2,2012-12-04 13:22:22,2012-12-04 13:22:22
d8398921eb34fe7cee59df99ac4fffceca0c19fc...9acd7cf1bdc53fefe28b516e7e39523b866a8daa,1,2,2,4,2,2012-12-04 13:26:12,2012-12-04 13:26:12
cf848fd06d2d337811dae20e97f480b43f1b8bda...c367cc5ca66c0d59c0e5228ed1724023ea6ad06e,1,1,1,2,1,2013-03-16 12:40:16,2013-03-16 12:40:16
d2b882fae5dcb9d4072cff9f1d271d378def26c2...3df5253cc387c97f11e818e3a85fd10b0d17710c,1,2,1,3,2,2013-03-14 17:30:25,2013-03-14 15:40:09
d2b882fae5dcb9d4072cff9f1d271d378def26c2...5c4e74acc32f2afefcb8ad3a4cbbcd7122e7f0bf,4,29,29,58,8,2013-03-14 17:28:29,2013-03-14 17:28:29
5c4e74acc32f2afefcb8ad3a4cbbcd7122e7f0bf...38ecec447299ed77a358782a1c0d9c058b91631e,5,8,21,29,6,2013-03-14 17:50:57,2013-03-14 17:50:57
38ecec447299ed77a358782a1c0d9c058b91631e...753ecbdcecfacfaea9157267db4151d1b68e555a,3,38,29,67,13,2013-03-14 19:51:44,2013-03-14 19:51:44
b20bd1b6055b1dd9825ca86e78d056c7a32d7f69...4524f00adf594b5c93c9d608bcd490bd39bdd3ce,1,1,1,2,1,2013-04-20 08:41:16,2013-04-20 08:41:16
4524f00adf594b5c93c9d608bcd490bd39bdd3ce...ae2f5ecdf78336f01d596eab6b17e2fbc57e11fb,1,1,1,2,1,2013-04-20 12:43:48,2013-04-20 12:43:48
ae2f5ecdf78336f01d596eab6b17e2fbc57e11fb...44d63b4ceaed168f7e468cc6784618690e64fb84,1,9,9,18,7,2013-04-20 12:56:13,2013-04-20 12:56:13
b20bd1b6055b1dd9825ca86e78d056c7a32d7f69...34d4a3c8dfdf52ec70b8fe62fe4a3f65245bbe77,2,2,2,4,2,2013-04-20 05:06:51,2013-04-20 05:06:51
be1dc5544a7840d17657d3d8fcecb0d0fd4401b5...a8eb3fe1d2def9d4cc78003cd0a14de573a11fc5,1,45,0,45,1,2012-11-19 20:42:58,2012-11-19 13:38:58
a8eb3fe1d2def9d4cc78003cd0a14de573a11fc5...e7e1e99e92cfaf6757a1e4e25260eaca1b3b33a0,1,3,3,6,3,2012-11-19 20:42:58,2012-11-19 19:58:54
e7e1e99e92cfaf6757a1e4e25260eaca1b3b33a0...a9c2500a55a4d5bdb4aeab13c0167377f9841e90,1,1,0,1,1,2012-11-20 14:34:58,2012-11-20 14:34:58
be1dc5544a7840d17657d3d8fcecb0d0fd4401b5...c3b074acab554fc40a8fcb6060ed7ab10e4171a4,7,97,0,97,6,2012-11-20 09:33:49,2012-11-19 18:14:05
c3b074acab554fc40a8fcb6060ed7ab10e4171a4...95c23b2f974ec15e89cd7e762c80af0fa0ce57a5,34,365,359,724,74,2012-11-19 18:24:05,2012-11-19 18:24:05
95c23b2f974ec15e89cd7e762c80af0fa0ce57a5...85007434645c817e7674003bbdda0674287dd106,3,86,57,143,23,2012-11-19 18:44:05,2012-11-19 18:44:05
85007434645c817e7674003bbdda0674287dd106...406a0c809b3c10d8fb2754cf626094b98ee78aeb,16,158,7,165,16,2012-11-19 19:34:05,2012-11-19 19:34:05
406a0c809b3c10d8fb2754cf626094b98ee78aeb...9f65c274efbebf569b9d5576a33eabebda31e7e9,3,11,6,17,5,2012-11-20 12:16:04,2012-11-20 12:16:04
9f65c274efbebf569b9d5576a33eabebda31e7e9...93fdc4ca9d073ad73beacfd673ddc4e5652111ab,10,34,21,55,10,2012-11-20 12:19:55,2012-11-20 12:19:55
93fdc4ca9d073ad73beacfd673ddc4e5652111ab...f6248c255e1cd6d6d27f1a8d9ac38adc75157c09,1,4,1,5,2,2012-11-20 12:22:00,2012-11-20 12:22:00
f6248c255e1cd6d6d27f1a8d9ac38adc75157c09...ed92cfdebd99680048b1a4b697cb338bb93b4170,1,1,1,2,1,2012-11-20 14:46:22,2012-11-20 14:46:22
ed92cfdebd99680048b1a4b697cb338bb93b4170...ebcbe0c87b12d10c40c6a3fa13ceec02e8220090,5,20,0,20,5,2012-11-20 17:34:05,2012-11-20 17:34:05
d005242d230b1e0c59e183996f0f3117540130d3...bd50a9f466b3df15917b32142bfc325114ef811a,2,3,3,6,3,2012-10-26 12:05:57,2012-10-26 12:05:57
d005242d230b1e0c59e183996f0f3117540130d3...b5ced56ba4293d426f7f2e2a9872222f8146ef4c,1,3,2,5,2,2012-10-25 20:11:06,2012-10-25 20:11:06
fb903de50828ca01c533e5f02527623ff27a253b...351b0e758b10f482e180395639dee2210d734dec,1,2,0,2,1,2012-10-21 17:29:19,2012-10-21 17:29:19
351b0e758b10f482e180395639dee2210d734dec...da854542673c9debd4ffa28f1113174e63004857,2,14,2,16,3,2012-10-22 12:49:03,2012-10-22 12:49:03
9f1e9f11f1e66d0b6f22dba2870a2372c091b3bb...886cf2f5be5673cc99795322671e17551ee6fa3b,1,1,1,2,1,2013-01-17 01:00:09,2013-01-17 01:00:09
003c3121049aef98bf37f048563b2ab892207620...42dd006dfc39fc637027a6c2c8c659febde24ad6,2,2,2,4,2,2013-02-01 20:06:44,2013-02-01 20:06:15
42dd006dfc39fc637027a6c2c8c659febde24ad6...fac503877dbd3541009a30c8b9353d6eef85b059,1,47,38,85,5,2013-02-01 20:22:40,2013-02-01 20:18:09
ffe064a2c1cb831258bc1019215f2defe23e7f99...ff976bc86c73e5a060aa36744976c1712965dd81,1,1,1,2,1,2012-12-31 22:33:00,2012-12-31 22:12:07
d52f06f38013540a9798686aa37c4dad120c3d74...80fb38de7abdfacbf5ad2e0150b934c1392721f0,54,261,279,540,144,2012-11-13 11:27:45,2012-11-06 03:31:55
d52f06f38013540a9798686aa37c4dad120c3d74...b7445bb006ad3fa1ae60cc406dbda5203207fa65,1,1,1,2,1,2012-11-07 15:15:41,2012-11-07 15:15:41
b7445bb006ad3fa1ae60cc406dbda5203207fa65...313595e171c9931b4d61b1b4b19c50347bc4f87b,1,1,0,1,1,2012-11-07 15:32:39,2012-11-07 15:32:39
313595e171c9931b4d61b1b4b19c50347bc4f87b...784cb886cf63ba956d6ae93a92d538fd200b5463,1,6,5,11,1,2012-11-07 15:49:52,2012-11-07 15:49:52
c01b0fd5d4fb8110be2539b165b2e028540ad6f6...83626d05cd44fcb6ea36711f532768d03d42fc09,1,3,0,3,1,2012-10-17 07:43:44,2012-10-17 07:43:44
e8d6c3c1b6a146ca400a3337ddde57d0042f5087...453b2ae68b1f127de1deeb745950132542eac667,3,16,1,17,4,2012-10-16 06:43:22,2012-10-16 06:43:22
453b2ae68b1f127de1deeb745950132542eac667...76e1ca64301d52fb25b0a0e8cb9d513ba7d33c46,2,6,2,8,2,2012-10-16 06:48:55,2012-10-16 06:48:55
db2c15369c365340aeaf4e431e8838714b40396b...7335f366dc952aa371e1e17cfbe2874d51dd6f16,4,4,1,5,4,2013-01-02 19:49:27,2013-01-02 19:49:27
7335f366dc952aa371e1e17cfbe2874d51dd6f16...621c6b8533b527c735bb90c0a49ed18f55af93fa,2,3,3,6,3,2013-01-02 19:50:24,2013-01-02 19:50:24
621c6b8533b527c735bb90c0a49ed18f55af93fa...e29687552e375d324a153de077e0dbe7a4a5fd3c,2,3,3,6,3,2013-01-02 20:07:02,2013-01-02 20:07:02
e29687552e375d324a153de077e0dbe7a4a5fd3c...6c724ed96c4666efc0994f81c97dc40a7580f927,1,3,3,6,3,2013-01-02 20:31:48,2013-01-02 20:31:48
6c724ed96c4666efc0994f81c97dc40a7580f927...1883e0830cb9a8803e98059c9f4c6c82b55c5d84,1,223,0,223,1,2013-01-05 21:58:27,2013-01-05 21:58:27
1883e0830cb9a8803e98059c9f4c6c82b55c5d84...8c604c9d31561dc364173626923d568bf76414ba,1,86,0,86,1,2013-01-05 21:58:36,2013-01-05 21:58:36
8c604c9d31561dc364173626923d568bf76414ba...74e48f070f5adb83c0d82ca5b8795bebb666033e,2,3,3,6,2,2013-01-14 23:27:26,2013-01-14 23:27:26
74e48f070f5adb83c0d82ca5b8795bebb666033e...8ee5fce9d64b70d8981896457484fae622d142c9,1,235,0,235,1,2013-01-14 23:27:59,2013-01-14 23:27:59
9acd7cf1bdc53fefe28b516e7e39523b866a8daa...2519fd8376ba3ecf674bade735fbd4d31238f01c,2,3,3,6,2,2012-12-05 01:14:08,2012-12-05 01:14:08
9acd7cf1bdc53fefe28b516e7e39523b866a8daa...107a4e386a84484f2d966f95416d8fe2a99ce0c2,1,1,1,2,1,2012-12-04 18:19:26,2012-12-04 18:19:26
c367cc5ca66c0d59c0e5228ed1724023ea6ad06e...330fe4162eea06dbcf2cd498fe35436163093e40,3,154,6,160,13,2013-03-17 01:01:48,2013-03-17 01:01:48
753ecbdcecfacfaea9157267db4151d1b68e555a...a685624d27a99a4d7ee9d607fcf2ccbc85eb7fc7,14,128,99,227,20,2013-03-14 20:24:27,2013-03-14 20:24:27
a685624d27a99a4d7ee9d607fcf2ccbc85eb7fc7...2681a01bcf1230cc54764db4c40d12befb4c48a7,4,24,17,41,7,2013-03-14 20:57:38,2013-03-14 20:57:38
2681a01bcf1230cc54764db4c40d12befb4c48a7...5bf88506ecbc2fd57f0103cd3d8ce394a82954b5,2,2,1,3,2,2013-03-15 07:39:07,2013-03-15 07:39:07
5bf88506ecbc2fd57f0103cd3d8ce394a82954b5...39bbdc468f628ae9835926a09e24a91c702ddede,1,1,1,2,1,2013-03-15 07:39:50,2013-03-15 07:39:50
39bbdc468f628ae9835926a09e24a91c702ddede...35ad4fe7db13f3974ca8f0bbce2b39a1b2357b5c,10,87,111,198,15,2013-03-15 12:20:03,2013-03-15 12:20:03
44d63b4ceaed168f7e468cc6784618690e64fb84...da88fca34c2ffa5259420d244ea6c1313f047186,1,1,1,2,1,2013-04-21 14:49:23,2013-04-21 14:49:23
44d63b4ceaed168f7e468cc6784618690e64fb84...a2be79568feb52fd743327fe99cfc8c54f882152,3,25,3,28,4,2013-04-21 08:20:56,2013-04-21 08:20:56
ae006dd90ba635c1c7ee7c5c56b5570bb50a3f83...01817135e944ade092c35399409fe995b0c6152f,1,1,0,1,1,2013-05-03 10:09:57,2013-05-03 10:09:57
ae006dd90ba635c1c7ee7c5c56b5570bb50a3f83...ef61d1f20004f20ec4a421f9bfd698ac070783dd,1,7,3,10,3,2013-05-03 02:58:53,2013-04-19 08:43:54
ef61d1f20004f20ec4a421f9bfd698ac070783dd...4e055e8a631ead1e8556287866e7a55f4a97062d,1,2,0,2,1,2013-05-03 02:58:53,2013-04-20 01:18:37
4e055e8a631ead1e8556287866e7a55f4a97062d...f1c9b05868cb6ecc72c1dc6f7de0583ca7f95faa,1,1,3,4,2,2013-05-03 03:31:23,2013-05-03 03:31:23
ebcbe0c87b12d10c40c6a3fa13ceec02e8220090...236584c2f804286b8cffab69c40deb0bca8c8632,3,7,3,10,4,2012-11-20 18:01:25,2012-11-20 18:01:25
236584c2f804286b8cffab69c40deb0bca8c8632...942c41011954e6b43ebc74340c668aa616e98e5b,13,134,233,367,65,2012-11-20 21:05:15,2012-11-20 21:05:15
942c41011954e6b43ebc74340c668aa616e98e5b...4d846c09b1982016356256afeb40dd252215429b,2,2,3,5,3,2012-11-20 21:18:44,2012-11-20 21:18:44
ebcbe0c87b12d10c40c6a3fa13ceec02e8220090...10d8b77b500e708f39f565f7f020814b4446a419,1,2,4,6,2,2012-11-20 16:59:28,2012-11-20 16:57:45
10d8b77b500e708f39f565f7f020814b4446a419...18bc873d53e79ef947b4d3fd66413c32e29fc1cb,1,1,1,2,1,2012-11-20 16:59:37,2012-11-20 16:59:00
4f687aaa8e7f62da40cb03f007cc6ad30047c18f...f73e46eece9e4f43703fa9bf6583ec7b38bb6c8f,1,1,2,3,1,2012-10-26 14:13:24,2012-10-26 14:13:24
f73e46eece9e4f43703fa9bf6583ec7b38bb6c8f...b4708d006c7a423a1682916403cfab848a9a48b8,4,19,11,30,8,2012-10-26 15:37:12,2012-10-26 15:37:12
b4708d006c7a423a1682916403cfab848a9a48b8...1c9351abf015ef3fc1375511cd0138d2759ca8f5,3,17,12,29,5,2012-10-26 16:00:09,2012-10-26 16:00:09
1c9351abf015ef3fc1375511cd0138d2759ca8f5...72f984e3d3505c5ff3dd1096f92d4be075fee04f,2,2,2,4,2,2012-10-26 18:52:26,2012-10-26 18:52:26
72f984e3d3505c5ff3dd1096f92d4be075fee04f...cec97c27083c00070513914a0063de349f0afcbb,1,0,6,6,1,2012-10-26 19:10:17,2012-10-26 19:10:17
4f687aaa8e7f62da40cb03f007cc6ad30047c18f...a7d0816933497a9e2db6abac7fac3ad73ac58582,8,93,22,115,15,2012-10-26 14:12:40,2012-10-26 12:52:10
a7d0816933497a9e2db6abac7fac3ad73ac58582...e51c37bdbda1822f93e1f8bcc21e970686eec464,5,27,1,28,6,2012-10-26 14:12:40,2012-10-26 13:53:45
e51c37bdbda1822f93e1f8bcc21e970686eec464...263282dec926451d2db39162c99d479277a52e72,1,4,0,4,1,2012-10-28 08:31:52,2012-10-28 08:22:03
0e0c5c53a3ebbf838363ff0bfc354a336b5e9336...ff396e0a7eb504e62c79277d2697cbc8c7c9e660,2,12,11,23,3,2012-10-25 21:39:02,2012-10-11 21:41:49
ff396e0a7eb504e62c79277d2697cbc8c7c9e660...0447ab375a988a328823d20cae0ddbbba652d74a,4,7,13,20,4,2012-10-25 21:39:02,2012-10-22 17:30:42
0447ab375a988a328823d20cae0ddbbba652d74a...643ed9cbf3b0dd09e0ae22df55662d5b33b1d6c7,1,4,4,8,4,2012-10-25 21:49:49,2012-10-25 21:49:49
da854542673c9debd4ffa28f1113174e63004857...893ce9ae24ffce68152cc0370ad74005e0997cee,1,14,0,14,2,2012-10-22 15:45:42,2012-10-22 15:45:42
893ce9ae24ffce68152cc0370ad74005e0997cee...4bc64b5530a45b26a13bf6e71d3b9d41aa1e8f98,2,4,1,5,2,2012-10-22 16:00:57,2012-10-22 16:00:57
886cf2f5be5673cc99795322671e17551ee6fa3b...7e40684b476f89db69cce22a9170375456716f30,1,4,13,17,2,2013-01-17 09:57:47,2013-01-17 09:57:47
7e40684b476f89db69cce22a9170375456716f30...b53ca0bcfea0cf9d82084ad9debbc65512103ddd,1,1,1,2,1,2013-01-17 10:07:01,2013-01-17 10:07:01
b53ca0bcfea0cf9d82084ad9debbc65512103ddd...9115a4f92f03265253c976ca789f799832ad766f,1,9,2,11,1,2013-01-17 10:21:52,2013-01-17 10:21:52
9115a4f92f03265253c976ca789f799832ad766f...b08bb209795dfc4b764679016f43cd483298f52c,1,2,2,4,1,2013-01-17 11:11:53,2013-01-17 11:11:53
886cf2f5be5673cc99795322671e17551ee6fa3b...6b78053d759e7d8a27afa745ba404131ff8d7877,1,14,0,14,1,2013-01-17 07:11:00,2013-01-17 07:11:00
fac503877dbd3541009a30c8b9353d6eef85b059...e565be241f39cf4119cb1d3e2668455ed11630fe,2,26,2,28,3,2013-02-02 19:33:42,2013-02-02 07:25:57
fac503877dbd3541009a30c8b9353d6eef85b059...85de55a120a615f8cf51a343a89789b802d776e2,1,5,0,5,2,2013-02-02 18:32:13,2013-02-02 18:32:13
0bda2d5d2bfd04161ed763c75e1bded90b73d8a5...0f07922f19dee37849e32b6a829087b4f98c2809,1,1,0,1,1,2013-01-02 20:31:20,2013-01-02 20:31:20
0bda2d5d2bfd04161ed763c75e1bded90b73d8a5...91995909d9ef6fc5540c7577987ed2244ac7862a,2,9,3,12,3,2013-01-02 16:57:02,2013-01-02 16:57:02
91995909d9ef6fc5540c7577987ed2244ac7862a...00a1f5bc2cc2c98bda3818e770eaae95e664480a,15,241,113,354,40,2013-01-02 17:00:00,2013-01-02 17:00:00
00a1f5bc2cc2c98bda3818e770eaae95e664480a...d431e4339269041784986da40a0e0879baaf96a9,19,58,61,119,50,2013-01-02 17:32:34,2013-01-02 17:32:34
d431e4339269041784986da40a0e0879baaf96a9...ccf0686b01160e4a61bf8fb4b26f43d1486af9c2,8,26,40,66,24,2013-01-02 17:46:06,2013-01-02 17:46:06
ccf0686b01160e4a61bf8fb4b26f43d1486af9c2...6a9e7dc55bbf7bedaee1870763132d65dad15be9,1,2,2,4,2,2013-01-02 17:56:22,2013-01-02 17:56:22
6a9e7dc55bbf7bedaee1870763132d65dad15be9...67896ea9a258eee8bb8ecca849d59f48e16ac77a,3,25,25,50,16,2013-01-02 18:25:25,2013-01-02 18:25:25
67896ea9a258eee8bb8ecca849d59f48e16ac77a...ce484fa9da2edd7e2be98600e2fe81770de31a90,4,4,6,10,6,2013-01-02 18:45:11,2013-01-02 18:45:11
ce484fa9da2edd7e2be98600e2fe81770de31a90...642e64034c44216362a65e1bc8eebb1931146056,1,1,0,1,1,2013-01-02 18:59:47,2013-01-02 18:59:47
642e64034c44216362a65e1bc8eebb1931146056...07a5cb2ef80ab4087a2edfb3571adf4cb8780ca2,1,1,1,2,2,2013-01-02 19:52:03,2013-01-02 19:52:03
07a5cb2ef80ab4087a2edfb3571adf4cb8780ca2...1b25a8f4374363d546d4a58f47c6fe00c3b3af07,1,4,2,6,2,2013-01-02 20:39:02,2013-01-02 20:39:02
b28ab8962beb1cc4e1bfe122e1110b770f4bc3d2...f0a6fbaae3b8d06c43eef6879afbcbbfdca52f1d,2,11,12,23,7,2012-11-13 19:26:57,2012-11-13 19:26:36
f0a6fbaae3b8d06c43eef6879afbcbbfdca52f1d...a85e11fa51497888684f247bc09450cbcc67a058,7,107,79,186,13,2012-11-13 20:11:56,2012-11-13 20:11:56
a85e11fa51497888684f247bc09450cbcc67a058...578cf89812fc12e99e22a3da83aaca89e7c8d430,6,39,36,75,20,2012-11-14 00:20:37,2012-11-14 00:20:37
578cf89812fc12e99e22a3da83aaca89e7c8d430...433d2278e0a9228ba8142dfb6b69df900654158d,2,35,34,69,18,2012-11-14 11:14:46,2012-11-14 11:14:46
433d2278e0a9228ba8142dfb6b69df900654158d...ece563296bcac93ce5918a050a70a95ceba0d7f9,2,29,26,55,9,2012-11-14 13:36:51,2012-11-14 13:36:51
784cb886cf63ba956d6ae93a92d538fd200b5463...96211b01a86c0f147dda88f336e9443c94f46ea4,2,10,5,15,6,2012-11-08 14:47:12,2012-11-08 14:47:12
96211b01a86c0f147dda88f336e9443c94f46ea4...f1ac2a616bedc2941bc7f67e2ac25e915da2ddb2,10,10,73,83,15,2012-11-08 17:41:07,2012-11-08 17:41:07
f1ac2a616bedc2941bc7f67e2ac25e915da2ddb2...8fbac65d036b142a75df5220eafc24ac3775a52c,2,4,3,7,3,2012-11-08 17:59:14,2012-11-08 17:59:14
784cb886cf63ba956d6ae93a92d538fd200b5463...993d6338b8efab89488900ed8ed9837f8000d20c,1,2,2,4,1,2012-11-08 14:43:01,2012-11-08 14:43:01
76e1ca64301d52fb25b0a0e8cb9d513ba7d33c46...ad5a6a4ae1fa784b2a6ecac8cc9791e23ec8f134,1,2,2,4,2,2012-10-16 10:45:30,2012-10-16 10:45:30
ad5a6a4ae1fa784b2a6ecac8cc9791e23ec8f134...8e8d82d49ac80b230e89f034f7aac00ddd555d1e,1,9,0,9,2,2012-10-16 10:45:48,2012-10-15 19:47:38
30227869482bbbdbfea153f2b45ef3bb9a9fd218...f8e1f4a7c9ee2554efcf7376a0cfbefae8956d7b,4,145,100,245,15,2013-01-14 23:52:55,2013-01-14 22:55:02
f8e1f4a7c9ee2554efcf7376a0cfbefae8956d7b...d28176b132bdc74055f31e2d62665d5d74ebacb4,4,255,137,392,4,2013-01-14 23:52:57,2013-01-14 23:11:35
c0c5d94b2bf605149a1d4d56d2adc7dd102b290a...6ea6ab7c8d152ce17f6321a984a213b17d7f5e7e,4,35,20,55,6,2012-12-02 05:41:06,2012-12-02 05:41:06
6ea6ab7c8d152ce17f6321a984a213b17d7f5e7e...cc0295b789a89a3f52e83e34b08ddf17b464308a,6,13,5,18,7,2012-12-05 03:14:05,2012-12-05 03:14:05
cc0295b789a89a3f52e83e34b08ddf17b464308a...674efd38d83d6f805d2ed9637028d195470b309b,2,2,2,4,2,2012-12-05 12:17:40,2012-12-05 12:17:40
674efd38d83d6f805d2ed9637028d195470b309b...a350b52c9b621a5f37b27f8ca6cfc424ff573425,2,94,11,105,12,2012-12-05 15:06:15,2012-12-05 15:06:15
a350b52c9b621a5f37b27f8ca6cfc424ff573425...4c3cdfa4fffb221d797e35913361bedbe1060d44,1,4,4,8,3,2012-12-05 15:08:24,2012-12-05 15:08:24
f6bfa095bf3178c94464fa3b5afb706e9a6b778c...2a1c5cdf99e943950af7630742299222a591827c,3,15,9,24,5,2012-12-04 20:06:55,2012-12-04 20:06:55
2a1c5cdf99e943950af7630742299222a591827c...e376f3150736e7936082529a3f6c92395f4c9720,4,64,57,121,7,2012-12-04 20:48:24,2012-12-04 20:48:24
a96e0ec57ef6ae129a1adb54e5b9b67d8ffb04b3...415bade302d6c3eef5810c7b812a8f608ef43001,33,43,43,86,43,2013-03-17 19:46:54,2013-03-17 19:46:54
a96e0ec57ef6ae129a1adb54e5b9b67d8ffb04b3...77295b00b8833bebdaa4e846337fa78101573095,1,1,1,2,2,2013-03-17 14:50:20,2013-03-17 14:50:20
7799b5bda6ba0a65c5a951dfd72db4fe334dc70e...8cad1c9f4c2984c0a73627290b5e7c6b465a68c2,7,107,6,113,11,2013-03-15 13:09:34,2013-03-15 13:09:34
8cad1c9f4c2984c0a73627290b5e7c6b465a68c2...2a04341fba22b708c4cd31ec8fa8c07713bc5877,2,4,4,8,4,2013-03-15 13:14:56,2013-03-15 13:14:56
2a04341fba22b708c4cd31ec8fa8c07713bc5877...21b1fee92c9d860281712ed97cf724e6d5d3fe76,17,56,49,105,32,2013-03-15 13:16:02,2013-03-15 13:16:02
21b1fee92c9d860281712ed97cf724e6d5d3fe76...2449bea2c46f44ef09122856363beb955c853c1f,2,17,122,139,7,2013-03-15 13:39:47,2013-03-15 13:39:47
2449bea2c46f44ef09122856363beb955c853c1f...86e23a584a025131eedb919c8f67f3e81a0f58f3,1,6,2,8,2,2013-03-15 14:05:07,2013-03-15 14:05:07
86e23a584a025131eedb919c8f67f3e81a0f58f3...4f23c30ace844cdcd2c59da1a758c8a6788ca6f3,2,2,1,3,2,2013-03-15 14:20:40,2013-03-15 14:20:40
da88fca34c2ffa5259420d244ea6c1313f047186...16c3d7031519b7fd62742b19aa3c006796466e18,1,1,1,2,1,2013-04-25 12:47:04,2013-04-25 12:47:04
da88fca34c2ffa5259420d244ea6c1313f047186...86b939158a515f0ab9c6aed601dfe536176172e0,1,1,1,2,1,2013-04-22 08:48:52,2013-04-22 08:48:52
86b939158a515f0ab9c6aed601dfe536176172e0...cbcfe12f58b815db9b9263b36f1576ae389b7276,1,1,1,2,1,2013-04-22 08:58:42,2013-04-22 08:58:42
cbcfe12f58b815db9b9263b36f1576ae389b7276...5ac5f586f8685368be9adb999297642feca1736e,3,171,2,173,4,2013-04-22 10:44:09,2013-04-22 10:44:09
da88fca34c2ffa5259420d244ea6c1313f047186...1833f8e75f9f44535f34c7a95ea41baa9b4234a1,1,1,1,2,1,2013-04-21 17:08:36,2013-04-21 17:08:36
204bd0b0669c06793d3dad02b23fec258983bb81...793ab5a1abf8085b25ac389fc557958579540588,1,1,2,3,1,2013-05-03 16:13:12,2013-05-03 15:59:26
cec97c27083c00070513914a0063de349f0afcbb...d2c7a75970be4037846019fe612754e87a2140e2,1,1,1,2,1,2012-10-26 21:05:20,2012-10-26 21:05:20
ecdf778e80d3804a076061989b5abb2d6e1e5c19...d4e070cfadcccfe503402dd5d0524ca102d372d4,4,37,23,60,16,2012-10-29 20:40:00,2012-10-29 20:40:00
d4e070cfadcccfe503402dd5d0524ca102d372d4...f417a265d7783cb10e4b55556f5de9fd0a7c9696,9,57,25,82,18,2012-10-29 21:45:11,2012-10-29 21:45:11
643ed9cbf3b0dd09e0ae22df55662d5b33b1d6c7...847bba926929c4d64dcc5065b9b2762a62a87c87,1,47,0,47,1,2012-10-25 22:10:40,2012-10-25 22:10:40
847bba926929c4d64dcc5065b9b2762a62a87c87...78235edda8009e7dcec3f15b3ec79a0c17d9d797,3,85,108,193,4,2012-10-25 22:19:01,2012-10-25 22:19:01
78235edda8009e7dcec3f15b3ec79a0c17d9d797...8778961d33c15938f4ed3de301fd9b865b9299d8,2,20,18,38,8,2012-10-25 22:24:02,2012-10-25 22:24:02
8778961d33c15938f4ed3de301fd9b865b9299d8...35b7a5395524d25e3bb9c20b473f1a1eb6970b6f,1,13,14,27,2,2012-10-25 22:24:16,2012-10-25 22:24:16
35b7a5395524d25e3bb9c20b473f1a1eb6970b6f...8c89beb6f9bca14dd79fb1e0a81ebb65354edf73,3,6,6,12,5,2012-10-25 22:26:47,2012-10-25 22:26:47
8c89beb6f9bca14dd79fb1e0a81ebb65354edf73...55779b00ea695463056338af993c6332b710ea8f,4,46,61,107,5,2012-10-25 22:33:53,2012-10-25 22:33:53
55779b00ea695463056338af993c6332b710ea8f...5f16687805b4daa98f7227849d064345e68210d2,2,7,7,14,7,2012-10-25 22:39:23,2012-10-25 22:39:23
5f16687805b4daa98f7227849d064345e68210d2...fba8ad560797500063df84089a99c24fdc5cacd7,3,42,41,83,3,2012-10-25 22:56:24,2012-10-25 22:56:24
fba8ad560797500063df84089a99c24fdc5cacd7...0e9d4f30f4961cc7ee768995a37c5bf9a123c08a,2,43,18,61,3,2012-10-25 23:32:33,2012-10-25 23:32:33
0e9d4f30f4961cc7ee768995a37c5bf9a123c08a...0ebcc60a33f5aba9e7740f43a108b96461dd3fbf,2,27,22,49,8,2012-10-25 23:44:20,2012-10-25 23:44:20
0ebcc60a33f5aba9e7740f43a108b96461dd3fbf...3080127354a2c92fd3ceecc05fe93e091e3b5eec,1,4,4,8,4,2012-10-25 23:44:50,2012-10-25 23:44:50
3080127354a2c92fd3ceecc05fe93e091e3b5eec...700a784bc91c0ee24cbe2f1c36589e40b92ac28d,2,24,14,38,7,2012-10-25 23:59:50,2012-10-25 23:59:50
700a784bc91c0ee24cbe2f1c36589e40b92ac28d...7192f86ed0e2eec1bee94ee148253c1e65f925e3,1,6,2,8,2,2012-10-26 00:32:17,2012-10-26 00:32:17
7192f86ed0e2eec1bee94ee148253c1e65f925e3...904615c1509b0923ba9b785d41cafcd264952d54,2,9,4,13,4,2012-10-26 00:50:24,2012-10-26 00:50:24
4bc64b5530a45b26a13bf6e71d3b9d41aa1e8f98...83dc5f936290cd928362c56959a40b906a2acd15,1,1,1,2,1,2012-10-22 18:21:34,2012-10-22 18:21:34
83dc5f936290cd928362c56959a40b906a2acd15...42abdf69d59ecf28688af5994ff2e324c50a6d33,5,98,4,102,8,2012-10-22 18:42:06,2012-10-22 18:42:06
b08bb209795dfc4b764679016f43cd483298f52c...bddead9efff5ca6b067d6cda20c224651a443a4b,1,28,11,39,10,2013-01-17 12:19:40,2013-01-17 12:19:40
bddead9efff5ca6b067d6cda20c224651a443a4b...48a5012b211ab2d7938b30e89e878b9212594bf3,1,4,1,5,1,2013-01-17 13:59:05,2013-01-17 13:58:40
b08bb209795dfc4b764679016f43cd483298f52c...4d19a4fbebab7c240834fea73087a61725596932,1,1,1,2,1,2013-01-17 11:24:26,2012-12-10 15:56:12
5c504ed863e6caf04306a2e4bb4954ccdf9d1f77...843ea5bf2239be273e684de4f4d99077c5fa5e0e,1,7,10,17,3,2013-01-17 18:58:29,2013-01-17 18:58:29
85de55a120a615f8cf51a343a89789b802d776e2...0d5a098c1978accd5691acc19b3c2868e8273506,1,2,3,5,3,2013-02-05 07:01:29,2013-02-05 07:01:29
85de55a120a615f8cf51a343a89789b802d776e2...7812cb77c81cb199c7c8fd276130238ccabb856d,1,1,1,2,1,2013-02-05 03:20:04,2013-02-05 03:20:04
7812cb77c81cb199c7c8fd276130238ccabb856d...1e907498a944c22db79e9cfbd26ee7f10fe1a091,2,17,7,24,3,2013-02-05 03:34:35,2013-02-05 03:34:35
1e907498a944c22db79e9cfbd26ee7f10fe1a091...81cc1cb87b2056b11640c9887bd40674c9d7925e,2,48,20,68,9,2013-02-05 03:42:30,2013-02-05 03:42:30
81cc1cb87b2056b11640c9887bd40674c9d7925e...8ff5cf9cd5193b7135f53de3b62dd50bcbbfc2dc,3,22,6,28,5,2013-02-05 10:08:09,2013-02-05 03:46:31
8ff5cf9cd5193b7135f53de3b62dd50bcbbfc2dc...df85c9c06ae3d687bb6ec2f2d11a8ae71fa8ed5f,2,5,2,7,2,2013-02-05 10:08:25,2013-02-05 05:59:13
df85c9c06ae3d687bb6ec2f2d11a8ae71fa8ed5f...9dccecc9b54240a7088ceac554c3f9b6b24d51f7,1,2,2,4,2,2013-02-05 10:58:49,2013-02-05 10:58:49
85de55a120a615f8cf51a343a89789b802d776e2...6b9a60904451fb192e445774768ccb53f7f8d2f8,4,16,302,318,20,2013-02-04 12:28:10,2013-02-04 12:28:10
6b9a60904451fb192e445774768ccb53f7f8d2f8...27d9ac0fe8a33f0e94178c1f46826bc114e16467,9,42,69,111,26,2013-02-04 13:07:56,2013-02-04 13:07:56
27d9ac0fe8a33f0e94178c1f46826bc114e16467...5c6492662ef730eef7a9122f53438c32724ae91d,1,36,90,126,28,2013-02-04 13:18:20,2013-02-04 13:18:20
5c6492662ef730eef7a9122f53438c32724ae91d...896c3a0a9d4c9ccdfab275d772ae5991dd92865e,4,0,24,24,6,2013-02-04 13:24:16,2013-02-04 13:24:16
896c3a0a9d4c9ccdfab275d772ae5991dd92865e...6f7ccea6686d4cc6c6241bc4289c13ff04cc8557,2,7,4,11,4,2013-02-04 14:19:37,2013-02-04 14:19:37
6f7ccea6686d4cc6c6241bc4289c13ff04cc8557...935b6ae6534e77f2b9e84bcb686aeeda88089122,2,25,0,25,2,2013-02-04 15:53:43,2013-02-04 15:53:43
935b6ae6534e77f2b9e84bcb686aeeda88089122...c75fc9c7a692f8b7613ca8824f18e075af785c9b,3,21,24,45,5,2013-02-04 16:18:36,2013-02-04 16:18:36
c75fc9c7a692f8b7613ca8824f18e075af785c9b...f385c7212ebe4a69af05335f223117b740ff9560,1,1,8,9,3,2013-02-05 07:14:35,2013-02-05 07:14:35
f385c7212ebe4a69af05335f223117b740ff9560...12198bee2ff321eed6f2580e40675c4081999d4f,1,5,19,24,6,2013-02-05 07:17:45,2013-02-05 07:17:45
12198bee2ff321eed6f2580e40675c4081999d4f...081c272b85d9344ff3a0b548f8f5eabc60e9a58d,4,4,27,31,7,2013-02-05 08:15:49,2013-02-05 08:15:49
081c272b85d9344ff3a0b548f8f5eabc60e9a58d...39e37677f291c344e25583916a1811a052e38db6,3,10,10,20,7,2013-02-05 09:12:15,2013-02-05 09:12:15
39e37677f291c344e25583916a1811a052e38db6...70e3bffd95eb5736dd108e0836abaa85a2f1c742,9,43,47,90,21,2013-02-05 10:47:50,2013-02-05 10:47:50
70e3bffd95eb5736dd108e0836abaa85a2f1c742...867945d193743ca6abe5064570ae5854a0bf2826,3,6,27,33,8,2013-02-05 11:02:58,2013-02-05 11:02:58
867945d193743ca6abe5064570ae5854a0bf2826...adfd36f26a448d54069713667c488404314c1887,1,0,5,5,1,2013-02-05 11:30:56,2013-02-05 11:30:56
adfd36f26a448d54069713667c488404314c1887...478570dc323e2a92204e1598e0f9232c54661429,1,0,2,2,1,2013-02-05 11:43:25,2013-02-05 11:43:25
478570dc323e2a92204e1598e0f9232c54661429...bd3288e3207c12e90d7fed629b345cfe83018bbf,1,6,0,6,1,2013-02-05 13:55:49,2013-02-05 13:55:49
bd3288e3207c12e90d7fed629b345cfe83018bbf...18fc0900523a850179bb15f8ca73a0bdf8631607,3,0,55,55,3,2013-02-05 13:59:40,2013-02-05 13:59:40
18fc0900523a850179bb15f8ca73a0bdf8631607...48628d31d59f007fbf4b6958eb2a48adedaef8e4,1,3,15,18,4,2013-02-07 07:42:22,2013-02-07 07:42:22
48628d31d59f007fbf4b6958eb2a48adedaef8e4...8ae1d812dc9c8099b691e164e7119ede7eb21c61,1,18,13,31,4,2013-02-07 07:56:13,2013-02-07 07:56:13
8ae1d812dc9c8099b691e164e7119ede7eb21c61...cdcf69d0d9c06bbaf6a6ba25793985fe02dd1092,2,33,1,34,2,2013-02-07 08:06:39,2013-02-07 08:06:39
cdcf69d0d9c06bbaf6a6ba25793985fe02dd1092...d09d87e3b022f6b7cba0988c4377e44196e35939,1,2,2,4,2,2013-02-07 08:25:47,2013-02-07 08:25:47
85de55a120a615f8cf51a343a89789b802d776e2...d223cddc78dd2b256bdea381ab80b0ed4b37fa74,1,1,1,2,1,2013-02-04 11:36:05,2013-02-04 11:36:05
85de55a120a615f8cf51a343a89789b802d776e2...e0d62d9c5fa1145ef5378db07f28c3d399e9c34d,1,1,2,3,1,2013-02-02 20:04:07,2013-02-02 20:04:07
1b25a8f4374363d546d4a58f47c6fe00c3b3af07...cac7723451e575ce39a6930990178450a2a972f0,20,744,821,1565,16,2013-01-02 21:35:11,2013-01-02 21:35:11
cac7723451e575ce39a6930990178450a2a972f0...40a956eb6825f2bbca06e9f24c1fb24dc71a1ecd,5,2,19,21,6,2013-01-02 22:01:08,2013-01-02 22:01:08
40a956eb6825f2bbca06e9f24c1fb24dc71a1ecd...da03a5c7e25601c2bce8375dbbe1cffc58db7bbf,10,58,68,126,20,2013-01-03 07:06:07,2013-01-03 07:06:07
ece563296bcac93ce5918a050a70a95ceba0d7f9...ba25b2dc84cc25e66d6fa1450fee39c9bac002c5,5,38,21,59,17,2012-11-16 10:27:39,2012-11-16 10:27:39
ece563296bcac93ce5918a050a70a95ceba0d7f9...8a2b1369483e175f5ac8b4247852e6ab119db7ae,1,1,1,2,1,2012-11-14 18:33:22,2012-11-14 18:33:22
7528b534c6dcb9124a1045f50eb94ce6dae3f1a7...13dde2e4a4ee7346dc7a5674417cf5a3eb7257fb,2,9,9,18,3,2012-11-09 13:17:50,2012-11-09 13:17:50
13dde2e4a4ee7346dc7a5674417cf5a3eb7257fb...f0712f39fbb75f4a1911a977ba63f9856331eea5,2,2,2,4,2,2012-11-09 13:24:28,2012-11-09 13:24:28
7166739086f161ac0f371903e0130cdb192b9f51...607d8b7970b3bfc007030f978fcee00623cda743,3,12,4,16,3,2012-10-17 12:09:16,2012-10-17 12:09:16
607d8b7970b3bfc007030f978fcee00623cda743...31f1cebe4bc545fc00947475211ab52d84b356ce,3,14,16,30,3,2012-10-17 12:17:27,2012-10-17 12:17:27
31f1cebe4bc545fc00947475211ab52d84b356ce...7a0a552b434243b260733ec3d1cfb069b5beb581,1,0,2,2,1,2012-10-17 12:21:16,2012-10-17 12:21:16
7a0a552b434243b260733ec3d1cfb069b5beb581...8e989d4863d6425f87e3a7230ff86823b6b2e551,4,18,22,40,4,2012-10-17 13:14:20,2012-10-17 13:14:20
8e989d4863d6425f87e3a7230ff86823b6b2e551...a9a3480de97296234fad349fe25aac6f11cf9285,4,7,4,11,5,2012-10-17 19:01:27,2012-10-17 19:01:27
a9a3480de97296234fad349fe25aac6f11cf9285...e0c43c46ddd7f9488ef076e0c91800e43bd376b3,4,10,11,21,8,2012-10-17 19:02:52,2012-10-17 19:02:52
e0c43c46ddd7f9488ef076e0c91800e43bd376b3...db469ea3e69f03f5c1966958041bca91a04686ce,1,16,16,32,6,2012-10-17 19:35:08,2012-10-17 19:35:08
2a750bf2ca649fb7aac6ae352a6eb1c4d7820c9f...8ee8f36f6ea5155037d847d2c0876a363a4c1808,2,1,2,3,2,2012-10-16 20:52:44,2012-10-16 20:52:44
2a750bf2ca649fb7aac6ae352a6eb1c4d7820c9f...30a31d63da9e6d9f9fd1f47f4964a7c9da346f58,2,5,0,5,3,2012-10-16 18:27:44,2012-10-16 18:27:44
30a31d63da9e6d9f9fd1f47f4964a7c9da346f58...789e4b848c097686182367a5dc7220c7749e4ff4,1,1,0,1,1,2012-10-16 18:48:32,2012-10-16 18:48:32
2a750bf2ca649fb7aac6ae352a6eb1c4d7820c9f...fa4c38f32b3ac8aba6411e29ff01dfe8f336981d,3,20,3,23,4,2012-10-16 17:17:48,2012-10-16 17:17:48
4c3cdfa4fffb221d797e35913361bedbe1060d44...8022628f7055afb39af71e90ee5d65313d65ebb7,2,75,1,76,20,2012-12-05 20:50:20,2012-12-05 20:50:20
4c3cdfa4fffb221d797e35913361bedbe1060d44...d1e31bfce96e4d385c1441c43f7d5ec3552731fe,1,0,39,39,1,2012-12-05 16:38:54,2012-12-05 16:38:54
d1e31bfce96e4d385c1441c43f7d5ec3552731fe...95ffe08674787b21172e38f9e1a4b47309c56418,2,31,43,74,18,2012-12-05 16:53:24,2012-12-05 16:53:24
95ffe08674787b21172e38f9e1a4b47309c56418...78d3611eba515beb85b86c1fc238cbbdbb1bc02f,2,2,2,4,2,2012-12-05 17:18:09,2012-12-05 17:18:09
78d3611eba515beb85b86c1fc238cbbdbb1bc02f...7591718ef206fcf3f0c4380b2d8928e1258d37a0,1,11,11,22,10,2012-12-05 17:21:28,2012-12-05 17:21:28
7591718ef206fcf3f0c4380b2d8928e1258d37a0...198e93ccf2b880d9dba52240dc8759b930b4ebf3,2,43,14,57,14,2012-12-05 18:31:08,2012-12-05 18:31:08
198e93ccf2b880d9dba52240dc8759b930b4ebf3...4af26f66f87fb77487c9955e58826344af6d3f66,1,120,108,228,69,2012-12-05 19:34:11,2012-12-05 19:34:11
4af26f66f87fb77487c9955e58826344af6d3f66...0c59de2e71c0cc69b89f206265892d4f5f3ee93d,1,5,0,5,2,2012-12-07 16:28:05,2012-12-07 16:28:05
0c59de2e71c0cc69b89f206265892d4f5f3ee93d...f127382be3113b204c4cd26c0d325150054bcff4,1,5,1,6,1,2012-12-07 16:28:47,2012-12-07 16:28:47
f127382be3113b204c4cd26c0d325150054bcff4...d8a239e4b1418b7681d8a1abad20264573c85f11,1,18,1,19,1,2012-12-07 16:32:38,2012-12-07 16:32:38
e376f3150736e7936082529a3f6c92395f4c9720...61140b71cdc74ee3d9e31bfb62e44fa941b465d3,1,1,1,2,1,2012-12-05 00:22:30,2012-12-05 00:19:58
351390239673923d71610ba320b2bf163ab6f9a9...aa5327a565c4f528760520031089f2a1a68d7535,1,9,1,10,2,2013-03-18 11:22:41,2013-03-18 11:22:41
d747448b8b8534e9c53133afaf0b2b32cc30fee7...748874a09ebc05bdec64b2d8cf333b1a6a061007,1,2,2,4,2,2013-04-26 08:01:52,2013-04-26 08:01:52
5ac5f586f8685368be9adb999297642feca1736e...93dd06fc2d81869a95dc24df004027ba489b3ec0,4,5,1,6,4,2013-04-22 22:59:09,2013-04-22 22:28:30
b5461e0c56fefea1fd307996a1f517899273c920...9214962d2476ba287b76241f4ccc1223cccc0cb1,1,1,0,1,1,2013-05-07 08:20:36,2013-04-23 19:45:59
b5461e0c56fefea1fd307996a1f517899273c920...75fbdc40eb6c46a5a1a5d95a314dad0b3eeda299,1,1,1,2,1,2013-04-23 09:32:02,2013-04-23 09:32:02
7ec1cfd5f5775f176b3bf9f55ac712d332b4c2e3...f58d55da075562f57f7d28c2ba5b347d576a80b8,1,10,0,10,1,2013-04-30 10:28:45,2013-04-30 10:28:45
afc3c216c47d06c6859cac582f1f017ff69203ab...ca244c35cc0145908caa8aaab956f5dc1240aed1,2,26,25,51,3,2013-05-03 21:08:49,2013-05-03 21:08:49
dc9916b474f68a23781df15bee5e814da687ab26...ec7a1c504f2549ed9093d489f395050568f3b2a8,1,1,0,1,1,2012-11-20 22:18:36,2012-11-20 22:18:36
ec7a1c504f2549ed9093d489f395050568f3b2a8...b39002ce8861c1c76806501309ff159d4d65f375,1,1,1,2,1,2012-11-20 22:40:29,2012-11-20 22:40:29
b39002ce8861c1c76806501309ff159d4d65f375...3ab33fcfca85e65931844124bda83148b6e27f69,1,12,5,17,5,2012-11-21 07:04:32,2012-11-21 07:04:32
3ab33fcfca85e65931844124bda83148b6e27f69...c1c1a1eeeecaadfd68a586adb8d6fd4daab4064f,3,12,6,18,8,2012-11-21 07:14:15,2012-11-21 07:14:15
c1c1a1eeeecaadfd68a586adb8d6fd4daab4064f...d18e2bd59d3003e2ae38116688e350bfc2774ae7,2,7,11,18,2,2012-11-21 03:14:05,2012-11-21 03:14:05
d18e2bd59d3003e2ae38116688e350bfc2774ae7...898d09a21ef3bf937d0b9379dd13c917b553e859,4,26,13,39,7,2012-11-21 10:45:15,2012-11-21 10:45:15
898d09a21ef3bf937d0b9379dd13c917b553e859...a0f2f05e50312efcbf878f877fcde7888a52e3e1,1,1,1,2,1,2012-11-21 10:52:55,2012-11-21 10:52:55
a0f2f05e50312efcbf878f877fcde7888a52e3e1...cc5391515a71956820723a77ec121c4ab1abc626,2,25,2,27,4,2012-11-21 11:27:11,2012-11-21 11:27:11
50a6c614b5a9eeb2faae2c5a2a71365b7d35d41a...0a9adbbe4a049e0af405feb1e5ce80b28bbbd292,1,2,2,4,2,2012-10-29 20:51:28,2012-10-29 20:51:28
42abdf69d59ecf28688af5994ff2e324c50a6d33...e51b2d58e7e751b62d1d924e3c494117fd9d0604,12,59,23,82,20,2012-10-22 20:37:50,2012-10-22 20:37:50
e51b2d58e7e751b62d1d924e3c494117fd9d0604...9902f1af6edc0b6c0a935fb3578715d20636d76e,1,5,0,5,1,2012-10-22 20:49:21,2012-10-22 20:49:21
9902f1af6edc0b6c0a935fb3578715d20636d76e...b2df61d85ab295a9ba4585f667537a9afc3efc6a,2,3,1,4,2,2012-10-23 08:29:47,2012-10-23 08:29:47
b2df61d85ab295a9ba4585f667537a9afc3efc6a...e09bff082eade2ce35e6ef8af3e265b37f6a0483,1,4,0,4,1,2012-10-24 08:28:32,2012-10-24 08:28:32
e09bff082eade2ce35e6ef8af3e265b37f6a0483...9f7ba5bca06e4c3d1f9880ba8c13ba9408ed2947,1,1,1,2,1,2012-10-24 09:40:08,2012-10-24 09:39:53
9f7ba5bca06e4c3d1f9880ba8c13ba9408ed2947...012d62b19828ab1f94ae743c92233f48c714cf8b,2,6,1,7,2,2012-10-24 09:41:47,2012-10-24 09:41:47
42abdf69d59ecf28688af5994ff2e324c50a6d33...bd049e5e7c80259689eb4494a3e7eea4bd5a66b0,3,38,0,38,3,2012-10-22 20:09:21,2012-10-21 11:00:27
bd049e5e7c80259689eb4494a3e7eea4bd5a66b0...fe59547ae5b272a183253c31e5273d52d0a02381,1,11,1,12,1,2012-10-22 20:09:21,2012-10-21 11:41:06
fe59547ae5b272a183253c31e5273d52d0a02381...5a89934af8bd09d40c01c940b2305f95374be1bd,1,11,1,12,1,2012-10-22 20:09:21,2012-10-21 11:59:50
5a89934af8bd09d40c01c940b2305f95374be1bd...524b907042c36d832b82d980c9fee85e6d92b6da,1,4,8,12,4,2012-10-22 20:09:21,2012-10-21 12:33:02
524b907042c36d832b82d980c9fee85e6d92b6da...b32a8eea939930cd49141526b5fec19c747c561d,1,11,1,12,4,2012-10-22 20:09:21,2012-10-21 13:13:39
b32a8eea939930cd49141526b5fec19c747c561d...93e8d426c5efc21b73627110ebed08b82a7031ce,2,17,0,17,2,2012-10-22 20:09:21,2012-10-21 16:48:56
93e8d426c5efc21b73627110ebed08b82a7031ce...6ffd2f3db61a9213677c765eb9f6e76e644a9a2f,1,2,2,4,2,2012-10-22 20:09:21,2012-10-22 18:59:46
6ffd2f3db61a9213677c765eb9f6e76e644a9a2f...77bc1101074fe6458f0b0beaf19ef6663f735806,2,248,6,254,7,2012-10-22 20:09:21,2012-10-22 19:53:06
77bc1101074fe6458f0b0beaf19ef6663f735806...e6cdfb607a3ac87d110d5d200b5900f531d1669e,3,72,10,82,11,2012-10-25 10:13:01,2012-10-25 10:13:01
e6cdfb607a3ac87d110d5d200b5900f531d1669e...56bf829c753662a880805b278cae87d9cd1aa3ac,1,6,6,12,6,2012-10-25 10:19:18,2012-10-25 10:19:18
56bf829c753662a880805b278cae87d9cd1aa3ac...4281de3640dabe6b913b6b0dc3273d52b6906021,2,4,4,8,4,2012-10-25 10:38:55,2012-10-25 10:38:55
48a5012b211ab2d7938b30e89e878b9212594bf3...bc59fd046f9f786c8bbc5512a9177359b384b329,2,46,5,51,4,2013-01-17 20:19:36,2013-01-17 20:19:36
bc59fd046f9f786c8bbc5512a9177359b384b329...b7457f39b48a067fe142be5486895dc08224963f,1,0,13,13,1,2013-01-17 20:20:18,2013-01-17 20:20:18
b7457f39b48a067fe142be5486895dc08224963f...65c35466b695b06807c997859ce4ca5b515b6550,2,17,19,36,5,2013-01-17 20:26:22,2013-01-17 20:26:22
843ea5bf2239be273e684de4f4d99077c5fa5e0e...2e9c0e2b47ab1813a96af7afa08f4449eb4e2c2d,5,15,10,25,11,2013-01-17 20:35:45,2013-01-17 20:35:45
843ea5bf2239be273e684de4f4d99077c5fa5e0e...f65713dfa673f8b01602f01310956b64baf22d86,1,4,0,4,1,2013-01-17 19:35:35,2013-01-17 19:35:35
f2cac135d535cb0926b49f2aded21ee89475c755...c08f19f275182a24fa675c31d630126c75b50af9,1,1,0,1,1,2013-02-26 09:09:32,2013-02-26 09:09:32
d7b667fee238cfd457bdc143a37585ac931cf4ad...5ac5510fd68fa060986733c07421d8411731ee24,2,2,2,4,2,2013-02-26 08:47:27,2013-02-26 08:47:27
0a20f7e75e6aed0e52d5bf747f4b2bf17ec61b0b...1b4ba3eb99e30bded9bffea20c457af5e08a58f2,2,18,1,19,2,2013-02-06 11:44:09,2013-02-06 11:44:09
1b4ba3eb99e30bded9bffea20c457af5e08a58f2...f339af858b25cc32ac1bc0c46add29a6a3f43b51,1,48,0,48,1,2013-02-11 12:06:37,2013-02-11 12:06:37
f339af858b25cc32ac1bc0c46add29a6a3f43b51...483f720861e7aa018b581dce7bb52d4650405edf,1,1,1,2,1,2013-02-11 12:12:41,2013-02-11 12:12:41
ddea7d1689e1bbe62d6f226986e51ce7a0eb835d...622dae76cc0e9e3c76c5d2ba18efeb139644881e,2,15,7,22,4,2013-02-12 17:22:40,2013-02-12 17:22:40
4e1757bfda0530238e3ab4208b47789e196d5602...210e9cd489bc0c413474ad347e6ce065f3ec7c81,2,4,1,5,2,2013-02-07 11:05:30,2013-02-07 11:05:30
210e9cd489bc0c413474ad347e6ce065f3ec7c81...66121d6caabb7f5169e4fc21e6bb8938a5ec14b5,4,20,21,41,17,2013-02-07 11:20:33,2013-02-07 11:20:33
428af5ea62ef89dc5e2c2bddb6c910df24dace79...f9dd547aa7289c59a389ce1393c4b3eb4e0239f4,1,1,1,2,1,2013-02-15 07:16:46,2013-02-15 07:16:46
428af5ea62ef89dc5e2c2bddb6c910df24dace79...08dfbc962b9263662a188cbd71ebf39e6223e721,1,2,2,4,2,2013-02-14 21:39:48,2013-02-14 21:39:48
08dfbc962b9263662a188cbd71ebf39e6223e721...4bc7d98d65a84d037d6d8ddc807cdf0ceeb5a456,2,13,7,20,9,2013-02-14 23:10:18,2013-02-14 23:10:18
a1999955eb0b212c818a383bc54f8392194d0bc1...e65731bb7ebf58366c185a10e50ec1db6eb495c4,2,2,2,4,2,2013-01-03 07:12:24,2013-01-03 07:12:24
e65731bb7ebf58366c185a10e50ec1db6eb495c4...ce84e3f440e5f737ca808fd88cf54caefeda6b81,5,51,4,55,6,2013-01-03 07:37:13,2013-01-03 07:37:13
ce84e3f440e5f737ca808fd88cf54caefeda6b81...d6036f08aa94fa5a45b569fc8b9e80f064496bcf,3,8,4,12,3,2013-01-03 07:52:14,2013-01-03 07:52:14
d6036f08aa94fa5a45b569fc8b9e80f064496bcf...2095780f24db7c75f5a004654ae2e4052fe16bdd,1,3,3,6,3,2013-01-03 10:37:12,2013-01-03 10:37:12
5e262cf4fdefcd409952c175d09119a1770fe6ee...0e9794ca5d04b69d347c14ac6e5a273da6bea8b0,1,3,1,4,1,2012-11-16 10:47:09,2012-11-16 10:47:09
0e9794ca5d04b69d347c14ac6e5a273da6bea8b0...5d9788b05cc72858c3bdcd4c9b3f0beae4e91e7b,1,2,1,3,1,2012-11-16 10:54:35,2012-11-16 10:54:35
5d9788b05cc72858c3bdcd4c9b3f0beae4e91e7b...c7aeb5127e3e7e852ed76096ad90a68ebd1195fa,1,1,2,3,1,2012-11-16 11:03:07,2012-11-16 11:03:07
f0712f39fbb75f4a1911a977ba63f9856331eea5...12c0408ef5e09244a1716dd4e13986c9c5224b76,1,1,1,2,1,2012-11-09 16:03:42,2012-11-09 16:03:42
db469ea3e69f03f5c1966958041bca91a04686ce...853c69c48a1641ad742cf9f70326fc93c44ea58d,1,66,35,101,12,2012-10-17 23:14:09,2012-10-13 18:55:50
853c69c48a1641ad742cf9f70326fc93c44ea58d...413778b6458c71706685150f191becee5d398391,2,51,27,78,31,2012-10-17 23:14:10,2012-10-13 20:46:27
db469ea3e69f03f5c1966958041bca91a04686ce...b42c53c2e592e076a63d12e6c9d1a158a9c01212,2,3,0,3,3,2012-10-17 23:10:35,2012-10-16 14:20:16
b42c53c2e592e076a63d12e6c9d1a158a9c01212...5d42d92c870b80ebccb4def8f6cb185c2badb17f,848,0,4,4,1,2012-10-17 23:10:35,2012-10-16 14:26:17
5d42d92c870b80ebccb4def8f6cb185c2badb17f...ce91014730e59101af3dd52ae7cd6f3070954fa4,2,2,2,4,2,2012-10-17 23:10:35,2012-10-16 14:26:40
db469ea3e69f03f5c1966958041bca91a04686ce...883d138f15610a831ec8f5bf9d9ec640b6df140d,1,1,1,2,1,2012-10-17 20:59:42,2012-10-17 20:59:42
d21443d1c6e8acd36f579e290c8b8cdcf70546fb...ec05d9daf92ea1df8354dfb2c9cdcaea3d38b617,1,1,1,2,1,2012-10-16 21:13:45,2012-10-16 21:13:37
ec05d9daf92ea1df8354dfb2c9cdcaea3d38b617...234eb7a8e4de164a10f66ae388f4155310bfe659,1,1,1,2,1,2012-10-16 21:15:56,2012-10-16 21:15:49
234eb7a8e4de164a10f66ae388f4155310bfe659...372220d35b344a43352e2176dfb4c377a53f0930,1,1,2,3,2,2012-10-16 21:27:47,2012-10-16 21:27:47
8022628f7055afb39af71e90ee5d65313d65ebb7...9b9650989905b33e74aa7441a97e4242fae4b277,1,2,1,3,1,2012-12-06 10:08:51,2012-12-06 10:08:51
8022628f7055afb39af71e90ee5d65313d65ebb7...b39aba73d51000d83914894857c9db38c277970f,2,78,0,78,2,2012-12-05 21:06:47,2012-12-05 17:27:54
aa5327a565c4f528760520031089f2a1a68d7535...0eccc08015681f882561581d4603466512037f6c,2,25,24,49,3,2013-03-18 17:22:15,2013-03-18 17:22:15
0eccc08015681f882561581d4603466512037f6c...0c884498d2efa02432d553ddb51361e7ba59da8f,14,15,13,28,13,2013-03-18 17:35:27,2013-03-18 17:35:27
0c884498d2efa02432d553ddb51361e7ba59da8f...6956f1f6e1844c683336eea03d090ed3f306a3f7,2,131,102,233,2,2013-03-18 18:50:41,2013-03-18 18:50:41
aa5327a565c4f528760520031089f2a1a68d7535...a0f2fbc25094066995aefe7c3ad6b0f0de8e5fe3,1,2,3,5,1,2013-03-18 11:44:26,2013-03-18 11:44:26
a0f2fbc25094066995aefe7c3ad6b0f0de8e5fe3...0f39610532238468a0d058c4df5e6433807fdbd1,1,13,10,23,9,2013-03-18 12:07:04,2013-03-18 12:07:04
b536acc92ad86754fc85dc7c08455762ffb83ad4...79c4fd7a7d3ac17e7f324d001af47c15b89f0cc0,1,5,1,6,2,2013-04-26 09:43:52,2013-04-26 09:25:04
b536acc92ad86754fc85dc7c08455762ffb83ad4...40b949abab1cd3872deae08b0f257189c4b00323,1,13,13,26,8,2013-04-26 09:26:39,2013-04-01 16:51:05
6d204544a1fb15b4c8d5abc36a291649e480a116...25d5c1f63714d28a331095cf5b03fa577d3734d1,1,6,1,7,1,2013-05-08 18:27:43,2013-05-08 18:27:43
75fbdc40eb6c46a5a1a5d95a314dad0b3eeda299...529376bb0b42a68fb9b459203efd547c3931861c,2,2,0,2,2,2013-04-24 17:40:09,2013-04-24 07:31:36
75fbdc40eb6c46a5a1a5d95a314dad0b3eeda299...d7edceec739cbfd87044e63033430f487c8799c4,1,2,1,3,1,2013-04-24 15:33:27,2013-04-24 15:33:27
75fbdc40eb6c46a5a1a5d95a314dad0b3eeda299...63b58b9491badf4fe5fa79a32c6ad77be2bf3c25,2,11,3,14,4,2013-04-24 15:06:31,2013-04-24 15:06:31
63b58b9491badf4fe5fa79a32c6ad77be2bf3c25...85c468ec480a1541de36da07fc5fb4ca73c9ad5e,1,55,27,82,24,2013-04-25 09:29:26,2013-04-24 16:49:01
85c468ec480a1541de36da07fc5fb4ca73c9ad5e...b36b40ca40c1a380e74ac5384ef40938323307a8,1,1,1,2,1,2013-04-25 20:53:40,2013-04-25 12:53:30
b36b40ca40c1a380e74ac5384ef40938323307a8...963ec23407760bcd86ac989916140b1e8f6d5c0c,2,15,4,19,6,2013-04-25 20:54:00,2013-04-25 13:05:22
963ec23407760bcd86ac989916140b1e8f6d5c0c...05c2c15cd1672a46e2b31e2ba1e71b872e8993e3,2,11,4,15,2,2013-04-25 20:54:00,2013-04-25 19:58:25
75fbdc40eb6c46a5a1a5d95a314dad0b3eeda299...d51618b9a1ca72e294a264739764a5d7d3727ac3,2,13,0,13,2,2013-04-24 11:57:08,2013-04-24 10:12:56
d51618b9a1ca72e294a264739764a5d7d3727ac3...7907bc819c8492c4bd04090bd267cea568393ea1,1,5,2,7,1,2013-04-24 11:57:18,2013-04-24 11:49:29
7907bc819c8492c4bd04090bd267cea568393ea1...f5b549af2545942c925c92cb148e5ad5efd459b1,2,4,4,8,2,2013-04-26 08:02:00,2013-04-26 08:02:00
75fbdc40eb6c46a5a1a5d95a314dad0b3eeda299...d4688af39c7b75b605dd3386f95e996b908983e7,5,93,0,93,4,2013-04-23 20:30:50,2013-04-23 20:30:50
75fbdc40eb6c46a5a1a5d95a314dad0b3eeda299...2ad723e1c19fbced977964a055adeb4cd1dc5995,1,2,2,4,2,2013-04-23 20:14:13,2013-04-23 19:30:32
561ac35553d23d000f75cda4450dba94e84053dc...3f462878428b4d9731e54f3b20166beb09fb77e7,2,6,3,9,4,2013-04-30 11:49:35,2013-04-30 11:49:35
ca244c35cc0145908caa8aaab956f5dc1240aed1...493b5ff011d5788f669adabf978a40b49b8cf6a3,1,18,0,18,1,2013-05-05 09:48:32,2013-05-05 09:48:32
ca244c35cc0145908caa8aaab956f5dc1240aed1...93dccb7298b59929d2a7e56479f867efeb66c61a,1,1,1,2,1,2013-05-04 19:39:53,2013-05-04 19:39:53
ca244c35cc0145908caa8aaab956f5dc1240aed1...439cd3ebd3613825fc426238770f522a9401d51e,9,57,34,91,18,2013-05-04 03:26:43,2013-05-03 15:39:18
2fc236177f70244101b285bde8ee6a77f779c0ce...ccd181d7c5bde22cbdaf93f3c5b60f4e938d22f6,1,1,1,2,1,2013-05-03 08:03:49,2013-05-03 08:03:49
2fc236177f70244101b285bde8ee6a77f779c0ce...fc180a19c23c552a41e329d484967e1a09e4a846,1,2,2,4,2,2013-05-03 07:48:14,2013-05-03 07:48:14
2fc236177f70244101b285bde8ee6a77f779c0ce...895b16eac854ead0c4bbd613abc3e4ed066f3561,1,1,1,2,1,2013-05-03 07:14:44,2013-05-03 07:14:44
cc5391515a71956820723a77ec121c4ab1abc626...8c5b79a923770195d5c6cb73ac1451df81351910,2,3,2,5,3,2012-11-21 12:30:35,2012-11-21 12:21:12
cc5391515a71956820723a77ec121c4ab1abc626...6bf656970d9e4ccb1a46c78917844de6d72aad89,8,66,73,139,26,2012-11-21 05:14:05,2012-11-21 05:14:05
13e72f5a6ffa7332488ad495610971e540ea3fd1...2f5e44a02d536b6c05a278ac63b022c9cae1fbfd,1,1,1,2,1,2012-10-27 15:00:51,2012-10-27 15:00:51
2f5e44a02d536b6c05a278ac63b022c9cae1fbfd...17cec0508776ee577b67b2542f8757accef32c79,4,10,12,22,8,2012-10-27 15:54:24,2012-10-27 15:35:15
13e72f5a6ffa7332488ad495610971e540ea3fd1...c370c1b389fe4411b2c1740c23fb7396aa5e9698,1,1,1,2,1,2012-10-27 14:12:01,2012-10-27 14:12:01
e705344daa78d256279c7a25958766e3ed19d9fd...a8398e5124fe14d211e2c1aaadb5109cfa1d7b8c,1,1,1,2,1,2012-10-29 21:50:35,2012-10-29 21:50:35
a8398e5124fe14d211e2c1aaadb5109cfa1d7b8c...9d56c7f6571bf2c4d8650cb07d070f90b79a6c5e,1,1,1,2,1,2012-10-29 22:29:13,2012-10-29 22:29:13
9d56c7f6571bf2c4d8650cb07d070f90b79a6c5e...53a3be03fc5a118991eb3903c1e763135187ef3c,1,1,1,2,1,2012-10-29 22:32:32,2012-10-29 22:32:32
53a3be03fc5a118991eb3903c1e763135187ef3c...e4cf99db4615f406dfc60bfc8bca473581b4f910,7,39,10,49,8,2012-10-30 07:22:24,2012-10-30 07:22:24
e4cf99db4615f406dfc60bfc8bca473581b4f910...36dbac2fd90c12a74781c9982db8f18bae938265,5,49,65,114,8,2012-10-30 08:03:21,2012-10-30 08:03:21
36dbac2fd90c12a74781c9982db8f18bae938265...37e39e4176757019fb6e9d437b86229497e63b57,2,54,83,137,2,2012-10-30 11:04:56,2012-10-30 11:04:56
37e39e4176757019fb6e9d437b86229497e63b57...8272e18e57fd93e9adac789353a5b3640d781041,1,4,2,6,1,2012-10-30 11:27:15,2012-10-30 11:27:15
8272e18e57fd93e9adac789353a5b3640d781041...404040d7ae01d1542acc998d6dd4467fb7f049c4,1,0,0,0,0,2012-10-30 11:35:57,2012-10-30 11:35:57
012d62b19828ab1f94ae743c92233f48c714cf8b...fd0aca122545bf7e4911f45aaff7bcd960accc7b,5,58,3,61,7,2012-10-24 11:20:53,2012-10-24 11:20:53
fd0aca122545bf7e4911f45aaff7bcd960accc7b...b7a9e41bd269e2b5519928c35592aad96d3707c6,2,57,11,68,3,2012-10-24 11:52:17,2012-10-24 11:52:17
b7a9e41bd269e2b5519928c35592aad96d3707c6...6f4576b7436ff4573b28ab8305796e96bb2aed29,3,28,1,29,3,2012-10-24 12:23:04,2012-10-24 12:23:04
012d62b19828ab1f94ae743c92233f48c714cf8b...2d7062d8fc5d4fc8fb8aba83947de7955cd41e3c,1,1,1,2,1,2012-10-24 11:06:10,2012-10-24 11:06:10
309e2ceaf85929cc1d8dceaa24620cc1bdae0ede...bf753e99e7d2ba876a62cb5f163375e8fc5fd004,2,6,4,10,5,2013-01-17 20:54:02,2013-01-17 20:53:40
15b121d603db92fe8f08bfb5e55530630e3da18c...115454f3ed35d136c2edd77296ffff97570a6822,5,14,5,19,7,2013-02-28 15:46:28,2013-02-28 15:46:28
c08f19f275182a24fa675c31d630126c75b50af9...3b548d925176791958a12324ab27ad457b110068,3,7,4,11,6,2013-02-26 20:31:45,2013-02-26 20:31:45
c08f19f275182a24fa675c31d630126c75b50af9...15c0e58a49d623a0f8747e1d7e74364324eeb79f,3,0,42,42,4,2013-02-26 09:11:43,2013-02-26 09:11:43
15c0e58a49d623a0f8747e1d7e74364324eeb79f...9c252a60c195cb348c9776f40ca2c6b1f33723f9,2,0,21,21,3,2013-02-26 09:17:02,2013-02-26 09:17:02
9c252a60c195cb348c9776f40ca2c6b1f33723f9...2c5e4955c020eb8d5a28a48d6adc375c327523ac,2,35,2,37,3,2013-02-26 20:53:46,2013-02-26 20:53:46
2c5e4955c020eb8d5a28a48d6adc375c327523ac...4e5164338a77894c68816bc1e7eec018aea8301c,2,109,0,109,2,2013-02-26 20:53:59,2013-02-26 20:53:59
4e5164338a77894c68816bc1e7eec018aea8301c...0cf0487d65a482b1e9d8dfe69899e333216a387c,2,11,2,13,2,2013-02-26 21:04:14,2013-02-26 21:04:14
0cf0487d65a482b1e9d8dfe69899e333216a387c...cba6e9243620e2ddcb15c749d626156c5ce1c063,2,38,26,64,3,2013-02-26 21:14:32,2013-02-26 21:14:32
cba6e9243620e2ddcb15c749d626156c5ce1c063...135418dcbf72d264a846649b95ea8e6d8a2aadcf,1,1,1,2,1,2013-02-27 06:24:12,2013-02-27 06:24:12
06dd530edecf90711c5bf7fe6918729a0096a572...4c0c90865502e5a1c22933e51e53a1625d0bd61a,1,6,1,7,1,2013-02-12 15:01:55,2013-02-12 15:01:55
4bfb98ddc90bcc6076e2819619fec7607e74358b...4ce3ef41deb59e5ff9da6f879c27d65677997477,1,3,3,6,3,2013-02-06 13:50:35,2013-02-06 13:50:35
4ce3ef41deb59e5ff9da6f879c27d65677997477...c9777518e3455913389128a272e0c3e6c0a74d63,1,3,3,6,3,2013-02-06 14:26:46,2013-02-06 14:26:46
c9777518e3455913389128a272e0c3e6c0a74d63...6474797d1cc48d1a9fb0659b1b28cc27580558a1,1,1,1,2,1,2013-02-06 14:27:09,2013-02-06 14:27:09
66121d6caabb7f5169e4fc21e6bb8938a5ec14b5...d4c24b990fd05409749f06f81c23920277761539,1,1,1,2,1,2013-02-07 17:53:37,2013-02-07 17:53:37
f9dd547aa7289c59a389ce1393c4b3eb4e0239f4...836b561a12a6954c5bbc87bc8fbc0f51636f71c5,1,65,0,65,1,2013-02-15 19:35:03,2013-02-15 19:35:03
836b561a12a6954c5bbc87bc8fbc0f51636f71c5...5a906b1d12899675e1a2932beb29d6cfc10539c7,1,31,0,31,1,2013-06-05 14:32:22,2013-06-05 14:32:22
f9dd547aa7289c59a389ce1393c4b3eb4e0239f4...bbd1bfd1558c32a4210a554e5e6fcc35d58e4052,1,1,1,2,1,2013-02-15 14:37:06,2013-02-15 14:37:06
f9dd547aa7289c59a389ce1393c4b3eb4e0239f4...a1d106110d81eee71afb4563bce2ee88ff27a70e,1,1,1,2,1,2013-02-15 13:00:15,2013-02-15 12:58:57
a1d106110d81eee71afb4563bce2ee88ff27a70e...20868acc96f953a86d17e47787638981be89389b,1,1,1,2,1,2013-02-15 13:50:42,2013-02-15 13:50:42
f9dd547aa7289c59a389ce1393c4b3eb4e0239f4...6178964929047c71ec4b49e545c59ce3a4caaf81,1,2,2,4,2,2013-02-15 09:52:10,2013-02-15 09:52:10
6178964929047c71ec4b49e545c59ce3a4caaf81...46f7b7c1f2be9ecbc2d81c886212dcd81629700e,1,3,1,4,1,2013-02-15 09:53:35,2013-02-15 09:53:35
46f7b7c1f2be9ecbc2d81c886212dcd81629700e...cdf95f1ce6992cd9252ed9113d4aa6afd2478e42,1,11,14,25,8,2013-02-15 10:20:50,2013-02-15 10:20:50
cdf95f1ce6992cd9252ed9113d4aa6afd2478e42...b65e5b1e969187b300561af6cfcdcfe39fc0c867,1,1,1,2,1,2013-02-16 05:50:41,2013-02-16 05:50:41
b65e5b1e969187b300561af6cfcdcfe39fc0c867...a53f687fe6876c4db8c790f933dfac9e0c3fafa4,1,12,8,20,9,2013-02-16 06:24:36,2013-02-16 06:24:36
e65cc4f849174e2767f2121120ea8f1880c3d6d2...b7297285369171c95b006e49d6da7bc84b969fc8,5,10,7,17,5,2013-02-16 12:42:22,2013-02-16 12:42:22
2095780f24db7c75f5a004654ae2e4052fe16bdd...e6c0673ef1108a93928c4d88ba273e12616b836b,5,157,1,158,5,2013-01-03 17:11:14,2013-01-03 17:11:14
2095780f24db7c75f5a004654ae2e4052fe16bdd...6b9177ca0209b78398edb409f11bb7b4f5db7ca3,2,12,10,22,9,2013-01-03 14:36:50,2012-12-07 00:51:49
b339c747a9943e9961239a234dcd6e16566a53e1...3ac1f9459a481fa77be2c0c1b68d4f1ccc5fe9f9,5,102,49,151,32,2012-11-18 16:41:41,2012-11-18 16:41:41
b339c747a9943e9961239a234dcd6e16566a53e1...6c1b44859d3ddddfbec619ef71f63a4084f5f6dd,2,5,2,7,4,2012-11-17 00:00:26,2012-11-17 00:00:26
6c1b44859d3ddddfbec619ef71f63a4084f5f6dd...7caf4de2cf1095bce65386d4c1bc7df604a09ae6,1,4,1,5,2,2012-11-17 14:28:32,2012-11-17 14:28:32
7caf4de2cf1095bce65386d4c1bc7df604a09ae6...98e938bdb0049ee4e25b0aac41ce3c3489735052,2,58,14,72,9,2012-11-17 14:43:13,2012-11-17 14:43:13
b339c747a9943e9961239a234dcd6e16566a53e1...31bf0cd8763b01ec028f8cd5eeaee43c745ad7c6,3,4,4,8,3,2012-11-16 18:31:17,2012-11-16 18:31:17
5b66e08ae539e24cc309b3ad8b85bc9e22ab41f5...b664b784f16f5f0fca295af538483bb83c20f98f,1,1,8,9,2,2012-11-09 17:06:20,2012-11-09 17:06:20
b664b784f16f5f0fca295af538483bb83c20f98f...6cec9ed3283a611a40b6df981ed00ccaa1bd0e73,1,4,10,14,4,2012-11-09 17:36:55,2012-11-09 17:36:55
c0073254510f4dd033b3c313f90ec7653e5db4bb...51ef5b929708d3ad90b6db6afbb78ee24eeb8aa1,1,1,0,1,1,2012-10-18 10:00:43,2012-10-18 10:00:43
9b9650989905b33e74aa7441a97e4242fae4b277...55f776f095cdab330d418db3b4590c62cc975658,1,7,25,32,9,2012-12-06 14:54:53,2012-12-06 14:54:53
9b9650989905b33e74aa7441a97e4242fae4b277...c338321695470eccf1b2f96348b9e57b894a5c2a,2,3,3,6,3,2012-12-06 14:42:08,2012-12-06 14:42:08
f2c89c7c903b76e0a84385fa8d7761d28c2093a7...07e4a12a095000ac9a062db566573ebb66efabb7,1,1,1,2,1,2012-12-06 19:38:38,2012-12-06 19:38:38
f2c89c7c903b76e0a84385fa8d7761d28c2093a7...32d9c223a5fd247652c685fb62781c08987b006b,1,1,1,2,1,2012-12-06 19:10:42,2012-12-06 19:10:42
db7e0bf88d0d77b187a4dcf58e49d252be554568...80e984ee5e6d29431a4a87ed26105fb0e8987ffb,2,8,6,14,3,2012-12-08 18:48:33,2012-12-08 18:48:33
80e984ee5e6d29431a4a87ed26105fb0e8987ffb...8a08fdcd32ec58bc538ce5b6fc9df3fbe61d05e1,2,11,6,17,5,2012-12-09 08:34:46,2012-12-09 08:34:46
8a08fdcd32ec58bc538ce5b6fc9df3fbe61d05e1...f4d9059b7e2d1750abbe3ff9a41d3e854df68ffb,3,12,3,15,4,2012-12-09 08:56:15,2012-12-09 08:56:15
f4d9059b7e2d1750abbe3ff9a41d3e854df68ffb...f1dfc27c5dad642d2d2c446f1a3fd865464b6fa6,2,2,2,4,2,2012-12-09 14:03:24,2012-12-09 14:03:24
f1dfc27c5dad642d2d2c446f1a3fd865464b6fa6...a76a34dd1d0719521790eb8bd30cd368dc7a331c,1,1,1,2,1,2012-12-09 14:05:24,2012-12-09 14:05:24
a76a34dd1d0719521790eb8bd30cd368dc7a331c...2b79706d6d3c4f39f3eb11508ca59c5f6f1caa4f,1,35,37,72,18,2012-12-10 00:08:34,2012-12-10 00:08:34
db7e0bf88d0d77b187a4dcf58e49d252be554568...f8144bd37766fbd815ccc6d7de6b48f17d3fbf65,1,5,0,5,2,2012-12-08 10:42:38,2012-12-08 10:42:38
f8144bd37766fbd815ccc6d7de6b48f17d3fbf65...3a481777629e3280b48b55deb287dca02ee389e6,1,1,0,1,1,2012-12-08 16:35:10,2012-12-08 16:34:24
6956f1f6e1844c683336eea03d090ed3f306a3f7...ae06a0aab8be3ea3bad8066d2e19c12d86b85ad8,12,25,62,87,18,2013-03-18 20:43:14,2013-03-18 20:43:14
ae06a0aab8be3ea3bad8066d2e19c12d86b85ad8...112dc875ba325cfb0b223165c20d8424698e7791,3,34,1,35,3,2013-03-18 21:08:54,2013-03-18 21:08:54
112dc875ba325cfb0b223165c20d8424698e7791...b765a7958d5d8602d0f8cc3b23b07cfa4f304208,7,25,3,28,10,2013-03-18 21:33:41,2013-03-18 21:33:41
b765a7958d5d8602d0f8cc3b23b07cfa4f304208...747292e2d33ec77219be584fa55fc67c08f008b2,1,6,5,11,2,2013-03-18 21:38:16,2013-03-18 21:38:16
747292e2d33ec77219be584fa55fc67c08f008b2...7587a3b2fc0e0a3e39e969172f00391c2053e8b9,1,1,1,2,1,2013-03-18 21:44:57,2013-03-18 21:44:57
6956f1f6e1844c683336eea03d090ed3f306a3f7...28e7d1a8bf3ef172331125cf56d92af85ea5e8b2,5,16,4,20,7,2013-03-18 20:11:28,2013-03-18 20:11:28
28e7d1a8bf3ef172331125cf56d92af85ea5e8b2...a15fe61fb041ae7c2704bde6d73c246b85d618f7,3,17,2,19,5,2013-03-19 04:47:08,2013-03-18 21:06:24
316cf61965f70e90fb158e6172e2859f2535f46b...72db22d385ad98eea44bdc880ca08c95f867241e,2,5,0,5,2,2013-03-20 07:53:39,2013-03-20 07:53:39
72db22d385ad98eea44bdc880ca08c95f867241e...6347e9a60bd3c00a6a6616756ecc398079775fb2,2,14,1,15,2,2013-03-20 08:19:00,2013-03-20 08:19:00
6347e9a60bd3c00a6a6616756ecc398079775fb2...51b1859e49ae7eddfb9eafc5ad3531cb2772bf38,1,1,6,7,1,2013-03-20 08:25:11,2013-03-20 08:25:11
51b1859e49ae7eddfb9eafc5ad3531cb2772bf38...3d9bd6e3e77a4f3664001582dfb133e869f23d9c,1,1,1,2,1,2013-03-20 11:41:18,2013-03-20 11:41:18
3d9bd6e3e77a4f3664001582dfb133e869f23d9c...9d0607440968550be8b2e0e170d09b0b0500d592,1,1,1,2,1,2013-03-20 11:49:32,2013-03-20 11:49:32
9d0607440968550be8b2e0e170d09b0b0500d592...c71a7896b1d5ac23785393b486d64902af56d33e,1,1,2,3,1,2013-03-20 14:41:59,2013-03-20 14:41:59
c71a7896b1d5ac23785393b486d64902af56d33e...a0cc38827fe44a91c3538ef34a6cd9ff8e3bc4d7,1,0,2,2,1,2013-03-20 17:30:59,2013-03-20 17:30:59
a0cc38827fe44a91c3538ef34a6cd9ff8e3bc4d7...a163135cb5bd9886b634d8026b7adf473b023782,6,40,16,56,10,2013-03-20 18:22:29,2013-03-20 18:22:29
a163135cb5bd9886b634d8026b7adf473b023782...3cdac0b93440db5a3b0871a06be53bf8767b7dc8,3,70,42,112,8,2013-03-20 19:55:25,2013-03-20 19:55:25
b8f965a66592f77e49489b5160aac55c1e63df82...9ef5573c82acb0dc0d9068df08f469926a0a19c3,4,13,22,35,7,2013-04-26 17:59:29,2013-04-26 17:59:29
9ef5573c82acb0dc0d9068df08f469926a0a19c3...a022fd41645300e011feb3f6893813ce2d3cde11,5,47,20,67,8,2013-04-26 19:12:43,2013-04-26 19:12:43
a022fd41645300e011feb3f6893813ce2d3cde11...0cde12d18c56d3183c34a2679cb5851349c3ebcd,1,9,4,13,3,2013-04-26 19:19:12,2013-04-26 19:19:12
0cde12d18c56d3183c34a2679cb5851349c3ebcd...df96c079ef3e358ea221ce4c43163d478b79a5e0,1,1,1,2,1,2013-04-26 19:19:56,2013-04-26 19:19:56
40b949abab1cd3872deae08b0f257189c4b00323...7eb1e04e58e3c1675eee97fde1b90b976be775ff,1,4,1,5,1,2013-04-26 12:49:50,2013-04-26 12:49:50
25d5c1f63714d28a331095cf5b03fa577d3734d1...0f7c402c735eca30880b428ccad4479c6ab80884,1,6,1,7,2,2013-05-09 12:37:39,2013-05-09 12:37:39
25d5c1f63714d28a331095cf5b03fa577d3734d1...76d958ebe79d6ee6fa3229f02e91ba21bc65ecb6,1,10,5,15,6,2013-05-09 05:37:56,2013-05-09 05:37:56
16d3425a256dac77d71384068c214e4f3c9a619d...1ae9c697349f1b001c077c27149987177d264524,1,3,14,17,2,2013-04-25 22:15:50,2013-04-25 22:10:09
3f462878428b4d9731e54f3b20166beb09fb77e7...26d0e47ce4ad1d26b07959bb4a39203301f35e4e,1,1,1,2,1,2013-04-30 13:29:43,2013-04-30 13:29:43
493b5ff011d5788f669adabf978a40b49b8cf6a3...67ccc8b52aceebea9c0cb22b3277daf0b467c78e,38,130,131,261,85,2013-05-05 14:01:10,2013-05-05 14:01:10
67ccc8b52aceebea9c0cb22b3277daf0b467c78e...b1b354b0f86daae9a2cf19869dd3e6cb2d9ffd5e,11,173,173,346,23,2013-05-05 14:02:02,2013-03-20 21:46:30
b1b354b0f86daae9a2cf19869dd3e6cb2d9ffd5e...a50d96a84149c34c85f9f02cacfd2d15582c8eff,1,1,1,2,1,2013-05-05 14:02:02,2013-03-20 22:00:52
493b5ff011d5788f669adabf978a40b49b8cf6a3...ba9baff8d94ab6b3dc69e347552df480170cfd20,1,1,1,2,1,2013-05-05 13:54:22,2013-05-05 13:54:22
53413f128d049a7f45e4b3daf3dd0c3408a777e9...13dcc390cb1f930b42d62ad273d6c157fd90cc72,2,5,1,6,2,2013-05-07 11:44:49,2013-05-07 06:14:03
53413f128d049a7f45e4b3daf3dd0c3408a777e9...1c1e7975a9d9485897476741c825a9816c78b8ee,2,5,0,5,3,2013-05-07 07:12:35,2013-05-06 16:53:19
53413f128d049a7f45e4b3daf3dd0c3408a777e9...543d86f351780ebfd9bdd945e6cc247da4919602,3,18,8,26,6,2013-05-06 09:26:36,2013-05-06 09:26:36
543d86f351780ebfd9bdd945e6cc247da4919602...a735ce2aa7da72242629a4452c33e7a1900fdd62,3,60,33,93,22,2013-05-06 09:27:54,2013-05-06 09:27:54
a735ce2aa7da72242629a4452c33e7a1900fdd62...ff346c01fac3eb0c588d493ac4c848340b4ec0c4,1,15,0,15,2,2013-05-06 12:08:53,2013-05-06 12:08:53
ff346c01fac3eb0c588d493ac4c848340b4ec0c4...42b86b79d0547d8d6f9f3fc8bc3414f7eb4a3964,4,50,26,76,8,2013-05-06 12:09:26,2013-05-06 12:09:26
42b86b79d0547d8d6f9f3fc8bc3414f7eb4a3964...b7f1cf9f491f6cefdfc5f651f724331f07cfd6f5,3,138,59,197,62,2013-05-06 12:09:41,2013-05-06 12:09:41
b7f1cf9f491f6cefdfc5f651f724331f07cfd6f5...8e4625af614b58df97d60031c2b5c72f37f1a692,2,10,3,13,4,2013-05-06 12:10:05,2013-05-06 12:10:05
8e4625af614b58df97d60031c2b5c72f37f1a692...1882baa1aaa1c195cce55678b2b8a12e1b59db34,13,86,105,191,17,2013-05-06 12:10:55,2013-05-06 12:10:55
1882baa1aaa1c195cce55678b2b8a12e1b59db34...4528fa9817f2f9ba9ccf330ea2c9f6575b6a3c4b,5,54,52,106,16,2013-05-06 13:24:58,2013-05-06 13:24:58
4528fa9817f2f9ba9ccf330ea2c9f6575b6a3c4b...749d3383cc390ef156d0c37a1b5f9c21062e7f9c,1,13,0,13,1,2013-05-06 14:42:13,2013-05-06 14:42:13
8688789353e1b6c3b4c6ed0eb410797092f1331b...5d66df0a3f994695c08f4f0004cf6d62dd9f83ae,1,2,0,2,1,2013-05-08 11:26:42,2013-05-08 11:26:42
9477448ac0731fc1a79f4dd9432a08e34c5a7eba...4c6c24856cc326e26b6f7ac91ee6eae9fcc722f7,15,224,46,270,26,2012-11-21 16:19:03,2012-11-21 04:14:05
17cec0508776ee577b67b2542f8757accef32c79...c78359a84bc958c7e6d4fca84dc77b25f6b28cf7,1,34,14,48,3,2012-10-27 16:15:00,2012-10-27 16:15:00
c78359a84bc958c7e6d4fca84dc77b25f6b28cf7...3d0197246ebd382d1bbfe8501177cef7fd269e7d,3,4,8,12,6,2012-10-27 16:27:47,2012-10-27 16:27:47
3d0197246ebd382d1bbfe8501177cef7fd269e7d...646bad43e97482333648522917aefc83b69e2e9a,2,17,2,19,4,2012-10-27 16:27:51,2012-10-17 22:49:20
404040d7ae01d1542acc998d6dd4467fb7f049c4...1d15586fee7b3bcb773db702e571b2453d107aca,1,4,8,12,3,2012-10-30 11:58:10,2012-10-30 11:58:10
38175209c59a10e30d8444f5b90af507d168cc08...5add5f760ebd87e9318f13d3f2ae4e4a4ddbe3ae,2,5,1,6,2,2012-10-24 13:13:20,2012-10-24 13:13:20
b985ff6f182e7a3dd1767b8145cd66ebbdc3c8da...a7efeb378135a9d2a263b4d14d24c462d4c8eb29,1,1,1,2,1,2012-10-24 12:25:28,2012-10-24 12:25:08
bf753e99e7d2ba876a62cb5f163375e8fc5fd004...9db7c16a1ef24c009df4aa4e5b4987b97a53e606,1,6,6,12,6,2013-01-17 23:00:02,2013-01-10 01:09:46
115454f3ed35d136c2edd77296ffff97570a6822...9c40002625b34588435456e5487d2b174566b9f5,2,2,7,9,2,2013-02-28 17:30:07,2013-02-28 17:30:07
115454f3ed35d136c2edd77296ffff97570a6822...b1f58fcaeab2320b549522c8ae792d57535224a6,1,1,1,2,1,2013-02-28 17:29:21,2013-02-28 17:29:21
e4b67d3b1831025cc74a7f73e0700014885dea80...3c5954b8c8cd9fcda374fd58bc1b079954b488b7,1,1,1,2,1,2013-02-27 14:47:04,2013-02-27 14:47:04
3c5954b8c8cd9fcda374fd58bc1b079954b488b7...b3d648b4e882c41e0bb7bd72dc8815f6a7321fc4,2,15,8,23,3,2013-02-27 15:48:51,2013-02-27 15:48:51
b3d648b4e882c41e0bb7bd72dc8815f6a7321fc4...33cd1ae9dce7d8a798ca312a27eb0b4872892f05,1,15,19,34,8,2013-02-27 16:09:48,2013-02-27 16:09:48
135418dcbf72d264a846649b95ea8e6d8a2aadcf...9f45e01e8426b9d678a210bb5237628676f99894,11,83,22,105,20,2013-02-28 13:14:21,2013-02-07 10:42:52
9f45e01e8426b9d678a210bb5237628676f99894...5f657203a1c19b3eca38b3961dfe24e3a06af910,9,74,14,88,15,2013-02-28 13:15:22,2013-02-07 11:10:14
5f657203a1c19b3eca38b3961dfe24e3a06af910...b4648c3b521f2160bd4d7f47267dfaf204456825,1,2,2,4,2,2013-02-28 13:15:22,2013-02-07 13:11:31
b4648c3b521f2160bd4d7f47267dfaf204456825...ba5373805a1e3396434df3dc023b8b573374b5a1,1,1,0,1,1,2013-02-28 13:15:22,2013-02-08 08:16:08
ba5373805a1e3396434df3dc023b8b573374b5a1...3d4e32457b66f5fa49bc35d938ec27ab24b7f15b,1,7,7,14,2,2013-02-28 13:15:22,2013-02-08 11:42:14
3d4e32457b66f5fa49bc35d938ec27ab24b7f15b...9959669f1cb533e14e5df8d240c7560a2f258f84,6,13,81,94,9,2013-02-28 13:15:22,2013-02-14 08:14:34
9959669f1cb533e14e5df8d240c7560a2f258f84...cf6d9a222213e37c9490bd30ae3a9971ac1baff5,5,14,0,14,9,2013-02-28 13:15:22,2013-02-19 19:01:57
cf6d9a222213e37c9490bd30ae3a9971ac1baff5...9c747fbb95ed795b7159db79cea76ab8e4bd3da0,8,48,10,58,11,2013-02-28 13:37:02,2013-02-19 19:02:25
9c747fbb95ed795b7159db79cea76ab8e4bd3da0...d3f042a6f2bab3553dd4202637dfb916d8243cd6,4,4,4,8,4,2013-02-28 14:35:27,2013-02-28 14:35:27
d3f042a6f2bab3553dd4202637dfb916d8243cd6...2f1f05d431d1df062e46365930b98b358554a07d,3,14,15,29,7,2013-02-28 14:55:35,2013-02-28 14:55:35
135418dcbf72d264a846649b95ea8e6d8a2aadcf...8f621c9e064afe1465728143d71f0658053d55ad,2,6,0,6,3,2013-02-28 11:15:53,2013-02-08 12:47:24
8f621c9e064afe1465728143d71f0658053d55ad...e6d2e5696186cc81b7d9a12af25e00528ca2cc30,9,69,315,384,13,2013-02-28 12:10:00,2013-01-23 14:13:28
e6d2e5696186cc81b7d9a12af25e00528ca2cc30...999fc2391b012a9de66ad089a3c3eafe8c8b02d8,1,4,0,4,1,2013-02-28 12:10:00,2013-02-08 13:55:02
999fc2391b012a9de66ad089a3c3eafe8c8b02d8...68a7ecdaaf0959d5087d08ef3c94bb201e6dd166,6,52,29,81,8,2013-02-28 12:10:00,2013-02-11 11:41:12
68a7ecdaaf0959d5087d08ef3c94bb201e6dd166...62de22c142d0ad9d956e7f6dae2eef4559d38436,1,10,1,11,3,2013-02-28 12:10:01,2013-02-11 13:15:10
62de22c142d0ad9d956e7f6dae2eef4559d38436...0afdf39dbcc50eb5889be08e5b1aaefe162e456c,6,37,6,43,10,2013-02-28 12:11:13,2013-02-11 14:17:43
0afdf39dbcc50eb5889be08e5b1aaefe162e456c...f13600845d2ccec816337234eb5f1dccd40777f7,1,5,0,5,1,2013-02-28 12:11:13,2013-02-11 14:21:04
f13600845d2ccec816337234eb5f1dccd40777f7...16c720fd966ccb70a7642c59b81b23f74f00c122,2,61,1,62,4,2013-02-28 12:11:13,2013-02-11 13:32:29
16c720fd966ccb70a7642c59b81b23f74f00c122...9e8a818696f3b3538b93a306d6e8d3ce5973ece0,1,2,0,2,1,2013-02-28 12:11:13,2013-02-12 11:37:33
9e8a818696f3b3538b93a306d6e8d3ce5973ece0...9b606ede000666bc5f5330f43fa0ea0c7ff9815c,1,2,2,4,2,2013-02-28 12:11:13,2013-02-14 14:25:56
9b606ede000666bc5f5330f43fa0ea0c7ff9815c...c643b50dbd726b6a3396ea459d14378e1c52b48b,4,8,4,12,5,2013-02-28 12:11:13,2013-02-14 14:26:50
c643b50dbd726b6a3396ea459d14378e1c52b48b...c6385e41355a622ef1be2d72d0fd20eef2897707,1,3,3,6,3,2013-02-28 12:11:13,2013-02-14 14:43:06
c6385e41355a622ef1be2d72d0fd20eef2897707...cf3cf3750e53439cfaa8df786fd71308e4ef4867,3,6,0,6,4,2013-02-28 12:11:14,2013-02-19 12:30:37
cf3cf3750e53439cfaa8df786fd71308e4ef4867...bca72eac747acbec42e4b93fecb4f6100e3ba257,1,5,0,5,2,2013-02-28 12:11:14,2013-02-19 12:37:43
bca72eac747acbec42e4b93fecb4f6100e3ba257...ab98db73a35172d723adf474d9dc50b5d613a9bf,1,15,0,15,1,2013-02-28 12:11:14,2013-02-19 12:43:24
ab98db73a35172d723adf474d9dc50b5d613a9bf...b6d0f2852d1f2518ca8987667beb7df2b8223611,3,22,3,25,6,2013-02-28 12:11:14,2013-02-19 13:06:40
b6d0f2852d1f2518ca8987667beb7df2b8223611...8caccae45457940b54174a3516a1a56915016c22,1,29,3,32,2,2013-02-28 12:11:14,2013-02-19 13:21:59
8caccae45457940b54174a3516a1a56915016c22...cff845784eb76aeaff7b4242e0aaa2469a530a59,2,14,12,26,4,2013-02-28 12:11:14,2013-02-19 13:31:45
cff845784eb76aeaff7b4242e0aaa2469a530a59...1dab19d0d7b25cb5af27b8d10c8b615b2d38c2cf,1,314,0,314,1,2013-02-28 12:30:47,2013-02-28 12:30:47
135418dcbf72d264a846649b95ea8e6d8a2aadcf...8d847b89d25951b57d843676bf9207f22c12597e,1,1,1,2,1,2013-02-27 14:00:33,2013-02-27 14:00:33
135418dcbf72d264a846649b95ea8e6d8a2aadcf...df63ab78a8bac8fd7cd2ea2edc7d2c274210602a,1,1,1,2,1,2013-02-27 10:27:10,2013-02-27 10:27:10
135418dcbf72d264a846649b95ea8e6d8a2aadcf...4a55c6987703717fd63b7884f2c9695ccac8c010,3,9,9,18,5,2013-02-27 08:53:36,2013-02-27 08:53:36
d6513b5153ae2d8bdfc3017f0cbbe909678dd37c...6b96ca47e036759aa9f3c636b2f0e32ac36651c8,1,15,30,45,15,2013-02-12 17:42:36,2013-02-12 17:42:36
6b96ca47e036759aa9f3c636b2f0e32ac36651c8...8353bd8ee320bebe955582af2122b7a0683e53c9,1,2,2,4,2,2013-02-12 17:49:11,2013-02-12 17:49:11
4b5803020717d77e3a4a75055ab347a026c38fdb...2f0a75ab77af430f682d67aa9bb865007d832795,2,3,3,6,3,2013-02-08 06:55:39,2013-02-08 06:55:39
1df225bb384ad53ca081bdda85a805105a3eff7c...726fa6c76afc9162fe046439f7f11b729190aaa6,3,27,20,47,14,2013-09-29 13:04:57,2013-09-29 13:04:57
1df225bb384ad53ca081bdda85a805105a3eff7c...bfb607a073e8f2c78bd388516e31b052faa5f765,1,20,15,35,18,2013-09-29 12:44:49,2013-09-29 12:44:49
655e68a0adc391013bea1dd4ef3838edde7c3f97...e9d8d074a12007ba23b198a2587e31456c3d6a18,4,32,17,49,5,2013-02-18 18:31:43,2013-02-18 18:31:43
e9d8d074a12007ba23b198a2587e31456c3d6a18...a29db26cc99cb7406d1f9d7fe91650e6e2dd8294,11,59,57,116,20,2013-02-18 19:10:49,2013-02-18 19:10:49
a29db26cc99cb7406d1f9d7fe91650e6e2dd8294...ba937b2b3d81a7a9d3097387150fe8c8f2d784ca,5,17,17,34,10,2013-02-18 19:21:24,2013-02-18 19:21:24
ba937b2b3d81a7a9d3097387150fe8c8f2d784ca...bfc359ca61bd7e7ffea714b4ad64a7d9927441c3,4,22,9,31,5,2013-02-19 07:43:41,2013-02-19 07:43:41
fa3cc1dd24fed0cd3b041e469cada054fda479ab...18a496142b7b22166025535829776ea09cd39e52,5,32,64,96,33,2013-02-16 19:24:51,2013-02-16 19:24:51
18a496142b7b22166025535829776ea09cd39e52...f45f03319943580578c5d5743adbf4f3ae5f5695,2,1,1,2,1,2013-02-16 19:35:11,2013-02-16 19:35:11
f45f03319943580578c5d5743adbf4f3ae5f5695...42ffbea8e0b6db016b60866c8b2b1d8b28dc4d71,1,1,1,2,1,2013-02-16 19:37:06,2013-02-16 19:37:06
42ffbea8e0b6db016b60866c8b2b1d8b28dc4d71...9764ba6df2357ee93b9d4163f4011552be32de25,2,3,1,4,2,2013-02-16 19:47:43,2013-02-16 19:47:43
fa3cc1dd24fed0cd3b041e469cada054fda479ab...2a4ef0fe4941f6d17e22b8066a0fb9f6aabc2780,1,1,1,2,1,2013-02-16 15:11:36,2013-02-16 15:11:36
2a4ef0fe4941f6d17e22b8066a0fb9f6aabc2780...a9c1b85e08e7e6ed1f209b8a5e2b43ea3b91dbb4,2,3,3,6,2,2013-02-16 15:40:33,2013-02-16 15:40:33
a9c1b85e08e7e6ed1f209b8a5e2b43ea3b91dbb4...f7ae1bce258695b07c674d8857112f927f412b90,2,3,3,6,2,2013-02-19 07:13:19,2013-02-19 07:13:19
e6c0673ef1108a93928c4d88ba273e12616b836b...eab1e6cea167c507901fa925fb769862f3a78c7c,1,1,1,2,1,2013-01-04 16:43:41,2013-01-04 16:43:41
e6c0673ef1108a93928c4d88ba273e12616b836b...29623d77e48e3fd103990b9582f754fb5792f24e,1,2,2,4,2,2013-01-04 15:14:55,2013-01-04 15:14:55
e6c0673ef1108a93928c4d88ba273e12616b836b...fd4bcd9f09305c057e91a4f791c74d00da9ac143,1,1,1,2,1,2013-01-04 14:05:00,2013-01-04 14:05:00
e6c0673ef1108a93928c4d88ba273e12616b836b...f04597d91864ed9af1444b1caef05b5498bd6c88,3,52,20,72,7,2013-01-04 12:59:08,2012-12-23 21:46:27
f04597d91864ed9af1444b1caef05b5498bd6c88...90cba379a436a942d5d71bfb0bb5a9a321fcbd2b,2,117,45,162,18,2013-01-04 12:59:08,2012-12-28 15:36:42
90cba379a436a942d5d71bfb0bb5a9a321fcbd2b...1b96ca348f55b4125295c6d826a244d8f6bce1d8,2,3,23,26,3,2013-01-04 12:59:08,2013-01-03 16:21:16
1b96ca348f55b4125295c6d826a244d8f6bce1d8...47bb945caf22f422ba86a6a91a77bb24ffd01f29,2,7,7,14,3,2013-01-04 12:59:08,2013-01-04 12:58:58
e6c0673ef1108a93928c4d88ba273e12616b836b...39ba934c0a65f571214998e056e925b61f389360,31,329,315,644,78,2013-01-03 19:09:18,2013-01-03 19:09:18
39ba934c0a65f571214998e056e925b61f389360...dccd8b6eaa8b2e98b0245262a8e39df8fb8ae634,42,219,179,398,90,2013-01-04 06:43:25,2013-01-04 06:43:25
dccd8b6eaa8b2e98b0245262a8e39df8fb8ae634...afbdbb0c959affbdb8725eafb8169025a8aede1e,22,149,199,348,38,2013-01-04 16:50:31,2013-01-04 16:50:31
afbdbb0c959affbdb8725eafb8169025a8aede1e...ef5b36eaaf92db19ae90cc599c3f64b865bdc4d5,9,21,20,41,13,2013-01-04 19:45:30,2013-01-04 19:45:30
ef5b36eaaf92db19ae90cc599c3f64b865bdc4d5...14d0ef8f37b68c0911edfb197581bb7e818b1e50,4,15,43,58,10,2013-01-04 20:13:32,2013-01-04 20:13:32
14d0ef8f37b68c0911edfb197581bb7e818b1e50...c6298678f5032823130f5b2eb6fc1810cbb01a10,23,151,314,465,72,2013-01-04 21:35:31,2013-01-04 21:35:31
c6298678f5032823130f5b2eb6fc1810cbb01a10...e16cebac3eaadc0df93576358f60ae4a498ce15f,22,110,75,185,36,2013-01-04 22:35:38,2013-01-04 22:35:38
e16cebac3eaadc0df93576358f60ae4a498ce15f...9a88e4d184e5959cb3b7212d027ae4bbe1c97302,7,10,36,46,13,2013-01-04 22:43:32,2013-01-04 22:43:32
9a88e4d184e5959cb3b7212d027ae4bbe1c97302...de6fa5dd520244e9802b5b486ce9d437556baf31,1,2,2,4,2,2013-01-04 22:49:43,2013-01-04 22:49:43
86b181398c0f4f3085cb2c1c155dc1a96afb614f...6878f55620796d0bd8160ba0df298ea0ae060fc2,1,6,6,12,6,2012-11-19 12:01:40,2012-11-19 12:01:40
d412abd10886c76968278d655ac3a0c01fef0329...51f48392abb225eaed58a6368382cdc28a961d3b,1,4,4,8,2,2012-11-17 21:26:22,2012-11-17 21:25:48
6cec9ed3283a611a40b6df981ed00ccaa1bd0e73...ca54d43f9900666ff86fb4c647f9f9441eec781a,1,4,2,6,3,2012-11-09 23:55:56,2012-11-09 23:55:56
6cec9ed3283a611a40b6df981ed00ccaa1bd0e73...45dcb1b5c4e765fa048492865d2664f52e0a11a9,2,226,0,226,2,2012-11-09 22:35:02,2012-11-06 21:56:53
45dcb1b5c4e765fa048492865d2664f52e0a11a9...c42ada9bee6e95b6fd3ebdc55d4b269f7e18d9f6,5,172,192,364,21,2012-11-09 23:03:46,2012-11-09 23:03:46
c42ada9bee6e95b6fd3ebdc55d4b269f7e18d9f6...245544a9d9807c6875eb7b3d63ab6d76468464d6,2,11,5,16,4,2012-11-10 09:47:30,2012-11-10 09:47:30
51ef5b929708d3ad90b6db6afbb78ee24eeb8aa1...122769e358287c32777092f66eec2b67a501c386,2,72,33,105,12,2012-10-20 13:25:48,2012-10-20 13:25:48
122769e358287c32777092f66eec2b67a501c386...d4e3664067f330c7d070ee6c92b794cb50ff2d76,1,2,1,3,1,2012-10-20 13:27:34,2012-10-20 13:27:34
51ef5b929708d3ad90b6db6afbb78ee24eeb8aa1...054c15e7b5f9967417a0ea03aad0c4d77afd3bca,1,4,0,4,2,2012-10-19 21:38:07,2012-10-19 21:38:07
51ef5b929708d3ad90b6db6afbb78ee24eeb8aa1...b1ef7d7a44dc135faa179c6223eabb7bb8822f0b,1,1,1,2,1,2012-10-19 10:41:09,2012-10-10 12:11:40
b1ef7d7a44dc135faa179c6223eabb7bb8822f0b...46921e690ec95fdfb4c38ea1a2dd65261719ba23,1,16,16,32,13,2012-10-19 10:41:10,2012-10-10 13:41:20
46921e690ec95fdfb4c38ea1a2dd65261719ba23...ec1bccb26173640387124567e9ef748ae220ff37,6,13,13,26,12,2012-10-19 10:41:10,2012-10-12 06:19:34
ec1bccb26173640387124567e9ef748ae220ff37...57c134c39a106a3e9b9de776c06fe971b83a8224,2,41,51,92,12,2012-10-19 10:41:10,2012-10-16 11:01:40
57c134c39a106a3e9b9de776c06fe971b83a8224...41ec5400336a55254716309738c6c4d523b6ce02,1,0,5,5,1,2012-10-19 10:41:10,2012-10-16 11:41:49
41ec5400336a55254716309738c6c4d523b6ce02...c28722689d54eb0a69c72e8258e189ccd8ce7964,3,8,11,19,3,2012-10-19 10:41:10,2012-10-16 11:57:13
c28722689d54eb0a69c72e8258e189ccd8ce7964...414080cb0300e924ec2c994495349f4f93cdf1c4,1,0,6,6,1,2012-10-19 10:41:10,2012-10-16 12:09:09
51ef5b929708d3ad90b6db6afbb78ee24eeb8aa1...770ec3359d9c4bb3a53d7e44719cc4fa51b6b174,1,1,1,2,1,2012-10-19 10:09:34,2012-10-19 10:09:34
770ec3359d9c4bb3a53d7e44719cc4fa51b6b174...c61020632147e0855cf229bce81aa080ca1e5992,2,6,6,12,4,2012-10-19 10:23:10,2012-10-19 10:23:10
c61020632147e0855cf229bce81aa080ca1e5992...2dc0f098fdfe1d07e557f7da92b3cff9d7351276,1,4,4,8,4,2012-10-19 10:25:39,2012-10-19 10:25:39
2dc0f098fdfe1d07e557f7da92b3cff9d7351276...0369c74e581ed7f3c2e6576be3f1afcd20b54022,1,2,2,4,2,2012-10-19 10:28:26,2012-10-19 10:28:26
0369c74e581ed7f3c2e6576be3f1afcd20b54022...00325a733a76d8388a64e4a38c8f4e70f2a49938,1,3,4,7,4,2012-10-19 10:34:18,2012-10-19 10:34:18
00325a733a76d8388a64e4a38c8f4e70f2a49938...cf70439e0a61637a8ad12360c53df08320b937b9,1,2,4,6,3,2012-10-19 10:39:02,2012-10-19 10:39:02
51ef5b929708d3ad90b6db6afbb78ee24eeb8aa1...b3a5f0a78d1d3e6d6ec3655ca1c936d983b7d69c,1,3,3,6,1,2012-10-18 18:16:52,2012-10-17 14:55:08
b3a5f0a78d1d3e6d6ec3655ca1c936d983b7d69c...aef2031ad6bac1d3c35e5beb3b82fb0abfd3c1de,1,22,0,22,1,2012-10-18 18:16:52,2012-10-17 15:02:51
aef2031ad6bac1d3c35e5beb3b82fb0abfd3c1de...4fd73683d904ecc71af3ebce128630f0f90997ae,4,23,13,36,6,2012-10-18 18:53:35,2012-10-18 18:53:35
3d9ba7b76c869bd9972ca4827ce43412d29f6f10...84465576d72a0ca98d2b9f6f4101d8c8e80bb1ef,1,1,1,2,1,2012-12-07 13:53:04,2012-12-07 13:53:04
552c2d665bf4f5bbb6fc0a4f04ec30e4263bbfe4...23a8e59938477be9938ed96176e8f9220ca78471,2,82,38,120,13,2012-12-06 20:16:48,2012-12-06 20:16:48
552c2d665bf4f5bbb6fc0a4f04ec30e4263bbfe4...2c37fa381e80135b7b2e87163a46ca2ecee15925,2,4,2,6,2,2012-12-06 20:03:13,2012-11-18 22:36:50
2c37fa381e80135b7b2e87163a46ca2ecee15925...0aa7f79ca4255eadd7d2aad7c3378915ee54e107,4,36,2,38,8,2012-12-06 20:44:22,2012-12-06 20:44:22
2b79706d6d3c4f39f3eb11508ca59c5f6f1caa4f...f6fd2e309ffc6456d874c0a7a8440afa3438ed1c,1,6,0,6,1,2012-12-10 11:15:51,2012-12-10 11:15:51
2b79706d6d3c4f39f3eb11508ca59c5f6f1caa4f...bf13579b929151aa80ca957486b1851b067aa4ac,8,68,20,88,15,2012-12-10 03:14:05,2012-12-10 03:14:05
20c8d6e6442e5a339fbb47f844e85c1a739e9939...b1437d4c8d6991be1b53477c50748b45de2ee09c,3,7,3,10,4,2012-12-10 13:39:10,2012-12-10 03:24:05
b1437d4c8d6991be1b53477c50748b45de2ee09c...a5243178edec1fde0365006b2aaaf44953181d84,1,1,1,2,1,2012-12-10 19:28:18,2012-12-10 19:27:27
a5243178edec1fde0365006b2aaaf44953181d84...8918d11379cc29d679de72f230193cd35d722c3e,1,1,1,2,1,2012-12-10 20:00:10,2012-12-10 20:00:10
8918d11379cc29d679de72f230193cd35d722c3e...9f940aeaf4fbfed2906900dda81b1f6b5a0656a6,1,7,2,9,4,2012-12-10 21:53:33,2012-12-10 21:53:33
7587a3b2fc0e0a3e39e969172f00391c2053e8b9...46fa92187d6c076619e9cd58877e03c6d15a1f03,1,14,10,24,3,2013-03-19 01:00:29,2013-03-19 01:00:29
46fa92187d6c076619e9cd58877e03c6d15a1f03...e00e54b69ca7cd1c4cfbb726b87372c479ff8b73,1,21,4,25,3,2013-03-19 01:36:40,2013-03-19 01:22:55
e00e54b69ca7cd1c4cfbb726b87372c479ff8b73...fc66c18349c01b5d5d07b9780d54ad12f42112de,1,1,1,2,2,2013-03-19 03:53:12,2013-03-19 03:53:12
fc66c18349c01b5d5d07b9780d54ad12f42112de...92de0faf6e86d7fed33bc8989e3f2147c16450dd,2,11,8,19,3,2013-03-19 05:21:00,2013-03-19 04:46:07
306ea84e85fe4821dd124163eef8ca5a7f041cbb...96a584211bf7bfa87b172b72015d7729b32150cf,1,0,4,4,1,2013-03-19 09:08:27,2013-03-19 09:08:27
96a584211bf7bfa87b172b72015d7729b32150cf...351c952192da7cdd088fe693289e96d945dcafe3,1,63,53,116,12,2013-03-19 09:42:46,2013-03-19 09:42:46
351c952192da7cdd088fe693289e96d945dcafe3...175e09f16742cbc8d5535e548cef880768ec3397,2,5,5,10,5,2013-03-19 10:27:15,2013-03-19 10:27:15
175e09f16742cbc8d5535e548cef880768ec3397...1f6b6b6c629592e3ecc08e9dac6514a4b1a831a0,2,82,70,152,38,2013-03-20 12:28:22,2013-03-20 09:17:12
1f6b6b6c629592e3ecc08e9dac6514a4b1a831a0...916c61fc64292bf4ae2fd84cbbbc86a5afa943bf,1,21,20,41,12,2013-03-21 12:34:15,2013-03-21 12:34:15
916c61fc64292bf4ae2fd84cbbbc86a5afa943bf...a19e3d898d6bb52867f1356f3410f52fa0d76e98,1,10,1,11,2,2013-03-21 13:08:54,2013-03-20 09:19:01
a19e3d898d6bb52867f1356f3410f52fa0d76e98...06c5389780cf5625f68a0efa3d8ef21b496966a7,1,1,0,1,1,2013-03-21 15:24:06,2013-03-21 15:24:06
306ea84e85fe4821dd124163eef8ca5a7f041cbb...54f40301ff2b3e0c9ef1e9593c634ab8612c12e6,1,2,2,4,2,2013-03-19 06:39:26,2013-03-19 06:39:26
54f40301ff2b3e0c9ef1e9593c634ab8612c12e6...fb1c85061eae848e68244a1e3c56e1602584f08a,2,0,17,17,2,2013-03-19 06:40:32,2013-03-19 06:40:32
fb1c85061eae848e68244a1e3c56e1602584f08a...e68955b4fcea3b85b3838cb50507a9e3dd5acb5c,1,10,6,16,5,2013-03-19 07:27:12,2013-03-19 07:27:12
e68955b4fcea3b85b3838cb50507a9e3dd5acb5c...1752c6dc8b755bc2fbff2757e8549521b0823048,2,6,3,9,3,2013-03-19 07:38:33,2013-03-19 07:38:33
3cdac0b93440db5a3b0871a06be53bf8767b7dc8...f39d3b9a096ecffca3ca9120cce35684ba139b85,1,1,1,2,2,2013-03-20 22:15:42,2013-03-20 22:15:42
df96c079ef3e358ea221ce4c43163d478b79a5e0...3a5d90c4a3c1b1cf6fae6e1ef9210593961971d1,2,39,19,58,21,2013-04-28 16:11:40,2013-04-28 16:11:40
df96c079ef3e358ea221ce4c43163d478b79a5e0...f60486a0c42a7167d283bc64a8fbcdb0fa5533a2,1,1,1,2,1,2013-04-28 15:42:11,2013-04-28 15:42:11
df96c079ef3e358ea221ce4c43163d478b79a5e0...228baa80b2063bc2692474e3bbc6eeef887f063e,1,25,1,26,4,2013-04-27 21:31:48,2013-04-27 20:20:26
228baa80b2063bc2692474e3bbc6eeef887f063e...20a88f5c43efa3ab0af80d26c90268132e6f7997,1,6,2,8,2,2013-04-29 20:26:03,2013-04-29 20:26:03
df96c079ef3e358ea221ce4c43163d478b79a5e0...4f2d2c90f7c32a9113ccce440411ec80374ee385,16,15,863,878,17,2013-04-27 20:50:17,2013-04-27 20:50:17
4f2d2c90f7c32a9113ccce440411ec80374ee385...cb9b826010082e7ebbb8e8d7d3cfcc07691866f6,2,11,9,20,3,2013-04-27 21:04:03,2013-04-27 21:04:03
cb9b826010082e7ebbb8e8d7d3cfcc07691866f6...13dd7eb4760fbd4acb23eec47ab439c277d1b28f,1,1,1,2,1,2013-04-28 17:56:42,2013-04-28 17:56:42
13dd7eb4760fbd4acb23eec47ab439c277d1b28f...233c9b8587d481af6b21099aaa22359a4ff502c4,2,8,16,24,6,2013-04-28 18:03:27,2013-04-28 18:03:27
233c9b8587d481af6b21099aaa22359a4ff502c4...ca281483b33e312ccb9956a0672d39151474ed12,3,3,7,10,4,2013-04-28 18:27:49,2013-04-28 18:27:49
42dc33e9dd473aad564fd4b1c3c277fbddf63366...bffa1e657533dcd324042642f30b06dee3f61930,1,12,8,20,2,2013-04-26 13:25:46,2013-04-26 13:25:46
4353babe61a57be128bd967731e7c536c9a55ba3...7f57fe5034f6fdfbdd4e29745b50e7bfa1576bf5,11,98,7,105,12,2013-05-09 08:47:08,2013-04-14 17:07:11
7f57fe5034f6fdfbdd4e29745b50e7bfa1576bf5...ad947bc70591ea2453a1db9fd248284e369f8695,1,1,0,1,1,2013-05-09 08:47:08,2013-05-05 13:27:31
ad947bc70591ea2453a1db9fd248284e369f8695...76d6bc4f82b04931a5f4dfc86af8d98c48e33e82,3,5,5,10,5,2013-05-09 08:47:08,2013-05-09 08:02:48
76d6bc4f82b04931a5f4dfc86af8d98c48e33e82...b1aaf0d2ac68a6d2e0ec50de13ac30c520c7a3ab,1,1,1,2,1,2013-05-09 08:47:08,2013-05-09 08:03:15
b1aaf0d2ac68a6d2e0ec50de13ac30c520c7a3ab...9fdcdb774ff496f4f1c8bf61290d1d70cbd5c3ed,1,0,32,32,1,2013-05-09 08:47:09,2013-05-09 08:04:05
9fdcdb774ff496f4f1c8bf61290d1d70cbd5c3ed...f1126f494cf4fb2b27c43ac3d3bd69fea9c4afe4,6,38,39,77,15,2013-05-09 08:47:09,2013-05-09 08:27:14
f1126f494cf4fb2b27c43ac3d3bd69fea9c4afe4...6e1ee1fea6400c3621005f1b79e1b8dab43cd000,4,43,24,67,5,2013-05-09 08:47:09,2013-05-09 08:46:32
00ed1e9088a5e7800a468c96a3850a8a3569a99e...c937b2af5d5ea268619ca83e730befb32dec7474,1,2,6,8,2,2013-05-01 07:26:40,2013-05-01 07:26:40
af5d0e9e92f3fb818c73f1b8b991ea61ddc35dd4...9d668750698558ce7864c370e34a06c7a710ff00,3,17,4,21,4,2013-05-07 14:57:29,2013-05-07 14:57:29
9d668750698558ce7864c370e34a06c7a710ff00...be68cc461755752697642c58154781ae4ec9ab31,3,45,1,46,3,2013-05-07 14:57:59,2013-05-07 14:57:59
be68cc461755752697642c58154781ae4ec9ab31...03441769dfc09776eb8511275a3f492ded1a7c42,8,53,46,99,17,2013-05-07 16:26:41,2013-05-07 16:26:41
03441769dfc09776eb8511275a3f492ded1a7c42...04da04ff64dc1d6277148144530fa8a8b86f39b9,1,2,2,4,2,2013-05-07 16:46:35,2013-05-07 16:46:35
caf065007a49a58f8005c0a8d2cb0140719af8d2...f64874c1f541c72ea07f680769d963d4964232d7,1,1,1,2,1,2013-05-06 14:52:47,2013-05-06 14:52:47
caf065007a49a58f8005c0a8d2cb0140719af8d2...298d089740e6c37ecb91f030f872ddd36a3f92d6,1,3,0,3,1,2013-05-06 14:50:30,2013-05-06 14:50:30
7b6f2fb16030851dbba67a06614ec6c2aedaec4f...de12eba25c840a533cd7fa8edddc5fb3b96634f8,4,26,5,31,4,2013-05-08 16:40:31,2013-05-08 16:40:31
de12eba25c840a533cd7fa8edddc5fb3b96634f8...abff03996ad59e25be52d51605f6ede698363ecb,3,6,8,14,4,2013-05-08 17:06:12,2013-05-08 17:06:12
abff03996ad59e25be52d51605f6ede698363ecb...5bd5d09b83c21bca1d6cd534622f410f9b0da4de,1,2,2,4,2,2013-05-08 17:11:49,2013-05-08 17:11:49
5bd5d09b83c21bca1d6cd534622f410f9b0da4de...aee110e20dd81861a62ea458b5629619c32a2d0a,3,29,3,32,5,2013-05-08 18:03:14,2013-05-08 18:03:14
aee110e20dd81861a62ea458b5629619c32a2d0a...7069fac317e503438065243ccb66e1878875d406,6,19,3,22,6,2013-05-08 18:03:36,2013-05-08 18:03:36
4c6c24856cc326e26b6f7ac91ee6eae9fcc722f7...1de0ea28b957068bff7d5a5eaac82956b7529560,3,19,1,20,3,2012-11-21 17:27:21,2012-11-21 17:25:32
4c6c24856cc326e26b6f7ac91ee6eae9fcc722f7...00464099704ec16ad64faa3fe8c19d931ee7037a,7,81,152,233,23,2012-11-21 05:14:05,2012-11-21 05:14:05
6d2e64164a46633afa7409461e4635834288e717...b6fc0310316eb61f68551a3b37f340b0fb4d0b20,2,15,13,28,8,2012-10-31 11:53:38,2012-10-31 11:53:38
b6fc0310316eb61f68551a3b37f340b0fb4d0b20...d9c20cf5a63dd1f337e408d26eb3f68750dadb75,3,7,3,10,3,2012-10-31 12:29:42,2012-10-31 12:29:42
d9c20cf5a63dd1f337e408d26eb3f68750dadb75...9014fb7525504dedaaca3b586af028455dc4004b,1,19,0,19,1,2012-10-31 12:39:05,2012-10-31 12:39:05
9014fb7525504dedaaca3b586af028455dc4004b...2032f4cd9665d0b4244e30160c64996dc37c0a0e,3,19,12,31,7,2012-10-31 13:22:13,2012-10-31 13:22:13
5add5f760ebd87e9318f13d3f2ae4e4a4ddbe3ae...6f25967c476be198853940a85f2d5d410b7bd7b1,3,28,4,32,5,2012-11-07 23:47:11,2012-11-07 23:47:11
6f25967c476be198853940a85f2d5d410b7bd7b1...944d3823c32c0b5d336efb8a7a44eb73bfae4f38,1,3,1,4,1,2012-11-08 21:32:00,2012-11-08 21:32:00
5add5f760ebd87e9318f13d3f2ae4e4a4ddbe3ae...2335d7b9cf577fb03ed4efc660b8e3e706c1c01b,1,6,6,12,2,2012-10-25 04:54:15,2012-10-25 04:54:15
b07e1b3aedf87fdf3ec7a6855cec8194b0a30a59...296cdd591f7f01ffdbe18cd6a839bbd0e624dfba,14,125,25,150,17,2013-01-18 10:57:31,2012-11-06 13:30:48
9a5c152c0eaac36f91b073e99ff1235c4467933b...1c517153a889f77f0a2c321ce4e013f4504253e9,2,7,5,12,3,2013-02-28 17:56:36,2013-02-28 17:56:16
1c517153a889f77f0a2c321ce4e013f4504253e9...00ae65b10808289252b1115eb86b90fcddc17d59,4,6,11,17,7,2013-02-28 19:02:41,2013-02-28 19:02:41
00ae65b10808289252b1115eb86b90fcddc17d59...ed9543ff5d84b2087febc539b84f091a8ddea4c0,3,6,5,11,6,2013-02-28 19:06:16,2013-02-28 19:06:16
ed9543ff5d84b2087febc539b84f091a8ddea4c0...547ae558d7bd21805d0c4b0d2665b84f5a4e6e59,1,3,3,6,3,2013-02-28 19:11:12,2013-02-28 19:11:12
547ae558d7bd21805d0c4b0d2665b84f5a4e6e59...7a0af60b51c2e8e46f2cd35e7ab33199d1bb2651,1,1,1,2,1,2013-02-28 19:14:00,2013-02-28 19:14:00
7a0af60b51c2e8e46f2cd35e7ab33199d1bb2651...0b52c461da6e22c68e2e124cd7e833a74021d0f6,2,4,4,8,3,2013-03-01 07:23:18,2013-03-01 07:23:18
33cd1ae9dce7d8a798ca312a27eb0b4872892f05...92039dd67763fc6503f74c96cb3c16724e04e18f,4,20,7,27,8,2013-02-27 18:20:31,2013-02-27 18:20:31
92039dd67763fc6503f74c96cb3c16724e04e18f...aceb747bb87319c4118ce60fe9c221e54068ba31,1,5,5,10,5,2013-02-27 18:40:01,2013-02-27 18:40:01
5c3cb47c16cacd8e9056f2a68978d69bc153a0f8...87f555e1ef26205633ff6458623054c6a95b983b,1,11,16,27,5,2013-03-01 14:07:55,2013-03-01 14:07:55
87f555e1ef26205633ff6458623054c6a95b983b...ef646928e4f89586d7057c91aee2678c3f89f363,5,9,13,22,8,2013-03-01 14:26:26,2013-03-01 14:26:26
ac4a09e9cca9018dbb8e52446078b91a4b87e410...e119b0a0cb33b1b7f2dafcf17c2a94af40aed833,3,73,25,98,19,2013-02-27 10:24:12,2013-02-27 10:24:12
e119b0a0cb33b1b7f2dafcf17c2a94af40aed833...873db06255eae1f69644c2a0815b88c923021c8f,3,44,7,51,9,2013-02-27 11:34:45,2013-02-27 11:34:45
873db06255eae1f69644c2a0815b88c923021c8f...dffc2b8a8b3ed03f12dc8f41a6f24b96f2605268,2,15,0,15,2,2013-02-27 11:58:06,2013-02-27 11:58:06
dffc2b8a8b3ed03f12dc8f41a6f24b96f2605268...e96d77d3dbd789981b8e85e7afba9a5908d79483,3,77,7,84,15,2013-02-27 13:36:20,2013-02-27 13:36:20
e96d77d3dbd789981b8e85e7afba9a5908d79483...3b3add35fb88578df96fe9b728ddac896ea9c944,4,59,13,72,18,2013-02-27 14:07:42,2013-02-27 14:07:42
60fdc04d0314b3f69fc7b8f7190aecbb8049abc6...2c71c2e1df1bec9ded0a62feb6f68f60fbdfb154,1,25,16,41,13,2013-02-27 19:05:57,2013-02-27 19:05:57
2c71c2e1df1bec9ded0a62feb6f68f60fbdfb154...863d297ede6989f00ab0a5af28efdf99a51f805a,1,5,4,9,2,2013-02-27 19:10:23,2013-02-27 19:10:23
b9f8b4019073fe60515bda8947d9040b4b73ea38...839957cf56acb905afc18605c0579d07083e0d37,13,43,43,86,33,2013-02-13 11:48:16,2013-02-13 11:48:16
2f0a75ab77af430f682d67aa9bb865007d832795...433f2dbceff3a597707d1375b519491737adf6e5,1,18,2,20,3,2013-02-09 10:30:49,2013-02-09 10:30:49
433f2dbceff3a597707d1375b519491737adf6e5...152f87864c020bfcd49b134e9c97b81e9ef1c215,2,0,4,4,2,2013-02-09 10:32:24,2013-02-09 10:32:24
152f87864c020bfcd49b134e9c97b81e9ef1c215...38985390b061a0d1d0d91d5574f612b4710768b6,11,14,24,38,7,2013-02-09 13:13:56,2013-02-09 13:13:56
38985390b061a0d1d0d91d5574f612b4710768b6...ff76e05271d50536c2c94b98d2949ad13355b78c,1,1,0,1,1,2013-02-09 13:16:33,2013-02-09 13:16:33
ff76e05271d50536c2c94b98d2949ad13355b78c...2f019b2b4ca7ab646427b81ebaf3ff96cda211f4,4,9,69,78,6,2013-02-09 13:21:19,2013-02-09 13:21:19
2f019b2b4ca7ab646427b81ebaf3ff96cda211f4...38737079b6c1096c2517e249198b8bc0bedf4156,396,1,76030,76031,391,2013-02-09 13:26:47,2013-02-09 13:26:47
38737079b6c1096c2517e249198b8bc0bedf4156...a404c43805cf6256f80dad6247a16db257a42d17,1,0,229,229,5,2013-02-09 13:34:04,2013-02-09 13:34:04
a404c43805cf6256f80dad6247a16db257a42d17...fcfb6d8438c5a728a0ea6f026f9b1297c3ec3a1a,2,0,43,43,3,2013-02-11 07:15:42,2013-02-11 07:15:42
fcfb6d8438c5a728a0ea6f026f9b1297c3ec3a1a...7a88bf09782db5f6c2b22a0e16fbc9df1a2168eb,2,1,65,66,5,2013-02-11 07:58:02,2013-02-11 07:58:02
7a88bf09782db5f6c2b22a0e16fbc9df1a2168eb...2d83e43db0163028fddd54095a7f7260b3e5cc65,1,2,4,6,3,2013-02-11 08:02:52,2013-02-11 08:02:52
2d83e43db0163028fddd54095a7f7260b3e5cc65...ab19196391f6383cd11a9f2f748bc2a90287fcc4,1,10,1,11,1,2013-02-11 08:14:32,2013-02-11 08:14:32
2f0a75ab77af430f682d67aa9bb865007d832795...40e7846f3e25b7f679c9dda719c135fca1ef3d5b,2,6,0,6,2,2013-02-08 16:04:08,2013-02-08 16:04:08
40e7846f3e25b7f679c9dda719c135fca1ef3d5b...2bd955961cdb6d0fa7e51e8fbb61581d6b101b05,2,4,1,5,2,2013-02-09 20:01:17,2013-02-09 19:54:52
fb71426cdbda99e83b3bcfdcd2c8cf50d7e7c9e0...9f8d50e99699accc1898fad25eee5d536505682d,1,9,2,11,1,2013-09-29 14:43:33,2013-09-29 14:43:33
9f8d50e99699accc1898fad25eee5d536505682d...9da1928faae709f958504451a724d1d555421573,2,32,35,67,11,2013-09-29 14:43:59,2013-09-29 14:43:59
9da1928faae709f958504451a724d1d555421573...267e8c73f2533942b7d112f1b827131fd4bbad72,2,1,9,10,2,2013-09-29 14:45:43,2013-09-29 14:45:43
9764ba6df2357ee93b9d4163f4011552be32de25...32a5548c416ea1e2537c9c89735629d83d95f270,1,3,0,3,1,2013-02-17 10:05:26,2013-02-17 10:05:26
32a5548c416ea1e2537c9c89735629d83d95f270...1efeb1b562cd9c8e2e460d2753da5bb2f5978bfd,2,8,16,24,3,2013-02-17 10:16:19,2013-02-17 10:16:19
9764ba6df2357ee93b9d4163f4011552be32de25...3ae7a45d5af0843ee6821c601b0825157c8d3025,2,2,2,4,2,2013-02-17 10:00:02,2013-02-17 10:00:02
0a94640e328ab30dcf90e65ba79242bc1aa77a57...e3d7ce2cc482a730b2dc63ca09057b22a960b998,6,19,23,42,8,2013-01-05 10:12:02,2013-01-05 10:12:02
e3d7ce2cc482a730b2dc63ca09057b22a960b998...5a214ee6f198a90f41a54b3dd7f2ff6a318a8deb,10,9,62,71,15,2013-01-05 11:11:15,2013-01-05 11:11:15
5a214ee6f198a90f41a54b3dd7f2ff6a318a8deb...2f5a733346959f993d7e87ad944d38eb8dbe6f13,1,1,0,1,1,2013-01-05 11:12:31,2013-01-05 11:12:31
2f5a733346959f993d7e87ad944d38eb8dbe6f13...de05a598b3d73a545899f26173cafbaeff474629,4,36,31,67,16,2013-01-05 11:30:42,2013-01-05 11:30:42
de05a598b3d73a545899f26173cafbaeff474629...1724f45f46dcf278abb76fe92ef2c8648f5ea21f,7,88,56,144,18,2013-01-05 12:49:08,2013-01-05 12:49:08
0a94640e328ab30dcf90e65ba79242bc1aa77a57...a1566a9c8645510f83782d181e41044d1ad2ec7f,13,142,183,325,24,2013-01-05 01:53:34,2013-01-05 01:18:39
0d5c6a48be6417b1e61f9ca3f8f8dbe95f059b97...ab344f31b6a9b9456ffed1d30fb77bc6bd0a2381,2,27,27,54,11,2013-01-09 09:07:55,2013-01-09 09:07:55
f33ada855c68a24499737deff701e9d7387bc98d...d5642d3098f33fc5128cb53a52ce80a2ade4b83e,1,10,10,20,4,2013-01-05 20:50:12,2013-01-05 20:50:12
51f48392abb225eaed58a6368382cdc28a961d3b...527d223680864a40887674768cf83a4a8626ead9,4,31,22,53,14,2012-11-18 20:51:53,2012-11-14 13:45:15
527d223680864a40887674768cf83a4a8626ead9...20189f84eef7b242962242b4a5d929208d561ed2,3,157,140,297,99,2012-11-18 20:51:53,2012-11-18 20:51:49
51f48392abb225eaed58a6368382cdc28a961d3b...bb3fc1e04ed32b16a7ea5e7be11944e4eda4afaf,1,1,1,2,1,2012-11-18 18:36:22,2012-11-18 18:36:22
51f48392abb225eaed58a6368382cdc28a961d3b...e226551e812faf2264b9747e3123c3ec0d1b9e58,1,7,3,10,3,2012-11-18 17:56:29,2012-11-18 17:53:30
ca54d43f9900666ff86fb4c647f9f9441eec781a...1c5b2a5153abee3a140ce1f2926d746675addcf5,10,186,15,201,16,2012-11-10 21:08:47,2012-11-10 21:08:47
1c5b2a5153abee3a140ce1f2926d746675addcf5...3e0467333471576735d225baec289c1e67e1a09c,5,17,3,20,6,2012-11-10 21:33:10,2012-11-10 21:33:10
3e0467333471576735d225baec289c1e67e1a09c...283a9c7b7d5818c18f100e50c66420441c090fee,3,6,6,12,3,2012-11-10 21:45:13,2012-11-10 21:45:13
283a9c7b7d5818c18f100e50c66420441c090fee...3c7806c3f29e0c2cdbb0c973a9180296267815cb,3,4,3,7,3,2012-11-10 22:08:42,2012-11-10 22:08:42
ca54d43f9900666ff86fb4c647f9f9441eec781a...4abf5d06f1104469500c3565890f70f81fbee8bc,2,5,5,10,5,2012-11-10 16:30:22,2012-11-10 16:30:22
5ec1ad8b2375bdce7a820df1be3dc67b18ad2bd0...0189ee97ed34b74cf0f500d678d4435b17ab6a85,7,56,18,74,13,2012-10-21 09:12:14,2012-10-21 09:12:14
84465576d72a0ca98d2b9f6f4101d8c8e80bb1ef...eededdd4beeb995a270172bb1985228ee09dbd41,1,1,1,2,1,2012-12-07 18:36:12,2012-12-07 13:55:56
84465576d72a0ca98d2b9f6f4101d8c8e80bb1ef...12b4bb5946e6f43962a2161711e672facce1c1f4,1,39,21,60,10,2012-12-07 15:42:09,2012-12-07 15:42:09
23a8e59938477be9938ed96176e8f9220ca78471...045b4c8fcd3898bf66ac74acdf13cc079a104105,3,34,37,71,21,2012-12-07 03:46:29,2012-12-07 03:40:42
9f940aeaf4fbfed2906900dda81b1f6b5a0656a6...5d219bd5f04ea5a9745f37bc2bac87ddc9460d1f,1,1,1,2,2,2012-12-11 07:22:14,2012-12-11 07:21:57
9f940aeaf4fbfed2906900dda81b1f6b5a0656a6...c76764b7dc2b0b7ac04215b0bc9b644db1b30796,5,42,36,78,6,2012-12-11 01:39:05,2012-12-11 01:39:05
9f940aeaf4fbfed2906900dda81b1f6b5a0656a6...7d3ee2baa61fcc4d127260e8f2d9b87687c528b5,1,1,2,3,1,2012-12-11 01:17:09,2012-12-08 22:05:48
d6338a8482920fc69cc016e5da796194034a1861...0103363191d63d9a81bfeba61abf443532f47183,9,21,17,38,9,2013-03-21 19:01:14,2013-03-21 19:01:14
0103363191d63d9a81bfeba61abf443532f47183...c4299bb45a97314fd51962b91346c65ba564d388,3,80,33,113,13,2013-03-21 20:11:08,2013-03-21 20:11:08
c4299bb45a97314fd51962b91346c65ba564d388...fec283889bdc02893bd2fc78a0638b9a4ad2ac1a,1,6,0,6,1,2013-03-21 20:22:21,2013-03-21 20:22:21
fec283889bdc02893bd2fc78a0638b9a4ad2ac1a...ad5ea14210cc6dcb674c421e296b67ed2d0e6dbc,2,1,1,2,1,2013-03-21 20:22:54,2013-03-21 20:22:54
ad5ea14210cc6dcb674c421e296b67ed2d0e6dbc...5f9d654939d388c7aeb8e84f6bb5b0d65319c535,2,12,5,17,2,2013-03-21 20:50:18,2013-03-21 20:50:18
1752c6dc8b755bc2fbff2757e8549521b0823048...e2ddf03c7edc39576901106bbf4bbec7b41053e8,1,1,1,2,1,2013-03-19 10:52:59,2013-03-19 10:52:59
1752c6dc8b755bc2fbff2757e8549521b0823048...5bf3a898edbbd0fc4f7a4557f6ffaea8ffabfbc7,5,3,183,186,14,2013-03-19 10:34:14,2013-03-19 10:34:14
5bf3a898edbbd0fc4f7a4557f6ffaea8ffabfbc7...f3dfd2299381778d66f833520afa7aeb7804f576,3,20,1,21,3,2013-03-19 10:34:59,2013-03-19 10:34:59
f3dfd2299381778d66f833520afa7aeb7804f576...57f3409bcc6a4bee6bc29f8cd03f501c117655b0,7,39,25,64,8,2013-03-19 10:35:42,2013-03-19 10:35:42
57f3409bcc6a4bee6bc29f8cd03f501c117655b0...4d378f3c9a7bec3cbdbd2b2e59150702849e65f7,2,50,0,50,2,2013-03-19 10:35:55,2013-03-19 10:35:55
4d378f3c9a7bec3cbdbd2b2e59150702849e65f7...124a5e270e581bf3928559bd2de2c9c973c30952,6,56,6,62,10,2013-03-19 11:28:29,2013-03-19 11:28:29
124a5e270e581bf3928559bd2de2c9c973c30952...b1bd3f1252eb529030f2295e4c2a991158894b64,14,247,82,329,30,2013-03-19 12:39:32,2013-03-19 12:39:32
b1bd3f1252eb529030f2295e4c2a991158894b64...ba4f0abf47940f27160166500979f6bcbd797d45,2,7,5,12,2,2013-03-19 12:50:26,2013-03-19 12:50:26
ba4f0abf47940f27160166500979f6bcbd797d45...063c4a069c1de3ee70cc500906121367b94a7886,4,19,63,82,4,2013-03-19 12:58:58,2013-03-19 12:58:58
063c4a069c1de3ee70cc500906121367b94a7886...e6c20802147e895ddbb0036349dcd585675e6d03,1,1,1,2,1,2013-03-19 13:04:58,2013-03-19 13:04:58
e6c20802147e895ddbb0036349dcd585675e6d03...70af962963e6fd353c6d866899e571776b24b044,1,12,12,24,1,2013-03-19 13:11:31,2013-03-19 13:11:31
70af962963e6fd353c6d866899e571776b24b044...2465a4fdb27ff90a58974b2d2dbf191626f53169,2,1,15,16,2,2013-03-19 13:37:11,2013-03-19 13:37:11
2465a4fdb27ff90a58974b2d2dbf191626f53169...4403f71f454d8341fba830db1f0aaf95ef2dc54b,5,9,2,11,3,2013-03-19 13:54:58,2013-03-19 13:54:58
4403f71f454d8341fba830db1f0aaf95ef2dc54b...0cbb235c3e74aa5dd716cdf9ab06db779f6166e8,2,6,6,12,2,2013-03-19 15:53:21,2013-03-19 15:53:21
0df01283b082704a16bee11f735aa9a82cfdc773...f7ca6c5079bb3c79c709721dae06b77200a1972e,1,1,1,2,1,2013-03-21 13:20:17,2013-03-21 13:20:17
3471e26fb218ce3f827c652792ac6c429c861fc0...693878cf3898b2161904f28db971acf78bfd1ae5,1,16,0,16,1,2013-04-28 20:04:56,2013-04-28 20:04:56
693878cf3898b2161904f28db971acf78bfd1ae5...ad6bcb1396d764b2f3ce1af63d1d0412d1120d14,2,3,3,6,3,2013-04-28 20:10:10,2013-04-28 20:10:10
ad6bcb1396d764b2f3ce1af63d1d0412d1120d14...348eb12598afb7f61b438da5e2240b709b17402f,3,6,4,10,4,2013-04-29 06:15:18,2013-04-29 06:15:18
348eb12598afb7f61b438da5e2240b709b17402f...a1704273ecd8809f918e5776f4bc27490169ae2a,2,32,18,50,7,2013-04-29 06:43:18,2013-04-29 06:43:18
a1704273ecd8809f918e5776f4bc27490169ae2a...fbb7cd8b769711e884ca5a6bde92d75f4d0600ed,1,1,1,2,1,2013-04-29 06:49:25,2013-04-29 06:49:25
ebf6821f54386d154cf250053b1007b61b1f9a27...bfaa3edbf185ac1153cdda305246117c45ae622e,2,7,45,52,3,2013-04-29 10:14:55,2013-04-29 10:14:55
bfaa3edbf185ac1153cdda305246117c45ae622e...5872b10de537dd120aa30b72f4fa0e8eb7472ecd,1,1,1,2,1,2013-04-29 10:18:08,2013-04-29 10:18:08
5872b10de537dd120aa30b72f4fa0e8eb7472ecd...de2cd345eba0039907be58455dd2e95a0bb17d89,2,0,16,16,2,2013-04-29 10:50:23,2013-04-29 10:50:23
de2cd345eba0039907be58455dd2e95a0bb17d89...f81e201cc8a29cb5439ba3fbe31197c23e438235,1,0,13,13,1,2013-04-29 10:54:12,2013-04-29 10:54:12
f81e201cc8a29cb5439ba3fbe31197c23e438235...65b601fe2ccc55b5f91db1e9a8d7626d4fe3b6d5,1,1,0,1,1,2013-04-29 11:36:40,2013-04-29 11:36:40
6e1ee1fea6400c3621005f1b79e1b8dab43cd000...1df9deb21343434c3de69b32a3bd63486bcec6c0,1,1,2,3,1,2013-05-16 07:42:09,2013-05-11 05:26:21
6e1ee1fea6400c3621005f1b79e1b8dab43cd000...5b5ff7708be0eb896aca0eb203a38663242da08b,1,1,1,2,1,2013-05-13 08:59:30,2013-05-13 08:59:30
6e1ee1fea6400c3621005f1b79e1b8dab43cd000...b9a489f31fcd4c09756041ba4efb62158b4788ed,1,3,3,6,3,2013-05-13 07:48:08,2013-05-13 07:48:08
6e1ee1fea6400c3621005f1b79e1b8dab43cd000...bbd33a0d4d5fdb393da33fed4246b35e983edfd3,1,1,1,2,1,2013-05-13 07:34:46,2013-05-13 07:34:46
6e1ee1fea6400c3621005f1b79e1b8dab43cd000...ba21546a583750b0390f3ac19a6c0eda79a44bed,1,7,7,14,7,2013-05-12 14:11:09,2013-05-12 14:10:34
6e1ee1fea6400c3621005f1b79e1b8dab43cd000...56a0cc7feec54e7bd7a0480b13ffad5750e7ada5,1,4,3,7,2,2013-05-11 08:27:54,2013-05-11 08:27:54
6e1ee1fea6400c3621005f1b79e1b8dab43cd000...320f0ac856b9a1f6862e8189dccfcb9bb0589628,1,13,0,13,1,2013-05-11 07:53:07,2013-05-11 07:53:07
6e1ee1fea6400c3621005f1b79e1b8dab43cd000...aba29ab94ceb2957e4a284f882f92e4fa2f82650,1,1,1,2,1,2013-05-10 15:45:02,2013-05-10 15:45:02
6e1ee1fea6400c3621005f1b79e1b8dab43cd000...d5c0e9737a83dc18e11c2fafd9b3a9d85bc3c4c4,1,3,3,6,1,2013-05-10 13:29:08,2013-05-10 09:18:19
6e1ee1fea6400c3621005f1b79e1b8dab43cd000...85e784cc1d3d44cdb553bc3be77a3522e6ae4603,2,3,3,6,3,2013-05-09 16:41:00,2013-05-09 16:41:00
cde6b8e4da6d086786a2c0adceb50eaa73485d4c...23ee8e6257f09172e30c2bd6fd1d1fcd4d4e58b3,3,37,0,37,3,2013-05-01 09:41:37,2013-05-01 09:41:37
23ee8e6257f09172e30c2bd6fd1d1fcd4d4e58b3...083d66563e8275fd13851ec0a1974cb17379f84f,4,101,92,193,70,2013-05-01 10:29:29,2013-05-01 10:29:29
083d66563e8275fd13851ec0a1974cb17379f84f...56d15660b8e89ae0bc37953b4fe24739323e5921,4,10,15,25,6,2013-05-01 10:39:37,2013-05-01 10:39:37
2e9599b746d5858eea0e4edcd5db4969b74c885c...862e0ff6b846d9207c3adf9e86b5b84420595935,3,133,24,157,7,2013-05-08 08:36:48,2013-05-08 05:19:51
2e9599b746d5858eea0e4edcd5db4969b74c885c...8dcd7343efa777bfedd27b83a708f6e9fa4f8280,1,2,2,4,2,2013-05-07 19:49:54,2013-05-07 19:49:54
3022b9fdbfce5c407d745d713ba73d729bc9cb1a...930f4366ba3030d54f994a6e454470adca74f888,2,7,1,8,3,2013-05-06 17:41:08,2013-05-06 17:41:08
930f4366ba3030d54f994a6e454470adca74f888...4d9bdab00501e01cc82a74ecfc4e7895421a5c2c,1,6,0,6,1,2013-05-06 17:56:45,2013-05-06 17:56:45
9e8aadb0f06f16248f82ae948ed7f875f8c0e2f2...71ff619973d52c22e49303883aaa77801be378c7,1,2,2,4,2,2012-11-22 01:38:56,2012-11-22 01:38:56
9e8aadb0f06f16248f82ae948ed7f875f8c0e2f2...6ddf4567f43497a10e7faddf98d0a5d467bf043c,2,1,2,3,2,2012-11-22 11:45:39,2012-11-22 11:45:39
6ddf4567f43497a10e7faddf98d0a5d467bf043c...8b4010397caf09a9db6759dd7be989d4dc4cfdcd,1,2,1,3,1,2012-11-22 19:22:44,2012-11-22 19:22:44
8b4010397caf09a9db6759dd7be989d4dc4cfdcd...246faa3d7a60ea2296a24d0c5de1a71a7a48854b,1,15,0,15,1,2012-11-22 19:49:01,2012-11-22 19:49:01
246faa3d7a60ea2296a24d0c5de1a71a7a48854b...3b7c2adf0aead7438a0319d21a050c30b408c03a,2,2,0,2,2,2012-11-22 19:49:44,2012-11-22 19:49:44
3b7c2adf0aead7438a0319d21a050c30b408c03a...ddb7399ac424222719ebfddb239abb3abac4b7eb,1,74,0,74,1,2012-11-24 23:05:11,2012-11-24 23:05:11
ddb7399ac424222719ebfddb239abb3abac4b7eb...2b1afa0e62e275c7b4df71ad454af34d454e0e17,5,17,18,35,13,2012-11-24 23:05:44,2012-11-22 20:50:36
2b1afa0e62e275c7b4df71ad454af34d454e0e17...b3834bc9b03566252ca83f70f4af882561ac261f,1,14,12,26,2,2012-11-24 23:05:47,2012-11-22 23:55:57
b3834bc9b03566252ca83f70f4af882561ac261f...267b18dead74106420430f79cde38fd90c17445d,2,99,0,99,3,2012-11-24 23:06:53,2012-11-24 23:04:13
267b18dead74106420430f79cde38fd90c17445d...79a4ed15cefc4f70919a8a0b5059816f823d69d2,2,16,6,22,2,2012-11-24 23:36:19,2012-11-24 23:36:19
00464099704ec16ad64faa3fe8c19d931ee7037a...30a66c065a14be05f05099118938fb20c8989b3e,7,73,12,85,9,2012-11-21 20:01:40,2012-11-21 20:01:40
00464099704ec16ad64faa3fe8c19d931ee7037a...1cda62465f60adf5abbcde443fbb1cb1e402a407,2,35,31,66,11,2012-11-21 19:05:37,2012-11-21 19:02:03
1cda62465f60adf5abbcde443fbb1cb1e402a407...3e800c3bb1b835cd17e32eedd8816bc17f6317e4,4,20,19,39,19,2012-11-21 19:25:49,2012-11-21 19:23:19
3e800c3bb1b835cd17e32eedd8816bc17f6317e4...d7ce2c5c0736de54478d96e8d11b3b9dc4fcb5e2,1,1,2,3,1,2012-11-21 19:26:37,2012-11-21 19:26:37
2032f4cd9665d0b4244e30160c64996dc37c0a0e...48de0ba867133232d5dc91c39333afd1d936e9bb,1,1,1,2,1,2012-11-01 22:34:16,2012-11-01 22:34:16
2032f4cd9665d0b4244e30160c64996dc37c0a0e...57e6777b3c3059c96b76776098b8eff4535770d0,1,2,2,4,2,2012-11-01 21:56:39,2012-11-01 21:56:39
57e6777b3c3059c96b76776098b8eff4535770d0...badb092a2d7e90ccf5358f1e8e6af9c9592351c4,1,18,20,38,1,2012-11-01 21:57:12,2012-11-01 21:57:12
badb092a2d7e90ccf5358f1e8e6af9c9592351c4...b1be377fb0b5e76fc1b0d78700eb3e714b66f1c2,3,17,0,17,3,2012-11-01 21:57:44,2012-11-01 21:57:44
b1be377fb0b5e76fc1b0d78700eb3e714b66f1c2...e60185699b0cd34fe3ae37db6db318478232c84b,2,26,8,34,2,2012-11-01 21:58:13,2012-11-01 21:58:13
2032f4cd9665d0b4244e30160c64996dc37c0a0e...f61ca97648b4438c9177a523214e6332cee32763,3,5,14,19,5,2012-11-01 20:45:31,2012-11-01 20:45:31
b6628b4a97f64bea9a9eec00cba5222e71efc584...8f3adf9f03465c8610800a63e7d7e05adea36e29,1,140,112,252,30,2012-10-25 08:57:23,2012-10-24 17:42:55
8f3adf9f03465c8610800a63e7d7e05adea36e29...c8fe07ed322eaa2f6d093d73d8c9ae6b36dbd758,1,44,47,91,9,2012-10-25 08:57:23,2012-10-24 17:50:34
c8fe07ed322eaa2f6d093d73d8c9ae6b36dbd758...5ff6fadcc1fc4588485d34a06c7e27d8b6f302c4,1,33,19,52,17,2012-10-25 08:57:23,2012-10-24 17:59:48
5ff6fadcc1fc4588485d34a06c7e27d8b6f302c4...fd86bf4ae9ccfaab6cf4dfba38de6c7e0b80ec9f,3,117,112,229,15,2012-10-25 08:57:23,2012-10-25 08:13:11
fd86bf4ae9ccfaab6cf4dfba38de6c7e0b80ec9f...f9def67981f34c843124b71823c6b1f41cf529e6,5,297,3,300,3,2012-10-25 08:57:23,2012-10-25 08:49:31
f9def67981f34c843124b71823c6b1f41cf529e6...03f43291cdf60c6a185383d7d218fd87196d6231,2,1,316,317,2,2012-10-25 08:57:23,2012-10-25 08:52:34
03f43291cdf60c6a185383d7d218fd87196d6231...1ea0dd0ffc37232d27f4fa1350af6ebb3b5439f2,193,100336,0,100336,169,2012-10-25 08:59:41,2012-10-25 08:59:41
1ea0dd0ffc37232d27f4fa1350af6ebb3b5439f2...6d0dcb6614fc0743d50ffe68bf61c2c50728c1d6,4,11,5,16,7,2012-10-25 09:16:14,2012-10-25 09:16:14
6d0dcb6614fc0743d50ffe68bf61c2c50728c1d6...11452c903fc7550921c1965e918524e4ab1b811d,1,1,1,2,1,2012-10-25 09:30:09,2012-10-25 09:30:09
c7c1a97c2fecb8931bbe66af6860a072ca97335d...232d61d59808e6f0c731d135d728800c4b13ae27,19,126,116,242,27,2013-01-17 15:35:57,2013-01-17 15:35:57
232d61d59808e6f0c731d135d728800c4b13ae27...6f05ea4f6e26e76edc0a6ad5d2eb4e5db676aea0,5,47,35,82,8,2013-01-18 18:21:13,2013-01-18 18:21:13
6f05ea4f6e26e76edc0a6ad5d2eb4e5db676aea0...af7dcda1cb33fc8c828d41f4c2ac89f7d2ce8315,1,1,1,2,1,2013-01-18 20:23:11,2013-01-18 20:23:11
af7dcda1cb33fc8c828d41f4c2ac89f7d2ce8315...5c3fdfaacba50edbd6d6d7db65d2aa2e69bb5cad,1,1,1,2,1,2013-01-19 09:11:25,2013-01-19 09:11:25
5c3fdfaacba50edbd6d6d7db65d2aa2e69bb5cad...569a88a456a5f01fbef6f5280b6982c3db8e2a72,2,15,2,17,4,2013-01-19 09:58:36,2013-01-19 09:58:36
569a88a456a5f01fbef6f5280b6982c3db8e2a72...3a1022e3818e2a56e151eca22f25379aa5521866,2,2,2,4,2,2013-01-19 10:09:23,2013-01-19 10:09:23
3a1022e3818e2a56e151eca22f25379aa5521866...cfe89832722c50e798d73ac43d6e0ae7d7fb78e9,1,2,2,4,1,2013-01-19 10:50:44,2013-01-19 10:50:44
cfe89832722c50e798d73ac43d6e0ae7d7fb78e9...54a24608a29d113f0c607027cddd8b6947c6a55c,3,39,14,53,10,2013-01-19 11:56:55,2013-01-19 11:56:55
54a24608a29d113f0c607027cddd8b6947c6a55c...cb96cc030ad159342c82887120eb28e315424121,1,3,3,6,1,2013-01-19 11:57:50,2013-01-19 11:57:50
cb96cc030ad159342c82887120eb28e315424121...fa46fc94a73f00c0a6d231279a9518aad9a8b5f0,1,2,2,4,2,2013-01-19 13:52:25,2013-01-19 13:52:25
fa46fc94a73f00c0a6d231279a9518aad9a8b5f0...7e6a5800b65f10142e7b3b01e54b3aacb55a6789,1,2,2,4,2,2013-01-19 14:24:07,2013-01-18 19:02:48
7e6a5800b65f10142e7b3b01e54b3aacb55a6789...359703c6968526b44bd3e5b089db1db667781a7c,1,5,2,7,2,2013-01-19 14:24:37,2013-01-19 00:30:05
359703c6968526b44bd3e5b089db1db667781a7c...8db80f1f6d5cf58ed7490803a38b19579496b7eb,3,3,2,5,3,2013-01-19 14:24:51,2013-01-19 00:32:38
8db80f1f6d5cf58ed7490803a38b19579496b7eb...bba88e84a96349889696df83b941edd28856f1c2,1,2,2,4,2,2013-01-19 14:24:56,2013-01-19 00:33:27
bba88e84a96349889696df83b941edd28856f1c2...8a5b770c3669f91d1b6da65a1f95272091479293,2,14,14,28,6,2013-01-19 14:26:23,2013-01-19 00:34:11
8a5b770c3669f91d1b6da65a1f95272091479293...75447fb044d767a5bda7c707e58a0456318c021a,1,40,13,53,13,2013-01-19 14:26:40,2013-01-19 00:35:16
75447fb044d767a5bda7c707e58a0456318c021a...47e510e14f53cf4d46adeda61069d2c3a591107f,2,2,2,4,2,2013-01-19 14:26:55,2013-01-19 00:47:57
47e510e14f53cf4d46adeda61069d2c3a591107f...607a38dd00018d28dfd7ce55643ce354957e3533,1,2,3,5,2,2013-01-19 14:27:00,2013-01-19 14:22:41
607a38dd00018d28dfd7ce55643ce354957e3533...d9270337c1c7ee387fc6e563c55101ce7320e257,1,9,7,16,2,2013-01-19 14:27:03,2013-01-19 14:23:05
d9270337c1c7ee387fc6e563c55101ce7320e257...cd8a302997aa8214de8a8e27fe9bb87c1b8abdf2,2,4,0,4,2,2013-01-20 12:17:56,2013-01-20 12:17:56
cd8a302997aa8214de8a8e27fe9bb87c1b8abdf2...820e84662f429f688e519641f5fadfdf8e845611,2,2,1,3,2,2013-01-21 07:06:25,2013-01-21 07:06:25
22d6ce987360638d75e574ca6663fe0e23dfccc0...c280c3ce6d1c19f1acb470862338c0c17e16bdab,1,1,1,2,1,2013-03-01 14:09:14,2013-01-17 00:05:44
22d6ce987360638d75e574ca6663fe0e23dfccc0...5da7424f8dc68a877aafcf8df6d67af28b8b945d,2,17,15,32,14,2013-03-01 12:36:12,2013-03-01 12:36:12
5da7424f8dc68a877aafcf8df6d67af28b8b945d...153a4c142df90f769df68b333f533c639f923148,2,9,8,17,7,2013-03-01 13:09:11,2013-03-01 13:09:11
153a4c142df90f769df68b333f533c639f923148...520f02259c7076ca44f298dd401ef9df2ac8c0d3,2,12,10,22,9,2013-03-01 13:15:29,2013-03-01 13:15:29
520f02259c7076ca44f298dd401ef9df2ac8c0d3...6aead7991f93c63e23fd96677a1c499ebca2155f,6,15,14,29,13,2013-03-01 13:24:59,2013-03-01 13:24:59
6aead7991f93c63e23fd96677a1c499ebca2155f...dbcf4144ee4da9670efa26f2297d11291823d949,1,2,2,4,2,2013-03-01 13:35:22,2013-03-01 13:35:22
dbcf4144ee4da9670efa26f2297d11291823d949...a73e58f70b264b36b3291bba9a8a2789235ccadb,1,1,1,2,1,2013-03-01 13:59:43,2013-03-01 13:59:43
3bb342b961f2a02098175e24855ab56fc1785c43...d269d107d86c600ab2add651f47cced8f601ae84,2,2,3,5,2,2013-02-27 17:12:02,2013-02-27 17:12:02
43d75960303be538fb79804ca6e2a90241aee0df...7499f65014257989510da50505fa7c0f5a4fae88,10,35,42,77,25,2013-02-27 16:50:30,2013-02-27 16:50:30
1cfc2b6fc7e49f8281a055b340509863c7706ada...737a449795c9057fab1f326f28c8e24972d0bd71,1,57,25,82,17,2013-03-02 12:04:57,2013-03-02 11:53:27
1cfc2b6fc7e49f8281a055b340509863c7706ada...86da625f1dc99ef57e554f1c39cb0db20f45a5b6,2,12,12,24,10,2013-03-02 10:58:47,2013-03-02 10:58:47
86da625f1dc99ef57e554f1c39cb0db20f45a5b6...907c334fe0ef1be349668cb7bd9639780a098344,1,1,1,2,1,2013-03-02 11:23:30,2013-03-02 11:23:30
1cfc2b6fc7e49f8281a055b340509863c7706ada...1c8c5c76b6a0cd1b55feb11b26c25b8e3c08173f,1,16,17,33,14,2013-03-01 22:53:37,2013-03-01 22:53:37
1cfc2b6fc7e49f8281a055b340509863c7706ada...dd653f62f3bf07e1ea2260b06cd44ab1aaba028b,1,2,1,3,1,2013-03-01 16:34:11,2013-03-01 16:34:11
dd653f62f3bf07e1ea2260b06cd44ab1aaba028b...1c0c7bd6e3ca2a0cbcb7af6a4b6c8067e10b3880,1,1,1,2,1,2013-03-01 16:36:19,2013-03-01 16:36:19
863d297ede6989f00ab0a5af28efdf99a51f805a...c13f9adab8199d35b6f04e87be767655002a7725,1,1,1,2,1,2013-02-27 22:09:14,2013-02-27 22:09:14
863d297ede6989f00ab0a5af28efdf99a51f805a...5f9bc743f5fbd7170bb3040ab8e5d8fbafb3b903,1,42,12,54,13,2013-02-27 20:51:46,2013-02-27 20:51:46
5f9bc743f5fbd7170bb3040ab8e5d8fbafb3b903...46bbeabcde4a2b7cdfcec29da4bde51ceb45a97a,1,6,4,10,5,2013-02-27 21:17:46,2013-02-27 21:17:46
863d297ede6989f00ab0a5af28efdf99a51f805a...70e1b3b1cb7dbfaceec702f929ca13536772ac2b,1,3,1,4,2,2013-02-27 19:32:36,2013-02-27 19:28:36
375caeefcfb2672c8fdce18cf6f35372729d0c43...fd01f3aacda1e7e1966489e7d9a31f89745cd509,2,40,4,44,6,2013-02-13 11:09:16,2013-02-13 11:09:16
fd01f3aacda1e7e1966489e7d9a31f89745cd509...54ab9bb6df3a2cd9f9384aebae07e0b18acee10b,2,8,1,9,3,2013-02-13 13:47:59,2013-02-13 13:47:59
54ab9bb6df3a2cd9f9384aebae07e0b18acee10b...6fc3263e15b71830e6f1b2a66891da5f4c055137,6,28,17,45,15,2013-02-13 14:48:52,2013-02-13 14:48:52
6fc3263e15b71830e6f1b2a66891da5f4c055137...6df02adc7a5cb7badf748be783f9a552cf19aeee,3,17,1,18,4,2013-02-14 14:51:56,2013-02-14 14:51:56
6df02adc7a5cb7badf748be783f9a552cf19aeee...c305eb31aa1cf1aec24b907e0db1d7b2084400dc,2,54,3,57,11,2013-02-14 15:55:33,2013-02-14 15:55:33
ab19196391f6383cd11a9f2f748bc2a90287fcc4...8e0b58d7e7cde0d9afb93f267197f62b9b649cd3,3,17,0,17,3,2013-02-11 13:47:01,2013-02-11 13:47:01
8e0b58d7e7cde0d9afb93f267197f62b9b649cd3...d64090b8a9065746c6d532057228c079a1d57013,27,117,159,276,80,2013-02-11 17:16:59,2013-02-11 17:16:59
d64090b8a9065746c6d532057228c079a1d57013...dd8d0a659d947df0dcaaae2960aa1567a8740b11,2,8,7,15,2,2013-02-11 17:25:06,2013-02-11 17:25:06
dd8d0a659d947df0dcaaae2960aa1567a8740b11...ea0cb39d63cb193179338b9348c40d59da5787b1,3,5,5,10,5,2013-02-11 17:27:26,2013-02-11 17:27:26
ea0cb39d63cb193179338b9348c40d59da5787b1...2a1fac9e4f9687d4b55f13527aed5dfb848e3a4d,1,11,0,11,1,2013-02-11 17:41:02,2013-02-11 17:41:02
2a1fac9e4f9687d4b55f13527aed5dfb848e3a4d...ab0cfc00367a60cfe9cc488521bf55882d54769a,5,7,12,19,8,2013-02-11 18:28:27,2013-02-11 18:28:27
ab19196391f6383cd11a9f2f748bc2a90287fcc4...f6957f76586a5bba510f29a7ed965a606945c868,1,1,1,2,1,2013-02-11 12:22:06,2013-02-11 12:22:06
f6957f76586a5bba510f29a7ed965a606945c868...157b03866124d562b78583fbcb38b3db8ac84d4e,1,2,1,3,1,2013-02-17 13:02:22,2013-02-17 13:02:22
8045a81bcf5822f1992442750e1484a93c368229...818caf0b5d1fc4f0cb2889ca5bd9e2d0d7fd8ac8,2,69,9,78,8,2013-02-08 13:33:29,2013-02-08 13:33:29
818caf0b5d1fc4f0cb2889ca5bd9e2d0d7fd8ac8...9544f9038981b881b539419be72276b2b2fd079f,2,41,12,53,15,2013-02-08 15:48:05,2013-02-08 15:33:15
9544f9038981b881b539419be72276b2b2fd079f...56b3223945637d25394b001c880626f9a4a5b9e0,1,1,1,2,1,2013-02-08 17:19:59,2013-02-08 17:19:59
267e8c73f2533942b7d112f1b827131fd4bbad72...e48c6fab60d57b4af31f5b5d3e81ba09e4e68881,2,15,6,21,2,2013-09-29 20:36:44,2013-09-29 20:36:44
267e8c73f2533942b7d112f1b827131fd4bbad72...d8562cc9a141917e5b0adc1f33f2ec8da8ab10d4,7,131,1,132,10,2013-09-29 17:31:08,2013-08-19 09:11:36
d8562cc9a141917e5b0adc1f33f2ec8da8ab10d4...e8b6974af3ca2835c5ef54cbffb1535ebd50aeca,3,7,9,16,7,2013-10-03 13:36:43,2013-10-03 13:29:13
5d72a3e1330e536c13e060aab133ecf15cb00cb7...67465dc5ef885fef236b6a4e2de5e008e8e149b1,2,4,4,8,4,2013-02-19 09:45:49,2013-02-19 09:45:49
5d72a3e1330e536c13e060aab133ecf15cb00cb7...fab586bc87899a2e9a480fbe8651d4e1faa0fc6d,1,1,1,2,1,2013-02-19 09:17:59,2013-02-18 16:03:29
0d3b75845ae18475f74eaea0692ab532ce1ffd49...cfdf94fc279e45ddbe0bbb94022a7488c663501c,1,1,1,2,1,2013-02-17 14:18:42,2013-02-17 14:18:42
cfdf94fc279e45ddbe0bbb94022a7488c663501c...020078663e401798d199a1a293ac59d990f81dad,5,22,6,28,9,2013-02-18 07:28:18,2013-02-18 07:28:18
eaa8cd28d07a1017b3e2abfc43d008daca962343...eded4bfa95320974a0a2f52da2ce0f46974734bb,3,16,3,19,7,2013-01-05 21:09:26,2013-01-05 21:09:26
0a1603992490d47b3fe676a02dedb5417603a1f2...cc64f2a814802abe9ae3bb8297079b643c8774df,11,214,207,421,17,2013-01-07 18:52:43,2013-01-07 18:48:57
cc64f2a814802abe9ae3bb8297079b643c8774df...b6ac9b43344fa645e54991619153c82f643b9579,1,1,0,1,1,2013-01-07 20:05:21,2013-01-07 20:05:21
b6ac9b43344fa645e54991619153c82f643b9579...11e28aff7db8498dc08165717b476a7b0a34533f,1,2,2,4,2,2013-01-07 20:20:19,2013-01-07 18:04:20
11e28aff7db8498dc08165717b476a7b0a34533f...b7314a1687cf67bc8b74f652e44d9b0cb92d4826,1,1,1,2,1,2013-01-07 20:20:20,2013-01-07 18:19:50
b7314a1687cf67bc8b74f652e44d9b0cb92d4826...b5f116f08bfd02f87b819411f89d93c711411c90,2,22,0,22,3,2013-01-07 20:20:20,2013-01-07 18:39:15
b5f116f08bfd02f87b819411f89d93c711411c90...ea8cd13f79f52e500ddb174f18ae0d6bd83631e7,1,1,1,2,1,2013-01-07 20:20:20,2013-01-07 18:47:53
ea8cd13f79f52e500ddb174f18ae0d6bd83631e7...71c8801eefd64d4b2e2f37205b1a5415e3c5bf93,1,1,1,2,1,2013-01-07 20:20:20,2013-01-07 20:18:41
71c8801eefd64d4b2e2f37205b1a5415e3c5bf93...92a619ad28ae380e5c88c1784bb92f91a7c55bb1,3,6,8,14,3,2013-01-07 20:23:13,2013-01-07 20:22:35
92a619ad28ae380e5c88c1784bb92f91a7c55bb1...b6568db1bc1dcd7f8b4d5a946b0b91f9dacd7327,1,2,1,3,1,2013-01-08 10:23:33,2013-01-08 10:23:33
ab344f31b6a9b9456ffed1d30fb77bc6bd0a2381...3aa5daf69636948aebc9fdce6e63e58f96b8c25f,1,1,0,1,1,2013-01-09 16:39:43,2013-01-09 09:04:41
ab344f31b6a9b9456ffed1d30fb77bc6bd0a2381...2f6603e58174e5aff35fbc0ce6a9616dc77b077a,11,116,95,211,16,2013-01-09 05:14:05,2013-01-09 05:14:05
2f6603e58174e5aff35fbc0ce6a9616dc77b077a...9b22f41e540b0a27d135c6d5fc4bef08a6e1d9f8,2,4,0,4,2,2013-01-09 10:04:55,2013-01-09 10:04:55
9b22f41e540b0a27d135c6d5fc4bef08a6e1d9f8...7bfd38eaa95988accfc6bb09759d7688126f5692,2,44,0,44,2,2013-01-09 06:14:05,2013-01-09 06:14:05
fed9a3d5c8941dc50ba711d1dd64263bf8d02ae1...891bc414b13a1c6e2a9a09261de1ba3e36270f2f,1,2,2,4,2,2013-01-05 21:26:14,2013-01-05 21:26:14
891bc414b13a1c6e2a9a09261de1ba3e36270f2f...2c8a46e0fe0232e811e4bfbb0fa8d607298fdf10,1,2,2,4,2,2013-01-05 21:29:48,2013-01-05 21:29:48
2c8a46e0fe0232e811e4bfbb0fa8d607298fdf10...031008648f3c2ffb860c39899398dceb395d2948,3,10,10,20,10,2013-01-05 21:36:04,2013-01-05 21:36:04
031008648f3c2ffb860c39899398dceb395d2948...baf591cc2793533e524810c14afc76b5fe5126f7,2,1,2,3,2,2013-01-05 21:49:01,2013-01-05 21:49:01
baf591cc2793533e524810c14afc76b5fe5126f7...68eb394824f6d7edd895d8175d16f281af68073a,4,9,6,15,6,2013-01-05 22:08:02,2013-01-05 22:08:02
68eb394824f6d7edd895d8175d16f281af68073a...1665a06fddf7c51fcf80da74590c613f5c785f47,3,60,19,79,13,2013-01-05 22:30:38,2013-01-05 22:30:38
1665a06fddf7c51fcf80da74590c613f5c785f47...676a9a7e287655342ac0683dedce0c69a984465e,1,1,1,2,1,2013-01-07 09:32:12,2013-01-07 09:32:12
676a9a7e287655342ac0683dedce0c69a984465e...6c777ff8237e6c0f8628a2997848cd868974560c,3,26,30,56,10,2013-01-07 12:08:03,2013-01-07 12:08:03
6c777ff8237e6c0f8628a2997848cd868974560c...8d8c161a7f1daa92a58194765816b75449769fb1,4,14,4,18,7,2013-01-07 12:36:01,2013-01-07 12:36:01
8d8c161a7f1daa92a58194765816b75449769fb1...a0bd09ab830899237ada52f02437164d7eaaf1ed,1,4,4,8,2,2013-01-07 12:44:57,2013-01-07 12:44:57
a0bd09ab830899237ada52f02437164d7eaaf1ed...fb470e8e2aff80a16b56f9c5422c04e74dcb213c,4,18,12,30,6,2013-01-07 15:36:24,2013-01-07 15:36:24
3c7806c3f29e0c2cdbb0c973a9180296267815cb...9d499b86f8fdb41d2e1cd202989abe67ab88ace7,2,3,3,6,3,2012-11-13 10:36:41,2012-11-13 10:36:41
12b4bb5946e6f43962a2161711e672facce1c1f4...40576b87092598b28a11ba796bab6857d009702b,2,173,118,291,20,2012-12-07 16:39:40,2012-12-04 23:57:21
40576b87092598b28a11ba796bab6857d009702b...e1282d507f1a0321c4f25815470b0fa05265e6dd,6,122,94,216,21,2012-12-07 18:06:46,2012-12-07 18:06:46
e1282d507f1a0321c4f25815470b0fa05265e6dd...4b2ecbc420ca10ad78e0e6f921d6740c84f2574a,4,149,160,309,41,2012-12-07 21:05:17,2012-12-07 21:05:17
5d219bd5f04ea5a9745f37bc2bac87ddc9460d1f...8738eb23693b2cf4fdc2e5e77378478ba05eee24,1,1,1,2,1,2012-12-11 10:25:55,2012-12-11 10:25:55
8738eb23693b2cf4fdc2e5e77378478ba05eee24...f2bf05066d545259b1ca0a07561c2b8ee77918c0,1,1,1,2,1,2012-12-11 10:57:25,2012-12-11 10:57:25
5d219bd5f04ea5a9745f37bc2bac87ddc9460d1f...c92726e6c8a995e1555c31411977d6bcce25c1e3,3,15,16,31,7,2012-12-11 11:44:36,2012-12-11 11:44:36
c92726e6c8a995e1555c31411977d6bcce25c1e3...ca936d2784773652530e7b02af40b925ca45a4d6,10,83,12,95,13,2012-12-11 03:14:05,2012-12-11 03:14:05
ca936d2784773652530e7b02af40b925ca45a4d6...95af2baa3775144d9541ea3b6f2e4c87b65b309e,1,1,1,2,1,2012-12-11 16:14:18,2012-12-11 16:14:18
95af2baa3775144d9541ea3b6f2e4c87b65b309e...59a86e4229f187667a3f855aaf6250fd29655df2,1,2,6,8,2,2012-12-11 16:46:58,2012-12-11 16:46:58
59a86e4229f187667a3f855aaf6250fd29655df2...7f636b1306e821111555c9042b4cddc98b3dc666,2,2,2,4,2,2012-12-11 17:16:56,2012-12-11 17:16:56
26afde94fda0026fd52078427e3f52e804ba8404...592412992daf1830fb1df5cc06aac02814c6f911,2,48,12,60,3,2012-12-16 16:27:16,2012-12-16 16:27:16
592412992daf1830fb1df5cc06aac02814c6f911...5058c4fdcf51e3040121ecc822a6f856e7f4537d,2,16,2,18,3,2012-12-16 17:52:39,2012-12-16 17:52:39
5058c4fdcf51e3040121ecc822a6f856e7f4537d...e7abd35f731e63fdb8bb4b210297a20cb9b70479,1,1,1,2,1,2012-12-17 13:11:33,2012-12-17 13:11:33
e7abd35f731e63fdb8bb4b210297a20cb9b70479...f4a6f1fd5a9fb9f35bb43956275c5f1da96ce019,1,3,2,5,1,2012-12-17 13:57:10,2012-12-17 13:57:10
5f9d654939d388c7aeb8e84f6bb5b0d65319c535...26606aa2ec5f518f2b310a0e1855e0f3f43c9bbd,1,6,6,12,4,2013-03-22 01:11:53,2013-03-22 01:07:11
26606aa2ec5f518f2b310a0e1855e0f3f43c9bbd...f5e001bd8cc76fb104a2e7c6e1ac4f6d0c2e8bf0,1,44,43,87,4,2013-03-22 07:09:21,2013-03-22 02:59:36
07a88d66993da87c3f3b6f1108403f8671c19f1d...3b42c267a6299b7aeed8c3309dae49b5b7b3f9e0,2,2,0,2,2,2013-03-19 16:07:14,2013-03-19 16:07:14
3b42c267a6299b7aeed8c3309dae49b5b7b3f9e0...8ec01e0ba9f839db885598c59439bc3c2f697f58,2,0,6,6,2,2013-03-19 16:14:59,2013-03-19 16:14:59
8ec01e0ba9f839db885598c59439bc3c2f697f58...fb4f171587f4457488f9e3aa98e48467dde618ec,2,34,34,68,15,2013-03-19 16:52:17,2013-03-19 16:52:17
fb4f171587f4457488f9e3aa98e48467dde618ec...52d3fa191f570ddfad4549e848f45d90327e3df6,2,3,2,5,3,2013-03-19 17:17:59,2013-03-19 17:17:59
52d3fa191f570ddfad4549e848f45d90327e3df6...a3cdaeef6654edac27a07fac8189c581977827e5,9,141,104,245,11,2013-03-19 18:00:41,2013-03-19 18:00:41
a3cdaeef6654edac27a07fac8189c581977827e5...6880ace1feff9fdd390099026882fe4af3e4b742,1,1,1,2,1,2013-03-19 18:11:47,2013-03-19 18:11:47
f7ca6c5079bb3c79c709721dae06b77200a1972e...a1fe375e44987d89b9f9fbacb784eed83de233b2,5,6,66,72,11,2013-03-21 15:10:14,2013-03-21 14:41:16
f7ca6c5079bb3c79c709721dae06b77200a1972e...02f70851e4f029e5de877e2ed2851af269e6045b,1,2,2,4,2,2013-03-21 14:29:53,2013-03-21 14:29:53
fbb7cd8b769711e884ca5a6bde92d75f4d0600ed...de7d6431b1c449eb8ea3cba608068dc2b245b635,5,23,0,23,8,2013-04-29 07:10:45,2013-04-29 07:10:45
65b601fe2ccc55b5f91db1e9a8d7626d4fe3b6d5...ad2e4feb5eb0b671dd569c776c9209f864da9318,1,163,0,163,1,2013-04-29 12:52:06,2013-04-29 12:52:06
56d15660b8e89ae0bc37953b4fe24739323e5921...7e5cad8f280e9817eaa32e80d041cd606c6f0e88,1,1,1,2,1,2013-05-01 22:09:18,2013-05-01 22:09:18
de7680b137658a72bf3e767b2edfca7edf4adba1...28ef0fe751e48f51dad0874771305a253dcf06b3,1,4,0,4,1,2013-05-08 06:09:23,2013-05-08 06:09:23
4d9bdab00501e01cc82a74ecfc4e7895421a5c2c...7357ebc4a0fbf645024d0da96766bfc01f08b415,1,5,3,8,3,2013-05-06 23:58:10,2013-05-06 23:58:10
7357ebc4a0fbf645024d0da96766bfc01f08b415...cef76fdd17f2cb2f165900d907517857a8a73787,1,3,4,7,3,2013-05-08 20:42:29,2013-05-08 20:39:31
4d9bdab00501e01cc82a74ecfc4e7895421a5c2c...8b65d069cce294ddc3450862e8066b1dbf6695da,1,35,24,59,5,2013-05-06 18:48:28,2013-05-06 18:48:28
6e3e3e7fd2a2dbbe736f43c1d201da68a57e9490...65327cfc081030a3c7e4df978c2a346dd71895ab,1,19,0,19,1,2012-11-22 10:24:46,2012-11-22 10:24:46
65327cfc081030a3c7e4df978c2a346dd71895ab...ced242a2d09b65494ae8752b882fa4beed8b58c5,2,2,1,3,2,2012-11-22 10:45:16,2012-11-22 10:45:16
e750efd9fc5b50fc8bed0bc73ba121c03c8b58a4...a4e6ab0a299cc54b4a0f9ff860dc2f541f50af9f,1,10,9,19,4,2012-11-26 12:44:29,2012-11-26 12:44:29
a4e6ab0a299cc54b4a0f9ff860dc2f541f50af9f...29636d4dabd649cd96f0ab975f1bd88b652ef040,1,4,1,5,2,2012-11-26 03:14:05,2012-11-26 03:14:05
29636d4dabd649cd96f0ab975f1bd88b652ef040...899afd0067065be6b15d7b737100b82757421828,3,16,22,38,3,2012-11-26 04:14:05,2012-11-26 04:14:05
899afd0067065be6b15d7b737100b82757421828...23734a715e622f3f028bd565df3be130d3aba737,7,130,33,163,14,2012-11-21 05:24:05,2012-11-21 05:24:05
23734a715e622f3f028bd565df3be130d3aba737...ab42370af01a52c0ba3cfd97d365c735ecb4c468,3,11,6,17,4,2012-11-21 06:14:05,2012-11-21 06:14:05
ab42370af01a52c0ba3cfd97d365c735ecb4c468...ade80e5c4dffca1a95de0189130ecf5f7e4011e9,2,15,1,16,2,2012-11-27 03:14:05,2012-11-27 03:14:05
ade80e5c4dffca1a95de0189130ecf5f7e4011e9...d7c5885c3ddba13e77046913f91797e05d0f732f,2,21,3,24,4,2012-11-27 04:29:11,2012-11-27 04:29:11
f8e27b92bfe12bb3bf6e98bcaa9078941eaf7823...89d9319a791fd49dea734414bdbfe840816fb14c,3,16,1,17,3,2012-11-04 21:47:37,2012-11-04 21:47:37
f8e27b92bfe12bb3bf6e98bcaa9078941eaf7823...f082c8ae2a12188be6bd1c1e3f1b5b6edca8ebb3,7,393,201,594,8,2012-11-04 21:43:33,2012-11-04 21:43:33
f082c8ae2a12188be6bd1c1e3f1b5b6edca8ebb3...dd4d124832c387ddfc694fdcdae694dc5289cb6c,1,0,165,165,1,2012-11-04 21:44:58,2012-11-04 21:44:58
f8e27b92bfe12bb3bf6e98bcaa9078941eaf7823...97bf7ac39799619aa4fb4818678cb01373b72388,2,0,6,6,2,2012-11-04 21:29:44,2012-11-04 21:29:44
820e84662f429f688e519641f5fadfdf8e845611...e78e067204dbb394a4eab4fe706276c489b05f63,1,1,1,2,1,2013-01-21 09:48:25,2013-01-21 09:48:25
5b4032d1759f6ac666fd102a7eed689c8dc110ea...bcaf3c2c3e7707f85cdb81d6c5748db7bf746ef1,1,1,1,2,1,2013-03-06 16:55:11,2013-03-06 16:55:11
5b4032d1759f6ac666fd102a7eed689c8dc110ea...50620b7df8218df835763e6665da2ab58d50fbdb,1,11,12,23,11,2013-03-03 11:38:01,2013-03-03 11:38:01
5b4032d1759f6ac666fd102a7eed689c8dc110ea...56d1cc5be50939089c011325b18dee3a295edf4c,2,66,7,73,8,2013-03-02 22:27:52,2013-03-02 22:27:52
56d1cc5be50939089c011325b18dee3a295edf4c...5421f6b239fcf2742e6190ee6ffdaa6144ab800a,2,26,17,43,15,2013-03-02 22:38:48,2013-03-02 22:38:48
5421f6b239fcf2742e6190ee6ffdaa6144ab800a...6e908f1a36e702a5c829981f0ed48924ad837b16,1,4,4,8,4,2013-03-03 11:29:57,2013-03-03 11:29:57
aa3109b84a75d46570d29be106a681a0d539abe0...51b547f842538234eb97ddfcee5c13a6e85f9287,1,5,5,10,1,2013-02-28 07:25:23,2013-02-28 07:25:23
51b547f842538234eb97ddfcee5c13a6e85f9287...e6b5f4ade9d7dc5aae1bcb41be4fc74cf751fb92,2,22,22,44,12,2013-02-28 07:43:48,2013-02-28 07:43:48
e6b5f4ade9d7dc5aae1bcb41be4fc74cf751fb92...54d95f5897235009f670a8de262333fe528875cf,12,35,37,72,20,2013-02-28 09:06:52,2013-02-28 09:06:52
54d95f5897235009f670a8de262333fe528875cf...fa6bf2c0f5d8a87b0fa0cd32daaa4a55d1d0178c,1,1,2,3,1,2013-02-28 10:08:25,2013-02-28 10:08:25
fa6bf2c0f5d8a87b0fa0cd32daaa4a55d1d0178c...dec15a41420733b9ce75c1939d871f6406142975,1,6,1,7,2,2013-02-28 14:13:24,2013-02-28 14:13:24
dec15a41420733b9ce75c1939d871f6406142975...6393ed6a418a628cfe37688558fe1a58a489a4ab,1,3,0,3,2,2013-02-28 14:21:58,2013-02-28 14:21:58
6682689ab2367b1215b5cf2d521858e094496c39...7ed08786542ebb62ca9d1f7943d148c0290032a7,12,87,0,87,12,2013-02-28 14:39:58,2013-01-11 16:53:30
f4c8df897d21059ab7a84453955a4356e579add8...fd5dc597ed3406596f5cd2757515b692e25d555f,1,1,1,2,1,2013-02-13 13:27:18,2013-02-13 13:27:18
fd5dc597ed3406596f5cd2757515b692e25d555f...6b24c375cbf39ad407b504d1ac386566a1571c76,2,57,53,110,3,2013-02-13 15:28:28,2013-02-13 15:28:28
c8b92a4be2d526a128e17c784bd9af93e5ee91f5...12a1f73b6126a3495c338287ad3ada0267657b4a,1,117,34,151,31,2013-02-14 19:43:48,2013-02-14 19:43:48
12a1f73b6126a3495c338287ad3ada0267657b4a...5417fbfecdfded18e89e55e56022b666d1a0e13f,1,5,0,5,1,2013-02-14 20:00:05,2013-02-14 20:00:05
5417fbfecdfded18e89e55e56022b666d1a0e13f...99739a58c397ac619c62b0c19162c4656e55ce24,1,77,0,77,1,2013-02-15 12:54:26,2013-02-15 12:54:26
99739a58c397ac619c62b0c19162c4656e55ce24...beb00af0c16c5b28b60043a6d42e09517ecd2c08,1,153,1,154,6,2013-02-15 17:50:52,2013-02-15 17:50:52
beb00af0c16c5b28b60043a6d42e09517ecd2c08...da040fc1348eb7747dd18084a2b12967f7c2b759,2,18,0,18,3,2013-02-18 10:15:26,2013-02-18 10:15:26
da040fc1348eb7747dd18084a2b12967f7c2b759...1b97a2eee8b89320de891e3ae8496adfa7f3a84b,3,222,43,265,42,2013-02-20 11:23:56,2013-02-20 11:10:51
ab0cfc00367a60cfe9cc488521bf55882d54769a...8bf8c70c4bdd14502c6f3ae314207b99aa2c9f49,5,40,5,45,8,2013-02-11 21:00:12,2013-02-11 21:00:12
8bf8c70c4bdd14502c6f3ae314207b99aa2c9f49...68aa88c9bdacc16b74b486062eea9cdd056fab16,1,7,1,8,2,2013-02-11 21:13:21,2013-02-11 21:13:21
68aa88c9bdacc16b74b486062eea9cdd056fab16...06d9ccf4843cb016855499c169a7238c1c271ee2,2,34,34,68,18,2013-02-11 21:17:34,2013-02-11 21:17:34
06d9ccf4843cb016855499c169a7238c1c271ee2...d138b3de4bf7c238e09bb56e2de8b46ba756bc5f,1,2,0,2,1,2013-02-11 21:23:38,2013-02-11 21:23:38
ab0cfc00367a60cfe9cc488521bf55882d54769a...a699ebdbcc11051b9473a88788cf8efdde659975,5,19,2,21,5,2013-02-11 19:31:19,2013-02-11 19:31:19
a699ebdbcc11051b9473a88788cf8efdde659975...4821aa6c251a1a2eb4f1fac7bf0f2897a435b48b,2,5,2,7,2,2013-02-15 07:49:35,2013-02-15 07:49:35
4821aa6c251a1a2eb4f1fac7bf0f2897a435b48b...f6cc71bc36283223a10f3004121be34f06547d94,1,8,2,10,1,2013-02-15 07:51:21,2013-02-15 07:51:21
449380265ad3276512d4de7d03e06854d9f1a536...7cc4339f71be5a71e1d8a95c4524c4671e9d8a24,2,34,6,40,9,2013-02-12 16:44:42,2013-02-12 16:44:42
7cc4339f71be5a71e1d8a95c4524c4671e9d8a24...82bd0904ffb34e16ac66fb83a9ce79a5845ce78b,1,5,0,5,1,2013-02-13 09:25:13,2013-02-13 09:25:13
82bd0904ffb34e16ac66fb83a9ce79a5845ce78b...ae40e855efc393d752f290ed8eda67961874acf5,1,6,0,6,1,2013-02-13 09:29:42,2013-02-13 09:29:42
836104b41a557e8411d422c0dca7930e85b0de95...d18f89dadb515823e13aa02db723e320a675a294,1,12,0,12,1,2013-09-30 06:27:45,2013-09-30 06:27:45
d18f89dadb515823e13aa02db723e320a675a294...dd2847f53872ae5070d3b9074ad79a6e56999daa,1,5,1,6,2,2013-09-30 06:50:30,2013-09-30 06:50:30
dd2847f53872ae5070d3b9074ad79a6e56999daa...51f9c05fb75611d858005c8059be2b2b65d1e0d9,1,0,1,1,1,2013-09-30 06:55:48,2013-09-30 06:55:48
401041cfd6cc83e2714f2a4232ff5e129f717d65...303fb06c96abc43357a9e121fdfef1647f84fd49,1,0,4,4,1,2013-02-19 11:22:29,2013-02-19 11:22:29
020078663e401798d199a1a293ac59d990f81dad...01a7250ba502c63681bf0060b2cbf1b2a28afac6,4,22,6,28,7,2013-02-18 12:35:38,2013-02-18 12:35:38
020078663e401798d199a1a293ac59d990f81dad...17346111819d8b920eb1d6bc9dbf41fe06a5404a,2,2,2,4,2,2013-02-18 12:15:35,2013-02-18 12:15:35
020078663e401798d199a1a293ac59d990f81dad...26d4574adacd4f7a06d65f9ecd7a53d6fddbfa7a,2,5,0,5,3,2013-02-18 10:43:49,2013-02-14 15:33:20
26d4574adacd4f7a06d65f9ecd7a53d6fddbfa7a...8db3920c01dfa4cf6c83afd67418bab8cb785bac,5,19,14,33,14,2013-02-18 10:43:49,2013-02-15 08:27:13
8db3920c01dfa4cf6c83afd67418bab8cb785bac...f97296597caf34bb66a3e28a7419665757608795,4,2,74,76,6,2013-02-18 10:43:49,2013-02-18 08:36:50
f97296597caf34bb66a3e28a7419665757608795...b45e9aefd3207c00f9d83a0cbfcca457c9562a59,15,107,132,239,56,2013-02-18 10:43:50,2013-02-18 08:40:56
b45e9aefd3207c00f9d83a0cbfcca457c9562a59...29f70acc987abe0b188ef187c70f179088d79589,4,21,4,25,5,2013-02-18 10:43:50,2013-02-18 09:07:49
29f70acc987abe0b188ef187c70f179088d79589...0b512af803d007852bcba40c75203e0e45dda177,7,39,25,64,19,2013-02-18 10:43:50,2013-02-18 09:10:09
0b512af803d007852bcba40c75203e0e45dda177...1644117a1ac45bd7d250e7bced929a00a3befe5e,13,134,135,269,60,2013-02-18 10:43:50,2013-02-18 09:10:58
1644117a1ac45bd7d250e7bced929a00a3befe5e...0b4f4fe157828430eb7b7a0d88c022d72fa01637,8,69,19,88,18,2013-02-18 10:43:50,2013-02-18 09:14:23
0b4f4fe157828430eb7b7a0d88c022d72fa01637...b607c70e8fc53adfd3472c98f573bf96d903b822,2,33,0,33,2,2013-02-18 10:43:50,2013-02-18 09:38:29
b607c70e8fc53adfd3472c98f573bf96d903b822...69698aacbc237f6b9cbabae8eef2b7438f505466,1,12,0,12,1,2013-02-18 10:43:50,2013-02-18 09:41:32
69698aacbc237f6b9cbabae8eef2b7438f505466...6074896cbfc7f8649e8f7feec1e88de76c2bfbc0,3,7,9,16,7,2013-02-18 10:43:50,2013-02-18 10:43:08
6074896cbfc7f8649e8f7feec1e88de76c2bfbc0...231d9e0426b875eda9ea70baaf5dccbcdd463dab,1,12,4,16,3,2013-02-18 12:49:17,2013-02-18 12:49:17
231d9e0426b875eda9ea70baaf5dccbcdd463dab...ff94f29be5330ebaad3efe9e541360deff2b0d70,7,17,16,33,9,2013-02-18 12:49:56,2013-02-18 12:49:56
ff94f29be5330ebaad3efe9e541360deff2b0d70...557a9fa3216f003e84d66f6d6319e24bea341d0f,1,0,1,1,1,2013-02-18 13:16:29,2013-02-18 13:16:29
557a9fa3216f003e84d66f6d6319e24bea341d0f...d27ed43daa18476b3fec6e705406c76a1b057f60,3,7,7,14,7,2013-02-18 13:22:18,2013-02-18 13:22:18
d27ed43daa18476b3fec6e705406c76a1b057f60...41e97a766b2cf5f75bfca5bb892e49eba720a330,1,11,6,17,7,2013-02-18 13:52:39,2013-02-18 13:52:39
41e97a766b2cf5f75bfca5bb892e49eba720a330...e5f048f44d054c0e825c880f7b58f0288cdc122f,17,125,60,185,26,2013-02-18 14:54:30,2013-02-18 14:54:30
e5f048f44d054c0e825c880f7b58f0288cdc122f...d58eb62d681b4316daa5eaeff37997ff5750dccf,3,11,34,45,6,2013-02-19 07:32:10,2013-02-19 07:32:10
d58eb62d681b4316daa5eaeff37997ff5750dccf...6e333d507565a63037e9f4142a29138efa530971,1,1,1,2,1,2013-02-19 08:57:09,2013-02-19 08:57:09
b6568db1bc1dcd7f8b4d5a946b0b91f9dacd7327...0a0d2ecf851aa7c60b0b0c97a026a0cdadef5711,1,38,39,77,3,2013-01-08 14:34:15,2013-01-08 14:34:15
b6568db1bc1dcd7f8b4d5a946b0b91f9dacd7327...f9528bfb86817efa4af6eaab464936abb3f44ecb,19,149,155,304,26,2013-01-08 05:14:05,2013-01-08 05:14:05
f9528bfb86817efa4af6eaab464936abb3f44ecb...aa97ff7fde07a682db59bbcfbac21cf35d8acc08,3,3,3,6,3,2013-01-09 07:34:26,2013-01-09 07:34:26
d27cc91ee92f4bd16e007984a7d131a218d2d5dc...2b93201533d0d5c7fdcb9b6e74f0eec944ed0ea9,2,77,0,77,2,2013-01-09 19:30:19,2012-12-02 20:18:03
2b93201533d0d5c7fdcb9b6e74f0eec944ed0ea9...b255c3c44b849510e19be88833bb73425b8d0e9d,3,46,5,51,8,2013-01-09 19:30:20,2012-12-02 20:54:19
b255c3c44b849510e19be88833bb73425b8d0e9d...97d17cf835ebe5121330a3775ae58bcab792851e,6,56,11,67,15,2013-01-09 19:30:20,2012-12-03 00:29:07
97d17cf835ebe5121330a3775ae58bcab792851e...f038057b9d75ce6ef8e6a2706152a23f045f91da,1,1,1,2,1,2013-01-09 19:30:20,2012-12-03 05:09:05
f038057b9d75ce6ef8e6a2706152a23f045f91da...0d9f73fa1e3d9f0c97b20b4bc85cd71b3df95df7,3,7,3,10,4,2013-01-09 19:30:20,2013-01-09 05:58:27
0d9f73fa1e3d9f0c97b20b4bc85cd71b3df95df7...3cc0458312a0d230050b09679da80497052769c8,2,11,4,15,4,2013-01-09 19:30:20,2013-01-09 18:14:24
3cc0458312a0d230050b09679da80497052769c8...5133fe8efb0f58f3a8fe0fe8e5474fa7db98cac1,2,29,40,69,2,2013-01-09 19:30:20,2013-01-09 19:28:31
5133fe8efb0f58f3a8fe0fe8e5474fa7db98cac1...d7bc1214748564604eb544c56dabb0b551737ae6,2,3,2,5,2,2013-01-09 21:02:41,2013-01-09 21:02:41
7bfd38eaa95988accfc6bb09759d7688126f5692...c7bb3a1f726be189ccce51bdd631b26eb4f64db1,14,75,94,169,40,2013-01-09 05:14:05,2013-01-09 05:14:05
c7bb3a1f726be189ccce51bdd631b26eb4f64db1...71bd9568669d18bc04c551a603a04af2ea99328c,15,36,46,82,20,2013-01-09 05:44:05,2013-01-09 05:44:05
71bd9568669d18bc04c551a603a04af2ea99328c...9773ccc4519c4c35f969248c4e0f13689b631760,14,48,68,116,46,2013-01-09 06:14:05,2013-01-09 06:14:05
fb470e8e2aff80a16b56f9c5422c04e74dcb213c...e47104bd7a08c57f6dc6e5e8b9b5f2a63c75f9eb,1,2,1,3,2,2013-01-09 19:43:49,2013-01-09 19:43:49
fb470e8e2aff80a16b56f9c5422c04e74dcb213c...3e89244e08ed79564c0c483cb1f810936d661996,1,3,0,3,1,2013-01-07 17:21:35,2013-01-07 17:07:11
273c0d2aa3238aee213efab07f52b78eab1af64f...bca7bddd3d0c6327e7ce0ce86874d72d1c76788f,5,49,27,76,9,2012-12-12 17:42:08,2012-12-12 17:42:08
273c0d2aa3238aee213efab07f52b78eab1af64f...63d9373aa8722b69e7263f39af8e5194048b8b0d,3,2,3,5,3,2012-12-12 16:53:43,2012-12-12 16:53:43
7f636b1306e821111555c9042b4cddc98b3dc666...6cf5d7c96d8fcbf7b1c05481710afc79c2f7aa21,1,2,2,4,2,2012-12-11 20:28:40,2012-12-11 20:28:40
7f636b1306e821111555c9042b4cddc98b3dc666...743073ce5fc4316d2867f30996f0dcfbc0183474,5,0,0,0,0,2012-12-11 19:11:29,2012-12-11 19:11:29
f4a6f1fd5a9fb9f35bb43956275c5f1da96ce019...e954438a1d3a45addebf52ab04155459d7d84db0,4,138,2,140,10,2012-12-18 19:24:31,2012-12-18 19:24:31
f4a6f1fd5a9fb9f35bb43956275c5f1da96ce019...aa8d4d9fea175e209ac3652f3743ce2801144a66,1,1,0,1,1,2012-12-18 16:39:35,2012-12-18 16:39:35
235605fc6d88f0a47f4c5b7e9abc6a99e9286495...84043e8e44337353169a7c1ec8ccca2ce823b995,1,4,2,6,2,2013-03-22 13:08:02,2013-03-22 13:08:02
84043e8e44337353169a7c1ec8ccca2ce823b995...de2c189ec10448787e41e4f2283de7c120fb16df,2,3,8,11,2,2013-03-22 13:11:16,2013-03-22 13:11:16
6880ace1feff9fdd390099026882fe4af3e4b742...8300ae366cc2a2e342002a96e735445e8bf15f14,3,31,1,32,5,2013-03-20 04:36:09,2013-03-20 04:28:10
6880ace1feff9fdd390099026882fe4af3e4b742...397c3da9758c03a215a308c011f94261d9c61cfa,1,2,2,4,2,2013-03-20 00:29:59,2013-03-20 00:29:59
b6641d69326db65da0a746f46bd4c2743bb6725f...29b0ac489b7dea0bab97b25cf34a3b2d44fcd069,5,51,41,92,6,2013-03-24 09:57:44,2013-03-24 09:57:44
e7adcaa55b01ced9139135aeef072c2ee776ed0d...a7ad09543ef415967b3d6ea25781601697f95571,6,396,0,396,6,2013-04-30 07:29:30,2013-04-30 07:29:30
886f7b63b52ca61c241d7b0ac2b6b9a0d360b05c...36b2f2e3c2fe5e34dfa334f27f459dcb3a469cbd,1,44,0,44,1,2013-05-16 09:45:30,2013-05-16 09:45:30
36b2f2e3c2fe5e34dfa334f27f459dcb3a469cbd...31f007f79fda5814902fd8e9be5733ce6611781f,1,11,9,20,1,2013-05-16 09:54:10,2013-05-16 09:54:10
886f7b63b52ca61c241d7b0ac2b6b9a0d360b05c...dfe082fa1d3327c9bf6ee74a91f17044ff288150,1,1,1,2,1,2013-05-16 09:26:15,2013-05-16 03:59:26
edcdbd671b3a1f01f0e1052d5867e4a14c90278b...97a9c2293affaeeba6f448b8760bb5dffd170f2c,4,22,38,60,14,2013-05-13 09:41:04,2013-04-14 12:08:16
97a9c2293affaeeba6f448b8760bb5dffd170f2c...c0e3b39792cb7ad479af66c07685eb37e654ccb6,6,14,12,26,8,2013-05-13 09:44:33,2013-04-14 12:09:47
c0e3b39792cb7ad479af66c07685eb37e654ccb6...3a4c1c5c63f625e6e6075d384a85c67c3992ffb7,2,6,3,9,4,2013-05-13 09:44:50,2013-04-12 08:49:11
3a4c1c5c63f625e6e6075d384a85c67c3992ffb7...6505cd5ec95987b585a08294b53b5b1c2a5e38fc,2,11,0,11,2,2013-05-13 09:46:30,2013-04-14 01:52:43
6505cd5ec95987b585a08294b53b5b1c2a5e38fc...1738055dabb902b45d07839bec053bfc59fd05ee,2,35,0,35,3,2013-05-13 09:46:33,2013-04-14 09:15:35
e8b963fc3254c663d16bf2b05ea30e3569aaf47b...50d4420237a9de7be1304607147aec22e4a14af7,1,5,0,5,1,2013-05-13 18:06:48,2013-05-13 18:06:48
50d4420237a9de7be1304607147aec22e4a14af7...c5feabde2d8cd023215af4d2ceeb7a64839fc428,2,14,3,17,2,2013-05-13 18:18:08,2013-05-13 18:18:08
c5feabde2d8cd023215af4d2ceeb7a64839fc428...72ee345d3a0213c6df78f5f56cd1dd26ff7c53e1,2,21,31,52,14,2013-05-13 19:54:23,2013-05-13 19:54:23
72ee345d3a0213c6df78f5f56cd1dd26ff7c53e1...bbd125915ff90909440675a220a78fd41dfab847,1,1,0,1,1,2013-05-13 20:10:09,2013-05-13 20:10:09
9c1abeb50ab88d6f591fb77db89eba9fe2435e2d...4f5aae1d26ac66f8baf0574a2e457597a3e7cc33,1,1,1,2,1,2013-05-02 05:47:42,2013-05-02 05:46:27
8b65d069cce294ddc3450862e8066b1dbf6695da...77d0e41df00c45aaafdec5fd6cdddce003c29445,2,5,5,10,5,2013-05-06 19:09:23,2013-05-06 19:09:23
ced242a2d09b65494ae8752b882fa4beed8b58c5...5f7dc99a62e16bc1fc7ebcebd645cd815776dc6c,1,0,1,1,1,2012-11-23 15:39:36,2012-11-23 15:39:36
ced242a2d09b65494ae8752b882fa4beed8b58c5...e29ccece332e57c9fb6c532a3680e3b457e3a301,6,60,31,91,10,2012-11-22 18:34:26,2012-11-22 18:34:16
e29ccece332e57c9fb6c532a3680e3b457e3a301...71214bee755028946ff12748b8d7acbfef62d18d,9,55,10,65,14,2012-11-22 19:41:26,2012-11-22 19:41:16
71214bee755028946ff12748b8d7acbfef62d18d...a4d1bc1791a942d0bcc1a61bc46ad69afda0038d,1,1,1,2,1,2012-11-22 19:51:26,2012-11-22 19:51:16
a4d1bc1791a942d0bcc1a61bc46ad69afda0038d...26622f4c8f96910b0f14e73bdebfb8198c693912,4,21,8,29,9,2012-11-22 20:34:06,2012-11-22 20:34:06
26622f4c8f96910b0f14e73bdebfb8198c693912...5ca1772385d6f67a16a12f134c707b471b23cbe8,2,18,0,18,2,2012-11-23 03:34:09,2012-11-23 03:34:09
5ca1772385d6f67a16a12f134c707b471b23cbe8...96105e214f0517d38a4dd1b2140993e03caa1e66,2,7,1,8,2,2012-11-23 03:39:09,2012-11-23 03:39:09
96105e214f0517d38a4dd1b2140993e03caa1e66...2b683b0d0bf90c84b33ec4ed5c70e3bc787094e2,10,62,6,68,16,2012-11-23 04:11:09,2012-11-23 04:11:09
2b683b0d0bf90c84b33ec4ed5c70e3bc787094e2...552b3105fba11493d25575ee9220631a816141f6,9,42,101,143,33,2012-11-23 04:31:09,2012-11-23 04:31:09
552b3105fba11493d25575ee9220631a816141f6...f17ddeb394ced4322f9b29eada92d5086bdef03b,6,30,8,38,11,2012-11-23 04:24:09,2012-11-23 04:24:09
f17ddeb394ced4322f9b29eada92d5086bdef03b...ab9d02365181df373beffbe7732b36b9b3f7a307,6,38,25,63,15,2012-11-23 06:11:09,2012-11-23 06:11:09
ab9d02365181df373beffbe7732b36b9b3f7a307...c50ec72b52e9ed7270f7c81c2c71fd8e5a28eeb0,22,79,83,162,45,2012-11-23 18:11:09,2012-11-23 18:11:09
c50ec72b52e9ed7270f7c81c2c71fd8e5a28eeb0...470aa7675e07724ff48f159ee12da40409949222,8,9,16,25,11,2012-11-23 18:31:09,2012-11-23 18:31:09
470aa7675e07724ff48f159ee12da40409949222...9304d049de0493de457fdec02114d5a23d116f9b,13,64,68,132,57,2012-11-23 19:31:09,2012-11-23 19:31:09
9304d049de0493de457fdec02114d5a23d116f9b...e92b563acf93a1d123ae9f3b599f7d4b1ba56f8e,4,13,13,26,8,2012-11-23 18:53:24,2012-11-23 18:53:24
e92b563acf93a1d123ae9f3b599f7d4b1ba56f8e...0e1635a68a2a3f9c74ca52f2b5c19d63428faf2c,14,35,62,97,22,2012-11-23 20:25:28,2012-11-23 20:25:28
0e1635a68a2a3f9c74ca52f2b5c19d63428faf2c...0693215c30d597802b134f7c663aa5deba6faa00,5,23,17,40,7,2012-11-23 20:55:38,2012-11-23 20:55:38
0693215c30d597802b134f7c663aa5deba6faa00...d71a68af41e875f7391a385a252052b4f7f5583e,1,3,3,6,1,2012-11-23 21:10:59,2012-11-23 21:10:59
d71a68af41e875f7391a385a252052b4f7f5583e...4023d9f85290faea47a2b2bcf3ce879ed0f07e9f,5,56,24,80,6,2012-11-24 09:46:19,2012-11-24 09:46:19
4023d9f85290faea47a2b2bcf3ce879ed0f07e9f...d405c8fc605256c1273cca1e30dfa1196459d625,4,21,8,29,7,2012-11-24 10:25:04,2012-11-24 10:25:04
d405c8fc605256c1273cca1e30dfa1196459d625...f997947664a7c959b5e606614f56dc52443bd0dd,3,16,13,29,4,2012-11-24 10:37:30,2012-11-24 10:37:30
f997947664a7c959b5e606614f56dc52443bd0dd...f37fa968b2509d8e2ab0fc72aba1fb53df7451c7,9,65,27,92,19,2012-11-24 20:00:30,2012-11-24 20:00:30
f37fa968b2509d8e2ab0fc72aba1fb53df7451c7...3f1d6d6ab3a7e1b2bbbae7dcd17edc884f9fbf07,1,8,1,9,2,2012-11-24 20:11:46,2012-11-24 20:11:46
3f1d6d6ab3a7e1b2bbbae7dcd17edc884f9fbf07...65c470e84396a9db4b697a45128ce8d28c612d7c,9,40,8,48,15,2012-11-24 20:16:51,2012-11-24 20:16:51
65c470e84396a9db4b697a45128ce8d28c612d7c...2f22874ba6b26c1653bd72d9bcac0bee9e24de8a,2,6,2,8,2,2012-11-24 20:39:51,2012-11-24 20:39:51
2f22874ba6b26c1653bd72d9bcac0bee9e24de8a...c31d48dd250c56164280343a2cbe6ae14bd72a4a,7,62,13,75,10,2012-11-25 09:57:01,2012-11-25 09:57:01
c31d48dd250c56164280343a2cbe6ae14bd72a4a...97a92f8ae78a186aa76fcc860b570cf07c90c048,2,1,3,4,3,2012-11-25 10:26:34,2012-11-25 10:26:34
97a92f8ae78a186aa76fcc860b570cf07c90c048...1d7fdf45ff9cece4ceef46f19616e294fc0e24ee,1,0,8,8,1,2012-11-25 14:53:49,2012-11-25 14:53:49
285743eee14b5bff83e24196536b3a9784a5fd45...cc52eed9816edb513482ec0db428e46c0bdce4c5,1,1,1,2,1,2012-11-27 04:29:11,2012-11-27 04:29:11
cc52eed9816edb513482ec0db428e46c0bdce4c5...70bf7f6e191c0e99ad03e1eec2ecbe2aae53fa09,11,45,31,76,20,2012-11-21 05:54:05,2012-11-21 05:54:05
70bf7f6e191c0e99ad03e1eec2ecbe2aae53fa09...f5551efdfd71c6aedb609093374a6c4dbed6a78b,20,147,100,247,36,2012-11-27 06:31:15,2012-11-27 06:31:15
f5551efdfd71c6aedb609093374a6c4dbed6a78b...039996bd0a9e547cd5dbcb7f12fa43152f0589c1,2,3,3,6,3,2012-11-27 14:35:00,2012-11-27 14:35:00
039996bd0a9e547cd5dbcb7f12fa43152f0589c1...81f8114f24313bb90f09f5ed1ff656759cb55020,2,26,22,48,2,2012-11-27 15:48:25,2012-11-27 15:48:25
81f8114f24313bb90f09f5ed1ff656759cb55020...cfeddb554e08264dba5ab8b36aa8780929db7ff6,1,0,2,2,1,2012-11-27 18:27:13,2012-11-27 18:27:13
cfeddb554e08264dba5ab8b36aa8780929db7ff6...43401123989633b6a6dac4a29100775deb833c2a,1,9,1,10,2,2012-11-27 19:30:39,2012-11-27 19:30:39
43401123989633b6a6dac4a29100775deb833c2a...c4f3c54ecb3279ce91d987b64055f2eacb1b7fd5,1,1,2,3,1,2012-11-27 19:33:56,2012-11-27 19:33:56
ba567c8d76dabeb1cd80f0dce3683977a966a9a1...f555578414347855be452cc8ee095c1304768c2b,10,137,1,138,8,2012-11-05 18:12:26,2012-11-05 18:12:26
f555578414347855be452cc8ee095c1304768c2b...949233aa1f205d81283e21c6804975ee2481bd54,3,3,8,11,4,2012-11-06 11:47:43,2012-11-06 11:47:43
96ba1708ac9d724d1d941749b3a4d457b8fa93a4...d1e63c7df285740db9672ba023383c83b83fd03b,6,14,26,40,10,2013-01-21 12:16:48,2013-01-21 12:16:48
d1e63c7df285740db9672ba023383c83b83fd03b...ee43e9248ce54761e8c8df17459d5aa5911ead89,4,10,1,11,4,2013-01-21 13:05:18,2013-01-21 13:05:18
ee43e9248ce54761e8c8df17459d5aa5911ead89...68fa988219d1ae3933bae5288f59e7f9f86f9a97,2,3,3,6,3,2013-01-21 14:36:55,2013-01-21 14:36:55
68fa988219d1ae3933bae5288f59e7f9f86f9a97...d770714578cffe5423c6a1752367f7f545fa1f22,1,18,14,32,10,2013-01-22 08:35:58,2013-01-22 08:35:58
69159634d616ab1b40f053eda7847a40c98d0943...bb7490771e0e19ed28cef7d20ed6f70650d3a78b,1,10,10,20,8,2013-03-03 15:51:24,2013-03-03 15:51:24
bb7490771e0e19ed28cef7d20ed6f70650d3a78b...06807885cf6095517f8d128f0d870f1f81837784,1,6,6,12,5,2013-03-03 16:21:36,2013-03-03 16:21:36
06807885cf6095517f8d128f0d870f1f81837784...891dc550e0c5cef88b250a98d9546a25da0912ba,1,5,5,10,4,2013-03-03 16:22:56,2013-03-03 16:22:56
4635ad83e64865b30a34f5925c7c43e26b185112...512ab1b61a10dd0d4fc9307d222db6b7fd7488f5,2,6,12,18,5,2013-03-03 20:01:20,2013-03-03 20:01:20
512ab1b61a10dd0d4fc9307d222db6b7fd7488f5...282b804556b5727873527551da6cad3534144251,2,8,11,19,6,2013-03-03 20:08:04,2013-03-03 20:08:04
282b804556b5727873527551da6cad3534144251...d199de044425ad73caa031627c714b7010d76e3f,2,8,11,19,6,2013-03-04 06:54:00,2013-03-04 06:54:00
d199de044425ad73caa031627c714b7010d76e3f...152c6018b3ace729095e7b58f5be3963b81050fb,2,4,11,15,5,2013-03-04 06:56:54,2013-03-04 06:56:54
6b24c375cbf39ad407b504d1ac386566a1571c76...1a01fc0c964defe60c9dc99fa2b5fa0387f3246a,1,20,0,20,2,2013-02-14 10:13:25,2013-02-13 16:45:05
1a01fc0c964defe60c9dc99fa2b5fa0387f3246a...7e45ba700415a180998cee5eb36158727be5f051,1,1,1,2,1,2013-02-14 10:14:52,2013-02-14 10:14:52
7e45ba700415a180998cee5eb36158727be5f051...3025824415184c16f86bb67276474113de48d813,2,2,2,4,2,2013-02-14 11:58:33,2013-02-14 11:58:33
6b24c375cbf39ad407b504d1ac386566a1571c76...ed3f44085e01f50864ce840f007a50d2154df6f5,6,99,135,234,17,2013-02-13 17:14:35,2013-02-13 17:14:35
eefb27f5ae0edf0c005eb8ce6da56cbd17c9aa8a...512d826cc3e89bb577f485d4767d91185f3f0556,1,1,1,2,1,2013-02-20 13:15:04,2013-02-20 13:15:04
d138b3de4bf7c238e09bb56e2de8b46ba756bc5f...644f8819af5d06deedb4420e8ad45637b96c9676,1,2,2,4,1,2013-02-12 08:41:21,2013-02-12 08:41:21
d138b3de4bf7c238e09bb56e2de8b46ba756bc5f...918e2213e71cb1a6c0cc7fd4249c51db90a2614c,1,1,0,1,1,2013-02-12 08:28:37,2013-02-12 07:56:53
918e2213e71cb1a6c0cc7fd4249c51db90a2614c...2d0c3e4c6dff291aa85e8bda18b8ac85e92c1994,1,1,1,2,2,2013-02-12 08:28:48,2013-02-12 08:26:42
d138b3de4bf7c238e09bb56e2de8b46ba756bc5f...9a22ac63eca587d5efd56d626b7579236734cda0,1,1,1,2,1,2013-02-12 06:54:56,2013-02-12 06:54:56
9a22ac63eca587d5efd56d626b7579236734cda0...b5db541338314b01423d79fb9155e8c4ddc5d494,9,22,22,44,10,2013-02-12 07:16:45,2013-02-12 07:16:45
51f9c05fb75611d858005c8059be2b2b65d1e0d9...278250821cc83a6357087dc585c27e2884d53b15,2,0,4,4,2,2013-09-30 10:59:16,2013-09-30 10:59:16
51f9c05fb75611d858005c8059be2b2b65d1e0d9...4692612b8490071e62db3462be475d196411c6e1,1,1,1,2,1,2013-09-30 09:01:57,2013-09-30 09:01:57
073c8a296668ab1e06b01ebf0a9e94786227eef4...810d90dd26d98a80ffb3a4100b1c4f70b824bb70,2,14,1,15,3,2013-10-08 10:24:50,2013-10-08 10:24:50
810d90dd26d98a80ffb3a4100b1c4f70b824bb70...817399e3be6bda06ed7b4c61eb8192a532ed735e,2,6,5,11,3,2013-10-08 11:07:59,2013-10-08 11:02:30
817399e3be6bda06ed7b4c61eb8192a532ed735e...06d6f443677b068eb942eb94dad1dc1ca22c0eed,2,13,3,16,4,2013-10-08 12:21:01,2013-10-08 12:21:01
06d6f443677b068eb942eb94dad1dc1ca22c0eed...3682a0820be8c5e3b6f368cb121fca3f23fc6f87,1,2,2,4,2,2013-10-08 13:44:52,2013-10-08 13:38:24
073c8a296668ab1e06b01ebf0a9e94786227eef4...f141711cfd47808d5f954e1ccf057a858b36d63a,2,29,2,31,5,2013-10-07 10:10:01,2013-10-07 10:10:01
f141711cfd47808d5f954e1ccf057a858b36d63a...1a18e778f5e95223831f56de916d4fe0ce9d9dba,1,38,0,38,1,2013-10-07 10:18:37,2013-10-07 10:18:37
1a18e778f5e95223831f56de916d4fe0ce9d9dba...93341579b6fd11c57b464a974079bbd9fcc28ef5,1,1,0,1,1,2013-10-07 10:27:32,2013-10-07 10:27:32
6bc9249b38c060c7f67e40b7d8a9ce5f2f351457...08f665cf2876c70a2a987a498b01d00de7478e4a,1,0,1,1,1,2013-02-20 07:41:32,2013-02-20 07:41:32
6bc9249b38c060c7f67e40b7d8a9ce5f2f351457...bed500090e3cfe7a9e42e540cc2b8407b4ffcfc5,2,76,0,76,2,2013-02-20 03:43:18,2013-02-20 03:43:18
bed500090e3cfe7a9e42e540cc2b8407b4ffcfc5...c6f5b96ba8102738dcb9bf21f00f0fcb8b4fe1d1,1,6,4,10,1,2013-02-20 03:44:03,2013-02-20 03:44:03
c6f5b96ba8102738dcb9bf21f00f0fcb8b4fe1d1...4243105eb5cba030eb6dcdc9cb4d18c977a4fe6b,1,1,1,2,1,2013-02-20 21:41:41,2013-02-20 21:41:41
6bc9249b38c060c7f67e40b7d8a9ce5f2f351457...49a46d6ca906bf17b959e8eb7d6e25284ab3635d,1,1,1,2,1,2013-02-20 01:01:39,2013-02-20 01:01:39
6bc9249b38c060c7f67e40b7d8a9ce5f2f351457...3a45e6010f6dde8f5047fc82283f0ef3c0f44712,2,2,2,4,2,2013-02-19 21:14:28,2013-02-19 21:14:28
6bc9249b38c060c7f67e40b7d8a9ce5f2f351457...eb58529757ec626bc07b0d1752e62499f8dc9a03,1,1,1,2,1,2013-02-19 15:56:43,2013-02-19 15:13:54
1481d1cfe08d875424aa59e2f3db7843cc56ab97...97de6f851b54e87f5a01f9bbc16ce64464c88579,3,28,21,49,5,2013-02-18 14:40:11,2013-02-18 14:40:11
80e79f33aff57ba56838992591a13e086fad76b2...31e3dc600a73f41c02ecc4f9ffa7007957204168,2,7,7,14,4,2013-01-09 07:47:25,2013-01-09 07:47:25
66ecfa77e5105c8a8151db899e3d3a09dba3024e...16b61590ab4ca046ea7a2dbab3703367df56d108,5,37,0,37,7,2013-01-09 17:38:27,2013-01-09 17:38:27
16b61590ab4ca046ea7a2dbab3703367df56d108...6869a5640347bb391aea657c763716f27dea380e,2,3,1,4,2,2013-01-09 18:31:05,2013-01-09 18:31:05
6ea7bc27e4d143acbabf9fef2a95a7cc0ba997b7...4eac403e3b3a32188c48d006e431ee838cd5c3dc,1,2,10,12,2,2013-01-09 23:09:09,2013-01-09 22:56:47
4eac403e3b3a32188c48d006e431ee838cd5c3dc...7cd03836e55f842fd518b4637c19235ee8701f17,1,7,9,16,7,2013-01-09 23:09:09,2013-01-09 23:08:15
4398bdf2c953bf159cef1b8e34c5ec44f582b814...b510f8c4965b210cc1a583fc15dc09871669e1bf,2,8,8,16,6,2012-12-21 11:37:44,2012-12-21 11:37:44
b48852e78901e3ce3fdc6449c4dc67d01b30f0ca...fa203e8b67b3e8fd25ab1edd0ccbedc6072563b2,1,21,7,28,9,2012-12-12 23:46:38,2012-12-12 23:45:48
b48852e78901e3ce3fdc6449c4dc67d01b30f0ca...d3b8952f8fb067afe89f08eadbae7733c0cc6824,8,28,2,30,28,2012-12-12 17:51:20,2012-12-10 22:46:31
d3b8952f8fb067afe89f08eadbae7733c0cc6824...a5861b8ff34621be246ea0951a9e46b8859af4d4,1,52,46,98,3,2012-12-13 00:44:25,2012-12-10 23:04:47
743073ce5fc4316d2867f30996f0dcfbc0183474...5fd830f01c483dcccd8312caf289d5d03e7f389c,1,20,9,29,8,2012-12-13 01:10:10,2012-12-12 11:23:49
743073ce5fc4316d2867f30996f0dcfbc0183474...d7eb3145539222df4653fbe300d179a81b303517,2,10,2,12,3,2012-12-12 10:02:29,2012-12-12 10:02:29
d7eb3145539222df4653fbe300d179a81b303517...105f5ba3c992cf9c69951a4f9ca877afe803a23d,3,13,14,27,5,2012-12-12 10:30:19,2012-12-12 10:30:19
105f5ba3c992cf9c69951a4f9ca877afe803a23d...439d03bbedd2dfcd5ddcb5dc16afe610208188b0,2,15,6,21,5,2012-12-12 10:54:28,2012-12-12 10:54:28
fd1b9fdc12f0fac112810851903203bc256b6548...dfe2a742c2f2b862109a757cf90495ea1fcde70c,2,7,7,14,3,2013-01-31 11:13:17,2013-01-31 11:13:17
aa8d4d9fea175e209ac3652f3743ce2801144a66...77d632890bce9835929daeec829b529799915815,4,22,28,50,7,2012-12-20 18:52:12,2012-12-18 18:52:18
aa8d4d9fea175e209ac3652f3743ce2801144a66...9ada67881970b05d4be49cbe329b4bf50ffe4f77,11,54,28,82,26,2012-12-18 18:02:00,2012-12-18 18:02:00
9ada67881970b05d4be49cbe329b4bf50ffe4f77...552c6d4598f6396456c569cfece98ae469bfa84c,5,15,12,27,8,2012-12-18 18:43:44,2012-12-18 18:43:44
552c6d4598f6396456c569cfece98ae469bfa84c...96af55bb852660486d25c72c937426f2d2ae971a,1,7,1,8,1,2012-12-18 19:06:29,2012-12-18 19:06:29
96af55bb852660486d25c72c937426f2d2ae971a...69c8231b49a8179697070d528d36811dc2f335e6,3,20,13,33,7,2012-12-19 10:08:27,2012-12-19 10:08:27
de2c189ec10448787e41e4f2283de7c120fb16df...409b0a0ab557dcc146e3123e976a4634f3d05877,1,2,1,3,1,2013-06-09 19:30:20,2013-06-09 19:30:20
de2c189ec10448787e41e4f2283de7c120fb16df...5cc5b74e8e42e23f6ffa45609de540e5b6209b60,3,4,4,8,3,2013-03-22 17:34:59,2013-03-22 17:34:59
de2c189ec10448787e41e4f2283de7c120fb16df...c0da61c6d88dd6ea08bd6ace3149652178d2e26d,1,4,4,8,2,2013-03-22 16:52:25,2013-03-22 16:52:25
de2c189ec10448787e41e4f2283de7c120fb16df...ccc880675818406e4ac33cfa69d95993696d6f96,1,4,4,8,4,2013-03-22 16:39:22,2013-03-22 16:39:22
ccc880675818406e4ac33cfa69d95993696d6f96...3869cfecc164fb15a9092f55ad20e5d60ec400b6,1,1,1,2,1,2013-03-22 16:42:31,2013-03-22 16:42:31
3869cfecc164fb15a9092f55ad20e5d60ec400b6...78dd9a148196dcd51666f678c2601281b9568ea0,1,1,1,2,1,2013-03-22 16:54:42,2013-03-22 16:54:42
de2c189ec10448787e41e4f2283de7c120fb16df...693dcce6bc2cb7db515972c250fd5f598143eb1d,1,1,1,2,1,2013-03-22 15:31:19,2013-03-22 15:31:19
693dcce6bc2cb7db515972c250fd5f598143eb1d...ba1dbd39fb20a004eb54a8653d548628e1186587,1,1,1,2,1,2013-03-22 15:38:27,2013-03-22 15:38:27
0b55ec11d50e75a145d5b7efbcb5d25e0a4a210e...3dc4fc23c6b687af4dbd194070908801ec110d82,3,27,0,27,3,2013-05-07 08:46:22,2013-05-06 15:08:09
0b55ec11d50e75a145d5b7efbcb5d25e0a4a210e...1d16e4953a8f6c8fc1396169fc97bc5da1e3bd94,1,1,1,2,1,2013-05-06 13:17:37,2013-05-06 13:17:37
0b55ec11d50e75a145d5b7efbcb5d25e0a4a210e...4dd855072a0b75f1c786f26df2899572df9144d7,1,1,1,2,1,2013-04-30 07:51:48,2013-04-30 07:51:48
4dd855072a0b75f1c786f26df2899572df9144d7...83eac338230eb7e1cb59fa2da685268a0803992c,1,2,0,2,1,2013-04-30 07:52:25,2013-04-30 07:52:25
31f007f79fda5814902fd8e9be5733ce6611781f...3e115faafa13a0bcad5458a9632dec909eb376da,2,8,4,12,3,2013-05-16 11:12:21,2013-05-16 11:12:21
31f007f79fda5814902fd8e9be5733ce6611781f...d79592a7f613f47e2dce67184ca3e2106658e2e5,1,77,0,77,1,2013-05-16 10:32:26,2013-05-15 13:59:15
d79592a7f613f47e2dce67184ca3e2106658e2e5...d08e1db93091418694130870406995f21502d478,1,11,8,19,3,2013-05-16 10:32:26,2013-05-15 14:10:39
d08e1db93091418694130870406995f21502d478...6e8cb844499dfcc77bd92f3daf0f7890400ec072,2,70,37,107,17,2013-05-16 10:32:27,2013-05-16 10:32:16
76ffd116849aa3c092723727e156385eded4982f...bd6dfe7d443efc51c3b8502b632ce2e2816424d8,2,4,1,5,2,2013-05-24 06:49:49,2013-05-24 06:49:49
bd6dfe7d443efc51c3b8502b632ce2e2816424d8...7cb86eb33550b9e765bea0bfb52705e2b5584802,3,48,34,82,6,2013-05-24 14:12:27,2013-05-24 14:12:27
7cb86eb33550b9e765bea0bfb52705e2b5584802...a3645b5b4d86b385f870b73784acb79f824918ff,7,69,60,129,10,2013-05-24 16:43:47,2013-05-24 16:43:47
a3645b5b4d86b385f870b73784acb79f824918ff...63c6f30aba95398f732876f94f1fba1f8ed19622,2,54,26,80,5,2013-05-24 17:36:28,2013-05-24 17:36:28
bbd125915ff90909440675a220a78fd41dfab847...06805fff143b9838dd2bab902701867e549783bd,1,2,1,3,2,2013-05-14 10:55:08,2013-05-14 10:55:08
bbd125915ff90909440675a220a78fd41dfab847...c449dab161885f89331fee44bfb485df06fea1d2,1,1,1,2,1,2013-05-14 10:34:05,2013-05-14 10:34:05
bbd125915ff90909440675a220a78fd41dfab847...f59b7409cb653a6e31b5fdc1f45fab211bc3d646,10,222,220,442,19,2013-05-14 09:46:41,2013-05-14 09:46:41
f59b7409cb653a6e31b5fdc1f45fab211bc3d646...5075520fd82d1af83afa77d5eca0ff2fc942d43b,1,1,0,1,1,2013-05-14 09:56:03,2013-05-14 09:56:03
5075520fd82d1af83afa77d5eca0ff2fc942d43b...58796f38c9fa0bfce2021a0e3a740bec54d718ac,2,4,3,7,3,2013-05-14 10:07:39,2013-05-14 10:07:39
58796f38c9fa0bfce2021a0e3a740bec54d718ac...42cf48f59d648d732636f4d7e74d460437dc71b7,1,1,1,2,1,2013-05-14 10:12:05,2013-05-14 10:12:05
42cf48f59d648d732636f4d7e74d460437dc71b7...72d5a566b46db918b17a1040b6e6d0a3dd986386,2,13,0,13,2,2013-05-14 10:31:29,2013-05-14 10:31:29
72d5a566b46db918b17a1040b6e6d0a3dd986386...d32c19b2d969091ee3020620c46e39a558d406e1,5,70,56,126,6,2013-05-14 11:34:34,2013-05-14 11:34:34
4f5aae1d26ac66f8baf0574a2e457597a3e7cc33...ca225d92c38d955f3c39fd80e031396fee7723a3,15,27,28,55,15,2013-05-02 08:18:29,2013-05-02 08:18:29
ca225d92c38d955f3c39fd80e031396fee7723a3...6473aaf8777f15c0bf247f509fab5e3f978af1c7,1,1,3,4,1,2013-05-02 08:23:58,2013-05-02 08:23:58
6473aaf8777f15c0bf247f509fab5e3f978af1c7...2aa620c25ad2c6386bd454b9678d852ee55e83f8,9,46,63,109,12,2013-05-02 08:46:45,2013-05-02 08:46:45
2aa620c25ad2c6386bd454b9678d852ee55e83f8...37f3d0f25b7188312e5d781514245a2853054e4b,2,16,14,30,5,2013-05-02 10:23:50,2013-05-02 10:23:50
37f3d0f25b7188312e5d781514245a2853054e4b...0b981eb9b3fbef8f34b9be37a2484c96189ea417,12,158,145,303,25,2013-05-02 11:36:53,2013-05-02 11:36:53
0b981eb9b3fbef8f34b9be37a2484c96189ea417...92f04733540694ccfddce353cb510e5f1c36f798,4,21,11,32,7,2013-05-02 11:51:47,2013-05-02 11:51:47
92f04733540694ccfddce353cb510e5f1c36f798...c8649c5d6099b396fe6cc01b322de95224830916,1,3,0,3,1,2013-05-02 12:28:07,2013-05-02 12:28:07
4f5aae1d26ac66f8baf0574a2e457597a3e7cc33...4c44c5ef9a569c65bca8e70078205ef2ce7d6396,8,273,4,277,9,2013-05-02 07:06:59,2013-05-02 06:52:05
4c44c5ef9a569c65bca8e70078205ef2ce7d6396...a7ba81ea5d3f2c9b0085db68e880e89cec960f6f,1,4,4,8,4,2013-05-02 07:57:10,2013-05-02 07:53:54
a7ba81ea5d3f2c9b0085db68e880e89cec960f6f...8589f0f4000095583a3a536f4986dd85a379669d,1,4,1,5,1,2013-05-02 20:32:09,2013-05-02 20:25:31
a87f5c60a4552b8be5f7d5f9de3b4cda20ec648a...72f878e638ea67c4075a50345b264904b2c882d1,1,2,1,3,2,2013-05-10 05:53:13,2013-05-08 07:40:25
a87f5c60a4552b8be5f7d5f9de3b4cda20ec648a...1e78ceea496a8e031d82e9531d2122287602dcb3,3,55,5,60,3,2013-05-08 07:00:19,2013-05-08 07:00:19
1e78ceea496a8e031d82e9531d2122287602dcb3...188a74c3a2e16329eae9abc0006830dbfdea0472,2,15,4,19,5,2013-05-08 07:06:48,2013-05-08 07:06:48
188a74c3a2e16329eae9abc0006830dbfdea0472...646fbe92867037a7dd230be880783c3d8ede5dc1,6,670,60,730,14,2013-05-08 10:43:21,2013-05-08 10:43:21
78ff99a7a3eb9d2721e76fc3a66a1e4006ebdd00...ac88d51225c9e681933502d00e4fd128e86fcc0c,3,7,0,7,3,2013-05-08 01:28:47,2013-05-07 02:12:02
78ff99a7a3eb9d2721e76fc3a66a1e4006ebdd00...3a8ee2291a7f8c3a504e532beedc2548dc4212e8,1,22,4,26,3,2013-05-07 08:12:44,2013-05-07 08:12:44
78ff99a7a3eb9d2721e76fc3a66a1e4006ebdd00...bfe4af846d04f3b6f5554860e7a8843a3a84672c,1,4,3,7,1,2013-05-07 03:17:57,2013-05-07 03:17:57
5f7dc99a62e16bc1fc7ebcebd645cd815776dc6c...70ef433e09ebfc9d48e990e22f2fb223193dd087,1,2,2,4,2,2012-11-24 17:21:57,2012-11-24 17:04:42
be942d74aff137f55b1e75e0c66b91cad1fd2001...fbe03c506ff5e5714f4feacc33e42c5d4931dbbc,1,27,0,27,1,2012-11-25 15:58:06,2012-11-25 15:58:06
fbe03c506ff5e5714f4feacc33e42c5d4931dbbc...04b51a2b892c9c675f638239a3fbfec39cdc4729,2,34,4,38,10,2012-11-25 16:24:27,2012-11-25 16:24:27
04b51a2b892c9c675f638239a3fbfec39cdc4729...ae282f6326ea27ebcbe02e41c20147ba654c589d,1,0,1,1,1,2012-11-25 16:29:18,2012-11-25 16:29:18
ae282f6326ea27ebcbe02e41c20147ba654c589d...1d857aae17a2f7a3bc759707f0fb642943d9569e,3,14,7,21,5,2012-11-25 16:52:12,2012-11-25 16:52:12
c4f3c54ecb3279ce91d987b64055f2eacb1b7fd5...184a9ecaf6cf25e429fe5653380e356b25a15a90,3,8,6,14,3,2012-11-27 21:51:05,2012-11-27 21:49:22
184a9ecaf6cf25e429fe5653380e356b25a15a90...d2767221a5b566a7c476dba55d958d6062ea0733,1,6,4,10,1,2012-11-27 21:51:07,2012-11-27 21:49:52
d2767221a5b566a7c476dba55d958d6062ea0733...dc99b19af7d56644784bcf5edc4bd09112dd45a5,3,12,8,20,6,2012-11-27 21:51:10,2012-11-27 21:50:24
c4f3c54ecb3279ce91d987b64055f2eacb1b7fd5...0fbd9ac7487febe699abd697220ef787b1d08291,5,5,50,55,11,2012-11-27 20:36:09,2012-11-27 20:36:09
8b489ba7759009ea5731db82a57ee3a36386287e...378ae951c628574625efafd2f92074e1fca9489d,1,1,1,2,1,2012-11-06 15:51:40,2012-11-06 15:51:40
378ae951c628574625efafd2f92074e1fca9489d...96b2959fe394835c53c248938a76011234f1d49d,2,58,25,83,13,2012-11-06 17:31:01,2012-11-06 17:31:01
96b2959fe394835c53c248938a76011234f1d49d...be4138af75b2a80ceb7d444c573fc35c644d9c63,1,9,0,9,4,2012-11-06 20:16:47,2012-11-06 20:15:25
d770714578cffe5423c6a1752367f7f545fa1f22...0ab906d5dec343562e0869d9a3fd9a47afe7a9e2,1,1,1,2,1,2013-01-22 09:04:02,2013-01-22 09:04:02
152c6018b3ace729095e7b58f5be3963b81050fb...c2082f4d780a44ca0b29c60939dd1ea919d706c1,1,1,2,3,2,2013-03-04 17:47:20,2013-03-04 17:47:20
c2082f4d780a44ca0b29c60939dd1ea919d706c1...24cc0faf2cecc5148082e6f36363c57a0bdf1a09,2,5,0,5,2,2013-03-04 18:11:23,2013-03-04 18:11:23
24cc0faf2cecc5148082e6f36363c57a0bdf1a09...533693ab41cdabb15078aa038082c2c8ccf7d5b3,1,1,2,3,3,2013-03-04 19:11:03,2013-03-04 19:11:03
533693ab41cdabb15078aa038082c2c8ccf7d5b3...dc7507cfe7a677f4436f30a2414b09ff7a1998e8,1,3,3,6,3,2013-03-04 19:12:36,2013-03-04 19:12:36
dc7507cfe7a677f4436f30a2414b09ff7a1998e8...d54845a16a8c6c646ecf1d29ca385644f7b2660d,3,14,8,22,4,2013-03-04 19:34:26,2013-03-04 19:34:26
d54845a16a8c6c646ecf1d29ca385644f7b2660d...730e79e78785857fd706b73252547a5c7f6431d9,3,13,10,23,7,2013-03-04 20:00:51,2013-03-04 20:00:51
152c6018b3ace729095e7b58f5be3963b81050fb...9a06dd4aa1ab008b6e12205ec3f8d00a50f79aa1,3,28,0,28,3,2013-03-04 14:51:00,2013-03-04 14:51:00
9a06dd4aa1ab008b6e12205ec3f8d00a50f79aa1...0d9a6fe7b16e52cc4d5595d6b26552c39911cf07,12,39,32,71,24,2013-03-04 14:52:30,2013-03-04 14:52:30
0d9a6fe7b16e52cc4d5595d6b26552c39911cf07...c6d6bd6ab48c999c46e3944bd037f6b34f55fa93,1,1,1,2,1,2013-03-05 10:29:44,2013-03-05 10:29:44
b7ac654b88aa9b03f431d93c25e397ff2bc66a7a...33c513274d2201787d592850e60a018b777e0c43,3,5,6,11,4,2013-02-20 11:35:36,2013-02-20 11:35:36
33c513274d2201787d592850e60a018b777e0c43...dddf6eab2dc01dd2ac685f142a61824523fea50b,1,2,3,5,2,2013-02-20 11:45:54,2013-02-20 11:45:54
ed3f44085e01f50864ce840f007a50d2154df6f5...e9d3b9659525c23a1d8c3b755c792040a5b41148,2,33,10,43,5,2013-02-16 13:42:49,2013-02-16 13:42:49
ed3f44085e01f50864ce840f007a50d2154df6f5...b6b6b640b1728ddd0d076ed64937e37671da9dfa,1,1,1,2,1,2013-02-14 13:29:24,2013-02-14 13:29:24
ed3f44085e01f50864ce840f007a50d2154df6f5...b698094d4dcd1558bfcc1611d3572297dd11ae1e,2,12,11,23,4,2013-02-14 12:00:02,2013-02-14 12:00:02
b698094d4dcd1558bfcc1611d3572297dd11ae1e...49cf9badbce730c053496306778b801d596658af,4,22,3,25,5,2013-02-14 13:17:43,2013-02-14 13:17:43
49cf9badbce730c053496306778b801d596658af...c9ca15e8d6d77b12f6cba3dfccce1427ba760d39,1,2,0,2,1,2013-02-14 13:25:55,2013-02-14 13:25:55
ed3f44085e01f50864ce840f007a50d2154df6f5...77a3bfe1debc23586e1947b4f8b1f11c94222dc0,2,128,117,245,3,2013-02-14 07:44:34,2013-02-14 07:44:34
f0e417091c2cef32b560472a38f66cf6cdcaec15...33c1463645b51bcb26932e4825df0ce8fee6c729,3,203,41,244,46,2013-02-20 21:17:05,2013-02-20 21:17:05
33c1463645b51bcb26932e4825df0ce8fee6c729...4a60c377b8cd531800757894e26cec1ac649046f,3,48,25,73,16,2013-02-20 21:51:59,2013-02-20 21:51:59
4a60c377b8cd531800757894e26cec1ac649046f...ce9e35c295d4df4b6a093ffef7ce0ad3f5e1a24e,1,2,7,9,3,2013-02-21 20:04:16,2013-02-21 20:04:16
ce9e35c295d4df4b6a093ffef7ce0ad3f5e1a24e...9ee6c58accfd51036d7242dc51fbfec2c9abeb06,2,64,18,82,15,2013-02-21 20:13:46,2013-02-21 20:13:46
4bf63212d751db6450caac6fd07f5e2c8386e43e...806b76a168536ef05b20c5449f19164ea149583f,2,2,2,4,2,2013-02-12 09:46:50,2013-02-12 09:46:50
1eabd9dfecad735a4e59884c568b27d27932517f...70f828cd4b06c0854e71b72cc03cf45c11987d7e,1,30,7,37,3,2013-10-09 11:28:25,2013-10-09 11:28:25
70f828cd4b06c0854e71b72cc03cf45c11987d7e...7dbbb6defeba71892230b20c5d1390f94ae1f719,2,26,2,28,3,2013-10-09 13:01:02,2013-10-09 13:01:02
7dbbb6defeba71892230b20c5d1390f94ae1f719...5277ac1b15edbb6dd7aa7a5cadee0efc07cdb3d4,1,46,13,59,8,2013-10-10 09:16:15,2013-10-10 09:16:15
5277ac1b15edbb6dd7aa7a5cadee0efc07cdb3d4...5b23a7bbb9cc47cda3111a5213b3433303c3e143,2,35,11,46,10,2013-10-10 12:29:16,2013-10-10 12:29:16
dc825ae33016b91235e210c2d37323c076fcf572...b658489f27454a130b813cad95b0bd3f9bdac1c8,1,5,1,6,1,2013-10-07 11:49:01,2013-10-07 11:49:01
08f665cf2876c70a2a987a498b01d00de7478e4a...468c8c5f0a66a9ebf1489926ba32c19db71d821a,1,9,10,19,8,2013-02-20 09:15:56,2013-02-20 09:15:56
468c8c5f0a66a9ebf1489926ba32c19db71d821a...aa1780d03c7ceb916c2e122b841d3d4ebc5ce597,4,98,63,161,5,2013-02-20 10:53:15,2013-02-20 10:53:15
aa1780d03c7ceb916c2e122b841d3d4ebc5ce597...99760edc757b24796d5db1f5328d55f483e4c33c,2,5,4,9,3,2013-02-20 11:33:03,2013-02-20 11:33:03
99760edc757b24796d5db1f5328d55f483e4c33c...c77730dd71b31d70a19f1729c795a44d7e609eb0,1,1,1,2,1,2013-02-21 10:04:06,2013-02-21 10:04:06
7cd03836e55f842fd518b4637c19235ee8701f17...2b38c8a15682f7531d97eb9f4758821148741469,1,0,16,16,1,2013-01-10 04:17:03,2013-01-10 04:17:03
7cd03836e55f842fd518b4637c19235ee8701f17...8a3bbbdb88b55fef8aafd5bf1c818670d26eb146,1,1,9,10,2,2013-01-10 00:46:23,2013-01-10 00:46:23
b510f8c4965b210cc1a583fc15dc09871669e1bf...86673a66b7ff2eebe1d88311425586be5c79c0ca,2,2,2,4,3,2012-12-21 21:22:52,2012-12-21 21:22:52
b510f8c4965b210cc1a583fc15dc09871669e1bf...931ec399bd16321f5bdd8e745f2f87dfe25a83ac,3,1,6,7,6,2012-12-21 17:43:46,2012-12-21 17:43:46
931ec399bd16321f5bdd8e745f2f87dfe25a83ac...8f01190eb5ec0f40d6f8874a3f3c79637000a709,12,86,86,172,86,2012-12-21 17:47:04,2012-12-21 17:47:04
8f01190eb5ec0f40d6f8874a3f3c79637000a709...eaa99478a7612405bc93941ea69b93e7e776ca56,3,3,3,6,3,2012-12-21 17:55:39,2012-12-21 17:55:39
fa203e8b67b3e8fd25ab1edd0ccbedc6072563b2...0236b3d17ead6a42e334e68b539fbc01cb348a6b,1,0,0,0,0,2012-12-13 11:09:48,2012-12-10 13:41:21
0236b3d17ead6a42e334e68b539fbc01cb348a6b...71266ad28f2ec4e9c771659f781885164d9b0412,1,26,5,31,5,2012-12-13 11:09:48,2012-12-10 13:50:55
71266ad28f2ec4e9c771659f781885164d9b0412...c3b9774f4bd0499d1f3d629c4b9bd110e4106b66,2,903,70,973,34,2012-12-13 11:11:41,2012-12-13 11:11:41
c3b9774f4bd0499d1f3d629c4b9bd110e4106b66...1309a40b5e037ed3da8290d0d58534d75924bd42,1,14,6,20,8,2012-12-13 11:11:47,2012-12-12 21:36:20
1309a40b5e037ed3da8290d0d58534d75924bd42...fe608f303924cb5fdb00c1eb01aa32e6c612b610,1,73,17,90,3,2012-12-13 11:11:49,2012-12-12 22:55:09
5857a7a9ce6f9bd37b633d48074778bcbde880a4...cc2484c3e61764adbb61d78c97148c41cf346cd1,2,3,3,6,3,2013-02-01 06:59:30,2013-02-01 06:59:30
cc2484c3e61764adbb61d78c97148c41cf346cd1...61833bcb7457d98800c0581b6d09406929057a54,1,3,1,4,1,2013-02-01 07:33:12,2013-02-01 07:33:12
5857a7a9ce6f9bd37b633d48074778bcbde880a4...5e28710692dd1eb872b6c25e674c81c0593ed0ac,1,1,1,2,1,2013-01-31 22:03:11,2013-01-31 22:03:11
5857a7a9ce6f9bd37b633d48074778bcbde880a4...7225c06934993e1c1deccf3adfc2ed770f69e0db,1,1,1,2,1,2013-01-31 21:58:03,2013-01-31 21:58:03
c0160d008c0e39ba92ab3494f1513fd10fcd7b7e...4ea9b3331f34f9ad39282627b1f94b44caa938b6,1,1,1,2,1,2012-12-19 17:44:15,2012-12-19 17:44:15
c0160d008c0e39ba92ab3494f1513fd10fcd7b7e...52fbcd45a4df8e93b04791fe25ff39c58f524bfa,3,38,128,166,18,2012-12-19 16:34:24,2012-12-19 16:34:24
52fbcd45a4df8e93b04791fe25ff39c58f524bfa...965102b3f654544adada3283dcd0fab92028f253,4,3,3,6,2,2012-12-19 17:02:12,2012-12-19 17:02:12
965102b3f654544adada3283dcd0fab92028f253...9b57bf78112017072ff3303946f9f2129a015cba,2,10,10,20,2,2012-12-19 18:57:41,2012-12-19 18:57:41
2ab782ae37c6a9f3efcd68ac9d486eafe1b23f3d...251945e2e56b52daaeb9c8f71fcea90ba6ad928b,2,3,3,6,3,2013-06-10 09:36:22,2013-06-10 09:36:22
77faffbda3e6d26329b140b0a38f71dcdb9aa381...0d56b1b07f8ec05725b9c8f4ed45f10c76325d43,1,18,7,25,9,2013-03-23 20:20:09,2013-03-23 20:20:09
77faffbda3e6d26329b140b0a38f71dcdb9aa381...de3b181a690db5acd17453fca1b348d95227950a,1,2,4,6,2,2013-03-23 20:05:42,2013-03-23 20:05:42
de3b181a690db5acd17453fca1b348d95227950a...c4f8d34b7d16751432c30904b60314430617ccfd,1,1,1,2,1,2013-03-23 20:06:00,2013-03-23 20:06:00
c4f8d34b7d16751432c30904b60314430617ccfd...979dcdba958cb6063c2676532a25ac407b601645,1,15,15,30,3,2013-03-24 09:24:26,2013-03-24 09:24:26
77faffbda3e6d26329b140b0a38f71dcdb9aa381...cc869d5dc101ea1175e308d8532064f06072d08b,3,99,1,100,4,2013-03-23 18:14:37,2013-03-23 18:14:37
cc869d5dc101ea1175e308d8532064f06072d08b...b49cfbc1d54b6cfa674ba803b3a90fb81c609c8b,10,130,8,138,12,2013-03-23 19:17:25,2013-03-23 19:13:51
b49cfbc1d54b6cfa674ba803b3a90fb81c609c8b...617239000762a01c57b35cbb699f155622ae921a,2,7,8,15,3,2013-03-24 07:57:15,2013-03-24 07:57:15
617239000762a01c57b35cbb699f155622ae921a...7d2fbe6bd880b001857a373500e4fae31d43060a,4,106,2,108,4,2013-03-24 15:12:28,2013-03-24 15:12:28
7d2fbe6bd880b001857a373500e4fae31d43060a...bc7c5f87bbd5cc25a0aaf03e9e5ecf6a65375098,6,66,7,73,11,2013-03-24 15:26:49,2013-03-24 15:26:49
bc7c5f87bbd5cc25a0aaf03e9e5ecf6a65375098...5b35000f16201bd631f161ef6d79b0a77dc2c27b,18,183,228,411,30,2013-03-24 18:31:14,2013-03-24 18:31:14
5b35000f16201bd631f161ef6d79b0a77dc2c27b...9e2525cbd0da4204f93937e368e277be38d1a7b3,2,2,0,2,2,2013-03-24 19:09:59,2013-03-24 19:09:59
9e2525cbd0da4204f93937e368e277be38d1a7b3...718ec26a23e3e303e04c569447acf963b9ef307e,2,53,0,53,2,2013-03-24 19:55:51,2013-03-24 19:55:51
718ec26a23e3e303e04c569447acf963b9ef307e...770f262a6a89ff5335ed452b83d1b8edb3e3ff5d,1,1,1,2,1,2013-03-24 20:22:45,2013-03-24 20:22:45
770f262a6a89ff5335ed452b83d1b8edb3e3ff5d...8adf9c79560f0b1d39270b8ee957df75b53fc30a,1,5,2,7,2,2013-03-24 20:23:12,2013-03-24 20:23:12
8adf9c79560f0b1d39270b8ee957df75b53fc30a...83eb63cbe8c266256ce93af9336e118233845173,1,24,0,24,1,2013-03-24 20:24:34,2013-03-24 20:24:34
83eb63cbe8c266256ce93af9336e118233845173...3b6228dc27fad65250884256bec05a66e1dff74c,1,0,1,1,1,2013-03-24 20:37:14,2013-03-24 20:37:14
3b6228dc27fad65250884256bec05a66e1dff74c...b3dc4fb72146d439314bdb40377272a317974397,3,14,6,20,6,2013-03-24 20:39:38,2013-03-24 20:39:38
b3dc4fb72146d439314bdb40377272a317974397...9710e42d798556ecaf0ffeaf4806a117c1b3530c,9,75,26,101,17,2013-03-24 21:16:52,2013-03-24 21:16:52
9710e42d798556ecaf0ffeaf4806a117c1b3530c...9bd1983e167c7a040565d8e03a20364455bddd59,1,0,2,2,1,2013-03-24 22:02:08,2013-03-24 22:02:08
9bd1983e167c7a040565d8e03a20364455bddd59...e90aebe259b1f81cb2523099cab4626b9276e751,2,33,31,64,18,2013-03-24 22:17:03,2013-03-24 22:17:03
e90aebe259b1f81cb2523099cab4626b9276e751...4be12be62a9dc30faecff139684f7537f0726d45,1,10,8,18,2,2013-03-24 22:17:20,2013-03-24 22:17:20
4be12be62a9dc30faecff139684f7537f0726d45...8f08fbfd9f768b885c631bdc8bc8ad202c6827a0,8,209,0,209,8,2013-03-24 22:19:40,2013-03-24 22:17:38
8f08fbfd9f768b885c631bdc8bc8ad202c6827a0...3d3e40c251179654d136d9838087f275c549e827,2,25,0,25,2,2013-03-24 22:19:40,2013-03-24 22:18:03
3d3e40c251179654d136d9838087f275c549e827...ed4dcf7484149c4432597c81b9ce1324010e036a,3,6,10,16,5,2013-03-24 22:19:40,2013-03-24 22:18:39
ed4dcf7484149c4432597c81b9ce1324010e036a...611ac727450b4fb9214e428cd91f7913d48ed7d8,2,2,2,4,2,2013-03-24 22:46:56,2013-03-24 22:46:56
611ac727450b4fb9214e428cd91f7913d48ed7d8...d4543eb5a71bd3aa5bfc24f9fadf07e4fe3d461d,7,49,14,63,15,2013-03-25 07:20:14,2013-03-25 07:20:14
d4543eb5a71bd3aa5bfc24f9fadf07e4fe3d461d...033037a059c9229df310e3508f9c50beb676bf00,4,6,3,9,4,2013-03-25 09:18:44,2013-03-25 09:14:12
033037a059c9229df310e3508f9c50beb676bf00...e3351287b4284af95390835bc75a6c3c461f04ba,3,8,8,16,8,2013-03-25 10:22:14,2013-03-25 10:22:14
e3351287b4284af95390835bc75a6c3c461f04ba...3e695acfa2f4035431cb325645b3114d06e43105,5,29,14,43,6,2013-03-25 11:58:09,2013-03-25 11:58:09
3e695acfa2f4035431cb325645b3114d06e43105...0359f1d9ec286fbbf58027e2cdb2a307806f54da,3,7,13,20,9,2013-03-25 12:28:39,2013-03-25 12:28:39
0359f1d9ec286fbbf58027e2cdb2a307806f54da...03de5a5ceea394e03120dcda709058fb0f2c1ab6,1,1,1,2,1,2013-03-25 12:35:57,2013-03-25 12:35:57
03de5a5ceea394e03120dcda709058fb0f2c1ab6...e0af7cefb4c92b474d14116b40927d70c13e78cc,3,4,4,8,4,2013-03-25 16:32:10,2013-03-25 16:32:10
77faffbda3e6d26329b140b0a38f71dcdb9aa381...325a933e0b217e7908983771b3893dd577f57a3d,1,1,1,2,2,2013-03-23 08:30:20,2013-03-23 07:16:07
5f159d4bc09d4577bcfac02e71bdaf58d7007477...df46903dbe551f80c1eb36389efd73b529dc1e31,1,1,1,2,1,2013-03-25 03:23:02,2013-03-25 03:23:02
3e115faafa13a0bcad5458a9632dec909eb376da...22279bc55870435c61d5e8208cc3117ef2268052,9,62,7,69,10,2013-05-16 14:02:22,2013-03-11 06:44:45
3e115faafa13a0bcad5458a9632dec909eb376da...d7c655347249183363d85ad5872d3cf86e2e1003,1,4,3,7,1,2013-05-16 12:09:47,2013-05-16 12:09:47
8cfc6a4de8e01a9dd7603fd8b3dce0d19da2f81a...22d411e5579a9fcde24ae0f58a660da4f35652da,1,1,1,2,1,2013-05-16 14:32:36,2013-05-16 14:32:36
63c6f30aba95398f732876f94f1fba1f8ed19622...17f664866b9f001168871c13b42ed280e609ead1,2,2,2,4,2,2013-05-24 20:17:07,2013-05-24 20:17:07
63c6f30aba95398f732876f94f1fba1f8ed19622...483f9854e43d2a3fc6cf48ec7228ddef62b93375,6,104,1,105,9,2013-05-24 19:42:21,2013-05-23 18:10:32
e6224942cee8f02d96e51098552a738f1d89860f...634cbd71380f595f6f44ce93399b92fbee37f98f,27,31,31,62,30,2013-05-14 12:33:31,2013-05-14 12:33:31
634cbd71380f595f6f44ce93399b92fbee37f98f...46daf01a155b68fb1cda270881aa1f6c8307e830,6,31,16,47,9,2013-05-14 17:11:48,2013-05-14 17:11:48
46daf01a155b68fb1cda270881aa1f6c8307e830...9d9b78823d151970fd784b995da2be1a5155b581,4,6,12,18,5,2013-05-14 17:25:16,2013-05-14 17:25:16
9d9b78823d151970fd784b995da2be1a5155b581...a0ab5e432627b3e357d495192fd37ec2754e9b3e,1,1,2,3,1,2013-05-14 17:46:17,2013-05-14 17:46:17
e6224942cee8f02d96e51098552a738f1d89860f...bc915e4570acf547f898be3fbc44c25ccf8174c1,1,1,1,2,1,2013-05-14 12:25:17,2013-05-14 12:25:17
1d857aae17a2f7a3bc759707f0fb642943d9569e...b382ce4d9195b42819a2767880f5f14a5a5ec8e6,1,1,1,2,1,2012-11-26 00:22:44,2012-11-26 00:22:44
1d857aae17a2f7a3bc759707f0fb642943d9569e...585eb70588ca80d5bcc48a03194f821077375873,2,9,5,14,4,2012-11-26 09:23:08,2012-11-26 09:23:08
585eb70588ca80d5bcc48a03194f821077375873...7ae851f6422ffeb51bf587e9621b3dc21180221d,1,1,1,2,1,2012-11-26 10:43:32,2012-11-26 10:43:32
7ae851f6422ffeb51bf587e9621b3dc21180221d...ca8bb9dff80a6ad26efd7b10a1854c8ca033f9ad,1,1,1,2,1,2012-11-26 10:52:49,2012-11-26 10:52:49
ca8bb9dff80a6ad26efd7b10a1854c8ca033f9ad...2d5a6fc850844fb30c94c749fed5564f54052b77,2,2,2,4,2,2012-11-26 11:07:16,2012-11-26 11:07:16
7acd0604007da3ac8c56bbe3a07d8ee1692e6908...e2b73513f4b323d96f4b9fa0cf4a06a057666750,1,1,1,2,1,2012-11-28 02:09:55,2012-11-28 02:09:55
7acd0604007da3ac8c56bbe3a07d8ee1692e6908...001729bb40e679e76ee4e7b80c2f441ffe0eea7f,2,4,4,8,3,2012-11-28 09:32:06,2012-11-28 08:52:38
be4138af75b2a80ceb7d444c573fc35c644d9c63...0d4568db783f0b5c9e4049fb37056e4acbba36ed,3,9,1,10,3,2012-11-06 22:47:33,2012-11-06 22:47:33
f70f7d07099b70550107b6919e32c6fc61c566f2...69ec189ad25000caa247aad944eda2398045b612,1,1,1,2,1,2013-01-22 15:10:00,2013-01-22 15:10:00
730e79e78785857fd706b73252547a5c7f6431d9...a40541c42d01614c4d1aecab5f3be17b0178fcf1,1,1,1,2,1,2013-03-04 20:54:26,2013-03-04 20:54:26
730e79e78785857fd706b73252547a5c7f6431d9...bf06b3196dfd303665058455529e344d54867e25,3,2,6,8,3,2013-03-04 20:18:53,2013-03-04 20:18:53
ba1a453ef3dddf50a2c118f4490267b19a0b2cc8...585259b8370dd50e732aac188ee7887dc1a5f4f2,1,1,1,2,1,2013-02-21 07:25:07,2013-02-21 07:25:07
585259b8370dd50e732aac188ee7887dc1a5f4f2...af3138e8013af5f38f3dae6a3e0eee68f382a0ee,2,5,5,10,4,2013-02-21 08:00:18,2013-02-21 08:00:18
af3138e8013af5f38f3dae6a3e0eee68f382a0ee...830da0c2181eee0b65d7e51d1e2854580cc9d76a,2,28,38,66,23,2013-02-21 08:28:13,2013-02-21 08:28:13
830da0c2181eee0b65d7e51d1e2854580cc9d76a...9f722427e5835e4aeb5c1dd6a9cc8720b40d87c0,1,1,0,1,1,2013-02-21 08:41:13,2013-02-21 08:41:13
9f722427e5835e4aeb5c1dd6a9cc8720b40d87c0...03f6a28ec0dab308070e83ec422f12fa289aad9f,18,3,1,4,1,2013-02-21 08:41:37,2013-02-21 08:41:37
03f6a28ec0dab308070e83ec422f12fa289aad9f...42ce2c108022f09e6c8e2fa9a90ea3f74f2b97b4,4,21,16,37,10,2013-02-21 09:27:22,2013-02-21 09:27:22
42ce2c108022f09e6c8e2fa9a90ea3f74f2b97b4...28da2a8bdc8fd5cbb05a32933c0ab1c56202481f,2,9,0,9,3,2013-02-21 09:44:33,2013-02-21 09:44:33
28da2a8bdc8fd5cbb05a32933c0ab1c56202481f...37187336b1ae92751d98f33d1f378aac069ecdaa,7,21,21,42,14,2013-02-21 10:27:52,2013-02-21 10:27:52
37187336b1ae92751d98f33d1f378aac069ecdaa...2d5096b6787a601740a59cf9b8d5d4cf53471a83,1,1,1,2,1,2013-02-21 10:39:09,2013-02-21 10:39:09
2d5096b6787a601740a59cf9b8d5d4cf53471a83...5aeaf248f1730ba1698d9e98ec43920b172b9e0c,5,56,34,90,10,2013-02-21 11:09:47,2013-02-21 11:09:47
5aeaf248f1730ba1698d9e98ec43920b172b9e0c...cce14e0b0133ec6e8f380a23a6309bb52e67cc20,4,8,6,14,5,2013-02-21 11:28:05,2013-02-21 11:28:05
cce14e0b0133ec6e8f380a23a6309bb52e67cc20...be817c53c6fcf946bc149b2e603e3809e79d9d36,3,3,4,7,3,2013-02-21 12:11:04,2013-02-21 12:11:04
be817c53c6fcf946bc149b2e603e3809e79d9d36...4a137651ec0408699b9ad137ba8794429f524f32,2,7,1,8,2,2013-02-21 12:11:24,2013-02-21 12:11:24
4a137651ec0408699b9ad137ba8794429f524f32...99b6750e1586d7d5195a064e9b5226db7c64d276,3,3,3,6,3,2013-02-21 14:26:09,2013-02-21 14:26:09
99b6750e1586d7d5195a064e9b5226db7c64d276...292dffc2286afbb2bcd16331a0be764140e97132,1,23,0,23,2,2013-02-21 15:01:02,2013-02-21 15:01:02
ba1a453ef3dddf50a2c118f4490267b19a0b2cc8...a3bbc5956bdecc39846ede219fa27b3311e2192b,1,0,25,25,2,2013-02-20 15:36:09,2013-02-20 15:36:09
ba1a453ef3dddf50a2c118f4490267b19a0b2cc8...8ba27b7b463e6691c75528748590a1cd9b9651c9,4,36,0,36,4,2013-02-20 13:49:33,2013-02-20 13:13:18
8ba27b7b463e6691c75528748590a1cd9b9651c9...1b7b17d12a9f176dd305b9ec95bd50ba3f56f520,1,25,21,46,11,2013-02-20 13:49:40,2013-02-20 13:13:42
1b7b17d12a9f176dd305b9ec95bd50ba3f56f520...e2d94e0719cb4eed4757f4cef946b1c29ef971f0,3,35,36,71,10,2013-02-20 13:49:48,2013-02-20 13:15:01
e2d94e0719cb4eed4757f4cef946b1c29ef971f0...52e0df5c23b94cc8f2929a97bc2211fd51bc1de4,2,4,19,23,2,2013-02-20 13:50:24,2013-02-20 13:37:20
52e0df5c23b94cc8f2929a97bc2211fd51bc1de4...6d68923edceb23ae6a5281e022a351a0d9c0d59b,3,2,7,9,3,2013-02-20 13:50:29,2013-02-20 13:45:29
04186e9797209ff5a9b2fd4025d458a6e2223f62...6fd88b8cbba62d1af4e249cee455a30df0eb0b1b,1,1,1,2,1,2013-02-15 09:16:21,2013-02-15 09:16:21
6fd88b8cbba62d1af4e249cee455a30df0eb0b1b...27f4cf75422d2995fdd403ee9562ab30afe85536,3,15,2,17,4,2013-02-17 19:31:20,2013-02-15 09:31:05
27f4cf75422d2995fdd403ee9562ab30afe85536...c20be05a8075217db5ec2c0f6b6a6072b422268f,1,1,1,2,1,2013-02-17 19:31:48,2013-02-17 17:38:45
04186e9797209ff5a9b2fd4025d458a6e2223f62...ba65f2910b1285217326028655de057a702572af,5,34,25,59,6,2013-02-14 15:58:56,2013-01-30 20:14:34
04186e9797209ff5a9b2fd4025d458a6e2223f62...1bf79f244344f167448926964e0bf3207344b939,1,1,1,2,1,2013-02-14 15:43:20,2013-02-04 11:12:10
6c8444f22e43de2f0166a6d7f98c7d9404d90ba2...73f780d640e442c9b2d9eb4fc7297f91c6cc76ee,1,1,0,1,1,2013-09-30 13:47:26,2013-09-30 13:47:26
73f780d640e442c9b2d9eb4fc7297f91c6cc76ee...715eaed6aecc77512d5c3f99c9cb26c143380fdd,1,1,5,6,6,2013-09-30 13:49:55,2013-09-30 13:49:55
b658489f27454a130b813cad95b0bd3f9bdac1c8...83e9825c972796d90e678bb8ed3ddc04ee5b02b8,6,11,11,22,11,2013-10-07 12:16:04,2013-10-07 12:16:04
9611640e3891e222a08d9a7ba1a7cc9d73c4e641...7bab81b199936597e1c762278bd16167de073342,6,235,240,475,10,2013-02-25 19:21:38,2013-02-25 19:21:38
7bab81b199936597e1c762278bd16167de073342...f17fe7fff2809720e13e84c1aea61878b8559e9d,2,14,15,29,3,2013-02-25 19:26:15,2013-02-25 19:26:15
f17fe7fff2809720e13e84c1aea61878b8559e9d...d0646babdbb54c652ce19e6329b904193be8522c,4,9,41,50,12,2013-02-25 19:45:33,2013-02-25 19:45:33
d0646babdbb54c652ce19e6329b904193be8522c...db8baf2895f111652699c5b48d8cb2663eed6c3f,1,10,10,20,2,2013-02-25 20:12:11,2013-02-25 20:12:11
db8baf2895f111652699c5b48d8cb2663eed6c3f...5e69ad2ceae8d3619775695b7fcab62a7a32377a,1,16,1,17,3,2013-02-25 20:51:15,2013-02-25 20:51:15
5e69ad2ceae8d3619775695b7fcab62a7a32377a...8de19b259ec4f451852ffaaaf7f1010dc05a6c2b,5,4,5,9,4,2013-02-25 20:56:10,2013-02-25 20:56:10
8de19b259ec4f451852ffaaaf7f1010dc05a6c2b...39fe9b644f200d4eeee30d4bc43486d177fd9b03,2,12,3,15,5,2013-02-25 21:10:50,2013-02-25 21:10:50
39fe9b644f200d4eeee30d4bc43486d177fd9b03...c9b1df1201dccded5fdfb4835209af9c0f258c55,1,0,2,2,2,2013-02-25 21:16:34,2013-02-25 21:16:34
78698698dc0cef4daa50ef89b10ff6b4352d6fc8...c2982c9a3116f95036d74530f7c20c692cb983d7,3,56,5,61,6,2013-01-10 06:43:25,2013-01-10 06:43:25
8fe58ed541e04f81de8e401c17d021aa4092a526...a7b572d0ab4861110100b54abcc863a312dcefaa,2,2,2,4,2,2012-12-22 09:59:05,2012-12-22 09:59:05
a7b572d0ab4861110100b54abcc863a312dcefaa...ed35ea703cc4430c4c30f58d1183607ccc625bf8,2,16,12,28,3,2012-12-22 10:01:54,2012-12-22 10:01:54
ed35ea703cc4430c4c30f58d1183607ccc625bf8...cec866a7cee86a0f56a5c1f0b11d2c19b61947e8,2,15,12,27,3,2012-12-22 11:01:15,2012-12-22 11:01:15
cec866a7cee86a0f56a5c1f0b11d2c19b61947e8...2398af9ab03e79f807c5e989cd25aafe0799a61e,2,12,5,17,4,2012-12-22 12:18:40,2012-12-22 12:18:40
2398af9ab03e79f807c5e989cd25aafe0799a61e...988e6ac2058881429ced53323e954c2e029de2c9,1,1,1,2,1,2012-12-22 12:34:38,2012-12-22 12:34:38
988e6ac2058881429ced53323e954c2e029de2c9...cc42bf784e52f7e6eed8f46e0190dbc066372a19,1,1,1,2,1,2012-12-22 14:16:16,2012-12-22 14:16:16
cc42bf784e52f7e6eed8f46e0190dbc066372a19...c926a2b6eef8bde3180332e6e241e46573fcc34f,1,0,6,6,2,2012-12-22 14:33:22,2012-12-22 14:33:22
c926a2b6eef8bde3180332e6e241e46573fcc34f...640018ba55e9fabc049e111bc9e42ee1ca3aa07c,1,1,0,1,1,2012-12-22 14:52:42,2012-12-22 14:52:42
640018ba55e9fabc049e111bc9e42ee1ca3aa07c...1ba28aaef8a985f6e06b2a2673dcaf4723843241,6,8,5,13,8,2012-12-22 17:52:28,2012-12-22 17:52:28
1ba28aaef8a985f6e06b2a2673dcaf4723843241...056fa05b869a8e12700bf56934e93ca76abb2db7,3,1,6,7,6,2012-12-22 19:06:18,2012-12-22 19:06:18
056fa05b869a8e12700bf56934e93ca76abb2db7...5d1044c335b033714744f286105d24980fb57f04,1,2,0,2,1,2012-12-22 19:36:33,2012-12-22 19:36:33
57e210f6e585f126e6a0bb69f1cc2693be75d100...03369a9165e2f333a3feb501004acf369e339d67,8,55,84,139,18,2012-12-13 03:14:05,2012-12-13 03:14:05
120f50cff42dfb133bdf066061ebf305e872d55e...f7e934696c99f2337cc4e254cb49f652a704310f,1,1,1,2,1,2012-12-15 10:33:45,2012-12-15 10:33:45
120f50cff42dfb133bdf066061ebf305e872d55e...0f7d3f591cea40d922250260326892ed49275968,4,101,98,199,8,2012-12-15 10:32:09,2012-12-15 10:32:09
61833bcb7457d98800c0581b6d09406929057a54...d53befb0d165df1f9b51c4cc1e19b6b4bcdf821d,1,1,1,2,1,2013-02-01 13:37:21,2013-02-01 13:37:21
d53befb0d165df1f9b51c4cc1e19b6b4bcdf821d...591e094e0636c084f218d52f25c01d51f7d3ecf5,1,4,0,4,1,2013-02-01 15:04:41,2013-02-01 15:04:41
591e094e0636c084f218d52f25c01d51f7d3ecf5...e6002bdaffc819ea3b743955315cf50eb804dbdb,9,117,8,125,11,2013-02-01 17:04:11,2013-02-01 17:04:11
e6002bdaffc819ea3b743955315cf50eb804dbdb...0965aeb2ea3a7f89b0a74b746ec9aee063b0713c,1,1,1,2,1,2013-02-01 17:07:54,2013-02-01 17:07:54
61833bcb7457d98800c0581b6d09406929057a54...8edc6b6a8c240322499356df96e1199bb6bbc872,3,62,1,63,3,2013-02-01 11:11:19,2013-01-08 21:05:00
8edc6b6a8c240322499356df96e1199bb6bbc872...fc0c69287069af9a47176abb1488f653f91eebdb,3,134,0,134,3,2013-02-01 13:59:22,2013-02-01 13:59:22
fc0c69287069af9a47176abb1488f653f91eebdb...149ccd5d91abf0c4b7ec610c03ad46a8ad17eec2,2,50,44,94,3,2013-02-01 14:00:12,2013-02-01 14:00:12
149ccd5d91abf0c4b7ec610c03ad46a8ad17eec2...6dba727cb282ee19b5e4c6b0d0e3ec3bff01ac63,1,5,0,5,1,2013-02-01 17:58:53,2013-02-01 17:58:53
6dba727cb282ee19b5e4c6b0d0e3ec3bff01ac63...33c48ecd35f4a2d5b2596882e36e722f700aff2f,1,1,2,3,1,2013-02-03 18:38:33,2013-02-03 18:38:33
9826db17e756c71eed5abdf75e3b5d2d105dff1a...2b921a6c725d53e2223a670b0110833f25877f4e,1,9,5,14,5,2012-12-20 09:52:42,2012-12-20 09:52:42
2b921a6c725d53e2223a670b0110833f25877f4e...85d5f606f656fc8680e28baf3d58d24898d23261,3,45,0,45,3,2012-12-18 03:14:05,2012-12-18 03:14:05
85d5f606f656fc8680e28baf3d58d24898d23261...8826077471d667680ee0ed9f86a41c4b30429e5c,32,87,252,339,58,2012-12-18 03:14:05,2012-12-18 03:14:05
251945e2e56b52daaeb9c8f71fcea90ba6ad928b...c5f56ee8a06e305265d78cdb847f3dc87bd7e6f2,5,92,132,224,17,2013-06-10 12:58:51,2013-06-10 12:58:51
c5f56ee8a06e305265d78cdb847f3dc87bd7e6f2...4f953f6f7f0099698a58f54af2a24c5b631fd314,2,43,30,73,7,2013-06-10 13:26:11,2013-06-10 13:26:11
4f953f6f7f0099698a58f54af2a24c5b631fd314...f23d25bb4f21c8d3ecca1279556f55d2229f79b8,4,17,5,22,8,2013-06-10 14:09:30,2013-06-10 14:09:30
f23d25bb4f21c8d3ecca1279556f55d2229f79b8...1f26c46a94c3eb66e351d6762937342f2b59110a,2,8,1,9,2,2013-06-10 15:27:35,2013-06-10 15:27:35
251945e2e56b52daaeb9c8f71fcea90ba6ad928b...b898372154fcb1de8b1b2a7e3486a5113ecae19b,1,1,1,2,1,2013-06-10 11:06:12,2013-06-10 11:06:12
afa9f6045aabb142ca88c9ee187436321c7398c1...850881a2ef2d89b7eb045f408bf9c8803094e6cf,1,1,1,2,1,2013-03-25 08:46:57,2013-03-25 08:46:57
850881a2ef2d89b7eb045f408bf9c8803094e6cf...1fb99264a99e5fbe03b9ccef42ac8c4f07575d8c,2,34,0,34,2,2013-03-25 08:47:22,2013-03-25 08:47:22
1fb99264a99e5fbe03b9ccef42ac8c4f07575d8c...ff35b37fd2df3b4bdcb9f1b7448d98df07237d08,1,8,2,10,4,2013-03-25 08:47:47,2013-03-25 08:47:47
ff35b37fd2df3b4bdcb9f1b7448d98df07237d08...e292d7c17b48182f7f8df20d93b92e8ba9e98ce6,6,11,26,37,10,2013-03-25 08:48:30,2013-03-25 08:48:30
e292d7c17b48182f7f8df20d93b92e8ba9e98ce6...d0df8a6ff80a25dc36157e8f412ed9d56afda4e5,4,81,155,236,10,2013-03-25 09:07:11,2013-03-25 09:07:11
d0df8a6ff80a25dc36157e8f412ed9d56afda4e5...c610347cc19e615d0fe87950f7e3d6887317ac55,3,1,45,46,4,2013-03-25 11:36:08,2013-03-25 11:36:08
c610347cc19e615d0fe87950f7e3d6887317ac55...98bea4b1ff6e7f5fdc07d6712cc6e1fd2d1e53ea,1,17,17,34,17,2013-03-25 11:40:08,2013-03-25 11:40:08
98bea4b1ff6e7f5fdc07d6712cc6e1fd2d1e53ea...d6ac38133c57336fa555532c1e85d7ad99499def,4,0,109,109,5,2013-03-25 12:58:43,2013-03-25 12:58:43
d6ac38133c57336fa555532c1e85d7ad99499def...53e54ddf8a107f02fe870159663d9763c48a3c54,1,2,2,4,1,2013-03-25 13:19:06,2013-03-25 13:19:06
979dcdba958cb6063c2676532a25ac407b601645...159cd0d742df2ed3b234f47cb19d99b68434c9fe,1,2,2,4,2,2013-03-24 09:48:23,2013-03-24 09:48:23
159cd0d742df2ed3b234f47cb19d99b68434c9fe...4cc27fd9e1cd1a2073737f94b62a19a169aac32e,1,1,1,2,1,2013-03-24 10:10:32,2013-03-24 10:10:32
bcc4e4dc7ed0740e92a61fc82c3c669f8f2d8d30...213e117a52d40a74c380c01dc7e84b938ad32ff8,3,19,15,34,4,2013-06-04 15:50:42,2013-06-04 15:50:42
6e15284844f36b93175928e83d0492a22e1c7f9b...62ef763a80271b58e0c0f6e51891828f22689daa,1,9,13,22,7,2013-03-26 00:46:10,2013-03-26 00:46:10
62ef763a80271b58e0c0f6e51891828f22689daa...b49c1cb161e4d97c4ee33ae45a48e948f1097e60,2,10,3,13,2,2013-03-26 00:51:39,2013-03-26 00:51:39
22d411e5579a9fcde24ae0f58a660da4f35652da...fd50e8e983ea4b87af90ff79352f6c87e18bf094,1,1,1,2,1,2013-05-18 06:44:54,2013-05-18 06:44:54
fd50e8e983ea4b87af90ff79352f6c87e18bf094...143a03e551162680ba029ea2078ce453c40c49ab,1,33,0,33,1,2013-05-18 06:46:14,2013-05-18 06:46:14
22d411e5579a9fcde24ae0f58a660da4f35652da...2f69171a8a78fda542f1dd0196b588450c7fb71d,1,3,3,6,3,2013-05-17 22:39:55,2013-05-17 22:39:55
22d411e5579a9fcde24ae0f58a660da4f35652da...70bdde4156093dd6b78acc52a5d72c59a0b5153d,1,1,1,2,1,2013-05-17 20:40:20,2013-05-17 20:40:20
22d411e5579a9fcde24ae0f58a660da4f35652da...684d772b8a5af728dae1ce4ba32c2fdf4d584355,1,1,1,2,1,2013-05-16 20:16:41,2013-05-16 20:16:41
22d411e5579a9fcde24ae0f58a660da4f35652da...4e4d99ec74a4a2830e774396aff085c694165f32,1,12,0,12,2,2013-05-16 16:15:26,2013-05-16 16:15:26
68825be12fb5d35080660d3f9eb6916a7a421fa8...7ef1c99db30ac5ad2ecd04e3b0b9b847a2805fb6,1,6,0,6,1,2013-05-24 20:38:33,2013-05-24 20:38:33
7ef1c99db30ac5ad2ecd04e3b0b9b847a2805fb6...233eb1c693178068cb769e1633df81e938c543ee,5,48,3,51,7,2013-05-24 21:07:19,2013-05-24 21:07:19
233eb1c693178068cb769e1633df81e938c543ee...d58aca0693d28e17633fb0d2825f1cddfd4f0748,2,5,0,5,2,2013-05-24 21:20:08,2013-05-24 21:20:08
a0ab5e432627b3e357d495192fd37ec2754e9b3e...9a94f5eb73b02f1a036d632989e901eaba2f1efa,1,1,0,1,1,2013-05-14 19:17:46,2013-05-14 19:17:46
9a94f5eb73b02f1a036d632989e901eaba2f1efa...ac148c50b07e298ff3f54147bd3faa0485f7e0a1,3,6,6,12,5,2013-05-14 19:45:28,2013-05-14 19:45:28
a0ab5e432627b3e357d495192fd37ec2754e9b3e...db949b69c14b38cd75185195bb5381473d21d280,4,12,4,16,8,2013-05-14 18:44:16,2013-05-14 18:44:16
db949b69c14b38cd75185195bb5381473d21d280...c75da470c52cbf5ef10e2259f5e9be9b35bbe4aa,4,4,0,4,4,2013-05-15 11:37:16,2013-05-15 11:37:16
9b1b5aee836cd4a874888317d504252ca7fdcf3d...0fccee82b71346e35196533e0052a77a4ed19935,1,4,0,4,2,2013-05-16 09:15:42,2013-05-16 09:15:42
9b1b5aee836cd4a874888317d504252ca7fdcf3d...ef1886d7462f738074132bae25ae468003564d1a,1,2,2,4,2,2013-05-16 07:49:57,2013-05-16 07:49:57
0bec49ebc103234007c7246e48a3b4ab9fab12cd...5ed4e7e21682a0fa8617ddd8c5f5d1b3fc611314,2,3,3,6,3,2012-11-28 09:45:33,2012-11-28 09:45:14
5ed4e7e21682a0fa8617ddd8c5f5d1b3fc611314...47234ab3672697f85f8e9f452aea4453e1b9aadc,8,43,13,56,17,2012-11-28 03:14:05,2012-11-28 03:14:05
47234ab3672697f85f8e9f452aea4453e1b9aadc...e9be4b375bf2e4929ca82d06ff0dd4b62c5e9c44,3,70,6,76,3,2012-11-21 03:18:05,2012-11-21 03:18:05
e9be4b375bf2e4929ca82d06ff0dd4b62c5e9c44...f614ae8ef71bf1de7deeeaadbdf9a4a8614771b1,7,84,42,126,13,2012-11-21 04:14:05,2012-11-21 04:14:05
f614ae8ef71bf1de7deeeaadbdf9a4a8614771b1...3d242a3154644bb1fea1b70d2661cee4f3db342c,1,4,2,6,2,2012-11-28 15:05:58,2012-11-28 15:05:11
62219aa34a9c154480555d6efeab44afca169290...10d881c9cad92169a3105cff0f02601dad4448cf,2,10,5,15,2,2012-11-07 11:31:26,2012-11-07 11:31:26
69ec189ad25000caa247aad944eda2398045b612...2be107d0d9414d6de4df5bd5e3bea2fb1f1dbde5,11,442,424,866,65,2013-01-22 15:58:09,2013-01-22 15:58:09
69ec189ad25000caa247aad944eda2398045b612...745c0dfa5768ffa5cb190d280127c8c5d1f6a5e4,1,0,2,2,1,2013-01-22 15:15:22,2013-01-22 15:15:22
745c0dfa5768ffa5cb190d280127c8c5d1f6a5e4...e982a9512e925f1534dfc893158f5654f97454f1,2,0,5,5,2,2013-01-22 15:25:35,2013-01-22 15:25:35
3a09f02e11679bb727d0ced94b88c1f5435a3299...9bb35e7e59c79031544b4b52516723a13d3bd452,3,41,15,56,9,2013-03-05 07:27:06,2013-03-05 07:27:06
9bb35e7e59c79031544b4b52516723a13d3bd452...f9200e118c3afb6384bc858792133060cf6655fe,4,2,100,102,3,2013-03-05 11:16:56,2013-03-05 11:16:56
292dffc2286afbb2bcd16331a0be764140e97132...b0fb68c191709c598ca6378914fd4f2da95dfb3a,2,9,0,9,2,2013-02-22 16:50:17,2013-02-22 16:50:17
292dffc2286afbb2bcd16331a0be764140e97132...30180ed82e3525e3d12c66f28e91ef87f8064257,1,1,1,2,1,2013-02-22 16:29:03,2013-02-22 16:26:33
292dffc2286afbb2bcd16331a0be764140e97132...dbd9d8d4c3c6a27ebf8add4fc20e790b94ca56a6,1,5,1,6,2,2013-02-22 16:10:25,2013-02-22 16:03:59
9ffabc6d7ed0c71d133a29671b50795fb621522c...979dd2603c18502e3a0065d0aa0c94af5e495b8a,1,5,6,11,6,2013-09-30 22:39:33,2013-09-30 22:39:33
979dd2603c18502e3a0065d0aa0c94af5e495b8a...4ee78342663ef458942eef2007084fcf881b3f87,1,14,14,28,2,2013-10-01 02:45:15,2013-10-01 02:45:15
c07251887c08553a2f734d7a18e6cfefad7a7084...f40e0171db1fd15bdfa87ea30a0a2a38834c7b01,5,228,5,233,6,2013-10-11 11:44:00,2013-10-11 11:44:00
2db9410945049c20b2245750f2bba06b63b95755...eb7072de912ad57af3a650aec3300f41f16e0fb3,2,1,6,7,2,2013-10-07 13:56:02,2013-10-07 13:56:02
eb7072de912ad57af3a650aec3300f41f16e0fb3...db10e6aaa6e592bd6ebca94d7fc879da26079826,1,2,2,4,1,2013-10-07 16:42:59,2013-10-07 16:42:59
2db9410945049c20b2245750f2bba06b63b95755...baa65e89b90f21047e586c5842a1b7d499625fd0,2,11,0,11,2,2013-10-07 13:06:30,2013-10-07 13:06:30
c9b1df1201dccded5fdfb4835209af9c0f258c55...d8a40d8c933da8e89013e989940f8b60d0f2e247,7,317,323,640,6,2013-02-26 11:31:39,2013-02-26 04:28:11
d8a40d8c933da8e89013e989940f8b60d0f2e247...aa36f07a02b524c843374968af6a6c122d980bd7,1,2,2,4,2,2013-02-26 12:20:14,2013-02-26 12:20:14
aa36f07a02b524c843374968af6a6c122d980bd7...f11e855bdb7f4026a4ec4c553ce7308b9bf71a0a,1,6,6,12,6,2013-02-27 12:49:53,2013-02-27 12:49:53
f11e855bdb7f4026a4ec4c553ce7308b9bf71a0a...38fce3deb03904fdfcf2fe512b094d49e22fe61c,2,31,15,46,12,2013-02-28 02:44:40,2013-02-27 13:37:38
38fce3deb03904fdfcf2fe512b094d49e22fe61c...14c2a37da218ca5ca23918d4787113644e1fd1cc,1,25,11,36,1,2013-02-28 02:44:52,2013-02-27 13:55:37
14c2a37da218ca5ca23918d4787113644e1fd1cc...00d0e57e859454c62084893a74fad71c26d5c50c,1,19,2,21,3,2013-02-28 02:46:17,2013-02-27 14:43:33
00d0e57e859454c62084893a74fad71c26d5c50c...2a687dd5625c29e48b7b64a388a828c358d45215,3,12,6,18,7,2013-02-28 05:56:27,2013-02-28 05:56:27
2a687dd5625c29e48b7b64a388a828c358d45215...f8009a4858fba2db871d8aecf9480021489da37c,2,2,2,4,2,2013-03-01 08:28:29,2013-03-01 08:28:29
f8009a4858fba2db871d8aecf9480021489da37c...95b826071f09f3bb63d663f2210e654609aace52,2,55,4,59,4,2013-03-04 08:50:42,2013-03-04 08:50:42
c9b1df1201dccded5fdfb4835209af9c0f258c55...573942263adf806b6eb61d04ba6e748334a4a519,1,1,2,3,2,2013-02-26 08:17:09,2013-02-26 08:17:09
c2982c9a3116f95036d74530f7c20c692cb983d7...abc2bdc3aa49c2651f83dd6c577d4e61fe21293f,15,28,15,43,9,2013-01-10 06:43:25,2013-01-10 06:43:25
5d1044c335b033714744f286105d24980fb57f04...328e0d80cabcb0d0a37cefb0f796a312505e87d0,1,7,1,8,1,2012-12-22 21:45:22,2012-12-22 21:45:22
5d1044c335b033714744f286105d24980fb57f04...68c43d59f09a66cca0da1b9a50c11421d52eac9a,1,6,0,6,1,2012-12-22 21:22:51,2012-12-22 21:22:51
03369a9165e2f333a3feb501004acf369e339d67...d41175cf21596b72872e362ae2c107e75c970faa,1,1,1,2,1,2012-12-13 15:55:38,2012-12-13 15:55:38
0f7d3f591cea40d922250260326892ed49275968...d3b3810928a62f4fc5d2c68cdd7375006cb0a8b5,1,1,0,1,1,2012-12-15 10:44:30,2012-12-07 12:11:51
8826077471d667680ee0ed9f86a41c4b30429e5c...a09d93821521e8908c46a418471969999ab8a312,1,1,1,2,1,2012-12-20 12:31:09,2012-12-20 12:31:09
a09d93821521e8908c46a418471969999ab8a312...6d93eafa6a0db951afb15f584856a0b18a9ce03b,1,4,8,12,1,2012-12-20 12:50:43,2012-12-20 12:50:43
8826077471d667680ee0ed9f86a41c4b30429e5c...2f7effe804bdae9fca4ca0bb55c841664c2de978,17,44,174,218,35,2012-12-19 03:14:05,2012-12-19 03:14:05
2f7effe804bdae9fca4ca0bb55c841664c2de978...adb17d60522f17dd22dfda9b37ed874f4d4430cd,3,18,15,33,6,2012-12-20 13:39:54,2012-12-20 13:39:54
1b49ae2e310db06b79808e7064be392a147f0be2...0afad135e79c3764c882f34d9498b37fecf8d294,1,5,2,7,1,2013-06-10 16:44:32,2013-06-10 16:44:32
0afad135e79c3764c882f34d9498b37fecf8d294...1487ed3e378ab6499fd6be45a91a4e401abc4ac0,3,7,7,14,5,2013-06-10 18:09:52,2013-06-10 18:09:52
1487ed3e378ab6499fd6be45a91a4e401abc4ac0...7b5d68f0a7fe2f8c9ef85f2fca10ce3d3bb7e388,4,27,5,32,7,2013-06-10 18:40:23,2013-06-10 18:40:23
7b5d68f0a7fe2f8c9ef85f2fca10ce3d3bb7e388...9e2c8d94766617358d39b81fe42f360e6dc469f8,2,7,16,23,7,2013-06-11 06:36:15,2013-06-11 06:36:15
9e2c8d94766617358d39b81fe42f360e6dc469f8...038d40f0f5b202fe9ed133fdf9de1774bdbc8ede,14,24,18,42,13,2013-06-11 06:54:01,2013-06-11 06:54:01
038d40f0f5b202fe9ed133fdf9de1774bdbc8ede...09572e40bc233792a9c8c528b373ba6dc4493791,1,4,6,10,2,2013-06-11 07:02:17,2013-06-11 07:02:17
6e78a1d7c8d8fe433a120f403d40379919d958db...6752968bb5d4a3c09fdf15996ad0055d1b1fa8b0,2,7,1,8,2,2013-03-25 13:27:09,2013-03-25 13:27:09
6752968bb5d4a3c09fdf15996ad0055d1b1fa8b0...1496c01521b46265660de72209fd81b585639bcf,1,1,3,4,1,2013-03-25 13:52:54,2013-03-25 13:52:54
b9d989dc056a2a2b9316ff9aa06b57c736426871...71d67e6557acb1ce3beeec2c2c6deb35015bd8bb,23,1011,0,1011,32,2013-06-05 08:51:48,2013-05-09 05:00:56
b9d989dc056a2a2b9316ff9aa06b57c736426871...86a262de1af7f34629276f584a7af45fcd08b871,4,25,4,29,4,2013-06-05 06:41:33,2013-06-05 05:34:13
b9d989dc056a2a2b9316ff9aa06b57c736426871...ff7e80804317373f14a6bc96374d9bd052b604e9,1,3,1,4,3,2013-06-04 22:23:28,2013-06-04 22:11:43
b9d989dc056a2a2b9316ff9aa06b57c736426871...37a90d5f764231cd765ff38448c6d650e61a4012,5,29,4,33,9,2013-06-04 17:59:30,2013-06-04 14:50:51
188e6a7a3fba5ca3705d6e0c5ab09b3cf89700a3...abc47852a97317d7ba155c14feb4154094e48220,1,3,3,6,2,2013-03-31 01:54:12,2013-03-31 01:54:12
143a03e551162680ba029ea2078ce453c40c49ab...a77b00e49bc3017b39e07608c2c00b68797de532,1,1,1,2,1,2013-05-18 22:46:48,2013-05-18 22:46:48
143a03e551162680ba029ea2078ce453c40c49ab...2d1875960212d40cb348cefb29ac78828498bc66,1,1,1,2,1,2013-05-18 12:39:33,2013-05-18 12:39:33
91ab245db770be1021c7d08e56e17d88db2b53b6...c401e5b9b1af6ce7796405c0c79eebf220506ef2,1,16,13,29,4,2013-05-27 10:39:59,2013-05-27 10:39:59
abea7125266c3bd4199f28fff03914796867831c...84e4cfc6bbfa7251dc8e2b88ca4c507b98cadc61,1,3,0,3,1,2013-05-30 06:46:02,2013-05-30 06:46:02
84e4cfc6bbfa7251dc8e2b88ca4c507b98cadc61...a52936f36a867dbdf40f0f45fd23db95e149480f,7,15,18,33,7,2013-05-30 06:46:28,2013-05-30 06:46:28
6cf29166680e062ba7ab264271b8475f5ab98bb2...2446e91d5546dd4b4fb5d3539c4671005a85ad92,1,1,1,2,1,2013-05-27 08:33:12,2013-05-27 08:33:12
6cf29166680e062ba7ab264271b8475f5ab98bb2...de29a424e6d1a5349a2738e9f02b04fe168f3676,7,21,21,42,17,2013-05-19 09:13:39,2013-05-19 09:13:39
01a8f3886e0071bc65e4516f3b3c949dfd33a55e...56b42f58e7e8385bde229ae8039bb91200aed46b,2,8,0,8,2,2013-05-30 07:57:10,2013-05-30 07:57:10
56b42f58e7e8385bde229ae8039bb91200aed46b...e14718fb2e7202e1929d03ceea43a1c487d74f3d,4,37,24,61,12,2013-05-30 07:57:50,2013-05-30 07:57:50
e14718fb2e7202e1929d03ceea43a1c487d74f3d...6e5b1686f4431386aab23cea64564718b62b3cb0,2,12,14,26,4,2013-05-30 08:13:38,2013-05-30 08:13:38
6e5b1686f4431386aab23cea64564718b62b3cb0...31fdcac1612588071c08593ac3318b93f0312eec,1,13,8,21,4,2013-05-30 08:25:34,2013-05-30 08:25:34
31fdcac1612588071c08593ac3318b93f0312eec...888e493b82435a074938aa25f823c2c9b0fb8026,1,10,4,14,3,2013-05-30 08:40:15,2013-05-30 08:40:15
888e493b82435a074938aa25f823c2c9b0fb8026...132575faa07384dd738e06b96ad892912d8a2725,3,4,10,14,5,2013-05-30 08:44:35,2013-05-30 08:44:35
d58aca0693d28e17633fb0d2825f1cddfd4f0748...ca69099f2ccc1ca6e807aecb3df5dfb9fe87f121,1,9,0,9,1,2013-06-12 02:11:05,2013-06-12 02:11:05
d58aca0693d28e17633fb0d2825f1cddfd4f0748...07fd95f3840908018cb3712162a441e63409bc31,2,9,9,18,13,2013-05-29 10:40:17,2013-05-28 23:41:15
d58aca0693d28e17633fb0d2825f1cddfd4f0748...d0b04b03b488bc5c78dfdadca61fbbccffd4853b,1,6,2,8,2,2013-05-27 11:35:54,2013-05-27 11:35:54
d58aca0693d28e17633fb0d2825f1cddfd4f0748...8c3fe4c22fe6145b15c518699b9f12e35eedf8ee,1,1,1,2,1,2013-05-27 07:34:40,2013-05-27 07:34:40
d58aca0693d28e17633fb0d2825f1cddfd4f0748...603720e3aa50635326edf8c43e86c6d92694f9c8,2,21,21,42,12,2013-05-27 07:32:58,2013-05-27 07:32:58
d58aca0693d28e17633fb0d2825f1cddfd4f0748...29a522cb4242992becefa9c38ad8420d1cbc6df4,1,2,2,4,2,2013-05-26 04:51:12,2013-05-26 04:51:12
d58aca0693d28e17633fb0d2825f1cddfd4f0748...f66209626c6e13467c1dda4a012a3151c02cbe79,1,2,2,4,2,2013-05-26 04:40:09,2013-05-26 04:40:09
d58aca0693d28e17633fb0d2825f1cddfd4f0748...86b0f4f5ad58532a7a1a8fd1feeb906238887165,1,1,1,2,1,2013-05-26 04:39:46,2013-05-26 04:39:46
d58aca0693d28e17633fb0d2825f1cddfd4f0748...fc80592ea1cb67cd65498a8b5f332848696b0356,1,8,0,8,1,2013-05-26 04:15:04,2013-05-26 04:15:04
d58aca0693d28e17633fb0d2825f1cddfd4f0748...245deb5cce916fb7a42c33cc98210ce5e4b6ed0a,2,4,4,8,3,2013-05-26 00:43:51,2013-05-26 00:43:51
d58aca0693d28e17633fb0d2825f1cddfd4f0748...5f9d78fdff746a0b50313cf415acac809569a186,2,38,14,52,14,2013-05-25 17:38:55,2013-05-25 17:38:55
ac148c50b07e298ff3f54147bd3faa0485f7e0a1...fb4a38f6077a27ea14709641f7fbe1547f37c8d4,1,3,3,6,3,2013-05-15 06:41:33,2013-05-15 06:41:33
3d242a3154644bb1fea1b70d2661cee4f3db342c...e0a9ffcdaa0bef73caee5a502cabe1b4d8767f1b,10,38,33,71,12,2012-11-28 17:04:28,2012-11-28 16:08:25
3d242a3154644bb1fea1b70d2661cee4f3db342c...4db362f5196710eab4c09fa394bc67b0d09f1ab8,2,2,1,3,2,2012-11-28 16:00:02,2012-11-20 04:49:25
e0fb0703c4fecb6ed036d7599b0692de9c92b206...70690e1971f6d009da9a37782764ae7446f69636,6,59,5,64,7,2013-01-22 17:05:01,2013-01-22 17:05:01
70690e1971f6d009da9a37782764ae7446f69636...96d97c4857cd2497108c8e5740ac8134cd439546,5,31,14,45,6,2013-01-22 17:45:13,2013-01-22 17:45:13
96d97c4857cd2497108c8e5740ac8134cd439546...0ed7f32db3114ea3b0e07acdfff7054904057af5,1,4,0,4,1,2013-01-22 17:54:45,2013-01-22 17:54:45
ed60b6fc90ed21b7375ef9822fee61eee2fc6d0e...c3659ef2e50ff238cecb62e5e4b89f6d94c54be2,1,5,5,10,2,2013-02-25 06:53:49,2013-02-25 06:53:49
ac6180bcb04d3f7486b87bf1a950e8250c6e27a5...4aa22754094ce51d33f1932cf33c32b7a99ffb49,2,6,10,16,5,2013-10-01 12:15:14,2013-10-01 12:15:14
4aa22754094ce51d33f1932cf33c32b7a99ffb49...e219cf7246c6a0495e4507deaffeba11e79f13b8,10,14,7,21,12,2013-10-01 12:15:28,2013-10-01 12:15:28
ac6180bcb04d3f7486b87bf1a950e8250c6e27a5...1b205cbc390f693b00a42a420fd320d796716146,1,4,2,6,2,2013-10-01 11:52:57,2013-10-01 11:52:57
1b205cbc390f693b00a42a420fd320d796716146...f22e6c917d938748366faed71935e602967b8b89,1,132,52,184,20,2013-10-01 21:13:09,2013-10-01 21:13:09
f22e6c917d938748366faed71935e602967b8b89...5e96d070210690d5513d575045b312625ae1cd75,2,15,20,35,16,2013-10-02 09:04:51,2013-10-02 09:04:51
5e96d070210690d5513d575045b312625ae1cd75...f1253fa7108e6277dcf9e71e0d52279b6f63b93b,3,97,16,113,18,2013-10-02 10:08:07,2013-10-02 10:08:07
f1253fa7108e6277dcf9e71e0d52279b6f63b93b...55880751aacb609d6d9d5bff2dd236c1b1952551,3,30,8,38,6,2013-10-02 10:50:01,2013-10-02 10:50:01
55880751aacb609d6d9d5bff2dd236c1b1952551...d7ec7c794aee1a2749fd3e832c9fac312d003c63,2,1,210,211,2,2013-10-02 10:51:43,2013-10-02 10:51:43
d7ec7c794aee1a2749fd3e832c9fac312d003c63...da54a1e644254687225a7351dc44bb28d688600a,2,13,12,25,2,2013-10-02 14:41:01,2013-10-02 14:41:01
ac6180bcb04d3f7486b87bf1a950e8250c6e27a5...5c2c5db7b7a87f42d7a08f86f23de539915a5704,1,1,1,2,1,2013-10-01 08:53:44,2013-10-01 08:53:44
5c2c5db7b7a87f42d7a08f86f23de539915a5704...d66025f7683c66d2e9b80452bf2a46b54730b7fd,1,4,3,7,1,2013-10-01 09:43:53,2013-10-01 09:43:53
d66025f7683c66d2e9b80452bf2a46b54730b7fd...c9dd2ca64bb9a2f4924b598d6b2288bdf3c43d27,1,1,1,2,1,2013-10-02 06:23:27,2013-10-02 06:23:27
07437ac3d436d427e4e8554f685f09a17d31e171...3d51147de18b7e1725ace4be52f9a4fd684e4f35,2,3,2,5,2,2013-10-08 07:54:40,2013-10-08 07:54:40
3d51147de18b7e1725ace4be52f9a4fd684e4f35...9a0329016b010d2882534309e96ead8b84418c3c,2,24,30,54,6,2013-10-08 08:06:38,2013-10-08 08:06:38
07437ac3d436d427e4e8554f685f09a17d31e171...29c807ced3303f60379940d34d9724480938e192,2,9,1,10,5,2013-10-08 07:32:00,2013-09-02 15:36:05
abc2bdc3aa49c2651f83dd6c577d4e61fe21293f...dd20da1bfff2cd5ea43c8c3c6837bd40e5f44f4f,4,4,24,28,4,2013-01-10 15:38:37,2013-01-10 15:38:37
9f595aa42f4dd2950579858282cf4414fcd60f42...fa8f8343745deb7b677a525d12dc69435a98ae21,2,7,3,10,5,2012-12-22 22:15:48,2012-12-22 22:15:48
fa8f8343745deb7b677a525d12dc69435a98ae21...60038a99ca591c3520cf76831369be88a77f0c04,1,3,0,3,1,2012-12-22 22:18:39,2012-12-22 22:18:39
60038a99ca591c3520cf76831369be88a77f0c04...3933930538d68b04751caea9030d4f3c59649b2b,1,17,0,17,1,2012-12-22 22:35:52,2012-12-22 22:35:52
3933930538d68b04751caea9030d4f3c59649b2b...86ed2e8f1743e82b3fafffc8ad3fa66cb87a3336,1,1,1,2,1,2012-12-22 22:39:42,2012-12-22 22:39:42
86ed2e8f1743e82b3fafffc8ad3fa66cb87a3336...0af5884bcdd0f1ef7827a9493422cd6aad876219,1,6,0,6,1,2012-12-22 22:49:46,2012-12-22 22:49:46
0af5884bcdd0f1ef7827a9493422cd6aad876219...3ff131a747834f6ef481a6fa8ee663fea3fac93b,3,4,4,8,4,2012-12-22 23:10:57,2012-12-22 23:10:57
3ff131a747834f6ef481a6fa8ee663fea3fac93b...25c33ca3d07944bbd2e0b3fbd642cc0164ff0f5d,1,1,2,3,2,2012-12-22 23:14:04,2012-12-22 23:14:04
25c33ca3d07944bbd2e0b3fbd642cc0164ff0f5d...e440da62b847ba8d6a272f7b87ce81dcf3179f84,2,4,1,5,2,2012-12-23 10:12:31,2012-12-23 10:12:31
e440da62b847ba8d6a272f7b87ce81dcf3179f84...f314d3e68fb0455aff7061ceb8f898e97d22d839,1,6,3,9,2,2012-12-23 11:57:40,2012-12-23 11:57:40
f314d3e68fb0455aff7061ceb8f898e97d22d839...6a932d0af511623ab2f9e9e00a28b0cbfd664372,1,3,0,3,1,2012-12-23 11:58:41,2012-12-23 11:58:41
d09873018aab1f7d757f36f779186d72f087b8a2...1d156c9c8ee0d81370844d58c2863cb4b780489e,5,22,2,24,8,2012-12-13 17:20:37,2012-12-13 16:42:15
1d156c9c8ee0d81370844d58c2863cb4b780489e...e228dae8769d67e7539fd0bf1475d85c0244aa8d,1,2,2,4,2,2012-12-13 17:20:37,2012-12-13 17:20:10
e228dae8769d67e7539fd0bf1475d85c0244aa8d...a8fbda945eec91c597a26100eff000bb3eb9b6af,6,81,124,205,20,2012-12-13 19:44:55,2012-12-13 19:44:55
a8fbda945eec91c597a26100eff000bb3eb9b6af...44209861e8a3ed4e5d0e0e59823d4bf61c338f1f,4,46,23,69,8,2012-12-14 03:14:05,2012-12-14 03:14:05
44209861e8a3ed4e5d0e0e59823d4bf61c338f1f...b01f8b63c2c13f8d6b9111771fb4f1422214d91c,18,201,131,332,45,2012-12-14 05:14:05,2012-12-14 05:14:05
b01f8b63c2c13f8d6b9111771fb4f1422214d91c...190e483fb4b5edb6d8dfa71b67dc52da402ddab9,8,74,36,110,19,2012-12-14 05:34:05,2012-12-14 05:34:05
9bc315bb2573f6925b1758ce90dab5fd6fbfc690...27ff15ad3e19bfbd6143f43cc61043fd78ffd3e1,1,0,36,36,1,2012-12-20 17:53:07,2012-12-20 17:53:07
27ff15ad3e19bfbd6143f43cc61043fd78ffd3e1...691799a3fe2167ceacd048effddb7adfde1c4c78,1,13,19,32,12,2012-12-20 17:53:23,2012-12-20 17:53:23
9bc315bb2573f6925b1758ce90dab5fd6fbfc690...4496903950f56dde684d4cf603358f5a9535cdb5,1,49,37,86,24,2012-12-20 15:54:28,2012-12-15 00:45:44
4496903950f56dde684d4cf603358f5a9535cdb5...b2e46f44ceee2078b8e1d92ae5ff892c044bc0e7,1,200,6,206,62,2012-12-20 15:54:28,2012-12-20 15:52:29
b2e46f44ceee2078b8e1d92ae5ff892c044bc0e7...19eb63741995e3be60781db74edab5d5ae896c6b,33,95,95,190,76,2012-12-20 15:54:28,2012-12-15 00:16:25
19eb63741995e3be60781db74edab5d5ae896c6b...757c7a52916fbee75a94ee453e055e8ce02a428e,4,14,16,30,7,2012-12-20 15:54:28,2012-12-15 01:19:21
757c7a52916fbee75a94ee453e055e8ce02a428e...4c8ac320dd72f6094bc05128a8c8878e5836f8c4,1,5,4,9,4,2012-12-20 15:54:28,2012-12-20 15:51:14
6d93eafa6a0db951afb15f584856a0b18a9ce03b...9916e8d6dc66b0a4f71bf88bae55d8077204b5f6,3,14,2,16,4,2012-12-20 13:39:39,2012-12-20 13:39:39
9916e8d6dc66b0a4f71bf88bae55d8077204b5f6...d11f9a632c19b6579bc9d0a676208c38a357fb57,1,2,1,3,1,2012-12-20 13:42:05,2012-12-20 13:42:05
d11f9a632c19b6579bc9d0a676208c38a357fb57...b2e31692a51318171e110f01363af782129b7ce7,1,0,0,0,0,2012-12-20 13:58:07,2012-12-20 13:58:07
e9c6d4adfaa3e47b73c7d3aefaceb1fff4fb2109...4b02f4a22d2c7f10418c9202bb718dab185e6d82,4,27,2,29,6,2012-12-19 04:14:05,2012-12-19 04:14:05
8cdfa86b578a27feefe2c30f28eb3f46afbb8201...dfc8281162a42d51791cf04e04ace8011b9f80e9,1,1,1,2,1,2013-07-12 11:40:27,2013-07-12 11:40:27
8cdfa86b578a27feefe2c30f28eb3f46afbb8201...ec38d6290c26b6c7ad21d9436627d18402cd3f95,1,5,3,8,5,2013-07-12 08:48:57,2013-06-17 08:44:33
8cdfa86b578a27feefe2c30f28eb3f46afbb8201...7bed77858c3fccae1de78477aff9aa31bc60e0dc,1,1,1,2,1,2013-07-12 08:44:57,2013-07-12 08:44:57
1496c01521b46265660de72209fd81b585639bcf...9d92433a7c83432657faf4c02839bba1ba6f22ac,4,27,10,37,9,2013-03-25 14:10:14,2013-03-25 14:10:14
aa0808386da50db098a189218041fc4f04a8a07e...6b4a1a7be6163e2fdc6efb6de67d79ddc3238932,1,2,1,3,1,2013-06-05 10:30:48,2013-06-05 10:30:48
6b4a1a7be6163e2fdc6efb6de67d79ddc3238932...64457799c5b77fe121374a2c9dbd2ad01d3a3836,2,3,1,4,2,2013-06-05 11:49:48,2013-06-05 11:49:48
64457799c5b77fe121374a2c9dbd2ad01d3a3836...f1e0d37b15914ce7f17a612c8afb4452a501ecd7,11,79,161,240,19,2013-06-05 12:50:11,2013-06-05 12:50:11
f1e0d37b15914ce7f17a612c8afb4452a501ecd7...36e832cc280115673e96f3adf624b9737d40f7fd,1,1,1,2,1,2013-06-05 15:11:56,2013-06-05 15:11:56
470f9064facd7a5452947ea7d3b650ea885c2195...da6f4f06c7b8ad32ae014fd232037ec05e8e8a80,3,98,0,98,3,2013-06-06 15:01:03,2013-06-06 15:01:03
da6f4f06c7b8ad32ae014fd232037ec05e8e8a80...32abda6c5d1134ce43cb5e0ef00c62b6eb0d026e,1,1,1,2,1,2013-06-06 15:08:44,2013-06-06 15:08:44
0fbaf95f13bfa8097cd277971a41028b159da0a7...78dc760f0d38b6c2f928361e3ca90f9a3a613a08,1,1,1,2,1,2013-06-06 08:47:54,2013-06-06 08:47:54
0fbaf95f13bfa8097cd277971a41028b159da0a7...a4e671dc31dd2b2775bd52304f0c772eaac451bc,2,7,7,14,7,2013-06-06 08:31:40,2013-06-06 08:31:40
a4e671dc31dd2b2775bd52304f0c772eaac451bc...963f475daf95a0e19acd2f2b093033fc983abfaf,2,2,2,4,2,2013-06-06 09:32:05,2013-06-06 09:32:05
963f475daf95a0e19acd2f2b093033fc983abfaf...b05600f28b39b3bf8f469ca7b293117c65217762,5,316,261,577,5,2013-06-06 09:37:51,2013-06-06 09:37:51
b05600f28b39b3bf8f469ca7b293117c65217762...68d146b4a692357354e25d0c0f93edf861b37e8c,7,125,237,362,7,2013-06-06 10:19:23,2013-06-06 10:19:23
68d146b4a692357354e25d0c0f93edf861b37e8c...4a344c168360e9494fa2e33f85833e5fee80a5f8,5,14,11,25,5,2013-06-06 10:38:13,2013-06-06 10:38:13
4a344c168360e9494fa2e33f85833e5fee80a5f8...20ce3980d3f06784a0bf617ef6d3b898ed2f1e54,8,24,8,32,11,2013-06-06 11:02:29,2013-06-06 11:02:29
20ce3980d3f06784a0bf617ef6d3b898ed2f1e54...3cce570c4c63efc1d0e2e264bdd1e4c2b4a2e530,1,22,1,23,3,2013-06-06 11:16:08,2013-06-06 11:16:08
3cce570c4c63efc1d0e2e264bdd1e4c2b4a2e530...beb0adf20287d4cc60c9415a5168ebfc8c631f68,1,3,2,5,3,2013-06-06 12:40:26,2013-06-06 12:40:26
beb0adf20287d4cc60c9415a5168ebfc8c631f68...883f465abe9df65a5186b358d0404f059b1f7a0d,1,2,0,2,1,2013-06-06 13:10:24,2013-06-06 13:10:24
883f465abe9df65a5186b358d0404f059b1f7a0d...cf9a366e22f731118b19de8a9922fb8df20e86a3,1,1,1,2,1,2013-06-06 13:16:49,2013-06-06 13:16:49
ea7e1636601a38078ff3b8e5246199bc471c0442...ddaedaef1ae90ccfa1146b816000a28b6503ace9,1,3,1,4,2,2013-03-31 12:04:08,2013-03-31 12:04:08
ea7e1636601a38078ff3b8e5246199bc471c0442...8fcdbaea71460c5a67ae91aa6539773655a785bd,1,6,7,13,4,2013-03-31 11:54:46,2013-03-31 11:54:46
ea7e1636601a38078ff3b8e5246199bc471c0442...15143a3b7b1c36d03da5ae462e0cf3e8bcdd97f1,1,3,3,6,3,2013-03-31 11:48:49,2013-03-31 11:48:49
8ab44f688f58f1a4fa07fb715f5a4958bcaf4ad4...246989bcca07e71bcec37886d0303a22e4da8420,6,10,6,16,7,2013-05-27 12:43:44,2013-05-27 12:43:44
2e297c1ec275c20602d5e48322613e88d8dbab13...fb3179006453a3ea3e38dd09abe0572e102e0d89,1,6,7,13,6,2013-05-27 11:58:09,2013-05-27 10:46:16
2446e91d5546dd4b4fb5d3539c4671005a85ad92...ac77f5ff1f3ceab2b882e4f8818c34ce6a5badc0,1,2,0,2,1,2013-05-27 08:46:51,2013-05-27 08:46:51
edc2e0a64be33dc05a5714acea891965fab1cdfa...e96374b74bc791858951d21d1a2dd7fb5fbaa1c9,5,7,4,11,5,2013-05-20 11:22:18,2013-05-20 11:22:18
e96374b74bc791858951d21d1a2dd7fb5fbaa1c9...6956c797611500ab731808e849ad4c71a3640c34,1,1,1,2,1,2013-05-20 11:46:39,2013-05-20 11:46:39
6956c797611500ab731808e849ad4c71a3640c34...6654db2c82b1410a214b4fe1f2bd5ce620782cad,1,7,7,14,6,2013-05-20 11:52:06,2013-05-20 11:52:06
edc2e0a64be33dc05a5714acea891965fab1cdfa...d812216deb6864a8eaf70ccb944558baa44afb59,1,1,1,2,1,2013-05-20 07:44:20,2013-05-20 07:44:20
d812216deb6864a8eaf70ccb944558baa44afb59...f18c7c440db8ecb26087bc78016c6b7f1f4ccce1,1,8,6,14,2,2013-05-20 07:46:24,2013-05-20 07:46:24
132575faa07384dd738e06b96ad892912d8a2725...1036ab2415bfbeba8313d5b9b5008284343b569f,1,1,1,2,1,2013-05-31 07:17:12,2013-05-31 07:17:12
8b64df58b956ea9c48c090503f921c3b923224b1...987b51b9112da3670d81ec0648b73f047d94f454,1,1,1,2,1,2013-05-27 18:02:42,2013-05-27 18:02:42
e36c0c14d5032354edf65fa9a85c13a5da582158...f7f6acee0b5beab61ea6d3e7996ce93fd0a4b22f,1,14,0,14,2,2013-05-15 12:22:34,2013-05-15 12:22:34
d8f825ef009d10fe03674989239e3a26e21fff36...c873cf81f61d644639b459b2fde1267a41050bc1,17,56,113,169,26,2012-11-28 17:40:54,2012-11-28 17:40:54
efe2f5f8c7e147f83785d34dc5a006f1dc62ad65...621ca86b9edc9f4086f28ab469b3ca3d5b35b82a,1,1,1,2,1,2013-01-22 18:07:11,2013-01-22 18:07:11
c3659ef2e50ff238cecb62e5e4b89f6d94c54be2...3cf814ff9d16d761ec37a8189e5192a378ef13bb,1,9,9,18,9,2013-02-25 08:28:59,2013-02-25 08:28:59
3cf814ff9d16d761ec37a8189e5192a378ef13bb...262f80a68ac2ed14be0bbf3666b91480fb56e47d,2,3,3,6,2,2013-02-25 17:22:46,2013-02-25 17:22:46
262f80a68ac2ed14be0bbf3666b91480fb56e47d...580a56b6ff2a32243e62f52df73eb58e9671cb5f,2,3,3,6,2,2013-02-25 17:44:37,2013-02-25 17:44:37
c3659ef2e50ff238cecb62e5e4b89f6d94c54be2...e975ed836d10214c4891d7d6e2052c7485d40c72,1,2,1,3,2,2013-02-25 08:21:38,2013-02-25 08:21:38
e219cf7246c6a0495e4507deaffeba11e79f13b8...b9d58c4cecd06be74c3cc32ccfb522b31544ab2e,4,26,0,26,5,2013-10-03 07:20:33,2013-10-02 15:09:29
b9d58c4cecd06be74c3cc32ccfb522b31544ab2e...1c9a41e0d5cac3ee937555ae4189ecd1ad597004,4,19,2,21,4,2014-02-06 09:12:59,2014-02-06 09:12:59
e219cf7246c6a0495e4507deaffeba11e79f13b8...b6bd4856a33df3d144be66c4ed1f1396009bb08b,3,25,0,25,4,2013-10-02 15:09:29,2013-10-02 15:09:29
e219cf7246c6a0495e4507deaffeba11e79f13b8...ae9dd6276267e0df2d9c2da3b89393e4ee212175,15,54,34,88,31,2013-10-01 14:00:28,2013-10-01 14:00:28
ae9dd6276267e0df2d9c2da3b89393e4ee212175...836c870cc9f72449befd03c994f563040ff94f69,1,2,2,4,2,2013-10-01 14:08:40,2013-10-01 14:08:40
836c870cc9f72449befd03c994f563040ff94f69...1d3f03fb69111e25a33ccb7f66582904ad0371f8,6,19,10,29,8,2013-10-01 15:26:55,2013-10-01 15:26:55
f81532b5b929d5fa8fdf72a71eb036b0cf27735b...ad3defa3c2f7c3b1d5a15e0f145f424302eb23a4,3,22,1,23,3,2013-10-11 19:41:33,2013-10-11 19:41:33
f81532b5b929d5fa8fdf72a71eb036b0cf27735b...ba7c1764be87f272759471bde01b92dcc147e952,2,8,9,17,2,2013-10-11 15:54:46,2013-10-11 15:54:38
9651457260ea1b9e0e458ed0afd3fed0a8991648...5cf31b92c4b56f9526b8557a78a59944a4a47bb4,1,9,6,15,1,2013-10-08 09:06:46,2013-10-08 09:06:46
c147b571f4dbb6a6c6b104173f91c3a94f5be0f9...65f5d062e9665b10ef8c1be07156be285c759faa,4,27,1,28,6,2013-10-09 07:21:53,2013-10-08 14:21:40
c147b571f4dbb6a6c6b104173f91c3a94f5be0f9...9ee49c5c49ee5f44efee5cd91117c6b45c0ce825,1,5,1,6,3,2013-10-08 12:45:57,2013-10-08 12:45:57
dd20da1bfff2cd5ea43c8c3c6837bd40e5f44f4f...e25656d09bea03892a1d7720cdd70894db7805aa,3,27,20,47,4,2013-01-10 16:09:12,2013-01-10 16:09:12
6a932d0af511623ab2f9e9e00a28b0cbfd664372...aec1a84042a789bc5a7926ec91b49c2b689e081d,2,12,1,13,2,2012-12-24 00:12:53,2012-12-23 15:49:11
6a932d0af511623ab2f9e9e00a28b0cbfd664372...d62a8a4d50c05748cb6760a503191531181dd8b0,1,8,2,10,2,2012-12-23 21:16:51,2012-12-23 16:18:27
6a932d0af511623ab2f9e9e00a28b0cbfd664372...4ebee56acc589f0285fcad441b2619fd8eccdc74,1,3,1,4,1,2012-12-23 16:00:26,2012-12-23 16:00:26
190e483fb4b5edb6d8dfa71b67dc52da402ddab9...69c18903e710ceec9aa577312835f5b70029f208,1,25,19,44,20,2012-12-14 19:22:34,2012-12-14 19:20:26
190e483fb4b5edb6d8dfa71b67dc52da402ddab9...678e5355a3e43aa2a13d109fe5d75de231eef413,7,40,3,43,10,2012-12-14 17:33:33,2012-12-14 17:33:33
678e5355a3e43aa2a13d109fe5d75de231eef413...f2db188dbe26b93e76eb3536f1a972a4a9e01f66,8,73,33,106,19,2012-12-14 19:39:55,2012-12-14 19:39:55
f2db188dbe26b93e76eb3536f1a972a4a9e01f66...f03dc8716d8edd144b341cbde967ccd9db84d6f7,1,1,1,2,1,2012-12-14 19:48:16,2012-12-14 19:48:16
f03dc8716d8edd144b341cbde967ccd9db84d6f7...0ff468160e11270af7178d2494d0d6dabde20a6e,3,3,3,6,3,2012-12-14 19:54:49,2012-12-14 19:54:49
0ff468160e11270af7178d2494d0d6dabde20a6e...b79e00881ec441c7266e8aca6083a3eb9586cd40,3,19,13,32,4,2012-12-14 20:05:10,2012-12-14 20:05:10
d8d95c85aea31a3814c7c9910a4bf429510ec481...d188adfd97417be489df8a1cef2ca3bf986676ee,3,17,0,17,3,2012-12-20 19:16:42,2012-12-20 19:16:42
40c6d8717573ee892529b5d8398d417e166f14c6...a7aee9d1ee9b8e90deb9c8d71a4ea9d96c0d6f8f,2,26,18,44,7,2012-12-19 17:14:05,2012-12-19 17:14:05
a7aee9d1ee9b8e90deb9c8d71a4ea9d96c0d6f8f...b772c2c3f02c5beebd4c7ba8d43f9f5ac351b3f7,1,4,0,4,1,2012-12-20 14:42:13,2012-12-20 14:42:13
94149f8e7a86e580d9bd47d2a0bbcc6309edc895...e68b0cac3df483574f7fee454e71734709f22a93,1,5,0,5,1,2013-07-12 13:11:45,2013-07-12 13:11:45
e68b0cac3df483574f7fee454e71734709f22a93...f1fc1ae6f10d122c6b852edc0fdf11f38a2d7e30,1,1,1,2,1,2013-07-12 13:12:23,2013-07-12 13:12:23
795bb9cf65daf2bfff7dda20d5fed6719d1b1b1d...8c9123943f1fbee5b72d97031a5e30ec7dd96db6,1,1,0,1,1,2013-03-25 14:12:12,2013-03-25 14:12:12
36e832cc280115673e96f3adf624b9737d40f7fd...e7bcbb95c88a42fc31bc0ccbdf6a819780a612ec,14,138,93,231,32,2013-06-05 19:25:27,2013-06-05 19:25:27
36e832cc280115673e96f3adf624b9737d40f7fd...89d6ee16328a26c33abffcd00d589740d4514ea0,1,1,0,1,1,2013-06-05 18:08:42,2013-06-05 18:08:42
8da7c3bfbc975d03d997edddb2dd83d0af5fb187...a687bd93324255550b2cc1f239f6937913f01d80,1,1,0,1,1,2013-06-06 15:28:15,2013-06-06 15:28:15
a687bd93324255550b2cc1f239f6937913f01d80...543506f3c59b3c7b8d6c67b69e28466cf3b45b3a,2,7,4,11,4,2013-06-06 15:40:05,2013-06-06 15:40:05
543506f3c59b3c7b8d6c67b69e28466cf3b45b3a...8df699a336af347628f83274b1eb11255f353e9e,5,115,1,116,6,2013-06-06 16:19:17,2013-06-06 16:19:17
025e41576e9a394487598cf9a3ce31d0fb7867ef...71b0f8ea0b7d4460fdbb70ca9b61789d37ed4885,5,32,13,45,10,2013-03-31 14:08:10,2013-03-31 14:08:10
e26d149cd8a4eedaf56810de01e085c5661f1c02...9351a295c1ac84e2e67559a9140cb921445c8951,3,8,6,14,5,2013-05-27 14:14:47,2013-05-27 14:14:47
1ed92561b232a4f2546da39bd8d14228f6d082c5...df67b25bc2c56b59758bdf5dfcab6ff0946632d7,1,3,1,4,3,2013-05-28 14:09:01,2013-05-28 14:08:21
df67b25bc2c56b59758bdf5dfcab6ff0946632d7...e5e3e0d9e6fddccf6e9be327dd2fbf116e7f6481,2,4,1,5,2,2013-05-28 14:24:23,2013-05-28 14:24:23
e5e3e0d9e6fddccf6e9be327dd2fbf116e7f6481...07aa6e596318288edcd95bc327489f42021f275f,2,6,0,6,2,2013-05-28 14:37:23,2013-05-28 14:37:23
07aa6e596318288edcd95bc327489f42021f275f...98cf0ae3384afa34a417766f46a7b3171dc40279,3,15,9,24,9,2013-05-28 15:00:44,2013-05-28 15:00:44
98cf0ae3384afa34a417766f46a7b3171dc40279...45f9cca9b30c4f3f57d5abfc01b347adbc3ce34b,1,4,0,4,2,2013-05-28 15:59:01,2013-05-28 15:59:01
6654db2c82b1410a214b4fe1f2bd5ce620782cad...0f615d4096810b9db13fca1a8aafb64f946fbd5f,1,56,0,56,1,2013-05-27 07:21:01,2013-05-27 07:21:01
6654db2c82b1410a214b4fe1f2bd5ce620782cad...0ebfa5e5a2f93cb57e00159aa20ec8bf52dba67e,6,863,0,863,7,2013-05-21 21:13:30,2013-05-21 21:13:30
6654db2c82b1410a214b4fe1f2bd5ce620782cad...a5a96c812b91fdea97eb6b3997a3c11fe49a908c,1,1,1,2,1,2013-05-21 17:33:54,2013-05-21 17:33:54
6654db2c82b1410a214b4fe1f2bd5ce620782cad...714d9d192fd58c731ad3440f77549d446cb011c8,1,0,1,1,1,2013-05-21 00:25:25,2013-05-21 00:25:25
6654db2c82b1410a214b4fe1f2bd5ce620782cad...e8d2f28805d0cc5d9e0a1bd5509892641be2182f,1,1,1,2,1,2013-05-20 12:00:05,2013-05-20 12:00:05
ee2124b7e935bb8bbe7a33c1a276efa296311b28...01d694aabae539769ac75dd8903b351acb8b811b,1,4,4,8,4,2013-06-25 11:01:41,2013-06-25 11:01:41
ee2124b7e935bb8bbe7a33c1a276efa296311b28...aefdcdd4311bfd3695b591374b49630b97b77f8c,1,1,1,2,1,2013-06-02 07:15:37,2013-06-02 07:05:48
ee2124b7e935bb8bbe7a33c1a276efa296311b28...63968c1a424debe8f5c6b5c23fbdff302bf57e3c,2,3,2,5,3,2013-06-02 02:44:11,2013-06-02 02:44:11
ee2124b7e935bb8bbe7a33c1a276efa296311b28...08c2c94d46f78f68f09dcc43b8249570a64caffe,2,30,2,32,2,2013-06-01 15:24:15,2013-06-01 15:24:15
08c2c94d46f78f68f09dcc43b8249570a64caffe...41f88f468af711ee6b296754964de0c026dbd24c,1,1,1,2,1,2013-06-01 15:40:20,2013-06-01 15:40:20
ee2124b7e935bb8bbe7a33c1a276efa296311b28...efa79936c3a43f9acf557a83c1c682a601308a97,1,2,2,4,1,2013-06-01 12:14:43,2013-06-01 12:14:43
efa79936c3a43f9acf557a83c1c682a601308a97...a00e29d7ccc51f1bfd5a95f7cfba71e2dbe94021,1,2,2,4,1,2013-06-01 12:15:22,2013-06-01 12:15:22
ee2124b7e935bb8bbe7a33c1a276efa296311b28...57497e9f25aca0f49b079b03626ef99fde279520,1,1,1,2,1,2013-05-31 08:30:21,2013-05-31 08:30:21
987b51b9112da3670d81ec0648b73f047d94f454...3db67ff09c3b1ff2c66da238c6796942483ae6e1,1,2,2,4,2,2013-05-27 19:30:54,2013-05-27 19:30:54
f7f6acee0b5beab61ea6d3e7996ce93fd0a4b22f...36705e54bb1966f3c5f34fd5cd10e942631d8de3,1,5,5,10,4,2013-05-15 15:42:45,2013-05-15 15:42:45
36705e54bb1966f3c5f34fd5cd10e942631d8de3...57791cdb914d51563d442ed238318a2c1ca3cec9,1,0,5,5,1,2013-05-15 15:44:12,2013-05-15 15:44:12
f7f6acee0b5beab61ea6d3e7996ce93fd0a4b22f...7de708b9098d0b039429f946698b4a22b3a66c8c,1,3,3,6,3,2013-05-15 15:35:00,2013-05-15 15:35:00
c873cf81f61d644639b459b2fde1267a41050bc1...15a72a3b87551e599ce8bd7b6f479310f70c1260,2,16,0,16,2,2012-11-28 17:59:19,2012-11-28 17:59:19
15a72a3b87551e599ce8bd7b6f479310f70c1260...34c2d8e82eec046bd73a2ed145210bdc83bbe90e,2,2,1,3,2,2012-11-28 18:09:13,2012-11-28 18:09:13
65737bd5bd6eb65556699a176e69757a3ac8c37a...8ec36ca056cdae7ecd6b2b7dce215d7ef897e22d,1,2,2,4,2,2013-01-23 15:58:38,2013-01-23 15:58:38
65737bd5bd6eb65556699a176e69757a3ac8c37a...d3c34ef8afa1018e9dae0a144227b399ba89adbf,1,1,1,2,1,2013-01-23 14:47:19,2013-01-23 14:47:19
65737bd5bd6eb65556699a176e69757a3ac8c37a...b614e3b5cbff88b16b87ea8dc1b03ddc53146d15,1,1,1,2,1,2013-01-23 14:32:31,2013-01-23 14:32:31
65737bd5bd6eb65556699a176e69757a3ac8c37a...70687cd5812a53ce574589f4f7ce6a6d683c2f07,2,8,6,14,7,2013-01-23 12:39:29,2013-01-23 12:34:19
65737bd5bd6eb65556699a176e69757a3ac8c37a...79b9249ff44c5ccbef44a8d9420a3fff369d932a,2,25,0,25,2,2013-01-23 08:29:46,2013-01-23 08:29:46
b1492a2a627d1fe51f5cdd5423169247a188f7e4...16d6eb3f9a6d97e17b501079c8770ba68ab999eb,1,1,1,2,1,2014-02-06 14:21:31,2014-02-06 14:21:31
16d6eb3f9a6d97e17b501079c8770ba68ab999eb...5101ff7bec35704d844df8e608f604abd22df57a,1,2,0,2,2,2014-02-06 14:23:29,2014-02-06 14:23:29
68d89548cd7d796c78e7b9d3f7b64702d39d0f5c...970d86b7c5d0be871d8ab8d7cbd51997fd62e28a,7,12,13,25,9,2013-10-01 17:34:41,2013-10-01 17:34:41
1a6ba7e640577a98b6db480c8e7884882fb0fa03...78b3fb769c9ad1c0283a344a572caa01f4389213,1,2,2,4,2,2013-10-07 12:40:56,2013-10-07 11:32:33
1a6ba7e640577a98b6db480c8e7884882fb0fa03...363c5204d9947444eb955aa59861c8c5a2f6faf5,1,13,6,19,5,2013-10-04 10:20:40,2013-10-04 10:20:40
1a6ba7e640577a98b6db480c8e7884882fb0fa03...4017789f5aac8a8244e80c3f4feada5393c8a4ed,1,6,4,10,4,2013-10-04 09:25:44,2013-10-04 09:18:44
1a6ba7e640577a98b6db480c8e7884882fb0fa03...9d622bd790578e58a72424cd637ab40c87a7073e,1,1,1,2,1,2013-10-03 09:04:51,2013-10-03 09:04:51
d43d7471c17a67174da2b53bea63d39e7a43a35e...995ce5fdc759059a0f80479af9e4c3850099e937,1,7,8,15,3,2013-10-12 07:01:27,2013-10-12 07:01:27
995ce5fdc759059a0f80479af9e4c3850099e937...70b793eb7a800c326c35ba5e72cf5f0a3af5e749,4,6,4,10,5,2013-10-13 08:00:51,2013-10-13 08:00:51
70b793eb7a800c326c35ba5e72cf5f0a3af5e749...20c47923a10bfeb6dcd895adfcf05c78c696ec7f,1,5,0,5,1,2013-10-13 08:11:10,2013-10-13 08:11:10
20c47923a10bfeb6dcd895adfcf05c78c696ec7f...b65a0461d139c34271b81c3fee0026dd32a88016,1,0,5,5,1,2013-10-13 11:22:40,2013-10-13 11:22:40
b65a0461d139c34271b81c3fee0026dd32a88016...5c67c88731b4e53325a5c6efdcc36f08d405bbdb,1,18,13,31,8,2013-10-13 11:38:20,2013-10-13 11:38:20
5c67c88731b4e53325a5c6efdcc36f08d405bbdb...41f63acc84ac0f8f348c8393f4094b2aa597461c,1,2,1,3,1,2013-10-13 13:03:16,2013-10-13 13:03:16
a37b8ab2b269e376e8d946a68461740a4ab55ce9...551fa4c9d017b42ca362055d8bddb817bb395a52,1,0,6,6,1,2013-10-09 11:19:38,2013-10-09 11:19:38
358426d66164d720d793ea37bacb4fc331c30171...65cad57a35002a9fd168863ae8a4d7ca045fb938,40,119,39,158,48,2013-10-09 07:05:09,2013-10-06 18:13:56
358426d66164d720d793ea37bacb4fc331c30171...1875141a963a4238bda29011d8f7105839485253,1,7,0,7,2,2013-10-08 18:50:46,2013-10-08 18:36:16
1875141a963a4238bda29011d8f7105839485253...6d7ced4a2311eeff037c5575cca1868a6d3f586f,1,1,2,3,2,2013-10-08 18:53:22,2013-10-08 18:53:22
358426d66164d720d793ea37bacb4fc331c30171...903090d1484408c8fe3fb91da28a6af17d3e288d,2,2,2,4,2,2013-10-08 18:32:26,2013-10-08 18:32:26
0bd3c195a508de614343ae2696dee9afa873cad5...9152ab79554b251c7e90ecd99ece67deff55ae92,1,0,2,2,1,2013-01-10 18:20:56,2013-01-10 18:20:56
9cf1f69cfa4e2e953f842e010573e76ec7486552...645afc384a12a06b7760fce1f0fdc822e9c6b164,1,3,3,6,3,2012-12-14 20:13:07,2012-12-14 20:12:05
d188adfd97417be489df8a1cef2ca3bf986676ee...75dd7042940cc6fe7532d42612e1b0db0729a86d,5,47,2,49,6,2012-12-20 20:16:51,2012-12-20 20:16:51
75dd7042940cc6fe7532d42612e1b0db0729a86d...2a3f5dae0f562e08436934dbc95e0f6ed6902ee9,10,22,26,48,14,2012-12-20 21:04:27,2012-12-20 21:04:27
d188adfd97417be489df8a1cef2ca3bf986676ee...e3a7e43ff4fb1ebf9e594b32abcb980a8b905c49,2,3,3,6,3,2012-12-20 19:22:25,2012-12-20 18:31:29
e3a7e43ff4fb1ebf9e594b32abcb980a8b905c49...501f048846bad9a66583bb73d448564eca752905,4,12,14,26,7,2012-12-20 19:22:25,2012-12-20 18:38:44
501f048846bad9a66583bb73d448564eca752905...56f9a674a6f398abc2541b435808361b13b7e713,3,18,1,19,3,2012-12-20 20:52:26,2012-12-20 20:52:26
56f9a674a6f398abc2541b435808361b13b7e713...c9bf2bb288cffba2d4a30f1937ca88b9b92e64ed,2,73,69,142,17,2012-12-20 20:52:35,2012-12-20 19:17:09
c9bf2bb288cffba2d4a30f1937ca88b9b92e64ed...1acff973c85fb836c6b28a5d36aafa4332029424,3,26,22,48,4,2012-12-20 20:52:37,2012-12-20 19:05:01
8c9123943f1fbee5b72d97031a5e30ec7dd96db6...7a4f70d79b9d78d3417b16bdaf0dc67d9dcdd4e9,2,3,3,6,3,2013-03-25 17:12:29,2013-03-25 17:12:29
e7bcbb95c88a42fc31bc0ccbdf6a819780a612ec...c18564d2cbbffa5d15d2ead97ba0fc4623f77e07,2,3,3,6,3,2013-06-06 01:10:51,2013-06-06 01:10:51
88deb2217af336d014c91dc8b5398ebd99a674da...6cf6b45adca4ac4dfc3d2e3511e81d6ace427ce9,2,2,2,4,2,2013-06-06 06:04:25,2013-06-06 06:04:25
c0d7b5bb70260aee0f26c67872559eb1482f2f53...66c817677cc495ed284ebf44d3bef3b51f6b4ea1,1,1,2,3,2,2013-06-06 17:18:47,2013-06-06 17:16:18
71b0f8ea0b7d4460fdbb70ca9b61789d37ed4885...45c4804c8e6bdc35bf5ad69ee4e84aea88d86a3c,1,1,1,2,1,2013-04-01 09:25:31,2013-04-01 09:25:31
71b0f8ea0b7d4460fdbb70ca9b61789d37ed4885...676bce2ab941fcc50ef5796ff77229e238eb9b35,2,360,0,360,2,2013-03-31 15:49:06,2013-03-31 15:49:06
676bce2ab941fcc50ef5796ff77229e238eb9b35...d444a23ad6d9c2455a0159435d0c63342aca5edb,2,155,0,155,2,2013-03-31 15:49:31,2013-03-31 15:49:31
d444a23ad6d9c2455a0159435d0c63342aca5edb...154e54b46e01615bc13f5e3ac2d0f07f7a27464d,6,11,170,181,10,2013-03-31 15:49:58,2013-03-31 15:49:58
154e54b46e01615bc13f5e3ac2d0f07f7a27464d...9dc644635f99dffa26555eeb1c92f988221ccb6a,6,5,325,330,7,2013-03-31 15:50:17,2013-03-31 15:50:17
9dc644635f99dffa26555eeb1c92f988221ccb6a...26323046fda07b2353ee427afcd0253cea935047,5,13,3,16,6,2013-03-31 16:00:45,2013-03-31 16:00:45
26323046fda07b2353ee427afcd0253cea935047...1ea385625b481e405fbbffc2b2465553b20d90de,2,0,126,126,2,2013-03-31 20:44:59,2013-03-31 20:44:59
1ea385625b481e405fbbffc2b2465553b20d90de...a0bca5b71d11454b51f890f4dd36bbf948f1edf5,1,41,0,41,1,2013-03-31 20:45:38,2013-03-31 20:45:38
a0bca5b71d11454b51f890f4dd36bbf948f1edf5...2a6b4f965e97867dbec9c3c5091b61c4ec27bb5d,1,6,0,6,1,2013-03-31 20:45:58,2013-03-31 20:45:58
2a6b4f965e97867dbec9c3c5091b61c4ec27bb5d...685681e28af2cae7c5ba208130ad5b6b4e5c4ed9,4,0,10,10,8,2013-03-31 20:46:25,2013-03-31 20:46:25
685681e28af2cae7c5ba208130ad5b6b4e5c4ed9...da5b0c91dc79136be4315cf61e5520692e19be8a,2,90,18,108,8,2013-03-31 20:46:54,2013-03-31 20:46:54
da5b0c91dc79136be4315cf61e5520692e19be8a...b53557aca64fbf55f9bbd59849d83daa10b7361f,13,18,21,39,17,2013-03-31 20:47:26,2013-03-31 20:47:26
b53557aca64fbf55f9bbd59849d83daa10b7361f...bbfbff3add4c78ce1256ac3bbe787cc6eb9fe1b9,7,67,11,78,11,2013-03-31 20:48:12,2013-03-31 20:48:12
bbfbff3add4c78ce1256ac3bbe787cc6eb9fe1b9...458631c5ba8c830021bd7c219affdb0afe6f0efe,3,2,5,7,3,2013-03-31 20:58:17,2013-03-31 20:58:17
458631c5ba8c830021bd7c219affdb0afe6f0efe...7bb71bb088e17578482e7f934147b0fd11c7ad0e,2,4,8,12,4,2013-04-01 06:21:31,2013-04-01 06:21:31
7bb71bb088e17578482e7f934147b0fd11c7ad0e...22817398e6c1cf9a479fecd99c55369fd81717cb,5,72,87,159,7,2013-04-01 11:39:19,2013-04-01 11:39:19
22817398e6c1cf9a479fecd99c55369fd81717cb...51c167554cf492be98cecad182a6870cd6febb82,1,22,0,22,1,2013-04-01 13:02:54,2013-04-01 13:02:54
51c167554cf492be98cecad182a6870cd6febb82...bb06e905efb1722502d71059c21add8cfde851aa,1,37,0,37,1,2013-04-01 13:03:11,2013-04-01 13:03:11
bb06e905efb1722502d71059c21add8cfde851aa...49b024f5f5b88d406b895f050943db1e75adfa2a,11,32,64,96,26,2013-04-01 13:04:35,2013-04-01 13:04:35
49b024f5f5b88d406b895f050943db1e75adfa2a...541d89941014137762dff696c83b3357eba8efeb,13,51,54,105,27,2013-04-01 13:56:25,2013-04-01 13:56:25
541d89941014137762dff696c83b3357eba8efeb...9a26e9a0d634c8bb796f0b08f6397d1e343bd4be,7,18,11,29,11,2013-04-01 14:27:44,2013-04-01 14:27:44
9a26e9a0d634c8bb796f0b08f6397d1e343bd4be...f5dec306fda53a6b2e90f64c0407077ab0022e8f,8,20,17,37,10,2013-04-01 15:16:08,2013-04-01 15:16:08
f5dec306fda53a6b2e90f64c0407077ab0022e8f...adccf3b49912df4ea630eb6e96e34204ddf932e6,2,3,3,6,3,2013-04-01 15:24:05,2013-04-01 15:24:05
adccf3b49912df4ea630eb6e96e34204ddf932e6...3b88636d3c3a85d8dea83149b1f401d505d84d60,3,5,8,13,6,2013-04-01 15:35:29,2013-04-01 15:35:29
3b88636d3c3a85d8dea83149b1f401d505d84d60...f536c133550b74b3083c66adaebf0ae6d425f81b,8,10,19,29,11,2013-04-01 16:06:47,2013-04-01 16:06:47
f536c133550b74b3083c66adaebf0ae6d425f81b...8a6bf09ad0f95a859406c86c3a925f824dfbd633,1,2,2,4,2,2013-04-01 17:35:41,2013-04-01 17:35:41
9351a295c1ac84e2e67559a9140cb921445c8951...5ec3129ea657dc1c28c45ed4f54ec62fc6050ce6,2,7,1,8,3,2013-05-27 19:51:37,2013-05-27 14:53:50
45f9cca9b30c4f3f57d5abfc01b347adbc3ce34b...091c21e0e408a85ce833ff45bf3b6c0d155e434f,1,1,1,2,1,2013-05-29 07:07:14,2013-05-29 07:07:14
45f9cca9b30c4f3f57d5abfc01b347adbc3ce34b...6b4602a733ddd485c751e52ae831d1c4f2165b92,1,2,2,4,2,2013-05-28 17:48:51,2013-05-28 17:48:51
6d6d084c391b480bceef4478cca404555440ffe8...ef935aba4f01fcbf4e9d0b8861b1d8ea5d13ffa6,1,1,1,2,1,2013-06-11 09:31:05,2013-06-11 09:31:05
ef935aba4f01fcbf4e9d0b8861b1d8ea5d13ffa6...c38a6fe17308769d3d0ddbed99d0768b15c7dc73,3,3,3,6,3,2013-06-11 10:51:22,2013-06-11 10:51:22
c38a6fe17308769d3d0ddbed99d0768b15c7dc73...52f312a8a83eb24fdae41eed7923a64f816f70d3,2,3,1,4,3,2013-06-11 10:54:58,2013-06-11 10:54:58
52f312a8a83eb24fdae41eed7923a64f816f70d3...6eb045fc98f02a54b5db37ff2a43b008fe971158,5,18,15,33,6,2013-06-11 11:17:37,2013-06-11 11:17:37
6eb045fc98f02a54b5db37ff2a43b008fe971158...c058aaf7dcc0f05ea3583f5ba04ff483e6cf65ed,1,5,6,11,1,2013-06-11 11:22:33,2013-06-11 11:22:33
c058aaf7dcc0f05ea3583f5ba04ff483e6cf65ed...0ee2668a4fd5604f4e308e60656ec3849b16288d,1,1,1,2,1,2013-06-11 11:27:27,2013-06-11 11:27:27
0ee2668a4fd5604f4e308e60656ec3849b16288d...ae90107caadea4421bbdb1a498f44f24a23da2f4,1,4,0,4,1,2013-06-11 12:10:45,2013-06-11 12:10:45
ae90107caadea4421bbdb1a498f44f24a23da2f4...62a9bb5af70f95bdf1f4d5d2daa22bc0d07b84d3,1,89,86,175,5,2013-06-11 12:39:19,2013-06-11 12:39:19
62a9bb5af70f95bdf1f4d5d2daa22bc0d07b84d3...4daf68b57f92bf697a375ebfa4bc2ebc2e3e0312,2,16,21,37,3,2013-06-11 12:50:25,2013-06-11 12:50:25
86ae72787c830e3d89c37f80254f64905d8daebe...71033c9efb9dc1e9cb28b01b2b5aa55a50d2c8d7,1,16,4,20,3,2013-05-22 06:50:09,2013-05-22 06:50:09
71033c9efb9dc1e9cb28b01b2b5aa55a50d2c8d7...432df031cff8c3003ae2a3063dd3a078a6902c91,1,1,1,2,1,2013-05-22 10:39:00,2013-05-22 10:39:00
432df031cff8c3003ae2a3063dd3a078a6902c91...44275e5066c36da3295f46971385db0e81ca1288,2,4,4,8,4,2013-05-22 11:06:08,2013-05-22 11:06:08
44275e5066c36da3295f46971385db0e81ca1288...adc51a9b9108a3cf8088393bdd1a68a37504dc09,1,2,1,3,1,2013-05-22 11:06:31,2013-05-22 11:06:31
978bc81646ff6e7823ef6de3c2717d4780cd8da7...64c37a21c86e326e711beb2c9fd91de8c6601031,1,1,1,2,1,2013-06-07 13:59:53,2013-05-28 22:13:42
64c37a21c86e326e711beb2c9fd91de8c6601031...1405d28cf780735c4c06f70c13e317600ef3875c,1,57,2,59,6,2013-06-07 14:00:40,2013-05-24 23:53:32
1405d28cf780735c4c06f70c13e317600ef3875c...96e8c6b7ed3f8caf63ca2ac52f844d414479801b,2,9,1,10,2,2013-06-07 14:18:11,2013-06-07 14:18:11
96e8c6b7ed3f8caf63ca2ac52f844d414479801b...3c2b085b2169be6f5880294bf95d27d4c899ae40,7,26,8,34,10,2013-06-07 14:31:12,2013-06-07 14:31:12
3c2b085b2169be6f5880294bf95d27d4c899ae40...475da57868fd69a07dd7d43adf195f3b5f3ac2bd,1,13,9,22,1,2013-06-07 14:33:43,2013-06-07 14:33:43
475da57868fd69a07dd7d43adf195f3b5f3ac2bd...6955c075977812b02361115dfbd9c5bd4ae1f064,4,29,18,47,10,2013-06-07 14:41:01,2013-06-07 14:41:01
6955c075977812b02361115dfbd9c5bd4ae1f064...ed7a11ae8fefbf424dfdef05198cfc644aa0ba24,1,0,1,1,1,2013-06-07 15:28:47,2013-06-07 15:28:47
ed7a11ae8fefbf424dfdef05198cfc644aa0ba24...d0357f3bbe9258bcb2ca9732e25f34fc9933af57,1,1,1,2,1,2013-06-07 15:33:16,2013-06-07 15:33:16
978bc81646ff6e7823ef6de3c2717d4780cd8da7...6daf4b9784f583e933188da1a6e35a25c36b60ac,1,1,1,2,1,2013-06-06 21:25:07,2013-06-06 21:25:07
0447c731ba392641145ac53cb8c50fab5392cda7...50e8d6c0c03b11cc539cca37aea782538ee77262,4,37,3,40,8,2013-06-03 16:49:04,2013-06-03 16:49:04
50e8d6c0c03b11cc539cca37aea782538ee77262...0611c5c6120503b57237c2580fddf318cd6a552a,1,16,14,30,2,2013-06-03 18:01:07,2013-06-03 18:01:07
0447c731ba392641145ac53cb8c50fab5392cda7...336750c916498e99505f593067d4eeadccb3c261,2,30,11,41,3,2013-06-03 15:39:46,2013-06-03 15:31:35
0447c731ba392641145ac53cb8c50fab5392cda7...a7de004481967a8f8cd6afae5024408df0a83c1c,1,5,1,6,1,2013-06-03 15:04:41,2013-06-03 15:04:41
159eee8dfde049b571172ee3594cf8c920b0fc10...5511a731bcc05034abacd4ec01ff7d5a2a3b89d3,2,6,1,7,2,2013-06-11 15:03:13,2013-06-11 15:03:13
5511a731bcc05034abacd4ec01ff7d5a2a3b89d3...993af5d0d2d596040195c4109c531c33deeac026,9,12,14,26,12,2013-06-11 15:15:18,2013-06-11 15:15:18
159eee8dfde049b571172ee3594cf8c920b0fc10...ad0f1276dbfffadb18fa28980fb4bca91dbc19b9,1,12,12,24,1,2013-06-11 14:36:54,2013-06-11 14:36:54
ced044ad249f794370ea111532a30f81a3c83408...9e0246684d14e5323cfb71291faff290e2762f48,3,24,18,42,5,2013-05-15 19:35:59,2013-05-15 19:35:59
d9027df5b55f2eb82f1a71e96412c5e802909090...dc13af90b12a2366f77a9b68a7b74d7b5f54bc1a,1,3,3,6,3,2013-01-28 11:54:07,2013-01-28 11:54:07
d9027df5b55f2eb82f1a71e96412c5e802909090...f6c482c06f48449e7dcff34455b5bbdfbd8f6c7b,12,117,31,148,15,2013-01-24 15:47:09,2013-01-24 15:47:09
5101ff7bec35704d844df8e608f604abd22df57a...46ad09bf70400eeebab5495ee6a5ded4da86012e,3,9,6,15,4,2014-02-11 13:34:47,2014-02-11 13:34:47
5101ff7bec35704d844df8e608f604abd22df57a...42083b19aee3ee2bc3688ff1a31006a4b5e31b38,1,0,1,1,1,2014-02-06 15:01:27,2014-02-06 15:01:27
970d86b7c5d0be871d8ab8d7cbd51997fd62e28a...fa7d75733cf8c861fd6ad479b0397877f5a08332,1,1,1,2,1,2013-10-04 10:38:49,2013-10-04 10:38:49
fa7d75733cf8c861fd6ad479b0397877f5a08332...a817993439733dd6cd45fed82ddb7f145b1602d9,1,0,2,2,1,2013-10-04 11:26:48,2013-10-04 11:26:48
970d86b7c5d0be871d8ab8d7cbd51997fd62e28a...a859723ef80d65ce03b647ffd808aabfca88765b,1,6,3,9,4,2013-10-02 13:02:54,2013-10-02 13:02:54
970d86b7c5d0be871d8ab8d7cbd51997fd62e28a...e58c81d643f87ad88d8328a167afdd6314b2afc1,1,3,5,8,3,2013-10-02 12:43:11,2013-10-02 12:43:11
970d86b7c5d0be871d8ab8d7cbd51997fd62e28a...58b46cbcf606882b5cd9ee581c3fd95871e0d766,1,4,4,8,4,2013-10-02 07:29:40,2013-10-02 07:29:40
58b46cbcf606882b5cd9ee581c3fd95871e0d766...45efba580173e7e2d8a1a8610ed3e2442723c4ca,1,2,2,4,2,2013-10-02 08:28:01,2013-10-02 08:28:01
970d86b7c5d0be871d8ab8d7cbd51997fd62e28a...485162ec608784dc1cbafe70b3ba3201b0f74098,2,1,2,3,2,2013-10-02 06:07:36,2013-10-02 06:05:32
485162ec608784dc1cbafe70b3ba3201b0f74098...a3731cf3623f181e25113ebbb2415d7dddb630b2,3,9,8,17,4,2013-10-02 06:07:36,2013-10-02 06:05:52
e8b9712d89f681049f8d537b8ef7f2a4295f102b...99916fe159b40475f885513f62b2a8069d622e97,1,12,6,18,3,2013-10-07 09:27:38,2013-10-07 09:27:38
1073019d360e5aae6fd02efb3e9920a1a3658869...9ed59ee9f00ec31564f4f1f069f1cdcc7d78281b,3,4,0,4,4,2013-10-14 10:03:25,2013-10-14 10:03:25
1073019d360e5aae6fd02efb3e9920a1a3658869...3888d94adcdf776b680d5bdf9873af92aa01e6c2,1,2,0,2,1,2013-10-14 07:24:38,2013-10-14 07:24:38
551fa4c9d017b42ca362055d8bddb817bb395a52...f7ef23e41210a43d75fe3255562792be3636f849,4,7,2,9,5,2013-10-09 12:25:31,2013-10-09 12:25:31
f7ef23e41210a43d75fe3255562792be3636f849...92768844cf894fda2d0eb50555a78b19d00f0ce8,1,2,2,4,2,2013-10-09 13:52:03,2013-10-09 13:52:03
551fa4c9d017b42ca362055d8bddb817bb395a52...c8e7d6df794fe845299fab07827aa35269e2c2bf,2,10,1,11,2,2013-10-09 11:41:41,2013-10-09 11:41:41
c8e7d6df794fe845299fab07827aa35269e2c2bf...4416be54a90f9c7ecbf40e5bd6ca9b5ff1d8d26a,1,38,0,38,1,2013-10-09 11:41:54,2013-10-09 11:41:54
4416be54a90f9c7ecbf40e5bd6ca9b5ff1d8d26a...51825e434e14cfd6dcd2f9021b3fcb0ce7bf92c7,1,12,0,12,1,2013-10-09 11:43:18,2013-10-09 11:43:18
3fb1042d777f6b53632dacb6f853d94f830d8b18...87ffd67617095b0602b44a649d4d123e765ccdfc,3,23,61,84,9,2013-10-09 09:30:49,2013-10-09 09:30:49
da34e008c3b67b4d06ecc8a06a102271157f3c13...1d11a7fdd2d75174125735a929bd73dd32957982,1,2,2,4,2,2014-02-05 16:31:15,2014-02-05 16:31:15
da34e008c3b67b4d06ecc8a06a102271157f3c13...208ec627c323b86824dd5443c507a69e531d20b3,1,1,1,2,1,2014-02-05 05:43:20,2014-02-05 05:43:20
ace9ff4a46d2cc97446fb984d86c3e468ff2e661...e649ea2fc5e765f11579ad9aa8e90e69764bd590,3,31,5,36,4,2013-10-14 14:47:46,2013-10-14 13:55:44
ace9ff4a46d2cc97446fb984d86c3e468ff2e661...eda5b3b1c52f6f68f516b6840ec35b230bb67e4a,1,1,1,2,1,2013-10-14 13:47:05,2013-10-14 13:47:05
ace9ff4a46d2cc97446fb984d86c3e468ff2e661...12800e544527c08e3423ecabe4dffd5bef90e9d5,4,16,12,28,7,2013-10-14 13:39:54,2013-10-14 13:39:54
12800e544527c08e3423ecabe4dffd5bef90e9d5...02693b72a4240a9d94246e590775a66eb48c55ed,4,24,1,25,8,2013-10-14 13:40:16,2013-10-14 13:40:16
9152ab79554b251c7e90ecd99ece67deff55ae92...f97ae2ff854fe74f2fa350ad2f179443fffa66b4,1,3,3,6,2,2013-01-10 20:55:34,2013-01-10 20:55:34
645afc384a12a06b7760fce1f0fdc822e9c6b164...40c11a366309818a7d0e5133c78b65faa1967dca,1,0,14,14,1,2012-12-14 21:06:02,2012-12-14 21:06:02
9b07ed06901a584d4928c46b622eac9fed81ab61...4b649c2f4da31a22aaf658a4a512565e318ab037,1,1,1,2,1,2012-12-20 21:12:38,2012-12-20 21:12:38
4b649c2f4da31a22aaf658a4a512565e318ab037...0efc903eef01d2f1081fc9cf5fa68893c01e959a,1,3,3,6,3,2012-12-20 21:25:42,2012-12-20 21:24:05
c43b289612b2420bc7e3c5faaf014b527ccace04...7a42decec7a58c4824a1b951368d19b4ba3336dd,1,3,3,6,2,2013-07-12 13:18:43,2013-07-12 13:18:43
7a42decec7a58c4824a1b951368d19b4ba3336dd...acb402a1c1cfb23613be0f988b60884c352de37c,7,56,2,58,8,2013-07-12 15:22:03,2013-07-12 15:22:03
90db28d6d0a031cad8dc58bc5936e381ce82a764...5949e302431167ecd61dec198e26f6587dbe0955,4,63,44,107,8,2013-03-26 09:38:42,2013-03-26 09:13:30
90db28d6d0a031cad8dc58bc5936e381ce82a764...ec1a37875d2be29835d0ac165db22a19ca269e38,1,6,0,6,1,2013-03-26 08:46:53,2013-03-23 14:56:29
ec1a37875d2be29835d0ac165db22a19ca269e38...77c802a4fe2ff598d6ce30bc6c042c5640d6922f,1,7,11,18,5,2013-03-26 08:46:53,2013-03-23 20:34:45
77c802a4fe2ff598d6ce30bc6c042c5640d6922f...7e93aaa6e69dc89aacc1b55618c22344928c1be7,1,2,2,4,2,2013-03-26 08:46:53,2013-03-23 20:38:51
7e93aaa6e69dc89aacc1b55618c22344928c1be7...83d3f7e052a93a90366127211e0c700582018584,1,11,13,24,3,2013-03-26 08:46:53,2013-03-24 10:02:39
83d3f7e052a93a90366127211e0c700582018584...f7e630c4528d0561466ede42d5e4820aa8b4d267,1,11,4,15,6,2013-03-26 08:46:53,2013-03-24 21:23:28
f7e630c4528d0561466ede42d5e4820aa8b4d267...448152ab944aa1c74d01d0717f10267a978c1c7c,3,13,17,30,9,2013-03-26 08:48:06,2013-03-26 07:47:40
448152ab944aa1c74d01d0717f10267a978c1c7c...cf6d4dc10c8d6488153c73a3586d2d3477d735fc,2,98,0,98,2,2013-03-26 08:48:06,2013-03-26 07:48:13
cf6d4dc10c8d6488153c73a3586d2d3477d735fc...4b3950456d666bc92fcf123532e73ae82c3c5e12,3,14,1,15,4,2013-03-26 08:48:07,2013-03-26 08:16:49
4b3950456d666bc92fcf123532e73ae82c3c5e12...bfebf108508fa011294c36ad59a4943173c309b2,1,10,2,12,2,2013-03-26 09:06:24,2013-03-26 09:06:24
bfebf108508fa011294c36ad59a4943173c309b2...e3e8b9fcb9299b6772c0936e8202137cc372fc53,1,2,2,4,2,2013-03-26 09:17:49,2013-03-26 09:17:49
e3e8b9fcb9299b6772c0936e8202137cc372fc53...c7bd99b04053421726012d77f85919b1d6fc0387,2,16,66,82,13,2013-03-26 12:41:57,2013-03-26 12:41:57
c7bd99b04053421726012d77f85919b1d6fc0387...da1cf5b9e70dc16113f441e17ad33c4e53bc1ca5,1,2,1,3,1,2013-03-26 13:16:06,2013-03-26 13:16:06
90db28d6d0a031cad8dc58bc5936e381ce82a764...242f6aa218da6385b08d28705eb42297d899c089,4,48,1,49,6,2013-03-26 08:28:26,2013-03-26 08:27:34
242f6aa218da6385b08d28705eb42297d899c089...5e6f45b07f0c5b35f3c5ae0b9a49e14b79460d8d,1,3,3,6,3,2013-03-26 17:04:00,2013-03-26 17:04:00
90db28d6d0a031cad8dc58bc5936e381ce82a764...33e236c63124e5c59dba5979d641ba174f4a1479,3,33,0,33,3,2013-03-26 05:47:11,2013-03-26 05:42:08
76a4cbe464a4472e82065c670d1190552db67cc6...65d9f8c16c35dd716955c420223aa22720628b6e,2,2,2,4,2,2013-04-01 18:16:52,2013-04-01 18:16:52
65d9f8c16c35dd716955c420223aa22720628b6e...0e9080e3dda595d91c563439e7d07f4ecf822403,1,1,1,2,1,2013-04-01 18:25:50,2013-04-01 18:25:50
0e9080e3dda595d91c563439e7d07f4ecf822403...19ab03f4612a2e622098bc199538380b011754c1,4,9,8,17,7,2013-04-01 18:37:39,2013-04-01 18:37:39
19ab03f4612a2e622098bc199538380b011754c1...8cadeb67502d9f674dc69c0b05341269c2baeb8f,13,216,203,419,25,2013-04-01 19:30:48,2013-04-01 19:30:48
8cadeb67502d9f674dc69c0b05341269c2baeb8f...8465238899ef2e7569df2c2a1780a4e331ed612c,1,5,2,7,3,2013-04-01 19:53:07,2013-04-01 19:53:07
6e96120337099315f65a572a70f239eedd6d98e0...73f9474b10bfb826c371d663cd9ae053e96f191c,2,2,1,3,2,2013-05-29 18:41:12,2013-05-29 18:41:12
73f9474b10bfb826c371d663cd9ae053e96f191c...6393757707d5686b79be789303cd7cdbbf09cb11,1,7,0,7,1,2013-05-29 20:26:24,2013-05-29 20:26:24
091c21e0e408a85ce833ff45bf3b6c0d155e434f...67a3dc4e742833cb6405cc29c25be558b5a7aa00,2,2,2,4,2,2013-05-29 07:41:17,2013-05-29 07:41:17
4daf68b57f92bf697a375ebfa4bc2ebc2e3e0312...e06e5633b38ba988135e5ee1ead33a9bbfadd361,1,1,5,6,1,2013-06-11 13:57:52,2013-06-11 13:57:52
adc51a9b9108a3cf8088393bdd1a68a37504dc09...db4453b626dd4fd428a169ceb092e9d653b59af1,1,1,1,2,1,2013-05-22 16:08:45,2013-05-22 16:08:45
adc51a9b9108a3cf8088393bdd1a68a37504dc09...576ad4453afbcf8a68e6740bf66d9c1365f9e44c,1,1,1,2,1,2013-05-22 13:12:30,2013-05-22 13:12:30
576ad4453afbcf8a68e6740bf66d9c1365f9e44c...3a22631dd347333036b4eec62e96be1196c1ee27,8,118,84,202,17,2013-05-22 13:58:44,2013-05-22 13:58:44
3a22631dd347333036b4eec62e96be1196c1ee27...8bc0a06cd4e389f8004f5c0be8caabef9c75cb38,2,9,1,10,3,2013-05-22 14:21:05,2013-05-22 14:21:05
8bc0a06cd4e389f8004f5c0be8caabef9c75cb38...54d0453234ec4d5a307db88fa0eecc1e0cca7177,2,21,1,22,7,2013-05-22 14:59:15,2013-05-22 14:59:15
54d0453234ec4d5a307db88fa0eecc1e0cca7177...83e2e624902e50072d96686023568e7575831a90,1,8,0,8,5,2013-05-22 14:59:43,2013-05-22 14:59:43
83e2e624902e50072d96686023568e7575831a90...ac952d047031dc6ee2dde8eac6f74e219378d03f,4,83,2,85,5,2013-05-22 14:59:59,2013-05-22 14:59:59
ac952d047031dc6ee2dde8eac6f74e219378d03f...6caa5a84069e2b45e647999bb37952c5ff4f7b73,1,4,4,8,3,2013-05-22 15:10:51,2013-05-22 15:10:51
d0357f3bbe9258bcb2ca9732e25f34fc9933af57...642f9f4a1cd66152846d0bc61fba2efd550edd33,4,20,20,40,6,2013-06-10 17:24:49,2013-06-10 17:24:49
642f9f4a1cd66152846d0bc61fba2efd550edd33...6637c1e475e1e5845edfb6817a9a8074036275b7,4,5,15,20,7,2013-06-12 07:59:00,2013-06-12 07:59:00
6637c1e475e1e5845edfb6817a9a8074036275b7...f7ea649f4b409d5561b2bd81e46863a1f0c77e1b,2,5,5,10,4,2013-06-14 12:13:14,2013-06-14 12:13:14
d0357f3bbe9258bcb2ca9732e25f34fc9933af57...08e52a5624f3534f3b7ad9f9c88ef2f35a8ff77a,2,29,19,48,2,2013-06-07 15:46:33,2013-06-07 15:46:33
08e52a5624f3534f3b7ad9f9c88ef2f35a8ff77a...590c84c7a4a5f838a94c13b39c749ab25dffa210,2,20,5,25,5,2013-06-08 13:26:57,2013-06-08 13:26:57
590c84c7a4a5f838a94c13b39c749ab25dffa210...4a1b093602ad36094f0f0ab2b8b0d48b2cb6f623,4,4,4,8,4,2013-06-08 14:10:25,2013-06-08 14:10:25
4a1b093602ad36094f0f0ab2b8b0d48b2cb6f623...05bc65895c083cf89e44e72c80918cda761cfaa1,1,1,1,2,1,2013-06-08 15:32:00,2013-06-08 15:32:00
0611c5c6120503b57237c2580fddf318cd6a552a...d24c1dd8344db9665603a1aab0a2e8a58f722647,1,1,0,1,1,2013-06-04 05:07:33,2013-06-04 05:07:33
336750c916498e99505f593067d4eeadccb3c261...15d54b29649652226dc62044680913640be6e407,8,20,23,43,5,2013-06-05 15:17:13,2013-06-03 16:34:07
964f7a1196c56a100242525eb3b8a4b69118d2ff...8bee0e1d3201865fc6ff297d326086c104f531bc,1,6,2,8,2,2013-06-12 08:00:05,2013-06-12 08:00:05
964f7a1196c56a100242525eb3b8a4b69118d2ff...31b06ebd011025ef44cbc384ad74736e75b62184,3,26,18,44,9,2013-06-12 02:38:02,2013-05-19 18:38:53
ed9b661c9d3151805e5b9ab678f588bdabd49b2d...68b601f6afeb435e9cfa1aa88f9db718f2d3596f,1,1,1,2,1,2013-06-17 17:00:50,2013-06-17 10:29:50
66ebf8d83f894ed361031eb9ede5a8b829fefd36...f9a48f72d485af69b5cad6062b48ac5cfb651b74,1,8,8,16,3,2013-01-28 12:52:30,2013-01-28 12:52:30
f6c482c06f48449e7dcff34455b5bbdfbd8f6c7b...ac8247b46df8eb8c475436fc276a3648379ae7a0,7,117,106,223,14,2013-01-25 08:07:21,2013-01-25 08:07:21
ac8247b46df8eb8c475436fc276a3648379ae7a0...3ce79e06580c0efb0abeba0263bdc3ea10670e2d,1,1,1,2,1,2013-01-25 08:10:12,2013-01-25 08:10:12
3ce79e06580c0efb0abeba0263bdc3ea10670e2d...097e6053efd973c70c4995784a1abc30e9384008,1,2,1,3,2,2013-01-25 08:16:20,2013-01-25 08:16:20
f6c482c06f48449e7dcff34455b5bbdfbd8f6c7b...8a86fe7bb0785ea69e591fd287430eb5448ac64e,14,249,29,278,19,2013-01-24 20:31:23,2013-01-19 17:06:50
8a86fe7bb0785ea69e591fd287430eb5448ac64e...82499a4cbfdd9605312322fea80b76f034230b1b,10,603,0,603,10,2013-01-24 20:31:23,2013-01-19 17:11:11
82499a4cbfdd9605312322fea80b76f034230b1b...695becc4cb017d76329efb55aae7ddb9a208895b,14,706,0,706,14,2013-01-24 20:31:23,2013-01-19 17:32:09
695becc4cb017d76329efb55aae7ddb9a208895b...7d3efec7d190948423d7e40a3f87e2d62b4ea808,1,17,0,17,2,2013-01-24 20:31:24,2013-01-19 17:32:55
7d3efec7d190948423d7e40a3f87e2d62b4ea808...911f6eb1067f27606c9f6f1f8e554fba0cf02d19,2,45,0,45,2,2013-01-24 20:31:24,2013-01-19 17:33:38
911f6eb1067f27606c9f6f1f8e554fba0cf02d19...360aa1b4075ba6ffa9927971c580db0059ab4842,1,93,0,93,1,2013-01-24 20:31:24,2013-01-19 17:43:07
360aa1b4075ba6ffa9927971c580db0059ab4842...ea6f46cb87c7ba8c0c620a8ff954f203b3276a7c,8,212,0,212,8,2013-01-24 20:31:24,2013-01-19 17:47:08
ea6f46cb87c7ba8c0c620a8ff954f203b3276a7c...a96cf3ad09c06fb5bfe668a77edc5d7adb2d092f,6,69,0,69,7,2013-01-24 20:31:24,2013-01-19 17:48:05
a96cf3ad09c06fb5bfe668a77edc5d7adb2d092f...3c6e144608b655ff1b43ec33baf020d19d460ba8,2,4,0,4,2,2013-01-24 20:31:24,2013-01-19 17:48:46
3c6e144608b655ff1b43ec33baf020d19d460ba8...b9a7bcb6a45c343f51aea49bccf38722e49c949c,1,10,0,10,1,2013-01-24 20:31:24,2013-01-19 17:49:15
b9a7bcb6a45c343f51aea49bccf38722e49c949c...c098ac64309b2eb75195324fec08f552c839cf32,1,1,0,1,1,2013-01-24 20:31:24,2013-01-19 17:50:03
c098ac64309b2eb75195324fec08f552c839cf32...b6458ae3b3afd872720e1abbd5e0a284752c2323,1,4,0,4,1,2013-01-24 20:31:24,2013-01-19 17:51:01
b6458ae3b3afd872720e1abbd5e0a284752c2323...3a0d4865f63fd078b54436864c201a7c41a9ddf9,1,1,1,2,1,2013-01-24 20:31:24,2013-01-19 17:51:42
3a0d4865f63fd078b54436864c201a7c41a9ddf9...17e9207dff39374ae33574b19123d1a1320fff4c,3,28,0,28,3,2013-01-24 20:31:24,2013-01-19 17:53:03
17e9207dff39374ae33574b19123d1a1320fff4c...a987f1469e2480559b675c251d49509f6200112f,1,26,0,26,1,2013-01-24 20:31:24,2013-01-19 17:55:59
a987f1469e2480559b675c251d49509f6200112f...c5f427b0a499136568bcf3cc738e5f1a8575e358,35,399,0,399,35,2013-01-24 20:31:24,2013-01-19 17:58:13
c5f427b0a499136568bcf3cc738e5f1a8575e358...6d1c566ec9f8506500f997c5ab33915e98826f3f,2,2,2,4,2,2013-01-24 20:31:24,2013-01-19 18:52:55
6d1c566ec9f8506500f997c5ab33915e98826f3f...845f146518783e7122d5ff9c593ffe3c6a59cecf,1,3,3,6,3,2013-01-24 20:31:24,2013-01-20 07:46:15
845f146518783e7122d5ff9c593ffe3c6a59cecf...2984716870a26b704a04e4ac4e72bfbc05750f73,1,1,6,7,4,2013-01-24 20:31:24,2013-01-20 08:08:46
2984716870a26b704a04e4ac4e72bfbc05750f73...9d318db48f4d76b8493aefa80e7b29c2ea3cc1cf,10,10,10,20,10,2013-01-24 20:31:24,2013-01-20 11:20:50
9d318db48f4d76b8493aefa80e7b29c2ea3cc1cf...9804b7df68a0ba4a1b144bc652351ad77a38fc3f,9,173,23,196,11,2013-01-24 20:31:24,2013-01-20 11:25:16
9804b7df68a0ba4a1b144bc652351ad77a38fc3f...cca993597013e1359d84230b0f69a2e02edb8e97,11,91,1,92,11,2013-01-24 20:31:24,2013-01-20 11:25:45
cca993597013e1359d84230b0f69a2e02edb8e97...b7470440ffbc9cb9f58f9de4b3064760670a20a4,8,121,0,121,8,2013-01-24 20:31:24,2013-01-20 21:03:29
b7470440ffbc9cb9f58f9de4b3064760670a20a4...a7667ffc14017732228058e34e1f724be08bf9a0,3,33,21,54,7,2013-01-24 20:31:24,2013-01-20 21:04:53
a7667ffc14017732228058e34e1f724be08bf9a0...17a8ee57fe7a2c2b7c18c59f88828be9d5a455a0,3,1,42,43,3,2013-01-24 20:31:25,2013-01-20 21:05:51
17a8ee57fe7a2c2b7c18c59f88828be9d5a455a0...13fb3fdcf20f505b2591cfe3fc1a1e74242a932c,2,11,1,12,4,2013-01-24 20:31:25,2013-01-20 21:06:11
13fb3fdcf20f505b2591cfe3fc1a1e74242a932c...b8dadd6427e50aa6d4f8f5dee113518340495550,5,1,61,62,5,2013-01-24 20:31:25,2013-01-20 21:07:17
b8dadd6427e50aa6d4f8f5dee113518340495550...497f7ab5ba11bcb9d663c86e74326d8116125e18,9,86,0,86,9,2013-01-24 20:31:25,2013-01-20 21:07:28
497f7ab5ba11bcb9d663c86e74326d8116125e18...1dd0feacc7ba885c53da74028ee081a5a08e05ca,11,107,53,160,14,2013-01-24 20:31:25,2013-01-21 19:55:55
1dd0feacc7ba885c53da74028ee081a5a08e05ca...4ce715a360b089f95bf8e2b37cf87ec237492fcc,2,3,3,6,3,2013-01-24 20:31:25,2013-01-22 17:14:00
4ce715a360b089f95bf8e2b37cf87ec237492fcc...ccf8fa4fa23c9d48350bd2ed53f4a86afcfd6655,1,2,0,2,1,2013-01-24 20:31:25,2013-01-22 17:15:05
ccf8fa4fa23c9d48350bd2ed53f4a86afcfd6655...f6f414ce3b8c252779e78cfd1a6470dc03e2e374,8,45,40,85,31,2013-01-24 20:31:25,2013-01-22 17:20:39
f6f414ce3b8c252779e78cfd1a6470dc03e2e374...f87b76a805e8ac2d6a77747be171714e2289281a,4,22,6,28,9,2013-01-24 20:31:25,2013-01-22 17:21:07
f87b76a805e8ac2d6a77747be171714e2289281a...dcea52203ddc93c1d073e7615d98725cc3584d2f,4,34,33,67,27,2013-01-24 20:31:25,2013-01-22 17:29:19
dcea52203ddc93c1d073e7615d98725cc3584d2f...7534154b44f920005e6732bbcc9e9af391b81546,3,11,1,12,4,2013-01-24 20:31:25,2013-01-22 20:58:44
7534154b44f920005e6732bbcc9e9af391b81546...7658f8c151b22680cf594d028e180a8a859fc9b8,1,24,20,44,10,2013-01-24 20:31:25,2013-01-22 21:03:52
7658f8c151b22680cf594d028e180a8a859fc9b8...18bd1c9d30e16783d750c7786cbcc7d350f4d0aa,35,330,281,611,116,2013-01-24 20:31:25,2013-01-22 22:20:27
18bd1c9d30e16783d750c7786cbcc7d350f4d0aa...31d84d71d3659dc815875f39f466cdcf81d97aaf,12,129,3,132,15,2013-01-24 20:31:48,2013-01-23 14:14:20
31d84d71d3659dc815875f39f466cdcf81d97aaf...d721863382b3e2cedae03e8f235809eb409224c0,3,5,3,8,5,2013-01-24 20:31:48,2013-01-23 14:14:53
d721863382b3e2cedae03e8f235809eb409224c0...a5ce8696a6aa5a3a588fc618d8c959ce6c687310,48,0,518,518,48,2013-01-24 20:31:48,2013-01-23 16:42:38
a5ce8696a6aa5a3a588fc618d8c959ce6c687310...eb99feb4a7e01c4e83203ec014c082205b77ad02,4,19,19,38,16,2013-01-24 20:31:48,2013-01-23 16:43:23
eb99feb4a7e01c4e83203ec014c082205b77ad02...690db9693fcee3beedc467b48fd9e4bd42ee936d,10,47,47,94,29,2013-01-24 20:31:48,2013-01-23 19:39:47
690db9693fcee3beedc467b48fd9e4bd42ee936d...9a604eb6798a2cc26df09ef9470273093acdb853,1,0,2,2,1,2013-01-24 20:31:48,2013-01-23 20:06:48
9a604eb6798a2cc26df09ef9470273093acdb853...b695db4af4c9fe0dc27f78e549a6a785bf936731,1,0,1,1,1,2013-01-24 20:31:49,2013-01-23 21:40:45
b695db4af4c9fe0dc27f78e549a6a785bf936731...2befa8fe30bd5f3512e67d671e25df6f128389f0,1,2,2,4,2,2013-01-24 20:31:49,2013-01-23 23:00:56
2befa8fe30bd5f3512e67d671e25df6f128389f0...1a917bc954f7e2b0c7233288c73476f572cad8d6,1,1,1,2,1,2013-01-24 20:31:49,2013-01-23 23:18:07
1a917bc954f7e2b0c7233288c73476f572cad8d6...645f9604752ae258ab3f125c8fa98adf3b81c127,7,11,10,21,11,2013-01-24 20:31:49,2013-01-24 08:16:03
645f9604752ae258ab3f125c8fa98adf3b81c127...ca105d0462090b1650019890feeeef3fdd356209,1,1,1,2,1,2013-01-24 20:31:49,2013-01-24 08:39:16
ca105d0462090b1650019890feeeef3fdd356209...ca752e64fbf1cd03ff3eff1ada80a1cfbcd9b2b4,8,6,13,19,8,2013-01-24 20:31:49,2013-01-24 09:19:09
ca752e64fbf1cd03ff3eff1ada80a1cfbcd9b2b4...b5dd9e6775e2da52a9efb07bbeedd7cd56230c1d,3,15,14,29,5,2013-01-24 20:31:49,2013-01-24 09:43:09
b5dd9e6775e2da52a9efb07bbeedd7cd56230c1d...11b7b93cf7a0329ce9c012ef866c975acc42d9b4,2,18,19,37,5,2013-01-24 20:31:49,2013-01-24 11:39:00
11b7b93cf7a0329ce9c012ef866c975acc42d9b4...b4967b3703e1d520dd520f4bb7196ba3ecc302e9,1,1,2,3,2,2013-01-24 20:31:49,2013-01-24 12:10:17
b4967b3703e1d520dd520f4bb7196ba3ecc302e9...7403afea9748316b78242ecb250f619fe1a15b36,1,12,6,18,2,2013-01-24 20:31:49,2013-01-24 12:15:14
7403afea9748316b78242ecb250f619fe1a15b36...6d713e84e185f60b00c38e792d11df27ed110605,1,1,7,8,1,2013-01-24 20:31:49,2013-01-24 18:18:43
6d713e84e185f60b00c38e792d11df27ed110605...e52fec9cd9812e6fd8a7700c2188dbbf6e022c81,1,1,1,2,1,2013-01-24 20:31:49,2013-01-24 18:19:18
e52fec9cd9812e6fd8a7700c2188dbbf6e022c81...d839f6c52571e3b873a05779b1131f7b00670b31,3,3,4,7,3,2013-01-24 20:31:49,2013-01-24 18:31:28
1739b7fcbbf3fcd8b86c31460510ed85a53b11c5...4b9c28bccded2064fc95cf891b87a375d5bcdcf7,1,1,3,4,3,2014-02-11 15:42:27,2014-02-11 15:42:27
45efba580173e7e2d8a1a8610ed3e2442723c4ca...45de7d263d8494d0aaaf99d7a6c44f7f9d2adf09,2,4,0,4,2,2013-10-02 13:18:28,2013-10-02 13:18:28
2c0c9e26e82a99d11ddbacd4dc161de42fa78162...97cf31c4cb36c4d7f259f768f04a8e995da1d278,2,14,1,15,2,2013-10-14 13:15:14,2013-10-14 12:27:27
2c0c9e26e82a99d11ddbacd4dc161de42fa78162...55327823c455f5acb2beeb7e5b1e4b5daf4cbd74,3,4,4,8,4,2013-10-14 10:27:32,2013-10-14 10:27:32
55327823c455f5acb2beeb7e5b1e4b5daf4cbd74...3cbfb1ee7c28c0171bc4c584ce3c852b07f8521a,1,9,0,9,1,2013-10-14 10:27:39,2013-10-14 10:27:39
7af1bc3b88e3a32cb07d7aee7962af22c2339c02...461abaa843b5c21a5103fde802db770dd583ac92,2,25,0,25,2,2013-10-09 15:17:52,2013-10-09 15:14:55
461abaa843b5c21a5103fde802db770dd583ac92...cb6a86ed622bae50dad97cb67b9b7212806bb3c8,1,3,1,4,1,2013-10-10 14:07:39,2013-10-09 15:17:04
7af1bc3b88e3a32cb07d7aee7962af22c2339c02...2128419c5b42905a20e2d459fa11c8e4680ed58f,1,9,1,10,1,2013-10-09 13:51:39,2013-10-09 13:44:25
2128419c5b42905a20e2d459fa11c8e4680ed58f...7991b0449920b0c90bd7c529bbb2e5b1699a87ef,1,6,2,8,3,2013-10-09 13:51:39,2013-10-09 13:46:00
7991b0449920b0c90bd7c529bbb2e5b1699a87ef...97f124b31d95ae0adba00b2b906d602f73ae5ffd,1,1,1,2,1,2013-10-09 13:51:39,2013-10-09 13:48:28
97f124b31d95ae0adba00b2b906d602f73ae5ffd...85123076141beea0e79495b240d86c3bbdd92fd8,1,1,3,4,1,2013-10-09 14:49:01,2013-10-09 14:49:01
7af1bc3b88e3a32cb07d7aee7962af22c2339c02...c41e66db520c43fdcfc0e1e49208a23bb02835a7,2,72,1,73,5,2013-10-09 13:43:11,2013-10-09 13:17:40
c41e66db520c43fdcfc0e1e49208a23bb02835a7...4c8224ae1e9a89e9df5c32beb7afad2f0835fc2b,2,13,4,17,6,2013-10-09 13:43:17,2013-10-09 13:37:18
4c8224ae1e9a89e9df5c32beb7afad2f0835fc2b...ffec158de4c6a78dfa17ae0063d8f796c21a58c8,6,81,176,257,11,2013-10-09 13:43:24,2013-10-09 13:37:37
ffec158de4c6a78dfa17ae0063d8f796c21a58c8...e50c0d5cb7bcdc1131dae8cd5d5de2947732cda8,4,17,9,26,11,2013-10-09 14:01:04,2013-10-09 14:01:04
e50c0d5cb7bcdc1131dae8cd5d5de2947732cda8...dd68e37db36de31da256be0f9167469b9918a909,3,5,5,10,5,2013-10-09 16:03:09,2013-10-09 16:03:09
10aa84bd7428fb28fe1dc7923c10f355cbe7fbc7...665a2f6000a3a864473edc51a193739ff8186db1,2,6,11,17,7,2014-02-05 08:26:46,2014-02-05 08:26:46
0b0ba8be7f09b1664a6875be7d5736ebf7f62977...3b8b396ccd30a65789c423c211de986cb757456d,1,2,2,4,2,2014-02-11 14:05:36,2014-02-11 14:05:36
0b0ba8be7f09b1664a6875be7d5736ebf7f62977...348e44ef06c3ebc89ada47c64d7bec5bf56dfd54,2,4,1,5,3,2014-02-11 13:49:39,2014-02-11 13:49:39
d1a054c513e27ac960a9cf7e147e9a22b48b17df...2fbe4fad138c0b68c9e98b32ae398a6b93ea535b,1,1,1,2,1,2013-10-15 04:58:05,2013-10-15 04:58:05
32dadb46fa6ee08486d54d712bd06421ede93b0d...97a4e1b86ace4b338bba345ea54166503fe0048d,1,2,3,5,1,2013-01-11 16:23:35,2013-01-10 19:21:54
97a4e1b86ace4b338bba345ea54166503fe0048d...f0c4e94d7406cb30c77b1f3dd20f541a9398588a,1,13,13,26,2,2013-01-11 17:59:06,2013-01-11 17:58:13
32dadb46fa6ee08486d54d712bd06421ede93b0d...c913f40ca45c4ba66fb98ad2587f12244bc3a33a,1,1,1,2,1,2013-01-11 12:40:29,2013-01-11 12:40:29
acb402a1c1cfb23613be0f988b60884c352de37c...ace5c54ab91cdb9142a27d4543ee839684d29d5d,4,39,3,42,9,2013-07-12 16:10:42,2013-07-12 15:58:17
acb402a1c1cfb23613be0f988b60884c352de37c...3232f547ac250096f0f4baefff1bc245be1455ac,2,11,2,13,3,2013-07-12 15:29:39,2013-07-12 15:29:39
3232f547ac250096f0f4baefff1bc245be1455ac...dc038a7108f3e61e708310b5a9ab4b193723366b,10,14,14,28,12,2013-07-12 16:01:39,2013-07-12 16:01:39
dc038a7108f3e61e708310b5a9ab4b193723366b...dbf4e5b0b04a40f9e22cb37e12ba2873df717af7,2,2,2,4,2,2013-07-12 16:15:49,2013-07-12 16:15:49
dbf4e5b0b04a40f9e22cb37e12ba2873df717af7...7406494abc786a2d6aefe4097bf785bd1a20dc5d,1,1,1,2,1,2013-07-12 18:23:56,2013-07-12 18:23:56
7406494abc786a2d6aefe4097bf785bd1a20dc5d...3b660be6ee79d75ab3e287411a0cdb01bf63c722,4,10,14,24,7,2013-07-12 18:49:03,2013-07-12 18:49:03
3b660be6ee79d75ab3e287411a0cdb01bf63c722...8b1d44f789cce12219dbc70890d8a72675b71315,2,5,1,6,2,2013-07-12 18:56:03,2013-07-12 18:56:03
58a1ed6dd3090cdcacf01e86a01128e055218c77...38ffb8220c8d8ae030b762f7b2d244eabe8cc0bf,4,33,18,51,7,2013-03-26 15:16:06,2013-03-26 15:16:06
38ffb8220c8d8ae030b762f7b2d244eabe8cc0bf...f93c4dc0d83dd40452d40447a62cd68a08e24b09,2,19,14,33,6,2013-03-26 15:23:28,2013-03-26 15:23:28
f93c4dc0d83dd40452d40447a62cd68a08e24b09...6abf58466fc47a7efd86a03c5b0b3878edfbce36,3,34,34,68,5,2013-03-26 15:51:06,2013-03-26 15:51:06
6abf58466fc47a7efd86a03c5b0b3878edfbce36...ce0945efcd36cc89d1b633500e4bdecf373fc304,9,26,45,71,17,2013-03-26 16:11:38,2013-03-26 16:11:38
ce0945efcd36cc89d1b633500e4bdecf373fc304...3728c4904e61e47d23b6454754451bd716f4f422,7,19,164,183,17,2013-03-26 17:00:54,2013-03-26 17:00:54
3728c4904e61e47d23b6454754451bd716f4f422...e3f116424877864424250971f824b5a2552aec9a,1,1,0,1,1,2013-03-26 17:27:39,2013-03-26 17:27:39
58a1ed6dd3090cdcacf01e86a01128e055218c77...b8502cbaeeb843f579221664289f3ff93be3df67,2,21,2,23,2,2013-03-26 14:19:55,2013-03-26 14:19:55
58a1ed6dd3090cdcacf01e86a01128e055218c77...7ed0dc0185e93a0af9bf67888c5b24a49baf48a3,1,3,3,6,2,2013-03-26 14:14:57,2013-03-26 14:14:57
8465238899ef2e7569df2c2a1780a4e331ed612c...c4ec1c7d969f69871fbe2b21cada8ba881551e2a,2,3,3,6,3,2013-04-03 07:00:01,2013-04-03 07:00:01
8465238899ef2e7569df2c2a1780a4e331ed612c...d3559e2556e70947787d841bc6ee98110059f2b3,1,3,3,6,3,2013-04-02 08:23:06,2013-04-02 08:23:06
d3559e2556e70947787d841bc6ee98110059f2b3...af657b0509476db56e88014062ccf0a7a6b9d8b7,1,6,0,6,1,2013-04-02 08:32:41,2013-04-02 08:32:41
af657b0509476db56e88014062ccf0a7a6b9d8b7...b641cdd183cc40fe25ee67ece41e883146a6207f,1,1,1,2,1,2013-04-02 11:30:32,2013-04-02 11:30:32
8465238899ef2e7569df2c2a1780a4e331ed612c...08c6f5f604e88a47a8dde8e2052883285c4e6c1c,1,24,0,24,1,2013-04-02 05:52:47,2013-04-02 05:52:47
6393757707d5686b79be789303cd7cdbbf09cb11...9c82bca5ee274d700ec3166d4521d4c6d2ff896c,3,10,5,15,3,2013-05-30 13:58:36,2013-05-29 19:19:23
9c82bca5ee274d700ec3166d4521d4c6d2ff896c...5f4fea17ad42d24f069d19d36853b7ea61ee66c8,1,14,9,23,1,2013-06-03 15:00:24,2013-06-03 15:00:24
6393757707d5686b79be789303cd7cdbbf09cb11...8f50eb746781290b20d3247900228caabac1269e,1,6,0,6,2,2013-05-29 21:03:54,2013-05-29 21:03:54
003f18c2a686f52781b6b39cb8e7e86de406a5a6...04cc6dd67a6117e97c328396dedbf69f40d7e330,1,32,28,60,3,2013-05-29 10:16:30,2013-05-29 10:16:30
c5de01f824ff640e1aebdf8b5058434766948a94...e444c7f6babe956ef22a775b8ec197d58765b6a0,2,18,1,19,3,2013-05-22 23:55:48,2013-05-22 23:55:48
c5de01f824ff640e1aebdf8b5058434766948a94...2c947647be5e4876b725112235eb70c415d76161,1,3,2,5,3,2013-05-22 18:51:08,2013-05-22 18:51:08
2c947647be5e4876b725112235eb70c415d76161...719f72315f6242a71d8b1fb3eeffc233034a9643,1,5,1,6,1,2013-05-23 17:52:38,2013-05-23 17:52:38
6c765d30b9c686ad5e535bde4cb2574215d0a484...a4ff01258229d9ed888786356270280c5e172406,1,9,0,9,1,2013-05-23 06:54:48,2013-05-23 06:37:24
a4ff01258229d9ed888786356270280c5e172406...a2456832d2210f53602c03eaa3ab1efa6207a4d1,1,9,9,18,5,2013-05-23 06:59:54,2013-05-23 06:59:54
a2456832d2210f53602c03eaa3ab1efa6207a4d1...f58dc8e6c95ef9d566402395d12c46bb97759cf2,2,4,4,8,4,2013-05-23 07:05:07,2013-05-23 07:05:07
f58dc8e6c95ef9d566402395d12c46bb97759cf2...76f3898fbf13bb4a4b7cf910c393177ae19bd25e,1,4,4,8,3,2013-05-23 08:44:24,2013-05-23 08:44:24
76f3898fbf13bb4a4b7cf910c393177ae19bd25e...5f7f35e8fe9b921f599aba29406947720959f4fa,1,4,0,4,1,2013-05-23 08:47:57,2013-05-23 08:47:57
5f7f35e8fe9b921f599aba29406947720959f4fa...bbaa0fccfab36c6a58265e944f390bcd73b0f974,3,14,24,38,13,2013-05-23 08:54:44,2013-05-23 08:54:44
bbaa0fccfab36c6a58265e944f390bcd73b0f974...068cf2f467ee76d5a371694b41b3247d04377cb9,5,268,235,503,8,2013-05-23 09:23:47,2013-05-23 09:23:47
068cf2f467ee76d5a371694b41b3247d04377cb9...25236efe6e44a5fa65526657b05817b14b09d661,1,1,0,1,1,2013-05-23 09:26:06,2013-05-23 09:26:06
579c0b979190274ca51f50fea1cdfce31c3ec77a...c1b05e7b8638e562ded689ae9a3ae1990fb1d5a7,18,19,19,38,20,2013-06-26 12:53:03,2013-06-06 16:02:58
c1b05e7b8638e562ded689ae9a3ae1990fb1d5a7...d1da45e1a369c924e26a75e821e9ba8b482e29ef,1,1,2,3,2,2013-06-26 15:08:55,2013-06-26 14:00:21
b1bdd82992b5133e24154c8692e25e79049cd907...2e839cee93bcbf3904f0aeb50206f555c340d672,9,68,49,117,15,2013-06-17 08:57:37,2013-06-17 08:57:37
b1bdd82992b5133e24154c8692e25e79049cd907...ddc57ece6bac4acb904035c1927f8b74f1d632ac,1,12,3,15,4,2013-06-17 08:38:27,2013-06-17 08:38:27
05bc65895c083cf89e44e72c80918cda761cfaa1...e898994508335cdda751cb1e9463a0b59a3b90e9,1,3,0,3,1,2013-06-09 17:09:14,2013-06-09 16:36:08
05bc65895c083cf89e44e72c80918cda761cfaa1...37ff9d88ec0a9717900e05c26156f11f0e5ba5a5,2,4,2,6,4,2013-06-09 14:28:55,2013-06-09 13:00:42
37ff9d88ec0a9717900e05c26156f11f0e5ba5a5...c830bab79a86d2397d1bd66c911e549377e396b4,2,4,2,6,4,2013-06-09 21:47:55,2013-06-09 21:47:55
2c69ced3343d865bab613c6f76e5c6066b4f29b3...2e87b2b606f333ae4a84df7661cb3e7f300f0209,1,1,1,2,1,2013-06-04 13:35:08,2013-06-04 13:35:08
2e87b2b606f333ae4a84df7661cb3e7f300f0209...d926df0cef7034ebb43e6b9026e6af837a0a2f17,1,3,0,3,1,2013-06-04 13:39:59,2013-06-04 13:39:59
d926df0cef7034ebb43e6b9026e6af837a0a2f17...f375adcb96797450767f7b67842df043c44541c7,1,1,0,1,1,2013-06-04 14:01:41,2013-06-04 14:01:41
f375adcb96797450767f7b67842df043c44541c7...211e435ade337c968fab11c52427c172adcec99a,1,4,0,4,1,2013-06-04 15:20:50,2013-06-04 15:20:50
5d0929458cc502fd4f4981103d6d3a88ebb8e377...8f52501eb579923a86f94efac8286f8897faec93,2,4,5,9,4,2013-06-12 13:43:58,2013-06-12 13:43:58
68b601f6afeb435e9cfa1aa88f9db718f2d3596f...cc5440e82a396fe4967a0b31322d9bb67ee70057,4,19,24,43,6,2013-06-18 14:43:49,2013-06-18 14:43:49
68b601f6afeb435e9cfa1aa88f9db718f2d3596f...d3cd2b75983f4d4bdcc3cb15cafb94c7d41cd29b,1,3,3,6,3,2013-06-18 08:59:08,2013-06-18 08:59:08
944b2450b1eb08f3d7fcbfce2cf2ac5ef5544808...299a9a10400e7fdcc641a90db95290322058c529,3,30,6,36,5,2013-01-28 19:02:10,2013-01-28 19:02:10
299a9a10400e7fdcc641a90db95290322058c529...1c931fb81477397929a31a6b95c5d65b6d582182,2,3,9,12,5,2013-01-28 21:03:38,2013-01-28 21:03:38
1c931fb81477397929a31a6b95c5d65b6d582182...f72dc7f7798f521d20a71fb465df57f0d66befb5,1,7,1,8,1,2013-01-29 09:00:56,2013-01-29 09:00:56
f72dc7f7798f521d20a71fb465df57f0d66befb5...7121a58eb9e4dcb63d762e17a668f3bb4b0eaa85,2,14,3,17,3,2013-01-29 09:32:05,2013-01-29 09:32:05
7121a58eb9e4dcb63d762e17a668f3bb4b0eaa85...c84675ee06dfc72c46c178ef40e30f03053dcc5a,2,21,1,22,4,2013-01-29 10:12:24,2013-01-29 10:12:24
aa1f1eb680e4328c2cf619a770f1e90f74c41987...585a53c4158e098c7c916cca6b252efbe06a6334,2,14,1,15,3,2013-01-25 09:08:22,2013-01-25 09:08:22
585a53c4158e098c7c916cca6b252efbe06a6334...00e4a479d3732a528745513e4150fe28fee178e2,4,32,10,42,7,2013-01-25 09:30:49,2013-01-25 09:30:49
00e4a479d3732a528745513e4150fe28fee178e2...20a4742efdc9ed96da4ba3cbf6f513aff75c7ab1,5,9,24,33,12,2013-01-25 09:36:15,2013-01-25 09:36:15
20a4742efdc9ed96da4ba3cbf6f513aff75c7ab1...2812e6f1f5a15a5f56ee61001e4a46cd922e827b,1,4,1,5,1,2013-01-25 11:47:54,2013-01-25 11:47:54
2812e6f1f5a15a5f56ee61001e4a46cd922e827b...5aca1d64e0b8ca2c58c961eb9e04e5d8629ed8ab,1,1,1,2,1,2013-01-25 11:56:04,2013-01-25 11:56:04
5aca1d64e0b8ca2c58c961eb9e04e5d8629ed8ab...8016a7bd33d6d488a2d180af1d4ac12ef3421e00,1,1,1,2,1,2013-01-25 12:18:23,2013-01-25 12:18:23
8016a7bd33d6d488a2d180af1d4ac12ef3421e00...70e05801b196a460ec2b1d6f6f096f44d32b7928,1,1,1,2,1,2013-01-25 13:36:10,2013-01-25 13:36:10
70e05801b196a460ec2b1d6f6f096f44d32b7928...3ddd9f753c0a6a57313ea4860bf7167f98f53cd2,3,9,8,17,4,2013-01-25 13:42:41,2013-01-25 13:42:41
3ddd9f753c0a6a57313ea4860bf7167f98f53cd2...6350b32a3dddf70a28526c4f95c652072411e9c7,4,16,7,23,7,2013-01-25 13:51:45,2013-01-25 13:51:45
6350b32a3dddf70a28526c4f95c652072411e9c7...6743ecec597000315007b51bc3e45ea9c58cbaa7,3,15,7,22,5,2013-01-25 14:18:37,2013-01-25 14:18:37
6743ecec597000315007b51bc3e45ea9c58cbaa7...1c88fbb3915e6d2efcac5cc2edb8d480f1112c75,1,14,1,15,2,2013-01-25 14:25:43,2013-01-25 14:25:43
1c88fbb3915e6d2efcac5cc2edb8d480f1112c75...74e329064abc1306132dd73dcb2e25221379f568,19,39,126,165,26,2013-01-25 14:36:14,2013-01-25 14:36:14
74e329064abc1306132dd73dcb2e25221379f568...5f3df89c64f9b93ce9b8f6a791c6d6d51fd18624,1,3,5,8,2,2013-01-25 15:18:27,2013-01-25 15:18:27
5f3df89c64f9b93ce9b8f6a791c6d6d51fd18624...639b0a8715074a166eb9ef4252e4f2b5ae5e2c84,1,1,3,4,1,2013-01-25 15:26:00,2013-01-25 15:26:00
1935b494f6716d8410eaf8da59eb11c7f920b80c...573c89e624806750d6ad948f62d3ead9bdf6d121,3,40,22,62,4,2013-10-10 07:30:07,2013-10-10 07:30:07
573c89e624806750d6ad948f62d3ead9bdf6d121...bd83991ac7d4f720f81e140ed9a85902d58a5496,3,4,13,17,4,2013-10-10 07:53:49,2013-10-10 07:53:49
bd83991ac7d4f720f81e140ed9a85902d58a5496...d1ffbdfcb63bbd50573cfda4c59217bb60e76c7e,2,10,1,11,2,2013-10-10 08:05:49,2013-10-10 08:05:49
f1402213db619da498a0ca8959d9aa030ec1d997...883409b941b591a482a4d883a4925d87c00b18a6,1,2,0,2,2,2014-02-05 17:19:46,2014-02-05 17:19:46
d701d5869516142a4073804622503299202cfbe2...41b55d75f54e55b6a840bda04e7bae5d0f8dedb8,2,7,12,19,4,2014-02-05 14:47:24,2014-02-05 14:47:24
d701d5869516142a4073804622503299202cfbe2...68249f23dacbddf61ca296a7decf98ecf6fc16fb,3,15,1,16,3,2014-02-05 13:54:51,2014-02-05 13:54:51
68249f23dacbddf61ca296a7decf98ecf6fc16fb...8f88cbf06bce7e88b9a4470645665b65ca543946,3,10,10,20,5,2014-02-05 14:09:13,2014-02-05 14:09:13
8f88cbf06bce7e88b9a4470645665b65ca543946...a1a01254b903d76e0151b48fa4316add9a6930da,2,12,3,15,3,2014-02-05 14:21:41,2014-02-05 14:21:41
d701d5869516142a4073804622503299202cfbe2...55572c4e86c6b4cb12c8984b54de57fc02972ad1,4,13,6,19,4,2014-02-05 09:39:55,2014-02-05 09:39:55
c0ec30aead795822d786cadeae496bb7ffb4b6ea...f99ee99f6530cfab85c67d01832eb76ba5f85fa3,1,2,2,4,2,2014-02-06 07:51:39,2014-02-06 07:51:39
8f237526f39a4a4cab312651b1bf30a077bd0552...db7d15497082656bb60e43821529d07c38111a1b,1,2,0,2,2,2013-10-15 06:25:14,2013-10-15 06:25:14
2fbe4fad138c0b68c9e98b32ae398a6b93ea535b...42fbc911322db2a5fa8a9550ffceecd4da29f572,1,1,1,2,1,2013-10-18 03:10:42,2013-10-18 03:10:42
42fbc911322db2a5fa8a9550ffceecd4da29f572...20ea670e67be8086fc4f11b587b91ddbc6cf4ee4,7,8,8,16,8,2013-10-18 04:28:49,2013-10-18 04:28:49
20ea670e67be8086fc4f11b587b91ddbc6cf4ee4...873bd3ad2d7e9f1961bd365f1a33b60930cc7233,2,2,2,4,2,2013-10-18 04:29:39,2013-10-18 04:29:39
e54246d3102d7e8cd7f4d03251ee47ced36e3eeb...5aada8cc2adef82780e23b859aeabb71f7d1f5ca,2,5,3,8,2,2013-01-11 19:03:43,2013-01-11 19:03:43
5aada8cc2adef82780e23b859aeabb71f7d1f5ca...167f26b90d5b4d4b0306a6f0721444c4132141d8,2,10,8,18,8,2013-01-11 19:04:14,2013-01-11 19:04:14
167f26b90d5b4d4b0306a6f0721444c4132141d8...b3bfb75252b9feaaab7fa5969b9c9bb4b34d864e,1,6,8,14,2,2013-01-11 19:16:37,2013-01-11 19:16:37
b3bfb75252b9feaaab7fa5969b9c9bb4b34d864e...b55ed840e63088e28127f9989fc69d49345a0083,3,23,18,41,11,2013-01-11 19:20:11,2013-01-11 19:20:11
b55ed840e63088e28127f9989fc69d49345a0083...fd836f5490dbc05b84895f4d3736bfa572f80911,4,22,5,27,6,2013-01-11 20:04:21,2013-01-11 20:04:21
fd836f5490dbc05b84895f4d3736bfa572f80911...a213d4b9e80fed7a8ad38185d2a93e6def295e50,2,22,14,36,2,2013-01-12 00:24:51,2013-01-12 00:24:51
a213d4b9e80fed7a8ad38185d2a93e6def295e50...4d0af232da7df8c4a33b9f2e44933f1f3d2527bc,1,8,9,17,9,2013-01-12 00:24:57,2013-01-11 21:25:18
4d0af232da7df8c4a33b9f2e44933f1f3d2527bc...eb626edd3fe2602321080e231cf748afc86d4700,2,17,9,26,8,2013-01-12 00:25:01,2013-01-11 23:44:40
eb626edd3fe2602321080e231cf748afc86d4700...4c6224aad173a26f1fbe20588b4b155f031d779f,10,89,15,104,14,2013-01-13 15:25:18,2013-01-10 18:17:57
4c6224aad173a26f1fbe20588b4b155f031d779f...122acb2254c94823bd7b7b64aa1bd953df5fdf66,5,16,13,29,8,2013-01-13 15:25:18,2013-01-12 19:54:52
122acb2254c94823bd7b7b64aa1bd953df5fdf66...68bfcd0521020d9f0154ffe767aa1e327e93ca24,10,73,34,107,14,2013-01-13 15:25:18,2013-01-13 15:24:29
68bfcd0521020d9f0154ffe767aa1e327e93ca24...8543313bf5396afe3bdf5851a84c688eacc8156f,3,25,1,26,4,2013-01-14 07:37:29,2013-01-14 07:37:29
8543313bf5396afe3bdf5851a84c688eacc8156f...f716c0a1dd175527e688709cbbd71c121a43586e,2,5,1,6,2,2013-01-14 07:44:27,2013-01-14 07:44:27
f716c0a1dd175527e688709cbbd71c121a43586e...23e338852c6030e199608517315c5d4fad6b27d8,6,21,32,53,8,2013-01-14 08:09:01,2013-01-14 08:09:01
23e338852c6030e199608517315c5d4fad6b27d8...eff6d3c12b8f1cd0d3f8f9bab8ceaeba31f915b2,1,21,0,21,1,2013-01-14 11:39:09,2013-01-14 11:39:09
8b1d44f789cce12219dbc70890d8a72675b71315...36fd4de8251cb265244320e67d3d5a3420712a85,87,96,110,206,100,2013-07-13 05:45:48,2013-07-13 05:45:48
36fd4de8251cb265244320e67d3d5a3420712a85...bea14d6c28b225980b64e7fd9d92ef50756cfd36,10,3,37,40,11,2013-07-13 06:05:28,2013-07-13 06:05:28
bea14d6c28b225980b64e7fd9d92ef50756cfd36...399d0bdde79774b4cc7e6a9dd480a8b7cb690bed,8,14,33,47,14,2013-07-13 06:47:06,2013-07-13 06:47:06
399d0bdde79774b4cc7e6a9dd480a8b7cb690bed...3805797cae702e46a83b5da9b6411f1899c3d1a0,19,71,71,142,50,2013-07-13 06:52:47,2013-07-13 06:52:47
3805797cae702e46a83b5da9b6411f1899c3d1a0...a10f917ae835a7192cf20f72f3a603cfa296fed3,3,3,3,6,3,2013-07-13 06:55:46,2013-07-13 06:55:46
a10f917ae835a7192cf20f72f3a603cfa296fed3...e12ee379cfe08429886b662025a6258bdfa493c7,1,4,0,4,1,2013-07-13 06:57:54,2013-07-13 06:57:54
e12ee379cfe08429886b662025a6258bdfa493c7...d33767004594d8fcfe8d7bdb7f373132524b3d6e,5,28,14,42,8,2013-07-13 07:13:36,2013-07-13 07:13:36
d33767004594d8fcfe8d7bdb7f373132524b3d6e...46277c39482559451f8e6e032ae1d50f902ca340,2,6,7,13,7,2013-07-13 16:39:49,2013-07-13 16:39:49
46277c39482559451f8e6e032ae1d50f902ca340...e97abfce3b9e4e836aaf9d9ac32a45c6490f8831,7,12,10,22,9,2013-07-13 17:00:46,2013-07-13 17:00:46
e97abfce3b9e4e836aaf9d9ac32a45c6490f8831...a41875d21e9c87f15754c1d23db3a6fb80b7bdcd,33,52,58,110,54,2013-07-13 17:36:21,2013-07-13 17:36:21
a41875d21e9c87f15754c1d23db3a6fb80b7bdcd...d8fc0c3bb9c9f8b802e62c572caa23bc91238219,5,7,11,18,8,2013-07-13 17:53:46,2013-07-13 17:53:46
8b1d44f789cce12219dbc70890d8a72675b71315...de5c8601eb8df5e4a20b9fbb8a095ca87f3427be,1,1,1,2,1,2013-07-13 01:37:05,2013-07-13 01:37:05
a31fe1a63f03c674338f95bf91e53198c2b526f5...5f14a6bcf8ca5ec4325bae401069c3a03a617bd0,4,4,0,4,4,2013-03-27 16:26:37,2013-03-27 16:26:37
5f14a6bcf8ca5ec4325bae401069c3a03a617bd0...d55ade16861d0700e302f50945560e8570eddcd7,10,119,7,126,12,2013-03-27 17:04:29,2013-03-27 17:04:29
d55ade16861d0700e302f50945560e8570eddcd7...ba59912072efb1e648e94d4c2cc2c2d0625f74db,8,80,19,99,17,2013-03-27 18:07:52,2013-03-27 18:07:52
ba59912072efb1e648e94d4c2cc2c2d0625f74db...0a044c7318ada48999bcf61cc95ab65b0d1435ca,1,43,19,62,11,2013-03-27 18:28:00,2013-03-27 18:28:00
0a044c7318ada48999bcf61cc95ab65b0d1435ca...f230fe3ddab86130af57671b325ff83984d62117,1,1,1,2,1,2013-03-27 19:42:01,2013-03-27 19:42:01
a31fe1a63f03c674338f95bf91e53198c2b526f5...3392f6c1f0d7810e25a12cefd3a6676ebb227d0e,1,3,1,4,2,2013-03-27 09:15:12,2013-03-27 09:15:12
3392f6c1f0d7810e25a12cefd3a6676ebb227d0e...d8eefdccfc58fdbc4918941a21d699e644c7443a,3,55,82,137,42,2013-03-30 10:35:35,2013-03-30 10:35:35
482cd2001df09707afb5a03690eb20490145fa92...ac07a6c6003170e013562714e9f9bc0a58bed874,1,2,2,4,2,2013-04-03 14:11:36,2013-04-03 14:11:06
ac07a6c6003170e013562714e9f9bc0a58bed874...67b78fa74fee1d8d86f18e48c91db51479daa960,1,3,0,3,1,2013-04-03 14:21:19,2013-04-03 14:21:19
67b78fa74fee1d8d86f18e48c91db51479daa960...f64717f13112af305ec4ad154decb3f1260aff7c,1,13,7,20,3,2013-04-03 14:33:07,2013-04-03 14:33:07
f64717f13112af305ec4ad154decb3f1260aff7c...d61a21d2d77808977fc7d1ea96a5f123719b8b7d,1,3,0,3,1,2013-04-03 14:37:34,2013-04-03 14:37:34
d61a21d2d77808977fc7d1ea96a5f123719b8b7d...9f4fde04f5b74199c9bd72621e03c544aaf6f2ef,2,16,11,27,3,2013-04-03 15:36:37,2013-04-03 15:36:37
9f4fde04f5b74199c9bd72621e03c544aaf6f2ef...3011ac4150e355da9e5956cb223d19e18425e0eb,9,119,176,295,19,2013-04-03 18:05:10,2013-04-03 18:05:10
3011ac4150e355da9e5956cb223d19e18425e0eb...e91ff84df72a76b91bb8c24a6e677cdca98120de,4,0,19,19,3,2013-04-03 18:09:07,2013-04-03 18:09:07
e91ff84df72a76b91bb8c24a6e677cdca98120de...f8a4a760480a2395ca371c4ab6201344a186fa39,2,21,4,25,6,2013-04-03 18:17:50,2013-04-03 18:17:50
f8a4a760480a2395ca371c4ab6201344a186fa39...c3bbbff673bf0c877ed19991e5588e7063701ed7,1,16,0,16,1,2013-04-03 18:21:24,2013-04-03 18:21:24
c3bbbff673bf0c877ed19991e5588e7063701ed7...890b9f3a2dd90d68009943d9067ee7f76b4590f4,1,3,11,14,7,2013-04-03 19:04:26,2013-04-03 19:04:26
890b9f3a2dd90d68009943d9067ee7f76b4590f4...3fba2114260531977b5fecfc17941f5b851005ee,1,3,3,6,2,2013-04-03 19:14:07,2013-04-03 19:14:07
7af16bbb0fdce36cf8b7e43e5cd64a712dfdaa1d...c52e013f965c4c754577446f5b4a5b39556b78b4,1,1,1,2,1,2013-04-03 07:03:31,2013-04-03 07:03:31
7af16bbb0fdce36cf8b7e43e5cd64a712dfdaa1d...41bbbb6df0300579867c4654d8662b38fa9f0a58,7,43,104,147,28,2013-04-03 02:20:52,2013-04-02 22:28:12
41bbbb6df0300579867c4654d8662b38fa9f0a58...734d6fcdf00846364fa39fc374753b7ea2cef603,5,32,7,39,11,2013-04-03 02:21:04,2013-04-03 02:05:00
734d6fcdf00846364fa39fc374753b7ea2cef603...85e039049cba5ac1bf92e6cbba2ea1236d6892f7,2,8,8,16,4,2013-04-03 03:06:18,2013-04-03 03:06:18
7af16bbb0fdce36cf8b7e43e5cd64a712dfdaa1d...5f4445c3d384741c45242f077b3c0dbf76234ee8,8,113,66,179,22,2013-04-02 18:30:36,2013-04-02 18:30:36
5f4445c3d384741c45242f077b3c0dbf76234ee8...0c5795a49726402d2f2751d8b05d5bbb9dd23511,2,12,19,31,9,2013-04-02 18:46:19,2013-04-02 18:46:19
0c5795a49726402d2f2751d8b05d5bbb9dd23511...03f41e2820d76d272aa7357cf726b5d131bb80e0,9,65,26,91,19,2013-04-02 19:37:20,2013-04-02 19:37:20
03f41e2820d76d272aa7357cf726b5d131bb80e0...88abe66c27504bcda71fd0ddbeb22d0115b8c09f,1,4,0,4,1,2013-04-02 19:39:37,2013-04-02 19:39:37
88abe66c27504bcda71fd0ddbeb22d0115b8c09f...94390fc7b42e92d4e1d38c8392a2e310a256c4ca,15,99,34,133,14,2013-04-03 06:26:38,2013-04-03 06:26:38
94390fc7b42e92d4e1d38c8392a2e310a256c4ca...7e8bf92bd77f5a63802c87bfbb6282a17a43c691,2,4,6,10,3,2013-04-03 06:32:17,2013-04-03 06:32:17
7e8bf92bd77f5a63802c87bfbb6282a17a43c691...413a310faa17f626f351fa3afd6423e8782935a9,8,15,10,25,8,2013-04-03 07:06:31,2013-04-03 07:06:31
413a310faa17f626f351fa3afd6423e8782935a9...dfeef6c22849c04ffd225a0356fd11fb8e4907f6,5,67,31,98,13,2013-04-03 12:55:08,2013-04-03 12:55:08
d0779d61d34334d56b2e5131faca8758ee928a74...45ecbb0358e9f397372b7360fe822139bae9ad8f,1,1,1,2,1,2013-06-26 20:11:41,2013-06-23 18:39:46
2e839cee93bcbf3904f0aeb50206f555c340d672...26994b5d309740d8728dcad73132ce268cd5933c,1,0,4,4,1,2013-06-17 11:52:54,2013-06-17 11:52:54
7ae72e65116433d9e8655f735263d7fdb974c8e1...2000f013f76a8356dca556156dfbe2cf84c7e730,1,1,1,2,1,2013-06-29 13:37:41,2013-06-25 18:32:28
7ae72e65116433d9e8655f735263d7fdb974c8e1...2a601d26f280f84beb0e109f84f346643f5734d6,2,454,123,577,2,2013-06-29 05:44:24,2013-06-27 21:58:43
8f52501eb579923a86f94efac8286f8897faec93...70e80d95a78460e307145730e8f6e554fe91a03e,1,1,1,2,1,2013-06-12 19:30:13,2013-06-12 19:30:13
70e80d95a78460e307145730e8f6e554fe91a03e...f01d482427dd586c9b7b36887941e8af6bb42391,3,53,22,75,20,2013-06-12 19:30:36,2013-06-12 19:30:36
f01d482427dd586c9b7b36887941e8af6bb42391...8ccad7c3c7f93b4b4b217ad8bd356083632e8a05,2,6,12,18,8,2013-06-16 20:06:33,2013-06-16 20:06:33
8f52501eb579923a86f94efac8286f8897faec93...995e656addd588377fbf8ae6f9e04dee37ebc604,4,13,9,22,6,2013-06-12 19:11:35,2013-06-12 19:11:35
cc5440e82a396fe4967a0b31322d9bb67ee70057...81697850eb16d66615fb072e7c288b3b3dc70758,7,85,37,122,25,2013-06-18 14:47:52,2013-06-17 10:07:16
81697850eb16d66615fb072e7c288b3b3dc70758...95965d3f5417b62ec61fcdd3d7f21fe1f6260993,6,87,45,132,31,2013-06-18 14:47:52,2013-06-17 10:26:58
95965d3f5417b62ec61fcdd3d7f21fe1f6260993...fa877b63126c84cb304228cf37b61d186d5e4477,5,63,45,108,25,2013-06-18 14:47:52,2013-06-17 10:41:35
fa877b63126c84cb304228cf37b61d186d5e4477...e940fbc7c1b322c15f5d5ae878fbd3117e9b98f9,10,55,27,82,24,2013-06-18 14:47:52,2013-06-17 11:17:32
e940fbc7c1b322c15f5d5ae878fbd3117e9b98f9...209f96bebeaf012ba941f2f8b1e659dd2334b5a1,7,22,23,45,8,2013-06-18 14:47:52,2013-06-17 11:55:41
209f96bebeaf012ba941f2f8b1e659dd2334b5a1...c9fb7e39eb601d1b959ea89363bb877f7679b2bc,1,12,3,15,4,2013-06-18 14:47:52,2013-06-17 12:38:19
c9fb7e39eb601d1b959ea89363bb877f7679b2bc...e12c9ee2bc76026b146ea1b29fd0acc5ac696d34,12,76,75,151,21,2013-06-18 14:47:52,2013-06-17 13:51:43
e12c9ee2bc76026b146ea1b29fd0acc5ac696d34...fcc1ba5bf2df46d58a4270a6b6695e0ae51b1fbc,2,4,4,8,4,2013-06-18 14:47:52,2013-06-17 14:00:24
fcc1ba5bf2df46d58a4270a6b6695e0ae51b1fbc...b4fe5a76a75577c45be70459ec8f4e7612d0139b,2,3,3,6,3,2013-06-18 14:47:52,2013-06-17 14:03:56
b4fe5a76a75577c45be70459ec8f4e7612d0139b...5bed576ac2c6ea9aa4eac634c605473a12e96b3a,3,22,22,44,5,2013-06-18 14:47:52,2013-06-17 14:55:43
5bed576ac2c6ea9aa4eac634c605473a12e96b3a...7d57b96ee0f668acf10067b06a614b3052e27f89,2,12,5,17,5,2013-06-18 14:47:52,2013-06-17 16:59:41
7d57b96ee0f668acf10067b06a614b3052e27f89...ed9cff9a3c0a230f5497e85e8e178699ed02683e,7,44,63,107,16,2013-06-18 14:47:52,2013-06-17 18:00:59
ed9cff9a3c0a230f5497e85e8e178699ed02683e...32ef2f37f6a3eee713638bdf4da8c5ee2c570169,2,14,18,32,4,2013-06-18 14:47:52,2013-06-18 13:56:31
32ef2f37f6a3eee713638bdf4da8c5ee2c570169...a0b6c964c5f3b69aa98411a2fc7815f6c3a37854,5,10,8,18,6,2013-06-18 14:47:52,2013-06-18 14:09:04
a0b6c964c5f3b69aa98411a2fc7815f6c3a37854...48019f1a0fa884c1a8439848fe0dd1d6bc8588cc,3,22,23,45,12,2013-06-18 14:47:52,2013-06-18 14:32:33
48019f1a0fa884c1a8439848fe0dd1d6bc8588cc...4e5b3d9aaebd420fc95152540a664a17ec3019e7,3,20,6,26,10,2013-06-18 15:39:18,2013-06-18 15:39:18
4e5b3d9aaebd420fc95152540a664a17ec3019e7...60bb35161741338e585feedf09538f5935bba271,1,1,1,2,1,2013-06-18 15:58:33,2013-06-18 15:58:33
729c74320a932ae4ec2a9557404673e67afa265c...ab36cdec84ce73a28e28612f67f50ed6397f0cb1,1,5,1,6,2,2013-06-29 14:19:10,2013-06-29 14:19:10
c84675ee06dfc72c46c178ef40e30f03053dcc5a...525a8cd3e96b7bae0acda8b6e94df529fa06ff6a,9,43,22,65,17,2013-01-30 00:12:03,2013-01-29 08:25:17
525a8cd3e96b7bae0acda8b6e94df529fa06ff6a...ad33c398008d9a2ec4a900c1d54f678a47de2cdd,2,2,2,4,2,2013-01-31 04:22:08,2013-01-31 04:22:08
c84675ee06dfc72c46c178ef40e30f03053dcc5a...9fdbdc662a01ac0845638c1012aa0625de6158be,1,1,1,2,1,2013-01-29 12:49:10,2013-01-29 12:49:10
639b0a8715074a166eb9ef4252e4f2b5ae5e2c84...561a0e3a4a53030ef465c1ce729aba2e5def9964,1,3,3,6,2,2013-01-25 16:05:17,2013-01-25 15:52:11
639b0a8715074a166eb9ef4252e4f2b5ae5e2c84...8a65229b3548a421ca6e7c41a819b40d50f7e162,5,16,3,19,5,2013-01-25 15:42:57,2013-01-24 20:15:24
39aeac71b34648d8c691ff36f577bdacbd3e362f...f10153818b51da7ee4e691cea308dd8964d908c9,3,56,1,57,3,2014-02-11 18:24:23,2014-02-11 18:15:13
d1ffbdfcb63bbd50573cfda4c59217bb60e76c7e...e8d1e827d8fe68d61a7be180bcc411c0d4e7982c,1,1,1,2,1,2013-10-10 09:14:21,2013-10-10 09:14:21
d1ffbdfcb63bbd50573cfda4c59217bb60e76c7e...b0502c20a96cb16fa1892bf3fe92604e965f9af5,3,4,4,8,4,2013-10-10 08:43:24,2013-10-10 08:43:24
883409b941b591a482a4d883a4925d87c00b18a6...fcc906e6aa1749046b691bbd60b2020fc970bdfb,4,159,6,165,7,2014-02-06 02:44:14,2014-02-04 02:35:48
883409b941b591a482a4d883a4925d87c00b18a6...268c183b29aa14cd479a960a6af711efa16a00ed,23,44,38,82,22,2014-02-05 18:30:57,2014-02-05 18:30:57
268c183b29aa14cd479a960a6af711efa16a00ed...fc953eb16201ad85c85ee0f48cb5862e63c1762a,3,4,4,8,3,2014-02-05 19:30:13,2014-02-05 19:30:13
883409b941b591a482a4d883a4925d87c00b18a6...01a097d77a529615791cf1f4cb4153c45735e4f5,1,1,1,2,1,2014-02-05 17:49:16,2014-02-05 17:49:16
f99ee99f6530cfab85c67d01832eb76ba5f85fa3...90ab30b74be3b0235db165722272c19248eda2da,2,4,3,7,4,2014-02-06 14:03:32,2014-02-06 14:03:32
f99ee99f6530cfab85c67d01832eb76ba5f85fa3...eb272227c30ab9ed428910ce13b153290dc38c85,2,10,6,16,7,2014-02-06 08:16:26,2014-02-06 08:16:26
eb272227c30ab9ed428910ce13b153290dc38c85...0a3d50eb32faef18a3bb8bc7626303cdcc50ac3b,2,5,3,8,3,2014-02-06 14:17:33,2014-02-06 14:17:33
c61512d4e18a873df229ba2fddb28dfddc423009...d39948a8d000edaf84a74ea2a9a58b6e230e0041,6,18,19,37,10,2014-02-11 19:03:43,2014-02-11 19:03:43
1284f21c073e42c44b9faa7b0ad1ec90b66ca8fb...61748c993de8a38300c0c038cec5a07e6c324cd6,27,323,127,450,84,2014-02-11 15:23:33,2014-02-04 07:48:33
1284f21c073e42c44b9faa7b0ad1ec90b66ca8fb...91571c078dee6297a17afecb6dc071ce882c82be,19,229,71,300,38,2014-02-11 14:45:30,2014-01-27 14:53:59
db7d15497082656bb60e43821529d07c38111a1b...4886d8fd03087ceb07c96c3067120b0c1815354d,1,29,0,29,1,2013-10-15 11:24:17,2013-10-15 11:24:17
4886d8fd03087ceb07c96c3067120b0c1815354d...a271570ea9e0e53cf5574a1060d97a55145b583e,1,6,1,7,3,2013-10-15 13:28:53,2013-10-15 13:28:53
db7d15497082656bb60e43821529d07c38111a1b...6fff92e984c8977bb1b8d5424e8b81796e2ccb07,4,25,3,28,7,2013-10-15 06:56:04,2013-10-09 12:26:30
6fff92e984c8977bb1b8d5424e8b81796e2ccb07...2e8b0fa5cf9e70c55bd1dbb254db3f9aa45b23e9,3,6,0,6,3,2013-10-15 06:59:58,2013-10-15 06:59:58
2e8b0fa5cf9e70c55bd1dbb254db3f9aa45b23e9...01186f9fc6f5f5645ea5406ce571f83db0dc080a,3,9,1,10,3,2013-10-15 08:19:19,2013-10-15 08:19:19
01186f9fc6f5f5645ea5406ce571f83db0dc080a...f4d68f398f2ed176df97a9870f5d634bd5c06e0c,1,8,2,10,1,2013-10-15 08:29:22,2013-10-15 08:29:22
5717304098ae81285a5a616fb066e9ae7ea88f54...3bef6b46f83f82be7ceea0d3bee7e35507554e09,1,2,2,4,2,2013-10-22 08:27:23,2013-10-22 08:22:45
5717304098ae81285a5a616fb066e9ae7ea88f54...ebe49e6ac6a04ebfc9583abb327dfe1df4ecb968,1,4,0,4,1,2013-10-21 22:29:36,2013-10-21 22:29:36
5717304098ae81285a5a616fb066e9ae7ea88f54...6173d0a92f4b8e472d5d71e3518ae5460257d39e,5,29,0,29,5,2013-10-21 18:54:37,2013-10-15 12:59:48
5717304098ae81285a5a616fb066e9ae7ea88f54...5014ecf6e40e810de17066efab0803e43a9c834d,1,1,1,2,1,2013-10-21 18:54:18,2013-10-21 18:54:18
5717304098ae81285a5a616fb066e9ae7ea88f54...193c8ab1a41c7c4e0e7985ac4aec5a6da15c1578,1,2,0,2,2,2013-10-21 18:45:56,2013-10-21 18:45:56
eff6d3c12b8f1cd0d3f8f9bab8ceaeba31f915b2...80b8921a9a0adb60c7eb8edeaf195d9dc2530cb9,1,48,20,68,10,2013-01-14 14:46:55,2013-01-14 14:46:55
eff6d3c12b8f1cd0d3f8f9bab8ceaeba31f915b2...471b5910a64d5cbfe268caf210c1745cf3e8fefd,3,11,4,15,7,2013-01-14 11:44:27,2013-01-08 15:17:53
394841364cd37deef99592fd83928413557b89ea...c49dcbacc3455ccfa149375a2f792b5f3c5223ec,5,6,6,12,6,2013-07-15 06:30:33,2013-07-15 06:30:33
c49dcbacc3455ccfa149375a2f792b5f3c5223ec...2a0739010467030e8ea74d30b6188aa06444fa8c,4,29,22,51,9,2013-07-15 07:01:15,2013-07-15 07:01:15
394841364cd37deef99592fd83928413557b89ea...bd9cd3fbbfa4c0314ad511a33b6d42853170e86b,1,1,1,2,1,2013-07-14 17:54:23,2013-07-14 17:54:23
f230fe3ddab86130af57671b325ff83984d62117...9e24929f162249ad2b2bfb8905be416d7148b40d,1,1,1,2,1,2013-03-27 19:55:10,2013-03-27 19:55:10
f230fe3ddab86130af57671b325ff83984d62117...ed7a2136dd311829196db8631d28720ca756dc19,1,4,4,8,4,2013-03-27 19:51:40,2013-03-27 19:51:40
ed7a2136dd311829196db8631d28720ca756dc19...2b2d43ed2a91b9a82608d26a6ece70929009b5ed,2,38,36,74,22,2013-03-27 20:21:32,2013-03-27 20:21:32
2b2d43ed2a91b9a82608d26a6ece70929009b5ed...11d52a15533cf0cbaa4a3a61186f8942d90ce374,1,2,2,4,2,2013-03-27 20:33:59,2013-03-27 20:33:59
52b0ceb87aa3a730b23de0aeac6a01710535c647...e29c9b79329511ebfc335c87039118bd3fdcadb6,2,2,2,4,2,2013-03-30 14:35:19,2013-03-30 11:23:58
e29c9b79329511ebfc335c87039118bd3fdcadb6...e998257dcf3a0e4a46305a8c6019e74fcce2887f,2,3,3,6,2,2013-03-30 14:35:19,2013-03-30 14:33:26
3fba2114260531977b5fecfc17941f5b851005ee...5f56619bed215a0066df9ff2bf2e5936cdac9270,1,9,7,16,7,2013-04-03 19:43:12,2013-04-03 19:43:12
3fba2114260531977b5fecfc17941f5b851005ee...6d07a97462eed7a61316871b47f1e214e8553c7a,2,14,7,21,2,2013-04-03 19:33:34,2013-04-03 19:33:34
6d07a97462eed7a61316871b47f1e214e8553c7a...d9ab7ba6ebf21ac5736fc0b0d982789b0c09ee3e,1,1,1,2,1,2013-04-03 19:37:07,2013-04-03 19:37:07
d9ab7ba6ebf21ac5736fc0b0d982789b0c09ee3e...278d2abaafa97a709fdcf5a34ed1df858d9ca51d,3,20,7,27,6,2013-04-03 20:32:36,2013-04-03 20:32:36
278d2abaafa97a709fdcf5a34ed1df858d9ca51d...b011bb0de8d25767582af58d6b89f586a6fbe083,1,1,1,2,1,2013-04-03 20:33:42,2013-04-03 20:33:42
b011bb0de8d25767582af58d6b89f586a6fbe083...8d92523ed3683a6fe8066005d26b4777c0b31c6f,2,2,2,4,2,2013-04-04 05:57:07,2013-04-04 05:57:07
3fba2114260531977b5fecfc17941f5b851005ee...af5ef203e8b6082455bd6fca141c2f6b11f6b9b5,2,2,2,4,2,2013-04-03 19:28:19,2013-04-03 19:28:19
4bbe2b74a85793c06679851706633cbee87ff8ca...921151d0414512df79f0724e0a52af6ab96108d1,1,1,1,2,1,2013-04-03 13:31:28,2013-04-03 13:31:28
921151d0414512df79f0724e0a52af6ab96108d1...727d229e28012b3469760c69e028192b617b7e15,2,10,8,18,7,2013-04-03 13:49:32,2013-04-03 13:49:32
727d229e28012b3469760c69e028192b617b7e15...b1117dacbbdc7459e4ca495471ae9a24ebf69f7d,1,1,1,2,1,2013-04-03 14:06:28,2013-04-03 14:06:28
b460f1e4275ef00f176e6fe0f397c93f4a2c76c9...f121806ad0d71ace008e43bd96835a8ee1f20418,1,1,1,2,1,2013-04-04 06:32:29,2013-04-04 06:32:29
f121806ad0d71ace008e43bd96835a8ee1f20418...64fb2c595aec7a18c7487062971210b59c0a9628,1,1,1,2,1,2013-04-04 06:50:18,2013-04-04 06:50:18
64fb2c595aec7a18c7487062971210b59c0a9628...568ce1edd7df2eaf511878ccc3b202fcad7931a3,2,2,3,5,2,2013-04-04 06:58:12,2013-04-04 06:58:12
568ce1edd7df2eaf511878ccc3b202fcad7931a3...98b7717df7e455b745c47582dcd5718f2ab904a2,8,10,32,42,9,2013-04-04 07:53:39,2013-04-04 07:53:39
98b7717df7e455b745c47582dcd5718f2ab904a2...08fac411f211478e119c12dfeba7f66ad5d4040c,1,3,3,6,2,2013-04-04 07:55:43,2013-04-04 07:55:43
0f2798d498c69372137d13a8ba3ec8e87b7f0a8a...ae2233b1149392d63c6fa4ede8a58b7d82d7790c,2,35,39,74,20,2013-04-09 17:53:27,2013-04-09 17:53:27
ae2233b1149392d63c6fa4ede8a58b7d82d7790c...4496a747c669611e35d758c994ed7ee9a235985a,1,7,1,8,1,2013-04-09 17:58:47,2013-04-09 17:58:47
d899fcdd2da157c72e4efc427a5d2f1e91a5b491...148eade9d71ee9957633c4a5371857fdb0def605,3,7,6,13,6,2013-06-19 16:57:32,2013-06-19 16:57:32
148eade9d71ee9957633c4a5371857fdb0def605...48d372725a9f40efaa239531e93866bba04f796d,1,80,0,80,1,2013-06-20 06:52:47,2013-06-20 06:51:09
995e656addd588377fbf8ae6f9e04dee37ebc604...2c3ddacbd7171b62e4ba143faaceb013aa79305f,1,1,1,2,1,2013-06-13 06:58:03,2013-06-13 06:58:03
2c3ddacbd7171b62e4ba143faaceb013aa79305f...96c06d7f5f413918989c4a4673b604875f09b9cd,2,5,5,10,4,2013-06-13 07:07:06,2013-06-13 07:07:06
995e656addd588377fbf8ae6f9e04dee37ebc604...3668cdf5bb4d923d5c7c7768d8d1bb092e69e179,1,1,1,2,1,2013-06-13 03:44:25,2013-06-13 03:44:25
995e656addd588377fbf8ae6f9e04dee37ebc604...0023a27ec051d589d1782c23c617a45473be767b,2,5,0,5,3,2013-06-12 23:20:58,2013-05-02 13:22:19
30d2d2381f608b7c926747d61a9231aa417ea5da...670aaaeb9db7902c8776cb7754ac8fd1e7a606a1,1,1,1,2,1,2013-06-18 18:05:43,2013-06-18 18:05:43
b8ce54470338d651fbd11fde7e661c9c185bbba7...2b4bebd9f25a1b378af3bd60accdd9268fc7fe49,1,3,0,3,1,2013-06-29 14:31:08,2013-06-29 14:31:08
2b4bebd9f25a1b378af3bd60accdd9268fc7fe49...c7da44d6d1e442351818d6b8c1079788ca13456b,1,1,1,2,1,2013-06-30 08:20:57,2013-06-30 08:20:57
9fdbdc662a01ac0845638c1012aa0625de6158be...033aa1a885801c299a20ab39af6f897bb53dc3d4,75,139,150,289,117,2013-01-29 20:18:19,2013-01-29 20:18:19
033aa1a885801c299a20ab39af6f897bb53dc3d4...fb617c61b95aef4615346a5e554db469384d9b6c,49,90,90,180,81,2013-01-29 20:29:21,2013-01-29 20:29:21
fb617c61b95aef4615346a5e554db469384d9b6c...7ba4f2dcfaa85fb89e15d9caa21bf75ad976389f,4,12,5,17,6,2013-01-29 20:57:15,2013-01-29 20:57:15
9fdbdc662a01ac0845638c1012aa0625de6158be...cdd55431735ab359f12bb9b6e203c0face879272,1,1,1,2,1,2013-01-29 17:58:34,2013-01-29 17:58:34
9fdbdc662a01ac0845638c1012aa0625de6158be...2a669fc89997376af1e76bf3ed574d948009c5b2,1,4,0,4,1,2013-01-29 17:20:59,2013-01-29 17:20:59
2a669fc89997376af1e76bf3ed574d948009c5b2...c72910a8bf782c10662dd4392e81ef6408f801ee,2,11,1,12,2,2013-02-01 10:23:23,2013-02-01 09:42:02
c72910a8bf782c10662dd4392e81ef6408f801ee...ce6436b98a8a86356ee93e6eaf136d27d7f77b93,2,16,1,17,2,2013-02-01 13:53:35,2013-02-01 13:53:35
ce6436b98a8a86356ee93e6eaf136d27d7f77b93...566de5ab06d1c29ac632d2fbd0f4440788fe1339,1,5,2,7,2,2013-02-01 14:20:51,2013-02-01 14:20:51
566de5ab06d1c29ac632d2fbd0f4440788fe1339...413952ff944d10164d9d08a8a48e7725fe44b1b3,2,44,0,44,4,2013-02-06 15:57:00,2013-02-05 16:13:47
413952ff944d10164d9d08a8a48e7725fe44b1b3...3f4e215c804f13def585dea995efa29b2af266ec,1,19,14,33,3,2013-02-06 16:02:30,2013-02-05 17:36:36
3f4e215c804f13def585dea995efa29b2af266ec...f978a71f41d5546be2c0c6b33052979c06912bd1,2,8,0,8,2,2013-02-06 16:02:30,2013-02-05 17:37:44
f978a71f41d5546be2c0c6b33052979c06912bd1...41e93bbfe23b3791d1b440dd3961d4fadfbb8461,1,5,0,5,1,2013-02-06 16:05:55,2013-02-06 13:59:47
41e93bbfe23b3791d1b440dd3961d4fadfbb8461...5be0265fe7e82a127e9fd2805e81e4e40f5e3c5f,1,16,0,16,3,2013-02-06 16:10:29,2013-02-06 14:03:05
5be0265fe7e82a127e9fd2805e81e4e40f5e3c5f...b9d40d2524a78013737be16b4cd0976ded843a1b,1,24,0,24,3,2013-02-06 16:11:00,2013-02-06 14:05:56
b9d40d2524a78013737be16b4cd0976ded843a1b...bb24275f8d0e726aec347c8be7f199346e90793d,2,32,0,32,7,2013-02-06 16:11:00,2013-02-06 15:34:06
bb24275f8d0e726aec347c8be7f199346e90793d...a534c9b72d54729122a9ccfe4f43ce5bdaa9bed2,1,5,5,10,5,2013-02-06 16:11:00,2013-02-06 15:41:36
a534c9b72d54729122a9ccfe4f43ce5bdaa9bed2...5d8a99f10429168e6471fdd1843f5045a10a84b3,1,6,0,6,1,2013-02-06 16:11:01,2013-02-06 15:45:38
5ee8c132a540973c6726bfb99b2050dccc390449...45917935ef38cdb35b152dc8a04b37efb92f33f0,1,3,3,6,3,2013-01-25 20:37:55,2013-01-25 20:37:55
45917935ef38cdb35b152dc8a04b37efb92f33f0...b280c2f361ab2c22166523a3123c378d69fdf4df,1,1,1,2,1,2013-01-25 20:38:21,2013-01-25 20:38:21
b280c2f361ab2c22166523a3123c378d69fdf4df...890e774ddc7bea953daddcce9f5677fafc30896a,1,1,1,2,1,2013-01-25 21:14:36,2013-01-25 21:14:36
5ee8c132a540973c6726bfb99b2050dccc390449...6efda51cc5caad07b6a01d293daf913eec01901f,4,5,5,10,4,2013-01-25 17:20:15,2013-01-25 17:20:15
6efda51cc5caad07b6a01d293daf913eec01901f...f225ff86743fca4c6957790d78b66ba663d5b40d,1,1,1,2,1,2013-01-25 18:33:49,2013-01-25 18:33:49
f225ff86743fca4c6957790d78b66ba663d5b40d...e1679d20c7f3e51ef63a5730543914bc9e1f1ae2,1,2,2,4,2,2013-01-25 18:34:49,2013-01-25 18:34:49
e1679d20c7f3e51ef63a5730543914bc9e1f1ae2...df64bdffdf274d0e4d96ea8c58046370b201f1e2,1,1,1,2,1,2013-01-25 18:35:31,2013-01-25 18:35:31
df64bdffdf274d0e4d96ea8c58046370b201f1e2...916165dfc4591145ebddee063857e85414b813f6,1,5,0,5,1,2013-01-25 18:35:58,2013-01-25 18:35:58
916165dfc4591145ebddee063857e85414b813f6...ef85202f71facf1cf84b07d719ac7ab6d0071cbc,1,8,7,15,3,2013-01-25 18:37:38,2013-01-25 18:37:38
ef85202f71facf1cf84b07d719ac7ab6d0071cbc...c5cbbea82e5f1ce07d5928e409fe78a80b1b7094,1,20,24,44,15,2013-01-25 18:38:24,2013-01-25 18:38:24
c5cbbea82e5f1ce07d5928e409fe78a80b1b7094...75a02e090a436aac2a182f2b56dfda4719cbd5b8,1,2,2,4,1,2013-01-25 19:19:31,2013-01-25 19:19:31
552e42f634fee790a8b6ce8d6655120bb2e69e4f...558369731fc95eb0690ce02fd3c38b7f4cf6921b,1,11,0,11,1,2013-01-27 17:09:40,2013-01-27 17:09:40
1bcf0aa2e6983d8ae01b1f1b8e1f94e5c63cfd24...a5c62585a966408542846029fa341bdced01798c,1,1,1,2,1,2014-02-12 07:27:00,2014-02-12 07:27:00
e8d1e827d8fe68d61a7be180bcc411c0d4e7982c...ce21d8688d091312f47c547c2900a83fdcaebc75,3,49,1,50,4,2013-10-10 13:19:28,2013-09-26 20:42:49
ce21d8688d091312f47c547c2900a83fdcaebc75...a00c534c4c7921e40f58f714291a2bb09ad02225,2,10,6,16,4,2013-10-10 13:19:28,2013-10-02 14:47:23
a00c534c4c7921e40f58f714291a2bb09ad02225...7cad12f77f223e72a05a3cf79a793b69dd9c0b87,1,9,0,9,1,2013-10-10 13:19:28,2013-10-02 20:37:11
7cad12f77f223e72a05a3cf79a793b69dd9c0b87...72bf6a47e038e277cbf42134169bcfa9a0edcf65,1,0,8,8,1,2013-10-10 13:19:28,2013-10-07 20:14:13
e8d1e827d8fe68d61a7be180bcc411c0d4e7982c...af1a33917ad9aa2a6e5934fd125a53c320a12df5,1,9,0,9,1,2013-10-10 13:17:30,2013-08-07 19:45:57
af1a33917ad9aa2a6e5934fd125a53c320a12df5...9d5bb5a79248861a2bd6439ceb7b5ccaeb5fa068,3,29,9,38,3,2013-10-10 13:17:30,2013-09-10 13:57:34
9d5bb5a79248861a2bd6439ceb7b5ccaeb5fa068...3e71af9f7f2ecd67df8276dabbcb495eb709f0b7,2,3,4,7,3,2013-10-10 13:17:30,2013-10-07 20:24:40
3e71af9f7f2ecd67df8276dabbcb495eb709f0b7...0cd28156d58444ee6f4b4c4b89e23dd14f6176ab,2,6,3,9,6,2013-10-10 13:17:30,2013-10-10 13:05:59
54b892153440935a08e00c63db3ec8a607ae3565...8b6a14b5059e4975eb29b565465fbfaf19e6427b,2,3,3,6,3,2014-02-10 07:36:31,2014-02-10 07:36:31
8b6a14b5059e4975eb29b565465fbfaf19e6427b...dee11dadad88ed83300c7684aab52e5508f29f24,1,8,5,13,5,2014-02-10 07:55:38,2014-02-10 07:55:38
54b892153440935a08e00c63db3ec8a607ae3565...725d35edc2680479c83bc9db94d4ac0489be735c,1,1,1,2,1,2014-02-09 19:20:42,2014-02-09 19:20:42
54b892153440935a08e00c63db3ec8a607ae3565...898d4fe37d6461daf5b4e2c31620cf9e11e682f0,1,2,2,4,1,2014-02-09 17:53:06,2014-02-09 17:53:06
54b892153440935a08e00c63db3ec8a607ae3565...b99adc9b9ac5283eb94306031af52334c831dc39,1,1,1,2,1,2014-02-09 12:04:15,2014-02-09 12:04:15
54b892153440935a08e00c63db3ec8a607ae3565...88d397f473a40236c7a03a7acf924a3640e70d9c,1,3,3,6,2,2014-02-09 03:15:44,2014-02-09 02:47:20
54b892153440935a08e00c63db3ec8a607ae3565...acf209bc53ca594c8c17c8082ca75da698b1e197,1,1,0,1,1,2014-02-09 00:24:49,2014-02-09 00:24:49
f7b46fa5fff2b26d8213aeb8619f2212e39f9541...b8e81e558f4387b4ab4fed6594594ac29a7adec2,4,16,0,16,4,2014-02-07 06:27:32,2014-02-07 06:19:49
b8e81e558f4387b4ab4fed6594594ac29a7adec2...973066e76dac1f6dae6c5356420abba7cb589462,2,20,0,20,2,2014-02-08 05:45:46,2014-02-08 05:45:46
f7b46fa5fff2b26d8213aeb8619f2212e39f9541...ff45c9755ff8195e2cfb30e408f39c75e576917b,1,2,1,3,2,2014-02-06 19:20:23,2014-02-06 19:02:30
f7b46fa5fff2b26d8213aeb8619f2212e39f9541...7a8f0019cfffe54e8ad732ee00d779bea751e489,2,2,2,4,2,2014-02-06 18:16:47,2014-02-06 18:16:47
f7b46fa5fff2b26d8213aeb8619f2212e39f9541...e139cc9e33810203fe3ac298ad6649cdbcd79f87,1,3,1,4,1,2014-02-06 16:56:47,2014-02-06 16:56:47
f7b46fa5fff2b26d8213aeb8619f2212e39f9541...1759214fccbd0f98687e3df260f24e17a553aeb5,1,2,1,3,2,2014-02-06 16:32:03,2014-02-06 16:32:03
1759214fccbd0f98687e3df260f24e17a553aeb5...eb2f3a804475f3bbcdf168aba7d13539bd7104c6,1,10,1,11,2,2014-02-07 07:45:03,2014-02-07 07:45:03
9f9be175e0cd39c36f1c195f4334ce7491b09c32...f4733b0026c717dcbbb357a5c31dd946c6af13b1,2,3,0,3,2,2013-10-15 09:23:25,2013-10-15 09:23:25
f4733b0026c717dcbbb357a5c31dd946c6af13b1...17df09b79ee10ef9c1fdeb8593337745768ef6f9,1,5,14,19,6,2013-10-15 09:32:22,2013-10-15 09:32:22
9f31fbc9831f4742618116fbc3c534fb4d3b7798...88519e90331339aa67420390193aaf32f7682c90,2,48,35,83,3,2013-10-23 07:11:54,2013-10-23 07:11:54
5093cb02d669a7a84ecc0e24bb46ecec9cd5a3a4...618ba8ca473ab852e9d8991c3b4ad76450c3aafe,1,1,1,2,1,2013-10-23 01:15:08,2013-10-22 02:29:45
618ba8ca473ab852e9d8991c3b4ad76450c3aafe...c2084639df00a93d3568c89244e48cb79075471f,1,1,1,2,1,2013-10-23 01:15:08,2013-10-22 02:35:05
c2084639df00a93d3568c89244e48cb79075471f...03dec79c74f8f067258f26ed2cacc6353e9be401,4,4,4,8,4,2013-10-23 01:15:08,2013-10-22 02:38:15
5093cb02d669a7a84ecc0e24bb46ecec9cd5a3a4...1c70bd2549475ea3e8bc79bf871339266ddec984,1,1,1,2,1,2013-10-22 18:15:01,2013-10-22 18:15:01
5093cb02d669a7a84ecc0e24bb46ecec9cd5a3a4...4dbce776159b6a6936e66d529a2009040065a12f,1,1,1,2,1,2013-10-22 15:38:11,2013-10-22 15:38:11
b6da734824d0c74ef5bb4b784d404144c76d75f4...e98d4780850e8649718f10c2a4d5b3dc7f04b390,3,1,8,9,5,2013-01-14 18:21:04,2013-01-14 18:21:04
e98d4780850e8649718f10c2a4d5b3dc7f04b390...a36926216fc7d3f4d2c36b4637d21a39b8ea7cd9,2,33,10,43,5,2013-01-14 18:55:57,2013-01-14 18:55:57
6aa34c0efd9b5bdb8a5e5fd16a40f90bc37adcf0...16c3925927ebabaca3598e1c804856b952321003,3,22,15,37,7,2013-07-15 12:03:56,2013-07-15 12:03:56
16c3925927ebabaca3598e1c804856b952321003...374722030fb5380cb92bc5471a0cce41e2df8e04,2,4,11,15,4,2013-07-15 12:11:34,2013-07-15 12:11:34
374722030fb5380cb92bc5471a0cce41e2df8e04...a6cfb54c88f34127a696992041c5690885baa6f5,1,6,6,12,6,2013-07-15 13:18:47,2013-07-15 13:18:47
11d52a15533cf0cbaa4a3a61186f8942d90ce374...9e616459e068f2ba65f90016a09387a192fe4cfc,5,196,27,223,20,2013-03-28 09:59:06,2013-03-28 09:59:06
9e616459e068f2ba65f90016a09387a192fe4cfc...f49a2ac0df978eaf897a8c8b28a202ae9a01165f,7,59,38,97,15,2013-03-28 10:14:53,2013-03-28 10:14:53
f49a2ac0df978eaf897a8c8b28a202ae9a01165f...c04120c1c512bd515fceccc70d0c7cf0a6bf4cb7,3,22,11,33,9,2013-03-28 10:24:04,2013-03-28 10:24:04
c04120c1c512bd515fceccc70d0c7cf0a6bf4cb7...ecf3b2e4710276aa1e12a931960bda2aff6ec95c,3,19,0,19,3,2013-03-28 10:33:54,2013-03-28 10:33:54
ecf3b2e4710276aa1e12a931960bda2aff6ec95c...2f585840dbf4910d3a4b40c1771ff1dd4525625d,4,12,7,19,9,2013-03-28 10:52:44,2013-03-28 10:52:44
2f585840dbf4910d3a4b40c1771ff1dd4525625d...63e6f055f12a5f955ae3bb7f27b562f89efbd8bb,2,4,2,6,3,2013-03-28 11:24:01,2013-03-28 11:24:01
63e6f055f12a5f955ae3bb7f27b562f89efbd8bb...618249734b1bcb8886b9d96714d278119037261c,2,67,16,83,2,2013-03-28 12:39:59,2013-03-28 12:39:59
618249734b1bcb8886b9d96714d278119037261c...70947fedda4f955f69d928ad0309b3f042056582,2,61,28,89,9,2013-03-28 12:51:25,2013-03-28 12:51:25
70947fedda4f955f69d928ad0309b3f042056582...5ad4be295f68310bbd031585bbf6e203084f325e,5,12,30,42,8,2013-03-28 13:39:18,2013-03-28 13:39:18
5ad4be295f68310bbd031585bbf6e203084f325e...583bfac5f57d3d5c599c8d5d1c422e1bf7b9f265,1,4,1,5,1,2013-03-28 14:00:19,2013-03-28 14:00:19
583bfac5f57d3d5c599c8d5d1c422e1bf7b9f265...21191318ae616a88376977d2438f1f4d7826283e,4,40,20,60,8,2013-03-28 14:41:29,2013-03-28 14:41:29
11d52a15533cf0cbaa4a3a61186f8942d90ce374...26bd6acadb27275b28ac017faf9c4fc6166274a5,1,1,1,2,1,2013-03-28 03:03:54,2013-03-28 03:03:54
11b89eb3810e32b78d4188f8a5d75b66cd87c21e...52ae054447980f2efb775e43adbe5ad4bcf575e6,1,2,2,4,2,2013-03-30 14:46:56,2013-03-30 14:46:56
5cb3024e1365e5e871f518aef6075c90b49a6600...3c3baf8f6d7799039cf16db044c9873f79137a49,1,5,0,5,1,2013-04-04 19:11:15,2013-04-04 19:11:15
3c3baf8f6d7799039cf16db044c9873f79137a49...25856a47e5a757e88a33218cc51367f6171db1c4,11,148,76,224,37,2013-04-04 19:11:51,2013-04-04 19:11:51
25856a47e5a757e88a33218cc51367f6171db1c4...1fe61284afc08796d09f1626a198a1c35f0a62aa,5,120,9,129,10,2013-04-04 20:19:24,2013-04-04 20:19:24
1fe61284afc08796d09f1626a198a1c35f0a62aa...ef7e605ed5b6cf3cc00e0af8b16a7641a498457c,1,3,0,3,1,2013-04-04 20:31:26,2013-04-04 20:31:26
4546c7109ce46b5607bd1c5362bd50881ced6983...ed90090a0e96374576201a7c98a6a4813beaf4cd,2,2,2,4,2,2013-04-09 18:14:47,2013-04-09 18:14:47
315d4cc8e86efa1ad5a1e50e55311cb23419e23f...015d8da7319e8e58869d56c8f516c275035a6c56,1,16,13,29,2,2013-07-02 02:14:39,2013-07-02 02:14:39
48d372725a9f40efaa239531e93866bba04f796d...98423a37b2403a944e48c6bc2d07ec5e6226b226,1,1,0,1,1,2013-06-21 09:05:21,2013-06-21 09:05:21
48d372725a9f40efaa239531e93866bba04f796d...ed25ddca7ad630dbafe6bb775871833b600b2aea,1,1,1,2,1,2013-06-20 17:21:04,2013-06-20 17:21:04
48d372725a9f40efaa239531e93866bba04f796d...2d05271c6745be21edee1314ef754fe1472d4095,1,1,1,2,1,2013-06-20 08:28:32,2013-06-20 08:23:40
f438bd415ffc4405c2e81360a92ffaf907cd87ad...a54f2d512a84a328ef4dfb1a3d8a1915579b8bfc,2,9,9,18,9,2013-06-30 16:14:27,2013-06-30 16:14:27
a54f2d512a84a328ef4dfb1a3d8a1915579b8bfc...0f84833c33174e4c8cd72690e93bba5444d9e25f,2,0,76,76,2,2013-06-30 16:19:06,2013-06-30 16:19:06
a6e44bfdae9a656303e35bee7f0a412088719f8d...23b3f0518b888a381d1b2a34e5986f058f1781ba,2,4,3,7,2,2013-06-13 07:24:01,2013-06-13 07:24:01
23b3f0518b888a381d1b2a34e5986f058f1781ba...7a53215d75f239212037c9e8052e0bcc9310d1d1,1,3,2,5,2,2013-06-13 07:42:45,2013-06-13 07:42:45
7a53215d75f239212037c9e8052e0bcc9310d1d1...18ea0e0ea726114b82161118d3e46bc0f11a90df,2,5,0,5,2,2013-06-13 07:59:27,2013-06-13 07:59:27
18ea0e0ea726114b82161118d3e46bc0f11a90df...200c5f5894960ba473ccc898edba0b7146e31cd7,1,1,1,2,1,2013-06-13 14:41:21,2013-06-13 14:41:21
200c5f5894960ba473ccc898edba0b7146e31cd7...81a9e81fae349e3e2b1cc336bf6cef767d65dbfc,1,1,0,1,1,2013-06-13 14:47:04,2013-06-13 14:47:04
670aaaeb9db7902c8776cb7754ac8fd1e7a606a1...439f399bece8c2b01dc064b6c02f28fb4149595e,60,1,2419,2420,64,2013-06-18 18:22:34,2013-06-18 18:22:34
439f399bece8c2b01dc064b6c02f28fb4149595e...2a63f64f24d25865dec249021ea806da86d8bb9e,5,0,70,70,5,2013-06-18 18:44:04,2013-06-18 18:44:04
2a63f64f24d25865dec249021ea806da86d8bb9e...e1882b535c3f4140b8b55d6f3a26525f84c5007b,4,0,318,318,4,2013-06-18 18:54:31,2013-06-18 18:54:31
e1882b535c3f4140b8b55d6f3a26525f84c5007b...1b3b90dbfd3219f571084321c751bd2263ad1836,2,0,45,45,2,2013-06-18 19:06:20,2013-06-18 19:06:20
7ba4f2dcfaa85fb89e15d9caa21bf75ad976389f...59b6de93cebe4aaa8cca121e6147fd7c83786f17,3,91,26,117,19,2013-01-30 14:48:00,2013-01-30 13:20:00
7ba4f2dcfaa85fb89e15d9caa21bf75ad976389f...e2fb18a3ec8052997f0c9b795f76a6e4d57a9d97,96,143,144,287,141,2013-01-30 14:40:43,2013-01-30 14:40:43
e2fb18a3ec8052997f0c9b795f76a6e4d57a9d97...b742f47e89674c7aaae78b6e4174339480594d1f,35,42,36,78,38,2013-01-30 14:53:18,2013-01-30 14:53:18
b742f47e89674c7aaae78b6e4174339480594d1f...b096ee327598919b2d78a99ce82e6b0107369604,4,75,74,149,6,2013-01-30 15:01:58,2013-01-30 15:01:58
b096ee327598919b2d78a99ce82e6b0107369604...560985b0f685f810a1ce16ae206fbbf81b8fb704,2,2,2,4,2,2013-01-30 15:07:44,2013-01-30 15:07:44
560985b0f685f810a1ce16ae206fbbf81b8fb704...bfd00caff3010100f367ed60d73f065cc8b21f06,4,7,7,14,7,2013-01-30 15:13:05,2013-01-30 15:13:05
7ba4f2dcfaa85fb89e15d9caa21bf75ad976389f...1694dc8fe226c0687ce2c54a71739adba22f33c5,1,1,1,2,1,2013-01-30 05:15:13,2013-01-30 05:15:13
71e89df5e061e4c3a372977e7e6fb25f42791414...0125b74b3cbdb7df3b029cd2373b96ca3905c16a,2,6,7,13,4,2013-01-26 10:08:34,2013-01-26 10:08:34
0125b74b3cbdb7df3b029cd2373b96ca3905c16a...b68bba441eaa9baf76dc2c0f9532615aaec3137b,1,1,1,2,1,2013-01-26 10:15:38,2013-01-26 10:15:38
e0b5e260357b4882e43863f61dcf337b120534b2...bd948549293e1abfa32ec566b687670fed47a3d7,1,5,2,7,2,2013-01-28 06:59:34,2013-01-28 06:59:34
bb44a7a25d5c9efbf50ebb47b3b6a29adc97a1bc...0bcabdaf8330d0a260d95ee8435170fa7258eb98,4,7,13,20,6,2014-02-12 10:54:49,2014-02-12 10:54:49
0bcabdaf8330d0a260d95ee8435170fa7258eb98...59769fdb940712737656a441ef43a1ad2dd47f4d,4,13,2,15,5,2014-02-12 10:56:13,2014-02-12 10:56:13
59769fdb940712737656a441ef43a1ad2dd47f4d...70df6055356ccc1cc1d8c8199e9b23d171d045f4,1,7,5,12,1,2014-02-12 11:03:32,2014-02-12 11:03:32
bb44a7a25d5c9efbf50ebb47b3b6a29adc97a1bc...abb6204de832e2b9398389b4de48dd6021da00f9,1,4,0,4,1,2014-02-12 08:45:34,2014-02-12 08:45:34
fa323c0ca112aeab52869efd84f2cb137558967b...92b7c569a7d3249968108afab3a7c32c0cdcbc8c,1,8,4,12,2,2013-11-10 13:01:29,2013-11-10 00:06:22
4123c76ec192f08be4d74f4958624c6e87041564...6cc3bb0f8fe292001c80c3a14cdc21952dd50c5f,1,2,1,3,1,2013-10-11 08:40:22,2013-10-11 08:40:22
6cc3bb0f8fe292001c80c3a14cdc21952dd50c5f...39c78b71c1780c6f749f21edef4de0ac94ca9c96,1,1,0,1,1,2013-10-11 10:15:18,2013-10-11 10:15:18
dee11dadad88ed83300c7684aab52e5508f29f24...e009e0203e78f6d648b3a3d3a230b9c977dc5141,1,46,12,58,10,2014-02-10 12:59:30,2014-02-10 12:59:30
e009e0203e78f6d648b3a3d3a230b9c977dc5141...464d820bc59ed4bf26884f1be45463c02d79544e,1,1,1,2,1,2014-02-10 13:01:15,2014-02-10 13:01:15
dee11dadad88ed83300c7684aab52e5508f29f24...bed05a1381fab0b7c74817f68aac8e18c60c6a25,3,60,37,97,32,2014-02-10 11:02:26,2014-02-10 11:02:26
dee11dadad88ed83300c7684aab52e5508f29f24...7b33efdf5e8c6c4184b86315ec106803dfb0ff8b,1,1,1,2,1,2014-02-10 10:44:27,2014-02-10 10:44:27
35fb7d54081f21b757de26cb3e2e763a77720d6d...9a3d665919218ebe30fd1b10a70e75db16675bff,5,28,1,29,5,2014-02-10 19:46:46,2014-02-10 19:46:46
eb2f3a804475f3bbcdf168aba7d13539bd7104c6...c03df58e9e7974befd5039334151314e5fb970cc,1,5,2,7,2,2014-02-07 10:41:31,2014-02-07 10:41:31
eb2f3a804475f3bbcdf168aba7d13539bd7104c6...4ecf30cd5b4731ed7735a658630729fd1c5fc993,2,20,4,24,3,2014-02-07 10:34:30,2014-02-07 10:34:30
17df09b79ee10ef9c1fdeb8593337745768ef6f9...c69b2856b1baa15f7a6fd98b7d333f5ba0f70c86,1,18,0,18,1,2013-10-15 12:58:26,2013-10-15 12:58:26
17df09b79ee10ef9c1fdeb8593337745768ef6f9...948af77367c38f6fcde988917e56b602d1de9a36,1,18,3,21,3,2013-10-15 09:51:56,2013-10-15 09:51:56
c2f74de4c04cb6f23f9b8be86df5852b37b0df55...2b555306a11abdd5836f506f42109014dd7f3654,2,12,12,24,2,2013-10-23 16:29:29,2013-10-23 16:29:29
c2f74de4c04cb6f23f9b8be86df5852b37b0df55...eb44ab00868d0835e64050716f96950788739159,1,5,5,10,1,2013-10-23 15:33:29,2013-10-23 15:33:29
c2f74de4c04cb6f23f9b8be86df5852b37b0df55...89f7b65e03382a3e1e541c14227180662b91a929,1,1,1,2,1,2013-10-23 08:34:43,2013-10-23 08:34:43
a6cfb54c88f34127a696992041c5690885baa6f5...559e83d30004e0c41a30f4ce3463f695eb7e26a1,3,24,21,45,5,2013-07-16 08:28:19,2013-07-16 08:28:19
559e83d30004e0c41a30f4ce3463f695eb7e26a1...247e0951864c6888cfdd18b8746c554df2916ec1,2,5,1,6,3,2013-07-16 08:50:00,2013-07-16 08:50:00
a6cfb54c88f34127a696992041c5690885baa6f5...670e1be7a402b1340393d298c7ebc05930ed7ac3,1,1,1,2,1,2013-07-15 22:35:14,2013-07-15 22:35:14
a6cfb54c88f34127a696992041c5690885baa6f5...b5cd66d41de98c63fdb048e3d0ce600c9353e230,1,2,2,4,2,2013-07-15 22:32:41,2013-07-15 22:32:41
a6cfb54c88f34127a696992041c5690885baa6f5...d331b3f91223f996e57092d3e6a64701ff0b1904,1,1,1,2,1,2013-07-15 21:12:18,2013-07-15 21:12:18
21191318ae616a88376977d2438f1f4d7826283e...4524ba20b804dacccbaca3c37e781adc82c5e0d3,3,10,3,13,7,2013-03-28 19:57:38,2013-03-28 19:57:38
4524ba20b804dacccbaca3c37e781adc82c5e0d3...a18ce409431dfad00af137bf3983bb0f456d2485,3,3,10,13,7,2013-03-28 21:01:42,2013-03-28 21:01:42
a18ce409431dfad00af137bf3983bb0f456d2485...49f14f057d6deb0903ae4e9b876c89f717f85f10,2,13,10,23,6,2013-03-29 06:47:14,2013-03-29 06:47:14
49f14f057d6deb0903ae4e9b876c89f717f85f10...66a1b88393cea26b9626087c0a2d5bec69cbf863,2,3,3,6,2,2013-03-30 10:50:44,2013-03-30 10:50:44
21191318ae616a88376977d2438f1f4d7826283e...f1b369b57ddaa4c308c0f1debcc9548f14f86b24,1,1,1,2,1,2013-03-28 16:03:00,2013-03-28 16:03:00
ef7e605ed5b6cf3cc00e0af8b16a7641a498457c...b65903e005f1a594b9a66fb9dcff96ca5ea4c04f,4,29,23,52,11,2013-04-05 12:42:07,2013-04-05 12:42:07
b65903e005f1a594b9a66fb9dcff96ca5ea4c04f...38d23c0e5f816937047c9326f9dd33fb10490032,2,62,41,103,6,2013-04-05 12:55:02,2013-04-05 12:55:02
38d23c0e5f816937047c9326f9dd33fb10490032...362d82d10e217231cd607e932a64b3e9b48f67c8,2,5,3,8,4,2013-04-05 13:19:05,2013-04-05 13:19:05
362d82d10e217231cd607e932a64b3e9b48f67c8...c33d5e16fe5f5dde4f270adaf7fb6fe5b9552018,5,140,103,243,9,2013-04-05 16:01:19,2013-04-05 16:01:19
c33d5e16fe5f5dde4f270adaf7fb6fe5b9552018...ff4471a3cd1d29228a67e582bc54bed952c0a8ee,6,48,53,101,8,2013-04-05 16:47:12,2013-04-05 16:47:12
ff4471a3cd1d29228a67e582bc54bed952c0a8ee...cd6280f4fe712da9b65a8c62950b71fe93705147,3,9,28,37,7,2013-04-05 16:47:45,2013-04-05 16:47:45
cd6280f4fe712da9b65a8c62950b71fe93705147...10902c844fe834399e9b909b75ab3ea502c64a89,1,1,1,2,1,2013-04-05 16:48:56,2013-04-05 16:48:56
10902c844fe834399e9b909b75ab3ea502c64a89...0da5a4fab136158f9a51de1f92f74ebd9ea922a2,2,11,0,11,1,2013-04-05 17:44:16,2013-04-05 17:44:16
0da5a4fab136158f9a51de1f92f74ebd9ea922a2...3df5fee4ff20ef9cf4834ea15b0a2a0df5f5437b,2,23,24,47,4,2013-04-05 18:03:39,2013-04-05 18:03:39
3df5fee4ff20ef9cf4834ea15b0a2a0df5f5437b...6c206805ae445b7052d98640cb0083256d836db1,1,22,0,22,2,2013-04-05 18:20:11,2013-04-05 18:20:11
6c206805ae445b7052d98640cb0083256d836db1...07c82cf77629c36548796051f6cbbcb01fd1954e,3,0,38,38,5,2013-04-05 18:21:53,2013-04-05 18:21:53
07c82cf77629c36548796051f6cbbcb01fd1954e...39f4604653507e565c93a6fa8ef62bda421e78b2,8,59,182,241,21,2013-04-06 11:35:17,2013-04-06 11:35:17
39f4604653507e565c93a6fa8ef62bda421e78b2...37eeeb9fca90aa34c502181b9967fb62f9f87752,21,180,99,279,36,2013-04-06 12:10:24,2013-04-06 12:10:24
37eeeb9fca90aa34c502181b9967fb62f9f87752...5b06c9a73bda4e8e9c0dce11ebc2fe866dc85a7f,1,1,1,2,1,2013-04-06 12:11:47,2013-04-06 12:11:47
5b06c9a73bda4e8e9c0dce11ebc2fe866dc85a7f...f4ae433d9017c0b6e9f3ffcb68dc0426ca7b721d,3,8,3,11,5,2013-04-06 12:53:35,2013-04-06 12:53:35
f4ae433d9017c0b6e9f3ffcb68dc0426ca7b721d...52ad34fd59273e1f65ab1726a97ead7f13095c84,1,3,0,3,1,2013-04-06 18:21:09,2013-04-06 18:21:09
ef7e605ed5b6cf3cc00e0af8b16a7641a498457c...ef93cc1745dca59ceec57db23ec507f3446b64ea,1,1,1,2,1,2013-04-05 01:35:36,2013-04-05 01:35:36
ed90090a0e96374576201a7c98a6a4813beaf4cd...92b4b77a2af8fdeefcf1d7c44fcba16d62cd158f,5,5,5,10,5,2013-04-10 07:19:08,2013-04-10 07:19:08
ed90090a0e96374576201a7c98a6a4813beaf4cd...65e8b18190428b6fbb9db9d0b8ab19de533aa0d9,4,4,4,8,4,2013-04-10 02:43:02,2013-04-10 02:43:02
47f78a2c7614b0a32110e909c2244f67310d030e...66e10f0566a979b5ba852b2f82a94d3a4280a4e7,2,2,1,3,2,2013-07-02 08:42:39,2013-07-02 08:42:39
cab2ba0af300ec58ef325c4f9e5763aeebb61dbf...4bba945437f67ffa5fb6a4afad60729c1827e26b,1,5,0,5,1,2013-07-06 09:14:06,2013-07-06 09:14:06
cab2ba0af300ec58ef325c4f9e5763aeebb61dbf...2c7b0d5a4655348d4cf45378afa6cda4eb233af2,1,1,1,2,1,2013-07-06 01:31:56,2013-07-06 01:31:56
5ffc90d90df54440f857b46009b1bd63c0786a2d...6a84d926724d60c208d101525a83ab832ccfcdec,2,30,1,31,2,2013-07-01 09:47:39,2013-06-25 22:46:07
6a84d926724d60c208d101525a83ab832ccfcdec...b62c9e5991dae0e4a8ae8e947b438cdd4e753c79,1,1,1,2,1,2013-07-01 09:48:01,2013-06-26 10:27:49
b62c9e5991dae0e4a8ae8e947b438cdd4e753c79...20b2a0b235d01a63cb0cf47b6329b557242a3981,7,285,18,303,18,2013-07-01 09:48:02,2013-06-26 14:32:34
20b2a0b235d01a63cb0cf47b6329b557242a3981...1216a62e3ba2e5c9d959fca748136661755d72e8,1,1,0,1,1,2013-07-01 09:48:02,2013-06-26 15:01:59
1216a62e3ba2e5c9d959fca748136661755d72e8...22c00e64626791bf138a7691205d3e6e89cd315c,1,0,1,1,1,2013-07-01 09:48:02,2013-06-26 15:25:24
22c00e64626791bf138a7691205d3e6e89cd315c...af81ff4e098241fae4f61ddd3542c44a457fba2c,1,2,2,4,2,2013-07-01 09:48:02,2013-06-30 16:44:59
af81ff4e098241fae4f61ddd3542c44a457fba2c...6fa06893e9f165a05e88330a835e30b8c084e9bb,1,1,1,2,1,2013-07-01 09:48:25,2013-06-25 22:46:07
0f84833c33174e4c8cd72690e93bba5444d9e25f...6e550af150958d0c88bf21f206c2309dc0b5c78d,7,35,1,36,7,2013-06-30 19:10:52,2013-06-30 19:10:52
f4e2865d2fabf55bb017f7f88fa2ef0d1c3d4fad...04e77826ba6dc496a045f49cc83f3cc1d0dda11b,1,3,2,5,3,2013-06-24 07:20:08,2013-06-24 07:20:08
f4e2865d2fabf55bb017f7f88fa2ef0d1c3d4fad...862fbb62b28a67c6fbc66a593cc296fd5f453ee1,1,2,0,2,1,2013-06-23 19:54:24,2013-06-23 19:54:24
f4e2865d2fabf55bb017f7f88fa2ef0d1c3d4fad...ef629ab47e91cdbbe0fba6585ed23e7b2d26f610,2,3,3,6,3,2013-06-22 15:19:00,2013-06-22 15:19:00
f4e2865d2fabf55bb017f7f88fa2ef0d1c3d4fad...8c1ac6f3c6658a3c694fd2e0108a120de5a862d6,1,2,2,4,1,2013-06-22 11:29:51,2013-06-22 11:29:51
81a9e81fae349e3e2b1cc336bf6cef767d65dbfc...cfd15eb480973e5206c83dc4f2ed18781d78f7e0,2,4,4,8,3,2013-06-13 16:56:26,2013-06-13 16:56:26
81a9e81fae349e3e2b1cc336bf6cef767d65dbfc...5b40780290e7d7c9e129e58c4f3f435073598ae6,4,66,0,66,5,2013-06-13 16:53:04,2013-06-13 16:53:04
5b40780290e7d7c9e129e58c4f3f435073598ae6...94be73202617a5b0886c348ffbaf08947ecf8b45,3,9,3,12,5,2013-06-13 17:01:35,2013-06-13 17:01:35
94be73202617a5b0886c348ffbaf08947ecf8b45...fbf69899032ffd5e74e401aae7c94852a0722e92,3,8,4,12,3,2013-06-13 17:06:33,2013-06-13 17:06:33
fbf69899032ffd5e74e401aae7c94852a0722e92...46231f0f1d2d8aad0712ba98a6368af138a8561c,2,9,8,17,3,2013-06-13 17:16:48,2013-06-13 17:16:48
46231f0f1d2d8aad0712ba98a6368af138a8561c...00882b3c33cb377b903cdf8e2b91149081739785,1,2,1,3,1,2013-06-13 17:21:51,2013-06-13 17:21:51
00882b3c33cb377b903cdf8e2b91149081739785...6838304a85cd3b5dfdac076c600cb15f5643c674,9,118,76,194,24,2013-06-13 18:06:27,2013-06-13 18:06:27
fcccf7622b7df6b87b4f024963b1bccf0dcf24d8...78680a81774d67997fa0abece4dc1d4a5ec12ce6,4,35,8,43,7,2013-06-19 10:52:25,2013-06-19 10:52:25
78680a81774d67997fa0abece4dc1d4a5ec12ce6...6e35aceff29ddeae6282de31e81e48446ab927fa,42,198,68,266,60,2013-06-19 12:40:33,2013-06-19 12:40:33
1fdeb9e03042b1b645ed0fe6c33fb4f21dd6ddb1...f8a2db53417a345d78d8e6b78367d5bbb9bb601b,1,1,1,2,1,2013-01-31 01:43:57,2013-01-31 01:37:23
a037c9c2497bf6a813d2138afae22e55cde8b093...9da7b2e8d8ed08cb193af2babf150cb8c7715f80,1,11,0,11,3,2013-01-31 06:42:11,2013-01-31 06:42:11
b68bba441eaa9baf76dc2c0f9532615aaec3137b...bd3b677b86d7c76788420e94862836343ac5c841,5,71,24,95,12,2013-01-27 10:34:27,2013-01-27 10:34:27
bd3b677b86d7c76788420e94862836343ac5c841...6b01196fb238cb921056ecd8d1572ff2874bf912,11,45,32,77,20,2013-01-27 10:56:20,2013-01-27 10:56:20
6b01196fb238cb921056ecd8d1572ff2874bf912...070f49fdc550654e538977f4fe6ce4a609521696,1,3,1,4,1,2013-01-27 11:12:30,2013-01-27 11:12:30
070f49fdc550654e538977f4fe6ce4a609521696...7175b6a7695cf5c14185deccb8850d988f0dba95,2,5,5,10,4,2013-01-27 11:20:23,2013-01-27 11:20:23
7175b6a7695cf5c14185deccb8850d988f0dba95...cd47e625f0f6b564dff9a5e5fa51f3d88db2b530,1,2,2,4,2,2013-01-27 12:10:42,2013-01-27 12:10:42
cd47e625f0f6b564dff9a5e5fa51f3d88db2b530...d24fd32aa5090e1f26f028921048e15f09f82323,3,18,0,18,3,2013-01-27 13:41:35,2013-01-27 13:41:35
b68bba441eaa9baf76dc2c0f9532615aaec3137b...6ab6c55de5516ac636b5ca1147c1d1f81831c599,1,4,4,8,4,2013-01-26 14:22:48,2013-01-26 14:22:48
bd948549293e1abfa32ec566b687670fed47a3d7...2ddaf0038710d057e96f8211036399aa65d3ddb4,1,8,1,9,2,2013-01-28 13:49:27,2013-01-28 13:49:27
2ddaf0038710d057e96f8211036399aa65d3ddb4...a90d5c21b55584572ff22d7a3affd84cd19d38d2,1,12,0,12,1,2013-01-28 15:46:58,2013-01-28 15:46:58
a90d5c21b55584572ff22d7a3affd84cd19d38d2...e76215a395bb814972c1385ce815b2da2a6e3402,1,13,12,25,12,2013-01-28 22:51:45,2013-01-28 22:51:45
bd948549293e1abfa32ec566b687670fed47a3d7...3c47e6248ade6cd8561e1e361a01f7a770907bfd,1,1,1,2,1,2013-01-28 09:59:39,2013-01-28 09:59:39
c86553cd836b7be3948ace41ef47f85776a48a97...439a61783d0b61bbcc8f3c9e5b828b2270a679aa,23,430,151,581,61,2014-02-12 14:52:53,2014-02-07 16:59:55
c86553cd836b7be3948ace41ef47f85776a48a97...0e90ff8018ff9e2fe8c6b238ebd5cdd6babd72e8,1,0,2,2,1,2014-02-12 13:02:50,2014-02-12 13:02:50
75303241b1ce6a9cb38e40f48ae1bd2ad11808b3...c77d957b365bd023b1dc73b5f5111b4fe262bfbe,3,88,8,96,7,2013-11-11 12:58:06,2013-11-11 12:58:06
c77d957b365bd023b1dc73b5f5111b4fe262bfbe...986697a99bde07ea0d7e878f8618f801b6b81a8c,5,6,17,23,7,2013-11-11 12:58:39,2013-11-11 12:58:39
c9e31875dc4e27e679aed3f301a8161b45b4ce99...79afb001ad1b6233514fb2eb683fd7202e6d324e,2,2,2,4,2,2013-11-10 08:43:04,2013-11-10 08:43:04
baf8afc6d34a01555141bc297d84f5bffd4393c0...00ebfaa9425dda6dc60ddc98b69050c28bb19ec6,2,2,2,4,2,2014-02-10 14:51:51,2014-02-10 14:51:51
baf8afc6d34a01555141bc297d84f5bffd4393c0...1794f606bd74ae775cd10a3f7da293fb67134c1c,85,7,162348,162355,85,2014-02-10 14:18:46,2014-02-10 14:18:46
5a098e84e4de30d95ba5e0a3a7bbd81813cf3305...58ac731c3764d1cbf3a4a1e60e5c5374ec460546,2,7,3,10,3,2014-02-10 13:36:58,2014-02-10 13:36:58
5a098e84e4de30d95ba5e0a3a7bbd81813cf3305...56f989e53e80fe7545a3400ba7ee98a0cd2cf259,3,10,10,20,7,2014-02-10 13:04:52,2014-02-10 13:04:52
56f989e53e80fe7545a3400ba7ee98a0cd2cf259...ec437ad999858db18627174ff1cf9f272e4ddefb,1,16,0,16,2,2014-02-10 13:23:19,2014-02-10 13:23:19
ec437ad999858db18627174ff1cf9f272e4ddefb...5e30f4d54c61f6d9cfee731c8cce4fa1ef58d628,1,5,0,5,1,2014-02-10 15:32:36,2014-02-10 15:32:36
1af84f8ceb8cbe5d6ba5704dd94d7593b0a37429...faafde2d2b8dc3457c45aa87e6dd280bfdd13dde,1,21,21,42,2,2014-02-11 07:37:55,2014-02-11 07:37:55
78363222ba1be8834ce664556316d570f218803e...5ed87ab7ccc8e5cf92b068bb75542f05b28a947e,3,3,3,6,3,2014-02-13 20:14:20,2014-02-13 20:14:20
78363222ba1be8834ce664556316d570f218803e...009858bf4bd4b81c526aaccfe6847b1c8862aaa3,1,1,1,2,1,2014-02-13 19:59:45,2014-02-13 19:59:45
65d34388618f78480135add63b3fa5e7d38368ce...e772da0c1e04db57ec6c85c238742c2f4a587f76,1,8,11,19,1,2014-02-07 16:03:36,2014-02-07 16:03:36
e772da0c1e04db57ec6c85c238742c2f4a587f76...ea10424e0e0a3f92cb11eaa190497b50c33b1f9d,1,8,2,10,2,2014-02-07 16:06:32,2014-02-07 16:06:32
7c4db532ff246a9831a5decaaf031affeb1eb21d...6a7d63aa47d583a21b87b623a010d8b98abb8777,4,118,27,145,13,2013-10-15 20:48:57,2013-10-09 14:45:32
a8eb525e72f6883a07539af9429ccd41dbc8698b...aefe2e952f33267ce38fb9270400f4f6f194d37b,14,196,120,316,39,2013-10-16 05:20:53,2013-10-04 19:11:50
4ab27017e51cd48cf9f733a6dde2056b7da45d52...05c988419f438ec72556f3a52227c62943c67845,3,43,6,49,10,2013-10-24 05:31:15,2013-09-02 10:48:32
4ab27017e51cd48cf9f733a6dde2056b7da45d52...74790bd8d92aeeb5ec51fe1ecf27bc5f5212d31e,1,1,1,2,1,2013-10-23 20:53:06,2013-10-23 20:53:06
71f92d453926085ddf02216cfddbb6de3e6bb72f...0542261437fd9df7539fe480069449b566057300,1,21,8,29,3,2013-10-24 14:17:22,2013-10-24 14:17:22
79e0796c64a758d539507bd84cfe6da9eb5f96a8...5768f98d8dcbb3d98c1267add687828de2422642,1,1,1,2,1,2013-07-16 18:39:39,2013-07-16 18:39:39
5768f98d8dcbb3d98c1267add687828de2422642...a466b2175adc6021a75f31baabbaa42b14203d44,1,25,0,25,1,2013-07-16 19:18:14,2013-07-16 19:18:14
a466b2175adc6021a75f31baabbaa42b14203d44...7a167cf1f74b4e74c4ba9de715585a1251165c5b,11,75,54,129,13,2013-07-16 19:19:07,2013-07-16 19:19:07
7a167cf1f74b4e74c4ba9de715585a1251165c5b...d207a31fc97edf4e19a50c4a650d6a34b4f5a2cf,4,6,6,12,5,2013-07-16 19:25:59,2013-07-16 19:25:59
d207a31fc97edf4e19a50c4a650d6a34b4f5a2cf...a165a0b23fd6cc81e7fc0163827310f69ce0399a,2,18,1,19,2,2013-07-16 19:43:14,2013-07-16 19:43:14
a165a0b23fd6cc81e7fc0163827310f69ce0399a...132caae73446e23a2ff8a7b1a4110efe42a36eb1,10,77,19,96,18,2013-07-16 20:12:52,2013-07-16 20:12:52
132caae73446e23a2ff8a7b1a4110efe42a36eb1...c4301ce04917e37a9f12338b7cfb3b1fa30139ba,2,3,3,6,3,2013-07-16 20:14:22,2013-07-16 20:14:22
c4301ce04917e37a9f12338b7cfb3b1fa30139ba...4b198670c8113892cc907a7f750c26ca96cd6710,1,1,1,2,1,2013-07-16 20:19:59,2013-07-16 20:19:59
4b198670c8113892cc907a7f750c26ca96cd6710...03b26b0105658599847122b00558ec36bf2f8811,1,1,0,1,1,2013-07-16 20:27:18,2013-07-16 20:27:18
03b26b0105658599847122b00558ec36bf2f8811...d65eb22e2d5f0de8984855919d644a562003b9b2,1,1,1,2,1,2013-07-16 20:35:54,2013-07-16 20:35:54
4b47a58f2f7296a93ed57c81dec1247a615a52f6...2d9bbe662eed29dc099e4bb7e6408503f0489e09,1,2,2,4,2,2013-07-18 10:59:18,2013-07-18 10:59:18
2d9bbe662eed29dc099e4bb7e6408503f0489e09...afa1a20de1b3e8d8d1be7cb85069bc5ae069f9d8,1,1,1,2,1,2013-07-18 10:59:41,2013-07-18 10:59:41
52ad34fd59273e1f65ab1726a97ead7f13095c84...9fddd5b440105376caf913e1c09756ec2aaf4431,24,63,142,205,26,2013-04-06 19:32:23,2013-04-06 19:32:23
9fddd5b440105376caf913e1c09756ec2aaf4431...7f368753741a9998c1cbde06c44c5b53677a47d9,1,5,5,10,5,2013-04-07 09:32:24,2013-04-07 09:32:24
7f368753741a9998c1cbde06c44c5b53677a47d9...e0df75de3fbe640528e2b327a387e4ebce442055,7,80,109,189,11,2013-04-07 10:19:36,2013-04-07 10:19:36
e0df75de3fbe640528e2b327a387e4ebce442055...5577ee826db7cdb01c348a6bbaef867a02719e2e,1,0,8,8,2,2013-04-07 18:18:48,2013-04-07 18:18:48
52ad34fd59273e1f65ab1726a97ead7f13095c84...f5ff99d6b2366b368face5007d8f498175d40f9f,1,4,4,8,2,2013-04-06 18:25:46,2013-04-06 18:25:46
97de212e80737a608d939f648d959671fb0a0142...c1a9e9228117d68e9e8556e6dc13b8e181dd973c,1,1,1,2,1,2013-04-09 07:14:11,2013-04-09 07:14:11
c1a9e9228117d68e9e8556e6dc13b8e181dd973c...546d7d44d00ce7cbd9f056ed3ebfd8c172967ac1,1,1,0,1,1,2013-04-09 08:17:24,2013-04-09 08:17:24
546d7d44d00ce7cbd9f056ed3ebfd8c172967ac1...c34288fa27f9bca5b371b94890cac4f6a06773eb,1,3,0,3,1,2013-04-09 12:04:31,2013-04-09 12:04:31
c34288fa27f9bca5b371b94890cac4f6a06773eb...52cd655f71c6a5393b71640c13cd95e35e8d2624,1,1,0,1,1,2013-04-09 16:29:45,2013-04-09 16:29:45
97de212e80737a608d939f648d959671fb0a0142...de6db604774b5d25405f9a8d358050f2da5b21a4,1,3,3,6,3,2013-04-07 20:58:25,2013-04-07 20:58:25
19f505a73525b5559f04761707566ebb157fe9b6...c610f2da5504be78762e2f8a94009d951c19dd7d,2,6,2,8,2,2013-04-10 11:35:44,2013-04-10 11:35:44
c610f2da5504be78762e2f8a94009d951c19dd7d...d2c70b8920fbf8750c4f4e0b5d45d3846c32b9a9,1,1,1,2,1,2013-04-10 11:38:04,2013-04-10 11:38:04
d2c70b8920fbf8750c4f4e0b5d45d3846c32b9a9...1d03fa2e7f4d341f17d7ad5dcad4b1f8eda14a60,1,9,0,9,1,2013-04-10 12:11:45,2013-04-10 12:11:45
1d03fa2e7f4d341f17d7ad5dcad4b1f8eda14a60...e230551940b31f7779a16975f2b3e941815d2e03,3,46,3,49,8,2013-04-10 12:41:47,2013-04-10 12:41:47
e230551940b31f7779a16975f2b3e941815d2e03...4fcd89fe7fb44da5c9bbdcca89bfbbffa5d0b032,2,1,8,9,2,2013-04-10 15:26:25,2013-04-10 15:26:25
7588186e8173f53a7f9b86d2b6959d7f94a3caac...ae9e4a52c5b9e090c8df61978b5838a94408c265,1,7,0,7,1,2013-07-04 09:14:03,2013-07-04 09:09:19
7588186e8173f53a7f9b86d2b6959d7f94a3caac...0c4fd05d728203474ffbba2c5ce9dba4dd433b18,1,3,3,6,2,2013-07-03 05:15:50,2013-07-03 05:15:50
5315fd5a594e7de0e91804a9f28d4f2a0f8dd3ac...b686b4b9623f277c35d0972ada4d8f8803cb7c97,1,7,3,10,6,2013-07-07 11:46:37,2013-07-07 11:46:37
5315fd5a594e7de0e91804a9f28d4f2a0f8dd3ac...4de11c2009bd20f7811106d6cb8bda294561ff0a,1,12,12,24,1,2013-07-07 10:35:37,2013-07-07 10:35:37
a324960d92d4c2436064329137857686d90100b5...3b9e3021ee3d07e561d362aa95e45f3d94d99eed,1,1,1,2,1,2013-06-24 16:57:49,2013-06-24 16:57:49
a324960d92d4c2436064329137857686d90100b5...f3a924023756ce99ee29d9c8d6cbb4c3b3e9ac26,1,1,3,4,2,2013-06-24 15:40:23,2013-06-24 15:40:23
a324960d92d4c2436064329137857686d90100b5...cf35d19c2ef6afd04b7339e5425f2f4a015e6acf,8,81,8,89,15,2013-06-24 14:55:44,2013-05-09 23:37:47
905eb176146cffd623b515c45d398af194ef9ae8...1aeebdf68112a42f5aea97267cec5c732e1065f1,1,1,0,1,1,2013-06-24 22:55:37,2013-06-24 22:55:37
1aeebdf68112a42f5aea97267cec5c732e1065f1...82271e78181b91cb4294cfb2f4aa790bd54343b6,1,2,2,4,2,2013-06-24 22:57:26,2013-06-24 22:57:26
ef9298febbe5d84b641fcef4e4c9f8997e17a15a...f49fb5dca1ecf2b1ae6415920de09b4d95c14bb1,6,12,10,22,6,2013-07-01 16:01:19,2013-07-01 16:01:19
ac6c912860619aa8ae3229d07ff7c458481df791...a5d6bbe0af50494cee2200537fd8b78d7e4841a6,2,3,2,5,2,2013-06-24 13:21:46,2013-06-24 13:21:46
ac6c912860619aa8ae3229d07ff7c458481df791...c6464aa859ce4d26a768d9cf6792453be0c0373b,1,0,2,2,1,2013-06-23 17:00:10,2013-06-23 17:00:10
8d70ac008dbb43752e2c1f69530c4453eb8e0e2d...09daff61780a2fa391cf1a80bf152cca15740754,2,42,9,51,8,2013-06-22 08:38:47,2013-06-22 08:38:47
09daff61780a2fa391cf1a80bf152cca15740754...c2317d6785016918975d93c08d915055448d56cb,1,1,1,2,1,2013-06-22 09:57:05,2013-06-22 09:57:05
c2317d6785016918975d93c08d915055448d56cb...19d628dd239f03e950a41c4498131f9b2a221909,2,3,3,6,3,2013-06-22 10:39:34,2013-06-22 10:39:34
19d628dd239f03e950a41c4498131f9b2a221909...0bc714c271174137431d9194d8f1567953f97a8b,7,7,49,56,8,2013-06-22 10:41:08,2013-06-22 10:41:08
0bc714c271174137431d9194d8f1567953f97a8b...59f75e6c1ec29721d1430e8dbcb5858a0ddb910a,2,0,9,9,5,2013-06-22 10:47:11,2013-06-22 10:47:11
59f75e6c1ec29721d1430e8dbcb5858a0ddb910a...ee13297af2706be438666a3761938423fc9a51db,9,22,93,115,21,2013-06-22 11:11:20,2013-06-22 11:11:20
ee13297af2706be438666a3761938423fc9a51db...9787c37aed0c934d9ae4f6786413eb25b55c3a17,2,24,1,25,9,2013-06-22 12:01:08,2013-06-22 12:01:08
9787c37aed0c934d9ae4f6786413eb25b55c3a17...edcd46599b8363c3447c07ae4dcf320af8bfd4c1,6,6,6,12,6,2013-06-22 12:04:49,2013-06-22 12:04:49
edcd46599b8363c3447c07ae4dcf320af8bfd4c1...102aaf0682e7e670fecbaf2cdc9ed1c35647f04f,4,9,9,18,9,2013-06-22 12:08:11,2013-06-22 12:08:11
102aaf0682e7e670fecbaf2cdc9ed1c35647f04f...96f3a88c0111b56cce8ac77b7c48225510b2b73b,1,4,4,8,3,2013-06-22 12:11:23,2013-06-22 12:11:23
96f3a88c0111b56cce8ac77b7c48225510b2b73b...529feb4b40bacf2a35cd76501ec1b56788bc9b14,4,9,7,16,7,2013-06-22 13:00:39,2013-06-22 13:00:39
529feb4b40bacf2a35cd76501ec1b56788bc9b14...7b87fcbad42c57317f34d178b83176a96e914ebd,2,2,3,5,2,2013-06-22 13:46:57,2013-06-22 13:46:57
7b87fcbad42c57317f34d178b83176a96e914ebd...248ece76e51014700733727e553a428e2f85579d,2,3,3,6,3,2013-06-22 13:48:34,2013-06-22 13:48:34
248ece76e51014700733727e553a428e2f85579d...e45179c9b4d0504def48f00cfe4b97463b090614,9,18,47,65,16,2013-06-22 15:57:34,2013-06-22 15:57:34
e45179c9b4d0504def48f00cfe4b97463b090614...95791316f4037273af7b747ce1851d5f4e46933f,5,14,9,23,11,2013-06-22 20:57:29,2013-06-22 20:57:29
313ac55539ab93110d070e17811480092d55d8ce...74c8a635ce27336cd385d438291b22e921f88e1c,2,54,17,71,7,2013-06-13 19:58:27,2013-06-13 19:58:27
74c8a635ce27336cd385d438291b22e921f88e1c...1cbfc8d0af7dabb88da8628d5706f7e721ce90ce,2,8,5,13,5,2013-06-14 05:37:55,2013-06-14 05:37:55
1cbfc8d0af7dabb88da8628d5706f7e721ce90ce...a8bcb9a5d583170dcf375def4dc4a980713c280c,1,3,5,8,3,2013-06-14 09:58:12,2013-06-14 09:58:12
6e35aceff29ddeae6282de31e81e48446ab927fa...d274ca3888b1d099fc80ba135754df81243cee6e,2,5,19,24,9,2013-06-19 16:38:43,2013-06-19 16:38:43
6e35aceff29ddeae6282de31e81e48446ab927fa...cf8b465cb96f5aa6e53fec60c0d6e62ad1ccbc5e,6,17,16,33,7,2013-06-19 15:32:08,2013-06-19 15:32:08
cf8b465cb96f5aa6e53fec60c0d6e62ad1ccbc5e...b3ef63a0a547610ba8ac6435674eabc5a2130c3d,12,7,98,105,12,2013-06-19 16:48:48,2013-06-19 16:48:48
6e35aceff29ddeae6282de31e81e48446ab927fa...63a67bb4abff7690ef5f1c91b924c6aaf7f90985,2,38,63,101,12,2013-06-19 14:48:43,2013-06-19 14:48:43
63a67bb4abff7690ef5f1c91b924c6aaf7f90985...a3b42b6fa13991440aeb75264f865329cff719a3,2,0,16,16,2,2013-06-19 15:24:18,2013-06-19 15:24:18
9da7b2e8d8ed08cb193af2babf150cb8c7715f80...41332212005d2a6d2d2131bc30c29bd29b81453e,2,16,9,25,11,2013-01-31 08:48:51,2013-01-31 08:29:36
9da7b2e8d8ed08cb193af2babf150cb8c7715f80...bcc0eed3e4565a346d15a17a90722ebb0c3cefab,1,13,0,13,1,2013-01-31 06:46:59,2013-01-31 06:46:59
bcc0eed3e4565a346d15a17a90722ebb0c3cefab...563c55eb7e4db988048bd1b2675ee73e0e601402,2,2,2,4,2,2013-01-31 06:55:31,2013-01-31 06:55:31
563c55eb7e4db988048bd1b2675ee73e0e601402...193a5624b2daf4d638c382b88001d06535f57f2d,17,134,5,139,23,2013-01-31 07:11:35,2013-01-31 07:11:35
193a5624b2daf4d638c382b88001d06535f57f2d...315fd7d746aebe3456d5cc87caf0416cb83ea671,1,1,1,2,1,2013-01-31 08:08:20,2013-01-31 08:08:20
315fd7d746aebe3456d5cc87caf0416cb83ea671...130f60d55b13682cc4ca4cba390535dc10dbca07,14,50,80,130,23,2013-01-31 09:22:06,2013-01-31 09:22:06
130f60d55b13682cc4ca4cba390535dc10dbca07...2af323bbd1993b121b2ff7bcc695e2bb10af5a1b,4,8,4,12,4,2013-01-31 10:08:56,2013-01-31 10:08:56
e3c3c67b25e2601194293885818ff4dfb39885cd...ce0ec05c6371e055e9cc90e6239cafc015a6a69b,2,42,56,98,2,2013-01-27 16:47:19,2013-01-27 16:47:19
6ab6c55de5516ac636b5ca1147c1d1f81831c599...e33debc2147966525246bad999d0cacc4e676585,23,593,255,848,90,2013-01-27 17:27:32,2012-12-01 12:49:21
b4f16faafd5bff1683996152b49342743a0f1a8b...1c5876eb7b2deb069d919bd19b51c9f6218e0f41,12,90,52,142,24,2013-01-28 15:22:45,2013-01-28 15:22:45
1c5876eb7b2deb069d919bd19b51c9f6218e0f41...8b54b7233ef58a2a39da9777dbeab59b4024cc75,5,35,11,46,10,2013-01-28 15:39:02,2013-01-28 15:39:02
8b54b7233ef58a2a39da9777dbeab59b4024cc75...9ad5fbb416b00bf87c5f5ab3e1ee7ac5d5378b64,1,1,1,2,1,2013-01-28 15:46:24,2013-01-28 15:46:24
9ad5fbb416b00bf87c5f5ab3e1ee7ac5d5378b64...f7ade3b682a104dca76b0eb4e9a0fbc62cfd9cf7,1,2,1,3,2,2013-01-28 15:53:01,2013-01-28 15:53:01
d41e404e09c79394ff1938eee01b56345edc6ed9...29cfd33d949d21d67f3892473c24d4f0a127dfe6,27,424,46,470,53,2014-02-14 04:59:39,2014-02-09 03:08:49
d41e404e09c79394ff1938eee01b56345edc6ed9...aaad7fd973d88a49fe23f01cca6b2248ad7977d4,1,13,5,18,2,2014-02-13 19:09:11,2014-02-13 19:09:11
d41e404e09c79394ff1938eee01b56345edc6ed9...cf9c8e7382254b7abc928ec5af093da736d1ec3f,1,36,0,36,2,2014-02-13 13:25:43,2014-02-13 13:25:43
d41e404e09c79394ff1938eee01b56345edc6ed9...9d8c8275f8e7ef24263d9cbb9161a9487972581b,1,2,0,2,1,2014-02-13 12:30:06,2014-02-13 12:30:06
d41e404e09c79394ff1938eee01b56345edc6ed9...af9d7fafa9089e51db60f43b60a4fedebe053843,5,42,12,54,8,2014-02-13 09:00:44,2014-02-13 09:00:44
af9d7fafa9089e51db60f43b60a4fedebe053843...0f134e54dd4b6044deb3042787602fde938436e5,1,1,0,1,1,2014-02-13 09:06:35,2014-02-13 09:06:35
0f134e54dd4b6044deb3042787602fde938436e5...13ecbb04bc4deeddec49ccad6e9c1538bbc405d4,2,2,1,3,2,2014-02-13 11:57:11,2014-02-13 11:57:11
13ecbb04bc4deeddec49ccad6e9c1538bbc405d4...abb3121308d6317fdcc103ca463dc7c0cb9077dc,3,2,2,4,3,2014-02-13 11:59:07,2014-02-13 11:59:07
abb3121308d6317fdcc103ca463dc7c0cb9077dc...1d48904ac807c6d382c8965329085b321381cc3d,3,12,2,14,3,2014-02-13 13:45:24,2014-02-13 13:45:24
1d48904ac807c6d382c8965329085b321381cc3d...f0f88390c1309b0d5a8cead701477e21c2174f05,7,98,13,111,9,2014-02-13 14:08:26,2014-02-13 14:08:26
f0f88390c1309b0d5a8cead701477e21c2174f05...67798492bc5409b5a596fa28022e1e6cdf5985e4,3,5,3,8,5,2014-02-13 14:16:23,2014-02-13 14:16:23
67798492bc5409b5a596fa28022e1e6cdf5985e4...9b5728057e1d0a47fd2923c3b2fa2248edebafac,7,154,141,295,21,2014-02-13 17:59:09,2014-02-13 17:59:09
9b5728057e1d0a47fd2923c3b2fa2248edebafac...ea1e92a0b660ebf2bcc99015301a367fe947d84b,4,31,4,35,6,2014-02-14 10:30:12,2014-02-14 10:30:12
ea1e92a0b660ebf2bcc99015301a367fe947d84b...fd12e5c604f63516bc09c53f7fde52bc3a5cd494,1,6,2,8,4,2014-02-14 10:42:08,2014-02-14 10:42:08
80f34cfbc79da8380aa93fab469fb00e5e6d62a6...36462d77b56d2ed94c6dcd95ef3c529b6edf96d4,1,9,3,12,2,2014-02-12 13:49:31,2014-02-12 13:49:31
a516a8469b73a7d1bc8d3ccc163fbd1e85a557a5...84af998aea2682f4f03586d3d65cffce843cd071,1,3,2,5,2,2013-11-11 21:03:45,2013-11-11 21:03:45
986697a99bde07ea0d7e878f8618f801b6b81a8c...b983e9ef0a599c591606d30a450b9fe7e78c6c85,3,23,6,29,4,2013-11-12 08:19:23,2013-11-12 08:19:23
c6bc57c1a79a7add81c484d65d9795bec721e7e2...ccd842c3a7742d1d99a13a32ea725032810f2690,1,3,3,6,3,2014-11-11 12:52:30,2014-11-11 12:52:30
ccd842c3a7742d1d99a13a32ea725032810f2690...2139e3519b1f1023478bec087cf94f2ec237c0c7,4,167,94,261,4,2014-11-11 14:49:26,2014-11-11 14:49:26
c6bc57c1a79a7add81c484d65d9795bec721e7e2...07cca8cc0c5bd6913e55c99a0493dc2f92dcdbb5,1,22,62,84,21,2014-11-11 09:47:44,2014-11-11 09:47:44
07cca8cc0c5bd6913e55c99a0493dc2f92dcdbb5...1d1b21164258c2e2a6e1d782e517871c33ea961d,1,27,4,31,3,2014-11-11 10:01:47,2014-11-11 10:01:47
1d1b21164258c2e2a6e1d782e517871c33ea961d...a15dc7b8141e4aa981409bffd2bb6ad311902dfa,1,2,0,2,1,2014-11-11 10:22:05,2014-11-11 10:22:05
faafde2d2b8dc3457c45aa87e6dd280bfdd13dde...9d61ea55d15aa5b201d9be6145d4c70db4fd0de8,1,2,1,3,1,2014-02-11 09:39:13,2014-02-11 09:39:13
faafde2d2b8dc3457c45aa87e6dd280bfdd13dde...9d3d0a9e1804929618dc4ddb90267e11a45605c1,2,2,2,4,2,2014-02-11 09:03:44,2014-02-11 09:03:44
faafde2d2b8dc3457c45aa87e6dd280bfdd13dde...41adbc0b944501501f7334691cd9d10b21a7fe27,1,1,1,2,1,2014-02-11 08:53:07,2014-02-11 08:53:07
5e935bfec6cefe0f295858e0d3eddc2d80a91dbd...91e7692b66f8916f634af6cf1d2dc1a459699733,1,6,1,7,2,2014-02-18 18:38:22,2014-01-30 12:11:19
5e935bfec6cefe0f295858e0d3eddc2d80a91dbd...c131c185acafeed355a255d90892145ae689781a,1,12,0,12,1,2014-02-14 04:50:02,2014-02-14 04:50:02
253850dd6d1da28758631f7b1945666fd489c8a5...babba432f1387cb53298e976ca406cac28d272e5,1,1,1,2,1,2013-10-16 08:47:10,2013-10-16 08:47:10
253850dd6d1da28758631f7b1945666fd489c8a5...d378332ff9d05d1ab3d7661a4fbea99188225d8f,2,26,1,27,3,2013-10-16 08:38:13,2013-10-16 08:38:13
253850dd6d1da28758631f7b1945666fd489c8a5...b4c85f067655ae1482a8902bec1394914e398da5,1,1,1,2,1,2013-10-16 07:05:52,2013-10-16 07:05:52
253850dd6d1da28758631f7b1945666fd489c8a5...5b0abbcbc3dd368ecca4c55432d287de9a1838ef,1,1,1,2,1,2013-10-16 07:01:31,2013-10-16 07:01:31
03dba1fd4299e7a0364aa94a845aaeca60b0c286...399e6341122c864bc01887b62f80c961186b49c2,1,8,2,10,1,2013-10-17 06:48:35,2013-10-17 06:48:35
399e6341122c864bc01887b62f80c961186b49c2...91a31d767f0e134153129e42bd16d5f67f401054,1,1,1,2,1,2013-10-17 07:01:48,2013-10-17 07:01:48
91a31d767f0e134153129e42bd16d5f67f401054...7b70d81c831d3e033993ef571e085bfee28ae590,2,3,6,9,4,2013-10-17 07:52:38,2013-10-17 07:52:38
7b70d81c831d3e033993ef571e085bfee28ae590...60e2a6563d3343fde2a4db935ee1da207c847d5e,2,5,2,7,3,2013-10-17 09:27:09,2013-10-17 09:27:09
60e2a6563d3343fde2a4db935ee1da207c847d5e...a4de8f71c7a268c637d3876caa8bf6388d8e5620,1,2,1,3,2,2013-10-17 09:31:49,2013-10-17 09:31:49
a4de8f71c7a268c637d3876caa8bf6388d8e5620...13c192d44c474a47db16f51458847a29267ad516,1,1,1,2,1,2013-10-17 09:32:00,2013-10-17 09:32:00
13c192d44c474a47db16f51458847a29267ad516...fd39c80f8b4a7c98e0da62bf7e7f29ee192887ca,1,1,0,1,1,2013-10-17 09:33:39,2013-10-17 09:33:39
c465636a7c3476a5d63c52d0a0160f5f484c3b12...67a80d07ab1791489e4ef39b7a340613f1da520d,2,67,39,106,34,2013-10-24 12:56:17,2013-10-24 12:55:40
c465636a7c3476a5d63c52d0a0160f5f484c3b12...8387806604b102c9c4d5aa179160c529b9006a30,1,0,1,1,1,2013-10-24 12:46:54,2013-10-24 12:46:54
024a37ce20865d2d29b86d15936746f19250ef3d...cddec75dc1e309483aa80ea4533ff972507686ef,2,32,32,64,13,2013-10-24 15:17:53,2013-10-24 15:17:53
d65eb22e2d5f0de8984855919d644a562003b9b2...cbe9f56afae2b1e55de96f59eed36859eea6eb82,5,47,4,51,8,2013-07-16 21:09:23,2013-07-16 21:09:23
4a72f5d82aa3f69e747c51dc9e021d90fa3dd816...98e1597f8c4a3c55018a8d1f29a8462d2404dadf,2,2,2,4,2,2013-07-18 11:11:17,2013-07-18 11:11:17
f77918c3afa25f73a18e1fb2963adb3d833771e3...c7a64311b198081b94cde4214e0509d15fb79130,1,3,72,75,5,2013-04-10 17:00:56,2013-04-10 17:00:56
c7a64311b198081b94cde4214e0509d15fb79130...86e368a8af35fb0f09369630a226c80dc16ae5ec,1,41,55,96,11,2013-04-10 17:27:43,2013-04-10 17:27:43
86e368a8af35fb0f09369630a226c80dc16ae5ec...0415566b3796f500e7f694a0aee4882752d150c1,3,0,385,385,3,2013-04-10 17:48:21,2013-04-10 17:48:21
0415566b3796f500e7f694a0aee4882752d150c1...0ae892007dac045e58cab793806f778b90ce6c2e,6,11,106,117,7,2013-04-10 19:20:00,2013-04-10 19:20:00
0ae892007dac045e58cab793806f778b90ce6c2e...001f3bc59ef34752b98ab405fde2520b15eff51c,12,99,112,211,47,2013-04-10 20:28:42,2013-04-10 20:28:42
001f3bc59ef34752b98ab405fde2520b15eff51c...7786fe7ca84503ac2f00253f7097c754c51c1062,5,2,26,28,6,2013-04-10 20:48:40,2013-04-10 20:48:40
7786fe7ca84503ac2f00253f7097c754c51c1062...c351b8a3e53c05c73f3365cc738c9437e8774392,5,7,12,19,10,2013-04-11 06:39:49,2013-04-11 06:39:49
c351b8a3e53c05c73f3365cc738c9437e8774392...1743cbf1d8f7fde1595c6b95a417f8a5e2f4d62c,6,44,45,89,29,2013-04-11 07:45:18,2013-04-11 07:45:18
1743cbf1d8f7fde1595c6b95a417f8a5e2f4d62c...630c547dbdfd688da4efced9428779f228242ef2,2,15,33,48,13,2013-04-11 08:03:57,2013-04-11 08:03:57
630c547dbdfd688da4efced9428779f228242ef2...b8ba0b759cd474c7097078057cad40fb8922f4e0,2,6,6,12,6,2013-04-11 08:25:11,2013-04-11 08:25:11
b8ba0b759cd474c7097078057cad40fb8922f4e0...6dcbd646ddc629258b017b2d08f2b98c076eb1c3,2,9,1,10,3,2013-04-11 08:50:58,2013-04-11 08:50:58
6dcbd646ddc629258b017b2d08f2b98c076eb1c3...e996c52636f46b193b5ff7291e9b835c317e5438,1,60,53,113,18,2013-04-11 09:54:26,2013-04-11 09:54:26
d0f3e993c56ab41be562a6802d0b8f3a71cafe85...c64ee6ac3390560a782011bcc261162de88375a9,3,3,3,6,3,2013-07-07 09:30:31,2013-07-07 09:30:31
d6ab5ad3066995e1013dfb18707304c911f0a7c0...b8f51acf7bf72fb832be7aefe8d7009f2a23a0f0,1,1,1,2,1,2013-07-03 17:34:23,2013-07-03 17:34:23
d6ab5ad3066995e1013dfb18707304c911f0a7c0...702dc30448b6f1c5f4f3e45a9b170c2bcc0a2f15,1,1,1,2,1,2013-07-03 10:57:35,2013-07-03 10:57:35
ee890f2b2a66be925746f2238dc462a74b0fd219...15bc1223c79a8cfbc558b2eaaca06994e0272333,9,26,25,51,20,2013-07-02 11:06:25,2013-07-02 11:06:25
15bc1223c79a8cfbc558b2eaaca06994e0272333...3802ae0cfa17dbe33d09e3d006b162fa9ab1c256,1,1,0,1,1,2013-07-02 11:26:13,2013-07-02 11:26:13
3802ae0cfa17dbe33d09e3d006b162fa9ab1c256...44ac961b8d7e07f794330b6e527c50b437923fb5,5,40,18,58,17,2013-07-03 17:10:27,2013-07-03 17:10:27
44ac961b8d7e07f794330b6e527c50b437923fb5...5f0b50db7aaa3d10bf2b49d5fb7ca55d6f3ccd10,1,7,2,9,2,2013-07-04 11:32:02,2013-07-04 11:32:02
5f0b50db7aaa3d10bf2b49d5fb7ca55d6f3ccd10...5067e9dc88b5bf4d1aae06a8c12bb05d082f4f74,4,17,9,26,8,2013-07-04 14:10:34,2013-07-04 14:10:34
5067e9dc88b5bf4d1aae06a8c12bb05d082f4f74...96448d1b7b48820a10bd0fff0ba95de56117e7e8,2,5,5,10,3,2013-07-05 12:19:31,2013-07-05 12:19:31
96448d1b7b48820a10bd0fff0ba95de56117e7e8...7ee53643cfb10ad9620041d9e47cdb13f3bc2538,1,1,1,2,1,2013-07-06 07:58:33,2013-07-06 07:58:33
7ee53643cfb10ad9620041d9e47cdb13f3bc2538...2643ee72a9c1735fd045d751f0f56a286ea0759c,1,2,2,4,1,2013-07-06 07:59:00,2013-07-06 07:59:00
2643ee72a9c1735fd045d751f0f56a286ea0759c...1738c17f331ca84700e028b653c3c4cb5b1eb7a8,2,3,3,6,3,2013-07-06 09:13:28,2013-07-06 09:13:28
1738c17f331ca84700e028b653c3c4cb5b1eb7a8...db11c1fd88660c3cf49ddb737f2b709981c0f554,2,3,3,6,3,2013-07-08 04:38:19,2013-07-08 04:38:19
db11c1fd88660c3cf49ddb737f2b709981c0f554...2882d16e7a244d6627d9f6d9436651a38bf11bad,1,3,35,38,8,2013-07-08 04:55:16,2013-07-08 04:55:16
c04e9733273e24b831cdbd44c9cc4057f7380578...9f2e1b33a44aecf5a4cf2d450df313f026e4409b,1,11,0,11,1,2013-07-07 17:30:29,2013-07-07 17:30:29
c04e9733273e24b831cdbd44c9cc4057f7380578...db325ef940e7c084d3a9daf0a5efec2b2580004b,1,1,1,2,1,2013-07-07 17:00:07,2013-07-07 17:00:07
9ee86156db9f6bc9f746711e25fbfb8343aee23e...7ebbb6e33f872651c8f92799570d58353a4a08b3,2,11,1,12,2,2013-07-08 10:59:56,2013-07-08 10:59:56
20ed39e781fc49bd4ec6e04e862ebd4ece53a15b...32e029d2618dd657d4f8063325a87ec5e4713f15,1,1,1,2,1,2013-06-24 16:54:08,2013-06-24 16:54:08
82271e78181b91cb4294cfb2f4aa790bd54343b6...c00917e48fcfb45c686a164fe706a9c17e6797da,1,15,13,28,2,2013-06-25 08:49:09,2013-06-25 08:49:09
95791316f4037273af7b747ce1851d5f4e46933f...2ed7cbfba4ff3c6a4cf3e72515a0375544998de0,172,198,201,399,129,2013-06-23 16:47:22,2013-06-23 16:47:22
2ed7cbfba4ff3c6a4cf3e72515a0375544998de0...40bca5246b6e1cea36932c5e0eae89a63d8f0a03,6,100,100,200,62,2013-06-23 17:25:06,2013-06-23 17:25:06
a8bcb9a5d583170dcf375def4dc4a980713c280c...b4e8fea274ff18717391e1c220342d82b965a22f,3,106,87,193,21,2013-06-14 11:42:55,2013-06-14 11:42:55
b4e8fea274ff18717391e1c220342d82b965a22f...977146f568794b56d955efd4b7df8ecaf9c97599,1,4,0,4,1,2013-06-14 12:03:22,2013-06-14 12:03:22
977146f568794b56d955efd4b7df8ecaf9c97599...a59fe739fe05bcdf0eed06f1aea276a1236c32d2,1,4,1,5,1,2013-06-14 12:17:47,2013-06-14 12:17:47
a8bcb9a5d583170dcf375def4dc4a980713c280c...815c186b29e801377ab552ecf3665c7732a61415,1,26,28,54,1,2013-06-14 11:08:21,2013-06-14 11:08:21
4a53e0285c9f823cde7cf8dec9d065952b707864...93e003aa61e885fe129b9678b1894e485c25c81c,1,3,1,4,2,2013-06-19 16:54:10,2013-06-19 16:54:10
93e003aa61e885fe129b9678b1894e485c25c81c...8e737ed54235ba0d296d25bc24f2f00e986c1507,3,14,8,22,4,2013-06-19 18:58:52,2013-06-19 18:58:52
8e737ed54235ba0d296d25bc24f2f00e986c1507...1811d32e23f2c7c4c76f4e868ab3b5850f6addb3,18,190,201,391,26,2013-06-19 19:44:57,2013-06-19 19:44:57
1811d32e23f2c7c4c76f4e868ab3b5850f6addb3...cc2145da80abe53052598b062d7853efdf225d8b,3,24,42,66,11,2013-06-19 19:52:57,2013-06-19 19:52:57
cc2145da80abe53052598b062d7853efdf225d8b...3d978f065f184beb10ef6652c08a19f672ebcb91,1,6,12,18,2,2013-06-19 19:55:49,2013-06-19 19:55:49
3d978f065f184beb10ef6652c08a19f672ebcb91...c54d07b9ed083fe5739cc0e467eaf79b2deda255,1,6,0,6,1,2013-06-19 20:03:43,2013-06-19 20:03:43
c54d07b9ed083fe5739cc0e467eaf79b2deda255...5a2111526dd7a255f74c98b95eeefc578ab0f444,8,18,14,32,7,2013-06-20 08:32:59,2013-06-20 08:32:59
5a2111526dd7a255f74c98b95eeefc578ab0f444...38a9fc4f4701ff3f2d1a06e8567f45d1bb9fb9c6,2,12,5,17,3,2013-06-20 08:46:54,2013-06-20 08:46:54
38a9fc4f4701ff3f2d1a06e8567f45d1bb9fb9c6...86d9ed9a0a9d58c09b89da08dd4216b89a2025a2,2,1,8,9,2,2013-06-20 09:06:44,2013-06-20 09:06:44
86d9ed9a0a9d58c09b89da08dd4216b89a2025a2...f47ba909a29f70d59180a373b9a89dd8935fd455,8,63,60,123,13,2013-06-20 10:14:23,2013-06-20 10:14:23
f47ba909a29f70d59180a373b9a89dd8935fd455...2864aca48c11d4f50471b988d9f11fec7b8f825b,2,6,3,9,3,2013-06-20 10:29:17,2013-06-20 10:29:17
2864aca48c11d4f50471b988d9f11fec7b8f825b...4d149ac8a9103f5249eb8641879b8643304723a0,2,5,2,7,2,2013-06-20 12:59:39,2013-06-20 12:59:39
4d149ac8a9103f5249eb8641879b8643304723a0...1ecdfb46a46a1725c47df33c786f1d059a2ab97e,1,1,1,2,1,2013-06-21 05:51:15,2013-06-21 05:51:15
1ecdfb46a46a1725c47df33c786f1d059a2ab97e...7e4ee824ab4cfedba72e742331536a6e207f7f2d,1,1,1,2,1,2013-06-21 06:19:31,2013-06-21 06:19:31
7e4ee824ab4cfedba72e742331536a6e207f7f2d...2c482097fc8028ec9f96d268c42016720aaf9be8,1,0,9,9,1,2013-06-21 13:16:05,2013-06-21 13:16:05
2c482097fc8028ec9f96d268c42016720aaf9be8...b1dbabdec30d8e03afb0155b9494cfe2ef351352,1,9,4,13,3,2013-06-21 13:36:28,2013-06-21 13:36:28
b1dbabdec30d8e03afb0155b9494cfe2ef351352...d0efe2c07cdbd13698bfb70f9be7157ec4f7245b,1,1,3,4,2,2013-06-21 13:42:59,2013-06-21 13:42:59
d0efe2c07cdbd13698bfb70f9be7157ec4f7245b...8c918e583a5a0ec4c0c904522730215b2d147ae6,1,0,7,7,1,2013-06-21 18:50:34,2013-06-21 18:50:34
8c918e583a5a0ec4c0c904522730215b2d147ae6...c78393ec1714daaa01313793cdc3fa2e98378d7a,5,25,35,60,11,2013-06-21 19:08:16,2013-06-21 19:08:16
c78393ec1714daaa01313793cdc3fa2e98378d7a...c3c849927d42c4ba5431b3970dab63fdb89b77f5,1,11,1,12,2,2013-06-21 19:29:30,2013-06-21 19:29:30
c3c849927d42c4ba5431b3970dab63fdb89b77f5...be26d2724bc710bdc0cb2327830aff84ce61fba2,1,4,2,6,3,2013-06-21 19:34:38,2013-06-21 19:34:38
be26d2724bc710bdc0cb2327830aff84ce61fba2...0273b79b92fb38086f14f2a44e621c37c35cc748,1,2,5,7,2,2013-06-21 19:38:43,2013-06-21 19:38:43
0273b79b92fb38086f14f2a44e621c37c35cc748...e8e9e0f771c34cf45e9c42f69de4da6b747f07e0,1,15,1,16,2,2013-06-21 19:44:40,2013-06-21 19:44:40
e8e9e0f771c34cf45e9c42f69de4da6b747f07e0...7384541b345169a829c4c9f2b63bf71fd223d9b9,1,1,1,2,1,2013-06-21 19:47:49,2013-06-21 19:47:49
7384541b345169a829c4c9f2b63bf71fd223d9b9...f0606451194db37f897f2f487f8ab855271674a5,1,5,0,5,1,2013-06-21 20:17:20,2013-06-21 20:17:20
f0606451194db37f897f2f487f8ab855271674a5...f3cbbfe020678d6734573bc3f21b53f8c2668070,1,15,0,15,1,2013-06-21 20:17:41,2013-06-21 20:17:41
f3cbbfe020678d6734573bc3f21b53f8c2668070...fe514b17ab6de8c9d1f091e50e94aaf27183aa6d,7,68,47,115,12,2013-06-21 20:17:58,2013-06-21 20:17:58
fe514b17ab6de8c9d1f091e50e94aaf27183aa6d...99eb96075dbfc87d401e544888dfe718711e0a84,1,1,1,2,1,2013-06-21 20:19:30,2013-06-21 20:19:30
99eb96075dbfc87d401e544888dfe718711e0a84...3208dad1e7e0c1eeb638e5a2779a290ed9c3e73a,1,4,0,4,1,2013-06-21 20:21:55,2013-06-21 20:21:55
3208dad1e7e0c1eeb638e5a2779a290ed9c3e73a...4c9e47f6e054649eefd453089d1658b9508c16fc,1,8,8,16,5,2013-06-21 20:36:02,2013-06-21 20:36:02
4c9e47f6e054649eefd453089d1658b9508c16fc...ede746bf079dd45ac1e2f701e8a9019dba8e0417,3,2,3,5,3,2013-06-21 20:47:42,2013-06-21 20:47:42
ede746bf079dd45ac1e2f701e8a9019dba8e0417...fdf7fc044ae1666a0d7dfb9a0022c48dfa3d7231,2,3,3,6,3,2013-06-21 21:02:09,2013-06-21 21:02:09
fdf7fc044ae1666a0d7dfb9a0022c48dfa3d7231...6577d3a49cf6f21b1e044339f9cb984a67e9fdab,2,2,1,3,2,2013-06-21 21:06:21,2013-06-21 21:06:21
6577d3a49cf6f21b1e044339f9cb984a67e9fdab...dc0f08f8d807c363e082f9ada7a1addeefdb554d,2,13,0,13,2,2013-06-21 21:11:06,2013-06-21 21:11:06
dc0f08f8d807c363e082f9ada7a1addeefdb554d...1dd6606161bea762cefe14c7a39f79a8c0b43dd7,3,24,6,30,3,2013-06-22 07:56:51,2013-06-22 07:56:51
1dd6606161bea762cefe14c7a39f79a8c0b43dd7...9de23248d8f3d6464d329b979ccfe98c23eb4aa3,3,18,2,20,3,2013-06-22 08:02:31,2013-06-22 08:02:31
df6db81e2ab36410c377f8a9a712756653de0e2a...2c7554e897356fe424f292c66cd03e0192b05167,4,152,5,157,7,2013-01-31 09:26:03,2013-01-28 17:22:44
0949c01093770e66a5fd5354c166e1ae6bd6742c...bccc2729ef3bcebf344903e73cc8b3f7f03bd242,1,14,2,16,3,2014-02-12 16:42:56,2014-02-12 16:42:56
0949c01093770e66a5fd5354c166e1ae6bd6742c...a36f5730b04da9e745f9643908154b89b7249d5c,1,1,1,2,1,2014-02-12 14:45:36,2014-02-12 14:45:36
80b113705d2f538b1bc1d2f92206c4b91fc61a33...00d6ac299e073b3117ea9d730fbffa9ef7e3b8a0,1,2,1,3,1,2013-11-12 08:36:09,2013-11-12 08:36:09
5cf5c177df6b4b999e8a687b029449060ff40d5e...ee993dfc645bbe98431d3181e0d544d50b13c4de,1,4,3,7,1,2014-02-15 21:46:02,2014-02-15 21:46:02
5cf5c177df6b4b999e8a687b029449060ff40d5e...b6a609edbc1e46c72980b577e482b76f85dd39fc,2,131,126,257,11,2014-02-15 11:35:20,2014-02-15 11:35:20
b6a609edbc1e46c72980b577e482b76f85dd39fc...87415ab2a67495713be5da79a60c1ec26060be9b,9,10,8,18,9,2014-02-15 11:41:48,2014-02-15 11:41:48
87415ab2a67495713be5da79a60c1ec26060be9b...d7310fe7a9fcfec4fa49e6f5cd64899604155633,1,8,4,12,4,2014-02-15 12:01:08,2014-02-15 12:01:08
d7310fe7a9fcfec4fa49e6f5cd64899604155633...e702928fbacfee00e248f3ffe3382e5ea259f816,1,2,2,4,2,2014-02-15 12:11:31,2014-02-15 12:11:31
e702928fbacfee00e248f3ffe3382e5ea259f816...1701144b41b2a7507cec2fab4d8a045cf71f4c98,1,4,0,4,1,2014-02-15 12:14:50,2014-02-15 12:14:50
1701144b41b2a7507cec2fab4d8a045cf71f4c98...db961b8b46497c4626a4d9479e3e20c308e83a57,3,18,23,41,9,2014-02-15 12:31:01,2014-02-15 12:31:01
db961b8b46497c4626a4d9479e3e20c308e83a57...1e106756fa12d91e233adee740e338e3846939ac,2,13,5,18,5,2014-02-15 12:36:58,2014-02-15 12:36:58
1e106756fa12d91e233adee740e338e3846939ac...99fd58ce4af0e18a6f4252597985269aa5e2b635,4,15,12,27,7,2014-02-15 12:52:33,2014-02-15 12:52:33
2350c11c87894c5a96ecadd58267e116624dea8d...116f73b540ba0249e8df1da97fd4189b0327ebce,1,7,0,7,1,2014-11-11 16:48:39,2014-11-11 16:48:39
8dc9cb3ddb2aae7d5ba4ad065932a4f4f2e7892e...af154478675f9e3d970dbd9339e0ed23c23a7eec,1,20,0,20,1,2014-11-11 15:09:58,2014-11-11 15:09:58
af154478675f9e3d970dbd9339e0ed23c23a7eec...3dcb5f8501e6eedb41c5d8a83eff1e3b80822f1d,2,2,0,2,2,2014-11-11 15:10:24,2014-11-11 15:10:24
3dcb5f8501e6eedb41c5d8a83eff1e3b80822f1d...d65f2bad6c7f834b708886f1ee8160a67281638d,2,11,0,11,1,2014-11-11 15:30:14,2014-11-11 15:30:14
d65f2bad6c7f834b708886f1ee8160a67281638d...857852ce048607a0898a9b40e04fdb0658b6a83d,2,24,12,36,4,2014-11-12 10:59:57,2014-11-12 10:59:57
9d61ea55d15aa5b201d9be6145d4c70db4fd0de8...c187d2795555e88f7e363399cad11f45cc778d19,1,2,1,3,1,2014-02-14 14:45:41,2014-02-14 14:45:41
87a449f264684551d0b9cdfa9ed2d32f21110adb...ddbe978041753d7851780165f8c6c66865570862,7,192,49,241,9,2014-02-18 10:27:02,2014-02-18 10:27:02
ddbe978041753d7851780165f8c6c66865570862...6cf39fe10ddf6f90a17d52ba6b50425f58215eeb,9,249,209,458,9,2014-02-18 10:41:21,2014-02-18 10:41:21
87a449f264684551d0b9cdfa9ed2d32f21110adb...3c742dad27d298fae9aa8ee68cf1a83178fb8704,2,3,3,6,2,2014-02-18 09:40:45,2014-02-18 09:40:45
615d859f9402116f66c18cb97f935400086f61cf...f3d77a7661a9933bd194ed6634f8383ac9fd0448,1,1,1,2,1,2013-10-16 11:39:09,2013-10-16 11:39:09
fd39c80f8b4a7c98e0da62bf7e7f29ee192887ca...7c3fd6941fa72b7a3827cb1cf83d387dd008050e,1,1,1,2,1,2013-10-17 10:16:57,2013-10-17 10:16:57
fd39c80f8b4a7c98e0da62bf7e7f29ee192887ca...73d19bb32030b6de61a0810b85187cb4f02a80fc,1,7,7,14,5,2013-10-17 10:01:29,2013-10-17 09:58:03
8387806604b102c9c4d5aa179160c529b9006a30...90086fe2dc3cf20754bd2a6dd7cfddea6de15b18,1,4,2,6,2,2013-10-25 07:39:31,2013-10-25 07:39:31
8387806604b102c9c4d5aa179160c529b9006a30...d9cb02f1a232b6dcb144332b3c7ec59e2a11ce37,1,153,0,153,1,2013-10-24 12:59:44,2013-10-24 12:59:44
cddec75dc1e309483aa80ea4533ff972507686ef...0f3ef9bed2fa631d1e3a7a9f52b3ebc0557eff38,1,1,0,1,1,2013-10-24 17:27:23,2013-10-24 17:27:23
cddec75dc1e309483aa80ea4533ff972507686ef...0f87ae3be5d7d1bc0a3728f43ae0465005b68b92,3,34,5,39,5,2013-10-24 15:23:26,2013-10-24 15:16:14
d20f78f70085b7a19df88f91e125fe76cf1b493e...c1c28d3ceadb51b0a676d19f5addf687f5e3e080,3,11,29,40,5,2013-07-16 21:46:27,2013-07-16 21:46:27
c1c28d3ceadb51b0a676d19f5addf687f5e3e080...29306dd6a41a20210bc30775a437a67649b99038,1,3,3,6,3,2013-07-17 05:15:55,2013-07-17 05:15:55
29306dd6a41a20210bc30775a437a67649b99038...9ea5766c3554843b88bfb65de48872ccd50363e7,4,11,3,14,5,2013-07-17 05:26:00,2013-07-17 05:26:00
9ea5766c3554843b88bfb65de48872ccd50363e7...d2284b4112b31ae4e2301a8433bb64b40fdad80f,1,13,8,21,2,2013-07-17 05:43:56,2013-07-17 05:43:56
d2284b4112b31ae4e2301a8433bb64b40fdad80f...403638b8a00735632c060ab32cc0c1a64937b935,5,46,3,49,6,2013-07-17 11:43:18,2013-07-17 11:43:18
403638b8a00735632c060ab32cc0c1a64937b935...2a37db4c9ee8353d2d576a9a7d0edf57e988634e,4,1,7,8,4,2013-07-17 11:53:23,2013-07-17 11:53:23
2a37db4c9ee8353d2d576a9a7d0edf57e988634e...8587e3a357add7371b2286f3ab642c9ea8f58e2e,4,36,12,48,10,2013-07-17 12:11:03,2013-07-17 12:11:03
8587e3a357add7371b2286f3ab642c9ea8f58e2e...dcac37d9e41f21485822647b922ac952bf64358a,5,49,50,99,10,2013-07-17 12:48:22,2013-07-17 12:48:22
2c191ab06c61b839c3addf6b2f7e5660675908a2...d3e94eef4afe4c6aac9e2fbf2db0e4e4b08b1cae,1,2,2,4,1,2013-07-18 13:36:01,2013-07-18 13:36:01
2c191ab06c61b839c3addf6b2f7e5660675908a2...089605fe6b9850ff87e1b1535d084b73e305d627,2,9,1,10,3,2013-07-18 13:33:12,2013-06-11 21:15:59
089605fe6b9850ff87e1b1535d084b73e305d627...1a31cb2c379291680cc67dad12f78294000632e3,1,3,3,6,3,2013-07-18 13:33:12,2013-06-26 14:49:29
1a31cb2c379291680cc67dad12f78294000632e3...d04f32866fdcd57b11fe9288f7e96df0ad793a67,1,2,0,2,1,2013-07-18 13:33:12,2013-07-11 17:05:01
e996c52636f46b193b5ff7291e9b835c317e5438...ae33fdf297e03866ecc6c31c5470dd5ad72d1328,19,268,6,274,22,2013-04-15 05:54:52,2013-03-19 15:37:50
ae33fdf297e03866ecc6c31c5470dd5ad72d1328...de8df1be1a75cfde02a5a1d3f52a888b770c54e0,2,53,29,82,13,2013-05-02 20:41:24,2013-05-02 19:30:13
de8df1be1a75cfde02a5a1d3f52a888b770c54e0...ec63804831d1a55171abfb7fc0894af20d4298e8,2,7,6,13,4,2013-05-02 20:41:33,2013-05-02 20:27:40
e996c52636f46b193b5ff7291e9b835c317e5438...ef2c8593b9f80951e97fadb5a3c9c5cdf0f1b1c9,2,18,10,28,13,2013-04-11 20:54:20,2013-04-11 20:54:20
ef2c8593b9f80951e97fadb5a3c9c5cdf0f1b1c9...67b82e90cf00b2ba6063e8203b4f449d890cf98d,3,13,13,26,6,2013-04-12 06:56:10,2013-04-12 06:56:10
cefd8fe2fac3e8056f48073529ffc52d1e0af678...6f5f5e7ee32bbd693796571fa6fcb8575accc08a,4,133,6,139,17,2013-07-08 06:47:31,2013-07-08 06:47:31
6ace422c298eef2c592d64c08f59b3da3d8d8a6d...fe4601361d0d713451a3ad6c398f45e8c7bd6211,1,1,1,2,1,2013-07-08 13:05:09,2013-07-08 13:05:09
fe4601361d0d713451a3ad6c398f45e8c7bd6211...66d6c809662980041fce66d182489c025475e7a7,1,1,1,2,1,2013-07-08 15:24:02,2013-07-08 15:24:02
66d6c809662980041fce66d182489c025475e7a7...87f4e1f153ef763bbdbd614f3c9e1f2ea4798830,1,138,0,138,1,2013-07-08 15:28:40,2013-07-08 15:28:40
87f4e1f153ef763bbdbd614f3c9e1f2ea4798830...967d42e0c8701c82d7d7494b1fd1d96cd4f2973f,2,2,2,4,2,2013-07-08 16:28:59,2013-07-08 16:28:59
967d42e0c8701c82d7d7494b1fd1d96cd4f2973f...63e532eff01ac927e7fa39781d9ebd61503c9a3e,6,10,8,18,9,2013-07-08 17:12:35,2013-07-08 17:12:35
63e532eff01ac927e7fa39781d9ebd61503c9a3e...5baac66992a1a4e3df4f9873632a9a083e52b92c,2,41,5,46,6,2013-07-09 07:44:47,2013-07-09 07:44:47
5baac66992a1a4e3df4f9873632a9a083e52b92c...f63cd42bab1afe48c795cf28e4d73ecfe156b6c0,2,31,34,65,6,2013-07-09 14:44:35,2013-07-09 14:44:35
f63cd42bab1afe48c795cf28e4d73ecfe156b6c0...b8c3f9a628d6830282743b4b419aaf4c37e060e9,2,20,0,20,3,2013-07-09 15:34:44,2013-07-09 15:34:44
b8c3f9a628d6830282743b4b419aaf4c37e060e9...03586c6c79e093046d46379885821ba9083a0d73,1,1,1,2,1,2013-07-09 17:51:49,2013-07-09 17:51:49
03586c6c79e093046d46379885821ba9083a0d73...3dcc441916e3d51ea29e292d7446ac9a1a4787cb,6,58,58,116,18,2013-07-09 17:52:06,2013-07-09 17:52:06
3dcc441916e3d51ea29e292d7446ac9a1a4787cb...223d26405128a64f624b78e7d4b03565d1e85a69,4,15,14,29,7,2013-07-10 10:48:03,2013-07-10 10:48:03
381638b77f68004dd9b5607eacceb3cee5b2bf3c...0d285c1cb167c327992a860764d28780e25f7812,1,0,6,6,1,2013-07-10 16:11:07,2013-07-10 16:09:48
7ebbb6e33f872651c8f92799570d58353a4a08b3...8dd6af1466079778fb6a91be9a3d32d7d90275a6,4,15,14,29,7,2013-07-10 10:48:50,2013-07-10 10:48:03
7ebbb6e33f872651c8f92799570d58353a4a08b3...ea5a006f27cfd3013f94652e0e0f0e63091036ad,5,138,3,141,7,2013-07-08 21:34:00,2013-06-27 21:49:26
7ebbb6e33f872651c8f92799570d58353a4a08b3...de680eb8c05d15c0a5ab3afe7da45cfc70d6e1fb,1,10,8,18,8,2013-07-08 16:52:10,2013-07-08 16:52:10
d41940d36ee8ff693a3c22d6c317e864b53792f0...d40e6bc228ce68cb3e77161e1ef62b039b41fef5,1,1,1,2,1,2013-06-25 09:02:10,2013-06-25 09:02:10
d40e6bc228ce68cb3e77161e1ef62b039b41fef5...8fb84104e4c50c77d1ec66ebf207b057fa58f043,1,4,4,8,3,2013-06-25 09:39:58,2013-06-25 09:39:58
8fb84104e4c50c77d1ec66ebf207b057fa58f043...746ffcfcbdd28a0965ab7d15860aa07977bc4c2f,2,41,26,67,8,2013-06-25 10:15:07,2013-06-25 10:15:07
746ffcfcbdd28a0965ab7d15860aa07977bc4c2f...c71697abc9dd5cf8ddc45f2972fbb51ee80db62d,1,2,2,4,2,2013-06-25 10:16:08,2013-06-25 10:16:08
c71697abc9dd5cf8ddc45f2972fbb51ee80db62d...367a5d1b32c154baea584c0ffe85253869bee415,1,7,0,7,2,2013-06-25 10:41:49,2013-06-25 10:41:49
367a5d1b32c154baea584c0ffe85253869bee415...dc917552641f88defa77f3ac7d68312ccccd21c4,3,36,17,53,6,2013-06-25 10:55:03,2013-06-25 10:55:03
dc917552641f88defa77f3ac7d68312ccccd21c4...11c9b06f7cf412cc61883e61899525fca33c7f1b,1,2,2,4,2,2013-06-25 11:12:38,2013-06-25 11:12:38
11c9b06f7cf412cc61883e61899525fca33c7f1b...d0529ad21df0bb2e67b17ac71a27aa47dbf5339f,1,1,1,2,1,2013-06-25 11:19:33,2013-06-25 11:19:33
d0529ad21df0bb2e67b17ac71a27aa47dbf5339f...0705a7a5070dfa74db1f51e71aa74376bc000f11,2,89,0,89,2,2013-06-25 13:49:27,2013-06-25 13:49:27
0705a7a5070dfa74db1f51e71aa74376bc000f11...58427749fd553ce802f037a7bdbbfd30f9df232a,2,18,0,18,2,2013-06-25 14:05:39,2013-06-25 14:05:39
58427749fd553ce802f037a7bdbbfd30f9df232a...0a0cdc6c61007675f92ff474d605dcf7b617a6be,2,3,2,5,3,2013-06-25 14:34:50,2013-06-25 14:34:50
0a0cdc6c61007675f92ff474d605dcf7b617a6be...db03bfa86838020d5add006f8e7714d4a0823c32,2,4,4,8,4,2013-06-26 11:41:03,2013-06-26 11:41:03
db03bfa86838020d5add006f8e7714d4a0823c32...a5dbe353549ad71ce2868d67dee5226ad8d46e63,2,12,1,13,2,2013-06-26 11:51:57,2013-06-26 11:51:57
a5dbe353549ad71ce2868d67dee5226ad8d46e63...112e919823a3286fe7224b01ee3cd87b48c66304,4,10,31,41,4,2013-06-26 12:02:28,2013-06-26 12:02:28
112e919823a3286fe7224b01ee3cd87b48c66304...a064060096aa99403f626544acaa307dea709e2d,2,9,0,9,2,2013-06-26 12:09:17,2013-06-26 12:09:17
a064060096aa99403f626544acaa307dea709e2d...21f7c99c25615961f6eed870b38ba8fba558b879,1,12,1,13,2,2013-06-26 12:32:09,2013-06-26 12:32:09
21f7c99c25615961f6eed870b38ba8fba558b879...1dd80d22a58d6407951e89eedcdbf21d340f9261,6,66,66,132,51,2013-06-26 12:57:02,2013-06-26 12:57:02
1dd80d22a58d6407951e89eedcdbf21d340f9261...f50cb7fc9fe7150337fef9b85e628dc540adc516,4,75,25,100,8,2013-06-26 13:58:56,2013-06-26 13:58:56
f50cb7fc9fe7150337fef9b85e628dc540adc516...9f087fb9e7d1891cd12ced9d40141a6d32510160,1,2,1,3,1,2013-06-26 15:15:50,2013-06-26 15:15:50
9f087fb9e7d1891cd12ced9d40141a6d32510160...3c4689c23c9d6f50e9facb48a8dc0a7344764ebf,1,12,1,13,2,2013-06-26 15:35:32,2013-06-26 15:35:32
3c4689c23c9d6f50e9facb48a8dc0a7344764ebf...01cf474fa1be16f1d342963829c775a4cb8a848b,1,1,0,1,1,2013-06-26 16:13:29,2013-06-26 16:13:29
01cf474fa1be16f1d342963829c775a4cb8a848b...467e7c10b5a9176509b50d5b5552bfeb0c86b587,1,4,2,6,3,2013-06-26 16:25:07,2013-06-26 16:25:07
467e7c10b5a9176509b50d5b5552bfeb0c86b587...6642709faa090107e13ab8ad5aa74f2949e73faf,1,2,2,4,2,2013-06-26 17:17:07,2013-06-26 17:17:07
6642709faa090107e13ab8ad5aa74f2949e73faf...318b50a0b3df4842cc33a15ff2019c948af15359,2,21,0,21,2,2013-06-26 17:54:51,2013-06-26 17:54:51
318b50a0b3df4842cc33a15ff2019c948af15359...6c0fd9f29ad92b0f4b1cdea82a33d485622d0fd5,2,40,15,55,17,2013-06-26 18:34:20,2013-06-26 18:34:20
6c0fd9f29ad92b0f4b1cdea82a33d485622d0fd5...49fcbdbd1e0c7405c819cecedf54029b4541fcc2,3,18,1,19,3,2013-06-26 18:50:47,2013-06-26 18:50:47
49fcbdbd1e0c7405c819cecedf54029b4541fcc2...b143976bfa1ef73aef3dd81a6691c9d6d411c372,1,1,1,2,1,2013-06-26 20:00:15,2013-06-26 20:00:15
b143976bfa1ef73aef3dd81a6691c9d6d411c372...f15e8a0cfe2a977cd9925332e15ef2405170fbd3,2,6,1,7,2,2013-06-28 20:11:27,2013-06-28 20:11:27
f15e8a0cfe2a977cd9925332e15ef2405170fbd3...3e4de1ded4343f66b4d7036129b80684b2f46d38,1,16,4,20,4,2013-06-28 20:33:14,2013-06-28 20:33:14
3e4de1ded4343f66b4d7036129b80684b2f46d38...28d517f58e7acf331f8f85ada1b06eb393d5291d,1,2,2,4,2,2013-06-29 05:35:52,2013-06-29 05:35:52
28d517f58e7acf331f8f85ada1b06eb393d5291d...0904cc485c23385e4ac0628ddce5e1c842909af4,1,4,0,4,2,2013-06-29 06:05:26,2013-06-29 06:05:26
e55e23bbda6f6a95982109bc46e48a5550e4c181...3e09e6f7b8032859a82266282dfd35715b3b3727,23,58,57,115,38,2013-06-24 15:24:14,2013-06-24 15:24:14
3e09e6f7b8032859a82266282dfd35715b3b3727...afc9d548198ac2b405fbf3a268cdc0c2ffd35995,1,1,1,2,1,2013-06-24 15:26:57,2013-06-24 15:26:57
afc9d548198ac2b405fbf3a268cdc0c2ffd35995...15f62fcc27235b3c8012c80f0517ecf5c27aa205,4,5,5,10,4,2013-06-24 16:24:27,2013-06-24 16:24:27
15f62fcc27235b3c8012c80f0517ecf5c27aa205...05a7e8b9c0b1ebdc01470a31f933b7526ca2cd08,7,52,48,100,13,2013-06-24 16:25:10,2013-06-24 16:25:10
05a7e8b9c0b1ebdc01470a31f933b7526ca2cd08...113d2ff525b6005e1cc7ff86a5a0189c4ab3d0e4,6,60,13,73,14,2013-06-24 17:07:21,2013-06-24 17:07:21
113d2ff525b6005e1cc7ff86a5a0189c4ab3d0e4...b4a9cab7f0eaac8a29d82c0c70293f866e1d6b01,1,1,1,2,1,2013-06-24 17:47:59,2013-06-24 17:47:59
b4a9cab7f0eaac8a29d82c0c70293f866e1d6b01...89a1e7e1f5cdfe4c5ebc076ed39d37aea0e543fc,1,1,1,2,1,2013-06-24 18:00:33,2013-06-24 18:00:33
89a1e7e1f5cdfe4c5ebc076ed39d37aea0e543fc...106764ab3b42f9d81a6ad81f2611ea1d78d7ae05,3,65,65,130,54,2013-06-24 19:03:32,2013-06-24 19:03:32
da98cebc5bd72f5cfc25c50fcaecbe952db5f3ed...e7c930a55b9832a767bfb1a5e2a8add8f9e719f9,6,21,10,31,7,2013-06-14 13:30:48,2013-06-14 13:30:48
e7c930a55b9832a767bfb1a5e2a8add8f9e719f9...940c05086ee595fd5ea7f77a07b78bff14efb7e2,1,6,4,10,2,2013-06-14 14:19:26,2013-06-14 14:19:26
361a8781c939e96c9718403db5330f389f13e64b...aa618dd87df8943aaabdfa6122d40f3285681452,1,1,1,2,1,2014-02-14 13:28:49,2014-02-14 13:28:49
0212bc7a0d4440cc873e3de00716ce8c50693631...dac0e2f17411e23f06ddfef7fb737716e82f0518,1,2,0,2,2,2014-02-14 10:13:52,2014-02-14 10:13:52
dac0e2f17411e23f06ddfef7fb737716e82f0518...0007db8352fa56be06d663f4046a2b5602e51bc0,1,0,1,1,1,2014-02-18 14:38:07,2014-02-18 14:38:07
00d6ac299e073b3117ea9d730fbffa9ef7e3b8a0...0a08c775193af3ee566700017d85517b7f9829cd,3,34,15,49,11,2013-11-12 10:56:20,2013-11-12 10:56:20
00d6ac299e073b3117ea9d730fbffa9ef7e3b8a0...dfb8d2b7ff5390ad1689fb98c5ddd3b10194f480,1,4,3,7,4,2013-11-12 09:24:03,2013-10-24 08:31:12
e16eb912990770c9e5bddece966d2988ed7fa575...4e9284a023f26e3dfd56a0130b8e2a38c884f0e6,2,10,0,10,2,2013-11-12 14:11:46,2013-11-12 14:11:46
3e30b105910980967c4fc10808eeeee86acbe452...0f834d117291e64e054b0226cc8e63ebaa517964,1,16,4,20,3,2014-02-15 20:57:20,2014-02-15 20:57:20
3e30b105910980967c4fc10808eeeee86acbe452...c35036c091adf71dca557edb6ffc5cb07e361500,3,11,0,11,3,2014-02-15 20:03:10,2014-02-15 20:03:10
3e30b105910980967c4fc10808eeeee86acbe452...5a68db91c8a2ae7d23b07a5c52b8b74d859a819f,2,12,0,12,3,2014-02-15 19:46:15,2014-02-15 19:46:15
116f73b540ba0249e8df1da97fd4189b0327ebce...9d457fa4771456290881630f726054d0c47ee842,1,1,1,2,1,2014-11-11 17:08:39,2014-11-11 17:08:39
6adc313a1f48809543c626aa226ad56979cdde99...9eb571f0ea49d182353d576739d412b914a46b62,1,51,0,51,1,2014-11-13 15:19:07,2014-11-13 15:19:07
9eb571f0ea49d182353d576739d412b914a46b62...334fe86574227433bd2909577c5955c40721d509,1,4,1,5,3,2014-11-13 15:20:43,2014-11-13 15:20:43
6adc313a1f48809543c626aa226ad56979cdde99...4a5044e30269f8b3c6c075093cd4646a478231c7,1,7,1,8,1,2014-11-13 12:09:47,2014-11-13 12:09:47
0488e34ba723b9a55bd6e35aafc0cf089b0b49fd...200eeea2587d36a90f8308425887e953c48eecbc,5,8,2,10,5,2014-03-31 10:19:37,2014-03-28 12:09:25
200eeea2587d36a90f8308425887e953c48eecbc...eeeaaa4bc136c30db7d276cdcba4739937157663,1,1,0,1,1,2014-03-31 10:19:37,2014-03-28 12:48:00
0488e34ba723b9a55bd6e35aafc0cf089b0b49fd...3055331965ee4eb1724a2abf91ac2a66a0856b82,1,1,1,2,1,2014-03-31 10:05:41,2014-03-31 10:05:41
3055331965ee4eb1724a2abf91ac2a66a0856b82...dd32c9f0ed73eeebc32fbbed38de5c467839b665,1,1,1,2,1,2014-03-31 10:24:55,2014-03-31 10:24:55
0488e34ba723b9a55bd6e35aafc0cf089b0b49fd...5b4aba5f56e6d5c934300707c99dd70916c1a59e,3,0,0,0,0,2014-03-31 02:45:28,2014-03-31 02:45:28
5b4aba5f56e6d5c934300707c99dd70916c1a59e...34c5e6de28aabbf1894d24ed5838f33e068c0c8d,1,6,9,15,3,2014-03-31 02:58:03,2014-03-31 02:58:03
0488e34ba723b9a55bd6e35aafc0cf089b0b49fd...f43a6339d783f689355ac9dbfaa280083817243c,1,1,1,2,1,2014-03-30 15:36:32,2014-03-30 15:36:32
26ebfa20f082214f3dbd5d5ca49957d8cc83d234...8a55636f8974d73c097a52721e2208cea727bc17,6,42,39,81,9,2014-02-18 11:15:43,2014-02-18 11:15:43
8686d09d3e9e53089f7d3f11d74f0368f76a2aa2...9d637d576cbac348b6e6e0bee1b98f184f4e2a26,1,2,2,4,2,2014-02-18 14:21:13,2014-02-18 14:21:13
4c78bc0d839c15c4760ff4a567b8dd81b39670a9...654d876c86a759bd026cf324fde874f34f5b9951,1,4,1,5,2,2014-02-14 13:42:17,2014-02-14 13:42:17
e9142c6f2cfcdf9a13bce375579085bd5ce00947...ff046c72004f0c00827d615a60f37153f54a6347,2,41,3,44,7,2013-10-17 08:42:39,2013-10-17 08:42:39
ff046c72004f0c00827d615a60f37153f54a6347...78e591c737f65f7c5998d554d4c059b9a2d0674f,1,4,4,8,4,2013-10-17 08:57:58,2013-10-17 08:57:58
78e591c737f65f7c5998d554d4c059b9a2d0674f...52739518bc8c01f0c9821b01ce5bc3bcd92f2159,1,10,6,16,4,2013-10-17 09:36:23,2013-10-17 09:36:23
e9142c6f2cfcdf9a13bce375579085bd5ce00947...e09cc195a7400187e7b59f7ff24273962d9912d7,1,1,1,2,1,2013-10-16 17:28:39,2013-10-16 17:28:39
e09cc195a7400187e7b59f7ff24273962d9912d7...12420a2256168a122b3a1f5a2c974df52fe802ec,2,2,10,12,2,2013-10-16 17:31:46,2013-10-16 17:31:46
e9142c6f2cfcdf9a13bce375579085bd5ce00947...6404d6978075e272f1c83078eeda39d4a68d09c1,1,25,14,39,3,2013-10-16 17:19:25,2013-10-16 17:19:25
6404d6978075e272f1c83078eeda39d4a68d09c1...9afc930b999048594e3f5a6a22097adcf2da50fe,6,30,27,57,9,2013-10-16 17:42:42,2013-10-16 17:42:42
7c3fd6941fa72b7a3827cb1cf83d387dd008050e...1712406f8a2eacda42133629b3329f3983de7c43,1,2,2,4,1,2013-10-18 07:11:37,2013-10-18 07:11:37
318f96a40d8b657494bc5b8008c02e8cc0162fd4...728f0c2005c85474b4c51eebcef850eb93855249,1,6,6,12,2,2013-10-18 07:49:55,2013-10-17 13:41:02
318f96a40d8b657494bc5b8008c02e8cc0162fd4...164f9d876083db94c47185ddcd11c40cde08ea01,1,2,1,3,1,2013-10-17 14:33:57,2013-10-08 13:07:54
235a6182ace5d004be0808935fb29d3ec99b0e38...3fb6ad9020ccde4d5e3b9bf3c36f5b201a8f6e7a,1,4,1,5,2,2013-10-27 10:50:18,2013-10-27 10:50:18
235a6182ace5d004be0808935fb29d3ec99b0e38...056060f94bf260f4f6729565373b15f2bbf843ab,1,2,2,4,2,2013-10-26 00:41:59,2013-10-26 00:41:59
d71914ca230ce83fe1d908d31fb11667a9539304...d636ad49bfba59499e45b445ca7e137e83613d8b,6,75,11,86,6,2013-10-29 14:39:46,2013-10-29 14:39:46
3c11359910892daefc68d698fe28cf0862683fde...4727fa3fcce5e42cdbd1e89e167d674cf23676be,1,8,0,8,2,2013-10-25 09:26:22,2013-10-25 09:26:22
a27e4404dbb553b3916c9f3c3202f41fb85cdffb...bfd9f814079b076926f03e8d2dfae20903f312ae,1,1,0,1,1,2013-11-01 07:25:03,2013-11-01 07:25:03
bfd9f814079b076926f03e8d2dfae20903f312ae...6055c615dbf37bece7e34af843b000c23a72eaf8,1,1,0,1,1,2013-11-01 07:28:30,2013-11-01 07:28:30
6055c615dbf37bece7e34af843b000c23a72eaf8...844f8fd2131e10832efd05175930944c0ed9df63,2,7,1,8,2,2013-11-01 07:36:59,2013-11-01 07:36:59
dcac37d9e41f21485822647b922ac952bf64358a...3ada8f45c7a719a95864b3ee2c1acdfdf4468eaa,1,1,3,4,2,2013-07-17 13:17:17,2013-07-02 11:39:13
3ada8f45c7a719a95864b3ee2c1acdfdf4468eaa...656d800f8c72bc6bb97700b7289a2d5eebc4e42f,1,1,6,7,2,2013-07-17 13:17:18,2013-07-02 12:00:21
656d800f8c72bc6bb97700b7289a2d5eebc4e42f...aa0473d0eb581a1c4d20be22c53ec4002a3801e0,2,13,15,28,7,2013-07-17 13:17:18,2013-07-17 13:16:34
4f65509cbf7081451a4d04a8721577f0474828e4...d3c429ed21ef13a9004406df5c05bf2a4be4168c,1,80,0,80,1,2013-07-18 16:32:13,2013-07-18 16:32:13
67b82e90cf00b2ba6063e8203b4f449d890cf98d...e45d1d255865a58c57f9f6c0743f3253503e1552,1,21,21,42,4,2013-04-12 09:25:25,2013-04-12 09:25:25
6a9aed1e878bc8651243d645d0a9d2f7da33f248...7ab2130cabe0ba4a1190324b79cb18f87669ff08,1,0,6,6,1,2013-07-10 16:09:48,2013-07-10 16:09:48
7ab2130cabe0ba4a1190324b79cb18f87669ff08...4da48868e57fdf5bfd41b680f5452450807c23f5,1,6,0,6,1,2013-07-10 16:29:54,2013-07-10 16:29:54
4da48868e57fdf5bfd41b680f5452450807c23f5...e49ec46461ef033fb54c717378628a31bd33248b,2,6,4,10,3,2013-07-11 06:19:19,2013-07-11 06:19:19
0d285c1cb167c327992a860764d28780e25f7812...88301d569544d8ee82a62c68399ef94779aaf64a,1,1,1,2,1,2013-07-10 22:19:52,2013-07-10 22:19:52
e1ac3db92741907b5c085d3e236a02d953cfe0cc...1da67c2cec044d5bc681361889e9850d2cb69759,2,2,2,4,2,2013-07-09 16:42:35,2013-07-09 16:42:35
940c05086ee595fd5ea7f77a07b78bff14efb7e2...9e86f3b156848da323b64aed14676d14ec226d76,1,1,0,1,1,2013-07-02 08:27:51,2013-07-02 08:27:51
940c05086ee595fd5ea7f77a07b78bff14efb7e2...43d2e7b1044ec5720f8a3d6e9cb3091d8d533dc4,2,7,1,8,3,2013-06-14 17:07:09,2013-03-26 14:34:32
940c05086ee595fd5ea7f77a07b78bff14efb7e2...48e5dff99c5ae206019082295357f513e412671e,1,2,2,4,1,2013-06-14 16:58:16,2013-06-14 16:58:16
48e5dff99c5ae206019082295357f513e412671e...593dfc40df6470089567e0daa1c752507a984b7e,1,5,21,26,3,2013-06-15 10:10:43,2013-06-15 10:10:43
0a08c775193af3ee566700017d85517b7f9829cd...963213b8427ad7eee87382f41282e0e4f59d15ed,1,1,1,2,1,2013-11-12 17:15:26,2013-11-12 17:15:26
0a08c775193af3ee566700017d85517b7f9829cd...f1ecf53c1e55fbbc66cb2d7d12fb411cbfc2ace8,5,44,1,45,5,2013-11-12 11:47:28,2013-11-12 11:47:28
f1ecf53c1e55fbbc66cb2d7d12fb411cbfc2ace8...dd501aa7a79644919ba0c47d1ed764b6db768c8d,5,73,0,73,5,2013-11-12 12:28:12,2013-11-12 12:28:12
dd501aa7a79644919ba0c47d1ed764b6db768c8d...90d599397fdfbf35ccdf3593afe391f984fba601,1,2,0,2,1,2013-11-12 12:29:43,2013-11-12 12:29:43
90d599397fdfbf35ccdf3593afe391f984fba601...963a31144b0d69af7b08e1912965a920636ce600,3,13,0,13,3,2013-11-12 12:32:17,2013-11-12 12:32:17
963a31144b0d69af7b08e1912965a920636ce600...c5b667351abcda4b5ac134873007a0ce47976e88,7,38,0,38,7,2013-11-12 13:08:20,2013-11-12 13:08:20
c5b667351abcda4b5ac134873007a0ce47976e88...13a66040300241caf234726bfc72ca90ef4c34fd,4,22,2,24,6,2013-11-12 13:20:31,2013-11-12 13:20:31
13a66040300241caf234726bfc72ca90ef4c34fd...3397361fd7aeec711167c40b3fbab1e05a53b73d,2,40,0,40,2,2013-11-12 16:56:48,2013-11-12 16:56:48
bd2ca33d5827401a5ef380ddf323cff86ab38439...d89c6adfe675620cb1730fa3036ddff18ff20105,6,38,17,55,15,2013-11-12 20:32:28,2013-11-12 20:32:28
d89c6adfe675620cb1730fa3036ddff18ff20105...cb6639ffbb53828b2b831029be7dd3833b44ca05,1,10,1,11,2,2013-11-13 06:06:58,2013-11-13 06:06:58
cb6639ffbb53828b2b831029be7dd3833b44ca05...f597b5f43ab7e86eae45afc0ed5d6ac96a8a51f6,1,2,2,4,1,2013-11-13 07:03:11,2013-11-13 07:03:11
f597b5f43ab7e86eae45afc0ed5d6ac96a8a51f6...929a2969202236c82600adc56a5c06edf7073aef,1,6,0,6,1,2013-11-13 07:08:03,2013-11-13 07:08:03
929a2969202236c82600adc56a5c06edf7073aef...672cd9b0d97b3f800929e2b57ce557b6d73a070e,1,6,0,6,1,2013-11-13 07:12:22,2013-11-13 07:12:22
672cd9b0d97b3f800929e2b57ce557b6d73a070e...02448fce1ebf5314eabd9c6a298a5025fed2ace9,1,10,5,15,2,2013-11-13 07:20:36,2013-11-13 07:20:36
02448fce1ebf5314eabd9c6a298a5025fed2ace9...e51411ecc7c3dbb5b37af1f0d51b0a8118d6f8bd,2,35,1,36,2,2013-11-13 08:28:15,2013-11-13 08:28:15
e1c93a6bca0684e1b9dd61ddd968bf6bfe7640aa...1c61ac1c64e136b391d472a24bbc5538352e299d,3,9,5,14,5,2014-02-18 18:17:26,2014-02-18 18:17:26
0f834d117291e64e054b0226cc8e63ebaa517964...4f4a1b961d7896f7a71dd69defeaa9d3012ad42d,1,1,1,2,1,2014-02-16 17:22:16,2014-02-16 17:22:16
4f4a1b961d7896f7a71dd69defeaa9d3012ad42d...e9cf2e140f9685e43a63ed6095874f8096de90c3,1,2,2,4,2,2014-02-16 17:51:09,2014-02-16 17:51:09
4bbb3d5510d5396eca034a9a8593952b16b15ab5...99dc9c6fc9880519dddf2cb2557b984792843848,5,40,0,40,5,2014-02-16 10:22:03,2014-02-16 10:22:03
4e65d085b50844469a322d46773de04c16159ce1...e0467e8f58d168900e7282160e1674a2125265cc,1,1,1,2,1,2014-11-14 10:41:58,2014-11-14 10:41:58
4e65d085b50844469a322d46773de04c16159ce1...ced2438312c3fd48f9487465533bb493d83ee998,1,6,2,8,2,2014-11-14 10:08:58,2014-11-14 10:08:58
4e65d085b50844469a322d46773de04c16159ce1...e375d0de65894a03d382c462fe99bbe66915dba7,1,1,1,2,1,2014-11-14 08:33:33,2014-11-14 08:32:49
4e65d085b50844469a322d46773de04c16159ce1...5e9f6562bb861a4e7e062760cf094a5dba283d80,1,11,0,11,1,2014-11-13 17:20:35,2014-11-13 17:20:35
e19ff109a27b331cafb36f5681af43e3fc5a66e8...0331f36a2c97180b95355cc676b3c8238c763789,2,2,2,4,2,2014-02-14 13:58:15,2014-02-14 13:58:15
e1c1e882b37df6d0d36d54d0d2f48c3a58c101ed...441e6dcf0d4d09a713ae6bc7bb47eddc76ad9f48,1,15,15,30,15,2014-02-11 10:44:08,2014-02-11 10:44:08
2ab2d60b9ea42f5631bfd4cd48b16a02d065215e...9b276f0003d19599e6426eb5f58028a81ede4a30,6,167,150,317,7,2014-03-31 13:31:53,2014-03-31 13:31:53
9b276f0003d19599e6426eb5f58028a81ede4a30...8f3701eff005aeedcebff8ce02074f5056a369b3,3,168,167,335,3,2014-03-31 13:43:45,2014-03-31 13:43:45
8a55636f8974d73c097a52721e2208cea727bc17...b05a67f4e3fdf94477539d61bff6d74337d2ddef,2,103,96,199,2,2014-02-18 14:22:57,2014-02-18 14:22:57
b05a67f4e3fdf94477539d61bff6d74337d2ddef...702128892b5edd093e8671527fb9860d3631f5eb,5,35,11,46,6,2014-02-18 14:24:27,2014-02-18 14:24:19
8a55636f8974d73c097a52721e2208cea727bc17...4f6b570fbe6e87befd9242f19acee1f14a28574e,6,134,19,153,6,2014-02-18 13:38:33,2014-02-17 14:54:19
ec8628fa95b54dae3a0a680e3df043ba01c3e0de...0bf4e568ea3accebbcafa7be1f74a15b672ae31a,1,2,2,4,1,2014-02-18 14:49:50,2014-02-18 14:49:50
4f2c4699461f407d6d95f6b9dc9cc6ba3e00bf5f...d4d1bce5ec18edc53e38eac2d31c046918b05576,1,1,1,2,1,2013-10-18 16:04:58,2013-10-18 15:55:09
584117aa87cbb9c3bc4c43f962fa86bbdda04d25...92b3612025d233b174e0caa3532604d4ee48d1ab,1,13,7,20,4,2013-10-21 06:55:41,2013-10-21 06:55:41
164f9d876083db94c47185ddcd11c40cde08ea01...2cd3d421817a225dcd6068ce9aeac0689b5b97f0,5,5,5,10,5,2013-10-17 19:11:41,2013-10-17 19:11:41
6981c207a0c9c42f6d40bdb0946dc83c75500075...6b0501b4c078ed1e88109c2a291211b234ebcd7a,1,1,1,2,1,2013-10-27 14:15:08,2013-10-27 14:15:08
6b0501b4c078ed1e88109c2a291211b234ebcd7a...4faa8956237bc73e671fe9ab2d17271cf9bcbf2e,1,1,1,2,2,2013-10-27 14:37:17,2013-10-27 14:37:17
4faa8956237bc73e671fe9ab2d17271cf9bcbf2e...05b5e318a150d08f3bcac96bcde74df8de1d7107,1,1,1,2,1,2013-10-27 14:38:38,2013-10-27 14:38:38
05b5e318a150d08f3bcac96bcde74df8de1d7107...890c4f9848046d80bd51903cbaba2d5b7855ac91,1,4,4,8,4,2013-10-27 14:46:16,2013-10-27 14:46:16
890c4f9848046d80bd51903cbaba2d5b7855ac91...b43084d180c3fd852b38b409e491f80634a61bb1,1,9,7,16,2,2013-10-27 15:06:02,2013-10-27 15:06:02
b43084d180c3fd852b38b409e491f80634a61bb1...0040139bbec7b282e792ff42ee8195d5423da5a3,1,2,2,4,2,2013-10-28 09:06:39,2013-10-28 09:06:39
0040139bbec7b282e792ff42ee8195d5423da5a3...bc0a419eca170607c1e4120ab259e5c03f5c0515,1,56,0,56,1,2013-10-28 11:23:09,2013-10-28 11:23:09
bc0a419eca170607c1e4120ab259e5c03f5c0515...ff7073ac23afdf5873f0b5eaee54b9c735e7e04d,2,5,1,6,2,2013-10-28 11:29:37,2013-10-28 11:29:37
0b57c118fc63be9169815b302b58886a0688dd82...ee0e9830c1c1e4c54fd0b18fadef50f76c3680a4,1,5,1,6,1,2013-10-29 16:13:51,2013-10-29 16:13:51
844f8fd2131e10832efd05175930944c0ed9df63...5d98afb55b43eb92dd5540b4a2f36835bf74f936,2,2,2,4,2,2013-11-01 10:52:44,2013-10-31 19:19:57
b98f414a1b8dbadbccceac3a544c15bb456a952b...fd033671933fcc0f472480d98c907aefde357416,4,5,5,10,5,2013-07-17 15:35:28,2013-07-17 15:35:28
d3c429ed21ef13a9004406df5c05bf2a4be4168c...7d6960104dcb1f2bac4edadb68d6978de2e507a0,3,6,0,6,3,2013-07-20 11:20:21,2013-07-20 11:20:21
d3c429ed21ef13a9004406df5c05bf2a4be4168c...2a5e05cfd86df0f36e75a8f0f60682a9372f9c3c,1,1,1,2,1,2013-07-20 10:31:13,2013-07-20 10:31:13
d3c429ed21ef13a9004406df5c05bf2a4be4168c...7a666d2589b672b2774f96ba3ca3c0135b776bed,1,157,62,219,1,2013-07-19 16:03:40,2013-07-19 16:03:40
d3c429ed21ef13a9004406df5c05bf2a4be4168c...66d239f97240501e83a41840a9afe587166fc2bf,1,1,1,2,1,2013-07-19 15:29:10,2013-07-19 15:29:10
d3c429ed21ef13a9004406df5c05bf2a4be4168c...fcbe7a205df580325596cb933388a09ed6980550,1,2,0,2,1,2013-07-19 07:56:50,2013-07-19 07:56:50
63b78a3989e00b917e51841d4960beca9a11b315...53b3d6264142a7d8e362702661f98d21fdfff4b6,1,20,0,20,2,2013-04-14 20:17:06,2013-04-14 20:17:06
53b3d6264142a7d8e362702661f98d21fdfff4b6...b851bbfa780055d39f20398aa66e5a7a648947c8,2,33,51,84,16,2013-04-15 17:41:39,2013-04-15 17:41:39
b851bbfa780055d39f20398aa66e5a7a648947c8...23f5698413cca147ac30e138ee8c739df0d56db0,1,2,4,6,2,2013-04-15 18:02:53,2013-04-15 18:02:53
23f5698413cca147ac30e138ee8c739df0d56db0...b8b5a698278c3d6d196453557303e4362974e410,1,2,2,4,1,2013-04-15 18:10:43,2013-04-15 18:10:43
63b78a3989e00b917e51841d4960beca9a11b315...f210a5d8320365e27da8c75b054deedcb9cd8ea7,1,2,2,4,2,2013-04-12 19:19:18,2013-04-12 19:16:08
63b78a3989e00b917e51841d4960beca9a11b315...ab5205daf64106862aeaa963a0eef65c66a1ec57,1,3,3,6,3,2013-04-12 15:46:11,2013-04-12 15:46:11
63b78a3989e00b917e51841d4960beca9a11b315...a42bfe6f0869a7c254c7826a284fff6191bc04fd,1,1,1,2,1,2013-04-12 15:17:29,2013-04-12 15:17:29
e45d1d255865a58c57f9f6c0743f3253503e1552...7305d98c8e486b47ba6e90a9a4fe3b223d519827,3,51,51,102,18,2013-04-15 18:54:45,2013-04-14 20:17:06
d169ae132b814425f4e66473848aa5220a3d6545...555c25e601fb32f23e652ee301c02f4d5ee8e59f,2,0,13,13,4,2014-02-18 15:34:22,2014-02-18 15:34:22
c938833bd9f5373af5b8012df39a360517fd5261...6cdd08965e50110030384491204d223a4730d088,1,1,1,2,1,2013-11-18 16:43:25,2013-11-18 16:43:25
6cdd08965e50110030384491204d223a4730d088...250a86d2787ae60aaf800a5ebfee69caa4d1a1d5,1,1,1,2,1,2013-11-18 16:45:28,2013-11-18 16:45:28
c938833bd9f5373af5b8012df39a360517fd5261...59b6337de04c8f60dad4a0f86845143e10e97c92,1,1,0,1,1,2013-11-18 09:54:20,2013-11-18 09:54:20
c938833bd9f5373af5b8012df39a360517fd5261...856d4088fbc7da5b5b583acc11ab674c4452b402,9,165,2,167,13,2013-11-17 15:35:34,2013-10-09 20:22:37
c938833bd9f5373af5b8012df39a360517fd5261...9be86adbbc0d71b394e16a41ea54fe1087875160,1,10,4,14,5,2013-11-17 13:46:04,2013-11-17 13:46:04
c938833bd9f5373af5b8012df39a360517fd5261...c09aed8b07d9930491f66924582596c1100ba467,1,3,0,3,1,2013-11-15 17:49:31,2013-11-15 17:49:31
e51411ecc7c3dbb5b37af1f0d51b0a8118d6f8bd...c727fdd054cd2f73a4311265d9f5e9f1a7d434eb,3,21,2,23,3,2013-11-13 08:35:10,2013-11-13 08:35:10
25741c97a2ae1446fe03b86cc5e0bd5f49b41cf6...638f8541dcd4a718e0c8187bb1dd4dfddffeb57d,3,14,13,27,3,2014-02-18 18:36:03,2014-02-18 18:36:03
8136048875004a21632e98eaa6d675a529caa831...4d093f9f8df502f89bfdbff8e0db6848b4e8ab43,7,7,0,7,7,2014-02-17 20:35:23,2014-02-17 20:35:23
8136048875004a21632e98eaa6d675a529caa831...10561f4c462b3068ad795a47b7f4e19c06ac2ffb,1,1,1,2,1,2014-02-17 07:06:35,2014-02-17 07:06:35
58011d61c35beb4b55440caefcac6caa1905d891...18c8226566edb1c7fa43ccc1bf7a1db33f91489f,1,6,3,9,5,2014-11-13 17:40:47,2014-11-13 17:40:47
18c8226566edb1c7fa43ccc1bf7a1db33f91489f...e08e405ac4c448d8b720ed2ef6181c15e3f3dfc1,8,78,41,119,11,2014-11-13 20:06:19,2014-11-13 20:06:19
e08e405ac4c448d8b720ed2ef6181c15e3f3dfc1...d2c3c98e3cf88dd59a2a1a0d94e711e31c11b2cd,1,10,5,15,3,2014-11-14 10:55:13,2014-11-14 10:55:13
d2c3c98e3cf88dd59a2a1a0d94e711e31c11b2cd...2388fdd7c6274dad8c10f5bc517f0a8b1aa28aa3,9,86,15,101,10,2014-11-14 14:06:39,2014-11-14 14:06:39
046fa9bdb106f4a94b3f62646726e99923e75b0a...8da35fe26ecda1a984fbf2c1a5ab8bf4c1d25bee,1,1,1,2,1,2014-03-31 12:49:57,2014-03-31 12:49:57
046fa9bdb106f4a94b3f62646726e99923e75b0a...24f64e65a63fa5c1a6dd562d5855fe8b67b1cd2b,1,4,0,4,1,2014-03-31 11:16:52,2014-03-31 11:16:52
dfc92cd25d7025378a4411525dc5a1b8ff5b1663...2496f85d464c599d83bd95bde11b1cb6895693bd,1,4,3,7,4,2014-03-31 16:10:20,2014-03-31 16:10:20
8f3701eff005aeedcebff8ce02074f5056a369b3...95b84e2c5aa92a5a8effc108fdbdf596dff4818c,2,14,5,19,2,2014-04-01 07:33:23,2014-04-01 07:33:23
95b84e2c5aa92a5a8effc108fdbdf596dff4818c...33a00ceeeacfc52272d25cef914a027b9bf13a2a,3,39,0,39,3,2014-04-01 07:39:53,2014-04-01 07:39:53
33a00ceeeacfc52272d25cef914a027b9bf13a2a...d7afdab7a5fcb1aa686955f6d13e024737e89a94,1,31,0,31,1,2014-04-01 07:44:58,2014-04-01 07:44:58
d7afdab7a5fcb1aa686955f6d13e024737e89a94...a88225b7689ab87b49908db23e1bebf1c7ea09d3,1,1,0,1,1,2014-04-01 07:45:10,2014-04-01 07:45:10
1f1cfc9eba6d9b60decb4fcd0645fcbfd288925f...49addad7b5f18776dbd593f628237736e638b28c,13,355,354,709,53,2014-04-05 06:37:42,2014-04-05 06:36:47
1f1cfc9eba6d9b60decb4fcd0645fcbfd288925f...8c7f4f2bba7c14a632864ab1362d2eb7051f7fdf,1,0,0,0,0,2014-04-05 03:13:38,2014-04-05 03:13:38
83941ca2080432938cfcd8e4de9b8d2e616af09e...f6189a9f07607628d02c3660496d50c57dcc226b,1,0,0,0,0,2014-03-31 16:23:10,2014-03-31 16:23:10
1a923fe02eb3f1b8ec2caca7224682651f2b0bf0...4c61538b820953c4cf72fd1502d9eae42ffbf042,1,29,1,30,2,2013-10-21 12:23:59,2013-10-21 10:53:23
4c61538b820953c4cf72fd1502d9eae42ffbf042...79ac0e9b3e19b3f606fb2ca3cf9ed9363cf0ddf9,1,3,2,5,2,2013-10-23 09:18:23,2013-10-22 12:37:06
79ac0e9b3e19b3f606fb2ca3cf9ed9363cf0ddf9...e7b6a42f26cd7998e5fa26387b054723b1003fe5,1,1,1,2,1,2013-10-23 09:18:23,2013-10-22 12:41:08
e7b6a42f26cd7998e5fa26387b054723b1003fe5...01c65ac58631474d3b96bb253dfd32b046f8dd30,1,1,1,2,1,2013-10-23 09:18:24,2013-10-22 12:43:00
01c65ac58631474d3b96bb253dfd32b046f8dd30...56863dcbe3b1474b091c87702d94c8c224324b44,1,1,1,2,1,2013-10-23 09:19:16,2013-10-22 12:34:19
92b3612025d233b174e0caa3532604d4ee48d1ab...7210a34bc7c5d1b5d9ccaf8deb0aa4fac9058132,1,1,1,2,1,2013-10-21 07:05:13,2013-10-21 07:05:13
05ca0a31476497d8de360bd1303498ffc1379a5c...3ee4701316a707d2b8821bf850000bcd1a11af6a,1,16,5,21,6,2013-10-18 13:22:23,2013-10-18 13:22:23
ff7073ac23afdf5873f0b5eaee54b9c735e7e04d...0678b8a426553110e63dde3c75aaf719e74771e1,2,24,2,26,3,2013-10-29 09:41:20,2013-10-29 09:41:20
ff7073ac23afdf5873f0b5eaee54b9c735e7e04d...8706890f9b8b5b743616b82e93407fb02a46e7e6,1,4,0,4,2,2013-10-28 14:44:28,2013-10-28 14:44:28
ee0e9830c1c1e4c54fd0b18fadef50f76c3680a4...c46eaca91247ccf8e6fb3b691dad028e1b084ae3,5,19,17,36,19,2013-11-04 22:09:03,2013-11-04 22:06:27
ee0e9830c1c1e4c54fd0b18fadef50f76c3680a4...8acad9eae159b18df7621f5ce07a8cf44a4e73d6,3,54,0,54,3,2013-10-31 00:18:41,2013-10-31 00:18:41
8acad9eae159b18df7621f5ce07a8cf44a4e73d6...fc19f73bd57cbc606f18259d418aa5ccedcd4b7c,2,16,16,32,16,2013-10-31 00:26:19,2013-10-31 00:26:19
fc19f73bd57cbc606f18259d418aa5ccedcd4b7c...27692c529fb2605bb3eb22ebd3cd23755d0378b2,2,4,4,8,4,2013-10-31 00:27:40,2013-10-31 00:27:40
ee0e9830c1c1e4c54fd0b18fadef50f76c3680a4...67c18aa9419e59f1e6907d8068a6f48e2fcef48d,1,1,0,1,1,2013-10-30 16:11:56,2013-10-29 17:02:01
ee0e9830c1c1e4c54fd0b18fadef50f76c3680a4...cc505f550da83b2073adb168bcca620f656a076b,2,8,1,9,2,2013-10-30 10:34:26,2013-10-30 10:20:43
ee0e9830c1c1e4c54fd0b18fadef50f76c3680a4...20c21b9ac48cb390917cd47c27ca435f4e677b04,1,1,1,2,1,2013-10-30 10:27:44,2013-10-30 10:27:44
ee0e9830c1c1e4c54fd0b18fadef50f76c3680a4...dfbb7b3ae9c21e02f02dab23b6746613ba739dab,1,9,4,13,2,2013-10-29 23:46:42,2013-10-29 23:46:42
ee0e9830c1c1e4c54fd0b18fadef50f76c3680a4...dcaedb4a5e3dae774e0211935977cf4514e2a928,12,0,0,0,0,2013-10-29 21:05:44,2013-10-29 21:05:44
ee0e9830c1c1e4c54fd0b18fadef50f76c3680a4...ce75f46bf7adb96ccc20f8ef3be581898ef05681,1,14,12,26,13,2013-10-29 18:06:10,2013-10-29 18:06:10
ce75f46bf7adb96ccc20f8ef3be581898ef05681...aca7f56fef15da8cbe66ec88c1d1a364d4ae8181,1,14,14,28,13,2013-10-31 07:34:11,2013-10-31 07:34:11
ee0e9830c1c1e4c54fd0b18fadef50f76c3680a4...f0e6ebabd10ffbf828103b8d161e281cd0cbf7e9,1,128,0,128,1,2013-10-29 17:06:12,2013-10-29 17:06:12
f0e6ebabd10ffbf828103b8d161e281cd0cbf7e9...fa6f1983094998229c5ff5d532c5808479a337d0,1,1,1,2,1,2013-11-01 12:05:26,2013-11-01 12:05:26
ee0e9830c1c1e4c54fd0b18fadef50f76c3680a4...5c98cae9fe5e4d90c520277f6415d51d3bc405f8,1,2,0,2,1,2013-10-29 16:21:54,2013-10-29 16:21:54
fd033671933fcc0f472480d98c907aefde357416...ba33ed41401e87a07f023c10972168f1bdd27534,2,6,1,7,2,2013-07-18 07:29:45,2013-07-18 07:29:45
ba33ed41401e87a07f023c10972168f1bdd27534...fe7bef3a537aa4c613cc2e4b40d6b94496427268,5,32,28,60,5,2013-07-18 08:49:40,2013-07-18 08:49:40
fe7bef3a537aa4c613cc2e4b40d6b94496427268...02e39563c8e931c94a650f36d8732beecc068019,1,26,27,53,5,2013-07-18 09:06:51,2013-07-18 09:06:51
fd033671933fcc0f472480d98c907aefde357416...3d7194f0112da12e8732df9ffe8b34fe7d0a9f6b,97,1584,476,2060,342,2013-07-18 02:41:30,2013-04-25 14:15:33
3d7194f0112da12e8732df9ffe8b34fe7d0a9f6b...489fa5d72631505873b8c33f3a2bbd5919330a92,19,116,59,175,60,2013-07-18 02:42:51,2013-06-03 20:20:50
489fa5d72631505873b8c33f3a2bbd5919330a92...5d56da6bddcaa4d510fd97a8e38d80e750e3e20f,7,101,106,207,53,2013-07-18 02:42:51,2013-06-06 21:22:36
5d56da6bddcaa4d510fd97a8e38d80e750e3e20f...216d5e2c1adb8470421a99943f09c45e4e515d5b,3,63,56,119,10,2013-07-18 02:42:51,2013-06-07 20:39:32
216d5e2c1adb8470421a99943f09c45e4e515d5b...bbef8bb5896d8858bf91692bdd5aa9236472a885,4,41,17,58,7,2013-07-18 02:45:03,2013-06-08 15:51:18
bbef8bb5896d8858bf91692bdd5aa9236472a885...09112dbb1df2669b0042d6d785a5469a9855ac20,5,21,11,32,9,2013-07-18 02:45:03,2013-06-26 20:45:57
09112dbb1df2669b0042d6d785a5469a9855ac20...0ef055a4aef76d20668a40717fb33bfe41599cfb,15,17,42,59,31,2013-07-18 02:46:38,2013-07-12 16:23:42
0ef055a4aef76d20668a40717fb33bfe41599cfb...128f2845770b7a6d553ee764cdbbe63da5ba9e84,7,8,9,17,8,2013-07-18 02:46:38,2013-07-15 19:10:49
128f2845770b7a6d553ee764cdbbe63da5ba9e84...d99594273d57b2d5ed7c748b3185712960b89478,26,153,163,316,89,2013-07-18 02:48:03,2013-07-16 21:14:03
d99594273d57b2d5ed7c748b3185712960b89478...539c70c7d64589656cce804282725b97e28e49ff,9,17,8,25,11,2013-07-18 02:48:03,2013-07-17 14:35:11
539c70c7d64589656cce804282725b97e28e49ff...fae3f466151ac8ee9f9e0e496669be8a9e649120,3,16,7,23,6,2013-07-18 02:48:03,2013-07-17 15:23:36
fae3f466151ac8ee9f9e0e496669be8a9e649120...0e82c98174618c77e75153884269b5a02850c1d0,1,4,11,15,2,2013-07-18 02:48:03,2013-07-17 18:05:09
0e82c98174618c77e75153884269b5a02850c1d0...58064027408bcbfb9e6216a3157dffd9c324848d,3,8,17,25,7,2013-07-18 02:48:03,2013-07-17 20:28:07
58064027408bcbfb9e6216a3157dffd9c324848d...532809a17310a14c16df7adfecbdfa363a068f40,3,3,3,6,3,2013-07-18 02:48:03,2013-07-17 20:42:49
532809a17310a14c16df7adfecbdfa363a068f40...0a013adc4da162512b75d5ed20c338392af7577b,4,27,4,31,5,2013-07-18 02:48:03,2013-07-17 21:40:40
0a013adc4da162512b75d5ed20c338392af7577b...4d373005968b8269a8d2fe56b7776820396127a4,1,4,4,8,2,2013-07-18 04:12:03,2013-07-18 04:12:03
fd033671933fcc0f472480d98c907aefde357416...87e8c2dc3ddb6a988ffcd0fee19f98ac8063bb8b,1,12,12,24,1,2013-07-17 20:51:12,2013-07-17 20:51:12
f602be2e284dab308372ba10a756c6aa1c7069d4...6d0b210ce81d9639db2ada090301b482bd0da7c2,1,1,1,2,1,2013-07-22 06:18:48,2013-07-22 06:18:48
20365121e0e741b5e415ddf5ab616b068a8acc8e...4261a5a1eac0692d9d6a488cc86047bd582145de,2,2,1,3,2,2013-07-26 14:53:35,2013-07-26 14:53:35
20365121e0e741b5e415ddf5ab616b068a8acc8e...8aecfc375c10033ae76c9a7fc94e600a48cd498e,2,2,2,4,2,2013-07-24 15:26:14,2013-07-24 15:26:14
304baaf8efcecf6b639ea1d925ee9973d5b14fd7...cab7d7686f6c11bd77564eb73abd85fb9f61c58e,3,82,75,157,25,2013-08-15 09:42:32,2013-08-15 09:42:32
cab7d7686f6c11bd77564eb73abd85fb9f61c58e...86584aa89f2a0a97eeef1e4eacb2cc8ea9380d12,1,2,0,2,1,2013-08-15 09:46:52,2013-08-15 09:46:52
86584aa89f2a0a97eeef1e4eacb2cc8ea9380d12...12d55ba6ccb1b2afa02fcc1fc7ca5ffbd0e21cc3,2,12,5,17,5,2013-08-15 10:13:22,2013-08-15 10:13:22
12d55ba6ccb1b2afa02fcc1fc7ca5ffbd0e21cc3...f230591b3d75034d0d4c9daa615a76ac876786a6,2,2,2,4,2,2013-08-15 10:24:08,2013-08-15 10:24:08
f230591b3d75034d0d4c9daa615a76ac876786a6...55582047413c639a4843f52f9869fafc01bf6522,1,58,45,103,8,2013-08-15 11:33:38,2013-08-15 11:33:38
707cea8d45c45a2f840a5d053092e699912cb8a8...cb877b7e6f6b036a2811aec7313dab94473774de,2,12,9,21,6,2013-07-24 20:04:51,2013-07-22 18:45:56
cb877b7e6f6b036a2811aec7313dab94473774de...669ada924b3d058f5ad8bfc6822b1a9e64b3549b,1,18,18,36,7,2013-07-30 11:52:46,2013-07-29 20:34:53
8456584065c8133a20da41468f31e9114858d01b...0b747a0f4ab3917ea1593b0f25169e600cd1059f,3,13,14,27,10,2013-08-06 14:58:45,2013-08-06 14:58:45
0b747a0f4ab3917ea1593b0f25169e600cd1059f...f8137075d5a615e968a4b63af13e1c51c36153df,2,8,4,12,4,2013-08-06 15:03:13,2013-08-06 15:03:13
f8137075d5a615e968a4b63af13e1c51c36153df...6eabf90b804e199f6a9c2b96ac4b293405da9897,5,22,6,28,8,2013-08-06 15:45:45,2013-08-06 15:45:45
6eabf90b804e199f6a9c2b96ac4b293405da9897...65eddc00adaa89b93cda204634af84538a91e8ad,1,1,2,3,1,2013-08-06 15:49:37,2013-08-06 15:49:37
65eddc00adaa89b93cda204634af84538a91e8ad...21c70354f609c292d302c433f9f9bcea31674ab9,2,22,23,45,5,2013-08-06 17:12:20,2013-08-06 17:12:20
21c70354f609c292d302c433f9f9bcea31674ab9...512cd02335de9de22aab688743a01fa868229f0d,11,66,86,152,15,2013-08-06 18:12:01,2013-08-06 18:12:01
512cd02335de9de22aab688743a01fa868229f0d...27b7aeddfbd4b927c45d574c2c1cc846abe0cca2,3,19,6,25,4,2013-08-06 18:22:41,2013-08-06 18:22:41
c7b825fe14340a7cead56dad23f562c3d7a9e0e1...615e4968464949a2e62af5c2cde363db67f37882,1,4,4,8,3,2013-04-15 13:30:26,2013-04-15 13:29:55
615e4968464949a2e62af5c2cde363db67f37882...b1a8fdd84d5a7cdbdb5ef3829b59a73db0f4d2dd,1,2,2,4,1,2013-04-15 13:53:19,2013-04-15 13:53:19
b1a8fdd84d5a7cdbdb5ef3829b59a73db0f4d2dd...a45e4721e022e7b09d06b45fadab1ac09bf32673,2,4,1,5,2,2013-04-15 13:58:10,2013-04-15 13:58:10
555c25e601fb32f23e652ee301c02f4d5ee8e59f...f0750b9166dd729383c4b3f865c80bb024d03798,4,26,20,46,8,2014-02-18 18:09:31,2014-02-18 18:09:31
421b9c32dfc472b308aab8b282f94a51a4773645...f4912e04fd62556ee153b4a4903cbb1706a39746,1,2,2,4,2,2013-11-13 11:43:40,2013-11-13 11:43:40
f4912e04fd62556ee153b4a4903cbb1706a39746...201d489780de36eeb8e1826bbb7d1ebd8a64959b,9,53,2,55,9,2013-11-13 12:10:03,2013-11-13 12:10:03
201d489780de36eeb8e1826bbb7d1ebd8a64959b...467e4e81f4876433ef30602fe75944a8ab16693a,1,3,0,3,1,2013-11-13 12:17:03,2013-11-13 12:17:03
467e4e81f4876433ef30602fe75944a8ab16693a...31239d116a873bd6110c3995821df66c9720663a,1,1,1,2,1,2013-11-13 12:21:03,2013-11-13 12:21:03
31239d116a873bd6110c3995821df66c9720663a...64edb27aa95cef237564b2f6dad38ba6208f3745,2,4,2,6,2,2013-11-13 14:13:40,2013-11-13 14:13:40
64edb27aa95cef237564b2f6dad38ba6208f3745...37741f3eb8e1083388f9cf6937fce3c9ddb15d0c,1,4,0,4,1,2013-11-13 15:06:24,2013-11-13 15:06:24
37741f3eb8e1083388f9cf6937fce3c9ddb15d0c...aed65f56ec746eeae0af86ec7ff733bda881b41d,1,51,41,92,16,2013-11-13 15:35:44,2013-11-13 15:34:19
aed65f56ec746eeae0af86ec7ff733bda881b41d...9fbe3ac771bfb953fe46c6989333b09600570cad,1,4,2,6,3,2013-11-13 15:39:04,2013-11-13 15:39:04
9fbe3ac771bfb953fe46c6989333b09600570cad...c946defb3d9ff2ad87a410f2e25999465c4b9065,3,9,10,19,8,2013-11-13 15:56:14,2013-11-13 15:56:14
f614fa97ae5068f0793ce1bcc73d474e44843695...8ddadc997137d099a9fca5308bf4137203c2ce66,1,1,1,2,1,2013-11-18 18:22:39,2013-11-18 18:22:39
f614fa97ae5068f0793ce1bcc73d474e44843695...a09fc160d02f232e9819c7459a9ff91a4e990bf3,1,10,0,10,1,2013-11-18 12:15:59,2013-11-18 12:15:59
a09fc160d02f232e9819c7459a9ff91a4e990bf3...ba169cc52d42425525921464070a513097a003ff,1,26,0,26,1,2013-11-18 14:42:56,2013-11-18 14:42:56
ba169cc52d42425525921464070a513097a003ff...11931bfb9c683ec615d3c4935976b7f70262f291,1,17,1,18,2,2013-11-18 14:49:29,2013-11-18 14:49:29
11931bfb9c683ec615d3c4935976b7f70262f291...434d276dba22924dbcbd903d4fea0d20c409ed98,1,1,1,2,1,2013-11-18 17:53:10,2013-11-18 17:53:10
638f8541dcd4a718e0c8187bb1dd4dfddffeb57d...c0e29f2540587c037456d11d17002ef6a22c8bf4,1,2,0,2,1,2014-02-18 19:59:34,2014-02-18 19:59:34
638f8541dcd4a718e0c8187bb1dd4dfddffeb57d...a718a9af3e9a4f7431cab066fc81f3311f9fe639,3,14,13,27,7,2014-02-18 18:48:02,2014-02-18 18:48:02
0744eac9c61efcba998a5328acf01f80bdfa6e84...936353edfdf00653b23f6837f29095dbc3a5f5dc,7,88,83,171,20,2014-02-17 16:06:24,2014-02-17 16:06:24
936353edfdf00653b23f6837f29095dbc3a5f5dc...64dbcfe27f362ebbb3da840b0914c40dba814505,1,0,1,1,1,2014-02-17 16:09:49,2014-02-17 16:09:49
0744eac9c61efcba998a5328acf01f80bdfa6e84...97b47c735e74cdaf316002be8c00f6d06ae4a96e,1,6,2,8,3,2014-02-17 11:29:56,2014-02-17 11:29:56
97b47c735e74cdaf316002be8c00f6d06ae4a96e...c9b3767ff1d78207ccb44650715a33cc98c6bc72,1,1,1,2,1,2014-02-17 13:11:21,2014-02-17 13:11:21
0744eac9c61efcba998a5328acf01f80bdfa6e84...8dc3dafe24fd481acdd8ebe87cad189fd8b861f4,1,7,7,14,7,2014-02-17 10:26:33,2014-02-17 10:26:33
a4e98f0ec985c91631f41c56317926f29365d95a...1016acc6096849e239d65ae386005b7563f110c6,1,6,3,9,3,2014-11-18 12:59:04,2014-11-18 12:59:04
a4e98f0ec985c91631f41c56317926f29365d95a...b8fcaa7f4126ce2b5fe0436197b2aacc1be84e96,1,3,8,11,2,2014-11-18 11:55:22,2014-10-21 07:59:03
a4e98f0ec985c91631f41c56317926f29365d95a...53bf52f191612df92d993cbcd3c4d6c89ab9c95a,9,76,48,124,43,2014-11-18 11:10:07,2014-11-14 16:23:55
53bf52f191612df92d993cbcd3c4d6c89ab9c95a...f34d5d8a1d952d7ad388290449fbe53207325948,1,1,1,2,1,2014-11-24 12:06:42,2014-11-24 12:06:42
f34d5d8a1d952d7ad388290449fbe53207325948...ef944e83ec8c439350df03c3bb9b5bbb3f68f406,2,2,2,4,2,2014-11-24 14:21:35,2014-11-24 14:21:35
e5a0713f0e699b8e4c79ca3a4780b8deb2411052...230335650d2328bf00e8e2c987887d7d670387da,1,2,12,14,2,2014-04-01 07:19:37,2014-04-01 07:19:37
bdd3513f03a1db060051a29ffcf535821235eac1...9f7757ed24969eb004b5b81e967dff5ee4b78b1e,1,1,1,2,1,2013-10-20 15:29:11,2013-10-20 15:29:11
7210a34bc7c5d1b5d9ccaf8deb0aa4fac9058132...6c5fa569d78bad28fcd9d63edfc7b69715e9ac56,5,25,28,53,9,2013-10-21 07:32:05,2013-10-21 07:32:05
6c5fa569d78bad28fcd9d63edfc7b69715e9ac56...e660da4f43b8fea31153200776a83ea571a17a4c,1,34,0,34,1,2013-10-21 10:04:06,2013-10-21 10:04:06
e660da4f43b8fea31153200776a83ea571a17a4c...7999c2065ebb0dfabd9b152c5e9726c797982773,2,103,35,138,12,2013-10-21 10:05:20,2013-10-21 10:05:20
7999c2065ebb0dfabd9b152c5e9726c797982773...3dc0031fff5666d62d41ec0cc366b81aca102955,1,7,0,7,1,2013-10-21 10:05:52,2013-10-21 10:05:52
3dc0031fff5666d62d41ec0cc366b81aca102955...43dbd7986e878e0a7f93ba962ab8073d22fb09f4,1,2,9,11,2,2013-10-21 10:06:26,2013-10-21 10:06:26
43dbd7986e878e0a7f93ba962ab8073d22fb09f4...36a69b0a309e140cbf87e26422d22b6a634d12c0,3,28,88,116,8,2013-10-21 10:07:16,2013-10-21 10:07:16
36a69b0a309e140cbf87e26422d22b6a634d12c0...8ffbb511381411d962dab1668019064730354490,1,7,2,9,4,2013-10-21 10:26:17,2013-10-21 10:26:17
8ffbb511381411d962dab1668019064730354490...abda0560f150c7754abfff2cb775742ab4eaec7a,2,5,2,7,3,2013-10-21 10:41:32,2013-10-21 10:41:32
abda0560f150c7754abfff2cb775742ab4eaec7a...0407eb2ee60b57caa91e284ce1747e551d38ea73,1,4,1,5,1,2013-10-21 10:47:23,2013-10-21 10:47:23
0407eb2ee60b57caa91e284ce1747e551d38ea73...be7eb8e3c2954e4ba3546d124ee4f9e45657484f,1,3,1,4,1,2013-10-21 11:06:17,2013-10-21 11:06:17
be7eb8e3c2954e4ba3546d124ee4f9e45657484f...cf1416fad736763c8b44e464dcda7c63173551a6,2,4,1,5,2,2013-10-21 11:20:37,2013-10-21 11:20:37
898e2acd33edbaa3eec689542150272f605330b1...bb494203d263104e9f2ac13d18c438798f7a99f8,2,18,1,19,2,2013-10-20 03:57:34,2013-10-20 03:57:34
bb494203d263104e9f2ac13d18c438798f7a99f8...cb9cf077de8bf315842a7f357b65ec7e5b5ce0de,3,142,45,187,3,2013-10-20 05:05:20,2013-10-20 05:05:20
898e2acd33edbaa3eec689542150272f605330b1...bae18f0a9865edd607e64e78be96c4db0a25fe89,1,1,1,2,1,2013-10-19 07:08:54,2013-10-19 07:08:54
bae18f0a9865edd607e64e78be96c4db0a25fe89...53564d90099dacec79f8a4fca010999a3381d9e1,4,4,4,8,4,2013-10-19 07:23:51,2013-10-19 07:23:51
dfade97edffdec9a1e042c620b98e799d74794cf...9d79d6e152858605afeddeeb10f43a5efbdf0376,1,6,1,7,5,2013-11-08 16:49:38,2013-11-08 16:49:38
a967f1229bbbf0187d7ec1ebf289e1c75684c599...1040e88e5645fc3dccf55b418bfbf04d307f3d8b,2,5,5,10,5,2013-10-31 08:42:15,2013-10-31 08:42:15
284546b2e00639bfa5e965f6a846cf308752d58e...58408b96f32869dd67ee28fbcb34c33fae2f9ab3,14,0,0,0,0,2014-01-05 13:56:31,2014-01-05 13:56:31
58408b96f32869dd67ee28fbcb34c33fae2f9ab3...3ce9e7407d09d7fb9d82afc4ee29975c3f558799,7,0,0,0,0,2014-01-05 14:08:12,2014-01-05 14:08:12
959863b92b3b362a2dfb267a4f7ec1cacb9d8ad2...b55f22afc042f937e26a2e019b9b60f66d347b34,1,2,1,3,1,2013-10-31 14:35:06,2013-10-31 14:35:06
b55f22afc042f937e26a2e019b9b60f66d347b34...9ab4539a629e8ab31fc775c71662a7cf4f2384d5,1,1,1,2,1,2013-10-31 17:48:39,2013-10-31 17:48:39
31cdb7a405e5a3683b12a2ac7b4f195444552a96...56d4788264ce2739f5dc89f85f309b69cb3ab692,1,2,1,3,1,2013-12-09 10:07:32,2013-12-09 10:07:32
56d4788264ce2739f5dc89f85f309b69cb3ab692...cd8a90eee5284456f09316dc4663de734d50e667,1,1,0,1,1,2013-12-30 10:39:26,2013-12-30 10:39:26
31cdb7a405e5a3683b12a2ac7b4f195444552a96...2c4e3e001f2e3b22546d9a0288ca7d2d7121fff1,1,1,1,2,2,2013-12-09 10:06:12,2013-12-09 10:06:12
c27e49e916cebf87a5dc9e6cf1669d33f7e8cd8c...d9deb24f3a507933106b2c9a00a9bc73f9eee269,5,64,3,67,6,2013-11-01 14:33:47,2013-11-01 14:33:47
c27e49e916cebf87a5dc9e6cf1669d33f7e8cd8c...482a39abb09871bea6c307c92ed92f7c298cad1d,1,14,14,28,13,2013-11-01 14:25:06,2013-11-01 14:25:06
482a39abb09871bea6c307c92ed92f7c298cad1d...592d1fabd625b5ee1814707296eeeaedca89ac67,1,12,14,26,13,2013-11-01 14:29:28,2013-11-01 14:29:28
592d1fabd625b5ee1814707296eeeaedca89ac67...4c47a89fa5db6ccfcc9ae21fbfd7bb94b427b313,1,1,1,2,1,2013-11-01 14:58:24,2013-11-01 14:58:24
02e39563c8e931c94a650f36d8732beecc068019...475f607a22dcf8ec16c1b51edb638fa624768061,3,12,4,16,5,2013-07-18 10:55:01,2013-07-18 10:55:01
02e39563c8e931c94a650f36d8732beecc068019...bbb06e504e387762bb5a073d1f0debdc05e03f98,6,61,28,89,17,2013-07-18 10:08:48,2013-07-18 10:08:48
bbb06e504e387762bb5a073d1f0debdc05e03f98...b1fbd6583247c85096bc9c7362907db3539e806b,3,7,12,19,7,2013-07-18 10:21:56,2013-07-18 10:21:56
b1fbd6583247c85096bc9c7362907db3539e806b...82e1fe4675226ea9665d9175aeca90a8528052f8,1,0,2,2,1,2013-07-18 10:22:47,2013-07-18 10:22:47
82e1fe4675226ea9665d9175aeca90a8528052f8...33347efa26857243c9e61d4c89d1c4631244c5be,7,14,10,24,7,2013-07-18 10:33:43,2013-07-18 10:33:43
4d373005968b8269a8d2fe56b7776820396127a4...7856fba3621c0c3437f3bd208de0fdab43f0ab9d,2,26,11,37,7,2013-07-30 20:13:01,2013-07-30 20:09:40
7856fba3621c0c3437f3bd208de0fdab43f0ab9d...9a900dbb7104582a9d6c65e48d50cd921d009dc0,1,0,2,2,1,2013-07-30 20:19:17,2013-07-30 20:19:17
d7f551bd3a947ad7f15445a61191f010aca2ef92...d0d10992bc7045c0ffbf07c45aad2f061f88bbc3,1,1,1,2,1,2013-08-03 08:30:07,2013-08-03 08:30:07
d0d10992bc7045c0ffbf07c45aad2f061f88bbc3...2d681c0d1ed14bf23c041aa04fa3e77caceda9a1,1,1,0,1,1,2013-08-03 08:32:17,2013-08-03 08:32:17
06e98c0f9bdf73aa57a58587910236ca29dfd4e3...2db010b6a39da4a3737e63d86dbdb3390e6ca863,2,14,2,16,4,2013-07-27 07:40:38,2013-07-27 07:40:38
8aecfc375c10033ae76c9a7fc94e600a48cd498e...994ad1cbc179ae33daae75056475d2514a443249,1,5,1,6,1,2013-07-26 16:23:26,2013-07-24 21:09:56
55582047413c639a4843f52f9869fafc01bf6522...39d8a64d255a80df1ed3194f88ac56486b027870,6,18,4,22,6,2013-08-15 19:25:09,2013-07-30 14:48:00
55582047413c639a4843f52f9869fafc01bf6522...4b91ffca3e07bb4bebcca67430c58457441ed304,5,5,5,10,5,2013-08-15 17:31:16,2013-08-15 17:31:16
4b91ffca3e07bb4bebcca67430c58457441ed304...bae85fa876c89bcde79011f2a70a7a0747b09efd,1,4,4,8,3,2013-08-15 17:53:10,2013-08-15 17:50:17
bae85fa876c89bcde79011f2a70a7a0747b09efd...f3ee1b42bd7897c3b8943f8e160df66d5086098b,3,3,3,6,3,2013-08-15 17:58:22,2013-08-15 17:58:22
f3ee1b42bd7897c3b8943f8e160df66d5086098b...0b4324938a1b81554032b9583397c4b7c53fb3ec,1,2,2,4,2,2013-08-15 18:01:05,2013-08-15 18:01:05
0b4324938a1b81554032b9583397c4b7c53fb3ec...602e2e68d956a53cf411124e0548d7a93139768f,7,25,24,49,16,2013-08-15 18:19:29,2013-08-15 18:19:29
602e2e68d956a53cf411124e0548d7a93139768f...3f28d9f7338cf0e061eba41881def195d61c6954,5,12,12,24,11,2013-08-15 18:31:00,2013-08-15 18:31:00
3f28d9f7338cf0e061eba41881def195d61c6954...a50b787d58d95cc4b98211bc4197cbdbe14c524b,1,1,1,2,1,2013-08-15 19:04:09,2013-08-15 19:04:09
a50b787d58d95cc4b98211bc4197cbdbe14c524b...9b4e389ba91d58a7fcd334e7d47c584237d6111b,1,1,1,2,1,2013-08-15 19:06:43,2013-08-15 19:06:43
55582047413c639a4843f52f9869fafc01bf6522...aaeaf7c973fb2d48a16cdd1b8af45c00c634611e,1,1,1,2,1,2013-08-15 12:02:39,2013-08-15 12:02:39
b6d0dd871c7c8caa4809e1e8b60f6e4bb66f38c2...7683efc6be4a57fe2105916879dc8c50f4024086,5,33,28,61,9,2013-08-02 10:44:25,2013-08-02 10:44:25
7683efc6be4a57fe2105916879dc8c50f4024086...4e82d1752ff8595ad35e9eac69134a6bdf18e626,1,1,1,2,1,2013-08-02 12:20:55,2013-08-02 12:20:55
4e82d1752ff8595ad35e9eac69134a6bdf18e626...f003ad59dd43bb0e80f23b805c3d1b0f9d0108b1,1,1,3,4,1,2013-08-02 12:50:04,2013-08-02 12:50:04
27b7aeddfbd4b927c45d574c2c1cc846abe0cca2...bc3a4d319469887ad6667a9b7726963cbe72eabc,1,1,0,1,1,2013-08-07 07:40:26,2013-08-06 19:24:29
a45e4721e022e7b09d06b45fadab1ac09bf32673...f95f1bb338c2ba02c14cf901923717eaed2321dc,1,1,1,2,1,2013-04-15 16:36:00,2013-04-15 16:36:00
a45e4721e022e7b09d06b45fadab1ac09bf32673...5f8f685bd45b65f0b8506988b7ad9447f2026abb,1,63,0,63,1,2013-04-15 16:01:02,2013-04-15 16:01:02
5f8f685bd45b65f0b8506988b7ad9447f2026abb...6a4a17f3399904b43275c4a2d53322cb2b011aca,1,12,14,26,7,2013-04-15 16:01:36,2013-04-15 16:01:36
6a4a17f3399904b43275c4a2d53322cb2b011aca...d74d7c7cfb49ead619d21e35f07b1feba8295118,3,19,4,23,5,2013-04-15 16:02:05,2013-04-15 16:02:05
d74d7c7cfb49ead619d21e35f07b1feba8295118...4da8b37e6776af07c7542552155cc06358728d22,1,1,1,2,1,2013-04-15 16:02:36,2013-04-15 16:02:36
4da8b37e6776af07c7542552155cc06358728d22...771b5c22987870c84e0bfa90549af1567cb21117,1,7,0,7,1,2013-04-15 16:33:44,2013-04-15 16:33:44
771b5c22987870c84e0bfa90549af1567cb21117...880cb8aa487a78c22bedb26b3cfd0e1d8590a932,2,2,0,2,2,2013-04-16 06:26:01,2013-04-16 06:26:01
a45e4721e022e7b09d06b45fadab1ac09bf32673...efe90876062b3ca0f645baa7091d865c759c4da2,1,4,1,5,2,2013-04-15 15:05:48,2013-04-15 15:05:48
c946defb3d9ff2ad87a410f2e25999465c4b9065...7d037c111be4a2357452510d524421c74204a814,2,45,104,149,8,2013-11-14 15:01:23,2013-11-14 15:01:23
7d037c111be4a2357452510d524421c74204a814...9fbbae9dbf9d2358d0cde2ae0b7f627da53f85d0,6,22,29,51,15,2013-11-14 15:23:31,2013-11-14 15:23:31
c946defb3d9ff2ad87a410f2e25999465c4b9065...0ab0ca0d9d92f7343e094bec1aaafa7469bce9e9,10,10,10,20,10,2013-11-14 12:35:45,2013-11-14 12:35:45
c946defb3d9ff2ad87a410f2e25999465c4b9065...91c7b266cdffbd82ac70f35ca9bd5d08b989dbe3,2,33,10,43,3,2013-11-13 19:56:35,2013-10-23 20:27:40
91c7b266cdffbd82ac70f35ca9bd5d08b989dbe3...b89d8497f6bf911a74c350dfce6256c2a08ef59b,2,3,1,4,2,2013-11-13 20:07:53,2013-11-13 20:07:53
33eae33423d224e10a3a9aeefd70d632d70b20fe...3bab1bd4c162239dcf582a82360cf94d4953ef69,6,18,18,36,11,2013-11-20 08:03:50,2013-11-20 08:03:50
949c6c1b0a980075a49681064fc06034a4ab69aa...8c7d342a284a53da80c9028f73eb8fa3ed83af28,1,1,0,1,1,2013-11-26 11:34:20,2013-11-26 11:34:20
d793bceb90c3e2a7e2302531a69d6e693e66ae78...16916fb103ef0e7f848536a63b57f301e3e08e03,1,5,6,11,4,2013-12-03 10:19:48,2013-12-03 10:19:48
16916fb103ef0e7f848536a63b57f301e3e08e03...640b913ac63415a2fda946a4d2dd4ce4c730985f,3,4,4,8,2,2013-12-03 13:38:55,2013-12-03 13:38:55
640b913ac63415a2fda946a4d2dd4ce4c730985f...a4cbdbb10dc692d95407944ef6f0769700ac5ba3,2,28,28,56,12,2013-12-04 07:13:09,2013-12-04 07:13:09
a718a9af3e9a4f7431cab066fc81f3311f9fe639...7e42084fb800546070d3c5d0d704320d1785fdda,6,31,25,56,15,2014-02-18 19:18:46,2014-02-18 19:18:46
7e42084fb800546070d3c5d0d704320d1785fdda...88b8b15dbdc1247b349c9fc6f8d71377322890b9,7,50,31,81,13,2014-02-18 20:05:44,2014-02-18 20:05:44
88b8b15dbdc1247b349c9fc6f8d71377322890b9...83d35399d13fa46020b004f966d67fb527b8809c,1,19,19,38,1,2014-02-18 20:29:12,2014-02-18 20:29:12
83d35399d13fa46020b004f966d67fb527b8809c...ee750298675f0beed94688a9798d3e0b8362b455,4,16,13,29,10,2014-02-19 07:38:01,2014-02-19 07:38:01
ee750298675f0beed94688a9798d3e0b8362b455...ededfd2d29bea4fff7c69634dc813c274eb346ee,1,6,10,16,8,2014-02-19 08:35:24,2014-02-19 08:35:24
64dbcfe27f362ebbb3da840b0914c40dba814505...883c86a59e8ad7ec85891ad7a45340ea7caa2ca9,2,4,4,8,4,2014-02-18 07:04:30,2014-02-18 07:04:30
64dbcfe27f362ebbb3da840b0914c40dba814505...423dcb46eeba31461f02424c0afa1629b24f9652,3,4,3,7,3,2014-02-17 16:23:11,2014-02-17 16:23:11
0cc4a41d41823699ac6e6e30cd9cc44f70b661f7...e0022912d77a40938c576d4b67a61d8322473210,1,2,2,4,2,2014-02-17 16:30:50,2014-02-17 16:30:50
c58edd7c708c39a6e7c60bd96c7f97ced370f304...1f902c2464a4f5c68f1b42be597d4e3e25a32130,1,2,2,4,2,2014-11-12 11:06:24,2014-11-12 11:06:24
e37461979a5eb890975125134e7717c470c76a5f...d0f6654e9ced38d03f5946fde10c3f0e3732a5d7,1,3,3,6,2,2014-11-18 07:12:05,2014-11-18 07:12:05
e37461979a5eb890975125134e7717c470c76a5f...da35baed656a90eb5531955d591152c7142cd0cb,3,206,19,225,14,2014-11-17 21:56:51,2014-11-17 21:56:51
cfee95d0327485dffb8ea4d698d3f7f310fc6c19...f7bf892cca6bb8106194c14bef1ed9ddfc26ec91,8,40,98,138,15,2014-11-18 15:14:36,2014-11-18 15:14:36
f7bf892cca6bb8106194c14bef1ed9ddfc26ec91...8e7fa0c2a1add0c583409c2617bc06e949cd3a72,2,4,1,5,2,2014-11-18 15:15:51,2014-11-18 15:15:51
f4b9a65c05f24c3558687c98b5163b465dc46314...31f7560332ba710d962a4055dbd8c6c02d5c06cb,1,1,1,2,1,2014-11-30 13:25:17,2014-11-30 13:25:17
b70cee9c2fde878d77b1540c31e7560ea9f97460...0dcc1e88a4a9a1fe4745421474fcb3e93bfb87ef,3,109,0,109,3,2014-11-27 14:48:19,2014-11-27 14:48:19
b70cee9c2fde878d77b1540c31e7560ea9f97460...6818c96db02546a61730d5cfd799dce9e2a85c16,1,3,3,6,1,2014-11-26 13:30:14,2014-11-26 13:30:14
6818c96db02546a61730d5cfd799dce9e2a85c16...3e60dd7cb510fa00794701925ae0776332c09163,1,1,1,2,1,2014-11-26 14:49:25,2014-11-26 14:49:25
b70cee9c2fde878d77b1540c31e7560ea9f97460...434c4a2b5d0a6b89d050f3b7b4e4e4442ffde733,1,2,2,4,2,2014-11-25 23:31:50,2014-11-25 23:31:50
b70cee9c2fde878d77b1540c31e7560ea9f97460...bc16f81321b69b829c432af72840a4529ce3228a,1,1,1,2,1,2014-11-25 18:18:56,2014-11-25 18:18:56
9be05a430b312190dd884d9f6145bac7dd3e6485...24ea884fab740ea9c666179a61c53d5768a8db89,1,1,1,2,1,2014-04-01 09:30:07,2014-04-01 09:30:07
24ea884fab740ea9c666179a61c53d5768a8db89...3b0510a7c124a8511966ad4785757bd4d78998ac,1,1,1,2,1,2014-04-01 10:08:16,2014-04-01 10:08:16
b98bd5c8d07adab118775e9dc8aaf62fae733c38...049cb4bf894840c38c8ad54be800e552028b0310,1,1,1,2,1,2014-04-02 10:10:01,2014-04-02 10:10:01
b98bd5c8d07adab118775e9dc8aaf62fae733c38...9ae11007fee229f39c6edc072597d1b457c8f982,1,4,0,4,1,2014-04-01 08:41:57,2014-04-01 08:41:57
b98bd5c8d07adab118775e9dc8aaf62fae733c38...799361a389f890620bd11d75f2fae5a6aa4fc9e6,3,4,1,5,3,2014-04-01 08:28:55,2014-04-01 08:28:55
9f7757ed24969eb004b5b81e967dff5ee4b78b1e...ae4a20133fb2917368a3f937da55da12a53a1863,1,31,11,42,2,2013-10-21 03:58:38,2013-10-21 03:58:38
9f7757ed24969eb004b5b81e967dff5ee4b78b1e...e41f4a84805f501da18428dea1d96a495b96d703,1,1,1,2,1,2013-10-21 02:20:53,2013-10-21 02:20:53
9f7757ed24969eb004b5b81e967dff5ee4b78b1e...511f666fc492e653c91179efa36dcc24a73980d9,1,1,1,2,1,2013-10-20 19:10:51,2013-10-20 19:10:51
396e484a0d3cedc76eadf95ee29d940d6cd95443...3f66131b574ebcd5dd9fe3b5c7a6152fa535a1d2,1,2,2,4,2,2013-10-21 13:16:08,2013-10-21 13:16:08
3f66131b574ebcd5dd9fe3b5c7a6152fa535a1d2...85be902e0847bc7a6d49f6b2186bd59e6841f959,1,6,0,6,1,2013-10-21 13:50:42,2013-10-21 13:50:42
ad41430c29514d14e79722c8813df246949fd798...f9b66aecddb248dcd501419e0ee94fd69fab4de3,5,17,19,36,19,2013-11-05 13:35:49,2013-11-05 13:35:49
a1ded954911224f6c24ce3ded144718278884930...d55428b8424f1a6469b2b8e92a03994de79b0fd3,1,1,1,2,1,2013-10-31 09:25:08,2013-10-31 09:25:08
c0f6a932b9277a49232348029198f3094276a84b...f1c82bc56c9391abac5ba9b70e406d899cf26495,3,21,14,35,17,2013-12-09 17:32:37,2013-12-09 17:32:37
c0f6a932b9277a49232348029198f3094276a84b...ee4dd77d130b1ea26b053870eb1ba3b07469a595,1,4,2,6,2,2013-12-09 16:50:30,2013-12-09 16:50:30
c0f6a932b9277a49232348029198f3094276a84b...ccf2e48a2c957eb420dc92e914be045c00d72a53,1,1,0,1,1,2013-12-09 14:36:21,2013-12-09 14:36:21
c0f6a932b9277a49232348029198f3094276a84b...954dd3986184d4c8c6886e97ba11c0c333c01ebb,1,3,1,4,1,2013-12-09 14:26:43,2013-12-09 14:26:43
dbf8ae7301b50d1652ce1ccbf974e8b8ac88ffd3...d0637d63dbf6cd30e9e032e3d79dab9f77a0007d,1,4,0,4,1,2013-12-09 14:00:06,2013-12-09 14:00:06
dbf8ae7301b50d1652ce1ccbf974e8b8ac88ffd3...29cb573b6ced5cfeca0fc905040ff615e2d76835,3,36,14,50,12,2013-12-09 13:05:50,2013-12-09 13:05:50
29cb573b6ced5cfeca0fc905040ff615e2d76835...38be0ed79e8643e002b0e0697aba2fb553a78a0b,1,1,1,2,1,2013-12-09 13:17:33,2013-12-09 13:17:33
38be0ed79e8643e002b0e0697aba2fb553a78a0b...fc088f0c715cfebfad98532c23975221eff5c2d1,1,4,1,5,1,2013-12-10 09:22:22,2013-12-10 09:22:22
6579de0727b37535ecba3a8f6188f51a714e3a3e...8fc29329109d68635fd352127c61125c74ccfa64,1,8,8,16,8,2014-01-07 10:05:44,2014-01-07 10:05:44
6579de0727b37535ecba3a8f6188f51a714e3a3e...09cbe95b20f87ac95dd84a3a033e3f0a1b9aa5a5,3,48,0,48,6,2014-01-06 21:38:13,2013-12-26 16:50:29
4c47a89fa5db6ccfcc9ae21fbfd7bb94b427b313...bc8a875df1609728f1c7674abef46c01168a0d20,1,1,1,2,1,2013-11-03 13:51:10,2013-10-22 07:55:44
4c47a89fa5db6ccfcc9ae21fbfd7bb94b427b313...68da4154af6c7ca782f5cac2cebafb355b925b0c,3,7,0,7,7,2013-11-02 22:19:35,2013-11-02 22:19:35
4c47a89fa5db6ccfcc9ae21fbfd7bb94b427b313...17105038caf237687ad0fc9f34bf5f368d0cc8a5,2,40,0,40,2,2013-11-02 22:12:29,2013-11-02 22:12:29
4c47a89fa5db6ccfcc9ae21fbfd7bb94b427b313...4637dc896c1eef960d99751d518b83cf9c9f45ec,1,10,3,13,3,2013-11-02 13:53:33,2013-11-02 13:53:33
4c47a89fa5db6ccfcc9ae21fbfd7bb94b427b313...dfe19b2b84498af2eb0c7e401fda8f9eddfd0f46,2,2,1,3,2,2013-11-01 16:29:37,2013-11-01 16:29:37
4c47a89fa5db6ccfcc9ae21fbfd7bb94b427b313...9e31555afb6422ffe911283f29ba1fc3b95d3321,3,3,3,6,3,2013-11-01 15:38:55,2013-11-01 15:38:55
0d715bcd812ca6c99884e117f28a400669aa8e57...d19d094b935b6b1b773d369893d4f112e91b38a9,5,10,13,23,14,2013-07-30 11:12:24,2013-07-30 11:12:24
8886b900cad751273044d40d9d0eefbe1ea81616...9efdebaf128e88788948efce7e1008783c8fcb79,1,3,3,6,2,2013-08-03 12:40:43,2013-08-03 12:40:43
2db010b6a39da4a3737e63d86dbdb3390e6ca863...b5668234b1b33cc72c36ed167baf40a3101c801d,10,1,10,11,10,2013-07-27 16:34:37,2013-07-27 16:34:37
04806be3bfa5ac095d526f21b7727edcaa2fec7c...3648c83ec04addd6ca957cf22c25e5308b067a56,1,1,1,2,1,2013-07-27 10:25:40,2013-07-27 10:25:40
f2b37438199dfb05ccfa5ef454d954e02380d2c9...f7b922c687dde96759b119dfaf0a5dd89eb4b9b8,1,96,96,192,1,2013-08-16 09:49:49,2013-08-16 09:49:49
f7b922c687dde96759b119dfaf0a5dd89eb4b9b8...3bc4845874112242d6e885731c033ffe85ee98dd,2,15,6,21,6,2013-08-16 09:53:52,2013-08-16 09:53:52
a410bc12898ba7cd422997d332d87ef8ff20d48e...fd7c8c71e5ced72b501b015adedd295f14017785,1,1,1,2,1,2013-08-19 15:52:19,2013-08-19 15:52:19
fd7c8c71e5ced72b501b015adedd295f14017785...4250c349152e252ff36bab54c53d7b267a5b1232,3,4,4,8,4,2013-08-19 17:11:41,2013-08-19 17:11:41
b58eeeaf105f345702f55d337bd49803a8601fbe...a43a38039476598fe1e959b29d7033a5b1b1c8d0,3,3,5,8,4,2013-08-07 19:51:36,2013-08-07 19:51:36
880cb8aa487a78c22bedb26b3cfd0e1d8590a932...edf41005b2c6cf3d429b8ca10f41fe64306b044a,3,16,1,17,4,2013-04-16 09:45:45,2013-04-16 09:45:45
edf41005b2c6cf3d429b8ca10f41fe64306b044a...133d78229ec092cb5360d600b62286c7320869ff,4,23,0,23,4,2013-04-16 10:13:29,2013-04-16 10:13:29
83b0a24e0520c468a5bfe7cff4b6df921395172b...100615896b6ef67b56dba598739bc01992b14399,1,24,0,24,2,2013-11-18 16:59:09,2013-11-18 16:59:09
83b0a24e0520c468a5bfe7cff4b6df921395172b...f51c21b671c9abedc5773a3cf17b0d762cee814b,2,4,1,5,2,2013-11-14 15:57:09,2013-11-14 15:57:09
f8f76fdbfd06184c53c4dc3832601f3c07aeba77...cb589d231aaa9f4cf7a10c41d6fd1ebe34428173,2,5,4,9,5,2014-01-09 08:29:55,2014-01-09 08:29:55
a1d88f0fede0fc34aec671318d3f02b78e776bb4...3f3b202c6efa17a8e6731ba44c5f3bf672c28672,4,25,3,28,7,2013-11-20 08:21:45,2013-11-20 08:21:45
99490159e5f9d6ff4b45f78b977d01caa1e3c4fc...0429740af6ce639beb1d31505c4eaa2f325893eb,1,4,0,4,4,2013-12-16 17:56:47,2013-12-16 17:56:47
99490159e5f9d6ff4b45f78b977d01caa1e3c4fc...28bb65f3637ae16c98f374248e3ffa5f26983443,2,6,7,13,2,2013-12-16 17:34:56,2013-12-16 17:34:56
99490159e5f9d6ff4b45f78b977d01caa1e3c4fc...37383966ef3fada865d3d21a8ce7a3c640bbd11e,18,251,16,267,33,2013-12-16 13:39:14,2013-11-29 16:10:59
6d125d477169f93834a1b6a78da39baa77f41968...8841eec426d7213de6cc381b0898be1a14e418e5,5,35,7,42,9,2013-11-18 19:34:07,2013-11-18 19:34:07
51b5509bacdfba1d3ca84a4b56c6bd21942f1d2e...526c2fdf48add9c5051514f987494244b5d6b45e,2,3,3,6,3,2013-11-27 07:49:21,2013-11-27 07:49:21
51b5509bacdfba1d3ca84a4b56c6bd21942f1d2e...d9bb4230cc3aa161876df821c34d8e9c53d2e7a6,50,955,156,1111,126,2013-11-27 04:22:07,2013-11-06 15:13:21
a4cbdbb10dc692d95407944ef6f0769700ac5ba3...6f0725119c87efaab0b97953c02499678ae48ea2,1,3,1,4,1,2013-12-04 08:02:36,2013-12-04 08:02:36
6a18fd986270c7a0507d48c176bdefc52bd68b03...0bd0c8149bd83f422c38c8aff20d5b698b84f6bb,1,3,1,4,2,2014-02-19 10:06:10,2014-02-19 10:06:10
0bd0c8149bd83f422c38c8aff20d5b698b84f6bb...2b8d2891304b4ecc71c0c9eae0952633a15b42fb,2,2,2,4,2,2014-02-19 11:10:31,2014-02-19 11:10:31
6a18fd986270c7a0507d48c176bdefc52bd68b03...c9befd3d1b91fa7c559f8718f88b274f24688c59,1,22,22,44,12,2014-02-19 09:55:26,2014-02-19 09:55:26
75c3dc9efcc88b8cc9a3d1013fbb5358bb64b432...8e6ff86d3814f017448eb4b82065f8fa7cb526e1,1,5,2,7,3,2014-11-23 10:32:23,2014-11-23 10:32:23
75c3dc9efcc88b8cc9a3d1013fbb5358bb64b432...44e53aefd471081759d9fba160d9a651d520626e,1,4,0,4,1,2014-11-23 10:28:34,2014-11-23 10:28:34
75c3dc9efcc88b8cc9a3d1013fbb5358bb64b432...214f6985a825b6b6f4119abc7b2b7147e7f97d20,1,2,1,3,1,2014-11-17 11:03:03,2014-11-17 11:03:03
75c3dc9efcc88b8cc9a3d1013fbb5358bb64b432...c89c2ddd8697f4e31de63787e57617ba9d061feb,1,0,2,2,1,2014-11-16 16:17:59,2014-11-16 16:17:50
75c3dc9efcc88b8cc9a3d1013fbb5358bb64b432...5b5446bd761e1d6b07171ba5c6c9b994f797b6a8,1,0,2,2,1,2014-11-15 14:25:08,2014-11-15 14:25:08
75c3dc9efcc88b8cc9a3d1013fbb5358bb64b432...987007b8dbfdfb6ebd2831f135f3b4b6641f63d0,1,1,2,3,2,2014-11-15 10:17:01,2014-11-15 10:17:01
d803f210aa5e87a441fca562910122f2cfde9fa6...533f4cdf30b38c587f7a91f0dfd898b907ecd944,8,98,40,138,15,2014-11-18 10:38:23,2014-10-22 08:54:59
435128171ddf41025f410429b8a639a368e77582...e683d9c087cc503cd8cb11214ddf265897e726c0,7,28,15,43,8,2014-11-20 16:18:16,2014-11-20 16:18:16
435128171ddf41025f410429b8a639a368e77582...f9aead9f6e7e477236a51fa4eab3a6cba5dd2331,2,6,1,7,2,2014-11-18 16:00:38,2014-11-18 16:00:38
435128171ddf41025f410429b8a639a368e77582...7fb3b908ed825282a2b540e514a92a6cd8e267c5,2,5,5,10,5,2014-11-18 15:51:39,2014-11-18 14:43:24
291571ec29f1352336e34b5abee4ef6c67b16179...b34f1be47f667412fc4355bafd17163f2a9f8466,2,3,6,9,4,2014-11-19 13:48:28,2014-11-19 13:48:28
31f7560332ba710d962a4055dbd8c6c02d5c06cb...191aa9712eeb8fe39e8947dc681cefe4221044ec,1,14,12,26,5,2014-11-30 16:24:05,2014-11-30 16:24:05
c431ae419d75ea79ed22a5107c261e60f40f24a9...b82a205b740840e2a7d0fa3eecf3e361ca73416e,1,32,0,32,1,2014-11-26 17:51:12,2014-11-26 17:51:12
b82a205b740840e2a7d0fa3eecf3e361ca73416e...8ccaee19792ac10dffd7a86be0835f2ea5674d0e,2,1,1,2,1,2014-11-26 19:54:42,2014-11-26 19:54:42
8ccaee19792ac10dffd7a86be0835f2ea5674d0e...c85d4af88921aba31afd39c3403fe2d41381c2ca,2,1,1,2,1,2014-11-27 09:24:19,2014-11-27 09:24:19
5fad132579f6c366a113e952abe43a8a46b1a3d5...226819c8d171d3fd6f4c5d87649b460d84de6fa9,1,3,0,3,2,2014-11-26 20:19:19,2014-11-26 20:19:19
3b0510a7c124a8511966ad4785757bd4d78998ac...cfd9fd30d60c5a880785acda27e9f3d55b17e4ef,6,67,21,88,6,2014-04-02 10:38:35,2014-04-02 10:38:35
cfd9fd30d60c5a880785acda27e9f3d55b17e4ef...c4e81ed9de6a5bbfe089e9b61ca0400167e489f3,8,74,28,102,10,2014-04-02 10:54:41,2014-04-02 10:54:41
c4e81ed9de6a5bbfe089e9b61ca0400167e489f3...0d41f6f0a3ab23cee63e349eda5fb79240734dd4,2,0,30,30,2,2014-04-02 12:37:57,2014-04-02 12:37:57
0d41f6f0a3ab23cee63e349eda5fb79240734dd4...cc773654883d34c70462eeeeb280453473c35e21,5,43,10,53,5,2014-04-02 12:38:24,2014-04-02 12:38:24
cc773654883d34c70462eeeeb280453473c35e21...ed67ba966336c71583229063a12553f432643d64,2,11,2,13,2,2014-04-02 12:50:50,2014-04-02 12:50:50
ed67ba966336c71583229063a12553f432643d64...7d8d9bd1a16e8cf1d87bc7e5115d6c1e7eb14c75,1,0,99,99,1,2014-04-02 12:51:37,2014-04-02 12:51:37
7d8d9bd1a16e8cf1d87bc7e5115d6c1e7eb14c75...1b5fb4ac2187c0a9cd775686740615a9e2311646,1,1,1,2,1,2014-04-02 13:08:49,2014-04-02 13:08:49
1b5fb4ac2187c0a9cd775686740615a9e2311646...928fbeeec057692d923146994c4b8dff57024417,2,57,2,59,6,2014-04-02 13:33:07,2014-04-02 13:33:07
928fbeeec057692d923146994c4b8dff57024417...49f977d675b44b6aae0f491fbbf86dd1ee05eb64,5,5,11,16,6,2014-04-02 16:55:23,2014-04-02 16:55:23
3b0510a7c124a8511966ad4785757bd4d78998ac...cf788f3d97658fe874d850ae450bcca8f10b1678,1,1,1,2,1,2014-04-01 15:03:58,2014-03-31 14:39:12
3b0510a7c124a8511966ad4785757bd4d78998ac...03b14bb814a655b1ba13f318f67b78147ec47546,1,1,1,2,1,2014-04-01 14:46:27,2014-04-01 14:46:27
3b0510a7c124a8511966ad4785757bd4d78998ac...bbea1d1a72cbe0d2b53316e6d67c361a58207de7,1,1,0,1,1,2014-04-01 14:05:26,2014-04-01 14:05:26
2ceef7691795958e657f24d78089eecb0eb4a90d...6a9eb4b231fc7e563b9c3551dafc5d1bfdc959b3,3,38,14,52,16,2014-04-06 09:57:48,2014-04-06 09:57:48
bc40efa19d499f603c80c77b1d1e291bd4373be6...4cc2afdf2eb414cb4aeea5ffab1ac86f56e97a55,1,1,1,2,1,2014-04-06 15:42:24,2014-04-06 15:42:24
bc40efa19d499f603c80c77b1d1e291bd4373be6...8e7f80eed180e092ce5052175e6a7b5d7af9e58a,11,133,103,236,28,2014-04-06 14:10:37,2014-04-06 14:10:37
f9b66aecddb248dcd501419e0ee94fd69fab4de3...a540ab429025695659bcfad50ae9943cca6c60a9,4,19,15,34,16,2013-11-06 13:02:28,2013-11-05 14:00:48
a540ab429025695659bcfad50ae9943cca6c60a9...36f3de4f59313c2f3582dd65f802b9ebf92e6bb9,1,4,2,6,3,2013-11-06 13:02:28,2013-11-05 15:25:37
f9b66aecddb248dcd501419e0ee94fd69fab4de3...6424ec936e4faa1d236579714efc825939766ce9,1,10,13,23,7,2013-11-05 14:58:13,2013-11-05 14:58:13
6424ec936e4faa1d236579714efc825939766ce9...b813a4888a8755a0944fbe96c6fd35485137bf3c,3,9,7,16,6,2013-11-05 15:15:43,2013-11-05 15:15:43
f9b66aecddb248dcd501419e0ee94fd69fab4de3...d78b6ce4cc01ac5da52246c149f57de456b904ae,5,29,3,32,9,2013-11-05 14:41:29,2013-11-05 14:41:29
bc82b2f803a0503965258cd7c32b2893b717ce19...a215dbe43a7eff508b46a757dd29e6bc71b29c43,1,1,0,1,1,2013-12-09 18:13:08,2013-12-09 18:13:08
0253c949a2569e02eba7585a794e0db4aaee4406...8fc9b5c0e26b05f88396cc896a2079b88325c4ce,2,1,12,13,2,2014-01-12 16:32:46,2014-01-12 16:32:46
8fc9b5c0e26b05f88396cc896a2079b88325c4ce...9c7d821cf752a98f8c7a40056816f6629ca1f734,1,15,0,15,2,2014-01-12 16:47:58,2014-01-12 16:47:58
8e006c64d3ac2602ef0ac45576f15ad7d96e8401...6d86b698e33044f4ffdfa682e47194464ce5702b,1,4,1,5,1,2013-11-04 13:18:55,2013-11-04 13:18:55
186e8ad9964d712647aefc75b17ae91f75a18601...27fe6cbe137cbc63865740b97840a9a7386b73b7,1,11,3,14,3,2013-11-04 19:28:07,2013-11-04 19:28:07
186e8ad9964d712647aefc75b17ae91f75a18601...d419a59c5e8f8f1c6a444cb030292e724241703f,3,15,1,16,4,2013-11-04 13:21:05,2013-11-04 13:21:05
186e8ad9964d712647aefc75b17ae91f75a18601...aff447b4ddeaa32650efb12995afd2648b715bdc,1,1,1,2,1,2013-11-04 09:08:13,2013-11-04 09:08:13
9e31555afb6422ffe911283f29ba1fc3b95d3321...88c15909f9e369eeef6ca9c7a1d3e16ba15b4062,9,27,0,27,9,2013-11-02 15:49:26,2013-11-02 15:49:26
88c15909f9e369eeef6ca9c7a1d3e16ba15b4062...faa6a34a17ef12fe29fd39cf29b0f2889bfa6144,2,17,9,26,9,2013-11-02 16:05:06,2013-11-02 16:05:06
faa6a34a17ef12fe29fd39cf29b0f2889bfa6144...5f0bb6cfa88d5388e855b178d7944a993ef7cb24,3,105,2,107,3,2013-11-02 16:13:38,2013-11-02 16:13:38
5f0bb6cfa88d5388e855b178d7944a993ef7cb24...81f69b5d310a958d93d7e433c0446730e4fa4e82,4,4,4,8,4,2013-11-02 16:24:43,2013-11-02 16:24:43
81f69b5d310a958d93d7e433c0446730e4fa4e82...7265b4068d0a9b83b34cc7b802041e37199ba90f,1,5,2,7,3,2013-11-02 16:32:14,2013-11-02 16:32:14
4537623d12fb7372262267be5d6ec3b41f3f476c...3f9b1d62effb576213e43f6ef9f55587ad3d9a67,1,36,32,68,18,2013-08-08 09:30:50,2013-08-08 09:30:50
3f9b1d62effb576213e43f6ef9f55587ad3d9a67...f4978bc08ea9fa4468d70eefaa32fd1eeafce5a9,1,2,1,3,2,2013-08-08 09:44:33,2013-08-08 09:44:33
f4978bc08ea9fa4468d70eefaa32fd1eeafce5a9...ca52f848411efaa5ccfb364c2169b38a8e9644b4,10,99,82,181,55,2013-08-08 12:14:59,2013-08-08 12:14:59
ca52f848411efaa5ccfb364c2169b38a8e9644b4...02c3bb7a32058a355756f0f77b2b8208913205e5,4,31,21,52,11,2013-08-08 13:14:38,2013-08-08 13:14:38
02c3bb7a32058a355756f0f77b2b8208913205e5...7fefb0397eea99910537541bbba70d0a68a44644,10,31,26,57,18,2013-08-08 14:29:31,2013-08-08 14:29:31
7fefb0397eea99910537541bbba70d0a68a44644...2388ca0f3299ceb06b234fe08eaa71d79e6f0801,1,5,10,15,4,2013-08-08 14:42:27,2013-08-08 14:42:27
38ef603bfbe8b381461e05e7ee6c71dbb97af431...73c163fb1d2ec95c0590afd0a8fa12c57de17155,2,7,3,10,2,2013-08-04 10:16:27,2013-08-04 10:16:27
73c163fb1d2ec95c0590afd0a8fa12c57de17155...53a7568098618dcd78242864c16187eda61aa562,1,3,0,3,1,2013-08-04 13:22:06,2013-08-04 13:22:06
53a7568098618dcd78242864c16187eda61aa562...49709b1d8a7530ba02bb279eff0fb16cfc7eaf35,1,1,1,2,1,2013-08-04 13:27:32,2013-08-04 13:27:32
49709b1d8a7530ba02bb279eff0fb16cfc7eaf35...5d4afc0f2b2cf29cbd0bc38a76a06deafc479130,3,6,0,6,3,2013-08-04 13:35:18,2013-08-04 13:35:18
cb86cf844c4abddba6e5d5e43cebd3297d724897...a7fab42b9cd34ddd44ff2ab0837691f57428b8e4,6,87,16,103,11,2013-07-27 18:23:35,2013-07-27 18:23:35
a7fab42b9cd34ddd44ff2ab0837691f57428b8e4...efa267602122dc2aa5ee789a87fe4039c7ffe484,4,10,3,13,4,2013-07-29 13:50:00,2013-07-29 13:50:00
efa267602122dc2aa5ee789a87fe4039c7ffe484...dd8f090bc84a96bce0f086a8be9840751da21747,2,2,2,4,2,2013-07-29 13:51:04,2013-07-29 13:51:04
dd8f090bc84a96bce0f086a8be9840751da21747...4de1db11685811e06b351fdcfe92c1d7a34e3246,3,53,0,53,3,2013-07-29 14:07:03,2013-07-29 14:07:03
205107fea1906b5f9a1b95c482cfb515381256c1...5e0e97ec5dd963a33a6522b0095a15abf987d6e0,1,0,1,1,1,2013-07-29 09:12:44,2013-07-29 09:12:44
96e89ec36f583644e325f37285e745f8779922eb...37e1f53734cb314861097bdf1d0b19adb948fe4b,1,2,1,3,2,2013-08-16 12:28:32,2013-08-16 12:28:32
37e1f53734cb314861097bdf1d0b19adb948fe4b...14db7042316c7b47153a70b1cb1f07bb3b3430eb,2,0,2,2,2,2013-08-16 12:37:42,2013-08-16 12:37:42
14db7042316c7b47153a70b1cb1f07bb3b3430eb...ffa234bc80465be160dc93fedeff1eb3ee1c15ba,1,3,3,6,1,2013-08-16 12:40:55,2013-08-16 12:40:55
ffa234bc80465be160dc93fedeff1eb3ee1c15ba...0e387919c3827260434aed48e1f28ee02ce5e58d,6,17,29,46,7,2013-08-16 13:59:26,2013-08-16 13:59:26
4250c349152e252ff36bab54c53d7b267a5b1232...6ec73fc9a64938566d2e6d1a804990fa0f8849f0,2,3,7,10,3,2013-08-19 19:49:27,2013-08-19 19:49:27
6ec73fc9a64938566d2e6d1a804990fa0f8849f0...7c55c73d6318004242b192c7c6ce17cc57e45760,7,10,248,258,15,2013-08-19 19:54:12,2013-08-19 19:54:12
7c55c73d6318004242b192c7c6ce17cc57e45760...63009af1176c114029827679c3eb632ad5edca26,2,15,2,17,3,2013-08-19 20:20:32,2013-08-19 20:20:32
4250c349152e252ff36bab54c53d7b267a5b1232...125c07fa0aa31e6c83c8fcc90df623c2ef85832f,2,9,1,10,4,2013-08-19 19:10:21,2013-08-19 19:10:21
125c07fa0aa31e6c83c8fcc90df623c2ef85832f...7047a44a26f0f75ab23c58c47d096060c01256ed,2,16,0,16,4,2013-08-19 19:10:56,2013-08-19 19:10:56
7047a44a26f0f75ab23c58c47d096060c01256ed...2e5481b74663deddeda66ccd74eb7e38649cccb7,1,31,0,31,1,2013-08-19 19:11:18,2013-08-19 19:11:18
2e5481b74663deddeda66ccd74eb7e38649cccb7...c1583c6d74e7a7088cf6d22957851261de965f23,3,3,3,6,3,2013-08-19 19:12:04,2013-08-19 19:12:04
c1583c6d74e7a7088cf6d22957851261de965f23...608f3286539fbcdb4727cb77623261fa506381ff,4,4,4,8,4,2013-08-19 19:12:40,2013-08-19 19:12:40
608f3286539fbcdb4727cb77623261fa506381ff...20397091f10f4c00db7cfab7b8598b9a6b7fdec1,4,7,3,10,4,2013-08-19 19:12:59,2013-08-19 19:12:59
20397091f10f4c00db7cfab7b8598b9a6b7fdec1...434c034159f584348b56a322dbcda8dc65b812f2,5,16,6,22,9,2013-08-19 19:53:11,2013-08-19 19:53:11
434c034159f584348b56a322dbcda8dc65b812f2...a73e068c06532480137b8b9861ed88f42578bb12,5,37,46,83,37,2013-08-20 13:56:05,2013-08-20 13:56:05
a73e068c06532480137b8b9861ed88f42578bb12...9acaec7a26d7cb140e4d0215c9f3cef4e42c5087,2,2,2,4,2,2013-08-20 14:31:26,2013-08-20 14:31:26
9acaec7a26d7cb140e4d0215c9f3cef4e42c5087...e9f1c39e7e258e58fa79a8646c3ad224119a0ae5,2,15,15,30,15,2013-08-20 18:41:14,2013-08-20 18:41:14
a43a38039476598fe1e959b29d7033a5b1b1c8d0...89d0d75c528b7b39471966db260c002383ccb9db,3,18,14,32,7,2013-08-07 20:54:26,2013-08-07 20:54:26
a43a38039476598fe1e959b29d7033a5b1b1c8d0...49fa9907ae55be4922929def98afb9be29281c1e,4,38,38,76,35,2013-08-07 20:20:10,2013-08-07 20:20:10
49fa9907ae55be4922929def98afb9be29281c1e...f2082edb6058b5ff665ff84c465b6d75f58b6c54,2,14,14,28,13,2013-08-07 20:22:46,2013-08-07 20:22:46
f2082edb6058b5ff665ff84c465b6d75f58b6c54...a3b0dc2e17de0ec5ea5327ac6b84659aeb84d252,4,22,22,44,19,2013-08-07 20:24:34,2013-08-07 20:24:34
a3b0dc2e17de0ec5ea5327ac6b84659aeb84d252...c52f9e1a32e76ae7ea48a939baf162e20de67a82,4,32,32,64,28,2013-08-07 20:28:02,2013-08-07 20:28:02
c52f9e1a32e76ae7ea48a939baf162e20de67a82...df437f419ba92f376f95917b235930311b4c9946,7,26,26,52,21,2013-08-07 20:30:40,2013-08-07 20:30:40
df437f419ba92f376f95917b235930311b4c9946...e3f9bd231b0b071e4586b5134bae99367380a6bf,3,3,3,6,3,2013-08-07 20:32:20,2013-08-07 20:32:20
e3f9bd231b0b071e4586b5134bae99367380a6bf...846e59505eefab7bd04227edcdc55c6033d42ec5,8,11,18,29,10,2013-08-07 20:35:24,2013-08-07 20:35:24
846e59505eefab7bd04227edcdc55c6033d42ec5...b2152847b162577ca3d58afcee3486537e0b6b81,10,17,28,45,18,2013-08-07 20:40:29,2013-08-07 20:40:29
68a317808f90c0e5685dfd91abf5604f5012ab01...d7d8edf3cadb9a70db2f354324c18b306d89e91d,2,2,3,5,2,2013-04-16 13:02:41,2013-04-16 13:02:41
d7d8edf3cadb9a70db2f354324c18b306d89e91d...14798b8e686aafaa9ea3bc9b18294fefa54801f5,2,9,7,16,8,2013-04-16 13:29:49,2013-04-16 13:29:49
14798b8e686aafaa9ea3bc9b18294fefa54801f5...be41d0e1bfb61abeb12c33c2344e374adc7803cf,1,34,0,34,1,2013-04-16 13:30:16,2013-04-16 13:30:16
be41d0e1bfb61abeb12c33c2344e374adc7803cf...211c433cd89ddc49b1f8c3ef6ba7bc366428a851,1,28,0,28,1,2013-04-16 13:39:48,2013-04-16 13:39:48
f51c21b671c9abedc5773a3cf17b0d762cee814b...6156cacbe9e16d53d02dcba0332e3f656aeb9c4c,1,1,1,2,1,2013-11-14 18:50:07,2013-11-14 18:50:07
f51c21b671c9abedc5773a3cf17b0d762cee814b...580049c04bdd9de73e4d37d7be641fd9ae7a9985,3,75,4,79,4,2013-11-14 18:40:05,2013-11-14 18:40:05
f51c21b671c9abedc5773a3cf17b0d762cee814b...42d9400e5ad20757e8ab324e68ea687453a5329f,1,30,4,34,2,2013-11-14 18:14:07,2013-11-14 18:14:07
cb589d231aaa9f4cf7a10c41d6fd1ebe34428173...b471122f3eacb4fadb563b946efb6fcf4d708514,1,2,2,4,2,2014-01-09 15:33:56,2014-01-09 15:33:56
cb589d231aaa9f4cf7a10c41d6fd1ebe34428173...c466f4cc44a61c1fbb827113e232c65f3c0ac9ec,1,1,0,1,1,2014-01-09 12:17:02,2014-01-09 12:17:02
cb589d231aaa9f4cf7a10c41d6fd1ebe34428173...4791084d7c9356c16ead5bf3162fd132fa10c979,2,82,0,82,2,2014-01-09 10:36:55,2014-01-09 10:36:55
4791084d7c9356c16ead5bf3162fd132fa10c979...b49ebf5737ce95bcab792c18bddc1a4675f148ed,7,20,85,105,12,2014-01-09 10:37:12,2014-01-09 10:37:12
b49ebf5737ce95bcab792c18bddc1a4675f148ed...fc60c391ae93e0a9ef9a5123ee7d71cd504e4366,2,10,6,16,3,2014-01-09 10:51:20,2014-01-09 10:51:20
fc60c391ae93e0a9ef9a5123ee7d71cd504e4366...768d21654a135130a28278c46cf413dbe65f8c81,2,41,35,76,8,2014-01-09 12:23:07,2014-01-09 12:23:07
768d21654a135130a28278c46cf413dbe65f8c81...a9d7efa12fc013fba03bafd68307b49dafa33c34,1,0,18,18,1,2014-01-09 13:16:10,2014-01-09 13:13:56
3f3b202c6efa17a8e6731ba44c5f3bf672c28672...182aa19e26cbc77b3cc7f10f0c228ea4aa2d7c77,1,14,10,24,5,2013-11-20 09:06:19,2013-11-20 09:06:19
182aa19e26cbc77b3cc7f10f0c228ea4aa2d7c77...30912835e3a6824459e1cc64e3144fe90b9aa959,1,6,2,8,2,2013-11-20 09:06:42,2013-11-20 09:06:42
80c4657fa78eaf7d360e0f247243736387b5ce87...a9d1038f0355db6ec975a5080cfe09d4b1b99338,1,1,1,2,1,2013-12-16 20:56:45,2013-12-16 20:56:45
f40ad6ce403e4365e4b5515cfa593437babb1298...84f96137753143ee597a3c15fff93239f835df61,1,7,0,7,1,2013-12-16 19:09:15,2013-12-16 19:09:15
84f96137753143ee597a3c15fff93239f835df61...687cf48e60ede21c75dd53ca39b8560031469015,1,6,2,8,2,2013-12-16 19:10:18,2013-12-16 19:10:18
687cf48e60ede21c75dd53ca39b8560031469015...6f556d8e71a777b6eaf45ad2f2d243c4e9ff1381,1,9,3,12,3,2013-12-16 19:10:59,2013-12-16 19:10:59
6f556d8e71a777b6eaf45ad2f2d243c4e9ff1381...42003f531233d0e2c99dd8d217bb5ce228ca22e4,5,37,20,57,9,2013-12-16 19:11:52,2013-12-16 19:11:52
8841eec426d7213de6cc381b0898be1a14e418e5...60959df3f276d7f50a9a3c759e4fc871183aa0d4,4,8,8,16,8,2013-11-19 13:41:11,2013-11-19 13:41:11
60959df3f276d7f50a9a3c759e4fc871183aa0d4...b26abe8ff8c22241c78024089926f63a17e7d86b,1,43,0,43,1,2013-11-19 13:41:32,2013-11-19 13:41:32
b26abe8ff8c22241c78024089926f63a17e7d86b...8a91e5d7d0d8f6b395588446f94749170b32821e,1,1,1,2,1,2013-11-19 14:13:37,2013-11-19 14:13:37
8a91e5d7d0d8f6b395588446f94749170b32821e...4cac195a0eab44e092c4bb02e7a5f2aaae6766e3,1,38,0,38,1,2013-11-19 14:14:06,2013-11-19 14:14:06
4cac195a0eab44e092c4bb02e7a5f2aaae6766e3...bd20ec1a3415a9f945b5052a8f0f83cbd2806837,5,51,4,55,8,2013-11-19 14:14:56,2013-11-19 14:14:48
8841eec426d7213de6cc381b0898be1a14e418e5...a48e9ce999a67ca9a202ee84eba8a88781927798,1,1,1,2,1,2013-11-19 11:35:48,2013-11-19 11:35:48
526c2fdf48add9c5051514f987494244b5d6b45e...44c55307a0dc1d011cb9deabb2f1d631ebd2cb63,2,23,31,54,23,2013-11-27 08:04:00,2013-11-27 08:04:00
526c2fdf48add9c5051514f987494244b5d6b45e...ca1526e7ffa2b1eeccae187406987de0250c2012,6,15,15,30,11,2013-11-27 08:00:14,2013-11-27 08:00:14
ca1526e7ffa2b1eeccae187406987de0250c2012...68726c5bb4b2fed89e9bce9de76e383eccb0a365,1,1,1,2,1,2013-11-27 16:57:55,2013-11-27 16:57:55
fa7d62494a24584c0d27d52344aae8e382304936...4091322dba7ee3b94de9ad0b8b061622ba1e468c,4,58,27,85,16,2013-11-27 11:13:33,2013-11-27 11:13:33
4091322dba7ee3b94de9ad0b8b061622ba1e468c...64dff782149f75743c21716e2fea01e0e532ff2f,1,25,27,52,2,2013-11-27 11:26:16,2013-11-27 11:26:16
64dff782149f75743c21716e2fea01e0e532ff2f...319d2b78b4b9deecafe7d9279e61855f2c910cfc,1,2,2,4,2,2013-11-27 11:40:32,2013-11-27 11:40:32
2b8d2891304b4ecc71c0c9eae0952633a15b42fb...06fc7e31b5427795e59829c469ae5262c537101c,1,2,0,2,1,2014-02-19 12:12:55,2014-02-19 12:12:55
eb390226749cf23e50fbae614b88533ea660b2e8...daa1796cf9bbdeb88a5b472c6bac34676fe8d8a9,1,3,3,6,2,2015-02-05 22:25:40,2015-02-05 22:25:40
eb390226749cf23e50fbae614b88533ea660b2e8...f73cb6ff74ea954799af247376aa2fc9bf89efbc,32,33,1,34,33,2015-02-05 19:41:18,2014-11-09 11:53:07
4c5cc19844600ca7624c3c7205495fcf043412a5...fe46a5c0847007b2e6e36addc3e1f09a3e837390,2,18,1,19,2,2014-11-18 16:44:12,2014-11-18 16:44:12
0dcc9f39be64944938444e264b08bad98cb55068...23ef17835734bf81589543dfb390ccf4729731cd,1,1,1,2,1,2014-11-19 09:11:27,2014-11-19 09:11:27
a726042773481e15e2f14192bea96599b200699d...e65866d4ff337f66e3526a3eb7ac5ea9ae0c3d8f,1,19,2,21,1,2014-11-19 15:45:41,2014-11-19 15:45:41
e65866d4ff337f66e3526a3eb7ac5ea9ae0c3d8f...580cedd76cb1b2a9101fcb722dfec455ad00c8c6,4,16,2,18,5,2014-11-19 16:11:16,2014-11-19 16:11:16
3a723ad24c56404a4180b011bd577153f9d25ccd...8f60144782ba564c63d757c11a72440202f2490c,4,4,4,8,4,2014-12-02 09:32:24,2014-12-02 09:32:24
3a723ad24c56404a4180b011bd577153f9d25ccd...824ad40699bf4ee22f0dbe53b5ae344c916c0d9f,1,2,0,2,1,2014-11-29 10:01:32,2014-11-29 10:01:32
3a723ad24c56404a4180b011bd577153f9d25ccd...f7274dd6a197da3501b7f3f5c7d298660f048fcc,1,28,28,56,13,2014-11-29 09:48:19,2014-09-19 08:33:41
3a723ad24c56404a4180b011bd577153f9d25ccd...64ab6c9ed54d1c0a86f4c3bb6b87fcac882da0c0,3,47,1,48,3,2014-11-28 14:01:41,2014-11-28 14:01:41
64ab6c9ed54d1c0a86f4c3bb6b87fcac882da0c0...d336127a20ce22a9512123595a887c4207b748e9,1,3,0,3,2,2014-11-28 14:19:03,2014-11-28 14:19:03
3a723ad24c56404a4180b011bd577153f9d25ccd...385105382b62f10ce84730ccb4f15aecea189470,1,2,2,4,1,2014-11-28 06:55:59,2014-11-28 06:55:59
385105382b62f10ce84730ccb4f15aecea189470...e08255ceea2af40f66039c7768be8de5122649f1,1,6,2,8,1,2014-11-28 10:13:49,2014-11-28 10:13:49
e08255ceea2af40f66039c7768be8de5122649f1...ba955fe17403e005e9f551e3b31e3d539681f4d1,1,4,3,7,1,2014-12-01 10:41:30,2014-12-01 10:41:30
ba955fe17403e005e9f551e3b31e3d539681f4d1...0afa07f7f07c68c74de20f5a353fba60c1752826,3,32,5,37,6,2014-12-02 14:19:43,2014-12-02 14:19:43
0afa07f7f07c68c74de20f5a353fba60c1752826...40e80dbeb5d767a8a1f3142963f670fbad3ecf4c,1,0,1,1,1,2014-12-02 15:18:32,2014-12-02 15:18:32
40e80dbeb5d767a8a1f3142963f670fbad3ecf4c...8dd3a16227149405f2e38663c16099b53db1745d,1,1,1,2,1,2014-12-02 15:24:55,2014-12-02 15:24:55
8dd3a16227149405f2e38663c16099b53db1745d...a33cb855302f189f3510fc2fbe73851d9d7a7b74,1,2,0,2,1,2014-12-02 15:28:12,2014-12-02 15:28:12
a33cb855302f189f3510fc2fbe73851d9d7a7b74...6f9d9ea09ead63bbed43b94f57edf5e05ade661c,1,2,2,4,2,2014-12-02 15:57:52,2014-12-02 15:57:52
6f9d9ea09ead63bbed43b94f57edf5e05ade661c...3b643bc87ba126e00550e6a067e4327020452a1b,1,27,1,28,3,2014-12-02 16:16:46,2014-12-02 16:16:46
3b643bc87ba126e00550e6a067e4327020452a1b...ed7760b1d7b58d07793437db78f960ed7c4ae182,1,4,0,4,2,2014-12-02 18:25:04,2014-12-02 18:25:04
ed7760b1d7b58d07793437db78f960ed7c4ae182...9e4d39c0513fc91fc2c844d482e82a8e9df8927d,4,42,19,61,16,2014-12-03 11:41:47,2014-12-03 11:41:47
9e4d39c0513fc91fc2c844d482e82a8e9df8927d...3838b168b33163d4cbe64b7ff6e6b408bc8d857f,1,3,1,4,1,2014-12-03 11:43:26,2014-12-03 11:43:26
3faa14e7a748097528ed36cf02ccacd62cd8f044...14ac0746712ac11e823a856b4c15cd5d91ea541e,2,0,4,4,3,2014-04-03 06:43:40,2014-04-03 06:43:40
14ac0746712ac11e823a856b4c15cd5d91ea541e...7ab46b969f5c817acc849e0ed6ce23d25bd5fa09,1,0,1,1,1,2014-04-03 06:49:34,2014-04-03 06:49:34
3faa14e7a748097528ed36cf02ccacd62cd8f044...599344583bcf57eff46b36d68e6536188d41c906,2,8,8,16,4,2014-04-02 18:02:02,2014-04-02 18:02:02
599344583bcf57eff46b36d68e6536188d41c906...77c0a6db4baac1bd91e3636b32b3ffa9d0373211,1,0,17,17,1,2014-04-02 18:03:31,2014-04-02 18:03:31
77c0a6db4baac1bd91e3636b32b3ffa9d0373211...6ae2529041258c2d63a992298c9708cc03efd8d1,5,38,43,81,6,2014-04-02 18:13:05,2014-04-02 18:13:05
6ae2529041258c2d63a992298c9708cc03efd8d1...65cd9829eecd2485f17eaadf84107631d5a723d9,3,0,175,175,3,2014-04-02 18:35:59,2014-04-02 18:35:59
65cd9829eecd2485f17eaadf84107631d5a723d9...3c867dfa8efec28155158e3b2b7dbb21ba3ce0a1,5,100,0,100,5,2014-04-02 18:51:17,2014-04-02 18:51:17
3c867dfa8efec28155158e3b2b7dbb21ba3ce0a1...9ee697dd6847de0bd1a38714df7d8bb509534d20,5,41,66,107,13,2014-04-02 18:51:53,2014-04-02 18:51:53
9ee697dd6847de0bd1a38714df7d8bb509534d20...9b598fa62d73c5a66d7fed872db943859e2d6a5a,5,11,7,18,8,2014-04-03 07:36:10,2014-04-03 07:36:10
9b598fa62d73c5a66d7fed872db943859e2d6a5a...c31b703110620c438d724561ab6d5a5a44b08e19,2,5,5,10,4,2014-04-03 08:47:56,2014-04-03 08:47:56
c31b703110620c438d724561ab6d5a5a44b08e19...e1dd76d5a52391626d538bf9803a32c1f0e83287,1,1,1,2,1,2014-04-03 08:49:12,2014-04-03 08:49:12
e1dd76d5a52391626d538bf9803a32c1f0e83287...9b6224f99cacdce3bcbec9a2c1ef4d8af296c56c,3,11,14,25,10,2014-04-03 09:05:21,2014-04-03 09:05:21
69432c885c7f77489c2b3a3cf118c7622647ac9b...f732e6c8da83c46ac85dfd913f2adddaa1c8148d,2,2,2,4,2,2014-04-01 16:37:45,2014-04-01 16:37:45
69432c885c7f77489c2b3a3cf118c7622647ac9b...f4f0a7e03e64e3fffb9b14ba5583e2c6b7c6441b,1,31,4,35,4,2014-04-01 15:18:52,2014-03-28 16:15:58
f4f0a7e03e64e3fffb9b14ba5583e2c6b7c6441b...ce30a56f333f61c01314cf32e15381080a9b14d3,1,31,15,46,8,2014-04-01 15:18:52,2014-03-29 09:56:13
ce30a56f333f61c01314cf32e15381080a9b14d3...528a641e9ee5f72f3f5a1da1e1a31b9b61262efd,1,41,32,73,8,2014-04-01 15:18:52,2014-04-01 11:07:23
528a641e9ee5f72f3f5a1da1e1a31b9b61262efd...109ab1a58baec790dceb318e96142132cd5b053c,1,40,29,69,13,2014-04-01 15:18:52,2014-04-01 11:50:20
84a8b29fbf17c74ceb04bc7d480278905eea84ac...ae2089a98ebfac56fabb5d1027c549ea13b1622c,2,19,0,19,3,2014-04-06 11:10:48,2014-04-06 11:10:48
d238a21bcb44d2f0fc7f027ccc19c613050f77e8...6c47514322e7e1e395869ff81af32eb71b074301,1,3,3,6,3,2014-04-09 03:09:53,2014-04-07 04:31:02
4e002a71670587e8b1e2a97833fef059441c8ca8...a73df4f72d9d5fbc118b80cea6f6bda4f877f5df,6,29,4,33,8,2014-04-07 11:09:29,2014-04-07 11:09:29
a73df4f72d9d5fbc118b80cea6f6bda4f877f5df...84d17f79655498f49d5c957c8f09aeef7cdc56c2,1,1,1,2,1,2014-04-07 11:32:59,2014-04-07 11:32:59
84d17f79655498f49d5c957c8f09aeef7cdc56c2...4ab32be8a70e3996bd664ce35858dc6151531b4d,1,0,2,2,1,2014-04-07 12:20:40,2014-04-07 12:20:40
4ab32be8a70e3996bd664ce35858dc6151531b4d...021faad3fe1026ec0c1ea6debbd4eb28e74ffcb8,1,1,0,1,1,2014-04-07 13:03:05,2014-04-07 13:03:05
021faad3fe1026ec0c1ea6debbd4eb28e74ffcb8...5436d6afd614f929a67c8b0257fa1644823d55b3,2,9,2,11,4,2014-04-07 13:36:33,2014-04-07 13:36:33
5436d6afd614f929a67c8b0257fa1644823d55b3...e6f58cb87da914f2a424df66b680e19e49dcd2e6,2,2,3,5,4,2014-04-07 13:47:37,2014-04-07 13:47:37
7e4739fe22e1ea3baee65d3129f0bd3a569f4817...fc3c57734da26039bf30253b3495d8926c33b755,2,8,12,20,2,2013-11-21 07:46:09,2013-11-21 07:46:09
fc3c57734da26039bf30253b3495d8926c33b755...4525fc840547358a270671ff107c3e4967679442,1,1,1,2,1,2013-11-21 08:03:00,2013-11-21 08:03:00
94f8b51cb39ccad5dc5031688c4b87a93227fe1b...1a20976aa3ab59d5269e9413be5ffbf7f5f5bcbe,1,2,0,2,1,2013-11-06 07:32:17,2013-11-06 07:32:17
1a20976aa3ab59d5269e9413be5ffbf7f5f5bcbe...593b05ea945f63fde39689eb62cf890d417b39bc,1,1,1,2,1,2013-11-06 07:54:42,2013-11-06 07:54:42
593b05ea945f63fde39689eb62cf890d417b39bc...d618a5fec361b85fafffd5cf4a53d044e82bdb5a,9,65,64,129,9,2013-11-06 07:58:43,2013-11-06 07:58:43
1ad2a93678c3a513fcc6ba575343c0b1d93a16f0...97c72d7417ab766b37c745cbdcbc8cedab986362,7,85,24,109,11,2014-01-08 02:50:36,2014-01-02 16:31:25
1ad2a93678c3a513fcc6ba575343c0b1d93a16f0...acd2702ed3103baf8beef6e747791aaa91688bb6,1,4,4,8,4,2014-01-07 14:19:45,2014-01-07 14:19:45
9c7d821cf752a98f8c7a40056816f6629ca1f734...5c1a360f4172273e4fe568e9cbafda9a95858623,2,7,18,25,2,2014-01-13 07:47:32,2014-01-13 07:47:32
9c7d821cf752a98f8c7a40056816f6629ca1f734...2b090339d1c794b4e280c7a38bf863ea6bb25069,1,1,1,2,1,2014-01-12 20:29:29,2014-01-12 20:29:29
400a55805c96f8ec463b941baf08c6f494742585...c467ef5221d1393d70b857aac582e4fbcf6abc3d,1,1,1,2,1,2013-11-04 19:36:07,2013-11-04 19:36:07
41ca07e6cb384a38dc629738ee4a7bf422e4e13a...15e0ab498dc9f680dc6995c46a8ba7b76fc1f081,4,15,2,17,5,2014-05-15 17:54:19,2014-05-15 17:54:19
66dacfc52a1a91783b68e503e0e1844e26f47a54...44e2a2e453c6954554d3cc6a03bfe64554a228e8,2,2,2,4,2,2013-08-08 15:59:46,2013-08-08 15:59:46
263b301f66720c1b7b9e2d6fce481e5e410761f4...0675552463c5afccd81bbfe1ff276d19d0d79446,1,3,0,3,2,2013-08-04 13:46:46,2013-08-04 13:46:46
0675552463c5afccd81bbfe1ff276d19d0d79446...65197b8a8a74f662313ac0885aced49b9d243e9d,1,1,1,2,1,2013-08-04 14:14:15,2013-08-04 14:14:15
65197b8a8a74f662313ac0885aced49b9d243e9d...b99f357e96f683643b1e739b12a1ba972303d0aa,1,2,0,2,1,2013-08-04 14:18:49,2013-08-04 14:18:49
b99f357e96f683643b1e739b12a1ba972303d0aa...e06352979de1a3344d0ab34c5f0ecf7ed73da66f,2,7,1,8,3,2013-08-04 16:00:41,2013-08-04 16:00:41
e06352979de1a3344d0ab34c5f0ecf7ed73da66f...2d75b454ef87a87bff942dc31837687919113468,2,38,8,46,5,2013-08-04 16:01:57,2013-08-04 16:01:57
2d75b454ef87a87bff942dc31837687919113468...8f05fbbab5754b2a05547bae7ed3f9c409d8a640,4,27,12,39,8,2013-08-04 16:35:47,2013-08-04 16:35:47
8f05fbbab5754b2a05547bae7ed3f9c409d8a640...af5faaf0e1e001558302704a421eb01f5e7a26ea,8,99,64,163,14,2013-08-04 17:43:49,2013-08-04 17:43:49
be17a32d041209c5268c72005ac7c82eac15c934...f52f5f679427bd66ed3d3d8fee9a00880714095d,1,84,71,155,1,2013-07-29 17:11:55,2013-07-29 17:11:55
f52f5f679427bd66ed3d3d8fee9a00880714095d...121f20d253ac414d360e1defde9e7df52c15d5da,1,1,1,2,1,2013-07-29 19:19:03,2013-07-29 19:19:03
5e0e97ec5dd963a33a6522b0095a15abf987d6e0...cd19f82e5126e087ea6ef3b1bc3307bb74efacbd,38,62,62,124,61,2013-07-29 10:47:06,2013-07-29 10:46:00
0e387919c3827260434aed48e1f28ee02ce5e58d...533ef87b134738e9d5c24067e531ee3fe4e9bf55,2,5,1,6,2,2013-08-17 10:32:59,2013-08-17 10:32:59
533ef87b134738e9d5c24067e531ee3fe4e9bf55...798f7db24faba28c33a2a67602a8b81ed4869d5d,1,1,1,2,1,2013-08-17 14:36:44,2013-08-17 14:36:44
0e387919c3827260434aed48e1f28ee02ce5e58d...e3dd374a6c98955b36d24c837bc1fb0d99dfc30e,1,1,1,2,1,2013-08-16 22:37:22,2013-08-16 22:37:22
65cba5c6b91483f7f629c9bb2dcd98e2da92405c...b66f4898ea14bdfe271465fbcc9b133ae0bee4f1,1,9,2,11,1,2013-08-20 09:40:51,2013-08-20 09:40:51
b66f4898ea14bdfe271465fbcc9b133ae0bee4f1...7daf394732db2bc696938739cdb8f1bccd0a501f,1,1,1,2,1,2013-08-20 09:41:56,2013-08-20 09:41:56
65cba5c6b91483f7f629c9bb2dcd98e2da92405c...fd0afcc996d687232c1181263b17793b2827d44e,4,11,35,46,16,2013-08-20 03:05:23,2013-08-20 03:05:23
395f3a1d20eb250992629054ddaf1b22aaa899a1...97b58d14848807e6bb9ccb703ef641a99dfa8603,1,1,1,2,1,2013-08-20 19:30:45,2013-08-20 19:30:45
97b58d14848807e6bb9ccb703ef641a99dfa8603...1f7d485d33b38acf77d26295945a9392708b5ff0,1,91,0,91,1,2013-08-20 19:34:14,2013-08-20 19:34:14
1f7d485d33b38acf77d26295945a9392708b5ff0...0a44ecf3a0eb7be66b2dbbb6e8404e3242a4b016,1,1,1,2,1,2013-08-20 19:41:05,2013-08-20 19:41:05
2e0a373415f05f77e8cc2a12b1a1f22c3214a0ba...4e6f131c8a7446b54f908c4f87f0b2dfda4c5750,1,1,1,2,1,2013-08-08 07:27:52,2013-08-08 07:27:52
211c433cd89ddc49b1f8c3ef6ba7bc366428a851...0715abaf24aeaf4ed66d61d7978be04008d25070,1,4,0,4,1,2013-04-16 17:00:30,2013-04-16 17:00:30
0715abaf24aeaf4ed66d61d7978be04008d25070...295ca904f1728f9748c77595fd32de1d7e3dcf6f,3,18,17,35,6,2013-04-16 17:01:21,2013-04-16 17:01:21
211c433cd89ddc49b1f8c3ef6ba7bc366428a851...93ec507d19ca1124cb651149cf56181bb4ec79a2,1,3,0,3,1,2013-04-16 16:06:57,2013-04-16 16:05:05
83b6e5d65a5f25038fd44539436e060319775a8d...a7d3e2b9b6a015e0e4a4e3b84439308bb6fe367a,2,13,3,16,4,2013-11-15 07:18:06,2013-11-15 07:18:06
a7d3e2b9b6a015e0e4a4e3b84439308bb6fe367a...77e3fab89f633b70a0f805cce94d09304ad893e2,1,6,0,6,1,2013-11-15 07:20:35,2013-11-15 07:20:35
0d3f1a2d58cf19f3b07fdfecb7ee3a41d442a81d...ef7fce4a9f38b86128a1c4c0f553ba3d1198ef27,1,1,1,2,1,2014-01-09 16:04:46,2014-01-09 16:04:46
0d3f1a2d58cf19f3b07fdfecb7ee3a41d442a81d...e270cd705b4e7520406c306011af22d61dbdd8f3,1,8,14,22,3,2014-01-09 14:55:57,2014-01-09 14:55:57
e270cd705b4e7520406c306011af22d61dbdd8f3...3aa57b77aedd25d538d907bf166451529e88b159,1,2,2,4,1,2014-01-09 14:58:52,2014-01-09 14:58:52
893153113d5cc8b36314edac1e2454a8c6dd98e3...8ddb064bbd3ef80700c6dd2131cad6f7e81c96e8,1,3,1,4,1,2013-11-20 09:19:51,2013-11-20 09:19:51
8ddb064bbd3ef80700c6dd2131cad6f7e81c96e8...7101b22c2efac40d4454a887a602ff46288d66fc,10,10,10,20,10,2013-11-20 10:34:14,2013-11-20 10:34:14
7101b22c2efac40d4454a887a602ff46288d66fc...e3a718574c1c862a1b806b8bb04fa1f4b10a2d37,1,117,0,117,1,2013-11-20 10:44:46,2013-11-20 10:44:46
e3a718574c1c862a1b806b8bb04fa1f4b10a2d37...b07c02eb13fca5f991575bb0955373d54f1a2d9d,6,72,12,84,7,2013-11-20 11:41:41,2013-11-20 11:41:41
b07c02eb13fca5f991575bb0955373d54f1a2d9d...436e96467dba5ccbaa5ffef21f760f6441fe8a0f,5,7,15,22,8,2013-11-20 12:05:42,2013-11-20 12:05:42
436e96467dba5ccbaa5ffef21f760f6441fe8a0f...3bdf930852094169a5ea522b7b3cbf4f20a66027,1,13,4,17,2,2013-11-20 15:29:50,2013-11-20 15:29:50
3bdf930852094169a5ea522b7b3cbf4f20a66027...fd6e51612e1cc2b05b9c1d8be36a3eaecfcc995f,1,2,1,3,1,2013-11-20 17:27:49,2013-11-20 17:27:49
3d7edf0fe3036f56b426952aa3574d174f4f2016...26a5695e33befd0c1875696f5cb68181bf3f3368,1,3,3,6,3,2013-12-17 09:38:30,2013-12-17 09:38:30
26a5695e33befd0c1875696f5cb68181bf3f3368...9c668133dc4172509adb4fd797bad4b2b1dae6b0,1,13,0,13,1,2013-12-17 09:54:07,2013-12-17 09:54:07
3d7edf0fe3036f56b426952aa3574d174f4f2016...49ad8f3b578205df7e0f83e41869f4cbb2694e78,1,7,4,11,3,2013-12-17 08:37:53,2013-12-17 08:37:53
bd20ec1a3415a9f945b5052a8f0f83cbd2806837...32d7332d2c9fe21db74073e65d1317c11dc2c861,2,43,3,46,4,2013-11-19 14:33:38,2013-11-19 14:33:38
32d7332d2c9fe21db74073e65d1317c11dc2c861...a185cce5d39e2bf7f865cd3c4b2f74f355d6d051,1,34,0,34,1,2013-11-19 14:36:11,2013-11-19 14:36:11
44c55307a0dc1d011cb9deabb2f1d631ebd2cb63...b34378c4d7932b34a89ef95936dc1a828453e31e,2,9,8,17,8,2013-11-27 09:14:42,2013-11-27 09:14:42
b34378c4d7932b34a89ef95936dc1a828453e31e...c2f6eb0ffe736b88094d97b75299c5fe45429b24,1,2,2,4,2,2013-11-27 09:18:33,2013-11-27 09:18:33
c2f6eb0ffe736b88094d97b75299c5fe45429b24...042ec53c403fffeea1a75e90e059bc61b856fca1,3,3,1,4,3,2013-11-27 09:29:52,2013-11-27 09:29:52
44c55307a0dc1d011cb9deabb2f1d631ebd2cb63...562a461c56334bbf466ed1c42e3fc9650207c62f,1,10,0,10,1,2013-11-27 09:09:46,2013-11-27 09:07:26
44c55307a0dc1d011cb9deabb2f1d631ebd2cb63...e2e11670222cfc5654dbefe05b688ae62add0b9c,2,9,2,11,4,2013-11-27 08:49:59,2013-11-27 08:49:59
44c55307a0dc1d011cb9deabb2f1d631ebd2cb63...b2e4664cc78d61ec058e81f37cdff11636b02967,2,14,6,20,4,2013-11-27 08:32:37,2013-11-27 08:32:37
2e07865f16f96bc4706758cc5f2634574d38be37...e3d4eb2140029dcc42144e2d2920386fe8be9cc2,2,5,5,10,5,2013-11-30 16:27:02,2013-11-30 16:25:04
2e07865f16f96bc4706758cc5f2634574d38be37...6095a1cb2535f9bc7d5abd835ad4b1fdf0a34e31,1,7,16,23,9,2013-11-30 11:39:11,2013-11-30 11:39:11
2e07865f16f96bc4706758cc5f2634574d38be37...c5a339daf751e0548f64a80bded2ee8ee1c697d1,1,1,0,1,1,2013-11-29 13:23:48,2013-11-29 13:23:48
2e07865f16f96bc4706758cc5f2634574d38be37...5907207e4ddb85fff997ad243f6be7486800eceb,3,24,3,27,3,2013-11-29 08:32:34,2013-11-28 21:46:55
2e07865f16f96bc4706758cc5f2634574d38be37...b8cb7df76102db12a11bca81674882911fcfbcd8,3,3,3,6,3,2013-11-29 07:57:45,2013-11-29 07:57:45
2e07865f16f96bc4706758cc5f2634574d38be37...4c53d6f3db4b52229318fd0010a3a427380edd2a,2,0,0,0,0,2013-11-28 23:53:14,2013-11-28 23:53:14
2e07865f16f96bc4706758cc5f2634574d38be37...64efc05229b04d9928d621572d01bb1952ac0f65,2,14,2,16,4,2013-11-28 20:05:37,2013-11-28 20:05:37
3f94e14d9694ba487599354dd0a2ec0964fcdcd4...81eae5de89d13e6079ee5a9d975216d1a460d8d0,1,18,10,28,8,2013-11-27 13:00:57,2013-11-27 13:00:57
88bab75aa43b6e1abc71bade2a350b0aa1abc722...d4f94a5b078db54e1b696cacefa6c2f98f7d00dc,1,3,3,6,3,2013-12-04 11:56:12,2013-12-04 11:56:12
88bab75aa43b6e1abc71bade2a350b0aa1abc722...169b4ce0ca2ef04d37deb6bdb054cb8124a9db61,2,14,4,18,4,2013-12-04 11:37:17,2013-12-02 19:33:43
169b4ce0ca2ef04d37deb6bdb054cb8124a9db61...0687ecb66d52868db27ef89a18e4109abc70b935,3,44,8,52,9,2013-12-04 11:37:17,2013-12-02 19:38:32
0687ecb66d52868db27ef89a18e4109abc70b935...25951b914619a9e056122f0c39ce64e4afe453d8,3,15,2,17,3,2013-12-04 11:37:17,2013-12-03 09:31:56
25951b914619a9e056122f0c39ce64e4afe453d8...cfcf24dce53d79c950de12eca0353b890ad95508,4,31,33,64,18,2013-12-04 11:37:17,2013-12-03 09:34:06
cfcf24dce53d79c950de12eca0353b890ad95508...5f9cdbab1d8373f3455c1cd8136db6479a54adf7,2,4,2,6,2,2013-12-04 11:37:17,2013-12-03 10:08:00
5f9cdbab1d8373f3455c1cd8136db6479a54adf7...d4c50dbd33e03cb6b5ec06f9411bb77afb70e5e4,7,70,49,119,7,2013-12-04 11:37:17,2013-12-03 17:11:10
d4c50dbd33e03cb6b5ec06f9411bb77afb70e5e4...887c0c67acdc4f9b847ea27d293328b09e703d8d,1,58,6,64,5,2013-12-04 11:37:18,2013-12-03 17:25:16
887c0c67acdc4f9b847ea27d293328b09e703d8d...cf5d3bb0add2344ea6fd31520535fd2f382ff637,3,68,53,121,7,2013-12-04 11:37:18,2013-12-03 19:59:06
cf5d3bb0add2344ea6fd31520535fd2f382ff637...fff69bdb97d9038976b8a5716238c796487dba50,1,1,0,1,1,2013-12-04 11:37:38,2013-12-04 11:02:16
fff69bdb97d9038976b8a5716238c796487dba50...882029d9c62c54293147da0d5e2d3b6eaaa89535,2,8,4,12,5,2013-12-04 11:37:39,2013-12-04 11:19:53
882029d9c62c54293147da0d5e2d3b6eaaa89535...822dac87eccad5044e0e82fd671e8b71f21942a5,2,132,116,248,3,2013-12-04 11:37:39,2013-12-04 11:20:16
822dac87eccad5044e0e82fd671e8b71f21942a5...21f4e5d3ac80c319592ecedb8bbf0c162841beb7,3,15,4,19,9,2013-12-04 11:37:39,2013-12-04 11:35:38
d353e203c838d46967b2b0a07525abd165d4e99e...dad6b0213c96bc0b6a5b78714878ee542b7bee2d,1,1,0,1,1,2014-02-19 12:49:44,2014-02-19 12:49:44
53f05343f55c1324fb73a63b972db674050941ed...722d80739b6b4eb6e4803fc55f750300d66b94be,1,14,4,18,3,2014-11-12 11:59:25,2014-11-12 11:59:25
53f05343f55c1324fb73a63b972db674050941ed...5cf6d5949d6c776e24d3bd5c0b417000f1efc57a,1,1,6,7,2,2014-11-12 11:54:43,2014-11-12 11:54:43
f0b8477cdacb80fcabf7e50f520f6d280feccced...6aec286fca169502edd4c643a6d2202a012fa142,2,6,4,10,3,2014-12-29 11:58:01,2014-12-29 11:58:01
a7ddcab7aabaf9ca01499844100ca8bd2acae3e6...80db117a339364b7a7c11d44f8fd7f0cf2a2a12b,1,114,0,114,1,2014-11-23 09:45:44,2014-11-23 09:45:44
a7ddcab7aabaf9ca01499844100ca8bd2acae3e6...e69db3ba5b386b69998f30536a1a2b3c0e748df9,1,2,2,4,2,2014-11-23 09:11:06,2014-11-23 09:11:06
a7ddcab7aabaf9ca01499844100ca8bd2acae3e6...7cfaf890cb52cc91b9332ce7479f3187c6e7d51f,1,3,90,93,3,2014-11-23 09:08:29,2014-11-23 09:08:29
20cd7a50be263f954ffc7157892e94aa09f78d04...762d8d3271c17f295a45d59701c7354fc9702a3d,1,1,1,2,1,2014-11-23 10:14:29,2014-11-23 10:14:29
20cd7a50be263f954ffc7157892e94aa09f78d04...cdf558682640876d950527f02d75f9f4532aa007,1,4,0,4,1,2014-11-20 22:05:46,2014-11-20 22:05:46
20cd7a50be263f954ffc7157892e94aa09f78d04...4a39b6d9f7390aae4ed06c8a5a2144eabb1ff689,1,2,2,4,2,2014-11-20 16:15:58,2014-11-20 16:15:58
20cd7a50be263f954ffc7157892e94aa09f78d04...2e0bbe68cb713ec35a6a68c7a54f0ad881dbea58,1,13,5,18,5,2014-11-20 14:58:03,2014-11-20 14:58:03
20cd7a50be263f954ffc7157892e94aa09f78d04...c4fc734e78f8061e54e3d7374e8db5eb6f555290,1,23,0,23,1,2014-11-20 11:18:28,2014-11-20 11:18:28
c4fc734e78f8061e54e3d7374e8db5eb6f555290...a72a919ae5cf8d8984fef50ed3cac141fe17cc66,1,2,1,3,2,2014-11-20 11:22:46,2014-11-20 11:22:46
20cd7a50be263f954ffc7157892e94aa09f78d04...2f3df4cb567a6f14b5a0e161084c2f4cf6fbf764,4,8,8,16,7,2014-11-20 03:26:58,2014-11-09 05:12:14
2f3df4cb567a6f14b5a0e161084c2f4cf6fbf764...1353f9aa643f86a3f38f3d2dfa8666d3d942293e,4,23,3,26,6,2014-11-20 03:27:24,2014-11-09 05:04:31
30e28a7e0c458395b7a205e72a89e7d1b68571eb...64919745544cd09cdb510bf15e9522280d61fdde,4,19,1,20,4,2014-12-01 17:58:37,2014-12-01 17:58:37
30e28a7e0c458395b7a205e72a89e7d1b68571eb...06b7907c2afe0cb0fa25f4cdef0ff470710de2f9,2,37,10,47,3,2014-12-01 14:25:10,2014-12-01 14:25:10
06b7907c2afe0cb0fa25f4cdef0ff470710de2f9...612b8806ddc7881421e26a9dbfe465d6445fb3d6,2,30,7,37,8,2014-12-01 14:55:33,2014-12-01 14:55:33
30e28a7e0c458395b7a205e72a89e7d1b68571eb...25a566da0aae470d7819820500e9343c7f462dfc,3,4,5,9,5,2014-12-01 14:11:26,2014-12-01 14:11:26
bf39347970865bcd97e5370c7a754406498a2d65...ba51a1dd328c453927d390147f5fa4be3e1f6fe7,3,20,0,20,3,2014-12-03 09:15:00,2014-10-20 09:56:01
ba51a1dd328c453927d390147f5fa4be3e1f6fe7...ed1c22568a9363161d20a1c38147d0ef0f019c2b,2,5,0,5,2,2014-12-03 09:40:04,2014-12-03 09:40:04
bf39347970865bcd97e5370c7a754406498a2d65...9211b541d3eaa60401f4ab6a5d264f9179ad4160,1,16,2,18,1,2014-12-02 14:22:23,2014-12-02 14:22:23
9211b541d3eaa60401f4ab6a5d264f9179ad4160...835cbc06d8d9c773a3b405eca81650378a8ccdcd,3,22,9,31,5,2014-12-02 15:42:56,2014-12-02 15:42:56
27cd35de697ad42781cc4bdb0209f1f331a2591b...880478b21e7c9b0068b3e14b8f7fb58ada2c232e,2,13,9,22,4,2014-11-29 20:01:52,2014-11-29 19:59:28
27cd35de697ad42781cc4bdb0209f1f331a2591b...674cbe939cb65e67479e0d73f4004e52c4546791,5,52,41,93,12,2014-11-29 19:34:18,2014-11-29 19:34:18
674cbe939cb65e67479e0d73f4004e52c4546791...a8df4ee9e2b7881cea46ebc6b3e7889d13e3b5e5,1,22,0,22,1,2014-11-29 22:49:51,2014-11-29 22:49:51
a8df4ee9e2b7881cea46ebc6b3e7889d13e3b5e5...9d937293136afd7994218b8dc72bb0956fb19eeb,8,101,64,165,16,2014-11-29 22:50:25,2014-11-29 22:50:25
9d937293136afd7994218b8dc72bb0956fb19eeb...f7d8467af94d6d4783419c8536275810de2bc19e,1,2,2,4,1,2014-11-29 22:52:04,2014-11-29 22:52:04
f7d8467af94d6d4783419c8536275810de2bc19e...5c1496a4d803de6efe5c81b5d0a3bba7599bf81f,2,19,1,20,3,2014-11-30 08:50:15,2014-11-30 08:50:15
6c68db60910839a6a0009a18992281f1d5ff899b...279952bb788b8e1601aafc66306d173956165740,2,2,2,4,4,2014-12-03 15:29:52,2014-12-03 15:29:52
6c68db60910839a6a0009a18992281f1d5ff899b...106de470c95267dbfef7078839477eb844a11689,1,12,12,24,7,2014-12-03 13:21:00,2014-12-03 13:21:00
106de470c95267dbfef7078839477eb844a11689...4ce27042f9db09f80cca071a5d0571e7205441f3,1,1,1,2,1,2014-12-03 13:41:39,2014-12-03 13:41:39
4ce27042f9db09f80cca071a5d0571e7205441f3...a8ce1d88b5f9d85dc78267363bbe5de7f81b1807,1,34,16,50,10,2014-12-03 14:40:12,2014-12-03 14:40:12
a8ce1d88b5f9d85dc78267363bbe5de7f81b1807...cdabe7302571a21fd377505f144c053b59adb738,1,1,1,2,1,2014-12-03 15:30:57,2014-12-03 15:30:57
cdabe7302571a21fd377505f144c053b59adb738...1aca3718807019315fa2e31c1da58183a9e25f5e,1,2,1,3,2,2014-12-03 15:50:03,2014-12-03 15:50:03
6c68db60910839a6a0009a18992281f1d5ff899b...c0a0d46c97d5d1c4fae54b01af98520749959592,1,1,1,2,1,2014-12-03 11:51:17,2014-12-03 11:51:17
c0a0d46c97d5d1c4fae54b01af98520749959592...2a0ee91f7ca3008d6bbdd10a7351485d1fa0468f,1,0,1,1,1,2014-12-03 13:07:18,2014-12-03 13:07:18
ca1d31f8cdd111c79f547b2e511f478d8f15696e...bb9ec71127965fc92f98a7f0aeacf666424861c8,1,14,0,14,1,2014-04-04 14:22:11,2014-04-04 14:22:11
ca1d31f8cdd111c79f547b2e511f478d8f15696e...fa27b633f8bbeda837651d99a9e2109b1390a889,1,5,0,5,1,2014-04-03 08:13:14,2014-04-03 08:13:14
ca1d31f8cdd111c79f547b2e511f478d8f15696e...770747af68b82642fa98e69c79c9574321504167,2,3,3,6,3,2014-04-03 08:09:52,2014-04-03 08:09:52
973f9d30d9c81a1a06670c257998f3bb8dfe43be...03b8dcce87c976a37a4de044e9f7cdfb8d64a3b7,3,26,0,26,4,2014-04-02 13:25:26,2014-04-02 13:25:26
973f9d30d9c81a1a06670c257998f3bb8dfe43be...c66c84a40d79be3d8d361753c13245093cf7e672,1,22,0,22,1,2014-04-02 12:45:59,2014-04-02 12:45:59
c66c84a40d79be3d8d361753c13245093cf7e672...3acad539becb29a778bc438003db9e8e260b6411,3,21,6,27,8,2014-04-02 14:15:55,2014-04-02 14:15:55
973f9d30d9c81a1a06670c257998f3bb8dfe43be...1ad79393ad9090b6c8c4c9d43e6058af4216394c,1,1,0,1,1,2014-04-02 12:42:35,2014-04-02 12:42:35
973f9d30d9c81a1a06670c257998f3bb8dfe43be...f38eddc69e12baf7ba3eec54852744075555fec0,4,23,258,281,5,2014-04-02 11:57:00,2014-04-02 11:57:00
973f9d30d9c81a1a06670c257998f3bb8dfe43be...09d24a1f67bd5fa50b05582c54ca2f5b75ea9b65,2,2,2,4,2,2014-04-02 11:16:37,2014-04-02 11:16:37
973f9d30d9c81a1a06670c257998f3bb8dfe43be...3a959a68ec6c6b18107855979a783d1529105a02,2,0,8,8,3,2014-04-02 11:11:55,2014-04-02 11:11:55
973f9d30d9c81a1a06670c257998f3bb8dfe43be...cc3ea3d3736db8d089e6e94d8f863d47631d0963,1,24,16,40,1,2014-04-02 10:46:17,2014-04-02 10:46:17
cc3ea3d3736db8d089e6e94d8f863d47631d0963...7aacc08a92c2bbac74c45d9b506a801f3d947984,1,3,3,6,3,2014-04-02 10:47:07,2014-04-02 10:47:07
7aacc08a92c2bbac74c45d9b506a801f3d947984...d54e3f361ad61a9bd767ec2d4ab00277d4a06c6d,1,0,2,2,1,2014-04-02 10:47:45,2014-04-02 10:47:45
973f9d30d9c81a1a06670c257998f3bb8dfe43be...b06f43288aa3f8e617e6534ce28e9a12107981d9,1,5,0,5,1,2014-04-02 10:26:09,2014-04-02 10:26:09
ae2089a98ebfac56fabb5d1027c549ea13b1622c...b3ad3f202478dd88a3cfe4461703bc3df1019f90,1,1,0,1,1,2014-04-06 11:29:29,2014-04-06 11:29:29
ae2089a98ebfac56fabb5d1027c549ea13b1622c...7ced2eb447ee78f376958986a83531fe7105e760,1,1,1,2,1,2014-04-06 11:26:24,2014-04-06 11:26:24
884390de20532fc78dd1b78efafe9a5acc534c6d...c803e78fd0de5e3614cf5881c9688e4c7d40641b,2,4,3,7,3,2014-04-14 16:40:27,2014-04-14 16:39:24
650d0bc695eb0f874561b8d4ed3fc86510573fba...26c5102002ac78bb328e11a2f273800e853b3fa9,1,1,1,2,1,2014-04-07 14:39:45,2014-04-07 14:39:45
650d0bc695eb0f874561b8d4ed3fc86510573fba...66209fbc7668b5b64b34c2997185223891211829,3,52,4,56,10,2014-04-07 14:18:25,2014-04-04 16:32:53
bfd4494890c80e131d606c5026ea3e1146e7d4d0...bcfd9386f54f12bf5b294686afbc6bcdad8a39c5,2,3,5,8,2,2014-04-07 09:22:27,2014-04-07 09:17:55
fd61e3e9016940e1c4668837472ddd8b952217f6...b2b2989f7fd20a387c62ca0c39c5eba7c821885f,1,1,1,2,1,2014-04-15 12:52:02,2014-04-15 12:52:02
4525fc840547358a270671ff107c3e4967679442...b5ea6aa11c8313cf1db4609e54dfb54596ccdac4,1,23,18,41,12,2013-11-21 18:38:05,2013-11-21 18:38:05
4525fc840547358a270671ff107c3e4967679442...7b9f428dbe77da922c4e1132d48111061a545214,1,11,10,21,2,2013-11-21 16:17:48,2013-11-21 16:13:31
4525fc840547358a270671ff107c3e4967679442...bb71c5d89f8bfd8a8047bf7056ad4b518c87ac64,1,5,2,7,1,2013-11-21 15:04:23,2013-11-21 15:04:23
4525fc840547358a270671ff107c3e4967679442...4db87f7c4bd46983c1aad8ed7cc7338ca7bbf72e,5,118,1,119,7,2013-11-21 12:18:02,2013-11-21 12:18:02
d618a5fec361b85fafffd5cf4a53d044e82bdb5a...9d14c5137a5a82ed8edd353ac7e6ed701fc6f49d,6,29,11,40,10,2013-11-06 16:45:39,2013-11-06 16:45:39
9d14c5137a5a82ed8edd353ac7e6ed701fc6f49d...580dfe5af9c84feafaad1f870d53e2a49d27e0be,1,2,2,4,2,2013-11-06 17:13:45,2013-11-06 17:13:45
580dfe5af9c84feafaad1f870d53e2a49d27e0be...cfa15d0846e43b72d91ec83384c8d1cefcd1c80c,3,0,8,8,8,2013-11-06 17:14:11,2013-11-06 17:14:11
cfa15d0846e43b72d91ec83384c8d1cefcd1c80c...0ba378dcb36343d060df985dc8626f310c9bf303,1,1,1,2,1,2013-11-06 17:38:37,2013-11-06 17:38:37
0ba378dcb36343d060df985dc8626f310c9bf303...7ab3bf9668195cb2a885db6a78078f0d6e24ea54,1,2,0,2,1,2013-11-06 17:43:51,2013-11-06 17:43:51
d618a5fec361b85fafffd5cf4a53d044e82bdb5a...3c8c06751cab946e05785be6985c4c23b4cfbb02,3,3,12,15,3,2013-11-06 12:10:59,2013-11-06 12:10:59
d618a5fec361b85fafffd5cf4a53d044e82bdb5a...87fc35073a1f5ae84798263fc7c789a32f85d637,3,9,3,12,6,2013-11-06 10:14:48,2013-11-06 10:14:48
16697f6efa4653986753905ab9100fa11dde7f09...8a54fda45957b3755f7c06e5c9b955c794488ff1,2,256,222,478,108,2013-12-10 10:11:26,2013-12-05 14:26:11
8a54fda45957b3755f7c06e5c9b955c794488ff1...ac5842d970ba305681bb1c0826db769243101123,5,7,8,15,7,2013-12-10 10:11:26,2013-12-05 14:26:34
ac5842d970ba305681bb1c0826db769243101123...f38435b9e79cc155bc725300a5aa920f17c69271,2,11,19,30,7,2013-12-10 10:11:27,2013-12-06 08:08:44
f38435b9e79cc155bc725300a5aa920f17c69271...ede272406a36d8263ababd7aab86ece5d9a9b9b5,3,7,7,14,5,2013-12-10 10:11:27,2013-12-06 15:04:18
ede272406a36d8263ababd7aab86ece5d9a9b9b5...acbac26a5a847f7e5aadeae0a67219d651fb8913,2,30,26,56,6,2013-12-10 10:11:27,2013-12-06 15:04:50
acbac26a5a847f7e5aadeae0a67219d651fb8913...b3c1d0d8df28d54c094b3980563394db97e25897,3,5,3,8,4,2013-12-10 10:11:27,2013-12-06 15:05:34
b3c1d0d8df28d54c094b3980563394db97e25897...49a26eaece601b7dfd20c5809f0ce1129ffbb06b,1,1,1,2,1,2013-12-10 10:11:27,2013-12-06 15:05:59
49a26eaece601b7dfd20c5809f0ce1129ffbb06b...a885c68781ae0ca997d68fdea9f470ea4de1d1cd,1,1,0,1,1,2013-12-10 10:11:27,2013-12-06 15:40:39
a885c68781ae0ca997d68fdea9f470ea4de1d1cd...475fedc0a7c6bb9af9b15bea208ada33c94524f0,1,1,1,2,1,2013-12-10 10:11:27,2013-12-06 16:20:17
475fedc0a7c6bb9af9b15bea208ada33c94524f0...81fc5137ac999cbb7518e17ff58113da16cffac3,1,0,3,3,1,2013-12-10 10:11:27,2013-12-09 17:39:30
81fc5137ac999cbb7518e17ff58113da16cffac3...e5affcf1ee37b6d355855325b7b6ea983a443bff,1,1,1,2,1,2013-12-10 10:11:27,2013-12-09 17:40:55
e5affcf1ee37b6d355855325b7b6ea983a443bff...2a62aa45cd85f46148e9b5ebcaeaddcff06265e2,1,3,3,6,3,2013-12-10 10:11:27,2013-12-09 18:29:39
2a62aa45cd85f46148e9b5ebcaeaddcff06265e2...70bb976bc61c9cd209bbf67520426166664bb539,1,3,4,7,3,2013-12-10 10:11:28,2013-12-09 19:02:36
70bb976bc61c9cd209bbf67520426166664bb539...7c1b8694f5c0624c1d5362a7146e86b221043803,2,4,4,8,4,2013-12-10 10:11:28,2013-12-09 19:50:36
7c1b8694f5c0624c1d5362a7146e86b221043803...f57a4dd92253c2b7e3d566b4a39a0e7c8b2ee5cf,1,1,1,2,1,2013-12-10 10:11:28,2013-12-09 20:51:01
f57a4dd92253c2b7e3d566b4a39a0e7c8b2ee5cf...23c99a98e1b615ac5b14f754c762ae0c355af420,1,1,0,1,1,2013-12-10 10:11:28,2013-12-09 21:03:14
23c99a98e1b615ac5b14f754c762ae0c355af420...77febe8f1e867874c10fff9f70011f7e67c1a5f8,2,3,3,6,3,2013-12-10 10:11:28,2013-12-09 21:17:03
77febe8f1e867874c10fff9f70011f7e67c1a5f8...5ffce6a65ee162d4b887da0b630f8aaf23e92124,1,2,0,2,1,2013-12-10 10:11:28,2013-12-09 21:26:09
5ffce6a65ee162d4b887da0b630f8aaf23e92124...92ce4904b9b531eeda408bdd0bd12ba2be0739f4,1,5,0,5,1,2013-12-10 10:11:28,2013-12-09 21:31:25
92ce4904b9b531eeda408bdd0bd12ba2be0739f4...2293cb1051de5d4a0d5842ce82329bd0656673e0,3,3,3,6,3,2013-12-10 10:11:28,2013-12-09 21:36:45
2293cb1051de5d4a0d5842ce82329bd0656673e0...f3d5b565d50e1bb13644c30275f5e4aba2276d39,1,1,1,2,1,2013-12-10 10:11:29,2013-12-10 08:20:31
f3d5b565d50e1bb13644c30275f5e4aba2276d39...0f5f021527065985d2af45dc0f3b2adf472d10f9,1,1,1,2,1,2013-12-10 10:11:29,2013-12-10 08:35:39
0f5f021527065985d2af45dc0f3b2adf472d10f9...7c91055e4a44d2b8096756ffcfb090a61c967a5d,1,3,3,6,3,2013-12-10 10:11:29,2013-12-10 08:35:54
7c91055e4a44d2b8096756ffcfb090a61c967a5d...ed82ab4117cbfc32767fe1f5f179cf3447cbaabb,3,4,4,8,4,2013-12-10 10:11:29,2013-12-10 10:08:40
ed82ab4117cbfc32767fe1f5f179cf3447cbaabb...0124ae18c594fbc7c40bcf80e44a9feb0b9cf977,1,1,1,2,1,2013-12-10 11:20:35,2013-12-10 11:20:35
0124ae18c594fbc7c40bcf80e44a9feb0b9cf977...d75eb243781f915076c1204d074d1f82479c1efb,2,2,2,4,2,2013-12-10 11:20:54,2013-12-10 11:20:54
d75eb243781f915076c1204d074d1f82479c1efb...2ab76ca5316d815e5cdb03782ff919397d343b26,2,4,8,12,5,2013-12-10 11:24:48,2013-12-10 11:24:48
2ab76ca5316d815e5cdb03782ff919397d343b26...f088c867a4b03104c349b9037198a895d1968f34,1,6,0,6,2,2013-12-10 11:35:10,2013-12-10 11:35:10
f088c867a4b03104c349b9037198a895d1968f34...58eca3118aa7c786f2b945328fedc23eb0c1a6d0,1,1,1,2,1,2013-12-10 11:38:31,2013-12-10 11:38:31
58eca3118aa7c786f2b945328fedc23eb0c1a6d0...7db71b9476f2df6138b550566d0cc8763961a7c2,1,1,1,2,1,2013-12-10 11:41:38,2013-12-10 11:41:38
7db71b9476f2df6138b550566d0cc8763961a7c2...74d6e492d37ffb42a63e482308b72e45b0c6da36,1,5,5,10,5,2013-12-10 11:46:50,2013-12-10 11:46:50
74d6e492d37ffb42a63e482308b72e45b0c6da36...6708a770de54e2dd4ee6c90b31b66e2c6f93aa2c,1,2,2,4,2,2013-12-10 11:48:00,2013-12-10 11:48:00
6708a770de54e2dd4ee6c90b31b66e2c6f93aa2c...5289190ce844e445c0215852dabea5c2880c10dc,3,6,0,6,3,2013-12-10 12:15:08,2013-12-10 12:15:08
5289190ce844e445c0215852dabea5c2880c10dc...5a2ae296fafb434e9f6a72118b02ddc1f584a9a9,5,17,24,41,6,2013-12-10 13:43:27,2013-12-10 13:43:27
5a2ae296fafb434e9f6a72118b02ddc1f584a9a9...bbd8525d75d6dba4dd6f5dc996073e61f47e43dc,5,65,65,130,16,2013-12-10 14:03:24,2013-12-10 14:03:24
bbd8525d75d6dba4dd6f5dc996073e61f47e43dc...72f2be8666ed1ca9461c36352c2b9479f352c155,1,3,5,8,4,2013-12-10 15:07:46,2013-12-10 15:07:46
880fef0d92ba9983babdf47c3d91526b4a5729f8...2934e7a9627bb92ab9367923cdbcbaa13f7843d4,1,5,4,9,5,2013-12-11 14:34:10,2013-12-11 14:34:10
880fef0d92ba9983babdf47c3d91526b4a5729f8...0cd2ea88b3a70a968ac64346167f9056d6413907,1,1,1,2,1,2013-12-11 14:09:23,2013-12-11 14:09:23
880fef0d92ba9983babdf47c3d91526b4a5729f8...7b3b63d4d49dd5c3876e2f0c02026dd9cb289f32,3,11,2,13,3,2013-12-11 13:41:07,2013-12-11 13:41:07
18fac5879d0228f501bea6316a5fbb955859fec3...4650855685ec57fabdb66e0004f08b59b07706cc,2,18,1,19,2,2014-01-08 22:54:03,2014-01-08 22:54:03
18fac5879d0228f501bea6316a5fbb955859fec3...03770698417563abe70fdea223700ca370e9f062,10,38,14,52,10,2014-01-08 10:42:57,2014-01-08 10:42:57
3c7a80646198c546a2cfd4aa05b7724f51a6eb7f...eace1ce645f285f01b49128328c18f582376bc3a,3,24,39,63,13,2014-01-08 16:39:03,2014-01-08 16:39:03
eace1ce645f285f01b49128328c18f582376bc3a...65696aaa2e1a837d635cba1162c9293da943cbc8,3,21,16,37,9,2014-01-08 16:59:23,2014-01-08 16:59:23
3c7a80646198c546a2cfd4aa05b7724f51a6eb7f...04baf0b569a84430cb8c366594b82a72a4ff73b6,7,29,44,73,14,2014-01-08 16:06:03,2014-01-08 03:03:27
5c1a360f4172273e4fe568e9cbafda9a95858623...6cd745c2f794049eea3d6833dd0f70923c0618ad,1,1,1,2,1,2014-01-14 09:57:10,2014-01-14 09:57:10
5c1a360f4172273e4fe568e9cbafda9a95858623...7c6287c878c3106492c1f96d7624e99aa6c8b398,1,12,15,27,5,2014-01-13 11:17:38,2014-01-13 11:17:38
7c6287c878c3106492c1f96d7624e99aa6c8b398...6a80083294bdd09f6e6d1d97a9512c434dc4e73d,2,5,19,24,6,2014-01-13 14:16:45,2014-01-13 14:16:45
6a80083294bdd09f6e6d1d97a9512c434dc4e73d...d84b0fa6b5c84774e300e5fe6415defb30c441fe,1,4,9,13,4,2014-01-13 14:49:35,2014-01-13 14:49:35
d84b0fa6b5c84774e300e5fe6415defb30c441fe...db966364de38d896961abba74c20a69bd3d6361c,1,10,2,12,2,2014-01-13 15:20:30,2014-01-13 15:20:30
db966364de38d896961abba74c20a69bd3d6361c...8781459124b87912b105bab3c2b67c46f5457db9,1,1,1,2,1,2014-01-13 15:21:59,2014-01-13 15:21:59
8781459124b87912b105bab3c2b67c46f5457db9...0de6e2da38058e4628d20cfb06433e873609a70f,1,15,1,16,1,2014-01-13 15:54:02,2014-01-13 15:54:02
0de6e2da38058e4628d20cfb06433e873609a70f...09d5868c2286f927ce2cc23dfcc2c446723985b3,2,7,6,13,5,2014-01-14 08:47:28,2014-01-14 08:47:28
09d5868c2286f927ce2cc23dfcc2c446723985b3...9247490109b9d4e4691d304e7bfb4bca6d54e209,3,58,25,83,27,2014-01-14 09:49:54,2014-01-14 09:49:54
9247490109b9d4e4691d304e7bfb4bca6d54e209...99a2b31e98f3934407b782ee4a2d2a26c8ec4e2a,1,2,0,2,1,2014-01-14 17:56:52,2014-01-14 17:56:52
5c1a360f4172273e4fe568e9cbafda9a95858623...0db36897e61205dda4644cdc77fa79dcc7b9114a,2,15,0,15,2,2014-01-13 09:41:10,2014-01-13 09:30:46
0db36897e61205dda4644cdc77fa79dcc7b9114a...87d16e184186759568b14a7f021489ad21792c42,1,2,1,3,1,2014-01-13 10:43:22,2014-01-13 10:43:22
2b090339d1c794b4e280c7a38bf863ea6bb25069...433fca6c5bebd135ca2d48e2d231b51904d07057,1,1,1,2,1,2014-01-20 04:47:19,2014-01-20 04:47:19
2ee04b120a142ee227cb860ffddb991ef31a6910...bd2b6f59445919cdcef627f7f1b1fca5d402168b,8,196,26,222,11,2013-11-05 08:28:49,2013-11-05 08:28:49
bd2b6f59445919cdcef627f7f1b1fca5d402168b...f2eb668348bc8ff70d62ee607a080f235f470dfd,3,22,9,31,11,2013-11-05 08:45:23,2013-11-05 08:45:23
f2eb668348bc8ff70d62ee607a080f235f470dfd...f61850e6e3521073f49f1cfe429b7fe49f3b44f0,5,89,51,140,11,2013-11-05 10:06:52,2013-11-05 10:06:52
f61850e6e3521073f49f1cfe429b7fe49f3b44f0...160bd862bede180faf66de7e5b09300347c24279,6,65,52,117,10,2013-11-05 10:21:11,2013-11-05 10:21:11
160bd862bede180faf66de7e5b09300347c24279...3083e5e4cdd0d158bc1c092f3e339eb8f83b2c4a,1,6,5,11,1,2013-11-05 10:23:11,2013-11-05 10:23:11
76eb9532df62f0b48340006f463615c870c3841f...2d56d89b92198502a6ed2c684d6b4d1a51bb119f,2,5,5,10,5,2013-08-08 16:45:03,2013-08-08 16:45:03
2d56d89b92198502a6ed2c684d6b4d1a51bb119f...f0e994b6c0cd27b52683c2c67cb59f0de71e0f99,2,14,18,32,10,2013-08-08 18:11:28,2013-08-08 18:11:28
f0e994b6c0cd27b52683c2c67cb59f0de71e0f99...53cc9df4f13cc61fcdd2f093af3aaab44c0842f5,1,1,0,1,1,2013-08-08 18:14:19,2013-08-08 18:14:19
53cc9df4f13cc61fcdd2f093af3aaab44c0842f5...869f45b36a0efbe8839afb9c4367ae84b68cd375,2,3,3,6,3,2013-08-08 18:26:13,2013-08-08 18:26:13
af5faaf0e1e001558302704a421eb01f5e7a26ea...02e859a23470d799a77963503687789d4a410a0c,3,114,95,209,5,2013-08-05 09:26:33,2013-08-05 09:26:33
02e859a23470d799a77963503687789d4a410a0c...d602d5b1b05036788c67c13510c34725c68116ea,1,1,1,2,1,2013-08-05 09:32:24,2013-08-05 09:32:24
af5faaf0e1e001558302704a421eb01f5e7a26ea...ad6208c579a9858c4280ab692f2bfefcfb285fc6,1,1,1,2,1,2013-08-04 22:04:20,2013-08-04 22:04:20
ad6208c579a9858c4280ab692f2bfefcfb285fc6...171ce67a0c36145ebb123f0df0ef15681272a159,1,1,1,2,1,2013-08-04 22:04:47,2013-08-04 22:04:47
f4205abb7725c96c1a967f5b3779e09c6e94a21d...8290e7cc70db5f62ae02c4e19c0e6193dafd35f0,2,9,3,12,3,2013-07-29 18:06:59,2013-07-29 18:06:59
8290e7cc70db5f62ae02c4e19c0e6193dafd35f0...2c6577a15ebe1efd93e2e2cfcce493fb838f3108,1,5,0,5,1,2013-07-29 18:17:46,2013-07-29 18:17:46
2c6577a15ebe1efd93e2e2cfcce493fb838f3108...bd7e569f725327f0ad784273741aa38e756ed495,2,12,4,16,3,2013-07-29 18:24:38,2013-07-29 18:24:38
bd7e569f725327f0ad784273741aa38e756ed495...71db10b9f22a42fdd772ff2908813733d6fb613b,1,2,0,2,1,2013-07-29 18:41:05,2013-07-29 18:41:05
71db10b9f22a42fdd772ff2908813733d6fb613b...79bea312055751bcd92421927f5ff51b22362d63,2,59,24,83,9,2013-07-29 19:59:41,2013-07-29 19:59:41
b55e22e277bd754d4ab89c046ccbe8f943730c8d...1dda34f306a94a4046d7150f5dc11a6fde360dd0,1,5,0,5,3,2013-08-02 13:43:30,2013-08-02 13:43:30
b55e22e277bd754d4ab89c046ccbe8f943730c8d...6dfdd2ebfe61903df0aa1164ede147cab40f0c7c,1,2,3,5,3,2013-07-29 17:08:45,2013-07-29 17:08:45
b55e22e277bd754d4ab89c046ccbe8f943730c8d...1458dea9fe7530b716754ddeb89f032b43b97a1f,1,2,1,3,2,2013-07-29 13:16:36,2013-07-29 13:16:36
7daf394732db2bc696938739cdb8f1bccd0a501f...23f53c43ce9785f9974b81f3b34bb1f315b66f01,1,1,0,1,1,2013-08-20 14:44:15,2013-08-20 14:44:15
23f53c43ce9785f9974b81f3b34bb1f315b66f01...b3b9b7561637b201d6167d4d7fde8c5de0008a2d,1,2,1,3,3,2013-08-20 18:09:54,2013-08-20 18:09:54
b3b9b7561637b201d6167d4d7fde8c5de0008a2d...9174020f14f622fcd5ae57bc7bcba0d067c0e88a,3,9,7,16,3,2013-08-20 18:20:11,2013-08-20 18:20:11
9174020f14f622fcd5ae57bc7bcba0d067c0e88a...25e629e460c30bb903be52dbf28fcc499566f318,3,18,1,19,3,2013-08-20 18:31:37,2013-08-20 18:31:37
25e629e460c30bb903be52dbf28fcc499566f318...e7f92c8a16a8632acae6c2d9fc8e316eec8ba5ef,1,1,1,2,1,2013-08-20 18:50:33,2013-08-20 18:50:33
e7f92c8a16a8632acae6c2d9fc8e316eec8ba5ef...27e532b42612559e100657026fe8c7510ec7625e,1,1,1,2,1,2013-08-20 19:05:58,2013-08-20 19:05:58
7daf394732db2bc696938739cdb8f1bccd0a501f...a442ad2b141e078fcc2899ece6068b82b5338bb8,1,48,0,48,1,2013-08-20 12:59:26,2013-08-20 12:59:26
a442ad2b141e078fcc2899ece6068b82b5338bb8...7a26a4b69ddf42c60aa406d10589a976ced0f6f3,9,18,53,71,18,2013-08-20 12:59:45,2013-08-20 12:59:45
7daf394732db2bc696938739cdb8f1bccd0a501f...90af8aa6fe3bcbb5c5e7a477b1e42f05f0a7102b,1,1,0,1,1,2013-08-20 11:35:49,2013-08-20 11:35:49
0a44ecf3a0eb7be66b2dbbb6e8404e3242a4b016...ed3d31d5b2a3b4384273689f92dd39b10244dd37,1,3,0,3,1,2013-08-21 09:04:33,2013-08-21 09:04:33
ed3d31d5b2a3b4384273689f92dd39b10244dd37...3b0d7a30718a26b019a14a9e5c0b61f3c3fee58d,2,12,27,39,3,2013-08-21 09:08:10,2013-08-21 09:08:10
3b0d7a30718a26b019a14a9e5c0b61f3c3fee58d...5d8ca6e60b8cbbb08222e4e5b93ed8c4592d051a,3,0,198,198,3,2013-08-21 09:08:32,2013-08-21 09:08:32
0a44ecf3a0eb7be66b2dbbb6e8404e3242a4b016...5f24bdb7d067df9204e08e126f43c071116089b0,5,25,10,35,7,2013-08-21 08:53:51,2013-08-21 07:55:18
5f24bdb7d067df9204e08e126f43c071116089b0...1101ceb3f4dfb8983f5876215378331a2d9bcc88,3,8,8,16,8,2013-08-21 10:20:29,2013-08-21 10:20:29
0a44ecf3a0eb7be66b2dbbb6e8404e3242a4b016...a38c6550db410a5264a8056044f562fac7ab4b92,1,1,1,2,1,2013-08-21 07:13:50,2013-08-21 07:13:50
0a44ecf3a0eb7be66b2dbbb6e8404e3242a4b016...f70c5fcab242c6c0ec444c6acd6a565d53ad75fe,1,1,1,2,1,2013-08-21 02:25:46,2013-08-21 02:25:46
4e6f131c8a7446b54f908c4f87f0b2dfda4c5750...f79b210061724fa1460fbb10853467182031c2c5,3,4,9,13,4,2013-08-08 08:40:42,2013-08-08 08:40:42
f79b210061724fa1460fbb10853467182031c2c5...acc21d30fb7a38e8ae069116a37d67b535da3996,11,42,32,74,20,2013-08-08 08:57:34,2013-08-08 08:57:34
248b25544ca5e6a7d258140ff67d17511c81965c...d7d11727b7d693604f1bc1ecd1f2bb3e9e82453e,2,4,0,4,2,2013-04-16 18:51:26,2013-04-16 18:51:26
d7d11727b7d693604f1bc1ecd1f2bb3e9e82453e...eed2314d7ea033260d3e48223b3083c02c5ecd80,1,1,0,1,1,2013-04-16 18:59:39,2013-04-16 18:59:39
eed2314d7ea033260d3e48223b3083c02c5ecd80...69a63903de2f07b8103588abd9577ea089b814f9,4,17,9,26,8,2013-04-16 19:20:35,2013-04-16 19:20:35
69a63903de2f07b8103588abd9577ea089b814f9...f7e4686a425b7e51237420d99d9cf4a23a83b099,2,9,0,9,2,2013-04-17 06:49:34,2013-04-17 06:49:34
77e3fab89f633b70a0f805cce94d09304ad893e2...0759dd4513c0190b80058d4851e2bde36cbaede6,3,28,0,28,3,2013-11-15 13:24:10,2013-11-15 13:24:10
0759dd4513c0190b80058d4851e2bde36cbaede6...dcea191314c778331305d0926d6852fe04477115,3,48,0,48,4,2013-11-15 13:25:09,2013-11-15 13:25:09
dcea191314c778331305d0926d6852fe04477115...0815098d3af16444645d161cde3ef5150b2fd75d,6,79,23,102,8,2013-11-15 13:25:37,2013-11-15 13:25:37
0815098d3af16444645d161cde3ef5150b2fd75d...9340d4887fbf4638588bf3333bf4e1a8081fa805,1,31,0,31,1,2013-11-15 13:29:53,2013-11-15 13:29:53
9340d4887fbf4638588bf3333bf4e1a8081fa805...27ad882693a1848b17c3841fec72f21a3b9428ee,1,1,0,1,1,2013-11-15 13:30:25,2013-11-15 13:30:25
3ce3c305ebac1ae076a2e51df77f7f0ee4034d67...b621c987bdb171dee4fd177f973d026b13c6db3e,1,1,1,2,1,2014-01-10 19:31:44,2014-01-10 19:31:44
9c668133dc4172509adb4fd797bad4b2b1dae6b0...65448e2ff75a92409e246d8e9aae494bc4132457,7,140,17,157,9,2013-12-17 14:39:50,2013-12-17 14:39:39
9c668133dc4172509adb4fd797bad4b2b1dae6b0...b90cbfd21ec9bd366ee931d246d51f8821b2a023,7,7,0,7,1,2013-12-17 10:20:36,2013-12-17 10:20:36
b90cbfd21ec9bd366ee931d246d51f8821b2a023...5ac57305477ed90bf416b3c795516e9b9135bf5b,2,3,1,4,2,2013-12-17 10:42:13,2013-12-17 10:42:13
5ac57305477ed90bf416b3c795516e9b9135bf5b...86a8796b1322879d01e9cea8fb728458e0e328cb,4,71,15,86,13,2013-12-17 10:42:40,2013-12-17 10:42:40
86a8796b1322879d01e9cea8fb728458e0e328cb...2428a0b2dd8e84e285df4b356ee6f1593204cd34,4,3,11,14,4,2013-12-17 10:58:44,2013-12-17 10:58:44
2428a0b2dd8e84e285df4b356ee6f1593204cd34...d550933907a51aa6cf5ed8b042db2f7e3323fa8c,3,21,3,24,3,2013-12-17 12:45:55,2013-12-17 12:45:55
d550933907a51aa6cf5ed8b042db2f7e3323fa8c...0b59af49cb80a27ac188532c8de2bfec8a1c1d8b,1,13,16,29,7,2013-12-17 12:50:19,2013-12-17 12:50:19
0b59af49cb80a27ac188532c8de2bfec8a1c1d8b...8b89ef8639b2b6ee69d991fb0d6089f9437bbee2,3,44,1,45,3,2013-12-17 13:30:15,2013-12-17 13:30:15
8b89ef8639b2b6ee69d991fb0d6089f9437bbee2...074efd8fd57736bcec25b2f08324b9d25aa886d5,4,16,7,23,6,2013-12-17 14:20:45,2013-12-17 14:20:45
074efd8fd57736bcec25b2f08324b9d25aa886d5...68f8ffb55164a97bae4efec30646ee6cb0036f5a,2,37,18,55,19,2013-12-17 14:29:08,2013-12-17 14:29:08
68f8ffb55164a97bae4efec30646ee6cb0036f5a...5f85d6d1cea2e9f3557206b97cef15676ea2d14c,1,1,1,2,1,2013-12-17 14:31:12,2013-12-17 14:31:12
5f85d6d1cea2e9f3557206b97cef15676ea2d14c...fc3878c03461a1b75a30332756544b2e10b77917,1,24,0,24,1,2013-12-18 11:30:04,2013-12-18 11:30:04
fc3878c03461a1b75a30332756544b2e10b77917...6ac73f45f0d88b4a7fded64260a8d6ea1cff7400,2,26,19,45,3,2013-12-18 11:42:12,2013-12-18 11:42:12
26c8b3163454ab4610a8130f13de1dc686dcdabf...ff0d8a18bf24f3d33fc63aab7af0e5b60de6f76b,1,1,1,2,1,2013-12-17 23:04:40,2013-12-17 23:04:40
26c8b3163454ab4610a8130f13de1dc686dcdabf...984eb08cbe15def95f1cfc2eff32fcb03eb3981b,1,1,4,5,2,2013-12-17 20:32:19,2013-12-17 20:32:19
26c8b3163454ab4610a8130f13de1dc686dcdabf...1521f467cbf8b1b9b3e9cb4169f3e96a9984bb46,5,45,10,55,11,2013-12-17 18:48:59,2013-12-04 02:13:19
26c8b3163454ab4610a8130f13de1dc686dcdabf...3adf35fb642fd8acfa4ecc1bd73f06ddb8fa9849,1,1,2,3,1,2013-12-17 18:37:56,2013-12-17 18:37:56
26c8b3163454ab4610a8130f13de1dc686dcdabf...fb44054e98668032281f529ad46a400420e54add,1,2,1,3,1,2013-12-17 16:59:09,2013-12-17 16:58:59
fb44054e98668032281f529ad46a400420e54add...b563fccbbc18afe5d8b581b2d17cc865038624a1,1,1,2,3,1,2013-12-17 17:00:43,2013-12-17 17:00:43
9772cefc43d1b9ea8ad526a33e20706361857b0f...6cc3cc515267712733d6dd1643080bd6b2cc6cdc,2,5,2,7,4,2013-11-19 15:27:23,2013-11-19 15:27:23
9aaf478f10993ac134bf86546c95dbb4284f9f5f...d4ffcc7cbff79cfee5a35f4bd1dae01fed4164a2,1,3,1,4,2,2013-11-27 10:22:19,2013-11-27 10:22:19
931e6a721f44d5042a019eca189fac677f719006...71e92681f2b567b759746ed61f1441466da5c776,5,20,20,40,13,2013-12-01 10:53:00,2013-12-01 10:53:00
09d00563af8168de14daca9193a6f708e5563870...70c2e1d773291b4854da5a3b479baa352428bb4b,1,1,0,1,1,2013-11-28 08:36:13,2013-11-28 08:36:13
09d00563af8168de14daca9193a6f708e5563870...22d3aa4e32ec9204c8ceeed8e4c0492bb1a5a6bb,3,3,3,6,3,2013-11-28 06:57:56,2013-11-28 06:57:56
09d00563af8168de14daca9193a6f708e5563870...568e05a73b1c4aac814f75da488d3d1ed7d847e9,3,205,9,214,7,2013-11-28 02:08:37,2013-11-27 18:24:27
09d00563af8168de14daca9193a6f708e5563870...d4533a130869df269f581f1ae3163a8591e0c6bc,1,1,1,2,1,2013-11-27 16:26:04,2013-11-27 16:26:04
dad6b0213c96bc0b6a5b78714878ee542b7bee2d...499a118590e875596974e522aecf61bdc05fe0f2,1,1,1,2,1,2014-02-20 08:24:31,2014-02-20 08:24:31
dad6b0213c96bc0b6a5b78714878ee542b7bee2d...29d400ba0d67b282144e04610ab23f45b21fcc41,2,2,1,3,3,2014-02-20 01:35:21,2014-02-20 01:32:42
dad6b0213c96bc0b6a5b78714878ee542b7bee2d...49cb1c7277d4b26cba8f28745ca9b9e348c72a50,1,1,1,2,1,2014-02-19 17:25:18,2014-02-17 15:25:40
49cb1c7277d4b26cba8f28745ca9b9e348c72a50...44ab156ef45fb1a566395b4d98afe796b28d21c9,3,10,10,20,8,2014-02-19 17:25:18,2014-02-17 15:45:28
44ab156ef45fb1a566395b4d98afe796b28d21c9...d8a24003cbd66dc80393dae46299c5734d50b5e0,1,1,1,2,1,2014-02-19 17:25:18,2014-02-18 09:34:57
d8a24003cbd66dc80393dae46299c5734d50b5e0...57cb1ca7917f27f2c7500858fb66d53b3ea49783,3,22,12,34,12,2014-02-19 17:25:18,2014-02-17 16:08:13
57cb1ca7917f27f2c7500858fb66d53b3ea49783...96dded3ec8401e9832b3888338f37c846bd43583,9,126,39,165,52,2014-02-19 17:25:18,2014-02-17 17:49:42
0a34f2dcb562098c481140246f7ac22683b38d76...8752cd3322f9d64b7eab0123048ece072e6b3a76,2,2,1,3,2,2015-02-09 17:11:06,2015-02-09 17:11:06
8752cd3322f9d64b7eab0123048ece072e6b3a76...27e521720a77bcf70ad04a428aee650a8d240401,2,5,0,5,2,2015-02-11 16:40:03,2015-02-11 16:40:03
0a34f2dcb562098c481140246f7ac22683b38d76...692bb679d0ade7401e6a422e2faeb04b63bd23c2,1,4,4,8,4,2015-02-09 07:51:37,2015-02-09 07:51:37
0a34f2dcb562098c481140246f7ac22683b38d76...a3a66939cacd7ffd6aa806fdb0d973ab7c1eb09c,1,1,1,2,1,2015-02-09 07:27:51,2015-02-09 07:27:51
0a34f2dcb562098c481140246f7ac22683b38d76...8681cb3137511e51e19f76aef9839be28f8fcd6a,9,98,7,105,22,2015-02-08 16:35:41,2015-02-07 11:14:55
8681cb3137511e51e19f76aef9839be28f8fcd6a...43cf295ab6c71e032244c60f18e2228227380af5,1,1,1,2,1,2015-02-10 18:36:35,2015-02-10 18:36:35
0a34f2dcb562098c481140246f7ac22683b38d76...fd21d72b1b7042566b6deff184ddcc86cc4907f4,3,93,2,95,4,2015-02-08 12:56:12,2015-02-05 21:04:49
d9f84f68675f4f2f637585754565f40564574e3c...de1c450abd6b367390a1295cac402344f500d41d,4,21,16,37,10,2015-02-12 15:48:53,2015-02-12 15:48:53
de1c450abd6b367390a1295cac402344f500d41d...0c4a70a306b871899bf87ce4673918abfee4d95f,183,3610,3453,7063,1926,2015-02-12 18:17:35,2015-02-12 18:17:35
0c4a70a306b871899bf87ce4673918abfee4d95f...940a402b6e015cde1b3513808cb9ac7f0a3bec8c,6,31,15,46,14,2015-02-12 18:32:58,2015-02-12 18:32:58
940a402b6e015cde1b3513808cb9ac7f0a3bec8c...5bb743efec0043d79ac508503c9e28bee5fae48f,1,1,1,2,2,2015-02-12 18:48:42,2015-02-12 18:48:42
5bb743efec0043d79ac508503c9e28bee5fae48f...026e988544f282c87afec9a85ff21a23877f6226,16,266,191,457,132,2015-02-12 20:00:55,2015-02-12 18:53:23
026e988544f282c87afec9a85ff21a23877f6226...686000446639fbf0756733c822a1ebb19e09e121,1,1,1,2,1,2015-02-12 20:22:23,2015-02-12 20:22:23
d9f84f68675f4f2f637585754565f40564574e3c...597359b04ff8c696a64ef5891689217af9f8a636,2,6,6,12,3,2015-02-12 13:23:15,2015-02-12 13:23:15
d9f84f68675f4f2f637585754565f40564574e3c...d458e39e314455be3110a619cb614f30ee461445,1,1,1,2,1,2015-02-12 12:47:23,2015-02-12 12:47:23
6aec286fca169502edd4c643a6d2202a012fa142...cf9573686586fafc199c6178b672f9ee617476d2,4,63,3,66,18,2014-12-29 13:55:21,2014-12-29 13:55:21
cf9573686586fafc199c6178b672f9ee617476d2...0d8118c68fdb55aab9b2e464f66049a44cc6a37f,1,1,1,2,1,2014-12-29 13:57:07,2014-12-29 13:57:07
6aec286fca169502edd4c643a6d2202a012fa142...a2afc5c3f95268920f5f93d367a94aa67945c0aa,1,1,1,2,1,2014-12-29 12:07:58,2014-12-29 09:36:57
6aec286fca169502edd4c643a6d2202a012fa142...675704f4bb990cb8d2451adb2f81baf1e34e1f40,1,1,2,3,2,2014-12-29 12:05:55,2014-12-29 10:29:06
704d21f517f393b18c634f26ec58cc836cd0d6f4...8348e1a9b57b042e97f14d3b4f7682806902efa1,2,2,2,4,2,2015-03-03 02:45:28,2015-03-03 02:45:28
704d21f517f393b18c634f26ec58cc836cd0d6f4...5b2b9a1f1fcfa323ae56d0d0214ff61bb6088321,2,21,0,21,8,2015-03-03 01:28:47,2015-03-03 01:28:47
5b2b9a1f1fcfa323ae56d0d0214ff61bb6088321...cc877c53abbb1a8799b35dddac35b963dd5ecfdd,1,9,0,9,1,2015-03-03 01:41:05,2015-03-03 01:41:05
cc877c53abbb1a8799b35dddac35b963dd5ecfdd...16e899ca8b44a87883464ada507f521d02548fe2,5,40,15,55,11,2015-03-03 02:11:50,2015-03-03 02:11:50
16e899ca8b44a87883464ada507f521d02548fe2...be165b18d0f3713a888767550ef66917c5a389ab,2,2,1,3,2,2015-03-03 02:22:37,2015-03-03 02:22:37
be165b18d0f3713a888767550ef66917c5a389ab...f850cff4174bfe99a6f2ef0da365bf002990ad92,1,4,1,5,1,2015-03-03 02:34:29,2015-03-03 02:34:29
5f7574cf0506cfe29e68a282d1402b43d4a40118...f4038138fb250bd912d593ca83e867efb4ced186,1,7,7,14,5,2014-11-24 10:30:07,2014-11-24 10:30:07
3615b4de24d584441ab3e26e5db662f7fb3d41fa...a55feb14f162a0b3b11a7c21fd4149ca8c105bc4,1,3,0,3,2,2014-12-18 08:22:34,2014-12-18 08:22:34
334f240899ffe1c7cb662649ef26c2f5420ea92a...1fa19401e969f79cbd737c55e63249ca9355791c,7,149,3,152,9,2014-12-23 17:38:25,2014-12-08 21:54:09
1b34a24ffd63ac9a5a37ac0edbf3a3f2ca6d1810...4053c055beb7d88f9e22ca4187b9868a40030b00,3,17,1,18,3,2014-11-21 14:02:23,2014-11-21 13:52:57
b036300f0ac7442c488a6eef6a85c3f6cb77d7fd...f68003560d96a9c2b9496e9091c809d1e17402e9,1,0,1,1,1,2014-11-21 08:59:46,2014-11-21 08:59:46
b036300f0ac7442c488a6eef6a85c3f6cb77d7fd...7c54c63ac14eb8f5ce0e364d709988fcfe4dda64,6,75,52,127,56,2014-11-20 14:46:04,2014-11-20 14:46:04
7c54c63ac14eb8f5ce0e364d709988fcfe4dda64...458f8c1f80ff20ba3d6e439c65500ed1c1d81ba4,1,2,0,2,1,2014-11-20 14:54:39,2014-11-20 14:54:39
d7568727b98d5a057968a564e3ee5d71bf7ff0c5...9a8ffadc39bf3d9742d4c623d261bee4c6d9e5bf,2,22,10,32,13,2014-12-01 16:31:43,2014-11-13 18:40:55
7ff1c0e3f9c6c6098443a6ee49345ed75536f49a...f53e0fff47eda03296dee95dbd44b6f5a78c6269,1,2,0,2,1,2014-12-01 15:40:45,2014-12-01 15:40:45
ac04665a8c35a9c96fe4fc6fe4391aa8ef703fd0...80497793355f8b8c735f40dd25c20c2ac989b6e1,1,1,1,2,1,2014-12-03 11:50:00,2014-12-03 11:50:00
c2e5343849fdfc24d7f363da7eb881214bf1b327...c5bdc7e13ac4f953f83f226b0f2f5b45905d2bce,1,2,2,4,2,2014-12-02 20:47:19,2014-12-02 20:47:19
c2e5343849fdfc24d7f363da7eb881214bf1b327...5f15ed04fc58cfe8b7d54b3490248430575b16d9,2,11,1,12,2,2014-12-02 20:38:45,2014-12-02 20:38:45
c2e5343849fdfc24d7f363da7eb881214bf1b327...12f8699296aed86b01cc455dfaa05305966fb5a8,1,11,8,19,1,2014-12-02 20:30:06,2014-12-02 20:30:06
d45b25304c848596d5a1f45eeb8ff8a321d0f2d3...d80a59c7b1d3459579c3da95b64a5f235021aa59,8,43,24,67,25,2014-12-04 10:10:38,2014-12-04 10:10:38
d80a59c7b1d3459579c3da95b64a5f235021aa59...6670c99487891afd4a577d0a9ed54fe455bb0324,1,2,2,4,2,2014-12-04 10:12:51,2014-12-04 10:12:51
d45b25304c848596d5a1f45eeb8ff8a321d0f2d3...14a1c1b4e6393dab2bd4c691a7241810980c0623,1,2,0,2,1,2014-12-04 10:03:40,2014-12-04 10:03:40
d45b25304c848596d5a1f45eeb8ff8a321d0f2d3...d7aff11876f517d9e9cb4eb2237ceed4211d7013,1,1,1,2,1,2014-12-04 09:30:10,2014-12-04 09:30:10
d7aff11876f517d9e9cb4eb2237ceed4211d7013...58b58fe44b0924ce24f2f3e5d63b0f99fcf22f9f,2,2,2,4,2,2014-12-04 09:38:04,2014-12-04 09:38:04
58b58fe44b0924ce24f2f3e5d63b0f99fcf22f9f...176105eca628b297fbfc20b29146f2a8d5ddd74d,1,6,2,8,3,2014-12-04 09:38:35,2014-12-04 09:38:35
88326858a45829431045c12d0cc09def4f5c128e...372cb87f05e73dadb1304a9b8412e32624258e5b,1,6,6,12,1,2014-12-04 08:47:27,2014-12-04 08:47:27
7611ce72b97da690317a1adb2a0bdf17bddb1b8c...ba72bd1deeaeedc6f37c1374db933d837d7c5fef,5,13,1,14,3,2014-04-07 09:53:48,2014-04-07 09:53:48
1eec1f4f20a13d8110757fb5027462346aa0a9fc...0e7665e09b75a5ddeed16df894f31a632d7338aa,1,1,1,2,1,2014-04-03 11:24:05,2014-04-03 11:24:05
0e7665e09b75a5ddeed16df894f31a632d7338aa...eca269f7f98b3a2455e7788c884bcb927ea693b1,1,1,1,2,1,2014-04-03 14:35:33,2014-04-03 14:35:33
1eec1f4f20a13d8110757fb5027462346aa0a9fc...563fec734912d81cd7caea6fa8ec2b397fb72a9b,1,3,0,3,1,2014-04-03 10:03:16,2014-04-03 10:03:16
563fec734912d81cd7caea6fa8ec2b397fb72a9b...5307dd5f74236fc48b64080d3191cba1ebe4315e,1,4,4,8,2,2014-04-07 15:47:20,2014-04-07 15:47:20
62743b1525a53b3bed3a2992c3d90fe4d2583055...80bc7c4ca536e1f3e6192ae8779ba3f8f443cef4,1,1,1,2,1,2014-04-02 14:10:53,2014-04-02 14:10:53
26c5102002ac78bb328e11a2f273800e853b3fa9...aea3712e8dd71092847eeaec6f934a426d1becc0,4,17,4,21,8,2014-04-07 15:11:06,2014-04-07 15:11:06
ab7b8b2125889f0f3ba03e65d1ce26088e30631e...5163a8fcb9cfd63435560fda00173b76df2ccc93,2,1,1,2,2,2014-04-07 10:32:24,2014-04-07 08:22:18
cd6232187b707b0a278bd91986ec85dcfe66046f...05e792b4c492e04aaa7e301432f71e01d63c02bc,4,129,2,131,6,2014-04-18 12:16:19,2014-04-15 14:39:46
cd6232187b707b0a278bd91986ec85dcfe66046f...d859d080942175082c1a0cf34d89c0eefd1a3c39,15,148,19,167,25,2014-04-15 15:02:02,2014-04-15 15:02:02
6b491a2bed703f648f0b5772fbd0d9a23ca41109...574fffb722915049e5b0f424637847050f96fc78,1,2,2,4,2,2013-11-21 19:53:48,2013-11-21 19:53:48
e6afbff4c23b2b9c178d8e67436c458079b0bc9a...17952c30b272db567d2d1869f765e127640bf5da,1,2,2,4,1,2013-11-23 10:45:51,2013-11-23 10:33:24
253680bbffe2423a11d4fa8626c2b35c289ea8cc...c28786ecbeb7ba2e630896b37481b918af4ed39e,2,2,2,4,2,2013-11-06 19:52:37,2013-11-06 19:52:37
ce1efb56eb6a8f32ceaa9f9213bf99069e3a9064...4b98597edc416d9f26198d7fddc34edadc6092e0,1,24,0,24,1,2013-11-08 16:29:26,2013-11-08 16:29:26
72f2be8666ed1ca9461c36352c2b9479f352c155...bfacf1366842055d7338df0ad5f705d5f819a60b,27,30,30,60,29,2013-12-10 19:33:21,2013-12-10 19:33:21
2934e7a9627bb92ab9367923cdbcbaa13f7843d4...c26d392b1a160ae357a63cf160daeb81a0dd8ece,4,23,0,23,5,2013-12-11 15:30:22,2013-12-11 15:30:22
0456c666289d81cc2b34af72922346d073842588...3e57d88e578f958a6921f893725e8dd767393901,1,2,0,2,1,2013-12-11 16:40:11,2013-12-11 13:54:26
3e57d88e578f958a6921f893725e8dd767393901...7cb75aeb4612553f24237e79d459390c71470e0b,1,1,1,2,1,2013-12-11 16:40:11,2013-12-11 14:23:21
bb9e01cba6650c9e4aad920596647a65b85adc7e...9697e5327fa4dbe84e35b750203480857c68efd0,3,3,3,6,3,2014-01-20 13:05:19,2014-01-20 13:05:19
bb9e01cba6650c9e4aad920596647a65b85adc7e...2ddfa882c0a3807b35cb0b1a690e4fbaf1e14dbe,1,4,4,8,2,2014-01-20 09:44:40,2014-01-20 09:44:40
03770698417563abe70fdea223700ca370e9f062...449a8eb95c430bab63430a531b36a2211c7ea69c,1,7,1,8,2,2014-01-08 15:04:08,2014-01-08 15:04:08
03770698417563abe70fdea223700ca370e9f062...09eccf4745a715013361c332b23b82ffb310af4b,1,14,10,24,11,2014-01-08 14:58:57,2014-01-08 14:58:57
09eccf4745a715013361c332b23b82ffb310af4b...f46620e6f4d01e4a204dc79104a6934f43c707af,1,9,13,22,6,2014-01-09 11:05:24,2014-01-09 11:05:24
03770698417563abe70fdea223700ca370e9f062...d6c037de81096680db07397a44a0824355c703c8,4,8,4,12,4,2014-01-08 14:32:03,2014-01-08 14:32:03
65696aaa2e1a837d635cba1162c9293da943cbc8...e19f1a11edcddd4a08ea95b60efec1daa3517c36,2,6,1,7,2,2014-01-08 17:57:35,2014-01-08 17:57:35
65696aaa2e1a837d635cba1162c9293da943cbc8...b89b00bf6c1f7e0d369b692c3124acdf3b6f30c1,1,1,2,3,1,2014-01-08 17:33:35,2014-01-08 17:33:35
3f71f2fa72d572536e2f1f212fd626accfe26801...55024ed13af87cea939c6250103c11f8a6e6fa10,2,5,45,50,5,2014-01-13 21:18:30,2014-01-13 21:18:30
38d8d749d73921f370ec8ff28e19f2a5fb7e6f34...065d9c22faf4ae5cdc5dd17f6b655aa15433d5d8,1,2,1,3,2,2014-01-15 11:36:53,2014-01-15 11:36:53
38d8d749d73921f370ec8ff28e19f2a5fb7e6f34...2f55d0b6bec248cca0cd14ff2ff623ab35e1e1dc,1,1,1,2,1,2014-01-15 11:23:47,2014-01-15 11:23:47
38d8d749d73921f370ec8ff28e19f2a5fb7e6f34...f9780eeeca8872c5438f114d12add81785abf41c,1,6,1,7,3,2014-01-15 11:00:11,2014-01-15 11:00:11
d4e82f5e11a1cb069943cf2854ad3dbe9b4f72b3...604b38cd0af1afc7714840b2cd9aa80720852535,1,1,1,2,1,2014-01-22 09:00:25,2014-01-22 09:00:25
869f45b36a0efbe8839afb9c4367ae84b68cd375...8e6ffa1ea80cf25f51d479680cd5f6362d64399a,1,1,1,2,1,2013-08-08 20:34:36,2013-08-08 20:34:36
8e6ffa1ea80cf25f51d479680cd5f6362d64399a...5c44623bc93ff94463f6d9c8d2014e90014aceb8,1,1,1,2,1,2013-08-08 20:38:41,2013-08-08 20:38:41
869f45b36a0efbe8839afb9c4367ae84b68cd375...3ee46726c5231b5c7f8b3bf45cfb700ebcaf414d,1,2,2,4,2,2013-08-08 20:25:47,2013-08-08 20:25:47
d602d5b1b05036788c67c13510c34725c68116ea...348e9a741324fe5ceaac849d342afe93957b44b9,2,109,0,109,2,2013-08-08 07:55:28,2013-08-05 12:23:25
d602d5b1b05036788c67c13510c34725c68116ea...b92655663c9f066de6a67217ad9a55f38e20cffd,5,22,16,38,13,2013-08-05 13:51:04,2013-08-05 13:51:04
b92655663c9f066de6a67217ad9a55f38e20cffd...bb5e50e0f78ec0dc68d637a43b6ea9889ef1a10d,2,2,2,4,2,2013-08-05 13:55:15,2013-08-05 13:55:15
bb5e50e0f78ec0dc68d637a43b6ea9889ef1a10d...88c741dde062e320ad007a2c5ccb4e7bdc6cdacf,10,29,19,48,11,2013-08-05 14:59:58,2013-08-05 14:59:58
88c741dde062e320ad007a2c5ccb4e7bdc6cdacf...128ef337078298966e499365e7dcb6272606b3b5,2,6,10,16,4,2013-08-05 15:16:37,2013-08-05 15:16:37
128ef337078298966e499365e7dcb6272606b3b5...1e3f09b21f124b15eebf71a23c12cfa41f1e5372,2,9,9,18,7,2013-08-05 15:29:44,2013-08-05 15:29:44
79bea312055751bcd92421927f5ff51b22362d63...5e35f21605a15414258c5a857f75679f9df2c102,2,37,1,38,3,2013-07-30 08:15:36,2013-07-29 12:25:33
5e35f21605a15414258c5a857f75679f9df2c102...e03d01d036bf5f5257d767a1b6ab23f06787a421,1,7,3,10,4,2013-07-30 08:15:36,2013-07-29 14:05:08
8c08fb9b28c77fb5bb19bfd7c041d557c89f7120...a4ca5cbaefd859bcdb2cddbf9378172874eca146,1,1,0,1,1,2013-07-30 12:45:53,2013-07-30 12:05:24
9d33c72616aad6a0fd6a6592ba417d770e1923b4...203bc7bb7e352391bc1405c800ae4907d7f3fe02,1,11,10,21,1,2013-09-25 13:54:36,2013-09-25 13:54:36
817b9d1b47a68e173c9edd110fb173a4ebc70266...5a664b3ca4cb1114bf5607332f325f5a6f77add2,1,2,2,4,2,2013-08-20 19:12:42,2013-08-20 19:12:42
2b36dee64485062c69779217d4a202e5ca1b67bd...c8a115c0e3a9c8242c2a422572d47a49e0cb2874,32,925,50,975,86,2013-08-25 22:58:41,2013-05-30 23:16:49
2b36dee64485062c69779217d4a202e5ca1b67bd...d139cc6b3283cef8f14660738d423ea63317203c,3,64,0,64,3,2013-08-25 21:48:11,2013-08-25 21:21:00
0a0b0e1eab251c7e9c9dedc620f14602f8ce3541...625fb2f29d99ab21de2497a36512be69c80e39be,8,43,14,57,12,2013-08-21 09:16:26,2013-08-21 09:16:26
625fb2f29d99ab21de2497a36512be69c80e39be...606701ada4076b963439983a5633535108d81f0f,2,2,1,3,2,2013-08-21 09:22:18,2013-08-21 09:22:18
606701ada4076b963439983a5633535108d81f0f...fd1661468f8132800dec17ad9317d419b1440f5a,5,1,13,14,7,2013-08-21 09:31:47,2013-08-21 09:31:47
fd1661468f8132800dec17ad9317d419b1440f5a...fb492386c5323c4996d05a63ba8d93db6ed07f93,1,1,0,1,1,2013-08-21 09:33:12,2013-08-21 09:33:12
fb492386c5323c4996d05a63ba8d93db6ed07f93...8dd37afe3489ef46e14b33c66d9b80e913540f62,33,144,130,274,46,2013-08-21 09:34:02,2013-08-21 09:34:02
8dd37afe3489ef46e14b33c66d9b80e913540f62...fede36f08995790d0aed89fdc3eeaacd94e98dc5,1,1,0,1,1,2013-08-21 09:40:02,2013-08-21 09:40:02
08be25eb4b9e618dcc65a0ffaea5bf0c63dc8a65...668358439e5f4c92c96fc1ae72b0cf06df8dbd90,3,0,4,4,4,2013-08-21 12:07:09,2013-08-21 12:07:09
1a83fea711961844adc7ddb21ce007143fefc144...3b19ef5b2654f9adce3e5f44e713dfc0655be121,1,17,3,20,2,2013-08-08 14:16:52,2013-07-29 13:18:31
1a83fea711961844adc7ddb21ce007143fefc144...9ad393b2ebed2ba0dc8ccf0ffbf8b080da0564ac,1,1,1,2,1,2013-08-08 11:51:57,2013-08-08 11:51:57
9ad393b2ebed2ba0dc8ccf0ffbf8b080da0564ac...1499f2dfdf1c3015f6b1b62ec0d0c2948b2ce542,1,1,1,2,1,2013-08-09 11:31:16,2013-08-09 11:31:16
f7e4686a425b7e51237420d99d9cf4a23a83b099...73365d701bc760bec52bab0e634053c4a2d98cb9,1,2,2,4,2,2013-04-17 20:00:31,2013-04-17 20:00:31
12dbd0a4137546026a7a1f606510627f262d6dc0...34c8ca286aeeb6731d7b7d0cba3430564c2b2cd5,1,6,2,8,1,2014-01-11 13:54:49,2014-01-11 13:54:49
12dbd0a4137546026a7a1f606510627f262d6dc0...12cb7cee2669502843a17331cb04ada904ff6f81,2,0,15,15,5,2014-01-11 10:11:32,2014-01-11 10:11:32
12cb7cee2669502843a17331cb04ada904ff6f81...8a179611262221f6f3cf2f8737d4340d74f0b282,23,55,115,170,49,2014-01-11 10:11:54,2014-01-11 10:11:54
8a179611262221f6f3cf2f8737d4340d74f0b282...4434f93aa984aabbb5bc35225f0ffe92c0b6f05d,3,18,36,54,7,2014-01-11 10:36:10,2014-01-11 10:36:10
4434f93aa984aabbb5bc35225f0ffe92c0b6f05d...047a76009a869baef2f58023f42ea7e5388c1381,4,9,30,39,8,2014-01-11 13:35:39,2014-01-11 13:35:39
047a76009a869baef2f58023f42ea7e5388c1381...54b908afb730337ac5ae9ba00fb3515818de35b2,1,0,1,1,1,2014-01-11 13:45:29,2014-01-11 13:45:29
54b908afb730337ac5ae9ba00fb3515818de35b2...04ad19dc5c84e68f285753325c8a185a92e464d0,1,1,0,1,1,2014-01-11 14:05:41,2014-01-11 14:05:41
12dbd0a4137546026a7a1f606510627f262d6dc0...32499e8276c936ddc0a3c951413b6f73cbdae00c,1,2,2,4,2,2014-01-11 09:54:05,2014-01-11 09:54:05
32499e8276c936ddc0a3c951413b6f73cbdae00c...8419a2a4ebf79631f712f3066b8a9d4594fe9666,1,2,1,3,2,2014-04-10 14:17:25,2014-04-10 14:17:25
753a2f17c2caed217b6843f9cd3c0edb0a3aa2c0...2eb1220f6701442660b090fba66c82f8008ee1f6,2,7,10,17,7,2014-01-11 17:24:20,2014-01-11 17:15:47
2eb1220f6701442660b090fba66c82f8008ee1f6...ef404d8ea62f277ec40d9a0a82c08d389b07b54e,2,0,6,6,6,2014-01-11 17:40:17,2014-01-11 17:40:17
5405f19baced5972472d5d8bdd6a8c77d59e68ea...1616dfdc07689ccea258e606f414e65836f666a3,3,22,14,36,9,2013-12-19 17:36:27,2013-12-19 17:36:27
1616dfdc07689ccea258e606f414e65836f666a3...5c68f4f4e51b88d73b8fce0defc51f977280d967,1,1,1,2,1,2013-12-19 17:39:58,2013-12-19 17:39:58
5c68f4f4e51b88d73b8fce0defc51f977280d967...3958330edc5aa6044ebe90382fd901834ecfa821,4,14,6,20,7,2013-12-19 17:54:57,2013-12-19 17:54:57
79248f4ca503a765131731dc7ffa5bfeca89cf73...1f41e1bcdd491240f42f76d8b18b2b341fbd1b8a,2,6,4,10,4,2013-12-18 14:03:59,2013-12-18 14:03:59
1f41e1bcdd491240f42f76d8b18b2b341fbd1b8a...4efaa51bbe37e05396dc28143e5015a211ecfa64,1,1,1,2,1,2013-12-18 14:07:49,2013-12-18 14:07:49
79248f4ca503a765131731dc7ffa5bfeca89cf73...5cb852589186a661476461ec5dd7bb15dee5bfd9,2,9,5,14,3,2013-12-18 13:02:31,2013-12-18 13:02:31
8bcb2ff27e79753a84c1800e453584d3a23fbb4e...1231a3678aac1c614b19b92f8b2afb397feae959,2,7,2,9,3,2013-12-20 07:48:43,2013-12-20 07:48:43
8bcb2ff27e79753a84c1800e453584d3a23fbb4e...5c17be36048ab3a0e456ac40d154e09ae6f23ae4,1,1,1,2,1,2013-12-19 19:42:11,2013-12-19 19:42:11
bd94cae8f4fd00747d40b6abe1390e54f4343dc2...4db2e97bf401dbe7a3fdd928242926c146ab935b,1,1,1,2,1,2013-12-18 15:10:12,2013-12-18 15:10:12
31892227d7611c1818dbe94b360327e714106297...4e878ad902c8026513e69f2ed79b6ed17b63ed24,1,2,0,2,1,2013-12-02 08:39:46,2013-12-02 08:39:46
db0c353a78a79932e57cd4fa6b6245d793622db7...071de30f80ea471c48f52ff1f5d728089b75a8c0,3,3,2,5,3,2013-11-29 11:31:57,2013-11-29 11:31:57
70c2e1d773291b4854da5a3b479baa352428bb4b...33aea41708b94f480b6eaad760e26abe17a37dfa,12,30,21,51,17,2013-11-28 09:38:20,2013-11-28 09:38:20
23d180f5f1905eb8d714daaf2d097767ff355817...843548cc7681e600b1180a91a407385b35c7f23c,1,3,0,3,1,2013-12-16 17:39:54,2013-12-04 23:07:14
23d180f5f1905eb8d714daaf2d097767ff355817...6edb4c0634740e4231e5939b13fd696b6823b3de,3,11,0,11,4,2013-12-05 08:29:45,2013-12-05 08:29:45
23d180f5f1905eb8d714daaf2d097767ff355817...4f61da6943dbffb0b2461b60a8b8cdced4e52974,1,1,1,2,1,2013-12-05 07:30:30,2013-12-05 07:30:30
23d180f5f1905eb8d714daaf2d097767ff355817...c099074fcc96304d948cc028ff7ae5913b561ed3,7,71,6,77,8,2013-12-04 19:10:20,2013-12-03 14:22:33
499a118590e875596974e522aecf61bdc05fe0f2...90bdcac6b17c0da762959dcfae3521f3be4606b7,7,118,15,133,18,2014-02-23 08:47:52,2014-02-20 14:09:30
499a118590e875596974e522aecf61bdc05fe0f2...0f080a94106904c57cfcb6c1d02c6207c1d4617e,1,1,0,1,1,2014-02-20 12:07:42,2014-02-20 12:07:42
499a118590e875596974e522aecf61bdc05fe0f2...055937c417fde5af2b54796b61b0e1486f1e42d3,6,0,0,0,0,2014-02-20 11:56:22,2014-02-20 11:56:22
499a118590e875596974e522aecf61bdc05fe0f2...f92b1f3d018bf51e9372b88dd50a2be8149b2fa6,18,43,46,89,35,2014-02-20 11:05:33,2014-02-20 11:05:33
f92b1f3d018bf51e9372b88dd50a2be8149b2fa6...32ecb02784a25feb2f264f47b883de3a0cb5f8fd,36,175,195,370,57,2014-02-20 11:51:22,2014-02-20 11:51:22
499a118590e875596974e522aecf61bdc05fe0f2...c2ed468d803f37e29636d234d6c5db4e7e220880,1,1,1,2,1,2014-02-20 09:59:03,2014-02-20 09:59:03
499a118590e875596974e522aecf61bdc05fe0f2...c1dddf8c7d947691729f6d64a8ea768b5c915855,2,2,2,4,2,2014-02-20 08:45:58,2014-02-20 08:45:25
c1dddf8c7d947691729f6d64a8ea768b5c915855...acdb808abc819180529855fa2f919587fa0dec58,3,48,47,95,3,2014-02-20 09:10:25,2014-02-20 09:10:25
acdb808abc819180529855fa2f919587fa0dec58...a7a2100f3d3344669d951665dc8e2253451d859f,1,26,26,52,14,2014-02-20 09:51:58,2014-02-20 09:51:58
a7a2100f3d3344669d951665dc8e2253451d859f...fcdcb1a6751354819410444ae7f38391e64a686d,3,20,29,49,3,2014-02-20 11:31:04,2014-02-20 10:42:58
c3a3f80af9277ca22a186a6ac8feafe9ddfda97c...b6a934207cef56a7474168b96a4a8615313b89be,1,2,1,3,2,2014-02-25 13:39:55,2014-02-25 13:39:55
b6a934207cef56a7474168b96a4a8615313b89be...5f31caa0ed88b0d779336d909dc7f48b9f86cd25,1,1,1,2,1,2014-02-25 13:45:19,2014-02-25 13:45:19
85c2cb2a1980d494aef198c59e4f3859b2668ba3...631bbe50ff1e389fd587b15f33cda399938914f3,1,3,2,5,2,2015-02-06 05:49:15,2015-02-06 05:49:15
85c2cb2a1980d494aef198c59e4f3859b2668ba3...b3c90dd51418d0c41df4ccd57d9480ea44b35eec,4,45,31,76,16,2015-02-06 05:48:21,2015-02-06 00:57:27
dc365a1d20c2c395c32a2e3869fd1de500c09ae9...af44c65030a1fbc4e29c3cf51e4d3c33b9666201,3,12,0,12,3,2015-02-09 13:34:06,2015-02-09 13:34:06
8aabb58d5bac01377224ba76d8f8f3ba403e325d...7486bc0ae33adc141abbca2ea5dea833e56d5409,1,1,1,2,1,2015-03-01 08:40:04,2015-03-01 08:40:04
2f4656b5c7e2a9b351237432e76a7b928a1684b1...516bcabbf42d60db2ac989dce4c7187b2a1e5de9,7,50,16,66,11,2015-03-04 22:20:47,2015-03-03 12:07:14
2f4656b5c7e2a9b351237432e76a7b928a1684b1...fbc3cb69c327e52a002c7909c257c43c9a2f5ba5,12,208,9,217,14,2015-03-03 15:19:37,2015-03-03 15:19:37
fbc3cb69c327e52a002c7909c257c43c9a2f5ba5...53aec08d0295c8c33286f634c1f4ece81271c04d,1,1,0,1,1,2015-03-04 09:13:16,2015-03-04 09:13:16
2f4656b5c7e2a9b351237432e76a7b928a1684b1...10212c01fd18aa9961e86bd961475068a7596f00,1,1,1,2,1,2015-03-03 14:31:05,2015-03-03 14:31:05
2f4656b5c7e2a9b351237432e76a7b928a1684b1...3102454a566292d6435fcaae8d21c6c2d26c0341,1,8,7,15,2,2015-03-03 12:52:13,2015-03-03 12:52:13
2f4656b5c7e2a9b351237432e76a7b928a1684b1...d513ca584aaed7ca2a1de2d2fbd2192422f13d81,3,7,20,27,3,2015-03-03 10:21:48,2015-02-24 15:48:22
d513ca584aaed7ca2a1de2d2fbd2192422f13d81...3702c4ad80614d71fc5ac3ea1af7c3789ec8146d,4,32,7,39,5,2015-03-03 10:22:30,2015-02-24 16:02:11
2f4656b5c7e2a9b351237432e76a7b928a1684b1...afe5d7d209a4088d71e35d6382e6523b89f94ebe,47,722,195,917,77,2015-03-03 10:14:31,2015-02-19 05:02:57
afe5d7d209a4088d71e35d6382e6523b89f94ebe...d9ff616fd803c8bd9d208c22d01770acc8d58a38,13,59,57,116,29,2015-03-03 10:14:32,2015-02-20 13:49:26
d9ff616fd803c8bd9d208c22d01770acc8d58a38...19f04cf989a75f425af09a8551957dae42b1ff31,1,1,0,1,1,2015-03-03 10:14:32,2015-02-20 13:49:36
19f04cf989a75f425af09a8551957dae42b1ff31...d86c0cda24a76c9330b5fed59e857ce9e4150b9b,8,12,14,26,8,2015-03-03 10:14:32,2015-02-20 15:05:40
d86c0cda24a76c9330b5fed59e857ce9e4150b9b...f13567edc4b9ce68179d12562a711540c8994206,1,7,2,9,2,2015-03-03 10:14:32,2015-02-24 13:29:21
f13567edc4b9ce68179d12562a711540c8994206...ca56d9ff9ff8b28172d5e3dae7e09b77e2e6b835,1,0,4,4,1,2015-03-03 10:14:32,2015-02-24 13:29:41
ca56d9ff9ff8b28172d5e3dae7e09b77e2e6b835...bbcb12f2719d5d8747339ad1bcb3457217870dc2,1,5,5,10,2,2015-03-03 10:14:32,2015-02-24 13:31:08
bbcb12f2719d5d8747339ad1bcb3457217870dc2...85fa334eb6fd2069287a660e6ffa2295ea3a787f,1,1,1,2,1,2015-03-03 10:14:32,2015-02-24 13:35:14
85fa334eb6fd2069287a660e6ffa2295ea3a787f...d57e809cbd56aea8a49c6595663fc4b7250c5a34,19,156,57,213,35,2015-03-03 10:14:32,2015-02-28 16:33:18
d57e809cbd56aea8a49c6595663fc4b7250c5a34...5c910b94cef084fc1fae398fdf72a220f800e7ad,2,6,3,9,3,2015-03-03 10:14:33,2015-02-28 16:41:01
5c910b94cef084fc1fae398fdf72a220f800e7ad...2c7baed3946dcc724e091698978419a18c7d6930,1,1,3,4,2,2015-03-03 10:20:01,2015-03-03 10:20:01
2c7baed3946dcc724e091698978419a18c7d6930...fc6160816119504e1cea0954453cd557231341a1,1,3,3,6,2,2015-03-03 12:09:45,2015-03-03 12:09:45
2f4656b5c7e2a9b351237432e76a7b928a1684b1...6f71f5bb1be3d3c8ea2364a7763c62421de28f91,1,1,1,2,2,2015-03-03 09:28:44,2015-03-03 09:28:44
2f4656b5c7e2a9b351237432e76a7b928a1684b1...f438791721360e547f3661a553f491d258013eb8,3,16,1,17,3,2015-03-03 07:06:59,2015-03-03 07:06:59
f4038138fb250bd912d593ca83e867efb4ced186...0d5c8500b843734daed0da4244862fc584b7fb4c,1,3,3,6,3,2014-11-24 12:27:00,2014-11-24 12:26:41
f4038138fb250bd912d593ca83e867efb4ced186...335320a2e1df302bbf0a16374ca7248c43562ca2,1,3,3,6,3,2014-11-24 12:26:41,2014-11-24 12:26:41
335320a2e1df302bbf0a16374ca7248c43562ca2...282ca063e51bbd115e269f1d28894443bff24b33,1,18,0,18,1,2014-11-24 12:38:02,2014-11-24 12:38:02
282ca063e51bbd115e269f1d28894443bff24b33...8f4353a1644c2893b7747e2b55c7a3ad190b7b76,1,1,1,2,1,2014-11-24 19:56:30,2014-11-24 19:56:30
f4038138fb250bd912d593ca83e867efb4ced186...e0c870c0451789318e46ff5cb2b44a8d7d555f4c,1,3,1,4,1,2014-11-24 11:14:07,2014-11-24 11:14:07
e0c870c0451789318e46ff5cb2b44a8d7d555f4c...4e3bf439cba782bf7d3ea326f0f6f5878166f0e2,2,3,0,3,3,2014-11-24 11:14:19,2014-11-24 11:14:19
4e3bf439cba782bf7d3ea326f0f6f5878166f0e2...a0a3eba1970cc6ea23cfdfe5750971215b2cafd2,1,1,1,2,1,2014-11-24 13:59:54,2014-11-24 13:59:54
be206a514235fe1ca7f35cf018c44202a331cb87...f06f69b9da81337db14324783b45ea5f55fcf735,16,33,15,48,16,2014-12-15 19:21:26,2014-12-15 01:01:59
be206a514235fe1ca7f35cf018c44202a331cb87...0ed4ae7295ef1cf5d3a63be64315738a19a178b1,1,5,1,6,1,2014-12-15 12:02:07,2014-12-15 02:01:02
be206a514235fe1ca7f35cf018c44202a331cb87...d6840542a7e96bbadf6ca221af489ec91d3fd747,1,1,1,2,1,2014-12-14 20:45:49,2014-10-30 17:18:32
ed7b3f84aea9bdac396a5ad70751fe9fd3549961...d11e048d7fea208a89dab80712925eaf34f69627,1,23,0,23,1,2014-12-14 14:47:13,2014-12-14 14:47:13
fe68c45aa566b436a122c1598c58006d37472e8d...91a3a7a6a0cf7806ad4c00f2cac4854a77441b5f,3,10,6,16,4,2014-12-29 15:07:00,2014-12-24 14:52:40
9ddc6cf05e52e1a90ca52ae28c95d05f5bdd2004...86c55106a0fb00533299efb96ba72ac91efc4276,1,1,1,2,1,2014-12-01 16:45:25,2014-12-01 16:45:25
f447aed26a7f1d8ca538e45ef02b22e7693049ec...0ec4685837e2ca83d1bdebd72f99ddb725dc609c,1,1,1,2,1,2014-12-02 13:48:42,2014-12-02 13:48:42
f447aed26a7f1d8ca538e45ef02b22e7693049ec...bff0034584f47b64cad2813dc6db9bb571faecce,1,6,1,7,2,2014-12-02 13:39:58,2014-12-02 13:39:58
bff0034584f47b64cad2813dc6db9bb571faecce...79912d6870ec019fa0100c1ced1c5a2c1f9c3227,1,3,2,5,2,2014-12-02 13:46:16,2014-12-02 13:46:16
a70e7d61acfa6eb41acf049ece0ca39ac70de09a...f69095fa3d3e3840d7b07e757ec2e7d69cc49ff5,1,1,1,2,1,2014-12-03 09:41:26,2014-12-03 09:41:26
c59b5e4e68616f7c43df148cf38bb3e36a08725a...a3e9046ad522d4d234c9b4e644a1175f9ed8213d,1,1,1,2,1,2014-12-04 11:29:30,2014-12-04 11:29:30
236741008ed82b77e3e4357e07060f7764d1d21a...1a80d13a3990937580c97e2b0ba8fb98f69bc055,8,123,50,173,39,2014-12-04 11:01:50,2014-11-25 16:15:30
1a80d13a3990937580c97e2b0ba8fb98f69bc055...3a5ed5260b24051939575d1934ce9b8392cac09f,20,123,127,250,68,2014-12-04 11:03:55,2014-11-27 11:34:39
3a5ed5260b24051939575d1934ce9b8392cac09f...b56b96d438c92981cd5c0f5e2f4b23d3799a3bd3,3,22,1,23,3,2014-12-04 11:03:55,2014-12-04 10:55:37
b56b96d438c92981cd5c0f5e2f4b23d3799a3bd3...f9a730ebb48ffe21c7b80ed4d188e47ec1baa497,4,16,13,29,4,2014-12-04 13:53:26,2014-12-04 11:43:08
69e8b0e9fd03bf745556d7382c1156073998a0d6...db585009be76ed7b00b4298f863333c92b94cf04,1,0,4,4,1,2014-12-05 14:33:22,2014-12-05 14:33:22
db585009be76ed7b00b4298f863333c92b94cf04...3f1fad5f090ba77f202ae9ad1adbad394deef4db,1,10,0,10,1,2014-12-05 14:59:55,2014-12-05 14:59:55
3a533d48c634b0affd285832bd8dbc24435e19bc...0e2fcb68d7d169574391b845df0973575fa41c08,1,0,1,1,1,2015-02-04 23:23:38,2015-02-04 23:23:38
0e2fcb68d7d169574391b845df0973575fa41c08...d8cb235195cc70542d580842383d2697d5a5c5fd,1,1,1,2,1,2015-02-05 00:57:55,2015-02-05 00:57:55
14b68586b8c2187d918a2d6c8cad51a72e2b51cd...89c942908cc1d98dfd4af1f89b69704f691a0edf,1,1,1,2,1,2014-04-04 20:17:21,2014-04-04 20:17:21
14b68586b8c2187d918a2d6c8cad51a72e2b51cd...e159a5615721f4742c39872e02cb316dd511b2e3,1,3,1,4,1,2014-04-04 13:52:07,2014-04-04 13:52:07
14b68586b8c2187d918a2d6c8cad51a72e2b51cd...11f864c9403e528c734d5c13a748b39733c9889e,2,15,15,30,9,2014-04-04 12:22:03,2014-04-04 12:22:03
fefa10c3c208cb0cce6e25e498221d1d97d26238...3befe6ec339651feedc8437b5bb10d473c3e3f66,1,5,16,21,4,2014-04-07 15:57:57,2014-04-07 15:57:57
3befe6ec339651feedc8437b5bb10d473c3e3f66...d70939f6806ed388444309def47c170fa02c5591,1,1,1,2,1,2014-04-07 15:59:10,2014-04-07 15:59:10
d70939f6806ed388444309def47c170fa02c5591...d92e4830f78018b3a38bc448aaec4a045f4d3d62,2,6,6,12,5,2014-04-07 16:11:02,2014-04-07 16:11:02
0d3ba71bcb92218585988ca1b9f863a796d6e168...cf43bf3620f7b2600f5af168f7bf56c0129924f2,3,9,0,9,3,2014-04-16 19:05:13,2014-04-16 19:03:54
cf43bf3620f7b2600f5af168f7bf56c0129924f2...7ee0a94e8bd4da8862fab0ec2e8b7ccc0a2581f9,1,0,3,3,1,2014-04-16 19:14:40,2014-04-16 19:14:40
7ee0a94e8bd4da8862fab0ec2e8b7ccc0a2581f9...556ddbcad49be5d59cd6275639ac149f5b2ee7ac,1,1,1,2,1,2014-04-18 10:05:00,2014-04-18 10:05:00
0d3ba71bcb92218585988ca1b9f863a796d6e168...8d78662e69a11dc82916793d97aba36dacae1440,3,3,2,5,3,2014-04-15 13:53:14,2014-04-15 10:11:13
0d3ba71bcb92218585988ca1b9f863a796d6e168...b0114867311652e32868e8f48b9c268a712367bf,1,4,0,4,1,2014-04-15 08:23:37,2014-04-15 08:23:37
1e8ed9d51454df4d18ace7c89d41d79121135743...3b339a8b040b1c12469a2eb1ed05bdc3b2aa9af4,3,45,2,47,4,2014-04-08 07:32:00,2014-04-08 07:32:00
352bb972665822cace72497241e7b309c2167268...ca6978dfc58a98bf0f5f3a8f227930e3391b3f64,1,1,1,2,1,2014-04-14 03:00:48,2014-04-14 02:53:40
352bb972665822cace72497241e7b309c2167268...133da280582e5cdb003a2d2bc6885b21f861432c,1,34,0,34,1,2014-04-14 00:26:48,2014-04-14 00:26:48
0dc48fac6b68299c8043b7e03a9fac3ae2b4888c...6e4dbde2e7e9f4ca2b172f8e59230cc3f6a86f4f,1,2,1,3,2,2014-04-07 12:14:14,2014-04-07 12:14:14
6e4dbde2e7e9f4ca2b172f8e59230cc3f6a86f4f...db880cf39f9a68bb7d18b028fe6c1b843d5ca6cb,1,0,0,0,0,2014-04-07 12:17:40,2014-04-07 12:17:40
0dc48fac6b68299c8043b7e03a9fac3ae2b4888c...a4523c5292a07bef98d38c4938e700d257a1db2b,1,4,1,5,2,2014-04-07 12:11:00,2014-04-07 12:11:00
cad9572ee9f19fa8613833704752250f4b2dc549...fc7188cc06bdfc25b61d48414eb0691ce09153ae,1,2,2,4,2,2014-04-16 05:19:30,2014-04-16 05:19:30
cad9572ee9f19fa8613833704752250f4b2dc549...891b67c800cfbac2044460342e935582051ef46e,2,0,4,4,2,2014-04-15 18:50:16,2014-04-15 18:50:16
cad9572ee9f19fa8613833704752250f4b2dc549...b29171d9ec430c35413335eb6a8cbe83383c46c6,1,3,1,4,1,2014-04-15 18:27:25,2014-04-15 16:57:07
cad9572ee9f19fa8613833704752250f4b2dc549...4691285989000a8053c9540fa50ca95d3a00551d,1,1,1,2,1,2014-04-15 18:23:55,2014-04-15 16:04:22
c51ac0484f37b65b31cd83b816b151fc7d50cf05...c7dc20c1202d6cd9d7593de76718e16c4d601980,1,6,1,7,1,2014-04-29 07:11:02,2014-04-29 07:11:02
7f685986220349f61e7df87afda13e2ca9b8390b...06feb3c44231ab3fb8ac26c00d606587ac90a11c,1,9,1,10,1,2013-11-22 10:41:55,2013-11-22 10:41:55
06feb3c44231ab3fb8ac26c00d606587ac90a11c...51ae88c4e42f577b706447884dad94b11e9c916f,1,1,1,2,1,2013-11-22 10:55:20,2013-11-22 10:55:20
51ae88c4e42f577b706447884dad94b11e9c916f...f285da48b1977fd024ba258c9b03d96a77a63d95,1,1,1,2,1,2013-11-22 10:58:37,2013-11-22 10:58:37
f285da48b1977fd024ba258c9b03d96a77a63d95...983bf359945bc9d4ec1e9581e6bc35dac65e3a3b,1,5,5,10,4,2013-11-22 13:19:22,2013-11-22 13:18:47
2dbc476aae645759cf0ef9f7eabcf14f5a42ff9e...abc5edab55ca46657e4ccea552838b9b8d96757f,1,1,0,1,1,2013-11-23 19:43:18,2013-11-23 19:43:18
c28786ecbeb7ba2e630896b37481b918af4ed39e...02484930e161f773a205bb1c1d29a8664755fd60,5,0,16,16,5,2013-11-08 07:22:50,2013-11-08 07:22:50
c28786ecbeb7ba2e630896b37481b918af4ed39e...54e65c11762c867c39e9566dac3307bf790d2d86,1,1,1,2,1,2013-11-08 06:48:45,2013-11-08 06:48:45
c28786ecbeb7ba2e630896b37481b918af4ed39e...0b67606af6b339b6d3a84ffd981bf7d850e3b93f,3,43,1,44,3,2013-11-07 16:53:09,2013-11-07 16:53:09
0b67606af6b339b6d3a84ffd981bf7d850e3b93f...e8bb32e62355542e2fe3c17c06a433f355694788,2,47,0,47,2,2013-11-07 16:53:35,2013-11-07 16:53:35
e8bb32e62355542e2fe3c17c06a433f355694788...f64dd1b492952083449dc7f0e226cf7b20e1a1fb,1,16,1,17,1,2013-11-09 09:40:17,2013-11-09 09:40:17
c28786ecbeb7ba2e630896b37481b918af4ed39e...da238bbdf43daf167859fcc3dd11a0ca79bac225,2,0,3,3,2,2013-11-07 08:56:12,2013-11-07 08:56:12
5221dbfee74e48f379bc06b2848a64243a76270c...251df827a5308d483a95242970569075ab655703,15,161,2,163,18,2014-01-28 07:38:00,2014-01-27 21:34:05
5221dbfee74e48f379bc06b2848a64243a76270c...4125de5ef1c694f65b038b4a4b17de7adcdeef78,2,11,5,16,2,2014-01-27 14:50:53,2014-01-27 12:37:00
adf559581cf5ac61445088158072820522337e9f...445f31c64261eb9c9ca85e59fcb9f8fde171cd9e,1,1,1,2,1,2013-12-11 15:59:37,2013-12-11 15:59:37
7bb2a536a02454bef0f5b9c6def342992128da36...5675d3431688862b639c82afdd47b114169e38c9,1,0,1,1,1,2013-12-12 09:46:49,2013-12-12 09:46:49
7bb2a536a02454bef0f5b9c6def342992128da36...405694a5d683d9a784d1c07d3d65713a0c898908,1,7,3,10,3,2013-12-12 09:32:16,2013-12-12 09:32:16
405694a5d683d9a784d1c07d3d65713a0c898908...5a4386a466425422fc20c255e8a310eff0380f6b,2,16,1,17,2,2013-12-12 09:33:57,2013-12-12 09:33:57
5a4386a466425422fc20c255e8a310eff0380f6b...6c3459978dff210af0066307f76800956cbec5a8,2,36,5,41,5,2013-12-12 09:34:42,2013-12-12 09:34:42
6c3459978dff210af0066307f76800956cbec5a8...7901d143153842a1a8b382d16e90a20cf4dd3b36,1,15,9,24,2,2013-12-12 09:51:39,2013-12-12 09:51:39
7901d143153842a1a8b382d16e90a20cf4dd3b36...432018f84beb96a8f6eb791af59e175263ea01aa,5,5,5,10,5,2013-12-12 09:52:10,2013-12-12 09:52:10
432018f84beb96a8f6eb791af59e175263ea01aa...cb599a09be48ff7bcf73bbd4ea785c337c45b407,3,21,2,23,4,2013-12-12 10:20:54,2013-12-12 10:20:54
cb599a09be48ff7bcf73bbd4ea785c337c45b407...8c5aa5e3b1e9cae4962b797c15cb3366cb689b38,1,1,1,2,1,2013-12-12 12:20:08,2013-12-12 12:20:08
2a748d9a0142d90814db93c4b58ff6bbae0ad2f3...f59fe341dec81f3d90fd91ea19fb28318445f6fd,1,1,0,1,1,2014-01-21 09:20:05,2014-01-21 09:20:05
a67f3c393f223114a8682f5409700a80a5ee7cc4...515ed7755e2419955b069c33da878efadbbff6c2,3,11,10,21,5,2014-01-10 11:58:52,2014-01-10 11:58:52
515ed7755e2419955b069c33da878efadbbff6c2...f1266765533105e94815829178869bddbc826901,8,484,495,979,12,2014-01-10 12:14:55,2014-01-10 12:14:55
f1266765533105e94815829178869bddbc826901...95e6a5dcd380d738fbf9d959111f049d15ca8d11,3,55,55,110,26,2014-01-10 12:39:45,2014-01-10 12:39:45
ddb6fb9c47740aa51caa30b8e35e15f0868a7be9...bcb0b6509eb948978dbf04bef054c8ae52033e0e,1,1,0,1,1,2014-01-08 18:57:58,2014-01-08 18:57:58
bcb0b6509eb948978dbf04bef054c8ae52033e0e...9e347d9a9d6d078cbde984c98b485d72d4bb5cd0,3,56,54,110,3,2014-01-08 23:06:19,2014-01-08 23:06:19
9e347d9a9d6d078cbde984c98b485d72d4bb5cd0...a10c08c4c75ea2753b092e66b1daed7ffe23a0b6,1,5,0,5,2,2014-01-09 08:12:17,2014-01-09 08:12:17
55024ed13af87cea939c6250103c11f8a6e6fa10...92c568226808cc48aa6396c17d5d15741bd3d123,1,2,3,5,2,2014-01-15 15:16:07,2014-01-15 15:16:07
92c568226808cc48aa6396c17d5d15741bd3d123...d015bb322f82462b80d2fcec8884bc97574e18b5,1,2,2,4,2,2014-01-16 10:05:55,2014-01-16 10:05:55
55024ed13af87cea939c6250103c11f8a6e6fa10...82aaa8977862b56e14ffdabdbee54fad51fca0ec,1,11,10,21,1,2014-01-14 13:24:00,2014-01-14 13:24:00
55024ed13af87cea939c6250103c11f8a6e6fa10...6ecda0f4051fd85ff53317279b0b92c9dcd5bf10,1,1,1,2,1,2014-01-14 08:09:20,2014-01-14 08:09:20
55024ed13af87cea939c6250103c11f8a6e6fa10...d5bb466fe4aa44b5c303d7ba55f48af752e164da,1,5,2,7,2,2014-01-13 21:22:46,2014-01-13 21:21:25
065d9c22faf4ae5cdc5dd17f6b655aa15433d5d8...37ef33cba18f947699fc3f285397be34861ab51e,3,15,9,24,9,2014-01-15 12:26:05,2014-01-15 12:26:05
37ef33cba18f947699fc3f285397be34861ab51e...8bfc62fb8b02bde7da97958deb8aeda63581bfce,4,28,10,38,6,2014-01-15 12:38:50,2014-01-15 12:38:50
8bfc62fb8b02bde7da97958deb8aeda63581bfce...f19cdee8cc1e85066154d008ee2653d845c9f3cd,3,23,52,75,10,2014-01-15 13:06:12,2014-01-15 13:06:12
f19cdee8cc1e85066154d008ee2653d845c9f3cd...7bcd112a297fede6ce58801ae462664a246d0442,1,1,1,2,1,2014-01-15 13:31:49,2014-01-15 13:31:49
7bcd112a297fede6ce58801ae462664a246d0442...4e2c34d81b46b97929ca1db3fe1c2a1f77b03552,1,4,2,6,3,2014-01-15 14:38:48,2014-01-15 14:38:48
065d9c22faf4ae5cdc5dd17f6b655aa15433d5d8...2e7abbd66c1e68eaf6cd227ce7e26e2d9a3d4180,3,35,3,38,3,2014-01-15 12:03:52,2014-01-15 12:03:52
dba982403b7b894d2096ea61b89a247060eefe57...2e3f250d4516c92adce5511747419d7f1fe04b97,14,94,9,103,28,2014-01-18 19:15:10,2014-01-18 19:07:00
dba982403b7b894d2096ea61b89a247060eefe57...390f0b76b51d966b2ac429c28d07fbec5497a4c0,1,5,0,5,1,2014-01-17 10:34:06,2014-01-17 10:34:06
dba982403b7b894d2096ea61b89a247060eefe57...e6a03dc35ea2d0d6850a1741d022678df87c351c,1,1,1,2,1,2014-01-17 01:43:50,2014-01-17 01:43:50
dba982403b7b894d2096ea61b89a247060eefe57...af9a14c49cd0e33090765885eb0fa7abefac84ff,2,4,2,6,2,2014-01-16 17:40:45,2014-01-16 17:40:45
dba982403b7b894d2096ea61b89a247060eefe57...1d2bdb4d5880bb1ad39b62c81ff2971aa0cb3798,22,27,27,54,27,2014-01-16 17:03:42,2014-01-16 17:03:42
1d2bdb4d5880bb1ad39b62c81ff2971aa0cb3798...4a1654ed6a2393279ba6227454acbc3a80559d7d,6,19,19,38,19,2014-01-16 18:29:18,2014-01-16 18:29:18
4a1654ed6a2393279ba6227454acbc3a80559d7d...efa10c819d133407041bc9e89b4d2a43e64552fd,3,6,6,12,6,2014-01-16 18:35:21,2014-01-16 18:35:21
efa10c819d133407041bc9e89b4d2a43e64552fd...4d82e9ed0b6ddb45663bde71412de9c840c58337,3,3,3,6,3,2014-01-16 18:36:51,2014-01-16 18:36:51
dba982403b7b894d2096ea61b89a247060eefe57...21bc41c6ee9995a821900378e933e08e4e5214bc,3,13,4,17,5,2014-01-16 16:02:09,2014-01-16 16:02:09
21bc41c6ee9995a821900378e933e08e4e5214bc...1d497a127b2a54953e783375d1f9e6fd728abdb8,1,2,0,2,2,2014-01-16 16:09:58,2014-01-16 16:09:58
1d497a127b2a54953e783375d1f9e6fd728abdb8...7001ad2dda56343dcdf035aebdf3334068d123a0,2,6,4,10,3,2014-01-16 16:10:35,2014-01-16 16:10:35
7001ad2dda56343dcdf035aebdf3334068d123a0...4f2e9fb8e56249d3bcce128a50a6fa6b4deca00f,1,2,2,4,2,2014-01-16 16:11:00,2014-01-16 16:11:00
4f2e9fb8e56249d3bcce128a50a6fa6b4deca00f...8f0a97da0498dbfab0ad98402bea577ee68abdab,2,7,1,8,2,2014-01-16 16:25:32,2014-01-16 16:25:32
8f0a97da0498dbfab0ad98402bea577ee68abdab...1c4870c54a9292ce4b4f1cfa553a5cbf21135deb,1,1,1,2,1,2014-01-16 17:31:12,2014-01-16 17:31:12
dba982403b7b894d2096ea61b89a247060eefe57...05e4af5b4c7709ab08194d109ddec8e19f44758d,4,28,1,29,5,2014-01-16 11:14:47,2014-01-16 11:14:47
6c5606d212b79477709d5a9b53eb2ffb9f5f0650...bcedc4858d98b0d9bc1b642fb6658a5f919cfa57,1,2,2,4,2,2014-01-22 09:08:42,2014-01-22 09:08:42
bcedc4858d98b0d9bc1b642fb6658a5f919cfa57...51f06bad0b3292226269ada45d6e6994182b6b7b,1,1,1,2,1,2014-01-22 09:10:01,2014-01-22 09:10:01
51f06bad0b3292226269ada45d6e6994182b6b7b...1018cbdc803d56e6cae385aee97aa04752d3e3fb,1,1,0,1,1,2014-01-22 09:18:34,2014-01-22 09:18:34
b8ee6af05dbce7c25a5962d1957dcf6efdbeddb6...27b3d2302ed73276a041775330715962fa3b449b,1,2,2,4,2,2013-08-08 20:48:06,2013-08-08 20:48:06
d521cf8d011d91d494b25a5944d16a2466f5f264...a2501d158646e2a9eb9c17c3c88a9a24a74ea24b,1,4,4,8,3,2013-08-05 16:08:51,2013-08-05 16:08:51
a2501d158646e2a9eb9c17c3c88a9a24a74ea24b...498a9ce3d2744d9af7811f2b1d8bef8aeeb78eaf,1,4,4,8,3,2013-08-05 16:10:20,2013-08-05 16:10:20
c5add8fe55441aa19d424d19fbb2e321f99cb47f...a28bc409fcedfbd668ab9be725b451d5c02ba5cb,3,5,5,10,4,2013-07-31 11:33:09,2013-07-31 11:33:09
a28bc409fcedfbd668ab9be725b451d5c02ba5cb...c4856e6f8dbc7b7db5cb01c340e211026dda03af,2,4,1,5,2,2013-07-31 13:24:11,2013-07-31 13:24:11
c4856e6f8dbc7b7db5cb01c340e211026dda03af...9f38cf5093f5141717cfa1b1c956ed8ec9135ebe,5,41,20,61,10,2013-07-31 14:05:22,2013-07-31 14:05:22
9f38cf5093f5141717cfa1b1c956ed8ec9135ebe...9b7241dfdd4a3a33e137b9aed9b73d59a07973b1,7,31,4,35,9,2013-07-31 14:39:57,2013-07-31 14:39:57
9b7241dfdd4a3a33e137b9aed9b73d59a07973b1...b19bffc536c85262e85f81237c544e18040742c6,3,12,7,19,5,2013-07-31 14:53:42,2013-07-31 14:53:42
c5add8fe55441aa19d424d19fbb2e321f99cb47f...e08f977bb92e0ac8fa4f8be8bb2c71e899f782cf,1,1,1,2,1,2013-07-30 18:23:30,2013-07-30 18:23:30
c5add8fe55441aa19d424d19fbb2e321f99cb47f...b9717ba45e3b306c091946c43718f6019aed7b33,2,15,5,20,6,2013-07-30 17:06:45,2013-07-30 17:06:45
1165759b14b02ad87dff46716e37e569f678b0b5...11605c2d8dac95503242a87b56715fbe985953e9,2,2,2,4,2,2013-09-25 13:59:38,2013-09-25 13:59:38
11605c2d8dac95503242a87b56715fbe985953e9...c611ea513ceff4036d0e184959628f1ac39c7ef1,1,3,3,6,2,2013-09-25 14:20:07,2013-09-25 14:20:07
c611ea513ceff4036d0e184959628f1ac39c7ef1...7bb03a536a33b4e61f75b62e060c4b174b798f69,1,4,3,7,1,2013-09-25 15:26:54,2013-09-25 15:26:54
5a664b3ca4cb1114bf5607332f325f5a6f77add2...6ad88561d22c4ee1138ba229aeb5a7fc91284204,1,2,2,4,2,2013-08-20 19:14:54,2013-08-20 19:14:22
5a664b3ca4cb1114bf5607332f325f5a6f77add2...df7d426d2f4b7194e13841213474ee983b999c9a,1,14,6,20,6,2013-08-20 19:13:49,2013-08-20 19:13:49
551946a34e60195c44f293febaa8a0e77f0a23c7...48ce80a60c4d80afa555ce511e98102ff5291a31,1,3,3,6,3,2013-08-26 09:54:57,2013-08-26 09:54:57
48ce80a60c4d80afa555ce511e98102ff5291a31...b5593683af9c8d182c954e04fbde9934404c5058,2,4,1,5,2,2013-08-26 10:06:41,2013-08-26 10:06:41
b5593683af9c8d182c954e04fbde9934404c5058...cc4b638c343d49c205fa510380b65043229e5a9e,4,25,0,25,4,2013-08-26 10:20:45,2013-08-26 10:20:45
c8e3d3192532839b7648301eb0849fd76da4f04b...dc016fef3983a956bb3f98a70b8db6490e949605,1,21,1,22,2,2013-08-26 11:15:21,2013-08-26 11:15:21
dc016fef3983a956bb3f98a70b8db6490e949605...6b206c9d965c664053ff0139736357ea096f4766,1,1,1,2,1,2013-08-26 11:27:19,2013-08-26 11:27:19
6b206c9d965c664053ff0139736357ea096f4766...3cc26654d576ed6a0f6eb33980c41f1b66b5f1eb,7,0,110,110,7,2013-08-26 11:53:36,2013-08-26 11:53:36
3cc26654d576ed6a0f6eb33980c41f1b66b5f1eb...0093554ad6055a0843b0537557e8ca44d6ff2429,2,31,1,32,4,2013-08-26 12:07:07,2013-08-26 12:07:07
0093554ad6055a0843b0537557e8ca44d6ff2429...77a9b1449eab304a117ac50f4e7b725ef9408ac7,1,1,0,1,1,2013-08-26 12:09:33,2013-08-26 12:09:33
668358439e5f4c92c96fc1ae72b0cf06df8dbd90...c69637df9a7397133198853e093fd5cfabf10ae2,1,1,1,2,1,2013-08-22 06:18:50,2013-08-22 06:18:50
668358439e5f4c92c96fc1ae72b0cf06df8dbd90...c7713cafce69f0419af0923665b3365662377b73,1,1,1,2,1,2013-08-21 15:38:59,2013-08-21 15:38:59
26befdc717f4389883755a0bb83d2c94e23bc459...85ec34518318cf40f2a0c5ef60398e0225e691c1,3,4,3,7,4,2013-04-18 09:46:41,2013-04-18 09:46:41
26befdc717f4389883755a0bb83d2c94e23bc459...1a92ae9fcb1e25579f8cd65b6c9683d193a97455,1,1,1,2,1,2013-04-18 04:34:08,2013-04-18 04:34:08
aef944ba7f4b580ae8ab725424c8e923e9a097f8...e78c51f7cf2686e081e7f17f60ef1e9eb4d7bb76,1,1,1,2,2,2013-12-19 17:59:19,2013-12-19 17:59:19
e78c51f7cf2686e081e7f17f60ef1e9eb4d7bb76...d1e8495890ed28d221595e3a60c2df8567b277c1,2,7,2,9,3,2013-12-19 18:11:01,2013-12-19 18:11:01
d1e8495890ed28d221595e3a60c2df8567b277c1...63d5fcc868b0502c7d56a093256a4fcb270a8728,3,19,13,32,5,2013-12-19 18:21:22,2013-12-19 18:21:22
63d5fcc868b0502c7d56a093256a4fcb270a8728...3cdb8f26c9c1580d33557a0f619a90989df23245,2,2,2,4,2,2013-12-19 18:25:01,2013-12-19 18:25:01
3cdb8f26c9c1580d33557a0f619a90989df23245...d1aff25ca4d20c39340936b2fa2976349f028e43,5,45,33,78,14,2013-12-19 19:00:44,2013-12-19 19:00:44
d1aff25ca4d20c39340936b2fa2976349f028e43...9728ae854eaa10c2e6d4bdf1de2bccd86577aa01,1,2,2,4,1,2013-12-19 19:06:59,2013-12-19 19:06:59
9728ae854eaa10c2e6d4bdf1de2bccd86577aa01...e64c3b2b5c1907034a07aa69c0e732afc40170a5,1,6,6,12,6,2013-12-20 06:56:39,2013-12-20 06:56:39
e64c3b2b5c1907034a07aa69c0e732afc40170a5...a84967630097f198601805695845da4f5138ef46,2,2,4,6,2,2013-12-20 08:03:29,2013-12-20 08:03:29
a84967630097f198601805695845da4f5138ef46...68118b5446602640cf41d5413ff5b1e57e787daf,1,1,1,2,1,2013-12-21 21:23:13,2013-12-21 21:23:13
3b0acc9eea5c8e74db9bcb7b46c018ff6ede7e6c...078b3f580e0f2b34d05297a046f8171673790bc9,2,3,3,6,2,2013-12-18 14:27:52,2013-12-18 14:27:52
078b3f580e0f2b34d05297a046f8171673790bc9...5e21976d134a3465e04ba5537bf13af5e9d03717,1,1,1,2,1,2013-12-18 14:33:40,2013-12-18 14:33:40
6d3bb508f5616521f530c535dff5d889d846e617...be3e1ccb9da49b6edc843dcff4170a07598905f7,1,3,3,6,3,2013-12-20 14:02:06,2013-12-20 14:02:06
be3e1ccb9da49b6edc843dcff4170a07598905f7...1dab27ee37df5969c75ff982ee9226475a8ea501,1,77,0,77,1,2013-12-20 14:02:26,2013-12-20 14:02:26
1dab27ee37df5969c75ff982ee9226475a8ea501...0e4a8e231c19dd2258067fe8a04a69cda305d0ff,1,1,1,2,1,2013-12-20 14:03:05,2013-12-20 14:03:05
854977a20123e49d0264fc0f4f968bee44f607df...6b2ee672690dc39197ac6b2eac4416a0fdea8e21,1,1,0,1,1,2013-12-22 10:08:43,2013-12-22 10:08:43
4db2e97bf401dbe7a3fdd928242926c146ab935b...35c4351e2b5165dd9dc31ec625d7bb21821781c3,1,1,1,2,1,2013-12-18 18:58:16,2013-12-18 18:58:16
4db2e97bf401dbe7a3fdd928242926c146ab935b...d27224ceca2b1eb0644f593157e398193bd3e2dc,3,10,0,10,4,2013-12-18 15:52:14,2013-12-18 12:49:09
d27224ceca2b1eb0644f593157e398193bd3e2dc...5e93494db2c3980055dee36412da34dd315713aa,1,4,2,6,1,2013-12-18 16:06:49,2013-12-18 16:06:49
4e878ad902c8026513e69f2ed79b6ed17b63ed24...e3464a54d85062f76439e5a1806fecc37a53cfd8,5,11,16,27,9,2013-12-02 12:27:36,2013-12-02 12:27:36
e3464a54d85062f76439e5a1806fecc37a53cfd8...4f32d2e28ed998e5d3826a26f7c73501d559cf65,1,0,5,5,1,2013-12-02 12:32:54,2013-12-02 12:32:54
4f32d2e28ed998e5d3826a26f7c73501d559cf65...bc663a738353c270bdce5357d4433cda538e817a,1,0,3,3,1,2013-12-02 12:33:27,2013-12-02 12:33:27
4e878ad902c8026513e69f2ed79b6ed17b63ed24...4ab31d834eb9ebe08c11dfc30d87ea1a3c16dd9a,2,2,2,4,2,2013-12-02 10:13:53,2013-12-02 10:13:53
071de30f80ea471c48f52ff1f5d728089b75a8c0...596e64e5d7a51dbd03bceeb3e6e626781ef34134,4,21,9,30,6,2013-11-29 12:46:40,2013-11-29 12:46:40
596e64e5d7a51dbd03bceeb3e6e626781ef34134...da10cad1da7039a346f1f0d32325d8be4c3a1c56,6,29,25,54,11,2013-11-29 13:05:32,2013-11-29 13:05:32
071de30f80ea471c48f52ff1f5d728089b75a8c0...44920811424ae78de6db7b16772d63a648cedfea,3,6,2,8,3,2013-11-29 12:16:17,2013-11-29 12:16:17
071de30f80ea471c48f52ff1f5d728089b75a8c0...81fe86b4279775b3cbed2d64529d671d6fbe49d2,2,13,0,13,3,2013-11-29 11:52:10,2013-11-29 11:52:10
038b3049e8f64a913ea14525bc44c385c3141836...9f4909faadcd3aa9bf85cd2bbf5bdb0c1eecf385,1,36,0,36,2,2013-11-28 14:20:40,2013-11-28 14:20:40
9f4909faadcd3aa9bf85cd2bbf5bdb0c1eecf385...47239aabef2619dba34e2702588bdbc70234c6f4,1,1,0,1,1,2013-11-28 17:12:12,2013-11-28 17:12:12
47239aabef2619dba34e2702588bdbc70234c6f4...376cfc6ac68da97af33dfdc1a17e75ab157f5b59,1,5,3,8,2,2013-11-28 17:12:30,2013-11-28 17:12:30
376cfc6ac68da97af33dfdc1a17e75ab157f5b59...80302a0f6f4fcfe5adf719888f8ad67422a98d4d,2,8,6,14,4,2013-12-03 17:51:21,2013-12-03 17:51:21
68d9538170b03ce3f79093216d86964f6809fe6b...00d72e73c855613b7e07158a8975796dec7cf9ad,1,1,1,2,1,2013-12-06 19:11:14,2013-12-06 19:11:14
12fb44e6e8f9675c9601a7dd2e08972d80544f96...2c15b52aec545dcfd307e9da4f03d42f7382b205,1,1,1,2,1,2013-12-05 08:29:44,2013-12-05 08:29:44
a767c13367c25d2684c94a90ee9f91f02da286a9...3b20c89005686c04966d749239ce312b65bd8f59,3,29,4,33,5,2013-12-05 18:26:21,2013-12-05 18:26:21
9f20580ed7338e72ffeadff86c0d605a2802c957...75eed4eb834919a8cb5a47b8a05335fd2e74f99e,5,132,5,137,9,2014-02-25 12:36:36,2014-02-25 12:36:36
9f20580ed7338e72ffeadff86c0d605a2802c957...0432bdf19eb3483e109582832a36dc7a3601a384,2,16,4,20,7,2014-02-25 10:57:42,2014-02-25 10:57:42
0432bdf19eb3483e109582832a36dc7a3601a384...8016cefafe97d3a143cf21b270c110d357e46273,2,11,1,12,3,2014-02-25 10:58:22,2014-02-25 10:58:22
8016cefafe97d3a143cf21b270c110d357e46273...38f4b61a588ffd515496a04663a2f3fa9178d161,1,2,0,2,1,2014-02-25 10:58:58,2014-02-25 10:58:58
38f4b61a588ffd515496a04663a2f3fa9178d161...36c2c354fc4829827960d202a070f8e7b87c9446,2,2,2,4,2,2014-02-25 11:00:33,2014-02-25 11:00:33
9f20580ed7338e72ffeadff86c0d605a2802c957...4c746c2522aedd8e8bf4d8bf1a8042e3a2b59bf9,2,112,0,112,2,2014-02-25 10:53:01,2014-02-25 10:53:01
9f20580ed7338e72ffeadff86c0d605a2802c957...710cffc6d7f1ca40392c77d603f6dce9ef8b34ac,1,1,0,1,1,2014-02-25 10:07:36,2014-02-25 10:07:36
e8466a21ca880b0ecc2682177d07234f6f3725f6...138e2a50b7d839bd37c21b2849df422f9dfef6bb,1,8,10,18,4,2014-02-20 13:16:33,2014-02-20 13:16:33
40a8ae5e5f03c57a1743b7a8ac097481e930d242...71e7bff1eabd0c277a75910fd2975bfc7b95af2a,1,1,1,2,1,2014-02-24 07:32:24,2014-02-24 07:32:24
40a8ae5e5f03c57a1743b7a8ac097481e930d242...13fbf4889287f20bd6804e47e20d6535043443b6,2,6,6,12,5,2014-02-24 07:31:36,2014-02-24 07:31:36
13fbf4889287f20bd6804e47e20d6535043443b6...71d4474684bb9bf38908e1aea296264b15f9060e,3,330,330,660,3,2014-02-24 07:36:22,2014-02-24 07:36:22
71d4474684bb9bf38908e1aea296264b15f9060e...58634dfb6a5d8218ccf7f1680bac5c201f80ac9a,2,23,20,43,10,2014-02-24 07:43:45,2014-02-24 07:43:45
58634dfb6a5d8218ccf7f1680bac5c201f80ac9a...8290c9a67fe1e200493dfcdbad60b9e092f016eb,2,29,33,62,6,2014-02-24 07:51:50,2014-02-24 07:51:50
8290c9a67fe1e200493dfcdbad60b9e092f016eb...6c8a17d06dc13bb8fa5944710ca148c2ccfe8557,1,21,21,42,21,2014-02-24 10:17:39,2014-02-24 10:17:39
6c8a17d06dc13bb8fa5944710ca148c2ccfe8557...76ad6046f97087e467dff2a5e647df3098c3d520,1,1,1,2,1,2014-02-24 11:50:06,2014-02-24 11:50:06
6f5a9b4110bc5e88b7c7ed9fb6a03d6158ad247d...599ee9670d9757436aee8db5c7c16d44c5ef3f99,1,1,1,2,1,2014-03-13 21:04:36,2014-03-13 21:04:36
aee28088f8eb64f886b65be55ea7a457943aadc5...27c3d529d1ed57b1b23f94e495999c8050a8c3a5,1,2,1,3,2,2014-02-27 14:48:42,2014-02-27 14:48:42
5f31caa0ed88b0d779336d909dc7f48b9f86cd25...2c28dbd2547d77054b0a080af6b0dfec674ad799,3,49,8,57,7,2014-02-25 14:23:23,2014-02-25 13:54:30
bc57ff0ef023db3d07f1adfa6a309fb4a24ed203...9dbd7e5aec921e43f3ea89c8e3357ca0174b0937,13,123,42,165,28,2015-02-07 22:19:17,2015-02-06 23:23:58
bc57ff0ef023db3d07f1adfa6a309fb4a24ed203...db7921f2d8349da8183dc716fdf62b6ab5bc697a,3,17,9,26,9,2015-02-07 22:15:04,2015-02-06 21:42:02
bc57ff0ef023db3d07f1adfa6a309fb4a24ed203...463d9f76e449849be15926a7df0564fbc9a35452,4,50,2,52,8,2015-02-07 19:55:17,2015-02-06 15:21:26
bc57ff0ef023db3d07f1adfa6a309fb4a24ed203...4ed70669ad1aea1ad1636c5091707ccf1fc7f2e7,2,14,0,14,2,2015-02-07 00:54:45,2015-02-07 00:17:23
bc57ff0ef023db3d07f1adfa6a309fb4a24ed203...8d1fa44f2327f88d00bee6d51da96291a73188a1,1,1,1,2,1,2015-02-06 21:55:43,2015-02-06 21:55:43
c8e5dfef671e12f57f61f10c175d4e013d797596...59ebcfe0e041e68fc666c3d6c8de23bb45e6fb41,1,8,0,8,2,2015-02-11 22:50:31,2015-02-11 22:50:31
bd19bce37c9ec0aa3af0e061005d7f146d799708...c93f4662d87058efaec2c2912bd10f8cc5572b3d,2,56,53,109,2,2015-02-09 18:30:06,2015-02-09 18:30:06
c93f4662d87058efaec2c2912bd10f8cc5572b3d...026494029efebd411d597b3cc4c73f59f908012a,1,1,4,5,2,2015-02-09 18:32:56,2015-02-09 18:32:56
026494029efebd411d597b3cc4c73f59f908012a...43890ed1dc0d6b4b3cf29116391f52246b4f6eae,1,5,5,10,6,2015-02-09 18:46:38,2015-02-09 18:46:38
2dfd21983483bd5fd32b327edb4b02228b377c47...6685661b549cdece3b93131af168b5174bc0403f,5,33,6,39,5,2015-02-12 20:05:27,2015-02-11 13:12:43
2dfd21983483bd5fd32b327edb4b02228b377c47...e8335a65e38bab5262be17ce31aaa03bd2af36c1,1,2,2,4,2,2015-02-12 01:02:24,2015-02-11 22:06:20
2dfd21983483bd5fd32b327edb4b02228b377c47...452b3612cf41ef4c64f94416f7c10aa3acf78735,1,1,1,2,1,2015-02-11 21:15:10,2015-02-11 21:15:10
2dfd21983483bd5fd32b327edb4b02228b377c47...29e606deeca83c41d72f880d9574af5983686ab3,3,30,4,34,3,2015-02-11 17:21:57,2015-02-02 23:11:19
29e606deeca83c41d72f880d9574af5983686ab3...55153660647741af22be2278d292de8a54bc0402,3,8,2,10,4,2015-02-11 17:24:40,2015-02-11 17:24:40
55153660647741af22be2278d292de8a54bc0402...09d3d351a1a80032c4e9bf185a15ff95819a4da0,3,9,4,13,5,2015-02-11 17:47:21,2015-02-11 17:47:21
09d3d351a1a80032c4e9bf185a15ff95819a4da0...6b4ddf2cc13eda5dd6df64bab6f95f88d64cd2fa,9,162,15,177,18,2015-02-12 01:55:33,2015-02-12 01:34:41
6b4ddf2cc13eda5dd6df64bab6f95f88d64cd2fa...b3f944a3983db179fdaee0a1f0618c94600be823,23,55,51,106,44,2015-02-12 02:29:24,2015-02-12 02:08:53
b3f944a3983db179fdaee0a1f0618c94600be823...f7e902453511feb9e0d1717755df8723a0a648ea,1,0,1,1,1,2015-02-12 02:36:40,2015-02-12 02:36:40
f7e902453511feb9e0d1717755df8723a0a648ea...9f33898f7aa9c2269aef8aad6cbd9075ab2efd3e,4,26,14,40,9,2015-02-12 17:19:55,2015-02-12 17:19:55
9f33898f7aa9c2269aef8aad6cbd9075ab2efd3e...378520bd8be0a23510c9beea5987e10343194fb5,1,25,0,25,1,2015-02-12 18:53:01,2015-02-12 18:53:01
378520bd8be0a23510c9beea5987e10343194fb5...e8271226b1a474f097909b8006d78dd60bbca7be,1,2,2,4,1,2015-02-12 18:57:08,2015-02-12 18:57:08
2dfd21983483bd5fd32b327edb4b02228b377c47...93bd185efe1d3e981a727df609b8aed521ad0f1c,1,4,2,6,2,2015-02-11 16:49:37,2015-02-11 16:49:37
529188e4788991961796b1b6131389072ee61efb...080449f8af56e1aa0d80c921d0bc6ea4a61f1c38,12,16,15,31,16,2015-02-17 16:58:08,2015-02-13 13:14:27
529188e4788991961796b1b6131389072ee61efb...d9b32f20c6847e45200c38cc4476c3b825434f4f,6,33,1,34,3,2015-02-13 17:27:50,2015-02-13 16:17:08
529188e4788991961796b1b6131389072ee61efb...7474b1b03f3111e1fefa05cbee1432a35bc55c6d,1,3,2,5,3,2015-02-13 17:15:08,2015-02-13 17:15:08
529188e4788991961796b1b6131389072ee61efb...055c2f1e33ffe0bae1b5f1ec6d5fea68ee055bad,2,9,3,12,4,2015-02-13 14:43:02,2015-02-13 14:43:02
529188e4788991961796b1b6131389072ee61efb...4a62a0f01a0058d1d260ddecb0341f48b5b2e26d,1,1,1,2,1,2015-02-13 14:30:54,2015-02-13 14:30:54
529188e4788991961796b1b6131389072ee61efb...da1608196b2c8401939c727ec70efc9c342e4945,3,13,6,19,3,2015-02-13 14:16:00,2015-02-13 14:16:00
da1608196b2c8401939c727ec70efc9c342e4945...7c39e728ef348482bd8caeeeeba2316ace92f4e9,5,19,24,43,6,2015-02-13 14:16:17,2015-02-13 14:16:17
529188e4788991961796b1b6131389072ee61efb...25e44d05300a6b5b35232b27b4ccb27f47f09a67,17,99,46,145,36,2015-02-13 13:44:42,2015-02-13 12:33:28
529188e4788991961796b1b6131389072ee61efb...34cc4c598232d2e27dcc99f5534dbe318e89cff9,12,13,10,23,13,2015-02-13 13:31:51,2015-02-13 13:31:42
529188e4788991961796b1b6131389072ee61efb...25ff20677e898a3977f4e46baed75626a3987029,2,101,0,101,2,2015-02-13 13:05:37,2015-02-13 12:58:54
529188e4788991961796b1b6131389072ee61efb...161d15541a65ba167830f9a9bf5d181d0c5f4d77,3,9,4,13,4,2015-02-13 11:39:11,2015-02-13 11:39:11
529188e4788991961796b1b6131389072ee61efb...07d05d2df7d1b79406232e91a7354e0c7fd1877a,9,64,74,138,26,2015-02-13 11:02:58,2015-02-13 10:57:56
07d05d2df7d1b79406232e91a7354e0c7fd1877a...522efa43fe9ff5828838a5d5ed49db23bfd88c95,5,85,58,143,21,2015-02-13 11:02:58,2015-02-13 11:00:12
522efa43fe9ff5828838a5d5ed49db23bfd88c95...9b917b4a73ddd7607cd19847e89381fda0ec65d5,4,26,10,36,7,2015-02-13 11:02:58,2015-02-13 11:01:28
9b917b4a73ddd7607cd19847e89381fda0ec65d5...ce08f919bfab73178b2f8c584f34fd8849834365,10,57,5,62,18,2015-02-13 11:07:59,2015-02-13 11:02:17
ce08f919bfab73178b2f8c584f34fd8849834365...d702a2525df1b7a9a9fc774e04ceac717b5f2932,1,1,0,1,1,2015-02-13 11:09:11,2015-02-13 11:09:11
d702a2525df1b7a9a9fc774e04ceac717b5f2932...421e882ea422a4a33b64f0c5d466d6b22731199c,3,8,8,16,6,2015-02-13 13:43:31,2015-02-13 12:48:27
421e882ea422a4a33b64f0c5d466d6b22731199c...9efb838be2d4a1b28f1378074af1f44442a7114a,1,2,1,3,2,2015-02-14 12:31:46,2015-02-14 12:31:46
9efb838be2d4a1b28f1378074af1f44442a7114a...67afb5b145dd98ba92f653180d2b7ba470a59e37,1,1,2,3,2,2015-02-14 12:32:05,2015-02-14 12:32:05
75043a9eba557d1fe31d81dc30bd979af321e907...492f3a477940daf425aabc9dd4a33e7a1e9092c1,3,52,1,53,6,2014-12-29 16:07:23,2014-12-29 16:07:23
492f3a477940daf425aabc9dd4a33e7a1e9092c1...f0085d034b33adc78753e2952a5e04842ca979e3,3,24,19,43,3,2014-12-29 16:09:39,2014-12-29 16:09:39
f0085d034b33adc78753e2952a5e04842ca979e3...c1e57b47b81db4b3959b0ce63d7f65cb6cdf6f57,2,42,0,42,2,2014-12-29 17:40:25,2014-12-29 17:40:25
c1e57b47b81db4b3959b0ce63d7f65cb6cdf6f57...82829ed49e11a173275633cad63978e4ee07e927,6,41,29,70,8,2014-12-30 09:15:11,2014-12-30 09:15:11
82829ed49e11a173275633cad63978e4ee07e927...607ea7c6e5663542ae53de66a80f3e8beefe1341,9,47,53,100,11,2014-12-30 10:01:30,2014-12-30 10:01:30
607ea7c6e5663542ae53de66a80f3e8beefe1341...eb29648bf4a9b2ad960a582eba0a51f088afa78f,1,1,3,4,1,2014-12-30 10:47:13,2014-12-30 10:47:13
75043a9eba557d1fe31d81dc30bd979af321e907...6b507219465e50ceff726535f92b75fa9567906d,2,64,5,69,6,2014-12-29 15:36:56,2014-12-19 12:27:27
6b507219465e50ceff726535f92b75fa9567906d...6af34b0f71898f4a93473584a40cdea6e075e92b,1,4,20,24,4,2014-12-29 15:36:56,2014-12-19 18:26:19
6af34b0f71898f4a93473584a40cdea6e075e92b...180fda3d0a911724bdd15a7b2d5aeee444054d10,1,20,20,40,4,2014-12-29 15:36:56,2014-12-22 12:48:00
180fda3d0a911724bdd15a7b2d5aeee444054d10...23e83a6a99d1e79c0d81281b2bde5680bbfe5f3d,1,1,1,2,1,2014-12-29 15:41:50,2014-12-29 15:41:50
75043a9eba557d1fe31d81dc30bd979af321e907...b07802ab684d2126f84f927a21191a79d200788d,1,1,1,2,1,2014-12-29 14:41:10,2014-12-29 14:41:10
b07802ab684d2126f84f927a21191a79d200788d...ed4e682eb809de9103c713a6604a732345e57529,3,11,9,20,4,2014-12-29 15:48:43,2014-12-29 15:48:43
ed4e682eb809de9103c713a6604a732345e57529...2ed9a42edc0c85a1e6957cbe2878229285fa519b,1,1,1,2,1,2014-12-29 15:56:29,2014-12-29 15:56:29
e916f1c295050ef26aef7b309843df6a8cac158e...bf02072a86d4b0d06c246ecbea4f980523983941,2,10,3,13,4,2015-03-07 10:27:39,2015-03-06 11:50:35
e916f1c295050ef26aef7b309843df6a8cac158e...dc558eb24e7432570e1fdbd73c9d67551602c8dc,1,1,1,2,1,2015-03-06 12:49:27,2015-03-06 12:49:27
dc558eb24e7432570e1fdbd73c9d67551602c8dc...be94e135524943236f85a63de08fa8ccc445a0af,3,16,0,16,3,2015-03-06 13:08:40,2015-03-06 13:03:41
e916f1c295050ef26aef7b309843df6a8cac158e...757dca2b78c8b218295c855d6b7529bad05ae24b,3,4,1,5,4,2015-03-06 12:39:57,2015-03-06 12:26:33
e916f1c295050ef26aef7b309843df6a8cac158e...52211ea72a345c32f7bd4389c83d70dfa796f99c,1,2,1,3,1,2015-03-04 20:00:53,2015-03-04 20:00:53
e916f1c295050ef26aef7b309843df6a8cac158e...c842c452838423f82c3e9aecdfecc236b2675002,1,7,0,7,1,2015-03-04 19:24:14,2015-03-04 19:24:14
abc69c890513fb58c1ceae7548f4fbcc221b7c34...2088cee935e47b569f0c79b10dcb2c506b666af3,2,8,12,20,8,2015-03-03 23:57:28,2015-03-03 16:01:27
63178a9509f72eb7adf1c73c2fc6dc1ec0a1ea42...1fec4eff361fed0fecd2928ef83d928fab5e1976,1,1,1,2,1,2015-03-10 16:06:58,2015-03-10 16:06:58
63178a9509f72eb7adf1c73c2fc6dc1ec0a1ea42...94229f24c7507c64786cd511ccf994e4fea83765,2,3,3,6,3,2015-03-04 23:10:31,2015-03-04 23:10:31
63178a9509f72eb7adf1c73c2fc6dc1ec0a1ea42...6ddd45948f35dd6a3e04fbaf95d9f6935b4cbbc1,1,8,2,10,2,2015-03-04 22:31:28,2015-03-04 22:31:28
63178a9509f72eb7adf1c73c2fc6dc1ec0a1ea42...66c61f023b5c0f492cda561d31848da159c1bd00,39,462,414,876,48,2015-03-04 22:14:00,2015-03-04 22:14:00
390e38022539d9fd949fea701791945fea500703...b78c38e9dcb0011b5c9e34535cad965d6b9d7908,1,5,1,6,2,2015-01-19 03:03:50,2015-01-19 03:03:50
b78c38e9dcb0011b5c9e34535cad965d6b9d7908...77adf81e870d2a8ec5faf296cca620dd7e485eb6,1,6,1,7,1,2015-01-19 03:13:41,2015-01-19 03:13:41
77adf81e870d2a8ec5faf296cca620dd7e485eb6...3e17d15661a8c6bae2dc92fe09ed9e75a1f7a1a7,2,8,4,12,2,2015-01-19 03:39:29,2015-01-19 03:39:29
3e17d15661a8c6bae2dc92fe09ed9e75a1f7a1a7...3a46ea4ce666fb0276d71a55f8ee3c5fad76b66d,2,8,0,8,2,2015-01-19 03:39:43,2015-01-19 03:39:43
3a46ea4ce666fb0276d71a55f8ee3c5fad76b66d...fd41e39906544e3e587ccd38491f4fa6cd445a99,2,8,8,16,4,2015-01-19 03:42:09,2015-01-19 03:42:09
fd41e39906544e3e587ccd38491f4fa6cd445a99...31cddc152c96e60a5be366f0ebc944463109e7be,1,2,2,4,1,2015-01-19 03:47:58,2015-01-19 03:47:58
31cddc152c96e60a5be366f0ebc944463109e7be...85c0ce2e1a2f99de2e7155026cd97d5fe9765018,2,10,3,13,5,2015-01-19 03:53:46,2015-01-19 03:53:46
b87c9e289e16260957630089b24baaa1882cdde1...918245094c05d2dfaf566a06e4e4b47cd1e15a27,3,14,16,30,11,2014-12-17 23:00:43,2014-12-17 23:00:43
918245094c05d2dfaf566a06e4e4b47cd1e15a27...7813363fd79d758980d30354aea0d0d21af92612,1,2,2,4,2,2014-12-17 23:02:58,2014-12-17 23:02:58
252e4fd9964dbd681e9ef2dce61822483c7e18db...e8fc5591a2861b5c577b8f27d69912897077349b,1,5,5,10,3,2015-01-03 09:14:05,2015-01-03 09:14:05
5cf2bd4c997d84e9a02d722d6ba870c24b06cc0f...63be16008e28e4bf728cf94550c6dabc8b146aaa,1,1,0,1,1,2014-12-24 13:43:45,2014-12-24 13:43:45
63be16008e28e4bf728cf94550c6dabc8b146aaa...fe104386b16a73cbac1588aa5cce8319c6355ee9,1,4,0,4,1,2014-12-24 14:15:45,2014-12-24 14:15:45
5cf2bd4c997d84e9a02d722d6ba870c24b06cc0f...e41dadcb33fda44ee274daa673bd933e13aa90eb,36,900,3,903,42,2014-12-24 13:38:07,2014-12-19 14:15:29
e41dadcb33fda44ee274daa673bd933e13aa90eb...a61ccd4ad2d83b2422561a374c300260e5a6d240,4,37,57,94,4,2014-12-24 13:44:17,2014-12-24 13:44:17
a61ccd4ad2d83b2422561a374c300260e5a6d240...7fe8d41d88f744b16e6e12c1c07ef3f956994110,3,18,11,29,8,2014-12-25 14:46:28,2014-12-25 14:46:28
7fe8d41d88f744b16e6e12c1c07ef3f956994110...592e396869ba5dc116cec333733cea8dfbf4a9b5,14,114,73,187,20,2014-12-25 16:35:04,2014-12-25 16:35:04
592e396869ba5dc116cec333733cea8dfbf4a9b5...aadfb3665f39e5886254bac856ebd1cc47f8c652,4,27,19,46,6,2014-12-25 16:46:19,2014-12-25 16:46:19
3ae51c3c51ab9112dd698dc38fa4c3e32058a452...5b92ddb80994ff6ab992dcdb39e3a27c687f0dc3,1,1,1,2,1,2014-12-02 06:30:56,2014-12-02 06:30:56
bbf9953b99d59801c72dd7b9550ee149ca77bfcf...7d8dfccf70da047b68f974b7e63610f5c7bf1a43,1,15,9,24,2,2014-12-08 13:15:11,2014-12-08 13:15:11
bbf9953b99d59801c72dd7b9550ee149ca77bfcf...b7d4184f24000fcdee7ca48fd802e35ac03abb67,2,18,8,26,4,2014-12-08 12:51:27,2014-12-08 12:51:27
b7d4184f24000fcdee7ca48fd802e35ac03abb67...f811b695f8c9d7019b5e9f33aae962163e8c0020,2,5,5,10,4,2014-12-08 13:21:17,2014-12-08 13:21:17
bbf9953b99d59801c72dd7b9550ee149ca77bfcf...3dd6244651947c5dd72b7a7dfcbd10e497d592d6,1,1,1,2,1,2014-12-08 11:45:02,2014-12-08 11:45:02
75d2145ec0ac2d1d9112e535d115dd59ea15f841...155b2d46ae19bebeb9b40794fb9b2e3f6e3ab993,1,1,1,2,1,2015-02-18 21:48:57,2015-02-18 21:48:57
75d2145ec0ac2d1d9112e535d115dd59ea15f841...2f0a764d310a8fc6628f560debfa930ef2842297,2,19,9,28,6,2015-02-18 21:28:24,2015-02-18 21:28:24
490ae737c748a393e57040bfd649bb1c4244e494...3a3471cc2e4860307740e7f251898abc70646aae,1,1,1,2,1,2014-12-05 12:40:11,2014-12-05 12:40:11
490ae737c748a393e57040bfd649bb1c4244e494...704b7237e6c4daa3642c01f8803072fdc3a45eaf,2,12,1,13,3,2014-12-04 15:54:08,2014-12-04 15:54:08
704b7237e6c4daa3642c01f8803072fdc3a45eaf...288df41c0a3b950f3474d9ae00c644d4780de321,1,3,5,8,1,2014-12-04 17:14:54,2014-12-04 17:14:54
288df41c0a3b950f3474d9ae00c644d4780de321...3dc25ba331c4f5c4708b0fcd8478d943d182d760,2,2,7,9,2,2014-12-04 20:22:21,2014-12-04 20:22:21
490ae737c748a393e57040bfd649bb1c4244e494...4acf25169336b9d7a20782d5ad954a40db8764e0,1,1,1,2,1,2014-12-04 14:58:08,2014-12-04 14:58:08
490ae737c748a393e57040bfd649bb1c4244e494...cdc62cffcb86dfd939c119cba2acaf266af39f23,4,125,0,125,4,2014-12-04 14:22:10,2014-12-04 14:22:10
490ae737c748a393e57040bfd649bb1c4244e494...db2edff937cbc309c10bb1a987356a58f8a9c8fa,3,8,4,12,4,2014-12-04 13:07:01,2014-12-04 13:07:01
31323205bcc3ed663e7a1c5be4c5e5bd5b9ec5a6...e3ecdb4810c94d8f3d4f899923dcfe12ddb2be56,1,2,2,4,1,2015-02-12 02:41:47,2015-02-12 02:41:47
e3ecdb4810c94d8f3d4f899923dcfe12ddb2be56...783ecc9a2fe8fa18c0fc7692ec6a56e8ea06838a,1,2,0,2,1,2015-02-12 02:59:38,2015-02-12 02:59:38
3d2c81856c842521af103e5f1d72aafa8329bf9b...17bb700712f28c58564b0a2b1a2fcf375346d279,1,24,23,47,2,2014-04-04 17:12:23,2014-04-04 17:12:23
207f34b890b58c09281850a37477948ec75e0ef4...53504928427ad6ffcc451bff9da86d9fbad580b8,1,1,2,3,2,2014-04-03 12:03:45,2014-04-03 12:03:45
53504928427ad6ffcc451bff9da86d9fbad580b8...8cc5e85543b0a553536ebe70f01fa29e0b0f60bd,2,2,0,2,2,2014-04-03 14:06:11,2014-04-03 14:06:11
e36108f75ba1c7f00886092197500ffc2fa618cc...f64ccc3f5be1f64155ecd3da18a1b549ec66c7c9,1,1,1,2,1,2014-04-08 02:59:13,2014-04-08 02:59:13
d92e4830f78018b3a38bc448aaec4a045f4d3d62...be6cee2354140a889781c824caa151dc60a24a6d,1,1,0,1,1,2014-04-07 16:24:08,2014-04-07 16:24:08
6be82c5e3b65bccc5b951628de34ebe94e06fdec...6b068dccbb441127fd33319f6c56c43e59026182,1,5,50,55,5,2014-04-14 21:49:16,2014-04-14 21:49:16
6be82c5e3b65bccc5b951628de34ebe94e06fdec...d2b4948a1fe606457d2d0e42d9e06f5a4cc1fd91,1,2,2,4,2,2014-04-14 21:36:12,2014-04-14 21:36:12
7fab63b41f1a28cc5efa6b9afef30170e41c94ea...77e565d347b2b7b56769977dacc4eb1d4a741ed3,1,1,1,2,1,2014-04-23 09:13:21,2014-04-23 09:13:21
7fab63b41f1a28cc5efa6b9afef30170e41c94ea...43e77099d86960401013a45f56e29bfb83368d2c,4,14,9,23,5,2014-04-23 09:07:36,2014-04-15 14:26:15
43e77099d86960401013a45f56e29bfb83368d2c...cd61239540c00279563cc0e4ae763a569be0bef5,2,2,9,11,2,2014-04-23 09:08:51,2014-04-16 09:26:02
cd61239540c00279563cc0e4ae763a569be0bef5...acebfdc7b12a849bef055fa53d0f278318bdad72,1,4,2,6,2,2014-04-23 09:09:38,2014-04-23 09:09:38
e7087fbfc4146d52fdac8a73e6c3157c3aa57cfa...76ca5976de41722c2cdaa0aa1d31c3c2c7bbbb9f,2,0,0,0,0,2014-04-08 10:28:59,2014-04-08 10:28:59
e7087fbfc4146d52fdac8a73e6c3157c3aa57cfa...4df1a10e906d308089343ea400f5c510a9f0e90c,2,4,0,4,1,2014-04-08 09:17:19,2014-04-08 09:17:19
e7087fbfc4146d52fdac8a73e6c3157c3aa57cfa...16567af9f56d8e4131a61563e67e3136ffaecf8c,1,1,1,2,1,2014-04-08 09:11:14,2014-04-08 09:11:14
e7f80806666aef65dae9293dbda34f994299f7b2...ac906b427ade64e19e34951c49c0be3143252abd,1,14,15,29,5,2014-04-07 13:08:46,2014-04-07 13:08:46
ac906b427ade64e19e34951c49c0be3143252abd...43ecf68af00c18cfddbe155eea49427d896910b2,1,1,1,2,1,2014-04-07 13:11:57,2014-04-07 13:11:57
e7f80806666aef65dae9293dbda34f994299f7b2...5b018cc5b11d5ac66d7a3c3c77e2157b4f68e760,2,2,2,4,2,2014-04-07 12:52:35,2014-04-07 12:52:35
11d3a00c28677e3b20582535247945f3d7670fad...8a56e7db485d3109f3b2f02896c1165c33ffa8fb,1,1,1,2,1,2014-04-07 14:48:51,2014-04-01 16:08:25
11d3a00c28677e3b20582535247945f3d7670fad...459e62959107ff407693d62e6dceae8eb26dc0b6,1,1,1,2,1,2014-04-07 14:45:52,2014-04-01 15:49:16
11d3a00c28677e3b20582535247945f3d7670fad...6d196962670b35ea48588aad3cfdb6f2d11febab,2,11,1,12,2,2014-04-07 14:03:49,2014-04-07 14:03:49
6d196962670b35ea48588aad3cfdb6f2d11febab...52cf11b9f2f22218abd79aa3936ddb7f0d6cee59,1,2,2,4,2,2014-04-07 14:26:52,2014-04-07 14:26:52
11d3a00c28677e3b20582535247945f3d7670fad...c06255e1508417d68a0ebc43192f77136cd40af4,1,2,2,4,2,2014-04-07 12:17:32,2014-04-07 12:17:32
9b52affe31f2496fb10ae1d90b21f42ed173b7dc...e365cd84526bb84732ffdfc86060019f5c184030,1,7,6,13,1,2014-04-21 10:19:46,2014-04-16 14:36:45
9b52affe31f2496fb10ae1d90b21f42ed173b7dc...00b576e67dee85547feed3ec7679496c085bd8df,1,2,2,4,2,2014-04-17 07:42:08,2014-04-17 07:42:08
00b576e67dee85547feed3ec7679496c085bd8df...e6b668ab0169f981a5c4162cd8625daf02e6f5a8,1,1,1,2,1,2014-04-17 07:42:33,2014-04-17 07:42:33
e6b668ab0169f981a5c4162cd8625daf02e6f5a8...c2ad30638a7c9fa307fe1f3a6653a8010fde1f64,1,129,0,129,1,2014-04-17 08:15:50,2014-04-17 08:15:50
c2ad30638a7c9fa307fe1f3a6653a8010fde1f64...f931195d341f8bf8baa80e33c019fcb10045af97,1,2,2,4,2,2014-04-17 08:47:35,2014-04-17 08:47:35
9b52affe31f2496fb10ae1d90b21f42ed173b7dc...5ef7fdbd54ef41de01b64b4df58529d4bf3c62a3,1,1,1,2,1,2014-04-17 02:42:05,2014-04-17 02:36:43
9b52affe31f2496fb10ae1d90b21f42ed173b7dc...07a9d44de7a54b2cd1bffd9fcc830f7b2a03b549,7,38,5,43,8,2014-04-16 19:55:36,2014-02-22 19:27:23
9b52affe31f2496fb10ae1d90b21f42ed173b7dc...7f13afdc0aa67de5da7c5ba9bb73dcd786ca284b,1,1,1,2,1,2014-04-16 18:08:59,2014-04-16 18:07:26
c7dc20c1202d6cd9d7593de76718e16c4d601980...e52f50c22fa0ca855ad75208b511bf27967e92ab,1,1,1,2,1,2014-04-29 15:21:58,2014-04-29 09:54:09
e52f50c22fa0ca855ad75208b511bf27967e92ab...0b914e7ceb28c67a50d19c7fac10a95b3ea4a1fa,1,10,0,10,3,2014-04-29 15:21:58,2014-04-29 15:06:56
0b914e7ceb28c67a50d19c7fac10a95b3ea4a1fa...c8cf90d28655b49d10e6d7b9b82ce3cda41089a9,1,1,0,1,1,2014-04-29 15:23:29,2014-04-29 15:23:29
c7dc20c1202d6cd9d7593de76718e16c4d601980...513dbdbff31bd81243ccf349e3932aa02f29f05f,1,1,1,2,1,2014-04-29 09:49:42,2014-04-29 09:49:42
983bf359945bc9d4ec1e9581e6bc35dac65e3a3b...b76948e6c92ce445249116ef86dbbd4d0b57573a,7,206,0,206,8,2013-11-23 20:04:50,2013-11-20 22:59:50
983bf359945bc9d4ec1e9581e6bc35dac65e3a3b...1d4b7d2167855fd342eafca8194c880039a8187a,1,2,1,3,1,2013-11-22 13:58:27,2013-11-22 13:58:27
4a1dc7326479d8fe54f888f5622c0d2a56bca8ad...fcfc77f5b7ef5d91a82f06e81182e01a8fbb4fdf,1,3,1,4,2,2013-11-24 05:09:55,2013-11-24 05:09:55
02484930e161f773a205bb1c1d29a8664755fd60...57ad81a9c55352d39a88a5c878cc81f59f5328fa,10,29,29,58,29,2013-11-08 16:20:15,2013-11-08 15:04:36
02484930e161f773a205bb1c1d29a8664755fd60...979ca7d6a288129253e3a187fb1058c707175681,2,8,5,13,3,2013-11-08 15:34:15,2013-11-08 15:34:15
979ca7d6a288129253e3a187fb1058c707175681...e130e2f6c71c61e1c22c379cf05b86a6fe25ee32,1,9,5,14,2,2013-11-08 16:20:13,2013-11-08 16:20:13
02484930e161f773a205bb1c1d29a8664755fd60...a360ce73b2a934d8fb0d7b4c463c0f102f5a2d57,1,1,1,2,1,2013-11-08 13:51:29,2013-11-08 13:51:29
a184fcf368686f8224315c8afa6e5ec923e37c4b...fd9a8c36010e6fe9377f75eff044d7551761c2b6,3,8,4,12,2,2014-01-28 08:51:18,2014-01-28 08:51:18
8695ab28e6e4a945fe3d8368e69884ec2b5b4ea3...5e2ccc671b8ee1c4b70c504b5b964a8bac259cda,1,15,0,15,1,2014-01-27 17:55:36,2014-01-27 17:54:28
f87855ae3a41c287a0b183c3a19efa82f1dd166e...7b32be6eb127e6fd911f7895ed7d396529030474,1,14,0,14,1,2014-01-27 10:19:45,2014-01-27 10:19:45
7b32be6eb127e6fd911f7895ed7d396529030474...abae12891553e16d31e172bfc63bb4672139d353,1,2,2,4,1,2014-01-27 10:59:15,2014-01-27 10:59:15
445f31c64261eb9c9ca85e59fcb9f8fde171cd9e...38fc5dc2a8713dd6a546757064d2f6108089195f,2,3,3,6,3,2013-12-11 16:17:08,2013-12-11 16:17:08
c959143ed75b7a97d23d2198f4a34eb2a1455b21...9b7b27ce7216652493648228f2352d1d08836549,3,3,3,6,3,2013-12-12 17:05:21,2013-12-12 17:05:21
01b98970cd85bf8d906db1c50dd4667a5a1552f6...bb0f723741e7db85b3427cc757b8969a5be8b97e,1,1,1,2,1,2014-01-20 13:41:18,2014-01-20 13:41:18
01b98970cd85bf8d906db1c50dd4667a5a1552f6...a0e3893d1bf5166b2ca672baedb6aea54a47b227,1,1,1,2,1,2014-01-20 12:23:06,2014-01-20 12:23:06
01b98970cd85bf8d906db1c50dd4667a5a1552f6...3f6c64c81a8756a0e033e30f1d4268e9f5d0e1ec,1,1,1,2,1,2014-01-20 12:06:32,2014-01-20 12:06:32
01b98970cd85bf8d906db1c50dd4667a5a1552f6...74187621ea0297103bd00d1e98c7e01692f64271,2,4,4,8,4,2014-01-20 12:00:50,2014-01-20 12:00:50
74187621ea0297103bd00d1e98c7e01692f64271...e583df544308ff321ce92c79612ff950a4093e79,2,2,4,6,3,2014-01-20 12:16:12,2014-01-20 12:16:12
afd2999373fe1a6bdc611ab4a14e3e81d2f7350d...2f4d0a3008d550f19a1dd3b354853a7295994308,1,1,1,2,1,2014-01-21 10:05:03,2014-01-21 10:05:03
a10c08c4c75ea2753b092e66b1daed7ffe23a0b6...0f8c36b8d7e73c78c87422763d4afceeea244689,1,3,2,5,1,2014-01-09 08:30:01,2014-01-09 08:30:01
71f1a84599101b2af2f74ae54ebfb2f880935985...02d9fa2974b54bc868e0a3347187a474c1ff6045,1,8,0,8,1,2014-01-15 18:01:04,2014-01-14 16:47:12
71f1a84599101b2af2f74ae54ebfb2f880935985...2e79f83071d5d56fc6af3e1bd2b0357c5ad15f12,1,1,2,3,1,2014-01-14 18:23:56,2014-01-14 18:23:56
2e79f83071d5d56fc6af3e1bd2b0357c5ad15f12...688af57da0afe45df9169ab8a9cbec609627f2b7,1,1,1,2,1,2014-01-14 18:27:19,2014-01-14 18:27:19
688af57da0afe45df9169ab8a9cbec609627f2b7...0c637acb697d0df8f766b978c6c3beadd46348b0,1,1,1,2,1,2014-01-14 18:28:41,2014-01-14 18:28:41
71f1a84599101b2af2f74ae54ebfb2f880935985...fe3f7f536d9eb97df08310afaa09621d7f64baa1,1,0,2,2,1,2014-01-14 18:05:12,2014-01-14 18:05:12
71f1a84599101b2af2f74ae54ebfb2f880935985...414ead57ee294618e73ef62f521b11d98fdce3a0,1,1,1,2,1,2014-01-14 17:57:29,2014-01-14 17:57:29
71f1a84599101b2af2f74ae54ebfb2f880935985...cc1f7ea2de68ba7d2f45a65e36549c63fb23508f,1,2,2,4,2,2014-01-14 17:26:01,2014-01-14 17:26:01
71f1a84599101b2af2f74ae54ebfb2f880935985...556ae5ae8187b89a3785219d5621e7ebc9bb7a8c,2,4,4,8,2,2014-01-14 15:06:53,2014-01-14 15:06:53
5a52c9b0a69936d612be84704d7616bf8306c2af...8b513fbc50e2e35be0c5fda35a980b064a3c7523,9,78,70,148,13,2014-01-14 11:51:59,2014-01-14 11:51:59
1fc42d9934fbf511db2a28e980b298c019a217a7...7d3363954e0e02b61bd5acefde5f561b0b865f21,1,2,1,3,1,2014-01-15 17:52:52,2014-01-15 17:49:39
1fc42d9934fbf511db2a28e980b298c019a217a7...5ae0d61d0a457ebaeed78f6acd01447b5760e75a,1,2,1,3,2,2014-01-15 14:29:22,2014-01-15 14:16:19
1fc42d9934fbf511db2a28e980b298c019a217a7...5e96ee341c0b0ed933e1e939ca3302965a44913b,1,119,0,119,1,2014-01-15 14:16:23,2014-01-15 14:16:23
5e96ee341c0b0ed933e1e939ca3302965a44913b...6153aa136007daa4b5c592190b72de389de8b032,4,32,21,53,16,2014-01-15 14:16:45,2014-01-15 14:16:45
6153aa136007daa4b5c592190b72de389de8b032...4a5e4b18f5470eedc0fb8af9a135edc609d167f6,1,65,0,65,1,2014-01-15 14:32:07,2014-01-15 14:32:07
4a5e4b18f5470eedc0fb8af9a135edc609d167f6...234b86c97fa576d406201a032d2cb72e60ee21b7,3,17,8,25,4,2014-01-15 14:32:44,2014-01-15 14:32:44
234b86c97fa576d406201a032d2cb72e60ee21b7...46997c6a89c6115c64f6e0c8836bb3b598fcd433,4,0,200,200,4,2014-01-15 14:32:56,2014-01-15 14:32:56
46997c6a89c6115c64f6e0c8836bb3b598fcd433...a77dfc464b033038537da1a4710b39df37a2cc06,1,0,73,73,1,2014-01-15 18:55:23,2014-01-15 18:55:23
a77dfc464b033038537da1a4710b39df37a2cc06...974281d140a37d8c480bcf871b9498c50d42769b,1,5,1,6,1,2014-01-16 09:40:33,2014-01-16 09:40:33
4e96b1759cbfd62a015e2f1aaf79d2f6759df185...708ae96dd757c1e8b8f30729232f6757031607c8,1,2,2,4,2,2014-01-16 07:39:49,2014-01-16 07:39:49
3fe578a7fdaea8607cf98ffb1878c03fd5ac3649...a3f645ef51ec12ce93934b4ddb11313613d8c451,71,145,147,292,140,2014-01-19 19:39:56,2014-01-19 18:55:59
3fe578a7fdaea8607cf98ffb1878c03fd5ac3649...d435fbb9b223c035e9d32e5746a4f9bc092e5dce,1,1,1,2,1,2014-01-17 10:39:33,2014-01-17 10:39:33
4d7792bc388d72a8ce6c2f84e102ba68a28dae81...427520ac537b1d34cc53eb0e8090f68600a21321,1,1,1,2,1,2014-01-18 18:11:42,2014-01-18 18:11:42
4d7792bc388d72a8ce6c2f84e102ba68a28dae81...073a269831d5bf6d9b9c55d91826d87721746bc9,7,65,22,87,16,2014-01-18 12:16:46,2014-01-18 12:16:46
073a269831d5bf6d9b9c55d91826d87721746bc9...ffbbccb7ea3e3c667b4cfdeaeeedfbef0a5f190a,1,8,19,27,7,2014-01-18 13:02:53,2014-01-18 13:02:53
ffbbccb7ea3e3c667b4cfdeaeeedfbef0a5f190a...757e92d52eadd0fea43a4998e89f309f196c4396,1,5,5,10,5,2014-01-18 14:06:20,2014-01-18 14:06:20
757e92d52eadd0fea43a4998e89f309f196c4396...712a2ec4fd7f2d6fb27bdb029ddac7e357558f63,1,1,1,2,1,2014-01-18 14:22:57,2014-01-18 14:22:57
712a2ec4fd7f2d6fb27bdb029ddac7e357558f63...1016b547f51ade65fa67684d787b53a440a1e000,1,1,0,1,1,2014-01-18 14:26:39,2014-01-18 14:26:39
4d7792bc388d72a8ce6c2f84e102ba68a28dae81...a757c4a24f110aa25ad36dd347d499cf859e4d0d,1,1,1,2,1,2014-01-18 10:35:03,2014-01-18 10:35:03
1018cbdc803d56e6cae385aee97aa04752d3e3fb...96ed6c456981f0e71c8629ab6cc464f896b2ca3b,1,6,6,12,4,2014-01-22 15:00:50,2014-01-22 15:00:50
1018cbdc803d56e6cae385aee97aa04752d3e3fb...16ba8fa077145f99dff98501770ed80d0a58fd58,1,25,6,31,5,2014-01-22 14:07:29,2014-01-22 14:07:29
16ba8fa077145f99dff98501770ed80d0a58fd58...462161a3b07369d0df68b0298929b3f89cf46c03,1,18,0,18,1,2014-01-23 09:43:04,2014-01-23 09:43:04
462161a3b07369d0df68b0298929b3f89cf46c03...c6b9767e74421bae7f0532ce7fab8753863e94f0,3,34,0,34,3,2014-01-23 10:08:57,2014-01-23 10:08:57
c6b9767e74421bae7f0532ce7fab8753863e94f0...3bcfdf07cd81408105cb912ceb64532688e1e9cd,2,4,4,8,3,2014-01-23 12:06:44,2014-01-23 12:06:44
3bcfdf07cd81408105cb912ceb64532688e1e9cd...d819d0d1f84946bcc0d2c871682c220db6dbd478,3,3,3,6,3,2014-01-23 15:00:39,2014-01-23 12:47:54
1018cbdc803d56e6cae385aee97aa04752d3e3fb...c983e8eb3d9cac01090b8657735544f71f891576,3,67,39,106,23,2014-01-22 12:22:47,2014-01-22 12:22:47
c983e8eb3d9cac01090b8657735544f71f891576...de724a7a34a501234000a539e9ba6ce16857ad5d,3,21,10,31,8,2014-01-22 13:17:41,2014-01-22 13:17:41
de724a7a34a501234000a539e9ba6ce16857ad5d...d9be420ee603fef634107c576b41715de18b5385,1,160,0,160,1,2014-01-22 13:19:02,2014-01-22 13:19:02
d9be420ee603fef634107c576b41715de18b5385...79bfbe5918b414cc44fbb506f0b350c04f49c1e9,2,6,114,120,14,2014-01-22 13:20:20,2014-01-22 13:20:20
79bfbe5918b414cc44fbb506f0b350c04f49c1e9...193a5ed3c3c352f043752c8ed3b0f3d1cb8c0ddc,2,5,4,9,4,2014-01-22 13:20:40,2014-01-22 13:20:40
193a5ed3c3c352f043752c8ed3b0f3d1cb8c0ddc...39a86963e93b4a24296ffe96e63c5a189f8d1d07,1,4,1,5,1,2014-01-22 13:30:14,2014-01-22 13:30:14
39a86963e93b4a24296ffe96e63c5a189f8d1d07...51ea42e2386f109e3fb4f3619dd33eb9a5398080,4,18,19,37,4,2014-01-22 13:54:53,2014-01-22 13:54:53
614e0857d66f5635eead6270e70d6c7d337a1ff1...f4398835f4e9ce380c52142b7a407b3ec922905f,1,9,1,10,1,2014-06-24 08:29:50,2014-06-24 08:29:50
f4398835f4e9ce380c52142b7a407b3ec922905f...0c90697e0033e74b54a522421d752eb3757f5547,1,1,1,2,1,2014-06-24 09:00:42,2014-06-24 09:00:42
ebf11981e07d334ffe902fd04ec418e602789bd9...6636c161fee6afd4c700ecbf2771b40eea268d61,1,13,5,18,5,2013-08-09 12:56:15,2013-08-09 12:46:25
ebf11981e07d334ffe902fd04ec418e602789bd9...3f283904b08fa7f6abef7bb0013c152f1792c89a,2,4,4,8,3,2013-08-09 12:25:22,2013-08-09 12:25:22
3f283904b08fa7f6abef7bb0013c152f1792c89a...d6d0a1721c0adf798157905555b56b2a4a389eda,1,1,1,2,1,2013-08-09 12:46:09,2013-08-09 12:46:09
b19bffc536c85262e85f81237c544e18040742c6...e6affad928cfcc8f5c8b031bf791b65377eeb25f,1,1,1,2,1,2013-07-31 17:45:25,2013-07-31 17:45:25
e6affad928cfcc8f5c8b031bf791b65377eeb25f...f90c5655447233cf2228223b7625c78f6e3bdb62,7,11,21,32,17,2013-08-01 11:55:30,2013-08-01 11:55:30
f90c5655447233cf2228223b7625c78f6e3bdb62...08bcf639a015628f5ddfc34236bc6b84a977957f,4,3,18,21,6,2013-08-01 12:21:43,2013-08-01 12:21:43
08bcf639a015628f5ddfc34236bc6b84a977957f...ce5fca48288043bf1e7077826a9b36a16b3eb5c7,6,11,11,22,7,2013-08-01 12:59:57,2013-08-01 12:59:57
ce5fca48288043bf1e7077826a9b36a16b3eb5c7...3e9460b6cb8184aada5932abeeafa6be53459a69,2,4,4,8,4,2013-08-01 13:11:50,2013-08-01 13:11:50
3e9460b6cb8184aada5932abeeafa6be53459a69...0be062152a780950d699676c7cf7e6b7154d7db9,1,8,8,16,3,2013-08-01 13:20:18,2013-08-01 13:20:18
b19bffc536c85262e85f81237c544e18040742c6...fb8a3e319a59cedd19191a169cfae08b2923ecbe,1,10,6,16,1,2013-07-31 16:31:34,2013-07-31 16:31:34
b6adabb45da1413db2c9c6585ff69fa4e40d05fe...a59330998e1debe8ed7e8e60d0c24f1de9ba3b9a,2,3,3,6,2,2013-09-25 18:33:35,2013-09-25 18:33:35
a59330998e1debe8ed7e8e60d0c24f1de9ba3b9a...8674e1c22704e89ea030c9e38c296cae735610ee,2,8,5,13,4,2013-09-26 07:02:18,2013-09-26 07:02:18
86d92bdae7c87ec2c00b19052ef4799e42a12573...45c39250209aa4bcfc41c82445cf4ae68a45b880,1,6,0,6,1,2013-08-26 10:50:13,2013-08-26 10:50:13
77a9b1449eab304a117ac50f4e7b725ef9408ac7...3d8f38c683283f1e9eb5c1243b0ea9cc2ca5f6b1,2,3,3,6,3,2013-08-26 12:54:07,2013-08-26 12:54:07
77a9b1449eab304a117ac50f4e7b725ef9408ac7...4675ff46e8b1d354d86cdf80ac3bd4f60814dbe3,1,4,0,4,1,2013-08-26 12:49:11,2013-08-26 12:49:11
4675ff46e8b1d354d86cdf80ac3bd4f60814dbe3...17af835387c996f82b46f3bade67d513b4e40cc5,12,54,42,96,15,2013-08-26 13:30:03,2013-08-26 13:30:03
79b76d2cb65fc0411b65cbd8d6614401fd60473e...d2aa48c0d5e49309b14baa5f2f792af945e74bb3,2,4,0,4,2,2013-08-22 11:49:57,2013-08-22 11:49:57
d2aa48c0d5e49309b14baa5f2f792af945e74bb3...0fcd89e3ac810bb137240edf86fac5b80d52faed,3,13,13,26,13,2013-08-22 12:40:48,2013-08-22 12:40:48
0fcd89e3ac810bb137240edf86fac5b80d52faed...9a00bbda89ab22f533db725e751ad46ff68c2cbe,1,4,1,5,1,2013-08-22 12:45:36,2013-08-22 12:45:36
79b76d2cb65fc0411b65cbd8d6614401fd60473e...b3e07ec334b8c80c8e745722db4bf620bf2e8e9f,1,1,1,2,1,2013-08-22 11:17:58,2013-08-22 11:17:58
59b57eecf5de30ed2c632da104bca0fc0f52bf36...0a53e47bae31d3f7d84acc3dd7ec2c19f5d0460a,1,21,10,31,5,2013-08-09 13:17:52,2013-08-09 13:17:52
f23ffeece741caaf5e50002c4dca23a914480331...487f7551df7501740f1f484bc3212561ac61cb23,1,3,0,3,1,2013-12-21 22:05:44,2013-12-21 22:05:44
5e21976d134a3465e04ba5537bf13af5e9d03717...e1fa9abd897339deedc265435facccadd11707a0,2,16,10,26,9,2013-12-18 14:46:06,2013-12-17 19:35:51
0e4a8e231c19dd2258067fe8a04a69cda305d0ff...ae3cb2d6ce72f1592886ae9085b4ae14449837b2,1,6,6,12,1,2013-12-20 17:31:45,2013-12-20 17:31:45
0e4a8e231c19dd2258067fe8a04a69cda305d0ff...756258ab1dcbae59425711b78efb57e48316ded0,1,6,4,10,2,2013-12-20 16:30:34,2013-12-20 16:30:34
25d793eac5a85c83985a59f1e80be59cb4882457...cc0d550f4792b355f3bf0abe5bea67a99b26f596,1,28,0,28,1,2013-12-23 12:15:22,2013-12-23 12:15:22
25d793eac5a85c83985a59f1e80be59cb4882457...b8b8a34b524fc38c194973d298ca24a0769c27a6,3,18,4,22,6,2013-12-23 11:19:13,2013-12-23 11:19:13
25d793eac5a85c83985a59f1e80be59cb4882457...0eb7d64824ae19290dc898ba6bbf241217cba95f,1,3,3,6,2,2013-12-22 19:14:17,2013-12-22 19:14:17
566b49624a230728a3a873ee1937f4b8d30ff8f5...0760ba3efb7566b9f56bb066f4b15ba8ea34e1e7,14,106,3,109,17,2013-12-18 22:43:45,2013-12-09 05:34:51
8fb9dccd3b6df116c5b449e21a3e24b1114e9bf6...8c670b66f00966b10c5ddfa02dae71a1e36e8be3,1,5,0,5,1,2013-12-19 15:15:48,2013-12-19 15:15:48
8fb9dccd3b6df116c5b449e21a3e24b1114e9bf6...f8114954292e3551b61406438d41cd05a6f9ae31,5,47,6,53,7,2013-12-19 13:02:54,2013-11-27 08:17:29
7ecd1249d5839cc511768a197c4c697ab7955cf4...3a2c32c054efce240f5ccb946dbe2c7831d201cf,1,1,1,2,1,2013-12-02 13:22:38,2013-12-02 13:22:38
3a2c32c054efce240f5ccb946dbe2c7831d201cf...e411f3bab2c20ba22b838bb025fa33e980470d20,2,3,3,6,2,2013-12-02 15:24:03,2013-12-02 15:24:03
477e9f87e14a8b7a04355453283d49e4e14fcafb...5499d2163f639d07d043e21236b9088471436cb6,2,3,3,6,3,2013-11-30 11:31:26,2013-11-30 11:31:26
477e9f87e14a8b7a04355453283d49e4e14fcafb...b6e3f391e74bfcd382e29a358271d3692587c1ce,1,1,0,1,1,2013-11-29 20:43:40,2013-11-29 20:43:40
477e9f87e14a8b7a04355453283d49e4e14fcafb...23e36202d263fb8e665f271c55d949ff38b9ae28,1,6,32,38,1,2013-11-29 19:51:33,2013-11-29 19:38:23
477e9f87e14a8b7a04355453283d49e4e14fcafb...72e2fe2c8a48fae4ec72d9d25b1742187afa0c92,2,4,4,8,4,2013-11-29 15:46:38,2013-11-29 15:46:38
a4a27a5a2bdb44ad831a3b64c598be8d1062f653...97e05469e284a18f6663e0b65d8f98ff8d46c1c6,2,5,4,9,4,2013-12-06 20:14:55,2013-12-06 20:14:55
97e05469e284a18f6663e0b65d8f98ff8d46c1c6...1dfd585f3ee25d80861e105827d8ecc6e004f27a,1,5,0,5,1,2013-12-06 20:20:11,2013-12-06 20:20:11
41d67d14214379d19a5fc2abfc4db2d73221b23a...f6d96d354c9413ddb1a82c51a379653e18515297,2,9,7,16,4,2013-12-05 09:26:55,2013-12-05 09:26:55
f6d96d354c9413ddb1a82c51a379653e18515297...e5f4c7883fc6373da2681cac4bd0ea614566a4bc,1,1,3,4,3,2013-12-05 09:55:07,2013-12-05 09:55:07
a2efc277cf7ba0f461f73b93ce4f1e80a8c45a97...d277bf4bf9ad9c0131557b63eadf6a178ac4535d,1,1,1,2,1,2013-12-06 08:17:19,2013-12-06 08:17:19
d277bf4bf9ad9c0131557b63eadf6a178ac4535d...bdc745b2915e0f23865557b4575249afc3e7d235,1,9,5,14,6,2013-12-06 10:21:33,2013-12-06 10:21:33
6304428467319d5598ec4773aeab39ccecf089cb...f7ca46b5a3bf4e74f432de8a4adfd2ebbb2e3bc5,4,2,22,24,6,2014-02-25 15:14:03,2014-02-25 15:14:03
f7ca46b5a3bf4e74f432de8a4adfd2ebbb2e3bc5...2171bbcd6effb4b0de873ee502050fa543198ded,2,1,2,3,2,2014-02-25 15:41:56,2014-02-25 15:41:56
2171bbcd6effb4b0de873ee502050fa543198ded...a1b9b1d83fc1e81ab6ff9d6593c8a95697e7474a,2,4,2,6,4,2014-02-25 15:42:22,2014-02-25 15:42:22
a1b9b1d83fc1e81ab6ff9d6593c8a95697e7474a...8eeebf0de601f3a05e3fe4d273ead7aaf3257a2c,2,7,1,8,2,2014-02-25 15:47:29,2014-02-25 15:47:29
8eeebf0de601f3a05e3fe4d273ead7aaf3257a2c...ffce379a67624d832ec6aec238f8f7d23c6aefcd,1,1,1,2,1,2014-02-25 15:49:20,2014-02-25 15:49:20
ffce379a67624d832ec6aec238f8f7d23c6aefcd...0f473674920dfc6759ddf131b32eb0b4b06256d0,2,2,2,4,2,2014-02-25 16:15:11,2014-02-25 16:15:11
138e2a50b7d839bd37c21b2849df422f9dfef6bb...2d554f42f07a9bebcb6d43ace2cdeedcc54e8de9,7,154,4,158,10,2014-02-22 20:21:12,2014-01-09 16:50:27
138e2a50b7d839bd37c21b2849df422f9dfef6bb...bbd92f554d22911afca9fca67077c73e8826bf23,1,1,0,1,1,2014-02-21 14:32:42,2014-02-21 14:32:42
138e2a50b7d839bd37c21b2849df422f9dfef6bb...544ce2d06ac1b458252ee8c330fb43522b9184f6,1,5,5,10,3,2014-02-21 10:32:06,2014-02-21 10:32:06
138e2a50b7d839bd37c21b2849df422f9dfef6bb...f8807281ee591ac00462c1f60de0a01392b906e4,1,1,1,2,1,2014-02-21 06:46:27,2014-02-21 06:46:27
138e2a50b7d839bd37c21b2849df422f9dfef6bb...2f69213e3f32e2e4222f6335e790e2c778069014,28,633,88,721,52,2014-02-20 15:26:38,2014-02-13 20:45:51
138e2a50b7d839bd37c21b2849df422f9dfef6bb...e39f0de8ee73ded91aebed696bba696c8082de31,4,33,11,44,6,2014-02-20 14:39:13,2014-02-20 14:39:13
e39f0de8ee73ded91aebed696bba696c8082de31...4e15cbf463c611dfad80e7f4a77e43638a356f98,1,3,0,3,1,2014-02-20 14:42:22,2014-02-20 14:42:22
d0e73eeca1f4e9d460a50200518e49b3afebbac9...7e14f86c71b8b2f94ad65cae6118f752c8f31610,2,5,2,7,5,2014-03-04 07:08:39,2014-03-04 07:08:39
7e14f86c71b8b2f94ad65cae6118f752c8f31610...f84d84622393223e40dd9533f86266d5f377f881,1,8,1,9,3,2014-03-10 19:39:29,2014-03-10 19:39:29
d0e73eeca1f4e9d460a50200518e49b3afebbac9...93bc67ab114d73589c385cc83dc2dda70fa3b211,2,8,1,9,3,2014-03-04 01:38:09,2014-03-04 01:38:09
d0e73eeca1f4e9d460a50200518e49b3afebbac9...affc37ad024670520e6d552dc21414c68ef5c923,1,2,2,4,2,2014-03-04 00:10:49,2014-03-04 00:10:49
affc37ad024670520e6d552dc21414c68ef5c923...28f40b72053fdc684c975ea32c11820b47b75e52,2,4,4,8,3,2014-03-04 00:40:30,2014-03-04 00:40:30
71e7bff1eabd0c277a75910fd2975bfc7b95af2a...05c5b77070ef444ba1298e984b1f583d11a106ee,1,1,1,2,1,2014-02-24 11:22:00,2014-02-24 11:22:00
71e7bff1eabd0c277a75910fd2975bfc7b95af2a...62b227b2f359c168447d24d1c099fa174329fcc9,1,1,1,2,1,2014-02-24 07:37:36,2014-02-24 07:37:36
ac98d74adba93332d198572e432e548ddfb83a9f...324749486f8d712c48e77a04a482b734c3d54b41,1,3,2,5,2,2014-02-27 11:39:04,2014-02-24 12:04:05
ac98d74adba93332d198572e432e548ddfb83a9f...6c660698eba8d9c296adffcd09576949fc48f788,1,3,0,3,1,2014-02-24 12:21:34,2014-02-24 12:21:34
6c660698eba8d9c296adffcd09576949fc48f788...31386adf53e0a029167de3b73f3ebda93b0e86a2,4,31,17,48,12,2014-02-24 12:55:27,2014-02-24 12:55:27
506709485c8be7a3fb26e4fa6f7d1ea0ad999280...f6f80659ec23ffc7ad4847b13ac78047862f0d91,4,28,3,31,4,2014-03-14 08:44:16,2014-03-14 08:44:16
506709485c8be7a3fb26e4fa6f7d1ea0ad999280...5a616649b549eafc082ad876ac086da8945217f2,1,6,4,10,2,2014-03-14 07:52:57,2014-03-14 07:52:57
5a616649b549eafc082ad876ac086da8945217f2...af53aa9072ae355b6de167b0d20f9b87195131ec,1,17,3,20,4,2014-03-14 07:53:46,2014-03-14 07:53:46
af53aa9072ae355b6de167b0d20f9b87195131ec...56df3dbff2e07f6c4402ff7410412238d643ce0f,1,13,1,14,2,2014-03-14 07:55:50,2014-03-14 07:55:50
56df3dbff2e07f6c4402ff7410412238d643ce0f...48e9054056db7f14bdef0d2d5c859f357110ed95,2,12,9,21,3,2014-03-14 08:03:49,2014-03-14 07:57:39
506709485c8be7a3fb26e4fa6f7d1ea0ad999280...0983438037a13606ff6cbd281a7892295bfd7dd2,1,1,1,2,1,2014-03-13 21:25:55,2014-03-13 21:25:55
27c3d529d1ed57b1b23f94e495999c8050a8c3a5...a02c1fd39076b3592bbe34d16c0f6ac59d7a888b,1,0,1,1,1,2014-02-27 19:08:02,2014-02-27 19:08:02
27c3d529d1ed57b1b23f94e495999c8050a8c3a5...6dcfc1040d1c4104cfe7f091fed7ef31f899a791,6,83,51,134,13,2014-02-27 19:04:44,2014-02-27 19:04:44
f1e1e5bf0deb641f73f016991b749963f9baf855...fd76f497866b6945a2fc9ce560154ab9f283e1dd,2,7,20,27,8,2014-02-26 08:06:58,2014-02-26 08:06:58
fd76f497866b6945a2fc9ce560154ab9f283e1dd...084bb6b1fc2a352857d8bc9c243003c029b17a3e,2,4,3,7,3,2014-02-26 08:13:11,2014-02-26 08:13:11
d3c2253c6d464cdf8fd39a06ac66c26cd73d393e...42422dcc6aab156cc3e89c75c7ed2a71c715b169,3,45,12,57,15,2015-02-07 15:41:30,2015-02-07 15:41:30
12f1a42eccb8c11031ee84157ed5dc6ce0bf23cc...affb5b3ff48f9037349eac77f86adb7c946663ce,2,3,0,3,3,2015-03-13 14:48:35,2015-03-13 14:48:35
72decfb1b9023c6019afe9f1608830d7e93f6872...29f78d1976ab4c37a7cfb1ce3d0a321b7b85a400,1,5,2,7,2,2015-02-09 20:45:39,2015-02-09 20:45:39
29f78d1976ab4c37a7cfb1ce3d0a321b7b85a400...f5769c4cedc6a1ce2df8b54763ce13c8e441c60d,1,1,1,2,1,2015-02-09 20:50:18,2015-02-09 20:50:18
5e2098feb4b8ecbae3854172d28c816827669d53...f7c948223d000e4488d864d50f3292a6c7afeaf7,1,2,0,2,1,2015-02-24 17:08:34,2015-02-24 17:08:34
5e2098feb4b8ecbae3854172d28c816827669d53...51b18fe6f6558f14e5a8123d27f65f3557134822,1,1,1,2,1,2015-02-24 09:50:18,2015-02-24 09:50:18
4e5bc1d5356e860be316656fd8c3393c468d24b6...8d0690c5c768415a5dae1155c236f7650ea894cf,2,2,1,3,2,2015-03-02 10:01:17,2014-12-17 14:26:43
4e5bc1d5356e860be316656fd8c3393c468d24b6...4bc5c66fe12a2dc5d8fe9ed5878da5dea2444442,2,26,0,26,2,2015-03-02 04:26:21,2015-03-02 04:15:59
4e5bc1d5356e860be316656fd8c3393c468d24b6...f84b7eef3f969a65d0930c9d62b6968b2ae70f12,11,500,2,502,12,2015-03-01 19:51:03,2015-02-04 20:31:55
0da0d800f2a0db9d9c16cf5e2feb0dd80b528223...15bee7e0ffa2f7eccd700da0238ad7a7e66ddbb0,2,18,5,23,5,2015-02-18 11:32:20,2015-02-18 08:40:42
0da0d800f2a0db9d9c16cf5e2feb0dd80b528223...9bf8480b4a0d3ea6e284c4bd8bf26243f3f3f6f5,19,241,153,394,48,2015-02-17 21:20:44,2015-02-14 15:04:45
9bf8480b4a0d3ea6e284c4bd8bf26243f3f3f6f5...ca504a77fe994da893cd0632de5e0e7ea5b729fc,1,4,4,8,4,2015-02-17 21:20:44,2015-02-14 15:45:22
ca504a77fe994da893cd0632de5e0e7ea5b729fc...9729cc584f5758395960416f308a9c45f698cdee,5,28,34,62,11,2015-02-17 21:21:13,2015-02-14 18:52:45
9729cc584f5758395960416f308a9c45f698cdee...192e7306626e073a5e6fb3b41d69f0e3fddb0821,1,2,2,4,2,2015-02-17 21:21:13,2015-02-15 17:48:32
192e7306626e073a5e6fb3b41d69f0e3fddb0821...d2ebdf664b42d4fac6b2e060ef79aa9fe0b0e72d,22,163,193,356,48,2015-02-17 21:23:31,2015-02-16 18:58:40
d2ebdf664b42d4fac6b2e060ef79aa9fe0b0e72d...ab401a6132411294cee03cf4e0902ec75c2c42dc,3,1,30,31,5,2015-02-17 21:23:31,2015-02-16 21:08:44
ab401a6132411294cee03cf4e0902ec75c2c42dc...ab65be7a2f5d46a681d882f4f90d1f0438c64b02,1,1,1,2,1,2015-02-17 21:23:31,2015-02-16 21:08:55
ab65be7a2f5d46a681d882f4f90d1f0438c64b02...99fb4d387fbcddc56292b788a84b1e62d27765dd,1,16,0,16,1,2015-02-17 21:23:31,2015-02-16 21:09:17
99fb4d387fbcddc56292b788a84b1e62d27765dd...4036fb167ddce47db8ad4d885000b2c9db96595d,1,2,2,4,2,2015-02-17 21:23:31,2015-02-16 21:09:52
4036fb167ddce47db8ad4d885000b2c9db96595d...65b125a5035cb021aeb81e168fd4ae1ad6c74c11,1,1,0,1,1,2015-02-18 07:18:19,2015-02-18 07:16:42
0da0d800f2a0db9d9c16cf5e2feb0dd80b528223...c3e05fc321c6c99a4e31216721f91699ef6469a1,1,1,1,2,1,2015-02-17 21:15:29,2015-02-17 21:15:29
7474b1b03f3111e1fefa05cbee1432a35bc55c6d...78124d97836ebdfbb45c5567b9f2775889fd9718,5,20,0,20,3,2015-02-13 18:19:16,2015-02-13 18:13:47
ec5622b1a45c9cdce86d1a44aa3a4be6f4eb71bc...47e38e5c0e516c5c09017760f495c53155fe26c1,1,2,0,2,1,2015-02-16 19:16:23,2015-02-16 19:16:23
47e38e5c0e516c5c09017760f495c53155fe26c1...4ecfcb4a1e05189372a72547103f1c2e9a23ab3b,1,1,2,3,2,2015-03-03 15:38:38,2015-03-03 15:38:38
ec5622b1a45c9cdce86d1a44aa3a4be6f4eb71bc...b0a9dbdfb132412837f4ca10cee1406560cb2b08,1,5,1,6,2,2015-02-16 18:14:07,2015-02-16 18:14:07
ec5622b1a45c9cdce86d1a44aa3a4be6f4eb71bc...958eaba3d9839ce6283933dad50c599758c554f3,1,1,1,2,1,2015-02-16 08:48:32,2015-02-16 08:48:32
ec5622b1a45c9cdce86d1a44aa3a4be6f4eb71bc...87b413592499ddcf1149d9e2b580f76a13bf625c,1,2,2,4,1,2015-02-16 05:51:23,2015-02-16 05:51:23
0991d19c0d157025db8e9bf01d216771a4dbfe31...7fa80b5bd01caff61c08c70b052c9965893cce5a,2,6,5,11,5,2014-12-30 12:37:14,2014-12-30 12:36:13
7fa80b5bd01caff61c08c70b052c9965893cce5a...d4b613ded728bbd45e5d67e5af555d661581ecf0,1,1,1,2,1,2014-12-30 13:00:07,2014-12-30 13:00:07
d4b613ded728bbd45e5d67e5af555d661581ecf0...ed464edabeb62e35363ebadd0a5bb5ff394b6781,3,5,5,10,5,2014-12-30 13:29:55,2014-12-30 13:29:55
ed464edabeb62e35363ebadd0a5bb5ff394b6781...7240150c8986c7aa21d0eb3140ac9a4c7674a4d2,6,8,8,16,8,2014-12-30 14:17:46,2014-12-30 14:17:46
7240150c8986c7aa21d0eb3140ac9a4c7674a4d2...0da5154b5a71216a9bbff861561636906ca8c167,3,6,5,11,5,2014-12-30 14:40:11,2014-12-30 14:40:11
0da5154b5a71216a9bbff861561636906ca8c167...cd0aed3d54fc01d0c361a8cf282d2de48297f66a,8,15,15,30,15,2015-01-07 09:46:00,2015-01-07 09:46:00
cd0aed3d54fc01d0c361a8cf282d2de48297f66a...8dd672776ee72990fd41b37559a8ba102595d6ca,5,10,10,20,9,2015-01-07 10:39:20,2015-01-07 10:39:20
8dd672776ee72990fd41b37559a8ba102595d6ca...fd100e381a1b9f36830813d7b4549cbbb2562773,1,1,1,2,1,2015-01-07 10:39:43,2015-01-07 10:39:43
21ae36c6b53b1e115235e9a12547cc084da2a32f...757df0142f521380b92d28a721a7fd2bd8aa382f,1,1,1,2,1,2015-01-07 18:58:17,2015-01-07 18:58:17
6296f65d6560e7b04231cdbd53e3b5769397a9a7...f12ec5f4e80bee7690a2ec72cd65e72e62b21a18,3,185,5,190,6,2015-03-05 16:23:38,2015-03-05 09:54:28
6296f65d6560e7b04231cdbd53e3b5769397a9a7...730a49afc29d291287d5eae511c6e27e1a04ab72,1,1,1,2,1,2015-03-05 10:09:08,2015-03-05 10:06:06
3d6d0e1e778061aa96ab4e4b888138997b363207...f24e46b8f01624bffc37f2f800cb03bcafc43591,1,0,2,2,1,2015-03-04 05:59:43,2015-03-04 05:59:43
3d6d0e1e778061aa96ab4e4b888138997b363207...b5ec0d6d450b32fa00d95d864fa797f64e9ca17e,2,2,2,4,2,2015-03-04 04:38:42,2015-03-03 22:05:31
3d6d0e1e778061aa96ab4e4b888138997b363207...443cf9723192b821b95960f91c3ce0350d77edab,1,3,3,6,3,2015-03-04 04:37:56,2015-03-03 22:47:10
443cf9723192b821b95960f91c3ce0350d77edab...dc7c90f132321497d9a914734f902762d2022a3a,1,3,3,6,3,2015-03-04 04:37:56,2015-03-03 22:50:02
694ac54862d9b88ee0e82577d8fbf622534391bf...65105ff3bbe66363d4c922913dbc8c9514f1485c,10,77,80,157,15,2015-03-05 01:22:55,2015-03-05 01:22:55
65105ff3bbe66363d4c922913dbc8c9514f1485c...7b9b9f704eb1a14d6f943cc4d37d493a6cb8fde3,1,1,1,2,1,2015-03-05 02:26:49,2015-03-05 02:26:49
606d24ff2df157ec70003132d1ead7a47dc32883...9698b36c1cd0808adb006593c0e8649cb42f3571,11,127,3,130,19,2015-03-15 17:44:59,2015-03-15 16:17:12
9698b36c1cd0808adb006593c0e8649cb42f3571...09ef69b7c8e534cedff2ca1a42b58f534e349107,5,19,8,27,6,2015-03-16 11:52:55,2015-03-16 11:52:45
09ef69b7c8e534cedff2ca1a42b58f534e349107...0e20dc910f25db3b3f71867d54367db36334ff45,1,1,0,1,1,2015-03-16 11:58:34,2015-03-16 11:58:34
0e20dc910f25db3b3f71867d54367db36334ff45...410d25c8ca8afabb25e5f89b36e3cfd09ffe6f87,11,41,44,85,15,2015-03-16 13:22:50,2015-03-16 13:22:50
410d25c8ca8afabb25e5f89b36e3cfd09ffe6f87...f53683e67fa0db7b13d0dee977bc21206af7e0fd,3,22,12,34,9,2015-03-16 14:51:49,2015-03-16 13:35:48
f53683e67fa0db7b13d0dee977bc21206af7e0fd...1b437ec3498bc544dbd1b252f5c755e9073407fd,15,115,25,140,36,2015-03-16 19:38:41,2015-03-16 15:20:17
1b437ec3498bc544dbd1b252f5c755e9073407fd...22fcb2f418ed6a2c7e68c0cd3ec2d414510ad4ec,5,30,22,52,11,2015-03-17 15:11:57,2015-03-17 13:04:25
606d24ff2df157ec70003132d1ead7a47dc32883...8fed435208fed3115c740eb630c263a97b5a631d,3,12,2,14,4,2015-03-13 21:34:11,2015-03-13 15:40:15
606d24ff2df157ec70003132d1ead7a47dc32883...09791774a594972d410fa72f5e0a256f19f0915a,3,5,4,9,4,2015-03-13 14:42:31,2015-03-13 14:42:31
606d24ff2df157ec70003132d1ead7a47dc32883...4e49f21b141e8cbbf581c119c7524f6e9553f136,3,4,7,11,5,2015-03-13 13:51:48,2015-03-13 13:51:48
4e49f21b141e8cbbf581c119c7524f6e9553f136...84d28209b6f8a63f35ad082bc8851e28550643e1,4,22,27,49,9,2015-03-13 15:06:56,2015-03-13 13:55:17
84d28209b6f8a63f35ad082bc8851e28550643e1...f2024b1e06587c2b274d4982a48d80d052bba088,2,8,5,13,6,2015-03-13 15:07:02,2015-03-13 13:55:38
f2024b1e06587c2b274d4982a48d80d052bba088...10421674afdc8a18cdab52288e736d06e3015096,2,5,0,5,2,2015-03-13 15:07:02,2015-03-13 13:56:08
10421674afdc8a18cdab52288e736d06e3015096...12b779e70b54692f4f00cb386440833bd1426a93,2,47,6,53,3,2015-03-13 15:07:08,2015-03-13 13:56:53
12b779e70b54692f4f00cb386440833bd1426a93...b160db1482255146e58317be4b16b1e9aebc3748,1,1,0,1,1,2015-03-13 15:07:12,2015-03-13 13:57:27
606d24ff2df157ec70003132d1ead7a47dc32883...f96dc6295aeb6f7d731c635c1a8a8ff609b4510f,3,5,5,10,3,2015-03-13 12:49:27,2015-03-06 11:25:31
f96dc6295aeb6f7d731c635c1a8a8ff609b4510f...7f4cffd88b393a55f6462ce870807c7afd7ca98a,1,2,2,4,1,2015-03-13 12:49:27,2015-03-06 11:25:42
606d24ff2df157ec70003132d1ead7a47dc32883...2718955441587618933a632008b85762247081a2,4,4,3,7,4,2015-03-13 12:47:26,2015-03-13 12:47:26
85c0ce2e1a2f99de2e7155026cd97d5fe9765018...a5f5849340b4ad38da21fcada446ef3eb01872b5,1,3,1,4,3,2015-01-19 04:11:17,2015-01-19 04:11:17
1524e2171aa4ab4bb1aab629c41b382dba77e143...1e22b494e2618e004ad816ed92b8aca70fa037e5,1,1,1,2,1,2014-12-19 12:49:33,2014-12-19 12:49:33
1524e2171aa4ab4bb1aab629c41b382dba77e143...6d747cfd3a41d6e2f396855ef7f29f400ea3f4a8,1,1,0,1,1,2014-12-18 14:50:20,2014-12-18 14:50:20
19865b7cfd4d081f6bee6e973858ee488e995561...842ac35ae4f6aac8bd3f2ab8649a6e07576f89fa,1,5,6,11,5,2014-12-15 18:22:18,2014-12-15 17:47:38
19865b7cfd4d081f6bee6e973858ee488e995561...7512016d51feb6c02c3a0322325564b6b7f5ad9c,1,1,1,2,1,2014-12-15 14:59:16,2014-12-15 14:59:16
7512016d51feb6c02c3a0322325564b6b7f5ad9c...62ea02740d2fff83d636eb659eb5f80dbf1bd888,6,66,2,68,6,2014-12-15 17:57:42,2014-12-15 17:47:26
62ea02740d2fff83d636eb659eb5f80dbf1bd888...764eaedf810af307d68d5e6b552988db1cb15f54,1,23,0,23,3,2014-12-16 11:38:44,2014-12-16 11:38:44
764eaedf810af307d68d5e6b552988db1cb15f54...49f4fe8c6ea776825461a1d18da27a198fb95b55,1,1,1,2,1,2014-12-16 11:43:38,2014-12-16 11:43:38
49f4fe8c6ea776825461a1d18da27a198fb95b55...4a389e761635ad17a707d3caa8ec5bf09b849f2f,1,2,2,4,1,2014-12-16 11:46:55,2014-12-16 11:46:55
4a389e761635ad17a707d3caa8ec5bf09b849f2f...c8b2def2be44771ffb479ad989acc7eccf4012f8,2,6,1,7,2,2014-12-18 10:08:11,2014-12-18 10:08:11
c8b2def2be44771ffb479ad989acc7eccf4012f8...af56c1dd323ee418eb8dbfa9eb35c7ec9ac58a66,3,13,4,17,3,2015-01-06 15:56:56,2015-01-06 15:56:56
19865b7cfd4d081f6bee6e973858ee488e995561...4ab728bfe89adbc8f9d430e80f0582b1775a50d5,1,1,1,2,1,2014-12-15 14:31:23,2014-12-15 14:31:23
19865b7cfd4d081f6bee6e973858ee488e995561...c4a56797a4c3a818c0ac6e57e2ea3acb76f3f1eb,3,4,12,16,3,2014-12-15 13:10:56,2014-12-15 13:10:56
19865b7cfd4d081f6bee6e973858ee488e995561...71789468d306c7974fcf27442c83d7fc131e94fa,3,51,0,51,3,2014-12-15 12:43:36,2014-12-15 12:43:36
71789468d306c7974fcf27442c83d7fc131e94fa...e61e7a17b433cfe88910d21d00be90d909ca83bc,1,0,10,10,1,2014-12-15 12:44:47,2014-12-15 12:44:47
e61e7a17b433cfe88910d21d00be90d909ca83bc...d117927131351e319db947e83ef4b9ec228d5030,1,1,0,1,1,2014-12-15 14:17:10,2014-12-15 14:17:10
19865b7cfd4d081f6bee6e973858ee488e995561...83de96ae3a5acbbaf8b94a04b6c160e6819d91a2,2,3,1,4,2,2014-12-15 12:01:55,2014-12-15 12:01:55
5dbbec4612d12d00d9db6ad057044054b923817f...a33d2f865388cc83526509ad3f9084222cce6b77,2,53,0,53,2,2015-01-06 10:50:05,2015-01-06 10:50:05
5dbbec4612d12d00d9db6ad057044054b923817f...cc282dd00eb8a062ac2c279eed3245d722ad3217,1,7,0,7,2,2015-01-06 03:40:38,2015-01-06 03:40:38
5dbbec4612d12d00d9db6ad057044054b923817f...52bc4e79f83e56f7f90563aa2bd97b98b4cc2715,2,4,0,4,2,2015-01-05 10:51:21,2014-12-17 11:18:11
5dbbec4612d12d00d9db6ad057044054b923817f...9993a0e356788e6327b92ec481800ce8bf86dce0,1,1,1,2,1,2015-01-05 10:44:42,2015-01-05 10:44:42
5dbbec4612d12d00d9db6ad057044054b923817f...2a4ee2fd7f068f6eba0c51bbc8e4b0948c4dcfe4,1,7,2,9,3,2015-01-04 13:09:35,2015-01-04 13:02:31
fe104386b16a73cbac1588aa5cce8319c6355ee9...5140a4cd139e43a3c7a1d23fdd61bfc0d9aff6a6,11,179,140,319,21,2014-12-25 12:32:49,2014-12-25 12:32:49
5140a4cd139e43a3c7a1d23fdd61bfc0d9aff6a6...88b480174cbd0d95726df1390f667996efcf52f3,3,12,10,22,6,2014-12-25 12:46:18,2014-12-25 12:46:18
fe104386b16a73cbac1588aa5cce8319c6355ee9...1fbc01024123c44740e1c94cab5a74faf2856a21,4,158,1,159,6,2014-12-25 12:28:40,2014-09-02 15:12:13
fe104386b16a73cbac1588aa5cce8319c6355ee9...19109a9458382c86cb71c2008892f425cf3fea16,1,3,1,4,2,2014-12-24 21:18:30,2014-08-28 16:57:39
fe104386b16a73cbac1588aa5cce8319c6355ee9...b4e6dec8909493bddab01a7b51c99b2314b37420,4,69,22,91,17,2014-12-24 16:34:14,2014-12-24 16:34:14
b4e6dec8909493bddab01a7b51c99b2314b37420...f0d0b19393136a5f2f9faea845ed2c02849b7db9,7,94,42,136,36,2014-12-25 08:13:45,2014-12-25 08:13:45
fe104386b16a73cbac1588aa5cce8319c6355ee9...84b40a346a46ca75e7a8981999c6b74187328435,9,36,2,38,12,2014-12-24 15:22:08,2014-12-15 10:11:38
f9ece12e872e9bf748f4daebfba88c341d4046f5...d2bd5e833fdcf5bbb039936a3f71eaf7ff829063,2,35,20,55,4,2014-12-25 18:51:07,2014-12-25 18:51:07
5b92ddb80994ff6ab992dcdb39e3a27c687f0dc3...4cbe72d76722ce6c3d327ec62f54478a6e955d32,11,45,17,62,18,2014-12-02 09:31:57,2014-12-02 09:31:57
4cbe72d76722ce6c3d327ec62f54478a6e955d32...6eeaef6dc4cc0cda9c80bf46f38eae9f640debec,2,17,4,21,2,2014-12-02 09:47:12,2014-12-02 09:47:12
acf1844897405849f836fefc96284dd7a8416879...bfe99a1eee8a11900a4f807df265b3e90099ecaa,1,22,23,45,6,2014-12-08 13:41:45,2014-12-08 13:41:45
e6c5a8b161c89a03ca5ee6666f65cf4cfbfa4ab9...1961b590700c3f1168322039b5992bc904fdeda1,2,7,1,8,3,2014-12-05 13:42:26,2014-12-05 13:42:26
1961b590700c3f1168322039b5992bc904fdeda1...b23f71ec4d76bc1a6ed4b6c1add8dbc8fb32eb40,1,10,0,10,1,2014-12-05 13:49:25,2014-12-05 13:49:25
b23f71ec4d76bc1a6ed4b6c1add8dbc8fb32eb40...6487419364fa9c179e24028d85b2be10d574067f,3,13,2,15,3,2014-12-05 14:02:08,2014-12-05 14:02:08
e6c5a8b161c89a03ca5ee6666f65cf4cfbfa4ab9...90a308ea00ece729b15b430a397d22e3b3fe3102,2,3,1,4,3,2014-12-05 11:34:18,2014-12-05 11:34:18
d7fa9952efef4316cdaa1c7c86c4b8c2c6703bc7...18164afbccf90074abf55e2bcdb91204b213ede1,3,12,11,23,8,2014-12-04 17:11:49,2014-11-28 18:06:21
1521867219e9b51d8dc7be255b416e4830ab4566...8f0b558aaadd7d665011642f64aa639d73bb4a76,1,23,0,23,1,2014-12-05 14:29:45,2014-12-05 14:29:45
8cc5e85543b0a553536ebe70f01fa29e0b0f60bd...860f159d41b7a013108a111fefa224e365f4a337,4,108,0,108,4,2014-04-03 15:16:05,2014-04-03 15:16:05
8969a2f0614ebccde04013d468808b65853d458c...688e429094e2ae06d87918f67ced6e0b3303bfbb,1,1,1,2,1,2014-04-08 07:26:26,2014-04-08 07:26:26
2a99f18478797c67e0b795d71688bd06153abe5a...c46a0612706a2570342178fe8f61222034675c38,2,10,0,10,4,2014-04-24 17:39:09,2014-04-16 08:02:42
c46a0612706a2570342178fe8f61222034675c38...3bf1cff4215c8b60c4133c3e822495f046638583,1,1,0,1,1,2014-04-24 17:39:33,2014-04-23 14:15:50
3bf1cff4215c8b60c4133c3e822495f046638583...ae7bd9f7c0d78a4c039a8511d8d045eebd9706e4,2,26,0,26,3,2014-04-24 17:39:33,2014-04-24 17:35:06
862e0e34d34213097e1a178c280c2ce2f273f322...2a9eb0265056dc50ae97f1f5784ed60ddc797634,1,1,1,2,1,2014-04-08 10:38:24,2014-04-08 10:38:24
c945ca3ad17d67da93afccc51461c9a07d702f19...24934c9b13a66f1746479c419fd253ced6bd75b2,1,1,1,2,1,2014-04-08 11:38:57,2014-04-08 11:38:57
9a02e27b84589856b41e171493aa441add497ac1...b27c42be870f55667eaa8a7152aa9e70e4e32a29,7,53,49,102,40,2014-04-09 11:35:01,2014-04-09 11:35:01
b27c42be870f55667eaa8a7152aa9e70e4e32a29...26ec74c446e2242fe76bfe9ce84c8f86e9c46f3d,2,123,4,127,5,2014-04-09 11:35:26,2014-04-09 11:35:26
26ec74c446e2242fe76bfe9ce84c8f86e9c46f3d...1bd28994ccde18228a1c295110a283c79dfe70ee,9,19,137,156,16,2014-04-09 11:35:58,2014-04-09 11:35:58
9a02e27b84589856b41e171493aa441add497ac1...c5cdd07899df5cc5d87c514a7649979056fcced7,3,13,0,13,3,2014-04-09 10:36:25,2014-04-09 10:36:25
c5cdd07899df5cc5d87c514a7649979056fcced7...36f861f1b1b7dc02a83d16243f680c8fbdfabfb7,68,286,228,514,110,2014-04-09 12:05:03,2014-04-09 12:05:03
36f861f1b1b7dc02a83d16243f680c8fbdfabfb7...466f0fb7621300c944f24e8fcc99f2d28b4afcea,1,0,1,1,1,2014-04-09 12:05:40,2014-04-09 12:05:40
466f0fb7621300c944f24e8fcc99f2d28b4afcea...9f6a8ff4b55a44c6f02ecffbba8d0a108794931a,1,2,2,4,2,2014-04-09 17:55:09,2014-04-09 17:55:09
9a02e27b84589856b41e171493aa441add497ac1...f5b7899cf755dae81a1ba0f0ad428209e808c5d7,1,1,1,2,1,2014-04-09 09:38:33,2014-04-09 09:38:33
9a02e27b84589856b41e171493aa441add497ac1...0ed2f8ded9a33a9d6741c32a706a2f9d087391b4,1,4,0,4,2,2014-04-09 02:02:45,2014-04-09 02:02:45
2876f5d51492651dac2bc4077c3712b57c3221e5...1eed8965783786b1ec07286e78f30750d48734a4,1,1,1,2,1,2014-04-25 10:49:21,2014-04-25 10:49:21
b14c475a4cb210c8c242d36b8e25974d87c19cba...e2fd2bf9f5cf820adb66f6a0a875bc67ddaeb546,1,7,5,12,5,2014-04-21 13:43:20,2014-04-17 15:57:09
b14c475a4cb210c8c242d36b8e25974d87c19cba...b3e5b12e9bbe05cabae610298f3637faa8ee5a02,1,2,2,4,1,2014-04-17 16:15:05,2014-04-17 15:53:56
b14c475a4cb210c8c242d36b8e25974d87c19cba...f81123811e0d6607c619fffc483b234b000ca002,1,15,0,15,2,2014-04-17 14:30:24,2014-04-17 14:30:24
b14c475a4cb210c8c242d36b8e25974d87c19cba...bd183bfba925aca510adfed4dcd0a1776cf69707,1,4,0,4,1,2014-04-17 11:45:06,2014-04-17 11:45:06
5ce14184068490ec972d154df5b283c8797a545b...536b2f2f75d384446e4d3d103903a6ff909bd4da,1,1,1,2,1,2014-05-06 14:02:21,2014-05-06 14:02:21
6fd13ab041ba1b8df5a856be7f97c3724c7c519e...241132b6ebde69556bf1246ba6fd2a96e51815c3,1,1,1,2,1,2014-04-22 12:51:38,2014-04-22 12:51:38
dc55127c1dce5f3563a090f65f20b689749f5297...193a9e7d4c7b516fa1ed1c23eeb89ab71c316019,1,1,0,1,1,2014-04-30 11:35:35,2014-04-30 11:35:35
7660290b37c6d468ce6db4d46e811ef140782901...b2a258722bc8afbcca4af6e90cf00e4200cfbf7c,1,2,1,3,2,2014-05-02 10:23:12,2014-05-02 10:23:12
d4c96ac907b1977a530ae53383afc98772b23d80...9c4ed864d53a60273fd1de08acb63246fb42967c,1,1,1,2,1,2013-11-24 20:06:17,2013-11-24 20:06:17
fd9a8c36010e6fe9377f75eff044d7551761c2b6...b75777fd95ac7e432a6f576c018b8285efffbca4,1,1,1,2,1,2014-01-28 09:53:02,2014-01-28 09:53:02
fd9a8c36010e6fe9377f75eff044d7551761c2b6...5de16dee768f4482d8db48b58fad1cf55c1320ee,2,15,0,15,2,2014-01-28 09:19:22,2014-01-28 09:19:22
f381308c8509ee01fd86c64cccdd5128effdc389...29bfe34521a3a2ddf16ae954706e355ea0ee6e4a,1,1,1,2,1,2013-12-12 13:31:37,2013-12-12 13:31:37
9b7b27ce7216652493648228f2352d1d08836549...2ca4e70894229d9a7920f7539b9390bc43159b73,1,5,4,9,1,2013-12-13 11:21:12,2013-12-13 11:21:12
9b7b27ce7216652493648228f2352d1d08836549...a7a344f042995543e8f5a854ff47be14ce85a945,1,10,17,27,3,2013-12-13 11:12:54,2013-12-13 11:12:54
a7a344f042995543e8f5a854ff47be14ce85a945...4ec8eecb66968efeab228cd1ce45d34dc76d396d,1,1,1,2,1,2013-12-13 11:14:43,2013-12-13 11:14:43
88ebeb92c29efcf54cb4680927f5a677fbf68e0a...8d83322dd1a6b0d8b867e5ed9e1a3d66d6cdab52,1,1,1,2,1,2014-01-20 12:24:19,2014-01-20 12:24:19
adf6ee09b05d057ec9245287c0b878b5e5c2ae81...b85e4d3cbdab72ce1b52b409a28081b776f37659,2,13,15,28,3,2014-01-14 18:49:32,2014-01-14 18:49:32
b85e4d3cbdab72ce1b52b409a28081b776f37659...2c071314ae6e377cf358e6d423a9d4ebd947e5a4,2,23,22,45,2,2014-01-14 18:55:42,2014-01-14 18:55:42
2c071314ae6e377cf358e6d423a9d4ebd947e5a4...2940785c179702acb7b7b333740d93d2ac0e6c8b,3,7,0,7,3,2014-01-14 18:55:59,2014-01-14 18:55:59
d435fbb9b223c035e9d32e5746a4f9bc092e5dce...da817a1f56ae4ba502f688592a74468b6e3b327c,5,10,5,15,10,2014-01-20 09:38:16,2014-01-20 09:38:16
96808199b24c24923ccdb2e5299a5b2d73e6f85d...7f9081c10816e079eaa79ba7f3371b30d1564498,1,3,1,4,2,2014-01-18 14:34:40,2014-01-18 14:34:40
dcc6ff5bcdf760e73fb2a045521716d0997fdbab...119c782e0b9f691a3eeff1f44c23522aa4f9c552,2,2,0,2,2,2014-01-22 16:01:47,2014-01-22 16:01:47
119c782e0b9f691a3eeff1f44c23522aa4f9c552...7ad70a56d3258687b5e129b15dbfca4edb199eb4,2,4,4,8,2,2014-01-22 16:51:00,2014-01-22 16:51:00
7ad70a56d3258687b5e129b15dbfca4edb199eb4...4fc17cf13f955e9deedcfba81009dd658c4779a9,1,3,3,6,1,2014-01-27 12:01:20,2014-01-27 12:01:20
dcc6ff5bcdf760e73fb2a045521716d0997fdbab...efbb4fbb7aa15ab3db613df826271869936692c8,1,2,2,4,2,2014-01-22 15:54:53,2014-01-22 15:54:53
94865a607b6189b29457d4afc02704c43e1ec0c2...4b3afe2325e063943bdec123154a576f6a300bce,4,2,3,5,5,2014-01-22 18:22:20,2014-01-22 18:22:20
4b3afe2325e063943bdec123154a576f6a300bce...c227aa44f9c54dd88f2ac8de7a3463a23f516dff,43,109,131,240,86,2014-01-22 19:03:52,2014-01-22 19:03:52
c227aa44f9c54dd88f2ac8de7a3463a23f516dff...cee68dec8a9b9531690da0f81fbe1ebdc31a7eea,1,16,17,33,16,2014-01-22 19:59:09,2014-01-22 19:59:09
cee68dec8a9b9531690da0f81fbe1ebdc31a7eea...380342784d3efbecb98de81c9b2679e3d720f7c9,7,74,28,102,18,2014-01-23 10:55:43,2014-01-23 10:55:43
380342784d3efbecb98de81c9b2679e3d720f7c9...c3270875edd4d381b11401545b100e7b0408d6ef,1,1,1,2,1,2014-01-23 11:02:43,2014-01-23 11:02:43
c3270875edd4d381b11401545b100e7b0408d6ef...418660b9713fbb6bad156dc15fafcc80ecd3e7c0,1,1,1,2,1,2014-01-23 11:05:34,2014-01-23 11:05:34
418660b9713fbb6bad156dc15fafcc80ecd3e7c0...9db8cb3fecca819c2d48fbff9ad69d969a336801,1,8,17,25,9,2014-01-23 11:17:31,2014-01-23 11:17:31
9db8cb3fecca819c2d48fbff9ad69d969a336801...4cde3593b91b2aff4681bc8a3cece8be3d194b42,1,3,2,5,2,2014-01-23 11:21:58,2014-01-23 11:21:58
4cde3593b91b2aff4681bc8a3cece8be3d194b42...e013cd44e0da544cd23e0cdb1eed44b2f8cdf494,1,3,4,7,3,2014-01-23 11:24:25,2014-01-23 11:24:25
e013cd44e0da544cd23e0cdb1eed44b2f8cdf494...71851a7e4e6784105b727ae7fde8fae72343ef3c,2,4,5,9,5,2014-01-23 11:31:16,2014-01-23 11:31:16
71851a7e4e6784105b727ae7fde8fae72343ef3c...573f1f4ade80cc3b66723ad12594467e881b4510,1,2,2,4,2,2014-01-23 12:23:21,2014-01-23 12:23:21
0be062152a780950d699676c7cf7e6b7154d7db9...b8f6d67b96991e8089fb3b139d4e17994af60b17,1,75,53,128,16,2013-08-01 19:35:04,2013-08-01 19:35:04
b8f6d67b96991e8089fb3b139d4e17994af60b17...e834742407a74c26a443cce888c8ab0c210bf1cd,34,143,97,240,58,2013-08-01 19:35:40,2013-08-01 19:35:40
0be062152a780950d699676c7cf7e6b7154d7db9...942cf323339373911df9b3559df9de8141c2c8d6,1,8,4,12,2,2013-08-01 19:23:57,2013-08-01 19:23:57
052a7cc9cdc0fb14a55e7a7d71a8e4696c909658...1a9b0df76736553d955deb2e50cb9dd011c4d113,1,26,1,27,3,2013-09-27 10:57:05,2013-09-27 10:57:05
052a7cc9cdc0fb14a55e7a7d71a8e4696c909658...96ae1a809958450912980407ae2175f2f86f9c55,2,3,2,5,2,2013-09-27 09:56:30,2013-09-27 09:56:30
8674e1c22704e89ea030c9e38c296cae735610ee...02cf9aa6873c4c2e35dfedc8d4c6ad375bd8a219,2,3,3,6,3,2013-09-26 07:28:43,2013-09-26 07:28:43
02cf9aa6873c4c2e35dfedc8d4c6ad375bd8a219...3cb663f5c9359d809ecc82cc29a62d7658a48fbe,2,1,22,23,3,2013-09-26 07:33:06,2013-09-26 07:33:06
3cb663f5c9359d809ecc82cc29a62d7658a48fbe...edd2143d35d439e203d53b5e413f71e9f02db139,2,11,2,13,3,2013-09-26 11:48:58,2013-09-26 11:48:58
edd2143d35d439e203d53b5e413f71e9f02db139...65b9768ccfbdc3de682d66430601cf3af1b2a2f8,12,32,66,98,25,2013-09-26 11:49:22,2013-09-26 11:49:22
65b9768ccfbdc3de682d66430601cf3af1b2a2f8...0a2a34a4d18d0489f7db6aad5b5518b503692b5b,8,36,21,57,22,2013-09-26 11:52:17,2013-09-26 11:52:17
0a2a34a4d18d0489f7db6aad5b5518b503692b5b...482f64c574acbfac56d1031e7b8efe91429f70aa,1,50,0,50,3,2013-09-26 12:06:00,2013-09-26 12:06:00
482f64c574acbfac56d1031e7b8efe91429f70aa...c6096e47d6f1d020d96ac55706044290dc6d82e8,1,3,0,3,1,2013-09-26 12:08:33,2013-09-26 12:08:33
241286a7b3b927270663abc5972666c08b13ff02...01c8aae8f25555788049fd3537cb3251bcb5801a,1,2,2,4,3,2013-08-26 13:46:03,2013-08-26 13:46:03
9a00bbda89ab22f533db725e751ad46ff68c2cbe...5a3d4cb6349c430ec1be6842f9b37204e0386cd7,1,0,1,1,1,2013-08-24 19:42:52,2013-08-24 19:42:52
9a00bbda89ab22f533db725e751ad46ff68c2cbe...dc3e1d63921f4209f3823981d698fe29a6ce624e,1,4,3,7,3,2013-08-23 13:52:49,2013-08-23 13:52:49
dc3e1d63921f4209f3823981d698fe29a6ce624e...bda409c4c8e938c4cee254b04dd954978f770d8c,1,3,3,6,3,2013-08-26 10:37:58,2013-08-26 10:37:58
9a00bbda89ab22f533db725e751ad46ff68c2cbe...b30909c269816ee14f2d6403b6001690226a7cda,1,2,0,2,1,2013-08-22 14:00:42,2013-08-22 14:00:42
0a53e47bae31d3f7d84acc3dd7ec2c19f5d0460a...62ba789545555dbed2df5e21d3db4dcb54b1bbae,3,42,1,43,4,2013-08-09 20:02:34,2013-08-09 18:14:02
0a53e47bae31d3f7d84acc3dd7ec2c19f5d0460a...d8bd9cfafeccc36294265cf17f8f1350df619537,1,2,2,4,2,2013-08-09 18:08:56,2013-08-09 18:08:56
0a53e47bae31d3f7d84acc3dd7ec2c19f5d0460a...a6377cb6498aec95b08d3b5e15563310359412ac,1,1,1,2,1,2013-08-09 13:37:28,2013-08-09 13:37:28
cc0d550f4792b355f3bf0abe5bea67a99b26f596...bfcaf4e543c2ac3d2996753a83dcab614a2a2e68,1,3,1,4,2,2013-12-23 14:41:06,2013-12-23 14:41:06
b8b8a34b524fc38c194973d298ca24a0769c27a6...7765777583eab9cd54d731238e50fe29c1339441,1,1,1,2,1,2013-12-23 11:24:10,2013-12-23 11:24:10
8f8db776858be45845d18122761fdc09d5989368...17f7da3d975f62c96a11db3516759918dfb2c508,1,1,1,2,1,2014-01-25 23:33:55,2014-01-25 23:33:55
8f8db776858be45845d18122761fdc09d5989368...8b3b6f1096497ad63bbd4cd9bf78fa913ae345b5,19,124,17,141,24,2014-01-25 16:07:39,2014-01-23 02:07:01
8c670b66f00966b10c5ddfa02dae71a1e36e8be3...dc4b7cb49a075bdce4a6e55f789b991ee94fb529,1,3,2,5,2,2013-12-19 16:54:07,2013-12-19 16:54:07
8c670b66f00966b10c5ddfa02dae71a1e36e8be3...1e8add32299e2057208de1fa607c8774ba5b81b1,1,2,0,2,2,2013-12-19 15:23:22,2013-12-19 15:23:22
1e8add32299e2057208de1fa607c8774ba5b81b1...d429835ae0901ad542de47f351628c9e1a5ffd8f,1,2,0,2,2,2013-12-19 15:25:50,2013-12-19 15:25:50
d429835ae0901ad542de47f351628c9e1a5ffd8f...392d79db0eb9d8027353c1bb147a243a7f302bee,1,2,2,4,2,2013-12-19 15:32:30,2013-12-19 15:32:30
e411f3bab2c20ba22b838bb025fa33e980470d20...b08608b261f8c9c552d8957b6231c7725b9529ac,8,66,4,70,10,2013-12-02 22:20:34,2013-12-02 18:03:07
1dfd585f3ee25d80861e105827d8ecc6e004f27a...d514d7abf07f72c37ad12c2e0933bb1969493b24,1,8,4,12,3,2013-12-07 16:15:11,2013-12-07 16:15:11
1dfd585f3ee25d80861e105827d8ecc6e004f27a...8583d7d186dc11ee5f5a05926fa3cf4dbe62eb52,1,2,8,10,4,2013-12-06 20:21:59,2013-12-06 20:21:59
0f473674920dfc6759ddf131b32eb0b4b06256d0...645e8d470559b07a22164c55b76195a60fb8b37b,15,163,105,268,21,2014-02-25 17:15:08,2014-02-25 17:15:08
645e8d470559b07a22164c55b76195a60fb8b37b...345b3d4b72d3e450a65ec92806be019be512da54,4,52,40,92,16,2014-02-25 17:21:53,2014-02-25 17:21:53
2a7da96a0d7fb71a1371ce2d97157a2dd8a766f2...65cb88f3ba48d0f446df167c2f707e9b464f2036,1,1,1,2,1,2014-03-13 21:15:33,2014-03-13 21:15:33
65cb88f3ba48d0f446df167c2f707e9b464f2036...632fe8fbe1af9653fec6ecbb5c3e5c66d738641c,1,1,0,1,1,2014-03-13 21:19:50,2014-03-13 21:19:50
bbd92f554d22911afca9fca67077c73e8826bf23...1a3527f6e7eeffe120a900609857bdc3df0a1f28,1,1,1,2,1,2014-02-21 15:02:38,2014-02-21 15:02:38
1a3527f6e7eeffe120a900609857bdc3df0a1f28...490f99d45e0f610e88505ff0fb2dc83a557e22c5,2,96,2,98,3,2014-02-21 15:07:43,2014-02-21 15:07:43
79dd7beebdfe2d729bfdc39ffaffc264a1a84f67...97ac3def1fc7af0b8b07c98e437771f4a552e6be,1,2,1,3,2,2014-02-24 19:41:10,2014-02-24 19:41:10
97ac3def1fc7af0b8b07c98e437771f4a552e6be...8907a9586909aa98898044a237fb285a23074b68,1,1,1,2,1,2014-02-24 19:54:12,2014-02-24 19:54:12
8907a9586909aa98898044a237fb285a23074b68...504777ec20f006fd92cc948c03d35df3e1df4d3b,1,3,3,6,3,2014-02-24 19:57:59,2014-02-24 19:57:59
fbbd989770ea48d472a5c4d7d95b970542279099...83d94d5c9a675f2248eafc9aa33ab06cd24b65d1,1,1,1,2,1,2014-03-05 08:01:21,2014-03-05 08:01:21
83d94d5c9a675f2248eafc9aa33ab06cd24b65d1...5d34c877e3a3059cae9c0d1fef4ae8c8c3bf671f,1,1,1,2,1,2014-03-05 10:23:24,2014-03-05 10:23:24
fbbd989770ea48d472a5c4d7d95b970542279099...4239e457ac1a5293c260b0102e1ae9538544d839,1,1,1,2,1,2014-03-04 23:08:48,2014-03-04 23:08:48
31386adf53e0a029167de3b73f3ebda93b0e86a2...9c4109766528c8da70dc37fd23ab68dfceeea141,1,2,2,4,1,2014-02-24 13:17:36,2014-02-24 13:17:36
f6f80659ec23ffc7ad4847b13ac78047862f0d91...8839339ee36a27693b68a2779b485b0acc932173,1,7,0,7,1,2014-03-14 09:06:10,2014-03-14 09:06:10
1ec106b853cf2b3aa7c8fa29e24d1f429df2f0a8...b5d81174fb12296ade36ec1f52546b8527bbdcf1,1,5,6,11,3,2014-03-14 11:02:55,2014-03-14 11:02:55
a02c1fd39076b3592bbe34d16c0f6ac59d7a888b...fdd8b9e32a2a394c7dcd71e64e6bca8c25eda730,1,1,1,2,1,2014-02-28 06:10:17,2014-02-28 06:10:17
9114cfbb0a27c57d38c520384976cd9f770947df...8064b3b76788f84b2e86b2b6331cd874c2dddcaf,1,1,1,2,1,2014-02-28 14:18:47,2014-02-28 14:18:47
084bb6b1fc2a352857d8bc9c243003c029b17a3e...a355ea6f17ce89897d2c6496b363e5c77f48919b,3,8,0,8,4,2014-02-26 08:41:44,2014-02-26 08:41:44
a355ea6f17ce89897d2c6496b363e5c77f48919b...93cdf8a312466a459b74c30236704582a9fccbed,2,8,1,9,2,2014-02-26 09:50:02,2014-02-26 09:50:02
084bb6b1fc2a352857d8bc9c243003c029b17a3e...0afd656b92940c410cebd29d0b236f01cfdfb69c,1,1,1,2,1,2014-02-26 08:31:04,2014-02-26 08:31:04
64673acf9f75cb29d665553ba58ffb2046012eeb...03c8bf39e10b52bc5e9f128fe53876ad8b398dac,1,1,1,2,1,2015-02-08 08:53:31,2015-02-08 08:53:31
5bf33f977c16757dbf669fe2b25b09da406508dd...f228e17d39804e5cd5642e81a12df1cca19fd77d,10,9,13,22,10,2015-02-07 19:38:58,2015-02-07 19:38:58
5bf33f977c16757dbf669fe2b25b09da406508dd...36b255e57bae0dbfbb0e1767713bdd713c48d622,2,4,0,4,4,2015-02-07 17:35:50,2015-02-07 17:35:50
dd8dd92e501b7e980e913e7fa3a3efa5824d21fe...3e97ac2022c52a79640fccc97127f8bb059134fd,5,36,9,45,21,2015-02-06 18:21:48,2015-02-06 18:21:48
3e97ac2022c52a79640fccc97127f8bb059134fd...bdf49cc70b6fdb41087707e23846615c5723dcca,1,2,2,4,2,2015-02-06 20:52:34,2015-02-06 20:52:34
04953950546300400d2d95f4c3df547c59a2b174...b0dacc8eb06615cf5d0afb1fc8d799dd64325846,6,109,11,120,8,2015-02-12 01:53:07,2015-01-21 03:34:09
30cf916b263c187fe231acb6e622d21297092add...4377ba1c360cf6f4d15e3b5ad2a7ed7bc41f795e,3,2,35,37,22,2015-02-12 19:50:09,2015-02-12 19:34:34
86bb522713e8519e7b6c06f1fcb2cc752cc37212...00c7d533a04d8efe8aefa389e3212b977db7b5fc,1,1,1,2,1,2015-02-09 22:33:47,2015-02-09 22:33:47
86bb522713e8519e7b6c06f1fcb2cc752cc37212...aaa7a065c6fff7c57b750fd50f73866afe7ba026,2,7,1,8,3,2015-02-09 22:21:52,2015-02-09 22:21:27
c8e9eac25f384ece01de756a808fffddfc578546...1e1a95f5c36357b03df9420903d421edf7ac08c4,1,1,0,1,1,2015-02-24 12:12:25,2015-02-24 12:12:25
c8e9eac25f384ece01de756a808fffddfc578546...9338c6325263d950966e87ddb23095075f18558e,4,25,4,29,5,2015-02-24 11:20:57,2014-12-17 08:53:17
7561b1c2a486ae57e9fbebadadbe1269bfdba6a0...ad6d6232342558705c54ba70a94f9d7ddbd00f8c,35,522,54,576,51,2015-02-24 14:07:24,2015-02-17 15:59:50
ad6d6232342558705c54ba70a94f9d7ddbd00f8c...448817c4de965bf7286f33a3447937987a8864a1,9,44,15,59,15,2015-02-24 14:07:24,2015-02-17 21:52:32
448817c4de965bf7286f33a3447937987a8864a1...f2b37de54ba3cb0a375fb3a03e7ffd1f18444c39,5,5,2,7,5,2015-02-24 14:07:24,2015-02-18 07:21:30
f2b37de54ba3cb0a375fb3a03e7ffd1f18444c39...6979b3afd50f86550e523ed66ef22fd153e6cbc8,4,56,24,80,10,2015-02-24 14:07:24,2015-02-18 16:00:26
6979b3afd50f86550e523ed66ef22fd153e6cbc8...a938b3eeb4684f5747f63c23385f870ccbf43d2d,3,19,7,26,9,2015-02-24 14:07:24,2015-02-18 16:00:39
a938b3eeb4684f5747f63c23385f870ccbf43d2d...3fde1dce1f9058d4b57d17eac55051fb174c6aa4,1,2,2,4,2,2015-02-24 14:07:25,2015-02-18 17:10:22
3fde1dce1f9058d4b57d17eac55051fb174c6aa4...20691df230332022cb4d5008d84c7ee6e6c8dbfd,13,163,47,210,38,2015-02-24 14:07:25,2015-02-18 21:42:52
20691df230332022cb4d5008d84c7ee6e6c8dbfd...bc80efb1fd2978a328fdc89a3164f60bcf7ed604,2,9,4,13,5,2015-02-24 14:07:25,2015-02-21 10:07:35
bc80efb1fd2978a328fdc89a3164f60bcf7ed604...16c767814a921ab0d7ad3c551bb439a9e270f7b7,2,2,1,3,2,2015-02-24 14:07:25,2015-02-21 10:08:05
16c767814a921ab0d7ad3c551bb439a9e270f7b7...fcd3e626b085f6d16ff2c780093bafa898647a85,1,2,2,4,2,2015-02-24 14:07:25,2015-02-21 10:08:30
fcd3e626b085f6d16ff2c780093bafa898647a85...46bcf40b2cbc818837c855bebaef1b621e7c5283,2,3,3,6,3,2015-02-24 14:08:42,2015-02-24 14:08:42
46bcf40b2cbc818837c855bebaef1b621e7c5283...56f51bed6b166f12b8b0f4f1bd883142c5e079a6,1,28,4,32,4,2015-02-24 23:06:55,2015-02-24 23:04:48
7561b1c2a486ae57e9fbebadadbe1269bfdba6a0...63c4f3ca7665d076ea143991823ec99c8f996a73,2,3,3,6,3,2015-02-24 11:20:04,2015-02-24 11:20:04
7561b1c2a486ae57e9fbebadadbe1269bfdba6a0...71a844cdaee129d4e300c20cbb27db009cf81b73,7,53,9,62,16,2015-02-24 09:43:20,2015-02-14 16:18:05
71a844cdaee129d4e300c20cbb27db009cf81b73...3177693c6f47fda14f84abf0b8f694aec3e076fc,2,36,1,37,6,2015-02-24 09:43:20,2015-02-23 19:00:30
3177693c6f47fda14f84abf0b8f694aec3e076fc...53e404144c8ce9f602ec1e3a642d5d3971dc8217,4,3,2,5,3,2015-02-24 18:36:11,2015-02-24 18:24:30
ed3bd155fcd139ba1898fd4a29ff76924f6fe756...643afcbe00b766f786e6c7bac6cbd55870159df1,2,2,2,4,2,2015-03-02 22:02:09,2015-03-02 22:02:09
d899bc914f07ce47b5962563467790c25ba52c89...eccf695640680050127c830887631d241dc7c8be,6,49,6,55,7,2015-02-13 01:06:55,2015-02-13 01:06:55
eccf695640680050127c830887631d241dc7c8be...01c6806f804d9b76042229e11077190975eb8bf0,1,5,5,10,4,2015-02-13 16:56:25,2015-02-13 16:56:25
d899bc914f07ce47b5962563467790c25ba52c89...1a89db5ffbca432c14eae9d364debc5b87b4635e,2,24,1,25,2,2015-02-12 21:02:58,2015-02-12 21:02:58
1a89db5ffbca432c14eae9d364debc5b87b4635e...8a37435738423853654ec622d59fbb2048ad7a1e,1,1,1,2,1,2015-02-12 21:21:47,2015-02-12 21:21:47
417975ae2f0d5d87915aa448184494e0e8370edb...ff492307b9fb0cd0f016a358cbf1228392f764d1,2,12,3,15,4,2015-02-18 00:27:40,2015-02-18 00:27:40
417975ae2f0d5d87915aa448184494e0e8370edb...24d939afb9816f3de2ca247de82f96ca32de3612,4,3,4,7,6,2015-02-18 00:23:44,2015-02-18 00:23:44
417975ae2f0d5d87915aa448184494e0e8370edb...896c046217ab44e7e685f0c2ca2d4f3835d63d44,9,162,106,268,16,2015-02-18 00:14:49,2015-02-18 00:14:49
218283b368161130f43333e75629870c9649b319...7f1adc3d9cdc5c3f1c0fcbf6c72d89b8ee062af5,4,9,6,15,6,2015-02-20 15:01:37,2015-02-20 14:56:12
7f1adc3d9cdc5c3f1c0fcbf6c72d89b8ee062af5...2570e4df79fa09d3c4abc1d0ec82c67a322b249e,2,8,6,14,4,2015-02-20 15:55:38,2015-02-20 15:55:38
d0f045eb860f819a736d76622d8d9c546a9610ee...d76c5824bc05640d276be96f7853f2d266fd6750,6,168,81,249,42,2015-02-13 22:49:19,2015-02-13 22:49:19
d0f045eb860f819a736d76622d8d9c546a9610ee...f989190ed4ea3f9b03451918b55384a2e23fe3af,2,5,1,6,2,2015-02-13 21:36:59,2015-02-13 21:36:59
87b413592499ddcf1149d9e2b580f76a13bf625c...7d5f86f6cbd187e75a6ba164ad6bfd036977dd07,14,91,27,118,22,2015-02-16 19:10:15,2015-02-09 13:35:48
7d5f86f6cbd187e75a6ba164ad6bfd036977dd07...ebd39fc082b09177e0777e5de5729c3f98495e87,1,3,2,5,2,2015-02-16 19:10:15,2015-02-16 17:42:52
87b413592499ddcf1149d9e2b580f76a13bf625c...29a997cde978d45b3d6bd75df8f9226288e3abcb,1,1,1,2,1,2015-02-16 17:25:57,2015-02-16 17:25:57
87b413592499ddcf1149d9e2b580f76a13bf625c...2df8a91c8259711b3fb3d0ab3b31329aae869b96,8,12,12,24,12,2015-02-16 17:10:07,2015-02-16 17:10:07
37ed5837a82ec85e49bb5935c7e891b418b3da77...a0c4fa31741ed3b5f01eaec0cf02fae10c39a62d,1,0,8,8,2,2014-12-29 17:11:34,2014-12-29 17:11:34
2010ae11f3e2a9b930ebd075c019225356558e14...0930086bea914d4fd32c21706bcdcb3daf529561,2,1,5,6,2,2014-12-30 14:38:27,2014-12-30 14:38:27
757df0142f521380b92d28a721a7fd2bd8aa382f...d02a22ba21f91d2aa4f9cf716dc3aefcf7e7495e,10,148,107,255,31,2015-01-08 01:07:36,2015-01-08 01:07:36
757df0142f521380b92d28a721a7fd2bd8aa382f...703087b8bfb2e416cc429da28a4bf7b12743ff49,1,1,0,1,1,2015-01-07 22:59:22,2015-01-07 22:59:22
119ebe30a6efe8ce46c709853124aa5fd041d05b...c17e11ca27882c0a35e23eba72689f2fdb89680a,2,3,3,6,3,2015-03-05 19:35:36,2015-03-05 19:35:36
119ebe30a6efe8ce46c709853124aa5fd041d05b...38862308f003d39b660920c36e142b2ece0a4f70,1,21,20,41,1,2015-03-05 17:43:41,2015-03-05 17:43:41
8b551ee31858db9c5da1ff5245359151d5b71211...fc64b3f7b78fefde211caf56bb4f0b06edc0b045,3,5,5,10,5,2015-03-09 15:20:44,2015-03-09 15:20:44
8b551ee31858db9c5da1ff5245359151d5b71211...21aff22adb37af1fc16667e6691ed5346e72c9e1,1,1,1,2,1,2015-03-09 02:26:46,2015-03-09 02:26:46
8b551ee31858db9c5da1ff5245359151d5b71211...27e3b47b7f9ba6daaef61677c6743e99c3c6dc60,1,14,13,27,5,2015-03-09 00:35:49,2015-03-09 00:35:49
8b551ee31858db9c5da1ff5245359151d5b71211...bb7be246f6928368d0bdadfb7a3258d610d48252,1,4,4,8,4,2015-03-09 00:30:01,2015-03-09 00:30:01
bb7be246f6928368d0bdadfb7a3258d610d48252...bb9560a35a7860e6de44c51b6d2300f3ee1e27ae,1,4,4,8,4,2015-03-09 03:45:03,2015-03-09 03:45:03
8b551ee31858db9c5da1ff5245359151d5b71211...9b3e156e43b8a14e4eb294a47bda6a477c8573b0,7,16,16,32,9,2015-03-09 00:03:30,2015-03-09 00:03:30
9b3e156e43b8a14e4eb294a47bda6a477c8573b0...7e4258777f8eed31cfe202bb96178823218f3b1c,5,73,76,149,26,2015-03-09 03:52:22,2015-03-09 03:52:22
7e4258777f8eed31cfe202bb96178823218f3b1c...de11c13ac074baa2b63165a51c59f2925c0dff83,1,1,1,2,1,2015-03-09 05:39:37,2015-03-09 05:39:37
21d660a591c514196116bbc646c713aca23a8f68...46f94173248ed143a78fb9c3e2951501cd553d27,1,6,0,6,1,2015-03-04 21:43:52,2015-03-04 17:51:30
46f94173248ed143a78fb9c3e2951501cd553d27...02f17ce1b3233e5a35d68493b9f3cc03fb8d7c9f,1,1,0,1,1,2015-03-04 21:44:11,2015-03-04 18:16:13
02f17ce1b3233e5a35d68493b9f3cc03fb8d7c9f...00778c073130789e9f65e02e6fa6e8b987506c9e,1,5,4,9,2,2015-03-04 21:45:27,2015-03-04 21:45:27
8e7e77e4b61a1ca587b91b3ff65a26601eebcf7d...890f14786a49cb715d8856c1a6917003649796c5,1,4,1,5,2,2015-03-04 17:04:23,2015-03-03 23:35:07
8e7e77e4b61a1ca587b91b3ff65a26601eebcf7d...f04847a3c70c96c008498179f58db6aceb0c5d09,1,2,0,2,1,2015-03-04 15:24:12,2015-02-16 19:16:23
f04847a3c70c96c008498179f58db6aceb0c5d09...fe6fb32fe6cc9836f92e169f3e1f5bb3dae8ffc8,1,2,2,4,2,2015-03-04 15:24:36,2015-03-03 15:38:38
8e7e77e4b61a1ca587b91b3ff65a26601eebcf7d...af522ede14cad4605bc7f0137ddf6950974eccce,1,1,1,2,1,2015-03-04 15:22:26,2015-03-04 15:22:26
961971544abb4a98634a0602ec69c777e9443b4c...c572bdb587bada094af867839a60a26a1fc1423e,1,1,0,1,1,2015-03-10 19:10:26,2015-03-10 19:10:26
afb694886eccc1bad6abd900bede8699f2a10dff...141168ad3cf0ad2f79f0a5c64c29e7f95c2064b5,2,2,2,4,2,2015-03-14 00:14:34,2015-03-14 00:14:34
b8f5e23f270df85b32baa1fd6912b6a5eb334755...b09e8c771c19953cbebbce5b546d0d92ba9d623e,2,3,3,6,3,2015-03-13 16:47:50,2015-03-13 16:47:50
2fba31890e922fa8bae61e7aa3f21c5b4314e735...46755a7bfec1a35ff7967cf92ed8da3d911d32f0,1,1,1,2,1,2015-01-20 07:16:26,2015-01-20 07:16:26
2fba31890e922fa8bae61e7aa3f21c5b4314e735...1809b3ee36b38cd47504114dfb1fed53206ebd15,4,78,1,79,4,2015-01-19 19:18:00,2015-01-19 19:18:00
2fba31890e922fa8bae61e7aa3f21c5b4314e735...3d2aaa169ea7cfa8d416103c70711a440c716dd9,4,21,11,32,5,2015-01-19 14:18:08,2015-01-19 13:07:37
2fba31890e922fa8bae61e7aa3f21c5b4314e735...39e54e21cb5dfaddaf4c83bc4509c951675091ea,2,45,8,53,11,2015-01-19 13:13:30,2015-01-18 21:17:10
2fba31890e922fa8bae61e7aa3f21c5b4314e735...6bf58e76bd9b74239b668f09c1c38e89d5e53f11,2,2,2,4,2,2015-01-19 13:08:06,2015-01-19 11:55:05
f023db2b474ab53056bdff3d01675fb6388265cd...031461e1063040f61f80872de4394e763ec2dfa2,1,2,0,2,2,2014-12-23 08:52:21,2014-12-23 08:52:21
031461e1063040f61f80872de4394e763ec2dfa2...1440ac815435063330955a6c73ca5ba3b2304ba4,1,8,2,10,2,2014-12-23 09:05:50,2014-12-23 09:05:50
f023db2b474ab53056bdff3d01675fb6388265cd...59bb635e0e94a0e6c61a0c53cdb70a4eb7bd3910,2,9,24,33,4,2014-12-22 11:27:48,2014-12-22 11:27:48
59bb635e0e94a0e6c61a0c53cdb70a4eb7bd3910...ed2bcf952be8e6431ad5d3fb7b39927880b512b0,4,18,6,24,6,2014-12-22 11:50:58,2014-12-22 11:50:58
ed2bcf952be8e6431ad5d3fb7b39927880b512b0...52a8e5c01a2a5377dbd51587f8197c49b17430b3,1,1,1,2,1,2014-12-22 11:55:32,2014-12-22 11:55:32
52a8e5c01a2a5377dbd51587f8197c49b17430b3...1f2628fe2118642b467e93a362cebb11ca780a40,4,10,13,23,5,2014-12-22 13:02:47,2014-12-22 13:02:47
1f2628fe2118642b467e93a362cebb11ca780a40...d0b1bc222e7486bcb4877a7b8526b1646c2be0fc,1,1,1,2,1,2014-12-22 14:48:40,2014-12-22 14:48:40
d0b1bc222e7486bcb4877a7b8526b1646c2be0fc...fb7be3238d86501353863313af72563528ace76f,1,8,1,9,2,2014-12-22 15:09:48,2014-12-22 15:09:48
fb7be3238d86501353863313af72563528ace76f...f775809910a2c8ebec1887ec39ba33325d00171a,1,0,2,2,1,2014-12-22 17:11:15,2014-12-22 17:11:15
f023db2b474ab53056bdff3d01675fb6388265cd...e9f974dc12cb7ab37f1fc089f0525bd491572a5c,1,3,3,6,2,2014-12-17 06:49:43,2014-12-17 06:11:50
f023db2b474ab53056bdff3d01675fb6388265cd...c981d693380e5c5c0b66aa654e63cf653f1e5f42,1,1,1,2,1,2014-12-16 17:04:52,2014-12-16 17:04:52
8d71e4e0d0868de0659047f18cad08924a3ba49e...15303bbfd76ae91fcba6202c5449425cb3c99829,2,8,0,8,4,2014-12-16 11:57:40,2014-12-16 11:57:40
d531de0bc9f4b0fe535229a530410d2a3729d610...bc95576e2cbbd2def7a6fce1bde2d0263a3d7da1,1,8,4,12,1,2015-01-09 10:26:26,2015-01-09 10:26:26
7c5bf9372c09402ddb72e00eebf16c0807a2007c...99e52c9ad082a4a8f953bab9f41e023de5182c37,2,7,6,13,3,2014-12-25 12:58:43,2014-12-25 12:58:43
99e52c9ad082a4a8f953bab9f41e023de5182c37...fca161f5c50e282acf65e11decc86a35d5e43847,3,9,5,14,6,2014-12-25 13:55:12,2014-12-25 13:55:12
fca161f5c50e282acf65e11decc86a35d5e43847...40ff1bc8ba4969a47e805694ec11a367a15f23eb,1,3,2,5,3,2014-12-25 13:55:23,2014-12-25 13:55:23
a9cf84e5acf1385391279eaa49e9b0d34c3050b9...9f9f1b3b87431221e15b52c6385afbfa6fdb0723,1,2,2,4,2,2014-12-30 00:51:39,2014-12-29 20:20:22
a9cf84e5acf1385391279eaa49e9b0d34c3050b9...95cd5b275a3dcb442c5571814baafbfb90639a20,1,1,0,1,1,2014-12-29 20:59:08,2014-12-29 20:59:08
a9cf84e5acf1385391279eaa49e9b0d34c3050b9...b753bfd1456628a255cbe3cbf90067a68544bc8b,2,10,9,19,5,2014-12-29 19:29:59,2014-12-29 19:29:59
b753bfd1456628a255cbe3cbf90067a68544bc8b...25c37b0e73e4e5ee0168bc6c407d4dcd035299fa,1,1,1,2,1,2014-12-30 17:53:46,2014-12-30 17:53:46
e46f546b4cf0218dcec0771381d0718e0ba72f58...6ce3b1a31174a9f09dd34c114c7fb13d898db6ec,2,10,4,14,6,2014-12-26 08:07:02,2014-12-26 08:07:02
6ce3b1a31174a9f09dd34c114c7fb13d898db6ec...b7eb0d178e2a1e951ba6e110ad703def3fb35357,2,5,1,6,2,2014-12-26 08:14:53,2014-12-26 08:14:53
b7eb0d178e2a1e951ba6e110ad703def3fb35357...61b4214e94116501424e1c9daaeef32566453b13,2,6,0,6,2,2014-12-26 08:35:49,2014-12-26 08:35:49
61b4214e94116501424e1c9daaeef32566453b13...770b2a5cfbec1081756bfa2d8bf046b7b16bb638,1,20,12,32,2,2014-12-26 08:52:39,2014-12-26 08:52:39
770b2a5cfbec1081756bfa2d8bf046b7b16bb638...92eb3974ac28aff7c78f4ca0cbafbad842fc7160,4,27,3,30,6,2014-12-26 10:39:12,2014-12-26 10:39:12
92eb3974ac28aff7c78f4ca0cbafbad842fc7160...84af3ceb9bbcbf171f92d01967670bf079012f23,1,24,0,24,2,2014-12-26 10:41:04,2014-12-26 10:41:04
84af3ceb9bbcbf171f92d01967670bf079012f23...2cbfc515f22e2064fb29c9cbb8326a132a3515fc,2,42,32,74,5,2014-12-26 14:36:35,2014-12-26 14:36:35
2cbfc515f22e2064fb29c9cbb8326a132a3515fc...16ebeedef225db60e1f62d43e5152a04c29fd289,2,26,6,32,3,2014-12-26 14:37:04,2014-12-26 14:37:04
16ebeedef225db60e1f62d43e5152a04c29fd289...9fd061807e65d106bac4c42618aaf177cd58855d,1,17,15,32,3,2014-12-26 14:55:58,2014-12-26 14:55:58
9fd061807e65d106bac4c42618aaf177cd58855d...78865a0c993f72c470e67ccb40f7b8d87ad50878,2,15,8,23,4,2014-12-26 16:16:38,2014-12-26 16:16:38
78865a0c993f72c470e67ccb40f7b8d87ad50878...1c089a8561556377dccbf661a3016cac2329c713,1,1,1,2,1,2014-12-29 08:04:31,2014-12-29 08:04:31
ed932d82db3bf9d3e557c289ed2ccfbc99ab5083...b01c5d993c10704c5097d9eaba24ef849fe3a46d,1,3,3,6,3,2014-12-25 19:31:04,2014-12-25 19:31:04
6cf501004b54c1b311ea7c6c364cfb4a88c1060b...3d2f12308198417a9cbda095a602e9252407732e,1,1,1,2,1,2014-12-29 11:31:30,2014-12-29 11:31:30
6cf501004b54c1b311ea7c6c364cfb4a88c1060b...eae5f544cd232e49fa8df8e85a41d746224816ce,1,1,1,2,1,2014-12-28 21:52:17,2014-12-28 21:52:17
c7db2661a5d7c6bf14479c18e808d1d8c619a95c...2f13d4daa30433b9db168f291d870260e401e44a,5,144,18,162,8,2014-12-12 19:49:51,2014-12-12 19:49:51
2f13d4daa30433b9db168f291d870260e401e44a...6ef75dc77854133db0ef90c30f1a07575692b801,1,37,6,43,5,2014-12-12 20:13:59,2014-12-12 20:13:59
6ef75dc77854133db0ef90c30f1a07575692b801...5f63c00598a9ec79dc03fe016b525b73fcb78112,3,14,8,22,5,2014-12-15 15:46:36,2014-12-15 15:46:36
5f63c00598a9ec79dc03fe016b525b73fcb78112...5f797be0e8a8e5372aea439be05f25ff88fe3cbf,3,16,13,29,7,2014-12-15 16:06:03,2014-12-15 16:06:03
5f797be0e8a8e5372aea439be05f25ff88fe3cbf...7b71a9e2212c72b21ca38fa82237c1c51d2aa6ff,3,40,6,46,13,2014-12-15 18:00:44,2014-12-15 18:00:44
7b71a9e2212c72b21ca38fa82237c1c51d2aa6ff...f3f27fee88a30899564ed32a2968b0ac8e31451f,11,98,84,182,27,2014-12-16 14:58:15,2014-12-16 14:58:15
f3f27fee88a30899564ed32a2968b0ac8e31451f...06a219baa5130479bf2ee31f26c138509679c562,7,49,95,144,11,2014-12-16 16:15:48,2014-12-16 16:15:48
06a219baa5130479bf2ee31f26c138509679c562...eb2face2cb8c0f7d4cae5c3423162f27c7fc02b1,5,31,33,64,11,2014-12-17 10:20:05,2014-12-17 10:20:05
eb2face2cb8c0f7d4cae5c3423162f27c7fc02b1...51ee71d8e0912656b46dcc4d3add7c2aabd2ead3,5,28,16,44,7,2014-12-17 10:26:33,2014-12-17 10:26:33
51ee71d8e0912656b46dcc4d3add7c2aabd2ead3...d6eda842a9094929423a0c43f3db76c0621603bf,3,35,15,50,13,2014-12-17 10:44:36,2014-12-17 10:44:36
d6eda842a9094929423a0c43f3db76c0621603bf...c0d589dedb15548aabad88855fd6c340b348cf5b,1,7,3,10,4,2014-12-17 11:10:58,2014-12-17 11:10:58
c0d589dedb15548aabad88855fd6c340b348cf5b...b667a45942a230b86c21f47897de5a787015059f,10,256,380,636,37,2014-12-18 15:22:10,2014-12-18 15:22:10
b667a45942a230b86c21f47897de5a787015059f...abd83baeab474764030f1daa7c7ca3335ca91d98,2,11,8,19,3,2014-12-20 22:23:17,2014-12-20 22:23:17
abd83baeab474764030f1daa7c7ca3335ca91d98...bcc04adb1342155d4ec2b670702406285145cb32,25,60,274,334,39,2014-12-20 23:11:08,2014-12-20 23:11:08
c7db2661a5d7c6bf14479c18e808d1d8c619a95c...de7c3291e9e7d4a8f542c912c7575ec97a3a78df,1,9,3,12,4,2014-12-09 20:44:13,2014-11-20 06:29:56
c7db2661a5d7c6bf14479c18e808d1d8c619a95c...82eb0a44d7afa3b6ab77b8f7c9386740496a72e1,1,63,0,63,2,2014-12-09 13:51:15,2014-12-09 13:51:15
c7db2661a5d7c6bf14479c18e808d1d8c619a95c...8b6a2829ce400dda594500d2a8822dfdb11d8781,1,1,1,2,1,2014-12-08 23:04:34,2014-12-08 23:04:34
93dde8a312dbe2359c020c582d84cfd35a1085fe...138aa81e60f18214e0a95a6ffc6ec1ddbc27925a,2,2,1,3,2,2015-02-18 22:20:26,2015-02-18 22:20:26
138aa81e60f18214e0a95a6ffc6ec1ddbc27925a...833d4dddf2fc3a933a28b4deb60ef6a3dc7eb0fb,1,0,2,2,1,2015-02-18 22:34:05,2015-02-18 22:34:05
833d4dddf2fc3a933a28b4deb60ef6a3dc7eb0fb...558dd811971776fc4a921b79296f5d792b245686,4,7,4,11,5,2015-02-18 22:58:20,2015-02-18 22:58:20
558dd811971776fc4a921b79296f5d792b245686...716544085ce3d100f466103ba5d7c00a771ba6ca,1,1,0,1,1,2015-02-18 23:16:13,2015-02-18 23:16:13
0f7d47f695afa051374996cb1c72bc3ec55820c5...a9761ac1b86275397f36e484f02ab7e87eb1ff05,2,43,2,45,4,2014-12-20 22:20:29,2014-12-20 20:55:55
eb12e3ab56eecb05ea2847b414554266cfb2947c...4f9a14061b707f39d8a98dae328089bbfbc09e70,1,33,15,48,6,2014-12-05 16:29:34,2014-12-05 16:29:34
4f9a14061b707f39d8a98dae328089bbfbc09e70...3dd86b83baccc2a2aecc12a1f4a4819438c62a81,1,13,26,39,9,2014-12-08 12:19:31,2014-12-08 12:19:31
3dd86b83baccc2a2aecc12a1f4a4819438c62a81...2fcef3278ce4ccb62cefa590b0f65509028fbcc0,1,1,1,2,1,2014-12-08 12:39:18,2014-12-08 12:39:18
2fcef3278ce4ccb62cefa590b0f65509028fbcc0...b8dfd63eacc26bb2ef6a900b75e794c33cf2c9ca,1,1,1,2,1,2014-12-08 12:39:25,2014-12-08 12:39:25
eb12e3ab56eecb05ea2847b414554266cfb2947c...7cefd9c6ef4fbbd8eb297ac03e2fa3e43c44f1a1,1,4,3,7,2,2014-12-05 16:10:25,2014-12-05 16:10:25
7cefd9c6ef4fbbd8eb297ac03e2fa3e43c44f1a1...4491a3d12b414a52f32175e328df8dc48987d0fd,1,12,3,15,2,2014-12-05 16:17:51,2014-12-05 16:17:51
eb12e3ab56eecb05ea2847b414554266cfb2947c...ed2eaf55c1c2402a0a630838901bdddbc11fda47,3,52,99,151,3,2014-12-05 14:59:17,2014-12-05 14:59:17
ed2eaf55c1c2402a0a630838901bdddbc11fda47...e0f30c605bbf0a92f3ddeffdd80d765a5f041a06,5,62,23,85,10,2014-12-05 15:13:07,2014-12-05 15:13:07
e0f30c605bbf0a92f3ddeffdd80d765a5f041a06...c8a96d8ab05333b75a2215a7330fc4296c480f40,1,52,29,81,6,2014-12-05 15:25:22,2014-12-05 15:25:22
05d713be1900988bfff9cc5a94c490519add4a62...a46fe875c6aea206e575e2b083bd31ed36ee1b1e,6,90,4,94,7,2014-12-04 19:49:19,2014-12-04 19:49:19
0a9cab4ee65f2b42c56989698c401cab60d68b53...639c93b4f2bd492a214065b5fdc47da2f5d8614d,4,5,4,9,5,2015-02-06 10:23:12,2015-02-06 10:21:42
0a9cab4ee65f2b42c56989698c401cab60d68b53...dbca8c97588d1fcc4155b079eb54157991be3aa7,2,13,6,19,7,2015-02-05 21:23:32,2015-02-05 21:23:32
dbca8c97588d1fcc4155b079eb54157991be3aa7...62ed1c537e9b8aa85d354b377f18083fb71b8e05,22,67,16,83,31,2015-02-05 22:20:55,2015-02-05 22:20:55
62ed1c537e9b8aa85d354b377f18083fb71b8e05...e0aa5c371ea1c633a0648f13cd7bea35f3aea75c,5,5,3,8,6,2015-02-06 00:49:41,2015-02-06 00:49:41
e0aa5c371ea1c633a0648f13cd7bea35f3aea75c...bbca6a0abd9f5559fe4abbf2cb2100a0e4717ac8,18,195,108,303,57,2015-02-06 03:15:05,2015-02-06 03:15:05
bbca6a0abd9f5559fe4abbf2cb2100a0e4717ac8...c5be267e40c0ba05c2a7de6a71d154f1b5161160,5,19,11,30,11,2015-02-06 04:21:21,2015-02-06 04:21:21
c5be267e40c0ba05c2a7de6a71d154f1b5161160...8952fc015fae476a20051c01cf4217d82d30c83d,7,7,9,16,8,2015-02-06 04:29:41,2015-02-06 04:29:41
8952fc015fae476a20051c01cf4217d82d30c83d...bdfb349ff70f0fde6d4dc7b4317c3bc7ead580a4,8,100,62,162,26,2015-02-06 06:00:54,2015-02-06 06:00:54
bdfb349ff70f0fde6d4dc7b4317c3bc7ead580a4...f9e6f668981f6f57d41c34d68a84879a48593269,3,27,22,49,22,2015-02-06 06:40:35,2015-02-06 06:40:35
f9e6f668981f6f57d41c34d68a84879a48593269...ce0811ae5cf2c69ccf24e101b1ec1554a42e9856,2,5,5,10,4,2015-02-06 17:19:51,2015-02-06 17:19:51
0a9cab4ee65f2b42c56989698c401cab60d68b53...71668312c42426ed23e46c9a79f93e329f2b6625,2,2,2,4,2,2015-02-05 20:56:25,2015-02-05 20:56:25
0a9cab4ee65f2b42c56989698c401cab60d68b53...5194214e3a2f97accf0c8119b4cb39fd4fcef5db,23,514,16,530,30,2015-02-05 20:50:34,2015-01-27 23:37:19
5194214e3a2f97accf0c8119b4cb39fd4fcef5db...7ddba92a394b5e5fd67eda50b6ee25b38e53e7b9,2,26,1,27,2,2015-02-05 20:50:34,2015-02-02 21:52:44
7ddba92a394b5e5fd67eda50b6ee25b38e53e7b9...18231b0bb353fffa77b492e4b04fa61c9b3a25bb,5,6,6,12,6,2015-02-05 20:50:34,2015-02-02 22:26:29
18231b0bb353fffa77b492e4b04fa61c9b3a25bb...713bc152bde5396bb95a1555907bcd9a2847839d,2,2,2,4,2,2015-02-05 20:50:34,2015-02-02 22:45:03
713bc152bde5396bb95a1555907bcd9a2847839d...33349dd54928a0b074b4ae3ebfabf214799fc085,16,52,32,84,35,2015-02-05 20:50:34,2015-02-03 01:01:07
33349dd54928a0b074b4ae3ebfabf214799fc085...592ed8738cccd68ced1c2fbf58d0ff16d66e8d14,2,3,3,6,3,2015-02-05 20:50:34,2015-02-03 02:25:33
592ed8738cccd68ced1c2fbf58d0ff16d66e8d14...3d943d966d7383bb1c4988cc3f0c00b49aa14ec9,1,2,0,2,1,2015-02-05 20:50:34,2015-02-03 17:18:32
3d943d966d7383bb1c4988cc3f0c00b49aa14ec9...93585661b1699384060616f0a19433ededadf3fe,1,1,1,2,1,2015-02-05 20:50:34,2015-02-03 17:42:56
93585661b1699384060616f0a19433ededadf3fe...2d5765bd2ca9b7ce3e4251cb082cbc8c52e51996,1,2,2,4,2,2015-02-05 20:50:34,2015-02-03 18:34:38
2d5765bd2ca9b7ce3e4251cb082cbc8c52e51996...1ac20698a5122111c8e12de4cc59da837b0f9573,14,85,140,225,18,2015-02-06 01:03:43,2015-02-05 18:31:36
0a9cab4ee65f2b42c56989698c401cab60d68b53...58ecb06f74f9aa6af46f7110cb5753e1f30790cd,2,4,4,8,4,2015-02-05 20:26:57,2015-02-05 20:26:57
0a9cab4ee65f2b42c56989698c401cab60d68b53...485e55f88c6f2a50f1d88188a015fb1572f8bd94,6,27,39,66,10,2015-02-05 18:12:47,2015-02-05 14:56:58
49a5159946bc8added6258f62efcf7674e4b0562...68436e964fa1220c3fa040fa501324a729eabb70,1,7,0,7,1,2014-04-04 08:19:40,2014-04-04 08:19:40
49a5159946bc8added6258f62efcf7674e4b0562...04324908fb14fe2bb0600a164a60870100122d3f,3,7,1,8,3,2014-04-04 07:36:25,2014-04-04 07:36:25
49a5159946bc8added6258f62efcf7674e4b0562...6205b068cd9318732d05a19002bf3e9920ddc0a4,1,2,10,12,2,2014-04-04 06:05:09,2014-04-04 06:05:09
b8d31483113c6b0583a4d838e08ba9d4154d4b02...7c5b61224a040ed6489633ab5efd033c26bd2469,1,1,1,2,1,2014-04-23 13:50:05,2014-04-23 13:50:05
7c5b61224a040ed6489633ab5efd033c26bd2469...2134e18ec64222e60aa0d8947a5d9e265c6e4975,1,1,0,1,1,2014-04-23 14:19:59,2014-04-23 14:19:59
2134e18ec64222e60aa0d8947a5d9e265c6e4975...e54b457ea31eff54d031b7092a2a78dc81c69a63,1,2,2,4,2,2014-04-23 14:22:49,2014-04-23 14:22:49
d89f26e0112a8bb4a3e75c51d08a3c22dbfe1753...2eaca5453654f4c5e773067f303d6002268cd06e,1,4,0,4,1,2014-04-24 17:53:00,2014-04-24 17:53:00
2eaca5453654f4c5e773067f303d6002268cd06e...7e10d1017819ea0be41887803e9b4d6edd92bf49,2,30,2,32,2,2014-04-24 17:53:18,2014-04-24 17:53:18
5ea31c7f74c816a1ea53839bc828360e7d57abf8...665a69941bed38139c38d1142e7dec2c6cd1b517,1,1,1,2,1,2014-04-08 11:05:57,2014-04-08 11:05:57
24934c9b13a66f1746479c419fd253ced6bd75b2...b82140c6a4f23451f88c0fff113eab1f8fc2fa24,2,39,37,76,24,2014-04-08 11:59:22,2014-04-08 08:20:39
b82140c6a4f23451f88c0fff113eab1f8fc2fa24...3aee31c00dfc1eccfc95543b80ee37a153cfb4bf,1,1,1,2,1,2014-04-08 12:14:16,2014-04-08 12:14:16
3aee31c00dfc1eccfc95543b80ee37a153cfb4bf...684877acc4786bc3b641797644ba0d19cd1f2399,1,1,1,2,1,2014-04-08 12:58:28,2014-04-08 12:58:28
f5b7899cf755dae81a1ba0f0ad428209e808c5d7...55cf6243a4959449d253003cff15d4e0978d08f9,1,1,1,2,1,2014-04-09 15:46:22,2014-04-09 15:27:34
797813b98f8c1b412bde18aff6f666af1c2bc819...12c49dd989b8a46a5412e04e46cb53c0f519d254,1,4,6,10,2,2014-04-09 05:58:57,2014-04-09 05:58:57
fc6517f1da4dec8c43ab18c4790f3b9b1fcb1208...f34972358c235a3bdd6b688a8303acd9f888d33f,1,3,3,6,1,2014-04-14 17:01:18,2014-04-14 15:59:22
3657e951956fd5cbeb42c14e6df9af645da3067e...5ac015664d6bc06fec5c3d16b9c5a08c8957d453,1,3,9,12,3,2014-04-27 12:25:35,2014-04-27 12:25:35
3657e951956fd5cbeb42c14e6df9af645da3067e...a5e20638c2ca2317f88261cd627b2d8453e4445e,4,4,4,8,4,2014-04-27 09:36:45,2014-04-27 09:36:45
3657e951956fd5cbeb42c14e6df9af645da3067e...292c3c210b0b1fd932e8fad079e0d990e3d87039,1,0,1,1,1,2014-04-26 21:16:50,2014-04-26 21:16:50
3657e951956fd5cbeb42c14e6df9af645da3067e...25cc5fbf78196ba0629f72b4c37ed7f9d3b5eb53,1,1,1,2,1,2014-04-26 01:43:24,2014-04-26 01:43:24
3657e951956fd5cbeb42c14e6df9af645da3067e...4618ec8791b10a9a98587e9a22b647581ac25543,1,2,2,4,2,2014-04-25 20:31:30,2014-04-25 20:31:30
ad61a61304ea422462ef1f7e71da7f71d91f60b9...bc732a89bea1ffffe0d2821e7f1c4bfc81c47e2c,1,1,1,2,1,2014-04-18 10:35:38,2014-04-18 10:35:38
ad61a61304ea422462ef1f7e71da7f71d91f60b9...b9e040f8bfbf7723120a35786dbeedc6e8bcc9c4,1,1,1,2,1,2014-04-18 08:03:57,2014-04-18 08:03:57
b9e040f8bfbf7723120a35786dbeedc6e8bcc9c4...eadcd278bedd4d83a9e0e5b0bb6285cccc16ac7f,1,34,0,34,1,2014-04-18 08:10:40,2014-04-18 08:10:40
eadcd278bedd4d83a9e0e5b0bb6285cccc16ac7f...f0f0ac6321310e2d31a67b9025a49b80df5417f3,1,0,2,2,1,2014-04-18 08:39:04,2014-04-18 08:39:04
e026491d533d96d58a98ac9dcb13f0b710c689a4...99e0d0dd6f9d1a6b66c5322f142e6dd008f62ebd,2,8,6,14,3,2014-05-07 09:52:07,2014-05-07 09:52:07
e026491d533d96d58a98ac9dcb13f0b710c689a4...fa7d0e3ae0bcc1f2aa4a46b0ca3b80e78d3c3c46,1,9,8,17,2,2014-05-07 09:21:02,2014-05-07 09:21:02
fa7d0e3ae0bcc1f2aa4a46b0ca3b80e78d3c3c46...c9104fa6e435a713dcdeb6de9db15079b4851aa7,1,28,11,39,6,2014-05-07 11:26:49,2014-05-07 11:26:49
c9104fa6e435a713dcdeb6de9db15079b4851aa7...18529269c6adf102d2e521bd5241794ea2347b55,1,3,7,10,1,2014-05-07 11:43:07,2014-05-07 11:43:07
18529269c6adf102d2e521bd5241794ea2347b55...97eb2240b1e401bf75408b9cc6b1560bc52ab849,1,0,8,8,1,2014-05-07 11:52:43,2014-05-07 11:52:43
e026491d533d96d58a98ac9dcb13f0b710c689a4...14102fd2112dba60795421726bbf6d59dac273da,1,0,5,5,1,2014-05-06 17:14:00,2014-05-06 17:14:00
536b2f2f75d384446e4d3d103903a6ff909bd4da...da9b009d31ee342d96da7b8796b937849de650cd,1,7,3,10,3,2014-05-08 11:06:47,2014-05-06 21:28:21
172ad9624599647df5682f7f2a9d2d74d947d068...d1980adf93e417850fcd3bac8caed1f2c9da7fb4,2,2,2,4,2,2014-05-22 08:35:01,2014-05-22 08:35:01
172ad9624599647df5682f7f2a9d2d74d947d068...5f25cdfe19c7c0a8c1ada592307e9017e2a754e1,15,142,17,159,26,2014-05-13 11:41:36,2014-04-15 01:12:07
172ad9624599647df5682f7f2a9d2d74d947d068...ad0f5fdc2729ac26268c2638c064abbf14134688,9,119,59,178,21,2014-05-05 10:03:37,2014-03-27 22:05:15
172ad9624599647df5682f7f2a9d2d74d947d068...73801a746362e4c284f323e415c1853eed77ba56,1,3,0,3,1,2014-05-05 08:04:52,2014-05-05 08:04:52
bf855d19cb2a45e480270789b5a8eebb0ba98f32...d1648a6a2150c26c12a4f108040676a49627b8a0,1,2,1,3,2,2014-04-23 18:58:58,2014-04-23 18:58:58
bf855d19cb2a45e480270789b5a8eebb0ba98f32...7dd0860e5a9d0a1758732742999190890ac33d48,1,0,3,3,3,2014-04-23 15:02:25,2014-04-23 07:01:43
bf855d19cb2a45e480270789b5a8eebb0ba98f32...baec3f9bd76f4780e66b1055433948427e30cc6d,1,1,1,2,1,2014-04-23 06:57:54,2014-04-23 06:57:54
bf855d19cb2a45e480270789b5a8eebb0ba98f32...4134b38a8487bf28ac0a79f073e8136eabf7708c,1,2,2,4,3,2014-04-22 22:06:16,2014-04-22 22:06:16
bf855d19cb2a45e480270789b5a8eebb0ba98f32...5a521e56cbdb4fe12af3648dccec9a25938b7c37,1,2,0,2,2,2014-04-22 15:21:32,2014-04-22 15:21:32
bf855d19cb2a45e480270789b5a8eebb0ba98f32...2a944b1d9f7a20899363e5cd90cacc83dec0954f,1,5,4,9,1,2014-04-22 13:35:09,2014-04-22 13:35:09
e2843373075933f43d714f32e6a5d62e08128ad1...af2a39470f6c7e548355d5f839a9251620a870ec,2,2,30,32,3,2014-04-30 13:00:49,2014-04-30 13:00:49
9eeb96846fc9ba71367c1af95b1c547fe24ea1b6...469077e55dab70dd392eb7a62d6a8c6764d6d784,1,4,0,4,1,2014-05-01 07:14:52,2014-04-30 10:04:11
9c4ed864d53a60273fd1de08acb63246fb42967c...7cc8459d439c58b300ce970caa5d1f2ae2675e01,1,23,0,23,1,2013-11-25 09:47:55,2013-11-25 09:47:55
7cc8459d439c58b300ce970caa5d1f2ae2675e01...f74d4f20f234b8833628a2bc044cea2d1e953811,2,22,24,46,17,2013-11-25 10:32:47,2013-11-25 10:32:47
9c4ed864d53a60273fd1de08acb63246fb42967c...d1a87f3db074aa9764972cae496d10400aa8072f,1,2,2,4,2,2013-11-25 08:59:26,2013-11-25 08:59:26
9c4ed864d53a60273fd1de08acb63246fb42967c...f10a156669e5241a4390b432e82aea5ca76a71fe,1,1,1,2,1,2013-11-24 20:38:11,2013-11-24 20:38:11
b75777fd95ac7e432a6f576c018b8285efffbca4...53bdcb53ae8891225de6c3b295a8c3f964725b81,2,6,5,11,4,2014-01-29 13:48:59,2014-01-29 13:48:59
b75777fd95ac7e432a6f576c018b8285efffbca4...e2e900a338894010e7ba4dac89fa7b926803a977,1,3,1,4,1,2014-01-28 21:10:36,2014-01-28 21:10:36
b75777fd95ac7e432a6f576c018b8285efffbca4...3671984b24209b7a6c2516fcaf61d19bbd4c8b71,3,128,17,145,7,2014-01-28 15:10:25,2014-01-28 15:10:25
3671984b24209b7a6c2516fcaf61d19bbd4c8b71...794461c83591ba75e8e10dd2e4401aeadd31b63b,1,4,4,8,4,2014-01-29 02:21:15,2014-01-29 02:21:15
794461c83591ba75e8e10dd2e4401aeadd31b63b...3235d2c342ce6c22aa821d330c585467614eb961,1,1,1,2,1,2014-01-29 03:12:51,2014-01-29 03:12:51
3235d2c342ce6c22aa821d330c585467614eb961...2dc4179d7f43b7fc89a8427ccb83b8f3e5809c51,1,7,13,20,3,2014-01-29 14:17:36,2014-01-29 14:17:36
2dc4179d7f43b7fc89a8427ccb83b8f3e5809c51...d030f62e4b2cbeab342e6aa419d71d9d0f8515fc,1,6,1,7,2,2014-01-29 14:17:58,2014-01-29 14:17:58
c3ae30b60edd40f30c10e69532ecf8833cd0440f...c62892b225fe219cca1735e1817b3cca8714d3fa,1,1,1,2,1,2014-01-27 13:27:47,2014-01-27 13:27:47
c3ae30b60edd40f30c10e69532ecf8833cd0440f...ac2038b0c94abbc03fec3ef11f0efbe5f508d7d9,2,11,2,13,3,2014-01-27 13:16:13,2014-01-27 13:16:13
c3ae30b60edd40f30c10e69532ecf8833cd0440f...f591e4a48c662f2ed5a5c1f3e1ed92d7ad2cd1fb,1,6,6,12,4,2014-01-27 12:51:01,2014-01-27 12:51:01
29bfe34521a3a2ddf16ae954706e355ea0ee6e4a...32e18169e8482761bd87a9b1e07c3ff7188cc4ad,1,1,1,2,1,2013-12-12 16:30:32,2013-12-12 16:30:32
2ca4e70894229d9a7920f7539b9390bc43159b73...440f3f384f1ef03a8911b6d6ff3e4a21c3308adf,3,123,0,123,3,2013-12-13 13:18:57,2013-12-13 13:18:57
440f3f384f1ef03a8911b6d6ff3e4a21c3308adf...99830bb6f882672159fe53c96667942ce6fe1c1e,1,1,4,5,2,2013-12-13 13:22:27,2013-12-13 13:22:27
99830bb6f882672159fe53c96667942ce6fe1c1e...51c9f0fd76b4e88121c670e04b87f21b732bdeae,1,5,1,6,1,2013-12-13 14:17:54,2013-12-13 14:17:54
51c9f0fd76b4e88121c670e04b87f21b732bdeae...c638ef334848e1cd94cb2e4dbff07d3d227d1b77,1,1,1,2,1,2013-12-13 14:23:58,2013-12-13 14:23:38
edd95a0e74eecf88858e0806057df6cb003ab046...416c25871dcf8680ccf1af5da91fe0004e59eb05,2,2,1,3,2,2014-01-21 10:36:50,2014-01-21 10:36:50
2940785c179702acb7b7b333740d93d2ac0e6c8b...e19d05ddd6542dee7ebe7ce0ccadebb9f71ea1c0,1,4,4,8,1,2014-01-14 19:07:59,2014-01-14 19:07:59
e19d05ddd6542dee7ebe7ce0ccadebb9f71ea1c0...ea9ea3fe928e3cca8b297edd4ba0c38bcb424c0b,2,4,2,6,2,2014-01-14 19:15:17,2014-01-14 19:15:17
2940785c179702acb7b7b333740d93d2ac0e6c8b...ff8f8eae9c3b1a1769cd934edee050e18fa4831e,1,1,1,2,1,2014-01-14 18:58:47,2014-01-14 18:58:47
4742dba4c555dc9acc232c31e1066736943ef9fd...69ff7657d7741558eff120eb9dfde1c5cab87609,1,2,2,4,2,2014-01-23 07:23:58,2014-01-23 07:23:58
4742dba4c555dc9acc232c31e1066736943ef9fd...7c3a705365bbf014ba6ccf2125c8ea6a6679d40d,1,2,3,5,3,2014-01-23 02:01:02,2014-01-23 01:46:01
4742dba4c555dc9acc232c31e1066736943ef9fd...2b829aebc7d38b398b0344972f62eda64fb7cade,1,2,2,4,2,2014-01-22 19:31:48,2014-01-22 19:31:48
3fb22a1e51037cdb4a7b6fa28462461db558f57f...3ff27c4b1b69a83aff35b95dcf145bffd16651dd,1,1,1,2,1,2014-01-22 16:46:40,2014-01-22 16:46:40
3fb22a1e51037cdb4a7b6fa28462461db558f57f...3ba40f03ad4c5ba1de10a07e1acc09852858848c,1,2,0,2,1,2014-01-22 16:37:01,2014-01-22 16:37:01
3ba40f03ad4c5ba1de10a07e1acc09852858848c...a4f2da4763cbb84c649146bc3befbf0caa1c26e1,1,1,1,2,1,2014-01-22 16:38:36,2014-01-22 16:38:36
ced4a37a186601b37121c19523955b96767d9af5...5cc830d3db1565492584021deebe749a545e6c0d,1,1,1,2,1,2014-01-25 09:48:36,2014-01-25 09:48:36
ced4a37a186601b37121c19523955b96767d9af5...05c38ab8e0f3aa7994eb7000a6f70d77de6b40ad,1,0,7,7,1,2014-01-25 08:04:33,2014-01-25 08:04:33
ced4a37a186601b37121c19523955b96767d9af5...39a2adf4f49981dda9ab3e0d6a23b74acccbe128,3,5,9,14,4,2014-01-25 03:14:05,2014-01-25 02:59:42
ced4a37a186601b37121c19523955b96767d9af5...71c157e43b8bc2adfb2a01ee7cbad0baa5bd98bd,4,1,12,13,4,2014-01-25 02:06:44,2014-01-25 02:06:44
2d9667df264dae9a11fe58f8320a716d61e48e06...72801b864e048c984095b62054b5c7fafe087ff2,1,1,0,1,1,2014-06-24 13:07:27,2014-06-24 13:07:27
2d9667df264dae9a11fe58f8320a716d61e48e06...f40e87a03bdaaafa72e5afede57581d6c54dc506,2,16,5,21,4,2014-06-24 12:30:29,2014-06-24 10:57:41
f40e87a03bdaaafa72e5afede57581d6c54dc506...49c9e8ec02e5219cf984da61de52352ec5775c98,2,10,1,11,3,2014-06-24 12:30:29,2014-06-24 12:16:52
49c9e8ec02e5219cf984da61de52352ec5775c98...308b11a5b7aca22a35fc9c4b06593be0fca5d6cc,1,12,0,12,1,2014-06-24 12:30:29,2014-06-24 12:19:40
308b11a5b7aca22a35fc9c4b06593be0fca5d6cc...8307704c2dec2059089b9bf4acbd231e0fe0c8e2,8,33,27,60,9,2014-06-24 12:57:38,2014-06-24 12:57:38
2d9667df264dae9a11fe58f8320a716d61e48e06...1817b9aec424388b3667b4a744dd1288eec3560f,1,1,1,2,1,2014-06-24 12:12:08,2014-06-24 12:12:08
2d9667df264dae9a11fe58f8320a716d61e48e06...a49d45db419bcba4cb80919bdb3e1699725b15ce,5,21,15,36,6,2014-06-24 10:34:46,2014-06-24 10:34:46
a49d45db419bcba4cb80919bdb3e1699725b15ce...8c67c339dc631a6458d87deed7ce011562bb5e2a,1,2,0,2,1,2014-06-24 10:35:50,2014-06-24 10:35:50
e36baaddcdbf705a4a19d818f91edcb424bf941c...eb0590b063fa4ac2fa24e884b76747838e6a631c,3,14,3,17,6,2013-08-02 09:15:30,2013-08-02 09:15:30
eb0590b063fa4ac2fa24e884b76747838e6a631c...6af4223a27555b4a1e4471fdc7829071ab0db9e1,1,1,1,2,1,2013-08-02 09:49:20,2013-08-02 09:49:20
13e073e45be6b3c9357ffbb45e843782b9be79d9...72dd8011a739356ee66d90a0bb3adcb865495464,2,15,18,33,11,2013-09-27 13:25:24,2013-09-27 13:25:24
13e073e45be6b3c9357ffbb45e843782b9be79d9...06903b0396572ce0971a9fa5ad0bd2d0c9bf3715,1,3,0,3,1,2013-09-27 12:39:38,2013-09-27 12:39:38
06903b0396572ce0971a9fa5ad0bd2d0c9bf3715...b688bac9b6ca02571ed9fb3149e5b3bb6052c9fb,1,7,1,8,1,2013-09-28 11:40:48,2013-09-28 11:40:48
b688bac9b6ca02571ed9fb3149e5b3bb6052c9fb...e99701fbfa6d5a2d4abd9cc1321a3575c86c85ea,2,4,4,8,4,2013-09-29 17:46:02,2013-09-29 17:46:02
e3f361faedc24dcfc1a5b57f0913ecb2dbb89247...ff765bb27ea405b85804348e0c9458519a87ee6a,2,0,35,35,2,2013-09-26 12:56:05,2013-09-26 12:56:05
ff765bb27ea405b85804348e0c9458519a87ee6a...8063672adda8cda6765a2c7691c403217985d1fc,1,3,0,3,3,2013-09-26 13:00:11,2013-09-26 13:00:11
8063672adda8cda6765a2c7691c403217985d1fc...12dd7d2a9ab3066085572e0a47425a0442dd07ab,2,14,0,14,4,2013-09-26 16:05:55,2013-09-26 16:05:55
12dd7d2a9ab3066085572e0a47425a0442dd07ab...a85c58c736911b9b98c11fbf44391b43b0c91611,1,0,1,1,1,2013-09-26 16:22:04,2013-09-26 16:22:04
a85c58c736911b9b98c11fbf44391b43b0c91611...5e843a176982ed78cc2a6cf28618839e130cf608,3,26,15,41,6,2013-09-26 16:46:31,2013-09-26 16:46:31
01c8aae8f25555788049fd3537cb3251bcb5801a...c4bf88f96f31b0ff73939702b137f79383d28d1d,1,7,3,10,4,2013-08-26 15:06:15,2013-08-26 07:09:53
f834385a1dba246b942429806667ec8f828acc85...b1358639c8943a1e3a4e46e08a429a0f4a29ecf1,1,2,1,3,2,2013-08-25 18:47:04,2013-08-23 09:34:08
21e3d848b464f8cabbbddb3d2d4e2b697d4476b0...45280499b8d0135ad7a2d088e24bae1eddd7eb74,1,2,1,3,1,2013-08-27 01:54:09,2013-08-27 01:54:09
21e3d848b464f8cabbbddb3d2d4e2b697d4476b0...6f70d6977aa60ed7166726b0cb19035b77ca955d,2,3,3,6,3,2013-08-24 03:27:08,2013-08-24 03:27:08
21e3d848b464f8cabbbddb3d2d4e2b697d4476b0...2b9d48ccd020a4ff62741118be94ab8d8f3b08b9,2,14,14,28,2,2013-08-23 08:31:32,2013-08-23 08:28:07
21e3d848b464f8cabbbddb3d2d4e2b697d4476b0...b74a50451c1e80ae59ffad7e8b7316f86476c43e,1,1,1,2,1,2013-08-22 18:10:18,2013-08-22 18:10:18
fe059b6c4bfb4cb0f7c7dec8fb7cd3da7634df30...109af25ed2c18fffb8952a3788b6c970c8103671,1,5,5,10,5,2013-08-10 16:56:15,2013-08-10 16:56:15
fe059b6c4bfb4cb0f7c7dec8fb7cd3da7634df30...994fe9fd31f20ea9122fd8819d23f621cfae7989,1,0,36,36,1,2013-08-10 14:20:33,2013-08-10 14:20:33
44b1eadf087d793bac66ed50ba3ccc5e5739a081...088f0602b9816efc0035038793cc3f9c6f095b5a,1,1,1,2,1,2013-12-23 16:01:51,2013-12-23 16:01:51
088f0602b9816efc0035038793cc3f9c6f095b5a...1443d5102a83efdeac0a8c7fa2c6d28fc0a606ab,1,7,0,7,1,2013-12-23 16:29:10,2013-12-23 16:29:10
1443d5102a83efdeac0a8c7fa2c6d28fc0a606ab...84ec22635652cba5981f467271fb7c1793b5be78,1,1,1,2,1,2013-12-23 16:32:23,2013-12-23 16:32:23
84ec22635652cba5981f467271fb7c1793b5be78...055b3c4dd649075a1df75cc24d6b38248112ebf5,1,1,1,2,1,2013-12-23 18:02:38,2013-12-23 18:02:38
845b98ec2b72e7c59167e9a06c22561c42a920d6...1af65c96c952fd7b02b24cae34e526d7dd7b5950,2,6,1,7,2,2013-12-09 08:22:59,2013-12-06 12:20:35
845b98ec2b72e7c59167e9a06c22561c42a920d6...166177751650e648f8cc7ccafbd87c7923994b75,1,1,6,7,3,2013-12-09 08:02:35,2013-12-09 08:02:35
845b98ec2b72e7c59167e9a06c22561c42a920d6...300ddbf45e11e61a2ba4899965fd36526c9e6ab4,1,1,1,2,1,2013-12-07 17:03:02,2013-12-07 17:03:02
a1e5d4e8b5788087cba478530e3a0352cdef363e...fd3ab6955f85142c6694ddea7aeb8335a2f08275,1,2,0,2,1,2014-02-26 16:24:05,2014-02-26 16:24:05
1c7aecc8f5be4eee30b44a188cbae8341a67f740...058aae5940762c18b3f099a6c3cb734041641390,1,5,5,10,5,2014-03-08 14:07:59,2014-02-26 00:10:35
1c7aecc8f5be4eee30b44a188cbae8341a67f740...5bdcdcd81fd56e9806ca1560d0ca1304d2e84be2,2,7,1,8,3,2014-02-26 07:51:23,2014-02-26 07:51:23
1c7aecc8f5be4eee30b44a188cbae8341a67f740...fe8c9021266c579127cf52f6456eb0090e400e63,2,18,0,18,4,2014-02-25 21:42:45,2014-02-25 21:42:45
fe8c9021266c579127cf52f6456eb0090e400e63...e935635620cbc4a3f2f18303f12891cc997f1cb1,1,3,3,6,2,2014-02-26 22:33:04,2014-02-26 22:33:04
e935635620cbc4a3f2f18303f12891cc997f1cb1...c0744e5ba07a16475b014b976664c729c59516b7,1,3,4,7,3,2014-02-28 16:22:07,2014-02-28 16:22:07
a9dcfd851f80c35522ac844b316af783d0db7e64...2b816075dc71dfe8f6f9e5349fdff7f03ad9dad0,8,33,24,57,22,2014-03-03 07:40:29,2014-02-25 11:12:09
2b816075dc71dfe8f6f9e5349fdff7f03ad9dad0...dd703b3e2a5e7d4dc58f76fa65f4585825f6c3a5,2,0,12,12,2,2014-03-03 07:40:29,2014-02-25 11:13:40
dd703b3e2a5e7d4dc58f76fa65f4585825f6c3a5...b30b9c9c464e3b6611c80b6436c8346eb2bbcccf,1,2,2,4,2,2014-03-03 07:40:30,2014-02-25 11:14:17
b30b9c9c464e3b6611c80b6436c8346eb2bbcccf...d6b0ac96f7b2952edb8aad0efcd48e0bccd23fe0,5,31,26,57,12,2014-03-03 07:40:30,2014-02-25 11:15:18
a9dcfd851f80c35522ac844b316af783d0db7e64...39bb54feb3685d74f57109553e032b041644dc43,1,1,1,2,1,2014-03-02 18:45:38,2014-03-02 18:45:38
a9dcfd851f80c35522ac844b316af783d0db7e64...3ada1d7ec38c48f3f69c5bd2efde4a9546c71ec1,3,65,2,67,7,2014-03-02 18:10:45,2014-03-02 17:29:01
a9dcfd851f80c35522ac844b316af783d0db7e64...c3d55039842bd4a11ff48f10eb813bc6776afb55,1,2,2,4,1,2014-03-02 17:03:37,2014-03-02 17:03:37
c3d55039842bd4a11ff48f10eb813bc6776afb55...2135da1466b02f903b03b3dd3fb1c85b59d309ec,1,1,1,2,1,2014-03-03 08:28:28,2014-03-03 08:28:28
490f99d45e0f610e88505ff0fb2dc83a557e22c5...ec225ae1cbbdd413749dc43545ada4662cb1aa3f,1,1,1,2,1,2014-02-21 17:25:29,2014-02-21 17:25:29
490f99d45e0f610e88505ff0fb2dc83a557e22c5...e7382de1084f75bc8cfb2a5135412fdbd81f3b25,20,132,3,135,24,2014-02-21 15:25:22,2014-02-18 23:09:16
403298317f0035be27a812dae9c5090a51c11faa...3af7254174160970226e131f601daf86c612b348,1,1,2,3,1,2014-02-21 14:38:05,2014-02-21 14:38:05
504777ec20f006fd92cc948c03d35df3e1df4d3b...44013827988cb18d7c3b504f001256388da71abf,3,22,1,23,3,2014-02-25 08:15:43,2014-02-25 08:15:43
44013827988cb18d7c3b504f001256388da71abf...136316a92d143e672ee03fe0f6ef078cab8ed21c,1,2,1,3,2,2014-02-25 08:44:29,2014-02-25 08:44:29
136316a92d143e672ee03fe0f6ef078cab8ed21c...e1c00d5300065514965c8912b68edabc9d5a1879,1,4,1,5,2,2014-02-25 08:54:07,2014-02-25 08:54:07
504777ec20f006fd92cc948c03d35df3e1df4d3b...e800fe0e50ff3766aa28f868b6650f330000d434,1,1,1,2,1,2014-02-25 01:53:57,2014-02-25 01:53:57
504777ec20f006fd92cc948c03d35df3e1df4d3b...9439cb55260185b4a456982613f657f3c1b11915,5,22,5,27,8,2014-02-24 21:06:25,2013-11-28 08:45:35
0538828fdd221b9886618f454e93a4239903daff...e868de687da060a109bd67fd492ed110eb134d47,1,1,1,2,1,2014-02-21 17:45:28,2014-02-21 17:45:28
36c094b08dc37887050eedad7f0fb4f05e79f9cc...55e2f353d412537a58ff19a63a8cc3d5651d881f,1,2,2,4,2,2014-03-17 12:05:20,2014-03-17 09:41:39
55e2f353d412537a58ff19a63a8cc3d5651d881f...f04d5bfaf6afcdbc4e91a2fa3069a5438b7fa569,2,5,4,9,2,2014-03-17 12:06:19,2014-03-17 10:27:59
f04d5bfaf6afcdbc4e91a2fa3069a5438b7fa569...3f818a3d58bbfcd009e9985abb835fb4de56cadf,1,5,6,11,3,2014-03-17 12:06:27,2014-03-17 11:16:26
3f818a3d58bbfcd009e9985abb835fb4de56cadf...656d9548bcfa315751fc01b3afb0ec14104e15a8,2,38,15,53,28,2014-03-17 12:23:04,2014-03-17 12:04:18
36c094b08dc37887050eedad7f0fb4f05e79f9cc...548f070f0e36f76c3afb285668aaa460a6fb73cc,2,17,0,17,2,2014-03-17 12:02:04,2014-03-17 09:29:50
36c094b08dc37887050eedad7f0fb4f05e79f9cc...c0d2b976caa8bacd3a1fb90337eb2ddcbee93c8e,1,2,0,2,1,2014-03-17 11:29:51,2014-03-17 11:29:51
36c094b08dc37887050eedad7f0fb4f05e79f9cc...cfabaa8bd59adc13f7545e1523ecfd986339a77b,1,12,0,12,1,2014-03-17 00:01:14,2014-03-17 00:01:14
ad3acff40990edf0ea3a380b8aa862098612f06a...9886998f24b3d6e44aafc412b87980cb1755544c,3,75,0,75,5,2014-03-19 18:07:51,2014-03-19 18:07:51
ad3acff40990edf0ea3a380b8aa862098612f06a...4f68e15d9e89f338cde64fcfa3e14c0b9bc04afd,1,1,1,2,1,2014-03-19 17:08:26,2014-03-19 17:08:26
aff7ac37ad27df853d42445d615f4356a91d85c8...86e25595c8766a41b31fef61c7bde6cf98826641,3,12,2,14,3,2014-02-24 15:44:25,2014-02-24 15:44:25
aff7ac37ad27df853d42445d615f4356a91d85c8...5818cf063bda5f6a96ccefe086b64a3699dd2c67,2,9,0,9,3,2014-02-24 14:34:56,2014-02-24 14:31:58
b5d81174fb12296ade36ec1f52546b8527bbdcf1...fa3c087a4cad7a62b2aec9df88d379c1822e0d0c,2,2,2,4,2,2014-03-14 12:23:28,2014-03-14 12:23:28
b5d81174fb12296ade36ec1f52546b8527bbdcf1...f3ceebad42f56619aad1aa793735e47cd7da7aec,1,1,2,3,2,2014-03-14 11:33:03,2014-03-14 11:33:03
f3ceebad42f56619aad1aa793735e47cd7da7aec...ccc14fa21c227228dffcf87c7ae683965f0f451e,1,2,0,2,1,2014-03-14 11:33:22,2014-03-14 11:33:22
f0a417df38e64de365d03b980918173196cac62d...bce8edbbcc03bd29230124f9d7871dabbc79d38f,1,1,1,2,1,2014-03-14 10:57:26,2014-03-14 10:57:26
0d7986a8c7806a5d7630283f26667f954a5e61f7...b007cadf5534e4202a955825770019787a37f7d6,3,3,3,6,5,2014-03-14 10:19:02,2014-03-14 10:19:02
b007cadf5534e4202a955825770019787a37f7d6...ac6b9fafdc78a3c5d7fc5c5903e7d28d2f626d41,2,21,24,45,2,2014-03-14 10:53:05,2014-03-14 10:53:05
1ff1b6d816cd1150df436a8ff56502e8adfa1b0e...6ef3505b190001cba49077c98bce25054cdc4577,2,5,1,6,2,2014-02-26 10:44:29,2014-02-26 10:44:29
6ef3505b190001cba49077c98bce25054cdc4577...5d6e4bd2d8d2e45407bb437e5b22656cffedc15a,1,1,1,2,1,2014-02-26 11:18:27,2014-02-26 11:18:27
4713fc34cf93b2d90a84c735e168a65df83bb4e1...5c3972ae1e2c40959b7a2da75b78396a09aacb5c,1,0,6,6,1,2014-02-27 06:58:27,2014-02-27 06:58:27
a3681c0f98f9956722591389eae9d8b89a92470a...69c7ea165938cba835c0a60fdd8cb91877fc3d76,1,1,1,2,1,2015-02-10 18:31:54,2015-02-10 18:31:54
9a3afa4d19afa4622c7ed1217d4b239549eac166...49d6721329bd9fccf656bb750ee8f6c712852cf6,1,3,0,3,1,2015-02-07 21:49:05,2015-02-07 21:49:05
367dee33e260fec07c6ebaf4e10b76e6dcda816d...d909ae73dc5bca391e6639af0d8f9fcacb7a00ea,1,2,1,3,1,2015-02-11 11:21:11,2015-02-11 11:20:51
367dee33e260fec07c6ebaf4e10b76e6dcda816d...3d369a5b85ecebdb884b43764b0b21ee2bfad0ad,2,2,18,20,4,2015-02-10 17:30:39,2015-02-10 17:30:39
428df28cda4b31a70d908e612bbad627b32c3426...545f12d548c65d2dde966c29ee518df515732ae6,2,3,3,6,3,2015-02-24 18:46:52,2015-02-24 18:46:52
a52529f9b6258b2ae2793930096c3fcbe40078f3...1511506f724d2ac33c2c8221035109961b36b28a,1,1,1,2,1,2015-02-25 23:17:20,2015-02-25 23:17:20
a52529f9b6258b2ae2793930096c3fcbe40078f3...2c0cc2e1f69f5a90f586be0a14434047f33a9b83,1,11,4,15,3,2015-02-25 21:34:04,2015-02-25 21:34:04
2c0cc2e1f69f5a90f586be0a14434047f33a9b83...df31e0a88c5264046fbb0789f67529f023b3f810,1,1,1,2,1,2015-02-25 21:41:35,2015-02-25 21:41:35
df31e0a88c5264046fbb0789f67529f023b3f810...e4dc4390e57efa0b8207d63b4446c019580d00aa,1,1,1,2,1,2015-02-25 22:15:40,2015-02-25 22:15:40
0283fff5914f74d9435ab2097b2770dfdf635941...769d1ce64bdb7c9fd3981c65bc25dd14eb176c1e,1,1,1,2,1,2015-02-24 15:10:55,2015-02-24 15:10:55
27e75344705762a31b8ca82582f724988e18abf8...3ff71897384b905218960c8562b681645ee21621,1,1,1,2,1,2015-03-03 18:01:49,2015-03-03 18:01:49
27e75344705762a31b8ca82582f724988e18abf8...38c52b1be6ca05862db0f7e8c4931bebc873bf75,2,16,15,31,14,2015-03-02 23:36:07,2015-03-02 23:11:39
f84bd771d4daa5753ad6a4b7e1a0c3cc9f51d33f...b8c9257fb1dc70cd65a14cb7dec62455ea54e394,8,45,5,50,10,2015-03-02 23:26:00,2015-03-02 23:05:23
d905a431e89423a901ff5cd242c5f2bf90a4f511...a04ac76117aec7262d223f3dd61a97c7ff88f3a7,1,10,10,20,2,2015-02-18 08:23:01,2015-02-18 08:23:01
d905a431e89423a901ff5cd242c5f2bf90a4f511...70edf950fe6baf90bb98c904d9132924e55e50d6,4,28,14,42,4,2015-02-18 06:40:00,2015-02-18 06:40:00
70edf950fe6baf90bb98c904d9132924e55e50d6...367d9a2dc683ef549905f35186412b5248376028,1,1,0,1,1,2015-02-18 06:42:04,2015-02-18 06:42:04
d785b20c43b114bbae385a5446f9369370fbd3bf...ebd00cc7f0da544f03e04464031085b66306a43f,1,2,2,4,2,2015-02-15 10:24:00,2015-02-15 10:24:00
d785b20c43b114bbae385a5446f9369370fbd3bf...c217860ae74381d75a4932fabb4417ac08b014b4,1,1,1,2,1,2015-02-14 19:19:13,2015-02-14 19:19:13
d785b20c43b114bbae385a5446f9369370fbd3bf...252ee4e7e51ae18f30f4b9089be850daaca958ac,3,24,18,42,5,2015-02-14 07:49:12,2014-08-11 18:06:15
5725b6daad2f403f13112cfcafa5b45ac126c0ca...ee804e2d94018f633c6e400b443ef514b5d7a10f,1,1,1,2,1,2015-02-14 20:13:31,2015-02-14 20:13:31
5725b6daad2f403f13112cfcafa5b45ac126c0ca...76aad9b76ed756ca9ba2cbcdb399c815e542b3ae,265,1374,1098,2472,908,2015-02-14 18:09:23,2015-01-24 18:02:58
f989190ed4ea3f9b03451918b55384a2e23fe3af...3ab07b8aae8dae43cfa3aae1306c59ea264a8594,1,51,80,131,24,2015-02-15 14:18:13,2015-02-15 14:01:27
ba215e9cd5a45b40f794f1953c96a726b52c1f77...6fd06006856bd7f06c5bf15db2ef064cba043a58,2,2,2,4,2,2015-03-04 20:05:15,2015-03-04 17:56:41
eceec9b1c528a4fb05888e0c83e1d58c41f3d047...3df135a66c01a2af933349996488889ea26a3048,1,2,1,3,1,2015-02-17 08:16:58,2015-02-17 08:16:28
3df135a66c01a2af933349996488889ea26a3048...2c893cb380bba56149dcb5b1d6f6daba2af1d8fc,1,1,0,1,1,2015-02-17 08:23:09,2015-02-17 08:23:09
eceec9b1c528a4fb05888e0c83e1d58c41f3d047...904c382f6abb3c1ee3b3a7c5de0579b1cf2e3bea,1,2,1,3,1,2015-02-17 08:16:28,2015-02-17 08:16:28
eceec9b1c528a4fb05888e0c83e1d58c41f3d047...d11c64a67ff0385cb4a3c3e3b52c023c083b7c57,4,138,16,154,15,2015-02-17 01:51:29,2015-02-17 01:51:29
eceec9b1c528a4fb05888e0c83e1d58c41f3d047...7194810892d13712f3728524216d03661e66e942,1,20,14,34,6,2015-02-17 01:36:34,2015-02-04 01:50:30
55a906f643b5d52722597f18f2f8e417e92dab6b...57e91940dd719564f395116c7d91870396b0d58b,2,10,1,11,2,2015-02-17 19:52:03,2015-02-17 19:52:03
a0c4fa31741ed3b5f01eaec0cf02fae10c39a62d...4fe699fdc3396c93b7d84a43ba96c432711a1ea5,1,91,56,147,10,2014-12-29 19:14:51,2014-12-29 19:14:51
a0c4fa31741ed3b5f01eaec0cf02fae10c39a62d...b97b85496307acf57fdfd0a2b55b721f8f592718,2,2,31,33,2,2014-12-29 18:10:53,2014-12-29 18:10:53
a0c4fa31741ed3b5f01eaec0cf02fae10c39a62d...95c0393789e6f65e2c0ddcbdf1d7e38801be2dd4,1,11,13,24,4,2014-12-29 17:30:27,2014-12-29 17:30:27
c9572857279a1bfff585932ce506f19960b8c7fd...6e217bd55cf900692da49592cca36a04b2eb4a95,2,36,22,58,3,2014-12-30 15:28:34,2014-12-30 15:28:34
6e217bd55cf900692da49592cca36a04b2eb4a95...884352294deab0c11845547ce2ab96b60f468458,1,1,1,2,1,2014-12-30 18:10:46,2014-12-30 18:10:46
d02a22ba21f91d2aa4f9cf716dc3aefcf7e7495e...a9f7fd2c1a7052247333b89f6a22a883b480370d,19,408,5,413,24,2015-01-10 17:51:43,2014-12-31 13:07:48
a9f7fd2c1a7052247333b89f6a22a883b480370d...ee28ee5f13d37c1c430973cdbef34f301b91343a,1,1,0,1,1,2015-01-11 04:04:06,2015-01-11 04:04:06
ee28ee5f13d37c1c430973cdbef34f301b91343a...ef933a4a962e4ab12c448241ad500e229a569f21,1,5,4,9,3,2015-01-13 18:34:01,2015-01-13 18:34:01
d02a22ba21f91d2aa4f9cf716dc3aefcf7e7495e...8589b4e137f50293952923bb07e2814257d7784d,15,144,7,151,18,2015-01-08 08:22:50,2015-01-08 08:22:50
8589b4e137f50293952923bb07e2814257d7784d...57a65ede77b7bbae6e3b2a7aa52135de7b0c2f8e,20,123,77,200,27,2015-01-08 17:53:35,2015-01-08 17:53:35
57a65ede77b7bbae6e3b2a7aa52135de7b0c2f8e...8133e44998236438c46e1b662bd284323287f415,2,12,3,15,3,2015-01-08 18:30:35,2015-01-08 18:30:35
8133e44998236438c46e1b662bd284323287f415...d0a50985ec613584821806062df4eaa39337449c,4,24,20,44,6,2015-01-08 19:26:16,2015-01-08 19:26:16
d0a50985ec613584821806062df4eaa39337449c...939c046a9872c1d7c38d73dc08860681ecebd1f1,4,5,7,12,5,2015-01-08 21:21:00,2015-01-08 21:21:00
939c046a9872c1d7c38d73dc08860681ecebd1f1...08c9cb4cabab648d90e6fcf055f1143fbbc994e8,5,12,8,20,9,2015-01-08 22:26:43,2015-01-08 22:26:43
a28cad0cf3cdb387e6da221ba2feef73182013da...f26c0fa556be1903c1a6aebf104a82363ced96cf,1,1,1,2,1,2015-01-13 18:26:55,2015-01-13 18:26:55
06ad715e4cc962c799ba9fba5ef37a91a2e214f5...8b53d9efe648f10e0572c2d8017489d0d3bb4755,1,1,1,2,1,2015-03-06 09:41:47,2015-03-06 09:41:29
6b214a5d87e9a7a57b3da1b9605626e516f65d1a...224e104d8dc79e081fd897a1e52799dc1a0082bb,3,4,10,14,4,2015-03-09 11:52:45,2015-03-09 11:52:45
1647994adade890fbb2d8276c1bb99e6ec909fb8...88e4aed9df812eee9af2f27a975eeac894580042,1,6,0,6,1,2015-03-11 20:03:23,2015-03-11 20:02:49
8be36a2c0f8952fd4daae8b7007e687966b5a75f...3d9a766d9f465ef97b259be860891ce35bd04d0b,3,4,0,4,4,2015-03-04 18:29:25,2015-03-04 18:24:34
c572bdb587bada094af867839a60a26a1fc1423e...7fd4dc1e11e772095123008c79796202b5b7c80d,6,6,46,52,9,2015-03-10 20:17:16,2015-03-10 20:17:16
7fd4dc1e11e772095123008c79796202b5b7c80d...04c674e6792ad638dfb505f06f4cf9e980bb4a74,2,0,40,40,4,2015-03-10 20:27:58,2015-03-10 20:27:58
04c674e6792ad638dfb505f06f4cf9e980bb4a74...8527e8d5996bb5543cb5a13e857b864b466a31f2,4,27,27,54,4,2015-03-10 22:19:28,2015-03-10 22:19:28
8527e8d5996bb5543cb5a13e857b864b466a31f2...83f7e98d9a672158d5c754307ab471fd50c5b2a3,8,88,144,232,8,2015-03-10 22:59:14,2015-03-10 22:59:14
83f7e98d9a672158d5c754307ab471fd50c5b2a3...0414b2ae98180f1a462aae5300ba0fde94614cb4,6,0,108,108,6,2015-03-10 23:03:37,2015-03-10 23:03:37
0414b2ae98180f1a462aae5300ba0fde94614cb4...9839d106c46a2c035c19337cfce0a905e2e1fea3,3,4,4,8,3,2015-03-10 23:06:30,2015-03-10 23:06:30
9839d106c46a2c035c19337cfce0a905e2e1fea3...4b1bb42bf77328e2f80e40933d53037a1144bf0a,2,1,6,7,2,2015-03-11 04:56:19,2015-03-11 04:56:19
4b1bb42bf77328e2f80e40933d53037a1144bf0a...9ed71f77fee46fc489af8a6150cf12c1c6c468c1,1,0,9,9,1,2015-03-11 06:34:18,2015-03-11 06:34:18
c572bdb587bada094af867839a60a26a1fc1423e...ea7478d6b5a464d888a1aa7743a0076470f8bd3d,1,21,13,34,4,2015-03-10 19:59:39,2015-03-10 19:59:39
4803675190833cdf7e83558a32b2f2ea3283dce0...a1b3e239ee0fdf43d511ea96ed30770336bb9c3f,1,1,1,2,1,2015-03-13 20:27:05,2015-03-13 20:27:05
465f41673a418096b761d12438301c7b217f9a81...505a492cd87be7683827c5f46a05b6a7dddffc86,6,128,37,165,17,2015-01-19 21:18:36,2014-11-05 20:45:18
465f41673a418096b761d12438301c7b217f9a81...d5ae521cf798a4c553fcf836b51a28b65cd46da7,3,6,1,7,2,2015-01-19 20:55:44,2015-01-19 20:19:21
e5d491b7c702a7996190f85f94563252c5ca8fdb...855fe20165715e34deb1e7153d02c811003095e5,1,1,1,2,1,2015-01-21 20:02:30,2015-01-21 20:02:30
554719d985916d9f49f70b577382ab3a6da7eb7f...b34e83d261f30549062ee7c8b9e25f632bbcf163,3,13,17,30,8,2014-12-23 14:04:39,2014-08-27 10:12:42
90e4b400bac1cd8eb68a5ea85b5d5df092efdc61...b1792d9e4c28366ecc896e36d22099ab564c150f,2,29,0,29,2,2015-01-13 12:01:50,2015-01-13 12:01:50
b1792d9e4c28366ecc896e36d22099ab564c150f...5140bd88247125e24090a45be920b509b0fcf958,2,10,6,16,4,2015-01-13 12:14:32,2015-01-13 12:14:32
bc95576e2cbbd2def7a6fce1bde2d0263a3d7da1...9c03c1c545d1afeaf12d8ee1c204936cdf8c55e1,5,32,6,38,8,2015-01-10 03:10:01,2015-01-10 03:10:01
bc95576e2cbbd2def7a6fce1bde2d0263a3d7da1...3c19929c757e5ff45f5afa3713002ee1862c0b75,2,190,199,389,43,2015-01-09 20:29:48,2015-01-09 20:29:48
3c19929c757e5ff45f5afa3713002ee1862c0b75...606c701bd0522f59d633b8e46d9f3b322032d1cf,1,27,21,48,11,2015-01-10 02:12:00,2015-01-10 02:12:00
606c701bd0522f59d633b8e46d9f3b322032d1cf...b9dd52dd14a98b69db0537fa3431fe6a01a3284d,1,21,27,48,11,2015-01-10 02:13:09,2015-01-10 02:13:09
b9dd52dd14a98b69db0537fa3431fe6a01a3284d...c736968695d2b2e0bd3be16fda2287e02966d9b2,1,27,21,48,11,2015-01-10 02:14:45,2015-01-10 02:14:45
c736968695d2b2e0bd3be16fda2287e02966d9b2...2e3749cdccfd2eb2e596980e16b88a604e97834e,1,7,7,14,7,2015-01-11 01:32:42,2015-01-11 01:32:42
2e3749cdccfd2eb2e596980e16b88a604e97834e...1c3c8a9c55457a3147d5da7431505ecf87f70007,1,19,19,38,5,2015-01-11 01:34:35,2015-01-11 01:34:35
6428698580d9554983209b6e43c1ce9b201f717d...1b6ebd17179b610f832d5a1cfda866167124bb1c,1,2,2,4,3,2014-12-26 14:29:02,2014-12-26 14:29:02
1b6ebd17179b610f832d5a1cfda866167124bb1c...071ad02c027ac14e0944e957664fc24c82b720c3,1,4,2,6,3,2014-12-26 14:29:19,2014-12-26 14:29:19
071ad02c027ac14e0944e957664fc24c82b720c3...6342bc299457a2b298e8cb556bcd55efe1bbe030,3,7,3,10,5,2014-12-27 19:08:29,2014-12-27 19:08:29
da9d8279046c7f5f1dfb0972c0c8ac676cfc8b2c...2660e83c97c46b7303a71b1110c693fbfbc9662c,2,10,5,15,2,2014-12-30 09:46:47,2014-12-30 09:30:56
2660e83c97c46b7303a71b1110c693fbfbc9662c...27ee0fc57b3b3fe28f55d2a8cae424e99cf8f79e,3,50,0,50,4,2014-12-30 09:46:47,2014-12-30 09:32:24
27ee0fc57b3b3fe28f55d2a8cae424e99cf8f79e...5d2e637c17d28315185816a32b202ada15a7c77f,1,41,0,41,1,2014-12-30 09:46:48,2014-12-30 09:32:52
42fb42aed4cc30d101e81fa5934d9f1b9521dfce...43c2d5a2687bd45bb1f8e3f8390a7b558afb75a0,5,35,0,35,3,2014-12-29 09:44:08,2014-12-29 09:44:08
b01c5d993c10704c5097d9eaba24ef849fe3a46d...e3951019f5de7359659a4c13db0eeb16cf1195f1,1,6,0,6,1,2014-12-26 12:19:30,2014-12-26 12:19:30
e3951019f5de7359659a4c13db0eeb16cf1195f1...038161f4e0b41a0fd6b877171a1f47d062b5c857,1,1,1,2,1,2014-12-26 12:19:54,2014-12-26 12:19:54
038161f4e0b41a0fd6b877171a1f47d062b5c857...f1c39763c9daf5f053f9b9ae0bcd1c50ea59133f,5,10,38,48,5,2014-12-26 12:25:37,2014-12-26 12:25:37
f1c39763c9daf5f053f9b9ae0bcd1c50ea59133f...a248efadf7a4a8e2ebf0a98413c195b3c8766f20,1,1,1,2,1,2014-12-26 12:28:49,2014-12-26 12:28:49
a248efadf7a4a8e2ebf0a98413c195b3c8766f20...573d554c6927f0e6804c986af7d8837e0abd6cd9,2,2,2,4,3,2014-12-26 12:34:50,2014-12-26 12:34:50
573d554c6927f0e6804c986af7d8837e0abd6cd9...aa54482a37df5b122e35029a316094c2f55d5044,1,1,1,2,1,2014-12-26 12:53:50,2014-12-26 12:53:50
eae5f544cd232e49fa8df8e85a41d746224816ce...c45f4cbe8fb973bc2ee57efb5595294da4cab5d2,1,1,1,2,1,2014-12-29 06:17:04,2014-12-29 06:17:04
c45f4cbe8fb973bc2ee57efb5595294da4cab5d2...2b90aa0ec066947615e2590434ac26d3661836f8,2,6,6,12,6,2014-12-29 18:22:47,2014-12-29 06:22:56
e45e6ba2c3e25afb138e5f0ece71c6f677f2ab86...5b49bb208a21fa96d0ae1bb93506725deee6c5b5,9,16,20,36,16,2014-12-22 14:42:26,2014-12-22 14:42:26
5b49bb208a21fa96d0ae1bb93506725deee6c5b5...3eb586c12cf46fe0098c5c0fbec8478a44a5d77d,1,1,2,3,2,2014-12-22 15:18:53,2014-12-22 15:18:53
3eb586c12cf46fe0098c5c0fbec8478a44a5d77d...a2d188f688759b3889de576bb8019e189bcac902,4,46,38,84,9,2014-12-22 18:36:15,2014-12-22 18:36:15
a2d188f688759b3889de576bb8019e189bcac902...9a8ac2accc78f231fdf7ad7fd8b8bb405a24942b,2,4,4,8,4,2014-12-23 08:51:14,2014-12-23 08:51:14
9a8ac2accc78f231fdf7ad7fd8b8bb405a24942b...32eb5de510a7e32d9bb886595aa47d95dc00490f,6,59,114,173,8,2014-12-23 15:31:38,2014-12-23 15:31:38
32eb5de510a7e32d9bb886595aa47d95dc00490f...47634e392fab457dd0634225961944804bc04efe,20,140,210,350,54,2014-12-23 16:49:39,2014-12-23 16:49:39
47634e392fab457dd0634225961944804bc04efe...016981c009a2a8c6066085300a838d9c9d6bfd5d,5,33,28,61,18,2014-12-24 09:04:33,2014-12-24 09:04:33
016981c009a2a8c6066085300a838d9c9d6bfd5d...7b792af872699cd9439c750b780b0b906342cff0,3,18,12,30,8,2014-12-24 09:39:03,2014-12-24 09:39:03
7b792af872699cd9439c750b780b0b906342cff0...97d7c06f781f17a21689cf35410009f1247427e9,4,15,10,25,5,2014-12-24 10:56:03,2014-12-24 10:56:03
97d7c06f781f17a21689cf35410009f1247427e9...8045d96ea81ffd1a87018c751a4604613b04da71,1,1,1,2,1,2014-12-24 11:39:35,2014-12-24 11:39:35
8045d96ea81ffd1a87018c751a4604613b04da71...35eec009e50d85c7296a7c16fcbd313f620b53c8,1,0,4,4,4,2014-12-24 12:34:37,2014-12-24 12:34:37
3febfce1ae67f0f9f87c7298956af4857ffd55e5...cd4c65c159627ead220bcadbe1a58ced0017851b,1,20,4,24,4,2014-12-11 12:17:43,2014-12-11 12:17:43
cd4c65c159627ead220bcadbe1a58ced0017851b...bd43cf065384745e4386237ad0f5d4eb14868034,1,7,8,15,6,2014-12-12 09:17:07,2014-12-12 09:17:07
bd43cf065384745e4386237ad0f5d4eb14868034...e5951cf4aec15fc58730f88454d2b6d71ff25802,1,4,4,8,4,2014-12-12 09:42:55,2014-12-12 09:42:55
3febfce1ae67f0f9f87c7298956af4857ffd55e5...eceda17f0911bd62dba83d193df680f7cedc8cd9,1,1,0,1,1,2014-12-10 16:24:11,2014-12-10 16:24:11
3febfce1ae67f0f9f87c7298956af4857ffd55e5...22368fb8e8d684fd540120c33233cf0c42825f3e,1,1,0,1,1,2014-12-10 14:52:56,2014-12-10 14:52:56
22368fb8e8d684fd540120c33233cf0c42825f3e...1d0dfd50cc7a795b948bc19d701518681b3c9439,1,1,1,2,1,2014-12-10 14:54:01,2014-12-10 14:54:01
d3a363729ff6ba0003f4674beae1ecd44958a402...c33d078f53244c5b2d4d6cd49f62befed8e2471a,1,1,1,2,1,2014-12-10 23:51:54,2014-12-10 23:51:54
d3a363729ff6ba0003f4674beae1ecd44958a402...96a648ded25a46335302a7fa392cddfd2e3f4acb,2,12,12,24,6,2014-12-09 00:44:06,2014-12-09 00:22:28
7ad5fd6ce7d1180480e84f5596d1f80b0fe1091f...86d5e20664856a0f6635ba184dd85a4f342f8b8f,1,1,1,2,1,2015-02-19 00:40:22,2015-02-19 00:40:22
86d5e20664856a0f6635ba184dd85a4f342f8b8f...5555c4d99c3d2eeaf171d6e4178a1b7c93b363a6,2,4,2,6,3,2015-02-19 01:42:29,2015-02-19 01:42:29
55319c0a7aa0dbcdf3a8b73fc60447a353c5beec...18d9172edc3bb3a1cfd7640ea0555e887ce5bde5,1,2,2,4,2,2014-12-22 09:03:52,2014-12-22 09:03:52
bf91fb92744439fca87dd31fde34e3aa7e769fb7...2a494d99faabb3b34bbb6e57a8d93bafd4f002be,1,1,1,2,1,2014-12-05 16:30:50,2014-12-05 16:30:50
a46fe875c6aea206e575e2b083bd31ed36ee1b1e...d31d711a70779132ea43387f93eb4ccc1e472761,8,56,102,158,16,2014-12-04 20:14:20,2014-12-04 20:14:20
e54b457ea31eff54d031b7092a2a78dc81c69a63...de794b6a77dba50a76e79538797ce2873c1e8700,1,2,1,3,1,2014-04-24 03:00:56,2014-04-24 03:00:56
e54b457ea31eff54d031b7092a2a78dc81c69a63...a4bf8037fbd18a27d83a8ee1943978ad241257ce,1,5,5,10,3,2014-04-23 19:00:26,2014-04-23 19:00:26
f382983f1a136a58baffe911f8dec11bfcbea64b...fead96788c30c13b5adc25132cd003638a6d4f51,2,5,11,16,4,2014-04-08 13:02:53,2014-04-08 13:02:53
5830d672f7caf8c4a2d0dcc63f9a096523b3cb32...5b123dbf7f587a58db2b45390dff43fa167dbb04,1,2,2,4,2,2014-04-10 08:05:40,2014-04-07 17:10:28
67b07f96ea6ce7a22d070da7e83724ed153e14ef...fd8a165df70642efe44c5735b9c5b12da17d7b34,1,1,1,2,1,2014-04-09 18:20:54,2014-04-09 18:20:54
03472b4fc02a256c90c0285765e7da82c56e93a2...728b05cab7f4bc87cbdc9d1ecb3d54f96ff24ce2,7,224,59,283,7,2014-04-10 12:31:54,2014-04-03 03:11:25
03472b4fc02a256c90c0285765e7da82c56e93a2...670e02982cb650163efc632410a6948c48992daa,2,2,2,4,2,2014-04-10 07:20:19,2014-04-10 07:20:19
670e02982cb650163efc632410a6948c48992daa...549758b387afbcefe7722f75a404dd7aadc0e7f9,1,1,1,2,1,2014-04-10 07:21:30,2014-04-10 07:21:30
549758b387afbcefe7722f75a404dd7aadc0e7f9...355b120224444d5de9b4c759c7388b14ff6b157c,1,1,3,4,2,2014-04-10 07:23:10,2014-04-10 07:23:10
03472b4fc02a256c90c0285765e7da82c56e93a2...bca528a57c9276c0cd815d67fed4a72c514d53a2,7,26,6,32,7,2014-04-10 06:14:02,2014-04-09 05:14:16
e099d6621353029954ca8855be73f2b83873bc63...53f0d6cc519e68fec80468d7d58a64171f93b8b4,1,7,6,13,3,2014-04-09 12:14:19,2014-04-09 12:14:19
53f0d6cc519e68fec80468d7d58a64171f93b8b4...ac01e445360c5930d436371fcad92df784c29422,1,1,1,2,1,2014-04-09 16:17:45,2014-04-09 16:17:45
f7da04dccde6deccc10a98a024e6230baaf08dd5...274d6db18749f4fbcceabd3529b5bcdad9e5b5a4,1,1,0,1,1,2014-04-28 20:20:33,2014-04-28 20:20:33
1b491c364d07a6764575fa11430f7c7d1ec6ecd1...19438af8d1b67c3cd0a2989aa7b9ff167c4598aa,1,1,1,2,1,2014-04-22 10:23:57,2014-04-22 10:23:57
9b7dd8b4c04c427de22543fec7f52be26decdb22...03b56b9446f851a621480e697e33328d51e75751,1,5,1,6,1,2014-04-22 04:22:55,2014-04-22 04:22:55
9b7dd8b4c04c427de22543fec7f52be26decdb22...db86fe47ce42f8f5aa72cc52d07c7e6eb312dcf9,2,6,1,7,2,2014-04-19 03:20:43,2014-04-19 03:13:53
9b7dd8b4c04c427de22543fec7f52be26decdb22...b5a73b1f902c97c3289df159b1007eb4a0db9eac,1,1,0,1,1,2014-04-18 15:55:06,2014-04-18 15:55:06
b5a73b1f902c97c3289df159b1007eb4a0db9eac...61e68634033219cb9620ef11078bc90254f1b553,1,6,3,9,3,2014-04-20 10:01:55,2014-04-20 10:01:55
2bfd95d8502607ee8c41675b1711a6710b1e05e1...e9d4587ff11c8510f01dfa184414f73d75b4550b,1,2,1,3,2,2014-04-21 15:48:42,2014-04-21 15:48:42
2bfd95d8502607ee8c41675b1711a6710b1e05e1...01799721dc6cbc1dbfbd72b2b0d5fc128ac03da9,1,14,8,22,3,2014-04-21 10:34:08,2014-04-21 10:34:08
2bfd95d8502607ee8c41675b1711a6710b1e05e1...f0a4f62c7eb0900ca1c3cdecffbacc46a72480d2,1,22,0,22,1,2014-04-18 09:13:15,2014-04-15 13:04:48
f0a4f62c7eb0900ca1c3cdecffbacc46a72480d2...23665d2506cfb0d7d30c368f4d82699587b9f86b,1,3,1,4,1,2014-05-05 15:04:19,2014-05-05 15:04:19
23665d2506cfb0d7d30c368f4d82699587b9f86b...ea109704d10d7fc5e9808e5355df994a7f6e109b,1,4,3,7,3,2014-05-19 18:35:59,2014-05-19 18:35:59
1f1c59b61d30b76d69f0f925b43a0b96465f38ed...6b04a5f9108c640f638afa8055e2a5b60f926d5a,4,70,6,76,8,2014-05-13 12:33:38,2014-05-06 17:51:56
6b04a5f9108c640f638afa8055e2a5b60f926d5a...bb89661365a3085302d7fbc0e66e991a421f73c6,1,2,2,4,1,2014-05-13 12:34:00,2014-05-07 10:09:05
1f1c59b61d30b76d69f0f925b43a0b96465f38ed...51280fc76c168e146bd29b05adecae19c2892fc0,2,9,9,18,7,2014-05-13 12:15:46,2014-05-13 12:15:46
f09a1ef81d787962e160af7e56d08bc23af52dd1...4f670fbe9c83bdf20e1a58d3166848ab6d453b6c,1,2,1,3,1,2014-05-05 11:30:50,2014-05-05 11:30:50
4f670fbe9c83bdf20e1a58d3166848ab6d453b6c...f5c4bda8fe53549f2ba63484359543f272954a61,1,29,41,70,3,2014-05-05 12:07:19,2014-05-05 12:07:19
f09a1ef81d787962e160af7e56d08bc23af52dd1...cac916d974cf12083002d01488dfd3ca8ac2a89a,1,1,0,1,1,2014-05-05 11:21:00,2014-05-05 11:21:00
ba37f84067039454b709906803f9f2f873c0c5f0...dc1eff9b91343d8b1cb06b05b5f72dcec1cef860,1,18,27,45,12,2014-05-05 11:34:43,2014-05-05 11:34:43
dc1eff9b91343d8b1cb06b05b5f72dcec1cef860...6dc09db53d5951fe274c3ff6d35ac77d40e2a310,1,5,3,8,3,2014-05-05 15:14:58,2014-05-05 15:14:58
1feaa336edf7a16ca39b036345890f05d35a1463...edc32047dc7f02783134495ce094a29297cca243,1,81,36,117,13,2014-04-24 15:17:23,2014-04-24 15:17:23
edc32047dc7f02783134495ce094a29297cca243...2242c074afc637c3ef2f7f9367fa60aab7c7f50b,1,44,23,67,17,2014-05-01 13:05:22,2014-05-01 13:05:22
2242c074afc637c3ef2f7f9367fa60aab7c7f50b...db7f07387fed8f4dd1ad321e6e5c46fad6d44b45,1,5,1,6,3,2014-05-05 06:09:46,2014-05-05 06:09:46
1feaa336edf7a16ca39b036345890f05d35a1463...0050c07fdda59f36ca2959e08d422ff5d6479e10,1,11,0,11,1,2014-04-24 13:00:18,2014-04-24 13:00:18
0050c07fdda59f36ca2959e08d422ff5d6479e10...c4b1a5f5ea338d9be6b24f29a562b567b3c2598b,4,20,4,24,6,2014-04-28 14:22:31,2014-04-28 14:22:31
c4b1a5f5ea338d9be6b24f29a562b567b3c2598b...cb69baedd335b0609503502080fc684520b3794c,1,0,1,1,1,2014-04-30 09:48:46,2014-04-30 09:48:46
cb69baedd335b0609503502080fc684520b3794c...4146e885dde2338b25c1a176ede2f5a2d0946f96,1,10,8,18,4,2014-05-05 09:55:49,2014-05-05 09:55:49
4146e885dde2338b25c1a176ede2f5a2d0946f96...5a949e609512cdabd7885712a37e04095d1f4600,2,55,0,55,2,2014-05-05 11:47:47,2014-05-05 11:47:47
5a949e609512cdabd7885712a37e04095d1f4600...fac225780cf5579a566977ee78e320ad3f40fd0e,1,6,4,10,3,2014-05-05 12:01:48,2014-05-05 12:01:48
fac225780cf5579a566977ee78e320ad3f40fd0e...b96ad52e10151fed49f63b107ce6871c8d25647e,1,2,2,4,2,2014-05-06 06:52:58,2014-05-06 06:07:15
b96ad52e10151fed49f63b107ce6871c8d25647e...00cd3ecc44a6c6d29565c95cd5173c8e5de35537,1,3,2,5,1,2014-05-06 07:57:08,2014-05-06 07:57:08
1feaa336edf7a16ca39b036345890f05d35a1463...fe1ca616017633a243017ad265c4713aca773ea3,4,20,3,23,7,2014-04-24 11:23:17,2014-04-24 11:23:17
728bdfc50451b2d5a4135110131e70d942a299e1...84870438f95092957c2ad5ca4581e2b95f98033d,4,52,78,130,13,2014-04-24 13:18:10,2014-04-24 08:49:01
a64724611fa972dfc06fc72bf1fe80c93a4b80f1...9571743d8f46e583a4edb465b831f495d642bf32,1,28,0,28,1,2014-04-30 13:02:42,2014-04-30 13:02:37
d4b4088321237c3ad5bbc79b321d7af3ff7f0c9d...cc9b7cba3833293fcb25779f1c901e043c4c17d8,1,1,1,2,1,2014-05-01 14:42:28,2014-05-01 14:42:28
59b81a666460a493ad68632ecb2cc5790eb3f9e8...87c397f5774c4c11ba2e4c55098920c081e53670,1,3,3,6,3,2014-05-02 11:13:45,2014-05-02 11:13:45
85b5d203acbea36224fc7e3c0c6b93cce0141b84...c883660a3e754b5a3b14ef4a1be69503d345e3b5,1,4,5,9,2,2014-05-02 10:46:15,2014-05-02 10:46:15
c883660a3e754b5a3b14ef4a1be69503d345e3b5...dd47f9532ff8015e3d981ba4fd7341b7514ae109,1,4,3,7,3,2014-05-02 10:46:32,2014-05-02 10:46:32
66a5f753bb65e53b2e4a93b6d7b12ba8ea983f39...48dd07edbabaa349f55ca403cc157b8cfd155000,2,24,22,46,17,2013-11-25 13:01:47,2013-11-25 13:01:47
66a5f753bb65e53b2e4a93b6d7b12ba8ea983f39...b65129b685f333e4341d5d083ea561bcb57c1b68,1,53,0,53,1,2013-11-25 12:55:09,2013-11-25 12:55:09
b65129b685f333e4341d5d083ea561bcb57c1b68...f884605d6f3bfac5e69dcd2bb8166021db0346ab,1,1,1,2,1,2013-11-25 12:59:35,2013-11-25 12:59:35
580db8dea138cfb8069b5eb0203b68803e660b46...741db7603ce198f15b2325d1e4bc776cbb291ab6,1,1,3,4,2,2014-01-29 15:07:15,2014-01-29 15:07:15
741db7603ce198f15b2325d1e4bc776cbb291ab6...4f3876a2b6f3e0c14807058ba73336c1ebcb7613,2,4,3,7,4,2014-01-29 16:28:51,2014-01-29 16:28:51
7f03b32049e93bbe84b63ced9c8493fc2f2a0b98...0ee296d1fa346ed7d3235a55959ffdccf550878c,2,67,71,138,2,2014-01-30 16:31:24,2014-01-30 16:31:24
364bd38d05ef97ae77d68f27bbfeafb2375cab82...b466217965965b1f6084d91eca44413658d09e99,1,1,1,2,1,2014-01-30 08:57:52,2014-01-30 08:57:52
f591e4a48c662f2ed5a5c1f3e1ed92d7ad2cd1fb...3c053bdc20dd0e88d6fb8cddcaff1cd6332c1d0a,1,20,15,35,1,2014-02-21 10:05:37,2014-02-21 10:05:37
3c053bdc20dd0e88d6fb8cddcaff1cd6332c1d0a...77dc5de9233db897f7eaf50f4fd0f230b17b555d,1,8,2,10,3,2014-02-21 14:34:38,2014-02-21 14:31:10
ee53b73986ba4c9dd2f0c726a44718acb8febaf8...d89527839ea0dd1734dacb71c3ed2a97f1ff74d7,28,57,56,113,50,2013-12-14 20:05:10,2013-12-14 13:43:48
ee53b73986ba4c9dd2f0c726a44718acb8febaf8...5e73a3b12407602d315aa648e36620b9b1baa22b,1,4,5,9,5,2013-12-14 12:10:24,2013-12-14 12:10:24
5e73a3b12407602d315aa648e36620b9b1baa22b...d476ac7d41f117ad9cf612e99216a4e7eaa04fb6,1,1,1,2,1,2013-12-14 12:11:31,2013-12-14 12:11:31
ee53b73986ba4c9dd2f0c726a44718acb8febaf8...63723ef6df788391ed776441421ae482ad4fbd82,6,47,0,47,7,2013-12-13 19:40:45,2013-12-13 19:40:45
ee53b73986ba4c9dd2f0c726a44718acb8febaf8...969a4a8f7173eaa79f593b4a7d92df263f43d9c0,1,1,1,2,1,2013-12-13 16:46:58,2013-12-13 16:46:58
416c25871dcf8680ccf1af5da91fe0004e59eb05...9cc9e9cd9a5914b3aa7abf91325839ccd485fa0d,1,81,0,81,1,2014-01-21 11:30:33,2014-01-21 11:30:33
416c25871dcf8680ccf1af5da91fe0004e59eb05...7fe7897c56046ade852def480d2cebe1be584512,1,3,0,3,2,2014-01-21 11:25:12,2014-01-21 10:45:46
7fe7897c56046ade852def480d2cebe1be584512...1ee94423230b26be023cb4ebcb8aed6472c25ed2,1,2,1,3,1,2014-01-21 12:33:29,2014-01-21 12:33:29
ea9ea3fe928e3cca8b297edd4ba0c38bcb424c0b...eba8aa742c63f387f4444e25ad924bb7066ee523,1,9,0,9,1,2014-01-14 19:45:20,2014-01-14 19:45:20
69ff7657d7741558eff120eb9dfde1c5cab87609...ccae561f9bf5ff091760a3a0d7fa091e46d38a59,2,10,2,12,3,2014-01-23 08:08:26,2014-01-23 08:08:26
ccae561f9bf5ff091760a3a0d7fa091e46d38a59...68590fddd860c5d840d8f04314ed11f0d02ddd44,2,4,1,5,2,2014-01-23 08:13:23,2014-01-23 08:13:23
69ff7657d7741558eff120eb9dfde1c5cab87609...03e0a759af4decaad1b0a5fc2ae60a2e447ea067,2,4,4,8,4,2014-01-23 07:57:28,2014-01-23 07:57:28
6d3a92f22536ef01e8d770b11ba04ffe448b5679...b373158077d7033019172e5105717542d46e326a,2,9,5,14,6,2014-01-24 07:42:24,2014-01-24 07:42:24
6d3a92f22536ef01e8d770b11ba04ffe448b5679...be150fa9913d760802dc4c673ed59930f03ffec0,1,1,1,2,1,2014-01-23 17:24:31,2014-01-23 17:24:31
6d3a92f22536ef01e8d770b11ba04ffe448b5679...42220f2a18f69ab23c496aa93a1b8d528d2d0004,2,0,2,2,2,2014-01-23 14:14:07,2014-01-23 14:14:07
0955a45a53e206087f0dcc10fd5b41450c37b4c9...2a496c095ab355fd1819c8434ed72e640ba1aa2c,2,2,0,2,2,2014-01-26 19:32:31,2014-01-26 19:32:31
2a496c095ab355fd1819c8434ed72e640ba1aa2c...c7966a426bab8c6807efad094a5fee0381a901e2,2,2,0,2,2,2014-01-26 19:33:04,2014-01-26 19:33:04
c7966a426bab8c6807efad094a5fee0381a901e2...b95a56c18130a0ac2d4cf21cf36c5de4bbc6f686,2,120,134,254,7,2014-01-26 19:33:32,2014-01-26 19:33:32
b95a56c18130a0ac2d4cf21cf36c5de4bbc6f686...76be57fcf2d8c5bb9ab4ae0837233e6c7b8a0698,3,25,27,52,13,2014-01-26 19:34:22,2014-01-26 19:34:22
76be57fcf2d8c5bb9ab4ae0837233e6c7b8a0698...ffee5bb090c3723bb57e6858d32e9c34baba9912,7,487,152,639,18,2014-01-26 20:00:23,2014-01-26 20:00:23
ffee5bb090c3723bb57e6858d32e9c34baba9912...78b2fb5de9d96390110f469d057a2081be34a69b,10,93,86,179,12,2014-01-27 11:12:58,2014-01-27 11:12:58
78b2fb5de9d96390110f469d057a2081be34a69b...f304f975d67e9e7f4388b1401c3a580b29b8d8c8,8,32,8,40,13,2014-01-27 12:21:40,2014-01-27 12:21:40
f304f975d67e9e7f4388b1401c3a580b29b8d8c8...86e4f6e06ddb314c97e2bc3e027d9f0ee0d9a852,1,3,3,6,2,2014-01-27 15:36:30,2014-01-27 15:36:30
86e4f6e06ddb314c97e2bc3e027d9f0ee0d9a852...891ea6f6e66c753d9a2f7a4e261f4d37e118c253,7,11,14,25,9,2014-01-27 16:18:18,2014-01-27 16:18:18
39c2099106b462ed20668b759181fc7d0b0a356c...14bc7e0573267337ae566b42be0275275af46dc6,1,1,1,2,1,2014-06-24 13:15:10,2014-06-24 13:15:10
5eb734905cc92ce25ae29cc4f23a682d03b1fc8a...69baa3afb21ed7426b393a2b723b776b3a38dc6f,2,28,26,54,24,2014-06-24 17:22:33,2014-06-24 17:22:33
5eb734905cc92ce25ae29cc4f23a682d03b1fc8a...b6d79b681b62268ba3318d5453695a4968b06cb0,1,6,4,10,2,2014-06-24 14:57:34,2014-06-24 14:57:34
8c67c339dc631a6458d87deed7ce011562bb5e2a...30912c75b8e8eef7cd5d042f1266ec350aac6da5,2,20,3,23,3,2014-06-24 11:57:59,2014-06-24 11:57:59
72dd8011a739356ee66d90a0bb3adcb865495464...b5d7bcb7842d7a63de332e998d2c11ba3a5e1e6d,1,1,2,3,2,2013-09-27 14:06:06,2013-09-26 13:40:44
5e843a176982ed78cc2a6cf28618839e130cf608...13d00884073029c7e08da11303ab018fdf8c5e7f,1,1,1,2,1,2013-09-26 18:01:22,2013-09-26 18:01:22
e8975207535decfca0f8bc53d3a91ece6be146dd...a7bd18f9f2d684a2b37208e3ebd26d763bbc1ef3,1,2,2,4,2,2013-08-26 17:58:34,2013-08-26 17:58:34
a7bd18f9f2d684a2b37208e3ebd26d763bbc1ef3...0787726ae7b1692e019ca9d209f5a99ba6e9f294,3,3,0,3,3,2013-08-26 18:13:54,2013-08-26 18:13:54
b00ee27ccfe1b8d9828985a6cd87f0786edca89b...11ecf007810548d6e919cc032b3c9bcaf74bba48,1,1,0,1,1,2013-08-10 17:54:17,2013-08-10 17:54:17
11ecf007810548d6e919cc032b3c9bcaf74bba48...37cf2eb691b19998b69b8ad9bf8489837d00c81a,2,22,11,33,3,2013-08-10 18:10:24,2013-08-10 18:10:24
37cf2eb691b19998b69b8ad9bf8489837d00c81a...0175e665893ca8f8fd660ff55841e95c02fcb987,3,4,8,12,5,2013-08-10 18:20:03,2013-08-10 18:20:03
0175e665893ca8f8fd660ff55841e95c02fcb987...083990c795c74a0dfc76813e44706289a7ede43d,8,29,12,41,13,2013-08-12 09:08:52,2013-08-12 09:08:52
083990c795c74a0dfc76813e44706289a7ede43d...7984d3ca00edf45fed8bad6ed921060244970977,5,14,21,35,8,2013-08-12 09:38:30,2013-08-12 09:38:30
7984d3ca00edf45fed8bad6ed921060244970977...e2f946fddb7caf9757b33ba3dc7de8634f4ee825,4,11,7,18,6,2013-08-12 14:21:57,2013-08-12 14:21:57
e2f946fddb7caf9757b33ba3dc7de8634f4ee825...7ecebdd02df9b11fa6ba4f8033dcfe097935ed66,7,80,55,135,12,2013-08-12 15:21:47,2013-08-12 15:21:47
7ecebdd02df9b11fa6ba4f8033dcfe097935ed66...a0228f94a14a4401cb77f2bb13444794bb6888aa,2,9,0,9,2,2013-08-12 16:28:10,2013-08-12 16:28:10
a0228f94a14a4401cb77f2bb13444794bb6888aa...57b62c2b98bbebd1732c439fab2a3ff119ba5051,1,2,0,2,1,2013-08-12 17:59:06,2013-08-12 17:59:06
57b62c2b98bbebd1732c439fab2a3ff119ba5051...7300440a74fb476bad454a99d3a39e509d77e70f,2,71,55,126,7,2013-08-12 19:22:31,2013-08-12 19:22:31
7300440a74fb476bad454a99d3a39e509d77e70f...9711acc9e1e24955a28ab09994bbfd9ed538aeb3,1,5,1,6,1,2013-08-12 19:23:01,2013-08-12 19:23:01
9711acc9e1e24955a28ab09994bbfd9ed538aeb3...34c97a311c6463bb171a46eaf4a5357aed41964d,1,6,6,12,3,2013-08-12 19:28:31,2013-08-12 19:28:31
34c97a311c6463bb171a46eaf4a5357aed41964d...a36195bd2853bfef1b6883eef64334767e12fcf1,2,7,4,11,4,2013-08-13 09:04:11,2013-08-13 09:04:11
a36195bd2853bfef1b6883eef64334767e12fcf1...7825830ca51dc7bf84ca6216c3b66e3ce1c63c44,4,11,10,21,8,2013-08-13 09:24:10,2013-08-13 09:24:10
7825830ca51dc7bf84ca6216c3b66e3ce1c63c44...31e9f82ebc24ff04cb4eeaf933f6f3b158a38a62,5,29,17,46,15,2013-08-13 13:26:48,2013-08-13 13:26:48
31e9f82ebc24ff04cb4eeaf933f6f3b158a38a62...04ccf8bc2f96eb73229a39278f84814b849262f2,2,4,4,8,4,2013-08-13 13:26:59,2013-08-13 13:26:59
04ccf8bc2f96eb73229a39278f84814b849262f2...b6fdca9c81e617062f86bcd3a1d4d35f058faad1,2,3,3,6,3,2013-08-13 13:57:47,2013-08-13 13:57:47
01be32043af7ffb6981086f7fc05891bed578c15...fb36355f2ff6d4c5465158608c60e0d33cb552ee,2,10,1,11,2,2013-08-10 16:12:25,2013-08-10 16:12:25
fb36355f2ff6d4c5465158608c60e0d33cb552ee...f3fa44721dcaf9f87b1907b0607ff6e6098eadb7,3,8,14,22,3,2013-08-10 16:30:27,2013-08-10 16:30:27
f3fa44721dcaf9f87b1907b0607ff6e6098eadb7...5b8cc95d6e12cf01b81d3ab06b2110847107241f,1,1,2,3,1,2013-08-10 16:37:31,2013-08-10 16:37:31
5b8cc95d6e12cf01b81d3ab06b2110847107241f...3281021e8b42ba4d0fff5be268f5c43dd6ab4ff8,14,153,77,230,36,2013-08-10 17:25:53,2013-08-10 17:25:53
3281021e8b42ba4d0fff5be268f5c43dd6ab4ff8...80ee5ed88db2ec2c574674b37715433898e3e1c7,2,0,52,52,2,2013-08-10 17:26:58,2013-08-10 17:26:58
055b3c4dd649075a1df75cc24d6b38248112ebf5...405492e90c4804dc327df73e9b8052abeef53703,1,11,11,22,3,2013-12-24 02:01:38,2013-12-24 02:01:38
055b3c4dd649075a1df75cc24d6b38248112ebf5...e6f83399f3e5d3f245428d2495552317eefe8cfe,1,7,2,9,3,2013-12-23 18:28:59,2013-12-23 18:28:59
e6f83399f3e5d3f245428d2495552317eefe8cfe...62f1c97720f20f56a6bc4f1dd39194846953642d,1,14,0,14,1,2013-12-24 08:55:45,2013-12-24 08:55:45
abf11135c228790f212beb5e1ff716f9ebd33ebd...d80fa8025b2feec5cd4485551e1bc95a92371e5d,1,6,1,7,1,2013-12-08 16:45:56,2013-12-08 16:45:56
fd3ab6955f85142c6694ddea7aeb8335a2f08275...4d896a2b8679eca3777b9d11b91cdd9d1dd72b0e,1,1,1,2,1,2014-02-27 07:38:11,2014-02-27 07:38:11
4d896a2b8679eca3777b9d11b91cdd9d1dd72b0e...c94dc3de787c301a7d0d0ca62b475d2ecbfa4630,1,1,1,2,1,2014-02-27 09:12:12,2014-02-27 09:12:12
fd3ab6955f85142c6694ddea7aeb8335a2f08275...e27746f1ed954f540247d5c6592cc9813a523f52,1,1,1,2,1,2014-02-26 18:34:37,2014-02-26 18:34:37
03920b96d01ea4f5267c7ccd1aa036eab17d62b4...7ba0b502d3e6fdc5efc5619d803a1b9fcf9db791,8,31,1,32,21,2014-03-03 15:58:44,2014-02-18 10:12:01
7ba0b502d3e6fdc5efc5619d803a1b9fcf9db791...edd6028bdb1f0e8ba6744540e9d3f324ab40126d,14,1,36,37,14,2014-03-03 15:58:44,2014-02-18 10:46:01
edd6028bdb1f0e8ba6744540e9d3f324ab40126d...b59d105c0e541520073761b15ce575be3518cef2,1,1,1,2,1,2014-03-03 15:58:44,2014-02-18 10:13:16
b59d105c0e541520073761b15ce575be3518cef2...8e421d2bcb8088fa065b9bd8a6e1776c5140f4cd,3,31,9,40,7,2014-03-03 15:58:44,2014-02-18 13:44:00
8e421d2bcb8088fa065b9bd8a6e1776c5140f4cd...eeb011e34a2ccc3ff8a37bd91d8cb7b5cc033228,2,0,8,8,2,2014-03-03 15:58:44,2014-02-18 10:14:04
eeb011e34a2ccc3ff8a37bd91d8cb7b5cc033228...ec196fbbf2cb1849631d921015296806d0563da6,1,1,1,2,1,2014-03-03 15:58:44,2014-02-18 11:19:08
ec196fbbf2cb1849631d921015296806d0563da6...7959455f4d5dc25963176b9f83981b17b415996e,1,0,6,6,2,2014-03-03 15:58:44,2014-02-18 11:14:27
7959455f4d5dc25963176b9f83981b17b415996e...306744bbb0a5e1fc6253ec9512cbae87df2a94c7,3,21,16,37,4,2014-03-03 15:58:44,2014-02-18 13:27:39
306744bbb0a5e1fc6253ec9512cbae87df2a94c7...ad278c4e7468cc7aac8af27199bc6851853cf779,3,8,18,26,3,2014-03-03 15:58:44,2014-02-18 16:32:12
f1d8efb7700fb95b98924ffe2e65dd08f7f376c9...d02e129a549190c3bd26ed32eac13dfa62f2844d,1,1,1,2,1,2014-03-05 11:23:44,2014-02-26 19:04:32
81527e9fba64a276d58e17074721668bd213f57c...e421772f8935b9bdce02b6f552593f8dabca9074,1,0,6,6,1,2014-03-25 17:53:30,2014-03-25 17:53:30
e421772f8935b9bdce02b6f552593f8dabca9074...7f67e066dc9749d2532d220fafa3f397a5fe1f24,2,2,2,4,2,2014-03-25 18:10:08,2014-03-25 18:10:08
81527e9fba64a276d58e17074721668bd213f57c...01ec6c793c533306365319e3bf01174a976352d0,2,3,1,4,3,2014-03-25 17:53:09,2014-03-25 08:25:31
01ec6c793c533306365319e3bf01174a976352d0...02850210b6694983bed0c3eb7ad8dedfc7d95c54,1,2,2,4,1,2014-03-25 17:53:09,2014-03-25 08:52:27
02850210b6694983bed0c3eb7ad8dedfc7d95c54...eda2c0c607e4f12803d9021f9f2eacf56a4d2fcd,2,24,3,27,4,2014-03-25 17:53:09,2014-03-25 11:40:49
eda2c0c607e4f12803d9021f9f2eacf56a4d2fcd...0a4283b50adb10c13cf2f00c83e372549a004a05,2,12,9,21,7,2014-03-25 17:53:09,2014-03-25 12:10:32
0a4283b50adb10c13cf2f00c83e372549a004a05...12c3962fc0741f4976688a9a15c5865b23414181,1,5,3,8,2,2014-03-25 17:53:09,2014-03-25 13:00:43
12c3962fc0741f4976688a9a15c5865b23414181...d26302215a81b3428ba121fe58be904ea1ac7b6e,1,16,14,30,2,2014-03-25 17:53:09,2014-03-25 16:25:16
d26302215a81b3428ba121fe58be904ea1ac7b6e...5245fac63b7ec7b4ad17c91e821350cff8e3bf04,2,7,1,8,2,2014-03-25 17:53:09,2014-03-21 21:11:01
5245fac63b7ec7b4ad17c91e821350cff8e3bf04...9dd58c320a38cbcaf8134157103b2b2a2fad76d2,2,6,3,9,3,2014-03-25 17:53:09,2014-03-25 16:54:32
e868de687da060a109bd67fd492ed110eb134d47...64e4b400d0e15f675315bce2dc286b64ee0041e4,3,17,0,17,3,2014-02-23 14:13:38,2014-02-23 14:06:49
e868de687da060a109bd67fd492ed110eb134d47...e83fead6d14a17c40753e87792f6576ce9f97db4,1,1,0,1,1,2014-02-23 13:30:06,2014-02-23 13:30:06
e868de687da060a109bd67fd492ed110eb134d47...170340e6b15f91e79cf683c892ec887c3115b317,59,0,0,0,0,2014-02-23 09:34:39,2014-02-23 09:04:56
e868de687da060a109bd67fd492ed110eb134d47...4e0a2e3c968cd6be218577b3a615b888822c99cf,2,3,3,6,3,2014-02-22 15:11:54,2014-02-22 15:11:54
4e0a2e3c968cd6be218577b3a615b888822c99cf...bb35c2d36f4f275cda650c1ad47595c287feba10,4,21,1,22,6,2014-02-22 15:37:10,2014-02-22 15:37:10
493c7a614782381a5267939d5b5cf7bdb61daf3a...1c6e93edf9f3496903cd68510e9118405fd2b8e9,1,1,0,1,1,2014-03-17 15:33:29,2014-03-17 15:33:29
02b310dffbd4f65883e8b388edbd04afb87d2dd0...e07b2f527fcaff6f2a998b0a74b0669389fbbbe6,3,4,1,5,4,2014-03-14 12:41:28,2014-03-14 12:41:28
e07b2f527fcaff6f2a998b0a74b0669389fbbbe6...17a9ecf8cf6724613b38c08040bdb786ffe30718,1,1,3,4,1,2014-03-14 12:43:50,2014-03-14 12:43:50
5ebdbfab8443707aaff8d5a006f4968bd7b7c489...3dcfae75244126d47d880c2351a8d280fb3fac47,1,1,0,1,1,2014-02-28 07:57:19,2014-02-28 07:57:19
3dcfae75244126d47d880c2351a8d280fb3fac47...4710897c0d6211b55be2f72a93604582d27d305e,1,1,0,1,1,2014-02-28 08:06:17,2014-02-28 08:06:17
4710897c0d6211b55be2f72a93604582d27d305e...f4b2cee695ace72d9eb31fd0fefa42745148b6a4,1,0,2,2,1,2014-02-28 08:18:49,2014-02-28 08:18:49
ba9ff219730fb4d41daf702ff7d4246ff62a6025...049d0cc396669d7b970fc3d23e87eb62b3e57b75,1,1,1,2,1,2014-02-28 14:56:41,2014-02-28 14:56:41
5d6e4bd2d8d2e45407bb437e5b22656cffedc15a...8fe10e642ad9b5d236d2b00cea475bdc519130c0,1,2,0,2,1,2014-02-26 17:26:31,2014-02-26 17:26:31
5d6e4bd2d8d2e45407bb437e5b22656cffedc15a...91c70c5b1c60160253520a5ac6ac3eec46faf416,1,1,2,3,1,2014-02-26 16:32:52,2014-02-26 16:32:52
5d6e4bd2d8d2e45407bb437e5b22656cffedc15a...a47a6f2afd7021600964b6580e863b888532031c,1,3,2,5,3,2014-02-26 16:26:48,2014-02-26 16:26:48
5d6e4bd2d8d2e45407bb437e5b22656cffedc15a...a9280de11f6b5255de2feeaab618aab0ac54db38,4,26,9,35,9,2014-02-26 12:06:31,2014-02-26 12:06:31
b2cab1c52ad32166c49903d00f25c305aa225ddb...37e211822ea1abda42c7051019f25433a772e209,1,1,1,2,1,2014-02-27 14:02:57,2014-02-27 14:02:57
b2cab1c52ad32166c49903d00f25c305aa225ddb...0de7a7cfcdd1556a3353f8d88053db54a0844ed3,1,2,0,2,1,2014-02-27 13:55:22,2014-02-27 13:55:22
0de7a7cfcdd1556a3353f8d88053db54a0844ed3...ccd617e58ea71c42b6b073e692447d0fe3c00be6,1,4,0,4,1,2014-02-27 13:56:35,2014-02-27 13:56:35
b2cab1c52ad32166c49903d00f25c305aa225ddb...cac868ee94cd28792845882f66d75aee6e9c5acd,3,4,4,8,4,2014-02-27 13:52:14,2014-02-27 13:52:14
49d6721329bd9fccf656bb750ee8f6c712852cf6...04b09bdd6793df01ef488a8480be8fce48cb3f09,1,22,19,41,14,2015-02-07 23:16:29,2015-02-07 23:15:46
89f8020fe12e16faf125a193b25a0eeaea3b49c0...eef461d4a1751915d15b10af6d4f36e28b67cf20,2,77,63,140,14,2015-02-07 23:35:44,2015-02-06 21:40:45
89f8020fe12e16faf125a193b25a0eeaea3b49c0...4cce10583d55360430e0f660ddf3c527f6a42026,1,2,5,7,1,2015-02-07 07:57:28,2015-02-07 07:57:28
7bcf1c0044d052027a88b8e79269575f048c5d55...75048fcd6917cfc25795bcca0929d442f9c65be4,1,1,1,2,1,2015-02-24 19:46:42,2015-02-24 19:46:42
8bcff0f1c14710aacef6cb188ca34fc26b401707...1e42cd2040c788774734e6621b426b3d99362123,1,1,1,2,1,2015-02-24 18:09:38,2015-02-24 18:09:38
a33e615b471f8c9b49b1a1baf79f7380ce606790...9c4337e58bf8a5e2c9085a1f4eff0e942d659d2d,2,2,2,4,2,2015-02-24 18:01:41,2015-02-24 18:01:41
7f200b7d18cddd141f964bd9da5eeb9b9df3fad5...5b6d6bbc195c438de0babb9a1f0b6971bbd5673e,1,1,1,2,1,2015-02-24 17:42:35,2015-02-24 17:42:35
5f7a3e1bbdcb6044e4b25d0a7722b10f9140bb46...43f1ab9c12630e85861003c424da43314c2768a8,1,1,2,3,2,2015-02-25 22:25:08,2015-02-25 22:23:49
367d9a2dc683ef549905f35186412b5248376028...a8a328b1513c0aa442faaf8e8dd6f06f86ac3211,11,53,39,92,21,2015-02-18 08:16:42,2015-02-18 08:16:42
a8a328b1513c0aa442faaf8e8dd6f06f86ac3211...a6070074bc30cf2e6c9eb9b053fc79bdd35d9d6b,1,1,0,1,1,2015-02-18 08:17:23,2015-02-18 08:17:23
a6070074bc30cf2e6c9eb9b053fc79bdd35d9d6b...63f11a68c5e9edf36d062bd4f029d81a0861ef82,5,25,10,35,9,2015-02-18 17:38:46,2015-02-18 17:38:46
01d86d33a18189e8b3e24f1c2e35f3a4622db0d6...b86caf0de317cfc4012f10d30a2e15eef471948e,1,28,31,59,6,2015-02-15 23:10:47,2015-02-15 23:10:47
ee804e2d94018f633c6e400b443ef514b5d7a10f...1da7781cb313d4df2514a1bfc6ad125e9539371c,1,6,0,6,1,2015-02-15 03:11:45,2015-02-15 03:11:45
1da7781cb313d4df2514a1bfc6ad125e9539371c...655e9c6b4278102e78ffb7de13ca7b0b0f454c2a,1,1,0,1,1,2015-02-15 03:45:16,2015-02-15 03:45:16
ee804e2d94018f633c6e400b443ef514b5d7a10f...49d509935284c2f07c8f5cb53a31d5787c6ef7ab,2,8,5,13,3,2015-02-15 02:46:39,2015-02-14 20:26:08
49d509935284c2f07c8f5cb53a31d5787c6ef7ab...020ec31eb5f09380e8cdcc877ffbdf27b0afb2d7,1,1,0,1,1,2015-02-15 03:47:57,2015-02-15 03:47:57
020ec31eb5f09380e8cdcc877ffbdf27b0afb2d7...9e0467c38efb1a279b87cf17df5fb1b9b85aa0fe,2,2,2,4,2,2015-02-15 22:53:33,2015-02-15 22:43:18
9e0467c38efb1a279b87cf17df5fb1b9b85aa0fe...e0f61a59b4e9be1fc2f20320a0400793318b8a9f,2,2,4,6,2,2015-02-16 03:50:53,2015-02-16 03:50:53
9e9ce95d62ec4feb76c3ec238dd3189c781f40ce...83e2a1ca12372279cf7948b4d4b3e8a11c50e428,7,11,11,22,11,2015-02-20 04:25:28,2015-02-20 04:07:54
7f97c320f9ae265346ba367464c77d147d6436c2...61acaff5a1e4db254c92854e639aa0cb8c2d3cff,2,3,3,6,3,2015-03-04 18:49:48,2015-03-04 18:49:48
317e8cfee091f6633e51ccc321e0c3feaec46bf2...b6a678ef43f763b3c507ace0639b802207ed3cb7,1,2,2,4,2,2015-02-17 04:27:58,2015-02-17 04:27:58
d884c210049b59b4cfcbb2c9bd162595acad7204...252443893ce6e4ca2caaca8eefe75c918c20ffff,1,6,1,7,1,2015-01-06 05:48:04,2015-01-06 05:48:04
d884c210049b59b4cfcbb2c9bd162595acad7204...33a510685706549fcf61f78021ce7099ea23e067,1,5,1,6,2,2015-01-06 05:36:58,2015-01-06 05:36:58
d884c210049b59b4cfcbb2c9bd162595acad7204...3d7519016f9fc3642e1d672d3f80092562e9505a,2,12,6,18,5,2015-01-06 04:04:53,2015-01-06 03:57:09
ac1584249c262e447a6360734597fa17fe077718...05dd6309baa3c0dbc4346c33136a30c5c1cf6922,1,1,1,2,1,2015-01-02 13:54:51,2015-01-02 13:54:51
ac1584249c262e447a6360734597fa17fe077718...67b06e7a9b54e39b2f104079dfb293645d8352c7,4,3,14,17,5,2015-01-01 23:20:19,2014-09-29 21:58:01
ac1584249c262e447a6360734597fa17fe077718...33c9f05c6bb90a995ddc685b4a22479f17c575e5,14,41,37,78,30,2015-01-01 20:12:00,2014-10-09 07:47:47
ac1584249c262e447a6360734597fa17fe077718...d37cf2a23da0fcbaca695092822e9cd2af4b1bdb,1,1,1,2,1,2015-01-01 20:11:38,2014-10-19 08:02:13
ac1584249c262e447a6360734597fa17fe077718...56f211aa50246ff167894fcd050acad88d81f59e,2,30,0,30,2,2015-01-01 02:37:31,2014-09-05 01:57:28
56f211aa50246ff167894fcd050acad88d81f59e...82dec3baf284675564a3c3adc9c198519828bc67,1,0,7,7,1,2015-01-01 02:37:31,2014-09-05 01:59:45
82dec3baf284675564a3c3adc9c198519828bc67...2c9b35732409c2a73150788067e1b03b91101f39,2,2,12,14,2,2015-01-01 02:37:31,2014-09-05 09:43:52
ac1584249c262e447a6360734597fa17fe077718...e5c0e2603ac6946c08b1c0be0f74cf857f234bd6,4,4,4,8,4,2014-12-31 20:05:38,2014-12-31 20:05:38
ac1584249c262e447a6360734597fa17fe077718...021cff67f3514b4c2cb1f7b859cbfc314afa0a0c,2,12,1,13,2,2014-12-31 02:15:04,2014-12-31 02:15:04
021cff67f3514b4c2cb1f7b859cbfc314afa0a0c...3efb06a22bb970c0e6db0bbd1fc9f8c4caba44ba,1,28,0,28,1,2015-01-10 20:37:48,2015-01-10 20:37:48
3efb06a22bb970c0e6db0bbd1fc9f8c4caba44ba...32233d522f6b4cab90835643b8a3d2e2a890cb64,1,1,1,2,1,2015-01-10 23:15:56,2015-01-10 23:15:56
32233d522f6b4cab90835643b8a3d2e2a890cb64...02adb9ccd605a10984f4af582fcd9b22bfab52d7,2,2,2,4,2,2015-01-11 04:07:34,2015-01-11 04:07:34
884352294deab0c11845547ce2ab96b60f468458...1d8dcfaf8be8679556e1602d0061fc5cdd828845,4,5,4,9,5,2014-12-30 21:59:38,2014-12-30 20:50:08
bb1f8b1d8be3d2cfd4467ff78bff875498e1b0e2...72c3d728c4e5193997a154bb9424b97672e30027,1,1,1,2,2,2015-01-13 18:45:14,2015-01-13 18:45:14
9e222d6d0e00111bcb67ee2c822071206f658511...ff39821935d04f50beff8f15c789bd0f327dca10,1,17,0,17,1,2015-01-08 23:43:34,2015-01-08 23:43:34
8b53d9efe648f10e0572c2d8017489d0d3bb4755...663b3c968f73f8ffebf32059fed86192ecbee5d8,4,36,6,42,7,2015-03-06 17:09:00,2015-03-06 16:14:19
663b3c968f73f8ffebf32059fed86192ecbee5d8...84ebc22ad2d9296d23b442948dd3435b33d36cbe,1,1,1,2,1,2015-03-06 22:12:26,2015-03-06 22:12:26
8b53d9efe648f10e0572c2d8017489d0d3bb4755...7e204cf389346d23e71bc4c2fa9e14cf82a7ed2e,35,736,19,755,53,2015-03-06 14:54:00,2015-03-05 18:38:23
8b53d9efe648f10e0572c2d8017489d0d3bb4755...b673d87227867f6d142ee6e615c750a600661c6b,5,33,46,79,16,2015-03-06 14:01:13,2015-03-06 14:01:13
8b53d9efe648f10e0572c2d8017489d0d3bb4755...b14d21e1749b682bbdfebad80cf404c2b640b551,2,14,114,128,4,2015-03-06 10:18:53,2015-03-06 10:18:53
88e4aed9df812eee9af2f27a975eeac894580042...5f40253f7696e920614328246120805fbf79d97c,1,2,6,8,2,2015-03-11 23:07:33,2015-03-11 23:07:33
88e4aed9df812eee9af2f27a975eeac894580042...d2d709a252ec4c26894b269a03df871fe51e8b82,3,15,14,29,12,2015-03-11 23:05:01,2015-03-11 23:05:01
d2d709a252ec4c26894b269a03df871fe51e8b82...d6dda952b8eea8f6b08df9a4d12e5991929de3d4,2,5,3,8,4,2015-03-12 00:52:02,2015-03-12 00:52:02
88e4aed9df812eee9af2f27a975eeac894580042...5c4f567ea021a48fa53ef6c1b235775ec511fe09,2,4,4,8,4,2015-03-11 20:52:55,2015-03-11 20:52:55
f0a132ed992ea74c8a71335e94e300321c30ff09...6d0ff0ade8c136e1093a7f3336a58b361abdfd51,1,0,12,12,1,2015-03-11 01:09:13,2015-03-11 01:09:13
c621a7712b7f75e0a71224c15983e68fd465d69b...536d4373737cf5c4710d949fb4819d99faf2cdd7,2,5,0,5,2,2015-03-11 16:31:39,2015-03-11 16:31:39
536d4373737cf5c4710d949fb4819d99faf2cdd7...66384d7d4434f9185dbe8bfe22cb7db974763ed3,1,1,0,1,1,2015-03-12 00:50:02,2015-03-12 00:50:02
06439fd78422066072bc12e45f409a59794375b9...3aded9d5816b8605d5ccf486ab2e38247e2b654f,1,5,4,9,4,2015-03-14 00:47:30,2015-03-14 00:47:30
06439fd78422066072bc12e45f409a59794375b9...8c2655b5bf935830313db99fc83c34771ecbd609,2,0,7,7,5,2015-03-14 00:44:54,2015-03-14 00:44:54
07f9a3f928d39accf876d052b265844f74130099...2172d7ff9e6369d963199348291046f6e06a4215,2,3,1,4,2,2015-03-13 21:17:51,2015-03-13 21:17:51
20477eb5caeae80ff7dd7e09e2d68278da629ce2...b63e6e5abca5e538a2500a54c6be1a030ed3b0f8,1,1,1,2,1,2015-01-19 22:14:00,2015-01-19 22:14:00
45bebd76d639e72aeb5b415a1f801659d8df8607...ae1be437227d4bf7c19ae5eb4aab88d3d2cd8d53,1,1,1,2,1,2015-01-21 23:58:35,2015-01-21 23:58:35
a113ce48e35dafa2bd3cc774827bded360b9c6da...6f4332725d0d5feb1062055c6050eef85cfd2aa2,1,5,1,6,2,2014-12-23 12:39:31,2014-12-23 12:39:31
2fef5c1323ee684b1d38241f92e5dac7fb446671...e8818da3055d057134e0e26b872c06e3dd9268ff,1,3,1,4,1,2014-12-23 07:37:26,2014-12-23 07:37:26
2fef5c1323ee684b1d38241f92e5dac7fb446671...e99ea1146aa15c712113bfb33322be8754d1696d,1,2,2,4,1,2014-12-22 19:58:22,2014-12-22 19:58:22
2fef5c1323ee684b1d38241f92e5dac7fb446671...3f129fd618bb5f6568ab95c7c7f4450c897bd3c2,1,3,2,5,3,2014-12-17 10:07:10,2014-12-17 10:07:10
679b450c49198734dcce96ca996dce7456838d26...37163d7c750c4e517dd0cc08707e690bb6a23730,1,19,18,37,14,2015-01-11 03:28:50,2015-01-11 03:28:50
394e2ec50b066b5e911b749aa13192ab50e703d4...18fa1550251655ce84a0886caaab7262fbeb9c51,3,28,0,28,4,2014-12-30 17:19:48,2014-09-28 09:52:14
394e2ec50b066b5e911b749aa13192ab50e703d4...3a3b0da81e2320be890ddb9c00a055ea4c6a305b,3,17,22,39,4,2014-12-30 16:44:31,2014-10-03 10:56:48
a7b7a2dd4c866403ec5536f213df9e4762fa112b...aacf07467c1a30b349b8fa1d0155e8c95418bafe,1,2,2,4,2,2014-12-26 21:54:12,2014-12-26 21:24:21
a7b7a2dd4c866403ec5536f213df9e4762fa112b...5b51ef7bdd50e4171e7bdd82e242ac3da35156f7,1,12,0,12,1,2014-12-26 17:14:23,2014-12-26 17:14:23
5b51ef7bdd50e4171e7bdd82e242ac3da35156f7...ce6b0519ccddff2476d2255df49b39ccdb07013e,1,5,8,13,4,2015-01-12 15:47:39,2015-01-12 15:47:39
ce6b0519ccddff2476d2255df49b39ccdb07013e...1cdce0f1828edd806f66999f84de404f24c77dc0,1,7,3,10,2,2015-01-13 14:47:35,2015-01-13 14:47:35
a7b7a2dd4c866403ec5536f213df9e4762fa112b...465f186954d00fa47c8b05cc91f33e7943aa209a,4,9,42,51,9,2014-12-26 16:33:53,2014-12-26 16:33:53
9a3ae331adac6f4cc5ace771f740981811bdb41e...f28a12a559ef5492b583f0ae5dff5dcb49c7afe1,1,4,2,6,2,2014-12-12 11:15:42,2014-12-12 11:15:42
f28a12a559ef5492b583f0ae5dff5dcb49c7afe1...118bd7178b2be5f8a8fbcfa6af66e9e6d299b658,3,6,2,8,3,2014-12-12 11:28:48,2014-12-12 11:28:48
118bd7178b2be5f8a8fbcfa6af66e9e6d299b658...bfebab1c10345a4a36490efaf2297c6f2f97f0d6,1,6,2,8,3,2014-12-12 13:55:06,2014-12-12 13:55:06
0f07c18a9fc98badd33473705e457789dfb6eee4...9c9dc64a40d0a3c9e7265436e82dbe055320be97,1,1,1,2,1,2014-12-11 11:26:34,2014-12-11 11:25:59
5555c4d99c3d2eeaf171d6e4178a1b7c93b363a6...10e4e2110c388ac43f1ebf437b963f13a1882129,6,18,9,27,12,2015-02-19 04:49:19,2015-02-19 04:49:19
10e4e2110c388ac43f1ebf437b963f13a1882129...ff70d2f24e8b437a4c006b61a9b669309718baad,2,16,11,27,8,2015-02-19 06:06:49,2015-02-19 06:06:49
ff70d2f24e8b437a4c006b61a9b669309718baad...a3d039259e56cd7cb6551c21551f010ea12e6acc,3,3,3,6,3,2015-02-19 06:07:09,2015-02-19 06:07:09
602fd68dc194fd47dbeb88b56d5db7eee04472a0...bf69d183461f61e3822c167ff8a65a89d58e80ff,1,19,0,19,1,2014-12-22 15:35:47,2014-12-22 15:35:47
2a494d99faabb3b34bbb6e57a8d93bafd4f002be...0d5265bbec0ffec004fab0b85b81a0a1bea3b471,3,15,8,23,3,2014-12-07 10:29:37,2014-12-07 10:29:37
2a494d99faabb3b34bbb6e57a8d93bafd4f002be...369375d0862f16f7a9926374226b1bad028f530c,1,0,0,0,0,2014-12-07 00:24:03,2014-12-07 00:24:03
2a494d99faabb3b34bbb6e57a8d93bafd4f002be...04fa03a7d84581d4c5817920456d6b1dc4cb1a58,1,3,7,10,6,2014-12-06 16:22:19,2014-12-06 16:22:19
800aacef563dd43b48d7ce58585a626a8d20f95e...ccdf7a329a3eb483a6ec2f9c68d77f5697844f0d,1,2,1,3,2,2014-04-25 03:38:54,2014-04-25 03:38:54
fead96788c30c13b5adc25132cd003638a6d4f51...e617cf95d448891d51361154d6845218cb5a4508,3,31,1,32,3,2014-04-08 15:12:57,2014-04-08 15:12:57
fead96788c30c13b5adc25132cd003638a6d4f51...301c4068e13c838368fa2f5d9e2e9af2b2124c23,1,58,0,58,1,2014-04-08 14:12:18,2014-04-05 19:31:07
301c4068e13c838368fa2f5d9e2e9af2b2124c23...8af8bee4538baa703085ccc2f44df2c967618ca4,1,15,26,41,4,2014-04-08 14:43:21,2014-04-08 14:43:21
fead96788c30c13b5adc25132cd003638a6d4f51...9924492adfe60844e5ab00b8ce12a17049cbe5b5,1,1,1,2,1,2014-04-08 14:10:10,2014-04-08 14:10:10
9924492adfe60844e5ab00b8ce12a17049cbe5b5...b2b790afa73f227ca60b64c557b6329c34213f06,1,1,1,2,1,2014-04-08 15:18:17,2014-04-08 15:18:17
5b123dbf7f587a58db2b45390dff43fa167dbb04...415c0f4bbe12dbd78bf24d50e66e3092df07fa21,2,2,1,3,2,2014-04-10 10:45:02,2014-04-10 10:45:02
5b123dbf7f587a58db2b45390dff43fa167dbb04...05eb22448604b784811bd6a1c8c1db599bf4b6b4,1,23,0,23,1,2014-04-10 09:23:44,2014-04-10 09:23:44
05eb22448604b784811bd6a1c8c1db599bf4b6b4...f7d2f36084aaf3ce40fac748b7cfe034f7738b0a,1,1,0,1,1,2014-04-10 09:28:12,2014-04-10 09:28:12
f7d2f36084aaf3ce40fac748b7cfe034f7738b0a...c927f0620a85a5b43e76d0fdd0a7d276ba9e44aa,2,2,7,9,3,2014-04-14 07:06:42,2014-04-14 07:06:42
fd8a165df70642efe44c5735b9c5b12da17d7b34...7793417206fcb62b8de156bcb8beeb4c10b371d9,1,1,1,2,1,2014-04-09 18:26:11,2014-04-09 18:26:11
731c009a80748aa6dc3f9d6460d9d6f7e3d27c18...def67592b4d3f15d404cba1c4f5bc0faef315629,1,4,0,4,2,2014-04-11 08:38:20,2014-04-11 08:35:57
731c009a80748aa6dc3f9d6460d9d6f7e3d27c18...0da8428f8efb7af188deb3e85ca911efbfb0e59e,2,6,4,10,7,2014-04-10 17:24:20,2014-04-09 15:24:12
ec5bfec24e798199d1c53f6ff74fb632e0d244e1...c5bbb15d0cd8faaad5045b444a7f25758552c9db,2,2,2,4,2,2014-04-14 11:50:31,2014-04-14 11:50:31
71678f08f8b008d06da98fdae1905e1880300c00...63ba983511461e749825abe120ec34f3e7c7fd96,1,3,3,6,3,2014-04-09 15:13:44,2014-04-09 15:13:44
71678f08f8b008d06da98fdae1905e1880300c00...b2959c4102b411c9e078ea21fd4b2f5411932290,2,7,0,7,2,2014-04-09 13:09:11,2014-04-09 13:09:11
b2959c4102b411c9e078ea21fd4b2f5411932290...944ebb8e2e06ac916024eed48ab7dc4b29f76de2,1,1,0,1,1,2014-04-09 13:17:37,2014-04-09 13:17:37
430562f3ca1978f7d094c0bce539b9ecc411d15f...c8c9c365a06f2cea7d68ea56b4c584ef7afab0e4,1,0,0,0,0,2014-04-29 06:28:03,2014-04-29 06:28:03
d54d3324b1ae46a60712dbb974214e41fca5b93b...2314438925af827b694fbaaf59c31c49dd2c0c31,5,30,34,64,17,2014-05-30 21:19:50,2014-05-08 17:15:58
2314438925af827b694fbaaf59c31c49dd2c0c31...3351f15af63929caec03c8dd0d62f52b8f7704eb,1,3,0,3,1,2014-05-30 21:34:52,2014-05-30 21:34:52
d54d3324b1ae46a60712dbb974214e41fca5b93b...5ba00d950bb15fde71f58ac08ec22e04cc9437d6,4,17,8,25,6,2014-05-30 20:43:53,2014-05-30 20:43:53
5ba00d950bb15fde71f58ac08ec22e04cc9437d6...e02aec662751d545b70fe014c757d7061c577016,2,45,4,49,3,2014-05-30 21:13:15,2014-05-30 21:13:15
e02aec662751d545b70fe014c757d7061c577016...1a97db413b03881f0ce4307811181776e3d6e408,4,23,38,61,18,2014-05-30 21:41:11,2014-05-30 21:41:11
1a97db413b03881f0ce4307811181776e3d6e408...c2c43e6aa1f9dc43d16f3d3c03ef247f73156db2,2,18,2,20,5,2014-05-31 11:00:23,2014-05-31 11:00:23
c2c43e6aa1f9dc43d16f3d3c03ef247f73156db2...8beb7c886e3bb9706bfa6760325453e749b84231,2,37,21,58,5,2014-05-31 11:21:13,2014-05-31 11:21:13
8beb7c886e3bb9706bfa6760325453e749b84231...e53f4a4ea541f3f7fd845fe395662ab86d196d55,1,6,6,12,3,2014-05-31 11:24:04,2014-05-31 11:24:04
e53f4a4ea541f3f7fd845fe395662ab86d196d55...5d6f5be0603e51514705976e35c2a6f2fff74c84,2,8,14,22,5,2014-05-31 11:48:33,2014-05-31 11:48:33
d54d3324b1ae46a60712dbb974214e41fca5b93b...65cf5957deec1816f867f0285b34f314599c905a,2,0,4,4,2,2014-05-30 18:11:07,2014-05-30 18:11:07
d54d3324b1ae46a60712dbb974214e41fca5b93b...72b295259ed8565e166a7f2a466ca33d183f6108,3,6,3,9,4,2014-05-30 15:22:59,2014-05-30 15:22:59
72b295259ed8565e166a7f2a466ca33d183f6108...e9de569458b55b43a0d09dceef07c3c5d583af24,4,22,18,40,14,2014-06-02 10:43:07,2014-06-02 10:43:07
814a459527db7a989c37bf5906da505a37a0d8c8...223070b3fe9cb302d3d47ba5a616d90bab8910fd,1,21,5,26,3,2014-04-22 10:06:54,2014-04-22 10:06:54
223070b3fe9cb302d3d47ba5a616d90bab8910fd...e79c915d3be1aa4dd5789d517be6b0665007e97a,1,4,4,8,2,2014-04-22 10:54:23,2014-04-22 10:54:23
69577b57f8c78254d408803aefb9d0f4a13e421d...a220fc54555f7d9d6ece9a4455ecf6afcc07d1e9,1,4,0,4,1,2014-05-26 08:14:58,2014-05-13 12:49:03
69577b57f8c78254d408803aefb9d0f4a13e421d...d41fba4d374c5b586a25b755d79a410574f09062,1,1,0,1,1,2014-05-13 15:08:59,2014-05-13 15:08:59
d41fba4d374c5b586a25b755d79a410574f09062...636ec6d3a048957b5cb348d7ff1b0b5bc6973bbf,4,12,20,32,7,2014-05-13 15:59:08,2014-05-13 15:59:08
5ddba39eef738c8f31b86c589bd459222728f9ae...caa876af90025f345d1d91466f80458b23ec0235,1,7,7,14,7,2014-05-13 13:01:13,2014-05-13 13:01:13
caa876af90025f345d1d91466f80458b23ec0235...b787540f71a3a7e68e940f39e7c903b0214a80e3,1,3,9,12,4,2014-05-13 13:40:08,2014-05-13 13:40:08
aeb5a01ed15929b116d1750b7da2433498c305e0...fd7a221cca9d5ac5338b265fb66b280e205b6330,1,2,2,4,2,2014-05-06 06:07:15,2014-05-06 06:07:15
aeb5a01ed15929b116d1750b7da2433498c305e0...de576be52e6a05b6db95d2559a53b71c249be5c4,1,1,1,2,1,2014-05-05 22:47:56,2014-05-05 22:47:56
aeb5a01ed15929b116d1750b7da2433498c305e0...06bed543e69c16d4c267d1bd49e879c3e9b761e9,4,26,0,26,11,2014-05-05 19:46:51,2014-01-22 00:34:39
06bed543e69c16d4c267d1bd49e879c3e9b761e9...11bedfe37d4a19d6aa22a45fbce6622bbbb09cb6,1,2,2,4,2,2014-05-05 19:48:49,2014-03-04 14:14:38
11bedfe37d4a19d6aa22a45fbce6622bbbb09cb6...a7bdf87f434a09afd7e96c2e7f99cc3fc5be9a07,1,20,0,20,5,2014-05-05 19:50:03,2014-03-04 14:14:58
b6ca6623abbebe205b1cf5d7f71cb31a08097739...2efcd3013a22555965a01d170c2b3a7775d92280,1,1,0,1,1,2014-05-12 11:57:20,2014-05-12 11:57:20
dd3a55064edb595215c70a77d655e5578ddfcb20...a8624cbe5927ceed786b5aa68fe9e917b1d8cbee,1,7,0,7,2,2014-05-07 13:50:56,2014-05-07 13:50:56
dd3a55064edb595215c70a77d655e5578ddfcb20...4fea8afc4bc507bf94d93c1ef04a9575add900ab,2,67,2,69,4,2014-05-07 13:14:24,2014-05-07 13:14:24
901fc30049d38ee2b242b26237f71964fccd68c3...5bf12bbb1d05e0f4fc2661ccd68e0c208499ba57,4,11,1,12,4,2014-04-30 15:28:05,2014-04-30 15:28:05
87c397f5774c4c11ba2e4c55098920c081e53670...d10b34a685509eebbe52391ffce861cde45cc0ca,6,34,2,36,7,2014-05-02 13:05:08,2014-05-02 13:05:08
87c397f5774c4c11ba2e4c55098920c081e53670...02421245256a145a2b29a81f210585b15d1f2b67,4,13,16,29,9,2014-05-02 11:48:32,2014-05-02 11:48:32
48dd07edbabaa349f55ca403cc157b8cfd155000...426bce65cf06990429d2d0ccb28ab854a02a837b,2,22,24,46,17,2013-11-25 13:02:25,2013-11-25 10:32:47
426bce65cf06990429d2d0ccb28ab854a02a837b...ddc44b908b31238a0164331dd8cd5be82eb32bd3,2,5,5,10,5,2013-11-25 14:53:44,2013-11-25 14:53:44
ddc44b908b31238a0164331dd8cd5be82eb32bd3...f539c8a30631357daf58917a1968798f91c85c56,1,3,2,5,2,2013-11-25 15:41:02,2013-11-25 15:41:02
ad90e2593f3112eeb60cef9ce7d0b0b79bb2defe...224d2c16967f271158464dae0d12e8dc8de35eb2,1,1,1,2,1,2013-11-25 14:29:08,2013-11-25 14:29:08
0ee296d1fa346ed7d3235a55959ffdccf550878c...d1781d3b1174b49da6d61f65d351ba40bdbc5314,2,18,23,41,12,2014-01-30 17:46:13,2014-01-30 17:46:13
d1781d3b1174b49da6d61f65d351ba40bdbc5314...c75ab4ec9aa217729d036344e0a52fafcf65fd17,2,0,18,18,2,2014-01-30 17:48:47,2014-01-30 17:48:47
b466217965965b1f6084d91eca44413658d09e99...3fafac3efa58f97abf4c1accaf303fa863876b7d,1,0,1,1,1,2014-01-30 11:20:35,2014-01-30 11:20:35
3fafac3efa58f97abf4c1accaf303fa863876b7d...89ab7e79adb76752f46ced38e74e396b020e84ff,2,3,3,6,2,2014-01-30 11:31:56,2014-01-30 11:31:56
89ab7e79adb76752f46ced38e74e396b020e84ff...30aae10e0519d9e0b10ea2224897168273ba6e4a,1,1,1,2,1,2014-01-30 11:33:29,2014-01-30 11:33:29
30aae10e0519d9e0b10ea2224897168273ba6e4a...ef735e82f303ef42591d7ad0d107bfd7c44aa8de,1,0,1,1,1,2014-01-30 11:37:06,2014-01-30 11:37:06
ef735e82f303ef42591d7ad0d107bfd7c44aa8de...57001c23326c94cb846bc74b9734e1b1b683f5dd,1,7,7,14,3,2014-01-30 11:49:18,2014-01-30 11:49:18
57001c23326c94cb846bc74b9734e1b1b683f5dd...d5e8fcb312db77e5f86815eec404294a4b3cf900,4,12,3,15,4,2014-01-30 12:02:57,2014-01-30 12:02:57
d476ac7d41f117ad9cf612e99216a4e7eaa04fb6...e78b90ab1d3c5831dea8dc04a83ce31b74aac70a,6,8,8,16,8,2013-12-16 08:57:50,2013-12-16 08:57:50
d476ac7d41f117ad9cf612e99216a4e7eaa04fb6...3229311b0bbc7ed26956bb9e390b3353d5f68166,1,4,0,4,1,2013-12-15 10:49:54,2013-12-15 10:49:54
d476ac7d41f117ad9cf612e99216a4e7eaa04fb6...d9b5777db182ba3ee2341b19246feba86adb5708,3,12,4,16,5,2013-12-15 02:21:12,2013-12-15 01:28:17
d476ac7d41f117ad9cf612e99216a4e7eaa04fb6...fa817dffeae76fa101ee8849bbac645307c0c82f,23,48,53,101,30,2013-12-14 21:24:12,2013-12-13 21:31:23
d87d46f9d9454dbf9aba082e1ea0b0b604375f78...3efbdbfda6402418bad09b12ef0be243d1529b62,1,5,2,7,1,2014-01-14 19:52:39,2014-01-14 19:52:39
3efbdbfda6402418bad09b12ef0be243d1529b62...fb0b9329379d3df9b22ab202556a15bd0181f13e,1,1,1,2,1,2014-01-14 21:55:51,2014-01-14 21:55:51
68590fddd860c5d840d8f04314ed11f0d02ddd44...a91faf40221fc574513f7e17a93a0a5a941b8fce,1,8,2,10,3,2014-01-23 11:07:21,2014-01-23 11:07:21
a91faf40221fc574513f7e17a93a0a5a941b8fce...f909739f396e71895829955f40ced755f4fbe772,1,8,3,11,3,2014-01-23 12:28:19,2014-01-23 12:28:19
68590fddd860c5d840d8f04314ed11f0d02ddd44...b057e58b6f32c9458fe212e8ef01ca4214860667,2,2,4,6,3,2014-01-23 10:44:53,2014-01-23 10:44:53
b057e58b6f32c9458fe212e8ef01ca4214860667...f1da402be753a7cfff1fe7c8be96ce61a1ec3f58,1,1,1,2,1,2014-02-11 09:06:25,2014-02-11 09:06:25
68590fddd860c5d840d8f04314ed11f0d02ddd44...9e6fc8b5269f8583e88c67c7cdc356f76a8237ed,1,16,2,18,9,2014-01-23 10:19:43,2014-01-23 10:19:43
68590fddd860c5d840d8f04314ed11f0d02ddd44...5e08f8134ebb695c15bf9c8f1899efdb68c7336f,1,1,1,2,1,2014-01-23 09:09:19,2014-01-23 09:09:19
2adbc0b778985ee6b0a78b5acd845904520ccc64...a82ba262cfd4aba3379f2643650b50930a7b6877,1,2,3,5,1,2014-01-25 16:57:18,2014-01-25 16:57:18
2adbc0b778985ee6b0a78b5acd845904520ccc64...17b422cf97c9f66ac9e87f9e22480042ccb37ce5,2,7,0,7,1,2014-01-24 11:09:33,2014-01-24 11:09:33
17b422cf97c9f66ac9e87f9e22480042ccb37ce5...b9062368ab9c2df1b371568609e8b05b54773f3c,1,1,1,2,1,2014-01-24 11:12:04,2014-01-24 11:12:04
b9062368ab9c2df1b371568609e8b05b54773f3c...3de736ed0f48fc00073b6e2b8699a48ec64466fd,1,1,1,2,1,2014-01-24 11:12:36,2014-01-24 11:12:36
2adbc0b778985ee6b0a78b5acd845904520ccc64...f89df5b496b3d2f64c9c7493848755c5baad46f4,1,7,6,13,1,2014-01-24 08:14:35,2014-01-24 08:14:28
14bc7e0573267337ae566b42be0275275af46dc6...de6a1a3e9674d2a028a49c9965b4efcc7924103a,1,10,12,22,5,2014-06-24 14:01:36,2014-06-24 13:08:18
69baa3afb21ed7426b393a2b723b776b3a38dc6f...e93f6b030a1a4c71aaea9a64672369723dc845a0,11,119,52,171,17,2014-06-24 19:19:35,2014-06-24 19:19:35
e93f6b030a1a4c71aaea9a64672369723dc845a0...9a3cab6bf63928c32f60997aa5bdc665e26c4ce0,2,0,39,39,1,2014-06-24 19:23:32,2014-06-24 19:23:32
883cb467c5427cbd80e7bc8175032754cf095aa9...cbb5b000c0c7593673683c08a402ea01a3a7f369,1,3,0,3,1,2013-09-27 14:32:09,2013-08-25 21:37:42
0787726ae7b1692e019ca9d209f5a99ba6e9f294...65455278535f9af769b6faa1ec9085737c2ff352,1,11,0,11,1,2013-08-27 09:01:45,2013-08-27 09:01:45
0787726ae7b1692e019ca9d209f5a99ba6e9f294...bb01b4f131a273e0d1da78bd1fd1936ff151458b,1,8,2,10,1,2013-08-26 18:59:15,2013-08-26 18:59:15
df9550c75d4e0aaa4d3c84d934da43de5f3563cf...a2a7c8093b7fb2966a40c6c6be45c4dd52683ab4,7,19,36,55,11,2013-08-27 09:18:53,2013-08-27 09:18:53
a2a7c8093b7fb2966a40c6c6be45c4dd52683ab4...dd19ce962828255579b107f81e0fb54ba067575f,1,4,1,5,2,2013-08-27 09:34:54,2013-08-27 09:34:54
dd19ce962828255579b107f81e0fb54ba067575f...9fbbd6a68ec603de8fd32681d90f47aa98cbd289,1,1,0,1,1,2013-08-27 09:41:49,2013-08-27 09:41:49
9fbbd6a68ec603de8fd32681d90f47aa98cbd289...bbc916baeecfd848eba86dd71c83623a79512a68,3,16,6,22,3,2013-08-27 09:47:28,2013-08-27 09:47:28
bbc916baeecfd848eba86dd71c83623a79512a68...61d98601583b30928076eb7180d444854f0b4f0a,4,9,9,18,6,2013-08-27 09:59:44,2013-08-27 09:59:44
61d98601583b30928076eb7180d444854f0b4f0a...449edae5aba573943fa048a45d1a78cda9fb13f8,4,8,8,16,8,2013-08-27 10:11:05,2013-08-27 10:11:05
449edae5aba573943fa048a45d1a78cda9fb13f8...95f032c4facf893879470328649892aea800fed4,2,3,3,6,3,2013-08-27 10:14:55,2013-08-27 10:14:55
95f032c4facf893879470328649892aea800fed4...8457415eb92f80bf485d40c41fafa02cd9377904,1,11,0,11,1,2013-08-27 10:20:36,2013-08-27 10:20:36
8457415eb92f80bf485d40c41fafa02cd9377904...c2f104000615f1f68ca9be61825add098265053f,3,4,4,8,4,2013-08-27 10:49:29,2013-08-27 10:49:29
c2f104000615f1f68ca9be61825add098265053f...79f0858a18081d37669883f1b5a32d033197561d,1,7,0,7,2,2013-08-27 10:56:04,2013-08-27 10:56:04
b6fdca9c81e617062f86bcd3a1d4d35f058faad1...13b281c2e4556dc4ad845271d6ae59d5959aff64,1,1,1,2,1,2013-08-14 09:44:54,2013-08-14 09:44:54
13b281c2e4556dc4ad845271d6ae59d5959aff64...a6e57749dccb2373dc13089006eba770bc376a67,1,6,0,6,2,2013-08-14 09:45:17,2013-08-14 09:45:17
b6fdca9c81e617062f86bcd3a1d4d35f058faad1...2b904cb34fcc9408b49e866976eaa7e82f032184,1,8,1,9,1,2013-08-13 22:02:27,2013-08-13 22:02:27
dc5bd10d45481268f00c8cc9f8500d29d392e07f...4345e9220ee2935610c97b0226d011a4736366f1,5,220,186,406,5,2013-12-24 09:45:28,2013-12-24 09:45:28
4345e9220ee2935610c97b0226d011a4736366f1...dac67ed65f22db82bbeeaaa8532460ba772b7311,9,47,53,100,23,2013-12-24 09:45:42,2013-12-24 09:45:42
dac67ed65f22db82bbeeaaa8532460ba772b7311...0c0beec26e4e864dec27b4755f420cb593c0d828,4,4,4,8,4,2013-12-24 10:58:23,2013-12-24 10:58:23
dc5bd10d45481268f00c8cc9f8500d29d392e07f...f537e4c963a8229c79554b537433f3c7f4d8efc9,1,2,1,3,1,2013-12-24 09:11:33,2013-12-24 09:11:33
ce527b68f07c245e887a640b6f874406bae7d0ed...5953582b65e1d49c3d04d9bc97069cb323ab277c,5,34,8,42,9,2013-12-24 12:53:52,2013-12-24 12:53:52
5953582b65e1d49c3d04d9bc97069cb323ab277c...4c61c467385ca889bc273a171bcd1ebfb9e739e9,3,76,21,97,9,2013-12-24 16:22:48,2013-12-24 16:22:48
4c61c467385ca889bc273a171bcd1ebfb9e739e9...b1970e0cf1271a8263a7ccf6b2aa8abb7ae59b2d,2,75,11,86,7,2013-12-24 17:04:57,2013-12-24 17:04:57
c4f9dff480ea030d6878b0197a71670f3a141e0e...0c3aa2e844f56bc1372742e57939ab6b708761c4,1,5,0,5,1,2014-03-11 11:18:10,2014-03-11 11:18:10
0c3aa2e844f56bc1372742e57939ab6b708761c4...9f405068cdfeb185cd3762f0ae5df6d87f6e31ba,1,2,0,2,1,2014-03-11 11:33:47,2014-03-11 11:33:47
9f405068cdfeb185cd3762f0ae5df6d87f6e31ba...7157f79caa88689f1b8989d183ef20fbc942bd0f,9,155,147,302,23,2014-03-11 13:15:08,2014-03-11 13:15:08
d02e129a549190c3bd26ed32eac13dfa62f2844d...9a676ccc0a8dd26eb1ebd5042acbf31cfb906f91,5,85,49,134,33,2014-03-05 19:44:01,2014-03-05 19:44:01
9a676ccc0a8dd26eb1ebd5042acbf31cfb906f91...13d2bcc3b4d6141643fe31dc4d7212ebca0612a5,2,68,0,68,2,2014-03-05 20:23:49,2014-03-05 20:23:49
13d2bcc3b4d6141643fe31dc4d7212ebca0612a5...f096bd61bda605f2e3631bcd4663ab68c7396989,1,11,1,12,2,2014-03-05 21:10:35,2014-03-05 21:10:35
f096bd61bda605f2e3631bcd4663ab68c7396989...4a251849cf0408780f6ee536699c212f8fe7a7be,3,12,6,18,9,2014-03-06 15:08:51,2014-03-06 15:08:51
4a251849cf0408780f6ee536699c212f8fe7a7be...e6ceec9d60b9fe5eaec8faf777307f39bd4b1fa3,2,4,4,8,2,2014-03-06 15:15:19,2014-03-06 15:15:19
d02e129a549190c3bd26ed32eac13dfa62f2844d...e9942e5a7996dd9492aea5eb422431e257313f18,1,1,1,2,1,2014-03-05 19:23:21,2014-03-05 19:23:21
d02e129a549190c3bd26ed32eac13dfa62f2844d...1445f4211e54e6f9fed1a79573d1b39c168b1083,2,3,3,6,3,2014-03-05 15:37:00,2014-03-05 15:37:00
7f67e066dc9749d2532d220fafa3f397a5fe1f24...8b35b208372e2394953226b7e4342d860a695f84,2,16,9,25,8,2014-03-25 21:33:14,2014-01-28 21:36:50
eb7a9868002a3d96675a1509d75be52cfe43fa2f...af0b59d477f7a9c314e17d3ceaf994f9cf5c4655,1,1,1,2,1,2014-03-26 07:50:18,2014-03-26 07:50:18
6d57accef2976932e9bea76b6cb9a4cbe9d81918...8362026a33c98aa73ddbb9f330b91bb5327e29e3,25,36,25,61,28,2014-04-13 17:05:52,2014-04-12 08:56:37
11f20576e9d236fb0ed2f6882364b10589c37292...37192d5e184f73feebde9f571d34c6af2bbb8f7a,1,1,0,1,1,2014-03-17 16:43:27,2014-01-06 18:36:34
cb43d88ada0e11e528c583b7015660898513782f...de855e2420465e66009b9773bc2a928b73153841,1,2,0,2,1,2014-03-17 13:50:16,2014-03-17 13:50:16
7bce8748a442a24efa6352cf2df5fff614e33283...7c60713e82982066e187b8c16ce327978b451b0a,6,271,256,527,7,2014-03-17 11:44:54,2014-03-17 11:44:54
fbc8b2c2d642d06d77add4908fdc305a9739a30f...189f88de5b6a85d1bae43cc4625e5d6604bbe6a8,1,1,1,2,1,2014-03-20 08:03:02,2014-03-20 08:03:02
99a9d97c44a23aae4e712de45180ed362369ab11...acb03f1fc3e7080f3eeaaaef720d33e6951ffa1b,1,1,0,1,1,2014-03-26 08:46:51,2014-03-26 08:46:51
99a9d97c44a23aae4e712de45180ed362369ab11...0a05c8dd8d648f5cc58508b70e0aff3d6a67ff32,2,3,3,6,2,2014-03-26 08:45:22,2014-03-26 08:45:22
0a05c8dd8d648f5cc58508b70e0aff3d6a67ff32...92ca779ebcfaebd01b2b107478b8f77896b14587,1,6,2,8,3,2014-03-26 08:55:04,2014-03-26 08:55:04
92ca779ebcfaebd01b2b107478b8f77896b14587...c818712dfa0be11efd13c7e9ccac7dd7045e67d7,1,4,0,4,1,2014-03-26 09:13:06,2014-03-26 09:13:06
1f988a224c11e2bcd38feae4c0af84607ec67df7...fcdb34373fea4cccc635bbe92f70e47d093b80a8,2,4,4,8,3,2014-03-28 08:31:06,2014-03-28 08:31:06
17a9ecf8cf6724613b38c08040bdb786ffe30718...f84d015fa95448c6ee6a256cbea6c2ed011a289d,1,1,1,2,1,2014-03-14 21:09:43,2014-03-14 21:09:43
17a9ecf8cf6724613b38c08040bdb786ffe30718...901976d9729fe5fb91929c463b0ad3a68e457c82,1,70,70,140,1,2014-03-14 18:53:43,2014-03-14 18:53:43
17a9ecf8cf6724613b38c08040bdb786ffe30718...686128cd68cfb6fc90ee32848c00826a7abe6280,1,1,1,2,1,2014-03-14 17:08:05,2014-03-14 17:06:01
17a9ecf8cf6724613b38c08040bdb786ffe30718...4aa3ce75342f26be3c87ac8c84f24658b9ef22a4,1,10,0,10,2,2014-03-14 16:25:11,2014-03-14 16:25:11
4aa3ce75342f26be3c87ac8c84f24658b9ef22a4...5e7e814e813da0ab9dcadd0c223a3aff6e89dfdd,1,4,0,4,1,2014-03-17 13:42:20,2014-03-17 10:16:55
17a9ecf8cf6724613b38c08040bdb786ffe30718...779fa4a7b7f2eef7910509df1787412844a3b3b8,3,25,5,30,6,2014-03-14 14:49:11,2014-03-13 17:32:30
779fa4a7b7f2eef7910509df1787412844a3b3b8...090ed21e6f53ade25716fb0b406f25b93b6a7690,2,2,2,4,2,2014-03-14 14:58:47,2014-03-14 14:57:52
17a9ecf8cf6724613b38c08040bdb786ffe30718...25f68a71d6a176c35e3817cf98d4668a7a303f74,1,7,9,16,1,2014-03-14 13:58:10,2014-03-14 13:58:10
25f68a71d6a176c35e3817cf98d4668a7a303f74...a9f2903e8642bc15da5a0b53f71b65ec1f25fc6e,1,1,1,2,1,2014-03-14 13:58:52,2014-03-14 13:58:52
17a9ecf8cf6724613b38c08040bdb786ffe30718...a39eeba1dc631508ef4af7f26f4ba2e8cdea8bfe,1,3,0,3,1,2014-03-14 13:55:41,2014-03-14 13:55:41
36ea864504854558c0dd3f626177a638022c312d...394737b2cb2ab82caa3b192ee4ae8fd17cb22cb9,2,2,2,4,2,2014-03-24 14:15:57,2014-03-24 14:15:57
394737b2cb2ab82caa3b192ee4ae8fd17cb22cb9...7847e108631f739ed4278ee40118073bdda8250b,1,1,1,2,1,2014-03-25 10:05:37,2014-03-25 10:05:37
36ea864504854558c0dd3f626177a638022c312d...3ef0a625ac656e64861df912492dc3b8febb66c3,2,34,33,67,2,2014-03-24 14:12:23,2014-03-24 14:12:23
36ea864504854558c0dd3f626177a638022c312d...65f5496e0210be96b4803f655d1a4c94ef1e07fe,4,30,6,36,9,2014-03-24 14:11:35,2014-03-24 14:11:35
f4b2cee695ace72d9eb31fd0fefa42745148b6a4...b36751c89771d82f64635d4dccc624573d17c3c2,1,1,1,2,1,2014-02-28 10:57:58,2014-02-28 10:57:58
b36751c89771d82f64635d4dccc624573d17c3c2...46b1c63b7af29ecc24292b20b7f246ff5f189048,1,1,1,2,1,2014-02-28 11:11:43,2014-02-28 11:11:43
049d0cc396669d7b970fc3d23e87eb62b3e57b75...b7072ff0de546549895545d2e6de16f6f3d7205c,1,2,1,3,2,2014-02-28 20:14:43,2014-02-28 20:14:43
b7072ff0de546549895545d2e6de16f6f3d7205c...110585c503a0d85fe61cde60c70fa333506370de,2,7,2,9,2,2014-02-28 20:23:08,2014-02-28 20:23:08
049d0cc396669d7b970fc3d23e87eb62b3e57b75...564c37d9b69367fb7384a22edad53c8e75aeb2cb,13,349,563,912,19,2014-02-28 18:30:13,2014-02-13 10:55:46
564c37d9b69367fb7384a22edad53c8e75aeb2cb...c06f4cd42ff7a45ba89d6f951d1287b15c11b54a,1,41,42,83,7,2014-02-28 18:31:14,2014-02-28 18:26:58
0a963ee15a3c544fcf647ae94d348fe3369251c9...75f274b7505935cc5fd0b609a83afb1c8aaba79b,1,10,16,26,2,2014-02-27 13:30:41,2014-02-27 13:30:41
5d27b23dddde5b42f818fae071a8a761ed4b5ddc...a1f5ae98e2afde84b028d17b489d7461f64a03d9,2,12,2,14,3,2015-03-12 17:10:19,2015-03-12 17:10:19
2cedeb48561122f35bfd5004aaa9c59ee3922911...c6e9d14ceb03d4f1cf2d3a720f1e64c41d3c43b8,2,5,3,8,3,2015-02-24 22:20:00,2015-02-24 19:30:30
c6e9d14ceb03d4f1cf2d3a720f1e64c41d3c43b8...1c7947ace0e4f79f1c354a3d63b5f2caedbe1e35,1,4,4,8,2,2015-02-25 20:40:27,2015-02-25 20:40:27
0b8e41aae2d6d64d18d8034e863e72cc832d0b83...008e3d66e9649079037260c072020340c69f3eec,1,2,2,4,2,2015-02-19 12:11:10,2015-02-18 14:47:10
0b8e41aae2d6d64d18d8034e863e72cc832d0b83...93e42f690bc057ca0e803074aaeb1b55ea9c2232,1,32,0,32,1,2015-02-19 10:20:58,2015-02-19 10:20:58
0b8e41aae2d6d64d18d8034e863e72cc832d0b83...3d6b042e9e8613162b92b2f61342f2f0ee919924,1,2,0,2,1,2015-02-18 20:59:15,2015-02-18 20:59:15
0b8e41aae2d6d64d18d8034e863e72cc832d0b83...9a5199f00577e759b14e1a2058400105f90e7cf4,5,21,0,21,5,2015-02-18 18:10:02,2015-02-18 18:06:58
0b8e41aae2d6d64d18d8034e863e72cc832d0b83...823f8c1a1c6b993d7fa2e4885c4f53897a9e8eb7,1,1,1,2,1,2015-02-18 17:13:10,2015-02-18 17:13:10
2a9eed6620fd57c2a82edf5eab95dade3da250d3...64a7ecc9267f6f82d34b9e87a0271216c94cbbfd,1,1,1,2,2,2015-02-21 20:16:08,2015-02-21 20:16:08
2b10520b306697d7cbae8f3f84ca30cacc821fa4...f937e059493037f3e18896a81693de81cf6a69a1,2,2,2,4,2,2015-01-22 14:51:20,2015-01-22 14:51:20
f937e059493037f3e18896a81693de81cf6a69a1...a63187f28b18e2feea16681b313166a982254e4e,1,1,1,2,1,2015-01-22 14:53:16,2015-01-22 14:53:16
2b10520b306697d7cbae8f3f84ca30cacc821fa4...9d271538a8e9ddff892a084e5c8a881bf2fdb0b0,2,29,0,29,2,2015-01-22 11:08:45,2014-06-02 23:10:38
9d271538a8e9ddff892a084e5c8a881bf2fdb0b0...e03f1af00a513a15085a69374a84a2f2df4689d1,4,39,23,62,17,2015-01-22 11:14:53,2015-01-21 22:59:30
466651553839d77c0f7352399b5714341ff4fa02...3f57022f1e40d874abec35c003b30febcb07bddf,1,1,1,2,1,2015-01-11 05:48:35,2015-01-11 05:48:35
13581528480fe63c4f5cd76f7a6844624881ab4a...4d03a2803e4f9248924d5ff5c55176ad21e3f6a4,1,1,1,2,1,2015-01-13 18:47:20,2015-01-13 18:47:20
4d03a2803e4f9248924d5ff5c55176ad21e3f6a4...1e37e8924ab38cfbb2a838c2bc6589b03f72dbcd,4,28,23,51,10,2015-01-13 19:44:17,2015-01-13 19:44:17
76802012e62a70bd040ec5cb8efa7e357dda0eee...ad14ed5e49a956511ae8f4d3bf377457fdb1075d,12,134,64,198,58,2015-03-06 16:31:49,2015-03-06 16:31:49
3cf4359b00d13959741e8c4909112c21b021c86c...cacac147de2b317d02788c5da1cdc6010f00a340,16,128,49,177,27,2015-03-07 20:11:08,2015-03-01 15:06:46
cacac147de2b317d02788c5da1cdc6010f00a340...285c5341855f8af6cbea5e964e3104a4698fa450,11,95,20,115,16,2015-03-08 22:10:05,2015-03-07 18:23:43
285c5341855f8af6cbea5e964e3104a4698fa450...928fc94c3d900069902b097d6464acee712a886c,12,76,63,139,26,2015-03-08 23:57:08,2015-03-07 19:47:06
928fc94c3d900069902b097d6464acee712a886c...9623b71a3975bb442b85aa57146b788f96de6320,2,6,5,11,4,2015-03-11 00:36:43,2015-03-11 00:21:09
9623b71a3975bb442b85aa57146b788f96de6320...5710c1aaf865d56013e272d2f32abe70d987eafc,1,4,2,6,2,2015-03-14 16:30:48,2015-03-14 16:30:48
5710c1aaf865d56013e272d2f32abe70d987eafc...13e9f4f33420bf0bae0b61b98dd3c2301d6f6223,2,96,0,96,2,2015-03-14 16:33:02,2015-03-14 16:33:02
3cf4359b00d13959741e8c4909112c21b021c86c...3bfd53149c2791b1598f3fc14e37cd33b7aef2d5,14,14,60,74,15,2015-03-07 02:36:22,2015-03-07 02:36:22
3bfd53149c2791b1598f3fc14e37cd33b7aef2d5...cd73b26e0732ab3ce979e971e6ceeb0c2417b5c3,13,65,68,133,30,2015-03-07 03:02:12,2015-03-07 03:02:12
cd73b26e0732ab3ce979e971e6ceeb0c2417b5c3...3cbc0b1c6d21ce6797900416ac9c1b22caf94845,9,882,139,1021,16,2015-03-07 04:02:34,2015-03-07 04:02:34
3cbc0b1c6d21ce6797900416ac9c1b22caf94845...ceb8f9dfeb77c99dfac121fb349ee3c8a9969ae9,4,4,72,76,9,2015-03-07 05:15:15,2015-03-07 05:15:15
ceb8f9dfeb77c99dfac121fb349ee3c8a9969ae9...887cf5c7101c058d30b10d767c186d548e6c5e92,36,7,4,11,3,2015-03-07 05:40:23,2015-03-07 05:40:23
887cf5c7101c058d30b10d767c186d548e6c5e92...433b4c76fc7d23d03811fa05e1589e3a8a788e82,7,37,45,82,18,2015-03-07 08:28:53,2015-03-07 08:28:53
433b4c76fc7d23d03811fa05e1589e3a8a788e82...4f3d704845c1ead8d39f49b04812305a8f8ab93a,6,7,3,10,3,2015-03-07 08:29:25,2015-03-07 08:29:25
4f3d704845c1ead8d39f49b04812305a8f8ab93a...e2b8025abe929007fb82e952b0be954a7598e528,7,16,11,27,9,2015-03-07 09:06:16,2015-03-07 09:06:16
e2b8025abe929007fb82e952b0be954a7598e528...be3edeb6a1db341e5a10f9031c79f5fbc25e6f59,9,15,19,34,15,2015-03-07 18:35:17,2015-03-07 18:35:17
e89ffd546eafad4e03ce5b17b5c9147b70afeedc...ee45fa89b62bd11b397f84e9ed42ee78dadabd20,1,1,1,2,1,2015-03-10 15:07:31,2015-03-09 20:45:35
e89ffd546eafad4e03ce5b17b5c9147b70afeedc...23fabc081d7476339e96ec0dfdf7cd6744da5375,1,1,1,2,1,2015-03-09 23:36:41,2015-03-09 23:36:41
e89ffd546eafad4e03ce5b17b5c9147b70afeedc...c6b242112781120233a3627098e50689f6ccf9f8,7,17,12,29,7,2015-03-09 22:20:32,2015-03-09 22:20:32
c6b242112781120233a3627098e50689f6ccf9f8...3e6147ada4a7a252d5e9ca604a43d85b7756a5ea,1,6,0,6,1,2015-03-09 23:24:45,2015-03-09 23:24:45
e89ffd546eafad4e03ce5b17b5c9147b70afeedc...d36ee3190aa1fb8c1238967a3049d5b8271c9030,8,68,3,71,9,2015-03-09 21:12:03,2015-03-09 21:12:03
d36ee3190aa1fb8c1238967a3049d5b8271c9030...b8d73315f5e094906111ab16607b5fa2685d2ea8,3,31,0,31,3,2015-03-09 21:25:14,2015-03-09 21:25:14
e89ffd546eafad4e03ce5b17b5c9147b70afeedc...dd24c3d4b9ab153cd74e551772412122f8c643c1,2,43,38,81,6,2015-03-09 20:02:06,2015-03-09 20:02:06
c02d891cb5f1c1df8fb69da31c901abcc4511f5b...ccc2c6e762cba3b25ce8fe842b35aef837d7ffd0,1,0,5,5,3,2015-03-12 01:03:21,2015-03-12 01:03:21
f186b20cb2e5fa59c1b7b6ac9c56141327c89e47...fff34a7f4d58ff0add8c2cb043a4fd53d004bd71,2,11,10,21,11,2015-03-12 15:49:46,2015-03-12 15:49:46
c6f57d73e05bd4bddb6adad2d8d7bcaad4dc677a...cb3b671839ccb99fbe100ae1fe684d391a30f191,2,3,1,4,2,2015-03-18 00:06:40,2015-03-18 00:06:40
745aad4196fa5217f682af472006e8a01bb1ecea...9a0c99274e21c86da84f903fad257a82dc7cc40f,2,18,15,33,12,2015-03-17 21:07:05,2015-03-17 21:07:05
3aded9d5816b8605d5ccf486ab2e38247e2b654f...6235b027ec19f3ba0e668a6ee6e77d861c4f68bd,1,1,1,2,1,2015-03-14 09:22:06,2015-03-14 09:22:06
3aded9d5816b8605d5ccf486ab2e38247e2b654f...2da2720584e162c53436a046380740bd64c3ad24,8,43,36,79,17,2015-03-14 02:20:25,2015-03-14 02:20:25
2da2720584e162c53436a046380740bd64c3ad24...dffa2fa9e92e37a664afa2807fd5b01fbbd87ef2,9,33,25,58,22,2015-03-14 06:40:46,2015-03-14 06:40:46
3aded9d5816b8605d5ccf486ab2e38247e2b654f...89d3028b20d769185b20d9af8e2e2f58d29667b8,1,8,4,12,3,2015-03-14 02:00:16,2015-03-14 02:00:16
63a32bc29b892298c6cd2205ea6ca7f3c7ac51ea...fe1e3db5a3cf0495970b5fb38d1bf0945bc11c5a,1,1,1,2,1,2015-01-19 22:18:31,2015-01-19 22:18:31
cc2f14ea0be86cd0b7793209962a567a12db81c6...9c7a7d4349f707200e7e71582fd83065dcfaf591,1,1,1,2,1,2014-12-23 08:23:19,2014-12-23 08:23:19
fe0174799d4fecc94a778f0145896f64f92f9015...b758b4c80bacd655f0241375c2391028cfd73f77,1,1,0,1,1,2015-01-11 03:26:00,2015-01-11 03:26:00
e9bf4e411f2d3535c6cda11a29716ed7e0db136a...13b86fcb02ef3e3fc6bba949b95cb59cdbac2777,2,3,3,6,3,2015-01-11 03:50:35,2015-01-11 03:50:35
13b86fcb02ef3e3fc6bba949b95cb59cdbac2777...49eacb84e92309b54e425f0579ab2c3f91569d97,1,2,2,4,2,2015-01-11 03:52:27,2015-01-11 03:52:27
80597d59e0c4a27515c2f1749d80c5c620878d3b...c2331d87e5ab561db8a4003c4df1ed20755ab108,3,0,0,0,0,2014-12-27 15:22:15,2014-12-27 15:22:15
c2331d87e5ab561db8a4003c4df1ed20755ab108...6ade72992e197be70fb202eb98d68dc81b4dddfa,1,0,0,0,0,2014-12-27 15:23:21,2014-12-27 15:23:21
80597d59e0c4a27515c2f1749d80c5c620878d3b...4adc033761db149e5bb46f4be02788f1fd384b20,2,72,76,148,10,2014-12-27 14:03:02,2014-12-27 14:03:02
4adc033761db149e5bb46f4be02788f1fd384b20...b8bffc0da26ff53a220ec83e71a195666867d28f,1,0,1,1,1,2014-12-27 15:48:10,2014-12-27 15:48:10
34b54ee815098eab0e62f7dbdb02cb42299cfc42...6cce2be7eb742231e60bafd28fb883e0554dbfd0,1,4,9,13,2,2015-01-13 18:20:04,2015-01-13 18:20:04
ff65e5569462ab5581e3656826308e427c4ca641...2497273030e80bd7e4f891c7500901c0a38abea1,1,1,1,2,1,2014-12-12 14:35:05,2014-12-12 14:35:05
9c9dc64a40d0a3c9e7265436e82dbe055320be97...0ff2c67d4be386907cf4d84f3cb3eba5ef284290,1,1,0,1,1,2014-12-11 12:35:10,2014-12-11 12:35:10
9c9dc64a40d0a3c9e7265436e82dbe055320be97...2ff60660886008eef2a39bf1f2dcc249bbec8232,1,3,1,4,1,2014-12-11 12:18:18,2014-12-11 12:18:18
231797707772275aed229db5613865d8081bdd3f...3c2139ed172c607467ec6cf412d7ed33147bac22,1,1,1,2,1,2015-02-19 06:23:24,2015-02-19 06:23:24
bf69d183461f61e3822c167ff8a65a89d58e80ff...8be0c60e4069cd07ee4ae4d4f2508b554a0d16c3,1,1,1,2,1,2014-12-22 15:44:14,2014-12-22 15:44:14
e4c8e8fd76fbfdfef4431df555a6a101256e2661...17b3da07ce90c0651303b4605a2ef634359b42b3,6,9,9,18,9,2014-04-28 19:33:17,2014-04-28 19:33:17
e4c8e8fd76fbfdfef4431df555a6a101256e2661...95ef25a57a872f6cc03416b4c88ca3b17a90f740,1,7,6,13,5,2014-04-25 13:01:46,2014-04-25 13:01:46
95ef25a57a872f6cc03416b4c88ca3b17a90f740...bdd392bd13fc19371bb09fd90e291959bc0fb4e7,1,1,1,2,1,2014-04-25 13:03:32,2014-04-25 13:03:32
415c0f4bbe12dbd78bf24d50e66e3092df07fa21...8e278cfe75c3a63debf80f8d79433d492d204117,1,1,1,2,1,2014-04-15 13:55:07,2014-04-15 13:55:07
415c0f4bbe12dbd78bf24d50e66e3092df07fa21...993831ff7daa643c2972d3e524dc4f138888d8e9,1,2,2,4,2,2014-04-11 17:03:41,2014-04-11 17:03:41
993831ff7daa643c2972d3e524dc4f138888d8e9...72e82151f16d9053e6aa05cba4eed2ef77fbb912,1,2,2,4,2,2014-04-11 17:04:48,2014-04-11 17:04:48
415c0f4bbe12dbd78bf24d50e66e3092df07fa21...9cb2a4ac8abfe27ecbf1133aec7b29604f20c248,3,39,2,41,4,2014-04-11 15:54:02,2014-04-10 16:41:20
415c0f4bbe12dbd78bf24d50e66e3092df07fa21...aa6426f46dd615cdb30d8806567c1291a5c97fe1,2,0,8,8,2,2014-04-11 08:22:32,2014-04-11 08:22:32
415c0f4bbe12dbd78bf24d50e66e3092df07fa21...872482678be0eef25191e118b8300112735f0023,3,8,5,13,5,2014-04-11 08:02:52,2014-04-11 08:02:52
415c0f4bbe12dbd78bf24d50e66e3092df07fa21...db1be88f21aca737a375f87d4301a7fb20ac9822,1,1,0,1,1,2014-04-10 12:39:58,2014-04-10 12:39:58
4881d4932edd1ba2a7297a37e3613dcb62bd0948...28f1a5d7d8e108b85ed36356c50c03e96558d9ea,2,14,1,15,2,2014-04-11 17:06:27,2014-04-11 17:06:27
4881d4932edd1ba2a7297a37e3613dcb62bd0948...25eadf0c5bd05deb98f7ea0420fc5c63682cb989,3,33,12,45,5,2014-04-11 11:37:33,2014-04-11 11:31:37
25eadf0c5bd05deb98f7ea0420fc5c63682cb989...5dd2f36ae153ac5a933a4e6ae0ae773508aa1f74,20,39,37,76,27,2014-04-11 19:45:56,2014-04-11 19:45:56
5dd2f36ae153ac5a933a4e6ae0ae773508aa1f74...490ab228e662f42a88e389469fd79b1274b4cf4a,1,4,2,6,2,2014-04-11 19:52:49,2014-04-11 19:52:49
a54bef0a4200d8323bb18e8d11481ef7bd63d314...636718adf00e71bfd3a2bf96df86c1b3b0c931bc,4,5,6,11,6,2014-06-03 07:01:15,2014-06-03 07:01:15
636718adf00e71bfd3a2bf96df86c1b3b0c931bc...7bb0551fd9f703674f2126ca316d8a097ef9d1ed,1,4,0,4,1,2014-06-03 07:04:31,2014-06-03 07:04:31
7bb0551fd9f703674f2126ca316d8a097ef9d1ed...87e0fe6f76fa8829abb99dd90a8af65ed11bc3a3,2,6,10,16,4,2014-06-03 07:27:50,2014-06-03 07:27:50
5d6f5be0603e51514705976e35c2a6f2fff74c84...94b0f1b2bb691928ce0db0fba2ccfe02d1a5d11e,2,2,2,4,2,2014-05-31 12:57:22,2014-05-31 12:57:22
2c46b35b100be89e0549336616391aef2337454d...be85d1d2b203120402b95c88036b36d3b7db6dd4,1,1,1,2,1,2014-06-03 15:46:47,2014-06-03 15:46:47
2c46b35b100be89e0549336616391aef2337454d...d514833a1579d50070fc687acc2af4f135b25a56,2,19,8,27,2,2014-06-02 13:18:16,2014-06-02 13:18:16
f420ae4b18c574e5f057e98f18f0ce7353670a4f...114e67564dbcfadafc237459a7549e5a85640817,2,0,37,37,2,2014-05-22 12:40:38,2014-05-22 12:40:38
f420ae4b18c574e5f057e98f18f0ce7353670a4f...60053e6e2c79e47c84f1703a35e5c073249b9086,1,1,1,2,1,2014-05-21 11:06:12,2014-05-21 11:06:12
dc7158a0f9ed29171451cc04441e90a540e4952c...38d0e001eac2026b8526fc7098bd147df4fc522d,2,2,1,3,2,2014-05-22 09:09:00,2014-05-22 09:09:00
38d0e001eac2026b8526fc7098bd147df4fc522d...3296fb9f3a30fab41bac61b2afbe689cfcbbd15f,1,6,0,6,1,2014-05-22 14:27:32,2014-05-22 14:27:32
3296fb9f3a30fab41bac61b2afbe689cfcbbd15f...babfc068ae2747ce578a90c7cb22fd88f03349bd,1,1,1,2,1,2014-05-22 17:34:03,2014-05-22 17:34:03
bc7cce92518d57ab2b62be1ba6f5215ad9762272...c91300e4ce1f991a6070330c6fe2f7528dea3e10,3,0,6,6,6,2014-05-13 16:55:03,2014-05-13 16:55:03
b787540f71a3a7e68e940f39e7c903b0214a80e3...d57889212bf5481c50076e9980c27f5a6531ec6b,2,13,8,21,7,2014-05-13 15:41:36,2014-05-13 15:41:36
81ecd1195fd91c99f34c837524530800dbaf7bb2...b1d68b6e9bd837b3b685b76ceca1b6a44cf2dc17,2,35,0,35,2,2014-05-06 10:34:17,2014-04-01 14:39:26
b1d68b6e9bd837b3b685b76ceca1b6a44cf2dc17...402361afff4a4eb8c19ea7ab4f4c6ec5daf64221,1,8,1,9,2,2014-05-06 10:34:17,2014-04-15 16:58:12
3dea71ce0f8e78d7022ea25312af7c812c777d79...700b6366db9d4ee0bf8d6e9e0e47519ae46e40c6,1,1,1,2,1,2014-05-08 12:57:42,2014-05-08 12:57:42
3dea71ce0f8e78d7022ea25312af7c812c777d79...23de3551ab1ece5a3782c07d3a88a092122431d0,1,8,0,8,1,2014-05-08 12:37:36,2014-05-08 12:37:36
23de3551ab1ece5a3782c07d3a88a092122431d0...05e63fe09c8a44ed14d4282db81d18927ce1a5ad,3,133,3,136,3,2014-05-08 12:38:17,2014-05-08 12:38:17
05e63fe09c8a44ed14d4282db81d18927ce1a5ad...8eae01ea58c505a3c132e3d4f09cf77e7c1fc574,1,20,4,24,4,2014-05-08 12:38:52,2014-05-08 12:38:52
8eae01ea58c505a3c132e3d4f09cf77e7c1fc574...51e976d295edfefd5e2cb2dfc7967fb90c87ac40,3,18,50,68,5,2014-05-08 12:40:02,2014-05-08 12:40:02
51e976d295edfefd5e2cb2dfc7967fb90c87ac40...ee3cd06f4cdf0c150801b1268d806b8a252960f5,1,0,1,1,1,2014-05-08 12:40:19,2014-05-08 12:40:19
ee3cd06f4cdf0c150801b1268d806b8a252960f5...2da289cf22995d14e275b7c908b7e6014a11c7d9,5,30,4,34,6,2014-05-08 12:52:59,2014-05-08 12:52:59
2da289cf22995d14e275b7c908b7e6014a11c7d9...86bf684f5dc95e8bd2445f088f862d0a0539922a,3,6,5,11,5,2014-05-08 13:30:39,2014-05-08 13:30:39
86bf684f5dc95e8bd2445f088f862d0a0539922a...536373ad05b55c69442e7d7d6cb549791031cac2,3,22,17,39,16,2014-05-08 16:00:03,2014-05-08 16:00:03
3dea71ce0f8e78d7022ea25312af7c812c777d79...5014a5b7d51f329311b80f8c0770b11616812120,1,22,22,44,11,2014-05-08 11:59:31,2014-05-08 11:59:31
5014a5b7d51f329311b80f8c0770b11616812120...ad5a982d841f572e4e9207ae5ac6a0013648d30e,2,8,7,15,5,2014-05-08 13:28:07,2014-05-08 13:00:20
3dea71ce0f8e78d7022ea25312af7c812c777d79...c01efa0ed5a9dadd2daf8cc63c5612864c771f23,2,48,0,48,3,2014-05-08 10:12:14,2014-05-08 10:10:04
c01efa0ed5a9dadd2daf8cc63c5612864c771f23...92591b63dcba5115537cd1e6da714540590975b8,1,7,1,8,1,2014-05-08 11:18:12,2014-05-08 11:18:12
92591b63dcba5115537cd1e6da714540590975b8...3bfbea37e9a0cca64bf67e0a8a8ce3ceb9b9db55,1,6,0,6,2,2014-05-08 11:18:22,2014-05-08 11:18:22
3dea71ce0f8e78d7022ea25312af7c812c777d79...5f74f0511fbf75b719528d55f7d1f5d7c52f21b8,1,1,1,2,1,2014-05-08 07:13:41,2014-05-08 07:13:41
3dea71ce0f8e78d7022ea25312af7c812c777d79...9e805b77544df5be602d0c218d7be1047eb6729f,1,5,1,6,1,2014-05-07 20:33:54,2014-05-07 20:33:54
9e805b77544df5be602d0c218d7be1047eb6729f...a45f7262f9a3e26361b6fde4f77d0d27437535cf,1,3,3,6,2,2014-05-07 20:41:35,2014-05-07 20:41:35
a45f7262f9a3e26361b6fde4f77d0d27437535cf...04561011177f5323f4fe0e18e7a0137d72b314ea,1,3,3,6,2,2014-05-08 13:23:17,2014-05-08 13:23:17
9dfc4fe6ac0194722dacd4ed5e2539126419c360...c608a5dceab0a5fa2df8286d5808091f2517d4ab,3,25,0,25,4,2014-05-02 14:02:57,2014-05-02 14:02:57
6abd1f9347d598d58fd43033816413640fc64049...4cb17deec171151c0e1acd582861cafced43e89e,1,4,1,5,1,2013-11-25 15:46:16,2013-11-25 15:46:16
4cb17deec171151c0e1acd582861cafced43e89e...8b9bbeeba28ee077aec04180b7f13c2ed9967051,1,1,1,2,1,2013-11-25 15:59:12,2013-11-25 15:59:12
8b9bbeeba28ee077aec04180b7f13c2ed9967051...0461760f2153c68210a25d40093e7575b67c9607,1,1,1,2,1,2013-11-25 16:11:03,2013-11-25 16:11:03
0461760f2153c68210a25d40093e7575b67c9607...47e8c67d1d6fce78bbe713eb030c24ecebc81081,1,3,1,4,2,2013-11-25 16:24:45,2013-11-25 16:24:45
47e8c67d1d6fce78bbe713eb030c24ecebc81081...75f0ff2ce1dffd3d034f8353e454349830166999,2,7,8,15,7,2013-11-25 16:57:08,2013-11-25 16:57:08
75f0ff2ce1dffd3d034f8353e454349830166999...11aa7b00251d8fd29bb7f8c5a6176eb9713ff3ae,2,10,2,12,2,2013-11-25 16:57:44,2013-11-25 16:57:44
11aa7b00251d8fd29bb7f8c5a6176eb9713ff3ae...7ed15bbc0d95aba8cba82148712f737025adfefc,2,13,2,15,3,2013-11-25 16:58:00,2013-11-25 16:58:00
7ed15bbc0d95aba8cba82148712f737025adfefc...58601ebdab0cfa90e823418ccd587a0a503a985f,4,10,10,20,6,2013-11-25 18:07:55,2013-11-25 18:07:55
58601ebdab0cfa90e823418ccd587a0a503a985f...8de013ea2d23347811b7a179a96c5f066a5338b3,1,2,2,4,2,2013-11-25 19:12:46,2013-11-25 19:12:46
8de013ea2d23347811b7a179a96c5f066a5338b3...46c50caa6e9536aa36ff615b9593c2940bb47fa6,3,3,0,3,3,2013-11-25 19:23:05,2013-11-25 19:23:05
46c50caa6e9536aa36ff615b9593c2940bb47fa6...ec630ffc3b0199a29dbf4b908f17bd3edc3e7bc0,1,5,5,10,4,2013-11-25 19:36:17,2013-11-25 19:36:17
ec630ffc3b0199a29dbf4b908f17bd3edc3e7bc0...666861f8ffdcea5c1a708c27aa2baf916ef80913,3,32,21,53,5,2013-11-25 20:10:18,2013-11-25 20:10:18
666861f8ffdcea5c1a708c27aa2baf916ef80913...a5f7f5d8b4798cfd0b03f79f5d06fdadb0eb9885,1,5,1,6,1,2013-11-25 20:13:13,2013-11-25 20:13:13
a5f7f5d8b4798cfd0b03f79f5d06fdadb0eb9885...8e117f0e375e7bd8868ac53b16989f0028e66a4d,1,2,6,8,2,2013-11-25 20:21:11,2013-11-25 20:21:11
8e117f0e375e7bd8868ac53b16989f0028e66a4d...02d8c0032377f0771153893cb41a604935ea73a5,1,1,1,2,1,2013-11-25 20:33:04,2013-11-25 20:33:04
02d8c0032377f0771153893cb41a604935ea73a5...c57180367c8a9e55beb378fc7d0fd3c1cc1497e5,1,2,2,4,2,2013-11-26 08:08:46,2013-11-26 08:08:46
397543480298ed24e5f9656e8f7b8142f8b54f0f...74f1da10d1e6923c347426de9603df7bd8919e09,2,10,16,26,6,2014-01-30 19:31:10,2014-01-30 19:31:10
b7fc0e81cefcc49a4bc1a60e1588c443b2af26df...7060668e098a9728b24016e7419f7abffa21a4e6,1,181,180,361,68,2013-12-16 12:52:04,2013-12-16 12:52:04
d1d138562a347ec78f0331d5242e28fbb368bad0...48f741eed9f3676a8d0d089d7336fcffd31ebaa7,6,90,31,121,10,2014-01-24 12:18:32,2014-01-24 12:18:32
48f741eed9f3676a8d0d089d7336fcffd31ebaa7...1338c7dd71555144286d751a5299366a5c13d2df,1,3,1,4,1,2014-01-24 12:38:02,2014-01-24 12:38:02
82edf9ca5a10a6d7ce57b0698d82fccf9e6648ce...075905ffe84912b44098e42e5bfd9e1e43c84fdc,1,2,2,4,2,2014-06-24 19:48:21,2014-06-24 19:48:21
075905ffe84912b44098e42e5bfd9e1e43c84fdc...9c6bd919a33309d9557419b65ed84151ab52090c,1,2,1,3,2,2014-06-24 19:50:04,2014-06-24 19:50:04
9c6bd919a33309d9557419b65ed84151ab52090c...f91f230cec3d4768a752b93f35fa45fb8c85d10a,2,11,1,12,2,2014-06-24 19:57:11,2014-06-24 19:57:11
cbb5b000c0c7593673683c08a402ea01a3a7f369...c6d6c0d114e66ff6424f1b1238f051f8321d49eb,1,2,2,4,2,2013-10-06 09:55:01,2013-10-06 09:55:01
cbb5b000c0c7593673683c08a402ea01a3a7f369...479631aafc525efef151309ac257e60c73230ac0,5,66,24,90,19,2013-09-29 08:47:29,2013-07-31 10:52:23
479631aafc525efef151309ac257e60c73230ac0...5b657a65d4ec309be2cb7dfcacf85e98d59a4eb0,1,19,0,19,1,2013-09-29 16:55:09,2013-09-29 16:55:09
79f0858a18081d37669883f1b5a32d033197561d...59f428dca20228984e9f50c33b12f54eb15638e5,3,91,14,105,17,2013-08-28 01:22:42,2013-08-28 01:22:42
79f0858a18081d37669883f1b5a32d033197561d...afdfbd1e8a5865ebb2494c7d55220248a4981b77,2,23,7,30,8,2013-08-27 18:39:34,2013-08-27 10:44:58
afdfbd1e8a5865ebb2494c7d55220248a4981b77...24e26d8b7a4a2487600f273f7b1a6236691d2664,4,41,23,64,7,2013-08-27 18:39:34,2013-08-27 17:40:42
24e26d8b7a4a2487600f273f7b1a6236691d2664...643a6e5824cc8ffb6b58288b7822f42d13476c8f,6,30,20,50,10,2013-08-27 18:39:34,2013-08-27 18:35:41
643a6e5824cc8ffb6b58288b7822f42d13476c8f...eb4272e2f57683c4be6a064c8e1675513e4a908a,1,0,7,7,1,2013-08-27 19:00:41,2013-08-27 19:00:41
79f0858a18081d37669883f1b5a32d033197561d...df9e1db9040db43eecb9f2a449055a28adfc5707,2,175,78,253,26,2013-08-27 11:43:01,2013-08-27 11:30:06
df9e1db9040db43eecb9f2a449055a28adfc5707...7c38f4e23784b3c141db254059b88cb1044bd946,1,5,5,10,4,2013-08-27 13:05:53,2013-08-27 13:04:20
7c38f4e23784b3c141db254059b88cb1044bd946...f57944cc6170e1c06e7fe18e52a08c90ccb10ddb,1,15,8,23,7,2013-08-28 11:11:57,2013-08-28 10:38:41
f57944cc6170e1c06e7fe18e52a08c90ccb10ddb...cda4d6881aba6ebcdd71a8f1c47976e77cf9e9aa,1,17,7,24,6,2013-08-28 11:22:01,2013-08-28 11:16:34
cda4d6881aba6ebcdd71a8f1c47976e77cf9e9aa...98ea81e65956cb37fc67c03e3a88c29c6932b12c,1,16,5,21,5,2013-08-29 21:29:38,2013-08-29 21:26:08
98ea81e65956cb37fc67c03e3a88c29c6932b12c...fe8fa9a58110a70645edfa3ce0320a292da39fce,1,1,1,2,1,2013-09-03 12:27:51,2013-09-03 12:24:20
a6e57749dccb2373dc13089006eba770bc376a67...cd2535324378f44378d2a5e28f05d5df7bf9128f,3,24,1,25,4,2013-08-14 10:23:12,2013-08-14 10:23:12
cd2535324378f44378d2a5e28f05d5df7bf9128f...8da4d15f233d8f4ebacd39847172c91f3c262a3e,1,4,4,8,1,2013-08-14 10:23:26,2013-08-14 10:23:26
8da4d15f233d8f4ebacd39847172c91f3c262a3e...d6aec3fc1a974d104612b5dc2832c74f701c3caf,1,8,7,15,3,2013-08-14 10:41:06,2013-08-14 10:41:06
d6aec3fc1a974d104612b5dc2832c74f701c3caf...c17280f55a49ee8a37a73f1c34824ce4be3f013c,1,1,1,2,1,2013-08-14 11:14:23,2013-08-14 11:14:23
c17280f55a49ee8a37a73f1c34824ce4be3f013c...f989140b7730b592e0751a12f815808908cfcff1,1,5,5,10,1,2013-08-14 11:19:11,2013-08-14 11:19:11
f989140b7730b592e0751a12f815808908cfcff1...ddaa1f1fe6bfaeac4ddc9ef6301163e2fe69c1e7,1,1,2,3,2,2013-08-14 11:20:16,2013-08-14 11:20:16
ddaa1f1fe6bfaeac4ddc9ef6301163e2fe69c1e7...6579ba3e7733d061c77d56cdd7aa98b7c38a94d6,1,11,9,20,7,2013-08-14 12:14:08,2013-08-14 12:14:08
6579ba3e7733d061c77d56cdd7aa98b7c38a94d6...7d1b3d4e272b1d11b6f53389169358373e2fae60,3,2,3,5,3,2013-08-14 13:02:21,2013-08-14 13:02:21
a6e57749dccb2373dc13089006eba770bc376a67...bf6133b95635d97ed4993c900e07d7a52715cbf8,1,2,2,4,2,2013-08-14 10:09:00,2013-08-14 10:09:00
be0c6c27f08694d2a1885507b99f4b54c16f86ea...5a7f15fbab05c571c568f75ab5fef4fe918494bd,2,7,1,8,3,2013-08-15 08:51:40,2013-08-15 08:51:40
5a7f15fbab05c571c568f75ab5fef4fe918494bd...20c65f3bcb9cba208abded1593dc2e50ea6347d2,1,2,2,4,1,2013-08-15 08:54:16,2013-08-15 08:54:16
20c65f3bcb9cba208abded1593dc2e50ea6347d2...d0a95c30b9246bd5914f47f2d644c7c16c43fe7d,2,5,1,6,2,2013-08-15 09:27:19,2013-08-15 09:27:19
16ea2ec1894da1077ccd7b0e39a50b3cedd1fe2a...f6a4e5636d2ed6d99006c36b59da04ec86dfebab,1,2,1,3,2,2013-12-25 07:08:56,2013-12-25 07:08:56
f6a4e5636d2ed6d99006c36b59da04ec86dfebab...1a2e11c891ef4a2a87b84f2b0b36316bb809ff14,4,9,15,24,4,2013-12-25 07:19:51,2013-12-25 07:19:51
1a2e11c891ef4a2a87b84f2b0b36316bb809ff14...1e64333c5fe81a36373f0d437e425e8cab107a91,3,43,34,77,12,2013-12-25 07:45:53,2013-12-25 07:45:53
1e64333c5fe81a36373f0d437e425e8cab107a91...34f994b7c50fa45c4257cbe5f0fef61f58abb549,4,7,3,10,4,2013-12-25 07:56:39,2013-12-25 07:56:39
34f994b7c50fa45c4257cbe5f0fef61f58abb549...73af33e4b1aed1cbde3644a0e94ab2d40340e31b,1,32,26,58,8,2013-12-25 10:45:54,2013-12-25 10:45:54
0f055197776275cdf55538469a07cf8d5e13ad24...592dce18b549cd29933603f53f1ab8fb9f33840e,1,4,1,5,1,2014-03-27 14:32:28,2014-03-27 13:32:32
0f055197776275cdf55538469a07cf8d5e13ad24...762c7b4f2b272f56d185f09f061a8811c751a50e,1,1,1,2,1,2014-03-27 12:20:43,2014-03-27 12:20:43
0f055197776275cdf55538469a07cf8d5e13ad24...b04c343311dfd5f12815936384762a9f1412fe34,1,26,27,53,2,2014-03-27 09:53:26,2014-03-27 09:53:26
b04c343311dfd5f12815936384762a9f1412fe34...8a90db9e33b2dbb46655c0c3044da382b66c4d36,1,7,0,7,1,2014-03-27 09:56:30,2014-03-27 09:56:30
8a90db9e33b2dbb46655c0c3044da382b66c4d36...417c0cb2d33e76e271c89e99b323f2443e942107,8,37,4,41,8,2014-03-27 11:17:27,2014-03-27 11:17:27
a599d8120ddf4d9a6f66ff0bfbd024e414f38772...55fbe71ad11640347be8128d3c26a33b934e30a8,1,1,1,2,1,2014-03-12 06:54:42,2014-03-11 21:50:02
a599d8120ddf4d9a6f66ff0bfbd024e414f38772...71b1030bf7cb85e5fc9efb40951e9613dbbc5ada,1,13,0,13,1,2014-03-11 18:23:02,2014-03-11 18:20:15
71b1030bf7cb85e5fc9efb40951e9613dbbc5ada...f9c4bb56388daf0747b8b90a28e0f97acfbb92f8,1,3,3,6,1,2014-03-12 07:13:27,2014-03-12 07:13:27
a599d8120ddf4d9a6f66ff0bfbd024e414f38772...a6eb28abc5e4d90780f63e30fbcb7857989ef7ac,1,5,2,7,2,2014-03-11 16:23:03,2014-03-11 16:23:03
a6eb28abc5e4d90780f63e30fbcb7857989ef7ac...dff9221c407bdb277db14b3daef6fc230f38ac7c,1,1,1,2,1,2014-03-11 16:34:43,2014-03-11 16:34:43
dff9221c407bdb277db14b3daef6fc230f38ac7c...42f25e75f84622f57073e4ba64f292eac2dac78d,1,1,1,2,1,2014-03-12 08:25:37,2014-03-12 08:25:37
42f25e75f84622f57073e4ba64f292eac2dac78d...e603da7360dd8141a00b8096cb67acda0e039940,2,60,46,106,31,2014-03-12 15:14:28,2014-03-12 15:14:28
e603da7360dd8141a00b8096cb67acda0e039940...7f50c7f62c083ef5599b2ffe24723683c246bfb0,2,24,25,49,2,2014-03-12 15:14:48,2014-03-12 15:14:48
7f50c7f62c083ef5599b2ffe24723683c246bfb0...1436433c7b982fbe17b10f744f2f65f208305d3c,2,22,12,34,14,2014-03-12 15:15:03,2014-03-12 15:15:03
1436433c7b982fbe17b10f744f2f65f208305d3c...37db76a31b8d9676aeadcaf6e2e175ead0f68d74,4,89,55,144,11,2014-03-12 17:25:48,2014-03-12 17:25:48
37db76a31b8d9676aeadcaf6e2e175ead0f68d74...b47646ef13597836cad342a4d9372316289f0155,4,28,6,34,7,2014-03-12 17:26:09,2014-03-12 17:26:09
b47646ef13597836cad342a4d9372316289f0155...aaff356655e47d78d1da6adca314ccf11f02268c,1,5,0,5,1,2014-03-13 08:27:05,2014-03-13 08:27:05
aaff356655e47d78d1da6adca314ccf11f02268c...44c940391701c8ac6715a90a707db0c255e016d9,1,13,12,25,1,2014-03-13 08:27:20,2014-03-13 08:27:20
44c940391701c8ac6715a90a707db0c255e016d9...10c0cb8ca763861b8c636ccece7278407650f1c8,2,53,42,95,27,2014-03-13 09:28:41,2014-03-13 09:28:41
10c0cb8ca763861b8c636ccece7278407650f1c8...d1bee5e374595231327525472fab391bc078fa81,1,0,1,1,1,2014-03-13 18:35:11,2014-03-13 18:35:11
d1bee5e374595231327525472fab391bc078fa81...9064fba071d06439ead76890015c3d38ffa63375,1,1,0,1,1,2014-03-13 19:15:18,2014-03-13 19:15:18
56318a24b1f7c07f7fe5d3fd23bf7d26c0240a87...75c9c68c18f287473e49b1f8e9282c1062d48897,1,21,17,38,11,2014-03-12 07:55:08,2014-03-12 07:55:08
75c9c68c18f287473e49b1f8e9282c1062d48897...1c23f2b2594a1326a21a3ecd0856fa9b57eca059,1,1,2,3,1,2014-03-12 08:08:58,2014-03-12 08:08:58
1c23f2b2594a1326a21a3ecd0856fa9b57eca059...ae4ae2b225ffa5883a45d1de4cc79bdc96550cdf,12,0,0,0,0,2014-03-12 08:19:24,2014-03-12 08:19:24
0004aafe37fc9d0ae63e9e1ebe8c88e10bc23433...9583631666072a2242a10b53768cac41eb6cdca5,1,1,0,1,1,2014-03-06 14:55:57,2014-03-06 14:55:57
0004aafe37fc9d0ae63e9e1ebe8c88e10bc23433...61a72bc2e22548e7c216cf4499ced0841ff521cf,1,2,2,4,2,2014-03-06 13:08:40,2014-03-06 13:08:40
0004aafe37fc9d0ae63e9e1ebe8c88e10bc23433...60978e94bb2d10eff4c33219b462cd8640b25063,1,1,0,1,1,2014-03-06 11:36:34,2014-03-01 13:12:23
4c132ed48e5ddc81bb28bd07e92024ab3bf4d86e...0776199b4a693b7465ce7e50d4f21b4addc4941e,2,3,3,6,3,2014-03-06 13:48:56,2014-03-06 13:48:56
4c132ed48e5ddc81bb28bd07e92024ab3bf4d86e...261f212b3b99debd49805ff068a615e47d9aa762,7,13,13,26,13,2014-03-06 09:05:00,2014-03-06 09:05:00
261f212b3b99debd49805ff068a615e47d9aa762...2ed06dc41dbb5936af845b87d79e05bbf24c73b8,1,1,1,2,1,2014-03-06 12:04:01,2014-03-06 12:04:01
4c132ed48e5ddc81bb28bd07e92024ab3bf4d86e...1688a29023b834acd59379cf9555a119f45ae883,2,13,0,13,4,2014-03-06 04:24:03,2014-03-06 04:24:03
285ed33718cc86e65dd6ef11f75aa2a42018be16...5bda665d74fe5fdb08980d3ab04822e578f6aa57,1,1,0,1,1,2014-03-25 20:35:08,2014-03-25 20:35:08
b2e74741555f9cb9d58c3c44810803d0db39b9f3...74f16902cfdf9e75f187afda3cb58127b590a3db,1,2,2,4,1,2014-03-25 19:57:58,2014-03-25 19:57:58
8fa53ce43dff48a3e282460c9f9f40dbdfee6e12...a740e2d6d16271c2e3d06252e35e65b10d002834,2,19,1,20,2,2014-03-18 11:25:49,2014-03-18 11:25:49
acaf297846907bff096dcbd71d6665ac6d4b8abc...b6778cb2ea0888b6b0e20584366518e2a128d1a5,1,2,2,4,2,2014-03-19 02:21:25,2014-03-19 02:21:25
acaf297846907bff096dcbd71d6665ac6d4b8abc...f03820ebf2f28ddb26e422322219a815d8cd3749,1,3,0,3,1,2014-03-18 22:17:27,2014-03-18 22:17:27
acaf297846907bff096dcbd71d6665ac6d4b8abc...e3fc01b3eaa13a51aef380dc21f1e7d259706227,11,320,1,321,13,2014-03-18 17:54:30,2014-03-18 17:27:03
7c60713e82982066e187b8c16ce327978b451b0a...a91a6491bf3e74791ecf8dd1111d54435b8578cb,2,12,5,17,4,2014-03-17 12:33:21,2014-03-17 12:33:21
a91a6491bf3e74791ecf8dd1111d54435b8578cb...eea317795ea970f762a1331beba6fde20e7a8aeb,2,24,2,26,3,2014-03-17 12:33:41,2014-03-17 12:33:41
eea317795ea970f762a1331beba6fde20e7a8aeb...0ea0e542a93d023fb582f21d89a937c5c32cac18,1,0,12,12,1,2014-03-17 12:35:50,2014-03-17 12:35:50
0ea0e542a93d023fb582f21d89a937c5c32cac18...928b7f3bff82c614b8b6e68be8ed51707927a8c6,2,26,1,27,3,2014-03-17 13:14:27,2014-03-17 13:14:27
928b7f3bff82c614b8b6e68be8ed51707927a8c6...86c76eccea1bf3cf6c58b4315e6a6cb29e058a18,1,10,0,10,1,2014-03-17 13:22:39,2014-03-17 13:22:39
86c76eccea1bf3cf6c58b4315e6a6cb29e058a18...c02e3d441b6ef35bdbb4a45829f47369aa911690,1,1,1,2,1,2014-03-17 13:29:45,2014-03-17 13:29:45
189f88de5b6a85d1bae43cc4625e5d6604bbe6a8...19c28822ef60da0f4eda380e6cab3be4a4cb18e5,1,74,0,74,1,2014-03-20 08:16:17,2014-03-19 19:01:00
19c28822ef60da0f4eda380e6cab3be4a4cb18e5...f18a714f357405a87031250f4350343ae54d528f,1,19,41,60,6,2014-03-20 08:16:17,2014-03-19 19:02:12
f18a714f357405a87031250f4350343ae54d528f...729b358ff2981d8931e27fdc33d29b9528232c32,1,5,42,47,4,2014-03-20 08:16:17,2014-03-19 19:02:39
729b358ff2981d8931e27fdc33d29b9528232c32...41e981740ffc54f68ae5f8fe7b719183cd125094,2,3,1,4,2,2014-03-20 08:16:17,2014-03-19 18:56:31
2e94f0d224b8e994adc2ac7868fa6ec5c5c9264a...961d87937b55535ff3ffd041dbc78af82d644daa,1,12,0,12,1,2014-03-26 11:44:00,2014-03-26 11:44:00
961d87937b55535ff3ffd041dbc78af82d644daa...1aabfcb92d41f690e6756a7f057e85f17e30a0db,2,2,1,3,2,2014-03-26 11:45:39,2014-03-26 11:45:39
1aabfcb92d41f690e6756a7f057e85f17e30a0db...466203eb0c386b4b64512dc44cf7efa6221718df,1,2,0,2,1,2014-03-26 11:56:25,2014-03-26 11:56:25
c818712dfa0be11efd13c7e9ccac7dd7045e67d7...d21ad74146c6f490bd2a19ccf359c357fa3b7a81,1,1,0,1,1,2014-03-26 09:58:51,2014-03-26 09:58:51
c818712dfa0be11efd13c7e9ccac7dd7045e67d7...9422b451eb622196036ec3429bb61ac9a7078c2a,1,10,10,20,10,2014-03-26 09:50:42,2013-12-19 09:52:29
4af38885dfee57fee5e7a61ed59987a5454d5714...2e6b537018062b8407411e7bd51327f797f2fe1f,2,2,5,7,2,2014-03-28 12:57:52,2014-03-28 12:54:38
4af38885dfee57fee5e7a61ed59987a5454d5714...f48fc3c6cbcc0cbcb34cefa2025434c09cf57e04,1,10,0,10,1,2014-03-28 12:37:09,2014-03-28 12:37:09
f48fc3c6cbcc0cbcb34cefa2025434c09cf57e04...77b57c114be6b1fa02538c35066ccc363bfe68e6,2,4,2,6,3,2014-03-28 12:44:46,2014-03-28 12:38:36
4af38885dfee57fee5e7a61ed59987a5454d5714...b7225bead8ecf8664c898029648925556be8553d,2,6,1,7,2,2014-03-28 10:14:23,2014-03-20 12:23:07
b7225bead8ecf8664c898029648925556be8553d...ce857b7cc983172e35dca36f950864d693cfdf2b,9,42,27,69,11,2014-03-28 12:22:43,2014-03-26 07:25:02
ecae936d344b7d29f1898f81ac283d444c086f0d...6e73b208a9f69c68bf8575d902d6662eb3db0662,1,13,0,13,1,2014-03-15 08:23:48,2014-03-15 08:23:48
e320ee3fb775f4ebbf2c315d56108f9c41f707c9...8bbac4576b7c75f47a3a940dc5fb6b1217a3c397,1,1,6,7,2,2014-03-25 10:10:50,2014-03-25 10:10:50
8bbac4576b7c75f47a3a940dc5fb6b1217a3c397...80daf9a7774fd757a8838f0b49b6384ec7ceb724,3,4,4,8,4,2014-03-25 11:47:48,2014-03-25 11:47:48
110585c503a0d85fe61cde60c70fa333506370de...36b065e634f65e5c4690ccd7eed0cc90986ec67b,9,20,15,35,15,2014-02-28 20:43:16,2014-02-28 20:43:16
36b065e634f65e5c4690ccd7eed0cc90986ec67b...fe8552eff6ee444cbca11e5e80e8a9a2c16eefbc,2,19,0,19,2,2014-03-03 08:21:50,2014-03-03 08:21:50
5bf492fe1ff116d07d3514cde12510092e140f85...df2353716b076a445c454dcb2da1f09e06f7f3c5,1,1,1,2,1,2015-02-28 00:22:53,2015-02-28 00:22:53
df2353716b076a445c454dcb2da1f09e06f7f3c5...a41b9533fe569e1cd8471fbac8a34447560ecbb8,1,1,1,2,1,2015-02-28 00:24:05,2015-02-28 00:24:05
5bf492fe1ff116d07d3514cde12510092e140f85...62a81494ba22a33e5c798d9ce169a64239166f34,1,2,1,3,1,2015-02-27 00:03:42,2015-02-27 00:03:42
cd6baa141528f6d4e676715c2d3995fdc05e9544...a9eba1bde0e0ccd86bbc1df32d2538f986105d55,1,0,1,1,1,2015-02-26 03:51:13,2015-02-26 03:51:13
cd6baa141528f6d4e676715c2d3995fdc05e9544...1da71cc520dd09098d8f756de3f58b8e2f153fcd,21,57,39,96,38,2015-02-26 03:34:16,2015-02-26 03:34:16
1da71cc520dd09098d8f756de3f58b8e2f153fcd...0a4dec24c8effab297c195301f1213ab09d94633,1,13,0,13,1,2015-02-26 03:41:17,2015-02-26 03:41:17
0a4dec24c8effab297c195301f1213ab09d94633...128012dba8737b0dc65d41a3eb1690c9d8797a34,4,6,10,16,6,2015-02-26 03:50:01,2015-02-26 03:50:01
128012dba8737b0dc65d41a3eb1690c9d8797a34...6de4e4a622a98d86a44e9adf2fca15ff30c478c7,1,1,0,1,1,2015-02-26 17:34:20,2015-02-26 17:34:20
2cd2543c445c4e0889fea71908e861fd88f77863...4aeb9165660348d862172965238c366afaca05d5,1,9,2,11,3,2015-02-25 00:53:59,2015-02-25 00:53:59
e480e45a8b944143bec0468f9d5d4e2bfca82c86...d4e43dc1e6c8d61fcc0bbafbccdda845cb533e08,1,1,1,2,1,2015-02-19 19:58:29,2015-02-19 19:58:29
1475cb9aaae75d37719c8eac92f9483bb2fde416...b5c3e1a43158314cc1c624cff6294546ee64b418,4,207,6,213,9,2015-03-08 21:46:22,2015-03-08 21:46:22
b5c3e1a43158314cc1c624cff6294546ee64b418...69d2e1d8291621174cfa397e5f85d882da421031,2,13,0,13,2,2015-03-08 21:56:45,2015-03-08 21:56:45
69d2e1d8291621174cfa397e5f85d882da421031...1b5ca280d80e537a16cb9d8c22b605181a66c91f,2,10,9,19,2,2015-03-08 22:21:28,2015-03-08 22:21:28
1b5ca280d80e537a16cb9d8c22b605181a66c91f...f3d78ee31a23b012e1aa6d149a9cab4d9d329d06,1,16,0,16,2,2015-03-08 22:21:47,2015-03-08 22:21:47
1475cb9aaae75d37719c8eac92f9483bb2fde416...df13c9cac927af8d9b72d674b44c3d8017e1c846,1,9,6,15,3,2015-03-08 19:05:15,2015-03-08 19:05:15
df13c9cac927af8d9b72d674b44c3d8017e1c846...2e99d7c9157040612669993b54cbb236f199367a,1,4,2,6,1,2015-03-08 19:15:09,2015-03-08 19:15:02
560e717fd6cc4e1a6055e2d84432fe3ad60ce7eb...4165426725677d092275f2935a43527f130d8bcb,7,70,85,155,10,2015-01-06 20:32:04,2015-01-06 20:32:04
4165426725677d092275f2935a43527f130d8bcb...b8f48bf414f1ea1f6e36c9c560ae252bbfc20864,3,139,114,253,11,2015-01-06 21:09:56,2015-01-06 21:09:56
635f62be67a0a0e7cb02df40317e1c58c78738fb...a5b255fbdfcd01f355de2dca76e379e12b43d6e6,2,11,4,15,9,2015-01-22 17:37:47,2015-01-22 17:37:47
a5b255fbdfcd01f355de2dca76e379e12b43d6e6...98ee4a1fa73183cacf6c470b56e34afccec1c5dc,15,94,17,111,20,2015-01-22 17:40:03,2015-01-22 17:40:03
78bf00c78873c025b4930483be26b2892fd32df1...f891ababeb3f1ac90c65596bd5bae50fd56aa66b,1,1,1,2,1,2015-01-11 05:42:16,2015-01-11 05:42:16
1e37e8924ab38cfbb2a838c2bc6589b03f72dbcd...63924efeaffbf2a359817ea5f26a4c6cf0dbfb30,1,1,0,1,1,2015-01-13 20:04:04,2015-01-13 20:04:04
0625d68f7510a2f2203bfe2c57f5927a0121c561...4dddaef8661c8bfb5127d5db12b91d18cfcf0b8f,5,108,4,112,12,2015-03-06 23:46:13,2015-03-06 22:08:28
0625d68f7510a2f2203bfe2c57f5927a0121c561...9f089ac48c22b2f7cfbc7dd0ca29da924c566363,1,4,1,5,1,2015-03-06 19:06:26,2015-03-06 18:49:38
332413d7c4003c3718f8d91c54d7f3410710a5f9...4218a2bfcf7a3f864268c3eafe8ead28bb7808d8,10,40,4,44,18,2015-03-10 15:11:20,2015-02-28 01:17:57
2a76c7fd8a94f40575ac16f42c29ec55c38bad0a...ddd381c9a51b3408cf303283c466c7f70baf7e6a,1,1,1,2,1,2015-03-10 00:38:42,2015-03-10 00:38:42
b51e2a05592e09c6c64d5e28eafba8d4bbbcbe24...6b76ffc222e063cf4450aacb71805068e044beba,6,31,23,54,18,2015-03-10 00:06:08,2015-03-10 00:06:08
85e3b25c04f33a73886d6294a54045b8e71c3545...158507d942137e947a0e78a66e85a475667dd765,4,18,1,19,5,2015-03-12 04:29:11,2015-03-12 04:29:11
cb3b671839ccb99fbe100ae1fe684d391a30f191...d659c1d1fddcb4d915f07ad1152b1d8a999a1f64,10,31,31,62,29,2015-03-18 01:01:33,2015-03-18 01:01:33
dffa2fa9e92e37a664afa2807fd5b01fbbd87ef2...30ca451fd4f926998868b9db524e8fa98cd9457d,48,92,106,198,81,2015-03-14 07:29:32,2015-03-14 07:29:32
30ca451fd4f926998868b9db524e8fa98cd9457d...f311e189d5449f6118fc84746c62e33585e4c39c,1,1,7,8,4,2015-03-14 07:33:26,2015-03-14 07:33:26
dffa2fa9e92e37a664afa2807fd5b01fbbd87ef2...abf90611cbfd54590444a2f0221d2cbd7d8a6747,2,23,25,48,19,2015-03-14 07:13:15,2015-03-14 07:13:15
f57bffc82a5aa00e6494c65565255dfc9434f403...8cc111bd038e4c4d67b835de4a1996c04c6674d6,1,1,1,2,1,2015-01-27 21:40:23,2015-01-27 21:40:23
73885c31d6153c2b4ce5039970d51f0802df12ba...e2c9a486d73bc796fae678bc1fa6ec3c4d0e46ca,1,1,1,2,1,2014-12-23 09:11:56,2014-12-23 09:11:56
73885c31d6153c2b4ce5039970d51f0802df12ba...c5a1b808393d5b3769db0d65214df1645b69f6bf,1,1,0,1,1,2014-12-23 08:53:17,2014-12-23 08:53:17
73885c31d6153c2b4ce5039970d51f0802df12ba...b5d0f90e3047676f4e129ed4cd2732b6c5a7a3eb,1,3,3,6,3,2014-12-23 08:48:43,2014-12-23 08:48:43
c8bb171664de94778d4e6eba7773596b265f9efb...29ed4627754f4f462828aca5b7bf9dc1035cb6df,1,2,2,4,1,2014-12-29 09:17:23,2014-10-07 16:54:38
c8bb171664de94778d4e6eba7773596b265f9efb...cd688a60111853f63413a87ad6632ad57368e886,10,21,21,42,20,2014-12-28 22:53:27,2014-10-19 14:09:38
c8bb171664de94778d4e6eba7773596b265f9efb...faab452af92dbdbdb45d399fc5bbe85bb345cb9d,3,0,3,3,3,2014-12-28 13:42:15,2014-09-27 10:22:11
c8bb171664de94778d4e6eba7773596b265f9efb...5dbe94dc9bda5deceb6957a7e757425874f448de,1,1,1,2,1,2014-12-28 13:36:24,2014-12-04 15:31:12
c8bb171664de94778d4e6eba7773596b265f9efb...6c65b91d8c754c61fe8e50966283af5f78c1c9f0,3,4,4,8,4,2014-12-27 21:38:25,2014-09-30 20:28:05
c8bb171664de94778d4e6eba7773596b265f9efb...05a6115bc8f9ae3e3b41a155334adb6f73d5a0cc,2,23,21,44,21,2014-12-27 20:43:43,2014-12-27 20:43:43
2497273030e80bd7e4f891c7500901c0a38abea1...98e64610b2b5ad8340d763d3fd370bc11d0ad700,2,7,45,52,6,2014-12-17 07:27:03,2014-12-17 07:27:03
2497273030e80bd7e4f891c7500901c0a38abea1...7fcd0e836728950b5e78667b5b4187fea689e8ef,1,1,1,2,2,2014-12-15 08:44:29,2014-12-15 08:44:29
2497273030e80bd7e4f891c7500901c0a38abea1...6b1f2e433963a3cd70aeab01d45a1c4bf617bc05,1,14,0,14,1,2014-12-14 17:34:23,2014-12-14 13:37:38
2497273030e80bd7e4f891c7500901c0a38abea1...4eb3c47d4ec3e6750ae79e14eb008ce92fda96fd,2,5,5,10,3,2014-12-14 14:13:09,2014-12-14 14:13:09
2497273030e80bd7e4f891c7500901c0a38abea1...0cfca15292570197ec08bc9aa2bd550a0bcefc2d,1,7,0,7,1,2014-12-13 19:09:26,2014-12-13 19:09:26
0cfca15292570197ec08bc9aa2bd550a0bcefc2d...5ad463e0e89084133c764f20d030aae33b9aa907,1,4,4,8,1,2014-12-15 09:41:30,2014-12-15 09:41:30
3c2139ed172c607467ec6cf412d7ed33147bac22...1d6050104c17d7924d5cce0e6ddb35f5da45a08e,1,9,2,11,4,2015-02-19 18:26:57,2015-02-19 16:16:46
3c2139ed172c607467ec6cf412d7ed33147bac22...7c3147e6e969a7ae97e2f8d05e536abeeb7d3936,1,2,3,5,2,2015-02-19 16:57:33,2015-02-19 16:57:33
7c3147e6e969a7ae97e2f8d05e536abeeb7d3936...8184a6564454faf0f9ae9dfee1377c3407d08447,13,27,90,117,21,2015-02-19 16:57:35,2015-02-19 16:57:35
ad85f1ea78bc7d58db2e11fc47e9d02ac5f4d3d2...4386c210a17e071822126bccfedf0e19fbf1eb0a,1,8,5,13,6,2014-12-23 22:28:09,2014-12-23 22:28:09
27f31a7e3a396e0014be96799e4a15589ef96224...410790a355a6389bfa372e0834c31541b8ac8e4f,1,26,0,26,1,2014-04-28 09:48:18,2014-04-28 09:48:18
410790a355a6389bfa372e0834c31541b8ac8e4f...e5cf5f4f98464543ec2f06415e071b8110368cc7,1,1,1,2,1,2014-04-28 09:50:21,2014-04-28 09:50:05
e5cf5f4f98464543ec2f06415e071b8110368cc7...7339464e7701c0778cca12c12ace83ebd8ffe2f7,2,7,0,7,2,2014-04-28 09:55:13,2014-04-28 09:53:37
7339464e7701c0778cca12c12ace83ebd8ffe2f7...0b615eb0e2b5cca7685360c0cae72484741d672e,2,14,1,15,5,2014-04-28 10:13:29,2014-04-28 10:13:29
0b615eb0e2b5cca7685360c0cae72484741d672e...bbfa4a771ab8ca4745419b8d660af89249e088f4,1,3,3,6,4,2014-04-28 10:16:34,2014-04-28 10:16:34
bbfa4a771ab8ca4745419b8d660af89249e088f4...7ec5ff4dbae71d147f413da5cea64116e7eb305d,3,7,3,10,7,2014-04-28 10:21:49,2014-04-28 10:21:49
7ec5ff4dbae71d147f413da5cea64116e7eb305d...285926918b95f1d771bf4e9c84972d4e55b41ea9,4,4,4,8,4,2014-04-28 10:42:01,2014-04-28 10:42:01
285926918b95f1d771bf4e9c84972d4e55b41ea9...c685024951b8fed73ab05039baa170859ddf7b12,2,7,1,8,3,2014-04-28 11:02:05,2014-04-28 11:02:05
c685024951b8fed73ab05039baa170859ddf7b12...bd8b2b7fd98faf3308cb1f722426ff8f7c39f1d5,1,2,1,3,1,2014-04-28 14:39:42,2014-04-28 14:37:19
0f31acd0ec9b8a6ccfe9c6b0038736ad724814c0...bb7df7663a8952d60abea015f823b7acbc8c49c2,2,14,0,14,2,2014-04-13 15:46:41,2014-04-13 15:46:41
bb7df7663a8952d60abea015f823b7acbc8c49c2...61ef72e5d1219646778005422e423ebe95433bbb,1,1,2,3,1,2014-04-15 08:40:37,2014-04-15 08:40:37
0f31acd0ec9b8a6ccfe9c6b0038736ad724814c0...d97d811d2a463af2fe2920e06b6455fd72432a00,1,6,0,6,3,2014-04-13 14:40:56,2014-04-13 14:40:56
0f31acd0ec9b8a6ccfe9c6b0038736ad724814c0...d16bb8c025c604138ca38f02dd8fcbadffd3906d,1,7,0,7,1,2014-04-13 12:18:25,2014-04-13 12:18:25
0f31acd0ec9b8a6ccfe9c6b0038736ad724814c0...5d7bdf76426488f3229bb1f97aaa54a676cbf166,2,2,1,3,2,2014-04-12 21:10:45,2014-04-12 21:10:45
0f31acd0ec9b8a6ccfe9c6b0038736ad724814c0...0fd26ea46cb2714ad20f5518f58fb4778423f224,1,1,1,2,1,2014-04-12 07:05:08,2014-04-12 07:05:08
0f31acd0ec9b8a6ccfe9c6b0038736ad724814c0...c1c9e11457cb13a51686f9f24bfa849bc6ac7fa3,1,1,1,2,1,2014-04-11 22:00:58,2014-04-11 22:00:58
0f31acd0ec9b8a6ccfe9c6b0038736ad724814c0...e9409d1f4d07cfdca9d4fc18f62a9c688035deae,2,4,4,8,4,2014-04-11 21:13:21,2014-04-11 21:13:21
0f31acd0ec9b8a6ccfe9c6b0038736ad724814c0...c898dc00dca49e8a073421cbfe0765254e52fed8,1,1,1,2,1,2014-04-11 20:14:30,2014-04-11 20:14:30
c898dc00dca49e8a073421cbfe0765254e52fed8...802087c937d844d061cacff7fe1d44fd044ee91f,3,13,4,17,5,2014-04-14 13:22:57,2014-04-14 13:22:57
802087c937d844d061cacff7fe1d44fd044ee91f...5554eb166b5cbce0145c3f6220142856742c1ca0,1,4,2,6,2,2014-04-14 13:24:37,2014-04-14 13:24:37
0f31acd0ec9b8a6ccfe9c6b0038736ad724814c0...276a35c75c6eef958d5987450492981871efbe9b,1,7,4,11,1,2014-04-11 20:04:56,2014-04-11 11:01:58
276a35c75c6eef958d5987450492981871efbe9b...47f3eec515c8585595394323f15b1b454fdbb734,1,7,8,15,1,2014-04-11 20:04:56,2014-04-11 20:04:18
31fcac9ff9e1c3a0b08617bcc9d5e549c11634b6...d2851b088313cd4c343acb28d61bd517740932b6,1,0,1,1,1,2014-06-03 08:36:27,2014-06-03 08:36:27
d2851b088313cd4c343acb28d61bd517740932b6...da37a251f9f6a794c696cbc6afc8b2b04443fbeb,2,1,1,2,2,2014-06-03 10:33:43,2014-06-03 10:33:43
31fcac9ff9e1c3a0b08617bcc9d5e549c11634b6...3398e0a3d7a1bed8efb7e700dee92f95173d8334,9,25,126,151,23,2014-06-03 07:56:40,2014-06-03 07:56:40
87e0fe6f76fa8829abb99dd90a8af65ed11bc3a3...fc43c4e7fad0b958f4ba36a48ccecee82343ec2a,4,175,121,296,19,2014-06-03 09:44:22,2014-06-03 09:44:22
fc43c4e7fad0b958f4ba36a48ccecee82343ec2a...31c963edb137055c1fe7a67c31b63fabbfd8c0bd,4,14,13,27,6,2014-06-03 10:05:06,2014-06-03 10:05:06
31c963edb137055c1fe7a67c31b63fabbfd8c0bd...4656ef957a59a76b050badf60577c30bbf758535,12,13,5,18,4,2014-06-03 10:40:07,2014-06-03 10:40:07
4656ef957a59a76b050badf60577c30bbf758535...4e55dd5f1447d3050b3a683d0e5e131946ccedc0,2,4,3,7,4,2014-06-03 10:57:26,2014-06-03 10:57:26
4e55dd5f1447d3050b3a683d0e5e131946ccedc0...95d61a094d4d69fc332b40923ba08bbb57776f39,3,39,29,68,6,2014-06-03 11:19:11,2014-06-03 11:19:11
660585caa41002d9cfbe51842aaa6602b8de2895...6854be80a85ae8bc8203a3ae768e2bab7d5daa34,6,13,9,22,10,2014-06-02 11:12:46,2014-06-02 11:12:46
6854be80a85ae8bc8203a3ae768e2bab7d5daa34...33ff53d91560f15f80347c4f5774ba8b9791f133,4,5,5,10,5,2014-06-02 11:13:35,2014-06-02 11:13:35
33ff53d91560f15f80347c4f5774ba8b9791f133...133d231f87fdeb4a920051833750d4865b492b39,3,3,3,6,3,2014-06-02 11:21:12,2014-06-02 11:21:12
660585caa41002d9cfbe51842aaa6602b8de2895...379299ad18c28bb8b6f0ea52c5086193bb1d0e96,1,3,2,5,3,2014-06-02 07:39:43,2014-06-02 07:39:43
379299ad18c28bb8b6f0ea52c5086193bb1d0e96...c8460c4731fe73cf3ca4cb45d098f21636c71df3,1,3,1,4,1,2014-06-02 07:48:55,2014-06-02 07:48:55
34cf3c49167464ea00635cc4db17c67032fe1610...3410aaf950bb8a36415c9246195709b652d1d75c,1,1,0,1,1,2014-06-02 17:05:07,2014-06-02 17:05:07
34cf3c49167464ea00635cc4db17c67032fe1610...9a4c8f7e41eaec63d98431f5ff776240e2dc7604,3,22,9,31,8,2014-06-02 15:58:00,2014-06-02 15:58:00
9a4c8f7e41eaec63d98431f5ff776240e2dc7604...144212fba27b688d0e3a12ea6092c4f4c7b89da9,2,8,2,10,5,2014-06-02 16:31:43,2014-06-02 16:31:43
144212fba27b688d0e3a12ea6092c4f4c7b89da9...5a064b0249922c4d82fb44ae9f3bcf230a3cbbd0,1,4,1,5,1,2014-06-02 18:25:01,2014-06-02 18:25:01
9f80ab8e75181534cb21809258337f081beaf918...74079fe2369c20767cb6c639eec1886c9822fefc,5,6,227,233,6,2014-05-22 15:19:50,2014-05-22 15:19:50
9f80ab8e75181534cb21809258337f081beaf918...88781783dd425d1ba4ff5cacf9b4cc4c23a9a35e,1,42,0,42,1,2014-05-22 11:23:20,2014-05-22 11:23:20
88781783dd425d1ba4ff5cacf9b4cc4c23a9a35e...e089b11b7a4026acc7706e519682f4b7141b2bcd,1,11,0,11,1,2014-05-22 11:38:48,2014-05-22 11:38:48
e089b11b7a4026acc7706e519682f4b7141b2bcd...0455391add2032dddc7353d1b0ae36d591818d3f,3,8,9,17,4,2014-05-22 11:39:09,2014-05-22 11:39:09
0455391add2032dddc7353d1b0ae36d591818d3f...a9d60b3b146acf5540b422919fa87fa931801062,1,12,0,12,1,2014-05-22 11:39:50,2014-05-22 11:39:50
a9d60b3b146acf5540b422919fa87fa931801062...36cac35b24d7b8318de40bd2e495b8807eef48fc,1,12,8,20,1,2014-05-22 12:38:47,2014-05-22 12:38:47
36cac35b24d7b8318de40bd2e495b8807eef48fc...b9d1fc2f3bdebe541795d6ef6e94da9e98b043d3,1,5,5,10,2,2014-05-22 15:31:22,2014-05-22 15:31:22
9f80ab8e75181534cb21809258337f081beaf918...1ad174fbcdb7c14eb8fbe9820e1152383f41a89e,3,19,11,30,11,2014-05-22 09:25:44,2014-05-22 09:25:44
9f80ab8e75181534cb21809258337f081beaf918...b019c06195cf3ca3e097f57c53cbd863165fa077,1,1,1,2,1,2014-05-22 09:01:01,2014-05-22 09:01:01
c91300e4ce1f991a6070330c6fe2f7528dea3e10...24b68fdada1fbcc4874c32703aac0ca7ef1d52b4,1,1,1,2,1,2014-05-14 09:13:05,2014-05-14 09:13:05
f18f8e675594ba86a59176933f2521a9c6ec9f2f...0505a882991da981b4797e0a48c7c5098cd084e2,1,3,3,6,3,2014-05-15 13:30:21,2014-05-15 13:30:21
0505a882991da981b4797e0a48c7c5098cd084e2...a3a512f2efe293aa2a6a1e4eb7edf04fd9087974,2,2,2,4,2,2014-05-15 13:30:50,2014-05-15 13:30:50
f18f8e675594ba86a59176933f2521a9c6ec9f2f...f4bca105d16e3bc47c2cd2725c519d2dcd788e70,1,17,1,18,2,2014-05-14 16:10:43,2014-05-14 16:10:43
f4bca105d16e3bc47c2cd2725c519d2dcd788e70...982d4d51e8110bec280eb00db0fb756b062103d9,2,35,0,35,2,2014-05-14 16:11:14,2014-05-14 16:11:14
982d4d51e8110bec280eb00db0fb756b062103d9...d54133b09fdb0b2e589896dc8740bb8d0c99ed54,1,32,0,32,1,2014-05-14 16:26:49,2014-05-14 16:14:06
d54133b09fdb0b2e589896dc8740bb8d0c99ed54...a754f0b2205d4f09092c8c7c032ad944a229be8f,1,7,0,7,2,2014-05-14 16:26:58,2014-05-14 16:26:58
a754f0b2205d4f09092c8c7c032ad944a229be8f...a6e4153878eda841b0a71e5e1666e6bed0a050ae,1,5,1,6,1,2014-05-14 16:32:40,2014-05-14 16:32:40
a6e4153878eda841b0a71e5e1666e6bed0a050ae...11dba4cee7dc43f88c340bccd553cff0e3d874e4,1,1,1,2,1,2014-05-14 16:54:05,2014-05-14 16:54:05
11dba4cee7dc43f88c340bccd553cff0e3d874e4...797e807249076920d6c4bb71f6258ca05ee0db34,1,2,2,4,1,2014-05-14 17:04:00,2014-05-14 17:04:00
797e807249076920d6c4bb71f6258ca05ee0db34...a966f72224427fe6830426f459d445cd19ecd5a0,1,3,0,3,1,2014-05-14 17:08:42,2014-05-14 17:08:42
a966f72224427fe6830426f459d445cd19ecd5a0...be1120e9681bfb83084c7aeadae3e83692901de9,3,4,4,8,4,2014-05-14 17:13:06,2014-05-14 17:13:06
f18f8e675594ba86a59176933f2521a9c6ec9f2f...2f8fd80ebba35706d70fd7b4d4246d7cc1b65ac3,1,2,2,4,2,2014-05-14 14:06:52,2014-05-14 14:06:52
f18f8e675594ba86a59176933f2521a9c6ec9f2f...ad7de951214fcfa9a0677b2b8bd669b5bd07d83e,1,31,0,31,1,2014-05-14 11:49:16,2014-05-14 11:48:51
68b89142aa6a55314ba6d6a62b9efe776b13ff07...f0e46ec9178bfa51034a27067ecbf14ad97f3a37,1,1,1,2,1,2014-05-13 05:58:12,2014-05-13 05:58:12
68b89142aa6a55314ba6d6a62b9efe776b13ff07...fe6d392236fb6f1edd5dc1c33d52806cb4fa8a39,1,39,0,39,1,2014-05-12 13:34:41,2014-05-12 13:34:41
fe6d392236fb6f1edd5dc1c33d52806cb4fa8a39...0c73e6664389ef5af352560c2fced1fbfc650a27,1,12,9,21,5,2014-05-12 14:51:43,2014-05-12 14:51:43
0c73e6664389ef5af352560c2fced1fbfc650a27...5880d7df6253fc97024005e7c32dbc41def99aaf,2,49,0,49,2,2014-05-12 15:01:22,2014-05-12 15:01:22
5880d7df6253fc97024005e7c32dbc41def99aaf...ab032256da9f24351871143058343f7463f9d7fc,3,14,6,20,5,2014-05-13 08:01:40,2014-05-13 08:01:40
ab032256da9f24351871143058343f7463f9d7fc...2d2b2da45a586bdf29e115dcb4b4f66f9a1feed0,1,15,0,15,1,2014-05-13 10:20:10,2014-05-13 10:20:10
4917dc64693ad7131f6943497e4caee13f1c55ef...da347d1bb45ad3b08b2aa0b40041c67dac0df3c5,2,2,1,3,2,2014-05-08 16:23:44,2014-05-08 09:02:04
4917dc64693ad7131f6943497e4caee13f1c55ef...41231862baeb01dc6ed49f68488e863bca6dbfb2,1,0,1,1,1,2014-05-08 16:23:39,2014-05-08 16:23:39
5218537c3bff9e26f657fd0f8c773471a5170d9b...20be9ef251ff0d1e865f1ec5090ee151a24135bb,1,0,25,25,1,2014-05-08 18:09:51,2014-05-08 18:09:51
20be9ef251ff0d1e865f1ec5090ee151a24135bb...2ec1a879f7cb96370a54f379c39a88b75b67f4c7,1,1,0,1,1,2014-05-08 18:10:07,2014-05-08 18:10:07
2ec1a879f7cb96370a54f379c39a88b75b67f4c7...211e975d8acbc046219fefbf95a12a8f0bbf980b,1,3,4,7,3,2014-05-08 18:10:20,2014-05-08 18:10:20
c5ef0c60bff41f53b98091fefb24517a4abc038a...993fc8485518e53b7b868b47a622455b01d741a1,1,1,1,2,1,2014-05-02 19:00:23,2014-05-02 19:00:23
c57180367c8a9e55beb378fc7d0fd3c1cc1497e5...cbbf715d30eb36f82f56cc4295c3ed3ec766abbe,1,4,0,4,1,2013-11-26 10:14:25,2013-11-26 10:14:25
c57180367c8a9e55beb378fc7d0fd3c1cc1497e5...705c495eded552bc6e67856a26e4bdd59778c4c7,1,5,22,27,6,2013-11-26 09:22:04,2013-11-26 09:22:04
705c495eded552bc6e67856a26e4bdd59778c4c7...fecbf9255c6de2ef9e44339726613280c1a28b3d,1,1,2,3,1,2013-11-26 09:22:23,2013-11-26 09:22:23
fecbf9255c6de2ef9e44339726613280c1a28b3d...6f17221b7a7861ca077f75ca563888eaab79ad1d,1,1,1,2,1,2013-11-26 09:30:56,2013-11-26 09:30:56
6f17221b7a7861ca077f75ca563888eaab79ad1d...c275169a1bdfd6c45ac29be9bc0e4e3d6435a8fb,1,4,3,7,2,2013-11-26 09:31:02,2013-11-26 09:31:02
74f1da10d1e6923c347426de9603df7bd8919e09...25d93987d4667ad1aa1d9550117685ce14f9d5cb,1,4,3,7,4,2014-01-31 01:18:59,2014-01-31 01:12:41
baccb9a4079311835f496f14a5dc411ac779bb23...4645f464a310d9b13620fdbc0e9a0933f427aca7,4,12,1,13,4,2014-01-24 19:29:22,2014-01-24 19:29:22
4645f464a310d9b13620fdbc0e9a0933f427aca7...237ddd60244526ab5869c78cc086cec637544399,4,4,1,5,4,2014-01-24 19:29:52,2014-01-24 19:29:52
f91f230cec3d4768a752b93f35fa45fb8c85d10a...a6e3b780d6d11e48f96c401cab4dba853b32369d,1,37,31,68,14,2014-06-25 07:36:46,2014-06-25 07:18:52
f91f230cec3d4768a752b93f35fa45fb8c85d10a...907548a0fbf3c048536c2012bdbdbd10b604c067,2,4,0,4,2,2014-06-25 07:14:35,2014-06-25 07:14:35
f91f230cec3d4768a752b93f35fa45fb8c85d10a...8e7a5cda30a0626a2b519932e8c487c7cc10d68e,1,1,1,2,1,2014-06-25 07:06:39,2014-06-25 07:06:39
6b16f8a7a84a91bafac97e1e7e2390e32877eabb...4994ebbb11d701a5831edce2ca450d0c1011c99e,1,8,8,16,5,2013-08-27 21:15:32,2013-08-27 21:15:32
6b16f8a7a84a91bafac97e1e7e2390e32877eabb...777456b29ccf69774048061bb0aac91e4406fef8,1,4,3,7,4,2013-08-27 21:04:04,2013-08-27 21:04:04
777456b29ccf69774048061bb0aac91e4406fef8...7f65339fffaf6d051338ee399bfe439234ce70a0,1,2,2,4,1,2013-08-28 18:36:09,2013-08-28 18:36:09
7f65339fffaf6d051338ee399bfe439234ce70a0...ffa46e0225bad993f8999a33905dcff7a75327e0,1,5,0,5,1,2013-08-29 15:59:08,2013-08-29 15:59:08
5dad053a82a824c61a813aaf608d1e9240e1020c...ad5228481019e1f282d3a32249e801d15f0690d4,1,1,1,2,1,2013-09-03 15:09:12,2013-09-03 15:09:12
73af33e4b1aed1cbde3644a0e94ab2d40340e31b...f7e7dc7ebbdac2a45d528d1f9c19055febd0bede,9,59,66,125,13,2013-12-25 11:32:43,2013-12-25 11:32:43
f7e7dc7ebbdac2a45d528d1f9c19055febd0bede...923bd2ecd28f633ef7e5a789ba3889a550cf45c7,1,397,0,397,1,2013-12-25 20:31:18,2013-12-25 20:31:18
923bd2ecd28f633ef7e5a789ba3889a550cf45c7...48c682b52f61d96ef14ca9168b5f2678385dd626,4,62,61,123,17,2013-12-25 20:32:23,2013-12-25 20:32:23
48c682b52f61d96ef14ca9168b5f2678385dd626...f554aa38d504387aae09d4000bd208078e1c3c1b,4,4,8,12,5,2013-12-25 20:32:48,2013-12-25 20:32:48
f554aa38d504387aae09d4000bd208078e1c3c1b...9305ef8940988fc9baad7c5196819f272445dd9b,3,10,594,604,5,2013-12-25 20:33:40,2013-12-25 20:33:40
9305ef8940988fc9baad7c5196819f272445dd9b...21b028b548affbaefceb71286b3046899b659cd8,2,29,3,32,7,2013-12-25 21:21:26,2013-12-25 21:21:26
21b028b548affbaefceb71286b3046899b659cd8...d4ec23b8b5fbc4aab4f5ba65c93e976fa4113db9,2,4,2,6,2,2013-12-26 07:39:55,2013-12-26 07:39:55
d4ec23b8b5fbc4aab4f5ba65c93e976fa4113db9...5f7db3e94bd821ef561d44c85e611e843d64dc2c,2,3,2,5,2,2013-12-26 07:44:18,2013-12-26 07:44:18
73af33e4b1aed1cbde3644a0e94ab2d40340e31b...c447a2131d864cb715c0fb9ba562db67ade2f7c6,1,1,1,2,1,2013-12-25 11:30:33,2013-12-25 11:30:33
168afa024ee8c2023f229de2bab89fc26a168fa1...4fc57b5872feddb3521478659bee6f9b9da838ef,1,1,1,2,1,2014-03-27 18:09:50,2014-03-27 15:23:05
168afa024ee8c2023f229de2bab89fc26a168fa1...9ec08daa90162ea4d63db518fca0312f5bd5328d,1,1,19,20,1,2014-03-27 15:08:02,2014-03-27 15:08:02
168afa024ee8c2023f229de2bab89fc26a168fa1...3b3186d58be54c0c720564939cebc0419a5751c1,1,2,2,4,2,2014-03-27 14:34:55,2014-03-27 14:34:55
ae4ae2b225ffa5883a45d1de4cc79bdc96550cdf...c4263dfbaff03711b7f18343d8e8bdc380242501,1,6,12,18,10,2014-03-13 08:39:41,2014-03-13 08:39:41
c4263dfbaff03711b7f18343d8e8bdc380242501...46cc3b22c9fbe89b9fadc9c7488ec4e353b4970e,2,9,0,9,2,2014-03-13 08:47:53,2014-03-13 08:47:53
46cc3b22c9fbe89b9fadc9c7488ec4e353b4970e...b0a86cb3ba649ea959d05a972f6cd1d6798f86c9,1,2,3,5,2,2014-03-13 09:33:33,2014-03-13 09:33:33
b0a86cb3ba649ea959d05a972f6cd1d6798f86c9...5be424565ebe71b6c4d93adfecea9d7b057ae086,1,13,0,13,3,2014-03-13 09:37:13,2014-03-13 09:37:13
ae4ae2b225ffa5883a45d1de4cc79bdc96550cdf...c22646d2a4f5fd50997cd95d89b35b27df65721f,1,4,6,10,6,2014-03-12 14:26:39,2014-03-12 13:04:24
c22646d2a4f5fd50997cd95d89b35b27df65721f...3e6fe8bff04f7ab72119cdfc04d7c752c58a3d40,1,95,0,95,1,2014-03-12 15:01:10,2014-03-12 15:01:10
3e6fe8bff04f7ab72119cdfc04d7c752c58a3d40...85a4d1ec6c0288d960c5c51d2d6e6b4ce55e2e35,1,3,0,3,1,2014-03-12 15:01:34,2014-03-12 15:01:34
9ff75e6a6f7ada371fb1c0905a6e5b24d41504e4...8634d0d5c1a8c7c1dc0aa735bb7bd450ca6c9b86,1,1,1,2,1,2014-03-06 16:31:08,2014-03-06 16:31:08
046773d6e53035599544de4f85906bf706eab7d1...c1fd25ce6ed28ad19fe4928be018a189c06cc3d7,6,7,12,19,9,2014-03-19 10:59:23,2014-03-19 10:59:23
046773d6e53035599544de4f85906bf706eab7d1...65d634706cf833fc4b0b2f263f9d8fb35219858e,1,12,0,12,1,2014-03-19 09:14:27,2014-03-19 09:14:27
65d634706cf833fc4b0b2f263f9d8fb35219858e...1897fb00b8d804cffa40da074f83575489beddb0,10,42,54,96,33,2014-03-19 09:15:24,2014-03-19 09:15:24
046773d6e53035599544de4f85906bf706eab7d1...53d3294d1de6a3ded84532c1874ca48910fd69b0,3,26,29,55,17,2014-03-19 07:57:37,2014-03-19 01:32:40
53d3294d1de6a3ded84532c1874ca48910fd69b0...a90574fab290233225375b1c9e9c232b0e540b52,1,7,11,18,4,2014-03-19 07:57:38,2014-03-19 07:55:59
612a909eac58b8ebb6a2d9f68bbe2b8998411b89...83e83b6617694c03457ca3a36230b54560ce6833,2,17,32,49,7,2014-03-20 08:53:03,2014-03-20 08:53:03
78a7a9b0be5f4f257ee491a88df7c85fcb2b926b...7bf92b368fae70c835c729515f9dac1fb766c185,1,14,1,15,1,2014-03-26 14:38:14,2014-03-26 14:38:14
78a7a9b0be5f4f257ee491a88df7c85fcb2b926b...043c9f8640b558f2d46b9d64a498ab47f0c0700a,6,12,12,24,11,2014-03-26 13:00:12,2014-03-26 12:51:28
e6fbf79bc51c6a466d7fa880adb598cded41707a...c34186f88258aadd03c7e692606ff2499d221d2b,1,33,13,46,3,2014-03-28 16:51:13,2014-03-28 15:43:28
6e73b208a9f69c68bf8575d902d6662eb3db0662...ac09f6deb9ced5f5db6dc21b9cf9c153953d175f,1,4,4,8,3,2014-03-15 19:45:00,2014-03-14 04:49:50
6e73b208a9f69c68bf8575d902d6662eb3db0662...39f80884db394decdb4b4a21a30bc1ecb3203944,11,96,86,182,21,2014-03-15 09:39:35,2014-03-15 09:39:35
80daf9a7774fd757a8838f0b49b6384ec7ceb724...c21c3e5707c4f6e28a3733153f2e898279e0730d,1,4,0,4,1,2014-03-25 17:32:49,2014-03-25 17:32:49
80daf9a7774fd757a8838f0b49b6384ec7ceb724...f08464c055420f9091512a3f9ec1dc2de960fbde,11,12,23,35,17,2014-03-25 12:01:52,2014-03-25 12:01:52
f08464c055420f9091512a3f9ec1dc2de960fbde...cce80d04fe0271709170222d3b5774c39203ea07,1,0,5,5,1,2014-03-25 12:02:55,2014-03-25 12:02:55
ada7d0f393efb1a96fdfe626087f50ac5f5f6664...3e6b342a1ab6702d2f897ecc0f259d3876e65ade,3,19,42,61,19,2015-02-27 18:38:15,2015-02-27 18:38:15
a9eba1bde0e0ccd86bbc1df32d2538f986105d55...e27f5aef462e5cf32f23fbb3137b98011c0c0ddf,2,3,1,4,3,2015-02-26 06:17:46,2015-02-26 06:17:46
a9eba1bde0e0ccd86bbc1df32d2538f986105d55...8490a8ab2a70828e4bb5587c7cc07c750483ef2e,1,0,0,0,0,2015-02-26 04:55:53,2015-02-25 09:20:17
8490a8ab2a70828e4bb5587c7cc07c750483ef2e...e53dd7526f69545ca86fc6935ad8077592628772,3,21,1,22,3,2015-02-26 04:57:23,2015-02-25 09:29:33
a9eba1bde0e0ccd86bbc1df32d2538f986105d55...e993b59b7dcaf795abb82af3f548f35aff01c6a8,1,1,1,2,1,2015-02-26 03:53:45,2015-02-26 03:53:45
e993b59b7dcaf795abb82af3f548f35aff01c6a8...c254cb03d8ddfb217341c2f83223ba30228f3088,2,12,10,22,2,2015-02-26 04:00:28,2015-02-26 04:00:28
b510223e7fe157c8e27e8a1d4788af9db74f8d7c...6ac0a0217cfcfa9915d5380337b9e5dd25b699ea,1,1,1,2,1,2015-02-27 00:44:52,2015-02-27 00:44:52
1065f3d30b0d793fc0b944cc9d19c8e9858ae08a...cdb64a81a8ca96961033b8ab06d5191ef5449634,1,5,3,8,3,2015-03-12 17:20:24,2015-03-12 17:20:24
82483f953671237896e8131d557642161ed5e97f...6fe057cc7b4ec4c7483422ea0fe2b4eb28e315df,1,7,8,15,3,2015-02-25 05:40:47,2015-02-25 05:40:47
6fe057cc7b4ec4c7483422ea0fe2b4eb28e315df...1faf3676aa023395c468d4e89224726c8e5b9b7d,6,77,200,277,10,2015-02-25 06:19:14,2015-02-25 06:19:14
1faf3676aa023395c468d4e89224726c8e5b9b7d...6e559be6c68b921e12518816a824724564e3e315,7,18,22,40,6,2015-02-25 06:58:47,2015-02-25 06:58:47
6e559be6c68b921e12518816a824724564e3e315...ee343661e18ccd95f2c74e7bc0d0116a100270ea,3,10,7,17,2,2015-02-25 07:17:11,2015-02-25 07:17:11
ee343661e18ccd95f2c74e7bc0d0116a100270ea...878e86bf64ce09938c1f2cc4dd1555029969a7c2,13,13,13,26,13,2015-02-25 07:26:32,2015-02-25 07:26:32
82483f953671237896e8131d557642161ed5e97f...f43c0429c25dff42aec395a24057eb8d37ff449d,4,10,4,14,6,2015-02-25 05:31:54,2015-02-25 05:31:54
a7f52b6cc25991bffa30eefa7d8bd6be138cffec...ebe0d34128c31bb88f6eb5aca96fae012c7fcf8b,1,1,1,2,1,2015-02-22 18:52:30,2015-02-22 18:52:30
f930cf8461fce0070e755cc255e92b2042b6db5c...a6bb345d585e8aa9ae80ef4f9745f104085537db,1,2,0,2,1,2015-03-08 23:34:26,2015-03-08 23:34:26
842f9e03a8b6c5e7a25381aeeafa35ef7d927c71...b55a0519acb34a764b2a350010aa813fd35b361e,4,4,4,8,4,2015-01-06 23:39:33,2015-01-06 23:39:33
08e0c0b6d6702c3a73636ae8d2efd10cad955f06...d005c44816b87637b5952dd50178fb7e94e30cc2,1,1,1,2,1,2015-01-22 18:38:24,2015-01-22 18:38:24
d005c44816b87637b5952dd50178fb7e94e30cc2...7afa4d5791bc9cf94eb3e33257d7f6f740c6bcf1,1,0,1,1,1,2015-01-22 19:14:29,2015-01-22 19:14:29
89ef79f8b48f2bcff6417bc1e997054c5b27d6c6...84edc020b2107252a383ce73ca41924b8be9ddad,1,1,1,2,1,2015-03-17 06:44:30,2015-03-17 06:44:30
84edc020b2107252a383ce73ca41924b8be9ddad...3a324d9c6d52b7605e8b701ac70eddc2528b408b,3,7,48,55,9,2015-03-17 06:51:46,2015-03-17 06:51:46
3a324d9c6d52b7605e8b701ac70eddc2528b408b...409097bd7e0f5857cf0bc5462bd47484980ec787,1,4,2,6,1,2015-03-17 07:06:25,2015-03-17 07:06:25
f891ababeb3f1ac90c65596bd5bae50fd56aa66b...f31a96104f0b8f535c04ecf5bcec1bcb4719ee93,1,1,0,1,1,2015-01-11 06:48:16,2015-01-11 06:48:16
f891ababeb3f1ac90c65596bd5bae50fd56aa66b...2543af84f0925a1eea585675b2a334a5691a110b,1,6,0,6,1,2015-01-11 06:18:14,2015-01-11 06:18:14
be9f5589ed96cb7baeb6ee2bcc5f4a704573675d...1c49c30119ebce11f3a0b7cc93dc0c88e04d39db,2,3,3,6,3,2015-01-13 23:46:00,2015-01-13 23:46:00
be9f5589ed96cb7baeb6ee2bcc5f4a704573675d...48f81ca7a75dcb42982ab0a90ba5fd040e4c7b50,1,1,1,2,1,2015-01-13 20:16:40,2015-01-13 20:16:40
b70b1055b1798897eb7326bba86ca5f8992330d0...90f5dacc4b22c43aeec1c10ead45e2df18489b81,2,2,2,4,2,2015-03-10 00:59:32,2015-03-10 00:59:32
90f5dacc4b22c43aeec1c10ead45e2df18489b81...86a17390dd923351ed51b9b94d34460d7a5c8214,2,11,12,23,2,2015-03-10 01:09:23,2015-03-10 01:09:23
f29a7ce51f1f9d859258e190cf1d01c3d58806e1...3f823068e1f6e3e88d6631de60d9aaf9ecd5e6f9,3,4,0,4,4,2015-03-12 04:11:32,2015-03-12 04:11:32
b8b3f7f11c9ddd07d4e1027ed61cc963d0cefa9b...aa4691acacade89cb811221a64829d290badd343,1,2,2,4,2,2015-03-18 01:38:10,2015-03-18 01:38:10
60df262c38d7c235b483cc1c4beb12f793e0e58a...a2fb3711f07eba7fc33b798cee1827c95b204ca8,2,2,2,4,2,2015-03-16 01:06:25,2015-03-16 01:06:25
60df262c38d7c235b483cc1c4beb12f793e0e58a...3b1d5a1dffa35746d3619b90f3e82f8437e38c91,5,30,10,40,11,2015-03-15 15:52:22,2015-03-15 14:42:31
60df262c38d7c235b483cc1c4beb12f793e0e58a...99f995755ef4b445216dd7baae35f5a4846ef30c,14,59,59,118,38,2015-03-15 12:49:41,2015-03-13 15:16:51
99f995755ef4b445216dd7baae35f5a4846ef30c...31fc73f0a9b9225ba3737b9525fcf7a1695a45f2,25,143,134,277,45,2015-03-15 12:50:38,2015-03-13 15:22:03
31fc73f0a9b9225ba3737b9525fcf7a1695a45f2...bbdf23261c00de58b18948381b0cc206e7d3501f,2,33,33,66,24,2015-03-15 12:50:38,2015-03-13 15:23:45
bbdf23261c00de58b18948381b0cc206e7d3501f...e97cdb042d941c989b303137c42e4c22f535f36b,3,0,3,3,3,2015-03-15 12:50:38,2015-03-13 15:23:59
e97cdb042d941c989b303137c42e4c22f535f36b...75aff0f79c73ccc430a8c92b2317d114a5c8b24d,7,9,10,19,8,2015-03-15 12:51:11,2015-03-13 15:25:54
75aff0f79c73ccc430a8c92b2317d114a5c8b24d...224187ffb96283cbf42953a30c116931c03562a2,14,60,37,97,25,2015-03-15 12:51:11,2015-03-13 15:27:51
224187ffb96283cbf42953a30c116931c03562a2...84371de01f3ce7bab334539a93734658528736ec,5,18,25,43,7,2015-03-15 12:52:28,2015-03-13 15:28:33
84371de01f3ce7bab334539a93734658528736ec...5ad35bbe028c60c1281871b45619455a508f7b5b,19,137,106,243,25,2015-03-15 12:55:57,2015-03-13 15:30:36
5ad35bbe028c60c1281871b45619455a508f7b5b...f66b77e6317acaaf382f2632325afc8b1413a9c7,1,3,1,4,3,2015-03-15 12:55:57,2015-03-13 21:20:14
f66b77e6317acaaf382f2632325afc8b1413a9c7...e88d06c892eed5c50fb98eeb90d47380f47e6194,1,1,1,2,1,2015-03-15 12:56:32,2015-03-15 12:56:32
e88d06c892eed5c50fb98eeb90d47380f47e6194...584580e5156020e639b2a578c332ae92e38b3a5c,1,1,0,1,1,2015-03-15 12:56:56,2015-03-15 12:56:56
f311e189d5449f6118fc84746c62e33585e4c39c...9b445c683657a85a090af69b12545b657fe5f616,3,9,9,18,6,2015-03-14 08:47:19,2015-03-14 08:47:06
998f9907141c6a057d6d3bb7bb1a4a84cc4e6421...7dedbfb097d1fae7a7d698ab0d3f981f8291b21e,1,1,1,2,1,2015-03-16 17:56:54,2015-03-16 17:56:54
7dedbfb097d1fae7a7d698ab0d3f981f8291b21e...cba6d797d756e6cc3cf976610d5d21f55e6460b5,1,0,5,5,1,2015-03-16 18:12:44,2015-03-16 18:12:44
e3987bb6b150a255a76310cc1eabda8945e2f0cd...0eed5cace39fccba57e590c4fb9bea1e1cd8387d,3,13,11,24,8,2015-01-21 04:44:33,2015-01-19 04:24:00
0eed5cace39fccba57e590c4fb9bea1e1cd8387d...772e321120b38353ca9dba1466fd480a8f9c9784,1,2,2,4,2,2015-01-22 06:44:49,2015-01-22 06:44:49
772e321120b38353ca9dba1466fd480a8f9c9784...2733e27864810819704f26be623d1b39cb7366b6,1,1,1,2,1,2015-01-22 07:19:24,2015-01-22 07:19:24
e3987bb6b150a255a76310cc1eabda8945e2f0cd...54f9432255fe96d70543ecbcb847be657b7b6978,1,2,1,3,2,2015-01-20 06:25:09,2015-01-20 06:25:09
e3987bb6b150a255a76310cc1eabda8945e2f0cd...c92de64bdb057922ca6f243f36502bbf160b9ffc,4,14,0,14,2,2015-01-20 05:43:25,2015-01-20 05:08:04
8cc111bd038e4c4d67b835de4a1996c04c6674d6...50297f7134e878fba84168785ae461d14e08c572,1,1,1,2,1,2015-01-28 06:51:11,2015-01-28 06:51:11
8cc111bd038e4c4d67b835de4a1996c04c6674d6...35d6d1ce4669d1f3850862f3c144abaaf5b841d3,11,2,10,12,11,2015-01-28 00:24:05,2015-01-26 05:12:16
f3d7bf63f1b53aafdc335f7294de39f2757310bf...90ed76ac3cfc64f7bfc66a90104d055ddd1bb2e7,1,8,1,9,1,2014-12-23 09:22:12,2014-12-23 09:22:12
9470675b4e13ce16ab22f372c1bdad591c9ee1bc...ee26dae63e312e236a6e7f4c79ee1e382c4082a2,6,20,16,36,11,2015-02-19 23:02:49,2015-02-19 23:02:49
ee26dae63e312e236a6e7f4c79ee1e382c4082a2...6177256033f045e14161c8672223da84c6db56dc,7,42,57,99,10,2015-02-19 23:46:48,2015-02-19 23:46:48
6177256033f045e14161c8672223da84c6db56dc...b876793d031247bed2aa3b31dc9ebb960bef47e0,4,120,119,239,15,2015-02-19 23:47:10,2015-02-19 23:47:10
b876793d031247bed2aa3b31dc9ebb960bef47e0...4511bc1f3d7b28a01a0d35d69eea14b80f6bf91f,3,11,18,29,4,2015-02-19 23:56:23,2015-02-19 23:56:23
4511bc1f3d7b28a01a0d35d69eea14b80f6bf91f...78aa1bb4e2aa355c8567ab660756a1bfc884df36,1,1,1,2,1,2015-02-20 00:16:41,2015-02-20 00:16:41
78aa1bb4e2aa355c8567ab660756a1bfc884df36...ad67bf51d2c9c0a3d3061346336cd85f482931b5,1,4,2,6,2,2015-02-20 00:24:59,2015-02-20 00:24:59
ad67bf51d2c9c0a3d3061346336cd85f482931b5...c2623d2e203914840a5a9173b7e12aa77597d869,1,2,2,4,2,2015-02-20 00:27:20,2015-02-20 00:27:20
c2623d2e203914840a5a9173b7e12aa77597d869...00ac564423249c5be50e44d44ef822b4b686a931,2,6,3,9,3,2015-02-20 00:46:19,2015-02-20 00:46:19
00ac564423249c5be50e44d44ef822b4b686a931...6a6a33452288542aa93354f6ce5a7720721e0688,4,12,16,28,8,2015-02-20 01:24:34,2015-02-20 01:24:34
2df09c6415e1bdfc3d81cd3f8f2f15d7c970f415...b3198b61b96e0445cced0fc9a07b4fb991f12524,1,10,0,10,1,2014-12-24 10:45:03,2014-12-24 10:45:03
119b02877dbdd40d45727d2adc0a76579ae829ac...bc7656a306552c3308082ddf4695addac539ec6d,1,3,0,3,2,2014-07-02 14:38:03,2014-07-02 14:38:03
bc7656a306552c3308082ddf4695addac539ec6d...f50c7ecadcea18575df8a18526b0a78c5b0e1d87,1,0,2,2,2,2014-07-02 17:09:27,2014-07-02 17:09:27
f50c7ecadcea18575df8a18526b0a78c5b0e1d87...c3533deda1501accee8ba956539553e9af1f7e23,1,1,1,2,1,2014-07-03 08:26:47,2014-07-03 08:26:47
119b02877dbdd40d45727d2adc0a76579ae829ac...39f82b75f59ce8d0ce8159362f79b04ea478723b,3,18,4,22,5,2014-07-02 09:55:05,2014-07-02 09:55:05
39f82b75f59ce8d0ce8159362f79b04ea478723b...8a365f5d56db350965e2aa2f971197ed2fc96e45,1,2,2,4,2,2014-07-02 11:32:53,2014-07-02 11:32:53
8a365f5d56db350965e2aa2f971197ed2fc96e45...12f696c23e028f28ee29d5a3426ce28747f86cf1,1,1,2,3,2,2014-07-02 14:02:26,2014-07-02 14:02:26
a727d25eee91ac4a5ef4f6dc2ec63b073439758d...51d5e4cd6e109d2e0972f36b5f73d2af9966f827,2,53,48,101,23,2014-06-03 09:37:23,2014-05-29 12:13:01
51d5e4cd6e109d2e0972f36b5f73d2af9966f827...90c2e0d971b5c105224196b8509012f943c9ea9b,2,3,3,6,2,2014-06-03 09:37:23,2014-05-30 15:21:14
90c2e0d971b5c105224196b8509012f943c9ea9b...79f8abc51fa876e12de4150ab3ec489208aaed84,2,11,11,22,5,2014-06-03 09:37:23,2014-06-02 08:20:37
79f8abc51fa876e12de4150ab3ec489208aaed84...9abee4eac80852be502f1cc35cedae063d314e45,1,9,0,9,1,2014-06-03 09:37:23,2014-06-02 08:20:56
9abee4eac80852be502f1cc35cedae063d314e45...1dca950c2831bbe37c7d421ae2033aca4cfc4334,1,2,1,3,1,2014-06-03 09:37:23,2014-06-02 08:51:22
1dca950c2831bbe37c7d421ae2033aca4cfc4334...7bf64b2648f4d23ad6850641d52b06b1fc447b81,1,1,1,2,1,2014-06-03 09:37:23,2014-06-02 09:28:32
7bf64b2648f4d23ad6850641d52b06b1fc447b81...e18d5be55af9eab1cfeb7ebae90e3799fb4f7a53,1,0,4,4,1,2014-06-03 09:37:23,2014-06-02 09:35:39
e18d5be55af9eab1cfeb7ebae90e3799fb4f7a53...ecfd33c12f0d008d4b09b9dab486e3d0100239c3,1,130,0,130,1,2014-06-03 09:37:23,2014-06-02 12:13:35
ecfd33c12f0d008d4b09b9dab486e3d0100239c3...209726917b1231e02bf77f1f5ee71cbc95f94853,1,1,1,2,1,2014-06-03 09:37:23,2014-06-02 14:22:51
209726917b1231e02bf77f1f5ee71cbc95f94853...ef7cfdceea0355c0e9c434ec3fc2b9915979da5e,2,5,5,10,4,2014-06-03 09:39:29,2014-06-02 15:04:59
ef7cfdceea0355c0e9c434ec3fc2b9915979da5e...84dc9cd6926ea8bc4db533e658463b4e60f68e6b,1,1,1,2,1,2014-06-03 09:39:29,2014-06-03 10:06:13
84dc9cd6926ea8bc4db533e658463b4e60f68e6b...18b1f171bd0b9700e73c37c23150bea9fb251b3e,4,17,17,34,8,2014-06-04 06:37:19,2014-06-04 06:37:19
b6f3f62667c20085d7158d5902bf4e81bf7ec515...7984e5b1efd430ce1ea1486c647f4beaa1c13e46,1,2,1,3,1,2014-06-03 15:09:51,2014-06-03 15:09:51
b6f3f62667c20085d7158d5902bf4e81bf7ec515...f39db7e5ed2712244a3ddfd3b36e5a74a53a8cc8,1,1,1,2,1,2014-06-03 15:02:03,2014-06-03 15:02:03
b6f3f62667c20085d7158d5902bf4e81bf7ec515...f870507659e1ed169b9e9396dbd350c205c150e4,1,7,7,14,5,2014-06-03 14:36:53,2014-06-03 14:36:53
95d61a094d4d69fc332b40923ba08bbb57776f39...55ab7a2a958c99332f71d8b0e94ccae2b5b54c13,7,42,30,72,14,2014-06-03 11:49:50,2014-06-03 11:49:50
0c869ed75cb9d4255cf4e6c268ab5e884169aeb8...de1a7aa7eb523cf2fdad12f8eeda2ba4c5b51820,1,2,0,2,1,2014-06-03 19:46:54,2014-06-03 19:46:54
fc72f8e37ccb447131ee1492c147cef9add83581...62e523f4f4db67e3792980c4b56473f86c7c5e91,1,1,1,2,1,2014-06-03 15:22:29,2014-06-03 15:22:29
9e6466c78442075e0f8fb8fe317ffe53dfcb5a95...696b9903f08011e37811dc8b8ff4f7da77201d13,1,1,1,2,1,2014-05-23 06:47:58,2014-05-23 06:47:58
05bff8b6800494dace7456c6acec6cb80c1bc1b2...8bf7b62e8169fc1e2b9cf66edd9a66232f285270,1,5,0,5,1,2014-05-22 17:40:25,2014-05-22 17:40:25
961810a4427ed452a9557b3f4bbe5fa8a1f21229...6d45909f03f6cc32f72135ce7ca7b4fd62132c15,1,5,0,5,1,2014-05-15 07:57:21,2014-05-15 07:57:21
6d45909f03f6cc32f72135ce7ca7b4fd62132c15...34fd557055e027b6423241e73b7cf26c741c0b6b,2,19,12,31,2,2014-05-15 08:22:59,2014-05-15 08:17:13
34fd557055e027b6423241e73b7cf26c741c0b6b...02b85fd2366bc6c0d3194ab68e13eb6291733c26,2,10,0,10,2,2014-05-15 08:22:59,2014-05-15 08:03:26
02b85fd2366bc6c0d3194ab68e13eb6291733c26...2d8c310f11f6340e043da97dfc10f268a78c2d9e,1,1,0,1,1,2014-05-15 08:30:50,2014-05-15 08:30:50
2d8c310f11f6340e043da97dfc10f268a78c2d9e...223a8695be207aa1725d9ae3755e4d0396dfe9f0,1,1,0,1,1,2014-05-15 08:32:20,2014-05-15 08:32:20
961810a4427ed452a9557b3f4bbe5fa8a1f21229...b024c094d3b6a2d1f81e0314dbfcfb1e6303155d,1,1,0,1,1,2014-05-15 06:10:19,2014-05-15 06:01:00
0e8d2557d83b14f9f550aa4d122351d2ce591172...c4c2655c010b1095bb9c28337041d21cf3271dca,1,1,1,2,1,2014-05-14 13:02:42,2014-05-14 13:02:42
0e8d2557d83b14f9f550aa4d122351d2ce591172...fda0dff6d3bb20c6d05dee67d969354ae95244ea,1,2,0,2,1,2014-05-14 12:49:14,2014-05-14 12:49:14
23ae3911aa55f075e30da9da4e687e064e59a9fa...0f29ccffd2b9805545db63d8266bb8367de1e35c,2,4,6,10,3,2014-05-08 20:50:48,2014-05-08 20:49:27
993fc8485518e53b7b868b47a622455b01d741a1...cac61501fd5d21eb7e4d8e494c3ea9d7d4e35005,1,2,2,4,2,2014-05-03 09:03:34,2014-05-03 09:03:34
993fc8485518e53b7b868b47a622455b01d741a1...d210484205c51e12e63ea0ad20cd10b7ef3f7057,1,1,1,2,1,2014-05-02 22:14:58,2014-05-02 22:14:58
9939c04e1808703c801327000ea8f99f33d8e936...d47fb275ce85ce1a4b134cf7fe6d8e578d740518,1,4,6,10,8,2014-01-31 11:04:14,2014-01-31 11:04:14
d47fb275ce85ce1a4b134cf7fe6d8e578d740518...9e181d36ead37ace996c5ec8a25f7639bc308345,1,0,2,2,1,2014-01-31 11:09:10,2014-01-31 11:09:10
006df5dfa0df02eeae24b529bd6364b7372f2f78...6addb15b15f3d59469d7569271b6449a2a164b87,2,3,3,6,3,2014-02-03 07:45:42,2014-02-03 07:45:42
8bce9d7fedd4136e42396430c0e672507e459689...ea177b33b3dd8595b9788269a0c086fd181e9996,1,5,0,5,1,2014-08-13 15:06:23,2014-07-29 06:38:17
907548a0fbf3c048536c2012bdbdbd10b604c067...9549be5fe717af5877d46ec6f38be1f86c1eceb6,10,72,0,72,2,2014-06-25 13:23:10,2014-06-25 13:23:10
9549be5fe717af5877d46ec6f38be1f86c1eceb6...4d77d4e12e4722919e3b79094b257e9a50ef3543,1,1,1,2,1,2014-06-25 13:25:02,2014-06-25 13:25:02
907548a0fbf3c048536c2012bdbdbd10b604c067...674cbe1534442f2149a3b787a24b5db3cb581d55,8,20,12,32,10,2014-06-25 08:40:33,2014-06-25 08:40:33
ffa46e0225bad993f8999a33905dcff7a75327e0...255d6d8b215a6733f4b49229aded0152b4510891,1,18,18,36,5,2013-08-29 17:32:40,2013-08-29 17:32:40
ffa46e0225bad993f8999a33905dcff7a75327e0...b928d45d519f767e8206e1c2c0d1a8a84f23fe90,1,1,1,2,1,2013-08-29 16:34:37,2013-08-29 16:34:37
ffa46e0225bad993f8999a33905dcff7a75327e0...99eefcb54d0f467a96629ef63caaf3cceda18eb6,2,19,0,19,3,2013-08-29 16:12:22,2013-08-29 16:12:22
1de270c9e05658095711fd4cc1e8b2634fdf25cc...38cebe03bcd49895332401e5103925754ab7db85,1,9,1,10,2,2013-09-03 17:55:01,2013-09-03 17:55:01
c797493e00bf3adf32beb0c0b1cee9d19974485f...a389d77769f941aac666df232f223692d0e95971,1,1,1,2,1,2013-12-26 08:09:15,2013-12-26 08:09:15
a389d77769f941aac666df232f223692d0e95971...4cd7a56333138de7438b2b59788f8732222845d7,3,12,2,14,3,2013-12-26 08:20:36,2013-12-26 08:20:36
c797493e00bf3adf32beb0c0b1cee9d19974485f...aff37adb9ed1b721838c87c4227fca366428a438,2,2,0,2,2,2013-12-26 06:44:59,2013-12-26 06:44:59
c797493e00bf3adf32beb0c0b1cee9d19974485f...a443a1986250f21c69f368f914ee0d119371f2de,2,7,3,10,3,2013-12-25 19:29:40,2013-12-25 14:12:25
7bf0add0d173333b87f80ead081a4e2952a1688e...3df417b857c3bcf6257b5d9d42bb816f63fa9a28,2,3,3,6,3,2013-12-26 08:51:52,2013-12-26 08:51:52
5be424565ebe71b6c4d93adfecea9d7b057ae086...494dc8ca8b13471aa40c9e614c594fb6ccf810c0,1,1,1,2,1,2014-03-13 18:29:03,2014-03-13 18:29:03
5be424565ebe71b6c4d93adfecea9d7b057ae086...b4edf4f996d1bad2d893a404f5d1b8a08c3c3e0d,1,1,0,1,1,2014-03-13 11:04:33,2014-03-13 11:04:33
0aa389b4911221e0ec5730d5342a1c59f37a8015...775f686e0e6e126555910a32c5c400d24e90789e,1,1,1,2,1,2014-03-24 15:51:55,2014-03-24 15:51:55
0aa389b4911221e0ec5730d5342a1c59f37a8015...369bd858d880dfdcadc75a87970c25c9c4d82a4a,10,7,16,23,10,2014-03-24 14:17:43,2014-03-24 14:17:43
0aa389b4911221e0ec5730d5342a1c59f37a8015...f9a69ab1da1f311e11f56b29ffe295598a754fe5,1,1,0,1,1,2014-03-24 13:22:26,2014-03-24 13:22:26
0aa389b4911221e0ec5730d5342a1c59f37a8015...de5e41c67d1e0c2d4aa53fbe863a8b3f7e24f731,1,6,8,14,2,2014-03-24 12:35:24,2014-03-24 12:35:24
0aa389b4911221e0ec5730d5342a1c59f37a8015...00487d455a10e074a4539a231a9b3028853a7334,1,6,0,6,1,2014-03-24 11:04:43,2014-03-24 11:04:43
00487d455a10e074a4539a231a9b3028853a7334...842c0d6b5f7a60a4e4523fe1faefaab5038c96eb,1,1,1,2,1,2014-03-24 13:31:35,2014-03-24 13:31:35
0aa389b4911221e0ec5730d5342a1c59f37a8015...af3aaaddbd6d29e5e78f28ade1f18e65404227ab,3,7,9,16,8,2014-03-21 14:50:33,2014-03-21 14:50:33
af3aaaddbd6d29e5e78f28ade1f18e65404227ab...d03612412a575bb7bb05a2f51570b36493283b8a,1,4,1,5,1,2014-03-21 14:51:30,2014-03-21 14:51:30
0aa389b4911221e0ec5730d5342a1c59f37a8015...0bc88794684fe89af61360c6b88056dec18f1ecc,1,2,0,2,1,2014-03-20 14:32:30,2014-03-20 14:32:30
0aa389b4911221e0ec5730d5342a1c59f37a8015...2e33a820722b03645c755e1b710d1226a0f72f45,1,1,0,1,1,2014-03-19 16:10:22,2014-03-19 16:10:22
0aa389b4911221e0ec5730d5342a1c59f37a8015...7d36d71d97923aa3c73609a839c106cb03ee15fa,1,3,3,6,2,2014-03-19 11:46:18,2014-03-19 11:46:18
0aa389b4911221e0ec5730d5342a1c59f37a8015...257aa851d27076453b2dcfee2cc77a75f0e05acf,1,7,0,7,1,2014-03-18 15:24:49,2014-03-18 15:24:49
257aa851d27076453b2dcfee2cc77a75f0e05acf...d09f5796bff136c463edf45f621fab6cfeb660b6,1,8,3,11,3,2014-03-18 15:25:54,2014-03-18 15:25:54
0aa389b4911221e0ec5730d5342a1c59f37a8015...70994c348dede58b6ed8da84b02465e4665dc305,1,9,0,9,1,2014-03-17 13:55:56,2014-03-17 13:55:56
0aa389b4911221e0ec5730d5342a1c59f37a8015...67eb14d308bfb98d30e44f4e8efdcba60fe2786c,1,1,1,2,1,2014-03-17 13:36:20,2014-03-17 13:36:20
0aa389b4911221e0ec5730d5342a1c59f37a8015...509c45163a69b608a65f11e3383f565c13d643c4,5,9,20,29,10,2014-03-10 16:40:40,2014-03-10 16:40:40
f16de8ac8c67b5dcd251cc202b261f6f12e9f56e...dcda7516d6657e1372137e5549e3af4400e0ad5f,1,1,1,2,1,2014-03-11 10:18:14,2014-03-11 10:18:14
c4d4481f4c66797434dca6426393e770c9d5785e...8199ba05b824cf4e2885b19e1ff7c99279a07288,1,3,2,5,3,2014-03-07 08:43:14,2014-03-07 08:43:14
c4d4481f4c66797434dca6426393e770c9d5785e...9818775cad7eec3bdc11a958a876f5fff1f991fb,1,1,1,2,1,2014-03-07 03:07:02,2014-03-07 03:07:02
d2dc0385a22a1a16064557ad5d5b1b862dd1f948...1921a934a9373884133eb3859efa250794b0ea92,1,1,1,2,1,2014-03-19 12:42:13,2014-03-19 12:42:13
492dc82ced619206aeed7e3aaae393d85a4d3f40...0e31cb40d3998f8bad3e0a1e35985e28ef825e19,1,2,1,3,2,2014-03-19 13:01:13,2014-03-19 13:01:13
0e31cb40d3998f8bad3e0a1e35985e28ef825e19...622bbf9629d2f5f081fbad6bbd9f0e3b6f092be6,1,1,0,1,1,2014-03-19 13:07:42,2014-03-19 13:07:42
83e83b6617694c03457ca3a36230b54560ce6833...2767abd90d94b3fd0fedfad85015abbffd7e4cd9,1,6,0,6,1,2014-03-20 12:31:55,2014-03-20 12:23:07
83e83b6617694c03457ca3a36230b54560ce6833...3a294daf535a733054ed4d79a64ee64904bf5218,1,1,0,1,1,2014-03-20 09:04:41,2014-03-20 09:04:41
ad7cd8fb35869abc884a415fd16057d522a2fd8e...682cafdce627d5965a1f9e8d8053a2c6faf59219,1,1,1,2,1,2014-03-27 05:43:16,2014-03-27 05:43:16
ad7cd8fb35869abc884a415fd16057d522a2fd8e...83f811fff5f6b2188c82f187f747122d2f7cd936,4,147,71,218,11,2014-03-26 20:15:25,2014-03-21 04:05:46
ad7cd8fb35869abc884a415fd16057d522a2fd8e...4709364b7e1cfdb2bf5e0c51a7025a3154014d12,1,7,0,7,1,2014-03-26 19:54:39,2013-12-29 23:25:28
5fc3d746d22ffafb881187a7ce5280d973a1cad4...73a987ea6bedd569e24f37d323883a7dbeb3ae56,1,1,1,2,1,2014-03-25 17:40:44,2014-02-01 05:14:05
cce80d04fe0271709170222d3b5774c39203ea07...d89130b0974782824fb11d4e0cc0fd9b12fe7cab,2,159,0,159,2,2014-03-25 12:48:02,2014-03-25 12:48:02
d89130b0974782824fb11d4e0cc0fd9b12fe7cab...12d081008da393a4e2d2c931b7898875e565d8d5,1,13,0,13,1,2014-03-25 13:07:16,2014-03-25 13:07:16
12d081008da393a4e2d2c931b7898875e565d8d5...6cc4ac7b98b0fb2ba028644fd8dc4e2d89b65e2a,4,7,43,50,6,2014-03-25 13:07:54,2014-03-25 13:07:54
6cc4ac7b98b0fb2ba028644fd8dc4e2d89b65e2a...ba87b76de1177574e26ad09ca97c30fde76d7a45,5,19,24,43,8,2014-03-25 13:08:25,2014-03-25 13:08:25
ba87b76de1177574e26ad09ca97c30fde76d7a45...45e6abffb422045dd30c3f1c74dd14186a23741d,1,0,61,61,1,2014-03-25 13:09:17,2014-03-25 13:09:17
45e6abffb422045dd30c3f1c74dd14186a23741d...d4bfacc36524c79516435e34352e8dc15919a118,1,1,3,4,1,2014-03-25 13:16:12,2014-03-25 13:16:12
d4bfacc36524c79516435e34352e8dc15919a118...535339a6ab756b0bfb1164afb764acef6e1f46af,2,1,13,14,2,2014-03-25 14:25:59,2014-03-25 14:25:59
47c5a2ab22b0fbc9c20b996ec24c27608e99bc43...7202db072f802a7f003684b300995251dd518376,1,4,0,4,1,2015-02-27 10:26:47,2015-02-27 10:26:47
47c5a2ab22b0fbc9c20b996ec24c27608e99bc43...804a2488cfd6704726c0dc7e6b0facc7e2ff7ce3,2,29,0,29,2,2015-02-27 09:49:47,2015-02-27 09:47:37
1aa08c2d804e4d71b96d6d09a3dacb1fe6cf90d8...238455aa97c21cf4126994627725ba0196decf9c,1,4,2,6,2,2015-02-27 20:32:05,2015-02-27 20:32:05
7fef8456e8bc92adb0de3f2bc7192e3bedfce47d...51abeaa1bc93862a4d15506a590704f9fc56cfd6,7,55,9,64,13,2015-03-01 01:13:01,2015-02-28 17:07:53
7fef8456e8bc92adb0de3f2bc7192e3bedfce47d...449cf43a55a34553fae591db7d69d1505b4daa53,1,1,0,1,1,2015-02-26 17:03:34,2015-02-26 17:03:34
7fef8456e8bc92adb0de3f2bc7192e3bedfce47d...d3c44b1a6c470990cd79d2e4feec3d1d9b450496,5,5,5,10,5,2015-02-26 08:50:43,2015-02-25 09:59:50
a30a56634d3ea44ccfc69c037324b502456f9aba...4803af45dfbd516890b3ab31fa55b93009174d63,1,1,1,2,1,2015-02-25 21:55:37,2015-02-25 17:22:08
a30a56634d3ea44ccfc69c037324b502456f9aba...a672b4688309dc356922bd3f9c61b8ae9de018f8,1,9,3,12,3,2015-02-25 16:34:01,2015-02-25 16:34:01
a30a56634d3ea44ccfc69c037324b502456f9aba...183f521079873c0d0942f2ad72660822714d0b2a,1,3,3,6,2,2015-02-25 15:14:10,2015-02-25 15:14:10
a30a56634d3ea44ccfc69c037324b502456f9aba...607f0c05feb2cde82493a36ac43ba5ecd6c71620,2,7,4,11,5,2015-02-25 12:13:27,2015-02-20 16:43:28
607f0c05feb2cde82493a36ac43ba5ecd6c71620...6afb03ee96a2f0c36e69a6da4e10dbe298c5b79f,3,7,1,8,3,2015-02-25 12:13:46,2015-02-20 16:44:13
6afb03ee96a2f0c36e69a6da4e10dbe298c5b79f...7b34c9dc593c15ed60f397b1e43e34bab8702674,4,64,14,78,8,2015-02-25 12:40:05,2015-02-20 16:55:23
7b34c9dc593c15ed60f397b1e43e34bab8702674...0e7d1fd44f057c83c5384618f4599271f9fdd006,2,4,2,6,4,2015-02-25 13:05:03,2015-02-25 13:05:03
0e7d1fd44f057c83c5384618f4599271f9fdd006...e0c186c35735a2dc9e05e88ad9975ae016c815d9,7,51,10,61,16,2015-02-25 13:20:35,2015-02-25 13:05:45
e0c186c35735a2dc9e05e88ad9975ae016c815d9...85af3e82bfe0ebd01e816ee7c5ee6a2c28ce8ff9,7,60,42,102,15,2015-02-25 13:29:49,2015-02-25 13:29:49
85af3e82bfe0ebd01e816ee7c5ee6a2c28ce8ff9...ae70a80fc202822a485cabf78da9774d14055617,1,5,2,7,3,2015-02-25 13:32:55,2015-02-25 13:32:55
ae70a80fc202822a485cabf78da9774d14055617...769f137a5344dbc3748c2fea7c1d560392410ca4,2,5,1,6,2,2015-02-25 13:37:15,2015-02-25 13:37:15
769f137a5344dbc3748c2fea7c1d560392410ca4...5d86332153838252384f9f87a0ae3e34c46eb266,5,30,8,38,11,2015-02-25 14:12:19,2015-02-25 14:12:19
5d86332153838252384f9f87a0ae3e34c46eb266...969de4c15a876ab9096f163ef6182571ca199492,2,41,5,46,5,2015-02-25 14:51:13,2015-02-25 14:49:40
969de4c15a876ab9096f163ef6182571ca199492...f0b78a852933a54173bb9b4ceddba44b52dc3cfa,3,11,2,13,6,2015-02-25 15:40:48,2015-02-25 14:56:42
f0b78a852933a54173bb9b4ceddba44b52dc3cfa...4658e554b7129c44221a73fe8ec3b73b4b9b8b24,2,3,3,6,2,2015-02-25 17:14:29,2015-02-25 16:17:24
a30a56634d3ea44ccfc69c037324b502456f9aba...87da9185ff3b973afd0676ed375e7aa98a0fb233,2,32,0,32,3,2015-02-25 11:52:37,2015-02-25 11:22:05
a30a56634d3ea44ccfc69c037324b502456f9aba...9c6f0487950f1b510d7222885ed8591607b4fe9b,1,1,1,2,1,2015-02-25 10:18:15,2015-02-25 10:18:15
9c6f0487950f1b510d7222885ed8591607b4fe9b...00c631573f1f7564cfd8d823dce761fc6c76e2bc,1,1,1,2,1,2015-02-25 14:16:24,2015-02-25 14:16:24
a30a56634d3ea44ccfc69c037324b502456f9aba...9b8d5c4ab4e5dc544891f37fa6dd91134577e313,1,3,3,6,3,2015-02-25 10:01:50,2015-02-25 09:49:51
ebe0d34128c31bb88f6eb5aca96fae012c7fcf8b...19327e6535a69000f1cf89b1f92a3c19fc1d546e,1,1,1,2,1,2015-02-23 06:06:43,2015-02-23 06:06:43
19327e6535a69000f1cf89b1f92a3c19fc1d546e...9459e9db2470e9c50488811d1d0fcdd025a327d0,1,1,1,2,1,2015-02-23 06:26:09,2015-02-23 06:26:09
ebe0d34128c31bb88f6eb5aca96fae012c7fcf8b...b19b8c679a136234094443e2d4a345f136a0bcc1,4,18,2,20,6,2015-02-23 02:36:21,2015-02-23 01:31:12
b19b8c679a136234094443e2d4a345f136a0bcc1...d4bfdd34baa9eea2e89223b039f15cd4d4b3e5ae,1,3,3,6,2,2015-02-23 03:03:12,2015-02-23 03:03:12
ebe0d34128c31bb88f6eb5aca96fae012c7fcf8b...5f232b5687b447e7eac40f58c56628da22580de6,7,66,19,85,13,2015-02-22 23:01:49,2015-02-22 23:01:49
ebe0d34128c31bb88f6eb5aca96fae012c7fcf8b...31774a3bb739260622b31001cac778468d7dd92f,1,2,0,2,1,2015-02-22 20:49:00,2015-02-22 20:49:00
ebe0d34128c31bb88f6eb5aca96fae012c7fcf8b...2bf0a690bfd3985b9f8f0394a8a77d3b9dde44d1,1,1,1,2,1,2015-02-22 20:39:13,2015-02-22 20:39:13
b55a0519acb34a764b2a350010aa813fd35b361e...ccdf08d80a64590f6188a3e36d68625e506b331c,5,16,20,36,11,2015-01-07 00:24:47,2015-01-07 00:24:47
ccdf08d80a64590f6188a3e36d68625e506b331c...7eeec5e45a3f56ee6b05985962eb88d733b6beb2,1,0,1,1,1,2015-01-07 01:00:27,2015-01-07 01:00:27
7eeec5e45a3f56ee6b05985962eb88d733b6beb2...ee9849b7363c7bda9d81a73ca1f1351414607e3e,1,4,4,8,4,2015-01-07 02:05:10,2015-01-07 02:05:10
7afa4d5791bc9cf94eb3e33257d7f6f740c6bcf1...a5f1b67ed4d5c46d1c243260cbfe86733fee075e,2,8,0,8,2,2015-01-22 19:24:05,2015-01-22 19:24:05
7afa4d5791bc9cf94eb3e33257d7f6f740c6bcf1...7411fb36c5fc3b938e8b8228d217e645c9768a93,2,30,18,48,5,2015-01-22 19:15:21,2015-01-22 19:15:21
a224a655d812d60fa8be45e36922049b313ecb2f...452ba19cdd8e61fa568e2f6462c14b8f31c4c07b,1,2,5,7,3,2015-02-21 14:09:17,2015-02-21 09:58:11
409097bd7e0f5857cf0bc5462bd47484980ec787...16b73176694d248d4ee6f8c8525857169872e12e,2,5,5,10,5,2015-03-17 16:15:39,2015-03-17 16:15:39
409097bd7e0f5857cf0bc5462bd47484980ec787...b27622a16f04b92634c7de7765ef182f69f3c6a3,1,1,1,2,1,2015-03-17 15:34:17,2015-03-17 15:34:17
409097bd7e0f5857cf0bc5462bd47484980ec787...9c7fffb6559facdcf8bbda680795f70d836293bf,4,45,2,47,5,2015-03-17 13:55:43,2015-03-17 13:55:43
9c7fffb6559facdcf8bbda680795f70d836293bf...7d2b34bd61df9722ac2461e87ce595228eecef21,1,1,2,3,1,2015-03-17 15:00:32,2015-03-17 15:00:32
31bcd04711d448c016506897b8431273e3454faa...0a089661fd488bf71b7a426441204713200f57ed,2,2,2,4,2,2015-01-12 12:35:29,2015-01-12 12:35:29
31bcd04711d448c016506897b8431273e3454faa...8689ce1efef8438debeec2a3a6d669f4d5a435c4,4,31,4,35,6,2015-01-12 10:08:53,2015-01-12 10:08:53
8689ce1efef8438debeec2a3a6d669f4d5a435c4...ef0cf7b42dbdd7a017450ada45881134524e4997,1,1,1,2,1,2015-01-12 10:49:07,2015-01-12 10:49:07
31bcd04711d448c016506897b8431273e3454faa...319704451233f4abfbb0e4bcc9bb3e0a756f5eb1,8,115,78,193,11,2015-01-12 07:51:31,2015-01-12 07:51:31
319704451233f4abfbb0e4bcc9bb3e0a756f5eb1...4e7df0037a45f4d2b05ef1a582cb1bbef44afd10,1,3,3,6,3,2015-01-12 08:05:04,2015-01-12 08:05:04
4e7df0037a45f4d2b05ef1a582cb1bbef44afd10...bba8e59a044f34a02000b752a70198fb74236b1d,7,7,7,14,7,2015-01-12 17:08:25,2015-01-12 17:08:25
e683d054533f4faf9c1c778c8be729d76e435708...41f09bed82a7808e0e785d297567dc1411b41938,1,57,63,120,4,2015-01-15 23:19:04,2015-01-15 23:19:04
41f09bed82a7808e0e785d297567dc1411b41938...eb84ee7a20cb84d3657e1b341e792053eba94455,1,1,1,2,1,2015-01-15 23:19:58,2015-01-15 23:19:58
eb84ee7a20cb84d3657e1b341e792053eba94455...67b42e26cf955cf6dc240fd77935a47fbfac6694,1,1,1,2,1,2015-01-16 01:23:22,2015-01-16 01:23:22
01ab08125982b7c786818ffdd608e6169d0ff43d...3c5c1a7802c315c7b82ecd5e4eb8200663eb3463,2,2,1,3,2,2015-01-14 16:42:44,2015-01-14 16:42:44
01ab08125982b7c786818ffdd608e6169d0ff43d...e348af1d4c29f2aa7fb03a7910fd816850caab11,1,12,1,13,2,2015-01-14 08:03:25,2015-01-14 08:03:25
c7e0e4e8a48e83047ef903bd59147974b811635d...8ac16a6b321d7754c42badca11dcf36b2857b492,1,3,22,25,9,2015-01-13 22:47:27,2015-01-13 22:47:27
86a17390dd923351ed51b9b94d34460d7a5c8214...fcaf0a89e8f4be206b0378c32fd683e1cf15f804,1,1,1,2,1,2015-03-10 01:28:30,2015-03-10 01:28:30
86a17390dd923351ed51b9b94d34460d7a5c8214...9720240be264e12aebb3b2b3b0051e587de78414,11,12,25,37,20,2015-03-10 01:25:32,2015-03-10 01:25:32
9720240be264e12aebb3b2b3b0051e587de78414...3bce263a3d535927932a3ba174b6dfc2e41743a3,2,2,4,6,3,2015-03-10 01:45:36,2015-03-10 01:45:36
d086221f73e7ae124438006b645f1a262404cc93...e0caed91e2cd6b959f808139df7c40f3644f88fd,1,8,3,11,3,2015-03-10 07:51:16,2015-03-10 07:51:16
3f823068e1f6e3e88d6631de60d9aaf9ecd5e6f9...dd78cd1ce4699afb76ee430e7d82b852333805d8,6,56,9,65,9,2015-03-12 17:04:09,2015-03-12 17:04:09
3f823068e1f6e3e88d6631de60d9aaf9ecd5e6f9...0b38c3e04138984123592da78ad78c79fdeaec3d,3,12,14,26,5,2015-03-12 15:08:48,2015-03-12 15:08:48
3f823068e1f6e3e88d6631de60d9aaf9ecd5e6f9...3c7e0f45c2d9c242bf45d153bb73e96ce7525a06,6,108,6,114,12,2015-03-12 08:26:06,2015-03-04 11:58:40
5bbc70da9cb439342bdbe022988e4e734d891f44...f8c8d988e85bd62abbba3a0433e5a74c47b6245d,1,3,1,4,2,2015-03-18 01:13:20,2015-03-18 01:11:27
aad3cbeec52cf5bbb5a2c724eeb9b946be6f0fe9...bacb05c554dfa8781c53c1db7a4f9a706e33fd50,3,5,2,7,5,2015-03-16 06:50:55,2015-03-16 06:50:55
19e0dafbef47ca04f19d38b72b817beeb09e8510...d7f357a386162f645ba5a8550dfa1d3b22d0ff2c,2,6,0,6,2,2015-03-14 18:30:36,2015-03-14 18:20:40
cba6d797d756e6cc3cf976610d5d21f55e6460b5...8eebb6e56601738027d8c5e65c9c3bd77911e3a8,1,0,2,2,1,2015-03-16 20:13:02,2015-03-16 20:13:02
cba6d797d756e6cc3cf976610d5d21f55e6460b5...7c3c836d3b62c72d1adf5431c0fedc91d92a8907,1,1,1,2,1,2015-03-16 19:29:27,2015-03-16 19:29:27
7c3c836d3b62c72d1adf5431c0fedc91d92a8907...2e672c39a09577a0a16e75a10a249c923d8ee863,2,8,4,12,2,2015-03-16 19:59:50,2015-03-16 19:59:50
cba6d797d756e6cc3cf976610d5d21f55e6460b5...9269606c94853c8cc0f9c850582dae09d809cdab,1,4,1,5,2,2015-03-16 19:09:53,2015-03-16 19:09:53
f79f75858173420c93921926737b40d68b72e19f...8eb365c0a04b912d2e10eb16adeeb4216563be2c,1,7,6,13,2,2015-01-28 06:54:46,2015-01-28 06:54:46
6290b75da9540723a06aaffcf8cdf9fdd963a10f...e0e6574ff7ae42e50afcf11bde4889f1e849ff48,1,52,22,74,6,2015-01-28 07:07:27,2015-01-28 07:07:27
6290b75da9540723a06aaffcf8cdf9fdd963a10f...bf44938cc0b9c3023dd486fc23e7ddbf6be8b573,5,17,17,34,17,2015-01-28 06:50:31,2015-01-28 06:50:31
6a6a33452288542aa93354f6ce5a7720721e0688...ee6c4a2cca65d56c01156950d62dfb2f01839cb9,4,28,11,39,10,2015-02-20 02:23:10,2015-02-20 02:23:10
ee6c4a2cca65d56c01156950d62dfb2f01839cb9...906f8efd29ad7d4abb95e8e3507d5a6aa700d653,3,212,223,435,16,2015-02-20 04:45:21,2015-02-20 04:45:21
906f8efd29ad7d4abb95e8e3507d5a6aa700d653...692aa78380c4c494ab2367516d68c862f35d7c76,5,115,103,218,10,2015-02-20 05:55:47,2015-02-20 05:55:47
d986aea3f085daafc52f4a8d8de8618eeaf01df4...0d861c9935485c9d26ebb98b00cc9b8411889108,1,1,1,2,1,2014-06-04 07:57:14,2014-06-04 07:43:53
729618c50fbe44d6c4bdcbdd6d15e3eaec2067a4...fe302d4cb6146b27f4d93b7b9924bcd8130b0aab,1,4,4,8,2,2014-06-03 12:47:57,2014-06-03 12:47:57
d7960bca8d2dbc67d369e70fee468364c4850481...5b87a4dc517eccb0e100ce751bf631bc0ee01100,1,0,8,8,4,2014-06-03 13:22:52,2014-06-03 13:22:46
d7960bca8d2dbc67d369e70fee468364c4850481...754b0838e0c2857b0ca73d2ced675ed5b3042242,2,2,1,3,2,2014-06-03 13:17:08,2014-06-03 13:17:08
754b0838e0c2857b0ca73d2ced675ed5b3042242...f758438ed5de9e8ccf2d91131626610787470b00,2,1,2,3,2,2014-06-03 13:44:46,2014-06-03 13:44:46
f758438ed5de9e8ccf2d91131626610787470b00...fdcc5ddec1e599289e09aeef0c5fbc276abcc05c,2,2,0,2,2,2014-06-03 15:06:27,2014-06-03 15:06:27
de1a7aa7eb523cf2fdad12f8eeda2ba4c5b51820...fd348de76d651d49acc8eb742cc647dc777ef5fc,88,1352,1414,2766,820,2014-06-03 21:16:31,2014-04-24 22:48:22
476cd0f7638df222fec3487a2d5fbc6129139bdc...123dea35b53cf1f6ac55359516bc4ca33fa402fc,1,10,8,18,1,2014-06-10 14:34:29,2014-04-15 19:40:18
123dea35b53cf1f6ac55359516bc4ca33fa402fc...9b346202bc09d808064fa5b9647be4e43cfd488b,1,6,3,9,2,2014-06-10 14:34:29,2014-06-10 14:30:07
476cd0f7638df222fec3487a2d5fbc6129139bdc...c8e6752414010fadeb4516a3d860719666ac7212,1,2,2,4,2,2014-06-10 12:23:35,2014-05-08 12:55:43
476cd0f7638df222fec3487a2d5fbc6129139bdc...20b2102771c5657874b557a867aadbe4c6772892,3,15,4,19,5,2014-06-10 12:10:53,2014-06-10 06:50:27
68942dbb3dcbb41f7d03137f94868d1b662dfd4b...7f84ba8662384cebf5574cbd2da5841aab2eac90,1,4,0,4,1,2014-05-23 12:31:09,2014-05-23 12:31:09
696b9903f08011e37811dc8b8ff4f7da77201d13...6a85cdf1627629ecaa762fa60a7abdbd092cc20a,30,363,46,409,51,2014-05-23 08:22:42,2014-05-23 08:22:00
4e1f9e2b8b14eeaabc8f2a779acc8c9d94f538f5...1057251150159c2db656e5345a3278027bad9840,2,16,4,20,6,2014-07-02 03:57:30,2014-07-02 03:37:20
4e1f9e2b8b14eeaabc8f2a779acc8c9d94f538f5...c1b7e904ff0b744b54bc31a828abb7409232fedf,2,3,0,3,2,2014-07-01 19:54:19,2014-07-01 19:54:19
4e1f9e2b8b14eeaabc8f2a779acc8c9d94f538f5...0b55b4768f3e46fc38087093bfaa0af001575c33,1,0,1,1,1,2014-07-01 17:24:40,2014-07-01 17:24:40
4e1f9e2b8b14eeaabc8f2a779acc8c9d94f538f5...6b101abaef25dce40f3d7c8f58e00924d7a7f7bb,1,0,4,4,4,2014-07-01 16:27:50,2014-07-01 16:27:50
cb58e1cbd74a76c2e25f56e8df1f1f494d14128a...dbd88d453b8e6c78a423fa7e692004b1db6ea069,4,11,11,22,9,2014-05-16 10:57:32,2014-05-16 10:57:32
cb58e1cbd74a76c2e25f56e8df1f1f494d14128a...52bd8d40667f6755828fdcc486dafbf34eb88627,2,40,15,55,10,2014-05-16 10:47:34,2014-05-16 10:47:34
cb58e1cbd74a76c2e25f56e8df1f1f494d14128a...85cecc0b2ef25ef4e4dc56583b0e202400168abb,3,15,1,16,3,2014-05-16 10:28:35,2014-05-16 10:28:35
cb58e1cbd74a76c2e25f56e8df1f1f494d14128a...821ab16846f2bc9433ec4429191a57f030887ca5,1,1,0,1,1,2014-05-16 09:29:12,2014-05-16 09:29:12
cb58e1cbd74a76c2e25f56e8df1f1f494d14128a...474ae8a6877744108e256e5aacfffb815ce56583,1,0,3,3,1,2014-05-16 08:04:10,2014-05-16 08:04:10
474ae8a6877744108e256e5aacfffb815ce56583...00a482511c20dc427b10629e8a1c993472dae2b6,1,4,0,4,1,2014-05-16 08:10:31,2014-05-16 08:10:31
cb58e1cbd74a76c2e25f56e8df1f1f494d14128a...36a5bbcc8f37b7980a440a9e79ddf9717f23760a,1,1,1,2,1,2014-05-16 05:42:58,2014-05-16 05:42:58
b8115e76a4ba8b2ac6ec79c43217d4ecff1e44bb...3b34084bdeadecdceb0a86e2820dd7c5985099f6,1,4,4,8,4,2014-05-09 06:46:23,2014-05-09 06:46:23
9e181d36ead37ace996c5ec8a25f7639bc308345...468c9ce4648462dee9eaf9001d23b925386a4531,1,9,1,10,2,2014-01-31 16:34:09,2014-01-31 16:06:13
468c9ce4648462dee9eaf9001d23b925386a4531...72d25a26bd6383a530f9da6bd01f994a5825237b,2,33,0,33,2,2014-02-01 16:47:54,2014-02-01 16:47:54
72d25a26bd6383a530f9da6bd01f994a5825237b...d40a7de170e57ec72eb362b4e015e19fd35780d3,2,29,1,30,3,2014-02-01 23:59:48,2014-02-01 23:59:48
d40a7de170e57ec72eb362b4e015e19fd35780d3...75cecf36e0d60bd4ca1dce0997745268b49eaee5,2,71,0,71,2,2014-02-02 15:32:12,2014-02-02 15:32:12
75cecf36e0d60bd4ca1dce0997745268b49eaee5...70fb26a6b7091aee9875970f070a6801e35de764,2,45,51,96,24,2014-02-03 12:59:20,2014-02-03 12:59:20
70fb26a6b7091aee9875970f070a6801e35de764...4b0fb02816e91eac09ce84c2383b0275b35aef97,1,20,14,34,7,2014-02-03 15:02:44,2014-02-03 15:02:44
4b0fb02816e91eac09ce84c2383b0275b35aef97...6a87daed765ddfbaa30ac942de8ccf55cc3a64a4,1,1,0,1,1,2014-02-03 16:56:31,2014-02-03 16:56:31
9e181d36ead37ace996c5ec8a25f7639bc308345...f416b2f5cf228981be5b1c9518fa7312069e0ae1,3,27,4,31,5,2014-01-31 11:24:38,2014-01-31 11:24:38
6addb15b15f3d59469d7569271b6449a2a164b87...5ec0955919326fb6f5a4e46875f0f2143d246a1c,2,14,6,20,5,2014-02-03 16:12:51,2014-02-03 16:12:51
5ec0955919326fb6f5a4e46875f0f2143d246a1c...ca7e4a948b7826bf17707996e30ad191ff3f2d58,6,57,51,108,12,2014-02-03 16:13:24,2014-02-03 16:13:24
ca7e4a948b7826bf17707996e30ad191ff3f2d58...5d871f1884f269d916d8f73a55d08a47db0f25d4,2,3,3,6,2,2014-02-03 17:53:54,2014-02-03 17:53:54
5d871f1884f269d916d8f73a55d08a47db0f25d4...bacfad1c651d7b880a07f5f417ccb64693150935,2,3,3,6,2,2014-02-04 12:45:04,2014-02-04 12:45:04
bacfad1c651d7b880a07f5f417ccb64693150935...97a4d8aea46fb45894f6e47597320ed2f6a12495,6,43,15,58,12,2014-02-04 12:46:15,2014-02-04 12:46:15
6addb15b15f3d59469d7569271b6449a2a164b87...7085892e470f02363d8b2c305adb3968be7177a2,2,1,47,48,2,2014-02-03 10:25:47,2014-02-03 10:24:42
2653ca6ee159c47e48c650a8917c246acac492b8...d8b769ec740f9e6d47c3885d99796e4ca9337cbc,2,5,1,6,2,2014-08-13 16:36:00,2014-08-13 16:35:49
79ee94eccbda6f8f8499df8a65ce8b588ea6defa...d45b627abf164540466bcb8a542d407b19cff8d8,1,0,29,29,1,2014-06-25 10:31:34,2014-06-25 10:31:34
79ee94eccbda6f8f8499df8a65ce8b588ea6defa...313e4966658dfa1b48315ee21c31eb3662c1739f,1,38,6,44,6,2014-06-25 09:27:19,2014-06-25 09:22:54
79ee94eccbda6f8f8499df8a65ce8b588ea6defa...af7e77984c72da8b240f5d7079ca1d30847843f6,4,36,0,36,6,2014-06-25 09:07:06,2014-06-25 09:07:06
3f8e6cf3d1360ce0843e4fd8f9c04040aba2baae...b1c40e81510ccccc5e93a82d2f5b819d6dea69e5,5,32,6,38,11,2014-06-26 11:31:34,2014-06-26 07:53:01
3f8e6cf3d1360ce0843e4fd8f9c04040aba2baae...340ed1dd2ea82f8cd64cbd52fb7d8c73a8a3ac22,1,2,7,9,7,2014-06-26 07:42:43,2014-06-26 07:42:43
340ed1dd2ea82f8cd64cbd52fb7d8c73a8a3ac22...a34dabd85c9cb64b92b22cd9cb91864387e408d4,1,9,13,22,7,2014-06-26 07:49:00,2014-06-26 07:49:00
3f8e6cf3d1360ce0843e4fd8f9c04040aba2baae...ba7b4630a22df2b1e12d4420b1fdacb4c582d48c,10,10,14,24,10,2014-06-26 07:39:35,2014-06-26 07:39:35
ba7b4630a22df2b1e12d4420b1fdacb4c582d48c...3a4b6b39301bd4651fb0c1584583ae4e813bc611,1,3,3,6,3,2014-06-26 09:03:32,2014-06-26 09:03:32
3a4b6b39301bd4651fb0c1584583ae4e813bc611...1e3c9eb4505bc271bf0b153cb80cd906e43355c4,1,1,1,2,1,2014-06-26 09:05:06,2014-06-26 09:05:06
3f8e6cf3d1360ce0843e4fd8f9c04040aba2baae...3900eee30e709880b8e32eda3edbfd3bcd42942d,1,1,1,2,1,2014-06-26 07:29:39,2014-06-26 07:29:39
8315f363e40a2f26e9d0b9fbdabe7d5c0603bf65...bae719df664714c20c0157944337a9857bd2d91f,1,1,0,1,1,2013-08-29 19:23:19,2013-08-29 19:23:19
8315f363e40a2f26e9d0b9fbdabe7d5c0603bf65...3d41e182c2051d539006107df9ece42b947100c2,1,1,1,2,1,2013-08-29 18:11:01,2013-08-29 18:11:01
3d41e182c2051d539006107df9ece42b947100c2...07f156f5c2c6776079f0210f4067121d1b74048d,1,2,2,4,1,2013-08-29 18:44:45,2013-08-29 18:44:45
07f156f5c2c6776079f0210f4067121d1b74048d...b32088414941fefd85172614ba6d615db2f07961,5,48,25,73,7,2013-08-29 18:45:19,2013-08-29 18:45:19
b32088414941fefd85172614ba6d615db2f07961...25a723c3ae04c5818427682b2fbe97609a97f1ea,1,1,1,2,1,2013-08-29 18:49:13,2013-08-29 18:49:13
fd6fc422c6bc8eecfd12a4b15ce06d61e7ee3a25...05de390fd872b8aae48cd0f53b5edd308a18e51d,3,15,3,18,4,2013-12-26 11:31:02,2013-12-26 11:31:02
8310b4589d0216cf7bb12eeee97785c3372690d9...6a0c0f3f3fc114a8b02e2d3f44539cf36534061c,4,44,15,59,6,2013-12-26 09:16:30,2013-12-26 09:16:30
6a0c0f3f3fc114a8b02e2d3f44539cf36534061c...7458437ed970b610defc2ab3042ea1494b06e822,2,6,3,9,4,2013-12-26 09:24:43,2013-12-26 09:24:43
a13190bca59aaffb6ecf79c0c123d35bbfd2279b...6bb474a0dc7a01108e9d2345da1c5a6e70d8aed0,1,1,1,2,1,2014-03-21 16:27:13,2014-03-21 16:22:12
c0090a3ff50802d796ec36f49ade1bb4fdd4d190...fefab474569f231676a4fd1579a70723d729f206,3,12,1,13,4,2014-03-20 15:09:14,2014-03-19 13:32:38
c0090a3ff50802d796ec36f49ade1bb4fdd4d190...dd7efd1768f7f61dfa8c47200fc95bac831c9ff5,1,24,0,24,3,2014-03-20 13:44:55,2014-03-13 14:20:31
dd7efd1768f7f61dfa8c47200fc95bac831c9ff5...cc83c696c0f453c48811263b08505dba77b34315,1,1,1,2,1,2014-03-20 13:47:06,2014-03-20 13:47:06
c0090a3ff50802d796ec36f49ade1bb4fdd4d190...817f5ff6a3da3bcb494109bffbd9eca2fedc20b0,2,6,3,9,6,2014-03-20 12:33:16,2014-03-20 10:56:52
817f5ff6a3da3bcb494109bffbd9eca2fedc20b0...5f595be4b80ae57c92d01dc1c0026566f80e67d4,4,3,6,9,4,2014-03-20 12:33:16,2014-03-20 12:30:27
5f595be4b80ae57c92d01dc1c0026566f80e67d4...4dc09e5c1dbed7aa40209499e4d0889936bc72a1,1,4,2,6,2,2014-03-20 12:33:16,2014-03-20 12:31:43
4dc09e5c1dbed7aa40209499e4d0889936bc72a1...9afd04842f6658dcd1dc02cda17247c321ff6a67,3,4,3,7,4,2014-03-20 12:46:31,2014-03-20 12:46:31
c3f088d2610b83d06091aa9fdbbb8e0cc3ea8ca3...5d6d795d60050c2c5db95501b6de38e458fd41b6,2,2,1,3,2,2014-03-11 02:56:26,2014-03-10 03:28:49
c3f088d2610b83d06091aa9fdbbb8e0cc3ea8ca3...29db8efaa4666ea479d927593540ee6f27dddf54,2,3,0,3,3,2014-03-09 05:01:06,2014-03-09 04:58:56
29db8efaa4666ea479d927593540ee6f27dddf54...a37c67940092d6d5ca82a12be76d4264034ccc6d,1,1,1,2,1,2014-03-09 05:01:06,2014-03-09 04:59:43
a37c67940092d6d5ca82a12be76d4264034ccc6d...74d2085cdfab5c929ca68f37375af6d3d3345bba,2,40,3,43,4,2014-03-09 05:01:06,2014-03-09 05:00:43
74d2085cdfab5c929ca68f37375af6d3d3345bba...efd860d1da9df2a6e35e5f7f280eebd13a9f70a1,1,1,1,2,1,2014-03-10 07:44:49,2014-03-10 07:44:49
c3f088d2610b83d06091aa9fdbbb8e0cc3ea8ca3...1c46a0d471d167d11082e883c75a82272205d55b,1,1,1,2,1,2014-03-08 19:33:28,2014-03-08 19:33:28
c3f088d2610b83d06091aa9fdbbb8e0cc3ea8ca3...c5f76e5939f90b89d7c5072b9dda9371ec1f7cc4,1,1,1,2,1,2014-03-08 02:39:48,2014-03-08 02:35:45
c3f088d2610b83d06091aa9fdbbb8e0cc3ea8ca3...30f8713aa1e35abdd33a90c0a8e691a9b6befbf4,1,4,4,8,3,2014-03-08 02:05:56,2014-03-08 02:05:56
c3f088d2610b83d06091aa9fdbbb8e0cc3ea8ca3...498a4e6b0c8b7cc9266f71dd3337669a9442934d,1,7,0,7,2,2014-03-08 00:57:05,2014-03-08 00:57:05
c3f088d2610b83d06091aa9fdbbb8e0cc3ea8ca3...339fce559a436998b1cfad4c5380a39a69f6582d,2,9,11,20,7,2014-03-07 15:35:59,2014-03-07 15:35:59
a74194a550d8f1f118d742ddb913a202ba47afe8...e013be10d7185dcdc814c11a65537ecd903e404d,2,3,1,4,2,2014-03-20 11:37:35,2014-03-20 11:37:35
d4aab6528cb80b0f41bdac2240dd9cc32543481d...9e4d3f328f00459447e087677a1684e54faa47c8,2,2,2,4,2,2015-02-27 21:49:40,2015-02-27 21:49:40
039fd3c5620823d2eab340e6c033954cdbd982eb...dd37a10df44bd1771aa8b163fd857628d03842d9,2,50,41,91,15,2015-03-02 16:52:48,2015-02-23 22:14:57
dd37a10df44bd1771aa8b163fd857628d03842d9...0e11be40c39df66859ae0f3dc265cd903820c153,1,146,0,146,1,2015-03-03 09:49:28,2015-02-24 15:05:39
039fd3c5620823d2eab340e6c033954cdbd982eb...ff696856079c984332de167219f2768415e6730f,1,1,0,1,1,2015-02-28 16:02:57,2015-02-27 10:26:47
f980827ba65c1237fca74ccb4452b78785d2ce1b...4efe3cf5569045c3f115777a448c042ed3ba1d22,1,5,0,5,1,2015-02-26 17:25:59,2015-02-26 17:25:59
d66148ef393f1748c669c934eec4e928d92ef36a...7ff9c8229d8df09be5927086222aad0cd5d71477,7,102,2,104,7,2015-03-12 18:13:51,2015-01-08 17:15:50
9459e9db2470e9c50488811d1d0fcdd025a327d0...d723bf78b8f86ee19db47725de8d22e8b6d5d6e2,1,1,0,1,1,2015-02-23 18:05:18,2015-02-23 18:05:18
9459e9db2470e9c50488811d1d0fcdd025a327d0...48eeb006f08a1bdea9cd8ad4dc49819a8daccf51,1,1,1,2,1,2015-02-23 14:10:56,2015-02-23 14:10:56
9459e9db2470e9c50488811d1d0fcdd025a327d0...e23110e6f158608c75e4c661fd57a4bb9c96334a,1,2,2,4,2,2015-02-23 14:08:46,2015-02-23 14:08:46
a4118ca445871c04625edee6463cffd838772b13...64ca07c3b95c6b1e9444d9139858b11a6097c1ca,1,3,3,6,3,2015-02-24 05:27:41,2015-02-24 05:27:41
a4118ca445871c04625edee6463cffd838772b13...c9829146f88ff87460add83a3719db3e2593f278,3,7,2,9,4,2015-02-24 04:04:18,2015-02-23 21:21:49
a4118ca445871c04625edee6463cffd838772b13...897a2de54c1d5cbead4589d44a3d173c14849f23,1,9,0,9,2,2015-02-24 03:35:42,2015-02-24 03:35:42
a4118ca445871c04625edee6463cffd838772b13...12589d339070d86b57a4f97778a48b1b9cc5a0a1,3,5,9,14,4,2015-02-24 02:43:39,2015-02-24 02:43:39
a4118ca445871c04625edee6463cffd838772b13...b0dfe434c60da7d04ddf23f7a3e85af97d377568,4,89,16,105,8,2015-02-24 02:43:26,2015-02-23 20:38:30
a5f1b67ed4d5c46d1c243260cbfe86733fee075e...3395457acbc8ec898edae622eedc20c8fcd6b8fa,1,2,1,3,2,2015-01-22 20:08:47,2015-01-22 20:08:47
a5f1b67ed4d5c46d1c243260cbfe86733fee075e...130663e7ad099f057c19df9a024e029e182501d8,2,31,4,35,3,2015-01-22 19:48:20,2015-01-22 19:48:20
829d72d30ab5e39cb5e5664c4afd9c36b1786cb5...71e146999c405ab301cd3c3e3aa03b89d46c461e,1,13,12,25,1,2015-02-21 19:14:17,2015-02-21 19:13:24
e4ac6bbf82dd9bf1a1a8f9e7c5dbe0b577c147ce...df91781a346e6b70c43195f2f4f550b097ac9d2e,1,1,3,4,2,2015-03-17 09:09:49,2015-03-17 09:09:49
1c6a1253899219b84cc9cb8b090a3bfbbd19605e...f07b165ab7b0834eadbe05da81fc167dcc23d59d,3,122,0,122,3,2015-01-13 03:29:06,2015-01-12 23:30:34
1c6a1253899219b84cc9cb8b090a3bfbbd19605e...058f223b01c87fc45825c2459d36371166abfc27,1,1,1,2,1,2015-01-12 17:30:52,2015-01-12 17:30:52
67b42e26cf955cf6dc240fd77935a47fbfac6694...9c0d241e27044ab326d3fcce84b10c5f9db09044,1,2,2,4,2,2015-01-16 16:47:58,2015-01-16 16:47:58
9c0d241e27044ab326d3fcce84b10c5f9db09044...5e0497758276660989cda53f86346954b53a17ad,1,1,1,2,1,2015-01-16 16:49:07,2015-01-16 16:49:07
67b42e26cf955cf6dc240fd77935a47fbfac6694...4dfa1ed269fb5a483d37eeffc8009f85f13d1e0f,4,34,19,53,6,2015-01-16 07:24:30,2015-01-16 07:24:30
4dfa1ed269fb5a483d37eeffc8009f85f13d1e0f...33f27fcb6a28bb69727427e1c9ff3c8804466f60,2,2,12,14,4,2015-01-16 07:34:30,2015-01-16 07:34:30
33f27fcb6a28bb69727427e1c9ff3c8804466f60...03a669d81d632354cff9bfa56928209623a1e503,1,8,12,20,4,2015-01-16 08:09:25,2015-01-16 08:09:25
3bf9b6604b577931a9bceaa23032bb6675b999e8...55947addc35fcf21f80c8c3e9a7a9840ba1193c0,2,6,10,16,4,2015-01-14 17:56:33,2015-01-14 17:56:33
55947addc35fcf21f80c8c3e9a7a9840ba1193c0...ff7f4a134e4d62a22a38409b7f71c582d86f53d8,2,0,29,29,2,2015-01-14 17:57:38,2015-01-14 17:57:38
fcaf0a89e8f4be206b0378c32fd683e1cf15f804...de629b4835f3ac6feac6bd567cee3ec79eb2b7d0,6,9,22,31,8,2015-03-10 02:02:30,2015-03-10 02:02:30
f6113c2818ce8c6741ac7cdfee627c5d3b969a8e...21c99e6a7797edb6a857e90c83fee3e5f1051adc,1,1,0,1,1,2015-03-10 02:21:42,2015-03-10 02:21:42
e0caed91e2cd6b959f808139df7c40f3644f88fd...f5e42f602f8a4eb85a7087bc0f407f9510df0ea8,3,329,16,345,6,2015-03-10 16:13:02,2015-03-10 13:50:42
e0caed91e2cd6b959f808139df7c40f3644f88fd...76842aac754e2355c34e751002fcbb1e8187e344,1,6,6,12,4,2015-03-10 13:14:49,2015-03-10 13:06:15
e0caed91e2cd6b959f808139df7c40f3644f88fd...383c56efa1882d9cab956de5b5b72e51691c3f0c,21,73,78,151,53,2015-03-10 12:39:31,2015-03-10 10:51:36
e0caed91e2cd6b959f808139df7c40f3644f88fd...ca9aca927970ec81387d7cd0d7372a11d03074de,3,11,1,12,4,2015-03-10 12:32:28,2015-03-10 12:32:28
ca9aca927970ec81387d7cd0d7372a11d03074de...11e966d7a93ec0a745cde65021fa79a6a6b24667,1,1,0,1,1,2015-03-11 16:43:40,2015-03-11 16:43:40
e0caed91e2cd6b959f808139df7c40f3644f88fd...ed4c7190ed47f0311ba5f5a140b2c71a694b05db,3,21,14,35,9,2015-03-10 10:23:11,2015-03-06 14:39:20
ed4c7190ed47f0311ba5f5a140b2c71a694b05db...02ed61c4db6fd6c20e3a23e525ccc3aef174a874,2,23,2,25,2,2015-03-10 18:09:34,2015-03-06 19:09:14
e0caed91e2cd6b959f808139df7c40f3644f88fd...6653cd7312fb4d88cc77af0d29d588c329d66cca,1,9,0,9,1,2015-03-10 10:20:57,2015-03-10 10:20:57
e0caed91e2cd6b959f808139df7c40f3644f88fd...b7a31a4b024e2c5f607003f1c42e2cd46adb2ff4,3,3,1,4,3,2015-03-10 09:07:25,2014-09-03 20:28:04
52acd2b45c3676bae3cb9a1c008e4deada3ca840...0e70fbe3338ad18e6d08fe1c5d487582f48642d4,1,1,1,2,2,2015-03-18 02:01:36,2015-03-18 02:01:36
0e70fbe3338ad18e6d08fe1c5d487582f48642d4...066fb568e7b8ee7d04e934a82171fece48768034,1,22,4,26,2,2015-03-18 02:06:43,2015-03-18 02:06:43
bacb05c554dfa8781c53c1db7a4f9a706e33fd50...055457360c6316e9a10dfc8ee18ef8c87655d8ad,3,56,1,57,3,2015-03-16 16:33:18,2015-03-16 15:09:31
bacb05c554dfa8781c53c1db7a4f9a706e33fd50...67f55d9b25b079f2123284b73a525013286ea588,3,32,10,42,4,2015-03-16 15:28:20,2015-03-12 10:30:46
aea75cfb0ac7b373bacdee17ee9e8c1314c3b676...8587a2937020eca2fda3efbcf31862697e7f5b3f,3,48,7,55,9,2015-03-15 19:14:30,2015-03-15 18:54:36
8eebb6e56601738027d8c5e65c9c3bd77911e3a8...5c9a924fe7172f62ed359277e467c8570bda718c,1,1,1,2,1,2015-03-16 20:45:27,2015-03-16 20:45:27
5c9a924fe7172f62ed359277e467c8570bda718c...b70e5c57c31d4cc0970c01921322d647d01e3a8b,2,121,1,122,2,2015-03-16 20:47:21,2015-03-16 20:47:21
0af2a161fa55a4abd7f8248b25a7361b209ecc4a...47e061466968dac72ba488eee0d3c44f568b11ab,2,5,5,10,5,2015-01-20 11:19:16,2015-01-19 23:22:40
0af2a161fa55a4abd7f8248b25a7361b209ecc4a...b21a2d821a4e16aba1609dfa1e01ba455e8ccd8f,6,99,14,113,8,2015-01-20 09:45:48,2014-09-17 17:08:35
8eb365c0a04b912d2e10eb16adeeb4216563be2c...792ced2f4190226c3335967a8e5a30d3b72bd4ae,16,372,8,380,25,2015-01-29 00:25:26,2015-01-28 21:18:22
8eb365c0a04b912d2e10eb16adeeb4216563be2c...965cec68accf9e9c2137e433ab00283f2ae6987f,2,11,2,13,2,2015-01-28 18:53:28,2015-01-28 18:53:28
965cec68accf9e9c2137e433ab00283f2ae6987f...b40809d73135ada0e82c826f96e6cb1dd6fbaa7c,2,10,2,12,3,2015-01-28 19:25:13,2015-01-28 19:25:13
b40809d73135ada0e82c826f96e6cb1dd6fbaa7c...34b7472b33986db8894939b59116784f706d4759,1,2,1,3,1,2015-01-28 22:20:00,2015-01-28 22:20:00
34b7472b33986db8894939b59116784f706d4759...b076d8cddb37ea7ae24cd035967cba885cdc429d,1,3,1,4,1,2015-01-28 23:36:12,2015-01-28 23:36:12
b076d8cddb37ea7ae24cd035967cba885cdc429d...f2f7b5a18e91005deda8ea36d95fd159568d93a4,1,1,1,2,1,2015-01-28 23:37:20,2015-01-28 23:37:20
8eb365c0a04b912d2e10eb16adeeb4216563be2c...537cd66d7e4237f0df6db88b3225327c8e4140c5,5,37,11,48,10,2015-01-28 17:28:17,2015-01-28 17:28:17
537cd66d7e4237f0df6db88b3225327c8e4140c5...c6c7552e41cba12ca84238bd466d522aa1712220,4,21,17,38,7,2015-01-28 21:19:32,2015-01-28 21:19:32
c6c7552e41cba12ca84238bd466d522aa1712220...68f7302474768351abf12767c7741823f56f35cd,4,5,7,12,4,2015-01-28 22:25:55,2015-01-28 22:25:55
8eb365c0a04b912d2e10eb16adeeb4216563be2c...8633bbc9b852d8809f20db86a3cdfa2cd3b8dd95,1,14,5,19,6,2015-01-28 08:37:44,2015-01-28 07:41:36
8633bbc9b852d8809f20db86a3cdfa2cd3b8dd95...fe831dcd6f4af535abba1a9dc350c4d8a0f809e9,2,9,9,18,2,2015-01-28 08:37:44,2015-01-28 08:30:27
fe831dcd6f4af535abba1a9dc350c4d8a0f809e9...4e7a4cd95696746bcab78a4f9ec071dd4089397a,7,19,27,46,15,2015-01-28 08:48:18,2015-01-28 08:32:48
56a456b43dba7d772db45e2b73aa18b5eab53d37...9910b7ff99c3d7f89f512c1915ce40ed0c1696e3,5,25,10,35,7,2015-02-05 18:10:52,2015-02-04 16:10:39
9910b7ff99c3d7f89f512c1915ce40ed0c1696e3...04a70d9ff7c8132bfd01ebf4d10fd34745719833,1,1,1,2,1,2015-02-05 18:10:55,2015-02-05 18:09:23
56a456b43dba7d772db45e2b73aa18b5eab53d37...ab22caa97e4c1d749f1acfa344c0b1c91eba598b,3,12,29,41,6,2015-02-05 14:56:28,2015-02-05 14:56:28
56a456b43dba7d772db45e2b73aa18b5eab53d37...f4ce0ddde44c278af9c7a9f198c9893d7db7472d,1,2,1,3,1,2015-02-04 14:35:10,2015-02-04 14:35:10
f4ce0ddde44c278af9c7a9f198c9893d7db7472d...8efed8b356606f688c05a1ce423e9001c4aa73b3,1,1,1,2,1,2015-02-05 15:02:06,2015-02-05 15:02:06
2f2d82e945cc151f71efe5e511eb95606b87911b...56af5f5cf9b10246af62c4dc7064fffa516709db,2,4,4,8,3,2015-02-20 06:42:54,2015-02-20 06:42:54
56af5f5cf9b10246af62c4dc7064fffa516709db...a6220d0a9fc80da028aa39a23cce30fe4fd3b685,1,1,0,1,1,2015-02-20 06:49:49,2015-02-20 06:49:49
a6220d0a9fc80da028aa39a23cce30fe4fd3b685...74ccfa8f7979a297f547be70a2e965d5336aec75,1,0,1,1,1,2015-02-20 07:05:40,2015-02-20 07:05:40
74ccfa8f7979a297f547be70a2e965d5336aec75...abc65bbbf3bbabeb1f03b3e55dda32732624cfde,1,3,3,6,4,2015-02-20 07:18:21,2015-02-20 07:18:21
e46ec91a942fc0773279999debe661f493999500...198c2e40b08240f0102320d2f404583e40c1f0cd,2,5,3,8,2,2014-07-03 17:08:03,2014-07-03 17:08:03
e46ec91a942fc0773279999debe661f493999500...6dafbf24124a098f65864cdecd91bcb5e50c2540,5,109,67,176,28,2014-07-03 14:58:42,2014-02-24 11:12:29
8fcdd6bfaf2bf8360026e963b57b0648c63ab74b...3decd462699d09717775100334587c5f5a5c2a3f,4,9,9,18,7,2014-07-02 17:05:36,2014-07-02 17:05:36
8fcdd6bfaf2bf8360026e963b57b0648c63ab74b...75e903c08bf405135be3e52344a3bde871252729,1,1,1,2,1,2014-07-02 16:53:41,2014-07-02 16:53:41
6360ce095505b342d0c737c61b08bb19eadbe242...4d85bc21baabcc45f6d28fb55a12779896d289fe,1,3,2,5,2,2014-06-04 08:08:15,2014-06-04 08:08:15
6360ce095505b342d0c737c61b08bb19eadbe242...5921c7481302913bffe88788c354f415cd19df82,1,1,0,1,1,2014-06-04 07:58:40,2014-06-04 07:58:40
605dfc9c32f37c4462f8e5b876391a509bf1c6af...7a385b811c7c304863c75e0023f63e7a15871ce6,1,1,1,2,1,2014-06-03 17:10:03,2014-06-03 17:10:03
5b87a4dc517eccb0e100ce751bf631bc0ee01100...ad432583a91ada2e75a2546cef51982a566ecc0f,4,64,61,125,7,2014-06-03 13:40:50,2014-06-03 13:40:50
9e924c70f3bc1d173eb89149c369ca7e502e225b...4147fc7eb62eb58fe33a9eea7b5450ae011b6e96,1,4,4,8,4,2014-06-04 07:27:23,2014-06-04 07:27:23
772f2f1ac8aab40a2cd62f285af131eb61ad12bb...466b768bb34730ee6a24d950333c232009c34bbd,11,38,24,62,27,2014-06-10 15:09:15,2014-02-21 18:39:09
466b768bb34730ee6a24d950333c232009c34bbd...de90b572d8f22708ea76ffbea9c513143fdeea2e,5,116,68,184,28,2014-06-10 15:09:15,2014-02-24 11:12:29
772f2f1ac8aab40a2cd62f285af131eb61ad12bb...a7be3dfa30a452b307d1fdc0b4157ecbe908da8d,4,1,34,35,5,2014-06-10 14:51:49,2014-06-10 14:51:49
a7be3dfa30a452b307d1fdc0b4157ecbe908da8d...f8ea52c3a0fe29daf76fbd7a0e65399c09c95f5a,3,28,35,63,12,2014-06-10 14:56:35,2014-06-10 14:56:35
f8ea52c3a0fe29daf76fbd7a0e65399c09c95f5a...c4b02642d2ca74f463e64dd591796aabe5c54af9,9,78,36,114,13,2014-06-10 15:07:52,2014-06-10 15:07:52
c4b02642d2ca74f463e64dd591796aabe5c54af9...d65bf4605e561b58d3bb8ddba0ffb335e3a4c768,2,3,3,6,3,2014-06-10 16:22:39,2014-06-10 16:22:39
d65bf4605e561b58d3bb8ddba0ffb335e3a4c768...f6ee55aabd31c624d5bca71bca5c6ed152d844d0,2,2,2,4,2,2014-06-10 16:23:02,2014-06-10 16:23:02
772f2f1ac8aab40a2cd62f285af131eb61ad12bb...95af7123bbe229f0e0c713de7271d668de105bd0,1,11,9,20,5,2014-06-10 12:43:11,2014-06-10 12:43:11
95af7123bbe229f0e0c713de7271d668de105bd0...5d95fc67262adba75c0227f7e200d820848c9ca5,1,2,2,4,2,2014-06-10 12:45:03,2014-06-10 12:45:03
a56e35e9250b23c8949780fb2f5d8ed236c6d536...245c04c29a04906113991144d8d4eebc5c6ecf1c,5,18,18,36,18,2014-05-23 13:01:02,2014-05-23 13:01:02
09fc3df9014e14725017d97b30e15ff97c3e8493...3e1853c5a0d89147a6a44a31a302f93e96c2ed92,1,3,0,3,1,2014-05-23 13:09:54,2014-05-23 13:09:54
fc8616582b30d44b7010d2d4eb05b8d21699f3ce...8ec38c17e2dfa103bfbcd50ef5481e6e2c1fd4ef,1,2,0,2,1,2014-05-23 10:19:39,2014-05-23 10:19:39
8ec38c17e2dfa103bfbcd50ef5481e6e2c1fd4ef...8ae2d2152b197931725a3f4b9aa3697f37988c20,1,1,1,2,1,2014-05-23 10:22:10,2014-05-23 10:22:10
9f2183f904cf3a4b8bcfd653b023aa4a9427c0c1...b192aa5694b8df233124c4be58802a9100b0c321,1,1,1,2,1,2014-05-22 19:34:34,2014-05-22 19:34:34
b192aa5694b8df233124c4be58802a9100b0c321...ebe2a34a6b81f468187a8049ddae8242b00d1ebe,1,1,7,8,2,2014-05-22 19:44:32,2014-05-22 19:44:32
6dfd88a145b7c7f9dc798d888a2aa4ad5c1c54b7...4593a0bc22d628f96e87fbb8446078a9bad2c678,1,3,5,8,3,2014-05-18 21:21:51,2014-05-18 21:21:51
6dfd88a145b7c7f9dc798d888a2aa4ad5c1c54b7...e1e9c307a6a5f0c3125fdb769ef065c55587782c,2,4,0,4,2,2014-05-17 08:41:12,2014-05-17 08:41:12
6dfd88a145b7c7f9dc798d888a2aa4ad5c1c54b7...d7cee6ed76b1892f4fe71d6f0cf6e83e8870478a,1,1,0,1,1,2014-05-16 22:04:09,2014-05-16 22:04:09
3b34084bdeadecdceb0a86e2820dd7c5985099f6...566badbaee55b7df45c7d912f80c372b6118b6ee,1,3,1,4,2,2014-05-12 05:30:35,2014-05-09 09:37:27
3b34084bdeadecdceb0a86e2820dd7c5985099f6...049b63473f827e3d28b0128356b81b3208bf0b0c,1,2,2,4,2,2014-05-09 17:34:25,2014-05-09 17:34:25
3b34084bdeadecdceb0a86e2820dd7c5985099f6...ea696805a7a82ec6a70da1dd7d5bc010f035ea26,2,2,2,4,2,2014-05-09 15:58:23,2014-05-09 15:58:23
edc18e777ca72442986c9843624934f248a8a2fe...3a48e1cfd1de2d96007b89aa5a16f013976eeb96,2,2,2,4,2,2014-02-04 10:39:07,2014-02-04 10:39:07
5e004719c44edee3b6ab7921b016fd0044bad8b4...798360194a94f2df787ef59e669f17793af92f4b,1,2,2,4,2,2014-01-31 16:46:52,2014-01-31 16:46:52
97a4d8aea46fb45894f6e47597320ed2f6a12495...f297c6b3d722af6fbeaa2cd5cfa30d552f6d1c41,2,3,4,7,3,2014-02-04 14:05:14,2014-02-04 14:05:14
f297c6b3d722af6fbeaa2cd5cfa30d552f6d1c41...31987259e4c1d878bb796d07e5594156dbcfac5c,1,11,3,14,3,2014-02-04 17:14:36,2014-02-04 17:14:36
31987259e4c1d878bb796d07e5594156dbcfac5c...fc16a228c915437e17dc040e2798c26acac8fd86,3,6,3,9,3,2014-02-05 07:02:13,2014-02-05 07:02:13
c573265891bae3d46d1f9b713de76918a37b3811...84408015cd038b25a3f2d286c172461b263a6b1a,1,2,2,4,2,2014-02-04 02:20:36,2014-02-04 02:20:36
c573265891bae3d46d1f9b713de76918a37b3811...c52bc838cdf04f7b2a06fe02f5cfaf23e0e5bdc6,3,17,20,37,3,2014-02-03 16:06:21,2014-02-03 13:16:59
d8b769ec740f9e6d47c3885d99796e4ca9337cbc...1d63464c82db58763a0941c22ab8c3c973890a38,3,16,14,30,8,2014-08-13 18:28:22,2014-08-13 18:28:22
d8b769ec740f9e6d47c3885d99796e4ca9337cbc...100022d3eaf78d6c4adad647cb00b03a1befffb0,1,1,1,2,1,2014-08-13 17:13:14,2014-08-13 17:10:18
d8b769ec740f9e6d47c3885d99796e4ca9337cbc...540596b7b5bf0e107fafbc6041d9318125c3cef8,2,5,2,7,2,2014-08-13 16:47:03,2014-08-13 16:47:03
4116588f65fdcb454b1f6cd88a0e1614d19969d4...086ec401847e2352933543479e7aaf7e7208233d,2,0,60,60,2,2014-06-25 09:45:19,2014-06-25 09:45:19
4d482b3b0c6ea6747f74e2eb0231631498496b59...1e673c72a1a9ce1f5f4291e2f8dbc4db220f55cb,2,29,6,35,5,2014-06-26 07:13:38,2014-06-26 07:13:38
4d482b3b0c6ea6747f74e2eb0231631498496b59...9ab3882510630fb76d2373c217a9a977d70c716e,1,1,0,1,1,2014-06-25 11:02:14,2014-06-25 11:02:14
4d482b3b0c6ea6747f74e2eb0231631498496b59...401f958e6be7faf572d040409f602d6b2c0a6edc,1,1,1,2,1,2014-06-25 10:57:25,2014-06-25 10:57:25
a34dabd85c9cb64b92b22cd9cb91864387e408d4...b80e98f47a40de1b9810be7fc7364f1784c78685,1,3,3,6,3,2014-06-26 07:55:08,2014-06-26 07:55:08
cafe181b5487891453f0ead532b026e80579ec1e...84992cd0fac36846ebfde5800d52158258107ecc,3,5,10,15,5,2013-08-31 22:04:22,2013-08-31 22:04:22
25a723c3ae04c5818427682b2fbe97609a97f1ea...30b8218ffba6c417b1742b0632e302cc1fe63c55,1,3,3,6,2,2013-08-30 14:10:58,2013-08-30 14:10:58
25a723c3ae04c5818427682b2fbe97609a97f1ea...850b4af0fffa77d5f3440d89015543f060d9ac67,23,29,29,58,28,2013-08-30 02:26:32,2013-08-30 02:26:32
25a723c3ae04c5818427682b2fbe97609a97f1ea...e602c9b0b17b2442048aa5df81fbd057bd7ab12e,1,2,1,3,1,2013-08-29 19:53:22,2013-08-29 19:53:22
be7798b81010b182919d7b5f6ac866df778aef03...eee9227a5fb620e646d55060dff68a94154da3b7,1,1,0,1,1,2013-09-04 11:44:41,2013-09-04 11:44:41
fcf55171c4d5a25bc08da37e704f95ca8ca4e06b...9a247213a880611cadcb57dfa744b11d3ce7a114,1,8,1,9,2,2013-12-26 12:58:15,2013-12-26 12:58:15
9a247213a880611cadcb57dfa744b11d3ce7a114...b27bd2b10d08e16663d6554d11e0eeef708a87d5,1,2,2,4,2,2013-12-26 13:11:48,2013-12-26 13:11:48
6bb474a0dc7a01108e9d2345da1c5a6e70d8aed0...4b2c50d53f32fcd09674dc8ba0aa9719ece73d56,1,8,0,8,1,2014-03-22 19:34:05,2014-03-22 19:09:23
4b2c50d53f32fcd09674dc8ba0aa9719ece73d56...6adbfda2f832b7e0e5a16718d625a3be3f137819,1,2,2,4,2,2014-03-23 18:13:30,2014-03-23 18:07:09
6bb474a0dc7a01108e9d2345da1c5a6e70d8aed0...d8a015cc9723557665ada26609b3f13820b03665,1,1,1,2,1,2014-03-21 20:52:08,2014-03-21 17:34:59
d8a015cc9723557665ada26609b3f13820b03665...5c038d949f1e40939548c530214d65d33ab94904,1,1,1,2,1,2014-03-21 21:04:57,2014-03-21 21:04:57
5c038d949f1e40939548c530214d65d33ab94904...ae1a3148242907b21e9952f1964919622b4f3129,1,1,0,1,1,2014-03-21 21:08:36,2014-03-21 21:08:36
6bb474a0dc7a01108e9d2345da1c5a6e70d8aed0...78261b4aad4ceed5b3b11e761436313b1cac3bfe,1,8,0,8,1,2014-03-21 18:14:11,2014-03-21 18:14:11
2ae6f17deb4700f4115b4a615f8ca0c5cb03d090...6bf5215b2378fdb9cb442a053ddd12570c69d00c,1,1,1,2,1,2014-03-10 08:11:19,2014-03-10 08:11:19
6bf5215b2378fdb9cb442a053ddd12570c69d00c...b5264c24e89dc882cb42802fe1d8d5e2f5012c46,1,1,0,1,1,2014-03-10 08:15:30,2014-03-10 08:15:30
0142aa5a34eaf5e7425a1d8b5087606471d1fa33...daa7f077db81f3ecc3417419b7f74b157bb3fda3,4,168,13,181,8,2014-03-10 12:48:08,2014-03-10 12:48:08
daa7f077db81f3ecc3417419b7f74b157bb3fda3...0fdab6a7478a6bc57c05485a246be318063e4e22,3,0,18,18,3,2014-03-10 15:09:45,2014-03-10 15:09:45
0fdab6a7478a6bc57c05485a246be318063e4e22...b1ff8e31b1717c1abbaa3db88da77aef48b51c4e,3,40,2,42,7,2014-03-10 15:10:23,2014-03-10 15:10:23
b1ff8e31b1717c1abbaa3db88da77aef48b51c4e...3e864036e73f537a37e601716f0835fbee4593c7,1,2,1,3,1,2014-03-10 17:16:43,2014-03-10 17:16:43
3e864036e73f537a37e601716f0835fbee4593c7...e57e1e04e3d4b930e60a87643f09c908b3bfb90b,1,0,1,1,1,2014-03-11 07:15:04,2014-03-11 07:15:04
e57e1e04e3d4b930e60a87643f09c908b3bfb90b...cf890b227a277086dd1b5cfee356027f1a77a424,2,40,38,78,20,2014-03-11 08:07:22,2014-03-11 08:07:22
cf890b227a277086dd1b5cfee356027f1a77a424...c6d39a14d6b15f457bfc050f54e256cd5da64cc9,2,13,3,16,4,2014-03-11 08:24:07,2014-03-11 08:24:07
322a8f1d6d98795e9a60fce005350f0e9dcd8660...ad71eca8bbaeccc6e67d977c8d7c2deb324f123d,1,2,0,2,1,2014-03-10 17:14:59,2014-03-10 17:14:59
82a9a4c034eab240330696df578045336f34675e...d2c85a68bb763d2beccf8ebc0087791f6714c6de,4,34,4,38,7,2015-02-28 09:06:32,2014-12-28 20:08:33
0f144f36bc5703ba745a8a6d1cde14fb694c4e34...9bb5986d4afff761ddc344413fdb34babb4c9d70,2,1,3,4,2,2015-03-13 16:27:10,2015-03-12 20:35:51
0f144f36bc5703ba745a8a6d1cde14fb694c4e34...80b2f3fb86d6e6b16565b9e9de82dda169926bcb,11,90,35,125,14,2015-03-12 23:20:58,2015-03-12 23:20:58
0f144f36bc5703ba745a8a6d1cde14fb694c4e34...f0cbbd70bba7c44e9b09a3472e6c2f6f58623150,19,29,27,56,27,2015-03-12 22:37:00,2015-03-12 22:37:00
0f144f36bc5703ba745a8a6d1cde14fb694c4e34...7ac62388a5ba030dd60e6aef971eb32adf39ed0d,8,18,15,33,8,2015-03-12 20:56:53,2015-03-12 20:56:53
7ac62388a5ba030dd60e6aef971eb32adf39ed0d...bf0c04e5ff61cd68177e52c15128aea9b1a41427,2,21,18,39,2,2015-03-12 21:51:41,2015-03-12 21:51:41
0f144f36bc5703ba745a8a6d1cde14fb694c4e34...e7f4f0ae1db4b0d940d0c4f1e4b32bebf9e6c299,3,15,2,17,4,2015-03-12 18:53:21,2015-03-12 18:53:21
bb2358379e347de9c6f9a0b521d2f8599f636881...b3fd0ca04d498504e93894378be98dc1bda7e259,2,15,7,22,6,2015-02-23 22:27:52,2015-02-23 22:27:52
bb2358379e347de9c6f9a0b521d2f8599f636881...0e1d31a734c576421bdb798f3f8e6bf9381c854b,1,2,0,2,1,2015-02-23 21:52:02,2015-02-23 21:52:02
bb2358379e347de9c6f9a0b521d2f8599f636881...e35fe204795bbb19d46f34af49c1ad4f7148e68f,1,1,1,2,1,2015-02-23 21:38:04,2015-02-23 21:38:04
e35fe204795bbb19d46f34af49c1ad4f7148e68f...ea31726781296efa9c2493c3f01aa62ca77b45fe,2,9,3,12,2,2015-02-24 17:06:59,2015-02-24 17:06:59
bb2358379e347de9c6f9a0b521d2f8599f636881...5ce2d44b136aae8e9e42397474a0e75bc6b32ded,1,1,1,2,1,2015-02-23 19:51:18,2015-02-23 19:51:18
bb2358379e347de9c6f9a0b521d2f8599f636881...5d2dda9744eb902e397410f8f4b94af3a0acb1df,1,1,1,2,1,2015-02-23 19:39:08,2015-02-23 19:39:08
bb2358379e347de9c6f9a0b521d2f8599f636881...846f83177448832bd04ea0167b34541b5d3b71c6,10,25,24,49,24,2015-02-23 18:40:06,2015-02-23 18:40:06
ac918a5cdb405ce81d89c57a9309b52df7c9ca42...2feaa69cd5831578f99c3833f8b1e3e5a8031c1d,3,6,6,12,6,2015-02-24 07:10:35,2015-02-24 07:10:35
ac918a5cdb405ce81d89c57a9309b52df7c9ca42...bd6550a5121d5a386c5928bbd74b79ab382c548f,1,1,1,2,1,2015-02-24 06:54:32,2015-02-24 06:54:32
71e146999c405ab301cd3c3e3aa03b89d46c461e...90aa870c3607c170091b6034c0150f119697b0b9,8,53,19,72,16,2015-03-16 21:05:52,2015-02-21 21:12:13
71e146999c405ab301cd3c3e3aa03b89d46c461e...50305c363b85c0d55b5a0c7bcd5fcb569a437ec1,1,3,3,6,3,2015-02-22 09:54:28,2015-02-22 09:54:28
71e146999c405ab301cd3c3e3aa03b89d46c461e...52902f54346acb8076594a85e34f16605790b49f,4,7,8,15,4,2015-02-22 02:28:32,2015-02-22 02:28:32
52902f54346acb8076594a85e34f16605790b49f...87b04868a11a840d04a86ea1f8b2af9ec94efbd8,13,56,96,152,23,2015-02-22 06:01:27,2015-02-22 06:01:27
df91781a346e6b70c43195f2f4f550b097ac9d2e...6a269450e6b8443a6a15b8ba6e0fe6737c78bd5b,2,6,6,12,2,2015-03-17 17:09:26,2015-03-17 00:48:36
3103e567bce530fdeddf87461cb6a0d112df28d6...5b32fda4b8698deda5402b8c640d36bf5cd69222,1,14,1,15,7,2015-01-13 14:38:38,2015-01-13 13:09:19
5b32fda4b8698deda5402b8c640d36bf5cd69222...e64e0104fa97d6b420aa430018acfcfc3894044b,1,8,8,16,3,2015-01-13 14:47:23,2015-01-13 14:47:23
e64e0104fa97d6b420aa430018acfcfc3894044b...7606b93c26ca58211d2cfbbad2e051dcd0ea7c32,1,1,1,2,1,2015-02-11 10:02:36,2015-02-11 10:02:36
3103e567bce530fdeddf87461cb6a0d112df28d6...c13f420b663af3eca6a8c11c7c9c5b3aa684336b,2,8,2,10,3,2015-01-13 10:17:05,2015-01-06 08:50:37
3103e567bce530fdeddf87461cb6a0d112df28d6...0be1a45b9f4296016e758a5e650f516262fae640,2,15,1,16,4,2015-01-13 03:19:22,2015-01-13 03:19:22
0be1a45b9f4296016e758a5e650f516262fae640...e588328674f1c0c956b924c9ec78391d209150cd,2,3,3,6,3,2015-01-13 03:26:51,2015-01-13 03:26:51
ada6c6080b2fa0d63003f8b29b5c32195254906d...20028523b5a2969b70a1fde9468c434b78f916ea,11,139,5,144,11,2015-01-17 23:40:09,2015-01-17 23:37:27
20028523b5a2969b70a1fde9468c434b78f916ea...a81081aa72ad516d685152ea4790f9156262ab92,3,12,6,18,8,2015-01-18 00:17:34,2015-01-18 00:17:34
ada6c6080b2fa0d63003f8b29b5c32195254906d...ef0b15c55268fbf7ac8ee0bd0b5b8bc0fe265ac4,2,4,1,5,2,2015-01-17 22:54:54,2015-01-17 22:54:54
ada6c6080b2fa0d63003f8b29b5c32195254906d...55d980905540bae6d02ac104dac5c23e96dd5711,10,15,14,29,14,2015-01-17 18:50:41,2014-09-30 14:39:37
ada6c6080b2fa0d63003f8b29b5c32195254906d...8243eb3f0e3ee06a793831ae0899bfe409a31903,5,32,1,33,5,2015-01-17 18:22:35,2015-01-17 13:12:49
ada6c6080b2fa0d63003f8b29b5c32195254906d...e460e04e16abe5409b2e4918016a29b0415790ca,4,13,3,16,4,2015-01-17 18:19:28,2015-01-16 13:38:53
ada6c6080b2fa0d63003f8b29b5c32195254906d...33fea08944915f1d27c78ede2fa5d1f973b9eb49,1,2,2,4,1,2015-01-17 17:06:43,2015-01-15 22:35:32
ada6c6080b2fa0d63003f8b29b5c32195254906d...727363163e56c25c2040057a546b171267842d6f,28,0,0,0,0,2015-01-17 16:10:28,2015-01-17 16:10:28
ada6c6080b2fa0d63003f8b29b5c32195254906d...b0ec61500e4de9dafd9dfb0177d92349c789de8e,2,6,1,7,2,2015-01-17 15:39:29,2015-01-17 15:39:29
ada6c6080b2fa0d63003f8b29b5c32195254906d...09152bad0c3dd950d3d6dd0c0ea7f31056df1fdf,1,1,1,2,1,2015-01-17 14:15:20,2015-01-17 14:15:20
ada6c6080b2fa0d63003f8b29b5c32195254906d...41d7be3ce1ae9a4bff93b62322f35989b6ad4cf6,8,28,9,37,11,2015-01-17 00:01:15,2015-01-17 00:01:15
41d7be3ce1ae9a4bff93b62322f35989b6ad4cf6...e7f772550c5fad5761777b76f97726be84693746,3,7,4,11,6,2015-01-17 00:09:20,2015-01-17 00:09:20
e7f772550c5fad5761777b76f97726be84693746...38600e328bf4bacf2d3e4288943fb7652ee6c674,2,7,2,9,4,2015-01-17 01:22:17,2015-01-17 01:22:17
38600e328bf4bacf2d3e4288943fb7652ee6c674...f2eb234c068ccb57f100080a499d307b9b2f5502,1,2,2,4,2,2015-01-17 02:12:15,2015-01-17 02:12:15
ada6c6080b2fa0d63003f8b29b5c32195254906d...6ac8bb0f7ccd7b1f10909aea62b1d8493fc0574a,2,2,2,4,2,2015-01-16 18:52:48,2014-12-16 22:03:28
6ac8bb0f7ccd7b1f10909aea62b1d8493fc0574a...ad18fcd0e61d2d6826a8e478345c3cd9b59049c5,1,3,1,4,2,2015-01-16 18:52:48,2014-12-17 13:11:24
ad18fcd0e61d2d6826a8e478345c3cd9b59049c5...bb80bf3612b9fe47a4a5b11645ad494fe169f586,1,1,1,2,1,2015-01-16 18:55:35,2014-12-17 20:54:10
ff7f4a134e4d62a22a38409b7f71c582d86f53d8...02d8575a610176bbb79eac91b5ab783872ef098a,1,4,19,23,2,2015-01-15 00:23:46,2015-01-13 18:58:32
ff7f4a134e4d62a22a38409b7f71c582d86f53d8...204b3c121cb038c5825dff3fa877ae2eea15403b,7,30,8,38,8,2015-01-14 23:22:31,2015-01-14 23:22:31
204b3c121cb038c5825dff3fa877ae2eea15403b...1e45ba7f169781d7c1d79fdfcee14760558db253,1,1,1,2,1,2015-01-15 00:23:20,2015-01-15 00:23:20
21c99e6a7797edb6a857e90c83fee3e5f1051adc...61ed518781cfc78bf1710286d84d4e74521f48d4,5,7,3,10,6,2015-03-11 04:04:23,2015-01-02 12:47:22
21c99e6a7797edb6a857e90c83fee3e5f1051adc...b26ab0ceeb60723b8a75078c4d49ed99c9ea3866,3,44,1,45,3,2015-03-10 04:43:54,2015-03-09 22:10:59
82bb3ec33d1978101231ac2cc144be647417105e...3175438f02ca4bc0469aca097e02b2671865ef43,3,7,3,10,5,2015-03-12 12:47:15,2015-03-12 12:47:15
82bb3ec33d1978101231ac2cc144be647417105e...ae7e3806324fbe1ab63e68da823472fcbe31d652,1,5,0,5,2,2015-03-10 19:03:04,2015-03-10 19:03:04
ae7e3806324fbe1ab63e68da823472fcbe31d652...0d4328fd00617bd23cd91f212e964b86c70792f7,1,1,0,1,1,2015-03-10 19:03:35,2015-03-10 19:03:35
82bb3ec33d1978101231ac2cc144be647417105e...cadf76562a7fc7d4f341c440ce3d5e301f4c87d1,6,9,8,17,6,2015-03-10 17:30:07,2015-03-10 17:30:07
cadf76562a7fc7d4f341c440ce3d5e301f4c87d1...1178dacdb60e80d25700f984099dc6ce8dbf7efb,1,1,1,2,1,2015-03-10 17:50:53,2015-03-10 17:50:53
066fb568e7b8ee7d04e934a82171fece48768034...847bd0d0e5bd5bf5c8dafa38de2f420da902bdd6,2,28,26,54,2,2015-03-18 06:16:10,2015-03-18 06:16:10
066fb568e7b8ee7d04e934a82171fece48768034...2aaf685305e2af63aeb23e41e140bd05165f01f7,5,17,24,41,14,2015-03-18 05:25:25,2015-03-18 05:25:25
2aaf685305e2af63aeb23e41e140bd05165f01f7...293553747aab45ce2d63e73a366a2d4d1c80363b,1,4,741,745,20,2015-03-18 05:31:45,2015-03-18 05:31:45
293553747aab45ce2d63e73a366a2d4d1c80363b...521785157b1f6f729e77fdad2ec83492120e8c7c,3,5,10,15,7,2015-03-18 05:48:00,2015-03-18 05:48:00
b3c226765e8bb677c2630f6915336cf0e817b75d...37973ef61b9c4dc8624bce79441113b35fa28e8e,1,1,1,2,1,2015-03-16 16:39:43,2015-03-16 16:39:43
37973ef61b9c4dc8624bce79441113b35fa28e8e...93e321e7c8e6c83f2b58098c514e148d8d70f79f,1,1,1,2,1,2015-03-16 16:46:23,2015-03-16 16:46:23
f9fb76670f9db5c7bf7d74fe0129129c785f8099...5ade3a6b781413c62df2ce44f6b79ba8ef3c3d62,1,1,1,2,1,2015-01-20 19:59:35,2015-01-20 19:59:35
f9fb76670f9db5c7bf7d74fe0129129c785f8099...6da0ab7d60ecdf189190ac095aecdf174e73a03e,5,34,9,43,10,2015-01-20 19:52:55,2015-01-20 19:52:55
b1dffe67295b8f8929d125a8c0fb3207c4e79853...4ade9bf24da50091e3a3fc310ca9070caed19a75,1,1,1,2,1,2015-01-23 01:05:31,2015-01-23 01:05:31
815e9aa283f113051268370908776c5517dab711...c39f80bdb412bc9cc7646de0929efe8cb5b870d4,3,10,18,28,6,2015-01-29 07:00:41,2015-01-29 07:00:41
abc65bbbf3bbabeb1f03b3e55dda32732624cfde...50df9a7cb91cdaafe569f473dd24d15ff04312c6,10,59,32,91,19,2015-02-20 08:11:25,2015-02-20 08:11:25
50df9a7cb91cdaafe569f473dd24d15ff04312c6...675f59540687d40357182df2582c92d8c2bedb49,3,4,4,8,4,2015-02-20 08:20:17,2015-02-20 08:20:17
83fd03f2ddb6b2fb2088bb9b3945fe13afb91320...ddb8c8e0d678b076bb9272b2471fa5b30fbef775,1,2,2,4,2,2014-07-04 11:15:36,2014-07-04 11:15:36
83fd03f2ddb6b2fb2088bb9b3945fe13afb91320...3b5722bca9e7e853c1428631ae21c600e17ef4a5,2,13,10,23,6,2014-07-04 09:57:24,2014-07-04 09:57:24
83fd03f2ddb6b2fb2088bb9b3945fe13afb91320...cb69e76a2902286d30eabe7f7b7241c9b5471bea,1,1,1,2,1,2014-07-04 08:49:36,2014-07-04 08:49:36
83fd03f2ddb6b2fb2088bb9b3945fe13afb91320...b37247ac31b2365e8a7f557e7f6ee614d00628ea,2,13,13,26,13,2014-07-04 07:45:20,2014-07-04 07:45:20
b37247ac31b2365e8a7f557e7f6ee614d00628ea...7dd0646e0d284050ee760c5dfa9ce69beecb9ed6,1,1,1,2,1,2014-07-04 11:46:44,2014-07-04 11:46:44
83fd03f2ddb6b2fb2088bb9b3945fe13afb91320...8395b2784afce34cebf6a5ba8e4850057333de05,1,4,4,8,4,2014-07-04 06:32:46,2014-07-04 06:32:46
83fd03f2ddb6b2fb2088bb9b3945fe13afb91320...d390219c6fedc884fdd0990595cfd1d832aef4df,2,3,2,5,3,2014-07-04 06:22:46,2014-07-04 06:22:46
83fd03f2ddb6b2fb2088bb9b3945fe13afb91320...c899c294fd36ae6a1c7a45152e8b76b4f0d82b37,1,1,1,2,1,2014-07-04 06:14:34,2014-07-04 06:14:34
83fd03f2ddb6b2fb2088bb9b3945fe13afb91320...9c2b046454ff68fe861bcd8fb81661c9c7753ef2,2,2,2,4,2,2014-07-04 02:51:44,2014-07-04 02:51:44
3decd462699d09717775100334587c5f5a5c2a3f...dce6cb2d8448e6c59285998f7fc54e1cb23d269a,1,1,0,1,1,2014-07-03 02:57:01,2014-07-03 02:57:01
dce6cb2d8448e6c59285998f7fc54e1cb23d269a...4d051e987fb2071bea2f3ee00d8fc16b56648204,1,1,1,2,1,2014-07-03 03:05:51,2014-07-03 03:05:51
554c4844678c4d35e8fc8986066b53613e778c37...b9c6ca14963af5ad07da5ed5db43b7cbe20624fc,1,4,2,6,3,2014-06-04 09:29:05,2014-06-04 09:29:05
5921c7481302913bffe88788c354f415cd19df82...c283fba3b7e9fb89ae2ed77597adee2700982718,4,49,11,60,9,2014-06-04 08:52:17,2014-06-04 08:52:17
c283fba3b7e9fb89ae2ed77597adee2700982718...a89c590ffef54c9ff4c790b5d91a8afe68b1ee42,1,4,4,8,4,2014-06-04 09:56:03,2014-06-04 09:56:03
5921c7481302913bffe88788c354f415cd19df82...4e249dadb5bbcda8e36e6282a36ea2aa1b7900fd,1,2,0,2,1,2014-06-04 08:08:21,2014-06-04 08:08:21
5921c7481302913bffe88788c354f415cd19df82...74bcc8321e5c9eb2f84306d1688ead35f3c86579,1,2,2,4,1,2014-06-04 08:04:36,2014-06-04 08:04:36
ab7a9347a164c33eb115b9806ed6261d5bb84505...df92f825fca070401ef9fdab11af15041543a25a,1,1,1,2,1,2014-06-03 17:12:01,2014-06-03 17:12:01
3e1853c5a0d89147a6a44a31a302f93e96c2ed92...cc28b21adce61206e5ca96dfe23bab4cec9a0400,1,1,0,1,1,2014-05-24 07:30:58,2014-05-24 07:30:58
3e1853c5a0d89147a6a44a31a302f93e96c2ed92...d0e794cc1a7eba4d438841d6a661bc41687e624e,4,9,3,12,5,2014-05-23 18:23:59,2014-05-17 09:36:39
d0e794cc1a7eba4d438841d6a661bc41687e624e...4ac56fa1db2286848b1bed9df3aeec8685c4cbd3,2,3,5,8,3,2014-05-23 18:26:31,2014-05-23 18:26:31
3e1853c5a0d89147a6a44a31a302f93e96c2ed92...1e6766f9edb2a9bda18e89acef64ee03e8d3b2e4,2,29,0,29,2,2014-05-23 15:02:47,2014-05-22 01:46:01
1e6766f9edb2a9bda18e89acef64ee03e8d3b2e4...2490cfbcca368a872a0b66998bf739cc7ded8ae8,1,34,0,34,1,2014-05-23 22:58:49,2014-05-23 22:58:49
2490cfbcca368a872a0b66998bf739cc7ded8ae8...446e920a1b0511eaf124b5c443d9f1c5a56b2667,1,19,0,19,1,2014-05-26 16:30:58,2014-05-26 16:28:45
446e920a1b0511eaf124b5c443d9f1c5a56b2667...435740b8a261e664ba021536690395b4313846f3,1,1,1,2,1,2014-05-26 16:32:01,2014-05-26 16:32:01
435740b8a261e664ba021536690395b4313846f3...a8f2977c6ac969e91180d06cd3c9ceffed48fd58,2,8,7,15,5,2014-05-27 12:22:04,2014-05-26 16:32:52
a8f2977c6ac969e91180d06cd3c9ceffed48fd58...2d4ba2679a3bb2a26adf6c013d5d4be19ed8da94,1,2,5,7,1,2014-05-28 11:59:02,2014-05-28 11:59:02
2d4ba2679a3bb2a26adf6c013d5d4be19ed8da94...28de31f5200d908551d8372fed7511df80e284fd,1,2,4,6,2,2014-05-28 15:14:51,2014-05-28 15:14:51
8ae2d2152b197931725a3f4b9aa3697f37988c20...d575ee3e90a7b13e4ed29fdea0b611ae8ef50496,3,43,2,45,4,2014-05-23 12:34:02,2014-05-23 12:34:02
8ae2d2152b197931725a3f4b9aa3697f37988c20...6990f8a8464fd579c7152512d3d3b25b60b6f5c9,1,1,1,2,1,2014-05-23 12:07:42,2014-05-23 12:07:42
8ae2d2152b197931725a3f4b9aa3697f37988c20...8efc80ef0629bc5916debb4bc476374ac5ad6733,1,1,0,1,1,2014-05-23 12:02:39,2014-05-23 12:02:39
8ae2d2152b197931725a3f4b9aa3697f37988c20...c5922ca97fa83492b0c8419b642be00d820ce0fb,1,4,0,4,1,2014-05-23 11:48:56,2014-05-23 11:48:56
8ae2d2152b197931725a3f4b9aa3697f37988c20...695fd3cf2c7e01d06e9c335cae208089a4c6bfbd,13,109,119,228,21,2014-05-23 11:25:55,2014-05-23 11:25:55
8ae2d2152b197931725a3f4b9aa3697f37988c20...a5e1624359d9960782cd76f24c6300aeb28a2746,1,2,2,4,2,2014-05-23 10:27:35,2014-05-23 10:27:35
a5e1624359d9960782cd76f24c6300aeb28a2746...b44138ae4030bb5b63af4f4d835ddceb06c1b953,1,1,1,2,1,2014-05-23 10:29:14,2014-05-23 10:29:14
b44138ae4030bb5b63af4f4d835ddceb06c1b953...484c09792c5c6b4f8f1111978a82cf080a31a920,2,2,2,4,2,2014-05-23 11:33:20,2014-05-23 11:33:20
593b6674e1b3fb1d5277b823703b9bbc366152b2...52d0ae32b00378f823601184fa390361cd266f0d,1,1,0,1,1,2014-08-12 18:41:28,2014-08-12 18:41:28
593b6674e1b3fb1d5277b823703b9bbc366152b2...8abf010db3b9cd381377d0cf77087de11d71ed52,1,0,23,23,1,2014-07-29 07:02:50,2014-07-29 07:02:50
8abf010db3b9cd381377d0cf77087de11d71ed52...0768100ad856e2ff85ca0ad6751ac212b47f34a4,1,7,0,7,1,2014-07-29 07:07:47,2014-07-29 07:07:47
a85aa4e09ea7a4aef3c7191f5d042e225953526a...0202c98772f0fa760a346edef34db91671d05e74,1,2,0,2,1,2014-05-19 11:45:52,2014-05-19 11:45:52
0202c98772f0fa760a346edef34db91671d05e74...50313b646d41b423d6a424b8c1d4e173dc66e76b,1,1,1,2,1,2014-05-19 11:55:56,2014-05-19 11:55:56
a85aa4e09ea7a4aef3c7191f5d042e225953526a...85c5a20352c7e739859eae8ad972f08fc61592b0,1,4,4,8,3,2014-05-19 10:34:26,2014-05-19 10:34:26
a85aa4e09ea7a4aef3c7191f5d042e225953526a...39d95b1d94968bd1fd465bde2790457e74addd06,2,104,8,112,9,2014-05-19 10:30:30,2014-05-19 10:17:00
39d95b1d94968bd1fd465bde2790457e74addd06...aacd43d72dcb6d36834a055df52c283a6ce2ffa7,1,1,1,2,1,2014-05-19 10:31:20,2014-05-19 10:31:20
a85aa4e09ea7a4aef3c7191f5d042e225953526a...f0b3092d2f7e0a177445727e6c6bd461c19b6ba7,1,2,0,2,1,2014-05-19 09:52:02,2014-05-19 09:52:02
f0b3092d2f7e0a177445727e6c6bd461c19b6ba7...971dc47907ac54c49a5792697fc02ba350247f86,1,1,1,2,1,2014-05-19 10:43:16,2014-05-19 10:43:16
971dc47907ac54c49a5792697fc02ba350247f86...0957f341b173c95c48906d7545531042cfd39641,1,51,18,69,16,2014-05-22 13:18:28,2014-05-22 13:18:28
0957f341b173c95c48906d7545531042cfd39641...b6a88c78500d66aa2965259e7db2574b1818602c,1,3,3,6,3,2014-05-22 13:41:33,2014-05-22 13:41:33
b6a88c78500d66aa2965259e7db2574b1818602c...d2e92940b47307e719e785c65f729c7d953075c1,1,6,0,6,1,2014-05-22 14:21:59,2014-05-19 09:50:18
d2e92940b47307e719e785c65f729c7d953075c1...ab126c806884f26a42d515b573ce202c49dfafcb,1,2,0,2,1,2014-05-22 15:20:50,2014-05-22 15:20:50
4ba5acd23826831d5db52e66db5238a9030264a3...a3d8be09c6c62e39301d82e47b710717ff68245f,4,8,4,12,5,2014-05-11 14:50:14,2014-04-17 15:13:31
4ba5acd23826831d5db52e66db5238a9030264a3...7477dd7a7ca68b6f5365068e34c854381096da3c,1,2,2,4,2,2014-05-11 13:23:51,2014-05-11 13:23:51
c355b9abfe441da1d164cb1a27a8e6dbee266bb2...31b0e14981d57c2f38734872181c6dc49a2e6f5a,3,28,22,50,7,2014-05-12 09:23:24,2014-05-12 09:23:24
07157799c42b015bbfe2d301db4660cb4a555784...c296ecfb59fcb2d4588f9f4352ec784ab899ec01,2,29,21,50,23,2014-02-04 13:49:06,2014-02-04 13:49:06
fdd8e4507527badd875a40a0ab8a3ed47a03c764...45da59daab5878eb20adc402fbd9c9f44407ed75,1,5,0,5,1,2014-08-14 12:15:48,2014-08-14 12:15:48
fdd8e4507527badd875a40a0ab8a3ed47a03c764...4e4080016604e2c7ca9a5e75d6dd37d34b99cb09,17,164,15,179,25,2014-08-14 11:48:14,2014-08-02 15:12:01
d9bc57d18ec3d4ad0b0d8b223a67e496bc81ac88...275a5281d5f35bf2243a0b5814b8fb83f1561105,1,3,3,6,2,2014-07-14 13:25:09,2014-07-14 13:25:09
fb3104dabf5a6e47019a795bef70c6dbf1aea3b2...d32ec4ce9973f1903e0136a66dbae5c8e2296c60,1,1,1,2,1,2014-06-25 20:52:45,2014-06-25 20:52:45
7abd1fd64f3a77ac02f787a65a555d14e7e2a5b0...024e0577c6b6ded30ee09536082bd24405bda1e5,1,1,0,1,1,2014-06-26 09:56:15,2014-06-26 09:56:15
84992cd0fac36846ebfde5800d52158258107ecc...2bfea8f4f38044ac57ac60413c82c5f1209c5a5a,1,1,1,2,1,2013-09-08 10:31:00,2013-09-08 10:31:00
84992cd0fac36846ebfde5800d52158258107ecc...1f3f874142775ba6d074460a570c69e1fb02e096,1,1,1,2,1,2013-09-01 19:07:02,2013-09-01 19:07:02
84992cd0fac36846ebfde5800d52158258107ecc...a848d9dbccce3621041f8b71a3de96c660489697,1,37,35,72,9,2013-09-01 10:13:17,2013-09-01 10:13:17
a848d9dbccce3621041f8b71a3de96c660489697...cabf9e04045c343eaa8cdf0b9c0bd6f341e5480a,1,1,1,2,1,2013-09-04 07:08:39,2013-09-04 07:08:39
7008ace6c25a8349af2da5fd0ef5900cad136b6e...cbae8097c0af53a20873214bcaccfb3d20c0a76b,3,12,12,24,11,2013-08-30 19:10:26,2013-08-30 19:04:26
a8cb13c85dec55600e8d75fce6aa6c87d47eb2ac...626359831402aeede4c4cb12cb10c7534a0dae79,1,1,1,2,1,2013-09-04 14:05:48,2013-09-04 14:05:48
b27bd2b10d08e16663d6554d11e0eeef708a87d5...5b1984ce5a01d66b2630f76ef47ac156980ee38e,2,3,3,6,3,2013-12-27 10:13:30,2013-12-27 10:13:30
b27bd2b10d08e16663d6554d11e0eeef708a87d5...edc550b65b19668e2a75d6e6eac99016583fded7,1,1,1,2,1,2013-12-27 04:36:09,2013-12-27 04:36:09
b27bd2b10d08e16663d6554d11e0eeef708a87d5...6daa97f47212d89bfa0dcbb7f549ecb68d1b3783,1,1,1,2,1,2013-12-26 19:13:25,2013-12-26 19:13:25
b27bd2b10d08e16663d6554d11e0eeef708a87d5...2804fbbdb1e87c5ce335205a3a4f0aadde60c9e4,2,2,2,4,3,2013-12-26 17:28:20,2013-12-26 17:28:20
b27bd2b10d08e16663d6554d11e0eeef708a87d5...27912f9c21c3dfb20f8d1d037f8c085281de5b0e,3,45,2,47,5,2013-12-26 13:54:13,2013-12-23 09:37:38
d66d10970d2dcd4a6be0de6fef2274e4eefa5657...a87f03768f87c3ebe62b7aaf94380eb56239bd4e,1,2,2,4,2,2014-03-24 13:00:01,2014-03-19 00:05:10
ae1a3148242907b21e9952f1964919622b4f3129...842ad4a42590484ee12a9e76ffde90a300e9f3b8,2,15,1,16,2,2014-03-25 02:58:16,2014-03-24 03:13:01
ae1a3148242907b21e9952f1964919622b4f3129...dab09af518a1ab573b30f12895b448790bc66222,3,17,7,24,4,2014-03-24 02:30:37,2014-03-24 02:17:01
ae1a3148242907b21e9952f1964919622b4f3129...6672d6492f8a118d6ef26efaec38d3b1bab9223a,1,1,1,2,1,2014-03-23 22:49:22,2014-03-23 22:49:22
ae1a3148242907b21e9952f1964919622b4f3129...3704d85bc49e76891f37f3b14d6fddb499921ed8,1,2,2,4,2,2014-03-22 20:44:13,2014-03-22 20:44:13
ae1a3148242907b21e9952f1964919622b4f3129...07833d16760bf30e4c9c84653909d4efe2dbcaff,3,0,0,0,0,2014-03-22 20:38:22,2014-03-22 20:37:54
ae1a3148242907b21e9952f1964919622b4f3129...fa340595746ba18fae3c6422ff4c9ea4af8e3023,1,8,8,16,5,2014-03-22 19:36:54,2014-03-22 19:36:54
fa340595746ba18fae3c6422ff4c9ea4af8e3023...760f827ba0257d6664f429a832d1962fcac6e58e,2,1,4,5,3,2014-03-22 19:40:42,2014-03-22 19:40:42
fb919a631c16f0046c5599a9e9e9fa38ff4a699a...6d9dccbec802d8d5956f31eda4af4f03fafd66b8,1,1,1,2,1,2014-03-21 11:26:34,2014-03-21 11:26:34
6d9dccbec802d8d5956f31eda4af4f03fafd66b8...895c913247e0444374316ea46dec9304ce1efdf4,3,3,3,6,3,2014-03-21 11:42:59,2014-03-21 11:42:59
fb919a631c16f0046c5599a9e9e9fa38ff4a699a...44aa6b90ddde3a7babc6ed9f50d73040d6184789,3,39,0,39,3,2014-03-21 09:25:25,2014-03-21 09:18:19
d5437c483899b8f1d9871e9c8af1976899a87351...c6860a5828fe569f6a81e2c96bb7e4a32f572a29,1,12,8,20,6,2015-02-23 23:18:45,2015-02-23 23:18:45
24c8381de281576deeaacf6ba1b46271767594d8...e363f2e67544e210e92acc06a5af90d91c0aa684,3,18,0,18,4,2015-02-24 06:51:24,2015-02-24 06:50:40
7d5d5e53b11db478946e6c477a9a59b0be9b6d5b...5c801602189bdf179432e9ef5885f6c6fef438f2,12,18,18,36,17,2015-01-18 15:29:37,2015-01-18 15:29:37
7d5d5e53b11db478946e6c477a9a59b0be9b6d5b...d84a2ab641f7e69ff597954ad0fb3aa5fdffe1e4,1,2,2,4,2,2015-01-18 07:01:45,2015-01-18 07:01:45
acc3366827ea5ad8ddcf872fabaefc94b97f0d9f...99647a1b706246bd59d016bb8223d4e1de45724e,1,10,0,10,2,2015-01-17 03:36:44,2015-01-17 03:36:44
18b7acc399e05c2a1aeb42ee5f738778b0289dcf...46ed6fb58fc33d084751e77fe7d5521d108a1e43,7,8,30,38,8,2015-01-15 01:22:36,2015-01-15 01:22:36
46ed6fb58fc33d084751e77fe7d5521d108a1e43...36acf5b29318ff5f680dbfa3525e80a153b91a33,1,1,1,2,1,2015-01-15 01:22:48,2015-01-15 01:22:48
36acf5b29318ff5f680dbfa3525e80a153b91a33...a7dddd1bcab578ce0e28069da256face8039a2da,1,114,0,114,1,2015-01-15 01:34:39,2015-01-15 01:34:39
a7dddd1bcab578ce0e28069da256face8039a2da...973449b56748f7e65384ea9f66d72ed9226e0b08,1,9,9,18,7,2015-01-15 01:40:35,2015-01-15 01:40:35
973449b56748f7e65384ea9f66d72ed9226e0b08...8e36070cce9ba4b414397674d1f236c33f2689cc,1,3,3,6,3,2015-01-15 01:44:59,2015-01-15 01:44:59
dbd347bfa00e133da8ac178612ed8c30ef871ca4...ebfc7d052bbde2f0adcd986a207788d2aec7d85d,2,7,3,10,3,2015-03-18 15:37:29,2015-03-18 15:37:29
dbd347bfa00e133da8ac178612ed8c30ef871ca4...ce8359c15173e92af0d083dbfd1d618e18645e24,1,2,2,4,2,2015-03-18 15:25:50,2015-03-18 15:25:50
dbd347bfa00e133da8ac178612ed8c30ef871ca4...9d938fd77da033f09530571a6194609aee8bbc7b,5,18,12,30,7,2015-03-18 13:28:50,2015-03-17 14:51:14
dbd347bfa00e133da8ac178612ed8c30ef871ca4...88f9ed3d196776295294d540556216b95d0bcd60,2,7,7,14,3,2015-03-18 13:08:26,2015-03-17 09:28:50
88f9ed3d196776295294d540556216b95d0bcd60...31e484085a22ccc012b825670e5bbff25684933c,1,19,20,39,4,2015-03-18 13:08:26,2015-03-17 09:29:06
31e484085a22ccc012b825670e5bbff25684933c...6581aea3bf8e3529aa4fed85ccd923b2afb630b5,2,10,2,12,3,2015-03-18 13:08:26,2015-03-17 09:29:17
6581aea3bf8e3529aa4fed85ccd923b2afb630b5...d328b4166ed235346e3ea841f178a52224c23c99,1,10,4,14,4,2015-03-18 13:08:26,2015-03-17 09:33:25
d328b4166ed235346e3ea841f178a52224c23c99...5adb1128dcca2810a32b7b974372970c6d36a98c,1,7,3,10,2,2015-03-18 13:08:26,2015-03-17 10:43:43
5adb1128dcca2810a32b7b974372970c6d36a98c...b1b8261f56d35e471bc32b0f2050e27650b7c797,6,65,17,82,12,2015-03-18 15:17:43,2015-03-17 17:37:50
dbd347bfa00e133da8ac178612ed8c30ef871ca4...120f032b1a6c7df431da6821d22c806b6c9bf4ca,3,2,20,22,4,2015-03-18 07:46:53,2015-03-17 14:39:21
dbd347bfa00e133da8ac178612ed8c30ef871ca4...9e5738b0072f8715d52801f3469be9f3742beb97,14,202,39,241,28,2015-03-18 07:42:42,2015-03-13 10:39:26
8aa2cd465c0aee74fcc14a3282a4885908aec88b...63d0bf1f5e45f46ed346425585f258fc22acee8a,2,2,2,4,3,2015-03-18 05:59:45,2015-03-18 05:59:45
148740cc6769b0faf7ee564552143ccd0a18768b...ab7a79bf3bb47fd1c9d82da0bb29a3cdf0246cdc,9,80,40,120,10,2015-01-21 01:34:23,2015-01-20 23:23:37
148740cc6769b0faf7ee564552143ccd0a18768b...9371c6b90136547e3622622510af9894fc27aeb0,3,124,0,124,3,2015-01-21 00:46:27,2015-01-21 00:46:27
9371c6b90136547e3622622510af9894fc27aeb0...62c00661c43334f8e2bbed508d9517529dbee7e0,2,8,3,11,4,2015-01-21 00:47:29,2015-01-21 00:47:29
62c00661c43334f8e2bbed508d9517529dbee7e0...09de0bfc37c54b84d5a49dbce8c11cfd2f3cfb80,1,0,2,2,1,2015-01-21 00:55:12,2015-01-21 00:55:12
09de0bfc37c54b84d5a49dbce8c11cfd2f3cfb80...e9d6d1e51afa9f46f19748977739f7d2c078b84f,2,40,1,41,3,2015-01-21 00:55:35,2015-01-21 00:55:35
e9d6d1e51afa9f46f19748977739f7d2c078b84f...737f6516e697ec5876fcdeb55acedfeefd24c9cc,3,22,3,25,5,2015-01-23 17:14:45,2015-01-23 17:14:45
737f6516e697ec5876fcdeb55acedfeefd24c9cc...103a1bb06d00c0b3ee1f0148ee8fc809f4f276f8,5,24,14,38,11,2015-01-23 18:28:38,2015-01-23 18:28:38
103a1bb06d00c0b3ee1f0148ee8fc809f4f276f8...7c701acf573f95cce7f8b1b7756de5d73404f09b,5,16,12,28,13,2015-01-23 19:01:09,2015-01-23 19:01:09
7c701acf573f95cce7f8b1b7756de5d73404f09b...041bad0fe17a31eb7becde3a656a1d0e50dc85bf,1,4,11,15,3,2015-01-23 19:10:06,2015-01-23 19:10:06
041bad0fe17a31eb7becde3a656a1d0e50dc85bf...a720dde67c2b488117ed57f7f07ab55f8150c352,4,9,22,31,4,2015-01-23 19:55:41,2015-01-23 19:55:41
4ade9bf24da50091e3a3fc310ca9070caed19a75...e36334c77071b565f6d533bc1dcb2ecf78e6b7cc,1,6,0,6,1,2015-01-23 02:39:05,2015-01-23 02:39:05
4ade9bf24da50091e3a3fc310ca9070caed19a75...1511999d88d4a6a7c8a42f93dff93097b92682b1,2,27,3,30,4,2015-01-23 01:51:35,2015-01-23 01:51:35
1718075a02a0774029f3739be5b0717bc9224a04...953c1fff8f242f09f3f16998112931d48d6a5ecc,1,1,1,2,1,2015-01-29 01:00:40,2015-01-29 01:00:40
1718075a02a0774029f3739be5b0717bc9224a04...ef315dda5f6b252151feb320af0abdea12690df4,2,1,4,5,2,2015-01-29 00:59:25,2015-01-29 00:59:25
1718075a02a0774029f3739be5b0717bc9224a04...54f6d8c7b5a1c67a222011c35ad70909da0e686d,3,20,2,22,6,2015-01-28 23:57:31,2015-01-27 23:37:19
54f6d8c7b5a1c67a222011c35ad70909da0e686d...d74e732299dc2c896a64350ddfdbdb2bb55a5fc6,1,2,0,2,1,2015-01-28 23:58:25,2015-01-28 23:53:16
6e1f9e746cb5dc555003b5398c46113ce83fceae...a9288e554e55e843b95ab6f8109a4c610af64c83,8,40,163,203,31,2015-01-29 08:53:43,2015-01-29 08:53:43
a9288e554e55e843b95ab6f8109a4c610af64c83...c9f18d4587f16eb16b8b902d69576520c08b7f5a,1,2,2,4,1,2015-01-29 09:03:20,2015-01-29 09:03:20
b7cf72f6eaad22a08081f4576447e52cebd5cf15...23c31a0b12eaae7f7f25f30eca1066968bcb6059,2,8,2,10,3,2015-01-30 07:06:43,2015-01-30 07:06:43
23c31a0b12eaae7f7f25f30eca1066968bcb6059...b21565f18d297c167f05f4c7861e01c916c15682,1,2,2,4,2,2015-01-30 07:28:38,2015-01-30 07:28:38
b21565f18d297c167f05f4c7861e01c916c15682...d5d1802096ab8751dfa1e4cf535e9bee79457328,1,2,2,4,2,2015-01-30 07:48:00,2015-01-30 07:48:00
d5d1802096ab8751dfa1e4cf535e9bee79457328...c47328948b5fff218c68279260a57ab6b03e7423,1,3,0,3,1,2015-01-30 08:22:51,2015-01-30 08:22:51
6ca23357c439c3396ee5911ecd0099d8a48968d9...61d07eabfc7b9ad44b0d50f73003cabe28a04b42,1,1,1,2,1,2015-02-04 21:54:19,2015-02-04 21:54:19
6b0199ffc1c8e6a79b68a510052a1d1713afc29d...1bf9fa8c7fc027b5273c143949e57eac9bef52a4,1,3,1,4,1,2015-02-24 15:28:23,2015-02-24 15:28:23
1bf9fa8c7fc027b5273c143949e57eac9bef52a4...5179c5830bb3d8602eb25cc00f53be697c6010ac,1,4,3,7,2,2015-02-24 17:13:11,2015-02-24 15:28:40
6b0199ffc1c8e6a79b68a510052a1d1713afc29d...198d75b3a8516e75c595c5baaa6359c239bc800d,1,2,1,3,2,2015-02-21 10:13:31,2015-02-20 13:58:42
6b0199ffc1c8e6a79b68a510052a1d1713afc29d...00408f37e34f37f1299df6957f62bfa7ff341749,13,12,13,25,25,2015-02-20 16:20:03,2015-02-20 15:30:15
6b0199ffc1c8e6a79b68a510052a1d1713afc29d...8830cfaa60806fa637785535b3ca35a8c3b9dcff,1,8,3,11,2,2015-02-20 14:06:06,2015-02-20 14:06:06
6b0199ffc1c8e6a79b68a510052a1d1713afc29d...e0edea4ae949a006c051768d073737436ba50b2b,1,0,3,3,2,2015-02-20 13:35:29,2015-02-20 13:35:29
6b0199ffc1c8e6a79b68a510052a1d1713afc29d...874640123b9b508fef40d4285a7c28d7e4653dd7,1,1,1,2,1,2015-02-20 13:20:42,2015-02-20 13:20:42
6b0199ffc1c8e6a79b68a510052a1d1713afc29d...eb210f4a1876f0dbf70b8c3ae855b6a986777421,2,47,37,84,10,2015-02-20 11:22:53,2015-02-20 11:22:53
eb210f4a1876f0dbf70b8c3ae855b6a986777421...4310431ee73fdd6aa3874aaccc0a901252e7f61f,2,26,0,26,2,2015-02-20 11:44:07,2015-02-20 11:44:07
4310431ee73fdd6aa3874aaccc0a901252e7f61f...00ca490259de684f4240de4f61728b8eaefbb13e,3,48,0,48,4,2015-02-20 12:13:48,2015-02-20 12:13:48
00ca490259de684f4240de4f61728b8eaefbb13e...73d12d6e6db807d6d15a665cddc0ca9a47bff4eb,1,1,0,1,1,2015-02-20 12:24:51,2015-02-20 12:24:51
6b0199ffc1c8e6a79b68a510052a1d1713afc29d...5493e27d53d157c1d43dca6c29815f4bc3a39c5c,1,1,1,2,1,2015-02-20 11:00:42,2015-02-20 11:00:42
5493e27d53d157c1d43dca6c29815f4bc3a39c5c...51b234cfb6582650f362cf2339d0f8b0b5a10345,1,1,1,2,1,2015-02-20 11:03:28,2015-02-20 11:03:28
6b0199ffc1c8e6a79b68a510052a1d1713afc29d...7ce664c88e8d160176e89311d833837f9813de77,1,1,0,1,1,2015-02-20 09:47:01,2015-02-20 09:47:01
6b0199ffc1c8e6a79b68a510052a1d1713afc29d...0632e85c82eeb76c9b61e497655c9cf2ef5dc262,3,11,10,21,5,2015-02-20 09:23:34,2015-02-20 09:23:34
1b76554125f4c24df9d2f2cc2f76abd3a1c61fd6...87f89bc97099cb065aa797f14684e96c9624b2f3,1,8,0,8,1,2014-07-04 12:19:59,2014-07-04 12:19:59
494d15cfdeb714a439e0536178219fc4928421d5...9d0614edbbcb5628e4d1b1424f7a426006e80c73,1,1,0,1,1,2014-09-08 12:28:34,2014-09-08 12:24:36
9d0614edbbcb5628e4d1b1424f7a426006e80c73...59d2f6db757e42a9a0db02c01852de2d53847191,2,2,2,4,2,2014-09-08 12:28:42,2014-09-08 12:25:20
3cb99017c7898050995127a8090250529196ead7...fe1553e943fd1c0734506d888560fc97bf22aafc,1,1,1,2,1,2014-07-07 21:25:05,2014-07-07 21:21:45
3cb99017c7898050995127a8090250529196ead7...e97834567bcd37633379aae9dad97db476994cac,1,1,1,2,1,2014-07-07 19:32:46,2014-07-07 19:32:46
8031be73fede0718b81c1b9d038be8a7c81a946a...8d106bed3c2146217697e9a13e637dd8c5d60c48,2,4,4,8,4,2014-07-03 07:48:16,2014-07-03 07:48:16
ec8d39897c76439c71b79738c5a348b36a03753b...0cedd7039a882b67f1a94875f4e99de4c63b173b,1,4,1,5,1,2014-06-04 16:20:25,2014-06-04 16:20:25
0cedd7039a882b67f1a94875f4e99de4c63b173b...181aa2b9160347ad23de3ef1e6f5ce45234261e1,1,1,1,2,1,2014-06-04 16:23:31,2014-06-04 16:23:31
ec8d39897c76439c71b79738c5a348b36a03753b...d95d56f0b9b2a321e18bb0f92b008f58e37b20a7,1,5,1,6,2,2014-06-04 15:07:15,2014-06-04 15:07:15
d95d56f0b9b2a321e18bb0f92b008f58e37b20a7...ad60701e9e097a046f65048bd4e707da512daa07,1,2,0,2,1,2014-06-04 15:10:53,2014-06-04 15:10:53
ad60701e9e097a046f65048bd4e707da512daa07...47937802a2c29f6ec4a1bd15bb06e8e2866fdb7f,2,42,0,42,2,2014-06-04 15:51:01,2014-06-04 15:51:01
47937802a2c29f6ec4a1bd15bb06e8e2866fdb7f...f1ec62f465711c136d9ffc84b328f7c55e68fa9c,6,35,20,55,9,2014-06-04 15:52:35,2014-06-04 15:52:35
f1ec62f465711c136d9ffc84b328f7c55e68fa9c...eeef2c7350502bb1f77a723ff4677901d2a68926,2,2,2,4,2,2014-06-04 17:39:43,2014-06-04 17:39:43
eeef2c7350502bb1f77a723ff4677901d2a68926...9654b098c6478e7c17bc8c848f9284daa26ead76,2,9,10,19,4,2014-06-05 06:29:24,2014-06-05 06:29:24
9d09d616af77936f0e278b991253ac7a2b0fccf3...1c23333f344205f97fc909af724ed88c2ee45c2b,3,10,7,17,7,2014-06-10 17:59:26,2014-06-10 17:59:26
1c23333f344205f97fc909af724ed88c2ee45c2b...de55d7aa577e52315866f605a08c43e547877eec,2,4,4,8,4,2014-06-10 17:59:51,2014-06-10 17:59:51
cc28b21adce61206e5ca96dfe23bab4cec9a0400...0853eebd1c1d80fdcb467a2cafede6f20e62759f,1,6,12,18,5,2014-05-24 08:11:45,2014-05-24 08:11:45
0853eebd1c1d80fdcb467a2cafede6f20e62759f...5cfaf945cdad16baf877c873c26bc58b004707ae,7,75,58,133,23,2014-05-24 10:06:44,2014-05-24 10:06:44
5cfaf945cdad16baf877c873c26bc58b004707ae...50f3280e019290a1c1434967f0beb24c0e938e9d,1,0,17,17,1,2014-05-24 10:15:23,2014-05-24 10:15:23
3553e36d169e18025a2409b7055fff082d89f630...e10136999437bfcfd810ced0c629a84101e4a007,2,4,4,8,3,2014-05-27 11:06:20,2014-05-27 11:06:20
e10136999437bfcfd810ced0c629a84101e4a007...82855e078f7cfa55396522305d7f3408dad4019a,2,2,2,4,2,2014-05-28 10:53:10,2014-05-27 14:36:14
06154af09ab5cf1071a25bbc5197cd15ee632932...d30454e112378c24cc9edfd7b511ca42bdb1e399,1,1,1,2,1,2014-07-29 07:29:12,2014-07-29 07:29:12
3a279bb2a9ce88e722745681bff308af601b4845...126eefc5b84272e15ecdd856a97234de6ca10d0c,1,2,2,4,1,2014-05-19 12:45:55,2014-05-19 12:45:55
2a8aa7429b6f489acd07c99e2e33a09c21c2ba01...b2ec09e5d6e430eb4d4fd248364de9fe3bc9a116,1,1,1,2,1,2014-05-26 15:09:31,2014-05-26 15:09:27
2a8aa7429b6f489acd07c99e2e33a09c21c2ba01...040b3be5b1e1a0212c4c0073dfb252c26adbfc7d,1,2,0,2,1,2014-05-26 14:15:12,2014-05-26 14:15:12
2a8aa7429b6f489acd07c99e2e33a09c21c2ba01...75e90cb45660bd9861a047d0cd4f630ca2e71dd3,2,35,2,37,2,2014-05-26 13:38:18,2014-05-26 13:38:18
75e90cb45660bd9861a047d0cd4f630ca2e71dd3...c7a55309308aeffb65ac79dbe4696fa87a0e9f7c,1,5,3,8,3,2014-05-26 13:40:44,2014-05-26 13:40:44
c7a55309308aeffb65ac79dbe4696fa87a0e9f7c...fe10f37199a04b92dd5bf2b713d49849491f9dfc,1,6,6,12,5,2014-05-26 13:54:06,2014-05-26 13:54:06
2a8aa7429b6f489acd07c99e2e33a09c21c2ba01...8bec6b0bcb100b30a43fcd9c6649d1bee113b6a7,3,24,14,38,10,2014-05-26 12:17:46,2014-05-26 12:17:46
8bec6b0bcb100b30a43fcd9c6649d1bee113b6a7...3b2b3cff04993c7247e953c10aa8c6fb5e8d6ddb,3,43,12,55,4,2014-05-26 12:54:03,2014-05-26 12:53:34
3b2b3cff04993c7247e953c10aa8c6fb5e8d6ddb...f8a6d3405ea3a25f5b0776241831deb037020fc6,2,65,3,68,3,2014-05-26 13:47:54,2014-05-26 13:47:54
f8a6d3405ea3a25f5b0776241831deb037020fc6...43e7b8fa075a2744b2debf11f52d1df731950aa8,1,1,1,2,1,2014-05-26 13:55:41,2014-05-26 13:55:41
43e7b8fa075a2744b2debf11f52d1df731950aa8...9b2a13497dfc1fc97ac5d84f4074729cda040e2a,1,1,0,1,1,2014-05-26 13:58:03,2014-05-26 13:58:03
2a8aa7429b6f489acd07c99e2e33a09c21c2ba01...23bcb9cb0d294611c3bcd1b453dd67ee73d50dff,1,9,0,9,1,2014-05-26 07:09:27,2014-05-26 07:09:27
23bcb9cb0d294611c3bcd1b453dd67ee73d50dff...9f6709d8c4bcd72cfa7c52f7e3158da6d117b273,1,2,2,4,2,2014-05-26 07:11:09,2014-05-26 07:11:09
9f6709d8c4bcd72cfa7c52f7e3158da6d117b273...f39d8a8a6006ab8d5e3aa747036be586684718aa,1,3,1,4,2,2014-05-26 07:12:57,2014-05-26 07:12:57
f39d8a8a6006ab8d5e3aa747036be586684718aa...1748073315e18a1211ca9502d5d227e95d844bcc,1,1,1,2,1,2014-05-26 07:14:44,2014-05-26 07:14:44
a54408b9ed65a02bce73bd3ce3eb689a05cd0a93...8b9b34f8427766c0eac65e6b16a7437acd5fcb9b,1,1,0,1,1,2014-05-12 10:06:25,2014-05-12 10:06:25
32b9ec50dddb8a82ffceefe17c4cc6fbaacc1ed4...e8f8abddb0e56dd5704652360d286068c1948583,92,306,895,1201,92,2014-02-04 15:11:30,2014-02-04 15:11:30
45da59daab5878eb20adc402fbd9c9f44407ed75...2ada4ef0622eda6a90169dc3aef101883b27e87e,6,68,85,153,39,2014-08-15 07:03:18,2014-08-15 07:03:18
275a5281d5f35bf2243a0b5814b8fb83f1561105...e043da1376d3639e1ab7c4d569f4fc7627d9ecf1,1,53,16,69,10,2014-07-15 19:53:20,2014-07-15 19:53:20
275a5281d5f35bf2243a0b5814b8fb83f1561105...3780444ccb209408f46105b9dc05953ef47202bc,1,1,1,2,1,2014-07-15 12:27:54,2014-07-15 12:27:54
3780444ccb209408f46105b9dc05953ef47202bc...45623089e2325494cf79c5b832eeb08d5598b2fe,7,169,116,285,11,2014-07-15 12:34:06,2014-07-15 12:34:06
45623089e2325494cf79c5b832eeb08d5598b2fe...3dc347a369783f2a1fec3b6cc724a9b41a43283c,2,28,16,44,2,2014-07-15 13:05:56,2014-07-15 13:05:56
3dc347a369783f2a1fec3b6cc724a9b41a43283c...be5b6db883ee634dc53e0a50ac57f424507d7a7d,17,165,192,357,31,2014-07-15 15:28:21,2014-07-15 15:28:21
be5b6db883ee634dc53e0a50ac57f424507d7a7d...1d5965267b83f84d00efcddc624813b010e6510a,1,1,4,5,2,2014-07-15 16:42:51,2014-07-15 16:42:51
275a5281d5f35bf2243a0b5814b8fb83f1561105...56398ea1611b4bf1b3e27cc057ffb049e78e5173,6,17,18,35,10,2014-07-15 11:25:11,2014-07-15 11:25:11
56398ea1611b4bf1b3e27cc057ffb049e78e5173...44b819833407b81fd97873bebffc939c23294595,1,1,1,2,1,2014-07-15 12:30:05,2014-07-15 12:30:05
44b819833407b81fd97873bebffc939c23294595...8968f6d874171edc4a95027ac25d2cf83e8b7858,2,8,4,12,3,2014-07-16 07:51:20,2014-07-16 07:51:20
8968f6d874171edc4a95027ac25d2cf83e8b7858...188b6f48d4a29a254f4d8c5b0c810729888df47c,1,3,3,6,3,2014-07-16 08:01:13,2014-07-16 08:01:13
188b6f48d4a29a254f4d8c5b0c810729888df47c...c0a95947bcc3b2321f28ecfe72519c69e5c81e74,1,2,2,4,2,2014-07-17 12:03:17,2014-07-17 12:03:17
275a5281d5f35bf2243a0b5814b8fb83f1561105...dcc6302c851df21a1a87f5019bb208ef40eb1d58,1,2,2,4,2,2014-07-15 09:59:37,2014-07-15 09:59:37
dcc6302c851df21a1a87f5019bb208ef40eb1d58...b916bf4368a2f98ad56e395376888a8126e1563a,1,0,1,1,1,2014-07-15 10:27:29,2014-07-15 10:27:29
275a5281d5f35bf2243a0b5814b8fb83f1561105...cc6edc416e48aae0244f9217086fcab184593b12,1,1,1,2,1,2014-07-15 07:34:05,2014-07-15 07:34:05
4809cbaef0a8df5da6d65e476f32f358ba0278cd...4b022747f4c52ce506c2bc503257aaaf6043e822,1,2,1,3,2,2014-08-03 09:56:08,2014-08-03 09:56:08
4809cbaef0a8df5da6d65e476f32f358ba0278cd...dc8e6de062d9be0953878f35b88fe977576f8bdb,1,10,10,20,10,2014-08-03 09:44:37,2014-08-03 09:44:37
024e0577c6b6ded30ee09536082bd24405bda1e5...df3c466e37fdd6a08b0274123d34997a2c006ba9,2,2,3,5,3,2014-06-27 17:50:36,2014-06-27 17:50:36
024e0577c6b6ded30ee09536082bd24405bda1e5...ec61dfdc8cea4c6a3e8a03790eb1c225f8562d27,1,24,0,24,1,2014-06-26 14:09:15,2014-06-26 13:38:11
024e0577c6b6ded30ee09536082bd24405bda1e5...b5007c156581be092fd8d42706cb5ab48ada8f81,2,5,5,10,5,2014-06-26 12:09:17,2014-06-26 12:09:17
024e0577c6b6ded30ee09536082bd24405bda1e5...1dab15940db4c77ac23f49ece7eee2847d4614aa,10,39,40,79,24,2014-06-26 11:30:07,2014-06-26 11:30:07
1dab15940db4c77ac23f49ece7eee2847d4614aa...04516027df466747168bd80507aff62e61ac0d2d,8,8,16,24,9,2014-06-26 11:49:09,2014-06-26 11:49:09
04516027df466747168bd80507aff62e61ac0d2d...3a21c904dda9aa9c701675ccc6d1c15b20a745b3,8,20,16,36,13,2014-06-26 12:00:09,2014-06-26 12:00:09
3a21c904dda9aa9c701675ccc6d1c15b20a745b3...98ba075c327c20f84bb465907ff1d954538e0e39,13,45,44,89,26,2014-06-26 12:11:45,2014-06-26 12:11:45
98ba075c327c20f84bb465907ff1d954538e0e39...16a0a4aeccbd2fd2998262eb9cba7bb45b1b7f80,2,9,4,13,4,2014-06-26 13:49:22,2014-06-26 13:49:22
16a0a4aeccbd2fd2998262eb9cba7bb45b1b7f80...8f60b5b4fc9c4bc5c4e727a90b6e03acbbe70d54,5,12,11,23,9,2014-06-26 13:57:10,2014-06-26 13:57:10
8f60b5b4fc9c4bc5c4e727a90b6e03acbbe70d54...cb74c014ea6d27314143ffd4975717b1acee607a,4,7,6,13,5,2014-06-26 14:00:05,2014-06-26 14:00:05
cb74c014ea6d27314143ffd4975717b1acee607a...f86afb732b0842cc1e65e504a60016998385a3dc,3,4,6,10,3,2014-06-26 15:40:13,2014-06-26 15:40:13
f86afb732b0842cc1e65e504a60016998385a3dc...e382c8dfc7fb4bdbf57c770338805a1e17915fd1,4,10,6,16,6,2014-06-26 15:45:33,2014-06-26 15:45:33
e382c8dfc7fb4bdbf57c770338805a1e17915fd1...2acde87e0d223bbc3ecd15777b9a1048d6bc5172,8,24,14,38,15,2014-06-26 15:51:11,2014-06-26 15:51:11
2acde87e0d223bbc3ecd15777b9a1048d6bc5172...8fee5a0572372b1d3a69fa1816380eb11182afaf,17,84,90,174,53,2014-06-26 20:24:17,2014-06-26 20:24:17
8fee5a0572372b1d3a69fa1816380eb11182afaf...76dca50abee38e1bff2e551534c2b40bdb9d5082,2,2,2,4,2,2014-06-26 20:40:08,2014-06-26 20:40:08
76dca50abee38e1bff2e551534c2b40bdb9d5082...0f550aa386eac5daf2c357786e76afb42e6b0ac2,16,0,23,23,16,2014-06-26 20:57:55,2014-06-26 20:57:55
0f550aa386eac5daf2c357786e76afb42e6b0ac2...ab29ddcfc435527a2d59f891d9b043569e238a29,1,1,1,2,1,2014-06-26 21:01:16,2014-06-26 21:01:16
ab29ddcfc435527a2d59f891d9b043569e238a29...f0de4b539f493e578068bd42d23129d81acbfb63,1,8,8,16,8,2014-06-26 21:28:32,2014-06-26 21:28:32
f0de4b539f493e578068bd42d23129d81acbfb63...9231b91a401245e44b57dbe688eeabfc45dd4bea,1,2,6,8,2,2014-06-26 21:37:04,2014-06-26 21:37:04
9231b91a401245e44b57dbe688eeabfc45dd4bea...8daa69a3ebd98fc293508570aed3e1f2eec4359f,1,2,1,3,2,2014-06-30 11:02:52,2014-06-30 11:02:52
8daa69a3ebd98fc293508570aed3e1f2eec4359f...13f017f01b8363466576c1934b42a450bb1cc19a,1,11,47,58,4,2014-06-30 11:22:09,2014-06-30 11:22:09
13f017f01b8363466576c1934b42a450bb1cc19a...4967c087862e5c7c5009605000380d4451ce07ec,6,4,105,109,6,2014-06-30 13:43:32,2014-06-30 13:43:32
1f3f874142775ba6d074460a570c69e1fb02e096...54faf7871ee43115e972f3cb70d93fde01f030e1,1,6,0,6,1,2013-09-02 21:09:20,2013-09-02 21:09:20
1f3f874142775ba6d074460a570c69e1fb02e096...6bf117c601eda2ae3045644ab778d167955cd0c3,4,99,23,122,4,2013-09-02 20:35:40,2013-09-02 20:35:40
6bf117c601eda2ae3045644ab778d167955cd0c3...71abf70458ca1f6d85bc828b215931eaf3639b5d,3,28,40,68,6,2013-09-02 20:50:45,2013-09-02 20:50:45
71abf70458ca1f6d85bc828b215931eaf3639b5d...7dfb2b6379719cd6c3ee7b919f973146e9dbc645,1,0,2,2,2,2013-09-02 20:52:58,2013-09-02 20:52:58
7dfb2b6379719cd6c3ee7b919f973146e9dbc645...cdc4d64da6fc6fbb6c3b78c5e07cdddd91a4c900,1,1,1,2,1,2013-09-03 20:58:42,2013-09-03 20:58:42
cdc4d64da6fc6fbb6c3b78c5e07cdddd91a4c900...b45e92646e3f91c60e25197d68f72f50b1754c99,1,85,0,85,1,2013-09-03 21:04:27,2013-09-03 21:04:27
b45e92646e3f91c60e25197d68f72f50b1754c99...0df1cf7fcceee10db1e66ecf99dcd453d9e687a4,1,33,67,100,11,2013-09-03 21:06:13,2013-09-03 21:06:13
0df1cf7fcceee10db1e66ecf99dcd453d9e687a4...9028999c933a3db790ef4645474d7b04888a308f,1,15,9,24,7,2013-09-03 21:06:29,2013-09-03 21:06:29
9028999c933a3db790ef4645474d7b04888a308f...3707cc119b291c06703ebf31456c4b8140c324c6,2,1,70,71,4,2013-09-03 21:12:00,2013-09-03 21:12:00
3707cc119b291c06703ebf31456c4b8140c324c6...3832b2aa679d71dc857f4a6083f0038a2eeb7a9f,2,128,79,207,10,2013-09-03 21:53:01,2013-09-03 21:53:01
3832b2aa679d71dc857f4a6083f0038a2eeb7a9f...7b8bd93e673a6ace673cab00e0cc10489d64437d,2,56,88,144,6,2013-09-03 21:53:13,2013-09-03 21:53:13
7b8bd93e673a6ace673cab00e0cc10489d64437d...8e238f42732e5968dc46e3f08d853d0f3c9b2760,2,1,18,19,3,2013-09-04 13:20:40,2013-09-04 13:20:40
b349af202ff55cfbed8168b9266b43509f014f8e...76a07394547a8df1ac1553ecd52f3e6e2d20a8af,5,10,4,14,6,2013-09-09 13:32:43,2013-09-09 13:32:43
76a07394547a8df1ac1553ecd52f3e6e2d20a8af...e0ca2adafda95dbb0476847499d662623ff0b6be,4,36,31,67,9,2013-09-09 14:11:58,2013-09-09 14:11:58
b349af202ff55cfbed8168b9266b43509f014f8e...9e9f0551415a8c606105c6277048becff981b460,2,24,7,31,3,2013-09-09 13:20:43,2013-09-09 13:20:43
c2c11e655f055353d9eddb6544cf5f1a4d01509f...0235c2a7f3d9424cff075ea366b8f4990824e1db,1,2,3,5,2,2013-09-11 17:27:50,2013-09-11 17:27:50
0235c2a7f3d9424cff075ea366b8f4990824e1db...694768e51870ebb24a25730188e018782d3175ca,2,5,1,6,2,2013-09-11 18:00:16,2013-09-11 18:00:16
626359831402aeede4c4cb12cb10c7534a0dae79...8248e1f2b83895f394a3fecd25dcea4a8b40303b,4,243,14,257,11,2013-09-04 17:17:17,2013-09-04 15:19:03
8248e1f2b83895f394a3fecd25dcea4a8b40303b...fadcc251899095e37b97091a03b2025b1f39c7a6,2,10,5,15,12,2013-09-05 14:41:57,2013-09-05 14:17:40
626359831402aeede4c4cb12cb10c7534a0dae79...9109a207589c3a3d085005ee87049bba6aeecc1a,1,14,2,16,3,2013-09-04 15:15:42,2013-09-04 15:15:42
5b1984ce5a01d66b2630f76ef47ac156980ee38e...32c7310f4a2ba8b408f0dd0cc17eba9b92159817,1,19,9,28,7,2013-12-27 12:11:19,2013-12-27 12:11:19
32c7310f4a2ba8b408f0dd0cc17eba9b92159817...00056c82f20ce900cec9b9fd17e3950e80fbb693,2,26,0,26,3,2013-12-27 12:25:03,2013-12-27 12:25:03
00056c82f20ce900cec9b9fd17e3950e80fbb693...3998bb3abad41abf6ba67ee04c37bdfc48e9313e,1,4,1,5,2,2013-12-27 12:28:24,2013-12-27 12:28:24
5b1984ce5a01d66b2630f76ef47ac156980ee38e...498ec08da3a7dae92b317e838689e73935fcb38a,1,1,0,1,1,2013-12-27 11:38:29,2013-12-27 11:38:29
a87f03768f87c3ebe62b7aaf94380eb56239bd4e...5e985a7eed7317d4f0ed323c4f6f7d0f386fbde4,3,2,4,6,4,2014-03-24 13:22:11,2014-03-24 13:22:11
a87f03768f87c3ebe62b7aaf94380eb56239bd4e...eb4320cb07db2b704d6e976fe9e2ac7d959b6c25,1,14,31,45,4,2014-03-24 13:20:29,2014-03-24 13:20:29
a87f03768f87c3ebe62b7aaf94380eb56239bd4e...5fbf15cb88411ebca2156dfefe993503e074ce3e,2,8,4,12,2,2014-03-24 13:10:21,2014-03-24 13:10:21
12d162993e6198df2ce62bf53e6b8182ca783fd5...1e3b5c3787bcd7f1fce775e2c3de5ce0aabc813d,3,44,60,104,8,2014-03-24 12:55:27,2014-03-13 22:34:12
1e3b5c3787bcd7f1fce775e2c3de5ce0aabc813d...2855a799fde6ec60c5bfff348f6dfa9b1e480bcc,1,1,1,2,1,2014-03-24 12:55:27,2014-03-19 00:01:17
12d162993e6198df2ce62bf53e6b8182ca783fd5...b816389182084bd0234d8409bdd4cfef41f8e502,1,5,0,5,1,2014-03-24 08:56:26,2014-03-24 08:52:50
b816389182084bd0234d8409bdd4cfef41f8e502...7862201de9e3e8229e33a28d17fb2edb691eead0,1,1,0,1,1,2014-03-24 08:57:28,2014-03-24 08:57:28
cc575875b6c46d384601037645970667a12c8017...85b5812bc21623c6a11ed92f482ac8282ec12fc1,2,13,26,39,3,2014-03-22 20:29:13,2014-03-22 20:29:13
85b5812bc21623c6a11ed92f482ac8282ec12fc1...e153469f31db106d0720e357a5e22431635f2b9e,1,4,2,6,3,2014-03-23 22:07:18,2014-03-23 22:07:18
e153469f31db106d0720e357a5e22431635f2b9e...19938156d89ea980596fd5b1d72856f3defb228a,1,26,0,26,1,2014-03-23 22:20:17,2014-03-23 22:20:17
8ae593304ba1fbb505822a464b2b645e10f5bb2c...7dd18a3ec832cb5e49932dff33f3a4ced30fe1e8,2,38,26,64,13,2014-03-21 12:52:30,2014-03-21 12:52:30
c6860a5828fe569f6a81e2c96bb7e4a32f572a29...b821a1bd41166c295ea1625ccf57b9bb48f61649,1,3,3,6,1,2015-02-24 00:29:32,2015-02-24 00:29:32
c6860a5828fe569f6a81e2c96bb7e4a32f572a29...746dd89ab010299f731c195082087d32f25698df,1,1,1,2,1,2015-02-24 00:19:03,2015-02-24 00:19:03
c6860a5828fe569f6a81e2c96bb7e4a32f572a29...cb65a3f1d965f226f19ac20c69435c3387eb39ed,3,3,3,6,3,2015-02-23 23:48:00,2015-02-23 23:48:00
d84a2ab641f7e69ff597954ad0fb3aa5fdffe1e4...5bd463c1d2a10be21344e80084072927e0f2081e,1,3,0,3,3,2015-01-18 13:09:56,2015-01-18 12:42:20
d84a2ab641f7e69ff597954ad0fb3aa5fdffe1e4...5ee99290bedb6f20ee9648d64029c383c1abb05c,2,2,2,4,2,2015-01-18 12:04:58,2015-01-18 12:04:58
d84a2ab641f7e69ff597954ad0fb3aa5fdffe1e4...1e9e3fc73dda9a76c1de1df373e7a5af7a584d06,2,2,2,4,2,2015-01-18 11:28:29,2015-01-17 09:00:52
8e36070cce9ba4b414397674d1f236c33f2689cc...c9bdc03bd9eeb4b38a2232eeb7bd9e1b14d76723,7,10,13,23,9,2015-01-15 02:42:25,2015-01-15 02:42:25
8e36070cce9ba4b414397674d1f236c33f2689cc...41353b63626a4d5eae3570015bfba72748364f35,1,1,1,2,1,2015-01-15 02:07:42,2015-01-15 02:07:42
1f21dfaeabe9e515b821139a22809fb03fccbcd9...7602cef572fd770a06eb3d94f2aef57c2693dcb6,1,1,0,1,1,2015-03-18 16:06:17,2015-03-18 14:28:32
1050f5230eec21cf47d5af262a1b3e62c07fec5d...abbb29b30c55fb44edd4f1eb0b87a8ce4a72a05d,1,18,1,19,1,2015-01-22 19:27:11,2015-01-22 19:27:11
1050f5230eec21cf47d5af262a1b3e62c07fec5d...7dd5656a5b352dd5df5dabeeebdb21d7ffd9ef03,4,200,0,200,6,2015-01-22 15:58:01,2014-10-15 06:57:35
7dd5656a5b352dd5df5dabeeebdb21d7ffd9ef03...47625ab75e2cbb55ad7a7c95dcce507b3f992e4c,2,164,158,322,101,2015-01-22 16:46:34,2015-01-22 16:46:34
1050f5230eec21cf47d5af262a1b3e62c07fec5d...ab2a6111ee029bffe908cff6b5ede51dccd89bb6,1,1,1,2,1,2015-01-21 21:36:27,2015-01-21 21:36:27
1050f5230eec21cf47d5af262a1b3e62c07fec5d...201b2f1099c6c1a963455d54bacbe473c7e27f95,1,9,0,9,1,2015-01-21 17:57:54,2015-01-21 17:57:54
201b2f1099c6c1a963455d54bacbe473c7e27f95...d9b946fb3edb3288b6ae39c8882b287639a75cbb,1,16,0,16,1,2015-01-21 18:08:15,2015-01-21 18:08:15
1050f5230eec21cf47d5af262a1b3e62c07fec5d...c68742ed560b0bbf84c9fe6f6707cf47e9ed792c,1,9,4,13,2,2015-01-21 14:14:46,2015-01-21 14:14:46
c68742ed560b0bbf84c9fe6f6707cf47e9ed792c...addb2555841510bb48bc0fb9f1a90d80a7ed87fe,1,6,4,10,4,2015-01-26 16:03:04,2015-01-26 16:03:04
1050f5230eec21cf47d5af262a1b3e62c07fec5d...bfa8d573c5ff4088f53b97b923fc06f554e82266,1,2,0,2,1,2015-01-21 08:50:17,2015-01-21 08:50:17
c70dcd290704777104a136bd038dffc68daec4ab...65e700472b471242475eb9d9e3a340c6ce24615a,4,15,13,28,7,2015-01-26 19:39:32,2015-01-26 19:39:32
65e700472b471242475eb9d9e3a340c6ce24615a...4641514cbfdcc56a0cbc5ad3444a92284df9a665,6,31,53,84,14,2015-01-26 23:59:40,2015-01-26 23:59:40
4641514cbfdcc56a0cbc5ad3444a92284df9a665...9b5b334a798233b200318ecfbff55f0284f874da,3,0,50,50,3,2015-01-27 00:04:08,2015-01-27 00:04:08
9b5b334a798233b200318ecfbff55f0284f874da...00a0d5aeeaf19ea4d72fd1890afac099026f1706,4,58,94,152,8,2015-01-27 00:24:11,2015-01-27 00:24:11
00a0d5aeeaf19ea4d72fd1890afac099026f1706...33913f9b8fef1f8df45dc26239faf8fa4cffc982,4,91,4,95,5,2015-01-27 06:08:27,2015-01-27 06:08:27
cefe81b1bbb1d257c3de35afe0de896f9f6b751c...c6e24850a3ad662d82f8e0812eb2a38df4f43c13,1,5,0,5,1,2015-01-23 17:38:11,2015-01-23 17:38:11
cefe81b1bbb1d257c3de35afe0de896f9f6b751c...22b7d2156c6d67deb85eccba5ca7e542a7f409e6,1,1,1,2,1,2015-01-23 11:36:53,2015-01-23 11:36:53
c9f18d4587f16eb16b8b902d69576520c08b7f5a...35bf471a13abe0ec68ca8ceb19f896be5ce63c46,1,1,1,2,1,2015-01-29 15:34:01,2015-01-29 15:34:01
c9f18d4587f16eb16b8b902d69576520c08b7f5a...4ce18089f6d3f242bb48fd6c72161144b38b6e29,1,1,2,3,1,2015-01-29 15:13:38,2015-01-29 15:13:38
c9f18d4587f16eb16b8b902d69576520c08b7f5a...1f0e16569f1924ed967bff9f4f78bbee874251db,4,32,17,49,9,2015-01-29 09:20:17,2015-01-29 09:20:17
1f0e16569f1924ed967bff9f4f78bbee874251db...08582f153249d91d361977d7968126a420739a8b,2,8,6,14,7,2015-01-29 16:55:57,2015-01-29 16:55:57
c47328948b5fff218c68279260a57ab6b03e7423...b4d9ceb26fc4bd9125cdbd6796a618415d8f6af7,9,203,3,206,14,2015-02-02 08:59:42,2014-07-29 15:41:55
b4d9ceb26fc4bd9125cdbd6796a618415d8f6af7...3cd1eda5a4f8e4ac95ebab558e8965724481dd97,3,6,2,8,5,2015-02-02 08:59:42,2015-01-16 11:49:50
3cd1eda5a4f8e4ac95ebab558e8965724481dd97...f79b6af18a29f8ddececb9c64de5ff6d456d1d29,2,19,9,28,5,2015-02-02 08:59:43,2015-01-25 09:35:16
f79b6af18a29f8ddececb9c64de5ff6d456d1d29...d56c2a9bc58091f906b8d0001600bad448847d4f,1,0,1,1,1,2015-02-02 08:59:43,2015-01-27 13:28:11
c47328948b5fff218c68279260a57ab6b03e7423...a54e9e5459cd45173b5db76a8bcce76b2e050433,1,13,18,31,2,2015-02-01 21:26:34,2015-01-30 20:50:00
a54e9e5459cd45173b5db76a8bcce76b2e050433...7b3fd03155eb757b07f53fdee37ce355d2234d89,1,1,1,2,1,2015-02-02 08:32:10,2015-02-02 08:32:10
c47328948b5fff218c68279260a57ab6b03e7423...a7a45dc949b9475dff674be57e8d3a7aa8811857,1,1,1,2,1,2015-01-30 21:29:41,2015-01-30 21:29:41
c47328948b5fff218c68279260a57ab6b03e7423...ab6f7164e03139889c09a6a207e9df3481e57b3b,15,0,0,0,0,2015-01-30 20:51:10,2015-01-30 20:40:04
c47328948b5fff218c68279260a57ab6b03e7423...e6e337088bbb4736983119928b6b6b451bd3ef20,10,23,23,46,18,2015-01-30 18:24:45,2015-01-30 18:24:45
c47328948b5fff218c68279260a57ab6b03e7423...8ac227bab2334c41784c567faf7aafb1ebd75890,1,1,5,6,2,2015-01-30 15:17:55,2015-01-30 15:17:55
c47328948b5fff218c68279260a57ab6b03e7423...1a1d7085fa02e1ef681b10e15c2f144cc5224a9d,1,3,0,3,1,2015-01-30 15:03:27,2015-01-30 15:03:27
73d12d6e6db807d6d15a665cddc0ca9a47bff4eb...938a1381fc89d39df9c440aad2f95e3b93d80f3b,4,9,7,16,5,2015-02-20 15:04:03,2015-02-20 13:39:35
938a1381fc89d39df9c440aad2f95e3b93d80f3b...0c4d27e82da8f438d35fcb47241c41522e6b0dce,2,9,4,13,3,2015-02-20 21:36:19,2015-02-20 21:36:19
0c4d27e82da8f438d35fcb47241c41522e6b0dce...08874d2b51e71debac61659050ea577dffd89bf8,4,68,37,105,10,2015-02-20 22:27:17,2015-02-20 22:27:17
08874d2b51e71debac61659050ea577dffd89bf8...6945f4a299d9b46b9896e431086277bfedf54b7d,1,5,0,5,1,2015-02-20 22:30:06,2015-02-20 22:30:06
6945f4a299d9b46b9896e431086277bfedf54b7d...26d57a648c09f40bd1da3c81a0efe3661288b1af,2,2,0,2,2,2015-02-20 22:32:39,2015-02-20 22:32:39
73d12d6e6db807d6d15a665cddc0ca9a47bff4eb...c801df81fb48272b670b7448e3898a98cdb8b742,4,5,5,10,5,2015-02-20 13:39:35,2015-02-20 13:39:35
c801df81fb48272b670b7448e3898a98cdb8b742...4ef6ffaad3e9b7a29b438722e5e101de78521ec7,10,44,22,66,14,2015-02-20 14:19:50,2015-02-20 14:19:50
3131d0609cf402d8e92d72c4081f567e96846d15...47b9ac664e9540b870da679d8d11250c94cb8b0a,1,12,14,26,7,2014-09-09 07:18:32,2014-09-09 07:18:32
f10c189b2136761c0cda6d6d2b3197743d19c9e6...771f4dbc3e41fd67cbd5c7a563165b68e25f8eff,1,138,0,138,1,2014-07-17 13:49:33,2014-07-17 13:49:33
771f4dbc3e41fd67cbd5c7a563165b68e25f8eff...f59a721ee0b36a2d1b22d32021ea004f731f1426,1,2,2,4,2,2014-07-17 13:49:54,2014-07-17 13:49:54
f59a721ee0b36a2d1b22d32021ea004f731f1426...4db9c6e0a8fe23bd517aad3292b7d4063a80ed17,1,1,1,2,1,2014-07-17 13:50:04,2014-07-17 13:50:04
4db9c6e0a8fe23bd517aad3292b7d4063a80ed17...2bd20b7c4d1c2222f1dce8130c5d5aacc1008aab,1,8,8,16,6,2014-07-17 13:57:04,2014-07-17 13:57:04
e088777e1ba1c8fa809f2a6894aea640373c56c1...b0b05aa28d127452600c800dabb554735a9d7e04,2,38,3,41,4,2014-09-05 13:56:36,2014-09-05 13:56:36
b0b05aa28d127452600c800dabb554735a9d7e04...fd6b7b4a300c9121806ec487001f763f011ee700,1,2,1,3,1,2014-09-05 14:27:53,2014-09-05 14:27:53
8d106bed3c2146217697e9a13e637dd8c5d60c48...1208c6caa81ab4e03301f965ec67d12e2b038358,2,15,0,15,3,2014-07-03 10:51:24,2014-07-03 10:51:24
1208c6caa81ab4e03301f965ec67d12e2b038358...310231dbed83e66ad4d17b8c25f225f60b30eeb7,5,28,0,28,5,2014-07-03 11:40:21,2014-07-03 11:40:21
310231dbed83e66ad4d17b8c25f225f60b30eeb7...16068f3bfeee5af56095cdbf642872e8955e1779,2,38,1,39,3,2014-07-03 12:05:07,2014-07-03 12:05:07
8d106bed3c2146217697e9a13e637dd8c5d60c48...43b05afc4d190a1301c87b0fe33e974b7b815807,1,1,1,2,1,2014-07-03 10:17:46,2014-07-03 10:17:46
8d106bed3c2146217697e9a13e637dd8c5d60c48...b048c7d24a61c7e9bd52671b483b0998e032bc34,1,1,1,2,1,2014-07-03 10:02:31,2014-07-03 10:02:31
a76bf07ae2ecaf47dab58cbeac37cb82ae8d3ad8...2545b0f85851d1e4ebc1137a2c8786a238e02ee4,4,31,30,61,14,2014-06-05 18:21:28,2014-06-05 18:21:28
a76bf07ae2ecaf47dab58cbeac37cb82ae8d3ad8...248a3e5688b7576995d21f1fb47c3deb2ae4de08,2,11,9,20,3,2014-06-05 06:39:03,2014-06-05 06:39:03
a76bf07ae2ecaf47dab58cbeac37cb82ae8d3ad8...829c7282a3f3372f6cb1465c65d7b03309b889dd,1,3,4,7,4,2014-06-05 01:14:31,2014-06-05 01:14:31
a76bf07ae2ecaf47dab58cbeac37cb82ae8d3ad8...793955cdfc8f2c2e6f19161426b80e63f8bffe02,1,1,1,2,1,2014-06-04 21:04:44,2014-05-29 15:28:49
a76bf07ae2ecaf47dab58cbeac37cb82ae8d3ad8...e84057da1bc0d96e7f24424f423a9491d99d5585,28,51,2,53,30,2014-06-04 20:55:27,2014-06-04 20:55:27
d9739b8026246b733cf5a36794376cbb946528fe...8aac4fadba2c50d2a1b855c893fba31038cc15d8,2,3,4,7,4,2014-06-10 18:57:05,2014-06-10 18:57:05
8aac4fadba2c50d2a1b855c893fba31038cc15d8...1f5891e99183f1b20ced08d75dd44c9a01c48094,1,1,1,2,1,2014-06-10 19:01:56,2014-06-10 19:01:56
7c6a58a756cc3bff78a6d0a0ca8abfe9b2c147da...1bb9aeb565fca50304881e36488b202455bdddd2,5,3,37,40,6,2014-05-24 11:10:36,2014-05-24 11:10:36
1bb9aeb565fca50304881e36488b202455bdddd2...5a1429ae2110faaf354574f8e6c7866c29102107,3,8,12,20,6,2014-05-24 11:20:12,2014-05-24 11:20:12
5a1429ae2110faaf354574f8e6c7866c29102107...bbc4b2be8db5166ce54a81e6f25ffe48fa293a5f,2,3,14,17,4,2014-05-24 11:26:15,2014-05-24 11:26:15
bbc4b2be8db5166ce54a81e6f25ffe48fa293a5f...ef933ae69bb48fd186c650927bff7d52a3956174,2,2,2,4,2,2014-05-24 11:41:13,2014-05-24 11:41:13
e6beb6090320d6756369934c5151e36429c5d5f1...6dcbe1b43c50229fd0dff69eba2c6ab658d91ad2,33,49,49,98,49,2014-05-29 15:42:44,2014-05-29 15:42:44
6dcbe1b43c50229fd0dff69eba2c6ab658d91ad2...38ff5d1ab9d9eb5d09bbc8498410b770445b698e,30,45,45,90,45,2014-05-29 15:43:21,2014-05-29 15:43:21
38ff5d1ab9d9eb5d09bbc8498410b770445b698e...a2b3eb134a5549bf9c80a8ee0f950a4c67777413,9,32,24,56,18,2014-05-29 15:57:27,2014-05-29 15:57:27
a2b3eb134a5549bf9c80a8ee0f950a4c67777413...b66d9c4f28168be13616696a20e252c7adae3e49,4,19,175,194,6,2014-05-29 16:32:19,2014-05-29 16:32:19
b66d9c4f28168be13616696a20e252c7adae3e49...4c51619de3a0443ee25d19ee5ba0d7ab77bedc07,2,2,2,4,2,2014-05-29 16:42:49,2014-05-29 16:42:49
3bdf0e2921c4cac46084834899302b25858e6bde...7dfb678df98b1b9ad420d9cbf4fe74f1553f34a7,1,1,2,3,2,2014-05-27 13:53:04,2014-05-27 13:45:24
3bdf0e2921c4cac46084834899302b25858e6bde...c8b58f0007ae81f39534e1de4f8958b9a7ed7590,1,7,4,11,5,2014-05-27 12:56:52,2014-05-27 12:56:52
3bdf0e2921c4cac46084834899302b25858e6bde...046647a74689f8bce86b119c63fa49dfc0756639,1,12,2,14,3,2014-05-27 12:25:34,2014-05-27 12:25:34
046647a74689f8bce86b119c63fa49dfc0756639...cee88509a382d93468982d33bee33a2dd08eb389,1,1,2,3,2,2014-05-27 14:30:39,2014-05-27 14:30:00
3bdf0e2921c4cac46084834899302b25858e6bde...f22c709539d06be6fa76f148dedffdef1170936c,38,74,5,79,39,2014-05-27 12:12:15,2014-05-27 12:12:15
c183019ce15218d54a5daaf61dfb5ef58f47f592...7795a4b90c81de76e128227b7773ca6eb1abc80e,1,2,2,4,1,2014-05-28 13:08:27,2014-05-28 13:08:27
c183019ce15218d54a5daaf61dfb5ef58f47f592...666260bf6bff01011ba498dd8f38190b2d690725,1,4,0,4,1,2014-05-28 11:04:57,2014-05-27 07:22:17
d30454e112378c24cc9edfd7b511ca42bdb1e399...7cefdb49eb460e87e3c3b827af32ae1b6834c4da,4,28,2,30,5,2014-07-29 09:49:46,2014-07-29 09:49:46
d30454e112378c24cc9edfd7b511ca42bdb1e399...bf9ce1f4cf5592f7aa1f761a5b394e7d500dc034,4,46,22,68,11,2014-07-29 09:11:16,2014-07-29 09:11:16
bf9ce1f4cf5592f7aa1f761a5b394e7d500dc034...098ee55e3c153b558c466c90bde9a18062bd33ef,1,6,15,21,5,2014-07-29 09:21:03,2014-07-29 09:21:03
098ee55e3c153b558c466c90bde9a18062bd33ef...378a3f5ca1286f4458632461067516e5c0a8f561,1,14,7,21,2,2014-07-29 09:33:51,2014-07-29 09:33:51
378a3f5ca1286f4458632461067516e5c0a8f561...549655765a443dde5dd46a52a2fb7cadd2dbd0e8,1,2,2,4,2,2014-07-29 09:42:01,2014-07-29 09:42:01
549655765a443dde5dd46a52a2fb7cadd2dbd0e8...027fcc0512accb81043e81d4f7b9a06a3f0fa12f,1,2,2,4,2,2014-07-29 11:29:36,2014-07-29 11:29:36
027fcc0512accb81043e81d4f7b9a06a3f0fa12f...2f780af2462d71164c2e11bc6147f87400303a64,5,11,8,19,8,2014-07-29 11:29:59,2014-07-29 11:29:59
2f780af2462d71164c2e11bc6147f87400303a64...f844556531304a791080ff29f1cfdf9a29e79bfd,2,1,5,6,2,2014-07-29 12:18:11,2014-07-29 12:18:11
d30454e112378c24cc9edfd7b511ca42bdb1e399...1cf1e7bedbddc326d2551e984d6bac8f1027ede8,1,9,2,11,2,2014-07-29 08:04:19,2014-07-29 08:04:19
f08cb264878b4051b07f773586994290117296a5...5d770882028ab98556b0d27716affc9f1b54dd55,1,9,9,18,2,2014-05-20 09:00:23,2014-05-20 09:00:23
f08cb264878b4051b07f773586994290117296a5...8ee3299cc451898b7072383dab7d54601b8bd479,1,3,1,4,1,2014-05-19 16:28:45,2014-05-19 16:28:45
f08cb264878b4051b07f773586994290117296a5...dca537ab2902aa9936e4c29574ad540793028a76,1,1,1,2,1,2014-05-19 15:49:29,2014-05-19 15:49:29
dca537ab2902aa9936e4c29574ad540793028a76...6be0188b5c289b1cff7f15fcfdff0ea9b8eec1ff,1,33,5,38,4,2014-05-19 15:51:58,2014-05-19 15:51:58
eb06509a3712071340619ab53139f7f7b96ac40c...ce8e7d280b06a0dde196743f2fea29750f8089b1,1,1,1,2,1,2014-05-20 12:30:25,2014-05-20 12:30:25
ce8e7d280b06a0dde196743f2fea29750f8089b1...13761caead142c38c5163a3ae5d9bc650c186d71,1,1,1,2,1,2014-05-20 18:51:35,2014-05-20 18:51:35
eb06509a3712071340619ab53139f7f7b96ac40c...0660183cb0733e68520e109c9470d9b4f4109194,1,1,1,2,1,2014-05-20 11:29:52,2014-05-20 11:29:52
d52a3281dccefa5fcb774b9f0314abba7edfc820...b3b0876e9826820f31d28eaf0e44dc589313eafe,2,8,2,10,4,2014-05-21 08:37:41,2014-05-21 08:37:41
d52a3281dccefa5fcb774b9f0314abba7edfc820...b08fe47fe8977905252c73653cece86359922e29,1,4,1,5,1,2014-05-20 21:03:34,2014-05-20 21:03:34
7ad5fb53ac4e14b22684a0d4904ccf724fd4e082...c456231690c8fabeeefc844d46c9d5b0403df357,6,36,14,50,8,2014-05-26 20:26:41,2014-05-26 20:26:41
7ad5fb53ac4e14b22684a0d4904ccf724fd4e082...e426d43924be265d4834f47fd765895dde6017fb,3,6,7,13,3,2014-05-26 18:54:57,2014-05-26 18:54:57
e426d43924be265d4834f47fd765895dde6017fb...c9020ae5866527f0642b00bea42b71ed0476d0e4,1,2,3,5,2,2014-05-26 20:30:45,2014-05-26 20:30:45
c9020ae5866527f0642b00bea42b71ed0476d0e4...1e7fa8d99b52d89571b8e9581746561d00c383d5,2,2,4,6,2,2014-05-27 05:12:03,2014-05-27 05:12:03
8b9b34f8427766c0eac65e6b16a7437acd5fcb9b...78897ee2d2ecb6db40139ed3af1b591d96f59387,1,2,2,4,2,2014-05-12 13:49:32,2014-05-12 12:00:04
54c20837032cb1bae03f9794cc39884224bf91d3...6136dd5a751b22cf88609840a89a40ffbc0b9145,2,65,0,65,2,2014-08-25 19:19:41,2014-08-15 19:51:43
6136dd5a751b22cf88609840a89a40ffbc0b9145...eeebf7dae61676f79a482930174d37e3afb79dd6,2,32,33,65,11,2014-08-25 19:20:08,2014-08-20 01:43:02
54c20837032cb1bae03f9794cc39884224bf91d3...4142754c7f1dda713519b62df76cbc03c9e299c1,1,1,1,2,1,2014-08-18 13:51:30,2014-08-18 13:51:30
54c20837032cb1bae03f9794cc39884224bf91d3...45ef553a404f152ca34b6f5ac20b29f30224be47,1,4,4,8,4,2014-08-18 06:05:58,2014-08-18 06:05:58
45ef553a404f152ca34b6f5ac20b29f30224be47...dab09316ebbef585009bf7cc33afcabec7804d64,1,4,4,8,4,2014-08-18 21:07:32,2014-08-18 21:07:32
54c20837032cb1bae03f9794cc39884224bf91d3...66c18eaeb3a63b277be9dc691eca194deee89045,1,7,3,10,3,2014-08-17 13:37:56,2014-08-17 13:37:56
54c20837032cb1bae03f9794cc39884224bf91d3...7be7cf2936646ea2c80d9e5bec6a5526326785f3,1,1,2,3,1,2014-08-16 10:31:26,2014-07-26 19:45:34
433dac7799a1a5fd4a0dfeaa0157148eb9058202...0602c5d0279dba64bd3a34d2cc8ce39224ccaa49,2,2,2,4,2,2014-08-15 07:20:12,2014-08-15 07:20:12
e043da1376d3639e1ab7c4d569f4fc7627d9ecf1...c3a7d3e14727b8ba7c13cc7e48bc07648dc9fb74,1,11,12,23,9,2014-07-16 06:38:19,2014-07-16 06:38:19
2d6c4d2bb05e52731877ad17a0a78d0d3609ebcc...a6546f51e2a383d812dd633166447f6758bd9bdb,1,1,1,2,1,2014-07-15 17:59:47,2014-07-15 17:59:47
e24589a165d8ed23aa8164f488f2de9f1b358668...0b5e0e4c557a9cf8aad9a551ff71dc3699143895,4,48,3,51,6,2014-08-13 13:48:26,2014-08-11 18:15:12
0b5e0e4c557a9cf8aad9a551ff71dc3699143895...6085b6a765f4db9c167fb607af5f605f0d9b586d,2,23,24,47,6,2014-08-13 13:48:26,2014-08-11 21:48:54
6085b6a765f4db9c167fb607af5f605f0d9b586d...a3c969cd92a2f658d322bec1cfe07c520b678bf7,3,21,2,23,4,2014-08-13 13:48:26,2014-08-11 21:59:30
a3c969cd92a2f658d322bec1cfe07c520b678bf7...c9eaa46c738ad23bbb3d6f3dfbdaf8a485d0a030,1,4,1,5,1,2014-08-13 13:48:26,2014-08-12 08:53:50
c9eaa46c738ad23bbb3d6f3dfbdaf8a485d0a030...b9519c83142d566ee562da57563db42849e91771,4,47,4,51,9,2014-08-13 13:48:26,2014-08-13 12:12:05
b9519c83142d566ee562da57563db42849e91771...04ad197bcc41a26da2c2a80c5b4ffbfad2c296ee,2,6,4,10,5,2014-08-13 13:48:26,2014-08-13 12:22:34
04ad197bcc41a26da2c2a80c5b4ffbfad2c296ee...cbc90565b55d89704d64bc48db323b82b739a873,9,108,8,116,24,2014-08-14 08:17:52,2014-08-14 08:17:52
e24589a165d8ed23aa8164f488f2de9f1b358668...d3f5a0c67f029441537d4f64040bf6454b999120,1,3,0,3,3,2014-08-13 13:45:23,2014-07-16 15:44:43
2600d08f65a8169c6f9414aca6517c828641ec23...aabb4093b7e69cd41e50f674a971b4a113345748,8,9,9,18,9,2014-08-12 05:01:37,2014-08-12 05:01:37
2600d08f65a8169c6f9414aca6517c828641ec23...2cb7bf713ef5eaa725898cee28ae602431e86379,1,2,2,4,2,2014-08-04 08:06:53,2014-08-04 08:06:53
2600d08f65a8169c6f9414aca6517c828641ec23...73bdeff02eb85cee02046b50524721df52ed20bf,1,6,0,6,1,2014-08-04 07:57:32,2014-08-04 07:57:32
2600d08f65a8169c6f9414aca6517c828641ec23...010ba5ec2219d346c8e257f3f87b22b43c5959aa,1,0,24,24,1,2014-08-04 07:55:57,2014-08-04 07:55:57
2600d08f65a8169c6f9414aca6517c828641ec23...5511bb9f645176f54b10b0c21e0d216ed92649ee,1,1,0,1,1,2014-08-03 15:42:56,2014-08-03 15:42:56
2600d08f65a8169c6f9414aca6517c828641ec23...d2ed33224a98cb80d9f2bec0fb4e3608586f843e,1,4,0,4,1,2014-08-03 15:40:29,2014-08-03 15:40:29
7a7c01b92ac4aa4dad387f122d604b03997f268d...74039eb08326e1cde898e9c9c5e452bb1bdd2e2e,2,2,0,2,1,2014-06-27 13:02:07,2014-06-27 13:02:07
7a7c01b92ac4aa4dad387f122d604b03997f268d...379ffbb26243018eeacf69266f9152f888772de3,1,8,10,18,4,2014-06-27 08:46:52,2014-06-27 08:46:52
c8ac0ab392e33e66a6b984774091b8aae9661790...6a6803c2f96648638b79d459968b561b03fb5562,2,6,2,8,2,2014-07-04 14:42:11,2014-07-04 14:42:11
54faf7871ee43115e972f3cb70d93fde01f030e1...e832c4d90d3482a58d2b50ceadfdebc75c93a765,1,1,1,2,1,2013-09-03 05:25:39,2013-09-03 05:25:39
9ad5d9a4c6a3e292ddde7e46949f739eb63c746e...f87e2d2801fa4c9c47466e38012210348fac0710,4,32,1,33,4,2013-09-09 18:10:58,2013-09-09 05:45:30
f87e2d2801fa4c9c47466e38012210348fac0710...cfe13a0d9f052ab604a8d76e89b4c2fdaf64c2fd,1,6,2,8,1,2013-09-09 20:26:27,2013-09-09 20:26:27
cfe13a0d9f052ab604a8d76e89b4c2fdaf64c2fd...cc1eb9657e67827e3de88d86b7f09f6aa11767a2,1,4,1,5,5,2013-09-10 14:49:23,2013-09-10 14:49:23
9ad5d9a4c6a3e292ddde7e46949f739eb63c746e...e86e8818327059279247db3a451994c6a62ab161,3,234,5,239,6,2013-09-09 16:04:38,2013-03-28 18:37:44
e86e8818327059279247db3a451994c6a62ab161...7a56075efac308a3bd08e022e56e96d41c4c05b5,4,38,27,65,13,2013-09-09 16:04:38,2013-06-28 12:59:05
7a56075efac308a3bd08e022e56e96d41c4c05b5...fdc23a93e7368283f8f78b8e8627aef9ad73c617,1,4,2,6,6,2013-09-09 17:18:10,2013-09-09 17:18:10
694768e51870ebb24a25730188e018782d3175ca...fc6ed495487084b051d7228fdafe814784ea3ea0,2,10,9,19,9,2013-09-11 18:12:33,2013-09-11 18:12:33
694768e51870ebb24a25730188e018782d3175ca...d4d4a78f834b409631b012aa555c0cb2c4e3166d,3,17,1,18,3,2013-09-11 18:04:15,2013-08-08 18:09:33
d4d4a78f834b409631b012aa555c0cb2c4e3166d...5dae40f579f66fdc060de633b183ede7bd8b2ce4,6,143,35,178,14,2013-09-11 18:04:15,2013-08-15 21:43:46
5dae40f579f66fdc060de633b183ede7bd8b2ce4...810851f5740599dc8b1419dcf817bac48ee967fc,1,6,3,9,3,2013-09-11 18:04:15,2013-09-11 16:23:04
810851f5740599dc8b1419dcf817bac48ee967fc...88d4559e62f4e49de6b3ceab2620e418c11eb7f6,2,1,3,4,2,2013-09-11 18:32:24,2013-09-11 18:03:26
201158f1dee15accf6abbd7ad5a50af023ba5d23...a9d3e6ce573e1e108ab340141ab0f104bf27a430,1,1,1,2,1,2013-09-06 23:18:09,2013-09-06 23:18:09
a9d3e6ce573e1e108ab340141ab0f104bf27a430...0f2299a8d43c8e66d1bf764b737b8ec14266fb2a,1,1,1,2,1,2013-09-06 23:19:35,2013-09-06 23:19:35
0f2299a8d43c8e66d1bf764b737b8ec14266fb2a...24bc3e0874bd81d1cf8cc8a7104f277d5a9fa5c7,1,1,1,2,1,2013-09-06 23:45:42,2013-09-06 23:45:42
201158f1dee15accf6abbd7ad5a50af023ba5d23...ca1d63c2f668059eb5da3f8b61001ee898651eb1,1,1,1,2,1,2013-09-06 22:53:10,2013-09-06 22:53:10
3998bb3abad41abf6ba67ee04c37bdfc48e9313e...3333d8b87b157baa3420a1028257b93cdb1ef993,1,6,4,10,2,2013-12-27 13:15:07,2013-12-27 13:15:07
231b91d0c819ef1e4fb1beb23c5decfa34876ec6...4d0ce5e85be98960584d6a6e78399f623b55eafd,2,9,3,12,4,2013-12-29 12:17:13,2013-12-29 12:17:13
231b91d0c819ef1e4fb1beb23c5decfa34876ec6...cf31f289d7bf073e8d8d91b6ee8df1225596e4dd,2,8,8,16,2,2013-12-29 11:55:45,2013-12-29 11:55:45
cf31f289d7bf073e8d8d91b6ee8df1225596e4dd...8b6870680173347db5df23529acb40a7a69fe918,3,8,26,34,10,2013-12-29 11:56:16,2013-12-29 11:56:16
231b91d0c819ef1e4fb1beb23c5decfa34876ec6...611c5f1d7cb0ae74d923499d01c2f30d5e8f9384,6,65,21,86,14,2013-12-29 10:58:00,2013-12-29 10:58:00
e0bddb64da0d0c2b68cae779dbc4a4bbd49565e6...8af94ed75505f0253823b9b2d44320fecea5b5fb,1,8,0,8,1,2014-03-24 13:59:09,2014-03-24 13:59:09
1c42cc35a187504ec38d4fe5eb4113d80c23614c...20c3cbb18cfc414e144e5cb214d6b663ba17f828,1,25,10,35,8,2014-03-21 14:04:45,2014-03-21 14:04:45
b821a1bd41166c295ea1625ccf57b9bb48f61649...0f6221e7365a93a356410f4d38443381924d4cc6,1,15,9,24,4,2015-02-24 01:56:05,2015-02-24 01:56:05
b1c79eaf945b22602552edf8d111c5245057bad2...4ffdb83e713b1ffa9578c02d31cfd0d9afe56ca7,12,141,19,160,22,2015-01-20 09:50:24,2015-01-18 00:34:34
b1c79eaf945b22602552edf8d111c5245057bad2...c9823b975562eb889d8a6a2a734f6cac208c9a72,1,3,0,3,3,2015-01-18 17:55:48,2015-01-16 16:22:32
c9823b975562eb889d8a6a2a734f6cac208c9a72...5af05e3d3c4e824e6b04bed6e8e2c45788880df2,2,2,3,5,2,2015-01-18 17:55:48,2015-01-16 16:26:21
2c053c93b2ab6f4a42822a8db537e228463e8129...f8b97b454b8eae343bd7ea6e92fd2257eeae45b0,2,3,3,6,4,2015-01-15 05:12:16,2015-01-15 05:12:16
2c053c93b2ab6f4a42822a8db537e228463e8129...8bc65f6d4bc665a1bde9ae2863eb884050acff1d,1,10,0,10,3,2015-01-15 03:39:10,2015-01-15 03:39:10
2c053c93b2ab6f4a42822a8db537e228463e8129...210a13ad425d14eceacd902407c2ee3f2801ac32,1,1,1,2,1,2015-01-15 03:34:49,2015-01-15 03:34:49
1646bfc273458440a2f027b04ab49ebbb8b441ed...85d226e57f24fd4c368bed3fe352a9f1f8db51a1,2,3,3,6,3,2015-03-18 17:25:22,2015-03-18 17:25:22
b5e961eb4c8ccc022d49af76d563a8a97ad5eb34...0eaabc270868b79185f72ac6e99551e33dbb3c23,1,0,1,1,1,2015-03-18 18:42:03,2015-03-18 18:42:03
b5e961eb4c8ccc022d49af76d563a8a97ad5eb34...1446af25b1b5938871f697a9643bf04c78ba33f0,1,16,0,16,1,2015-03-18 18:35:38,2015-03-18 18:35:38
0da59cb55bfc8b6bb50f45d0ccdb19edc8b0a6e9...ededa98995208591c5792c0ece1a5ec0ef302127,1,1,1,2,1,2015-01-27 06:46:54,2015-01-27 06:46:54
ededa98995208591c5792c0ece1a5ec0ef302127...95db00c3e9b7658b1a2a38f62006371988eabe5c,1,1,0,1,1,2015-01-27 20:19:32,2015-01-27 20:19:32
c6e24850a3ad662d82f8e0812eb2a38df4f43c13...85b3c87b7f35843f26a9ead60f0bbfcb1d64dc2a,1,1,1,2,1,2015-01-23 19:57:48,2015-01-23 19:57:48
85b3c87b7f35843f26a9ead60f0bbfcb1d64dc2a...13c4e25d6fd7ce4ae34340667d6ee5640ff925a1,1,4,1,5,1,2015-01-23 20:30:48,2015-01-23 20:30:48
13c4e25d6fd7ce4ae34340667d6ee5640ff925a1...1f5ecf6c502b1dffa26986b1e62cf46cbc58f981,1,4,4,8,1,2015-01-23 20:33:20,2015-01-23 20:33:20
c6e24850a3ad662d82f8e0812eb2a38df4f43c13...061ac7923670083cf7237a32867b2f8ce86a1c83,3,3,3,6,3,2015-01-23 19:18:10,2015-01-23 19:18:10
c6e24850a3ad662d82f8e0812eb2a38df4f43c13...31bf578d67620dfc904ff2f980788fe38ee9ca92,2,3,2,5,2,2015-01-23 18:55:12,2015-01-23 18:55:12
c6e24850a3ad662d82f8e0812eb2a38df4f43c13...99736d45946c3c81f5c0e266722fece1272b7544,6,11,16,27,6,2015-01-23 18:39:23,2015-01-23 18:39:23
03430ad77cb36ecfb450f9e4dec28d3fff1499e3...0fe1c9b64869703b8d803d56955422dceabf6e37,1,1,1,2,1,2015-01-30 23:49:01,2015-01-30 23:49:01
e6e337088bbb4736983119928b6b6b451bd3ef20...ad6c372eeee5d112ad199dd4e487df584976445d,28,72,72,144,67,2015-02-03 23:18:40,2015-02-03 23:18:40
ad6c372eeee5d112ad199dd4e487df584976445d...7aa3f6053efd9c1e2db962f7146a13bdf3d147c9,3,71,49,120,3,2015-02-04 16:23:24,2015-02-04 16:23:24
1f617c3c5ffd3b8b4d1eb29d9cda8a2e7a749133...2f76ccdfac59f7bb6875e0a7753a390d4f6f2b38,1,7,6,13,1,2015-02-20 21:17:38,2015-02-20 21:17:38
1f617c3c5ffd3b8b4d1eb29d9cda8a2e7a749133...92434b29cc45677fe72bb6a8a5bd09d5ead8d138,5,39,6,45,9,2015-02-20 18:27:37,2015-02-20 18:27:37
1f617c3c5ffd3b8b4d1eb29d9cda8a2e7a749133...157b4b4b1f41267375d3b32c9c1606a538eb8488,8,289,0,289,8,2015-02-20 17:42:58,2015-02-20 17:38:41
b634d2801e6abdd039447f53ec5d9cf709f66b06...69dc5461c3fda2fd447f556c6237c2594c182e71,1,1,1,2,1,2014-07-18 15:03:23,2014-07-18 15:03:23
b634d2801e6abdd039447f53ec5d9cf709f66b06...714f7201d3362793d11f33793e5ef6dc83bdd2f0,25,301,35,336,35,2014-07-17 20:47:16,2014-06-26 07:49:14
714f7201d3362793d11f33793e5ef6dc83bdd2f0...c589029667644df4593572e2c94226bd2a5f7740,2,4,3,7,4,2014-07-17 20:47:16,2014-07-04 07:26:59
c589029667644df4593572e2c94226bd2a5f7740...ecd771ccdfe54b08ea7f80f64667228b7938238d,2,5,5,10,2,2014-07-17 20:47:16,2014-07-14 09:50:35
ecd771ccdfe54b08ea7f80f64667228b7938238d...9b5c7a4d6026265cfeaeac9ad5101f8826515dbe,10,95,17,112,23,2014-07-17 20:47:16,2014-07-14 13:17:59
9b5c7a4d6026265cfeaeac9ad5101f8826515dbe...0a6e978db70bb4d84ce7993f5376f395c6bea11e,1,1,1,2,1,2014-07-17 20:47:17,2014-07-15 10:00:51
0a6e978db70bb4d84ce7993f5376f395c6bea11e...1591467655b6045108f88e8ac2d8b6a069ef4bb1,3,25,25,50,4,2014-07-17 20:47:17,2014-07-17 20:45:16
1591467655b6045108f88e8ac2d8b6a069ef4bb1...e1d307bf4b88afa59d851918c29ffbb61b01e8c5,3,14,18,32,5,2014-07-17 21:22:40,2014-07-17 21:22:40
1767873845ef479dd977303f9a6babc9e23ace9f...1f355279d2cce2f1b75d5af953b17d6aeea5eff2,1,0,6,6,1,2014-09-06 09:51:28,2014-09-06 09:51:28
1767873845ef479dd977303f9a6babc9e23ace9f...20d0d5a7e8a54083b1203090a98e82adfaf64038,1,6,0,6,3,2014-09-05 17:25:45,2014-09-02 06:14:50
cfde0936ea20edab82081c3f1288098c882e7de9...285bb09b98bf5532e1fc149492fc5d50db9f2ab9,1,10,10,20,2,2014-07-21 15:10:28,2014-07-21 15:10:28
cfde0936ea20edab82081c3f1288098c882e7de9...9714061bb0f099f3800ffdc75bc8807ee783e32a,2,9,1,10,2,2014-07-21 13:45:27,2014-07-21 13:45:27
9714061bb0f099f3800ffdc75bc8807ee783e32a...b4217500352efcc463ee0517a97d37c41e66ddd5,1,12,10,22,1,2014-07-22 06:34:16,2014-07-22 06:34:16
5bb2840dc406bde0cf2318fdc8f6c4596351b4a7...fe2cb593f99f0cf2c4ac4efe624ae8b4b11f1be8,1,16,30,46,2,2014-07-05 05:52:43,2014-07-05 05:52:43
248a3e5688b7576995d21f1fb47c3deb2ae4de08...4ed39a77ef79178b231f3fb309b41df1fd8cc2df,2,4,3,7,3,2014-06-05 06:45:12,2014-06-05 06:45:12
868629dc40ca98ce3ad5740b27fe176c853ad72d...336d50d008e8efcaef89ce5656620cbe068aa064,4,56,19,75,7,2014-06-05 10:01:49,2014-06-05 10:01:49
db779388fee09b14ee591d9cb4981bdae3d23be9...9bca8ae8f2feefe42acbdb61004ff5c3ec2a8a65,1,6,6,12,3,2014-06-05 19:20:33,2014-06-05 19:20:33
1f5891e99183f1b20ced08d75dd44c9a01c48094...dd86ce3f062ed84d90aa51ab5aee4cfcce24cda5,5,34,4,38,7,2014-06-11 11:09:45,2014-06-11 11:09:45
1f5891e99183f1b20ced08d75dd44c9a01c48094...e57fdc1190af582544154b77f0271ef9f206bc47,3,21,6,27,4,2014-06-11 11:04:30,2014-06-11 11:04:30
e57fdc1190af582544154b77f0271ef9f206bc47...f43e41973f912588d7af23a5575ede94a88d3a5d,2,11,0,11,3,2014-06-11 11:36:30,2014-06-11 11:22:56
1f5891e99183f1b20ced08d75dd44c9a01c48094...d2d99521b62677acaf6904914e844bbf17cbc697,1,4,2,6,2,2014-06-11 08:37:48,2014-06-11 08:37:48
1f5891e99183f1b20ced08d75dd44c9a01c48094...587502390b3afa423a10f98f7568a26352cb0976,4,5,5,10,5,2014-06-10 20:28:11,2014-05-09 12:26:19
1d7735773e44e25d91a2cb2111877465ddae4366...0b00b3dac3ec31924dae821c0fccc08598161762,7,41,8,49,12,2014-06-11 14:11:52,2014-06-11 14:11:52
1d7735773e44e25d91a2cb2111877465ddae4366...f2db4a18b96f5e0918dad3ba3cf3744779fc7036,1,1,1,2,1,2014-06-11 13:39:55,2014-06-11 13:39:55
ef933ae69bb48fd186c650927bff7d52a3956174...9c046fea676b65c4883707fad22ceb8dd0e7525e,6,110,78,188,41,2014-05-26 13:24:21,2014-05-26 12:40:10
ef933ae69bb48fd186c650927bff7d52a3956174...f441436e53377f207657ac0e0e518e5ee2b33a6c,3,99,0,99,4,2014-05-26 13:08:22,2014-05-26 13:08:22
f441436e53377f207657ac0e0e518e5ee2b33a6c...242291850d7513731355c42e67c2f8c3cc727451,1,20,0,20,1,2014-05-26 15:05:55,2014-05-26 15:05:55
242291850d7513731355c42e67c2f8c3cc727451...10ee137e9c13271d49d7046723b1e473d62a578f,4,27,31,58,14,2014-05-27 08:16:50,2014-05-27 08:16:50
10ee137e9c13271d49d7046723b1e473d62a578f...c7e00aca2d68a15c901506f1af4242df92670b6a,2,28,10,38,7,2014-05-27 08:27:42,2014-05-27 08:27:42
ef933ae69bb48fd186c650927bff7d52a3956174...cc1dd324643db07bdb29f3673995a8ad0dffa2df,1,2,0,2,1,2014-05-24 17:05:02,2014-05-24 17:05:02
e9c440d2215187899ef0515e0e9dd171277b70f1...4f9669cd9f35a72dd9c950decccbe012d1a3d957,1,9,3,12,3,2014-05-29 17:35:43,2014-05-29 17:35:43
cb4b504b26a269ba6ebb3fee165296a80d962c69...2341cefd6fa2811a1af41f2068554738d7eebfc4,10,15,21,36,16,2014-05-27 15:14:41,2014-05-27 15:14:41
d25bc257666c9949b6f62414368c09e83df9d6f1...affd376f7a36df4a80369bc1c7c8557dd4822b7d,4,2,12,14,5,2014-05-27 15:51:41,2014-05-27 15:51:41
666260bf6bff01011ba498dd8f38190b2d690725...59f68b1b9fcf245ff8fe7344faa3f63983aad106,1,1,23,24,1,2014-05-28 13:26:25,2014-05-28 13:26:25
535feb08ce90352c89799df5e3e70a10e53ee10d...03654a6abf47c88b8b980a6707874ff78080d2fe,9,87,1,88,10,2014-07-29 14:10:15,2014-07-29 14:10:15
03654a6abf47c88b8b980a6707874ff78080d2fe...6fb9badcaef5152c60bf4091899a84b34f5cc1b8,8,26,17,43,15,2014-07-29 15:23:18,2014-07-29 15:23:18
6fb9badcaef5152c60bf4091899a84b34f5cc1b8...d45a6b2941f30d71f828e0fc8adaeab19f87b1a0,10,45,23,68,14,2014-07-29 16:19:26,2014-07-29 16:19:26
d45a6b2941f30d71f828e0fc8adaeab19f87b1a0...d79c0ea271f20b148ab433c0d510f90f1b807b74,5,17,73,90,8,2014-07-29 18:23:54,2014-07-29 18:23:54
d79c0ea271f20b148ab433c0d510f90f1b807b74...b2a6f4e13632c6f00620cdd7116d7b29d257c738,8,44,65,109,14,2014-07-29 19:19:47,2014-07-29 19:19:47
b2a6f4e13632c6f00620cdd7116d7b29d257c738...2c32edb3aeb3abd4eae12a51b071629da5ab30ff,1,1,12,13,2,2014-07-29 19:24:03,2014-07-29 19:24:03
2c32edb3aeb3abd4eae12a51b071629da5ab30ff...81aebaa189586d4384fff92324fc9ec5bd8d8962,1,1,1,2,1,2014-07-30 09:04:47,2014-07-30 09:04:47
81aebaa189586d4384fff92324fc9ec5bd8d8962...048a21974ef56285099eb4b54b6ca1e6fd7e3e8c,3,42,2,44,6,2014-07-30 10:12:11,2014-07-30 10:12:11
048a21974ef56285099eb4b54b6ca1e6fd7e3e8c...4c6859a2dee6da420f33c3b7f9946f3642eb85f7,1,7,1,8,1,2014-07-30 10:26:23,2014-07-30 10:26:23
4c6859a2dee6da420f33c3b7f9946f3642eb85f7...ecabefba1906526bf4038fa8c642688f93dbeb3e,1,4,2,6,2,2014-07-30 10:26:54,2014-07-30 10:26:54
ecabefba1906526bf4038fa8c642688f93dbeb3e...6ac26a3cb6feabf09aefc4e23855c393d50cf08a,7,103,3,106,8,2014-07-30 10:27:29,2014-07-30 10:27:29
6ac26a3cb6feabf09aefc4e23855c393d50cf08a...cc331684593143cba773b0160222865eeb86b134,2,13,1,14,4,2014-07-30 11:25:27,2014-07-30 11:25:27
cc331684593143cba773b0160222865eeb86b134...593df8e69a81a3ab0a4755db74dc282c00e02ef5,10,76,37,113,31,2014-07-30 12:15:39,2014-07-30 12:15:39
593df8e69a81a3ab0a4755db74dc282c00e02ef5...70f868b737af99c8a8697a3cb5e19b8da3d9c3d9,7,35,70,105,11,2014-07-30 13:05:43,2014-07-30 13:05:43
70f868b737af99c8a8697a3cb5e19b8da3d9c3d9...d9d8d3b7995c351cb4a7d91718f3f48324bd099a,6,47,23,70,15,2014-07-30 14:17:29,2014-07-30 14:17:29
535feb08ce90352c89799df5e3e70a10e53ee10d...014e6d0f875a1fb1b97aaad1153f92b85e88354d,3,10,1,11,4,2014-07-29 12:28:20,2014-07-29 12:28:20
761fbbfeea5653e8d01e2d3d7fc936031ad39385...ac46130748c31f3052f7ac325f897637e7b326f5,1,11,0,11,1,2014-05-20 13:36:51,2014-05-20 13:36:51
761fbbfeea5653e8d01e2d3d7fc936031ad39385...c18e2778b2f1a4a2c3fb8e0f79c400456645e036,2,2,2,4,2,2014-05-20 13:22:23,2014-05-20 13:22:23
761fbbfeea5653e8d01e2d3d7fc936031ad39385...9eb7fe6d06f39cc011fa9ee3cc8b137d60f5d90e,1,2,2,4,2,2014-05-20 13:21:30,2014-05-20 13:21:30
9eb7fe6d06f39cc011fa9ee3cc8b137d60f5d90e...1a4c9118aec5c25bf39cdc6db640569bf5c6d0e9,1,2,3,5,2,2014-05-20 13:22:47,2014-05-20 13:22:47
f48658813ca86464aa76de4ff906c1ef47ddd863...52c3179be94e857ecb0de2cfa8ecbd484a36d213,2,43,83,126,19,2014-05-26 18:43:58,2014-05-20 13:29:14
52c3179be94e857ecb0de2cfa8ecbd484a36d213...603e04bc21b07b8b6f70e972383ea2f29d0bfce0,1,8,0,8,2,2014-05-26 18:43:58,2014-05-20 13:58:30
603e04bc21b07b8b6f70e972383ea2f29d0bfce0...281643a1bfd6f4da88a278bfce20133c80105de5,3,21,3,24,4,2014-05-26 18:43:58,2014-05-23 10:58:34
4142754c7f1dda713519b62df76cbc03c9e299c1...911e47a93dba48a4948ef2869d2f5a563e3a9a58,1,3,1,4,1,2014-08-18 15:19:05,2014-08-18 15:11:13
b3a88a0fdc062f11d2580e361296865acdba4973...a391cd21d74140b8d5a253f64b66f5d313304f58,1,1,1,2,1,2014-09-14 09:31:32,2014-09-14 09:31:32
b3a88a0fdc062f11d2580e361296865acdba4973...1da0c0b6e43198074e775549011b73533fd3f64a,3,13,24,37,4,2014-09-14 08:15:14,2014-08-31 11:06:23
3c9ea7f4a90a4d3902b36a94678f6f39c1a1cc61...8d7ed7e53bed1e58515ea9c2da4c27fd59d2970c,1,4,0,4,1,2014-09-24 06:42:45,2014-09-24 06:42:45
c3a7d3e14727b8ba7c13cc7e48bc07648dc9fb74...332a3c6d48d5ef67e2aa8fe964a632136a282293,1,4,2,6,2,2014-07-16 09:02:41,2014-07-16 09:02:41
332a3c6d48d5ef67e2aa8fe964a632136a282293...9e3694a6e300748fd14eaa19e442297a44b9f742,1,13,9,22,10,2014-07-16 09:27:18,2014-07-16 09:27:18
e3df8bf015c41db8ec62c82d5b2820a4b5e816d5...cc5a5a03a4274d6885d48306053538e03efd3ded,1,1,1,2,1,2014-07-16 08:55:34,2014-07-16 08:55:34
e3df8bf015c41db8ec62c82d5b2820a4b5e816d5...e9a9238165085d7c1c111c2c05e28220cd080d89,1,4,0,4,1,2014-07-16 06:38:42,2014-07-16 06:38:42
a6546f51e2a383d812dd633166447f6758bd9bdb...07537faca72e2475a25e1e73c12bc924499afc27,4,7,2,9,5,2014-07-21 15:50:29,2014-07-15 18:27:35
a6546f51e2a383d812dd633166447f6758bd9bdb...9879c427cef89a65d721133a62ff41a6e2a9057a,1,1,1,2,1,2014-07-15 20:04:14,2014-07-15 20:04:14
d4f5af820f2fdb442404804859c84d2ef21794d9...abdc4426486c6e6458c12ba49dd641d4c5ab257a,19,51,51,102,49,2014-08-07 08:27:54,2014-08-04 20:32:41
d4f5af820f2fdb442404804859c84d2ef21794d9...66f8a44fd30da19235cf05077931c9fc42d1d14c,1,1,1,2,1,2014-08-05 03:51:26,2014-08-05 03:51:26
d4f5af820f2fdb442404804859c84d2ef21794d9...ecd33c9d92b6b4f4e69f70b168d816f6105428ac,1,4,2,6,2,2014-08-05 03:41:20,2014-08-05 03:41:20
d4f5af820f2fdb442404804859c84d2ef21794d9...9e4a9935c23ed8c501207ea108cf0b7b86d9bd58,1,3,0,3,1,2014-08-04 22:22:15,2014-08-04 22:22:15
d4f5af820f2fdb442404804859c84d2ef21794d9...6a412c99690a6cd4c2467951e4cdb87dfdbf248f,1,19,0,19,1,2014-08-04 19:56:08,2014-08-04 19:56:08
d4f5af820f2fdb442404804859c84d2ef21794d9...15c682fcb01807b8c7c857aba213f2f14904083d,2,5,3,8,3,2014-08-04 18:29:17,2014-08-04 18:29:17
85a15b0e224422965690220bbd51fe232a88fcd0...593e262e40329d2feb9bea1592c4ee7b6bcefac2,1,1,1,2,1,2014-07-08 11:55:20,2014-07-08 11:55:20
76e36dd253229d580f2c6336a77e5fc403fe90c3...ca6fd8841e3bf1d6db9370fd7aa7934b320550e4,4,14,0,14,4,2014-06-30 07:42:28,2014-06-25 09:15:27
ca6fd8841e3bf1d6db9370fd7aa7934b320550e4...aaba993352d65ad645215083cd6a4a46006f4b32,4,58,0,58,5,2014-06-30 07:44:30,2014-06-25 10:30:57
aaba993352d65ad645215083cd6a4a46006f4b32...e1afea777a6f0d2e28adc2765c9445cb10bd25f8,3,18,17,35,3,2014-06-30 07:44:30,2014-06-25 11:30:23
e1afea777a6f0d2e28adc2765c9445cb10bd25f8...58570880f0ffde173de31a0093f6a9d243467fef,3,97,3,100,6,2014-06-30 07:44:30,2014-06-25 14:19:03
58570880f0ffde173de31a0093f6a9d243467fef...8e8c074205f4c85238309f4e21e80748f09d0ec8,3,4,6,10,5,2014-06-30 07:44:30,2014-06-26 07:41:36
8e8c074205f4c85238309f4e21e80748f09d0ec8...0723bf1afaaf13ddcb58c211161389052d18e501,4,53,77,130,13,2014-06-30 07:44:30,2014-06-26 08:57:36
0723bf1afaaf13ddcb58c211161389052d18e501...4ca8a175a2695dd2fc28084253a4471bad30bf00,5,42,26,68,9,2014-06-30 07:44:30,2014-06-26 09:58:40
4ca8a175a2695dd2fc28084253a4471bad30bf00...f0af302c8323cf18943d6de5854bbbaa32d891a9,3,38,11,49,8,2014-06-30 07:44:30,2014-06-26 11:32:35
f0af302c8323cf18943d6de5854bbbaa32d891a9...b6425f33bc0b0547058e96e5ab99a7892d9297f2,3,22,10,32,7,2014-06-30 07:44:30,2014-06-26 12:19:29
b6425f33bc0b0547058e96e5ab99a7892d9297f2...c223fb1a9677ae00285426090618f5762de9f40e,9,190,13,203,20,2014-06-30 07:45:16,2014-06-27 08:14:57
c223fb1a9677ae00285426090618f5762de9f40e...e66a8b4cdab176ff89a685788dcbcac089712e49,9,44,33,77,17,2014-06-30 09:13:24,2014-06-30 08:54:57
e66a8b4cdab176ff89a685788dcbcac089712e49...d145f09cd675fa46a6cc20fac8304f02d2d14656,4,18,45,63,7,2014-06-30 09:38:03,2014-06-30 09:38:03
d145f09cd675fa46a6cc20fac8304f02d2d14656...d3796b84f8f3ab9da30447eb0bac2cf9aed32b31,4,23,9,32,9,2014-06-30 10:41:27,2014-06-30 10:41:27
d3796b84f8f3ab9da30447eb0bac2cf9aed32b31...fdbf77ef994dfdee9377fa917ca35ce3d5bd1231,5,13,20,33,14,2014-06-30 11:27:17,2014-06-30 11:27:17
fdbf77ef994dfdee9377fa917ca35ce3d5bd1231...eb5182ac8da38e0eadd87cee7385965f05dabc9d,1,70,0,70,1,2014-06-30 13:00:12,2014-06-30 13:00:12
eb5182ac8da38e0eadd87cee7385965f05dabc9d...3e52517da1c506885c06c13ff59ff5863bcb68ea,6,122,9,131,12,2014-06-30 14:18:26,2014-06-30 14:18:26
87eda15b7b4c809415000f1298dec5c88ae4e8a0...6947d3c0baba7fd68e8373892c6fdad73e0c0457,1,5,8,13,5,2014-07-04 23:03:33,2014-07-04 23:03:33
fa17712c56ace6aa6bb83a75b4f11606549870ce...a30ce86690025a57264b2e9f619a75ee8cdf4826,3,58,75,133,8,2013-09-10 07:17:15,2013-09-10 07:17:15
a30ce86690025a57264b2e9f619a75ee8cdf4826...94d364e8cc84d82d278fee3881f5fab48a149ed2,6,30,28,58,11,2013-09-10 10:15:49,2013-09-10 10:15:49
94d364e8cc84d82d278fee3881f5fab48a149ed2...eaa2781d9cc15590533038647c4901672cef7c6f,1,6,0,6,2,2013-09-10 10:37:56,2013-09-10 10:37:56
eaa2781d9cc15590533038647c4901672cef7c6f...6cc2e6d7edd38cb81c1eabfb0b2607c256785bb3,1,3,2,5,2,2013-09-10 10:42:53,2013-09-10 10:42:53
6cc2e6d7edd38cb81c1eabfb0b2607c256785bb3...3811e4348187ff3dbe9a257c53798e726a851b55,1,1,1,2,1,2013-09-10 10:43:06,2013-09-10 10:43:06
c7cb7599e23a37f3ff97522a43bbd97222d86774...e19526c2ac3e6a8ae62934c09ac70219062c818a,2,14,1,15,2,2013-09-11 12:10:45,2013-09-11 12:10:45
fc6ed495487084b051d7228fdafe814784ea3ea0...4002561e1798bc1b6609c3ea852b0bf568f1e51d,2,45,12,57,2,2013-09-11 19:20:51,2013-09-11 19:20:51
fc6ed495487084b051d7228fdafe814784ea3ea0...73446fe15e35c6e9d077b071bec7f06f64a1b6b9,6,37,13,50,7,2013-09-11 18:17:28,2013-09-11 18:17:28
73446fe15e35c6e9d077b071bec7f06f64a1b6b9...8589824f005dc6d0c8291c454ff7ecdcadacf695,2,36,0,36,2,2013-09-12 15:59:31,2013-09-12 15:59:31
8589824f005dc6d0c8291c454ff7ecdcadacf695...c1dd31cf8bd98ec1a8d951fa6211bfa799233650,3,29,0,29,3,2013-09-12 16:00:32,2013-09-12 16:00:32
c9f741bb07bac1722dcbfeb909acd4ed49d1d1ae...13fec18ac9cbdecdef3b0e5fb7dd7480e9d7cbbf,3,11,2,13,3,2013-09-11 19:46:37,2013-09-11 19:46:37
13fec18ac9cbdecdef3b0e5fb7dd7480e9d7cbbf...7bf8d22f178d5628e9c2dc8e79ec94a016e1d69b,3,0,71,71,5,2013-09-11 19:50:08,2013-09-11 19:50:08
71d31a38fc73252a76076820c63d054a8047d667...01ff084a4df76ba0856a513aca9bdf8f1d550365,11,108,9,117,16,2013-09-07 11:44:03,2013-09-04 07:33:09
640175f5a550219ae732d1f893fa4f00b0b8c575...0f72f00ce93be37986e8ffba096f937700701ee0,2,5,5,10,4,2013-12-29 10:27:33,2013-12-29 10:27:33
075650fc6b269decd5691aa4fe669ebad3800f48...e7a35a94c9a39af94f1481eb554d3ed32cceca64,1,0,3,3,1,2013-12-29 13:55:09,2013-12-29 13:55:09
e7a35a94c9a39af94f1481eb554d3ed32cceca64...34b0bea0221ecdfb2e38b54af06cab5184704dc4,1,1,0,1,1,2013-12-29 14:47:31,2013-12-29 14:47:31
34b0bea0221ecdfb2e38b54af06cab5184704dc4...6ee3934028889c739eaf69e1c92b9854f7a29661,2,9,4,13,3,2013-12-29 16:13:16,2013-12-29 16:13:16
6ee3934028889c739eaf69e1c92b9854f7a29661...988ce2c0af072abb52cf9547a5afd0d0e98255d1,2,3,3,6,3,2013-12-29 16:18:36,2013-12-29 16:18:36
988ce2c0af072abb52cf9547a5afd0d0e98255d1...586678622c0e96a5d86c895daf7a307ff5d4d6e4,2,15,4,19,3,2013-12-29 16:36:41,2013-12-29 16:36:41
586678622c0e96a5d86c895daf7a307ff5d4d6e4...6f99361b74d77d6ec803a2795b7e27cb062cd7a2,2,5,1,6,2,2013-12-29 16:58:47,2013-12-29 16:58:47
6f99361b74d77d6ec803a2795b7e27cb062cd7a2...e2dbe0fad7f04826bde06ae9e8d16ca0bc8a2ce2,1,1,1,2,1,2013-12-30 07:59:42,2013-12-30 07:59:42
8bc65f6d4bc665a1bde9ae2863eb884050acff1d...80e784edb859cbe208721a330b7e37dbffc4331b,3,244,241,485,4,2015-01-15 05:43:31,2015-01-15 05:43:31
80e784edb859cbe208721a330b7e37dbffc4331b...4babc50eb706834b7707f1cf11849df1d5be9b86,9,210,194,404,15,2015-01-15 06:42:58,2015-01-15 06:42:58
4babc50eb706834b7707f1cf11849df1d5be9b86...23498337b17fe5f94bd87884ee6773187ec993a8,2,7,4,11,3,2015-01-15 07:09:30,2015-01-15 07:09:30
23498337b17fe5f94bd87884ee6773187ec993a8...3333bd46085230ddbfd2a2208a7811507fc66317,1,3,0,3,3,2015-01-15 07:18:21,2015-01-15 07:18:21
3333bd46085230ddbfd2a2208a7811507fc66317...cad685e70b704a98778aa11a5f3c3448334367ff,8,125,141,266,10,2015-01-15 08:15:12,2015-01-15 08:15:12
cad685e70b704a98778aa11a5f3c3448334367ff...10f45cf33a0d403b18116d500e4cce2bb0f0dceb,1,5,10,15,5,2015-01-15 08:37:33,2015-01-15 08:37:33
10f45cf33a0d403b18116d500e4cce2bb0f0dceb...b124d9e0bb35cbd77e441197f2f94a785d4f1f7b,1,8,7,15,1,2015-01-15 09:17:07,2015-01-15 09:17:07
0eaabc270868b79185f72ac6e99551e33dbb3c23...e535d217687d3f00844857400282462dfa13049c,1,5,1,6,1,2015-03-18 18:50:27,2015-03-18 18:38:58
c83e19c0e212082cd021a028ef294f522d4ae088...d3d64a4512566015d4ee523cddef4f393c194b45,1,1,1,2,1,2015-01-24 04:41:51,2015-01-24 04:41:51
d3d64a4512566015d4ee523cddef4f393c194b45...a6bdf7d8769c1726084f42a510b6aed097fffbf2,2,7,3,10,3,2015-01-24 04:50:17,2015-01-24 04:50:17
89f9ae77e2c3238c21d25ce9bfe57d6a466d71c6...3588a07b8379c98029598cac8050a1f90fd9c354,3,0,4,4,2,2015-01-25 07:08:52,2015-01-25 07:08:52
e60fd1f644918948df36c5e65c563d9a11c73c37...76027e5efd739f9699f92c8e8cc0199ab17d7c47,3,43,18,61,15,2015-02-03 02:54:27,2015-02-03 02:54:27
76027e5efd739f9699f92c8e8cc0199ab17d7c47...46b6ceeac7a6c24456a5669a49599e4d7fcd4755,1,988,8,996,9,2015-02-03 03:11:45,2015-02-03 03:11:45
25a5c84820c273a2dd76baa600a095fecc7c526a...a42d84eca30956ca9255f93e6803efb43e1874cf,2,3,3,6,3,2015-01-23 22:38:20,2015-01-23 22:38:20
a42d84eca30956ca9255f93e6803efb43e1874cf...893a68baf34bce26cb7cab0bc486b0b791308176,1,12,8,20,3,2015-01-24 00:17:27,2015-01-24 00:17:27
98116b768c5bf74799fb7d5bd283cec0d99dc73b...7a5784ec41c6d51df75dc7cf284045edfc644c7c,1,4,0,4,1,2015-01-30 06:03:34,2015-01-30 06:03:34
d54f80980432d781b8730c672576e5e47620f502...ca701a964971a3291270e60669757c9853e3cf66,2,23,2,25,3,2015-01-29 21:28:41,2015-01-29 21:28:41
d54f80980432d781b8730c672576e5e47620f502...9de4e696a68b7a0fb4d1e04becac24813fc4c922,1,4,4,8,2,2015-01-29 18:14:30,2015-01-29 17:01:27
9de4e696a68b7a0fb4d1e04becac24813fc4c922...ed17adfbcd7f279747ac8f23da079808299b06e6,3,6,6,12,6,2015-01-29 18:14:30,2015-01-29 17:15:15
d54f80980432d781b8730c672576e5e47620f502...ff56b2d9edee0ed0c5bb6964446fab1d66222f38,2,4,2,6,3,2015-01-29 18:13:12,2015-01-29 08:30:21
d54f80980432d781b8730c672576e5e47620f502...4eafc188437e0214c09d59083586ea871b625b14,3,83,37,120,18,2015-01-29 18:03:47,2015-01-29 04:08:28
47f3218e6fa8e1f475e41f0f927a358ebd7f102a...561a7153082ef6cad7ec244d7881b8ddd35b9f8c,1,21,1,22,2,2015-02-02 18:00:05,2015-02-02 18:00:05
1bdd3ce4633049d8f86582bf4b0209d6c03074d0...c0acb28c4ec710c90eb55dc996251a30001c8e79,9,87,2,89,9,2015-02-02 18:24:40,2015-02-02 18:24:40
157b4b4b1f41267375d3b32c9c1606a538eb8488...f6add983d332758cd1ae22732da762cff608af1e,5,20,2,22,3,2015-02-24 09:42:07,2015-02-24 09:42:07
3d1a246f2c9c146d444aad68567eb06b84d82783...25ee53c3aea763f794948947a6f4c4fd422bbf7b,2,2,2,4,2,2014-09-12 09:19:38,2014-09-12 09:19:38
3d1a246f2c9c146d444aad68567eb06b84d82783...47171aab3d50fc87e1b81811f9f2a7d109b2857f,1,1,0,1,1,2014-09-12 09:07:17,2014-09-12 09:07:17
638331d05a23eed00a3596a0d2ec02aa0f917337...6b7e80cb198926a07e3fc94ca850edd4ed4169b8,2,10,4,14,3,2014-09-09 14:56:33,2014-09-09 14:56:33
84b6163b794c101370c1713a68cb24c6b586c2d5...c86962e098f1fa6b5f5a616d29e3adac118ff436,3,16,16,32,16,2014-07-19 11:27:01,2014-07-19 11:27:01
84b6163b794c101370c1713a68cb24c6b586c2d5...3926150f5ffedd3257ba9a00ffb87560b9fc7af7,1,1,1,2,1,2014-07-18 13:17:40,2014-07-18 13:15:53
bf5fb04e5c23af42680d126f44031d7c4331b563...9f505954a602aae78032b385b2435cfae59c3a41,2,12,11,23,4,2014-09-06 10:20:37,2014-09-06 10:20:37
f42a1ded99920998a9b63b309adc227485428d2c...a0dbcd2365b9c90892ccd0c5dfb18c7c58de8704,20,84,113,197,51,2014-09-10 14:56:39,2014-09-08 00:54:18
f42a1ded99920998a9b63b309adc227485428d2c...7f7bf86bbffee21e577ab559c10f9f3b7ab79e49,4,10,4,14,5,2014-09-08 18:49:15,2014-09-08 06:47:26
f42a1ded99920998a9b63b309adc227485428d2c...5d5d4ef91a31d39f15662a6a6bd8a314d860e608,7,58,39,97,15,2014-09-07 22:31:13,2014-09-07 22:31:13
c5678d4ecb9e557c9e70ddddbef493470d2fc229...2a4c73c0a204575d9e3e2d275fa46b65722733a5,1,1,1,2,1,2014-07-21 19:47:41,2014-07-21 19:47:41
2a4c73c0a204575d9e3e2d275fa46b65722733a5...af2a6ec1507e4145f14b0cbaccc7f75447c168cc,2,17,0,17,2,2014-07-21 19:52:01,2014-07-21 19:52:01
98c66b508caa810eb0d6b0f060aaee9e43411df5...68a9203bcef1e44bdf72acf4cc8d4977eec79b7a,1,1,1,2,1,2014-07-22 06:52:19,2014-07-22 06:52:19
fe2cb593f99f0cf2c4ac4efe624ae8b4b11f1be8...a5379ef9f785e66d56c43d0bd792e4da37f929a9,1,12,12,24,4,2014-07-05 07:24:57,2014-07-05 07:24:57
7e41eca38ae4598e083372777c20ff6aa2b491ad...7be6b8ca73b1bd7fd46f01ca43fe9d57a2ba0809,3,168,1,169,4,2014-06-05 13:54:50,2014-06-05 13:03:50
7e41eca38ae4598e083372777c20ff6aa2b491ad...ffd50e8cf562b69a897e389a968b9366ee1e6aae,2,12,5,17,3,2014-06-05 13:28:13,2014-06-05 13:28:13
7e41eca38ae4598e083372777c20ff6aa2b491ad...23626780c4636b6c6f46b259a827ceb9c289c101,1,101,1,102,2,2014-06-05 13:26:00,2014-06-04 15:56:02
7e41eca38ae4598e083372777c20ff6aa2b491ad...27f32ac6486c3bbd0ca3a5a19aa3aa1a4e4ded93,1,0,1,1,1,2014-06-05 12:47:51,2014-06-05 12:47:51
f7cf0286116cb6c771e539d34921b4b5f472be68...440036df69d147fcd4df10a85731199e6aa1d84b,1,6,6,12,3,2014-06-06 06:01:09,2014-06-06 06:01:09
440036df69d147fcd4df10a85731199e6aa1d84b...67ba36ebaca1a6346d443952ec06ac089a217de7,4,30,31,61,14,2014-06-06 06:01:17,2014-06-06 06:01:17
f7cf0286116cb6c771e539d34921b4b5f472be68...dccfb374d396b1b7cbd86bde848165796618ef52,1,8,1,9,5,2014-06-06 01:58:20,2014-06-06 01:58:20
f7cf0286116cb6c771e539d34921b4b5f472be68...7040a42cfc0e2a0a3c7d510bde7a75b06a4530db,1,4,1,5,3,2014-06-06 01:31:55,2014-06-06 01:31:55
7040a42cfc0e2a0a3c7d510bde7a75b06a4530db...1e160e130de2f4702a928b2ee951c1c11316207f,1,1,0,1,1,2014-06-06 01:32:39,2014-06-06 01:32:39
d1f3643cbcf35034be71842733d8fe0937474139...314e4736e485ef00092ff7248503b439fac5c490,2,6,2,8,2,2014-06-11 15:06:28,2014-06-11 15:06:28
b27705ce4b11d4ba83393b8eb7eb1e2c55588647...4594ca888610758ba916e1b2f36cdf92b1bdae41,1,2,2,4,2,2014-06-11 16:13:05,2014-06-11 16:13:05
4f9669cd9f35a72dd9c950decccbe012d1a3d957...e6f1eef47858e21dad9526a45586c609f8dea5e8,1,4,4,8,4,2014-05-29 18:30:07,2014-05-29 18:30:07
e6f1eef47858e21dad9526a45586c609f8dea5e8...5b26b45dcbba8ee11177eef348502bd2ea3b037f,6,106,90,196,15,2014-05-29 18:30:20,2014-05-29 18:30:20
6bd114a700b90a9686294e91b7c5a6bee25f0cdf...2273234653924b731f9ef01432e392481ee1d4e2,9,127,23,150,21,2014-05-28 14:51:47,2014-05-28 03:47:00
6bd114a700b90a9686294e91b7c5a6bee25f0cdf...ca907e4f9f37acac51b60bd95fb495780e4c9a84,1,6,8,14,4,2014-05-28 07:28:39,2014-05-28 07:28:39
86f1f8335fea3b5b35c9755fd26c1e4cbf7d2e1e...91c1534e59c0492546c46724f9d401c40e1c9133,1,1,0,1,1,2014-07-30 16:09:24,2014-07-30 16:09:24
91c1534e59c0492546c46724f9d401c40e1c9133...2ecc79507a4a9556f6f609c7289b7b0942ccc6bb,3,4,2,6,3,2014-07-30 16:13:35,2014-07-30 16:13:35
2ecc79507a4a9556f6f609c7289b7b0942ccc6bb...51d2910a7455f685a6981d02ab880c01bd44028b,1,1,0,1,1,2014-07-30 16:22:24,2014-07-30 16:22:24
51d2910a7455f685a6981d02ab880c01bd44028b...ecbb3ddf212dd274bbba201b3297219fe2070db5,2,8,3,11,3,2014-07-30 16:35:36,2014-07-30 16:35:36
bdb9340e4d0fc0badb5202a5c910be8cdf2ba180...d3067379a407ef04c7ba5823114e2cc541dc6860,1,2,2,4,2,2014-08-11 09:48:00,2014-08-11 09:48:00
d3067379a407ef04c7ba5823114e2cc541dc6860...ddd238eff87cb2df799b17dd3e8701780cc4d5b4,1,0,1,1,1,2014-08-11 10:00:37,2014-08-11 10:00:37
e918ae240ee860c9126f537bbee38a1e92cb7508...f4889f50fcd9ec8df9a1f44def25bb9ea384a3bf,1,1,0,1,1,2014-05-27 06:58:26,2014-05-27 06:58:26
31773f4dd7f89df7cea3ef4b3f547b479329ef9e...4fdd21685cbbac7fc23e17c531cf28eeecc98577,4,59,4,63,14,2014-09-01 11:51:40,2014-08-14 10:41:16
1db77dc14bbc48dcf9ed07a344fdc3e4df8cd733...8eff8bcebfcf8c6e12a653ad1955f859bdb4a55a,1,1,1,2,1,2014-08-18 16:23:45,2014-08-18 16:23:45
8d7ed7e53bed1e58515ea9c2da4c27fd59d2970c...41cfdd25e21efc4be563a8061a8c1656eeda22ed,1,1,1,2,1,2014-09-24 09:50:00,2014-09-24 09:50:00
8d7ed7e53bed1e58515ea9c2da4c27fd59d2970c...3aa7132adc114934f51c78935903b6730bc173e6,1,180,0,180,1,2014-09-24 08:37:30,2014-09-24 08:37:30
3aa7132adc114934f51c78935903b6730bc173e6...15ba6ea1055350cc80c6d0f9ff60e3425bd553a7,1,66,119,185,7,2014-09-24 09:04:40,2014-09-24 09:04:40
6da15541d3d3844a07bfa2a2495fdc3c09ce5191...b9c2e6ebdc17f1e57cdf8161fde661340eb7d1ed,1,1,1,2,1,2014-09-24 08:03:51,2014-09-24 06:52:38
6da15541d3d3844a07bfa2a2495fdc3c09ce5191...4e89860826628945cbed35b170913da34c2a51c3,1,2,2,4,2,2014-09-24 07:51:27,2014-09-24 07:51:27
90c96d1dc0ee68c89989b44967e1e94000058d38...ca840e8769fa75f786bf01e1ac839a81bd8ac32b,1,1,1,2,1,2014-10-06 12:28:10,2014-10-06 12:28:10
90c96d1dc0ee68c89989b44967e1e94000058d38...299114948bc12c92fb182e739b7cbb47d310d9e6,3,6,2,8,3,2014-10-06 12:15:39,2014-10-06 12:15:39
90c96d1dc0ee68c89989b44967e1e94000058d38...46b7a3f8f550bce35a206ef8e36c9d1072eac746,2,29,4,33,4,2014-10-06 12:07:36,2014-10-06 12:07:36
27cf081e1b0b1df1661aaf0ae6b60b05ef3eb8d8...4ca3f64719f924a483b19ba921f41ac06c3b6a63,3,15,16,31,14,2014-08-17 22:25:49,2014-08-17 22:25:49
27cf081e1b0b1df1661aaf0ae6b60b05ef3eb8d8...68c87a2de3e3de1f9127c9d2196a45493a13141f,1,2,0,2,1,2014-08-17 19:15:22,2014-08-17 19:15:22
27cf081e1b0b1df1661aaf0ae6b60b05ef3eb8d8...2ca928d49a60e96b29bb2cc3d60de7e3ee268754,1,1,1,2,1,2014-08-17 17:58:57,2014-08-17 17:58:57
27cf081e1b0b1df1661aaf0ae6b60b05ef3eb8d8...50c2efea03685532024e32e2c1376cac4ed0f904,3,18,3,21,3,2014-08-17 15:05:32,2014-08-17 15:05:32
27cf081e1b0b1df1661aaf0ae6b60b05ef3eb8d8...ec381a93089605afc33b387a09de3a828c63d535,1,1,1,2,1,2014-08-15 09:38:32,2014-08-15 09:38:32
27cf081e1b0b1df1661aaf0ae6b60b05ef3eb8d8...938eed1ef8c8d123920ce9466d6879676716d7c1,2,8,8,16,2,2014-08-15 09:02:05,2014-08-15 09:02:05
27cf081e1b0b1df1661aaf0ae6b60b05ef3eb8d8...6063a1e6c1d7b4877b6f2c1168246977aab15fcd,2,4,0,4,4,2014-08-15 08:59:19,2014-08-15 08:59:19
27cf081e1b0b1df1661aaf0ae6b60b05ef3eb8d8...a1d0997850408c29b32d117e2127b2b2f50fd3c7,1,70,89,159,32,2014-08-15 08:52:37,2014-08-15 06:54:50
9879c427cef89a65d721133a62ff41a6e2a9057a...a10f5fadb51ea6c516495c7e92c9527487cbc736,1,6,2,8,2,2014-07-18 11:20:18,2014-07-16 03:03:17
9879c427cef89a65d721133a62ff41a6e2a9057a...824821b4e9e29986de517b528759630b7fd11780,1,1,1,2,1,2014-07-17 21:33:21,2014-07-17 21:33:21
9879c427cef89a65d721133a62ff41a6e2a9057a...4f00d8fd1c4430dcf71df31758eddf30353b4657,1,3,0,3,1,2014-07-16 06:30:14,2014-07-16 06:30:14
e5e3fcaf791801103e325ec54e7ca0fa00d08a50...af6842a97dbd834d1bd635c69419eded74942c06,1,106,0,106,1,2014-08-19 12:13:16,2014-08-19 12:13:16
af6842a97dbd834d1bd635c69419eded74942c06...0b3ebb6440420de714fe5066aba19ca77e8b1b8f,1,147,0,147,1,2014-08-19 12:24:47,2014-08-19 12:24:02
eb7baeef9b1759525d51741e22e8caf20f9ad7ac...352af72f434046b1c1562641f904b4d20fe7ef54,1,1,1,2,1,2014-08-06 09:28:14,2014-08-06 09:28:14
8fb76a8308292d991a32ea76e50fb5ecfa3284b2...2e3818f14f1c8ac54f36c216082dcab0d5cce99a,1,12,0,12,1,2014-07-02 06:49:10,2014-07-02 06:49:10
2e3818f14f1c8ac54f36c216082dcab0d5cce99a...81d41c0f927f69d75937d3c8f757740e936ed6e9,2,36,1,37,4,2014-07-02 09:40:20,2014-07-02 09:40:20
81d41c0f927f69d75937d3c8f757740e936ed6e9...5a88873e5cac26edf65dcfae8d449beb4ed865bb,4,38,24,62,4,2014-07-02 11:43:23,2014-07-02 11:43:23
5a88873e5cac26edf65dcfae8d449beb4ed865bb...767bd7808153d3ec5ead766dcbd655523afd5324,4,16,17,33,9,2014-07-02 12:09:06,2014-07-02 12:09:06
767bd7808153d3ec5ead766dcbd655523afd5324...dacf9f9f863dcb67a3dcb8dcfc4c151b10bca5e3,1,29,0,29,1,2014-07-02 16:17:56,2014-07-02 16:17:56
8fb76a8308292d991a32ea76e50fb5ecfa3284b2...b5543be19dc4e6c546e5fb98eb8dc5ff47f66815,1,8,9,17,2,2014-07-01 12:49:40,2014-07-01 12:49:40
b5543be19dc4e6c546e5fb98eb8dc5ff47f66815...e12a517e8310f8ec9961b9faddeaec061af383b7,1,5,3,8,2,2014-07-01 14:20:07,2014-07-01 14:20:07
8fb76a8308292d991a32ea76e50fb5ecfa3284b2...815fbbbf917021ec41c1310ff93358f54c6bf615,4,4,4,8,4,2014-07-01 12:16:37,2014-07-01 12:16:37
8fb76a8308292d991a32ea76e50fb5ecfa3284b2...751d267f299d6851a19f4ff19e9e60a91c10e62d,1,4,0,4,1,2014-07-01 12:03:49,2014-07-01 12:03:49
593e262e40329d2feb9bea1592c4ee7b6bcefac2...d51294b99f3d87faf48243db6664513e9a880e29,1,2,2,4,2,2014-07-08 12:48:25,2014-07-08 12:48:25
839c3b198e50ac38d1c647189927e18f36133518...e1ca9de0dabb9d1da13073110072b3327280eb55,1,1,1,2,1,2013-09-12 18:46:31,2013-09-12 18:46:31
7bf8d22f178d5628e9c2dc8e79ec94a016e1d69b...cb6d7e5192c926b61d8cbdd4f4e0d45813ed7a09,2,9,3,12,3,2013-09-12 13:28:46,2013-09-12 13:28:46
7bf8d22f178d5628e9c2dc8e79ec94a016e1d69b...5c2d3c8e50b55e04d7094f9d4a95e7f6f88894ce,2,2,2,4,2,2013-09-12 12:30:55,2013-09-12 12:30:55
7bf8d22f178d5628e9c2dc8e79ec94a016e1d69b...811622346bbcec03d2084a8a1259f3100fdbeaa2,1,1,1,2,1,2013-09-12 11:33:09,2013-09-12 11:33:09
7bf8d22f178d5628e9c2dc8e79ec94a016e1d69b...0a05ab9126aa1edadea069e9e7dbe272da4b9618,3,16,2,18,4,2013-09-12 02:53:37,2013-09-11 01:36:04
e2dbe0fad7f04826bde06ae9e8d16ca0bc8a2ce2...02822f74dac710504f171e67f26ee64e063a2ff6,1,5,0,5,1,2013-12-30 15:34:27,2013-12-30 15:34:27
02822f74dac710504f171e67f26ee64e063a2ff6...9393809066c10d1568e75372a8c99c3a67bed489,2,5,1,6,2,2013-12-30 20:14:15,2013-12-30 20:14:15
9393809066c10d1568e75372a8c99c3a67bed489...ee3046f9a9f496b84b6b1e5e0d17dc69cecc72ff,1,1,1,2,1,2013-12-30 22:44:11,2013-12-30 22:44:11
ee3046f9a9f496b84b6b1e5e0d17dc69cecc72ff...b75401d5910af3744596d54dba36ba4de87aae4e,1,5,5,10,2,2014-01-20 10:45:17,2014-01-20 10:45:17
b75401d5910af3744596d54dba36ba4de87aae4e...fb782476f9b68641019d91cf6de9899333518ab5,2,2,2,4,2,2014-01-20 11:26:34,2014-01-20 11:26:34
fb782476f9b68641019d91cf6de9899333518ab5...e77694bff3e0867f226be28108b814895d32d354,1,5,0,5,1,2014-01-20 13:00:50,2014-01-20 13:00:50
e2dbe0fad7f04826bde06ae9e8d16ca0bc8a2ce2...9a7e2399dd766bae96ed15b6e6d4c69374d310fe,3,6,5,11,5,2013-12-30 12:38:42,2013-12-30 12:38:42
9a7e2399dd766bae96ed15b6e6d4c69374d310fe...9a31844e2af5473184538472b4aa105245f25aec,25,30,31,61,30,2013-12-30 12:49:22,2013-12-30 12:49:22
e2dbe0fad7f04826bde06ae9e8d16ca0bc8a2ce2...568d1c27c5a1b4d6749943240cdba2625eee2b6e,1,10,4,14,4,2013-12-30 12:26:35,2013-12-30 12:26:35
e2dbe0fad7f04826bde06ae9e8d16ca0bc8a2ce2...92343f42ba5eaf7d34615fcf01a6277adc1e59ed,1,6,9,15,6,2013-12-30 10:00:45,2013-12-30 10:00:45
92343f42ba5eaf7d34615fcf01a6277adc1e59ed...2cc162d6875540f20617890fc557b0e8dac83e78,1,1,1,2,1,2013-12-30 10:02:15,2013-12-30 10:02:15
e2dbe0fad7f04826bde06ae9e8d16ca0bc8a2ce2...94c96cd4458b89e3280fec8cc8ed42a69e063191,2,3,0,3,2,2013-12-30 08:41:05,2013-12-30 08:41:05
1e0f36b42a7e8fe8a4549b31233262fedfda742c...c6ab8d04e865c69f53aba7ba1da0b120aaa342b9,1,1,1,2,1,2015-01-15 18:34:40,2015-01-15 18:34:40
1e0f36b42a7e8fe8a4549b31233262fedfda742c...a0d4235c04e8f47e8625a6f46d64b65df599b370,2,70,52,122,7,2015-01-15 18:26:33,2015-01-15 18:26:33
a0d4235c04e8f47e8625a6f46d64b65df599b370...de27375d6cb2772b91459f5e706aed5b03b35a54,2,8,4,12,3,2015-01-15 19:17:47,2015-01-15 19:17:47
1e0f36b42a7e8fe8a4549b31233262fedfda742c...b79ada97bb8e85c85472e0cee269a28c0e6d5ef7,12,12,772,784,17,2015-01-15 13:10:13,2015-01-15 13:02:09
1e0f36b42a7e8fe8a4549b31233262fedfda742c...377ae460056bb2a4e5824c4f7a3bbcb481e3e38b,2,17,14,31,9,2015-01-15 12:13:54,2014-12-03 13:50:06
377ae460056bb2a4e5824c4f7a3bbcb481e3e38b...bf079c24afb8ad2991a4eaf60a71a7bc45dd775d,31,497,743,1240,56,2015-01-15 12:41:11,2014-12-03 14:27:31
bf079c24afb8ad2991a4eaf60a71a7bc45dd775d...089516209c0c9c618b359aaa59e26395e2f67405,3,4,3,7,3,2015-01-15 13:01:12,2015-01-15 11:19:34
50b6c66129a54e416e77a50aec4c2d271a2c17e7...63f712948307723052589895d5bb993df03eafbd,1,4,2,6,2,2015-03-18 20:55:41,2015-03-18 20:55:41
7ed6da5454c98e78770cee13ac929f5f608a34a1...e7e329d36402ff84f4ba08184283853518136d7f,1,2,2,4,2,2015-03-18 23:17:30,2015-03-18 23:17:30
a6bdf7d8769c1726084f42a510b6aed097fffbf2...5e98293b0e21a7fd9d62ce7272afef31b8414abb,1,17,8,25,4,2015-01-24 05:03:12,2015-01-24 05:03:12
7a84dcf2226f4b9be0c1ded92c91c2c6ef823970...05b6bb4bf704c2a47d6b2717308ee2ad9b5eec81,1,1,1,2,1,2015-01-26 20:25:13,2015-01-26 20:25:13
3588a07b8379c98029598cac8050a1f90fd9c354...773b1eaf8f81ca6e11b19f2a0b1fcf5ff231399e,1,4,0,4,1,2015-01-25 07:35:02,2015-01-25 07:35:02
7dad2663a671be5cc70db63333dfe033984452d0...4f1d1fc51baf396d49f6b159c84e15194706847c,12,27,31,58,23,2015-02-03 03:30:09,2015-02-03 03:30:09
4f1d1fc51baf396d49f6b159c84e15194706847c...c8e7928e348117447380455684a3689d43fa492b,1,1,1,2,1,2015-02-03 03:33:57,2015-02-03 03:33:57
c8e7928e348117447380455684a3689d43fa492b...afb8ecc3d1569520379a2d0613137c46d44a12ce,1,7,5,12,1,2015-02-03 04:02:46,2015-02-03 04:02:46
630ff5744b58923890a269762bf3a3c9b1f6663f...0b404c3599841fba3c118ecd6eb996b074fcfa11,1,3,0,3,1,2015-01-24 02:14:26,2015-01-24 02:14:26
0b404c3599841fba3c118ecd6eb996b074fcfa11...a250fa5feb310ca6def85ae3b9947247ac2ecf98,2,11,2,13,2,2015-01-24 02:17:55,2015-01-24 02:17:55
a250fa5feb310ca6def85ae3b9947247ac2ecf98...1b1277af46d894a0ed8b9ed625a0fe361863970c,1,4,3,7,2,2015-01-24 02:18:04,2015-01-24 02:18:04
630ff5744b58923890a269762bf3a3c9b1f6663f...3dfcb95f0d5a9851b3829f357bc53abb96c0e6ba,2,3,3,6,3,2015-01-24 01:41:10,2015-01-24 01:41:10
604f39274dc1558f8710019e226b1a364f056d7e...65a4e64b3ab54e53badce9bff5372188f51c3044,1,1,1,2,1,2015-01-29 23:38:22,2015-01-29 23:38:22
65a4e64b3ab54e53badce9bff5372188f51c3044...5ec36902dd41d1e6383373006ab16f2d1303ee0d,1,0,2,2,1,2015-01-30 00:00:46,2015-01-30 00:00:46
a3c2873f50f42016619f8ffc959cf9e20b5f340d...f1cf49218fb40b61f82ff74dbb7eaba32b439a5a,3,38,10,48,7,2015-01-30 01:07:44,2015-01-30 01:07:44
f1cf49218fb40b61f82ff74dbb7eaba32b439a5a...31245a40c10a556998a9923be21b9ac947232824,2,3,3,6,3,2015-01-30 01:13:28,2015-01-30 01:13:28
31245a40c10a556998a9923be21b9ac947232824...78d7c5087bafc316d298ac01745579990e3dd93c,3,6,2,8,3,2015-01-30 01:30:51,2015-01-30 01:30:51
c0acb28c4ec710c90eb55dc996251a30001c8e79...b60d06eb2c91a61b91a214dac0f0f526b146f8d7,5,111,6,117,7,2015-02-04 09:24:25,2015-02-02 21:08:10
c0acb28c4ec710c90eb55dc996251a30001c8e79...ee955d7a125f9d18ac7ae334542ae68dd8d5114c,7,86,2,88,10,2015-02-03 16:45:33,2015-01-30 19:23:35
c0acb28c4ec710c90eb55dc996251a30001c8e79...97d4ac40477788c1c43d2f32baefd1df1ceeb9f4,8,37,25,62,19,2015-02-03 16:41:32,2015-01-31 04:21:31
c0acb28c4ec710c90eb55dc996251a30001c8e79...ae5743e9c1d32f905aa1c64bce34e20379c85322,1,10,10,20,8,2015-02-03 09:50:10,2015-02-03 09:44:41
c0acb28c4ec710c90eb55dc996251a30001c8e79...7ba97ab4a53eba8d28d028a04e20e6ead1cd9f52,6,24,0,24,2,2015-02-03 00:43:51,2015-02-03 00:43:51
7ba97ab4a53eba8d28d028a04e20e6ead1cd9f52...68fbf1423fddcb7d49e408d05105ca6911e91122,1,13,10,23,4,2015-02-03 19:05:20,2015-02-03 19:05:20
c0acb28c4ec710c90eb55dc996251a30001c8e79...2bd70b6a01b6b5b3406718d1f539f9f480cf3bec,5,18,7,25,8,2015-02-02 23:47:51,2015-02-02 23:47:51
9e4a40982e25b31c0654b295fdf16d9aab2013f5...4e4e1cb9b56cbb7e467a38c89c8c2d38a58b45d2,1,6,0,6,1,2014-09-09 07:36:25,2014-09-09 07:36:25
ee833ddc7de5bed05c37f6e39c6c4706646c933d...3bffae3383fc93802264faef9a85182e23aabc58,1,4,0,4,1,2014-09-09 06:20:18,2014-08-28 13:10:43
6b7e80cb198926a07e3fc94ca850edd4ed4169b8...b0435576df97b06308457456aa10de46fcfce6fe,1,1,1,2,1,2014-09-10 10:22:47,2014-09-10 10:22:47
6b7e80cb198926a07e3fc94ca850edd4ed4169b8...f964067c95082ac2960a7bdc7d8968d5d80424c4,2,5,5,10,4,2014-09-10 09:15:23,2014-09-10 09:15:23
6b7e80cb198926a07e3fc94ca850edd4ed4169b8...f8ec9dd397a1088271766da22ee372a24b64b291,5,91,0,91,7,2014-09-09 21:16:05,2014-08-28 08:57:30
6b7e80cb198926a07e3fc94ca850edd4ed4169b8...083b153d457ec6ea4fe89da286eec0fb9c83ada0,1,8,8,16,3,2014-09-09 17:43:28,2014-09-09 17:43:28
91ab8570c7a63754e04b907ec841ff8cd6ef7adb...6a10e2e52a1ae614fe467245e5e5946e67e0905d,1,1,0,1,1,2014-07-20 06:23:25,2014-07-20 06:23:25
1fd43e1f92d98e7de5c71629116510f331d9bfd6...c23e1f3d4110d57a6756042e13749ad55086d9b9,1,1,2,3,1,2014-07-24 09:48:47,2014-07-24 09:48:47
c23e1f3d4110d57a6756042e13749ad55086d9b9...bb80741c246f8c5050312ec4a770625c8e9d38ed,1,1,0,1,1,2014-07-24 09:49:29,2014-07-24 09:49:29
9f505954a602aae78032b385b2435cfae59c3a41...56b08c7ec6fd96a1822e24dae8dbeb37a66c1613,1,2,0,2,1,2014-09-06 11:29:52,2014-09-06 11:29:52
56b08c7ec6fd96a1822e24dae8dbeb37a66c1613...4585ae37784f7985d414f9c1a6c3ee56148b9c41,1,0,42,42,1,2014-09-06 11:38:55,2014-09-06 11:38:55
de6f4c313509ca6f6450186a8bf0e62e67f01ab1...b54f2393c3e952f8ff9f297b3c848c3c1cede1c9,1,15,35,50,2,2014-09-08 07:05:16,2014-09-03 09:06:08
b54f2393c3e952f8ff9f297b3c848c3c1cede1c9...1067b00724c045b4fa46a9f8ff5acd09d65553e0,3,59,6,65,6,2014-09-08 07:05:16,2014-09-04 08:46:35
1067b00724c045b4fa46a9f8ff5acd09d65553e0...f827482c12b3aeec2ed5f60afbf7c676e27435e3,4,12,46,58,6,2014-09-08 07:05:16,2014-09-04 09:25:14
f827482c12b3aeec2ed5f60afbf7c676e27435e3...357bf00921be191fcd401cdf26d9798f2b57a127,1,6,2,8,2,2014-09-08 07:05:17,2014-09-04 10:05:58
357bf00921be191fcd401cdf26d9798f2b57a127...75b04a17cf27cd7f7a252a697f347c08d58e2fd4,1,14,9,23,5,2014-09-08 07:05:17,2014-09-04 11:27:57
75b04a17cf27cd7f7a252a697f347c08d58e2fd4...dc7554d020f7e278f30c8d4c4113a19f7c3cd82f,1,13,10,23,4,2014-09-08 07:05:17,2014-09-04 11:49:57
dc7554d020f7e278f30c8d4c4113a19f7c3cd82f...721b75733c49117100a5caf04bf6040fe6004dca,3,7,5,12,5,2014-09-08 07:05:17,2014-09-04 12:13:24
721b75733c49117100a5caf04bf6040fe6004dca...7d45624daff1ed4a3896c6270a0911a73f6f815f,1,6,2,8,3,2014-09-08 07:05:17,2014-09-05 07:46:58
7d45624daff1ed4a3896c6270a0911a73f6f815f...13cfa49a3dc90e87a5f6de8cd5c64d0cd0f4202d,1,10,8,18,5,2014-09-08 07:05:17,2014-09-05 08:55:17
13cfa49a3dc90e87a5f6de8cd5c64d0cd0f4202d...23706716fcf57da7ba572a8720c753c75f554b05,2,69,111,180,4,2014-09-08 07:05:17,2014-09-06 18:11:28
23706716fcf57da7ba572a8720c753c75f554b05...205358b1ae71611a04e03789b3bac74bd1052da5,1,6,13,19,2,2014-09-08 07:05:17,2014-09-08 07:04:56
68a9203bcef1e44bdf72acf4cc8d4977eec79b7a...669682686ea32a787aa9ef950388f780cfc00146,3,23,16,39,3,2014-08-06 16:03:01,2014-07-30 07:50:50
669682686ea32a787aa9ef950388f780cfc00146...82dc40936a233edee59b4be45e0458883446ca9e,1,2,7,9,1,2014-08-06 16:03:01,2014-07-30 07:51:12
82dc40936a233edee59b4be45e0458883446ca9e...1118a6fd342f2b5cfe438b63a829368782ff1919,1,23,0,23,1,2014-08-06 16:03:01,2014-08-06 13:16:45
1118a6fd342f2b5cfe438b63a829368782ff1919...e0fea696c6e4eb007c945d63faca594a70dd45e7,2,24,11,35,5,2014-08-06 16:03:01,2014-08-06 13:17:12
68a9203bcef1e44bdf72acf4cc8d4977eec79b7a...059f3a34accb28900a5fad4de2a736d32529a641,1,18,0,18,2,2014-07-23 08:44:27,2014-07-23 08:44:27
68a9203bcef1e44bdf72acf4cc8d4977eec79b7a...667f40d271c12e364fded058c99d54f96fec2d03,1,1,0,1,1,2014-07-23 08:34:28,2014-07-23 08:34:28
68a9203bcef1e44bdf72acf4cc8d4977eec79b7a...6eb50a69f4a1bb55fa7848a6aad68faa45f982c2,1,1,1,2,1,2014-07-23 08:18:41,2014-07-23 08:18:41
68a9203bcef1e44bdf72acf4cc8d4977eec79b7a...ccfd881386ce4ede542d80dbb668afb31e57d0a6,1,15,5,20,6,2014-07-23 07:00:19,2014-07-23 07:00:19
68a9203bcef1e44bdf72acf4cc8d4977eec79b7a...7738383f1b875005400ce34db1498ffd9e404b51,1,3,4,7,2,2014-07-22 14:36:29,2014-07-22 14:36:29
68a9203bcef1e44bdf72acf4cc8d4977eec79b7a...1072c95180aa31b999088fec4d14ce6765041a15,1,4,0,4,1,2014-07-22 11:29:41,2014-07-22 11:29:41
1072c95180aa31b999088fec4d14ce6765041a15...733012cb65e43e41aa3b553c7fd02079cbf9eff4,1,1,1,2,1,2014-10-29 09:52:54,2014-10-29 09:52:54
68a9203bcef1e44bdf72acf4cc8d4977eec79b7a...0c0b737b1e5f3aaf291f0cbc1f2f328caa47a782,1,1,1,2,1,2014-07-22 10:20:35,2014-07-22 10:20:35
d5a8f9ccca0b206c6a111c81a9c1ac2340974e1a...4c68d2387e51632e9808ed3a0db9f6dc14e25b31,1,26,3,29,4,2014-07-07 12:12:06,2014-07-07 12:12:06
4c68d2387e51632e9808ed3a0db9f6dc14e25b31...553f3aba48e7b124b02b0a7eecd85eacec7453e3,1,11,18,29,4,2014-07-07 12:19:32,2014-07-07 12:19:32
553f3aba48e7b124b02b0a7eecd85eacec7453e3...cb4d8eff4cb158fbef4d59bf64e04e776e29eaed,3,5,1,6,3,2014-07-07 12:41:02,2014-07-07 12:41:02
d5a8f9ccca0b206c6a111c81a9c1ac2340974e1a...3aea2f6fe1f0cb968778c5b6f1d048c5d1d9f1fc,1,3,3,6,2,2014-07-05 10:43:46,2014-07-05 10:43:46
70a6af9328b663c93a5802bf689362525ec4ae87...4ca6ebf017e93686ee885ee1a28dc5c6934c9d39,1,38,0,38,1,2014-06-05 17:36:59,2014-06-05 17:36:59
4ca6ebf017e93686ee885ee1a28dc5c6934c9d39...0fdce4a52b1a9ba9e0efd98f00e558e4f07daeb5,10,53,32,85,12,2014-06-05 17:37:35,2014-06-05 17:37:35
67ba36ebaca1a6346d443952ec06ac089a217de7...1a87fb754ed047e5966789f80e8eeedf7bc22473,1,2,0,2,1,2014-06-06 07:36:19,2014-06-06 07:36:19
8ec42ff85ced58f925a1214738c841372f774eda...0faf80aa9d2a32d872a21f125862d46157013082,1,10,13,23,5,2014-06-06 06:25:02,2014-06-06 06:25:02
0faf80aa9d2a32d872a21f125862d46157013082...bd65f486d907b00f588bdfe7c7c241782fb491fd,1,1,1,2,1,2014-06-06 16:58:38,2014-06-06 16:58:38
bd65f486d907b00f588bdfe7c7c241782fb491fd...7cf1a4259ac123725f2eb0ab6fc682e739d45734,1,2,1,3,2,2014-06-06 17:55:49,2014-06-06 17:55:49
7cf1a4259ac123725f2eb0ab6fc682e739d45734...2838a993da78bf365d7a84dc51f57a605fc99c96,1,31,10,41,6,2014-06-07 08:09:56,2014-06-07 08:09:56
4b6c93c127799d088e16be5028088c0d6f48b578...c92ce615bed30f1a1e23707b16814fbc66faf4be,1,2,2,4,2,2014-06-14 14:28:59,2014-06-14 14:28:59
4b6c93c127799d088e16be5028088c0d6f48b578...ac0763ac7a05d3b240877e14ac2cd4d824a57924,1,2,1,3,2,2014-06-11 19:32:00,2014-06-11 19:32:00
4b6c93c127799d088e16be5028088c0d6f48b578...e740a00ed659221929a79e580634424423690514,1,6,1,7,1,2014-06-11 19:08:39,2014-06-11 19:08:39
e740a00ed659221929a79e580634424423690514...afa4a075e463103cd7148bc97db21421a0718a8a,2,6,3,9,2,2014-06-11 19:22:58,2014-06-11 19:22:58
afa4a075e463103cd7148bc97db21421a0718a8a...5b2193555b69f82f2efdadaf62ada1e9c3c2d77a,1,14,0,14,1,2014-06-11 19:53:42,2014-06-11 19:53:42
5b2193555b69f82f2efdadaf62ada1e9c3c2d77a...7ed935b6765ed1e9de810cfdf8ac9f6eb3fb741d,3,4,4,8,4,2014-06-11 20:13:31,2014-06-11 20:13:31
7ed935b6765ed1e9de810cfdf8ac9f6eb3fb741d...56f0f6aba399d85c6e99e69c57a18a040bad4cf3,1,1,1,2,1,2014-06-11 20:37:21,2014-06-11 20:37:21
56f0f6aba399d85c6e99e69c57a18a040bad4cf3...61c2a2d39a3a73761e862818b73940510eb80b80,1,6,1,7,2,2014-06-11 20:43:05,2014-06-11 20:43:05
8f259c5ecca69af417e10cba11c329a95d3052d9...f329d34ff339f0d0da150b262465a654bfe445a5,2,15,3,18,4,2014-05-29 19:03:42,2014-05-29 19:03:42
f329d34ff339f0d0da150b262465a654bfe445a5...7ba1853660e09bc997d829fc596ea576c122086b,1,3,0,3,1,2014-05-30 10:31:45,2014-05-30 08:57:13
64b1956b0bd95abbed25409867cbe93347ea3b71...e52c4a62f23ebc53f65b1acdbbe3e7c055e8a9d7,1,3,3,6,1,2014-05-28 17:08:00,2014-05-28 17:08:00
49c50ee868cc355ae8d748ec67fce2e01311697f...8a3807c83880f71612b1e092c49e865d24e29704,1,0,19,19,1,2014-05-28 09:40:22,2014-05-28 09:40:22
49c50ee868cc355ae8d748ec67fce2e01311697f...a18ae13e985d07fe9ef8288794778d31e2435696,9,61,5,66,11,2014-05-28 08:35:43,2014-05-28 08:35:43
a18ae13e985d07fe9ef8288794778d31e2435696...a3db7631b84b9e41a2191cc2ac9659f921554da5,1,3,3,6,1,2014-05-28 09:52:02,2014-05-28 09:52:02
260c877cab3f4c1d05ab3d984a2fad5a1e018e5e...6ba4cb1d2b0bcfaf8459c8936513637acc92da5e,1,0,111,111,1,2014-05-28 16:01:19,2014-05-28 16:01:19
6ba4cb1d2b0bcfaf8459c8936513637acc92da5e...aca6be50d3dc1963491c9dcff61dac3b3ec937ca,3,63,60,123,7,2014-05-28 16:02:26,2014-05-28 16:02:26
aca6be50d3dc1963491c9dcff61dac3b3ec937ca...aea79b80351109506bd089694df6f22785456f68,4,15,5,20,6,2014-05-28 16:03:01,2014-05-28 16:03:01
aea79b80351109506bd089694df6f22785456f68...900d30798b7eef1301978ff6f97b4cee7414b696,2,6,4,10,3,2014-05-28 16:03:45,2014-05-28 16:03:45
900d30798b7eef1301978ff6f97b4cee7414b696...14f78d067d703c20b788498cd90c40903ba9f84e,2,29,16,45,11,2014-05-28 16:04:18,2014-05-28 16:04:18
14f78d067d703c20b788498cd90c40903ba9f84e...1932f902d51d17ff4eb4ebfd15a16fac55cf9eb4,3,3,3,6,3,2014-05-28 16:04:42,2014-05-28 16:04:42
1932f902d51d17ff4eb4ebfd15a16fac55cf9eb4...cea0fc1de80242a5849cff343148328028b81914,1,0,1,1,1,2014-05-28 16:33:49,2014-05-28 16:33:49
260c877cab3f4c1d05ab3d984a2fad5a1e018e5e...b7de9de4d2682a7af66e1fd8db5ec0a3fcf8980e,1,32,6,38,5,2014-05-28 15:09:20,2014-05-28 15:09:20
b7de9de4d2682a7af66e1fd8db5ec0a3fcf8980e...bc62c283c6f769a8f82842d13e909209296c4d3b,1,7,6,13,5,2014-05-29 13:42:20,2014-05-29 13:42:20
ecbb3ddf212dd274bbba201b3297219fe2070db5...e27a822405ba0a219a2a0dbb6e52c7b4ac38f3b7,1,3,0,3,1,2014-07-30 17:14:56,2014-07-30 17:14:56
f4889f50fcd9ec8df9a1f44def25bb9ea384a3bf...d7b3bbfc4ab9d128f0d9c4734b3a7bebbc5d6eef,2,13,4,17,4,2014-05-27 09:06:31,2014-05-27 09:06:31
4102eb3b85a1a9d43bebe116066719e6b0872566...9a1dcf8d21e20b141b209f75db227dbfdf096bfc,1,40,5,45,7,2014-09-08 08:21:21,2014-09-08 08:21:21
4102eb3b85a1a9d43bebe116066719e6b0872566...c586192813ad73e306a97b57f4cc97b00aaa6ca6,3,8,12,20,3,2014-09-02 23:33:02,2014-09-02 23:26:40
4102eb3b85a1a9d43bebe116066719e6b0872566...a2b6c1e65f9decaf92a0abe1720336d38212d787,2,2,2,4,2,2014-09-02 08:47:25,2014-09-02 08:47:25
4102eb3b85a1a9d43bebe116066719e6b0872566...30db1405d65eebff2d557a602d6114a2889dd882,1,4,2,6,2,2014-09-02 05:48:57,2014-09-02 05:48:57
4102eb3b85a1a9d43bebe116066719e6b0872566...46c3bbd78d7062f8c67ecbadb34d85528d5c88f9,1,2,2,4,2,2014-09-02 02:33:13,2014-09-02 02:33:13
4102eb3b85a1a9d43bebe116066719e6b0872566...60e24f4973d6c999d5ffa7b3b3d542348ace786e,7,0,7,7,7,2014-09-01 23:39:56,2014-09-01 23:39:56
4102eb3b85a1a9d43bebe116066719e6b0872566...765eabeacccbc199bb2a762dffdb7abde6adb246,1,2,0,2,1,2014-09-01 22:47:15,2014-09-01 22:47:15
4102eb3b85a1a9d43bebe116066719e6b0872566...0306a4e2e4e16443128ced5e8758752c4d9bf3c9,3,33,13,46,9,2014-09-01 16:57:25,2014-09-01 16:57:25
0306a4e2e4e16443128ced5e8758752c4d9bf3c9...730712f77e4ebaf10b6181672b5f85cf984ac27f,1,16,11,27,4,2014-09-02 07:58:54,2014-09-02 07:58:54
730712f77e4ebaf10b6181672b5f85cf984ac27f...fc65f71747a9b07cac3cb765c043150877a98565,1,7,4,11,5,2014-09-02 08:05:51,2014-09-02 08:05:51
fc65f71747a9b07cac3cb765c043150877a98565...7f99aa57a28f56c6e04263cd7c2785ed867ec9a1,1,1,2,3,2,2014-09-02 08:35:34,2014-09-02 08:35:34
4102eb3b85a1a9d43bebe116066719e6b0872566...3e127a054bd3ec702b5adea3655dc283a636d245,1,1,0,1,1,2014-09-01 16:07:00,2014-09-01 16:07:00
4102eb3b85a1a9d43bebe116066719e6b0872566...330251de91e2078fe77d2bc26931a818eaa63076,3,12,18,30,3,2014-09-01 15:35:25,2014-09-01 15:27:02
09b23228dfa2242e4123e10091f8a0194ecdc3de...b99b2e60d587143dcb5a18e3682fa49e3a735ab1,4,49,0,49,5,2014-09-15 09:54:49,2014-09-09 15:39:53
b99b2e60d587143dcb5a18e3682fa49e3a735ab1...f37b4cc5ad1440098fedaf544b2ef42dd7513cbd,1,55,31,86,2,2014-09-15 09:54:49,2014-09-15 09:54:16
f37b4cc5ad1440098fedaf544b2ef42dd7513cbd...685754b0887de5228485083d7ee9dcbbb763f67e,1,1,1,2,1,2014-09-16 06:44:50,2014-09-16 06:44:50
248990b5e8e169d7c48adb539980a9db6cea4eca...99bc22d7b47e95902972a4e996cb22d6b06a6202,1,0,3,3,1,2014-09-23 21:55:23,2014-09-23 21:55:23
248990b5e8e169d7c48adb539980a9db6cea4eca...b095c1a44eda0ea599795859639e50f7c89e448f,1,4,8,12,4,2014-09-23 19:56:38,2014-09-23 19:56:38
248990b5e8e169d7c48adb539980a9db6cea4eca...0241efba59edda3195173004e73aa6e17f99a69a,1,1,1,2,1,2014-09-23 06:40:46,2014-09-23 06:40:46
248990b5e8e169d7c48adb539980a9db6cea4eca...83e8f923a3b9949e2f7c79717bf45c737c566e68,1,0,10,10,1,2014-09-22 19:34:16,2014-09-20 15:17:50
248990b5e8e169d7c48adb539980a9db6cea4eca...705fe01dca32f1666731712fab3a890f15c71152,4,22,34,56,5,2014-09-22 19:24:25,2014-09-20 14:06:35
248990b5e8e169d7c48adb539980a9db6cea4eca...778afb699f08d6b8e7f1ac5e77e927f45e11f8be,5,18,15,33,12,2014-09-22 19:01:19,2014-09-19 13:26:20
868755777f66f35eceeb55ca3caa160546eb7a00...a6b4e371eed3f21d626930e55c773daa95e18245,2,8,15,23,4,2014-09-25 14:25:20,2014-09-25 14:25:20
270efdf221c1ae52408c5a05e9592cb18f3d10df...9535ce2caa7122e3f1be8932660c3d53e0457bbc,2,15,9,24,6,2014-10-06 14:09:22,2014-10-06 13:07:48
270efdf221c1ae52408c5a05e9592cb18f3d10df...f815115de69c0bd746031e3389acfcdf2a306a75,1,1,1,2,1,2014-10-06 13:18:25,2014-10-06 13:18:25
6dc24e3bcfa35daa1a39d65f5eb5bc49729309a5...18a275f693956f2b900b8f70da66f6a1d3e64cf6,1,1,1,2,1,2014-08-19 07:48:14,2014-08-19 07:48:12
6dc24e3bcfa35daa1a39d65f5eb5bc49729309a5...c0f9abad8599a8954ac3c91218b8443339187fe2,1,6,6,12,6,2014-08-18 17:08:46,2014-08-18 17:08:46
cb33279a0f36f2c6a70d5ecf00bbd8749b92c51b...652de6f5912deb828cdd666a8a390b06ddd1abbd,1,6,5,11,2,2014-08-25 09:11:57,2014-08-16 13:12:06
cb33279a0f36f2c6a70d5ecf00bbd8749b92c51b...1b14864549445a8199900c10837c597453a0581f,2,2,2,4,2,2014-08-16 12:58:53,2014-08-16 12:55:36
cb33279a0f36f2c6a70d5ecf00bbd8749b92c51b...0b5783119f9577ae6b7506836c384a541854979d,3,5,5,10,5,2014-08-16 12:30:44,2014-08-16 12:30:44
cb33279a0f36f2c6a70d5ecf00bbd8749b92c51b...d28a27f7c434b03b8e715af8be628a86f44188a3,9,50,32,82,17,2014-08-15 14:52:20,2014-08-15 14:52:20
cb33279a0f36f2c6a70d5ecf00bbd8749b92c51b...3f36f84c1fb4dd2d444e02e4aeba5e1c65ddfd94,6,13,13,26,12,2014-08-15 14:03:01,2014-08-15 14:03:01
cb33279a0f36f2c6a70d5ecf00bbd8749b92c51b...f85dec28382c7dfb493715ddb84f58d68ad3d696,1,2,2,4,2,2014-08-15 13:11:15,2014-08-15 13:11:15
aa25c0ffe5c6904461ad42d0c48d571eb1809ea2...de582ab375a1fd04b63ea351aabbff5b31bcad6b,1,4,2,6,3,2014-07-16 12:12:33,2014-07-16 12:12:33
2dc31b76aa3f85876a3fc9dc2dffff5205609ad5...99425a124cdae00dbedaa6e6a124e2d67d86e66d,3,37,6,43,8,2014-09-01 12:37:53,2014-09-01 12:37:53
c0e1312567dc09aea0aecd72a3fa777c31b85b50...ab19a966f025a1954c57380b77a7c00a4f7e52be,1,2,0,2,1,2014-08-09 12:21:25,2014-08-09 12:21:25
c0e1312567dc09aea0aecd72a3fa777c31b85b50...a52db7831b2a0086c01c514054a080b45502aca2,1,5,5,10,1,2014-08-09 09:19:19,2014-08-09 09:19:19
0b3ebb6440420de714fe5066aba19ca77e8b1b8f...5e7f5ee8b8f29c9a21c6eac89c71cd71485519e1,2,25,20,45,6,2014-08-20 00:38:52,2014-08-20 00:38:52
0b3ebb6440420de714fe5066aba19ca77e8b1b8f...6f679236506da2ac580e227ac46fdcb3529dc6dd,1,1,0,1,1,2014-08-19 17:01:11,2014-08-19 17:01:11
0b3ebb6440420de714fe5066aba19ca77e8b1b8f...7e0a2b3b3dac62541abf990ca633cb272c58d4cf,1,1,1,2,1,2014-08-19 15:42:34,2014-08-19 15:42:34
7e0a2b3b3dac62541abf990ca633cb272c58d4cf...e354e548b9259cc5b6924459a3b797b573afbe00,1,1,1,2,1,2014-08-19 15:42:55,2014-08-19 15:42:55
e354e548b9259cc5b6924459a3b797b573afbe00...dfc5bf6bf712b7d861cb793f87d1fe3292bde2de,1,1,1,2,1,2014-08-19 15:43:17,2014-08-19 15:43:17
0b3ebb6440420de714fe5066aba19ca77e8b1b8f...3f161a3a3d1c2411cd80260a6eaf13eb608e0ce3,2,16,12,28,11,2014-08-19 12:37:51,2014-08-18 23:37:33
3f161a3a3d1c2411cd80260a6eaf13eb608e0ce3...794a8d8187a9fefc7908307ac9d995f4262aae8a,2,14,2,16,4,2014-08-19 13:20:57,2014-08-19 12:53:37
352af72f434046b1c1562641f904b4d20fe7ef54...11d5ad2f17ed487ac10414c16480a23cedf60d3c,1,1,1,2,1,2014-08-06 12:27:22,2014-08-06 12:27:22
11d5ad2f17ed487ac10414c16480a23cedf60d3c...aa5e663f85cd7c29910c37ab9716317961c31e91,1,7,0,7,1,2014-08-06 12:28:22,2014-08-06 12:28:22
aa5e663f85cd7c29910c37ab9716317961c31e91...43f560b17461d035bb5b9cb18a69f68512465453,2,3,1,4,2,2014-08-06 15:44:57,2014-08-06 15:44:57
ac1ff491b4f68890381a6e397a342a78962ecad3...6a0cb250966e3bca5bd0dcda82505bfd905167a7,2,22,1,23,2,2014-07-08 15:15:23,2014-07-08 15:15:23
edb3368c93c6ff64840ef5cd12f2af30b18b5b52...f774949d3f7676f925c7fc858d462ec2400e43a2,6,58,33,91,6,2013-09-12 17:15:10,2013-09-12 17:15:10
f774949d3f7676f925c7fc858d462ec2400e43a2...ed72e949f2947e26b8990aac9b8e6f3b836c85b7,1,1,1,2,1,2013-09-12 17:23:03,2013-09-12 17:23:03
edb3368c93c6ff64840ef5cd12f2af30b18b5b52...00ce2863742f031ebf69ffa30b9d5b6cf936b987,1,1,1,2,1,2013-09-12 16:20:55,2013-09-12 16:20:55
e1ca9de0dabb9d1da13073110072b3327280eb55...91e112ffe2a2c16b3b5e2cd4ce032cb9fa769660,2,5,2,7,3,2013-09-13 08:12:42,2013-09-13 08:12:42
91e112ffe2a2c16b3b5e2cd4ce032cb9fa769660...c606df8fdf7ea4601415fb54135f1c53083f9456,2,33,0,33,2,2013-09-13 09:37:13,2013-09-13 09:37:13
e1ca9de0dabb9d1da13073110072b3327280eb55...86d14441a44922e466da294f9b1147453b462d18,1,2,2,4,1,2013-09-13 05:44:30,2013-09-13 05:44:30
86d14441a44922e466da294f9b1147453b462d18...1045ea6476436f961f2a9e2d65a786ba7f4907a6,1,1,1,2,1,2013-09-13 05:49:45,2013-09-13 05:49:45
e1ca9de0dabb9d1da13073110072b3327280eb55...df9cbbc924466d2343f399adde0cea7cf2553fdb,17,129,149,278,118,2013-09-12 22:00:24,2013-09-05 11:46:34
df9cbbc924466d2343f399adde0cea7cf2553fdb...553841ecedd7aa2122278b3c1c547b23392074c3,1,4,1,5,2,2013-09-12 22:30:49,2013-09-12 22:30:49
6f037b9fe89290333a744d5d2a283b50880e14c0...069a6dfa9152dc61042bc3385651e9a81c8d3392,2,5,0,5,2,2013-09-12 18:39:53,2013-09-12 18:39:27
a2355c52507a40ed1805e4e6138778bbd0011ee4...da4244484b2a39b518b039fce46200f93817e79d,2,3,3,6,3,2013-12-30 21:53:01,2013-12-30 21:53:01
da4244484b2a39b518b039fce46200f93817e79d...447b46ca186d3b1fc14898bbd932485569d71c68,4,41,41,82,8,2013-12-30 21:53:16,2013-12-30 21:53:16
447b46ca186d3b1fc14898bbd932485569d71c68...1b1a408a717b6ad1ca3f15bf1b13b8251a5a33e4,41,96,96,192,96,2013-12-30 21:55:15,2013-12-30 21:55:15
1b1a408a717b6ad1ca3f15bf1b13b8251a5a33e4...5c3e0f61d731c97d9c08eaaf8b5b57b66e26c4e5,9,37,8,45,17,2013-12-30 22:36:31,2013-12-30 22:36:31
5c3e0f61d731c97d9c08eaaf8b5b57b66e26c4e5...6cbadc953f172bf331c059b05c71ca85736d3030,30,44,40,84,41,2013-12-30 22:38:53,2013-12-30 22:38:53
6cbadc953f172bf331c059b05c71ca85736d3030...2ecf83191d4ae7a158d70f8cfa11ec9f2744b0ce,3,16,15,31,14,2013-12-30 23:12:02,2013-12-30 23:12:02
2ecf83191d4ae7a158d70f8cfa11ec9f2744b0ce...16eb3ac360df60469cc9b1a93870c0273c7fe78f,39,231,260,491,210,2013-12-30 23:27:02,2013-12-30 23:27:02
16eb3ac360df60469cc9b1a93870c0273c7fe78f...010a770b3fa15119b40a994fde6ffdde3acf6d2d,42,102,129,231,85,2013-12-31 00:50:36,2013-12-31 00:50:36
010a770b3fa15119b40a994fde6ffdde3acf6d2d...0392669cbc7686f54677362457cfc4e62a527414,11,31,16,47,16,2013-12-31 01:15:58,2013-12-31 01:15:58
0392669cbc7686f54677362457cfc4e62a527414...57ab639c0dec366a7aecbe69490f0662f477ecd0,6,49,49,98,13,2013-12-31 10:01:48,2013-12-31 10:01:48
57ab639c0dec366a7aecbe69490f0662f477ecd0...85a0be14f654089f658815f056d9144b6be5ebc6,5,43,39,82,13,2013-12-31 10:40:18,2013-12-31 10:40:18
85a0be14f654089f658815f056d9144b6be5ebc6...718165ba0aa47368fefb6ad9eb4fd8d99dcc6582,2,6,6,12,7,2013-12-31 12:12:20,2013-12-31 12:12:20
718165ba0aa47368fefb6ad9eb4fd8d99dcc6582...fccd70c97da1a41216d137b6e43e7c8e255234c0,17,32,70,102,5,2013-12-31 12:39:45,2013-12-31 12:39:45
fccd70c97da1a41216d137b6e43e7c8e255234c0...da41efcfa5df54469805fa7bf1e178d5f8330bd0,4,30,25,55,7,2013-12-31 12:42:32,2013-12-31 12:42:32
da41efcfa5df54469805fa7bf1e178d5f8330bd0...da587351cf74b952043e58050a2cc09c62b4f835,5,10,5,15,4,2013-12-31 12:58:52,2013-12-31 12:58:52
da587351cf74b952043e58050a2cc09c62b4f835...b936addfeaf261a3ff76c2e997a11dca1bf8134b,1,2,0,2,1,2013-12-31 13:34:06,2013-12-31 13:34:06
b936addfeaf261a3ff76c2e997a11dca1bf8134b...a11d25b1818d69fc003f7ef0c760eec95483825e,5,62,62,124,10,2013-12-31 13:46:46,2013-12-31 13:46:46
a11d25b1818d69fc003f7ef0c760eec95483825e...1b5510a85e9dc59b6a8f1ad8e19539c563cfcb0a,4,89,85,174,19,2013-12-31 14:01:25,2013-12-31 14:01:25
1b5510a85e9dc59b6a8f1ad8e19539c563cfcb0a...b563312c2f59c04d535aa798e5cdfa8596f22dee,5,20,17,37,15,2013-12-31 14:16:50,2013-12-31 14:16:50
b563312c2f59c04d535aa798e5cdfa8596f22dee...d7a48443ce3dae559726de4d9f5ce358877bfbcd,31,33,33,66,33,2013-12-31 14:34:14,2013-12-31 14:34:14
d7a48443ce3dae559726de4d9f5ce358877bfbcd...5b2aa853a3e1b1ef5fd5ae4a23cf7850988c9f43,8,40,35,75,16,2013-12-31 15:08:31,2013-12-31 15:08:31
5b2aa853a3e1b1ef5fd5ae4a23cf7850988c9f43...a379bd00dc92529b8ef72885342e90c6be9a2ec1,9,64,60,124,22,2014-01-01 18:53:44,2014-01-01 18:53:44
a379bd00dc92529b8ef72885342e90c6be9a2ec1...8c1d414674d817d452c92b2fd95e722d52fc51fc,37,127,50,177,50,2014-01-01 19:42:42,2014-01-01 19:42:42
8c1d414674d817d452c92b2fd95e722d52fc51fc...6c0c5b53417d660566df669c41e96f385bb36e4c,1,8,7,15,1,2014-01-01 19:43:23,2014-01-01 19:43:23
6c0c5b53417d660566df669c41e96f385bb36e4c...42fc32d8bd5e626167264ceb7cec1cefcc574ee6,1,0,2,2,2,2014-01-01 19:48:41,2014-01-01 19:48:41
42fc32d8bd5e626167264ceb7cec1cefcc574ee6...a9fba2cd0acf847bced02e5ff3673b41adca151a,7,109,117,226,10,2014-01-01 19:59:45,2014-01-01 19:59:45
a9fba2cd0acf847bced02e5ff3673b41adca151a...5fa805a7ba9e6dd437a5bbda1ea28741d0d8b9ee,17,60,63,123,28,2014-01-01 20:11:18,2014-01-01 20:11:18
5fa805a7ba9e6dd437a5bbda1ea28741d0d8b9ee...eaec2350c43c58c2081156219c4f388182a50c59,3,27,22,49,11,2014-01-01 20:27:10,2014-01-01 20:27:10
eaec2350c43c58c2081156219c4f388182a50c59...8e90011369507911ea02ba357f19f0a4d18f03af,4,30,27,57,6,2014-01-01 20:44:30,2014-01-01 20:44:30
8e90011369507911ea02ba357f19f0a4d18f03af...a843ee7ece776810131a0bc8241d94b439506b93,7,15,9,24,8,2014-01-01 20:59:06,2014-01-01 20:59:06
a843ee7ece776810131a0bc8241d94b439506b93...8a2052c0ed5e150ba57396911bd650879250db55,2,9,3,12,2,2014-01-01 21:13:54,2014-01-01 21:13:54
8a2052c0ed5e150ba57396911bd650879250db55...a81002d920b7df1dadb4c3b931642135f2f28ec8,2,2,2,4,2,2014-01-02 11:11:52,2014-01-02 11:11:52
a81002d920b7df1dadb4c3b931642135f2f28ec8...34245ceb9962050bd8a953b4ea79e8e990558ab4,3,8,19,27,7,2014-01-02 11:26:58,2014-01-02 11:26:58
34245ceb9962050bd8a953b4ea79e8e990558ab4...66a91c4fabe2b777d0e63329c466614ed76c6b83,3,8,8,16,8,2014-01-02 11:32:27,2014-01-02 11:32:27
66a91c4fabe2b777d0e63329c466614ed76c6b83...3230df5fbe3125461d2668483353a7f93e50c60a,3,7,7,14,7,2014-01-02 11:36:47,2014-01-02 11:36:47
3230df5fbe3125461d2668483353a7f93e50c60a...3567107cdbb8ea454434bbba33ae90f124e79888,1,0,2,2,2,2014-01-02 11:40:18,2014-01-02 11:40:18
24820d5eef31ea688ad7191722c02579240bf669...60e451fde4ea3212c97bc3246b08e82cce7bf390,18,85,90,175,62,2013-12-30 13:27:18,2013-12-30 13:27:18
60e451fde4ea3212c97bc3246b08e82cce7bf390...689f6f7051724ba2a189dc4b062b9e891dafb2d3,2,2,2,4,2,2014-01-02 08:16:02,2014-01-02 08:16:02
23255bff9913fc1a58c1cf629a2a030c1cbf8a87...714ef622644ff478f9538f9b0b4d160d6340214f,2,14,1,15,2,2015-01-16 01:06:32,2015-01-16 01:06:32
714ef622644ff478f9538f9b0b4d160d6340214f...d76d8974928c238eed133cced439cbde4dd3239c,1,4,4,8,2,2015-01-18 16:21:18,2015-01-18 16:21:18
892be53fa369f9802d45f98356392733978c19f2...84e6fe361d75d284eaef30d0acd6e87b8062088c,2,59,1,60,2,2015-01-15 22:31:40,2015-01-15 22:31:40
c8c05edcd500c0a755cb6962b51f97381663bd1a...517cc92c65f5b8127d40f9c918ea986483798e90,1,1,1,2,1,2015-01-24 19:25:16,2015-01-24 19:25:16
c8c05edcd500c0a755cb6962b51f97381663bd1a...42bac7f9f27b0e8fb113e452fc2106882262172d,20,252,4,256,26,2015-01-24 17:51:16,2014-01-25 17:15:44
42bac7f9f27b0e8fb113e452fc2106882262172d...70c44a0da2bdeead90a99fe79e7c047d38b8ca5c,15,369,360,729,227,2015-01-24 17:51:16,2015-01-19 20:37:20
70c44a0da2bdeead90a99fe79e7c047d38b8ca5c...b92449c73e3b80a85144de08e0062c74cb37e80d,5,20,11,31,10,2015-01-25 06:03:30,2015-01-25 06:03:30
c8c05edcd500c0a755cb6962b51f97381663bd1a...7ac648911fb018dafa2708fe29ed59847fe875a1,7,44,46,90,46,2015-01-24 14:45:21,2015-01-24 14:40:25
1f770b0ffa85daabfca33e50a702aaf07038c410...a4dad7085850aa62134ed23b90f3a045c3569663,1,4,0,4,1,2015-01-25 07:59:03,2015-01-25 07:59:03
832b63b53817cae84d8b971ce335806713ba20a1...0e896aa9e90be3cb7765239860a9970996685998,2,2,2,4,2,2015-02-03 10:44:55,2015-02-03 10:44:55
afb8ecc3d1569520379a2d0613137c46d44a12ce...84a5a548a5e1377f34b7989fc546eaedf86c3510,3,4,1,5,3,2015-02-03 04:08:23,2015-02-03 04:08:23
84a5a548a5e1377f34b7989fc546eaedf86c3510...e89058268118e3b2be4ebaf5d7bf2c684b590437,27,66,66,132,56,2015-02-03 04:36:54,2015-02-03 04:36:54
20e269cb925cfad58cce0b19e17aa15075c4481e...ac7af45d8987422c2a529d3d87eae6d9bd608e12,1,18,0,18,1,2015-01-31 08:10:26,2015-01-31 08:10:17
ded30e3efe78360bd310be604d7723638c039a17...254a63dcf7dcfe824eb0b7227e2cd63fac027f85,5,41,48,89,18,2015-02-03 21:11:33,2015-02-03 21:11:33
8618277f24e9adeef28fe93dc23b39f7a5357c52...a89d7adfa44767e71cfb9005e5a3eed6a91b4d84,1,1,1,2,1,2015-02-03 21:57:28,2015-02-03 21:57:28
8618277f24e9adeef28fe93dc23b39f7a5357c52...4adf6389b0f0889f4bee328c68439c22ee106751,1,1,1,2,1,2015-02-03 20:40:56,2015-02-03 20:40:56
8618277f24e9adeef28fe93dc23b39f7a5357c52...e0d85078ba8b128ba6e0378ebd00a4e12d1e86ed,1,1,1,2,1,2015-02-03 19:23:59,2015-02-03 19:23:59
4e4e1cb9b56cbb7e467a38c89c8c2d38a58b45d2...685757b9d6c1c137c479288fe640c9440a785d71,2,2,0,2,2,2014-09-09 08:11:07,2014-09-09 08:11:07
4e4e1cb9b56cbb7e467a38c89c8c2d38a58b45d2...a83975ab8d4df3d28a550c54a265560df3612cc7,1,1,1,2,2,2014-09-09 07:48:58,2014-09-09 07:48:58
a83975ab8d4df3d28a550c54a265560df3612cc7...8c765aaf3f22f0b0bb535753510a541a04195ef9,1,1,0,1,1,2014-09-09 07:52:30,2014-09-09 07:52:30
f2007e748890a2b818b4f3b0dceea0a5158df539...07061b672ca97ec703b7041473024859585ec9c1,2,4,4,8,2,2014-09-10 10:40:13,2014-09-10 10:40:13
ffb6d27ab0a5084db41baac90783921eb5746031...4e6d0daf1ae84b8383b71c853de5c8806ac06baf,1,2,0,2,1,2014-09-10 15:30:29,2014-09-10 15:30:29
ffb6d27ab0a5084db41baac90783921eb5746031...ae0987424fe70baa3e5f6f99cda116c3a316a422,1,1,1,2,1,2014-09-10 15:12:40,2014-09-10 15:12:40
bbe50443958a8a7239f4b3f0979060b749624755...276ee454877f66afeec3043745d4c9326e809008,1,3,0,3,1,2014-09-09 21:55:45,2014-09-09 21:55:45
6a10e2e52a1ae614fe467245e5e5946e67e0905d...a02ff56b4da4b3b9ed07f1f45123d41c286de050,1,2,2,4,2,2014-07-21 10:25:26,2014-07-21 10:25:26
6a10e2e52a1ae614fe467245e5e5946e67e0905d...e443e59542911e21684abdc1493bb041ec179a4f,3,8,7,15,6,2014-07-21 08:47:38,2014-07-21 08:47:38
e443e59542911e21684abdc1493bb041ec179a4f...ebc1c4bde95abaa7f362faea4c1b5f58d29fa45a,2,2,2,4,2,2014-07-21 08:50:03,2014-07-21 08:50:03
bb80741c246f8c5050312ec4a770625c8e9d38ed...e03ab14f782bc03c54c9f3feb94e5dc011b436cd,1,1,0,1,1,2014-07-25 16:26:04,2014-07-25 16:26:04
bb80741c246f8c5050312ec4a770625c8e9d38ed...420ba2119b2c63966ae60159c9216f7fdca0c469,7,81,62,143,20,2014-07-24 19:14:12,2014-07-24 19:14:12
420ba2119b2c63966ae60159c9216f7fdca0c469...2d25faf21c85df4930dfd989be4f53d9fb0be87f,2,6,2,8,3,2014-07-24 20:25:38,2014-07-24 20:25:38
bb80741c246f8c5050312ec4a770625c8e9d38ed...14d3f304039b3396a031295bef89bcf9667e9c5d,1,1,1,2,1,2014-07-24 10:00:55,2014-07-24 10:00:55
ebae2d0241c5f84f48af6a15d7b8217cb12840af...84bbf07d962c58f0c8b1dc6fdb6c47b29f6e8815,1,1,1,2,1,2014-09-10 20:20:40,2014-09-10 20:20:40
1535835d3e987d54931160c9371a6b927b2a8b91...042465c448e73bb46ce7d159723a7c4805dad062,3,4,4,8,4,2014-09-08 08:16:15,2014-09-08 08:16:15
1535835d3e987d54931160c9371a6b927b2a8b91...26e0741ce183eaf6e242e2d39dc4ca96b10d5324,1,2,1,3,1,2014-09-08 07:57:42,2014-09-08 07:57:42
205358b1ae71611a04e03789b3bac74bd1052da5...4ef809c77d7f4155709a6d3f0188332c206ba0e0,3,140,0,140,3,2014-09-08 13:25:50,2014-09-08 13:25:50
4ef809c77d7f4155709a6d3f0188332c206ba0e0...e0eb48031dc3ed8079c637fa3b82556747f9f8e0,11,92,64,156,15,2014-09-08 13:26:49,2014-09-08 13:26:49
e0eb48031dc3ed8079c637fa3b82556747f9f8e0...531f16beb0a860a94f732f9e697a447513abe363,9,72,162,234,22,2014-09-08 13:27:12,2014-09-08 13:27:12
531f16beb0a860a94f732f9e697a447513abe363...c741fcab9d8f1a28b2b95e3cd2096adc5178eba6,6,5,30,35,6,2014-09-08 17:41:55,2014-09-08 17:41:55
c741fcab9d8f1a28b2b95e3cd2096adc5178eba6...bde3f25d262b13d0139276786fe9d9cba29269b8,3,121,1,122,3,2014-09-08 17:42:12,2014-09-08 17:42:12
bde3f25d262b13d0139276786fe9d9cba29269b8...218219abbdfdc3bc0bc1a9c95cfc0e0ddb5861dd,19,131,130,261,40,2014-09-08 18:54:52,2014-09-08 18:54:52
218219abbdfdc3bc0bc1a9c95cfc0e0ddb5861dd...02e87d9223b8398f6d2f06b2ba57313c2ad384be,3,11,6,17,6,2014-09-08 19:12:54,2014-09-08 19:12:54
02e87d9223b8398f6d2f06b2ba57313c2ad384be...93dc885530aa80b84a2e39841f82a51a6e62f4a5,1,1,1,2,1,2014-09-08 19:25:20,2014-09-08 19:25:20
6b4d5d21be69705f22cb2e848fdba9f182ef2bc5...1df0345e9e642ca7e9d73c12430921b0fe62d25e,10,82,20,102,14,2014-07-23 08:13:33,2014-07-23 08:13:33
1df0345e9e642ca7e9d73c12430921b0fe62d25e...367445fdcde4d07a685610449a2ab4d43b1fc507,14,79,101,180,24,2014-07-23 09:03:49,2014-07-23 09:03:49
367445fdcde4d07a685610449a2ab4d43b1fc507...f0bfeb6e33f8d3620b7d5d6da8439fbdf954d6cb,9,23,23,46,23,2014-07-23 09:18:51,2014-07-23 09:18:51
f0bfeb6e33f8d3620b7d5d6da8439fbdf954d6cb...001096cab8fb8462f8bc3f4bf7073ccca6de7ad3,2,0,17,17,2,2014-07-23 15:03:33,2014-07-23 15:03:33
5a67d482afd7780506c0dc2689a7d839647d5da5...005752e4c6485cf79b0a53583c03b5a69fe19f10,2,15,4,19,2,2014-07-07 13:46:57,2014-07-07 13:46:57
005752e4c6485cf79b0a53583c03b5a69fe19f10...e87f2380779871a64742acdd9dd0358aac7eafce,2,27,0,27,2,2014-07-08 18:25:25,2014-07-08 18:25:25
393b54613ba72504565c91f523b7d1aedc797956...838bbb55e55c1ea41b16ffd0e31f617747ad0ce4,1,1,2,3,1,2014-06-06 17:41:42,2014-06-06 17:41:42
838bbb55e55c1ea41b16ffd0e31f617747ad0ce4...34d9f34a61bc20f1dec9e6ad504e08835716bd66,6,36,7,43,11,2014-06-06 18:39:30,2014-06-06 18:39:30
34d9f34a61bc20f1dec9e6ad504e08835716bd66...d325a279fb65b2c91f12e45aa20d61949919b95a,3,3,1,4,3,2014-06-06 19:01:34,2014-06-06 19:01:34
d325a279fb65b2c91f12e45aa20d61949919b95a...71d074a674c07d9eed3572e071ef2d53479be5de,1,0,2,2,2,2014-06-06 19:06:04,2014-06-06 19:06:04
71d074a674c07d9eed3572e071ef2d53479be5de...dd03841fea7aa2d71130c7167b61d3c959ddaf19,1,1,1,2,1,2014-06-06 19:09:52,2014-06-06 19:09:52
dd03841fea7aa2d71130c7167b61d3c959ddaf19...910a99f90b27b0b6de0140ce89f356b746d43113,4,6,8,14,6,2014-06-06 19:21:07,2014-06-06 19:21:07
910a99f90b27b0b6de0140ce89f356b746d43113...bc6a17a6828f2695a7ad0f64671ac1b6845c111d,1,6,0,6,1,2014-06-06 19:33:52,2014-06-06 19:33:52
7a89cef601dde68d5964f68bb6fe2e94d72fcf55...f07f524badf39c197dbcb18e74935fc5957803a3,1,1,1,2,1,2014-06-08 21:42:09,2014-06-08 21:40:37
7a89cef601dde68d5964f68bb6fe2e94d72fcf55...a705d194facc24be0e265f95ed6d03d533547d7a,1,8,8,16,2,2014-06-08 21:36:09,2014-06-08 21:36:09
7a89cef601dde68d5964f68bb6fe2e94d72fcf55...597836d6ccc52588d90780313ccc4eef730e16df,1,4,4,8,4,2014-06-08 21:27:57,2014-06-08 21:27:57
7a89cef601dde68d5964f68bb6fe2e94d72fcf55...95b786ff79e4fd2320f4776e87dc498088d00cf6,1,2,2,4,2,2014-06-07 16:39:48,2014-06-07 16:39:48
9fd6c3d591fb56e50a9cdbbaac557383e3ef86a7...fcb0b76c32b3512ead419a4451e9cc632270fc89,2,27,3,30,2,2014-06-12 09:01:54,2014-06-12 09:01:54
9fd6c3d591fb56e50a9cdbbaac557383e3ef86a7...90bfe286a694e2af9de49dcb3b32360132249a48,2,15,0,15,4,2014-06-12 07:31:17,2014-06-12 07:28:34
7ba1853660e09bc997d829fc596ea576c122086b...d8c7efa626ba925aa9c1bf1efaf6289cd5db4f0b,4,6,1,7,4,2014-05-30 13:26:45,2014-05-30 13:26:45
13cbc82aa164a6d2885546dc8fe1d0885700fe83...ce498eed9a2f394ce8c3110d0e233e873152c931,1,2,0,2,1,2014-05-28 17:18:25,2014-05-28 17:18:25
8a3807c83880f71612b1e092c49e865d24e29704...dc158af665a32a28e19ef7efd849fdb7f22e7b6c,2,5,0,5,4,2014-05-28 10:23:03,2014-05-28 10:23:03
6e69b4eb977fbaee0d2531d03896be7a2f746d08...9c5edce13831261be23f37afae60235c2d10c88a,1,10,6,16,2,2014-07-30 19:48:06,2014-07-30 19:48:06
9c5edce13831261be23f37afae60235c2d10c88a...f0c26bcb640002d4317e70d2c54e95f27d08f276,2,6,2,8,4,2014-07-30 19:48:21,2014-07-30 19:48:21
f0c26bcb640002d4317e70d2c54e95f27d08f276...dab9835ae1cd147cb2a25ec3fb262a3f540b2ca8,2,10,16,26,3,2014-07-30 19:58:20,2014-07-30 19:58:20
dab9835ae1cd147cb2a25ec3fb262a3f540b2ca8...3ed2fce208474face31a6df2dbbdc60b49826238,2,9,7,16,5,2014-07-30 20:04:47,2014-07-30 20:04:47
487f78be129d44ae3dc098c9bd17925975435097...468b2e8e0b46e7a7cee7cc9d9ce9b5c22e79c467,9,51,14,65,15,2014-09-04 13:47:20,2014-06-24 01:35:36
487f78be129d44ae3dc098c9bd17925975435097...69d149e0d0de88e143af2e83fe8bf9a0a970ad83,2,9,15,24,5,2014-09-04 13:34:07,2014-09-04 13:34:07
9ccef9a7b3c8bd007c897467c0fb944831db3fab...20c2e90222ac0b12a4cc3fb9b9455232f6e250ae,4,9,7,16,5,2014-09-02 12:28:27,2014-09-02 12:28:27
0cc30145f441a16ce513bba942ea67ede4086a7f...5d8be4438add1183d91e030b852c628cf09f4916,141,290,290,580,284,2014-10-03 10:19:24,2014-10-01 22:21:29
892371bc22813abe855f563bf4f0ee355fe067ab...998cd3cb63d56a0058c8e519d7c20e3d6e540899,15,370,103,473,78,2014-09-15 23:25:24,2014-08-18 18:09:09
71e055444942e93ad028f50896fe680cdf2caf5d...66ae1bde872bd828e9de660cd45007363000c986,4,21,0,21,5,2014-09-16 15:31:20,2014-09-12 16:46:20
71e055444942e93ad028f50896fe680cdf2caf5d...45a6b62407876d68c27cbcba2e80c3986207d074,1,17,62,79,9,2014-09-16 15:11:25,2014-09-16 15:11:25
6f797f86de3ba7a1dd234aab2fc0d5faf81f8ad2...d5c8ca7412f024a254653f0a72e3b1fe026adcde,1,1,0,1,1,2014-10-03 06:01:54,2014-10-03 06:01:54
0241efba59edda3195173004e73aa6e17f99a69a...0f7cad07d0db03c791ee87008cd5e22995673cdd,1,4,1,5,1,2014-09-23 07:03:38,2014-09-23 07:03:38
a6b4e371eed3f21d626930e55c773daa95e18245...8ebe769f267647110846a976e5f0d8fb77cd4abb,2,11,10,21,4,2014-09-25 15:40:27,2014-09-25 15:40:27
a6b4e371eed3f21d626930e55c773daa95e18245...20d6f969286807a8548c0fc263b82576a560f637,14,24,51,75,37,2014-09-25 15:00:21,2014-09-25 15:00:21
b390ee1a83d87c608c2d5d48eed18d35dad9825a...5c908ba28c5374ea88f871079da4b43cda058a13,1,3,0,3,1,2014-09-24 09:29:47,2014-09-23 15:56:44
7a0e1c7238033b33b7296701bfded56d4ad7f250...bd2355191fa45ec04ba7b79b7fcb2b26088abc16,5,32,9,41,5,2014-09-04 21:15:28,2014-09-01 09:09:07
7a0e1c7238033b33b7296701bfded56d4ad7f250...551145bc98e257280b615e305d531a44d7aa4131,11,184,25,209,29,2014-09-03 11:08:35,2014-07-27 14:40:00
551145bc98e257280b615e305d531a44d7aa4131...392113919adc75ba1537d89a0de8d0641e24d5b8,9,152,20,172,23,2014-09-03 11:08:36,2014-07-27 17:56:33
0cfa8aaf79742a5a8387d37ce1f2437fdc346e95...7681f8b0f7995d64d6f4bfc0c89d66bbb08af94a,1,6,10,16,5,2014-09-01 23:41:37,2014-09-01 23:41:37
0cfa8aaf79742a5a8387d37ce1f2437fdc346e95...5ef4b3fb53bf3c09df998e64c9eede698aecc364,1,5,5,10,5,2014-08-23 23:53:14,2014-08-23 23:53:03
0cfa8aaf79742a5a8387d37ce1f2437fdc346e95...1b1ca3ee56598995c39fcd02aeac29638c342e4c,1,9,1,10,1,2014-08-23 23:48:04,2014-08-23 23:48:04
de582ab375a1fd04b63ea351aabbff5b31bcad6b...16eea49277e736c53078ec1e7b5005ac7a26a112,4,9,9,18,4,2014-07-25 20:23:42,2014-07-16 18:44:24
de582ab375a1fd04b63ea351aabbff5b31bcad6b...c300788830b07faca8669920e92c0a99193bbf5e,1,9,0,9,1,2014-07-16 18:56:58,2014-07-16 18:56:58
de582ab375a1fd04b63ea351aabbff5b31bcad6b...3c439888a6a080ffaa26a0edc7291d25eaa26791,2,9,9,18,3,2014-07-16 18:12:46,2014-07-16 18:12:46
de582ab375a1fd04b63ea351aabbff5b31bcad6b...2ef455078e2c6a49a21797c5012dc9d16ddb2be6,1,6,9,15,4,2014-07-16 15:07:49,2014-07-16 13:57:41
e09ef2fc38adf76a8986ab3078fe92831bf56836...8c34c94a4fbcbaee9caa5163b6c7f9502e2080a5,1,1,1,2,1,2014-08-09 18:00:03,2014-08-09 18:00:03
9d3e384ae6553fee85b7a1ed2b99a18a9884606e...da7e14c864eb039ffe1c06409681721892917b71,5,35,9,44,8,2014-08-11 09:31:37,2014-07-27 22:27:15
da7e14c864eb039ffe1c06409681721892917b71...f361be9eca790c444c9a95c98fe8e5f95e1d7f95,3,27,5,32,4,2014-08-11 09:34:45,2014-07-30 22:07:40
9d3e384ae6553fee85b7a1ed2b99a18a9884606e...13c17ed49467752989b01e124450d98d93b60035,1,2,2,4,2,2014-08-11 07:41:05,2014-08-11 07:41:05
9d3e384ae6553fee85b7a1ed2b99a18a9884606e...4862f75a3d6efb16259a7485d8b012dfea88cb91,1,2,2,4,1,2014-08-10 11:31:11,2014-08-10 11:31:11
9d3e384ae6553fee85b7a1ed2b99a18a9884606e...2fd30cc57f1d848c1f8e356aacfa76806549fb82,1,2,0,2,1,2014-08-10 11:25:35,2014-08-10 11:25:35
2fd30cc57f1d848c1f8e356aacfa76806549fb82...0e3f8ea2ef2a7d6cc51ccb5d7ae854c6244b40eb,2,2,7,9,3,2014-08-10 12:33:22,2014-08-10 12:33:22
0e3f8ea2ef2a7d6cc51ccb5d7ae854c6244b40eb...99eb283101108f1f95e95ade8c1352f547578b26,9,90,45,135,14,2014-08-11 06:50:56,2014-08-11 06:50:56
99eb283101108f1f95e95ade8c1352f547578b26...d7701a263f71d48ba284ad325fd7c5a48742fe7d,6,21,13,34,13,2014-08-11 09:59:36,2014-08-11 09:59:36
1eaa8e18be417c9e9b37a56aa5a3f89f4352d352...f5b23bc2caa8ece27abe4278f6a1b779442f85b4,1,1,1,2,1,2014-08-20 13:03:18,2014-08-20 13:03:18
86491e65746c37b2db497980110a237cb730cafe...ed9e922dd0047435b8d349f0c949ba0a2d789247,1,1,1,2,1,2014-08-19 16:25:28,2014-08-19 16:25:28
2c97f5d636ad09a23dc66d6894328df06150259d...87efd92d8cc378697359012226d2679cab7e1e9e,1,1,1,2,1,2014-08-20 15:13:03,2014-08-20 15:13:03
5ff79f9494c154c963190016e701170545d91617...996d146cbd6987d54bc720550b96aacd90c2982a,1,12,12,24,5,2013-09-13 13:38:30,2013-09-13 13:38:30
996d146cbd6987d54bc720550b96aacd90c2982a...49f609a9366db616f6695f9e34ecfdfbcadafa2c,1,7,6,13,2,2013-09-13 13:38:37,2013-09-13 13:38:37
5ff79f9494c154c963190016e701170545d91617...8199be83f5975cd6ac1afd964ebba2963186d71b,1,1,1,2,1,2013-09-13 11:02:37,2013-09-13 11:02:37
6113d80639241476ff07afa7cf12e3ee927f3b25...53b75acf79e5ba1b6e4092df16a7fc48e8659ef6,1,1,1,2,1,2013-09-14 01:07:05,2013-09-14 01:07:05
7617ff56f290218dc80c78f5c941a28ac9f8538c...b512fbc0ecba0a8de9c9efe5c7d82a97f0ea744c,2,15,11,26,4,2014-01-02 12:33:15,2014-01-02 12:33:15
779355ae8ed1dd1c429405c7da5525e10de1f9cd...423ffe29d549d72a603e0d3a529ec59c035a0934,3,4,4,8,4,2014-01-03 21:15:13,2014-01-03 21:15:13
423ffe29d549d72a603e0d3a529ec59c035a0934...d0a56e228018b72b30598ca5b4c744d57d8f1f3e,4,24,21,45,6,2014-01-03 21:28:00,2014-01-03 21:28:00
d0a56e228018b72b30598ca5b4c744d57d8f1f3e...6dfbd3f771d48cfefe0dcf7a41f44e833a1e7878,1,26,28,54,6,2014-01-03 21:46:32,2014-01-03 21:46:32
6dfbd3f771d48cfefe0dcf7a41f44e833a1e7878...b1b3f485a199affd0f77e8a694202f2547bf6fd5,2,39,32,71,3,2014-01-03 21:46:46,2014-01-03 21:46:46
b1b3f485a199affd0f77e8a694202f2547bf6fd5...b765d7d739be09997257dbea21ad854c33eb3890,1,2,10,12,2,2014-01-04 17:25:35,2014-01-04 17:25:35
b765d7d739be09997257dbea21ad854c33eb3890...09c2f8c7b10fe78a0e3feead06b6010f88238c79,5,22,24,46,11,2014-01-04 17:26:12,2014-01-04 17:26:12
09c2f8c7b10fe78a0e3feead06b6010f88238c79...0a364762d96f2474e9cd177fba54b7a2e5614e8a,8,46,40,86,14,2014-01-04 17:27:09,2014-01-04 17:27:09
0a364762d96f2474e9cd177fba54b7a2e5614e8a...b4d29d700aa70921839f6ad485112113b49d502f,1,8,8,16,8,2014-01-04 17:30:38,2014-01-04 17:30:38
b4d29d700aa70921839f6ad485112113b49d502f...35287f10284beb66b811bb45d1e6d4f6857ee372,1,5,5,10,3,2014-01-04 17:32:06,2014-01-04 17:32:06
35287f10284beb66b811bb45d1e6d4f6857ee372...e680228bf21a20213560f93de1f573b4ab4c2f79,3,28,8,36,5,2014-01-04 17:46:52,2014-01-04 17:46:52
84e6fe361d75d284eaef30d0acd6e87b8062088c...3d3c7efa3e03c34dd48fa7ca959f11af204ffe75,5,9,6,15,7,2015-01-15 22:55:45,2015-01-15 22:55:45
254d1d7aa07fd1b45dd4090e98bcba86f5d3c699...aad6ceaef9ccfba8e058012a0877b80c103a3838,12,52,14,66,16,2015-01-25 16:09:10,2015-01-25 15:33:54
aad6ceaef9ccfba8e058012a0877b80c103a3838...b20fc14133957d0e71bcf48aed4b426d439681db,2,4,4,8,7,2015-01-25 17:34:02,2015-01-25 17:34:02
b20fc14133957d0e71bcf48aed4b426d439681db...c821412e305b3e7226485d561ce39ab0d419e990,1,1,1,2,1,2015-01-25 17:36:11,2015-01-25 17:36:11
c821412e305b3e7226485d561ce39ab0d419e990...afce47923cf184bd11a6122c25fb57fe98f73148,1,1,1,2,1,2015-01-25 17:38:35,2015-01-25 17:38:35
afce47923cf184bd11a6122c25fb57fe98f73148...2a4502111e03c233861b545ae3ff3afd95614c4a,1,1,1,2,1,2015-01-25 22:31:40,2015-01-25 21:23:28
a4dad7085850aa62134ed23b90f3a045c3569663...93bc2d5202e5802bd31419d05232b62355516a53,7,179,3,182,18,2015-01-27 07:25:28,2014-08-21 10:53:32
a4dad7085850aa62134ed23b90f3a045c3569663...ce9686e3f56658f2fb8df8ad6e1335e338875df9,1,16,2,18,2,2015-01-26 03:59:04,2015-01-26 03:59:04
ce9686e3f56658f2fb8df8ad6e1335e338875df9...615488150bd176088d5b37a2441fd1f11396edf7,1,1,1,2,1,2015-01-26 04:01:32,2015-01-26 04:01:32
615488150bd176088d5b37a2441fd1f11396edf7...2b02852507466c8cd7dc9a7db7a7e0dd4c7b5183,3,22,39,61,13,2015-01-26 04:31:02,2015-01-26 04:31:02
2b02852507466c8cd7dc9a7db7a7e0dd4c7b5183...9d85ea3acff1c925118718996afc9daa39d679c7,9,11,8,19,18,2015-01-26 06:49:05,2015-01-26 06:49:05
a073e00ab41b5fa4979b021b55cf184ffc104fb9...4e97f26649a7756bef843fca74e3c58eadd117e1,6,47,40,87,12,2015-02-03 12:42:38,2015-01-30 09:46:08
e89058268118e3b2be4ebaf5d7bf2c684b590437...aaae5e6f5ebc61f724e901f26e928f5e3bd9eb88,2,3,3,6,3,2015-02-03 04:55:05,2015-02-03 04:55:05
aaae5e6f5ebc61f724e901f26e928f5e3bd9eb88...9fbdbf8b3fff72ae37a320e7e9fac3b9224e3c53,2,2,2,4,2,2015-02-03 04:57:10,2015-02-03 04:57:10
9fbdbf8b3fff72ae37a320e7e9fac3b9224e3c53...c427bf08e41342957632289e084604f53e65e353,2,2,2,4,2,2015-02-03 04:58:28,2015-02-03 04:58:28
c427bf08e41342957632289e084604f53e65e353...cc39bca3fa71930421f1c46844b4d02d5ff93e8b,12,70,48,118,16,2015-02-03 05:15:44,2015-02-03 05:15:44
cc39bca3fa71930421f1c46844b4d02d5ff93e8b...6579c336f96b00bb7897f7cbf2056286c1781281,1,2,2,4,2,2015-02-03 05:20:34,2015-02-03 05:20:34
6579c336f96b00bb7897f7cbf2056286c1781281...da884aabc7674c68eee23699efb357bc94aef8d3,5,9,11,20,9,2015-02-03 05:22:57,2015-02-03 05:22:57
da884aabc7674c68eee23699efb357bc94aef8d3...368e9a0862dd7d58b009956e8f1ac51d2a549cda,3,16,18,34,7,2015-02-03 05:26:40,2015-02-03 05:26:40
368e9a0862dd7d58b009956e8f1ac51d2a549cda...7558fe98759ec28c2fd97ae10cb1610a1a6c38cd,2,6,5,11,6,2015-02-03 05:31:03,2015-02-03 05:31:03
7558fe98759ec28c2fd97ae10cb1610a1a6c38cd...7d48205c1a472c07969e4dc43965fa3090b84376,4,16,8,24,5,2015-02-03 05:34:16,2015-02-03 05:34:16
7d48205c1a472c07969e4dc43965fa3090b84376...647ff6240ef5e8256a44b126aa7573812d5e70b7,6,31,27,58,7,2015-02-03 05:38:50,2015-02-03 05:38:50
647ff6240ef5e8256a44b126aa7573812d5e70b7...615bb941358389a1fdfec34abc6af8b61db75580,1,4,1,5,3,2015-02-03 05:41:38,2015-02-03 05:41:38
615bb941358389a1fdfec34abc6af8b61db75580...d04344373b899c1e54948ca46478f7b907a576d2,9,6,11,17,11,2015-02-03 05:53:27,2015-02-03 05:53:27
d04344373b899c1e54948ca46478f7b907a576d2...61cc6a9244f316f684cd887febd9dae1030a04b0,8,33,33,66,13,2015-02-03 05:59:28,2015-02-03 05:59:28
635ebac606d77eae03ce2e2a8f0a814ad4c79177...490cf7bfcefdb2e275c537699717c12e440f57ec,1,6,5,11,2,2015-02-04 02:12:20,2015-02-04 02:12:20
ca0f107809e8547357d66d6241ee39be86546ecb...704922c855a9741b5495db56ac266788a9c25c33,1,1,1,2,1,2015-02-03 23:07:01,2015-02-03 23:07:01
414afd68f3b9c529fa9de9f60bfe86994b1fda81...ead2dc0c21726ff2b6b150dae2d1b940207846c2,1,9,1,10,2,2014-07-25 09:12:17,2014-07-25 09:12:17
414afd68f3b9c529fa9de9f60bfe86994b1fda81...32a6f41f1cd5bbea690461d2e930843266893f1b,2,33,3,36,2,2014-07-25 08:50:58,2014-07-08 11:56:37
414afd68f3b9c529fa9de9f60bfe86994b1fda81...e59674f9545d36da13c306e223b2cb84e9fcaa48,3,7,2,9,5,2014-07-25 06:25:16,2014-07-01 19:05:29
5a89b610286896d3fc647e66fd9d559465a74f6b...3a6f9c093e40020c63e2c78664d5c726eef09498,2,8,4,12,4,2014-07-28 14:41:37,2014-07-25 16:30:25
aa8c915deb0353e71d9cd61ed40cd41d1093ed6a...8ec602e64fd3129a8459ba40c7e01979fc155d00,1,1,1,2,1,2014-09-22 16:50:27,2014-09-05 00:57:04
aa8c915deb0353e71d9cd61ed40cd41d1093ed6a...d915a239f78afcd1a924c63bd26b954e8d2a2ab1,1,1,1,2,1,2014-09-11 01:38:47,2014-09-11 01:38:47
aa8c915deb0353e71d9cd61ed40cd41d1093ed6a...bc04c2632511ce871cb3fa511c838d91f260b9df,1,1,1,2,1,2014-09-11 01:19:31,2014-09-11 01:19:31
bc04c2632511ce871cb3fa511c838d91f260b9df...9d9109eecfb65a2ee600a46cf8b5d6fab5d38cc3,1,1,1,2,1,2014-09-11 01:20:06,2014-09-11 01:20:06
aa8c915deb0353e71d9cd61ed40cd41d1093ed6a...43f0efe5d3737e5802d55be240d677bde56d95a6,1,5,5,10,4,2014-09-11 00:23:06,2014-09-11 00:23:06
b712ded13fb63a52500b65b9e0e26bb266f66dd4...dac5e6de5a679aae51ca14481bf3f7d9cad0eb3b,1,6,0,6,2,2014-09-08 12:07:31,2014-09-08 12:07:31
b712ded13fb63a52500b65b9e0e26bb266f66dd4...e59b3720e97594eeccb5e0a44c40f0cbd78fe7eb,2,41,41,82,5,2014-09-08 10:27:11,2014-09-08 10:27:11
e59b3720e97594eeccb5e0a44c40f0cbd78fe7eb...67c956e16d11c2f0960b2d07efe0f57c617d9cd2,1,4,0,4,1,2014-09-08 13:30:10,2014-09-08 13:30:10
be4359efba514095cda25c225495b55f92a01f45...9c3935c5b0b6feddf91fd2170b50e5910b2cc932,3,13,14,27,5,2014-09-09 09:10:40,2014-09-09 09:10:40
9c3935c5b0b6feddf91fd2170b50e5910b2cc932...ac6a107ac7d7350d1df46d84bf831ab3d8bcc91a,2,13,12,25,8,2014-09-09 09:36:29,2014-09-09 09:36:29
ac6a107ac7d7350d1df46d84bf831ab3d8bcc91a...2ff83aa389894c1dc306f1bf3d2d4aebe25eff62,2,2,2,4,2,2014-09-09 09:52:16,2014-09-09 09:52:16
2ff83aa389894c1dc306f1bf3d2d4aebe25eff62...8ebb26fcc1eb25cc5613be6954c5ca43b3125435,1,98,0,98,1,2014-09-09 11:17:42,2014-09-09 11:17:42
7e0bd5df28743a86996a217db2fba7e13836c28c...bb54784c08cee557cdb92c38da7ae2975e98cee6,1,1,1,2,1,2014-08-13 13:42:54,2014-08-13 13:42:54
bb54784c08cee557cdb92c38da7ae2975e98cee6...3a246fbd38c8b0b3aea9881a5fbc6d868551ca51,2,4,4,8,3,2014-08-13 13:45:48,2014-08-13 13:45:48
76af5a1db73155c0a120f30cda9d60155146dfe1...974b5a7b2f31f8e7d6b38a45bfd055a40651c945,5,25,1,26,6,2014-07-25 19:05:23,2014-07-25 19:05:23
974b5a7b2f31f8e7d6b38a45bfd055a40651c945...d3ea53877d689df64db9c68f43e2c08f527b01ed,4,27,4,31,4,2014-07-26 07:33:42,2014-07-26 07:33:42
22995fc9324774ce5301589d05a4687793faddac...4e0afce6a70aa8d2f56706ce1304104b4f136c60,1,4,1,5,1,2014-07-09 08:12:08,2014-07-07 09:12:41
4e0afce6a70aa8d2f56706ce1304104b4f136c60...de229135011c8012acf157e1e8b10e4dc443dcd4,1,1,1,2,1,2014-07-09 08:12:08,2014-07-07 11:11:48
de229135011c8012acf157e1e8b10e4dc443dcd4...5d25f3d9b12203c3010ba92d7dacfcbeaf51781e,1,5,2,7,3,2014-07-09 08:12:08,2014-07-08 14:12:06
5d25f3d9b12203c3010ba92d7dacfcbeaf51781e...6b121aa5a7d2a02bf758c13cb9b5ef9845700b08,2,13,6,19,2,2014-07-09 08:12:09,2014-07-08 15:28:02
6b121aa5a7d2a02bf758c13cb9b5ef9845700b08...91e01275cb7c63e8f101c016d83f725d0e7e6cb9,3,45,6,51,5,2014-07-09 08:12:09,2014-07-09 08:12:02
22995fc9324774ce5301589d05a4687793faddac...437cccf9a9aecb44681e8b82921fd748297953d4,3,2,2,4,3,2014-07-09 06:47:06,2014-07-09 06:47:06
bc6a17a6828f2695a7ad0f64671ac1b6845c111d...2aef3b00cf2ee06dc4128a1a54483cccc1fd48f9,3,29,6,35,5,2014-06-06 20:15:54,2014-06-06 20:15:54
f055bad5135c8c3934daf16f8d9400f9a23b8960...b980ab407e6194723546125c80a0911b5e557215,1,12,1,13,3,2014-06-10 09:58:11,2014-06-10 09:58:11
b980ab407e6194723546125c80a0911b5e557215...fa9c39591c074d4766593f7ef93b91cbceb22c43,1,9,4,13,2,2014-06-10 10:57:50,2014-06-10 10:57:50
f055bad5135c8c3934daf16f8d9400f9a23b8960...7edf65d1ee9e65e5d5d2bde573936715b46e250d,3,24,0,24,3,2014-06-10 09:25:43,2014-06-10 09:25:43
7edf65d1ee9e65e5d5d2bde573936715b46e250d...525fa6c11ba739968c1af5b3dbd69a23c3834811,1,1,1,2,1,2014-06-10 09:29:23,2014-06-10 09:29:23
525fa6c11ba739968c1af5b3dbd69a23c3834811...55440ac9bec0b2e113d75540b898e4b46d766ba1,2,8,0,8,2,2014-06-10 09:33:17,2014-06-10 09:33:17
55440ac9bec0b2e113d75540b898e4b46d766ba1...f2353352a24976829470b7eb60b295313dfa75bb,1,1,1,2,1,2014-06-10 09:39:48,2014-06-10 09:39:48
f055bad5135c8c3934daf16f8d9400f9a23b8960...3affaa9b984eb07564bdec3521ae44d639e5e011,1,2,4,6,2,2014-06-10 08:40:28,2014-06-10 08:40:28
f055bad5135c8c3934daf16f8d9400f9a23b8960...6384344f156ccec0de746be68b168a745bdf73ae,1,1,0,1,1,2014-06-10 08:00:12,2014-06-10 08:00:12
6384344f156ccec0de746be68b168a745bdf73ae...dca6c490ccb8eb1e9bc73e214acf2ac6654f11ea,2,21,1,22,3,2014-06-10 09:16:47,2014-06-10 08:23:23
11e1c0134195270eabd2774055713699450ba49d...1f3a69c1d197254edb620032fc83ff668b649fa5,1,1,1,2,1,2014-06-12 18:39:08,2014-06-12 18:39:08
11e1c0134195270eabd2774055713699450ba49d...8e2752f4595db07197cacbf8c352e51b5268b71b,2,2,1,3,2,2014-06-12 13:32:47,2014-06-12 08:42:38
11e1c0134195270eabd2774055713699450ba49d...6e2a75df8ef0ea623c42c8cb6afc75690c011c5a,1,1,1,2,1,2014-06-12 13:16:29,2014-06-12 13:16:29
ce498eed9a2f394ce8c3110d0e233e873152c931...2dbf1a00a91b98f639212b46efdcbe60484e4483,3,4,4,8,3,2014-05-29 08:15:14,2014-05-27 10:47:09
2dbf1a00a91b98f639212b46efdcbe60484e4483...dfaf1a09924407df3b08d8796bc00ad2a0f56723,1,1,0,1,1,2014-05-29 08:15:54,2014-05-27 11:04:14
ce498eed9a2f394ce8c3110d0e233e873152c931...321130de7aa2c98eb8298c4e1caf2e2f468cd514,1,4,4,8,4,2014-05-29 07:12:35,2014-05-29 07:12:35
ce498eed9a2f394ce8c3110d0e233e873152c931...e61e3eaadb7f0c7c106b72d1325437e7743a2027,3,17,49,66,4,2014-05-29 06:44:25,2014-04-15 16:01:54
e61e3eaadb7f0c7c106b72d1325437e7743a2027...fd476cf62013e49acf23a301b841e7c09197e9ae,6,31,29,60,6,2014-05-29 06:44:25,2014-04-18 15:21:21
fd476cf62013e49acf23a301b841e7c09197e9ae...54ff9d90adc66f88c608b2157789d71b0944590e,1,4,1,5,1,2014-05-29 06:44:25,2014-05-28 12:37:08
54ff9d90adc66f88c608b2157789d71b0944590e...59797b2f2eef559397b53b6a3763c62d40363902,2,5,3,8,2,2014-05-29 06:44:25,2014-05-28 13:18:23
59797b2f2eef559397b53b6a3763c62d40363902...a9580a157a39bd6d7bc046f1bada88eb5d698b9c,4,11,17,28,4,2014-05-29 06:44:25,2014-05-28 13:47:03
a9580a157a39bd6d7bc046f1bada88eb5d698b9c...f79a300417120bb2bdd5d5b22c8ced42e5c3dab7,17,18,21,39,21,2014-05-29 06:58:15,2014-05-28 13:58:02
f79a300417120bb2bdd5d5b22c8ced42e5c3dab7...c1551c6ed077a00731e692edc1a7ddb0b1f29ad1,1,8,8,16,8,2014-05-29 06:58:15,2014-05-29 06:36:32
c1551c6ed077a00731e692edc1a7ddb0b1f29ad1...0879babfd1224626d0523a66caca0cac44ee9ee8,1,3,3,6,3,2014-05-29 08:13:30,2014-05-29 08:13:30
0879babfd1224626d0523a66caca0cac44ee9ee8...17a696a98b8f7a8bbdbcd4bdc3d1500e08ddceaa,1,1,0,1,1,2014-05-29 10:01:34,2014-05-29 10:01:34
3ed2fce208474face31a6df2dbbdc60b49826238...e8e2de0731bc1a6bfc62c4052b1af02a484d92c3,2,6,8,14,2,2014-07-31 16:03:47,2014-07-31 15:57:41
3ed2fce208474face31a6df2dbbdc60b49826238...9661070e26bea4cf364e607c64c64561a3ed3360,1,2,1,3,2,2014-07-31 14:04:08,2014-07-31 14:04:08
3ed2fce208474face31a6df2dbbdc60b49826238...0f4748873d927a6650c4056ae846151c33de8936,4,67,4,71,7,2014-07-31 11:06:14,2014-07-31 11:06:14
0f4748873d927a6650c4056ae846151c33de8936...833bc305933bbf7b8b06d5464ae5716ccbe82674,2,19,0,19,3,2014-07-31 11:14:27,2014-07-31 11:14:27
e794b561330070465a67ec57bc65069e12b78ef5...8265d43d016d4bcd67ce1f7cb452a239953cf8bd,2,11,1,12,2,2014-08-11 10:18:07,2014-07-31 09:22:46
678f3ddd6b7d409f2fd0ffeb7f7b9ad6b23b3fb0...66516da3c1d7a5fda7876b564a7be00b17d38d25,1,3,1,4,3,2014-09-04 14:15:08,2014-09-04 14:15:08
66516da3c1d7a5fda7876b564a7be00b17d38d25...3162140dfa30350a15caba662884ea9a24357ae9,2,4,2,6,4,2014-09-05 06:36:11,2014-09-05 06:36:11
3162140dfa30350a15caba662884ea9a24357ae9...3a971ca9ef612f44950182ded49c3bf9907fa530,1,5,5,10,5,2014-09-05 10:12:41,2014-09-05 10:12:41
20c2e90222ac0b12a4cc3fb9b9455232f6e250ae...079c1685f2cdcf40e86f4d3c9784b5cfe9db4ba2,1,3,3,6,1,2014-09-03 08:20:57,2014-09-03 08:20:57
20c2e90222ac0b12a4cc3fb9b9455232f6e250ae...0a7dea29aadb737f778830096515b10dc3dd1dd7,2,4,4,8,4,2014-09-03 06:06:16,2014-09-03 06:06:16
0a7dea29aadb737f778830096515b10dc3dd1dd7...cf53b361b98b899aeededde6aad1d4aca54fd8ff,1,2,0,2,1,2014-09-03 10:33:44,2014-09-03 10:33:44
20c2e90222ac0b12a4cc3fb9b9455232f6e250ae...ce7e6e61ef8e73cbe00ab63513e84eb1506e6bde,1,2,2,4,2,2014-09-02 20:13:14,2014-09-02 20:13:14
f0e391ce758ca6e7fd78023d8d7b9fbdd65ab32c...d5c569118cf3a928b3f7e77a017a0df39c2cb1f1,2,3,3,6,3,2014-09-04 08:00:29,2014-09-04 08:00:29
500a1a7bc30866b957de3ff975a60758dea8338f...5a14213f06856b1b63db1712eb41099f7dd99f8d,1,2,2,4,2,2014-09-16 15:50:33,2014-09-16 15:50:33
39c47844193266642c9e56c10290d8df3ae74b3c...dcc51b0d2c84fefaa35d61dc718b0aeecb023811,1,5,5,10,4,2014-09-17 04:48:08,2014-09-17 04:48:08
a3d90c5045ae322a013484165cdebcd764dc5d69...6014e28c2df977643ed4d1c5480158db0e9a09eb,1,0,10,10,1,2014-10-03 10:21:23,2014-10-03 10:21:23
a3d90c5045ae322a013484165cdebcd764dc5d69...3960a5a25aa857959544d274097b4f0e38777468,1,1,1,2,1,2014-10-03 10:19:31,2014-10-03 10:19:31
a3d90c5045ae322a013484165cdebcd764dc5d69...2e9f5de86896e53e9cf34aef52bbc2ad08019a21,33,67,67,134,67,2014-10-03 07:18:46,2014-09-25 22:07:40
a3d90c5045ae322a013484165cdebcd764dc5d69...b4963e9dda1ced7c219f24172e9fa4c8a5076b69,4,19,3,22,6,2014-10-03 06:23:32,2014-09-19 08:23:18
e586ee347f7740d2c16018a547fce7d3de9c3eb5...532eff616915e91b56e559a37080d92d5e5b741c,2,28,1,29,3,2014-09-24 12:02:24,2014-09-24 12:02:24
e586ee347f7740d2c16018a547fce7d3de9c3eb5...1e980ffbad96cdda4f34d4028b052e275db572ef,1,6,1,7,1,2014-09-23 14:56:41,2014-09-23 14:56:41
e586ee347f7740d2c16018a547fce7d3de9c3eb5...b083ab83ea5c5d63d4cc96f4179e9b7d5fb8f520,2,2,2,4,2,2014-09-23 14:11:16,2014-09-23 14:11:16
e586ee347f7740d2c16018a547fce7d3de9c3eb5...b897cc63a51d1199109ff9b1d2f8f665bd098a30,1,1,1,2,1,2014-09-23 13:14:17,2014-09-23 13:13:03
e586ee347f7740d2c16018a547fce7d3de9c3eb5...a5d23ae3c8ecdb516b330d9133ff3a19337d5cc9,2,67,3,70,4,2014-09-23 11:20:21,2014-09-23 11:20:21
e586ee347f7740d2c16018a547fce7d3de9c3eb5...f12d6278ed57ba3a76f411b05cf9fba940feebfd,2,26,5,31,7,2014-09-23 11:18:36,2014-09-23 11:18:36
9f939c9697c735839072185a9792338f617a2a41...30c447ed2f35a0d1f4eb0f6200aa9ab952c46768,2,18,1,19,2,2014-10-02 12:38:26,2014-10-02 12:38:26
9f939c9697c735839072185a9792338f617a2a41...1489b8d50eb420b884d5d7b142d55a718a76ea82,1,16,4,20,1,2014-10-02 10:39:26,2014-10-02 10:39:26
9f939c9697c735839072185a9792338f617a2a41...d2808476e3f85c9940500b84ee14d38615ceca41,1,8,2,10,1,2014-10-02 09:52:19,2014-10-02 09:49:31
d2808476e3f85c9940500b84ee14d38615ceca41...d3388d4790c6d09e97d9961e3e9de2d0c60d704b,1,8,2,10,3,2014-10-02 09:55:02,2014-10-02 09:55:02
5040dbfbf871533a8ae0f744856344f167e9a3d8...74d4031bbe1a5c522879e4db644c9069d9cedb3e,2,8,0,8,2,2014-09-25 15:52:33,2014-09-25 15:52:33
c6efa56ee7039882625942ce29ea9fdeeffaa6cd...705652d62538ec29d125e0ec62bebc99ddc3af71,5,33,2,35,5,2014-10-24 08:52:52,2014-10-24 08:52:52
c6efa56ee7039882625942ce29ea9fdeeffaa6cd...7b339e61e8e4a93798807f3c90bf7179a0ecd28b,6,33,75,108,17,2014-10-23 18:47:28,2014-10-23 18:47:28
c6efa56ee7039882625942ce29ea9fdeeffaa6cd...6704792933575846c55724a8fe667edb4ddcb490,2,5,17,22,4,2014-10-23 09:11:53,2014-10-23 09:11:53
e8f1331fa4b3f4c4037f6509b2a846f521f506fc...5f6eb09cdf1bb264e788521cd7289e419fd68e13,3,48,35,83,22,2014-09-03 16:18:23,2014-09-03 16:18:23
e8f1331fa4b3f4c4037f6509b2a846f521f506fc...6f423b987f0c461ace7702a142c7230082d122be,2,11,1,12,2,2014-09-03 14:10:41,2014-09-03 14:10:41
e8f1331fa4b3f4c4037f6509b2a846f521f506fc...62fc80642dbdb6a3b840a770fde15b84b8495a03,3,80,72,152,16,2014-09-03 13:59:50,2014-09-03 13:59:50
62fc80642dbdb6a3b840a770fde15b84b8495a03...1bd15fa717e053824e3abbf72e4010f19677fb79,2,50,52,102,15,2014-09-03 15:33:03,2014-09-03 15:33:03
1bd15fa717e053824e3abbf72e4010f19677fb79...5b86dab03bbd19d9a3e6090d4672d8f1493e6fe5,3,46,87,133,22,2014-09-04 10:55:10,2014-09-04 10:55:10
5b86dab03bbd19d9a3e6090d4672d8f1493e6fe5...18f88a1b7627fe08d5f3e299276709101d091d48,1,54,0,54,1,2014-09-04 11:00:27,2014-09-04 11:00:27
18f88a1b7627fe08d5f3e299276709101d091d48...f88b6d03306be1ec487a0746512f8d02722da435,1,13,11,24,5,2014-09-08 11:11:39,2014-09-08 11:11:39
f88b6d03306be1ec487a0746512f8d02722da435...f27830fa4c11548279b5eed68e92b6f352ad4a9f,1,17,0,17,1,2014-09-08 11:26:25,2014-09-08 11:26:25
f27830fa4c11548279b5eed68e92b6f352ad4a9f...11bb67c3c6d4b90629744f8a011121e35968c58b,2,32,11,43,4,2014-09-08 12:53:59,2014-09-08 12:53:59
11bb67c3c6d4b90629744f8a011121e35968c58b...b18d1c2786c2a385d6b797734a1afad7a01ddf35,1,0,10,10,1,2014-09-08 13:25:42,2014-09-08 13:25:42
cb0d63b9e3fa464ae8c0cd9cf7bdb8d080a7e02f...ceabda743a14f2cbd8edfd704743765c8f58a743,4,28,11,39,17,2014-07-28 09:47:27,2014-07-28 09:47:27
cb0d63b9e3fa464ae8c0cd9cf7bdb8d080a7e02f...2e55eac21522b67cba5d80e9af33ee2142fd80b6,1,1,1,2,1,2014-07-28 08:24:49,2014-07-28 08:24:49
cb0d63b9e3fa464ae8c0cd9cf7bdb8d080a7e02f...062ff17b1cd65485d88b676584ae793cce8b3345,3,31,7,38,9,2014-07-27 21:48:53,2014-07-27 20:26:23
cb0d63b9e3fa464ae8c0cd9cf7bdb8d080a7e02f...2f78d75c4ad1adfa2d3c09e80ae5de2fcb6193f7,1,1,1,2,1,2014-07-27 06:31:31,2014-07-27 06:31:31
cb0d63b9e3fa464ae8c0cd9cf7bdb8d080a7e02f...afc5b7110fbabc2ec0f4a5de0ddcf98565a1a3fb,4,11,5,16,6,2014-07-26 17:43:04,2014-07-26 17:43:04
ed9e922dd0047435b8d349f0c949ba0a2d789247...4b9a838dc8d92e2448daeb02070b86a2ae0504e0,5,17,0,17,2,2014-08-20 12:25:55,2014-08-20 12:25:55
4b9a838dc8d92e2448daeb02070b86a2ae0504e0...2353554ba50f5aeb82611a365563b079de194c45,1,1,1,2,1,2014-08-20 14:24:17,2014-08-20 14:24:17
ed9e922dd0047435b8d349f0c949ba0a2d789247...7ad93ab250019d7737186a0bf8884faf2db2b625,6,84,15,99,16,2014-08-20 10:09:19,2014-08-17 20:22:01
7ad93ab250019d7737186a0bf8884faf2db2b625...9d5c69019371379d055be8ba963fde78d3e0c7f6,1,23,0,23,1,2014-08-20 10:31:19,2014-08-20 10:31:16
ed9e922dd0047435b8d349f0c949ba0a2d789247...e72b7cc250b473cec2c5a222f14247859f423936,2,35,0,35,2,2014-08-20 09:56:52,2014-08-20 09:56:52
ed9e922dd0047435b8d349f0c949ba0a2d789247...5b99b6f250fb069d029a358c1ae823eb10e5bc37,1,6,6,12,7,2014-08-20 08:31:25,2014-08-20 08:31:25
ed9e922dd0047435b8d349f0c949ba0a2d789247...30ba7aea19203998eda68203ce0cdac38fa6b48b,3,17,1,18,3,2014-08-20 07:56:49,2014-08-20 07:54:47
87efd92d8cc378697359012226d2679cab7e1e9e...0e14fb05258f8929a23a41b8bb413b22895e5179,2,83,17,100,19,2014-08-21 03:05:17,2014-08-21 03:05:17
87efd92d8cc378697359012226d2679cab7e1e9e...66f6ca0770fa91a3763d45f8c1d2194d95b3c67b,2,13,11,24,7,2014-08-20 18:34:55,2014-08-20 18:34:55
87efd92d8cc378697359012226d2679cab7e1e9e...1ff781c3c97d383ba37e243da854405ddfabbfed,1,1,1,2,1,2014-08-20 16:53:19,2014-08-20 16:53:19
87efd92d8cc378697359012226d2679cab7e1e9e...64102476dcadd4ff943dfb27adedea6497456c71,1,1,1,2,1,2014-08-20 16:11:51,2014-08-20 16:11:51
6df16564efd712ca201428504dde5b6ac020a87d...4f9098032c0f55672f125b8be56d881490176959,1,0,66,66,1,2013-09-14 07:14:55,2013-09-14 07:14:55
4d5cdbd286d9ab8ffa09eaea5ef91c8767bfe7aa...83b212a4ef942ec34096c2d194f8dd827ef4eb8b,2,13,7,20,3,2013-09-13 12:39:04,2013-09-13 12:39:04
83b212a4ef942ec34096c2d194f8dd827ef4eb8b...c71460d2d3c6b868da099f090af812e15d552bb9,1,1,1,2,1,2013-09-14 11:28:15,2013-09-14 11:28:15
9f2e19b064844bf1310df0a97b3d11b37c6f3b33...7311477e484b8838093c7fae704445221aba9a71,1,4,0,4,1,2013-09-14 15:24:55,2013-09-14 15:24:55
7311477e484b8838093c7fae704445221aba9a71...3fe2558a5c3b2cc9097d75a27dd184a8b3db9689,1,1,1,2,1,2013-09-14 15:25:42,2013-09-14 15:25:42
3fe2558a5c3b2cc9097d75a27dd184a8b3db9689...a51562d6d9a8b52de5752523e2fe8e2c931f55e9,1,10,7,17,4,2013-09-14 17:51:16,2013-09-14 17:51:16
a51562d6d9a8b52de5752523e2fe8e2c931f55e9...74a621385fe0905f3373d947eb0aeba1af1ebb80,1,8,1,9,1,2013-09-14 17:55:33,2013-09-14 17:55:33
74a621385fe0905f3373d947eb0aeba1af1ebb80...90dc5ff5fdfe316b0ccd5706c7c98738c48876de,2,3,4,7,4,2013-09-14 18:18:01,2013-09-14 18:18:01
90dc5ff5fdfe316b0ccd5706c7c98738c48876de...e0e88cddd805a1aa5f467dcea826c24a64187df0,2,14,8,22,11,2013-09-14 19:01:31,2013-09-14 19:01:31
b512fbc0ecba0a8de9c9efe5c7d82a97f0ea744c...8a0bfa499891a2c9453ef5b350ecc23397ec12be,1,1,1,2,1,2014-01-03 15:02:57,2014-01-03 15:02:57
b512fbc0ecba0a8de9c9efe5c7d82a97f0ea744c...4105878ae7b6d84d81df8c2092d2292a105eff80,1,1,1,2,1,2014-01-03 05:46:39,2014-01-03 05:46:39
4105878ae7b6d84d81df8c2092d2292a105eff80...0fefbad6c9926f459aefa69ed0ff422cab3c4f93,1,13,5,18,4,2014-01-03 05:54:05,2014-01-03 05:54:05
b512fbc0ecba0a8de9c9efe5c7d82a97f0ea744c...7cc25205410efc6b20b11d94ab2cbc1a322ff816,6,44,8,52,13,2014-01-02 16:18:56,2013-12-20 19:12:44
d25b5d029d539ccccbea25d7efceeddbf4002459...46e0e59217ce77690cc5de8de0e984ee7550aafe,2,5,11,16,4,2014-01-05 11:29:21,2014-01-05 11:29:21
46e0e59217ce77690cc5de8de0e984ee7550aafe...ac6c050773bdd24f63f94dc2f4124778fa604b53,3,3,4,7,4,2014-01-05 11:41:09,2014-01-05 11:41:09
ac6c050773bdd24f63f94dc2f4124778fa604b53...70f705887ad52152100e45d398a5f0d330ddc5bb,1,3,2,5,3,2014-01-05 11:45:03,2014-01-05 11:45:03
70f705887ad52152100e45d398a5f0d330ddc5bb...7a84c5c86ccd130569684cda451ebd31c7020c1c,1,2,2,4,2,2014-01-05 11:58:48,2014-01-05 11:58:48
7a84c5c86ccd130569684cda451ebd31c7020c1c...d28ee0df124d79e9d0968c3325ae010b55d4a7b6,2,14,8,22,6,2014-01-05 11:59:01,2014-01-05 11:59:01
b926b02332daeab5c9819e2512533a470e67e9ab...43da3f0929521615fe77d1dcb85318a8128bb7e8,1,3,0,3,1,2015-01-28 10:34:33,2015-01-28 10:09:11
43da3f0929521615fe77d1dcb85318a8128bb7e8...087c4cbc3cba2cce1c25773af304833d217976fc,2,4,4,8,4,2015-01-28 10:34:33,2015-01-28 10:08:44
b926b02332daeab5c9819e2512533a470e67e9ab...e20dba0299c1395cc8862c44b0b3933266abe001,2,20,5,25,5,2015-01-26 08:23:16,2015-01-26 08:23:16
7bf203685210a7484c8deb03d7275e482656e2b3...39bfe0aa1d3a17858accce3b8118fd9fe2926cc7,1,4,2,6,1,2015-02-03 17:45:39,2015-02-03 17:45:39
7bf203685210a7484c8deb03d7275e482656e2b3...0ef495734d6f011b39afdb887f44e14045c351ba,2,32,73,105,18,2015-02-03 17:26:17,2014-12-13 16:06:53
7bf203685210a7484c8deb03d7275e482656e2b3...b9d9ac82a9d650b659866ea26dcb4e7987f10381,5,43,21,64,7,2015-02-03 17:10:56,2015-02-03 05:30:11
b9d9ac82a9d650b659866ea26dcb4e7987f10381...c8782e1a402f187573562ce8af9068898fd01673,1,2,2,4,2,2015-02-03 17:22:56,2015-02-03 17:22:56
c8782e1a402f187573562ce8af9068898fd01673...19f39b4292a80942ff42d345afca957c04545b9b,1,1,1,2,1,2015-02-03 17:23:55,2015-02-03 17:23:55
704922c855a9741b5495db56ac266788a9c25c33...7b233ea853df7c13be688c0e47636d2750453f31,4,4,4,8,4,2015-02-04 00:55:31,2015-02-04 00:55:31
7b233ea853df7c13be688c0e47636d2750453f31...655fbc6bddb1d5f8df3e50f2896e5c6c276628b8,1,4,2,6,1,2015-02-04 03:25:57,2015-02-04 03:25:57
7d3daa4dfbf5e00d48e4658d7bf7406406e63607...8d0bc76487b428ad629f9bdd883cf8af794431a6,1,1,1,2,1,2014-09-12 17:56:25,2014-09-12 17:52:27
cbb44b9da3e7288200485caed7a9716013e34984...81a70bf5153bb9470e96dde05102afd397528cf0,4,9,3,12,6,2014-09-12 15:38:14,2014-09-12 15:38:14
c091e6cfff8a00eb28e40fd0233e519776b64a24...976eb7a9555e8ffe669148c7026e66f81a147428,2,2,2,4,2,2014-09-10 13:28:58,2014-09-10 13:28:58
00c6723883671769f6efd692f935dc3203d7ccc6...ddaa493ef3f6ca2b84bc02acc7a5961cf18e3c12,5,20,6,26,6,2014-07-28 17:54:40,2014-07-28 17:54:40
00c6723883671769f6efd692f935dc3203d7ccc6...37c4ba6f8d8b6be9f15bd0df701c64eea9c4d8e4,3,20,4,24,7,2014-07-28 16:48:13,2014-07-28 05:01:01
00c6723883671769f6efd692f935dc3203d7ccc6...03ae6b89bd1031fe6017d0e839e0795b0083f400,3,15,0,15,3,2014-07-28 14:46:36,2014-07-03 14:23:41
00c6723883671769f6efd692f935dc3203d7ccc6...914275ac0a479ef6f4ae8f1969c04db4362c73e5,1,2,0,2,2,2014-07-28 13:11:27,2014-07-28 13:11:27
e0cdb8a3611aa2e4727c8523b9a924afd5751b01...83b40ba268a343af6c38a24d8ccc2e6a7e047633,1,9,0,9,1,2014-07-25 11:47:11,2014-07-25 11:47:11
53ead2e35c9195ae1f68bf5d7154e341636caf1b...3d7b79e454ed680f20abe9eb957693ea44599b48,1,1,1,2,1,2014-08-14 11:19:44,2014-08-14 11:19:44
3d7b79e454ed680f20abe9eb957693ea44599b48...fe465004489024f731835d5eb934efa2decf6ac3,1,1,1,2,1,2014-08-14 11:20:34,2014-08-14 11:20:34
53ead2e35c9195ae1f68bf5d7154e341636caf1b...9284038dbef5153dac40eda14f1685a72efe1d1a,10,205,42,247,11,2014-08-13 10:28:19,2014-08-12 12:16:25
9284038dbef5153dac40eda14f1685a72efe1d1a...cf3ba0209dc7dc8b9ac93d574a8f6296b858be40,5,126,9,135,7,2014-08-13 10:29:03,2014-08-13 10:23:51
53ead2e35c9195ae1f68bf5d7154e341636caf1b...9f4613bb8696cf15739ce2deb469407c0bbdefee,1,1,1,2,1,2014-08-13 07:24:50,2014-08-13 07:24:50
53ead2e35c9195ae1f68bf5d7154e341636caf1b...88773498b97929d36370deef714c3ebb30f71877,1,1,1,2,1,2014-08-12 16:10:16,2014-08-12 16:10:16
53ead2e35c9195ae1f68bf5d7154e341636caf1b...e642cbe0fa72ab35baec1a63cb29ed1090f9f7c2,1,5,5,10,5,2014-08-12 13:41:25,2014-08-12 13:41:25
e642cbe0fa72ab35baec1a63cb29ed1090f9f7c2...ad6d14a1b1e5f6277d5faf56a19e0876c46891cd,1,1,1,2,1,2014-08-13 07:16:00,2014-08-13 07:16:00
d7ab859b911dba7a035ee67047ccd5cbd6e33c73...09e64ae605914656e2b928dad0dce5df28b6f9a2,2,13,3,16,4,2014-09-11 08:06:56,2014-09-11 08:04:58
c337a2782463cdaed6cd0cae36b904b9ccda78b7...1f3261ac414ce42e5bbb6d5e0891e2cb5483dace,1,11,0,11,1,2014-07-09 16:13:31,2014-07-09 16:13:31
47d5ef4bd54ac493a35d190d0909059b6e35c0fe...239d942606bd35d90c4546eb7b0fd530baf00a05,1,1,0,1,1,2014-07-09 12:49:53,2014-07-09 12:49:53
47d5ef4bd54ac493a35d190d0909059b6e35c0fe...34cfd84ed253dbee59c3097b0d10d9ed112cac58,2,10,9,19,6,2014-07-09 11:22:32,2014-07-09 11:17:45
34cfd84ed253dbee59c3097b0d10d9ed112cac58...4024aa8e812a546b0d6c9110b6b8d36d327961fc,4,48,5,53,6,2014-07-09 12:42:25,2014-07-09 12:42:25
4024aa8e812a546b0d6c9110b6b8d36d327961fc...1e3fce1a82ee3583f2e209f48c30b964e32a637c,1,6,1,7,2,2014-07-10 11:10:37,2014-07-10 11:10:37
1e3fce1a82ee3583f2e209f48c30b964e32a637c...108be8a666d7478e78c39c8e4e54db622f0e58dc,5,8,5,13,5,2014-07-10 11:56:35,2014-07-10 11:56:35
108be8a666d7478e78c39c8e4e54db622f0e58dc...60cc1d8e92ad7d2be9f452cbbce8b583bc87056f,2,4,1,5,2,2014-07-10 17:31:05,2014-07-10 17:31:05
47d5ef4bd54ac493a35d190d0909059b6e35c0fe...d6067296def59635a82ede72db0f6cc136c9887b,1,1,1,2,1,2014-07-09 09:38:29,2014-07-09 09:38:29
ab094e67eed54f5c29a33d2114cc91908e543972...0d13abb1c8d527f2a6e6b97e34899e9b35f264bc,2,19,1,20,2,2014-06-07 12:46:58,2014-06-07 12:46:58
ab094e67eed54f5c29a33d2114cc91908e543972...98d697a1a6adf2e69831dafb05fc36fdd4b797b6,1,6,0,6,1,2014-06-07 12:18:01,2014-06-07 12:18:01
ab094e67eed54f5c29a33d2114cc91908e543972...3dc0bce9474ac52046f5c3efb2532af6334a7aae,2,19,1,20,2,2014-06-07 12:06:55,2014-06-07 12:06:55
ab094e67eed54f5c29a33d2114cc91908e543972...c1ccc3a57b8e335c014e3176f3255ed74703572f,3,44,3,47,4,2014-06-07 09:14:33,2014-03-28 20:15:25
86fa07402467272a28ed7983268f9012eb85879d...11728851bf0b1b06e14858b08b1afcec44ec3d46,2,6,3,9,3,2014-06-12 18:36:38,2014-06-12 18:36:38
11728851bf0b1b06e14858b08b1afcec44ec3d46...c827af21d3548f98c809550b471bbb3f5a344076,1,0,2,2,1,2014-06-12 18:49:02,2014-06-12 18:49:02
c827af21d3548f98c809550b471bbb3f5a344076...98416ec9ab805b0afb994972e073b743b8204312,2,27,14,41,3,2014-06-12 18:49:45,2014-06-12 18:49:45
98416ec9ab805b0afb994972e073b743b8204312...1bde927750b60d17334e188b70959059f3b00060,4,15,21,36,6,2014-06-12 19:08:54,2014-06-12 19:08:54
749d198f10fe031d56fda540788148eeaa906bc8...3910b5917c84875f94f8b15594e4c506a3de39cc,1,14,0,14,1,2014-05-29 10:49:15,2014-05-29 10:49:15
3910b5917c84875f94f8b15594e4c506a3de39cc...4a03bbe4831399381a45cde7fd19ecfb67895bd4,2,43,7,50,5,2014-05-30 15:09:31,2014-05-30 15:09:31
749d198f10fe031d56fda540788148eeaa906bc8...631eb0420c03da8ada8edb2e94f7474952fbd070,1,6,5,11,4,2014-05-29 10:33:14,2014-05-29 10:33:14
b1ce97d5a1b3890e4137212547d97f3ab38c3991...c1b1c321962de51090d590dc40fc2784aaa0d561,4,13,0,13,5,2014-05-29 14:55:55,2014-05-29 14:55:55
c1b1c321962de51090d590dc40fc2784aaa0d561...1f976a646d1439e41925ec83dc2ea92d48370831,4,4,4,8,4,2014-07-01 13:29:58,2014-07-01 13:29:58
b1ce97d5a1b3890e4137212547d97f3ab38c3991...2e03ccff0297d1cf34f85fc3b4e47431253492af,1,3,3,6,3,2014-05-29 14:46:45,2014-05-29 12:20:40
b1ce97d5a1b3890e4137212547d97f3ab38c3991...97e06bcfe661ca138c3d7f5a810783e5ec7596f5,1,12,1,13,1,2014-05-29 14:37:28,2014-05-29 14:37:28
97e06bcfe661ca138c3d7f5a810783e5ec7596f5...420b46eedf03bdcaaa4177b9db7b8c39162fe40c,1,0,2,2,1,2014-06-25 14:56:56,2014-06-25 14:50:16
833bc305933bbf7b8b06d5464ae5716ccbe82674...8aff39a6d0a63e904ada910900ee07a1c3190a9d,2,30,59,89,10,2014-08-04 13:57:59,2014-08-04 13:57:59
833bc305933bbf7b8b06d5464ae5716ccbe82674...38a692d20be957ebf0c8a71937887a61c6bb2a23,1,3,3,6,3,2014-07-31 16:55:13,2014-07-31 16:55:13
833bc305933bbf7b8b06d5464ae5716ccbe82674...79d71461c2be3802a96b048e5ba55bfde90f5fac,1,16,16,32,16,2014-07-31 16:39:04,2014-07-31 16:39:04
833bc305933bbf7b8b06d5464ae5716ccbe82674...f82b9e48ec038a3718aeeeb248b0a01c9f88fa33,4,29,140,169,12,2014-07-31 12:39:01,2014-07-31 12:39:01
f82b9e48ec038a3718aeeeb248b0a01c9f88fa33...43d570e0ce74d70f046edd84b5c104956eee859c,1,1,0,1,1,2014-07-31 12:39:28,2014-07-31 12:39:28
43d570e0ce74d70f046edd84b5c104956eee859c...f4845d6b7c397ac04aa36dd8122fe4627483a29b,1,4,6,10,3,2014-07-31 12:39:44,2014-07-31 12:39:44
f4845d6b7c397ac04aa36dd8122fe4627483a29b...830eaa7f4e9026cc2d1088fd601d5a913fdbdbb6,1,1,1,2,1,2014-07-31 12:51:17,2014-07-31 12:51:17
830eaa7f4e9026cc2d1088fd601d5a913fdbdbb6...bb2f4d665e946806d0bb94d3a50569ae6aa12e66,10,53,44,97,24,2014-07-31 13:20:47,2014-07-31 13:20:47
bb2f4d665e946806d0bb94d3a50569ae6aa12e66...c2c7d14ec51ec8654cc4e0ca57ba0bc146fd8725,11,124,92,216,34,2014-07-31 14:23:40,2014-07-31 14:23:40
c2c7d14ec51ec8654cc4e0ca57ba0bc146fd8725...5a68c20fba095ec61aa3b74cb0fbeb69adbc1373,5,67,79,146,19,2014-07-31 15:07:24,2014-07-31 15:07:24
5a68c20fba095ec61aa3b74cb0fbeb69adbc1373...ee4643c732c3d91437e50d0c8486dbb8ea5b51b5,3,43,20,63,20,2014-07-31 16:19:40,2014-07-31 16:19:40
ee4643c732c3d91437e50d0c8486dbb8ea5b51b5...b238b1544c391bbc60a7d38c30d98e05be786667,5,52,56,108,11,2014-07-31 16:24:53,2014-07-31 16:24:53
b238b1544c391bbc60a7d38c30d98e05be786667...61f70334efa3ff4a2eda4a1d29c2ee59ecb82721,2,4,12,16,7,2014-07-31 16:35:07,2014-07-31 16:35:07
61f70334efa3ff4a2eda4a1d29c2ee59ecb82721...49b119fa31d530cf2411b2c84e54b8f455e23315,2,0,36,36,1,2014-07-31 16:38:26,2014-07-31 16:38:26
49b119fa31d530cf2411b2c84e54b8f455e23315...2a6fc1c5debc81ac883bad4e7f9748be88a9b9ff,1,4,1,5,2,2014-07-31 17:12:49,2014-07-31 17:12:49
2a6fc1c5debc81ac883bad4e7f9748be88a9b9ff...cbe4891d7c44d59c902d13315eb3140fb6d47486,4,54,94,148,10,2014-07-31 17:13:27,2014-07-31 17:13:27
cbe4891d7c44d59c902d13315eb3140fb6d47486...a35a22ae051d9b1ab97eb91ea4354baba2addf80,1,6,2,8,1,2014-07-31 18:01:42,2014-07-31 18:01:42
a35a22ae051d9b1ab97eb91ea4354baba2addf80...7783f5ec73841fcd96dc3c86283b961e0459714a,2,5,5,10,3,2014-07-31 18:30:35,2014-07-31 18:30:35
7783f5ec73841fcd96dc3c86283b961e0459714a...3a017a4e3cfeefce562429eb19b132612bf8f63c,1,2,1,3,1,2014-07-31 19:34:25,2014-07-31 19:34:25
3a017a4e3cfeefce562429eb19b132612bf8f63c...faaedbf0514f14d7f7341d72b507f541efbc5d26,2,32,32,64,21,2014-07-31 19:34:37,2014-07-31 19:34:37
faaedbf0514f14d7f7341d72b507f541efbc5d26...394ac378f806db8d521e13709bdd3a3e5550399d,4,29,31,60,20,2014-07-31 20:05:30,2014-07-31 20:05:30
394ac378f806db8d521e13709bdd3a3e5550399d...bd72c74dab2f97b86f3112306c41aeedb63fea23,2,5,5,10,4,2014-07-31 20:33:13,2014-07-31 20:33:13
bd72c74dab2f97b86f3112306c41aeedb63fea23...ff5176d45a14f9814ef05e257664de3ddbb30d20,1,4,2,6,2,2014-08-01 12:11:27,2014-08-01 12:11:27
ff5176d45a14f9814ef05e257664de3ddbb30d20...0082cfb14641ca7fa0cdf3aee641694c26c0ae26,1,7,6,13,7,2014-08-01 12:18:17,2014-08-01 12:18:17
0082cfb14641ca7fa0cdf3aee641694c26c0ae26...72053703e816c848a54b089ecb318e66291b8b8c,2,13,9,22,10,2014-08-01 12:41:02,2014-08-01 12:41:02
72053703e816c848a54b089ecb318e66291b8b8c...7e1680934bbba7df0c7d4b2448e28bbd2d697168,1,25,23,48,15,2014-08-01 14:30:28,2014-08-01 14:30:28
7e1680934bbba7df0c7d4b2448e28bbd2d697168...9338ed0606913460f09d6e0633eb436a52491514,3,51,51,102,6,2014-08-01 14:54:44,2014-08-01 14:54:44
9338ed0606913460f09d6e0633eb436a52491514...4710a76a8d5a69e3f68154aeb2392caa665c59f2,1,7,4,11,3,2014-08-01 15:06:28,2014-08-01 15:06:28
4710a76a8d5a69e3f68154aeb2392caa665c59f2...b954f24420114a6acee9caf038e6dae6650bd066,1,2,3,5,3,2014-08-06 06:07:11,2014-08-06 06:07:11
b954f24420114a6acee9caf038e6dae6650bd066...8f1e60b05719bf8c5c7474ad228f925a0cab6b07,4,51,76,127,25,2014-08-06 06:52:56,2014-08-06 06:52:56
8f1e60b05719bf8c5c7474ad228f925a0cab6b07...e4c6dbe35f25dc902882437a407810a7bc87b042,1,10,8,18,7,2014-08-06 06:57:15,2014-08-06 06:57:15
e4c6dbe35f25dc902882437a407810a7bc87b042...e1f141ac1aa55aa12cd36fc5ddf5292734cdc0a3,1,5,1,6,1,2014-08-06 09:14:53,2014-08-06 09:14:53
e1f141ac1aa55aa12cd36fc5ddf5292734cdc0a3...349eaaa9c27687e5e1430a967d19877215220d83,1,5,4,9,5,2014-08-06 09:15:05,2014-08-06 09:15:05
349eaaa9c27687e5e1430a967d19877215220d83...fe228b89d540ff61fd97e27b0ebe5915a737bb52,1,2,2,4,2,2014-08-07 17:12:02,2014-08-07 17:12:02
fe228b89d540ff61fd97e27b0ebe5915a737bb52...a0755d2f051c5a9cd31721333adee22cb40b1008,4,158,156,314,44,2014-08-07 17:46:17,2014-08-07 17:46:17
80f8cb2f8844566cda41529a2b0fd4b75eb3080d...80036470c3fd86262e307d661a503105b3cd0a43,1,3,0,3,1,2014-08-11 10:31:58,2014-08-11 10:31:58
80036470c3fd86262e307d661a503105b3cd0a43...f8eedb4cdac6423a038c80d39d70ad1db17d3da5,1,5,3,8,3,2014-08-11 12:25:25,2014-08-11 12:25:25
3a971ca9ef612f44950182ded49c3bf9907fa530...d93b046c4c7adf5a8fe37122864d7b1fabbd5bf6,4,31,2,33,7,2014-09-05 11:36:43,2014-09-05 10:33:05
d93b046c4c7adf5a8fe37122864d7b1fabbd5bf6...23241c181c0becdff17365aa49f80c05210f8b16,2,6,3,9,3,2014-09-06 09:46:14,2014-09-06 09:46:14
23241c181c0becdff17365aa49f80c05210f8b16...9edf6d4dd08d3bd74df22645a919dbf26d22faf7,1,1,1,2,1,2014-09-06 18:42:11,2014-09-06 18:42:11
6298e55795f4cfa624bfd91bfe716cc21beb8544...fe314d460efd18ea064df987a5a215904b95fd4e,2,12,12,24,9,2014-09-19 13:39:56,2014-09-19 13:39:56
fe314d460efd18ea064df987a5a215904b95fd4e...648557048226ba98c514531135e96df9c34bdda7,4,33,4,37,5,2014-09-20 08:55:58,2014-09-20 08:55:58
00ccaed029efbbdff96a4b64628a3a2d9bf5125d...788033a2cf2a18a881c7029bfb01585b844a05d5,3,41,62,103,3,2014-09-04 07:16:50,2014-09-03 11:15:03
00ccaed029efbbdff96a4b64628a3a2d9bf5125d...40fc4261f2e6c8eaf6e885405863e929ecbd47b3,5,51,1,52,11,2014-09-02 23:27:02,2014-08-18 14:46:46
d5c569118cf3a928b3f7e77a017a0df39c2cb1f1...0ac4a933ffae00adc4b7ab58af9bef15ed8c412b,5,98,5,103,17,2014-09-04 12:41:31,2014-08-14 14:17:19
43217dd5ddcb7557ea0c7300c6a02253f1b99d7d...d92749989490289793e1e64fc6fff5673c41c75a,1,0,5,5,1,2014-10-04 08:54:00,2014-10-04 08:54:00
43217dd5ddcb7557ea0c7300c6a02253f1b99d7d...d1fa3b336d1d3e3c1f9a10ca007e3d1193e5e205,9,223,2,225,13,2014-10-03 11:54:37,2014-10-01 00:48:41
553680d04e84b91a5c01b0121da76b9c63956c57...8952c5ce2eeeef1013674feedfceb56e77c874d2,1,1,1,2,1,2014-09-17 09:23:44,2014-09-17 09:23:44
8952c5ce2eeeef1013674feedfceb56e77c874d2...2b35c887904b6a7a05a7c88fdf1ccd66ba943e20,3,158,24,182,20,2014-09-17 16:27:23,2014-09-17 16:27:23
2b35c887904b6a7a05a7c88fdf1ccd66ba943e20...630d042433e0cecffe80aa5ebd7aa7a91c5eb2d8,1,1,1,2,1,2014-09-17 16:28:00,2014-09-17 16:28:00
de717a33352e789641fdb51ba162eefcd8efdfa4...b268fa059527f8b98969116d1beda11cc69a84bb,1,1,1,2,1,2014-09-25 07:34:29,2014-09-25 07:34:29
de717a33352e789641fdb51ba162eefcd8efdfa4...184e0f8df14640f1fb1ddcabb912f50c200f6249,1,1,1,2,1,2014-09-24 16:15:37,2014-09-24 16:15:37
184e0f8df14640f1fb1ddcabb912f50c200f6249...64a2afd3a430014796dc8ff9a1dc6af778b8349c,1,1,1,2,1,2014-09-24 16:30:58,2014-09-24 16:30:58
64a2afd3a430014796dc8ff9a1dc6af778b8349c...2aeac794c2deb74043a74b263c4f4fc5d8a849a3,1,7,0,7,1,2014-09-24 16:46:42,2014-09-24 16:46:42
143b936300ab8f3f63945fe5b38b6e7c6c2564bb...53f6f537b09f0f3992589eed968499226814848e,1,1,1,2,1,2014-09-25 23:48:17,2014-09-25 23:48:17
143b936300ab8f3f63945fe5b38b6e7c6c2564bb...16d530b7b040093d8489f130af2dde684fabc3c6,3,4,1,5,3,2014-09-25 16:41:49,2014-09-25 16:41:49
143b936300ab8f3f63945fe5b38b6e7c6c2564bb...810028f3f38e39feb77709c5193a30b97048501c,1,1,1,2,1,2014-09-25 16:05:27,2014-09-25 16:05:27
30eaf4840bfc22711758f303fa981a5fc64cd217...6b2b20af417b09e0c6a404206b89e7e2ab7be0ed,2,3,2,5,3,2014-10-23 12:21:58,2014-10-23 12:21:21
10528341c296fafca8388159d7b0023cd2ffb1cb...7039c9868a3209d89f8306c65ca5b74f8e2ea2c0,5,7,7,14,7,2014-10-23 01:39:02,2014-10-23 01:39:02
7039c9868a3209d89f8306c65ca5b74f8e2ea2c0...7fbc4f5b3ac2abfa8ad94cc228114462b7b94601,5,16,8,24,7,2014-10-23 22:49:48,2014-10-23 22:49:48
7fbc4f5b3ac2abfa8ad94cc228114462b7b94601...000af8d5d7087cadbfd8ad677fb941e74a8ee3c7,5,55,2,57,6,2014-10-24 22:19:35,2014-10-24 22:19:35
000af8d5d7087cadbfd8ad677fb941e74a8ee3c7...37f33393b2e6aa18c416cb7a55d8de80dde0af58,1,3,3,6,3,2014-10-25 00:17:00,2014-10-25 00:17:00
37f33393b2e6aa18c416cb7a55d8de80dde0af58...9397d19380aa4f63c9f8b67bf06b9d9ca3db3c1a,1,1,1,2,1,2014-10-28 16:02:36,2014-10-28 16:02:36
9397d19380aa4f63c9f8b67bf06b9d9ca3db3c1a...bf07fcf06ad7a5d2fd5f25079ce9e16d003481c7,1,1,1,2,1,2014-10-28 16:04:46,2014-10-28 16:04:46
bf07fcf06ad7a5d2fd5f25079ce9e16d003481c7...d9023da90d3d723bcb9ba372b0b89a8747aca6af,1,10,14,24,3,2014-10-28 17:48:20,2014-10-28 17:48:20
70004f4ef6160e788e6a600b9da06608c8559aa2...593a1b3b3ec41ef78465e1dc2078d7d6dbae186f,4,50,17,67,8,2014-10-07 12:11:18,2014-10-07 12:11:18
70004f4ef6160e788e6a600b9da06608c8559aa2...7dcbf350197de169f3ca85b730c852e14c8feaa2,8,22,14,36,14,2014-10-07 11:16:19,2014-10-07 11:16:19
70004f4ef6160e788e6a600b9da06608c8559aa2...fd8d1d9b62066766c96610b7d42b20fa0e84b0ac,7,14,14,28,11,2014-10-07 08:54:00,2014-10-07 08:54:00
70004f4ef6160e788e6a600b9da06608c8559aa2...f4efb19038d01225374c91cca9274cce3d728b3d,2,21,0,21,2,2014-10-07 08:04:09,2014-10-06 21:37:27
70004f4ef6160e788e6a600b9da06608c8559aa2...2aa2d268fd83e318263a2b93aae4f0db3210ef38,1,1,1,2,1,2014-10-06 16:30:25,2014-10-06 16:30:25
70004f4ef6160e788e6a600b9da06608c8559aa2...014eeb2e0bf6ec8c969e1b188b9085b5e4166b5f,1,1,1,2,1,2014-10-06 16:27:38,2014-10-06 16:27:38
70004f4ef6160e788e6a600b9da06608c8559aa2...897d69d6d5b88c964a94742d291d2d3a6e5b56c3,1,1,1,2,1,2014-10-06 16:26:40,2014-10-06 16:26:40
3ed8fbce2a8ee80e549256ab9c3f48c4d6837d9e...b752ee8aa93ead6d9e39219444a20761d9f01de5,1,47,0,47,1,2014-08-21 14:02:04,2014-08-21 13:51:31
3ed8fbce2a8ee80e549256ab9c3f48c4d6837d9e...274ca09024c48d698b84e34ed8fbe01680190605,2,17,5,22,6,2014-08-21 11:59:04,2014-08-21 11:59:04
f932996e10deccb2fba97af90b9ac336391fcf87...93f15a49537a47e6a1dead5cec8553b974cd464d,1,1,1,2,1,2014-09-03 19:57:32,2014-09-03 19:57:32
bf0de1a500e7a9aecc7c8bbf623ad39b75c6433b...2c047642f5afd68faaafa39385d5b2c29de7ea1e,1,1,1,2,2,2014-09-11 10:59:42,2014-09-11 10:59:42
8b1fe5f4ff1ca0ef975331a8508b51ba4df8e6c9...c8c2b49dfb327f1bde09f11d8301a63a613b6027,1,1,8,9,4,2014-08-24 20:31:25,2014-08-24 20:31:25
f2befb6934214ec8d24459df84efc39c33e533a1...02ee3a53a0df043093b97ab06d5ae35c291d89d2,1,1,1,2,1,2014-08-29 16:50:44,2014-08-29 16:50:44
f2befb6934214ec8d24459df84efc39c33e533a1...09f83de297dc11b6572e26ec4e063c05fd668b22,1,3,0,3,2,2014-08-29 16:44:56,2014-08-29 16:44:56
f2942ffee0f34e3b48e89d5047b9328e1693e370...672daff56c6bb5c6eeeb5d34a2f4ed83dc0ec201,1,1,0,1,1,2014-08-21 10:28:45,2014-08-21 10:28:45
e0e88cddd805a1aa5f467dcea826c24a64187df0...8bbb5628c41dce8f68ed9cf187b681eb06c51c53,1,1,1,2,1,2013-09-15 19:46:32,2013-09-15 19:46:06
d28ee0df124d79e9d0968c3325ae010b55d4a7b6...a6da154ed3b91394d071e903ee578c7ab243afd1,2,2,2,4,2,2014-01-05 20:12:03,2014-01-05 20:12:03
a6da154ed3b91394d071e903ee578c7ab243afd1...2ee8d5aa4321f7ed28c207dbcd2efb5495636d0d,3,19,15,34,7,2014-01-06 12:05:39,2014-01-06 12:05:39
2ee8d5aa4321f7ed28c207dbcd2efb5495636d0d...7399c8c928f163ffa48ff166457affc88796fc6e,1,3,0,3,1,2014-01-06 12:19:08,2014-01-06 12:19:08
7399c8c928f163ffa48ff166457affc88796fc6e...0b017e8e1782d00da87e4d5b090ee7b37dca3c65,6,8,8,16,8,2014-01-06 12:19:25,2014-01-06 12:19:25
0b017e8e1782d00da87e4d5b090ee7b37dca3c65...8f85c5cdd58c122e5c59dbb2527535b438e3e9b5,4,10,2,12,4,2014-01-06 12:34:41,2014-01-06 12:34:41
8f85c5cdd58c122e5c59dbb2527535b438e3e9b5...b62d4f6dca1875e7daa3cd833ecb0c7293ac0b48,1,45,0,45,1,2014-01-06 13:05:41,2014-01-06 13:05:41
b62d4f6dca1875e7daa3cd833ecb0c7293ac0b48...d187ffebee8170877df9a99ec995ffd81aac2201,2,31,40,71,12,2014-01-06 13:05:57,2014-01-06 13:05:57
d28ee0df124d79e9d0968c3325ae010b55d4a7b6...0e61011499b02cbe2fa201409cddf03fc03cd7a6,1,1,1,2,1,2014-01-05 12:58:06,2014-01-05 12:58:06
ff7055eef30ac6e770166728443c22b88e07f561...2b8b060236535d3abe27d705be97523b0816da67,2,5,4,9,3,2015-01-26 23:15:51,2015-01-26 23:15:51
ff7055eef30ac6e770166728443c22b88e07f561...3e47ea5064f7e93cadb0ef347dfa27517552a4a0,2,21,10,31,7,2015-01-26 21:31:24,2015-01-26 21:31:20
3e47ea5064f7e93cadb0ef347dfa27517552a4a0...6a2384e0bc7d0b703c8f6af144c85af47eae6630,2,16,0,16,2,2015-01-26 21:37:18,2015-01-26 21:37:18
e19c1f71d3a6d6b5be638c4f1fb5c9d2401e04be...3503b504eabf95487fc3fb49df953a7d694da4fe,2,26,1,27,3,2014-09-14 14:18:58,2014-09-14 14:18:58
3503b504eabf95487fc3fb49df953a7d694da4fe...757426dbb18b5c62670b6090d6fed25fc71528a1,2,33,0,33,2,2014-09-14 14:54:10,2014-09-14 14:54:10
757426dbb18b5c62670b6090d6fed25fc71528a1...e9b32005ebaa432f0fb40d3c87f9d0bf9b109db9,2,32,1,33,2,2014-09-14 15:09:23,2014-09-14 15:09:23
e9b32005ebaa432f0fb40d3c87f9d0bf9b109db9...eb4a9bfbca5427e6b9a8fcf2ed0b1f9f96ae099d,2,4,0,4,2,2014-09-14 15:09:33,2014-09-14 15:09:33
29f990002c6e2704bb25ba4aa89491f319699202...5564fe31491a8a584b66feb6097742ec4025b8fa,4,44,15,59,13,2014-09-12 16:44:53,2014-09-12 16:43:44
5564fe31491a8a584b66feb6097742ec4025b8fa...e84861d510af63969a7ca09e4248426faf2dd345,3,16,17,33,10,2014-09-12 17:41:32,2014-09-12 17:40:04
e84861d510af63969a7ca09e4248426faf2dd345...9945e8c4244d90a0481846454355e02e80369aa2,2,22,14,36,5,2014-09-12 17:51:44,2014-09-12 17:51:44
9945e8c4244d90a0481846454355e02e80369aa2...75fbca83e36100b1e2ab2416c8906d6e5b805231,2,20,0,20,2,2014-09-12 18:12:31,2014-09-12 18:12:31
75fbca83e36100b1e2ab2416c8906d6e5b805231...9b59570c8ee9bfa39c64531ea4cc12b46ff99f9e,1,27,26,53,1,2014-09-12 19:02:50,2014-09-12 19:02:50
83e5211a1d3036d773a816f82b0fbd59e21e561d...11eec88d97b206d0bcb75d81d5910469f0de6c87,2,5,4,9,2,2014-09-10 14:46:10,2014-09-10 14:46:10
1f3261ac414ce42e5bbb6d5e0891e2cb5483dace...d4e7db40829a9ece62ead4d98380b36c2707c556,1,14,0,14,1,2014-07-10 06:36:28,2014-07-09 10:52:58
d4e7db40829a9ece62ead4d98380b36c2707c556...0f80ffdf8756a76a6ea0daaa2da5d3e193fcbe99,1,1,3,4,2,2014-07-10 06:37:51,2014-07-10 06:37:51
0f80ffdf8756a76a6ea0daaa2da5d3e193fcbe99...4a505f38acdefe1ee023dcdd773385bf7b7270bb,2,12,2,14,4,2014-07-10 06:46:52,2014-07-10 06:46:52
1f3261ac414ce42e5bbb6d5e0891e2cb5483dace...0b1cf50060de0d0a3039dfb2fca47364c7fb5f82,2,2,1,3,2,2014-07-09 22:16:24,2014-07-09 18:45:13
1f3261ac414ce42e5bbb6d5e0891e2cb5483dace...a40ec4ead1088f5bd5870f25a90b627138ab75f4,1,1,1,2,2,2014-07-09 18:46:37,2014-07-09 18:46:37
9a2fec52732e7c6a91a26f1f6e5bcb1e1a70f55f...4dcf2f1c2dca266743f66056a382afe0002a7d3e,1,6,0,6,1,2014-06-07 12:55:31,2014-06-07 12:55:31
92ccc687b0154a129cad0b899e639e60c886ddff...afe47e26f5961c5578ef28a79c7dc0ca43db76dd,4,10,3,13,6,2014-06-12 19:58:59,2014-06-12 19:58:59
1bde927750b60d17334e188b70959059f3b00060...6c6cdd23ff8241fd2f8c52143f102c9b914f5233,1,1,1,2,1,2014-06-12 19:24:19,2014-06-12 19:24:19
ec18f0bae557c6368c4ac211041a81bfe05492e8...a54735613324cd0501e90c4744a698c46cfdc128,1,1,0,1,1,2014-08-02 01:54:39,2014-08-02 01:54:39
ec18f0bae557c6368c4ac211041a81bfe05492e8...4a36d669b5cb9c4727e82e68dd3a573f5cb1f53f,2,7,3,10,4,2014-08-01 10:29:23,2014-04-16 02:14:05
4a36d669b5cb9c4727e82e68dd3a573f5cb1f53f...d048a27771c9e6916083b074d254c708fd78d508,1,2,1,3,1,2014-08-01 10:41:09,2014-04-16 02:14:05
f8eedb4cdac6423a038c80d39d70ad1db17d3da5...3cc2c6ef79c8b6f511af32c40a336bc8bfc4c2fe,1,0,21,21,1,2014-08-11 13:01:07,2014-08-11 13:01:07
3cc2c6ef79c8b6f511af32c40a336bc8bfc4c2fe...2804902cfce28859fbed96e1d9de1d12964800ee,9,123,148,271,17,2014-08-11 14:55:31,2014-08-11 14:55:31
c0bb3f5af200a457cd375b455528578d1c459e40...4adcd5113386e30edb7993f36bb009f472b36262,1,6,33,39,5,2014-10-03 18:44:16,2014-10-03 18:44:16
4adcd5113386e30edb7993f36bb009f472b36262...b2a45a1d35254a8142c7e0c9c511615db2228097,1,1,1,2,1,2014-10-03 19:01:23,2014-10-03 19:01:23
c0bb3f5af200a457cd375b455528578d1c459e40...1b1ba6b0a51cda30df2fe68fa577f6045d187b86,4,166,31,197,23,2014-10-03 17:30:20,2014-10-01 15:31:13
1b1ba6b0a51cda30df2fe68fa577f6045d187b86...7edc1439fe11e396bb6327a3f50aca5dfe3c411c,2,6,4,10,3,2014-10-03 17:30:20,2014-10-01 18:45:26
7edc1439fe11e396bb6327a3f50aca5dfe3c411c...2c46c4523fc8aa41cb60e4840af16fdd595f7dd2,4,62,46,108,24,2014-10-03 17:30:20,2014-10-02 18:26:39
2c46c4523fc8aa41cb60e4840af16fdd595f7dd2...088987e2dd4b7ad8d62ebd34448dbe194df7812d,5,120,15,135,18,2014-10-03 17:30:20,2014-10-03 05:48:35
088987e2dd4b7ad8d62ebd34448dbe194df7812d...bcf88c85597d8a40a209f4aa24cd6015f66d97c6,1,4,3,7,3,2014-10-05 15:12:53,2014-10-05 15:12:53
bcf88c85597d8a40a209f4aa24cd6015f66d97c6...a9cd3bfaeefcdc9eee594aeca062bb9f0663aaf1,1,1,0,1,1,2014-10-05 15:16:12,2014-10-05 15:16:12
a9cd3bfaeefcdc9eee594aeca062bb9f0663aaf1...8dce0cd215b657d11b3e183e361fc86ae9314ecd,1,3,1,4,1,2014-10-05 15:46:52,2014-10-05 15:46:52
630d042433e0cecffe80aa5ebd7aa7a91c5eb2d8...b9f0508732a70a50e48c460365d7eeee059cc7c0,1,4,2,6,2,2014-09-19 19:38:12,2014-09-19 19:33:03
630d042433e0cecffe80aa5ebd7aa7a91c5eb2d8...175a913065ea1a3ccdf89c2d94a870a61db30aa9,2,33,0,33,2,2014-09-18 13:45:18,2014-09-18 13:45:18
175a913065ea1a3ccdf89c2d94a870a61db30aa9...c0cecdb08afe4262019428290ed231f0040aa547,1,2,1,3,1,2014-09-18 15:14:40,2014-09-18 15:14:40
630d042433e0cecffe80aa5ebd7aa7a91c5eb2d8...28ee311d0cb03cf185154a4249190258ee25b3d8,1,0,6,6,1,2014-09-18 03:01:25,2014-09-18 03:01:25
2aeac794c2deb74043a74b263c4f4fc5d8a849a3...4ed5a506be313f3a19293df484c551b80ef4d5bf,1,2,2,4,1,2014-09-25 07:38:17,2014-09-25 07:36:01
2aeac794c2deb74043a74b263c4f4fc5d8a849a3...05b535e1c0308f7aa8cd81f03e8cb872e27e56f1,1,1,0,1,1,2014-09-24 19:59:26,2014-09-24 19:59:26
b82d4018b85829b5dbb2b0a0bdfad960e78c4f8f...71fce0b2f82fa4c6dea4fef4c0672514a00ec72c,1,14,12,26,1,2014-10-02 14:49:11,2014-10-02 14:49:11
b82d4018b85829b5dbb2b0a0bdfad960e78c4f8f...c41805f60e6b0fe97ca545a1ac99cbb1e0406100,2,25,0,25,2,2014-10-02 14:14:42,2014-10-02 14:14:42
c41805f60e6b0fe97ca545a1ac99cbb1e0406100...929678899d462e4a43f66c256621144ea65ff630,1,1,1,2,1,2014-10-02 14:15:09,2014-10-02 14:15:09
cc42edfa495703877143abc98c1b6dbf6862aa55...250d582bdd40e25f0aa16c76fc7a6ff31b113c22,1,1,1,2,2,2014-10-24 19:28:02,2014-10-24 18:48:01
d7c50b4a95b5530ae0e2f5249cfd9a419dd940c6...3246ed514fac233ba9aa9ab86e08336225d40150,1,2,2,4,2,2014-11-05 09:44:40,2014-11-05 09:44:40
3246ed514fac233ba9aa9ab86e08336225d40150...4a41d4b7d246c4e5f9a9062c7dd417510b0bae0c,1,2,2,4,2,2014-11-05 14:21:35,2014-11-05 14:21:35
d7c50b4a95b5530ae0e2f5249cfd9a419dd940c6...5f682094d9b7c985ad62ebe29664bb6fe87b54be,3,6,1,7,5,2014-11-03 22:37:13,2014-06-18 17:49:39
d7c50b4a95b5530ae0e2f5249cfd9a419dd940c6...e3098b69e7a4bc8b08bd85093204305991d8370d,2,6,3,9,3,2014-11-03 14:25:31,2014-11-03 14:25:31
e1299bab7b1c275c145669a1a0eff2928511ecb4...6cb5d3d2d4c88183a79c2587d7d1bcc4797c406e,2,2,0,2,2,2014-10-30 12:44:46,2014-10-30 12:44:29
51ed8b7edd119897a4a0b2f5948d049dfc8691a4...48bc9e36235e2348eae77be461863b78896fdcf7,1,2,1,3,1,2014-10-08 13:00:47,2014-10-07 16:50:13
51ed8b7edd119897a4a0b2f5948d049dfc8691a4...166c215a75b50ce62fd40297f52e366df7dc9103,5,21,22,43,6,2014-10-08 08:01:07,2014-10-02 22:13:23
51ed8b7edd119897a4a0b2f5948d049dfc8691a4...68b5ac7f185b9b30cd862eacf806db726d8ce6e4,5,38,8,46,9,2014-10-07 20:21:00,2014-10-07 19:55:15
68b5ac7f185b9b30cd862eacf806db726d8ce6e4...41518a467dcef61deca24ad2f6205c6fd5706e1b,4,7,27,34,7,2014-10-23 02:08:19,2014-10-23 02:08:19
c0306f78d2686202aa56cf862a7c787d07c85d1a...8fad7e63a3eac7e88026d82cf7fa3696a3cb379b,1,2,2,4,2,2014-10-07 12:22:55,2014-10-07 12:22:33
d790b2cbb814a429268361cf6f3198e7ffb938d8...0084b8a7763b04f432579e5a19ce0c6a06136b03,1,4,1,5,1,2014-10-07 02:42:07,2014-10-07 02:42:07
b5cc8136127326b953663abda962985d111fa250...37d62938425f912d8f38c24e064b04f5abba075c,2,2,1,3,2,2014-08-26 09:33:26,2014-08-22 10:51:47
b5cc8136127326b953663abda962985d111fa250...99b81be88777fddfc497b50789f9e185b9c0cd71,2,2,0,2,2,2014-08-26 08:58:16,2014-08-26 08:58:16
b5cc8136127326b953663abda962985d111fa250...207d798dc4b82da319d962b4ce0ec2111e79ba31,4,126,63,189,14,2014-08-26 08:30:14,2014-08-15 08:14:58
207d798dc4b82da319d962b4ce0ec2111e79ba31...a7dcf690fb2fd670ecbbd20f7105d394f0b175a2,7,29,28,57,14,2014-08-26 08:30:14,2014-08-15 13:29:25
a7dcf690fb2fd670ecbbd20f7105d394f0b175a2...04a87cb5c475b4ffcb5670e6fe83667a30763256,3,6,4,10,6,2014-08-26 08:30:15,2014-08-26 07:05:08
b5cc8136127326b953663abda962985d111fa250...075e5eeccb91b742c7209dd3668ec9d28e4d0ea1,1,10,13,23,4,2014-08-26 08:04:57,2014-08-26 08:04:57
075e5eeccb91b742c7209dd3668ec9d28e4d0ea1...099e17038fb71739ec2c7d785cfccb069305b439,1,1,0,1,1,2014-08-26 08:20:55,2014-08-26 08:20:55
b5cc8136127326b953663abda962985d111fa250...1646009724406cd36975f1d25cdb8cfb3a6f7832,4,7,7,14,5,2014-08-26 04:10:53,2014-08-26 04:10:53
85cf0633fbd3090c83fc51ef57d58f07bdaebb94...bfaf3a79a9515e9c578ae9952e720f6f62e97780,1,1,1,2,1,2014-08-21 14:44:39,2014-08-21 14:44:39
93f15a49537a47e6a1dead5cec8553b974cd464d...36c3e2cc624ae4c3b66d58d6b2968457bc4f3011,1,2,0,2,1,2014-09-04 07:00:04,2014-09-04 07:00:04
36c3e2cc624ae4c3b66d58d6b2968457bc4f3011...d62e89ba052fb1fe50d6c01f0b7517c9295c2b59,1,1,1,2,1,2014-09-04 07:25:48,2014-09-04 07:25:48
80174c16d6e28f751e6afc59f9ba28f8c6b792fc...09cdd94322d078b44d1eeddb6fbd67a889bed1c3,2,8,2,10,4,2014-09-11 23:41:03,2014-09-11 15:48:29
a25e6f725a6b31db6a9a327cc5cd51a078caef03...f8182183599e8fd3ccf9d7d3741ecbf966d8c853,1,8,0,8,1,2014-08-25 06:52:31,2014-08-25 06:52:31
a25e6f725a6b31db6a9a327cc5cd51a078caef03...92160789aa2134a582211efeb0fd1a3034e4ca0f,1,5,0,5,1,2014-08-25 06:47:19,2014-08-25 06:47:19
a25e6f725a6b31db6a9a327cc5cd51a078caef03...c1eee5968f9750ceaf33bcc7402899ed7bfd7b86,1,1,1,2,1,2014-08-25 05:42:46,2014-08-25 05:42:46
48d8f993c3667ef829936a6c4605af3b08c4bdde...5317c26cf75ef07ce21979ea4d3eb63f478fe242,1,1,1,2,1,2014-08-29 17:35:04,2014-08-29 17:35:04
f9814bf28831aeef746cfdc35431c8de45ff7677...c10f61802be9d9059b64386cca6bfc3b07beb0b1,2,4,0,4,2,2014-11-14 11:22:22,2014-11-11 15:59:50
f9814bf28831aeef746cfdc35431c8de45ff7677...a9dc2c202938863896ca2de55dc301c655285b93,2,3,3,6,3,2014-11-14 11:14:17,2014-11-14 11:14:17
f9814bf28831aeef746cfdc35431c8de45ff7677...de3bef058ee16aae0f29802e39c3af24c5b79790,1,2,1,3,1,2014-11-14 10:47:08,2014-11-14 10:47:08
f9814bf28831aeef746cfdc35431c8de45ff7677...e4a38e447169069f3d5042d3341ceb4bdc51bf1b,5,5,8,13,7,2014-11-05 16:51:49,2014-11-05 16:51:08
f9814bf28831aeef746cfdc35431c8de45ff7677...383ac10ca5797818f7a61d04fbff0fbf54e87c0e,1,2,2,4,1,2014-11-05 16:28:59,2014-08-27 16:20:28
f9814bf28831aeef746cfdc35431c8de45ff7677...586590d20ed7e47465460c0fbcd0df1b9ea45afc,1,0,4,4,1,2014-11-05 16:24:20,2014-11-05 16:24:20
f9814bf28831aeef746cfdc35431c8de45ff7677...f36db59d97b375744ee1c05d07792a8d64ae945b,3,11,8,19,6,2014-11-05 16:16:04,2014-11-05 16:14:22
f9814bf28831aeef746cfdc35431c8de45ff7677...98db90c4c9f33d16f496ebb5fe589d6312f136c4,2,4,8,12,4,2014-11-05 14:49:35,2014-11-05 14:45:54
b1433228a5d539077275854ca9553720a0c55c02...7f8460159fbd1e0168de56a10c0f7fd8e7556693,1,2,2,4,2,2014-08-21 08:49:12,2014-08-21 08:49:12
2d31a9f345fd84fc65cac9b429a907e96b4e18b7...a3ef683108a7af10bb63342db429a47ffc5abea4,8,19,26,45,11,2013-09-17 14:05:42,2013-09-17 13:12:10
2d31a9f345fd84fc65cac9b429a907e96b4e18b7...9c629a1ebc642bfeec9f8cc7379613b1acf7817b,3,4,4,8,4,2013-09-16 10:33:34,2013-09-16 10:33:34
9c629a1ebc642bfeec9f8cc7379613b1acf7817b...16b6040c2e810253b29bfed4df5fcd098c456813,1,2,2,4,2,2013-09-16 11:04:22,2013-09-16 11:04:22
d187ffebee8170877df9a99ec995ffd81aac2201...92cb78749534567d9480e1753ca4fdb0cced3b39,1,5,3,8,2,2014-01-06 13:58:10,2014-01-06 13:58:10
d187ffebee8170877df9a99ec995ffd81aac2201...54ddca5c4e93f4359b2c6b9ed81291b0c9f13470,1,2,4,6,2,2014-01-06 13:12:30,2014-01-06 13:12:30
6a2384e0bc7d0b703c8f6af144c85af47eae6630...c916124178645412a554a6b8b39c05bbd42269c8,7,12,15,27,9,2015-01-26 23:01:51,2015-01-26 23:01:51
c916124178645412a554a6b8b39c05bbd42269c8...59b08942aa3de480899f32f1a6f2f948329ae3fc,4,93,92,185,11,2015-01-26 23:02:28,2015-01-26 23:02:28
59b08942aa3de480899f32f1a6f2f948329ae3fc...e07da5989f5ae14dddc130b80210342ca776e6d2,1,8,5,13,4,2015-01-26 23:02:59,2015-01-26 23:02:59
e07da5989f5ae14dddc130b80210342ca776e6d2...21297e78afd5ddfbfdf62f471acf1ab2f0c2a892,3,43,39,82,4,2015-01-26 23:03:14,2015-01-26 23:03:14
21297e78afd5ddfbfdf62f471acf1ab2f0c2a892...752cb506c033c281064abb56093c41a7dac2735a,5,11,6,17,6,2015-01-26 23:03:30,2015-01-26 23:03:30
752cb506c033c281064abb56093c41a7dac2735a...ed9137862773c8cd242e16a7945cf18a0b2e1ff9,2,4,4,8,4,2015-01-26 23:12:13,2015-01-26 23:12:13
ed9137862773c8cd242e16a7945cf18a0b2e1ff9...90ba3a385cda545a58b3bb7893898bc16e982a73,2,6,10,16,5,2015-01-27 00:08:59,2015-01-27 00:08:59
90ba3a385cda545a58b3bb7893898bc16e982a73...ed8c3e2d738312c09e336fb8d549eea7d9cc71b9,1,1,1,2,1,2015-01-27 00:10:34,2015-01-27 00:10:34
eb4a9bfbca5427e6b9a8fcf2ed0b1f9f96ae099d...c69b8e04591907d030b2cd544a606fd0e576116a,62,392,470,862,164,2014-09-14 16:32:51,2014-09-14 16:32:51
c69b8e04591907d030b2cd544a606fd0e576116a...8210d813812571b479d630ff61410347f8ebeb5b,17,26,26,52,24,2014-09-14 16:51:54,2014-09-14 16:51:54
8210d813812571b479d630ff61410347f8ebeb5b...13af7de9411ef20fcab00f7c5d7cdc6b90dbd4b7,9,56,60,116,12,2014-09-14 17:38:57,2014-09-14 17:38:57
13af7de9411ef20fcab00f7c5d7cdc6b90dbd4b7...1aa48174db63871bb10b53e49c86222a4d9b7c6d,9,12,10,22,12,2014-09-14 18:52:54,2014-09-14 18:52:54
1aa48174db63871bb10b53e49c86222a4d9b7c6d...bdbadebe3e6e25180d8c1465dde4573fa0ecc389,20,63,63,126,43,2014-09-15 07:57:02,2014-09-15 07:57:02
bdbadebe3e6e25180d8c1465dde4573fa0ecc389...39ab7527d41c2351b82398947307f3d668f06944,3,3,3,6,3,2014-09-15 08:04:25,2014-09-15 08:04:25
39ab7527d41c2351b82398947307f3d668f06944...38ed0deaac78f74cf983caf2f607956c1b2dcf83,5,1,0,1,1,2014-09-15 08:31:30,2014-09-15 08:31:30
38ed0deaac78f74cf983caf2f607956c1b2dcf83...77c64a9b361a35cfdb7d93c92c5ecc94a8d1aa08,10,32,32,64,20,2014-09-15 08:36:50,2014-09-15 08:36:50
77c64a9b361a35cfdb7d93c92c5ecc94a8d1aa08...ce49f035cfccc9cb2e86b986b8a69b18fcc9cadc,3,11,8,19,7,2014-09-15 08:55:36,2014-09-15 08:55:36
ce49f035cfccc9cb2e86b986b8a69b18fcc9cadc...6558e52d904daa9f710192e838fdb7872b1682e2,1,2,2,4,1,2014-09-15 09:01:45,2014-09-15 09:01:45
6558e52d904daa9f710192e838fdb7872b1682e2...4f1bb91a75111188ce52e8fde1c3ac0acfff452e,6,6,6,12,6,2014-09-15 13:45:28,2014-09-15 13:45:28
78ec7d9c9d156fe556d165c1c096bf5534d62d25...412780cc600f2329e078bf8b3bd6006fb7c8874a,1,1,1,2,2,2014-09-11 11:12:20,2014-09-11 11:12:20
78ec7d9c9d156fe556d165c1c096bf5534d62d25...7a6857adfba9a6c0db3b64c7bb5968d88a17c8b0,1,1,1,2,1,2014-09-11 08:43:00,2014-09-11 08:43:00
4fb5a39dc04822f1cfac1090a431e51fb43e7a07...53a8d50b2b1db9addf0f5fbcfa56db0fcc811073,2,12,3,15,4,2014-07-10 08:09:00,2014-07-10 08:09:00
8ecbfe3dc999dd26796a193f71ef9c802a320ddf...25c9bf4b6a637c028f29dc36338d4c5ac8c8376c,1,1,3,4,2,2014-07-14 07:02:46,2014-07-14 07:02:46
a019b49a2b23f1853bf315b2fa6a803e8a05c011...1218a5e630f7ca6d1f1bb58d1ad1fef0974c70ad,1,1,1,2,1,2014-07-10 21:07:20,2014-07-10 21:07:20
a5cbb4cb82a6911b5c1de117ae6ed4cbf667a679...8ec02ed9aa36160bd19155cef1f71ca7e12ad4f3,3,29,24,53,14,2014-06-14 10:05:25,2014-06-14 10:05:25
a5cbb4cb82a6911b5c1de117ae6ed4cbf667a679...8b6dd9d4a802eeba5fa4f7e10d738a2af5e87d98,7,74,1,75,9,2014-06-14 09:17:11,2014-06-14 09:17:11
8b6dd9d4a802eeba5fa4f7e10d738a2af5e87d98...d718209b47022abe8a28a7267cd40569bd7ec06a,3,7,7,14,9,2014-06-14 09:18:00,2014-06-14 09:18:00
d718209b47022abe8a28a7267cd40569bd7ec06a...9c843041faf000a76bd2b542f594c061dab45c3a,12,47,11,58,15,2014-06-14 12:32:41,2014-06-14 12:32:41
a5cbb4cb82a6911b5c1de117ae6ed4cbf667a679...1355ede49d02e2a7b1715a3ed6bd7389bfedf6bc,31,7,375,382,43,2014-06-13 11:24:54,2014-06-13 11:24:54
1355ede49d02e2a7b1715a3ed6bd7389bfedf6bc...d593c98fcbd34789068a72c9386f69a152107139,12,0,155,155,17,2014-06-13 11:29:26,2014-06-13 11:29:26
a5cbb4cb82a6911b5c1de117ae6ed4cbf667a679...45e1941fb3acf8fdc0544842ce503de007e3c706,5,12,6,18,6,2014-06-13 10:14:43,2014-05-23 13:16:03
45e1941fb3acf8fdc0544842ce503de007e3c706...87760a290eddbc35f4e89b129da6ec842a70f609,3,37,4,41,4,2014-06-13 10:34:15,2014-06-13 10:34:15
87760a290eddbc35f4e89b129da6ec842a70f609...8880c55a1ee35877abd7229e65b359116e33b5d1,1,1,1,2,1,2014-06-14 07:27:11,2014-06-14 07:27:11
a5cbb4cb82a6911b5c1de117ae6ed4cbf667a679...8761dd2a6fb2e19556fbfaa30ab211c1f09f3e29,2,10,1,11,2,2014-06-13 06:14:34,2014-06-12 14:01:23
2c77dae2d7cee9917e9d2664d2f84749ef821e91...4535db04b28996baf118bafeb77acd16065e5c5a,2,2,2,4,2,2014-08-11 17:58:39,2014-08-11 17:58:39
ac71c386f98fa9b88381abbf9d20e79f57bd7957...9bebacd69260b7106bcee42ad7317c7f9c5c5525,6,44,69,113,8,2014-10-05 22:14:46,2014-10-04 15:09:06
ac71c386f98fa9b88381abbf9d20e79f57bd7957...fa34901237cc244fe8b828d079af891e63de1c8f,60,56,56,112,56,2014-10-05 16:21:11,2014-10-02 16:42:54
ac71c386f98fa9b88381abbf9d20e79f57bd7957...07e9cb6b77b35ed92d0d9a8e5bcdf92884024dbf,3,6,2,8,3,2014-10-04 15:56:12,2014-10-04 15:56:12
ac71c386f98fa9b88381abbf9d20e79f57bd7957...c0e2eee38bc0315a623219d716c724a7e4c98c77,5,11,11,22,11,2014-10-04 14:58:59,2014-10-04 14:58:59
ac71c386f98fa9b88381abbf9d20e79f57bd7957...84fbd2935197c545703541e24d453f6e723293bf,1,9,11,20,7,2014-10-04 10:29:24,2014-10-04 09:44:20
d8b8be440939c6e7ed2a4118dc0708d33ac94972...db2bb8c304a4bf93b8f01c8bbdd44e0c9b9837a0,1,27,19,46,5,2014-09-19 11:23:53,2014-09-19 11:23:53
01c101752da95b4d4d0caf4f36fd9f6aa87a272f...c36b06e46857bfa16e4f110c592951736cf486af,1,1,0,1,1,2014-09-18 15:21:20,2014-09-18 15:21:20
01c101752da95b4d4d0caf4f36fd9f6aa87a272f...ff4a45effb49b5935ba46ca0f17221062bd28d52,2,9,0,9,2,2014-09-18 07:41:38,2014-09-18 07:41:38
ff4a45effb49b5935ba46ca0f17221062bd28d52...664b433afef12b12d93fac078826ad6fc7c492f5,1,1,0,1,1,2014-09-18 07:44:12,2014-09-18 07:44:12
9cd5ff043a72001201b4c8192a45f8029ebe84ac...390183a4269684f64e2e290869bee21cf18bf160,5,35,35,70,14,2014-09-25 23:32:33,2014-09-01 15:47:28
fabe282873382cfc40dbab6b23f138cc6c44f250...aaaf2bd9531a5ba614a77d05c3945eee328e8e14,2,3,3,6,3,2014-09-26 07:30:38,2014-09-26 07:30:38
71fce0b2f82fa4c6dea4fef4c0672514a00ec72c...97c5d38097a6308c31e0e5f9afaef719d5080b5f,1,6,0,6,1,2014-10-02 16:27:18,2014-10-02 16:27:18
71fce0b2f82fa4c6dea4fef4c0672514a00ec72c...8e33f9460c6f98df089eb367b96d9a1fc91c5d52,4,37,5,42,6,2014-10-02 15:17:47,2014-10-02 15:17:47
28b6f09fcc1ea50c44e942ed6c342a42bdf12dc4...d3dbd353ccebb753e7791643312795ae27bb4c9d,1,2,0,2,1,2014-09-24 10:48:33,2014-09-24 10:48:33
d3dbd353ccebb753e7791643312795ae27bb4c9d...18adc4f67ddee72141ec9be5ebbe3923ec4f41e4,1,1,1,2,1,2014-09-25 11:09:46,2014-09-25 11:09:46
18adc4f67ddee72141ec9be5ebbe3923ec4f41e4...b874cb21ebf9653a0a15a43838bbb2ac5d37aaff,1,3,2,5,1,2014-09-25 15:23:06,2014-09-25 15:23:06
b874cb21ebf9653a0a15a43838bbb2ac5d37aaff...d5dc171cb7e04a1a513dca044578e95d52706a84,1,1,1,2,1,2014-09-25 15:23:40,2014-09-25 15:23:40
d5dc171cb7e04a1a513dca044578e95d52706a84...16a6d2450b5a5839c69c9d2365244f59bd17f1ac,1,1,1,2,1,2014-09-25 15:24:56,2014-09-25 15:24:56
16a6d2450b5a5839c69c9d2365244f59bd17f1ac...99e5e6db73379190f2025daafe4bb5490f4bb360,1,0,1,1,1,2014-09-25 15:34:11,2014-09-25 15:34:11
28b6f09fcc1ea50c44e942ed6c342a42bdf12dc4...53f2130e63b2d20a9c3f6f709f38b70cb27a63ab,3,16,10,26,6,2014-09-24 10:26:53,2014-09-24 10:26:53
53f2130e63b2d20a9c3f6f709f38b70cb27a63ab...13aec95264541b274d5ed9b828b44860cde93dec,3,5,4,9,3,2014-09-24 12:59:57,2014-09-24 12:59:57
13aec95264541b274d5ed9b828b44860cde93dec...3695ae185b7073f363335d41ba3d6317a63c0739,3,9,4,13,6,2014-09-25 09:19:26,2014-09-25 09:19:26
3695ae185b7073f363335d41ba3d6317a63c0739...b13c1469a317a36a72e87fa92972e440fc8438e5,2,2,2,4,2,2014-09-25 09:46:30,2014-09-25 09:46:30
b13c1469a317a36a72e87fa92972e440fc8438e5...4b65b0e0f5804492e90c3ee8037739c47bcc354b,9,40,23,63,16,2014-09-25 10:56:23,2014-09-25 10:56:23
4b65b0e0f5804492e90c3ee8037739c47bcc354b...424b42d6e9a988c7c0384ac49bf0ca6a344febc1,1,2,2,4,2,2014-09-25 12:01:02,2014-09-25 12:01:02
424b42d6e9a988c7c0384ac49bf0ca6a344febc1...3a106cbcd3304ec20d936a9f3e2ec18715553d49,1,1,1,2,1,2014-09-25 12:06:41,2014-09-25 12:06:41
3a106cbcd3304ec20d936a9f3e2ec18715553d49...619c81b4884ecfc33486007dd5e5324b08c0b0a8,4,5,11,16,4,2014-09-25 12:26:35,2014-09-25 12:26:35
619c81b4884ecfc33486007dd5e5324b08c0b0a8...3bf316dbd9b4c555ef9b21f43d56c7d7309766d7,3,3,3,6,3,2014-09-25 13:10:03,2014-09-25 13:10:03
3bf316dbd9b4c555ef9b21f43d56c7d7309766d7...66ef5c1aa2f50b93ad654dc3b8d9f3a0f5c8bc1b,1,14,8,22,4,2014-09-25 13:10:10,2014-09-25 13:10:10
66ef5c1aa2f50b93ad654dc3b8d9f3a0f5c8bc1b...eaeb4a90d431ff5e1e6156c10f3118f70c3c4f8e,3,4,4,8,4,2014-09-25 13:22:08,2014-09-25 13:22:08
6280b53f305e45d0e6c474dbcf684f0015aee385...40c8f159a24b661e9f27dfcde492c4d2a6bbfbe2,3,14,1,15,4,2014-10-27 09:51:31,2014-10-27 09:51:31
6280b53f305e45d0e6c474dbcf684f0015aee385...d7476123852a7164b63e097b4aac73b04d1eca5c,1,10,0,10,4,2014-10-27 08:20:43,2014-10-27 08:20:43
d7476123852a7164b63e097b4aac73b04d1eca5c...93532432dce129e9075ffa18bc99d77019f63eb2,1,27,2,29,5,2014-10-27 08:30:39,2014-10-27 08:30:39
93532432dce129e9075ffa18bc99d77019f63eb2...5e017a4566495b0024ab065e7ceab279ff77e030,1,16,1,17,6,2014-10-27 08:53:35,2014-10-27 08:53:35
5e017a4566495b0024ab065e7ceab279ff77e030...d3bdd3ba67dda8b8392770a2b6e4a7473ec4d42d,1,5,1,6,2,2014-10-27 09:02:20,2014-10-27 09:02:20
36f9224e4a79b49d0958476395d1472ba9b52a2a...667c0a909bde1cf71f21d8ec9768e98b1c489030,2,42,0,42,2,2014-11-10 17:01:42,2014-11-07 18:18:00
36f9224e4a79b49d0958476395d1472ba9b52a2a...2148e1997ace8bb5efab214c07492ed5a372dd31,2,14,1,15,2,2014-11-08 10:54:08,2014-11-08 10:54:08
1c1d9f78a4d7e569fda4ee70603a7bc2472a4ae4...706b6b5acb8e900e3d43e810d83829f9931bb9ec,1,2,10,12,4,2014-10-24 15:26:33,2014-10-23 21:39:48
1c1d9f78a4d7e569fda4ee70603a7bc2472a4ae4...472a6621e969f3b74fa21325722e65f446912f2a,3,32,12,44,6,2014-10-23 20:57:16,2014-10-23 20:57:16
1c1d9f78a4d7e569fda4ee70603a7bc2472a4ae4...add5d43b6ea0f4fbe85af4c07afe9e549b700205,1,11,0,11,1,2014-10-23 17:01:44,2014-10-23 17:01:44
8388bbe82918d2fca2600620f48e048ccfab2c97...bafd30f92cfb754fe6864c9cd595df10b52b11f2,6,57,3,60,8,2014-10-30 16:29:18,2014-10-22 15:29:26
8388bbe82918d2fca2600620f48e048ccfab2c97...961a6bfcc2f0b1063445143ba8841e6c6dcea8bf,3,6,1,7,4,2014-10-30 15:28:59,2014-10-30 15:28:59
961a6bfcc2f0b1063445143ba8841e6c6dcea8bf...20e04d9f398b1f4221fa9f5de529dea7c2f0f9c1,1,8,0,8,1,2014-10-30 15:30:09,2014-10-30 15:30:09
e261de255dfff71f5acc7d33f339a30a3cb32ab9...4d0d5e79ba4317cedfb2b0304ac5d376ad781b1a,16,18,26,44,17,2014-10-13 19:31:49,2014-10-13 19:31:49
e261de255dfff71f5acc7d33f339a30a3cb32ab9...a22d4cebb0c7687f7f8d97849e84125a0b3a52eb,1,0,1,1,1,2014-10-13 19:24:42,2014-10-13 19:24:42
e261de255dfff71f5acc7d33f339a30a3cb32ab9...c278520f9b96347868ce4f65b0d59aa6197e333d,1,0,4,4,2,2014-10-13 19:21:58,2014-10-13 19:21:58
e261de255dfff71f5acc7d33f339a30a3cb32ab9...2d235221079ef6af90bf482a8f563dd409290751,7,42,11,53,11,2014-10-13 18:55:09,2014-09-25 14:43:23
e261de255dfff71f5acc7d33f339a30a3cb32ab9...d584c406e8a687ee0f15cc0ed67ae9001784b1d3,1,2,2,4,2,2014-10-13 18:54:33,2014-10-02 22:26:56
e261de255dfff71f5acc7d33f339a30a3cb32ab9...014919340a27c771b280452b30913bc6b0a791e5,1,1,0,1,1,2014-10-13 16:07:23,2014-10-13 16:07:23
e95a8e15007518761f9c95d1aca3f94b2d8946d3...ae5381f2cc4a7b0f2cbb67d6cbbf57b10de1e307,1,4,1,5,1,2014-10-07 18:13:50,2014-10-07 18:13:50
8fad7e63a3eac7e88026d82cf7fa3696a3cb379b...3386a82d5eb105f764e62e818bcec19b1c92be8e,1,5,0,5,1,2014-10-07 13:50:23,2014-10-07 13:50:23
8fad7e63a3eac7e88026d82cf7fa3696a3cb379b...0bf99f65577d1e0edda8f4e060159d927b308974,4,63,22,85,7,2014-10-07 13:05:24,2014-10-07 13:05:24
0bf99f65577d1e0edda8f4e060159d927b308974...06c91aa20e6a8aed383d0a623a558983705edcb9,1,1,1,2,1,2014-10-07 14:28:55,2014-10-07 14:28:55
905004fdc37abd39645e29174927f56f3337e270...12e751a892b6872cedf9b9463a8e6fb90456f5f1,1,3,0,3,1,2014-10-30 07:01:19,2014-10-30 07:01:19
905004fdc37abd39645e29174927f56f3337e270...9c6106c4f68fea96a36d77b9b09685dc9fde0161,1,2,1,3,1,2014-10-30 06:58:34,2014-10-30 06:58:34
905004fdc37abd39645e29174927f56f3337e270...87fa3f0d2efd454441b838e3fd0b3645a6052c33,1,1,1,2,1,2014-10-30 04:18:57,2014-10-30 04:18:57
905004fdc37abd39645e29174927f56f3337e270...1f62cb3ee7c4e163472c4268016ac933de26ada5,1,1,0,1,1,2014-10-30 02:09:24,2014-10-30 02:09:24
23d4fcbd2c43c1b9d4323a4e25a46643aba2a06a...e9015dfbc9ed38f74fa6f035eb927176e0988510,2,7,1,8,2,2014-08-27 15:04:18,2014-08-26 07:11:11
2a532498185a8ffeb02b96c04296b1e843959b09...ecd946be4ce3efffa88c60f2e36a72394561b187,1,7,7,14,1,2014-08-21 14:58:06,2014-08-21 14:58:06
6c9cb565f16a006df7c980eadcd7061edb7b9281...37a274a56861803f8387822062a2d2c1e6662f33,6,56,14,70,9,2014-09-12 05:35:57,2014-08-17 14:21:31
6c9cb565f16a006df7c980eadcd7061edb7b9281...8321a4d41fb760c6ac4c91aea3dd757eea953c21,2,8,14,22,3,2014-09-12 05:22:30,2014-09-11 20:53:21
6c9cb565f16a006df7c980eadcd7061edb7b9281...233d89a9e7516bf85f391300067226207935917e,3,12,7,19,8,2014-09-11 17:48:02,2014-09-03 11:13:26
6c9cb565f16a006df7c980eadcd7061edb7b9281...58c0a4f5cf27f76f1dc0474197b8aca06b6db12d,5,157,6,163,6,2014-09-11 17:24:51,2014-09-11 10:05:38
58c0a4f5cf27f76f1dc0474197b8aca06b6db12d...0d5958c7296190bb9a814048529502b3ebf90bc2,5,60,3,63,9,2014-09-11 17:24:51,2014-09-11 16:19:49
1a9b2a47a139f2e683873c5d46cea15161e35783...92deb451da16bdc1b9520fc06f593b7e373d81af,17,172,8,180,17,2014-08-25 09:25:02,2014-08-25 09:25:02
1a9b2a47a139f2e683873c5d46cea15161e35783...2e497d84380907ad61225d358024ac1805da85e1,2,15,15,30,12,2014-08-25 09:19:52,2014-08-25 09:19:52
f74dba8c42ba5466945085bca137cc3a3a39ee87...c44764f523cea756f1f2efdc4db954f4f19df440,3,61,11,72,6,2014-10-03 09:52:29,2014-10-03 08:12:44
8a7d10af2329342ca003300847ace4793c66f854...4cca1b050a0e80e4ce6bb67f530549a2f28af630,12,278,34,312,18,2014-08-29 19:32:07,2014-08-29 19:22:45
4cca1b050a0e80e4ce6bb67f530549a2f28af630...b1411e90f81ea87ad45dee324b13881095e031ea,2,8,8,16,7,2014-09-02 12:33:23,2014-09-02 12:33:23
b1411e90f81ea87ad45dee324b13881095e031ea...858dbd084253d2920d7007babe0471469eb459e7,10,171,44,215,29,2014-09-05 17:30:55,2014-09-05 17:30:55
858dbd084253d2920d7007babe0471469eb459e7...4561a09c69b9769ebdbbf7cb9a3ed8f8cc03651b,2,30,15,45,13,2014-09-05 17:51:23,2014-09-05 17:51:23
8a7d10af2329342ca003300847ace4793c66f854...af7b19003cc6183c0a43c2c7c6ee52691fef1069,1,1,1,2,1,2014-08-29 18:11:57,2014-08-29 18:11:57
1d04a6fda7e5768dfc71cdffd74ede8f924ec647...a2b36858f537d0c580a3eb0d9164d6976767f15b,1,17,0,17,1,2014-09-08 06:17:37,2014-09-08 06:17:37
1d04a6fda7e5768dfc71cdffd74ede8f924ec647...c41e5f5018d059a9c57d2c19088e6c274cc60e10,1,1,1,2,1,2014-09-07 21:55:11,2014-09-07 21:55:11
1d04a6fda7e5768dfc71cdffd74ede8f924ec647...966d4d85ef758af2c8858f6410388d64011d0b84,1,1,0,1,1,2014-09-02 14:12:01,2014-09-02 14:10:05
1d04a6fda7e5768dfc71cdffd74ede8f924ec647...5e2bce0fef9e213842ee46ff406dd0e177fdec2d,1,4,4,8,2,2014-08-31 00:09:32,2014-08-14 05:55:41
1d04a6fda7e5768dfc71cdffd74ede8f924ec647...a870bc9ddfa11f88cb1e1b177bb1c207a8321479,1,1,1,2,1,2014-08-30 22:08:01,2014-08-30 22:08:01
0ce1826b44b4194b116f0a1875cbb891f6ca192d...b33d4bc2f1d26ee3526b9d7f530f468a9d5b5a5e,3,14,40,54,15,2014-11-06 09:58:00,2014-11-06 09:58:00
6641341b65d925a335e50f17a62a8a599ef54293...6ace931c3548aaa6c229c7f38191d128e6dc1362,2,3,2,5,3,2014-11-09 11:37:56,2014-11-09 11:37:56
c3e83d4771071b1e63ebcc88be624296ce72499a...57c7dafbfe61950fef716b72126410cf449472e4,1,8,0,8,1,2014-11-05 17:11:29,2014-11-05 14:35:56
8672203baf5971acb96cf62562876887fb69623b...300f2444a84671e0bcfcfed60b55f57ac311727a,1,4,2,6,3,2013-09-18 07:35:38,2013-09-18 07:35:38
16b6040c2e810253b29bfed4df5fcd098c456813...ca1b67ce38eb43edc969c0ca04264b7ea423413c,4,40,1,41,4,2013-09-18 02:38:08,2013-09-17 20:37:36
16b6040c2e810253b29bfed4df5fcd098c456813...fbd16e54205f9a80a58b33f0e6bdf23b3007470c,1,1,1,2,1,2013-09-17 05:52:26,2013-09-17 05:52:26
16b6040c2e810253b29bfed4df5fcd098c456813...1b1c81b17534ffd9329e0180f8bb7822e7fe0ac2,1,2,0,2,1,2013-09-16 13:49:04,2013-09-16 13:49:04
0f52d259617c4fe82ca1377bba904b3297407dea...e6b97d09470b01b5b65e87dab339c500f1bac45f,4,8,7,15,6,2015-01-27 02:56:56,2015-01-27 02:56:56
412780cc600f2329e078bf8b3bd6006fb7c8874a...350f5574793f9a2c262541f3b873a9b39dd171ad,4,8,4,12,4,2014-09-11 11:18:00,2014-09-11 11:18:00
350f5574793f9a2c262541f3b873a9b39dd171ad...5913f74446cd529cef4899aeaa60f273a1aa418b,3,19,1,20,3,2014-09-11 11:31:19,2014-09-11 11:31:19
a338954c331ed451c7b7dd39b28b9649dfca26ba...cff1758486675cb41ad959c8eefde11b016c0571,10,52,9,61,15,2014-07-10 14:54:31,2014-07-10 14:54:31
a338954c331ed451c7b7dd39b28b9649dfca26ba...e1535eff9567a94fae3ebfdb9df927f72f39ec56,1,1,1,2,1,2014-07-10 12:59:01,2014-07-10 12:59:01
25c9bf4b6a637c028f29dc36338d4c5ac8c8376c...99e1f4888a2333b36bba8505001e8e267c44523f,3,3,2,5,3,2014-07-14 10:16:57,2014-07-14 10:15:48
25c9bf4b6a637c028f29dc36338d4c5ac8c8376c...207bc8a0e70be38e49cd28bee1bc0b6bea50687a,3,81,72,153,7,2014-07-14 09:06:14,2014-07-14 09:06:14
207bc8a0e70be38e49cd28bee1bc0b6bea50687a...7435b879a62f636a82c7a004b91ea291019a0b1e,1,1,1,2,1,2014-07-14 10:11:01,2014-07-14 10:11:01
9c843041faf000a76bd2b542f594c061dab45c3a...204fee4f41cafedbb30d4c68793985a9e3ea84e4,11,38,39,77,24,2014-06-14 20:44:23,2014-06-14 20:44:23
04e8b5184fe7a1af514314a8f1f9557d25ee8af0...d3d0775acde8dbbb887665c3c52009d76e906d10,3,4,2,6,4,2014-06-13 12:18:23,2014-06-13 12:18:23
04e8b5184fe7a1af514314a8f1f9557d25ee8af0...76e2564018a28f79817dfd7c1e83ab2fc0bb58bc,1,3,3,6,2,2014-06-13 12:10:58,2014-06-13 12:10:58
04e8b5184fe7a1af514314a8f1f9557d25ee8af0...59e1819561912cb38bf00a7a34de1ac9e85c3a35,2,6,2,8,4,2014-06-13 12:00:35,2014-06-13 12:00:35
15c27192c0fa4e33188c3f6663362faca02df8af...273093a9b4e5970d7ed8b9bb6e16dee9f5ce2b70,1,2,2,4,2,2014-06-13 12:35:20,2014-06-13 12:35:20
43619db5155d29ddaab4c02ed383213f18531d26...aaa2bbd790efcfc59d0428076ec6387afd1ae519,1,1,0,1,1,2014-08-11 18:39:02,2014-08-11 18:39:02
ee068e76f334040fee7f328c67832489dd0de51a...da21b9e7d045a1f9b044563b62f09992ac685065,2,15,31,46,7,2014-10-21 15:26:40,2014-10-21 15:26:40
ee068e76f334040fee7f328c67832489dd0de51a...cccfede34cac854b4a6cbbe64d83647ee0c0af35,1,20,0,20,1,2014-10-21 09:33:26,2014-10-21 09:33:26
cccfede34cac854b4a6cbbe64d83647ee0c0af35...ce61de68ba43bd59dcec607dddae49591459bf93,1,2,1,3,1,2014-10-21 09:38:41,2014-10-21 09:38:41
ee068e76f334040fee7f328c67832489dd0de51a...593a287c8d0cfcc22ca2db35dc9a72140e296c2e,5,11,0,11,5,2014-10-21 09:27:16,2014-10-11 11:10:41
ff43500024f707a435cbcad43eb4d467368aabfe...ce3fb02ea0bab3530bcca116e389c2dd98ba1a68,2,3,3,6,3,2014-10-06 09:27:13,2014-10-06 09:27:13
ff43500024f707a435cbcad43eb4d467368aabfe...86d5a63e5eed67637e8177082d224935dd10b8f9,3,14,5,19,3,2014-10-06 08:19:11,2014-10-06 08:19:11
ff43500024f707a435cbcad43eb4d467368aabfe...9f0083a96c03ec22b1d9442a9c7530899e633301,17,167,8,175,22,2014-10-06 03:15:27,2014-10-05 05:53:44
9f0083a96c03ec22b1d9442a9c7530899e633301...fecd9c0cb22eda0a208042c568d8d833a1bd6292,4,150,1,151,5,2014-10-06 03:15:36,2014-10-06 02:17:28
fecd9c0cb22eda0a208042c568d8d833a1bd6292...3a3b2eb33e2ca41153a960b89ae7796b43aa93e8,2,14,0,14,3,2014-10-06 03:15:36,2014-10-06 03:04:58
3a3b2eb33e2ca41153a960b89ae7796b43aa93e8...31bc42de57b3cfd7bf068df06d15372307b8661b,7,170,0,170,9,2014-10-06 07:07:03,2014-10-06 06:59:03
43be3fcb833fe522721a7192fffd8d7348b01ffb...11848febd1170042523907652a36503c57e9fac2,6,25,4,29,8,2014-10-05 16:41:33,2014-10-05 13:03:15
1ad78be981109b6ed85774fb93a15be1a044658f...1d0f638248edc12c1e36f3276e895eee31584601,1,2,4,6,3,2014-10-28 17:57:30,2014-10-28 17:57:30
1ad78be981109b6ed85774fb93a15be1a044658f...dc4caa26bf438ec9193efd445d55dd0ad79cc906,1,4,4,8,3,2014-10-28 16:47:57,2014-10-28 16:47:57
8fd0d74bd84a8424e8c2f5e131efdb737f21a1f9...d5badd7ef661e9e896fe272614eca4171ed76cf4,1,1,0,1,1,2014-09-20 16:15:36,2014-09-20 16:15:36
cbff0155fa8a04a6b5e6c2a6d9fe10dfb91fb2e7...eb764b1b7ba43685f9f8347cadb73089e25a2086,1,1,1,2,1,2014-09-19 12:33:09,2014-09-19 12:33:09
9079441dbb8961e74f5ffe9e3f87ebdbb8866bef...0311efcbf0ea12d33dfa01b40ffb074c48e0ea10,1,1,1,2,1,2014-09-18 16:39:30,2014-09-18 16:39:30
6c3ad0dab639203961f8b3b2e59ffe78e9a21581...5b68a9adafec4a85832c81754760b3149e3e2235,3,10,0,10,3,2014-10-02 08:53:33,2014-10-02 08:53:33
6c3ad0dab639203961f8b3b2e59ffe78e9a21581...0eb27eada4ee6538b172cbf20278d3b2bbee4cf8,2,3,5,8,5,2014-10-02 08:53:05,2014-10-02 08:53:05
1302dc8f0420dacec65ef1dcc955763c6c263cec...89f7345f3ffdc212e60d4d657d878d1e5d6d6f9a,24,65,65,130,47,2014-09-26 07:51:17,2014-09-24 06:28:41
1302dc8f0420dacec65ef1dcc955763c6c263cec...87cf5b7055451a387c64bd488dacf2bc03917913,1,31,26,57,7,2014-09-26 07:46:48,2014-09-26 07:46:48
4e96c84e587c0dc70225127e03bc531949f5dd88...b0a3276253498475029fe25bcaef0eacc9e27ee6,2,3,3,6,3,2014-10-02 16:53:07,2014-10-02 16:53:07
2f6856f713eb310ec977c195054fede4373a2e59...d504ca8a0c696b31eaf383f97f47e08afac23084,2,3,0,3,2,2014-10-27 12:02:12,2014-10-27 12:02:12
d504ca8a0c696b31eaf383f97f47e08afac23084...d78e80fa74777e886ca131614f3b4d3f06bf9fff,2,10,0,10,2,2014-10-27 12:05:50,2014-10-27 12:05:50
d78e80fa74777e886ca131614f3b4d3f06bf9fff...3b6737f970eec80d82ddc78d098b3b3fccbe4acf,1,23,0,23,1,2014-10-27 14:08:37,2014-10-27 14:08:37
3b6737f970eec80d82ddc78d098b3b3fccbe4acf...28c08775b3d1994d3a8c5057534c704ff9da4bae,1,3,0,3,1,2014-10-27 14:11:03,2014-10-27 14:11:03
94d8698a855e889a7e2d808ad4f63e02dd13c101...d08bb4b3a467d730009a97c79573854af79147d6,1,11,1,12,2,2014-10-27 15:08:11,2014-10-27 15:08:11
d08bb4b3a467d730009a97c79573854af79147d6...50ee0b81b8ade93a919a78ef1c04dc0afd6f3074,2,2,6,8,2,2014-10-28 08:19:58,2014-10-28 08:19:58
8157c6b8a557369f875413f506f34d549254de56...2bca55197bb195a5b72af7053b31249dc8c921cb,2,3,3,6,3,2014-10-24 09:25:39,2014-10-24 09:25:39
d9aa3f92159a6d422f570ffbe776fc09b708f1f7...3d705131f7d1a85dbf09053a200fbf36c6225625,6,707,4,711,7,2014-10-14 03:05:21,2014-10-14 03:05:21
3d705131f7d1a85dbf09053a200fbf36c6225625...91c96b3714a8f5753d9851ee8e2a859b201f6905,3,9,8,17,6,2014-10-22 17:40:41,2014-10-22 17:40:41
d9aa3f92159a6d422f570ffbe776fc09b708f1f7...f7dc15c6bdb75a5f611c389ece3fe251f94a2d8f,1,2,3,5,2,2014-10-09 09:49:28,2014-10-09 09:49:28
d9aa3f92159a6d422f570ffbe776fc09b708f1f7...deffd2e5385d4aca161e3047dc551ae8bbdfb0f8,1,1,0,1,1,2014-10-09 07:29:10,2014-10-09 07:29:10
672bd3902d86b78d730cea809fce312ec49d39d7...30b803fa3f4da65d5b94f582dfa244483bd009ec,3,72,0,72,2,2014-10-14 14:01:45,2014-10-14 14:01:45
30b803fa3f4da65d5b94f582dfa244483bd009ec...8e7da6455b47882b97257ba7266eaf171cb029c8,1,5,5,10,5,2014-10-14 14:12:22,2014-10-14 14:12:22
672bd3902d86b78d730cea809fce312ec49d39d7...5d59890b9de69a286f833f634f87fc18ddf0db7b,1,1,1,2,1,2014-10-14 11:21:42,2014-10-14 11:21:42
672bd3902d86b78d730cea809fce312ec49d39d7...920eb7abc4b3e7006ca6cffd4de2b290ddfe3d6d,1,8,4,12,3,2014-10-14 10:02:05,2014-10-14 10:02:05
920eb7abc4b3e7006ca6cffd4de2b290ddfe3d6d...f174800b207d8bcbab46bdbeb65bf219eecf6d83,1,3,3,6,3,2014-10-14 10:28:30,2014-10-14 10:28:30
672bd3902d86b78d730cea809fce312ec49d39d7...9abe5d36d79971a8dda3626a2bab90e42c401014,2,70,0,70,2,2014-10-14 09:23:33,2014-10-14 09:23:33
9abe5d36d79971a8dda3626a2bab90e42c401014...1d432e96bc44ad2f7f67dc4a551d34083f51f281,1,1,0,1,1,2014-10-14 10:31:47,2014-10-14 10:31:47
4c7da578f200f0bc721cc2cae27eb2b25f96e8dd...f013973d19b9ae145b6f642e085172f1e266d5ef,1,7,2,9,2,2014-10-08 09:22:41,2014-10-08 09:22:41
0fd06adf0c5e373f2c03574f9f92069491985492...bbc52b000008c9020d2a38dafc09ff3341a69cae,1,1,1,2,1,2014-10-07 09:48:25,2014-10-07 09:48:25
2c7e08745b8ed4361b9560439a721e5647973ad7...15c89672388a9868b88264c45a2a29838a246a43,7,7,7,14,7,2014-08-26 16:01:46,2014-08-26 15:58:05
2c7e08745b8ed4361b9560439a721e5647973ad7...9122823afca108ffc7019261c7e8f255d640066b,2,18,10,28,2,2014-08-26 11:44:39,2014-08-08 15:56:01
9122823afca108ffc7019261c7e8f255d640066b...c0b146899b46892485727102f552a1db324bb2ef,1,1,1,2,1,2014-08-26 11:44:39,2014-08-08 15:56:33
c0b146899b46892485727102f552a1db324bb2ef...6d785abaa9367173d62300b8000a68554e4e293c,1,7,7,14,2,2014-08-27 14:32:59,2014-08-11 16:26:20
6d785abaa9367173d62300b8000a68554e4e293c...0a52b70b923af6d4351d4b7a28527c6740e812cf,1,16,14,30,5,2014-08-27 14:36:38,2014-08-27 14:36:38
0a52b70b923af6d4351d4b7a28527c6740e812cf...fc62664146458f023c5573d7e6dead5f11c6fd4b,1,2,0,2,1,2014-08-27 14:53:35,2014-08-27 14:53:35
b3b50bb86ea89c54d790516552e65eb8b4149fe1...7c1e60f0b48a31fb40e30e1af80a8fea02fadb4b,1,1,1,2,1,2014-08-27 07:16:33,2014-08-27 07:16:33
b3b50bb86ea89c54d790516552e65eb8b4149fe1...6eb85b1a30eb2e87fc6a55d17bb38fdf535a516b,3,173,1,174,3,2014-08-26 21:24:49,2014-08-26 21:23:54
b3b50bb86ea89c54d790516552e65eb8b4149fe1...9a4ef7e7eb1fe73938578d82c2662913e3d51ad6,2,137,0,137,2,2014-08-26 20:32:41,2014-08-26 20:32:41
9a4ef7e7eb1fe73938578d82c2662913e3d51ad6...5d9a5c02d83c2aa9fed66c045eb88762679fb60e,1,4,0,4,1,2014-08-26 20:39:37,2014-08-26 20:39:37
5d9a5c02d83c2aa9fed66c045eb88762679fb60e...9e5bc432630d04867cea9f38383d1a4fc49b62cd,2,5,21,26,10,2014-08-26 21:04:14,2014-08-26 21:04:14
9e5bc432630d04867cea9f38383d1a4fc49b62cd...ede08dbdd787fdd3a30b62dc0e7e2c796bb6d43a,7,98,87,185,13,2014-08-27 06:57:50,2014-08-27 06:57:50
ede08dbdd787fdd3a30b62dc0e7e2c796bb6d43a...c3ad51a0e492108825093e12d441cca90d597a19,9,114,40,154,10,2014-08-27 07:48:51,2014-08-27 07:48:51
c3ad51a0e492108825093e12d441cca90d597a19...13f6dc1a9476ef2c86538ede8420e915eb999a1c,8,39,28,67,13,2014-08-27 08:55:42,2014-08-27 08:55:42
13f6dc1a9476ef2c86538ede8420e915eb999a1c...7e59a8fee8c89d6217bd48bf1050526f59cb96aa,5,35,14,49,7,2014-08-27 09:37:31,2014-08-27 09:37:31
7e59a8fee8c89d6217bd48bf1050526f59cb96aa...8b00d01c6711918951a7951cff3e57660c807ae7,6,15,5,20,8,2014-08-27 09:47:30,2014-08-27 09:47:30
8b00d01c6711918951a7951cff3e57660c807ae7...043f275900c833bd0d4efa3c08d4f3e4158f00f8,1,4,3,7,1,2014-08-27 09:49:45,2014-08-27 09:49:45
043f275900c833bd0d4efa3c08d4f3e4158f00f8...7f4b993793083abad99c12e2ea223ea08843ccb9,1,4,3,7,1,2014-08-27 09:54:18,2014-08-27 09:54:18
7f4b993793083abad99c12e2ea223ea08843ccb9...c5c906fe6472f953b379aca4c34fad23b3b7742e,3,6,6,12,6,2014-08-27 12:26:35,2014-08-27 12:26:35
a83451a5c052b594ae602923d0beb1195ea6bac8...eea595971f8e8cc4e8a1d8ce141986ca617edc9a,19,19,19,38,19,2014-08-21 15:25:14,2014-08-21 15:25:14
a034a4665229425d5b3eff3082069b9ab1b57ab4...d94be1ddbfb8fadf015eacbdc58c62c3cc0ffa91,1,68,0,68,1,2014-10-12 21:29:42,2014-10-12 21:29:42
a034a4665229425d5b3eff3082069b9ab1b57ab4...7d9cdc2d37cec34544069cf85dc7ea33137589eb,1,6,1,7,1,2014-09-12 14:53:08,2014-09-12 14:53:08
a034a4665229425d5b3eff3082069b9ab1b57ab4...5704e6fee9d2dea67c4a91b43d06a9958484d29b,4,46,4,50,6,2014-09-12 12:59:58,2014-09-12 12:59:58
a034a4665229425d5b3eff3082069b9ab1b57ab4...e645b9a9d5e7c80b7a445d2b792d24e05bbdc6a8,2,5,3,8,2,2014-09-12 11:43:52,2014-09-12 11:43:52
a034a4665229425d5b3eff3082069b9ab1b57ab4...02eca79ef1e7925b85e0919cdaab8c85ff8c916a,3,9,8,17,3,2014-09-12 11:22:15,2014-09-12 10:45:00
a034a4665229425d5b3eff3082069b9ab1b57ab4...377a5bd5216a9bd3fb66aad340414b3b4b88dbcc,1,2,2,4,2,2014-09-12 08:03:11,2014-09-12 08:03:11
5087f36d2358e470988df800f3ecfbe556190946...5e9db3982349970b6c5f3affb6b0981a4234f621,1,265,0,265,1,2014-08-25 11:16:19,2014-08-25 11:16:19
5e9db3982349970b6c5f3affb6b0981a4234f621...9297f012892054f61f923e48207704937d737569,1,1,0,1,1,2014-08-25 11:32:03,2014-08-25 11:32:03
9297f012892054f61f923e48207704937d737569...d8a645ac39bf164a9d0080b3744d416b29eaf330,1,3,3,6,3,2014-08-25 15:24:54,2014-08-25 15:24:54
d8a645ac39bf164a9d0080b3744d416b29eaf330...a94ab6b9168ff2f1d11f2ff88c1808b52fd40055,1,2,2,4,2,2014-08-30 09:35:51,2014-08-30 09:35:51
a94ab6b9168ff2f1d11f2ff88c1808b52fd40055...1034dbdabf2766fa02f45ef312d05d62fe9dfae8,1,7,7,14,6,2014-08-31 08:59:13,2014-08-31 08:59:13
1034dbdabf2766fa02f45ef312d05d62fe9dfae8...fe3762fd0a720e474e70e5dbd63c0821f0a08cd8,1,7,6,13,3,2014-09-01 08:19:22,2014-09-01 08:19:22
fe3762fd0a720e474e70e5dbd63c0821f0a08cd8...ca139e8c783bdf3dd0b8b664fbe8f416e13c9aa3,1,2,2,4,1,2014-09-01 09:26:47,2014-09-01 09:26:47
ca139e8c783bdf3dd0b8b664fbe8f416e13c9aa3...54782454f61234d8afbc12958b481133b3c4bae1,1,24,28,52,20,2014-09-02 09:14:34,2014-09-02 09:14:34
54782454f61234d8afbc12958b481133b3c4bae1...47fdc972b865431263856000d4688b25122edd1d,1,1,1,2,1,2014-09-02 09:19:27,2014-09-02 09:19:27
47fdc972b865431263856000d4688b25122edd1d...51b6e64db854c48a7b31ca6b8cf6c9f3beb7ff41,1,1,1,2,1,2014-09-02 09:23:26,2014-09-02 09:23:26
51b6e64db854c48a7b31ca6b8cf6c9f3beb7ff41...0bb1e4b5c0f37cac5cf50ca37d358bfd34effb8d,1,38,35,73,23,2014-09-08 11:54:08,2014-09-08 11:54:08
0bb1e4b5c0f37cac5cf50ca37d358bfd34effb8d...8088d22d4177d23369775ed93968c45b0ec84eec,2,6,2,8,2,2014-09-08 12:11:21,2014-09-08 12:11:21
8088d22d4177d23369775ed93968c45b0ec84eec...74fecb495cd8965d396d8943018f8042ea5d7f2e,1,7,4,11,4,2014-09-17 07:14:12,2014-09-17 07:14:12
74fecb495cd8965d396d8943018f8042ea5d7f2e...7ecc730a7ebf62de93bf36fa8bac0943609a7ca7,1,1,0,1,1,2014-09-17 07:44:11,2014-09-17 07:44:11
7ecc730a7ebf62de93bf36fa8bac0943609a7ca7...6f61cbd162582c78a2c3e197f34a63e4543c9b1b,1,3,1,4,1,2014-09-22 11:10:13,2014-09-22 11:10:13
174c00cf2c026a3bdc61d94b45195a5e5c99202f...57fddea8bbb867bde744e769d6d627e420533682,1,16,0,16,1,2014-09-01 11:48:35,2014-06-26 22:04:10
174c00cf2c026a3bdc61d94b45195a5e5c99202f...0cbc19f9449ffc6e624c0b7e22ea837468658377,31,646,138,784,75,2014-09-01 09:49:17,2014-08-21 08:14:31
174c00cf2c026a3bdc61d94b45195a5e5c99202f...81336bd2b52bdbee9a1199f78e7da001814fae84,5,35,0,35,5,2014-09-01 08:26:47,2014-08-08 14:03:58
b33d4bc2f1d26ee3526b9d7f530f468a9d5b5a5e...d1b489e048e2bd9304ae335d9105e6efde99012b,3,40,14,54,15,2014-11-06 11:07:16,2014-11-06 11:07:16
d1b489e048e2bd9304ae335d9105e6efde99012b...bf8b87411701667a8d9e608b2e7b3171c4c3e551,2,3,4,7,3,2014-11-06 11:07:42,2014-11-06 09:47:38
70f30abd8413167cd77dbc7cd5dd7a138fc5ee92...280822cd379a7b7d3790f1546d677e14b700d2d1,1,1,1,2,1,2014-11-10 09:38:25,2014-11-10 09:38:25
37a0e063545c6d6a8097e0e053b9756491536d6e...b099951c554e74165ec18bc4011b20811b6c376c,2,27,27,54,27,2013-09-22 09:46:42,2013-09-21 21:46:36
e6b97d09470b01b5b65e87dab339c500f1bac45f...aac36b120ef86469feb05ae5db39205493f851ed,1,2,0,2,1,2015-01-27 03:28:11,2015-01-27 03:28:11
aac36b120ef86469feb05ae5db39205493f851ed...a3d879d427c1236d26832dcd0312b3e0d6158bbe,9,112,87,199,12,2015-01-27 04:57:42,2015-01-27 04:57:42
a3d879d427c1236d26832dcd0312b3e0d6158bbe...8ecf7d3207ca52d694f6d8ebd9bed96041c49a8c,1,1,1,2,1,2015-01-27 04:58:38,2015-01-27 04:58:38
8ecf7d3207ca52d694f6d8ebd9bed96041c49a8c...65e88f1e1aa247c9a89af82717aae791786ad276,6,16,9,25,12,2015-01-27 06:39:48,2015-01-27 06:39:48
7a914e5a8fb5af088afe598d1ceb38d145280700...2df7a7b204c2d5488da7b685530e95a487db0946,2,0,0,0,0,2014-07-10 16:54:25,2014-07-10 16:54:25
2df7a7b204c2d5488da7b685530e95a487db0946...6d0bfc922d87a5957609c055a8a034d88ea45909,2,0,0,0,0,2014-07-10 21:34:29,2014-07-10 21:34:29
a66d6a523b0cc2f985ead056a3d39797189ec4be...b93c1a562c3ef7dbf20a3b5f4699d3f61b375512,4,44,11,55,7,2014-07-11 12:05:40,2014-07-11 12:05:40
b93c1a562c3ef7dbf20a3b5f4699d3f61b375512...ce30172cef695bb2c64e407a31e14284d769fb6e,1,0,0,0,0,2014-07-11 12:10:41,2014-07-11 12:10:41
ce30172cef695bb2c64e407a31e14284d769fb6e...853ce95423605fcd398ce092c66ce43fa7f4a11b,1,2,2,4,2,2014-07-11 12:10:57,2014-07-11 12:10:57
853ce95423605fcd398ce092c66ce43fa7f4a11b...f4fbc7b92b8dc0ed94524a79326c073560845d1b,1,1,0,1,1,2014-07-11 12:14:48,2014-07-11 12:14:48
f4fbc7b92b8dc0ed94524a79326c073560845d1b...6d332ce146b634e18b12e2476ace3955d7d33290,9,121,116,237,14,2014-07-11 13:05:57,2014-07-11 13:05:57
6d332ce146b634e18b12e2476ace3955d7d33290...ba5787c38ab2b281cf7cd47c61ea25ecebba42cc,2,3,3,6,2,2014-07-11 13:39:04,2014-07-11 13:39:04
ba5787c38ab2b281cf7cd47c61ea25ecebba42cc...5c51e4835e59b675ac344840800fe57d7b4749ab,1,2,2,4,1,2014-07-11 13:42:09,2014-07-11 13:42:09
dbb7610365782e1d780903d88e8b804e89262a02...d74bf464d38da126bbc44ab39bac4b9e2adb12b4,1,1,0,1,1,2014-06-15 06:40:24,2014-06-15 06:40:24
1555146adf7e23085f04eda76f3c7f213a2e774c...55795b7c297c08b4b3f7f6dc3ee98cd0d29c6748,10,37,48,85,15,2014-06-14 16:02:16,2014-06-14 16:02:16
55795b7c297c08b4b3f7f6dc3ee98cd0d29c6748...951279b1a312db5d943c970d435bba5b29901375,1,3,3,6,1,2014-06-14 16:09:36,2014-06-14 16:09:36
951279b1a312db5d943c970d435bba5b29901375...3637d244be046c145598777fce2488598d7ca6e8,3,16,19,35,4,2014-06-14 16:35:45,2014-06-14 16:35:45
3637d244be046c145598777fce2488598d7ca6e8...869809a1cf33dc19cf22119301cea42af5f5e45a,2,0,19,19,3,2014-06-14 16:41:32,2014-06-14 16:41:32
869809a1cf33dc19cf22119301cea42af5f5e45a...52b7fa248a8670a86764c4786f4a34b072992715,1,1,1,2,1,2014-06-14 16:55:26,2014-06-14 16:55:26
52b7fa248a8670a86764c4786f4a34b072992715...56cb6d889910a2c4b6420c190c235b6e8a0324bb,2,2,2,4,2,2014-06-14 16:58:54,2014-06-14 16:58:54
56cb6d889910a2c4b6420c190c235b6e8a0324bb...72f0a6b286e6a11addc70249643a96fd5b0559c1,1,1,1,2,1,2014-06-14 17:01:56,2014-06-14 17:01:56
72f0a6b286e6a11addc70249643a96fd5b0559c1...9e21e96b2a4fdd0485946dfe7ef85b7475ee00a4,1,1,1,2,1,2014-06-14 17:33:12,2014-06-14 17:33:12
9e21e96b2a4fdd0485946dfe7ef85b7475ee00a4...b48bb4a77ceb3fec8a361a6836eb6feba71c84c9,2,0,0,0,0,2014-06-14 17:35:40,2014-06-14 17:35:40
342b7b62c4726dfbe2ab0c94252d7634b026982a...2af8ace1dc49e5ff59be01c2063139a3244b9cee,2,3,1,4,2,2014-06-13 15:40:37,2014-06-13 15:40:37
5fdcaadf347e41109f20a4dee733f5b51030feda...3f1ece26909f90e538a50cd724b64da28f0b7308,5,29,14,43,6,2014-06-13 15:25:44,2014-06-13 14:19:08
273093a9b4e5970d7ed8b9bb6e16dee9f5ce2b70...d5b0f29c4a3a9d7da849d91a16f70bd494831da7,1,28,0,28,1,2014-06-13 14:11:46,2014-06-13 14:11:46
d5b0f29c4a3a9d7da849d91a16f70bd494831da7...ae564c97d48bf728745c57720734cb40378fd90f,10,53,48,101,23,2014-06-13 14:46:48,2014-06-13 14:46:48
ae564c97d48bf728745c57720734cb40378fd90f...a7345e368a92396c04e9cd8d1a9c1ed2ed50d15e,2,54,1,55,5,2014-06-13 15:02:42,2014-06-13 15:02:42
a7345e368a92396c04e9cd8d1a9c1ed2ed50d15e...e8f222e39c5f7124bd604246c8d2502181760888,1,4,5,9,4,2014-06-13 16:35:21,2014-06-13 16:35:21
e8f222e39c5f7124bd604246c8d2502181760888...8ff171f62849d5e418847c1751a802f93604cc61,3,11,11,22,11,2014-06-13 16:39:12,2014-06-13 16:39:12
8ff171f62849d5e418847c1751a802f93604cc61...47d6f70528dd4b41739c0a6767f74a8a40d9aaaa,2,12,0,12,2,2014-06-13 16:42:17,2014-06-13 16:42:17
aaa2bbd790efcfc59d0428076ec6387afd1ae519...423390a2c75e64370e64c1d3a70ef463797cc3dd,1,27,26,53,3,2014-08-12 08:48:58,2014-08-12 08:48:58
c5ad011917af7b11d0d021e77cce471a223a52e5...05f19392b76d9fbe40d97547ee2a3c87883c9639,1,2,2,4,2,2014-10-22 08:11:18,2014-10-22 08:11:18
86d5a63e5eed67637e8177082d224935dd10b8f9...20179772140ff0bdc2d61852c0a4f48ee6e4a2d0,3,9,16,25,7,2014-10-06 08:44:01,2014-10-03 14:24:11
20179772140ff0bdc2d61852c0a4f48ee6e4a2d0...216fb6ee07b80c2cb6cd78fdcb52c898fa2f41ea,1,4,9,13,5,2014-10-06 08:44:01,2014-10-03 16:59:57
216fb6ee07b80c2cb6cd78fdcb52c898fa2f41ea...e5998adc26f66b2b84cbcc28e98f3fc8f89b4696,2,28,5,33,4,2014-10-06 08:44:01,2014-10-06 08:42:03
e5998adc26f66b2b84cbcc28e98f3fc8f89b4696...1e7e1d52b1945b7a854e2242b72af3f419bcda76,1,1,0,1,1,2014-10-06 08:45:17,2014-10-06 08:45:17
1e7e1d52b1945b7a854e2242b72af3f419bcda76...1db8d3104cfab111771a7afbaa015e989640fde4,1,1,1,2,1,2014-10-06 09:51:15,2014-10-06 09:51:15
1db8d3104cfab111771a7afbaa015e989640fde4...eceef546d19c16d16772868a05e6769907442f83,2,18,1,19,2,2014-10-06 14:50:24,2014-10-06 14:50:24
31bc42de57b3cfd7bf068df06d15372307b8661b...40263a06c196e0c99cc13d187228bd62bbcf4a6a,8,61,82,143,12,2014-10-07 00:19:12,2014-10-07 00:19:12
40263a06c196e0c99cc13d187228bd62bbcf4a6a...9dcb643fd4fe9e6b36239f3d7589fd9079d35dfb,1,0,0,0,0,2014-10-07 16:17:04,2014-10-07 16:17:04
d6db6dda7552ed6c480ce330cc446881892487b9...ec5482a0dc460ec8d6f25ca6fd40377aba2d7714,1,2,0,2,1,2014-10-29 14:34:28,2014-10-29 14:34:28
f01e311ed134689066cd65312ff58003068259d7...332645232235c1b16faf538cc409c5b60d425168,1,2,0,2,1,2014-10-29 23:23:47,2014-10-29 23:23:47
fda61a047ffb9b04bc4dd38e897088fde17fb3c1...b5c0bdd7c949fa3986200bc8f953c3905b7490b2,2,10,8,18,3,2014-09-23 19:16:27,2014-09-21 21:26:18
fda61a047ffb9b04bc4dd38e897088fde17fb3c1...ef6e94e37e0fce23acf32992476aeb63405be0c1,40,379,376,755,376,2014-09-22 08:01:50,2014-09-21 21:40:22
fda61a047ffb9b04bc4dd38e897088fde17fb3c1...b65a2d07e47580a1b284215296116ef396baf28e,2,2,2,4,2,2014-09-21 17:45:54,2014-09-21 17:45:54
fda61a047ffb9b04bc4dd38e897088fde17fb3c1...ad47993ac46cef672600f2384ee5fa2e661ec8be,10,57,67,124,21,2014-09-21 09:43:05,2014-09-21 08:29:52
eb764b1b7ba43685f9f8347cadb73089e25a2086...4bf3abe2b80b5f620ce588728194d6ce4f6779ef,1,18,3,21,3,2014-09-19 15:44:21,2014-09-19 15:44:21
eb764b1b7ba43685f9f8347cadb73089e25a2086...7121b4a48800aa77184a6e2f18bd72288129067e,1,3,1,4,3,2014-09-19 15:39:25,2014-09-19 15:39:25
f56877a9eaa8adc0f2fca99a889cc42e049024bf...2b1137bd14c6291c0cc819749dee87989f201599,1,1,1,2,1,2014-09-18 22:53:46,2014-09-18 22:53:46
4a21db82ec8edfc79a1b16d5d28bdd7e82085234...e4bc359841d4254ad46a9e4c9a602cc25b017db1,1,2,2,4,2,2014-09-18 17:19:11,2014-09-18 17:19:11
e4bc359841d4254ad46a9e4c9a602cc25b017db1...aca574d0f414821a9a1bbdd0efe53b97cd42ca57,2,2,2,4,2,2014-09-19 10:07:58,2014-09-19 10:07:58
de5e0e590fa4e75cb9d66398b902a8348a2c42dc...430758653ce7e4d32b40648e6263b79c2709bdad,6,215,3,218,10,2014-09-26 08:58:11,2014-06-27 14:48:30
87cf5b7055451a387c64bd488dacf2bc03917913...1be7c25dce8e18b60e048f123314fc20605b2557,1,1,1,2,2,2014-09-26 08:17:26,2014-09-26 08:17:26
87cf5b7055451a387c64bd488dacf2bc03917913...a932e28ddd43ad344b81b3894503356e9861e050,1,7,9,16,3,2014-09-26 07:55:39,2014-09-26 07:55:39
a932e28ddd43ad344b81b3894503356e9861e050...8fae6ad75a5e474d17d504056af606f99183a6fb,1,1,1,2,1,2014-09-26 09:45:41,2014-09-26 09:45:41
8fae6ad75a5e474d17d504056af606f99183a6fb...9ecd3bc6cebf63e5040084032cf99adec18c859f,1,26,0,26,1,2014-09-26 09:55:57,2014-09-26 09:55:57
06fd4bf7e18bd3f3e4805eee332c6bd485760e42...76594d474ca6d04c2e608e7b3df1229729288f14,4,206,7,213,6,2014-10-08 08:30:04,2014-08-18 10:54:51
f9885c0c3cc489bd24ef88bd25682de9288a5ada...8101640c33d240fc5b29c3dec33c56b67325a89f,1,9,9,18,7,2014-10-27 13:30:57,2014-10-27 13:30:57
08d361e8b3a8b147cc059ade2d7f826a90e27337...951abce5627ca55cb66511cdbd4eda4db577f78b,1,18,8,26,2,2014-10-27 17:13:01,2014-10-27 17:06:01
c71792d98c3bcf6b15f28f27b89359b0be081914...fa39863611a3eab3f386ccd0e8e5003cbd9a7ddb,1,11,9,20,5,2014-10-28 18:02:01,2014-10-28 18:02:01
9cf50550d7a7616cd5dba382bdd7c65473a9c95d...bc403356bb16da28a8c9cb486decf308036fd8f5,1,10,6,16,2,2014-11-04 15:02:38,2014-11-04 15:02:38
bc403356bb16da28a8c9cb486decf308036fd8f5...019c0f9e0f0f8b74803be57cb9f8ef8ab2e057ef,1,0,2,2,1,2014-11-05 13:57:05,2014-11-05 13:57:05
f6bed511cd7b45726ba50ec0b2e934bd590b0b76...e4912243c1110f7194ff4e9a3da6f23a3ccac113,2,3,2,5,2,2014-10-24 21:44:30,2014-09-26 14:11:17
80059cb5231a557d0e86653a53e27ce19f62b488...ef9f8677e65b4b791550daad4ebff8ae50c2f0d2,3,10,0,10,5,2014-10-31 10:08:45,2014-10-31 10:08:45
ef9f8677e65b4b791550daad4ebff8ae50c2f0d2...9b251bd1cc1ed551aad9bc67ca2743b8e2666c6e,1,2,0,2,1,2014-10-31 10:10:19,2014-10-31 10:10:19
f7dc15c6bdb75a5f611c389ece3fe251f94a2d8f...47f539f5a6a930b2cfd4f9834b4d1bd5e1c180cb,20,332,55,387,46,2014-10-09 14:09:53,2014-10-08 13:44:25
2fb99c79ffd89c5807f504247856f4bf48f6c34a...d567dd33db06db8ef68d7603afc14670ba35240f,1,1,1,2,1,2014-10-09 13:33:03,2014-10-09 13:33:03
2fb99c79ffd89c5807f504247856f4bf48f6c34a...099cf3558f9e41022ac38d2f8226bdbe3c9aa470,1,10,0,10,1,2014-10-09 12:02:10,2014-10-09 12:02:10
099cf3558f9e41022ac38d2f8226bdbe3c9aa470...64e72af3cb65731c84e1aa27b68a04fe378bebd9,2,7,2,9,3,2014-10-09 12:20:49,2014-10-09 12:20:49
64e72af3cb65731c84e1aa27b68a04fe378bebd9...a912308340ec70f13de98ae5116a8d71929a995f,1,8,0,8,1,2014-10-09 14:12:17,2014-10-09 14:12:17
a912308340ec70f13de98ae5116a8d71929a995f...1d14676e0ce0db006058e02aa0ceedf9c05e5625,2,3,2,5,3,2014-10-10 06:24:58,2014-10-10 06:24:58
1d14676e0ce0db006058e02aa0ceedf9c05e5625...fc2adfb6e4af59e45809661e32be0d2ad3158503,1,6,0,6,1,2014-10-10 06:32:05,2014-10-10 06:32:05
2fb99c79ffd89c5807f504247856f4bf48f6c34a...b4828f4cf6405d27c01cc5be42334dd29a27285b,1,10,7,17,2,2014-10-09 11:33:38,2014-10-09 11:33:38
b4828f4cf6405d27c01cc5be42334dd29a27285b...4149fc24cfe4ffa2d0d950e7f930529a05899b7c,1,4,2,6,2,2014-10-10 10:51:00,2014-10-10 10:51:00
4149fc24cfe4ffa2d0d950e7f930529a05899b7c...2ea166fc338f95cb9f6db1c61426dce4b2cfd8e1,3,20,3,23,5,2014-10-10 15:31:47,2014-10-10 15:31:47
c3b81e5f400ebc935683fc2cf0e561b2b17a1052...ab1ad3bd18d9b9359fc361d7dab3b317fdd38984,2,27,22,49,5,2014-10-21 20:54:22,2014-10-21 20:52:38
c3b81e5f400ebc935683fc2cf0e561b2b17a1052...3418f56a6915d11023a07c4ea8ecc535ec52871a,4,66,62,128,6,2014-10-21 20:44:02,2014-10-21 20:39:34
c3b81e5f400ebc935683fc2cf0e561b2b17a1052...0e70e3b557ccc660c97e7dc7938e53c17faac479,1,1,1,2,1,2014-10-21 18:19:07,2014-10-21 18:18:29
c3b81e5f400ebc935683fc2cf0e561b2b17a1052...ce056d80748da32e20c3bfab1bff9567a812bfe1,1,1,1,2,1,2014-10-21 10:36:09,2014-10-21 10:36:09
c3b81e5f400ebc935683fc2cf0e561b2b17a1052...6c476a8dac8411f9a9d5a2cbf9ff088dc55369d9,1,7,1,8,2,2014-10-21 09:04:09,2014-10-21 09:04:09
6c476a8dac8411f9a9d5a2cbf9ff088dc55369d9...6e9fb7facce76999b0a13fd676a701ea5580b76c,1,15,31,46,16,2014-10-23 14:24:44,2014-10-23 14:24:44
6e9fb7facce76999b0a13fd676a701ea5580b76c...fd44d0b6c23443cc899316926e4f8a3a9d9ad032,1,21,4,25,6,2014-10-27 14:02:21,2014-10-27 14:02:21
c3b81e5f400ebc935683fc2cf0e561b2b17a1052...2c98584a9c0c019af58012865ae4425df5127ac6,1,0,4,4,1,2014-10-21 08:56:11,2014-10-19 09:25:43
c3b81e5f400ebc935683fc2cf0e561b2b17a1052...38670a663c30ed2fb2b10ac51d5d6bc56b4101a3,3,11,11,22,3,2014-10-21 08:46:55,2014-10-20 22:49:59
ab2db486b8014e509455b624dfd1719f77e27ede...c0a5d043819d6ad52912e2ba68c7fcb12e237978,1,1,1,2,1,2014-10-20 10:51:02,2014-10-20 10:51:02
5d59890b9de69a286f833f634f87fc18ddf0db7b...6774d5f6eaaf252215ab7279ead96f38b2e6b0bf,1,1,0,1,1,2014-10-14 13:00:40,2014-10-14 13:00:40
4bebdc09463e29d26eac0117e0e3b45a9448c600...706ee232c5a4af1556496af991bb62308fff28dc,1,4,2,6,2,2014-10-14 14:47:31,2014-10-14 14:47:31
706ee232c5a4af1556496af991bb62308fff28dc...0d30b13a7a95b941061a8466aef32e29870aa66d,1,8,9,17,2,2014-10-14 14:48:32,2014-10-14 14:48:32
4bebdc09463e29d26eac0117e0e3b45a9448c600...3c66490e6fda4fcd222de188ace35add821f6b91,2,2,1,3,2,2014-10-14 13:46:50,2014-10-14 13:46:50
bbc52b000008c9020d2a38dafc09ff3341a69cae...10783f4d7b1b4b8f1ade255176c0d1b3667c66ae,1,0,1,1,1,2014-10-07 21:41:02,2014-10-07 21:41:02
bbc52b000008c9020d2a38dafc09ff3341a69cae...901d099ceab49a32e83e14313c630e262a35a427,2,2,2,4,2,2014-10-07 21:28:38,2014-10-07 21:28:38
bbc52b000008c9020d2a38dafc09ff3341a69cae...7984065776d0a32d245a3caa57342be83e45af2d,1,4,4,8,3,2014-10-07 20:39:45,2014-10-07 20:39:45
bbc52b000008c9020d2a38dafc09ff3341a69cae...23b4a2e72118afeb691fa92891ca79cbc85b9c4f,3,15,20,35,6,2014-10-07 19:12:18,2014-10-07 14:09:28
bbc52b000008c9020d2a38dafc09ff3341a69cae...6d4076fdc674cd5f9002e908e082d6c1c9dd1b90,1,2,1,3,1,2014-10-07 18:48:39,2014-10-07 18:48:26
bbc52b000008c9020d2a38dafc09ff3341a69cae...ceaebe233c00bbf0df2d2bd6e3c852752546ba42,1,1,1,2,1,2014-10-07 16:52:16,2014-10-07 16:52:16
f99b876837e8e86dc5f4d898c16046d3183804a8...822d9aa6ba150ed1983dda3cfddaaa177f6b9f97,6,46,17,63,10,2014-10-30 13:48:23,2014-09-25 02:30:06
f99b876837e8e86dc5f4d898c16046d3183804a8...c3104abfd4d5c58838a6f4514ffa4b7c04ff6dcd,1,1,1,2,1,2014-10-30 10:01:21,2014-10-30 10:01:21
070e3964dcf5e61a97618913af75fdc878f71871...f44a68a0049663814205c277ff85ac96820e5f95,1,5,2,7,2,2014-08-27 14:00:15,2014-08-27 14:00:15
070e3964dcf5e61a97618913af75fdc878f71871...0bf45aece390a474ae01feb7d237878cb9e37c04,3,27,2,29,4,2014-08-27 08:21:58,2014-08-13 11:04:13
f12fdf16e3c1aee5203d0217f0b44b64bb80706c...a5eb6915d0daef99867e4eadb3be41014f135e41,1,1,0,1,1,2014-08-27 14:24:54,2014-08-27 14:24:54
a5eb6915d0daef99867e4eadb3be41014f135e41...c4a8663b573d683ebd5c8decd7c419c87c6ddb83,1,3,1,4,1,2014-08-27 14:27:26,2014-08-27 14:27:26
e328668f2950636fe21e69b49d10d6ea1ae12da4...52e903e99f3b220553e65be7b6034dfbaeef6d81,1,10,2,12,3,2014-08-22 07:56:39,2014-08-21 15:59:27
52e903e99f3b220553e65be7b6034dfbaeef6d81...b70606287bda9b52be2288513f612505fa3d86b2,1,6,6,12,3,2014-08-22 07:56:39,2014-08-22 07:49:50
6f61cbd162582c78a2c3e197f34a63e4543c9b1b...0f35c61dc0eee93237c6d345dbc99effd87bbb7c,5,5,5,10,5,2014-09-28 11:59:33,2014-09-28 11:59:33
0f35c61dc0eee93237c6d345dbc99effd87bbb7c...841fc4d95e9cc49ec5071577eaba603dba4eb07c,11,10,10,20,10,2014-09-28 13:47:53,2014-09-28 13:47:53
841fc4d95e9cc49ec5071577eaba603dba4eb07c...5121fce196f560039d02804ca43f46ff0235e728,1,0,0,0,0,2014-09-29 11:38:43,2014-09-29 11:38:43
4198b58a8c21bf99e370fa3dd1452bdb278a0be9...6143cef4c49d5a3e9c8c13a7328dcb6581d664f5,2,13,0,13,2,2014-09-01 11:49:16,2014-09-01 11:48:17
4198b58a8c21bf99e370fa3dd1452bdb278a0be9...0c34fa3ea0662f94fdc565cfd3f921db40733821,2,27,12,39,8,2014-09-01 10:59:04,2014-09-01 10:59:04
0c34fa3ea0662f94fdc565cfd3f921db40733821...0ec4abf73c5de8b36c33beba443d998652042ef5,1,6,6,12,3,2014-09-01 11:02:41,2014-09-01 11:02:41
0ec4abf73c5de8b36c33beba443d998652042ef5...5801d520a75ce03339944d67cfde6cc3c1b05cfc,2,13,0,13,2,2014-09-01 12:05:01,2014-09-01 11:48:17
5801d520a75ce03339944d67cfde6cc3c1b05cfc...262276c5f55802541f4df19a44488b4f5239054c,2,13,0,13,2,2014-09-01 12:26:10,2014-09-01 12:26:10
262276c5f55802541f4df19a44488b4f5239054c...ca17e4b7adae4583b915f6ea7f2714b2225cd73c,1,0,4,4,1,2014-09-01 12:30:31,2014-09-01 12:30:31
ca17e4b7adae4583b915f6ea7f2714b2225cd73c...92a9964940784063810d068f230088d7f297ba54,1,22,30,52,6,2014-09-01 13:30:46,2014-09-01 13:30:46
92a9964940784063810d068f230088d7f297ba54...26b14dd2d597d7bd5579cfcbad456abb0af6a5e5,2,9,12,21,10,2014-09-01 14:31:27,2014-09-01 14:31:27
26b14dd2d597d7bd5579cfcbad456abb0af6a5e5...c0323b40ee5633f2808f52f98bde0509a2f3ee59,3,6,6,12,4,2014-09-01 14:35:18,2014-09-01 14:35:18
f10cea340cce18aeb498de9782661077997aa49e...5136b6aec0b783189f46b4fad77c0b2beca9c3f1,1,1,1,2,1,2014-11-10 14:09:41,2014-11-10 14:09:41
5136b6aec0b783189f46b4fad77c0b2beca9c3f1...f56541de9a488dec68f4e98f738f90c51d898fc9,5,50,96,146,5,2014-11-10 14:17:04,2014-11-10 14:17:04
68850b73d7a4fa04b29d5074e8c6721b7c722cd8...6cac4e6271fcbfdd51feb3d32dc6c29905adb966,1,1,1,2,1,2014-11-07 10:51:18,2014-11-07 10:51:18
68850b73d7a4fa04b29d5074e8c6721b7c722cd8...9353db59a084a1524c19efba2ef185a15967f233,3,1,7,8,3,2014-11-06 19:34:41,2014-11-06 19:34:41
d4c4fc35a66da709849081caf0292a5025a1b857...05ef996e52eddececee3e0edb9c8bb5a0dc4c82d,1,3,6,9,3,2013-09-19 08:45:31,2013-09-19 08:45:31
e4ba9349a39cedf0e54562b76e47a3a8e7925941...a5e19c4edcb8201cb33318cc0bec06a239694451,1,28,1,29,3,2013-09-24 06:32:56,2013-09-24 06:31:12
724ccadbd2006bc9a3596ff2d35d7b2fce90928e...7e6fa0afd63b75d2653ff75fcde26164f832a094,1,2,2,4,1,2015-01-27 17:30:16,2015-01-27 17:30:16
724ccadbd2006bc9a3596ff2d35d7b2fce90928e...4fefd353d86a0b7b223b44c5f2e355b09231f79d,2,3,3,6,3,2015-01-27 13:14:52,2015-01-27 13:14:52
849985a62dfee0ea32ddd89be1cca78a9ad369a1...8c15fd0014047b2bad478af412d3d8eb54845080,1,1,1,2,1,2014-07-11 14:16:44,2014-07-11 14:16:44
8c15fd0014047b2bad478af412d3d8eb54845080...248b12833c775f39c5b99cd9a6eeb38ec5e54d53,2,10,0,10,2,2014-07-11 14:37:20,2014-07-11 14:37:20
248b12833c775f39c5b99cd9a6eeb38ec5e54d53...f3b0cb77fcb379107cdd4f770fdb16381cda1baf,1,1,1,2,1,2014-07-11 14:42:03,2014-07-11 14:42:03
46e33ed3714e876030e796bd5ef53248a8bb79e1...e6722cb1786f7765228c2ac81f337ec5d09f9d19,3,6,3,9,6,2014-06-15 14:53:00,2014-06-11 16:37:29
b48bb4a77ceb3fec8a361a6836eb6feba71c84c9...d29bb23a6896c1c660fe27d1a9bd5dbfde94bf52,5,16,7,23,9,2014-06-14 19:54:56,2014-06-14 19:54:56
2af8ace1dc49e5ff59be01c2063139a3244b9cee...eb7845682d3e9f66694ce6a5a97765fda898a4d2,7,29,29,58,8,2014-06-13 17:21:48,2014-06-13 17:21:48
eb7845682d3e9f66694ce6a5a97765fda898a4d2...600f4c68940160556b0a4c6ecf18c40dd6ad94d5,1,3,3,6,1,2014-06-14 09:36:31,2014-06-14 09:36:31
600f4c68940160556b0a4c6ecf18c40dd6ad94d5...9be5425a887d96aaf603dd537d36f410eb663e4f,16,87,107,194,20,2014-06-14 09:36:46,2014-06-14 09:36:46
2af8ace1dc49e5ff59be01c2063139a3244b9cee...d69853585415c1fa89a9e39e4f2e0853412b047b,3,17,1,18,3,2014-06-13 16:10:28,2014-06-13 12:38:10
49506fc71a03e39a1a316e6740423a44030526ed...054d68a3e9092f21d407dc39b784dece8c935bfe,2,3,1,4,3,2014-06-14 09:58:08,2014-06-14 09:58:08
05f19392b76d9fbe40d97547ee2a3c87883c9639...f3c120d25a7c9ab31609f93a0549c5174c519baf,1,17,3,20,3,2014-10-28 14:00:03,2014-10-28 14:00:03
f3c120d25a7c9ab31609f93a0549c5174c519baf...f6491508fe54c75c8db8db17b27d6d7912198a7a,5,205,175,380,5,2014-10-29 11:31:23,2014-10-29 11:31:23
f6491508fe54c75c8db8db17b27d6d7912198a7a...eea6a8a17deb384bfe6b9b83462df6cb5f7f17ad,2,17,5,22,8,2014-10-29 11:38:00,2014-10-29 11:38:00
05f19392b76d9fbe40d97547ee2a3c87883c9639...b0ef23c1936577b0d3a9d5e58c808bb24b41b0ea,1,10,10,20,6,2014-10-22 10:38:47,2014-10-22 10:38:47
42a1d8083c77d3803320bbbd0ac1559ff32d2519...d59f8abea56be5c9ffdafc77c4d5755161a903a4,2,4,7,11,3,2014-11-05 12:58:51,2014-11-05 12:58:51
42a1d8083c77d3803320bbbd0ac1559ff32d2519...5a8ec1f6712ea044500c015e55f7515007a8285e,1,6,0,6,1,2014-11-05 11:18:26,2014-11-05 11:18:26
5a8ec1f6712ea044500c015e55f7515007a8285e...2ee1ec430012e4489ea1d70a13bcb827cafede2e,1,10,1,11,2,2014-11-05 11:53:10,2014-11-05 11:53:10
2ee1ec430012e4489ea1d70a13bcb827cafede2e...6d775ddae4e561b9a932177fdaf5f6a4a16030a2,2,4,7,11,3,2014-11-05 15:03:45,2014-11-05 12:58:51
ed9350dc576553b3d2c7543b80404a7c41def649...bd0d679b236aa03c5b1f4596d5d669e225288030,1,2,2,4,1,2014-10-29 23:24:07,2014-10-29 23:24:07
ed9350dc576553b3d2c7543b80404a7c41def649...e712583a5e0c3fdb74abcd7c394237354edb3b45,1,44,7,51,4,2014-10-29 22:21:55,2014-10-29 22:21:55
e712583a5e0c3fdb74abcd7c394237354edb3b45...19caccf77390c320b1ff4579bb72a638f5d553cf,1,11,3,14,6,2014-10-30 17:38:09,2014-10-30 17:38:09
19caccf77390c320b1ff4579bb72a638f5d553cf...493d3e8240d9d49952ab7c90e742ff4117fab711,1,14,16,30,10,2014-10-30 18:08:10,2014-10-30 18:08:10
493d3e8240d9d49952ab7c90e742ff4117fab711...792f7e09e26b7d8872166d27924837f0fd42526b,1,9,9,18,9,2014-10-30 18:10:07,2014-10-30 18:10:07
792f7e09e26b7d8872166d27924837f0fd42526b...5c645b76b3a9343ac4ff55b8cb14472efc38b746,1,2,2,4,2,2014-10-30 18:14:31,2014-10-30 18:14:31
5c645b76b3a9343ac4ff55b8cb14472efc38b746...2022754d933176877e9cff1159512e63e9fff2d8,1,5,30,35,7,2014-10-30 22:36:25,2014-10-30 22:36:25
ed9350dc576553b3d2c7543b80404a7c41def649...9cadfc9e134f720846bfa3d874d00545ecc78ac4,2,7,7,14,6,2014-10-29 15:17:22,2014-10-29 15:17:22
90741c8892f5f8fd5d5154c8cd9d3fda9397df56...28ba985ef936bfffcb83025b2a093e048c761938,1,7,0,7,3,2014-09-21 19:06:38,2014-09-21 19:06:38
9971a9692a41b7bab4461ea0f94a4fa5e7e81c89...559af04f3421bcd1301dd00bb3e296e7e281910f,3,24,13,37,14,2014-09-21 12:05:48,2014-09-21 12:05:48
9971a9692a41b7bab4461ea0f94a4fa5e7e81c89...244513568ccef5710ecc7a414ad38b8dc19dbac8,2,5,5,10,5,2014-09-21 11:28:47,2014-09-21 11:28:47
9971a9692a41b7bab4461ea0f94a4fa5e7e81c89...9cf77b6604ec8830af1253cf187525e3d2548d44,1,1,1,2,1,2014-09-21 10:47:24,2014-09-21 10:47:24
ac516abe957d9cf0c1ce7ec80fa47eebf6ace0d4...eb033aa60ec572da447871daf5f1f171439ae5e2,3,7,12,19,3,2014-09-20 16:02:01,2014-09-20 16:02:01
ac516abe957d9cf0c1ce7ec80fa47eebf6ace0d4...adaec60a5014c0386fa5e9f859d39461e7f6e9fe,5,22,19,41,5,2014-09-20 13:32:46,2014-09-20 13:26:14
ac516abe957d9cf0c1ce7ec80fa47eebf6ace0d4...0576c028ccf6af90a6110112aca1a7c54d00c314,2,4,1,5,2,2014-09-19 21:16:02,2014-09-19 07:02:17
ac516abe957d9cf0c1ce7ec80fa47eebf6ace0d4...04ef3ddc6c3e6b8199a73ff390116e707bd5f33e,1,4,6,10,5,2014-09-19 15:32:23,2014-09-19 15:32:23
ac516abe957d9cf0c1ce7ec80fa47eebf6ace0d4...29a0d993b087742f017804e87d547d227602678f,1,7,4,11,3,2014-09-19 14:16:45,2014-09-19 14:16:45
ac516abe957d9cf0c1ce7ec80fa47eebf6ace0d4...9439602edc1f4f5a5afaa160aff8daa1a994ee96,1,3,4,7,1,2014-09-19 12:15:24,2014-09-19 12:09:50
ac516abe957d9cf0c1ce7ec80fa47eebf6ace0d4...9cad1cbe322e5b540e1b4796867220b4160ed0b1,1,3,3,6,2,2014-09-19 07:58:22,2014-09-19 07:58:22
ac516abe957d9cf0c1ce7ec80fa47eebf6ace0d4...ee8be80ce709d8525b9b374d815b2f591c33184f,1,1,0,1,1,2014-09-19 06:52:42,2014-09-19 06:52:42
b0349915e2615617aff9c5291f7e305d59ea3992...da99560ecbc105c8a98ce2f0e47415634420040f,1,12,21,33,6,2014-10-02 12:07:21,2014-10-02 09:38:21
b0349915e2615617aff9c5291f7e305d59ea3992...81eacd1b2a591d3ce1f14d4119527ea9b290ba8f,3,30,15,45,5,2014-10-02 10:12:51,2014-09-28 09:02:29
b0349915e2615617aff9c5291f7e305d59ea3992...3098e7a453c84ac4df1686b8bad6ef8004aca60d,8,26,37,63,8,2014-10-02 10:03:30,2014-09-26 22:41:17
b0349915e2615617aff9c5291f7e305d59ea3992...a68a3f65af50e3e49f75ef5be4ec1e8eae183300,1,2,2,4,2,2014-10-02 09:20:54,2014-10-02 09:20:54
fd338d67159e6dffaf54fd42fbeddb3b17e4d49f...ac55373ff39674782e914b045469ae49c77e814a,1,1,1,2,1,2014-09-27 09:15:08,2014-09-27 09:15:08
fd338d67159e6dffaf54fd42fbeddb3b17e4d49f...862315dcb0b2cc5c8d78a8633a942a7921b94039,1,1,1,2,1,2014-09-27 08:34:51,2014-09-27 08:34:51
fd338d67159e6dffaf54fd42fbeddb3b17e4d49f...b49dd2c57306b53006a628ba28a830b7a431d16f,2,15,6,21,5,2014-09-27 08:11:20,2014-09-27 07:56:19
fd338d67159e6dffaf54fd42fbeddb3b17e4d49f...f258a59ef6156f9da3b527efe9088fd0708f6fdf,4,74,9,83,17,2014-09-26 20:03:37,2014-09-04 22:01:12
fd338d67159e6dffaf54fd42fbeddb3b17e4d49f...97e2f8a0d991f189c7cb60aec3f2e1f17e928451,1,7,2,9,2,2014-09-26 19:55:45,2014-09-24 01:19:16
fd338d67159e6dffaf54fd42fbeddb3b17e4d49f...633d42a3359c8d43dd68716852faca0ec6de22f4,2,3,3,6,3,2014-09-26 15:04:11,2014-09-26 15:04:11
633d42a3359c8d43dd68716852faca0ec6de22f4...20e0c9b132f1a7d12b156936114155c89d55b8cf,10,29,98,127,19,2014-09-26 15:04:41,2014-09-26 15:04:41
20e0c9b132f1a7d12b156936114155c89d55b8cf...aa46a15d2adaa018b7d8c59e6def2643fb2acab1,1,4,3,7,1,2014-09-26 15:12:25,2014-09-26 15:12:25
fd338d67159e6dffaf54fd42fbeddb3b17e4d49f...0cdef83dc8cfb96c17718d6dd1a2438dc9cea24f,2,2,2,4,2,2014-09-26 14:52:36,2014-09-26 14:52:36
fd338d67159e6dffaf54fd42fbeddb3b17e4d49f...f456fce2a5bf62589c2bd07e99835b07ab7bd976,2,102,4,106,11,2014-09-26 13:33:48,2014-09-26 13:26:52
45d9446978338b233e7fe7e1e5d368131c5528c4...271a3520794d0d977ba3907963871da59cee554f,2,15,16,31,13,2014-11-09 07:33:27,2014-11-09 07:33:27
45d9446978338b233e7fe7e1e5d368131c5528c4...3e55d56c905f119e482dba7a2a5ea0d19f089aeb,1,0,1,1,1,2014-11-01 00:22:16,2014-11-01 00:22:16
45d9446978338b233e7fe7e1e5d368131c5528c4...56ffa0fba47c8e81c2980140988cbdd2c0520b9d,2,3,3,6,3,2014-10-28 07:06:22,2014-10-12 12:19:10
45d9446978338b233e7fe7e1e5d368131c5528c4...6093d4fd831957a5ebac4925e4b660f629b9ee60,1,1,0,1,1,2014-10-28 06:28:02,2014-10-28 06:28:02
408bbb1bc6840a678d444e7398de2ac1f45aa26d...fd17ba9ffc3350c3054746eac4b6be1a84d690ac,3,16,5,21,3,2014-10-30 11:26:45,2014-10-29 13:46:42
fd17ba9ffc3350c3054746eac4b6be1a84d690ac...dade6650e1fe9ba13462957c15126d506e98673a,1,1,0,1,1,2014-10-30 11:27:06,2014-10-30 11:25:56
7371c9e2f453c6bd910aa1335a278743bbf827bf...bc0cf7458957ad6b2e32ef4176afc1cca2c9c9f7,1,10,7,17,6,2014-11-02 23:13:30,2014-11-02 23:13:30
7371c9e2f453c6bd910aa1335a278743bbf827bf...ffa586061dbbb9f10196653673bf18842d2078b3,1,1,1,2,1,2014-11-01 21:30:46,2014-11-01 21:30:46
7371c9e2f453c6bd910aa1335a278743bbf827bf...54ded5d95b16ea09be50dc7a9347fb6d5c02b1d9,1,3,3,6,3,2014-11-01 21:26:12,2014-11-01 21:26:12
7371c9e2f453c6bd910aa1335a278743bbf827bf...d549a2a525e524086c1697138e39b452e5c72c94,1,20,12,32,13,2014-10-31 12:00:50,2014-10-31 12:00:50
7371c9e2f453c6bd910aa1335a278743bbf827bf...884e916fe2ebb6095af1817c7a962623c12af34e,1,3,4,7,4,2014-10-31 11:51:53,2014-10-31 11:51:25
7371c9e2f453c6bd910aa1335a278743bbf827bf...76e3b8c6599e41c15c63076ebe2bbd27e7293043,1,1,0,1,1,2014-10-31 10:55:56,2014-10-31 10:55:56
6303d003c699082ef7c5f83b7b805e95a62b7886...82c938ad75d40a62abfd7b4bd603e57bef6555f5,29,264,219,483,35,2014-10-09 15:22:20,2014-10-09 15:22:20
e3bd17a7ba5238c147a79d0770e8503fd913610c...b97218db4d76a571a8ac4dd3e94ad5f7e6d9f67d,1,1,1,2,1,2015-01-19 02:34:35,2014-10-14 15:40:56
e3bd17a7ba5238c147a79d0770e8503fd913610c...dcf6c26075027c56e733da7db06e5e355b40074e,2,10,8,18,3,2014-10-15 07:53:16,2014-10-15 07:53:16
e3bd17a7ba5238c147a79d0770e8503fd913610c...cec3b6c355279692a6cd9cf3b884517edcea376d,1,6,0,6,1,2014-10-15 06:53:01,2014-10-15 06:52:45
e3bd17a7ba5238c147a79d0770e8503fd913610c...ace045499a1ac4988401fb5511e7678e6c53108b,1,1,1,2,1,2014-10-15 05:54:30,2014-10-15 05:54:30
e3bd17a7ba5238c147a79d0770e8503fd913610c...0901345d1b4a83f37f281a6229aa115775a3d5c9,1,9,0,9,1,2014-10-14 22:45:44,2014-10-14 22:45:44
e3bd17a7ba5238c147a79d0770e8503fd913610c...62b322d7b567f1fae2ea8b5a3b0e71a62506e47d,4,109,2,111,6,2014-10-14 17:07:34,2014-10-14 17:07:34
19b0ba5ecbf63052cc4d9b85364efc22d5e12f11...fb05fa859e5f552e8b84f07d741ea7a68b121f80,1,17,0,17,1,2014-10-15 11:08:55,2014-10-15 09:35:16
fb05fa859e5f552e8b84f07d741ea7a68b121f80...adb64dc2ee32b23cbbf7b1d9eed59cf4f72c4e63,1,1,1,2,1,2014-10-15 11:08:55,2014-10-15 09:37:49
adb64dc2ee32b23cbbf7b1d9eed59cf4f72c4e63...2803d9e0257c08107db5cebb9a5b10b87d6ca358,1,1,1,2,1,2014-10-15 11:08:55,2014-10-15 10:53:06
2803d9e0257c08107db5cebb9a5b10b87d6ca358...76cde5c0e534e59c7dcd8bc7e096cfb0bf9f2603,3,5,2,7,5,2014-10-15 11:13:42,2014-10-15 11:13:42
19b0ba5ecbf63052cc4d9b85364efc22d5e12f11...57b38f6f1c8c6a09ad1d6ac47a28776578703c31,2,12,9,21,2,2014-10-15 10:48:37,2014-10-15 10:48:37
57b38f6f1c8c6a09ad1d6ac47a28776578703c31...af609805c5e6a97893cf1a02d8fb043fff183656,1,1,1,2,1,2014-10-15 11:16:03,2014-10-15 11:16:03
21e9ed2eaf14b52ac03296a42fe89bb7270d4e19...629bd2831f8c5a699eab09f7f1c7f4c45a194ebd,1,0,2,2,2,2014-10-08 17:33:28,2014-10-08 17:33:28
d30e1f5cb827893c1f24411545399284d0994d96...17835f095fb10168d5d2f6b2fd4c136844c2bfd1,1,3,2,5,2,2014-10-08 11:44:24,2014-10-08 11:40:25
d30e1f5cb827893c1f24411545399284d0994d96...e8a826030e8616261aac4e0865200d63dc9821b4,1,75,86,161,8,2014-10-08 08:54:51,2014-10-08 08:54:51
e8a826030e8616261aac4e0865200d63dc9821b4...9021debf50d979fc7d62ece432a0071c10e6868e,2,42,0,42,2,2014-10-08 10:56:57,2014-10-08 10:56:57
9021debf50d979fc7d62ece432a0071c10e6868e...74217f753f4f4f6d882af651ccb4ef88ed5c87d4,3,22,7,29,7,2014-10-08 10:57:54,2014-10-08 10:57:54
74217f753f4f4f6d882af651ccb4ef88ed5c87d4...b485fdb5c1eb126d43b66a3c7fad45cd7961496d,1,6,2,8,1,2014-10-08 12:05:14,2014-10-08 12:05:14
b485fdb5c1eb126d43b66a3c7fad45cd7961496d...ab68fd2206165117b94ce9619d8bfab3d805f206,6,33,40,73,20,2014-10-08 12:47:24,2014-10-08 12:47:24
652f4c8090793de4737b904b5feb11c27424f4c5...6f34d40436531029228e78d7a55a0e3982dbf89e,14,0,15,15,15,2014-11-05 09:04:08,2014-11-05 09:04:08
ed478105bdc528b070f3bdede6b5056980cefed0...a1dda564b19ed268a8019a9ac814933ac309a92b,1,9,9,18,7,2014-10-30 21:59:05,2014-10-30 21:59:05
3069826d1aea24be9d1c7ba65fa199d5530a8123...039976af46de4a5f1acf523f088302ae9db57e30,1,1,1,2,1,2014-08-29 13:17:43,2014-08-29 09:28:13
3069826d1aea24be9d1c7ba65fa199d5530a8123...6682f8d75d4bf121ce2326c541960b1908d86013,1,2,0,2,2,2014-08-29 00:21:16,2014-08-29 00:21:16
3069826d1aea24be9d1c7ba65fa199d5530a8123...8d715fb104baf57219124fea0bc54d3f7846a1a3,2,3,3,6,3,2014-08-28 19:30:18,2014-08-28 19:20:55
0d5253812ba3e2c1b8234d10991a1c09042dc339...da55f2d9b0ea76cdaf85651570641df9c7bb915f,1,2,2,4,2,2014-08-28 13:46:06,2014-08-28 13:46:06
d4d723caeed66ea215561689947b35dc8bde7404...e38081e55b6ef37e0272ffeb14658757e8d6aff0,1,5,0,5,1,2014-08-27 14:38:42,2014-08-27 14:38:42
abda2dab43cab774ced331093ec7649157a2b5a5...230c52f76a346832a1be4b87461ebf2fd4d7c905,1,2,0,2,1,2014-08-22 14:33:36,2014-08-22 14:33:36
abda2dab43cab774ced331093ec7649157a2b5a5...3dbd8d2293bf0ef4a211db2591382113aee48cfc,2,4,0,4,2,2014-08-22 12:32:04,2014-08-22 12:32:04
abda2dab43cab774ced331093ec7649157a2b5a5...4a14b5900ba752b9f481d00260890868f62dd599,1,3,2,5,1,2014-08-22 10:33:58,2014-08-22 10:33:58
abda2dab43cab774ced331093ec7649157a2b5a5...e4f75fd26275bfa40064fa01e537d1cb4c7fde08,1,23,1,24,1,2014-08-22 08:21:04,2014-08-22 08:21:04
e4f75fd26275bfa40064fa01e537d1cb4c7fde08...abb415276f3854f09dc06f68523f10e927ecc5c3,1,1,0,1,1,2014-08-22 08:25:13,2014-08-22 08:25:13
fe14384e27b28ab9e6bde4fcee0fac744c938913...b0e92ca9ae9a2c051381b9cd3817123f6907e4fa,1,3,3,6,3,2014-10-13 07:52:08,2014-10-13 07:52:08
05ef996e52eddececee3e0edb9c8bb5a0dc4c82d...687cd9fa5bb662302dee85388db28a94b73beafb,2,4,4,8,4,2013-09-21 16:54:18,2013-09-21 16:54:18
05ef996e52eddececee3e0edb9c8bb5a0dc4c82d...61a86101e81368b79bc9b99ef355518cde83facc,4,60,32,92,9,2013-09-20 15:42:38,2013-09-20 15:39:12
05ef996e52eddececee3e0edb9c8bb5a0dc4c82d...a47fe72ad66c0ee24d375ba92759a3831ba969b2,1,1,0,1,1,2013-09-19 17:25:40,2013-09-19 17:25:40
05ef996e52eddececee3e0edb9c8bb5a0dc4c82d...ed68bf7ebff3ffe8321fe3466859777b8e708416,1,1,1,2,1,2013-09-19 13:36:37,2013-09-19 13:36:37
daf2cf62d7f6f718cb723ae61c4ef60e5d6a711f...35597f61aabc613e8b64c8f8e66999f8f3b3a8a6,2,59,1,60,3,2013-09-24 22:56:25,2013-09-24 22:56:25
35597f61aabc613e8b64c8f8e66999f8f3b3a8a6...435a5ff8a1774c6feb2a683371ada0804318af11,1,0,2,2,1,2013-09-24 23:09:33,2013-09-24 23:09:33
435a5ff8a1774c6feb2a683371ada0804318af11...64e012a378b657efd44fb7570e0924dfed64e008,2,20,0,20,2,2013-09-25 14:49:39,2013-09-25 14:49:39
64e012a378b657efd44fb7570e0924dfed64e008...fa8588827e45946464298fb7e36f4dcd24f0c4fb,1,16,12,28,2,2013-09-25 14:54:34,2013-09-25 14:54:34
7e6fa0afd63b75d2653ff75fcde26164f832a094...6182f1cabf08e75b01146198cbd09fdea0bfdb67,1,4,3,7,1,2015-01-27 17:48:42,2015-01-27 17:48:42
7e6fa0afd63b75d2653ff75fcde26164f832a094...233f9f0766f4316661f9464698d971069ea30e37,1,1,1,2,1,2015-01-27 17:35:46,2015-01-27 17:35:46
f3b0cb77fcb379107cdd4f770fdb16381cda1baf...1da2262efd272a4cf086f1cf1a033699a43df857,8,149,0,149,8,2014-07-15 06:19:27,2014-07-11 16:29:51
f3b0cb77fcb379107cdd4f770fdb16381cda1baf...62d2aed036ce0699eb494fb629983a5809f746a5,4,24,18,42,6,2014-07-13 17:56:29,2014-07-13 17:56:29
f3b0cb77fcb379107cdd4f770fdb16381cda1baf...fa5726690f8472a7c229ff8a2e78b4081da50388,1,2,2,4,2,2014-07-13 13:22:11,2014-07-13 13:14:55
f3b0cb77fcb379107cdd4f770fdb16381cda1baf...55efb2d9f2f3024137cfd28ec0b58c723f044b42,7,7,42,49,9,2014-07-11 17:53:10,2014-07-07 07:32:12
55efb2d9f2f3024137cfd28ec0b58c723f044b42...07b9d80604f130c5958e24651e73e889c6e43bb7,3,16,2,18,3,2014-07-11 17:53:10,2014-07-11 10:24:11
07b9d80604f130c5958e24651e73e889c6e43bb7...3b80d68f9d9d074ca24ca7cbc2f123360670a29a,2,48,1,49,3,2014-07-11 17:53:10,2014-07-11 15:12:03
f31f101d364ea51bb32a7ed0c8a66ccff7811a15...8d240fb0e76f6333a51b1e9eaffb9196d2e4557a,3,10,2,12,3,2014-06-16 09:17:34,2014-06-16 09:17:34
f31f101d364ea51bb32a7ed0c8a66ccff7811a15...89ed1e09bba6c0fe5d259510f2b91de730c9675d,1,18,8,26,7,2014-06-16 08:52:21,2014-06-16 08:52:21
68e4df7065ebb805d8215b8c28f0eaf510dec17f...6a7990c007f2349f3093aef3e70eaa8c092033c8,14,2,156,158,14,2014-06-14 12:51:07,2014-06-14 12:51:07
054d68a3e9092f21d407dc39b784dece8c935bfe...0b7f83ad7e0444f6514898359a415a731f9ee8ff,1,7,0,7,1,2014-06-14 10:26:07,2014-06-12 19:41:33
47064ea55cf82ee4e38b616348243a53fae12ce2...a9fadce361163e97eb1de0ec62e4235ff0fa3daa,5,96,50,146,5,2014-10-26 10:34:50,2014-10-20 15:50:53
47064ea55cf82ee4e38b616348243a53fae12ce2...9be12dd9ca171a4665e0efe4d26d44366302fc43,1,1,2,3,1,2014-10-23 21:10:54,2014-10-23 21:10:54
47064ea55cf82ee4e38b616348243a53fae12ce2...2c14f9c41f195b8c914adb10c9a315d301944608,1,0,2,2,1,2014-10-23 14:25:09,2014-10-23 14:25:09
47064ea55cf82ee4e38b616348243a53fae12ce2...40815b2bafb209c258048ef08e7506559f1bfa90,1,1,1,2,1,2014-10-23 11:12:21,2014-10-23 11:12:21
47064ea55cf82ee4e38b616348243a53fae12ce2...5d5b3b8273297f9fe70a8c14376da7e6e528e2c5,1,6,6,12,3,2014-10-22 20:56:42,2014-10-22 20:52:50
47064ea55cf82ee4e38b616348243a53fae12ce2...aa923847b2ad2734d28b50546674d3264a7969bb,1,19,19,38,12,2014-10-21 21:23:58,2014-10-21 21:23:58
47064ea55cf82ee4e38b616348243a53fae12ce2...3dbe0810f503ae51fc5e9310d753278c5b645b11,1,0,5,5,1,2014-10-21 20:36:09,2014-10-21 20:36:09
5a699090cde818294fca93d2793dd6195c0a7c2d...ff48e1eeb73de6a98ba92c6f1b7bbddda17edcd0,2,2,2,4,2,2014-10-31 09:12:41,2014-10-31 09:12:41
b43e918a73c88a8d922c5c5d79e2aa2bf42a9d29...a286f920508368eafabdb934cc2f50e04e5c8ada,2,5,11,16,3,2014-09-24 07:35:13,2014-09-24 07:35:13
b43e918a73c88a8d922c5c5d79e2aa2bf42a9d29...065ab3e5f302434a189038aa46a475154c79a91d,2,10,5,15,3,2014-09-22 19:37:52,2014-09-22 17:46:57
b43e918a73c88a8d922c5c5d79e2aa2bf42a9d29...de6c8778f768674a504d5b8a63055060c455d771,52,52,52,104,52,2014-09-22 14:30:25,2014-09-22 14:30:25
b43e918a73c88a8d922c5c5d79e2aa2bf42a9d29...f0231e409a5f1b987f8e3b864ab4ed4674890fa2,3,1,173,174,3,2014-09-22 11:48:28,2014-09-22 11:48:28
b43e918a73c88a8d922c5c5d79e2aa2bf42a9d29...416018062131e048fd5e97a3d399bb20e771e965,1,6,6,12,3,2014-09-22 10:25:07,2014-09-22 10:25:07
9790598b143b45f8f5b3d36c41a9cecc41916886...eb819c1e4fee9dc26e162657d31da54bb0731c2b,1,4,4,8,4,2014-09-19 11:39:49,2014-09-19 11:39:49
9790598b143b45f8f5b3d36c41a9cecc41916886...9a1fe30682900daeebf34bae3a7a725d69426308,1,1,1,2,1,2014-09-19 09:17:22,2014-09-19 09:17:22
e2073f286e1eceb961795af5ea88a39b440e49ac...1c9d2e39c1aef8e10ebff6e57c174c197a3a1c93,7,70,12,82,7,2014-10-02 08:58:02,2014-09-15 07:10:35
efcac2befc8d890c61dec434e238520ab401fa46...106a5d95148032f8a933b1ef1388eef27a4089f1,1,4,4,8,1,2014-09-30 06:56:16,2014-09-30 06:56:16
efcac2befc8d890c61dec434e238520ab401fa46...31abf76840c5cb8f0713180e3ec39bd06428de1b,1,12,2,14,1,2014-09-30 03:58:21,2014-09-30 03:50:00
efcac2befc8d890c61dec434e238520ab401fa46...bc3137ac4961f5f763fe8db2b5bb43bccfa34258,1,2,1,3,1,2014-09-29 18:35:41,2014-09-29 18:35:41
bc3137ac4961f5f763fe8db2b5bb43bccfa34258...adf04082299a37bc953d93a4d38f9b8c24cc307d,1,1,1,2,1,2014-10-01 17:07:28,2014-10-01 17:07:28
57c0d9ec46c9ab2a229d0f212547611c6b3446ce...e145f46a930b932ebc3ff70f75d69f45573cbad9,2,6,8,14,6,2014-09-30 08:56:48,2014-09-30 08:56:48
57c0d9ec46c9ab2a229d0f212547611c6b3446ce...5601b87b3113e3e072c4f7b0fc159816ccb05fb7,2,3,3,6,3,2014-09-30 08:34:19,2014-09-30 08:34:19
57c0d9ec46c9ab2a229d0f212547611c6b3446ce...63033faa3aa1d8b173f3644c53385bf589a1cc00,1,2,2,4,2,2014-09-30 08:28:30,2014-09-30 08:28:30
63033faa3aa1d8b173f3644c53385bf589a1cc00...b80e81eb28a364490cedc348ce3c1559cd8185af,1,0,0,0,0,2014-09-30 08:29:11,2014-09-30 08:29:11
aa46a15d2adaa018b7d8c59e6def2643fb2acab1...6d0ddf45bada832a315d7f84b3cafd1a92beff34,8,139,22,161,8,2014-09-26 17:32:44,2014-09-26 17:32:44
6d0ddf45bada832a315d7f84b3cafd1a92beff34...3a8cd1fa59dc9d3ab0b00e0f01276e73b35a996c,3,58,32,90,7,2014-09-29 09:05:17,2014-09-29 09:05:17
3a8cd1fa59dc9d3ab0b00e0f01276e73b35a996c...83a21c33f12bfb2dc2059a3d528a0458db147cf9,2,16,1,17,4,2014-09-29 09:11:53,2014-09-29 09:11:53
c2c41fb2d3b6b5934ff26cec77c15f6c45351018...a92f48f6154335669787eeb9167bcdb335bff97a,6,0,24,24,6,2014-09-28 11:44:04,2014-09-28 11:44:04
e9171fea85fa15c9ecb5a974afe3ec38a78cdd2e...2edf212a8be3bb14b844b542df587b6029897fe6,3,9,4,13,5,2014-11-02 23:51:34,2014-11-01 23:14:42
1b1403804e03db3cea3ad6a84dcfead449ed29d5...0b1084a4538bc46684c8620410988d3b1093e7ab,3,40,14,54,15,2014-11-05 11:35:33,2014-11-03 23:50:07
1b1403804e03db3cea3ad6a84dcfead449ed29d5...a56d0d47db5b11787472fbed37f23c60bf0e57fe,1,1,1,2,1,2014-11-04 10:16:53,2014-11-04 10:16:53
1b1403804e03db3cea3ad6a84dcfead449ed29d5...71ed0ab06974d0bc72ad737645c35facf2b01c31,3,11,5,16,6,2014-11-03 19:37:47,2014-11-03 19:02:12
1b1403804e03db3cea3ad6a84dcfead449ed29d5...c3be1517ae3c576f7f4248b82b611a833fe06675,6,12,7,19,8,2014-11-03 19:37:08,2014-11-03 19:35:06
1b1403804e03db3cea3ad6a84dcfead449ed29d5...c49cb40f65d75a54c8471cb5207512ec145593cc,2,0,5,5,2,2014-11-03 19:17:02,2014-11-03 19:17:02
d59192f81dba7e5ed3b03ffae844c297861b316d...85f1e8b84a7aab0b3ca116ccf1b5f795e9a2af82,1,0,7,7,1,2014-10-10 03:33:29,2014-10-10 03:33:29
66dd61ef0f1f98f860bdef5aa2cdb1c6f2e1f83f...5b2a42a091b2300ae1962b158b1496ac160c9e0f,2,41,7,48,4,2014-10-12 19:52:17,2014-10-12 02:17:02
5b2a42a091b2300ae1962b158b1496ac160c9e0f...b3c70d001d7371e8952cd7be879e727b5ee4155a,3,78,11,89,10,2014-10-13 04:56:56,2014-10-13 04:07:18
367d4db4cd335cfa3145f7cc501b82ce63d0adb4...2d187976be893a764aea9699e6b5a1cb15c34d84,3,43,35,78,12,2014-10-27 17:28:36,2014-10-21 22:19:16
72abe9f679043a1ac566f60109b21cadace204d7...93e8a0563da89a59e35a876788d0a8bd442640da,3,29,23,52,10,2014-10-21 19:55:44,2014-10-21 08:40:36
72abe9f679043a1ac566f60109b21cadace204d7...3a47ed979a62e91fdcd7d05ebb309759788a23b6,4,15,28,43,6,2014-10-20 22:25:44,2014-10-20 22:25:44
72abe9f679043a1ac566f60109b21cadace204d7...01db264ffcaaa5579c63b1d33f97d446cc726c3e,4,10,21,31,4,2014-10-20 21:57:46,2014-10-20 21:29:49
72abe9f679043a1ac566f60109b21cadace204d7...f7d01f2067048e2dbdff14ef081a66d89316824c,3,8,12,20,3,2014-10-20 21:43:51,2014-10-20 21:43:51
72abe9f679043a1ac566f60109b21cadace204d7...c0c8dccf2e36c269cfb26b31b86cf60d262c4843,27,29,84,113,53,2014-10-20 21:03:33,2014-10-20 20:48:07
72abe9f679043a1ac566f60109b21cadace204d7...5ed7c20150928194306ad51263b6a9b7fb4b4cfd,1,1,1,2,1,2014-10-20 14:22:39,2014-10-20 14:22:39
72abe9f679043a1ac566f60109b21cadace204d7...1768e3eccb91689405e411a3ebcb2622e16dcdd8,1,8,1,9,2,2014-10-20 14:18:45,2014-10-20 14:18:45
1768e3eccb91689405e411a3ebcb2622e16dcdd8...0b78bd7a42a341bb227fb544b5b12abf8e152a41,1,12,3,15,5,2014-10-20 14:22:36,2014-10-20 14:22:36
0b78bd7a42a341bb227fb544b5b12abf8e152a41...46cdb931d8a48febd459cf932b6e7c7b626ec452,1,0,9,9,2,2014-10-20 14:41:28,2014-10-20 14:41:28
46cdb931d8a48febd459cf932b6e7c7b626ec452...b1b6761e05de0b675e31fb227939fff36618a282,1,89,0,89,1,2014-10-20 14:41:37,2014-10-20 14:41:37
b31535494e5e9d13a3643809c7699c9f6e512d21...732e6c3dbb2a249ec486ece5646eb5fbe46e8680,1,1,1,2,1,2014-10-15 09:03:27,2014-10-15 09:03:27
3f1c95c6384ef69aaae9d0b30a50395c31d1196a...e8e022daecd78b25fd7608cf5fd5476397f1db96,2,5,1,6,2,2014-10-15 14:29:05,2014-10-15 14:29:05
a1dda564b19ed268a8019a9ac814933ac309a92b...3c9bf8a322be062c1a07483927deb1415f517547,1,1,0,1,1,2014-10-30 22:41:45,2014-10-30 22:41:45
d4180875cbd361b0b3905fac08c94ff5931695a9...36361f4e451cdd84482d7b4fb2477f1f2c4cdd6b,1,5,4,9,1,2014-08-29 09:58:47,2014-08-29 09:58:15
d4180875cbd361b0b3905fac08c94ff5931695a9...185e7681d2357396f9d5fa70414d5597a78c9008,2,19,20,39,2,2014-08-29 09:38:21,2014-08-29 09:38:21
d4180875cbd361b0b3905fac08c94ff5931695a9...68fd66c6e3ba6f5458526fa6461735b6ee610b78,2,16,2,18,2,2014-08-28 18:33:41,2014-08-28 18:33:41
e38081e55b6ef37e0272ffeb14658757e8d6aff0...c9054319c8f64e7f91cf062e36434da78979fa76,1,1,1,2,1,2014-08-27 15:21:54,2014-08-27 15:21:54
e38081e55b6ef37e0272ffeb14658757e8d6aff0...5aee89d08c352381a31cc67e747ab0209e35c6a1,1,4,3,7,1,2014-08-27 15:04:20,2014-08-27 15:04:20
5aee89d08c352381a31cc67e747ab0209e35c6a1...d771253bdbad9f5de3923fbd3f075019dce13fcf,2,14,4,18,2,2014-09-17 17:37:41,2014-09-17 17:37:41
230c52f76a346832a1be4b87461ebf2fd4d7c905...06fade7545c9006ed7d83b22ef4d0c58296dc560,1,1,2,3,1,2014-08-22 17:10:07,2014-08-22 17:10:07
230c52f76a346832a1be4b87461ebf2fd4d7c905...8ed7391cb03ebf47efeb5ce5379eb667a3f22676,1,1,1,2,1,2014-08-22 15:40:25,2014-08-22 15:40:25
a756fd1ff6a7112ae60b4e738fb70013a5657a47...a7e071e9822a9803e9d686484298170dade5beb5,6,36,33,69,19,2014-10-13 11:39:54,2014-10-13 11:39:54
a7e071e9822a9803e9d686484298170dade5beb5...3cd5abf635d32af0aed5f4160707ee3e10938ab6,1,75,38,113,2,2014-10-13 11:56:54,2014-10-13 11:48:22
3cd5abf635d32af0aed5f4160707ee3e10938ab6...e1cf9c15eb38cd830a52de41b9c242add0b76767,3,36,16,52,5,2014-10-13 12:04:10,2014-10-13 12:04:10
cc778b0a2775997d2615c714c16aaa42197c7111...09352d1f040df68bbabcbd0ebaf6b8bb7627ce32,4,51,17,68,17,2014-09-29 14:10:32,2014-09-29 14:10:32
09352d1f040df68bbabcbd0ebaf6b8bb7627ce32...17ad28f3c664006a9f91c16b8b9bcae6d12ae7c6,1,0,0,0,0,2014-09-29 14:13:02,2014-09-29 14:13:02
731619ac5c7cc0ef494554cb770a54be0596175d...dcf9abc1b1550c79c40d744cfac8cc138f204369,1,1,1,2,1,2013-09-22 08:45:19,2013-09-22 08:45:19
731619ac5c7cc0ef494554cb770a54be0596175d...1a5cde17ac80c112428eb089aa7a7d4d88461128,2,7,3,10,4,2013-09-21 18:34:14,2013-09-21 18:33:34
1a5cde17ac80c112428eb089aa7a7d4d88461128...5367e42bd663cd8a66b364a2ce08c22a83800feb,1,2,2,4,1,2013-09-21 18:59:46,2013-09-21 18:59:46
089f0000cae2d49aa7f031e628a6d9e66db69fec...4fcc17e6673b271992a9d4a5106f8bd64cfe86b1,2,108,1,109,3,2013-09-23 00:25:47,2013-09-12 20:27:51
4fcc17e6673b271992a9d4a5106f8bd64cfe86b1...75b2ff8f43d52c76d4d4eaac37618295b5046cc6,1,5,46,51,6,2013-09-23 00:25:47,2013-09-16 04:40:21
75b2ff8f43d52c76d4d4eaac37618295b5046cc6...8a8123a3d4d3a5f991ae599e454b99fd548d47f2,2,8,4,12,3,2013-09-23 00:56:17,2013-09-23 00:25:10
6182f1cabf08e75b01146198cbd09fdea0bfdb67...2fa36ddd9c9efcc4f0d40755f535867573a0483c,1,1,1,2,1,2015-01-27 19:32:28,2015-01-27 19:32:28
2fa36ddd9c9efcc4f0d40755f535867573a0483c...e956066d4a9c3f556a52f80acfb5c761aede7c6c,3,28,0,28,3,2015-01-27 20:19:32,2015-01-27 20:19:32
94381704d1e739aa61fb60131bcfe12f918d7f74...b35f1d1c2f8741e777a670e06785b6ff47e7e764,1,2,1,3,2,2015-01-27 20:47:39,2015-01-27 20:45:31
9220e3ef18dfaa9fed0e016b667d1b8c862cc5df...af67d58fa423be4a0b97e587e660aeece39c0828,1,1,1,2,1,2014-06-18 11:24:49,2014-06-18 11:24:49
af67d58fa423be4a0b97e587e660aeece39c0828...ca1248fb2e348b398b6d6e70a4d4db4dd771c2cf,1,1,1,2,1,2014-06-18 11:27:55,2014-06-18 11:27:55
9220e3ef18dfaa9fed0e016b667d1b8c862cc5df...0014326ded8164bbbd12f8411c622d4ee9a1952f,1,2,2,4,2,2014-06-16 11:26:38,2014-06-16 11:26:38
0014326ded8164bbbd12f8411c622d4ee9a1952f...a6549118b51b95e16cf8342cc35b5126dfba1c88,1,2,0,2,1,2014-06-16 14:23:38,2014-06-16 14:23:38
a6549118b51b95e16cf8342cc35b5126dfba1c88...3e3396365d6b477a06584b7149f1b816996ac4b1,2,3,3,6,3,2014-06-16 14:25:45,2014-06-16 14:25:45
9220e3ef18dfaa9fed0e016b667d1b8c862cc5df...4ea7b192d4de3b670829b817914f26c943cc286c,2,4,5,9,4,2014-06-16 10:08:23,2014-06-16 10:08:23
2fc6f8f2cb18a441b777d35c21f5e6d1f066a4d6...4f61061cfbf5a3917442c7e0a971099cf0f9a0a9,3,11,5,16,5,2014-09-22 13:02:46,2014-09-22 13:02:46
2fc6f8f2cb18a441b777d35c21f5e6d1f066a4d6...88d3da19f928002d9857162cd5e3fc0939317429,1,1,1,2,1,2014-09-22 12:35:51,2014-09-22 12:35:51
88d3da19f928002d9857162cd5e3fc0939317429...457caaae49c9a228fb0711e8371dc520401e92e9,2,4,4,8,4,2014-09-22 12:50:06,2014-09-22 12:50:06
0c29cb3451414d21346894c140a17c53de6e1567...f7aba277e7971668172196da74f946e5a48aabc3,4,25,1,26,4,2014-09-30 10:07:31,2014-09-30 10:07:31
0c29cb3451414d21346894c140a17c53de6e1567...794078a32a4f1048c28098bdfd122f0af46161df,1,2,0,2,2,2014-09-30 10:03:36,2014-09-30 10:02:37
794078a32a4f1048c28098bdfd122f0af46161df...b5d2d3d799ecc0bb036c3015ae47346cdf985df5,1,10,25,35,9,2014-09-30 10:03:44,2014-09-30 10:03:44
b5d2d3d799ecc0bb036c3015ae47346cdf985df5...f778387e38a76283f255bb7c18166d44ac5d677d,1,1,0,1,1,2014-09-30 10:05:07,2014-09-30 10:05:07
c20c2c83859bf7ba699c085a1baf0ee1f1a6da7a...75eacf4d4469fb533f60f573733d47a42d3ad7e0,2,4,4,8,4,2014-09-30 09:28:43,2014-09-30 09:28:43
ff2b0bfabd0607f3d3fea1ae9c8282e112239daa...31e50ed3e4884f6bbff5264edd2a1f8f8c963864,1,61,48,109,11,2014-09-30 11:32:38,2014-09-30 11:32:38
31e50ed3e4884f6bbff5264edd2a1f8f8c963864...49157242edd4dc871b0f1b3b3625f82b98b3806b,1,9,0,9,1,2014-09-30 12:27:28,2014-09-30 12:27:28
49157242edd4dc871b0f1b3b3625f82b98b3806b...65cb51af3168ce0abceddfe234077ecb1729ac76,2,22,7,29,4,2014-09-30 12:59:30,2014-09-30 12:59:30
65cb51af3168ce0abceddfe234077ecb1729ac76...ae88a9bfea17095c3e3215969edf5e8d6918bf6b,1,1,0,1,1,2014-09-30 13:12:20,2014-09-30 13:12:20
477214cdc6b696a083ece7735801116f2c8bbc26...05b3202855216d82bee5b0d098e1d8f2db45c63c,1,6,5,11,6,2014-09-28 20:56:47,2014-09-28 20:56:47
05b3202855216d82bee5b0d098e1d8f2db45c63c...8b17bdaafc0fc675bc116a24f7e5ce8a593e38f7,1,3,3,6,3,2014-09-29 10:55:15,2014-09-29 10:55:15
477214cdc6b696a083ece7735801116f2c8bbc26...be296633fdc41249b44c1822f094cf2f17e323a4,1,23,14,37,17,2014-09-28 19:23:21,2014-09-28 19:23:21
488081cdea53d6c874510ed8d1376e46794826e6...8ddb2be69a7dfc17bc3819ab78c6fd159b7ff5b4,1,1,1,2,1,2014-10-10 07:38:39,2014-10-10 07:38:39
8ddb2be69a7dfc17bc3819ab78c6fd159b7ff5b4...be14c7a83fa3c591038746a6e94f8de9e5058f04,1,4,3,7,4,2014-10-10 07:44:08,2014-10-10 07:44:08
b956605f9e5f95ded853d3458f0f132dbb5b892a...2b3090d91b6d508cb88feab9c4d32791566bab63,2,2,4,6,6,2014-10-12 21:39:41,2014-10-12 21:39:41
01441f544ecd32d6a820d2908413ff0cb6ff1245...e00e67db42ea3e4b994160dbdc288a8effa14713,2,11,0,11,2,2014-10-28 17:52:21,2014-10-28 17:52:21
e00e67db42ea3e4b994160dbdc288a8effa14713...57471894819c07796d2aa04e5a21d1a648a7751e,1,1,0,1,1,2014-10-29 12:38:43,2014-10-29 12:38:43
381a6283a9d27ccf0a8d43f33ec01b720ec6a1bf...c926922ade4f3f8b84cabe95186860e0f8a6a8f8,2,7,1,8,2,2014-10-15 12:52:39,2014-10-15 12:52:39
a0a826ebdcb783c660dd40d8cb217db28a9d4998...5d7e1b6ae2eab12017c6f6cec9ef6cc96bf2666d,1,6,8,14,3,2014-10-16 06:51:53,2014-10-16 06:51:53
a0a826ebdcb783c660dd40d8cb217db28a9d4998...786045ab81887e132a902190abb62b9747420c17,1,1,1,2,1,2014-10-16 05:03:10,2014-10-16 05:00:17
786045ab81887e132a902190abb62b9747420c17...f2764e566e80b3618f5b8508877b9d52021e9f83,1,3,1,4,1,2014-10-18 05:04:21,2014-10-18 05:04:21
a0a826ebdcb783c660dd40d8cb217db28a9d4998...5700842ba8ca2f3100395a9fb98c759e78e63d96,21,260,141,401,48,2014-10-16 04:52:33,2014-10-15 07:21:21
5700842ba8ca2f3100395a9fb98c759e78e63d96...cd3eabd71236d2be1430d2dbf23aad91d73aa783,3,4,4,8,4,2014-10-17 03:45:13,2014-10-17 03:45:13
cd3eabd71236d2be1430d2dbf23aad91d73aa783...e1491465de441b386c72726f0b869104d1c15680,7,57,39,96,33,2014-10-18 22:58:34,2014-10-17 04:10:50
e1491465de441b386c72726f0b869104d1c15680...e06f0ead9843df2688ca2f341a3b37d4d56a955d,7,45,36,81,31,2014-10-18 23:07:23,2014-10-17 04:36:52
e06f0ead9843df2688ca2f341a3b37d4d56a955d...de53bc9d8470d94ec1b956cc2ea1df077c4d034d,1,7,0,7,1,2014-10-18 23:07:46,2014-10-17 04:38:08
de53bc9d8470d94ec1b956cc2ea1df077c4d034d...f9e423b499795e599d25f76c3ef519cac8ac6db0,1,2,1,3,1,2014-10-18 23:16:20,2014-10-18 23:16:20
f9e423b499795e599d25f76c3ef519cac8ac6db0...74c82ae32583ebf335f310a29ffb22d75b356863,4,10,10,20,7,2014-10-18 23:24:12,2014-10-18 23:24:12
74c82ae32583ebf335f310a29ffb22d75b356863...5bb8aff5ddcc1debb4406303477c1ddbe618d058,2,5,4,9,4,2014-10-18 23:43:45,2014-10-18 23:43:45
5bb8aff5ddcc1debb4406303477c1ddbe618d058...7a5072c5a8f03cd7342a5f8e74e1fde0250ce360,4,15,15,30,15,2014-10-22 04:29:31,2014-10-21 02:53:17
a0a826ebdcb783c660dd40d8cb217db28a9d4998...39c66c822ec955205aa69a7d38b16669f488e8da,4,7,7,14,5,2014-10-15 21:01:31,2014-10-10 09:06:08
a0a826ebdcb783c660dd40d8cb217db28a9d4998...b57ec54fae7f17fad21c564aee1c39625f77ec20,1,1,1,2,1,2014-10-15 17:25:47,2014-10-15 17:25:47
b57ec54fae7f17fad21c564aee1c39625f77ec20...c2bcdeb95090e2344b90e5babe5b68dfba064130,1,3,3,6,1,2014-10-15 17:52:39,2014-10-15 17:52:39
36361f4e451cdd84482d7b4fb2477f1f2c4cdd6b...01520d5d77604a2487b32e79a1d5d80caf136329,3,13,5,18,4,2014-08-29 12:19:35,2014-08-29 12:19:35
36361f4e451cdd84482d7b4fb2477f1f2c4cdd6b...fc7626728834aa2718f960556379ae44f5f81a91,1,4,0,4,1,2014-08-29 11:55:54,2014-08-29 11:55:54
36361f4e451cdd84482d7b4fb2477f1f2c4cdd6b...6840a276d51962cf5c4e1111994cefd9843f16c0,3,0,0,0,0,2014-08-29 11:49:01,2014-08-29 11:49:01
6840a276d51962cf5c4e1111994cefd9843f16c0...97547428bd481b984a4c5513931617db0d890ee5,1,0,0,0,0,2014-08-29 14:04:00,2014-08-29 14:04:00
97547428bd481b984a4c5513931617db0d890ee5...0d5ae2802e887dcd95fe537a59450a2c0f548382,4,3,2,5,2,2014-08-29 15:30:42,2014-08-29 15:29:42
d5be6d90bc53a6dfb11ece1f5f32e1746091199a...49313946da68b336706c68b76760e5c0036d9726,1,0,1,1,1,2014-08-29 12:26:24,2014-08-29 12:26:24
c9054319c8f64e7f91cf062e36434da78979fa76...75b0ef82ba81ae6892cb14756fee2500b8b2d56f,1,4,1,5,1,2014-08-29 22:56:26,2014-08-29 22:56:26
75b0ef82ba81ae6892cb14756fee2500b8b2d56f...893bd8aceca731ebe3124cebe6c7a09adc17b971,1,6,1,7,1,2014-09-05 22:35:46,2014-09-05 22:35:46
c9054319c8f64e7f91cf062e36434da78979fa76...1056d91c67750e11973064932de28d49ea1debec,11,68,74,142,12,2014-08-28 08:06:19,2014-08-28 08:06:19
c9054319c8f64e7f91cf062e36434da78979fa76...6f154c07c8d1d479e2b7a2b69c91dd12362fa918,1,2,4,6,3,2014-08-28 07:42:52,2014-08-28 07:42:52
c9054319c8f64e7f91cf062e36434da78979fa76...63e25c2bb40d8e85897a50c94301511553b4a266,1,6,0,6,1,2014-08-27 20:12:37,2014-08-27 20:08:40
06fade7545c9006ed7d83b22ef4d0c58296dc560...5418c6174735ee7b9202a4a751996fbaa641469a,1,2,2,4,2,2014-08-22 18:36:03,2014-08-22 18:36:03
6c0994a3b3197fe177ac804b0cd25096ff478263...01b791237cf6a1b7deaee3da3df6541e0b5107d1,8,262,130,392,41,2014-10-13 15:24:05,2014-10-13 15:24:05
01b791237cf6a1b7deaee3da3df6541e0b5107d1...5e1c39cb783843163edf47718fa6d39b4ebb52e1,5,31,24,55,10,2014-10-13 15:33:44,2014-10-13 15:33:44
5e1c39cb783843163edf47718fa6d39b4ebb52e1...410d6e306b04a4bfd321996e1e6548032f8f8b85,1,0,8,8,1,2014-10-14 06:54:15,2014-10-14 06:54:15
410d6e306b04a4bfd321996e1e6548032f8f8b85...93505f7d04cfbbc9565dc5759dbeb768515520e7,1,2,4,6,1,2014-10-14 07:05:29,2014-10-14 07:05:29
93505f7d04cfbbc9565dc5759dbeb768515520e7...fc5bfd1dc1c963d018d4de61b03c5ba28aafcd18,2,5,4,9,2,2014-10-14 07:31:06,2014-10-14 07:22:59
fc5bfd1dc1c963d018d4de61b03c5ba28aafcd18...23b692c701f0d310d6069fc74656f2bfdfdfc360,2,73,0,73,2,2014-10-14 07:31:38,2014-10-14 07:31:38
23b692c701f0d310d6069fc74656f2bfdfdfc360...b229b0f00327b210374d847b57760757fdcd8ee3,2,5,1,6,2,2014-10-14 07:40:35,2014-10-14 07:40:35
b229b0f00327b210374d847b57760757fdcd8ee3...d3056feb119de28a0e7333f80ee6d42ecf690dc5,1,9,8,17,2,2014-10-14 08:08:47,2014-10-14 08:08:47
d3056feb119de28a0e7333f80ee6d42ecf690dc5...18d2ee31e81e617a4c860359cb29f9118b8a3e70,1,1,1,2,1,2014-10-14 08:54:43,2014-10-14 08:54:43
18d2ee31e81e617a4c860359cb29f9118b8a3e70...ab04096c6cf5ff340b17df56afeae9782464742d,1,2,0,2,1,2014-10-14 09:16:47,2014-10-14 09:14:57
ab04096c6cf5ff340b17df56afeae9782464742d...9bf7bfda20a466b375a459b95068de8c0139fc9a,2,0,12,12,2,2014-10-14 10:09:24,2014-10-14 10:09:24
9bf7bfda20a466b375a459b95068de8c0139fc9a...6ce65a3e950532e8fb65cf188eb5df9a6eddfb39,7,29,29,58,14,2014-10-14 11:13:59,2014-10-14 11:11:53
6ce65a3e950532e8fb65cf188eb5df9a6eddfb39...fedb223b09f001f0a977c9d89130459c417347f2,1,1,2,3,1,2014-10-14 11:52:15,2014-10-14 11:52:15
fedb223b09f001f0a977c9d89130459c417347f2...b4f7b387d0dfaef1766a82040249abb933632930,1,10,12,22,3,2014-10-14 13:03:53,2014-10-14 13:03:53
5367e42bd663cd8a66b364a2ce08c22a83800feb...8fb83bc81e9410d84ec61158743336e85dba3c4e,1,2,2,4,2,2013-09-22 08:48:04,2013-09-22 08:48:04
5367e42bd663cd8a66b364a2ce08c22a83800feb...51e6095dd16a02c67966cea5de51a2c2ec81d9d6,4,22,10,32,7,2013-09-22 05:05:14,2013-09-16 17:31:22
51e6095dd16a02c67966cea5de51a2c2ec81d9d6...fcba0d55f483248022ca6c85faf33c5b4202dd9a,2,2,2,4,2,2013-09-22 05:06:22,2013-09-22 05:06:22
5367e42bd663cd8a66b364a2ce08c22a83800feb...d426195df876ad6d76e6d79d3031e8da95fb532a,2,27,27,54,27,2013-09-21 23:21:22,2013-09-21 21:46:36
0630be3828998af1261b87ae85b42c0ef9a439ed...642398285d21221186ad988198e85a5b60838f86,4,59,19,78,8,2013-09-24 07:48:36,2013-09-24 07:48:36
0630be3828998af1261b87ae85b42c0ef9a439ed...4cfbfbb845680f2df67110ca15f2479cba8e2441,3,73,20,93,6,2013-09-23 23:36:25,2013-09-22 04:50:18
4cfbfbb845680f2df67110ca15f2479cba8e2441...9d06921ffb2082cdcb6bcce3e420d53011a3b71d,1,15,0,15,1,2013-09-23 23:36:39,2013-09-23 23:18:29
9d06921ffb2082cdcb6bcce3e420d53011a3b71d...04c7c262a7be469a4ae4865464b003c4b522a895,2,6,8,14,4,2013-09-24 13:22:46,2013-09-24 13:22:46
0630be3828998af1261b87ae85b42c0ef9a439ed...95beea7e62877bdd5295ebf9b6dbef70c0afaa69,1,1,0,1,1,2013-09-23 18:09:29,2013-09-23 18:09:29
0630be3828998af1261b87ae85b42c0ef9a439ed...5fba1d95fd2901446aed8aef7f86708da1075b79,1,1,1,2,1,2013-09-23 16:41:26,2013-09-23 16:41:26
6a73124df230594b7ce5d516977d6074a027a914...085a93d4a513dd661d57f2a9a5141e2c6b5680a2,1,1,1,2,1,2014-06-16 19:31:15,2014-06-16 19:31:15
c1ff1fdeff2692bfb0d3210709aa2df1421f0516...e0c725c55f4cb3a70246f2eb3a28be7a0ca8b3a8,1,8,5,13,2,2014-06-18 14:18:38,2014-06-18 14:18:38
c1ff1fdeff2692bfb0d3210709aa2df1421f0516...780d868fec936327cbdf688cf6e2571b07d780c9,11,80,142,222,43,2014-06-18 11:41:12,2014-06-18 11:41:12
a04f0e5b3dece759bc82d89d32a4cadb67e6bb71...acf4d039f504b15e19e39d3e92edd97319c5967e,1,1,1,2,1,2014-09-22 15:08:16,2014-09-22 15:08:16
1099468b320136c4c26816f281e956666a3b628e...6614957aa638009a026148f1bd14aece1ebd1fa6,1,13,12,25,2,2014-10-01 18:59:06,2014-10-01 18:59:06
73b92f85bcd6c213b845cc997843a969cf0906cf...0ca85051145424795a2e123fab36a721648553ff,1,1,1,2,1,2014-10-01 07:55:47,2014-10-01 07:49:46
0ca85051145424795a2e123fab36a721648553ff...2ac1f95ba1be7b8954dfdeef596770ea746b3cfe,4,5,5,10,5,2014-10-01 07:56:04,2014-10-01 07:53:12
2ac1f95ba1be7b8954dfdeef596770ea746b3cfe...3dde6bb3fa74238df0e1a2bbf4077852a9fd0bdb,1,4,1,5,2,2014-10-01 07:57:10,2014-10-01 07:54:54
0e183aa721b1628579810b322533dbd86fa202ee...99a7bf882328ac8a0664c1be88593828a20f8fb5,1,7,0,7,1,2014-09-30 12:54:21,2014-09-30 12:54:21
99a7bf882328ac8a0664c1be88593828a20f8fb5...6fa81e5d58b29f485a449cf896e0bb31d83a6ad1,1,1,1,2,1,2014-09-30 12:55:03,2014-09-30 12:55:03
6fa81e5d58b29f485a449cf896e0bb31d83a6ad1...2b88c9cd15d79ff755cea501d5d6fb511538de73,2,3,3,6,3,2014-09-30 13:54:56,2014-09-30 13:54:56
88d3e97e502f0be4f01fed100a06e04b2e0f2017...6bae8c48ef83cf45984930c57282903cbff506ad,1,1,2,3,1,2014-10-01 11:19:40,2014-08-16 09:53:44
88d3e97e502f0be4f01fed100a06e04b2e0f2017...64d7761e2898e8270706eae6105d13f29daee5ec,1,0,0,0,0,2014-10-01 09:44:40,2014-10-01 09:44:40
88d3e97e502f0be4f01fed100a06e04b2e0f2017...6294033024d311efa14a9400eb0b8815c702fc44,14,14,14,28,14,2014-10-01 09:12:56,2014-09-26 14:57:36
88d3e97e502f0be4f01fed100a06e04b2e0f2017...f030ee846ed39c5e0a326e8ba117ec79f40e230d,4,103,0,103,4,2014-10-01 08:27:48,2014-10-01 08:20:40
88d3e97e502f0be4f01fed100a06e04b2e0f2017...e2e4dc5942221f37713c3414e1811cc85dfaeab9,1,1,1,2,1,2014-10-01 07:04:25,2014-09-27 20:05:02
88d3e97e502f0be4f01fed100a06e04b2e0f2017...b7160cb752fdb942b11e7ac4f9d158bed5ee2ecc,1,1,1,2,1,2014-10-01 07:04:10,2014-09-27 14:46:20
88d3e97e502f0be4f01fed100a06e04b2e0f2017...5f10ef7c0992b6d61e06114254f4f317cd44cd61,1,1,2,3,1,2014-10-01 07:03:58,2014-09-27 14:34:46
88d3e97e502f0be4f01fed100a06e04b2e0f2017...9567778f9446a738090f4fa1c6ceea9daa26f7a4,1,39,6,45,7,2014-10-01 06:56:04,2014-09-29 14:50:20
0e8e9e5d77478294288d34474e580916418ddd91...e1f6fa6f18afa8461cd82a56250222c2972c7785,6,139,4,143,7,2014-09-29 13:03:08,2014-09-29 13:02:39
376e004c16510174dd29ab2953ebdbb28ce2e91b...da4eff4addb89caa8afebf7ec9fb836864a9255e,1,10,9,19,1,2014-09-29 12:48:05,2014-09-29 12:48:05
376e004c16510174dd29ab2953ebdbb28ce2e91b...1ba26184eb3ff6131580dabb655a82090a1220da,1,18,0,18,1,2014-09-29 11:55:31,2014-09-29 11:55:31
376e004c16510174dd29ab2953ebdbb28ce2e91b...44bc5fe5d69953278aa6ce84c55a72dab49761cf,1,3,1,4,1,2014-09-29 11:40:36,2014-09-29 11:40:36
376e004c16510174dd29ab2953ebdbb28ce2e91b...a963e8c293568c865f03df8da4edf7bb450b4814,1,12,10,22,1,2014-09-29 11:38:54,2014-09-29 11:33:26
b23b78ada12d1bbff4ea4e4bf65a34b223aeb8b4...776bca07cd4b3996a39035e90232c99599ed2663,10,218,3,221,13,2014-10-28 10:20:36,2014-10-16 16:34:19
9c824888c899393b5d72afe18b8bb0a134beec67...4e0da2325b689221cb7f675648380fcbc2a9a492,5,70,11,81,6,2014-10-13 13:07:57,2014-10-10 12:15:34
9c824888c899393b5d72afe18b8bb0a134beec67...f7342ce56764aaf6465bca74239955778c25107b,1,6,0,6,1,2014-10-10 13:17:00,2014-10-10 13:17:00
9c824888c899393b5d72afe18b8bb0a134beec67...0189be0831350a5d473884a5b454a10509ff58ce,15,28,21,49,21,2014-10-10 12:39:48,2014-10-10 12:39:48
0189be0831350a5d473884a5b454a10509ff58ce...200118357de47c6db69a48eac2b488bfb46e9026,1,1,1,2,1,2014-10-10 12:44:27,2014-10-10 12:44:27
200118357de47c6db69a48eac2b488bfb46e9026...daa55f31d899819069ddbaa9596769a233b5a729,1,2,0,2,1,2014-10-10 12:58:11,2014-10-10 12:58:11
daa55f31d899819069ddbaa9596769a233b5a729...ea04ed7879ad7177bef7a6dbe3bf90d76ebb8b45,5,11,5,16,7,2014-10-10 13:30:14,2014-10-10 13:30:14
ea04ed7879ad7177bef7a6dbe3bf90d76ebb8b45...0852d5e480e2789dcc6b5cce08fc0875f97af4bf,1,2,2,4,2,2014-10-10 13:36:06,2014-10-10 13:36:06
0852d5e480e2789dcc6b5cce08fc0875f97af4bf...8c01448cf9ffb3662ebd22e02077e48ba59c65ca,1,7,1,8,1,2014-10-10 14:39:29,2014-10-10 14:39:29
8c01448cf9ffb3662ebd22e02077e48ba59c65ca...b2d1e97df99dfdda65d5411de76dd34091d6be3e,1,1,1,2,1,2014-10-10 15:42:05,2014-10-10 15:42:05
b2d1e97df99dfdda65d5411de76dd34091d6be3e...b02c21df5cc0dcc795f71f8c11d05d61dc2ad897,1,1,1,2,1,2014-10-12 18:49:20,2014-10-12 18:49:20
9c824888c899393b5d72afe18b8bb0a134beec67...d059f50d4c232903440dcf2adc4f26e3ffb3099f,7,187,159,346,45,2014-10-10 10:03:32,2014-10-10 10:03:32
05922e71f45670a1b75d8b700bf894258c79fcd7...077fc683faa85f9abe4cc40ea1c7877e6b6c1f2a,1,1,2,3,1,2014-10-16 21:34:03,2014-10-16 21:34:03
05922e71f45670a1b75d8b700bf894258c79fcd7...761c2a64cc651e2239aac65c6ebd81d17f444703,1,7,0,7,1,2014-10-16 11:02:24,2014-10-16 11:02:24
05922e71f45670a1b75d8b700bf894258c79fcd7...92c184a57f7698e79288b380cebc68b839afb4f5,1,6,2,8,3,2014-10-16 09:46:40,2014-10-16 09:46:40
8aca1ff0034c34590828df265a933d45fa7c95a4...47ac48c03127b62212108442a8e61f41a7cee6ec,1,1,1,2,1,2014-08-29 13:38:05,2014-08-12 15:43:02
47ac48c03127b62212108442a8e61f41a7cee6ec...614ca3ec6568f67883c914d43fd37a5758a8ed5b,2,1,28,29,3,2014-08-29 13:38:05,2014-08-12 15:51:56
614ca3ec6568f67883c914d43fd37a5758a8ed5b...1526ddce1af774f5228a86d0c0283ebbb333dadb,1,1,0,1,1,2014-08-29 13:38:51,2014-08-29 13:38:51
db88190636456a84db747a3f9335a55ca9819274...82893089332bc1eb7f36bce8aef5ef19c91164eb,8,104,110,214,27,2014-08-28 11:19:11,2014-08-28 11:19:11
82893089332bc1eb7f36bce8aef5ef19c91164eb...d4a2ef52715438b26a4bfc5ba3684d8c303832c9,3,4,4,8,4,2014-08-28 12:01:37,2014-08-28 12:01:37
d4a2ef52715438b26a4bfc5ba3684d8c303832c9...48f8c5a873b50584fb3fb2af3cd386ab3c03d694,1,2,2,4,1,2014-08-28 12:10:47,2014-08-28 12:10:47
48f8c5a873b50584fb3fb2af3cd386ab3c03d694...2dc4c65aa5215412bf9b8ba361f193860e6bed43,1,1,3,4,1,2014-08-28 12:58:23,2014-08-28 12:58:23
c9bf35817bb3d3f367bdd4eb68df2f830a54da55...7b9a1819f78270d951d5662d24724d8aab3719c9,1,1,0,1,1,2014-08-28 08:54:21,2014-08-28 08:54:21
c9bf35817bb3d3f367bdd4eb68df2f830a54da55...0534d75a842509a30a3cdbea152b64682038002e,1,1,0,1,1,2014-08-28 07:40:05,2014-08-28 07:40:05
0534d75a842509a30a3cdbea152b64682038002e...f9c7f414765f202f843f42e5e23f0d5e6da7d26a,1,1,0,1,1,2014-08-28 08:08:02,2014-08-28 08:08:02
6a0ea920a5735b25f2dbadd00a5238a73600a5a1...40af6f9c23f445ff77f5d82fd3bc86f287374f52,1,1,1,2,1,2014-08-22 20:23:44,2014-08-22 20:23:44
6a0ea920a5735b25f2dbadd00a5238a73600a5a1...e61b491ae1edfa63fbb14a17a605749ef6eab03f,1,9,8,17,9,2014-08-22 20:18:40,2014-08-22 20:18:40
6a0ea920a5735b25f2dbadd00a5238a73600a5a1...47b5b3d5fad0bf9a0193e8d01e6c4d9656583a45,1,12,10,22,6,2014-08-22 19:46:12,2014-08-22 19:46:12
47b5b3d5fad0bf9a0193e8d01e6c4d9656583a45...18ec2f93a6c8a1cb783af1522f198668481d2384,1,1,1,2,1,2014-08-22 19:49:39,2014-08-22 19:49:39
05fca6bfc2d045e7e144baec28a6596e618ecb4b...fc6a291af3fb849ea590481d7df359fe37798458,1,1,1,2,1,2014-10-13 14:26:35,2014-10-13 14:26:35
2d842b61af824d874895d5bb1b77453bb44a0e31...331a4675feda69ae5c341d2d8c5b386ec58f6562,2,3,3,6,3,2014-09-29 15:10:41,2014-09-29 15:10:41
3f0f30d04d47d52fed824738759e4d596adc0b4e...3d2ec9fe0040904214f765962dc325302d11aca0,1,1,1,2,1,2013-09-22 08:52:42,2013-09-17 05:52:26
550c1828a3c4bc61ae95c9fe123450ab0897e219...9587506124f2a36f9b844da2c9fe17a26fe1daa9,7,31,96,127,13,2013-09-24 09:08:28,2013-09-24 09:08:28
085a93d4a513dd661d57f2a9a5141e2c6b5680a2...b81649135627634956e05bd6fd5276d7342188b5,1,1,1,2,1,2014-09-01 22:16:55,2014-06-24 18:26:31
085a93d4a513dd661d57f2a9a5141e2c6b5680a2...7be80fd89954a248527ca9be4bb9d9c320390811,3,5,4,9,3,2014-06-17 06:27:50,2014-06-17 06:27:50
7be80fd89954a248527ca9be4bb9d9c320390811...e44e2316c3e223955847859492f6f9bd7974e50e,1,1,1,2,1,2014-06-17 06:40:48,2014-06-17 06:40:48
67934145e88e439c4266d6a4f19372f170fc6095...6f7cf8692c266ea27bcfc3d22ddc2eccce4926ef,1,11,11,22,2,2014-06-22 12:03:52,2014-06-22 12:03:52
67934145e88e439c4266d6a4f19372f170fc6095...f3369e3a004ad01176b9191e2cb494866f91b637,3,34,6,40,4,2014-06-19 10:20:42,2014-06-19 10:20:42
67934145e88e439c4266d6a4f19372f170fc6095...bac7d17c7b736e09228857f8c8cce8bf6ba70aa7,1,9,1,10,1,2014-06-19 08:41:23,2014-06-19 08:41:23
67934145e88e439c4266d6a4f19372f170fc6095...98e53b816fb59fdb12b383a72f55c3b93a065463,1,5,1,6,1,2014-06-19 06:22:58,2014-06-19 06:22:58
67934145e88e439c4266d6a4f19372f170fc6095...4e145bd8562da254fa9b7da198c683dc71387c34,3,16,10,26,7,2014-06-18 20:43:33,2014-06-18 20:43:33
4e145bd8562da254fa9b7da198c683dc71387c34...3ee7209a6817b75a1d54dc383cf2e027f77dc18e,2,28,24,52,3,2014-06-18 20:53:19,2014-06-18 20:53:19
3ee7209a6817b75a1d54dc383cf2e027f77dc18e...6a50414c57ad217b1dbd311c7a37b3ab30d470a5,5,5,6,11,5,2014-06-18 21:17:38,2014-06-18 21:17:38
6a50414c57ad217b1dbd311c7a37b3ab30d470a5...2a52be9c3ebedcc8c512f64bb8cccdeebd15dd8a,2,11,2,13,3,2014-06-19 06:58:42,2014-06-19 06:58:42
2a52be9c3ebedcc8c512f64bb8cccdeebd15dd8a...ab5cac7b9a4f5b5dd86db381a5076a461254dfa9,1,9,6,15,4,2014-06-19 07:14:59,2014-06-19 07:14:59
73c1030da1318284495288461210e8d145aa7181...4e894b1dd5a55b23fc43b15cae58fff2e81f47ca,1,0,18,18,1,2014-07-03 10:24:53,2014-06-23 08:49:21
73c1030da1318284495288461210e8d145aa7181...63c1cdce42f140146c2dfac1e49832a33b84b2cf,2,7,2,9,2,2014-06-23 09:54:58,2014-06-23 09:54:58
63c1cdce42f140146c2dfac1e49832a33b84b2cf...185da5f976db725c072d3b738b264a401b73cba6,2,9,5,14,4,2014-06-23 10:28:57,2014-06-23 10:28:57
185da5f976db725c072d3b738b264a401b73cba6...8f0051e2c2250728cc660bd9770ca6f3a70b084a,1,44,0,44,2,2014-06-23 12:02:09,2014-06-23 12:02:09
8f0051e2c2250728cc660bd9770ca6f3a70b084a...4c575b72d542783e889cf11961f33ead7e23cc59,4,49,35,84,8,2014-06-23 13:44:49,2014-06-23 13:44:49
73c1030da1318284495288461210e8d145aa7181...ffece96dd13fc99e24d65f2a374572c218c1f892,5,46,0,46,12,2014-06-23 08:38:22,2014-06-23 08:38:22
ffece96dd13fc99e24d65f2a374572c218c1f892...5e00b7337ba0b9aae279e5dbaa68c4b2c644318d,1,18,0,18,6,2014-06-23 09:06:25,2014-06-23 09:06:25
73c1030da1318284495288461210e8d145aa7181...37425618bc5a15bb58ed6695d4932d309d452cb2,3,13,0,13,3,2014-06-23 07:45:26,2014-06-23 07:45:26
37425618bc5a15bb58ed6695d4932d309d452cb2...d12c1e90f8f3e9454d2a52f40854dadcdb2d822b,3,28,1,29,3,2014-06-23 08:39:56,2014-06-23 08:39:56
73c1030da1318284495288461210e8d145aa7181...9f36888b9945970e8aa14282f0ea70286350679c,1,4,0,4,1,2014-06-23 07:16:38,2014-06-23 07:16:38
9f36888b9945970e8aa14282f0ea70286350679c...882c7b50b81644be8e8e4be5bcf4b5432d9abb14,1,1,1,2,1,2014-06-23 07:50:29,2014-06-23 07:50:29
882c7b50b81644be8e8e4be5bcf4b5432d9abb14...7ed11fded5862bd7c03448e48ba17efdabdbc218,1,1,1,2,1,2014-06-24 06:43:55,2014-06-24 06:43:55
b64351478a6eec7b50ffa6017bc58fefda60c2a7...a1eb1ad1685c88de953ad15c1f48f74b10e4ae3e,1,13,1,14,2,2014-06-19 09:24:59,2014-06-18 14:02:22
a1eb1ad1685c88de953ad15c1f48f74b10e4ae3e...2c3626884efb86ac4477754780e5c5d612e5264e,2,12,0,12,2,2014-06-19 09:24:59,2014-06-18 14:02:38
2c3626884efb86ac4477754780e5c5d612e5264e...26d1bd7c2a285da734ed0b8eab5c31cd5237caa4,7,17,19,36,11,2014-06-19 12:20:25,2014-06-19 12:20:25
26d1bd7c2a285da734ed0b8eab5c31cd5237caa4...db88797ef9e9012238b45857dfcec15a12838305,2,14,1,15,2,2014-06-19 14:51:36,2014-06-19 14:46:01
acf4d039f504b15e19e39d3e92edd97319c5967e...441237eea52bddb357ffb8170a08a7f8d36d2183,1,0,2,2,1,2014-09-22 16:09:49,2014-09-22 16:09:14
acf4d039f504b15e19e39d3e92edd97319c5967e...0b85e2a606d0fba63a72541e60fadcea84c123a6,1,6,5,11,2,2014-09-22 15:15:53,2014-09-15 10:01:30
0b85e2a606d0fba63a72541e60fadcea84c123a6...3a9c294ac0c7e61a6b96c9be3dd757fea49e07db,1,2,1,3,2,2014-09-22 15:15:53,2014-09-16 11:40:58
3a9c294ac0c7e61a6b96c9be3dd757fea49e07db...68bb1701cdf879143a80338eb172049f9cb7f2fd,1,2,2,4,2,2014-09-22 15:15:53,2014-09-18 07:40:02
68bb1701cdf879143a80338eb172049f9cb7f2fd...7d7ba112b6cdeeca9d8f26efca8b1d864c94d13b,1,1,1,2,1,2014-09-22 15:15:53,2014-09-19 08:40:18
7d7ba112b6cdeeca9d8f26efca8b1d864c94d13b...c108839cb9787b3e08afe12cad8d3f4adf24eccc,1,30,24,54,11,2014-09-22 15:26:18,2014-09-22 15:26:18
3dde6bb3fa74238df0e1a2bbf4077852a9fd0bdb...522d754dfee9673befc7e6dc93c8a080eba7ae66,3,3,3,6,3,2014-10-01 08:43:16,2014-10-01 08:43:16
3dde6bb3fa74238df0e1a2bbf4077852a9fd0bdb...b040078974c0226438109ae41418d978074976e0,2,4,0,4,4,2014-10-01 08:41:20,2014-10-01 08:41:20
2b88c9cd15d79ff755cea501d5d6fb511538de73...0d4ae0e392b3ea5c5ff3b0fd37725cdc07a70191,6,36,31,67,23,2014-09-30 21:32:03,2014-09-29 21:11:30
2b88c9cd15d79ff755cea501d5d6fb511538de73...083f1e2f13e546e973cf7304adb00c81b1423ba6,1,7,8,15,1,2014-09-30 21:23:18,2014-09-29 11:26:09
2b88c9cd15d79ff755cea501d5d6fb511538de73...0c84ffad1c2d1e10e255d832fa16b7eb097f566c,1,2,1,3,1,2014-09-30 19:15:33,2014-09-30 19:15:33
2b88c9cd15d79ff755cea501d5d6fb511538de73...04b7dd038c636dd62a4a2edeaa97bc063663c130,1,2,1,3,1,2014-09-30 19:11:21,2014-09-30 19:08:04
2b88c9cd15d79ff755cea501d5d6fb511538de73...dc7311abd23de082a123e33ae9b7bd7754a1726b,1,2,1,3,1,2014-09-30 19:05:33,2014-09-30 19:05:33
2b88c9cd15d79ff755cea501d5d6fb511538de73...789b42759270afae22422ae2bcda1083a46d8b60,1,1,1,2,1,2014-09-30 15:34:46,2014-09-30 15:34:46
2b88c9cd15d79ff755cea501d5d6fb511538de73...6fd00826d2f756bda6bd65928ae7b5d565903ebf,1,11,11,22,10,2014-09-30 15:07:21,2014-09-30 15:07:21
6fd00826d2f756bda6bd65928ae7b5d565903ebf...63377c9ba570ad71666cdd88cc776cd9c3d92231,1,4,0,4,2,2014-10-01 14:40:30,2014-10-01 14:40:30
63377c9ba570ad71666cdd88cc776cd9c3d92231...dae670bd693cbfc19cbef1258d228534cfd0ad7e,7,7,7,14,7,2014-10-01 15:30:40,2014-10-01 15:30:40
2b88c9cd15d79ff755cea501d5d6fb511538de73...6aa0448f7655a5e6f4f7e485a20b91f306f14931,3,22,22,44,22,2014-09-30 14:41:48,2014-09-30 14:41:48
ca1c35aa51f8350c09f7a0a42bbf0008941bf1b3...60a33d649f8de6a55b7f302cbcaf6ae84c99fb57,2,2,0,2,1,2014-10-01 13:30:29,2014-10-01 13:30:29
9654cbb5924c968cdefcb83732b313c54fe292d1...693cee89f9262c6ca17248ee7a99db171c354abd,2,4,1,5,3,2014-09-29 15:32:56,2014-09-29 15:32:56
2ebd2d41a52dd6401d86cb57a5f64372da968c41...88b1e0ffcd27ab3d9ff9ce1fe5b493e3f6296b21,3,33,7,40,3,2014-09-29 13:40:13,2014-09-29 13:40:13
88b1e0ffcd27ab3d9ff9ce1fe5b493e3f6296b21...36d7e18f4a6ba94e503d49fa544744d5c47a766b,1,6,0,6,1,2014-09-29 13:45:16,2014-09-29 13:45:16
2ebd2d41a52dd6401d86cb57a5f64372da968c41...fbc6f95a02913a76cafc43a1886ef339f3b7ebde,2,3,0,3,2,2014-09-29 13:12:07,2014-09-29 13:12:07
fbc6f95a02913a76cafc43a1886ef339f3b7ebde...ab6459ad488e51a1477d48535c2cae6ce2d14a23,1,2,0,2,1,2014-09-29 14:07:53,2014-09-29 14:07:53
f7342ce56764aaf6465bca74239955778c25107b...b5763e91cdeaba55b3c426129ba3c4f9638c5eb1,6,42,6,48,12,2014-10-15 17:03:25,2014-10-15 15:26:15
b5763e91cdeaba55b3c426129ba3c4f9638c5eb1...2e485af7b051512f804ae46a81cba480d2eca46f,1,1,1,2,1,2014-10-16 12:16:18,2014-10-16 12:16:18
f7342ce56764aaf6465bca74239955778c25107b...8a52ff9c293a46fa7d6b4427f5f25992c7dc2c60,1,4,0,4,1,2014-10-11 17:53:27,2014-10-11 17:53:27
3880bb61760ef1f69b0df49148202ff6b4208f01...19ab9b40b800e15a1a07b00b9adc6534ada12dd1,1,5,1,6,1,2014-10-21 08:29:26,2014-10-20 16:03:12
3880bb61760ef1f69b0df49148202ff6b4208f01...9e1b97ad99b239ace4a9383ef9d2bf0855c0dfd7,6,43,40,83,16,2014-10-19 21:36:23,2014-10-19 21:20:55
3880bb61760ef1f69b0df49148202ff6b4208f01...6a73b76c5f2e1559ba771e5910852ac4e1283b58,1,1,3,4,1,2014-10-19 21:02:19,2014-10-19 21:02:19
3880bb61760ef1f69b0df49148202ff6b4208f01...f808ecf11e5e5664b9617112691efece5ed01980,2,15,3,18,6,2014-10-19 20:19:56,2014-10-19 14:24:22
3880bb61760ef1f69b0df49148202ff6b4208f01...b011052ce7ae714e762a611bad1b9e8866fdf7cd,1,0,2,2,1,2014-10-19 09:46:57,2014-10-19 09:46:57
3880bb61760ef1f69b0df49148202ff6b4208f01...b66a1527356d808f418bab273f821c83a4365c90,6,13,20,33,8,2014-10-19 09:12:39,2014-10-19 08:50:23
3880bb61760ef1f69b0df49148202ff6b4208f01...a3623a9691b4cba19338fb6fe1c7acf64d5e8e70,1,1,1,2,1,2014-10-18 20:49:56,2014-10-18 20:49:56
3880bb61760ef1f69b0df49148202ff6b4208f01...290104219652592a221bfe100a7bbbbee69390fb,1,1,1,2,1,2014-10-18 20:41:39,2014-10-18 20:36:00
d6fdca9a88356c9844e3597846044959bd765949...32d0bf3afdd25eaff1f3bd2e80696e39b5b69c35,1,26,8,34,3,2014-10-16 13:50:09,2014-10-16 13:50:09
92c184a57f7698e79288b380cebc68b839afb4f5...fad588f2bee102bf4ab090874d041e227d4e2ee4,1,8,8,16,3,2014-10-16 15:18:40,2014-10-16 15:18:40
fad588f2bee102bf4ab090874d041e227d4e2ee4...d9bfebc0e87ef426aea7eb4fdd1338f04b106354,3,27,22,49,11,2014-10-16 18:08:30,2014-10-16 18:08:30
073cbc1c66d641c76b5343c623c14958b6445e42...0a0cbe1274bf25334f9a20a06f4781cd89bf45e4,1,1,1,2,1,2014-08-23 00:20:31,2014-08-23 00:20:31
073cbc1c66d641c76b5343c623c14958b6445e42...dd875243e99f242ccf4a5711e39c72aa84761a58,1,1,1,2,1,2014-08-23 00:19:17,2014-08-23 00:19:17
30ea264b3b8207ae279d37e5162f0b934f22dcea...ee6ec5bd6dfe717cb967b9bb3952ce9c6d895098,1,4,0,4,2,2014-09-12 09:22:43,2014-09-12 09:22:43
30ea264b3b8207ae279d37e5162f0b934f22dcea...44185ace11604140693b1d2e68073fc6cc2dcf39,1,67,29,96,3,2014-08-31 00:04:45,2014-08-31 00:04:45
30ea264b3b8207ae279d37e5162f0b934f22dcea...aef3a5bf417ba57fa361f05b0c632fddd7c51fa1,1,8,2,10,3,2014-08-23 08:43:26,2014-08-23 08:43:26
30ea264b3b8207ae279d37e5162f0b934f22dcea...668e8aacfb69a620b52cd8e23b3ae1261aef02ca,1,0,2,2,1,2014-08-23 08:13:22,2014-08-23 08:13:22
30ea264b3b8207ae279d37e5162f0b934f22dcea...3663354cb9b661b77185ff172dcea6ad44345d9d,2,64,46,110,17,2014-08-23 08:08:12,2014-08-22 20:51:59
30ea264b3b8207ae279d37e5162f0b934f22dcea...a3953a46f401e075c4319a49cf4c88825d78ce17,1,1,1,2,1,2014-08-23 08:05:31,2014-08-20 20:31:15
30ea264b3b8207ae279d37e5162f0b934f22dcea...b5481afd73798e08f49c32752bcd3de0cf8cbdca,1,1,1,2,1,2014-08-23 06:36:25,2014-07-26 18:31:00
813e2728966709f60f0b85997eb73030fb6768ef...51f8352dcad8108a5af9a65c85e99a3e5a00103e,2,3,1,4,2,2014-09-29 15:02:45,2014-09-29 15:02:45
9587506124f2a36f9b844da2c9fe17a26fe1daa9...ddf873ad5e4d5e856ac59c580a7352cc2d47ad76,1,18,0,18,2,2013-09-24 12:36:57,2013-09-24 12:36:57
9587506124f2a36f9b844da2c9fe17a26fe1daa9...0009016b6803c01ffaa92eee87e5a3d475af95dd,1,2,1,3,2,2013-09-24 11:50:37,2013-09-24 11:50:37
9587506124f2a36f9b844da2c9fe17a26fe1daa9...1e65fdf7033db240c3ce7ce29b483bf2c392170c,1,6,0,6,1,2013-09-24 10:25:16,2013-09-24 10:25:16
9587506124f2a36f9b844da2c9fe17a26fe1daa9...e894e3eea505ebd675b90c3c53382fd8f273ced8,3,9,3,12,2,2013-09-24 09:27:25,2013-09-24 09:27:25
e894e3eea505ebd675b90c3c53382fd8f273ced8...66998f6d46ee778e6bde749e41f1d712b184a771,9,79,25,104,17,2013-09-24 12:58:39,2013-09-24 12:58:39
66998f6d46ee778e6bde749e41f1d712b184a771...ffd0a985ee86691ddb4807cf9be267bdd37c7815,4,1,68,69,4,2013-09-24 13:00:21,2013-09-24 13:00:21
ffd0a985ee86691ddb4807cf9be267bdd37c7815...09cb2ba8151a60056f4d17fb448ed79c31f02bee,1,3,3,6,2,2013-09-24 19:12:48,2013-09-24 19:12:48
09cb2ba8151a60056f4d17fb448ed79c31f02bee...d90462033ef47a8218d2029efddf1614c6051ccd,1,11,1,12,1,2013-09-24 19:13:28,2013-09-24 19:13:28
d90462033ef47a8218d2029efddf1614c6051ccd...61eb050993e85459282dd6f39c1f703d29b6d3a7,3,34,31,65,4,2013-09-24 19:14:03,2013-09-24 19:14:03
61eb050993e85459282dd6f39c1f703d29b6d3a7...2f6342978bfb0bd7aafc345a36bb0846b73cc80d,10,72,44,116,26,2013-09-24 19:14:28,2013-09-24 19:14:28
2f6342978bfb0bd7aafc345a36bb0846b73cc80d...bcdc7b5d63ece0136ef7c87517c975e69d3b8aab,1,83,0,83,1,2013-09-25 10:27:16,2013-09-25 10:27:16
bcdc7b5d63ece0136ef7c87517c975e69d3b8aab...ea779cc5abe9218193197d1c7b60d898dde47904,3,469,474,943,3,2013-09-25 11:04:01,2013-09-25 11:04:01
ea779cc5abe9218193197d1c7b60d898dde47904...6954d50fd3307f25f16ac06f21aebe37cb7059db,1,55,0,55,1,2013-09-25 11:04:16,2013-09-25 11:04:16
6954d50fd3307f25f16ac06f21aebe37cb7059db...bae15dc5f78276106151cfcf9d0c8988521db42e,1,1,1,2,1,2013-09-25 11:04:32,2013-09-25 11:04:32
bae15dc5f78276106151cfcf9d0c8988521db42e...087d7e554f603faf946ea7ccb910e7b99a0801c2,1,27,0,27,1,2013-09-25 11:05:03,2013-09-25 11:05:03
087d7e554f603faf946ea7ccb910e7b99a0801c2...573d367be5a61e9b344e48b6678cdd8067fe6bd1,7,44,43,87,9,2013-09-25 11:05:35,2013-09-25 11:05:35
573d367be5a61e9b344e48b6678cdd8067fe6bd1...0a01994466622c5fce69252042a35231ab418379,1,1,2,3,2,2013-09-25 11:23:06,2013-09-25 11:23:06
0a01994466622c5fce69252042a35231ab418379...e8292e733bd35eefad4c222f324c3d5070ac83eb,1,3,0,3,1,2013-09-25 12:49:35,2013-09-25 12:49:35
e44e2316c3e223955847859492f6f9bd7974e50e...45f9d15c0e697797741be1f82cff1548cd0efbe0,1,1,1,2,1,2014-06-18 07:11:09,2014-06-18 07:11:09
e44e2316c3e223955847859492f6f9bd7974e50e...b3a90aba41a040378530cb9f1980497e16bbdb11,3,10,10,20,4,2014-06-17 18:23:43,2014-06-17 18:23:43
b3a90aba41a040378530cb9f1980497e16bbdb11...9e3094b232fe5343e5986f0e6a072a5194e18ada,5,45,42,87,6,2014-06-17 18:36:40,2014-06-17 18:36:40
9e3094b232fe5343e5986f0e6a072a5194e18ada...66e068bbdf7ef407206fb992f4b90644722549be,1,1,1,2,1,2014-06-17 18:45:03,2014-06-17 18:45:03
66e068bbdf7ef407206fb992f4b90644722549be...a7f3672b75dff07688c5e4196ad1835bb89ff690,5,36,32,68,5,2014-06-17 18:53:26,2014-06-17 18:53:26
a7f3672b75dff07688c5e4196ad1835bb89ff690...6149dba5189b9f32b3a9caf0c4c585a973ec99fb,7,51,81,132,9,2014-06-17 19:09:01,2014-06-17 19:09:01
6149dba5189b9f32b3a9caf0c4c585a973ec99fb...a7d5052cd4e117768d9c32f582ed72d2cc98e5e6,8,16,20,36,11,2014-06-17 19:20:10,2014-06-17 19:20:10
a7d5052cd4e117768d9c32f582ed72d2cc98e5e6...a90a201d0ee3c9e33cc04075ac8a2509c1d2acc9,4,37,50,87,5,2014-06-17 19:32:35,2014-06-17 19:32:35
a90a201d0ee3c9e33cc04075ac8a2509c1d2acc9...2d87556847931bd146eddaafdee48c2f8954326c,36,52,229,281,53,2014-06-17 19:51:43,2014-06-17 19:51:43
2d87556847931bd146eddaafdee48c2f8954326c...6d352790c45cdb40265e7012eb991e3f69655924,1,2,2,4,2,2014-06-17 19:54:21,2014-06-17 19:54:21
6d352790c45cdb40265e7012eb991e3f69655924...73f91da8b19be5b98b5c4e11cf27ceb50eb6c20b,5,13,40,53,9,2014-06-17 20:49:17,2014-06-17 20:49:17
73f91da8b19be5b98b5c4e11cf27ceb50eb6c20b...85333f093b5f56a06a86a0a9bacfc501622b4917,1,8,5,13,2,2014-06-18 06:26:04,2014-06-18 06:26:04
85333f093b5f56a06a86a0a9bacfc501622b4917...9ef5898e672992361597ec2737e14513fec884c6,1,11,12,23,4,2014-06-18 09:53:29,2014-06-18 09:53:29
e44e2316c3e223955847859492f6f9bd7974e50e...3a8413247b4bdd226823345af4d5d94a9c6035e1,1,1,1,2,1,2014-06-17 13:00:41,2014-06-17 13:00:41
3a8413247b4bdd226823345af4d5d94a9c6035e1...91c38a199f0f0fed1a9dc9251dac4a7c6f017b41,5,8,8,16,8,2014-06-17 14:13:30,2014-06-17 14:13:30
e44e2316c3e223955847859492f6f9bd7974e50e...70ed6ef2a6894042c9bbd92f273542bca2a2374f,1,1,1,2,1,2014-06-17 12:48:43,2014-06-17 12:48:43
e44e2316c3e223955847859492f6f9bd7974e50e...94266f1f664dfb4cf430ffd4fadbf251c38b985a,2,94,0,94,2,2014-06-17 08:21:49,2014-05-30 11:30:17
e59e48d75a1fba2e0c840acd5bf5125af610297e...1065f4616c13ff3f344c9ea290ab09c5ca2b2ac7,1,7,11,18,5,2014-06-20 07:26:12,2014-06-20 07:26:12
1065f4616c13ff3f344c9ea290ab09c5ca2b2ac7...7d04d460c64874ffd5bd2c4e85ad89c71834f042,1,2,0,2,1,2014-06-20 08:44:42,2014-06-20 08:44:42
e59e48d75a1fba2e0c840acd5bf5125af610297e...55512a80a601a95626f305d568d63d581176fe5d,1,7,2,9,2,2014-06-19 11:40:42,2014-06-19 11:40:42
08e4be01c06243dce77602cb19e7a32aeb7cbee8...c42b9d006db3f4454c114e4a1a3592a6de6b4aa8,1,4,4,8,2,2014-06-23 12:47:05,2014-06-23 12:47:05
550f2337a75abc7cdf93c3c86eaa803c52a2b1eb...bf1f8a0e0f419b3e4d401a55721d91ff342127bd,1,2,2,4,1,2014-06-23 16:19:14,2014-06-23 16:19:14
550f2337a75abc7cdf93c3c86eaa803c52a2b1eb...1e7598164beb6de7035101b984d4caa8073fdc78,1,8,4,12,3,2014-06-23 15:28:03,2014-06-18 07:20:56
1e7598164beb6de7035101b984d4caa8073fdc78...f789f29ca63df2050c7c4975957832b0a7cdab7d,1,1,1,2,1,2014-08-18 07:22:11,2014-08-18 07:22:11
f789f29ca63df2050c7c4975957832b0a7cdab7d...11b707a62e437a24056eb9525176ce88678fb5c8,1,1,1,2,1,2014-08-19 20:21:59,2014-08-19 20:21:59
b87c8c1a5019aa098473c6f2d3aadf66fa076acb...ab64ca7a11becad2ca32fdb7ef0530437aa361d9,1,3,3,6,2,2014-10-12 12:23:12,2014-10-12 12:23:12
88db8708b6c65f1858798ffc360a6d2f06cca806...0f12e051c072521460fadfce2cec4e9768bc35ba,1,0,1,1,1,2014-09-30 15:53:54,2014-09-30 15:53:54
32d0bf3afdd25eaff1f3bd2e80696e39b5b69c35...4da88dbb2d8d8c1201a18829e22e71837e39736e,4,159,19,178,15,2014-10-17 10:47:20,2014-10-16 16:45:33
fd22d32bcd177fba4413c2f4c6eb4940c49a0aac...966f68b33e1f15f08e383ec68346ed1bd690b59b,1,10,2,12,1,2014-10-17 10:15:59,2014-10-17 10:15:59
33431c3e7d3f32c457ffb7e35a91ff874f5ba42d...668c7d517a196126d8d40f5195e9f91dd66d7ddc,1,1,1,2,1,2014-08-23 08:59:03,2014-08-23 08:59:03
668c7d517a196126d8d40f5195e9f91dd66d7ddc...9bdd30f422237fc64d88330c0712e64d23464501,1,0,182,182,1,2014-08-23 10:16:18,2014-08-23 10:16:18
0009016b6803c01ffaa92eee87e5a3d475af95dd...66c7eedec7f0183d3a7fe4fcdadcc9c1d749757e,2,6,0,6,3,2013-09-24 18:13:25,2013-09-24 18:13:25
66c7eedec7f0183d3a7fe4fcdadcc9c1d749757e...c562d290eaab16f8e72e7e3e9ff188e172372226,2,6,0,6,2,2013-09-25 17:07:14,2013-09-24 21:12:31
c562d290eaab16f8e72e7e3e9ff188e172372226...055b60d4200aeee0eeab762f162c05305e58c41d,9,61,5,66,9,2013-09-30 09:10:46,2013-09-26 20:40:55
055b60d4200aeee0eeab762f162c05305e58c41d...775aa5ba7ce5ef335bcae81bbc2bf8b7b1321303,2,107,0,107,2,2013-10-01 08:05:58,2013-10-01 08:05:58
70ed6ef2a6894042c9bbd92f273542bca2a2374f...8f8a6bf2c242fe326e70fbf46c6c27074aac47b3,1,2,2,4,2,2014-06-18 09:54:54,2014-06-18 09:54:54
8f8a6bf2c242fe326e70fbf46c6c27074aac47b3...2b6b07f31e203ff3e3d6eb0f05adc93493a3f5ac,2,2,2,4,2,2014-06-18 10:05:33,2014-06-18 10:05:33
995d193d32c96a608435f232f67efcaf48cba67c...cf0a3702741d2bdf0fd2aa7637d7394314eefba5,1,6,1,7,1,2014-06-20 11:58:57,2014-06-20 11:58:57
995d193d32c96a608435f232f67efcaf48cba67c...0771109bb8f7d8a1b8132439806675110b1c9fd3,2,66,25,91,9,2014-06-20 09:54:03,2014-06-20 09:54:03
995d193d32c96a608435f232f67efcaf48cba67c...8401ec56e3c8ae1ba3db8a1554acf328af45f98d,2,4,3,7,3,2014-06-20 09:17:06,2014-06-20 09:17:06
e2552475e26248d208efe520cf35aad4ea67f74b...c83004a0f16017b46be04b2f229f3bc2b4daaf71,1,0,4,4,2,2014-06-20 10:01:22,2014-06-20 10:01:22
a89af6ab8f6ca8118f942e2b2fdaeaf54f81cb31...8b1da505e0f46f720d5097c4850ee83f10cc8d51,1,1,1,2,1,2014-10-01 09:40:43,2014-10-01 09:40:43
51bc636eb34934747f7808b2fc0cd59e9cb8e6b6...093c2c6a01fe2cfaff72b2624b65896fed339ab5,6,28,13,41,9,2014-10-02 07:59:01,2014-10-01 07:10:13
136d44550d7c37b9db052471865f46104d8fc607...b7874c8520bff24c955eba9636367a453dff6cb8,1,1,1,2,1,2014-09-30 18:04:13,2014-09-30 18:04:13
d7ec8451dc5c938e6e30830b83ca17c84091fece...f50c0e5af11c07b637c84d95622a315b71eebe97,1,1,1,2,1,2014-10-20 09:59:16,2014-10-20 09:59:16
f50c0e5af11c07b637c84d95622a315b71eebe97...2064a147249ab5984d90980bb9ce44f788a9b941,4,30,3,33,6,2014-10-20 10:18:07,2014-10-20 10:18:07
564c4138e914abab570ad92c4850dd2b35d37198...082d59d21f7f8857eca2715c1a58fbce30f9b92d,1,1,1,2,1,2014-10-20 13:37:20,2014-10-20 08:52:29
082d59d21f7f8857eca2715c1a58fbce30f9b92d...ebc0a7050afe71f5c30341dcf6b15da76b810408,1,1,1,2,1,2014-10-20 13:37:52,2014-10-20 09:59:16
ebc0a7050afe71f5c30341dcf6b15da76b810408...644fd232dbe827aaae46068119345c2344495239,4,30,3,33,6,2014-10-20 13:37:52,2014-10-20 10:18:07
644fd232dbe827aaae46068119345c2344495239...49bd9812000626af71c1b7b00d9f998fcaca2a46,1,2,1,3,1,2014-10-20 13:38:07,2014-10-17 16:03:34
49bd9812000626af71c1b7b00d9f998fcaca2a46...3d3726a026f465a441abd7438de85790d9d84d94,1,1,1,2,2,2014-10-20 13:38:08,2014-10-17 16:08:26
564c4138e914abab570ad92c4850dd2b35d37198...4880b91ff1be9dda28dfe2b3feb0cd746cadf73e,1,70,0,70,1,2014-10-18 09:13:15,2014-10-18 09:13:15
564c4138e914abab570ad92c4850dd2b35d37198...0ff6105589960bc617b8e974874f1f22a5841ad0,1,2,0,2,1,2014-10-18 09:08:01,2014-10-18 09:08:01
564c4138e914abab570ad92c4850dd2b35d37198...9a92e53f622f29388851f25abe191dad38e35516,1,5,9,14,5,2014-10-18 08:49:59,2014-10-18 08:49:59
9a92e53f622f29388851f25abe191dad38e35516...3e6b284bd0cf597f6446e1990a53acb806fb359a,1,5,5,10,2,2014-10-18 08:51:35,2014-10-18 08:51:35
564c4138e914abab570ad92c4850dd2b35d37198...76e2ae8148e8fd72048cc1c9d57e5b5f5452aae9,1,2,2,4,1,2014-10-18 08:39:01,2014-10-18 08:39:01
564c4138e914abab570ad92c4850dd2b35d37198...35b1a036d79382c9311d4c6fac0cdbefb067e940,1,6,0,6,2,2014-10-18 08:33:51,2014-10-18 08:33:51
564c4138e914abab570ad92c4850dd2b35d37198...768da57fe4aeb9fddc96620d5a91d5a2974e438d,1,1,1,2,1,2014-10-18 08:28:50,2014-10-18 08:28:50
966f68b33e1f15f08e383ec68346ed1bd690b59b...f8cdd62e2269b6c8243b6d1bc9bf73dc7dd1b535,2,89,19,108,11,2014-10-17 11:08:02,2014-10-17 11:08:02
840e98ba87a53b85689b87ae1d4528d92154d67d...f299301cfe73496ae47575840033edf97d110b95,1,102,0,102,1,2014-06-18 10:35:31,2014-06-18 10:35:31
71feb7578267fd306601fb7dacf2b875b64799c4...d1e424bd5c403d73d399bf0f92e39aefde56e638,1,1,1,2,1,2014-06-20 10:37:33,2014-06-20 10:37:33
8b1da505e0f46f720d5097c4850ee83f10cc8d51...02bf992f378f8b56ec7e698b5d603ded895dd0a4,4,23,6,29,12,2014-10-01 13:43:27,2014-10-01 13:43:27
8b1da505e0f46f720d5097c4850ee83f10cc8d51...d29cbc70b247608eda5241675dcfe002e0a10e0e,1,1,1,2,1,2014-10-01 09:56:23,2014-10-01 09:56:23
a54d5dc776b88151d8834185c6b761f1ee732f71...37e09858e8f6dec949f004a933eef8346ddc97d4,2,15,31,46,7,2014-10-22 08:12:33,2014-10-21 15:26:40
37e09858e8f6dec949f004a933eef8346ddc97d4...4c034142a13c2e82e62b6f27a61e371b463310fb,1,2,2,4,2,2014-10-22 08:12:46,2014-10-22 08:11:18
a54d5dc776b88151d8834185c6b761f1ee732f71...db5ea013f4a75b6f6b6cf7fd43011f5c2c29fda1,7,42,11,53,11,2014-10-21 08:37:15,2014-09-25 14:43:23
bd9d9b6defe3c32472cf6e4af67a4c043ee129e0...9e6e0171ce4262f10d45ee828773f01fa372cf45,1,1,1,2,1,2014-10-17 17:41:27,2014-10-17 17:41:27
bd9d9b6defe3c32472cf6e4af67a4c043ee129e0...d1c3864778d06b8e47b478caf4ff6f61c573151e,1,2,1,3,1,2014-10-17 16:03:34,2014-10-17 16:03:34
d1c3864778d06b8e47b478caf4ff6f61c573151e...61d9d4e2eb2a51243276422d901b158abbb2f0da,1,1,1,2,2,2014-10-17 16:08:26,2014-10-17 16:08:26
5a4a1a2fa44630d00f7029ae0bb11d614147af23...e6631c87860c182ce9c838da6b4ad8d570061dfb,1,1,0,1,1,2014-10-21 11:21:58,2014-10-21 11:21:58
5a4a1a2fa44630d00f7029ae0bb11d614147af23...6797c59e6e5ceac9f087a63b62fbc148e7a7d5b9,1,6,0,6,6,2014-10-17 17:27:30,2014-10-17 17:27:30
5a4a1a2fa44630d00f7029ae0bb11d614147af23...6cff68fb30ef63af127a27293688e4fc40a9cef9,1,1,1,2,1,2014-10-17 14:27:44,2014-10-17 14:27:44
ffa009dc340e0d1dd65d323756e291d8cdf9bf6a...8301557966ce1083f0758da9e191758b71034d8d,1,2,2,4,1,2014-06-18 12:21:24,2014-06-18 12:21:24
d1e424bd5c403d73d399bf0f92e39aefde56e638...e364a852afde6a1897221b5c17c2a4be56a40b43,1,5,1,6,1,2014-06-22 12:48:31,2014-06-22 12:48:31
d1e424bd5c403d73d399bf0f92e39aefde56e638...a7e0ca9e83851ae573eb19a977814f550b07f44f,18,18,18,36,18,2014-06-21 09:20:22,2014-06-21 09:18:57
d1e424bd5c403d73d399bf0f92e39aefde56e638...61a403ff22db19c8482bbd701b6222a1e4b4eb99,1,3,1,4,1,2014-06-21 09:00:54,2014-06-17 12:13:01
d1e424bd5c403d73d399bf0f92e39aefde56e638...83f4735b57f5c2e679c5379c3ecd29fadf3ddb22,11,12,11,23,12,2014-06-21 07:43:00,2014-06-21 07:41:44
d1e424bd5c403d73d399bf0f92e39aefde56e638...1d8c32982d6b80181a3e4be01cd6c587082b4ddf,1,1,0,1,1,2014-06-20 22:05:27,2014-06-20 22:05:27
d1e424bd5c403d73d399bf0f92e39aefde56e638...9ba2e1873b9c6b972655a423fce6dd6aa4c2417d,1,4,0,4,1,2014-06-20 19:38:08,2014-06-20 19:38:08
d1e424bd5c403d73d399bf0f92e39aefde56e638...8a35660e4023a65430400463e55970ebe6308ce3,1,1,1,2,1,2014-06-20 11:48:14,2014-06-20 11:48:14
ba22e3ae583ffa156d9945c8e67f16316753bd33...ed00ab75214389d108a857a22027f221a6649fbe,1,10,10,20,6,2014-10-22 13:24:40,2014-10-22 12:42:41
ed00ab75214389d108a857a22027f221a6649fbe...ba76dbc3667c2eb0a1a3687f8b0481e619946d73,1,1,1,2,1,2014-10-22 13:42:43,2014-10-22 13:42:43
ba76dbc3667c2eb0a1a3687f8b0481e619946d73...e8da077d4f9b63d7d7157416dbf0dad010ea90bd,2,5,2,7,3,2014-10-23 14:53:19,2014-10-23 12:21:21
e8da077d4f9b63d7d7157416dbf0dad010ea90bd...5f7906e1635baa1aca12527ac9d9f8e84323e95d,5,33,2,35,5,2014-10-24 09:52:59,2014-10-24 08:52:52
5f7906e1635baa1aca12527ac9d9f8e84323e95d...16a10eb1cd4a5447da9d50b1eba25f020dc8f6b7,3,32,12,44,6,2014-10-24 09:53:32,2014-10-23 20:57:16
16a10eb1cd4a5447da9d50b1eba25f020dc8f6b7...d4ae4fe670c75ffbb3974734aafbcdc667e53172,2,3,3,6,3,2014-10-24 10:24:27,2014-10-24 09:25:39
d4ae4fe670c75ffbb3974734aafbcdc667e53172...9712fbcdd366c173e2ec277a617a4e690f6a86e9,1,1,1,2,1,2014-10-24 10:30:04,2014-10-24 10:30:04
1ea246f167530a142931ff46a726c8a5d608f5a2...b1e60cfa1b56d01c2328ebe2a3d49cd82058f981,1,4,33,37,5,2014-10-21 10:20:59,2014-10-21 10:20:59
b1e60cfa1b56d01c2328ebe2a3d49cd82058f981...9f54397f3a3e094665d25109a63f24757a19df3a,1,2,1,3,1,2014-10-21 11:35:04,2014-10-21 09:38:41
9f54397f3a3e094665d25109a63f24757a19df3a...536f61e0e77227828d363a7008bd39b0e9fd43a7,1,20,0,20,1,2014-10-21 11:35:13,2014-10-21 09:33:26
536f61e0e77227828d363a7008bd39b0e9fd43a7...be80837a6941abe48d99acad1c3eb8a9957a0b42,2,3,3,6,2,2014-10-21 16:12:52,2014-10-21 16:12:52
c5360a588d4e8a27322dd1eb6cee0e563c32788c...8ad1330b6a8648406bcd392ad5884498a25fbceb,1,1,1,2,1,2014-10-20 08:52:29,2014-10-20 08:52:29
692ecdb81c1d9c6ab9a189ba1eb231f279b6cd75...2d7178070585a9ec30606a750ff9bd4fad809166,2,2,2,4,2,2014-06-22 16:24:50,2014-06-22 16:24:50
9712fbcdd366c173e2ec277a617a4e690f6a86e9...7f97a1277de78bcd86d68978e9ec29a2548fc144,4,15,1,16,5,2014-10-24 16:39:14,2014-10-24 16:24:49
477743a154e85c411e8a533980abce460b5669fc...912715c3e452723dd7dda3430f57e69b7f1605af,2,5,1,6,2,2014-10-29 13:59:57,2014-10-29 13:59:57
912715c3e452723dd7dda3430f57e69b7f1605af...43fba7f0c518942d060e7a7dd9f7ec3065ac1f69,1,17,3,20,3,2014-10-29 14:00:38,2014-10-28 14:00:03
43fba7f0c518942d060e7a7dd9f7ec3065ac1f69...995d198419b6f196b014ccb47d0298b419b53e6d,5,205,175,380,5,2014-10-29 14:00:46,2014-10-29 11:31:23
995d198419b6f196b014ccb47d0298b419b53e6d...a2dfff418bf2532ebb5aee88414107929b17eefd,2,17,5,22,8,2014-10-29 14:00:55,2014-10-29 11:38:00
a2dfff418bf2532ebb5aee88414107929b17eefd...1ab1526d92d6084acfd459e82c9ce490e9e29807,3,14,1,15,4,2014-10-29 14:11:28,2014-10-27 09:51:31
1ab1526d92d6084acfd459e82c9ce490e9e29807...9de385435d15070ba11eb8c94a24269dc4435841,1,2,0,2,1,2014-10-29 14:49:09,2014-10-29 14:34:28
9de385435d15070ba11eb8c94a24269dc4435841...d52a5c76084296ff09bd3677add69a9bd7663ebe,1,1,0,1,1,2014-10-29 14:51:57,2014-10-29 14:51:57
d52a5c76084296ff09bd3677add69a9bd7663ebe...353a98757850a37118bc5ff0718d8050f934bf90,2,2,0,2,2,2014-10-30 12:45:15,2014-10-30 12:44:29
477743a154e85c411e8a533980abce460b5669fc...5c74abb590b7a519b0e135665841b98f3095295c,1,1,0,1,1,2014-10-24 20:00:21,2014-10-24 20:00:21
