id,files,locs added,locs removed,locs total,hunks,commit time,author time
4b825dc642cb6eb9a060e54bf8d69288fbee4904...960d97449b67ae654f51dcdb98bc2a47fd2082db,1,0,0,0,0,2010-01-24 18:03:43,2010-01-24 18:03:43
960d97449b67ae654f51dcdb98bc2a47fd2082db...60dab21756d567a3511c45ad6b9e961bbc53754d,52,14180,0,14180,50,2010-01-24 18:04:13,2010-01-24 18:04:13
60dab21756d567a3511c45ad6b9e961bbc53754d...948653ba25b0d150235f2a6988678d340ee6b37d,34,0,7291,7291,33,2010-01-24 18:07:26,2010-01-24 18:07:26
948653ba25b0d150235f2a6988678d340ee6b37d...fb1a4844f7c1d91c60f17b8486e9cb62ab58d37e,1,2,2,4,2,2010-03-20 18:42:36,2010-03-20 18:42:36
fb1a4844f7c1d91c60f17b8486e9cb62ab58d37e...eb04e1a3af44696de2059500e916f416a973db0c,1,2,70,72,3,2010-03-20 18:46:32,2010-03-20 18:46:32
eb04e1a3af44696de2059500e916f416a973db0c...ecd87f7cf58ebeae8bb7590bda5585215ef6fa78,1,15,0,15,1,2010-03-20 23:29:39,2010-03-20 23:29:39
ecd87f7cf58ebeae8bb7590bda5585215ef6fa78...ebe0d943297004e662064ee1366a9a0e7bb65547,1,1,0,1,1,2010-03-20 23:31:48,2010-03-20 23:31:48
ebe0d943297004e662064ee1366a9a0e7bb65547...a71114b54660b674e70987e7ffeac118e72a9f64,1,0,18,18,1,2010-03-20 23:32:10,2010-03-20 23:32:10
a71114b54660b674e70987e7ffeac118e72a9f64...7de4696e3141c2f1d0352b3a19ef5c3f0d564d11,1,17,0,17,1,2010-03-20 23:53:40,2010-03-20 23:53:40
7de4696e3141c2f1d0352b3a19ef5c3f0d564d11...5c8b45e66a0604a3347022584c8d47ace6be23a9,1,0,1,1,1,2010-03-21 01:45:20,2010-03-21 01:45:20
5c8b45e66a0604a3347022584c8d47ace6be23a9...770ca9c8a60415e0b034b5bce15a71c8aaf5a422,1,1,1,2,1,2010-03-24 22:11:47,2010-03-24 22:11:47
770ca9c8a60415e0b034b5bce15a71c8aaf5a422...28512638f83c84909a033085c15092e14c28839a,2,16,1,17,4,2010-03-30 04:49:34,2010-03-30 04:49:34
28512638f83c84909a033085c15092e14c28839a...b5fa3d0a241c826b5f6efe4f73874ceecdcd5ca3,1,2,2,4,2,2010-04-02 19:34:38,2010-04-02 19:34:38
b5fa3d0a241c826b5f6efe4f73874ceecdcd5ca3...66ff719e736cb8e9e2dbf237079796bfbe4cb918,7,1073,1041,2114,7,2010-04-05 22:03:06,2010-04-05 22:03:06
66ff719e736cb8e9e2dbf237079796bfbe4cb918...e580422990d22676fd1acfd4429421b2980c1a38,1,3,8,11,1,2010-04-05 22:07:51,2010-04-05 22:07:51
e580422990d22676fd1acfd4429421b2980c1a38...1c403b368c334957df5ee754de358cb2f027e717,2,4,2,6,2,2010-04-08 18:19:56,2010-04-08 18:19:56
e580422990d22676fd1acfd4429421b2980c1a38...8de232320aa3334160a9140ca007160ffbceb4f1,4,25,11,36,5,2010-04-06 03:05:42,2010-04-06 03:05:42
8de232320aa3334160a9140ca007160ffbceb4f1...b2c0b30cd6a23585715a8160e3266b59b8eacb39,1,6,0,6,2,2010-04-07 03:11:38,2010-04-07 03:11:38
2788c15f2c9b4678b694e347c4d2710ff25e16df...a266e0e7439d0670e1007b05129573737f82eb95,1,85,85,170,1,2010-04-15 15:52:12,2010-04-15 15:52:12
a266e0e7439d0670e1007b05129573737f82eb95...a728304cbd8d592b416be183ef73324062413ec6,1,1,1,2,1,2010-04-15 15:52:37,2010-04-15 15:52:37
2788c15f2c9b4678b694e347c4d2710ff25e16df...6fadb8c0e5b64804228dd97ca2a4f46209221a2f,1,43,83,126,27,2010-04-12 03:21:07,2010-04-12 03:21:07
6fadb8c0e5b64804228dd97ca2a4f46209221a2f...cb98f0cb3d858f1967ef25dd38faff6d2aea362e,1,5,5,10,4,2010-04-12 03:27:05,2010-04-12 03:27:05
7efa6be1659aabe77b642aacdf646993ba746063...7a3236ee6a0c652fa503c12e450fe768e1980562,2,14,14,28,2,2010-04-15 18:01:56,2010-04-15 18:01:56
7a3236ee6a0c652fa503c12e450fe768e1980562...0bb949575253965ac84b9afacf22747ee03c9376,1,73,0,73,1,2010-04-15 18:02:37,2010-04-15 18:02:37
0bb949575253965ac84b9afacf22747ee03c9376...c9796ba5f968337887bdfb30e91b2e13127e298b,1,7,27,34,7,2010-04-15 18:15:00,2010-04-15 18:15:00
c9796ba5f968337887bdfb30e91b2e13127e298b...69bf6b2fea6d0100a557ad92eea8fbb0ff1996f7,1,14,14,28,9,2010-05-11 07:01:52,2010-05-11 07:01:52
69bf6b2fea6d0100a557ad92eea8fbb0ff1996f7...ed906cfb1b4299d0a7de1524c9d2ae499f33dac0,1,11,5,16,4,2010-05-11 16:05:48,2010-05-11 16:05:48
ed906cfb1b4299d0a7de1524c9d2ae499f33dac0...5e584284fa7d92de41a671991e4790e87ed45d76,3,27,19,46,3,2010-05-12 18:54:39,2010-05-12 18:54:39
5e584284fa7d92de41a671991e4790e87ed45d76...150260abf0a1c590a3f73b69353209dd85d2eed7,4,132,138,270,7,2010-05-13 15:05:35,2010-05-13 15:05:35
150260abf0a1c590a3f73b69353209dd85d2eed7...b7cd34648274896f0d7aa32e9fd42e59b2bb5e13,1,61,0,61,1,2010-05-13 18:33:42,2010-05-13 18:27:21
b7cd34648274896f0d7aa32e9fd42e59b2bb5e13...a94380546ff9e546f853ec4a461be7b1d109949c,7,345,155,500,47,2010-05-14 09:43:33,2010-05-14 09:43:33
a94380546ff9e546f853ec4a461be7b1d109949c...b048cc64e4535a2915d273ae1ac4594eba50b0c5,1,5,5,10,5,2010-05-14 10:05:35,2010-05-14 10:05:35
b048cc64e4535a2915d273ae1ac4594eba50b0c5...de6ff168fab1f0b081a01986bfbdec667599ce34,1,6,1,7,5,2010-05-14 10:07:31,2010-05-14 10:07:31
de6ff168fab1f0b081a01986bfbdec667599ce34...d1cb8ba354b041db9bc1098d37eb9a5e276fc149,8,227,126,353,26,2010-05-20 05:42:44,2010-05-20 05:42:44
de6ff168fab1f0b081a01986bfbdec667599ce34...937fcf292d7d50e10b7d1fca02da5adc9a4e3d01,1,44,23,67,7,2010-05-20 05:18:52,2010-05-20 05:18:52
937fcf292d7d50e10b7d1fca02da5adc9a4e3d01...19881651f46517590035cc023a05260ee177275c,1,8,10,18,9,2010-05-20 05:42:09,2010-05-20 05:42:09
1df6aa03069fa8dc42ee64a24ddb0a28d2932b8a...4a710d6083965ff87df31665ed923579a0f7e70b,7,204,277,481,16,2010-05-20 06:01:08,2010-05-20 06:01:08
1df6aa03069fa8dc42ee64a24ddb0a28d2932b8a...fc1a7dd4ecc47e699103ef5a423d22befa2a8e5e,1,34,12,46,4,2010-05-20 05:55:40,2010-05-20 05:55:40
fc1a7dd4ecc47e699103ef5a423d22befa2a8e5e...8c279c521b89da81403b5c4b348cb696095a6f03,1,1,1,2,1,2010-05-20 05:56:25,2010-05-20 05:56:25
8c279c521b89da81403b5c4b348cb696095a6f03...25469074873ac1de5744f278ba8c9fd55466bdad,2,4,1,5,2,2010-05-20 06:01:55,2010-05-20 06:01:55
4a710d6083965ff87df31665ed923579a0f7e70b...210dc678fa114594277dcefc7989f56110784a6e,1,11,0,11,1,2010-05-20 06:09:15,2010-05-20 06:09:15
210dc678fa114594277dcefc7989f56110784a6e...3aad2edf40c5912a700b637ae9150ac5df68957a,1,2,2,4,1,2010-05-20 06:11:48,2010-05-20 06:11:48
f7ecf0d2c79b72a3bf17c473ba5c855dfdb7b3c7...f6939ab9a881d3a41ad2ef544072776f34d58bb4,3,4,10,14,6,2010-05-20 06:14:09,2010-05-20 06:14:09
f6939ab9a881d3a41ad2ef544072776f34d58bb4...164da1a5154500aa4f71431dfb00a8db2849c9fe,3,16,18,34,11,2010-05-20 06:25:11,2010-05-20 06:25:11
164da1a5154500aa4f71431dfb00a8db2849c9fe...52cb02b4705d2646efbc3df68b0db885f80cd51b,2,2,0,2,2,2010-05-20 08:16:29,2010-05-20 08:16:29
52cb02b4705d2646efbc3df68b0db885f80cd51b...4ea43222317d36d958f10a07d91d9df2280585d2,1,32,32,64,16,2010-05-20 18:24:42,2010-05-20 18:24:42
4ea43222317d36d958f10a07d91d9df2280585d2...193c9b2063cbb8649915dc67752007164aa7648d,1,1,1,2,1,2010-05-20 18:27:19,2010-05-20 18:27:19
193c9b2063cbb8649915dc67752007164aa7648d...a4b696e71e5fcf4b07a457b3acd3302ea73b1650,1,16,16,32,7,2010-05-21 17:07:46,2010-05-21 17:07:46
193c9b2063cbb8649915dc67752007164aa7648d...6c2f15db379b7680cf002192a15cd86fa432e682,1,332,0,332,1,2010-05-20 22:43:56,2010-05-20 22:43:56
6c2f15db379b7680cf002192a15cd86fa432e682...ebd38d1015c3d2a8455c0b0737fdcd15155a2f59,1,3,0,3,1,2010-05-20 22:52:31,2010-05-20 22:52:31
ebd38d1015c3d2a8455c0b0737fdcd15155a2f59...4092e6cbe6249c188781b8a2979f1760ae4ec181,1,9,2,11,3,2010-05-21 01:12:14,2010-05-21 01:12:14
64074d18a5447dfbfeb68d80037b0fa94394914f...7bc81bfb1f39521640e9ed485fbc8fb8eef1dd45,6,5,300,305,7,2010-05-25 14:12:05,2010-05-25 14:12:05
7bc81bfb1f39521640e9ed485fbc8fb8eef1dd45...2ba77f66beb7a68888fe28a65f120d99736a0089,5,280,0,280,5,2010-05-25 14:12:30,2010-05-25 14:12:30
2ba77f66beb7a68888fe28a65f120d99736a0089...9c1fbb381d01c318b5edc2d838b1bedcd0e983b8,1,8,2,10,4,2010-05-29 17:10:05,2010-05-29 17:10:05
9c1fbb381d01c318b5edc2d838b1bedcd0e983b8...b0e4a21bd6f069cd0f5364c233fbe1174806e584,8,165,368,533,50,2010-06-03 16:34:01,2010-06-03 16:34:01
b0e4a21bd6f069cd0f5364c233fbe1174806e584...74782cf679bb83a815b600b6b5fb9ccae1562906,1,8,5,13,2,2010-06-03 16:36:24,2010-06-03 16:36:24
74782cf679bb83a815b600b6b5fb9ccae1562906...8cd48729cf0d44004d683588cd0e124dd87f51ea,1,9,7,16,3,2010-06-03 16:38:47,2010-06-03 16:38:47
8cd48729cf0d44004d683588cd0e124dd87f51ea...2ab87401fb7191e147ecb4e8bbb8f324a4d987f2,1,0,61,61,1,2010-06-03 16:40:01,2010-06-03 16:40:01
2ab87401fb7191e147ecb4e8bbb8f324a4d987f2...bedeaf91f9a0e7e01915100ccd180e8268838ba4,2,159,0,159,3,2010-06-03 16:52:52,2010-06-03 16:52:52
bedeaf91f9a0e7e01915100ccd180e8268838ba4...f83b409499417466d1e6ce98c636560aef00e830,1,1,1,2,1,2010-06-03 16:55:14,2010-06-03 16:55:14
f83b409499417466d1e6ce98c636560aef00e830...3179222202bb995a7ccb2b161d456e98f201deb4,3,20,11,31,6,2010-06-03 17:24:04,2010-06-03 17:24:04
3179222202bb995a7ccb2b161d456e98f201deb4...0d11bfb13ffded65e67bc075e87a5a2fe9032bbe,1,2,4,6,4,2010-06-03 17:31:07,2010-06-03 17:31:07
0d11bfb13ffded65e67bc075e87a5a2fe9032bbe...1ca728c035dc6b19c988615992ab3036e4fe87f4,1,8,0,8,1,2010-06-04 01:48:02,2010-06-04 01:48:02
1ca728c035dc6b19c988615992ab3036e4fe87f4...e5f49c0bb62e59dbbf7ff77cfae2c7654253ec95,1,13,15,28,4,2010-06-06 23:06:08,2010-06-06 23:06:08
e5f49c0bb62e59dbbf7ff77cfae2c7654253ec95...6eaed54f0ff55231f1b497edb406af2a92b5c18b,2,5,2,7,2,2010-06-29 16:16:37,2010-06-29 16:16:37
e5f49c0bb62e59dbbf7ff77cfae2c7654253ec95...b65cbcc4de3cc3316d512a031e6d5cf2b1bf5388,1,15,0,15,1,2010-06-15 02:16:54,2010-05-13 18:35:51
b65cbcc4de3cc3316d512a031e6d5cf2b1bf5388...2ac1392fe3597f2a17915b6ba578e7c2f46c1f2a,1,3,7,10,4,2010-06-24 17:09:46,2010-06-24 17:09:46
7d05a57033a523c059e33861ecd99614fbc0e812...5ac7c670f99d50c51ce2ac97819d6af0ff0e6e07,1,1,1,2,1,2010-07-07 01:29:23,2010-07-07 01:29:23
5ac7c670f99d50c51ce2ac97819d6af0ff0e6e07...1968400c54b90e0f7e056f1adee04ae97a5ad526,3,5,4,9,4,2010-07-09 21:03:47,2010-07-09 21:03:47
1968400c54b90e0f7e056f1adee04ae97a5ad526...f6877543746024dc0a3909d013c43fd0db6804cf,1,7,7,14,6,2010-07-15 19:11:04,2010-07-15 19:11:04
f6877543746024dc0a3909d013c43fd0db6804cf...e52312de90ce30d5d12075c663a16f5fa8b61834,1,1,1,2,1,2010-07-15 19:31:25,2010-07-15 19:31:25
7d05a57033a523c059e33861ecd99614fbc0e812...7240acad095e1a849d90ec621660a7cdbb02fdf3,2,24,24,48,2,2010-07-07 01:26:56,2010-07-07 01:26:56
7240acad095e1a849d90ec621660a7cdbb02fdf3...943968c7c9da05ac7bb3ae9d6127b7d70f2d9f2e,1,5,5,10,3,2010-07-07 02:37:11,2010-07-07 02:37:11
943968c7c9da05ac7bb3ae9d6127b7d70f2d9f2e...c1f98ec1d633f388a0a4befd1fa8708c1e0ccde9,4,47,36,83,5,2010-07-17 04:31:37,2010-07-17 04:31:37
7d05a57033a523c059e33861ecd99614fbc0e812...0be7ab457a8838b0a7faff49bd718c952d9b7e8d,1,1,1,2,1,2010-07-02 09:07:42,2010-07-02 09:07:42
0be7ab457a8838b0a7faff49bd718c952d9b7e8d...f0aa2dbe36bb60374278d759b87ec0d87e822b36,1,1,1,2,1,2010-07-02 09:08:42,2010-07-02 09:08:42
c4194c9794bcec267e72389aad42badf52bd58d2...2f56c79619ed86d193fee6ad11cae0cd67e641f6,1,2,2,4,1,2010-07-17 16:03:41,2010-07-17 16:03:41
2f56c79619ed86d193fee6ad11cae0cd67e641f6...8a24acc9cd5e05bd86bae21cb9413e1128a4babd,1,32,25,57,15,2010-07-17 16:17:34,2010-07-17 16:17:34
c4194c9794bcec267e72389aad42badf52bd58d2...070a0ba8b8c5bb210816c2531b347fd74225d684,1,7,5,12,1,2010-07-17 05:05:49,2010-07-17 05:05:49
070a0ba8b8c5bb210816c2531b347fd74225d684...d55679b3e45ceea7349cab7683ff85af5a542bd6,1,6,6,12,1,2010-07-17 05:08:14,2010-07-17 05:08:14
d55679b3e45ceea7349cab7683ff85af5a542bd6...d9ce70d9186ce8d17eda0a09737302b5a3eacef4,1,2,10,12,2,2010-07-17 05:15:21,2010-07-17 05:15:21
d9ce70d9186ce8d17eda0a09737302b5a3eacef4...401889b1efbd8836cf63f1d619bda1dc47d1ad94,1,8,4,12,1,2010-07-17 05:19:40,2010-07-17 05:19:40
5435186b42af4c8f3cbaaee6bf599230409c7a61...cd3e1f4db1a85fd0acdb8a370c2e794fc83d6c54,1,3,0,3,1,2010-07-19 18:08:07,2010-07-19 18:08:07
cd3e1f4db1a85fd0acdb8a370c2e794fc83d6c54...53652a95fa51ad1baef8438ba3e17f5783245167,1,4,1,5,2,2010-07-22 15:18:01,2010-07-22 15:18:01
5435186b42af4c8f3cbaaee6bf599230409c7a61...34ce32ab92bba100e0247c8f38bf3d9715360477,1,5,2,7,1,2010-07-18 05:13:57,2010-07-18 05:13:57
34ce32ab92bba100e0247c8f38bf3d9715360477...9b5d916ae1af9f4100030f4101eb22272190317a,1,8,1,9,6,2010-07-23 00:53:58,2010-07-22 15:32:47
9b5d916ae1af9f4100030f4101eb22272190317a...017ed97538db430ac554a3b8caa2e72808b29632,1,29,11,40,10,2010-07-29 00:08:31,2010-07-29 00:08:31
017ed97538db430ac554a3b8caa2e72808b29632...44cde60c1c884f08f37e8666eaefe7a8dc837494,1,1,1,2,1,2010-07-29 00:10:16,2010-07-29 00:10:16
44cde60c1c884f08f37e8666eaefe7a8dc837494...90fb186612518e39628fe603496d717557e8e37a,1,1,2,3,1,2010-07-29 03:34:53,2010-07-29 03:34:53
d9077f278c54364e58db0dd8d536d35c5bdc4459...0b140cf1b45b9286b58e9401dbdad308d756de3d,2,82,17,99,9,2010-07-30 04:48:11,2010-07-30 04:48:11
90fb186612518e39628fe603496d717557e8e37a...08b7768647abc1356b73aff72e3c929128342283,1,8,0,8,1,2010-07-29 05:57:58,2010-07-22 15:36:25
08b7768647abc1356b73aff72e3c929128342283...f5bc803f2bf08bc9aa5a52b9b594b1a6de0b6d62,1,3,3,6,2,2010-07-29 05:57:58,2010-07-23 14:45:35
f5bc803f2bf08bc9aa5a52b9b594b1a6de0b6d62...8a3ea3ec2ad450c2298f2a92e3e39c1510e7c32c,1,36,19,55,16,2010-08-04 05:39:12,2010-08-04 05:39:12
8a3ea3ec2ad450c2298f2a92e3e39c1510e7c32c...18a136453a23e0baf7c91b844003a9d31d2100ab,1,74,61,135,31,2010-08-04 06:40:16,2010-08-04 06:40:16
c2e9913956ce02638fffe175c5d946287844f19b...aa2687e08050b597cc2db971aa9555909a0f3a5f,1,70,1,71,2,2010-08-04 07:00:17,2010-08-04 07:00:17
aa2687e08050b597cc2db971aa9555909a0f3a5f...b6d10ae77440e2558c737beb23a699a75f6c5a89,1,4,0,4,1,2010-08-05 20:22:58,2010-08-05 20:22:58
b6d10ae77440e2558c737beb23a699a75f6c5a89...7195c8d2ee7778cb1b999021ac2bff0322e5cb3d,1,9,9,18,6,2010-08-09 02:38:46,2010-08-09 00:45:25
7195c8d2ee7778cb1b999021ac2bff0322e5cb3d...d64e76804cf5c82bcb4bcea3e7ec6f6e01c63639,1,3,2,5,2,2010-08-09 03:25:07,2010-08-09 03:25:07
d64e76804cf5c82bcb4bcea3e7ec6f6e01c63639...a923c03b57b3eb6d1a2992d6a5c282976a0d0d2c,2,20,30,50,2,2010-08-09 23:35:22,2010-08-09 23:35:22
a923c03b57b3eb6d1a2992d6a5c282976a0d0d2c...430ee899a03ffe7facf08bf965f3febf8a46f677,2,16,9,25,4,2010-08-10 01:35:03,2010-08-10 01:35:03
430ee899a03ffe7facf08bf965f3febf8a46f677...89f1fc76c49f3abfeb71621238c766e3bd817808,1,2,1,3,1,2010-08-10 01:38:50,2010-08-10 01:38:50
89f1fc76c49f3abfeb71621238c766e3bd817808...5f1db10955bc981eb4e6cc229746327a44ec47de,4,5,5,10,5,2010-08-10 01:44:36,2010-08-10 01:44:36
5f1db10955bc981eb4e6cc229746327a44ec47de...ff0f0e291a3f77bd50a724fd979d4fecf766ac2b,1,12,11,23,8,2010-08-10 02:05:56,2010-08-10 02:05:56
ff0f0e291a3f77bd50a724fd979d4fecf766ac2b...45465db9c64389a7f2a84ffb49c08647a27a8d75,1,7,7,14,5,2010-08-10 02:06:34,2010-08-10 02:06:34
45465db9c64389a7f2a84ffb49c08647a27a8d75...44e49f8706596f46d852cfa213876011e20972e6,1,12,8,20,5,2010-08-10 02:11:52,2010-08-10 02:11:52
44e49f8706596f46d852cfa213876011e20972e6...fdd14c1788858e474287e8ce345b1fbfe28b0d88,2,13,2,15,2,2010-08-10 02:25:40,2010-08-10 02:25:40
fdd14c1788858e474287e8ce345b1fbfe28b0d88...68c75c02eff827383f740a3d6ca5b90d868089a4,1,1,8,9,2,2010-08-10 02:29:50,2010-08-10 02:29:50
68c75c02eff827383f740a3d6ca5b90d868089a4...4e17c6dc65e0d2dff827dd1bb51916f330eaa724,1,7,6,13,5,2010-08-10 02:59:18,2010-08-10 02:59:18
4e17c6dc65e0d2dff827dd1bb51916f330eaa724...f33a07d3b348bdc121c7cc95c392e36fc2f0ff0f,4,13,13,26,12,2010-08-10 04:07:32,2010-08-10 04:07:32
f33a07d3b348bdc121c7cc95c392e36fc2f0ff0f...5ac2995ed8e771304d195e66d0dcadd3c0c97af0,2,14,0,14,2,2010-08-10 07:01:07,2010-08-10 07:01:07
5ac2995ed8e771304d195e66d0dcadd3c0c97af0...79518c32abb44268dc04b4214a56b44bfd25d506,1,5,0,5,1,2010-08-10 16:10:17,2010-08-10 16:10:17
79518c32abb44268dc04b4214a56b44bfd25d506...6f01f432fb844ceb31a24157a20f7ffca3db1f14,1,10,4,14,2,2010-08-10 16:10:48,2010-08-10 16:10:48
6f01f432fb844ceb31a24157a20f7ffca3db1f14...7c0ea46beba228ff5e8c973062bb57d369b821d6,1,1,0,1,1,2010-08-10 16:11:15,2010-08-10 16:11:15
7c0ea46beba228ff5e8c973062bb57d369b821d6...93936b971d2d5ac903af29c7d25caf5f2484866a,1,1,1,2,1,2010-08-10 16:33:40,2010-08-10 16:33:40
93936b971d2d5ac903af29c7d25caf5f2484866a...5cd4e0e794e3ff0ba6801b6fda9242f1d82a7bea,1,6,1,7,3,2010-08-10 17:01:05,2010-08-10 17:01:05
5cd4e0e794e3ff0ba6801b6fda9242f1d82a7bea...c0ec8f8c2273579b30667e959f478c3d3f8b28dc,1,7,7,14,1,2010-08-11 15:24:44,2010-08-11 15:24:44
c0ec8f8c2273579b30667e959f478c3d3f8b28dc...b7a287b712f1a5933a3bfba2b5f88c72ec36079a,1,1,1,2,1,2010-08-11 16:43:05,2010-08-11 16:43:05
b7a287b712f1a5933a3bfba2b5f88c72ec36079a...7e20a576b772e4eeb029609a1855dc16a5a0ea4d,1,1,1,2,1,2010-08-11 17:34:03,2010-08-11 17:34:03
7e20a576b772e4eeb029609a1855dc16a5a0ea4d...641beda175e12e476e5ad10fa234578519d9608b,1,4,3,7,2,2010-08-11 17:39:04,2010-08-11 17:39:04
641beda175e12e476e5ad10fa234578519d9608b...b62226ae73eee430f899d3797de5dc65d1b9cdd7,7,1528,4726,6254,28,2010-08-11 18:00:26,2010-08-11 18:00:26
b62226ae73eee430f899d3797de5dc65d1b9cdd7...60bdf64d33a5bf5068717393b393e8df4c2708d7,1,1,1,2,1,2010-08-11 18:53:00,2010-08-11 18:53:00
60bdf64d33a5bf5068717393b393e8df4c2708d7...0af551cb89579ecbff8b78d3f5edcb211302877c,1,1,1,2,1,2010-08-11 18:58:45,2010-08-11 18:58:45
0af551cb89579ecbff8b78d3f5edcb211302877c...5274efc3352517922bfaa20724de246ea4eec364,1,1,3,4,1,2010-08-11 19:04:01,2010-08-11 19:04:01
5274efc3352517922bfaa20724de246ea4eec364...59fca99d2feee753aff8b4c436c238babe7e1d18,1,2,3,5,2,2010-08-11 19:15:25,2010-08-11 19:15:25
59fca99d2feee753aff8b4c436c238babe7e1d18...078e29150dccb4e64c4b8c78c65c64f91198e7fb,1,158,136,294,45,2010-08-11 19:19:50,2010-08-11 19:19:50
078e29150dccb4e64c4b8c78c65c64f91198e7fb...44d45649ec3ea0e9a3560df1a5708bc7a590aa5a,1,0,3,3,1,2010-08-11 19:32:40,2010-08-11 19:32:40
44d45649ec3ea0e9a3560df1a5708bc7a590aa5a...e1f6987b3de0587fb160948c5e9566878fb6d184,1,3,0,3,1,2010-08-11 21:09:17,2010-08-11 21:09:17
e1f6987b3de0587fb160948c5e9566878fb6d184...154f5e116e36c7adf1035fc46ff4ecda73a31b6d,2,3,3,6,3,2010-08-13 15:13:42,2010-08-13 15:13:42
154f5e116e36c7adf1035fc46ff4ecda73a31b6d...43abda835a09a471240c461cc3602d301479b389,1,7,8,15,1,2010-08-13 15:18:42,2010-08-13 15:18:42
43abda835a09a471240c461cc3602d301479b389...bffa2952f4609b2a39ae6c03e623f395185cfec9,1,4,3,7,3,2010-08-13 15:38:37,2010-08-13 15:38:37
bffa2952f4609b2a39ae6c03e623f395185cfec9...bd20b78646f8e64db064437dadeb78c8ffb57401,1,0,0,0,0,2010-08-13 15:39:10,2010-08-13 15:39:10
bd20b78646f8e64db064437dadeb78c8ffb57401...deaa08400f283d024ec83c2c4d76f9476da1e99c,2,6,3,9,4,2010-08-13 16:32:21,2010-08-13 16:32:21
deaa08400f283d024ec83c2c4d76f9476da1e99c...0d40d843ef2862c504005ee43ff64e255ea1b04d,1,1,3,4,1,2010-08-13 16:37:14,2010-08-13 16:37:14
44d45649ec3ea0e9a3560df1a5708bc7a590aa5a...96ab97e16798c753887446c5ba694a1b95a9acc3,1,2,2,4,2,2010-08-11 20:09:54,2010-08-11 20:09:54
9182b30a3aafab51d71e6a11e9b687c14bd6bbcf...5c8f106330cbb5bcf22c0209fb2edc3eb3760bd7,4,74,10,84,5,2010-08-13 19:24:16,2010-08-13 19:24:16
5c8f106330cbb5bcf22c0209fb2edc3eb3760bd7...140f672a93e9e4e7666ea37b4f363ec97fd7ae0d,2,9,6,15,2,2010-08-16 04:01:25,2010-08-16 04:01:25
140f672a93e9e4e7666ea37b4f363ec97fd7ae0d...ee56b5414bf37a74a157bde8fd3256d0f4468341,7,9,1,10,1,2010-08-20 17:58:08,2010-08-20 17:58:08
ee56b5414bf37a74a157bde8fd3256d0f4468341...f050dc98cacaeeea84a300221bcb96baefc37513,4,384,370,754,6,2010-08-21 14:29:07,2010-08-21 14:29:07
f050dc98cacaeeea84a300221bcb96baefc37513...52cb17be69dfb45d3fbd756435139be774726388,11,2346,0,2346,9,2010-08-21 14:30:05,2010-08-21 14:30:05
52cb17be69dfb45d3fbd756435139be774726388...c2d222decc481362a4b49295d9170f23d3c0fe0b,3,78,38,116,12,2010-08-22 05:34:13,2010-08-22 05:34:13
c2d222decc481362a4b49295d9170f23d3c0fe0b...ac1f74ede250f7a41ead335386996fc91b856c37,1,9,9,18,9,2010-08-22 05:39:40,2010-08-22 05:39:40
9182b30a3aafab51d71e6a11e9b687c14bd6bbcf...fcf8374f6eb25001a87ee86a7c9c75560a2fb03a,1,1,0,1,1,2010-08-13 17:24:14,2010-08-13 17:24:14
fcf8374f6eb25001a87ee86a7c9c75560a2fb03a...f313936e8b46eca9ff15aad1eb19f91925c3c9bc,1,3,2,5,2,2010-08-13 18:38:45,2010-08-13 18:38:45
f313936e8b46eca9ff15aad1eb19f91925c3c9bc...a8549e5ebbc8dcf81276ede6976680330ba15155,1,43,24,67,6,2010-08-13 23:49:14,2010-08-13 23:49:14
a8549e5ebbc8dcf81276ede6976680330ba15155...0cf1d90c7cf206d122722b3876d8451b821c6846,1,2,1,3,2,2010-08-13 23:50:53,2010-08-13 23:50:53
96ab97e16798c753887446c5ba694a1b95a9acc3...2e03575209e121802b648e0fe48809766b8fa119,1,1,1,2,1,2010-08-12 20:10:14,2010-08-12 20:10:14
96ab97e16798c753887446c5ba694a1b95a9acc3...9fc563ab4743ce5762e0acd362f9919fe95e8054,1,1,4,5,1,2010-08-11 20:30:15,2010-08-11 20:15:21
9fc563ab4743ce5762e0acd362f9919fe95e8054...4da4cf0f7e4d7a7ead7ed2eb2fb37577349862b1,1,68,0,68,1,2010-08-13 05:45:20,2010-08-12 13:08:50
70769f5e9a8a8b9387d8b8a740c3a2e6ee4d9656...48cce7cee7f0038c00bcd42fb9ca874d4615639d,15,0,2474,2474,11,2010-08-23 05:44:15,2010-08-23 05:44:15
48cce7cee7f0038c00bcd42fb9ca874d4615639d...7ae590b005dcc2860c6d998259f0879d8c6691b0,15,2474,0,2474,11,2010-08-23 05:44:48,2010-08-23 05:44:48
7ae590b005dcc2860c6d998259f0879d8c6691b0...b7315160465709669564a8f51e9d43816d113323,5,43,41,84,27,2010-08-23 05:59:09,2010-08-23 05:59:09
b7315160465709669564a8f51e9d43816d113323...4cb7f310d06cbe0cc6bab6604556a28d86f7bd88,2,4,3,7,3,2010-08-23 06:10:15,2010-08-23 06:10:15
4cb7f310d06cbe0cc6bab6604556a28d86f7bd88...1019c7f6049e4c1a0e263c3b625c798d5c9ad666,1,8,1,9,1,2010-08-23 06:17:25,2010-08-23 06:17:25
1019c7f6049e4c1a0e263c3b625c798d5c9ad666...b22c2094277a97f8ea683ad32bf81a105c9bea6a,2,17,14,31,12,2010-08-23 06:40:21,2010-08-23 06:40:21
b22c2094277a97f8ea683ad32bf81a105c9bea6a...8e7a4773a0d0b83df4e51ae18576bc0489a4ee68,2,7,3,10,2,2010-08-23 06:53:18,2010-08-23 06:53:18
8e7a4773a0d0b83df4e51ae18576bc0489a4ee68...c43f55925391a333473022da523392353dabe69e,1,8,7,15,5,2010-08-23 06:56:41,2010-08-23 06:56:41
c43f55925391a333473022da523392353dabe69e...3a617231404999b9f088ad001a1c2dbf6f9b61ee,1,3,0,3,1,2010-08-23 07:08:04,2010-08-23 07:08:04
3a617231404999b9f088ad001a1c2dbf6f9b61ee...f0d67b79641f2f6faf87834b5d177af146116a3f,4,6261,9,6270,7,2010-08-25 05:41:45,2010-08-25 05:41:45
f0d67b79641f2f6faf87834b5d177af146116a3f...b8670a8024ecf8ecbe16fe94d087beccb49d6e24,2,5,2,7,2,2010-08-25 05:44:20,2010-08-25 05:44:20
b8670a8024ecf8ecbe16fe94d087beccb49d6e24...d9fcb27dd8abeec2650b0a7d5a5274ff553e70fa,1,0,2,2,1,2010-08-25 23:27:11,2010-08-25 23:27:11
d9fcb27dd8abeec2650b0a7d5a5274ff553e70fa...4de69a3378fcac05c35091bf1128735999eed61c,2,26,17,43,11,2010-08-29 02:20:47,2010-08-29 02:20:47
4de69a3378fcac05c35091bf1128735999eed61c...79ecbfbd63bdfc75d54c018bf3a676343ba9ecb5,1,18,18,36,8,2010-08-29 02:58:58,2010-08-29 02:58:58
0cf1d90c7cf206d122722b3876d8451b821c6846...ec1bf21c1969f71cae56d0e2f5d32811cbde40ae,1,7,1,8,1,2010-08-14 05:29:35,2010-08-14 05:29:27
ec1bf21c1969f71cae56d0e2f5d32811cbde40ae...280b11a3f8d3fe9ba726c1f3059d705e6804789f,1,2,0,2,1,2010-08-15 19:04:33,2010-08-15 19:04:27
280b11a3f8d3fe9ba726c1f3059d705e6804789f...0d7f8d775ab4ab171c6372f992d506088ca5d3ed,1,1,3,4,1,2010-08-15 19:12:50,2010-08-15 19:12:50
0d7f8d775ab4ab171c6372f992d506088ca5d3ed...6faf48600694045f539be3540253c6c252e32038,2,9,7,16,4,2010-08-18 05:21:45,2010-08-18 05:21:45
6faf48600694045f539be3540253c6c252e32038...cb7fb6dbceb9f70cdf08a48c201c439d74e9ff05,1,5,7,12,3,2010-08-18 05:26:57,2010-08-18 05:26:57
cb7fb6dbceb9f70cdf08a48c201c439d74e9ff05...f9e53ffa77cb371be9dcf99a6466663585726901,1,6,4,10,2,2010-08-18 05:28:08,2010-08-18 05:28:08
f9e53ffa77cb371be9dcf99a6466663585726901...b75228bdcb86fe13c50c3b2e7e3169823501888b,1,8,10,18,3,2010-08-18 05:52:53,2010-08-18 05:52:53
79ecbfbd63bdfc75d54c018bf3a676343ba9ecb5...6d7669feeaeb54df341c32bb4251fd0c40a0b85a,1,1,0,1,1,2010-09-17 12:08:43,2010-09-17 12:08:43
79ecbfbd63bdfc75d54c018bf3a676343ba9ecb5...1e0419a5024a38b37fa002c76c8a560bd02c270c,4,44,19,63,22,2010-09-09 12:53:33,2010-09-09 12:53:24
1e0419a5024a38b37fa002c76c8a560bd02c270c...cffb3e67d2c7719fbfdc611c57bb9fc9b211b3a1,2,4,1,5,3,2010-09-09 13:06:22,2010-09-09 13:06:04
cffb3e67d2c7719fbfdc611c57bb9fc9b211b3a1...3ddc6fd603075cc22c84e2f00c5691d1a6e41055,1,56,9,65,9,2010-09-09 14:05:44,2010-09-09 14:05:42
3ddc6fd603075cc22c84e2f00c5691d1a6e41055...7c53e93f5b22a10f866c8cc9cd6b197d5400d350,2,7,18,25,9,2010-09-09 14:14:11,2010-09-09 14:14:11
7c53e93f5b22a10f866c8cc9cd6b197d5400d350...13a7871230ced95868c46eb587273388db1dd8ed,1,189,62,251,43,2010-09-23 18:40:01,2010-09-23 18:40:01
13a7871230ced95868c46eb587273388db1dd8ed...f85869bebf78699cac644686e916dcd976bdc1dc,1,45,1,46,2,2010-09-26 21:21:04,2010-09-26 21:21:04
f85869bebf78699cac644686e916dcd976bdc1dc...bfdcb520475f274c51c4582999c174273bcfde26,5,0,0,0,0,2010-09-30 16:38:14,2010-09-30 16:38:14
bfdcb520475f274c51c4582999c174273bcfde26...abd9fa2f27e62c67a6b33a1930e399270c7142b7,1,15,15,30,11,2010-09-30 17:00:07,2010-09-30 17:00:07
abd9fa2f27e62c67a6b33a1930e399270c7142b7...ac77f5306cd2a35fcad8af20c486b5b645fbde7f,2,1,1,2,1,2010-09-30 17:01:54,2010-09-30 17:01:54
ac77f5306cd2a35fcad8af20c486b5b645fbde7f...821f848246dca9740bf7c0859f146f81c43cc12f,1,4,1,5,1,2010-09-30 17:05:24,2010-09-30 17:05:24
821f848246dca9740bf7c0859f146f81c43cc12f...83cbe16c5972b92559b7b03a8963cfc363ba8036,1,14,9,23,6,2010-09-30 17:16:39,2010-09-30 17:16:39
83cbe16c5972b92559b7b03a8963cfc363ba8036...a576b24268ffb7461284bd82e6a6ccfafcbaccde,1,45,0,45,1,2010-10-14 05:19:34,2010-10-14 01:15:35
65426765e0802c3ae8581bf21fd43640b5746423...81accd09fdfe1440dfa8ad142a09478115e6a3f4,1,19,19,38,13,2010-08-16 07:14:49,2010-08-16 07:14:49
81accd09fdfe1440dfa8ad142a09478115e6a3f4...4d022ee471ab3737848b881cf63ad0a48b251e8c,1,3,3,6,3,2010-08-18 05:47:04,2010-08-18 05:47:04
4d022ee471ab3737848b881cf63ad0a48b251e8c...f6cd10e7f2ee91d442a26eaa096fecff1a344e96,1,1,0,1,1,2010-08-18 05:49:23,2010-08-18 05:49:23
34f15fe3280016d0aa7e3ca3e1da7420a1e7817b...7169d3dd419923771f99e90f9d607b5f198a3a94,3,576,367,943,3,2010-08-18 05:57:50,2010-08-16 21:48:04
7169d3dd419923771f99e90f9d607b5f198a3a94...c307935b4c5a163cd200e2b92b86ec2765d64475,1,37,49,86,11,2010-08-18 05:57:50,2010-08-16 22:05:13
71df119772902147a8ba945ee00c3a21f0025dd6...9ac07e0e4251d026d028b77e9f9bd6b4930d7ed1,5,711,415,1126,33,2010-11-19 04:25:11,2010-11-19 04:25:11
9ac07e0e4251d026d028b77e9f9bd6b4930d7ed1...df1e4b833b6f617255a4bfd3c3304d03aad02741,1,0,0,0,0,2010-11-19 04:30:49,2010-11-19 04:30:49
df1e4b833b6f617255a4bfd3c3304d03aad02741...773e064e45580d73d076a920c1e40b3930b7ce56,1,8,9,17,4,2010-11-19 05:41:32,2010-11-19 05:41:32
aa1a03d135f16addd7086cdb09d9e98906cd934b...1259e6e686a3ccbd77b8585f74e4e969a4f99076,1,32,8,40,5,2010-10-23 20:06:54,2010-10-23 20:06:54
1259e6e686a3ccbd77b8585f74e4e969a4f99076...ae5b9e5935f74dd3240da44dcc3c2c9693e9b3c8,2,0,0,0,0,2010-10-23 20:14:09,2010-10-23 20:14:09
ae5b9e5935f74dd3240da44dcc3c2c9693e9b3c8...9312c89f728fb1917eb7c38d2c8c0ec09739771c,1,1,1,2,1,2010-10-23 20:15:56,2010-10-23 20:15:56
9312c89f728fb1917eb7c38d2c8c0ec09739771c...c3fea3d3850984b5b86b14b97d583ac00ede26fa,1,9,11,20,6,2010-10-23 20:50:15,2010-10-23 20:50:15
c3fea3d3850984b5b86b14b97d583ac00ede26fa...10d0ea87a7b3936c5fc7521fd25b6cad830a3961,1,3,1,4,2,2010-10-23 20:56:39,2010-10-23 20:56:39
10d0ea87a7b3936c5fc7521fd25b6cad830a3961...bc8ac592ee5633150054fb1c1a06c8d1385b6be0,1,19,26,45,4,2010-10-23 21:11:51,2010-10-23 21:11:51
bc8ac592ee5633150054fb1c1a06c8d1385b6be0...a9e055cf3893d95cfb04e936ff2a95fef8d73eac,2,2,3,5,2,2010-10-23 21:17:58,2010-10-23 21:17:56
a9e055cf3893d95cfb04e936ff2a95fef8d73eac...aae80dc83cd86a93e24143d3dbd94349a34386c0,3,1,1,2,1,2010-10-23 21:21:34,2010-10-23 21:21:34
aae80dc83cd86a93e24143d3dbd94349a34386c0...88ae83698a8c157ae91b6630843b4af8ba0ecc72,1,3,3,6,4,2010-10-23 21:24:03,2010-10-23 21:24:03
f6cd10e7f2ee91d442a26eaa096fecff1a344e96...7f4b38824da7a32d0e03fe17cca9fa7b90a29509,1,0,0,0,0,2010-08-18 06:25:37,2010-08-18 06:25:37
c307935b4c5a163cd200e2b92b86ec2765d64475...88044f40d7e06eea9fa2de8b427fa79f074eefa7,1,10,2,12,3,2010-08-18 06:08:16,2010-08-18 06:07:58
88044f40d7e06eea9fa2de8b427fa79f074eefa7...7a33f7281963cc1bd1324a5d0fa4f874d4a73da1,2,5,10,15,2,2010-08-18 06:16:29,2010-08-18 06:16:29
7a33f7281963cc1bd1324a5d0fa4f874d4a73da1...04a706273bc1afb7387c28d133e738e87dae2096,2,1,1,2,1,2010-08-18 06:21:13,2010-08-18 06:21:13
04a706273bc1afb7387c28d133e738e87dae2096...a884c218388dda4b9a7618a618e53855c542cb49,1,4,5,9,1,2010-08-18 06:29:05,2010-08-18 06:29:05
3b9dd052fa48755366e07ee2dab812ef00260727...71b308c30afc3e0d6a2b195174c8179d1eecf1bb,2,104,103,207,45,2011-01-23 00:43:02,2011-01-23 00:43:02
71b308c30afc3e0d6a2b195174c8179d1eecf1bb...98335ab5a04dc24294ab23bb63cef834ebd3126a,1,2,15,17,3,2011-01-23 00:57:30,2011-01-23 00:57:30
98335ab5a04dc24294ab23bb63cef834ebd3126a...c50f6e0a7e7166b730521ac66c4a67cf0192a3e4,3,11,5,16,5,2011-01-23 01:02:13,2011-01-23 01:02:13
c50f6e0a7e7166b730521ac66c4a67cf0192a3e4...eea85ed4cf4432131268929bbec9c769b69bd2ed,3,14,4,18,4,2011-01-23 01:45:25,2011-01-23 01:45:25
eea85ed4cf4432131268929bbec9c769b69bd2ed...2cdb10c472f1d0a330a03b18240ec2e1bc0fe617,42,4652,2350,7002,50,2011-01-23 02:37:35,2011-01-23 02:37:35
2cdb10c472f1d0a330a03b18240ec2e1bc0fe617...80d6d583065ecf3075d4974e4d6cfd94677f3111,1,1,1,2,1,2011-01-23 04:32:35,2011-01-23 04:24:29
80d6d583065ecf3075d4974e4d6cfd94677f3111...46a9bad46bf9be482c62d6ac722b5833dbcc6925,2,1,18,19,2,2011-01-24 03:07:42,2011-01-23 05:46:15
46a9bad46bf9be482c62d6ac722b5833dbcc6925...2496a8e8f1f1eaf6d9a8638b99f308fb90c18ffe,1,26,48,74,14,2011-01-24 03:07:43,2011-01-24 02:32:51
2496a8e8f1f1eaf6d9a8638b99f308fb90c18ffe...78f4ec5517f09eeb4e456f54bfd8683eb99a49e7,1,6,0,6,1,2011-01-24 03:07:43,2011-01-24 02:59:17
78f4ec5517f09eeb4e456f54bfd8683eb99a49e7...15b32829ca230bed107a5696cf32c7c6a7f60b84,2,3,3,6,3,2011-01-24 05:12:07,2011-01-24 05:12:07
15b32829ca230bed107a5696cf32c7c6a7f60b84...55495513b7fd61fdbf80c4aed32b909580ac5138,1,3,2,5,1,2011-01-25 21:51:01,2011-01-24 13:06:30
55495513b7fd61fdbf80c4aed32b909580ac5138...38d79ac945f93c6ff0a5d5b9b713f39cab2622a2,1,43,0,43,1,2011-01-25 22:10:09,2011-01-25 22:09:13
33d032c2b966ede111a9a3a8d8874e7d4622074c...f62ec9094314411b0b05e5501e9ed2c862f7367f,1,2,2,4,2,2010-08-18 17:58:19,2010-08-18 17:58:19
f62ec9094314411b0b05e5501e9ed2c862f7367f...f4a9c70f05a1576e4b539ed916b3be6cb2fade12,1,49,43,92,22,2010-08-18 19:24:38,2010-08-18 19:24:38
f4a9c70f05a1576e4b539ed916b3be6cb2fade12...d3b7e404ba7e6a61022f978f51f2b2d5a2209bf7,1,120,0,120,3,2010-08-19 02:56:32,2010-08-19 02:56:32
38d79ac945f93c6ff0a5d5b9b713f39cab2622a2...de50e81376e8d02ad345fc202a4251de96507c5b,1,2,2,4,2,2011-02-01 00:54:11,2011-02-01 00:54:11
de50e81376e8d02ad345fc202a4251de96507c5b...8c9e80188a2f04e968085f46b35e1c3d489b5cc5,1,2,2,4,2,2011-02-02 09:38:11,2011-02-02 09:38:11
8c9e80188a2f04e968085f46b35e1c3d489b5cc5...1733fc8acd940c849f80295f8acce73bf6d9c03c,4,1869,1023,2892,388,2011-02-03 12:23:37,2011-02-03 12:23:37
38d79ac945f93c6ff0a5d5b9b713f39cab2622a2...cebeb1f81bc56ce542d4b5655eef074e78734f75,1,32,0,32,1,2011-01-26 19:30:14,2011-01-26 19:30:14
cebeb1f81bc56ce542d4b5655eef074e78734f75...7217a506e739f26a00390f0d97fbbfbfab867630,1,1,0,1,1,2011-01-27 03:16:38,2011-01-27 03:16:38
7217a506e739f26a00390f0d97fbbfbfab867630...70a1c04805d2e592b780977e9a8ca9532c0a7968,1,1,1,2,1,2011-01-27 03:27:19,2011-01-27 03:27:19
38d79ac945f93c6ff0a5d5b9b713f39cab2622a2...dab3e71f992bb594351356d6b8b832ab42b77934,1,1,2,3,1,2011-01-26 11:14:22,2011-01-26 11:14:22
a105038907ee74e6611084e2adda226e48bd0a86...107e463934a82164255fce54a1fed82e17738781,2,32,14,46,19,2010-10-23 21:34:28,2010-10-23 21:34:28
107e463934a82164255fce54a1fed82e17738781...2acb0c81fd27c91cb5b86525ccfadbea89b113af,2,14,3,17,6,2010-10-23 21:39:55,2010-10-23 21:39:55
d3b7e404ba7e6a61022f978f51f2b2d5a2209bf7...7c63a523b55ead03535a2fe13c5f6602f4f2423d,1,2,1,3,1,2010-08-20 18:42:35,2010-08-20 16:56:41
7c63a523b55ead03535a2fe13c5f6602f4f2423d...34c0003bae9fd8af82a88a35031458606a854206,1,3,0,3,1,2010-08-20 18:42:46,2010-08-20 11:18:43
34c0003bae9fd8af82a88a35031458606a854206...d780598fb3ff03c8fdca5b68218623c923f2acdf,1,1,1,2,1,2010-08-20 21:41:43,2010-08-20 20:39:16
d780598fb3ff03c8fdca5b68218623c923f2acdf...62a17ea8d0ab4224859f82c1b376828b804bed2a,1,1,1,2,1,2010-08-21 15:27:58,2010-08-21 15:27:58
62a17ea8d0ab4224859f82c1b376828b804bed2a...79a96886ae385b81035f6bdf8fb2df263ff63a0a,1,2,2,4,1,2010-08-23 07:33:56,2010-08-20 20:49:46
79a96886ae385b81035f6bdf8fb2df263ff63a0a...997150e4d377dcfbed6684c0ea513f1afb93390e,1,9,2,11,2,2010-08-23 07:34:28,2010-08-21 20:11:31
d3b7e404ba7e6a61022f978f51f2b2d5a2209bf7...ce1d7e045523fe9bbbba6554fb989e9a4d94aa8a,1,1,1,2,1,2010-08-20 04:29:07,2010-08-20 04:29:07
ce1d7e045523fe9bbbba6554fb989e9a4d94aa8a...1acecc461cf546fed295075b050bd42c66b2f196,1,0,3,3,1,2010-08-20 04:29:35,2010-08-20 04:29:35
1acecc461cf546fed295075b050bd42c66b2f196...7827a908cc461c51977479a3ec8a548f609edf86,1,5,4,9,1,2010-08-20 04:56:44,2010-08-20 04:56:44
7827a908cc461c51977479a3ec8a548f609edf86...30e0d834bd29a64a45c703fb2d9adff9e62db90c,1,1,1,2,1,2010-08-21 17:54:48,2010-08-21 17:54:48
1733fc8acd940c849f80295f8acce73bf6d9c03c...33139c8012358ded1013db1df7c1979c09ba1500,1,6,0,6,1,2011-02-08 15:48:31,2011-02-08 15:48:31
1733fc8acd940c849f80295f8acce73bf6d9c03c...7588f53379dcd49b93e67de1e5a331f28b3f4e5d,1,5,0,5,1,2011-02-07 20:02:37,2011-02-07 20:02:37
7588f53379dcd49b93e67de1e5a331f28b3f4e5d...84161236ea8d2ca99cc635f97a4df8e0e2d5cf8c,1,1,1,2,1,2011-02-07 20:14:42,2011-02-07 20:14:42
18be2cf89a9cd314496e36464bde479caf505c57...a2c48898b5c0c29a67ac88bdd42fecaae1c501a2,1,2,0,2,1,2011-03-01 06:30:12,2011-03-01 06:30:12
a2c48898b5c0c29a67ac88bdd42fecaae1c501a2...c1f064c0fe461b5fec596e75d9426e6c59c06dd5,1,2,1,3,1,2011-03-01 06:33:03,2011-03-01 06:33:03
c1f064c0fe461b5fec596e75d9426e6c59c06dd5...937c886b99837fdd8e2750b9d21559ca082ed4d1,6,14,21,35,6,2011-03-01 06:36:58,2011-03-01 06:36:58
9b29109f2cc36af69800266ecbde7f85045ed9de...5b4f0aa34ba6589e68b78f6ce648e8365eb89999,2,2,1,3,2,2011-02-15 15:28:53,2011-02-15 15:28:53
9b29109f2cc36af69800266ecbde7f85045ed9de...369e439a0fc30df2018f52c5dd6c2f2f2baa9145,1,6,1,7,1,2011-02-15 14:29:35,2011-02-15 14:29:35
2acb0c81fd27c91cb5b86525ccfadbea89b113af...22b8ab5215b8bdc29ac62b12d8e9a4d76a592a87,2,4,4,8,3,2010-10-24 00:16:04,2010-10-24 00:16:04
22b8ab5215b8bdc29ac62b12d8e9a4d76a592a87...8f5642f76bb29dad29ecba76cacebf19c80d730c,2,92,34,126,22,2010-10-24 00:16:44,2010-10-24 00:16:44
2acb0c81fd27c91cb5b86525ccfadbea89b113af...49e3ec0f6e907e11008f5102bc593def9a19728c,1,3,1,4,1,2010-10-23 23:41:12,2010-10-23 23:41:12
997150e4d377dcfbed6684c0ea513f1afb93390e...b59c1cc00e1f6a25a12a224080a70287fa33e4da,1,1,0,1,1,2010-08-24 22:52:53,2010-08-23 17:48:10
30e0d834bd29a64a45c703fb2d9adff9e62db90c...a470eef75a1dcc0fe9e1578657ab30516739f32e,1,1,1,2,1,2010-08-23 07:24:49,2010-08-23 07:24:49
33139c8012358ded1013db1df7c1979c09ba1500...ff29c100515ecb4dd82da5a2f8a4d3e2d0563acf,1,81,73,154,48,2011-02-09 16:23:09,2011-02-09 10:21:03
c13b80dd9ce4a77e200a13dd05a9a00ac979c05c...5e25d85bcfe0952273618fc1586caf2375fb0a04,1,7,7,14,6,2011-03-01 19:10:06,2011-02-27 07:29:33
5e25d85bcfe0952273618fc1586caf2375fb0a04...96c1155fa3ea4758f039741ba37d257f064fdc9a,1,12,12,24,11,2011-03-01 19:10:07,2011-02-27 07:30:59
96c1155fa3ea4758f039741ba37d257f064fdc9a...11827ed6461a8f5490d372d1baa006d268289542,1,4,4,8,4,2011-03-01 19:10:07,2011-02-27 07:33:18
11827ed6461a8f5490d372d1baa006d268289542...1f60eae9143b2a8d7d9c43e7d40f247786e1b000,1,5,3,8,1,2011-03-01 19:10:07,2011-02-27 07:36:27
1f60eae9143b2a8d7d9c43e7d40f247786e1b000...b68861f48d2e6075340603dabb7b9cb743dc888e,1,2,0,2,1,2011-03-01 19:10:07,2011-02-27 07:51:40
b68861f48d2e6075340603dabb7b9cb743dc888e...8ef7f55c4ee8870e86f6098f0b6f46eae2e75a16,1,3,3,6,3,2011-03-01 19:10:07,2011-02-27 07:54:04
8ef7f55c4ee8870e86f6098f0b6f46eae2e75a16...7d39c4483097e3fb16080caa8358cb41bd0eaf5a,1,1,1,2,1,2011-03-01 19:10:07,2011-02-27 08:23:19
7d39c4483097e3fb16080caa8358cb41bd0eaf5a...df5722ee731f5fcacd8323a1e93bdd9c7f469b5c,1,6,41,47,6,2011-03-01 19:10:07,2011-02-27 08:55:40
df5722ee731f5fcacd8323a1e93bdd9c7f469b5c...b26e8bbd5bbf134404d398c819bcc32b61c58979,1,10,0,10,1,2011-03-02 08:07:31,2011-03-02 08:07:31
6f2d5058f8c8cc27b4339c801b6024b288c9ca67...5e69fa5bc6bc969d0cb57fef5cb1da5e6614d733,1,2,8,10,2,2011-02-16 13:59:44,2011-02-16 13:59:44
5e69fa5bc6bc969d0cb57fef5cb1da5e6614d733...696a6126b7076bd74aa54532fb0306337e511c1a,1,20,14,34,2,2011-02-16 16:27:44,2011-02-16 16:27:44
40f00569714ee0dab3916c4dd87b9819a24f3c0b...ac10328814ceb16dfbffa904854081c7f3319135,1,49,45,94,14,2010-10-24 01:23:30,2010-10-24 01:23:30
ac10328814ceb16dfbffa904854081c7f3319135...7f0bb87d7a89de80bcd63cf005d5a5fc956f54a8,1,22,13,35,12,2010-10-24 01:45:34,2010-10-24 01:45:34
7f0bb87d7a89de80bcd63cf005d5a5fc956f54a8...1a37db2d2b224dd6c0243e6fb89e579f7170b41f,4,10,8,18,5,2010-10-24 02:01:13,2010-10-24 02:01:13
1a37db2d2b224dd6c0243e6fb89e579f7170b41f...985cdfa107543e456f3cf8a50b6d8ebc1b023e10,7,13,17,30,14,2010-10-24 02:05:49,2010-10-24 02:05:49
985cdfa107543e456f3cf8a50b6d8ebc1b023e10...a63e92273f9a841877f20c3d42b74dd1cfa46487,1,13,9,22,8,2010-10-24 02:21:35,2010-10-24 02:21:35
a63e92273f9a841877f20c3d42b74dd1cfa46487...9b79047a0088837aabcfadf235fd9b216374bb2e,4,3,0,3,1,2010-10-24 02:38:42,2010-10-24 02:38:42
9b79047a0088837aabcfadf235fd9b216374bb2e...5be6f1f3b1727d0249de4741b9211004605c58bf,1,18,13,31,4,2010-10-24 04:43:20,2010-10-24 04:43:20
5be6f1f3b1727d0249de4741b9211004605c58bf...42420bb93a4d37312a9382663cce7783bc75ecb9,1,1,2,3,1,2010-10-24 04:45:30,2010-10-24 04:45:30
42420bb93a4d37312a9382663cce7783bc75ecb9...8694236447e14846fed650d047dcca7346150d31,1,3,1,4,2,2010-10-24 05:15:17,2010-10-24 05:15:17
8694236447e14846fed650d047dcca7346150d31...90ef7c944b76246548e047a36056acbb9d090021,1,3,0,3,3,2010-10-24 05:19:36,2010-10-24 05:19:36
90ef7c944b76246548e047a36056acbb9d090021...72c0e596718b27e423c00fa43ffc62a786bd498a,1,4,1,5,3,2010-10-24 05:30:26,2010-10-24 05:30:26
72c0e596718b27e423c00fa43ffc62a786bd498a...2571f188e35d62fc8c5360285820025420af29a0,1,6,9,15,3,2010-10-24 05:56:27,2010-10-24 05:56:27
2571f188e35d62fc8c5360285820025420af29a0...bc08925c1d416f04a1de1a63b521c4a58c98d5aa,3,94,95,189,43,2010-10-24 20:13:20,2010-10-24 20:13:20
40c807740188b4a9da563cece0c41d74eb7cbcd2...75b34e5962b155238bcb711e87b34a6409787e78,1,1,316,317,1,2010-08-25 05:12:59,2010-08-25 05:12:59
75b34e5962b155238bcb711e87b34a6409787e78...5a8f1285923f2449e4d7d4c95c775573f26c29f7,1,14,6,20,7,2010-08-26 06:15:58,2010-08-26 06:15:58
5a8f1285923f2449e4d7d4c95c775573f26c29f7...0cec104e42f77c03d97a3578bd9f1529d249f455,1,0,2,2,1,2010-08-26 22:52:54,2010-08-26 22:52:51
0cec104e42f77c03d97a3578bd9f1529d249f455...33aeaab7b178c60753cd145b9b95c92ce2234650,1,1,1,2,1,2010-08-26 22:56:33,2010-08-26 22:56:31
33aeaab7b178c60753cd145b9b95c92ce2234650...8c3477d199e51b03b0ef8fb8baeb884a30b5309e,1,2,2,4,1,2010-08-26 23:09:10,2010-08-26 23:09:10
8c3477d199e51b03b0ef8fb8baeb884a30b5309e...a77e668cfc39c424aa37d0f3c48ea0b732c66f54,1,4,0,4,1,2010-08-27 04:57:00,2010-08-27 04:57:00
a77e668cfc39c424aa37d0f3c48ea0b732c66f54...2c0dce9143b84802dbc681d7021d00157d6988d4,1,2,1,3,1,2010-08-29 02:40:51,2010-08-29 02:40:51
2c0dce9143b84802dbc681d7021d00157d6988d4...cfbd24a704ec59c568f17a74d4dc5a381ea6435d,1,3,2,5,1,2010-08-30 23:27:42,2010-08-30 22:40:36
05aa1e4af4482a6f2a639467a2671916faeb5b35...e24de7ffa943045d8929dfc2807fcce3b9da7cfa,2,8,2,10,2,2010-08-23 15:16:54,2010-08-23 15:16:54
e24de7ffa943045d8929dfc2807fcce3b9da7cfa...6735c0ee7468990acb392923886d4e8487c662fe,1,3,0,3,1,2010-08-24 22:47:39,2010-08-24 22:47:39
6735c0ee7468990acb392923886d4e8487c662fe...387f71e533fdb590b2ffb02d45665c2187267c56,1,6,4,10,2,2010-08-24 22:52:09,2010-08-24 22:52:09
ff29c100515ecb4dd82da5a2f8a4d3e2d0563acf...e75f023662342a429435300255095b6b2c713aa2,1,4,9,13,4,2011-02-11 22:00:34,2011-02-11 22:00:34
e75f023662342a429435300255095b6b2c713aa2...2fe0b745d5fc52dee6d94ed315a41131c1653eab,1,5,0,5,3,2011-02-11 22:09:19,2011-02-11 22:09:19
2fe0b745d5fc52dee6d94ed315a41131c1653eab...3a41223daf37c7cd6fdec070de484bca94755a52,1,1,0,1,1,2011-02-11 22:11:23,2011-02-11 22:11:23
b26e8bbd5bbf134404d398c819bcc32b61c58979...315586244c0a4fb0f0ccc7727441b0d0b7bb10c4,1,1,0,1,1,2011-03-05 22:49:49,2011-03-05 22:49:49
315586244c0a4fb0f0ccc7727441b0d0b7bb10c4...37f0ac6fe38fcb4b4ad041338a575279ec101d9a,3,407,407,814,34,2011-03-05 23:09:11,2011-03-05 23:09:11
37f0ac6fe38fcb4b4ad041338a575279ec101d9a...5ed87b9881523b7f7f346af8ef25961037c2607a,2,9,3,12,8,2011-03-05 23:59:57,2011-03-05 23:59:57
5ed87b9881523b7f7f346af8ef25961037c2607a...758b71478314adf9e230e5f59b27c79584f4da23,3,22,4,26,7,2011-03-06 01:29:43,2011-03-06 01:29:43
758b71478314adf9e230e5f59b27c79584f4da23...10ee9c474c536d8b8ca53c723f729b9f76891bbb,28,131,14,145,19,2011-03-06 01:36:52,2011-03-06 01:36:52
10ee9c474c536d8b8ca53c723f729b9f76891bbb...d9801c57e154292df482a35cf271db27957cefbe,1,2,2,4,2,2011-03-06 02:28:16,2011-03-06 02:28:13
d9801c57e154292df482a35cf271db27957cefbe...6a4a1e25b144483a4606687c95b9b4ee3fd4b745,1,5,0,5,1,2011-03-06 02:52:01,2011-03-06 02:52:01
6a4a1e25b144483a4606687c95b9b4ee3fd4b745...cada0b681a1ec1b31c7c832bd4bc2b5c4a5a278e,1,1,1,2,1,2011-03-06 03:14:20,2011-03-06 03:14:20
cada0b681a1ec1b31c7c832bd4bc2b5c4a5a278e...a638ad6f0c5e36f4ace94fb545ca40425a88ebb2,6,21,14,35,6,2011-03-06 03:14:47,2011-03-06 03:14:47
a638ad6f0c5e36f4ace94fb545ca40425a88ebb2...eb091e9f8039bec38b61d37ff67f652f6b602b9c,3,23,31,54,10,2011-03-06 03:20:55,2011-03-06 03:20:55
eb091e9f8039bec38b61d37ff67f652f6b602b9c...e81479ba2f7d0fc386448baa5edea5d0e1116c63,1,21,1,22,2,2011-03-06 03:33:33,2011-03-06 03:33:33
b26e8bbd5bbf134404d398c819bcc32b61c58979...2ea8ab2bec373b35b02915ef27f20f8c41f4698b,1,21,11,32,6,2011-03-02 15:36:50,2011-03-02 15:36:50
2ea8ab2bec373b35b02915ef27f20f8c41f4698b...598a1c9633040e802be5cd047ea6a9ab79ec461c,1,3,3,6,3,2011-03-02 15:38:54,2011-03-02 15:38:54
696a6126b7076bd74aa54532fb0306337e511c1a...899e1a817eeb064996500c7c7a870c5636db4890,3,3,31,34,3,2011-02-21 15:09:15,2011-02-21 15:09:15
899e1a817eeb064996500c7c7a870c5636db4890...964f1b44a3469c3d63980ff55ab3446821c1d390,3,3,3,6,3,2011-02-21 20:36:45,2011-02-21 20:36:45
696a6126b7076bd74aa54532fb0306337e511c1a...8d402bbe8891f35b790d55f69b20d69eaed33d64,2,18,16,34,5,2011-02-19 03:51:05,2011-02-19 03:51:05
8d402bbe8891f35b790d55f69b20d69eaed33d64...7df2afc560aac9d7898dd97595beaf832baf8281,1,1,2,3,3,2011-02-19 03:58:33,2011-02-19 03:58:33
bc08925c1d416f04a1de1a63b521c4a58c98d5aa...c873907cfad02cf19853f94156570aec6fe16c5d,1,7,4,11,1,2010-10-26 05:15:04,2010-10-26 05:15:04
c873907cfad02cf19853f94156570aec6fe16c5d...231c448384ffa27258a3f86d13fbf03f90b605c4,1,16,1,17,2,2010-10-26 05:15:27,2010-10-26 05:15:27
231c448384ffa27258a3f86d13fbf03f90b605c4...b1ab6fedac9f69c39913bbefe17c9d8df7728c65,1,0,0,0,0,2010-10-26 05:16:36,2010-10-26 05:16:36
bc08925c1d416f04a1de1a63b521c4a58c98d5aa...c37eaaa9b0de50c36fc3556cbbe53e58453867cc,1,3,0,3,1,2010-10-25 19:34:49,2010-10-25 19:34:49
bc08925c1d416f04a1de1a63b521c4a58c98d5aa...1cd1a2507debc84dcbe738012818c04f20309b96,1,0,0,0,0,2010-10-25 16:18:14,2010-10-25 16:18:14
cfbd24a704ec59c568f17a74d4dc5a381ea6435d...021504bc305330c2bd8fffa74378dc5e15ce581a,1,13,1,14,1,2010-09-07 19:11:20,2010-09-07 19:11:20
cfbd24a704ec59c568f17a74d4dc5a381ea6435d...7d2fa8d98bec323ab963a07a6ad3cca9ff375a3e,1,2,1,3,1,2010-09-06 22:23:52,2010-09-06 22:23:52
7d2fa8d98bec323ab963a07a6ad3cca9ff375a3e...35849021d425ef09a9a5dccdd2b7de5f93fae37b,1,2,1,3,1,2010-09-06 22:24:26,2010-09-06 22:24:26
35849021d425ef09a9a5dccdd2b7de5f93fae37b...19482bafb689c8c88038b3f1225cddc73fe7efa1,1,4,2,6,2,2010-09-07 06:25:05,2010-09-07 06:25:05
19482bafb689c8c88038b3f1225cddc73fe7efa1...52ee26c4594948e615c84504ff3cd5f3b76741c8,1,2,1,3,1,2010-09-07 07:01:07,2010-09-07 07:01:07
52ee26c4594948e615c84504ff3cd5f3b76741c8...3b1b1b61b68120be8dee3522be14fea1dd059515,1,2,2,4,1,2010-09-07 07:04:59,2010-09-07 07:04:59
3b1b1b61b68120be8dee3522be14fea1dd059515...fa0e26e9b48b97c9bdde912e381f111504820db8,1,1,1,2,1,2010-09-07 15:31:02,2010-09-06 21:33:27
fa0e26e9b48b97c9bdde912e381f111504820db8...6b33019dfba45888e12868f5a953d67afd659d29,1,0,2,2,1,2010-09-07 15:31:03,2010-09-06 22:43:06
6b33019dfba45888e12868f5a953d67afd659d29...62d8c0dadd1ae841ab7e3554eb760ea7a197db21,1,2,1,3,2,2010-09-07 15:37:27,2010-09-07 15:37:27
3a41223daf37c7cd6fdec070de484bca94755a52...3c97e05b0cb85fff69aeb231fc66a459284f7890,1,1,1,2,1,2011-02-13 00:07:22,2011-02-13 00:07:22
3a41223daf37c7cd6fdec070de484bca94755a52...1b6e010c1aaba4c6b92b2551644c3d2388146d88,1,1,1,2,1,2011-02-12 00:30:02,2011-02-12 00:30:02
1b6e010c1aaba4c6b92b2551644c3d2388146d88...20f25adb704ce99b488e3c3ac0242893ebf63dae,1,1,1,2,1,2011-02-12 00:40:25,2011-02-12 00:40:25
993440dd1b5be9e96c8f12712ead429e15bca188...779bc0283e46beba37d9b93d455c71fba9bb5b5e,1,4,0,4,1,2011-02-14 00:30:19,2011-02-01 08:32:05
779bc0283e46beba37d9b93d455c71fba9bb5b5e...eebdfffecb5c9247ad63d7a73b914f7fd0837999,1,2,2,4,1,2011-02-14 00:31:32,2011-02-13 23:48:32
eebdfffecb5c9247ad63d7a73b914f7fd0837999...5bf99e4fef82fc80514902e78548969828a906d6,1,326,270,596,5,2011-02-14 14:38:32,2011-02-14 14:38:32
cdfbffc199af9e3dca7dc9b82ab4b7c7b4709abf...3090a50f726a90287e902e717e6573e8d65da08f,1,24,24,48,6,2011-03-06 03:55:52,2011-03-06 03:55:52
3090a50f726a90287e902e717e6573e8d65da08f...339c2a64ea8506d4f909dd9ebcecbd10f71c3195,5,0,0,0,0,2011-03-06 04:35:01,2011-03-06 04:34:16
339c2a64ea8506d4f909dd9ebcecbd10f71c3195...67dfe6f47a6255a1a1aa645073e2c3bc584d92e0,1,2,2,4,2,2011-03-06 04:53:28,2011-03-06 04:47:34
67dfe6f47a6255a1a1aa645073e2c3bc584d92e0...56cefd41e47ec005e9f644e648ecbd986263b3f0,2,1,1,2,1,2011-03-06 04:53:28,2011-03-06 04:51:37
56cefd41e47ec005e9f644e648ecbd986263b3f0...2404601c7257804c45a4e0f932d574bc2f971d45,1,2,2,4,2,2011-03-06 05:14:13,2011-03-06 05:13:48
2404601c7257804c45a4e0f932d574bc2f971d45...22333ab6e02544f1780733f719fdc183924ba92e,1,1,1,2,1,2011-03-06 16:15:38,2011-03-06 15:30:01
22333ab6e02544f1780733f719fdc183924ba92e...28c06a9fb92794a1589a97afc8aa67fdf969a4c7,1,14,2,16,7,2011-03-07 07:36:51,2011-03-07 07:36:34
28c06a9fb92794a1589a97afc8aa67fdf969a4c7...9f7b4b6091473c5fedc0c32dc8fcf8c365192263,1,2,2,4,2,2011-03-07 07:53:08,2011-03-07 07:53:08
9f7b4b6091473c5fedc0c32dc8fcf8c365192263...6ac62b0846b33d0833f8f6918a493a81a971f988,1,2,2,4,2,2011-03-07 07:53:30,2011-03-07 07:45:52
6ac62b0846b33d0833f8f6918a493a81a971f988...f93c3a5b87576e4ca1c780263a2caa8e1ac114c0,7,0,1097,1097,5,2011-03-07 07:57:06,2011-03-07 07:57:06
f93c3a5b87576e4ca1c780263a2caa8e1ac114c0...a39f656d95148d780b4dc2d8204de72591df2e2f,7,1097,0,1097,5,2011-03-07 08:38:05,2011-03-07 08:38:05
a39f656d95148d780b4dc2d8204de72591df2e2f...17894ff685da6ffa1ed4449fb8eac19e66e273fa,2,23,11,34,11,2011-03-07 17:23:23,2011-03-07 17:23:23
17894ff685da6ffa1ed4449fb8eac19e66e273fa...caeb9138fcebf2c6843faaf1d59b0ed0e9002b09,1,1,1,2,1,2011-03-15 16:49:03,2011-03-07 03:02:27
caeb9138fcebf2c6843faaf1d59b0ed0e9002b09...ff3ed8f40240551aab3a4213a18532f063e90f15,1,82,80,162,4,2011-03-15 21:47:10,2011-03-11 06:13:03
ff3ed8f40240551aab3a4213a18532f063e90f15...d7d467e69e5236bd9c9fa8823aead352926e98a3,7,49,49,98,38,2011-03-15 21:50:07,2011-03-09 23:41:30
d7d467e69e5236bd9c9fa8823aead352926e98a3...828141a41dda4fa6ca9d4d5e3a9734712d805a92,1,2,2,4,2,2011-03-19 22:01:36,2011-03-19 17:44:40
828141a41dda4fa6ca9d4d5e3a9734712d805a92...dc5379c0c99c05dd03be4a7c780d9857ba4ebbb1,2,1,3,4,2,2011-03-19 22:01:37,2011-03-19 19:41:23
dc5379c0c99c05dd03be4a7c780d9857ba4ebbb1...5b4ddd3a582510c29401c6fd5a46c80ef025c208,1,99,0,99,1,2011-03-20 04:34:34,2011-03-20 04:34:34
5b4ddd3a582510c29401c6fd5a46c80ef025c208...94cb8195b7cc134f878ee9173e6bfb378e9b0508,1,3,3,6,3,2011-03-20 17:20:27,2011-03-20 17:16:10
94cb8195b7cc134f878ee9173e6bfb378e9b0508...7f73ae3d720b15390c0c7ad1ee5c10bac4cca2fb,30,7,4746,4753,32,2011-03-20 17:23:53,2011-03-20 17:23:53
7f73ae3d720b15390c0c7ad1ee5c10bac4cca2fb...aa3068c8e028ae8edae457fc5439fb327b133325,1,1,1,2,1,2011-03-20 22:54:37,2011-03-19 22:29:55
aa3068c8e028ae8edae457fc5439fb327b133325...2fedc604cc989fa3b352ac6b213ff110dfde1fd7,1,1,1,2,1,2011-03-20 23:24:36,2011-03-20 23:24:36
2fedc604cc989fa3b352ac6b213ff110dfde1fd7...69039d03b90fef3a2a799e05de39514df1556fe3,1,43,6,49,14,2011-03-21 01:47:13,2011-03-21 01:47:13
69039d03b90fef3a2a799e05de39514df1556fe3...50fb1a7870fc7a430a30cd835d8f711614a8a138,2,1,1,2,1,2011-03-22 06:19:13,2011-03-22 06:19:10
50fb1a7870fc7a430a30cd835d8f711614a8a138...19fec34e0d4cb2856b9b55d4cdd261c26b77c6c6,1,37,31,68,1,2011-03-22 13:49:55,2011-03-22 12:58:49
19fec34e0d4cb2856b9b55d4cdd261c26b77c6c6...5c9fa3a83d96ab1af53baaa536195e19b3143289,1,1,1,2,1,2011-03-22 16:32:14,2011-03-22 16:32:14
5c9fa3a83d96ab1af53baaa536195e19b3143289...71880dee163428ec414f000fc2cb17492b692bfb,2,7,7,14,5,2011-03-22 16:49:08,2011-03-22 16:49:08
71880dee163428ec414f000fc2cb17492b692bfb...4dc87b52c2bb2f6d799c1e51af50da34d5b38ee8,1,4,0,4,1,2011-03-23 16:33:24,2011-03-23 16:33:24
4dc87b52c2bb2f6d799c1e51af50da34d5b38ee8...e4edeff4fa1aa8c81f495e2d75527584a29e83fb,1,0,4,4,1,2011-03-23 20:30:34,2011-03-23 20:30:34
e4edeff4fa1aa8c81f495e2d75527584a29e83fb...91fa2168395f7a04444a85d8e9113fb942872de3,1,4,4,8,2,2011-03-26 02:55:25,2011-03-26 02:55:25
91fa2168395f7a04444a85d8e9113fb942872de3...b9341fe4ce72c5f7c9a51cfe87b8f2565bca1a54,1,9,1,10,1,2011-03-26 03:25:50,2011-03-26 03:25:50
b9341fe4ce72c5f7c9a51cfe87b8f2565bca1a54...41c657a05aefd2d0ff9a8bb1b28a0c2c6eb950ee,1,1,1,2,1,2011-03-26 23:54:40,2011-03-26 21:53:16
41c657a05aefd2d0ff9a8bb1b28a0c2c6eb950ee...9b1a477b1215feb005a7b2d1e70e01cf439dc1dd,1,1,1,2,1,2011-03-28 22:55:11,2011-03-28 22:55:11
9b1a477b1215feb005a7b2d1e70e01cf439dc1dd...edf9c3fbdbd30e1441f1aee594e1686937ada017,1,4,1,5,1,2011-03-29 14:53:34,2011-03-28 16:15:07
edf9c3fbdbd30e1441f1aee594e1686937ada017...5b6db9d0bd8c45b5965f9e8871afbc9da83f437f,1,1,1,2,1,2011-03-29 19:01:22,2011-03-29 19:01:22
5b6db9d0bd8c45b5965f9e8871afbc9da83f437f...bb22ca66a8619808a87c1b5438845ed44baa4d3e,3,6,6,12,6,2011-03-30 15:26:45,2011-03-30 15:26:45
bb22ca66a8619808a87c1b5438845ed44baa4d3e...8185bc313a361f033345616b9adc4dc10506fcaf,4,1,1,2,1,2011-03-30 19:51:52,2011-03-30 19:51:52
ad3d7341494e74b7e498ea165505b1dc5c950c3f...ccf437a7c22027cec9659173f50273923ede5f02,1,2,2,4,2,2011-02-22 17:54:50,2011-02-22 17:54:50
ccf437a7c22027cec9659173f50273923ede5f02...792430393c8e5de85e3b2548280a69cf711b978d,2,2,2,4,2,2011-02-22 22:12:20,2011-02-22 06:31:41
f0e4dbeaf7d3686dc7d42a7894feb5b3e361673e...73df98404732c4d927e74dc2bce5850d36152aa3,1,1,1,2,1,2010-10-26 05:45:50,2010-10-26 05:45:50
1cd1a2507debc84dcbe738012818c04f20309b96...7226d7e6ce6a630bdd529cedaefa9cff5c09e987,1,2,0,2,1,2010-10-26 17:01:41,2010-10-26 17:01:41
9cbbe837c39626c7bc88646be560ea448b427655...35ababe1864ddad50d78bcade47d9cbea1281e24,2,8,6,14,3,2010-09-08 00:30:16,2010-09-08 00:30:16
35ababe1864ddad50d78bcade47d9cbea1281e24...970744f8b96c2f4d3e48bea496bd1d10c35fb5fa,2,6,8,14,3,2010-09-08 00:35:37,2010-09-08 00:35:37
970744f8b96c2f4d3e48bea496bd1d10c35fb5fa...20cef6944d5963aca75b35003000dfd22ac1524d,1,8,12,20,3,2010-09-08 00:38:50,2010-09-08 00:38:50
9cbbe837c39626c7bc88646be560ea448b427655...541c6c02f159118c8de2bc661a5f459a2884cf0e,1,7,2,9,2,2010-09-07 22:40:53,2010-09-07 22:40:53
541c6c02f159118c8de2bc661a5f459a2884cf0e...2bb7d6c6e79e888ca7d46929f16bf663e44d95e2,1,6,7,13,3,2010-09-07 22:44:34,2010-09-07 22:44:34
8185bc313a361f033345616b9adc4dc10506fcaf...e3007f0b31ae5214a311b84030e54f4d0a31a080,1,6,1,7,1,2011-04-07 20:38:30,2011-04-07 20:38:30
8185bc313a361f033345616b9adc4dc10506fcaf...ce7e249ae439cd7c873d48043cc909f3b36d29c8,4,560,0,560,3,2011-04-05 01:40:49,2011-04-05 01:40:49
ce7e249ae439cd7c873d48043cc909f3b36d29c8...3820568da429f6063cb16a00c1a00da4dbb6b113,1,1,1,2,1,2011-04-05 01:50:14,2011-04-05 01:50:14
3820568da429f6063cb16a00c1a00da4dbb6b113...b736756a92203078d0552bcde015f1d79134721c,1,6653,539,7192,2,2011-04-05 13:06:51,2011-04-05 13:06:51
b736756a92203078d0552bcde015f1d79134721c...7ef42605c2dd4c117dce8402d4a595cb31253a98,1,2,0,2,1,2011-04-05 13:09:18,2011-04-05 13:09:18
7ef42605c2dd4c117dce8402d4a595cb31253a98...ce6878eeb40a9fdba7e7a4b936c0af6ef368ab06,1,2,0,2,1,2011-04-05 13:11:33,2011-04-05 13:11:33
ce6878eeb40a9fdba7e7a4b936c0af6ef368ab06...5ea8b6446ba4341abe109f414624aaaf8c9cb833,1,1,0,1,1,2011-04-05 13:15:48,2011-04-05 13:15:48
5ea8b6446ba4341abe109f414624aaaf8c9cb833...164dcab88bb3f25805a843f93dca0d9e7e7e3a1c,4,5919,2,5921,4,2011-04-05 14:53:51,2011-04-05 14:53:51
164dcab88bb3f25805a843f93dca0d9e7e7e3a1c...2d4ddfeca940d9511784aba093f0294ff0e8f944,5,80,69,149,10,2011-04-05 15:48:26,2011-04-05 15:48:26
792430393c8e5de85e3b2548280a69cf711b978d...d88d40dd205b5e7210610d0a115f401f351aca1c,2,3,3,6,3,2011-02-23 15:46:40,2011-02-23 15:46:40
d88d40dd205b5e7210610d0a115f401f351aca1c...b0bb456eeb5732910c444e7951895f186d607bb0,4,580,440,1020,211,2011-02-25 13:15:39,2011-02-25 13:15:39
b0bb456eeb5732910c444e7951895f186d607bb0...cf4726e7c22d9bd3db265b218620148838796e58,1,1,1,2,1,2011-03-01 04:34:21,2011-03-01 04:34:21
cf4726e7c22d9bd3db265b218620148838796e58...ce120b5902cdf3c9ba4936fae6f222c405fc01b0,1,1,1,2,1,2011-03-01 04:51:01,2011-03-01 04:51:01
ce120b5902cdf3c9ba4936fae6f222c405fc01b0...2a2f1d6d8bed2894472e89e127a362d3e3d9c7ab,2,6,6,12,3,2011-03-01 05:03:06,2011-03-01 05:03:06
2a2f1d6d8bed2894472e89e127a362d3e3d9c7ab...7a5705b57ad4db0737b5fbbb77b8bc7845c25884,1,1,0,1,1,2011-03-01 05:32:49,2011-03-01 05:32:49
7a5705b57ad4db0737b5fbbb77b8bc7845c25884...8def09ffda26e7cc552f9183caa3322103270436,1,1,1,2,1,2011-03-01 05:53:49,2011-03-01 05:53:49
8def09ffda26e7cc552f9183caa3322103270436...6875bb5be7ee7fce13bae11b3db8da2918fe4821,1,1,1,2,1,2011-03-01 06:05:42,2011-03-01 06:05:42
792430393c8e5de85e3b2548280a69cf711b978d...e124b48fb0607594230d9cac57576e2a51763683,1,54,15,69,3,2011-02-23 00:49:37,2011-02-23 00:46:51
e90971b6bb302999c32edca080cd1ad7f280d582...c59f163cd57604c26d71c5d91fae87813ebc7c2a,1,2,3,5,3,2010-10-26 16:38:39,2010-10-26 16:38:39
c59f163cd57604c26d71c5d91fae87813ebc7c2a...373dd13bb0f775ebeb1c725e1d3d62700504c8e5,1,1,1,2,1,2010-10-26 17:01:19,2010-10-26 16:56:49
637d25b16d4e2ef7eaf3191bef84eaa07ec5a0a8...7b96c314bd2912b9ca478be087df4e008ce767d1,1,143,0,143,1,2010-10-27 15:58:20,2010-10-27 11:59:42
7b96c314bd2912b9ca478be087df4e008ce767d1...1754717e5b3cfaced866aacfb23e3878fd8830c7,1,79,0,79,1,2010-10-27 16:17:43,2010-10-27 13:20:23
1754717e5b3cfaced866aacfb23e3878fd8830c7...e2c718cc0f96f141b905fca005e099918553f1c0,2,6,3,9,4,2010-10-27 16:18:03,2010-10-27 13:35:06
e2c718cc0f96f141b905fca005e099918553f1c0...dc6978a8dcb0ddc292865e5e756091baa199e266,1,1,1,2,1,2010-10-27 16:24:34,2010-10-27 16:24:34
637d25b16d4e2ef7eaf3191bef84eaa07ec5a0a8...f19dab3f9cde5dd52a03978078137ae98f844df1,1,2,1,3,1,2010-10-26 18:18:14,2010-10-26 18:18:14
f19dab3f9cde5dd52a03978078137ae98f844df1...d96229ca1782b0239d34a89a74c39d60a46530d8,1,1,1,2,1,2010-10-27 17:47:45,2010-10-27 17:47:45
df703d6efaa4762efba558c7c095d033218b4555...56067ff0420b05a21018d3294606b099d69ffbb1,1,3,0,3,1,2010-09-08 00:49:41,2010-09-08 00:49:41
2bb7d6c6e79e888ca7d46929f16bf663e44d95e2...7dacbd42cde7b82c0da941a389fe1fca9111a375,3,2,3,5,3,2010-09-08 01:00:03,2010-09-08 00:04:51
e3007f0b31ae5214a311b84030e54f4d0a31a080...d2acfe06542056534eef0f3b75b6aea5ca872725,1,4,4,8,1,2011-04-09 15:58:31,2011-04-09 08:58:15
e3007f0b31ae5214a311b84030e54f4d0a31a080...c35755b8d677990e564c2208e2d3f791b587964e,2,15,11,26,6,2011-04-07 23:09:48,2011-04-07 01:47:53
c35755b8d677990e564c2208e2d3f791b587964e...96d7b26406817d46ebcdcaa25d7f688768d90962,2,4,15,19,3,2011-04-07 23:10:28,2011-04-07 21:10:57
96d7b26406817d46ebcdcaa25d7f688768d90962...a0ac99a4d96453e68ff4e650fca3055767ec26aa,3,111,217,328,84,2011-04-07 23:10:28,2011-04-07 21:13:04
a0ac99a4d96453e68ff4e650fca3055767ec26aa...b817d1758cdef628ec5b3e74a83704c84320ff25,1,12,0,12,2,2011-04-08 18:29:19,2011-04-08 18:29:19
b817d1758cdef628ec5b3e74a83704c84320ff25...043491dea58735a572148ef97a0240ef4b264de7,1,1,1,2,1,2011-04-08 18:30:24,2011-04-08 18:30:24
043491dea58735a572148ef97a0240ef4b264de7...f1a8fbf6499f65aed4c4d2feea505ded81dae20b,1,1,0,1,1,2011-04-08 21:51:20,2011-04-08 21:51:20
f1a8fbf6499f65aed4c4d2feea505ded81dae20b...eab37feb458c001a85c6281b764d297aee44ad91,1,3,1,4,2,2011-04-09 05:17:43,2011-04-09 05:17:43
eab37feb458c001a85c6281b764d297aee44ad91...a59a243edac417f798a564e9be3446f968bc12ab,2,1,1,2,1,2011-04-16 18:38:39,2011-04-16 18:38:39
a59a243edac417f798a564e9be3446f968bc12ab...a2274d19932cf64265b4c12c7a0863e3458d540c,2,57,43,100,35,2011-04-16 18:43:57,2011-04-16 18:43:57
a2274d19932cf64265b4c12c7a0863e3458d540c...7e5efcc23ca443a68636c6f70629403982ea73d7,1,10,7,17,8,2011-04-16 18:49:47,2011-04-16 18:49:47
14608f44cfe509a543eb5a6fb78796e0fd70a9f9...a30e338dc514368c6a49fb72fa50af9b921537c9,1,2,1,3,2,2011-05-26 18:18:38,2011-05-26 18:18:38
3f3d6f4ae967ea479742ad0115aaa2e85d89940e...6794dc3c10bb56b644780d5e45806c408974ba3a,1,6,5,11,1,2010-10-28 21:46:49,2010-10-28 21:46:49
4d486dec16bd32c063942148cfa6586a5733f573...6ce800b6b931b00404c74c2e908999d40456c709,1,5,4,9,3,2010-09-08 06:39:13,2010-09-08 06:39:13
6ce800b6b931b00404c74c2e908999d40456c709...9f9d6ee0512c0405ffd2fe9f737a0910ab4acd8b,1,4,1,5,3,2010-09-08 06:41:34,2010-09-08 06:41:29
9f9d6ee0512c0405ffd2fe9f737a0910ab4acd8b...8596d5ea5bd2471493b8036f29cb8b80ce088f3e,1,2,2,4,1,2010-09-08 08:02:07,2010-09-08 08:02:04
8596d5ea5bd2471493b8036f29cb8b80ce088f3e...4c8819de50d2745e38a82eccd8fd824d8c270252,4,11,0,11,3,2010-09-09 18:22:16,2010-09-09 18:22:16
4c8819de50d2745e38a82eccd8fd824d8c270252...4828e62772aef68b976aa9c6ed6140304a0f26a2,1,3,5,8,3,2010-09-09 18:36:51,2010-09-09 18:36:51
d2acfe06542056534eef0f3b75b6aea5ca872725...a556e26cb55a424d83022cfec4680d539eb94cd5,4,84,6,90,7,2011-08-05 08:50:39,2011-08-05 08:50:39
d2acfe06542056534eef0f3b75b6aea5ca872725...0843a608eb440b56b0ab46cbda9f5c5c2e7ddf99,1,5,5,10,10,2011-04-13 22:07:55,2011-04-13 22:07:55
d2acfe06542056534eef0f3b75b6aea5ca872725...1cf9f7487f8bafdc3afdb726bab6a59e7adb1edc,1,2,2,4,2,2011-04-12 10:23:07,2011-04-12 10:23:07
b0685726da213c4594a045059508ff40b5edbf25...0c9eec9b52a06c9e17e70c1acfd8b89f72e92575,1,1,1,2,1,2011-05-15 11:13:06,2011-05-15 11:13:06
0c9eec9b52a06c9e17e70c1acfd8b89f72e92575...4bbbfc88de894382a118aa61e551c76a83d08cec,1,1,1,2,1,2011-05-15 11:14:20,2011-05-15 11:14:20
4bbbfc88de894382a118aa61e551c76a83d08cec...fb41ccd5386456390101d798a18350779d414380,1,8,8,16,8,2011-05-15 11:15:23,2011-05-15 11:15:23
b0685726da213c4594a045059508ff40b5edbf25...59b993abe9da844c5c68b0cf149b5b24f9560e70,7,205,132,337,80,2011-05-13 14:04:11,2011-05-13 14:04:11
59b993abe9da844c5c68b0cf149b5b24f9560e70...8a3955dae60fb91b624e710138815b8133e7be07,1,1,1,2,1,2011-05-13 14:05:03,2011-05-13 14:05:03
8a3955dae60fb91b624e710138815b8133e7be07...5cad48ced5738704e63183b4053b56b5a9d77638,1,1,1,2,1,2011-05-13 14:39:59,2011-05-13 14:39:59
fdb8f6acede111e4b91010e5b311f83a85c9ee4e...5c93b0306921d3f407d968ed3734e052b5fdce1b,1,14,16,30,6,2011-05-30 21:41:24,2011-05-30 21:41:24
5c93b0306921d3f407d968ed3734e052b5fdce1b...d9f114c01941dfe3b0890e13122af6855c43f3d2,3,40,4,44,7,2011-05-30 21:49:12,2011-05-30 21:49:12
fdb8f6acede111e4b91010e5b311f83a85c9ee4e...3300a6847fec552b3180ee3bd8aca89bb649ec86,1,2,0,2,1,2011-05-28 05:09:28,2011-05-28 05:09:28
fdb8f6acede111e4b91010e5b311f83a85c9ee4e...1d0ec96931cf111c0e2fd5cd74e60b35ae716148,2,42,5,47,4,2011-05-26 22:02:51,2011-05-26 22:02:51
1d0ec96931cf111c0e2fd5cd74e60b35ae716148...347e0c005358c5c53891c83ae5ae8e16592b3a66,1,1,1,2,1,2011-05-26 22:20:47,2011-05-26 22:20:47
6794dc3c10bb56b644780d5e45806c408974ba3a...b57c5c8620f19045fe4ba407975bcf082736c2ae,1,1,1,2,1,2010-10-29 01:47:25,2010-10-29 01:47:25
6794dc3c10bb56b644780d5e45806c408974ba3a...3d95cfa01e383abc8cead8fd085f2b13a0d2c333,4,12,1,13,7,2010-10-29 01:37:43,2010-10-29 01:20:28
4828e62772aef68b976aa9c6ed6140304a0f26a2...f6ee7c0865521f1fbb9f55af19a02e6e3436eccd,1,1,1,2,1,2010-09-20 18:37:18,2010-09-20 18:37:18
f6ee7c0865521f1fbb9f55af19a02e6e3436eccd...d019e266d2d69a25705ecd270b38cc1cdfaa7c39,1,1,1,2,1,2010-09-23 23:01:29,2010-09-23 23:01:29
d019e266d2d69a25705ecd270b38cc1cdfaa7c39...7db47878f80366597d19f0a5b0e6df55275fa51f,1,2,2,4,1,2010-09-28 19:57:53,2010-09-28 19:07:05
7db47878f80366597d19f0a5b0e6df55275fa51f...50f7cc2ebf3e83a685927aed9a6f0fe4180ab5ce,1,0,2,2,1,2010-09-29 13:47:22,2010-09-29 12:13:26
50f7cc2ebf3e83a685927aed9a6f0fe4180ab5ce...e15dd09c30eb4d58f5e481efe6c8fcf54aec8977,1,1,1,2,1,2010-09-30 19:09:10,2010-09-29 19:34:26
4828e62772aef68b976aa9c6ed6140304a0f26a2...6af1777227bc3f0a3a09e83265d80c60625dc8a6,2,34,11,45,8,2010-09-09 22:08:48,2010-09-08 16:57:39
6af1777227bc3f0a3a09e83265d80c60625dc8a6...e10e662a48f51486ca10e56180e21be832aa47d9,5,410,35,445,12,2010-09-09 22:09:06,2010-09-08 17:25:03
e10e662a48f51486ca10e56180e21be832aa47d9...2ada12eecdb8b674dcdcf8870539932724b354a9,2,19,23,42,18,2010-09-09 22:16:31,2010-09-09 22:15:05
2ada12eecdb8b674dcdcf8870539932724b354a9...b6761011fced116fd5237e8d0047c915ada69a59,3,29,7,36,5,2010-09-09 22:24:01,2010-09-09 22:24:01
b6761011fced116fd5237e8d0047c915ada69a59...17104e5882f2a3f75eeaa159aa2f6bba8010d980,2,14,8,22,6,2010-09-09 23:13:27,2010-09-09 23:13:27
17104e5882f2a3f75eeaa159aa2f6bba8010d980...a991b1c2b085486a9ca04103a6cd28cb3f51267e,2,14,32,46,19,2010-09-10 15:30:40,2010-09-10 15:30:40
0d4f6b5261683fb7e669e1cd13aaec78f59d4095...a81061aa37849806757f1d38ef3a257de64bde8f,2,58,46,104,14,2011-08-05 11:00:13,2011-08-05 11:00:13
a81061aa37849806757f1d38ef3a257de64bde8f...a314d2a3746f50235c2ba9bf42077525021f6787,1,6,4,10,2,2011-08-05 11:24:11,2011-08-05 11:24:11
a314d2a3746f50235c2ba9bf42077525021f6787...6c5b7719a64b185f6c92bb79720b1b9619f6e3dc,1,1,1,2,1,2011-08-05 11:44:00,2011-08-05 11:44:00
0843a608eb440b56b0ab46cbda9f5c5c2e7ddf99...5b0dd0f4dfd31ab42335b1a5a94e10d15efd8c8d,1,2,2,4,1,2011-04-14 19:37:03,2011-04-14 19:37:03
0843a608eb440b56b0ab46cbda9f5c5c2e7ddf99...24b0f14ca0bd5771d7bb085c9f9e04427bf372da,7,285,227,512,63,2011-04-14 16:55:44,2011-04-11 17:34:35
24b0f14ca0bd5771d7bb085c9f9e04427bf372da...45cd0378d5c3fdb03098b37ce6894fb54f24914b,1,4,3,7,2,2011-04-14 17:14:28,2011-04-08 14:58:53
45cd0378d5c3fdb03098b37ce6894fb54f24914b...0e18366fc50d6a5a2f73b2d1aada63b77bb3c4ae,1,5,1,6,1,2011-04-14 19:03:33,2011-04-14 18:06:00
0e18366fc50d6a5a2f73b2d1aada63b77bb3c4ae...72bb744064ed1777070af4b3a4117c3b0a8ff072,1,17,19,36,8,2011-04-14 19:03:34,2011-04-14 18:34:59
72bb744064ed1777070af4b3a4117c3b0a8ff072...6ee79bc4baf7809a00f7133953b1b08c6092f2df,1,1,1,2,1,2011-04-14 19:20:55,2011-04-14 19:20:55
6ee79bc4baf7809a00f7133953b1b08c6092f2df...b62ca34b7274c3ff779a9669779dd32977426f26,1,2,2,4,2,2011-04-14 23:48:55,2011-04-14 23:48:55
3180b3f3dd9b10e486cd35fa74e7b3753829455c...a7361c1a132b13f31ebdb3396d51a0d1594b2c91,1,0,1,1,1,2011-05-05 17:01:41,2011-05-05 17:01:41
a7361c1a132b13f31ebdb3396d51a0d1594b2c91...fd2a816d536028ed1b1e35f08bf2fe8b5a084d4b,1,12,19,31,6,2011-05-05 17:33:28,2011-05-05 17:33:28
fd2a816d536028ed1b1e35f08bf2fe8b5a084d4b...dbed4dacf7ed2fde41a2966be813d0e2b71d6242,2,0,21,21,2,2011-05-05 18:04:35,2011-05-05 18:04:35
974d1e2d0bfd12a1120b503cf3175b772da03526...e3d389a1715a22c663909e6a8076710a85af952e,1,1,1,2,1,2011-05-16 20:36:59,2011-05-16 20:36:59
c24b78462a7b3e04d6503902c7295fea473e82a6...bad4fb528891adac2a5c0501bdc84197196eb28f,1,7,7,14,7,2011-05-31 02:02:45,2011-05-31 02:02:45
c24b78462a7b3e04d6503902c7295fea473e82a6...c7f763c966719a66f3d4f7f4345fa508e64a5148,1,6,6,12,5,2011-05-28 20:04:07,2011-05-28 20:04:07
c4c638f7d793f4649f5ec9a8fd1bafc76396e66e...252d117fa789e95f71c6eed745dca1b65eac2a18,1,1,1,2,1,2010-10-29 05:13:49,2010-10-29 05:13:49
252d117fa789e95f71c6eed745dca1b65eac2a18...45e892ff8c1abf6ba245aeae5a74ee632c7c63ff,1,1,1,2,1,2010-10-29 05:15:00,2010-10-29 05:15:00
45e892ff8c1abf6ba245aeae5a74ee632c7c63ff...e3db0c0c576a56aed6247f8c1f0bc15c97712269,2,0,2,2,2,2010-10-29 05:21:19,2010-10-29 05:21:19
e3db0c0c576a56aed6247f8c1f0bc15c97712269...ed8d1fad8a2dc25328a6a5d2f4cd3594f5d48b2f,1,2,2,4,1,2010-10-29 14:27:12,2010-10-29 10:26:14
e15dd09c30eb4d58f5e481efe6c8fcf54aec8977...3faa71c1a79ca1280976bbf2f341c07781a58600,1,2,2,4,2,2010-10-05 22:00:24,2010-10-05 02:23:58
e15dd09c30eb4d58f5e481efe6c8fcf54aec8977...e72efceb5054804ef1b027cc66277df692db15e2,2,4,6,10,3,2010-10-05 21:58:21,2010-10-05 21:58:21
341992913bb3f5a17cb5ea0055aed96b5c7e57f8...113c98f84937c43916eae1de92ca0affffc7955e,1,0,1,1,1,2011-08-09 23:50:46,2011-08-09 06:41:55
113c98f84937c43916eae1de92ca0affffc7955e...5fe1dda97c375e006273d2cc2448d035783813d0,1,3,3,6,2,2011-08-10 00:10:06,2011-08-10 00:10:06
5fe1dda97c375e006273d2cc2448d035783813d0...00be05ad18551cec2b1b4dd02bef18a19198c3a8,1,73,73,146,5,2011-08-10 02:53:52,2011-08-10 02:53:52
00be05ad18551cec2b1b4dd02bef18a19198c3a8...f10f81a2414995afd024967fbd8104c38b50cfcd,6,39,53,92,18,2011-08-10 04:59:47,2011-08-10 04:59:47
f10f81a2414995afd024967fbd8104c38b50cfcd...c996f0e685443b269c82cf8c2d7725c9cb42e752,4,11,3,14,4,2011-08-10 05:09:45,2011-08-10 05:09:45
c996f0e685443b269c82cf8c2d7725c9cb42e752...c6dbb2892b1e9af8aba4e8c0106bd30233a1a9bb,4,50,36,86,31,2011-08-10 06:07:03,2011-08-10 06:02:39
c6dbb2892b1e9af8aba4e8c0106bd30233a1a9bb...1e79f7b7dfc852d047be225289a38afe15993391,1,160,0,160,1,2011-08-10 07:17:59,2011-08-10 07:17:59
1e79f7b7dfc852d047be225289a38afe15993391...5f2b3275952dc891d163d2f0ecd685ec015f09e6,1,1,1,2,1,2011-08-10 17:30:43,2011-08-10 17:30:28
c0d3d939d7e0b7c28574d3c22b30c748937851e8...5373835d1750b0398989f4d3b8e407f90a996313,1,3,2,5,1,2011-04-21 10:32:49,2011-04-21 10:32:49
5373835d1750b0398989f4d3b8e407f90a996313...9a9660b2f9f8371e4546c28863b86a556f7be62c,1,1,2,3,1,2011-04-21 16:09:22,2011-04-21 16:09:22
9a9660b2f9f8371e4546c28863b86a556f7be62c...1b78ceb95732bcaf81f9ee61506e02b854824560,1,2,2,4,2,2011-04-21 18:57:53,2011-04-21 18:57:53
1b78ceb95732bcaf81f9ee61506e02b854824560...b2faa1fc3cff20568848c98e9a51ecda61f3bf73,1,2,2,4,2,2011-04-25 20:18:46,2011-04-25 20:18:46
4c3301b9ccd5643a20fd4f7d442d0efba9d85934...c5289aad2b5a48cbc1a91bfeb0d6edbf719d2491,1,4,4,8,3,2011-05-17 16:20:08,2011-05-17 16:20:08
c5289aad2b5a48cbc1a91bfeb0d6edbf719d2491...f467a7e84bf8872afd3b42b2faea51ff86b142d5,1,2,4,6,2,2011-05-17 16:38:20,2011-05-17 16:36:49
f467a7e84bf8872afd3b42b2faea51ff86b142d5...0e1c7ba929caddec63971cccfb7de7c0d343e060,1,2,2,4,1,2011-05-17 16:40:24,2011-05-17 16:40:24
0e1c7ba929caddec63971cccfb7de7c0d343e060...b6a8dec0e4a49ac6bd5e3fd5c7dd5c9f6aec452e,3,11,11,22,9,2011-05-17 18:23:11,2011-05-17 18:11:29
b6a8dec0e4a49ac6bd5e3fd5c7dd5c9f6aec452e...1cec539712e7a158c6f5435f26a5a812d314bef3,2,2,2,4,2,2011-05-17 18:24:08,2011-05-17 18:24:08
1cec539712e7a158c6f5435f26a5a812d314bef3...24f174de59701c31d2357ca66431b995dc95b150,2,4,4,8,2,2011-05-17 18:24:54,2011-05-17 18:24:54
24f174de59701c31d2357ca66431b995dc95b150...648026d780dc6b9ecad8d37d61a92b69be5fd654,1,2,2,4,1,2011-05-18 19:09:51,2011-05-18 19:09:51
452c2836b21724242d1c0616fffb0ae63f12e0b8...e02dd35b517aa27a392d88ce94c04d4f248c0370,1,43,21,64,12,2011-06-06 17:00:20,2011-06-06 17:00:20
e02dd35b517aa27a392d88ce94c04d4f248c0370...dc31d7c8521b81658969db04e75fbc96ab5fbaab,1,4,2,6,3,2011-06-06 17:13:48,2011-06-06 17:13:48
dc31d7c8521b81658969db04e75fbc96ab5fbaab...a2c89c09646d3ab56a2fb1c0f0270aa97d68f699,1,0,7,7,1,2011-06-06 17:18:15,2011-06-06 17:18:15
a2c89c09646d3ab56a2fb1c0f0270aa97d68f699...ef41c51637b4b3399a2f11ebcb8a8aa89d6c5ce9,1,2,2,4,2,2011-06-06 20:47:42,2011-06-06 20:47:42
bad4fb528891adac2a5c0501bdc84197196eb28f...7227e7fb278ee171f3a88cae7fbb16285dd83a98,4,8,6,14,6,2011-06-02 08:28:54,2011-06-02 08:28:54
ed8d1fad8a2dc25328a6a5d2f4cd3594f5d48b2f...72f5b495c0dfacdc74e97685ff9a88bc0b0045d7,1,2,1,3,2,2010-11-03 18:01:06,2010-11-03 17:48:48
72f5b495c0dfacdc74e97685ff9a88bc0b0045d7...fea0fdd547b64d52ab0e983de50daf7b7e6d6292,1,7,0,7,1,2010-11-06 10:21:16,2010-11-06 10:21:16
fea0fdd547b64d52ab0e983de50daf7b7e6d6292...9520ab82961723d3538a7e116a9965c3419fa80c,2,3,3,6,2,2010-11-06 14:39:00,2010-11-06 14:39:00
9520ab82961723d3538a7e116a9965c3419fa80c...af71023adc3ef28b63c9e9a3b4c3a65df11d28c6,1,1,1,2,1,2010-11-06 14:41:28,2010-11-06 14:41:28
af71023adc3ef28b63c9e9a3b4c3a65df11d28c6...a0bbe45a513634bd9bc8ee1c728c71c7d4ab7d27,1,1,1,2,1,2010-11-06 14:44:12,2010-11-06 14:44:12
a0bbe45a513634bd9bc8ee1c728c71c7d4ab7d27...81179481bceea4b5cdc4c9e78e14f216411bbfaf,1,0,1,1,1,2010-11-06 16:10:45,2010-11-06 16:10:45
ed8d1fad8a2dc25328a6a5d2f4cd3594f5d48b2f...f6c8c0ab3364636ec94fb15126a9784a2745a9d2,1,2,0,2,1,2010-10-31 22:53:42,2010-10-31 22:53:42
4e12ba48c2f6aee128a8f25303c525537bfa229f...afaf14304e55dac23b2f4c38b6c5f67a7ddb70c8,1,1,1,2,1,2010-10-09 22:33:55,2010-10-09 22:33:55
5f2b3275952dc891d163d2f0ecd685ec015f09e6...060315b591681789581c0d72415541800b00d863,1,2,2,4,1,2011-08-10 19:12:08,2011-08-10 19:12:08
b2faa1fc3cff20568848c98e9a51ecda61f3bf73...fc7d9e1ebb833b48e0ab86fda11bba015150fe41,1,1,0,1,1,2011-04-26 19:25:51,2011-04-26 19:25:51
e7089e8cf8b792a7a9dece118acc71a42cf08818...758f2f4f4c3f5669ee04b4b32ff7eec6ff52cd68,1,184,229,413,23,2011-05-07 10:13:37,2011-05-07 10:13:37
758f2f4f4c3f5669ee04b4b32ff7eec6ff52cd68...ef83a0481ed39ae10fecfaa8fda7450b162fceb7,1,1,1,2,1,2011-05-07 10:27:31,2011-05-07 10:27:31
ef83a0481ed39ae10fecfaa8fda7450b162fceb7...cf2ee8e826a01ae429e6d01b91cb76dd27f9cda7,1,221,239,460,21,2011-05-07 10:31:54,2011-05-07 10:31:54
648026d780dc6b9ecad8d37d61a92b69be5fd654...1f94b053173527f437e243ccdd1c770c90088fc4,1,3,0,3,1,2011-05-19 05:45:11,2011-05-19 05:45:11
7b37e953413974bcf3db642ef6df85fc63732d3e...695d2ca304b1d6b3b8b4ae9ffa7608f972f0a567,1,2,1,3,1,2011-06-02 08:43:38,2011-06-02 08:43:38
695d2ca304b1d6b3b8b4ae9ffa7608f972f0a567...4504c1144574fc82c399786ab365216c92797c4e,2,2,2,4,2,2011-06-02 17:44:29,2011-06-02 17:44:29
4504c1144574fc82c399786ab365216c92797c4e...ab3abb63dbf7b4697b900180c9eaa6acc874de82,3,31,36,67,13,2011-06-02 17:48:21,2011-06-02 17:48:21
ab3abb63dbf7b4697b900180c9eaa6acc874de82...0a3456758b6f915edae312014938d1b66101e89f,1,1,1,2,1,2011-06-04 13:06:25,2011-06-04 13:06:25
536b6ace6b40f9cefa86605a7656ee03fb5e21e8...7db1acaeb512644a12459208af544f79f247b62c,1,1,1,2,1,2011-07-11 10:00:55,2011-07-11 10:00:55
7db1acaeb512644a12459208af544f79f247b62c...d3dc77b211e1639a4bbb0235ae508eaa04614836,1,2,0,2,1,2011-07-12 11:54:04,2011-07-12 11:54:04
d3dc77b211e1639a4bbb0235ae508eaa04614836...a709725b0690b302d7f0eb44ad449f131f490d12,1,6,0,6,1,2011-07-12 12:00:11,2011-07-12 12:00:11
536b6ace6b40f9cefa86605a7656ee03fb5e21e8...09a8c715cbb26e4a4fe7a69ff4c8e0a077c669c8,1,1,0,1,1,2011-07-09 18:53:16,2011-07-09 18:53:16
09a8c715cbb26e4a4fe7a69ff4c8e0a077c669c8...29c7e128cd8346ddc170a3a41072dab46fa03e1f,1,1,2,3,2,2011-07-09 19:32:23,2011-07-09 19:32:23
81179481bceea4b5cdc4c9e78e14f216411bbfaf...45cb5a9aeffa09c6de74199eb7d4ee1936f7f336,1,1,1,2,1,2010-11-06 16:49:21,2010-11-06 16:49:21
81179481bceea4b5cdc4c9e78e14f216411bbfaf...168d2eb7e0654e72f9ecc2484738586110a605c3,1,11,0,11,2,2010-11-06 16:11:40,2010-11-06 15:39:02
732779413e1f532b1e27a28d42a7fe73ab9b7ab7...9cd21210f7820f678467b16d4ef0dd63dcff74a5,1,1,1,2,1,2010-11-23 14:22:26,2010-11-11 10:10:06
9cd21210f7820f678467b16d4ef0dd63dcff74a5...5fc91dfe4451f1296d1c93d9006fe3ad611bbf14,1,1,0,1,1,2010-11-24 20:32:01,2010-11-24 19:51:47
5fc91dfe4451f1296d1c93d9006fe3ad611bbf14...093b5d5c97daebd37de728a9fa76defb6efb83e3,1,1,1,2,1,2010-11-24 20:32:18,2010-11-24 20:14:33
093b5d5c97daebd37de728a9fa76defb6efb83e3...96a53956eb85413546b01d71c48b540d7314e17f,1,1,2,3,2,2010-11-24 20:35:42,2010-11-24 20:35:42
96a53956eb85413546b01d71c48b540d7314e17f...43c3719cd7d52e0ce7ded13938f8b199ec791b60,1,3,1,4,1,2010-12-01 00:10:16,2010-12-01 00:10:16
43c3719cd7d52e0ce7ded13938f8b199ec791b60...07768edc28ac7843f230ab617c58ff1fd9dd49c1,1,12,4,16,1,2010-12-01 02:12:11,2010-12-01 02:12:11
07768edc28ac7843f230ab617c58ff1fd9dd49c1...f7c3ea6e084efdb7606e5316333eb1b014e47b11,1,1,1,2,1,2010-12-01 04:10:38,2010-12-01 04:10:38
f7c3ea6e084efdb7606e5316333eb1b014e47b11...876673322c555c9afa82cea6652315f8b0901ad6,1,71,74,145,47,2010-12-01 05:13:16,2010-12-01 05:13:16
afaf14304e55dac23b2f4c38b6c5f67a7ddb70c8...819479765924f50837856e32c76394ec821c1936,1,1,0,1,1,2010-10-19 19:35:55,2010-10-19 19:35:55
afaf14304e55dac23b2f4c38b6c5f67a7ddb70c8...b87d0fbddfaa9437f6167b6a54ede42b17fff4e0,1,11,14,25,2,2010-10-13 09:54:21,2010-10-13 09:54:21
7344d57029cee72c152ca29aa687b4c117465313...b87096669bcfdc3ec836c1256cde3b31ec4ca6e8,1,2,2,4,2,2011-08-10 22:29:28,2011-08-10 22:29:28
37462b1bcc0f3fb7805ddfd1e21962d9e7f8e731...ac92ae7a5f1762bc1ec9d45f1d76a41baf641b5a,1,1,2,3,2,2011-04-26 21:59:45,2011-04-26 21:59:45
cf2ee8e826a01ae429e6d01b91cb76dd27f9cda7...2833b899148157d3e83775220baa36a43b7de20c,1,2,0,2,2,2011-05-08 06:42:48,2011-05-08 06:42:48
cf2ee8e826a01ae429e6d01b91cb76dd27f9cda7...6a71a7e9d51d3e936b50f7220426b6eca07b5512,1,4,3,7,1,2011-05-08 03:58:28,2011-05-08 03:58:28
6a71a7e9d51d3e936b50f7220426b6eca07b5512...d284eac8fd1b977002ac2e32e08d287c79abedd2,1,5,4,9,1,2011-05-08 04:14:52,2011-05-08 04:14:52
d284eac8fd1b977002ac2e32e08d287c79abedd2...f4283547f8ee2d4f8ee79821042ee870b05ad5d3,1,2,7,9,2,2011-05-08 16:30:16,2011-05-08 16:30:16
91ff0b8fec300b104d1e7f04b1d20645634da830...9ee01e94dcb9d8b2df550d4f5e94bd7bb21436ee,1,6,4,10,3,2011-05-19 07:10:34,2011-05-19 07:10:34
73b878bf9ecf62a1018faf4c55bb3c363e81b0d0...6aba703c8944de119bc4763f50023662dd924763,1,11,0,11,1,2011-06-21 17:49:34,2011-06-21 17:49:34
6aba703c8944de119bc4763f50023662dd924763...b49ca1703205042cb9a27a7c97e54bc2f7e6f6da,1,35,19,54,4,2011-06-21 17:53:11,2011-06-21 17:53:11
0a3456758b6f915edae312014938d1b66101e89f...26463fe4919970f1da9b10c6e1cb54f96da3c40e,1,0,1,1,1,2011-06-05 07:39:04,2011-06-05 07:39:04
37446e28af38a7aca5e0072e42262928e5d41f34...5416bcd103e3d1118a48ca93d17ffc0280ef96ec,1,6,2,8,1,2011-07-16 09:46:46,2011-07-16 09:46:46
5416bcd103e3d1118a48ca93d17ffc0280ef96ec...639cb05ba02c19b665a8da3a8207fe51e7c93893,1,1,1,2,1,2011-07-20 06:16:45,2011-07-20 06:16:45
639cb05ba02c19b665a8da3a8207fe51e7c93893...c72a81c5e91c04fe854001a5508cfaf01a076786,1,5,6,11,5,2011-07-20 09:03:51,2011-07-20 09:03:51
c72a81c5e91c04fe854001a5508cfaf01a076786...f78016f555372bcbd7561a7efd8247089e440c83,1,1,0,1,1,2011-07-20 13:27:48,2011-07-20 13:27:48
f78016f555372bcbd7561a7efd8247089e440c83...d965db4c5ef42219a8ad1785dc33b5a526254a7f,1,1,1,2,1,2011-07-20 13:56:51,2011-07-20 13:56:51
d965db4c5ef42219a8ad1785dc33b5a526254a7f...dc1604c697636946876e250903ba74738e2b5656,1,7,6,13,5,2011-07-20 19:38:37,2011-07-20 19:38:37
dc1604c697636946876e250903ba74738e2b5656...7f52ddf680bcdd066c8aa25269abd879d56dacf1,1,2,1,3,1,2011-07-22 16:22:49,2011-07-22 16:22:49
7f52ddf680bcdd066c8aa25269abd879d56dacf1...acdae8173571d7eeb0afafa6d249fef1224cd193,1,4,3,7,4,2011-07-22 17:00:53,2011-07-21 17:56:11
9bae730ec3a94e78bdb351a65334d2a0daaad03f...55daf5a0d500c99c8afd24e9e1d862bdd811d91f,1,2,2,4,1,2010-11-06 16:53:44,2010-11-06 16:53:44
55daf5a0d500c99c8afd24e9e1d862bdd811d91f...170b0da91226625784ae3f84d37183a8128f86e9,1,3,0,3,1,2010-11-06 17:25:24,2010-11-04 11:35:29
170b0da91226625784ae3f84d37183a8128f86e9...0d51c7a4e245395897124600a828497e18c77d67,1,24,4,28,4,2010-11-06 17:42:04,2010-10-31 23:06:17
0d51c7a4e245395897124600a828497e18c77d67...724e24e1b3850b070f6379bae1fadb8f30a8feaa,1,1,1,2,1,2010-11-06 17:42:23,2010-10-31 23:10:10
724e24e1b3850b070f6379bae1fadb8f30a8feaa...84774e88ae5cc61b77c75c0e4c12d76371e2be70,1,1,1,2,1,2010-11-09 22:23:56,2010-11-09 22:23:56
876673322c555c9afa82cea6652315f8b0901ad6...7c81999b782dbdd4e8c767741eb569bd8deb1b96,1,4,2,6,1,2010-12-01 15:20:49,2010-12-01 15:17:07
876673322c555c9afa82cea6652315f8b0901ad6...ae070b68028458046fa5d448e8d7ddebc56cf5ba,1,4,2,6,1,2010-12-01 15:17:07,2010-12-01 15:17:07
a1bb78d83ca80f97911af56c27b2b73cc8f07365...57ace156744bea037983638ff94cef24e335bea3,1,4,2,6,1,2010-10-21 04:29:03,2010-10-21 04:29:03
57ace156744bea037983638ff94cef24e335bea3...2502c9ff75e1b5b572c66d534b25428631e63480,1,1,1,2,1,2010-10-21 04:31:41,2010-10-21 04:31:41
2502c9ff75e1b5b572c66d534b25428631e63480...8f4a2982e9b6474368084ee9282ded32e12c703a,1,43,17,60,22,2010-10-21 14:08:51,2010-10-21 14:08:51
8f4a2982e9b6474368084ee9282ded32e12c703a...24b378173868fbc8afe681dbc5c685850b125e28,1,26,12,38,8,2010-10-21 18:35:16,2010-10-21 18:35:16
24b378173868fbc8afe681dbc5c685850b125e28...7914e53a6ad31175b7b27e8c580ccbfe7d34f5ab,1,2,1,3,1,2010-10-23 16:31:27,2010-10-23 16:31:18
7914e53a6ad31175b7b27e8c580ccbfe7d34f5ab...73489ab49f3b15f9119f0350d5a8ed14b4b04d58,1,13,1,14,3,2010-10-23 19:08:08,2010-10-23 19:08:08
73489ab49f3b15f9119f0350d5a8ed14b4b04d58...09f5134651ca488b761c59d4916e1b9c7f97cd6a,1,47,0,47,1,2010-10-23 19:27:19,2010-10-23 19:27:19
09f5134651ca488b761c59d4916e1b9c7f97cd6a...1939649ef71a6a24aaccdc1c4eda57e6c17a7342,1,17,17,34,2,2010-10-23 19:30:06,2010-10-23 19:30:06
1b3690933ea06d46220a9b3b8d306bd692b3ebe5...1311138f3ede0724b6b4b4b582b5e93ca8c88b24,1,2,1,3,2,2011-08-11 09:40:27,2011-08-11 09:40:27
1311138f3ede0724b6b4b4b582b5e93ca8c88b24...85d8cc0ac0b88a065f85b7a89ae0f480dba972ce,1,4,2,6,2,2011-08-11 09:42:35,2011-08-11 09:42:35
85d8cc0ac0b88a065f85b7a89ae0f480dba972ce...21933ec1eecea8b17fd36b031758ba39d3e65310,1,1,9,10,1,2011-08-11 11:29:58,2011-08-11 11:29:58
ac92ae7a5f1762bc1ec9d45f1d76a41baf641b5a...c1e3a7e6b4b8886b87e503c5ddbe51c48d80e582,3,1417,926,2343,381,2011-05-04 15:42:06,2011-05-04 15:42:06
c1e3a7e6b4b8886b87e503c5ddbe51c48d80e582...ffa8bc9438adc62d41da98fe620aadb2baf119f4,1,2,2,4,1,2011-05-04 16:17:23,2011-05-04 16:17:23
ac92ae7a5f1762bc1ec9d45f1d76a41baf641b5a...6ce2a0f9f9c96d5c7fced787894fb9eaed0aaa7d,1,5,6,11,2,2011-05-04 09:11:53,2011-05-04 09:11:53
1faa76a8047441b5f4177cbf1347ed8eb00b1cd0...9c1188592a661429f24232c6ebb01603a8f47830,1,1,2,3,1,2011-05-08 18:29:52,2011-05-08 18:29:52
9c1188592a661429f24232c6ebb01603a8f47830...e65c1ad37fbda3148e013d3b98add6b80803e3c9,2,2,8,10,2,2011-05-08 19:06:16,2011-05-08 19:06:16
e65c1ad37fbda3148e013d3b98add6b80803e3c9...7d792b68452fd8b4983d8723e3547c10b0c67578,5,304,9,313,6,2011-05-08 19:42:41,2011-05-08 19:14:58
7d792b68452fd8b4983d8723e3547c10b0c67578...0e2062cb4a26e5c88132042690c1855fb0f86982,1,13,20,33,7,2011-05-08 19:50:34,2011-05-08 19:50:34
9ee01e94dcb9d8b2df550d4f5e94bd7bb21436ee...bb94ded9f34bd098e4fec28e4e0fc6ebb61a11f9,1,1,0,1,1,2011-05-19 15:53:00,2011-05-19 15:53:00
b49ca1703205042cb9a27a7c97e54bc2f7e6f6da...d5d05a36cd1d89bb1cb5b20cbfb28bd220ed185d,1,1,3,4,1,2011-06-23 04:21:02,2011-06-23 04:21:02
d5d05a36cd1d89bb1cb5b20cbfb28bd220ed185d...b37d518d81a8cd21c2e7e55d160fccef50a8b178,1,0,35,35,1,2011-06-23 14:57:34,2011-06-23 14:57:34
b49ca1703205042cb9a27a7c97e54bc2f7e6f6da...94c63ee5711f8a88c30a05e47989926cc3b53615,1,2,1,3,3,2011-06-22 22:21:35,2011-06-22 22:21:35
94c63ee5711f8a88c30a05e47989926cc3b53615...5572931889ad89b64cf9390cadc21357f1dde24b,1,1,0,1,1,2011-06-23 15:58:18,2011-06-23 15:58:18
9cba6fcae914811e910df5297e6cedd3e610628e...7f31896fd4462c4e50748f71b24a3fb1cd375ea1,1,9,0,9,1,2011-06-06 06:51:25,2011-06-06 06:51:25
acdae8173571d7eeb0afafa6d249fef1224cd193...3f3f95de4e049367f32fea5570bffb5c542b0c8a,1,1,1,2,1,2011-07-22 17:08:21,2011-07-21 17:56:28
84774e88ae5cc61b77c75c0e4c12d76371e2be70...e863583caea7514cda74d2ba1d59432e72e807b9,1,1,1,2,1,2010-11-19 07:31:34,2010-11-19 07:31:34
84774e88ae5cc61b77c75c0e4c12d76371e2be70...473af90bdbc4728b8082565636228474a10ce4a3,1,7,6,13,1,2010-11-11 02:47:20,2010-11-11 02:47:20
473af90bdbc4728b8082565636228474a10ce4a3...5fb5af9fd277fdc0b04b33b9295b85577973eeea,1,1,1,2,1,2010-11-11 03:13:10,2010-11-11 03:13:10
5fb5af9fd277fdc0b04b33b9295b85577973eeea...4d65b4dcf292a08e3977856fd2de96e8bffc48fe,1,1,1,2,1,2010-11-11 13:29:59,2010-11-11 09:45:36
4d65b4dcf292a08e3977856fd2de96e8bffc48fe...a54714fd0b68a704ea907c2992253d0abe85b166,1,1,2,3,1,2010-11-11 14:35:49,2010-11-11 14:35:49
797a3479774bcfd82018804bde5f0d4a387c4731...a6885b51251ad349c63b4dbbd450874c750be1f2,1,1,1,2,1,2010-12-01 15:23:10,2010-12-01 15:23:10
a6885b51251ad349c63b4dbbd450874c750be1f2...2db11b3cde86c71dfbf67843c6a72225e116f342,1,2,1,3,1,2010-12-01 16:43:47,2010-12-01 16:43:47
1939649ef71a6a24aaccdc1c4eda57e6c17a7342...9329282b423acda465c370d882baa0c99ff464c8,1,3,0,3,1,2010-10-23 20:27:50,2010-10-23 20:27:50
21933ec1eecea8b17fd36b031758ba39d3e65310...98e4ca1edf9aacb59940db2a53fdf64a2aa0c03e,1,1,1,2,1,2011-08-12 15:31:31,2011-08-12 15:31:31
edd1da8572d4841729c1f9db904123af944d24bd...fe1d2a3f709ded0e6cbb74fed6404617edec89a7,1,0,6,6,1,2011-05-05 22:24:58,2011-05-05 22:24:58
edd1da8572d4841729c1f9db904123af944d24bd...7bc7e96d96d40896b5ec3fa98356ec9b7f091114,1,1,1,2,1,2011-05-04 19:51:19,2011-05-04 19:51:19
1d229e42d1e6f1357fb5fbf5bd44084a3f12b172...61557bbe0944b9842645349b130e69e9cd9c4f92,1,4,1,5,1,2011-05-05 03:13:33,2011-04-21 13:14:38
61557bbe0944b9842645349b130e69e9cd9c4f92...1a398b3eafb3abffea9873667b5601787feb252f,1,32,0,32,3,2011-05-05 03:17:03,2011-04-21 15:10:56
0e2062cb4a26e5c88132042690c1855fb0f86982...98180a91f9b8878b24bfb1365cf23b567bb97b18,1,1,1,2,1,2011-05-09 00:50:23,2011-05-09 00:50:23
362d0b78d392eb47e2ddb839a1369a276757c7de...e5e057e53815ed55f4ecfaef3057bf2940c7c0b2,5,36,44,80,8,2011-05-20 00:32:42,2011-05-20 00:32:42
e5e057e53815ed55f4ecfaef3057bf2940c7c0b2...b4a91bda9faad8c942ddbb717aff55145e9d11f5,1,6,6,12,9,2011-05-20 21:13:23,2011-05-20 21:13:23
b4a91bda9faad8c942ddbb717aff55145e9d11f5...7f53f98ec734e6b655d7a50fd245277d388fac1e,5,44,36,80,8,2011-05-24 19:47:21,2011-05-24 19:47:21
7f53f98ec734e6b655d7a50fd245277d388fac1e...cbbaaecc0eca29d0169a4a0fbe75ca5e1cabf65f,3,9,9,18,3,2011-05-24 19:53:51,2011-05-24 19:53:51
82c2125692facb0cc2ca0263567412addd2446e1...bca1d30716500a7236be024ae456ed25426daadc,1,7,0,7,1,2011-06-24 00:47:06,2011-06-24 00:36:30
7f31896fd4462c4e50748f71b24a3fb1cd375ea1...83f3d6ab0910f6e86b270babf8bfd7acd27c899e,1,3,2,5,2,2011-06-07 02:17:47,2011-06-07 02:17:47
83f3d6ab0910f6e86b270babf8bfd7acd27c899e...b10c7c04c4531843864dc4e99404226a1ae6681d,1,1,1,2,1,2011-06-07 20:32:25,2011-06-07 20:32:25
b10c7c04c4531843864dc4e99404226a1ae6681d...7610e41dad0ab47c0be5c0e4eed7bc456dd6e395,1,1,1,2,1,2011-06-08 18:29:16,2011-06-08 18:29:16
b4229a4d49b9c7744422edb05807af95110ba781...c23caaf1d89e7256c4f979f4e270837533ae1b0e,1,2,2,4,2,2011-07-23 17:24:03,2011-07-23 17:24:03
c23caaf1d89e7256c4f979f4e270837533ae1b0e...6fee66d751ccd3d934d7ab3c172bb679c46fef03,1,1,0,1,1,2011-07-24 02:25:54,2011-07-24 02:25:54
6fee66d751ccd3d934d7ab3c172bb679c46fef03...78641b530f8c767cd1b04fceb1f891726b1d4a69,1,1,1,2,1,2011-07-27 16:55:38,2011-07-27 16:55:38
78641b530f8c767cd1b04fceb1f891726b1d4a69...559bc567681d8a0a84c34b6e33c682d1738741aa,1,1,1,2,1,2011-07-30 14:56:26,2011-07-30 14:56:26
a54714fd0b68a704ea907c2992253d0abe85b166...850e08efd1a24d746c0a88f9cd5e068d8ea6d90b,1,3,0,3,2,2010-11-17 14:57:24,2010-11-17 14:57:24
850e08efd1a24d746c0a88f9cd5e068d8ea6d90b...decb4b55911133ee6646e31692a3ced893fdd5a9,1,6,3,9,3,2010-11-17 15:08:24,2010-11-17 15:08:24
a54714fd0b68a704ea907c2992253d0abe85b166...f19e32e00b816e02354b8280588f0cfebffcde0c,1,5,3,8,2,2010-11-16 09:56:00,2010-11-16 09:56:00
f19e32e00b816e02354b8280588f0cfebffcde0c...d7522e937c1f3704f47bb385c7f3bf2cd6c01e98,1,1,0,1,1,2010-11-16 13:01:07,2010-11-16 13:01:07
d7522e937c1f3704f47bb385c7f3bf2cd6c01e98...ea80fce0c197dfe38c5ed9f2c2049c0a9c56dedd,1,1,0,1,1,2010-11-16 13:02:31,2010-11-16 13:02:31
ea80fce0c197dfe38c5ed9f2c2049c0a9c56dedd...bea990b340cc34a9dd99fef84f84a4dfaccd80ae,1,0,2,2,1,2010-11-19 04:56:15,2010-11-19 04:56:15
bea990b340cc34a9dd99fef84f84a4dfaccd80ae...11aec5b3736d80ed85a5eaa529f32fcfcf943890,8,2209,1257,3466,615,2010-11-19 08:11:26,2010-11-19 08:11:26
2db11b3cde86c71dfbf67843c6a72225e116f342...02a5762d5f7a64d03f0f5b27f185e3929724c7d6,1,1,1,2,1,2010-12-05 16:16:25,2010-12-05 16:16:25
2db11b3cde86c71dfbf67843c6a72225e116f342...211da4667f821b49c76ae857ef45848769a439a2,1,3,1,4,1,2010-12-05 15:41:19,2010-12-05 07:29:54
211da4667f821b49c76ae857ef45848769a439a2...13a90524b8fd1ed588a2fbe2658204f3be141e80,1,4,0,4,1,2010-12-05 15:44:50,2010-12-03 09:11:15
0062417c5911c2b98c6f193053e957df1eb4a109...c86f2b52c04bd8de59ba99df2054451c37eb92de,1,1,1,2,1,2011-08-13 01:55:02,2011-08-13 01:55:02
fe1d2a3f709ded0e6cbb74fed6404617edec89a7...8e36358c0404fc7991871ba5da8dafe5dbd5775f,1,0,2,2,1,2011-05-05 22:32:48,2011-05-05 22:32:48
e10e3f04b4112412aa014836d2f1d724a6baccf7...caab9d30bdf539522177067fe9bc0376b1d9c239,1,6,2,8,1,2011-05-12 16:48:09,2011-05-12 16:48:09
caab9d30bdf539522177067fe9bc0376b1d9c239...0e41abd9e27206529f52c418ce75bbfeccd3a801,1,2,2,4,2,2011-05-12 17:02:27,2011-05-12 17:02:27
c03be7e137c1524f999cc7e8985aa48755c0be48...8ace459e0eeeff454aae3c9cd46c6ce54c91c18a,1,8,7,15,2,2011-06-24 04:13:25,2011-06-24 04:13:25
7610e41dad0ab47c0be5c0e4eed7bc456dd6e395...b4432895b55ecc5966cc4b970e4f774dc1354e0f,1,1,1,2,1,2011-06-12 05:32:35,2011-06-12 05:32:35
e52f6af0932681d1811acbb27f9a0ccea8a4f8a7...ebe10aef34b062ecc89dfbf18bd859a016dbbfed,1,2,1,3,1,2011-07-31 00:19:20,2011-07-31 00:13:29
ebe10aef34b062ecc89dfbf18bd859a016dbbfed...8175a1c468dc7b20e1ce93db9eeebaca2206ce2e,1,1,1,2,1,2011-07-31 00:19:20,2011-07-31 00:14:23
8175a1c468dc7b20e1ce93db9eeebaca2206ce2e...58816dd24981a78909bf63c821088c5099c2024b,1,4,5,9,3,2011-07-31 00:32:47,2011-07-31 00:29:13
9c9089879c33baadef99469bbcb14f54f9e97f21...c956187004bd3de473729f518c30c3a471614c98,1,1,1,2,1,2010-11-19 08:14:33,2010-11-19 08:14:33
c956187004bd3de473729f518c30c3a471614c98...8f1245d02702b39a4f3c7f844fc82f97578d557c,1,2,4,6,1,2010-11-19 08:37:54,2010-11-19 08:37:54
8f1245d02702b39a4f3c7f844fc82f97578d557c...822709f4f68589fa06596b891e4c6fcb2b5fe36b,1,1,1,2,1,2010-11-19 08:42:57,2010-11-19 08:42:57
822709f4f68589fa06596b891e4c6fcb2b5fe36b...146dd4fd762cda0b0706860002fdecc3e40d712a,1,0,7,7,1,2010-11-19 08:46:42,2010-11-19 08:46:39
89055740c8e84cec8b5aac1cb9e4863ad9b473c2...eefe8d9b5a79d625a6fe183a2990765440bd06b8,1,6,7,13,2,2010-12-05 20:23:54,2010-12-05 18:07:16
c86f2b52c04bd8de59ba99df2054451c37eb92de...b44a12d78c1417c3405a9e59e9890bd9c1798255,1,24,22,46,23,2011-08-14 08:04:32,2011-08-14 08:04:32
c86f2b52c04bd8de59ba99df2054451c37eb92de...fa785e0ef0604c20fcd512d79ee41315a0bf9549,17,435,462,897,241,2011-08-13 14:19:01,2011-08-13 14:19:01
fa785e0ef0604c20fcd512d79ee41315a0bf9549...50daa07400633d1c86392a1b392dc0ba1fc13525,1,5,0,5,1,2011-08-14 18:18:14,2011-08-14 18:18:14
8ace459e0eeeff454aae3c9cd46c6ce54c91c18a...4c8e51a459ae890f253cef1c51c3c0c5e1af79e8,1,1,1,2,1,2011-06-24 05:08:35,2011-06-24 05:08:35
dab7d7ebc7ad1746c2ba0f8ce3fe26a7f477cf21...bc1b72091546e1cf1a5d114363c3dd316175fe80,1,2,2,4,2,2011-06-14 11:35:03,2011-06-14 11:35:03
58816dd24981a78909bf63c821088c5099c2024b...3611b4c4e0492415408edbc44a2915eb7a3f71ef,1,14,17,31,8,2011-07-31 13:12:28,2011-07-31 13:12:28
3611b4c4e0492415408edbc44a2915eb7a3f71ef...f2f59b04ecb6950a6834ac320c3e74e3da5900da,1,3,0,3,2,2011-07-31 23:44:10,2011-07-31 23:44:10
58816dd24981a78909bf63c821088c5099c2024b...bd88d3e457c3486e7bc5603e8274f1ef809cb00f,3,1,1,2,1,2011-07-31 02:21:29,2011-07-31 02:21:29
bd88d3e457c3486e7bc5603e8274f1ef809cb00f...9a6433f92fcaca09906091edd6183915cede10c3,1,5,11,16,2,2011-07-31 02:22:39,2011-07-31 02:22:39
9a6433f92fcaca09906091edd6183915cede10c3...a36c13a73233567cd35f7f442190a0d5e1655105,1,10,5,15,1,2011-07-31 02:40:59,2011-07-31 02:40:59
a36c13a73233567cd35f7f442190a0d5e1655105...e49793fdc94eba27b715ea122a72bc9fa92af557,5,7,296,303,7,2011-07-31 02:53:03,2011-07-31 02:53:03
e49793fdc94eba27b715ea122a72bc9fa92af557...401e66acb4ee6cb2ada6f562b5710f365f9ae207,1,2,2,4,1,2011-07-31 03:05:07,2011-07-31 03:04:38
401e66acb4ee6cb2ada6f562b5710f365f9ae207...ffb7b8e3593e1b61398c36f3b136cc1d021cb891,2,1,1,2,1,2011-07-31 03:11:42,2011-07-31 03:11:42
ffb7b8e3593e1b61398c36f3b136cc1d021cb891...0d1c0661770a7c3585f4c374560a58bac82d2c35,2,10,10,20,4,2011-07-31 10:01:32,2011-07-31 10:01:32
0d1c0661770a7c3585f4c374560a58bac82d2c35...299291e6be14414c1488d6116ae16d081d8389f4,2,4,4,8,2,2011-07-31 10:26:32,2011-07-31 10:26:32
299291e6be14414c1488d6116ae16d081d8389f4...41246db22b120a64dd7f0971faafa94ed42846eb,1,3,0,3,3,2011-07-31 19:06:15,2011-07-31 19:05:49
41246db22b120a64dd7f0971faafa94ed42846eb...5c97f98709e037cc7be0ed37212c9bc03c12ea9b,1,1,1,2,1,2011-07-31 20:32:30,2011-07-31 20:32:30
5c97f98709e037cc7be0ed37212c9bc03c12ea9b...727ef92941ec816622f4e2a68f2275f29b4a3298,2,1,1,2,1,2011-07-31 22:23:01,2011-07-31 22:22:52
eefe8d9b5a79d625a6fe183a2990765440bd06b8...e7a7e5119e46216b86c008f4b958fb3511e05080,1,4,1,5,1,2010-12-06 20:09:10,2010-12-06 16:41:01
eefe8d9b5a79d625a6fe183a2990765440bd06b8...a623bb284ef12f1aeeae2fa362cb9658a81f1441,1,4,1,5,1,2010-12-06 16:41:01,2010-12-06 16:41:01
b44a12d78c1417c3405a9e59e9890bd9c1798255...6c1e80d6dd5d08a8c34eef9d91076b7bf2c529c2,1,4,4,8,4,2011-08-14 18:50:52,2011-08-14 18:50:52
6c1e80d6dd5d08a8c34eef9d91076b7bf2c529c2...b139b59797a28ac1bbdde9294e001a9c5bd2197e,1,2,2,4,2,2011-08-14 18:53:16,2011-08-14 18:53:16
b139b59797a28ac1bbdde9294e001a9c5bd2197e...014b6d41530055ef7a5ea9b42d243e0205e93ffc,1,2,2,4,2,2011-08-15 08:05:47,2011-08-15 08:05:47
014b6d41530055ef7a5ea9b42d243e0205e93ffc...e1702af5ee1dd18f0b83abe9615d0252d32e1ddf,2,11,8,19,7,2011-08-15 08:09:04,2011-08-15 08:09:04
b84c9aeb5017589d35e7961ffe335267e0888efd...5e26749118f79cfd1b43bf166344916c2d24f37a,1,2,2,4,1,2011-06-24 19:00:32,2011-06-24 19:00:32
bc1b72091546e1cf1a5d114363c3dd316175fe80...1a54c573703925a8a9e0443f5aeee5b43e29fccf,1,3,6,9,4,2011-06-15 22:12:01,2011-06-15 22:12:01
bc1b72091546e1cf1a5d114363c3dd316175fe80...bec30006904ded484974a7d4a6d164a248f7a794,1,1,1,2,1,2011-06-14 15:25:26,2011-06-14 15:25:26
8b168ad3b19adda8e80cb283b46679c27d11acbf...b14b4a60d1150fc48b31c6c570c2ecdd172fdd15,1,9,5,14,6,2011-08-01 01:50:38,2011-08-01 01:48:46
c29ae7838812d6955d7e278362a00e6466fac267...4504b435c3a16e9a0d0539a4bd56b1b398bf08b2,1,1,1,2,1,2010-12-16 18:28:47,2010-12-16 18:28:47
c29ae7838812d6955d7e278362a00e6466fac267...94712defc89d73c5f238ddcc085842b1a299d63c,1,165,13,178,26,2010-12-07 21:58:08,2010-12-07 21:58:08
94712defc89d73c5f238ddcc085842b1a299d63c...63d8a6ca864612cca87426668df98d3ae4eb0809,1,9,11,20,6,2010-12-14 06:15:26,2010-12-14 06:15:26
63d8a6ca864612cca87426668df98d3ae4eb0809...e5f76306df00ab6fa490ad2b493974494d50c97e,1,7,0,7,1,2010-12-14 06:18:42,2010-12-14 06:18:42
e5f76306df00ab6fa490ad2b493974494d50c97e...961ec5435dfed892cdf2599614e4c37a1ec25223,5,6,546,552,5,2010-12-15 05:15:51,2010-12-15 05:15:51
961ec5435dfed892cdf2599614e4c37a1ec25223...977c04216496cb48853ed92a9ce8677c3f4e7ebe,1,2,5,7,1,2010-12-15 05:27:42,2010-12-15 05:27:42
977c04216496cb48853ed92a9ce8677c3f4e7ebe...37b5fec090d00f38de64b591bcddcb205aadf8ee,1,2,2,4,2,2010-12-15 18:25:41,2010-12-15 18:25:41
bf52178981483e5ab040f161fb7543f8ccf4b6c5...64561534a6ba651a557bc204c73e64df48f3a479,2,2,5,7,3,2011-08-15 17:10:08,2011-08-15 17:06:26
64561534a6ba651a557bc204c73e64df48f3a479...20976f7af4d4de5d7bf72e60791dcb95c1135e63,1,4,4,8,2,2011-08-15 17:39:06,2011-08-15 17:39:06
20976f7af4d4de5d7bf72e60791dcb95c1135e63...2fef4ad3ee16149a781f7db5f037f829f23633c2,1,3,2,5,2,2011-08-15 17:43:58,2011-08-14 22:02:06
2fef4ad3ee16149a781f7db5f037f829f23633c2...c4ef2f3810eb0d984748e240f4d32c97483c6db8,1,1,1,2,1,2011-08-15 18:52:53,2011-08-15 18:46:43
c4ef2f3810eb0d984748e240f4d32c97483c6db8...9fe23b3f82bc552c6f89c8e183593592f07f341d,2,4,29,33,4,2011-08-16 06:37:13,2011-08-16 06:37:13
9fe23b3f82bc552c6f89c8e183593592f07f341d...94b065fb97c84683a8d8c9cd0ca1bad04182387c,1,2,2,4,1,2011-08-16 06:51:52,2011-08-16 06:51:52
5e26749118f79cfd1b43bf166344916c2d24f37a...0928889ddc85ce04f08461841d8e4cec51f03917,8,109,118,227,18,2011-06-25 19:53:03,2011-06-25 19:53:03
0928889ddc85ce04f08461841d8e4cec51f03917...2d09367d64e86cf8a45db22521660a21a59089ee,9,67,37,104,11,2011-06-26 02:38:14,2011-06-26 02:38:14
2d09367d64e86cf8a45db22521660a21a59089ee...401250356ed35e3284f06dd1c643a9de955363cc,2,16,11,27,8,2011-06-26 03:08:14,2011-06-26 03:08:14
401250356ed35e3284f06dd1c643a9de955363cc...036b1e5e4bf500c79294b83f88eda6f083ecfa9d,1,1,1,2,1,2011-06-26 05:15:08,2011-06-26 05:15:08
036b1e5e4bf500c79294b83f88eda6f083ecfa9d...b125225228a42a046930dc8c7e1861ef3b8acc14,7,351,279,630,7,2011-06-26 20:15:14,2011-06-26 20:15:14
5e26749118f79cfd1b43bf166344916c2d24f37a...14ba59535ec0d3c744f09c63454d20e1e4889f24,1,1,1,2,1,2011-06-25 19:11:28,2011-06-25 19:11:28
5e26749118f79cfd1b43bf166344916c2d24f37a...6edd2cb9b281b8219a0b525c140f0b539be19158,1,9,2,11,2,2011-06-25 09:55:11,2011-06-25 09:55:11
6edd2cb9b281b8219a0b525c140f0b539be19158...86581681eb41f5225c50dc4a35ec51f66393d2f5,1,11,10,21,3,2011-06-28 23:12:12,2011-06-28 23:12:12
ff68f939b682429dd3c4568f460ea63a961e64ca...d97a2ff8187eb69e430c508e4546a9b104bc64fc,1,1,0,1,1,2011-06-17 03:20:39,2011-06-17 03:20:39
b14b4a60d1150fc48b31c6c570c2ecdd172fdd15...413822acbc3d167696ee1e4ddaf318b9372fbdc4,2,2,2,4,2,2011-08-01 13:03:18,2011-08-01 13:03:18
413822acbc3d167696ee1e4ddaf318b9372fbdc4...766826369505cb49d50a8ce6bf3d65268e444846,1,1,1,2,1,2011-08-01 21:40:11,2011-08-01 21:40:11
2a49d6fb16aae3c76991a1008c6643fb16d1c3e8...58490fe18cb10ca7e6dc39e89db5b78114cd1985,1,2,1411,1413,3,2010-12-19 04:00:16,2010-12-19 04:00:16
58490fe18cb10ca7e6dc39e89db5b78114cd1985...b12c8957058ff472c98d821a1cec904686d2231a,1,1,1,2,1,2010-12-31 20:42:54,2010-12-31 20:42:54
b12c8957058ff472c98d821a1cec904686d2231a...967009110412645eaecb85e585d99c44be78cc0f,2,1,2,3,1,2011-01-03 22:49:19,2010-12-23 16:29:49
967009110412645eaecb85e585d99c44be78cc0f...990e5bdcfb229652383bf7efede989d144c4608b,1,3,30,33,3,2011-01-03 22:49:19,2011-01-03 16:45:55
990e5bdcfb229652383bf7efede989d144c4608b...5e3a844b1d8e4d1ac746277499f590ff7f03f4fb,5,0,110,110,4,2011-01-03 22:49:20,2011-01-03 19:29:05
94b065fb97c84683a8d8c9cd0ca1bad04182387c...c8b87abd0151c1992ff65f3611246a0348e1b5cb,1,1,1,2,1,2011-08-16 18:14:10,2011-08-16 18:14:10
b125225228a42a046930dc8c7e1861ef3b8acc14...aee2fa8f29375a07e9820be1e96b2bd85d58c1ba,1,6,6,12,6,2011-08-01 03:41:05,2011-08-01 03:41:05
aee2fa8f29375a07e9820be1e96b2bd85d58c1ba...976fc0f9ba35c75cbfaf4588c2d6b8620bf8ff6c,1,9,2,11,2,2011-08-01 03:53:56,2011-06-25 09:55:11
976fc0f9ba35c75cbfaf4588c2d6b8620bf8ff6c...27923098622737016665d9006f2ae18a3cfab624,1,11,10,21,3,2011-08-01 03:53:56,2011-06-28 23:12:12
27923098622737016665d9006f2ae18a3cfab624...0a7a6f82bf8cdbd60eaf87b1efb22b9568e752a9,1,1,1,2,1,2011-08-01 03:53:57,2011-06-29 11:00:10
0a7a6f82bf8cdbd60eaf87b1efb22b9568e752a9...777f14fa93fdd2acb290900be9ce4a5777fad2c0,1,1,1,2,1,2011-08-01 03:53:57,2011-06-29 20:52:19
777f14fa93fdd2acb290900be9ce4a5777fad2c0...51d121e79ae9bbca8bf5109d7f94383ddaa72e39,1,1,1,2,1,2011-08-01 03:53:57,2011-06-29 20:58:33
51d121e79ae9bbca8bf5109d7f94383ddaa72e39...fd345072dfc9698697bbc8743b28bce518fdadaf,1,8,1,9,1,2011-08-01 03:53:57,2011-07-04 14:04:45
fd345072dfc9698697bbc8743b28bce518fdadaf...c5371947367ad223df384f3b384f41b135f4d433,7,256,211,467,95,2011-08-01 03:53:58,2011-07-06 11:15:11
c5371947367ad223df384f3b384f41b135f4d433...4c9e90e7302dc9d14f2fbda7a651d96f133b9a9c,1,1,0,1,1,2011-08-01 03:53:58,2011-07-09 18:53:16
4c9e90e7302dc9d14f2fbda7a651d96f133b9a9c...53f28cf87d77d8a1e1674d1319bd507aa0c0e183,1,1,2,3,2,2011-08-01 03:53:58,2011-07-09 19:32:23
53f28cf87d77d8a1e1674d1319bd507aa0c0e183...05d83fcfeb1267cc5322eea2c273418571db71f6,1,1,1,2,1,2011-08-01 05:13:40,2011-08-01 05:13:40
05d83fcfeb1267cc5322eea2c273418571db71f6...0b15ec7d6d4d73c9779bc0e57fa53e3ba3f35896,1,1,1,2,1,2011-08-01 05:29:19,2011-08-01 05:29:19
0b15ec7d6d4d73c9779bc0e57fa53e3ba3f35896...11158f1bc4eed9e532c84acb400d2efac667e02d,1,1,1,2,1,2011-08-01 05:50:25,2011-08-01 05:50:25
fbfbbd5dad4c4e92600caf7ec8ce3cc3134333dd...91f39213da4559bdc5117d989d59c6eae4809c0f,1,1,3,4,1,2011-06-26 15:48:44,2011-06-26 15:48:44
2f370b8156520f7095aa55b6cd0c6ee7784e25a9...bfe9a840230534f92c5ffdb31c37df192eeba707,1,46,46,92,39,2011-06-20 16:35:34,2011-06-20 16:35:34
bfe9a840230534f92c5ffdb31c37df192eeba707...4f2003b5feb4b91963deab3a5de5aa8755a94369,1,1,0,1,1,2011-06-20 16:39:18,2011-06-20 16:39:18
2f370b8156520f7095aa55b6cd0c6ee7784e25a9...929eeccc5f88def4f324d7fadb535912b3ac8457,2,4,4,8,4,2011-06-19 22:42:14,2011-06-19 22:42:14
929eeccc5f88def4f324d7fadb535912b3ac8457...e9f342b91fc66aec3e51a8f86ec1d80d531596ad,1,395,403,798,16,2011-06-20 21:11:06,2011-06-20 21:11:06
e9f342b91fc66aec3e51a8f86ec1d80d531596ad...ddaf66a515c09f835603f95fe723d7da691324e6,1,168,139,307,56,2011-06-20 23:34:58,2011-06-20 23:34:58
4238aed87d0f8b5b95c17c4af259e3d893607f95...586dc13ee3bb485b8d4ee831661c00b72a8ceee1,1,2,2,4,2,2011-08-02 06:08:23,2011-08-02 06:08:23
586dc13ee3bb485b8d4ee831661c00b72a8ceee1...458cd3630980fb971d4d3e7c36e3789d4707b344,1,1,1,2,1,2011-08-02 06:43:52,2011-08-02 06:43:52
e7e087854bb3ed489a3181aba75a0d0d2a481549...73f6f66039395c314c5e6ad5402e1c005833d9af,1,34,34,68,14,2011-08-01 02:51:50,2011-08-01 02:51:50
5e3a844b1d8e4d1ac746277499f590ff7f03f4fb...1f4f4f41d75b8db5e4410e71015607860aa26397,1,2,3,5,4,2011-01-03 23:25:31,2011-01-03 23:25:31
5e3a844b1d8e4d1ac746277499f590ff7f03f4fb...342c27d1dcc4dc4d0dd818be75af92cc6caff617,1,5,11,16,4,2011-01-03 23:19:40,2011-01-03 23:19:40
2aabc1a276a86aa5a7ee167beb6370ba3f1eb063...7467f9c0417a0c1f9863e2d000aad73f34836ef2,2,10,5,15,6,2011-08-17 23:14:07,2011-08-17 23:14:07
2aabc1a276a86aa5a7ee167beb6370ba3f1eb063...3233fdeeec915555a30c1771af97a2ea0beb91d2,2,12,5,17,1,2011-08-17 16:42:24,2011-08-17 16:42:24
3233fdeeec915555a30c1771af97a2ea0beb91d2...8cbb3e715552d647a0b9379b8f9d692c54b75713,3,13,7,20,5,2011-08-18 02:03:33,2011-08-18 02:03:33
11158f1bc4eed9e532c84acb400d2efac667e02d...7fca5a5adf2ccc515466c0d2ea95828f10a48e54,1,5,4,9,4,2011-08-02 04:20:59,2011-08-02 04:20:59
7fca5a5adf2ccc515466c0d2ea95828f10a48e54...19450d9d597e6efb083b07ef05ba094b6ed86f89,1,7,11,18,5,2011-08-02 04:21:38,2011-08-02 04:21:38
b61671ccc6cc6983fd7737fe95b8bbf4aef8cc4e...26a391c60d0356e2e0dcf1929381583622e1be9c,1,1,1,2,1,2011-06-27 05:26:18,2011-06-27 05:26:18
f569ad981375e8a386124e5282111a4f5dcfe59f...954d45cbcbf07513e0e9920b57d3f3f69c2609ea,1,3,3,6,2,2011-06-29 03:29:49,2011-06-29 03:29:49
954d45cbcbf07513e0e9920b57d3f3f69c2609ea...ddd7ae43a5e8ee99d0c37dbf30eca107a2ecb9a0,1,1,1,2,1,2011-06-29 03:46:08,2011-04-15 20:51:42
458cd3630980fb971d4d3e7c36e3789d4707b344...44bc2bdbf2d96782d1efe35df1bbafa756cf8f57,1,4,6,10,6,2011-08-03 08:32:56,2011-08-03 08:24:43
44bc2bdbf2d96782d1efe35df1bbafa756cf8f57...7b95c57e2dba49cfbb85bcb21ba1fe3dfa6589e7,1,1,1,2,1,2011-08-03 08:34:55,2011-08-03 08:34:55
7b95c57e2dba49cfbb85bcb21ba1fe3dfa6589e7...ce89a01befa6a7249fabc43e48d1e27c2239d6a7,1,18,23,41,18,2011-08-03 09:44:29,2011-08-03 09:44:29
ce89a01befa6a7249fabc43e48d1e27c2239d6a7...28b1ca4b8cb16f5def341452e0130e27272eaa54,1,3,2,5,2,2011-08-04 23:39:46,2011-08-02 06:55:08
28b1ca4b8cb16f5def341452e0130e27272eaa54...601fbc59e425a42af15d539e701229051e86aee6,1,1,1,2,1,2011-08-04 23:41:53,2011-08-04 23:41:53
601fbc59e425a42af15d539e701229051e86aee6...cde1dc4f5cce8adb18d38d7da2470a80e9228829,1,1,1,2,1,2011-08-05 00:13:23,2011-08-05 00:13:23
458cd3630980fb971d4d3e7c36e3789d4707b344...00d8b84570854a0d5e917e2f02204afc0e9708df,1,3,4,7,3,2011-08-02 16:12:28,2011-08-02 16:12:28
e7ad33ce8964a239a61092e874e7063a2e7de235...e4183675f144a654b955f2a90776c7f83c9a2143,1,5,9,14,2,2011-01-05 22:52:42,2011-01-05 16:48:48
e4183675f144a654b955f2a90776c7f83c9a2143...4ab1c3d327ceb0e8c233205eaa0942545e48c537,1,5,0,5,1,2011-01-05 22:52:42,2011-01-05 22:52:27
4ab1c3d327ceb0e8c233205eaa0942545e48c537...db9da49bb396b1ba6dd9da8070d879dbe6277407,1,0,5,5,1,2011-01-06 16:18:35,2011-01-06 16:14:18
db9da49bb396b1ba6dd9da8070d879dbe6277407...3c07677ab3c5007ad25bb8200c08060b092ae8f7,1,4,4,8,1,2011-01-07 12:49:52,2011-01-07 12:49:52
3c07677ab3c5007ad25bb8200c08060b092ae8f7...4b67ea5cabb8c2b75faf2e255344cdffdf190464,1,0,6,6,1,2011-01-12 21:57:59,2011-01-12 21:57:59
4b67ea5cabb8c2b75faf2e255344cdffdf190464...4971aa0ae06ce65d1e5368b5bba8573cd62cab51,1,2,1,3,1,2011-01-14 17:57:00,2011-01-14 17:57:00
4971aa0ae06ce65d1e5368b5bba8573cd62cab51...c3175aaceaa1c69fed917ba226101fdf1e23662b,1,4,3,7,2,2011-01-18 18:44:57,2011-01-18 10:08:53
c3175aaceaa1c69fed917ba226101fdf1e23662b...6da1bd8b4322dff1a47536c8313089889652ac2e,1,29,34,63,9,2011-01-19 17:23:15,2011-01-19 17:23:15
6da1bd8b4322dff1a47536c8313089889652ac2e...c5f92fa2af5162a84335556a4360e7a3040a0cd1,1,1,1,2,1,2011-01-19 18:59:54,2011-01-19 18:59:54
c5f92fa2af5162a84335556a4360e7a3040a0cd1...044bd7c1e780ffa43285ce707763736fbf93aac1,1,1,2,3,2,2011-01-19 20:33:22,2011-01-19 20:33:22
044bd7c1e780ffa43285ce707763736fbf93aac1...31fb49c0fb8cb3ecfd48c1d1bd4284211523c66a,1,0,1,1,1,2011-01-19 20:47:45,2011-01-19 20:47:45
31fb49c0fb8cb3ecfd48c1d1bd4284211523c66a...e9d6b996ee9862db54136d003d6b4ef0f3f48221,1,2,7,9,2,2011-01-19 21:34:25,2011-01-19 21:34:25
e9d6b996ee9862db54136d003d6b4ef0f3f48221...d7ed89709750e03b45515ab7a7eb27856ec31d66,1,0,1,1,1,2011-01-19 21:41:34,2011-01-19 21:41:34
d7ed89709750e03b45515ab7a7eb27856ec31d66...5d67f6499a487898400c91dd59f86b5b103a0535,2,3,3,6,3,2011-01-20 20:28:42,2011-01-20 20:28:42
5d67f6499a487898400c91dd59f86b5b103a0535...16e9b7d61cc996b080d15716e61174223ce79df5,1,5,5,10,2,2011-01-20 20:30:01,2011-01-20 20:29:59
16e9b7d61cc996b080d15716e61174223ce79df5...b32b3710e2bad8d330a5dfd2a4fed7abc9b787ab,1,2,1,3,1,2011-01-20 20:59:36,2011-01-20 20:59:36
d2223de26a09ea578eb8d37e9497ab798e782402...01f0a9f99994092e056a9c817dd4f90c0139950b,1,1,1,2,1,2011-08-21 03:08:52,2011-08-21 03:07:28
01f0a9f99994092e056a9c817dd4f90c0139950b...e88011b49bba0423c47b24e6f74c13acb155ba72,2,1,1,2,1,2011-08-21 05:42:46,2011-08-21 05:42:46
e88011b49bba0423c47b24e6f74c13acb155ba72...ad423ae3fdf2d04ea00da4314418c2817ced6e29,3,12,2,14,4,2011-08-21 16:39:00,2011-08-21 16:39:00
ad423ae3fdf2d04ea00da4314418c2817ced6e29...6727b542acd1a272c9e00cb255ff636727b3df8e,2,2,2,4,2,2011-08-21 17:24:25,2011-08-21 17:24:25
6727b542acd1a272c9e00cb255ff636727b3df8e...97c7ae774a229ef49706d3aea3eec5c35b90ae9c,1,2,1,3,3,2011-08-21 17:40:31,2011-08-21 17:40:31
ddd7ae43a5e8ee99d0c37dbf30eca107a2ecb9a0...8628fef73ee277ad142389a0b768914913083868,4,10581,3,10584,6,2011-06-29 19:58:36,2011-06-29 19:58:36
ddd7ae43a5e8ee99d0c37dbf30eca107a2ecb9a0...35872f2e58ca3a314e6f3ea0ca6cdb211338be52,1,1,1,2,1,2011-06-29 11:00:10,2011-06-29 11:00:10
35872f2e58ca3a314e6f3ea0ca6cdb211338be52...d9146777db8a87f7b11d9814c6a31f8308265dde,1,1,1,2,1,2011-06-29 20:52:19,2011-06-29 20:52:19
d9146777db8a87f7b11d9814c6a31f8308265dde...02e749a3f4e12710ccafc5817d8771e5f57ddbfe,1,1,1,2,1,2011-06-29 20:58:33,2011-06-29 20:58:33
cde1dc4f5cce8adb18d38d7da2470a80e9228829...2db692e752d0aa497fa028b97795840bd76af1a9,1,1,1,2,1,2011-08-05 16:20:29,2011-08-05 16:20:29
2db692e752d0aa497fa028b97795840bd76af1a9...6241a72722476b29e86893aed95775f76d9ac753,1,1,1,2,1,2011-08-08 01:23:52,2011-08-08 01:23:52
6241a72722476b29e86893aed95775f76d9ac753...b1917779773001fc9280c0cd789d65960a5e26a0,1,1,1,2,1,2011-08-08 01:28:54,2011-08-08 01:28:35
55a7fc2466fc46a3dc454c5def5a6be061404f24...d9cc711ea1b29fcea97942d0d6aa2105866c034e,1,5,5,10,2,2011-08-09 06:03:16,2011-08-09 06:02:33
d9cc711ea1b29fcea97942d0d6aa2105866c034e...e13f5c4b371005a92e85f24029dd17df6d1fe7c5,1,2,1,3,1,2011-08-09 07:25:10,2011-08-09 07:25:10
e13f5c4b371005a92e85f24029dd17df6d1fe7c5...1c9145c9a7d97a4e120314dcfd008bfea26aa1ba,1,1,1,2,1,2011-08-09 12:46:33,2011-08-09 12:46:33
97c7ae774a229ef49706d3aea3eec5c35b90ae9c...3f22747dfb3d0c9a410a5a553f244802ef751fb7,1,17,17,34,17,2011-08-23 07:11:56,2011-08-23 07:11:56
705493215e6636779a86fd86979cc3e9aac463ba...93f0e38c510fdba16cbb68abe4dcfefa1f7034eb,1,1,1,2,1,2011-07-01 16:27:19,2011-07-01 16:27:19
93f0e38c510fdba16cbb68abe4dcfefa1f7034eb...8e0864f509b1bc9d0a97dde623d03d59542c2067,1,25,12,37,5,2011-07-04 07:49:33,2011-07-04 07:49:33
8e0864f509b1bc9d0a97dde623d03d59542c2067...e12930a2424bdb6158929b14113cb7260b54729d,1,1,1,2,1,2011-07-04 08:01:25,2011-07-04 08:01:25
e12930a2424bdb6158929b14113cb7260b54729d...e3367bc021ee70fe89f2a11156dffdcdd081d052,1,9,1,10,3,2011-07-04 08:42:37,2011-07-04 08:42:37
b1917779773001fc9280c0cd789d65960a5e26a0...b77d30c2f0dd0f9d9cc572679450a0642fb16be3,1,45,45,90,27,2011-08-08 14:46:58,2011-08-08 14:46:58
3f22747dfb3d0c9a410a5a553f244802ef751fb7...ef3c095bafa9a6fa9c771f368d4b30c8ce4deded,1,18,18,36,2,2011-08-24 22:22:08,2011-08-24 22:22:08
e3367bc021ee70fe89f2a11156dffdcdd081d052...3fb77e0cfab731b57b5d269feb1b9d3fc7801c19,1,8,1,9,1,2011-07-04 14:04:45,2011-07-04 14:04:45
fccc4824cc610a780c1ab72eafc5975e30242f23...4caa411f01a5e18dcfce8aa940e806e272b0ff33,3,26,12,38,9,2011-08-25 21:02:07,2011-08-25 21:02:07
f5e2524c96e8ada5b87761a71695ea9968406fff...d19dea057231909bccfadc24ca694954b2b60398,3,80,58,138,13,2011-07-04 19:54:51,2011-07-04 19:54:51
d19dea057231909bccfadc24ca694954b2b60398...b131981d8406ac9c18c200a2801d25acd4bf5a34,3,20,8,28,10,2011-07-04 20:56:44,2011-07-04 20:56:44
b131981d8406ac9c18c200a2801d25acd4bf5a34...e150d87944f8ea025ef64aab38f3b6f23e0b1221,1,1769,1190,2959,922,2011-07-05 22:26:41,2011-07-05 22:26:41
4caa411f01a5e18dcfce8aa940e806e272b0ff33...19dd8f83180a877bceeb6ce28c92ec7396a4dd4f,1,47,47,94,19,2011-08-30 01:04:00,2011-08-30 01:04:00
e150d87944f8ea025ef64aab38f3b6f23e0b1221...c80cc610e2d8559b21563f40de760058318e5a69,7,256,211,467,95,2011-07-06 11:15:11,2011-07-06 11:15:11
2df9a9a86357cc53e0e9eec45da377806cafbc07...2ba5f9d80d7d44565753f23e236d984e3e237b34,1,1,1,2,1,2011-09-01 13:16:55,2011-09-01 13:16:55
2df9a9a86357cc53e0e9eec45da377806cafbc07...9b32ced2b48e81b0c97bfebf08403b2d5abb1e21,1,1,0,1,1,2011-09-01 04:39:19,2011-09-01 04:39:19
2df9a9a86357cc53e0e9eec45da377806cafbc07...a6bc1d4e692b4139b2c2dfc497ffed0c44bd317b,2,11,0,11,2,2011-08-31 21:45:04,2011-08-31 21:45:04
bd723209465aa798affae35a6e9aca0da9d3433e...d07c233422939fa3f3875f24ea195b83704b6141,6,236,187,423,83,2011-09-01 20:08:37,2011-09-01 20:08:37
75ac1ea512ca955904f83f3386359be169d117fe...70a836c34dd05590c2a0260a5aa425ed9893da86,1,1,1,2,1,2011-09-03 06:02:43,2011-09-03 06:02:43
981e448b36ca25a8f33d081d8da1e7253eb13a7a...715957bffc6f919cf9ecf62dc77cde3788f9daa5,1,1,2,3,2,2011-09-06 15:43:15,2011-09-06 15:43:15
7b3c30d8c8a19fbb79431ca883cb243beae8e976...439778a2bef2fdd175a6a7560aa429a667c5afc8,1,1,2,3,1,2011-09-04 22:52:12,2011-09-04 22:52:12
715957bffc6f919cf9ecf62dc77cde3788f9daa5...ea716a8f46918759170ff9b8896673ce77efe074,1,2,2,4,2,2011-09-06 21:20:45,2011-09-06 21:20:45
ceb6e819d38fb521ec7caa53f12a55336204a964...64c9e797b82b9af17f368af672755a62406808db,1,2,2,4,2,2011-09-10 21:52:28,2011-09-10 21:52:28
4994e375a14cb5a72ecf649c84df6b28301c1ef9...115bce064e61d521cb9a141fa7c019c66c30fe90,1,1,1,2,1,2011-09-13 11:06:55,2011-09-13 11:06:55
fe2d67c9c00d7621971fbcccfac7483c9fc28897...8aa70882b433013f1c9e33ea8c563a52368e3ac7,1,1,1,2,1,2011-09-13 20:48:53,2011-09-13 20:48:53
8aa70882b433013f1c9e33ea8c563a52368e3ac7...53aded7bf306358b654a063ebc3aa77dcf2fb78e,1,1,1,2,1,2011-09-16 00:49:49,2011-09-16 00:49:49
8aa70882b433013f1c9e33ea8c563a52368e3ac7...7a984c7f84c8f287a05d035c295fc2086be4653b,1,6,9,15,4,2011-09-16 00:35:35,2011-09-16 00:35:35
79beb6c91c66b0e9d73831d867e7cba30bc8d659...2dc1493df692bc9250db923307cf3dcc181bffd3,1,1,1,2,1,2012-01-22 18:09:44,2012-01-22 18:09:44
2dc1493df692bc9250db923307cf3dcc181bffd3...5c02f406e4152cad92401ed52d06b9b1c26903ae,1,2,3,5,2,2012-01-22 18:11:34,2012-01-22 18:11:34
5c02f406e4152cad92401ed52d06b9b1c26903ae...1738287ce9950f30a25749d040a7c1a37e41127e,1,1,1,2,1,2012-01-22 22:01:18,2012-01-22 22:01:18
1738287ce9950f30a25749d040a7c1a37e41127e...1dd911f06a20789f6fccaacec4a7a245540f7bff,1,23,13,36,4,2012-01-24 01:29:06,2012-01-24 01:29:06
7a984c7f84c8f287a05d035c295fc2086be4653b...7f94518f6b6ce4c2e591dee920a1a888f1b34a18,1,11,9,20,10,2011-09-17 07:22:39,2011-09-17 07:22:39
7f94518f6b6ce4c2e591dee920a1a888f1b34a18...b23de068c5a3cafe2dc642d095221245e578af34,4,3,9053,9056,4,2011-09-17 07:33:30,2011-09-17 07:33:30
b23de068c5a3cafe2dc642d095221245e578af34...d13dfdef40a29ccd1aceb8eab11157a19a0b6294,2,9050,0,9050,2,2011-09-17 07:35:54,2011-09-17 07:35:54
f0358b52a560c19266605e1d7e598da20b14bb78...af98e6fc516c1e9bef640307f66cf719289890b5,2,7,13,20,5,2012-01-24 19:19:52,2012-01-24 19:19:52
af98e6fc516c1e9bef640307f66cf719289890b5...f6ccd1032d4342328d9ab598866b656f0d471d27,2,0,0,0,0,2012-01-24 19:31:12,2012-01-24 19:31:12
f6ccd1032d4342328d9ab598866b656f0d471d27...c04b0b57b549d20aa92e09b3fff1c356498f9671,1,3,3,6,1,2012-01-24 19:33:13,2012-01-24 19:33:13
d13dfdef40a29ccd1aceb8eab11157a19a0b6294...535918a3ed1342974e51ef73e4ad3f5d40298f2a,2,4,4,8,2,2011-09-17 09:11:22,2011-09-17 09:11:22
c04b0b57b549d20aa92e09b3fff1c356498f9671...0bf9143cd135df0b0357d4c7c50dcdb91dd85724,1,21,26,47,7,2012-01-26 15:29:10,2012-01-26 15:29:10
c04b0b57b549d20aa92e09b3fff1c356498f9671...d269a55d4541756c1b339429997e7ca507b5c908,2,444,456,900,7,2012-01-26 07:24:44,2012-01-26 07:24:44
6673ce68ff1935c8b2e917dfeda1af0d38f72114...d8a3970e143f52f304b3ddbc854ddf015560555b,1,10,10,20,4,2011-09-18 07:21:33,2011-09-18 07:21:33
6673ce68ff1935c8b2e917dfeda1af0d38f72114...d98f4ae88ee714a27a2b441d703abd96f5bb5ce1,1,1,1,2,1,2011-09-17 14:18:39,2011-09-17 14:18:39
4b213f905066bb6984e1fe4d1d6399bed84079b2...a111a7950047209ebc46f68f0e57cbc97dee4e96,1,1,2,3,2,2012-02-03 10:50:06,2012-02-03 10:50:06
4b213f905066bb6984e1fe4d1d6399bed84079b2...8b1f5ebe50eb5d201d1c0e3b9dfe71f2acfad23e,1,1,1,2,1,2012-01-29 16:19:50,2012-01-29 16:19:50
8b1f5ebe50eb5d201d1c0e3b9dfe71f2acfad23e...6a304122b7618655cdac02563423eaa23d39db33,2,16,8,24,3,2012-01-29 16:44:45,2012-01-29 16:44:45
6a304122b7618655cdac02563423eaa23d39db33...2b5f881ecc458ebe9c515a22d7310837c96049f4,3,10,6,16,3,2012-01-29 19:21:39,2012-01-29 19:21:39
2b5f881ecc458ebe9c515a22d7310837c96049f4...2eb19a9c9996482659a6593add9f2464c367f524,1,1,1,2,1,2012-01-29 21:05:05,2012-01-29 21:05:05
2eb19a9c9996482659a6593add9f2464c367f524...cff92881a848a70f51f8158d48a45e3a9f047e42,1,2,2,4,1,2012-01-29 21:06:10,2012-01-29 21:06:10
cff92881a848a70f51f8158d48a45e3a9f047e42...f5d13045c0b6c78143f482dfabe7a29d9ce1c960,1,3,6,9,1,2012-01-29 21:14:43,2012-01-29 21:14:43
f5d13045c0b6c78143f482dfabe7a29d9ce1c960...611162c891f842ca9e1e7e1ff57bf3320776dcb8,1,1,1,2,1,2012-01-29 22:22:24,2012-01-29 22:22:24
611162c891f842ca9e1e7e1ff57bf3320776dcb8...26d6be247987741b92c83bae2f47111b43a6f1f2,1,1,1,2,1,2012-01-29 23:09:12,2012-01-29 23:09:12
26d6be247987741b92c83bae2f47111b43a6f1f2...fddbaa3487a789465e00f36fb8fef4ce991f8cf0,1,3,2,5,3,2012-01-29 23:15:33,2012-01-29 23:15:33
fddbaa3487a789465e00f36fb8fef4ce991f8cf0...965f3f163677622206a2f313fa113af228f9ed2b,1,1,1,2,1,2012-01-30 00:58:14,2012-01-30 00:57:59
994cd0801d8793e405c50a5f4f1e32aab7f29597...3cdf17e1bc65553ec6fa166d0da469560eae182f,1,3,9,12,4,2011-09-22 17:47:24,2011-09-22 17:47:24
f2924da1b178bbfef491d8356e589894d50e4f0b...f96fed69428ff5f431dd770ac8d576c08eab468e,18,0,25131,25131,11,2012-02-03 12:38:26,2012-02-03 12:38:26
f96fed69428ff5f431dd770ac8d576c08eab468e...ac50fbc1e2306791c38daee840b2fb0d0c7a03d4,1,2,10,12,6,2012-02-03 13:43:07,2012-02-03 13:43:07
ac50fbc1e2306791c38daee840b2fb0d0c7a03d4...cedd640083a07a6692b42ec67ac686a36790b826,1,2,2,4,1,2012-02-03 15:15:19,2012-02-03 15:11:35
965f3f163677622206a2f313fa113af228f9ed2b...e1b81302bdaeccd08307978978bb38a350538b5b,1,0,4,4,1,2012-01-30 03:23:23,2012-01-30 03:23:23
3cdf17e1bc65553ec6fa166d0da469560eae182f...e17dc838a28b225d148efd56a1536dce15493999,1,1,1,2,1,2011-09-26 09:39:07,2011-09-26 09:39:07
cedd640083a07a6692b42ec67ac686a36790b826...5d2a6dbe3a2faafa0b06cf11faeeaf003d82964a,1,3,8,11,7,2012-02-04 11:31:25,2012-02-04 11:31:25
37470f8da672a09fa16c764e7bf0b7ce7e58e10a...a5e31d6132974442eb300f69db4c0a33425d7132,4,2,3,5,2,2012-01-30 04:26:32,2012-01-30 04:26:17
a5e31d6132974442eb300f69db4c0a33425d7132...3cebea1671eb7c4223e55a8e37244b5f8f46055b,1,1,2,3,2,2012-01-30 04:35:16,2012-01-30 04:35:16
5c85e31a21234d32848a4cec25d22cc50a0d9275...eaf87bb500aee22c57e67dd54d32a97f73701426,1,2,2,4,2,2011-10-07 16:50:22,2011-10-07 16:50:22
ab117fc461f720de82e30b47f10e28481da7cbef...4d65006439697c504ade338dbfc448c7ec97c694,1,1,1,2,1,2012-02-05 12:46:28,2012-02-05 12:46:28
2dcdaf0104523c62b67a50c2459044b6817c93c3...af3bd79de5c52c0ad549200a6ff9845d2e39b8b2,1,1,1,2,1,2012-01-31 15:14:54,2012-01-31 15:14:54
af3bd79de5c52c0ad549200a6ff9845d2e39b8b2...8552d9543eac0a6e9f2842984bf8f3b4cc323530,1,6,0,6,1,2012-01-31 16:12:19,2012-01-31 16:12:19
8552d9543eac0a6e9f2842984bf8f3b4cc323530...d7e668235ffc8c17daf9e1b8d97bc39dc344e7fa,1,1,3,4,1,2012-01-31 20:26:54,2012-01-29 19:13:55
d7e668235ffc8c17daf9e1b8d97bc39dc344e7fa...ce0c28932b44af38755d5e98f35b7888dfc498ef,2,6,13,19,6,2012-02-01 01:31:07,2012-02-01 01:31:07
362eb8794609e4bd173b3139ee78a955ee1494e7...b230b84043478874e1079263b649f8b64da9a63b,1,3,3,6,1,2011-10-08 10:51:05,2011-10-08 10:32:41
4d65006439697c504ade338dbfc448c7ec97c694...c93f45ff386024dfcceaf1d572a4db1a8eb3e9a7,2,3,3,6,3,2012-02-06 13:25:02,2012-02-06 13:24:56
4d65006439697c504ade338dbfc448c7ec97c694...0659528100ebf69e2a2ad0a31bacf8692d0b04db,2,4,4,8,2,2012-02-06 06:03:01,2012-02-06 06:03:01
0659528100ebf69e2a2ad0a31bacf8692d0b04db...deeb952314456d85688c539bfc5ddd73a5fdb2ed,1,1,1,2,1,2012-02-06 06:03:22,2012-02-06 06:03:22
deeb952314456d85688c539bfc5ddd73a5fdb2ed...5dbb3b4b0a7672c367b7e96160523459664ad318,1,1,1,2,1,2012-02-06 06:20:28,2012-02-06 06:20:28
ce0c28932b44af38755d5e98f35b7888dfc498ef...a2240384c73d0d9681e79978cb1f778026e5ad1e,1,1,1,2,1,2012-02-03 16:23:35,2012-02-03 16:23:35
25fa9bedd77bbafbe9625db0303950a38f023465...638f77206fcbd796b7199dc013f8587545ef31e7,1,2,0,2,1,2011-10-11 00:43:28,2011-10-11 00:43:28
f9ebf5d2e92ff12ff20b5d355d9619447bd09cff...9434b5bc79c20c42f8470b9342a6afdb53cb08ae,3,5,5,10,3,2012-02-08 01:35:49,2012-02-08 01:35:49
9434b5bc79c20c42f8470b9342a6afdb53cb08ae...080026e4f4b13579d473797598308fbab0363b10,2,3,3,6,3,2012-02-08 02:28:52,2012-02-08 02:28:52
080026e4f4b13579d473797598308fbab0363b10...f8f347e392489282d96286e91c2795ef741e752b,4,6,7,13,4,2012-02-19 19:00:08,2012-02-19 19:00:08
cfae00adab633f3d60e334add4365577a7ff8e7e...3606c8345f97b435a40e66e3ad0b02a88938abf4,5,1,1,2,1,2012-04-13 19:16:20,2012-04-13 19:16:20
5e213a872c6ee6e682d114af461e978450c70b90...f1e9bb3f944c0ca96faadb522c898364562d26e1,3,1010,612,1622,195,2011-10-11 23:19:51,2011-10-11 23:19:51
f8f347e392489282d96286e91c2795ef741e752b...fe6c2f56ec06e7df2dbc5f8e81644e4927c01fdc,2,2,5,7,2,2012-02-21 18:59:16,2012-02-21 18:59:16
3606c8345f97b435a40e66e3ad0b02a88938abf4...02bf76cd167600eac0fcc1340633693cb7cf5e11,1,2,2,4,2,2012-04-14 13:06:54,2012-04-14 13:06:54
f1e9bb3f944c0ca96faadb522c898364562d26e1...f3cc3a28e46a9f0de0caaf2ae5f25ab416cb313c,1,41,365,406,23,2011-10-15 11:03:26,2011-10-15 10:57:01
f3cc3a28e46a9f0de0caaf2ae5f25ab416cb313c...ecdb8d79ac45f987c9e2e9cc3116084a1fc9e41e,1,1,1,2,1,2011-10-15 13:50:08,2011-10-15 13:50:08
ecdb8d79ac45f987c9e2e9cc3116084a1fc9e41e...a87078d406173de8d3c17c1e4c587a49be6f2c70,1,37,37,74,5,2011-10-18 19:39:58,2011-10-18 19:39:58
f1e9bb3f944c0ca96faadb522c898364562d26e1...8d50ceb1273be0c467efb36abe3fafa575ed6b83,1,14,2,16,2,2011-10-14 20:10:58,2011-10-14 20:10:58
8d50ceb1273be0c467efb36abe3fafa575ed6b83...f022785b64bad9a213eb1f7b17fcc4a731e4139c,1,16,2,18,2,2011-10-19 15:25:24,2011-10-19 15:25:24
b0ddd13910a986aac63a938eaaef7072ee404f5e...5bbd604930a07e43f3737d6835f8f33a0c6c5359,1,1,1,2,1,2012-02-22 02:32:16,2012-02-22 02:32:16
c264d91c6c96f616ddb119c494dcc81185b2b712...eb2dc2fe908336e9ebc0fa8745116b633699528c,1,0,1,1,1,2012-04-20 22:39:14,2012-04-20 22:39:14
eb2dc2fe908336e9ebc0fa8745116b633699528c...1d320b59a390041f25cf87d790f6472a25a512ef,1,4,4,8,2,2012-04-22 14:08:46,2012-04-22 14:08:46
1d320b59a390041f25cf87d790f6472a25a512ef...a95f300ac87f13a702580759d9fc39049de2ca78,1,2,2,4,1,2012-04-23 21:33:31,2012-04-23 21:33:31
c264d91c6c96f616ddb119c494dcc81185b2b712...1b581aff029d6d46cd5b866a97622d455ecac294,1,3,0,3,1,2012-04-19 01:44:18,2012-04-19 01:44:18
a87078d406173de8d3c17c1e4c587a49be6f2c70...a37f57addb2ad6f8844e78813a6d9aeb9c64d100,1,2,2,4,1,2011-10-18 22:37:30,2011-10-18 22:37:30
b72f114d950a33c245c38b2a99688572523ba0f2...5fdb99f91bbbae8ccda5bde1187db2440e363934,1,1,1,2,1,2011-10-19 17:10:21,2011-10-19 17:08:58
5fdb99f91bbbae8ccda5bde1187db2440e363934...0a80ebafd0d06d291890a9d397956e7e98348629,4,0,1866,1866,4,2011-10-23 19:05:31,2011-10-23 19:05:31
0a80ebafd0d06d291890a9d397956e7e98348629...1437e0fefd301cd4bf73cfd089d7bc402932a21b,6,0,918,918,4,2011-10-23 19:19:47,2011-10-23 19:19:47
1437e0fefd301cd4bf73cfd089d7bc402932a21b...125a7a6840aff6d32ae03d200713bdfc942b45f2,1,1,1,2,1,2011-10-23 19:29:19,2011-10-23 19:29:19
125a7a6840aff6d32ae03d200713bdfc942b45f2...380c4f80d83f8bca72f315bfa6a15b0c1af5b596,1,1,1,2,1,2011-10-25 19:35:19,2011-10-25 19:35:19
380c4f80d83f8bca72f315bfa6a15b0c1af5b596...d32dfb7a4876e717a1b77898f42a2f590c37a9a9,1,4,4,8,4,2011-10-26 21:00:32,2011-10-26 21:00:32
1929462a397278dde68be0d7836119d5db1c19ae...ca4bf4793d91b330d0123fd3c88cb5ad49548ddb,1,1,1,2,1,2012-02-28 21:14:17,2012-02-28 21:14:17
1929462a397278dde68be0d7836119d5db1c19ae...1aad336ef75ca89845f347404f7d318273a1b2ef,1,1,1,2,1,2012-02-26 19:48:02,2012-02-26 19:48:02
a95f300ac87f13a702580759d9fc39049de2ca78...e49353b05f13f103dd9d267a1278f688ed451dc2,1,10,2,12,6,2012-04-24 20:19:51,2012-04-24 20:19:51
e49353b05f13f103dd9d267a1278f688ed451dc2...6e1417b8576206133bcc25603810391ce16e8de5,1,2,2,4,2,2012-04-25 13:02:49,2012-04-25 13:02:49
1ab8d64169596694a402316fd4724c0a692f815e...e1e53cf83c52338f4ff37e540cb5077285098e33,1,1,0,1,1,2012-04-25 06:51:21,2012-04-25 06:51:21
d20c503e0858b46371f5e4a54b0d289d1a0f3953...90734c0b4541f17bc54e2d2ebd6f45b6a43a66d0,2,14,0,14,2,2011-10-19 16:27:58,2011-10-19 16:27:58
d32dfb7a4876e717a1b77898f42a2f590c37a9a9...b0fd587b26a97fa6858100bb64797cf294e4d454,1,21,19,40,5,2011-10-30 12:12:17,2011-10-30 12:12:17
d32dfb7a4876e717a1b77898f42a2f590c37a9a9...5347f874ed8e74e8e81f1d9940298c9e6ef69a59,1,16,2,18,4,2011-10-28 16:15:20,2011-10-28 16:15:20
5347f874ed8e74e8e81f1d9940298c9e6ef69a59...0eb2dc932a716da518d0ac4bfcde9f3d777d20ad,1,2,14,16,4,2011-10-31 09:07:41,2011-10-31 09:07:41
0eb2dc932a716da518d0ac4bfcde9f3d777d20ad...8278b4552d09287e0854e8bace06899e7e85bd0d,1,9,10,19,3,2011-11-08 00:45:56,2011-11-08 00:45:56
8278b4552d09287e0854e8bace06899e7e85bd0d...212afb9d43fe2a6cee72ab1e3cb0de3f41759219,1,5,5,10,2,2011-11-08 01:34:51,2011-11-08 01:34:51
212afb9d43fe2a6cee72ab1e3cb0de3f41759219...6122ef5ab1e91bb268c89fd3ff108bdea1a56e81,1,8,8,16,1,2011-11-09 01:35:07,2011-11-09 01:35:07
db1574059df56be73020466baf689ef2f5a8d9e4...c448cc03e7ad3bbe33abab1dfc68d9c8340b71f6,1,1,0,1,1,2012-03-05 09:43:08,2012-03-05 09:43:08
21e77285e28f50269af940596ee5133b12e5c37a...5469e272a4d742a13ae7cfd76948232c15fde68d,1,2,9,11,3,2012-04-10 23:35:29,2012-04-10 23:35:29
fb6d9387ed7125ba599ccc26a177d9656b8d9e1c...e0b5b1c93d359b0f7f56a8960786c52b35c11135,1,1,1,2,1,2011-11-01 15:32:48,2011-11-01 15:32:48
758eab9f35ec072265971d93b6c77714bd1cdca4...aa0396eae757c9e03dda4e463fb0d4db5a5f82d7,1,1,2,3,1,2012-03-06 00:12:12,2012-03-05 23:36:27
c20eb1a6faa89c04380b0e0566d980042f154284...d055e4e6c1d33592f8042a465ef46600f76202de,1,11,0,11,1,2012-05-20 10:55:49,2012-05-20 10:55:49
c20eb1a6faa89c04380b0e0566d980042f154284...b2b24c351e3ab5e7fb4e4d3e8841b9aa951f3213,1,1,1,2,1,2012-05-18 20:24:27,2012-05-18 20:24:27
b2b24c351e3ab5e7fb4e4d3e8841b9aa951f3213...4934c5defdf7ea55699f578ecbdd7da0b609b603,1,1,1,2,1,2012-05-18 20:33:33,2012-05-18 20:33:33
d526c488ea169e86603b5e13266d238ccd4d298e...5718718cdd78a1b7cde4b11c2bd6e14ceded72b9,1,1,1,2,1,2011-11-02 07:53:20,2011-11-02 07:53:20
aa0396eae757c9e03dda4e463fb0d4db5a5f82d7...923b0f3adca333931ae64ec5ff58392554c9f426,1,0,0,0,0,2012-03-16 15:44:15,2012-03-16 15:44:15
aa0396eae757c9e03dda4e463fb0d4db5a5f82d7...1ec581885a93ad7e4cb6bf644f6a71ae4fe99a9d,1,2,0,2,2,2012-03-08 19:38:57,2012-03-08 19:38:57
1ec581885a93ad7e4cb6bf644f6a71ae4fe99a9d...efe88dfbf2958982630f34ff81934b0742c60d27,1,1,1,2,1,2012-03-13 17:33:13,2012-03-13 17:33:13
efe88dfbf2958982630f34ff81934b0742c60d27...767dc09916c87e1e9d118219e52aadba174f81d2,1,3,1,4,1,2012-03-13 18:11:02,2012-03-13 18:11:02
767dc09916c87e1e9d118219e52aadba174f81d2...6c1c1db5a219cb28d00501a303d71e4650c8d776,1,1,1,2,1,2012-04-03 15:55:40,2012-04-03 15:55:40
3942ee1775b07b6a1c725f064e066f39998a5069...6bfd7948c667d5c6d2e5a4a2e5b780f7035d2f81,1,12,13,25,4,2012-06-01 20:47:17,2012-06-01 20:47:17
6bfd7948c667d5c6d2e5a4a2e5b780f7035d2f81...7a2f9dcf8b56b6923a5bde028ea1838d32572588,6,651,177,828,70,2012-06-02 10:29:38,2012-06-01 21:23:31
5718718cdd78a1b7cde4b11c2bd6e14ceded72b9...4a69c416943a46e2e9fad23b989410d70098cb3f,1,2,2,4,2,2011-11-04 21:26:42,2011-11-04 21:26:42
5718718cdd78a1b7cde4b11c2bd6e14ceded72b9...6290f4018c57e1369c5ba1b71343ca6b47474e4d,1,16,14,30,1,2011-11-03 10:30:23,2011-11-03 10:30:23
923b0f3adca333931ae64ec5ff58392554c9f426...e2fff6fe07c6a82bf36f648de4cbe27f9544af7d,7,0,0,0,0,2012-03-21 05:41:50,2012-03-21 05:41:50
ce64453057d66d7c9b8f36862419f905e40a366c...086280e6fd29eb0674991bf2e11cdca02c05896f,1,2,2,4,1,2012-04-06 22:57:29,2012-04-06 22:57:29
086280e6fd29eb0674991bf2e11cdca02c05896f...339b6c96adbcbde6322df6e72d489ec93f98dbe5,1,1,2,3,1,2012-04-06 23:52:52,2012-04-06 23:52:52
7a2f9dcf8b56b6923a5bde028ea1838d32572588...d242bd27cdfaafb7d36c0e1908d7c60bde1e8b67,1,2,5,7,3,2012-06-04 06:38:12,2012-06-04 06:38:12
4a69c416943a46e2e9fad23b989410d70098cb3f...821f3449aaa8392c9f1522878fe7c2f0169df924,2,2,2,4,2,2011-11-05 02:27:14,2011-11-05 02:27:14
07634ccaf1defd6467c848413aca53bf647b2823...588e82c8dc0c1e75845dabb10391ed3a06f938d7,1,2,1,3,2,2011-11-06 22:08:45,2011-11-06 22:08:18
b780098073696e367793c20b8a7b4cd5493b9e37...d5c0d33d10ac210fbad2cccb321e868589f806cf,1,0,9,9,2,2011-12-30 15:18:15,2011-12-30 15:16:57
d5c0d33d10ac210fbad2cccb321e868589f806cf...5884c3a5fd0db16849877da1e061e1d7a646db67,1,1,3,4,1,2011-12-30 15:31:35,2011-12-30 15:31:35
5884c3a5fd0db16849877da1e061e1d7a646db67...f93c8e16364e0be57645ca9ca1f422a45a907ae0,1,12,12,24,9,2011-12-30 15:48:38,2011-12-30 15:48:38
9ced71e8efae9d1fb12d924eb496fcae03ecfa5a...9cf989542ce67e9c8ac3483a58666f4ddb805f1d,2,0,0,0,0,2012-03-21 07:35:50,2012-03-21 07:35:12
339b6c96adbcbde6322df6e72d489ec93f98dbe5...060ac246fdc80b1b0d5f8caa7b91ad69f96790b7,1,4,1,5,2,2012-04-08 13:18:19,2012-04-08 13:18:19
d2d5fd1eac2eb6a0a1f084cf5332927a6298d914...5a2585f42c3bcf62eaeeabc056594c3ecb535df4,1,14,0,14,1,2012-06-05 17:07:33,2012-06-05 17:07:33
5a2585f42c3bcf62eaeeabc056594c3ecb535df4...4505fa12b1dd30d3bd604924feba673c07ecbbf3,1,1,1,2,1,2012-06-05 17:27:22,2012-06-05 17:27:22
4505fa12b1dd30d3bd604924feba673c07ecbbf3...cbde32f684fedf0871dd57ed5f09d4bbcabb537d,1,1,1,2,1,2012-06-08 11:21:16,2012-06-08 11:21:16
cbde32f684fedf0871dd57ed5f09d4bbcabb537d...0c52750ea6df433a6ec73e909e3ad6408736bf52,1,5,4,9,1,2012-06-09 10:27:39,2012-06-09 10:27:39
0c52750ea6df433a6ec73e909e3ad6408736bf52...7aa306c0b3356d42b847035b366b6c810de350e8,2,1,1,2,1,2012-06-09 11:32:47,2012-06-09 11:32:47
588e82c8dc0c1e75845dabb10391ed3a06f938d7...8b634157e3ec396fd79db1f8a4978acb21515443,1,10,0,10,1,2011-11-07 14:38:37,2011-11-07 14:38:37
9cf989542ce67e9c8ac3483a58666f4ddb805f1d...7912513084ad7eff9406277c039fb189b045547e,1,1,1,2,1,2012-03-23 04:07:39,2012-03-23 04:07:39
7912513084ad7eff9406277c039fb189b045547e...863de294e848f7a562770ae18b42be15f2640d81,1,1,1,2,1,2012-03-23 04:20:25,2012-03-23 04:20:25
9cf989542ce67e9c8ac3483a58666f4ddb805f1d...1c55518defa53e0e8a4514bbf7b75ce999516168,4,661,523,1184,227,2012-03-21 23:42:54,2012-03-21 23:42:54
7aa306c0b3356d42b847035b366b6c810de350e8...ca30a53977af40b8c4c1849f9543b29974cac701,1,0,0,0,0,2012-06-10 11:33:29,2012-06-09 17:15:35
ce11ab3f8e2a32df00533a09ede0406bc45b2091...8074f1584fffd73f20f2782fc78558521ec4c310,3,1584,1330,2914,432,2011-11-10 23:10:21,2011-11-10 23:10:21
b3755703b7883afa3c2009d89d7926ed06f30af8...8c4ce42af3f1f2b099949a45a48a8aff5d5c196f,1,0,1,1,1,2012-01-06 15:40:09,2012-01-06 15:40:09
8c4ce42af3f1f2b099949a45a48a8aff5d5c196f...01296493e75690d8ce6764c51d6b02507ea2b855,1,0,12,12,1,2012-01-07 20:18:58,2012-01-07 20:18:58
b3755703b7883afa3c2009d89d7926ed06f30af8...3719f56c86830aafad1f333542fe1a1ff19e63aa,4,36,2,38,7,2012-01-05 23:46:14,2012-01-05 23:46:14
3719f56c86830aafad1f333542fe1a1ff19e63aa...3e0b0de9dae67025eb39a315afcdce2aaf393449,1,0,5,5,2,2012-01-18 03:01:57,2012-01-18 03:01:57
863de294e848f7a562770ae18b42be15f2640d81...9cb7e46f328e13df966f340ed14c58d855ed5e39,1,1,1,2,1,2012-03-23 06:29:10,2012-03-23 06:29:10
4026f032492fcd25ffab98ce6ae9861bfbae2d89...263af0b4681dba98698a40cca354d5db61c85c47,1,2,2,4,2,2012-04-03 09:57:00,2012-04-03 09:57:00
49089be067ee6bcdd53ccf80e468973571164c5b...2a60c6b3d18fcbd09d8521fe62ee8e296e58a3c8,1,2,0,2,1,2012-06-11 08:21:33,2012-06-10 12:41:31
2a60c6b3d18fcbd09d8521fe62ee8e296e58a3c8...288f9922c098105216f194cf3ba50fcb7fe60aee,1,4,5,9,4,2012-06-14 07:14:13,2012-06-14 07:12:56
288f9922c098105216f194cf3ba50fcb7fe60aee...83f4f281866be1cf7f391738c53c448a5ac658e9,1,2,2,4,2,2012-06-24 09:46:06,2012-06-24 08:10:27
83f4f281866be1cf7f391738c53c448a5ac658e9...5370479476dceae7cc3ea105946536d6bc0ee468,1,11,42,53,2,2012-07-08 19:20:17,2012-07-07 22:09:05
5370479476dceae7cc3ea105946536d6bc0ee468...d3969484ff1c2bc6e4691a926cef5594428b6ba7,3,5,5,10,3,2012-07-19 13:17:26,2012-07-19 13:17:26
d3969484ff1c2bc6e4691a926cef5594428b6ba7...889e377b2d20eaaa690785d7e47daf50aa46b972,8,78,160,238,77,2012-07-29 13:48:14,2012-07-29 13:48:14
889e377b2d20eaaa690785d7e47daf50aa46b972...cc265d4511ca49ebfd2f5618c5ae3e8751aacae9,1,0,9404,9404,1,2012-07-31 22:39:27,2012-07-31 22:39:27
cc265d4511ca49ebfd2f5618c5ae3e8751aacae9...1e3be1842b3aa7f4b96862d0a1f0d098f2176eec,12,1501,21,1522,22,2012-08-02 13:06:13,2012-07-31 21:32:04
1e3be1842b3aa7f4b96862d0a1f0d098f2176eec...703d0b8651120a96848d55a0db059a7f334c2638,2,78,0,78,1,2012-08-05 10:11:02,2012-08-05 10:11:02
703d0b8651120a96848d55a0db059a7f334c2638...3ce6e98cde37308ce1207ad09970c54a266d0a9a,1,2,52,54,1,2012-08-05 11:22:32,2012-08-05 11:22:32
3ce6e98cde37308ce1207ad09970c54a266d0a9a...f23340ed9b8d2d59b611d38aea7ee9569f94a3b4,3,22,6,28,4,2012-08-08 22:56:10,2012-08-08 22:52:31
f23340ed9b8d2d59b611d38aea7ee9569f94a3b4...d590b0efe9a7fbc4b8b7fd46683dfb989c2c26ef,5,542,371,913,37,2012-08-09 20:48:57,2012-08-06 13:09:40
d590b0efe9a7fbc4b8b7fd46683dfb989c2c26ef...1c30c5a6602c708cca718572eaa80b52110d3f81,4,5,7,12,4,2012-08-10 07:44:01,2012-08-10 07:39:29
1c30c5a6602c708cca718572eaa80b52110d3f81...5ed4dadf5c3db011f3eb3db80d830e3d35e1ba91,1,1,0,1,1,2012-08-10 09:34:12,2012-08-10 09:34:12
5ed4dadf5c3db011f3eb3db80d830e3d35e1ba91...02bdaea1245e33220dc3ebe0cce2cb77be06d7f9,1,22,9,31,2,2012-08-10 09:36:23,2012-08-10 09:36:23
02bdaea1245e33220dc3ebe0cce2cb77be06d7f9...66b137083fe7743ae3979ceb109959242142bdb2,2,182,182,364,7,2012-08-10 11:29:22,2012-08-10 11:29:22
66b137083fe7743ae3979ceb109959242142bdb2...8e90c33cefa2776ffb5058620f414063dba7257f,6,0,0,0,0,2012-08-12 14:04:11,2012-08-12 14:04:11
8e90c33cefa2776ffb5058620f414063dba7257f...1d96e328769d8f6f18d64d9ddd48fceeecb21399,2,4,5,9,3,2012-08-12 14:17:58,2012-08-12 14:17:58
1d96e328769d8f6f18d64d9ddd48fceeecb21399...50b46d6fa2f67fb2ea312258c1195c27082f2e56,1,60,3,63,6,2012-08-14 14:34:55,2012-08-14 14:34:55
50b46d6fa2f67fb2ea312258c1195c27082f2e56...596d9a9dccd0fc9bf26913f3824418cec9944bae,1,48,48,96,34,2012-08-14 23:21:11,2012-08-14 23:21:11
596d9a9dccd0fc9bf26913f3824418cec9944bae...e52927a03e6776333106bd4225e9f00c075e4c4d,1,21,18,39,7,2012-08-14 23:33:21,2012-08-14 23:33:21
e52927a03e6776333106bd4225e9f00c075e4c4d...456211dc54c7a0328485d73cf25443d210d8e1d8,2,13,7,20,5,2012-08-15 19:48:39,2012-08-15 19:48:39
456211dc54c7a0328485d73cf25443d210d8e1d8...920e52a5d484284a769a119f1624d3bbc3bf8c42,1,1,0,1,1,2012-08-15 21:52:37,2012-08-15 21:52:37
920e52a5d484284a769a119f1624d3bbc3bf8c42...445037ccf4795f83ca5513e365923bf7fa0a3ac2,1,1,11,12,2,2012-08-18 17:56:29,2012-08-18 17:47:54
445037ccf4795f83ca5513e365923bf7fa0a3ac2...28f922ff3c2090d2e821c243d8be6d1de3f4eec0,2,6,0,6,2,2012-08-18 17:56:42,2012-08-18 17:56:42
28f922ff3c2090d2e821c243d8be6d1de3f4eec0...7b0ba6b083e301606c15dc97072cc5c4d4b3122e,2,8,3,11,4,2012-08-20 21:57:28,2012-08-20 21:57:28
7b0ba6b083e301606c15dc97072cc5c4d4b3122e...38c7a90cbf51391019ad3aace588297ef5c5d472,1,13,6,19,3,2012-08-20 22:38:35,2012-08-20 22:38:35
38c7a90cbf51391019ad3aace588297ef5c5d472...fac03ef28f14811446f7c42fc93338685c2a3da7,1,17,12,29,8,2012-08-21 21:54:40,2012-08-21 21:54:40
fac03ef28f14811446f7c42fc93338685c2a3da7...adecc5da035d6d76b77e3fa95c6abde841073da2,3,16,8,24,4,2012-08-21 22:37:37,2012-08-21 22:16:50
adecc5da035d6d76b77e3fa95c6abde841073da2...68197bc42dd408890b2a9ce11aaaf0698a820544,1,1,1,2,1,2012-08-22 14:31:48,2012-08-22 14:31:48
68197bc42dd408890b2a9ce11aaaf0698a820544...a36b296b8986906bdb10acdfae255fccbf8bc558,2,19,30,49,2,2012-08-22 23:00:24,2012-08-22 18:07:07
a36b296b8986906bdb10acdfae255fccbf8bc558...42f16dfaa1db0f69e6060b1fa0d3744d06deee83,1,6,6,12,6,2012-08-26 15:27:39,2012-08-26 15:27:39
42f16dfaa1db0f69e6060b1fa0d3744d06deee83...dfca687243d9f5f316b16bf7990df1d79b80e389,1,19,19,38,8,2012-08-26 15:32:34,2012-08-26 15:32:34
dfca687243d9f5f316b16bf7990df1d79b80e389...39a1801a886079fad692bfd2ad1b4e419f355fb0,1,3,0,3,2,2012-08-26 15:46:31,2012-08-26 15:46:31
39a1801a886079fad692bfd2ad1b4e419f355fb0...6415ccd9b0de7e39f0b2c99a6926a0236eaa20ca,1,0,1,1,1,2012-08-27 09:16:05,2012-08-27 09:16:05
6415ccd9b0de7e39f0b2c99a6926a0236eaa20ca...6f5ed6f92140f2518ab2d685b80bbdec687a2088,1,0,12,12,1,2012-08-27 10:38:31,2012-08-27 10:38:31
6f5ed6f92140f2518ab2d685b80bbdec687a2088...19c8065b6a4238efcdddf08c37ea5a8ab54e3ce7,7,17,15,32,15,2012-08-27 10:53:46,2012-08-27 10:53:46
19c8065b6a4238efcdddf08c37ea5a8ab54e3ce7...07ee69683cfe10de4db3558a2e808450c0ded3e2,1,19,19,38,8,2012-08-27 18:21:32,2012-08-27 18:21:32
07ee69683cfe10de4db3558a2e808450c0ded3e2...0b60046431d14b6615d53ae6d8bd0ac62ae3eb6f,1,2,0,2,1,2012-08-28 22:41:15,2012-08-28 22:41:15
0b60046431d14b6615d53ae6d8bd0ac62ae3eb6f...5735ee396dd9623cd35b624ff165eb9fe453a6c8,3,4,4,8,3,2012-08-31 14:16:46,2012-08-31 14:16:46
5735ee396dd9623cd35b624ff165eb9fe453a6c8...d4467ad7f2aa8e31682b6774072bb4206e2098fc,1,1,1,2,1,2012-09-03 14:48:46,2012-09-03 14:48:46
d4467ad7f2aa8e31682b6774072bb4206e2098fc...1c6485adb9b98ef2fa50a6c01b8d9fbbdc1dd8fa,3,5,5,10,3,2012-09-05 20:14:00,2012-09-05 20:14:00
1c6485adb9b98ef2fa50a6c01b8d9fbbdc1dd8fa...dd420ef187e83748daf5cd27a99c83ac5007e7b9,1,10,10,20,6,2012-09-16 05:28:42,2012-09-16 05:28:42
dd420ef187e83748daf5cd27a99c83ac5007e7b9...cb0bb16eb7d2d6ce4faad728e1a4cfccadc3a471,1,10,10,20,6,2012-09-16 10:38:04,2012-09-16 10:38:04
cb0bb16eb7d2d6ce4faad728e1a4cfccadc3a471...0dcd9d120e6027427c3fca3ecbf0c796b0cce4fd,12,12,11,23,11,2012-09-16 10:45:57,2012-09-16 10:45:57
0dcd9d120e6027427c3fca3ecbf0c796b0cce4fd...d20a342c95ff6ca318aa16f1dc80aa1133baf8b8,1,13,3,16,3,2012-09-16 11:04:08,2012-09-16 06:30:41
d20a342c95ff6ca318aa16f1dc80aa1133baf8b8...bb7b3577b19a91b101ed9d27143109a4172b9530,1,2,2,4,2,2012-09-16 11:06:36,2012-09-16 11:06:36
bb7b3577b19a91b101ed9d27143109a4172b9530...bfeac11c9ae4345eda0dc2a1a6c573194d63d3a9,1,4,0,4,1,2012-09-16 11:07:31,2012-09-16 11:07:31
bfeac11c9ae4345eda0dc2a1a6c573194d63d3a9...2dd1153cfc389608036b848e41852ae5a57e62c1,1,1,1,2,1,2012-09-17 08:42:15,2012-09-17 08:39:36
2dd1153cfc389608036b848e41852ae5a57e62c1...2c079ae144cbab66d21edc99dded693a910d9fc2,3,3,8,11,4,2012-09-17 19:40:46,2012-09-17 19:40:46
2c079ae144cbab66d21edc99dded693a910d9fc2...b378ce239dfb017e32fbeacc5ab0346258b089e2,1,1,1,2,1,2012-09-19 22:25:40,2012-09-19 10:02:09
b378ce239dfb017e32fbeacc5ab0346258b089e2...e6c64a238d5438dbc28ea09a115ee44cb6f144ad,1,1,1,2,1,2012-09-19 22:28:55,2012-09-19 22:28:55
8bf92b09899c4dbda947882c3f138d27b8cb9f9f...78533f248cfbc7c2d759eb4f5baa316958c5f2f0,1,3,3,6,2,2011-11-11 08:09:34,2011-11-11 08:09:34
78533f248cfbc7c2d759eb4f5baa316958c5f2f0...05965584fc52bcd96c398ec11d5ec82f09b944ef,1,0,0,0,0,2011-11-17 17:32:22,2011-11-07 16:20:54
05965584fc52bcd96c398ec11d5ec82f09b944ef...9efe695f4d4d1f4f3cb69d6c19b665a5827ce151,1,4,4,8,1,2011-11-17 17:32:53,2011-11-17 09:42:23
9efe695f4d4d1f4f3cb69d6c19b665a5827ce151...f40da1b529bca15023ad83fd72fc48bb32ca7f38,1,0,0,0,0,2011-11-17 20:37:37,2011-11-17 20:37:37
8074f1584fffd73f20f2782fc78558521ec4c310...2dd8ad97f89db4f483bcae2949ad98407c3fbd3d,1,4,4,8,1,2011-11-17 09:42:23,2011-11-17 09:42:23
01296493e75690d8ce6764c51d6b02507ea2b855...0f9507774b174311c6937355f7504db0f0848a74,1,2,2,4,2,2012-01-13 01:46:56,2012-01-13 01:46:56
a36d55870279d56b292f620537d8a5938591c762...26ea01971cc4fa4da34389d2d089a23aa741e209,1,1,0,1,1,2012-01-20 19:07:26,2012-01-20 19:07:26
a36d55870279d56b292f620537d8a5938591c762...27d1fda0dc084b7b4c313fc4264c26a0c32c49f8,1,1,1,2,1,2012-01-19 19:22:34,2012-01-19 19:22:34
a36d55870279d56b292f620537d8a5938591c762...e80a3e06376656a7d14561aae7e15881b5290bbb,1,2,1,3,2,2012-01-19 18:41:01,2012-01-19 18:41:01
e80a3e06376656a7d14561aae7e15881b5290bbb...4932b4070f7d0c1fb6e804451ff17750df74c4b7,1,1,1,2,1,2012-01-20 16:42:53,2012-01-20 16:42:53
e6c64a238d5438dbc28ea09a115ee44cb6f144ad...4ac3ffef5c3901ebdcb6e2de7b58055d64854a53,3,4,4,8,3,2012-09-21 20:41:35,2012-09-21 09:22:44
e6c64a238d5438dbc28ea09a115ee44cb6f144ad...6be0119cd2560e31a95383e5ba89963ca576dfea,1,1,1,2,1,2012-09-20 19:14:13,2012-09-20 19:14:13
f40da1b529bca15023ad83fd72fc48bb32ca7f38...a7b1a71624db2428c2f73f6d6fccd19bcebb120c,1,1,1,2,1,2011-11-20 19:42:41,2011-11-20 19:42:41
d8e28f2f2e85df640661c795a2a555b48666914d...a8e96a79a1d3e7aed9a9b3e59acae6cfc9930a3d,4,295,329,624,148,2011-11-28 23:17:26,2011-11-28 23:17:26
f4cd5c18a37041e9f4be8179b27c052fba81b143...ce9c57c105fb078fbf95b1be2682d4d38c790f8f,1,2,2,4,1,2012-01-17 16:47:11,2012-01-17 16:47:11
e1b163041ec9f116644ef0e643e600fa2d81c00d...578f3778498442aa5106997ae1d6e379aa93e109,1,16,11,27,1,2012-09-22 10:04:03,2012-09-20 17:52:17
578f3778498442aa5106997ae1d6e379aa93e109...5bed678da053e26c3399793e6ad91cc40e09a30b,1,3,2,5,1,2012-09-22 10:15:45,2012-09-22 10:15:45
5bed678da053e26c3399793e6ad91cc40e09a30b...dc00673b7c056392409139dba451305a828a230d,1,1,1,2,1,2012-10-14 13:00:32,2012-10-03 21:07:27
dc00673b7c056392409139dba451305a828a230d...750bf0e093a0a80ad785e38f23db38ad077a2d80,1,6,1,7,3,2012-10-14 19:06:53,2012-10-14 13:15:07
750bf0e093a0a80ad785e38f23db38ad077a2d80...7b04f32d5a5a5a37bda023567b4da12dd8869d4d,1,1,1,2,1,2012-10-19 04:59:54,2012-10-19 04:59:54
7b04f32d5a5a5a37bda023567b4da12dd8869d4d...25c1073d13eb49a948d7040525ba656d93aece30,1,2,0,2,1,2012-10-20 23:01:31,2012-10-20 23:01:31
25c1073d13eb49a948d7040525ba656d93aece30...551dd5c5d67e3b2da4074d8f15a59a324a063a03,1,1,1,2,1,2012-10-29 13:12:34,2012-10-29 12:52:01
551dd5c5d67e3b2da4074d8f15a59a324a063a03...0615b940c3247e3547de1379ab09a4a6bb614252,1,25,25,50,28,2012-10-30 10:58:54,2012-10-30 10:57:08
0615b940c3247e3547de1379ab09a4a6bb614252...e85301270f08c3a025558c52d58ba526db737ac0,1,1,1,2,1,2012-11-01 13:48:09,2012-11-01 13:48:09
e85301270f08c3a025558c52d58ba526db737ac0...e9f6a9890c7785f4144b87890617774b8cf05a37,1,1,5,6,1,2012-11-04 17:44:33,2012-11-04 17:41:31
a0cf284836dfa72574e928c8299b22a4edc7d6f0...875df4e9b598b869e52bd081a080419d30913930,2,0,4,4,2,2011-11-23 12:20:56,2011-11-23 12:20:56
b1e3aa5fe484439726405417a2dd1f21c63d3a6d...791734033f61a03752c6a060b017d8a66b5b37ac,1,1,1,2,1,2011-12-10 12:13:39,2011-12-10 12:13:39
b1e3aa5fe484439726405417a2dd1f21c63d3a6d...cafea9f0904cc47b031bd3326286f348e706eed0,1,20,6,26,7,2011-12-09 20:04:21,2011-12-09 20:04:21
b1e3aa5fe484439726405417a2dd1f21c63d3a6d...d582fe5d8e2d7b960b60012e2a7d4bba9a326d04,1,1,1,2,1,2011-12-07 18:02:42,2011-12-07 18:02:42
b1e3aa5fe484439726405417a2dd1f21c63d3a6d...a835a4dbb0504fa721432bc7f772e01abb116d43,1,2,0,2,1,2011-11-30 16:54:35,2011-11-30 16:54:35
b1e3aa5fe484439726405417a2dd1f21c63d3a6d...ba7d47f9311d4ca45882284f73065c9c99e0b8ed,1,1,1,2,1,2011-11-29 18:17:50,2011-11-29 18:17:50
e9f6a9890c7785f4144b87890617774b8cf05a37...d141f70910f41cf28ccff86e5a7dc03b28cb27e6,4,6,4,10,4,2012-11-14 09:06:22,2012-11-14 09:06:22
fdb58e681555e8263f12cdc44c697c6bbab3db38...2727fa23a6715080f120fd41792a6a8c1b112125,1,17,1,18,2,2011-11-28 19:00:09,2011-11-28 19:00:09
e97689d7aacc22b2c682a0ae670559bf038916d5...2b5eeeef27f8d5224c66c0ac245e2f86691670f3,1,12,11,23,3,2011-12-13 19:51:33,2011-12-13 19:51:30
8c08445487860948779039f5981c26d74c6906b5...dac15682b35ad69f519205e1b82694d0cab189ca,1,3,0,3,1,2012-11-18 20:30:45,2012-11-15 15:24:15
dac15682b35ad69f519205e1b82694d0cab189ca...052ecc4b290f7d5d79d22a14701ee1bf6ecf3d85,2,4,3,7,3,2012-11-25 19:54:13,2012-11-25 19:54:13
052ecc4b290f7d5d79d22a14701ee1bf6ecf3d85...3d5d852697cfa17667267296082131d3c5224ae5,7,0,0,0,0,2012-12-08 18:54:17,2012-12-08 18:38:33
3d5d852697cfa17667267296082131d3c5224ae5...46446727b2ecc1963655828fdb76568f81d2b323,1,4,1,5,1,2012-12-09 23:12:30,2012-12-09 23:11:10
46446727b2ecc1963655828fdb76568f81d2b323...1987e5a1ee468686cbb3e507c1a924f5851c9755,2,6,2,8,2,2012-12-28 12:31:58,2012-12-28 12:27:59
1987e5a1ee468686cbb3e507c1a924f5851c9755...081f8aa0decdc1d2d561ff6dd23abaeff4bbf439,2,2,1,3,2,2012-12-28 12:39:19,2012-12-28 12:39:19
081f8aa0decdc1d2d561ff6dd23abaeff4bbf439...a2b3d06e8b5b0bfb3bd608a1b938c9fa50b1c600,2,2,1,3,2,2012-12-28 12:58:11,2012-12-28 07:17:17
a2b3d06e8b5b0bfb3bd608a1b938c9fa50b1c600...7bc8241f517ccad5013ab83d8599e991b7f4a356,1,1,1,2,1,2013-01-04 19:43:31,2013-01-04 19:43:31
2b5eeeef27f8d5224c66c0ac245e2f86691670f3...024600fd573d0eeddcf23ab3656cc3324c6c3cbf,1,1,1,2,1,2011-12-17 20:06:58,2011-12-17 20:06:58
024600fd573d0eeddcf23ab3656cc3324c6c3cbf...23bd7669559960c49df6db78cf148cacb7150c3b,1,9,5,14,5,2011-12-20 07:20:04,2011-12-20 07:20:04
23bd7669559960c49df6db78cf148cacb7150c3b...9feb29f4654540297e358454b821b2e29b848be8,1,1,1,2,1,2011-12-22 06:51:26,2011-12-22 06:51:26
9feb29f4654540297e358454b821b2e29b848be8...fd52982efdb175a82325f60c986f82e7241ad801,1,1,1,2,1,2011-12-24 07:56:42,2011-12-24 07:56:42
2b5eeeef27f8d5224c66c0ac245e2f86691670f3...e2ca1bf93104b773a05c1ffc32086d9373920b78,1,11,0,11,1,2011-12-14 19:58:54,2011-12-14 19:58:54
e2ca1bf93104b773a05c1ffc32086d9373920b78...71d52296113d9c729f51ff78894380b1aed93cc6,1,1,0,1,1,2011-12-28 09:20:24,2011-12-28 09:20:24
7bc8241f517ccad5013ab83d8599e991b7f4a356...21702c4198124647d541be635268b16ef7d33c72,1,0,0,0,0,2013-01-10 01:12:19,2013-01-09 20:02:21
fb9166461b4e23905ca9eddadeafd9895db0629f...90f99e1587354baa90a1321d584a854cc61efe75,1,1,0,1,1,2013-01-13 00:15:15,2013-01-13 00:15:15
90f99e1587354baa90a1321d584a854cc61efe75...29315016dc40a70fc1d6a3a8b6edf92c9b7be0d2,1,2,0,2,1,2013-01-13 00:16:35,2013-01-13 00:16:35
29315016dc40a70fc1d6a3a8b6edf92c9b7be0d2...e9a471bc3ff36c971a09d9999ea5800119df1d08,1,1,1,2,1,2013-01-13 18:24:50,2013-01-13 16:20:44
e9a471bc3ff36c971a09d9999ea5800119df1d08...964c929ef02710254a83231ec0941f32387b2cef,1,63,46,109,25,2013-01-13 19:56:44,2013-01-13 19:56:44
964c929ef02710254a83231ec0941f32387b2cef...3a7de0b41a2323ee4ad5f5a0747d704b0edec32d,4,8,4,12,4,2013-01-15 10:12:23,2013-01-15 09:17:44
3a7de0b41a2323ee4ad5f5a0747d704b0edec32d...c3358e2399cf3ce3c187bd9246f8f168467e44fe,2,117,93,210,48,2013-01-21 01:55:13,2013-01-21 01:55:13
c3358e2399cf3ce3c187bd9246f8f168467e44fe...aa9bcbeb5bd8bb667bf232095f001a7272eeffd9,1,6,4,10,5,2013-01-21 02:58:04,2013-01-21 02:58:04
aa9bcbeb5bd8bb667bf232095f001a7272eeffd9...922df45999f7b1e708140c27d3369fb89616789e,1,5,7,12,3,2013-01-31 03:28:18,2013-01-31 03:28:18
922df45999f7b1e708140c27d3369fb89616789e...7dae637800cbbb91961cdb3455b5e441bd4e0711,4,9,6,15,4,2013-02-05 08:04:19,2013-02-05 08:04:19
7dae637800cbbb91961cdb3455b5e441bd4e0711...19c03c4bf059ec8c1792509fda701fada289aefb,1,4,5,9,1,2013-02-09 10:11:08,2013-02-09 10:10:11
19c03c4bf059ec8c1792509fda701fada289aefb...522fa645c3354d4b8463eb78e6887f127d871b1f,1,13,0,13,1,2013-02-09 10:32:51,2013-02-09 10:30:33
522fa645c3354d4b8463eb78e6887f127d871b1f...b4587434f807115d54912e068b4627974531c701,1,1,1,2,1,2013-02-11 01:56:56,2013-02-11 01:15:47
b4587434f807115d54912e068b4627974531c701...2f966781d87842a783d120bf30c1ddfe6da7fa97,1,1,1,2,1,2013-02-16 01:58:23,2013-02-16 01:58:23
c01aa0474dfd1e86081502bd8b3e10c4f743c0ea...b83ce3b1b42157f8c817a62b4d353415e25c3af4,1,1,1,2,1,2013-02-17 16:05:40,2013-02-17 14:52:07
b83ce3b1b42157f8c817a62b4d353415e25c3af4...a10460934dfe86a1829f2eff93884238cfbd4c94,1,1,1,2,1,2013-03-04 17:00:53,2013-03-04 06:38:50
a10460934dfe86a1829f2eff93884238cfbd4c94...1b0f042e06da46af60d7289b21af85bf58bb4978,1,2,1,3,1,2013-03-05 05:25:20,2013-03-05 05:25:20
1b0f042e06da46af60d7289b21af85bf58bb4978...c8b0431c7d57a9670500bb0e1a22dc80d87f8d41,2,417,415,832,116,2013-03-30 09:19:28,2013-03-30 08:47:07
c8b0431c7d57a9670500bb0e1a22dc80d87f8d41...a7a4d0685cb6f9622a308c165d9317114d80ccd3,1,1,1,2,1,2013-03-31 00:49:47,2013-03-31 00:49:47
a7a4d0685cb6f9622a308c165d9317114d80ccd3...6cfbc95cd6b094430ecbb4c44d97dfda9adba852,2,4,336,340,3,2013-04-01 10:29:14,2013-04-01 09:42:26
6cfbc95cd6b094430ecbb4c44d97dfda9adba852...2a8e5828af49c041fe70193f4cda9ef3ab94ad97,1,12,6,18,4,2013-04-08 00:40:59,2013-04-08 00:40:31
2a8e5828af49c041fe70193f4cda9ef3ab94ad97...fa7527fb2620db8693dcf5d490ad1b7d01097264,1,1,1,2,1,2013-04-08 02:33:37,2013-04-08 02:33:37
fa7527fb2620db8693dcf5d490ad1b7d01097264...d94e5061894e2e1b458371d66613137d434ebbeb,1,5,1,6,1,2013-04-08 02:35:51,2013-04-08 02:35:51
d94e5061894e2e1b458371d66613137d434ebbeb...0adda79fee6ddccc46d0ba427c7e3d7277f39230,1,2,0,2,1,2013-04-08 02:41:59,2013-04-08 02:41:59
0adda79fee6ddccc46d0ba427c7e3d7277f39230...7a22a33d4041c479d0962499e853501073811887,3,7,4,11,3,2013-04-12 14:40:55,2013-04-12 10:55:48
7a22a33d4041c479d0962499e853501073811887...52f17087f986020280f1dc929fb14842c7d2f0d1,1,38,0,38,1,2013-05-10 08:48:25,2013-05-09 14:12:11
52f17087f986020280f1dc929fb14842c7d2f0d1...f27c2b7372cbf4cb8d1b02521895f4ed17518450,2,8,12,20,5,2013-05-12 11:24:19,2013-05-12 11:24:19
f27c2b7372cbf4cb8d1b02521895f4ed17518450...713abf57a9e8acd06bc7b8c1ecd3547e2ec7bdfe,4,9,7,16,4,2013-05-30 14:00:49,2013-05-24 22:09:15
713abf57a9e8acd06bc7b8c1ecd3547e2ec7bdfe...deec3622132f3c68e74d7a7d6a05534a6bf2650a,4,9,9,18,4,2013-05-31 19:30:44,2013-05-31 19:30:44
deec3622132f3c68e74d7a7d6a05534a6bf2650a...48d49e96d6db282eb9686d31ebbc5cbbbdd4d966,2,7,4,11,2,2013-06-03 17:29:37,2013-06-03 17:29:37
48d49e96d6db282eb9686d31ebbc5cbbbdd4d966...8f743702f6846a3fff86da56ea69c1f4e07d161b,1,3,2,5,1,2013-06-14 09:03:52,2013-06-14 08:57:11
8f743702f6846a3fff86da56ea69c1f4e07d161b...02713eedd21bbc92f704fbf65ff382e76bf81f2b,2,3,3,6,3,2013-06-24 20:25:18,2013-06-13 19:34:35
02713eedd21bbc92f704fbf65ff382e76bf81f2b...9ec546569b80c9efb34a763d194e94bfdf14e06b,2,7,2,9,3,2013-06-25 19:42:49,2013-06-25 19:42:49
9ec546569b80c9efb34a763d194e94bfdf14e06b...8fc26501f4635df92bbbff966d8d6e6064e0e419,2,2,3,5,3,2013-06-26 10:56:45,2013-06-26 10:22:04
8fc26501f4635df92bbbff966d8d6e6064e0e419...ff37dba6bf025a00f58b2bb12f7c6a827e6643c5,2,2,2,4,2,2013-06-30 20:45:20,2013-06-30 20:29:45
ff37dba6bf025a00f58b2bb12f7c6a827e6643c5...ce7c3c5c1595ddc42ca3b961179a0cf85aa714be,4,9,9,18,4,2013-07-03 17:40:15,2013-07-03 17:39:47
ce7c3c5c1595ddc42ca3b961179a0cf85aa714be...be4484add07b66dd5440266f121641137d9f1df7,6,0,0,0,0,2013-07-21 18:37:44,2013-07-21 12:51:35
be4484add07b66dd5440266f121641137d9f1df7...01624d71f58811b3ca93ffca5b680475dcc0382d,1,65,29,94,17,2013-08-01 11:23:22,2013-07-30 15:31:44
01624d71f58811b3ca93ffca5b680475dcc0382d...21c614849afc5b518685b68d81d2b0c8f7971f0a,2,22,14,36,13,2013-08-01 11:35:05,2013-08-01 11:27:07
21c614849afc5b518685b68d81d2b0c8f7971f0a...5bc2a985c74a1f854f7fc1ee8f8ce4639fe7cd67,2,8,11,19,3,2013-08-01 16:24:27,2013-08-01 16:24:27
5bc2a985c74a1f854f7fc1ee8f8ce4639fe7cd67...2cf1ef7ceaf034b189b23868dd16d1908059e6fa,1,5,9,14,3,2013-08-14 12:30:49,2013-08-14 12:30:49
2cf1ef7ceaf034b189b23868dd16d1908059e6fa...cd981e52f7cb96260f9703002885db154a10ebfb,5,0,0,0,0,2013-08-15 06:19:45,2013-08-14 20:48:13
cd981e52f7cb96260f9703002885db154a10ebfb...8a68443746a6b99b1025c6aef9bfd94a0b50778a,1,2,2,4,2,2013-08-15 10:31:35,2013-08-15 09:47:34
8a68443746a6b99b1025c6aef9bfd94a0b50778a...ab05d000f80f754764bf91b949de8b19cc11cf3d,6,0,0,0,0,2013-08-16 09:20:24,2013-08-16 05:12:58
ab05d000f80f754764bf91b949de8b19cc11cf3d...ab6b2fc4aa83c760dd9fff6ec29eac5c72c271b1,1,1,1,2,1,2013-08-26 06:55:11,2013-08-02 22:23:30
ab6b2fc4aa83c760dd9fff6ec29eac5c72c271b1...da9528e568388cd7044529f2d3de66515bb3964a,1,2,1,3,1,2013-08-26 06:58:18,2013-08-26 06:57:22
da9528e568388cd7044529f2d3de66515bb3964a...23f5e084e559177b434f702ff6be1d83e66374d3,2,2,2,4,2,2013-08-30 08:14:08,2013-08-30 08:14:08
23f5e084e559177b434f702ff6be1d83e66374d3...71ca9fb7a06bfcd2359c924ca261d41d1dd03e8d,10,44,16,60,9,2013-09-04 12:09:47,2013-08-30 13:08:06
71ca9fb7a06bfcd2359c924ca261d41d1dd03e8d...d1443410031e06421b70cd2fe39fc784c555e60a,2,3,3,6,3,2013-09-10 17:24:31,2013-09-10 16:51:18
d1443410031e06421b70cd2fe39fc784c555e60a...f033325bac27ea65f5f1367f73c55cb0467d3127,1,3,1,4,3,2013-09-10 19:24:36,2013-09-10 18:32:04
f033325bac27ea65f5f1367f73c55cb0467d3127...72cdf1e96c6506c76c51e53abc1f2bd224776649,1,2,0,2,1,2013-09-10 19:33:07,2013-09-10 19:33:07
72cdf1e96c6506c76c51e53abc1f2bd224776649...fdbff109c987d9802cf2b44355f8f785bbbeed7c,3,6,10,16,5,2013-09-20 14:18:55,2013-09-20 14:18:55
fdbff109c987d9802cf2b44355f8f785bbbeed7c...13f17a737a7429bc102fe5f0991313f9f9162da7,3,3,25,28,3,2013-09-24 08:38:05,2013-09-24 06:17:41
13f17a737a7429bc102fe5f0991313f9f9162da7...b7208f1e014314973b65026c34449f4eebc91aa2,2,45,165,210,41,2013-09-24 12:33:08,2013-09-24 08:41:45
b7208f1e014314973b65026c34449f4eebc91aa2...afaed48700b29fa2ea49e6553f5459e0b6e4185a,1,0,11,11,2,2013-09-24 16:30:20,2013-09-24 16:30:20
afaed48700b29fa2ea49e6553f5459e0b6e4185a...b96191e590fe74b1001d7a879a5a25543b75dc8e,1,1,1,2,1,2013-09-24 17:19:08,2013-09-24 17:19:08
b96191e590fe74b1001d7a879a5a25543b75dc8e...18d3a9dd9e5505aaccf9cde64f05d055fbd448e1,5,7,16,23,7,2013-09-29 09:01:42,2013-09-24 17:36:41
18d3a9dd9e5505aaccf9cde64f05d055fbd448e1...f07a80011b695f996bed8a7ff493934376f76009,1,1,1,2,1,2013-09-29 09:04:53,2013-09-27 09:29:37
f07a80011b695f996bed8a7ff493934376f76009...6d10fc8ccecbcfedbc743d7431688562cd6ae47a,1,7,2,9,3,2013-10-03 18:29:02,2013-10-03 18:09:15
6d10fc8ccecbcfedbc743d7431688562cd6ae47a...782aefab7ea7ae57d30b237be5823298c053136d,2,30,127,157,15,2013-10-12 19:54:14,2013-10-05 09:05:20
782aefab7ea7ae57d30b237be5823298c053136d...8565264a4d58df32fa9938e0f57e96b706c1e261,2,2,0,2,2,2013-10-15 21:10:51,2013-10-15 20:43:47
8565264a4d58df32fa9938e0f57e96b706c1e261...dc752d7952bef4b8ac9e3d7c6844a23fdaf30aba,1,0,19,19,1,2013-10-17 15:21:29,2013-10-17 15:00:10
dc752d7952bef4b8ac9e3d7c6844a23fdaf30aba...5e090e0db592a213b18c85d6e8e663ce650143cb,1,3,0,3,1,2013-10-21 18:37:53,2013-10-17 16:10:31
5e090e0db592a213b18c85d6e8e663ce650143cb...3f91469e7f4784376fb7752ba0dcb8a9387d9ad7,1,1,1,2,1,2013-11-01 08:51:34,2013-10-26 18:41:03
3f91469e7f4784376fb7752ba0dcb8a9387d9ad7...87274cb18123698acdb184ffd2a5fbb875dbbb81,1,1,1,2,1,2013-11-04 00:13:35,2013-11-03 21:22:43
87274cb18123698acdb184ffd2a5fbb875dbbb81...e039cf427584435aa8162c4a38533706044c73ba,1,0,1,1,1,2013-11-12 11:30:57,2013-11-12 11:30:57
e039cf427584435aa8162c4a38533706044c73ba...96d7c99762a0b1a61515cf17b2f172af8fa6674d,2,125,28,153,17,2013-11-12 11:32:32,2013-11-12 11:32:32
96d7c99762a0b1a61515cf17b2f172af8fa6674d...94c3540ce6b4993b3cc728f41fef7b4cb8f18e55,3,4,3,7,4,2013-11-18 08:01:34,2013-11-18 01:33:27
94c3540ce6b4993b3cc728f41fef7b4cb8f18e55...f1a8e914be01a56b7ada4aaf1113ed9b6dc68559,3,1,25,26,4,2013-11-18 22:39:22,2013-11-13 21:42:40
f1a8e914be01a56b7ada4aaf1113ed9b6dc68559...ca1ced9654c70c43502945eca8af1be4c395ab57,4,7,5,12,4,2013-11-19 08:56:54,2013-11-19 08:02:30
ca1ced9654c70c43502945eca8af1be4c395ab57...fbffd2322d37f920825629c385f905a05d141061,4,214,199,413,49,2013-11-19 14:22:16,2013-11-19 08:47:19
fbffd2322d37f920825629c385f905a05d141061...73ea9a5e683fa874d6eefc5940ca3dbbc77825e3,3,4,4,8,4,2013-12-03 09:31:38,2013-12-03 09:27:02
73ea9a5e683fa874d6eefc5940ca3dbbc77825e3...9fab0f9990239ac5aa17a2fc7f442eaac2fcc3f9,1,2,2,4,2,2013-12-11 21:50:35,2013-12-11 21:37:16
9fab0f9990239ac5aa17a2fc7f442eaac2fcc3f9...ec49630374cf567fed4cee3312a5d0673da4999d,1,3,2,5,1,2013-12-11 22:01:33,2013-12-11 19:15:22
ec49630374cf567fed4cee3312a5d0673da4999d...24420747fdbc06f02a3175d7157ca0e0f8b666cd,2,3,3,6,3,2013-12-15 21:00:24,2013-12-15 20:44:39
24420747fdbc06f02a3175d7157ca0e0f8b666cd...49e4569d02d2ffe69123796d46905093da969b75,1,1,1,2,1,2013-12-15 21:03:01,2013-12-15 21:03:01
49e4569d02d2ffe69123796d46905093da969b75...d592953e7ab0a96a696f8fca91f68451c39cb14d,1,2,0,2,1,2013-12-19 21:47:51,2013-12-19 09:31:49
d592953e7ab0a96a696f8fca91f68451c39cb14d...15b5cb1b5c13c9e684e8ca4ddddab7bfc033a83e,1,8,0,8,1,2013-12-20 10:05:33,2013-12-15 14:15:23
15b5cb1b5c13c9e684e8ca4ddddab7bfc033a83e...df2306766e245c1892d3ac600f28e8be5318471c,1,10,7,17,8,2013-12-20 10:56:49,2013-12-20 10:24:26
df2306766e245c1892d3ac600f28e8be5318471c...f4a2cbfcadff23ec02cb6afdf7a95bf0ad602dd1,1,7,0,7,1,2013-12-20 11:13:30,2013-12-20 11:09:19
f4a2cbfcadff23ec02cb6afdf7a95bf0ad602dd1...34c7fbde7476a54a4739f530e35faa7e1953ff57,1,106,50,156,22,2013-12-23 09:47:13,2013-12-23 08:52:21
34c7fbde7476a54a4739f530e35faa7e1953ff57...57be193031b95b003b96efe9eba7a4db7f58f4e1,3,2,5,7,3,2013-12-25 00:10:15,2013-12-23 21:51:10
57be193031b95b003b96efe9eba7a4db7f58f4e1...a557ea0513fbfccbba97cd9795f0bc86ffe501a8,1,16,0,16,1,2013-12-26 12:42:34,2013-12-15 13:31:05
a557ea0513fbfccbba97cd9795f0bc86ffe501a8...1c4df2aa073a4f791e54d4eede91e3bfbb8ee233,2,3,5,8,2,2013-12-29 19:18:19,2013-12-29 17:16:41
1c4df2aa073a4f791e54d4eede91e3bfbb8ee233...3da500d5e591c7b38addd3d7e3bc5e7d57ca49d7,1,48,48,96,6,2014-01-07 08:28:19,2013-12-31 15:54:15
3da500d5e591c7b38addd3d7e3bc5e7d57ca49d7...0a041711372717651c0a1e486b45483f5bc6f2c8,2,14,12,26,10,2014-01-07 08:32:55,2013-12-31 17:56:07
0a041711372717651c0a1e486b45483f5bc6f2c8...76d3021d194caf9004d73d1b5ce9013882b775e0,1,19,10,29,5,2014-01-10 19:15:04,2014-01-10 18:14:54
76d3021d194caf9004d73d1b5ce9013882b775e0...a20a3c76d541d40ffb75a8f02c8c0f7b05773e51,1,0,3,3,1,2014-01-14 21:36:27,2014-01-14 21:33:47
a20a3c76d541d40ffb75a8f02c8c0f7b05773e51...4e5f438e1ea0d7e39179ba5cf799a8d326ba7cc3,2,5,1,6,4,2014-01-15 20:14:06,2014-01-15 13:44:30
4e5f438e1ea0d7e39179ba5cf799a8d326ba7cc3...f5d58728e19102cbd2be07a4436e4a67e01c6722,1,0,0,0,0,2014-01-27 20:36:58,2014-01-27 15:15:39
f5d58728e19102cbd2be07a4436e4a67e01c6722...3c216951d4323a49d8cc0b8eb9e271cea5caf7e5,1,177,160,337,54,2014-01-28 22:40:30,2014-01-28 22:40:30
3c216951d4323a49d8cc0b8eb9e271cea5caf7e5...185b730edd7b18f1cdc69bd98f5e41cff48a5c01,1,2,2,4,2,2014-01-29 20:44:48,2014-01-29 20:44:48
185b730edd7b18f1cdc69bd98f5e41cff48a5c01...e70ee31d2b56f9cc501a1f9ffae90da48b399e8d,4,7,8,15,4,2014-01-29 20:50:49,2014-01-29 20:49:02
e70ee31d2b56f9cc501a1f9ffae90da48b399e8d...cacfa080502fb5b3a4ae3feb16d1490ec0354fd6,1,24,0,24,1,2014-02-01 10:16:39,2014-01-30 17:33:23
cacfa080502fb5b3a4ae3feb16d1490ec0354fd6...ab0a9ea391d6cdfd7cbc12a863b500ebb22729d8,1,64,64,128,40,2014-02-01 10:33:26,2014-02-01 10:26:33
ab0a9ea391d6cdfd7cbc12a863b500ebb22729d8...f73bb1f614d44967db61733b36f2e6244f589d15,2,115,101,216,50,2014-02-03 09:16:28,2014-02-03 09:16:28
f73bb1f614d44967db61733b36f2e6244f589d15...80530d6b4639980f3ab0858123edbd730745fcde,3,12,0,12,1,2014-02-18 22:12:39,2014-02-18 15:38:05
80530d6b4639980f3ab0858123edbd730745fcde...4d7ba31ada97d4f7bc50af6a1f7000dd0a8dc3de,1,3,3,6,3,2014-02-23 11:46:07,2014-02-23 10:51:41
4d7ba31ada97d4f7bc50af6a1f7000dd0a8dc3de...106bb43c37b8c5fe9daae9a1951186fdfa39c5b5,1,1,1,2,1,2014-02-23 11:49:57,2014-02-23 11:48:20
106bb43c37b8c5fe9daae9a1951186fdfa39c5b5...f639653d3dfb4143c1b7abffa2e6aff943de4e6c,1,14,5,19,1,2014-02-25 07:48:00,2014-02-24 21:47:05
f639653d3dfb4143c1b7abffa2e6aff943de4e6c...dea7690774e3948c954430b9f76646c915349f01,1,3,1,4,2,2014-02-25 20:13:17,2014-02-25 20:13:17
dea7690774e3948c954430b9f76646c915349f01...7997c1b9a1ecaddf28f448dae28b56e051e7c8a4,3,53,55,108,21,2014-03-02 07:41:57,2014-03-01 22:43:24
7997c1b9a1ecaddf28f448dae28b56e051e7c8a4...ee0de7541fe6718b8f086d273a88c11997f90c5f,1,1,1,2,1,2014-03-13 17:55:17,2014-03-13 16:55:50
ee0de7541fe6718b8f086d273a88c11997f90c5f...06b4df40e29f01382e60045c90a2907f9cdbf99b,2,29,27,56,25,2014-03-28 06:22:55,2014-03-28 06:21:03
06b4df40e29f01382e60045c90a2907f9cdbf99b...e67e9cc7c1b5a395521a6ee43031becc321e605a,3,4,2,6,3,2014-04-02 09:32:49,2014-04-02 06:42:10
e67e9cc7c1b5a395521a6ee43031becc321e605a...861c359e40eeeba2cf978bebf47b5c1c54c903ce,2,11,9,20,7,2014-04-10 08:05:21,2014-04-10 08:04:37
861c359e40eeeba2cf978bebf47b5c1c54c903ce...d01c26fd13c13c0572a1b111c7e6e86fd55ac468,1,3,3,6,3,2014-04-25 11:46:32,2014-04-25 11:46:32
d01c26fd13c13c0572a1b111c7e6e86fd55ac468...dcc5958a39264a52231c97c319943df8aab2d955,2,0,0,0,0,2014-04-27 08:53:31,2014-04-27 08:08:51
dcc5958a39264a52231c97c319943df8aab2d955...41b9f1a36a746bccb996615cca2dc431bc637a77,4,6,6,12,5,2014-04-29 21:23:01,2014-04-29 21:22:48
41b9f1a36a746bccb996615cca2dc431bc637a77...e12fc689a54f497f0368547bdcc967a1635fb5bb,1,1,1,2,1,2014-04-30 22:16:07,2014-04-30 22:16:07
e12fc689a54f497f0368547bdcc967a1635fb5bb...2e8a977d2c8c7c4bd704f076591d195b7cd521fa,1,5,4,9,3,2014-05-01 09:48:36,2014-04-30 22:22:52
2e8a977d2c8c7c4bd704f076591d195b7cd521fa...f067d5eec55bc643763a9396691e1dc4602941ad,1,0,0,0,0,2014-05-03 14:16:29,2014-05-03 14:07:24
f067d5eec55bc643763a9396691e1dc4602941ad...2d443d853fb61cdae27211adc440c149c191fc90,1,0,1,1,1,2014-05-03 16:18:14,2014-05-03 15:57:25
2d443d853fb61cdae27211adc440c149c191fc90...11262ec7429a67320638dd741388f5eccb76b97c,1,2,3,5,2,2014-05-09 17:07:09,2014-05-09 16:57:36
11262ec7429a67320638dd741388f5eccb76b97c...c0ea65101a59fad6e27cb6229208f6ee89c7f4a0,4,7,7,14,5,2014-05-13 05:26:05,2014-05-02 08:37:22
c0ea65101a59fad6e27cb6229208f6ee89c7f4a0...d916a720253d171a9b54818f2a07d14acbd2e4c7,2,3,1,4,2,2014-05-13 19:51:29,2014-05-13 19:50:00
d916a720253d171a9b54818f2a07d14acbd2e4c7...261f8dd39873e76ffbb57c2e2d46cb9dea351568,2,142,84,226,55,2014-06-06 21:33:09,2014-06-03 20:49:41
261f8dd39873e76ffbb57c2e2d46cb9dea351568...a82c61fb3e933b9a4ba22d5929f5cdfc3becc4a5,1,7,0,7,1,2014-06-12 22:17:30,2014-06-12 21:56:07
a82c61fb3e933b9a4ba22d5929f5cdfc3becc4a5...8c4b71e6c601550680d45f7d719cd9c1f6b0fe4d,2,35,16,51,16,2014-06-14 11:00:37,2014-06-14 11:00:37
8c4b71e6c601550680d45f7d719cd9c1f6b0fe4d...5e0b0d642b6d5f633714a2929a5a35d26330bfd3,3,8,8,16,6,2014-06-21 00:18:30,2014-06-21 00:18:30
5e0b0d642b6d5f633714a2929a5a35d26330bfd3...d2b86f78a41b86ff561f069934ffc83156ee0476,1,2,2,4,1,2014-06-24 18:02:44,2014-06-24 15:31:03
d2b86f78a41b86ff561f069934ffc83156ee0476...3220cf1d638ab7243236324de7a41667449cfec0,3,24,19,43,4,2014-06-24 20:52:35,2014-06-24 18:15:35
3220cf1d638ab7243236324de7a41667449cfec0...296b0bbf256f6420390ec9340847f85b50754d64,1,53,30,83,9,2014-06-24 21:08:04,2014-06-24 20:53:44
296b0bbf256f6420390ec9340847f85b50754d64...0efb9fb4df2b1cba354967d335272e3888850e5f,2,18,18,36,8,2014-06-27 21:52:55,2014-06-27 21:52:55
0efb9fb4df2b1cba354967d335272e3888850e5f...0443e508926f58935de99e0c6fc47d3e90765d6a,1,115,83,198,20,2014-06-30 21:18:55,2014-06-30 21:16:58
0443e508926f58935de99e0c6fc47d3e90765d6a...1c5be4d307f25c4b2800a8de675df1742ba6b1f3,2,38,33,71,15,2014-07-03 17:29:57,2014-07-03 17:29:57
1c5be4d307f25c4b2800a8de675df1742ba6b1f3...89354530141bbb7f3158bfc75a647e5cf40d247f,1,10,5,15,2,2014-07-05 14:48:11,2014-07-05 14:07:15
89354530141bbb7f3158bfc75a647e5cf40d247f...ff27f8c56398d15631437699e8b5eaddcad0f358,1,47,0,47,2,2014-07-10 10:15:57,2014-07-10 09:59:09
ff27f8c56398d15631437699e8b5eaddcad0f358...5027eeaab2c1873de8ff48d5c87411be6f26779a,2,7,1,8,2,2014-07-11 15:00:34,2014-07-10 10:33:56
5027eeaab2c1873de8ff48d5c87411be6f26779a...8daaa560231ef85e0b5ec8589b84332cbc8c5a20,2,3,1,4,2,2014-07-11 19:39:37,2014-07-11 19:16:21
8daaa560231ef85e0b5ec8589b84332cbc8c5a20...4fca586fae58bd4ee0d5f74fbd1705f419ce4f6d,3,5,3,8,4,2014-07-17 12:20:12,2014-07-16 19:21:52
4fca586fae58bd4ee0d5f74fbd1705f419ce4f6d...973b8453ded68af1d9c833d4ad4312e6c63ccbeb,1,35,16,51,7,2014-07-19 00:35:08,2014-07-18 23:51:26
973b8453ded68af1d9c833d4ad4312e6c63ccbeb...a99d8563ddc12cbf941057ee1b8b614fe2c9378c,3,43,2,45,5,2014-07-21 20:08:02,2014-07-18 20:47:32
a99d8563ddc12cbf941057ee1b8b614fe2c9378c...3c3c5e64604209a4d63e1e4c48dd245d45fadfd9,1,0,7,7,1,2014-07-22 22:55:04,2014-07-22 22:33:10
3c3c5e64604209a4d63e1e4c48dd245d45fadfd9...c3d967ab25534507f98bb1b15ac8a70614ac421b,1,2,2,4,1,2014-07-27 09:41:58,2014-07-27 08:33:45
c3d967ab25534507f98bb1b15ac8a70614ac421b...ef486012625dde5d1d986e8f67ab478bb3cf166a,2,18,8,26,9,2014-07-28 01:28:43,2014-07-28 01:28:43
ef486012625dde5d1d986e8f67ab478bb3cf166a...8ef199adf6ad33bc54dd6a4f6082a111c3449374,1,3,0,3,1,2014-07-29 11:34:37,2014-07-29 11:23:13
8ef199adf6ad33bc54dd6a4f6082a111c3449374...c3a72ff882104a1abc6ed05f5ca3eabb11c08a51,2,14,11,25,10,2014-07-31 18:28:49,2014-07-31 18:00:07
c3a72ff882104a1abc6ed05f5ca3eabb11c08a51...da7bf0d530d20e2abf6e53042221084e949dbf71,1,1,1,2,1,2014-08-02 10:03:29,2014-08-02 09:53:11
da7bf0d530d20e2abf6e53042221084e949dbf71...9318c6321a8b85b41f83ae67a6b23c5cd59921a4,37,445,1194,1639,18,2014-08-04 16:02:30,2014-08-02 20:45:00
9318c6321a8b85b41f83ae67a6b23c5cd59921a4...2bf27eb108a6396f065c4c832a855c6bcf3c2ae3,29,3047,0,3047,23,2014-08-04 16:02:40,2014-08-04 13:09:57
2bf27eb108a6396f065c4c832a855c6bcf3c2ae3...c73ae71db41b3ea924f7d6d37a71c6f9fbe86fc7,1,3,0,3,1,2014-08-04 16:02:40,2014-08-04 13:25:56
c73ae71db41b3ea924f7d6d37a71c6f9fbe86fc7...4b779d3ed9cb4117abc216815dcc582ee0b201bb,1,3,3,6,2,2014-08-04 16:29:59,2014-08-04 16:29:59
4b779d3ed9cb4117abc216815dcc582ee0b201bb...3928548dc41db5f877c5460ddd6906801ecd6f02,2,5,8,13,5,2014-08-05 12:44:42,2014-08-05 12:37:00
3928548dc41db5f877c5460ddd6906801ecd6f02...641586aaca7a6050a799af292530e822753e06aa,1,6,4,10,1,2014-08-05 13:27:36,2014-08-05 13:16:58
641586aaca7a6050a799af292530e822753e06aa...954eef1b1eb641eaec3f6c31e71dfd2101f73278,1,2,2,4,2,2014-08-05 22:40:11,2014-08-05 22:23:55
954eef1b1eb641eaec3f6c31e71dfd2101f73278...287f12229e1841a280e5176588f66ae433761fd0,4,6,6,12,7,2014-08-15 06:14:23,2014-08-15 05:53:44
287f12229e1841a280e5176588f66ae433761fd0...268611e33aeb094ed17fd834e1a338d50d5f28a2,2,2,2,4,2,2014-08-18 11:29:09,2014-08-18 11:29:09
268611e33aeb094ed17fd834e1a338d50d5f28a2...fccfbbbbdc7b6f961a93b4f831edc0d386e3042d,2,5,1,6,2,2014-08-27 13:24:45,2014-08-26 21:52:42
fccfbbbbdc7b6f961a93b4f831edc0d386e3042d...77d43a3d5d5f92514fe46b518797dde9204ee3af,1,1,1,2,1,2014-08-27 15:13:06,2014-08-27 15:09:42
77d43a3d5d5f92514fe46b518797dde9204ee3af...927df9df01956ac93660cd2e889f95465e51361c,1,1,1,2,1,2014-08-28 05:35:10,2014-08-27 21:14:51
927df9df01956ac93660cd2e889f95465e51361c...9c037544901810a8361d431e6b4ac7a2b3c73fbc,1,4,0,4,2,2014-08-30 17:30:23,2014-08-30 17:20:40
9c037544901810a8361d431e6b4ac7a2b3c73fbc...2a09bdf3e39fea832b95303afb39aea8988522bc,2,4,2,6,2,2014-08-30 17:30:29,2014-08-30 17:26:44
2a09bdf3e39fea832b95303afb39aea8988522bc...176aa951d5ad354579bb7cca4ccbc30d9b1c5a33,1,1,1,2,1,2014-09-01 11:12:23,2014-09-01 10:50:19
176aa951d5ad354579bb7cca4ccbc30d9b1c5a33...a44c533d55624e69065f6173d67ff91e9027949c,2,2,2,4,2,2014-09-01 20:42:25,2014-09-01 20:39:17
a44c533d55624e69065f6173d67ff91e9027949c...93c3ec448067613012a079b7f090388430fc053f,2,48,15,63,8,2014-09-10 12:04:40,2014-09-10 11:54:44
93c3ec448067613012a079b7f090388430fc053f...a3baca2367fab2de95894013981ab1ff5713c1ff,3,80,1,81,3,2014-09-10 19:59:48,2014-09-10 10:45:01
a3baca2367fab2de95894013981ab1ff5713c1ff...029093fdc44f5e99adf81de5c820414f7b23d4bb,2,48,15,63,8,2014-09-10 20:02:20,2014-09-10 20:02:20
029093fdc44f5e99adf81de5c820414f7b23d4bb...77684b163862f2a406406c202afc3905dc916437,2,8,0,8,2,2014-09-11 09:37:22,2014-09-11 07:46:56
77684b163862f2a406406c202afc3905dc916437...d352b37ac1ffbfd6a37b5742da47aeb966a8bbf8,1,1,1,2,1,2014-09-11 17:57:03,2014-09-11 17:47:44
d352b37ac1ffbfd6a37b5742da47aeb966a8bbf8...e830ce22b53c6aa430ca9e2a23a2992a742c3d04,1,1,1,2,1,2014-09-11 17:59:04,2014-09-11 17:59:04
e830ce22b53c6aa430ca9e2a23a2992a742c3d04...59911a536d4efe67a383f233a8e10bb5ce1b8809,3,42,13,55,17,2014-09-13 11:06:40,2014-09-13 11:04:27
59911a536d4efe67a383f233a8e10bb5ce1b8809...75d6ea62a03152db582ed19c07a78144a25783bd,1,1,1,2,1,2014-09-14 07:33:52,2014-09-14 07:16:00
75d6ea62a03152db582ed19c07a78144a25783bd...6cd8083b1598d8df3eabadfe805a3965c4d5aca7,1,1,1,2,1,2014-09-14 07:35:01,2014-09-14 07:35:01
6cd8083b1598d8df3eabadfe805a3965c4d5aca7...c35f8d3c2ecd442a5afc73c6881fcde505a3b5a9,1,1,0,1,1,2014-09-17 18:45:42,2014-09-17 18:45:42
c35f8d3c2ecd442a5afc73c6881fcde505a3b5a9...ed6ba6d8ba1afdc874034a79eeff22f37bdb68c2,2,5,5,10,5,2014-09-18 20:35:25,2014-09-18 20:26:03
ed6ba6d8ba1afdc874034a79eeff22f37bdb68c2...a8fabc504b147e526d9b18dfff79545c5b933645,2,5,5,10,5,2014-09-18 20:37:29,2014-09-18 20:37:29
a8fabc504b147e526d9b18dfff79545c5b933645...3e3b770b0d9ed9914a53c0c364b61ab3eedc70b9,2,52,0,52,4,2014-09-19 14:56:24,2014-09-17 19:52:10
3e3b770b0d9ed9914a53c0c364b61ab3eedc70b9...f134545b959d1aacd9d448e930185b76f5bb07e1,2,6,2,8,2,2014-09-19 14:56:57,2014-09-19 14:45:45
f134545b959d1aacd9d448e930185b76f5bb07e1...215bebe5e5ab5f83a8e3561e36107af60ad946bb,3,2,3,5,3,2014-09-20 14:51:12,2014-09-20 14:26:29
215bebe5e5ab5f83a8e3561e36107af60ad946bb...712568f229fd8b25bbd8a76f2908bad1fea3fc62,4,0,0,0,0,2014-09-22 17:09:01,2014-09-22 17:00:27
712568f229fd8b25bbd8a76f2908bad1fea3fc62...1c4fcf32142e888946db579df0efbb52542e0ed1,5,37,14,51,3,2014-09-25 08:29:05,2014-09-21 19:55:00
1c4fcf32142e888946db579df0efbb52542e0ed1...32c0b2b16034c66e6a72c6eeeded36ed7aa20081,14,82,84,166,74,2014-09-28 11:34:17,2014-09-28 11:17:34
32c0b2b16034c66e6a72c6eeeded36ed7aa20081...66d5b120d6f95fb732c5eea8faf43ac0c66af1f0,1,10,10,20,4,2014-09-28 20:34:19,2014-09-28 20:33:31
66d5b120d6f95fb732c5eea8faf43ac0c66af1f0...d3e9cbfcec2d90bdc7e269fc654b796020f0e1d2,1,2,2,4,2,2014-10-05 13:54:13,2014-10-05 13:54:13
d3e9cbfcec2d90bdc7e269fc654b796020f0e1d2...7aa92ea5f6c76be670836168ecc8c348192b9072,3,8,6,14,7,2014-10-05 14:03:42,2014-10-04 20:20:18
7aa92ea5f6c76be670836168ecc8c348192b9072...c9a5fb4d700a944c7e681a698c236e805397e091,2,2,2,4,2,2014-10-06 07:52:26,2014-10-06 07:43:26
c9a5fb4d700a944c7e681a698c236e805397e091...d5e062531240b74d0a273ad274850c9322ebd6e5,7,10,8,18,9,2014-10-06 09:15:16,2014-09-29 21:38:03
d5e062531240b74d0a273ad274850c9322ebd6e5...f8ee8fec3fa6ced7548a1e23fe1ab9bd302834de,2,2,2,4,2,2014-10-06 16:01:40,2014-10-06 15:49:16
f8ee8fec3fa6ced7548a1e23fe1ab9bd302834de...1cac1c9ecc1d3a2ebb4c6b107545ad6ec51d938e,2,76,38,114,10,2014-10-10 11:06:59,2014-10-10 11:06:15
1cac1c9ecc1d3a2ebb4c6b107545ad6ec51d938e...f3ecc0c67f335dacb3c304041a1a4557a940db5b,3,4,0,4,3,2014-10-11 15:04:31,2014-10-11 15:04:00
f3ecc0c67f335dacb3c304041a1a4557a940db5b...3d4c3da5d91923bd6f8a9693a420f7cf4892e506,2,1,2,3,2,2014-10-12 08:27:31,2014-10-11 15:15:35
3d4c3da5d91923bd6f8a9693a420f7cf4892e506...c2abc3f6e042d7fc4ac5498240bc129d18f658b3,1,1,1,2,1,2014-10-12 08:29:14,2014-10-12 08:24:13
c2abc3f6e042d7fc4ac5498240bc129d18f658b3...4b07bb3f8b0a077cd908923c4154b7ec0967f352,1,1,1,2,1,2014-10-12 08:30:11,2014-10-12 08:30:11
4b07bb3f8b0a077cd908923c4154b7ec0967f352...80ee26d734d7acbb24a52a49a8ec7525094367a7,3,0,0,0,0,2014-10-13 08:26:11,2014-10-12 20:15:03
80ee26d734d7acbb24a52a49a8ec7525094367a7...2b69bde02496a66d5f6c6502b2ca1c066748773c,1,12,12,24,10,2014-10-13 08:26:11,2014-10-12 20:27:47
2b69bde02496a66d5f6c6502b2ca1c066748773c...9d127a2c82f03145078bc19574bede8b6018b370,1,1,0,1,1,2014-10-13 08:26:33,2014-10-12 21:38:36
9d127a2c82f03145078bc19574bede8b6018b370...c9ac4325bbd9eccf6b51b4f5d92f79d778bab54d,3,0,0,0,0,2014-10-13 08:30:54,2014-10-13 08:30:54
c9ac4325bbd9eccf6b51b4f5d92f79d778bab54d...768a15235f572339c409996cb12dd52130de8d80,2,3,2,5,3,2014-10-13 09:57:55,2014-10-13 09:22:30
768a15235f572339c409996cb12dd52130de8d80...f3a94f5f6ece93b752209630f722f52fec881cca,1,7,4,11,1,2014-10-14 19:18:59,2014-10-14 19:18:59
f3a94f5f6ece93b752209630f722f52fec881cca...f2d91821557223bdbcfa93a767569bb5b319ed5a,3,74,5,79,5,2014-10-14 20:48:09,2014-10-12 21:39:27
f2d91821557223bdbcfa93a767569bb5b319ed5a...c3d52666d0d297e50f965af4ad214702a683e02f,1,1,7,8,6,2014-10-14 20:48:19,2014-10-13 08:43:09
c3d52666d0d297e50f965af4ad214702a683e02f...695e8d9f82bf34b64f7cc1ffcd47a1633a42da57,3,377,312,689,121,2014-10-15 12:43:43,2014-10-15 12:43:43
695e8d9f82bf34b64f7cc1ffcd47a1633a42da57...697fa65431bcafae222f13f574e27b1f21f81286,2,46,20,66,18,2014-10-15 13:00:52,2014-10-15 12:47:01
697fa65431bcafae222f13f574e27b1f21f81286...6f50688c1c16871a7055f5da0730bd43f9306b8a,3,20,1,21,5,2014-10-15 18:55:01,2014-10-15 12:50:01
6f50688c1c16871a7055f5da0730bd43f9306b8a...ad27d2e6b2ddea51038bbf75579e53b34271b504,3,4,3,7,4,2014-10-20 13:57:18,2014-10-20 13:57:18
ad27d2e6b2ddea51038bbf75579e53b34271b504...d7976c3f75a88c054dd75af88e78d7ba55e08119,3,180,153,333,108,2014-10-20 14:33:02,2014-10-20 14:33:02
d7976c3f75a88c054dd75af88e78d7ba55e08119...345925f04384b59929d8d39ba428cef548921408,10,30,43,73,16,2014-10-21 21:02:26,2014-10-21 21:01:13
345925f04384b59929d8d39ba428cef548921408...918c88e372b25c2de3811bfe5da0730a9f16b0a1,1,4,4,8,2,2014-10-23 11:01:08,2014-10-23 11:01:08
918c88e372b25c2de3811bfe5da0730a9f16b0a1...61015dbbea270c71490a6ea92484bcde8e5c6ec0,3,45,8,53,25,2014-10-26 22:47:30,2014-10-26 22:47:30
61015dbbea270c71490a6ea92484bcde8e5c6ec0...3c2aac800170996e900203aba33f81bdc2679597,4,111,89,200,24,2014-10-28 11:35:42,2014-10-28 11:24:51
3c2aac800170996e900203aba33f81bdc2679597...d2740f3c6b2330a3f926f29933b88eb2ecae3d04,2,2,71,73,2,2014-10-28 17:16:24,2014-10-28 17:12:47
d2740f3c6b2330a3f926f29933b88eb2ecae3d04...eba30f07ac8ac3533423cb50439841c81b6ce2dd,1,13,0,13,3,2014-11-02 18:09:54,2014-11-02 17:45:44
eba30f07ac8ac3533423cb50439841c81b6ce2dd...f1503cb6c3b814e570c778ec3af041226b26ac6e,1,5,5,10,3,2014-11-07 17:15:21,2014-11-07 17:15:21
f1503cb6c3b814e570c778ec3af041226b26ac6e...8d901e6fb8e005f9a1a8b52d2bc08fabd3e8d735,1,43,2,45,2,2014-11-07 17:36:13,2014-11-07 17:15:35
8d901e6fb8e005f9a1a8b52d2bc08fabd3e8d735...98fc61b9d1dae857ee4198535e9b23814cfdebca,1,2,2,4,1,2014-11-07 20:28:25,2014-11-07 19:50:24
98fc61b9d1dae857ee4198535e9b23814cfdebca...f6efcf0783e98d889d7af0d4cd9dc103fd92b580,1,1,1,2,1,2014-11-08 01:54:24,2014-11-08 01:51:03
f6efcf0783e98d889d7af0d4cd9dc103fd92b580...1d0d78509dfb31ea5236a2b6430529ccfd799763,2,6,14,20,2,2014-11-09 18:19:23,2014-11-09 15:23:18
1d0d78509dfb31ea5236a2b6430529ccfd799763...45a3adcb2e5fc7b289981b68f5959fffeeaba73b,2,52,0,52,2,2014-11-20 22:15:17,2014-11-17 18:26:03
45a3adcb2e5fc7b289981b68f5959fffeeaba73b...1318b71cdfe3ec4635282c92238628b7e7e3a21d,2,22,42,64,16,2014-11-20 22:35:45,2014-11-20 22:34:17
1318b71cdfe3ec4635282c92238628b7e7e3a21d...078a37ae38fd6d14f704c964a06a03bc7e48b201,2,8,6,14,4,2014-11-20 22:43:31,2014-11-20 22:39:33
078a37ae38fd6d14f704c964a06a03bc7e48b201...91dc92416318d1c98c06afe148040d909790f177,1,1,1,2,1,2014-11-21 08:50:58,2014-11-21 02:13:05
91dc92416318d1c98c06afe148040d909790f177...7275f79fbc03cef7612e2a49f9a33fea9e3a3723,4,14,8,22,4,2014-11-21 09:05:39,2014-11-21 02:07:28
7275f79fbc03cef7612e2a49f9a33fea9e3a3723...be023b8e2dfa64564354375c85c054e8b44bfe2f,1,3,4,7,3,2014-11-21 17:53:21,2014-11-21 17:49:17
be023b8e2dfa64564354375c85c054e8b44bfe2f...10f58216b0a569d96d10a9231443ba32258089fe,1,2,2,4,2,2014-11-29 14:18:32,2014-11-29 14:18:32
10f58216b0a569d96d10a9231443ba32258089fe...598ac2012870138c0172bed4a58692bbda8ddd8a,1,3,2,5,1,2014-11-29 21:52:07,2014-11-29 21:52:07
598ac2012870138c0172bed4a58692bbda8ddd8a...45798ee7f85f662bea21c21b9fc981103e553d9a,1,2,2,4,2,2014-11-30 17:59:27,2014-11-30 17:44:15
45798ee7f85f662bea21c21b9fc981103e553d9a...0dab79623123fdf31a2448a4a71ce3b64f713656,1,2,1,3,2,2014-12-08 15:33:58,2014-12-08 15:33:58
0dab79623123fdf31a2448a4a71ce3b64f713656...c97c23c06e7a5e90e692a1548fd0f0dd94e44190,1,2,2,4,2,2014-12-08 15:37:45,2014-12-08 15:37:45
c97c23c06e7a5e90e692a1548fd0f0dd94e44190...330b60c2120152e1ecacfbe37f3d4e73a4248c15,7,13,13,26,8,2014-12-21 18:12:45,2014-12-19 17:34:47
330b60c2120152e1ecacfbe37f3d4e73a4248c15...2fcde1ef33d96349dd28f1c4a9909c9aec999ed9,2,40,4,44,10,2014-12-21 21:54:27,2014-12-21 21:47:23
2fcde1ef33d96349dd28f1c4a9909c9aec999ed9...001a6c909a7deeba9e88a9fe632d9cb7e6085742,2,38,0,38,4,2014-12-22 14:02:33,2014-12-22 14:02:33
001a6c909a7deeba9e88a9fe632d9cb7e6085742...db639fd0ec54da3d9fc6407de5f7b7a0b7e8b1c8,2,2,2,4,2,2014-12-23 06:47:27,2014-12-23 05:50:27
db639fd0ec54da3d9fc6407de5f7b7a0b7e8b1c8...0d5c32fb8b9e6f6d0eecfa457672a271e6829103,1,2,6,8,3,2015-02-01 20:22:23,2015-02-01 20:22:23
0d5c32fb8b9e6f6d0eecfa457672a271e6829103...4af329eedb1efeebc48a89633146a1375acb2535,1,1,1,2,1,2015-02-01 20:25:31,2015-02-01 20:25:31
4af329eedb1efeebc48a89633146a1375acb2535...f61c062ff8bcbdb00e0a1b3317a91aed6ceee06b,1,2,6,8,3,2015-02-01 20:26:28,2015-02-01 20:26:28
f61c062ff8bcbdb00e0a1b3317a91aed6ceee06b...60a8ff033665e1207714d6670fcd7b65304ec02f,2,2,2,4,2,2015-02-01 20:56:31,2015-02-01 20:56:31
60a8ff033665e1207714d6670fcd7b65304ec02f...ad26878202861481a635dd2e44e4320cf43c685b,1,1,1,2,1,2015-02-07 09:42:42,2015-02-07 09:42:42
ad26878202861481a635dd2e44e4320cf43c685b...78c84ce70185ff0fc513957eb5f4270672b43a7e,2,34,0,34,2,2015-02-07 11:33:58,2014-12-04 11:28:26
78c84ce70185ff0fc513957eb5f4270672b43a7e...3be7fe5c01638c3390aa064fe5783bfa5613cb02,1,1,1,2,1,2015-02-07 11:41:05,2015-02-07 11:41:05
3be7fe5c01638c3390aa064fe5783bfa5613cb02...3575a69db6fc232d7098e345c39d6ed9e4a875f8,1,3,1,4,1,2015-02-08 19:31:24,2015-02-08 19:22:37
3575a69db6fc232d7098e345c39d6ed9e4a875f8...e7465be6380eac49554d7d783ce91f9a9170546b,1,41,23,64,3,2015-02-09 10:39:44,2015-02-09 10:39:44
e7465be6380eac49554d7d783ce91f9a9170546b...192d7fed3925934857021a2a5ce8143689c92690,2,2,2,4,2,2015-02-10 06:12:58,2015-02-10 05:55:18
192d7fed3925934857021a2a5ce8143689c92690...6443483dd2c49c97a4d184ea02783585e15f7237,1,2,2,4,2,2015-02-24 23:09:04,2015-02-24 22:41:10
6443483dd2c49c97a4d184ea02783585e15f7237...b4bbee54680eade0d081ecf5de8b53eb46e8776f,1,4,0,4,1,2015-03-02 09:05:19,2015-03-02 08:24:55
b4bbee54680eade0d081ecf5de8b53eb46e8776f...2a6bb8d219e2716b4c7ec0c333c74cc21b62e273,3,89,21,110,41,2015-03-02 21:45:20,2015-03-02 21:43:47
2a6bb8d219e2716b4c7ec0c333c74cc21b62e273...c0de8e873af6182f0d3461b149fd5d5b22aea7cd,3,4,5,9,5,2015-03-04 13:51:05,2015-03-04 13:46:53
c0de8e873af6182f0d3461b149fd5d5b22aea7cd...c8165a6da0958325b521bc3e94fd30cf6068c4ea,1,10,10,20,4,2015-03-04 20:18:38,2015-03-04 20:13:09
c8165a6da0958325b521bc3e94fd30cf6068c4ea...356e141ec9364155a5ed775dd99c5f042ce6ff75,3,5,2,7,3,2015-03-04 23:41:00,2015-02-09 19:39:26
356e141ec9364155a5ed775dd99c5f042ce6ff75...57639ee786ec33ae3cf49ff9f5eeb3551c29486c,4,24,20,44,16,2015-03-04 23:41:23,2015-03-04 22:51:35
57639ee786ec33ae3cf49ff9f5eeb3551c29486c...b07c91dad6a4d53cd44f95ff3160ee6f43a408d5,16,66,68,134,52,2015-03-04 23:41:23,2015-03-04 23:22:17
b07c91dad6a4d53cd44f95ff3160ee6f43a408d5...0a40054b7ed592b0d4cc2bf2be9bfed783734e61,5,7,7,14,7,2015-03-04 23:41:23,2015-03-04 23:34:22
0a40054b7ed592b0d4cc2bf2be9bfed783734e61...422537b96c61d1e37371becc97769d9df592b4ac,3,2,4,6,5,2015-03-06 16:02:03,2015-03-06 16:00:06
422537b96c61d1e37371becc97769d9df592b4ac...2431333b63fa18afc922d7412389ab822bbe1bda,1,1,1,2,1,2015-03-11 06:17:09,2015-03-09 19:33:11
2431333b63fa18afc922d7412389ab822bbe1bda...57342272e6c2c74894c4d2fa56344044f4350e90,7,34,1,35,7,2015-03-11 06:17:57,2015-03-11 06:17:57
57342272e6c2c74894c4d2fa56344044f4350e90...eee759bfe175e850bbc8e4ad0682ec4fe4bd05d6,3,3,2,5,3,2015-03-11 15:13:53,2015-03-11 12:29:16
eee759bfe175e850bbc8e4ad0682ec4fe4bd05d6...29af44ef9c5c4de0e7e493f19efc2564e5665a81,1,2,1,3,1,2015-03-11 15:14:58,2015-03-11 15:14:16
29af44ef9c5c4de0e7e493f19efc2564e5665a81...4f6a87f9853e8462e5ffb1c43a20bddc1bc6444a,1,16,4,20,2,2015-03-13 17:10:06,2015-03-13 16:26:57
4f6a87f9853e8462e5ffb1c43a20bddc1bc6444a...c7057bef0c432c245d678d5ea4cf16526619cafb,3,5,8,13,5,2015-03-13 20:42:27,2015-03-11 14:21:41
c7057bef0c432c245d678d5ea4cf16526619cafb...9581cf3a81ea396e73360ac3a99b8d453f9358e7,1,0,1,1,1,2015-03-13 20:46:00,2015-03-13 20:46:00
