id,files,locs added,locs removed,locs total,hunks,commit time,author time
4b825dc642cb6eb9a060e54bf8d69288fbee4904...8a4a1edf047f2c272f663866eb7b5fcd644d65b3,12,2074,0,2074,12,2006-03-22 03:33:07,2006-03-22 03:33:07
8a4a1edf047f2c272f663866eb7b5fcd644d65b3...70d3099041b3de973b4266be0caee72b962556dd,1,2,0,2,1,2006-03-22 03:36:03,2006-03-22 03:36:03
70d3099041b3de973b4266be0caee72b962556dd...20c9aafecfb762d8b258c410ba6c915684a8fb5b,6,0,832,832,6,2006-03-22 16:08:59,2006-03-22 16:08:59
20c9aafecfb762d8b258c410ba6c915684a8fb5b...12e2b5accb76053f22f5acb4e1c618749e2aab48,1,0,0,0,0,2006-03-22 16:15:42,2006-03-22 16:15:42
12e2b5accb76053f22f5acb4e1c618749e2aab48...6b6773fe39bfa9ebf8fbd06aeac056a571c29416,1,0,0,0,0,2006-03-22 16:16:06,2006-03-22 16:16:06
6b6773fe39bfa9ebf8fbd06aeac056a571c29416...aee5a0fe70baedc71ca3b6f87d80a88f794e6d31,1,5,2,7,3,2006-03-22 19:49:50,2006-03-22 19:49:50
aee5a0fe70baedc71ca3b6f87d80a88f794e6d31...37394df83756344ce35f9d2e47d7eee2bff17094,1,2,2,4,1,2006-03-22 19:52:26,2006-03-22 19:52:26
37394df83756344ce35f9d2e47d7eee2bff17094...193866de0aabe1a86d9cd2c4ff147f5dda626872,1,22,16,38,2,2006-03-22 21:01:00,2006-03-22 21:01:00
193866de0aabe1a86d9cd2c4ff147f5dda626872...130b8a1c030ae7888934fcd8dee6695eac271fcb,1,117,117,234,29,2006-03-23 20:55:47,2006-03-23 20:55:47
130b8a1c030ae7888934fcd8dee6695eac271fcb...f0034d64e3890553f214db0708b9a831476ea46a,4,217,211,428,35,2006-03-23 21:13:20,2006-03-23 21:13:20
f0034d64e3890553f214db0708b9a831476ea46a...c206df28db1d8e6ff7d276ea3d92cde35e0cc640,1,2,2,4,2,2006-03-23 22:29:02,2006-03-23 22:29:02
c206df28db1d8e6ff7d276ea3d92cde35e0cc640...b9e0b6ff37ab837ef2e031bac23c36ee3007cc46,1,37,4,41,2,2006-03-27 07:08:32,2006-03-27 07:08:32
b9e0b6ff37ab837ef2e031bac23c36ee3007cc46...11e82e95b6d8542902bfd4d0d1394bed0d676946,1,4,3,7,1,2006-03-27 07:09:28,2006-03-27 07:09:28
11e82e95b6d8542902bfd4d0d1394bed0d676946...a027d25f83606bf664176af56d7585ba405a034f,0,0,0,0,0,2006-03-27 07:19:23,2006-03-27 07:19:23
a027d25f83606bf664176af56d7585ba405a034f...648f08330b6f56db5ed555c01b5d37449d6a7337,1,71,0,71,1,2006-03-27 07:19:25,2006-03-27 07:19:25
648f08330b6f56db5ed555c01b5d37449d6a7337...e3828d1a483527ecf70944044134f09196011d66,1,3,3,6,3,2006-04-06 05:37:08,2006-04-06 05:37:08
e3828d1a483527ecf70944044134f09196011d66...fc26b57ace2f995cd4f99b014c8a5718815877e3,1,25,15,40,5,2006-04-08 06:28:40,2006-04-08 06:28:40
fc26b57ace2f995cd4f99b014c8a5718815877e3...56992c6ad95eb9323b325099dda828a5039def5b,1,6,4,10,3,2006-04-08 06:34:04,2006-04-08 06:34:04
56992c6ad95eb9323b325099dda828a5039def5b...4ab5a88bc4cd76c293190ed68a4962d91c108816,1,8,7,15,1,2006-04-09 04:03:36,2006-04-09 04:03:36
4ab5a88bc4cd76c293190ed68a4962d91c108816...40fdf0ad5c0dd13546a2a0925778605c5e7b1173,1,37,0,37,1,2006-04-09 04:04:52,2006-04-09 04:04:52
40fdf0ad5c0dd13546a2a0925778605c5e7b1173...904b1c337ed7b65eba0cf560a3aaaa400e1d3f74,1,2,2,4,2,2006-04-10 06:03:28,2006-04-10 06:03:28
904b1c337ed7b65eba0cf560a3aaaa400e1d3f74...cd297dd9ebb7559fc6f0d7ca43bc13dc07e36b9e,1,3,1,4,1,2006-04-10 06:09:16,2006-04-10 06:09:16
cd297dd9ebb7559fc6f0d7ca43bc13dc07e36b9e...0ababc8fea6a6003be1649cfc3817d6c5628f0c7,1,6,4,10,2,2006-04-22 06:24:10,2006-04-22 06:24:10
0ababc8fea6a6003be1649cfc3817d6c5628f0c7...facb2324f9b5db4f4e20f529cb12952daad20aff,1,1,3,4,1,2006-05-02 19:03:07,2006-05-02 19:03:07
facb2324f9b5db4f4e20f529cb12952daad20aff...4233896e9d9e19e544df6a010b134faaf018cf5a,1,1,0,1,1,2006-05-11 05:50:06,2006-05-11 05:50:06
4233896e9d9e19e544df6a010b134faaf018cf5a...5f62b671a3f16fc5e6147b48e5eb2ba05edfd758,1,2,2,4,2,2006-05-12 16:52:18,2006-05-12 16:52:18
5f62b671a3f16fc5e6147b48e5eb2ba05edfd758...6e4f0ce05e88fada8c1767cc2fe7c6a77f2d3602,1,87,19,106,8,2006-05-16 16:18:52,2006-05-16 16:18:52
6e4f0ce05e88fada8c1767cc2fe7c6a77f2d3602...329d1a3bb2abf5d64bd2fac5801034757619c950,1,0,16,16,1,2006-05-16 16:21:20,2006-05-16 16:21:20
329d1a3bb2abf5d64bd2fac5801034757619c950...d71a85001b0562ed05925e0c5635c3c0a1d52068,4,298,212,510,181,2006-05-16 22:15:05,2006-05-16 22:15:05
d71a85001b0562ed05925e0c5635c3c0a1d52068...2a6b0ee7c846d5bdd535dcc9a399d528f65460ac,1,2,2,4,2,2006-05-16 22:32:15,2006-05-16 22:32:15
2a6b0ee7c846d5bdd535dcc9a399d528f65460ac...4986837802a65ced713c2dac2ff7d80e42fd7807,4,88,77,165,47,2006-05-17 02:42:03,2006-05-17 02:42:03
4986837802a65ced713c2dac2ff7d80e42fd7807...956529c7beddf7fed3f9d92aec10ecaa3289ad1b,2,5,2,7,3,2006-05-17 03:55:50,2006-05-17 03:55:50
956529c7beddf7fed3f9d92aec10ecaa3289ad1b...f1c8b3ffc0d8dfd9dd2cb28c1e569d66d116cc9a,1,28,10,38,4,2006-05-17 16:01:19,2006-05-17 16:01:19
f1c8b3ffc0d8dfd9dd2cb28c1e569d66d116cc9a...3386923dccbb9f0e7a9518109d54bcbd0f8f863d,1,16,24,40,5,2006-05-17 18:04:46,2006-05-17 18:04:46
3386923dccbb9f0e7a9518109d54bcbd0f8f863d...c75701a0152a589c21c4862c33b691902a8b8f7b,1,1,1,2,1,2006-05-17 18:46:51,2006-05-17 18:46:51
c75701a0152a589c21c4862c33b691902a8b8f7b...81fda970ff9d5c820995aa0ea3f873b8c801f47b,1,5,2,7,3,2006-05-17 18:48:23,2006-05-17 18:48:23
81fda970ff9d5c820995aa0ea3f873b8c801f47b...d8bad24d34b1d11893555ce35707cd2716d49adc,1,21,27,48,13,2006-05-20 09:46:41,2006-05-20 09:46:41
d8bad24d34b1d11893555ce35707cd2716d49adc...497bfb7909ada30e3410827808bc0c1a0d9843a7,2,16,7,23,7,2006-05-27 10:18:18,2006-05-27 10:18:18
497bfb7909ada30e3410827808bc0c1a0d9843a7...d7856eb24b703d69aa616c0fb5972097e328712f,1,79,33,112,9,2006-05-31 11:14:21,2006-05-31 11:14:21
d7856eb24b703d69aa616c0fb5972097e328712f...5ee555c9f0097a193e9eec2d10f7633ec392f442,1,12,6,18,4,2006-05-31 16:29:43,2006-05-31 16:29:43
5ee555c9f0097a193e9eec2d10f7633ec392f442...4a36d0046628ddc2a252b2896e0a32860f04896a,1,18,9,27,4,2006-06-01 16:40:37,2006-06-01 16:40:37
4a36d0046628ddc2a252b2896e0a32860f04896a...330867ac2fa9c54d9f1869931e5bd87a6c0c872b,1,16,13,29,7,2006-06-02 14:27:25,2006-06-02 14:27:25
330867ac2fa9c54d9f1869931e5bd87a6c0c872b...65b1081e9e9f9b8c4a0f1621c98e823eac3e6bcf,1,1,1,2,1,2006-06-03 12:48:19,2006-06-03 12:48:19
65b1081e9e9f9b8c4a0f1621c98e823eac3e6bcf...b52b19ac4a87f5c824b08be53ffbacc4b520711b,1,2,2,4,2,2006-06-03 13:49:25,2006-06-03 13:49:25
b52b19ac4a87f5c824b08be53ffbacc4b520711b...6e69be66878c6fe384cbf42345337d19554ffbb6,2,10,10,20,10,2006-06-05 16:19:03,2006-06-05 16:19:03
6e69be66878c6fe384cbf42345337d19554ffbb6...69ae9aeab0bae23f0fb6673d5ad58ffce44c7841,1,1,1,2,1,2006-06-06 12:51:44,2006-06-06 12:51:44
69ae9aeab0bae23f0fb6673d5ad58ffce44c7841...66565227051d2e1a066268fe1a7416b3d304e602,2,197,105,302,19,2006-06-08 17:31:57,2006-06-08 17:31:57
66565227051d2e1a066268fe1a7416b3d304e602...50cdc997b81dcc1994a5f04e44dabf01fd6198de,1,3,20,23,4,2006-06-09 14:49:09,2006-06-09 14:49:09
50cdc997b81dcc1994a5f04e44dabf01fd6198de...66f124a65898ea18f78709ce4be25afedb67bcc1,1,5,0,5,1,2006-06-09 15:31:09,2006-06-09 15:31:09
66f124a65898ea18f78709ce4be25afedb67bcc1...6596108635d88116be67f6d22183588822e41c44,2,4,6,10,5,2006-06-09 15:36:06,2006-06-09 15:36:06
6596108635d88116be67f6d22183588822e41c44...79bc371da6bf36f78b9e99ab0b5a15b64167190e,1,1,0,1,1,2006-06-10 19:04:08,2006-06-10 19:04:08
79bc371da6bf36f78b9e99ab0b5a15b64167190e...b788be7cb9741b1a287ddd785a74bab267dc959b,1,0,1,1,1,2006-06-10 19:05:14,2006-06-10 19:05:14
b788be7cb9741b1a287ddd785a74bab267dc959b...a457262ef5bcb163417a1f6db0b770f1fc21b3a4,1,1,1,2,1,2006-06-11 01:16:36,2006-06-11 01:16:36
a457262ef5bcb163417a1f6db0b770f1fc21b3a4...b5256caee647eb3b8f49115d7803506b031d058f,1,29,19,48,11,2006-06-11 18:12:46,2006-06-11 18:12:46
b5256caee647eb3b8f49115d7803506b031d058f...4b6bcb235fc4ae30692d27910dffbf79295e36f4,1,2,1,3,2,2006-06-11 18:27:31,2006-06-11 18:27:31
4b6bcb235fc4ae30692d27910dffbf79295e36f4...08bb08fede9392f8c7047e88d6989e0b8583b31e,1,54,15,69,9,2006-06-11 18:59:45,2006-06-11 18:59:45
08bb08fede9392f8c7047e88d6989e0b8583b31e...5139bfbec88da7fef7afcd5c02799fe97e29ec03,1,2,0,2,1,2006-06-11 21:24:14,2006-06-11 21:24:14
5139bfbec88da7fef7afcd5c02799fe97e29ec03...83c75321619f9968e4373a13aced5f83d4228962,1,8,0,8,2,2006-06-13 02:20:15,2006-06-13 02:20:15
83c75321619f9968e4373a13aced5f83d4228962...582075e965a7df985aede0e088928c486fe9ce06,1,3,2,5,2,2006-06-13 04:09:56,2006-06-13 04:09:56
582075e965a7df985aede0e088928c486fe9ce06...55370e571081930d99128e71bae4fdb5f025b558,1,26,39,65,8,2006-06-13 04:12:06,2006-06-13 04:12:06
55370e571081930d99128e71bae4fdb5f025b558...25f5af1bcb7581e5e8462201781665e8ec637972,1,1,1,2,1,2006-06-14 17:31:09,2006-06-14 17:31:09
25f5af1bcb7581e5e8462201781665e8ec637972...ba7ebaf70be4cc91d0b4114f35e4afdf11151ae1,1,23,16,39,11,2006-06-14 20:05:06,2006-06-14 20:05:06
ba7ebaf70be4cc91d0b4114f35e4afdf11151ae1...dea19250497716bbd6f9128eacaa785a620aafde,2,29,19,48,3,2006-06-15 02:27:18,2006-06-15 02:27:18
dea19250497716bbd6f9128eacaa785a620aafde...807c75dadf647a5f07b661ff62c102cd3797479a,1,103,43,146,13,2006-06-15 03:11:35,2006-06-15 03:11:35
807c75dadf647a5f07b661ff62c102cd3797479a...268c82a903c06ce2711beed6d87ce551fa5356cb,2,77,19,96,16,2006-06-15 04:48:52,2006-06-15 04:48:52
268c82a903c06ce2711beed6d87ce551fa5356cb...f9dbb9f73a7336b826533a6b1d81e2e759380948,1,1,1,2,1,2006-06-15 10:02:37,2006-06-15 10:02:37
f9dbb9f73a7336b826533a6b1d81e2e759380948...34dd8afb259be3ae154887dc7db6b8a8fdab0b6a,1,1,1,2,1,2006-06-16 00:02:54,2006-06-16 00:02:54
34dd8afb259be3ae154887dc7db6b8a8fdab0b6a...a70ab6564bb469af0a64d43bb0b5c20bc27d83fb,1,7,1,8,3,2006-06-16 00:05:56,2006-06-16 00:05:56
a70ab6564bb469af0a64d43bb0b5c20bc27d83fb...d9b1d3436aac059ff2cdddb89f4b8fdc260366e1,1,9,4,13,1,2006-06-16 00:09:51,2006-06-16 00:09:51
d9b1d3436aac059ff2cdddb89f4b8fdc260366e1...9e27d8d1b4d5a93ef4107aab5e815a2c24ed899d,1,6,1,7,1,2006-06-16 00:18:15,2006-06-16 00:18:15
9e27d8d1b4d5a93ef4107aab5e815a2c24ed899d...598fcca346535040416d01aa6d2da53f8b1e8422,1,2,2,4,1,2006-06-16 00:19:47,2006-06-16 00:19:47
598fcca346535040416d01aa6d2da53f8b1e8422...894fc4b280b9ea967a4da08ce6b26462837b033f,1,1,2,3,1,2006-06-16 00:22:00,2006-06-16 00:22:00
894fc4b280b9ea967a4da08ce6b26462837b033f...cb3eada739ce377f80408abe2103c95d5a016918,1,12,2,14,6,2006-06-16 00:33:55,2006-06-16 00:33:55
cb3eada739ce377f80408abe2103c95d5a016918...44590a5d848011d4be05fcf1d098d09c01bb7caf,1,24,4,28,4,2006-06-16 00:45:02,2006-06-16 00:45:02
44590a5d848011d4be05fcf1d098d09c01bb7caf...aabfccf371ac9a16979772dc6411fbe806138fac,1,1,1,2,1,2006-06-16 01:51:15,2006-06-16 01:51:15
aabfccf371ac9a16979772dc6411fbe806138fac...4c572bdf56a95c6462027d18d80e6ed6cebbfd3e,1,5,0,5,1,2006-06-16 02:01:39,2006-06-16 02:01:39
4c572bdf56a95c6462027d18d80e6ed6cebbfd3e...7eb6a25d5e223053a1ebc824c78bf854a755ccd0,1,1,2,3,2,2006-06-16 02:18:04,2006-06-16 02:18:04
7eb6a25d5e223053a1ebc824c78bf854a755ccd0...7ebe209b320b53fcaa3645e77894f3424b0232cb,1,1,1,2,1,2006-06-16 02:25:10,2006-06-16 02:25:10
7ebe209b320b53fcaa3645e77894f3424b0232cb...66bd98be22d50cc09bf14f9aaa0102771a3b990d,1,18,1,19,3,2006-06-16 02:43:04,2006-06-16 02:43:04
66bd98be22d50cc09bf14f9aaa0102771a3b990d...9b7bbc619b4fe328188d9f12a438e148436fc9a6,1,3,3,6,2,2006-06-16 04:23:30,2006-06-16 04:23:30
9b7bbc619b4fe328188d9f12a438e148436fc9a6...8ad487f219f716511cb8ea414439e4ac525fc9ee,1,2,1,3,2,2006-06-16 14:23:33,2006-06-16 14:23:33
8ad487f219f716511cb8ea414439e4ac525fc9ee...d584a884b6377553d6ba544c10484dc2a866caee,1,45,45,90,44,2006-06-17 09:10:45,2006-06-17 09:10:45
d584a884b6377553d6ba544c10484dc2a866caee...d143f76973d5368389e760c73ae0c61113cb1c6a,1,4,4,8,4,2006-06-18 01:23:08,2006-06-18 01:23:08
d143f76973d5368389e760c73ae0c61113cb1c6a...8f52a2e0e95c03a3fdd8654c4af57d19594743f0,1,40,71,111,53,2006-06-18 01:29:53,2006-06-18 01:29:53
8f52a2e0e95c03a3fdd8654c4af57d19594743f0...c43e1e379d4158635b9cd0e2aaeb53f98fe9dd7b,1,2,1,3,1,2006-06-18 01:42:41,2006-06-18 01:42:41
c43e1e379d4158635b9cd0e2aaeb53f98fe9dd7b...5c7551e318050731f0afc5d07caea37ce679c5b3,1,8,6,14,3,2006-06-18 01:50:12,2006-06-18 01:50:12
5c7551e318050731f0afc5d07caea37ce679c5b3...7dd68a0811c87d3849d4571b02da14dafacac8cb,1,0,0,0,0,2006-06-18 23:34:09,2006-06-18 23:34:09
7dd68a0811c87d3849d4571b02da14dafacac8cb...37c237af35a2040eb50bc2de84f1af35c19df6f0,1,163,107,270,9,2006-06-19 00:12:14,2006-06-19 00:12:14
37c237af35a2040eb50bc2de84f1af35c19df6f0...70cab836b0d87ec1a94658411c398658780f5810,1,178,307,485,24,2006-06-19 01:29:54,2006-06-19 01:29:54
70cab836b0d87ec1a94658411c398658780f5810...057381c70d6ff56733d7dc25c86ab5c4ab047430,1,7,4,11,1,2006-06-20 15:42:10,2006-06-20 15:42:10
057381c70d6ff56733d7dc25c86ab5c4ab047430...897e829191e50424393032a1eb07132912287a09,1,189,0,189,1,2006-06-21 10:08:13,2006-06-21 10:08:13
897e829191e50424393032a1eb07132912287a09...5f8576d3a3ea0b54d69fd132ae6264baa93f5e97,2,2,1,3,2,2006-06-21 10:08:57,2006-06-21 10:08:57
5f8576d3a3ea0b54d69fd132ae6264baa93f5e97...ce6af8e8894b14c7b2c41b64a097bc49acc73b19,1,144,121,265,28,2006-06-22 03:03:44,2006-06-22 03:03:44
ce6af8e8894b14c7b2c41b64a097bc49acc73b19...c3c706d3f24dbad0fdeb80fe9caf158bd9d6de66,6,641,778,1419,148,2006-06-22 05:23:38,2006-06-22 05:23:38
c3c706d3f24dbad0fdeb80fe9caf158bd9d6de66...07040f8d039c116b8e5d0c493ba09f3b89c9479b,1,2,2,4,2,2006-06-22 05:26:26,2006-06-22 05:26:26
07040f8d039c116b8e5d0c493ba09f3b89c9479b...3cc1ba05f3315ca8c06ec93ed7867645c11c7ce1,1,74,74,148,5,2006-06-22 13:25:21,2006-06-22 13:25:21
3cc1ba05f3315ca8c06ec93ed7867645c11c7ce1...6ae392a4e57834224b2a686d774ab210da25daa5,4,279,238,517,163,2006-06-22 20:14:41,2006-06-22 20:14:41
6ae392a4e57834224b2a686d774ab210da25daa5...0fd3648d45be72bcfe76b95715b38dd5904b47da,2,8,8,16,8,2006-06-22 21:37:18,2006-06-22 21:37:18
0fd3648d45be72bcfe76b95715b38dd5904b47da...2d9979c73fad6f9aa6e78054dedb0e4aa78ec551,1,13,17,30,5,2006-06-22 22:25:03,2006-06-22 22:25:03
2d9979c73fad6f9aa6e78054dedb0e4aa78ec551...eced62567a992b4696617b555db76e4e755a26ae,1,5,5,10,5,2006-06-23 14:11:39,2006-06-23 14:11:39
eced62567a992b4696617b555db76e4e755a26ae...d25d393a33fafe0598ba1ed1f7d240c3e2883b2a,1,2,2,4,2,2006-06-24 14:10:12,2006-06-24 14:10:12
d25d393a33fafe0598ba1ed1f7d240c3e2883b2a...55f08065a9a2758134bc2dee6b338b888d073967,1,1,1,2,1,2006-06-27 20:56:51,2006-06-27 20:56:51
55f08065a9a2758134bc2dee6b338b888d073967...b5a1e0c8a6f06ae774e3d461f8d499a8049d9383,1,1,3,4,1,2006-06-27 21:26:25,2006-06-27 21:26:25
b5a1e0c8a6f06ae774e3d461f8d499a8049d9383...6bf8667410f10dc505b81261a568e6a42e1ce809,1,1,1,2,1,2006-06-27 21:36:45,2006-06-27 21:36:45
6bf8667410f10dc505b81261a568e6a42e1ce809...73f55becc5e056ad28f6aec22ec014ffb3ab913b,4,56,11,67,12,2006-07-01 14:05:50,2006-07-01 14:05:50
73f55becc5e056ad28f6aec22ec014ffb3ab913b...05a4b784e892ea0dd56201fa1b7a77c7a453bfa7,1,6,4,10,2,2006-07-02 02:11:37,2006-07-02 02:11:37
05a4b784e892ea0dd56201fa1b7a77c7a453bfa7...abf30546672d605b5fa7d539ef00f53b1a415135,1,25,32,57,3,2006-07-03 22:31:37,2006-07-03 22:31:37
abf30546672d605b5fa7d539ef00f53b1a415135...1edf3a2be937a1d0f087ac06e2f57e2c60ef25ea,1,5,4,9,2,2006-07-04 00:42:57,2006-07-04 00:42:57
1edf3a2be937a1d0f087ac06e2f57e2c60ef25ea...cef11df838cef0a09990700818154ff08f04812c,1,6,3,9,1,2006-07-04 01:23:18,2006-07-04 01:23:18
cef11df838cef0a09990700818154ff08f04812c...8a97cd67ef48517e58b2eff9a644e4ced9f95053,1,1,1,2,1,2006-07-04 01:23:46,2006-07-04 01:23:46
8a97cd67ef48517e58b2eff9a644e4ced9f95053...0027439156fb97bef30f6084d85898ec5b16155f,1,17,11,28,7,2006-07-04 02:19:41,2006-07-04 02:19:41
0027439156fb97bef30f6084d85898ec5b16155f...4531ab13243f5e94e1ecfbd55e992842666d08aa,1,1,1,2,1,2006-07-04 04:37:09,2006-07-04 04:37:09
4531ab13243f5e94e1ecfbd55e992842666d08aa...aaaa9eb2f390d6153592c0eb2fa31db00ff2b6c0,1,1,1,2,1,2006-07-05 01:42:12,2006-07-05 01:42:12
aaaa9eb2f390d6153592c0eb2fa31db00ff2b6c0...a208222f3713a7f28499040d924d8c89b41c4350,1,3,3,6,3,2006-07-05 01:48:00,2006-07-05 01:48:00
a208222f3713a7f28499040d924d8c89b41c4350...f96c860bbd754f64ccc427a7308f4b3faf2f2814,1,6,5,11,1,2006-07-05 02:01:24,2006-07-05 02:01:24
f96c860bbd754f64ccc427a7308f4b3faf2f2814...32548da2476603b40df3a15afb536b2750321aec,1,1,1,2,1,2006-07-05 02:03:38,2006-07-05 02:03:38
32548da2476603b40df3a15afb536b2750321aec...fde7edc456dac52fe43651b8e074ec6ed13d23f2,1,3,1,4,1,2006-07-05 02:07:20,2006-07-05 02:07:20
fde7edc456dac52fe43651b8e074ec6ed13d23f2...f197c7469f43c02bcbc65f2f41e2b419f0379700,1,3,2,5,1,2006-07-05 02:09:38,2006-07-05 02:09:38
f197c7469f43c02bcbc65f2f41e2b419f0379700...3811ac4b5cb8d240d037fea7b26a8abc7fc6e490,1,28,31,59,5,2006-07-05 04:14:46,2006-07-05 04:14:46
3811ac4b5cb8d240d037fea7b26a8abc7fc6e490...9b6df19cc4dcc03760aee8a6df95a0d3c8585780,1,9,1,10,1,2006-07-05 17:12:35,2006-07-05 17:12:35
9b6df19cc4dcc03760aee8a6df95a0d3c8585780...b2d15586bd7cf3f620793b116b4377b8cfc38c8a,1,49,23,72,12,2006-07-06 05:16:39,2006-07-06 05:16:39
b2d15586bd7cf3f620793b116b4377b8cfc38c8a...64179692a0eeadc7a6d93fe007bfc00990af6575,1,23,3,26,4,2006-07-06 05:43:26,2006-07-06 05:43:26
64179692a0eeadc7a6d93fe007bfc00990af6575...0a9c5698398f7a8347d2d5956c9d11a3eb2933d6,1,14,14,28,7,2006-07-06 14:50:56,2006-07-06 14:50:56
0a9c5698398f7a8347d2d5956c9d11a3eb2933d6...7f1c69041dae15bf544ab96205b4db05ffe4ff8c,1,3,3,6,3,2006-07-06 16:04:12,2006-07-06 16:04:12
7f1c69041dae15bf544ab96205b4db05ffe4ff8c...586e36867b9ee10be4102d64ef00f2b16b32fb08,1,66,39,105,26,2006-07-06 19:59:16,2006-07-06 19:59:16
586e36867b9ee10be4102d64ef00f2b16b32fb08...214007721c67d9702571e45573cf32c61c2201a8,1,3,3,6,3,2006-07-06 20:48:38,2006-07-06 20:48:38
214007721c67d9702571e45573cf32c61c2201a8...414d059941343fa3c6bbbf40d3cb55cba4c4c85e,1,4,3,7,2,2006-07-06 22:09:39,2006-07-06 22:09:39
414d059941343fa3c6bbbf40d3cb55cba4c4c85e...e2c2a9392e14f4190148b3c8014fdccf66785b88,1,4,0,4,1,2006-07-07 00:31:27,2006-07-07 00:31:27
e2c2a9392e14f4190148b3c8014fdccf66785b88...4ad5fcb4f752fb09d7074deb9b2c98167b1a7dd7,1,336,214,550,30,2006-07-08 21:15:08,2006-07-08 21:15:08
4ad5fcb4f752fb09d7074deb9b2c98167b1a7dd7...df9c37ec852f8c873e226cd0ae190f969e0edc17,1,842,546,1388,89,2006-07-09 20:49:40,2006-07-09 20:49:40
df9c37ec852f8c873e226cd0ae190f969e0edc17...9477c418dbf50f2341dec7c02f60ab3d77da5378,4,563,518,1081,57,2006-07-10 03:20:56,2006-07-10 03:20:56
9477c418dbf50f2341dec7c02f60ab3d77da5378...a155231ffdee6de9a6b9d18d93952ac6a336dc47,1,108,106,214,1,2006-07-13 04:05:08,2006-07-13 04:05:08
a155231ffdee6de9a6b9d18d93952ac6a336dc47...470a807deae604798bd48e8cd0ff8da1dd8c0c55,1,155,4,159,8,2006-07-13 04:21:15,2006-07-13 04:21:15
470a807deae604798bd48e8cd0ff8da1dd8c0c55...8192bd8e914822b54abcc245fe8013cd6c78e6cb,1,87,0,87,4,2006-07-13 04:37:06,2006-07-13 04:37:06
8192bd8e914822b54abcc245fe8013cd6c78e6cb...3d334ad8066f040e4878be45d8230a599176351b,1,14,15,29,11,2006-07-13 19:53:04,2006-07-13 19:53:04
3d334ad8066f040e4878be45d8230a599176351b...b84acca0576538d3af9a6a41ca92e2f45beca771,1,131,1,132,11,2006-07-14 03:05:52,2006-07-14 03:05:52
b84acca0576538d3af9a6a41ca92e2f45beca771...7d57c67749a4c38d80de6d5ed7917f4219ce34b4,1,71,52,123,24,2006-07-15 01:00:19,2006-07-15 01:00:19
7d57c67749a4c38d80de6d5ed7917f4219ce34b4...f5f6cbc8c0b6441fb1d106749f7124659a3816f0,1,11,10,21,2,2006-07-16 00:52:30,2006-07-16 00:52:30
f5f6cbc8c0b6441fb1d106749f7124659a3816f0...98bd178cb00da749062bcd7e8992b569156674fc,1,40,37,77,3,2006-07-16 18:23:09,2006-07-16 18:23:09
98bd178cb00da749062bcd7e8992b569156674fc...57403c1be2e9408e44b02628bae0bbe0680d1c4b,1,11,11,22,8,2006-07-16 19:39:07,2006-07-16 19:39:07
57403c1be2e9408e44b02628bae0bbe0680d1c4b...f4c67b7c5aba7fbdaf4b883b71ff9cc1b66e9af8,1,6,2,8,2,2006-07-16 20:10:37,2006-07-16 20:10:37
f4c67b7c5aba7fbdaf4b883b71ff9cc1b66e9af8...4737936c0b05236ecafa86f0186b0b236a2ff826,1,7,7,14,4,2006-07-16 20:57:18,2006-07-16 20:57:18
4737936c0b05236ecafa86f0186b0b236a2ff826...e8627fe1555602dc4713c4e848a41642b2654512,2,2,2,4,2,2006-07-17 01:49:55,2006-07-17 01:49:55
e8627fe1555602dc4713c4e848a41642b2654512...82e217c70cc158086b6b2df7637fda78d0ca81bd,1,1,1,2,1,2006-07-17 02:05:04,2006-07-17 02:05:04
82e217c70cc158086b6b2df7637fda78d0ca81bd...954554e2390772fda9a27fdd0c651b5ad76bca16,1,2,2,4,1,2006-07-17 02:08:00,2006-07-17 02:08:00
954554e2390772fda9a27fdd0c651b5ad76bca16...274d8b7927c6027265402dab35303ce20c4d00a0,1,16,8,24,10,2006-07-17 03:40:18,2006-07-17 03:40:18
274d8b7927c6027265402dab35303ce20c4d00a0...2d31381a5722719190be4a0dde630a0b9ea70fa5,1,14,11,25,7,2006-07-17 04:33:16,2006-07-17 04:33:16
2d31381a5722719190be4a0dde630a0b9ea70fa5...a03b3fd3e4f44e123c0f5a22e0649604240fe9c3,1,5,1,6,2,2006-07-17 04:57:07,2006-07-17 04:57:07
a03b3fd3e4f44e123c0f5a22e0649604240fe9c3...29a059142123a8bde16de2e579e7708a86a8de78,2,36,25,61,15,2006-07-24 03:09:35,2006-07-24 03:09:35
29a059142123a8bde16de2e579e7708a86a8de78...9e37da96d12c0f35c766a4724c5d565d0a50ab42,2,10,8,18,7,2006-07-24 03:50:15,2006-07-24 03:50:15
9e37da96d12c0f35c766a4724c5d565d0a50ab42...0a4dc3f8f295d10bbe855a11f52931c6c979e29e,1,3,2,5,2,2006-07-24 03:56:46,2006-07-24 03:56:46
0a4dc3f8f295d10bbe855a11f52931c6c979e29e...aa5c4d8828bd8956218ccca47ee7a029fe26008e,1,21,11,32,11,2006-07-24 06:06:59,2006-07-24 06:06:59
aa5c4d8828bd8956218ccca47ee7a029fe26008e...6e868bb091f14a534c898c7a47e6fecd3e403b60,1,2,0,2,1,2006-07-25 20:20:18,2006-07-25 20:20:18
6e868bb091f14a534c898c7a47e6fecd3e403b60...785d500cac31619b53f976fa122d1f1d10b721a5,1,21,44,65,12,2006-07-26 15:44:56,2006-07-26 15:44:56
785d500cac31619b53f976fa122d1f1d10b721a5...2f023fdd210a509353ae634bd1cd5d2fec59b0ce,1,1,1,2,1,2006-07-28 03:32:43,2006-07-28 03:32:43
2f023fdd210a509353ae634bd1cd5d2fec59b0ce...efe0fef88082eebf66e9b7c250a6a072a5aa1966,1,426,421,847,12,2006-07-28 04:06:35,2006-07-28 04:06:35
efe0fef88082eebf66e9b7c250a6a072a5aa1966...5d0b503c6d4b55b2fd890d6cfd5b936a0ae2bd0d,1,24,26,50,15,2006-07-28 04:39:22,2006-07-28 04:39:22
5d0b503c6d4b55b2fd890d6cfd5b936a0ae2bd0d...44e4c188dd308591837248077e209cab91f10f51,1,1,1,2,1,2006-07-28 04:54:50,2006-07-28 04:54:50
44e4c188dd308591837248077e209cab91f10f51...ed867fe6f8be7e6e1eeb948e5f7a3a9e6ee1f63e,3,2148,47,2195,38,2006-07-29 04:17:07,2006-07-29 04:17:07
ed867fe6f8be7e6e1eeb948e5f7a3a9e6ee1f63e...879225b3ae8a519ff680b44285953d7db258606d,1,4,4,8,4,2006-07-30 04:21:39,2006-07-30 04:21:39
879225b3ae8a519ff680b44285953d7db258606d...82e0a5a810f09b601543d3406b65ac15bd22307e,3,11,11,22,9,2006-07-30 23:07:00,2006-07-30 23:07:00
82e0a5a810f09b601543d3406b65ac15bd22307e...340b55336924ee60d0de2f189f5d852e087d3a1f,1,4,4,8,4,2006-08-01 07:35:37,2006-08-01 07:35:37
340b55336924ee60d0de2f189f5d852e087d3a1f...49747af6b1feceb4b9ca96815bfefc214df13abc,1,20,0,20,1,2006-08-01 09:23:44,2006-08-01 09:23:44
49747af6b1feceb4b9ca96815bfefc214df13abc...f2d4bffcc760eb03dae13a9d9e7f0bbd8ec33c1e,9,4614,0,4614,9,2006-08-09 05:44:05,2006-08-09 05:44:05
f2d4bffcc760eb03dae13a9d9e7f0bbd8ec33c1e...6a50758086f2db26b12b12e8c58a42cbbd28a98a,1,9,1,10,3,2006-08-09 05:44:25,2006-08-09 05:44:25
6a50758086f2db26b12b12e8c58a42cbbd28a98a...db85661c055cde53ba3c8a104a5c9bc9143ac74c,1,1,0,1,1,2006-08-12 23:08:16,2006-08-12 23:08:16
db85661c055cde53ba3c8a104a5c9bc9143ac74c...6a47e28340e3cd9e8be73872767e6dbebd1a28f5,4,261,21,282,231,2006-08-12 23:08:44,2006-08-12 23:08:44
6a47e28340e3cd9e8be73872767e6dbebd1a28f5...8aca450f435191c475cdb04ce7684da5b0e23775,2,7,6,13,6,2006-08-13 01:29:27,2006-08-13 01:29:27
8aca450f435191c475cdb04ce7684da5b0e23775...41c94b4688777c62ac93d63e78c885311eecaa82,1,1,1,2,1,2006-08-13 02:59:19,2006-08-13 02:59:19
41c94b4688777c62ac93d63e78c885311eecaa82...8cef646d1726729671b1889928a29ac416753236,22,5491,4608,10099,30,2006-08-13 03:05:31,2006-08-13 03:05:31
8cef646d1726729671b1889928a29ac416753236...f342a1a09a2767f52089209e5c2d18e45552d141,0,0,0,0,0,2006-08-13 14:46:11,2006-08-13 14:46:11
f342a1a09a2767f52089209e5c2d18e45552d141...a42a8e5afa2e4ca7690081bce9899d5e6e0d1cf4,4,0,0,0,0,2006-08-13 14:49:54,2006-08-13 14:49:54
a42a8e5afa2e4ca7690081bce9899d5e6e0d1cf4...f3ac04e5937e95bb85520a2f81e8669fd4843ae8,1,26,0,26,1,2006-08-13 14:51:02,2006-08-13 14:51:02
f3ac04e5937e95bb85520a2f81e8669fd4843ae8...1dbdf43658874e1326da41817b1e36a5248ca642,2,41,0,41,1,2006-08-13 14:52:14,2006-08-13 14:52:14
1dbdf43658874e1326da41817b1e36a5248ca642...991390e2422d558cac2cfa5508fe3e921ac38e42,8,119,10,129,7,2006-08-13 15:12:35,2006-08-13 15:12:35
991390e2422d558cac2cfa5508fe3e921ac38e42...7d4bf9725472b7684533a35e5fbd143c28a5758c,4,242,0,242,3,2006-08-13 15:15:15,2006-08-13 15:15:15
7d4bf9725472b7684533a35e5fbd143c28a5758c...139a9cd7d495922b0f6e8f79d5fb3239db59b5ba,2,8,8,16,5,2006-08-13 15:22:02,2006-08-13 15:22:02
139a9cd7d495922b0f6e8f79d5fb3239db59b5ba...e7a29e42391160949dc35c1af4b0d24ee1c8ad8f,17,3931,0,3931,17,2006-08-13 15:24:52,2006-08-13 15:24:52
e7a29e42391160949dc35c1af4b0d24ee1c8ad8f...f01c002f2620473aa32a5d07a51b5ffb43d573f7,1,36,0,36,1,2006-08-13 15:26:26,2006-08-13 15:26:26
f01c002f2620473aa32a5d07a51b5ffb43d573f7...eb1c972323188e062b3e444b5b5c5a4d5d16c8cc,4,0,5293,5293,4,2006-08-13 15:28:35,2006-08-13 15:28:35
eb1c972323188e062b3e444b5b5c5a4d5d16c8cc...c3a32e296492525c95598e4bb3a7d8e755982f88,3,0,267,267,3,2006-08-13 17:30:41,2006-08-13 17:30:41
c3a32e296492525c95598e4bb3a7d8e755982f88...6c3314abed7a54302afde8c7522745825cada33f,1,2,12,14,2,2006-08-13 18:36:50,2006-08-13 18:36:50
6c3314abed7a54302afde8c7522745825cada33f...51dd3736eb84b171b041f419f6fb8a7e8626b0f2,8,31,16,47,13,2006-08-13 18:38:51,2006-08-13 18:38:51
51dd3736eb84b171b041f419f6fb8a7e8626b0f2...0307071d9ef2d0b0a8f3cb3d3d5255e6d840130b,0,0,0,0,0,2006-08-13 18:39:29,2006-08-13 18:39:29
0307071d9ef2d0b0a8f3cb3d3d5255e6d840130b...fc5ab8d6557884d275ba91795d208df635b6bff5,5,50,23,73,14,2006-08-13 18:58:58,2006-08-13 18:58:58
fc5ab8d6557884d275ba91795d208df635b6bff5...9bdfc671fc19486f9cc1ca306bec2acd80ad77fc,2,3,3,6,3,2006-08-13 19:08:39,2006-08-13 19:08:39
9bdfc671fc19486f9cc1ca306bec2acd80ad77fc...0cd3821ac2b74d37384a36f281e5a952138aaae2,1,2,2,4,2,2006-08-13 19:12:58,2006-08-13 19:12:58
0cd3821ac2b74d37384a36f281e5a952138aaae2...e943090a72fada9068705a701e2f37ca2907d310,18,28,7,35,9,2006-08-13 20:01:26,2006-08-13 20:01:26
e943090a72fada9068705a701e2f37ca2907d310...61aab47bcf4c35d021a88d95b7a17643d1342596,9,0,3455,3455,9,2006-08-13 21:09:19,2006-08-13 21:09:19
61aab47bcf4c35d021a88d95b7a17643d1342596...7448c61ee2199f6f7002e33e533cebc42b000c89,10,465,130,595,58,2006-08-14 01:46:05,2006-08-14 01:46:05
7448c61ee2199f6f7002e33e533cebc42b000c89...76ac10ed1f53d5166e18461e0d1bb98ceabe1e84,8,38,455,493,8,2006-08-14 01:47:47,2006-08-14 01:47:47
76ac10ed1f53d5166e18461e0d1bb98ceabe1e84...ba79495789cc390bcc704da55d17cc051d84a851,1,5,0,5,1,2006-08-14 01:49:14,2006-08-14 01:49:14
ba79495789cc390bcc704da55d17cc051d84a851...f8402b9a081f0096986d140f809f4d57c6db7834,1,52,0,52,1,2006-08-14 02:00:28,2006-08-14 02:00:28
f8402b9a081f0096986d140f809f4d57c6db7834...7e5a2bd738f9acff63e97c108be6768cf4a45531,1,2,2,4,1,2006-08-14 02:17:22,2006-08-14 02:17:22
7e5a2bd738f9acff63e97c108be6768cf4a45531...269ff25860737c7bd86d451256886332263c07fd,1,3,3,6,3,2006-08-14 03:54:44,2006-08-14 03:54:44
269ff25860737c7bd86d451256886332263c07fd...afbd2e37c981234e3b8f891448d4612cd013bd96,1,4,1,5,2,2006-08-15 04:40:21,2006-08-15 04:40:21
afbd2e37c981234e3b8f891448d4612cd013bd96...b9e216ca75a0e8cfbaf14b064cc8a371de3e5c13,1,100,0,100,1,2006-08-16 21:14:03,2006-08-16 21:14:03
b9e216ca75a0e8cfbaf14b064cc8a371de3e5c13...9c173f754cf4239a9a0f0eec1fa0b52926636499,1,17,2,19,2,2006-08-16 21:20:38,2006-08-16 21:20:38
9c173f754cf4239a9a0f0eec1fa0b52926636499...ec38c6086c3d0efd65e9c6060cb641e80ae3b2a9,1,5,5,10,2,2006-08-17 02:38:34,2006-08-17 02:38:34
ec38c6086c3d0efd65e9c6060cb641e80ae3b2a9...fe392e6a741a97edf1208d341d884f8f6bcf0739,1,18,12,30,6,2006-08-17 03:08:13,2006-08-17 03:08:13
fe392e6a741a97edf1208d341d884f8f6bcf0739...5ec5de6953a22b33de46897c8e915eed300338e6,1,112,42,154,24,2006-08-17 04:18:32,2006-08-17 04:18:32
5ec5de6953a22b33de46897c8e915eed300338e6...26580d2675918bb689d55293e734e68671b4dfc6,2,5,7,12,4,2006-08-17 05:11:34,2006-08-17 05:11:34
26580d2675918bb689d55293e734e68671b4dfc6...2a4c269a9b7c15477e032a24f92d08dfaeb026e4,1,6,0,6,1,2006-08-17 05:14:50,2006-08-17 05:14:50
2a4c269a9b7c15477e032a24f92d08dfaeb026e4...065cd7ecf62c7b2ad5b58d447aca7a9cdb6f7bcb,1,1,1,2,1,2006-08-18 04:13:13,2006-08-18 04:13:13
065cd7ecf62c7b2ad5b58d447aca7a9cdb6f7bcb...b91f8a9e304b8b64b8e71e9e0dc0cd9871c0a868,1,2,1,3,1,2006-08-18 04:27:57,2006-08-18 04:27:57
b91f8a9e304b8b64b8e71e9e0dc0cd9871c0a868...367abc373be76ae24b5aed2c5e49fbc308ecebcc,1,6,1,7,2,2006-08-18 04:37:41,2006-08-18 04:37:41
367abc373be76ae24b5aed2c5e49fbc308ecebcc...8ff329b0f346ea5282e76dc7fa7f91a79d6ff8eb,1,4,2,6,2,2006-08-20 21:58:30,2006-08-20 21:58:30
8ff329b0f346ea5282e76dc7fa7f91a79d6ff8eb...5ae02b2ecd6293ef33de3d3acf00c456ed01b776,3,279,2,281,2,2006-08-21 19:36:44,2006-08-21 19:36:44
5ae02b2ecd6293ef33de3d3acf00c456ed01b776...ccabf2823b528c09455432cafdb504c6a0216a18,5,52,14,66,11,2006-08-22 05:00:07,2006-08-22 05:00:07
ccabf2823b528c09455432cafdb504c6a0216a18...25802e8bd07f6c50df2159a031f005950f509819,1,5,1,6,2,2006-08-22 05:35:48,2006-08-22 05:35:48
25802e8bd07f6c50df2159a031f005950f509819...874e4f65eecdf74bb76c361d778aac4ed6158ed6,1,12,8,20,5,2006-08-22 07:32:25,2006-08-22 07:32:25
874e4f65eecdf74bb76c361d778aac4ed6158ed6...ccf9d4406296fed48aae0989f2303287f133ed9e,3,69,56,125,24,2006-08-24 19:43:21,2006-08-24 19:43:21
ccf9d4406296fed48aae0989f2303287f133ed9e...8a1adfcd2a0ea8fbb72ac53537cbfe6ebeba0cdf,2,10,3,13,4,2006-08-24 21:30:21,2006-08-24 21:30:21
8a1adfcd2a0ea8fbb72ac53537cbfe6ebeba0cdf...23e255015fb5e4f5ce7e8dd091b1550e80cccdd9,1,2,2,4,1,2006-08-24 23:10:54,2006-08-24 23:10:54
23e255015fb5e4f5ce7e8dd091b1550e80cccdd9...7caca06cfc28fab22ec9c3a2d1363fec8d8c1951,1,2,1,3,1,2006-08-24 23:45:39,2006-08-24 23:45:39
7caca06cfc28fab22ec9c3a2d1363fec8d8c1951...906478800db84631ddbd6b132450f65a2176bd2c,3,35,39,74,11,2006-08-25 18:38:24,2006-08-25 18:38:24
906478800db84631ddbd6b132450f65a2176bd2c...94fc6aac1990dc3233c70f471432c5b9f230e756,1,26,12,38,3,2006-08-25 21:22:21,2006-08-25 21:22:21
94fc6aac1990dc3233c70f471432c5b9f230e756...a2af24b064bd1384c24b896fdd9c7d322954546b,2,317,2,319,2,2006-08-26 00:43:41,2006-08-26 00:43:41
a2af24b064bd1384c24b896fdd9c7d322954546b...48ec10044f011ccfe9bd232d629682b59cccbd97,3,60,64,124,26,2006-08-26 03:51:03,2006-08-26 03:51:03
48ec10044f011ccfe9bd232d629682b59cccbd97...0f458cf806ed4013dc2ef289c990f3818df0fd25,1,15,7,22,7,2006-08-26 16:50:31,2006-08-26 16:50:31
0f458cf806ed4013dc2ef289c990f3818df0fd25...0382a490f5e5ee781098981db050a23d4f2e5a36,1,1,0,1,1,2006-08-26 22:39:14,2006-08-26 22:39:14
0382a490f5e5ee781098981db050a23d4f2e5a36...c0e4280282d03a449caaf87d5a6bfe151a874796,1,1,1,2,1,2006-08-28 06:19:13,2006-08-28 06:19:13
c0e4280282d03a449caaf87d5a6bfe151a874796...f7efcc858dec55fa3b9babb94ebc73b0888e6d51,1,1,1,2,1,2006-08-31 03:59:51,2006-08-31 03:59:51
f7efcc858dec55fa3b9babb94ebc73b0888e6d51...f404d2c395626b3a09512b0b41da77fb7eb36260,1,1,1,2,1,2006-08-31 04:05:57,2006-08-31 04:05:57
f404d2c395626b3a09512b0b41da77fb7eb36260...6ceecc520a2b521dedce47f83c954727299b6653,1,1,0,1,1,2006-08-31 04:13:39,2006-08-31 04:13:39
6ceecc520a2b521dedce47f83c954727299b6653...a4ec609b6a52a3c0f791d5426c1a5816b23e6956,1,2,1,3,1,2006-08-31 04:16:23,2006-08-31 04:16:23
a4ec609b6a52a3c0f791d5426c1a5816b23e6956...78a7cf63f6e984e4c87cdef52688283f81846f0b,1,3,2,5,1,2006-08-31 04:19:59,2006-08-31 04:19:59
78a7cf63f6e984e4c87cdef52688283f81846f0b...b27be158f2dc1aab317535f081b18f367fe6175e,1,1,1,2,1,2006-08-31 04:22:45,2006-08-31 04:22:45
b27be158f2dc1aab317535f081b18f367fe6175e...3f47d3b8f5b2623a3bf289ad4446d0eafd12413d,1,2,1,3,1,2006-08-31 04:27:30,2006-08-31 04:27:30
3f47d3b8f5b2623a3bf289ad4446d0eafd12413d...45a3c06e8fd4ac04f5d914ecf5d2e25148160b3b,1,7,5,12,3,2006-08-31 05:16:50,2006-08-31 05:16:50
45a3c06e8fd4ac04f5d914ecf5d2e25148160b3b...e23c047e786ada99f7f42c1ad1c305eb2394ca7f,1,3,2,5,1,2006-08-31 05:21:16,2006-08-31 05:21:16
e23c047e786ada99f7f42c1ad1c305eb2394ca7f...fb534aea034c9b832b484e6dd26bd2e86f029433,1,1,1,2,1,2006-08-31 06:30:44,2006-08-31 06:30:44
fb534aea034c9b832b484e6dd26bd2e86f029433...d2529835be92c7be6a970ceda95285323fd57285,1,3,0,3,1,2006-08-31 06:32:27,2006-08-31 06:32:27
d2529835be92c7be6a970ceda95285323fd57285...a2206b784e77434c77259e2d46bd53ec1656070c,1,1,1,2,1,2006-08-31 08:14:33,2006-08-31 08:14:33
a2206b784e77434c77259e2d46bd53ec1656070c...bcc8a837055fe720579628d758b7034d6b520f2e,1,7,6,13,2,2006-08-31 17:26:31,2006-08-31 17:26:31
bcc8a837055fe720579628d758b7034d6b520f2e...288b1a67303174f336ac4111c50747d609cba32a,1,6,6,12,6,2006-08-31 21:44:24,2006-08-31 21:44:24
288b1a67303174f336ac4111c50747d609cba32a...18e563abe53d7a7fb4169c869f01812c119ae191,1,1,1,2,1,2006-08-31 23:30:29,2006-08-31 23:30:29
18e563abe53d7a7fb4169c869f01812c119ae191...805d21c2360a10fa5e7ac85cc593b4403afb6c9f,2,113,4,117,10,2006-09-01 02:43:54,2006-09-01 02:43:54
805d21c2360a10fa5e7ac85cc593b4403afb6c9f...c8009abcce562198cbc3930ed11f74dd62eba531,7,750,749,1499,379,2006-09-01 05:52:26,2006-09-01 05:52:26
c8009abcce562198cbc3930ed11f74dd62eba531...2a921daaa7a02a73967e51b9e09037f667af5af7,1,89,3,92,5,2006-09-01 06:22:39,2006-09-01 06:22:39
2a921daaa7a02a73967e51b9e09037f667af5af7...34d40c3aee0d7d49e5f36868ad307206ecdf0f27,1,54,1,55,2,2006-09-01 06:31:44,2006-09-01 06:31:44
34d40c3aee0d7d49e5f36868ad307206ecdf0f27...484af2a45aba1ab7955a8b3de43e875911b123a7,1,133,2,135,5,2006-09-01 06:50:35,2006-09-01 06:50:35
484af2a45aba1ab7955a8b3de43e875911b123a7...905a0ae351260b38ca2fba4e470d77524f62ffa4,2,55,0,55,2,2006-09-01 07:41:59,2006-09-01 07:41:59
905a0ae351260b38ca2fba4e470d77524f62ffa4...744c0609d4848d89c528f1eb61c596ee4bc0d393,1,8,1,9,3,2006-09-01 16:04:50,2006-09-01 16:04:50
744c0609d4848d89c528f1eb61c596ee4bc0d393...69efa31318238a1af5644da7aa5dc691dc33b376,1,2,2,4,2,2006-09-02 09:23:07,2006-09-02 09:23:07
69efa31318238a1af5644da7aa5dc691dc33b376...7f17d8f528355f135b55b3a329f8c1b79110b207,3,333,1,334,5,2006-09-02 11:47:54,2006-09-02 11:47:54
7f17d8f528355f135b55b3a329f8c1b79110b207...519b7d33e2e40c9d6f5defa67500979af2123d99,1,317,317,634,310,2006-09-02 14:50:30,2006-09-02 14:50:30
519b7d33e2e40c9d6f5defa67500979af2123d99...97ea47492fe13ddb1108045c244d5af6570ace92,4,305,68,373,42,2006-09-04 04:51:57,2006-09-04 04:51:57
97ea47492fe13ddb1108045c244d5af6570ace92...6346e5d1c23108ff850d324904c274b273ea993e,1,3,3,6,2,2006-09-04 19:58:06,2006-09-04 19:58:06
6346e5d1c23108ff850d324904c274b273ea993e...e2d3c4341908aa2a36023c91a8a684d10e93339a,3,92,40,132,22,2006-09-05 06:21:35,2006-09-05 06:21:35
e2d3c4341908aa2a36023c91a8a684d10e93339a...00e6e81f94a1831ceef76b371f9c186b4097d91e,2,44,0,44,2,2006-09-05 15:05:56,2006-09-05 15:05:56
00e6e81f94a1831ceef76b371f9c186b4097d91e...b5220adbbcbb6216af176fa38c626aca53ec8d0f,2,22,12,34,7,2006-09-05 17:58:22,2006-09-05 17:58:22
b5220adbbcbb6216af176fa38c626aca53ec8d0f...ded14024983f328620d68d2a51d059d883250ccb,1,96,112,208,15,2006-09-05 19:50:13,2006-09-05 19:50:13
ded14024983f328620d68d2a51d059d883250ccb...fd4fc0bcdd4d2e65d48e99aa40af79da72225bea,1,2,1,3,2,2006-09-05 20:00:36,2006-09-05 20:00:36
fd4fc0bcdd4d2e65d48e99aa40af79da72225bea...acf102237f9e26c1b864bf6e432f65040b477851,1,2,1,3,1,2006-09-05 20:20:16,2006-09-05 20:20:16
acf102237f9e26c1b864bf6e432f65040b477851...eff56887b164b489bb792f87770b7ba69e8f54df,2,14,2,16,4,2006-09-07 08:12:12,2006-09-07 08:12:12
eff56887b164b489bb792f87770b7ba69e8f54df...514aef10d785165704d49f780fc6fe20eb4ec690,1,165,0,165,1,2006-09-08 09:37:29,2006-09-08 09:37:29
514aef10d785165704d49f780fc6fe20eb4ec690...eb29e285f392f86b936002b425f55d597a842d14,1,242,76,318,34,2006-09-08 10:18:46,2006-09-08 10:18:46
eb29e285f392f86b936002b425f55d597a842d14...20391db9c279a6486d27d1d5cb5f334a1767e298,1,81,72,153,34,2006-09-08 10:44:32,2006-09-08 10:44:32
20391db9c279a6486d27d1d5cb5f334a1767e298...f337b8a6377d4920503015af4c2b3cb1262da1da,2,15,2,17,6,2006-09-08 17:48:21,2006-09-08 17:48:21
f337b8a6377d4920503015af4c2b3cb1262da1da...e8db15b70f92a89091795347914a5299f8a1c8fd,1,3,2,5,3,2006-09-08 19:18:49,2006-09-08 19:18:49
e8db15b70f92a89091795347914a5299f8a1c8fd...698eafb58a9b046446115be7d8a9d4a6db7ececb,1,1,1,2,1,2006-09-08 23:17:00,2006-09-08 23:17:00
698eafb58a9b046446115be7d8a9d4a6db7ececb...998d1d8839813b957a32465fdc7ef7d27d858eea,1,19,12,31,6,2006-09-09 08:31:07,2006-09-09 08:31:07
998d1d8839813b957a32465fdc7ef7d27d858eea...38fa3cfc34a61defc9534c8303ba8c4c50bacb86,1,1,1,2,1,2006-09-09 08:36:47,2006-09-09 08:36:47
38fa3cfc34a61defc9534c8303ba8c4c50bacb86...da74bde0b7ab66cee11c7e6542ee29579da53948,1,4,0,4,1,2006-09-09 17:12:26,2006-09-09 17:12:26
da74bde0b7ab66cee11c7e6542ee29579da53948...a4f25f9311c46c086eb6bb58b0afdcf66e4099d4,1,5,0,5,2,2006-09-09 17:26:51,2006-09-09 17:26:51
a4f25f9311c46c086eb6bb58b0afdcf66e4099d4...f153dec20c7827c7ec5016f24c85e999950bc33c,1,3,0,3,1,2006-09-09 17:42:51,2006-09-09 17:42:51
f153dec20c7827c7ec5016f24c85e999950bc33c...06ef8c06893595bbd03b57744837b491665900bc,1,2,0,2,1,2006-09-09 17:56:08,2006-09-09 17:56:08
06ef8c06893595bbd03b57744837b491665900bc...f50224d6530da96293ddbc16943e374a8b236e39,2,5,3,8,3,2006-09-09 23:21:30,2006-09-09 23:21:30
f50224d6530da96293ddbc16943e374a8b236e39...130f3e6d4381783ec2e94b3e146c01fbc633fc74,1,4,1,5,2,2006-09-14 22:26:42,2006-09-14 22:26:42
130f3e6d4381783ec2e94b3e146c01fbc633fc74...ea53a61a38ecdddaea6f344fcaf74bfe1d37397c,1,1,1,2,1,2006-09-14 22:28:25,2006-09-14 22:28:25
ea53a61a38ecdddaea6f344fcaf74bfe1d37397c...770a92a594a803486a66603a67f559ff15915d8b,5,12,5,17,8,2006-09-15 14:51:55,2006-09-15 14:51:55
770a92a594a803486a66603a67f559ff15915d8b...c792f325142ad928a1bf3263b5958cc01ea1a936,1,17,10,27,7,2006-09-15 17:52:30,2006-09-15 17:52:30
c792f325142ad928a1bf3263b5958cc01ea1a936...f6ecc6a95c4046f53d1f0d75af213305c2bd7ea7,6,113,141,254,34,2006-09-16 12:19:56,2006-09-16 12:19:56
f6ecc6a95c4046f53d1f0d75af213305c2bd7ea7...6ebf2f979c5efe6b234821f5e3b93c59da7f0aa3,2,0,2,2,2,2006-09-16 12:23:28,2006-09-16 12:23:28
6ebf2f979c5efe6b234821f5e3b93c59da7f0aa3...529203f6b576aa15201485dd8d704109aa543f0d,2,9,4,13,3,2006-09-16 14:57:15,2006-09-16 14:57:15
529203f6b576aa15201485dd8d704109aa543f0d...df11c1b76c8a0213be031d23d81e10ec4c28e658,1,16,10,26,3,2006-09-16 15:16:42,2006-09-16 15:16:42
df11c1b76c8a0213be031d23d81e10ec4c28e658...43d3deb7c81fb4bd35a7f98c5f01f5f653b4c5a2,1,15,2,17,2,2006-09-16 15:41:07,2006-09-16 15:41:07
43d3deb7c81fb4bd35a7f98c5f01f5f653b4c5a2...1293e80ff9afa96198c81fa79aa267a4ee44d9d1,1,11,9,20,1,2006-09-16 15:50:35,2006-09-16 15:50:35
1293e80ff9afa96198c81fa79aa267a4ee44d9d1...87284a8ee751e1b4bb4a1ed96cdb92cb938d5f04,1,2,2,4,1,2006-09-16 16:15:46,2006-09-16 16:15:46
87284a8ee751e1b4bb4a1ed96cdb92cb938d5f04...fa2aaf27c29769ca6611a77889321443db47e8e0,1,1,1,2,1,2006-09-16 16:26:30,2006-09-16 16:26:30
fa2aaf27c29769ca6611a77889321443db47e8e0...060c55bf043922401cb033117a3091ad24dbf047,2,5,1,6,2,2006-09-16 17:09:54,2006-09-16 17:09:54
060c55bf043922401cb033117a3091ad24dbf047...394334671cd4a0b22c01f724b30933fc83df863d,1,68,0,68,1,2006-09-16 22:48:53,2006-09-16 22:48:53
394334671cd4a0b22c01f724b30933fc83df863d...2d56dbc13d9c1254eb740ca48f413e9513f0e533,3,5,0,5,3,2006-09-16 23:22:29,2006-09-16 23:22:29
2d56dbc13d9c1254eb740ca48f413e9513f0e533...76188ae4572aee777e60ab3ae9fdafe17d7004f5,1,2,2,4,2,2006-09-17 10:10:25,2006-09-17 10:10:25
76188ae4572aee777e60ab3ae9fdafe17d7004f5...826bb93cc35a602f27d713a40e9714dedcfb5d47,5,140,134,274,9,2006-09-17 11:41:44,2006-09-17 11:41:44
826bb93cc35a602f27d713a40e9714dedcfb5d47...c12bce204620fd2ca95099030da98013a9490c37,1,19,2,21,3,2006-09-17 11:43:16,2006-09-17 11:43:16
c12bce204620fd2ca95099030da98013a9490c37...51a07a6a5f8b1e58fbbce6bcfe4d909a3f9ca964,1,11,0,11,3,2006-09-17 11:58:44,2006-09-17 11:58:44
51a07a6a5f8b1e58fbbce6bcfe4d909a3f9ca964...4dcbfc92c391983059b920d2a500c1246869f4c7,1,6,0,6,1,2006-09-18 12:58:17,2006-09-18 12:58:17
4dcbfc92c391983059b920d2a500c1246869f4c7...b0c3711d3e8bd844d1cfa8569864df1c1f73180a,6,190,127,317,6,2006-09-19 09:49:22,2006-09-19 09:49:22
b0c3711d3e8bd844d1cfa8569864df1c1f73180a...b5a33456e3feaafd50f41c201a714f9525e1d889,1,4,1,5,3,2006-09-19 10:18:57,2006-09-19 10:18:57
b5a33456e3feaafd50f41c201a714f9525e1d889...ca5b83c5c9619e12827f2e92adb6e6c5708df88e,1,4,0,4,2,2006-09-19 10:51:24,2006-09-19 10:51:24
ca5b83c5c9619e12827f2e92adb6e6c5708df88e...94b0bf5f2b7a4003196a679649567a13d0f13ad0,1,22,1,23,3,2006-09-22 21:07:04,2006-09-22 21:07:04
94b0bf5f2b7a4003196a679649567a13d0f13ad0...b240975a919eacfdaf14a77bb8e270502133e2c4,1,3,0,3,1,2006-09-22 21:26:03,2006-09-22 21:26:03
b240975a919eacfdaf14a77bb8e270502133e2c4...3b4eeab0444e7295802a4f090257ac5dac6f556a,1,4,4,8,4,2006-09-22 21:43:20,2006-09-22 21:43:20
3b4eeab0444e7295802a4f090257ac5dac6f556a...065be00c4ad62224e062643b8be75b4e6569c543,1,1,1,2,1,2006-09-23 08:20:04,2006-09-23 08:20:04
065be00c4ad62224e062643b8be75b4e6569c543...c79f06913801f7d700090e282ecf46123ff8ca65,1,44,5,49,4,2006-09-23 08:21:17,2006-09-23 08:21:17
c79f06913801f7d700090e282ecf46123ff8ca65...327bfb88a2ea85a9a30e5f5a1687d9ac399aa3f1,1,2,2,4,1,2006-09-23 08:34:50,2006-09-23 08:34:50
327bfb88a2ea85a9a30e5f5a1687d9ac399aa3f1...f71726142bfbe20aa6881110759390f5a38183f4,1,9,26,35,7,2006-09-23 13:11:19,2006-09-23 13:11:19
f71726142bfbe20aa6881110759390f5a38183f4...4c12d0b70e9918a00759c7c31cd0f420318ab525,1,1,1,2,1,2006-09-23 13:18:13,2006-09-23 13:18:13
4c12d0b70e9918a00759c7c31cd0f420318ab525...401b58c17e5b1e666ea30c262399254ae0a60a0e,1,191,170,361,24,2006-09-30 14:30:31,2006-09-30 14:30:31
401b58c17e5b1e666ea30c262399254ae0a60a0e...10532fb3ae4f18c77263a7cbc0840e9eb3805de4,1,194,98,292,17,2006-09-30 14:32:49,2006-09-30 14:32:49
10532fb3ae4f18c77263a7cbc0840e9eb3805de4...cc5625067a6bb75d357181cf6483ae0ab367c73f,1,12,2,14,3,2006-09-30 14:34:01,2006-09-30 14:34:01
cc5625067a6bb75d357181cf6483ae0ab367c73f...308d771dd1973015166f0ac3b6cc7d538f7911c4,6,43,5,48,8,2006-09-30 14:34:49,2006-09-30 14:34:49
308d771dd1973015166f0ac3b6cc7d538f7911c4...47200bc76f83784f448bda31ac2cb166647aca71,1,4,0,4,2,2006-10-01 13:15:11,2006-10-01 13:15:11
47200bc76f83784f448bda31ac2cb166647aca71...7dd456176d399a27784f22e58168ba9db95df8f5,1,60,7,67,10,2006-10-01 14:05:10,2006-10-01 14:05:10
7dd456176d399a27784f22e58168ba9db95df8f5...e94db76ada82c6a00d557e4452738bb3a81229b7,1,24,2,26,6,2006-10-01 14:15:56,2006-10-01 14:15:56
e94db76ada82c6a00d557e4452738bb3a81229b7...08d865862a0d26f8ca616ff5a39d97203bda9614,1,12,2,14,3,2006-10-01 14:32:29,2006-10-01 14:32:29
08d865862a0d26f8ca616ff5a39d97203bda9614...7654d3b833c0161aacc66abd6d861f53f9d8c395,1,2,1,3,1,2006-10-01 15:00:16,2006-10-01 15:00:16
7654d3b833c0161aacc66abd6d861f53f9d8c395...644256759f959b30c6e041adb46714675421fb5d,1,1662,1662,3324,1,2006-10-01 17:40:12,2006-10-01 17:40:12
644256759f959b30c6e041adb46714675421fb5d...feabeb8572979f7888bd73e80f436bece1448e5a,1,49,0,49,3,2006-10-02 16:15:33,2006-10-02 16:15:33
feabeb8572979f7888bd73e80f436bece1448e5a...7609b59c3f32f5836a4fb7b1e01c3c86df778151,1,0,6,6,1,2006-10-02 16:29:48,2006-10-02 16:29:48
7609b59c3f32f5836a4fb7b1e01c3c86df778151...785de349f5d31d8ecb75c6842b3b9d63e90a433d,1,29,19,48,3,2006-10-02 16:45:35,2006-10-02 16:45:35
785de349f5d31d8ecb75c6842b3b9d63e90a433d...ad2a6bd91626efbaf9509c9643c60679b1fab942,1,2,0,2,1,2006-10-02 16:58:33,2006-10-02 16:58:33
ad2a6bd91626efbaf9509c9643c60679b1fab942...9203775234e83c48411b8b182df72c41532250d0,2,28,25,53,11,2006-10-03 07:47:45,2006-10-03 07:47:45
9203775234e83c48411b8b182df72c41532250d0...301e2b64937cf1b03899f0583a9c6de1086820a5,1,2,2,4,1,2006-10-03 08:37:58,2006-10-03 08:37:58
301e2b64937cf1b03899f0583a9c6de1086820a5...215f785de699015ba7221f3414807f9e7474ef4d,1,1,1,2,1,2006-10-03 08:45:16,2006-10-03 08:45:16
215f785de699015ba7221f3414807f9e7474ef4d...3672372c1871d3626447006f0dccc4858a6aeedf,1,0,46,46,1,2006-10-03 09:35:19,2006-10-03 09:35:19
3672372c1871d3626447006f0dccc4858a6aeedf...3527e8f6745786e65dc209f1518372f3270a9920,2,5,5,10,4,2006-10-03 09:40:16,2006-10-03 09:40:16
3527e8f6745786e65dc209f1518372f3270a9920...374dbbe80a3df30f52505a9c3ebd31efef711ec0,1,1,1,2,1,2006-10-03 10:54:55,2006-10-03 10:54:55
374dbbe80a3df30f52505a9c3ebd31efef711ec0...eee853f120b61673191ffbbbf97e8ebb2f545751,1,0,13,13,1,2006-10-03 10:55:09,2006-10-03 10:55:09
eee853f120b61673191ffbbbf97e8ebb2f545751...004f3dd51799fa0a32379c8168c71c8b4690774f,2,3,0,3,2,2006-10-03 14:58:57,2006-10-03 14:58:57
004f3dd51799fa0a32379c8168c71c8b4690774f...25ee2d8e2efaf4cad8a6d4c247013e573d9d66e9,1,4,1,5,2,2006-10-03 18:33:02,2006-10-03 18:33:02
25ee2d8e2efaf4cad8a6d4c247013e573d9d66e9...d9ebe848d01d90bbc7397e6f115d47bd44ebfbf8,1,138,0,138,1,2006-10-05 07:40:31,2006-10-05 07:40:31
d9ebe848d01d90bbc7397e6f115d47bd44ebfbf8...1ffa984e0d27a832245920d045b88c94c00a998c,2,3982,3982,7964,2,2006-10-06 13:00:38,2006-10-06 13:00:38
1ffa984e0d27a832245920d045b88c94c00a998c...c5943ff9bbc62afe434901e0aa0f28f0c60ba94a,1,1,1,2,1,2006-10-06 14:05:30,2006-10-06 14:05:30
c5943ff9bbc62afe434901e0aa0f28f0c60ba94a...29f3fd50f717b8e0592f46c6ab8bfd5d77e8e063,1,7,0,7,1,2006-10-06 14:14:00,2006-10-06 14:14:00
29f3fd50f717b8e0592f46c6ab8bfd5d77e8e063...cc967562cae77d62f8288ead533ec1a7da539d0a,1,5,2,7,2,2006-10-06 14:26:52,2006-10-06 14:26:52
cc967562cae77d62f8288ead533ec1a7da539d0a...e218628dda347f5aa9241046780f3345713d7a35,1,3,1,4,1,2006-10-06 15:05:58,2006-10-06 15:05:58
e218628dda347f5aa9241046780f3345713d7a35...7b2c84ddbe004ed4ab2ee3982af40b7275d7dfde,4,8,12,20,8,2006-10-06 17:15:33,2006-10-06 17:15:33
7b2c84ddbe004ed4ab2ee3982af40b7275d7dfde...c26ae24a1be9fda111f2c3fc69a3e865bfc1ec31,3,97,87,184,33,2006-10-07 20:06:52,2006-10-07 20:06:52
c26ae24a1be9fda111f2c3fc69a3e865bfc1ec31...012153008398ea8fe57c19184d807250b38164a0,3,14,2,16,3,2006-10-08 09:57:17,2006-10-08 09:57:17
012153008398ea8fe57c19184d807250b38164a0...fac6a87dcf2cb731692ea5baa647293435cdde01,1,1,1,2,1,2006-10-08 14:34:13,2006-10-08 14:34:13
fac6a87dcf2cb731692ea5baa647293435cdde01...b30a469a5a66d1e11fbe1fa0bcc30636a23d4d78,2,5,4,9,2,2006-10-08 16:19:51,2006-10-08 16:19:51
b30a469a5a66d1e11fbe1fa0bcc30636a23d4d78...6cb2e8ee8b801381fba9fcb14078f87de2517926,1,2,2,4,2,2006-10-09 07:24:46,2006-10-09 07:24:46
6cb2e8ee8b801381fba9fcb14078f87de2517926...766c3765bd30e6a643eff99da0f1c293aa2897bd,4,9,5,14,7,2006-10-10 00:23:18,2006-10-10 00:23:18
766c3765bd30e6a643eff99da0f1c293aa2897bd...967eec18317d0451af93b1a86902e80d39086507,2,4,2,6,3,2006-10-10 01:17:47,2006-10-10 01:17:47
967eec18317d0451af93b1a86902e80d39086507...dbee06de85859af59591813d3004e6695b8bb278,6,5974,5974,11948,6,2006-10-10 01:59:20,2006-10-10 01:59:20
dbee06de85859af59591813d3004e6695b8bb278...016bd18ba37d095696a3de983008c4719dff6029,1,311,306,617,1,2006-10-10 02:41:44,2006-10-10 02:41:44
016bd18ba37d095696a3de983008c4719dff6029...8526de137ab426a7f9785b545a32a0b05476b2c1,1,2,2,4,2,2006-10-10 13:58:06,2006-10-10 13:58:06
8526de137ab426a7f9785b545a32a0b05476b2c1...c901863b31e4550d44f4512106c102cb4fac285e,1,3,4,7,2,2006-10-10 14:14:55,2006-10-10 14:14:55
c901863b31e4550d44f4512106c102cb4fac285e...cafd40805a20d02fe1a904a4c0a0cc6f0c525f80,1,1,1,2,1,2006-10-10 15:00:54,2006-10-10 15:00:54
cafd40805a20d02fe1a904a4c0a0cc6f0c525f80...692d676e993b198e30c8940ab61745d7578229bf,1,1,1,2,1,2006-10-10 17:48:43,2006-10-10 17:48:43
692d676e993b198e30c8940ab61745d7578229bf...05164f34be95f271301d5dbd9a1d13207b3bf850,1,8,0,8,1,2006-10-10 21:28:00,2006-10-10 21:28:00
05164f34be95f271301d5dbd9a1d13207b3bf850...8365b37c483a597774d4d4617bd9d0d7cd87c926,1,1,1,2,1,2006-10-11 04:09:08,2006-10-11 04:09:08
8365b37c483a597774d4d4617bd9d0d7cd87c926...dde208fc4b60aa183899687ec071a6c31556ead2,1,5,1,6,2,2006-10-11 04:23:04,2006-10-11 04:23:04
dde208fc4b60aa183899687ec071a6c31556ead2...6de5a6b96a72f7b0b2cc54fa7df5410664b6e18b,1,1,1,2,1,2006-10-11 12:51:26,2006-10-11 12:51:26
6de5a6b96a72f7b0b2cc54fa7df5410664b6e18b...2e544e9eb89c87b9eac6df445474d21e9be604eb,3,30,9,39,5,2006-10-11 13:35:05,2006-10-11 13:35:05
2e544e9eb89c87b9eac6df445474d21e9be604eb...96d429b940be462d5908d9a79fbcb2717f9211e5,1,3,3,6,3,2006-10-12 16:30:54,2006-10-12 16:30:54
96d429b940be462d5908d9a79fbcb2717f9211e5...edb54ef7334831d47591569316beb69e8ad717d6,1,2,2,4,2,2006-10-12 16:37:01,2006-10-12 16:37:01
edb54ef7334831d47591569316beb69e8ad717d6...ba7dc19416cf087c6b9c590234bac78b218d5874,1,1,1,2,1,2006-10-13 12:36:21,2006-10-13 12:36:21
ba7dc19416cf087c6b9c590234bac78b218d5874...cb53fc02b68ca267f9eddd8fd4f5d92ef08ae022,3,63,13,76,11,2006-10-13 13:57:55,2006-10-13 13:57:55
cb53fc02b68ca267f9eddd8fd4f5d92ef08ae022...bfa8306633da9c2500e4f3e190c81a9827a8f95a,1,2,0,2,1,2006-10-13 14:02:29,2006-10-13 14:02:29
bfa8306633da9c2500e4f3e190c81a9827a8f95a...e7669f64d88612884df27c5744558191f8e6c8b1,3,37,3,40,3,2006-10-13 14:56:14,2006-10-13 14:56:14
e7669f64d88612884df27c5744558191f8e6c8b1...af961d58c244224c14f3bb519214485cb670c64d,3,10,7,17,8,2006-10-15 02:57:55,2006-10-15 02:57:55
af961d58c244224c14f3bb519214485cb670c64d...c9511ef948ec3fd58bfd0af8898ef66abdc80255,1,9,0,9,3,2006-10-15 03:11:02,2006-10-15 03:11:02
c9511ef948ec3fd58bfd0af8898ef66abdc80255...2e23d0168e6d820a0264792ef256fb33ec9bb700,1,2,2,4,2,2006-10-15 17:03:08,2006-10-15 17:03:08
2e23d0168e6d820a0264792ef256fb33ec9bb700...688c724b1f07b3e0ca7cb27b1d9f76b7b11959ce,1,3,0,3,1,2006-10-15 22:47:58,2006-10-15 22:47:58
688c724b1f07b3e0ca7cb27b1d9f76b7b11959ce...6f7cd669597cbcf026886074fb31963fe767e2b3,3,48,33,81,9,2006-10-17 15:34:19,2006-10-17 15:34:19
6f7cd669597cbcf026886074fb31963fe767e2b3...14b09024cbe39bc16200448170ccbd183e3a9ec2,2,9,4,13,6,2006-10-17 19:12:22,2006-10-17 19:12:22
14b09024cbe39bc16200448170ccbd183e3a9ec2...ca91d7896325b594ce60621c4e420dc84719302a,1,5,3,8,1,2006-10-18 04:32:31,2006-10-18 04:32:31
ca91d7896325b594ce60621c4e420dc84719302a...24142f60314f916a3eef563553c3305d26112e08,1,31,37,68,6,2006-10-19 18:31:09,2006-10-19 18:31:09
24142f60314f916a3eef563553c3305d26112e08...4bcb578c794acd913ec1f42793ce4b1a7388025c,1,9,8,17,4,2006-10-19 21:47:05,2006-10-19 21:47:05
4bcb578c794acd913ec1f42793ce4b1a7388025c...215aab279379d65c360e28b28c9dbeafb043971f,1,20,7,27,9,2006-10-20 15:07:40,2006-10-20 15:07:40
215aab279379d65c360e28b28c9dbeafb043971f...f1f3d6f300f6db94910b11f387c7f9b741627c02,1,7,4,11,1,2006-10-25 14:05:25,2006-10-25 14:05:25
f1f3d6f300f6db94910b11f387c7f9b741627c02...513122442717ee350ce6e7ff6e7227cce54c0444,2,12,2,14,4,2006-10-26 10:58:23,2006-10-26 10:58:23
513122442717ee350ce6e7ff6e7227cce54c0444...897fbfe89c90de5f20a3eed2aeb187c625cfb43d,2,26,21,47,11,2006-10-26 12:41:25,2006-10-26 12:41:25
897fbfe89c90de5f20a3eed2aeb187c625cfb43d...44e4b36c083fd0728c5a73c7b71b118c336eb5d7,0,0,0,0,0,2006-10-26 15:53:47,2006-10-26 15:53:47
44e4b36c083fd0728c5a73c7b71b118c336eb5d7...476cbd2f1afd39e32feb350a732877c18f9f7715,2,21,26,47,11,2006-10-26 16:09:55,2006-10-26 16:09:55
476cbd2f1afd39e32feb350a732877c18f9f7715...fce3c7f74bea447340645b9929c46797b9779f8c,1,0,312,312,1,2006-10-26 19:21:54,2006-10-26 19:21:54
fce3c7f74bea447340645b9929c46797b9779f8c...3980dc92955a62bdfeb9f3b0572bfe64155a125d,2,89,5,94,7,2006-10-26 23:11:34,2006-10-26 23:11:34
3980dc92955a62bdfeb9f3b0572bfe64155a125d...440d512edd1c13164395859dffc792c2c32c3006,1,3,4,7,3,2006-10-27 01:19:27,2006-10-27 01:19:27
440d512edd1c13164395859dffc792c2c32c3006...4e5b46f7f624b119633390385560e09ab3d38fa8,2,21,17,38,5,2006-10-27 08:10:00,2006-10-27 08:10:00
4e5b46f7f624b119633390385560e09ab3d38fa8...8b875055eceb720e14ddac8f6096d08b532c7b5f,1,1,0,1,1,2006-10-27 08:23:25,2006-10-27 08:23:25
8b875055eceb720e14ddac8f6096d08b532c7b5f...c6860d55d4d11206c2fe5d5fd3393d972d9a8ff3,1,1,0,1,1,2006-10-27 09:25:46,2006-10-27 09:25:46
c6860d55d4d11206c2fe5d5fd3393d972d9a8ff3...83b0e17f3fc1b0ed9993827d2308c344392926d4,1,7,6,13,2,2006-10-27 10:49:18,2006-10-27 10:49:18
83b0e17f3fc1b0ed9993827d2308c344392926d4...4b3b2c1f42d6df46377c05b90bf9bcc664356d0e,1,10,40,50,3,2006-10-27 12:32:14,2006-10-27 12:32:14
4b3b2c1f42d6df46377c05b90bf9bcc664356d0e...fc351ba2791e63a31fc16a9478e007d88ee9bb18,1,1,1,2,1,2006-10-27 15:15:44,2006-10-27 15:15:44
fc351ba2791e63a31fc16a9478e007d88ee9bb18...4e3da33c59fafe34e237585743e86e24ba81046e,1,1,1,2,1,2006-10-28 03:02:47,2006-10-28 03:02:47
4e3da33c59fafe34e237585743e86e24ba81046e...7ec65c268355c52c871cf1e015fdd5551b83e0b7,1,0,1,1,1,2006-10-28 17:16:23,2006-10-28 17:16:23
7ec65c268355c52c871cf1e015fdd5551b83e0b7...939e92bea62dfd86de2f2b1a559617c5da1eeef2,1,5,4,9,5,2006-11-01 10:23:22,2006-11-01 10:23:22
939e92bea62dfd86de2f2b1a559617c5da1eeef2...40b55adf5c22542985c3f7fc2717df9604a3d973,1,1,1,2,1,2006-11-01 21:59:56,2006-11-01 21:59:56
40b55adf5c22542985c3f7fc2717df9604a3d973...ddd110c9e583fb43257ae1b9b06223bdc7e21f31,1,16,10,26,7,2006-11-02 14:43:20,2006-11-02 14:43:20
ddd110c9e583fb43257ae1b9b06223bdc7e21f31...4f92b3430119e734dea39ab4f4636e64d2c26903,1,5,7,12,2,2006-11-02 18:53:40,2006-11-02 18:53:40
4f92b3430119e734dea39ab4f4636e64d2c26903...0c45d03c70c322825c5532466f9ac1201e79d1d5,1,1,1,2,1,2006-11-02 19:53:11,2006-11-02 19:53:11
0c45d03c70c322825c5532466f9ac1201e79d1d5...d6d331696210c10f0502bd0effa0750ded27b420,1,1,1,2,1,2006-11-02 21:03:08,2006-11-02 21:03:08
d6d331696210c10f0502bd0effa0750ded27b420...e9917ab8373b5e79c2a4315ad7f75be2cecf5ae1,1,1,1,2,1,2006-11-02 23:07:13,2006-11-02 23:07:13
e9917ab8373b5e79c2a4315ad7f75be2cecf5ae1...7b780def0d7843e26d6a26dbc60499ea75f09e59,3,78,49,127,28,2006-11-03 11:30:57,2006-11-03 11:30:57
7b780def0d7843e26d6a26dbc60499ea75f09e59...7d58c0f93698b85001ff68e1e2605930aec5e4df,1,67,67,134,67,2006-11-04 21:09:05,2006-11-04 21:09:05
7d58c0f93698b85001ff68e1e2605930aec5e4df...78ed830b9bd48e2fd5349854d40c4bef0d907caa,1,2,0,2,1,2006-11-07 03:34:47,2006-11-07 03:34:47
78ed830b9bd48e2fd5349854d40c4bef0d907caa...2aa96154b76050f7e0cdd7413c7f332350a79609,1,169,148,317,16,2006-11-07 10:01:45,2006-11-07 10:01:45
2aa96154b76050f7e0cdd7413c7f332350a79609...d91ee794ba481f2fbac3329e01a18cf7ced5b1a3,1,1,1,2,1,2006-11-07 10:30:47,2006-11-07 10:30:47
d91ee794ba481f2fbac3329e01a18cf7ced5b1a3...98e8ea3186e3b57955e94364c454de40f458ea0a,2,7,11,18,5,2006-11-07 11:19:44,2006-11-07 11:19:44
98e8ea3186e3b57955e94364c454de40f458ea0a...83e98c28ef8aba11e525bf4266f8454232236ca0,1,3,0,3,2,2006-11-07 11:32:21,2006-11-07 11:32:21
83e98c28ef8aba11e525bf4266f8454232236ca0...ce2555ea7c265d0e08084b469d785d3d719445f6,1,1,1,2,1,2006-11-07 16:56:10,2006-11-07 16:56:10
ce2555ea7c265d0e08084b469d785d3d719445f6...e07bfbef2d12e03d81f88c99275a63698b643bcc,1,1,1,2,1,2006-11-08 09:44:04,2006-11-08 09:44:04
e07bfbef2d12e03d81f88c99275a63698b643bcc...c0e0119c3d8a745ddaed0428353d892c30ccc1a5,1,1,1,2,1,2006-11-09 08:22:17,2006-11-09 08:22:17
c0e0119c3d8a745ddaed0428353d892c30ccc1a5...03b0a9c654727e4bb551865793548c907687a4ae,4,9,4,13,5,2006-11-09 21:16:03,2006-11-09 21:16:03
03b0a9c654727e4bb551865793548c907687a4ae...d8fb55597026a0ebd9bc3535571f62b4c836be34,1,1,1,2,1,2006-11-09 21:25:07,2006-11-09 21:25:07
d8fb55597026a0ebd9bc3535571f62b4c836be34...7ff54c403435bbb9f0e66caf6e5f6a663acc543d,1,33,35,68,12,2006-11-11 11:34:51,2006-11-11 11:34:51
7ff54c403435bbb9f0e66caf6e5f6a663acc543d...d0eda6827f9bfcf88906e4e45f357cb40e425a05,1,4,4,8,3,2006-11-11 12:08:48,2006-11-11 12:08:48
d0eda6827f9bfcf88906e4e45f357cb40e425a05...93c1340d5504264584d8837b87c1b58dc8a8ac50,1,2,1,3,1,2006-11-11 12:11:37,2006-11-11 12:11:37
93c1340d5504264584d8837b87c1b58dc8a8ac50...9261e7ee13d867b3434ea0d9617ca30844318966,1,2,2,4,2,2006-11-13 10:37:42,2006-11-13 10:37:42
9261e7ee13d867b3434ea0d9617ca30844318966...044d47a504b73b66518852374e04024d22a75662,1,32,65,97,24,2006-11-14 21:02:41,2006-11-14 21:02:41
044d47a504b73b66518852374e04024d22a75662...fcc99cd0f5464d8172405ad33b797e74d751b4c6,1,1,1,2,1,2006-11-15 01:58:02,2006-11-15 01:58:02
fcc99cd0f5464d8172405ad33b797e74d751b4c6...d6ab3c71ac49f370367f28e0bdf433c173adbdb1,1,2,2,4,1,2006-11-15 10:07:22,2006-11-15 10:07:22
d6ab3c71ac49f370367f28e0bdf433c173adbdb1...db621dd8ddf90259d4a170691fdd15574c2c011b,2,10,5,15,4,2006-11-15 10:08:08,2006-11-15 10:08:08
db621dd8ddf90259d4a170691fdd15574c2c011b...f12df1df853d9ddabe45164f03c811ba01b6bfd2,1,1,5,6,2,2006-11-15 15:53:14,2006-11-15 15:53:14
f12df1df853d9ddabe45164f03c811ba01b6bfd2...32816eff59095841e078cf5a7bf637ea64c4c801,1,6,5,11,1,2006-11-15 17:13:07,2006-11-15 17:13:07
32816eff59095841e078cf5a7bf637ea64c4c801...317ea5caeacdae60ef759fd1e35c9219c9e14c87,1,9,2,11,1,2006-11-16 10:30:14,2006-11-16 10:30:14
317ea5caeacdae60ef759fd1e35c9219c9e14c87...6404d6e3ecfc369c45c2e9661628402d0a6e9898,1,1,0,1,1,2006-11-16 20:39:28,2006-11-16 20:39:28
6404d6e3ecfc369c45c2e9661628402d0a6e9898...06c185321c4d6feea0894146db0547caf9b4768a,1,12,8,20,5,2006-11-16 21:42:35,2006-11-16 21:42:35
06c185321c4d6feea0894146db0547caf9b4768a...1e620109d7bd3f77f770f5dbe22f3ef616fa0bb0,2,20,13,33,9,2006-11-17 09:56:30,2006-11-17 09:56:30
1e620109d7bd3f77f770f5dbe22f3ef616fa0bb0...c119a80ea37a6940ec55dfb7b9f9b296800c7928,1,6,2,8,3,2006-11-17 10:15:31,2006-11-17 10:15:31
c119a80ea37a6940ec55dfb7b9f9b296800c7928...cb0fbbbac1ccad88fe548d9e1fe2b8d791098eb0,1,8,1,9,3,2006-11-17 14:49:44,2006-11-17 14:49:44
cb0fbbbac1ccad88fe548d9e1fe2b8d791098eb0...797ccbaf3185e501a52b5a3517126fdbab03764c,1,22,7,29,7,2006-11-18 10:37:33,2006-11-18 10:37:33
797ccbaf3185e501a52b5a3517126fdbab03764c...7cc550727c4e0bcd93c5d435f0799f568fc74dfa,12,930,746,1676,96,2006-11-18 13:37:01,2006-11-18 13:37:01
7cc550727c4e0bcd93c5d435f0799f568fc74dfa...46faa03820f82e5b03e6b3d73bd9d5b194b2b310,2,14,6,20,5,2006-11-20 20:37:28,2006-11-20 20:37:28
46faa03820f82e5b03e6b3d73bd9d5b194b2b310...a87fa0188b8e0f56881afdfe0e7a7afb49eb0619,3,6,5,11,3,2006-11-20 20:54:42,2006-11-20 20:54:42
a87fa0188b8e0f56881afdfe0e7a7afb49eb0619...26cda0c1e549da365ae13cabcb7d0a84e0dad2b7,1,1,1,2,1,2006-11-20 21:01:17,2006-11-20 21:01:17
26cda0c1e549da365ae13cabcb7d0a84e0dad2b7...15a30ba90cb4ff46ea17e775dd20f38f3c07e112,1,9,2,11,2,2006-11-21 09:14:29,2006-11-21 09:14:29
15a30ba90cb4ff46ea17e775dd20f38f3c07e112...953bf593a6233d9f480ee3f706d21950590f40ef,1,1,1,2,1,2006-11-21 09:21:38,2006-11-21 09:21:38
953bf593a6233d9f480ee3f706d21950590f40ef...ae58d24fd55e33b9977516988e696466fdaefa18,4,22,28,50,16,2006-11-21 09:55:34,2006-11-21 09:55:34
ae58d24fd55e33b9977516988e696466fdaefa18...c95283119c423ef2d3ff842edb2797f31aff587c,1,7,9,16,8,2006-11-21 10:01:48,2006-11-21 10:01:48
c95283119c423ef2d3ff842edb2797f31aff587c...a2ab7ef088046c8e3af7e38dabb8746050e97396,2,8,6,14,3,2006-11-22 09:58:57,2006-11-22 09:58:57
a2ab7ef088046c8e3af7e38dabb8746050e97396...fea94528e2cad2d94e4e642273a5a98eb98c1729,1,1,1,2,1,2006-11-28 11:36:54,2006-11-28 11:36:54
fea94528e2cad2d94e4e642273a5a98eb98c1729...3ab145e5aaf68fca0973cb3a8a268739729a90d6,2,6,4,10,3,2006-11-29 20:22:29,2006-11-29 20:22:29
3ab145e5aaf68fca0973cb3a8a268739729a90d6...c136717119ec986be67848ec45b56e23d77d51fd,1,1,1,2,1,2006-11-29 23:25:33,2006-11-29 23:25:33
c136717119ec986be67848ec45b56e23d77d51fd...d98283a3a39b2fd4d2b0986c34c92f8c7b3c4e54,1,11,4,15,2,2006-11-30 20:39:33,2006-11-30 20:39:33
d98283a3a39b2fd4d2b0986c34c92f8c7b3c4e54...dc6f9cfc9cd0e2393b8f3087d8fcfa8e03260d4c,2,25,10,35,4,2006-11-30 20:52:24,2006-11-30 20:52:24
dc6f9cfc9cd0e2393b8f3087d8fcfa8e03260d4c...68313e77488d98d7419e87c7090d4ec9b9d4882b,1,3,3,6,2,2006-11-30 21:12:15,2006-11-30 21:12:15
68313e77488d98d7419e87c7090d4ec9b9d4882b...ef1ee513d314123017fce770e8fe0a9c85b9eb87,2,3669,3636,7305,2,2006-11-30 21:24:42,2006-11-30 21:24:42
ef1ee513d314123017fce770e8fe0a9c85b9eb87...39c05d36493f215155cf446f7d879d3bc96ac2f7,1,12,4,16,5,2006-12-02 13:43:02,2006-12-02 13:43:02
39c05d36493f215155cf446f7d879d3bc96ac2f7...94e59e287a9fde9425cd96713e8130aef06bc431,2,80,111,191,40,2006-12-03 11:06:32,2006-12-03 11:06:32
94e59e287a9fde9425cd96713e8130aef06bc431...a6ce3031871aca7c067672e91d298dd2a5bf176c,2,27,5,32,5,2006-12-04 19:37:49,2006-12-04 19:37:49
a6ce3031871aca7c067672e91d298dd2a5bf176c...2bdd208e4100f0b28b595b93eb07f18f63aa8ce5,2,5,5,10,4,2006-12-04 19:40:25,2006-12-04 19:40:25
2bdd208e4100f0b28b595b93eb07f18f63aa8ce5...47a6a32b27f7af24dec5dc963fa951177a091cd2,1,6,0,6,1,2006-12-04 20:42:38,2006-12-04 20:42:38
47a6a32b27f7af24dec5dc963fa951177a091cd2...f1c91fd023ad0bbd01a386bca4d8503e0e27df73,3,8,8,16,6,2006-12-05 22:58:27,2006-12-05 22:58:27
f1c91fd023ad0bbd01a386bca4d8503e0e27df73...12d13d9adaea1139b0928180c17aa83eef5d5c6a,1,24,0,24,1,2006-12-08 09:26:50,2006-12-08 09:26:50
12d13d9adaea1139b0928180c17aa83eef5d5c6a...010a112e048f932aff7feeb9987eec7a64e5328b,2,58,22,80,25,2006-12-11 08:53:33,2006-12-11 08:53:33
010a112e048f932aff7feeb9987eec7a64e5328b...a8bafe78745247dd13e3472582df29471e50aa28,1,1,1,2,1,2006-12-11 08:59:50,2006-12-11 08:59:50
a8bafe78745247dd13e3472582df29471e50aa28...df61a63fca0bc7d1d3e3a0e7ec1e06ce2bd8fb53,1,6,1,7,2,2006-12-11 09:22:33,2006-12-11 09:22:33
df61a63fca0bc7d1d3e3a0e7ec1e06ce2bd8fb53...665e1959cc03292a5109796dc1618d3848ec6f6e,1,5,5,10,2,2006-12-11 09:25:44,2006-12-11 09:25:44
665e1959cc03292a5109796dc1618d3848ec6f6e...3e3240f7ed52c035f3f68d50836f089bd2d03409,1,10,6,16,2,2006-12-11 09:38:03,2006-12-11 09:38:03
3e3240f7ed52c035f3f68d50836f089bd2d03409...2d2839a576b3e5f83f260dd6b4435e9c5a407f96,1,14,0,14,1,2006-12-11 14:30:55,2006-12-11 14:30:55
2d2839a576b3e5f83f260dd6b4435e9c5a407f96...025049a67a01399b38281bed9af189be5395c46d,1,1,1,2,1,2006-12-11 14:32:53,2006-12-11 14:32:53
025049a67a01399b38281bed9af189be5395c46d...fb11b33d68f64ea446f2f8c6d3ef2aed3652349f,1,5,4,9,4,2006-12-12 18:26:52,2006-12-12 18:26:52
fb11b33d68f64ea446f2f8c6d3ef2aed3652349f...6ac46e6a5a6cac509626267865980f4dfbeebc2d,4,66,18,84,13,2006-12-12 20:33:10,2006-12-12 20:33:10
6ac46e6a5a6cac509626267865980f4dfbeebc2d...ed37ca66e5f79b4250f38cbd7a7f809ebfc15a20,1,1,1,2,1,2006-12-13 01:23:23,2006-12-13 01:23:23
ed37ca66e5f79b4250f38cbd7a7f809ebfc15a20...3e165ae5ab080236eb0df35c691d6f3127c6499e,1,4,4,8,1,2006-12-13 19:04:36,2006-12-13 19:04:36
3e165ae5ab080236eb0df35c691d6f3127c6499e...18e330741f7e80aaa38ca700ab8a5884d6e671eb,1,3,3,6,3,2006-12-15 08:20:46,2006-12-15 08:20:46
18e330741f7e80aaa38ca700ab8a5884d6e671eb...898ca3198b3297f68eb77ad128450ad8f952e15e,3,133,91,224,68,2006-12-15 09:13:24,2006-12-15 09:13:24
898ca3198b3297f68eb77ad128450ad8f952e15e...7a724180a726c7b041d87494a4cf8780fc90e216,1,2,2,4,1,2006-12-18 22:08:10,2006-12-18 22:08:10
7a724180a726c7b041d87494a4cf8780fc90e216...0e540ec1b170c11cab11045b4965a927cb44ee34,2,50,38,88,20,2006-12-19 04:31:33,2006-12-19 04:31:33
0e540ec1b170c11cab11045b4965a927cb44ee34...42785b1c1dbdb51e798de90720a164731f495e44,2,8,3,11,4,2006-12-19 18:52:45,2006-12-19 18:52:45
42785b1c1dbdb51e798de90720a164731f495e44...dd27ea5830e0fb9116642a0e779ea18c31179379,2,3,0,3,2,2006-12-19 19:06:36,2006-12-19 19:06:36
dd27ea5830e0fb9116642a0e779ea18c31179379...0d149e52e6d3326730c6a5e688d5496a7ab91a87,2,14,15,29,9,2006-12-20 11:05:08,2006-12-20 11:05:08
0d149e52e6d3326730c6a5e688d5496a7ab91a87...d23e0c51701569126a04a8062581a7606c731b12,1,2,0,2,1,2006-12-20 11:11:33,2006-12-20 11:11:33
d23e0c51701569126a04a8062581a7606c731b12...2abdbd4e30f28347840a1861968b2f8a73d8883a,1,1,1,2,1,2006-12-20 11:25:15,2006-12-20 11:25:15
2abdbd4e30f28347840a1861968b2f8a73d8883a...8f1e0ef25370c1b7f959355c385e76325272b4f6,2,7,0,7,3,2006-12-20 13:10:29,2006-12-20 13:10:29
8f1e0ef25370c1b7f959355c385e76325272b4f6...30f708027f27e100cd73ac2e60d12dc50654381f,2,8,1,9,4,2006-12-20 15:58:28,2006-12-20 15:58:28
30f708027f27e100cd73ac2e60d12dc50654381f...0f5292b991ee83ee956766d6a7eab75445dd4dea,1,6,0,6,1,2006-12-21 12:57:22,2006-12-21 12:57:22
0f5292b991ee83ee956766d6a7eab75445dd4dea...6b8ffe79f4e616d6179f6b16099e7c25e7ae5cb1,4,63,53,116,12,2006-12-21 13:35:32,2006-12-21 13:35:32
6b8ffe79f4e616d6179f6b16099e7c25e7ae5cb1...a0d5e89a1e41c8ebb1b629f6089e4f3b2cb24b2c,1,2,0,2,1,2006-12-21 13:39:14,2006-12-21 13:39:14
a0d5e89a1e41c8ebb1b629f6089e4f3b2cb24b2c...98b1b580c7298c1ced00f9ec4d65452b4d559da7,3,25,16,41,13,2006-12-21 15:23:59,2006-12-21 15:23:59
98b1b580c7298c1ced00f9ec4d65452b4d559da7...ccc4c7663a117f4a9c5469f086d18133ae4f2e38,1,1,1,2,1,2006-12-21 18:37:24,2006-12-21 18:37:24
ccc4c7663a117f4a9c5469f086d18133ae4f2e38...30dc79f1d0aca3ead3980f890a546bc245feb5d5,2,6,10,16,7,2006-12-22 13:52:33,2006-12-22 13:52:33
30dc79f1d0aca3ead3980f890a546bc245feb5d5...fc84b9db10da2f69a830dbb9aa78b9c214b297ae,3,38,26,64,9,2006-12-22 13:56:36,2006-12-22 13:56:36
fc84b9db10da2f69a830dbb9aa78b9c214b297ae...bfdf836da9cf5d0ebd1d6a50c0174bb5b3922d52,2,25,6,31,7,2006-12-22 14:40:46,2006-12-22 14:40:46
bfdf836da9cf5d0ebd1d6a50c0174bb5b3922d52...cc5f46454fbf34ae8a8e526a621cab55e1c79cdb,2,3270,3130,6400,4,2006-12-23 06:07:21,2006-12-23 06:07:21
cc5f46454fbf34ae8a8e526a621cab55e1c79cdb...232da5dde03ae774980c9800950e60f3f4468c68,1,15,15,30,9,2006-12-23 06:17:16,2006-12-23 06:17:16
232da5dde03ae774980c9800950e60f3f4468c68...2abe5934f6793606c8717b6282f54d7eca1bd42c,1,22,0,22,4,2006-12-23 06:26:08,2006-12-23 06:26:08
2abe5934f6793606c8717b6282f54d7eca1bd42c...37ee2df8a81fa4e9fba49dbc166c4e89820f9152,1,2,1,3,1,2006-12-23 06:40:27,2006-12-23 06:40:27
37ee2df8a81fa4e9fba49dbc166c4e89820f9152...c20924818c560f1afd9c60f188c8bc616583217b,2,12,8,20,6,2006-12-23 16:37:49,2006-12-23 16:37:49
c20924818c560f1afd9c60f188c8bc616583217b...baa44a8f2731ec48f5f1b2349db2f956b7173635,2,20,1,21,3,2006-12-23 17:41:00,2006-12-23 17:41:00
baa44a8f2731ec48f5f1b2349db2f956b7173635...ec0dce5f60152461882d9682231428e7e668421a,1,6,3,9,4,2006-12-23 17:43:30,2006-12-23 17:43:30
ec0dce5f60152461882d9682231428e7e668421a...58b8f1ddb8650ed69907abb4972064c643933479,1,2,30,32,2,2006-12-23 17:50:02,2006-12-23 17:50:02
58b8f1ddb8650ed69907abb4972064c643933479...a960b2d3b50bd4077b646d020ef0ec3cd7328b88,1,1,1,2,1,2006-12-23 17:54:35,2006-12-23 17:54:35
a960b2d3b50bd4077b646d020ef0ec3cd7328b88...def8c734edd6ab2b8188070520ef2019502ffd98,1,8,6,14,4,2006-12-24 01:16:20,2006-12-24 01:16:20
def8c734edd6ab2b8188070520ef2019502ffd98...b8d46f7b6a38d92d9e0ad0b0df12c773bcf1c634,3,65,17,82,10,2006-12-28 11:37:07,2006-12-28 11:37:07
b8d46f7b6a38d92d9e0ad0b0df12c773bcf1c634...666cc900643ac0779b5d1afd132b23d97f7f09e0,2,6,1,7,3,2006-12-29 13:49:28,2006-12-29 13:49:28
666cc900643ac0779b5d1afd132b23d97f7f09e0...5f4f247df0aa567cea33d3c8e1f43be5bea3264c,1,27,22,49,6,2006-12-29 17:21:48,2006-12-29 17:21:48
5f4f247df0aa567cea33d3c8e1f43be5bea3264c...8937e088b6f06a0dbef36348aef5d7c10f3af340,1,7,3,10,4,2006-12-29 17:51:40,2006-12-29 17:51:40
8937e088b6f06a0dbef36348aef5d7c10f3af340...65a88fae8919e5da774dcc45c9b42220f875b697,1,28,29,57,23,2006-12-29 18:04:26,2006-12-29 18:04:26
65a88fae8919e5da774dcc45c9b42220f875b697...3f6a513b7ee693dfd030cb7c9200f22cfafd2b0f,1,1,1,2,1,2006-12-30 09:44:34,2006-12-30 09:44:34
3f6a513b7ee693dfd030cb7c9200f22cfafd2b0f...09bfb5df0dd385bdf1f6b8bca7c29d3fd98b87c5,2,35,840,875,23,2006-12-30 10:05:45,2006-12-30 10:05:45
09bfb5df0dd385bdf1f6b8bca7c29d3fd98b87c5...8786fa527613dabfec75daf5c94c41a279560c1f,1,2,2,4,2,2006-12-30 10:13:14,2006-12-30 10:13:14
8786fa527613dabfec75daf5c94c41a279560c1f...443e41b74066782c06f799903708fb448a555294,1,2,1,3,1,2006-12-31 00:44:09,2006-12-31 00:44:09
443e41b74066782c06f799903708fb448a555294...1267e796990b500730142fba16679859a6144550,1,2,2,4,2,2006-12-31 02:00:33,2006-12-31 02:00:33
1267e796990b500730142fba16679859a6144550...370c6d564a295cf7d5ccdcafc1bb66d07d615014,2,313,304,617,4,2006-12-31 03:58:43,2006-12-31 03:58:43
370c6d564a295cf7d5ccdcafc1bb66d07d615014...c3d8cb0c09c2d7d5f0fc3a78f8b4cef9b0adc640,4,491,488,979,18,2006-12-31 05:22:06,2006-12-31 05:22:06
c3d8cb0c09c2d7d5f0fc3a78f8b4cef9b0adc640...4c66f62a6fcc84a6c85249d0fb34b93edd40be00,3,48,31,79,28,2006-12-31 15:09:07,2006-12-31 15:09:07
4c66f62a6fcc84a6c85249d0fb34b93edd40be00...8cbb4a0ae6c5f638922c77dcd63060c932fe6806,3,16,2,18,5,2006-12-31 15:44:59,2006-12-31 15:44:59
8cbb4a0ae6c5f638922c77dcd63060c932fe6806...61504d516abcc7bae036056853f21601ad310826,3,141,139,280,3,2006-12-31 18:09:05,2006-12-31 18:09:05
61504d516abcc7bae036056853f21601ad310826...b06dd433b2d77e902c3f643cf791d2a10f63cea6,1,15,5,20,2,2006-12-31 22:03:34,2006-12-31 22:03:34
b06dd433b2d77e902c3f643cf791d2a10f63cea6...79f9678bf51285bc7b00470cf130abe0218b6cbb,1,534,534,1068,2,2007-01-01 14:54:55,2007-01-01 14:54:55
79f9678bf51285bc7b00470cf130abe0218b6cbb...5a6029c9fe3618a6cc6b43356598ee4bfc4c2f2a,2,24,2,26,4,2007-01-01 15:22:10,2007-01-01 15:22:10
5a6029c9fe3618a6cc6b43356598ee4bfc4c2f2a...ee636689f40f8e7f20d41ec41b5e38e561b4e4e3,1,1,0,1,1,2007-01-01 15:26:24,2007-01-01 15:26:24
ee636689f40f8e7f20d41ec41b5e38e561b4e4e3...ac78ad07c2a18a18ec7ce93d56824a55d56768bc,1,12,0,12,1,2007-01-01 17:20:42,2007-01-01 17:20:42
ac78ad07c2a18a18ec7ce93d56824a55d56768bc...41f62e13643462a88fa7d9015346196f3d37b966,1,14,0,14,1,2007-01-01 17:21:46,2007-01-01 17:21:46
41f62e13643462a88fa7d9015346196f3d37b966...407ba8308cc540d5b351041c7ead317920b70347,1,1,1,2,1,2007-01-01 17:29:31,2007-01-01 17:29:31
407ba8308cc540d5b351041c7ead317920b70347...b1e1d5d0c7c7eecee6e79f4530f4a7910641fd1c,1,566,566,1132,3,2007-01-02 11:40:22,2007-01-02 11:40:22
b1e1d5d0c7c7eecee6e79f4530f4a7910641fd1c...19b21ff10ae5f4800f367306cb589c5fe201eed3,1,0,13,13,1,2007-01-02 12:37:17,2007-01-02 12:37:17
19b21ff10ae5f4800f367306cb589c5fe201eed3...9c073265de00b196ddeb298fa01328210ccffd89,1,14,0,14,1,2007-01-02 12:39:13,2007-01-02 12:39:13
9c073265de00b196ddeb298fa01328210ccffd89...651116df95cb7e77f04d5a6411775c27f627d0ed,2,41,121,162,29,2007-01-02 14:32:26,2007-01-02 14:32:26
651116df95cb7e77f04d5a6411775c27f627d0ed...ecf3351792e617a72a5abb22de62400c72906a72,1,19,7,26,13,2007-01-02 14:35:10,2007-01-02 14:35:10
ecf3351792e617a72a5abb22de62400c72906a72...07612d92daee30463576027b98ae58aa777b045a,1,44,68,112,21,2007-01-02 16:42:31,2007-01-02 16:42:31
07612d92daee30463576027b98ae58aa777b045a...0ae7198b9e1614be54eecb5bb0272094996397d9,1,26,39,65,14,2007-01-02 16:43:05,2007-01-02 16:43:05
0ae7198b9e1614be54eecb5bb0272094996397d9...4805a45c0669b298c24005ce6505b49d88f85fe7,1,9,5,14,1,2007-01-02 17:34:56,2007-01-02 17:34:56
4805a45c0669b298c24005ce6505b49d88f85fe7...ca438a718a27eedc25572cafb3fb22780cf9fbb7,3,57,104,161,31,2007-01-02 19:03:12,2007-01-02 19:03:12
ca438a718a27eedc25572cafb3fb22780cf9fbb7...bb816b9c95b3ad8c6335588b4f232599d5838bd6,4,9,10,19,10,2007-01-02 19:05:00,2007-01-02 19:05:00
bb816b9c95b3ad8c6335588b4f232599d5838bd6...af9e5d45fca6b198d27c4e33e7c96d7d802e688a,1,1,1,2,1,2007-01-03 12:57:42,2007-01-03 12:57:42
af9e5d45fca6b198d27c4e33e7c96d7d802e688a...3736ed011b7df5cae9751ef94c16c8d7164d0e58,1,5,0,5,2,2007-01-03 15:16:14,2007-01-03 15:16:14
3736ed011b7df5cae9751ef94c16c8d7164d0e58...865706d2fe6c13066e5097561e39ad1d48adfb9a,1,0,0,0,0,2007-01-03 15:19:22,2007-01-03 15:19:22
865706d2fe6c13066e5097561e39ad1d48adfb9a...02483b4a593fb5ae9bb3925f6fe9641e31e2828e,1,4,1,5,3,2007-01-03 16:03:16,2007-01-03 16:03:16
02483b4a593fb5ae9bb3925f6fe9641e31e2828e...e0c7e6aec4cf55854217d5c0b2c7069ce84a3d12,2,7,2,9,2,2007-01-03 20:48:40,2007-01-03 20:48:40
e0c7e6aec4cf55854217d5c0b2c7069ce84a3d12...df91317ab43254bb0095482c49de080f5cf4f89e,2,23,35,58,15,2007-01-04 09:47:42,2007-01-04 09:47:42
df91317ab43254bb0095482c49de080f5cf4f89e...2daf49296abd4fcdf526a2c2814cd24e8f3eaff0,3,21,16,37,17,2007-01-04 10:03:34,2007-01-04 10:03:34
2daf49296abd4fcdf526a2c2814cd24e8f3eaff0...d1a4077fa8fa710b474ae052ff9d1d7a1ddc5779,1,600,499,1099,1,2007-01-04 12:37:50,2007-01-04 12:37:50
d1a4077fa8fa710b474ae052ff9d1d7a1ddc5779...5e497300aaaa61e1108d50ff9264ac79cbfe3f83,3,151,185,336,118,2007-01-04 12:49:32,2007-01-04 12:49:32
5e497300aaaa61e1108d50ff9264ac79cbfe3f83...783f589fbf005a6a3211bff20e3e8aeb1ea0ac22,1,89,61,150,34,2007-01-04 14:57:22,2007-01-04 14:57:22
783f589fbf005a6a3211bff20e3e8aeb1ea0ac22...04b51d353a45ec413631bf8715152b8c290b467b,1,18,0,18,1,2007-01-04 18:48:48,2007-01-04 18:48:48
04b51d353a45ec413631bf8715152b8c290b467b...150262153be3fcf1bbc7438d9b4c76d1d1d3bd6b,1,5,11,16,7,2007-01-05 06:40:38,2007-01-05 06:40:38
150262153be3fcf1bbc7438d9b4c76d1d1d3bd6b...887b890fa672183f7d6d754ac18478e036a7beb2,2,22,5,27,5,2007-01-05 09:14:15,2007-01-05 09:14:15
887b890fa672183f7d6d754ac18478e036a7beb2...645570310bc60b5bcee1aca4b05606503ad49c95,1,512,621,1133,1,2007-01-05 22:00:48,2007-01-05 22:00:48
645570310bc60b5bcee1aca4b05606503ad49c95...e473f3a9118e4eae8d1aa2c3ab3527944db2e83b,2,505,955,1460,30,2007-01-06 05:09:11,2007-01-06 05:09:11
e473f3a9118e4eae8d1aa2c3ab3527944db2e83b...c330527318775d32c87954f640c53066e7a732d9,2,7,219,226,19,2007-01-06 05:31:47,2007-01-06 05:31:47
c330527318775d32c87954f640c53066e7a732d9...ab0287681f790ad36beb5e35160bedfe181e30f7,1,36,39,75,34,2007-01-06 06:18:02,2007-01-06 06:18:02
ab0287681f790ad36beb5e35160bedfe181e30f7...458d427c0e4af4502e14400110b5327aa2513781,2,12,6,18,6,2007-01-06 22:34:12,2007-01-06 22:34:12
458d427c0e4af4502e14400110b5327aa2513781...f6205e054eb6b04b71f8487d55bb0e5730bb3c52,1,76,80,156,48,2007-01-07 00:28:31,2007-01-07 00:28:31
f6205e054eb6b04b71f8487d55bb0e5730bb3c52...d7b73ea5c7440c49c804b3cafe67e84aafbdd064,5,70,70,140,70,2007-01-07 09:20:19,2007-01-07 09:20:19
d7b73ea5c7440c49c804b3cafe67e84aafbdd064...955fdb87a72e0d85676db932eda9f6a4319306d9,2,4,5,9,3,2007-01-07 10:26:58,2007-01-07 10:26:58
955fdb87a72e0d85676db932eda9f6a4319306d9...46001b94f34f7230482e64f5444346ffc5044f2c,1,12,6,18,4,2007-01-07 11:15:31,2007-01-07 11:15:31
46001b94f34f7230482e64f5444346ffc5044f2c...4451a83407b396a3e52b83667fe51a10bfb31289,1,6,1,7,2,2007-01-07 12:13:32,2007-01-07 12:13:32
4451a83407b396a3e52b83667fe51a10bfb31289...a8f1d0ea4dcd97308a752b81b36ea7329db18881,1,8,11,19,11,2007-01-07 19:56:29,2007-01-07 19:56:29
a8f1d0ea4dcd97308a752b81b36ea7329db18881...386c0bc8a686eaa90be12dd1c6690668ff7442c7,2,6,6,12,6,2007-01-07 20:56:17,2007-01-07 20:56:17
386c0bc8a686eaa90be12dd1c6690668ff7442c7...0798c6e64e4e0c984d5ece50ade61827c2105c39,3,564,512,1076,29,2007-01-07 21:43:38,2007-01-07 21:43:38
0798c6e64e4e0c984d5ece50ade61827c2105c39...33662cd713c28b2db0adccec170ffe93b35f098a,2,3,3,6,3,2007-01-07 22:29:15,2007-01-07 22:29:15
33662cd713c28b2db0adccec170ffe93b35f098a...e1e47cddd64e904606c6d239d1d3e1d647f23df6,1,1,1,2,1,2007-01-07 22:51:41,2007-01-07 22:51:41
e1e47cddd64e904606c6d239d1d3e1d647f23df6...cb0250f1fa5af5c84e858ea978fcaa1194f4694f,2,49,4,53,11,2007-01-07 23:01:49,2007-01-07 23:01:49
cb0250f1fa5af5c84e858ea978fcaa1194f4694f...e50014d47e3f3799031119595a43082ea94afd89,1,2,2,4,1,2007-01-07 23:19:13,2007-01-07 23:19:13
e50014d47e3f3799031119595a43082ea94afd89...e057aeddccc52372b179c53bd88e15af9650353b,1,10,6,16,6,2007-01-07 23:38:37,2007-01-07 23:38:37
e057aeddccc52372b179c53bd88e15af9650353b...c78b1fb9a1f44c640290c1ffdb16b0c1d5531b7b,1,2,0,2,1,2007-01-07 23:42:15,2007-01-07 23:42:15
c78b1fb9a1f44c640290c1ffdb16b0c1d5531b7b...5acecf6e2814701f9e22f91f17fcb33ef910e88a,3,20,7,27,7,2007-01-07 23:59:13,2007-01-07 23:59:13
5acecf6e2814701f9e22f91f17fcb33ef910e88a...12e63353391f1a556a73fe92bcd8e5f0ac277726,4,41,37,78,13,2007-01-08 00:12:41,2007-01-08 00:12:41
12e63353391f1a556a73fe92bcd8e5f0ac277726...b603ca03c460bad9d8cf367ddc0f18ef46a2ef2d,1,9,20,29,7,2007-01-08 01:12:21,2007-01-08 01:12:21
b603ca03c460bad9d8cf367ddc0f18ef46a2ef2d...d0e8a2452ebd30abe403d402e813513cef675694,2,4,8,12,4,2007-01-08 01:17:28,2007-01-08 01:17:28
d0e8a2452ebd30abe403d402e813513cef675694...789f0e1093beb559bb2acef708cc4b27c00f557d,2,11,21,32,5,2007-01-08 01:26:48,2007-01-08 01:26:48
789f0e1093beb559bb2acef708cc4b27c00f557d...32d81db90d6ca32ed41b43cbaea347abb1c86c6e,1,65,59,124,24,2007-01-08 02:39:10,2007-01-08 02:39:10
32d81db90d6ca32ed41b43cbaea347abb1c86c6e...8bcb016dfaa029a5e98cc3c25b9f999053217f36,1,1,1,2,1,2007-01-08 04:51:39,2007-01-08 04:51:39
8bcb016dfaa029a5e98cc3c25b9f999053217f36...d97397d38e4c578cf999ea09c31f20702ff2c387,1,28,24,52,1,2007-01-08 06:08:37,2007-01-08 06:08:37
d97397d38e4c578cf999ea09c31f20702ff2c387...76d6d445bb68009c010e0b91dbf21747bc2d35ba,2,15,2,17,4,2007-01-08 16:12:20,2007-01-08 16:12:20
76d6d445bb68009c010e0b91dbf21747bc2d35ba...aa424984f7c37956f568512aa94bc16787e4c651,1,2,2,4,2,2007-01-09 06:04:54,2007-01-09 06:04:54
aa424984f7c37956f568512aa94bc16787e4c651...ea283bd13130303271077a6ee8b14b7c79bd0ce4,2,11,1,12,3,2007-01-09 15:19:40,2007-01-09 15:19:40
ea283bd13130303271077a6ee8b14b7c79bd0ce4...694becea3898f060ed815cf864ea1d4e87a800fb,1,10,0,10,1,2007-01-09 15:27:00,2007-01-09 15:27:00
694becea3898f060ed815cf864ea1d4e87a800fb...609dec9a78ac98e69b67a73989d8437f67c6d33a,1,2,2,4,1,2007-01-09 15:44:24,2007-01-09 15:44:24
609dec9a78ac98e69b67a73989d8437f67c6d33a...d3d7d7ebff2e1fc6a1e8ea9a620a7560ff71ef1a,1,26,14,40,12,2007-01-09 16:14:22,2007-01-09 16:14:22
d3d7d7ebff2e1fc6a1e8ea9a620a7560ff71ef1a...41cc839a2dff6342aaba048eae36d66d2a25d288,3,106,58,164,4,2007-01-09 17:15:22,2007-01-09 17:15:22
41cc839a2dff6342aaba048eae36d66d2a25d288...028f9d859dfed30e45046f28f5fec12cf6e7b2bf,1,0,97,97,1,2007-01-09 19:54:21,2007-01-09 19:54:21
028f9d859dfed30e45046f28f5fec12cf6e7b2bf...2ad5faf3a1dde0714583cd7ea7e9a40de0dca9ad,1,1,1,2,1,2007-01-09 21:21:01,2007-01-09 21:21:01
2ad5faf3a1dde0714583cd7ea7e9a40de0dca9ad...a3806202ffe1ecc85ba6213f06cc7b6f68c49695,1,2,2,4,2,2007-01-10 00:46:10,2007-01-10 00:46:10
a3806202ffe1ecc85ba6213f06cc7b6f68c49695...6de5275687cabf1016649899407c9cfb26d4ed70,1,1,1,2,1,2007-01-10 01:06:22,2007-01-10 01:06:22
6de5275687cabf1016649899407c9cfb26d4ed70...84ecf3937b156e7892131481ed6b1df230bbbbc7,1,5,3,8,4,2007-01-10 07:00:02,2007-01-10 07:00:02
84ecf3937b156e7892131481ed6b1df230bbbbc7...a5f9108a2109b2ed5778af860b0928d8e6b0fdd2,2,13,3,16,2,2007-01-10 09:37:22,2007-01-10 09:37:22
a5f9108a2109b2ed5778af860b0928d8e6b0fdd2...caad7f814e2cade14e5ccdf62a54b3ffce5ddb4b,2,18,1,19,3,2007-01-10 09:53:18,2007-01-10 09:53:18
caad7f814e2cade14e5ccdf62a54b3ffce5ddb4b...200319ea6b6a59daebce1cfc1d330a9d52c208c0,2,179,26,205,24,2007-01-10 11:08:54,2007-01-10 11:08:54
200319ea6b6a59daebce1cfc1d330a9d52c208c0...9b0aaeebea0d7ad39ae1cf51dac997d475fd06bd,1,3,3,6,1,2007-01-10 11:11:04,2007-01-10 11:11:04
9b0aaeebea0d7ad39ae1cf51dac997d475fd06bd...8ec860d637ca667e8050e0755d55fc1496301d96,2,2,0,2,2,2007-01-10 15:03:40,2007-01-10 15:03:40
8ec860d637ca667e8050e0755d55fc1496301d96...378bb9ded8df94f68a9c712375eda925778c33e4,1,1,1,2,1,2007-01-10 15:04:54,2007-01-10 15:04:54
378bb9ded8df94f68a9c712375eda925778c33e4...3d3237c1c0f3ec60b7b25442fc64c3705043fcd4,1,11,11,22,10,2007-01-10 16:00:22,2007-01-10 16:00:22
3d3237c1c0f3ec60b7b25442fc64c3705043fcd4...62303ad5efa11f0524dde236c91e8cb33ca87b3e,1,7,5,12,4,2007-01-10 16:13:48,2007-01-10 16:13:48
62303ad5efa11f0524dde236c91e8cb33ca87b3e...ee0175c4b9d665322ac496dfcc6f8b0cc70b3c35,1,68,0,68,1,2007-01-10 16:40:32,2007-01-10 16:40:32
ee0175c4b9d665322ac496dfcc6f8b0cc70b3c35...f2ff0db0320cfab0d856ff68d012cb843c97b600,3,61,26,87,15,2007-01-10 17:54:42,2007-01-10 17:54:42
f2ff0db0320cfab0d856ff68d012cb843c97b600...75b6bcdb4206fc8cb0bd4294bdc9fef87c44325d,2,20,13,33,8,2007-01-10 18:06:19,2007-01-10 18:06:19
75b6bcdb4206fc8cb0bd4294bdc9fef87c44325d...7b439921c48070e7b01ebda3580e0ada01a082b5,1,2,2,4,1,2007-01-10 18:26:13,2007-01-10 18:26:13
7b439921c48070e7b01ebda3580e0ada01a082b5...c6e6e72561979ab80aaf5ce1ab63d3dd010382a3,2,23,2,25,7,2007-01-10 18:46:41,2007-01-10 18:46:41
c6e6e72561979ab80aaf5ce1ab63d3dd010382a3...bb3520432673f18c3e461cb319e4be6bf547f23d,1,1,0,1,1,2007-01-10 21:19:20,2007-01-10 21:19:20
bb3520432673f18c3e461cb319e4be6bf547f23d...c69047213514549551f3f612968bc669561e17c5,1,1,1,2,1,2007-01-10 21:31:18,2007-01-10 21:31:18
c69047213514549551f3f612968bc669561e17c5...07aa989ce912e2bcdee79074e119599aa5eb72f6,1,2,2,4,2,2007-01-11 03:57:19,2007-01-11 03:57:19
07aa989ce912e2bcdee79074e119599aa5eb72f6...9449591eef44360b5bfdb9a23cea1f4a1a6f3c33,1,1,1,2,1,2007-01-11 04:52:41,2007-01-11 04:52:41
9449591eef44360b5bfdb9a23cea1f4a1a6f3c33...74c06be3ea29d246194815342a79ea798ea56771,1,10,2,12,3,2007-01-11 07:31:40,2007-01-11 07:31:40
74c06be3ea29d246194815342a79ea798ea56771...d1390665b6e7d475d237cafcf8948440c9adfbf8,1,1,1,2,1,2007-01-11 07:41:56,2007-01-11 07:41:56
d1390665b6e7d475d237cafcf8948440c9adfbf8...fd30d7746d1b98b362f796f235805061d63d514f,1,1,1,2,1,2007-01-11 13:57:40,2007-01-11 13:57:40
fd30d7746d1b98b362f796f235805061d63d514f...4b2028896db81e7c5fee13b92a23e89526762f6a,1,1,1,2,1,2007-01-11 16:59:41,2007-01-11 16:59:41
4b2028896db81e7c5fee13b92a23e89526762f6a...6350e8a7e027de13e33116ffd130260bda64e4bf,1,2,0,2,1,2007-01-11 17:24:14,2007-01-11 17:24:14
6350e8a7e027de13e33116ffd130260bda64e4bf...f368960479a1b8f7904bc2ca65a7a9cd74cc5a13,1,12,3,15,2,2007-01-11 18:40:34,2007-01-11 18:40:34
f368960479a1b8f7904bc2ca65a7a9cd74cc5a13...bfa79591b3c849d8df6cd8c7eac757732a855519,1,3,0,3,1,2007-01-11 18:44:53,2007-01-11 18:44:53
bfa79591b3c849d8df6cd8c7eac757732a855519...5b7f34d74bd78c97d86ae82f2899d0ce6d04b0c3,1,1,1,2,1,2007-01-11 19:32:18,2007-01-11 19:32:18
5b7f34d74bd78c97d86ae82f2899d0ce6d04b0c3...39b0976e3ed605ec985a6171b059f20ad566808d,2,2,2,4,2,2007-01-12 03:53:55,2007-01-12 03:53:55
39b0976e3ed605ec985a6171b059f20ad566808d...dfa1a0246f0249056f3ce85f62a61e609f20fd07,1,3,3,6,2,2007-01-12 07:32:15,2007-01-12 07:32:15
dfa1a0246f0249056f3ce85f62a61e609f20fd07...79c58b8406128b33080d72059dff66f49d64114c,1,7,8,15,2,2007-01-13 22:29:59,2007-01-13 22:29:59
79c58b8406128b33080d72059dff66f49d64114c...8507faea6ed79e46a0461bec9b73879cd700e8ab,1,3,2,5,2,2007-01-13 22:38:11,2007-01-13 22:38:11
8507faea6ed79e46a0461bec9b73879cd700e8ab...2bd21fe3b3e1231b6364aec5e61d7009979c6a99,1,3,3,6,3,2007-01-14 06:02:56,2007-01-14 06:02:56
2bd21fe3b3e1231b6364aec5e61d7009979c6a99...ed5bda3020bd418ad8edb477ad2b1fd8b313cc04,5,29,25,54,25,2007-01-14 06:22:20,2007-01-14 06:22:20
ed5bda3020bd418ad8edb477ad2b1fd8b313cc04...e1e631a04440c0d9ab6580ea1593286072fa7ef5,2,33,35,68,23,2007-01-14 07:17:41,2007-01-14 07:17:41
e1e631a04440c0d9ab6580ea1593286072fa7ef5...213118c81e3c441a99f2e0d3b8753538ffbc9b46,1,1,1,2,1,2007-01-14 13:48:41,2007-01-14 13:48:41
213118c81e3c441a99f2e0d3b8753538ffbc9b46...2b82ffbbfac419e017acea3e0f83c063549e545e,2,12,13,25,9,2007-01-14 15:47:32,2007-01-14 15:47:32
2b82ffbbfac419e017acea3e0f83c063549e545e...375499c1f3890b9f14c36fd50c80516ff5c7596e,1,1,1,2,1,2007-01-14 17:45:49,2007-01-14 17:45:49
375499c1f3890b9f14c36fd50c80516ff5c7596e...e50a2f6ca3a03501510228f940f48a0faa12127d,1,4,4,8,3,2007-01-14 17:54:54,2007-01-14 17:54:54
e50a2f6ca3a03501510228f940f48a0faa12127d...729396e6cfb1a0495399609f5929fb630a49649d,2,13,1,14,3,2007-01-14 19:30:40,2007-01-14 19:30:40
729396e6cfb1a0495399609f5929fb630a49649d...382a7ecd6d8e9a39bf24cec81fd65971ef3f8ada,2,9,9,18,7,2007-01-14 19:49:58,2007-01-14 19:49:58
382a7ecd6d8e9a39bf24cec81fd65971ef3f8ada...259131966049cd879dbcecf222afe1457b03db60,1,1,1,2,1,2007-01-14 20:07:36,2007-01-14 20:07:36
259131966049cd879dbcecf222afe1457b03db60...866187fff66ef50b9c4b4c47f332f742c7546cc5,1,14,6,20,1,2007-01-14 21:09:43,2007-01-14 21:09:43
866187fff66ef50b9c4b4c47f332f742c7546cc5...34355cd6986d5939dc711c531263cb561cba5f24,4,51,49,100,23,2007-01-14 21:49:59,2007-01-14 21:49:59
34355cd6986d5939dc711c531263cb561cba5f24...18f28ea7d46d5adce24565f277529c798ebf1763,1,6,6,12,3,2007-01-14 22:03:11,2007-01-14 22:03:11
18f28ea7d46d5adce24565f277529c798ebf1763...cd2bc219810a2837ac77d7f7d35b33d29849fa2b,1,1,1,2,1,2007-01-14 22:25:27,2007-01-14 22:25:27
cd2bc219810a2837ac77d7f7d35b33d29849fa2b...c6a893b68001be9b9389de5e2c5ea58c1a28c742,2,16,2,18,5,2007-01-14 22:36:54,2007-01-14 22:36:54
c6a893b68001be9b9389de5e2c5ea58c1a28c742...677483ce44de3e4a34f4cfcce04df2387d078a86,1,0,5,5,1,2007-01-14 22:37:33,2007-01-14 22:37:33
677483ce44de3e4a34f4cfcce04df2387d078a86...8ac2169dc01f646b9182a03353427f2c48cba49c,2,3,2,5,2,2007-01-14 22:51:55,2007-01-14 22:51:55
8ac2169dc01f646b9182a03353427f2c48cba49c...2aa67026ebe6bea90fd137fc99b4c9422977e3f0,1,1,1,2,1,2007-01-15 02:25:29,2007-01-15 02:25:29
2aa67026ebe6bea90fd137fc99b4c9422977e3f0...8b51bfbd3212a0bcaa35177056d0932b63eb268f,1,4,2,6,4,2007-01-15 10:29:13,2007-01-15 10:29:13
8b51bfbd3212a0bcaa35177056d0932b63eb268f...c8b7881c738f6949095029d75d847acc98b0afbc,2,12,5,17,8,2007-01-16 09:18:21,2007-01-16 09:18:21
c8b7881c738f6949095029d75d847acc98b0afbc...5ebd5f604ac90dae6381f59cfa637621faabf932,1,1,1,2,1,2007-01-16 11:38:33,2007-01-16 11:38:33
5ebd5f604ac90dae6381f59cfa637621faabf932...8bd7a3544dd77d92ac40e119fc6bc8a385622f25,1,6,3,9,4,2007-01-16 14:19:01,2007-01-16 14:19:01
8bd7a3544dd77d92ac40e119fc6bc8a385622f25...2d32400e3c7d226ef6d93fd91654768959695e80,1,7,6,13,3,2007-01-17 10:03:31,2007-01-17 10:03:31
2d32400e3c7d226ef6d93fd91654768959695e80...689739072f858d5e48d2c0394204dc17eba9e4e1,1,1,1,2,1,2007-01-17 10:29:19,2007-01-17 10:29:19
689739072f858d5e48d2c0394204dc17eba9e4e1...53e12752e00c2a86757ec15a0c871dee8ccd1bea,2,11,6,17,4,2007-01-17 10:43:10,2007-01-17 10:43:10
53e12752e00c2a86757ec15a0c871dee8ccd1bea...3362ccf3ddc20d787551ffdb441ae606a3d06630,2,2,2,4,2,2007-01-17 13:24:44,2007-01-17 13:24:44
3362ccf3ddc20d787551ffdb441ae606a3d06630...756183f6073a1e9fe6fae538d6f60899df47e2a1,1,1,1,2,1,2007-01-17 13:33:17,2007-01-17 13:33:17
756183f6073a1e9fe6fae538d6f60899df47e2a1...b98898d95be5cb7bb8b9fdb0d8a2595fc8d9cdf9,1,1,1,2,1,2007-01-17 13:37:51,2007-01-17 13:37:51
b98898d95be5cb7bb8b9fdb0d8a2595fc8d9cdf9...32f688d303ed3cbb942df421c5bb2ed7a5d5244c,2,3,3,6,2,2007-01-17 14:17:09,2007-01-17 14:17:09
32f688d303ed3cbb942df421c5bb2ed7a5d5244c...a87ecc44b6b4374ad2ebe10e033d45daab9e1369,1,1,1,2,1,2007-01-20 03:58:57,2007-01-20 03:58:57
a87ecc44b6b4374ad2ebe10e033d45daab9e1369...27c08b65446568b700606e837a85630d3634f25f,1,1,1,2,1,2007-01-20 04:04:02,2007-01-20 04:04:02
27c08b65446568b700606e837a85630d3634f25f...7b3ab69fcfd5a53d7084bbe4b19a7f3e58d8564d,1,4,1,5,1,2007-01-20 04:16:25,2007-01-20 04:16:25
7b3ab69fcfd5a53d7084bbe4b19a7f3e58d8564d...ddb3004a476d6eec3d449bc39d93fb5b5f98f01b,1,1,1,2,1,2007-01-22 00:25:16,2007-01-22 00:25:16
ddb3004a476d6eec3d449bc39d93fb5b5f98f01b...91410044426439983f409d198b8f9af2c5151d95,1,2,2,4,2,2007-01-22 00:28:23,2007-01-22 00:28:23
91410044426439983f409d198b8f9af2c5151d95...e45dbf29f88fb965c0abd039a65bc0302dea7e43,1,5,7,12,2,2007-01-22 00:38:57,2007-01-22 00:38:57
e45dbf29f88fb965c0abd039a65bc0302dea7e43...b81ea5f9ba19734f0409390bdf2fb685d7498bdc,1,4,1,5,2,2007-01-22 02:17:47,2007-01-22 02:17:47
b81ea5f9ba19734f0409390bdf2fb685d7498bdc...6c72f188cd8a7f98a10904b754eb4495f46af503,1,10,2,12,3,2007-01-22 02:41:23,2007-01-22 02:41:23
6c72f188cd8a7f98a10904b754eb4495f46af503...6c072457ed36464f7f2bc15128e69206dbac5d24,1,1,2,3,1,2007-01-22 02:53:30,2007-01-22 02:53:30
6c072457ed36464f7f2bc15128e69206dbac5d24...34c0bed54a5ad812b1f78a85529164e0085f50d7,1,2,1,3,2,2007-01-22 03:25:00,2007-01-22 03:25:00
34c0bed54a5ad812b1f78a85529164e0085f50d7...c39d1a21c61982baf511f6455047f7f055b228da,1,5,0,5,1,2007-01-22 03:49:04,2007-01-22 03:49:04
c39d1a21c61982baf511f6455047f7f055b228da...31d65e905237376161b8309411296c6ee72ee100,1,3,2,5,1,2007-01-22 04:50:30,2007-01-22 04:50:30
31d65e905237376161b8309411296c6ee72ee100...23220321d1c937a69b7c2a51766ce8940724e7bf,1,2,1,3,1,2007-01-22 05:00:02,2007-01-22 05:00:02
23220321d1c937a69b7c2a51766ce8940724e7bf...d2f9022a8ebbfadeb6a329714a607d2dc2882769,1,18,17,35,5,2007-01-22 05:14:45,2007-01-22 05:14:45
d2f9022a8ebbfadeb6a329714a607d2dc2882769...8e105ef9318da2a38019878c6152a4a67d9fceb1,2,12,8,20,9,2007-01-22 05:27:54,2007-01-22 05:27:54
8e105ef9318da2a38019878c6152a4a67d9fceb1...8fc9e06c46d55d2a8c27d951f5c4ee336b71f38a,1,2,2,4,1,2007-01-22 05:33:28,2007-01-22 05:33:28
8fc9e06c46d55d2a8c27d951f5c4ee336b71f38a...2550b1ea6a6eb6ba50d378a5dcfbc8146ca88bff,1,1,1,2,1,2007-01-22 05:40:01,2007-01-22 05:40:01
2550b1ea6a6eb6ba50d378a5dcfbc8146ca88bff...c96b991493b3e432fe095a18cab29b046577976c,2,11,10,21,3,2007-01-23 10:32:41,2007-01-23 10:32:41
c96b991493b3e432fe095a18cab29b046577976c...a30b3211e68eeea04107059cc82b3c3026138337,1,1,1,2,1,2007-01-23 11:07:10,2007-01-23 11:07:10
a30b3211e68eeea04107059cc82b3c3026138337...926e80b90226d176710e092bbfdcfd7b9f06389b,1,7,3,10,2,2007-01-23 11:10:02,2007-01-23 11:10:02
926e80b90226d176710e092bbfdcfd7b9f06389b...9f93c7b3b858c4491e1d2aa7a680b9b1dd29b17c,2,2,2,4,2,2007-01-23 14:46:19,2007-01-23 14:46:19
9f93c7b3b858c4491e1d2aa7a680b9b1dd29b17c...5cfaef9ff9b121850f1e27afae6819023acadbf7,1,2,2,4,1,2007-01-23 16:57:34,2007-01-23 16:57:34
5cfaef9ff9b121850f1e27afae6819023acadbf7...d9464547e0c328bf9f9b67e8d38621023a7e450e,2,14,3,17,4,2007-01-23 16:58:03,2007-01-23 16:58:03
d9464547e0c328bf9f9b67e8d38621023a7e450e...0eb642cc1f515f6c072c9ed96dfd757cb44f1656,1,0,1,1,1,2007-01-23 17:02:32,2007-01-23 17:02:32
0eb642cc1f515f6c072c9ed96dfd757cb44f1656...216477bc578cf53f8e8c774c7118b949f52b1b08,1,172,188,360,1,2007-01-25 14:06:43,2007-01-25 14:06:43
216477bc578cf53f8e8c774c7118b949f52b1b08...77a12d16f0a1793a8456a4ca178e230adf5f35d9,4,4,4,8,4,2007-01-29 20:48:10,2007-01-29 20:48:10
77a12d16f0a1793a8456a4ca178e230adf5f35d9...522b9cf35f30d0dc83e03f2425c5cbdccfbdc812,2,2,2,4,2,2007-01-31 15:51:19,2007-01-31 15:51:19
522b9cf35f30d0dc83e03f2425c5cbdccfbdc812...397be502f92abf14e97c247763d41d690561907a,1,2,3,5,2,2007-01-31 15:53:21,2007-01-31 15:53:21
397be502f92abf14e97c247763d41d690561907a...1e07c1a311358ce67e88d29c085160d8d210eb7b,1,4,1,5,2,2007-01-31 21:14:33,2007-01-31 21:14:33
1e07c1a311358ce67e88d29c085160d8d210eb7b...c60d4519bc25003dcde81d4967ab8060b3184a0b,1,6,3,9,3,2007-01-31 21:19:35,2007-01-31 21:19:35
c60d4519bc25003dcde81d4967ab8060b3184a0b...4e256bffa320f1fe87f6e4daf17bbb4ed29ae88a,1,5,1,6,2,2007-01-31 21:25:58,2007-01-31 21:25:58
4e256bffa320f1fe87f6e4daf17bbb4ed29ae88a...a82b048db8c72dccb019e086e0ca50617df14915,2,4,2,6,3,2007-01-31 21:36:48,2007-01-31 21:36:48
a82b048db8c72dccb019e086e0ca50617df14915...d4849a0d3589ea3d369137f79b102eb68403b489,2,4,1,5,2,2007-01-31 21:48:14,2007-01-31 21:48:14
d4849a0d3589ea3d369137f79b102eb68403b489...de4e28e1ba8cad85818b298009dca8098005c673,2,3,2,5,3,2007-01-31 21:56:32,2007-01-31 21:56:32
de4e28e1ba8cad85818b298009dca8098005c673...43f235f4257359dfcf9270cf31c56aa547d01fd3,1,11,1,12,3,2007-01-31 22:04:30,2007-01-31 22:04:30
43f235f4257359dfcf9270cf31c56aa547d01fd3...fd0f42bf5cf18d311db78680e4d28bc6ff1b016c,1,3,4,7,1,2007-02-03 19:32:16,2007-02-03 19:32:16
fd0f42bf5cf18d311db78680e4d28bc6ff1b016c...02ffee4610a24481aab1cac7676da2a207e3684b,1,1,1,2,1,2007-02-04 16:51:34,2007-02-04 16:51:34
02ffee4610a24481aab1cac7676da2a207e3684b...2c99c18652b9a098252d5443506c03fd45b2e2dc,1,2,2,4,1,2007-02-05 19:12:23,2007-02-05 19:12:23
2c99c18652b9a098252d5443506c03fd45b2e2dc...495ecb70b2b097e7d4a1ffe46d44562210cdc051,3,19,5,24,7,2007-02-05 20:16:46,2007-02-05 20:16:46
495ecb70b2b097e7d4a1ffe46d44562210cdc051...a69aad2242a5be4ee21955d6132247b4781d410e,2,20,2,22,2,2007-02-06 11:55:44,2007-02-06 11:55:44
a69aad2242a5be4ee21955d6132247b4781d410e...980b5d72dba596483be586a276d3a385519ee7ef,2,5,5,10,5,2007-02-07 14:56:35,2007-02-07 14:56:35
980b5d72dba596483be586a276d3a385519ee7ef...ecaa4d4570b05610d542b971fc4278de3c251e79,2,7,2,9,3,2007-02-07 15:06:49,2007-02-07 15:06:49
ecaa4d4570b05610d542b971fc4278de3c251e79...08ff26927b1a8066ffed432ecc46c4c6010d13cf,1,1,1,2,1,2007-02-07 15:20:30,2007-02-07 15:20:30
08ff26927b1a8066ffed432ecc46c4c6010d13cf...670d2f4140070b76c87e15c26a5787f505f5793e,1,1,1,2,1,2007-02-07 19:51:59,2007-02-07 19:51:59
670d2f4140070b76c87e15c26a5787f505f5793e...46806957f478d4f1435f13768cc85c1a39996d33,1,1,1,2,1,2007-02-08 21:59:50,2007-02-08 21:59:50
46806957f478d4f1435f13768cc85c1a39996d33...81f138d77e92e4deb6057cead988ebb679370973,1,4,2,6,3,2007-02-09 19:52:31,2007-02-09 19:52:31
81f138d77e92e4deb6057cead988ebb679370973...fb0dfd987c72906a9b499a4c5fd84807bff11678,1,2,3,5,2,2007-02-10 22:04:07,2007-02-10 22:04:07
fb0dfd987c72906a9b499a4c5fd84807bff11678...4c850c2ecdf475ca465cd173f3ff7bea67d77c29,1,1,1,2,1,2007-02-13 19:06:38,2007-02-13 19:06:38
4c850c2ecdf475ca465cd173f3ff7bea67d77c29...48c16eb85b5fc48d4f472bfef43571e86359e20a,4,4,4,8,4,2007-02-13 19:43:44,2007-02-13 19:43:44
48c16eb85b5fc48d4f472bfef43571e86359e20a...339789a931fbb01870b1ecd522e35bd439149292,1,1,1,2,1,2007-02-13 22:41:58,2007-02-13 22:41:58
339789a931fbb01870b1ecd522e35bd439149292...2712efd0fc89625da4d767f6073f575d040e30fd,2,2,2,4,2,2007-02-14 01:49:28,2007-02-14 01:49:28
2712efd0fc89625da4d767f6073f575d040e30fd...4434b5ae65bd3ecb9ea5b7e6a56d5b714748de90,1,14,1,15,4,2007-02-15 15:19:07,2007-02-15 15:19:07
4434b5ae65bd3ecb9ea5b7e6a56d5b714748de90...5c9fadbc5da45edddf34474ec6a1553c5b6ac978,1,2,3,5,1,2007-02-15 18:01:00,2007-02-15 18:01:00
5c9fadbc5da45edddf34474ec6a1553c5b6ac978...ef1bd0453245c3b619cad33303e167899581067a,1,1,1,2,1,2007-02-17 20:34:15,2007-02-17 20:34:15
ef1bd0453245c3b619cad33303e167899581067a...c66935db9d6068087f1fca83626db0b9280343e2,1,1,1,2,1,2007-02-17 20:58:04,2007-02-17 20:58:04
c66935db9d6068087f1fca83626db0b9280343e2...14a7b5dd0b07b3a65cf82e6e420756babce4c31e,1,3,0,3,1,2007-02-18 06:49:00,2007-02-18 06:49:00
14a7b5dd0b07b3a65cf82e6e420756babce4c31e...5616e4c357ec6d793bb20e8ff7b7bd77c995a5d6,1,1,1,2,1,2007-02-18 06:54:13,2007-02-18 06:54:13
5616e4c357ec6d793bb20e8ff7b7bd77c995a5d6...3eaebf45a21f3eceb0144769713353bebb9d44a7,1,12,12,24,9,2007-02-18 22:17:28,2007-02-18 22:17:28
3eaebf45a21f3eceb0144769713353bebb9d44a7...15f74eddb6725b027f8005fdb9fb85f57a824520,1,8,0,8,1,2007-02-18 23:27:48,2007-02-18 23:27:48
15f74eddb6725b027f8005fdb9fb85f57a824520...1878aa96446aae7aa65ccbbd8a1dfa90301a043a,1,7,1,8,2,2007-02-19 15:44:12,2007-02-19 15:44:12
1878aa96446aae7aa65ccbbd8a1dfa90301a043a...fade976946fba8a9c9782bbbc56058fdc238b31f,1,14,8,22,6,2007-02-22 20:37:37,2007-02-22 20:37:37
fade976946fba8a9c9782bbbc56058fdc238b31f...bb0ce1550da91e861faf7650b4617621ec14bfa8,1,2,0,2,1,2007-02-22 20:53:41,2007-02-22 20:53:41
bb0ce1550da91e861faf7650b4617621ec14bfa8...4259b02c99202092d222fc7ca19c1ab83df7eafa,1,4,3,7,4,2007-02-22 21:54:56,2007-02-22 21:54:56
4259b02c99202092d222fc7ca19c1ab83df7eafa...44599e174b5d1f924def5a3950375ead12b9d21b,4,20,7,27,9,2007-02-23 02:53:22,2007-02-23 02:53:22
44599e174b5d1f924def5a3950375ead12b9d21b...7820594c6630c0018a60e1c9c7bcacf78de06fb4,2,4,1,5,2,2007-02-23 04:47:24,2007-02-23 04:47:24
7820594c6630c0018a60e1c9c7bcacf78de06fb4...9dc40f564e79c3e5d8818afa4a1e7a1d243fbcf5,1,36,27,63,10,2007-02-25 04:31:28,2007-02-25 04:31:28
9dc40f564e79c3e5d8818afa4a1e7a1d243fbcf5...21ca78bcd0c800ad8b54dcd7c73418e219f0ce49,1,1,1,2,1,2007-02-25 07:11:59,2007-02-25 07:11:59
21ca78bcd0c800ad8b54dcd7c73418e219f0ce49...eb1f881d737eb64c81dbd143bc678e202c60d9f9,1,2,0,2,1,2007-02-25 13:27:29,2007-02-25 13:27:29
eb1f881d737eb64c81dbd143bc678e202c60d9f9...b93051f5af385ffca32df2333b1ca761cb56863f,1,1,0,1,1,2007-02-25 13:28:56,2007-02-25 13:28:56
b93051f5af385ffca32df2333b1ca761cb56863f...b2c2ab2bb7fc43e680214a3627181a0c2226c6f9,2,3,2,5,3,2007-02-25 17:40:27,2007-02-25 17:40:27
b2c2ab2bb7fc43e680214a3627181a0c2226c6f9...b15ae79a389299cac19f59ed14efafc3e9d8ef0d,2,3,2,5,3,2007-02-25 19:12:07,2007-02-25 19:12:07
b15ae79a389299cac19f59ed14efafc3e9d8ef0d...34cb5b5812db50d921f7c7a0c398eb68167b3da3,3,30,7,37,9,2007-02-25 19:36:29,2007-02-25 19:36:29
34cb5b5812db50d921f7c7a0c398eb68167b3da3...09f5db51dc2d2058cb6f5573e8ec440f7af46e9b,1,1,1,2,1,2007-02-27 20:37:46,2007-02-27 20:37:46
09f5db51dc2d2058cb6f5573e8ec440f7af46e9b...68d8e53d8751c095fcc148cb52aae472a6e60c26,1,27,17,44,14,2007-02-27 21:10:40,2007-02-27 21:10:40
68d8e53d8751c095fcc148cb52aae472a6e60c26...6850c4b29017bcb31e16f0d6c94110a8b8a82304,1,15,10,25,6,2007-02-27 21:19:11,2007-02-27 21:19:11
6850c4b29017bcb31e16f0d6c94110a8b8a82304...a782afdfd00f12cc6fab25c83bbaeefd0705b544,1,50,12,62,11,2007-02-27 21:32:28,2007-02-27 21:32:28
a782afdfd00f12cc6fab25c83bbaeefd0705b544...52a78d06a44a7047f34cf1f443cebaa7916e391d,1,1,1,2,1,2007-02-27 21:33:27,2007-02-27 21:33:27
52a78d06a44a7047f34cf1f443cebaa7916e391d...92417f694a5c66cda477bf33e1c2d3ce0765e05f,1,30,14,44,13,2007-02-27 21:43:08,2007-02-27 21:43:08
92417f694a5c66cda477bf33e1c2d3ce0765e05f...0d9920083bb2ed441bfbedd35107abf58216d9ff,1,5,2,7,3,2007-02-27 21:44:57,2007-02-27 21:44:57
0d9920083bb2ed441bfbedd35107abf58216d9ff...a4a6dfa6bd374904360c4e14c69319fe6ea3e180,1,24,14,38,12,2007-02-27 21:49:54,2007-02-27 21:49:54
a4a6dfa6bd374904360c4e14c69319fe6ea3e180...757138f216bb30859c50b84345d960807e06e252,1,1,1,2,1,2007-02-27 21:51:49,2007-02-27 21:51:49
757138f216bb30859c50b84345d960807e06e252...1c42201d7aba027afeaec8bef5e026d74ce38a7b,1,4,24,28,1,2007-02-27 21:58:14,2007-02-27 21:58:14
1c42201d7aba027afeaec8bef5e026d74ce38a7b...92973279ea26c415f505d187276460115c668f17,1,1,1,2,1,2007-02-27 22:00:31,2007-02-27 22:00:31
92973279ea26c415f505d187276460115c668f17...2cefce05c8619b359accb78eb0de8e54962f5abf,1,0,4,4,1,2007-02-27 22:13:43,2007-02-27 22:13:43
2cefce05c8619b359accb78eb0de8e54962f5abf...5adf740a1522c18504b66a7d67ab23b00aad34db,1,3,1,4,1,2007-02-28 14:27:06,2007-02-28 14:27:06
5adf740a1522c18504b66a7d67ab23b00aad34db...f8fcc9525d2d596c98d84f8fc085579018437813,1,3,2,5,1,2007-02-28 16:59:36,2007-02-28 16:59:36
f8fcc9525d2d596c98d84f8fc085579018437813...6b729ff7984d9d4d09dff042a3896022dae3783d,2,36,23,59,9,2007-03-01 04:54:51,2007-03-01 04:54:51
6b729ff7984d9d4d09dff042a3896022dae3783d...9791855ea91988e9ff02063e0c5ece759d8ba898,2,7,3,10,4,2007-03-01 05:16:34,2007-03-01 05:16:34
9791855ea91988e9ff02063e0c5ece759d8ba898...fe1910d4d9f547774cb26f4770b303635333f8e6,1,4,4,8,3,2007-03-05 17:34:17,2007-03-05 17:34:17
fe1910d4d9f547774cb26f4770b303635333f8e6...2b9b3e90c1810b53054842ec5b61e628798292ba,1,1,1,2,1,2007-03-05 17:42:12,2007-03-05 17:42:12
2b9b3e90c1810b53054842ec5b61e628798292ba...a6886d0904320f6eeb05bc85d98550c74cb0c088,1,1,3,4,1,2007-03-09 15:41:58,2007-03-09 15:41:58
a6886d0904320f6eeb05bc85d98550c74cb0c088...109e4b2987d78bf67a45aba3e62c29958aeb8d91,1,1,1,2,1,2007-03-11 20:03:45,2007-03-11 20:03:45
109e4b2987d78bf67a45aba3e62c29958aeb8d91...027668047a65837daef59efcc5f7042303dd71c3,1,26,24,50,14,2007-03-15 16:54:13,2007-03-15 16:54:13
027668047a65837daef59efcc5f7042303dd71c3...297a450e05e80e930d53631bb9ae2c3fe09378b7,4,308,0,308,3,2007-03-15 17:09:29,2007-03-15 17:09:29
297a450e05e80e930d53631bb9ae2c3fe09378b7...7d0a84193f539d85267d1458aba35a42d7dbd03b,2,77,1,78,2,2007-03-16 00:00:46,2007-03-16 00:00:46
7d0a84193f539d85267d1458aba35a42d7dbd03b...8613d9a93ac424ee5c60ba6f69751e93a2d179c6,1,10,1,11,2,2007-03-16 00:05:38,2007-03-16 00:05:38
8613d9a93ac424ee5c60ba6f69751e93a2d179c6...ab2d10c6d62c4d2b834337e238cf2a618eec4412,1,2,6,8,2,2007-03-16 04:32:37,2007-03-16 04:32:37
ab2d10c6d62c4d2b834337e238cf2a618eec4412...83b43a1e927d6b260f35f75bc2c3d177f271be93,3,25,22,47,15,2007-03-16 20:37:10,2007-03-16 20:37:10
83b43a1e927d6b260f35f75bc2c3d177f271be93...1d0dec55bad5d848a083084a9ac0c25dc57f9e1b,1,20,7,27,5,2007-03-17 02:02:01,2007-03-17 02:02:01
1d0dec55bad5d848a083084a9ac0c25dc57f9e1b...98b721d27f95f73e4edb6a284ae3096592a93207,1,1,0,1,1,2007-03-17 14:18:06,2007-03-17 14:18:06
98b721d27f95f73e4edb6a284ae3096592a93207...36774226dd241ae104e10e8073a0586c50ae59ad,1,4,4,8,4,2007-03-18 18:52:09,2007-03-18 18:52:09
36774226dd241ae104e10e8073a0586c50ae59ad...3728a8ac0494de7ccab48bfc69f5d71496ba64c2,2,21,3,24,5,2007-03-21 20:10:04,2007-03-21 20:10:04
3728a8ac0494de7ccab48bfc69f5d71496ba64c2...26034c4a2985c18c6c702f1c609001f859e33654,1,1,1,2,1,2007-03-21 20:15:26,2007-03-21 20:15:26
26034c4a2985c18c6c702f1c609001f859e33654...7ad613c5e9aaf79666c5de39ebfafad5c46e13b9,2,9,7,16,6,2007-03-22 01:37:28,2007-03-22 01:37:28
7ad613c5e9aaf79666c5de39ebfafad5c46e13b9...0f7c89cd97de6ca644a834a119dda1e057fd724e,4,28,10,38,11,2007-03-24 02:03:47,2007-03-24 02:03:47
0f7c89cd97de6ca644a834a119dda1e057fd724e...6d03f9290eb7b3f51b18413acdbd61d856749174,1,13,8,21,3,2007-03-24 02:07:37,2007-03-24 02:07:37
6d03f9290eb7b3f51b18413acdbd61d856749174...e2b52e1e401af05a6fe3ca7bf9e714f973fc4d61,2,5,5,10,2,2007-03-24 02:44:41,2007-03-24 02:44:41
e2b52e1e401af05a6fe3ca7bf9e714f973fc4d61...32b523b5c5f3e2bf40abba2ccf5c7a463ba24b07,1,5,3,8,4,2007-03-24 02:54:24,2007-03-24 02:54:24
32b523b5c5f3e2bf40abba2ccf5c7a463ba24b07...fde2867fce7b592096ae529ab5dcd0842e52f2ac,1,1,1,2,1,2007-03-24 03:00:03,2007-03-24 03:00:03
fde2867fce7b592096ae529ab5dcd0842e52f2ac...1b9f4d3d2e1bc2dfd7572da77159fa01f9ab5d6e,1,12,8,20,4,2007-03-24 03:12:12,2007-03-24 03:12:12
1b9f4d3d2e1bc2dfd7572da77159fa01f9ab5d6e...ec2b688920cf38f5bb2487b8a1897f7eb7557248,3,45,58,103,18,2007-03-24 21:55:03,2007-03-24 21:55:03
ec2b688920cf38f5bb2487b8a1897f7eb7557248...af79bb1f255433d553d8d9dde0306cc340903c1a,3,210,169,379,20,2007-03-25 00:58:19,2007-03-25 00:58:19
af79bb1f255433d553d8d9dde0306cc340903c1a...ae208246fbd1708b72e822b61c9e24d3034d1a05,3,26,24,50,14,2007-03-25 02:04:03,2007-03-25 02:04:03
ae208246fbd1708b72e822b61c9e24d3034d1a05...25b424134f9927a5bf0bab5cba836a0aa6c3cfc1,2,14,3,17,5,2007-03-25 02:45:12,2007-03-25 02:45:12
25b424134f9927a5bf0bab5cba836a0aa6c3cfc1...88abf0902a1f67d0d619baacf1e6904806e488b7,1,14,0,14,1,2007-03-25 10:30:59,2007-03-25 10:30:59
88abf0902a1f67d0d619baacf1e6904806e488b7...a10afee0c33811e00b926125497a3ae6c9c35052,1,4,3,7,3,2007-03-25 10:34:03,2007-03-25 10:34:03
a10afee0c33811e00b926125497a3ae6c9c35052...b8aa9e7cfcc8d6cae898661b75e6fb63a5288cb0,1,5,0,5,1,2007-03-25 10:45:20,2007-03-25 10:45:20
b8aa9e7cfcc8d6cae898661b75e6fb63a5288cb0...e6ffe025033f82d752ec4966c6b12c49d8e1dc29,1,3,3,6,3,2007-03-25 10:52:40,2007-03-25 10:52:40
e6ffe025033f82d752ec4966c6b12c49d8e1dc29...06b89271c1c23e48f627d25b3df05ceef5c8fbc8,1,13,0,13,1,2007-03-25 10:55:22,2007-03-25 10:55:22
06b89271c1c23e48f627d25b3df05ceef5c8fbc8...707f23f83a59e692454eb18285a610889ce8102f,2,10,1,11,2,2007-03-25 11:04:28,2007-03-25 11:04:28
707f23f83a59e692454eb18285a610889ce8102f...4e7c9b08a0fb6142755e39cfaae2f8330831008c,2,10,1,11,2,2007-03-25 11:52:53,2007-03-25 11:52:53
4e7c9b08a0fb6142755e39cfaae2f8330831008c...4903872c17f8809bd0c027092fc55d139d8ae789,1,13,1,14,1,2007-03-25 12:01:15,2007-03-25 12:01:15
4903872c17f8809bd0c027092fc55d139d8ae789...4b9bed95436bb060e57a18a08a5b486f7b812c6b,1,11,0,11,1,2007-03-25 12:07:59,2007-03-25 12:07:59
4b9bed95436bb060e57a18a08a5b486f7b812c6b...eab0e57fb5cab02efae2adbe97c502e967da029b,1,7,0,7,1,2007-03-25 12:16:23,2007-03-25 12:16:23
eab0e57fb5cab02efae2adbe97c502e967da029b...00a2fa5f35aa46c29a568729ef6dce4a7d5959b9,1,17,0,17,1,2007-03-25 12:32:31,2007-03-25 12:32:31
00a2fa5f35aa46c29a568729ef6dce4a7d5959b9...d7a8794eb574a870fde9a8afdfd452e52804f65d,5,174,148,322,39,2007-03-25 18:06:18,2007-03-25 18:06:18
d7a8794eb574a870fde9a8afdfd452e52804f65d...9c7f8ba90ea45a653cf45a6379ccd4943cc22200,3,20,19,39,15,2007-03-25 19:02:31,2007-03-25 19:02:31
9c7f8ba90ea45a653cf45a6379ccd4943cc22200...44769df602f4b6a5152233d32eb2f93e71475bfe,1,3,1,4,1,2007-03-25 20:28:34,2007-03-25 20:28:34
44769df602f4b6a5152233d32eb2f93e71475bfe...3446c3af764c4d91f3676b214575168b82205e83,1,6,7,13,5,2007-03-25 20:30:16,2007-03-25 20:30:16
3446c3af764c4d91f3676b214575168b82205e83...9c94ef4c411867d38f301ccbf406af21e277188c,4,869,864,1733,35,2007-03-26 02:06:50,2007-03-26 02:06:50
9c94ef4c411867d38f301ccbf406af21e277188c...14fa1e858c91cbb354009bc68fbd893ed4ff540c,1,4,4,8,3,2007-04-03 03:04:38,2007-04-03 03:04:38
14fa1e858c91cbb354009bc68fbd893ed4ff540c...bfe5f891068af9f86d7be288ad0da7b442427d9c,2,8,8,16,3,2007-04-03 21:19:54,2007-04-03 21:19:54
bfe5f891068af9f86d7be288ad0da7b442427d9c...2fac5e7949ec342c450b2e032509eed0e35cf1ff,2,7,2,9,4,2007-04-13 17:48:04,2007-04-13 17:48:04
2fac5e7949ec342c450b2e032509eed0e35cf1ff...f63242f068ccbc8006cd18d84ec97055c87ac3cc,1,0,4,4,1,2007-04-18 18:35:34,2007-04-18 18:35:34
f63242f068ccbc8006cd18d84ec97055c87ac3cc...2ad223aedd1f93c783d98d60adc9fda3bdfbb4b6,2,49,61,110,14,2007-04-22 03:16:53,2007-04-22 03:16:53
2ad223aedd1f93c783d98d60adc9fda3bdfbb4b6...e0aa10a664aabbc9ab900a07ea55cb892a7b8d3f,1,19,13,32,8,2007-04-22 04:17:43,2007-04-22 04:17:43
e0aa10a664aabbc9ab900a07ea55cb892a7b8d3f...03d268025966059201fac5d7b6da5c210d22b9f2,1,20,2,22,2,2007-04-22 05:13:33,2007-04-22 05:13:33
03d268025966059201fac5d7b6da5c210d22b9f2...1d2faf36cf356bc09d3389ad6fce6ee520560f25,1,13,13,26,6,2007-04-22 16:34:23,2007-04-22 16:34:23
1d2faf36cf356bc09d3389ad6fce6ee520560f25...94dfccc6dbb2dbf7b91e01622ff746c9c9f447d6,1,27,4,31,8,2007-04-23 15:29:57,2007-04-23 15:29:57
94dfccc6dbb2dbf7b91e01622ff746c9c9f447d6...11b64c1149a0d49d105b50a2869d74cbe18613ed,2,15,10,25,11,2007-04-24 21:48:52,2007-04-24 21:48:52
11b64c1149a0d49d105b50a2869d74cbe18613ed...14aafdf3191ca5da0dbd3c3fa3856dcc5a52c7be,1,1,1,2,1,2007-04-24 21:50:49,2007-04-24 21:50:49
14aafdf3191ca5da0dbd3c3fa3856dcc5a52c7be...2897b1bd2383031b6764192dc1ccb1d1205139a3,2,12,5,17,7,2007-04-24 22:35:04,2007-04-24 22:35:04
2897b1bd2383031b6764192dc1ccb1d1205139a3...cb828f3dab6ec8439ac111246346a8d4b3205fed,2,8,4,12,4,2007-04-25 18:19:39,2007-04-25 18:19:39
cb828f3dab6ec8439ac111246346a8d4b3205fed...958bed09da67c052dfa85c0bb8c0dc88873e5923,2,8,1,9,3,2007-04-25 18:41:49,2007-04-25 18:41:49
958bed09da67c052dfa85c0bb8c0dc88873e5923...5fae496933cf4cad5826fbd871d0db455dc2947e,2,10,6,16,5,2007-04-25 19:48:00,2007-04-25 19:48:00
5fae496933cf4cad5826fbd871d0db455dc2947e...0539495e865aa81f4124c2557c4f9514eeeaee3f,5,1255,3,1258,6,2007-04-25 21:11:06,2007-04-25 21:11:06
0539495e865aa81f4124c2557c4f9514eeeaee3f...33ee5c317d0f1aa64d8d8e567425dd8fe2789cd0,1,0,3,3,1,2007-04-25 21:22:04,2007-04-25 21:22:04
33ee5c317d0f1aa64d8d8e567425dd8fe2789cd0...fba422541a06a05ead698e1bffe4c7ec9a05ba22,1,3,1,4,2,2007-04-26 18:52:10,2007-04-26 18:52:10
fba422541a06a05ead698e1bffe4c7ec9a05ba22...610149fd19c087e51ccd5975ba2c2e5c3bfe49a8,1,1,0,1,1,2007-04-28 15:33:25,2007-04-28 15:33:25
610149fd19c087e51ccd5975ba2c2e5c3bfe49a8...fce2bdf7ff1d5a293690c65de36a7824a50bc54f,3,9,5,14,7,2007-04-28 15:39:30,2007-04-28 15:39:30
fce2bdf7ff1d5a293690c65de36a7824a50bc54f...09a2e48f45ca106c937d2fbee9e7586ab514dbe7,1,1,1,2,1,2007-04-28 15:43:18,2007-04-28 15:43:18
09a2e48f45ca106c937d2fbee9e7586ab514dbe7...e95a6cc746f9217fa285a87c2e9c0705babf2824,1,1,5,6,5,2007-04-28 15:45:38,2007-04-28 15:45:38
e95a6cc746f9217fa285a87c2e9c0705babf2824...74a8e206231162b005d95b667343678f786ae272,5,80,80,160,34,2007-04-29 18:39:07,2007-04-29 18:39:07
74a8e206231162b005d95b667343678f786ae272...5c54a4b8ee5cfea3aff55a1122b187b731319e61,2,10,2,12,4,2007-04-30 01:43:52,2007-04-30 01:43:52
5c54a4b8ee5cfea3aff55a1122b187b731319e61...672090463c893216e490b1e7a5bd44c816238021,1,1,0,1,1,2007-04-30 13:13:01,2007-04-30 13:13:01
672090463c893216e490b1e7a5bd44c816238021...2e448273f5674958fcb05073791dadd92fa8bcd0,1,2,1,3,2,2007-04-30 17:31:51,2007-04-30 17:31:51
2e448273f5674958fcb05073791dadd92fa8bcd0...13d2ef9282db6be4a0030ce1319948410f0bd2b6,1,1,1,2,1,2007-04-30 17:38:41,2007-04-30 17:38:41
13d2ef9282db6be4a0030ce1319948410f0bd2b6...67c640bb206d0c8b16042c0981fb25540ee47bdf,1,47,30,77,3,2007-05-01 21:03:44,2007-05-01 21:03:44
67c640bb206d0c8b16042c0981fb25540ee47bdf...c0cc8edd5dc9742291dcf353e31fe02125146793,1,1,1,2,1,2007-05-01 21:27:55,2007-05-01 21:27:55
c0cc8edd5dc9742291dcf353e31fe02125146793...c512984303f3d2148c4a755ccb1f41bfcbcf9527,2,2,8,10,4,2007-05-01 21:31:26,2007-05-01 21:31:26
c512984303f3d2148c4a755ccb1f41bfcbcf9527...7fa12b412b7e965ca7a37c9281dd6321c2fe284c,1,2,2,4,1,2007-05-01 21:36:01,2007-05-01 21:36:01
7fa12b412b7e965ca7a37c9281dd6321c2fe284c...ed1e3f7e0501be92411bb7d9fd6c25ab1e81cc73,1,2,6,8,1,2007-05-02 02:41:57,2007-05-02 02:41:57
ed1e3f7e0501be92411bb7d9fd6c25ab1e81cc73...003af8e383be2bf6f60338aa6135332ad33ba990,2,37,27,64,29,2007-05-05 17:37:38,2007-05-05 17:37:38
003af8e383be2bf6f60338aa6135332ad33ba990...1501447c7066bb7684dcfc34fb1dd3df512862de,1,1,1,2,1,2007-05-05 17:57:14,2007-05-05 17:57:14
1501447c7066bb7684dcfc34fb1dd3df512862de...51d05922112851babbeeebb65c8835f4ead82d1f,1,1,1,2,1,2007-05-11 05:24:22,2007-05-11 05:24:22
51d05922112851babbeeebb65c8835f4ead82d1f...edea4866e88e0123b06d52f14aed36d3c96c3c79,1,1,1,2,1,2007-05-11 05:29:00,2007-05-11 05:29:00
edea4866e88e0123b06d52f14aed36d3c96c3c79...c76f6cd12538301db8608ca088bf0c6816bd13e0,1,1,1,2,1,2007-05-11 21:14:11,2007-05-11 21:14:11
c76f6cd12538301db8608ca088bf0c6816bd13e0...f5a2db89fddf65f753b50ff7e77eab47db3b1f23,1,3,3,6,1,2007-05-11 21:39:38,2007-05-11 21:39:38
f5a2db89fddf65f753b50ff7e77eab47db3b1f23...009033bb4566079c1f5006ca0e4521ad64117cd0,2,7,2,9,3,2007-05-11 22:29:16,2007-05-11 22:29:16
009033bb4566079c1f5006ca0e4521ad64117cd0...a34a1a599bf84e3cbf189d6c4afb2d025649398c,2,5,2,7,3,2007-05-13 04:01:57,2007-05-13 04:01:57
a34a1a599bf84e3cbf189d6c4afb2d025649398c...ff4f265bc0273bda0c8873d470aefa20170abc41,2,16,3,19,5,2007-05-13 05:53:49,2007-05-13 05:53:49
ff4f265bc0273bda0c8873d470aefa20170abc41...7c6100f5ed840b49e8e0de1f9eb90ea2ef1c47ef,3,11,8,19,9,2007-05-13 17:20:03,2007-05-13 17:20:03
7c6100f5ed840b49e8e0de1f9eb90ea2ef1c47ef...d0c68580e500a4b9ffd0bf577d82df6d0320659a,1,2,1,3,1,2007-05-13 17:59:38,2007-05-13 17:59:38
d0c68580e500a4b9ffd0bf577d82df6d0320659a...108f308eaae62a78bd4dc8863f8c026f8828ef48,1,23,4,27,2,2007-05-14 17:46:00,2007-05-14 17:46:00
108f308eaae62a78bd4dc8863f8c026f8828ef48...33c097bd1e3caf623cc9a1e4518150c5a2233e93,1,3,2,5,3,2007-05-16 16:21:50,2007-05-16 16:21:50
33c097bd1e3caf623cc9a1e4518150c5a2233e93...9b5363b9eb197515e31589894c945dfd70b8b93b,2,86,64,150,28,2007-05-20 08:40:13,2007-05-20 08:40:13
9b5363b9eb197515e31589894c945dfd70b8b93b...5e964a4a734177c7359735b893e2d6ce5abaedbd,2,3,2,5,3,2007-05-20 16:42:42,2007-05-20 16:42:42
5e964a4a734177c7359735b893e2d6ce5abaedbd...5ef3d5364d9372c825146c087e24af460f32ca1e,1,23,2,25,4,2007-05-20 16:51:52,2007-05-20 16:51:52
5ef3d5364d9372c825146c087e24af460f32ca1e...19f5cf0c893aa2ba2ffb00c00c7efc1db4383f3e,1,1,1,2,1,2007-05-21 00:48:44,2007-05-21 00:48:44
19f5cf0c893aa2ba2ffb00c00c7efc1db4383f3e...d7fe34c440b5b52edd0ebabfa942d560e35224f3,1,2,2,4,2,2007-05-22 07:05:32,2007-05-22 07:05:32
d7fe34c440b5b52edd0ebabfa942d560e35224f3...eabac3f6a189342cf8bb615de904f9f125374c67,2,4,4,8,4,2007-05-22 07:11:50,2007-05-22 07:11:50
eabac3f6a189342cf8bb615de904f9f125374c67...fd4905b4d9183fe80fa0171c2f8ce47f0361df3b,1,17,13,30,4,2007-05-22 08:18:31,2007-05-22 08:18:31
fd4905b4d9183fe80fa0171c2f8ce47f0361df3b...f7ea17060fcaf6cd14a03343ec97f77367f5022a,1,1,1,2,1,2007-05-22 08:43:49,2007-05-22 08:43:49
f7ea17060fcaf6cd14a03343ec97f77367f5022a...79b3ff077252e25a16188ac723376798314a8a6b,1,1,1,2,1,2007-05-22 10:37:54,2007-05-22 10:37:54
79b3ff077252e25a16188ac723376798314a8a6b...970eb0f020b7a57f313e438490b4018c5569f8b3,2,2,5,7,3,2007-05-23 12:48:15,2007-05-23 12:48:15
970eb0f020b7a57f313e438490b4018c5569f8b3...7e03645a5534fc582847df6ece72aec516487b47,1,4,7,11,2,2007-05-23 13:51:04,2007-05-23 13:51:04
7e03645a5534fc582847df6ece72aec516487b47...ee31297a83f3add9f1832e863da3b6100ab9e7d3,1,37,46,83,6,2007-05-30 19:22:24,2007-05-30 19:22:24
ee31297a83f3add9f1832e863da3b6100ab9e7d3...d85a22a70ead4a3a22bf1eebe05d08b498f70aa1,1,4,1,5,2,2007-05-31 00:13:54,2007-05-31 00:13:54
d85a22a70ead4a3a22bf1eebe05d08b498f70aa1...2c33101693b172ccc3e87725eb5a7772de6745be,1,8,2,10,3,2007-05-31 03:51:28,2007-05-31 03:51:28
2c33101693b172ccc3e87725eb5a7772de6745be...3c5340d146100dab8c69d2c2c1925adca827342a,1,12,7,19,3,2007-05-31 04:15:41,2007-05-31 04:15:41
3c5340d146100dab8c69d2c2c1925adca827342a...a6b91166afd2c5030f13f5a35aa078f4b3394ceb,1,3,1,4,2,2007-05-31 16:49:49,2007-05-31 16:49:49
a6b91166afd2c5030f13f5a35aa078f4b3394ceb...f621f92a4d2df47b9f1568d6973e21a019203b93,2,9,3,12,3,2007-06-14 22:06:00,2007-06-14 22:06:00
f621f92a4d2df47b9f1568d6973e21a019203b93...4b8c7d856152df67ddab50327d6da8d68470ec7e,1,13,13,26,5,2007-06-14 22:12:49,2007-06-14 22:12:49
4b8c7d856152df67ddab50327d6da8d68470ec7e...03c623c35f429ce29e927b457ff0a45d8d643f2e,1,1,1,2,1,2007-06-16 22:19:17,2007-06-16 22:19:17
03c623c35f429ce29e927b457ff0a45d8d643f2e...6f510757ab47b4377c8af954418d216afda37949,1,2,2,4,2,2007-06-20 21:13:56,2007-06-20 21:13:56
6f510757ab47b4377c8af954418d216afda37949...5e6c14993a1010a2f6e8ce1f1d5d64171d324581,1,5,6,11,3,2007-06-21 02:38:16,2007-06-21 02:38:16
5e6c14993a1010a2f6e8ce1f1d5d64171d324581...8b683b891f2cfd299c1d0708bb41ea26393ea417,1,7,3,10,1,2007-06-21 02:52:53,2007-06-21 02:52:53
8b683b891f2cfd299c1d0708bb41ea26393ea417...5bb0902c5ef4cf767a5940799826e57f2fcfdd34,1,2,2,4,2,2007-06-21 03:09:04,2007-06-21 03:09:04
5bb0902c5ef4cf767a5940799826e57f2fcfdd34...f025ed878bcf610971f294fd931edfe30aa18a9e,1,4,3,7,3,2007-06-21 19:21:56,2007-06-21 19:21:56
f025ed878bcf610971f294fd931edfe30aa18a9e...456094c2053bb4a6ee37f50dc1d0093b3cd12fd6,1,3,2,5,1,2007-06-26 20:45:06,2007-06-26 20:45:06
456094c2053bb4a6ee37f50dc1d0093b3cd12fd6...05864eebcd4b6907043197ca9817715c3a46aa1b,1,1,1,2,1,2007-06-26 20:46:19,2007-06-26 20:46:19
05864eebcd4b6907043197ca9817715c3a46aa1b...fd249ca808408166882847c217d55ae4c5a799e8,2,134,94,228,18,2007-06-29 19:52:38,2007-06-29 19:52:38
fd249ca808408166882847c217d55ae4c5a799e8...614706bbf26e19c9ef6b5d5a11a8a6c103fce63a,1,2,1,3,2,2007-06-29 20:26:14,2007-06-29 20:26:14
614706bbf26e19c9ef6b5d5a11a8a6c103fce63a...28c9c6a805f089bee65cb4c20ad4234c15284218,1,1,1,2,1,2007-06-29 20:27:20,2007-06-29 20:27:20
28c9c6a805f089bee65cb4c20ad4234c15284218...7088b509cf1acad11d2884d95a83badeb15d1e52,1,1,1,2,1,2007-06-29 20:52:59,2007-06-29 20:52:59
7088b509cf1acad11d2884d95a83badeb15d1e52...7b9d8258909a626f3f380c763ed81150570bbad5,1,1,1,2,1,2007-06-29 21:03:27,2007-06-29 21:03:27
7b9d8258909a626f3f380c763ed81150570bbad5...88c88f0704e70299cd3101a40b29cb37b79276d0,1,1,1,2,1,2007-06-29 21:08:46,2007-06-29 21:08:46
88c88f0704e70299cd3101a40b29cb37b79276d0...e7a8310f654d5a656ebc7cec6b6480c77522bdfd,1,2,2,4,2,2007-06-29 21:43:22,2007-06-29 21:43:22
e7a8310f654d5a656ebc7cec6b6480c77522bdfd...ea98b164387d16fe5c0aeb9fc0b4498f2df8fb02,1,2,2,4,2,2007-06-29 21:52:45,2007-06-29 21:52:45
ea98b164387d16fe5c0aeb9fc0b4498f2df8fb02...2e0c87cf234c7d352336435b51f8b3eb012119ca,1,1,1,2,1,2007-06-29 22:05:25,2007-06-29 22:05:25
2e0c87cf234c7d352336435b51f8b3eb012119ca...e290083c35654f6ef300970d55d680d24c35782b,1,3,3,6,1,2007-06-29 22:20:02,2007-06-29 22:20:02
e290083c35654f6ef300970d55d680d24c35782b...73ab36b8f8f14ed7872bf930a08d8eae68f30fda,5,2998,0,2998,7,2007-06-30 00:21:30,2007-06-30 00:21:30
73ab36b8f8f14ed7872bf930a08d8eae68f30fda...21d59e8de607e33c54cf8f7bff2c5f0b7a6c40f9,1,1,1,2,1,2007-06-30 00:22:36,2007-06-30 00:22:36
21d59e8de607e33c54cf8f7bff2c5f0b7a6c40f9...62ae0eff503e7d1e99873db13efe49f634d176d0,1,6,4,10,3,2007-06-30 13:47:40,2007-06-30 13:47:40
62ae0eff503e7d1e99873db13efe49f634d176d0...af329ed00b0499a8d393f132d2765d02144f6820,1,5,6,11,5,2007-06-30 13:57:49,2007-06-30 13:57:49
af329ed00b0499a8d393f132d2765d02144f6820...fdd437800d983346c5936abedcf292c2a612b892,1,1,1,2,1,2007-07-01 12:54:38,2007-07-01 12:54:38
fdd437800d983346c5936abedcf292c2a612b892...b9a8e65576615974228e493155c8c85dc25f09d8,1,10,9,19,2,2007-07-02 15:27:58,2007-07-02 15:27:58
b9a8e65576615974228e493155c8c85dc25f09d8...b0cf71332a1cdfac2234a758bc350bcd1d723e9d,1,1,1,2,1,2007-07-03 13:19:09,2007-07-03 13:19:09
b0cf71332a1cdfac2234a758bc350bcd1d723e9d...fa7bfcfd783421b561bccb5c9402e0993b4af769,1,1,1,2,1,2007-07-04 16:10:26,2007-07-04 16:10:26
fa7bfcfd783421b561bccb5c9402e0993b4af769...38d74fe9122a0474221388084368ebbdd8c6f938,1,1,1,2,1,2007-07-04 16:15:09,2007-07-04 16:15:09
38d74fe9122a0474221388084368ebbdd8c6f938...6f064fc9c527a46b4de16f0af310b98d1a87b0f4,1,2,2,4,2,2007-07-05 02:45:01,2007-07-05 02:45:01
6f064fc9c527a46b4de16f0af310b98d1a87b0f4...12ebfa3b01847f277aa6630e76697d5cd09560d0,1,16,13,29,6,2007-07-05 04:27:46,2007-07-05 04:27:46
12ebfa3b01847f277aa6630e76697d5cd09560d0...f70010b0ad13e3e4d6366287fd79636a9ceca1cd,1,1,1,2,1,2007-07-05 04:43:24,2007-07-05 04:43:24
f70010b0ad13e3e4d6366287fd79636a9ceca1cd...28a80202b3d41ed69f529f91c2f5bc4e929d51fa,1,1,1,2,1,2007-07-05 08:18:25,2007-07-05 08:18:25
28a80202b3d41ed69f529f91c2f5bc4e929d51fa...cb3f9d8cd92ae1e5cf97684c907ebed893ca778b,1,1,1,2,1,2007-07-05 08:19:18,2007-07-05 08:19:18
cb3f9d8cd92ae1e5cf97684c907ebed893ca778b...2278b24f70c867bcd792d81ca3d87065562e8110,1,1,1,2,1,2007-07-05 20:40:44,2007-07-05 20:40:44
2278b24f70c867bcd792d81ca3d87065562e8110...bdb5dad8e521c060980e3efecb53b81b15ce74b0,1,1,1,2,1,2007-07-06 13:36:38,2007-07-06 13:36:38
bdb5dad8e521c060980e3efecb53b81b15ce74b0...5ed992d5f590a06429859c6b5c511fce07a33b28,2,4,4,8,3,2007-07-08 04:46:21,2007-07-08 04:46:21
5ed992d5f590a06429859c6b5c511fce07a33b28...4f85aaebc6bf645168b5a51a5d3c40c9162734a3,1,0,0,0,0,2007-07-08 04:48:11,2007-07-08 04:48:11
4f85aaebc6bf645168b5a51a5d3c40c9162734a3...89a9a747b603ae21945aa0cbcdf13560d3e7cea1,4,575,0,575,4,2007-07-08 05:00:24,2007-07-08 05:00:24
89a9a747b603ae21945aa0cbcdf13560d3e7cea1...e155a6ae51fad3649e77ebc6f784e4fc6b957ad1,1,3,0,3,1,2007-07-08 07:02:36,2007-07-08 07:02:36
e155a6ae51fad3649e77ebc6f784e4fc6b957ad1...52c6739c20838f2d705d404664dcc0cfa07f2c30,1,26,4,30,5,2007-07-08 16:06:10,2007-07-08 16:06:10
52c6739c20838f2d705d404664dcc0cfa07f2c30...6f0c9a5fd751d590be07e890758b8229e630413d,1,21,0,21,1,2007-07-08 16:28:45,2007-07-08 16:28:45
6f0c9a5fd751d590be07e890758b8229e630413d...b83a6b7a323d63280fe325b06e1c38d26b5031a9,1,1,1,2,1,2007-07-08 16:33:23,2007-07-08 16:33:23
b83a6b7a323d63280fe325b06e1c38d26b5031a9...feb475d9b1f7fc0a1b6efa746e952893014ff771,1,2,3,5,2,2007-07-08 16:35:48,2007-07-08 16:35:48
feb475d9b1f7fc0a1b6efa746e952893014ff771...5e7c1fc3ae42e2312bccc7679b03238f7e5d5c17,1,4,2,6,2,2007-07-08 20:22:50,2007-07-08 20:22:50
5e7c1fc3ae42e2312bccc7679b03238f7e5d5c17...b5bf00a37368baf69595434c0329f869b9ca18e9,1,18,9,27,5,2007-07-08 22:26:05,2007-07-08 22:26:05
b5bf00a37368baf69595434c0329f869b9ca18e9...69ef5fac9e84623c1260cf4d548c1034ac7e45a8,2,28,8,36,8,2007-07-08 23:19:09,2007-07-08 23:19:09
69ef5fac9e84623c1260cf4d548c1034ac7e45a8...b147039acc32884b50b955ebd94eeaa430713786,2,18,10,28,10,2007-07-08 23:52:14,2007-07-08 23:52:14
b147039acc32884b50b955ebd94eeaa430713786...b09043fbf6d98adfd22f85a347256f545afb2c11,1,4,1,5,1,2007-07-09 00:02:32,2007-07-09 00:02:32
b09043fbf6d98adfd22f85a347256f545afb2c11...54035207fe91cb57f49bb8c0c9f7b4ada8d05346,4,34,13,47,6,2007-07-09 00:15:44,2007-07-09 00:15:44
54035207fe91cb57f49bb8c0c9f7b4ada8d05346...c4eddea7c3adfddc79a6b43de69f0b31cff980d0,1,77,6,83,4,2007-07-09 00:20:44,2007-07-09 00:20:44
c4eddea7c3adfddc79a6b43de69f0b31cff980d0...de71a046e619884292b122ddcf1401ad9932a5c7,1,86,65,151,5,2007-07-09 00:48:16,2007-07-09 00:48:16
de71a046e619884292b122ddcf1401ad9932a5c7...d776dc9d5c5322e81b56272728325990ed6892bb,6,74,47,121,26,2007-07-09 03:08:20,2007-07-09 03:08:20
d776dc9d5c5322e81b56272728325990ed6892bb...0bb035a1abc37fbf033a18ac53dd62ec85599a49,2,115,30,145,10,2007-07-09 16:14:19,2007-07-09 16:14:19
0bb035a1abc37fbf033a18ac53dd62ec85599a49...7c85d973bfa8f716e9331423c74d35489236bb4e,1,68,41,109,13,2007-07-10 02:38:20,2007-07-10 02:38:20
7c85d973bfa8f716e9331423c74d35489236bb4e...9e83f1b65fa34e97cfd86ba17514d014749360e8,1,1,1,2,1,2007-07-12 20:33:05,2007-07-12 20:33:05
9e83f1b65fa34e97cfd86ba17514d014749360e8...4577cd4b16b633a7015d02ff229898b58831dd18,1,4,1,5,1,2007-07-15 02:42:11,2007-07-15 02:42:11
4577cd4b16b633a7015d02ff229898b58831dd18...eb5529eac0f73c273ecd6ab1968b30b00c48d903,2,16,5,21,5,2007-07-17 07:54:14,2007-07-17 07:54:14
eb5529eac0f73c273ecd6ab1968b30b00c48d903...3604d14896568ecdaaa232dc12380a56fa7c4b0c,1,9,5,14,1,2007-07-20 18:08:29,2007-07-20 18:08:29
3604d14896568ecdaaa232dc12380a56fa7c4b0c...a40f141f23a3e3addcfae71676ff187f139eb8cb,1,3,3,6,2,2007-07-20 18:58:22,2007-07-20 18:58:22
a40f141f23a3e3addcfae71676ff187f139eb8cb...f267cfaedf9f01ddf1f6f9c214ea07906c01a84a,1,2,2,4,1,2007-07-20 18:58:38,2007-07-20 18:58:38
f267cfaedf9f01ddf1f6f9c214ea07906c01a84a...78db847ef201a66f88e9ad330b2e51c65c58abb3,1,14,9,23,2,2007-07-20 19:33:44,2007-07-20 19:33:44
78db847ef201a66f88e9ad330b2e51c65c58abb3...42f30dd1812fc0ee262eaa43f0a354d8e439938c,1,1,1,2,1,2007-07-20 19:41:17,2007-07-20 19:41:17
42f30dd1812fc0ee262eaa43f0a354d8e439938c...a2482e5e87558edb2be67fd6e7369bb62168fde9,1,1,1,2,1,2007-07-20 19:44:15,2007-07-20 19:44:15
a2482e5e87558edb2be67fd6e7369bb62168fde9...9ffd93d53a44ad6dd56646b2e15740a49c1b4f08,1,2,2,4,2,2007-07-20 20:05:20,2007-07-20 20:05:20
9ffd93d53a44ad6dd56646b2e15740a49c1b4f08...6c5bfffd20797a043355958b1f0d27717ebd20e7,1,11,13,24,2,2007-07-20 21:53:37,2007-07-20 21:53:37
6c5bfffd20797a043355958b1f0d27717ebd20e7...c47f6f8f523c8add478fbf5570a67015426f5b86,2,16,51,67,9,2007-07-20 21:59:52,2007-07-20 21:59:52
c47f6f8f523c8add478fbf5570a67015426f5b86...f83211c684b0a1031001c448ff7a4cfbac8c1c1f,1,1,1,2,1,2007-07-20 22:21:41,2007-07-20 22:21:41
f83211c684b0a1031001c448ff7a4cfbac8c1c1f...e647a8a1f63864aa350e8c24926170d0fdff653c,1,3,0,3,1,2007-07-20 22:47:21,2007-07-20 22:47:21
e647a8a1f63864aa350e8c24926170d0fdff653c...97a6bdbaba302015e84c54a5024dd7faadf35581,1,1,1,2,1,2007-07-20 23:43:12,2007-07-20 23:43:12
97a6bdbaba302015e84c54a5024dd7faadf35581...37407164803df62c4efb1332e7f94b56e693a108,1,4,2,6,4,2007-07-21 00:12:18,2007-07-21 00:12:18
37407164803df62c4efb1332e7f94b56e693a108...e20e8e6e3cc565469cedfad105565ce534c98c71,1,6,3,9,2,2007-07-21 00:52:30,2007-07-21 00:52:30
e20e8e6e3cc565469cedfad105565ce534c98c71...24463a04ce5612f4007263f9af0d1e4d7568ed9a,2,15,4,19,5,2007-07-21 01:04:59,2007-07-21 01:04:59
24463a04ce5612f4007263f9af0d1e4d7568ed9a...b965c98ff1cf3038164c627d74df40f68bcc0a82,1,1,1,2,1,2007-07-21 01:53:38,2007-07-21 01:53:38
b965c98ff1cf3038164c627d74df40f68bcc0a82...480aae72d3fe7c10eb51e310b88acc37c34f8bd8,1,1,1,2,1,2007-07-21 01:55:05,2007-07-21 01:55:05
480aae72d3fe7c10eb51e310b88acc37c34f8bd8...9b9a7932735d43a936c74084a613f21b250de6f9,1,25,15,40,2,2007-07-21 03:16:22,2007-07-21 03:16:22
9b9a7932735d43a936c74084a613f21b250de6f9...a65a811ce03b2f7900ae0daa18d4d9fc213acbfd,1,14,8,22,6,2007-07-21 04:26:13,2007-07-21 04:26:13
a65a811ce03b2f7900ae0daa18d4d9fc213acbfd...bdf05d890fe3a8cc085b2b4f13881ca043943e44,2,3,2,5,3,2007-07-25 00:39:45,2007-07-25 00:39:45
bdf05d890fe3a8cc085b2b4f13881ca043943e44...f8b00051c377360f0106e56c24df1353aaf6ad44,2,3,2,5,2,2007-07-25 00:56:50,2007-07-25 00:56:50
f8b00051c377360f0106e56c24df1353aaf6ad44...8a80d05a446ac7ac8a95459fb68932ddf539ff62,1,1,1,2,1,2007-07-26 00:27:56,2007-07-26 00:27:56
8a80d05a446ac7ac8a95459fb68932ddf539ff62...e6c067858ec7f2c4e3e7da90f16c695f93a4ee07,1,1,1,2,1,2007-07-26 00:31:48,2007-07-26 00:31:48
e6c067858ec7f2c4e3e7da90f16c695f93a4ee07...80a149b82831defa1a9f724801daefda0a8c5685,9,403,373,776,19,2007-07-29 19:07:21,2007-07-29 19:07:21
80a149b82831defa1a9f724801daefda0a8c5685...3c82f8fb4aed7b4e65e1dd9ed79718a155a7a492,2,43,12,55,8,2007-07-29 22:32:06,2007-07-29 22:32:06
3c82f8fb4aed7b4e65e1dd9ed79718a155a7a492...17949afc34d2fa7626bcc739b5008d32ee411660,1,13,10,23,5,2007-07-29 23:01:42,2007-07-29 23:01:42
17949afc34d2fa7626bcc739b5008d32ee411660...d8e9f0c616402ed1b4dab244ff5f8680ed0a415f,1,1,1,2,1,2007-07-29 23:10:00,2007-07-29 23:10:00
d8e9f0c616402ed1b4dab244ff5f8680ed0a415f...334462b23c3daca53f2fbff177693f0f1ba29c48,1,5,1,6,1,2007-07-30 02:14:06,2007-07-30 02:14:06
334462b23c3daca53f2fbff177693f0f1ba29c48...660490e6f487332aaf10c19fd9bbb325bc9946af,2,13,3,16,4,2007-07-30 02:52:24,2007-07-30 02:52:24
660490e6f487332aaf10c19fd9bbb325bc9946af...4ae80a1e2cfe7445501e8f365d72417014cf1acb,1,1,1,2,1,2007-07-31 02:22:39,2007-07-31 02:22:39
4ae80a1e2cfe7445501e8f365d72417014cf1acb...6b0d3bb273f09910921ed84539de06c2e7ecd19b,2,17,2,19,3,2007-07-31 02:59:53,2007-07-31 02:59:53
6b0d3bb273f09910921ed84539de06c2e7ecd19b...560484fd8d17ce6cf0b0d5748ad55d3dcb19d44f,1,3,3,6,3,2007-08-07 22:23:30,2007-08-07 22:23:30
560484fd8d17ce6cf0b0d5748ad55d3dcb19d44f...78fe70f3e6585dd645ac7b0d8dc0ca06fee113e1,1,2,2,4,2,2007-08-07 22:25:26,2007-08-07 22:25:26
78fe70f3e6585dd645ac7b0d8dc0ca06fee113e1...d38ee78db9b8a8a89b985928c1d23543cb2ff1cd,1,4,7,11,4,2007-08-14 16:37:14,2007-08-14 16:37:14
d38ee78db9b8a8a89b985928c1d23543cb2ff1cd...760a244dbdca7b5a93d147c62ac37ff6eeb9573b,2,6,2,8,3,2007-08-16 03:35:29,2007-08-16 03:35:29
760a244dbdca7b5a93d147c62ac37ff6eeb9573b...05d401dd8439d8a2137d3fb69a70d671c0d3a69d,3,16,7,23,11,2007-08-19 00:07:41,2007-08-19 00:07:41
05d401dd8439d8a2137d3fb69a70d671c0d3a69d...f64eb21fade249bf0dc9d7ab820eafaaf4a521ad,1,31,30,61,4,2007-08-19 00:48:53,2007-08-19 00:48:53
f64eb21fade249bf0dc9d7ab820eafaaf4a521ad...735e2e8197e391c2666766d2b2ba924fe5fb73d8,1,1,1,2,1,2007-08-19 07:06:15,2007-08-19 07:06:15
735e2e8197e391c2666766d2b2ba924fe5fb73d8...24db022ba06523f92e94ac5fa791fc4865b55ba7,2,17,3,20,3,2007-08-19 07:28:41,2007-08-19 07:28:41
24db022ba06523f92e94ac5fa791fc4865b55ba7...2ef4093cf7f52383dd43bd361864edcda27e5c3c,14,362,271,633,92,2007-08-19 23:37:26,2007-08-19 23:37:26
2ef4093cf7f52383dd43bd361864edcda27e5c3c...887c00780df75ab42228285e4571b9052e6fd51a,2,12,0,12,2,2007-08-20 02:51:57,2007-08-20 02:51:57
887c00780df75ab42228285e4571b9052e6fd51a...2b05e24993c48f3b9c2cb9857090dc4b218b8834,2,5,2,7,3,2007-08-20 03:59:34,2007-08-20 03:59:34
2b05e24993c48f3b9c2cb9857090dc4b218b8834...f0353e89abf6643e5a88a649887a71a9ebd973d9,1,8,2,10,2,2007-08-20 06:29:41,2007-08-20 06:29:41
f0353e89abf6643e5a88a649887a71a9ebd973d9...05fb8eaa1058578f911ab5d0d4436e97010f4cc7,1,15,9,24,2,2007-08-20 07:04:00,2007-08-20 07:04:00
05fb8eaa1058578f911ab5d0d4436e97010f4cc7...bd78d4f65dea2fc5fbfd58a0f099f8839ee9707d,2,2,2,4,2,2007-08-20 07:08:01,2007-08-20 07:08:01
bd78d4f65dea2fc5fbfd58a0f099f8839ee9707d...4d4f13a96b65b31eea9dd6c706324274d97cbb36,0,0,0,0,0,2007-08-20 18:59:21,2007-08-20 18:59:21
4d4f13a96b65b31eea9dd6c706324274d97cbb36...8cf5d2df19d918bb84f4c59bc4346c215fbfaf88,0,0,0,0,0,2007-08-20 20:31:06,2007-08-20 20:31:06
8cf5d2df19d918bb84f4c59bc4346c215fbfaf88...e112e6b04d1736d3a847d44b96f7178175e17a15,3,11,5,16,5,2007-08-21 04:42:31,2007-08-21 04:42:31
e112e6b04d1736d3a847d44b96f7178175e17a15...8c15e852a4614ba5a5100e1c6e8a833c39b4ca79,2,2,2,4,2,2007-08-21 04:46:07,2007-08-21 04:46:07
8c15e852a4614ba5a5100e1c6e8a833c39b4ca79...b6d920cf05fae3dcfe515166013ce39411ac5e16,5,40,39,79,18,2007-08-21 05:43:44,2007-08-21 05:43:44
b6d920cf05fae3dcfe515166013ce39411ac5e16...c8bd6e0a4aef14ad4808a63fc106849918ea4666,2,2,2,4,2,2007-08-21 07:00:06,2007-08-21 07:00:06
c8bd6e0a4aef14ad4808a63fc106849918ea4666...46e770352a9d68fe72a2cf59fc2d18fe61669730,2,6,2,8,3,2007-08-21 07:33:52,2007-08-21 07:33:52
46e770352a9d68fe72a2cf59fc2d18fe61669730...b99fd476d07e737274c132a8e938cda73cf26377,1,30,11,41,5,2007-08-21 08:25:11,2007-08-21 08:25:11
b99fd476d07e737274c132a8e938cda73cf26377...e06b7447c2e8887549338b3b5f4fa9ed65fe9dcd,1,1,1,2,1,2007-08-22 04:52:53,2007-08-22 04:52:53
e06b7447c2e8887549338b3b5f4fa9ed65fe9dcd...fc3e180465a88558321b6550ac4692d7cc4b281f,1,12,6,18,5,2007-08-22 05:44:47,2007-08-22 05:44:47
fc3e180465a88558321b6550ac4692d7cc4b281f...f2f399dcd552e73f68c9e8adfe26ef7995724cb3,2,3,3,6,3,2007-08-22 06:19:22,2007-08-22 06:19:22
f2f399dcd552e73f68c9e8adfe26ef7995724cb3...96f2d0d00ba58f6b23dc5658e6c747526e9254d9,1,1,1,2,1,2007-08-22 06:19:47,2007-08-22 06:19:47
96f2d0d00ba58f6b23dc5658e6c747526e9254d9...3fb4779abbd4c8b12efda6a5648da8a7e002cab2,1,1,1,2,1,2007-08-22 06:47:44,2007-08-22 06:47:44
3fb4779abbd4c8b12efda6a5648da8a7e002cab2...f53aa62fd3f08ad7a05e99e3836132216a8d5c7d,2,12,3,15,4,2007-08-22 06:51:41,2007-08-22 06:51:41
f53aa62fd3f08ad7a05e99e3836132216a8d5c7d...f948f026809eab3d238cf6dc369cb5b86b61ce8c,1,10,5,15,7,2007-08-22 07:10:50,2007-08-22 07:10:50
f948f026809eab3d238cf6dc369cb5b86b61ce8c...4df20c0c1b8506981087dd8702f3a076bd57d017,1,6,1,7,1,2007-08-24 01:06:23,2007-08-24 01:06:23
4df20c0c1b8506981087dd8702f3a076bd57d017...257eaf7ee32df66ddd0a3333a5b6a829b9d388ef,3,11,0,11,11,2007-08-24 01:28:07,2007-08-24 01:28:07
257eaf7ee32df66ddd0a3333a5b6a829b9d388ef...557ec9a92f40f97254e48240825fcb9be5a08e20,1,1,1,2,1,2007-08-24 01:49:27,2007-08-24 01:49:27
557ec9a92f40f97254e48240825fcb9be5a08e20...97f2032e13b85db72910e9cc1e75f2eb75e43dc4,1,7,11,18,4,2007-08-25 03:03:27,2007-08-25 03:03:27
97f2032e13b85db72910e9cc1e75f2eb75e43dc4...34f1042902f8dbf133fdc3c62d17e12ec0cb7a26,1,17,1,18,2,2007-08-25 03:33:08,2007-08-25 03:33:08
34f1042902f8dbf133fdc3c62d17e12ec0cb7a26...0477a6e99e95ae93da983e7fc2a30bf16ea8ca77,3,16,2,18,3,2007-08-25 03:55:12,2007-08-25 03:55:12
0477a6e99e95ae93da983e7fc2a30bf16ea8ca77...3ae74b523ec379a1753d116bb7f1aec8db2c52d4,2,54,1,55,3,2007-08-25 05:12:20,2007-08-25 05:12:20
3ae74b523ec379a1753d116bb7f1aec8db2c52d4...127c0b8a5d9ab35f9f0b91688a8ff7df45244977,2,4,2,6,3,2007-08-27 04:58:02,2007-08-27 04:58:02
127c0b8a5d9ab35f9f0b91688a8ff7df45244977...25e83d27cb20ba8aa5dec7fec2d05e4da52d9fee,1,6,2,8,2,2007-08-28 04:34:23,2007-08-28 04:34:23
25e83d27cb20ba8aa5dec7fec2d05e4da52d9fee...15faf783b9c3c454868b5054fdcfb63e8950abf9,1,5,0,5,3,2007-08-28 04:42:35,2007-08-28 04:42:35
15faf783b9c3c454868b5054fdcfb63e8950abf9...042a46386a4e5efe787f963245aa534663559838,2,46,9,55,11,2007-08-30 05:51:11,2007-08-30 05:51:11
042a46386a4e5efe787f963245aa534663559838...5c19701a89c4b56e130a213759eb035fb0c302dc,2,33,8,41,8,2007-08-30 16:34:34,2007-08-30 16:34:34
5c19701a89c4b56e130a213759eb035fb0c302dc...079d651e10bc19a28c49945617e842415dc41981,2,26,0,26,2,2007-08-31 03:26:03,2007-08-31 03:26:03
079d651e10bc19a28c49945617e842415dc41981...85afa7c1ba32e2e867b89e4222a4d27ea97dd20d,2,9,1,10,2,2007-08-31 03:38:02,2007-08-31 03:38:02
85afa7c1ba32e2e867b89e4222a4d27ea97dd20d...e3263063e4ef3d2e0ee6b74b9da573bf40e87668,2,60,25,85,8,2007-08-31 05:33:43,2007-08-31 05:33:43
e3263063e4ef3d2e0ee6b74b9da573bf40e87668...fbd2b066a71c8c2371e11f7f6b201a9000b564e4,1,1,1,2,1,2007-08-31 05:41:08,2007-08-31 05:41:08
fbd2b066a71c8c2371e11f7f6b201a9000b564e4...346ceacce3fb6f83701d742ce0835d4db0ba98aa,3,8,3,11,4,2007-08-31 05:43:24,2007-08-31 05:43:24
346ceacce3fb6f83701d742ce0835d4db0ba98aa...a5c319f922efcf34652d0632a945d20a0ab36ca6,1,1,1,2,1,2007-09-02 22:34:18,2007-09-02 22:34:18
a5c319f922efcf34652d0632a945d20a0ab36ca6...456f0fe5985eaad42eba456b9ff710771669607c,2,52,10,62,11,2007-09-03 14:53:09,2007-09-03 14:53:09
456f0fe5985eaad42eba456b9ff710771669607c...a5dbcaf67579b2266b64ffbdd2a328d180f7f64b,4,420,161,581,39,2007-09-03 23:45:14,2007-09-03 23:45:14
a5dbcaf67579b2266b64ffbdd2a328d180f7f64b...d5bb0e317988965306b1ccb395fafc4554aba49c,1,2,2,4,2,2007-09-03 23:59:31,2007-09-03 23:59:31
d5bb0e317988965306b1ccb395fafc4554aba49c...1ce8006d480ebd64350983a17be1cc2e3f043958,2,39,2,41,4,2007-09-04 00:28:22,2007-09-04 00:28:22
1ce8006d480ebd64350983a17be1cc2e3f043958...139393fe0978e79c427ad13f1a03a10431ef95e5,5,10,2848,2858,80,2007-09-04 01:57:35,2007-09-04 01:57:35
139393fe0978e79c427ad13f1a03a10431ef95e5...53dc6afc310aa0e5df094304996ef605d4dbbd58,6,85,180,265,49,2007-09-04 02:55:38,2007-09-04 02:55:38
53dc6afc310aa0e5df094304996ef605d4dbbd58...7d02f06e036f6a42ccd2c276e9f00a7cd35dc74a,2,30,2,32,4,2007-09-04 04:17:14,2007-09-04 04:17:14
7d02f06e036f6a42ccd2c276e9f00a7cd35dc74a...d259ec1a93ea087d76c02009eccaa42786f737bb,2,13,1,14,3,2007-09-04 04:34:48,2007-09-04 04:34:48
d259ec1a93ea087d76c02009eccaa42786f737bb...f28f199dc0a353135ef8b9afa2f3d25c6ffd2c75,2,14,2,16,4,2007-09-04 04:44:54,2007-09-04 04:44:54
f28f199dc0a353135ef8b9afa2f3d25c6ffd2c75...f96bf1041553775a94c1034c97e253e350217173,7,130,38,168,16,2007-09-05 17:06:05,2007-09-05 17:06:05
f96bf1041553775a94c1034c97e253e350217173...ad5539bab3e1d6806e054dd5b14cf341a675ded0,1,2,2,4,2,2007-09-05 17:09:18,2007-09-05 17:09:18
ad5539bab3e1d6806e054dd5b14cf341a675ded0...84eb2cffca04d231015e86a4c1d9d23f9efbd68e,1,5,5,10,5,2007-09-05 17:22:13,2007-09-05 17:22:13
84eb2cffca04d231015e86a4c1d9d23f9efbd68e...ba2109136deda8fce5bd4d4dc96f0a45ffaf646a,1,2,2,4,2,2007-09-07 19:28:25,2007-09-07 19:28:25
ba2109136deda8fce5bd4d4dc96f0a45ffaf646a...3abf3125cb737f120b6b86c6011fd7ce0e6ba7cc,1,15,0,15,1,2007-09-07 21:39:44,2007-09-07 21:39:44
3abf3125cb737f120b6b86c6011fd7ce0e6ba7cc...902554a38da6c9e2d0c115bc189634d56f9b4d34,1,218,166,384,37,2007-09-07 21:57:40,2007-09-07 21:57:40
902554a38da6c9e2d0c115bc189634d56f9b4d34...13b66c8ba9618242df2c1cc352a2b1d879c36188,1,4,1,5,1,2007-09-08 12:33:06,2007-09-08 12:33:06
13b66c8ba9618242df2c1cc352a2b1d879c36188...b4e23b5af0820a66c2e275051f613f3df9a4444d,29,16,16,32,7,2007-09-08 12:42:32,2007-09-08 12:42:32
b4e23b5af0820a66c2e275051f613f3df9a4444d...6728e3cf74d02794113deb0af70a5f9a7caa2241,7,7,5,12,3,2007-09-08 12:46:01,2007-09-08 12:46:01
6728e3cf74d02794113deb0af70a5f9a7caa2241...d2f82aba26e49e957af493b4ed81c025ac5c194b,1,4,0,4,1,2007-09-08 13:49:42,2007-09-08 13:49:42
d2f82aba26e49e957af493b4ed81c025ac5c194b...28ee5c692245e18bdedcc91372949ec8b784ee36,3,92,2,94,4,2007-09-08 14:44:29,2007-09-08 14:44:29
28ee5c692245e18bdedcc91372949ec8b784ee36...2ce41905c4e9f2a9e9016b6d9eae806bfd1953de,1,0,14,14,1,2007-09-08 14:50:11,2007-09-08 14:50:11
2ce41905c4e9f2a9e9016b6d9eae806bfd1953de...cc22c04c9087d33ba403bd9630f04aababf82030,2,1,3,4,2,2007-09-08 14:58:52,2007-09-08 14:58:52
cc22c04c9087d33ba403bd9630f04aababf82030...2929f8aa67584fc5fab05bdfae8a5b06245cacc7,1,14,33,47,4,2007-09-08 16:19:34,2007-09-08 16:19:34
2929f8aa67584fc5fab05bdfae8a5b06245cacc7...15a78f8fea8679205bc734ec053ff24ebbfd31c8,3,6,1,7,3,2007-09-08 18:02:39,2007-09-08 18:02:39
15a78f8fea8679205bc734ec053ff24ebbfd31c8...3a4e1233aa2acabee0d0267d54c2d1112fbdcad4,5,109,48,157,35,2007-09-08 23:31:23,2007-09-08 23:31:23
3a4e1233aa2acabee0d0267d54c2d1112fbdcad4...7e9d8531544c00b80969b135b19bd2bfad686739,1,1,1,2,1,2007-09-09 16:12:56,2007-09-09 16:12:56
7e9d8531544c00b80969b135b19bd2bfad686739...97fe63cb4826cbeb74bc0c3a72648f57ae0f0881,1,5,8,13,3,2007-09-09 16:17:32,2007-09-09 16:17:32
97fe63cb4826cbeb74bc0c3a72648f57ae0f0881...4e504d86b9dc9e1501f598744f6c3b19f834c487,1,3,2,5,3,2007-09-09 18:09:27,2007-09-09 18:09:27
4e504d86b9dc9e1501f598744f6c3b19f834c487...b4bf244c0e3ca1c0945e2bfe0bf1a117b20f567e,1,8,5,13,4,2007-09-09 18:29:15,2007-09-09 18:29:15
b4bf244c0e3ca1c0945e2bfe0bf1a117b20f567e...b59c94d5c23c0b1ec4b2506be0aed6b0578f19f3,1,42,13,55,7,2007-09-09 19:00:56,2007-09-09 19:00:56
b59c94d5c23c0b1ec4b2506be0aed6b0578f19f3...052aa1445a780f69576a800836be73b57b62a909,2,6,4,10,5,2007-09-09 21:34:37,2007-09-09 21:34:37
052aa1445a780f69576a800836be73b57b62a909...139b03af7c2d7e70a26591424f82f09a02132198,1,14,4,18,2,2007-09-09 22:59:41,2007-09-09 22:59:41
139b03af7c2d7e70a26591424f82f09a02132198...cd6ec6e157f78ab6810ae79c88ebdf6300d5d458,1,10,8,18,1,2007-09-09 23:08:21,2007-09-09 23:08:21
cd6ec6e157f78ab6810ae79c88ebdf6300d5d458...f38251b2ce84a0ab6302475786c3e721dba2177c,1,1,1,2,1,2007-09-09 23:17:30,2007-09-09 23:17:30
f38251b2ce84a0ab6302475786c3e721dba2177c...899ee03d37b6cbe6d0e8abc497026d611325cfba,1,2,1,3,1,2007-09-10 00:00:30,2007-09-10 00:00:30
899ee03d37b6cbe6d0e8abc497026d611325cfba...6476b15f1a6c3651c18e354d41ee0ab9b9a23e16,1,7,2,9,4,2007-09-10 18:39:16,2007-09-10 18:39:16
6476b15f1a6c3651c18e354d41ee0ab9b9a23e16...ce256312d518e16a6ee7df5f7f301b8bf9a1caf2,1,1,1,2,1,2007-09-10 18:51:39,2007-09-10 18:51:39
ce256312d518e16a6ee7df5f7f301b8bf9a1caf2...a36771c83e8a8317b70ff2372cbbefd87e4d9dce,1,19,19,38,5,2007-09-10 19:43:58,2007-09-10 19:43:58
a36771c83e8a8317b70ff2372cbbefd87e4d9dce...2608bae43818bbb3b828e35a2684d0a8a51cb5ab,1,2,2,4,2,2007-09-11 00:43:12,2007-09-11 00:43:12
2608bae43818bbb3b828e35a2684d0a8a51cb5ab...ed51be16224d392ae0b539d7aa2db294973c624d,1,1,1,2,1,2007-09-11 01:08:51,2007-09-11 01:08:51
ed51be16224d392ae0b539d7aa2db294973c624d...4c5f091d228477087fcaf8ab13d7473497a4aa80,1,5,5,10,1,2007-09-11 02:13:00,2007-09-11 02:13:00
4c5f091d228477087fcaf8ab13d7473497a4aa80...e22336e7ae57833d1e903be196abdcd8d244e496,1,5,5,10,1,2007-09-12 15:45:05,2007-09-12 15:45:05
e22336e7ae57833d1e903be196abdcd8d244e496...e4a62e4ec60a1dc36274e5706b46faadf455bd16,1,1,1,2,1,2007-09-12 21:04:10,2007-09-12 21:04:10
e4a62e4ec60a1dc36274e5706b46faadf455bd16...8ece9e8fb1278e4e62aeb8896979b2a6815dcb3e,1,4,1,5,2,2007-09-12 22:16:43,2007-09-12 22:16:43
8ece9e8fb1278e4e62aeb8896979b2a6815dcb3e...08a6acc36262bc6e235bb50584ee5dc5c24fbe6d,1,10,10,20,3,2007-09-13 16:44:44,2007-09-13 16:44:44
08a6acc36262bc6e235bb50584ee5dc5c24fbe6d...500ff12d5da5e0d454663203101d65c9ed37cffa,1,10,4,14,3,2007-09-13 16:45:53,2007-09-13 16:45:53
500ff12d5da5e0d454663203101d65c9ed37cffa...41590d37e109453ae58b38d4889031f4130e7f64,1,2,2,4,2,2007-09-14 17:47:01,2007-09-14 17:47:01
41590d37e109453ae58b38d4889031f4130e7f64...82eccdfcd0ba2e97c3fb7abac20b1146fbce5b2d,1,3,0,3,1,2007-09-14 23:58:51,2007-09-14 23:58:51
82eccdfcd0ba2e97c3fb7abac20b1146fbce5b2d...6d71a10ed2b751f0e275506b24b82d5f611bfdac,2,5,5,10,5,2007-09-15 00:23:21,2007-09-15 00:23:21
6d71a10ed2b751f0e275506b24b82d5f611bfdac...d9a3b133f1bf6a283349b5c0ab64b7c09cb9b92b,1,1,0,1,1,2007-09-15 00:35:16,2007-09-15 00:35:16
d9a3b133f1bf6a283349b5c0ab64b7c09cb9b92b...62d84e44ac3b4a3673c320514bbf5ac8dc7712d6,2,20,13,33,8,2007-09-15 01:18:30,2007-09-15 01:18:30
62d84e44ac3b4a3673c320514bbf5ac8dc7712d6...606b863edaff29035960e4d813b45d63b8d92876,2,29,10,39,4,2007-09-15 02:16:29,2007-09-15 02:16:29
606b863edaff29035960e4d813b45d63b8d92876...d5f2129ac49e04185b49b7d5a548efa451d31dbc,1,3,3,6,3,2007-09-15 02:23:08,2007-09-15 02:23:08
d5f2129ac49e04185b49b7d5a548efa451d31dbc...9c2c47d7c021d1d944798642d0e7d51423af6bd8,1,19,20,39,12,2007-09-15 02:24:44,2007-09-15 02:24:44
9c2c47d7c021d1d944798642d0e7d51423af6bd8...df246df2da4ff76b37959878c006464c6b438906,1,4,7,11,4,2007-09-15 02:40:42,2007-09-15 02:40:42
df246df2da4ff76b37959878c006464c6b438906...1088d06e5485451549990e6143001488f1580d83,1,1,1,2,1,2007-09-15 03:05:00,2007-09-15 03:05:00
1088d06e5485451549990e6143001488f1580d83...3dabd7ec301770a2a6bb8457c96d630d42376719,2,7,1,8,3,2007-09-15 03:08:46,2007-09-15 03:08:46
3dabd7ec301770a2a6bb8457c96d630d42376719...dbca9cbf629e282b511c32c8c870da37ef9fa92b,1,2,2,4,1,2007-09-15 03:12:56,2007-09-15 03:12:56
dbca9cbf629e282b511c32c8c870da37ef9fa92b...f6a2e1734f73e30386e2679d4f4a8e5ac9a46f88,1,2,2,4,1,2007-09-15 03:26:33,2007-09-15 03:26:33
f6a2e1734f73e30386e2679d4f4a8e5ac9a46f88...e0c6e4ef98302345cc17131675e2c1f9f17b62f1,1,1,1,2,1,2007-09-15 03:44:44,2007-09-15 03:44:44
e0c6e4ef98302345cc17131675e2c1f9f17b62f1...456da2d4a805012003df3c1b173148368d3536f7,1,1,1,2,1,2007-09-17 03:42:06,2007-09-17 03:42:06
456da2d4a805012003df3c1b173148368d3536f7...415a0916b54a0dd3123893d67cc9091dd8ebe1d6,1,1,1,2,1,2007-09-17 18:20:51,2007-09-17 18:20:51
415a0916b54a0dd3123893d67cc9091dd8ebe1d6...537d7ca86902df1d2b61155d2822c7552030d846,1,13,2,15,8,2007-09-17 19:14:05,2007-09-17 19:14:05
537d7ca86902df1d2b61155d2822c7552030d846...aee81963ba7a43618c176cd78276f3c0c8c6745c,1,1,1,2,1,2007-09-18 12:38:15,2007-09-18 12:38:15
aee81963ba7a43618c176cd78276f3c0c8c6745c...d5999be9ae4946d8996b2bbd8df66d6c457c4f30,1,2,1,3,1,2007-09-18 14:35:41,2007-09-18 14:35:41
d5999be9ae4946d8996b2bbd8df66d6c457c4f30...c9899a74ac7b7ddb8663f4aa074c1c05f6514e5a,1,1,1,2,1,2007-09-18 18:08:35,2007-09-18 18:08:35
c9899a74ac7b7ddb8663f4aa074c1c05f6514e5a...595d1253653c618a8a112ec09777c294125195d9,1,31,8,39,9,2007-09-21 21:41:56,2007-09-21 21:41:56
595d1253653c618a8a112ec09777c294125195d9...b45325765327d257f00b55cd5383287c1bd94875,2,57,55,112,5,2007-09-23 15:58:49,2007-09-23 15:58:49
b45325765327d257f00b55cd5383287c1bd94875...92a9e73bbef6f995c4b4fc6fb6c566432f2d0671,1,575,423,998,235,2007-09-23 16:55:19,2007-09-23 16:55:19
92a9e73bbef6f995c4b4fc6fb6c566432f2d0671...a9add215ea64075ed1b512ceb6ac926cb9e5bd76,1,15,26,41,8,2007-09-26 22:28:00,2007-09-26 22:28:00
a9add215ea64075ed1b512ceb6ac926cb9e5bd76...6e8a8c535974ebada1e5dde9fa380c2c040106ce,1,12,37,49,4,2007-09-27 15:23:07,2007-09-27 15:23:07
6e8a8c535974ebada1e5dde9fa380c2c040106ce...ee2efbe1e39d32d4ec3a1598f66044e59474c708,1,2,2,4,1,2007-09-27 18:09:23,2007-09-27 18:09:23
ee2efbe1e39d32d4ec3a1598f66044e59474c708...1344a7fd503054299442c3463a0e311729f8229a,1,3,3,6,2,2007-09-27 20:49:30,2007-09-27 20:49:30
1344a7fd503054299442c3463a0e311729f8229a...beebbf8ba44655f2f90750f727ef9cbdfe152f1c,1,6,3,9,3,2007-10-01 14:14:09,2007-10-01 14:14:09
beebbf8ba44655f2f90750f727ef9cbdfe152f1c...ad1cef94bf134ff7f471a0649dac0158a481cd5d,2,21,10,31,5,2007-10-01 20:15:20,2007-10-01 20:15:20
ad1cef94bf134ff7f471a0649dac0158a481cd5d...bb998f25185e9b98514219e2ab169411f4ed7fb0,1,10,5,15,5,2007-10-06 16:45:20,2007-10-06 16:45:20
bb998f25185e9b98514219e2ab169411f4ed7fb0...92aac3abd6bc493a0c5f216e2e51359024b90af1,2,47,37,84,29,2007-10-06 17:04:20,2007-10-06 17:04:20
92aac3abd6bc493a0c5f216e2e51359024b90af1...a5f95c88c1c58565f0707e6c21bdf1874938a9d3,1,2,2,4,1,2007-10-06 21:00:37,2007-10-06 21:00:37
a5f95c88c1c58565f0707e6c21bdf1874938a9d3...0f5c1d15e974fdc44f4f2182e07d4ed6f9a37707,1,1305,1305,2610,1,2007-10-12 09:46:48,2007-10-12 09:46:48
0f5c1d15e974fdc44f4f2182e07d4ed6f9a37707...971840f343dae04fdc6ff51ecb03ec8b3aaee067,2,5,2,7,3,2007-10-12 12:51:07,2007-10-12 12:51:07
971840f343dae04fdc6ff51ecb03ec8b3aaee067...a2fc65fd3296931486974a3b362949ebc1a01062,1,12,16,28,2,2007-10-15 17:55:54,2007-10-15 17:55:54
a2fc65fd3296931486974a3b362949ebc1a01062...e287007f6a129901a07b6a342d0c7bfa36a7a868,2,36,20,56,10,2007-10-17 22:42:12,2007-10-17 22:42:12
e287007f6a129901a07b6a342d0c7bfa36a7a868...9ac9aaeec3dd036f805bc607ea4fd9afcab92047,1,1,1,2,1,2007-10-17 23:13:31,2007-10-17 23:13:31
9ac9aaeec3dd036f805bc607ea4fd9afcab92047...14b88f6019cd467c35a2c9e845740a61c153525e,2,6,5,11,4,2007-10-17 23:35:57,2007-10-17 23:35:57
14b88f6019cd467c35a2c9e845740a61c153525e...80a26a326696599dad5b0bf88f8fa8e242e711e5,1,2,2,4,2,2007-10-18 00:07:45,2007-10-18 00:07:45
80a26a326696599dad5b0bf88f8fa8e242e711e5...5421dfdea9c72598ecf1187aa03cd8d2b1e5578d,1,3,3,6,2,2007-10-18 00:30:37,2007-10-18 00:30:37
5421dfdea9c72598ecf1187aa03cd8d2b1e5578d...5736e8d90d5c7961e19cb707301d9f58daa0aa3b,1,1,1,2,1,2007-10-18 17:25:08,2007-10-18 17:25:08
5736e8d90d5c7961e19cb707301d9f58daa0aa3b...1ac9d6fbeed214d59ea5c31a87ff2c19bb08dbc8,3,26,4,30,4,2007-10-20 22:04:06,2007-10-20 22:04:06
1ac9d6fbeed214d59ea5c31a87ff2c19bb08dbc8...98204c7f6022958f277a7ea3bb8eacdc369753a4,1,1,1,2,1,2007-10-20 22:08:03,2007-10-20 22:08:03
98204c7f6022958f277a7ea3bb8eacdc369753a4...a613a70fdb87163efa25a2d853cb9ed736d8cc39,1,2,1,3,1,2007-11-05 18:49:00,2007-11-05 18:49:00
a613a70fdb87163efa25a2d853cb9ed736d8cc39...d5cb977a08156c9945ae7f01fa481c2e2838d8df,1,2,1,3,1,2007-11-14 04:51:53,2007-11-14 04:51:53
d5cb977a08156c9945ae7f01fa481c2e2838d8df...ee52c89dc956dc04d827d70440a089fd0cf94a46,1,5,4,9,1,2007-11-14 15:06:48,2007-11-14 15:06:48
ee52c89dc956dc04d827d70440a089fd0cf94a46...ab96367f121a5cdbe491fafb35cb041055a28a52,1,8,8,16,6,2007-11-14 21:55:45,2007-11-14 21:55:45
ab96367f121a5cdbe491fafb35cb041055a28a52...1d299d375b6d97d65559286d914df2d5a77949db,2,25,1,26,2,2007-11-16 17:49:12,2007-11-16 17:49:12
1d299d375b6d97d65559286d914df2d5a77949db...0a0990485e5c1fd4b4fdcce7f7723d9e0a9dd16d,2,21,2,23,4,2007-11-16 18:23:59,2007-11-16 18:23:59
0a0990485e5c1fd4b4fdcce7f7723d9e0a9dd16d...084079d2fd1c7ed3582612cc32b01346b43fb415,2,32,10,42,8,2007-11-16 19:01:53,2007-11-16 19:01:53
084079d2fd1c7ed3582612cc32b01346b43fb415...b9371a6ca4b756c4b4266a08336e80f715b66ad3,1,7,4,11,3,2007-11-16 21:50:27,2007-11-16 21:50:27
b9371a6ca4b756c4b4266a08336e80f715b66ad3...e2ef3df86d5f54274bf2b779d882c30aa0886bfe,5,69,38,107,12,2007-11-16 23:39:23,2007-11-16 23:39:23
e2ef3df86d5f54274bf2b779d882c30aa0886bfe...6853370fbb631a1d40d63c295626b7af6b0c7755,1,1,1,2,1,2007-11-16 23:54:45,2007-11-16 23:54:45
6853370fbb631a1d40d63c295626b7af6b0c7755...bf8f3fe0942cb3d2583f0965e44594088a38ccef,2,20,3,23,6,2007-11-17 04:25:22,2007-11-17 04:25:22
bf8f3fe0942cb3d2583f0965e44594088a38ccef...32b3ac4f063571257b36477cc5dcb659cac2c357,1,1325,1325,2650,1,2007-11-17 04:36:50,2007-11-17 04:36:50
32b3ac4f063571257b36477cc5dcb659cac2c357...264ffbc73be61778484a292392d1b18a8976588f,2,7,3,10,4,2007-11-17 22:09:51,2007-11-17 22:09:51
264ffbc73be61778484a292392d1b18a8976588f...2e2a1b8910afcc23b1f71c188dca2d88067d70da,1,2,2,4,2,2007-11-18 00:46:58,2007-11-18 00:46:58
2e2a1b8910afcc23b1f71c188dca2d88067d70da...5e99807271ebe194b7f0278a929b053b4dd46c81,3,16,5,21,8,2007-11-19 16:07:44,2007-11-19 16:07:44
5e99807271ebe194b7f0278a929b053b4dd46c81...e6a481e533dc25ecf4d25123d6515c61a97a7f19,1,1,1,2,1,2007-11-19 16:15:51,2007-11-19 16:15:51
e6a481e533dc25ecf4d25123d6515c61a97a7f19...1a2fdafd386a8f7be8b633634a684969921f8b8f,1,7,1,8,2,2007-11-27 01:03:49,2007-11-27 01:03:49
1a2fdafd386a8f7be8b633634a684969921f8b8f...b26da08821ef07860b489ea2450f672ea155ca88,1,3,2,5,2,2007-11-27 19:20:36,2007-11-27 19:20:36
b26da08821ef07860b489ea2450f672ea155ca88...2ccd2cb36be6169afee3bd6e82ba3539f432c73f,2,4,4,8,3,2007-11-27 23:58:07,2007-11-27 23:58:07
2ccd2cb36be6169afee3bd6e82ba3539f432c73f...0a755f6ab38d36ffda02f9ff5a6d606c24a94baa,3,16,3,19,6,2007-11-28 01:01:49,2007-11-28 01:01:49
0a755f6ab38d36ffda02f9ff5a6d606c24a94baa...5c6c99361f315bfbc5829be3af94499c3a107f5d,2,4,2,6,3,2007-11-28 16:38:34,2007-11-28 16:38:34
5c6c99361f315bfbc5829be3af94499c3a107f5d...3ae5fbc16a60cf3f41a1c6166a65dd473e904eb1,2,7,3,10,3,2007-11-28 22:23:40,2007-11-28 22:23:40
3ae5fbc16a60cf3f41a1c6166a65dd473e904eb1...ed7608d8eedc0cd9082b5246581c0fc4ccb392db,2,11,2,13,3,2007-11-28 23:13:59,2007-11-28 23:13:59
ed7608d8eedc0cd9082b5246581c0fc4ccb392db...95c0265486fc551a08ec20d6060a3a382aa8a76b,2,6,3,9,4,2007-11-28 23:42:16,2007-11-28 23:42:16
95c0265486fc551a08ec20d6060a3a382aa8a76b...b6d70a7ce3795e8c1306a513b89a31de0c5f0a13,2,2,2,4,2,2007-11-28 23:53:54,2007-11-28 23:53:54
b6d70a7ce3795e8c1306a513b89a31de0c5f0a13...7ac564cd98a869d558ea4b3be6919baab0f48d10,1,3,2,5,3,2007-11-29 17:12:08,2007-11-29 17:12:08
7ac564cd98a869d558ea4b3be6919baab0f48d10...4b8f6cdc86c395fb92c7d50e8642118963232af4,3,15,1,16,3,2007-11-29 19:07:20,2007-11-29 19:07:20
4b8f6cdc86c395fb92c7d50e8642118963232af4...aca1cc367782f8d038a13794a46aec6fd825eb45,2,1,5,6,2,2007-11-30 02:42:48,2007-11-30 02:42:48
aca1cc367782f8d038a13794a46aec6fd825eb45...37902e86b158eaa90f44d0932063d22df3050326,2,10,2,12,3,2007-11-30 08:39:49,2007-11-30 08:39:49
37902e86b158eaa90f44d0932063d22df3050326...5039a4bc5b951b9d28659f6f42f73c59e2e560fc,3,119,23,142,15,2007-11-30 21:36:49,2007-11-30 21:36:49
5039a4bc5b951b9d28659f6f42f73c59e2e560fc...a73445bbc7a68c3bf3cae8cee23bb757295eaacb,1,1,1,2,1,2007-11-30 23:37:34,2007-11-30 23:37:34
a73445bbc7a68c3bf3cae8cee23bb757295eaacb...66fbbec3bb2d0555da55eea4abae0081484d37b4,2,53,21,74,18,2007-12-03 21:41:10,2007-12-03 21:41:10
66fbbec3bb2d0555da55eea4abae0081484d37b4...701b072e1a104bce03df700c5f620d4000ccd573,1,3,5,8,4,2007-12-04 01:51:07,2007-12-04 01:51:07
701b072e1a104bce03df700c5f620d4000ccd573...aee221d33c2db2c76639dabeca2b1e3d022e348e,2,38,3,41,3,2007-12-04 04:43:45,2007-12-04 04:43:45
aee221d33c2db2c76639dabeca2b1e3d022e348e...8b74ba07aabc11c1e987e3c7dfe8314c23bb5452,1,1,1,2,1,2007-12-04 07:36:03,2007-12-04 07:36:03
8b74ba07aabc11c1e987e3c7dfe8314c23bb5452...4d13f3701c59cac1bdfd2e826fd7dcb6148fc48e,1,1,1,2,2,2007-12-04 16:42:42,2007-12-04 16:42:42
4d13f3701c59cac1bdfd2e826fd7dcb6148fc48e...d938c6bbd6b220f122c50f5f828b8f0cd818c168,2,7,2,9,3,2007-12-04 18:15:27,2007-12-04 18:15:27
d938c6bbd6b220f122c50f5f828b8f0cd818c168...76e3a901530609d3c4a695ccb8a48251445c6861,2,19,4,23,6,2007-12-04 19:37:03,2007-12-04 19:37:03
76e3a901530609d3c4a695ccb8a48251445c6861...f576ceeea9eea5fec6b31172765df4da8b264ac8,4,136,0,136,4,2007-12-04 20:51:16,2007-12-04 20:51:16
f576ceeea9eea5fec6b31172765df4da8b264ac8...e317bb7105c1288a6fbce03725013daebf095d25,1,5,6,11,2,2007-12-04 20:54:23,2007-12-04 20:54:23
e317bb7105c1288a6fbce03725013daebf095d25...4fc297101985faeccbff87956ac79fcbae3a9de1,1,11,2,13,4,2007-12-04 20:59:33,2007-12-04 20:59:33
4fc297101985faeccbff87956ac79fcbae3a9de1...c424e79ccb3695c6ff599e77bec867c6644ccc98,2,5,6,11,2,2007-12-04 21:29:28,2007-12-04 21:29:28
c424e79ccb3695c6ff599e77bec867c6644ccc98...74a132d944886379456d562990c8fb217ab332e3,4,36,7,43,8,2007-12-05 00:26:13,2007-12-05 00:26:13
74a132d944886379456d562990c8fb217ab332e3...1be558203961c43043d6e9de3341e8bb9c3dcbf3,2,17,4,21,3,2007-12-05 05:01:46,2007-12-05 05:01:46
1be558203961c43043d6e9de3341e8bb9c3dcbf3...2da897db844ddb4adfb73c4306976f1ac6525f9e,1,3,3,6,3,2007-12-05 08:00:30,2007-12-05 08:00:30
2da897db844ddb4adfb73c4306976f1ac6525f9e...b0b5fa74b6790ad18504c063f2ffcc1beb52916a,5,5998,2255,8253,10,2007-12-05 17:33:49,2007-12-05 17:33:49
b0b5fa74b6790ad18504c063f2ffcc1beb52916a...7cdddebe047302f51c4fd30823565f3ac1553d60,1,6,5,11,6,2007-12-05 21:23:07,2007-12-05 21:23:07
7cdddebe047302f51c4fd30823565f3ac1553d60...be4a8c32ac77c3b1cdf1b598943b23bdb3119467,1,15,5,20,4,2007-12-05 23:03:58,2007-12-05 23:03:58
be4a8c32ac77c3b1cdf1b598943b23bdb3119467...d44e9451f789db40e7cb370717258c00dff10edd,2,6,3,9,3,2007-12-06 19:51:00,2007-12-06 19:51:00
d44e9451f789db40e7cb370717258c00dff10edd...12ef255ffdb3c2d045ee37beb9419f14d9c30217,1,44,0,44,11,2007-12-06 23:23:10,2007-12-06 23:23:10
12ef255ffdb3c2d045ee37beb9419f14d9c30217...ffbedf0262b3eea906f39c0115b818d7456a3994,8,188,64,252,64,2007-12-07 01:52:21,2007-12-07 01:52:21
ffbedf0262b3eea906f39c0115b818d7456a3994...91f1299f68a68728467a2566a38845d82e30606f,2,15,2,17,3,2007-12-08 02:54:09,2007-12-08 02:54:09
91f1299f68a68728467a2566a38845d82e30606f...b3ec8edddd9261eef490f8317144e9c68c888819,3,33,7,40,6,2007-12-08 04:54:53,2007-12-08 04:54:53
b3ec8edddd9261eef490f8317144e9c68c888819...ccf055033ab165c677590b42fa0ca7e0a29e9fb7,1,17,3,20,1,2007-12-08 23:03:10,2007-12-08 23:03:10
ccf055033ab165c677590b42fa0ca7e0a29e9fb7...f97f77c034dc62001a687c728bdfdc71a23bf6b8,1,5,4,9,2,2007-12-10 01:45:03,2007-12-10 01:45:03
f97f77c034dc62001a687c728bdfdc71a23bf6b8...9ea8017f86c48ab624fbdc0e55a79110d9c61a9f,2,4,10,14,3,2007-12-10 19:04:59,2007-12-10 19:04:59
9ea8017f86c48ab624fbdc0e55a79110d9c61a9f...540f9304a76eae2eec707db3aeb10496201a6ced,1,1,1,2,1,2007-12-11 03:17:44,2007-12-11 03:17:44
540f9304a76eae2eec707db3aeb10496201a6ced...227f8b2514de31bd0b5c45ce6fc1b942c081f776,1,14,47,61,3,2007-12-11 04:40:54,2007-12-11 04:40:54
227f8b2514de31bd0b5c45ce6fc1b942c081f776...c6a44c7943f460594a6a75081ad9bce76fea80f0,2,21,2,23,2,2007-12-11 20:16:19,2007-12-11 20:16:19
c6a44c7943f460594a6a75081ad9bce76fea80f0...279f77e9609fba62c11a06f8c65221b16f7bc7d4,2,12,2,14,3,2007-12-12 01:32:35,2007-12-12 01:32:35
279f77e9609fba62c11a06f8c65221b16f7bc7d4...58c640fb1ce09a03399a3a441716cca23f3f2d04,6,209,15,224,13,2007-12-12 16:55:55,2007-12-12 16:55:55
58c640fb1ce09a03399a3a441716cca23f3f2d04...e1af5faf80ff9a457bcb78757c3eb04b55e931d1,2,23,1,24,5,2007-12-12 20:54:44,2007-12-12 20:54:44
e1af5faf80ff9a457bcb78757c3eb04b55e931d1...3e3b86c7a7437c7b0416a2ac8385cf9403fc9e28,1,5,2,7,1,2007-12-13 03:46:48,2007-12-13 03:46:48
3e3b86c7a7437c7b0416a2ac8385cf9403fc9e28...da33a981c6fb18a195377d55a6d243e2de887f45,5,30,15,45,11,2007-12-13 22:24:59,2007-12-13 22:24:59
da33a981c6fb18a195377d55a6d243e2de887f45...7120b56caa235ae9315aab0634d9ff7e21c300fd,2,11,14,25,6,2007-12-13 22:58:59,2007-12-13 22:58:59
7120b56caa235ae9315aab0634d9ff7e21c300fd...14a3a5bf9d65d9910a730d53208e3dccb34e3704,1,3,1,4,2,2007-12-14 01:57:29,2007-12-14 01:57:29
14a3a5bf9d65d9910a730d53208e3dccb34e3704...56a93fc2cce999ccfb0e3b80aeaa0f480ef7ae6e,1,12,9,21,3,2007-12-14 02:04:00,2007-12-14 02:04:00
56a93fc2cce999ccfb0e3b80aeaa0f480ef7ae6e...06c2f06a2183ef17a8119ef25a383a02572c0b55,2,24,10,34,5,2007-12-14 17:06:41,2007-12-14 17:06:41
06c2f06a2183ef17a8119ef25a383a02572c0b55...01e8f33e44b8ee4aa61b48d60cfcae34ac12fcf1,1,0,3,3,1,2007-12-14 18:59:47,2007-12-14 18:59:47
01e8f33e44b8ee4aa61b48d60cfcae34ac12fcf1...b264f789b9a6995ad0e7eec6771fafa852717571,2,221,173,394,23,2007-12-15 05:55:33,2007-12-15 05:55:33
b264f789b9a6995ad0e7eec6771fafa852717571...4e339ef5573dc6472c00c01a3de883346e6b03a3,1,2,0,2,1,2007-12-15 23:30:34,2007-12-15 23:30:34
4e339ef5573dc6472c00c01a3de883346e6b03a3...feb9051c0e29937c2494c3db0862a671efc21747,5,43,36,79,24,2007-12-16 01:03:50,2007-12-16 01:03:50
feb9051c0e29937c2494c3db0862a671efc21747...67c7b46ea36946c85d119d2c513486d2b1a05a24,1,19,1,20,2,2007-12-16 04:04:29,2007-12-16 04:04:29
67c7b46ea36946c85d119d2c513486d2b1a05a24...7a6978b3244023831057c1fde2a9daaab2d705e7,1,37,37,74,25,2007-12-16 04:09:53,2007-12-16 04:09:53
7a6978b3244023831057c1fde2a9daaab2d705e7...97e98591aaf929bef42bf6047f68e08d8aafc1a4,1,1,1,2,1,2007-12-16 10:08:53,2007-12-16 10:08:53
97e98591aaf929bef42bf6047f68e08d8aafc1a4...859aa6c9df064ef7ec9d8cc33af59d867fac0b9a,1,1,1,2,1,2007-12-16 10:33:38,2007-12-16 10:33:38
859aa6c9df064ef7ec9d8cc33af59d867fac0b9a...45e4a52cdd094134c4595b0ff017b7a9d6a8243c,1,12,20,32,8,2007-12-16 22:18:35,2007-12-16 22:18:35
45e4a52cdd094134c4595b0ff017b7a9d6a8243c...b721a2f472b53fec28276d2080d741cf070b686d,2,4,4,8,4,2007-12-17 00:44:00,2007-12-17 00:44:00
b721a2f472b53fec28276d2080d741cf070b686d...6a25c20f5cdf2eba12d204517598a9e1386ab3a6,1,2,2,4,1,2007-12-17 00:48:12,2007-12-17 00:48:12
6a25c20f5cdf2eba12d204517598a9e1386ab3a6...9af7387579a4350f66e49324483c6b599f43b9b2,1,2,0,2,1,2007-12-17 00:51:59,2007-12-17 00:51:59
9af7387579a4350f66e49324483c6b599f43b9b2...adc4c482017c237abc4d9a251b09549f34a88423,1,13,0,13,1,2007-12-17 01:11:02,2007-12-17 01:11:02
adc4c482017c237abc4d9a251b09549f34a88423...6496e4d9c419e447ac2d8a2e3623f07f74fd0860,3,15,2,17,5,2007-12-17 01:58:05,2007-12-17 01:58:05
6496e4d9c419e447ac2d8a2e3623f07f74fd0860...13a5fdb6a1571012c3e065a991fb4eff083057fb,1,1,1,2,1,2007-12-17 02:28:37,2007-12-17 02:28:37
13a5fdb6a1571012c3e065a991fb4eff083057fb...d7f5a0835bc463d15a4f6210e48110054a050f0b,1,1,1,2,1,2007-12-17 14:37:26,2007-12-17 14:37:26
d7f5a0835bc463d15a4f6210e48110054a050f0b...90b25efa6c3c3676c5ae1dd782d04726e03a31e8,2,7,2,9,4,2007-12-17 16:54:44,2007-12-17 16:54:44
90b25efa6c3c3676c5ae1dd782d04726e03a31e8...70ae356e4ed1f74bb008939b345437fbe7deb26d,1,8,0,8,1,2007-12-17 17:39:50,2007-12-17 17:39:50
70ae356e4ed1f74bb008939b345437fbe7deb26d...ce4ab8a60e17ceafc3e67ddf4cc1b0526841a459,1,4,1,5,2,2007-12-17 19:01:25,2007-12-17 19:01:25
ce4ab8a60e17ceafc3e67ddf4cc1b0526841a459...d1b9ad3cdb3fd226d4208ae6eaed98baf7026222,1,78,40,118,6,2007-12-17 20:22:53,2007-12-17 20:22:53
d1b9ad3cdb3fd226d4208ae6eaed98baf7026222...24e036c7c88e7e3a1f878292e4b59914e1f4575c,2,3,5,8,3,2007-12-17 21:02:05,2007-12-17 21:02:05
24e036c7c88e7e3a1f878292e4b59914e1f4575c...76c1889e22cbf2a2187bb55cd7adcbd56a5fd50a,1,536,536,1072,1,2007-12-18 03:13:39,2007-12-18 03:13:39
76c1889e22cbf2a2187bb55cd7adcbd56a5fd50a...fc51e14b810474fe9ed0b03bed5eddc82e9f7fde,3,64,13,77,9,2007-12-18 03:53:09,2007-12-18 03:53:09
fc51e14b810474fe9ed0b03bed5eddc82e9f7fde...7ef40fd19926c779086ae7d79796032708d568e0,2,3,1,4,3,2007-12-18 17:19:33,2007-12-18 17:19:33
7ef40fd19926c779086ae7d79796032708d568e0...1d7b7b94ef1c0c10cd5b2a976be40ccacbc49581,1,536,536,1072,1,2007-12-19 01:10:20,2007-12-19 01:10:20
1d7b7b94ef1c0c10cd5b2a976be40ccacbc49581...3bb82a34de18b8b8e80893571d65080bf5a4702b,1,1,1,2,1,2007-12-19 01:48:05,2007-12-19 01:48:05
3bb82a34de18b8b8e80893571d65080bf5a4702b...b32ec31d896eb163c5f3d9b54ca9da3c0dd90ce0,1,1,1,2,1,2007-12-19 18:23:46,2007-12-19 18:23:46
b32ec31d896eb163c5f3d9b54ca9da3c0dd90ce0...a7dfbb55d9e4be6bbf096abb0e06e32086476a96,1,7,0,7,2,2007-12-19 18:35:58,2007-12-19 18:35:58
a7dfbb55d9e4be6bbf096abb0e06e32086476a96...be9302b710416715b9d278f589be99fa6f9e7cb8,1,2,1,3,1,2007-12-19 18:47:01,2007-12-19 18:47:01
be9302b710416715b9d278f589be99fa6f9e7cb8...add0681f907c11e1a16b9e4759f575195a790c06,1,1,1,2,1,2007-12-19 19:05:34,2007-12-19 19:05:34
add0681f907c11e1a16b9e4759f575195a790c06...e2fc993334698b2a66dd24a671a9c23705df0fc3,1,1,1,2,1,2007-12-19 19:07:12,2007-12-19 19:07:12
e2fc993334698b2a66dd24a671a9c23705df0fc3...ba9c14a589caab13b5754273ff916d492dafa86b,15,70,741,811,29,2007-12-19 22:26:05,2007-12-19 22:26:05
ba9c14a589caab13b5754273ff916d492dafa86b...04194554738f8e2676f5d7876f5b78b12dbc2679,1,39,8,47,7,2007-12-20 06:00:01,2007-12-20 06:00:01
04194554738f8e2676f5d7876f5b78b12dbc2679...b740fe5632b8731a140f16a2f6855910ea6957b9,1,2,1,3,2,2007-12-20 07:39:35,2007-12-20 07:39:35
b740fe5632b8731a140f16a2f6855910ea6957b9...3261544c38ca70cc02c5eed7d0ab2c40c521a588,2,7,2,9,3,2007-12-20 13:36:56,2007-12-20 13:36:56
3261544c38ca70cc02c5eed7d0ab2c40c521a588...3f839a69c5682419c921a1a2110289c8941556b0,1,1,1,2,1,2007-12-20 15:07:37,2007-12-20 15:07:37
3f839a69c5682419c921a1a2110289c8941556b0...1fc7dcff11827a2abd3516c941b56d0b2b46f078,1,1,2,3,1,2007-12-20 15:11:07,2007-12-20 15:11:07
1fc7dcff11827a2abd3516c941b56d0b2b46f078...17640273705d1450b806bb5c8e71c2849d864a37,1,0,3,3,1,2007-12-20 18:55:43,2007-12-20 18:55:43
17640273705d1450b806bb5c8e71c2849d864a37...259c8aa6044491f41a19668c0283c4d339904ff0,1,0,6,6,1,2007-12-20 19:21:56,2007-12-20 19:21:56
259c8aa6044491f41a19668c0283c4d339904ff0...bdd6aca209fe79bc6a085693008436cce37d5b31,1,1,1,2,1,2007-12-20 19:31:02,2007-12-20 19:31:02
bdd6aca209fe79bc6a085693008436cce37d5b31...50c40add5ab530cefbdd09dbdcb641f22b9dc26c,2,4,1,5,3,2007-12-20 20:40:20,2007-12-20 20:40:20
50c40add5ab530cefbdd09dbdcb641f22b9dc26c...fde3d616ac3d8efe822c6dbf23d7659b00fc54b1,1,0,7,7,2,2007-12-21 02:11:26,2007-12-21 02:11:26
fde3d616ac3d8efe822c6dbf23d7659b00fc54b1...c73eadf59952f71f5c55fe9887f1f9e005fe95a4,1,10,1,11,4,2007-12-21 04:53:33,2007-12-21 04:53:33
c73eadf59952f71f5c55fe9887f1f9e005fe95a4...05930c5a0d667c024c9acd0d087be846990fdcea,1,1,1,2,1,2007-12-21 05:47:33,2007-12-21 05:47:33
05930c5a0d667c024c9acd0d087be846990fdcea...87d6bcec31046d84d1b4518d0888f1715e15e60b,1,3,3,6,3,2007-12-28 19:08:36,2007-12-28 19:08:36
87d6bcec31046d84d1b4518d0888f1715e15e60b...948753842bd5aeda6ad6e27c269d706675f488d1,1,2,1,3,2,2008-01-04 11:33:34,2008-01-04 11:33:34
948753842bd5aeda6ad6e27c269d706675f488d1...b91eef070db6ebe1ef7654e24c33d6eb9f0fca80,1,4,2,6,2,2008-01-07 01:03:31,2008-01-07 01:03:31
b91eef070db6ebe1ef7654e24c33d6eb9f0fca80...d36382e9a3fa604597d400d1084a2424f0d3eb80,1,3,0,3,1,2008-01-12 01:06:37,2008-01-12 01:06:37
d36382e9a3fa604597d400d1084a2424f0d3eb80...9bcd2b370b4aa72cc60af85d0f8a0872d0d17a0a,1,1,2,3,1,2008-01-12 23:03:39,2008-01-12 23:03:39
9bcd2b370b4aa72cc60af85d0f8a0872d0d17a0a...2fa855601e9ece6c0a240202b0534702b7e5c153,2,1374,1364,2738,10,2008-01-14 09:33:08,2008-01-14 09:33:08
2fa855601e9ece6c0a240202b0534702b7e5c153...c27cbdc4770e0641bff705599b3349e9d665246f,1,2,2,4,2,2008-01-14 09:42:53,2008-01-14 09:42:53
c27cbdc4770e0641bff705599b3349e9d665246f...5974495e6b1f40076ef257bc886dacd0c2e27bd7,1,14,1,15,2,2008-01-14 18:19:28,2008-01-14 18:19:28
5974495e6b1f40076ef257bc886dacd0c2e27bd7...709df933049ccce53d0b6bb510ad9c39fd6304fe,1,1,1,2,1,2008-01-14 18:46:44,2008-01-14 18:46:44
709df933049ccce53d0b6bb510ad9c39fd6304fe...8a356f0d23bca2b2ea81a8320f6ab3b48b4177e3,1,36,0,36,1,2008-01-14 18:47:21,2008-01-14 18:47:21
8a356f0d23bca2b2ea81a8320f6ab3b48b4177e3...04eb06069210eef20e9c2157b4f5557e868d7719,1,1,1,2,1,2008-01-14 19:13:46,2008-01-14 19:13:46
04eb06069210eef20e9c2157b4f5557e868d7719...047debc750bd7ca15229297c1f3ab98527fe5be6,1,1,1,2,1,2008-01-14 19:15:27,2008-01-14 19:15:27
047debc750bd7ca15229297c1f3ab98527fe5be6...6e739fd2ba917124dfbba5334eaa502e739490b8,1,1,1,2,1,2008-01-14 19:17:35,2008-01-14 19:17:35
6e739fd2ba917124dfbba5334eaa502e739490b8...260fc23e92e1aa04fbec8f29646cd9e853faf851,1,1,1,2,1,2008-01-14 19:37:05,2008-01-14 19:37:05
260fc23e92e1aa04fbec8f29646cd9e853faf851...ff08982508cb089d0b728cb797c76cc2fe76a702,1,1,1,2,1,2008-01-14 19:37:31,2008-01-14 19:37:31
ff08982508cb089d0b728cb797c76cc2fe76a702...c39bd07cc9f408d5680ba565e2a2fe71bbdc64b9,2,22,7,29,6,2008-01-14 20:06:34,2008-01-14 20:06:34
c39bd07cc9f408d5680ba565e2a2fe71bbdc64b9...2e6c123c875991792a8a701e108248e0b89524d4,1,8,1,9,6,2008-01-14 20:17:21,2008-01-14 20:17:21
2e6c123c875991792a8a701e108248e0b89524d4...d0fae71464427d9b9e29a5e3fa27729675bef95a,1,5,2,7,2,2008-01-14 20:40:05,2008-01-14 20:40:05
d0fae71464427d9b9e29a5e3fa27729675bef95a...0cd307ec1077f5b09972400180f54dc278ad624a,1,1350,1350,2700,1,2008-01-14 22:30:48,2008-01-14 22:30:48
0cd307ec1077f5b09972400180f54dc278ad624a...6c81082a6b20880cbd5d35ec5c50d4270f3af2ce,1,1,1,2,1,2008-01-14 22:56:07,2008-01-14 22:56:07
6c81082a6b20880cbd5d35ec5c50d4270f3af2ce...dcb46c7fe572923b02b575477ab02af797ab392a,1,1,1,2,1,2008-01-17 21:31:28,2008-01-17 21:31:28
dcb46c7fe572923b02b575477ab02af797ab392a...0635df43914eec10e4b468ddb2f952f5024c644e,2,5,5,10,3,2008-01-17 21:38:58,2008-01-17 21:38:58
0635df43914eec10e4b468ddb2f952f5024c644e...e7fef859f10045a296368e82d7bbe69924d338c2,1,1,1,2,1,2008-01-20 14:23:22,2008-01-20 14:23:22
e7fef859f10045a296368e82d7bbe69924d338c2...1faed11e3c0752981d8b01e1272fb3a72272f966,2,15,5,20,4,2008-01-23 03:54:23,2008-01-23 03:54:23
1faed11e3c0752981d8b01e1272fb3a72272f966...5da2e98cb39f30e940962fe0bf2d23356d9f90a8,2,52,57,109,17,2008-01-26 00:26:28,2008-01-26 00:26:28
5da2e98cb39f30e940962fe0bf2d23356d9f90a8...f354e85af6a66b94e680c5406866de2137ab95e6,1,1,1,2,1,2008-01-28 19:32:57,2008-01-28 19:32:57
f354e85af6a66b94e680c5406866de2137ab95e6...32ba00081ddd56c00655d0a7b7825ac947247cc6,1,1,1,2,1,2008-01-28 19:37:46,2008-01-28 19:37:46
32ba00081ddd56c00655d0a7b7825ac947247cc6...25c76232c6cacc643d1142b5f951a0e5fcc12b6b,2,2,2,4,2,2008-02-01 23:23:11,2008-02-01 23:23:11
25c76232c6cacc643d1142b5f951a0e5fcc12b6b...77da94552e94925e990d058ed81419d0835747ce,3,79,1,80,6,2008-02-03 04:05:24,2008-02-03 04:05:24
77da94552e94925e990d058ed81419d0835747ce...703e89ba302e86bba1f4777ce1a6aee6f38b7b87,2,12,2,14,4,2008-02-03 04:33:11,2008-02-03 04:33:11
703e89ba302e86bba1f4777ce1a6aee6f38b7b87...4a11e6d70b5c4b1473b62050929cffe3d2a67317,2,16,14,30,10,2008-02-03 17:56:21,2008-02-03 17:56:21
4a11e6d70b5c4b1473b62050929cffe3d2a67317...b0c7df65d0f92b77752e8f9b33898d0e3b2c05e8,2,30,11,41,9,2008-02-03 18:43:04,2008-02-03 18:43:04
b0c7df65d0f92b77752e8f9b33898d0e3b2c05e8...2c07690377522119891784ec11c89e87f0a12545,1,1,1,2,1,2008-02-03 21:46:47,2008-02-03 21:46:47
2c07690377522119891784ec11c89e87f0a12545...75cb0d8d05a0d44cca1529f891fe2a3de2061194,1,1,1,2,1,2008-02-05 19:32:00,2008-02-05 19:32:00
75cb0d8d05a0d44cca1529f891fe2a3de2061194...80568d29cb93f176468db99f5ab0c8dfa21152d7,1,1,1,2,1,2008-02-06 01:03:40,2008-02-06 01:03:40
80568d29cb93f176468db99f5ab0c8dfa21152d7...e71e4a47f35a4380664b6cc209e482adea6b4b14,1,1,1,2,1,2008-02-06 03:48:22,2008-02-06 03:48:22
e71e4a47f35a4380664b6cc209e482adea6b4b14...f43516f20975d3b3fc7910d187af97d7a8c6dc6f,1,3,3,6,1,2008-02-06 05:18:25,2008-02-06 05:18:25
f43516f20975d3b3fc7910d187af97d7a8c6dc6f...a19a123d89424a93068bf69cd1ccbc85eec33715,1,1,1,2,1,2008-02-17 15:05:55,2008-02-17 15:05:55
a19a123d89424a93068bf69cd1ccbc85eec33715...8f14ee1dd5c3bffc987f9a21a518f9901de66b54,1,32,0,32,1,2008-03-15 18:53:40,2008-03-15 18:53:40
8f14ee1dd5c3bffc987f9a21a518f9901de66b54...d44ddef720684d1eccba8cfe7d1afbaac5327378,1,3,6,9,2,2008-03-15 19:00:07,2008-03-15 19:00:07
d44ddef720684d1eccba8cfe7d1afbaac5327378...dc7f8cfca61350cfc769e1f365a0dbfe140faabf,1,1,1,2,1,2008-03-17 10:53:00,2008-03-17 10:53:00
dc7f8cfca61350cfc769e1f365a0dbfe140faabf...4515aba79c56b28d9cf7bae902c71fb38763f693,1,1,1,2,1,2008-04-08 16:40:03,2008-04-08 16:40:03
4515aba79c56b28d9cf7bae902c71fb38763f693...1ba2865b089fc06242004b7003b4f8dcfd92dc13,1,1,1,2,1,2008-04-10 01:17:07,2008-04-10 01:17:07
1ba2865b089fc06242004b7003b4f8dcfd92dc13...a9fe9a2a5f935fc79610d952b68d592f5cfd9ff8,1,4,1,5,2,2008-04-14 18:16:01,2008-04-14 18:16:01
a9fe9a2a5f935fc79610d952b68d592f5cfd9ff8...5d033dba02fc1ffe1398cdaf0e9d402fc75e13f0,2,10,3,13,3,2008-04-21 20:39:17,2008-04-21 20:39:17
5d033dba02fc1ffe1398cdaf0e9d402fc75e13f0...3e285bd60de63afe314971957a0547603bb74386,1,10,7,17,6,2008-04-21 22:54:25,2008-04-21 22:54:25
3e285bd60de63afe314971957a0547603bb74386...9de35ce3e73c63c791472ac773afa141a8c4ae7b,1,7,6,13,5,2008-04-21 22:54:46,2008-04-21 22:54:46
9de35ce3e73c63c791472ac773afa141a8c4ae7b...6d28ebff85e6bb9f27006fe557d249d4c6b9f584,1,25,33,58,10,2008-04-22 05:23:55,2008-04-22 05:23:55
6d28ebff85e6bb9f27006fe557d249d4c6b9f584...32b1cb3a5cde49b444fe4de269631942e9254b57,2,12,1,13,3,2008-04-22 21:59:40,2008-04-22 21:59:40
32b1cb3a5cde49b444fe4de269631942e9254b57...e454e8305d7c159c3bcffafeb09ea98b342777ad,2,23,5,28,2,2008-04-22 22:07:17,2008-04-22 22:07:17
e454e8305d7c159c3bcffafeb09ea98b342777ad...d3d8f3561b833781a3b7735685e1df48d8e7a60a,1,6,1,7,2,2008-04-22 22:18:11,2008-04-22 22:18:11
d3d8f3561b833781a3b7735685e1df48d8e7a60a...f861c88b1bb8f9c0bf37ec86cb12a3f7206680c3,1,1,1,2,1,2008-04-22 22:43:18,2008-04-22 22:43:18
f861c88b1bb8f9c0bf37ec86cb12a3f7206680c3...291f071eff51bc0653aaf3dcfd777cc57437ebdf,1,27,0,27,1,2008-04-22 23:07:35,2008-04-22 23:07:35
291f071eff51bc0653aaf3dcfd777cc57437ebdf...2efd0b4cc5cce9b22cd4bc638e25cc998736b6e7,1,10,7,17,3,2008-04-23 18:57:17,2008-04-23 18:57:17
2efd0b4cc5cce9b22cd4bc638e25cc998736b6e7...f12d94a6282d9efe6ba5863bf0de8a8a8b09a4af,1,6,2,8,2,2008-04-24 20:08:50,2008-04-24 20:08:50
f12d94a6282d9efe6ba5863bf0de8a8a8b09a4af...f8e5fd6fef68d243d22c593584aaf4ee549ed30c,2,8,7,15,2,2008-04-24 21:23:36,2008-04-24 21:23:36
f8e5fd6fef68d243d22c593584aaf4ee549ed30c...ba391eccf9ab50056e2126f712741537d27fe1c9,1,23,5,28,4,2008-04-24 21:32:35,2008-04-24 21:32:35
ba391eccf9ab50056e2126f712741537d27fe1c9...25f9974cee5874d10df32f2d16fb985181e0c077,3,4,14,18,3,2008-04-24 21:46:22,2008-04-24 21:46:22
25f9974cee5874d10df32f2d16fb985181e0c077...508b1e243224f18dd429f3087d7d6460e3a4eeb5,2,15,9,24,6,2008-04-25 03:48:07,2008-04-25 03:48:07
508b1e243224f18dd429f3087d7d6460e3a4eeb5...77bb2c505f1d2c4437f4b52866408f8bd1a5020f,1,1,1,2,1,2008-04-27 20:37:58,2008-04-27 20:37:58
77bb2c505f1d2c4437f4b52866408f8bd1a5020f...b84b997ea4be31dd1fdcc63136811dcd324dec68,1,7,1,8,3,2008-04-27 23:08:31,2008-04-27 23:08:31
b84b997ea4be31dd1fdcc63136811dcd324dec68...ab756ceab04d13706593ddcd0fda1ac8360ff773,1,1619,1593,3212,1,2008-04-28 14:00:27,2008-04-28 14:00:27
ab756ceab04d13706593ddcd0fda1ac8360ff773...4d652ca5204f00e7fa711ced6bf8b85676901690,1,451,445,896,1,2008-04-28 14:11:35,2008-04-28 14:11:35
4d652ca5204f00e7fa711ced6bf8b85676901690...f3f3238c53a3cad8ebe5c4be191ac4c5d0990f06,1,16,10,26,5,2008-04-28 21:09:27,2008-04-28 21:09:27
f3f3238c53a3cad8ebe5c4be191ac4c5d0990f06...aea452f1624df811c8b0b2916bfb22213d153f9d,6,178,25,203,9,2008-04-29 03:26:06,2008-04-29 03:26:06
aea452f1624df811c8b0b2916bfb22213d153f9d...5ca908d3b637a5d1e5c14b84d9a15653c3cb6d90,1,3,1,4,1,2008-04-29 20:52:48,2008-04-29 20:52:48
5ca908d3b637a5d1e5c14b84d9a15653c3cb6d90...f54d277df4a48173c5e53f3223d0e0d86a9bb6ac,1,3,1,4,2,2008-04-29 20:54:30,2008-04-29 20:54:30
f54d277df4a48173c5e53f3223d0e0d86a9bb6ac...e9c620794f9a261cfff1918a0a4105d434730565,1,1,1,2,1,2008-04-29 20:58:22,2008-04-29 20:58:22
e9c620794f9a261cfff1918a0a4105d434730565...c3cbc5bf98ad9bbed0c416b20f08b63d3b343448,2,3,3,6,3,2008-04-29 21:35:35,2008-04-29 21:35:35
c3cbc5bf98ad9bbed0c416b20f08b63d3b343448...08836acc30d0b715860171412bd8d61e1db4c96b,1,2,2,4,2,2008-04-29 21:37:41,2008-04-29 21:37:41
08836acc30d0b715860171412bd8d61e1db4c96b...aaff17be42c434d3a227bf5a8c5875b37c064da7,1,22,11,33,10,2008-04-29 22:06:54,2008-04-29 22:06:54
aaff17be42c434d3a227bf5a8c5875b37c064da7...d822c0c2140f8562f0bb7876b48a663ecef60176,1,32,2,34,2,2008-04-29 22:20:02,2008-04-29 22:20:02
d822c0c2140f8562f0bb7876b48a663ecef60176...2977f3df60a3fd406bb4fb51a34f1c8ddbbe2af5,1,451,451,902,1,2008-04-29 22:52:36,2008-04-29 22:52:36
2977f3df60a3fd406bb4fb51a34f1c8ddbbe2af5...ea44348fdb8d039dd74684cdafc6c73430f297b3,1,1,1,2,1,2008-04-29 23:26:53,2008-04-29 23:26:53
ea44348fdb8d039dd74684cdafc6c73430f297b3...17b1e407d101c5c7f91db633df3a80cd9b4466ae,5,105,103,208,44,2008-04-29 23:34:50,2008-04-29 23:34:50
17b1e407d101c5c7f91db633df3a80cd9b4466ae...cd455eeba7ef754f35a36b10ca27a31c14bb8a1f,1,9,7,16,6,2008-04-30 00:09:55,2008-04-30 00:09:55
cd455eeba7ef754f35a36b10ca27a31c14bb8a1f...bd4154879270c872e331054a9c481ca0d318517c,3,2,5,7,4,2008-04-30 19:35:17,2008-04-30 19:35:17
bd4154879270c872e331054a9c481ca0d318517c...ec06b7213d56d955b5334e218572beb32cd7c5a5,0,0,0,0,0,2008-05-01 20:54:35,2008-05-01 20:54:35
ec06b7213d56d955b5334e218572beb32cd7c5a5...42161a1e346941d6b17d099a580a29e3d8d39c62,1,1,1,2,1,2008-05-02 14:03:02,2008-05-02 14:03:02
42161a1e346941d6b17d099a580a29e3d8d39c62...87758bbe693c77c15e02f485a85e7d993248d190,1,3,2,5,2,2008-05-02 14:12:26,2008-05-02 14:12:26
87758bbe693c77c15e02f485a85e7d993248d190...35c68b4578f804bcd10fe7ee1628cbbd263c32ff,2,13,3,16,3,2008-05-02 19:49:41,2008-05-02 19:49:41
35c68b4578f804bcd10fe7ee1628cbbd263c32ff...ad3c49d1b664d282b1e38b2012a0818f0595d2a5,2,6,2,8,3,2008-05-03 01:39:27,2008-05-03 01:39:27
ad3c49d1b664d282b1e38b2012a0818f0595d2a5...f8698395acbe428bd7c3dd6dd5700a0c660deeab,2,11,6,17,6,2008-05-03 01:51:55,2008-05-03 01:51:55
f8698395acbe428bd7c3dd6dd5700a0c660deeab...d726a96b1f5008f29097f1efbea9a987015af641,1,1,0,1,1,2008-05-05 23:29:28,2008-05-05 23:29:28
d726a96b1f5008f29097f1efbea9a987015af641...e6fccd71031bd37300c1dfe79873b3d2529b4775,1,16,22,38,3,2008-05-06 00:13:20,2008-05-06 00:13:20
e6fccd71031bd37300c1dfe79873b3d2529b4775...6fc2c67581e3feffc757bb6b1e719e589bd7a5b2,1,10,1,11,2,2008-05-06 00:42:59,2008-05-06 00:42:59
6fc2c67581e3feffc757bb6b1e719e589bd7a5b2...eeab07179038a6a444e4b819f942663157768dfb,1,21,19,40,12,2008-05-06 00:54:59,2008-05-06 00:54:59
eeab07179038a6a444e4b819f942663157768dfb...789ad4f769a63fbb9eafd806ebf9e835d6fc771b,1,3,3,6,3,2008-05-06 01:29:13,2008-05-06 01:29:13
789ad4f769a63fbb9eafd806ebf9e835d6fc771b...e5e24bd33f348f89bedc76b2b650a2b4c5a0a024,1,3,7,10,2,2008-05-06 14:54:53,2008-05-06 14:54:53
e5e24bd33f348f89bedc76b2b650a2b4c5a0a024...ba48be3ada51aee683ce5992c5f00a8458f385f8,5,234,234,468,163,2008-05-06 18:56:02,2008-05-06 18:56:02
ba48be3ada51aee683ce5992c5f00a8458f385f8...1753ab3d823320da79cccc4041f662f2cfd1e20d,1,2,0,2,2,2008-05-06 19:39:58,2008-05-06 19:39:58
1753ab3d823320da79cccc4041f662f2cfd1e20d...46931d3146b454298231fc80a6c2d3894b125fde,3,18,1,19,3,2008-05-06 22:21:43,2008-05-06 22:21:43
46931d3146b454298231fc80a6c2d3894b125fde...69d9abff2cc051ba9b7bd62dc4ddaa55f9a8cd6d,1,8,13,21,6,2008-05-06 22:36:30,2008-05-06 22:36:30
69d9abff2cc051ba9b7bd62dc4ddaa55f9a8cd6d...a584f82aef3c20e11adeecc8513920e3d2a2ae2f,1,5,5,10,3,2008-05-06 23:28:21,2008-05-06 23:28:21
a584f82aef3c20e11adeecc8513920e3d2a2ae2f...4d41c71d3d923a1f38bd9ab320b8875fcc297639,1,2,2,4,1,2008-05-07 00:07:44,2008-05-07 00:07:44
4d41c71d3d923a1f38bd9ab320b8875fcc297639...96ca83d1501a2ffa78332c35d4a7afefe600f1ee,1,5,3,8,4,2008-05-07 00:46:14,2008-05-07 00:46:14
96ca83d1501a2ffa78332c35d4a7afefe600f1ee...5311565223cca0158cb44f4fffa812ce8dd4a4c8,1,2,6,8,3,2008-05-07 01:16:54,2008-05-07 01:16:54
5311565223cca0158cb44f4fffa812ce8dd4a4c8...4b970deacd80ddbcb909c42c41d5a566ad8f3e9f,1,1,1,2,1,2008-05-07 13:21:16,2008-05-07 13:21:16
4b970deacd80ddbcb909c42c41d5a566ad8f3e9f...9f0c0cfec5412dee5d7843e0b0b130d58038853c,1,2,2,4,2,2008-05-08 16:04:01,2008-05-08 16:04:01
9f0c0cfec5412dee5d7843e0b0b130d58038853c...ca73ba5668734523c008147ecd9ea037cc841af4,1,0,3,3,1,2008-05-08 16:10:47,2008-05-08 16:10:47
ca73ba5668734523c008147ecd9ea037cc841af4...858d56fc8e26a686cb19d1e35b0c2e8953987e49,1,6,7,13,2,2008-05-08 16:14:49,2008-05-08 16:14:49
858d56fc8e26a686cb19d1e35b0c2e8953987e49...a56317ea3ae99cee1783e27e36f3b9b323695bf8,1,5,2,7,2,2008-05-08 16:23:43,2008-05-08 16:23:43
a56317ea3ae99cee1783e27e36f3b9b323695bf8...407c5eb4302d6e7a1989123cb0028f97f309c3e0,1,7,3,10,3,2008-05-08 16:25:12,2008-05-08 16:25:12
407c5eb4302d6e7a1989123cb0028f97f309c3e0...487567e82fed4f596b5f97bfbcd5c2429ca35bb0,1,5,5,10,2,2008-05-08 17:08:59,2008-05-08 17:08:59
487567e82fed4f596b5f97bfbcd5c2429ca35bb0...6a9b73c7b97b7a1dbb3febde80aef70ebe162cd2,1,11,2,13,4,2008-05-08 17:11:03,2008-05-08 17:11:03
6a9b73c7b97b7a1dbb3febde80aef70ebe162cd2...0a794ed5fc651dbcce7eb9ff780656ea31c996d5,1,11,4,15,2,2008-05-08 17:16:49,2008-05-08 17:16:49
0a794ed5fc651dbcce7eb9ff780656ea31c996d5...b6bb0d46b6bfdd1478f408d5c223c925845a1ef8,4,4,449,453,6,2008-05-08 19:33:49,2008-05-08 19:33:49
b6bb0d46b6bfdd1478f408d5c223c925845a1ef8...aec0dad98046bf4242eaf9015a2a41f9e008cc0c,4,449,4,453,6,2008-05-08 21:42:40,2008-05-08 21:42:40
aec0dad98046bf4242eaf9015a2a41f9e008cc0c...6aa4200a8cefa87bb4ec100c0b0369517e35ed6b,1,1,1,2,1,2008-05-11 10:17:11,2008-05-11 10:17:11
6aa4200a8cefa87bb4ec100c0b0369517e35ed6b...1762dc24d66c7cbda189acffc21694884bb2ec7a,1,4,1,5,1,2008-05-11 20:59:24,2008-05-11 20:59:24
1762dc24d66c7cbda189acffc21694884bb2ec7a...440c08d768180cc668d0b2d77a9dfb14436555a5,1,1,1,2,1,2008-05-12 01:21:50,2008-05-12 01:21:50
440c08d768180cc668d0b2d77a9dfb14436555a5...99101e02f957087410cc0b5837ef09e3dfa12466,2,7,7,14,7,2008-05-12 19:45:02,2008-05-12 19:45:02
99101e02f957087410cc0b5837ef09e3dfa12466...16f6b3684d259c245c79a459195224a370234b82,1,1,1,2,1,2008-05-12 22:31:27,2008-05-12 22:31:27
16f6b3684d259c245c79a459195224a370234b82...37394598cb96ed17319b7f5f7e8e70ac0ee6633d,1,8,6,14,4,2008-05-12 22:59:58,2008-05-12 22:59:58
37394598cb96ed17319b7f5f7e8e70ac0ee6633d...e9b2781d30a325f835fbf7c0043cf855cbb6edfa,1,63,61,124,21,2008-05-13 00:37:30,2008-05-13 00:37:30
e9b2781d30a325f835fbf7c0043cf855cbb6edfa...70b5e670ca6f0c915232139db8e6766aa2c191d4,1,1,1,2,1,2008-05-13 00:42:12,2008-05-13 00:42:12
70b5e670ca6f0c915232139db8e6766aa2c191d4...20a7bff4019a93fd7cee04897effd49af8be4de4,2,6,3,9,3,2008-05-13 01:42:35,2008-05-13 01:42:35
20a7bff4019a93fd7cee04897effd49af8be4de4...3f5ff3097c315456fe92c9b1e4578590e1eb8648,7,242,242,484,215,2008-05-13 01:45:58,2008-05-13 01:45:58
3f5ff3097c315456fe92c9b1e4578590e1eb8648...28182b43209b0e62b9ca2192671fc26644953717,1,6,6,12,3,2008-05-13 02:20:08,2008-05-13 02:20:08
28182b43209b0e62b9ca2192671fc26644953717...bf802496c6b1055222814e8cd5185c023eadf202,1,2,1,3,2,2008-05-13 18:56:56,2008-05-13 18:56:56
bf802496c6b1055222814e8cd5185c023eadf202...5c0aea3bfe58142c0f92fc3a059588455376ec29,1,5,1,6,2,2008-05-13 19:47:39,2008-05-13 19:47:39
5c0aea3bfe58142c0f92fc3a059588455376ec29...06eb4d3223c4eee4223fbb084033dadfeae12f34,1,4,4,8,3,2008-05-13 19:58:00,2008-05-13 19:58:00
06eb4d3223c4eee4223fbb084033dadfeae12f34...44a6f5d0cb7f1124cd80e9b72d1fff9a46fe4c0b,1,1,1,2,1,2008-05-14 04:53:25,2008-05-14 04:53:25
44a6f5d0cb7f1124cd80e9b72d1fff9a46fe4c0b...f717260eead8a272f6c582cef43c3dcb4fb73b42,1,4,5,9,3,2008-05-14 17:23:44,2008-05-14 17:23:44
f717260eead8a272f6c582cef43c3dcb4fb73b42...ac324c97e319c8a107036e7ce98dff6e5f78a8ba,1,10,10,20,6,2008-05-14 17:54:54,2008-05-14 17:54:54
ac324c97e319c8a107036e7ce98dff6e5f78a8ba...831625c43e85a010064cac18b14ea49f1531c315,1,10,8,18,4,2008-05-14 18:06:59,2008-05-14 18:06:59
831625c43e85a010064cac18b14ea49f1531c315...69f72761faa6878e361711b70f1d27c467d256e4,1,5,2,7,1,2008-05-14 19:45:31,2008-05-14 19:45:31
69f72761faa6878e361711b70f1d27c467d256e4...d524c7eecca57959130099dada409e1fafd65677,1,1,0,1,1,2008-05-14 19:50:24,2008-05-14 19:50:24
d524c7eecca57959130099dada409e1fafd65677...b13a961ff58553ad76f134a3504d0c567f1703da,1,1,1,2,1,2008-05-14 20:10:39,2008-05-14 20:10:39
b13a961ff58553ad76f134a3504d0c567f1703da...1382ea8d98aa6d72c4240e42471917a350308d67,1,4,4,8,1,2008-05-14 21:18:46,2008-05-14 21:18:46
1382ea8d98aa6d72c4240e42471917a350308d67...5a92ec263d8289d2b6d21bcbfe02910c47a6ea4a,2,6,5,11,2,2008-05-15 12:53:07,2008-05-15 12:53:07
5a92ec263d8289d2b6d21bcbfe02910c47a6ea4a...31f22f244be7c37cc7a22f390d3483c9680b6b58,1,5,1,6,1,2008-05-15 13:45:09,2008-05-15 13:45:09
31f22f244be7c37cc7a22f390d3483c9680b6b58...54867a98033d7c1d2811308861ea5a92ef80ad4b,1,9,8,17,8,2008-05-15 14:16:19,2008-05-15 14:16:19
54867a98033d7c1d2811308861ea5a92ef80ad4b...9a7652260b7addcf8874bd46926ff92182b500ea,1,7,8,15,5,2008-05-15 14:45:29,2008-05-15 14:45:29
9a7652260b7addcf8874bd46926ff92182b500ea...de6520b50e481ba588e9021abcab16d06ea61141,7,71,9,80,24,2008-05-15 19:38:00,2008-05-15 19:38:00
de6520b50e481ba588e9021abcab16d06ea61141...82ba3709eec42dd8da33eb2023fda927166260eb,1,6,4,10,2,2008-05-15 20:29:52,2008-05-15 20:29:52
82ba3709eec42dd8da33eb2023fda927166260eb...c5f4d70e2ba039759ab6d889893d4feb1cca3c52,1,39,39,78,34,2008-05-15 21:03:31,2008-05-15 21:03:31
c5f4d70e2ba039759ab6d889893d4feb1cca3c52...2c2a6253e3744983741882ca4565a20b4b0b3f42,4,5,2,7,4,2008-05-15 23:36:06,2008-05-15 23:36:06
2c2a6253e3744983741882ca4565a20b4b0b3f42...afc2ebde1425722f4e2df14919c0df0ff7d2ff0c,1,6,2,8,3,2008-05-16 16:39:27,2008-05-16 16:39:27
afc2ebde1425722f4e2df14919c0df0ff7d2ff0c...da76a723e14c037d59e830bb0d01b0b627286020,1,1,1,2,1,2008-05-16 16:41:12,2008-05-16 16:41:12
da76a723e14c037d59e830bb0d01b0b627286020...3a7b09e5c747a9bf1386d667c7abed9630097072,1,1,3,4,1,2008-05-16 18:32:03,2008-05-16 18:32:03
3a7b09e5c747a9bf1386d667c7abed9630097072...d44c5025c42645a6e2b6e664b689669c3752b236,1,3,1,4,1,2008-05-16 18:37:11,2008-05-16 18:37:11
d44c5025c42645a6e2b6e664b689669c3752b236...6b535eb79fdb65df1e16997fa73e57cfcb806bbe,1,2,2,4,2,2008-05-16 19:51:34,2008-05-16 19:51:34
6b535eb79fdb65df1e16997fa73e57cfcb806bbe...3b81847f35529ec9642bfca9ddc4d21407c57413,1,0,1,1,1,2008-05-16 20:00:16,2008-05-16 20:00:16
3b81847f35529ec9642bfca9ddc4d21407c57413...2db27efd662693dd90fbf89ea1e4bbee7c9fb929,1,1,1,2,1,2008-05-18 20:19:46,2008-05-18 20:19:46
2db27efd662693dd90fbf89ea1e4bbee7c9fb929...456d8a62ccf3244c58ace2b315694ad54cfc05e3,1,1,1,2,1,2008-05-21 03:14:54,2008-05-21 03:14:54
456d8a62ccf3244c58ace2b315694ad54cfc05e3...ec075266e99e5b3875241341ec1c716fb81b72fc,1,11,11,22,4,2008-05-23 00:54:59,2008-05-23 00:54:59
ec075266e99e5b3875241341ec1c716fb81b72fc...7f27816d3068bff70eecfcf18366b54345750efe,1,3,0,3,1,2008-05-24 17:57:45,2008-05-24 17:57:45
7f27816d3068bff70eecfcf18366b54345750efe...cff5323a1de17423e231b01c7fa8ebe31a62cf5e,1,7,5,12,3,2008-05-24 18:09:21,2008-05-24 18:09:21
cff5323a1de17423e231b01c7fa8ebe31a62cf5e...0e63c789e3270e68c96c36a8ebad8d352fbfc76f,1,128,107,235,105,2008-05-24 18:11:55,2008-05-24 18:11:55
0e63c789e3270e68c96c36a8ebad8d352fbfc76f...895df76146e2486c812a3a9bc5ed1585b0176f21,1,1,1,2,1,2008-05-24 18:22:17,2008-05-24 18:22:17
895df76146e2486c812a3a9bc5ed1585b0176f21...3c5c3dffaa4cd72ef112f414e2e2bb3b72f3f1b4,1,1,1,2,1,2008-05-24 21:27:12,2008-05-24 21:27:12
3c5c3dffaa4cd72ef112f414e2e2bb3b72f3f1b4...042e51e731942ee48563e1caccd75d9ce226cf9d,1,3,3,6,1,2008-05-25 03:20:13,2008-05-25 03:20:13
042e51e731942ee48563e1caccd75d9ce226cf9d...6141984b7115882cd84cb2cd2cae11de35914775,1,1,1,2,1,2008-05-25 13:18:01,2008-05-25 13:18:01
6141984b7115882cd84cb2cd2cae11de35914775...e87d2c7a5812299ae8390987aec21cc954a8e45a,1,2,1,3,1,2008-05-27 19:17:26,2008-05-27 19:17:26
e87d2c7a5812299ae8390987aec21cc954a8e45a...7ec772374d132149d72418abce4569dedbd4168b,1,1,1,2,1,2008-05-27 22:44:06,2008-05-27 22:44:06
7ec772374d132149d72418abce4569dedbd4168b...c6e88b16e9f6e45d87019db45dd04d27482d25d7,2,36,0,36,2,2008-05-27 22:46:28,2008-05-27 22:46:28
c6e88b16e9f6e45d87019db45dd04d27482d25d7...11761def421412df7ea4d3414310befef450b7ea,1,8,4,12,4,2008-05-28 02:50:38,2008-05-28 02:50:38
11761def421412df7ea4d3414310befef450b7ea...6bf51eea0489149c755f12007b585dc5521b46d3,1,2,1,3,1,2008-05-28 18:46:38,2008-05-28 18:46:38
6bf51eea0489149c755f12007b585dc5521b46d3...52fbe5d2a8441c9bca5c2b8b9fa8b2bc388a11c1,13,10016,2,10018,13,2008-05-28 20:19:18,2008-05-28 20:19:18
52fbe5d2a8441c9bca5c2b8b9fa8b2bc388a11c1...abb055bb498c4938b8663eb37c98e9f9e8fd8c9e,1,7,3,10,2,2008-05-28 20:43:13,2008-05-28 20:43:13
abb055bb498c4938b8663eb37c98e9f9e8fd8c9e...9e48649729a5d4cd9ce52bcba067ba33a562cb4b,11,863,837,1700,491,2008-05-28 23:18:25,2008-05-28 23:18:25
9e48649729a5d4cd9ce52bcba067ba33a562cb4b...1e9593646f5047cfc5b1754b663e59ec9b73dfce,1,11,5,16,6,2008-05-29 00:03:45,2008-05-29 00:03:45
1e9593646f5047cfc5b1754b663e59ec9b73dfce...24eb176f0cd986cbedd08db11d168431df10ed69,4,4,4,8,4,2008-06-05 18:11:29,2008-06-05 18:11:29
24eb176f0cd986cbedd08db11d168431df10ed69...c90fe0283bac94327a8a8ec75e7292322c77dd01,1,4,4,8,3,2008-06-05 20:00:50,2008-06-05 20:00:50
c90fe0283bac94327a8a8ec75e7292322c77dd01...fa48ad1d1be18482dbabe58182025a8d22dee236,1,1,1,2,1,2008-06-06 00:28:33,2008-06-06 00:28:33
fa48ad1d1be18482dbabe58182025a8d22dee236...2f2602ed15b4bac1274d210348d63931a6fdf39e,1,1,1,2,1,2008-06-13 18:42:54,2008-06-13 18:42:54
2f2602ed15b4bac1274d210348d63931a6fdf39e...5e50079b1472d9fef27fdc3f59c0f2e494556dd9,1,4,4,8,3,2008-06-17 19:57:42,2008-06-17 19:57:42
5e50079b1472d9fef27fdc3f59c0f2e494556dd9...21d669135d3fe735d116a8b9a457b961ef684b0d,1,5,1,6,2,2008-06-17 19:59:16,2008-06-17 19:59:16
21d669135d3fe735d116a8b9a457b961ef684b0d...febe463cc29ab68270ad70aa9c0314373cfd1c95,1,1,1,2,1,2008-06-17 20:11:47,2008-06-17 20:11:47
febe463cc29ab68270ad70aa9c0314373cfd1c95...335b8816c2f1e66de1fa245278794f8c7fdb1e01,1,4,3,7,2,2008-06-17 20:32:15,2008-06-17 20:32:15
335b8816c2f1e66de1fa245278794f8c7fdb1e01...35b8157507afaa28aa6e2e8efa5bb03315b33e1c,1,1,1,2,1,2008-06-17 21:03:20,2008-06-17 21:03:20
35b8157507afaa28aa6e2e8efa5bb03315b33e1c...bf14ac123622da377624ab2e4babddcce4f9cdba,1,1,0,1,1,2008-06-17 21:31:57,2008-06-17 21:31:57
bf14ac123622da377624ab2e4babddcce4f9cdba...91a84d233d887dfe08f659779a31d43fb36cf3aa,1,5,7,12,4,2008-06-20 09:02:48,2008-06-20 09:02:48
91a84d233d887dfe08f659779a31d43fb36cf3aa...6159593520345aa00d4051e465736f0ec42a33cd,1,2,1,3,1,2008-06-20 16:20:20,2008-06-20 16:20:20
6159593520345aa00d4051e465736f0ec42a33cd...faa502cbc0336eacf0f6c1bbc872d168a9f513e9,1,2,2,4,2,2008-06-20 16:56:25,2008-06-20 16:56:25
faa502cbc0336eacf0f6c1bbc872d168a9f513e9...dee02e57558268b74bae06c247f854e7b8fa92c4,1,1,1,2,1,2008-06-20 21:18:40,2008-06-20 21:18:40
dee02e57558268b74bae06c247f854e7b8fa92c4...4812446594645b0a431b66507595afd3331e3292,1,1,1,2,1,2008-06-20 21:52:06,2008-06-20 21:52:06
4812446594645b0a431b66507595afd3331e3292...b5d65d4e4920d0a09bb53504cca7c21033ea8790,1,6,10,16,4,2008-06-24 10:00:42,2008-06-24 10:00:42
b5d65d4e4920d0a09bb53504cca7c21033ea8790...201f1b66cc4fe86ea08d118ce15d831c6561cc8c,1,1,1,2,1,2008-06-24 15:55:50,2008-06-24 15:55:50
201f1b66cc4fe86ea08d118ce15d831c6561cc8c...d1210a5a88ee435b0f46918d03852cf2f8469ca9,1,1,1,2,1,2008-06-24 16:16:15,2008-06-24 16:16:15
d1210a5a88ee435b0f46918d03852cf2f8469ca9...18d3e759458b7b6e3d615fa554949b8815f15669,1,1,1,2,1,2008-06-27 14:17:28,2008-06-27 14:17:28
18d3e759458b7b6e3d615fa554949b8815f15669...96e4006b74d03319af86b9ed27f7235ee2f8fe6c,1,1,1,2,1,2008-06-30 16:17:44,2008-06-30 16:17:44
96e4006b74d03319af86b9ed27f7235ee2f8fe6c...a23e4361fc0221ca6132e962a5a8b2030bd1c390,1,3,1,4,2,2008-07-01 02:05:46,2008-07-01 02:05:46
a23e4361fc0221ca6132e962a5a8b2030bd1c390...28937ded0ebecd0e48138e57322b299cefcef4a7,1,9,6,15,3,2008-07-01 02:08:45,2008-07-01 02:08:45
28937ded0ebecd0e48138e57322b299cefcef4a7...cf78e396db1b986360c32fb0ca071a0fb90da064,1,4,1,5,1,2008-07-01 02:25:55,2008-07-01 02:25:55
cf78e396db1b986360c32fb0ca071a0fb90da064...112f7b15ae903aa2378f780f79d30a3dbb011cee,1,6,3,9,1,2008-07-01 02:50:38,2008-07-01 02:50:38
112f7b15ae903aa2378f780f79d30a3dbb011cee...aacdeeb48d551c12939b91f395e3521f761ab945,1,13,20,33,2,2008-07-03 22:54:12,2008-07-03 22:54:12
aacdeeb48d551c12939b91f395e3521f761ab945...e132d6bc53093ed2387b565d37ce1d1845a4fe82,1,1,1,2,1,2008-07-09 19:23:19,2008-07-09 19:23:19
e132d6bc53093ed2387b565d37ce1d1845a4fe82...6eb2bfe6aefaeff522a9d3a8ac9511e15932bfcf,1,3,0,3,1,2008-07-09 19:26:41,2008-07-09 19:26:41
6eb2bfe6aefaeff522a9d3a8ac9511e15932bfcf...b36fe4686c76dc13ba64fd62e38387c7ed73e0c9,1,5,5,10,5,2008-07-09 21:38:28,2008-07-09 21:38:28
b36fe4686c76dc13ba64fd62e38387c7ed73e0c9...a33f85e691e07f03f724b2bd3c6948b346d33ee6,1,1,1,2,1,2008-07-15 15:58:01,2008-07-15 15:58:01
a33f85e691e07f03f724b2bd3c6948b346d33ee6...fa13d6009d5f7a6b2c51463522ce1ced49110410,7,3893,0,3893,7,2008-07-22 02:12:08,2008-07-22 02:12:08
fa13d6009d5f7a6b2c51463522ce1ced49110410...43c4b64f328c5d6f2642f6dcf33eb27c377c0491,1,1,1,2,1,2008-07-23 15:21:27,2008-07-23 15:21:27
43c4b64f328c5d6f2642f6dcf33eb27c377c0491...69212c501f8875b4650847053cc41eaa470e5848,2,8,5,13,5,2008-07-23 16:18:05,2008-07-23 16:18:05
69212c501f8875b4650847053cc41eaa470e5848...a27b5d0468acc5dd8cdfcbff9464546b353e3c04,4,21,5,26,7,2008-07-23 17:00:32,2008-07-23 17:00:32
a27b5d0468acc5dd8cdfcbff9464546b353e3c04...23eeaf38546d7d2757c02ca1c4b4a27aaa453133,1,1,1,2,1,2008-07-28 16:23:23,2008-07-28 16:23:23
23eeaf38546d7d2757c02ca1c4b4a27aaa453133...a3e97062d42ad6ee1c5feff9382a854768703d54,1,1,1,2,1,2008-07-28 16:34:46,2008-07-28 16:34:46
a3e97062d42ad6ee1c5feff9382a854768703d54...31293063fa0477a0fc31526c6f57a2ed0c343c07,1,37,62,99,3,2008-07-28 18:31:25,2008-07-28 18:31:25
31293063fa0477a0fc31526c6f57a2ed0c343c07...b8ceedbe2ba07f87a0f0e3862dfe012e8aa863b3,1,10,3,13,3,2008-08-04 14:18:06,2008-08-04 14:18:06
b8ceedbe2ba07f87a0f0e3862dfe012e8aa863b3...9d9c4d2a516216378f4eec0bc27a2cc1cfc78d53,1,7,8,15,3,2008-08-07 13:07:21,2008-08-07 13:07:21
9d9c4d2a516216378f4eec0bc27a2cc1cfc78d53...bf6f7e7a63cb3d43da2fcc98c81690d2dc1ac54b,1,10,6,16,3,2008-08-07 20:41:05,2008-08-07 20:41:05
bf6f7e7a63cb3d43da2fcc98c81690d2dc1ac54b...c66aa570299459ea948eb123a442da6e22a9611b,1,0,48,48,1,2008-08-08 17:21:42,2008-08-08 17:21:42
c66aa570299459ea948eb123a442da6e22a9611b...db63af106891ceda11eeea3c5ca6d7d39e09d81c,5,18,461,479,7,2008-08-08 17:42:52,2008-08-08 17:42:52
db63af106891ceda11eeea3c5ca6d7d39e09d81c...fc38ead4dc2dd201ad0eb7539a65a4a5bbc1644b,1,6,7,13,4,2008-08-10 23:59:01,2008-08-10 23:59:01
fc38ead4dc2dd201ad0eb7539a65a4a5bbc1644b...db076b06f5e01a9d544cc0a505e52debf730f179,1,0,3,3,1,2008-08-11 00:54:05,2008-08-11 00:54:05
db076b06f5e01a9d544cc0a505e52debf730f179...c9c024280abd20b4eef4a2dc280fa7f1d7be02f9,1,2,3,5,2,2008-08-11 01:35:23,2008-08-11 01:35:23
c9c024280abd20b4eef4a2dc280fa7f1d7be02f9...1023cf1d72a3bfe56cbbf8ef89ad96725639e066,2,10,5,15,4,2008-08-12 19:34:30,2008-08-12 19:34:30
1023cf1d72a3bfe56cbbf8ef89ad96725639e066...5dc7bb7233efee125922cc63e286c96a73b9326c,1,1,2,3,1,2008-08-13 01:44:36,2008-08-13 01:44:36
5dc7bb7233efee125922cc63e286c96a73b9326c...ec146fc73d0ea06bf29938e6427fad7bcaefd6ad,1,1,1,2,1,2008-08-13 18:16:14,2008-08-13 18:16:14
ec146fc73d0ea06bf29938e6427fad7bcaefd6ad...b69dc841ff6d3a3a9bcb8ebe107f1d1cad8a634f,1,1,1,2,1,2008-08-14 14:03:05,2008-08-14 14:03:05
b69dc841ff6d3a3a9bcb8ebe107f1d1cad8a634f...0865b073f81513056f46296cd2a236ab2ca35703,1,1,1,2,1,2008-08-21 17:08:50,2008-08-21 17:08:50
0865b073f81513056f46296cd2a236ab2ca35703...96e8f355daea4ec16b6f98f3cc2472a75cabc3eb,1,14,15,29,3,2008-10-18 21:59:09,2008-10-18 21:59:09
96e8f355daea4ec16b6f98f3cc2472a75cabc3eb...63bfe1ded1fe01d326594e9a757a2c2ceab8d8ae,1,6,2,8,3,2008-10-18 22:22:08,2008-10-18 22:22:08
63bfe1ded1fe01d326594e9a757a2c2ceab8d8ae...aa9236e5ea8c91fbf60d440872e4946a0452f852,1,13,1,14,5,2008-10-18 22:46:04,2008-10-18 22:46:04
aa9236e5ea8c91fbf60d440872e4946a0452f852...4add9fa9896be80364b2a97abc8bb5b5a6eb3e89,1,4,6,10,4,2008-10-18 23:27:43,2008-10-18 23:27:43
4add9fa9896be80364b2a97abc8bb5b5a6eb3e89...b860c30b8259fcb3e3bb128683ed400282d69c15,1,2,1,3,2,2008-10-21 01:48:23,2008-10-21 01:48:23
b860c30b8259fcb3e3bb128683ed400282d69c15...69cbcf863769e64f0a11c68a1846cd0e9785d25f,1,2,2,4,1,2008-10-21 01:49:11,2008-10-21 01:49:11
69cbcf863769e64f0a11c68a1846cd0e9785d25f...ad54d14ae55dd7e8063dc0c2c67346c4345d7259,1,1,1,2,1,2008-10-22 10:06:54,2008-10-22 10:06:54
ad54d14ae55dd7e8063dc0c2c67346c4345d7259...30751dd9f170e53e5feb6b92a64aa50970db69ef,1,1,1,2,1,2008-10-22 15:23:37,2008-10-22 15:23:37
30751dd9f170e53e5feb6b92a64aa50970db69ef...12bb969411716dcad3237f3403e83744add3f84c,2,5,5,10,5,2008-10-24 14:40:58,2008-10-24 14:40:58
12bb969411716dcad3237f3403e83744add3f84c...61784e15816a35086388ebd5b98b56dea3535052,1,1,1,2,1,2008-10-29 01:12:27,2008-10-29 01:12:27
61784e15816a35086388ebd5b98b56dea3535052...77cfd696ec4180f346a8531ed2d6ae133044a27c,1,0,2,2,1,2008-10-29 01:15:47,2008-10-29 01:15:47
77cfd696ec4180f346a8531ed2d6ae133044a27c...325755d4b38e87b13f9c24a4c2991ec497552aad,3,10,6,16,7,2008-10-29 02:01:22,2008-10-29 02:01:22
325755d4b38e87b13f9c24a4c2991ec497552aad...b64d60940d7e66eb636e255b51ea5020c0399524,1,1,1,2,1,2008-11-07 15:44:33,2008-11-07 15:44:33
b64d60940d7e66eb636e255b51ea5020c0399524...5c21e44fce5335cfe1bb4989006900476f2c75ca,3,110,92,202,17,2008-11-10 02:39:03,2008-11-10 02:39:03
5c21e44fce5335cfe1bb4989006900476f2c75ca...3b1cf91fa44a02ed1377e9fe37b868a6e54762ea,1,27,15,42,1,2008-11-12 13:18:47,2008-11-12 13:18:47
3b1cf91fa44a02ed1377e9fe37b868a6e54762ea...464535e0965d5de617a24e608a2d05393194c3fd,1,4,3,7,1,2008-11-13 02:35:02,2008-11-13 02:35:02
464535e0965d5de617a24e608a2d05393194c3fd...0aa8d40cdfb50fd423a3bdcf585ac27f89df5b97,1,15,4,19,4,2008-11-14 04:16:00,2008-11-14 04:16:00
0aa8d40cdfb50fd423a3bdcf585ac27f89df5b97...ab551c2b14ac6b0511cf3da10ca224ce461a0f10,6,52,54,106,48,2008-11-17 16:32:05,2008-11-17 16:32:05
ab551c2b14ac6b0511cf3da10ca224ce461a0f10...d81dfbcccf07aa63c6bf5beb10a2d37207d9e340,1,4,3,7,2,2008-11-18 04:53:34,2008-11-18 04:53:34
d81dfbcccf07aa63c6bf5beb10a2d37207d9e340...d1f089952ec7640aa08d8a8dc5031a670165576a,1,1,1,2,1,2008-11-18 06:00:34,2008-11-18 06:00:34
d1f089952ec7640aa08d8a8dc5031a670165576a...615a4ce1b4c20e5b538332d0a6e19157243a9471,1,1,1,2,1,2008-11-29 01:14:02,2008-11-29 01:14:02
615a4ce1b4c20e5b538332d0a6e19157243a9471...475f89b6519c95f730ed04cd3dd715f582873e4d,1,1,1,2,1,2008-12-16 00:02:17,2008-12-16 00:02:17
475f89b6519c95f730ed04cd3dd715f582873e4d...e611289a79d959c1185d002c29093e9809b6dec8,1,1,3,4,1,2008-12-16 00:05:04,2008-12-16 00:05:04
e611289a79d959c1185d002c29093e9809b6dec8...ba4453def2c0b88001340a75bd8b93e95f6029b3,1,0,5,5,1,2008-12-18 16:43:39,2008-12-18 16:43:39
ba4453def2c0b88001340a75bd8b93e95f6029b3...4c1e12e889f2a70bfa3603fed9d1cabe67d294e0,1,14,40,54,8,2008-12-19 04:29:48,2008-12-19 04:29:48
4c1e12e889f2a70bfa3603fed9d1cabe67d294e0...77344f4c50386690782ab8ddc92898a918f54f5c,2,63,8,71,6,2008-12-19 04:34:12,2008-12-19 04:34:12
77344f4c50386690782ab8ddc92898a918f54f5c...0935f4a0b1281f5d09685fa08b86944b2421747f,3,7,6,13,5,2008-12-19 04:36:28,2008-12-19 04:36:28
0935f4a0b1281f5d09685fa08b86944b2421747f...2875460f6321e17e06be94f01d727fe8ddfe5465,2,80,7,87,11,2008-12-19 04:37:10,2008-12-19 04:37:10
2875460f6321e17e06be94f01d727fe8ddfe5465...132b8de6141b5433ff80ce57f9486255840a392e,2,53,50,103,13,2008-12-19 04:37:54,2008-12-19 04:37:54
132b8de6141b5433ff80ce57f9486255840a392e...3963fcb30dfb430e4565c5ccd466cff166c3fe43,1,1,1,2,1,2008-12-19 05:42:15,2008-12-19 05:42:15
3963fcb30dfb430e4565c5ccd466cff166c3fe43...46ee77bcc3be1c84e95b510ca8a0ce1e19e8ea12,1,1719,1719,3438,2,2008-12-19 05:43:37,2008-12-19 05:43:37
46ee77bcc3be1c84e95b510ca8a0ce1e19e8ea12...62bd7e6817a39fcca21abd62f92d787fab210c03,1,1,1,2,1,2008-12-19 06:49:03,2008-12-19 06:49:03
62bd7e6817a39fcca21abd62f92d787fab210c03...80a6a91347bcda3ce2f19bf0dfb6973bc97c8916,1,5,3,8,3,2008-12-19 06:49:44,2008-12-19 06:49:44
80a6a91347bcda3ce2f19bf0dfb6973bc97c8916...18ee5a93a2d940789d57544da5f61324bd55e3ec,1,3,2,5,2,2008-12-19 06:58:18,2008-12-19 06:58:18
18ee5a93a2d940789d57544da5f61324bd55e3ec...5c1725d689c1b5b9a8d3c35aa85c42e71016855b,1,45,22,67,6,2008-12-19 18:21:12,2008-12-19 18:21:12
5c1725d689c1b5b9a8d3c35aa85c42e71016855b...c85243dfc4b09e6bb87532f2025f686b6ae45a22,4,861,388,1249,114,2008-12-20 01:19:17,2008-12-20 01:19:17
c85243dfc4b09e6bb87532f2025f686b6ae45a22...6f2f1830a4cbf8c9a6a74e80e920915f87673119,1,1,1,2,1,2008-12-20 14:39:36,2008-12-20 14:39:36
6f2f1830a4cbf8c9a6a74e80e920915f87673119...6048e40a4514445e17e9db255b949cb5e7a556c0,1,10,10,20,8,2008-12-20 22:45:11,2008-12-20 22:45:11
6048e40a4514445e17e9db255b949cb5e7a556c0...8ee1708ea93517f69979a6805480597b96b58da7,1,1,1,2,1,2008-12-21 21:18:40,2008-12-21 21:18:40
8ee1708ea93517f69979a6805480597b96b58da7...b850ab2b8e65eadd25093c81bbc67a881daa0488,6,86,154,240,29,2008-12-21 21:22:44,2008-12-21 21:22:44
b850ab2b8e65eadd25093c81bbc67a881daa0488...c9dd5d997229919b8dd4cc402b7b7a465982071a,1,99,0,99,1,2008-12-21 23:06:42,2008-12-21 23:06:42
c9dd5d997229919b8dd4cc402b7b7a465982071a...6b090328643988869e2288a4874935680d8573ca,2,19,0,19,2,2008-12-22 00:52:53,2008-12-22 00:52:53
6b090328643988869e2288a4874935680d8573ca...25885e07b2683601a20481d614d282ded419793e,2,41,1,42,3,2008-12-22 01:57:06,2008-12-22 01:57:06
25885e07b2683601a20481d614d282ded419793e...67ded9a36a89c5fa1b1061c283dad078a59bec8e,1,4,4,8,1,2008-12-22 02:02:05,2008-12-22 02:02:05
67ded9a36a89c5fa1b1061c283dad078a59bec8e...c03a2801556d42d60fed1a5b4ce5d25362ccd9f5,2,141,21,162,17,2008-12-22 04:59:34,2008-12-22 04:59:34
c03a2801556d42d60fed1a5b4ce5d25362ccd9f5...77477d56346b094f0be6985aae8e118655b8c6ec,1,1,1,2,1,2008-12-22 14:47:34,2008-12-22 14:47:34
77477d56346b094f0be6985aae8e118655b8c6ec...47aed822a43a02597f3b624f0efdcb4993212adf,1,0,18,18,4,2008-12-22 16:41:14,2008-12-22 16:41:14
47aed822a43a02597f3b624f0efdcb4993212adf...df1f656aae019bab1c0e84b41aca26714b4d0d5c,1,1,1,2,1,2008-12-22 17:31:22,2008-12-22 17:31:22
df1f656aae019bab1c0e84b41aca26714b4d0d5c...53e9fb9496d63b4b1adc3356ee5907bea6cf7ba0,1,1,1,2,1,2008-12-22 17:34:34,2008-12-22 17:34:34
53e9fb9496d63b4b1adc3356ee5907bea6cf7ba0...5459180728260b09a5d1d8b8ea17201dda131d47,1,1,1,2,1,2008-12-25 17:37:58,2008-12-25 17:37:58
5459180728260b09a5d1d8b8ea17201dda131d47...4b25b147ab60a026ba1841b313d713fe57530b04,2,17,2,19,3,2008-12-25 19:25:30,2008-12-25 19:25:30
4b25b147ab60a026ba1841b313d713fe57530b04...0e3e470edc77cde0eede8aa6b7642c336d081d66,2,19,3,22,7,2008-12-25 19:47:56,2008-12-25 19:47:56
0e3e470edc77cde0eede8aa6b7642c336d081d66...0a8f96ac3d37f637ab433c037d4f807e8ef94bbe,2,12,3,15,3,2008-12-25 20:12:18,2008-12-25 20:12:18
0a8f96ac3d37f637ab433c037d4f807e8ef94bbe...654d946ead6bc1f995c04af2abc02da30cfe4f74,2,16,6,22,5,2008-12-25 20:13:42,2008-12-25 20:13:42
654d946ead6bc1f995c04af2abc02da30cfe4f74...e4d8365ec7e9cc8bc8aba47817601d413dd10e28,1,2,2,4,2,2008-12-25 21:00:08,2008-12-25 21:00:08
e4d8365ec7e9cc8bc8aba47817601d413dd10e28...eff400e44f595035efac0f5169f08ede402ddeac,1,0,1,1,1,2008-12-25 21:09:08,2008-12-25 21:09:08
eff400e44f595035efac0f5169f08ede402ddeac...8cd50a398dfd9ab8ad93c7c26749c67345c14d74,1,7,5,12,2,2008-12-25 21:20:41,2008-12-25 21:20:41
8cd50a398dfd9ab8ad93c7c26749c67345c14d74...4ca4ce52f76f4db64f9a8350aa60ab54eba15697,2,107,82,189,27,2008-12-25 21:44:54,2008-12-25 21:44:54
4ca4ce52f76f4db64f9a8350aa60ab54eba15697...51428a3c9e21f8c98e9ada60e5fa34ee53de0aa3,1,7,7,14,2,2008-12-26 15:48:04,2008-12-26 15:48:04
51428a3c9e21f8c98e9ada60e5fa34ee53de0aa3...d37aeceb6974e013c2b15d4888fa84695c171422,1,0,2,2,1,2008-12-27 18:21:54,2008-12-27 18:21:54
d37aeceb6974e013c2b15d4888fa84695c171422...4f99e793fa7a745ee49c73193891d6e2a40565c2,2,14,5,19,7,2008-12-29 21:57:29,2008-12-29 21:57:29
4f99e793fa7a745ee49c73193891d6e2a40565c2...1b0276dc57cbca869027ba19986b0810f7042854,1,2,1,3,2,2008-12-29 22:05:02,2008-12-29 22:05:02
1b0276dc57cbca869027ba19986b0810f7042854...4afa60835146e71c0e57b492a1cca278eaf1ef9c,7,164,255,419,10,2008-12-30 02:31:26,2008-12-30 02:31:26
4afa60835146e71c0e57b492a1cca278eaf1ef9c...a09dac440609ac0154b489a647cfe3b93b7d400b,1,290,0,290,1,2008-12-30 02:40:04,2008-12-30 02:40:04
a09dac440609ac0154b489a647cfe3b93b7d400b...a1ca9427eca113e6747e99a86b2283e3a6f63502,1,1,146,147,1,2008-12-30 02:43:14,2008-12-30 02:43:14
a1ca9427eca113e6747e99a86b2283e3a6f63502...4f7441910f664800cca8d252f04ec479518edfe0,2,22,4,26,5,2008-12-30 20:45:33,2008-12-30 20:45:33
4f7441910f664800cca8d252f04ec479518edfe0...7138cf0ce04b4ee1834c0aaa9d5e435f6eac882f,1,1,0,1,1,2008-12-30 22:05:45,2008-12-30 22:05:45
7138cf0ce04b4ee1834c0aaa9d5e435f6eac882f...0a846e5be6e74d97c191379b3bc69c93125144ee,1,13,16,29,5,2008-12-30 23:29:14,2008-12-30 23:29:14
0a846e5be6e74d97c191379b3bc69c93125144ee...c0446c70d52fe2afd74b2f95c384ae238c48ad09,2,152,84,236,36,2008-12-31 02:58:13,2008-12-31 02:58:13
c0446c70d52fe2afd74b2f95c384ae238c48ad09...c7a14f13916ca8ed22f9bb6fe40fa104b370211f,1,6,5,11,4,2008-12-31 03:36:51,2008-12-31 03:36:51
c7a14f13916ca8ed22f9bb6fe40fa104b370211f...6a3d1a1e281a5d13bca1ea388ae2bd8ce513ffb2,2,6,2,8,3,2008-12-31 19:21:24,2008-12-31 19:21:24
6a3d1a1e281a5d13bca1ea388ae2bd8ce513ffb2...c59bf424a1aff179ad8b5cf51c157cd5f7f8a491,1,1,1,2,1,2009-01-02 19:23:12,2009-01-02 19:23:12
c59bf424a1aff179ad8b5cf51c157cd5f7f8a491...d20e7fede1ea2e7047a34a1749bc127c22b02049,1,6,4,10,4,2009-01-02 19:25:54,2009-01-02 19:25:54
d20e7fede1ea2e7047a34a1749bc127c22b02049...989e3f61f78c773d5c6066152c0bf3fd61d752ed,2,6,52,58,11,2009-01-02 22:23:52,2009-01-02 22:23:52
989e3f61f78c773d5c6066152c0bf3fd61d752ed...b2552e6ea35a1e00675d70a615d3af83137965df,1,59,64,123,16,2009-01-02 23:07:16,2009-01-02 23:07:16
b2552e6ea35a1e00675d70a615d3af83137965df...b2583a7526c0051f7c5f11a25e0cbaeb13930fc6,2,17,8,25,6,2009-01-02 23:32:10,2009-01-02 23:32:10
b2583a7526c0051f7c5f11a25e0cbaeb13930fc6...303ad32c749ba92d2ce31dfe46942c92093677cb,1,2,6,8,4,2009-01-02 23:44:06,2009-01-02 23:44:06
303ad32c749ba92d2ce31dfe46942c92093677cb...cff37cc83559586d3cc514d620880f2d9103fae9,1,4,1,5,1,2009-01-03 00:19:02,2009-01-03 00:19:02
cff37cc83559586d3cc514d620880f2d9103fae9...c0294278db40da764a98ea1c1506548e539213c7,2,12,8,20,4,2009-01-03 00:51:07,2009-01-03 00:51:07
c0294278db40da764a98ea1c1506548e539213c7...434b87b8a233eb24ec773de801f3adb460fbd0f4,5,7,3,10,5,2009-01-04 15:29:27,2009-01-04 15:29:27
434b87b8a233eb24ec773de801f3adb460fbd0f4...12166e9bb2684f294bdde5ecf106a548ed7370b4,1,13,5,18,2,2009-01-04 17:21:00,2009-01-04 17:21:00
12166e9bb2684f294bdde5ecf106a548ed7370b4...0eaead0b919bf173b917cf874f953570ccd1a536,1,1,1,2,1,2009-01-04 21:09:03,2009-01-04 21:09:03
0eaead0b919bf173b917cf874f953570ccd1a536...ddec4fdc3408e538b88d17636986280c59a75160,1,3,1,4,3,2009-01-04 21:15:02,2009-01-04 21:15:02
ddec4fdc3408e538b88d17636986280c59a75160...83be3dca69391751276b6a8b38420f25e06c1045,1,20,22,42,1,2009-01-04 22:25:46,2009-01-04 22:25:46
83be3dca69391751276b6a8b38420f25e06c1045...9472728bced5c6c2de53b8a95eead8d08a299eda,1,1,1,2,1,2009-01-04 22:32:18,2009-01-04 22:32:18
9472728bced5c6c2de53b8a95eead8d08a299eda...192d6cd4a30bef497f72b1ca9b62fd8b90ade806,3,19,12,31,5,2009-01-04 23:34:18,2009-01-04 23:34:18
192d6cd4a30bef497f72b1ca9b62fd8b90ade806...d1146aa7bfda81f5737fa1304af894cd9c578858,1,1,1,2,1,2009-01-04 23:58:43,2009-01-04 23:58:43
d1146aa7bfda81f5737fa1304af894cd9c578858...989667c9fd504e84281a0a30535406d471d4a7b6,2,56,46,102,30,2009-01-05 00:21:13,2009-01-05 00:21:13
989667c9fd504e84281a0a30535406d471d4a7b6...19a3ea2c7f88b7b3229629d7c7f7b596cee50c69,1,0,1,1,1,2009-01-05 00:34:40,2009-01-05 00:34:40
19a3ea2c7f88b7b3229629d7c7f7b596cee50c69...cc66e6affea6486cadb0d1514673a410997e11cf,1,18,13,31,5,2009-01-05 01:14:36,2009-01-05 01:14:36
cc66e6affea6486cadb0d1514673a410997e11cf...4694e537bc911d843524d5f54c65f29c8a60fc5c,2,8,1,9,2,2009-01-05 01:24:14,2009-01-05 01:24:14
4694e537bc911d843524d5f54c65f29c8a60fc5c...558d03f24ce63d05af53420dae2c80614cf81a3b,1,4,3,7,4,2009-01-05 02:45:20,2009-01-05 02:45:20
558d03f24ce63d05af53420dae2c80614cf81a3b...e216243a03d13d659f9811ef20ede3b213fd33f1,1,17,12,29,6,2009-01-05 12:05:38,2009-01-05 12:05:38
e216243a03d13d659f9811ef20ede3b213fd33f1...0c1653249a4a62a05290fa21e9cefd118bcce72a,1,1,0,1,1,2009-01-05 12:09:04,2009-01-05 12:09:04
0c1653249a4a62a05290fa21e9cefd118bcce72a...42c99472cc5718d90a129f6ebb10ea45d5816418,1,9,11,20,2,2009-01-05 13:31:21,2009-01-05 13:31:21
42c99472cc5718d90a129f6ebb10ea45d5816418...122b672f704cca094de50dfef05e88faa84cb51d,5,84,2,86,6,2009-01-05 17:34:42,2009-01-05 17:34:42
122b672f704cca094de50dfef05e88faa84cb51d...ebd9205fdb7f14b98301c4c183e9d6a51420ad0e,1,3,3,6,2,2009-01-05 19:22:25,2009-01-05 19:22:25
ebd9205fdb7f14b98301c4c183e9d6a51420ad0e...69e86d4f98a362d3834adf1bf4c32ed8e433f135,1,2,2,4,2,2009-01-05 20:43:24,2009-01-05 20:43:24
69e86d4f98a362d3834adf1bf4c32ed8e433f135...f796ad14fd1edf06caa28e19b38934ab54691d58,1,2,2,4,2,2009-01-05 20:43:58,2009-01-05 20:43:58
f796ad14fd1edf06caa28e19b38934ab54691d58...c6de039bb1568d8e6162b8152b8208eff1af282d,1,4,3,7,1,2009-01-05 21:04:15,2009-01-05 21:04:15
c6de039bb1568d8e6162b8152b8208eff1af282d...d3141dcdba883ef87c8cd0b51a1ff9b61d153ffa,1,6,4,10,1,2009-01-05 21:56:35,2009-01-05 21:56:35
d3141dcdba883ef87c8cd0b51a1ff9b61d153ffa...089da4ea777ed5c30dfc835b70b953c86943d62e,1,1,1,2,1,2009-01-05 21:59:07,2009-01-05 21:59:07
089da4ea777ed5c30dfc835b70b953c86943d62e...4503457616372973054a85c1628031792a4882f3,1,1,1,2,1,2009-01-05 22:02:20,2009-01-05 22:02:20
4503457616372973054a85c1628031792a4882f3...60226c8a30df9c1d41093de586e5936e42d44865,1,1,1,2,1,2009-01-05 22:05:59,2009-01-05 22:05:59
60226c8a30df9c1d41093de586e5936e42d44865...45b3a884d55ce6004f7cec3fd27b42198b147ceb,1,2,0,2,2,2009-01-05 22:14:26,2009-01-05 22:14:26
45b3a884d55ce6004f7cec3fd27b42198b147ceb...18229390005fc3aa43e290ae53eb3775f3ff10cb,1,5,16,21,3,2009-01-05 22:58:02,2009-01-05 22:58:02
18229390005fc3aa43e290ae53eb3775f3ff10cb...b1e161466cb7f68bc7447ffd580395764715d9ca,1,3,1,4,1,2009-01-05 23:06:57,2009-01-05 23:06:57
b1e161466cb7f68bc7447ffd580395764715d9ca...2a81c359d5a45ecaf2dcbc736c8fcdb257a72432,1,1,1,2,1,2009-01-05 23:19:58,2009-01-05 23:19:58
2a81c359d5a45ecaf2dcbc736c8fcdb257a72432...c786f1097ee26095f2f7eb721a450c550775ba84,1,1,1,2,1,2009-01-05 23:33:56,2009-01-05 23:33:56
c786f1097ee26095f2f7eb721a450c550775ba84...cc70e03ec7387aaab5f1e090fde2a3faeb001ba6,1,10,6,16,2,2009-01-06 16:17:50,2009-01-06 16:17:50
cc70e03ec7387aaab5f1e090fde2a3faeb001ba6...dcbec1f498da51bdb80253dd8d175548e72cfcfa,3,1705,4142,5847,496,2009-01-06 16:19:55,2009-01-06 16:19:55
dcbec1f498da51bdb80253dd8d175548e72cfcfa...ef661a50b9c03b922fa2269ec8f5bfbac09d93a4,1,5,7,12,4,2009-01-06 20:23:44,2009-01-06 20:23:44
ef661a50b9c03b922fa2269ec8f5bfbac09d93a4...d8706c5ac95a0e17ac0bb84d5ff3ee7a6eb38161,2,59,26,85,13,2009-01-07 00:13:57,2009-01-07 00:13:57
d8706c5ac95a0e17ac0bb84d5ff3ee7a6eb38161...f9e0b1ed7a5f252bb58aba9bdfb96653af2b4c1b,1,1,1,2,1,2009-01-07 14:31:28,2009-01-07 14:31:28
f9e0b1ed7a5f252bb58aba9bdfb96653af2b4c1b...49d0d5b7a3628947a14028d14ed042746cc6c3e4,3,17,17,34,7,2009-01-07 14:36:30,2009-01-07 14:36:30
49d0d5b7a3628947a14028d14ed042746cc6c3e4...c6f189ac73939c813bf3a2b848c492c8ba259807,2,12,1,13,3,2009-01-08 21:41:58,2009-01-08 21:41:58
c6f189ac73939c813bf3a2b848c492c8ba259807...6898cd6d2a8d515941032ddb806d3cbabd2d2506,1,3,3,6,2,2009-01-08 22:21:16,2009-01-08 22:21:16
6898cd6d2a8d515941032ddb806d3cbabd2d2506...eced38a30d21d025db3e219f3cce7239754316d8,1,66,37,103,2,2009-01-08 22:22:33,2009-01-08 22:22:33
eced38a30d21d025db3e219f3cce7239754316d8...d12e8a34e6d96f98ac4f9408a0d61a9ed373f917,2,35,8,43,7,2009-01-09 22:10:42,2009-01-09 22:10:42
d12e8a34e6d96f98ac4f9408a0d61a9ed373f917...ec7baf230d3c246dadf00c94115e6668425b9354,2,17,4,21,5,2009-01-09 22:14:48,2009-01-09 22:14:48
ec7baf230d3c246dadf00c94115e6668425b9354...d62875fb0181c44f8b34a8e842ae323801637b25,7,108,125,233,50,2009-01-09 23:49:18,2009-01-09 23:49:18
d62875fb0181c44f8b34a8e842ae323801637b25...afb05081c013bdd38e0dc8ac1c99bbb9f5a00559,6,54,30,84,28,2009-01-10 00:16:48,2009-01-10 00:16:48
afb05081c013bdd38e0dc8ac1c99bbb9f5a00559...29bf601f3495ced43fbb6152bf9306f2618bb955,2,5,2,7,3,2009-01-10 01:07:59,2009-01-10 01:07:59
29bf601f3495ced43fbb6152bf9306f2618bb955...b1018cad1256a7b9cc47e675b2a9e22c409b7aed,2,27,5,32,6,2009-01-10 19:57:07,2009-01-10 19:57:07
b1018cad1256a7b9cc47e675b2a9e22c409b7aed...0066ba3f823fdf3e41aa805f54876312c8bd915a,2,7,2,9,4,2009-01-10 20:30:03,2009-01-10 20:30:03
0066ba3f823fdf3e41aa805f54876312c8bd915a...7346a476cc1fe20612fb1e9b08faef27e36a962c,3,14,5,19,5,2009-01-11 16:17:20,2009-01-11 16:17:20
7346a476cc1fe20612fb1e9b08faef27e36a962c...9d997a81e298622ae4c2ef97c0646eabaa0d3164,1,1,1,2,2,2009-01-11 16:19:11,2009-01-11 16:19:11
9d997a81e298622ae4c2ef97c0646eabaa0d3164...73ff49ac9a3a6d049557394062e3ad915bb04ef1,2,6,2,8,3,2009-01-11 19:33:01,2009-01-11 19:33:01
73ff49ac9a3a6d049557394062e3ad915bb04ef1...2e42c5b0445b7c871c67b0a3bb7a0dc42d1d2112,1,36,29,65,17,2009-01-11 19:45:04,2009-01-11 19:45:04
2e42c5b0445b7c871c67b0a3bb7a0dc42d1d2112...fa615bedd47bd8a4b11e8490e26d2c89d1d86e2a,1,1,1,2,1,2009-01-11 21:22:37,2009-01-11 21:22:37
fa615bedd47bd8a4b11e8490e26d2c89d1d86e2a...1eae1541b8b4ca054d63d48f07001f55fa52fa5d,1,2,0,2,1,2009-01-12 00:24:16,2009-01-12 00:24:16
1eae1541b8b4ca054d63d48f07001f55fa52fa5d...762370256520c5356fdce8ba07acf7f404e83025,1,1,1,2,1,2009-01-12 00:24:36,2009-01-12 00:24:36
762370256520c5356fdce8ba07acf7f404e83025...aa29b8e3bcb76184698d9e4e8609c6b40b6fb4ee,1,8,28,36,20,2009-01-12 01:12:58,2009-01-12 01:12:58
aa29b8e3bcb76184698d9e4e8609c6b40b6fb4ee...869afc46cd8229f41d82380f01830dd59a0084f7,1,1,1,2,1,2009-01-12 02:05:50,2009-01-12 02:05:50
869afc46cd8229f41d82380f01830dd59a0084f7...af1b9994a41e04a377e42bbe756851f5fff61097,1,1,1,2,1,2009-01-12 02:08:37,2009-01-12 02:08:37
af1b9994a41e04a377e42bbe756851f5fff61097...0c97178553606c01b999441836e23f9f36c645a3,2,4,2,6,3,2009-01-12 14:00:35,2009-01-12 14:00:35
0c97178553606c01b999441836e23f9f36c645a3...ea7837776022fe9f2ccdf00ede30728e6f24d919,2,21,14,35,4,2009-01-12 14:07:14,2009-01-12 14:07:14
ea7837776022fe9f2ccdf00ede30728e6f24d919...95094d16858f872ccf99ac50f605a88fbdcbe1bc,1,4,0,4,2,2009-01-12 14:45:58,2009-01-12 14:45:58
95094d16858f872ccf99ac50f605a88fbdcbe1bc...944484c3fe001bcfea52fd85612042d7475597a1,1,2,2,4,2,2009-01-12 16:02:55,2009-01-12 16:02:55
944484c3fe001bcfea52fd85612042d7475597a1...9c029f1687d87abd52dca1cc2a5ecdb01895d6de,2,41,457,498,4,2009-01-12 18:22:44,2009-01-12 18:22:44
9c029f1687d87abd52dca1cc2a5ecdb01895d6de...d5858c7cb82ba08b4a4e304ebdd684a957d47f13,1,1,1,2,1,2009-01-13 15:08:11,2009-01-13 15:08:11
d5858c7cb82ba08b4a4e304ebdd684a957d47f13...6dc30ae7f60c44dd83dfb19da61957b20324eb9e,3,47,16,63,22,2009-01-13 16:40:19,2009-01-13 16:40:19
6dc30ae7f60c44dd83dfb19da61957b20324eb9e...9988e3877b1308b73ace985f243d47b21fd2ae05,1,1,1,2,1,2009-01-13 17:50:31,2009-01-13 17:50:31
9988e3877b1308b73ace985f243d47b21fd2ae05...263efad50f167fc08a8334f22d68af50040790a7,1,1,1,2,1,2009-01-13 17:52:45,2009-01-13 17:52:45
263efad50f167fc08a8334f22d68af50040790a7...9155d298ae8738ece29d4b2edfd32c578aebb27a,1,0,22,22,1,2009-01-14 22:42:21,2009-01-14 22:42:21
9155d298ae8738ece29d4b2edfd32c578aebb27a...82958c79ff7604b1854a58cf161e8d6691bed6ac,1,1,1,2,1,2009-01-14 22:42:55,2009-01-14 22:42:55
82958c79ff7604b1854a58cf161e8d6691bed6ac...f649acd8abcd3ccd86de331737f42d0d85efbc0c,2,108,0,108,3,2009-01-14 22:43:55,2009-01-14 22:43:55
f649acd8abcd3ccd86de331737f42d0d85efbc0c...34a9f8a210cfa0aabccc40a974646127d1871d1a,2,39,10,49,7,2009-01-14 23:09:52,2009-01-14 23:09:52
34a9f8a210cfa0aabccc40a974646127d1871d1a...c2fad371f1eb9e3204f5901d1dca056bbe4f389f,1,1,1,2,1,2009-01-17 22:04:23,2009-01-17 22:04:23
c2fad371f1eb9e3204f5901d1dca056bbe4f389f...f3e5e9a3d58020ac2727dde78e18a8b8ad42d7d7,1,1,1,2,1,2009-01-17 22:25:18,2009-01-17 22:25:18
f3e5e9a3d58020ac2727dde78e18a8b8ad42d7d7...2f536b3d4d6864994cc88ea72638e06609bc12d1,2,2,8,10,3,2009-01-18 13:04:32,2009-01-18 13:04:32
2f536b3d4d6864994cc88ea72638e06609bc12d1...cde93dc547dc5f65df86a3da036677aa53e660e2,2,17,0,17,2,2009-01-18 13:30:09,2009-01-18 13:30:09
cde93dc547dc5f65df86a3da036677aa53e660e2...8e8d7ade434de3d79cc6145f370866f297a07b54,3,68,46,114,20,2009-01-19 18:09:11,2009-01-19 18:09:11
8e8d7ade434de3d79cc6145f370866f297a07b54...1d513efd3c399800b42902cf920ad83be233276c,1,5,0,5,1,2009-01-19 18:14:51,2009-01-19 18:14:51
1d513efd3c399800b42902cf920ad83be233276c...d6e541426d10b335fa3b6b481ae591ede977c480,1,2,2,4,1,2009-01-19 18:56:02,2009-01-19 18:56:02
d6e541426d10b335fa3b6b481ae591ede977c480...96152559e0e2fa1afc70f8994e664f5805aebad5,3,22,18,40,6,2009-01-19 21:40:23,2009-01-19 21:40:23
96152559e0e2fa1afc70f8994e664f5805aebad5...82e8d11c12f160fbf07a8faef5931c2f7a364a6a,1,2,2,4,1,2009-01-19 21:57:18,2009-01-19 21:57:18
82e8d11c12f160fbf07a8faef5931c2f7a364a6a...735d44f6df67767bc04a0f135ffad0369f71a26f,1,3,3,6,2,2009-01-19 22:20:25,2009-01-19 22:20:25
735d44f6df67767bc04a0f135ffad0369f71a26f...679998283570ce9fbbe310a9f37169c20e871ef4,1,1,1,2,1,2009-01-19 23:04:03,2009-01-19 23:04:03
679998283570ce9fbbe310a9f37169c20e871ef4...04977b8ea2f9cbf786ae244a8b47aed67e37df7f,1,2,2,4,1,2009-01-19 23:17:30,2009-01-19 23:17:30
04977b8ea2f9cbf786ae244a8b47aed67e37df7f...9db710a15665f0fa32e3e3b20a65c3ad94966f8e,1,5,5,10,4,2009-01-19 23:22:25,2009-01-19 23:22:25
9db710a15665f0fa32e3e3b20a65c3ad94966f8e...4e7d565e50b4705f1daed7100937591330af34c4,1,2,2,4,1,2009-01-19 23:33:46,2009-01-19 23:33:46
4e7d565e50b4705f1daed7100937591330af34c4...7647cebc3929337d1e77069c8620158dcf84ff20,1,1,1,2,1,2009-01-20 15:46:40,2009-01-20 15:46:40
7647cebc3929337d1e77069c8620158dcf84ff20...28a1f022233585cf40ae727d7d8334665a495e61,2,14,14,28,4,2009-01-20 16:00:48,2009-01-20 16:00:48
28a1f022233585cf40ae727d7d8334665a495e61...a78557472ce1c2cdf7db01a13fcc8591f3fdcfb0,2,12,4,16,3,2009-01-20 17:25:37,2009-01-20 17:25:37
a78557472ce1c2cdf7db01a13fcc8591f3fdcfb0...cd28922b78a91c530c509638294fe3fac9c361f3,2,7,3,10,4,2009-01-20 17:33:25,2009-01-20 17:33:25
cd28922b78a91c530c509638294fe3fac9c361f3...aa7616cf9aac1692a483165144a42cde9a3169e0,3,16,4,20,6,2009-01-20 19:44:08,2009-01-20 19:44:08
aa7616cf9aac1692a483165144a42cde9a3169e0...0468e31bf703815f2d145877280b71e9eadaf6f0,1,5,4,9,2,2009-01-20 19:47:15,2009-01-20 19:47:15
0468e31bf703815f2d145877280b71e9eadaf6f0...db10da345e84e86d66a613e33e97916a7facb94f,1,1,1,2,1,2009-01-20 19:58:19,2009-01-20 19:58:19
db10da345e84e86d66a613e33e97916a7facb94f...00b70c75278896495365e25f0327af4a1b61acce,1,5,8,13,2,2009-01-21 21:46:53,2009-01-21 21:46:53
00b70c75278896495365e25f0327af4a1b61acce...626961c4a54cccaae0ecef81f2058cd0888611cc,2,10,2,12,3,2009-01-21 22:01:50,2009-01-21 22:01:50
626961c4a54cccaae0ecef81f2058cd0888611cc...9b3804a8eca6ce04dd48fbfcc157c8d176a25397,2,3,2,5,3,2009-01-21 22:36:21,2009-01-21 22:36:21
9b3804a8eca6ce04dd48fbfcc157c8d176a25397...f9a584972365bda0631116ec6fe07df9b6f9c372,3,19,23,42,8,2009-01-21 22:57:07,2009-01-21 22:57:07
f9a584972365bda0631116ec6fe07df9b6f9c372...7d9d2105406fe7fcdc196df860ca155c3e4c8453,2,15,9,24,7,2009-01-21 23:19:30,2009-01-21 23:19:30
7d9d2105406fe7fcdc196df860ca155c3e4c8453...d45f19394866c3006b5cca733d31417395b703e6,2,5,3,8,2,2009-01-21 23:31:29,2009-01-21 23:31:29
d45f19394866c3006b5cca733d31417395b703e6...58a17e6e6d57d0ba71acfcb36f7da4fcacfbeeae,1,1,1,2,1,2009-01-21 23:33:01,2009-01-21 23:33:01
58a17e6e6d57d0ba71acfcb36f7da4fcacfbeeae...68b49cf4273ce500e2666616771e2731c6833bca,1,4,4,8,3,2009-01-21 23:56:15,2009-01-21 23:56:15
68b49cf4273ce500e2666616771e2731c6833bca...b438d8391613d4f66f2c2bbaa89b944b93f3c9ee,1,1,1,2,1,2009-01-22 00:11:11,2009-01-22 00:11:11
b438d8391613d4f66f2c2bbaa89b944b93f3c9ee...5143ecbc58cb669095b0c53ca355e00aea988db5,1,1,1,2,1,2009-01-22 00:29:04,2009-01-22 00:29:04
5143ecbc58cb669095b0c53ca355e00aea988db5...8b79ea13656727e2449807a812dd0fd8c2783aad,1,1,1,2,1,2009-01-22 00:30:13,2009-01-22 00:30:13
8b79ea13656727e2449807a812dd0fd8c2783aad...2ff3e49279744ecd099693fa5b7faeb14ca301d8,1,1,1,2,1,2009-01-22 01:42:16,2009-01-22 01:42:16
2ff3e49279744ecd099693fa5b7faeb14ca301d8...d1a34f79081dfcfcfe851412dafd172428a6d92a,1,2,1,3,1,2009-01-23 19:36:59,2009-01-23 19:36:59
d1a34f79081dfcfcfe851412dafd172428a6d92a...ce00f88ae20b3b569138435c6dd87f44bf5d2be0,1,1,1,2,1,2009-01-28 22:38:00,2009-01-28 22:38:00
ce00f88ae20b3b569138435c6dd87f44bf5d2be0...2b7642cff025be3b8ac019ae77f2f19ecd07fa87,2,28,4,32,6,2009-02-07 16:54:11,2009-02-07 16:54:11
2b7642cff025be3b8ac019ae77f2f19ecd07fa87...a894c604895efb29e9b0937301cc404ad72e1738,1,3,0,3,1,2009-02-07 16:57:59,2009-02-07 16:57:59
a894c604895efb29e9b0937301cc404ad72e1738...31597b7b3ce7737ead61eec55d9f66b9e9836cf7,1,2,3,5,2,2009-02-07 17:15:01,2009-02-07 17:15:01
31597b7b3ce7737ead61eec55d9f66b9e9836cf7...f38648c7cd3a37f4070b77b2c92151f68aa66fef,2,5,2,7,3,2009-02-07 17:41:30,2009-02-07 17:41:30
f38648c7cd3a37f4070b77b2c92151f68aa66fef...ce90accc58d213fcf567ab2ca464ee9164601dc4,2,50,21,71,9,2009-02-09 14:48:15,2009-02-09 14:48:15
ce90accc58d213fcf567ab2ca464ee9164601dc4...ab74ce7b57f2baa297723416573c2cf6ca67f936,1,1,1,2,1,2009-02-09 15:01:23,2009-02-09 15:01:23
ab74ce7b57f2baa297723416573c2cf6ca67f936...b16da9d762c5fc87c5a9afacd517af0036972a47,2,19,3,22,4,2009-02-09 15:18:07,2009-02-09 15:18:07
b16da9d762c5fc87c5a9afacd517af0036972a47...6b938e1c162877ee62681f8aefe6f64ba208eead,1,1,3,4,1,2009-02-09 15:35:33,2009-02-09 15:35:33
6b938e1c162877ee62681f8aefe6f64ba208eead...136a459f4c24880f6d07f26c07e56451385637e0,1,5,4,9,3,2009-02-09 15:41:50,2009-02-09 15:41:50
136a459f4c24880f6d07f26c07e56451385637e0...0ae78024c23dd3ef4bcea883338d975dcf843597,1,13,1,14,3,2009-02-09 15:58:12,2009-02-09 15:58:12
0ae78024c23dd3ef4bcea883338d975dcf843597...9aa0c69c43bad9fce5ef7732692308afb2a38ec6,5,43,7,50,12,2009-02-09 23:29:57,2009-02-09 23:29:57
9aa0c69c43bad9fce5ef7732692308afb2a38ec6...831b15b06c338096c751a90354bbd53241485b12,1,76,65,141,20,2009-02-10 00:28:38,2009-02-10 00:28:38
831b15b06c338096c751a90354bbd53241485b12...7f1eb1c14fdf9a5d149c907df9e331cbecfa9720,1,2,1,3,2,2009-02-13 16:15:23,2009-02-13 16:15:23
7f1eb1c14fdf9a5d149c907df9e331cbecfa9720...848c45ea17cc03bcabd7ab882359e1c62f9485f5,2,22,17,39,10,2009-02-13 22:58:57,2009-02-13 22:58:57
848c45ea17cc03bcabd7ab882359e1c62f9485f5...e16c7fe0f8e2998d2e3ca1bc8f0794c43b29526f,2,42,2,44,5,2009-02-14 16:59:10,2009-02-14 16:59:10
e16c7fe0f8e2998d2e3ca1bc8f0794c43b29526f...7421f342840947a746aa6be944221e931e3556cc,1,1,1,2,1,2009-02-14 17:06:30,2009-02-14 17:06:30
7421f342840947a746aa6be944221e931e3556cc...868f262eed36c7f562f783e4cefb06db075b5e78,1,5,4,9,2,2009-02-14 17:13:08,2009-02-14 17:13:08
868f262eed36c7f562f783e4cefb06db075b5e78...d75c899fe78c52d89e5fb757ded979aca126d37b,1,3,7,10,3,2009-02-14 17:25:33,2009-02-14 17:25:33
d75c899fe78c52d89e5fb757ded979aca126d37b...6f4b08cdf9cb334f8531fe06a20153defb7f95b6,3,17,3,20,5,2009-02-14 18:10:45,2009-02-14 18:10:45
6f4b08cdf9cb334f8531fe06a20153defb7f95b6...782b4af76ec080aad93d5c4a15fbc805f3e5960e,1,5,13,18,3,2009-02-14 22:18:02,2009-02-14 22:18:02
782b4af76ec080aad93d5c4a15fbc805f3e5960e...21dde30348fe9bcbd8db8c1b30e470a9e2f39c16,3,8,5,13,4,2009-02-14 22:24:55,2009-02-14 22:24:55
21dde30348fe9bcbd8db8c1b30e470a9e2f39c16...87b3ea4bc982513dc11a4bccc6cb73f043ad39bd,1,3,1,4,2,2009-02-15 18:09:34,2009-02-15 18:09:34
87b3ea4bc982513dc11a4bccc6cb73f043ad39bd...f9a7cfacf7d609620fd5ce8a939268e93ef423a1,1,12,2,14,4,2009-02-15 18:20:01,2009-02-15 18:20:01
f9a7cfacf7d609620fd5ce8a939268e93ef423a1...20827707a94c8569bcc422f71bf5b37bc55695df,2,18,4,22,4,2009-02-15 21:13:33,2009-02-15 21:13:33
20827707a94c8569bcc422f71bf5b37bc55695df...22c9c9b9d31933a3615892a3796f5d9d75bac104,2,16,2,18,3,2009-02-15 22:33:19,2009-02-15 22:33:19
22c9c9b9d31933a3615892a3796f5d9d75bac104...f0189d618181409ac628b9bbdecd77338127b9b1,3,5,2,7,4,2009-02-15 22:46:54,2009-02-15 22:46:54
f0189d618181409ac628b9bbdecd77338127b9b1...5586fedf2932dc17b303c860d9f0a7604223f865,2,22,10,32,10,2009-02-16 15:36:42,2009-02-16 15:36:42
5586fedf2932dc17b303c860d9f0a7604223f865...e25c4a132f9f11cb407605e3ca7d1900ca904077,2,8,9,17,4,2009-02-16 15:52:15,2009-02-16 15:52:15
e25c4a132f9f11cb407605e3ca7d1900ca904077...a720bb31ab32c5629607a471e4674fd11e05b97c,1,2,2,4,2,2009-02-16 15:55:06,2009-02-16 15:55:06
a720bb31ab32c5629607a471e4674fd11e05b97c...8533da939d933561aa6c516db4e544dba076a988,2,22,21,43,5,2009-02-16 17:58:33,2009-02-16 17:58:33
8533da939d933561aa6c516db4e544dba076a988...048fc4555f8a794239a985c63cff3f76d20d6c61,5,22,12,34,13,2009-02-16 18:23:59,2009-02-16 18:23:59
048fc4555f8a794239a985c63cff3f76d20d6c61...f93df73a76b60ce3459113582125adbafcb9614f,1,1,1,2,1,2009-02-16 18:25:37,2009-02-16 18:25:37
f93df73a76b60ce3459113582125adbafcb9614f...72cf42bcbd4f7dc351d313c65d8bce113981d159,1,5,5,10,2,2009-02-16 21:20:51,2009-02-16 21:20:51
72cf42bcbd4f7dc351d313c65d8bce113981d159...0a1b0db347119a2e45d3d31285223ead27b64506,2,16,1,17,2,2009-02-17 12:38:16,2009-02-17 12:38:16
0a1b0db347119a2e45d3d31285223ead27b64506...63f8bb7027ea7bf4e5c111cb3e440f9bb3e87733,1,3,0,3,1,2009-02-17 12:42:46,2009-02-17 12:42:46
63f8bb7027ea7bf4e5c111cb3e440f9bb3e87733...6bd6a4e059f98782b19f3a6e43671a6b6be438e0,1,5,5,10,1,2009-02-17 13:57:28,2009-02-17 13:57:28
6bd6a4e059f98782b19f3a6e43671a6b6be438e0...ad7577a084136c48c1544e4831b1d7e69dc55f2a,1,11,23,34,10,2009-02-17 14:05:25,2009-02-17 14:05:25
ad7577a084136c48c1544e4831b1d7e69dc55f2a...10ab08de439130ead59d6cc1c31917f2869f923f,1,5,5,10,1,2009-02-17 14:08:11,2009-02-17 14:08:11
10ab08de439130ead59d6cc1c31917f2869f923f...7b5cfb78ec1f04cbab9c06e66c858426b6c7dfa7,1,2,2,4,2,2009-02-17 14:13:39,2009-02-17 14:13:39
7b5cfb78ec1f04cbab9c06e66c858426b6c7dfa7...f89f5eb61f6b19cc2204ddbe2abc797f7ee14cfd,3,23,22,45,4,2009-02-17 15:54:27,2009-02-17 15:54:27
f89f5eb61f6b19cc2204ddbe2abc797f7ee14cfd...f20c974644e2bee801f3ceb1042392e6a50e5d35,1,4,4,8,3,2009-02-17 15:58:11,2009-02-17 15:58:11
f20c974644e2bee801f3ceb1042392e6a50e5d35...4a4d049df9be6d0df5a331cb08d7b95564bc5ee2,1,1,1,2,1,2009-02-17 16:22:41,2009-02-17 16:22:41
4a4d049df9be6d0df5a331cb08d7b95564bc5ee2...80782d958c63bf9a6c5e602e1dc945ae1df20e83,1,5,5,10,5,2009-02-17 16:39:33,2009-02-17 16:39:33
80782d958c63bf9a6c5e602e1dc945ae1df20e83...8d9aa015c18e85f1f0aee1159e7928183483a5fd,1,1,3,4,2,2009-02-17 17:22:59,2009-02-17 17:22:59
8d9aa015c18e85f1f0aee1159e7928183483a5fd...4b7e1c906f497784329622d82da08c8646cae7e6,2,12,4,16,4,2009-02-17 17:43:05,2009-02-17 17:43:05
4b7e1c906f497784329622d82da08c8646cae7e6...d8b3bd700fe131d8b1dc381163abc6386a90501e,1,9,7,16,4,2009-02-17 17:51:50,2009-02-17 17:51:50
d8b3bd700fe131d8b1dc381163abc6386a90501e...b1a40c9bfdbbfce5416e4dfa52577379bdcc0a74,1,1,1,2,1,2009-02-17 21:56:13,2009-02-17 21:56:13
b1a40c9bfdbbfce5416e4dfa52577379bdcc0a74...1a65eb2a09db9a162f8ec5eb11de40c59e9b350a,1,1,1,2,1,2009-02-17 21:56:42,2009-02-17 21:56:42
1a65eb2a09db9a162f8ec5eb11de40c59e9b350a...b536d2ac67077aa45ed5d72bd702dab3c81e5d28,1,18,16,34,8,2009-02-17 22:15:42,2009-02-17 22:15:42
b536d2ac67077aa45ed5d72bd702dab3c81e5d28...1ac087f6f90eb41fe79d46b7e1f09cc7e2125670,1,10,7,17,3,2009-02-17 22:22:05,2009-02-17 22:22:05
1ac087f6f90eb41fe79d46b7e1f09cc7e2125670...3e46bce751f062775be95a6bef3cf53096a3ed21,1,1,1,2,1,2009-02-18 02:40:55,2009-02-18 02:40:55
3e46bce751f062775be95a6bef3cf53096a3ed21...75a973da35d4ad6583ebef8c389cebbef61bc5b4,2,35,11,46,6,2009-02-18 16:29:43,2009-02-18 16:29:43
75a973da35d4ad6583ebef8c389cebbef61bc5b4...ca79d866fe07302f03df2b3db09c886c6abef9ff,4,9,8,17,9,2009-02-18 19:43:14,2009-02-18 19:43:14
ca79d866fe07302f03df2b3db09c886c6abef9ff...481171a3f81c46b9e46ffbf76a5cddcec83be850,1,6,6,12,4,2009-02-18 19:59:51,2009-02-18 19:59:51
481171a3f81c46b9e46ffbf76a5cddcec83be850...3e6c7f083c6fe2b93517153c81472604fc7bd745,1,1,1,2,1,2009-02-18 21:57:46,2009-02-18 21:57:46
3e6c7f083c6fe2b93517153c81472604fc7bd745...2a600c13efd4c6367402ae51f1e9d819585eda7d,1,8,5,13,5,2009-02-19 21:30:25,2009-02-19 21:30:25
2a600c13efd4c6367402ae51f1e9d819585eda7d...db8623ebc83b26d1862248083f51bb6ecc0c596b,1,1,1,2,1,2009-02-19 21:35:33,2009-02-19 21:35:33
db8623ebc83b26d1862248083f51bb6ecc0c596b...fef476def30f4b1f3cfa902fff11bb761ab6ecfd,1,1,1,2,1,2009-02-19 22:34:21,2009-02-19 22:34:21
fef476def30f4b1f3cfa902fff11bb761ab6ecfd...db62240fcfe5636393fd3838fbb5ab62c363ad31,1,1,1,2,1,2009-02-19 22:41:33,2009-02-19 22:41:33
db62240fcfe5636393fd3838fbb5ab62c363ad31...a37ca9e9058243169725982e91bce60801b9857d,2,5,2,7,3,2009-02-20 19:45:29,2009-02-20 19:45:29
a37ca9e9058243169725982e91bce60801b9857d...883450b702d7818088ad1498473546d924a858de,1,2,3,5,3,2009-02-20 19:52:38,2009-02-20 19:52:38
883450b702d7818088ad1498473546d924a858de...48164ee603bc4ec17f2fb72571c531ebdc7213ae,2,13,1,14,3,2009-02-23 13:27:48,2009-02-23 13:27:48
48164ee603bc4ec17f2fb72571c531ebdc7213ae...cb3f842c8889458d96511b0103ebbff5cbac217d,1,21,8,29,6,2009-02-23 16:32:45,2009-02-23 16:32:45
cb3f842c8889458d96511b0103ebbff5cbac217d...9c0ddfa2ad14388ba8ff138b96966e993308f6cf,1,36,23,59,12,2009-02-25 04:08:04,2009-02-25 04:08:04
9c0ddfa2ad14388ba8ff138b96966e993308f6cf...041fd5f2b52bb5c5dbb9ddbd6fffcc89fdbfe638,1,27,9,36,10,2009-02-25 04:57:00,2009-02-25 04:57:00
041fd5f2b52bb5c5dbb9ddbd6fffcc89fdbfe638...85e0945718dd8108577b7b4b5b3c86def3bfb17c,1,18,21,39,12,2009-02-25 14:23:25,2009-02-25 14:23:25
85e0945718dd8108577b7b4b5b3c86def3bfb17c...1c5db3babaf32f6faa7e9e867990110c9713f64b,1,13,10,23,4,2009-02-25 15:19:08,2009-02-25 15:19:08
1c5db3babaf32f6faa7e9e867990110c9713f64b...4bbb70b4eb0bcd93c99c0bfcfcf4fc44504c4c41,2,7,4,11,2,2009-02-25 15:37:09,2009-02-25 15:37:09
4bbb70b4eb0bcd93c99c0bfcfcf4fc44504c4c41...f094c803deba3c35c66f9dc0923db800fb088753,1,18,10,28,3,2009-02-25 18:29:18,2009-02-25 18:29:18
f094c803deba3c35c66f9dc0923db800fb088753...58235cc38ea835cde0ae90dd2919b86e47f3dd05,2,13,15,28,10,2009-02-25 18:41:29,2009-02-25 18:41:29
58235cc38ea835cde0ae90dd2919b86e47f3dd05...410e13b40097fa6b26ce9a27f865ff258efa23b4,1,1,1,2,1,2009-02-26 01:15:54,2009-02-26 01:15:54
410e13b40097fa6b26ce9a27f865ff258efa23b4...985856b823b1648bffc3fd63c1faf836d0ddaf7c,3,7,7,14,7,2009-02-26 18:00:41,2009-02-26 18:00:41
985856b823b1648bffc3fd63c1faf836d0ddaf7c...1c8c3883a98d7d896efefe92eb0d22b1681e92f1,1,3,4,7,1,2009-02-27 15:20:59,2009-02-27 15:20:59
1c8c3883a98d7d896efefe92eb0d22b1681e92f1...f1f5cd9f6a80b0de18cc0402f28b440f48b95f83,2,29,34,63,10,2009-02-28 20:23:48,2009-02-28 20:23:48
f1f5cd9f6a80b0de18cc0402f28b440f48b95f83...6914fc29690d0d4ff7fa7ef2dd7862ef34e9aeb5,1,1,6,7,2,2009-02-28 20:28:45,2009-02-28 20:28:45
6914fc29690d0d4ff7fa7ef2dd7862ef34e9aeb5...ece001f1394aeddcfe061dcba224726173325220,1,1,1,2,1,2009-03-05 13:36:12,2009-03-05 13:36:12
ece001f1394aeddcfe061dcba224726173325220...2d4755a0fb1e34cc81d142415ed0ddf3791cf724,1,3,5,8,4,2009-03-06 04:23:44,2009-03-06 04:23:44
2d4755a0fb1e34cc81d142415ed0ddf3791cf724...26731d475bded26fb1323d4f33266f503474d4b8,2,17,15,32,12,2009-03-17 20:39:29,2009-03-17 20:39:29
26731d475bded26fb1323d4f33266f503474d4b8...36b4a9ba33b22b2394a1b190b0b4ade1be6d0b02,1,11,10,21,6,2009-03-17 20:43:46,2009-03-17 20:43:46
36b4a9ba33b22b2394a1b190b0b4ade1be6d0b02...a37cccc8827619cfbd76e229af9de2529041ee5b,1,29,29,58,4,2009-03-17 20:50:17,2009-03-17 20:50:17
a37cccc8827619cfbd76e229af9de2529041ee5b...aabf635cfe9b75fce3d96eb3e40e25f4a29ea99b,2,11,16,27,7,2009-03-17 21:07:11,2009-03-17 21:07:11
aabf635cfe9b75fce3d96eb3e40e25f4a29ea99b...e73990a566fcb2dac71e1a25ec83382645adc5b7,3,13,3,16,4,2009-03-17 22:27:25,2009-03-17 22:27:25
e73990a566fcb2dac71e1a25ec83382645adc5b7...ace13387c8d7b5823a580db0f1b2aafac515b9f5,1,3,3,6,3,2009-03-18 02:48:32,2009-03-18 02:48:32
ace13387c8d7b5823a580db0f1b2aafac515b9f5...62a251a0cf8b8652082da3d5a72b6c6e2b120914,1,2,1,3,1,2009-03-18 14:58:06,2009-03-18 14:58:06
62a251a0cf8b8652082da3d5a72b6c6e2b120914...2c31a1624f72df3987cd1d0d3605c359658986e5,2,17,2,19,3,2009-03-18 17:55:07,2009-03-18 17:55:07
2c31a1624f72df3987cd1d0d3605c359658986e5...7c04a64016c1f295dfdf4e731f693f8400a987bc,12,2221,2200,4421,18,2009-03-18 21:15:38,2009-03-18 21:15:38
7c04a64016c1f295dfdf4e731f693f8400a987bc...c0cdbf8b946effc4906b4cc96eaf01679b2e6736,1,6,1,7,3,2009-03-19 02:54:57,2009-03-19 02:54:57
c0cdbf8b946effc4906b4cc96eaf01679b2e6736...10303c37a152fe524f28d9ec7de140e82c60eb11,1,3,4,7,4,2009-03-19 03:17:38,2009-03-19 03:17:38
10303c37a152fe524f28d9ec7de140e82c60eb11...dae96f552e7ec4ddef52f86c61de18320a7b63ed,1,3,0,3,1,2009-03-19 15:16:02,2009-03-19 15:16:02
dae96f552e7ec4ddef52f86c61de18320a7b63ed...30e760b63fd6d82f30833cd2864f245dd9594cd9,2,21,3,24,4,2009-03-20 03:10:07,2009-03-20 03:10:07
30e760b63fd6d82f30833cd2864f245dd9594cd9...a974b255c30ac23906ba45bf95de99542a70b587,1,1,3,4,1,2009-03-22 04:24:40,2009-03-22 04:24:40
a974b255c30ac23906ba45bf95de99542a70b587...9476530fa1e39ce1324e98f4dbb79576895372e5,2,5,5,10,2,2009-03-22 15:06:58,2009-03-22 15:06:58
9476530fa1e39ce1324e98f4dbb79576895372e5...d7d908b05a442745c1a90728805b74db0a7921cf,14,4177,257,4434,31,2009-03-22 23:25:03,2009-03-22 23:25:03
d7d908b05a442745c1a90728805b74db0a7921cf...e06da1724cf05a83e14efa8b854348ac4e4a599a,2,56,56,112,2,2009-03-22 23:25:58,2009-03-22 23:25:58
e06da1724cf05a83e14efa8b854348ac4e4a599a...f8ef75eb9124ce924be5fb521c783efd5c996e33,11,77,77,154,75,2009-03-23 01:55:17,2009-03-23 01:55:17
f8ef75eb9124ce924be5fb521c783efd5c996e33...611d24086c3837da21e0816fa3cb7b826f28da87,1,3,1,4,1,2009-03-27 18:20:57,2009-03-27 18:20:57
611d24086c3837da21e0816fa3cb7b826f28da87...2937d645cbf32e720d71f2f07f01e30fce0f9a88,1,2,4,6,2,2009-03-30 07:59:31,2009-03-30 07:59:31
2937d645cbf32e720d71f2f07f01e30fce0f9a88...2764127335126601b90aac6488ef927dce1eceda,2,142,100,242,69,2009-03-31 17:35:20,2009-03-31 17:35:20
2764127335126601b90aac6488ef927dce1eceda...4130319e97b1c591d394b73961b6772559cd0549,4,11,3,14,7,2009-04-20 17:05:18,2009-04-20 17:05:18
4130319e97b1c591d394b73961b6772559cd0549...92a076cb2f7679043575977092be1233cb1c687f,1,3,0,3,1,2009-04-21 18:46:39,2009-04-21 18:46:39
92a076cb2f7679043575977092be1233cb1c687f...17841ea24426cbd25985567cb82cf3107767c9ac,1,1,1,2,1,2009-04-21 19:09:47,2009-04-21 19:09:47
17841ea24426cbd25985567cb82cf3107767c9ac...a0d079f430db0c67a2af60bd4e01da02e711d372,1,17,19,36,14,2009-04-21 19:19:28,2009-04-21 19:19:28
a0d079f430db0c67a2af60bd4e01da02e711d372...2adb9b2a0fab55301f66d1a293823ffa6649bdc9,2,27,17,44,8,2009-04-22 00:55:44,2009-04-22 00:55:44
2adb9b2a0fab55301f66d1a293823ffa6649bdc9...6a12363f2920f40cc03787e6284a0e7c442dc1ae,1,11,11,22,6,2009-04-22 01:34:13,2009-04-22 01:34:13
6a12363f2920f40cc03787e6284a0e7c442dc1ae...3715d73f79be3f3a61182f6c49dd306e5c0f3075,1,1,1,2,1,2009-04-22 02:31:29,2009-04-22 02:31:29
3715d73f79be3f3a61182f6c49dd306e5c0f3075...f5690995dd0d3b3b30410b781e060c5ce55e465f,1,1,1,2,1,2009-04-22 04:18:53,2009-04-22 04:18:53
f5690995dd0d3b3b30410b781e060c5ce55e465f...8be57929750eac38b0eb331cd99def3d88302cc1,1,4,4,8,3,2009-04-22 04:39:44,2009-04-22 04:39:44
8be57929750eac38b0eb331cd99def3d88302cc1...6a049246a123d7da75430f875e9eee1ba3270722,2,11,5,16,4,2009-04-22 05:23:53,2009-04-22 05:23:53
6a049246a123d7da75430f875e9eee1ba3270722...432ea4ca6cbd63cd972718d3a44772fe8ef1022b,1,2,2,4,2,2009-04-22 05:29:01,2009-04-22 05:29:01
432ea4ca6cbd63cd972718d3a44772fe8ef1022b...1bd4325cb979ed66588d6b3454b3eb4291a47151,2,4,1,5,3,2009-04-22 20:00:30,2009-04-22 20:00:30
1bd4325cb979ed66588d6b3454b3eb4291a47151...851846aabea72fe784b8a13cfb04cffecdb771b6,2,10,4,14,5,2009-04-29 21:45:58,2009-04-29 21:45:58
851846aabea72fe784b8a13cfb04cffecdb771b6...45b8d2531ef6a7c775ca3bac06bcad6ffc5419e3,1,5,9,14,1,2009-04-29 22:04:41,2009-04-29 22:04:41
45b8d2531ef6a7c775ca3bac06bcad6ffc5419e3...287ecdbf6759a3a89c168a5c0aff14833947f430,1,200,147,347,130,2009-04-30 01:26:09,2009-04-30 01:26:09
287ecdbf6759a3a89c168a5c0aff14833947f430...71efbdd3b26f3a283f8d4bfdcc7b6343142027b9,2,38,42,80,15,2009-04-30 21:44:25,2009-04-30 21:44:25
71efbdd3b26f3a283f8d4bfdcc7b6343142027b9...aef1989ba74ee568f8bab3ac0967fd849816da12,2,7,3,10,4,2009-04-30 21:50:15,2009-04-30 21:50:15
aef1989ba74ee568f8bab3ac0967fd849816da12...a4b8fed8ad7542309e5f4573468261c9a98af97f,1,1,1,2,1,2009-05-01 00:02:51,2009-05-01 00:02:51
a4b8fed8ad7542309e5f4573468261c9a98af97f...c6db93c37374410427b0b64d19c24659fbb32754,1,2,2,4,1,2009-05-01 00:21:29,2009-05-01 00:21:29
c6db93c37374410427b0b64d19c24659fbb32754...96fd5f18d49bd3a93586c4b8b6c3cdfc337cd067,1,1,1,2,1,2009-05-01 00:36:21,2009-05-01 00:36:21
96fd5f18d49bd3a93586c4b8b6c3cdfc337cd067...cbda6c541b9f2dd8fbaa084ecce7f421e8dc3dc4,2,128,128,256,60,2009-05-01 00:59:27,2009-05-01 00:59:27
cbda6c541b9f2dd8fbaa084ecce7f421e8dc3dc4...ffd457d4561eb1a6653aaef90f92a3b3010b9139,2,40,24,64,26,2009-05-02 19:22:55,2009-05-02 19:22:55
ffd457d4561eb1a6653aaef90f92a3b3010b9139...d415e0adb8f89a00768091795860daa5f2c29835,1,1,1,2,1,2009-05-02 19:23:53,2009-05-02 19:23:53
d415e0adb8f89a00768091795860daa5f2c29835...5e6e53835e552920db4f88ac0c9eca71aaacbef0,2,65,20,85,19,2009-05-02 21:14:38,2009-05-02 21:14:38
5e6e53835e552920db4f88ac0c9eca71aaacbef0...e45b41602ff483ebed67b5b73008aff5ceb1fe6f,2,18,13,31,9,2009-05-02 22:35:39,2009-05-02 22:35:39
e45b41602ff483ebed67b5b73008aff5ceb1fe6f...3a80de1c7a67fc48908b37cfbd8806a265488723,2,13,13,26,5,2009-05-03 15:57:25,2009-05-03 15:57:25
3a80de1c7a67fc48908b37cfbd8806a265488723...c6b59263b5fb13f84ecdae4e51e4dd15198a6bdf,1,1,1,2,1,2009-05-03 17:02:56,2009-05-03 17:02:56
c6b59263b5fb13f84ecdae4e51e4dd15198a6bdf...d72b8307de97a715c8916d571278b4bc35be23a6,1,24,16,40,20,2009-05-04 00:05:04,2009-05-04 00:05:04
d72b8307de97a715c8916d571278b4bc35be23a6...31b573185b7728fa74452fbecc515c6de94640a6,2,3,2,5,3,2009-05-04 00:19:57,2009-05-04 00:19:57
31b573185b7728fa74452fbecc515c6de94640a6...4460d5ad5949e5c9bf58d5de72b1d8b308181bf7,1,21,0,21,1,2009-05-04 04:54:09,2009-05-04 04:54:09
4460d5ad5949e5c9bf58d5de72b1d8b308181bf7...3a9c827bf86657a0d007f66c9920d4c2b1726961,1,6,3,9,4,2009-05-06 01:24:22,2009-05-06 01:24:22
3a9c827bf86657a0d007f66c9920d4c2b1726961...8f042d8be34fe2d197e45d6fa398456759a4c007,2,19,1,20,2,2009-05-06 02:17:24,2009-05-06 02:17:24
8f042d8be34fe2d197e45d6fa398456759a4c007...811891785f5bfa3f42ec9cb18e68fc3a114935e9,2,74,15,89,12,2009-05-07 00:50:28,2009-05-07 00:50:28
811891785f5bfa3f42ec9cb18e68fc3a114935e9...c41fab1eb099cd284b65c0d37431adfb38f4106a,1,2,1,3,2,2009-05-07 16:59:35,2009-05-07 16:59:35
c41fab1eb099cd284b65c0d37431adfb38f4106a...09b59038a0d1b6a1e72d24b9cf86c2a9b2aa4d16,1,2,2,4,2,2009-05-07 18:09:17,2009-05-07 18:09:17
09b59038a0d1b6a1e72d24b9cf86c2a9b2aa4d16...d0750727684cb17a762ee338132159e389920799,1,3,2,5,2,2009-05-10 14:38:35,2009-05-10 14:38:35
d0750727684cb17a762ee338132159e389920799...b763cc6602fdf2bede16be5bf106ceaa1d1d0525,1,14,2,16,1,2009-05-12 15:43:51,2009-05-12 15:43:51
b763cc6602fdf2bede16be5bf106ceaa1d1d0525...ec3ebd3e8a7dfda15d227ea3dd21361e534beac3,3,17,4,21,5,2009-05-14 14:44:31,2009-05-14 14:44:31
ec3ebd3e8a7dfda15d227ea3dd21361e534beac3...ed087197cef89ce79cbd6b4ab49f184f3b259602,1,3,9,12,1,2009-05-14 18:46:58,2009-05-14 18:46:58
ed087197cef89ce79cbd6b4ab49f184f3b259602...fd281e493d58dc54feded5d29660489e6bc7b151,1,1,0,1,1,2009-05-16 14:45:46,2009-05-16 14:45:46
fd281e493d58dc54feded5d29660489e6bc7b151...a073ee85963518be605018550eeb530180e2287f,1,10,1,11,2,2009-05-16 15:10:24,2009-05-16 15:10:24
a073ee85963518be605018550eeb530180e2287f...a4a58a38360039deda2905a34ebc6140d3c259b7,1,1,1,2,1,2009-05-16 17:39:22,2009-05-16 17:39:22
a4a58a38360039deda2905a34ebc6140d3c259b7...4a99fcf6e4b152706b951df584614da32b08f6e4,1,2,3,5,2,2009-05-16 19:32:16,2009-05-16 19:32:16
4a99fcf6e4b152706b951df584614da32b08f6e4...29411a4405c73b20244108db6bb868f3f11ccd73,1,6,2,8,1,2009-05-16 20:22:47,2009-05-16 20:22:47
29411a4405c73b20244108db6bb868f3f11ccd73...e10e625bf4865cb8e9927e94d15afa37f6537a03,1,1,4,5,2,2009-05-16 20:23:58,2009-05-16 20:23:58
e10e625bf4865cb8e9927e94d15afa37f6537a03...b97b886fcd212b7a4c8c883b1afb04b6bd071545,1,12,2,14,2,2009-05-18 15:36:36,2009-05-18 15:36:36
b97b886fcd212b7a4c8c883b1afb04b6bd071545...a0451f162e95b552f9dc307b8529c114edeab417,3,12,17,29,6,2009-05-20 21:12:08,2009-05-20 21:12:08
a0451f162e95b552f9dc307b8529c114edeab417...90a87c03b4943d75c24bc5e6246630231d12d933,2,33,6,39,9,2009-05-20 21:28:48,2009-05-20 21:28:48
90a87c03b4943d75c24bc5e6246630231d12d933...45729831b136238d6b58cd2057192fd74073dfce,2,5,12,17,6,2009-05-20 21:52:47,2009-05-20 21:52:47
45729831b136238d6b58cd2057192fd74073dfce...89d2f1e8516fe9f6ab30ffd275e520d47b4bf707,1,9,2,11,3,2009-05-20 21:59:24,2009-05-20 21:59:24
89d2f1e8516fe9f6ab30ffd275e520d47b4bf707...6faf75fb98ffdeb27dd8ce5a009d65dfa2921ec2,1,20,14,34,3,2009-06-02 02:14:58,2009-06-02 02:14:58
6faf75fb98ffdeb27dd8ce5a009d65dfa2921ec2...030ae6771533a09157347ffe1d28ee08096899da,1,1,1,2,1,2009-06-04 17:36:23,2009-06-04 17:36:23
030ae6771533a09157347ffe1d28ee08096899da...28ab4d32247943e1ae3409b23fe69303df0bc9eb,4,101,20,121,8,2009-06-15 13:36:12,2009-06-15 13:36:12
28ab4d32247943e1ae3409b23fe69303df0bc9eb...739644dce5312fc66a37806ff5e07c8e9784f803,1,1,1,2,1,2009-06-15 13:40:10,2009-06-15 13:40:10
739644dce5312fc66a37806ff5e07c8e9784f803...ee34b6982ab25cd7699f68506d7b18a02c3c4d44,2,19,5,24,7,2009-06-17 02:31:45,2009-06-17 02:31:45
ee34b6982ab25cd7699f68506d7b18a02c3c4d44...c6b9654ea8524e76f49f17f1bb0f6a38ce36bca3,2,13,4,17,5,2009-06-20 15:51:19,2009-06-20 15:51:19
c6b9654ea8524e76f49f17f1bb0f6a38ce36bca3...de07ebc1a0a656c53ebee3f95802db08bb3cd680,1,10,14,24,6,2009-06-23 18:11:09,2009-06-23 18:11:09
de07ebc1a0a656c53ebee3f95802db08bb3cd680...bbf3334db107abf72cbb3247b68b7e40d9f2cdfe,1,3,3,6,3,2009-06-23 18:14:57,2009-06-23 18:14:57
bbf3334db107abf72cbb3247b68b7e40d9f2cdfe...fd2a2fed84b6c32e24a050356a8f422310bae927,1,7,4,11,1,2009-07-11 13:44:44,2009-07-11 13:44:44
fd2a2fed84b6c32e24a050356a8f422310bae927...8db967e9d52407c8e76d81b9d472800667f6fa29,1,42,9,51,7,2009-07-11 13:49:46,2009-07-11 13:49:46
8db967e9d52407c8e76d81b9d472800667f6fa29...2a268f5f4b5b1d870d5af580de4c768e0121e5b5,2,26,27,53,9,2009-07-11 13:57:38,2009-07-11 13:57:38
2a268f5f4b5b1d870d5af580de4c768e0121e5b5...0c4418bbc4022ed5cb746af364ff1c0d7c331209,1,1,1,2,1,2009-07-11 14:50:59,2009-07-11 14:50:59
0c4418bbc4022ed5cb746af364ff1c0d7c331209...5b84c7c45c8c3c5e7c9a17239cd658b0c87ab892,1,1,1,2,1,2009-07-11 15:23:18,2009-07-11 15:23:18
5b84c7c45c8c3c5e7c9a17239cd658b0c87ab892...89b4bc53ca0ca3d4e5c80b94ce92b09cc34af8ef,2,22,1,23,2,2009-07-12 14:31:32,2009-07-12 14:31:32
89b4bc53ca0ca3d4e5c80b94ce92b09cc34af8ef...d857315967a1cc07b73924bbdf2eb12f4f910c45,2,101,2,103,4,2009-07-12 15:14:01,2009-07-12 15:14:01
d857315967a1cc07b73924bbdf2eb12f4f910c45...e8eff25f3b6d9a0c03f6581089406cebcc86aa34,2,70,3,73,3,2009-07-12 18:31:26,2009-07-12 18:31:26
e8eff25f3b6d9a0c03f6581089406cebcc86aa34...7d7a960035b7431887581c9cef09eaaef28e3d27,3,171,79,250,73,2009-07-12 20:19:43,2009-07-12 20:19:43
7d7a960035b7431887581c9cef09eaaef28e3d27...35951021545a3ae88018fc5ea3bebd1bc7d09c6a,2,50,19,69,21,2009-07-12 21:08:54,2009-07-12 21:08:54
35951021545a3ae88018fc5ea3bebd1bc7d09c6a...4ae7234736fd501110a7bf2acea6cc68e24bd4cd,1,2,2,4,2,2009-07-13 19:24:23,2009-07-13 19:24:23
4ae7234736fd501110a7bf2acea6cc68e24bd4cd...72bb9dfe281a12c1195c4e32ae1440a9d0708ba3,1,1,1,2,1,2009-07-13 19:24:44,2009-07-13 19:24:44
72bb9dfe281a12c1195c4e32ae1440a9d0708ba3...c0802e5d21548ce5c41e51ff500308d5a5c9b249,1,4,2,6,2,2009-07-13 19:48:08,2009-07-13 19:48:08
c0802e5d21548ce5c41e51ff500308d5a5c9b249...7cfec99858bf397714d3aac1c0ba4708d2ddb986,1,14,12,26,8,2009-07-13 21:50:58,2009-07-13 21:50:58
7cfec99858bf397714d3aac1c0ba4708d2ddb986...89dc1e01435ebeef173c9a843096cd5c1fbc9dd8,2,11,28,39,10,2009-07-13 22:21:40,2009-07-13 22:21:40
89dc1e01435ebeef173c9a843096cd5c1fbc9dd8...c3c94823f27ee1e935586d46fd86f055f3a3d97d,4,30,8,38,6,2009-07-14 21:13:23,2009-07-14 21:13:23
c3c94823f27ee1e935586d46fd86f055f3a3d97d...ad5ba1a72ef90c4327e3eb3ee133fbf87e181638,1,2,2,4,1,2009-07-14 21:20:16,2009-07-14 21:20:16
ad5ba1a72ef90c4327e3eb3ee133fbf87e181638...991dafae16e44512c5107b90bc8ce9675d8f5c12,2,7,2,9,3,2009-07-14 23:28:07,2009-07-14 23:28:07
991dafae16e44512c5107b90bc8ce9675d8f5c12...7a04d1da54caec00b900620390df820fb85b1227,2,8,2,10,3,2009-07-14 23:43:58,2009-07-14 23:43:58
7a04d1da54caec00b900620390df820fb85b1227...c5315f66870377579cb41a1c0d80389c02628a66,1,3,0,3,1,2009-07-15 12:35:57,2009-07-15 12:35:57
c5315f66870377579cb41a1c0d80389c02628a66...0e2f4a0fe3b26f2eadff19cd3f668a4e99752117,1,2,0,2,1,2009-07-16 07:31:22,2009-07-16 07:31:22
0e2f4a0fe3b26f2eadff19cd3f668a4e99752117...e124fec5e9cfee77cb23b27c0d43dc2631c83aab,2,10,1,11,3,2009-07-16 07:31:32,2009-07-16 07:31:32
e124fec5e9cfee77cb23b27c0d43dc2631c83aab...e532dfe5228217f55a33122a4438fd70522dbb4b,2,9,2,11,3,2009-07-16 07:31:41,2009-07-16 07:31:41
e532dfe5228217f55a33122a4438fd70522dbb4b...6b912beb7b7ba3147112b8291ba3d3deb888bdba,1,5,5,10,4,2009-07-16 07:31:47,2009-07-16 07:31:47
6b912beb7b7ba3147112b8291ba3d3deb888bdba...8d52c27808a77f51d1cf42c7e738b0b356466c1a,2,8,2,10,3,2009-07-16 07:31:55,2009-07-16 07:31:55
8d52c27808a77f51d1cf42c7e738b0b356466c1a...c10f87120f6fb2c6c269e766d6988e9be946dd03,2,25,5,30,5,2009-07-16 07:32:03,2009-07-16 07:32:03
c10f87120f6fb2c6c269e766d6988e9be946dd03...87869b8b81380617cfad8788799ee40de0e3e9c4,2,84,37,121,17,2009-07-16 07:32:11,2009-07-16 07:32:11
87869b8b81380617cfad8788799ee40de0e3e9c4...8e54b167cf60a6efa0e572d31f3886c3cfe74c0b,1,6,0,6,1,2009-07-16 07:32:17,2009-07-16 07:32:17
8e54b167cf60a6efa0e572d31f3886c3cfe74c0b...d36d224cc52e70d837306d33a03f517ef72abc60,2,12,0,12,3,2009-07-16 07:32:25,2009-07-16 07:32:25
d36d224cc52e70d837306d33a03f517ef72abc60...190812c3be99bde536d373b6b6ab65cfe053a532,2,21,23,44,12,2009-07-16 07:32:31,2009-07-16 07:32:31
190812c3be99bde536d373b6b6ab65cfe053a532...991d039b62f5dfcb9e3d99fe28212a6874e8f5c7,2,43,39,82,22,2009-07-16 07:32:39,2009-07-16 07:32:39
991d039b62f5dfcb9e3d99fe28212a6874e8f5c7...a38a5cd531a328319f8b7f3f33a84044b54591ce,2,13,3,16,2,2009-07-16 15:16:44,2009-07-16 15:16:44
a38a5cd531a328319f8b7f3f33a84044b54591ce...88bd74c732283cf8cd5e778439f0ea23654519d3,1,12,13,25,6,2009-07-17 01:47:26,2009-07-17 01:47:26
88bd74c732283cf8cd5e778439f0ea23654519d3...1a7f72e7fe96654838074f88c79e021d37c5c30a,2,6,4,10,5,2009-07-17 17:33:44,2009-07-17 17:33:44
1a7f72e7fe96654838074f88c79e021d37c5c30a...4edbff9fc13d49eb0c887be8c58c8e66dceb4c5c,1,17,14,31,8,2009-07-17 21:08:13,2009-07-17 21:08:13
4edbff9fc13d49eb0c887be8c58c8e66dceb4c5c...6504751006e6848369c9bfa5758f06b5ff40ba58,3,119,139,258,39,2009-07-17 22:15:37,2009-07-17 22:15:37
6504751006e6848369c9bfa5758f06b5ff40ba58...d828ff75a45bc1f232e607806c930e98d7256fc6,1,14,14,28,1,2009-07-17 22:20:26,2009-07-17 22:20:26
d828ff75a45bc1f232e607806c930e98d7256fc6...9d46c0ebb46037cfcc026e874d459d2cd412294e,1,1,1,2,1,2009-07-18 19:44:15,2009-07-18 19:44:15
9d46c0ebb46037cfcc026e874d459d2cd412294e...f0681d98fe1fcb2995eca50a41c1c66407eab97a,1,61,30,91,28,2009-07-19 12:53:39,2009-07-19 12:53:39
f0681d98fe1fcb2995eca50a41c1c66407eab97a...a3b8ac413f9c55994922c20b39223ab9ae6d1afa,2,33,6,39,4,2009-07-19 13:04:18,2009-07-19 13:04:18
a3b8ac413f9c55994922c20b39223ab9ae6d1afa...0d5c3a68a092401089c9242bdafdb1b2534feb6a,7,20,20,40,18,2009-07-19 13:21:51,2009-07-19 13:21:51
0d5c3a68a092401089c9242bdafdb1b2534feb6a...48e9a3999596c2ee1f4470a78637de8f27e3b219,5,12,12,24,11,2009-07-19 13:32:53,2009-07-19 13:32:53
48e9a3999596c2ee1f4470a78637de8f27e3b219...ec7fdf37235583a807b3f08e146edaadc81ca974,1,40,28,68,30,2009-07-19 15:29:03,2009-07-19 15:29:03
ec7fdf37235583a807b3f08e146edaadc81ca974...6d23f2fd81f9f1894060a353e66effdf9738af16,1,27,14,41,14,2009-07-19 15:48:30,2009-07-19 15:48:30
6d23f2fd81f9f1894060a353e66effdf9738af16...0ac9898d6b7200075d20e36d7c31ad77585c8778,1,2,2,4,1,2009-07-19 15:51:00,2009-07-19 15:51:00
0ac9898d6b7200075d20e36d7c31ad77585c8778...f57d93bf18a2d5c3b7a0b50da67cf6147aa389c3,2,13,13,26,5,2009-07-19 15:57:43,2009-07-19 15:57:43
f57d93bf18a2d5c3b7a0b50da67cf6147aa389c3...4d1f15c35157532f13dd4ad2ba580ac65ad8475a,1,39,23,62,34,2009-07-19 16:08:17,2009-07-19 16:08:17
4d1f15c35157532f13dd4ad2ba580ac65ad8475a...627a32cea2da11673f459d6eff1dc393b8c41d6f,1,20,12,32,12,2009-07-19 16:13:45,2009-07-19 16:13:45
627a32cea2da11673f459d6eff1dc393b8c41d6f...7175b2ffabe57fcd403ca03f2b4ff895f5012836,1,1,1,2,1,2009-07-19 16:21:08,2009-07-19 16:21:08
7175b2ffabe57fcd403ca03f2b4ff895f5012836...81985c7878db2dd4dc31a3a9f8028eaae314ec24,1,1,1,2,1,2009-07-19 17:02:01,2009-07-19 17:02:01
81985c7878db2dd4dc31a3a9f8028eaae314ec24...fa2d66363928ec6f6b615b9e5e5d9ab002651457,1,10,5,15,8,2009-07-19 19:03:18,2009-07-19 19:03:18
fa2d66363928ec6f6b615b9e5e5d9ab002651457...5272ed28bc03264e2167dbbdaccfbed6cdd64ffd,1,122,71,193,98,2009-07-19 19:37:11,2009-07-19 19:37:11
5272ed28bc03264e2167dbbdaccfbed6cdd64ffd...eaca153aea6e7b00fd458cac0c8abadcbab8ad61,1,20,12,32,11,2009-07-19 19:44:15,2009-07-19 19:44:15
eaca153aea6e7b00fd458cac0c8abadcbab8ad61...03de2cb5e7945fac42bc612b290dbe460924cc51,1,8,2,10,3,2009-07-19 19:47:30,2009-07-19 19:47:30
03de2cb5e7945fac42bc612b290dbe460924cc51...b953c1d50a2c9a169b7fc47e78c2b8b0acb8a93d,1,7,5,12,4,2009-07-19 19:50:45,2009-07-19 19:50:45
b953c1d50a2c9a169b7fc47e78c2b8b0acb8a93d...29ff710c9b02dee2c407b408ea88489b3cef688e,1,12,5,17,4,2009-07-19 19:55:21,2009-07-19 19:55:21
29ff710c9b02dee2c407b408ea88489b3cef688e...7a67f8897d3c2ed97254f0fdb969be14e77962d1,2,66,41,107,40,2009-07-21 09:17:33,2009-07-21 09:17:33
7a67f8897d3c2ed97254f0fdb969be14e77962d1...7e06b9b70f23dffd9c74047895b53b28af0dafc6,1,7,5,12,3,2009-07-21 15:57:51,2009-07-21 15:57:51
7e06b9b70f23dffd9c74047895b53b28af0dafc6...db8226229637b00dda8757e8b96fd8362cf67a70,1,1,1,2,1,2009-07-21 20:06:05,2009-07-21 20:06:05
db8226229637b00dda8757e8b96fd8362cf67a70...66c98419aa6f93deb2c3b7060191fc96c885dc29,1,3,7,10,3,2009-07-21 20:16:44,2009-07-21 20:16:44
66c98419aa6f93deb2c3b7060191fc96c885dc29...6649ae290373e147ef5d2f6b3664dadc1e2779a6,1,1,1,2,1,2009-07-21 20:24:12,2009-07-21 20:24:12
6649ae290373e147ef5d2f6b3664dadc1e2779a6...4e8f0c935e8fada0a755d9749cd371b96b9589d6,1,2,0,2,2,2009-07-21 20:48:29,2009-07-21 20:48:29
4e8f0c935e8fada0a755d9749cd371b96b9589d6...fe80b5af45049d1c8d10682eb1075f838d52a045,1,3,1,4,1,2009-07-22 14:38:21,2009-07-22 14:38:21
fe80b5af45049d1c8d10682eb1075f838d52a045...6fc57be843e2120ee6361af45b38d12a8c876f40,1,6,0,6,1,2009-07-22 15:03:23,2009-07-22 15:03:23
6fc57be843e2120ee6361af45b38d12a8c876f40...b964e56946c9111d7e53fa1eafb14cab3cd642f2,1,1,2,3,1,2009-07-22 17:30:17,2009-07-22 17:30:17
b964e56946c9111d7e53fa1eafb14cab3cd642f2...0a6c5205d21c29485ff8338881825135b6d9f373,3,8,6,14,6,2009-07-23 13:22:55,2009-07-23 13:22:55
0a6c5205d21c29485ff8338881825135b6d9f373...9c9dd7cedea56a350d49ddcdf0982be9fcb6bad2,1,2,4,6,2,2009-07-23 22:16:29,2009-07-23 22:16:29
9c9dd7cedea56a350d49ddcdf0982be9fcb6bad2...26eda09892459709d224f910038b8f6836bfd012,1,1,1,2,1,2009-07-23 22:38:29,2009-07-23 22:38:29
26eda09892459709d224f910038b8f6836bfd012...6a85898d131f9921f2d8e885a892fbdcf4d9c5c6,1,46,0,46,1,2009-07-24 00:57:27,2009-07-24 00:57:27
6a85898d131f9921f2d8e885a892fbdcf4d9c5c6...0d389c066aca61795ac43e08d56870959df1de9c,1,3,2,5,1,2009-07-24 00:58:24,2009-07-24 00:58:24
0d389c066aca61795ac43e08d56870959df1de9c...cf7a0cfdc106992ec3073560044304e7e6dcfbbd,1,1,0,1,1,2009-07-24 01:50:41,2009-07-24 01:50:41
cf7a0cfdc106992ec3073560044304e7e6dcfbbd...cafd392af0a2736a33cf1528198c66a233285b3d,2,64,78,142,34,2009-07-24 22:32:53,2009-07-24 22:32:53
cafd392af0a2736a33cf1528198c66a233285b3d...3d8ceaf2f21f4782ff21746887e2bcf56025e704,1,64,33,97,26,2009-07-25 16:04:30,2009-07-25 16:04:30
3d8ceaf2f21f4782ff21746887e2bcf56025e704...fd0bf5d6edec1f3c03008bb29b16d7e7e1b36abc,1,1,2,3,2,2009-07-25 16:08:18,2009-07-25 16:08:18
fd0bf5d6edec1f3c03008bb29b16d7e7e1b36abc...343b0936a43953a993d1f2cc500b954d5bcc8280,2,20,0,20,2,2009-07-25 20:56:15,2009-07-25 20:56:15
343b0936a43953a993d1f2cc500b954d5bcc8280...cae93c39eb57ccc2acc5e101eda7a56e0a734cdf,2,11,4,15,5,2009-07-25 21:31:59,2009-07-25 21:31:59
cae93c39eb57ccc2acc5e101eda7a56e0a734cdf...2cd9ee3510a03091c929b849ea164c9f97e262e7,2,38,2,40,3,2009-07-27 13:02:41,2009-07-27 13:02:41
2cd9ee3510a03091c929b849ea164c9f97e262e7...255a293cda03e787998747a3f7b1e456b683a0f6,1,1,2,3,1,2009-07-27 13:21:19,2009-07-27 13:21:19
255a293cda03e787998747a3f7b1e456b683a0f6...8c18dcdeb08b8e2b908c17efd760ff25635f3749,1,1,1,2,1,2009-07-27 19:02:40,2009-07-27 19:02:40
8c18dcdeb08b8e2b908c17efd760ff25635f3749...18a6fbbb6ab0bdabbbd377d23385650e45c30e74,2,12,4,16,5,2009-07-27 20:47:32,2009-07-27 20:47:32
18a6fbbb6ab0bdabbbd377d23385650e45c30e74...b7a3b220a8a2b5b0378c9f176ca5ae0f786a6fcf,1,6,2,8,2,2009-07-27 20:48:42,2009-07-27 20:48:42
b7a3b220a8a2b5b0378c9f176ca5ae0f786a6fcf...61b18c866c57f9156f746b691517649f2ce628aa,2,3,10,13,4,2009-07-28 12:22:10,2009-07-28 12:22:10
61b18c866c57f9156f746b691517649f2ce628aa...d6991fa273515a8503692324499edcc71b5c3f64,2,9,3,12,4,2009-07-28 12:28:59,2009-07-28 12:28:59
d6991fa273515a8503692324499edcc71b5c3f64...bddd1837bb512b0ed537fbbdecf3ac3f6067adba,2,3,3,6,2,2009-08-10 21:22:31,2009-08-10 21:22:31
bddd1837bb512b0ed537fbbdecf3ac3f6067adba...a64ad8b4e97e68b51996268ecc7bcdf4271d082c,2,7,2,9,6,2009-08-26 16:29:46,2009-08-26 16:29:46
a64ad8b4e97e68b51996268ecc7bcdf4271d082c...f52c4a3d5fb69f143d90f9a032e2a004c36ccae3,1,1,1,2,1,2009-08-26 17:39:52,2009-08-26 17:39:52
f52c4a3d5fb69f143d90f9a032e2a004c36ccae3...957cd6fb2a2b7b8cfe9ac6b3f2b3cc2bc8163449,2,4,4,8,3,2009-08-27 19:22:48,2009-08-27 19:22:48
957cd6fb2a2b7b8cfe9ac6b3f2b3cc2bc8163449...569c8b45c0d301663f3f6c88b606d199fc78ec1a,2,3,2,5,2,2009-08-27 20:07:45,2009-08-27 20:07:45
569c8b45c0d301663f3f6c88b606d199fc78ec1a...50d78e7658382d2a2f5149cae7a6572f78ce403f,2,30,12,42,8,2009-09-02 05:16:21,2009-09-02 05:16:21
50d78e7658382d2a2f5149cae7a6572f78ce403f...b7d4e0e46cb2cad6f400173cd09ce44d1b8ad04e,1,5,0,5,1,2009-09-07 17:20:38,2009-09-07 17:20:38
b7d4e0e46cb2cad6f400173cd09ce44d1b8ad04e...9d8d74569c8114f9c9b0f42bca71536e154c5944,3,58,42,100,15,2009-09-07 18:58:01,2009-09-07 18:58:01
9d8d74569c8114f9c9b0f42bca71536e154c5944...520f1a26845252dd6d7fd5f3b5bb7779ba91eb2c,4,54,43,97,17,2009-09-07 20:55:36,2009-09-07 20:55:36
520f1a26845252dd6d7fd5f3b5bb7779ba91eb2c...96dd06ea50674c77de4a5d953c227bb54d9276af,2,76,46,122,13,2009-09-08 01:07:50,2009-09-08 01:07:50
96dd06ea50674c77de4a5d953c227bb54d9276af...1e750a00e988b4738e4b47b923bd78dbaffa6fb8,1,8,1,9,2,2009-09-08 01:45:11,2009-09-08 01:45:11
1e750a00e988b4738e4b47b923bd78dbaffa6fb8...4ea4fad0902839c06c281b5de7b0aca29922b63d,1,4,0,4,1,2009-09-08 04:26:47,2009-09-08 04:26:47
4ea4fad0902839c06c281b5de7b0aca29922b63d...9de120e6d7cfffa3d990a6ccf23db3cd74e2bdc0,2,25,3,28,4,2009-09-09 00:21:21,2009-09-09 00:21:21
9de120e6d7cfffa3d990a6ccf23db3cd74e2bdc0...bf230ffb6a1e0aae4dd0d4dae67ed2cafa19ecbb,1,2,2,4,2,2009-09-09 16:33:16,2009-09-09 16:33:16
bf230ffb6a1e0aae4dd0d4dae67ed2cafa19ecbb...aadc268abf555f0f1cc7c5bc05d0dc73b35cb705,1,1,0,1,1,2009-09-09 16:50:58,2009-09-09 16:50:58
aadc268abf555f0f1cc7c5bc05d0dc73b35cb705...d1285504fb636a077ae5b1e53e35959cc7faebc7,4,36,71,107,8,2009-09-09 21:14:28,2009-09-09 21:14:28
d1285504fb636a077ae5b1e53e35959cc7faebc7...9e1a955aab953d778e8d8a8c05e13135e87f3e46,1,6,0,6,5,2009-09-11 17:47:40,2009-09-11 17:47:40
9e1a955aab953d778e8d8a8c05e13135e87f3e46...66c58e9db6469a0ae3ab7a878b00c66c6a904806,1,0,5,5,1,2009-09-14 17:33:15,2009-09-14 17:33:15
66c58e9db6469a0ae3ab7a878b00c66c6a904806...0790989eb60df9df884837c05f90bab14df0704e,2,9,3,12,3,2009-09-14 18:03:18,2009-09-14 18:03:18
0790989eb60df9df884837c05f90bab14df0704e...36ebb4f75ed2d6684c132ddbeb9a05ef015fbc90,1,3,3,6,2,2009-09-14 19:57:49,2009-09-14 19:57:49
36ebb4f75ed2d6684c132ddbeb9a05ef015fbc90...b539b6e1d99892b5b37f7eac938331cfd2ebcd51,1,4,2,6,2,2009-09-14 20:45:58,2009-09-14 20:45:58
b539b6e1d99892b5b37f7eac938331cfd2ebcd51...4a3c4c86c95a99282d743c09bccff8ad73a7ec11,1,1,1,2,1,2009-09-14 20:55:40,2009-09-14 20:55:40
4a3c4c86c95a99282d743c09bccff8ad73a7ec11...f3474c00cd6d9e5fd61b6ef1562003e9986ad67d,1,2,2,4,3,2009-09-14 21:14:15,2009-09-14 21:14:15
f3474c00cd6d9e5fd61b6ef1562003e9986ad67d...bca82254137a161094377b2d8189c2d9d5906a0f,2,63,2,65,4,2009-09-14 22:04:22,2009-09-14 22:04:22
bca82254137a161094377b2d8189c2d9d5906a0f...173c1477ae6efc4c2eeb7131ba0646c4e1323975,2,40,10,50,9,2009-09-14 22:09:42,2009-09-14 22:09:42
173c1477ae6efc4c2eeb7131ba0646c4e1323975...a2731202917f8e90cad94ee574241d1626dc7fb6,2,18,0,18,2,2009-09-14 22:34:04,2009-09-14 22:34:04
a2731202917f8e90cad94ee574241d1626dc7fb6...681f4fd3cdd4bdd23edbba05ed1389fabed86b41,1,2,6,8,2,2009-09-14 22:58:20,2009-09-14 22:58:20
681f4fd3cdd4bdd23edbba05ed1389fabed86b41...766635e8624f5e61e021086de9e763f2ef6b17ef,1,6,2,8,3,2009-09-14 23:12:06,2009-09-14 23:12:06
766635e8624f5e61e021086de9e763f2ef6b17ef...3eb56b09b8ce903355b9173b6e60b2354a6c7ba7,1,2,2,4,3,2009-09-14 23:20:23,2009-09-14 23:20:23
3eb56b09b8ce903355b9173b6e60b2354a6c7ba7...5e0da8c0365b729f63fbd6d27223776551cb8f46,1,1,0,1,1,2009-09-14 23:28:21,2009-09-14 23:28:21
5e0da8c0365b729f63fbd6d27223776551cb8f46...321267dcecdd812090368bf5bd646b3ddfdb4459,2,12,4,16,4,2009-09-15 00:32:13,2009-09-15 00:32:13
321267dcecdd812090368bf5bd646b3ddfdb4459...9b20eb4c85edb156d365e7e376faeef5c741e8fd,1,3,3,6,3,2009-09-15 00:35:35,2009-09-15 00:35:35
9b20eb4c85edb156d365e7e376faeef5c741e8fd...19cd84cf3261ee412a2521df73dcf9d6cfba04a3,1,3,3,6,1,2009-09-15 01:02:18,2009-09-15 01:02:18
19cd84cf3261ee412a2521df73dcf9d6cfba04a3...c4f144eeffd94c745839b0ced2de9c62cfa9f075,1,15,10,25,4,2009-09-15 07:59:53,2009-09-15 07:59:53
c4f144eeffd94c745839b0ced2de9c62cfa9f075...183f37e4b4128af7ba096ac40046768b84b6d66e,2,60,17,77,21,2009-09-15 15:19:58,2009-09-15 15:19:58
183f37e4b4128af7ba096ac40046768b84b6d66e...5b9214e7d8db9759471dd95822a207a8653b48a3,1,4,1,5,4,2009-09-15 15:28:28,2009-09-15 15:28:28
5b9214e7d8db9759471dd95822a207a8653b48a3...7638fc58354e295f96a2d948adcb1ce1c2da60b3,1,2,3,5,1,2009-09-15 15:56:18,2009-09-15 15:56:18
7638fc58354e295f96a2d948adcb1ce1c2da60b3...cf8c1249d1efbdaf4f4dd8d1a36bb803335f4ee8,2,8,5,13,5,2009-09-15 16:45:37,2009-09-15 16:45:37
cf8c1249d1efbdaf4f4dd8d1a36bb803335f4ee8...fc4c6915344625fadf55ca25d3cf9094544d301a,1,12,6,18,3,2009-09-15 16:46:15,2009-09-15 16:46:15
fc4c6915344625fadf55ca25d3cf9094544d301a...8356871a5522ad59cac80af2ca4695079059b97e,1,17,11,28,8,2009-09-15 17:11:15,2009-09-15 17:11:15
8356871a5522ad59cac80af2ca4695079059b97e...5550356a12f525cbda0640fd06169259d4c02092,2,50,2,52,4,2009-09-15 17:23:26,2009-09-15 17:23:26
5550356a12f525cbda0640fd06169259d4c02092...0b36b26259bb1384d8a6d7d55d8738082b96c304,1,1,1,2,1,2009-09-15 17:39:21,2009-09-15 17:39:21
0b36b26259bb1384d8a6d7d55d8738082b96c304...f55fb36e54eb82b112fa7af2c9b2c28c3a1c38cf,2,5,2,7,2,2009-09-15 17:51:38,2009-09-15 17:51:38
f55fb36e54eb82b112fa7af2c9b2c28c3a1c38cf...daffb954e397bd5d9f8e9aaedab6c0baa9609e1e,4,248,83,331,32,2009-09-15 19:15:04,2009-09-15 19:15:04
daffb954e397bd5d9f8e9aaedab6c0baa9609e1e...e907b8769f473d8b3b271ce91fb0e7a1b3a6d24f,1,1,1,2,1,2009-09-15 21:01:00,2009-09-15 21:01:00
e907b8769f473d8b3b271ce91fb0e7a1b3a6d24f...24ffc395a7b2e0b925fcb7959d743820fe269f07,1,1,1,2,1,2009-09-15 21:09:46,2009-09-15 21:09:46
24ffc395a7b2e0b925fcb7959d743820fe269f07...97e134fe80a734b97170bf43c9459511f4e165c7,2,45,20,65,23,2009-09-15 21:14:08,2009-09-15 21:14:08
97e134fe80a734b97170bf43c9459511f4e165c7...9ebb2fc654d51244618e208705e2258fe733058f,2,78,0,78,5,2009-09-16 02:19:18,2009-09-16 02:19:18
9ebb2fc654d51244618e208705e2258fe733058f...45dfa3b0fc49718c4f00600d1e25a129601d08ee,2,53,1,54,4,2009-09-16 08:33:00,2009-09-16 08:33:00
45dfa3b0fc49718c4f00600d1e25a129601d08ee...67089eedf6f84acd9c16ea2a6dadadf7b13a7c84,2,64,34,98,7,2009-09-17 22:37:19,2009-09-17 22:37:19
67089eedf6f84acd9c16ea2a6dadadf7b13a7c84...67d445a703491c90a7d3c46be34bcdceb4d1c896,9,73,48,121,24,2009-09-25 17:55:20,2009-09-25 17:55:20
67d445a703491c90a7d3c46be34bcdceb4d1c896...79ba722e6ee04c7d54c3d67e6fdcf6a99dbbaf3c,1,1,1,2,1,2009-09-25 18:21:02,2009-09-25 18:21:02
79ba722e6ee04c7d54c3d67e6fdcf6a99dbbaf3c...70b9aed422c34047299fe6e8934902fae61f2a3e,1,1,1,2,1,2009-09-25 21:36:40,2009-09-25 21:36:40
70b9aed422c34047299fe6e8934902fae61f2a3e...69e6e53555f21f07b534f1169298f7b33011bb4b,2,39,0,39,2,2009-09-25 21:41:21,2009-09-25 21:41:21
69e6e53555f21f07b534f1169298f7b33011bb4b...8df82d2b04505a45408c2fcf22859a4c60af2e58,2,5,6,11,2,2009-09-29 18:06:16,2009-09-29 18:06:16
8df82d2b04505a45408c2fcf22859a4c60af2e58...f8b7d391e6baa991dd7f8761ee50871aefef71b8,1,43,0,43,1,2009-09-29 18:11:10,2009-09-29 18:11:10
f8b7d391e6baa991dd7f8761ee50871aefef71b8...4bda398e6aa63082c41bb0d06fcc184acd7f76c5,6,95,95,190,50,2009-09-29 19:49:43,2009-09-29 19:49:43
4bda398e6aa63082c41bb0d06fcc184acd7f76c5...dfeb8140facfe840e4c16768b54435e04c29851b,1,2,2,4,2,2009-09-29 21:22:35,2009-09-29 21:22:35
dfeb8140facfe840e4c16768b54435e04c29851b...b0306cc3a662edf9675cd16081ff0e81b2a0f587,2,11,11,22,6,2009-09-29 21:34:12,2009-09-29 21:34:12
b0306cc3a662edf9675cd16081ff0e81b2a0f587...b996026e383eae34dd52824dda5bbe029e2eda51,2,2,1,3,2,2009-09-29 21:40:17,2009-09-29 21:40:17
b996026e383eae34dd52824dda5bbe029e2eda51...0256edbd6ff0cccfa1d522ab415afc34255b123b,2,107,4,111,3,2009-09-29 22:09:21,2009-09-29 22:09:21
0256edbd6ff0cccfa1d522ab415afc34255b123b...3b5de9df40249575ba575b63a0856d6f48c8382a,1,2,2,4,2,2009-09-29 22:25:02,2009-09-29 22:25:02
3b5de9df40249575ba575b63a0856d6f48c8382a...805832afc7b7e6d1cc199949d0bfdd3ea21d94a3,3,6,6,12,5,2009-09-29 22:48:25,2009-09-29 22:48:25
805832afc7b7e6d1cc199949d0bfdd3ea21d94a3...4b5a680f776ee2582e2c1f85b7b0cd9a95254dc3,1,2,1,3,1,2009-10-08 18:13:07,2009-10-08 18:13:07
4b5a680f776ee2582e2c1f85b7b0cd9a95254dc3...098a2bb4d0eec2d590c222bb04bcdda7e1dcd169,1,2,2,4,2,2009-10-12 16:26:01,2009-10-12 16:26:01
098a2bb4d0eec2d590c222bb04bcdda7e1dcd169...4a51b12b95fe6c6c617e02913b7ac5ee3a4b29a0,1,1,2,3,1,2009-10-23 01:26:28,2009-10-23 01:26:28
4a51b12b95fe6c6c617e02913b7ac5ee3a4b29a0...920238d4851bc9b1ee22f6ebdffde9ed55cb1e91,3,6,2,8,4,2009-10-23 01:39:41,2009-10-23 01:39:41
920238d4851bc9b1ee22f6ebdffde9ed55cb1e91...4c85dec058d0edc41f06f88cb605a9c133cb18e5,2,8,13,21,5,2009-10-23 01:44:44,2009-10-23 01:44:44
4c85dec058d0edc41f06f88cb605a9c133cb18e5...1ef930b3845248379f37a6b26c826122e9f65932,2,0,101,101,2,2009-10-23 01:45:36,2009-10-23 01:45:36
1ef930b3845248379f37a6b26c826122e9f65932...cd05cac37f8e63608496788fc7afa5400c18752e,19,1,3345,3346,25,2009-10-23 01:54:34,2009-10-23 01:54:34
cd05cac37f8e63608496788fc7afa5400c18752e...b2e96801165e20822dd535525260f96d9199ac67,2,5,19,24,6,2009-10-23 01:56:49,2009-10-23 01:56:49
b2e96801165e20822dd535525260f96d9199ac67...04ab7944102f99896a0662becf8e838fb9112412,1,1,1,2,1,2009-10-23 01:57:45,2009-10-23 01:57:45
04ab7944102f99896a0662becf8e838fb9112412...c7006d2fa54ee66cc0fa413aabe157a0248673e0,6,1,3892,3893,9,2009-10-23 02:06:20,2009-10-23 02:06:20
c7006d2fa54ee66cc0fa413aabe157a0248673e0...bcbd06b66fe49187c82b8233b1f1370980fff4d1,2,1,4,5,3,2009-10-23 07:25:40,2009-10-23 07:25:40
bcbd06b66fe49187c82b8233b1f1370980fff4d1...b7ccc58afec145120e8e675cf8fd30e9ea97f2a3,1,1,1,2,1,2009-10-23 15:13:47,2009-10-23 10:13:26
b7ccc58afec145120e8e675cf8fd30e9ea97f2a3...bbffc99f7c60d42d4286786dfd6a43aa31d62ae2,6,75,66,141,8,2009-10-26 22:07:57,2009-10-26 22:07:57
bbffc99f7c60d42d4286786dfd6a43aa31d62ae2...81f65ce33931831dc651c5d3ebf2b31b551b6b8b,6,32,1022,1054,14,2009-10-26 22:23:31,2009-10-26 22:23:31
81f65ce33931831dc651c5d3ebf2b31b551b6b8b...50cf4351a6c4b0031f268279b093e38850b90cd6,2,4,4,8,2,2009-10-27 00:40:59,2009-10-23 15:52:38
50cf4351a6c4b0031f268279b093e38850b90cd6...a1bb3ee44d59912b0f911db0133ea459186529ed,2,60,58,118,2,2009-11-03 02:01:02,2009-11-02 21:36:49
a1bb3ee44d59912b0f911db0133ea459186529ed...fbc162b9a3c31095c91207b72efcf827b3938034,1,7,7,14,6,2009-11-03 02:01:03,2009-11-02 21:40:00
fbc162b9a3c31095c91207b72efcf827b3938034...044ad9052aa88808fc6ccd512269d25bf44cd6b7,1,1,2,3,1,2009-11-03 02:01:03,2009-11-02 21:41:03
044ad9052aa88808fc6ccd512269d25bf44cd6b7...10068d5fd03ebd621cc26e74cb7fc1ae9a5abab7,1,0,0,0,0,2009-11-03 02:01:03,2009-11-02 22:58:12
10068d5fd03ebd621cc26e74cb7fc1ae9a5abab7...339708cda9985aeef947a28bec1354bdfcc2a358,1,0,16,16,2,2009-11-07 13:55:14,2009-11-07 13:55:14
339708cda9985aeef947a28bec1354bdfcc2a358...9a371e2d93d6e0a70b4c99e2ca44cbe14017fe5c,1,2,2,4,2,2009-11-07 13:57:27,2009-11-07 13:57:27
9a371e2d93d6e0a70b4c99e2ca44cbe14017fe5c...513053d62ba86ca6ab1f4646fdac3ec6819b2db9,1,2,0,2,1,2009-11-07 13:59:47,2009-11-07 13:59:47
513053d62ba86ca6ab1f4646fdac3ec6819b2db9...81bfd9b870f658ce00eec48ea48a84d69c20bf05,1,2,1,3,1,2009-11-07 15:00:43,2009-11-07 15:00:43
81bfd9b870f658ce00eec48ea48a84d69c20bf05...1a94a46826188fc3ba63680ca62db164589c70c9,1,1,1,2,2,2009-11-07 15:03:16,2009-11-07 15:03:16
1a94a46826188fc3ba63680ca62db164589c70c9...6a722e251dedd5f01ac0c46e330a368be7bb760b,2,6,1,7,3,2009-11-07 15:08:07,2009-11-07 15:08:07
6a722e251dedd5f01ac0c46e330a368be7bb760b...ef05f44cce870a8b78637b0a88b27087f7f13b37,1,2,13,15,1,2009-11-07 15:15:33,2009-11-07 15:15:33
ef05f44cce870a8b78637b0a88b27087f7f13b37...b0fe380cf89564305646bbd55d1fd7bd210fd591,2,15,3,18,4,2009-11-07 15:43:31,2009-11-07 15:43:31
b0fe380cf89564305646bbd55d1fd7bd210fd591...3106039aa89410c9abae9947b2520d9c8e62f8f0,2,17,1,18,3,2009-11-07 16:22:35,2009-11-07 16:22:35
3106039aa89410c9abae9947b2520d9c8e62f8f0...0f03c7489fc2a8a3d806e13276cf61ae51ef641f,1,5,4,9,4,2009-11-07 16:36:44,2009-11-07 16:04:08
0f03c7489fc2a8a3d806e13276cf61ae51ef641f...3dc5bc5a8b61eafba7a299f8cd772779a5bc8957,1,3,3,6,3,2009-11-07 16:37:05,2009-11-07 16:10:58
3dc5bc5a8b61eafba7a299f8cd772779a5bc8957...76f6f0d39dc16e6c081823938ec46f6627a05d31,1,3,3,6,2,2009-11-07 16:40:47,2009-11-07 16:40:47
76f6f0d39dc16e6c081823938ec46f6627a05d31...c2bbcd88335cf6f8df4ac9389ecbae90291377fb,1,12,1,13,2,2009-11-09 11:32:24,2009-11-08 23:26:01
c2bbcd88335cf6f8df4ac9389ecbae90291377fb...b256a3a266721f04d38dca59e56b37b9a682b2f2,1,2,0,2,1,2009-11-09 11:32:24,2009-11-09 10:55:25
b256a3a266721f04d38dca59e56b37b9a682b2f2...e03aee1aa6d26107328052998bdf9f54fa08d9ef,1,2,1,3,1,2009-11-09 11:39:29,2009-11-09 11:39:29
e03aee1aa6d26107328052998bdf9f54fa08d9ef...d251809912c06478fd0c7711736ef6ea3572723e,1,22,6,28,5,2009-11-09 11:59:54,2009-11-09 11:59:54
e03aee1aa6d26107328052998bdf9f54fa08d9ef...9a69b2cf08f11d58ba5e53e540b96b8f4ce5072d,1,3,4,7,4,2009-11-09 11:41:43,2009-11-06 11:59:45
4fd730dca797f495e7473cbfc97a7decf40ff24a...24e18d4cae4a1cb1a77323fd2e99300508e55642,1,1,1,2,1,2009-11-09 12:30:33,2009-11-09 12:30:33
24e18d4cae4a1cb1a77323fd2e99300508e55642...262fcf7b7b919da1564509f621cf7480a5d5572b,1,4,0,4,1,2009-11-09 12:47:53,2009-11-09 12:47:53
262fcf7b7b919da1564509f621cf7480a5d5572b...a8b089a02089d3d7b7e0744e59618ff9800e760a,1,3,0,3,1,2009-11-10 01:13:58,2009-11-10 01:13:58
a8b089a02089d3d7b7e0744e59618ff9800e760a...4b55e94d0849568a2fd121952f13a9d6571c731f,1,2,2,4,2,2009-11-11 04:07:05,2009-11-11 04:07:05
4b55e94d0849568a2fd121952f13a9d6571c731f...5cb1163469fb2c9cd80712cd5481b29055821022,2,20,3,23,4,2009-11-11 14:46:24,2009-11-11 14:46:24
5cb1163469fb2c9cd80712cd5481b29055821022...6035913e254fa46a8e41fc821ee130d6f84f22cc,1,0,1,1,1,2009-11-11 18:33:42,2009-11-09 21:19:51
6035913e254fa46a8e41fc821ee130d6f84f22cc...ca8a9e8c30c0c2a555c5aee2b76934d9c846cf0e,1,1,0,1,1,2009-11-11 18:33:42,2009-11-09 21:25:13
ca8a9e8c30c0c2a555c5aee2b76934d9c846cf0e...dee8e45ef35b4e97693a03c8199e7556823cf5c3,1,2,2,4,2,2009-11-11 18:42:50,2009-11-11 18:42:50
dee8e45ef35b4e97693a03c8199e7556823cf5c3...d933e9c26d9c883af6de6a48c456294748582d3c,1,2,2,4,2,2009-11-11 18:45:03,2009-11-11 18:45:03
d933e9c26d9c883af6de6a48c456294748582d3c...c4c820efff4fa7bcce0d5bf0a448625278ea6379,2,5,2,7,3,2009-11-11 18:49:29,2009-11-11 18:49:29
c4c820efff4fa7bcce0d5bf0a448625278ea6379...bf71575bb4f37321b71ef8ce21c8208ad2b192da,1,8,3,11,2,2009-11-11 18:56:39,2009-11-11 18:56:39
bf71575bb4f37321b71ef8ce21c8208ad2b192da...449e099b97d823ed0252d8821880bc0e471701ea,3,18,3,21,5,2009-11-11 19:17:16,2009-11-11 19:17:16
449e099b97d823ed0252d8821880bc0e471701ea...7c4144fab314d98b85303d01ab904bb711bc2ecc,2,8,2,10,3,2009-11-11 19:23:56,2009-11-11 19:23:56
7c4144fab314d98b85303d01ab904bb711bc2ecc...c2101245c07afdb831b0c79869c7263420407b67,1,1,1,2,1,2009-11-11 19:29:01,2009-11-11 19:29:01
c2101245c07afdb831b0c79869c7263420407b67...357e2ae98908478bcb624b5db68098772a0548c2,1,4,0,4,1,2009-11-11 19:55:32,2009-11-11 19:55:32
357e2ae98908478bcb624b5db68098772a0548c2...5ac2e0837cd5c86acc526c5bc5c3abbe91303116,1,3,1,4,1,2009-11-11 20:11:58,2009-11-11 20:11:58
5ac2e0837cd5c86acc526c5bc5c3abbe91303116...c07d15d5a26c5b5dc2af7b396a704784d5bede34,1,4,0,4,1,2009-11-11 20:15:58,2009-11-11 20:15:58
c07d15d5a26c5b5dc2af7b396a704784d5bede34...1ce92e022ddd6f547515e855544ba3c2fb1416e0,1,2,2,4,1,2009-11-11 23:08:07,2009-11-11 23:08:07
1ce92e022ddd6f547515e855544ba3c2fb1416e0...990d9ca1b05a587cce7599a1a40aa2558117db41,2,14,3,17,5,2009-11-12 13:59:47,2009-11-12 04:50:40
990d9ca1b05a587cce7599a1a40aa2558117db41...93be758de94b2d4a76fca217465c9e09b613cedd,2,11,16,27,4,2009-11-12 13:59:47,2009-11-12 05:48:45
93be758de94b2d4a76fca217465c9e09b613cedd...7b26e3bcc8fab748cf99f4bf8d7e25599f8cd1f3,1,1,1,2,1,2009-11-12 13:59:48,2009-11-12 06:03:59
7b26e3bcc8fab748cf99f4bf8d7e25599f8cd1f3...ee9192d103b3e3b5479a824caa9f6938598ebd30,1,3,3,6,3,2009-11-13 00:09:46,2009-11-12 15:24:19
ee9192d103b3e3b5479a824caa9f6938598ebd30...231c8756788f085d04c6120c12eaa66766abfa3f,1,1,1,2,1,2009-11-13 04:23:39,2009-11-12 22:27:10
231c8756788f085d04c6120c12eaa66766abfa3f...9cd5866a292b1d653651237802d80393a9081528,1,1,1,2,1,2009-11-13 04:23:39,2009-11-12 22:39:33
9cd5866a292b1d653651237802d80393a9081528...8cb8ae27d8e0c732b711d73d2ef71125b0a7769b,1,7,1,8,2,2009-11-13 04:23:39,2009-11-12 23:08:33
8cb8ae27d8e0c732b711d73d2ef71125b0a7769b...d338b1a1e7e2c43977bd65ca9502301c705c989b,1,3,0,3,2,2009-11-15 04:14:31,2009-11-13 21:26:00
d338b1a1e7e2c43977bd65ca9502301c705c989b...0a7232cc39912064de62ee06fd14221b36c93fd8,2,2,3,5,2,2009-11-15 05:27:06,2009-11-15 05:27:06
0a7232cc39912064de62ee06fd14221b36c93fd8...3a23a5c17dd0522da06db8f36890f134f9004de6,1,1,1,2,1,2009-11-17 15:45:01,2009-11-17 15:45:01
3a23a5c17dd0522da06db8f36890f134f9004de6...b33f37c22c1d6e83855ca7c43e8c365a767372db,1,1,0,1,1,2009-11-17 19:25:14,2009-11-17 19:25:14
b33f37c22c1d6e83855ca7c43e8c365a767372db...c08474580caa44d2b5f32be54c0d884832bbd1c3,1,1,1,2,1,2009-11-17 19:36:10,2009-11-17 19:36:10
c08474580caa44d2b5f32be54c0d884832bbd1c3...b30af34f28074b491929445f5aad3d62c63e772f,2,15,10,25,5,2009-11-17 19:52:08,2009-11-17 19:52:08
b30af34f28074b491929445f5aad3d62c63e772f...ac00fe5bbb2a95fdb747f76fd9dd7c58ba6a531c,2,29,19,48,10,2009-11-25 16:56:49,2009-11-18 02:26:42
ac00fe5bbb2a95fdb747f76fd9dd7c58ba6a531c...04dbdb7525eab7e845100fd17c48889bdb91dc92,2,6,2,8,3,2009-11-25 16:58:39,2009-11-19 05:11:29
04dbdb7525eab7e845100fd17c48889bdb91dc92...0bb3998a6a7a82b4c4269f3c57a9fcbe7229b162,1,2,2,4,2,2009-11-25 16:58:39,2009-11-19 12:37:48
0bb3998a6a7a82b4c4269f3c57a9fcbe7229b162...ef819c91b999523ed6cd0c7029e0cee8997ef01a,8,590,590,1180,8,2009-11-25 17:09:53,2009-11-25 17:09:53
ef819c91b999523ed6cd0c7029e0cee8997ef01a...0f6e9a8c69007ce7ebbb7c46637115a207d1a594,1,8,8,16,3,2009-11-25 18:24:24,2009-11-25 18:24:24
0f6e9a8c69007ce7ebbb7c46637115a207d1a594...a7678267d848fcef8775c8b9f4fa3e507b8cc5f4,1,7,5,12,3,2009-11-25 18:29:34,2009-11-25 18:29:34
a7678267d848fcef8775c8b9f4fa3e507b8cc5f4...1879e8cbeef6984495ee84f482900defda0dc3f4,1,1,0,1,1,2009-11-27 16:23:19,2009-11-27 16:23:19
1879e8cbeef6984495ee84f482900defda0dc3f4...e00be67f32f0f82421cefd9c7a715360f9db1f8b,1,19,0,19,1,2009-11-29 21:21:54,2009-11-29 21:21:54
1879e8cbeef6984495ee84f482900defda0dc3f4...ddb86f8d5bd1bd21b2beeeea55baf505b47dfed5,7,149,121,270,115,2009-11-27 20:09:14,2009-11-27 19:28:42
ddb86f8d5bd1bd21b2beeeea55baf505b47dfed5...a5efe9d3a6074ea39f677fdf21132badb0644bd3,1,1,1,2,1,2009-11-27 20:09:14,2009-11-27 19:29:44
a5efe9d3a6074ea39f677fdf21132badb0644bd3...255068da33e3d131b3a641c041fb8cecb1543fa4,2,4,4,8,4,2009-11-27 20:09:14,2009-11-27 19:31:28
2b7c38f80cf171ce830cd198ed2916a2c258a3cb...84857abefce7b5ec4f4018caf98d7d61e952789f,1,2,0,2,1,2009-11-30 18:00:06,2009-11-30 18:00:06
84857abefce7b5ec4f4018caf98d7d61e952789f...90ba57ce6d84653b4533569d88d4af6b9a50426b,1,1,1,2,1,2009-11-30 18:42:19,2009-11-30 18:42:19
84857abefce7b5ec4f4018caf98d7d61e952789f...17955cacf4e8c618ca5c2b09b0d2f43df353f683,2,12,1,13,2,2009-11-30 18:22:18,2009-11-30 18:21:56
df6e02a4a7d8da037ebdb812e6b92a067223a6ea...c7407bd4fc343783a4e723f21227a6ee43b9a934,1,1,1,2,1,2009-11-30 18:46:14,2009-11-30 18:46:14
c7407bd4fc343783a4e723f21227a6ee43b9a934...6e5a6a26a7d802b3abdc32d3b49f4936d1f63cd7,1,5,3,8,3,2009-11-30 18:50:25,2009-11-30 18:50:25
6e5a6a26a7d802b3abdc32d3b49f4936d1f63cd7...21dead4691dc5d6507e3651f00f9843b1314fb2b,1,2,2,4,1,2009-11-30 19:02:03,2009-11-30 19:02:03
21dead4691dc5d6507e3651f00f9843b1314fb2b...25c188b6d2b8a8758c2bd97ca45e0fb14b869431,2,22,17,39,9,2009-11-30 19:22:24,2009-11-30 19:22:24
25c188b6d2b8a8758c2bd97ca45e0fb14b869431...3ec9f4990c13f7e44365c9216be5c81b2827385b,1,2,2,4,2,2009-11-30 19:28:09,2009-11-30 19:28:09
3ec9f4990c13f7e44365c9216be5c81b2827385b...122e5dcf14291bfbaec23505c68e28b7f82aef85,1,1,1,2,1,2009-11-30 19:31:32,2009-11-30 19:31:32
122e5dcf14291bfbaec23505c68e28b7f82aef85...1a26e41917300708d817e96ca2141a01c982c096,1,1,1,2,1,2009-11-30 19:39:34,2009-11-30 19:39:34
1a26e41917300708d817e96ca2141a01c982c096...918cf68dfdaf057d6aa336be306b73eaede47a44,1,0,1,1,1,2009-11-30 20:08:55,2009-11-30 20:08:55
918cf68dfdaf057d6aa336be306b73eaede47a44...e514e67cd24db3daf7658d53138a4fbef5fdc0c2,2,2,2,4,2,2009-11-30 20:09:50,2009-11-30 20:09:50
e514e67cd24db3daf7658d53138a4fbef5fdc0c2...6798df54f40b316ce65c4e44e3c0370356956dd7,5,4,10,14,5,2009-11-30 20:45:16,2009-11-30 20:45:16
6798df54f40b316ce65c4e44e3c0370356956dd7...d605b8ee5667e4c26cf9c89f743e681938139162,1,4,4,8,1,2009-11-30 20:52:41,2009-11-30 20:52:41
d605b8ee5667e4c26cf9c89f743e681938139162...5480cd3fa181a2e105bba3c641ef58723fbd3521,1,3,7,10,4,2009-11-30 20:54:14,2009-11-30 20:54:14
5480cd3fa181a2e105bba3c641ef58723fbd3521...839e97199c66894e0d2cadbd6a9f09e6d5198656,1,8,1,9,1,2009-11-30 20:56:40,2009-11-30 20:56:40
839e97199c66894e0d2cadbd6a9f09e6d5198656...64e4a879f9f92053ac4d58a3fffc0bbff6900b6e,2,20,8,28,4,2009-12-01 19:40:28,2009-12-01 19:40:28
64e4a879f9f92053ac4d58a3fffc0bbff6900b6e...e277e6ed2120e9930193582307b8296ed37bd663,1,5,1,6,2,2009-12-01 22:11:32,2009-12-01 22:11:32
e277e6ed2120e9930193582307b8296ed37bd663...b8d0c0711f8a9ecd455d4c3cf13394e55c4bf151,1,45,0,45,1,2009-12-02 19:57:13,2009-12-02 19:57:13
b8d0c0711f8a9ecd455d4c3cf13394e55c4bf151...ad4f28631ac888e7ac8384b4b713012fd1ca2dca,1,1,1,2,1,2009-12-02 19:59:19,2009-12-02 19:59:19
ad4f28631ac888e7ac8384b4b713012fd1ca2dca...bfc15b57efb36ea4cedad3fe2c3645e7b6ad84de,1,0,4,4,2,2009-12-02 20:14:48,2009-12-02 20:14:48
bfc15b57efb36ea4cedad3fe2c3645e7b6ad84de...391f83b2a251abd5ab27aeb52a647a853906ce66,1,1,1,2,1,2009-12-02 20:20:33,2009-12-02 20:20:33
391f83b2a251abd5ab27aeb52a647a853906ce66...62436f4b292aadfe5419f897d7b8504054ab1c8c,1,20,15,35,2,2009-12-02 22:15:09,2009-12-02 22:15:09
62436f4b292aadfe5419f897d7b8504054ab1c8c...e534a310c7e99c44d93855ad5865ad5e985039ba,2,42,9,51,6,2009-12-03 00:05:51,2009-12-03 00:05:51
e534a310c7e99c44d93855ad5865ad5e985039ba...4daae7a79f43815935a2890d16904c5a052717f3,2,34,17,51,7,2009-12-03 15:51:04,2009-12-03 15:51:04
4daae7a79f43815935a2890d16904c5a052717f3...525bb27bc0ccfcf384a209773eb93dc1b5a8cc09,1,11,4,15,3,2009-12-03 16:05:12,2009-12-03 16:05:12
525bb27bc0ccfcf384a209773eb93dc1b5a8cc09...24e96ba22ca86e54f2442b88ffd2b7ea3f60f0bf,1,12,15,27,5,2009-12-03 16:14:10,2009-12-03 16:14:10
24e96ba22ca86e54f2442b88ffd2b7ea3f60f0bf...c3b2aa99288a7f7c4920c4add8c1aab272bbff4b,1,3,8,11,5,2009-12-03 16:15:26,2009-12-03 16:15:26
c3b2aa99288a7f7c4920c4add8c1aab272bbff4b...f0c32278b41c91f4ad29ca8371c5935c959802f1,1,3,6,9,1,2009-12-03 16:28:49,2009-12-03 16:28:49
f0c32278b41c91f4ad29ca8371c5935c959802f1...0f0fd1aee34b81411419ae3b152e03dfdf58b4f4,1,86,80,166,16,2009-12-03 16:45:38,2009-12-03 16:45:38
0f0fd1aee34b81411419ae3b152e03dfdf58b4f4...47293ebe15d7c475d432b843fa9a37800701055f,1,4,3,7,3,2009-12-03 16:59:59,2009-12-03 16:59:59
47293ebe15d7c475d432b843fa9a37800701055f...9d6c4d8413e678203a905ab3bc3a87415a6a70ce,1,4,7,11,4,2009-12-03 17:26:25,2009-12-03 17:26:25
9d6c4d8413e678203a905ab3bc3a87415a6a70ce...8a33a855b588bc398f31f971eb4b3c2f4cac84f7,1,8,1,9,2,2009-12-03 17:34:27,2009-12-03 17:34:27
8a33a855b588bc398f31f971eb4b3c2f4cac84f7...c2ebd0982609b98d6a389eea792d7a465dccc47a,1,1,1,2,1,2009-12-03 18:59:19,2009-12-03 18:59:19
c2ebd0982609b98d6a389eea792d7a465dccc47a...c6a0211e57cfc8da15f7993e71e27256aefc7f65,1,10,5,15,5,2009-12-03 19:20:06,2009-12-03 19:20:06
c6a0211e57cfc8da15f7993e71e27256aefc7f65...d42afd0f657d12d6daba6894d40226bea83fe1b6,4,409,58,467,25,2009-12-04 16:28:50,2009-12-04 16:28:50
d42afd0f657d12d6daba6894d40226bea83fe1b6...bbd933cbfe6d31a749cb336d7a84155ccfab247f,2,30,0,30,2,2009-12-04 17:06:47,2009-12-04 17:06:47
bbd933cbfe6d31a749cb336d7a84155ccfab247f...2b481b93cfca62f95aa7005e7db651456fa08e65,3,98,11,109,14,2009-12-04 17:28:47,2009-12-04 17:28:47
2b481b93cfca62f95aa7005e7db651456fa08e65...39a77c2d02d379d15bfe9c2e7b90c92d9cb3a34e,1,3,4,7,3,2009-12-04 17:36:24,2009-12-04 17:36:24
39a77c2d02d379d15bfe9c2e7b90c92d9cb3a34e...c90a1cb61b41a5686bc3764f144a156e734ed459,1,1,1,2,1,2009-12-04 17:51:47,2009-12-04 17:51:47
c90a1cb61b41a5686bc3764f144a156e734ed459...74f457d88093e4eca46bfd84374ec2b8dfb6f3b2,1,1,1,2,1,2009-12-04 17:53:09,2009-12-04 17:53:09
74f457d88093e4eca46bfd84374ec2b8dfb6f3b2...c7d640f000c6945a238aa99952b4b1b378775d7e,1,15,0,15,1,2009-12-05 02:18:43,2009-12-01 22:34:44
c7d640f000c6945a238aa99952b4b1b378775d7e...d684122be0ce3484fb9a4ead11db98d18c5805e7,1,1,1,2,1,2009-12-05 02:18:43,2009-12-05 02:18:37
d684122be0ce3484fb9a4ead11db98d18c5805e7...25b0ba9f9612583033b902a0e40345463a3a71d0,1,3,5,8,2,2009-12-05 02:20:58,2009-12-05 02:20:58
25b0ba9f9612583033b902a0e40345463a3a71d0...8d1efee3167deedd33bf7f6001823706659704ea,1,7,5,12,3,2009-12-05 04:18:05,2009-12-05 04:18:05
8d1efee3167deedd33bf7f6001823706659704ea...b24da33f52f8ce536ae60a6cbffeb2f5cf02bac5,2,10,1,11,2,2009-12-05 05:10:19,2009-12-05 05:10:19
b24da33f52f8ce536ae60a6cbffeb2f5cf02bac5...b776e2b79a5b051fba3091b0b5057ae14950f7cc,1,1,1,2,1,2009-12-05 19:33:40,2009-12-05 19:33:40
b776e2b79a5b051fba3091b0b5057ae14950f7cc...6071e939c7025ff7096673c93eaa7e2d78afbb6b,1,8,8,16,5,2009-12-05 20:02:45,2009-12-05 20:02:45
6071e939c7025ff7096673c93eaa7e2d78afbb6b...aae0617c834a030902cd8da2714f852d6a1431be,2,6,3,9,3,2009-12-05 20:12:02,2009-12-05 20:12:02
aae0617c834a030902cd8da2714f852d6a1431be...2a6de9ab66653e5e424d9cc79d195b555158d04f,2,19,2,21,3,2009-12-05 20:30:36,2009-12-05 20:30:36
2a6de9ab66653e5e424d9cc79d195b555158d04f...9c1db29a066d693ccbef82f18c99933637a37e65,1,1,1,2,1,2009-12-05 23:06:27,2009-12-05 23:06:27
9c1db29a066d693ccbef82f18c99933637a37e65...3afc6533e2396ac1752dc8ce677823f6506dd8dd,1,2,2,4,2,2009-12-06 00:55:54,2009-12-05 21:49:21
3afc6533e2396ac1752dc8ce677823f6506dd8dd...2d27e053a0e6ab4917a4f79918b58257600c5b82,1,5,5,10,4,2009-12-06 01:13:57,2009-11-30 20:04:55
2d27e053a0e6ab4917a4f79918b58257600c5b82...3c89e38fc26ef40797b83ba8ef4f8329b08afe75,2,40,1,41,2,2009-12-06 02:06:14,2009-12-06 02:06:14
3c89e38fc26ef40797b83ba8ef4f8329b08afe75...87ba780c69ac1af04afc40f2da39282d917f9108,2,11,11,22,11,2009-12-06 22:11:51,2009-12-06 22:11:51
87ba780c69ac1af04afc40f2da39282d917f9108...ebad701751689b773afe29d1e3c4532c7810d02a,8,230,242,472,9,2009-12-06 22:19:33,2009-12-06 22:19:33
3c89e38fc26ef40797b83ba8ef4f8329b08afe75...628e1564c48f2b4d18ed5af89ebed88b09d972d4,2,6,3,9,4,2009-12-06 02:31:57,2009-12-06 01:06:00
628e1564c48f2b4d18ed5af89ebed88b09d972d4...abbd2f4c3c93d9550cea81ccd6d6187c115eeb56,1,1,1,2,1,2009-12-06 02:31:57,2009-12-06 02:02:15
1fe9ff548251d44c36b051abaa14abb260831a4a...aea5b091954b3c823b318b392660b22c7b1e978a,1,17,0,17,2,2009-12-07 00:55:08,2009-12-07 00:55:08
aea5b091954b3c823b318b392660b22c7b1e978a...fbc73d45b487dd863886c7fd3f0af1fd4dec261b,2,34,4,38,6,2009-12-07 01:17:14,2009-12-07 01:17:14
fbc73d45b487dd863886c7fd3f0af1fd4dec261b...209278915592fc63bd62039e246046d446d329e0,2,6,1,7,3,2009-12-07 01:26:39,2009-12-07 01:26:39
209278915592fc63bd62039e246046d446d329e0...3f7fc25494988ee5be66c0af0d552b24f0ca1b79,2,2,14,16,2,2009-12-07 01:47:41,2009-12-07 01:47:41
3f7fc25494988ee5be66c0af0d552b24f0ca1b79...19ad49e607e91919210a766e17f67f0fc6af7af1,2,1,8,9,2,2009-12-07 01:52:31,2009-12-07 01:52:31
19ad49e607e91919210a766e17f67f0fc6af7af1...542099a278e79dce38e814e7e7b448a1b73df82f,2,15,24,39,6,2009-12-07 02:02:58,2009-12-07 02:02:58
542099a278e79dce38e814e7e7b448a1b73df82f...7d36ccfa8eb018fcf349e1f74e3a0a614385558f,1,11,12,23,7,2009-12-07 02:20:08,2009-12-07 02:20:08
7d36ccfa8eb018fcf349e1f74e3a0a614385558f...59802928566b6be3a66d65e77c2418fff37e6f5f,2,17,1,18,4,2009-12-07 04:00:31,2009-12-07 04:00:31
59802928566b6be3a66d65e77c2418fff37e6f5f...62a34450c0961e461a72ce4d96f94551ef393b56,1,3,1,4,1,2009-12-07 04:20:49,2009-12-07 04:20:49
62a34450c0961e461a72ce4d96f94551ef393b56...93fdbeb963a9c350f807818c7cc99982942a92f3,2,42,1,43,3,2009-12-07 08:11:46,2009-12-06 16:37:34
93fdbeb963a9c350f807818c7cc99982942a92f3...97323d192f368fb8fa4ab8c77fbd7da99b049800,1,2,0,2,1,2009-12-07 15:38:16,2009-12-07 15:38:16
97323d192f368fb8fa4ab8c77fbd7da99b049800...afaae84a7a56bcbb69cb772d9ea29766ad0a2aa6,4,6,3,9,7,2009-12-07 15:45:20,2009-12-07 15:45:20
afaae84a7a56bcbb69cb772d9ea29766ad0a2aa6...ed93204e108eb90aa863fbddf8acd992b9d4a1a5,1,2,2,4,2,2009-12-07 15:48:15,2009-12-07 15:48:15
ed93204e108eb90aa863fbddf8acd992b9d4a1a5...15f9d91c78f672823c807e4f3aa60788a85ed33f,1,1,1,2,1,2009-12-07 23:08:06,2009-12-07 23:08:06
15f9d91c78f672823c807e4f3aa60788a85ed33f...813886a4dff0cf4be62fea51c3ae8be9ef88e12a,1,2,0,2,2,2009-12-07 23:31:25,2009-12-07 23:31:25
813886a4dff0cf4be62fea51c3ae8be9ef88e12a...872d18c10e8ad1583b3a40671527355aa930aea7,1,1,1,2,1,2009-12-07 23:33:14,2009-12-07 23:33:14
872d18c10e8ad1583b3a40671527355aa930aea7...00a0abb751055964e9f1de202540a11e545f73d6,3,124,118,242,8,2009-12-08 00:34:55,2009-12-08 00:34:55
00a0abb751055964e9f1de202540a11e545f73d6...98ce35d52b17a033822f31d8a36232222d0d365e,2,11,9,20,8,2009-12-08 00:42:25,2009-12-08 00:42:25
98ce35d52b17a033822f31d8a36232222d0d365e...77510fec025e654a8d2fdc6b2cbb564c159b3204,1,1,1,2,1,2009-12-08 02:07:15,2009-12-08 02:07:15
77510fec025e654a8d2fdc6b2cbb564c159b3204...d2d17705a02462277a8a3af74d770892e680614f,1,0,28,28,4,2009-12-08 19:59:05,2009-12-08 19:59:05
d2d17705a02462277a8a3af74d770892e680614f...1d8f7f790d65d5aa1720789964e603382ece26c9,1,0,4,4,1,2009-12-08 20:17:26,2009-12-08 20:17:26
1d8f7f790d65d5aa1720789964e603382ece26c9...93adf60811524d6ef9ada12e826cb99cbf550663,1,1,2,3,2,2009-12-08 20:22:15,2009-12-08 20:22:15
93adf60811524d6ef9ada12e826cb99cbf550663...b3acfa5240ebe0fe1a8336f7497433ed869a0c3e,1,0,1,1,1,2009-12-08 20:27:27,2009-12-08 20:27:27
b3acfa5240ebe0fe1a8336f7497433ed869a0c3e...5778a35abd65673e2eb7f5012868203622c5b105,1,32,1,33,3,2009-12-08 21:03:22,2009-12-08 21:03:22
77510fec025e654a8d2fdc6b2cbb564c159b3204...f5b649fafbd85a1973a9c46ca6bf163d9de857a7,2,16,2,18,3,2009-12-08 19:21:24,2009-12-08 19:21:24
fde95fb5ccac0a2c303e4e8049bd3389a51ccd08...8d73fbd788705f5bec340a46ae0365325fd61b4a,1,26,39,65,8,2009-12-08 21:22:49,2009-12-08 21:22:49
8d73fbd788705f5bec340a46ae0365325fd61b4a...d3dc2d1234af10cb856519a01a97358eb4103008,1,2,2,4,1,2009-12-09 06:43:18,2009-12-09 03:46:07
d3dc2d1234af10cb856519a01a97358eb4103008...841f9ff7a1815b521044aeeb39ccbe70fa688201,2,9,2,11,3,2009-12-09 06:43:55,2009-12-07 23:43:36
841f9ff7a1815b521044aeeb39ccbe70fa688201...17791c9a3e8a88e129a6956e7053b964d7b34778,1,5,2,7,3,2009-12-09 06:52:32,2009-12-09 06:52:32
17791c9a3e8a88e129a6956e7053b964d7b34778...9e60fec46b2394541f75da3e333094d41069e84f,1,1,1,2,1,2009-12-09 16:09:41,2009-12-09 16:09:41
9e60fec46b2394541f75da3e333094d41069e84f...4e27f17007c2329e31b449e61bb31197b90a37f1,3,53,1,54,3,2009-12-09 20:43:13,2009-12-09 20:43:13
4e27f17007c2329e31b449e61bb31197b90a37f1...f6a0bf6816f4e2e67382b1b13fdd3ff2ea4b22f8,2,27,5,32,7,2009-12-09 21:16:18,2009-12-09 21:16:18
f6a0bf6816f4e2e67382b1b13fdd3ff2ea4b22f8...4b70f006f579fba24a882d80ca67f1971dbb4922,2,7,8,15,3,2009-12-09 21:28:58,2009-12-09 21:28:58
4b70f006f579fba24a882d80ca67f1971dbb4922...5e2163085cd210767d93416d78b2dc47c8abd912,1,1,1,2,1,2009-12-09 21:45:06,2009-12-09 21:45:06
5e2163085cd210767d93416d78b2dc47c8abd912...86bbf9cf87784cdd81ca79e4d809ef6f5879ef8b,1,2,2,4,2,2009-12-09 21:53:07,2009-12-09 21:53:07
86bbf9cf87784cdd81ca79e4d809ef6f5879ef8b...1052792bb23b56d25dcbacd3816c8b5a08bc9b72,2,39,4,43,3,2009-12-09 22:43:53,2009-12-09 22:43:53
1052792bb23b56d25dcbacd3816c8b5a08bc9b72...3ec2f1aef6b137d0f639e2fc53f95352d24b9d90,1,4,2,6,1,2009-12-09 22:49:31,2009-12-09 22:49:31
3ec2f1aef6b137d0f639e2fc53f95352d24b9d90...9d8bd161b6548b33fe6c834a65bb1733c07ea29c,1,3,4,7,3,2009-12-09 23:07:16,2009-12-09 23:07:16
9d8bd161b6548b33fe6c834a65bb1733c07ea29c...b846ad4ca060a100dec3ace5711f96a083bc4ac3,1,4,1,5,1,2009-12-10 00:00:59,2009-12-10 00:00:59
b846ad4ca060a100dec3ace5711f96a083bc4ac3...04524287d3e0112deae570ff9247c734833431bb,2,2,4,6,2,2009-12-10 04:36:07,2009-12-10 04:36:07
04524287d3e0112deae570ff9247c734833431bb...6bec6199c255b4fd3fa11b4682d97f2d0658ea4d,1,2,1,3,1,2009-12-10 04:37:14,2009-12-10 04:37:14
6bec6199c255b4fd3fa11b4682d97f2d0658ea4d...4e9fed3b16ed9612ed373d14a89294e98054f4dd,2,5,3,8,3,2009-12-10 04:51:58,2009-12-10 04:51:58
4e9fed3b16ed9612ed373d14a89294e98054f4dd...cf72fba64fd164507752376a578dee7919cec911,1,7,1,8,1,2009-12-10 04:58:49,2009-12-10 04:58:49
4e9fed3b16ed9612ed373d14a89294e98054f4dd...da51cd0e43d6d61e0d3d6c197cef1e658bad29bc,4,93,28,121,36,2009-12-10 04:57:53,2009-12-10 04:57:19
b3cee01820adde707428d68fcf02b0fdf53fe527...1a4d1904ae8631f94b7400d99af24d3fe2f33ecd,5,37,44,81,20,2009-12-10 05:17:10,2009-12-10 05:15:49
1a4d1904ae8631f94b7400d99af24d3fe2f33ecd...f25eedf32a7555f71a246c6f491292ce876c4133,2,20,1,21,3,2009-12-10 05:28:33,2009-12-10 05:28:33
f25eedf32a7555f71a246c6f491292ce876c4133...715d1c5a30cc4986018bbf063713f14c34c3e258,2,16,15,31,5,2009-12-10 05:43:20,2009-12-10 05:43:20
715d1c5a30cc4986018bbf063713f14c34c3e258...a5f8a1441158b66efb76de1d15f061f87f7bdc17,2,13,4,17,6,2009-12-10 05:58:29,2009-12-10 05:58:29
a5f8a1441158b66efb76de1d15f061f87f7bdc17...88572ee6924c2322c9d405280b493c4a894f14e2,2,4,2,6,3,2009-12-10 06:03:14,2009-12-10 06:03:14
88572ee6924c2322c9d405280b493c4a894f14e2...5473b041c07a370b696e16f9f73a8f6f47f34259,1,1,0,1,1,2009-12-10 07:45:56,2009-12-10 07:45:56
5473b041c07a370b696e16f9f73a8f6f47f34259...616aceef84dca3960f6b78680f41bdcf85fa7838,1,1,0,1,1,2009-12-10 07:49:13,2009-12-10 07:49:13
616aceef84dca3960f6b78680f41bdcf85fa7838...80913618b0a54a1788a4e0edc3820cf6ddf04fec,1,1,1,2,1,2009-12-10 07:56:47,2009-12-10 07:56:47
80913618b0a54a1788a4e0edc3820cf6ddf04fec...ede2f2c4f76aba3c0a279d8ca26e8176942cd83f,1,9,10,19,6,2009-12-10 17:07:19,2009-12-10 17:07:19
ede2f2c4f76aba3c0a279d8ca26e8176942cd83f...474d814076963f41157c0054448984c00fd46c1b,4,164,164,328,14,2009-12-10 17:25:25,2009-12-10 17:25:25
474d814076963f41157c0054448984c00fd46c1b...ecdcda870c70c262ec3198e067dd06e847f682dd,1,2,1,3,1,2009-12-10 22:03:24,2009-12-10 22:03:24
ecdcda870c70c262ec3198e067dd06e847f682dd...0ab118ae0d1f239e96f433fbbb65eee87bd529d9,1,1,10,11,3,2009-12-10 22:40:11,2009-12-10 22:40:11
0ab118ae0d1f239e96f433fbbb65eee87bd529d9...1bac61655b6c323ab4bcfc65b0d95c1587dd8503,1,12,32,44,8,2009-12-10 22:44:30,2009-12-10 22:44:30
1bac61655b6c323ab4bcfc65b0d95c1587dd8503...65ebf57c1e5d7fa96536b66d4fcacbafad8dc1e5,2,11,3,14,6,2009-12-11 01:01:04,2009-12-11 01:01:04
65ebf57c1e5d7fa96536b66d4fcacbafad8dc1e5...253e73af5173413b2938f911087d361e42cf0763,1,1,1,2,1,2009-12-11 20:49:22,2009-12-11 20:49:22
65ebf57c1e5d7fa96536b66d4fcacbafad8dc1e5...638c093b857197c0b25bd8b1ba5a9b00f82b39d5,2,3,3,6,2,2009-12-11 20:47:41,2009-12-11 20:47:41
65ebf57c1e5d7fa96536b66d4fcacbafad8dc1e5...5197ac9fc8aa71c2ebc0d7217f41a3679eb1b902,2,3,3,6,2,2009-12-11 19:46:38,2009-12-11 19:46:38
5b51cc92fcb320dcb638718ea56c3f4806072c71...b4b30cc6837dc5480f3d1a3da0cb9fe12dfc9b72,1,1,1,2,1,2009-12-14 06:15:02,2009-12-14 06:15:02
b4b30cc6837dc5480f3d1a3da0cb9fe12dfc9b72...649024909d376032e6e9c41f209182d584e51043,2,25,9,34,10,2009-12-14 21:24:28,2009-12-14 21:24:28
649024909d376032e6e9c41f209182d584e51043...fe9333cc792eecf98189f8fd18daf64b64dff049,1,2,3,5,2,2009-12-16 20:42:03,2009-12-16 20:42:03
fe9333cc792eecf98189f8fd18daf64b64dff049...9997620420ec0baf7dba8ce9dee0f19e616e1bc4,2,57,31,88,8,2009-12-16 21:45:00,2009-12-16 21:45:00
9997620420ec0baf7dba8ce9dee0f19e616e1bc4...f078e930edb25190bb04c682ad067b72331b6e69,1,1,1,2,2,2009-12-16 21:54:21,2009-12-16 21:54:21
f078e930edb25190bb04c682ad067b72331b6e69...de659859333c4e1a7840cc8d43765f47fcf53e9f,1,2,0,2,1,2009-12-16 22:08:10,2009-12-16 22:08:10
de659859333c4e1a7840cc8d43765f47fcf53e9f...9a0174b057ae58735c3c5f595e420c7bb1db038c,1,2,2,4,2,2009-12-17 04:09:55,2009-12-17 04:09:55
9a0174b057ae58735c3c5f595e420c7bb1db038c...100ed686426b8b404b094b8c8086aefce715f91a,1,1,5,6,3,2009-12-17 17:23:04,2009-12-17 17:23:04
100ed686426b8b404b094b8c8086aefce715f91a...892fb555477dc96f58e3f8fd5446f7990188fc21,1,1,1,2,1,2009-12-17 18:15:12,2009-12-17 18:15:12
892fb555477dc96f58e3f8fd5446f7990188fc21...3a4bcf8a9ca6d3a986858d2572b356176ae06012,1,6,2,8,3,2009-12-17 18:23:39,2009-12-17 18:23:39
3a4bcf8a9ca6d3a986858d2572b356176ae06012...ba86cc0294e483752fd76f620aba6d0a4a7a8ee1,1,3,1,4,2,2009-12-17 18:34:38,2009-12-17 18:34:38
ba86cc0294e483752fd76f620aba6d0a4a7a8ee1...ed5731dcc41db31fd699d1f4e4b250e83b10308e,2,3,8,11,3,2009-12-17 19:17:05,2009-12-17 19:17:05
ed5731dcc41db31fd699d1f4e4b250e83b10308e...1d921e21714ab98421abaee1e1003b4497a950f9,1,1,4,5,2,2009-12-17 19:18:15,2009-12-17 19:18:15
1d921e21714ab98421abaee1e1003b4497a950f9...aa81bb5e458efd25981933c339ac1a0090e6eb0f,1,3,3,6,3,2009-12-17 19:58:16,2009-12-14 15:56:01
aa81bb5e458efd25981933c339ac1a0090e6eb0f...927e1966debda40d8def96b6a4ea35d2a9d5423c,2,47,32,79,8,2009-12-17 20:01:05,2009-12-16 03:54:12
927e1966debda40d8def96b6a4ea35d2a9d5423c...04b92e78315c9c5650db6d8c25f90e7158070862,1,34,35,69,3,2009-12-17 20:01:05,2009-12-16 12:41:56
04b92e78315c9c5650db6d8c25f90e7158070862...d85d366fbffd9d46ac4153b2756866d77487e58d,1,1,1,2,1,2009-12-17 20:01:39,2009-12-15 02:45:22
d85d366fbffd9d46ac4153b2756866d77487e58d...6bc222e7a19d620a79a0b2af46c98664218a81a3,1,1,1,2,1,2009-12-17 20:04:07,2009-12-17 20:04:07
6bc222e7a19d620a79a0b2af46c98664218a81a3...b31b9bd756a1489c3b1b856ed8b624c55da9e02f,2,12,5,17,7,2009-12-17 20:05:45,2009-12-17 02:02:58
b31b9bd756a1489c3b1b856ed8b624c55da9e02f...fe7e2fee1673d76130b40488c61982b081aff29f,1,1,1,2,1,2009-12-17 20:06:54,2009-12-17 02:13:50
fe7e2fee1673d76130b40488c61982b081aff29f...9368b188c06dd66d43e3a488465078e1d6eb765f,1,0,4,4,1,2009-12-18 15:54:34,2009-12-18 15:54:34
9368b188c06dd66d43e3a488465078e1d6eb765f...b70872f70d720e5f25eea7fdf0453804074dc194,6,6,6,12,6,2009-12-18 16:01:19,2009-12-18 16:01:19
b70872f70d720e5f25eea7fdf0453804074dc194...99d83fbd6d0391a2300d5c3de7e59bb9942553be,1,88,64,152,62,2009-12-18 16:16:26,2009-12-18 16:16:26
99d83fbd6d0391a2300d5c3de7e59bb9942553be...f0366306923ecf97b487032d61c2fcc2b4b068c4,1,58,35,93,44,2009-12-18 16:27:56,2009-12-18 16:27:56
f0366306923ecf97b487032d61c2fcc2b4b068c4...27d65b59f96460987abb84dadc3a75dde8826b3a,1,1,8,9,1,2009-12-18 16:30:04,2009-12-18 16:30:04
27d65b59f96460987abb84dadc3a75dde8826b3a...148fb7ba8e992dd70c64cdc6a1c6f643fd1ba160,2,20,5,25,6,2009-12-18 17:19:34,2009-12-18 16:34:20
148fb7ba8e992dd70c64cdc6a1c6f643fd1ba160...d40083c866738727aa7ffd7f13d2955bc9575d5e,4,35,13,48,14,2009-12-18 17:41:53,2009-12-18 17:41:53
d40083c866738727aa7ffd7f13d2955bc9575d5e...c05712f0a51a137c9243cbc33b4cb0d5d853a80d,1,11,11,22,2,2009-12-18 17:43:35,2009-12-18 17:43:35
c05712f0a51a137c9243cbc33b4cb0d5d853a80d...5e811146ee34fde5fa60e142e7ee4422e2748024,1,3,2,5,2,2009-12-19 00:24:19,2009-12-19 00:24:19
5e811146ee34fde5fa60e142e7ee4422e2748024...67b3be24e1215609cca524ee8158fc7e6e80db93,1,2,1,3,1,2009-12-19 00:36:35,2009-12-19 00:36:35
67b3be24e1215609cca524ee8158fc7e6e80db93...298bfb79e6acfe2c0e3b1845a05291af82910ace,1,1,1,2,1,2009-12-19 00:43:04,2009-12-19 00:43:04
298bfb79e6acfe2c0e3b1845a05291af82910ace...1c7d3155f0afbd331b09ebd2fc3081d3a9834994,1,1,2,3,2,2009-12-19 00:47:53,2009-12-19 00:47:53
1c7d3155f0afbd331b09ebd2fc3081d3a9834994...92d6ce5aa09301372318b4f5ec3884fe61723823,1,1,1,2,1,2009-12-19 00:50:20,2009-12-19 00:50:20
92d6ce5aa09301372318b4f5ec3884fe61723823...a0af1a8f88b625fff3e7a582c775de45702ced8d,1,1,1,2,1,2009-12-19 00:50:24,2009-12-19 00:50:24
a0af1a8f88b625fff3e7a582c775de45702ced8d...f745357baec82e0be59c651f70d1e489f237c398,1,1,1,2,1,2009-12-19 00:58:11,2009-12-19 00:58:11
f745357baec82e0be59c651f70d1e489f237c398...0d06f3997be54896ab99e2ab0975dc7c144e7955,1,1,1,2,1,2009-12-19 00:58:15,2009-12-19 00:58:15
0d06f3997be54896ab99e2ab0975dc7c144e7955...42f8c3add3e0e4370d4bd6816bf471e07baf34be,1,11,11,22,2,2009-12-19 01:29:22,2009-12-19 01:29:22
42f8c3add3e0e4370d4bd6816bf471e07baf34be...3fd62eae9df3159fc238a515bb748140a942313d,5,25,8,33,7,2009-12-19 02:23:26,2009-12-19 02:23:26
3fd62eae9df3159fc238a515bb748140a942313d...1feb92afb42d5213e2705290761779260bbd1fa4,1,1,1,2,1,2009-12-19 03:35:02,2009-12-19 03:35:02
1feb92afb42d5213e2705290761779260bbd1fa4...f0505c6d75722d5617dedfd5f6165285c18103c8,2,27,11,38,11,2009-12-19 22:50:56,2009-12-19 22:50:56
f0505c6d75722d5617dedfd5f6165285c18103c8...0d5bd174614fa278826ac4aaaa64342f17c0ae56,2,15,5,20,4,2009-12-21 16:11:03,2009-12-21 16:11:03
0d5bd174614fa278826ac4aaaa64342f17c0ae56...d7a00234abb07658b47b098a318af334ff3b2509,1,2,2,4,2,2009-12-21 17:54:39,2009-12-21 17:54:39
d7a00234abb07658b47b098a318af334ff3b2509...5dc6b7ce3469eaadb37a151d449e8d36571d1894,3,224,167,391,31,2009-12-21 20:32:32,2009-12-21 20:32:32
5dc6b7ce3469eaadb37a151d449e8d36571d1894...03481a52c72e417b01cfeb499f26738cf5ed5839,3,39,17,56,6,2009-12-21 21:10:21,2009-12-21 21:10:21
03481a52c72e417b01cfeb499f26738cf5ed5839...209751fcbd8a42eef68df44c875763b6af8a5474,1,1,1,2,1,2009-12-21 21:24:03,2009-12-21 21:24:03
209751fcbd8a42eef68df44c875763b6af8a5474...e083d15fc786a853e54b800e3798536f1d958301,4,6,6,12,6,2009-12-21 23:02:02,2009-12-21 23:02:02
e083d15fc786a853e54b800e3798536f1d958301...36c99dc0c7a745a88488f519b38de811d6d4c8d9,1,11,4,15,7,2009-12-21 23:06:23,2009-12-21 23:06:23
36c99dc0c7a745a88488f519b38de811d6d4c8d9...61e37d41490aed319a176c6ca7feb95e5505059c,14,218,130,348,119,2009-12-22 00:58:13,2009-12-22 00:58:13
61e37d41490aed319a176c6ca7feb95e5505059c...3776cbe314ac6f5081e998c3d5ac84d3fbc51872,8,31,30,61,23,2009-12-22 01:13:16,2009-12-22 01:13:16
3776cbe314ac6f5081e998c3d5ac84d3fbc51872...7e69fdbad4d4bf05e94d22fd4a3e0a9fe625fc69,1,1,1,2,1,2009-12-22 01:19:49,2009-12-22 01:19:49
7e69fdbad4d4bf05e94d22fd4a3e0a9fe625fc69...c97e914d40a8a24b47f2b6ef4f706b5367d94ee2,1,1,1,2,1,2009-12-22 04:23:03,2009-12-22 04:23:03
c97e914d40a8a24b47f2b6ef4f706b5367d94ee2...261b7efb5f86a5c9a3de8434f3cad858101e4249,2,7,2,9,3,2009-12-22 05:24:23,2009-12-22 05:24:23
261b7efb5f86a5c9a3de8434f3cad858101e4249...f298cce100c6fe23840ac95e66aaea9cb2bfb447,2,18,2,20,3,2009-12-22 06:18:49,2009-12-22 06:18:49
f298cce100c6fe23840ac95e66aaea9cb2bfb447...1b67aaee74c9b683ac31893b40077abd62e6d8c6,1,3,1,4,1,2009-12-22 06:28:37,2009-12-22 06:28:37
1b67aaee74c9b683ac31893b40077abd62e6d8c6...1e64d581830f735999b60939eccf9bcdcb2e9ef9,3,24,6,30,9,2009-12-22 07:00:46,2009-12-22 07:00:46
1e64d581830f735999b60939eccf9bcdcb2e9ef9...e87b090cb706b495b6c48e960d6c059c7fbddbd9,1,1,3,4,1,2009-12-22 07:03:41,2009-12-22 07:03:41
e87b090cb706b495b6c48e960d6c059c7fbddbd9...1ea539b4f08d9056e7e133173f7093908a513f77,1,3,1,4,3,2009-12-22 16:54:54,2009-12-22 16:54:54
1ea539b4f08d9056e7e133173f7093908a513f77...7d0c18034e1a7967c1aabc84e66e6fd020cd541d,1,12,1,13,1,2009-12-22 17:04:17,2009-12-22 17:04:17
7d0c18034e1a7967c1aabc84e66e6fd020cd541d...9360cccc9eb276cfd571066d87bb099d5d109516,1,1,1,2,1,2009-12-22 18:28:46,2009-12-22 18:28:46
7d0c18034e1a7967c1aabc84e66e6fd020cd541d...39518945047413f1185682078043e70e0c5c9091,2,22,12,34,10,2009-12-22 17:49:53,2009-12-22 13:09:56
baff0b0c852d37c1fdcb16167f27c0c589289960...4729f4d44326fd302c63af8f3324b6c4bac54084,2,15,4,19,4,2009-12-22 20:02:52,2009-12-22 20:02:52
4729f4d44326fd302c63af8f3324b6c4bac54084...7b0b348419c85841671459b4d7153afc88d1fa83,1,1,1,2,1,2009-12-22 20:06:27,2009-12-22 20:06:27
7b0b348419c85841671459b4d7153afc88d1fa83...a00e63ea5a2c26f8e6384b5d1e2247be44c727e9,2,15,8,23,4,2009-12-22 20:46:54,2009-12-22 20:46:54
a00e63ea5a2c26f8e6384b5d1e2247be44c727e9...ea5d51400820585a6d31011e1a1109c5a1213360,1,5,3,8,1,2009-12-31 05:49:53,2009-12-31 05:49:53
ea5d51400820585a6d31011e1a1109c5a1213360...6cf981eea20695987b4f7341f80442a7cf8271eb,1,4,4,8,1,2009-12-31 14:59:16,2009-12-31 14:59:16
a00e63ea5a2c26f8e6384b5d1e2247be44c727e9...66975de2d249643779e2b3daad0457f7f5f92508,2,35,35,70,16,2009-12-31 05:37:23,2009-12-31 05:37:23
66975de2d249643779e2b3daad0457f7f5f92508...a5dbca4a06a930865a17a1d02fd88893b5a2b690,2,23,20,43,5,2009-12-31 20:06:45,2009-12-31 20:06:45
a5dbca4a06a930865a17a1d02fd88893b5a2b690...1d2b1a57dae0b73b3d99197f73f4edb623b5574a,2,37,7,44,4,2009-12-31 20:17:52,2009-12-31 20:17:52
1d2b1a57dae0b73b3d99197f73f4edb623b5574a...8db0dd2c64e52e1eebb57d4749d03e276d49fb44,1,4,0,4,1,2010-01-06 00:17:28,2010-01-06 00:17:28
a00e63ea5a2c26f8e6384b5d1e2247be44c727e9...fe6c86d53046b0f4d648f61c0b8e75387af65152,1,16,29,45,4,2009-12-31 04:53:06,2009-12-31 04:53:06
fe6c86d53046b0f4d648f61c0b8e75387af65152...6cb2945837ccca55204191a8e7a70b2b2486c28e,4,6,4,10,5,2009-12-31 14:50:49,2009-12-31 14:50:49
40ce7f98301e4ff0d912f91025af0fd7b82107bd...3d35a97247297eb5b1d41ed506be3bb1d88a511f,1,1,1,2,1,2010-01-03 17:54:41,2010-01-03 17:54:41
3d35a97247297eb5b1d41ed506be3bb1d88a511f...25ee9cee26c9c4170693908fbe233154e8158d69,1,2,2,4,2,2010-01-04 01:04:24,2010-01-04 01:04:24
25ee9cee26c9c4170693908fbe233154e8158d69...b2289f3ec174c5b22d130d8c36a5e07daa6d02df,1,5,4,9,2,2010-01-05 15:57:30,2010-01-05 15:57:30
b2289f3ec174c5b22d130d8c36a5e07daa6d02df...3f648c4e3abe236b8ec6a19822313be794e5a9df,1,12,3,15,2,2010-01-05 16:35:11,2010-01-05 16:35:11
230614b4df313493813d688b63ab68f3812a0030...787f271052220c20787104f0eba6441aedac22ff,3,26,2,28,5,2010-01-06 00:48:16,2010-01-06 00:48:16
787f271052220c20787104f0eba6441aedac22ff...6861b5d4eb16222ed5ea623af6ce75362b55d1d4,3,25,6,31,6,2010-01-06 15:19:38,2010-01-06 15:19:38
3f648c4e3abe236b8ec6a19822313be794e5a9df...ff3645ee05ca5cb416b7d3500a45a4410ce0470a,1,4,2,6,2,2010-01-05 22:33:41,2010-01-05 22:33:41
3f648c4e3abe236b8ec6a19822313be794e5a9df...ffb1867a4364ea65e60dad3469e8c8eb420ebcac,3,312,43,355,7,2010-01-05 22:01:20,2010-01-05 22:01:20
6861b5d4eb16222ed5ea623af6ce75362b55d1d4...e9d5947b4abbc052046585227892da0adcd56caf,2,31,5,36,8,2010-01-06 16:32:29,2010-01-06 16:32:29
6861b5d4eb16222ed5ea623af6ce75362b55d1d4...0d1a2c1b1145ad17bec061a231b8426b3424d144,2,11,6,17,4,2010-01-06 16:11:22,2010-01-04 21:25:14
e424e01c47084f29d83a643cc5540fd37b85c68d...84dd82eb1a295e8671a98ebf5a854dbac63caf78,1,24,0,24,1,2010-01-06 17:13:56,2010-01-06 17:13:56
84dd82eb1a295e8671a98ebf5a854dbac63caf78...c68fbc2071f67876edbb3fca202362aecb82ca9c,1,5,6,11,3,2010-01-07 15:00:55,2010-01-07 15:00:55
c68fbc2071f67876edbb3fca202362aecb82ca9c...c14fa516ae5525f93af562910d22f0a836ebdde3,1,3,3,6,2,2010-01-07 16:54:26,2010-01-07 16:54:26
c14fa516ae5525f93af562910d22f0a836ebdde3...308d6cdad023da190ace2a698ee4815ed8dad9c5,3,34,8,42,8,2010-01-07 17:21:58,2010-01-07 17:21:58
308d6cdad023da190ace2a698ee4815ed8dad9c5...a9665bbe9bb50b060b3f8f2f5facf2e1d1115f37,1,1,1,2,1,2010-01-07 17:25:50,2010-01-07 17:25:50
84dd82eb1a295e8671a98ebf5a854dbac63caf78...600d3145386a9dca8143918cc3e339168f886a63,3,72,60,132,13,2010-01-06 20:08:07,2010-01-06 20:08:07
600d3145386a9dca8143918cc3e339168f886a63...2526e293538c0959597fee60976b4360390d69e0,1,11,10,21,7,2010-01-06 20:23:30,2010-01-06 20:23:30
2526e293538c0959597fee60976b4360390d69e0...4681216c4bdf25b6b146b3f952917f46079c6ef7,2,13,18,31,7,2010-01-07 14:53:16,2010-01-07 14:53:16
4681216c4bdf25b6b146b3f952917f46079c6ef7...12e8f07e343b49042bd9a2035411c74b51ed7550,2,86,86,172,2,2010-01-07 14:55:15,2010-01-07 14:55:15
12e8f07e343b49042bd9a2035411c74b51ed7550...d36b29fa8e24820e0d1feb6a4ab46c440f54155a,1,1,1,2,1,2010-01-07 16:04:21,2010-01-07 16:04:21
d36b29fa8e24820e0d1feb6a4ab46c440f54155a...21e15219be8e04b3fe25d05a65abfaef96830b9f,1,1,8,9,1,2010-01-07 16:14:56,2010-01-07 16:14:56
21e15219be8e04b3fe25d05a65abfaef96830b9f...f126f1ce857f11154a8378fc7e0b04a00d803682,1,141,9,150,7,2010-01-07 16:15:40,2010-01-07 16:15:40
f126f1ce857f11154a8378fc7e0b04a00d803682...cc1a34852f02a9304c555fefba470b28f0a6f8b2,1,37,26,63,4,2010-01-07 16:51:48,2010-01-07 16:51:48
cc1a34852f02a9304c555fefba470b28f0a6f8b2...8fa9e9d6d0307a5af8d7478d6e030af5afabba9e,1,8,0,8,1,2010-01-07 18:33:30,2010-01-07 18:33:30
8fa9e9d6d0307a5af8d7478d6e030af5afabba9e...22ff8e9ea46be4b145aa4963083d7c2d99ce9b0c,1,175,3,178,4,2010-01-07 18:34:16,2010-01-07 18:34:16
22ff8e9ea46be4b145aa4963083d7c2d99ce9b0c...0bb4fd0af72846467a4c86a47f9cfa72874c21ae,1,43,49,92,13,2010-01-07 18:44:53,2010-01-07 18:44:53
0bb4fd0af72846467a4c86a47f9cfa72874c21ae...ebaf374f2ac02e224ff0d0775b9709579404dd58,1,60,0,60,2,2010-01-07 18:52:20,2010-01-07 18:52:20
ebaf374f2ac02e224ff0d0775b9709579404dd58...4fa00369f00b8ee708c8962135b7aa345e3d30d0,2,38,26,64,13,2010-01-07 19:07:21,2010-01-07 19:07:21
4fa00369f00b8ee708c8962135b7aa345e3d30d0...0e5370b89c0dfe56bf2f02fdd34fd820ecd48254,1,3,3,6,3,2010-01-07 19:08:32,2010-01-07 19:08:32
d6d5ed4c683ceee4d3c64ce75e7349dde8205d50...5a0ac24e35c07fe4be22df828e6b909fe65237b9,1,3,0,3,1,2010-01-11 17:26:28,2010-01-11 17:26:28
5a0ac24e35c07fe4be22df828e6b909fe65237b9...366039a6f05ffa09630e95be604e3f4f26a33bd6,2,5,31,36,8,2010-01-11 18:48:40,2010-01-11 18:48:40
366039a6f05ffa09630e95be604e3f4f26a33bd6...36a98b95c2f3f7617ddf51beec7515acf67d98ba,2,11,2,13,3,2010-01-11 20:57:45,2010-01-11 20:57:45
36a98b95c2f3f7617ddf51beec7515acf67d98ba...cb4880ee8353b5fc1a8a509cb0caf3a82818da0a,1,5,1,6,4,2010-01-11 21:08:39,2010-01-11 21:08:39
cb4880ee8353b5fc1a8a509cb0caf3a82818da0a...3e9ef6f5c08e63a90ef2dfd3bdc833994e7a0ac8,2,20,4,24,5,2010-01-11 21:25:01,2010-01-11 21:25:01
3e9ef6f5c08e63a90ef2dfd3bdc833994e7a0ac8...23d600c66d8e1f7298dcb46eedba862279cd251d,2,14,2,16,3,2010-01-11 21:31:31,2010-01-11 21:31:31
23d600c66d8e1f7298dcb46eedba862279cd251d...44e6beb10304789044de2c5a58f5bb82e8321636,1,9,6,15,5,2010-01-11 21:43:21,2010-01-11 21:43:21
44e6beb10304789044de2c5a58f5bb82e8321636...31252b1e4752d70eb895a659b41a85850ed727b4,1,2,3,5,3,2010-01-11 22:29:48,2010-01-11 22:29:48
31252b1e4752d70eb895a659b41a85850ed727b4...2c8af19a06c49dc2121d968c2609087b0a54e894,1,12,4,16,4,2010-01-12 04:32:11,2010-01-12 04:32:11
31252b1e4752d70eb895a659b41a85850ed727b4...8d7965a607bf91ec6855b626ab3885cd3488d167,1,1,1,2,1,2010-01-12 03:42:22,2010-01-06 19:23:39
8d7965a607bf91ec6855b626ab3885cd3488d167...f14fadef7311ace7333b6522d4b6f44a9e54d6dc,1,18,1,19,2,2010-01-12 03:42:30,2010-01-12 02:30:02
f14fadef7311ace7333b6522d4b6f44a9e54d6dc...7be5ec1248c749ece648c8d80a71b45320556381,1,2,2,4,1,2010-01-12 03:42:31,2010-01-12 03:32:06
6114565ab54f507476ba093496bb917beca65c54...4151ddef9d912ea48a404cfe4a0cf439a1f46815,1,3,1,4,3,2010-01-12 04:55:02,2010-01-12 04:55:02
4151ddef9d912ea48a404cfe4a0cf439a1f46815...7afe6dcc0837ac00cea7fbb7de6fb95b745148c2,2,20,2,22,3,2010-01-12 15:31:51,2010-01-12 15:31:51
7afe6dcc0837ac00cea7fbb7de6fb95b745148c2...c320e4f3c2174148e5c13276237abb01547d52f5,1,1,1,2,1,2010-01-12 15:33:04,2010-01-12 15:33:04
c320e4f3c2174148e5c13276237abb01547d52f5...d60b19781095f508e32a590c7ee112817b0794ee,1,7,4,11,2,2010-01-12 15:47:00,2010-01-12 15:47:00
d60b19781095f508e32a590c7ee112817b0794ee...dd45c324ecf12732185656de89b40d47e3b9d3ad,1,9,12,21,6,2010-01-12 15:59:50,2010-01-12 15:59:50
dd45c324ecf12732185656de89b40d47e3b9d3ad...857d8afd6917775b7cef6fd22e57dd9acec77f01,1,1,1,2,1,2010-01-12 16:06:32,2010-01-12 16:06:32
857d8afd6917775b7cef6fd22e57dd9acec77f01...6776920301308e1c7f251a67bbecbb6761a1f7b7,1,1,1,2,1,2010-01-12 16:06:40,2010-01-12 16:06:40
6776920301308e1c7f251a67bbecbb6761a1f7b7...61983cbf176c599687c36ffbf4b64ae8697486a3,1,1,2,3,2,2010-01-12 21:50:59,2010-01-12 21:50:59
61983cbf176c599687c36ffbf4b64ae8697486a3...1d8b3a9af22c6c34383b6653ecc1e44c48325b94,1,1,1,2,1,2010-01-12 22:03:34,2010-01-12 22:03:34
1d8b3a9af22c6c34383b6653ecc1e44c48325b94...b5f077ae6af6d644c5ae58ba9fd79a08dc58ba1e,1,3,1,4,1,2010-01-13 02:44:37,2010-01-13 02:44:37
b5f077ae6af6d644c5ae58ba9fd79a08dc58ba1e...8e53f7b5d6716e60d8c8ea7e167f2b187aae9d89,5,12,6,18,10,2010-01-13 02:54:06,2010-01-13 02:54:06
8e53f7b5d6716e60d8c8ea7e167f2b187aae9d89...5d49335eace4311de890b871e057d8b6e9122eb6,2,18,7,25,4,2010-01-13 05:12:18,2010-01-13 05:12:18
5d49335eace4311de890b871e057d8b6e9122eb6...23492fdf9fa6f2c3b8ee85d062fed74297f3c438,1,1,1,2,1,2010-01-13 05:42:22,2010-01-13 05:42:22
23492fdf9fa6f2c3b8ee85d062fed74297f3c438...05aaa3395723bbb48906ee8a99464a2c4e1e4193,2,4,3,7,3,2010-01-13 14:29:01,2010-01-13 14:29:01
05aaa3395723bbb48906ee8a99464a2c4e1e4193...1960f28c0bf75b16e88460d6135058fd93202322,1,6,0,6,1,2010-01-13 16:24:54,2010-01-13 16:24:54
1960f28c0bf75b16e88460d6135058fd93202322...d431519d61f55af8bd1714d00126c948d888f3a9,1,8,8,16,6,2010-01-13 20:23:05,2010-01-13 20:23:05
d431519d61f55af8bd1714d00126c948d888f3a9...812a247dc997fa09583c0557c6173f9ec58e7d60,1,1,1,2,1,2010-01-13 20:25:28,2010-01-13 20:25:28
812a247dc997fa09583c0557c6173f9ec58e7d60...4397f0fd41064346bce16772eec78cd5d2a1682e,1,1,2,3,2,2010-01-14 06:42:08,2010-01-14 06:42:08
812a247dc997fa09583c0557c6173f9ec58e7d60...37b909de6948ebb704375626831bfc80bd31290c,1,0,5,5,1,2010-01-14 05:45:29,2010-01-14 05:45:29
201816d8c541e3b93d9a955af680999b6f690a38...eb496f757a1eebef14eb5a1fdd971cc553f3540b,1,0,6,6,1,2010-01-15 15:49:18,2010-01-15 15:49:18
eb496f757a1eebef14eb5a1fdd971cc553f3540b...199a721103b17c18dea7a9abaeb79866ef4a7f51,1,2,0,2,1,2010-01-15 20:41:09,2010-01-15 20:41:09
199a721103b17c18dea7a9abaeb79866ef4a7f51...6618ff0b0abe38a0914d8afe0a2b271c977adf6b,1,1,2,3,2,2010-01-15 22:46:33,2010-01-15 22:46:33
6618ff0b0abe38a0914d8afe0a2b271c977adf6b...155ecf42a0033785160e071507f0795b3c86a32b,2,38,14,52,6,2010-01-16 15:11:01,2010-01-16 15:11:01
155ecf42a0033785160e071507f0795b3c86a32b...257a4693f4870489e779ae75e5c8ce5374b080a0,1,1,1,2,1,2010-01-18 22:19:44,2010-01-18 22:19:44
257a4693f4870489e779ae75e5c8ce5374b080a0...435772e29b4ac4ccfdefbc4045d43f714e153381,1,2,2,4,2,2010-01-18 22:52:36,2010-01-18 22:52:36
435772e29b4ac4ccfdefbc4045d43f714e153381...8eef3a4f2ce7226cf27423903505e4ac80dff718,1,1,1,2,1,2010-01-21 14:07:19,2010-01-21 14:07:19
8eef3a4f2ce7226cf27423903505e4ac80dff718...150e44cddaa606f9299d4e44ea8a0c01ad8f7166,2,13,1,14,3,2010-01-23 16:12:26,2010-01-23 16:12:26
150e44cddaa606f9299d4e44ea8a0c01ad8f7166...b9ca1579987ab08a7db21a8a0b64f65727f54011,1,1,1,2,1,2010-01-23 16:14:29,2010-01-23 16:14:29
b9ca1579987ab08a7db21a8a0b64f65727f54011...01f72026ec939e87da85a7afc1a5262872ea3ce5,3,80,9,89,11,2010-01-23 16:56:24,2010-01-23 16:56:24
01f72026ec939e87da85a7afc1a5262872ea3ce5...09ef5b7598bcdd9e6c254b24b55a54e6bfb2b4ca,1,6,17,23,3,2010-01-23 17:13:46,2010-01-23 17:13:46
09ef5b7598bcdd9e6c254b24b55a54e6bfb2b4ca...28ce15979f69903f2fe1187705b190968757ddf7,2,4,2,6,3,2010-01-23 17:20:53,2010-01-21 01:10:34
28ce15979f69903f2fe1187705b190968757ddf7...f6ec9d54d11432b91577addab6e613fb1f7a5203,2,9,4,13,3,2010-01-23 17:52:32,2010-01-23 17:52:32
28ce15979f69903f2fe1187705b190968757ddf7...21441b1cbc7a205e621b8c94a21eff102380ca03,1,2,2,4,2,2010-01-23 17:25:22,2010-01-19 19:52:35
21441b1cbc7a205e621b8c94a21eff102380ca03...a63754aa4e4e430007208d6b5cb76f9ca8c279f5,1,24,5,29,3,2010-01-23 17:25:22,2010-01-19 23:27:20
a63754aa4e4e430007208d6b5cb76f9ca8c279f5...2c28f229e5eb49f1469fd36ee979529a492f0f42,3,16,10,26,7,2010-01-23 17:26:35,2010-01-21 15:18:54
8ea634fd07afb58c6eac3ef994adf562292fafe7...3e286440d55749382a644ea97b4f0b2587779d65,2,19,4,23,5,2010-01-23 21:37:12,2010-01-23 21:37:12
3e286440d55749382a644ea97b4f0b2587779d65...a6ef036bb6a3610431471eebc2623bf8ad06bdd6,3,7,3,10,4,2010-01-23 21:48:47,2010-01-23 21:48:47
a6ef036bb6a3610431471eebc2623bf8ad06bdd6...0912109ffc86610161c769534df84400ccd1aa65,2,23,17,40,2,2010-01-23 21:51:51,2010-01-23 21:51:51
0912109ffc86610161c769534df84400ccd1aa65...ea9e0ed841f0f2851162e01d5199052872ba7483,2,55,55,110,2,2010-01-23 21:54:24,2010-01-23 21:54:24
ea9e0ed841f0f2851162e01d5199052872ba7483...781fe8b80d08b287e4c6e4ca408f773c6a1f3b2d,2,34,10,44,6,2010-01-23 22:08:26,2010-01-23 22:08:26
781fe8b80d08b287e4c6e4ca408f773c6a1f3b2d...4f9aa62a858f28b8ed310ac73f9d2cd788bf1eed,2,63,22,85,11,2010-01-24 01:49:59,2010-01-24 01:49:59
4f9aa62a858f28b8ed310ac73f9d2cd788bf1eed...f06e0e5575bc8f82d0fcbd5880bb9d8ccf361bfa,2,81,12,93,6,2010-01-24 02:20:19,2010-01-24 02:20:19
f06e0e5575bc8f82d0fcbd5880bb9d8ccf361bfa...6a3d0996edf2f8ba69f62c8c7c3eda07b674d81f,2,10,3,13,5,2010-01-25 02:37:05,2010-01-25 02:37:05
6a3d0996edf2f8ba69f62c8c7c3eda07b674d81f...c639405c4d1ec462b032ccfb571a6c73212ba101,2,28,3,31,5,2010-01-25 02:58:32,2010-01-25 02:58:32
c639405c4d1ec462b032ccfb571a6c73212ba101...76236a15062aa82a4841748e9071eb3c9535ef62,1,2,5,7,3,2010-01-25 03:13:52,2010-01-25 03:13:52
76236a15062aa82a4841748e9071eb3c9535ef62...f91b944cabf7be9aadb40ffe35fce76b50f5f25f,2,54,40,94,7,2010-01-25 05:46:03,2010-01-25 05:46:03
f91b944cabf7be9aadb40ffe35fce76b50f5f25f...1a14a38ff77839b2a71fbc3f3c0890ebe62438c7,2,22,1,23,2,2010-01-25 06:08:24,2010-01-25 06:08:24
1a14a38ff77839b2a71fbc3f3c0890ebe62438c7...323270f6dcc4fdbef0e6d81f5e37b315fbffc599,1,1,1,2,1,2010-01-25 14:31:40,2010-01-25 14:31:40
323270f6dcc4fdbef0e6d81f5e37b315fbffc599...d24443fb55ddc6a309c08a9a248128fef269d2a3,2,61,21,82,10,2010-01-25 18:45:07,2010-01-25 18:45:07
d24443fb55ddc6a309c08a9a248128fef269d2a3...e01ff6cda1be44900b9829c718733923b71db11f,1,7,1,8,3,2010-01-25 20:18:51,2010-01-25 20:18:51
e01ff6cda1be44900b9829c718733923b71db11f...0474917c9d82fa13d865282d2da2d3cb6e5b89ec,2,46,3,49,4,2010-01-25 21:45:39,2010-01-25 21:45:39
0474917c9d82fa13d865282d2da2d3cb6e5b89ec...390186b902c4c1ac13e23754d33ed4d8b3d5fa38,2,43,0,43,2,2010-01-25 22:01:07,2010-01-25 22:01:07
390186b902c4c1ac13e23754d33ed4d8b3d5fa38...bed759c95ca6d796125653b540e8611dc63b38bb,3,41,5,46,10,2010-01-25 23:43:33,2010-01-25 23:43:33
bed759c95ca6d796125653b540e8611dc63b38bb...ca90ffb332eafc93b8107aeb2afa7473132392fd,2,8,4,12,7,2010-01-25 23:48:52,2010-01-25 23:48:52
ca90ffb332eafc93b8107aeb2afa7473132392fd...55a64cf095b295d334010c6e0a00863f307caffa,1,1,1,2,1,2010-01-25 23:51:44,2010-01-24 17:19:46
55a64cf095b295d334010c6e0a00863f307caffa...9f17e70ae95cc2d4b945bc94283b87cc5b8b23db,2,20,8,28,6,2010-01-26 00:16:23,2010-01-26 00:16:23
9f17e70ae95cc2d4b945bc94283b87cc5b8b23db...0b3165fd23ba4d240dd72f93d315bb5f7bf970e8,2,16,0,16,2,2010-01-26 00:22:28,2010-01-26 00:22:28
0b3165fd23ba4d240dd72f93d315bb5f7bf970e8...a08ee9a9afd47a81a242180a5c636f2e1645be25,1,1,1,2,1,2010-01-26 00:43:33,2010-01-26 00:43:33
a08ee9a9afd47a81a242180a5c636f2e1645be25...7a3afc31943865b3536a1596d431278b99ff824d,1,1,1,2,1,2010-01-26 00:43:40,2010-01-26 00:43:40
7a3afc31943865b3536a1596d431278b99ff824d...942f8f7f75a55a36e6b9745030d3b3c983518aa8,1,1,4,5,1,2010-01-27 15:06:50,2010-01-27 15:06:50
942f8f7f75a55a36e6b9745030d3b3c983518aa8...eed69eccc54d010889b5d8495320538d7ceb4e51,3,92,58,150,30,2010-01-28 19:12:44,2010-01-28 19:12:44
eed69eccc54d010889b5d8495320538d7ceb4e51...e9092e995424828c455952e09b9ec83577009796,1,5,2,7,4,2010-01-28 19:16:52,2010-01-28 19:16:52
e9092e995424828c455952e09b9ec83577009796...31f1e99500af6e57cfdd571272be193b4646fc09,1,1,0,1,1,2010-01-28 19:18:20,2010-01-28 19:18:20
31f1e99500af6e57cfdd571272be193b4646fc09...0252b78201f817f87d10f14c85d0f37e4c50ce22,2,11,3,14,4,2010-01-28 19:34:09,2010-01-28 19:34:09
0252b78201f817f87d10f14c85d0f37e4c50ce22...98c7248518f9a2082ccf50240b5ab44bf98d7b5e,3,80,40,120,6,2010-01-28 20:25:52,2010-01-28 20:25:52
98c7248518f9a2082ccf50240b5ab44bf98d7b5e...0db207da238e879dad20f68178e6248750d3b984,2,20,11,31,8,2010-01-28 21:30:37,2010-01-28 21:30:37
0db207da238e879dad20f68178e6248750d3b984...b8076a914ba9d400dc9c48d866b145df6fabafcf,2,13,5,18,6,2010-01-28 22:17:51,2010-01-28 22:17:51
b8076a914ba9d400dc9c48d866b145df6fabafcf...388a00fe918c2ec759bd33c34bfc13aabfe413d0,1,13,7,20,4,2010-01-28 22:18:27,2010-01-28 22:18:27
388a00fe918c2ec759bd33c34bfc13aabfe413d0...4f2e209b85b56351ed17ac0b5de60db85666209f,1,8,4,12,3,2010-01-29 05:22:20,2010-01-29 05:22:20
4f2e209b85b56351ed17ac0b5de60db85666209f...cb65daa399630de0cdcd81af55ff76f6cd93da62,1,2,1,3,1,2010-01-29 20:04:26,2010-01-29 20:04:26
cb65daa399630de0cdcd81af55ff76f6cd93da62...31432e048f879b93ffa44c39d6f5989ab2620bd8,2,433,38,471,12,2010-02-01 23:06:03,2010-02-01 23:06:03
31432e048f879b93ffa44c39d6f5989ab2620bd8...1b28bba4d2ba692047813cf5185a7d55e2362472,1,4,2,6,3,2010-02-01 23:22:48,2010-02-01 23:22:48
1b28bba4d2ba692047813cf5185a7d55e2362472...f9417b9da980f4fa79d03ba691d9f3442c5ab2f2,1,4,4,8,4,2010-02-01 23:52:12,2010-02-01 23:52:12
f9417b9da980f4fa79d03ba691d9f3442c5ab2f2...f95147f465932cb91e1a6aace50c556820ca4074,2,12,2,14,4,2010-02-02 02:26:47,2010-02-02 02:26:47
f95147f465932cb91e1a6aace50c556820ca4074...e76ba32cebc26108e15b2e0e03c5152624c1bad9,2,13,2,15,3,2010-02-02 02:33:58,2010-02-02 02:33:58
e76ba32cebc26108e15b2e0e03c5152624c1bad9...8660ea1ab61dd16aec1ed24ec549c6258292b96a,2,13,6,19,5,2010-02-02 02:48:05,2010-02-02 02:48:05
8660ea1ab61dd16aec1ed24ec549c6258292b96a...532bec4c694532acbe2e14ad3b6ff72a4da90be0,1,11,1,12,1,2010-02-02 02:53:31,2010-02-02 02:53:31
532bec4c694532acbe2e14ad3b6ff72a4da90be0...8a4b2102ff57fb113267cd2824fa4f3a907ae9ed,1,1,1,2,1,2010-02-02 02:56:11,2010-02-02 02:56:11
8a4b2102ff57fb113267cd2824fa4f3a907ae9ed...e7912805d6ee290071fb15fbca752e9f47fcd032,2,149,155,304,52,2010-02-04 05:20:52,2010-02-04 05:20:52
e7912805d6ee290071fb15fbca752e9f47fcd032...e177465a6b65aecbb87486f6243410ffabfe14b7,1,18,0,18,1,2010-02-04 05:49:46,2010-02-04 05:49:46
e177465a6b65aecbb87486f6243410ffabfe14b7...104757705a19df3b6b9750aaef30aa451082f825,1,20,0,20,1,2010-02-04 14:23:50,2010-02-04 14:23:50
104757705a19df3b6b9750aaef30aa451082f825...be2407e233f1731e3f0ec79bdc8efaadd1f32f9f,2,152,91,243,48,2010-02-05 02:36:32,2010-02-05 02:36:32
be2407e233f1731e3f0ec79bdc8efaadd1f32f9f...5d2e0efd7c23132a7f3a3b34ae3b8058413c1b61,1,9,1,10,1,2010-02-05 03:02:27,2010-02-05 03:02:27
5d2e0efd7c23132a7f3a3b34ae3b8058413c1b61...9118828a590b844a93c5465ccbee129c30f5a569,1,2121,1294,3415,367,2010-02-05 03:03:32,2010-02-05 03:03:32
9118828a590b844a93c5465ccbee129c30f5a569...6f7adb95c1f87869e071541c7e5c92a6189db713,1,58,0,58,1,2010-02-05 03:43:23,2010-02-05 03:43:23
6f7adb95c1f87869e071541c7e5c92a6189db713...43b3ed086dd850388c72ea1cabb557125dfe095a,1,17,15,32,12,2010-02-05 16:02:56,2010-02-05 16:02:56
43b3ed086dd850388c72ea1cabb557125dfe095a...54bd004e53b4d89e9e7e7533f11c23ff99f70d73,2,5,3,8,4,2010-02-06 00:43:31,2010-02-06 00:43:31
54bd004e53b4d89e9e7e7533f11c23ff99f70d73...d74389997106b02cf513f573a0d7197ecc511514,2,5,2,7,3,2010-02-06 00:58:08,2010-02-06 00:58:08
d74389997106b02cf513f573a0d7197ecc511514...75bb2d6e510a3c048a42ce673e9655fa779eacd5,1,2,2,4,2,2010-02-08 16:31:01,2010-02-08 16:31:01
d74389997106b02cf513f573a0d7197ecc511514...8a66a30fece5db98a5f606b11c15fef1016d045a,1,1,1,2,1,2010-02-06 02:50:57,2010-02-05 17:31:49
8a66a30fece5db98a5f606b11c15fef1016d045a...3c5b1ca03ba6ca8504e7ba1c61c4d639814f4233,2,3,3,6,3,2010-02-06 03:46:44,2010-02-06 02:43:10
fec02aa5cb01fc865c69120d88a2eed541a21f0e...5267824aa36f0fcecb944a4daf0b99d6e01460fd,1,84,83,167,24,2010-02-09 04:28:15,2010-02-09 04:28:15
5267824aa36f0fcecb944a4daf0b99d6e01460fd...35c379075c9feaa7cf82b4cf4c50a790e35b4d5f,1,2,5,7,2,2010-02-10 20:56:53,2010-02-10 20:56:53
35c379075c9feaa7cf82b4cf4c50a790e35b4d5f...d3d497f900a559ca254d09470db532064eeacc1e,1,2,2,4,1,2010-02-10 21:40:48,2010-02-10 21:40:48
d3d497f900a559ca254d09470db532064eeacc1e...639f4931b0409a8eb83aaf89a03b6b52f674663e,1,5,5,10,4,2010-02-11 06:23:13,2010-02-11 06:23:13
639f4931b0409a8eb83aaf89a03b6b52f674663e...021b809acecc4e94613375b3182c86722470fe9b,2,7,3,10,4,2010-02-11 06:42:51,2010-02-11 06:42:51
021b809acecc4e94613375b3182c86722470fe9b...5d36fe3210787009e15e05ad602525d0c2823b5c,1,16,8,24,6,2010-02-11 21:50:26,2010-02-11 21:50:26
5d36fe3210787009e15e05ad602525d0c2823b5c...8404ad6070d1fae8e667eed734d958154f0d7e3c,1,1,1,2,1,2010-02-13 00:38:57,2010-02-13 00:38:57
8404ad6070d1fae8e667eed734d958154f0d7e3c...7a467ed9360c2c55ea55a56e5767c9581e4f4f69,1,8,13,21,2,2010-02-13 06:45:09,2010-02-13 06:45:09
7a467ed9360c2c55ea55a56e5767c9581e4f4f69...8b86004f9cf146f7e1e28c8ca98b893f9feac472,1,1,1,2,1,2010-02-13 06:50:19,2010-02-13 06:50:19
8b86004f9cf146f7e1e28c8ca98b893f9feac472...94d925cd4615d88532737f3cd106ecd1f8c34bc3,2,7,2,9,4,2010-02-13 07:14:23,2010-02-13 07:14:23
94d925cd4615d88532737f3cd106ecd1f8c34bc3...83a044f1b5a733dc7ea76dbc9b7dd3a3dc4b7f25,2,11,2,13,3,2010-02-13 07:18:38,2010-02-13 07:18:38
83a044f1b5a733dc7ea76dbc9b7dd3a3dc4b7f25...abcc1a76ee2a6733177b2cd104bc32cee5443ec4,2,5,2,7,3,2010-02-13 07:23:38,2010-02-13 07:23:38
abcc1a76ee2a6733177b2cd104bc32cee5443ec4...a7dc66b8325906066071fe5c44ce55ecf2eb5aed,2,2,2,4,2,2010-02-13 07:26:50,2010-02-13 07:26:50
a7dc66b8325906066071fe5c44ce55ecf2eb5aed...726fda08bea7bbd72d73be4563aba855c63966fe,2,15,6,21,7,2010-02-13 07:49:04,2010-02-13 07:49:04
726fda08bea7bbd72d73be4563aba855c63966fe...99e7560808679b5044dbefb2b7124bb019fdbda2,3,14,2,16,4,2010-02-13 08:14:00,2010-02-13 08:14:00
99e7560808679b5044dbefb2b7124bb019fdbda2...14e1200d59345e8ece8d6edfcf75af2e90ae8b72,1,4,5,9,4,2010-02-13 08:25:27,2010-02-13 08:25:27
14e1200d59345e8ece8d6edfcf75af2e90ae8b72...c1ac9fdf45632f0e0d1f7183500ce45dde7319d7,2,7,2,9,3,2010-02-13 08:30:45,2010-02-13 08:30:45
c1ac9fdf45632f0e0d1f7183500ce45dde7319d7...467063a2e25bae25adfa2e9ab789c62e241c9c56,2,13,0,13,9,2010-02-13 09:40:26,2010-02-13 09:40:26
467063a2e25bae25adfa2e9ab789c62e241c9c56...dd5c26304af1c5f884ebf0baa5df28a2f8a8c4cc,2,17,2,19,3,2010-02-13 10:37:17,2010-02-13 10:37:17
dd5c26304af1c5f884ebf0baa5df28a2f8a8c4cc...6a82f2ae63263ed9deaff9d9dcc775a2c0cde343,1,13,16,29,6,2010-02-13 10:45:48,2010-02-13 10:45:48
6a82f2ae63263ed9deaff9d9dcc775a2c0cde343...da966573c3f3cb083c48cd3ead88e7542937d4df,3,26,5,31,7,2010-02-13 11:10:43,2010-02-13 11:10:43
da966573c3f3cb083c48cd3ead88e7542937d4df...9195107dbb13ad34ae4e9f7cb1df5d79e4748560,3,19,29,48,7,2010-02-13 11:32:20,2010-02-13 11:32:20
9195107dbb13ad34ae4e9f7cb1df5d79e4748560...a6f3757d50f8be021505f4f7fa7201199e8b7f2d,3,17,12,29,4,2010-02-13 11:57:58,2010-02-13 11:57:58
a6f3757d50f8be021505f4f7fa7201199e8b7f2d...053af95294304f6a1e698191de31cb00c922e665,1,2,1,3,1,2010-02-13 12:05:39,2010-02-13 12:05:39
053af95294304f6a1e698191de31cb00c922e665...437ddb931df29c0b46ffb893165e15f159963085,2,8,3,11,5,2010-02-13 19:30:27,2010-02-13 19:30:27
437ddb931df29c0b46ffb893165e15f159963085...efe51cdf2049906788173390a9e9867f5a5ab47e,1,1,1,2,1,2010-02-14 03:33:48,2010-02-14 03:33:48
efe51cdf2049906788173390a9e9867f5a5ab47e...7e6b20e2e813e774ce970d17215260d54bf15cd7,1,1,1,2,1,2010-02-14 03:33:57,2010-02-14 03:33:57
7e6b20e2e813e774ce970d17215260d54bf15cd7...26b0e913dda386b6b2848196689a02a2da6aa40d,3,56,36,92,28,2010-02-26 14:26:14,2010-02-26 14:26:14
26b0e913dda386b6b2848196689a02a2da6aa40d...28b489bfc8ad240b01e63ed93634f2b8770332a3,1,1,0,1,1,2010-02-26 16:23:49,2010-02-26 16:23:49
28b489bfc8ad240b01e63ed93634f2b8770332a3...7f5179b65431b77e89fa32623a5000e3630c191c,2,35,2,37,3,2010-02-26 16:32:12,2010-02-26 16:32:12
7f5179b65431b77e89fa32623a5000e3630c191c...9e06903a99caf5619d0db858ed3d24f0e6ee15db,2,17,7,24,8,2010-02-26 17:35:04,2010-02-26 17:35:04
9e06903a99caf5619d0db858ed3d24f0e6ee15db...7d5da0ee030b1962ff1ff57b0221a02dfdc2886a,1,2,1,3,1,2010-02-27 07:31:33,2010-02-27 07:31:33
9e06903a99caf5619d0db858ed3d24f0e6ee15db...ba7195e3f90b3a3130ac0b15880ba2f27106f568,2,15,2,17,2,2010-02-27 01:01:19,2010-02-27 01:01:19
ba7195e3f90b3a3130ac0b15880ba2f27106f568...a45372a4c5cfd33c4ff12b145bd79fec2fe0d382,3,37,5,42,6,2010-02-27 14:02:13,2010-02-27 14:02:13
42568db4c414d4435f2f7e89be87d66645c42e1c...a49e6b63131e292bc1c31ee98b300ba87ce99162,2,28,13,41,13,2010-02-27 14:49:58,2010-02-27 14:49:58
a49e6b63131e292bc1c31ee98b300ba87ce99162...36faab439a1d3a5471847e952d0019e8e4e9b982,1,1,2,3,2,2010-02-27 15:03:43,2010-02-27 15:03:43
36faab439a1d3a5471847e952d0019e8e4e9b982...1d352084c4257217b0778f1ec3bb2e409411a4c3,2,47,6,53,3,2010-02-28 01:43:23,2010-02-28 01:43:23
1d352084c4257217b0778f1ec3bb2e409411a4c3...5353c6bcc352c4d900cc76af110e56ee1e70ae0f,1,9,1,10,2,2010-02-28 16:55:59,2010-02-28 16:55:59
5353c6bcc352c4d900cc76af110e56ee1e70ae0f...a18f682012ae8e63f3b43b39375b3c5ce0a561e3,5,45,38,83,16,2010-03-01 17:44:56,2010-03-01 17:44:56
a18f682012ae8e63f3b43b39375b3c5ce0a561e3...fc08d0ea8dc881ed56102eb14e3ad9c54cccc34e,1,8,3,11,3,2010-03-01 21:26:57,2010-03-01 21:26:57
fc08d0ea8dc881ed56102eb14e3ad9c54cccc34e...a4043cdcbfa1ca069265a7cbcaba269629789cc0,5,10,11,21,8,2010-03-01 23:19:29,2010-03-01 23:19:29
a4043cdcbfa1ca069265a7cbcaba269629789cc0...8c8f685a911c811e9b998958dd453a6a2b9d5940,1,1,3,4,2,2010-03-02 00:31:13,2010-03-02 00:31:13
8c8f685a911c811e9b998958dd453a6a2b9d5940...dcf0fa5048ef2379d551f29ffa29b14ec5ee09d5,9,190,185,375,57,2010-03-02 02:24:49,2010-03-02 02:24:49
dcf0fa5048ef2379d551f29ffa29b14ec5ee09d5...950b5d64a27994db1697eb4e605f5ea48ad8021b,5,5548,3,5551,8,2010-03-02 02:51:44,2010-03-02 02:51:44
950b5d64a27994db1697eb4e605f5ea48ad8021b...a33d01a7b09f2b3b06ba273b89b77fec8d20b144,2,1,3,4,2,2010-03-02 02:56:08,2010-03-02 02:56:08
a33d01a7b09f2b3b06ba273b89b77fec8d20b144...86ace44fbbdfe90d231877d6d3bb3b85a81782b4,1,12,9,21,8,2010-03-02 15:44:48,2010-03-02 15:44:48
86ace44fbbdfe90d231877d6d3bb3b85a81782b4...5c111a028a2c86f2392d987951db3a980900f1bd,1,4,13,17,3,2010-03-02 15:51:31,2010-03-02 15:51:31
5c111a028a2c86f2392d987951db3a980900f1bd...ad103c8e6a2fead02822360583d56bcf42c032c4,1,6,6,12,4,2010-03-02 15:53:54,2010-03-02 15:53:54
ad103c8e6a2fead02822360583d56bcf42c032c4...04e31ff058548fbdbdf77c61d4edc3a974b080f4,1,4,0,4,1,2010-03-02 18:56:15,2010-03-02 18:56:15
04e31ff058548fbdbdf77c61d4edc3a974b080f4...9584e908a2daa2a72bd738302dba7cfd0656dbdf,2,36,16,52,17,2010-03-02 22:34:12,2010-03-02 22:34:12
9584e908a2daa2a72bd738302dba7cfd0656dbdf...2c08004f6d4e7f11a875190e132d204a25cb9418,2,10,2,12,3,2010-03-05 05:07:57,2010-03-05 05:07:57
2c08004f6d4e7f11a875190e132d204a25cb9418...145f2f045901af5f03f4bdb8a2192027b56f8b30,1,6,5,11,2,2010-03-05 05:14:47,2010-03-05 05:14:47
145f2f045901af5f03f4bdb8a2192027b56f8b30...0a307b332e896b6b480952abb5d3bf03819893c8,1,1,1,2,1,2010-03-05 14:59:58,2010-03-05 14:59:58
0a307b332e896b6b480952abb5d3bf03819893c8...141ad3c3e21e7734e67e37b5fb39782fe11b3c18,3,36,24,60,11,2010-03-09 14:14:27,2010-03-09 14:14:27
141ad3c3e21e7734e67e37b5fb39782fe11b3c18...2fbe3fbf681b65426868920d00085f1fa56034c7,1,0,4,4,1,2010-03-09 14:16:35,2010-03-09 14:16:35
2fbe3fbf681b65426868920d00085f1fa56034c7...f68b46d7abb54cdcd3d1ce1713bc989f992d1448,3,91,39,130,37,2010-03-09 17:22:25,2010-03-09 17:22:25
f68b46d7abb54cdcd3d1ce1713bc989f992d1448...da26d0eb4e7f563da72cf4d5e9a1d99f6719fea4,1,6,20,26,2,2010-03-09 19:08:33,2010-03-09 19:08:33
da26d0eb4e7f563da72cf4d5e9a1d99f6719fea4...ba8938d444b9a49bdfb27213826ba108145c2e50,1,3,2,5,3,2010-03-11 15:49:19,2010-03-11 15:49:19
ba8938d444b9a49bdfb27213826ba108145c2e50...8effe3a7dee91c833cc1774646da9d743600c64c,14,141,115,256,22,2010-03-23 16:12:16,2010-03-23 16:12:16
8effe3a7dee91c833cc1774646da9d743600c64c...f6a50cacd8cd7663650d3ff5557cc20bfcdcd765,1,10,0,10,1,2010-03-23 16:19:47,2010-03-23 16:19:47
f6a50cacd8cd7663650d3ff5557cc20bfcdcd765...fa80693c4a2302993c4b18ac49d30c26f16d517d,2,11,10,21,9,2010-03-23 16:31:40,2010-03-23 16:31:40
fa80693c4a2302993c4b18ac49d30c26f16d517d...2301e2a1c3418b4588653e26f9171577e0077aec,1,1,1,2,1,2010-03-23 19:21:42,2010-03-23 19:21:42
2301e2a1c3418b4588653e26f9171577e0077aec...0fbac16dbe77b6bf846b43d3ef3bd75c374e2628,1,1,1,2,1,2010-03-23 20:22:09,2010-03-23 20:22:09
0fbac16dbe77b6bf846b43d3ef3bd75c374e2628...273822c138c70b1d58e2d1199090e9efa3e0e53e,1,4,4,8,4,2010-03-23 20:24:51,2010-03-23 20:24:51
273822c138c70b1d58e2d1199090e9efa3e0e53e...96ea3d615ef1511bc9ebe45cd34dda2d5af87559,7,64,7,71,8,2010-03-23 20:37:40,2010-03-23 20:37:40
ba8938d444b9a49bdfb27213826ba108145c2e50...1844f95c5b2f92a1b388ff43e20aa4f065a6e57c,1,12,7,19,6,2010-03-22 22:50:17,2010-03-22 22:50:17
1844f95c5b2f92a1b388ff43e20aa4f065a6e57c...08cf82e88e7a1f88da34ca251335a685889f8765,1,8,5,13,2,2010-03-23 00:05:08,2010-03-23 00:05:08
08cf82e88e7a1f88da34ca251335a685889f8765...656fe92178fda539d91fe31965b28bccff484778,3,29,9,38,8,2010-03-23 00:11:37,2010-03-23 00:11:37
96ea3d615ef1511bc9ebe45cd34dda2d5af87559...3b221da8b03265543f335f6160b945bfe55f8d9e,1,1,1,2,1,2010-03-24 19:18:11,2010-03-24 19:18:11
3b221da8b03265543f335f6160b945bfe55f8d9e...1ba2df02d6242d734297344a85b7bea3788a0671,1,11,11,22,7,2010-03-24 19:39:58,2010-03-24 19:39:58
1ba2df02d6242d734297344a85b7bea3788a0671...59124f92b52f24f2547afaecc55afe10e2955cb6,1,4,0,4,1,2010-03-24 20:04:10,2010-03-24 20:04:10
59124f92b52f24f2547afaecc55afe10e2955cb6...298c81a8440169f3cbcacb9655ac3fef0a3e6d76,1,1,1,2,1,2010-03-24 20:16:13,2010-03-24 20:16:13
298c81a8440169f3cbcacb9655ac3fef0a3e6d76...dab1d7467789c7092366f8231dceee0dc20d2553,1,28,7,35,5,2010-03-25 21:30:13,2010-03-25 21:30:13
656fe92178fda539d91fe31965b28bccff484778...b3ccf2f2881d9ad988aba1cf3ccffb810063ab29,14,141,115,256,22,2010-06-20 05:29:47,2010-03-23 16:12:16
b3ccf2f2881d9ad988aba1cf3ccffb810063ab29...b64a51e136a4bcce3d0c2d5292c53d85c2d0e7de,1,10,0,10,1,2010-06-20 05:29:47,2010-03-23 16:19:47
b64a51e136a4bcce3d0c2d5292c53d85c2d0e7de...4e5e31f29e2944ccf4bb349a4ed670f3e8c04ebf,2,11,10,21,9,2010-06-20 05:29:47,2010-03-23 16:31:40
4e5e31f29e2944ccf4bb349a4ed670f3e8c04ebf...f502d118d1c6226ffcc8e3498d8d12fb05b2d7c5,1,1,1,2,1,2010-06-20 05:29:47,2010-03-23 19:21:42
f502d118d1c6226ffcc8e3498d8d12fb05b2d7c5...31cfe62ed4884f0f7eff399375bf6e748738ef71,1,1,1,2,1,2010-06-20 05:29:47,2010-03-23 20:22:09
31cfe62ed4884f0f7eff399375bf6e748738ef71...83a97f5c21a3c8c063e05f0df40efe13069c82f2,1,4,4,8,4,2010-06-20 05:29:47,2010-03-23 20:24:51
83a97f5c21a3c8c063e05f0df40efe13069c82f2...568db29c2b1c139b641197ab61a9af77356cce11,7,64,7,71,8,2010-06-20 05:29:47,2010-03-23 20:37:40
568db29c2b1c139b641197ab61a9af77356cce11...d4aff802da1882a4969b389f37ecb60b9d61f1ce,1,1,1,2,1,2010-06-20 05:29:47,2010-03-24 19:18:11
d4aff802da1882a4969b389f37ecb60b9d61f1ce...d54014ed91f05af50be8c6ed2bcf3fb78604e82b,1,11,11,22,7,2010-06-20 05:29:48,2010-03-24 19:39:58
d54014ed91f05af50be8c6ed2bcf3fb78604e82b...ac670f39545688dad163677dd41e1cb937f6ac6f,1,4,0,4,1,2010-06-20 05:29:48,2010-03-24 20:04:10
ac670f39545688dad163677dd41e1cb937f6ac6f...dc886a83f5384dae947ff43cd04e5aa5451f3392,1,1,1,2,1,2010-06-20 05:29:48,2010-03-24 20:16:13
dc886a83f5384dae947ff43cd04e5aa5451f3392...9568866aad38ea5fc71f6d7581104524cdaaad29,1,28,7,35,5,2010-06-20 05:29:48,2010-03-25 21:30:13
9568866aad38ea5fc71f6d7581104524cdaaad29...23699bc783eae122373171b114157b0ec985edbd,1,1,1,2,1,2010-06-20 05:29:48,2010-03-31 18:36:24
23699bc783eae122373171b114157b0ec985edbd...ef8df7f55c3fb0466fa59d5cee20a2c34f009725,5,11,7,18,6,2010-06-20 05:29:48,2010-04-24 21:15:45
ef8df7f55c3fb0466fa59d5cee20a2c34f009725...3e1ac2aaac0a99a7c1078e8dc76898346daf5d54,1,102,17,119,7,2010-06-20 05:29:48,2010-06-13 03:55:49
3e1ac2aaac0a99a7c1078e8dc76898346daf5d54...ad849eb5a46d284caf8305f8f720169d4192a3ed,1,42,15,57,15,2010-06-20 05:29:48,2010-06-14 06:05:06
ad849eb5a46d284caf8305f8f720169d4192a3ed...ab2537a7ec3c856df1a6192ff72e556c4a22db0e,1,1,1,2,1,2010-06-20 05:29:49,2010-06-14 06:07:21
ab2537a7ec3c856df1a6192ff72e556c4a22db0e...4e337f504e623646f36785b25222b7f7392fbd46,2,45,18,63,17,2010-06-20 05:29:49,2010-06-14 15:17:13
4e337f504e623646f36785b25222b7f7392fbd46...c2976e68ff043ebf61bbbaad019667eabdb07211,1,4,5,9,3,2010-06-20 05:29:49,2010-06-14 15:25:22
c2976e68ff043ebf61bbbaad019667eabdb07211...e61d7d12e2e4c93e834e71aa6b3bd8b410a9dce6,1,3,3,6,3,2010-06-20 05:29:49,2010-06-14 15:49:30
e61d7d12e2e4c93e834e71aa6b3bd8b410a9dce6...cecd1d87350d0a5c07e2590cedbbda78ad7ae85f,1,4,4,8,3,2010-06-20 05:29:49,2010-06-14 19:03:13
d6f03aa0df4f734f6f09bf82effa5b7fcd8487fc...4a64f9a5b8472f394c52e0b3bb7972c8ce699a13,1,1,1,2,1,2010-03-31 18:36:24,2010-03-31 18:36:24
4a64f9a5b8472f394c52e0b3bb7972c8ce699a13...1533bf7c7794d8e078e7ce5e36de6d190651540a,5,11,7,18,6,2010-04-24 21:16:27,2010-04-24 21:15:45
1533bf7c7794d8e078e7ce5e36de6d190651540a...d1931a8241dcac1617cc8388f6dd6284c89c545d,2,24,10,34,4,2010-06-15 03:02:26,2010-04-29 03:45:34
d1931a8241dcac1617cc8388f6dd6284c89c545d...c34a62f8abbd9598e7a6647754c449ce92418b3a,4,15,13,28,3,2010-06-15 03:05:01,2010-06-15 03:05:01
c34a62f8abbd9598e7a6647754c449ce92418b3a...c90d609c0d10a8792b0b31e226592fd707f45570,3,15,1,16,3,2010-06-15 03:08:28,2010-06-15 03:08:28
6a0942c9d5bbcc7eb6b953b8d7191b7bbd1e669f...2e10af143b7eafb7142524f6534a62aee1910bd1,2,21,5,26,7,2010-07-20 02:12:40,2010-07-19 23:22:25
2e10af143b7eafb7142524f6534a62aee1910bd1...4ec1b743a81256ae15907e46260cfc8edc6f06b8,2,4,1,5,2,2010-07-21 14:47:13,2010-04-08 01:06:46
4ec1b743a81256ae15907e46260cfc8edc6f06b8...6803bf1fe5ec47cc273917f427b7ca9a888137b3,1,1,1,2,1,2010-07-21 14:47:13,2010-04-08 01:10:07
6803bf1fe5ec47cc273917f427b7ca9a888137b3...bb0f1a97fb7a011c6afa5ceba7f332b7559c4757,1,49,49,98,12,2010-07-21 14:47:13,2010-04-08 01:20:35
bb0f1a97fb7a011c6afa5ceba7f332b7559c4757...ef9fb80cabc8c8f9cbcf71bf9160de0abdaa2de8,1,34,16,50,18,2010-07-21 14:47:13,2010-04-08 01:38:19
ef9fb80cabc8c8f9cbcf71bf9160de0abdaa2de8...9faab0b74fd316c2161612236d9ea8a01f3c78f8,2,29,7,36,8,2010-07-22 19:52:01,2010-07-20 21:53:36
9faab0b74fd316c2161612236d9ea8a01f3c78f8...266facc08a2e1c8cb5a7a60de304da47657f2227,1,3,6,9,3,2010-07-22 19:52:02,2010-07-22 17:48:24
266facc08a2e1c8cb5a7a60de304da47657f2227...2084e01780b57e5becbb00817b883175ef67b0b5,1,6,4,10,5,2010-07-23 15:25:31,2010-07-23 15:25:31
2084e01780b57e5becbb00817b883175ef67b0b5...646fbea561ce5319d888780c20f0c0f03b8daad3,1,11,0,11,1,2010-07-27 10:50:08,2010-07-27 10:50:08
646fbea561ce5319d888780c20f0c0f03b8daad3...c4b4df469161ed3c3d372ebed342261efd413ac1,2,14,3,17,5,2010-07-27 17:45:32,2010-07-27 17:45:32
c4b4df469161ed3c3d372ebed342261efd413ac1...6f031c10157a2ca2265e0dbf684ef527d79afb56,5,84,84,168,84,2010-07-28 15:19:01,2010-07-28 15:19:01
6f031c10157a2ca2265e0dbf684ef527d79afb56...396dd2127330a7ed742d1e9092af54b668c46e85,3,32,17,49,7,2010-08-23 19:38:55,2010-08-23 19:38:55
396dd2127330a7ed742d1e9092af54b668c46e85...392174431af1c9abc94ab6bd1c14f9f8f92a2a7d,1,4,1,5,1,2010-08-23 21:10:39,2010-08-23 21:10:39
392174431af1c9abc94ab6bd1c14f9f8f92a2a7d...1bdcffba8ed6777ffc451523a34ade142715fd94,1,1,4,5,1,2010-08-23 21:23:13,2010-08-23 21:23:13
1bdcffba8ed6777ffc451523a34ade142715fd94...cb40495b21bcb7802f3ab6ae0f837f2bf5b385ed,1,6,0,6,1,2010-08-24 14:28:47,2010-08-24 14:28:47
cb40495b21bcb7802f3ab6ae0f837f2bf5b385ed...18dad474891b94c2f51083cb9df8860a84d630b0,1,3,1,4,1,2010-08-25 16:27:30,2010-08-25 16:27:30
18dad474891b94c2f51083cb9df8860a84d630b0...94f35d05199ec1634d9c8c60d10f298f260056bd,1,9,5,14,5,2010-08-25 16:57:34,2010-08-25 16:57:34
94f35d05199ec1634d9c8c60d10f298f260056bd...dc060f08cd898a12e16b817f46bb49861fbfed36,1,2,1,3,1,2010-08-26 16:36:50,2010-08-26 16:36:50
dc060f08cd898a12e16b817f46bb49861fbfed36...5673e4bc3aa5991dfa51de5cb6d7027f2545ad03,1,1,1,2,1,2010-08-26 16:51:37,2010-08-26 16:51:37
5673e4bc3aa5991dfa51de5cb6d7027f2545ad03...3b76b588153e93c57679fd7ca287eb863994dd59,1,1,1,2,1,2010-08-26 18:37:58,2010-08-26 18:37:58
3b76b588153e93c57679fd7ca287eb863994dd59...c0fe98f0281ea818ddf6a458d98b5aa3e2060701,1,10,8,18,7,2010-08-26 18:57:23,2010-08-26 18:57:23
c0fe98f0281ea818ddf6a458d98b5aa3e2060701...c5382ad7c118ca54dde630b6c7146f1c3b6afb80,1,40,40,80,36,2010-08-26 19:21:01,2010-08-26 19:21:01
c5382ad7c118ca54dde630b6c7146f1c3b6afb80...1e9d6e1255f94a4643770bb498e875d4016c0781,1,1,1,2,1,2010-08-26 19:26:30,2010-08-26 19:26:30
1e9d6e1255f94a4643770bb498e875d4016c0781...9ce1d09a0a002eb147411166dee800335a60f4e4,1,6,2,8,2,2010-08-26 19:36:44,2010-08-26 19:36:44
9ce1d09a0a002eb147411166dee800335a60f4e4...5d2be7e299131a31cffbd73edea59cde30445608,2,28,1,29,2,2010-08-27 13:10:52,2010-08-27 13:10:52
5d2be7e299131a31cffbd73edea59cde30445608...7f18d29287aad960fda58b29e3362c9323fc23db,1,2,4,6,1,2010-08-27 14:03:30,2010-08-27 14:03:30
7f18d29287aad960fda58b29e3362c9323fc23db...ea8b1584b1905bbb414dc2e3cf562c6f3904bd97,1,1,1,2,1,2010-08-27 17:15:48,2010-08-27 17:15:48
ea8b1584b1905bbb414dc2e3cf562c6f3904bd97...43fbe3b33aeaa73c151ddb59632c85bc7f8a87b9,1,7,1,8,2,2010-08-27 18:16:27,2010-08-27 18:16:27
43fbe3b33aeaa73c151ddb59632c85bc7f8a87b9...1ead20c2ed7cb4fd647d632ff9de8104669482de,1,3,1,4,1,2010-08-27 19:14:30,2010-08-27 19:14:30
1ead20c2ed7cb4fd647d632ff9de8104669482de...13f27fcd05987dc8951621ea55795fde792d7b79,1,1,1,2,1,2010-08-27 22:17:07,2010-08-27 22:17:07
13f27fcd05987dc8951621ea55795fde792d7b79...a2e1051fb4b2065fb5ebea49dc0bcc583d113187,1,1,1,2,1,2010-09-01 15:48:19,2010-09-01 15:48:19
a2e1051fb4b2065fb5ebea49dc0bcc583d113187...8d04ffec16790cbfb04b42421e0ac18600625374,1,9,3,12,6,2010-09-01 16:05:35,2010-09-01 16:05:35
8d04ffec16790cbfb04b42421e0ac18600625374...d48db1f440a76ca2396d2217aac010ff7d515517,1,6,5,11,3,2010-09-02 18:56:32,2010-09-02 18:56:32
d48db1f440a76ca2396d2217aac010ff7d515517...90a4abd5111e57213059eb80876551ae1fac6c53,1,2,2,4,1,2010-09-02 19:13:10,2010-09-02 19:13:10
90a4abd5111e57213059eb80876551ae1fac6c53...97cbd76695a69a973760560689d90d98e550ad7b,1,2,2,4,1,2010-09-02 20:15:54,2010-09-02 20:15:54
6a0942c9d5bbcc7eb6b953b8d7191b7bbd1e669f...a2bd8a53f3a750606abea9bbb6ee2302437d42f3,2,14,6,20,7,2010-06-21 18:18:06,2010-06-21 17:50:02
97cbd76695a69a973760560689d90d98e550ad7b...116f3b7c72004f3173a7d92457154a1fdb2180e1,1,2,2,4,2,2010-09-07 12:53:06,2010-09-07 12:53:06
97cbd76695a69a973760560689d90d98e550ad7b...65b24861bc2e5f25b08373b2c5afdf15d3256e90,1,54,32,86,10,2010-09-03 02:06:40,2010-09-03 02:06:40
65b24861bc2e5f25b08373b2c5afdf15d3256e90...1970154c3b50d3cbc990b93b48d7448390bd84cf,1,4,6,10,3,2010-09-05 03:28:17,2010-09-05 03:28:17
1970154c3b50d3cbc990b93b48d7448390bd84cf...426045cc741b76ce95cf91ff5818879b3d067b76,1,12,4,16,5,2010-09-05 03:34:52,2010-09-05 03:34:52
426045cc741b76ce95cf91ff5818879b3d067b76...2912f8ab9520e042e8b27865617e586e34a05704,1,93,95,188,7,2010-09-05 04:04:37,2010-09-05 04:04:37
2912f8ab9520e042e8b27865617e586e34a05704...920099b29c1157b637f918cdc293e1c89e9cd4dc,5,66,94,160,36,2010-09-05 14:17:18,2010-09-05 14:17:18
920099b29c1157b637f918cdc293e1c89e9cd4dc...b920f0aeb483f4565ff2f3c1d2a328d5200b23f7,1,34,30,64,14,2010-09-05 15:01:27,2010-09-05 15:01:27
b920f0aeb483f4565ff2f3c1d2a328d5200b23f7...a44ec402771f6d622506f39073d0be260400dd21,13,52,3,55,27,2010-09-08 16:00:29,2010-09-08 16:00:29
8c41325a081f4009aa94748b9b6045e50a78422e...7be11207b9267592a639eb739dc8d719c7de56a1,2,9,2,11,9,2010-09-28 00:59:42,2010-09-28 00:59:42
116f3b7c72004f3173a7d92457154a1fdb2180e1...bca576550249e9b79b1097669dff6d4ddd0d65cf,13,51,2,53,26,2010-09-08 17:54:33,2010-09-08 17:54:33
bca576550249e9b79b1097669dff6d4ddd0d65cf...acb162a697e672b2b22e64a02e6278baafac5717,4,8,8,16,8,2010-09-08 22:13:35,2010-09-08 22:13:35
acb162a697e672b2b22e64a02e6278baafac5717...2663041924af36a26a30e60da5d97e2ab9fed5ec,1,2,2,4,2,2010-09-09 12:23:10,2010-09-09 12:23:10
2663041924af36a26a30e60da5d97e2ab9fed5ec...82b35a4f2c11dc72178b78a1256b20d72b09708d,1,1,1,2,1,2010-09-09 14:20:32,2010-09-09 14:20:32
82b35a4f2c11dc72178b78a1256b20d72b09708d...1ed405176bfac58f35c3027006e152a4725fd63b,1,2,0,2,1,2010-09-09 14:34:21,2010-09-09 14:34:21
ca3b18ca5350c62444cb54233f08521ea47abbe3...ad950c8c5992937640a1e1aca8d63bb476b001f6,1,10,6,16,8,2010-09-09 19:33:06,2010-09-09 19:33:06
7be11207b9267592a639eb739dc8d719c7de56a1...34bf1a2a7d688d9861350fd7836eb98268db821e,1,1,0,1,1,2010-11-27 22:15:33,2010-11-27 22:15:33
7be11207b9267592a639eb739dc8d719c7de56a1...cf672a2e7a886cac5ae62f6772c6b4b43b19a2fc,2,18,3,21,3,2010-09-28 14:55:48,2010-09-28 14:55:48
cf672a2e7a886cac5ae62f6772c6b4b43b19a2fc...c7c067723006b0dfbb123c1a36885580a587d091,2,14,2,16,5,2010-09-28 15:12:13,2010-09-28 15:12:13
c7c067723006b0dfbb123c1a36885580a587d091...879799fe955f01b85b59fd8a0096d415fc48df03,4,23,10,33,10,2010-09-28 15:36:28,2010-09-28 15:36:28
879799fe955f01b85b59fd8a0096d415fc48df03...558d96b42aab634e26a66ff337a03ae89be5b33b,2,14,1,15,3,2010-09-28 15:53:09,2010-09-28 15:53:09
558d96b42aab634e26a66ff337a03ae89be5b33b...9190d4fd603884ed1debf8c0f7817d45b72e1aef,2,2,2,4,2,2010-09-28 15:57:20,2010-09-28 15:57:20
9190d4fd603884ed1debf8c0f7817d45b72e1aef...e3c4e5789743eecb3cbe2b626f3a5f09c616ee4b,1,2,2,4,1,2010-09-28 16:07:57,2010-09-28 16:07:57
e3c4e5789743eecb3cbe2b626f3a5f09c616ee4b...0368606c081fd15dfbcd8509734ef63c58a6b008,2,13,4,17,2,2010-09-28 16:50:44,2010-09-28 16:50:44
0368606c081fd15dfbcd8509734ef63c58a6b008...873c28425fb64fdb48cfa09d17041bded39b301f,1,24,12,36,3,2010-09-28 17:12:33,2010-09-28 17:12:33
873c28425fb64fdb48cfa09d17041bded39b301f...f1f6bc3ec43d86f5b2a0c2b8bf711a2d35930717,2,9,1,10,4,2010-09-28 17:33:21,2010-09-28 17:33:21
f1f6bc3ec43d86f5b2a0c2b8bf711a2d35930717...ab77451843e07dd57101e933b5b6c093b024d8eb,1,1,1,2,1,2010-09-29 03:13:40,2010-09-29 03:13:40
ab77451843e07dd57101e933b5b6c093b024d8eb...49f6f341814dce07b9fe2eff0052feb5ef286dfd,1,1,1,2,1,2010-09-29 12:41:27,2010-09-29 12:41:27
49f6f341814dce07b9fe2eff0052feb5ef286dfd...ec7ea3fba15379ebe8ddff5f6c99ec3faf8d6d17,1,1,1,2,1,2010-09-29 12:45:52,2010-09-29 12:45:52
ec7ea3fba15379ebe8ddff5f6c99ec3faf8d6d17...cb811c04b035eb2d652b0831e20ea1d3a4d9c448,4,100,61,161,36,2010-09-29 13:46:25,2010-09-29 13:46:25
1ed405176bfac58f35c3027006e152a4725fd63b...959c20f76866c17e12e0c0bd2b2a8753d618550b,1,3,0,3,1,2010-09-13 22:02:33,2010-09-13 22:02:33
959c20f76866c17e12e0c0bd2b2a8753d618550b...492a2e2c5360a193b867df53e157a32af65f3f7e,1,1,1,2,1,2010-09-14 13:57:26,2010-09-14 13:57:26
492a2e2c5360a193b867df53e157a32af65f3f7e...fc5b69fc706a6025e5084d4b86adb3b97840c84f,1,6,1,7,2,2010-09-17 17:18:39,2010-09-17 17:18:39
194c93eca2c3cfccbf74236587537d9892d88b1d...7c8588530abaf4e72154fe1f59c04aae217a32b8,1,1,1,2,1,2010-09-09 19:42:38,2010-09-09 19:42:38
7c8588530abaf4e72154fe1f59c04aae217a32b8...a166860a19a5d0de4529e4df4cb6647b3812577e,1,6,1,7,2,2010-09-09 19:45:24,2010-09-09 19:45:24
a166860a19a5d0de4529e4df4cb6647b3812577e...70377a65e2a1c8478f3dc1e0e125b7b25b5324f3,1,3,3,6,3,2010-09-09 19:48:28,2010-09-09 19:48:28
70377a65e2a1c8478f3dc1e0e125b7b25b5324f3...c36596ea58a69f7772b61829f8d0609a6fb1d9a0,1,5,6,11,6,2010-09-09 20:26:30,2010-09-09 20:26:30
c36596ea58a69f7772b61829f8d0609a6fb1d9a0...c168c30a6afb1b3af1dee81119dbfdd3bef50d61,1,1,1,2,1,2010-09-09 20:29:26,2010-09-09 20:29:26
c168c30a6afb1b3af1dee81119dbfdd3bef50d61...cb3a9c14f1d69a60777a887a7807d7d11c5cb0a1,1,3,3,6,3,2010-09-09 20:33:05,2010-09-09 20:33:05
cb3a9c14f1d69a60777a887a7807d7d11c5cb0a1...8b7015987cbd24c79f328bcf9260a6596a785bf5,1,5,1,6,1,2010-09-09 20:34:15,2010-09-09 20:34:15
8b7015987cbd24c79f328bcf9260a6596a785bf5...2bda99c18a0372eed02472e9d318676e180281da,3,12,12,24,10,2010-09-13 22:00:28,2010-09-13 22:00:28
2bda99c18a0372eed02472e9d318676e180281da...2131e1a7ad6d9df239ec00b301303e10dbd34d49,1,1,1,2,1,2010-09-14 13:52:13,2010-09-14 13:52:13
2131e1a7ad6d9df239ec00b301303e10dbd34d49...37b607d2815b893d13de4ac3461090d0dd46535e,6,85,65,150,51,2010-09-16 14:00:56,2010-09-16 14:00:56
37b607d2815b893d13de4ac3461090d0dd46535e...99fcf3babbba8b794fe8b0b2e20d517156cfd4d2,1,8,5,13,4,2010-09-17 17:38:13,2010-09-17 17:38:13
99fcf3babbba8b794fe8b0b2e20d517156cfd4d2...d1f3dc9a04225b327b6fd6deb9d3913918054a9f,1,9,4,13,2,2010-09-17 17:51:12,2010-09-17 17:51:12
d1f3dc9a04225b327b6fd6deb9d3913918054a9f...192bab8ed6e8ad2b4c5de0c4660c80b6ecddfd33,2,7,8,15,6,2010-09-17 18:30:30,2010-09-17 18:30:30
bc05cb9d80b63d8a324a3773a39ac1baa181c4d2...b4bb6e11268c5f2fb26ddc3ff564d8656cf58f93,2,4,17,21,3,2010-12-09 18:07:44,2010-12-09 18:07:44
b4bb6e11268c5f2fb26ddc3ff564d8656cf58f93...29616e60c88bf300f4b2ee4ad1a89a8ac6481027,2,72,92,164,71,2010-12-09 18:27:52,2010-12-09 18:27:52
29616e60c88bf300f4b2ee4ad1a89a8ac6481027...ab3ba4a81252c4357a7aab5f24d765d41d47986e,12,1991,463,2454,67,2010-12-09 18:34:28,2010-12-09 18:34:28
ab3ba4a81252c4357a7aab5f24d765d41d47986e...317888464def39e245fac49d463f283c6be16d53,2,5,1,6,2,2010-12-10 01:43:41,2010-12-10 01:43:41
317888464def39e245fac49d463f283c6be16d53...9b9d270e3d697d8129147d03807c4e37b23120b7,3,55,37,92,8,2010-12-10 01:45:08,2010-12-10 01:45:08
9b9d270e3d697d8129147d03807c4e37b23120b7...ac80ca2883f410796ea5cfb0ff93515f4da9fb43,1,5,5,10,1,2010-12-10 01:55:43,2010-12-10 01:55:43
ac80ca2883f410796ea5cfb0ff93515f4da9fb43...3c641bd1345aa25489fc16f09d5f4709bf05b09b,4,8,6,14,6,2010-12-10 02:14:03,2010-12-10 02:14:03
3c641bd1345aa25489fc16f09d5f4709bf05b09b...ab74d8e6a0810717419abb696154d034ad145f2b,1,1,1,2,1,2010-12-10 02:16:50,2010-12-10 02:16:50
ab74d8e6a0810717419abb696154d034ad145f2b...a500d33c5d63aa22f024472b2cc8c15c624a342e,2,7,9,16,7,2010-12-10 03:16:56,2010-12-10 03:16:56
a500d33c5d63aa22f024472b2cc8c15c624a342e...9fa9a570762c2b6dc6131b28b13547964d91be3e,1,1,1,2,1,2010-12-10 06:00:06,2010-12-10 06:00:06
9fa9a570762c2b6dc6131b28b13547964d91be3e...2e129759b44c022cdee5ce1057a7693d2a081263,2,5,5,10,5,2010-12-11 00:35:46,2010-12-11 00:35:46
2e129759b44c022cdee5ce1057a7693d2a081263...8ab5e1e45c051f395c9bc01505dda43187a8172e,1,1,0,1,1,2010-12-11 00:56:29,2010-12-11 00:56:29
8ab5e1e45c051f395c9bc01505dda43187a8172e...9d3a4a2b409f7a4c53800bb36b0de39c0c0084ae,1,0,17,17,1,2010-12-11 01:04:13,2010-12-11 01:04:13
9d3a4a2b409f7a4c53800bb36b0de39c0c0084ae...0b0889ceaaafb1fe37a87b14476066b8f9e93ce9,2,17,20,37,6,2010-12-11 01:21:54,2010-12-11 01:21:54
0b0889ceaaafb1fe37a87b14476066b8f9e93ce9...974637d639a06a050e11d87677d1c1c80bed709d,3,24,46,70,7,2010-12-11 01:41:39,2010-12-11 01:41:39
cb811c04b035eb2d652b0831e20ea1d3a4d9c448...06c505d85194890f8bacabc66895a6167b61728a,2,7,4,11,3,2010-09-30 18:24:59,2010-09-30 18:24:59
06c505d85194890f8bacabc66895a6167b61728a...57c046f91cbc3caf174ecc993fe883c027340901,1,3,3,6,3,2010-09-30 22:40:30,2010-09-30 22:40:30
cb811c04b035eb2d652b0831e20ea1d3a4d9c448...60744e8abd918a748cb32223bbb7ae6834727b3b,1,2,0,2,2,2010-09-30 17:46:36,2010-09-30 17:46:36
51d258074cf4cbb6e8c57361c421494220a65cb1...6541eb9d80db42c6ced396fcd198228bff9ec7f1,2,10,9,19,7,2010-09-17 18:41:28,2010-09-17 18:41:28
6541eb9d80db42c6ced396fcd198228bff9ec7f1...77e310b906112c9e20dfbf0e91249a0b81cf6107,2,8,9,17,6,2010-09-17 18:53:10,2010-09-17 18:53:10
77e310b906112c9e20dfbf0e91249a0b81cf6107...8691a826c0110639480b3eae9e21db05d72bf305,1,1,1,2,1,2010-09-17 18:58:50,2010-09-17 18:58:50
4fae75d575b20d887e4a273c7991c55f8821a62c...8b33e23ea07b206e96e39bb194675de80cff10ab,1,2,2,4,2,2010-12-12 19:37:00,2010-12-12 19:37:00
8b33e23ea07b206e96e39bb194675de80cff10ab...1a3fd3329dde3c61dc4b2b14792fb9a61b637893,3,62,22,84,9,2010-12-13 01:23:22,2010-12-13 01:23:22
1a3fd3329dde3c61dc4b2b14792fb9a61b637893...c9c9057c4d4097767ca181bdb4bb27d6fd2d8fbd,1,2,2,4,2,2010-12-13 02:01:47,2010-12-13 02:01:47
57c046f91cbc3caf174ecc993fe883c027340901...0229b83f7e5bf64edb2888ab349bedcd1a45e7c1,3,30,9,39,4,2010-10-05 18:23:10,2010-10-05 18:23:10
0229b83f7e5bf64edb2888ab349bedcd1a45e7c1...0cdcef5b364fa3c89d7f27935e77b453f4a56efd,6,145,52,197,21,2010-10-05 18:28:43,2010-10-05 18:28:43
0cdcef5b364fa3c89d7f27935e77b453f4a56efd...69e4f2535bb8c1fd373ab805aad969cce4e95573,1,7,2,9,2,2010-10-05 18:32:07,2010-10-05 18:32:07
69e4f2535bb8c1fd373ab805aad969cce4e95573...329b750af6649b3755920144bf1d52bfc3a42a0e,1,3,4,7,4,2010-10-05 18:38:19,2010-10-05 18:38:19
329b750af6649b3755920144bf1d52bfc3a42a0e...5057ff9f43017f673894584358ca95c8753b65d4,4,162,101,263,91,2010-10-05 19:53:35,2010-10-05 19:53:35
5057ff9f43017f673894584358ca95c8753b65d4...91028794d5029365eca0c3d40cfdae016403cbe6,2,16,20,36,17,2010-10-05 20:20:44,2010-10-05 20:20:44
91028794d5029365eca0c3d40cfdae016403cbe6...543db64412b37b5fa1f3d7fea19f62d6db993fb0,3,44,43,87,19,2010-10-09 01:29:41,2010-10-09 01:29:41
57c046f91cbc3caf174ecc993fe883c027340901...a2aefbf3b198620ae45d2451d21cc5bf96258a7d,1,1,1,2,1,2010-10-05 14:32:57,2010-10-05 14:32:57
8691a826c0110639480b3eae9e21db05d72bf305...7c5fd489ee7948b2235ebd7192544fa3695d400b,1,3,3,6,1,2010-09-17 19:40:04,2010-09-17 19:40:04
8691a826c0110639480b3eae9e21db05d72bf305...9dd70a44ad682e7b9aa66680c54a38789a116e27,2,4447,2534,6981,722,2010-09-17 19:38:27,2010-09-17 19:38:27
9dd70a44ad682e7b9aa66680c54a38789a116e27...2d70dc9c43831232a26dcdd01565df6c596ca977,2,4,4,8,4,2010-09-17 21:02:03,2010-09-17 21:02:03
2d70dc9c43831232a26dcdd01565df6c596ca977...7350e2e1cc671576804dab7cd82c739114146cb8,1,35,2,37,3,2010-09-17 22:26:21,2010-09-17 22:26:21
7350e2e1cc671576804dab7cd82c739114146cb8...be59693037c4230e1b395e51a42c6fc55b577455,1,4,2,6,2,2010-09-20 14:16:36,2010-09-20 14:16:36
be59693037c4230e1b395e51a42c6fc55b577455...5b92cdd0488804ba689dab70c6f8443aae23bcf9,1,1,1,2,1,2010-09-20 14:41:58,2010-09-20 14:41:58
5b92cdd0488804ba689dab70c6f8443aae23bcf9...747ba7defd82bffa6c7ccb69e53b834cbfddb62c,1,16,2,18,4,2010-09-20 18:53:29,2010-09-20 18:53:29
747ba7defd82bffa6c7ccb69e53b834cbfddb62c...20673d7e5836dda504b66730b528a8dae9787493,2,85,1,86,4,2010-09-20 21:47:41,2010-09-20 21:47:41
c9c9057c4d4097767ca181bdb4bb27d6fd2d8fbd...9f8cd6c499844451468257140e71f611abb3a040,3,65,39,104,12,2010-12-15 02:53:04,2010-12-15 02:53:04
9f8cd6c499844451468257140e71f611abb3a040...5b1b57850cfd4c92a4f9231581dff7faac489566,2,4,1,5,2,2010-12-15 23:31:10,2010-12-15 23:31:10
5b1b57850cfd4c92a4f9231581dff7faac489566...1ebb5ab3e1c670e04024cd949fa6f341e93c4487,1,2,1,3,1,2010-12-16 21:04:23,2010-12-16 21:04:23
1ebb5ab3e1c670e04024cd949fa6f341e93c4487...6bc9fc7c10a6dd2c8c7132307e63323a1f59d35f,1,5,1,6,1,2010-12-19 00:17:37,2010-12-19 00:17:37
6bc9fc7c10a6dd2c8c7132307e63323a1f59d35f...ade531cfaa194eb13fa6307368d1e715f3be8326,1,1,1,2,1,2010-12-19 00:26:36,2010-12-19 00:26:36
a2aefbf3b198620ae45d2451d21cc5bf96258a7d...2ca36598954759c5b5dce569a39c52b981ed4ab2,2,16,2,18,3,2010-10-09 14:42:01,2010-10-09 14:42:01
2ca36598954759c5b5dce569a39c52b981ed4ab2...2ae872c594790c4b935a1d7eabdf8b8212fd3c3f,2,27,2,29,4,2010-10-09 14:52:53,2010-10-09 14:52:53
2ae872c594790c4b935a1d7eabdf8b8212fd3c3f...51283d9643726721acc415dba891004a30cf1ae6,1,13,2,15,3,2010-10-09 15:41:58,2010-10-09 15:41:58
51283d9643726721acc415dba891004a30cf1ae6...da597bcf9014b1827e50c0e8f3b9268318574572,1,2,2,4,2,2010-10-09 16:26:44,2010-10-09 16:26:44
a2aefbf3b198620ae45d2451d21cc5bf96258a7d...b03416954d8033e641bd658fb18631699db6cc51,2,17,1,18,2,2010-10-09 03:48:06,2010-10-09 03:48:06
a2aefbf3b198620ae45d2451d21cc5bf96258a7d...d2e64979bf641181443a8e6456f6292973a7fa9a,1,4,2,6,2,2010-10-06 08:03:28,2010-10-06 08:03:28
10065a8deb471c358c53e4852025b0ac8a9c5d32...79305ed14617488e60416227d7eee70e07fe0c3c,1,1,0,1,1,2010-10-09 22:16:08,2010-10-09 22:16:08
79305ed14617488e60416227d7eee70e07fe0c3c...cbf9d874e52212d0289deae747066eccfebde770,1,4,1,5,2,2010-10-09 23:04:15,2010-10-09 23:04:15
cbf9d874e52212d0289deae747066eccfebde770...0ca35de311ff4d1dac5c9dc4de05a32a1754cd7a,3,62,13,75,8,2010-10-10 04:33:02,2010-10-10 04:33:02
0ca35de311ff4d1dac5c9dc4de05a32a1754cd7a...96d8c481b8cf64eb7ba789fce709e655f7706fd7,1,7,5,12,5,2010-10-10 17:22:39,2010-10-10 17:22:39
96d8c481b8cf64eb7ba789fce709e655f7706fd7...6f0b06aa9b467096ae781cf33f18fa925923cf6f,1,14,13,27,5,2010-10-10 17:37:36,2010-10-10 17:37:36
6f0b06aa9b467096ae781cf33f18fa925923cf6f...63c892b1ed1d51b7d8759f2fb6d52b0e6a11d419,1,8,6,14,3,2010-10-10 17:39:06,2010-10-10 17:39:06
63c892b1ed1d51b7d8759f2fb6d52b0e6a11d419...f2b028f736a46d4b3592b32df751db8e0f34f403,1,178,0,178,1,2010-10-10 18:16:35,2010-10-10 18:16:35
f2b028f736a46d4b3592b32df751db8e0f34f403...1f7bbd8939d1238c91942c6f0d49f9944f8db635,1,8,3,11,3,2010-10-10 18:51:11,2010-10-10 18:51:11
1f7bbd8939d1238c91942c6f0d49f9944f8db635...eb67d9941694d39a592228bc6da71def3e619b94,1,1,1,2,1,2010-10-10 19:14:23,2010-10-10 19:14:23
eb67d9941694d39a592228bc6da71def3e619b94...ba149e78a93afa9eab544c7defe3ccf0d412345a,2,9,8,17,5,2010-10-10 19:36:02,2010-10-10 19:36:02
ba149e78a93afa9eab544c7defe3ccf0d412345a...fac7e61f16130b29d5444fab12628a5eeea885cf,1,5,8,13,4,2010-10-10 19:42:56,2010-10-10 19:42:56
fac7e61f16130b29d5444fab12628a5eeea885cf...bb0b9b8958c22269767a151d86340d6eaf659bab,1,179,0,179,1,2010-10-10 20:06:33,2010-10-10 20:06:33
bb0b9b8958c22269767a151d86340d6eaf659bab...884de15fb970affd0b1697245795bce7b231a1db,1,1,1,2,1,2010-10-10 22:01:59,2010-10-10 22:01:59
884de15fb970affd0b1697245795bce7b231a1db...26db3f09331d0d69340d745a1e51d5e03a6eddb9,1,22,5,27,5,2010-10-10 22:46:32,2010-10-10 22:46:32
26db3f09331d0d69340d745a1e51d5e03a6eddb9...19b4ba35c4ef7528402067009c1b28898acc59d4,1,1,1,2,1,2010-10-10 22:54:30,2010-10-10 22:54:30
19b4ba35c4ef7528402067009c1b28898acc59d4...66a788ab837fd9b483740ee0b44c1e76f846aadd,1,1,1,2,1,2010-10-11 03:09:04,2010-10-11 03:09:04
66a788ab837fd9b483740ee0b44c1e76f846aadd...71a58263ec9e942410b36680eddcafaabe537c07,1,1,1,2,1,2010-10-11 03:09:07,2010-10-11 03:09:07
71a58263ec9e942410b36680eddcafaabe537c07...2c04035cd1d7cb1e73c6e9b2d63fc77e5165b8fc,1,4,2,6,1,2010-10-11 03:28:30,2010-10-11 03:28:30
2c04035cd1d7cb1e73c6e9b2d63fc77e5165b8fc...385ca2aa899d2ed953d9e18c95387e72e330b42c,2,5,3,8,3,2010-10-11 11:45:15,2010-10-11 11:45:15
385ca2aa899d2ed953d9e18c95387e72e330b42c...2866f16c09cce43044d721563a7bdbd9170fb494,1,1,1,2,1,2010-10-11 12:45:18,2010-10-11 04:37:46
653c04acb83cf5eeefc5b880f303cbc52ca29539...4a46f3d7fbbaa0b7dab49ac815ccec78f1c45d2b,2,4,2,6,4,2010-09-21 00:08:57,2010-09-21 00:08:57
4a46f3d7fbbaa0b7dab49ac815ccec78f1c45d2b...d5d4e4df65b56319b4f1216f63008a9751690315,2,6,2,8,4,2010-09-21 04:38:26,2010-09-21 04:38:26
d5d4e4df65b56319b4f1216f63008a9751690315...ae9df1412c41b1ae676d3808c323b0f01e0b0600,1,4,1,5,2,2010-09-21 04:44:47,2010-09-21 04:44:47
ae9df1412c41b1ae676d3808c323b0f01e0b0600...e7c2d3b45bf0e8fbe9d7c9316b6c5adb2c019ea3,2,14,8,22,6,2010-09-21 04:51:45,2010-09-21 04:51:45
e7c2d3b45bf0e8fbe9d7c9316b6c5adb2c019ea3...1f8a5e4bbc49c244051101765c46bd8f35e2aa32,2,5,3,8,5,2010-09-21 12:20:31,2010-09-21 12:20:31
1f8a5e4bbc49c244051101765c46bd8f35e2aa32...e0b24306a86629f02576017f25d295fbe07f21a5,2,14,12,26,4,2010-09-21 12:30:12,2010-09-21 12:30:12
e0b24306a86629f02576017f25d295fbe07f21a5...8ebb9b22df32fe5739a48087b6e33abb9f5cda49,1,1,2,3,2,2010-09-21 12:31:55,2010-09-21 12:31:55
8ebb9b22df32fe5739a48087b6e33abb9f5cda49...3a0a35288304ab5289a1815055623b18de4dc9f6,1,1,1,2,1,2010-09-21 12:53:34,2010-09-21 12:53:34
3a0a35288304ab5289a1815055623b18de4dc9f6...ba9e0fc177841bd74cc5ea4e52f09cd87d747bf5,3,18,3,21,5,2010-09-21 19:22:34,2010-09-21 19:22:34
ba9e0fc177841bd74cc5ea4e52f09cd87d747bf5...dc8491defe5360afe076249a696f72f73a96dc23,1,3,7,10,2,2010-09-21 20:13:50,2010-09-21 20:13:50
dc8491defe5360afe076249a696f72f73a96dc23...1ac3713e7fa187838b04290ada9e4fc56e01f145,1,1,1,2,1,2010-09-21 20:26:36,2010-09-21 20:26:36
1ac3713e7fa187838b04290ada9e4fc56e01f145...e3463946e19f2eb53d909fc2b59cc1c8636d21bd,2,5,2,7,3,2010-09-21 21:12:42,2010-09-21 21:12:42
e3463946e19f2eb53d909fc2b59cc1c8636d21bd...9ad7c21e701f827e108de038ff704f1e9b7022da,2,6,2,8,4,2010-09-22 11:34:31,2010-09-22 11:34:31
9ad7c21e701f827e108de038ff704f1e9b7022da...19b5d9e874bbd97d03d9e0561a70711e2bf91fcb,2,2,3,5,2,2010-09-22 12:08:45,2010-09-22 12:08:45
19b5d9e874bbd97d03d9e0561a70711e2bf91fcb...9dc6e0c572b9c809a3a4c123071d96d48a01dd1c,8,66,50,116,35,2010-09-22 13:16:28,2010-09-22 13:16:28
9dc6e0c572b9c809a3a4c123071d96d48a01dd1c...8e1d3697109e70ccdcb29e269af251216de057a8,2,5,5,10,5,2010-09-22 13:46:21,2010-09-22 13:46:21
8e1d3697109e70ccdcb29e269af251216de057a8...06883449d6ac16c2f9ed631da15d88929dd7f817,1,45,20,65,16,2010-09-22 15:21:59,2010-08-06 22:21:08
06883449d6ac16c2f9ed631da15d88929dd7f817...1f667aa035b3e4885d6b35fa9aa4990310f131af,3,25,11,36,14,2010-09-22 15:30:54,2010-09-08 20:31:32
1f667aa035b3e4885d6b35fa9aa4990310f131af...626624a19a6cbd70b44da08ee2123ba79f8e2bb0,2,18,15,33,14,2010-09-22 15:38:37,2010-09-07 16:51:57
626624a19a6cbd70b44da08ee2123ba79f8e2bb0...0b4b3ee8a5eda75d8399b333cda54f6b319fe74c,2,8,4,12,7,2010-09-22 15:52:32,2010-09-22 15:52:32
0b4b3ee8a5eda75d8399b333cda54f6b319fe74c...a32f4d7b6c197bcb521c7b0d351328f3821b6fee,1,2,2,4,2,2010-09-22 16:35:42,2010-09-22 16:35:42
a32f4d7b6c197bcb521c7b0d351328f3821b6fee...f9f9ee52e16f37900296e06982a7dccba89c5a78,2,31,0,31,3,2010-09-22 16:52:44,2010-09-22 16:52:44
f9f9ee52e16f37900296e06982a7dccba89c5a78...ab454d9526445fa025b9c897ec2b21aa89babc8d,1,1,1,2,1,2010-09-22 18:58:07,2010-09-22 18:58:07
ab454d9526445fa025b9c897ec2b21aa89babc8d...c8dd49f756562fef68f664869952e4f5aab08acd,4,11,6,17,7,2010-09-22 20:41:51,2010-09-22 20:41:51
c8dd49f756562fef68f664869952e4f5aab08acd...d7a6e75241ecc433cd5228174960dd8465ca3ff7,2,20,1,21,2,2010-09-22 20:50:38,2010-09-22 20:50:38
d7a6e75241ecc433cd5228174960dd8465ca3ff7...a7aa86d0b1a890468c945e473a1284352499b967,1,1,1,2,1,2010-09-22 20:56:48,2010-09-22 20:56:48
a7aa86d0b1a890468c945e473a1284352499b967...6a1d4f1a80e09e3857f25bb6eb7b190a3a9a4de0,1,1,1,2,1,2010-09-23 03:28:57,2010-09-23 03:28:57
6a1d4f1a80e09e3857f25bb6eb7b190a3a9a4de0...2f603359fecca5b4873c45775b293702a2c651e3,1,6,1,7,1,2010-09-23 03:43:55,2010-09-23 03:43:55
a03f040dbfb12da6409e31cb5923550d4be4a99e...574ae3b1be555dbd5242532739cd8e0a34e0569c,2,11,1,12,3,2011-01-21 15:33:50,2011-01-21 15:33:50
2defa4863a114358e03dbae1b10521555fd9cd9c...291b1edf444f30d9360a42c8d563e26eaf1a2ddb,1,2,4,6,4,2010-12-16 07:29:06,2010-12-16 07:29:06
2866f16c09cce43044d721563a7bdbd9170fb494...faabb2c31883deabaddd5642eb5e708b5802f2b0,1,3,2,5,1,2010-12-27 04:07:46,2010-10-11 16:54:00
2866f16c09cce43044d721563a7bdbd9170fb494...5646a4feee87b086fa4752373422622d54a8430d,2,34,3,37,2,2010-10-11 20:22:43,2010-10-11 20:22:43
2866f16c09cce43044d721563a7bdbd9170fb494...22ccbf82c8badd1d46f5ea52a0a7d5f3935a9fca,2,6,1,7,3,2010-10-11 19:11:03,2010-10-11 19:11:03
2866f16c09cce43044d721563a7bdbd9170fb494...aa9e4db1ab5cd6f514de616070829d64d69a3428,1,2,2,4,2,2010-10-11 14:08:38,2010-10-11 14:08:38
2f603359fecca5b4873c45775b293702a2c651e3...694b625c92c764621532dba20cbf943302b52d5a,2,11,7,18,4,2010-09-23 16:07:06,2010-01-30 18:50:49
694b625c92c764621532dba20cbf943302b52d5a...97b42492bb391bab346d265b70dc62e9d90ecd3d,1,5,1,6,2,2010-09-23 16:07:22,2010-02-04 21:54:53
97b42492bb391bab346d265b70dc62e9d90ecd3d...da5706c974f8ef720b3194179366e1096c19269e,2,47,0,47,2,2010-09-23 16:07:42,2010-03-14 11:34:32
da5706c974f8ef720b3194179366e1096c19269e...dc4c9abc39ce7eda44ff8878d476db1e57b7bc46,1,7,7,14,4,2010-09-23 16:08:15,2010-03-25 13:58:41
dc4c9abc39ce7eda44ff8878d476db1e57b7bc46...7367b524ec6c7cda0a4146e50a5dc6d7764bdef7,1,1,1,2,1,2010-09-23 16:08:29,2010-04-13 13:11:56
7367b524ec6c7cda0a4146e50a5dc6d7764bdef7...484cc6e22000aaa6cefab5752b165f6ebd62ffe1,2,15,3,18,5,2010-09-23 16:08:41,2010-08-27 23:14:59
484cc6e22000aaa6cefab5752b165f6ebd62ffe1...894bd02a06fc10cfa9cb3ebd1a17d8ede533b919,1,2,1,3,2,2010-09-23 16:08:54,2010-09-10 01:26:47
2f603359fecca5b4873c45775b293702a2c651e3...e270d804b4cee58dbf438251e9becb6f0f2ac123,1,2,1,3,1,2010-09-23 15:38:22,2010-09-23 15:38:22
291b1edf444f30d9360a42c8d563e26eaf1a2ddb...18fa1fd9da12fd6a259b422f91b663d9fbdb181e,1,1,1,2,1,2010-12-22 20:24:07,2010-12-22 20:24:07
291b1edf444f30d9360a42c8d563e26eaf1a2ddb...4424bda377336342ce04ab5299bf1ce624cdb7b1,2,8,5,13,5,2010-12-21 03:23:59,2010-12-21 03:23:59
4424bda377336342ce04ab5299bf1ce624cdb7b1...acab4ab0e50fadacb106468b1449643b9a03826b,1,1,1,2,1,2010-12-21 15:00:49,2010-12-21 15:00:49
291b1edf444f30d9360a42c8d563e26eaf1a2ddb...88d97deb773e6142b7656a4bc4ee973957b6ba49,3,450,179,629,21,2010-12-20 18:09:15,2010-12-20 18:09:15
88d97deb773e6142b7656a4bc4ee973957b6ba49...9e3f053c6568863251da20eba713d05f2bbdf9f0,1,8,6,14,5,2010-12-20 23:56:00,2010-12-20 23:56:00
9e3f053c6568863251da20eba713d05f2bbdf9f0...91d32e8f9699022ee468c060a24a43f947653f69,5,103,117,220,23,2010-12-21 12:06:41,2010-12-21 12:06:41
91d32e8f9699022ee468c060a24a43f947653f69...1db2f02cc78b10bd638d70457645e1daa5c01344,2,69,111,180,31,2010-12-21 15:58:52,2010-12-21 15:58:52
1db2f02cc78b10bd638d70457645e1daa5c01344...c810c62a67ca91785b214ce54950a1fc12592ef1,1,2,2,4,2,2010-12-21 16:04:07,2010-12-21 16:04:07
291b1edf444f30d9360a42c8d563e26eaf1a2ddb...faefbb1ad0b81e8001b582d06d5bd9c9236e62ce,3,30,10,40,10,2010-12-19 21:33:53,2010-12-19 21:33:53
01cba2ecaaedb5351f668bb09026db3e8bb69082...6ffa730721a8ebcd128f3dc202706e46d9cfe249,3,35,23,58,24,2010-12-27 19:03:27,2010-12-27 19:01:20
6ffa730721a8ebcd128f3dc202706e46d9cfe249...64ee5581afd6e9667ad45e75f082c95e2725efa6,2,41,0,41,2,2010-12-27 19:30:05,2010-12-27 19:30:05
64ee5581afd6e9667ad45e75f082c95e2725efa6...5fd21fc02bda43d4e31bcf2d5b55b918a9190a7f,2,19,2,21,3,2010-12-27 19:43:52,2010-12-27 19:43:52
d23f63b13ea47ac3e91906e5ac1e2503400cd903...1dee0d2ed8ae669d8276dbca06e27b70acb9a030,1,11,2,13,4,2010-10-11 21:52:00,2010-10-11 21:52:00
1dee0d2ed8ae669d8276dbca06e27b70acb9a030...c00a6ff1f14609bb166346a7f0c5174f4b0aa47b,1,8,0,8,1,2010-10-11 22:03:54,2010-10-11 22:03:54
c00a6ff1f14609bb166346a7f0c5174f4b0aa47b...1df5084c9748a8d38516266063344f145bc428c0,2,7,3,10,4,2010-10-11 22:20:57,2010-10-11 22:20:57
1df5084c9748a8d38516266063344f145bc428c0...6245ecb2b91cca73f66dc0543beb6626c138bcfc,1,27,28,55,23,2010-10-11 22:29:52,2010-10-11 22:29:52
6245ecb2b91cca73f66dc0543beb6626c138bcfc...ff6ceadbfd470463e63708413eb5a55bd7e90c69,2,12,8,20,9,2010-10-12 04:35:18,2010-10-12 04:35:18
6dfdb14753c66cfd38f8445bd6119ef4a1274d5e...a220c81eb9d65b514fcf3090a0aae75dadf5d371,1,2,2,4,2,2010-09-24 14:06:36,2010-09-24 14:06:36
a220c81eb9d65b514fcf3090a0aae75dadf5d371...5d45448e713af7d4a1e57a63ecde25589eb31007,1,4,2,6,3,2010-09-24 14:11:05,2010-06-25 14:24:36
5d45448e713af7d4a1e57a63ecde25589eb31007...5c055040d3685b2e01ee1ad06e403a3856f4c8b0,1,1,1,2,1,2010-09-24 14:13:00,2010-05-17 21:48:17
610ab137da38106f8c464f099a304ae3795c2231...73d060b522ccf72847e67f56fea0e9b129ff273e,1,1,1,2,1,2011-01-13 19:20:00,2011-01-13 19:20:00
82ac384b494258e17e2856ee2259475ecb0174ca...1f92edee207829a28de80ee72548cdbd599bcc79,1,3,1,4,1,2010-12-23 00:54:22,2010-12-23 00:54:22
8ece429d125785e36e468408f0dcb8c31f76da9e...11642ba20c10ced6363d81d6e3a0239ac10dab27,1,22,0,22,1,2010-12-24 17:02:00,2010-12-24 17:02:00
11642ba20c10ced6363d81d6e3a0239ac10dab27...d303687815581987f75f2e40e833022fc25c8741,5,19,30,49,14,2010-12-24 17:02:45,2010-12-24 17:02:45
d303687815581987f75f2e40e833022fc25c8741...1e1a9c7eb055511dce74e4b5f807b93d5a76bbd6,3,28,28,56,25,2010-12-24 17:53:55,2010-12-24 17:53:55
1e1a9c7eb055511dce74e4b5f807b93d5a76bbd6...e3f3f1892747004f86111fe17a8ed2e50c5d989e,1,0,2,2,1,2010-12-25 00:27:40,2010-12-25 00:27:40
e3f3f1892747004f86111fe17a8ed2e50c5d989e...846c52d1f8535a6283dcc42c6e8f0c26991936ad,2,41,115,156,29,2010-12-25 00:29:04,2010-12-25 00:29:04
846c52d1f8535a6283dcc42c6e8f0c26991936ad...5237b09602d5e360da361823748b0f34861b5a9a,2,7,31,38,8,2010-12-25 11:52:53,2010-12-25 11:52:53
5237b09602d5e360da361823748b0f34861b5a9a...00fb8a9ad61eb6d13e6f6c7c668caa66074f05d1,2,24,61,85,10,2010-12-25 14:38:33,2010-12-25 14:38:33
00fb8a9ad61eb6d13e6f6c7c668caa66074f05d1...f7ed2aca562620f9424b1667170352e798e99ef3,10,581,904,1485,22,2010-12-25 17:54:37,2010-12-25 17:54:37
f7ed2aca562620f9424b1667170352e798e99ef3...85f0dda56289ed6c044dadb3a42b1a4d2ddb0891,1,2,2,4,2,2010-12-25 22:00:25,2010-12-25 22:00:25
faefbb1ad0b81e8001b582d06d5bd9c9236e62ce...5607bd8d53c5086bedb702f71dee02543cc7056a,1,9,5,14,2,2010-12-22 15:14:53,2010-12-22 15:13:28
faefbb1ad0b81e8001b582d06d5bd9c9236e62ce...7f617e0c9f39d5cc608a05f808e6defade498fda,1,9,5,14,2,2010-12-22 15:13:28,2010-12-22 15:13:28
5fd21fc02bda43d4e31bcf2d5b55b918a9190a7f...dfa57073069c6b60f623635df65e02c0c0c9a582,1,6,7,13,5,2010-12-30 03:41:52,2010-12-30 03:41:52
5fd21fc02bda43d4e31bcf2d5b55b918a9190a7f...c27d5ca6f5b69818c48fdc9b0f988790653fb1a5,2,10,9,19,2,2010-12-29 02:07:04,2010-12-29 02:07:04
c27d5ca6f5b69818c48fdc9b0f988790653fb1a5...948c0dfffcf077ed71e4712b38a33d06ea63264c,1,6,6,12,2,2011-01-20 02:02:46,2011-01-20 02:02:46
ff6ceadbfd470463e63708413eb5a55bd7e90c69...1518ae1aedaafa820ed689ecf26cf43e92913896,2,6,3,9,5,2010-10-12 23:49:37,2010-10-12 23:49:37
ff6ceadbfd470463e63708413eb5a55bd7e90c69...5200194f517a7bde7bbe9aa50dc1e81f1e1db441,2,4,3,7,4,2010-10-12 13:19:49,2010-10-12 13:19:49
5200194f517a7bde7bbe9aa50dc1e81f1e1db441...085de849595ac99677795ed1524f840877a6b7bb,2,2,6,8,3,2010-10-12 14:13:00,2010-10-12 14:13:00
085de849595ac99677795ed1524f840877a6b7bb...478fa8fdb399c61acdbcc09d079aa4d6cecc2b60,1,0,1,1,1,2010-10-12 14:56:02,2010-10-12 14:56:02
478fa8fdb399c61acdbcc09d079aa4d6cecc2b60...b85f8673d943eb6b1b9403f1e2fc164e14e67880,1,1,1,2,1,2010-10-12 19:38:15,2010-10-12 19:38:15
b85f8673d943eb6b1b9403f1e2fc164e14e67880...3e5520fbdc7231b3f38e145020b40524c1e6654d,1,1,1,2,1,2010-10-12 19:44:36,2010-10-12 19:44:36
3e5520fbdc7231b3f38e145020b40524c1e6654d...9ced9f288ca53594a56487ccdd45bae1f5ec80e0,1,1,1,2,1,2010-10-12 19:44:53,2010-10-12 19:44:53
9ced9f288ca53594a56487ccdd45bae1f5ec80e0...783bb2a85fe33d00e82f40c8dab484e1cf0c63a1,2,2,2,4,2,2010-10-13 00:56:46,2010-10-13 00:56:46
5c055040d3685b2e01ee1ad06e403a3856f4c8b0...e0a9615f82fcdad73de6db42a995eb2a5550e361,1,1,1,2,1,2010-09-24 19:53:38,2010-09-24 19:53:38
e0a9615f82fcdad73de6db42a995eb2a5550e361...f10057bc481753d92ebfb8dfcef5197af5d76972,1,1,1,2,1,2010-09-24 19:57:51,2010-09-24 19:57:51
f10057bc481753d92ebfb8dfcef5197af5d76972...76db8a98220b6d76e98536b9578919bfb70048ed,2,35,3,38,5,2010-09-24 20:24:07,2010-09-24 20:24:07
76db8a98220b6d76e98536b9578919bfb70048ed...515efbdc7119aa79de710144effe18413d4cb14a,1,4,1,5,3,2010-09-24 20:30:57,2010-09-24 20:30:57
515efbdc7119aa79de710144effe18413d4cb14a...7862c45ad2f32096383a21b8b301155787724476,2,15,5,20,5,2010-09-24 20:57:25,2010-09-24 20:57:25
5c055040d3685b2e01ee1ad06e403a3856f4c8b0...a088751a1b2c5761dab8de9d7da8602defb45b11,1,2,2,4,2,2010-09-24 14:37:03,2010-09-24 14:37:03
cb1f7eeac5073748ae6200f2f960fb330ec966a8...2b64b1db6877f52ea2958c6aafb0e4644fbcfe13,1,4,2,6,1,2011-01-19 17:40:32,2011-01-19 17:40:32
1f92edee207829a28de80ee72548cdbd599bcc79...52b1709b94cf631e0641eebfa4f76b101528d93b,1,1,1,2,1,2010-12-26 16:35:14,2010-12-26 16:35:14
1f92edee207829a28de80ee72548cdbd599bcc79...116c82b027a03a7a5670fa580fa9af819cc1cc03,3,450,179,629,21,2010-12-24 11:55:46,2010-12-20 18:09:15
116c82b027a03a7a5670fa580fa9af819cc1cc03...56628c7adffb4b5436257255f55e31b85b58aa8f,1,8,6,14,5,2010-12-24 11:55:47,2010-12-20 23:56:00
56628c7adffb4b5436257255f55e31b85b58aa8f...0daf7223d08e2da983179e37e6c422abe90d6b82,5,104,118,222,23,2010-12-24 11:59:01,2010-12-21 12:06:41
0daf7223d08e2da983179e37e6c422abe90d6b82...38101be0484d79cb2d849ea252f508fe50bf72a3,2,68,110,178,30,2010-12-24 11:59:02,2010-12-21 15:58:52
38101be0484d79cb2d849ea252f508fe50bf72a3...76102f4d8b56d88f8e37bec65d552d132703198d,1,2,2,4,2,2010-12-24 11:59:03,2010-12-21 16:04:07
1f92edee207829a28de80ee72548cdbd599bcc79...0b6afcedd22aaffb96d3d45b9b220a16229e2f7c,2,44,0,44,2,2010-12-24 00:59:23,2010-12-23 21:21:14
0b6afcedd22aaffb96d3d45b9b220a16229e2f7c...c9e8a95709e12c6838a312850ce645e96a53ff5d,1,2,4,6,1,2010-12-24 14:53:39,2010-12-24 14:53:39
c9e8a95709e12c6838a312850ce645e96a53ff5d...b8931f744859e598aad52140d8ca085e013ac798,1,4,7,11,2,2010-12-27 17:43:48,2010-12-27 17:43:48
b8931f744859e598aad52140d8ca085e013ac798...007e2d152e10a8feffa347b5f328d2cb4bd45327,1,8,1,9,1,2011-01-15 15:24:13,2011-01-15 15:24:13
97b32d78307273f8bd2e5147bf5c0f0a45607a95...8c9d32723a8943d4595eb5e04be8f891a8ff7a7f,4,27,59,86,18,2010-12-28 01:30:51,2010-12-28 01:30:51
8c9d32723a8943d4595eb5e04be8f891a8ff7a7f...54d965ffa50fcc308721d370f952251d3da3e017,3,43,44,87,17,2010-12-28 03:13:44,2010-12-28 03:13:44
54d965ffa50fcc308721d370f952251d3da3e017...7490eb4f8e1930ca370eec21b4d5469f87b65db6,1,19,14,33,5,2010-12-29 17:44:45,2010-12-29 17:44:45
2a47ceae5b9bdc45fdc890e3cd5ec01c82db1688...445fdf720ce26b99aadace85b7ec976f90583c3a,2,5,9,14,3,2010-12-22 20:43:17,2010-12-22 20:43:17
445fdf720ce26b99aadace85b7ec976f90583c3a...f5d4bf8920868c2d1f88cc4f3bfcf85c0b566b2e,2,22,13,35,14,2010-12-22 20:54:37,2010-12-22 20:54:37
f5d4bf8920868c2d1f88cc4f3bfcf85c0b566b2e...e199ead4cba3687beca2444eea4bb8abc20f55b6,2,17,7,24,2,2010-12-22 21:03:01,2010-12-22 21:03:01
e199ead4cba3687beca2444eea4bb8abc20f55b6...a2bf7ab3c002e921aa1d4c9be9d0f337dfd4143d,1,1,1,2,1,2010-12-23 00:17:58,2010-12-23 00:17:58
dfa57073069c6b60f623635df65e02c0c0c9a582...9029dc02a234ad9699513f81acd1423f9c2c4e30,1,1,1,2,1,2010-12-30 05:58:03,2010-12-30 05:58:03
2e2d5e9db5ee9886644d75954d327e6d284e2da8...dc2e7317a90464e729fd9f29afaa16fa9c01487c,2,108,40,148,17,2011-01-21 02:58:28,2011-01-21 02:58:28
dc2e7317a90464e729fd9f29afaa16fa9c01487c...328a86f9a0d3f0907cc950f7543e34cb3efbda3f,2,5,30,35,4,2011-01-21 14:24:09,2011-01-21 14:24:09
2ef8da0924623a9bdede9eeed17ec848859844b7...ec462a33af41e9a2291599119e3ae74fc16e6a32,1,1,1,2,1,2010-10-13 04:07:52,2010-10-13 04:07:52
ec462a33af41e9a2291599119e3ae74fc16e6a32...9ede46b00423491fe5852b16ab0ed448e1f0f055,1,2,2,4,2,2010-10-13 04:10:32,2010-10-13 04:10:32
9ede46b00423491fe5852b16ab0ed448e1f0f055...73e4ef27f0d0a92e573092729107ca5572d52292,1,2,2,4,1,2010-10-13 04:32:52,2010-10-13 04:32:52
73e4ef27f0d0a92e573092729107ca5572d52292...8fb4d9af74d61e4bc55e615a21115c48bf5f65d9,1,2,2,4,2,2010-10-13 04:42:05,2010-10-13 04:42:05
8fb4d9af74d61e4bc55e615a21115c48bf5f65d9...39addc87a37b32be19f2c58ec8babe752c0243e1,1,4,4,8,2,2010-10-13 14:30:19,2010-10-13 14:30:19
39addc87a37b32be19f2c58ec8babe752c0243e1...88068f82c199847d3679b130664dd91cc2e89f00,2,24,5,29,5,2010-10-13 14:35:28,2010-10-13 14:35:28
88068f82c199847d3679b130664dd91cc2e89f00...f3d610e06499192509f482dbb72a1edf861827e0,1,2,0,2,1,2010-10-13 14:38:29,2010-10-13 14:38:29
f3d610e06499192509f482dbb72a1edf861827e0...cd8f4917ba1a6605b618fef1ac37b370604cd58b,1,2,2,4,1,2010-10-13 18:27:44,2010-10-13 18:27:44
cd8f4917ba1a6605b618fef1ac37b370604cd58b...d490bcfa7ca78a330e55b9267cc492a49c0f70bb,1,2,2,4,1,2010-10-14 01:25:23,2010-10-14 01:25:23
d490bcfa7ca78a330e55b9267cc492a49c0f70bb...ea507b3e998126ae1f94f4fd1618994d645c9cc8,1,8,5,13,3,2010-10-14 18:52:31,2010-10-14 18:52:31
ea507b3e998126ae1f94f4fd1618994d645c9cc8...ae772e742295591678ee53c89e5132df817c4606,3,1,1,2,1,2010-10-14 20:35:35,2010-10-14 20:35:35
ae772e742295591678ee53c89e5132df817c4606...8576570e6e5f2ebd95c49a66848f066dcf99d673,2,3,3,6,3,2010-10-14 20:57:12,2010-10-14 20:57:12
8576570e6e5f2ebd95c49a66848f066dcf99d673...80a4178af9b12e6617bfcec818c538dfe08d3791,1,4,4,8,2,2010-10-15 00:55:40,2010-10-15 00:55:40
80a4178af9b12e6617bfcec818c538dfe08d3791...c8e5d0bca04daebd335a8854e93519175893d4d0,1,2,3,5,1,2010-10-15 01:15:20,2010-10-15 01:15:20
c8e5d0bca04daebd335a8854e93519175893d4d0...f009fb2f86febdfce52a7ffc942dd92ca5067d48,1,2,2,4,1,2010-10-15 01:31:36,2010-10-15 01:31:36
f009fb2f86febdfce52a7ffc942dd92ca5067d48...2d5f8666acf9968b0424b196a26fd92a1e48125e,1,15,9,24,5,2010-10-15 01:40:35,2010-10-15 01:40:35
2d5f8666acf9968b0424b196a26fd92a1e48125e...40aa95c32097b0bc669ea5b1e127717b54b0335a,1,46,17,63,2,2010-10-15 01:48:03,2010-10-15 01:48:03
40aa95c32097b0bc669ea5b1e127717b54b0335a...21d389cceaace3272dede54aa8f92f2429d92e00,1,1,2,3,2,2010-10-15 02:06:27,2010-10-15 02:06:27
21d389cceaace3272dede54aa8f92f2429d92e00...0564553bf15cd54eb5af18810bf2e9300628ccc1,1,6,32,38,6,2010-10-15 02:37:56,2010-10-15 02:37:56
0564553bf15cd54eb5af18810bf2e9300628ccc1...2d201873ff47b927a8c1efcee07191a47033744c,1,1,1,2,1,2010-10-15 03:10:06,2010-10-15 03:10:06
2d201873ff47b927a8c1efcee07191a47033744c...091c481acaff96763596a82b423fbfd96f3332db,1,1,1,2,1,2010-10-15 03:10:19,2010-10-15 03:10:19
091c481acaff96763596a82b423fbfd96f3332db...497fc9849e91ba8602adf7908b4febf2d36bc1c8,1,4,4,8,2,2010-10-15 05:29:38,2010-10-15 05:29:38
7862c45ad2f32096383a21b8b301155787724476...395a032ad8263f2674fc95b779a7e9623c6317b9,1,3,1,4,1,2010-09-24 21:04:54,2010-09-24 21:04:54
7862c45ad2f32096383a21b8b301155787724476...033a4c41e0440106a0dffdd7328cd8b04781b45d,1,1,1,2,1,2010-09-24 21:00:18,2010-07-07 04:38:54
033a4c41e0440106a0dffdd7328cd8b04781b45d...c8c8f8458a579d8f87e7ee6b8e4510cc4e4445bb,1,1,1,2,2,2010-09-24 21:01:31,2010-06-27 01:16:39
56ffad2dad138293c132e6ad353111bd2d1f1239...cccd092fe0c3e680b6ba3fcfb3368aa3b65bd245,1,2,2,4,2,2011-04-11 19:43:43,2011-04-11 19:43:43
cccd092fe0c3e680b6ba3fcfb3368aa3b65bd245...11adde5127ec496cf692237ea0d4f6217eac97b8,6,460,460,920,229,2011-04-11 20:33:29,2011-04-11 20:33:29
11adde5127ec496cf692237ea0d4f6217eac97b8...f42010b6574af9e57b3782eced61a7d955bf06d6,7,616,616,1232,309,2011-04-12 08:47:46,2011-04-12 08:47:46
f42010b6574af9e57b3782eced61a7d955bf06d6...8547b34f9265ed2d2b5380b1db5dfcaf97d96d5a,1,3,8,11,3,2011-04-12 09:18:44,2011-04-12 09:18:44
56ffad2dad138293c132e6ad353111bd2d1f1239...272b8d69dcff771ffdb61ccd33c4e83eaea8ca50,2,26,6,32,4,2011-04-11 18:33:52,2011-04-11 18:33:52
56ffad2dad138293c132e6ad353111bd2d1f1239...780b7983d0a2fbde5cedcdb431a1f2436b256d40,1,34,30,64,4,2011-04-11 17:01:04,2011-04-11 17:01:04
56ffad2dad138293c132e6ad353111bd2d1f1239...6591f6dd9d1c86144903f60e5d19e624c5bf6751,1,2,7,9,2,2011-04-11 15:22:52,2011-04-11 15:22:52
56ffad2dad138293c132e6ad353111bd2d1f1239...467747d55f9fa38bfdacc7908dd396859206f2d7,1,4,4,8,4,2011-04-11 04:24:38,2011-04-11 04:24:38
467747d55f9fa38bfdacc7908dd396859206f2d7...91d039881310bab4c56b89d2b3c0b8bfd9200297,1,1,1,2,1,2011-04-11 04:32:45,2011-04-11 04:32:45
52b1709b94cf631e0641eebfa4f76b101528d93b...a939ade9c6d2b42be24031d902c86ec52847c0cc,1,26,26,52,23,2010-12-26 20:28:13,2010-12-26 20:28:13
a939ade9c6d2b42be24031d902c86ec52847c0cc...37d297c67fe3569a5a9d81586e14d4a887df7879,1,0,17,17,1,2010-12-26 20:28:49,2010-12-26 20:28:49
52b1709b94cf631e0641eebfa4f76b101528d93b...1830db422628d1556377621612b401bac5afa40e,1,7,22,29,4,2010-12-26 18:52:27,2010-12-26 18:51:29
1830db422628d1556377621612b401bac5afa40e...78a6f5b152f40739769169c76726cead5cb7206b,1,2,2,4,1,2010-12-26 22:49:01,2010-12-26 22:49:01
64902e03450dc9164dbdb046a701008a249497c1...7b1e873cd9656ab9184242cba708faecd5f46c3d,2,30,44,74,13,2010-12-30 16:06:53,2010-12-30 16:06:53
429b078dc7b5cf7765b44c8d32e125ecd8f1e2c9...3e0cc815043c2425819743e907a0ce263a7ce164,26,688,688,1376,658,2010-12-30 06:34:48,2010-12-30 06:34:48
3e0cc815043c2425819743e907a0ce263a7ce164...4eeae8b0bc789ad525e98568cffb37b04b27ae84,2,18,1,19,2,2010-12-30 07:23:08,2010-12-30 07:16:39
4eeae8b0bc789ad525e98568cffb37b04b27ae84...c1625f6b79b2693ea85f2c16349f708ff203773b,2,28,3,31,3,2010-12-30 07:38:28,2010-12-30 07:38:28
c1625f6b79b2693ea85f2c16349f708ff203773b...5bacb53866dbc3fbb36202a25c756a4ea2fd5965,3,458,187,645,21,2010-12-31 02:49:22,2010-12-20 18:09:15
5bacb53866dbc3fbb36202a25c756a4ea2fd5965...c072dbd4e283f2e601b0004920c46d2e6b62f899,1,8,6,14,5,2010-12-31 02:49:23,2010-12-20 23:56:00
c072dbd4e283f2e601b0004920c46d2e6b62f899...4c49c87d4daf7a5eb1b98a4d324ee599508cf1be,5,109,123,232,23,2010-12-31 02:53:00,2010-12-21 12:06:41
4c49c87d4daf7a5eb1b98a4d324ee599508cf1be...fef0f63526df8c4e186780c742fbcd717424581b,2,70,112,182,15,2010-12-31 02:56:10,2010-12-21 15:58:52
fef0f63526df8c4e186780c742fbcd717424581b...43828b7482d33e4ee96f482779b98528b7266ea2,1,2,2,4,2,2010-12-31 02:56:11,2010-12-21 16:04:07
43828b7482d33e4ee96f482779b98528b7266ea2...39d96ab8c55a044deccaff0ef8bc2c5813656368,1,1,1,2,1,2010-12-31 03:01:39,2010-12-20 18:09:15
39d96ab8c55a044deccaff0ef8bc2c5813656368...2fec5dbecd3dc6d2acfcb4df28d29638637ac579,1,2,2,4,2,2010-12-31 03:02:33,2010-12-20 23:56:00
2fec5dbecd3dc6d2acfcb4df28d29638637ac579...e29ebbc199ecf1d2c9f5b7de9113f34e818ffe11,1,2,2,4,2,2010-12-31 03:05:46,2010-12-21 12:06:41
e29ebbc199ecf1d2c9f5b7de9113f34e818ffe11...d5bb001b9a3cbe0753d11f7c20cede83e9c2d775,1,2,2,4,2,2010-12-31 03:05:48,2010-12-21 15:58:52
d5bb001b9a3cbe0753d11f7c20cede83e9c2d775...5bfbe7eaf6481cfda6f2c790fa070d58e1abc74d,1,2,2,4,2,2010-12-31 03:05:49,2010-12-21 16:04:07
5bfbe7eaf6481cfda6f2c790fa070d58e1abc74d...524bf39400e12db84e6857988d431c2c8ca7b2fb,1,22,0,22,1,2010-12-31 03:05:50,2010-12-24 17:02:00
524bf39400e12db84e6857988d431c2c8ca7b2fb...22e28b01e60e87b2454f88ca128fb84916b13564,5,19,30,49,14,2010-12-31 03:05:52,2010-12-24 17:02:45
22e28b01e60e87b2454f88ca128fb84916b13564...2d4001b82c6325ac6a767294e96a8af8f920f7cd,3,28,28,56,25,2010-12-31 03:05:53,2010-12-24 17:53:55
2d4001b82c6325ac6a767294e96a8af8f920f7cd...fd63416ab191c9c757ba8ca155f2656fcc8ce000,1,0,2,2,1,2010-12-31 03:05:54,2010-12-25 00:27:40
fd63416ab191c9c757ba8ca155f2656fcc8ce000...23d455b4469f2b47363c21867aad271d6930f112,2,41,115,156,29,2010-12-31 03:05:55,2010-12-25 00:29:04
23d455b4469f2b47363c21867aad271d6930f112...240d8b681e222dcbc50192331ed7ba00b0e07e0e,2,7,31,38,8,2010-12-31 03:05:56,2010-12-25 11:52:53
240d8b681e222dcbc50192331ed7ba00b0e07e0e...6f53be1839b10486c624e07595533d57c602eda5,2,24,61,85,10,2010-12-31 03:05:58,2010-12-25 14:38:33
6f53be1839b10486c624e07595533d57c602eda5...981d1e08eb00f4b5c29ad1f3977a45e30c93ad70,10,583,907,1490,22,2010-12-31 03:13:40,2010-12-25 17:54:37
981d1e08eb00f4b5c29ad1f3977a45e30c93ad70...2a5c16f217416a7cb5afce72a0f25c66d074fc0c,1,2,2,4,2,2010-12-31 03:13:42,2010-12-25 22:00:25
2a5c16f217416a7cb5afce72a0f25c66d074fc0c...6165cc45b7f673aa0d9daf33659a2783f68a45ac,4,30,62,92,17,2010-12-31 03:15:09,2010-12-28 01:30:51
6165cc45b7f673aa0d9daf33659a2783f68a45ac...6dbffb8596a9c96c68386ecc2d95da25b9dee369,3,43,44,87,17,2010-12-31 03:15:11,2010-12-28 03:13:44
6dbffb8596a9c96c68386ecc2d95da25b9dee369...3c6f1380fa67542ff8c67d6363a865ae3ec23516,1,19,14,33,5,2010-12-31 03:15:12,2010-12-29 17:44:45
3c6f1380fa67542ff8c67d6363a865ae3ec23516...6fb9759a75bf2b9a2aa3a8fce9cd7afc011d8c4f,2,30,44,74,13,2010-12-31 03:15:15,2010-12-30 16:06:53
328a86f9a0d3f0907cc950f7543e34cb3efbda3f...ad0ebf00abca53caaaa46fb172024ba9b23b03a1,1,10,4,14,3,2011-01-21 14:51:30,2011-01-21 14:51:30
497fc9849e91ba8602adf7908b4febf2d36bc1c8...df7dfc2404807dce2f97c21782eb3a14ced86d6b,1,18,16,34,16,2010-10-17 15:30:05,2010-10-17 15:30:05
497fc9849e91ba8602adf7908b4febf2d36bc1c8...25828768d7bc2d76438244e69d6eeb69c36227e6,1,2,2,4,1,2010-10-17 14:50:17,2010-10-17 14:50:17
25828768d7bc2d76438244e69d6eeb69c36227e6...e1b940d74824282fd3466d39a8ab574da4ef6fc5,2,16,1,17,4,2010-10-17 14:56:01,2010-10-17 14:56:01
e1b940d74824282fd3466d39a8ab574da4ef6fc5...a7d0b0b9e887782bf1ed795152a845da87729c52,1,1,1,2,1,2010-10-17 14:58:01,2010-10-17 14:58:01
a7d0b0b9e887782bf1ed795152a845da87729c52...8a5df39045292397a06d08b4fab2ad29819b5d44,2,66,23,89,7,2010-10-17 15:42:53,2010-10-17 15:42:53
8a5df39045292397a06d08b4fab2ad29819b5d44...97dfa0d5a85a32fe56aba837bbf2bc889b092d2b,3,12,1,13,3,2010-10-17 18:26:32,2010-10-17 18:26:32
97dfa0d5a85a32fe56aba837bbf2bc889b092d2b...008e971943b0ce55333a65caea7f64eb82b985ac,1,11,3,14,5,2010-10-17 18:48:24,2010-10-17 18:48:24
700ff05af0d30722dcc23a69849bfb278fdc7e75...2c4b20809e5d32e916c479c9b63a6b7528c880ce,6,31,12,43,12,2010-09-24 21:26:22,2010-09-24 21:26:22
2c4b20809e5d32e916c479c9b63a6b7528c880ce...69994211b078b8711220eaef33cc1bd6a63c5772,1,1,1,2,1,2010-09-24 21:44:48,2010-06-29 03:21:59
69994211b078b8711220eaef33cc1bd6a63c5772...1130beb72be9d9f5d6bb6f303501da5ec2e3744e,1,1,1,2,1,2010-09-24 21:47:37,2010-09-24 21:47:37
1130beb72be9d9f5d6bb6f303501da5ec2e3744e...c4e653237f258ce618ad5a9ec677917166fbed16,1,5,4,9,4,2010-09-24 21:56:03,2010-09-24 21:56:03
a5604aedb74ec39624b21229a5c8542c793b0382...02e0047e92de0f1575fb92c091806c4eb4b6ef26,1,0,4,4,2,2011-04-12 09:39:21,2011-04-12 09:39:21
02e0047e92de0f1575fb92c091806c4eb4b6ef26...01a2b51b26cddc6eb22dcb900b5c7b9fdb217113,1,1,1,2,1,2011-04-12 11:07:38,2011-04-12 11:07:38
01a2b51b26cddc6eb22dcb900b5c7b9fdb217113...f19a74f10b82faf61e91a1408d0776d02511b28c,1,1,1,2,1,2011-04-12 11:12:58,2011-04-12 11:12:58
db80ad94d5f8d008b44b4b4b13157b5aeea14c4f...0ff4c69929572e107624139851add5c9a5ec28c6,1,5,5,10,4,2011-04-12 04:38:48,2011-04-12 04:38:48
0ff4c69929572e107624139851add5c9a5ec28c6...312df0441b16981dd697d74fcbc1e1f212b47b7e,2,0,19,19,2,2011-04-12 04:54:12,2011-04-12 04:54:12
8806435a77886dad8970e8f9ddba1ef728d779f8...7dc707042692398392bd910b01f3a6aab81a90a0,1,62,46,108,29,2011-04-14 13:21:08,2011-04-14 13:21:08
6591f6dd9d1c86144903f60e5d19e624c5bf6751...eb857e2b714e6786078cf8641941f267a6e19fa0,1,6,1,7,2,2011-04-11 15:54:55,2011-04-11 15:54:55
eb857e2b714e6786078cf8641941f267a6e19fa0...a564a0b1ec167b2f0fdd2d017a986b226a9850f6,2,3,4,7,4,2011-04-11 16:24:31,2011-04-11 16:24:31
6591f6dd9d1c86144903f60e5d19e624c5bf6751...868e1e28ce7cee543e0e47ec2261b44c4c686f99,1,5,2,7,3,2011-04-11 15:32:23,2011-04-11 15:32:23
bb520104426136c5dd3a78ba5955158b397fa2f6...530c915553dd21f7f933d6d1ca8102ae714f5aa2,1,18,15,33,5,2011-04-11 15:15:00,2011-04-11 15:15:00
f01ef93aab1d2e90efbcacc71b01180f7f33656b...220a0ce1628d376ec14394c9b0be3c10f92a4cdb,2,34,24,58,7,2011-01-17 21:31:12,2011-01-17 21:31:12
f01ef93aab1d2e90efbcacc71b01180f7f33656b...28a1bad7b18b7ca4937666893e268d6e1378ee4f,1,3,0,3,1,2011-01-17 21:10:14,2011-01-17 21:10:14
28a1bad7b18b7ca4937666893e268d6e1378ee4f...4058881784cec4adad881188064421ded69a0258,1,1,0,1,1,2011-01-17 22:03:45,2011-01-17 22:03:45
4058881784cec4adad881188064421ded69a0258...78be517727674d1e0a208e3e144eac8840d653e7,1,1,1,2,1,2011-01-17 22:08:44,2011-01-17 22:08:44
78be517727674d1e0a208e3e144eac8840d653e7...d9660e1bf4f378e0fcb77ba266f27cdec7cda022,1,1,1,2,1,2011-01-17 22:20:37,2011-01-17 22:20:37
7e2810fa950f24055384e0b3be5b282183540c39...eed3803c98bf5c074e40aad12f2e91435bf81154,2,6,6,12,6,2010-12-31 19:56:51,2010-12-31 19:56:51
1922f311a321620f9df609503f49f41a53671ea4...f1bd0cfc4d3eabf566b6a3345d888e6db67bc00b,2,5,4,9,4,2011-01-21 23:41:42,2011-01-21 23:41:42
f1bd0cfc4d3eabf566b6a3345d888e6db67bc00b...4413c2fd93dc3809cb000492c86d8ffba39cf59a,1,5,5,10,2,2011-01-22 00:12:18,2011-01-22 00:12:18
4413c2fd93dc3809cb000492c86d8ffba39cf59a...bea4815294f6bdf94cbe50a5a978e2c6bfa2c396,1,261,314,575,52,2011-01-22 03:45:20,2011-01-22 03:45:20
bea4815294f6bdf94cbe50a5a978e2c6bfa2c396...30082d9eba66c3c919c9f8c5b97841568c443d68,1,26,46,72,31,2011-01-23 04:01:36,2011-01-23 04:01:36
30082d9eba66c3c919c9f8c5b97841568c443d68...dd5bf421225d23bc8732a92ea82049859c0cd57a,4,182,199,381,146,2011-01-23 04:51:41,2011-01-23 04:51:41
dd5bf421225d23bc8732a92ea82049859c0cd57a...ee22c8b34bb801f26cacc67a1a3a0ac595fe7928,3,10,11,21,10,2011-01-23 19:46:09,2011-01-23 19:46:09
ee22c8b34bb801f26cacc67a1a3a0ac595fe7928...02ca45573b8428f16e3eddb41f8fc50867bbda1b,1,80,103,183,9,2011-01-23 21:03:24,2011-01-23 21:03:24
3418f323876043db63a2da9f653e51d5458647fa...0d8b247cab2f91e118d0b734028ce827e09a71f7,3,10,2,12,5,2011-04-12 20:48:22,2011-04-12 20:48:22
008e971943b0ce55333a65caea7f64eb82b985ac...4fcfee4369d184d26ef819c34412fb8d9b09962c,1,2,2,4,2,2010-10-19 09:14:07,2010-10-19 09:14:07
008e971943b0ce55333a65caea7f64eb82b985ac...689d63f4871d96300d492fa5ab9d25301070efba,1,2,2,4,2,2010-10-19 05:32:13,2010-10-19 05:29:20
c4e653237f258ce618ad5a9ec677917166fbed16...adff8e45e255409e8f78a3347dea01bdbee0a53d,1,1,0,1,1,2010-09-24 22:02:31,2010-09-24 22:02:31
c4e653237f258ce618ad5a9ec677917166fbed16...0636dffc2481c14368464a22ffa1bd8017da2a26,2,12,5,17,5,2010-09-24 21:57:14,2010-08-21 02:32:34
f19a74f10b82faf61e91a1408d0776d02511b28c...7164615f6727c67da612fecc63867d30e1b4b4a3,3,44,3,47,7,2011-04-12 15:48:07,2011-04-12 15:48:07
7164615f6727c67da612fecc63867d30e1b4b4a3...885b64d4e683bce475a4ec8495cbba80b6b2e1b3,1,29,25,54,6,2011-04-12 17:50:15,2011-04-12 17:47:27
885b64d4e683bce475a4ec8495cbba80b6b2e1b3...81de96af740f8d397585d8a6fc2a3765dfd16d49,1,16,21,37,7,2011-04-12 22:57:14,2011-04-12 21:27:45
81de96af740f8d397585d8a6fc2a3765dfd16d49...4fde550cb62219d7edd14653888608fbbf39c22a,2,42,23,65,12,2011-04-13 17:43:52,2011-04-13 17:43:52
4fde550cb62219d7edd14653888608fbbf39c22a...59240d31c0c277a60fdc187e0fc9884007971106,2,10,12,22,8,2011-04-13 17:58:17,2011-04-13 17:58:17
59240d31c0c277a60fdc187e0fc9884007971106...a76decc47660591bb807aecf56825019da8b39fa,3,27,23,50,15,2011-04-13 19:43:15,2011-04-13 19:43:15
eccf15be6cfee8b567785ba29cc8841b1b0c2ef1...7666c3ef9a72fb77eaa018b692fd905be5559564,1,6,11,17,5,2011-04-15 13:18:21,2011-04-15 13:18:21
7666c3ef9a72fb77eaa018b692fd905be5559564...7bc8227d2966d0e91eb1725261fb71157bcbe854,1,1,1,2,1,2011-04-15 13:30:19,2011-04-15 13:30:19
7bc8227d2966d0e91eb1725261fb71157bcbe854...bcc8187b059792d9f9c0510e23c08ae037916c7e,1,3,7,10,3,2011-04-15 14:33:21,2011-04-15 14:33:21
f6f1cc77f402f0825898756e8c2100798918a61a...2b70893928035d53f46575003197e4a1fa52a844,2,8,13,21,13,2011-04-11 23:09:35,2011-04-11 23:09:35
31b3c44db3b26274b1ad0efd46952ecc2a9380cc...1299e89dcd803ee0ed48622c716dc3d4c8567cb7,2,19,0,19,2,2011-04-12 04:17:07,2011-04-12 04:17:07
220a0ce1628d376ec14394c9b0be3c10f92a4cdb...0c1ffe3cb381430ec501385fcb29dca22a27d816,1,55,12,67,19,2011-01-17 22:44:42,2011-01-17 22:44:42
eed3803c98bf5c074e40aad12f2e91435bf81154...4ab94a578ee7760c4e44bafa56139af82c40028b,1,1,1,2,1,2011-01-04 14:52:26,2011-01-04 14:52:26
4ab94a578ee7760c4e44bafa56139af82c40028b...cbf591152c9f61381e552c9a15bb7c339f1451a9,3,40,36,76,22,2011-01-05 03:29:30,2011-01-05 03:29:30
eed3803c98bf5c074e40aad12f2e91435bf81154...037d6bd5c33cea91974bbfeaaa30d26e9dc94d48,2,4,2,6,3,2011-01-01 22:13:04,2011-01-01 22:13:04
037d6bd5c33cea91974bbfeaaa30d26e9dc94d48...5f52e61d74678786e2f40d4edbeb2396661bb9bc,1,0,1,1,1,2011-01-01 22:18:47,2011-01-01 22:18:47
eed3803c98bf5c074e40aad12f2e91435bf81154...612a908514b6ad6ec35754b0193887b01ce2c9f2,2,45,1,46,3,2011-01-01 18:49:59,2011-01-01 18:49:59
02ca45573b8428f16e3eddb41f8fc50867bbda1b...33de9c559789d7f4565c9c57a7152f3ca2721b65,1,23,19,42,7,2011-01-24 03:22:46,2011-01-24 03:22:46
33de9c559789d7f4565c9c57a7152f3ca2721b65...6d358c0cdd4f84884c3d776bad0f48a93908b29b,1,3,5,8,2,2011-01-24 19:01:25,2011-01-24 19:01:25
6d358c0cdd4f84884c3d776bad0f48a93908b29b...6c18a1becb59f1b2e64a4920967dc5cecdb296f6,1,5,3,8,2,2011-01-24 19:14:55,2011-01-24 19:14:55
02ca45573b8428f16e3eddb41f8fc50867bbda1b...c50b74372c398b0c85164ad01977c5118b55d418,9,15,14,29,15,2011-01-24 03:19:33,2011-01-24 03:19:33
0d8b247cab2f91e118d0b734028ce827e09a71f7...42e20269ecf7a300c6dbd7475b8bef2ef160c546,1,1,1,2,1,2011-04-13 20:41:55,2011-04-13 20:41:55
0d8b247cab2f91e118d0b734028ce827e09a71f7...73f9ab67058d2dc14ab81c62bd9b228b0e1cad93,1,6,3,9,3,2011-04-12 22:30:21,2011-04-12 22:30:21
4fcfee4369d184d26ef819c34412fb8d9b09962c...1a2400de08a762c854e02865603d4f14f9f1c6cc,1,2,2,4,2,2010-10-25 15:19:45,2010-10-25 15:19:45
4fcfee4369d184d26ef819c34412fb8d9b09962c...0174518a49e86e3f479eaf916a68b64a1e662a4f,1,3,3,6,3,2010-10-22 03:18:47,2010-10-22 03:18:47
0174518a49e86e3f479eaf916a68b64a1e662a4f...9be7461c3c7e85b1995766533db8806eb0909779,1,8,2,10,4,2010-10-22 03:46:21,2010-10-22 03:46:21
9be7461c3c7e85b1995766533db8806eb0909779...3df41db0369cfaf0fc229c633eb87f222ad49357,1,2,2,4,1,2010-10-22 04:08:34,2010-10-22 04:08:34
3df41db0369cfaf0fc229c633eb87f222ad49357...e4a38670b10b1ce776afff389bae34991e986180,2,23,1,24,3,2010-10-22 04:28:33,2010-10-22 04:28:33
e4a38670b10b1ce776afff389bae34991e986180...8b129ccd49365582c4013fd391f6f83cc75a5d0a,1,2,0,2,1,2010-10-22 04:29:52,2010-10-22 04:29:52
8b129ccd49365582c4013fd391f6f83cc75a5d0a...4fc86d5eb1d4eaa3efad77dc224271d254f491e4,1,7,1,8,2,2010-10-22 04:36:07,2010-10-22 04:36:07
4fc86d5eb1d4eaa3efad77dc224271d254f491e4...6bc30425f6d3c9c1eaddacc5d08bb29a4a0636ca,1,2,1,3,2,2010-10-22 04:40:06,2010-10-22 04:40:06
6bc30425f6d3c9c1eaddacc5d08bb29a4a0636ca...424500bcf068a234b13cd9ef33d94580c35eeb86,3,50,83,133,45,2010-10-22 05:18:58,2010-10-22 05:18:58
424500bcf068a234b13cd9ef33d94580c35eeb86...d9a3e0080a4ffe472a2ee4458b223fb1feb8021c,3,83,50,133,45,2010-10-22 05:48:32,2010-10-22 05:48:32
d9a3e0080a4ffe472a2ee4458b223fb1feb8021c...7e02cee5ff8b5e9117366d7b43af7b5794f0f258,2,21,11,32,6,2010-10-22 06:16:14,2010-10-22 06:16:14
7e02cee5ff8b5e9117366d7b43af7b5794f0f258...53396b879bd29c090824da182e3cf69158829f82,3,26,28,54,5,2010-10-22 06:39:06,2010-10-22 06:39:06
53396b879bd29c090824da182e3cf69158829f82...9bd9ebdd73fe0e2d29fadf82947c98adde4023e7,1,1,1,2,1,2010-10-23 04:35:09,2010-10-23 04:35:09
4fcfee4369d184d26ef819c34412fb8d9b09962c...a58f8f22d19ff88fedb324bdf97d22dd7c16131f,1,1,1,2,1,2010-10-21 04:12:47,2010-10-21 04:12:47
689d63f4871d96300d492fa5ab9d25301070efba...dd79199a08b9b69d139606619b818c429e0540c3,1,3,1,4,1,2010-11-22 04:30:17,2010-11-22 04:12:12
689d63f4871d96300d492fa5ab9d25301070efba...1ac7b459a4defb8238309ae47afb3637719cf8be,1,3,1,4,1,2010-11-22 04:12:12,2010-11-22 04:12:12
83b261c9767e75b006b849481e6b0736956801e3...42aa714fb79199ad0a45d5f76f43729b399b058a,2,1,1,2,1,2010-09-27 00:47:19,2010-09-27 00:47:19
42aa714fb79199ad0a45d5f76f43729b399b058a...157a383dae5335ef1056d3818d7dd70ac81c25a7,1,1,1,2,1,2010-09-27 13:07:54,2010-09-27 13:07:54
157a383dae5335ef1056d3818d7dd70ac81c25a7...a384d840d609a8ee25b8ca8769a99c33c73b022f,1,1,1,2,1,2010-09-27 13:19:21,2010-09-27 13:19:21
a384d840d609a8ee25b8ca8769a99c33c73b022f...97d468fbf0f840f52c91855b0bc8db0ed6ac403c,2,12,2,14,6,2010-09-27 14:19:55,2010-09-27 14:19:55
97d468fbf0f840f52c91855b0bc8db0ed6ac403c...d558e9eb6f44783bb06666617c758408daf53e3d,2,4,5,9,3,2010-09-27 14:21:50,2010-09-27 14:21:50
d558e9eb6f44783bb06666617c758408daf53e3d...88fc523c59465b28633de91f4c9e87b8364064b7,1,1,1,2,1,2010-09-27 14:28:35,2010-09-27 14:28:35
88fc523c59465b28633de91f4c9e87b8364064b7...6dd2dc42700fff681513aa5a3bdc438bd48f4ba0,1,3,3,6,3,2010-09-27 14:38:13,2010-09-27 14:38:13
6dd2dc42700fff681513aa5a3bdc438bd48f4ba0...0da700a4d03c1c43e75e3ab7f8e719e13c7e444a,1,1,1,2,1,2010-09-27 14:53:29,2010-09-27 14:53:29
0da700a4d03c1c43e75e3ab7f8e719e13c7e444a...0be7f4eb4f027dce00f11d7816290022d447d336,4,27,21,48,14,2010-09-27 15:51:01,2010-09-27 15:51:01
0be7f4eb4f027dce00f11d7816290022d447d336...ea6a4813b7d996f6f7af0b61a5f1bf4ab80b291d,1,16,1,17,5,2010-09-27 16:10:00,2010-09-27 16:10:00
b05d631b302160d9483cbb595be5eae68c992dd3...34adda3c8805557028adf137d73cc13316c28cc8,1,3,1,4,3,2011-04-12 18:58:55,2011-04-12 18:58:55
34adda3c8805557028adf137d73cc13316c28cc8...e7787cd09805583ff690d9c5e4b4c58a88393bf9,1,2,2,4,2,2011-04-12 19:54:30,2011-04-12 19:54:30
1dda994c463f01977c7126407998d61efed218a5...d4b31a15ff7bd0ffb6576229d34a98ce1c9c4085,1,2,1,3,1,2011-04-14 20:26:20,2011-04-14 20:26:20
d4b31a15ff7bd0ffb6576229d34a98ce1c9c4085...19ceebd0f4817ddb2b6593d172e36e96d384aabb,1,1,1,2,1,2011-04-14 20:29:14,2011-04-14 20:29:14
19ceebd0f4817ddb2b6593d172e36e96d384aabb...8e1467f97eb8facb6677663794eb159eb8fedaab,1,1,1,2,1,2011-04-14 20:29:22,2011-04-14 20:29:22
7957516671c4fbb54727f7b10a3e068d92c57f7a...a5071d49ba29ba115954845db9363aa6459f1a84,1,2,2,4,2,2011-04-11 17:19:00,2011-04-11 17:19:00
2b70893928035d53f46575003197e4a1fa52a844...98da6b13bcc77dc117c68686ef4ed305bd83d400,2,7,4,11,4,2011-04-12 03:59:12,2011-04-12 03:59:12
2b70893928035d53f46575003197e4a1fa52a844...cb659c6054851dfcc52069885e7b7c0d17ee7097,1,1,1,2,1,2011-04-11 23:30:20,2011-04-11 23:30:20
733eb5e25316c0eaf27f3fbcbc7a6014fc3e99a1...3ab7b72919c8bd697e0cefab3b658bee0f51aef8,1,1,1,2,1,2011-01-17 23:07:52,2011-01-17 23:07:52
3ab7b72919c8bd697e0cefab3b658bee0f51aef8...e01e8d434d6e8421b93f328549b753191bb14c33,1,1,1,2,1,2011-01-17 23:08:51,2011-01-17 23:08:51
e01e8d434d6e8421b93f328549b753191bb14c33...9c76ac4f6d295a5b593048e54b4c4231c092e58a,1,5,2,7,2,2011-01-17 23:12:42,2011-01-17 23:12:42
9c76ac4f6d295a5b593048e54b4c4231c092e58a...d503845d0cf45632c0d7c3542ffd1b19257a8e5e,12,3073,369,3442,36,2011-01-18 00:49:24,2011-01-18 00:49:24
d503845d0cf45632c0d7c3542ffd1b19257a8e5e...35aeac13369c66d21f67cd7524f1cf341e3550ce,1,2,11,13,4,2011-01-18 00:55:40,2011-01-18 00:55:40
35aeac13369c66d21f67cd7524f1cf341e3550ce...9ae837a167f68136cb8df70f6c40b0e54c07bc01,1,1,1,2,1,2011-01-18 01:04:32,2011-01-18 01:04:32
9ae837a167f68136cb8df70f6c40b0e54c07bc01...3d0aa196c5420e7f68b32cee38f0cc740d4959c6,2,3,3,6,2,2011-01-18 03:06:57,2011-01-18 03:06:57
fc7bd61200a447b361b7d561cf376c29c165aed7...265cf0efa7ab3296b3fc4917b863d7b09e3d8bb4,1,2,7,9,3,2011-01-18 23:15:28,2011-01-18 23:15:28
cbf591152c9f61381e552c9a15bb7c339f1451a9...ae6655bcb6d852b79df2ddc5545832c5d08936f4,3,23,35,58,24,2011-01-05 21:26:05,2011-01-05 21:26:05
ae6655bcb6d852b79df2ddc5545832c5d08936f4...e56de77df90e50b9999a02e57241b1cf498b0fe4,7,295,295,590,292,2011-01-05 21:44:07,2011-01-05 21:41:23
e56de77df90e50b9999a02e57241b1cf498b0fe4...c43b078c6911027fd4124d542446ad0098662f6a,7,12,12,24,4,2011-01-06 00:17:31,2011-01-06 00:17:31
c43b078c6911027fd4124d542446ad0098662f6a...47e4cc1a0f3f26cf86d485fd53066503c4272e6b,1,4,4,8,1,2011-01-06 00:18:03,2011-01-06 00:18:03
47e4cc1a0f3f26cf86d485fd53066503c4272e6b...1ca82ccd9489f11d3a8fbdd8a32b4c164ffaf483,3,21,21,42,19,2011-01-06 00:26:06,2011-01-06 00:26:06
1ca82ccd9489f11d3a8fbdd8a32b4c164ffaf483...368f2441f64e95fe5dfda318709e795833470903,1,7,7,14,7,2011-01-07 14:52:58,2011-01-07 14:52:58
368f2441f64e95fe5dfda318709e795833470903...98c6c4b2b0afb2754883fc39c5626da3219e81e0,1,8,1,9,5,2011-01-09 03:03:00,2011-01-09 03:03:00
98c6c4b2b0afb2754883fc39c5626da3219e81e0...69497c3fd7ff560be0e47b4c65076915cca756bc,3,40,8,48,4,2011-01-09 03:28:42,2011-01-09 03:28:42
69497c3fd7ff560be0e47b4c65076915cca756bc...d515068ee807efef29b6c8406171be4725d7154f,4,34,9,43,4,2011-01-09 03:53:29,2011-01-09 03:53:29
d515068ee807efef29b6c8406171be4725d7154f...afefb4f3d28f47c0a93cc9dfddfcbadb595a8efb,2,59,2,61,3,2011-01-09 05:01:00,2011-01-09 05:01:00
afefb4f3d28f47c0a93cc9dfddfcbadb595a8efb...63487505c678152e59847e3ab7878ea5f2514dfa,1,23,0,23,1,2011-01-09 05:19:27,2011-01-09 05:19:27
63487505c678152e59847e3ab7878ea5f2514dfa...c55a76a23fdf8e9b22d9792a0f3a39051cc33993,1,3,3,6,2,2011-01-09 15:32:51,2011-01-09 15:32:51
c55a76a23fdf8e9b22d9792a0f3a39051cc33993...5a5f67800b048ae274e644547f4b8e03156ffa49,2,26,8,34,4,2011-01-09 15:50:13,2011-01-09 15:50:13
5a5f67800b048ae274e644547f4b8e03156ffa49...7bc538623077abb48d94b33ef8e389d1022b13af,1,13,33,46,13,2011-01-09 16:27:29,2011-01-09 16:27:29
7bc538623077abb48d94b33ef8e389d1022b13af...0f28835ee91a8aec5f9de60be42b55b802c67928,1,1,1,2,1,2011-01-09 19:31:15,2011-01-09 19:31:15
0f28835ee91a8aec5f9de60be42b55b802c67928...62a1a1a8fa64f92f429a3f5b8ed2e0d1f6fc3d6c,1,52,53,105,17,2011-01-09 20:19:27,2011-01-09 20:19:27
62a1a1a8fa64f92f429a3f5b8ed2e0d1f6fc3d6c...8c8bd3bf6ac982f98c1b89b0af74a1fd2d07e360,2,18,2,20,3,2011-01-09 20:48:52,2011-01-09 20:48:52
8c8bd3bf6ac982f98c1b89b0af74a1fd2d07e360...1d1d4fe112c49cbd704d880b27cc646f2bfe1737,1,21,16,37,3,2011-01-09 21:20:58,2011-01-09 21:20:58
cbf591152c9f61381e552c9a15bb7c339f1451a9...8099cdce800d45109b961e3521fc0080e9a876c6,2,30,4,34,6,2011-01-05 18:32:59,2011-01-05 18:32:59
8099cdce800d45109b961e3521fc0080e9a876c6...9bd9d270f69582b119b1835da4419a900f975b6b,1,18,18,36,2,2011-01-10 18:17:08,2011-01-10 18:17:08
b5c7c507c1617ada4b47fd2973dc42c6543f9cf2...c1316a4cb1fa9b9f85ef96f0e2ce45768ccd59cd,2,5,8,13,4,2011-04-06 01:59:09,2011-04-06 01:59:09
6c18a1becb59f1b2e64a4920967dc5cecdb296f6...6fb3998681c8bbb7fdcde66ba446c4b01bf18fb0,1,2,2,4,2,2011-01-24 21:45:29,2011-01-24 21:45:29
6fb3998681c8bbb7fdcde66ba446c4b01bf18fb0...98234b0f93d45cd40ad54d58a584bc099212e8fc,1,6,9,15,4,2011-01-24 21:58:56,2011-01-24 21:58:56
98234b0f93d45cd40ad54d58a584bc099212e8fc...9604a0321adbc7baeaef1203b8e36d1a576a40a4,1,5,5,10,2,2011-01-24 22:01:31,2011-01-24 22:01:31
9604a0321adbc7baeaef1203b8e36d1a576a40a4...9d306bd73bb47562cd52f0fc4cc158c534cfdfdf,1,1,1,2,1,2011-01-24 22:14:04,2011-01-24 22:14:04
9d306bd73bb47562cd52f0fc4cc158c534cfdfdf...294df4fdcbf889efae3257e9302e1ddb6e27b474,1,1,1,2,1,2011-01-24 22:14:11,2011-01-24 22:14:11
6c18a1becb59f1b2e64a4920967dc5cecdb296f6...ed48787ec58c12917faf47e3b95e043b2b6ded10,2,58,7,65,8,2011-01-24 21:18:19,2011-01-24 21:18:19
72ddc8c64518a748071fd662b21fc995fbd8e96c...149a040794b3b52bc392281fab68aba40c7018ce,2,4,4,8,4,2011-04-14 03:14:14,2011-04-14 03:10:32
149a040794b3b52bc392281fab68aba40c7018ce...ca5bc202ac37a8e3d5787b24ea3fdc229143802c,2,7,3,10,3,2011-04-14 03:45:58,2011-04-14 03:45:58
6d49e84dafd8990221913944727e4f5dcaec078d...69866fd2e5ba2456c2ae84a5ba711a1db2a25091,4,14,12,26,8,2011-04-12 23:32:18,2011-04-12 23:32:18
6d49e84dafd8990221913944727e4f5dcaec078d...bebd8bc01e63dcb053412f8b247e4fa611867c55,2,11,17,28,8,2011-04-12 23:29:09,2011-04-12 23:29:09
9bd9ebdd73fe0e2d29fadf82947c98adde4023e7...086822e6419c89c33b322bacbbc891148a4b3647,2,13,14,27,2,2010-10-25 07:31:19,2010-10-25 07:31:19
9bd9ebdd73fe0e2d29fadf82947c98adde4023e7...3b50eaca2cd0b1439235e39c4e98a6438e8f55b2,4,44,0,44,4,2010-10-24 16:18:33,2010-10-24 16:18:33
a4fc842019a678a331c7322a5be747e6adc426ca...bd474799bf95f4ecdc47a7577750eaf69e2236d4,1,5,0,5,1,2010-10-25 21:07:44,2010-10-25 21:07:44
a4fc842019a678a331c7322a5be747e6adc426ca...c22623602ee3c9ff70df9e6f51132931d19bab04,1,1,1,2,1,2010-10-25 20:25:10,2010-10-25 20:25:10
c22623602ee3c9ff70df9e6f51132931d19bab04...9b97599fa4d615a91d1605d9c664c50f576911ce,1,1,1,2,1,2010-10-25 20:26:07,2010-10-25 20:26:07
9b97599fa4d615a91d1605d9c664c50f576911ce...de58db0cdf4dc08db8683ad6cd0035c5d64b26ac,2,0,21,21,2,2010-10-26 00:54:27,2010-10-26 00:54:27
8e1467f97eb8facb6677663794eb159eb8fedaab...c4d0cccecf4dc0da677b5c377801c3170242ac6b,2,12,112,124,8,2011-04-15 13:48:50,2011-04-15 13:48:50
c4d0cccecf4dc0da677b5c377801c3170242ac6b...35d9425969be95c110bb16b650d3fbe7e122c1db,1,0,1,1,1,2011-04-15 14:53:37,2011-04-15 14:53:37
35d9425969be95c110bb16b650d3fbe7e122c1db...a9a79ccc6e5a3630c9925c267763591236597bcb,2,11,8,19,6,2011-04-15 20:36:43,2011-04-15 20:36:43
a9a79ccc6e5a3630c9925c267763591236597bcb...4d3cb7d7ee4cd709f3ed39d81a8ef014b60cd308,1,1,1,2,1,2011-04-15 20:45:45,2011-04-15 20:45:45
4d3cb7d7ee4cd709f3ed39d81a8ef014b60cd308...a519129e99ba03770e9290961d43fad9f6873a83,2,8,12,20,4,2011-04-15 21:16:43,2011-04-15 21:16:43
a519129e99ba03770e9290961d43fad9f6873a83...ce7b311b9227e86d7f03c002cbaf1796f8086059,2,5,17,22,6,2011-04-16 16:12:53,2011-04-16 16:12:53
8e1467f97eb8facb6677663794eb159eb8fedaab...b6d21592cb2023ce8922781536b984e6d2654ad7,2,2,0,2,2,2011-04-15 03:11:49,2011-04-15 03:11:49
5b197b6c5f429fefec20252945503f3ef3bc4748...94ee3e9743c2cab24084ae24e02871f6df4aef13,2,5,3,8,3,2011-04-16 21:18:56,2011-04-16 21:18:56
7fa6de0ec16df46b90a862778e16c4091198870d...352715bd0802e2df041f86e1a82669574183ec04,1,3,3,6,3,2011-04-12 21:46:15,2011-04-12 21:46:15
352715bd0802e2df041f86e1a82669574183ec04...9e71ad1b120e2b20c7430c017629877ba277f667,1,1,0,1,1,2011-04-12 22:32:23,2011-04-12 22:32:23
0d755dff13ae36a9b2f79ecbb0db05dd2c322e42...7bfb6a7dd315f0eda3e5227f7d41e38f66f46549,1,0,11,11,1,2011-04-12 04:29:52,2011-04-12 04:29:52
265cf0efa7ab3296b3fc4917b863d7b09e3d8bb4...92c3d87a9cdd611af06e46a5e66a4876c2be5ed0,2,173,161,334,45,2011-01-19 15:55:26,2011-01-19 15:55:26
92c3d87a9cdd611af06e46a5e66a4876c2be5ed0...bd6eb849eeb96298bfbd3de71a27cfcbe32bc772,1,10,12,22,4,2011-01-19 16:06:33,2011-01-19 16:06:33
bd6eb849eeb96298bfbd3de71a27cfcbe32bc772...d343bfe528cbb8b08c3beb94cb33d1c444932f06,1,7,12,19,5,2011-01-19 16:21:51,2011-01-19 16:21:51
d343bfe528cbb8b08c3beb94cb33d1c444932f06...7947cd77e4dcd73eb0816a1da5ef3902666ba47a,1,1,1,2,1,2011-01-19 16:24:56,2011-01-19 16:24:56
7947cd77e4dcd73eb0816a1da5ef3902666ba47a...3ea366401f461cd670c5472ddbb3ad7f3260d13c,1,16,15,31,6,2011-01-19 16:51:33,2011-01-19 16:51:33
3ea366401f461cd670c5472ddbb3ad7f3260d13c...1cecfa1ece0d48b253fb0775bba645c464e363a4,2,52,51,103,9,2011-01-19 17:16:29,2011-01-19 17:16:29
1cecfa1ece0d48b253fb0775bba645c464e363a4...7d89d3c07233f77437a0acf77b1adf7f2c17989f,1,4,2,6,3,2011-01-19 17:35:40,2011-01-19 17:35:40
7d89d3c07233f77437a0acf77b1adf7f2c17989f...44f3a1b405e158615d9f2fca3238ccb12f9fa895,1,2,2,4,1,2011-01-19 17:36:42,2011-01-19 17:36:42
44f3a1b405e158615d9f2fca3238ccb12f9fa895...96b00a493522fd3995f0752803da2c13bbf21755,1,4,4,8,2,2011-01-19 17:44:21,2011-01-19 17:44:21
96b00a493522fd3995f0752803da2c13bbf21755...64e1cdbb95b8bbefbc9dec70ae30e0714a549619,4,138,113,251,27,2011-01-20 03:12:15,2011-01-20 03:12:15
265cf0efa7ab3296b3fc4917b863d7b09e3d8bb4...74dfc7f2a992b8aebbd98ec75e5e0175e2616142,2,6,3,9,3,2011-01-19 10:11:43,2011-01-19 10:11:43
1d1d4fe112c49cbd704d880b27cc646f2bfe1737...4e86766d54a71263f8e7cbf2957405e12d9b8b36,1,3,2,5,3,2011-01-09 22:22:11,2011-01-09 22:22:11
4e86766d54a71263f8e7cbf2957405e12d9b8b36...fcf623786aeae20485e5253bd2b66c8758053646,1,5,0,5,1,2011-01-09 22:25:44,2011-01-09 22:25:44
1d1d4fe112c49cbd704d880b27cc646f2bfe1737...8e59a99e0ade75dec434f246f52e8b3f7393f359,10,341,192,533,108,2011-01-09 21:52:33,2011-01-09 21:52:33
8e59a99e0ade75dec434f246f52e8b3f7393f359...885d06c8ef906fa11d130d7d567c871d20ef9ba9,1,1,1,2,1,2011-01-09 21:56:40,2011-01-09 21:56:40
885d06c8ef906fa11d130d7d567c871d20ef9ba9...80af46e8ffe8292e0af0537db6c7e89019e5edba,1,4,0,4,1,2011-01-09 21:58:23,2011-01-09 21:58:23
80af46e8ffe8292e0af0537db6c7e89019e5edba...e2941d5a98e91c5f61b200b2763e5fa0eb339365,15,189,38,227,60,2011-01-09 21:58:47,2011-01-09 21:58:47
e2941d5a98e91c5f61b200b2763e5fa0eb339365...57cc182a40e909868d41f9b1bb405b06138f6cae,1,7,0,7,1,2011-01-17 21:22:49,2011-01-17 21:22:49
294df4fdcbf889efae3257e9302e1ddb6e27b474...2c290709d867ffd54b0011373de292b8e86a3509,1,26,13,39,6,2011-01-26 21:36:33,2011-01-26 21:36:33
294df4fdcbf889efae3257e9302e1ddb6e27b474...8d050558d3dc2c0abd0bde4bc9d03bfb66974689,1,0,3,3,1,2011-01-25 02:52:17,2011-01-25 02:52:17
8d050558d3dc2c0abd0bde4bc9d03bfb66974689...5ca8f0617f5c94495380ff783452a52eab706d39,3,60,12,72,8,2011-01-25 15:08:19,2011-01-25 15:08:19
5ca8f0617f5c94495380ff783452a52eab706d39...325dcdc2ab05173f809b9d83af59918b3695cc23,2,3,20,23,4,2011-01-25 23:55:39,2011-01-25 23:55:39
325dcdc2ab05173f809b9d83af59918b3695cc23...0e5b341cc0f3f9bf0f6659e09704f2267cfdfdba,2,20,11,31,6,2011-01-26 00:36:05,2011-01-26 00:36:05
0e5b341cc0f3f9bf0f6659e09704f2267cfdfdba...d7d64713a72c67243b279b9dcb16ae9fbb825c17,1,1,1,2,1,2011-01-26 00:45:00,2011-01-26 00:45:00
d7d64713a72c67243b279b9dcb16ae9fbb825c17...bab8079593913dbc689404aa4e83c46b9b4c9355,1,5,5,10,5,2011-01-26 16:37:08,2011-01-26 16:37:08
bb9408516aa0fc8892f4e07a99b1a47bce06081b...217a9919c3adcde198774301aa082e5be8a6489d,1,1,1,2,1,2011-02-14 21:38:19,2011-02-14 21:38:19
217a9919c3adcde198774301aa082e5be8a6489d...2ed81708bdacfd4b97b77baef67ad8b75205dd20,2,52,6,58,10,2011-02-14 22:22:23,2011-02-14 22:22:23
2ed81708bdacfd4b97b77baef67ad8b75205dd20...2cc03a86fc046e81013d32a662f4043f1c10b436,1,1,3,4,1,2011-02-14 22:30:18,2011-02-14 22:30:18
2cc03a86fc046e81013d32a662f4043f1c10b436...8e40a84c24271c0a9253902ceb97185f243a3318,3,9,9,18,9,2011-02-15 20:03:34,2011-02-15 20:01:52
8e40a84c24271c0a9253902ceb97185f243a3318...1ddfdabbb983e2d3bf7f7200a3da5051f274e6fe,2,18,3,21,4,2011-02-15 20:53:38,2011-02-15 20:47:52
1ddfdabbb983e2d3bf7f7200a3da5051f274e6fe...12c0e1a692aa045e9d3cf166a41748d7f5fe31cc,2,28,9,37,9,2011-02-15 21:08:39,2011-02-10 02:25:29
12c0e1a692aa045e9d3cf166a41748d7f5fe31cc...6b08d88d04f4a41849753999e6e18126895086d0,7,19,19,38,11,2011-02-15 21:09:09,2011-02-15 21:03:23
6b08d88d04f4a41849753999e6e18126895086d0...faa6fe32f72900d7b31000caead2794a8346f6d8,3,2,42,44,7,2011-02-15 21:30:34,2011-02-15 21:30:34
faa6fe32f72900d7b31000caead2794a8346f6d8...5b38439011799ae53156d137305d9440e0cddb0a,3,13,5,18,5,2011-02-17 16:03:09,2011-02-17 16:03:09
5b38439011799ae53156d137305d9440e0cddb0a...b9f5e2b97458f89cbcac3a333ba95b0eac568d49,2,10,7,17,4,2011-02-17 16:09:56,2011-02-16 03:41:08
b9f5e2b97458f89cbcac3a333ba95b0eac568d49...85d9343271da85fc945bf37a604873eaf247a3a7,2,45,18,63,3,2011-02-17 16:26:23,2011-02-17 16:26:23
85d9343271da85fc945bf37a604873eaf247a3a7...4b91b918a360d056a6e4a63ee306e97f839dac59,1,26,16,42,10,2011-02-17 18:14:46,2011-02-17 18:12:57
4b91b918a360d056a6e4a63ee306e97f839dac59...752db8fffeffa796f5cdb5553331436c0a4cc44e,1,9,4,13,2,2011-02-18 00:01:30,2011-02-18 00:01:30
752db8fffeffa796f5cdb5553331436c0a4cc44e...a43a5ca9cf79afcd662df5b9110d7ccba45c0b53,2,17,75,92,18,2011-02-18 17:06:26,2011-02-18 17:06:26
a43a5ca9cf79afcd662df5b9110d7ccba45c0b53...47abe5e1da5bcb5a268aefea9817b8747b051b18,2,95,62,157,14,2011-02-18 18:09:07,2011-02-18 18:09:07
47abe5e1da5bcb5a268aefea9817b8747b051b18...13e11987545a67f9b4dabbe839c89b3f63c982a5,1,1,1,2,1,2011-02-18 18:57:25,2011-02-18 18:57:25
13e11987545a67f9b4dabbe839c89b3f63c982a5...d5f7711ce088975aabaa5c2f64e29cfa0933b848,1,1,1,2,1,2011-02-18 18:57:32,2011-02-18 18:57:32
d5f7711ce088975aabaa5c2f64e29cfa0933b848...e405419fb796030f7fee2bb8372eca158f85d849,1,2,2,4,2,2011-02-21 23:44:22,2011-02-21 23:44:22
ca5bc202ac37a8e3d5787b24ea3fdc229143802c...38d6d9f6e03e544c3ea7a9f226c3f93d1d97c232,1,6,8,14,2,2011-04-14 04:46:10,2011-04-14 04:46:10
ca5bc202ac37a8e3d5787b24ea3fdc229143802c...e64d3d4e5793d84fe93894c90dc11a64810fae24,2,110,17,127,4,2011-04-14 04:30:30,2011-04-14 04:30:30
f7f4ef91cf38b3c00414d3ebdb706fc04a8e17c0...4344d0841756f8572c56490f12739ac204f40966,1,2,5,7,3,2011-04-13 16:35:38,2011-04-13 16:35:38
4344d0841756f8572c56490f12739ac204f40966...4ad9b44deada9da9639f53b1ca3cc4cf2ebf2df2,1,14,16,30,6,2011-04-13 17:27:19,2011-04-13 17:27:19
ee845c49758eeb5236d9e4520b7921e12d5f29b9...974b5aeab7a3788ff5fb9db87b9567784e0249fc,2,33,0,33,2,2010-10-25 20:05:31,2010-10-23 18:36:24
974b5aeab7a3788ff5fb9db87b9567784e0249fc...09022e0b09db71259751e7146bb64727615028af,2,30,4,34,4,2010-10-25 20:06:02,2010-10-23 17:23:51
a68a85ad09dc79cb2a7ea8b6abd1f880f218277c...7066bb384bb4b6e91dac787642f616a4dbc475e5,1,0,5,5,1,2010-10-26 03:26:19,2010-10-26 03:26:19
7066bb384bb4b6e91dac787642f616a4dbc475e5...6ab402dced3339d24ad007ecf3a6c3f5af3e7610,2,30,6,36,7,2010-10-26 21:37:44,2010-10-26 21:37:44
6ab402dced3339d24ad007ecf3a6c3f5af3e7610...6e7a4e73a2d821fd2a7b71e080b9284909af1596,2,10,2,12,3,2010-10-27 18:35:26,2010-10-27 18:35:26
6e7a4e73a2d821fd2a7b71e080b9284909af1596...6020b6bb38499e445e047f8a01de81f170ae20f5,1,27,27,54,14,2010-10-28 16:58:03,2010-10-28 16:58:03
6020b6bb38499e445e047f8a01de81f170ae20f5...e377621eaf85915b8459632cf2565e40e54d6c19,1,1,1,2,1,2010-10-28 19:59:58,2010-10-28 19:59:58
e377621eaf85915b8459632cf2565e40e54d6c19...9d1bfeb7ffe63b5a7488929b7be847bc1a00f6a6,2,7,6,13,5,2010-11-01 23:04:59,2010-11-01 23:04:59
9d1bfeb7ffe63b5a7488929b7be847bc1a00f6a6...62c83a764cdb3f6e7f6a9b696de1636570df19bf,1,6,1,7,2,2010-11-01 23:29:11,2010-11-01 23:29:11
62c83a764cdb3f6e7f6a9b696de1636570df19bf...fb4445070cd9e06929c7b6f27c10dbf42d4a3367,1,13,6,19,6,2010-11-03 19:39:28,2010-11-03 19:39:28
fb4445070cd9e06929c7b6f27c10dbf42d4a3367...4d7f7453dca8e385cfb02089a8d5b2c47371bba3,1,1,1,2,1,2010-11-03 19:46:31,2010-11-03 19:46:31
4d7f7453dca8e385cfb02089a8d5b2c47371bba3...335e0a33e19b9c8703246dd033dcc68c2da5de36,1,1,1,2,1,2010-11-03 19:46:40,2010-11-03 19:46:40
94ee3e9743c2cab24084ae24e02871f6df4aef13...235080e1256fc10468ce09b9d1e8db712c797f24,1,23,26,49,7,2011-04-17 00:48:27,2011-04-17 00:48:27
94ee3e9743c2cab24084ae24e02871f6df4aef13...6e3b596514d20124260bc4b3febd8dc105420626,1,1,1,2,1,2011-04-17 00:37:35,2011-04-17 00:37:35
6e3b596514d20124260bc4b3febd8dc105420626...5d70c6d797af15641a8e562cf5b3d022a1bdda25,1,7,1,8,2,2011-04-17 00:39:30,2011-04-17 00:39:30
c1d719b580ea78c33961113030d7fa25bcc98e6f...9c763ad39d42c54d24f659e7895a8f361a08d27c,2,40,1,41,4,2011-01-18 20:13:09,2011-01-18 20:13:09
9c763ad39d42c54d24f659e7895a8f361a08d27c...80928cc6fb50c49be24f8bfb40d43a21945e8608,1,0,0,0,0,2011-01-18 21:40:42,2011-01-18 21:40:42
0942b3b3f55c77664f3a72b1e2ae0b58cf108d4c...135a384cf3e4cc3671de4cfcced20f294a5667a8,1,7,8,15,6,2011-01-18 17:40:07,2011-01-18 17:40:07
64e1cdbb95b8bbefbc9dec70ae30e0714a549619...49cd9c66bf6097ced133971a82fa9bd7b2f73e1a,1,71,63,134,11,2011-01-20 19:27:02,2011-01-20 19:25:56
49cd9c66bf6097ced133971a82fa9bd7b2f73e1a...6458885881e7badb99c70c24843c31d13064a167,2,12,10,22,9,2011-01-20 20:25:04,2011-01-20 20:25:04
6458885881e7badb99c70c24843c31d13064a167...33a67ffa9d85450f1edf1b1645b57f7641e2e2d2,1,12,0,12,1,2011-01-21 16:08:15,2011-01-21 16:08:15
64e1cdbb95b8bbefbc9dec70ae30e0714a549619...c475222bfb729d7629cece87cf1cc96aaaacd305,1,16,62,78,9,2011-01-20 16:34:35,2011-01-20 16:34:35
c475222bfb729d7629cece87cf1cc96aaaacd305...0f6c7830ce5bdd31588dccdc40b6254fb4a9100f,1,1,1,2,1,2011-01-20 16:46:50,2011-01-20 16:46:50
64e1cdbb95b8bbefbc9dec70ae30e0714a549619...9ab00a712fe3757f130dce8b42293c82a68c690e,2,34,7,41,6,2011-01-20 14:39:30,2011-01-20 14:39:30
9ab00a712fe3757f130dce8b42293c82a68c690e...3e1d3d0f21d1b292fe721b4f483b3a3bc2dadd86,1,6,7,13,4,2011-01-20 15:22:36,2011-01-20 15:22:36
3e1d3d0f21d1b292fe721b4f483b3a3bc2dadd86...ef86694ada757e5bc14227f8e5cc7d9d3a771da2,2,27,27,54,10,2011-01-20 16:38:21,2011-01-20 16:38:21
ef86694ada757e5bc14227f8e5cc7d9d3a771da2...a7cb93bee529a09056f521e6c0b760447b5cfb29,3,11,11,22,11,2011-01-20 16:51:57,2011-01-20 16:51:57
fcf623786aeae20485e5253bd2b66c8758053646...d03d2e9f26f85366ad2e91b9e2c76a249d7bf7be,2,21,15,36,6,2011-01-10 00:11:05,2011-01-10 00:11:05
d03d2e9f26f85366ad2e91b9e2c76a249d7bf7be...628bacc3ce26a7a0e0462c2a2e0d764edf859c97,1,2,2,4,2,2011-01-10 01:16:18,2011-01-10 01:12:29
628bacc3ce26a7a0e0462c2a2e0d764edf859c97...8d28f41f669168ebd436599f8b187c783fec4ba9,1,4,4,8,1,2011-01-10 01:34:15,2011-01-10 01:34:15
8d28f41f669168ebd436599f8b187c783fec4ba9...bed64e65cc658409961a7127b715643390919e6c,1,3,1,4,2,2011-01-10 01:39:23,2011-01-10 01:39:23
bed64e65cc658409961a7127b715643390919e6c...b78e3fc39f96d63a60ea66e3d066815626e633d8,1,25,25,50,3,2011-01-10 01:51:20,2011-01-10 01:51:20
fcf623786aeae20485e5253bd2b66c8758053646...012f0c3b4bd3d04c2f3e1ea80fc1230901d607d9,1,3,14,17,5,2011-01-09 23:34:58,2011-01-09 23:34:58
ceaf0939422501c9d5f049205cc8f212f852bed5...e0856738e6151368cffc963800e06ebcc0bbc314,2,20,2,22,3,2011-04-06 03:18:35,2011-01-19 23:37:31
e0856738e6151368cffc963800e06ebcc0bbc314...bfa32317d2a56145a2d1151c60ce2d71d1328dd9,1,52,70,122,29,2011-04-06 14:50:31,2011-02-11 04:43:45
bfa32317d2a56145a2d1151c60ce2d71d1328dd9...246757bacdd6224724c667b7b9812d7d88bdd8e1,1,30,27,57,20,2011-04-06 14:57:07,2011-03-16 03:40:25
246757bacdd6224724c667b7b9812d7d88bdd8e1...29386db3196e883bffeda63f9e9db1f9ed336bba,1,4,5,9,4,2011-04-06 14:57:09,2011-04-06 14:31:14
29386db3196e883bffeda63f9e9db1f9ed336bba...879be3d8121179da4e7cafe1d36f7f1b1a97263b,1,60,61,121,17,2011-04-06 15:34:41,2011-04-06 15:34:41
879be3d8121179da4e7cafe1d36f7f1b1a97263b...b7dd8404c52518bc4d71b0e715c506252d651a3f,2,8,3,11,7,2011-04-07 02:11:58,2011-04-07 02:11:58
6344821f1bc394115fb3c869ab7b65b75cfc9cc5...ba43d37394b6018779d9a668c548e11579cd424a,1,1,2,3,1,2011-01-26 21:50:15,2011-01-26 21:50:15
ba43d37394b6018779d9a668c548e11579cd424a...ab1d9a8a2c296a2fa31b7d15146ce115c4057fad,1,2,3,5,2,2011-01-26 23:23:08,2011-01-26 22:12:23
bab8079593913dbc689404aa4e83c46b9b4c9355...7d75ea950ea31a6734dc42e2037742b0c6719e8a,1,1,1,2,1,2011-01-26 23:58:31,2011-01-26 23:58:31
d2eafa0bb835ab9dba33d364e052ebc44afd244a...85232c97bf1f129b2bc246cf674dc3d5582aaecb,1,12,19,31,5,2011-03-23 20:04:12,2011-03-23 20:04:12
e405419fb796030f7fee2bb8372eca158f85d849...c5264ce196c2f6d60b9d662a160f8e146c9aa23c,1,1,1,2,1,2011-02-23 14:53:29,2011-02-23 14:53:29
c5264ce196c2f6d60b9d662a160f8e146c9aa23c...e27fcf42ce152ede15c8617bb5d31dfb2088470c,1,1,0,1,1,2011-02-23 14:55:13,2011-02-23 14:55:13
e405419fb796030f7fee2bb8372eca158f85d849...cacea6f7e778d42cda56066a6b1da8fb163410cc,1,6,0,6,1,2011-02-23 01:50:27,2011-02-23 01:50:27
cacea6f7e778d42cda56066a6b1da8fb163410cc...3663836b0180f3a73d96ec234d5d7010e5652a4b,1,28,18,46,4,2011-02-23 07:00:27,2011-02-23 07:00:27
3663836b0180f3a73d96ec234d5d7010e5652a4b...292acd97a226ec15af2adc069d02973d59c6bc59,3,33,17,50,14,2011-02-23 18:18:44,2011-02-23 18:18:44
292acd97a226ec15af2adc069d02973d59c6bc59...2defcf96e571728b0a565527a532feb30466ebf4,1,1,1,2,1,2011-02-23 18:55:29,2011-02-23 18:55:29
2defcf96e571728b0a565527a532feb30466ebf4...83d1a1fd56cf00cea40c73564ea53588984f7255,1,1,1,2,1,2011-02-23 18:55:45,2011-02-23 18:55:45
83d1a1fd56cf00cea40c73564ea53588984f7255...5d9db486c774c10293d0813c89dfdbd973120030,1,0,6,6,1,2011-02-23 23:32:30,2011-02-23 23:32:30
5d9db486c774c10293d0813c89dfdbd973120030...58faec7cb7e820ef910b4850f5234da3989e6961,1,1,1,2,1,2011-02-24 05:37:37,2011-02-24 05:37:37
58faec7cb7e820ef910b4850f5234da3989e6961...14e9da51f96a7a9b1a5c239c32f4abe20eb2b795,2,13,1,14,2,2011-02-24 19:10:33,2011-02-24 19:10:33
14e9da51f96a7a9b1a5c239c32f4abe20eb2b795...71bd828d9f975fb1047b9fa2a78949cafd8006ac,1,9,13,22,3,2011-02-24 19:21:05,2011-02-24 19:21:05
cdb02d09f1166c5fa2ef12a8b5c5fd110a5f84c3...84712bd624a9a4eeaab9ea9c543bba494f2cc3e1,1,20,13,33,12,2011-04-14 19:49:15,2011-04-14 19:49:15
335e0a33e19b9c8703246dd033dcc68c2da5de36...d9478954b9de79a7f3538e935bfd98cdc61ee435,2,7,3,10,4,2010-11-03 22:59:55,2010-11-03 22:59:55
335e0a33e19b9c8703246dd033dcc68c2da5de36...3e38a861fee065fa1a6e7678eefe90b2379fed8e,2,7,3,10,4,2010-11-03 22:57:22,2010-11-03 22:57:22
16312c6b0627602153e8069f6c2018578289faea...2942be780f3f243dbf82ca012bba284846afee13,2,9,10,19,5,2011-04-22 04:27:52,2011-04-22 04:27:52
16312c6b0627602153e8069f6c2018578289faea...3d9445e3fce84448b4b569a1a6f1aa454a898265,2,28,2,30,4,2011-04-22 04:02:08,2011-04-22 04:02:08
5d70c6d797af15641a8e562cf5b3d022a1bdda25...adef5c3550141960089e2634619ef028931f4765,1,1,1,2,1,2011-04-17 17:21:46,2011-04-17 17:21:46
adef5c3550141960089e2634619ef028931f4765...a9b81d759af3a4574a42ca1de93be1247f7953a2,1,5,0,5,1,2011-04-17 17:34:38,2011-04-17 17:34:38
a9b81d759af3a4574a42ca1de93be1247f7953a2...728a70c036dfcdc0c45c5c60c08aeade786ce195,2,4,3,7,3,2011-04-17 17:51:24,2011-04-17 17:51:24
728a70c036dfcdc0c45c5c60c08aeade786ce195...21c0be8496127df3f0ad652e582133148430cc41,2,28,16,44,6,2011-04-17 18:07:42,2011-04-17 18:07:42
5d70c6d797af15641a8e562cf5b3d022a1bdda25...ecf6a3c3831ae6afef6273c06e53ee7710877125,10,146,146,292,103,2011-04-17 06:43:57,2011-04-17 06:43:57
ecf6a3c3831ae6afef6273c06e53ee7710877125...68cc3ad730c864afb653971b1353bf5160116c08,3,24,24,48,5,2011-04-17 18:12:05,2011-04-17 18:08:52
5d70c6d797af15641a8e562cf5b3d022a1bdda25...0b1c2e642ac0267b95759b2a7593a7d19aa43c9c,3,34,2,36,4,2011-04-17 03:35:18,2011-04-17 03:35:18
80928cc6fb50c49be24f8bfb40d43a21945e8608...be6ef80f8a3c47d2f2e9aef68b44773a06bdb098,1,0,0,0,0,2011-01-18 23:06:44,2011-01-18 23:06:44
80928cc6fb50c49be24f8bfb40d43a21945e8608...c5ec1cb3e5ce8d1f6d9b6175049a3886d3776a18,1,2,2,4,2,2011-01-18 22:14:32,2011-01-18 22:14:32
0f6c7830ce5bdd31588dccdc40b6254fb4a9100f...e4d01688932960896419dc52ffd691cc4f9b3029,1,57,18,75,9,2011-01-20 16:58:44,2011-01-20 16:58:44
012f0c3b4bd3d04c2f3e1ea80fc1230901d607d9...b14f02899e74c429effadd88527ffde17650149a,4,48,15,63,8,2011-01-10 00:38:44,2011-01-10 00:38:44
012f0c3b4bd3d04c2f3e1ea80fc1230901d607d9...84319aa4a32c1221110419cbe9e427dc9e184555,1,1,1,2,1,2011-01-09 23:52:20,2011-01-09 23:52:20
b7dd8404c52518bc4d71b0e715c506252d651a3f...75a4bc4a4e55360c7c3c734cbef2558050ed4456,1,14,3,17,3,2011-04-07 03:07:20,2011-04-07 03:07:20
75a4bc4a4e55360c7c3c734cbef2558050ed4456...bb99899ca0de93dd12f5a53f409ff6f72bfcf94c,2,282,128,410,57,2011-04-07 03:49:32,2011-04-07 03:49:32
bb99899ca0de93dd12f5a53f409ff6f72bfcf94c...4552d135f404b78f4fa1494a3de2911b2e2e4773,2,67,19,86,20,2011-04-07 04:00:52,2011-04-07 04:00:52
4552d135f404b78f4fa1494a3de2911b2e2e4773...f3c6077da02f080f09d73ec4d8a8029f76654c2b,2,30,17,47,3,2011-04-07 04:47:15,2011-04-07 04:47:15
f3c6077da02f080f09d73ec4d8a8029f76654c2b...c1dcad69427b78f3e70628ab1444f42033ee593a,1,142,151,293,31,2011-04-07 04:51:37,2011-04-07 04:51:37
b7dd8404c52518bc4d71b0e715c506252d651a3f...bbd9c776ea22296a6807d5b760bd4e82ee5f4414,2,2,1,3,2,2011-04-07 03:06:52,2011-04-04 14:27:31
7f95a730e50260c60e7d3ee4fa53cbe29258e6b6...e00f74c43bf58132be01c6417c6126a5bc085899,2,52,1,53,4,2011-01-27 18:35:06,2011-01-27 18:35:06
e00f74c43bf58132be01c6417c6126a5bc085899...1e4f3c07c70861fc334a0e61080f8bbde0d7d442,1,10,1,11,2,2011-01-28 00:50:39,2011-01-28 00:50:39
1e4f3c07c70861fc334a0e61080f8bbde0d7d442...bbd3f4f3fe66fc4ce6c6db31a17a1c04037323be,1,3,3,6,3,2011-01-28 16:08:46,2011-01-28 16:08:46
bbd3f4f3fe66fc4ce6c6db31a17a1c04037323be...0a0cff9d29c4bd559da689d96c532d06c03fce09,2,26,6,32,5,2011-01-28 16:55:39,2011-01-28 16:55:39
0a0cff9d29c4bd559da689d96c532d06c03fce09...b9f2131a9da53fff60549e87428a0efe43f9e80a,1,1,1,2,1,2011-01-29 00:25:27,2011-01-29 00:25:27
b9f2131a9da53fff60549e87428a0efe43f9e80a...85a195c6d5ad6fccf9dd3df40ebecc338325d461,2,13,4,17,4,2011-01-29 00:39:22,2011-01-29 00:39:22
85a195c6d5ad6fccf9dd3df40ebecc338325d461...945ac0d0b1cdb58ade92c7d57a1f4a51b2b799a4,1,3,8,11,2,2011-01-29 02:08:18,2011-01-29 02:08:18
945ac0d0b1cdb58ade92c7d57a1f4a51b2b799a4...91ca71daaab767f288f7173733f2bd907d8397a8,1,2,2,4,2,2011-01-31 09:13:54,2011-01-31 09:13:54
91ca71daaab767f288f7173733f2bd907d8397a8...d2384ad03a058370cc5978adaec5691fdee323bb,1,7,1,8,3,2011-01-31 10:14:38,2011-01-31 10:14:38
d2384ad03a058370cc5978adaec5691fdee323bb...749d41f7de7f83f0096e76ed8bf5f78cbc972e03,2,7,7,14,6,2011-01-31 13:21:42,2011-01-31 13:21:42
749d41f7de7f83f0096e76ed8bf5f78cbc972e03...8d8db3f2b3f8c3d41854726c8a0227f6deecc602,1,1,1,2,1,2011-01-31 13:31:29,2011-01-31 13:31:29
8d8db3f2b3f8c3d41854726c8a0227f6deecc602...d753a7a117f81540f50ee840b4ccb5846d9f15ca,1,1,1,2,1,2011-01-31 13:31:36,2011-01-31 13:31:36
d753a7a117f81540f50ee840b4ccb5846d9f15ca...4e975430510f443ef76a90d077bc8956fb8b8cc0,2,75,17,92,18,2011-01-31 13:49:14,2011-01-31 13:36:59
4e975430510f443ef76a90d077bc8956fb8b8cc0...389c099df686bd104ce0aab3361a94ebf3a05ce6,2,31,13,44,5,2011-01-31 14:58:27,2011-01-31 14:58:27
389c099df686bd104ce0aab3361a94ebf3a05ce6...485fa0c42a71b4decc9cb1ce08bb56efabcc76f3,1,6,2,8,2,2011-01-31 16:40:26,2011-01-31 16:23:36
485fa0c42a71b4decc9cb1ce08bb56efabcc76f3...7c9a5e6016c2fcd38872367a891e5b3887d3df53,2,16,5,21,7,2011-01-31 16:40:27,2011-01-31 16:39:54
7c9a5e6016c2fcd38872367a891e5b3887d3df53...f286a716d5e5836b8508eb5771624de0aafdb235,2,50,25,75,10,2011-01-31 17:53:44,2011-01-31 17:53:44
f286a716d5e5836b8508eb5771624de0aafdb235...e0b1bb8e3d66db4166ac7ee2146903bae7ab1eb9,3,21,11,32,5,2011-01-31 18:14:06,2011-01-31 18:14:06
b8fd1f03a6667079f28ce3768e743457a6f33958...52f31054fd97e20ba423d406a484885b2639178c,1,2,1,3,1,2011-04-10 20:32:40,2011-04-10 20:32:40
71bd828d9f975fb1047b9fa2a78949cafd8006ac...c1279895f3f33cacc08e508c2409b587c0e6a5a2,2,13,5,18,7,2011-03-03 14:16:47,2011-03-03 14:16:47
c1279895f3f33cacc08e508c2409b587c0e6a5a2...2d0bc7ce72ab8d64da0506a88c8cc543ce3ceaba,17,407,393,800,23,2011-03-03 18:38:06,2011-03-03 18:38:06
71bd828d9f975fb1047b9fa2a78949cafd8006ac...025f2c63e487e069215b2a03ded2b98198904af9,1,4,3,7,3,2011-02-28 23:54:15,2011-02-28 23:54:15
025f2c63e487e069215b2a03ded2b98198904af9...c6b891fb1c909a2791ba7a4d745940858bd7b94f,2,3,2,5,3,2011-03-07 13:43:08,2011-03-07 13:43:08
c6b891fb1c909a2791ba7a4d745940858bd7b94f...6ddc3816dd23fd0d3b9328b2cb4648589884a206,1,4,2,6,2,2011-04-11 19:05:15,2011-04-11 19:05:15
6ddc3816dd23fd0d3b9328b2cb4648589884a206...d7104422017b26eb7bdbf4fc325ab16d561c40ce,1,3,3,6,3,2011-04-11 19:14:41,2011-04-11 19:14:41
d7104422017b26eb7bdbf4fc325ab16d561c40ce...930731ba0fbf8d2fc21e77283e3a8c332ac44570,1,1,1,2,1,2011-04-11 19:33:15,2011-04-11 19:33:15
930731ba0fbf8d2fc21e77283e3a8c332ac44570...581fa824200448361be534680a920d8144476aa7,1,1,1,2,1,2011-04-11 19:44:29,2011-04-11 19:44:29
71bd828d9f975fb1047b9fa2a78949cafd8006ac...c8a887af066a62840ec1910604ddb7e0c38728e8,2,27,15,42,7,2011-02-27 18:47:35,2011-02-27 18:47:35
71bd828d9f975fb1047b9fa2a78949cafd8006ac...00a05ad98513d037d1fde190626ec75dd9326f9e,1,2,1,3,2,2011-02-25 19:40:05,2011-02-25 19:40:05
00a05ad98513d037d1fde190626ec75dd9326f9e...8415e8a13d0e1203a53d9c871fdcc4575c9d0760,1,13,0,13,1,2011-02-25 19:45:04,2011-02-25 19:45:04
8415e8a13d0e1203a53d9c871fdcc4575c9d0760...4aafe727daa4ba6b0ac632f6ee79556eacd7712c,1,2,2,4,2,2011-02-25 20:26:04,2011-02-25 20:26:04
4aafe727daa4ba6b0ac632f6ee79556eacd7712c...2746d7f29976462499fa98181986f47c75258c94,1,11,15,26,5,2011-03-09 20:44:46,2011-03-09 20:44:46
a4df6945b8f668d6fe4b1c77610987f738afa01e...b5b3c73db3e4e615e504cd0af08ff6842b104542,2,5,3,8,3,2010-11-09 15:34:32,2010-11-09 15:34:32
b5b3c73db3e4e615e504cd0af08ff6842b104542...fb48ae8e6cca25fd29ef2b1eb23e9efa7b0eef7c,12,98,45,143,37,2010-11-09 16:09:07,2010-11-09 16:09:07
a4df6945b8f668d6fe4b1c77610987f738afa01e...e57b73a0ac6f8fd0cdbbe7d43f1c7e198f475337,2,9,5,14,4,2010-11-06 18:52:30,2010-11-06 18:52:30
bc7bb0df28f52846e54a2ce5ecf493d4594b2a90...9b00827ac90e0411ff2d106cb799465af18f703f,1,7,2,9,2,2011-04-22 04:51:23,2011-04-22 04:51:23
9b00827ac90e0411ff2d106cb799465af18f703f...15ccae91db70ab5591de66001ee2f46d540e4e19,1,1,1,2,1,2011-04-23 17:56:51,2011-04-23 17:56:51
15ccae91db70ab5591de66001ee2f46d540e4e19...02ad0aa3b6d3c28494465539976211b6a89cb1e0,1,4,4,8,4,2011-04-23 21:58:56,2011-04-23 21:58:56
21c0be8496127df3f0ad652e582133148430cc41...d46042e0500fb8241bf5ba012dfc779b535aa5fe,2,20,3,23,3,2011-04-17 18:58:20,2011-04-17 18:58:20
3aa46725edd73d3b6099ffdf1c1775ee54315845...230a50ff1c40f366d0c56f5d0317bfd066e8233a,1,1,1,2,1,2011-04-17 18:25:16,2011-04-17 18:25:16
bba3d610c7e3b611fe1eb89178c91106a156a5dc...9ecdb2472be7661477564e46bce51432d4a5a84e,4,65,2,67,6,2011-09-19 20:42:36,2011-09-19 20:42:36
9ecdb2472be7661477564e46bce51432d4a5a84e...f60213648cefa9b53289ad01a55ead22a15e6ee1,3,57,40,97,12,2011-09-20 01:03:41,2011-09-20 01:03:41
f60213648cefa9b53289ad01a55ead22a15e6ee1...ca4133cc3fb4202d08de0d9e9d05e2442be63653,2,39,9,48,5,2011-09-20 01:07:07,2011-09-20 01:07:07
ca4133cc3fb4202d08de0d9e9d05e2442be63653...9b3768b968bc99d3422355e69e2c7c35bedf681e,3,50,17,67,9,2011-09-20 01:16:20,2011-09-20 01:16:20
9b3768b968bc99d3422355e69e2c7c35bedf681e...11c9de477c5fe005a2487c761c257653aaf97a37,2,44,1,45,2,2011-09-20 03:09:40,2011-09-20 03:09:40
11c9de477c5fe005a2487c761c257653aaf97a37...0ced30e3190b6fe2714d8f01ebf92d7eb48d424b,1,45,44,89,2,2011-09-20 03:14:37,2011-09-20 03:14:37
0ced30e3190b6fe2714d8f01ebf92d7eb48d424b...f8b79e38c473291f4d30d2674fd08004876095db,1,1,1,2,1,2011-09-20 03:25:02,2011-09-20 03:25:02
f8b79e38c473291f4d30d2674fd08004876095db...2e5522a406de493f85832ed1adb57c0f4ce87a9c,1,1,1,2,1,2011-09-20 03:38:45,2011-09-20 03:38:45
2e5522a406de493f85832ed1adb57c0f4ce87a9c...70e2e32e0eb03607ad0c8b7752dbd7747da47164,2,48,3,51,2,2011-09-20 03:50:52,2011-09-20 03:50:52
70e2e32e0eb03607ad0c8b7752dbd7747da47164...63c9719330668f0165da1390e3aa53d4011aa0c2,1,3,1,4,3,2011-09-20 13:17:38,2011-09-20 13:16:13
63c9719330668f0165da1390e3aa53d4011aa0c2...b03648c2a3d94a8516d3e15905d1b13bbaed4a2f,1,3,4,7,3,2011-09-20 13:58:20,2011-09-20 13:58:20
b03648c2a3d94a8516d3e15905d1b13bbaed4a2f...26898f0bc593f1a2b7d5f2cc4e86f173bf9cf17c,1,8,4,12,3,2011-09-20 15:23:01,2011-09-20 15:23:01
ea5ce8c2a916ad44af21411d6e2b21ab9f6863f0...8ad2b31ff65ee07be02fb8976ea3b0f4105518b5,1,0,1,1,1,2011-01-20 17:50:47,2011-01-20 17:50:47
8ad2b31ff65ee07be02fb8976ea3b0f4105518b5...3dbd600e1961d9ab5296afbf2b3eb0852ad176e0,2,79,84,163,18,2011-01-20 18:40:51,2011-01-20 18:40:51
c5c1f18adb4dfae5366eafada12ed02fe1b7064d...5a721cf31b142365954a2d71e860534da4536b16,2,25,5,30,6,2011-01-11 19:02:33,2011-01-11 19:02:33
5a721cf31b142365954a2d71e860534da4536b16...6504d4f7005c99ea4064068f3d712322a064b97a,1,22,0,22,1,2011-01-11 22:01:18,2011-01-11 22:01:18
6504d4f7005c99ea4064068f3d712322a064b97a...f83cdc3c4c134b2796335e9f9806f3b67e7ca87f,1,1,1,2,1,2011-01-11 22:43:02,2011-01-11 22:43:02
f83cdc3c4c134b2796335e9f9806f3b67e7ca87f...0c51e9d55f39366cab14719b80cb7e989c716351,3,62,5,67,6,2011-01-12 17:36:00,2011-01-12 17:36:00
0c51e9d55f39366cab14719b80cb7e989c716351...14b07ec5de0437278806d12d058a249940eb531b,1,1,1,2,1,2011-01-12 17:53:00,2011-01-12 17:53:00
14b07ec5de0437278806d12d058a249940eb531b...e221d39e981ceac030d2e0431570742fb51337d5,1,3,3,6,2,2011-01-12 17:54:15,2011-01-12 17:54:15
e221d39e981ceac030d2e0431570742fb51337d5...e9fb7d5be6e079aaa2cf0c3092c6f15cd1285bf4,1,4,3,7,3,2011-01-12 23:41:10,2011-01-12 23:41:10
e9fb7d5be6e079aaa2cf0c3092c6f15cd1285bf4...ed1144816b07fbb2ea94217fd967626619344ad9,1,1,1,2,1,2011-01-12 23:49:58,2011-01-12 23:49:58
ed1144816b07fbb2ea94217fd967626619344ad9...97b244312e5dba9b28129006c9407ca80bb6c99b,1,28,6,34,24,2011-01-13 00:18:46,2011-01-13 00:18:46
97b244312e5dba9b28129006c9407ca80bb6c99b...b07d43c649240a78f5e832e2825db3af87357932,1,17,13,30,10,2011-01-13 00:43:42,2011-01-13 00:43:42
b07d43c649240a78f5e832e2825db3af87357932...667a3b31e6a27cfe3f209765d583bff584ecc2f6,2,36,42,78,25,2011-01-13 01:05:39,2011-01-13 01:05:39
667a3b31e6a27cfe3f209765d583bff584ecc2f6...57956152d8a9d23ae97ba576b8ec4b63306c8758,1,9,18,27,10,2011-01-13 15:58:16,2011-01-13 15:58:16
57956152d8a9d23ae97ba576b8ec4b63306c8758...44fc87f66ca54278e37f15885a80c2407036df57,2,97,0,97,4,2011-01-13 16:01:25,2011-01-13 16:01:25
44fc87f66ca54278e37f15885a80c2407036df57...a8fa5f2ec1030bceb9a65d0237f0c92ae4e014dd,4,11,12,23,11,2011-01-13 17:33:24,2011-01-13 17:33:24
bbd9c776ea22296a6807d5b760bd4e82ee5f4414...14193e449efe76105df61d745ebd7031dd7fe783,3,24,18,42,12,2011-04-07 15:26:42,2011-02-03 02:57:44
bbd9c776ea22296a6807d5b760bd4e82ee5f4414...2f11ba7c98d4d2d2157b7ae554f57f1798b04306,1,15,2,17,3,2011-04-07 03:41:47,2011-04-07 03:41:47
e0b1bb8e3d66db4166ac7ee2146903bae7ab1eb9...0d2e4796dc97d3f9d6b5c1977e883b3ddf2f53d9,3,39,3,42,7,2011-01-31 19:31:15,2011-01-31 19:31:15
0d2e4796dc97d3f9d6b5c1977e883b3ddf2f53d9...c67867ad0cd546ab461f13336f74b3f762d8fe7d,1,13,9,22,4,2011-01-31 19:50:03,2011-01-31 19:50:03
e0b1bb8e3d66db4166ac7ee2146903bae7ab1eb9...f43572d3b86074afc561822b7fd9592e1f05d19b,2,99,84,183,19,2011-01-31 18:59:53,2011-01-31 18:59:53
f43572d3b86074afc561822b7fd9592e1f05d19b...31949fa528141dad4b92851212677b039cb23cfb,2,21,3,24,2,2011-02-01 03:37:28,2011-02-01 03:37:28
31949fa528141dad4b92851212677b039cb23cfb...af70dee88e374d27dd8c0c8ec18af5c89541d4c9,1,15,19,34,2,2011-02-01 08:22:22,2011-02-01 08:18:16
af70dee88e374d27dd8c0c8ec18af5c89541d4c9...eb5aab99525ede9f8609fbfc741c6337cf2d5061,1,15,15,30,2,2011-02-01 08:30:52,2011-02-01 08:30:52
eb5aab99525ede9f8609fbfc741c6337cf2d5061...375b78783825b9adab7a01541faf99f98ef7ecbd,2,12,1,13,2,2011-02-01 13:57:18,2011-02-01 13:57:18
375b78783825b9adab7a01541faf99f98ef7ecbd...cb49b4a1b648dea8ce5b1e5dbb2ab5432a84cb63,3,64,64,128,54,2011-02-01 15:00:53,2011-02-01 15:00:30
cb49b4a1b648dea8ce5b1e5dbb2ab5432a84cb63...cb85da7b62e74e7339ed652ade209aaffbd0c15b,2,46,4,50,5,2011-02-01 16:22:01,2011-02-01 16:22:01
cb85da7b62e74e7339ed652ade209aaffbd0c15b...fa4c90987fc9aede4de3f41976cda91acad81736,2,11,3,14,4,2011-02-01 23:09:51,2011-02-01 22:54:02
fa4c90987fc9aede4de3f41976cda91acad81736...fdd4101fe93321f33b916a92b5def1328ea331b3,2,7,2,9,3,2011-02-01 23:32:29,2011-02-01 23:32:29
fdd4101fe93321f33b916a92b5def1328ea331b3...462bb1f66abf239492ee33c60feee3402fe64f77,4,6,10,16,6,2011-02-01 23:59:00,2011-01-24 10:18:57
462bb1f66abf239492ee33c60feee3402fe64f77...b90369e8cb2b6f3cc0afa34d815958ff0b605874,2,183,65,248,7,2011-02-02 12:33:31,2011-02-02 12:33:02
b90369e8cb2b6f3cc0afa34d815958ff0b605874...e3cc440934fcb03bfeb10fb6281615409ad6f483,1,23,7,30,7,2011-02-02 19:52:26,2011-02-02 19:52:26
e3cc440934fcb03bfeb10fb6281615409ad6f483...5ef7ddc4c55f49cb7767bba99975f2c7ea5422d9,1,9,1,10,1,2011-02-02 20:16:26,2011-02-02 20:16:26
5ef7ddc4c55f49cb7767bba99975f2c7ea5422d9...d77a2a2274d34033da8609a26c9cc1f2bd14c879,2,37,33,70,10,2011-02-03 01:53:10,2011-02-03 01:53:10
d77a2a2274d34033da8609a26c9cc1f2bd14c879...823eecab9073b43a283a2500e9e43c3a06cc2495,1,7,7,14,2,2011-02-03 02:02:11,2011-02-03 02:02:11
823eecab9073b43a283a2500e9e43c3a06cc2495...50e950a96e0fae23a1ae418951a298e2949ff351,1,2,2,4,1,2011-02-03 04:19:15,2011-02-03 04:19:15
50e950a96e0fae23a1ae418951a298e2949ff351...ee22a59129e082a2bb9f5bc0b085191ab6faafc8,3,57,34,91,12,2011-02-03 05:12:47,2011-02-03 05:12:47
ee22a59129e082a2bb9f5bc0b085191ab6faafc8...0736db64a21d961263161c2392dc6a0161bd4e86,1,1,1,2,1,2011-02-03 16:17:56,2011-02-03 16:17:56
0736db64a21d961263161c2392dc6a0161bd4e86...4d808a3345f78fab963be96bf272951745b894e3,1,5,12,17,3,2011-02-03 17:22:37,2011-02-03 17:22:37
4d808a3345f78fab963be96bf272951745b894e3...7eba4b76dfb4dde3b514281d614d7ac4fedc0289,1,1,1,2,1,2011-02-03 17:23:02,2011-02-03 17:23:02
7eba4b76dfb4dde3b514281d614d7ac4fedc0289...d66cc553167c6b00d19aa62a4dd1e9affb20d395,1,2,2,4,2,2011-02-04 20:50:18,2011-02-04 20:50:18
d66cc553167c6b00d19aa62a4dd1e9affb20d395...03bad0a9600f05e61a1464c55354d26fcd8f97a4,2,33,4,37,7,2011-02-04 21:19:23,2011-02-04 21:19:23
03bad0a9600f05e61a1464c55354d26fcd8f97a4...8f8961de90453274ac194479272a8dfa99ffab17,1,35,36,71,7,2011-02-04 21:29:10,2011-02-04 21:29:10
8f8961de90453274ac194479272a8dfa99ffab17...08fcde6a59e5bb6ca9e58bf78aac64ff2c15c29d,3,1,22,23,3,2011-02-04 23:20:23,2011-02-04 23:20:23
08fcde6a59e5bb6ca9e58bf78aac64ff2c15c29d...2c77704b145a24ad39648740466ed015fd4163dc,1,1,1,2,1,2011-02-05 02:06:21,2011-02-05 02:06:21
2c77704b145a24ad39648740466ed015fd4163dc...d6fbbe1080fdcaf8eb22753eddf000aeb7d99545,1,6,0,6,1,2011-02-05 02:08:35,2011-02-05 02:08:35
8cdafe77047dcce78b9369a4154af7c3f6ef1357...ad4152709cd7c7b7fdafd2dc0b266fd273aff5d5,2,3,8,11,5,2011-03-31 01:21:49,2011-03-31 01:21:49
2d0bc7ce72ab8d64da0506a88c8cc543ce3ceaba...6c124d3dd47fb399c7512c5c3b3420e438c32b65,1,6,5,11,1,2011-03-06 23:42:09,2011-03-06 23:42:09
2d0bc7ce72ab8d64da0506a88c8cc543ce3ceaba...5c2d70979c15bbda5c90e1634abe11d8c350abcb,1,3,0,3,1,2011-03-05 15:30:29,2011-03-05 15:30:29
5c2d70979c15bbda5c90e1634abe11d8c350abcb...c9ef09c800ba7b6510d9e3a68f053ae29409f621,2,8,6,14,4,2011-03-05 15:46:12,2011-03-05 15:46:12
c9ef09c800ba7b6510d9e3a68f053ae29409f621...dd100bf5ac56d5d44afe45d73fe1824bd0135872,1,2,2,4,2,2011-03-05 15:59:25,2011-03-05 15:59:25
dd100bf5ac56d5d44afe45d73fe1824bd0135872...124acbfbc523614dc5835cfce2c82b867a59986f,1,1,1,2,1,2011-03-14 20:17:02,2011-03-14 20:17:02
2d0bc7ce72ab8d64da0506a88c8cc543ce3ceaba...55ec6a71d2378a5301af71c2c0080e15289c3f78,2,48,9,57,10,2011-03-05 02:16:40,2011-03-05 02:16:40
f0e7d28e83266b4c186e916346d81fec71053d28...2407690ef9b3ec59920917935dc1a312f6c2b56e,1,1,1,2,1,2011-03-21 15:10:27,2011-03-21 15:10:27
2407690ef9b3ec59920917935dc1a312f6c2b56e...e38f074d14fd65b3f8b0e1bd7956cd75b3dafe2b,1,17,15,32,4,2011-03-21 15:39:53,2011-03-21 15:39:53
e38f074d14fd65b3f8b0e1bd7956cd75b3dafe2b...d832f4f71ec51e67d4cae2557221ef582818f607,2,27,25,52,10,2011-03-21 19:12:31,2011-03-21 19:12:31
d832f4f71ec51e67d4cae2557221ef582818f607...00dd6013b6b53455ef7b788801a5dc0616651580,1,4,4,8,1,2011-03-21 19:24:53,2011-03-21 19:24:53
00dd6013b6b53455ef7b788801a5dc0616651580...c72371f71474cbd6e2318c8ad909a2f92dcb915c,4,11,12,23,9,2011-04-05 06:59:54,2011-04-05 06:59:54
c72371f71474cbd6e2318c8ad909a2f92dcb915c...c0389e3e37447aa7eb70cfb4837f4df6cdec5bba,1,1,1,2,1,2011-04-05 15:33:14,2011-04-05 15:33:14
d638aa9c6d6394db0c06431560b3d8b83cacc61c...6eb75676c4d21550daa755c3dfc3539b1c530556,1,6,1,7,1,2011-09-22 07:35:57,2011-09-22 07:35:57
6eb75676c4d21550daa755c3dfc3539b1c530556...d920ac68fdc7c0fc95ec2e9d9c1a4a17d024581b,1,9,24,33,6,2011-09-23 13:11:02,2011-09-23 13:11:02
fb48ae8e6cca25fd29ef2b1eb23e9efa7b0eef7c...a42f7a2590ea21dbe8eb1e11f927a952bdd30c1e,1,5,5,10,2,2010-11-09 17:13:39,2010-11-09 17:13:39
aa743969763bde258fd16979c7205605ac6eae0f...983548f8ebc3fcd1bb4600bc4b740cb8a5d4c48b,1,11,8,19,3,2010-11-09 18:44:06,2010-11-09 18:44:06
983548f8ebc3fcd1bb4600bc4b740cb8a5d4c48b...b0e1e83aa987279dcdb81112ec942c161111be17,1,11,3,14,2,2010-11-09 19:03:11,2010-11-09 19:03:11
02ad0aa3b6d3c28494465539976211b6a89cb1e0...86d5d3e80962e695a9d5f0b2c7fd2b566327424c,1,20,13,33,5,2011-04-25 17:13:57,2011-04-25 17:10:23
02ad0aa3b6d3c28494465539976211b6a89cb1e0...9559b1a294af42d4c12d20b8af7a8422903b0a73,1,4,15,19,3,2011-04-25 16:41:12,2011-04-23 09:29:07
9559b1a294af42d4c12d20b8af7a8422903b0a73...83e9ce95d753bac0a860271ca85aef474295c1c4,1,3,2,5,3,2011-04-25 16:41:12,2011-04-23 19:57:55
83e9ce95d753bac0a860271ca85aef474295c1c4...51650338838e61d4d785968ddb5317233b76f55a,2,17,6,23,7,2011-04-25 16:41:12,2011-04-23 21:07:31
7a8fac57ebfa36922797f94a6330f91461244c3f...2786a110535f760006026d90d7d82522703b04db,2,571,437,1008,153,2011-04-17 20:28:36,2011-04-17 20:28:36
2786a110535f760006026d90d7d82522703b04db...f408aa43143f257fbcf29a79747e5f5f99339f21,3,13,36,49,7,2011-04-17 21:11:40,2011-04-17 21:11:40
230a50ff1c40f366d0c56f5d0317bfd066e8233a...3cb9c1835c0382163b2e94ae626a7ae0d2d0d94f,2,20,3,23,3,2011-04-17 22:17:31,2011-04-17 18:58:20
3cb9c1835c0382163b2e94ae626a7ae0d2d0d94f...2a71493447b91731cfbcbd3cce18bbdb8949c96a,2,571,437,1008,153,2011-04-17 22:17:31,2011-04-17 20:28:36
2a71493447b91731cfbcbd3cce18bbdb8949c96a...15da298f72bf94a95563abc12b8e6fec8c604099,3,13,36,49,7,2011-04-17 22:17:31,2011-04-17 21:11:40
15da298f72bf94a95563abc12b8e6fec8c604099...34d80709ce9bd583f6f5dd17e9bffa2fb7cff3c5,2,14,5,19,7,2011-04-17 22:17:31,2011-04-17 22:15:20
26898f0bc593f1a2b7d5f2cc4e86f173bf9cf17c...3bd7bed340f9077d39734ffce366ef2caeb9ce35,1,41,97,138,9,2011-09-21 00:44:36,2011-09-20 02:50:29
3bd7bed340f9077d39734ffce366ef2caeb9ce35...b85f222df55418c733c9639e88c0cdd5111c585b,2,20,13,33,7,2011-09-21 02:18:34,2011-09-21 02:18:34
b85f222df55418c733c9639e88c0cdd5111c585b...61511d5ab35611b50bc93b8e9ecfb35e561bee1e,1,2,1,3,2,2011-09-21 03:01:07,2011-09-21 03:01:07
61511d5ab35611b50bc93b8e9ecfb35e561bee1e...03d95530b57ebcc46329240f170dd85ce79f871b,2,11,21,32,9,2011-09-21 13:40:57,2011-09-21 13:40:57
03d95530b57ebcc46329240f170dd85ce79f871b...a588336a6dcc6f29e870e8fcdd243f96bec5e833,3,34,78,112,29,2011-09-21 15:00:55,2011-09-21 15:00:55
a588336a6dcc6f29e870e8fcdd243f96bec5e833...a4cdbf09ee97471ec041d83ceb8f3feb9825b2a1,1,19,8,27,7,2011-09-22 01:15:00,2011-09-22 01:15:00
26898f0bc593f1a2b7d5f2cc4e86f173bf9cf17c...92a80cbd057c06e259a06bb40a85e921ad5aec6a,1,65,6,71,7,2011-09-20 16:44:49,2011-09-20 16:44:49
92a80cbd057c06e259a06bb40a85e921ad5aec6a...9fbed020a15b0bfe33ce622b6f2fbccc1e2b4739,1,51,30,81,20,2011-09-20 16:54:34,2011-09-20 16:54:34
9fbed020a15b0bfe33ce622b6f2fbccc1e2b4739...3d39b7d52763d1aa337ccc17482ca54af530fb1f,1,1,1,2,1,2011-09-20 17:14:59,2011-09-20 17:14:59
3d39b7d52763d1aa337ccc17482ca54af530fb1f...0aaa1fae8335c2ce09085c9d73fb1124a90cef49,1,1,1,2,1,2011-09-20 18:54:33,2011-09-20 18:54:33
0aaa1fae8335c2ce09085c9d73fb1124a90cef49...9ef0394fbdec99c6addb14b0127abfb813508ffe,1,2,2,4,1,2011-09-22 14:35:18,2011-09-22 14:35:18
9ef0394fbdec99c6addb14b0127abfb813508ffe...313bee9de4b2a3ddf9b72c3f3e0c7fd55845e2ee,1,23,14,37,6,2011-09-22 14:43:32,2011-09-22 14:43:32
313bee9de4b2a3ddf9b72c3f3e0c7fd55845e2ee...2c903b805c922355409b4d593fbc3206395d008d,1,2,1,3,2,2011-09-22 14:52:29,2011-09-22 14:52:29
2c903b805c922355409b4d593fbc3206395d008d...66202aeae53be1c302922e57f61debd43d6415db,1,2,2,4,1,2011-09-22 14:59:29,2011-09-22 14:59:29
66202aeae53be1c302922e57f61debd43d6415db...7babc7f20393acb44d4fced34fe86fde65f893a0,1,6,3,9,3,2011-09-22 15:07:16,2011-09-22 15:07:16
7babc7f20393acb44d4fced34fe86fde65f893a0...737820118b0af9c9e0d077481f0630f0f279a2c8,1,4,2,6,1,2011-09-22 15:12:42,2011-09-22 15:12:42
737820118b0af9c9e0d077481f0630f0f279a2c8...7dab8981f8868caaa350ea7029929e7e81662fd2,1,0,1,1,1,2011-09-22 15:14:45,2011-09-22 15:14:45
7dab8981f8868caaa350ea7029929e7e81662fd2...dc878ae33bfe44a746d1f24eca7033f80d32517c,1,15,10,25,6,2011-09-22 15:22:56,2011-09-22 15:22:56
dc878ae33bfe44a746d1f24eca7033f80d32517c...14cb04dc947cd9d01c97ec0c4dc487f2cd53c3ac,1,5,0,5,1,2011-09-22 15:30:03,2011-09-22 15:30:03
14cb04dc947cd9d01c97ec0c4dc487f2cd53c3ac...c7f3b6109eabd32ade5085ef81ec2208964122cd,1,0,5,5,1,2011-09-22 23:05:06,2011-09-22 23:05:06
c7f3b6109eabd32ade5085ef81ec2208964122cd...c80ad2524ea510fd68d4e33ed4a89752f795828b,1,14,5,19,6,2011-09-23 00:02:34,2011-09-23 00:02:34
c80ad2524ea510fd68d4e33ed4a89752f795828b...87e1c62d8e5a916587217196ee7d1755bc9115ca,1,2,1,3,2,2011-09-23 19:45:19,2011-09-23 19:45:19
a8fa5f2ec1030bceb9a65d0237f0c92ae4e014dd...d483ce0a9c8b19dafa70be93ca071673b86a65e2,2,98,5,103,8,2011-01-14 15:38:32,2010-10-10 00:32:54
d483ce0a9c8b19dafa70be93ca071673b86a65e2...3716f2d0416895e1220269ea2e8bb23b8b843db0,1,8,0,8,4,2011-01-14 15:39:06,2011-01-14 15:36:45
3716f2d0416895e1220269ea2e8bb23b8b843db0...fa45f25d1c554663f696c43bb1d08d24fec6abf5,1,5,5,10,3,2011-01-14 16:17:32,2011-01-14 16:17:32
fa45f25d1c554663f696c43bb1d08d24fec6abf5...52a02383fa521c51d9996a46f03a7080dd825f11,1,3,2,5,2,2011-01-14 16:21:45,2011-01-14 16:21:45
a8fa5f2ec1030bceb9a65d0237f0c92ae4e014dd...e5ee89ec9a11804b39e9722f47eeeb00648f37ea,1,9,2,11,2,2011-01-14 14:55:40,2011-01-14 14:55:40
c470db6950d05644fa9d99e79ce0b2bc3c6235a1...98d83ef85f41fefb40a14eec24c6804c088bbeeb,2,26,13,39,7,2011-04-08 02:52:15,2011-04-08 02:52:15
98d83ef85f41fefb40a14eec24c6804c088bbeeb...7a1c6beab0d92b1419050eb468773bf1138254a6,2,18,19,37,16,2011-04-08 15:35:08,2011-04-08 15:35:08
7a1c6beab0d92b1419050eb468773bf1138254a6...2594a935de347088cecac987c3868e9bb5f35194,6,10,10,20,10,2011-04-08 15:41:14,2011-04-08 15:41:14
2594a935de347088cecac987c3868e9bb5f35194...f182b7b92117f8e353a1f712569d3d2642100862,1,2,1,3,2,2011-04-08 16:24:25,2011-04-08 16:24:25
d6fbbe1080fdcaf8eb22753eddf000aeb7d99545...0c21c83e9691a08151f23a2c594568b07009f063,1,26,34,60,7,2011-02-07 05:11:52,2011-02-07 05:11:52
0c21c83e9691a08151f23a2c594568b07009f063...a2dbdc1f5438a857c2a9898bd36e4b2de685742e,2,14,7,21,9,2011-02-07 15:35:32,2011-02-07 15:35:32
d6fbbe1080fdcaf8eb22753eddf000aeb7d99545...82626799cacef94a1b35d0a0b4d284b38104704b,3,27,29,56,13,2011-02-07 00:34:57,2011-02-07 00:34:57
6c124d3dd47fb399c7512c5c3b3420e438c32b65...714ae379db9dcb704c04080196a05d13a028f7a4,2,14,4,18,6,2011-03-15 18:20:03,2011-03-15 18:20:03
714ae379db9dcb704c04080196a05d13a028f7a4...150d3decb54971a7378fb48d0b6970d3fb50ff95,5,12,32,44,8,2011-03-15 19:16:09,2011-03-15 19:16:09
150d3decb54971a7378fb48d0b6970d3fb50ff95...cd2ca7b5918b3cedfed497ac7d86bfd2c5f92a8b,1,5,0,5,1,2011-03-15 20:25:51,2011-03-15 20:25:51
cd2ca7b5918b3cedfed497ac7d86bfd2c5f92a8b...bd4468886d97edfb53342e1a10acb300d081ed27,1,3,0,3,1,2011-03-15 20:42:58,2011-03-15 20:42:58
6c124d3dd47fb399c7512c5c3b3420e438c32b65...8246347b7191e79ed09bf1fc4c4a0a58211cf345,1,9,0,9,1,2011-03-14 01:12:10,2011-03-14 01:12:10
8246347b7191e79ed09bf1fc4c4a0a58211cf345...7a69e34a5cd4df37762cbee9c9468c96c0ac3017,3,39,11,50,6,2011-03-16 05:16:32,2011-03-16 05:16:32
7a69e34a5cd4df37762cbee9c9468c96c0ac3017...929792834f77e075e4b5397fb4b25b1a2dcbd49a,1,3,4,7,2,2011-03-16 18:41:26,2011-03-16 18:41:26
6c124d3dd47fb399c7512c5c3b3420e438c32b65...515c56f9c6394a4ddadf29c55867f71dec6dcdb7,1,2,2,4,3,2011-03-10 23:17:38,2011-03-10 23:17:38
515c56f9c6394a4ddadf29c55867f71dec6dcdb7...11c26b3cc9bf84f93d34f45056d29a446baeb6c9,1,1,1,2,2,2011-03-11 16:46:59,2011-03-11 16:46:59
6c124d3dd47fb399c7512c5c3b3420e438c32b65...2ac4067a639856a6035c3bd00aab132c9714b52d,2,15,1,16,2,2011-03-10 03:38:26,2011-03-10 03:38:26
6c124d3dd47fb399c7512c5c3b3420e438c32b65...d4e4414451e15d23d7174e8eeddaa952ed0e4d73,1,165,103,268,18,2011-03-07 03:47:40,2011-03-07 03:47:40
0cf336d2c95809ef41d94131e629fd1767f054a0...c3c507e900fceb419628157504004ab2813b7d01,3,44,1,45,4,2011-03-24 19:41:46,2011-03-24 19:41:46
0cf336d2c95809ef41d94131e629fd1767f054a0...a2faed347de389d6f667a4e98576398db88d1a14,1,1,1,2,1,2011-03-17 18:50:53,2011-03-17 18:50:53
a2faed347de389d6f667a4e98576398db88d1a14...22738e0e4b988f8ce2cb341b137ba0fe4646d3f3,1,0,1,1,1,2011-03-17 19:20:02,2011-03-17 19:15:44
22738e0e4b988f8ce2cb341b137ba0fe4646d3f3...4f9e78616ecd9ca403a25ee0e3dc71781484e553,1,6,5,11,3,2011-03-17 19:21:32,2011-03-17 19:14:15
4f9e78616ecd9ca403a25ee0e3dc71781484e553...b4acb7ae819563c3b75bbdabfaf2662fd24b06e4,1,1,1,2,1,2011-03-17 19:23:20,2011-03-17 19:16:19
b4acb7ae819563c3b75bbdabfaf2662fd24b06e4...e2dd8916eef1daba1a56a5ff1fbb44cb3385f4f0,1,4,2,6,2,2011-03-18 16:59:09,2011-03-17 19:26:45
e2dd8916eef1daba1a56a5ff1fbb44cb3385f4f0...8a1156da9b835d826bfb4b82c41bcdd0d87aff05,1,9,1,10,2,2011-03-18 16:59:16,2011-03-17 19:40:07
0cf336d2c95809ef41d94131e629fd1767f054a0...51abb3dc071fd86afd346ec5c340734f5c61064f,1,2,2,4,2,2011-03-16 00:44:05,2011-03-04 22:33:20
d920ac68fdc7c0fc95ec2e9d9c1a4a17d024581b...140bebb739da81e4439663f15e09d7cbbb77bdb8,1,1,1,2,1,2011-09-26 16:01:21,2011-09-26 16:01:21
d1a88b2e588ff9ed5b41396152e936012210d225...a64dc0405064d68c7b7cd0f0fc8ea60086cbcd21,2,66,67,133,17,2010-11-09 20:52:20,2010-11-09 20:52:20
fb65ba418a283ba70e179d442965cfbaa5bb7e92...08f52d69bd4f048fb6d5f6c861a5655eec8be1b0,1,1,1,2,1,2011-04-26 13:45:27,2011-04-26 13:45:27
fb5ef2c4ec8a7b46967435c4a49022c67d8a7b26...8d3754751dfa348c1d1e2d6735ec8cbc3a404695,1,1,1,2,1,2011-04-17 22:29:49,2011-04-17 22:29:49
8d3754751dfa348c1d1e2d6735ec8cbc3a404695...3a3842c6696f121392c89b68f2f061043405ae9f,2,6,3,9,4,2011-04-19 07:29:20,2011-04-19 07:29:20
3a3842c6696f121392c89b68f2f061043405ae9f...825d3d96cebf9a88f34411a2df95622fd3e32619,2,5,1,6,3,2011-04-19 17:17:38,2011-04-19 17:17:38
825d3d96cebf9a88f34411a2df95622fd3e32619...8d2d94cfbab40d3919b4d5e596e589a2be09af1a,1,5,3,8,2,2011-04-19 17:45:01,2011-04-19 17:45:01
8d2d94cfbab40d3919b4d5e596e589a2be09af1a...103d3258876fb55316713ab3e4e743b2f8def54a,1,4,1,5,1,2011-04-19 21:48:07,2011-04-19 21:48:07
103d3258876fb55316713ab3e4e743b2f8def54a...60cfab3d191aa5dc1e0f21fa2478c77aa3332633,2,2,2,4,2,2011-04-20 23:08:29,2011-04-20 23:08:29
60cfab3d191aa5dc1e0f21fa2478c77aa3332633...a28eadff48d5e56bb529fc7a5c7e1a74e46398ed,1,26,30,56,6,2011-04-21 16:43:40,2011-04-21 16:43:40
a28eadff48d5e56bb529fc7a5c7e1a74e46398ed...dbe966aa57ce10d6c93db46eb2f3369a39e10d01,2,2,2,4,2,2011-04-21 17:03:19,2011-04-21 17:03:19
dbe966aa57ce10d6c93db46eb2f3369a39e10d01...3ac9eb7ce37b461a34e303e8b77aa544d313441c,3,20,3,23,6,2011-04-22 01:33:09,2011-04-22 01:33:09
3ac9eb7ce37b461a34e303e8b77aa544d313441c...d274b7b9f7727e8bccd6906d954e4dc790404d23,4,95,44,139,23,2011-04-22 01:51:23,2011-04-22 01:51:23
ae27424b30df318a41ea445c296a0d5566a36467...b4120a74306e1d98e212c77e5a89c1526a51fc3b,2,95,145,240,18,2011-09-25 23:56:34,2011-09-25 23:56:34
b4120a74306e1d98e212c77e5a89c1526a51fc3b...c7838c3607239b0231128b270762609703ae3893,2,7,7,14,4,2011-09-26 02:04:52,2011-09-26 02:04:52
a7ab491a5d3c7347ee5685bd6df11092f0d638ca...f4add19759678797ed8078a96d0c18b168df8588,1,0,8,8,4,2011-01-14 17:46:22,2011-01-14 17:46:14
f4add19759678797ed8078a96d0c18b168df8588...cf7ddcf79a3d4d455711b67b252b19ae343645b1,1,14,3,17,5,2011-01-14 19:12:29,2011-01-14 19:12:29
cf7ddcf79a3d4d455711b67b252b19ae343645b1...bcdd4f817378d5c6c95646ef556e0ff4215bcb5f,1,1,1,2,1,2011-01-14 19:56:21,2011-01-14 19:56:21
bcdd4f817378d5c6c95646ef556e0ff4215bcb5f...d9cb69873c0be7cb2f65d24deeb6a01fada0661b,1,1,1,2,1,2011-01-14 19:56:37,2011-01-14 19:56:37
f182b7b92117f8e353a1f712569d3d2642100862...3411d47a6a952e283864d2401438a6764d925b74,3,183,37,220,27,2011-04-11 11:40:14,2011-04-11 11:40:14
f182b7b92117f8e353a1f712569d3d2642100862...8c40c00fac2f30fa0804ae8097642636f9718ddd,1,4,8,12,3,2011-04-10 18:31:31,2011-04-10 18:31:31
8c40c00fac2f30fa0804ae8097642636f9718ddd...8c318bf41412d493604beed1879c4a273ff05a57,2,26,5,31,5,2011-04-10 19:17:00,2011-04-10 19:17:00
f182b7b92117f8e353a1f712569d3d2642100862...5dde3eb44169c3cdc8517aee693fe8f4d783d715,1,83,0,83,1,2011-04-08 20:09:53,2011-04-08 18:56:56
a2dbdc1f5438a857c2a9898bd36e4b2de685742e...7acb141ed7f2dedd950bb65acf878098640d081e,4,37,53,90,20,2011-02-07 16:48:38,2011-02-07 16:48:38
a2dbdc1f5438a857c2a9898bd36e4b2de685742e...5b421fed003e6704bd0fbba2dea5c1b6add2cf52,1,4,3,7,1,2011-02-07 16:09:47,2011-02-07 16:09:47
6da3885cc38043fd8d384d1184468b0a2fba9fd9...1a167767305202797cf4c839eb64bd7adfb00182,2,2,5,7,3,2011-03-31 03:23:38,2011-03-31 03:23:38
adbe5e95f3411882d98c4c6e70cdc0a79dfc3d57...6c28a394c2174c51196cd9ac073b819fc79adb3b,1,0,1,1,1,2011-03-31 01:59:38,2011-03-31 01:59:38
eb1497c1fb5a5e529e83c3597c7d212eae129ab7...e09d8898d8a8df27bb72ebc64a4cd08c11f21ddd,2,26,8,34,7,2011-03-22 00:59:20,2011-03-22 00:59:20
e09d8898d8a8df27bb72ebc64a4cd08c11f21ddd...b8013581ced78fb6c2005e76b44211e01fc2e466,1,4,2,6,3,2011-03-23 19:56:05,2011-03-23 19:56:05
b8013581ced78fb6c2005e76b44211e01fc2e466...e6da0fa6a96c9b4314303e251fd6efac98813ab8,1,3,1,4,2,2011-03-26 03:46:29,2011-03-26 03:46:29
e6da0fa6a96c9b4314303e251fd6efac98813ab8...e93ca40aa7ec4337a57fcdbc699d900e01b4c67e,1,2,1,3,2,2011-03-26 03:52:36,2011-03-26 03:52:36
7705c35b140f378e407c196599cc738bc54c5cec...50e8837207bbfb251af33280b8ef333f16c18e72,1,1,1,2,1,2011-03-22 22:18:15,2011-03-22 22:18:15
1912ded3ee0065a71ee0d16c1e5aaba0daef82a0...e8f4629b924cae0b0f1847d2368031f06bc08149,2,18,3,21,4,2011-03-24 23:02:38,2011-03-24 23:02:38
e8f4629b924cae0b0f1847d2368031f06bc08149...53697d10efc25ff4fe2bfdd049b4967b7ab507e6,1,1,1,2,1,2011-03-24 23:36:38,2011-03-24 23:36:38
53697d10efc25ff4fe2bfdd049b4967b7ab507e6...5ee4eefb9eb9f571f33afcb9462d9a2f6f8e5547,1,1,1,2,1,2011-03-24 23:40:09,2011-03-24 23:40:09
5ee4eefb9eb9f571f33afcb9462d9a2f6f8e5547...7b985c4ca0cc687998302483000f2dcf9dcb9bce,1,30,0,30,1,2011-03-24 23:52:45,2011-03-24 23:52:45
36c82a1bcea14680b7efed47da8f3ebd9bf3de82...d11fcfac186d64457d54d7e80f7d06b97b1c344a,1,19,16,35,11,2011-09-26 17:00:45,2011-09-26 17:00:45
d11fcfac186d64457d54d7e80f7d06b97b1c344a...51fd4593fc43f4c935d3226485f6864b05366621,1,1,0,1,1,2011-09-26 17:03:24,2011-09-26 17:03:24
51fd4593fc43f4c935d3226485f6864b05366621...649823de18564774a5812ae04083606447bd2b93,1,25,17,42,3,2011-09-28 14:06:29,2011-09-28 14:06:29
649823de18564774a5812ae04083606447bd2b93...3661835101865b08fae20df7458ba03551b86bc3,3,9,6,15,6,2011-09-28 15:30:38,2011-09-28 15:30:38
3661835101865b08fae20df7458ba03551b86bc3...a74cbb2b911b3afad96599728208d95a60d24cbf,1,17,17,34,2,2011-09-28 15:39:05,2011-09-28 15:39:05
a74cbb2b911b3afad96599728208d95a60d24cbf...a3b59d7f92c9e15af1888fc4e87639a290763a50,4,150,30,180,23,2011-09-28 15:55:29,2011-09-28 15:55:29
a3b59d7f92c9e15af1888fc4e87639a290763a50...8dda57f82f1c366f10c591da099f8e9495eaa01b,2,44,4,48,4,2011-09-28 16:00:21,2011-09-28 16:00:21
8dda57f82f1c366f10c591da099f8e9495eaa01b...9c4aaeb0a876235614bd0310517d2f86543c5f45,1,23,23,46,6,2011-09-28 16:05:12,2011-09-28 16:04:27
a64dc0405064d68c7b7cd0f0fc8ea60086cbcd21...795e880bba1f7f949df58748f7fd92e50296a8f4,2,39,4,43,2,2010-11-10 04:18:16,2010-11-10 04:18:16
795e880bba1f7f949df58748f7fd92e50296a8f4...3394d32ea75cffb8c8c386d607823cae878b9145,3,35,8,43,11,2010-11-10 04:29:26,2010-11-10 04:29:26
3394d32ea75cffb8c8c386d607823cae878b9145...efaf375e56920c9699c3d4ef09fb9171352aa8bb,1,2,2,4,2,2010-11-10 04:33:18,2010-11-10 04:33:18
efaf375e56920c9699c3d4ef09fb9171352aa8bb...86cf820d36341842e10084a97d2ecf87393336f3,2,4,39,43,2,2010-11-10 04:42:05,2010-11-10 04:42:05
86cf820d36341842e10084a97d2ecf87393336f3...50708c070704c607a0ddc51679b93845c8fee5e1,1,1,1,2,1,2010-11-10 16:14:53,2010-11-10 16:14:53
50708c070704c607a0ddc51679b93845c8fee5e1...648b0513facc0261f1dffa238344802410f0055b,1,1,1,2,1,2010-11-10 16:15:02,2010-11-10 16:15:02
648b0513facc0261f1dffa238344802410f0055b...902cc7947c1c6dd31ff216eea5d0130eb15a33a1,1,1,1,2,1,2010-11-12 00:04:53,2010-11-12 00:04:53
902cc7947c1c6dd31ff216eea5d0130eb15a33a1...0838bdf52cf9f27ebc2bbee74fd7170e2d854c11,1,1,1,2,1,2010-11-12 00:05:10,2010-11-12 00:05:10
a64dc0405064d68c7b7cd0f0fc8ea60086cbcd21...49f088f2db21816f4b453ab4a22442ac031ab9bd,1,66,64,130,19,2010-11-09 23:36:53,2010-11-09 23:36:53
49f088f2db21816f4b453ab4a22442ac031ab9bd...b50f41a2e3ba9ab9a7bcf69a9633b0a8258015d6,2,54,4,58,8,2010-11-13 13:39:28,2010-11-13 13:39:28
a64dc0405064d68c7b7cd0f0fc8ea60086cbcd21...118c8c4600b62d6de2b0248ae27626da74dcf5b2,2,41,5,46,2,2010-11-09 23:06:33,2010-11-09 23:06:33
118c8c4600b62d6de2b0248ae27626da74dcf5b2...8f2667f4c09d14de413cac1e3c5fc5783521b0e0,1,2,3,5,2,2010-11-09 23:20:27,2010-11-09 23:20:27
8f2667f4c09d14de413cac1e3c5fc5783521b0e0...2a23650a19ed4db2d031697638bdd71c06f44492,1,15,11,26,10,2010-11-10 15:23:48,2010-11-10 15:23:48
2a23650a19ed4db2d031697638bdd71c06f44492...00f1dfdd57fd8478688f9d201e539e0bf3946be2,1,2,2,4,1,2010-12-09 17:44:52,2010-12-09 17:44:52
00f1dfdd57fd8478688f9d201e539e0bf3946be2...5b2408147b9cf9b7f49a07ebe97b20c398568e22,1,3,3,6,1,2010-12-09 17:47:53,2010-12-09 17:47:53
5b2408147b9cf9b7f49a07ebe97b20c398568e22...1cdd9f8cab5b86d76ea20e996a9c636dd6f5ca6e,1,3,3,6,1,2010-12-09 17:48:52,2010-12-09 17:48:52
1cdd9f8cab5b86d76ea20e996a9c636dd6f5ca6e...a59bb30d0a5ea0d3d73285c6fed0fbe00b23321f,1,1,1,2,1,2010-12-09 17:50:01,2010-12-09 17:50:01
a64dc0405064d68c7b7cd0f0fc8ea60086cbcd21...e2d0671f4c260f2bd97fe76269188d5d6fc19dcd,1,25,0,25,1,2010-11-09 21:31:52,2010-11-09 21:31:52
a64dc0405064d68c7b7cd0f0fc8ea60086cbcd21...fc563cc42a4cf9b8d717f1fa4f397e76a132d90a,2,17,4,21,3,2010-11-09 21:14:11,2010-11-09 21:14:11
742e15c638bc3872a43d4696f24c1fe8b1f2d99a...455edf197add9a9ea21ac7cf4266784a083c74ef,1,1,1,2,1,2011-04-26 20:21:45,2011-04-26 20:21:45
455edf197add9a9ea21ac7cf4266784a083c74ef...fd11df1ec477690e7b50c532d04d1781dac91284,1,1,1,2,1,2011-04-26 20:22:07,2011-04-26 20:22:07
fd11df1ec477690e7b50c532d04d1781dac91284...a8988e3cd13d1ffab4291ec9fcbd2f88b8e424a2,1,169,0,169,1,2011-04-26 20:23:09,2011-04-26 20:23:09
a8988e3cd13d1ffab4291ec9fcbd2f88b8e424a2...b5772da08748edbf22d3a6134b1764a787231e8b,2,81,0,81,2,2011-04-27 04:56:08,2011-04-27 04:56:08
d9cb69873c0be7cb2f65d24deeb6a01fada0661b...8ab23aec2c333834a6e442fa15b73125ba857afe,4,123,122,245,49,2011-01-16 01:57:39,2011-01-16 01:57:39
8ab23aec2c333834a6e442fa15b73125ba857afe...21143c3b213843bc202c16b5532b6e9de951eb2c,1,2,1,3,2,2011-01-16 02:05:03,2011-01-16 02:05:03
21143c3b213843bc202c16b5532b6e9de951eb2c...914aa3d66b0d34fc44377a2facc00a77c65d0891,1,7,7,14,3,2011-01-16 04:24:14,2011-01-16 04:24:14
914aa3d66b0d34fc44377a2facc00a77c65d0891...f74b84498987ace9bbbc3c041607016a23ff251e,1,1,0,1,1,2011-01-16 04:25:45,2011-01-16 04:25:45
f74b84498987ace9bbbc3c041607016a23ff251e...158fa822dea3198de5a4bcff3955b869ebb758c8,1,23,11,34,5,2011-01-16 04:26:46,2011-01-16 04:26:46
158fa822dea3198de5a4bcff3955b869ebb758c8...0e93b2e24c67237c1172b5d7b1f75f52904d6a1c,1,222,259,481,22,2011-01-16 04:27:16,2011-01-16 04:27:16
0e93b2e24c67237c1172b5d7b1f75f52904d6a1c...cfca6d3836476a233cf349abc5f433f1ba7b8feb,1,5,5,10,5,2011-01-16 04:36:20,2011-01-16 04:36:20
cfca6d3836476a233cf349abc5f433f1ba7b8feb...c272f5f7da3473fd5ac85efe783a0d63608ec62b,2,79,14,93,11,2011-01-16 16:41:39,2011-01-16 16:41:39
c272f5f7da3473fd5ac85efe783a0d63608ec62b...5798446b9816daca48e8c03791f4afc0ab0ac4cf,1,9,4,13,3,2011-01-16 17:33:32,2011-01-16 17:33:32
5798446b9816daca48e8c03791f4afc0ab0ac4cf...ac2e731b2d219fd516a166a058831de1ff949d4a,1,20,1,21,2,2011-01-17 16:52:30,2011-01-17 16:52:30
d9cb69873c0be7cb2f65d24deeb6a01fada0661b...75655e5758bc786989f26a98b09aabbfb88f66fd,2,31,3,34,3,2011-01-15 12:56:20,2011-01-15 12:56:20
a019fc9ff35dabe678729d5bce7deef8817e2ef5...9ed5c774e4222a4f100b5a06e5f90327aa2d4b18,1,1,1,2,1,2011-04-10 19:38:54,2011-04-10 19:38:54
8805f1373d321d7e80e1984bd7e9a3e5d8e50943...534dbd660eaefbbc5827b1b61ba384e768562086,1,1,1,2,1,2011-02-07 16:56:48,2011-02-07 16:56:48
534dbd660eaefbbc5827b1b61ba384e768562086...4a828c93d40eb67b2041b08bbed0f1973442bd03,1,3,1,4,2,2011-02-08 15:57:06,2011-02-08 15:57:06
4a828c93d40eb67b2041b08bbed0f1973442bd03...944e0e6498396bb1add67b9b0d0b13dc465d393b,1,1,3,4,2,2011-02-08 16:08:25,2011-02-08 16:08:25
944e0e6498396bb1add67b9b0d0b13dc465d393b...b46dff39c35ae05f92f6909ff8d07aa470e4a8d4,1,6,0,6,1,2011-02-08 16:15:55,2011-02-08 16:15:55
b46dff39c35ae05f92f6909ff8d07aa470e4a8d4...d92dc2902c1e49642ce5148f7e082d880e77a2c5,2,3,16,19,3,2011-02-08 18:13:27,2011-02-08 18:13:27
d92dc2902c1e49642ce5148f7e082d880e77a2c5...2953d0481aacd38f1e2e1916ba6d18d2b10861d4,1,1,1,2,1,2011-02-09 14:26:34,2011-02-09 14:26:34
2953d0481aacd38f1e2e1916ba6d18d2b10861d4...806d9ce8111128c4f30c6559c325f8a4ad1018a3,1,31,9,40,9,2011-02-09 14:27:50,2011-02-09 14:27:50
806d9ce8111128c4f30c6559c325f8a4ad1018a3...f6e173437e9f94cd4e713e556c6fc8ca68be8384,3,42,1,43,4,2011-02-09 16:47:33,2011-02-09 16:47:33
f6e173437e9f94cd4e713e556c6fc8ca68be8384...6f4b36ed174b000701b9a40ef45f301b2b1505db,1,3,3,6,1,2011-02-09 16:50:45,2011-02-09 16:50:45
6f4b36ed174b000701b9a40ef45f301b2b1505db...f56b4a22a6cf37b3764939b0338bb545fa6b445f,1,3,2,5,3,2011-02-10 00:29:18,2011-02-10 00:29:18
f56b4a22a6cf37b3764939b0338bb545fa6b445f...3f036281dd52b27ae34be927162df8d078665202,2,1,518,519,2,2011-02-10 21:19:35,2011-02-10 21:19:35
3f036281dd52b27ae34be927162df8d078665202...4490f4285cc4cdafba67fee726d3eba4a3d81a0f,2,31,35,66,15,2011-02-10 21:20:47,2011-02-10 02:15:32
4490f4285cc4cdafba67fee726d3eba4a3d81a0f...78fc79fad47ce2991c0a7148b65acd7221223eb9,2,14,7,21,8,2011-02-10 21:20:48,2011-02-10 02:18:11
78fc79fad47ce2991c0a7148b65acd7221223eb9...43a41ba7ecef732b48dcfc930fa9df8835fc4944,2,24,0,24,2,2011-02-10 22:50:02,2011-02-10 22:50:02
43a41ba7ecef732b48dcfc930fa9df8835fc4944...3a1d7a3c7c5349021f6dae979ab9b8609ae8f105,2,37,44,81,10,2011-02-11 06:02:11,2011-02-11 06:02:11
3a1d7a3c7c5349021f6dae979ab9b8609ae8f105...f2e0ae1a3932d6089853e8c0eed6ecb446610c00,2,13,10,23,9,2011-02-11 06:07:06,2011-02-11 06:07:06
f2e0ae1a3932d6089853e8c0eed6ecb446610c00...066304edf0a1ed0303d79712bfa9c8697d5fa4d3,1,1,1,2,1,2011-02-11 06:39:46,2011-02-11 06:39:46
066304edf0a1ed0303d79712bfa9c8697d5fa4d3...481d940e79f9d01e49218bf76575849158214e28,1,1,3,4,2,2011-02-11 10:59:42,2011-02-10 22:57:06
481d940e79f9d01e49218bf76575849158214e28...ea3e10a49207f76957b5bd87095634882d5d374b,2,12,10,22,3,2011-02-11 23:14:11,2011-02-11 23:13:38
ea3e10a49207f76957b5bd87095634882d5d374b...081562cebc63617d2c99adbcefa107dbea5c9bee,1,5,4,9,2,2011-02-12 00:08:24,2011-02-12 00:08:24
081562cebc63617d2c99adbcefa107dbea5c9bee...d4790116b8ff83786e82767cba23a4bff0236e58,1,23,11,34,5,2011-02-12 02:59:46,2011-02-12 02:59:46
d4790116b8ff83786e82767cba23a4bff0236e58...f0999076723d85e77d4ba73d7c464466b5a7dba1,1,5,5,10,6,2011-02-12 12:53:02,2011-02-12 02:05:19
f0999076723d85e77d4ba73d7c464466b5a7dba1...3548ffaee244af2bd5e28e91ebfaa995adab93a7,1,0,1,1,1,2011-02-12 12:53:03,2011-02-12 02:09:45
3548ffaee244af2bd5e28e91ebfaa995adab93a7...2862f589db08b92c7b1f78fa961aff7354027c0b,2,10,2,12,3,2011-02-12 12:53:04,2011-02-12 02:35:41
2862f589db08b92c7b1f78fa961aff7354027c0b...d99268a4b728e47d02b9b893e08796c8060a68e9,3,111,0,111,3,2011-02-12 12:53:05,2011-02-12 02:42:35
d99268a4b728e47d02b9b893e08796c8060a68e9...fbf79c0b495e08d67c3a4767f371ec7bcfc40a17,23,70,13958,14028,35,2011-02-13 00:34:31,2011-02-13 00:34:31
fbf79c0b495e08d67c3a4767f371ec7bcfc40a17...3930afa3ad10440ecb6571c0840d576b9979bff5,1,3,3,6,3,2011-02-13 00:48:48,2011-02-13 00:48:48
3930afa3ad10440ecb6571c0840d576b9979bff5...dba8c20b4bfdeb95b6fb8c9555355babf1daa539,1,37,44,81,14,2011-02-13 22:17:35,2011-02-13 22:02:14
dba8c20b4bfdeb95b6fb8c9555355babf1daa539...c5edf982d59977c506fececd504a3dbfd1a398dc,2,12,2,14,3,2011-02-13 22:17:58,2011-02-13 22:03:46
c5edf982d59977c506fececd504a3dbfd1a398dc...659773348f1fca0fb609f92271013f2a087f3247,2,3,3,6,3,2011-02-13 23:37:07,2011-02-13 23:37:07
6c28a394c2174c51196cd9ac073b819fc79adb3b...459bd7f89d112dd6aec97bfd1923bb7d4337243c,1,7,2,9,3,2011-03-31 13:10:30,2011-03-31 13:10:30
6c28a394c2174c51196cd9ac073b819fc79adb3b...f9cc5597a47e8a95b13fa5599e94c20fe80903e0,4,17,50,67,7,2011-03-31 06:55:16,2011-03-31 06:55:16
6c28a394c2174c51196cd9ac073b819fc79adb3b...a807451a23577ad04140a32f7888e6c7b26a8838,2,6,2,8,3,2011-03-31 03:39:19,2011-03-31 03:39:19
7b985c4ca0cc687998302483000f2dcf9dcb9bce...d86c48679aeedf8a77ddc75b130f0babc6aa6336,1,1,1,2,1,2011-03-25 00:08:40,2011-03-25 00:08:40
d86c48679aeedf8a77ddc75b130f0babc6aa6336...2d80710ab00a4f3e8420b315ce5e5137d562afda,1,1,1,2,1,2011-03-25 00:12:31,2011-03-25 00:12:31
2d80710ab00a4f3e8420b315ce5e5137d562afda...23e8cc560809fa108c922f8930eeaef775867ce8,1,1,1,2,1,2011-03-25 00:12:40,2011-03-25 00:12:40
7b985c4ca0cc687998302483000f2dcf9dcb9bce...735a949a0649f0299e8e4d87b259290970a68ddf,1,8,5,13,1,2011-03-24 23:55:55,2011-03-24 23:55:55
9c4aaeb0a876235614bd0310517d2f86543c5f45...db31faccd7b96fb09ac49d6dafca9bf2357d3e83,1,1,1,2,1,2011-09-28 19:50:33,2011-09-28 19:50:33
9c4aaeb0a876235614bd0310517d2f86543c5f45...9a51bc648f303a1c308b0de3ea31f2e9b4304135,1,1,1,2,1,2011-09-28 19:50:22,2011-09-28 19:50:22
9a51bc648f303a1c308b0de3ea31f2e9b4304135...a2ad83b7f629e5d3ae71589467b420547bde5fcf,1,1,1,2,1,2011-09-28 19:50:56,2011-09-28 19:50:56
a2ad83b7f629e5d3ae71589467b420547bde5fcf...22fcc7744daded0dc0783d85df3bd88c6dbc4544,1,1,1,2,1,2011-09-28 20:47:45,2011-09-28 20:47:18
22fcc7744daded0dc0783d85df3bd88c6dbc4544...96a44a86d870f2634c82a4148d22d0a07044ba77,2,5,2,7,3,2011-09-29 14:34:55,2011-09-29 14:34:40
96a44a86d870f2634c82a4148d22d0a07044ba77...1ebced173697421db5e0839d7ca092007455b42c,2,35,18,53,10,2011-09-30 21:50:48,2011-09-30 21:50:07
1ebced173697421db5e0839d7ca092007455b42c...46219b57baa44cfdd2e7c1bab0227f38f2927508,1,23,14,37,11,2011-10-01 20:49:49,2011-10-01 20:49:49
46219b57baa44cfdd2e7c1bab0227f38f2927508...9f5d56a8b5bdeb1186130f81e514982e089da7a2,2,86,0,86,2,2011-10-01 20:58:01,2011-10-01 20:58:01
9f5d56a8b5bdeb1186130f81e514982e089da7a2...3e0fe5ea3b1dafe454039c7c12c4d5d5fa037c9f,1,1,1,2,1,2011-10-02 13:50:09,2011-10-02 13:50:09
0838bdf52cf9f27ebc2bbee74fd7170e2d854c11...50170e618059d10132a5319c64660a631b095f44,1,1,1,2,1,2010-11-22 23:26:46,2010-11-22 23:26:46
0838bdf52cf9f27ebc2bbee74fd7170e2d854c11...3e6e3c5eb82c1dcb6fe2d2555db63b5861d219ab,1,2,2,4,1,2010-11-22 00:54:56,2010-11-22 00:54:56
0838bdf52cf9f27ebc2bbee74fd7170e2d854c11...89b771daefcd0cc6a31b7285b06cbc4e5ecede57,2,11,4,15,5,2010-11-21 03:31:04,2010-11-21 03:31:04
0838bdf52cf9f27ebc2bbee74fd7170e2d854c11...ab2a70e6cfba19ec9140c3e393e8cdb60c537bdb,2,7,2,9,5,2010-11-21 00:58:46,2010-11-21 00:58:46
0838bdf52cf9f27ebc2bbee74fd7170e2d854c11...8259efe7342870c79195ab59ac2368bf9961bc5a,1,1,1,2,1,2010-11-19 22:14:24,2010-11-19 22:14:24
8259efe7342870c79195ab59ac2368bf9961bc5a...a2c2d68d7f29eb543d937a72bdf4b5399b7aa14a,1,13,2,15,3,2010-11-24 22:35:26,2010-11-24 22:35:26
0838bdf52cf9f27ebc2bbee74fd7170e2d854c11...5c0b5d25602ad2f3c8e60a9b57e6f2115650f993,2,6,6,12,4,2010-11-19 11:28:13,2010-11-19 11:28:13
0838bdf52cf9f27ebc2bbee74fd7170e2d854c11...2a0c7d702b83a6b2e40eb79a5d6ea94d74f3090d,2,14,1,15,2,2010-11-17 06:59:24,2010-11-17 06:59:24
2a0c7d702b83a6b2e40eb79a5d6ea94d74f3090d...c04500a8347f381b069c036d9ac24b591b3fc6b7,1,1,1,2,1,2010-11-17 20:50:05,2010-11-17 20:50:05
0838bdf52cf9f27ebc2bbee74fd7170e2d854c11...4a1559e1279c12b99f7bb2db867ca51713de7cd4,1,1,1,2,1,2010-11-12 05:40:19,2010-11-12 05:40:19
4a1559e1279c12b99f7bb2db867ca51713de7cd4...866ba43d0a8cd9807a39483df48d9366558cb6dd,1,2,1,3,1,2010-11-12 05:41:44,2010-11-12 05:41:44
866ba43d0a8cd9807a39483df48d9366558cb6dd...4190059c762f253fa9231d4493db8dead59b7b09,1,242,242,484,1,2010-11-12 05:42:53,2010-11-12 05:42:53
4190059c762f253fa9231d4493db8dead59b7b09...e1d6edf822f7f875f794849723b13bbf74dd3c83,1,12,12,24,1,2010-11-12 05:45:24,2010-11-12 05:45:24
b5772da08748edbf22d3a6134b1764a787231e8b...076c347605c752821dfb6457044df4ba87b601c1,1,2,5,7,3,2011-05-09 15:35:51,2011-05-09 15:35:51
076c347605c752821dfb6457044df4ba87b601c1...f34a90b3f7a5d54beb267ce08295cb1e64c3a2af,1,17,0,17,1,2011-05-09 15:46:00,2011-05-09 15:46:00
f34a90b3f7a5d54beb267ce08295cb1e64c3a2af...966c2fe46a785a2555ec9a1048fc4a9014c40aa3,1,0,1,1,1,2011-05-10 10:18:40,2011-05-10 10:18:40
b5772da08748edbf22d3a6134b1764a787231e8b...c0450f3c2aab7af902ccf4ba0537088fc26f065d,1,1,1,2,1,2011-04-27 20:33:12,2011-04-27 20:33:12
c0450f3c2aab7af902ccf4ba0537088fc26f065d...ebac797ac22225aeca4fad2658aae9b71670fec6,1,9,0,9,1,2011-04-28 19:28:01,2011-04-28 19:28:01
ebac797ac22225aeca4fad2658aae9b71670fec6...632cd6c4ba625ed1586b5c09140614ee3eef867f,1,4,4,8,2,2011-04-28 19:56:02,2011-04-28 19:56:02
632cd6c4ba625ed1586b5c09140614ee3eef867f...57f56be04f18f25fbf313973c1d8ce685fa05d3e,2,5,5,10,5,2011-04-28 20:06:13,2011-04-28 18:11:34
57f56be04f18f25fbf313973c1d8ce685fa05d3e...b8a9c2ba343f420ff6cce8100250d4e067fd300a,1,3,2,5,1,2011-04-28 20:31:51,2011-04-28 20:31:51
459bd7f89d112dd6aec97bfd1923bb7d4337243c...368bfc0fe0628e10ebf9873b123253c2a8dbf844,1,80,13,93,8,2011-03-31 15:37:48,2011-03-31 15:37:48
368bfc0fe0628e10ebf9873b123253c2a8dbf844...de0c25bef485bab8c2d1e642947311596a9b5e87,1,4,5,9,3,2011-03-31 17:36:16,2011-03-31 17:36:16
ff06d411d2569a3464fee7dda0580ee60f834b70...64a0005a3b5a168a421efa1d8b253de234620229,1,101,73,174,19,2011-04-02 21:05:04,2011-04-02 21:05:04
64a0005a3b5a168a421efa1d8b253de234620229...94fff6ff625be9fbbb54db53d9acec63f0919370,1,1,2,3,1,2011-04-04 18:22:58,2011-04-04 18:22:58
94fff6ff625be9fbbb54db53d9acec63f0919370...d47c0ae4228a59fcf731f626d650bb55c4e34609,1,6,5,11,5,2011-04-06 02:40:12,2011-04-06 02:40:12
ff06d411d2569a3464fee7dda0580ee60f834b70...a507f719ab6f2836db0e1bd0c0b5231839c458eb,1,1,1,2,1,2011-03-31 19:28:23,2011-03-31 19:28:23
a507f719ab6f2836db0e1bd0c0b5231839c458eb...fcc112f4062cd58113b28bd6eca4ab2eb80ac11d,1,1,1,2,1,2011-03-31 19:28:33,2011-03-31 19:28:33
2c74ee46ee6c9a08fb42e105281f59c582a26e7d...83dc078055164ab766ab90cd9c239f44d9da88f1,1,1,1,2,1,2011-04-10 20:28:44,2011-04-10 20:28:44
c10a76ec71b49575dad22b26c8675cfa8b41d862...215c507f796db16a6e9230a2ecc27c57a1b85280,2,3,16,19,3,2011-04-10 21:08:18,2011-04-10 21:08:18
ee81d4da920ffeddff4e47ee09ca1a63b33768b4...ef0157d19138471b497b8575e56df428e0986a7c,1,1,1,2,1,2011-03-28 16:31:03,2011-03-28 16:10:16
ef0157d19138471b497b8575e56df428e0986a7c...2555a5a2322f78fc1cfc8a0f2b55580fc79d2f32,1,1,1,2,1,2011-03-28 17:10:12,2011-03-28 17:10:12
30cc7ae75cb9a65db70168340a7d3717ab8a0e9e...e5b16e3356358a17c54c647b129e44cb09076ec8,2,12,18,30,11,2011-10-06 01:41:32,2011-10-06 01:41:32
3e0fe5ea3b1dafe454039c7c12c4d5d5fa037c9f...23f7c883c93399c2eedbd8f3b7aa7194b16ac872,1,1,1,2,1,2011-10-04 15:09:12,2011-10-04 15:09:12
e1d6edf822f7f875f794849723b13bbf74dd3c83...c8be9461eed2cd01fb45ae504f92f80fe72bddde,1,15,15,30,15,2010-12-07 01:36:42,2010-12-07 01:36:42
c8be9461eed2cd01fb45ae504f92f80fe72bddde...e4900df8389c85350d1d82c827fab0d4b91989d6,2,77,57,134,56,2010-12-07 01:37:16,2010-12-07 01:37:16
e1d6edf822f7f875f794849723b13bbf74dd3c83...11e52bdaeae769dec384ca0eb286901122f35501,2,13,8,21,4,2010-12-03 07:19:39,2010-12-03 07:19:39
e1d6edf822f7f875f794849723b13bbf74dd3c83...238ac5a0aa25e7fb4fead7a56b92951817446127,1,13,6,19,4,2010-12-03 06:12:52,2010-12-03 06:12:52
e1d6edf822f7f875f794849723b13bbf74dd3c83...df0a3fb8531a452a7b3c6eb7cd7eb7cd59b32d88,2,9,5,14,5,2010-12-01 20:31:22,2010-12-01 20:31:22
521ae562daa8f95def8872a55a260e9bdbc40d8b...419b5e5e2a0d376e71c3f37bf9a3d96f3b4a67f2,2,18,3,21,5,2011-05-10 15:49:32,2011-05-10 15:49:32
419b5e5e2a0d376e71c3f37bf9a3d96f3b4a67f2...a5e407cafb9d398b5bf2f209ad0e8a42691bf391,2,9,4,13,5,2011-05-10 15:56:42,2011-05-10 15:56:42
a5e407cafb9d398b5bf2f209ad0e8a42691bf391...1ec003f10c0950847810e1def71fde8e7ac2734e,2,5,5,10,2,2011-05-10 16:43:34,2011-05-10 16:43:34
b8a9c2ba343f420ff6cce8100250d4e067fd300a...ebf2faca1ef6894cc1150e5d1708423d07f4b49e,1,1,1,2,1,2011-04-28 21:56:52,2011-04-28 21:56:52
fcc112f4062cd58113b28bd6eca4ab2eb80ac11d...2ed81b44be958b5f2b5569ab15f22bde262b4eb6,1,1,1,2,1,2011-04-04 15:41:30,2011-04-04 15:41:30
fcc112f4062cd58113b28bd6eca4ab2eb80ac11d...ab4e300919c5b3335e6d6c99ce9b1c314d116f19,1,165,103,268,18,2011-04-03 23:13:38,2011-03-07 03:47:40
ab4e300919c5b3335e6d6c99ce9b1c314d116f19...de79e8c7e0d1d2243447d59c70a9058eabf56bc3,4,126,111,237,39,2011-04-03 23:13:38,2011-03-08 17:07:05
de79e8c7e0d1d2243447d59c70a9058eabf56bc3...5eecb13fa3391870e904548f03d8a509117984f3,2,33,40,73,16,2011-04-03 23:13:38,2011-03-10 01:20:53
5eecb13fa3391870e904548f03d8a509117984f3...607210e01068224ac613558c0a314ad4a8fba247,1,13,11,24,2,2011-04-03 23:13:38,2011-03-10 23:34:15
607210e01068224ac613558c0a314ad4a8fba247...4baa213d881a71ffd8557bc587f81d0bc606d63c,2,34,10,44,7,2011-04-03 23:13:38,2011-03-11 19:51:57
4baa213d881a71ffd8557bc587f81d0bc606d63c...00abeaee17a0eed8422a15ff5d48f4011490953b,1,9,16,25,5,2011-04-03 23:13:38,2011-03-11 19:57:37
00abeaee17a0eed8422a15ff5d48f4011490953b...ebb8e8e300be5da2671f62e939551bd3c859e81e,2,7,6,13,4,2011-04-03 23:13:39,2011-03-11 20:59:34
ebb8e8e300be5da2671f62e939551bd3c859e81e...8cd30c62d813af68ccd91cc41adf43b8907f41cf,4,68,70,138,27,2011-04-03 23:13:39,2011-03-12 02:28:42
8cd30c62d813af68ccd91cc41adf43b8907f41cf...9f88fa9165e73b879d0c955fdf81fdd681d2d192,2,11,8,19,6,2011-04-03 23:13:39,2011-03-13 19:44:51
9f88fa9165e73b879d0c955fdf81fdd681d2d192...b85d2cd8a5c49487dc3ea7f6fad963efd9fd0f55,1,6,5,11,3,2011-04-03 23:13:39,2011-03-13 20:17:13
b85d2cd8a5c49487dc3ea7f6fad963efd9fd0f55...77c559c3cbe361a87de735a67812695685b613e6,1,0,2,2,1,2011-04-03 23:13:39,2011-03-13 20:23:21
77c559c3cbe361a87de735a67812695685b613e6...f578e0f99748ec5ae84d750f0922957e5fea25cb,1,2,2,4,2,2011-04-03 23:13:39,2011-03-13 20:29:33
f578e0f99748ec5ae84d750f0922957e5fea25cb...dbe3b7a9d052b7bf0c73ead1ecd43a40152416a0,2,44,9,53,7,2011-04-03 23:13:39,2011-03-14 01:27:45
dbe3b7a9d052b7bf0c73ead1ecd43a40152416a0...5ac6ca3fa52a4a27d6952c71a77420e3e4a5d88a,1,24,21,45,4,2011-04-03 23:13:39,2011-03-14 02:24:45
5ac6ca3fa52a4a27d6952c71a77420e3e4a5d88a...2580420b7e1137acff7ec9fb38c1698e231e1d68,1,1,1,2,1,2011-04-03 23:13:39,2011-03-16 02:47:20
2580420b7e1137acff7ec9fb38c1698e231e1d68...d28922bc03ea03dd7f02bbc4abc8061ea4c7305b,1,2,2,4,2,2011-04-03 23:13:39,2011-03-16 23:00:20
d28922bc03ea03dd7f02bbc4abc8061ea4c7305b...dfeeb872d611c7ff7270fceb7234dd0e04671eb8,1,10,8,18,6,2011-04-03 23:13:39,2011-03-18 02:59:05
dfeeb872d611c7ff7270fceb7234dd0e04671eb8...11cfdb23940b2c76e1104c82afc9552ac6f3dc19,1,4,4,8,4,2011-04-03 23:13:39,2011-03-24 04:42:00
11cfdb23940b2c76e1104c82afc9552ac6f3dc19...102053abd84124b1a69606565bd8da82bc5d30e9,3,8,4,12,4,2011-04-03 23:13:39,2011-03-25 04:35:50
102053abd84124b1a69606565bd8da82bc5d30e9...9e05a0a37fcc6fc4985a95370f91e1f792e2273b,3,69,56,125,18,2011-04-03 23:13:40,2011-03-25 05:46:29
9e05a0a37fcc6fc4985a95370f91e1f792e2273b...47c80c2050fbc15b84cb69edce309777e71b6387,2,6,3,9,5,2011-04-03 23:13:40,2011-03-25 06:07:15
47c80c2050fbc15b84cb69edce309777e71b6387...3892df207d7a4a3babf5017a309263cceff48b65,2,13,5,18,6,2011-04-03 23:13:40,2011-03-25 14:40:46
3892df207d7a4a3babf5017a309263cceff48b65...e0900a686d3c80054afd0ebe4c8908a8b5568444,2,12,9,21,8,2011-04-03 23:13:40,2011-03-26 01:13:25
e0900a686d3c80054afd0ebe4c8908a8b5568444...479b28fb6aa7ec5619e1d14c4b0578b9464d5f2b,1,36,32,68,9,2011-04-03 23:13:40,2011-03-26 02:55:11
479b28fb6aa7ec5619e1d14c4b0578b9464d5f2b...56014a1a0089be9d8d44c286ce66fc9d2066acd7,1,2,2,4,2,2011-04-03 23:13:40,2011-03-26 02:57:01
56014a1a0089be9d8d44c286ce66fc9d2066acd7...5caf7d837630df4ac8e8fb21c79582dc897903f5,1,7,5,12,4,2011-04-03 23:13:40,2011-03-26 03:03:02
5caf7d837630df4ac8e8fb21c79582dc897903f5...448111cbd432864d0ae03c70ae321e97de989e9b,1,1,2,3,1,2011-04-03 23:13:40,2011-03-26 03:10:59
448111cbd432864d0ae03c70ae321e97de989e9b...03da4c7ca719443d52104c7f47abffc2e312753d,1,3,2,5,2,2011-04-03 23:13:40,2011-03-26 03:36:07
03da4c7ca719443d52104c7f47abffc2e312753d...11c97bb06672a1203f39eb39ab373dcc56bd9465,1,21,23,44,5,2011-04-03 23:13:40,2011-03-26 04:15:25
11c97bb06672a1203f39eb39ab373dcc56bd9465...217a7abc43967cb860fc0dccee13b475de81b07d,1,2,2,4,2,2011-04-03 23:13:41,2011-03-26 04:18:02
217a7abc43967cb860fc0dccee13b475de81b07d...a4d44979c6ecb4be59f1fbb50a0e5eaae804a0d3,1,1,3,4,1,2011-04-03 23:13:41,2011-03-29 04:23:39
a4d44979c6ecb4be59f1fbb50a0e5eaae804a0d3...fa4373c11ba10e040a982a641c74f8ff96f312f3,1,5,2,7,2,2011-04-03 23:13:41,2011-03-30 01:49:37
fa4373c11ba10e040a982a641c74f8ff96f312f3...1e9b3ef3d87a0934dec969ed469cd3cc9c910ae8,1,2,2,4,2,2011-04-03 23:13:41,2011-03-30 21:13:15
1e9b3ef3d87a0934dec969ed469cd3cc9c910ae8...5fc2281fcc83783b86647a5a86380b9ac21e7f79,3,24,5,29,5,2011-04-03 23:13:41,2011-04-02 01:13:01
5fc2281fcc83783b86647a5a86380b9ac21e7f79...8cbf551a48cbc47eccba2050e95745f70166ae1d,3,10,16,26,5,2011-04-03 23:13:41,2011-04-02 01:38:54
8cbf551a48cbc47eccba2050e95745f70166ae1d...ff7576755864193b4c1a00464bf0919bbbe96e8b,1,7,16,23,9,2011-04-03 23:13:41,2011-04-02 18:23:33
ff7576755864193b4c1a00464bf0919bbbe96e8b...2a8a2b61488e7857b116bedc9eb75bd971772c2f,1,11,11,22,3,2011-04-03 23:13:41,2011-04-03 20:49:48
2a8a2b61488e7857b116bedc9eb75bd971772c2f...ad2b3bc9f908a8e529c4479c8c9baead23c2d827,2,24,16,40,14,2011-04-03 23:13:41,2011-04-03 22:18:32
ad2b3bc9f908a8e529c4479c8c9baead23c2d827...6f79bee3e3ea874f27389a7e691c1bd7541f2ef6,2,4,3,7,2,2011-04-03 23:13:41,2011-04-03 22:47:44
6f79bee3e3ea874f27389a7e691c1bd7541f2ef6...17afd80d485b4ca36145a40fd7ac8f81f7099f7c,2,5,5,10,3,2011-04-09 19:56:35,2011-04-09 19:56:35
17afd80d485b4ca36145a40fd7ac8f81f7099f7c...3a1b4661f5b8249ce7a741084824ec5445c75719,2,26,17,43,13,2011-04-09 21:25:06,2011-04-09 21:25:06
2555a5a2322f78fc1cfc8a0f2b55580fc79d2f32...3296116041ea0eb89e123c24cf092e34ccb3f380,2,13,3,16,3,2011-03-30 17:17:48,2011-03-30 17:17:48
3296116041ea0eb89e123c24cf092e34ccb3f380...926884bf1f071b6dd92f0611d905b2cbffa16a19,1,1,1,2,1,2011-03-30 17:26:20,2011-03-30 17:26:20
2555a5a2322f78fc1cfc8a0f2b55580fc79d2f32...f2ce87df8ef933dc3372b7d7ab8ea6e54dcd66b6,1,4,1,5,1,2011-03-30 16:54:32,2011-03-30 16:54:32
e5b16e3356358a17c54c647b129e44cb09076ec8...ce8d9c0ca59a8f03e119c80ed29c7dbc65efdd85,2,31,32,63,11,2011-10-06 21:17:51,2011-10-06 21:17:51
e5b16e3356358a17c54c647b129e44cb09076ec8...4fd70e7e02d2cb4da150bf4090a6476661c71d2d,1,36,26,62,24,2011-10-06 14:21:23,2011-10-06 14:12:05
4fd70e7e02d2cb4da150bf4090a6476661c71d2d...3999d39b8437f13193ef1098e36227ffaca18362,1,1,1,2,1,2011-10-06 20:36:15,2011-10-06 20:36:15
11b76147c2d6fb23bee94a2a902e401b5b8f9755...749d32a290d8d22a662ffc18db2fb035b401564d,2,5,2,7,5,2011-10-04 16:08:46,2011-10-04 16:08:46
749d32a290d8d22a662ffc18db2fb035b401564d...22f2e8b3dc18dede5f1ccb28cbdf8cb5bcde115f,2,16,1,17,2,2011-10-04 19:53:19,2011-10-04 19:53:19
e4900df8389c85350d1d82c827fab0d4b91989d6...7481a3645af63cef1406687190fd62bdfb1bf254,2,65,33,98,11,2010-12-12 08:20:31,2010-12-12 08:20:31
8943b427f67766fd8d9e8a95b471ff4077213be2...796d25cf07ad63e2008ff4b70db182d33a3533dd,1,1,1,2,1,2010-12-09 09:23:45,2010-12-09 09:23:45
8943b427f67766fd8d9e8a95b471ff4077213be2...cc9dbd06e5ffa62223e1f2e3dbbdcbbcb2bf5e11,2,6,6,12,5,2010-12-07 02:17:42,2010-12-07 02:17:42
1ec003f10c0950847810e1def71fde8e7ac2734e...c8374fafe5bbedbdfbe25329758514b005731057,1,1,1,2,1,2011-05-10 16:54:29,2011-05-10 16:54:29
1ec003f10c0950847810e1def71fde8e7ac2734e...d75c61a5bdf61e96a0632564192837472b44791c,1,1,1,2,1,2011-05-10 16:46:55,2011-05-10 16:46:55
e5f4ec846ceff3e97711e45e968f6cead5e9a674...ca367674c1f741fef01780ba09431392be8a0e49,2,17,1,18,2,2011-04-29 01:15:45,2011-04-29 01:14:12
ca367674c1f741fef01780ba09431392be8a0e49...bf678fd9d6209f77a37b9dd29e7ea621cf3bd3f7,3,8,8,16,8,2011-04-29 02:26:34,2011-04-29 02:24:40
2ed81b44be958b5f2b5569ab15f22bde262b4eb6...4b0c26f0af96da05ab1a0166268c2925a6e6e6ac,2,39,8,47,11,2011-04-05 22:55:07,2011-04-05 22:12:50
2ed81b44be958b5f2b5569ab15f22bde262b4eb6...23a411b6bcbb96edbbfe53e11ec1671dccaa92b6,2,37,9,46,12,2011-04-05 19:55:40,2011-04-05 19:55:40
23a411b6bcbb96edbbfe53e11ec1671dccaa92b6...b1b2e83394ef6ebcbaa5167d95e827f86655b74c,1,4,1,5,2,2011-04-05 20:20:55,2011-04-05 20:20:55
b1b2e83394ef6ebcbaa5167d95e827f86655b74c...92a4d59c3221ada339177ca860570893766a6429,1,0,4,4,1,2011-04-05 20:32:42,2011-04-05 20:32:42
2ed81b44be958b5f2b5569ab15f22bde262b4eb6...a7e7dbd978b97c55a29b364fd277c4ade1ec22b6,2,11,9,20,3,2011-04-05 08:43:14,2011-04-05 08:43:14
a7e7dbd978b97c55a29b364fd277c4ade1ec22b6...3609bed9e7aa4c0aea4ebfc446ad15bc216aed0f,1,1,2,3,2,2011-04-05 14:20:58,2011-04-05 14:20:58
2ed81b44be958b5f2b5569ab15f22bde262b4eb6...f7ccec1b70a42de21b55dbb7b3d65da5628ade9e,2,13,1,14,3,2011-04-04 19:46:37,2011-01-31 17:57:23
f7ccec1b70a42de21b55dbb7b3d65da5628ade9e...9dc63971877d583dac5bb5c8b0c3d73d1127f144,1,2,2,4,2,2011-04-04 19:46:37,2011-02-01 11:02:02
9dc63971877d583dac5bb5c8b0c3d73d1127f144...933ea8c5fa44f93085a7b720ac50c473a394251e,1,1,1,2,1,2011-04-04 19:46:37,2011-02-01 15:00:19
933ea8c5fa44f93085a7b720ac50c473a394251e...6de29b24b197f4fbbf3e48369343d457e7a80523,1,3,3,6,1,2011-04-04 19:46:37,2011-02-01 17:26:41
6de29b24b197f4fbbf3e48369343d457e7a80523...03e6f7235bd671330f807642fefd297c42413c45,1,1,1,2,1,2011-04-04 19:46:37,2011-02-01 18:57:14
03e6f7235bd671330f807642fefd297c42413c45...15e34d1f07d0c687d040af22dbc66f3978715217,1,11,5,16,2,2011-04-04 19:46:37,2011-02-02 09:26:04
15e34d1f07d0c687d040af22dbc66f3978715217...c95ab2a39c178eee47ce7b1cbdffa812d7914bb6,1,7,8,15,4,2011-04-04 19:46:37,2011-02-02 10:25:09
c95ab2a39c178eee47ce7b1cbdffa812d7914bb6...5b0369366a83d7339f925bfef3a277d7287c9bd2,1,6,6,12,2,2011-04-04 19:47:19,2011-03-11 10:33:15
5b0369366a83d7339f925bfef3a277d7287c9bd2...fe3203bb5bdc0049467214e7f0979a3487d5681b,2,13,17,30,5,2011-04-04 23:25:12,2011-04-04 23:25:12
fe3203bb5bdc0049467214e7f0979a3487d5681b...9db18ddd84adf63166f411a4f2c776b51d1840e0,1,3,1,4,1,2011-04-05 20:28:25,2011-04-05 20:28:25
9db18ddd84adf63166f411a4f2c776b51d1840e0...791402b4536b8c5cbfeaf27d0a3c639cdb9fd192,2,6,4,10,4,2011-04-10 21:17:34,2011-04-10 21:17:34
2ed81b44be958b5f2b5569ab15f22bde262b4eb6...123dd72e808800d670769f9bca75c6f2c866326b,2,30,1,31,4,2011-04-04 18:21:15,2011-04-04 18:21:15
123dd72e808800d670769f9bca75c6f2c866326b...44a3b5839e6db9e3735b3d2d3035c6f79b3bcbe8,2,37,25,62,9,2011-04-04 23:48:24,2011-04-04 23:48:24
3a1b4661f5b8249ce7a741084824ec5445c75719...da89d8768cb53daac59f17a8acd8e6323a4d3be6,1,0,4,4,1,2011-04-10 19:40:49,2011-04-10 19:40:49
cec0d0d421063924cf0326db380b0d5a08675968...e828d18caa31822a27f4365b123405394ef4577d,1,4,4,8,3,2011-10-07 15:45:42,2011-10-07 15:45:42
cec0d0d421063924cf0326db380b0d5a08675968...1ba0f9c3ed7d7d8ecf245a5fc7cdf442652927f8,2,23,4,27,4,2011-10-07 15:16:38,2011-10-07 15:16:38
d2fea6123f6f8358c8771a48e674922ceddf202b...c42360b5beb4ad1a3ddca42da18be8a970d1097d,1,2,2,4,2,2011-05-10 16:57:55,2011-05-10 16:57:55
c42360b5beb4ad1a3ddca42da18be8a970d1097d...2812a87da7e9f9472ade4420ea9394806349659e,1,1,1,2,1,2011-05-10 17:37:05,2011-05-10 17:37:05
2812a87da7e9f9472ade4420ea9394806349659e...f9cccd05b66d7ae7a5e4010220a491e91201c35e,1,1,1,2,1,2011-05-10 17:50:21,2011-05-10 17:50:21
f9cccd05b66d7ae7a5e4010220a491e91201c35e...344af56868642b551de944a534493e6a72dd4776,1,1,1,2,1,2011-05-10 17:50:35,2011-05-10 17:50:35
344af56868642b551de944a534493e6a72dd4776...68d980bbb45f98fa582d598590c5e0e76f2bdf0c,1,1,1,2,1,2011-05-10 17:50:49,2011-05-10 17:50:49
68d980bbb45f98fa582d598590c5e0e76f2bdf0c...3a1c27b50825c7792a57a2f204ca86408de2cc14,1,1,1,2,1,2011-05-10 17:58:50,2011-05-10 17:58:50
3a1c27b50825c7792a57a2f204ca86408de2cc14...391398cf23603201f63c6e815a287e0cb107988c,2,22,3,25,5,2011-05-11 12:13:07,2011-05-11 12:12:19
391398cf23603201f63c6e815a287e0cb107988c...f794f48f02232811c55663fcb511fc9d8be26824,3,12,5,17,4,2011-05-11 15:43:37,2011-05-11 15:43:37
f794f48f02232811c55663fcb511fc9d8be26824...01c5b7f7f564fe63396fd2f3e207d4f01a59f605,1,1,1,2,1,2011-05-11 16:02:41,2011-05-11 16:02:41
01c5b7f7f564fe63396fd2f3e207d4f01a59f605...9fd37b2c8a512f5951c2eb7cd6cad34d9b12c02e,1,1,1,2,1,2011-05-12 19:04:36,2011-05-12 19:04:36
9fd37b2c8a512f5951c2eb7cd6cad34d9b12c02e...b60c8560cedacce6c82504f15e9bb54c2b3af59f,1,1,1,2,1,2011-05-12 19:04:51,2011-05-12 19:04:51
b60c8560cedacce6c82504f15e9bb54c2b3af59f...ceba855c010c792aad8fc15edc06b86285f71142,2,45,10,55,6,2011-05-13 15:43:53,2011-05-13 15:43:32
ceba855c010c792aad8fc15edc06b86285f71142...0f81cf89916262a3b5a0f85a33638edea562ca1f,1,37,0,37,1,2011-05-13 15:50:57,2011-05-13 15:50:57
0f81cf89916262a3b5a0f85a33638edea562ca1f...3486365062cdc7e8598cea238e67aafa33af7dce,2,28,4,32,4,2011-05-13 15:56:55,2011-05-11 18:31:42
3486365062cdc7e8598cea238e67aafa33af7dce...cbbd7d28e1088e76a9c89bfb30ba9af8f1fce759,2,54,2,56,5,2011-05-13 16:09:49,2011-05-13 16:09:49
cbbd7d28e1088e76a9c89bfb30ba9af8f1fce759...a5b7c0fa3316616d86bcb584375b02e33b0bac08,2,20,20,40,19,2011-05-13 16:14:31,2011-05-13 16:14:31
e2bace8fa129c2bf3fe5bd382a4b05d96e8cf245...24a8ffb3eae56345231931184891f25f6ce017cf,2,12,3,15,6,2011-05-01 21:09:50,2011-05-01 21:09:50
24a8ffb3eae56345231931184891f25f6ce017cf...f1392d82089323ec9ef97b33909b960cc16c25b6,1,4,1,5,2,2011-05-02 15:57:01,2011-05-02 15:57:01
f1392d82089323ec9ef97b33909b960cc16c25b6...86aa764f0b7b659fbd8eec9333d22c3a79bdfcd5,2,15,3,18,4,2011-05-02 17:14:13,2011-05-02 17:14:13
86aa764f0b7b659fbd8eec9333d22c3a79bdfcd5...6c449fd5df3e0ec50e893d055da9aea486e7d71c,2,8,2,10,3,2011-05-02 17:25:53,2011-05-02 17:25:53
6c449fd5df3e0ec50e893d055da9aea486e7d71c...ca338dc749971ee2c16312027280f76b64b90838,1,1,1,2,1,2011-05-02 17:31:23,2011-05-02 17:31:23
ca338dc749971ee2c16312027280f76b64b90838...eae7c4111ca0eb41f645f4b8708a76c9865b0206,1,1,1,2,1,2011-05-02 17:50:00,2011-05-02 17:50:00
eae7c4111ca0eb41f645f4b8708a76c9865b0206...53f275034a8e7f6041ed14221ef89a1c1d8534d9,1,1,1,2,1,2011-05-02 17:50:33,2011-05-02 17:50:33
53f275034a8e7f6041ed14221ef89a1c1d8534d9...c0d993903b789ec0cba040409a19d01bd65ad7e7,1,1,1,2,1,2011-05-02 20:25:20,2011-05-02 20:25:20
c0d993903b789ec0cba040409a19d01bd65ad7e7...f4b5d3fc51cfb2b62f182e88b85386b4456c080d,3,222,90,312,43,2011-05-02 20:25:36,2011-05-02 20:25:36
f4b5d3fc51cfb2b62f182e88b85386b4456c080d...f8a112f08e9349432cfa6bfc2da5d4275aceb11a,1,1,1,2,1,2011-05-02 20:32:02,2011-05-02 20:32:02
f8a112f08e9349432cfa6bfc2da5d4275aceb11a...89fd9dffad00c8a119c84de9a2453476643327a1,1,1,1,2,1,2011-05-02 20:36:16,2011-05-02 20:36:16
89fd9dffad00c8a119c84de9a2453476643327a1...3dbd7b54de95aef238277dc52fe9112ff896f66c,1,264,0,264,1,2011-05-02 20:56:39,2011-05-02 20:56:39
3dbd7b54de95aef238277dc52fe9112ff896f66c...ea24cd106b86dae2411e5b87c367f6ff5163aee8,4,13,268,281,7,2011-05-02 21:53:55,2011-05-02 21:53:55
ea24cd106b86dae2411e5b87c367f6ff5163aee8...6d2fd57f452398123f8edefa25eef8045d1b586e,1,1,1,2,1,2011-05-02 22:14:12,2011-05-02 22:14:12
6d2fd57f452398123f8edefa25eef8045d1b586e...4ac2fdda2c26e9b64502b9ef50748427bed2f3c6,2,4,2,6,3,2011-05-03 18:48:36,2011-05-03 18:48:36
4ac2fdda2c26e9b64502b9ef50748427bed2f3c6...3cdffce19f8ce7a52b91f387872e3de804044f02,1,2,2,4,1,2011-05-03 19:01:29,2011-05-03 19:01:29
3cdffce19f8ce7a52b91f387872e3de804044f02...bfad45fe4510db78a38170752ccc9c9efe5f38b6,2,16,5,21,5,2011-05-03 19:02:26,2011-05-03 19:02:26
bfad45fe4510db78a38170752ccc9c9efe5f38b6...a9d9f8c5422f171d9c451385fcfd7ed1661ec514,2,43,11,54,15,2011-05-04 01:44:42,2011-05-04 01:44:42
a9d9f8c5422f171d9c451385fcfd7ed1661ec514...97144424ccb79e251d6df354384fa3e4d5362949,2,95,66,161,13,2011-05-04 04:31:01,2011-05-04 04:31:01
97144424ccb79e251d6df354384fa3e4d5362949...480b88ca37fb3aff4ba043298a8fb419905d3f21,2,12,1,13,3,2011-05-04 15:29:38,2011-05-04 15:29:38
480b88ca37fb3aff4ba043298a8fb419905d3f21...3ed4b22073767c17c099351637514f5928c0fd68,1,1,0,1,1,2011-05-04 15:40:46,2011-05-04 15:40:46
3ed4b22073767c17c099351637514f5928c0fd68...5195335cf4df62c06488807ae857f64c2d549253,2,8,3,11,5,2011-05-04 19:53:00,2011-05-04 19:53:00
5195335cf4df62c06488807ae857f64c2d549253...5097e6d1c672ef5fd3fcc0022ce84519233189cc,1,47,39,86,10,2011-05-05 16:17:08,2011-05-05 16:17:08
5097e6d1c672ef5fd3fcc0022ce84519233189cc...cccf9ad91d8b6626e1e20bd267c9cd0b6223f15c,2,8,3,11,4,2011-05-05 16:52:04,2011-05-05 16:52:04
cccf9ad91d8b6626e1e20bd267c9cd0b6223f15c...f30cd4155effded691e62d9700912b2a2771ac63,1,1,1,2,1,2011-05-05 18:37:59,2011-05-05 18:37:59
f30cd4155effded691e62d9700912b2a2771ac63...a257e07ae48d6af98fda02669e15d96bf0b21bd3,1,1,1,2,1,2011-05-06 14:53:05,2011-05-06 14:53:05
a257e07ae48d6af98fda02669e15d96bf0b21bd3...f7f8450041df7c250f04b03cbbcbd2d01025f379,1,2,1,3,1,2011-05-06 16:10:16,2011-05-06 16:10:16
f7f8450041df7c250f04b03cbbcbd2d01025f379...c72b0f3256672424a193040509ed63c755c805a2,2,5,3,8,3,2011-05-06 17:49:20,2011-05-06 17:49:20
c72b0f3256672424a193040509ed63c755c805a2...c864455ccfad13895d2af6ba287f265ee64bd348,1,1,1,2,1,2011-05-06 18:54:47,2011-05-06 18:54:47
c864455ccfad13895d2af6ba287f265ee64bd348...09c0cf995b84e0cff6d86c9f63bdad2b0440466a,1,2,1,3,1,2011-05-07 15:48:42,2011-05-07 15:48:42
09c0cf995b84e0cff6d86c9f63bdad2b0440466a...c08556327032daa21493f2b3a77f2138352fadf8,2,18,11,29,9,2011-05-07 18:49:04,2011-05-07 18:49:04
c08556327032daa21493f2b3a77f2138352fadf8...31268449b9255b21fad4bafd7da13c910a00af37,2,32,5,37,6,2011-05-07 23:18:52,2011-05-07 23:18:52
31268449b9255b21fad4bafd7da13c910a00af37...3d1c27d52ec667cea5735366a41f65344ab17a5e,2,18,7,25,12,2011-05-07 23:28:07,2011-05-03 23:07:24
3d1c27d52ec667cea5735366a41f65344ab17a5e...8bb6e95b66413c484006288691a82c44ba50554e,3,36,35,71,19,2011-05-08 00:46:38,2011-05-08 00:46:38
8bb6e95b66413c484006288691a82c44ba50554e...90f37aaf7aa7c6da96ab15488b63b2eb45a2e799,2,14,8,22,6,2011-05-08 01:26:02,2011-05-08 01:26:02
90f37aaf7aa7c6da96ab15488b63b2eb45a2e799...18b1cf2942cc082c1c97a2ac9bc33ad77f42d775,2,3,4,7,3,2011-05-08 02:01:10,2011-05-08 02:01:10
18b1cf2942cc082c1c97a2ac9bc33ad77f42d775...efd0fce7a1ae9bc62ef2b1aa51d7adc224da1ec0,2,36,2,38,4,2011-05-09 07:48:23,2011-05-09 07:48:23
efd0fce7a1ae9bc62ef2b1aa51d7adc224da1ec0...8c13cfa805c0576a2f02f33beb9d15d73afd2d41,2,11,3,14,5,2011-05-09 08:01:20,2011-05-09 08:01:20
8c13cfa805c0576a2f02f33beb9d15d73afd2d41...4526c8b0a05ea16397a0640875bfbb54645a9482,2,55,28,83,21,2011-05-10 04:28:02,2011-05-10 04:27:52
4526c8b0a05ea16397a0640875bfbb54645a9482...38de389a8e675c0c2d1172dd23339325ae82539a,5,85,33,118,5,2011-05-10 10:24:36,2011-05-10 10:23:53
38de389a8e675c0c2d1172dd23339325ae82539a...304dd618b7aa17158446bedd80af330375d8d4d4,1,1,1,2,1,2011-05-10 15:20:22,2011-05-10 15:20:22
e2bace8fa129c2bf3fe5bd382a4b05d96e8cf245...0c2d1aee5421b650159116b6bdcb74a4fe96f9ad,2,27,5,32,5,2011-04-30 14:42:36,2011-04-30 14:42:36
c51a9706046de19d051b57771f67e5bf2bcd937f...307b1a3d77ba74388b38e8c9bb9b506bf1b21245,1,0,6,6,1,2011-10-11 01:51:15,2011-10-11 01:51:15
307b1a3d77ba74388b38e8c9bb9b506bf1b21245...511c9fe763bac171bb6ac3ac0a77c425da8b3112,1,4,13,17,6,2011-10-11 03:14:08,2011-10-11 03:14:08
511c9fe763bac171bb6ac3ac0a77c425da8b3112...d29182e8d00b08def0f37fe7e77d9836e39b83a8,2,18,10,28,10,2011-10-12 00:23:56,2011-10-12 00:23:56
d29182e8d00b08def0f37fe7e77d9836e39b83a8...6afc2c074bec5c19063c8f8ebca6bfb53c7d4cef,2,14,3,17,4,2011-10-12 00:31:45,2011-10-12 00:30:07
6afc2c074bec5c19063c8f8ebca6bfb53c7d4cef...83c08ffa1ffa778e41d728ed7fa49044dd7135f9,5,45,5,50,5,2011-10-12 01:04:22,2011-10-12 01:04:22
83c08ffa1ffa778e41d728ed7fa49044dd7135f9...6c4ca13d693663cdd124d4d29cb12897a6debc5e,2,9,4,13,4,2011-10-12 01:21:59,2011-10-12 01:21:59
6c4ca13d693663cdd124d4d29cb12897a6debc5e...a18645c6f8f5d8d84c4d47c7137683ac7b4098cc,2,3,3,6,2,2011-10-12 02:37:52,2011-10-12 02:37:52
a18645c6f8f5d8d84c4d47c7137683ac7b4098cc...92b06d302cc8e94d52e0c60c9167ec17606984f3,1,8,9,17,1,2011-10-12 02:55:10,2011-10-12 02:55:10
92b06d302cc8e94d52e0c60c9167ec17606984f3...3ad0ba62f03ff3d7aec7d3dfb25492cdf33350a7,2,14,6,20,7,2011-10-12 04:06:54,2011-10-12 04:06:30
3ad0ba62f03ff3d7aec7d3dfb25492cdf33350a7...8723f3b9e1db5d4fdcd50624441fe3536d1ae2f2,4,90,41,131,13,2011-10-13 15:11:41,2011-10-13 15:11:41
8723f3b9e1db5d4fdcd50624441fe3536d1ae2f2...7bef99e94d0fa6a9885403760e30a59ef32e96a4,1,1,1,2,1,2011-10-13 16:07:54,2011-10-13 16:07:54
7bef99e94d0fa6a9885403760e30a59ef32e96a4...0a3cab8d4916045da51d843bdb6385c110ab3163,2,65,36,101,15,2011-10-13 20:30:40,2011-10-13 20:30:40
0a3cab8d4916045da51d843bdb6385c110ab3163...787ef720abc10ee8d3b29c4b83d1bfbc9ac37ad8,1,1,1,2,1,2011-10-14 01:12:55,2011-10-14 01:12:55
787ef720abc10ee8d3b29c4b83d1bfbc9ac37ad8...ae6d0024c8b1e991d020fef9e8d4456818f99813,1,1,1,2,1,2011-10-14 01:13:28,2011-10-14 01:13:28
ae6d0024c8b1e991d020fef9e8d4456818f99813...f2c1d2e016018ba14cd3f1612f9a1803d5e1709e,2,27,19,46,16,2011-10-17 20:45:37,2011-10-17 20:45:27
f2c1d2e016018ba14cd3f1612f9a1803d5e1709e...c51b29477e2884fc28cfe4de5b64308177678262,3,39,18,57,10,2011-10-22 20:03:57,2011-10-22 20:03:57
c51b29477e2884fc28cfe4de5b64308177678262...e1a5d3ebfbf963f373d8c6aa2fbec36bacc200be,1,1,1,2,1,2011-10-22 20:06:57,2011-10-22 20:06:57
e1a5d3ebfbf963f373d8c6aa2fbec36bacc200be...e502012c0f8e7604eaabe4065ba769af04eec180,2,16,3,19,5,2011-10-22 20:08:14,2011-10-22 20:08:14
e502012c0f8e7604eaabe4065ba769af04eec180...a6bec46170980f0559a9d6c2471a40cb2189a5a1,1,1,1,2,1,2011-10-22 20:14:47,2011-10-22 20:14:47
a6bec46170980f0559a9d6c2471a40cb2189a5a1...516f3cd7b5fd0e374b01843b5f78240feb03d959,1,1,1,2,1,2011-10-23 19:31:50,2011-10-23 19:31:50
516f3cd7b5fd0e374b01843b5f78240feb03d959...f3a4d261ecd0e858515f6e3fa8f5ff59078ec895,3,32,15,47,12,2011-10-23 20:08:10,2011-10-23 20:07:07
ec829431feed29b393b1c22ca97e8af49f47e228...6f676e692d48b4f979ba1dfc5d10f3f16954b381,2,8,2,10,3,2011-05-13 17:33:43,2011-05-12 23:42:53
6f676e692d48b4f979ba1dfc5d10f3f16954b381...bc82ff0ff9faba5e7e8c3e40f1351fb5e3fc1a41,2,7,2,9,3,2011-05-13 17:39:38,2011-05-13 17:39:38
bc82ff0ff9faba5e7e8c3e40f1351fb5e3fc1a41...cf702496ee28830f3488ed3f1c3940cfbb2dfa8f,1,1,2,3,1,2011-05-13 17:47:44,2011-05-13 17:47:44
cf702496ee28830f3488ed3f1c3940cfbb2dfa8f...6171e0a923c4775d0b5e560900f397c33b6341d9,2,7,2,9,3,2011-05-14 16:07:40,2011-05-14 16:07:40
6171e0a923c4775d0b5e560900f397c33b6341d9...a5cf257a8a240f96f1ec255599fa1d1190f51ff5,2,6,3,9,3,2011-05-16 14:17:50,2011-05-16 14:17:50
a5cf257a8a240f96f1ec255599fa1d1190f51ff5...c17f589ec99e8309e813a4081eed47f39a0c6120,2,21,1,22,2,2011-05-16 14:38:36,2011-05-16 14:38:36
c17f589ec99e8309e813a4081eed47f39a0c6120...7d3ba9f89e8077dff96e4cd9784fda20625c38d6,2,7,5,12,4,2011-05-18 15:05:20,2011-05-18 15:05:20
7d3ba9f89e8077dff96e4cd9784fda20625c38d6...ba90af0dc5b279d785e49ff5c051073d2178d372,2,5,2,7,3,2011-05-18 15:29:25,2011-05-18 15:29:25
ba90af0dc5b279d785e49ff5c051073d2178d372...25118e22a204c5396f1265feb5cbfd71f35033e3,2,7,4,11,5,2011-05-18 15:46:22,2011-05-18 15:46:22
25118e22a204c5396f1265feb5cbfd71f35033e3...a1545b5079f4a25fb1dbe7cdfce76fff7a73afe3,1,0,1,1,1,2011-05-18 15:59:21,2011-05-18 15:59:21
a1545b5079f4a25fb1dbe7cdfce76fff7a73afe3...f82b9dddc498efdfbcd0978f8ba3e1da3b48eff3,2,31,1,32,2,2011-05-20 15:03:33,2011-05-20 15:03:33
f82b9dddc498efdfbcd0978f8ba3e1da3b48eff3...b43910a496ccb2b44dcc11b64667e21521aa4994,1,8,6,14,5,2011-05-20 15:22:52,2011-05-20 15:22:52
f3a4d261ecd0e858515f6e3fa8f5ff59078ec895...734700764549b33f19a1219d742e777cc0fc21b4,1,6,6,12,1,2011-10-24 13:27:16,2011-10-24 13:27:16
b43910a496ccb2b44dcc11b64667e21521aa4994...9a96af1d59cc6a10b89b6f2489b04871a9c1c7fa,2,14,7,21,4,2011-06-15 04:38:36,2011-06-15 04:38:36
b43910a496ccb2b44dcc11b64667e21521aa4994...e5457a5a1faa642b0af13e87ee3f76f2ef704b30,2,5,3,8,2,2011-05-25 17:58:05,2011-05-25 17:58:05
e5457a5a1faa642b0af13e87ee3f76f2ef704b30...a5396bde7008470d22d562303ac6fbfbe8ebdaec,1,1,1,2,1,2011-05-25 18:01:33,2011-05-25 18:01:33
a5396bde7008470d22d562303ac6fbfbe8ebdaec...657b197c193335899703fc158b153e2475cca539,1,3,0,3,1,2011-05-25 18:30:46,2011-05-25 18:30:46
657b197c193335899703fc158b153e2475cca539...b8fc9d14a134f91f17bf96194da86d38231da005,1,1,2,3,2,2011-05-25 19:08:37,2011-05-25 19:08:37
b8fc9d14a134f91f17bf96194da86d38231da005...408c98fb4b8c1b6957cfe620711f9ea7645293ba,3,29,10,39,6,2011-05-25 19:10:49,2011-05-25 19:10:49
408c98fb4b8c1b6957cfe620711f9ea7645293ba...287156197f296fcbcb8be11aa8ce6f1b819aeda6,1,2,0,2,1,2011-05-25 19:18:13,2011-05-25 19:18:13
287156197f296fcbcb8be11aa8ce6f1b819aeda6...1d1cb582c0f744afaa51a63d374b9ffe0f58d1db,1,1,1,2,1,2011-05-25 23:35:52,2011-05-25 23:35:52
1d1cb582c0f744afaa51a63d374b9ffe0f58d1db...edb2286544270dc53550180e06668e61c231fb5d,3,37,9,46,8,2011-05-25 23:49:50,2011-05-25 23:49:50
edb2286544270dc53550180e06668e61c231fb5d...bdce86dc2edb43267ec5c4b7aab6d1932f294d6f,2,6,11,17,3,2011-05-25 23:59:29,2011-05-25 23:59:29
bdce86dc2edb43267ec5c4b7aab6d1932f294d6f...9d4033d629fbfd1352e4ee5f20d0d320a61b80f1,1,34,0,34,1,2011-05-26 00:48:59,2011-05-26 00:48:59
9d4033d629fbfd1352e4ee5f20d0d320a61b80f1...1d202c6afc03c98dc656bf6bbde317fb0d050574,1,19,20,39,2,2011-05-26 20:51:41,2011-05-26 20:51:41
1d202c6afc03c98dc656bf6bbde317fb0d050574...71d2e657d00e7e6f283503eaac4d06e7e5d77ff9,1,1,1,2,1,2011-06-07 00:15:16,2011-06-07 00:15:16
71d2e657d00e7e6f283503eaac4d06e7e5d77ff9...c3c001cf5b0970457cc9d7492cb66bdc9a901a1e,1,1,2,3,1,2011-06-07 00:16:14,2011-06-07 00:16:14
c3c001cf5b0970457cc9d7492cb66bdc9a901a1e...07420566452622f37b01e69bbbdcbeeb5317e065,2,21,1,22,2,2011-06-07 00:18:36,2011-06-07 00:18:36
07420566452622f37b01e69bbbdcbeeb5317e065...80ad14bd14467c547c2867f2677ca581aa29bf33,2,70,21,91,11,2011-06-07 03:13:37,2011-06-07 03:13:37
80ad14bd14467c547c2867f2677ca581aa29bf33...75203de7435b7f32c69da1dde88aa6708bf6bb7d,3,50,72,122,16,2011-06-07 03:35:16,2011-06-07 03:35:16
75203de7435b7f32c69da1dde88aa6708bf6bb7d...6490c10c751af6ad8cd119526db227939cdcffe9,1,1,1,2,1,2011-06-07 03:54:17,2011-06-07 03:54:17
6490c10c751af6ad8cd119526db227939cdcffe9...d66c3b6d84c2af1132727c5be335bc2860dcbda9,1,1,1,2,1,2011-06-07 04:04:17,2011-06-07 04:04:17
d66c3b6d84c2af1132727c5be335bc2860dcbda9...0a80be67f4fe968d99777564a02aeddbde1fbf35,1,3,2,5,1,2011-06-08 00:55:17,2011-06-07 00:13:50
0a80be67f4fe968d99777564a02aeddbde1fbf35...db437be6e31c924aade13bb719f9facc122b3d9c,4,39,27,66,16,2011-06-08 01:00:44,2011-06-08 00:54:11
db437be6e31c924aade13bb719f9facc122b3d9c...39a2f29c29fdb296bb178b3c55d805ea0dc2f0ce,1,2,3,5,1,2011-06-08 14:55:52,2011-06-08 14:55:52
39a2f29c29fdb296bb178b3c55d805ea0dc2f0ce...641ad802111d2dc16ccf4b3721784a6addaf20df,3,22,18,40,10,2011-06-13 14:02:13,2011-06-13 14:02:13
641ad802111d2dc16ccf4b3721784a6addaf20df...6926247bf441deaa0441872849bb3786c257a4cf,2,48,18,66,10,2011-06-14 19:38:46,2011-06-14 19:38:46
6926247bf441deaa0441872849bb3786c257a4cf...13ceb0f56b380b395ed5a26b468bf2bf00d88216,2,1,1,2,2,2011-06-14 19:51:03,2011-06-14 19:51:03
13ceb0f56b380b395ed5a26b468bf2bf00d88216...5eef5917fdb399ace2698154c4cd7bbd24f13182,2,15,4,19,5,2011-06-14 19:59:22,2011-06-14 19:59:22
5eef5917fdb399ace2698154c4cd7bbd24f13182...8a532d15757f8c3ba491ae14d024e353de6b4c7f,1,1,1,2,1,2011-06-14 20:01:50,2011-06-14 20:01:50
8a532d15757f8c3ba491ae14d024e353de6b4c7f...d443e533aa83e89e6a1b02280dfc77f741cb4db6,3,4,4,8,3,2011-06-14 21:54:23,2011-06-14 21:54:23
d443e533aa83e89e6a1b02280dfc77f741cb4db6...138d5b7b811845950279f5ee5391339d7d31e360,1,1,1,2,1,2011-06-14 21:55:14,2011-06-14 21:55:14
138d5b7b811845950279f5ee5391339d7d31e360...d269e426e0844fa025e8ca5510c56860a9cde784,1,3,3,6,1,2011-06-14 22:05:27,2011-06-14 22:05:27
d269e426e0844fa025e8ca5510c56860a9cde784...d59b0f3e27827d189b8b2595142ec6bbc3941dd9,1,1,1,2,1,2011-06-14 22:06:28,2011-06-14 22:06:28
c4cc343c9cc47dbb1aa3501a9098e29aac74ad67...9fabe2028f05bc409f937ff7cd71caaacd26f945,2,17,1,18,2,2011-10-24 15:18:13,2011-10-21 14:56:16
9fabe2028f05bc409f937ff7cd71caaacd26f945...d28ab68699f57238b3479c5c0b9dae23968bb7b7,2,8,14,22,8,2011-10-24 15:18:14,2011-10-21 15:11:36
d28ab68699f57238b3479c5c0b9dae23968bb7b7...470cc071676394b46fbcfab1934340318d9ac751,1,2,2,4,1,2011-10-24 15:18:15,2011-10-21 15:16:27
470cc071676394b46fbcfab1934340318d9ac751...b208042f520b2ee768a93323d6bdc65eabfb0d65,1,30,37,67,7,2011-10-24 15:18:17,2011-10-24 01:13:59
b208042f520b2ee768a93323d6bdc65eabfb0d65...4ac6f8d9d322c7e468ed0d58e402abe7bdca354d,2,25,11,36,4,2011-10-24 15:18:18,2011-10-24 02:25:13
4ac6f8d9d322c7e468ed0d58e402abe7bdca354d...560c33b395ec809cc296c97cab41244949ec863c,1,1,2,3,2,2011-10-24 15:18:19,2011-10-24 03:03:00
560c33b395ec809cc296c97cab41244949ec863c...84d2307e0e20e9245523731a4450314cc0de6a95,2,26,22,48,11,2011-10-24 15:18:20,2011-10-24 15:17:24
84d2307e0e20e9245523731a4450314cc0de6a95...09c089aac9236e9e1866d8daad2e3b61a57f7d4c,1,1,1,2,1,2011-10-24 15:33:09,2011-10-24 15:33:09
09c089aac9236e9e1866d8daad2e3b61a57f7d4c...ee3eb6cabf1383efe479e090fe6ad8ed2e5a09a3,2,9,1,10,2,2011-10-24 21:26:43,2011-10-24 21:26:43
ee3eb6cabf1383efe479e090fe6ad8ed2e5a09a3...746074f0f74b0c0916fb2db2b6370c324822f31a,2,12,24,36,11,2011-10-24 22:05:53,2011-10-24 22:05:53
746074f0f74b0c0916fb2db2b6370c324822f31a...8e64b937eae1cadcfc088cc5ab6e2ef278435a5f,1,1,1,2,1,2011-10-24 22:18:17,2011-10-24 22:18:17
8e64b937eae1cadcfc088cc5ab6e2ef278435a5f...92f1fff4107e0de28bad750e762d425334cebf1a,1,1,1,2,1,2011-10-24 22:18:56,2011-10-24 22:18:56
92f1fff4107e0de28bad750e762d425334cebf1a...fc13f5b6cebc25e7cdb7bc72c4a7d3298e2c696a,1,1,1,2,1,2011-10-25 17:43:27,2011-10-25 17:43:27
3cfb134ab41d204a71977c0b4c73640f250c7112...fd4ee2a39752cc40e35fbcb1bfd48634ffe4bfd4,2,75,15,90,6,2011-08-04 22:16:15,2011-08-04 19:47:53
fd4ee2a39752cc40e35fbcb1bfd48634ffe4bfd4...8c2cb49917fc1082abac0a26298b992dcd6a5b6e,2,40,46,86,23,2011-08-04 22:16:15,2011-08-04 20:34:59
8c2cb49917fc1082abac0a26298b992dcd6a5b6e...700c16b0859a8c982869d5501934bed9e51d3662,1,0,1,1,1,2011-08-04 22:16:15,2011-08-04 22:14:35
700c16b0859a8c982869d5501934bed9e51d3662...5c4a9cc001fcd803efa65ff95571c72cbdafbe69,1,2,1,3,1,2011-08-04 22:41:34,2011-08-04 22:41:34
5c4a9cc001fcd803efa65ff95571c72cbdafbe69...e18cad6f88c7b3151722d5b58616badbea75ddf6,2,24,0,24,2,2011-08-04 22:56:49,2011-08-04 22:56:49
d59b0f3e27827d189b8b2595142ec6bbc3941dd9...124817e6684086ccf74e509309b73d4b4dd89932,1,10,11,21,4,2011-06-17 21:33:29,2011-06-17 21:33:29
124817e6684086ccf74e509309b73d4b4dd89932...96501d38a935187461d45c40f17f8327b2e7cd91,2,20,15,35,10,2011-06-19 22:58:47,2011-06-19 22:58:47
d59b0f3e27827d189b8b2595142ec6bbc3941dd9...5c3b9e0c24dbb31245e9266dcd20fface92747eb,3,18,2,20,4,2011-06-15 15:14:52,2011-06-15 15:14:52
fc13f5b6cebc25e7cdb7bc72c4a7d3298e2c696a...35bc30cd87c0578359c3127033dd85e1af132f69,1,4,0,4,1,2011-10-26 20:02:20,2011-10-26 20:02:20
35bc30cd87c0578359c3127033dd85e1af132f69...24e416dca36df4b182a612dba37f8b6cdaa25916,1,2,3,5,1,2011-10-26 21:04:15,2011-10-26 21:04:15
fc13f5b6cebc25e7cdb7bc72c4a7d3298e2c696a...a9f1346c166259e4505911e7e5f3640d3be9f0cc,2,13,13,26,12,2011-10-26 18:58:05,2011-10-26 18:58:05
e18cad6f88c7b3151722d5b58616badbea75ddf6...22028e403f6ae68b5985fbe6a849dd670897664f,1,5,2,7,2,2011-08-05 14:17:02,2011-08-05 14:17:02
22028e403f6ae68b5985fbe6a849dd670897664f...e7af6a296b75b8583175726039f2946de27549fc,1,2,2,4,2,2011-08-05 14:17:24,2011-08-05 14:17:24
e18cad6f88c7b3151722d5b58616badbea75ddf6...13647e94e0141757a17c8445d398b64e70393b5c,3,23,24,47,24,2011-08-05 14:02:33,2011-08-05 14:02:33
e18cad6f88c7b3151722d5b58616badbea75ddf6...7daf44b5ab1b5fbae9f8cbef9850519433609a12,1,28,0,28,1,2011-08-05 13:43:15,2011-08-05 13:43:15
7daf44b5ab1b5fbae9f8cbef9850519433609a12...2ce5e95951044ddfc06c3420c7efb1ea1e49134a,1,14,2,16,3,2011-08-05 13:43:58,2011-08-05 13:43:58
96501d38a935187461d45c40f17f8327b2e7cd91...ab1504f14f56944a5a6297c68b323f0af01d5be8,1,1,1,2,1,2011-06-28 15:46:03,2011-06-28 15:46:03
ab1504f14f56944a5a6297c68b323f0af01d5be8...aa6f8c8cd399d50e91dc0a3634395b6ebf54b209,1,1,1,2,1,2011-06-30 18:16:56,2011-06-30 18:16:56
aa6f8c8cd399d50e91dc0a3634395b6ebf54b209...e2ab2ba1d51b47f90fd8022e500ea3df563e7d74,1,1,1,2,1,2011-06-30 18:17:44,2011-06-30 18:17:44
e2ab2ba1d51b47f90fd8022e500ea3df563e7d74...5b92a5f5eccf69d480c11dbd2870f8161ae0441b,1,1,1,2,1,2011-06-30 22:16:34,2011-06-30 16:18:44
5b92a5f5eccf69d480c11dbd2870f8161ae0441b...139135a98aab1c422e5ae05b026535a40d58328f,2,28,1,29,2,2011-06-30 23:51:50,2011-06-30 23:51:50
139135a98aab1c422e5ae05b026535a40d58328f...e83fcdcb02d676d91d764a58f7e8d2eb1c95de69,2,22,5,27,6,2011-07-01 00:11:26,2011-07-01 00:11:26
e83fcdcb02d676d91d764a58f7e8d2eb1c95de69...e6f8951983b8ce1af8986651fd412f9e569504c6,1,1,1,2,1,2011-07-01 00:18:05,2011-07-01 00:18:05
96501d38a935187461d45c40f17f8327b2e7cd91...27e5052a7bd9e8d0af1a94ec2ad0c2c2317c3b50,1,10,0,10,1,2011-06-21 18:04:06,2011-06-21 18:04:06
27e5052a7bd9e8d0af1a94ec2ad0c2c2317c3b50...bb1702518e43e88c31922af8b0f3bd4aa29017d2,2,2,2,4,2,2011-06-22 12:50:44,2011-06-22 12:50:44
96501d38a935187461d45c40f17f8327b2e7cd91...15cd7d83a96da8885938dbdf8f2e7d85bc09777a,1,17,6,23,4,2011-06-20 19:21:44,2011-06-20 09:39:12
15cd7d83a96da8885938dbdf8f2e7d85bc09777a...d1c4f0e0d19da3478640bdff64a4c419683553a8,1,2,2,4,2,2011-07-14 03:47:34,2011-07-14 03:47:34
d1c4f0e0d19da3478640bdff64a4c419683553a8...5b0c3060f0f55d39d2251d4f79be58570c5ba029,3,22,0,22,3,2011-07-14 03:54:25,2011-07-14 03:54:25
96501d38a935187461d45c40f17f8327b2e7cd91...dd93d0eb32dc638ff3319792a885acd6d3c25c30,2,5,3,8,3,2011-06-20 13:57:26,2011-06-20 13:41:53
dd93d0eb32dc638ff3319792a885acd6d3c25c30...09fe3ea265d730cc5e2dd2705d5a60ffd382d166,1,2,2,4,1,2011-06-23 12:46:26,2011-06-23 12:46:26
c2da514bce84fcd452d5aefa38876a9c8675d8c1...c82dbf1928f54385e83df9ec6de47616f83fe682,1,8,7,15,6,2011-10-27 02:56:26,2011-10-27 02:56:26
b22c9046529852c7ce567df13397849e11e2b9cc...015328787cd2e52efbc77d1254ebcac13cc4ac53,2,15,10,25,6,2011-08-16 22:00:44,2011-08-16 22:00:44
015328787cd2e52efbc77d1254ebcac13cc4ac53...727d51ec9df1dadd742fc468ca3e003da172fb1b,1,2,2,4,2,2011-08-16 23:25:32,2011-08-16 23:25:32
727d51ec9df1dadd742fc468ca3e003da172fb1b...5d954c1b2395b0f7f9132dd76a6dd5048066db04,1,1,1,2,1,2011-08-16 23:30:20,2011-08-16 23:30:20
b22c9046529852c7ce567df13397849e11e2b9cc...0b8b6360127dacc36d06753bf934ff97e5973535,1,4,1,5,2,2011-08-16 15:19:19,2011-08-16 15:19:06
0b8b6360127dacc36d06753bf934ff97e5973535...2053d1c621e8ef65b79d6b339d7336c732ed1b82,1,3,20,23,3,2011-08-16 15:21:53,2011-08-16 15:21:01
e6f8951983b8ce1af8986651fd412f9e569504c6...1886d7443453feab0b73f4a7c4b15fbd9401c4af,2,18,9,27,3,2011-07-09 18:52:16,2011-07-09 18:41:58
e6f8951983b8ce1af8986651fd412f9e569504c6...bb7d98f018c284a27b286a819238bac5541aad5e,1,1,1,2,1,2011-07-07 10:13:10,2011-07-07 10:13:10
c82dbf1928f54385e83df9ec6de47616f83fe682...9ff4f26cf9165378347455f92ffaec3c3d6d460b,1,1,1,2,1,2011-10-27 19:07:21,2011-10-27 19:07:21
9ff4f26cf9165378347455f92ffaec3c3d6d460b...da062c54f40bdeaf0dbd726a7930d191ac893079,1,7,7,14,7,2011-10-27 19:25:30,2011-10-27 19:25:30
da062c54f40bdeaf0dbd726a7930d191ac893079...bad83b39cea9317b1c12673b1b5707a84c3feb9f,1,1,1,2,1,2011-10-27 19:26:37,2011-10-27 19:26:37
bad83b39cea9317b1c12673b1b5707a84c3feb9f...9ea21faf8feaae78fa6391bb9fb777fd8c4b0d26,1,8,8,16,8,2011-10-27 19:28:14,2011-10-27 19:28:14
9ea21faf8feaae78fa6391bb9fb777fd8c4b0d26...4fb7202e0a96c03d3571ffddc3c57481226b0ae0,1,2,2,4,2,2011-10-27 19:29:09,2011-10-27 19:29:09
4fb7202e0a96c03d3571ffddc3c57481226b0ae0...0b4ac1d2be17a35edaba2609ae61469714f922e3,1,3,3,6,3,2011-10-27 19:30:12,2011-10-27 19:30:12
0b4ac1d2be17a35edaba2609ae61469714f922e3...f0cf49fee2201718a56fe09d7a8be641f7775dc3,1,9,9,18,6,2011-10-27 19:31:35,2011-10-27 19:31:35
f0cf49fee2201718a56fe09d7a8be641f7775dc3...0804cdfe9a6e89cf8277971feac1f4322346a750,1,4,4,8,4,2011-10-27 19:32:49,2011-10-27 19:32:49
0804cdfe9a6e89cf8277971feac1f4322346a750...33e98834fe209ab615379b0dc3e50976ebda283a,1,5,5,10,3,2011-10-27 19:33:21,2011-10-27 19:33:21
33e98834fe209ab615379b0dc3e50976ebda283a...d00e29a65eb299ded5896bd84f413b2215548bd5,1,1,1,2,1,2011-10-27 19:33:37,2011-10-27 19:33:37
d00e29a65eb299ded5896bd84f413b2215548bd5...79875457c08451033d1a618cb7d3984c8055fc3a,1,2,2,4,2,2011-10-27 19:34:05,2011-10-27 19:34:05
79875457c08451033d1a618cb7d3984c8055fc3a...b723d49d0d465410128f22bd27f4fc9a35023be0,1,5,5,10,3,2011-10-27 19:34:42,2011-10-27 19:34:42
b723d49d0d465410128f22bd27f4fc9a35023be0...27d099d47168d823430a1709946263f849639d4c,1,2,2,4,2,2011-10-27 19:35:09,2011-10-27 19:35:09
2053d1c621e8ef65b79d6b339d7336c732ed1b82...5209dd75a0be7dfdd53684b43ff6d88dfeb45391,1,1,1,2,1,2011-08-17 20:08:44,2011-08-17 20:08:44
5209dd75a0be7dfdd53684b43ff6d88dfeb45391...e9e7db412ba3c7bc306b609c239dced20c61dda1,1,25,7,32,13,2011-08-17 20:29:55,2011-08-17 20:29:55
e9e7db412ba3c7bc306b609c239dced20c61dda1...624ee36646f0548a6e0a7f1213d7a90c1558e8c5,2,2,2,4,2,2011-08-17 21:05:16,2011-08-17 21:05:16
624ee36646f0548a6e0a7f1213d7a90c1558e8c5...8537a740cdbf0eec8fea0fe3faf44d80e9c68773,1,3,1,4,2,2011-08-17 21:06:21,2011-08-17 21:06:21
8537a740cdbf0eec8fea0fe3faf44d80e9c68773...130a29e78666def3b477056978406ea2fbcdad2b,1,1,1,2,1,2011-08-17 21:18:58,2011-08-17 21:18:58
130a29e78666def3b477056978406ea2fbcdad2b...1a738cb72fa9f8b7280f15586a68ef9377b18976,2,11,5,16,5,2011-08-17 21:34:09,2011-08-17 21:30:31
2053d1c621e8ef65b79d6b339d7336c732ed1b82...9c18eb2c15a762b4f3137fef9897914c80083a89,1,4,0,4,1,2011-08-17 11:30:12,2011-08-17 11:30:12
9c18eb2c15a762b4f3137fef9897914c80083a89...190136cf6132620327a86274fb108fabf55a1d4f,2,11,2,13,2,2011-08-17 14:56:21,2011-08-17 14:56:21
1886d7443453feab0b73f4a7c4b15fbd9401c4af...28b470d7d38c5c3d7d478f9c3f3b743bdae57b1b,2,2,2,4,2,2011-07-12 21:12:07,2011-07-12 21:12:07
1886d7443453feab0b73f4a7c4b15fbd9401c4af...84d066ff7ce38a301fe5cf76a1a79b3a1e754947,2,47,5,52,3,2011-07-11 01:45:50,2011-07-11 01:42:40
84d066ff7ce38a301fe5cf76a1a79b3a1e754947...8fed1e7b5e1248c79b06f5f34d286e27c79b3e57,1,5,5,10,3,2011-07-25 18:17:59,2011-07-25 18:17:59
736d4d770633720493afe1fefd6f135095c5b5f7...df4a160be7fcc234a8e17eccb1c3fd02f231bcfc,2,6,6,12,5,2011-10-27 20:02:54,2011-10-27 20:02:54
df4a160be7fcc234a8e17eccb1c3fd02f231bcfc...5c0c86378a602fbc06535617fc5d712fa6d6e024,2,26,3,29,5,2011-10-27 21:11:40,2011-10-27 21:11:40
5c0c86378a602fbc06535617fc5d712fa6d6e024...fa0e801f52cdc97832ef0b696caa1eda33fc6b36,2,26,2,28,5,2011-10-28 14:53:42,2011-10-28 14:53:42
fa0e801f52cdc97832ef0b696caa1eda33fc6b36...38f087b5ae86faba941426437c3fd1d746de9be1,2,39,23,62,16,2011-10-28 18:17:14,2011-10-28 18:17:14
e57057739bf0b272113b4b7aa0f3efa369d3fd69...d723942b274e3e48dac82ebde11906a4cb349415,2,12,16,28,4,2011-08-25 19:33:54,2011-08-25 19:33:38
d723942b274e3e48dac82ebde11906a4cb349415...e2187f49637c62d9b72ec852c9213a20778e63d3,1,2,2,4,1,2011-08-26 14:10:21,2011-08-26 14:10:21
e2187f49637c62d9b72ec852c9213a20778e63d3...2a045f8269de9ef936bfaa2efbf71b9962385cf8,2,3,5,8,3,2011-08-26 14:10:35,2011-08-26 14:10:35
2a045f8269de9ef936bfaa2efbf71b9962385cf8...3589a53de98c63a528855755492875318ed0136c,1,1,1,2,1,2011-08-26 14:44:50,2011-08-26 14:44:50
1a738cb72fa9f8b7280f15586a68ef9377b18976...6805fc2cd20e36af5c1b0c51f6f39f21cea4609a,2,17,1,18,3,2011-08-22 17:49:18,2011-08-22 17:49:18
6805fc2cd20e36af5c1b0c51f6f39f21cea4609a...84f29084d6ac8077ce5dcb4dd94d43aaeed18fb0,2,1,17,18,3,2011-08-22 19:02:46,2011-08-22 19:02:46
1a738cb72fa9f8b7280f15586a68ef9377b18976...f44d5e1e815ce63b58264b2f9a764c0b03101cfc,1,2,1,3,1,2011-08-17 21:49:09,2011-08-17 21:49:09
f44d5e1e815ce63b58264b2f9a764c0b03101cfc...93beee8ac0c035285ffab63a5c08cf1ac9cf2b2f,2,15,2,17,2,2011-08-18 14:17:12,2011-08-18 14:17:12
28b470d7d38c5c3d7d478f9c3f3b743bdae57b1b...e6a99fdb0ee9e0fd7552d5de8bc4acbe982e98b7,2,50,16,66,7,2011-07-23 00:10:17,2011-07-23 00:10:17
e6a99fdb0ee9e0fd7552d5de8bc4acbe982e98b7...1d220cdd55ec09cd46c594f154d11e7ba9d14b66,1,1,1,2,1,2011-07-23 00:17:46,2011-07-23 00:17:46
1d220cdd55ec09cd46c594f154d11e7ba9d14b66...0ed99097bda3bb6e302c3d93331f0e7312e42077,3,21,2,23,5,2011-07-23 00:39:12,2011-07-23 00:39:12
0ed99097bda3bb6e302c3d93331f0e7312e42077...27291ff06ddb655f90a8d1eada71f7ac61499b12,2,36,17,53,6,2011-07-23 01:26:36,2011-07-23 01:26:36
28b470d7d38c5c3d7d478f9c3f3b743bdae57b1b...2d275dfd050eaea985b12595ea042fa68ddd1ab8,1,4,3,7,3,2011-07-15 20:21:44,2011-07-15 20:21:44
38f087b5ae86faba941426437c3fd1d746de9be1...93750cee36f0b2edc1afd2dad64d9306865a39b9,2,29,29,58,11,2011-10-31 13:50:21,2011-10-31 13:50:21
93750cee36f0b2edc1afd2dad64d9306865a39b9...299cccded9a01eb8b6a61e888f2499cac185b356,1,14,8,22,8,2011-10-31 14:50:19,2011-10-31 14:50:19
299cccded9a01eb8b6a61e888f2499cac185b356...cec4018d0e5249203aaba203cd67147a1162b435,1,7,6,13,7,2011-10-31 16:07:19,2011-10-31 16:07:19
cec4018d0e5249203aaba203cd67147a1162b435...83a355a9a06c03eeb4e601dbe204909d273c91b5,2,8,20,28,9,2011-10-31 16:33:55,2011-10-31 16:33:55
38f087b5ae86faba941426437c3fd1d746de9be1...0191e98934b40be5699a85087b5342a149c978ce,2,7,7,14,7,2011-10-31 13:47:19,2011-10-31 13:33:11
3589a53de98c63a528855755492875318ed0136c...2fc6205fc7b9a6cfa0dd85f5ba24bc0953366e82,2,4,4,8,2,2011-08-29 17:38:26,2011-08-29 17:38:26
3589a53de98c63a528855755492875318ed0136c...f37fc9966e40b73dd4018872343b4b4ea36c4d46,1,2,2,4,2,2011-08-26 23:54:12,2011-08-26 23:54:12
84f29084d6ac8077ce5dcb4dd94d43aaeed18fb0...749dbad981f040bd65cbb50c10e9aa6e44bd26ff,2,20,2,22,2,2011-08-23 12:25:11,2011-08-23 12:25:11
84f29084d6ac8077ce5dcb4dd94d43aaeed18fb0...771e637a5193c63bd18f6edae8af3787a46f003e,1,6,3,9,3,2011-08-23 02:32:06,2011-08-23 02:32:06
771e637a5193c63bd18f6edae8af3787a46f003e...9b174520cce97a0cb9835b0e0b7d40be0f828212,1,3,3,6,3,2011-08-23 12:47:34,2011-08-23 12:47:34
9b174520cce97a0cb9835b0e0b7d40be0f828212...8cabdcd1225a6418d8325209c07e43d2c92633c6,1,1,1,2,1,2011-08-23 12:55:41,2011-08-23 12:55:41
27291ff06ddb655f90a8d1eada71f7ac61499b12...905e8920f9b2a895ed76693a74f34c0297cbcbfb,1,2,2,4,2,2011-08-03 18:02:10,2011-08-03 18:02:10
27291ff06ddb655f90a8d1eada71f7ac61499b12...c8cc1b35e400ef125597dfa7d84ee63553f6501d,1,3,2,5,2,2011-08-02 22:38:35,2011-08-02 22:38:35
27291ff06ddb655f90a8d1eada71f7ac61499b12...a4fb358eace24a2e768d3300c64883b8e0031a62,1,0,19,19,1,2011-07-26 16:08:50,2011-07-26 16:08:50
27291ff06ddb655f90a8d1eada71f7ac61499b12...06c41e09bd92a7d3ea099fdbbdfcced372602239,1,8,8,16,8,2011-07-26 15:52:01,2011-07-26 15:52:01
27291ff06ddb655f90a8d1eada71f7ac61499b12...b5f80a6e31f7463b7bdcbb582edc9cebff14864e,1,2,5,7,3,2011-07-26 15:49:23,2011-07-26 15:49:23
27291ff06ddb655f90a8d1eada71f7ac61499b12...ad16db370e3a18819c9dea0f0e09495bafddd13c,2,17,5,22,3,2011-07-25 21:06:38,2011-07-25 21:06:38
27291ff06ddb655f90a8d1eada71f7ac61499b12...ddf925b77007bb6f219c7bc56166753177a86dec,1,1,1,2,1,2011-07-25 18:02:37,2011-07-25 18:02:37
27291ff06ddb655f90a8d1eada71f7ac61499b12...8a610073f906916eb77399d83acd9cf6095f7db6,1,16,3,19,2,2011-07-23 21:58:08,2011-07-23 21:53:53
8a610073f906916eb77399d83acd9cf6095f7db6...7a1e8809632be7fb04b8e2fe4061bd47bb2ec485,1,15,4,19,3,2011-07-23 23:18:41,2011-07-23 23:18:41
7a1e8809632be7fb04b8e2fe4061bd47bb2ec485...68f1f4d54516a400ec9aa70eab50e7891032ffba,1,3,14,17,2,2011-07-25 17:23:14,2011-07-25 17:23:14
f8a1f7b670df212b2f63064e914952732ac9cf9c...0752687612d190f608e64181148ced1a4adfa5d6,2,1,16,17,2,2011-10-31 21:31:46,2011-10-31 21:31:46
0752687612d190f608e64181148ced1a4adfa5d6...006fde228da59ae71c11a67ef65dbfc09e788773,2,8,4,12,4,2011-10-31 22:24:34,2011-10-31 22:24:34
006fde228da59ae71c11a67ef65dbfc09e788773...52afe20860c4082165b7a9f2184fa1851f7e3fb0,2,21,16,37,11,2011-11-01 13:46:20,2011-11-01 13:46:20
52afe20860c4082165b7a9f2184fa1851f7e3fb0...969fcc16bc5ab77352407f77cd48860ca4d95434,1,6,0,6,1,2011-11-01 16:02:22,2011-11-01 16:02:22
969fcc16bc5ab77352407f77cd48860ca4d95434...fd15cfdc18061cec3b2ed799a140e3449458ffd9,1,1,1,2,1,2011-11-01 16:07:23,2011-11-01 16:07:23
fd15cfdc18061cec3b2ed799a140e3449458ffd9...902668825ffa359e5396f0097917d2271021ece1,1,1,1,2,1,2011-11-01 16:07:49,2011-11-01 16:07:49
902668825ffa359e5396f0097917d2271021ece1...b4392c220af3da945a8b2d7b0053291956c97a17,1,1,1,2,1,2011-11-02 18:05:26,2011-11-02 18:03:08
b4392c220af3da945a8b2d7b0053291956c97a17...3cd651669cc1668720465231fcafd848784d6640,1,3,3,6,1,2011-11-03 20:10:23,2011-11-03 20:10:23
3cd651669cc1668720465231fcafd848784d6640...47d66eaebd6d4a2ee3e037445bfac65d82fc6780,1,1,1,2,1,2011-11-03 20:18:21,2011-11-03 20:18:21
47d66eaebd6d4a2ee3e037445bfac65d82fc6780...8380e12ab4aa3241a1b365f86c121d27a5ea65a5,1,1,1,2,1,2011-11-03 20:18:50,2011-11-03 20:18:50
2fc6205fc7b9a6cfa0dd85f5ba24bc0953366e82...f035c4455fa52f6e2962e40c280ca8b8cecdce1f,1,1,1,2,1,2011-09-01 15:12:36,2011-08-29 17:39:04
f035c4455fa52f6e2962e40c280ca8b8cecdce1f...a42273807d2b1b1ff1362c1b9fc4cb48f65fda11,1,5,4,9,3,2011-09-01 15:16:38,2011-09-01 15:16:38
a42273807d2b1b1ff1362c1b9fc4cb48f65fda11...5e547826e19302e0e7c9b3f6e85cb59266925f1f,1,1,1,2,1,2011-09-01 15:40:27,2011-09-01 15:40:27
5e547826e19302e0e7c9b3f6e85cb59266925f1f...c2531e26d68df80a1544c99661c9653fc77ee6f7,1,1,1,2,1,2011-09-01 15:53:16,2011-09-01 15:53:16
2fc6205fc7b9a6cfa0dd85f5ba24bc0953366e82...20a1bd00eaae42dc729ef8f8224cceffc67ee90a,1,1,1,2,1,2011-08-29 17:39:04,2011-08-29 17:39:04
8380e12ab4aa3241a1b365f86c121d27a5ea65a5...02629f10479cba9b44d0f62acc2915261609afeb,1,1,1,2,1,2011-11-06 19:45:35,2011-11-06 19:45:35
02629f10479cba9b44d0f62acc2915261609afeb...83c72eaa9cea9fec3b38535378334b27ff6bcfb2,1,1,5,6,1,2011-11-06 19:49:31,2011-11-06 19:49:31
83c72eaa9cea9fec3b38535378334b27ff6bcfb2...f35ba5e699c15a1987baa389dbd4fc99f7a7eb03,16,1642,1648,3290,1051,2011-11-06 20:27:42,2011-11-06 20:27:42
f35ba5e699c15a1987baa389dbd4fc99f7a7eb03...262c32a70e1f14e5addd263af2f868525aab03c8,1,2,5,7,1,2011-11-06 20:49:45,2011-11-06 20:49:45
262c32a70e1f14e5addd263af2f868525aab03c8...e086c22826e681bb8afcff93c16c8ad41389a096,1,7,7,14,7,2011-11-06 21:05:45,2011-11-04 20:57:02
e086c22826e681bb8afcff93c16c8ad41389a096...7cbd7a640fb6590b0eb7cbedd83a8d46eb553c5a,2,15,4,19,4,2011-11-06 21:17:59,2011-10-30 17:13:26
7cbd7a640fb6590b0eb7cbedd83a8d46eb553c5a...90c019de5efb63b13c4ac9b29de06bac7eb9ffdc,1,2,7,9,2,2011-11-06 21:38:26,2011-11-06 21:38:26
90c019de5efb63b13c4ac9b29de06bac7eb9ffdc...47c605f693457412a53c9145cafe55420ab8f236,2,32,3,35,2,2011-11-06 21:59:41,2011-11-06 21:59:41
47c605f693457412a53c9145cafe55420ab8f236...471290deb6fd97c6a16cb4d969f277572db7f558,1,12,10,22,2,2011-11-06 22:24:44,2011-11-06 22:24:44
471290deb6fd97c6a16cb4d969f277572db7f558...a211ea27d29d8f0f25a6b16572bde76cea2c6a62,1,0,2,2,1,2011-11-06 22:34:49,2011-10-14 09:41:35
8380e12ab4aa3241a1b365f86c121d27a5ea65a5...92c840401271ba42543845a836f17c63aa28ef34,2,49,1,50,2,2011-11-06 03:06:53,2011-11-06 03:04:09
5e2ec36737e5cb7dd432e035ee8d600ddc61d895...4bc691a1c3a67aefb867e868d5577155571fb659,1,1,1,2,1,2011-09-07 14:08:04,2011-09-07 14:08:04
4bc691a1c3a67aefb867e868d5577155571fb659...8e8fa6dc1ad514b0fa20e41faddcb85693d0408a,2,16,12,28,7,2011-09-07 14:13:22,2011-09-07 14:13:22
a211ea27d29d8f0f25a6b16572bde76cea2c6a62...abcdaf904303b4e30ed44313e6703d4387e9f1f1,1,3,3,6,3,2011-11-06 22:54:21,2011-11-06 22:54:21
41b31d7386cf00e714d703db773ffa73b6bd8b24...0ce2d5e1cb4c2484154a916f3d1876759a59c032,1,1,1,2,1,2011-11-08 05:06:38,2011-11-08 05:06:38
8e8fa6dc1ad514b0fa20e41faddcb85693d0408a...81c778b2cad268a6208544ae32d2ad5b023051a0,2,8,3,11,5,2011-09-07 15:30:22,2011-09-07 15:30:22
f5250e15946b111de2bdc5ff5d321f3601db3e0a...a7e911b7fe84a35234d4be18102e168c6644e40d,1,12,16,28,8,2011-11-07 01:12:00,2011-11-07 01:12:00
a7e911b7fe84a35234d4be18102e168c6644e40d...1e677f30f68d8ea41261aa666a9ba0720383e9d0,2,16,1,17,2,2011-11-07 15:47:09,2011-11-07 15:46:46
1e677f30f68d8ea41261aa666a9ba0720383e9d0...90c907e8b65bc9d323863fc57389f2dca611292d,2,15,2,17,3,2011-11-07 16:07:36,2011-11-07 16:07:36
90c907e8b65bc9d323863fc57389f2dca611292d...13aa84580a837b811dbe2f5d1bc34cf9ca9a6d8d,1,1,1,2,1,2011-11-07 16:15:18,2011-11-07 16:15:18
13aa84580a837b811dbe2f5d1bc34cf9ca9a6d8d...795583d2936a48c6f0048e28f74c5fc71e3a60b0,2,16,4,20,5,2011-11-07 16:25:51,2011-11-07 16:25:51
795583d2936a48c6f0048e28f74c5fc71e3a60b0...8d2655d20c46e7356d832e855c76b813679ccecf,2,2,2,4,2,2011-11-07 16:40:39,2011-11-07 16:40:39
8d2655d20c46e7356d832e855c76b813679ccecf...9189d7b6a3a7522327c27db5777c712034e0183d,1,1,1,2,1,2011-11-07 16:50:39,2011-11-07 16:50:26
95cd2009f69b666efbf42f99ee0e586503575739...f0e43fad376830437a3607ccc146635b8dfb4e83,2,6,8,14,4,2011-11-08 14:48:57,2011-11-08 14:48:44
f0e43fad376830437a3607ccc146635b8dfb4e83...cc4a999648d2623972e6dabad0e6c4b1bb60458a,1,1,1,2,1,2011-11-08 15:09:53,2011-11-08 15:09:53
cc4a999648d2623972e6dabad0e6c4b1bb60458a...0cc806fd88c4dadb0904c7d0b68014520ff668b9,2,3,2,5,3,2011-11-08 20:47:03,2011-11-08 20:46:48
0cc806fd88c4dadb0904c7d0b68014520ff668b9...d8e2b4b6e43cb2de9cd1d21bc6aa1174393535ba,1,1,1,2,1,2011-11-08 20:52:29,2011-11-08 17:49:58
d8e2b4b6e43cb2de9cd1d21bc6aa1174393535ba...c3600e261ba8d9394fe505ef5a0611b6d6b18a8d,2,3,3,6,3,2011-11-08 20:52:30,2011-11-08 18:12:37
c3600e261ba8d9394fe505ef5a0611b6d6b18a8d...2a9f0681dee3a6421bafd2fbc4451c9fe364b6ca,2,15,1,16,2,2011-11-09 00:02:29,2011-11-09 00:02:29
2a9f0681dee3a6421bafd2fbc4451c9fe364b6ca...45101de6962186a21bc557d1c55ec4844dfb241e,2,24,0,24,2,2011-11-09 00:32:25,2011-11-09 00:32:25
45101de6962186a21bc557d1c55ec4844dfb241e...39f9b846e722600aece0a5428e38e9b12217395e,2,12,8,20,9,2011-11-09 04:08:04,2011-11-09 04:08:04
39f9b846e722600aece0a5428e38e9b12217395e...654930de210a3d6730fcb10ca0e0423b7d0a133b,1,1,1,2,1,2011-11-10 01:30:08,2011-11-09 05:00:02
654930de210a3d6730fcb10ca0e0423b7d0a133b...dd363d2c0f8d5eb03fe7beccff44a4a35887caa0,2,27,3,30,4,2011-11-10 02:29:15,2011-11-10 02:29:15
dd363d2c0f8d5eb03fe7beccff44a4a35887caa0...e977a85b87a7712215209e8481e51eda98058ab9,1,7,9,16,7,2011-11-10 02:51:55,2011-11-10 02:51:55
e977a85b87a7712215209e8481e51eda98058ab9...d5897098510faba7f1c14fdd0ad961add42fb5c1,1,6,6,12,2,2011-11-10 15:31:40,2011-11-10 15:30:10
d5897098510faba7f1c14fdd0ad961add42fb5c1...5ba7f60822f05d1b5681c938e7ba3479c0f31142,2,4,1,5,2,2011-11-10 23:05:58,2011-11-10 23:05:58
5ba7f60822f05d1b5681c938e7ba3479c0f31142...774eba33881093efa592d350a831ca1a812428a8,2,56,22,78,12,2011-11-11 02:53:07,2011-11-11 02:53:07
774eba33881093efa592d350a831ca1a812428a8...e0a4aa415d988b21c5b666a20ab00823673ffc3d,1,13,11,24,10,2011-11-11 02:59:45,2011-11-11 02:23:39
e0a4aa415d988b21c5b666a20ab00823673ffc3d...683be093a675d2b8b65d5a33c3416cbe99a71967,2,39,27,66,7,2011-11-14 01:50:36,2011-11-14 01:50:36
683be093a675d2b8b65d5a33c3416cbe99a71967...d2815ed750bc0dce51f065fde039312becfdb3ac,1,5,4,9,4,2011-11-14 02:03:36,2011-11-14 02:03:36
d2815ed750bc0dce51f065fde039312becfdb3ac...fa96f4bdeedd5b134ea1923e1147b4282fa4d6fa,1,3,0,3,1,2011-11-14 02:32:07,2011-11-14 02:32:07
fa96f4bdeedd5b134ea1923e1147b4282fa4d6fa...a467aa0a779b8741581cc2ab1fcd914f5718f5c8,2,38,25,63,4,2011-11-14 16:30:53,2011-11-13 08:10:21
a467aa0a779b8741581cc2ab1fcd914f5718f5c8...499d7e409c4f4d4ed255148e59552763cccf4260,1,14,14,28,8,2011-11-14 16:36:36,2011-11-11 20:05:06
499d7e409c4f4d4ed255148e59552763cccf4260...8bc60bab5dd9747e7ae06c3fdb0c60782d346ff0,7,35,24,59,9,2011-11-14 17:13:25,2011-11-14 17:13:25
8bc60bab5dd9747e7ae06c3fdb0c60782d346ff0...a8460d24e0fd9cae3c9091bd9adef645804dc935,2,14,24,38,6,2011-11-14 17:24:58,2011-11-14 17:24:58
a8460d24e0fd9cae3c9091bd9adef645804dc935...20cbf1b123c9d54029b7d5f6fef2343793f274c2,1,5,5,10,5,2011-11-14 17:31:28,2011-11-14 17:31:28
20cbf1b123c9d54029b7d5f6fef2343793f274c2...6736dd7168ccd1e6d72aca2e3c89d685c5d9c63a,2,10,12,22,6,2011-11-15 15:23:24,2011-11-15 15:22:32
6736dd7168ccd1e6d72aca2e3c89d685c5d9c63a...ca8fc725ac8f590fff965e70c270c53ab0a6c0f3,2,15,7,22,7,2011-11-15 16:38:55,2011-11-15 16:38:55
ca8fc725ac8f590fff965e70c270c53ab0a6c0f3...80797f5805c335a818bda4237642fc4935bd77f6,2,29,8,37,7,2011-11-16 02:06:53,2011-11-16 02:06:53
80797f5805c335a818bda4237642fc4935bd77f6...780c59b89d3b7fb9bcc480aa3173693a9d633853,2,26,1,27,2,2011-11-16 15:35:53,2011-11-16 15:35:53
780c59b89d3b7fb9bcc480aa3173693a9d633853...7c2d6c8cd87ce62210ca9f72bf132d4b1a797940,1,1,0,1,1,2011-11-16 16:39:34,2011-11-16 16:39:34
7c2d6c8cd87ce62210ca9f72bf132d4b1a797940...dd845a2c0f63f97e74e4d490ee66e12e0bf180c5,2,10,2,12,3,2011-11-17 16:47:56,2011-11-17 16:47:56
dd845a2c0f63f97e74e4d490ee66e12e0bf180c5...0de484d48338eda67c4e70e41654eb6593705dfc,1,1,1,2,1,2011-11-17 19:15:42,2011-11-17 19:15:42
0de484d48338eda67c4e70e41654eb6593705dfc...3d6237ef8aff8a31ace3e956e2700aa11e3da752,4,331,103,434,26,2011-11-17 19:48:27,2011-11-17 19:48:27
3d6237ef8aff8a31ace3e956e2700aa11e3da752...327bc07c54526979527f9622c99efdcc8c715f7a,1,1,1,2,1,2011-11-17 20:02:38,2011-11-17 20:02:38
327bc07c54526979527f9622c99efdcc8c715f7a...8485e420dfcb0bba67d3e437b3f3722a9c90165b,1,1,1,2,1,2011-11-18 00:06:35,2011-11-18 00:06:35
8485e420dfcb0bba67d3e437b3f3722a9c90165b...60e247943649cf8f2bad537e49cb22a7badb31cf,1,1,1,2,1,2011-11-18 00:07:03,2011-11-18 00:07:03
60e247943649cf8f2bad537e49cb22a7badb31cf...d459bd40d03892b32c3b58a6c3f0bd4f44a08763,1,3,3,6,1,2011-11-18 00:14:39,2011-11-18 00:14:39
d459bd40d03892b32c3b58a6c3f0bd4f44a08763...fb94277b6ee460c88df470f7bc9b64b4b3af2c9e,2,14,15,29,6,2011-11-18 14:29:10,2011-11-18 14:28:54
fb94277b6ee460c88df470f7bc9b64b4b3af2c9e...1eb1ad616069ab103ceecf48c48514f51dd5d5ac,1,0,3,3,1,2011-11-18 16:45:12,2011-11-18 16:45:12
1eb1ad616069ab103ceecf48c48514f51dd5d5ac...8cb065addc13a8042523b6db4bfd1d80a33c9a46,2,26,2,28,3,2011-11-21 16:33:21,2011-11-21 16:33:21
8cb065addc13a8042523b6db4bfd1d80a33c9a46...65d3dc695540719d0a72ad0c790532aceea39c04,1,11,1,12,2,2011-11-21 18:25:07,2011-11-21 18:25:07
65d3dc695540719d0a72ad0c790532aceea39c04...299bc655c90cc89652417675f976ae1bfefc4d8b,2,56,2,58,4,2011-11-21 18:25:46,2011-11-21 18:25:46
299bc655c90cc89652417675f976ae1bfefc4d8b...dff11c039215d0c4b1b27d631e9c7aaf30eb792e,1,2,2,4,1,2011-11-22 01:04:18,2011-11-22 01:04:18
dff11c039215d0c4b1b27d631e9c7aaf30eb792e...ca08d93b72d63d5c6d719f818f8f1ca401dc3cfe,1,9,0,9,9,2011-11-22 01:45:24,2011-11-22 01:33:06
ca08d93b72d63d5c6d719f818f8f1ca401dc3cfe...3586ea28a8303a8de9f7f94da9fe9c4272b3d8ec,2,2,65,67,4,2011-11-22 01:53:56,2011-11-22 01:53:56
3586ea28a8303a8de9f7f94da9fe9c4272b3d8ec...255460e4836e86b86f48dd5b7d2a2cbf3f996de2,1,1,1,2,1,2011-11-22 02:11:03,2011-11-22 02:11:03
255460e4836e86b86f48dd5b7d2a2cbf3f996de2...d511613d748a92af04a3f07943f34f9baadc4153,1,1,1,2,1,2011-11-22 02:11:33,2011-11-22 02:11:33
d511613d748a92af04a3f07943f34f9baadc4153...6c2a501de40a5f6b3ad382e2d309e5a10fce04d0,14,248,229,477,75,2011-12-06 20:25:38,2011-12-06 20:25:38
6c2a501de40a5f6b3ad382e2d309e5a10fce04d0...166b9d252a025009413eee1584dc364996dcb1c2,2,14,1,15,2,2011-12-06 21:02:54,2011-12-06 21:02:54
166b9d252a025009413eee1584dc364996dcb1c2...0fcfac7568823a4eec4e5dd7b9bf527a8ec04f5c,2,4,5,9,5,2011-12-06 21:17:09,2011-12-06 21:17:09
0fcfac7568823a4eec4e5dd7b9bf527a8ec04f5c...2c1d2b1a4dc74c6487d9f5dd0ecafd34358163a1,1,11,14,25,11,2011-12-06 21:23:22,2011-12-06 21:23:22
2c1d2b1a4dc74c6487d9f5dd0ecafd34358163a1...64df670a81e70fdece1049129523bb2ad1bc2858,1,1,1,2,1,2011-12-06 21:27:38,2011-11-17 19:28:22
64df670a81e70fdece1049129523bb2ad1bc2858...6aa4095ed62e3e37dae4c39c00fb627a3b282307,2,26,3,29,4,2011-12-06 21:44:32,2011-12-06 21:44:32
6aa4095ed62e3e37dae4c39c00fb627a3b282307...2c75a993be712ceb5da4eee9810f562b90fd7e23,1,4,3,7,2,2011-12-07 01:07:29,2011-12-07 01:07:29
2c75a993be712ceb5da4eee9810f562b90fd7e23...7f6a991313380b74d5fb18782fb6b99fd6c4a22d,3,27,3,30,7,2011-12-07 01:32:26,2011-12-07 01:32:26
7f6a991313380b74d5fb18782fb6b99fd6c4a22d...8f5f1b2e6c0f7b8b6d66bfc06c7b169a9443c2b8,4,127,21,148,22,2011-12-09 01:01:23,2011-12-09 01:01:23
8f5f1b2e6c0f7b8b6d66bfc06c7b169a9443c2b8...d6500cc8ded8d3d02e19a3ab831b6b9cf43e82ae,1,7,15,22,4,2011-12-09 01:26:50,2011-12-09 01:26:50
d6500cc8ded8d3d02e19a3ab831b6b9cf43e82ae...98386cfd775fdfa7837ccbec173b04f1e6d57896,10,4323,5570,9893,17,2011-12-09 02:04:57,2011-12-09 01:42:47
98386cfd775fdfa7837ccbec173b04f1e6d57896...e452ebd76dc0ee0e85c176bf4105e0afa77f9a34,2,1,4,5,3,2011-12-09 02:17:11,2011-12-09 02:17:11
e452ebd76dc0ee0e85c176bf4105e0afa77f9a34...07866a04ddcac0b912cd0a7e382fea8667b32d0e,1,15,17,32,2,2011-12-09 02:27:05,2011-12-09 02:27:05
07866a04ddcac0b912cd0a7e382fea8667b32d0e...ae28cfa12c8ccd359639271bb9b912d6ff2b72bf,1,1,1,2,1,2011-12-09 03:13:00,2011-12-09 03:13:00
69585ba3c7f4f49b6370f63963b7317698ead861...215d096310663e2df302e0b13e82216a3ddde920,1,1,1,2,1,2011-09-09 14:54:43,2011-09-09 14:54:43
215d096310663e2df302e0b13e82216a3ddde920...f0c8e4bd46e8b763becdb2018f4c69fea9530c26,1,1,1,2,1,2011-09-09 14:55:22,2011-09-09 14:55:22
f0c8e4bd46e8b763becdb2018f4c69fea9530c26...f567a7fcfc9bd963142e6bb4fcf7923cacb582f1,1,1,1,2,1,2011-09-12 22:54:48,2011-09-12 22:54:48
f567a7fcfc9bd963142e6bb4fcf7923cacb582f1...8f447576c918e3004ea479c278c11677920dc41a,1,1,1,2,1,2011-09-12 22:55:06,2011-09-12 22:55:06
9189d7b6a3a7522327c27db5777c712034e0183d...5ba98fe32445dd58707949f64a599f6d4b0ee49b,1,1,1,2,1,2011-11-07 23:07:54,2011-11-07 23:04:59
ae28cfa12c8ccd359639271bb9b912d6ff2b72bf...b290b1fde003695dcfb3939be4db81084bb2750c,1,1,0,1,1,2011-12-11 23:20:13,2011-12-11 23:20:13
8f447576c918e3004ea479c278c11677920dc41a...61277d2864b00c5206d0fdcefc67f7497663a012,3,47,2,49,5,2011-09-19 19:27:43,2011-09-19 19:27:43
61277d2864b00c5206d0fdcefc67f7497663a012...269899a50646e9c1a4f58f1fe91a8a7262fd77e7,1,1,1,2,1,2011-09-19 19:42:30,2011-09-13 00:39:32
269899a50646e9c1a4f58f1fe91a8a7262fd77e7...92405d4f5ffe9ec1f26f280303783014948438c5,9,294,17,311,17,2011-09-19 19:42:30,2011-09-12 23:40:14
92405d4f5ffe9ec1f26f280303783014948438c5...1878885fb7a09b65d95980a9b7dce2df2944e4f9,3,256,159,415,114,2011-09-19 19:42:30,2011-09-12 23:48:44
1878885fb7a09b65d95980a9b7dce2df2944e4f9...4092e3d2754e3847cd3159edb23184d4cfd4cf03,22,787,273,1060,75,2011-09-19 19:42:30,2011-09-12 15:37:41
4092e3d2754e3847cd3159edb23184d4cfd4cf03...25205d3f90f1bda06e7ca95c2aa8c43e535badb4,15,1,126,127,16,2011-09-19 19:42:30,2011-09-13 00:11:19
25205d3f90f1bda06e7ca95c2aa8c43e535badb4...2e0c9bfd364d990051fc3de94d7abd4194b6ce7d,2,49,10,59,4,2011-09-19 19:42:30,2011-05-28 16:00:28
2e0c9bfd364d990051fc3de94d7abd4194b6ce7d...28c2330665750134979144dba6d956b441cb7f02,1,0,16,16,2,2011-09-19 19:42:30,2011-09-13 01:07:03
28c2330665750134979144dba6d956b441cb7f02...8b4bd89addd2bab64656f699ee003aea03987c63,1,4,11,15,7,2011-09-19 19:42:30,2011-07-28 19:58:34
8b4bd89addd2bab64656f699ee003aea03987c63...5d6a1424aa182bfe25897a217550c2e585e3ed0b,2,435,445,880,70,2011-09-19 19:42:30,2011-07-29 00:43:23
5d6a1424aa182bfe25897a217550c2e585e3ed0b...f3a9d308125b181a589cf1fb92c21f1572bb5176,1,5,4,9,5,2011-09-19 19:42:30,2011-07-29 14:20:09
f3a9d308125b181a589cf1fb92c21f1572bb5176...03f99ff995ff2c55f995f08cde93b08e25f19f4c,1,21,17,38,11,2011-09-19 19:42:30,2011-07-31 15:53:15
03f99ff995ff2c55f995f08cde93b08e25f19f4c...d74c6bd0f40f315ee12b411a8a5766596095d439,2,41,9,50,6,2011-09-19 19:42:31,2011-08-02 02:30:11
d74c6bd0f40f315ee12b411a8a5766596095d439...0dc7b16e94ebb6ad27bcf8f12d62efac7d610db5,2,7,6,13,7,2011-09-19 19:42:31,2011-08-03 02:50:58
0dc7b16e94ebb6ad27bcf8f12d62efac7d610db5...df6e0d508efd3aa2e242e61d810d22d3491e221c,1,49,52,101,26,2011-09-19 19:42:31,2011-08-06 14:19:49
df6e0d508efd3aa2e242e61d810d22d3491e221c...6a670df9e9b9e5cd278b390a2e99ac179307a4e9,2,139,125,264,36,2011-09-19 19:42:31,2011-08-13 14:46:34
6a670df9e9b9e5cd278b390a2e99ac179307a4e9...990c094f1ceded54f93631d4ceb2c649a3b171be,1,23,29,52,7,2011-09-19 19:42:31,2011-08-14 19:20:12
990c094f1ceded54f93631d4ceb2c649a3b171be...bb1081ee448b4cbdba8f6b1ae98b29a08f9bfff8,1,27,24,51,4,2011-09-19 19:42:31,2011-08-14 19:52:57
bb1081ee448b4cbdba8f6b1ae98b29a08f9bfff8...bd55f905a0e53c58ae4c3db8cb17c7db25d58459,1,1,1,2,1,2011-09-19 19:42:31,2011-08-16 16:56:19
bd55f905a0e53c58ae4c3db8cb17c7db25d58459...8a6bbc70d07e78d0ff84f174d0d17c11a743e2c9,1,6,13,19,4,2011-09-19 19:42:31,2011-08-16 19:40:09
8a6bbc70d07e78d0ff84f174d0d17c11a743e2c9...66e9a6f77365fb4f682164cf1df5283fccf322d1,1,10,7,17,6,2011-09-19 19:42:31,2011-08-17 00:26:14
66e9a6f77365fb4f682164cf1df5283fccf322d1...68d07bf648c55c39aeb5b3abc634c58087b19fd8,1,2,2,4,1,2011-09-19 19:42:31,2011-08-17 14:34:13
68d07bf648c55c39aeb5b3abc634c58087b19fd8...9038aa958614583f581c2be39267d81bb42f3115,1,1,1,2,1,2011-09-19 19:42:31,2011-09-01 21:52:13
9038aa958614583f581c2be39267d81bb42f3115...005958b7313323911825b343178cdc5084e1796f,2,25,14,39,9,2011-09-19 19:42:31,2011-09-07 03:20:48
005958b7313323911825b343178cdc5084e1796f...0ccb88d48da3d3b7f1cc7369d948ffd5902c553e,1,24,28,52,7,2011-09-19 19:42:31,2011-09-07 19:41:23
0ccb88d48da3d3b7f1cc7369d948ffd5902c553e...ecd10464e8659b008e52161cc029f9d6863e33b3,1,36,33,69,7,2011-09-19 19:42:31,2011-09-08 00:57:37
ecd10464e8659b008e52161cc029f9d6863e33b3...9aa553aa18e79989dfa002ae5a295f626951bdf5,2,37,14,51,5,2011-09-19 19:42:31,2011-09-08 01:02:13
9aa553aa18e79989dfa002ae5a295f626951bdf5...8ba5010ac2cf7f78fd46aacffda2257ddbe953f1,2,144,14,158,3,2011-09-19 19:42:31,2011-09-08 01:30:35
8ba5010ac2cf7f78fd46aacffda2257ddbe953f1...0ec71ac707fc3edce6ee67a54da6c779164812f4,2,4,2,6,3,2011-09-19 19:42:31,2011-09-08 02:49:32
0ec71ac707fc3edce6ee67a54da6c779164812f4...2886249e84560b1fbc4e0ab777d703a6a6fdca8d,1,32,33,65,18,2011-09-19 19:42:31,2011-09-08 03:21:33
2886249e84560b1fbc4e0ab777d703a6a6fdca8d...38601e07dae4bc4304eb9842faec5396c9eab787,2,22,12,34,8,2011-09-19 19:42:31,2011-09-08 13:03:16
38601e07dae4bc4304eb9842faec5396c9eab787...6872d31f5a7d6162161b61bfd35ad0e8aa545395,1,4,3,7,5,2011-09-19 19:42:31,2011-09-08 14:18:36
6872d31f5a7d6162161b61bfd35ad0e8aa545395...619a89d5ff6f5bcf678bdb88c3b47dea96b06ea7,1,2,2,4,1,2011-09-19 19:42:31,2011-09-08 19:03:40
619a89d5ff6f5bcf678bdb88c3b47dea96b06ea7...8c91da57b9fbc8ded9854a899e4105530cea1d90,1,2,2,4,2,2011-09-19 19:42:32,2011-09-08 19:59:23
8c91da57b9fbc8ded9854a899e4105530cea1d90...4030de9519e91fdc247af3c508a8ede277242c3f,1,7,8,15,6,2011-09-19 19:42:32,2011-09-09 03:31:47
4030de9519e91fdc247af3c508a8ede277242c3f...06e56acb0d6f3d183389d3bcb7dfb54b7ae7c220,1,6,5,11,3,2011-09-19 19:42:32,2011-09-10 18:46:58
06e56acb0d6f3d183389d3bcb7dfb54b7ae7c220...30249ab572ab26ae3b0d9873d393cd4cb415a9f6,1,158,228,386,15,2011-09-19 19:42:32,2011-09-12 00:38:54
30249ab572ab26ae3b0d9873d393cd4cb415a9f6...6c618ddb0d1efd980316c7d268c5531419e67ae0,1,1,1,2,1,2011-09-19 19:42:32,2011-09-12 00:44:44
6c618ddb0d1efd980316c7d268c5531419e67ae0...6ece8f138f0c89d72fd597d95aa87304cdbe4d1d,2,18,15,33,13,2011-09-19 19:42:32,2011-09-12 01:18:32
6ece8f138f0c89d72fd597d95aa87304cdbe4d1d...b7ebbb9142f1f18f887fde6dfbb5fa5fd72dba47,1,1,1,2,1,2011-09-19 19:42:32,2011-09-13 01:46:16
b7ebbb9142f1f18f887fde6dfbb5fa5fd72dba47...daeb66504565d3b95dbd6310778def4166044750,2,15,10,25,8,2011-09-19 19:42:32,2011-09-14 18:25:14
daeb66504565d3b95dbd6310778def4166044750...76a84fba94e0fd32b1a6612c71ef09dee39f6666,2,9,6,15,6,2011-09-19 19:42:32,2011-09-15 13:27:36
76a84fba94e0fd32b1a6612c71ef09dee39f6666...29c52b0f6caa23403fd2942aa292b84ce1278191,2,3,2,5,2,2011-09-19 19:42:32,2011-09-15 20:26:35
29c52b0f6caa23403fd2942aa292b84ce1278191...e7a7cc8914cc1da17fd6fd14b370532d6f273069,1,1,1,2,1,2011-09-19 19:42:32,2011-09-19 19:41:35
8f447576c918e3004ea479c278c11677920dc41a...7856230f67f65f000bd9e16a1cc08233fb79abf4,1,11,11,22,11,2011-09-19 00:15:18,2011-09-19 00:15:18
7856230f67f65f000bd9e16a1cc08233fb79abf4...6174612daad811a89915d03017bd4869970e60da,1,1,0,1,1,2011-09-19 00:15:35,2011-09-19 00:15:35
6174612daad811a89915d03017bd4869970e60da...bc65f930b557b42a50f20adee4933a1ed3409f67,1,1,1,2,1,2011-09-19 13:41:55,2011-09-19 13:41:55
68ca9d47a049052bb3a00dbc3d0f9e08c1a3c5ea...66e65c81684e314448620822c0ba93d9d8c523cd,2,108,11,119,9,2011-11-08 02:22:04,2011-11-08 02:22:04
66e65c81684e314448620822c0ba93d9d8c523cd...f8eba6ee2530e540cb30512bb724ac6bfe6c8142,1,2,2,4,2,2011-11-08 02:33:03,2011-11-08 02:33:03
605e4bb1e67975855cb212ce68941419fcf88cec...9bea2167c434d5b97643f53da16b04927dc02a7d,2,101,89,190,8,2011-12-12 15:42:10,2011-12-12 15:22:38
9bea2167c434d5b97643f53da16b04927dc02a7d...2a63b980eda1cf4ec1c2f27749821785c78c65b6,3,7,5,12,4,2011-12-12 16:23:47,2011-12-12 16:23:47
2a63b980eda1cf4ec1c2f27749821785c78c65b6...c584ce4f562536a282c6ccfd78d5d12080850517,2,11,2,13,4,2011-12-14 02:40:59,2011-12-14 02:40:59
c584ce4f562536a282c6ccfd78d5d12080850517...5798eab1240734e5d04a85acd628d007f4c93765,1,1,1,2,1,2011-12-14 02:57:48,2011-12-14 02:57:48
5798eab1240734e5d04a85acd628d007f4c93765...4534db196bf9475c79f74d6b62ebc866c27d06d9,2,6,2,8,4,2011-12-14 03:29:35,2011-12-14 03:29:35
4534db196bf9475c79f74d6b62ebc866c27d06d9...f724bc6c921378b82d9d6fa17329b6451fbb7a51,4,34,33,67,10,2011-12-15 15:11:24,2011-12-15 15:11:24
f724bc6c921378b82d9d6fa17329b6451fbb7a51...dd900460ac6f77be71ceb878bc2cd1465397dc60,21,122,297,419,23,2012-01-12 02:35:13,2012-01-12 02:35:13
dd900460ac6f77be71ceb878bc2cd1465397dc60...b6a2dfbeb9ff77aa7776fd3439ad431b1100c51b,1,3,3,6,2,2012-01-12 02:49:55,2011-12-29 16:36:41
b6a2dfbeb9ff77aa7776fd3439ad431b1100c51b...77de76b942bf6bde5cf17ddad15b03049c92e6be,2,24,11,35,6,2012-01-12 02:56:18,2012-01-12 02:56:18
77de76b942bf6bde5cf17ddad15b03049c92e6be...491d7e219b595f8f4be1087ec73c256e1849711e,1,3,3,6,3,2012-01-12 03:11:22,2012-01-12 03:11:22
491d7e219b595f8f4be1087ec73c256e1849711e...d07116a9525f039d7a2a2e080f468d8ddbc283a7,2,2,2,4,2,2012-01-12 03:16:30,2011-12-18 15:54:30
d07116a9525f039d7a2a2e080f468d8ddbc283a7...cc5e8e3866e5dac7eacda5927679573c8da79492,3,57,1,58,3,2012-01-13 00:57:04,2012-01-13 00:40:41
cc5e8e3866e5dac7eacda5927679573c8da79492...6c8dd7e7d3a00133591d4f9c05c207900234e11e,2,4,4,8,4,2012-01-13 01:04:17,2012-01-12 17:39:08
6c8dd7e7d3a00133591d4f9c05c207900234e11e...d8289964788b6d5a31c2f89746c78079fb8a9869,2,14,6,20,7,2012-01-13 01:14:51,2012-01-13 01:14:51
d8289964788b6d5a31c2f89746c78079fb8a9869...c0da49ff37484764bd0f33fe40d1a5f83d0f39e8,2,21,5,26,6,2012-01-13 01:30:45,2012-01-13 01:30:45
c0da49ff37484764bd0f33fe40d1a5f83d0f39e8...2982abbb13454bd4bdf0299f1183fb0d8c02f02d,1,4,0,4,1,2012-01-18 01:41:51,2011-12-26 20:22:29
2982abbb13454bd4bdf0299f1183fb0d8c02f02d...8d9025ca50603e5404c6b50f7fa6c87046ee24c1,2,34,20,54,6,2012-01-20 03:14:24,2012-01-20 03:14:24
8d9025ca50603e5404c6b50f7fa6c87046ee24c1...135bb4ff812d9f97b961670ad9c4ed9d14f333bb,6,210,105,315,72,2012-01-20 03:36:08,2012-01-20 02:47:23
135bb4ff812d9f97b961670ad9c4ed9d14f333bb...e8673ae1aafe16a8a7f855958f545c710bf8133e,2,10,5,15,5,2012-01-20 19:17:19,2012-01-20 19:17:02
e8673ae1aafe16a8a7f855958f545c710bf8133e...4eef88cf6d7a72b33f1796e7405d559a2e0f506c,1,23,6,29,4,2012-01-20 20:57:11,2012-01-20 20:57:11
4eef88cf6d7a72b33f1796e7405d559a2e0f506c...d700f458d7cb38bbd6b8c1a74f3c8af9d63947f7,2,2,2,4,2,2012-01-20 21:41:14,2012-01-20 21:41:14
d700f458d7cb38bbd6b8c1a74f3c8af9d63947f7...499658970b2c9add7a7d175dffc8e263c3b7b50d,1,9,3,12,4,2012-01-20 21:47:49,2012-01-20 21:47:49
af1dc64bee90960f7898699c3788133177aff3bc...e4c48a34b4fe687d4a3b935b6c405f502dd0223e,2,42,3,45,4,2011-09-19 20:08:00,2011-09-19 20:08:00
e4c48a34b4fe687d4a3b935b6c405f502dd0223e...d5f144a7bba98212d6fe9e257f722b62baf651f0,4,61,78,139,30,2011-09-19 20:13:14,2011-09-19 20:13:14
d5f144a7bba98212d6fe9e257f722b62baf651f0...2831cfd072125a51f454346211666c9e11641474,2,27,4,31,5,2011-09-19 20:13:57,2011-09-19 20:13:57
f8eba6ee2530e540cb30512bb724ac6bfe6c8142...586fb059190ecacd89e3cd211c78e776792d2f2b,1,2,2,4,2,2011-11-08 14:42:08,2011-11-08 14:42:08
499658970b2c9add7a7d175dffc8e263c3b7b50d...633ca9c1610c49dbb780e565f4f1202e1fe20fae,3,25,1,26,3,2012-01-28 21:30:35,2012-01-28 19:58:00
633ca9c1610c49dbb780e565f4f1202e1fe20fae...c746f79cc024df41d9300f3b910a8a55b3c91c3e,2,17,2,19,4,2012-01-28 21:46:52,2012-01-28 21:46:52
c746f79cc024df41d9300f3b910a8a55b3c91c3e...3f88249b44d30b079f0f7b4b0b85b936d86cd300,1,0,1,1,1,2012-01-28 22:03:14,2012-01-23 17:20:32
3f88249b44d30b079f0f7b4b0b85b936d86cd300...6eba066573db377a0e565ac010346b6c9e718a04,1,2,1,3,2,2012-01-31 01:23:04,2012-01-31 01:23:04
6eba066573db377a0e565ac010346b6c9e718a04...eefead3d9629d68407600831a23c58a25163489e,1,4,1,5,3,2012-01-31 01:31:22,2012-01-31 01:31:22
eefead3d9629d68407600831a23c58a25163489e...0944be058e0995d6da066587366fd9ab655764d2,1,2,3,5,2,2012-01-31 03:38:37,2012-01-31 03:38:37
499658970b2c9add7a7d175dffc8e263c3b7b50d...1326510324380aaab162331b2d271a986a634c48,1,1,1,2,1,2012-01-22 19:53:50,2012-01-22 19:53:50
8e4859f0c11503e65c39b4a849bf4e4dee300bba...8ce91e980682e899ac73d963ed72b4ac717289ca,1,10,0,10,1,2012-01-31 21:02:25,2012-01-31 21:02:25
8ce91e980682e899ac73d963ed72b4ac717289ca...7a463c08139ce195883da6e8e847957de04b2bb9,1,1,1,2,1,2012-02-01 01:11:27,2012-02-01 01:11:27
7a463c08139ce195883da6e8e847957de04b2bb9...974e4afbe2b69cdb7e90bf0e7058b6330003f21f,1,1,1,2,1,2012-02-01 01:11:53,2012-02-01 01:11:53
974e4afbe2b69cdb7e90bf0e7058b6330003f21f...96bb57d4ef49a0ab8f753108cc016fa215e237f4,2,4,2,6,4,2012-02-10 01:27:27,2012-02-10 01:25:43
96bb57d4ef49a0ab8f753108cc016fa215e237f4...bf7a4df22abcea10cf8f97eb31b5fa989fb4daf5,2,13,3,16,4,2012-02-10 01:48:21,2012-02-10 01:48:21
bf7a4df22abcea10cf8f97eb31b5fa989fb4daf5...8618487c536f7128222e3d0fefca933cc3e94298,1,4,4,8,2,2012-02-10 02:37:54,2012-02-06 15:02:58
8618487c536f7128222e3d0fefca933cc3e94298...8db3fb13a536f69b8eb6c39962fac5af534376cc,2,6,6,12,4,2012-02-10 21:17:12,2012-02-10 21:17:12
a8dd45547cb32a6c5505e139ece70b71cfc97ee8...6c2b64dfa5e1d6f90c74f0f1719e9f11f52de7a4,2,11,1,12,2,2012-02-14 02:53:42,2011-12-09 17:41:35
6c2b64dfa5e1d6f90c74f0f1719e9f11f52de7a4...7226cf2800315e90b671db63f2b5f51150ad7e8e,4,18,13,31,8,2012-02-17 04:17:57,2012-02-14 23:19:32
7226cf2800315e90b671db63f2b5f51150ad7e8e...a619cb3063c104aa5ec808e13d2c84af565eacc6,2,3,2,5,3,2012-02-24 03:40:07,2012-02-22 05:21:18
a619cb3063c104aa5ec808e13d2c84af565eacc6...f36568324d1b68101cc6e8933b94db3bc8591fad,3,44,84,128,14,2012-02-24 03:55:20,2012-02-23 20:48:12
f36568324d1b68101cc6e8933b94db3bc8591fad...dec2804c783003c13d356ed3fec664c3ac4b05ee,2,13,0,13,2,2012-02-24 04:09:31,2012-02-17 19:17:20
dec2804c783003c13d356ed3fec664c3ac4b05ee...52816619a9fb6c5d329541c75407cd05a4750f1c,1,3,3,6,3,2012-02-24 04:22:04,2012-02-24 04:22:04
52816619a9fb6c5d329541c75407cd05a4750f1c...1c35f3816a3b1be0855dcea8ab212af506e91f83,1,19,21,40,6,2012-02-24 04:36:48,2012-02-13 14:52:43
1c35f3816a3b1be0855dcea8ab212af506e91f83...a52391aa1dcf3f28306e274e1b2d7f0affc4e725,5,34,18,52,14,2012-02-24 05:14:15,2012-02-24 05:14:15
a52391aa1dcf3f28306e274e1b2d7f0affc4e725...56426261f0ee97d6d2f903d08b137a6f5f2c0916,2,11,3,14,2,2012-03-02 03:31:17,2012-03-02 03:31:17
56426261f0ee97d6d2f903d08b137a6f5f2c0916...da02e190b5fa57d56a6561ac64209c36c64c4ecd,2,15,1,16,2,2012-03-02 16:08:52,2012-02-25 20:05:15
da02e190b5fa57d56a6561ac64209c36c64c4ecd...5cae50e66e34c277412c01ccb1c24bd6a85d2d8a,4,51,1,52,5,2012-03-02 16:45:30,2012-02-25 18:13:16
5cae50e66e34c277412c01ccb1c24bd6a85d2d8a...1ff284d2cd67f2f4e7cd8b9577191ba80d521763,1,14,1,15,2,2012-03-02 17:03:32,2012-03-02 17:03:32
1ff284d2cd67f2f4e7cd8b9577191ba80d521763...f0732c1e4138342c96e35ff51d5cd681b6cfdb94,2,11,11,22,8,2012-03-02 18:13:43,2012-02-10 21:39:28
f0732c1e4138342c96e35ff51d5cd681b6cfdb94...2803a5e6f2704691fdd8ce4d34fe961d0192a0fb,1,2,2,4,2,2012-03-02 18:28:27,2012-02-10 16:14:13
2803a5e6f2704691fdd8ce4d34fe961d0192a0fb...92cd9990971a097b6639607b0d1172e9fe6d0dca,2,11,1,12,3,2012-03-02 18:55:58,2012-02-09 14:45:34
92cd9990971a097b6639607b0d1172e9fe6d0dca...935df49d77c9719b12e28b07e1c26bcf8a5ab6a7,1,2,7,9,2,2012-03-03 02:10:36,2012-03-03 00:21:24
935df49d77c9719b12e28b07e1c26bcf8a5ab6a7...8013163a36be2e954344ad689e95a5773d61f1e9,1,1,1,2,1,2012-03-03 02:54:08,2012-03-03 02:40:44
8013163a36be2e954344ad689e95a5773d61f1e9...d3320462df1253196e61b2daadc3cdfe1b4c3771,2,11,4,15,6,2012-03-05 17:54:44,2012-03-05 17:54:44
d3320462df1253196e61b2daadc3cdfe1b4c3771...e529d91ccd00a75fcfa45a6aebaf8ecf0a9bac4b,1,1,1,2,1,2012-03-06 02:37:43,2012-03-06 02:37:43
e529d91ccd00a75fcfa45a6aebaf8ecf0a9bac4b...619f0d908a4227d4fd49971d7f9a5290eaffd72d,2,19,3,22,3,2012-03-06 17:54:51,2012-03-06 15:22:58
619f0d908a4227d4fd49971d7f9a5290eaffd72d...92a92be10f2c6eecc93e0def9001a2ef2852fde1,2,64,8,72,10,2012-03-07 00:56:17,2012-03-05 02:11:50
92a92be10f2c6eecc93e0def9001a2ef2852fde1...318d47b730769f538dbc24800b9ad67ff8e73ea9,1,59,103,162,3,2012-03-07 08:54:52,2012-03-07 08:54:25
318d47b730769f538dbc24800b9ad67ff8e73ea9...014b2a57007c4fd2bc85397f83fe36eec88aa975,1,2,2,4,2,2012-03-07 10:58:18,2012-03-07 10:58:18
014b2a57007c4fd2bc85397f83fe36eec88aa975...484cea1b5651d215a24d3a6827663a4e16a6a253,3,21,1,22,2,2012-03-07 14:39:39,2012-03-07 14:39:39
484cea1b5651d215a24d3a6827663a4e16a6a253...d3fad51cad1f71bd20beba81b51552295721a5a5,3,23,0,23,3,2012-03-07 15:54:05,2012-03-07 15:54:05
d3fad51cad1f71bd20beba81b51552295721a5a5...bd56456b1e886c7b03211212ac3c0a6a310b5cde,2,2,3,5,2,2012-03-07 16:08:59,2012-03-07 16:08:59
bd56456b1e886c7b03211212ac3c0a6a310b5cde...d30859eb6bd5af9aafa9db003e17835ff594d019,2,16,1,17,3,2012-03-07 16:37:14,2012-03-07 16:37:14
d30859eb6bd5af9aafa9db003e17835ff594d019...c5712a24bd6372761e4a8934bac5ac7d98a42191,1,3,1,4,1,2012-03-07 16:55:07,2012-03-07 16:55:07
c5712a24bd6372761e4a8934bac5ac7d98a42191...ae138ac6d199163f48b31685d63d22832fc41ad2,1,9,1,10,1,2012-03-07 17:23:46,2012-03-07 17:23:46
ae138ac6d199163f48b31685d63d22832fc41ad2...8d94ed91e47f68f742b6c282c8de40eb5fa8e140,1,103,59,162,3,2012-03-07 20:31:35,2012-03-07 20:28:00
8d94ed91e47f68f742b6c282c8de40eb5fa8e140...968e750673e9d1e16dfd4963e4fc934be488bdb0,1,1,1,2,1,2012-03-09 18:42:24,2012-03-09 18:42:24
968e750673e9d1e16dfd4963e4fc934be488bdb0...d39f73583d904f0cc8fa3798989b04393b707237,1,1,1,2,1,2012-03-09 18:43:52,2012-03-09 18:43:52
d39f73583d904f0cc8fa3798989b04393b707237...f40c862d1ea6f818dc1600165fa271f3c398eef3,1,3,3,6,1,2012-03-09 18:47:59,2012-03-09 18:47:59
f40c862d1ea6f818dc1600165fa271f3c398eef3...07c8a9b2448f42ee940e7fc1351344eb372f7463,1,6,3,9,1,2012-03-21 19:28:10,2012-03-21 19:04:10
07c8a9b2448f42ee940e7fc1351344eb372f7463...754bda21cbc5c9044daf7f968fb9b4ffae39e334,1,1,1,2,1,2012-03-21 19:46:34,2012-03-21 19:46:34
754bda21cbc5c9044daf7f968fb9b4ffae39e334...c68f4fe548fee5c8bb7cdc7ca2a2315d0433b6f8,1,1,1,2,1,2012-03-21 19:46:59,2012-03-21 19:46:59
c68f4fe548fee5c8bb7cdc7ca2a2315d0433b6f8...a29d482894a844724f4386f2fed0edf9cf70c069,2,6,2,8,3,2012-03-30 21:10:25,2012-03-30 21:09:46
c68f4fe548fee5c8bb7cdc7ca2a2315d0433b6f8...379a1370164ff6b0fc57e3b10e1867ae867e2850,1,10,1,11,2,2012-03-23 15:31:05,2012-03-23 15:31:05
379a1370164ff6b0fc57e3b10e1867ae867e2850...2795a8390c1986200bf4e00158dbf3ad2da8d898,2,8,0,8,2,2012-03-23 15:54:12,2012-03-23 15:31:53
a29d482894a844724f4386f2fed0edf9cf70c069...fccfeefb1036ac70f565c2f54b55a14fca528d57,1,1,1,2,1,2012-04-07 07:13:55,2012-04-07 07:13:55
a29d482894a844724f4386f2fed0edf9cf70c069...395612bb152660226b93f7f096cd0146fc06991e,2,15,10,25,12,2012-04-01 23:54:19,2012-04-01 23:54:19
395612bb152660226b93f7f096cd0146fc06991e...914df9cb42219200a0286d15e0f45a9994b8ab3d,2,10,6,16,6,2012-04-02 00:04:46,2012-04-02 00:04:46
a29d482894a844724f4386f2fed0edf9cf70c069...a41f2406748e3113751ab1e5b5d990d9144123fc,3,48,42,90,36,2012-04-01 23:29:39,2012-04-01 23:29:39
a29d482894a844724f4386f2fed0edf9cf70c069...7fa0da08b88534e486ddb7eb3752ef76467fb7dd,2,159,137,296,11,2012-04-01 23:03:34,2012-04-01 23:03:34
62a4c8450367a8f1ef3a6ae3c5c08c7a025113c2...2f1ddd450752b5ba2efadb3fdd7b9b13b67e851e,2,12,2,14,5,2012-04-11 01:54:07,2012-04-11 01:54:07
2f1ddd450752b5ba2efadb3fdd7b9b13b67e851e...0f827c800be0a386e9014f1c77d0a58102f23f67,1,1,1,2,1,2012-04-11 02:30:26,2012-04-11 02:30:26
0f827c800be0a386e9014f1c77d0a58102f23f67...5181ce0f35cf941ae2d7f5da2cf98ebcc638daff,2,2,3,5,3,2012-04-11 19:40:03,2012-04-11 16:00:42
5181ce0f35cf941ae2d7f5da2cf98ebcc638daff...6bc08c2b2f04629114ae7ca79c3c2c54320e4908,4,78,47,125,14,2012-04-15 21:41:54,2012-04-15 21:41:54
6bc08c2b2f04629114ae7ca79c3c2c54320e4908...16249f0acd36d44d15a2d676ce932b10a7be06f2,2,10,16,26,3,2012-04-15 21:52:48,2012-04-15 21:52:48
16249f0acd36d44d15a2d676ce932b10a7be06f2...aabc0d85bb9417542cf04ca68452d751d2dcf515,1,1,1,2,1,2012-04-15 21:53:00,2012-04-15 21:53:00
376e0d9fa8ff4e9ca0b77a6f0d0b268ac7faa87e...532ba250a9f6c5b0f51ec53d68aef9fb148e8dd6,30,762,632,1394,227,2012-04-18 16:47:20,2012-04-18 16:47:20
532ba250a9f6c5b0f51ec53d68aef9fb148e8dd6...247d824d35e81ec96e1a8913674c97fb45dd40ae,30,632,762,1394,228,2012-04-18 17:49:37,2012-04-18 17:49:37
41056ab1957b44bf5be2184f5c566121a985b38a...203a168980ece60213c87a10ac0ad294783d5563,3,28,19,47,12,2012-04-05 01:38:46,2012-04-05 01:17:01
203a168980ece60213c87a10ac0ad294783d5563...dc337f628c0d2a4f6d691851eb95a622599e38b2,1,0,6,6,2,2012-04-05 01:38:47,2012-03-04 17:54:33
dc337f628c0d2a4f6d691851eb95a622599e38b2...077fd7ed6f7c330a957b9c58b805e6cc3f48be82,1,2,11,13,2,2012-04-05 01:57:48,2012-03-05 21:57:34
077fd7ed6f7c330a957b9c58b805e6cc3f48be82...da70ca6b9629b821d9b0a7e11dee61a5d972f06b,1,1,1,2,1,2012-04-05 02:14:33,2012-03-06 15:25:29
da70ca6b9629b821d9b0a7e11dee61a5d972f06b...7c814f4837d48e02684c6dfb2fa74cf2d0667ac2,1,1,1,2,1,2012-04-05 02:29:56,2012-03-06 20:56:02
7c814f4837d48e02684c6dfb2fa74cf2d0667ac2...22ad8723ce07569a9b039c7901f29e86ad14523c,2,95,120,215,46,2012-04-05 03:03:34,2012-04-05 03:00:58
22ad8723ce07569a9b039c7901f29e86ad14523c...d5ee856a44eff3f07162cf7eb1181b58d3a1c6ff,3,5,5,10,5,2012-04-05 03:22:15,2012-03-13 13:39:40
d5ee856a44eff3f07162cf7eb1181b58d3a1c6ff...fdf37de77882204cafeba2f10fb5b9915b6e4b93,2,12,2,14,3,2012-04-05 03:30:13,2012-04-05 03:30:13
fdf37de77882204cafeba2f10fb5b9915b6e4b93...36d2d9ae937f626d98319ed850905e8d1cbfd078,2,10,7,17,8,2012-04-05 15:06:54,2012-04-05 15:06:54
36d2d9ae937f626d98319ed850905e8d1cbfd078...4cd57d727a075617c8db30dcf69542f66add63fe,2,20,5,25,5,2012-04-05 16:26:20,2012-04-05 16:12:38
4cd57d727a075617c8db30dcf69542f66add63fe...c04bfce556616a60cecf0ecaf9cb1f9d048a4747,2,12,9,21,8,2012-04-05 16:53:36,2012-03-30 15:56:11
c04bfce556616a60cecf0ecaf9cb1f9d048a4747...590bcab245d969dffc3c61b7679ab4d1a9a26ebd,2,13,4,17,7,2012-04-06 01:03:41,2012-04-02 17:12:57
590bcab245d969dffc3c61b7679ab4d1a9a26ebd...91a6d9dafc402e78b76d1ea41d70480b42dfde60,1,1,1,2,1,2012-04-06 01:42:23,2012-03-10 18:30:07
91a6d9dafc402e78b76d1ea41d70480b42dfde60...77536f5cb2ab042ac8be40ba59f36d8f3bd7e4d1,4,14,111,125,21,2012-04-06 01:55:28,2012-04-06 01:51:27
77536f5cb2ab042ac8be40ba59f36d8f3bd7e4d1...5376a809c0d2bee4b7872847c2821e458dfdcc3b,3,129,41,170,16,2012-04-06 12:39:59,2012-04-06 12:39:59
5376a809c0d2bee4b7872847c2821e458dfdcc3b...d7217cc29c24f582198ce2df7db54a55625e8259,4,57,32,89,14,2012-04-10 21:26:52,2012-04-10 21:18:00
d7217cc29c24f582198ce2df7db54a55625e8259...0e2642d2165ab61f0b141c385cb6b7becdb35401,2,19,1,20,2,2012-04-10 22:25:04,2012-04-02 22:37:02
aabc0d85bb9417542cf04ca68452d751d2dcf515...576607de0f00797f503473299d46155b06dba016,1,6,6,12,4,2012-04-16 01:59:25,2012-04-16 01:59:25
576607de0f00797f503473299d46155b06dba016...6e0b3e8e73d1c3fe6ec52f492f95dd396ddf2d10,1,10,10,20,9,2012-04-16 02:54:18,2012-04-16 02:54:18
9efe4d03df7ce417792152660a0bed36b261676e...d55a764e6e3a5980fb9633df1303418bcb512327,1,6,4,10,2,2012-05-16 21:43:16,2012-05-16 21:43:16
d55a764e6e3a5980fb9633df1303418bcb512327...d12e9b289e65f839da13986f9451e23274f784f1,1,1,0,1,1,2012-05-18 12:47:04,2012-05-18 12:47:04
d12e9b289e65f839da13986f9451e23274f784f1...0a2f93e6df6078072e0b574c368dea9bf1682476,2,8,4,12,3,2012-05-18 16:59:31,2012-05-18 16:40:10
0a2f93e6df6078072e0b574c368dea9bf1682476...8cfdb5c800cdaa19606ca2dbf694285482557552,1,1,1,2,1,2012-05-18 17:15:21,2012-05-18 17:15:21
8cfdb5c800cdaa19606ca2dbf694285482557552...c4df0c91bed4358ddca4b493afc06c69e5b501f0,1,36,0,36,1,2012-05-18 17:24:48,2012-05-18 17:24:48
c4df0c91bed4358ddca4b493afc06c69e5b501f0...f1dcaad09736c194f9148e5bf5fb08498a483a7a,18,651,651,1302,86,2012-05-18 17:28:50,2012-05-18 17:28:50
f1dcaad09736c194f9148e5bf5fb08498a483a7a...6bf3f20d4e0f69ab14702152880a0574623490e2,2,40,27,67,8,2012-05-18 17:48:24,2012-05-18 17:48:24
6bf3f20d4e0f69ab14702152880a0574623490e2...e93f2a89e277d3fffbc15b4ef82ebc3ac6a840f5,3,37,3,40,4,2012-05-18 20:34:30,2012-05-18 20:30:28
e93f2a89e277d3fffbc15b4ef82ebc3ac6a840f5...978acb9caf9ad5e645e1e5188a0120f05822cc81,1,1,0,1,1,2012-05-18 21:01:17,2012-05-18 21:01:17
978acb9caf9ad5e645e1e5188a0120f05822cc81...e0151e5827d7091f311c82d9f951aaaa2688ba8c,4,130,92,222,22,2012-05-21 17:44:19,2012-05-21 17:44:19
e0151e5827d7091f311c82d9f951aaaa2688ba8c...551f8510d516753a803f8d231138f82544dcb45a,2,8,16,24,7,2012-05-22 14:11:47,2012-05-22 14:11:47
551f8510d516753a803f8d231138f82544dcb45a...b5a84a48f4317a188aa78051d4f0cf12db9d7873,1,1,1,2,1,2012-05-22 21:25:46,2012-05-22 21:25:46
b5a84a48f4317a188aa78051d4f0cf12db9d7873...4757881759931bfddf32c26de6831f888b8cd20a,3,34,6,40,4,2012-05-23 01:29:13,2012-05-21 23:01:59
4757881759931bfddf32c26de6831f888b8cd20a...ae20e732f02c7e3bdd76324979b1a816c567ec22,2,125,9,134,8,2012-05-23 02:36:55,2012-05-23 02:36:55
ae20e732f02c7e3bdd76324979b1a816c567ec22...4621a0131b98461e41082aa0aaf73f9c6f4ca9ce,4,224,180,404,46,2012-05-23 03:04:45,2012-05-23 03:04:45
4621a0131b98461e41082aa0aaf73f9c6f4ca9ce...04c06e6858caca13fd9cca71ce80a1fd431f2c41,1,1,1,2,1,2012-05-25 01:04:50,2012-05-24 12:46:38
04c06e6858caca13fd9cca71ce80a1fd431f2c41...d5e5ce5bd006ae94e9d85949b4f7141642cebf81,2,10,1,11,3,2012-05-25 01:39:31,2012-05-25 01:39:31
d5e5ce5bd006ae94e9d85949b4f7141642cebf81...bc7231e3230b8f2c59b3370e7cae6b8a30d53c1e,2,103,110,213,18,2012-05-25 01:54:04,2012-05-25 01:52:35
bc7231e3230b8f2c59b3370e7cae6b8a30d53c1e...d0763a37c683feb3f3148a6dad877402421ab61d,3,27,45,72,7,2012-05-27 16:37:35,2012-05-27 16:37:35
d0763a37c683feb3f3148a6dad877402421ab61d...a4fc2edaab8c92bfebf90a10bd3f23dc7e03f993,3,57,5,62,4,2012-05-28 16:41:58,2012-05-28 16:18:40
a4fc2edaab8c92bfebf90a10bd3f23dc7e03f993...519b225a5b65b6503abf7497a324480aa45e4db2,1,1,1,2,1,2012-05-28 16:43:16,2012-05-28 16:43:16
519b225a5b65b6503abf7497a324480aa45e4db2...3ee332b2382b858bb603f227f15a4212c01d9d69,2,15,10,25,9,2012-05-28 16:43:41,2012-05-28 16:43:41
3ee332b2382b858bb603f227f15a4212c01d9d69...22d2fe367925d4ab4978dcca4866cbdd9c638547,1,1,1,2,1,2012-05-28 17:10:36,2012-05-28 17:10:36
22d2fe367925d4ab4978dcca4866cbdd9c638547...66cf58e79fcd80284b905e17b4765b7b0ce367f8,2,5,2,7,3,2012-05-28 19:07:39,2012-05-28 18:35:01
66cf58e79fcd80284b905e17b4765b7b0ce367f8...fb21faa1bc6fb3f8676aa97cd052f3de5248b4f4,1,1,1,2,1,2012-05-28 20:04:45,2012-05-28 20:04:45
fb21faa1bc6fb3f8676aa97cd052f3de5248b4f4...631f0933b061dc3d22ab3cd1974c5f6d02083f81,1,4,8,12,4,2012-05-28 21:26:35,2012-05-28 05:49:47
631f0933b061dc3d22ab3cd1974c5f6d02083f81...6f7bdf8977e2eb9e6f528218ea5c99653a224c35,2,4,4,8,4,2012-05-28 22:32:20,2012-05-28 22:32:00
6f7bdf8977e2eb9e6f528218ea5c99653a224c35...12a01ee543b9152d3f85753da924841cccf24ac8,1,1,1,2,1,2012-05-28 23:16:23,2012-05-28 23:16:23
12a01ee543b9152d3f85753da924841cccf24ac8...e9e12219796deeff75f70f4be375609ae6eb3283,1,1,1,2,1,2012-05-29 00:10:57,2012-05-28 23:33:00
e9e12219796deeff75f70f4be375609ae6eb3283...9efad09d68db59ccbaa3626bbefe31b2b65fbcfb,1,1,1,2,1,2012-05-29 01:39:31,2012-05-29 01:39:31
9efad09d68db59ccbaa3626bbefe31b2b65fbcfb...82d4c72fb15edd91869afa01a5bca3af678852fb,1,1,0,1,1,2012-05-29 02:20:37,2012-05-29 02:20:37
82d4c72fb15edd91869afa01a5bca3af678852fb...7f2cc46955b35dc3d5a0526d0cb038d4a50b936b,9,434,320,754,42,2012-05-29 02:36:23,2012-05-29 02:25:04
7f2cc46955b35dc3d5a0526d0cb038d4a50b936b...02dd7c570bf4dbbdfc168f4352d04c667447be5d,2,5,3,8,3,2012-05-29 16:04:27,2012-05-29 16:04:27
02dd7c570bf4dbbdfc168f4352d04c667447be5d...a8d9d05388465b16880be43629af008ff19b7725,9,105,16,121,18,2012-05-29 17:13:26,2012-05-29 16:40:13
a8d9d05388465b16880be43629af008ff19b7725...5660b6df505c31dc1b75f08ea886f072a214ccec,1,64,45,109,3,2012-05-29 17:25:02,2012-05-29 17:25:02
5660b6df505c31dc1b75f08ea886f072a214ccec...162ffe729547c889030df7e62207dc34e313c977,1,2,2,4,2,2012-05-29 18:57:37,2012-05-29 18:57:37
162ffe729547c889030df7e62207dc34e313c977...75277c52dcc7aba1682885ac200d568a1c0869c8,1,1,1,2,1,2012-05-29 18:58:34,2012-05-29 18:58:34
75277c52dcc7aba1682885ac200d568a1c0869c8...9c69891d2d621b49f15888cee5309adabeb26c18,1,1,1,2,1,2012-05-29 19:13:53,2012-05-29 19:13:53
9c69891d2d621b49f15888cee5309adabeb26c18...de1d3fa38f65f235fd60cb213c41eb4b32b84c95,1,1,1,2,1,2012-05-29 19:46:33,2012-05-29 19:46:33
de1d3fa38f65f235fd60cb213c41eb4b32b84c95...b4b2e8705879db0a3339a142fddfbb362a08084e,1,1,1,2,1,2012-05-29 20:08:00,2012-05-29 20:08:00
b4b2e8705879db0a3339a142fddfbb362a08084e...66f60ba81883f98bcb087523a209c48470437d89,1,1,1,2,1,2012-05-30 00:48:07,2012-05-30 00:48:07
66f60ba81883f98bcb087523a209c48470437d89...2c57d4cf27fd146d9147971710492a3b7a70d256,1,1,1,2,1,2012-05-30 02:33:17,2012-05-30 02:33:17
2c57d4cf27fd146d9147971710492a3b7a70d256...f313384be3a311fc0f3437a29b710aa1a50f131c,1,1,1,2,1,2012-05-30 15:20:28,2012-05-30 15:20:28
f313384be3a311fc0f3437a29b710aa1a50f131c...3e2a77c5e882b5fc88bf5469ea00067833a2a059,3,28,28,56,20,2012-05-30 17:46:50,2012-05-30 17:46:50
3e2a77c5e882b5fc88bf5469ea00067833a2a059...f633c7f165dc63b0df49159bdea2f3d62c876fe2,1,3,3,6,3,2012-05-30 18:07:59,2012-05-30 18:07:59
f633c7f165dc63b0df49159bdea2f3d62c876fe2...1122c8ce32e685648bf364eb4bb84bb706d7e3b4,2,15,16,31,13,2012-05-30 19:00:30,2012-05-30 18:16:27
1122c8ce32e685648bf364eb4bb84bb706d7e3b4...2d37b6ccb8a5fb9eb47a43221ec10faa693e63c5,1,0,3,3,1,2012-05-31 15:21:53,2012-05-29 04:31:01
2d37b6ccb8a5fb9eb47a43221ec10faa693e63c5...742872984e000ff8e13b9a23e74852d1b549f161,5,126,90,216,19,2012-05-31 15:31:13,2012-05-31 15:31:13
742872984e000ff8e13b9a23e74852d1b549f161...ba70f8aeb60038ae73b188e432c471f3b115a790,3,20,16,36,8,2012-05-31 16:24:44,2012-05-29 12:46:00
ba70f8aeb60038ae73b188e432c471f3b115a790...1442bf944949cabf1b6674a657bfdd642a16da33,1,3,2,5,1,2012-05-31 22:15:57,2012-05-31 22:15:57
1442bf944949cabf1b6674a657bfdd642a16da33...888635f8c17e857ff98a931451ee54aecddabbca,1,2,11,13,5,2012-06-01 15:24:23,2012-05-31 12:32:19
888635f8c17e857ff98a931451ee54aecddabbca...9a3046c3752b80da7526dce34968b8422f3d92f8,1,2,2,4,1,2012-06-03 14:42:24,2012-06-03 14:42:24
9a3046c3752b80da7526dce34968b8422f3d92f8...7c23b77af2477417205fda9bde5208a81e57e40e,47,209,322,531,104,2012-06-04 16:48:18,2012-06-04 16:48:18
7c23b77af2477417205fda9bde5208a81e57e40e...36623de76c6569088d441cbfbca37c0586f19354,9,0,7818,7818,9,2012-06-04 16:53:53,2012-06-04 16:53:53
36623de76c6569088d441cbfbca37c0586f19354...81c7b83d645d2f151e9e40f9f98cc4b70e81a62a,1,2,2,4,2,2012-06-04 16:56:06,2012-06-04 16:56:06
81c7b83d645d2f151e9e40f9f98cc4b70e81a62a...37ffb29d37129293523bf1deacf3609a28b0ceec,25,29,25,54,26,2012-06-04 22:04:11,2012-06-04 22:04:11
37ffb29d37129293523bf1deacf3609a28b0ceec...655350be5d50c44729ffd5ab723345f078cd3649,1,5,1,6,2,2012-06-05 15:52:22,2012-06-05 15:50:49
655350be5d50c44729ffd5ab723345f078cd3649...ef31b678d370570d4cef0128e3fb7da3ae6d0a3e,1,12,16,28,3,2012-06-05 15:59:07,2012-06-05 15:59:07
ef31b678d370570d4cef0128e3fb7da3ae6d0a3e...e0cdeac87b6063b5e5f27f852c6284de6db1e0ca,1,7,0,7,1,2012-06-05 16:16:48,2012-06-05 16:16:48
e0cdeac87b6063b5e5f27f852c6284de6db1e0ca...8265fa08376343d04c7c8c4796ebd4dcc7e3d2e0,3,65,18,83,15,2012-06-05 17:10:01,2012-06-05 17:10:01
8265fa08376343d04c7c8c4796ebd4dcc7e3d2e0...3225d6149655f68939111ffc76a1dffeb329afe9,5,60,56,116,43,2012-06-05 19:29:46,2012-06-05 19:29:46
3225d6149655f68939111ffc76a1dffeb329afe9...e680f36ca096090a6e699ce0eece5b3635a46f47,3,48,21,69,7,2012-06-05 20:38:18,2012-06-05 20:38:18
e680f36ca096090a6e699ce0eece5b3635a46f47...4dcd7dd324fe7362842ce805b05f88929655fc79,2,10,4,14,3,2012-06-06 21:06:03,2012-06-06 21:06:03
4dcd7dd324fe7362842ce805b05f88929655fc79...f5d2bc4db14bba1621a2e1a4baf171acfc9add1a,1,1,1,2,1,2012-06-06 21:38:52,2012-06-06 21:38:52
f5d2bc4db14bba1621a2e1a4baf171acfc9add1a...53a5810bfc7251b9fcb7d0f9fb56853fdceb0273,1,21,1,22,1,2012-06-06 21:39:23,2012-06-06 21:39:23
53a5810bfc7251b9fcb7d0f9fb56853fdceb0273...5d25f78291c11ca26ce70281ee4ac81d1e3d8dd4,1,7,2,9,1,2012-06-06 22:13:59,2012-06-06 22:13:59
5d25f78291c11ca26ce70281ee4ac81d1e3d8dd4...b9b87d53c681a8337cdbdbe81f8f4e577e5ec277,3,29,9,38,6,2012-06-06 23:03:10,2012-06-06 23:03:10
b9b87d53c681a8337cdbdbe81f8f4e577e5ec277...d487b06d93a576e66b81a0620207f083712268d1,2,2,2,4,2,2012-06-07 02:59:55,2012-06-07 02:59:44
d487b06d93a576e66b81a0620207f083712268d1...79af1b457baf6e66fff831e7328e06f823445910,1,3,8,11,2,2012-06-07 03:10:06,2012-06-07 03:10:06
79af1b457baf6e66fff831e7328e06f823445910...c80bc227280e9708dc9c3613ece9397f55f382ed,2,11,1,12,2,2012-06-07 15:08:31,2012-06-07 15:08:31
c80bc227280e9708dc9c3613ece9397f55f382ed...c68ab270fa8269d8b1f3360fc8ed290ba6f0e9a8,5,110,58,168,30,2012-06-07 15:24:35,2012-06-07 15:24:35
c68ab270fa8269d8b1f3360fc8ed290ba6f0e9a8...9fb3c01c37e24f72eb11d89c6a407f1e8cc55eff,1,3,4,7,2,2012-06-07 15:46:45,2012-06-07 15:46:45
9fb3c01c37e24f72eb11d89c6a407f1e8cc55eff...84da1699490c08ee3de636956a446b7f9194f76b,1,8,8,16,8,2012-06-07 15:50:04,2012-06-07 15:50:04
84da1699490c08ee3de636956a446b7f9194f76b...3b2d2b022c7268136070efd8ff2201f738f8cc80,1,135,59,194,34,2012-06-07 15:59:30,2012-06-07 15:59:30
3b2d2b022c7268136070efd8ff2201f738f8cc80...a86ed30f0aa9e656a7b64dda18debb386c27518e,1,3,3,6,3,2012-06-07 16:03:32,2012-06-07 16:03:32
a86ed30f0aa9e656a7b64dda18debb386c27518e...0344a390b7673e2f014dc120a4cc5d3492731369,1,6,5,11,4,2012-06-07 18:36:19,2012-06-07 18:36:19
0344a390b7673e2f014dc120a4cc5d3492731369...1bb1432fe995881821f433c5b7bf86c61f3b3f50,1,7,5,12,1,2012-06-11 01:30:43,2012-06-09 03:11:34
1bb1432fe995881821f433c5b7bf86c61f3b3f50...5f35b3d9f90d07ee084d59702a54051ee51fb0d3,9,149,86,235,37,2012-06-11 01:54:16,2012-06-11 01:54:16
5f35b3d9f90d07ee084d59702a54051ee51fb0d3...ac48a19b92e60f08e5b00a46b5551a503c292fd5,7,68,85,153,27,2012-06-11 12:00:16,2012-06-11 11:59:34
ac48a19b92e60f08e5b00a46b5551a503c292fd5...a47b304f814458fb1f53e1fda82e7ccb7c07189d,1,4,4,8,1,2012-06-11 16:51:28,2012-06-11 16:51:28
a47b304f814458fb1f53e1fda82e7ccb7c07189d...60e7adb3f453765c7784790db0f9a275ece9b681,1,1,1,2,1,2012-06-11 16:55:50,2012-06-11 16:51:42
60e7adb3f453765c7784790db0f9a275ece9b681...eb7a7af46ae38723f02b394ede4f0d74ad615262,1,8,6,14,2,2012-06-11 17:05:16,2012-06-11 17:04:44
eb7a7af46ae38723f02b394ede4f0d74ad615262...1ac15582f2a9d45af5a28a9de88d579c8d97bc23,1,40,49,89,26,2012-06-11 17:24:26,2012-06-11 17:24:26
1ac15582f2a9d45af5a28a9de88d579c8d97bc23...142ff73450c02254a0fd866a0688c4720f8d2bdf,1,1,1,2,1,2012-06-11 18:07:02,2012-06-11 18:07:02
142ff73450c02254a0fd866a0688c4720f8d2bdf...801768386b9fd44f1282834449b4cd1ae1e8d593,2,42,6,48,4,2012-06-11 18:17:36,2012-06-11 18:17:36
801768386b9fd44f1282834449b4cd1ae1e8d593...cac5b08f7215159ccd8ee328b02a7e2355aeb5bb,1,2,2,4,2,2012-06-11 19:04:34,2012-06-11 19:04:34
cac5b08f7215159ccd8ee328b02a7e2355aeb5bb...6af0bcc6262062aa99102a7a9bbde36779f1388f,1,1,1,2,1,2012-06-11 19:56:08,2012-06-11 19:36:29
6af0bcc6262062aa99102a7a9bbde36779f1388f...9e0c056171d1a5cac407f8fedbf926be91eaba1a,1,4,11,15,5,2012-06-11 21:16:19,2012-06-11 21:16:19
9e0c056171d1a5cac407f8fedbf926be91eaba1a...f8c02c886efdf3e42819a960da28738e20bb7a48,1,2,4,6,1,2012-06-11 22:44:54,2012-06-11 22:44:54
f8c02c886efdf3e42819a960da28738e20bb7a48...87e709cfcbac345520d937963730b5cfee47d33d,2,10,5,15,4,2012-06-12 01:01:23,2012-06-12 01:01:23
87e709cfcbac345520d937963730b5cfee47d33d...849303701a889a7efa4c7f239f80092ec17528e9,1,0,106,106,1,2012-06-12 01:18:17,2012-06-11 19:32:24
849303701a889a7efa4c7f239f80092ec17528e9...934a2a703feff091e635cc9da5afb0f30d65d49e,1,2,1,3,1,2012-06-12 01:24:19,2012-06-12 01:17:07
934a2a703feff091e635cc9da5afb0f30d65d49e...6a7f2492d0c15c007f539d400f2e83884d42fe82,1,1,1,2,1,2012-06-12 02:04:43,2012-06-12 02:04:43
6a7f2492d0c15c007f539d400f2e83884d42fe82...83dfb99ea96b7c528667d38bb5e0bcff3dd0f309,2,2,1,3,2,2012-06-12 02:35:04,2012-06-12 02:35:04
83dfb99ea96b7c528667d38bb5e0bcff3dd0f309...501927719cd5b486fae8e2e710cc8e60dbe550ae,1,8,1,9,3,2012-06-12 11:13:18,2012-06-12 11:13:18
501927719cd5b486fae8e2e710cc8e60dbe550ae...47298a7d1686096ddb12199de33deaf404b1a482,1,1,1,2,1,2012-06-12 15:01:44,2012-06-12 15:01:44
47298a7d1686096ddb12199de33deaf404b1a482...f13de6b3d6256f457da0a3c8274ba33656f8df4f,2,81,12,93,15,2012-06-12 16:52:30,2012-06-12 16:52:30
f13de6b3d6256f457da0a3c8274ba33656f8df4f...9c9bc5aa3bfa8dafc208862f26afbdc3f518b187,1,1,1,2,1,2012-06-12 16:53:58,2012-06-12 16:53:58
9c9bc5aa3bfa8dafc208862f26afbdc3f518b187...7c16273b1c5d7dd4377adf9d82063edb5c61429c,1,1,1,2,1,2012-06-13 22:31:28,2012-06-13 22:31:28
7c16273b1c5d7dd4377adf9d82063edb5c61429c...1ea4fe705207476698e7768036343b2ebe3bb31f,1,1,1,2,1,2012-06-13 22:33:10,2012-06-13 22:33:10
1ea4fe705207476698e7768036343b2ebe3bb31f...8f944a1b5c0abce054cf9e6ac4010c782557ce26,2,32,16,48,8,2012-06-15 06:09:38,2012-06-15 06:09:38
8f944a1b5c0abce054cf9e6ac4010c782557ce26...a7430dfb12f2bcf10bd51ec0bab4832791c0aa9f,1,14,26,40,7,2012-06-15 13:23:42,2012-06-15 13:22:58
a7430dfb12f2bcf10bd51ec0bab4832791c0aa9f...e64f89d9aaf26c2dae6c7f1ef29a2d3cadd0b4b2,1,1,1,2,1,2012-06-15 13:56:04,2012-06-15 13:56:04
e64f89d9aaf26c2dae6c7f1ef29a2d3cadd0b4b2...8763bec032bc2dc10bf0d6686b820b731b525091,1,1,1,2,1,2012-06-15 18:24:31,2012-06-15 18:24:22
8763bec032bc2dc10bf0d6686b820b731b525091...75bed122e134d36bf28bacd475fb4bfa9659eb39,1,1,1,2,1,2012-06-15 20:10:45,2012-06-15 20:10:37
75bed122e134d36bf28bacd475fb4bfa9659eb39...46d680458b74fcf956f6161a2b73b6b00fc2541d,1,2,2,4,2,2012-06-16 00:45:37,2012-06-16 00:44:07
46d680458b74fcf956f6161a2b73b6b00fc2541d...a101e81bde71e94170f1fa899432cbe8150910f9,9,64,69,133,48,2012-06-16 01:01:44,2012-06-16 01:01:44
a101e81bde71e94170f1fa899432cbe8150910f9...0b352f6cb58a1ece3f5d1fb978cdb40bd5b0e854,4,46,17,63,12,2012-06-16 01:25:25,2012-06-16 01:20:41
0b352f6cb58a1ece3f5d1fb978cdb40bd5b0e854...9c28a320c3fa6dcc06de4919d24da41451843570,2,71,37,108,13,2012-06-16 01:37:01,2012-06-16 01:37:01
9c28a320c3fa6dcc06de4919d24da41451843570...ea9ec9527647f0cea396ca536e6f34b4a4491d11,2,29,4,33,9,2012-06-16 02:29:02,2012-06-16 02:17:05
ea9ec9527647f0cea396ca536e6f34b4a4491d11...a416e2ba0d10bf1e1e94b5d023543d38ad08fcfb,1,1,0,1,1,2012-06-16 14:57:41,2012-06-16 14:57:41
a416e2ba0d10bf1e1e94b5d023543d38ad08fcfb...80295ed0e54f30ce91d652920454c61c9dd06a09,2,1,2,3,2,2012-06-17 19:42:57,2012-06-17 19:42:35
80295ed0e54f30ce91d652920454c61c9dd06a09...ab542c11cafd494e15bd84df3958a5e8876f02fe,1,6,2,8,4,2012-06-18 17:25:37,2012-06-18 17:25:24
ab542c11cafd494e15bd84df3958a5e8876f02fe...f7ee1f6e59f0b465f5f64bf6ac52108e445efaac,2,13,6,19,6,2012-06-18 17:27:04,2012-06-18 17:26:46
f7ee1f6e59f0b465f5f64bf6ac52108e445efaac...bab641a113dce7638bd17ea2eb0675abf0daa6ba,1,4,4,8,1,2012-06-18 17:28:47,2012-06-18 17:28:47
bab641a113dce7638bd17ea2eb0675abf0daa6ba...90a6a493e4aed3e2eb67c233a0374260487cf0a4,1,3,3,6,3,2012-06-18 17:52:05,2012-06-18 17:52:05
90a6a493e4aed3e2eb67c233a0374260487cf0a4...c31a5ee9aaf80a2f36a30cbede9b30de56a05d44,1,1,1,2,1,2012-06-18 18:17:10,2012-06-18 18:17:10
c31a5ee9aaf80a2f36a30cbede9b30de56a05d44...5c37506540550bfc596489d2bef93ac53adbe6e3,1,1,1,2,1,2012-06-18 18:33:37,2012-06-18 18:33:29
5c37506540550bfc596489d2bef93ac53adbe6e3...c18f1f119e07b08793ffb1e98621170f5f2eaba4,1,6,7,13,5,2012-06-18 20:02:26,2012-06-18 20:02:26
c18f1f119e07b08793ffb1e98621170f5f2eaba4...713cc8609637a943f77039726d96f5e9f7a36f2b,4,23,115,138,16,2012-06-19 03:10:32,2012-06-18 22:43:50
713cc8609637a943f77039726d96f5e9f7a36f2b...2e5d6452876caca921054108180a70a168a77c0d,1,1,1,2,1,2012-06-19 04:40:04,2012-06-19 04:40:04
2e5d6452876caca921054108180a70a168a77c0d...ccffddd89b5fd6ce9388d1db52361c59649b132a,1,1,1,2,1,2012-06-19 05:50:03,2012-06-19 05:50:03
ccffddd89b5fd6ce9388d1db52361c59649b132a...fcd6ea84653d0bfb0d0444bf7508878c39c8b6d2,1,1,1,2,1,2012-06-19 06:23:16,2012-06-19 06:23:16
fcd6ea84653d0bfb0d0444bf7508878c39c8b6d2...868a9cea08579ae635ce258aed3062705a8d2379,1,1,1,2,1,2012-06-19 15:00:16,2012-06-19 15:00:16
868a9cea08579ae635ce258aed3062705a8d2379...7692ae419d4c19bd06a0ba01fc2af8d21035873c,2,8,2,10,3,2012-06-19 15:35:45,2012-06-19 15:35:45
7692ae419d4c19bd06a0ba01fc2af8d21035873c...286c4d91dde12ba32f4a56273d05374b1cbb79e7,1,5,1,6,2,2012-06-19 21:11:05,2012-06-19 21:11:05
286c4d91dde12ba32f4a56273d05374b1cbb79e7...239fc86b01d52fd9df6d1963027ed37b4f6251fc,2,3,6,9,4,2012-06-20 15:19:24,2012-06-20 15:19:24
239fc86b01d52fd9df6d1963027ed37b4f6251fc...cc9bc0bb6b4ea729c427223c7296c2395423b081,1,1,1,2,1,2012-06-20 15:41:58,2012-06-20 14:18:52
cc9bc0bb6b4ea729c427223c7296c2395423b081...c8d5734e5bfafe7a5c7ede8ca87b412e79f3c22b,1,1,1,2,1,2012-06-20 15:55:32,2012-06-20 15:55:32
c8d5734e5bfafe7a5c7ede8ca87b412e79f3c22b...f3515b735e4ee00bb686922b2e1565934da845f8,1,1,1,2,1,2012-06-20 16:52:41,2012-06-20 16:52:41
f3515b735e4ee00bb686922b2e1565934da845f8...bc9945a6a466e3431260615c2e663ca8848095e7,1,5,1,6,3,2012-06-21 00:39:22,2012-06-21 00:39:22
bc9945a6a466e3431260615c2e663ca8848095e7...c20e031058c6210a1ed753f75af80588f076d60d,2,6,3,9,4,2012-06-21 15:38:31,2012-06-20 20:19:06
c20e031058c6210a1ed753f75af80588f076d60d...6cdca88eee674e48f9bf0e41fca18f75f32426b7,2,6,7,13,3,2012-06-21 15:38:31,2012-06-20 20:22:36
6cdca88eee674e48f9bf0e41fca18f75f32426b7...66501469c0c21107837375538a13273e32fdc7cf,1,38,41,79,9,2012-06-21 17:40:59,2012-06-21 17:40:59
66501469c0c21107837375538a13273e32fdc7cf...7ff3da186cf9bb5ea23f5a0b9543302ef0f861f7,17,394,283,677,221,2012-06-21 19:30:24,2012-06-21 19:30:24
7ff3da186cf9bb5ea23f5a0b9543302ef0f861f7...e2497c682f26b7916d76cb2896c6fe621b376d82,2,60,17,77,7,2012-06-21 19:39:04,2012-06-21 19:28:57
e2497c682f26b7916d76cb2896c6fe621b376d82...26bdbb806eeb1d8e1881b3fc11ff298eb4d1dca0,1,4,9,13,3,2012-06-21 19:57:12,2012-06-21 19:57:12
26bdbb806eeb1d8e1881b3fc11ff298eb4d1dca0...d5658e978d9a7234e537d57c45069ce223cb3853,1,1,4,5,1,2012-06-21 20:03:11,2012-06-21 20:03:11
d5658e978d9a7234e537d57c45069ce223cb3853...ad8dc12ac28915891127666d5b6c2d3200d1e79c,1,3,1,4,3,2012-06-22 13:46:07,2012-06-22 13:46:07
ad8dc12ac28915891127666d5b6c2d3200d1e79c...2236c55b9135dc9867218cc35b713bacdd0a8350,1,1,1,2,1,2012-06-22 17:28:03,2012-06-22 17:28:03
2236c55b9135dc9867218cc35b713bacdd0a8350...d2b0c60840b09a66c9d72bba635d0c29d3e7565e,1,1,1,2,1,2012-06-22 17:30:16,2012-06-22 17:30:16
d2b0c60840b09a66c9d72bba635d0c29d3e7565e...9bb3494ce99889e05a7333e38e4da9579ce6af8e,2,16,1,17,2,2012-06-22 19:57:46,2012-06-18 02:42:24
9bb3494ce99889e05a7333e38e4da9579ce6af8e...36369ce50ff276dcf2959add7dc949af83b221c2,2,109,37,146,22,2012-06-22 20:11:12,2012-06-22 20:03:39
36369ce50ff276dcf2959add7dc949af83b221c2...4df3aaeab3f5c1f54d7564fe9973f6bf35664265,1,1,1,2,1,2012-06-22 20:21:09,2012-06-22 20:21:09
4df3aaeab3f5c1f54d7564fe9973f6bf35664265...3206be877250f5fe958a0519ef19d52e277687ca,2,21,12,33,8,2012-06-23 23:38:27,2012-06-23 23:38:27
3206be877250f5fe958a0519ef19d52e277687ca...d4b5a1974d2b60989e9fe1158ce0b8c1f577c2d1,1,1,1,2,1,2012-06-23 23:43:12,2012-06-23 23:43:12
d4b5a1974d2b60989e9fe1158ce0b8c1f577c2d1...b47147118c8f291e7db34b377706b6f48ac45b3e,1,1,1,2,1,2012-06-24 19:33:04,2012-06-24 19:33:04
b47147118c8f291e7db34b377706b6f48ac45b3e...a2758377df7eef02d155a30f869bdc3d8b7c02b9,9,100,77,177,24,2012-06-25 14:02:28,2012-06-25 14:02:28
a2758377df7eef02d155a30f869bdc3d8b7c02b9...c436ae04de80f8d232b5456f605331ecfaba4f49,2,21,6,27,7,2012-06-25 14:34:25,2012-06-23 21:50:57
c436ae04de80f8d232b5456f605331ecfaba4f49...96246332f723b0f83e465d0f9f580741c8272f80,4,114,60,174,9,2012-06-25 14:49:21,2012-06-25 14:49:21
96246332f723b0f83e465d0f9f580741c8272f80...375c44d9c715051940a1b9fa5fbafb5c021b6a96,1,1,1,2,1,2012-06-25 16:44:57,2012-06-25 16:44:57
375c44d9c715051940a1b9fa5fbafb5c021b6a96...9cbe375a55dde24f98cd56c4f541473c01de1ff9,1,3,4,7,3,2012-06-26 13:16:29,2012-06-26 13:16:29
9cbe375a55dde24f98cd56c4f541473c01de1ff9...babf81570c0d7f1de4f16d4f2927058de1799e45,1,4,1,5,1,2012-06-26 18:45:21,2012-06-26 18:45:21
babf81570c0d7f1de4f16d4f2927058de1799e45...7a9b57aa691411e4d0eab56e4132673a4c7f4b00,1,1,1,2,1,2012-06-26 18:46:46,2012-06-26 18:46:46
7a9b57aa691411e4d0eab56e4132673a4c7f4b00...b6d02735e955523adcf88ff92b3bc7ecb144c624,1,4,1,5,2,2012-06-26 18:49:56,2012-06-26 18:49:56
b6d02735e955523adcf88ff92b3bc7ecb144c624...eecd8aef671d6a8720b4f66ee22b3d01ef1b951b,1,1,1,2,1,2012-06-26 20:39:46,2012-06-26 20:39:46
eecd8aef671d6a8720b4f66ee22b3d01ef1b951b...53eb2305fb4e46f9ba08c1a41cdbb78b53787db9,2,3,3,6,3,2012-06-26 20:55:40,2012-06-26 20:55:40
53eb2305fb4e46f9ba08c1a41cdbb78b53787db9...cde4c326b82af4679026a202f02799e9fbd18cb4,2,3,2,5,3,2012-06-26 21:08:49,2012-06-26 21:08:49
cde4c326b82af4679026a202f02799e9fbd18cb4...3c86547a3b841807c4744af0fa4ee3894cc17a33,1,0,1,1,1,2012-06-26 21:57:45,2012-06-26 21:56:56
3c86547a3b841807c4744af0fa4ee3894cc17a33...ad2221853f839c15305f539b7b373241dfb6d628,2,2,1,3,2,2012-06-27 04:41:33,2012-06-27 04:31:19
ad2221853f839c15305f539b7b373241dfb6d628...94e744aec9d25bb64a3cb72c3b81dd95e94d3955,2,15,1,16,2,2012-06-27 15:54:04,2012-06-27 00:36:00
94e744aec9d25bb64a3cb72c3b81dd95e94d3955...8a01c9201abb3a5311d5b0019b0322de89df6374,2,16,7,23,5,2012-06-27 15:58:16,2012-06-27 01:38:30
8a01c9201abb3a5311d5b0019b0322de89df6374...7cf927cb08a3b6a82f24b32dd14f84a5273daa30,1,1,1,2,1,2012-06-28 18:15:54,2012-06-27 17:26:11
7cf927cb08a3b6a82f24b32dd14f84a5273daa30...304eebb260fe37d4105d78be8c5c90d1ccce2e39,1,1,1,2,1,2012-06-28 18:15:54,2012-06-28 18:15:27
46d0a5cfabb674700ee146aeae5a8ff8cd5852c9...8fadc5ba01bc517ebb07736d5af9a965ed133a39,1,2,1,3,2,2012-04-17 01:42:27,2012-04-16 13:43:59
8fadc5ba01bc517ebb07736d5af9a965ed133a39...abd2a07498afa48a4ec3ce0471b9b0b4fc812b55,3,23,17,40,7,2012-04-17 01:57:41,2012-04-17 01:57:41
abd2a07498afa48a4ec3ce0471b9b0b4fc812b55...9ebc27db54194c88fa7aed29a8c648c330300ac8,2,1,10,11,2,2012-04-18 17:04:44,2012-04-18 17:04:04
9ebc27db54194c88fa7aed29a8c648c330300ac8...1434b5b56756d02190afe552b626823c97b11a49,3,193,1,194,3,2012-04-18 20:07:35,2012-04-18 20:07:35
1434b5b56756d02190afe552b626823c97b11a49...6cf1542a8b823c6bdacf7e6e01dfcb58e9949ff4,1,2,1,3,1,2012-04-18 21:00:44,2012-04-18 21:00:44
6cf1542a8b823c6bdacf7e6e01dfcb58e9949ff4...3e6f94c36046e927121e2b25174f1ecd2e45d65b,1,1,1,2,1,2012-04-19 14:43:26,2012-04-19 14:43:26
3e6f94c36046e927121e2b25174f1ecd2e45d65b...8ebb2f4793d2c464888b5f0dba97fb5c9d0c9541,2,55,4,59,7,2012-04-20 01:02:20,2012-04-20 01:02:20
8ebb2f4793d2c464888b5f0dba97fb5c9d0c9541...df2a22ee6149595b212ef7dca73535a853969f7b,1,20,4,24,5,2012-04-20 14:55:07,2012-04-20 14:55:07
df2a22ee6149595b212ef7dca73535a853969f7b...d3b61de52084353646e1abee7dc7a76c63237b9b,1,4,10,14,4,2012-04-20 18:18:15,2012-04-20 18:18:15
304eebb260fe37d4105d78be8c5c90d1ccce2e39...672701add1ddaf3988d84beaee6508f1e738def1,3,25,21,46,4,2012-06-30 00:47:59,2012-06-29 16:37:33
672701add1ddaf3988d84beaee6508f1e738def1...3d822afbe8929b04d4ca17c6abb7afb7eeccbceb,1,1,1,2,1,2012-06-30 18:53:47,2012-06-30 18:53:47
3d822afbe8929b04d4ca17c6abb7afb7eeccbceb...f18b75940e61a52ef9c0cf41a4bda3bcdae5c46c,1,1,1,2,1,2012-06-30 19:53:15,2012-06-30 19:53:15
f18b75940e61a52ef9c0cf41a4bda3bcdae5c46c...f71a6ec6cfe3f748a939eaa109e92b8a9bdac6cc,1,41,15,56,5,2012-07-02 15:34:26,2012-07-01 20:35:50
f71a6ec6cfe3f748a939eaa109e92b8a9bdac6cc...b418fa1f0937b5c92085778b0e935f94dcf46dbd,6,29,16,45,22,2012-07-02 15:34:26,2012-07-02 15:30:22
b418fa1f0937b5c92085778b0e935f94dcf46dbd...800f47a5476a64501d7bbaaf43e498963cf804d8,2,2,2,4,2,2012-07-02 19:24:33,2012-07-02 19:24:33
800f47a5476a64501d7bbaaf43e498963cf804d8...6e36cbf90e0067dfc638ac8700f6fcbc7927e17f,1,1,1,2,1,2012-07-02 21:52:42,2012-07-02 21:42:41
6e36cbf90e0067dfc638ac8700f6fcbc7927e17f...b414fe1b0150db68e44f2be3c0b2b265b5dd0bf5,2,4,4,8,3,2012-07-03 01:35:00,2012-07-03 01:35:00
b414fe1b0150db68e44f2be3c0b2b265b5dd0bf5...accb3c4932055692221ba7d21e207680df8017b3,1,1,1,2,1,2012-07-03 02:19:33,2012-07-03 02:19:33
accb3c4932055692221ba7d21e207680df8017b3...26f88d3de41ffeb006d7e235b3eb353023a5156f,1,1,1,2,1,2012-07-03 02:49:23,2012-07-03 02:49:23
26f88d3de41ffeb006d7e235b3eb353023a5156f...5c200cf036c98e298345307db3354131921dae63,1,1,1,2,1,2012-07-03 03:01:16,2012-07-03 03:01:16
5c200cf036c98e298345307db3354131921dae63...cdae7479a81d801a073423f560e96d519a2b301b,1,1,1,2,1,2012-07-03 04:16:14,2012-07-03 04:16:14
cdae7479a81d801a073423f560e96d519a2b301b...d8db54a056289cce647a5ba98be7453f000ef0ed,1,1,1,2,1,2012-07-03 14:31:28,2012-07-03 14:31:28
d8db54a056289cce647a5ba98be7453f000ef0ed...330eb3bb79708761c897d66cf961c3eb5450c53c,1,1,1,2,1,2012-07-03 15:22:47,2012-07-03 15:22:47
330eb3bb79708761c897d66cf961c3eb5450c53c...461256a7114752824b15ef302c8b2481deee90b4,1,1,1,2,1,2012-07-03 17:54:42,2012-07-03 17:54:42
461256a7114752824b15ef302c8b2481deee90b4...b325f7161c32a9dc8dfb49e5009af1b7f04ae276,1,1,1,2,1,2012-07-03 18:09:01,2012-07-03 18:09:01
b325f7161c32a9dc8dfb49e5009af1b7f04ae276...d7372b180cebd5346b0f3fc404e047cc6327874c,1,1,1,2,1,2012-07-03 19:06:36,2012-07-03 19:06:36
d7372b180cebd5346b0f3fc404e047cc6327874c...9feb945e9d5b155ea2691301edd1cb98ecc492aa,1,1,1,2,1,2012-07-03 20:04:10,2012-07-03 20:04:10
9feb945e9d5b155ea2691301edd1cb98ecc492aa...cef416116d9c954cf3fe0778d407578996a07b8a,1,1,1,2,1,2012-07-03 22:07:00,2012-07-03 22:07:00
cef416116d9c954cf3fe0778d407578996a07b8a...5c60e334d35df7065b7c09073f5aeaed58fd427d,1,10,5,15,5,2012-07-04 02:17:37,2012-07-04 02:17:37
5c60e334d35df7065b7c09073f5aeaed58fd427d...703f274ad4a4a00024e0bdfbcdf10c3c97488df1,1,8,3,11,4,2012-07-04 02:54:59,2012-07-04 02:54:59
703f274ad4a4a00024e0bdfbcdf10c3c97488df1...f661b9ea5e3750681e2f08e7bade045c5bc934ca,2,3,2,5,2,2012-07-04 03:09:44,2012-07-04 03:09:44
f661b9ea5e3750681e2f08e7bade045c5bc934ca...7f8178033f758bd941dfb2d320d86e4af114c945,1,1,1,2,1,2012-07-04 16:40:31,2012-07-04 16:40:18
7f8178033f758bd941dfb2d320d86e4af114c945...9a40b1848a77e106d8ff96d40ca01d9b325f63bc,1,1,1,2,1,2012-07-04 20:55:31,2012-07-04 20:55:31
9a40b1848a77e106d8ff96d40ca01d9b325f63bc...3dc77c4bfa08aba020cac17e87bca04fb217cedf,1,1,1,2,1,2012-07-05 18:52:05,2012-07-05 18:52:05
3dc77c4bfa08aba020cac17e87bca04fb217cedf...de9bed319e44cb01986fb1751ceb64266bba3f95,14,587,576,1163,333,2012-07-05 19:52:42,2012-07-05 19:52:13
de9bed319e44cb01986fb1751ceb64266bba3f95...43f24d50ec1f9de0cc7ebdd5340e07f9057a5a19,1,1,1,2,1,2012-07-05 20:38:35,2012-07-05 20:38:07
43f24d50ec1f9de0cc7ebdd5340e07f9057a5a19...1e027610d6000494558da753ce5601a05319408b,1,1,1,2,1,2012-07-05 20:41:53,2012-07-05 20:41:53
1e027610d6000494558da753ce5601a05319408b...cdd5132dcc02d4a3ff8df390677ffb8ff4b5a477,2,13,16,29,8,2012-07-05 21:21:58,2012-07-05 21:21:58
cdd5132dcc02d4a3ff8df390677ffb8ff4b5a477...86b775d036627ebd7242fbb4eb9f24e4ba1fa9c5,1,0,4,4,1,2012-07-05 21:46:08,2012-07-05 21:46:08
86b775d036627ebd7242fbb4eb9f24e4ba1fa9c5...1793eab32bc8a00b2ad041c9b10ad3bdd2bec702,3,47,11,58,12,2012-07-06 01:38:17,2012-06-26 17:48:31
304eebb260fe37d4105d78be8c5c90d1ccce2e39...a69fbbaa8bbb2f17d798bb05cca24b01fddcd2a2,2,26,26,52,22,2012-06-29 01:39:58,2012-06-29 01:39:58
d3b61de52084353646e1abee7dc7a76c63237b9b...78583d0cd90bf1031c1846e5f728a2adb37949ff,1,1,1,2,1,2012-04-22 21:49:16,2012-04-22 21:49:16
d3b61de52084353646e1abee7dc7a76c63237b9b...b0ea80e9fd35286c1cd68216c512712dff1f145d,1,55,51,106,14,2012-04-22 15:36:44,2012-04-22 15:36:44
b0ea80e9fd35286c1cd68216c512712dff1f145d...2d1247a413f889f711a77a12de63d79dfe14f069,1,1,1,2,1,2012-04-22 15:40:02,2012-04-22 15:40:02
2d1247a413f889f711a77a12de63d79dfe14f069...180a997da5fffa619a468eec2f391cdd75aa06dc,1,1,2,3,1,2012-04-22 18:53:36,2012-04-22 18:53:36
7532bd7df56d8654733ec06617e80447743f2adc...f8baea8f7a8b23d0e25c0dc82670fbe48b9bf587,2,63,74,137,21,2012-07-06 13:22:44,2012-07-06 13:22:44
f8baea8f7a8b23d0e25c0dc82670fbe48b9bf587...05aff402310d7db5d15f96b15071af6aa21a2afc,3,12,16,28,6,2012-07-06 13:48:52,2012-06-28 00:55:36
05aff402310d7db5d15f96b15071af6aa21a2afc...aaf134bb7092efe7b450fc08ca5cc3c53cb00d76,3,8,2,10,4,2012-07-06 14:01:32,2012-07-06 13:58:34
aaf134bb7092efe7b450fc08ca5cc3c53cb00d76...f5fd41252e3ae48a655c5da4a0b2910bb897b6ed,7,77,34,111,16,2012-07-06 14:12:20,2012-07-06 14:12:20
f5fd41252e3ae48a655c5da4a0b2910bb897b6ed...00d160331ab1cefab8130cc45afac09e1deda439,1,1,1,2,1,2012-07-06 15:11:54,2012-07-06 15:09:27
00d160331ab1cefab8130cc45afac09e1deda439...3f579f342df2cc92df8559e5ab97c110572e23ff,1,1,1,2,1,2012-07-06 15:16:38,2012-07-06 15:16:38
3f579f342df2cc92df8559e5ab97c110572e23ff...115fc4cec27ad38882042821cc29a38a406044c3,1,1,1,2,1,2012-07-06 23:14:34,2012-07-06 23:14:34
115fc4cec27ad38882042821cc29a38a406044c3...c5259bf137023b5454de5df8d6763f3393347709,1,1,1,2,1,2012-07-07 16:44:05,2012-07-07 16:44:05
c5259bf137023b5454de5df8d6763f3393347709...c8e8d905f8009952e54f53a17f15b3ffcd9b6749,1,1,1,2,1,2012-07-07 17:10:10,2012-07-07 17:10:10
c8e8d905f8009952e54f53a17f15b3ffcd9b6749...dc83072878ed9636c8158a014bd9fa4acc1ccce3,1,6,3,9,5,2012-07-07 21:28:35,2012-07-07 21:24:16
dc83072878ed9636c8158a014bd9fa4acc1ccce3...0b06932072d854d837d6a6991adf88294f068faf,1,1,1,2,1,2012-07-09 15:05:33,2012-07-09 15:05:25
0b06932072d854d837d6a6991adf88294f068faf...7fae98c55b3aed94abcfea1c0b0933c42c7220a0,1,1,1,2,1,2012-07-09 15:13:00,2012-07-09 15:13:00
7fae98c55b3aed94abcfea1c0b0933c42c7220a0...4a90bced777c7a4801fca240f5f9f7f02fb1d2b7,1,36,3,39,2,2012-07-09 15:21:35,2012-07-09 15:21:35
4a90bced777c7a4801fca240f5f9f7f02fb1d2b7...e0d77fab567d9495da3892cdc42ed2e89de32644,1,31,31,62,4,2012-07-09 15:23:55,2012-07-09 15:23:55
e0d77fab567d9495da3892cdc42ed2e89de32644...f30f7732e7775b6e417c4c22ced7adb2bf76bf89,1,1,1,2,1,2012-07-09 15:38:25,2012-07-09 15:38:25
f30f7732e7775b6e417c4c22ced7adb2bf76bf89...8f01b92b8fd85a66f2cba671f8b9ff6f7095c34b,12,147,135,282,73,2012-07-10 01:39:22,2012-07-10 01:38:11
8f01b92b8fd85a66f2cba671f8b9ff6f7095c34b...3dbf9a8d5e22ff6ab30b6f2c3678aa011920ae63,1,1,1,2,1,2012-07-10 02:08:00,2012-07-10 02:07:47
3dbf9a8d5e22ff6ab30b6f2c3678aa011920ae63...376f4e8cf637e76445082d7fdb88ab420d488b5c,1,7,0,7,1,2012-07-10 02:40:35,2012-07-09 06:56:42
376f4e8cf637e76445082d7fdb88ab420d488b5c...21b0db7993315f0a5390798fefe63eb21891493e,4,14,3,17,5,2012-07-10 03:06:51,2012-07-10 03:06:51
21b0db7993315f0a5390798fefe63eb21891493e...3384213df9cf64e9b5cc9eb67ad17b3bc3e6e3a0,1,1,1,2,1,2012-07-10 03:20:36,2012-07-10 03:20:22
3384213df9cf64e9b5cc9eb67ad17b3bc3e6e3a0...b6cb4b420fc0ddf47d94fc867df5d1ec487438b6,1,1,1,2,1,2012-07-10 03:48:09,2012-07-10 03:48:09
b6cb4b420fc0ddf47d94fc867df5d1ec487438b6...f843a7062fef5a262c244575712b8173ced7c1a2,2,10,3,13,4,2012-07-10 14:14:43,2012-07-10 14:14:43
f843a7062fef5a262c244575712b8173ced7c1a2...5bfded1dc678aa843bb60aa60b361f7e45ff9fec,1,1,1,2,1,2012-07-10 16:09:05,2012-07-10 16:06:18
5bfded1dc678aa843bb60aa60b361f7e45ff9fec...1f483f354db3f499f519519eab5225a0d2c28f18,1,1,0,1,1,2012-07-10 16:12:55,2012-07-10 16:12:01
1f483f354db3f499f519519eab5225a0d2c28f18...f73b9479262e6cf8057f29ee74a962cb08c7830c,1,2,2,4,2,2012-07-10 16:52:21,2012-07-10 16:48:53
f73b9479262e6cf8057f29ee74a962cb08c7830c...a7df439e24e9b087a540ef7c658e5fec65d538c8,1,1,1,2,1,2012-07-10 21:22:44,2012-07-10 21:22:44
a7df439e24e9b087a540ef7c658e5fec65d538c8...662380014fbc90fad02878e3ae5c08ba755b5db9,1,1,1,2,1,2012-07-10 21:24:06,2012-07-10 21:24:06
662380014fbc90fad02878e3ae5c08ba755b5db9...335bdf2b1a296cc1e77afe5e33727bf33150443b,2,3,3,6,2,2012-07-11 01:44:03,2012-07-11 01:44:03
335bdf2b1a296cc1e77afe5e33727bf33150443b...d8f9dece24f5c8ca26cc455879e9744c697df488,1,1,1,2,1,2012-07-11 13:39:43,2012-07-11 13:39:18
d8f9dece24f5c8ca26cc455879e9744c697df488...c210e08c3a73dca302afee24186b48f62ada9fba,1,3,0,3,3,2012-07-11 13:42:02,2012-07-11 13:42:02
c210e08c3a73dca302afee24186b48f62ada9fba...7b5ffcdac8e1cc4b110690cddc6345f44ae0aaab,6,19,19,38,19,2012-07-11 13:46:21,2012-07-11 13:46:21
7b5ffcdac8e1cc4b110690cddc6345f44ae0aaab...faf2eb4a8f9ff26f43773128ed2be8283314b3b6,1,15,4,19,6,2012-07-11 13:54:34,2012-07-11 13:54:01
faf2eb4a8f9ff26f43773128ed2be8283314b3b6...d67c2fd863216453ea4fc9b1a7cafd890506549e,1,2,2,4,2,2012-07-11 21:17:47,2012-07-11 21:17:47
d67c2fd863216453ea4fc9b1a7cafd890506549e...0bde43aeee5bed5fdfb5bffaecb8c1f43c8fdf19,1,1,1,2,1,2012-07-11 21:23:15,2012-07-11 21:00:21
0bde43aeee5bed5fdfb5bffaecb8c1f43c8fdf19...f4e5c1729a2efe6086ac2407f82e928b26991f83,3,29,22,51,8,2012-07-12 03:09:07,2012-07-12 02:46:34
f4e5c1729a2efe6086ac2407f82e928b26991f83...db4d122ff115f925fac5afc8a5a7ce41c4335d9d,1,1,1,2,1,2012-07-12 13:58:59,2012-07-12 13:58:59
db4d122ff115f925fac5afc8a5a7ce41c4335d9d...60e249437c3324b82124da70941a3b88cfc48a3d,1,2,2,4,2,2012-07-12 14:08:24,2012-07-11 21:33:53
60e249437c3324b82124da70941a3b88cfc48a3d...8f1f88a5da6d70ca10a59c0fe0250519db766e37,1,1,1,2,1,2012-07-12 15:37:25,2012-07-12 15:37:25
8f1f88a5da6d70ca10a59c0fe0250519db766e37...2d09e9a325c730c31ada7b68fa46e345ac5535e0,1,1,1,2,1,2012-07-12 15:57:28,2012-07-12 15:57:28
2d09e9a325c730c31ada7b68fa46e345ac5535e0...e866893fd29b0328ebc282cf0ba716e6f87384c3,1,0,8,8,1,2012-07-12 19:10:58,2012-07-12 18:54:43
e866893fd29b0328ebc282cf0ba716e6f87384c3...c29660c5936b76787c4a864d8188b325bc81a81f,1,8,0,8,1,2012-07-12 19:28:58,2012-07-12 19:28:58
c29660c5936b76787c4a864d8188b325bc81a81f...ced5e9037a8a1d7306fa6c735ba7f314022c3289,6,301,292,593,26,2012-07-13 07:47:43,2012-07-13 07:44:21
ced5e9037a8a1d7306fa6c735ba7f314022c3289...0d9006531d2b991cdbf419e1b4b0b4e03a588b10,1,1,1,2,1,2012-07-13 07:59:20,2012-07-13 07:59:20
0d9006531d2b991cdbf419e1b4b0b4e03a588b10...f70a696598f14917e49dc108271788e2ec2f6587,1,1,1,2,1,2012-07-18 03:04:03,2012-07-18 03:04:03
f70a696598f14917e49dc108271788e2ec2f6587...30168722204633e49ca9d47ecb6b43d80a4653a4,2,79,2,81,3,2012-07-20 02:02:37,2012-07-20 02:02:37
30168722204633e49ca9d47ecb6b43d80a4653a4...94924a05dec8513f285411491702900bb741713e,2,15,1,16,2,2012-07-20 23:36:55,2012-07-20 23:36:55
94924a05dec8513f285411491702900bb741713e...ff7a43456228826856f5f14f22fbe2d61ef59bf5,2,108,62,170,12,2012-07-23 01:49:39,2012-07-23 01:49:39
ff7a43456228826856f5f14f22fbe2d61ef59bf5...aa3fabce461313f7c31e9a250df57165f15be873,4,21,14,35,9,2012-07-23 02:03:27,2012-07-23 01:58:23
aa3fabce461313f7c31e9a250df57165f15be873...74cc5b0984335532ab272b8286566000c4bf3daf,1,11,0,11,1,2012-07-23 02:13:31,2012-07-13 21:03:21
74cc5b0984335532ab272b8286566000c4bf3daf...c14a6b385fa419ce67f115e853fb4a89d8bd8fad,8,27,25,52,18,2012-07-23 02:23:32,2012-07-23 02:23:32
c14a6b385fa419ce67f115e853fb4a89d8bd8fad...a08a18b80adc403dc2914ee6b1ca8752aeddef30,1,1,1,2,1,2012-07-23 16:48:05,2012-07-23 16:48:05
a08a18b80adc403dc2914ee6b1ca8752aeddef30...e761e0c6e0561093ff1e52d0cba6ace04daa8798,2,14,11,25,8,2012-07-23 16:49:45,2012-07-23 16:48:29
e761e0c6e0561093ff1e52d0cba6ace04daa8798...09fc2c50cb64d01299d5f04bd1920dcec91955be,1,1,1,2,1,2012-07-23 16:52:08,2012-07-23 16:52:08
8e7aaa7fd0784d1afab2e5fe7a8d347d5f3af4db...8ad22a2b152f55b12385b126305383e2c5ba1994,1,1,1,2,1,2012-04-22 22:07:15,2012-04-22 22:07:15
8ad22a2b152f55b12385b126305383e2c5ba1994...58ed62ed12cb48d9224f699e86e197804ca5ece4,4,618,546,1164,99,2012-04-23 19:05:12,2012-04-23 19:05:12
58ed62ed12cb48d9224f699e86e197804ca5ece4...54fab3174c7844959b374e98b453c048b60de0d0,12,149,48,197,21,2012-04-23 19:44:27,2012-04-23 19:43:26
54fab3174c7844959b374e98b453c048b60de0d0...ad329384ff7ef449db12ca30650f6637a7fc17f7,1,1,1,2,1,2012-04-25 00:06:21,2012-04-25 00:06:21
ad329384ff7ef449db12ca30650f6637a7fc17f7...d17a7f04d45bc95e95eeeb97d87fb86aac5c2508,1,18,0,18,1,2012-04-25 00:13:26,2012-04-25 00:13:26
d17a7f04d45bc95e95eeeb97d87fb86aac5c2508...f30744354f9dd0966b728ea48576612c4354a64b,1,23,21,44,15,2012-04-25 00:16:37,2012-04-25 00:16:37
f30744354f9dd0966b728ea48576612c4354a64b...97210d4e700aba1b67ac3652303bb685d129aced,2,61,83,144,21,2012-04-25 13:50:26,2012-04-25 13:50:26
97210d4e700aba1b67ac3652303bb685d129aced...245f5a244e024cb99ac84be86f86b88654a909c9,2,17,2,19,2,2012-04-25 14:08:38,2012-04-25 14:08:38
245f5a244e024cb99ac84be86f86b88654a909c9...42dbc86573a1172157def6fc417f33b69d00c2a5,1,5,3,8,2,2012-04-25 15:15:48,2012-04-25 15:15:48
42dbc86573a1172157def6fc417f33b69d00c2a5...8cc217eac3c49515b8aff591a9a5a7e304f6e597,1,3,0,3,1,2012-04-25 15:18:15,2012-04-25 15:18:07
8cc217eac3c49515b8aff591a9a5a7e304f6e597...87c83b04589e91a96adcfce788c6207295f83a5b,1,6,6,12,4,2012-04-25 16:25:51,2012-04-25 16:18:44
87c83b04589e91a96adcfce788c6207295f83a5b...6e066a4db72ff6b0d12dd8a43faec0a80e4a1fed,1,86,89,175,21,2012-04-25 16:25:52,2012-04-25 16:24:34
09fc2c50cb64d01299d5f04bd1920dcec91955be...d8aa8e71b0e015a2bcdd33a66f18892e0129b704,2,2,2,4,2,2012-07-23 18:51:55,2012-07-23 18:51:55
d8aa8e71b0e015a2bcdd33a66f18892e0129b704...3adc59efa6b16da98a37ef0641998cda0aee1a74,1,1,1,2,1,2012-07-23 19:37:41,2012-07-23 19:37:41
3adc59efa6b16da98a37ef0641998cda0aee1a74...91dfb28dd8ed9e29cf383e8b94f1b4fd06eee65a,1,1,1,2,1,2012-07-23 23:39:58,2012-07-23 23:39:58
91dfb28dd8ed9e29cf383e8b94f1b4fd06eee65a...077987876bbd01b8b48a72b3573694fafaa44d39,1,5,4,9,2,2012-07-24 18:45:02,2012-07-24 18:34:14
077987876bbd01b8b48a72b3573694fafaa44d39...717cb2a5c7909ed16f7c599b02759b27fd2e4258,2,3,1,4,3,2012-07-25 02:55:06,2012-07-25 02:55:06
717cb2a5c7909ed16f7c599b02759b27fd2e4258...fffd23285adfc31e994c0c83503eb283eab75bbd,1,131,0,131,1,2012-07-25 03:45:12,2012-07-25 03:45:12
fffd23285adfc31e994c0c83503eb283eab75bbd...569d064fc93459695cb6eb6fd09e5ba3fda62f03,4,16,6,22,5,2012-07-25 13:32:33,2012-07-25 13:32:33
569d064fc93459695cb6eb6fd09e5ba3fda62f03...da4d60929778490094fbf1f9c6abd9ea7d0e0c99,1,1,1,2,1,2012-07-25 13:45:38,2012-07-25 12:49:51
da4d60929778490094fbf1f9c6abd9ea7d0e0c99...ce15bd7d0c14106521bd21179b1507f2863d1960,2,10,5,15,6,2012-07-25 14:28:50,2012-07-25 14:19:09
ce15bd7d0c14106521bd21179b1507f2863d1960...ad5fba759bd36024caa282189f570195aa4d3b5d,1,1,1,2,1,2012-07-25 14:52:34,2012-07-25 14:51:48
ad5fba759bd36024caa282189f570195aa4d3b5d...647b772ab9ccbc3cd6e1dbd75f8a46a3e56eacec,1,1,1,2,1,2012-07-25 15:01:08,2012-07-25 15:01:08
647b772ab9ccbc3cd6e1dbd75f8a46a3e56eacec...bc07ae8c1dbe9af4cceee3f118ae8071a3a8afb2,1,1,1,2,1,2012-07-25 18:31:21,2012-07-25 18:25:39
bc07ae8c1dbe9af4cceee3f118ae8071a3a8afb2...de213be3728a339e1f2b98712a0869f8afb9da67,4,6,16,22,5,2012-07-25 18:38:55,2012-07-25 18:38:55
de213be3728a339e1f2b98712a0869f8afb9da67...2e42f06cdcefe0e1ecb15d52b16fe41779b0bed9,1,1,1,2,1,2012-07-25 19:24:05,2012-07-25 19:23:53
2e42f06cdcefe0e1ecb15d52b16fe41779b0bed9...3478cbb4d4f59473512891a6ba83158d47f26bf1,1,9,20,29,8,2012-07-25 19:42:53,2012-07-25 19:42:06
3478cbb4d4f59473512891a6ba83158d47f26bf1...17a26f5bd9b14225248942b876e96545b4c21fb6,2,5,5,10,4,2012-07-25 20:05:59,2012-07-25 20:05:48
17a26f5bd9b14225248942b876e96545b4c21fb6...0f14c53d7217ad65c5dfbb043c96f2683a563540,1,1,3,4,2,2012-07-25 20:09:30,2012-07-25 20:09:30
0f14c53d7217ad65c5dfbb043c96f2683a563540...81432c883576ebccdc164704847a7b38c8513bcc,1,23,19,42,1,2012-07-25 20:18:25,2012-07-25 20:18:01
81432c883576ebccdc164704847a7b38c8513bcc...f0432d54f68c35c63573128263c85217f3cf8d69,2,22,24,46,2,2012-07-25 20:36:21,2012-07-25 20:36:21
f0432d54f68c35c63573128263c85217f3cf8d69...d00048eabec29c783ca76560340692cda4c677ff,1,1,1,2,1,2012-07-25 20:53:42,2012-07-25 20:53:42
d00048eabec29c783ca76560340692cda4c677ff...5119b252ac2f3391e9f23efef4852095e0d7e6b3,2,6,7,13,3,2012-07-25 23:24:10,2012-07-25 23:24:10
5119b252ac2f3391e9f23efef4852095e0d7e6b3...ed898c62c8d3e8c2091592976c181ee4142287ac,2,21,8,29,6,2012-07-26 01:24:49,2012-07-26 01:24:49
ed898c62c8d3e8c2091592976c181ee4142287ac...d4ec6804e83b2c060a9fc94a044893751c2f640e,1,2,2,4,2,2012-07-26 01:33:30,2012-07-26 01:33:30
d4ec6804e83b2c060a9fc94a044893751c2f640e...cc6c014125ad2d6c8a705f0d543069ce5802757e,1,2,1,3,1,2012-07-26 01:44:44,2012-07-26 01:44:44
cc6c014125ad2d6c8a705f0d543069ce5802757e...a475f1aa4dd7ac96fcd80728ce2738386778f343,1,10,5,15,3,2012-07-26 01:58:59,2012-07-26 01:58:59
a475f1aa4dd7ac96fcd80728ce2738386778f343...155855b2a9bd95219871210ae7dcacd2a5f7e117,3,15,3,18,3,2012-07-26 02:23:24,2012-07-26 02:23:24
155855b2a9bd95219871210ae7dcacd2a5f7e117...0a1be437ff78d957e32d8493287c1041fed8cbb7,1,4,0,4,1,2012-07-26 02:33:58,2012-07-26 02:33:48
0a1be437ff78d957e32d8493287c1041fed8cbb7...14f67a95189422f83f5e9e19ed7b2d636da717b9,1,1,1,2,1,2012-07-26 13:30:49,2012-07-26 13:28:56
14f67a95189422f83f5e9e19ed7b2d636da717b9...e02e61ca87e58beb8a05708b686bca74e54a07dd,1,1,1,2,1,2012-07-27 02:26:25,2012-07-27 02:26:25
e02e61ca87e58beb8a05708b686bca74e54a07dd...d71b8b2db79b13a11c605a32bd5b336aea800003,1,1,1,2,1,2012-07-27 02:30:55,2012-07-27 02:30:55
d71b8b2db79b13a11c605a32bd5b336aea800003...f6f25eff88a818a352f447196ec64777ef07d362,1,1,1,2,1,2012-07-27 20:10:45,2012-07-27 20:10:30
f6f25eff88a818a352f447196ec64777ef07d362...4039d3668decade6c7098f7f270c45dd54ff6a8c,1,1,1,2,1,2012-07-27 21:34:39,2012-07-27 21:34:39
4039d3668decade6c7098f7f270c45dd54ff6a8c...e07b444dfe87f26f0d6031920026142425505ad6,2,8,5,13,5,2012-07-27 22:19:18,2012-07-27 22:19:01
e07b444dfe87f26f0d6031920026142425505ad6...beeab4d126b303b194899adf579d8f43e3fd5e69,2,2,2,4,2,2012-07-30 14:44:47,2012-07-30 14:44:47
09fc2c50cb64d01299d5f04bd1920dcec91955be...039222f8bf4591807e5d25e2a2308a79f87e656d,1,7,1,8,1,2012-07-23 17:23:20,2012-07-23 17:23:20
6e066a4db72ff6b0d12dd8a43faec0a80e4a1fed...6fbb4b4339a6ae51423d9600ef3517b594bec523,1,8,8,16,6,2012-04-27 15:22:01,2012-04-27 15:22:01
6fbb4b4339a6ae51423d9600ef3517b594bec523...6ad53c33d8fb4fa2f8adeef3d756875e4832f8a4,1,1,1,2,1,2012-04-28 14:52:32,2012-04-28 14:52:32
6ad53c33d8fb4fa2f8adeef3d756875e4832f8a4...5fc8d9e454a7abdf77a7de14aac7a94af276709f,1,8,9,17,6,2012-04-28 20:54:13,2012-04-28 20:54:13
6e066a4db72ff6b0d12dd8a43faec0a80e4a1fed...a25721a2cdf9e6cc105993ce70a0a2b8cef30dd8,1,11,8,19,5,2012-04-26 20:08:17,2012-04-26 20:08:17
beeab4d126b303b194899adf579d8f43e3fd5e69...07e50933c4293818c5b36d368368656844e4df88,1,2,1,3,1,2012-08-06 16:01:34,2012-08-06 16:01:32
07e50933c4293818c5b36d368368656844e4df88...5f3c36c7c0f997625a4b6be7397ecd31433511bf,1,1,1,2,1,2012-08-07 17:31:07,2012-08-07 17:30:58
5f3c36c7c0f997625a4b6be7397ecd31433511bf...37e8b44884cb9f5ceed84548c6e3961b449d98b2,1,3,0,3,1,2012-08-07 17:45:47,2012-08-07 17:45:47
37e8b44884cb9f5ceed84548c6e3961b449d98b2...1d8bf0a2b57fd429c600aab5b150b2a04b87e451,2,11,5,16,5,2012-08-08 00:49:34,2012-08-08 00:49:34
1d8bf0a2b57fd429c600aab5b150b2a04b87e451...ba6372d968447c2ca983f6afbf9e2a58de6dc9b8,1,3,1,4,1,2012-08-09 14:42:09,2012-08-09 14:42:09
ba6372d968447c2ca983f6afbf9e2a58de6dc9b8...5e906366dd86dda95df050257513c95834020e5e,2,4,285,289,4,2012-08-09 14:57:16,2012-08-08 18:33:55
5e906366dd86dda95df050257513c95834020e5e...060eabc9e82cce3d5c3867da0ea738655a7c1618,3,6,8,14,4,2012-08-09 17:44:20,2012-08-09 02:12:10
060eabc9e82cce3d5c3867da0ea738655a7c1618...d308531339ed22d9394183cb2ea7b52a6528ed38,2,160,127,287,33,2012-08-09 20:24:30,2012-08-09 19:22:15
d308531339ed22d9394183cb2ea7b52a6528ed38...95559f5117c8a21c1b8cc99f4badc320fd3dcbda,1,30,30,60,1,2012-08-09 20:24:36,2012-08-09 20:24:36
95559f5117c8a21c1b8cc99f4badc320fd3dcbda...81bf63359641255dfd340714d0635be03bda8de9,2,2,2,4,2,2012-08-09 20:25:57,2012-08-09 20:25:57
81bf63359641255dfd340714d0635be03bda8de9...e41553950debb135eaea303dc82f2dc5e19056be,1,4,4,8,2,2012-08-10 00:16:06,2012-08-10 00:16:06
e41553950debb135eaea303dc82f2dc5e19056be...77412e03056b2299309638212ae708acc190664c,1,13,7,20,7,2012-08-10 01:30:51,2012-08-10 01:30:51
77412e03056b2299309638212ae708acc190664c...3722aef8be5d31a7dbf3de6998cdf249081f028c,1,2,2,4,2,2012-08-10 23:34:01,2012-08-10 23:34:01
3722aef8be5d31a7dbf3de6998cdf249081f028c...dc3f7d3868e00fb318069b6f87dfc1fc4d10e56f,2,3,5,8,2,2012-08-11 20:30:46,2012-08-11 20:30:46
dc3f7d3868e00fb318069b6f87dfc1fc4d10e56f...aa1350d9e29571a82d09bb7a2eac4396901daa77,1,1,1,2,1,2012-08-14 18:24:09,2012-08-14 18:24:00
aa1350d9e29571a82d09bb7a2eac4396901daa77...b292c4c2df673d17d8c720e13d4d81ecae4ec499,2,36,2,38,4,2012-08-16 14:45:18,2012-08-16 14:45:18
b292c4c2df673d17d8c720e13d4d81ecae4ec499...9d07525a71e7bc12f606d8015d21425c5580e262,2,12,2,14,3,2012-08-16 17:12:59,2012-08-16 17:12:59
9d07525a71e7bc12f606d8015d21425c5580e262...ff7b7cfd1d754f6daf20541dc71c84ad690d3708,3,25,1,26,3,2012-08-20 00:24:03,2012-08-20 00:19:44
ff7b7cfd1d754f6daf20541dc71c84ad690d3708...109d91070151acdb19ed2c9c06c9dcb5b8930807,1,1,1,2,1,2012-08-20 00:34:03,2012-08-20 00:34:03
109d91070151acdb19ed2c9c06c9dcb5b8930807...488e502b980cfca8a246f55f6c5e0de3858686d6,1,28,2,30,2,2012-08-20 00:56:41,2012-07-30 18:10:18
488e502b980cfca8a246f55f6c5e0de3858686d6...2b2ca8baa3e220f086f3a5d99c1bb84b5d5bd7c5,1,9,2,11,2,2012-08-20 01:09:13,2012-08-20 01:09:13
2b2ca8baa3e220f086f3a5d99c1bb84b5d5bd7c5...6b9fde13444cc54fefc1a235a42ec41571522252,1,13,1,14,2,2012-08-20 01:24:33,2012-08-12 09:34:21
6b9fde13444cc54fefc1a235a42ec41571522252...3812f9436da09d9f31ca4a61a14cd70f3e8cbeaf,2,35,4,39,9,2012-08-20 01:48:52,2012-08-13 17:43:49
3812f9436da09d9f31ca4a61a14cd70f3e8cbeaf...0fea007a1a4d6456a8c7d246e4f7a4e14a1ba04a,2,25,1,26,2,2012-08-20 02:09:08,2012-08-15 19:31:37
0fea007a1a4d6456a8c7d246e4f7a4e14a1ba04a...2b5b4ebbd78ce10cbbe2a6f057feea615fc69629,3,10,4,14,4,2012-08-20 02:39:16,2012-08-20 02:28:36
2b5b4ebbd78ce10cbbe2a6f057feea615fc69629...9f86dc922ed832337d246d7baf8fd397dc837346,2,2,4,6,3,2012-08-20 02:46:06,2012-08-19 20:03:08
9f86dc922ed832337d246d7baf8fd397dc837346...ad040181dc6c05fa37941a6c9bfbe98bdf7ba8f1,2,17,1,18,2,2012-08-20 02:58:05,2012-08-19 20:30:10
ad040181dc6c05fa37941a6c9bfbe98bdf7ba8f1...f3ea073dc0cc506cbbdd24952953d7e8dda456a4,1,0,5,5,1,2012-08-20 12:02:36,2012-08-20 12:01:58
f3ea073dc0cc506cbbdd24952953d7e8dda456a4...0f553ed0ca0c50c5f66377e9f2c6314f822e8f25,5,62,16,78,9,2012-08-20 12:16:07,2012-08-19 21:41:43
0f553ed0ca0c50c5f66377e9f2c6314f822e8f25...ac043b1bc8096bfbb4be7995af4f5ccc5cad7c19,3,4,10,14,4,2012-08-20 13:33:35,2012-08-20 13:33:35
ac043b1bc8096bfbb4be7995af4f5ccc5cad7c19...465959e75c08f7f1961071832a8c27a205bf05d0,1,5,4,9,2,2012-08-21 03:09:46,2012-08-21 03:09:46
465959e75c08f7f1961071832a8c27a205bf05d0...9e246dd7fa010f2b8e112ec5a57491167556c55a,2,9,4,13,4,2012-08-21 12:59:51,2012-08-21 12:59:51
9e246dd7fa010f2b8e112ec5a57491167556c55a...9f7e4fcf6a7f469dd30baf5cb68cc7d938ce9144,1,1,1,2,1,2012-08-22 21:40:15,2012-08-22 21:40:15
9f7e4fcf6a7f469dd30baf5cb68cc7d938ce9144...ae1d2b3173876e7062324aa61398fef9d0f59f79,1,3,3,6,1,2012-08-23 01:47:59,2012-08-23 01:18:45
ae1d2b3173876e7062324aa61398fef9d0f59f79...10901f7d9fa6be01cc6b88cd94d279760b42a069,3,46,8,54,4,2012-08-23 01:48:02,2012-08-23 01:23:50
10901f7d9fa6be01cc6b88cd94d279760b42a069...a9c2a9bf61af4c09e8f089b45e8986b9a5416d46,6,13,137,150,16,2012-08-24 00:28:22,2012-08-23 21:46:12
a9c2a9bf61af4c09e8f089b45e8986b9a5416d46...c01e022f33575ed45fb8da65be756fc464d40a24,2,16,1,17,2,2012-08-24 01:33:29,2012-08-24 01:30:45
c01e022f33575ed45fb8da65be756fc464d40a24...2263134b224fe03b90552369b5007220747fbaf0,2,9,2,11,3,2012-08-24 02:19:06,2012-08-24 02:19:06
2263134b224fe03b90552369b5007220747fbaf0...e2eac3f4d2e7f47b67635704df8e3b6675a91ed6,2,9,13,22,5,2012-08-24 03:25:57,2012-08-24 03:25:57
e2eac3f4d2e7f47b67635704df8e3b6675a91ed6...a5be98620665c8af4d21a043a871e6a965de4fbc,2,13,9,22,5,2012-08-24 15:57:48,2012-08-24 15:57:48
a5be98620665c8af4d21a043a871e6a965de4fbc...05337e78fa68aac3a3d703d7cc59f145f13ea779,2,1,16,17,2,2012-08-24 15:59:01,2012-08-24 15:59:01
05337e78fa68aac3a3d703d7cc59f145f13ea779...6ad57e91a52fdee4853aab82791e13a4b122d35a,1,1,1,2,1,2012-08-24 21:43:54,2012-08-24 21:41:52
6ad57e91a52fdee4853aab82791e13a4b122d35a...b2698928bbdc1b247cb6de28e9b2624ec6b56667,1,1,1,2,1,2012-08-24 21:43:54,2012-08-24 21:43:39
b2698928bbdc1b247cb6de28e9b2624ec6b56667...2be615eaa16a5916d0a194e3c2f6bc2a2d62b236,1,1,1,2,1,2012-08-24 22:08:13,2012-08-24 22:08:02
2be615eaa16a5916d0a194e3c2f6bc2a2d62b236...f42cc8eab873199b93f5458993d4c83394565b4a,1,1,1,2,1,2012-08-27 14:20:18,2012-08-27 14:20:18
f42cc8eab873199b93f5458993d4c83394565b4a...157c561c153a7e63040904241a0e2bee82109f81,1,1,1,2,1,2012-08-27 16:39:14,2012-08-27 16:39:14
157c561c153a7e63040904241a0e2bee82109f81...f15eb3ce5b3e7967f04cb1a6d57542bd6f9f9262,1,1,1,2,1,2012-08-27 20:53:57,2012-08-27 20:53:57
f15eb3ce5b3e7967f04cb1a6d57542bd6f9f9262...3ec8daa69d2115b6f550a5fc9f1621d485eec089,1,1,1,2,1,2012-08-27 21:44:47,2012-08-27 21:44:47
3ec8daa69d2115b6f550a5fc9f1621d485eec089...9a92c5423fed1cbe81eb2516dd41cb1f4c2930a5,2,4,3,7,3,2012-08-28 12:52:09,2012-08-28 12:52:09
9a92c5423fed1cbe81eb2516dd41cb1f4c2930a5...c078b83b3fea891e0c228a9f2d101481678b4c9d,1,4,1,5,1,2012-08-28 12:56:06,2012-08-25 15:26:37
c078b83b3fea891e0c228a9f2d101481678b4c9d...afd717df9e189d3e374ce938f03e2712f31c29e3,2,23,10,33,7,2012-08-28 14:07:16,2012-08-28 14:07:16
afd717df9e189d3e374ce938f03e2712f31c29e3...84e45301c5e513b1e0eec08eccb599623a808d0e,2,2,2,4,2,2012-08-28 14:09:22,2012-08-28 14:09:22
84e45301c5e513b1e0eec08eccb599623a808d0e...7d076f5d79e2193e4399e78403f315db17206910,1,1,1,2,1,2012-08-28 15:31:13,2012-08-28 15:31:13
7d076f5d79e2193e4399e78403f315db17206910...b6a7d022eeb8c2cb0b065a311e53f9ea98554600,2,22,8,30,7,2012-08-28 21:02:01,2012-08-28 21:00:12
b6a7d022eeb8c2cb0b065a311e53f9ea98554600...c2f298c8e5b5543c3b129e6478d5b39fb83f9ade,1,1,1,2,1,2012-08-28 23:47:45,2012-08-28 23:47:35
c2f298c8e5b5543c3b129e6478d5b39fb83f9ade...a66b5c7569fb7d06b970bb5424401d1eb0786a3b,1,1,1,2,1,2012-08-29 00:09:37,2012-08-29 00:09:15
a66b5c7569fb7d06b970bb5424401d1eb0786a3b...fbdf8bed4fa34b6c922a287060ffaa01a55245a9,1,1,1,2,1,2012-08-29 00:34:23,2012-08-29 00:34:10
fbdf8bed4fa34b6c922a287060ffaa01a55245a9...9683f82d9d89059371fe2e4428f2d4fe676966f2,1,1,1,2,1,2012-08-29 04:04:52,2012-08-29 04:04:52
9683f82d9d89059371fe2e4428f2d4fe676966f2...be2899b3b1dfcd75516bbcf12c4eb49af9073538,1,1,1,2,1,2012-08-29 14:40:15,2012-08-29 14:40:15
be2899b3b1dfcd75516bbcf12c4eb49af9073538...670e3ff040b0a7164f36a3c5e07214420b8b09f4,2,15,9,24,5,2012-08-29 16:34:12,2012-08-29 12:50:56
670e3ff040b0a7164f36a3c5e07214420b8b09f4...3a633b0082dbba0365c014ece03d39e8358da18b,1,1,1,2,1,2012-08-29 16:49:39,2012-08-29 16:49:17
3a633b0082dbba0365c014ece03d39e8358da18b...0ca936d2c911fe037dda3cb9d6e21f6fe1735a2c,1,1,0,1,1,2012-08-30 14:47:47,2012-08-30 14:47:47
0ca936d2c911fe037dda3cb9d6e21f6fe1735a2c...a31f28b02630e9554bc1900f6a35ef1b310cc3e2,2,20,30,50,14,2012-08-30 21:07:03,2012-08-30 21:07:03
a31f28b02630e9554bc1900f6a35ef1b310cc3e2...e06a8cae3a1de58b770a66cbd124cf50e809fb31,1,1,1,2,1,2012-08-30 21:17:08,2012-08-30 21:17:08
e06a8cae3a1de58b770a66cbd124cf50e809fb31...6bc2a87943f59ad277cdee26aec1c25949c0f091,1,1,1,2,1,2012-08-30 21:17:27,2012-08-30 21:17:27
6bc2a87943f59ad277cdee26aec1c25949c0f091...705755ce48697d27192c3627d79bfd5029f72253,1,1,1,2,1,2012-09-05 20:22:40,2012-09-05 20:22:40
705755ce48697d27192c3627d79bfd5029f72253...1ad614b4a97e73d1fcb0b677e0953abebcc6989f,1,1,1,2,1,2012-09-05 22:13:31,2012-09-05 22:13:31
1ad614b4a97e73d1fcb0b677e0953abebcc6989f...2a1e5eccf510bd5c3527121e1808cdc687b3a721,1,1,1,2,1,2012-09-06 02:01:35,2012-09-06 02:01:35
2a1e5eccf510bd5c3527121e1808cdc687b3a721...bc3a47f83afb22451390b05c33b7b2c2654a7d6e,1,1,1,2,1,2012-09-08 17:06:17,2012-09-08 17:06:17
bc3a47f83afb22451390b05c33b7b2c2654a7d6e...1c99b568fd6e7126cccf849bfe472d28a7ad895e,1,1,1,2,1,2012-09-08 18:31:31,2012-09-08 18:31:31
1c99b568fd6e7126cccf849bfe472d28a7ad895e...949dfe52bc228efe2d0cb2d696b822ef2a5723d1,1,10,3,13,2,2012-09-10 01:19:27,2012-08-28 23:14:48
949dfe52bc228efe2d0cb2d696b822ef2a5723d1...c79a533ffd3e063a498fde6bdb1b934c7b4b47ab,1,1,1,2,1,2012-09-10 01:21:08,2012-09-10 00:56:44
c79a533ffd3e063a498fde6bdb1b934c7b4b47ab...9b67b4c0ef311f96d6e035fd38bbfbe42a82b392,1,4,1,5,2,2012-09-10 01:21:42,2012-09-10 00:47:07
9b67b4c0ef311f96d6e035fd38bbfbe42a82b392...5fb258b89500bbe5d01a54e4d65b0d441ebcb618,1,1,1,2,1,2012-09-10 01:23:34,2012-09-10 01:23:17
5fb258b89500bbe5d01a54e4d65b0d441ebcb618...b62e5522910766a8fb9f1cf29e069360ae75a902,2,15,3,18,4,2012-09-10 02:03:25,2012-09-10 02:00:53
b62e5522910766a8fb9f1cf29e069360ae75a902...71c1ae1718c0dd639a866c04f57be27028d506e8,1,1,1,2,1,2012-09-11 17:10:59,2012-09-11 17:10:59
71c1ae1718c0dd639a866c04f57be27028d506e8...01d406522095a26788b1975852ad7c1ee7cf6e34,1,1,1,2,1,2012-09-11 18:50:23,2012-09-11 18:50:23
01d406522095a26788b1975852ad7c1ee7cf6e34...9c5089a60d479a959b290a5b4ab8ef38c985e963,1,12,1,13,3,2012-09-11 19:42:10,2012-09-11 19:41:46
9c5089a60d479a959b290a5b4ab8ef38c985e963...74cdd784975ba6e628d1934a859faeb017824a5f,2,19,2,21,4,2012-09-13 13:44:12,2012-09-13 13:44:12
74cdd784975ba6e628d1934a859faeb017824a5f...b0a352bfa76cbe1b65f8186d3cb90fe35a08866d,2,11,2,13,2,2012-09-13 22:47:07,2012-09-13 22:47:07
b0a352bfa76cbe1b65f8186d3cb90fe35a08866d...560c178c82da95b2f88ae518552463d87fe5adbf,2,15,10,25,5,2012-09-14 14:15:10,2012-09-14 14:14:40
560c178c82da95b2f88ae518552463d87fe5adbf...e755c194161e1dc6793cbb690ba8334dad560c8f,1,7,8,15,4,2012-09-15 17:10:37,2012-09-15 15:57:01
e755c194161e1dc6793cbb690ba8334dad560c8f...86f8d9f1a5097b3b9d80cde3a6cc8ecde9956bac,1,1,1,2,1,2012-09-15 20:19:51,2012-09-15 20:19:51
86f8d9f1a5097b3b9d80cde3a6cc8ecde9956bac...3cb36f7a42a200cead4723841015f61301b02a52,1,12,0,12,1,2012-09-17 18:29:58,2012-09-17 18:29:58
3cb36f7a42a200cead4723841015f61301b02a52...42dd6b1c16d12c8ec0f8f13d001bcbcb96fda3c8,1,210,7,217,5,2012-09-17 18:53:05,2012-09-17 18:53:05
42dd6b1c16d12c8ec0f8f13d001bcbcb96fda3c8...4b469ead3d0bef6c2585da7beacba29e02e91ac6,1,1,1,2,1,2012-09-17 18:54:24,2012-09-17 18:54:24
4b469ead3d0bef6c2585da7beacba29e02e91ac6...b4d23e477355ec9cb5df3ac033336abea9a094b1,1,1,1,2,1,2012-09-17 18:55:02,2012-09-17 18:55:02
b4d23e477355ec9cb5df3ac033336abea9a094b1...1474c067f22e8232e873ac162bb882dbd590c9f0,1,4,2,6,1,2012-09-17 18:57:20,2012-09-17 18:57:20
1474c067f22e8232e873ac162bb882dbd590c9f0...e8e3e90a8620a945d2d4f6012a604d96db2bd317,1,1,1,2,1,2012-09-18 18:26:40,2012-09-18 18:26:21
e8e3e90a8620a945d2d4f6012a604d96db2bd317...15b5dbfe2386d67b8c1df3305812b35abc04458c,5,21,24,45,18,2012-09-18 22:04:31,2012-09-18 21:39:44
15b5dbfe2386d67b8c1df3305812b35abc04458c...f7980d4d68e76147e6a9ddd7b30d379ddce7f222,1,1,1,2,1,2012-09-19 15:32:02,2012-09-19 15:31:44
f7980d4d68e76147e6a9ddd7b30d379ddce7f222...2f92685a9ca2f376a64111efa87946cb4f409477,1,1,1,2,1,2012-09-19 16:00:47,2012-09-19 16:00:47
2f92685a9ca2f376a64111efa87946cb4f409477...99f4825707e2bf6f19598a00f53d58ef3878190c,1,1,1,2,1,2012-09-19 16:04:09,2012-09-19 16:04:09
99f4825707e2bf6f19598a00f53d58ef3878190c...c9b894c98c41f0265a4442610aac3aca74976126,1,1,1,2,1,2012-09-19 16:30:57,2012-09-19 16:30:57
c9b894c98c41f0265a4442610aac3aca74976126...6ad4a0ef3422f8c5b99428dbfdbb6000cbc4eca2,2,8,2,10,3,2012-09-20 00:46:18,2012-09-20 00:46:18
6ad4a0ef3422f8c5b99428dbfdbb6000cbc4eca2...a44463f83fee385879535ec2b2b37f584bcdebbd,1,1,1,2,1,2012-09-20 16:00:57,2012-09-20 16:00:57
a44463f83fee385879535ec2b2b37f584bcdebbd...022b265956012c4b915e4867465a5433570b9f86,1,1,1,2,1,2012-09-20 21:00:43,2012-09-20 21:00:43
022b265956012c4b915e4867465a5433570b9f86...044ee41282f8e97f2fa14b4d103c16ac6ba6874c,1,3,3,6,1,2012-09-21 01:05:40,2012-09-21 00:48:20
044ee41282f8e97f2fa14b4d103c16ac6ba6874c...6e995583a11b63bf1d94142da6408955ee93e7cc,2,9,5,14,4,2012-09-21 01:12:38,2012-09-21 01:12:38
6e995583a11b63bf1d94142da6408955ee93e7cc...d57363e800535a7400fde56e97d0a4cd424cffbb,1,1,1,2,1,2012-09-21 01:13:14,2012-09-21 01:13:14
d57363e800535a7400fde56e97d0a4cd424cffbb...c3b1367f4c19abf12eadc1460a37dc34ae765e1b,1,5,6,11,6,2012-09-25 20:19:38,2012-09-25 20:19:38
c3b1367f4c19abf12eadc1460a37dc34ae765e1b...f9ef91d6d68dc7317bb12c1ae2a8201f28facff1,1,23,18,41,10,2012-10-01 00:40:45,2012-09-29 04:23:55
f9ef91d6d68dc7317bb12c1ae2a8201f28facff1...22fac5c2e40b00911933040afaf9adcdd2c00ac2,1,6,7,13,6,2012-10-01 00:54:28,2012-10-01 00:54:28
22fac5c2e40b00911933040afaf9adcdd2c00ac2...9ced0274653b8b17ceb6b0675e2ae05433dcf202,3,11,2,13,3,2012-10-01 02:14:49,2012-09-30 21:41:42
9ced0274653b8b17ceb6b0675e2ae05433dcf202...631fbc769c952381fc3f42ffd77f7b5e4e6a21cc,1,1,1,2,1,2012-10-01 02:19:31,2012-10-01 02:19:31
631fbc769c952381fc3f42ffd77f7b5e4e6a21cc...ebf4d43011b7a6add9ded38b4322163f8b030cb6,1,1,12,13,3,2012-10-01 02:23:02,2012-10-01 02:23:02
ebf4d43011b7a6add9ded38b4322163f8b030cb6...da3ff3afe4d8421ae4ad04d6653f04ed6d7768e3,2,17,4,21,4,2012-10-04 01:07:50,2012-10-03 12:26:01
da3ff3afe4d8421ae4ad04d6653f04ed6d7768e3...425d17de832d281c2577f8d6653030cef95907b5,2,20,20,40,7,2012-10-04 01:14:08,2012-09-21 15:53:03
425d17de832d281c2577f8d6653030cef95907b5...52a84225596393879806ad9e024c3351c8b46034,1,1,1,2,1,2012-10-04 13:49:20,2012-10-04 13:49:20
52a84225596393879806ad9e024c3351c8b46034...60f546acb1c7136092b4fd01cccff052e468cc72,2,19,1,20,2,2012-10-04 17:25:50,2012-10-04 17:25:50
60f546acb1c7136092b4fd01cccff052e468cc72...71c17257c71303e5a92faeebe0d760db22e88a01,1,15,15,30,14,2012-10-05 14:47:59,2012-10-05 14:47:09
71c17257c71303e5a92faeebe0d760db22e88a01...cfe95a864330c45c2bf93ca4a89d84c01f5acff5,1,1,1,2,1,2012-10-06 00:31:43,2012-10-06 00:31:43
cfe95a864330c45c2bf93ca4a89d84c01f5acff5...bb38f706463a4d7598505b2f7adf3ed83935f298,2,30,15,45,5,2012-10-06 20:00:43,2012-10-06 20:00:43
bb38f706463a4d7598505b2f7adf3ed83935f298...7e8b854152beead5ba1c0e9f8683586ee937f72d,3,13,13,26,10,2012-10-10 00:06:31,2012-10-09 23:48:37
7e8b854152beead5ba1c0e9f8683586ee937f72d...fde2e44f864c1bb4b8476ccdd7cd16b5c0115860,1,8,5,13,6,2012-10-10 00:06:47,2012-10-10 00:06:02
fde2e44f864c1bb4b8476ccdd7cd16b5c0115860...5a21150c9b633dbef134fd540762b4d88ebc5f71,1,2,1,3,1,2012-10-10 00:42:33,2012-10-10 00:42:33
5a21150c9b633dbef134fd540762b4d88ebc5f71...a60fed4dec85e7b0c3b6fc5741b14cee1552afc4,2,3,2,5,2,2012-10-10 17:00:45,2012-10-10 17:00:45
a60fed4dec85e7b0c3b6fc5741b14cee1552afc4...798a7a7ea2cb612411b3d9fd87e8b0e894b27de8,2,6,3,9,2,2012-10-11 13:39:21,2012-10-11 13:38:44
798a7a7ea2cb612411b3d9fd87e8b0e894b27de8...1450305402ee8f36825fd5fa44df913a3be2f4c8,2,22,1,23,2,2012-10-11 14:25:43,2012-10-11 14:17:24
1450305402ee8f36825fd5fa44df913a3be2f4c8...077989e8c0c56ed059bffeb504cfd201e6c5c9cf,1,1,1,2,1,2012-10-14 16:07:05,2012-10-14 16:07:05
077989e8c0c56ed059bffeb504cfd201e6c5c9cf...1cda1120e3fee605e456a8258bd0b26ca1d00c8e,2,19,34,53,6,2012-10-15 13:38:27,2012-10-15 13:38:27
1cda1120e3fee605e456a8258bd0b26ca1d00c8e...cb67571dd2ee4aa3e2d9986580740696bac72d5a,1,1,1,2,1,2012-10-15 14:40:32,2012-10-15 14:40:32
cb67571dd2ee4aa3e2d9986580740696bac72d5a...d01253e20158f53c08aa6bc0c1cf66806cd19148,2,3,30,33,4,2012-10-15 15:38:00,2012-10-15 15:38:00
d01253e20158f53c08aa6bc0c1cf66806cd19148...96492b1d44a0c6154e6f98ec57808e6b5f4aaa09,1,12,3,15,2,2012-10-15 15:49:56,2012-10-15 15:45:00
96492b1d44a0c6154e6f98ec57808e6b5f4aaa09...c2a6bad60a2b2d84081ef369a023f75c4bd32ad5,1,10,0,10,5,2012-10-15 16:11:20,2012-10-15 16:11:20
c2a6bad60a2b2d84081ef369a023f75c4bd32ad5...57aa7977dd6d88898b5d1cf748a4f85c1e7a3bee,1,2,0,2,1,2012-10-15 16:14:54,2012-10-15 16:14:54
57aa7977dd6d88898b5d1cf748a4f85c1e7a3bee...6ac87167893e1de24761eaff47bbf9a20d0d6f98,1,4,0,4,2,2012-10-15 16:16:49,2012-10-15 16:16:49
6ac87167893e1de24761eaff47bbf9a20d0d6f98...435fbe17930d4e01b3e7b1a2ca6a925769b6e847,1,3,1,4,2,2012-10-15 16:18:14,2012-10-15 16:18:14
435fbe17930d4e01b3e7b1a2ca6a925769b6e847...0c447434963bbdd6c631acfc38e51022db949a8b,1,2,0,2,1,2012-10-15 16:19:20,2012-10-15 16:19:20
0c447434963bbdd6c631acfc38e51022db949a8b...611d7660cd23747bcc7948ad2ee2a663e00ff105,2,5,2,7,3,2012-10-15 16:31:27,2012-10-15 16:31:27
611d7660cd23747bcc7948ad2ee2a663e00ff105...b36d58d4e8cddcee08811c2a1b91c78d9a792483,1,11,0,11,6,2012-10-15 16:37:02,2012-10-15 16:37:02
b36d58d4e8cddcee08811c2a1b91c78d9a792483...8a4dc3657e7da482a12b51cba2c6806cc36d9919,1,1,0,1,1,2012-10-15 18:04:58,2012-10-15 18:04:58
8a4dc3657e7da482a12b51cba2c6806cc36d9919...f3323901f907fd139fe22761590af5be8460a2f0,1,3,0,3,1,2012-10-15 18:09:03,2012-10-15 18:09:03
f3323901f907fd139fe22761590af5be8460a2f0...be1f1d7b5b1152a0a817a743db81151f55d23ddf,1,2213,2001,4214,388,2012-10-15 19:53:39,2012-10-15 19:53:39
be1f1d7b5b1152a0a817a743db81151f55d23ddf...a0cbf601922bd8591f19c15b33e66b52560c0172,1,11,9,20,6,2012-10-15 20:00:50,2012-10-15 20:00:50
a0cbf601922bd8591f19c15b33e66b52560c0172...e092b641955ca753708384a73a9a159c9af817dd,1,1,1,2,1,2012-10-15 20:04:02,2012-10-15 20:04:02
e092b641955ca753708384a73a9a159c9af817dd...add850303690edbb0dea891585e2bb2aa826990c,1,1,1,2,1,2012-10-15 20:09:58,2012-10-15 20:09:50
add850303690edbb0dea891585e2bb2aa826990c...cc172a862be468b9847a7bfd653b97cde53d2b64,2,2,3,5,3,2012-10-15 20:51:16,2012-10-15 20:51:03
cc172a862be468b9847a7bfd653b97cde53d2b64...d6c84c5bb55814df0063e04b12c4143d07cba3f7,1,142,86,228,21,2012-10-15 21:11:21,2012-10-15 21:11:21
d6c84c5bb55814df0063e04b12c4143d07cba3f7...9104a3d5f2a1bb72b89ebdbad3f0bfdb2ea8ab74,4,127,129,256,10,2012-10-15 21:20:33,2012-10-15 21:20:33
9104a3d5f2a1bb72b89ebdbad3f0bfdb2ea8ab74...87bd3b5ada5c277aef6422eac1fb3813d2b2c825,1,99,99,198,4,2012-10-15 21:21:18,2012-10-15 21:21:18
87bd3b5ada5c277aef6422eac1fb3813d2b2c825...6aae3e1038925f8f22d6c0aeedf74f0358890be4,1,2,2,4,2,2012-10-15 22:05:36,2012-10-15 22:05:36
6aae3e1038925f8f22d6c0aeedf74f0358890be4...d70e64bff2660cf5a801fe818f1170d5ea93e4fe,3,8,8,16,3,2012-10-16 04:17:39,2012-10-16 04:15:22
d70e64bff2660cf5a801fe818f1170d5ea93e4fe...bf514bc085343bb37bfb1ad3fb7b8bd81204e0ae,1,2,0,2,1,2012-10-16 11:32:53,2012-10-16 11:32:53
0d07e7fc2cf33d70ea51ae58cd0c76bf48f8b3be...d5d8622329e379e449b54ab8805f043d1e6ec02a,2,44,2,46,4,2012-08-08 20:31:59,2012-08-08 20:31:59
d5d8622329e379e449b54ab8805f043d1e6ec02a...f952b97997e529f872859e5cfd43070fc533f3b0,1,2,2,4,1,2012-08-08 20:36:20,2012-08-08 20:36:20
f952b97997e529f872859e5cfd43070fc533f3b0...f29633536076e831e25705b560c983674ed839ee,7,851,13,864,10,2012-08-13 12:46:55,2012-08-13 12:46:55
f29633536076e831e25705b560c983674ed839ee...71b299249f8b1f6c0a09b998d70b848d3f93266e,2,0,818,818,2,2012-08-13 12:55:41,2012-08-13 12:55:41
13f4f5adc25543b8c243555fa5a9eb9682088168...a1e3122706de7c4a71cbeaff83e47c2e24f686d2,1,2,2,4,2,2012-04-28 21:06:48,2012-04-28 21:06:48
a1e3122706de7c4a71cbeaff83e47c2e24f686d2...dc3c983be094ee5c90d992c89b3a805feb6c4e26,1,1,1,2,1,2012-04-30 01:04:45,2012-04-30 01:04:45
dc3c983be094ee5c90d992c89b3a805feb6c4e26...6bed348a007f8467dfc09cf63a1783bce673c3f4,2,19,2,21,3,2012-05-01 18:39:45,2012-05-01 18:39:45
6bed348a007f8467dfc09cf63a1783bce673c3f4...95291b44e64d86b05fceecb7e08b5d444cbbdb85,1,38,47,85,11,2012-05-01 18:47:14,2012-05-01 18:47:14
95291b44e64d86b05fceecb7e08b5d444cbbdb85...ae6b14abaffd5f9f3560f5448fe0fcc20db26bb5,1,1,1,2,1,2012-05-02 00:15:09,2012-05-02 00:15:09
ae6b14abaffd5f9f3560f5448fe0fcc20db26bb5...d3e034f6c7b086ae772bf22d37f849a2d0ab5194,1,42,0,42,1,2012-05-02 00:22:56,2012-05-02 00:22:56
d3e034f6c7b086ae772bf22d37f849a2d0ab5194...9cb1ab436d0a791518ebe7b401fd169c39a356d9,1,11,6,17,4,2012-05-02 00:29:12,2012-05-02 00:29:12
9cb1ab436d0a791518ebe7b401fd169c39a356d9...bab6f5355cf8a02e1789d27d62defd78a7cdb1f4,1,5,6,11,4,2012-05-03 20:18:08,2012-05-03 20:13:28
bab6f5355cf8a02e1789d27d62defd78a7cdb1f4...f925c7a1c93afd7eae1edcf540e9d4374b2aa27b,6,50,100,150,15,2012-05-04 14:17:30,2012-05-04 13:57:32
f925c7a1c93afd7eae1edcf540e9d4374b2aa27b...714b8ffd2b28af446fea8f25e369597d7c509cb4,3,7,7,14,6,2012-05-04 17:31:35,2012-05-04 17:31:35
714b8ffd2b28af446fea8f25e369597d7c509cb4...e3cf0e220c6cfaac18642f3d4db96698ea601791,3,68,50,118,7,2012-05-05 23:05:03,2012-05-05 23:05:03
e3cf0e220c6cfaac18642f3d4db96698ea601791...a743be19bd3622071c22e9874c92024bc3f5367a,3,19,1,20,3,2012-05-05 23:27:01,2012-05-05 23:27:01
a743be19bd3622071c22e9874c92024bc3f5367a...95a4a776cffe6dd56f5796e93c0cba0225ee49e4,1,3,6,9,3,2012-05-07 01:24:46,2012-05-04 17:55:23
95a4a776cffe6dd56f5796e93c0cba0225ee49e4...443ea98ba03056bc9c5f23c94b49ac5200888be8,1,1,1,2,1,2012-05-07 01:40:05,2012-05-02 01:12:55
443ea98ba03056bc9c5f23c94b49ac5200888be8...bd84aad6cdde8cf3ce7842df1febb82fe9816647,2,24,1,25,2,2012-05-07 10:06:12,2012-05-07 10:06:12
bd84aad6cdde8cf3ce7842df1febb82fe9816647...169b4185bcd34803b4459cb564c04e72bd4ddf1e,1,1,1,2,1,2012-05-07 10:13:08,2012-05-07 10:13:08
bf514bc085343bb37bfb1ad3fb7b8bd81204e0ae...7d2e99fb6454f836773c32381a26dbe1f458f5ab,1,3,4,7,3,2012-10-16 13:39:33,2012-10-16 13:39:33
7d2e99fb6454f836773c32381a26dbe1f458f5ab...40f9ab9cdf7ed1d6478e198445218eb3c88a8245,1,20,35,55,3,2012-10-16 13:40:42,2012-10-16 13:40:42
bf514bc085343bb37bfb1ad3fb7b8bd81204e0ae...efc2d8b1a63a936cd455039b941a88aad5fda2d6,2,82,80,162,47,2012-10-16 12:24:18,2012-10-16 12:16:53
169b4185bcd34803b4459cb564c04e72bd4ddf1e...4de7b5412e33331ca6f9f8a2d6e5e00dec7299f2,1,4,5,9,4,2012-05-07 17:59:11,2012-05-07 17:59:11
169b4185bcd34803b4459cb564c04e72bd4ddf1e...03e0029761b6fd5789ac5df13cd06fd219a505ab,1,1,1,2,1,2012-05-07 17:14:00,2012-05-07 17:14:00
03e0029761b6fd5789ac5df13cd06fd219a505ab...0add0b30db54ecdc7f64c081d7abcb29ae5a8be4,1,1,1,2,1,2012-05-07 17:43:43,2012-05-07 17:43:43
6eacf67e306f7ed60b8468bbc43013e730594de6...78617f067a0e03d9fe9aad135bbdfba880ddf968,3,10,4,14,3,2012-10-16 14:01:18,2012-10-16 13:51:01
78617f067a0e03d9fe9aad135bbdfba880ddf968...72aada0a156881db8ad530a7543d58ea90e51e84,1,0,2,2,1,2012-10-16 14:01:21,2012-10-16 13:55:34
72aada0a156881db8ad530a7543d58ea90e51e84...6ba563887a572efc25e60623b5e1301864cff303,1,4,4,8,5,2012-10-16 14:03:17,2012-10-16 14:02:44
6ba563887a572efc25e60623b5e1301864cff303...605a38073e657d929eed06b3211baee1cd29c787,1,2,0,2,1,2012-10-16 14:10:17,2012-10-16 14:10:17
605a38073e657d929eed06b3211baee1cd29c787...ed9e34482a303e7e64c397f89533dbe64f51cfbf,16,116,107,223,65,2012-10-16 14:17:14,2012-10-16 14:17:14
ed9e34482a303e7e64c397f89533dbe64f51cfbf...4bb46f413a0e2f6933013b26d2aceddca6cf03f1,2,10,1,11,2,2012-10-16 14:25:08,2012-10-16 14:25:08
4bb46f413a0e2f6933013b26d2aceddca6cf03f1...2e3ca6ca46fd9352e02c140cabd1a2f979b3ce6d,1,0,2,2,1,2012-10-16 14:58:38,2012-10-16 14:58:38
2e3ca6ca46fd9352e02c140cabd1a2f979b3ce6d...08e134548f70f24cb73f8e1b7a6da39b1995d0ac,5,182,171,353,56,2012-10-16 15:15:41,2012-10-16 15:15:41
08e134548f70f24cb73f8e1b7a6da39b1995d0ac...fcaef889682d6724f7b8e662c66a7539a95ae3d8,4,31,36,67,20,2012-10-16 15:28:11,2012-10-16 15:26:14
20be650bae02c866fa9660a3683cbf1617166795...ca5e06a15c99d5c181aff6e08804ca803424648d,2,12,7,19,3,2012-11-19 02:20:12,2012-11-19 01:48:49
ca5e06a15c99d5c181aff6e08804ca803424648d...90f9f4965a49232cbad6b3f4427a6c3172a3e15c,1,1,1,2,1,2012-11-19 02:22:50,2012-11-17 20:20:09
90f9f4965a49232cbad6b3f4427a6c3172a3e15c...e889134058232c5e19156353c5fc3bf3b4915a94,3,372,265,637,85,2012-11-19 14:50:19,2012-11-19 14:50:19
e889134058232c5e19156353c5fc3bf3b4915a94...22f58bd688e35a473e6088bc47c1ba23ebcb0cdc,1,1,1,2,1,2012-11-19 22:17:48,2012-11-19 22:17:48
22f58bd688e35a473e6088bc47c1ba23ebcb0cdc...bb570fc37341520c27a76190e0c11271596890ec,2,18,54,72,11,2012-11-21 03:57:41,2012-11-21 03:57:41
bb570fc37341520c27a76190e0c11271596890ec...4fed8eb86d4b987524fd16e6c4e7be351301f38b,1,1,1,2,1,2012-11-22 02:47:59,2012-11-22 02:47:59
4fed8eb86d4b987524fd16e6c4e7be351301f38b...1fb2f92c357b985a5ba18d0938edd27b5f64d8c3,3,40,3,43,4,2012-11-24 19:08:51,2012-11-21 03:31:33
1fb2f92c357b985a5ba18d0938edd27b5f64d8c3...b7ec6ddd45e27b54f3e094172b7eeb6949d4f71b,2,63,1,64,4,2012-11-24 19:44:39,2012-11-23 20:03:55
b7ec6ddd45e27b54f3e094172b7eeb6949d4f71b...6b00b3cad94e348c0ba31c196aaac9fbf819fea3,1,11,0,11,1,2012-11-24 20:25:54,2012-11-24 20:25:54
6b00b3cad94e348c0ba31c196aaac9fbf819fea3...3fce79484434298fb6ad16030674c14b9600b22e,2,4,3,7,4,2012-11-24 21:05:20,2012-11-24 21:03:57
3fce79484434298fb6ad16030674c14b9600b22e...78c1560065e664213ac0cbea7518d442a58b0018,3,21,2,23,4,2012-11-24 21:53:27,2012-09-07 18:12:24
78c1560065e664213ac0cbea7518d442a58b0018...67df705bf5205fa075ba6ceee2d7fd4763894a16,2,3,2,5,3,2012-11-24 22:22:14,2012-11-24 22:22:14
67df705bf5205fa075ba6ceee2d7fd4763894a16...5c62ac80f00bbd86555cf3d45714789f831130e3,1,12,2,14,4,2012-11-25 00:00:14,2012-11-24 23:59:56
5c62ac80f00bbd86555cf3d45714789f831130e3...c27dc018e22260b6ad084dff4505172e6b107178,1,1,1,2,1,2012-11-25 00:04:34,2012-11-25 00:04:34
c27dc018e22260b6ad084dff4505172e6b107178...a938d7b1282fc0e5c52502c225ae8f0cef219f0a,4,293,328,621,93,2012-11-25 18:07:46,2012-11-23 15:29:08
a938d7b1282fc0e5c52502c225ae8f0cef219f0a...ae215fdcf843862dbddbdfd68117ac2926e35a42,1,12,13,25,4,2012-11-25 19:54:07,2012-11-25 19:54:07
ae215fdcf843862dbddbdfd68117ac2926e35a42...84629a9b876f6969777b43f3229b62b43bb624d2,1,3,1,4,1,2012-11-25 20:16:16,2012-11-08 16:52:27
84629a9b876f6969777b43f3229b62b43bb624d2...516a7a8792200614d43caf1c9a004760fb5fec68,2,35,2,37,3,2012-11-25 20:23:02,2012-11-08 06:02:14
516a7a8792200614d43caf1c9a004760fb5fec68...53a06660d82d03dfff52a03a91f7d4408b6e6e47,1,1,1,2,1,2012-11-25 20:30:35,2012-11-25 18:50:49
fbee36be16e155cc1384f34a35b455c2413ea94d...2af3642cd5f968d64c40b83250e00e077b48c086,1,13,14,27,4,2012-05-07 20:05:05,2012-05-07 20:05:05
2af3642cd5f968d64c40b83250e00e077b48c086...df254d47e43e6e1652b20a3b338b26f634cd2b2a,1,4,9,13,4,2012-05-07 20:38:55,2012-05-07 20:38:55
df254d47e43e6e1652b20a3b338b26f634cd2b2a...b26c34a69ffed321a1e9b506b31224fcaf64b3b0,1,4,1,5,2,2012-05-07 20:45:22,2012-05-07 20:45:22
b26c34a69ffed321a1e9b506b31224fcaf64b3b0...38fe2deab51f5230fff899950fc35aaac4d6a859,1,3,4,7,2,2012-05-07 20:49:23,2012-05-07 20:49:23
38fe2deab51f5230fff899950fc35aaac4d6a859...fe88534b29594fdd29354f8003745eecab20b40e,1,3,0,3,1,2012-05-09 07:34:12,2012-05-09 07:34:00
fe88534b29594fdd29354f8003745eecab20b40e...c5fda2945c14566900d89b08c4202129e629877f,2,1,6,7,4,2012-05-11 19:02:18,2012-05-11 03:45:14
c5fda2945c14566900d89b08c4202129e629877f...56d5c1c3a3b012b159e56acbb655a14abfcc8894,2,1,33,34,3,2012-05-11 19:11:13,2012-05-11 19:11:13
56d5c1c3a3b012b159e56acbb655a14abfcc8894...afb34fe227d158b3a0bf1a9ac350b6c4da718d80,2,77,34,111,18,2012-05-11 20:22:00,2012-05-11 20:20:32
afb34fe227d158b3a0bf1a9ac350b6c4da718d80...7799f21307c3e7c16c1b99b79b8f9f93f969b440,1,14,0,14,1,2012-05-11 20:32:50,2012-05-11 20:32:50
7799f21307c3e7c16c1b99b79b8f9f93f969b440...b6581df5de2083e322dcbede4dce74bacf93af5f,2,7,5,12,5,2012-05-12 18:23:50,2012-05-12 17:38:33
b6581df5de2083e322dcbede4dce74bacf93af5f...f93a2f569d31c4d1fc86ff3ae9605309ac491d68,2,36,18,54,21,2012-05-12 19:41:39,2012-05-12 19:41:39
f93a2f569d31c4d1fc86ff3ae9605309ac491d68...7778c7722239bf5b286e4d8f2740af9abe800c09,1,1,1,2,1,2012-05-12 21:26:39,2012-05-12 21:26:39
7778c7722239bf5b286e4d8f2740af9abe800c09...ca48d490407b198e022b0d0294a7493602155f74,2,11,8,19,6,2012-05-14 18:22:51,2012-05-14 18:12:14
ca48d490407b198e022b0d0294a7493602155f74...f76518e3931f7f2522a38bf37a7df24a620858fc,2,8,6,14,4,2012-05-16 03:14:13,2012-05-16 03:14:13
f76518e3931f7f2522a38bf37a7df24a620858fc...c4e22ad8b5edd52ac78ec44bf7df8a7f37403623,6,14,20,34,8,2012-05-16 03:29:20,2012-05-15 01:02:42
c4e22ad8b5edd52ac78ec44bf7df8a7f37403623...63aaff590cccfcad2a73d328245e8ecb9ed6e6db,1,1,1,2,1,2012-05-16 14:08:50,2012-05-16 14:08:50
fcaef889682d6724f7b8e662c66a7539a95ae3d8...ef7bce7e5c67f29a7e09ea1b0bb43b429fc9f59b,3,54,3,57,5,2012-10-16 19:07:44,2012-10-16 18:59:36
fcaef889682d6724f7b8e662c66a7539a95ae3d8...ce5784a480ee6dc355fc961ab8bcd5828dabcbb6,2,39,3,42,6,2012-10-16 15:37:15,2012-10-16 15:37:15
ce5784a480ee6dc355fc961ab8bcd5828dabcbb6...420dcc58423dcfd3848fb62586da184b914cff22,3,5,10,15,5,2012-10-16 15:54:54,2012-10-16 15:52:48
420dcc58423dcfd3848fb62586da184b914cff22...45d64e8be1f4a6c579466f1a163463c53446fc76,1,8,8,16,1,2012-10-16 16:21:17,2012-10-16 16:21:17
45d64e8be1f4a6c579466f1a163463c53446fc76...69ce829dfe6805d3ad7b0c6937dba390a0840e0e,1,365,275,640,204,2012-10-16 16:29:21,2012-10-16 16:29:21
69ce829dfe6805d3ad7b0c6937dba390a0840e0e...861476eb3fb5e378fdbb4e86e4737daf6de27f13,4,30,2,32,4,2012-10-16 16:30:28,2012-10-16 16:22:31
861476eb3fb5e378fdbb4e86e4737daf6de27f13...bf145b6f3e953b53408f3fe52f24ccded38e44d3,1,1,1,2,1,2012-10-16 17:28:57,2012-10-16 17:28:57
bf145b6f3e953b53408f3fe52f24ccded38e44d3...fd5facf1d1db40149e0221ce8215b56f155b9394,4,13,13,26,13,2012-10-16 18:14:37,2012-10-16 18:14:09
fd5facf1d1db40149e0221ce8215b56f155b9394...e83bc970f2dc11fc0fd545cb0ec756a0eab64eda,4,79,49,128,13,2012-10-16 18:47:11,2012-10-16 18:36:47
e83bc970f2dc11fc0fd545cb0ec756a0eab64eda...1fdc0b7f7873885aebe279af9ffccb3900d804b2,1,6,3,9,1,2012-10-16 19:01:59,2012-10-16 19:01:59
1fdc0b7f7873885aebe279af9ffccb3900d804b2...0ea348bb5b4b8bac7b3bd35bd37396847847d766,1,1,1,2,1,2012-10-16 19:03:33,2012-10-16 19:02:26
0ea348bb5b4b8bac7b3bd35bd37396847847d766...aeb036893d35fe036f5d0e119b6ece46eaf3931b,1,4,4,8,1,2012-10-16 19:07:18,2012-10-16 19:06:51
53a06660d82d03dfff52a03a91f7d4408b6e6e47...07662406e1125cc7b5dc084fdd63b29644417d33,12,112,111,223,54,2012-11-26 08:20:43,2012-11-26 08:20:43
53a06660d82d03dfff52a03a91f7d4408b6e6e47...d31cef38f2aa76ca71ed18aa97d035a84c7e33e6,4,1523,2314,3837,180,2012-11-26 02:31:19,2012-11-26 02:31:19
d31cef38f2aa76ca71ed18aa97d035a84c7e33e6...603e70b90e7b1e848d04226f26668eaf77874bc7,1,45,65,110,5,2012-11-26 10:49:20,2012-11-26 10:49:20
603e70b90e7b1e848d04226f26668eaf77874bc7...512b826f9f14e30b715b943547b97aaaf1099f4e,1,1,3,4,1,2012-11-26 11:09:42,2012-11-26 11:09:42
512b826f9f14e30b715b943547b97aaaf1099f4e...0877d424e08d57e6f0d1da9a86289fb10d0ee136,12,112,111,223,54,2012-11-27 00:59:22,2012-11-26 08:20:43
947acfc32e7cc72a3523d177716888b7d6d91c87...f9f034db6f411282e7a9ca921debf23b386f6010,1,1,1,2,1,2012-10-16 19:23:03,2012-10-16 19:23:03
f9f034db6f411282e7a9ca921debf23b386f6010...8bae5e19af30208a25ea357921f46845f6793951,1,3,1,4,2,2012-10-16 20:08:13,2012-10-16 20:08:13
8bae5e19af30208a25ea357921f46845f6793951...f47e3da3c29e958805465910b68012e1df52d760,1,1,1,2,1,2012-10-16 20:42:21,2012-10-16 20:42:06
f47e3da3c29e958805465910b68012e1df52d760...e2ff2b11207b7fce50d53fe6435b44b244e96523,1,27,22,49,18,2012-10-16 20:43:44,2012-10-16 20:43:30
e2ff2b11207b7fce50d53fe6435b44b244e96523...51feba61197b837b7d55754a56e12f66f0624ba1,1,1,1,2,1,2012-10-16 20:45:56,2012-10-16 20:45:50
51feba61197b837b7d55754a56e12f66f0624ba1...0c1cea376196d24acc73c64dbdff1880a2dfd006,2,101,58,159,17,2012-10-16 20:50:40,2012-10-16 20:50:30
0c1cea376196d24acc73c64dbdff1880a2dfd006...e03d9999398c772220a0f5e77f5660b949617b26,1,1,1,2,1,2012-10-16 21:19:36,2012-10-16 21:19:36
e03d9999398c772220a0f5e77f5660b949617b26...d1ad6c7eb5b4d48194fad11abf3c74d5c0d1ef0c,1,1,1,2,1,2012-10-16 21:25:20,2012-10-16 21:25:20
d1ad6c7eb5b4d48194fad11abf3c74d5c0d1ef0c...7607068faa13fea33d2cce6caf1420800ed00d52,1,1,1,2,1,2012-10-17 15:13:26,2012-10-16 21:28:57
7607068faa13fea33d2cce6caf1420800ed00d52...3bfd15878442ed97a7c768a09ccd51571d4e1d47,1,0,5,5,1,2012-10-17 16:50:23,2012-10-17 16:50:10
3bfd15878442ed97a7c768a09ccd51571d4e1d47...16d996ba0c150101632cef140116b7f68da162f8,8,11,14,25,12,2012-10-17 16:52:12,2012-10-17 16:50:12
16d996ba0c150101632cef140116b7f68da162f8...995f816cf4e0a404075c27e0d249db0b4a07a97e,1,1,1,2,1,2012-10-17 16:59:43,2012-10-17 07:29:21
995f816cf4e0a404075c27e0d249db0b4a07a97e...425272aea1fb30b734bac25b8f74dbe85a3ce215,2,62,50,112,17,2012-10-17 17:41:49,2012-10-17 17:40:52
425272aea1fb30b734bac25b8f74dbe85a3ce215...a15147199edff1b1c0fab89c66214abfb8c65d7c,1,1,1,2,1,2012-10-17 17:47:47,2012-10-17 17:47:47
a15147199edff1b1c0fab89c66214abfb8c65d7c...fad0e221818f0a78550584b3c0a16a6808ecd921,1,19,2,21,3,2012-10-17 18:52:16,2012-10-17 18:51:58
fad0e221818f0a78550584b3c0a16a6808ecd921...063ea024e945adbeefbf88578f8ba424ca8a0939,1,1,1,2,1,2012-10-17 19:02:31,2012-10-15 19:16:11
063ea024e945adbeefbf88578f8ba424ca8a0939...c31539c8a21e828efb296573c0272bc21220e24c,2,2,2,4,2,2012-10-17 19:20:50,2012-10-17 19:20:15
c31539c8a21e828efb296573c0272bc21220e24c...ee9687d441d625a420dc65590bbd0b930f800b3f,4,88,17,105,9,2012-10-17 20:28:55,2012-10-16 18:51:54
c4858c1b265d33e9b84fd6b0d95c592555a67865...e679f6c2db76bea42ab84a2c6c16b1e9f5cffd19,1,2,2,4,1,2012-11-27 01:38:20,2012-11-27 01:38:20
e679f6c2db76bea42ab84a2c6c16b1e9f5cffd19...b9dfcfd7362825ccda0ca4ea96d385b0c6ae522d,2,8,8,16,2,2012-11-27 01:39:08,2012-11-27 01:39:08
b9dfcfd7362825ccda0ca4ea96d385b0c6ae522d...243d4cc83cf15f30db1e09d9374c265a1513b18d,2,31,30,61,13,2012-11-27 14:46:06,2012-11-27 14:46:06
243d4cc83cf15f30db1e09d9374c265a1513b18d...1052f9cb2bad094144fa1186b0be8f477a9d4fa1,1,2,2,4,2,2012-11-27 14:53:30,2012-11-27 14:53:30
1052f9cb2bad094144fa1186b0be8f477a9d4fa1...9ae6b1a019553e95a6205d5c42ff7fa25e7a482e,3,18,19,37,11,2012-11-28 02:32:59,2012-11-28 02:32:59
9ae6b1a019553e95a6205d5c42ff7fa25e7a482e...081c4efcf7736433d2fb5702e7bd4f8616426af2,1,3,0,3,1,2012-11-28 22:59:37,2012-11-28 22:59:37
081c4efcf7736433d2fb5702e7bd4f8616426af2...6378a19c46421d20a26e6b3a3c21caf0ea2fedfa,1,34,0,34,1,2012-11-28 23:15:17,2012-11-28 23:15:17
6378a19c46421d20a26e6b3a3c21caf0ea2fedfa...8a79be7894b352c0947a8b067f83b8ef388dfc48,1,16,16,32,11,2012-11-29 16:16:42,2012-11-29 16:16:42
8a79be7894b352c0947a8b067f83b8ef388dfc48...e63625e16e0e337d2ddafd6b46313434dfae3f84,1,2,3,5,1,2012-11-29 16:28:16,2012-11-29 16:28:16
e63625e16e0e337d2ddafd6b46313434dfae3f84...b382af685a3f590d03be7a9dc790a657c7b33f99,1,1,1,2,1,2012-11-30 21:11:51,2012-11-30 21:11:51
b382af685a3f590d03be7a9dc790a657c7b33f99...c2d6847de09a52496f78baebc04f317e11ece6d2,2,43,143,186,25,2012-12-02 01:29:32,2012-12-01 20:25:52
c2d6847de09a52496f78baebc04f317e11ece6d2...b5acda7af2a0add9c06f3d996f54a99e91b049ad,1,16,27,43,10,2012-12-02 15:48:26,2012-12-02 15:48:26
b5acda7af2a0add9c06f3d996f54a99e91b049ad...27c9360a1b3c099850f4da8ba26a387f88b1897e,1,1,1,2,1,2012-12-02 15:53:34,2012-12-02 15:53:34
27c9360a1b3c099850f4da8ba26a387f88b1897e...5b9bf134390d56d6b6916225d86c1328e70e9970,7,68,54,122,31,2012-12-03 04:32:16,2012-12-03 04:32:16
5b9bf134390d56d6b6916225d86c1328e70e9970...ad690f815108cc1e05c2eb265e46140fd3236671,2,4,2,6,2,2012-12-03 05:49:40,2012-12-03 05:49:40
ad690f815108cc1e05c2eb265e46140fd3236671...4ada325479d11e34b462912b835cf5ad7369d33b,2,29,23,52,8,2012-12-03 16:32:19,2012-12-03 16:32:19
4ada325479d11e34b462912b835cf5ad7369d33b...3ab26340dcdf001da4e93df2f187a8343615673c,1,1,1,2,1,2012-12-04 04:43:34,2012-12-04 04:43:34
3ab26340dcdf001da4e93df2f187a8343615673c...228ab3ddae527f72cc3122a1c6115d7718bcfd57,38,828,1301,2129,247,2012-12-04 06:40:12,2012-12-04 06:39:27
228ab3ddae527f72cc3122a1c6115d7718bcfd57...2a419a7e8f339b24121e12be891b908dff2be76f,1,4,4,8,3,2012-12-04 06:45:30,2012-12-04 06:45:30
2a419a7e8f339b24121e12be891b908dff2be76f...ec72d9f4db9ede84f4c1fb3d4e0e29083dd07095,1,798,598,1396,349,2012-12-05 01:42:52,2012-12-04 18:21:47
ec72d9f4db9ede84f4c1fb3d4e0e29083dd07095...13449a99b2b279a7ae6401b8373d20504362213d,3,9,101,110,12,2012-12-05 02:30:37,2012-12-05 02:30:37
13449a99b2b279a7ae6401b8373d20504362213d...551c2c9f4ac776b6d53600c452ad40a4b4d6670b,2,128,113,241,101,2012-12-05 02:50:22,2012-12-05 02:50:22
551c2c9f4ac776b6d53600c452ad40a4b4d6670b...4437002771f6ab70fba6e2e9bd9cf60957e70871,1,2,2,4,2,2012-12-05 03:14:08,2012-12-05 03:14:08
4437002771f6ab70fba6e2e9bd9cf60957e70871...20608b3579d70d3bac7fd74b4e11e4c08cd9d9b5,2,86,89,175,85,2012-12-05 07:12:32,2012-12-05 06:43:16
20608b3579d70d3bac7fd74b4e11e4c08cd9d9b5...7f7007dffe1a867de5485533d490834ee71c7a4c,2,89,86,175,85,2012-12-05 13:54:00,2012-12-05 13:54:00
7f7007dffe1a867de5485533d490834ee71c7a4c...6df2900d3a201ba84d56dfb0eb67d4c6e88aaec2,1,4,4,8,3,2012-12-05 13:54:10,2012-12-05 13:54:10
6df2900d3a201ba84d56dfb0eb67d4c6e88aaec2...b7ece8c6206d87e71145d1aeefc984e1649af06a,38,1301,828,2129,248,2012-12-05 13:54:14,2012-12-05 13:54:14
b7ece8c6206d87e71145d1aeefc984e1649af06a...abe009cf263e2d3f29d96ad5abe5343922b11510,1,1,1,2,1,2012-12-06 03:42:54,2012-12-06 03:09:43
abe009cf263e2d3f29d96ad5abe5343922b11510...9bfe9e7dfb888c4cbd09a8b476444a9201ecdbee,1,1,1,2,1,2012-12-06 04:30:53,2012-12-06 04:30:53
9bfe9e7dfb888c4cbd09a8b476444a9201ecdbee...26bf8dd56bfbef54a07cbba519485dcd59add839,1,1,1,2,1,2012-12-06 04:47:33,2012-12-06 04:47:33
26bf8dd56bfbef54a07cbba519485dcd59add839...5dd8a90f734297d51ef74a6c4be23c2a4e43c4df,8,111,118,229,15,2012-12-06 18:46:37,2012-11-25 19:30:16
5dd8a90f734297d51ef74a6c4be23c2a4e43c4df...747600b157a831422a7c5acd8b768c348b673495,1,0,122,122,1,2012-12-06 22:01:36,2012-12-06 22:01:36
747600b157a831422a7c5acd8b768c348b673495...282c044d64e366d1bcb76d7d4f49c54098c6547f,2,6,20,26,4,2012-12-07 02:17:27,2012-12-07 02:17:27
282c044d64e366d1bcb76d7d4f49c54098c6547f...23d7cf0488bfeaab51d8f55435cab01f5cf990ca,2,9,6,15,4,2012-12-07 14:14:12,2012-12-07 14:14:12
23d7cf0488bfeaab51d8f55435cab01f5cf990ca...d343e6b9ed501052f1676694d5e53649c92e65a0,2,60,52,112,10,2012-12-08 23:04:13,2012-12-08 23:04:13
d343e6b9ed501052f1676694d5e53649c92e65a0...f8f52cfcf4ff5d0e3e50a73b03aff0fd9c72105b,2,6,53,59,5,2012-12-09 19:10:38,2012-12-08 19:49:42
f8f52cfcf4ff5d0e3e50a73b03aff0fd9c72105b...2eda329be6ac2f68e9b313ee607ea24165c68755,2,5,12,17,5,2012-12-09 19:46:06,2012-12-09 19:45:31
2eda329be6ac2f68e9b313ee607ea24165c68755...7d5b86ec39eed3361a48b9a90627af22f9f25e1e,1,13,10,23,6,2012-12-10 15:05:39,2012-12-10 15:05:39
7d5b86ec39eed3361a48b9a90627af22f9f25e1e...07a7b3e4cf961e51bddcdb90cdca34f9126ed286,2,238,100,338,51,2012-12-10 18:52:02,2012-12-10 18:52:02
07a7b3e4cf961e51bddcdb90cdca34f9126ed286...3c7f2af81d877b24a5e5b6488e78621fcf96b265,2,7,1,8,2,2012-12-11 01:19:26,2012-12-11 01:19:26
3c7f2af81d877b24a5e5b6488e78621fcf96b265...cef044d82ec0d338b2b69756d3ba08692fb80ae4,1,5,0,5,1,2012-12-11 01:45:20,2012-12-10 21:38:50
cef044d82ec0d338b2b69756d3ba08692fb80ae4...d41b983259042d3a07ae785c09f71c68d9ce7c3f,3,4,4,8,4,2012-12-11 01:51:49,2012-12-10 08:00:12
d41b983259042d3a07ae785c09f71c68d9ce7c3f...55313d32a22246fa1e09c3d66713632359848806,9,41,43,84,28,2012-12-11 02:48:20,2012-12-11 00:07:07
55313d32a22246fa1e09c3d66713632359848806...aa0e4aadd56002928d429af771b26114493486ac,1,1,1,2,1,2012-12-11 14:25:37,2012-12-11 14:25:37
aa0e4aadd56002928d429af771b26114493486ac...a918dc8aacb8461321c332f6f3b5756bdda5e8b2,4,58,43,101,38,2012-12-11 18:58:14,2012-12-10 23:25:23
a918dc8aacb8461321c332f6f3b5756bdda5e8b2...ef6d8779de9d5959eafc0b9706b90a585aaf7a26,3,32,1,33,3,2012-12-11 18:58:14,2012-12-11 13:06:48
ef6d8779de9d5959eafc0b9706b90a585aaf7a26...f42e1e654f43e9207c5b2f651c410f344982c2b5,1,16,17,33,7,2012-12-11 21:12:23,2012-12-11 21:12:23
f42e1e654f43e9207c5b2f651c410f344982c2b5...93e18922c5b6f6c1472cc0b44c65c70603d57cdd,2,64,26,90,10,2012-12-12 03:06:26,2012-11-18 18:53:24
93e18922c5b6f6c1472cc0b44c65c70603d57cdd...32842ac36564e9db60bcf8ad841674b161e7c924,3,16,4,20,4,2012-12-12 03:38:37,2012-12-01 22:11:56
32842ac36564e9db60bcf8ad841674b161e7c924...1d1c80d377bf3e4ae382a6ecd06624866e620fb6,1,1,1,2,1,2012-12-12 04:05:18,2012-12-12 04:05:18
1d1c80d377bf3e4ae382a6ecd06624866e620fb6...aad235b3251494afe71fd5bb6031e11965af9bdb,2,7,16,23,12,2012-12-12 04:16:08,2012-12-12 04:03:12
aad235b3251494afe71fd5bb6031e11965af9bdb...f12611feb43adb2b014eb2183db0713451746aff,2,42,4,46,5,2012-12-12 04:35:22,2012-12-10 21:12:54
f12611feb43adb2b014eb2183db0713451746aff...40e08f81bd880afc5197ab145bce30d28e88c88f,1,1,1,2,1,2012-12-12 04:35:51,2012-12-12 04:35:51
40e08f81bd880afc5197ab145bce30d28e88c88f...0018f7700bf8004d573c752ecbf66f299769c4de,2,10,16,26,5,2012-12-13 14:19:41,2012-12-12 22:05:50
0018f7700bf8004d573c752ecbf66f299769c4de...13651f296d14b2400d703d1945065c0373862eb5,2,33,1,34,2,2012-12-13 14:29:40,2012-10-01 23:36:54
13651f296d14b2400d703d1945065c0373862eb5...a270d638f84f4ac4ea419665249bdf7952671f09,1,13,13,26,9,2012-12-13 15:06:06,2012-12-11 04:39:08
a270d638f84f4ac4ea419665249bdf7952671f09...ca26d45395c8a790027633dec5a2ebc15ce9149a,2,8,2,10,4,2012-12-13 15:13:50,2012-12-13 01:19:18
ca26d45395c8a790027633dec5a2ebc15ce9149a...643ecf9d63018a7ef907c1e058b778b68ddaf48f,5,86,87,173,9,2012-12-13 15:42:43,2012-11-18 22:03:38
643ecf9d63018a7ef907c1e058b778b68ddaf48f...452e32769d514d835988c544492e4083df2bc1d6,2,31,31,62,18,2012-12-13 17:41:25,2012-12-13 17:40:55
452e32769d514d835988c544492e4083df2bc1d6...05531fc4080ae24070930d15ae0cea7ae056457d,5,21,12,33,10,2012-12-13 20:31:02,2012-06-20 15:19:24
05531fc4080ae24070930d15ae0cea7ae056457d...7d61c5238e57cf252faa2d999465bd69afc6c038,1,3,3,6,3,2012-12-13 20:52:59,2012-12-13 20:52:59
7d61c5238e57cf252faa2d999465bd69afc6c038...2c40fdd4a852fe6ee16feaa3bb6d7d49c7a02606,4,79,68,147,30,2012-12-14 15:37:20,2012-12-08 21:28:10
2c40fdd4a852fe6ee16feaa3bb6d7d49c7a02606...04bcb173a0f15aca97127dff625b2d55f2b49c41,1,1,1,2,1,2012-12-14 22:24:39,2012-12-14 22:24:19
04bcb173a0f15aca97127dff625b2d55f2b49c41...8b4cdbb663276e15197486c91850fab2dd390faf,1,1,1,2,1,2012-12-15 00:00:41,2012-12-15 00:00:41
8b4cdbb663276e15197486c91850fab2dd390faf...73689060ef75ca2747fa9e09c966f5c6d5eb0abb,1,1,1,2,1,2012-12-15 00:06:31,2012-12-15 00:06:31
73689060ef75ca2747fa9e09c966f5c6d5eb0abb...60fdc12b96ca4c4a5cf21f79a8175286b867ba3b,1,1,1,2,1,2012-12-15 06:26:18,2012-12-15 06:26:18
60fdc12b96ca4c4a5cf21f79a8175286b867ba3b...8424933153225cfd399b66588795741d2db6d8dd,1,1,1,2,1,2012-12-15 15:26:24,2012-12-15 15:26:16
8424933153225cfd399b66588795741d2db6d8dd...cc164a36f499422bd19f2b3eb8672e8185fa3e76,1,1,1,2,1,2012-12-15 15:33:33,2012-12-15 15:33:33
cc164a36f499422bd19f2b3eb8672e8185fa3e76...d907848642c6cd0af0ea67323b1762757b027d46,1,1,1,2,1,2012-12-15 15:50:35,2012-12-15 15:50:35
d907848642c6cd0af0ea67323b1762757b027d46...54cbcf1f3df04ae7bba1b981c49161debb248fba,1,1,1,2,1,2012-12-15 17:50:30,2012-12-15 17:50:30
54cbcf1f3df04ae7bba1b981c49161debb248fba...55a8ba52268ba0ef33cb750f5795add38f29d067,1,1,1,2,1,2012-12-15 18:05:58,2012-12-15 18:05:58
55a8ba52268ba0ef33cb750f5795add38f29d067...a763ae72775f69509d0a8a6b50702bcf2c7e6fbf,5,116,95,211,29,2012-12-16 04:16:48,2012-12-09 05:26:24
a763ae72775f69509d0a8a6b50702bcf2c7e6fbf...30e2ffbeb869bb2f65ef139633c68a1c62f0e892,1,1,4,5,1,2012-12-16 04:42:24,2012-12-16 04:42:24
30e2ffbeb869bb2f65ef139633c68a1c62f0e892...06f46dad9307c17d4aad6add2d3a9b0b2d3b451a,2,10,3,13,3,2012-12-16 15:39:19,2012-12-16 15:39:19
06f46dad9307c17d4aad6add2d3a9b0b2d3b451a...2ea7876c2510a7d4a609561648c34edea0aeb8d5,1,2,2,4,1,2012-12-16 18:09:40,2012-12-16 17:37:20
2ea7876c2510a7d4a609561648c34edea0aeb8d5...24db7346efb48ca857a2e44c610f6717e73f7f24,1,3,3,6,1,2012-12-16 22:19:48,2012-12-16 21:03:30
24db7346efb48ca857a2e44c610f6717e73f7f24...bddd10037a31aad68b5bb69f0b76dd0dd0ecb8af,1,45,30,75,16,2012-12-16 22:19:51,2012-12-16 22:13:17
bddd10037a31aad68b5bb69f0b76dd0dd0ecb8af...6ecac3b152b9ff6e6fd69af1efd4c5c5dafaf5be,1,1,2,3,1,2012-12-16 23:55:42,2012-12-16 23:55:42
6ecac3b152b9ff6e6fd69af1efd4c5c5dafaf5be...d2262fbd9b26d9ac53b88a7f4eea246f7bac1776,1,1,1,2,1,2012-12-17 00:54:45,2012-12-17 00:54:45
d2262fbd9b26d9ac53b88a7f4eea246f7bac1776...7d91be50ad60d2f257cae2a6991493d6d3a1c382,1,1,1,2,1,2012-12-17 00:55:09,2012-12-17 00:55:09
7d91be50ad60d2f257cae2a6991493d6d3a1c382...d6d6c3efe777ae796ace42dcb2462f8118023062,1,1,1,2,1,2012-12-17 17:10:22,2012-12-17 17:10:12
d6d6c3efe777ae796ace42dcb2462f8118023062...5c8984efc4a8c0472bcdc514e744b063e8f98a61,1,1,1,2,1,2012-12-17 20:13:09,2012-12-17 20:13:09
5c8984efc4a8c0472bcdc514e744b063e8f98a61...963c47f9ed5a79f2a75d925bba017c61f0419609,1,1,1,2,1,2012-12-18 16:50:54,2012-12-18 16:50:54
963c47f9ed5a79f2a75d925bba017c61f0419609...eed78cc321ed7e2b37fb34e32fbb528b24f61d6e,1,0,9,9,1,2012-12-18 18:24:05,2012-12-18 18:24:05
eed78cc321ed7e2b37fb34e32fbb528b24f61d6e...c928ed432a164e7f6caa057e128db4a4c5040405,1,25,578,603,18,2012-12-18 19:42:37,2012-12-18 19:42:37
ee9687d441d625a420dc65590bbd0b930f800b3f...9346c0ef9938b44f3711d588ebdb6800bc077d8f,4,5,0,5,5,2012-10-18 04:50:01,2012-10-18 04:50:01
9346c0ef9938b44f3711d588ebdb6800bc077d8f...739ba96318f65d2f2c3c80772519fc0887a8c798,1,0,1,1,1,2012-10-19 08:09:52,2012-10-19 08:09:52
c928ed432a164e7f6caa057e128db4a4c5040405...92001a384fac58e33eb4d211144086feef853245,1,2,2,4,1,2012-12-19 17:19:20,2012-12-19 17:19:20
92001a384fac58e33eb4d211144086feef853245...cc97125560d16fde1fad54974b10b5526f1309af,2,86,99,185,33,2012-12-19 23:37:39,2012-12-19 04:02:50
cc97125560d16fde1fad54974b10b5526f1309af...3ffaa0fecb571f1c5a5d2ca212e9a009fe0571a4,1,1,0,1,1,2012-12-20 00:06:16,2012-12-20 00:06:16
3ffaa0fecb571f1c5a5d2ca212e9a009fe0571a4...34946b3d63afb6943febe0ac4be4dcecc739729d,2,7,5,12,3,2012-12-20 01:18:58,2012-12-20 01:18:58
34946b3d63afb6943febe0ac4be4dcecc739729d...96a349e46d61ee05e576b8544051e375094c0b4d,1,6,6,12,2,2012-12-20 02:59:42,2012-12-20 02:59:18
96a349e46d61ee05e576b8544051e375094c0b4d...5afc93c436020f8ceabe8cab449f1c0030ba6ecd,2,12,3,15,4,2012-12-21 01:55:30,2012-12-19 23:52:08
5afc93c436020f8ceabe8cab449f1c0030ba6ecd...00bbbe207555d3aa9d7716bb9fc6d4e4f4bcbf1e,1,1,1,2,1,2012-12-21 02:56:53,2012-12-21 02:56:53
00bbbe207555d3aa9d7716bb9fc6d4e4f4bcbf1e...c8c6ab6924b48832bfc2b94d40887b2f1b6c891e,4,180,86,266,42,2012-12-21 03:08:32,2012-12-17 14:17:39
c8c6ab6924b48832bfc2b94d40887b2f1b6c891e...efb139f7ad22dc4a31d8ef8d5c1d67623b2563e3,1,1,1,2,1,2012-12-21 04:38:19,2012-12-21 04:12:32
efb139f7ad22dc4a31d8ef8d5c1d67623b2563e3...1e7e541b8b984d015c2052deaaa378a808265e11,1,1,1,2,1,2012-12-21 15:34:03,2012-12-21 15:34:03
1e7e541b8b984d015c2052deaaa378a808265e11...3e1589db32f75ede5ea0e927d7ecc6818e5a7b47,1,1,1,2,1,2012-12-21 20:51:37,2012-12-21 20:51:37
3e1589db32f75ede5ea0e927d7ecc6818e5a7b47...b8487664ade1a6bb39959b613846e720ac7901a6,1,29,32,61,15,2012-12-22 21:10:44,2012-12-22 21:10:06
b8487664ade1a6bb39959b613846e720ac7901a6...b20f536748300d5aef31ad68cc5adff849a1ee13,1,1,1,2,1,2012-12-22 21:23:27,2012-12-22 21:23:27
b20f536748300d5aef31ad68cc5adff849a1ee13...e29619031bd28bb1185316d8b2dc4b00a5809ed6,1,12,7,19,4,2012-12-22 21:55:10,2012-12-22 21:55:10
e29619031bd28bb1185316d8b2dc4b00a5809ed6...4de4be42f6327c4f3d833191caf6ee9caa89c852,1,2,2,4,1,2012-12-23 19:45:49,2012-12-23 19:45:49
4de4be42f6327c4f3d833191caf6ee9caa89c852...d8298046311e66a47424ec3f3cbe77e97bee3958,2,3,3,6,2,2012-12-23 20:09:10,2012-12-18 17:20:56
d8298046311e66a47424ec3f3cbe77e97bee3958...5eec75e582d27e2d4f625f6be33eabad84f16239,2,17,4,21,3,2012-12-23 20:41:56,2012-12-18 15:33:32
5eec75e582d27e2d4f625f6be33eabad84f16239...861a45b8fffc2073baa9f62b0648f395f0695f3e,1,6,7,13,2,2012-12-23 20:57:01,2012-12-23 20:57:01
c928ed432a164e7f6caa057e128db4a4c5040405...65bdfbf07f911d5014e32ab126ef0c568c22bf49,2,81,73,154,50,2012-12-19 15:42:33,2012-12-18 11:29:04
65bdfbf07f911d5014e32ab126ef0c568c22bf49...38941579fc48d4a25bea4000c6457861f41c5a4e,1,2,1,3,1,2012-12-19 15:42:33,2012-12-19 15:38:33
c928ed432a164e7f6caa057e128db4a4c5040405...1e0eca0f774462e05ffe42a708a3f3abae63ba22,1,35,128,163,13,2012-12-19 03:21:32,2012-12-18 18:17:40
b386080798a34d974f8da195bfa8a1c581798507...c6cf30a56e29c7f8e009443611f86a4c0839b689,3,40,2,42,3,2012-10-19 20:42:13,2012-10-16 00:22:19
c6cf30a56e29c7f8e009443611f86a4c0839b689...3144163f61ea89855818fab597a2b5f1074d10c3,1,36,33,69,13,2012-10-19 21:18:33,2012-10-19 21:18:33
3144163f61ea89855818fab597a2b5f1074d10c3...32051e97c1e77d0b678648832d090168b534841c,1,14,71,85,7,2012-10-20 01:59:45,2012-10-20 01:59:33
32051e97c1e77d0b678648832d090168b534841c...b5084b4bf29a2e517b90d5e7d82ed17c94a71d94,2,16,48,64,11,2012-10-20 02:32:25,2012-10-19 21:08:50
b5084b4bf29a2e517b90d5e7d82ed17c94a71d94...5228f0a61843db2bc93ff441ea748aa5e0ce08f4,1,1,1,2,1,2012-10-20 14:07:01,2012-10-20 14:01:31
5228f0a61843db2bc93ff441ea748aa5e0ce08f4...a7a8aad4e335f7d61de688f50aefcca4756a2651,1,2,0,2,1,2012-10-20 17:46:11,2012-10-20 17:46:11
a7a8aad4e335f7d61de688f50aefcca4756a2651...408e5e08c23dda11e6e7a7f8dc44c9e6fcbe870d,1,7,3,10,2,2012-10-20 18:00:30,2012-10-15 15:54:32
408e5e08c23dda11e6e7a7f8dc44c9e6fcbe870d...144b8bfeadc5316656105e1a10a31ba5348ef5d6,1,1,1,2,1,2012-10-20 18:58:19,2012-10-11 18:30:51
144b8bfeadc5316656105e1a10a31ba5348ef5d6...2b0e720406c42a4065010ba94e7adb7170ba74c3,4,28,1,29,4,2012-10-20 19:27:43,2012-10-15 18:20:36
2b0e720406c42a4065010ba94e7adb7170ba74c3...8076a33bd86d15b80992602f4cd662ef741fd803,3,5,2,7,3,2012-10-21 01:02:21,2012-10-21 01:02:01
8076a33bd86d15b80992602f4cd662ef741fd803...cafb542da901254fb5dff0f7bc97f0d2521c45a7,1,1,2,3,2,2012-10-21 01:25:39,2012-10-21 01:24:07
cafb542da901254fb5dff0f7bc97f0d2521c45a7...de9ff7cd171ebb47954ad95d50d2e41a49a7bfd2,2,10,2,12,3,2012-10-21 02:10:06,2012-07-19 15:54:14
de9ff7cd171ebb47954ad95d50d2e41a49a7bfd2...08341437e09524f757be435b185c564e8de8101d,1,0,5,5,1,2012-10-21 02:18:29,2012-10-21 02:18:29
08341437e09524f757be435b185c564e8de8101d...9dd0b010174dbfa70142a995a875a316337e1913,2,56,18,74,8,2012-10-21 02:29:18,2012-08-14 20:10:10
9dd0b010174dbfa70142a995a875a316337e1913...2decd0510d8bd70fe7bbae9ebbacc49717376cfd,1,1,1,2,1,2012-10-21 12:31:37,2012-10-21 12:31:37
2decd0510d8bd70fe7bbae9ebbacc49717376cfd...696c553053c24909dfc8feddff7b73d18f5abb2a,1,28,12,40,12,2012-10-22 00:14:05,2012-10-21 18:17:46
696c553053c24909dfc8feddff7b73d18f5abb2a...d0015ecd2fae7a194edb6b7927132cda8a269e10,1,1,1,2,1,2012-10-22 00:19:51,2012-10-22 00:19:51
d0015ecd2fae7a194edb6b7927132cda8a269e10...23d125a51acc1cd2d127c9feb684aa96cea7d1fc,1,8,1,9,4,2012-10-22 00:55:26,2012-10-22 00:55:26
23d125a51acc1cd2d127c9feb684aa96cea7d1fc...227c49a4596423a125bdcb1d25a2263e526360db,2,10,1,11,2,2012-10-22 01:06:41,2012-08-28 13:26:06
227c49a4596423a125bdcb1d25a2263e526360db...bede0123d99ed41ef2214edde795927e2a777f8a,3,4,5,9,3,2012-10-22 17:29:43,2012-10-22 17:28:51
bede0123d99ed41ef2214edde795927e2a777f8a...53b770e1fd84d8ef1c77df4bdf001fdd57a9ed10,1,4,0,4,1,2012-10-23 23:21:49,2012-10-23 23:21:49
53b770e1fd84d8ef1c77df4bdf001fdd57a9ed10...5dc37bb0b56e9eba94d10eabeea2d49496d80c3f,1,2,1,3,1,2012-10-24 00:38:42,2012-10-24 00:38:42
5dc37bb0b56e9eba94d10eabeea2d49496d80c3f...2eff7fe72d5e07871c502c8839989c8e2f3f0b25,2,2,2,4,2,2012-10-24 14:35:08,2012-10-24 14:31:22
2eff7fe72d5e07871c502c8839989c8e2f3f0b25...812c6087ada4a6383fd2e033d04648ec0f6691ea,2,78,0,78,2,2012-10-24 18:12:28,2012-10-24 18:12:28
812c6087ada4a6383fd2e033d04648ec0f6691ea...a7158fac1764c16e755489d376d90eea54e0f754,1,3,6,9,6,2012-10-24 20:47:40,2012-10-24 20:47:40
a7158fac1764c16e755489d376d90eea54e0f754...305e169ad663849cd8b4935e8f70c55dc8e2be01,1,7,5,12,5,2012-10-25 02:25:47,2012-10-25 02:25:08
305e169ad663849cd8b4935e8f70c55dc8e2be01...69e2f068fe7d16c1ccd6cb99c6376f0d8891ea33,3,9,14,23,10,2012-10-25 02:36:20,2012-10-24 00:22:34
69e2f068fe7d16c1ccd6cb99c6376f0d8891ea33...b398a68333d5eb9859fabb1ceabe84a1a753760a,3,18,36,54,19,2012-10-25 03:35:15,2012-08-19 19:53:09
b398a68333d5eb9859fabb1ceabe84a1a753760a...63d72536ba4f4031431dcf3984ebfbe9c90203f2,1,2,2,4,1,2012-10-25 14:32:30,2012-10-25 12:46:53
63d72536ba4f4031431dcf3984ebfbe9c90203f2...4f0e1e7c6588850feee6749d9be9a081ecbabc94,1,22,57,79,8,2012-10-25 14:50:57,2012-10-25 14:50:57
4f0e1e7c6588850feee6749d9be9a081ecbabc94...18e7a53d15dadae24703178a87192104935551b4,2,48,14,62,12,2012-10-26 00:41:47,2012-10-26 00:41:47
18e7a53d15dadae24703178a87192104935551b4...8121309694630d3cb29e5b8dc4ad81527a5bb494,1,6,1,7,2,2012-10-26 16:40:57,2012-10-26 16:38:05
8121309694630d3cb29e5b8dc4ad81527a5bb494...36c9ecb0f50aec9063725b0c45e0cca98ef87084,11,345,249,594,92,2012-10-29 02:44:57,2012-10-17 08:33:47
36c9ecb0f50aec9063725b0c45e0cca98ef87084...5be4c10cf78c0ec6785217a8a4ea10eacaedeb1c,1,1,0,1,1,2012-10-29 02:53:32,2012-10-29 02:53:32
5be4c10cf78c0ec6785217a8a4ea10eacaedeb1c...bea5ecbba72f22e8924186d9b81839122ec86aef,2,21,13,34,7,2012-10-29 03:32:54,2012-09-28 20:56:49
bea5ecbba72f22e8924186d9b81839122ec86aef...c78a3ba6577b6735137abcd5c01a35ca28c33660,3,23,4,27,5,2012-10-30 14:20:54,2012-10-22 03:40:37
c78a3ba6577b6735137abcd5c01a35ca28c33660...e8f91514a6f353e85d8117998087903dc7331210,2,36,27,63,17,2012-10-30 17:32:53,2012-10-30 17:32:53
e8f91514a6f353e85d8117998087903dc7331210...6e75fe5f1945893cce3ced481e586d8ad6cbfa1d,3,48,22,70,14,2012-10-31 20:41:31,2012-10-31 17:26:43
6e75fe5f1945893cce3ced481e586d8ad6cbfa1d...e8cf41a051a62bf1f19beab1a5c1d643f121e28e,3,7,90,97,13,2012-11-01 01:27:42,2012-10-31 17:55:51
e8cf41a051a62bf1f19beab1a5c1d643f121e28e...5ed0450dc471f61e4c5d5df30df3f3294a3e6bd6,1,10,30,40,5,2012-11-01 02:43:04,2012-11-01 02:43:04
5ed0450dc471f61e4c5d5df30df3f3294a3e6bd6...8657538b33ed80864047ea5c2ebafc65cb199bb7,1,3,1,4,2,2012-11-01 03:36:43,2012-11-01 03:36:43
8657538b33ed80864047ea5c2ebafc65cb199bb7...03a076281722b171e904009107f9cb45f5d955af,1,28,13,41,14,2012-11-01 04:29:58,2012-11-01 04:29:58
03a076281722b171e904009107f9cb45f5d955af...14e1501b89491bad5744af4f2a8d084834f9c295,5,28,14,42,15,2012-11-01 04:40:27,2012-11-01 04:40:27
14e1501b89491bad5744af4f2a8d084834f9c295...e2cdf527d6a04bdcb98081a9f4f3672ea2e90ebc,1,3,3,6,3,2012-11-01 20:39:45,2012-11-01 04:30:39
e2cdf527d6a04bdcb98081a9f4f3672ea2e90ebc...395f1da76ba9faeb2f72548c28da228474a2434c,1,3,11,14,6,2012-11-01 20:56:35,2012-11-01 20:53:39
395f1da76ba9faeb2f72548c28da228474a2434c...3f515045808dda2b4320a82894e875eb61d255e2,9,38,37,75,26,2012-11-01 21:32:08,2012-11-01 21:32:08
3f515045808dda2b4320a82894e875eb61d255e2...dc9913a0bfc169e2b2eb075fe0390f2b98e077f3,1,1,2,3,1,2012-11-01 21:57:23,2012-11-01 21:51:34
dc9913a0bfc169e2b2eb075fe0390f2b98e077f3...a8887e937adf52a31102fa970fb4c6e43dba5de9,1,1,1,2,1,2012-11-01 23:47:59,2012-11-01 23:47:59
a8887e937adf52a31102fa970fb4c6e43dba5de9...9c2f0005675c8d913aabd83ed6723aab6ac9e59c,1,0,5,5,1,2012-11-01 23:48:21,2012-11-01 23:48:21
9c2f0005675c8d913aabd83ed6723aab6ac9e59c...240b141a22c4783d619fc67c91f990d1535e7c57,2,11,1,12,4,2012-11-02 00:50:45,2012-11-02 00:50:45
240b141a22c4783d619fc67c91f990d1535e7c57...f651bf8893ceb585245bfc57ba76d3dcb5d0a3b6,2,5,9,14,6,2012-11-02 01:31:55,2012-11-02 00:36:48
f651bf8893ceb585245bfc57ba76d3dcb5d0a3b6...68f001e709b6e6a3ac09d918991480aeef8eb9e5,1,2,1,3,2,2012-11-02 01:40:01,2012-11-02 01:40:01
68f001e709b6e6a3ac09d918991480aeef8eb9e5...53cb49cb0a9696c887b91547ac1259c5b860bece,1,3,3,6,3,2012-11-02 02:22:39,2012-11-02 02:22:39
53cb49cb0a9696c887b91547ac1259c5b860bece...80d45a69ea5e81897ebcb6868a902f3b21d5b101,3,33,105,138,21,2012-11-05 22:21:24,2012-11-05 22:21:24
80d45a69ea5e81897ebcb6868a902f3b21d5b101...81b094b2c180d490c093dafe53a69f59e1f8afe7,6,196,90,286,70,2012-11-05 22:24:03,2012-11-03 04:06:50
81b094b2c180d490c093dafe53a69f59e1f8afe7...0ee94159023bebe1992c5281d0f4778b4f75ff0d,3,56,40,96,14,2012-11-06 14:53:00,2012-11-06 14:53:00
0ee94159023bebe1992c5281d0f4778b4f75ff0d...6b14cef7a85d22d979266a754b2a279ecd636b24,3,3,265,268,4,2012-11-08 01:12:03,2012-11-08 00:42:10
6b14cef7a85d22d979266a754b2a279ecd636b24...781a5c0b78a029b079aae970200d3e4edf543349,2,32,0,32,3,2012-11-08 01:22:14,2012-11-08 01:22:14
781a5c0b78a029b079aae970200d3e4edf543349...c45f6095f2d58a9fefd6bc788e50140acc7cf0c4,2,54,1,55,4,2012-11-08 01:23:24,2012-11-08 01:23:24
c45f6095f2d58a9fefd6bc788e50140acc7cf0c4...74490f862d9b926cd38eba8153ed3cda2a1a7716,1,3,3,6,3,2012-11-08 02:45:03,2012-11-08 02:45:03
74490f862d9b926cd38eba8153ed3cda2a1a7716...31a19a80bf216f8bf67e8be19d61355b310adfac,1,27,18,45,5,2012-11-08 03:11:16,2012-11-08 03:11:16
31a19a80bf216f8bf67e8be19d61355b310adfac...877306738f931a711c41d907e69fc8930f985830,1,3,1,4,1,2012-11-08 03:29:55,2012-11-08 03:29:55
877306738f931a711c41d907e69fc8930f985830...517846aad247aa3677d156aa426f71b8dcacdcf7,4,223,264,487,81,2012-11-08 15:10:43,2012-11-08 15:05:10
517846aad247aa3677d156aa426f71b8dcacdcf7...e78cfb1a3756773aec24e83e358e1e4b40f2a116,2,15,6,21,5,2012-11-10 04:43:46,2012-11-10 04:43:46
e78cfb1a3756773aec24e83e358e1e4b40f2a116...48bd8b509ba068652e9887d04c7529f3cb96c22c,3,55,93,148,14,2012-11-13 02:06:16,2012-11-13 02:06:16
48bd8b509ba068652e9887d04c7529f3cb96c22c...02c726f71caf00a74968896b241ad206b1e1fc41,1,1,1,2,1,2012-11-13 15:30:25,2012-11-12 03:49:17
02c726f71caf00a74968896b241ad206b1e1fc41...05fb5de3ee1ea0610e95d2081aaab8702be651de,1,1,1,2,1,2012-11-15 02:09:12,2012-11-15 02:09:12
861a45b8fffc2073baa9f62b0648f395f0695f3e...c9b75df7fba7c96f38efcd60629830e76ce24863,1,45,10,55,23,2012-12-29 02:05:01,2012-12-29 01:47:33
c9b75df7fba7c96f38efcd60629830e76ce24863...abead1c86b75d376544e52cd916031a67caf2c34,2,8,4,12,2,2012-12-31 17:30:02,2012-12-31 17:30:02
abead1c86b75d376544e52cd916031a67caf2c34...960911e60826163f8e36971213c20bde7f5864ad,1,1,1,2,1,2012-12-31 18:02:23,2012-12-31 18:02:23
960911e60826163f8e36971213c20bde7f5864ad...df7431b7dd4ce662871dc112b0a6e61bfa6da8f9,1,1,1,2,1,2012-12-31 18:10:05,2012-12-31 18:10:05
861a45b8fffc2073baa9f62b0648f395f0695f3e...1c4297816dc274754d399e9e66e0bbf39f4d008a,1,1,108,109,2,2012-12-26 21:06:16,2012-12-26 21:06:16
1c4297816dc274754d399e9e66e0bbf39f4d008a...97fa97f0c1cd6a14a0d7f5e2599b30c502bd3e8c,1,9,43,52,9,2012-12-26 21:47:31,2012-12-26 21:47:31
97fa97f0c1cd6a14a0d7f5e2599b30c502bd3e8c...69bab50296f945de1da3d0e75992a8210bc5427c,1,2,21,23,4,2012-12-26 22:35:55,2012-12-26 22:29:17
69bab50296f945de1da3d0e75992a8210bc5427c...c228874db1f70f79b2a0ed4ea4aa1352420a1e2d,1,4,15,19,4,2012-12-26 22:52:04,2012-12-26 22:52:04
c228874db1f70f79b2a0ed4ea4aa1352420a1e2d...e47dfc63090df1af806520fe829639b897309232,1,4,3,7,5,2012-12-26 23:38:21,2012-12-26 23:38:21
861a45b8fffc2073baa9f62b0648f395f0695f3e...eb5df5e1622bcd5298ce1e3014c49233faa7a632,1,3,44,47,3,2012-12-26 18:34:36,2012-12-17 21:51:59
eb5df5e1622bcd5298ce1e3014c49233faa7a632...25d933909b7ff2e1bdb330667c81e50a5eef5505,1,3,17,20,2,2012-12-26 18:34:36,2012-12-17 21:56:36
25d933909b7ff2e1bdb330667c81e50a5eef5505...bd9498c5ee91303f72bb44f09b4c6c28a33f1225,1,1,33,34,2,2012-12-26 18:34:36,2012-12-17 22:02:23
bd9498c5ee91303f72bb44f09b4c6c28a33f1225...af06c3c771f5935a993a7c741105eac78dd10fa7,1,1,19,20,1,2012-12-26 18:34:37,2012-12-17 22:05:41
af06c3c771f5935a993a7c741105eac78dd10fa7...334d6103818e56bc2ae2e4612a9d4823998da097,1,1,3,4,1,2012-12-26 18:34:37,2012-12-17 22:06:57
334d6103818e56bc2ae2e4612a9d4823998da097...716963937db14e775bf21fd76053a03edc10da49,1,1,3,4,1,2012-12-26 18:34:37,2012-12-17 22:09:30
716963937db14e775bf21fd76053a03edc10da49...338eaf6181f4078553dc2453ffe3bd73ab2478eb,1,5,15,20,6,2012-12-26 18:34:37,2012-12-17 22:30:38
338eaf6181f4078553dc2453ffe3bd73ab2478eb...155dbad029e001f4752a4aedc901cf950ebfe64d,1,7,10,17,3,2012-12-26 18:34:37,2012-12-17 22:41:38
155dbad029e001f4752a4aedc901cf950ebfe64d...f300c5c2f33641d56f467807b1389c928144d4a2,1,3,9,12,2,2012-12-26 18:34:37,2012-12-17 22:49:17
f300c5c2f33641d56f467807b1389c928144d4a2...8000c6cf20f682ef11bc52656efdaeb965c0dffa,1,0,5,5,1,2012-12-26 18:34:37,2012-12-17 22:57:02
8000c6cf20f682ef11bc52656efdaeb965c0dffa...5dbfddc1160dd6efc981994ef6528446f2740e9c,1,1,1,2,1,2012-12-26 18:34:38,2012-12-17 23:06:33
5dbfddc1160dd6efc981994ef6528446f2740e9c...d99f1243b61a75f34439a45a5abbcd2be132cb02,1,1,1,2,1,2012-12-26 18:34:38,2012-12-17 23:08:14
d99f1243b61a75f34439a45a5abbcd2be132cb02...1d0322f0b1c313af146411852838cf1dda036955,1,1,3,4,1,2012-12-26 18:34:38,2012-12-17 23:11:11
1d0322f0b1c313af146411852838cf1dda036955...dcf94a58c7419083cb10ea645c97c8d8c740810b,1,1,1,2,1,2012-12-26 18:34:38,2012-12-21 20:24:42
dcf94a58c7419083cb10ea645c97c8d8c740810b...7e3f96cf3f2d6eb0a9328a4d0b195333077448fc,1,1,1,2,1,2012-12-26 18:34:38,2012-12-24 15:38:02
7e3f96cf3f2d6eb0a9328a4d0b195333077448fc...3746bf8feb30bd875f736d57de6bd94abcbd53f5,1,8,1,9,3,2012-12-26 18:34:38,2012-12-24 15:54:11
861a45b8fffc2073baa9f62b0648f395f0695f3e...fd2af63bcab60693c79d482724db6ca291132e2a,2,15,58,73,17,2012-12-23 23:03:19,2012-12-19 16:26:49
fd2af63bcab60693c79d482724db6ca291132e2a...c1c97b474ea7123fabd3e5f0b2192e967c48eb84,2,2,12,14,5,2012-12-23 23:03:19,2012-12-19 16:27:42
c1c97b474ea7123fabd3e5f0b2192e967c48eb84...7a2a82ba62c42a55302d5b938b31672b34ae390d,2,1,21,22,2,2012-12-23 23:03:19,2012-12-19 16:30:13
7a2a82ba62c42a55302d5b938b31672b34ae390d...eac4e8e2510485c452af3614ddb8042ceec1fc34,1,0,5,5,1,2012-12-23 23:03:19,2012-12-19 16:31:36
eac4e8e2510485c452af3614ddb8042ceec1fc34...28f6fcb763266ecd476274f430cce0ef625f8b16,1,1,2,3,2,2012-12-23 23:03:19,2012-12-19 16:34:08
28f6fcb763266ecd476274f430cce0ef625f8b16...2378438a9773254a49ffe4d42cc195f7b35b1a29,1,7,8,15,5,2012-12-23 23:03:27,2012-12-19 18:33:55
2378438a9773254a49ffe4d42cc195f7b35b1a29...8c4b9f082bee05218f7e218b5a0db12e5e333ef4,1,5,6,11,4,2012-12-23 23:03:28,2012-12-19 18:42:07
8c4b9f082bee05218f7e218b5a0db12e5e333ef4...76bde01be89ab8d985c5af91a023e2db65e85867,1,21,21,42,16,2012-12-23 23:03:28,2012-12-19 18:59:16
76bde01be89ab8d985c5af91a023e2db65e85867...e9ea6679b250429f430ff5ece6dab3cde71bc11d,1,5,6,11,6,2012-12-23 23:03:28,2012-12-19 19:35:25
e9ea6679b250429f430ff5ece6dab3cde71bc11d...329d5e1d0328a5e638d4041e913fe1faccd919f3,1,0,6,6,3,2012-12-23 23:03:28,2012-12-19 19:40:24
329d5e1d0328a5e638d4041e913fe1faccd919f3...7a5000a39eaa3d3126722d4946fb2ed680383b87,1,8,42,50,9,2012-12-23 23:03:28,2012-12-19 20:52:39
7a5000a39eaa3d3126722d4946fb2ed680383b87...61d01c8d3567e2cae27fa89749ea2602bd0509bb,1,11,13,24,5,2012-12-23 23:03:28,2012-12-19 21:08:24
61d01c8d3567e2cae27fa89749ea2602bd0509bb...a10dd521df44032065b95c482f8aee1f5d505375,1,1,15,16,3,2012-12-23 23:03:28,2012-12-19 21:10:20
a10dd521df44032065b95c482f8aee1f5d505375...1043fa897156c077b96de8109c7869bf5b8381ab,1,111,111,222,3,2012-12-23 23:04:08,2012-12-19 21:13:54
1043fa897156c077b96de8109c7869bf5b8381ab...c334878871b2fa71a445054d9442a3fd12b742d7,1,1,1,2,1,2012-12-23 23:04:08,2012-12-19 21:15:21
c334878871b2fa71a445054d9442a3fd12b742d7...d552b94463010b6abeeed5227f67c00c06ff31ff,1,7,25,32,5,2012-12-23 23:04:08,2012-12-19 22:27:45
d552b94463010b6abeeed5227f67c00c06ff31ff...d086aa16b3aa862185684b69dc3e27ee5dbc32fc,1,3,3,6,3,2012-12-23 23:04:08,2012-12-19 22:32:54
d086aa16b3aa862185684b69dc3e27ee5dbc32fc...f07e6758ae42f8f73251be9b434aedfa4c42ec85,1,1,1,2,1,2012-12-23 23:04:08,2012-12-19 22:35:52
f07e6758ae42f8f73251be9b434aedfa4c42ec85...bc70e0c718e3c517e4551dddffd31663b53337b7,1,1,1,2,1,2012-12-23 23:04:18,2012-12-19 22:45:22
bc70e0c718e3c517e4551dddffd31663b53337b7...8958f7cd9db57864a5a4d155cc6c9471756cd34a,1,2,2,4,1,2012-12-23 23:04:18,2012-12-19 23:16:02
8958f7cd9db57864a5a4d155cc6c9471756cd34a...a8b38b0e6b66edab2993e7a517ac37968dc1de92,1,2,2,4,2,2012-12-23 23:04:18,2012-12-19 23:17:05
a8b38b0e6b66edab2993e7a517ac37968dc1de92...32cfbd6d671dc2827562e39c5d3cd7c7565550d1,1,1,0,1,1,2012-12-23 23:04:18,2012-12-19 23:26:55
32cfbd6d671dc2827562e39c5d3cd7c7565550d1...3eb1f64966a869b84e40606932e049063376c3a0,1,1,0,1,1,2012-12-23 23:04:18,2012-12-19 23:40:48
3eb1f64966a869b84e40606932e049063376c3a0...0d16158f699b715d137094aa427378381e827aec,1,12,1,13,4,2012-12-23 23:04:18,2012-12-19 23:56:33
0d16158f699b715d137094aa427378381e827aec...ec75705f88dd4b44ec133d5167b69e88c175bb24,1,1,1,2,1,2012-12-23 23:04:19,2012-12-20 00:06:44
ec75705f88dd4b44ec133d5167b69e88c175bb24...a3ddcc5fcea200ed43188438c4a500005fc7b68f,1,9,0,9,1,2012-12-23 23:04:19,2012-12-20 16:50:00
a3ddcc5fcea200ed43188438c4a500005fc7b68f...3c1b42805df4f932bcd49e5140c5e8b320ee2984,1,4,3,7,4,2012-12-23 23:04:19,2012-12-20 16:51:22
3c1b42805df4f932bcd49e5140c5e8b320ee2984...d41ac85ca3773f1be5dd91d59060fc064ac22673,1,20,20,40,2,2012-12-23 23:04:19,2012-12-20 17:06:06
d41ac85ca3773f1be5dd91d59060fc064ac22673...9e703a2a19c0b248f4efb8cf8343d317c3a557f1,1,14,11,25,13,2012-12-23 23:04:19,2012-12-20 17:11:13
9e703a2a19c0b248f4efb8cf8343d317c3a557f1...2dd2e4886b394a85b86da9fbd433706a8af9b7cd,1,4,4,8,2,2012-12-23 23:04:19,2012-12-23 16:51:07
2dd2e4886b394a85b86da9fbd433706a8af9b7cd...9256ba5380fca27ebc70e4d1e798fa45cb30e3a2,1,2,2,4,1,2012-12-23 23:04:30,2012-12-23 16:52:46
9256ba5380fca27ebc70e4d1e798fa45cb30e3a2...87a7690afa8c56d2aee2f902b49e3932bb3a2449,1,11,8,19,7,2012-12-23 23:04:30,2012-12-23 17:10:59
87a7690afa8c56d2aee2f902b49e3932bb3a2449...f66c33d751879d139465417291f8da2ff266631a,1,1,4,5,1,2012-12-23 23:04:30,2012-12-23 17:11:40
f66c33d751879d139465417291f8da2ff266631a...5f8e99b36826e494e307afdec5d54b3366eb93fe,1,33,16,49,16,2012-12-23 23:04:37,2012-12-23 21:54:53
5f8e99b36826e494e307afdec5d54b3366eb93fe...5e64281a11301bb95f657e828c5010a9b24d9bff,1,17,16,33,11,2012-12-23 23:04:38,2012-12-23 22:51:09
5e64281a11301bb95f657e828c5010a9b24d9bff...33be48acfdc2059368c3c8d171a1ddb94a3c9be9,1,1,14,15,2,2012-12-24 00:16:17,2012-12-24 00:16:17
33be48acfdc2059368c3c8d171a1ddb94a3c9be9...fa3dad300fb6dc1882eef178cc22a1d7f3974ec1,1,1,8,9,1,2012-12-24 00:28:52,2012-12-24 00:28:52
fa3dad300fb6dc1882eef178cc22a1d7f3974ec1...25712d77c3bc0221b5b2b9b9492c20a9cfbe1b17,1,3,13,16,1,2012-12-24 00:29:41,2012-12-24 00:29:41
25712d77c3bc0221b5b2b9b9492c20a9cfbe1b17...f7528916a29f5d8cd3d19285a67cd84ea9dcfe91,1,1,1,2,1,2012-12-24 00:47:13,2012-12-24 00:47:13
f7528916a29f5d8cd3d19285a67cd84ea9dcfe91...f193acf3a1f6838f8f6b90d4038e3cd9bb89f1ba,2,7,3,10,4,2012-12-28 14:54:47,2012-12-28 14:39:12
f193acf3a1f6838f8f6b90d4038e3cd9bb89f1ba...d3d8ed443cedf9bba3af4fd71744cceb0ace0c93,2,8,1,9,4,2012-12-28 14:56:29,2012-12-28 14:56:29
d3d8ed443cedf9bba3af4fd71744cceb0ace0c93...378ab82865f92a5aec4324d22c7345eff0a737a0,1,0,1,1,1,2012-12-28 15:09:50,2012-12-28 15:09:50
378ab82865f92a5aec4324d22c7345eff0a737a0...6215840995ae77f8d309ccaf58c6966b23925602,1,0,1,1,1,2012-12-28 15:16:22,2012-12-28 15:16:22
6215840995ae77f8d309ccaf58c6966b23925602...b3e546c4eb0e14c5fefefa1e0c14026ba63f0017,1,8,7,15,4,2012-12-28 15:43:01,2012-12-28 15:43:01
b3e546c4eb0e14c5fefefa1e0c14026ba63f0017...9dbfbe5b9ae2232d84d19ce27b0a9d31994fe165,2,4,5,9,4,2012-12-28 15:50:22,2012-12-28 15:50:22
9dbfbe5b9ae2232d84d19ce27b0a9d31994fe165...ecd106280abe7ac7e09a532d42d3441d4b910d56,1,1,2,3,2,2012-12-28 15:59:55,2012-12-28 15:59:55
ecd106280abe7ac7e09a532d42d3441d4b910d56...acb206a4886f53c3eb9628e17d699dbb1b96ef25,1,2,2,4,2,2012-12-28 16:06:04,2012-12-28 16:06:04
acb206a4886f53c3eb9628e17d699dbb1b96ef25...4862eb43e3c1b9d428bd64db50c08c6a6d6e01fd,1,2,1,3,2,2012-12-28 16:16:28,2012-12-28 16:16:28
4862eb43e3c1b9d428bd64db50c08c6a6d6e01fd...1490afe693949bd6b030f9a3b65010d9d9d3f80c,1,1,0,1,1,2012-12-28 16:16:49,2012-12-28 16:16:49
1490afe693949bd6b030f9a3b65010d9d9d3f80c...72e9e91612347eab1c28596a34c0b53d2c36b150,1,2,2,4,2,2012-12-28 16:27:59,2012-12-28 16:27:59
72e9e91612347eab1c28596a34c0b53d2c36b150...39e6792b5ce70789ef1445336ac76104220d5e09,1,4,4,8,5,2012-12-28 19:41:31,2012-12-28 19:38:30
05fb5de3ee1ea0610e95d2081aaab8702be651de...28df086bbc887c8d115bed2c7d0f83b1d39fb14d,1,1,1,2,1,2012-11-16 17:16:47,2012-11-16 17:16:47
28df086bbc887c8d115bed2c7d0f83b1d39fb14d...d08d48337f21d0f21467f4165efec8db0a7c7d3d,2,14,11,25,7,2012-11-16 20:57:43,2012-11-16 20:57:43
df7431b7dd4ce662871dc112b0a6e61bfa6da8f9...049cc9d1eba974905f868accb1f54299bb69bb7a,2,0,8,8,2,2012-12-31 18:20:24,2012-12-17 23:13:06
049cc9d1eba974905f868accb1f54299bb69bb7a...0b91e836a30aa03a18e5dfb735eca56cc45c16fb,2,0,24,24,2,2012-12-31 18:20:24,2012-12-17 23:15:51
0b91e836a30aa03a18e5dfb735eca56cc45c16fb...ccf7abafa6843e70fb71f458cea5d5567cb5984d,1,0,321,321,1,2012-12-31 18:20:25,2012-12-17 23:16:04
ccf7abafa6843e70fb71f458cea5d5567cb5984d...d96fa37666ddd9b24a077bfccb6a9a532daea23c,3,4,9,13,5,2012-12-31 18:21:47,2012-12-17 23:17:45
d96fa37666ddd9b24a077bfccb6a9a532daea23c...d50c18e61f1e498b21e64fd64f847463959061a1,2,1,45,46,3,2012-12-31 18:23:26,2012-12-31 18:23:26
d50c18e61f1e498b21e64fd64f847463959061a1...3f66e928c816de49e4c79a3375524c2d0c4e56ce,2,6,126,132,10,2012-12-31 18:23:32,2012-12-17 23:45:13
6d1080114da5385ab41c269943c77b592504b0ca...747dd8c0429cd94290ad71525bd7916b5192c5bd,1,12,31,43,13,2012-12-31 18:31:03,2012-12-31 18:31:03
747dd8c0429cd94290ad71525bd7916b5192c5bd...f75c0627f22b4af52199b46659675258811970f5,2,18,0,18,2,2012-12-31 19:32:58,2012-12-31 19:32:58
f75c0627f22b4af52199b46659675258811970f5...e1dcf96b526a7fd9b323cdf7b4f68be1e72f0d6c,1,1,0,1,1,2012-12-31 20:17:24,2012-12-31 20:17:24
e1dcf96b526a7fd9b323cdf7b4f68be1e72f0d6c...d1de3000c6d50c298de14fb1ae3381d75c303723,3,286,279,565,69,2012-12-31 21:23:20,2012-12-31 20:09:45
d1de3000c6d50c298de14fb1ae3381d75c303723...b9cdc4136b688963d1dc4befb169be02a0216ba9,3,43,38,81,19,2012-12-31 21:23:20,2012-12-31 21:20:35
b9cdc4136b688963d1dc4befb169be02a0216ba9...f717226b3a44f918eec30b2d59ab257270189bc3,1,5,2,7,1,2012-12-31 23:06:38,2012-12-31 23:06:38
f717226b3a44f918eec30b2d59ab257270189bc3...b0e40a4fd3253eb5472f127533a38aa69709d23e,1,12,11,23,9,2013-01-02 19:15:33,2013-01-02 19:15:33
b0e40a4fd3253eb5472f127533a38aa69709d23e...0d540c3750bd5d702ec5cc425fd4eebd1089fa52,2,2,2,4,2,2013-01-03 22:41:18,2013-01-03 22:41:18
0d540c3750bd5d702ec5cc425fd4eebd1089fa52...445dbd9d95e2df2f3cb454cb20ba3ae7a84e7eaf,5,309,324,633,85,2013-01-04 01:43:01,2013-01-04 01:39:15
445dbd9d95e2df2f3cb454cb20ba3ae7a84e7eaf...3d9edb32bc4abfb33a4029edab80099e1bfdaedc,2,1,64,65,5,2013-01-04 01:52:31,2013-01-02 22:47:30
3d9edb32bc4abfb33a4029edab80099e1bfdaedc...02d7f9aee3fbe9b568702ecc4edd664245dc8917,2,3,23,26,4,2013-01-04 01:52:35,2013-01-03 00:49:59
02d7f9aee3fbe9b568702ecc4edd664245dc8917...aa529696fb91eaa167ed4dad9c63957b3466a45c,3,38,99,137,14,2013-01-04 01:52:38,2013-01-03 01:45:45
aa529696fb91eaa167ed4dad9c63957b3466a45c...11e6a6600255932fa790720899e9e6ffc3a8d5f3,2,0,42,42,3,2013-01-04 01:55:52,2013-01-03 01:53:33
11e6a6600255932fa790720899e9e6ffc3a8d5f3...4ee1b03c54ff8c8f5cfd983aeaa13bbba212ffe3,1,4,7,11,3,2013-01-04 01:55:56,2013-01-03 02:10:54
4ee1b03c54ff8c8f5cfd983aeaa13bbba212ffe3...cef3450228f53a1facfbed2be77050e61ee6a178,2,0,54,54,3,2013-01-04 01:55:59,2013-01-03 02:25:49
cef3450228f53a1facfbed2be77050e61ee6a178...9a32f12bdfcc9b7d27cd5907d838c638e5c735f7,2,1,5,6,2,2013-01-04 01:56:02,2013-01-03 02:32:43
9a32f12bdfcc9b7d27cd5907d838c638e5c735f7...1e5b14a131fca29b97830168a1d743d007d1d761,1,4,11,15,6,2013-01-04 01:57:00,2013-01-03 02:55:56
1e5b14a131fca29b97830168a1d743d007d1d761...8ac7fa71b5df5ff00f0212976abd8b0c80d3956f,1,1,1,2,1,2013-01-04 02:27:22,2012-12-30 01:53:18
8ac7fa71b5df5ff00f0212976abd8b0c80d3956f...e9ab6a74d42df94cb967d5e275b61ce91b33af28,1,3,1,4,1,2013-01-04 22:35:01,2013-01-04 22:21:43
e9ab6a74d42df94cb967d5e275b61ce91b33af28...c0241a47e270cd0e0ac2b2a0fdefc5a3a15b5ae6,1,3,1,4,1,2013-01-05 03:29:27,2013-01-05 03:29:27
c0241a47e270cd0e0ac2b2a0fdefc5a3a15b5ae6...b760d798d35d4c945c9c5240bb8cb4719330ad1f,1,14,5,19,4,2013-01-06 14:55:51,2013-01-05 18:11:01
b760d798d35d4c945c9c5240bb8cb4719330ad1f...d2a51f0e44ba50d9949e307e391801b22ccab638,1,0,1,1,1,2013-01-06 15:03:59,2013-01-06 15:03:59
d2a51f0e44ba50d9949e307e391801b22ccab638...c61150427fc8ccc8e884df8f221a6c9bb5477929,1,6,0,6,1,2013-01-06 15:25:02,2013-01-06 15:24:56
c61150427fc8ccc8e884df8f221a6c9bb5477929...17049c73bc5bf1a41cce4a5b648f55da7bbac533,2,104,228,332,9,2013-01-07 15:34:07,2013-01-02 21:55:41
17049c73bc5bf1a41cce4a5b648f55da7bbac533...f6df0301c81fca4b52eb2667f33a1469f2cac41d,1,10,6,16,5,2013-01-07 15:34:11,2013-01-05 23:41:08
f6df0301c81fca4b52eb2667f33a1469f2cac41d...62acda819f9b6fba9263d0b613e15285807b23a7,3,49,4,53,6,2013-01-07 15:34:14,2013-01-06 00:34:24
62acda819f9b6fba9263d0b613e15285807b23a7...b6abb31df4d5be80dc13844d9988fb0c990ae5ae,3,105,4,109,8,2013-01-08 01:19:25,2013-01-08 01:16:50
b6abb31df4d5be80dc13844d9988fb0c990ae5ae...9434060722b7b935f61f8fb6c97a2a424255dc5d,1,13,10,23,8,2013-01-08 01:35:55,2013-01-07 11:48:44
9434060722b7b935f61f8fb6c97a2a424255dc5d...054daa20afc0e2c84e66f450b155d0253a62aedb,3,12,10,22,7,2013-01-08 02:08:47,2013-01-08 02:08:47
054daa20afc0e2c84e66f450b155d0253a62aedb...c9bf5c5e905ec8c4d29c61f8ddf04d8a40d8e04e,4,55,75,130,26,2013-01-08 02:41:15,2013-01-07 14:38:21
c9bf5c5e905ec8c4d29c61f8ddf04d8a40d8e04e...6d2ae92fe4e8bbbfd90d26ad5c5d51960f91f7b4,1,2,1,3,1,2013-01-08 02:41:18,2013-01-07 19:21:42
6d2ae92fe4e8bbbfd90d26ad5c5d51960f91f7b4...58b4994f5634b839cb6cafa1457da7eb5c5a9c7c,1,2,2,4,2,2013-01-08 02:41:21,2013-01-07 20:16:36
58b4994f5634b839cb6cafa1457da7eb5c5a9c7c...57d9dcd4a0c3a56160144b7f468fff6e419fed84,1,7,12,19,7,2013-01-08 02:41:25,2013-01-07 21:59:01
57d9dcd4a0c3a56160144b7f468fff6e419fed84...ed6209e8b219fd8e797a42effee4ccecf063bb21,1,10,41,51,15,2013-01-08 09:10:18,2013-01-08 09:10:18
ed6209e8b219fd8e797a42effee4ccecf063bb21...ce426c5d693ab8f15bfaf70fc4bec8f7e881d0b1,1,72,1,73,2,2013-01-08 09:33:27,2013-01-08 09:33:01
ce426c5d693ab8f15bfaf70fc4bec8f7e881d0b1...d4e666d475923477c693643a40168cc0e6889d8f,1,34,52,86,3,2013-01-08 10:07:18,2013-01-08 10:06:20
d4e666d475923477c693643a40168cc0e6889d8f...7cc629d0979fdc3b0a65d4501a3d71303708dee2,1,1,1,2,1,2013-01-08 10:15:36,2013-01-08 10:15:36
7cc629d0979fdc3b0a65d4501a3d71303708dee2...18c376a5bd658608fb044f2289ba9440d185ba3f,1,13,9,22,2,2013-01-08 13:04:00,2013-01-08 13:04:00
c61150427fc8ccc8e884df8f221a6c9bb5477929...e7fdda981928befda72b78e9e2b17e33e232a603,2,21,3,24,5,2013-01-06 17:49:15,2013-01-06 08:09:28
e7fdda981928befda72b78e9e2b17e33e232a603...412d910697f7c33a29066009930e1373fd80b27a,1,11,16,27,3,2013-01-07 16:03:38,2013-01-07 16:02:40
2f6b3f818fc51ee6ae44be69dc6b15b3d7a2dad4...8e6c1ba92faf830d40cafe7a4deb4ad5ab9045fe,2,10,5,15,9,2013-01-09 14:52:01,2013-01-09 09:23:34
8e6c1ba92faf830d40cafe7a4deb4ad5ab9045fe...ca49ef98d51e8a79ee70d5339a662dead5711165,1,2,2,4,2,2013-01-09 15:11:33,2013-01-09 15:10:08
ca49ef98d51e8a79ee70d5339a662dead5711165...2ff2d1d3dcd99f7bd45fa312ba91bb1248cb6d55,1,4,1,5,2,2013-01-10 15:50:25,2013-01-10 15:35:50
2ff2d1d3dcd99f7bd45fa312ba91bb1248cb6d55...c1a59f78c26eed95f4ad5d69d00578e63754713d,1,1,1,2,1,2013-01-10 20:54:32,2013-01-10 20:54:32
c1a59f78c26eed95f4ad5d69d00578e63754713d...5aba2102b2f62d8a92f262fe6611f9df45088b3a,1,3,3,6,2,2013-01-11 04:47:48,2013-01-11 04:47:48
5aba2102b2f62d8a92f262fe6611f9df45088b3a...bad229c53e50ae9e34ae3bd8ddf1737c538416f6,1,1,1,2,1,2013-01-11 18:01:56,2013-01-11 18:01:56
bad229c53e50ae9e34ae3bd8ddf1737c538416f6...c0c1bdde6099a3fa1c16014be090aa6bf1fca8ca,2,2,2,4,2,2013-01-11 21:08:09,2013-01-11 21:08:09
c0c1bdde6099a3fa1c16014be090aa6bf1fca8ca...fa71737fb424a43b9f705098c5be06b1c40f29b6,1,1,1,2,1,2013-01-11 21:59:24,2013-01-11 21:59:24
fa71737fb424a43b9f705098c5be06b1c40f29b6...776723436460c928b0eaf88fe36b575f36049a17,2,116,111,227,63,2013-01-14 00:41:31,2013-01-12 22:11:07
776723436460c928b0eaf88fe36b575f36049a17...b75b9ef8d030b0dbf247e826bfbf9585c7dbf98b,2,66,45,111,12,2013-01-14 01:00:03,2013-01-14 00:53:19
b75b9ef8d030b0dbf247e826bfbf9585c7dbf98b...de486684e3df1988080fd41c97d5f6ab8e6171ed,1,4,3,7,3,2013-01-14 01:37:53,2013-01-14 01:37:14
de486684e3df1988080fd41c97d5f6ab8e6171ed...31b95797155077e4e670c0bbb2c57815f89769a1,2,17,1,18,2,2013-01-14 02:40:24,2013-01-14 02:38:40
31b95797155077e4e670c0bbb2c57815f89769a1...38ad408f824492cd36a04d7c16df9df6c357ddb4,1,5,5,10,3,2013-01-14 03:05:37,2013-01-13 17:59:22
38ad408f824492cd36a04d7c16df9df6c357ddb4...eff59f97ac63dd723b6932e7c6e2186735315401,1,2,0,2,1,2013-01-14 03:05:41,2013-01-13 19:47:29
eff59f97ac63dd723b6932e7c6e2186735315401...348e1a75c87d13a0c87c6cc58b82bf9746e7eb9c,1,4,4,8,3,2013-01-14 04:00:14,2013-01-14 03:59:20
348e1a75c87d13a0c87c6cc58b82bf9746e7eb9c...e7a2e3c72f0c9833214b17ca81f76e0a9da62495,2,22,44,66,9,2013-01-15 03:10:39,2013-01-15 02:58:09
e7a2e3c72f0c9833214b17ca81f76e0a9da62495...a8cbbd3615d714bdb20fc5c817c0519bb226694c,1,8,7,15,1,2013-01-15 04:11:33,2013-01-15 04:11:33
a8cbbd3615d714bdb20fc5c817c0519bb226694c...2cc06af007ad2f85b52ee757296d235fcf93337a,1,2,2,4,2,2013-01-15 04:19:18,2013-01-15 04:19:18
2cc06af007ad2f85b52ee757296d235fcf93337a...86278d40ae86ecd45786eebcb20b72564f2bb53f,1,1,1,2,1,2013-01-15 04:19:45,2013-01-15 04:19:45
86278d40ae86ecd45786eebcb20b72564f2bb53f...10cc33e27beb56e41bea1274bc3b51b1c59af9af,3,27,10,37,5,2013-01-16 04:34:22,2013-01-16 04:09:35
10cc33e27beb56e41bea1274bc3b51b1c59af9af...2f0756b5341eb94ae540de20b9756762dc0a4144,1,1,1,2,1,2013-01-16 05:18:04,2013-01-16 05:18:04
2f0756b5341eb94ae540de20b9756762dc0a4144...306b698813c7d999b6f572d8d00b2691952fdea6,1,35,55,90,28,2013-01-16 17:31:23,2013-01-16 17:30:47
306b698813c7d999b6f572d8d00b2691952fdea6...a96aa9e2709b4ba132b966a0f1a13d0e8eb49b9a,2,7,9,16,4,2013-01-16 18:57:00,2013-01-16 17:55:56
a96aa9e2709b4ba132b966a0f1a13d0e8eb49b9a...cc324abf739669bd2a4669742c994b86c4ad467b,2,17,1,18,4,2013-01-16 19:31:29,2013-01-11 15:04:50
cc324abf739669bd2a4669742c994b86c4ad467b...50290b8ffb05c504d3866a619f282bf795bc01f6,1,2,2,4,2,2013-01-16 19:36:24,2013-01-16 19:36:24
50290b8ffb05c504d3866a619f282bf795bc01f6...8871218cdf37fa0a3e0457882828648e6a40164a,2,2,2,4,2,2013-01-17 22:01:42,2013-01-17 22:00:29
8871218cdf37fa0a3e0457882828648e6a40164a...7632711d5cdc184b9d05850c5ca577799d8df399,1,1,1,2,1,2013-01-18 15:48:39,2013-01-18 15:48:39
7632711d5cdc184b9d05850c5ca577799d8df399...4488f68adfe7d593f538aa1791ba35c6ace87a7e,1,3,3,6,3,2013-01-20 22:50:18,2013-01-14 05:45:13
4488f68adfe7d593f538aa1791ba35c6ace87a7e...359e3f57466e508ccfc3e30acfc2aee0c52df83c,1,6,8,14,4,2013-01-20 22:57:19,2013-01-14 02:59:37
359e3f57466e508ccfc3e30acfc2aee0c52df83c...c373a499d39e35172f9b93af993681e4b5f0908b,1,21,47,68,9,2013-01-20 23:08:59,2013-01-09 01:01:13
c373a499d39e35172f9b93af993681e4b5f0908b...1ad874f3447cdba89d77cfe00b10d6f1d7dcea4e,1,16,19,35,4,2013-01-20 23:10:07,2013-01-09 10:04:03
1ad874f3447cdba89d77cfe00b10d6f1d7dcea4e...dbf4926e31390ceda57730c68d40f34536803114,1,6,5,11,5,2013-01-20 23:20:53,2013-01-15 14:45:21
dbf4926e31390ceda57730c68d40f34536803114...19def21df41d6be6419e4d2480a656d9e1a0e6b7,2,34,3,37,3,2013-01-20 23:30:56,2013-01-16 18:07:53
19def21df41d6be6419e4d2480a656d9e1a0e6b7...cbe0c2ef90669c4c145227a2ddf41993583f5437,1,30,32,62,22,2013-01-20 23:36:43,2013-01-15 21:54:40
cbe0c2ef90669c4c145227a2ddf41993583f5437...4c6fb65d358f6a9795f06ec8d5ed3acad6ad795d,1,16,0,16,1,2013-01-21 01:53:50,2013-01-21 01:53:50
4c6fb65d358f6a9795f06ec8d5ed3acad6ad795d...1c77259d06e49ccaedbd0f7adf968e10748dacc0,1,1,1,2,1,2013-01-21 02:05:03,2013-01-21 02:05:03
1c77259d06e49ccaedbd0f7adf968e10748dacc0...372e04e78e81cc8eb868c5fc97f271a695569aa5,2,44,41,85,7,2013-01-21 22:12:31,2013-01-21 21:14:56
372e04e78e81cc8eb868c5fc97f271a695569aa5...b326225d9087ee8c5648ace3cf88feab0330353d,4,9,26,35,5,2013-01-21 23:03:07,2013-01-21 23:03:07
b326225d9087ee8c5648ace3cf88feab0330353d...caac041fcc31724b8b579939e8053966559483ca,2,4,3,7,2,2013-01-23 17:23:46,2013-01-23 17:23:46
caac041fcc31724b8b579939e8053966559483ca...bfc61b879e9e94ef7c6b31919b7f287ffdf180a8,3,33,3,36,4,2013-01-24 01:34:02,2013-01-24 01:33:17
bfc61b879e9e94ef7c6b31919b7f287ffdf180a8...f39ca223e0f373222976a79204d0d8ea7718253e,1,1,1,2,1,2013-01-25 04:11:47,2013-01-25 04:11:47
f39ca223e0f373222976a79204d0d8ea7718253e...fb0f2952929fbe0e8a39da8c7865a397c7e74835,1,12,4,16,4,2013-01-25 04:45:44,2013-01-25 04:45:44
fb0f2952929fbe0e8a39da8c7865a397c7e74835...487b703521e63188102c73e8ce6ce203d28f260b,3,42,2,44,4,2013-01-25 15:09:27,2013-01-23 22:42:28
487b703521e63188102c73e8ce6ce203d28f260b...58cd84f9d55ba8ce4311265990bd94cea73c4725,24,29,29,58,26,2013-01-26 15:48:10,2013-01-26 15:48:10
58cd84f9d55ba8ce4311265990bd94cea73c4725...47a6f52dc95b0f3a3a32d72752405fdfada0a74c,2,50,48,98,9,2013-01-26 20:05:42,2013-01-26 18:38:04
47a6f52dc95b0f3a3a32d72752405fdfada0a74c...c4b1da40075532e4f14821b1519ae0ef6665bf1e,1,1,1,2,1,2013-01-27 01:31:37,2013-01-27 01:31:37
c4b1da40075532e4f14821b1519ae0ef6665bf1e...b594673a4294a75c10db279239edfa60b6bb804e,1,8,11,19,3,2013-01-27 01:56:11,2013-01-27 01:55:21
b594673a4294a75c10db279239edfa60b6bb804e...a6c358d04693c5746e1557a2660dfccb169ad831,2,5,3,8,4,2013-01-27 03:02:15,2013-01-27 03:02:15
a6c358d04693c5746e1557a2660dfccb169ad831...6f7b6915bf457c413476faefb2159df717c2c210,7,173,162,335,97,2013-01-27 14:07:00,2013-01-27 04:48:59
6f7b6915bf457c413476faefb2159df717c2c210...64b55f0b7912d96c3bdae8c771b4da99c96954fd,5,9,6,15,7,2013-01-27 15:04:09,2013-01-24 04:25:29
64b55f0b7912d96c3bdae8c771b4da99c96954fd...54fc5fdfa2e07fb08f2652f4b48d51ffc2999938,2,50,2,52,3,2013-01-27 18:35:30,2013-01-03 22:05:00
54fc5fdfa2e07fb08f2652f4b48d51ffc2999938...0868699ce5d380e094fa869c34626eab3ef9b3ed,1,3,0,3,1,2013-01-27 18:53:47,2013-01-27 18:53:47
0868699ce5d380e094fa869c34626eab3ef9b3ed...aa3c92979a723cd972bf37c766c3b4a63cc23fdb,1,2,1,3,1,2013-01-29 19:40:30,2013-01-29 18:03:45
aa3c92979a723cd972bf37c766c3b4a63cc23fdb...451d0c37d9297598743b1372bf623d4b7d38e951,1,1,1,2,1,2013-01-29 21:56:32,2013-01-29 21:56:32
451d0c37d9297598743b1372bf623d4b7d38e951...a5c33fe1f7872a20267ff69905561c8cc55fe3c1,1,1,1,2,1,2013-01-30 01:48:48,2013-01-30 01:48:48
a5c33fe1f7872a20267ff69905561c8cc55fe3c1...f5110cdec0b0e7ee353fd55187e87a2648fe0eba,1,12,12,24,6,2013-01-31 01:36:58,2013-01-26 01:44:55
f5110cdec0b0e7ee353fd55187e87a2648fe0eba...f3ce0e696d41130e27ad06ae33a63057a2cace28,2,2,2,4,2,2013-01-31 01:37:13,2013-01-31 01:05:39
f3ce0e696d41130e27ad06ae33a63057a2cace28...d3a2ef7cfec6d798dce8fefa96098bc38b9c5a1d,1,6,6,12,2,2013-01-31 01:48:09,2013-01-31 01:48:09
d3a2ef7cfec6d798dce8fefa96098bc38b9c5a1d...d654914fd02412f8d2537279bb8a4db9ecc7095e,2,16,2,18,2,2013-01-31 18:04:32,2013-01-31 18:01:34
d654914fd02412f8d2537279bb8a4db9ecc7095e...115143b198772ca7b35613f06fdcca2aa3aaa039,1,1,0,1,1,2013-01-31 18:14:08,2013-01-31 18:13:50
115143b198772ca7b35613f06fdcca2aa3aaa039...0e2977583c0455eda940a28b2499cad2cbf24ee4,2,6,2,8,2,2013-02-01 22:17:39,2013-02-01 22:17:39
0e2977583c0455eda940a28b2499cad2cbf24ee4...21c7a056e23cd30716db75a62fc7ad7dd23a334b,1,1,1,2,1,2013-02-01 23:06:02,2013-02-01 23:06:02
21c7a056e23cd30716db75a62fc7ad7dd23a334b...d12b26ced63e1593b1ffd84c6d95113126bf1d66,1,1,1,2,1,2013-02-03 17:26:56,2013-02-03 17:26:56
d12b26ced63e1593b1ffd84c6d95113126bf1d66...ed0e2d1e8a5005a80d0dd127dc4019f696471ad6,1,21,0,21,1,2013-02-03 17:52:08,2013-02-03 17:51:54
ed0e2d1e8a5005a80d0dd127dc4019f696471ad6...7f94a5cc3a167a710576c008da2c186a98ce2dd4,7,354,358,712,84,2013-02-03 20:27:55,2013-02-03 20:27:55
7f94a5cc3a167a710576c008da2c186a98ce2dd4...64630eaf850797f45b523b3eadc9a158e78eb5a8,1,1,2,3,1,2013-02-03 20:31:23,2013-02-03 20:31:23
64630eaf850797f45b523b3eadc9a158e78eb5a8...fd43865c6d11a8901b2780a57418f652143f250a,1,1,4,5,1,2013-02-03 22:55:28,2013-02-03 22:55:28
fd43865c6d11a8901b2780a57418f652143f250a...7b50c4a711ed217767af0956043b901fa89d4671,1,1,1,2,1,2013-02-03 22:58:07,2013-02-03 22:58:07
7b50c4a711ed217767af0956043b901fa89d4671...f50680898b7560d7e53872a221614ce9c576a7d8,1,1,1,2,1,2013-02-03 23:04:53,2013-02-03 23:04:53
f50680898b7560d7e53872a221614ce9c576a7d8...cf260fe2858fcc6012a0a9cfa4b794d81c6fb9ad,1,3,2,5,2,2013-02-03 23:09:49,2013-02-03 23:09:49
cf260fe2858fcc6012a0a9cfa4b794d81c6fb9ad...a5b456edff358092fdcf4ac6460ade3bec183352,1,1,1,2,1,2013-02-04 14:35:33,2013-02-04 14:35:29
a5b456edff358092fdcf4ac6460ade3bec183352...a30785a4dde7430d11eeb94980831ffcca39e2f8,1,1,1,2,1,2013-02-04 15:13:09,2013-02-04 15:12:14
a30785a4dde7430d11eeb94980831ffcca39e2f8...f3db084f7cc73379b0d6f5341c987e2a801ea032,4,39,4,43,8,2013-02-04 20:22:07,2013-02-01 13:22:08
f3db084f7cc73379b0d6f5341c987e2a801ea032...363299ac24aebbf2445207621840f44fcaaf670a,34,58,168,226,42,2013-02-07 20:16:28,2013-01-28 04:34:38
363299ac24aebbf2445207621840f44fcaaf670a...6971d9d8e2b88d008884e0758c94c528dc97238c,3,10,5,15,4,2013-02-07 22:03:04,2013-02-07 22:03:04
6971d9d8e2b88d008884e0758c94c528dc97238c...dc9b009c1325e05344fa2216fac71fac3a0a0590,1,10,4,14,1,2013-02-08 04:43:21,2013-02-08 04:43:21
dc9b009c1325e05344fa2216fac71fac3a0a0590...6a0ee2d9ed34b81d4ad0662423bf815a3110990f,2,20,9,29,2,2013-02-08 14:49:14,2013-02-07 21:43:25
6a0ee2d9ed34b81d4ad0662423bf815a3110990f...1d5d959ee0c03ceb938b85576d130b7b3c510845,2,99,64,163,24,2013-02-11 17:39:44,2013-02-11 17:39:44
1d5d959ee0c03ceb938b85576d130b7b3c510845...b734666f4d2e9a92b8ebb99db5b05bd4c82e71f2,3,68,37,105,41,2013-02-14 03:03:37,2013-01-27 18:24:50
b734666f4d2e9a92b8ebb99db5b05bd4c82e71f2...93043d002a5ec8646cbd9d5658434848a1d07a49,2,51,24,75,9,2013-02-13 17:14:20,2013-02-13 17:14:20
93043d002a5ec8646cbd9d5658434848a1d07a49...0f977e6d03724551ddff51e9ae2b6b9ac61cf649,1,1,1,2,1,2013-02-18 04:12:44,2013-02-18 04:12:44
0f977e6d03724551ddff51e9ae2b6b9ac61cf649...a128355b25dc31a1312e4e190b9e3caec5f0b95b,2,25,17,42,3,2013-02-21 02:31:06,2013-02-21 02:30:42
a128355b25dc31a1312e4e190b9e3caec5f0b95b...a464d75005ea48c5ff6cc9c8f845f8e68cbca179,1,2,1,3,2,2013-02-21 14:56:20,2013-02-21 14:56:20
a464d75005ea48c5ff6cc9c8f845f8e68cbca179...710962c8c076c5d87432cca44deb8c74b4a3e993,1,1,1,2,1,2013-02-21 16:59:13,2013-02-21 16:59:13
710962c8c076c5d87432cca44deb8c74b4a3e993...85ee87b4444e1322f3a5b1a033902b3f9764b1ef,2,2,2,4,2,2013-02-21 17:00:51,2013-02-21 17:00:51
85ee87b4444e1322f3a5b1a033902b3f9764b1ef...9338a69e307c0051ef50d6365c5f45872a9d7ef7,2,4,3,7,4,2013-02-22 21:36:39,2013-02-22 21:33:52
9338a69e307c0051ef50d6365c5f45872a9d7ef7...59f5adb622dd6bc3419bbaa9cc2d4acd7a0b08b9,11,208,161,369,104,2013-02-23 01:13:36,2013-02-19 04:52:29
59f5adb622dd6bc3419bbaa9cc2d4acd7a0b08b9...7d36c0fb6e0e97a2f1af31657104d6cbd5d90b64,1,1,1,2,1,2013-02-23 02:30:10,2013-02-23 02:29:38
7d36c0fb6e0e97a2f1af31657104d6cbd5d90b64...2129c233e99a11845bea115b1cf18e19efc66e58,1,1,1,2,1,2013-02-24 02:16:28,2013-02-24 02:16:28
2129c233e99a11845bea115b1cf18e19efc66e58...6256c614fd36596debbf52ddcc2c9660705b3d8f,1,1,1,2,1,2013-02-25 04:24:28,2013-02-25 04:24:28
6256c614fd36596debbf52ddcc2c9660705b3d8f...972de58990ed1c136de700654700ca1efa3de1b1,1,17,19,36,10,2013-02-25 20:33:13,2013-02-25 20:33:13
972de58990ed1c136de700654700ca1efa3de1b1...6d188186d428668b91ddc60be4fb3c230dfec363,2,3,4,7,2,2013-02-25 20:48:22,2013-02-25 20:48:22
6d188186d428668b91ddc60be4fb3c230dfec363...31478b90128a60585c087bee57d31148677a99cd,1,1,1,2,1,2013-02-26 15:17:54,2013-02-20 23:01:06
31478b90128a60585c087bee57d31148677a99cd...2bbc3d5860b81e128cd92f865673e10046caac7d,2,21,0,21,2,2013-02-26 17:19:09,2013-02-26 17:19:04
2bbc3d5860b81e128cd92f865673e10046caac7d...b55bfb140f4ccf871a38ec52f21f7ca698515e52,1,2,1,3,1,2013-02-26 18:06:58,2013-02-26 18:06:58
b55bfb140f4ccf871a38ec52f21f7ca698515e52...85f1985f2444da01054800d6f41c3a6057da2e16,1,28,36,64,10,2013-02-27 03:38:06,2013-02-23 17:41:37
85f1985f2444da01054800d6f41c3a6057da2e16...8bc7bdebefb23ef31247dda50012ee19ce9f58af,7,8,7,15,8,2013-02-27 03:57:12,2013-02-27 03:55:36
8bc7bdebefb23ef31247dda50012ee19ce9f58af...1b6be73721270225fea8a182f4a57ae44f5e6405,1,35,47,82,11,2013-02-27 04:41:57,2013-02-27 04:41:57
1b6be73721270225fea8a182f4a57ae44f5e6405...0618710913f41d7a7f4c095f0edda035e65a887d,2,17,0,17,2,2013-02-27 15:15:32,2013-02-27 15:12:16
0618710913f41d7a7f4c095f0edda035e65a887d...1083f82d1ee0c8f15a66be15e6184294a69d4420,2,151,18,169,13,2013-02-28 03:45:55,2013-02-19 04:52:29
1083f82d1ee0c8f15a66be15e6184294a69d4420...8be9cd1ce71de8affa32a85b596c1bfed2e714a6,2,26,0,26,2,2013-02-28 03:45:55,2013-02-27 02:59:08
8be9cd1ce71de8affa32a85b596c1bfed2e714a6...054c6946d4f86e4ba5ce6284554c8cacd7498e93,1,24,42,66,13,2013-02-28 18:56:52,2013-02-28 18:56:52
054c6946d4f86e4ba5ce6284554c8cacd7498e93...38bc968052f7f20af48626b6739f312224314348,1,21,27,48,9,2013-02-28 19:14:40,2013-02-28 19:14:40
38bc968052f7f20af48626b6739f312224314348...eebc77849cebd9a69025996939f930cbf9b1bae1,3,72,41,113,23,2013-02-28 20:01:10,2013-02-08 15:26:36
eebc77849cebd9a69025996939f930cbf9b1bae1...eee2eaf1d7a189d99106423a4206c224ebd5b848,11,30,29,59,25,2013-02-28 20:45:10,2013-02-27 20:44:34
eee2eaf1d7a189d99106423a4206c224ebd5b848...22a4e5bd0a7c0a92b54b9965984b582fd42099f2,1,22,32,54,15,2013-02-28 21:18:12,2013-02-10 20:01:27
22a4e5bd0a7c0a92b54b9965984b582fd42099f2...3f05afbd8d9bbc75d30b68e720324d1ed984a315,2,37,15,52,3,2013-02-28 21:59:12,2013-02-02 02:20:15
3f05afbd8d9bbc75d30b68e720324d1ed984a315...34c4e122a333bbfc80bd4f6e79db20f3a73ae5b3,2,9,16,25,2,2013-02-28 22:21:18,2013-01-30 23:32:19
34c4e122a333bbfc80bd4f6e79db20f3a73ae5b3...4cbc235c0d6c9ef5e11c4fc243275e38e9044cb4,1,1,1,2,1,2013-03-01 18:50:10,2013-03-01 18:50:10
4cbc235c0d6c9ef5e11c4fc243275e38e9044cb4...9f981c84a5b9de7d9d3d465763476ff2682c5f24,1,1,1,2,1,2013-03-01 18:50:16,2013-03-01 18:50:16
9f981c84a5b9de7d9d3d465763476ff2682c5f24...3212a293695221df402317633adf63698d95efd1,2,20,1,21,3,2013-03-02 00:02:57,2013-03-02 00:02:57
3212a293695221df402317633adf63698d95efd1...8f7218198dad5dd1a93dc44087159b2c34b86292,1,0,8,8,1,2013-03-02 00:33:12,2013-03-02 00:33:12
8f7218198dad5dd1a93dc44087159b2c34b86292...761b96c3016e09613f356bd6070be04edec74d0f,2,17,8,25,7,2013-03-02 18:04:48,2013-03-02 18:04:48
761b96c3016e09613f356bd6070be04edec74d0f...9bf8b040d3ec99018904c792d3c06cb1b5b222f3,1,11,9,20,6,2013-03-02 18:07:07,2013-03-02 18:07:07
9bf8b040d3ec99018904c792d3c06cb1b5b222f3...91824bd2923b99b03fd1a9c4447b46fd7cc96615,1,3,4,7,3,2013-03-02 19:09:39,2013-03-02 19:09:39
91824bd2923b99b03fd1a9c4447b46fd7cc96615...692afbcc5f719392c729997eacb234c07d2a6c78,2,18,4,22,3,2013-03-04 00:40:33,2013-03-04 00:40:33
692afbcc5f719392c729997eacb234c07d2a6c78...49abe3dc92f4a70c696a47f09f09253d0695043c,1,7,7,14,7,2013-03-04 00:41:01,2013-03-04 00:41:01
49abe3dc92f4a70c696a47f09f09253d0695043c...8d1c42296fefc4e79189b6c2d78a8a78fdd9576d,2,49,5,54,6,2013-03-06 19:42:24,2013-03-06 19:42:24
8d1c42296fefc4e79189b6c2d78a8a78fdd9576d...5c82d36f194a854a19f81bebd3ed1a6e7559c811,2,5,49,54,6,2013-03-06 20:11:20,2013-03-06 20:11:20
5c82d36f194a854a19f81bebd3ed1a6e7559c811...91d57647e9700de1a3693a400c85688c90304dde,2,2,2,4,2,2013-03-11 14:09:10,2013-03-11 14:06:36
91d57647e9700de1a3693a400c85688c90304dde...ae3524642c54ec4df09733de03c169f4fd43ac34,1,1,1,2,1,2013-03-11 16:55:26,2013-03-11 16:55:16
ae3524642c54ec4df09733de03c169f4fd43ac34...79992d752393d80822a4f8be2b7bec3ecdd60f6a,11,29,27,56,25,2013-03-13 01:06:25,2013-03-13 01:06:25
79992d752393d80822a4f8be2b7bec3ecdd60f6a...e0416f25485c67ccf35b6c309bbc69128770a27e,2,4,1,5,2,2013-03-13 14:58:55,2013-03-13 14:44:05
e0416f25485c67ccf35b6c309bbc69128770a27e...92b23673e60569b74ac48304579866c839008e1a,1,1,1,2,2,2013-03-14 13:53:19,2013-03-01 04:33:37
92b23673e60569b74ac48304579866c839008e1a...c5fc953d19436cfa706c2477c7bdcdc8b6cdd1e2,1,4,4,8,3,2013-03-18 16:51:04,2013-03-18 16:51:04
c5fc953d19436cfa706c2477c7bdcdc8b6cdd1e2...8f4572406c8d885de9fb236ae3fb1c9d4833cbee,2,2,2,4,2,2013-03-19 19:56:20,2013-03-19 19:30:52
8f4572406c8d885de9fb236ae3fb1c9d4833cbee...c9ca9bf509edd1dc0a92564210f3f325cc7555b6,2,30,7,37,2,2013-03-22 16:47:01,2013-03-03 15:51:04
c9ca9bf509edd1dc0a92564210f3f325cc7555b6...6bbbb785db2f94400574b6baefaa3c911bf06547,2,2,3,5,3,2013-03-23 19:18:16,2013-03-23 19:18:16
6bbbb785db2f94400574b6baefaa3c911bf06547...f319f42db073a0c5cc6d2fc17f40d0093547edcd,2,2,2,4,2,2013-03-23 19:20:46,2013-03-23 19:20:46
f319f42db073a0c5cc6d2fc17f40d0093547edcd...237413e75dd3c4b76b0f9ced117f1c9c9cb98ac5,3,43,42,85,3,2013-03-26 01:41:34,2013-02-28 07:03:17
237413e75dd3c4b76b0f9ced117f1c9c9cb98ac5...f2cb536127952a30a1b7edc34765e9e1313145e9,2,2,1,3,2,2013-03-26 01:58:47,2013-03-01 01:24:21
f2cb536127952a30a1b7edc34765e9e1313145e9...8ca9f931ec311b6f73990eac7665451a28bceac3,4,171,173,344,146,2013-03-26 02:06:49,2013-03-04 02:22:11
8ca9f931ec311b6f73990eac7665451a28bceac3...84a94acae1ed7d65d91df235985e433d34486dc3,1,121,120,241,87,2013-03-26 02:06:50,2013-03-04 03:00:57
84a94acae1ed7d65d91df235985e433d34486dc3...100d3c351604e1f9641098da2e78678b4e6d9cdf,2,20,18,38,2,2013-03-26 02:06:50,2013-03-04 03:03:57
100d3c351604e1f9641098da2e78678b4e6d9cdf...1f530e286755416369f4452d20f5ab6bb175451d,2,11,1,12,3,2013-03-27 00:50:30,2013-03-25 04:47:46
1f530e286755416369f4452d20f5ab6bb175451d...332a490573bbbd9e7df1381bde8f590240cb8679,2,19,2,21,4,2013-04-01 16:48:30,2013-04-01 16:48:30
332a490573bbbd9e7df1381bde8f590240cb8679...5b59a63b2b9247b326c654ca941a1dfe77914024,1,1,7,8,2,2013-04-01 17:02:57,2013-04-01 17:02:57
5b59a63b2b9247b326c654ca941a1dfe77914024...73b315538f21cab1118e72402576f3851c555b95,1,2,8,10,3,2013-04-01 21:09:37,2013-04-01 21:09:37
73b315538f21cab1118e72402576f3851c555b95...05d55d08e74aca4e39a1f66e3dcb51036265039b,2,91,2,93,5,2013-04-02 19:32:08,2013-04-02 19:32:08
05d55d08e74aca4e39a1f66e3dcb51036265039b...feea9394b75a5dcb16fad013a402b388f97cefba,2,27,4,31,2,2013-04-03 15:26:07,2013-04-03 15:26:07
feea9394b75a5dcb16fad013a402b388f97cefba...9eb838e4189c7afbd187b4663923d97a608811ef,1,1,1,2,1,2013-04-03 17:01:49,2013-04-03 17:01:49
9eb838e4189c7afbd187b4663923d97a608811ef...1205103a72db407bfbc0de3d9b78f1fd6a02520c,7,15,10,25,14,2013-04-04 00:51:30,2013-03-13 23:23:36
1205103a72db407bfbc0de3d9b78f1fd6a02520c...8db7d6f20b4226994e88d1cd9243743c492773f5,5,54,24,78,6,2013-04-04 01:00:38,2013-03-04 04:20:25
8db7d6f20b4226994e88d1cd9243743c492773f5...5aaa276e9e0041d099c954fc2744f0797e3893b0,2,1,2,3,2,2013-04-04 01:21:23,2013-03-26 03:45:09
5aaa276e9e0041d099c954fc2744f0797e3893b0...6da5eb10337c29c61ebc09fb8e3975509f58f419,2,138,1,139,2,2013-04-04 02:27:16,2013-03-07 14:15:12
6da5eb10337c29c61ebc09fb8e3975509f58f419...ba16ba2efcb0a7703d1332044de87bf12700a66e,5,5,9,14,6,2013-04-04 16:27:21,2013-03-13 23:23:36
ba16ba2efcb0a7703d1332044de87bf12700a66e...7049877530882c2f8ee09f71f7fc736ca9570736,5,10,17,27,8,2013-04-04 16:55:03,2013-03-20 00:45:19
7049877530882c2f8ee09f71f7fc736ca9570736...32b066d3805a48f8c8312562ed52a1b5910b1d85,3,43,0,43,3,2013-04-04 17:32:25,2013-03-24 03:01:50
32b066d3805a48f8c8312562ed52a1b5910b1d85...37c801eda5a96ba8d58f3d8751c42df296d3bd39,1,5,3,8,2,2013-04-04 20:55:16,2013-04-04 20:55:16
37c801eda5a96ba8d58f3d8751c42df296d3bd39...6358da8aa32e7ed52da3af1a912bdd1a05863faf,1,3,2,5,1,2013-04-04 21:27:15,2013-04-04 21:27:15
6358da8aa32e7ed52da3af1a912bdd1a05863faf...5d1dfe747403c093cc0e837651dcf80027387fc6,8,134,106,240,45,2013-04-05 04:37:36,2013-03-27 01:20:27
5d1dfe747403c093cc0e837651dcf80027387fc6...1114611f77ee9cd203db65b120d397dbe2f14d14,1,5,0,5,3,2013-04-05 05:04:44,2013-04-05 05:04:44
1114611f77ee9cd203db65b120d397dbe2f14d14...5031c9db4bf22cc04472346eeee8f25a61c5ee68,5,271,247,518,70,2013-04-06 20:00:58,2013-04-05 21:30:48
5031c9db4bf22cc04472346eeee8f25a61c5ee68...1b610266502490eab42a0b9ddfac2f93da0b0fe1,2,27,16,43,9,2013-04-06 20:37:32,2013-04-05 12:57:01
1b610266502490eab42a0b9ddfac2f93da0b0fe1...dca7681284731053124e6437c5bec58e030cc91d,9,25,18,43,23,2013-04-06 21:09:52,2013-04-04 20:04:39
dca7681284731053124e6437c5bec58e030cc91d...c44f07916d7ee2139c7aa0f9e633143b74433d98,1,0,7,7,1,2013-04-08 01:11:09,2013-04-08 01:11:09
c44f07916d7ee2139c7aa0f9e633143b74433d98...18d006762c557ed635404436f5733dccaf786f9f,2,5,5,10,2,2013-04-08 03:29:36,2013-04-07 11:48:46
18d006762c557ed635404436f5733dccaf786f9f...eaedf098b311b2aaa48970b284e3b426562d0614,1,1,3,4,2,2013-04-08 03:33:04,2013-04-07 08:14:31
eaedf098b311b2aaa48970b284e3b426562d0614...1233fc77883c26eeeea4847f9f0b90e07d189b90,2,0,15,15,8,2013-04-08 16:49:19,2013-04-07 12:39:44
1233fc77883c26eeeea4847f9f0b90e07d189b90...a120bbbfae81daccf801fcf8deb0bc77d865e27f,2,36,32,68,14,2013-04-08 17:57:11,2013-04-07 02:56:03
a120bbbfae81daccf801fcf8deb0bc77d865e27f...aadae5058a44e745ebdbee5d5333402699326188,1,1,1,2,1,2013-04-08 18:17:01,2013-04-08 18:17:01
aadae5058a44e745ebdbee5d5333402699326188...f61314ff5cb5e6b620ace758a6f00c94a3031154,2,40,14,54,6,2013-04-08 19:10:39,2013-04-08 19:10:39
f61314ff5cb5e6b620ace758a6f00c94a3031154...ff3f83fdf67b314b742ceb044257e5a271fd2893,1,1,1,2,1,2013-04-08 19:21:30,2013-04-08 19:21:13
ff3f83fdf67b314b742ceb044257e5a271fd2893...1a3939659b2c2506fb50ca3ee21e84c642cb5f64,1,15,17,32,16,2013-04-08 19:31:47,2013-04-08 19:31:47
1a3939659b2c2506fb50ca3ee21e84c642cb5f64...e8731410a4714a3383dfc5342f835e0177b58ff7,7,26,35,61,22,2013-04-08 19:35:16,2013-04-08 19:35:16
e8731410a4714a3383dfc5342f835e0177b58ff7...5833081356c12c23faa4c772e7a201e4dda97517,1,1,1,2,1,2013-04-08 19:35:40,2013-04-08 19:35:28
5833081356c12c23faa4c772e7a201e4dda97517...58a75a583bfe7ce49dc1a39f19d7ff0e3a4b7b67,1,6,0,6,1,2013-04-08 19:36:45,2013-04-08 19:36:24
58a75a583bfe7ce49dc1a39f19d7ff0e3a4b7b67...d7d6b7a5c7992834fcd4d4b01eda87169704f032,1,18,10,28,6,2013-04-08 19:37:16,2013-04-08 19:26:05
d7d6b7a5c7992834fcd4d4b01eda87169704f032...570ec3dec7ceaef1f24693499867dfaf7c083c5c,1,2,7,9,1,2013-04-08 19:39:20,2013-04-08 19:39:20
570ec3dec7ceaef1f24693499867dfaf7c083c5c...bea0d9a49df88e382805df08c5431a5e1a0752c9,3,267,263,530,6,2013-04-08 22:00:02,2013-04-08 22:00:02
bea0d9a49df88e382805df08c5431a5e1a0752c9...52394ba986794423e7855ece3b4f80a1f2fb7398,9,48,48,96,23,2013-04-09 00:38:20,2013-04-08 22:18:45
52394ba986794423e7855ece3b4f80a1f2fb7398...f1ba486ee3faeb70faeec1688b79ed085dd6a102,3,25,27,52,9,2013-04-09 01:33:17,2013-04-09 01:33:17
f1ba486ee3faeb70faeec1688b79ed085dd6a102...85fc5878b3c6af73f42d61eedf73013e7faae408,3,29,2,31,5,2013-04-09 01:35:48,2013-04-09 01:33:25
85fc5878b3c6af73f42d61eedf73013e7faae408...f6471f4f3668d236211d3d3e353852f0bc3a20ea,1,4,4,8,3,2013-04-09 12:09:26,2013-04-09 12:07:21
f6471f4f3668d236211d3d3e353852f0bc3a20ea...baa50b5e1709dc66354c647e14ac819338cdf5b9,1,1,1,2,1,2013-04-09 12:10:08,2013-04-09 12:10:08
baa50b5e1709dc66354c647e14ac819338cdf5b9...0afc92bd73a61a0279a419647458e6ed89638ae0,1,1,1,2,1,2013-04-09 12:10:23,2013-04-09 12:10:23
0afc92bd73a61a0279a419647458e6ed89638ae0...0fa52c11cbfe70780648b99717f1dd3502befaff,24,768,656,1424,479,2013-04-09 15:59:31,2013-04-09 15:45:09
0fa52c11cbfe70780648b99717f1dd3502befaff...e01a6231c78448043de6672940a41637ba5bdf28,1,1,1,2,1,2013-04-09 16:40:50,2013-04-09 16:40:50
e01a6231c78448043de6672940a41637ba5bdf28...ac9cad19fa0473315489ee952ba73afdaeb80386,2,8,4,12,3,2013-04-09 16:48:34,2013-04-09 16:48:34
ac9cad19fa0473315489ee952ba73afdaeb80386...e80117adb49eff8f82140b01d755bdeefe7eb089,1,1,1,2,1,2013-04-10 21:27:31,2013-04-10 21:27:31
e80117adb49eff8f82140b01d755bdeefe7eb089...c0088f2d26bba38dc04e9076a73579800e04347f,1,1,1,2,1,2013-04-15 14:46:24,2013-04-15 14:43:29
c0088f2d26bba38dc04e9076a73579800e04347f...8576e24bfe3fce886bcb63ebc24ee16b3fa1a6a1,1,4,0,4,1,2013-04-15 16:46:14,2013-04-10 18:46:31
8576e24bfe3fce886bcb63ebc24ee16b3fa1a6a1...562ca75e06a07067cace674e4e492119d78ca161,4,60,60,120,37,2013-04-15 17:26:34,2013-04-15 17:26:34
562ca75e06a07067cace674e4e492119d78ca161...db0326b1fdd22b97e24af34245e38914c04a70ba,7,108,76,184,37,2013-04-16 21:47:21,2013-04-03 17:17:02
db0326b1fdd22b97e24af34245e38914c04a70ba...77d7f264524677104cd7f37ecdb631d5824eacd4,2,27,2,29,3,2013-04-17 02:18:44,2013-04-17 02:16:12
77d7f264524677104cd7f37ecdb631d5824eacd4...2c7b1b8502ba85320678499c8499b647c1ea82e2,1,4,10,14,4,2013-04-17 02:37:48,2013-04-17 02:37:48
2c7b1b8502ba85320678499c8499b647c1ea82e2...ea5c22ec12e6a548b1ec2d7b0dcd9f71bea8d5dd,3,70,1,71,7,2013-04-17 03:07:39,2013-03-17 06:40:18
ea5c22ec12e6a548b1ec2d7b0dcd9f71bea8d5dd...03db1ada2cc223edf545c5a452e55062647837fa,3,86,39,125,10,2013-04-17 15:27:57,2012-12-02 05:14:25
03db1ada2cc223edf545c5a452e55062647837fa...039371c741335d02e7e486420f4a96b43ec2d585,1,1,1,2,1,2013-04-17 16:25:48,2013-04-17 16:23:44
039371c741335d02e7e486420f4a96b43ec2d585...5179fa00b839ebc70ec38fb0cf6cb8f8c412f37e,1,5,6,11,5,2013-04-17 16:37:23,2013-04-17 07:06:12
5179fa00b839ebc70ec38fb0cf6cb8f8c412f37e...aae7abfeb6e9810d67947825c3d1302bb36be6b7,1,6,0,6,1,2013-04-18 16:38:00,2013-04-18 13:16:59
aae7abfeb6e9810d67947825c3d1302bb36be6b7...9d16fe6283667396094d49559a37fc672c06252c,2,51,20,71,15,2013-04-18 17:35:37,2013-04-18 17:19:22
9d16fe6283667396094d49559a37fc672c06252c...3ef7a9683b95fa334ab75458a531bb263782c748,1,1,2,3,1,2013-04-18 17:51:12,2013-04-18 17:43:51
3ef7a9683b95fa334ab75458a531bb263782c748...6aaa8a113fd067b493fd365dae829472f9da351d,1,1,1,2,1,2013-04-18 20:52:00,2013-04-18 20:52:00
6aaa8a113fd067b493fd365dae829472f9da351d...ebecdac24220cae4671c5a7d8dc16097077dac30,1,1,1,2,1,2013-04-18 20:52:15,2013-04-18 20:52:15
ebecdac24220cae4671c5a7d8dc16097077dac30...d754b50cb5197a30bbdb87396b2fcfe2301b42fe,1,10,10,20,5,2013-04-20 14:06:31,2013-04-20 14:02:07
d754b50cb5197a30bbdb87396b2fcfe2301b42fe...fb1731ab163424e22bac4372f15cda1195bfaa85,2,28,17,45,4,2013-04-20 15:51:51,2013-04-20 15:40:27
fb1731ab163424e22bac4372f15cda1195bfaa85...67a080b284af50433583da05f84e73bc63814bab,1,1,1,2,1,2013-04-22 13:58:09,2013-04-22 13:58:09
67a080b284af50433583da05f84e73bc63814bab...d8f7e8371230a6dd504ca02e65442745b6ff6ce2,2,17,1,18,3,2013-04-23 01:08:38,2013-04-23 01:08:18
d8f7e8371230a6dd504ca02e65442745b6ff6ce2...ad71f47b27f463c6952768c5ab2773ae15ffa745,2,4,4,8,4,2013-04-24 13:06:11,2013-04-24 13:06:11
ad71f47b27f463c6952768c5ab2773ae15ffa745...78c803f1b5198e77f77231516db3912aa9a87055,2,27,1,28,2,2013-04-24 15:40:42,2013-04-24 15:38:23
78c803f1b5198e77f77231516db3912aa9a87055...3a6194076b8b7ab5a9d9f5e6ec602db2ab427d3e,2,16,1,17,3,2013-04-24 18:15:41,2013-04-24 18:15:41
3a6194076b8b7ab5a9d9f5e6ec602db2ab427d3e...55e319aa52eb828a3a4c2298aa75b6d15cfa06f8,3,16,9,25,6,2013-04-24 21:09:30,2013-04-24 20:07:15
55e319aa52eb828a3a4c2298aa75b6d15cfa06f8...18cccd04a6f69018242bce96ef905bc5d3be6ff8,1,2,2,4,2,2013-04-29 17:31:59,2013-04-29 17:31:59
18cccd04a6f69018242bce96ef905bc5d3be6ff8...9c4a428528cc47b0ef87a273f191c0fbbccc9678,2,4,3,7,3,2013-05-01 15:33:06,2013-05-01 15:33:06
9c4a428528cc47b0ef87a273f191c0fbbccc9678...6b5391508e7354076a32375c7f536f8eb91195ee,1,6,0,6,1,2013-05-02 17:39:13,2013-05-02 17:39:13
6b5391508e7354076a32375c7f536f8eb91195ee...e8b110c646754ffd6f5ee418d7c2ddf4190f9704,1,1,1,2,1,2013-05-02 17:40:25,2013-05-02 17:40:25
e8b110c646754ffd6f5ee418d7c2ddf4190f9704...2406b5e290c1364c0a58832e0bbf4bcf82abfe10,2,33,3,36,5,2013-05-02 20:35:22,2013-05-02 20:35:22
2406b5e290c1364c0a58832e0bbf4bcf82abfe10...caf963992d98932560a7e4cd1b8a9c1b753f66e9,1,12,4,16,5,2013-05-06 14:32:16,2013-05-06 14:32:16
caf963992d98932560a7e4cd1b8a9c1b753f66e9...6d04ebfafb39aa0d5659be30fc98ddabc13f2609,1,1,1,2,1,2013-05-06 19:41:22,2013-05-06 19:41:22
6d04ebfafb39aa0d5659be30fc98ddabc13f2609...8d3c0506c860e887d0005fd12da53f1d11ce2883,2,12,2,14,3,2013-05-06 19:42:00,2013-05-06 19:42:00
8d3c0506c860e887d0005fd12da53f1d11ce2883...24f2166400418208693df37b1fa1d26d03144874,1,1,1,2,1,2013-05-07 19:26:49,2013-05-07 19:26:49
24f2166400418208693df37b1fa1d26d03144874...7725f8e8b1ac5ef3bd7c6e2f784500f2f5533635,1,1,1,2,1,2013-05-07 21:38:19,2013-05-07 21:37:51
7725f8e8b1ac5ef3bd7c6e2f784500f2f5533635...2fc6b658e8691eb71b1ed038ac94ed7ae7296f29,1,1,1,2,1,2013-05-08 14:54:56,2013-05-08 14:38:06
2fc6b658e8691eb71b1ed038ac94ed7ae7296f29...5e42df0517cefa6e81bdc5c3206740a5958b545c,1,1,1,2,1,2013-05-08 15:56:13,2013-05-03 02:01:15
5e42df0517cefa6e81bdc5c3206740a5958b545c...47f56f1612b907ec9eaa7111c7af66d335279fa2,1,45,7,52,9,2013-05-09 00:00:24,2013-05-09 00:00:24
47f56f1612b907ec9eaa7111c7af66d335279fa2...c9267ab078ad223eceb381fb45ab06a86baccfb0,3,4,3,7,4,2013-05-09 18:26:13,2013-05-03 01:45:02
c9267ab078ad223eceb381fb45ab06a86baccfb0...9fdbc8bf33418f7b3a3a88df9a04ffee53c8dc66,3,8,14,22,4,2013-05-09 18:53:15,2013-05-09 01:07:41
9fdbc8bf33418f7b3a3a88df9a04ffee53c8dc66...b5580a989869f0b702e60704a35e133eeee3e1fc,2,2,1,3,2,2013-05-09 19:14:46,2013-04-24 18:56:38
b5580a989869f0b702e60704a35e133eeee3e1fc...5dda0687f19c29976c4f4989ebc981b9e7231a3f,1,1,1,2,1,2013-05-10 16:48:39,2013-05-10 16:48:03
5dda0687f19c29976c4f4989ebc981b9e7231a3f...1debe49ac7d9379ede44e873e4a2ebaa10dfb0b6,1,1,1,2,1,2013-05-10 19:44:06,2013-05-10 19:43:39
1debe49ac7d9379ede44e873e4a2ebaa10dfb0b6...8ee67bde11ef496dcde4ee026e905c52eb7d4782,1,2,4,6,1,2013-05-11 19:58:45,2013-05-11 19:54:17
8ee67bde11ef496dcde4ee026e905c52eb7d4782...8ab32fe3ff81491e01f2da132ec2ba9bd499b555,1,7,5,12,6,2013-05-12 21:02:00,2013-05-12 20:50:54
8ab32fe3ff81491e01f2da132ec2ba9bd499b555...eaee6eae0fee57337fabe41eb4558cf1acdf765b,3,29,3,32,5,2013-05-12 21:40:49,2013-05-12 21:21:31
eaee6eae0fee57337fabe41eb4558cf1acdf765b...5e8a5f4adcbaf07a8306f8a6a14a9fbcda81afb8,1,10,20,30,9,2013-05-13 01:58:53,2013-05-13 01:58:53
5e8a5f4adcbaf07a8306f8a6a14a9fbcda81afb8...c1b8edfcc90961290f7555c55851209bc860c0b4,2,25,23,48,7,2013-05-13 19:00:57,2013-04-17 16:53:41
c1b8edfcc90961290f7555c55851209bc860c0b4...3971c2ebb2e6729fe80bac4ee7b91bc02f26486f,3,102,59,161,21,2013-05-13 22:17:25,2013-05-09 02:56:51
3971c2ebb2e6729fe80bac4ee7b91bc02f26486f...d80c6aca18240281f553a35d727c2891d4bc2b57,2,8,8,16,6,2013-05-14 00:37:42,2013-05-14 00:37:42
d80c6aca18240281f553a35d727c2891d4bc2b57...d8a35011ec05ed3493a85c1bd699902893cd437c,2,21,1,22,2,2013-05-14 01:55:00,2013-05-14 01:55:00
d8a35011ec05ed3493a85c1bd699902893cd437c...2f2e045ea66f320eee62b149a6b11f22aadb816b,1,1,1,2,1,2013-05-16 01:25:46,2013-05-16 01:25:30
2f2e045ea66f320eee62b149a6b11f22aadb816b...df372ad6e7f44d879a9d3e8b9e0a27f6d8c176b5,1,13,6,19,3,2013-05-17 03:04:38,2013-05-17 02:48:02
df372ad6e7f44d879a9d3e8b9e0a27f6d8c176b5...eabb56c27484cbffd2ce4951f661df83c91e5d7a,1,1,1,2,1,2013-05-20 16:57:40,2013-05-13 20:10:36
eabb56c27484cbffd2ce4951f661df83c91e5d7a...a2cd89a795067d67d8212a4571991e5d2fb0ea8f,2,24,1,25,2,2013-05-23 00:11:37,2013-05-23 00:11:37
a2cd89a795067d67d8212a4571991e5d2fb0ea8f...997da31121b9d084ccba05a9bb1e258c8c8faaf0,1,50,6,56,8,2013-05-23 19:08:57,2013-05-22 13:11:19
997da31121b9d084ccba05a9bb1e258c8c8faaf0...9cbd6898b9deb1a21b796933ba6f4e6dd801172e,1,5,4,9,3,2013-05-24 16:37:32,2013-05-24 16:37:32
9cbd6898b9deb1a21b796933ba6f4e6dd801172e...6190370ab7406b526c29cda0a4c8301b6a259660,1,1,1,2,1,2013-05-24 16:44:44,2013-05-24 16:44:44
6190370ab7406b526c29cda0a4c8301b6a259660...bd36ea22b670d52636dbe3f10cf6ce1e67d838b8,1,1,1,2,1,2013-05-24 16:44:52,2013-05-24 16:44:52
bd36ea22b670d52636dbe3f10cf6ce1e67d838b8...26980c6ec96369bbaf87be1e405594df8ec3f0dc,2,41,1,42,3,2013-05-26 23:53:58,2013-05-26 20:02:32
26980c6ec96369bbaf87be1e405594df8ec3f0dc...68c9d0528c43d89cbdab302c68924fb11cd3439c,1,1,3,4,1,2013-05-27 15:21:28,2013-05-26 11:20:47
68c9d0528c43d89cbdab302c68924fb11cd3439c...6fd5e480c1cd3e481e7097763ee281b65bc74306,3,33,10,43,9,2013-05-28 20:49:48,2013-05-25 14:18:57
6fd5e480c1cd3e481e7097763ee281b65bc74306...d0ca6096000a4a86f9a86f1deb0b498dd6dedf2c,1,1,1,2,1,2013-05-29 13:19:57,2013-05-29 13:19:18
d0ca6096000a4a86f9a86f1deb0b498dd6dedf2c...b21c88ff0c293db0711d378411901259052ca2b4,1,1,1,2,1,2013-05-30 21:25:21,2013-05-30 21:25:21
b21c88ff0c293db0711d378411901259052ca2b4...86fe6eea506d88912ad57ecd975232050548e2d1,1,1,1,2,1,2013-05-30 21:25:29,2013-05-30 21:25:29
86fe6eea506d88912ad57ecd975232050548e2d1...a0aa6232d0b451bb6e61a33d6f33a750b51bbe18,1,1,1,2,1,2013-05-31 15:20:32,2013-05-31 15:20:32
a0aa6232d0b451bb6e61a33d6f33a750b51bbe18...0b7c44a1da3ed278e6f50a76c4075620ddb595ad,1,1,1,2,1,2013-06-02 05:37:33,2013-06-02 05:35:24
0b7c44a1da3ed278e6f50a76c4075620ddb595ad...e53a91909061c7a7280a274990db179b94db81b6,2,14,7,21,5,2013-06-03 02:27:40,2013-05-11 19:34:48
e53a91909061c7a7280a274990db179b94db81b6...6b46fde81923659a7c07d261c355287397ceb459,1,1,1,2,1,2013-06-03 20:11:17,2013-06-03 20:10:48
6b46fde81923659a7c07d261c355287397ceb459...8643ac77fbd7508651639a41eced5338c1738c12,2,26,15,41,5,2013-06-05 13:58:33,2013-06-05 13:58:33
8643ac77fbd7508651639a41eced5338c1738c12...3a434434c420096cef478936ea21b33e9cfae30c,2,3,2,5,3,2013-06-19 23:17:42,2013-06-19 21:36:32
3a434434c420096cef478936ea21b33e9cfae30c...147726af127bce98b4e9dfe517d68f4a1ea0c1fc,2,17,1,18,3,2013-06-24 16:23:12,2013-06-21 19:45:30
147726af127bce98b4e9dfe517d68f4a1ea0c1fc...d139732a166f2c9b4ca3cafd9ee2974fe0c4f283,1,1,1,2,1,2013-06-27 03:08:37,2013-06-27 03:08:37
d139732a166f2c9b4ca3cafd9ee2974fe0c4f283...ec6eb38c64aadd6860c402cc0894c77b82b1a65d,2,5,1,6,3,2013-07-01 17:58:39,2013-06-28 23:08:16
ec6eb38c64aadd6860c402cc0894c77b82b1a65d...d57c22ce1e87d10ba09272c557b2a968f0a16078,1,2,1,3,1,2013-07-01 18:09:14,2013-07-01 18:09:14
d57c22ce1e87d10ba09272c557b2a968f0a16078...16115c1d9117cd0c22504d7b52f0f91e18c0d8df,1,3,2,5,3,2013-07-01 18:31:00,2013-06-02 21:23:03
16115c1d9117cd0c22504d7b52f0f91e18c0d8df...308980ee2a5c85ba1600446d093edc921f9a71de,1,5,1,6,1,2013-07-01 18:31:01,2013-06-27 10:35:21
308980ee2a5c85ba1600446d093edc921f9a71de...5f1aa2354aeffa787e40d44224a1b583b7c89666,2,3,2,5,3,2013-07-01 18:31:01,2013-06-02 06:32:48
5f1aa2354aeffa787e40d44224a1b583b7c89666...d53ddc90c1f119fb9148a553443ef3fbc3f3cc99,2,4,4,8,3,2013-07-02 13:48:40,2013-07-02 13:48:40
d53ddc90c1f119fb9148a553443ef3fbc3f3cc99...a44202dc604d14688756ae0cccde0fec53e53dbf,1,1,1,2,1,2013-07-02 20:12:12,2013-07-02 20:12:12
a44202dc604d14688756ae0cccde0fec53e53dbf...6e630fbbb19306e1914712502a2b22872e94ddad,2,4,4,8,3,2013-07-02 20:58:20,2013-07-02 20:58:20
6e630fbbb19306e1914712502a2b22872e94ddad...f576d00d9fe48b5e6f9c1c8d3287f2b893937dbb,1,1,1,2,1,2013-07-03 13:30:16,2013-07-03 13:30:16
f576d00d9fe48b5e6f9c1c8d3287f2b893937dbb...0dd88061a276675b468a2bacfef7e245e391f221,1,1,1,2,1,2013-07-03 13:30:49,2013-07-03 13:30:49
0dd88061a276675b468a2bacfef7e245e391f221...aee465987c6e2db9e37900e91161584b2c92390e,1,1,1,2,1,2013-07-04 17:28:03,2013-07-04 17:28:03
aee465987c6e2db9e37900e91161584b2c92390e...1f67d07c60c37e60052db37fc03d42af482c2d03,4,40,28,68,5,2013-07-04 18:00:26,2013-07-04 18:00:26
1f67d07c60c37e60052db37fc03d42af482c2d03...c93f91e33ee25e60683fd05ae0210c9b07f2e2ac,2,2,2,4,2,2013-07-08 16:27:33,2013-07-08 16:27:33
c93f91e33ee25e60683fd05ae0210c9b07f2e2ac...b13d8229ae25a6c48b1d59a0e592cde154e063f0,9,29,82,111,17,2013-07-10 16:00:26,2013-07-10 16:00:26
b13d8229ae25a6c48b1d59a0e592cde154e063f0...bc4e9763e217dfe237f24521a46412b7d52a9e0c,1,18,5,23,6,2013-07-10 18:18:57,2013-07-10 18:18:57
bc4e9763e217dfe237f24521a46412b7d52a9e0c...c33108cad16ba6ff831d5cbc45b9dfbf12650e0e,6,39,39,78,16,2013-07-11 16:52:48,2013-07-11 16:52:07
c33108cad16ba6ff831d5cbc45b9dfbf12650e0e...07b5f126e2067e115dde8ab4161a66a96e27adaa,2,14,8,22,7,2013-07-19 13:54:15,2013-07-19 13:53:57
07b5f126e2067e115dde8ab4161a66a96e27adaa...0600a29256be76bd87adb547545bf7219fafb6ee,1,3,1,4,1,2013-07-19 13:54:59,2013-07-19 13:54:59
0600a29256be76bd87adb547545bf7219fafb6ee...806b0230cd14916907807ced638aea066465e1d4,2,9,10,19,6,2013-07-22 18:04:48,2013-07-22 17:54:37
806b0230cd14916907807ced638aea066465e1d4...24571f4a730ea51127fe5f1f798c1283a2b8cc8a,1,1,3,4,1,2013-07-22 18:04:50,2013-07-22 18:04:01
24571f4a730ea51127fe5f1f798c1283a2b8cc8a...831a532c3ce9b014ed7c0f8fd910a0a2fc0aa5aa,1,1,7,8,1,2013-07-22 18:38:49,2013-07-22 18:08:10
831a532c3ce9b014ed7c0f8fd910a0a2fc0aa5aa...c8c32f1d0583711355c593fb4c84332bfba18254,1,2,2,4,2,2013-07-24 14:39:09,2013-07-24 14:39:09
c8c32f1d0583711355c593fb4c84332bfba18254...302f222df03d2c65f409b11b7fa65dba5400180f,1,1,1,2,1,2013-07-25 01:31:07,2013-07-25 01:21:56
302f222df03d2c65f409b11b7fa65dba5400180f...410cf4ee6bd454fa7e2bb5dc37a0b051f15d3e96,1,2,2,4,2,2013-07-25 01:31:08,2013-07-25 01:29:32
410cf4ee6bd454fa7e2bb5dc37a0b051f15d3e96...3484a68c16f8461fc3493450e916f5b9e8ad5df7,2,3,3,6,3,2013-08-07 21:15:16,2013-08-02 00:04:49
3484a68c16f8461fc3493450e916f5b9e8ad5df7...e253c65b2dbcc376e8ef96c0b9197ec1f68103e4,1,2,1,3,2,2013-08-07 21:18:01,2013-08-04 23:06:51
e253c65b2dbcc376e8ef96c0b9197ec1f68103e4...9214c37bbaa79aa99c85c8043a870c8cec3d7b0f,1,8,11,19,4,2013-08-08 13:44:07,2013-08-08 00:11:42
9214c37bbaa79aa99c85c8043a870c8cec3d7b0f...2bdeb6b14dfdb4b5f0c4adf2c43797921e1526cb,1,28,5,33,3,2013-08-10 03:08:16,2013-08-07 21:10:35
2bdeb6b14dfdb4b5f0c4adf2c43797921e1526cb...5bbfa46aba1e6d2d56923f77b194371791f75061,1,5,5,10,4,2013-08-10 03:47:21,2013-08-10 03:47:21
5bbfa46aba1e6d2d56923f77b194371791f75061...012bda75f1941eb60869be1e4b6606aa40b17024,1,1,1,2,1,2013-08-10 06:49:14,2013-08-10 06:49:14
012bda75f1941eb60869be1e4b6606aa40b17024...7627b8b6d9ef6e57dbd20a55b946bd1991c1223e,1,1,1,2,1,2013-08-12 16:31:00,2013-08-12 16:31:00
7627b8b6d9ef6e57dbd20a55b946bd1991c1223e...6318ae6ab90d4b450dfadf32ab95fe52ed6331cb,77,27783,1580,29363,210,2013-08-15 18:15:49,2013-08-15 18:15:49
6318ae6ab90d4b450dfadf32ab95fe52ed6331cb...b7b50a7d5f3aef469dfdbde56b30d1349b97436b,1,2,1,3,2,2013-08-15 19:56:47,2013-08-15 19:56:47
b7b50a7d5f3aef469dfdbde56b30d1349b97436b...7877c4fa73120bc6d21a5fcd302a896f03b23876,1,0,1,1,1,2013-08-15 19:58:15,2013-08-15 19:58:15
7877c4fa73120bc6d21a5fcd302a896f03b23876...cecb52ff5c5c5c6a030b6520dc1e39ec4c6df3d9,10,21,12,33,13,2013-08-16 00:38:48,2013-08-16 00:38:48
cecb52ff5c5c5c6a030b6520dc1e39ec4c6df3d9...70c9a0a13a56402724590f9450600fabb59e79a8,1,6,0,6,1,2013-08-16 13:43:43,2013-08-16 13:40:28
70c9a0a13a56402724590f9450600fabb59e79a8...df67c1ab0963c6a05735e84f4088a0f6b7484b3d,5,214,198,412,13,2013-08-16 13:48:00,2013-08-16 13:48:00
df67c1ab0963c6a05735e84f4088a0f6b7484b3d...31f09122677f6ee206796912041827c006031e46,1,1,0,1,1,2013-08-16 14:11:22,2013-08-16 14:11:22
31f09122677f6ee206796912041827c006031e46...338e48aea5c047486a410c8938fcfd8af2f0c060,1,1,1,2,1,2013-08-16 14:13:09,2013-08-16 14:13:09
338e48aea5c047486a410c8938fcfd8af2f0c060...b693b370a459ef89ef187518b832a45b6e848eca,3,14,4,18,5,2013-08-16 16:54:43,2013-08-16 16:54:43
b693b370a459ef89ef187518b832a45b6e848eca...ef694f6cc77674fc119b8bfa32c74aa456b84eb6,1,6,0,6,1,2013-08-16 18:39:42,2013-08-16 18:36:08
ef694f6cc77674fc119b8bfa32c74aa456b84eb6...32e803c5bc821a34d6d225659f7a4b4a24053e07,1,1,2,3,2,2013-08-16 18:41:13,2013-08-16 18:33:28
32e803c5bc821a34d6d225659f7a4b4a24053e07...c418b94eb48188cd9329519ae5e030a52dd81cc9,1,13,4,17,5,2013-08-19 15:55:49,2013-08-19 15:55:05
c418b94eb48188cd9329519ae5e030a52dd81cc9...3e3680c2cdc524ee9194ef27fdce318cf301144c,1,1,1,2,1,2013-08-19 16:10:25,2013-08-19 16:10:11
3e3680c2cdc524ee9194ef27fdce318cf301144c...584a4af9c8633b35fe49152c81977de03f885826,1,4,2,6,2,2013-08-19 16:25:42,2013-07-19 01:17:29
584a4af9c8633b35fe49152c81977de03f885826...215cc09067f08aa67ed467c667efccbbf3bf4468,1,4,1,5,1,2013-08-19 17:31:15,2013-08-19 17:31:15
215cc09067f08aa67ed467c667efccbbf3bf4468...e3584179fe919c59033e54f019a1511691d2c85b,1,1,11,12,1,2013-08-19 17:53:31,2013-08-19 17:53:31
e3584179fe919c59033e54f019a1511691d2c85b...f92a446ee8d6e98c43b87f185e73240fabec5ae4,1,2,2,4,2,2013-08-19 18:16:16,2013-08-19 18:16:16
f92a446ee8d6e98c43b87f185e73240fabec5ae4...42cd19fb8f29db6fb06f49e5b94829ea7036c3c5,1,2,2,4,1,2013-08-19 18:33:52,2013-08-19 18:33:52
42cd19fb8f29db6fb06f49e5b94829ea7036c3c5...493548c099b1b0c5413fd7db94346dbe61c028c7,1,1,2,3,2,2013-08-19 19:29:23,2013-08-19 19:01:00
493548c099b1b0c5413fd7db94346dbe61c028c7...a542590687ea2dd32d6209da50031edda5e5ba44,1,1,1,2,1,2013-08-19 19:49:18,2013-08-19 19:49:18
a542590687ea2dd32d6209da50031edda5e5ba44...f6e86c3ca4d527d5453a0b5b9591ef38b5d3c000,3,8,2,10,3,2013-08-19 20:05:27,2013-08-19 20:05:27
f6e86c3ca4d527d5453a0b5b9591ef38b5d3c000...62da89b89abec219a769d71f0b152c83acd21123,3,2,8,10,3,2013-08-19 22:27:30,2013-08-19 22:27:30
62da89b89abec219a769d71f0b152c83acd21123...6f4da9a8dfc46f760d9116f53eb137e6554377e9,1,2,2,4,2,2013-08-20 13:47:35,2013-08-20 13:47:35
6f4da9a8dfc46f760d9116f53eb137e6554377e9...2ac1cd91db5c20cbe8ba0db44f7640cd150060ee,1,1,1,2,1,2013-08-20 13:53:28,2013-08-20 13:53:28
2ac1cd91db5c20cbe8ba0db44f7640cd150060ee...29903f38afc188c250c9a48ee5a7ad4ce62a4a75,1,26,11,37,10,2013-08-27 12:38:29,2013-08-26 20:36:55
29903f38afc188c250c9a48ee5a7ad4ce62a4a75...9372f6f02755513b08792af8de406aab91d0e945,1,3,0,3,1,2013-08-27 18:22:55,2013-08-27 18:22:28
9372f6f02755513b08792af8de406aab91d0e945...a7a3b8ce1b602f4e87539e934005875e648be192,1,1,1,2,1,2013-08-27 19:05:00,2013-08-27 19:05:00
a7a3b8ce1b602f4e87539e934005875e648be192...01d5a1a1c9d5469057cafc5a2b27668d0e04ad22,2,29,18,47,3,2013-08-28 16:23:54,2013-08-28 16:12:37
01d5a1a1c9d5469057cafc5a2b27668d0e04ad22...ca1c90e55c05610c28a176e3bcb2a64450b5e296,1,3,1,4,1,2013-08-29 17:52:46,2013-08-27 04:31:14
ca1c90e55c05610c28a176e3bcb2a64450b5e296...004c1fc5bb40ae8dfec18d6719534abad636b7e8,8,166,152,318,27,2013-08-29 20:18:17,2013-08-29 20:18:17
004c1fc5bb40ae8dfec18d6719534abad636b7e8...83396ba832e1169c2e82ceb8493427e5456a82e9,1,12,7,19,8,2013-08-30 16:39:41,2013-08-30 16:38:43
83396ba832e1169c2e82ceb8493427e5456a82e9...c75c9a8ebb5d2483daa68bec799e0d770083a811,1,2,6,8,3,2013-08-30 23:55:03,2013-08-28 16:54:55
c75c9a8ebb5d2483daa68bec799e0d770083a811...f66d53c85643e703a8e37d9ca9375dd386a60cda,2,57,19,76,8,2013-09-03 06:01:53,2013-09-03 05:24:01
f66d53c85643e703a8e37d9ca9375dd386a60cda...0c185209233f4c15e57c6a24e8f81b27dd26db59,6,41,32,73,25,2013-09-03 14:43:32,2013-09-03 13:55:32
0c185209233f4c15e57c6a24e8f81b27dd26db59...58a504093c320744b8ab252cc75df966dd8968bc,1,5,5,10,4,2013-09-05 16:18:48,2013-09-05 16:18:48
58a504093c320744b8ab252cc75df966dd8968bc...dfaee326e6605dc6d848c4c5022e39069d2cee65,3,3,21,24,5,2013-09-05 16:23:56,2013-09-05 16:23:56
dfaee326e6605dc6d848c4c5022e39069d2cee65...776012b8b3898fad2e0727880f1dc4af5c7b33c1,4,70,47,117,7,2013-09-05 16:26:21,2013-08-21 22:33:57
776012b8b3898fad2e0727880f1dc4af5c7b33c1...bbbdd947256a3fcd788fb9d4f306046082a1ef1f,35,383,433,816,91,2013-09-06 01:38:22,2013-08-26 22:54:13
bbbdd947256a3fcd788fb9d4f306046082a1ef1f...73e120116ce13b992d5229b3e10fcc19f9505a15,1,3,0,3,1,2013-09-06 15:26:08,2013-09-06 15:26:08
73e120116ce13b992d5229b3e10fcc19f9505a15...1f16b168594f5b98341fd7db0b9fb5b3e84217c8,1,14,7,21,3,2013-09-06 16:33:55,2013-09-06 16:33:55
1f16b168594f5b98341fd7db0b9fb5b3e84217c8...1a25f21dc3033695be1b0ff8924c4b633e1dda46,23,34,25,59,23,2013-09-06 18:31:18,2013-09-06 18:31:18
1a25f21dc3033695be1b0ff8924c4b633e1dda46...6535cc599e4d7ccb80cb1d83f20344d71702516b,2,15,16,31,4,2013-09-06 19:44:59,2013-09-06 19:44:50
6535cc599e4d7ccb80cb1d83f20344d71702516b...e563cd3414930bc4a5b4bc47c67c3a917b44c160,3,68,69,137,4,2013-09-06 20:23:20,2013-09-06 20:23:20
e563cd3414930bc4a5b4bc47c67c3a917b44c160...4ca5a0c6913ce7e56654b7a795d17a1cc644a115,1,1,1,2,1,2013-09-06 20:25:33,2013-09-06 20:25:33
4ca5a0c6913ce7e56654b7a795d17a1cc644a115...5093b89f08aa4565d1987666d998d16e2e3b6f4a,5,303,293,596,15,2013-09-06 21:11:32,2013-09-06 21:11:04
5093b89f08aa4565d1987666d998d16e2e3b6f4a...9968364d145b1de5276e2864357dad26d2d14546,1,13,7,20,1,2013-09-07 00:30:19,2013-09-07 00:30:19
9968364d145b1de5276e2864357dad26d2d14546...0ed397d803415fcd4ef461dbfd6447c1f28ee521,1,4,0,4,1,2013-09-07 01:08:14,2013-09-07 01:08:14
0ed397d803415fcd4ef461dbfd6447c1f28ee521...eb9cbfcaf6803a07a953e0ca0922a973c5a11016,5,5,6,11,6,2013-09-07 01:14:40,2013-08-21 22:33:57
eb9cbfcaf6803a07a953e0ca0922a973c5a11016...99c123b159e85ab9d97bea65a5ec4fff62023bf9,7,82,58,140,11,2013-09-09 01:05:07,2013-09-09 01:05:07
99c123b159e85ab9d97bea65a5ec4fff62023bf9...b534ee2ccf3c9d19d78a79bfba2cd33a9754ba5b,14,24,2,26,15,2013-09-09 01:25:27,2013-09-09 01:25:27
b534ee2ccf3c9d19d78a79bfba2cd33a9754ba5b...69d84dadc2db228910bdf31c377621cb8b1dab21,1,0,1,1,1,2013-09-09 01:51:44,2013-09-09 01:51:44
69d84dadc2db228910bdf31c377621cb8b1dab21...d4518eacb0b5aa2bddf9812559debe2bdc1bd334,1,1,0,1,1,2013-09-09 02:23:32,2013-09-09 02:23:32
d4518eacb0b5aa2bddf9812559debe2bdc1bd334...8791920183f9f13a7be1d513652b9c96d29648c7,1,11,6,17,6,2013-09-09 02:26:05,2013-09-09 02:26:05
8791920183f9f13a7be1d513652b9c96d29648c7...38cb6d9ed8d7571561fbf001d4db410b01c8fd88,1,2,1,3,2,2013-09-09 13:49:49,2013-09-09 13:49:49
38cb6d9ed8d7571561fbf001d4db410b01c8fd88...1b3c0c00fa4a9f128e0478e0d010b618517347f4,3,22,16,38,4,2013-09-09 13:50:12,2013-09-09 13:50:12
1b3c0c00fa4a9f128e0478e0d010b618517347f4...4fd6e8e7605561facc1ed05ddcfee2f7c78ce3ec,1,177,177,354,5,2013-09-09 14:01:04,2013-09-09 13:54:52
4fd6e8e7605561facc1ed05ddcfee2f7c78ce3ec...2fe09ceaf9c261d8e7fbdf37a13b21bfd85da962,1,75,26,101,21,2013-09-09 15:23:22,2013-09-09 15:23:16
2fe09ceaf9c261d8e7fbdf37a13b21bfd85da962...3b53b75160606610cc8f87404f89fc9e10441c4b,14,151,121,272,34,2013-09-09 15:34:23,2013-09-09 15:26:21
3b53b75160606610cc8f87404f89fc9e10441c4b...cd4a9cd7fa7093df92e64d5da9f18742254a8ca7,8,143,131,274,27,2013-09-09 16:08:00,2013-09-09 15:39:02
cd4a9cd7fa7093df92e64d5da9f18742254a8ca7...99191a510ecb5584addc0391edd56d626067b28a,9,939,940,1879,93,2013-09-09 18:54:46,2013-09-09 16:13:41
99191a510ecb5584addc0391edd56d626067b28a...d788010aa724f58090560e83c224d3d140814b51,1,3,3,6,1,2013-09-09 18:55:07,2013-09-09 16:32:06
d788010aa724f58090560e83c224d3d140814b51...825ac3773694e0cd23ee74895fd5aeb535b27da4,18,250,213,463,29,2013-09-10 00:13:01,2013-09-10 00:13:01
825ac3773694e0cd23ee74895fd5aeb535b27da4...ac60f1071ddb460fec6ddee1bf6edacd414c3b35,1,4,2,6,1,2013-09-10 04:26:21,2013-09-10 04:26:21
ac60f1071ddb460fec6ddee1bf6edacd414c3b35...73fe17299a840a8a7f3ffffcac15e32a88bd3d66,2,17,6,23,8,2013-09-10 19:57:14,2013-09-10 19:57:14
73fe17299a840a8a7f3ffffcac15e32a88bd3d66...aab9d632797c46728a22eb615bd18cb7f5c9c497,3,11,3,14,4,2013-09-10 23:47:36,2013-09-10 23:47:36
aab9d632797c46728a22eb615bd18cb7f5c9c497...641492b7e198ebb3e4e564f245b54866a47fa060,1,1,1,2,1,2013-09-10 23:50:03,2013-09-10 23:50:03
641492b7e198ebb3e4e564f245b54866a47fa060...4ded9be72a724a79d764a4fc72ea9450322235a8,6,111,85,196,15,2013-09-11 00:24:26,2013-09-11 00:24:26
4ded9be72a724a79d764a4fc72ea9450322235a8...0b9f0343824526c2b218c313aebeeab3d41d1c96,3,52,40,92,9,2013-09-11 00:45:11,2013-09-11 00:45:11
0b9f0343824526c2b218c313aebeeab3d41d1c96...70a1c366480d1ce24b1311a4504ad99ca87fe78f,1,0,1,1,1,2013-09-11 01:24:04,2013-09-11 01:24:04
70a1c366480d1ce24b1311a4504ad99ca87fe78f...48a3549bc572bebb5dc581e4818e15f1443b3de2,1,21,3,24,6,2013-09-11 01:35:46,2013-09-11 01:35:46
48a3549bc572bebb5dc581e4818e15f1443b3de2...2e850fb802fc01f61c8e3b9030e8391c5b283a4e,3,7,8,15,8,2013-09-11 13:41:48,2013-09-11 13:41:48
2e850fb802fc01f61c8e3b9030e8391c5b283a4e...19de30ce0f781a4c126d0220f7a7651db4568e2d,1,1,1,2,1,2013-09-11 13:46:08,2013-09-11 13:46:08
19de30ce0f781a4c126d0220f7a7651db4568e2d...8a832797c0b47a0da9bfe036742df2271c041394,2,4,2,6,2,2013-09-11 14:51:31,2013-09-11 14:51:31
8a832797c0b47a0da9bfe036742df2271c041394...6d2c5c715aa53a13025fca6e8efa6533481c5e73,1,11,14,25,4,2013-09-11 19:29:15,2013-09-11 19:29:15
6d2c5c715aa53a13025fca6e8efa6533481c5e73...cb707d8bd0ccd40935a41f0814ff0b85a1e25c40,1,1,1,2,1,2013-09-11 20:03:40,2013-09-11 20:03:40
cb707d8bd0ccd40935a41f0814ff0b85a1e25c40...dab011e26d23e3751ffc9b391e6a404720b44649,2,7,1,8,2,2013-09-12 16:08:37,2013-09-12 16:08:29
dab011e26d23e3751ffc9b391e6a404720b44649...18099d52d831609bf63d1140a0dc63b5bd117f5e,1,20,0,20,1,2013-09-12 16:19:38,2013-09-12 16:18:36
18099d52d831609bf63d1140a0dc63b5bd117f5e...4228905b1482ab231e3d65646537ca870510ffe3,1,1,1,2,1,2013-09-12 16:30:28,2013-09-12 16:30:09
4228905b1482ab231e3d65646537ca870510ffe3...679536ee4b7a92ae64a5f58d90e9cc38c001e807,2,2,2,4,2,2013-09-12 17:33:51,2013-09-12 17:32:44
679536ee4b7a92ae64a5f58d90e9cc38c001e807...6b7a52b21a5b37f110c17bf9d6c81231565a080c,1,2,1,3,1,2013-09-12 20:25:23,2013-09-12 20:25:23
6b7a52b21a5b37f110c17bf9d6c81231565a080c...1d57ffe5fff06928aac53813342d33ec6bddd531,1,1,1,2,1,2013-09-12 20:36:29,2013-09-12 20:36:29
1d57ffe5fff06928aac53813342d33ec6bddd531...68213f20bb5d5426f99bafde028ecab601a9d105,2,6,3,9,2,2013-09-12 20:45:12,2013-09-05 18:04:11
68213f20bb5d5426f99bafde028ecab601a9d105...e12746d756ef32124b163136fe49e753b35c7111,1,2,1,3,2,2013-09-12 20:52:23,2013-09-12 20:52:23
e12746d756ef32124b163136fe49e753b35c7111...cb37994d76afb45efc3b606546349ed4e695c053,15,32,31,63,32,2013-09-12 21:04:29,2013-09-11 01:08:01
cb37994d76afb45efc3b606546349ed4e695c053...80538b04fd4ce8bd531d3d1fb60236a315c82d80,1,1,1,2,1,2013-09-13 15:29:48,2013-09-13 15:29:48
80538b04fd4ce8bd531d3d1fb60236a315c82d80...642e9a45579cfa90861b8ea71a95dd077775caaf,2,19,28,47,12,2013-09-17 09:24:27,2013-09-17 09:24:27
642e9a45579cfa90861b8ea71a95dd077775caaf...a25343001eea2436dcf8ea60deea3844f77e42e4,2,34,19,53,11,2013-09-17 12:10:52,2013-09-17 11:47:31
a25343001eea2436dcf8ea60deea3844f77e42e4...94ae7133449b2d0f5aab7e1a7f7190be65924145,1,31,23,54,8,2013-09-17 14:09:08,2013-09-17 13:53:55
94ae7133449b2d0f5aab7e1a7f7190be65924145...d79c036ad6cbf0da3593da98410f17bb6b272639,1,4,4,8,3,2013-09-19 13:06:19,2013-09-19 13:06:19
d79c036ad6cbf0da3593da98410f17bb6b272639...4671ef15c2d62962048fd4863911146fcc085f26,1,4,3,7,1,2013-09-19 13:55:14,2013-09-19 13:53:08
4671ef15c2d62962048fd4863911146fcc085f26...ec3ac9a247ec3132dea3c30ca36cefc217e25441,1,1,1,2,1,2013-09-19 14:24:22,2013-09-18 03:29:02
ec3ac9a247ec3132dea3c30ca36cefc217e25441...1185427c4c35ea57e3634ca735422e23d2e55751,1,1,1,2,1,2013-09-19 20:15:38,2013-09-19 20:15:38
1185427c4c35ea57e3634ca735422e23d2e55751...210cbcf520c16e8997b2748bca7c18f329081c84,1,1,1,2,1,2013-09-19 20:15:47,2013-09-19 20:15:47
210cbcf520c16e8997b2748bca7c18f329081c84...2aa2957d213c2801d9999a8902d041026fbb059a,1,1,1,2,1,2013-09-23 14:10:46,2013-09-22 08:19:28
2aa2957d213c2801d9999a8902d041026fbb059a...2d4c0d5f375bcf59a5a0cd19c4562bd57f03fb1d,1,1,1,2,1,2013-09-23 14:13:31,2013-09-20 10:00:24
2d4c0d5f375bcf59a5a0cd19c4562bd57f03fb1d...9dadd68e348e19a13ea5baebbc3183e26b2ed7c5,1,5,2,7,2,2013-09-23 16:01:09,2013-09-23 16:00:57
9dadd68e348e19a13ea5baebbc3183e26b2ed7c5...33c80f3dd4334c9b490c6e7dc69ffbda2c6a7fcf,1,21,21,42,9,2013-09-23 17:10:00,2013-09-23 16:50:31
33c80f3dd4334c9b490c6e7dc69ffbda2c6a7fcf...f519539d3b7a12b67adc3b2c63a19e3beca33a83,2,48,48,96,25,2013-09-28 16:35:08,2013-09-28 15:57:46
f519539d3b7a12b67adc3b2c63a19e3beca33a83...0a62e22579b67976a7d70002e493ee153d9496e8,1,21,22,43,8,2013-09-30 16:53:44,2013-09-30 16:23:21
0a62e22579b67976a7d70002e493ee153d9496e8...2c0b9027de841a437baf7b9c85262f196b9cb09e,1,6,3,9,2,2013-09-30 17:12:58,2013-09-30 17:12:58
2c0b9027de841a437baf7b9c85262f196b9cb09e...923bfc80dbba00659a2fbadafad6d894973cc560,2,7,14,21,7,2013-10-01 22:39:49,2013-10-01 22:39:49
923bfc80dbba00659a2fbadafad6d894973cc560...43757500674102ec14c103ea25f84857bdd88d7e,2,16,11,27,15,2013-10-04 15:47:42,2013-10-04 15:47:42
43757500674102ec14c103ea25f84857bdd88d7e...3bcd04f528597dac0a7084865461574ab4a06465,2,13,2,15,2,2013-10-06 21:43:54,2013-09-19 15:34:48
3bcd04f528597dac0a7084865461574ab4a06465...b561f5ab0a5e13f8203307016a02ee965a8be7d3,8,10,13,23,11,2013-10-06 23:16:18,2013-10-06 04:21:40
b561f5ab0a5e13f8203307016a02ee965a8be7d3...d1f247daf82e9b123690f8f51c7b3d1818bccbfe,1,2,2,4,2,2013-10-07 01:42:55,2013-10-02 12:58:15
d1f247daf82e9b123690f8f51c7b3d1818bccbfe...4d818ab12c53a24bb9dc989cff395ec2d090bd5c,2,25,1,26,2,2013-10-07 21:17:04,2013-10-05 18:28:54
4d818ab12c53a24bb9dc989cff395ec2d090bd5c...fea6904d4621df360f556ac73e9a87fdd6eeb7ea,2,4,14,18,4,2013-10-07 21:19:04,2013-10-07 21:18:11
fea6904d4621df360f556ac73e9a87fdd6eeb7ea...fc4ff9315d3102f9b216783061d00a2702555bd9,4,12,15,27,12,2013-10-07 22:24:02,2013-10-07 22:24:02
fc4ff9315d3102f9b216783061d00a2702555bd9...a9f1cb89df999805038ef2ff2c2fdceb3b78dd76,1,1,1,2,1,2013-10-10 20:24:41,2013-10-10 20:24:41
a9f1cb89df999805038ef2ff2c2fdceb3b78dd76...943dc6cf834a57b5bffe99314add0a4d397201ce,1,1,1,2,1,2013-10-11 15:07:59,2013-10-11 13:09:56
943dc6cf834a57b5bffe99314add0a4d397201ce...c93743b4faf7db5e2b95eee287adaece975541e3,1,1,1,2,1,2013-10-11 18:14:24,2013-10-11 18:14:03
c93743b4faf7db5e2b95eee287adaece975541e3...13d58a9bec67356ecae0d6902cb634e52cebcf19,3,18,9,27,11,2013-10-11 19:08:07,2013-10-11 19:08:07
13d58a9bec67356ecae0d6902cb634e52cebcf19...310b8f5b6e086de92531cc9c210c6eb9eb831dd8,3,47,25858,25905,3,2013-10-15 13:51:09,2013-10-15 13:51:09
310b8f5b6e086de92531cc9c210c6eb9eb831dd8...a5037cb9e3851b171b49f6d717fb40e59aa344c2,6,90,95,185,18,2013-10-15 14:40:48,2013-10-15 14:40:48
a5037cb9e3851b171b49f6d717fb40e59aa344c2...96286498d6aa1f65880d53c742f76c7f4fdcaa16,1,1,2,3,2,2013-10-15 14:44:50,2013-10-15 14:44:50
96286498d6aa1f65880d53c742f76c7f4fdcaa16...b24a3d5368ab1243ac43c773b318519da2f0ae7b,1,9,8,17,4,2013-10-15 16:03:55,2013-10-15 16:03:55
b24a3d5368ab1243ac43c773b318519da2f0ae7b...5ce4b06c285bd8cf52eaff0f39e0b9192a927873,2,21,1,22,3,2013-10-15 16:28:25,2013-10-06 16:53:26
5ce4b06c285bd8cf52eaff0f39e0b9192a927873...a339096d6a9d0313c2184de0d626e2c7e127955b,1,8,4,12,2,2013-10-15 16:28:32,2013-10-15 15:12:31
a339096d6a9d0313c2184de0d626e2c7e127955b...8df348e9eb3681ff5f09b1e52b72573e2eee3105,1,9,21,30,6,2013-10-15 19:48:53,2013-10-15 19:48:53
8df348e9eb3681ff5f09b1e52b72573e2eee3105...6095be1260c5c0e7dfe88380501188d4c50975eb,2,4,4,8,4,2013-10-15 20:14:35,2013-10-15 20:14:10
6095be1260c5c0e7dfe88380501188d4c50975eb...24e587929f62428e1959b10aace6dc4fd65ab397,2,9,0,9,2,2013-10-15 20:34:54,2013-09-29 16:06:32
24e587929f62428e1959b10aace6dc4fd65ab397...3ca883f863f8c4b3b1153e63ef40a8c2c523d399,1,10,3,13,2,2013-10-15 20:49:47,2013-09-24 14:23:58
3ca883f863f8c4b3b1153e63ef40a8c2c523d399...209f0a8a8ba08efed5f66ce6ccae051b16be1189,1,2,10,12,2,2013-10-15 21:59:58,2013-10-15 21:59:58
209f0a8a8ba08efed5f66ce6ccae051b16be1189...083edd60a6c189f17ff1087431e849dd11c111b2,2,46,13,59,9,2013-10-16 12:46:45,2013-10-11 08:09:54
083edd60a6c189f17ff1087431e849dd11c111b2...9b6f0745805941a6d7b7c16c02cf56ab00021c82,3,59,7,66,7,2013-10-23 02:03:20,2013-09-17 22:51:54
9b6f0745805941a6d7b7c16c02cf56ab00021c82...eca79fbf5b79d85d137a8eb207fcb1431af47d4e,3,7,59,66,7,2013-10-23 02:49:03,2013-10-23 02:49:03
eca79fbf5b79d85d137a8eb207fcb1431af47d4e...35b2b94979ed3419e50b72ab3b84307269fa25e8,1,43,0,43,1,2013-10-24 22:48:54,2013-10-24 17:45:42
35b2b94979ed3419e50b72ab3b84307269fa25e8...95d1192d5378926e750d0494818323ff17be821e,1,3,3,6,3,2013-10-25 19:26:44,2013-10-25 19:26:44
95d1192d5378926e750d0494818323ff17be821e...ced9d155f010bc456745a55a63ca959db9d405d3,2,3,13,16,6,2013-10-28 15:35:53,2013-10-28 15:35:53
ced9d155f010bc456745a55a63ca959db9d405d3...ebabb33411171ff5a6eb707e541b8d6646f35328,1,0,1,1,1,2013-10-28 17:33:33,2013-10-28 17:31:41
ebabb33411171ff5a6eb707e541b8d6646f35328...f9d41ac641dcb5a93ba8a9027476b160d8f41111,3,37,4,41,5,2013-10-28 21:53:31,2013-10-28 21:40:13
f9d41ac641dcb5a93ba8a9027476b160d8f41111...705216dc4664a85cdb44b460f8c2e0edcf27dd97,1,19,6,25,14,2013-10-28 21:53:39,2013-10-28 21:41:34
705216dc4664a85cdb44b460f8c2e0edcf27dd97...d5b7139abce9dd207773531d6dcb3493c6ac0c7c,1,1,1,2,1,2013-11-04 14:36:16,2013-11-04 14:36:16
d5b7139abce9dd207773531d6dcb3493c6ac0c7c...19c1b6109a73bc7d0d5bd84587b5c5a44d3e2a74,1,2,2,4,1,2013-11-04 17:51:57,2013-11-04 17:51:57
19c1b6109a73bc7d0d5bd84587b5c5a44d3e2a74...fb2e0a0c2864846af701203d3708da5dab3e6ba2,2,25,3,28,4,2013-11-05 22:13:49,2013-10-30 08:16:05
fb2e0a0c2864846af701203d3708da5dab3e6ba2...cc19a6bd3b6183887b52a965e77234f4dd9684ca,1,5,5,10,3,2013-11-05 22:16:38,2013-11-02 08:38:37
cc19a6bd3b6183887b52a965e77234f4dd9684ca...30eee925dbc9f8d465ccf064f48c24061ffdc378,2,7,2,9,2,2013-11-06 15:25:12,2013-11-05 20:03:28
30eee925dbc9f8d465ccf064f48c24061ffdc378...ff365d305fc22f40f4df9c4a6c7b1ca6c3c9800d,1,2,2,4,2,2013-11-06 15:37:06,2013-10-28 14:31:58
ff365d305fc22f40f4df9c4a6c7b1ca6c3c9800d...c66a5e70f2745048b30b7e7e8801d70ce9c640c7,4,52,5,57,7,2013-11-07 16:57:41,2013-09-18 13:41:07
c66a5e70f2745048b30b7e7e8801d70ce9c640c7...ee0d0e6e3f3773d15d3b9c3d654a05cbb914d7ab,5,27,22,49,5,2013-11-07 19:16:19,2013-10-30 12:20:38
ee0d0e6e3f3773d15d3b9c3d654a05cbb914d7ab...5ce0b342577076a4355ba1bb0ad0aef98261f236,3,45,11,56,11,2013-11-07 19:58:27,2013-09-12 20:51:59
5ce0b342577076a4355ba1bb0ad0aef98261f236...abfa210adfaee28e2496d7749d675d157d8e6c9d,2,2,8,10,3,2013-11-07 20:38:38,2013-10-25 18:02:04
abfa210adfaee28e2496d7749d675d157d8e6c9d...0bb4090c2c77746ae3976bcce52ea3f58a056604,1,6,1,7,1,2013-11-07 20:45:02,2013-10-25 18:12:46
0bb4090c2c77746ae3976bcce52ea3f58a056604...626cbde7f8267e2463cef85d84f9f0172f1c7cb9,5,9603,8,9611,5,2013-11-08 00:04:08,2013-11-07 21:51:46
626cbde7f8267e2463cef85d84f9f0172f1c7cb9...45be91e3981164e076a71de31f0b8a972a4bf104,1,75,72,147,3,2013-11-08 15:00:30,2013-11-07 21:32:12
45be91e3981164e076a71de31f0b8a972a4bf104...85d4c0133b5369b54bc9c4250989214bb2d45700,1,3,1,4,1,2013-11-08 15:03:51,2013-11-08 15:03:51
85d4c0133b5369b54bc9c4250989214bb2d45700...d0fadbba9f1dbe2ee009be6586fbdf3cda4eff98,3,11,76,87,11,2013-11-09 22:12:06,2013-11-09 22:12:06
d0fadbba9f1dbe2ee009be6586fbdf3cda4eff98...650f325d8e5e9092cd8ca7c1a7ab62c4bba582cf,1,8,5,13,2,2013-11-10 20:05:43,2013-09-07 00:46:55
650f325d8e5e9092cd8ca7c1a7ab62c4bba582cf...562145e887cc42ce8c9c9cd2c6e946ff01e6731d,1,3,5,8,2,2013-11-10 22:24:26,2013-11-09 22:55:32
562145e887cc42ce8c9c9cd2c6e946ff01e6731d...7d5a12376d18e0ec70241e653721ce9977123d34,1,1,1,2,1,2013-11-10 22:47:04,2013-11-10 22:47:04
7d5a12376d18e0ec70241e653721ce9977123d34...2ace149f485438e8a3af6650f3bb18c1c22e48b6,1,3,5,8,5,2013-11-10 23:42:37,2013-11-10 23:42:37
2ace149f485438e8a3af6650f3bb18c1c22e48b6...4b39a8289031bb7de25e9f018d9fd8235a35ec49,10,58,133,191,34,2013-11-10 23:43:27,2013-09-07 00:46:55
4b39a8289031bb7de25e9f018d9fd8235a35ec49...07c374745790bf9e05ca58ffe97f0b72ae930e66,1,1,9,10,1,2013-11-11 17:20:33,2013-11-11 00:53:23
07c374745790bf9e05ca58ffe97f0b72ae930e66...e8e53a6bb579938e0280724b7e84260589918cf2,0,0,0,0,0,2013-11-12 05:08:51,2013-11-12 05:08:51
e8e53a6bb579938e0280724b7e84260589918cf2...71b2ac524e49c0d1cc4e5d7bd8fd9d5a1317a20b,3,76,8,84,7,2013-11-12 05:13:08,2013-11-05 04:36:15
71b2ac524e49c0d1cc4e5d7bd8fd9d5a1317a20b...b7f62abb87dd200129fb2a781d008fc19d26115a,1,0,13,13,1,2013-11-12 18:31:35,2013-11-12 18:31:35
b7f62abb87dd200129fb2a781d008fc19d26115a...1cecf64e5aa415367a7dae0b55c2dd17b591442d,3,68,7,75,6,2013-11-13 02:15:08,2013-09-17 22:51:54
1cecf64e5aa415367a7dae0b55c2dd17b591442d...dce2edb3a615f9de158607c9f8be83809373940e,1,2,2,4,1,2013-11-14 01:53:04,2013-11-14 01:53:04
dce2edb3a615f9de158607c9f8be83809373940e...0d68b7877f761264bfe4950e4df156b854925a6b,2,3,1,4,2,2013-11-14 03:53:15,2013-08-24 17:02:17
0d68b7877f761264bfe4950e4df156b854925a6b...203569562414304aabec22fd20b0cb17ad34c7ad,1,158,50,208,21,2013-11-14 04:51:09,2013-11-14 02:25:37
203569562414304aabec22fd20b0cb17ad34c7ad...1a13e0b1adcc7e5f4affa2e64f0533cb76a802b5,1,1,1,2,1,2013-11-14 15:10:13,2013-11-14 03:05:37
1a13e0b1adcc7e5f4affa2e64f0533cb76a802b5...ac7ff97f8b9cc2cf29e1ed14d931dbb5b690e3af,12,59,44,103,28,2013-11-14 15:17:18,2013-11-14 15:17:18
ac7ff97f8b9cc2cf29e1ed14d931dbb5b690e3af...7f0b28e3083ab8e755801823166e1b008d128242,1,1,1,2,1,2013-11-14 15:21:46,2013-11-14 15:21:46
7f0b28e3083ab8e755801823166e1b008d128242...c389c2e6ba698e95c683ad113d728e757a4da29a,1,1,1,2,1,2013-11-14 19:36:04,2013-11-14 19:36:04
c389c2e6ba698e95c683ad113d728e757a4da29a...d0782ed7e81a181f0541e1ce7c8cba0825a80299,1,2,7,9,3,2013-11-14 19:46:47,2013-10-15 13:09:55
d0782ed7e81a181f0541e1ce7c8cba0825a80299...498e0e6c9bf486a0b1f16b455d65fcbc6c43867e,2,10,1,11,2,2013-11-14 20:27:37,2013-11-14 02:31:07
498e0e6c9bf486a0b1f16b455d65fcbc6c43867e...c2aca17d457d302cb1683f925b9e5ee93f0984ea,2,15,2,17,3,2013-11-14 21:33:12,2013-11-14 21:33:12
c2aca17d457d302cb1683f925b9e5ee93f0984ea...9aacb89f363dcaacfffcfe794ecf54b2c49e5b19,1,6,5,11,7,2013-11-15 14:32:46,2013-11-15 14:19:44
9aacb89f363dcaacfffcfe794ecf54b2c49e5b19...21c218eabb933095d933c9fe3fa29dcd0aef35fe,1,1,0,1,1,2013-11-15 14:50:31,2013-11-15 14:50:31
21c218eabb933095d933c9fe3fa29dcd0aef35fe...1f7661f519193b2e57fb74bebac224068d08d667,2,2,2,4,2,2013-11-15 14:54:53,2013-11-15 14:54:53
1f7661f519193b2e57fb74bebac224068d08d667...6f74abb7bfd08f88c9f89e6840ec52cb4c38e133,2,2,2,4,2,2013-11-15 14:55:16,2013-11-15 14:55:16
6f74abb7bfd08f88c9f89e6840ec52cb4c38e133...b04b3861802606a114c936e753c0f20da6e8b236,2,14,20,34,3,2013-11-15 15:32:13,2013-11-15 15:23:23
b04b3861802606a114c936e753c0f20da6e8b236...14c19cf1a8dc3845f3f6b82f27be75334b2591e3,1,15,3,18,2,2013-11-15 15:48:49,2013-11-15 15:48:49
14c19cf1a8dc3845f3f6b82f27be75334b2591e3...8d09ee0506794e8a2b7cfae4bb804e4ca59348e1,2,21,6,27,7,2013-11-15 17:19:05,2013-11-11 02:28:36
8d09ee0506794e8a2b7cfae4bb804e4ca59348e1...6fde9752599f035da5e328b54a1e23e075e4ad45,1,1,0,1,1,2013-11-15 22:07:12,2013-11-15 22:07:12
6fde9752599f035da5e328b54a1e23e075e4ad45...8f7db68cbf1cdc3677d89dc1191bc50c8d47a82f,1,14,10,24,2,2013-11-15 22:18:22,2013-11-15 22:18:22
8f7db68cbf1cdc3677d89dc1191bc50c8d47a82f...dc649a33e081c7beb083b04956731aa410eb6b3f,1,5,5,10,4,2013-11-17 00:06:44,2013-11-17 00:06:44
dc649a33e081c7beb083b04956731aa410eb6b3f...b407bddea2ae65200df0802bef7cf06c16b5e524,4,211,291,502,207,2013-11-24 20:22:09,2013-04-25 13:11:53
b407bddea2ae65200df0802bef7cf06c16b5e524...ed291938c287d34fe1183e588e12372e540eb5e7,1,6,3,9,4,2013-11-26 15:13:15,2013-11-25 18:48:10
ed291938c287d34fe1183e588e12372e540eb5e7...d2aa969206aa1b7738b911cdaf29038f249b5066,1,5,2,7,2,2013-11-26 19:04:55,2013-11-26 18:45:39
d2aa969206aa1b7738b911cdaf29038f249b5066...ed20e7c645064822f4070a0c60195e4bcdaba683,1,1,1,2,1,2013-11-27 19:51:29,2013-11-27 19:51:29
ed20e7c645064822f4070a0c60195e4bcdaba683...f9ad13c9ec8967916427642db2883a1bf3bccd86,26,18307,54,18361,36,2013-12-06 21:04:35,2013-12-06 20:55:55
f9ad13c9ec8967916427642db2883a1bf3bccd86...b278d8174f307fd351ae9ce6409c1806e7426e34,2,1,10,11,2,2013-12-16 03:02:51,2013-12-16 03:02:51
b278d8174f307fd351ae9ce6409c1806e7426e34...b8d0d54a3c4960794a1b492957abeb56eddd1e48,4,17,16,33,13,2013-12-16 17:48:46,2013-11-06 05:23:04
b8d0d54a3c4960794a1b492957abeb56eddd1e48...846771081c038f523612087d76deb3c853e252fd,1,1,1,2,1,2013-12-17 14:18:54,2013-12-17 14:18:54
846771081c038f523612087d76deb3c853e252fd...fd0bce07584b73fb755574c4d462e0b175d1c6b6,1,11,4,15,1,2013-12-18 14:10:42,2013-12-18 14:10:42
fd0bce07584b73fb755574c4d462e0b175d1c6b6...2d7315051193212fca6e7d64a3de87d96977c418,2,11,9,20,4,2013-12-18 14:16:21,2013-11-15 14:55:59
2d7315051193212fca6e7d64a3de87d96977c418...7deee6af72bfcf328fa09a28a1e68159cc58513f,2,7,16,23,4,2013-12-18 14:24:29,2013-12-18 14:23:27
7deee6af72bfcf328fa09a28a1e68159cc58513f...84190105c0f2acb39f33810678c36e4536bd1692,1,1,1,2,1,2013-12-19 01:44:32,2013-12-19 01:44:32
84190105c0f2acb39f33810678c36e4536bd1692...bb3fff9ac2c7c8b07809219305d7f86d282fd84f,1,1,1,2,1,2013-12-19 01:50:53,2013-12-19 01:50:53
bb3fff9ac2c7c8b07809219305d7f86d282fd84f...09ede3d33b1a43c399bc9549c634af634513a81d,1,17,15,32,2,2013-12-19 04:34:49,2013-12-19 04:32:40
09ede3d33b1a43c399bc9549c634af634513a81d...a6f474e699f95a90f95228bd525490151acc0451,5,40,23,63,7,2013-12-19 20:00:06,2013-12-19 20:00:06
a6f474e699f95a90f95228bd525490151acc0451...7e8a91c205723f11cd00c8834f348a649ab15926,2,28,5,33,8,2013-12-19 20:31:36,2013-12-19 20:31:36
7e8a91c205723f11cd00c8834f348a649ab15926...29c8003347e8768e26077c6d040203d662009220,5,22,16,38,12,2013-12-20 21:46:30,2013-12-20 21:46:30
29c8003347e8768e26077c6d040203d662009220...ed0f0e42dfd533f920305d58454d2f0a72c1be28,1,51,16,67,28,2013-12-20 22:25:03,2013-12-20 17:29:28
ed0f0e42dfd533f920305d58454d2f0a72c1be28...bae117445b915d0a2a5c5a78ad9e3c8cd014dc9e,2,2,2,4,2,2013-12-20 22:25:03,2013-12-20 17:30:23
bae117445b915d0a2a5c5a78ad9e3c8cd014dc9e...f3062f96e04cd0ecfdbdcccfcd2733b06beca131,2,143,380,523,27,2013-12-20 22:25:03,2013-12-20 22:13:48
f3062f96e04cd0ecfdbdcccfcd2733b06beca131...74a48958bd1f4b00a8a12bb0052f10fd13e85a1a,1,1,1,2,1,2013-12-20 22:37:38,2013-12-20 22:37:38
74a48958bd1f4b00a8a12bb0052f10fd13e85a1a...281808f61d2ea5e47a1be2b9d1a4577194aa1a86,1,1,1,2,1,2013-12-20 23:38:57,2013-12-20 23:38:57
281808f61d2ea5e47a1be2b9d1a4577194aa1a86...e0fad093b63d2d197a9c59ccce8896d75a83c95e,2,8,5,13,4,2013-12-20 23:39:16,2013-12-20 23:39:16
e0fad093b63d2d197a9c59ccce8896d75a83c95e...23db99440497fccbe9db8853a530d3d30d9320e4,1,1,1,2,1,2013-12-21 17:07:40,2013-12-21 17:07:40
23db99440497fccbe9db8853a530d3d30d9320e4...537e9ced6164074c32df429bb1fa4c30361aa711,8,545,225,770,186,2013-12-23 22:21:22,2013-12-11 16:34:05
537e9ced6164074c32df429bb1fa4c30361aa711...b39ee05b69336d5a6230287ab8bd48c48e5b206f,2,116,33,149,13,2013-12-30 17:34:08,2013-12-14 01:10:46
b39ee05b69336d5a6230287ab8bd48c48e5b206f...e1a4329d78a5bae18d19fb94c1c3714ad45258ef,1,6,6,12,4,2013-12-31 19:38:34,2013-12-31 19:38:34
e1a4329d78a5bae18d19fb94c1c3714ad45258ef...7d758aca355522f814aaa91e8199942b1f0d2e6c,1,1,1,2,1,2013-12-31 22:39:58,2013-12-31 22:39:58
7d758aca355522f814aaa91e8199942b1f0d2e6c...4d19306c7fe3e36dc5deba65b64a339baf2750e5,1,7,0,7,1,2014-01-06 19:49:58,2014-01-06 19:49:58
4d19306c7fe3e36dc5deba65b64a339baf2750e5...5801c3a29a3c9a0d43f36c1d844f7cc7c24b3376,1,3,7,10,3,2014-01-06 20:14:17,2014-01-06 20:04:20
5801c3a29a3c9a0d43f36c1d844f7cc7c24b3376...085814474e4a854d533b5ccbaef24c090081e0c4,2,19,1,20,3,2014-01-07 21:01:34,2013-12-24 20:59:37
085814474e4a854d533b5ccbaef24c090081e0c4...3118f58c465286d538404669d09026b882b2149e,3,3,3,6,3,2014-01-10 01:51:21,2014-01-10 01:51:21
3118f58c465286d538404669d09026b882b2149e...6de1d973a436282af7dfe3072924016c3cdc1984,1,2,2,4,1,2014-01-10 02:27:28,2014-01-08 13:44:10
6de1d973a436282af7dfe3072924016c3cdc1984...6bff3bf7d72383c1458004d4aae454b61caa400f,1,0,7,7,1,2014-01-10 03:36:07,2014-01-10 03:36:07
6bff3bf7d72383c1458004d4aae454b61caa400f...20ea8071b44c23e7915300eacc9ed958fbe4eaf5,1,1,0,1,1,2014-01-10 14:25:11,2014-01-10 12:45:01
20ea8071b44c23e7915300eacc9ed958fbe4eaf5...478cf3783b5d3fa142c532871b434a8210cee9ad,2,2,0,2,2,2014-01-10 22:29:03,2014-01-10 22:29:03
478cf3783b5d3fa142c532871b434a8210cee9ad...9ac88dea494b0b79d1e1d1d26f8d9f5eb670cf62,1,1,1,2,1,2014-01-13 14:37:10,2014-01-13 14:37:10
9ac88dea494b0b79d1e1d1d26f8d9f5eb670cf62...710d236ad1cf5824ec10a2278a425f78fac7e0de,6,30,24,54,15,2014-01-13 21:37:42,2014-01-13 21:37:42
710d236ad1cf5824ec10a2278a425f78fac7e0de...38c122a73a843a0d117d4f962cc94fda6f553086,1,0,12,12,4,2014-01-14 18:01:39,2014-01-14 17:48:42
38c122a73a843a0d117d4f962cc94fda6f553086...fdd78fad19ea3390cd96971cd29430e36378d137,2,9,8,17,2,2014-01-16 00:47:44,2014-01-12 19:44:07
fdd78fad19ea3390cd96971cd29430e36378d137...659ac9c155a9ecee03e635dde1661be7081322f3,1,7,2,9,3,2014-01-16 02:58:54,2014-01-16 02:58:54
659ac9c155a9ecee03e635dde1661be7081322f3...a2250b0f4c157745b8cd8ac1247c6084882c500f,1,4,4,8,2,2014-01-16 03:04:14,2014-01-16 03:04:14
a2250b0f4c157745b8cd8ac1247c6084882c500f...391c21b15d769fac1c37631b28c0226f57a59796,2,7,6,13,6,2014-01-17 05:38:56,2014-01-17 05:38:56
391c21b15d769fac1c37631b28c0226f57a59796...c11becbb692f7707443eb2582543dfe96e8319e6,1,17,3,20,2,2014-01-21 11:02:09,2014-01-21 11:02:09
c11becbb692f7707443eb2582543dfe96e8319e6...37d036a84cfcd39e3ca7723540c6a6791d58fc69,1,32,0,32,2,2014-01-22 20:35:09,2014-01-22 20:35:09
37d036a84cfcd39e3ca7723540c6a6791d58fc69...3f3f458974fe0bdccfe9042c9503fd2d03e2f6ff,1,3,3,6,3,2014-01-22 20:49:10,2014-01-22 20:49:10
3f3f458974fe0bdccfe9042c9503fd2d03e2f6ff...a20494228d51c57c454ff9f10a4ba8bbdda0e49c,2,6,9,15,3,2014-01-23 18:04:40,2014-01-22 22:50:36
a20494228d51c57c454ff9f10a4ba8bbdda0e49c...de7702ac59889177b0dd622d3b5503004abf0258,1,10,9,19,6,2014-01-23 21:00:54,2014-01-23 20:45:23
de7702ac59889177b0dd622d3b5503004abf0258...4655c3de5f0348da25452ea64d80613bf919284e,2,2,5,7,5,2014-01-23 21:12:48,2014-01-23 21:12:48
4655c3de5f0348da25452ea64d80613bf919284e...d63243d085c797e53a965620c439277284eada59,1,8,8,16,5,2014-01-26 03:01:57,2014-01-26 03:01:57
d63243d085c797e53a965620c439277284eada59...d41fc68d9b89d39f8c71ae9f810b72798ff3e9ac,1,0,7,7,1,2014-01-26 03:02:20,2014-01-26 03:02:20
d41fc68d9b89d39f8c71ae9f810b72798ff3e9ac...988d99ad278c2c9dc16c68f86bddc4df99dcd928,1,4,1,5,1,2014-01-26 03:07:27,2014-01-23 04:43:58
988d99ad278c2c9dc16c68f86bddc4df99dcd928...b2eb7ec0f0ee6f8a67680f024e778b960b05e722,1,16,0,16,1,2014-01-27 20:17:53,2014-01-27 19:16:06
b2eb7ec0f0ee6f8a67680f024e778b960b05e722...53e31f478e1d88d056aa52f6575d200fe3dcf047,1,1,1,2,1,2014-01-27 21:01:15,2014-01-27 21:01:15
53e31f478e1d88d056aa52f6575d200fe3dcf047...01c360f96390ff16edfe65ef3b34e167087ef645,2,39,4,43,2,2014-01-29 13:18:58,2014-01-25 07:20:18
01c360f96390ff16edfe65ef3b34e167087ef645...3dccf62c81b5fbecc3a0431a8927ed1d30806fc6,1,2,10,12,1,2014-02-02 20:40:39,2014-02-02 20:36:14
3dccf62c81b5fbecc3a0431a8927ed1d30806fc6...cd4e25e991898bf07ce82fe4ab3d60c32b4a5fc9,3,150,102,252,52,2014-02-02 21:17:23,2014-02-02 21:17:23
cd4e25e991898bf07ce82fe4ab3d60c32b4a5fc9...cab18353a62d39699310bf8c982e897c391411a1,1,1,1,2,1,2014-02-05 06:46:00,2014-02-05 06:23:49
cab18353a62d39699310bf8c982e897c391411a1...a74ad04bc9c4c7203303b2547e94f1cc53c2a460,5,94,64,158,28,2014-02-05 14:10:22,2014-02-05 14:10:22
a74ad04bc9c4c7203303b2547e94f1cc53c2a460...95b21c6ec2790d0d051cdfe95d73148d7c385d68,7,1406,1337,2743,290,2014-02-05 14:35:48,2014-02-02 21:44:13
95b21c6ec2790d0d051cdfe95d73148d7c385d68...0fcb0f6826c682c038508caf6d3fb1021d58266f,1,1,1,2,1,2014-02-05 14:54:23,2014-02-05 14:54:23
0fcb0f6826c682c038508caf6d3fb1021d58266f...79f59c2144c1ce293454dca21d01819bdd9f52d9,3,4,4,8,4,2014-02-05 14:57:11,2014-02-05 14:57:11
79f59c2144c1ce293454dca21d01819bdd9f52d9...d792e40fbc2b46346bc518483ac31772c55ebb12,2,28,28,56,28,2014-02-11 18:59:14,2014-02-11 18:59:14
d792e40fbc2b46346bc518483ac31772c55ebb12...eda283d0e4d59074ae98af0fdc2951e6c109d5fd,1,19,3,22,2,2014-02-13 22:48:58,2014-02-13 22:48:58
eda283d0e4d59074ae98af0fdc2951e6c109d5fd...de75b3cc626829c3478a8a6d59dddc948d348b41,1,6,1,7,1,2014-02-13 23:58:13,2014-02-13 23:57:27
de75b3cc626829c3478a8a6d59dddc948d348b41...6d2ab64df7bdda087e79deaa53db969fa6f2cd92,1,4,3,7,2,2014-02-14 00:00:30,2014-02-14 00:00:30
6d2ab64df7bdda087e79deaa53db969fa6f2cd92...70ac4485f30633074696fa28ca29b0325459f228,1,6,1,7,1,2014-02-14 00:12:06,2014-02-14 00:12:06
70ac4485f30633074696fa28ca29b0325459f228...a7ea12a9a7c696a14455bfe4bfebf984dd329832,1,4,0,4,1,2014-02-14 14:22:44,2014-02-14 14:22:44
a7ea12a9a7c696a14455bfe4bfebf984dd329832...954966e08d26bf29700711dc4d7b56198350e862,1,19,15,34,7,2014-02-14 15:05:47,2014-02-14 15:05:47
954966e08d26bf29700711dc4d7b56198350e862...027d470b574e15c94cda28f5e2c7a0ed54c11fa6,1,3,3,6,3,2014-02-19 22:25:00,2014-02-19 22:25:00
027d470b574e15c94cda28f5e2c7a0ed54c11fa6...a35996141e3c1de92e89ed77eac1799124e747d3,1,1,2,3,1,2014-02-19 22:57:34,2014-02-19 22:57:34
a35996141e3c1de92e89ed77eac1799124e747d3...279913c71b63da721fa2f118cdce150effbf773e,2,6,19,25,4,2014-03-04 22:08:35,2014-03-04 22:08:35
279913c71b63da721fa2f118cdce150effbf773e...10efa1f5b44046aab6bcc8423322a41923faa290,2,4,2,6,3,2014-03-05 01:40:23,2014-03-04 03:18:50
10efa1f5b44046aab6bcc8423322a41923faa290...3a68c114e3a30af86dc261c9d62ce2ae4144d420,3,10,1,11,3,2014-03-05 01:43:14,2014-03-04 02:37:56
3a68c114e3a30af86dc261c9d62ce2ae4144d420...06adf7c95d93507908181995a9ea15fe2729595a,3,24,1,25,3,2014-03-05 01:49:57,2014-03-04 03:43:51
06adf7c95d93507908181995a9ea15fe2729595a...f4b37d89820535d6c7503925aa8872645681a865,2,4,3,7,3,2014-03-05 01:58:31,2014-03-04 01:55:30
f4b37d89820535d6c7503925aa8872645681a865...2df1aad6a1c9376c2a477eba26ee992113ed1c23,3,34,2,36,3,2014-03-05 02:00:04,2014-03-04 03:04:23
2df1aad6a1c9376c2a477eba26ee992113ed1c23...984f77a930aa322bcc277762303370d7a2a4667a,1,12,6,18,2,2014-03-07 14:55:26,2014-03-07 14:55:26
984f77a930aa322bcc277762303370d7a2a4667a...a96d5bed58f2b30f97d6dd2f5691cd890f62b75f,1,3,4,7,2,2014-03-09 22:31:59,2014-03-09 22:31:59
a96d5bed58f2b30f97d6dd2f5691cd890f62b75f...b19d4d3450c385b7074035b17f3ba8d0b86cf0b0,2,7,27,34,4,2014-03-10 13:57:40,2014-03-10 13:56:42
b19d4d3450c385b7074035b17f3ba8d0b86cf0b0...2c180ef938201f1213b5c43c8212856d0282e1f0,2,20,10,30,7,2014-03-10 18:14:44,2014-03-09 23:59:14
2c180ef938201f1213b5c43c8212856d0282e1f0...0c12cb3910c446960a274fb0eab11b8830bed71f,1,9,6,15,2,2014-03-10 18:53:50,2014-03-10 18:53:50
0c12cb3910c446960a274fb0eab11b8830bed71f...14872941f9de78e7436e58ac1f03a4b2d5aa34e8,1,6,2,8,3,2014-03-10 19:37:11,2014-03-10 19:37:11
14872941f9de78e7436e58ac1f03a4b2d5aa34e8...a81dbc4ed82bc38b1ac5f6a8242e044232ea1594,1,3,7,10,4,2014-03-11 20:12:39,2014-03-11 20:12:39
a81dbc4ed82bc38b1ac5f6a8242e044232ea1594...22c515c6717efe46685b43215208aa4e5648fbc8,1,4,5,9,2,2014-03-12 10:08:16,2014-03-12 10:08:16
22c515c6717efe46685b43215208aa4e5648fbc8...26ce21786252981563e49e91a85b3e0bfa16c3e3,1,1,1,2,1,2014-03-13 00:46:18,2014-03-13 00:46:18
26ce21786252981563e49e91a85b3e0bfa16c3e3...6a89db86ed817f6a7498076e2a06b90f9fce0831,2,20,2,22,5,2014-03-13 01:11:26,2014-03-06 03:46:23
6a89db86ed817f6a7498076e2a06b90f9fce0831...854d242db457e3191e3ca1f2a366f6c981a12fbc,2,2,2,4,2,2014-03-13 02:26:42,2014-03-13 02:26:27
854d242db457e3191e3ca1f2a366f6c981a12fbc...2585ee58809c22a3c97f87b1b4aa68dbd41f386c,2,7,0,7,2,2014-03-13 03:22:31,2014-01-09 21:27:18
2585ee58809c22a3c97f87b1b4aa68dbd41f386c...594687abdcd8427df1face9466ebff7f04b36fc6,1,1,1,2,1,2014-03-14 02:36:39,2014-01-22 03:47:54
594687abdcd8427df1face9466ebff7f04b36fc6...c29e9c4db18738f7bfeb6b4a8019121a9079beb6,3,4,0,4,3,2014-03-14 03:12:40,2014-03-10 18:30:22
c29e9c4db18738f7bfeb6b4a8019121a9079beb6...aa951a3184fc02551bfcb8381cdac28298432419,1,11,7,18,3,2014-03-16 03:14:03,2014-03-16 03:09:12
aa951a3184fc02551bfcb8381cdac28298432419...44247b1cf2f4e76e8153f8cbac69dcfd5b2eacd4,1,6,6,12,6,2014-03-16 14:19:51,2014-03-13 18:16:52
44247b1cf2f4e76e8153f8cbac69dcfd5b2eacd4...e06f428f6ed99e0fafb2e21c456eafc570e3e5ba,1,4,2,6,2,2014-03-16 14:49:57,2014-01-30 15:07:06
e06f428f6ed99e0fafb2e21c456eafc570e3e5ba...472f70a9df75c289393d6618c36257a04f9cb902,1,14,0,14,1,2014-03-16 14:54:12,2014-03-16 14:46:57
472f70a9df75c289393d6618c36257a04f9cb902...551578eb3676f67cccd8a91a582c2225bc970cac,1,9,4,13,1,2014-03-17 17:13:00,2014-03-17 17:13:00
551578eb3676f67cccd8a91a582c2225bc970cac...c1e9bb9e61a79a1d0c4300cc31eac7ff61107085,1,4,4,8,1,2014-03-18 10:55:06,2014-03-18 10:55:06
c1e9bb9e61a79a1d0c4300cc31eac7ff61107085...b5074944b0b27f50ffe2ca9f96348b8d0cd5c82c,1,1,1,2,1,2014-03-18 15:50:04,2014-03-18 15:50:04
b5074944b0b27f50ffe2ca9f96348b8d0cd5c82c...14e0a632a04e114dbf6cc044e74c3260c7f28a7f,1,19,8,27,2,2014-03-18 19:55:50,2014-03-18 19:55:50
14e0a632a04e114dbf6cc044e74c3260c7f28a7f...55c196e8377221f1b417eda5cda74a56c5cae96a,1,4,7,11,2,2014-03-18 19:59:33,2014-03-18 19:59:33
55c196e8377221f1b417eda5cda74a56c5cae96a...a10aa3aac5223c250327d00c500ceb9c7a18b7f9,1,1,1,2,1,2014-03-19 01:29:04,2014-03-19 01:29:04
a10aa3aac5223c250327d00c500ceb9c7a18b7f9...3ffd95bdb13ade8a40a7dd975e6aca401b7a3d11,1,8,8,16,5,2014-03-20 16:33:06,2014-02-21 11:53:00
3ffd95bdb13ade8a40a7dd975e6aca401b7a3d11...d3c1ce9c243e04f80e2093e20ffe16bbade93985,1,1,0,1,1,2014-03-20 16:33:07,2014-02-21 11:53:36
d3c1ce9c243e04f80e2093e20ffe16bbade93985...9ad6e7e93e62a27e6ef803fbf46623bca732750f,11,0,7159,7159,11,2014-03-20 16:38:00,2014-03-20 13:00:22
9ad6e7e93e62a27e6ef803fbf46623bca732750f...ca0086b55a158d8a4347f94254878d6dc5dd90ed,2,4,2,6,3,2014-03-20 16:50:52,2014-03-18 09:15:58
ca0086b55a158d8a4347f94254878d6dc5dd90ed...e547a2775fc79e4b2eb807da9d30719afc570458,2,5,3,8,4,2014-03-20 18:42:44,2014-01-28 17:19:25
e547a2775fc79e4b2eb807da9d30719afc570458...541e7349b6533eb533c15d17e3e9e432e4a719ea,3,24,0,24,3,2014-03-20 19:47:35,2014-03-06 19:56:09
541e7349b6533eb533c15d17e3e9e432e4a719ea...85af4e6412e49c2e6a872feef00718a46c2fa2ce,1,9,2,11,2,2014-03-20 20:54:37,2014-03-11 07:44:34
85af4e6412e49c2e6a872feef00718a46c2fa2ce...5a8f76933288396b915800a18240aa17d3414201,2,13,6,19,3,2014-03-21 02:37:05,2014-02-05 05:54:15
5a8f76933288396b915800a18240aa17d3414201...890d441aa5d319e49951ba6f0ec719cd4cb96759,2,23,5,28,4,2014-03-21 02:54:38,2014-03-20 07:39:36
890d441aa5d319e49951ba6f0ec719cd4cb96759...ad032d3c7df04827989a4187117614c29bf3a4ad,1,2,2,4,2,2014-03-21 03:16:30,2014-03-18 21:38:08
ad032d3c7df04827989a4187117614c29bf3a4ad...2c2c93c7cbfafdb06a27dafee88fc67b265c8e32,2,3,1,4,2,2014-03-21 03:32:40,2014-02-21 18:43:51
2c2c93c7cbfafdb06a27dafee88fc67b265c8e32...5265cdac3d84b7bb4f8013ef10adaa5a9968fb1c,2,6,9,15,5,2014-03-21 16:33:10,2014-03-18 15:48:21
5265cdac3d84b7bb4f8013ef10adaa5a9968fb1c...4f490e55adaf4c2b141f41c846e04a36eb0626ef,1,43,11,54,6,2014-03-31 21:05:49,2014-03-31 21:05:49
4f490e55adaf4c2b141f41c846e04a36eb0626ef...99d735ab4662f45c3b65ea1200fa0d3e2b671111,1,5,2,7,1,2014-04-04 13:14:42,2014-04-04 09:38:15
99d735ab4662f45c3b65ea1200fa0d3e2b671111...7869891a97eae93699cc239274e73e53daedf781,1,10,5,15,3,2014-04-15 09:34:02,2014-04-15 09:34:02
7869891a97eae93699cc239274e73e53daedf781...a0568b07d8dcd94c3b8a27c0cf5747235c6bf93c,1,1,1,2,1,2014-04-15 09:47:52,2014-04-15 09:47:52
a0568b07d8dcd94c3b8a27c0cf5747235c6bf93c...b26628a2bb20abae0e0515394efdd621452267b1,1,1,1,2,1,2014-04-15 13:45:58,2014-01-27 19:26:27
b26628a2bb20abae0e0515394efdd621452267b1...e0b606d2bdd6cddeace765a50f727a33201e621d,1,1,15,16,2,2014-04-15 13:45:58,2014-01-27 19:27:32
e0b606d2bdd6cddeace765a50f727a33201e621d...7149726485ff41afcfd2d12cb3041fe268cc909d,1,1,11,12,2,2014-04-15 13:45:58,2014-01-27 19:32:46
7149726485ff41afcfd2d12cb3041fe268cc909d...a7c9facc357b4d2d98844cda4c26bb2e560c0cc8,1,9,10,19,6,2014-04-15 13:45:58,2014-01-27 19:43:27
a7c9facc357b4d2d98844cda4c26bb2e560c0cc8...92cff8b1a38fc45f1a6f6ddb92d089b739e7f5f5,2,27,174,201,16,2014-04-15 13:45:58,2014-02-18 15:49:24
92cff8b1a38fc45f1a6f6ddb92d089b739e7f5f5...8e5d1caf7ad8f02d727bdd5ef9dfed9ff463c8ea,2,36,59,95,28,2014-04-15 13:45:58,2014-02-18 16:13:48
8e5d1caf7ad8f02d727bdd5ef9dfed9ff463c8ea...3dee2983ab211bc9b1bdbf372b0ac002f7debb03,3,3,2,5,3,2014-04-15 13:45:59,2014-02-18 16:32:17
3dee2983ab211bc9b1bdbf372b0ac002f7debb03...9d79b99874a5f52f0b83ca11dd45a7302adebdae,1,2,2,4,3,2014-04-15 13:45:59,2014-02-18 16:34:49
9d79b99874a5f52f0b83ca11dd45a7302adebdae...ebbbe965b8408e145ebe4b3ffd183b169c29b75b,1,3,2,5,2,2014-04-15 13:45:59,2014-02-18 17:46:00
ebbbe965b8408e145ebe4b3ffd183b169c29b75b...cd546aba748aeac09886921ebc1a5fcaa3778bf8,1,2,2,4,2,2014-04-15 13:45:59,2014-02-18 17:50:42
cd546aba748aeac09886921ebc1a5fcaa3778bf8...9475e31d32544c275ee79155b223322f132f3f1a,1,2,0,2,1,2014-04-15 13:45:59,2014-02-18 17:52:48
9475e31d32544c275ee79155b223322f132f3f1a...81aa237ee11c731ee92ad6cf7cf958e80f15d057,1,93,0,93,3,2014-04-15 13:45:59,2014-02-24 18:05:16
81aa237ee11c731ee92ad6cf7cf958e80f15d057...c63d1da7cd106d9d12b93154c0423b244e491c3b,1,26,0,26,1,2014-04-15 13:45:59,2014-02-26 23:01:07
c63d1da7cd106d9d12b93154c0423b244e491c3b...3115d4c92d024ed42c286dc013258ecf684fd6b4,1,79,0,79,1,2014-04-15 13:45:59,2014-02-26 23:01:48
3115d4c92d024ed42c286dc013258ecf684fd6b4...d7af36676b89a15ad0571cbf0d2a7d8b93470e58,1,12,0,12,1,2014-04-15 13:45:59,2014-02-26 23:13:26
d7af36676b89a15ad0571cbf0d2a7d8b93470e58...8084ab24bc269af22e0cfd4af77a7a17eb39729a,1,89,3,92,4,2014-04-15 13:45:59,2014-02-26 23:23:10
8084ab24bc269af22e0cfd4af77a7a17eb39729a...80ea65edf7466afc11823a914b175bd835d5b228,1,41,0,41,1,2014-04-15 13:45:59,2014-02-26 23:32:02
80ea65edf7466afc11823a914b175bd835d5b228...4f14bea2c29fb9c1e1cf48da7f700c963e35f693,1,2,2,4,2,2014-04-15 13:46:00,2014-02-26 23:33:15
4f14bea2c29fb9c1e1cf48da7f700c963e35f693...1dedd3185ea1e9853a2ce26ef3051c63201b4533,1,11,0,11,2,2014-04-15 13:46:00,2014-04-05 14:23:03
1dedd3185ea1e9853a2ce26ef3051c63201b4533...f3b89ba0820882bd4ce4404b7e7c819e7b506de5,5,18,14,32,13,2014-04-15 13:46:00,2014-04-04 18:31:38
f3b89ba0820882bd4ce4404b7e7c819e7b506de5...95dfcc50ed37805fb83d5b67e15254caed0872e5,1,0,1,1,1,2014-04-15 14:06:18,2014-04-15 14:06:18
95dfcc50ed37805fb83d5b67e15254caed0872e5...b7283d738ec4c2d9d87cb16c32a3209cab567ed1,3,6,24,30,3,2014-04-15 14:08:18,2014-04-15 14:08:18
b7283d738ec4c2d9d87cb16c32a3209cab567ed1...d0131da70ed0144c36af3494e2f843f62d740b1a,1,1,1,2,1,2014-04-15 14:38:23,2014-04-15 14:38:23
d0131da70ed0144c36af3494e2f843f62d740b1a...4bd2830636350469a7e232e046f41e95383962a3,1,1,1,2,1,2014-04-17 19:15:51,2014-04-17 19:10:17
4bd2830636350469a7e232e046f41e95383962a3...1ca84214cc89d9e5f8af12b18b34426fc91b1b08,2,2,1,3,2,2014-04-18 14:00:42,2014-04-14 14:00:42
1ca84214cc89d9e5f8af12b18b34426fc91b1b08...def4841cfaf68e2ec156c554f8efa4aa64203f36,1,1,8,9,1,2014-04-18 14:21:21,2014-04-18 00:07:17
def4841cfaf68e2ec156c554f8efa4aa64203f36...90b43de21296cf59af7dd37c49c1a9a4f8483f68,4,39,29,68,18,2014-04-18 21:17:51,2014-04-18 21:17:51
90b43de21296cf59af7dd37c49c1a9a4f8483f68...1514dca501fd383a9cdb6b42cce7c71fdad1ee38,1,0,4,4,1,2014-04-23 16:02:06,2014-04-23 16:02:06
1514dca501fd383a9cdb6b42cce7c71fdad1ee38...04ddc4a44ba0f3f55829bf544f19c36404064ffc,1,1,0,1,1,2014-04-23 16:05:12,2014-04-23 16:02:55
04ddc4a44ba0f3f55829bf544f19c36404064ffc...bbace100a3ad51287cd2864eeb03ddebb381d44f,2,3,3,6,3,2014-04-24 19:42:18,2014-04-24 19:38:38
bbace100a3ad51287cd2864eeb03ddebb381d44f...c34dbf5a8d135e0f873ab7a76d1c8f8e316f31e4,3,32,3,35,6,2014-04-30 13:05:48,2014-04-26 17:24:05
c34dbf5a8d135e0f873ab7a76d1c8f8e316f31e4...b8133e282ceebf502c7c08d849b176a929c9c450,3,30,4,34,4,2014-04-30 14:46:26,2014-04-30 14:43:39
b8133e282ceebf502c7c08d849b176a929c9c450...568f3dd84693629768b40e7b5cf4c60e0c57c4d4,1,1,1,2,1,2014-05-01 17:15:13,2014-05-01 17:15:13
568f3dd84693629768b40e7b5cf4c60e0c57c4d4...2f46ac8091d8b2612c56280e7a5626f9142bb1cf,1,1,1,2,1,2014-05-01 20:42:42,2014-05-01 20:42:42
2f46ac8091d8b2612c56280e7a5626f9142bb1cf...69d4a48ff67188214bc28ec1a4d138c5997ce171,1,0,1,1,1,2014-05-02 13:49:28,2014-05-01 11:37:23
69d4a48ff67188214bc28ec1a4d138c5997ce171...da148f158f40b474841ad7a60cc39c5868cf420c,1,1,1,2,1,2014-05-02 14:03:52,2014-05-02 14:03:52
da148f158f40b474841ad7a60cc39c5868cf420c...787562247b680717e2a465c85acbe4358766e085,2,23,2,25,4,2014-05-05 13:45:57,2014-05-05 13:45:57
787562247b680717e2a465c85acbe4358766e085...10024c25820f08139f11d924cec552a26dfbba18,1,0,3,3,2,2014-05-09 00:11:27,2014-05-09 00:08:48
10024c25820f08139f11d924cec552a26dfbba18...97cbab51e20d39c0f13ea5ee890bb7f2a9817b41,1,2,1,3,2,2014-05-23 17:00:55,2014-05-23 17:00:55
97cbab51e20d39c0f13ea5ee890bb7f2a9817b41...b80700c75f2d4920ebdd81b6122fa0c4f65723b1,2,3,4,7,4,2014-05-23 17:01:03,2014-05-23 16:45:19
b80700c75f2d4920ebdd81b6122fa0c4f65723b1...1d931068d30b6a516b883cf7f420606de21eab68,3,49,0,49,4,2014-05-23 17:49:57,2014-05-23 16:45:51
1d931068d30b6a516b883cf7f420606de21eab68...efc4f8d7814a8c44bd5b4d924d237a04263e1a85,1,5,9,14,5,2014-05-29 17:45:59,2014-05-29 17:45:59
efc4f8d7814a8c44bd5b4d924d237a04263e1a85...3b9057a18de31b838bd0dd25ea466993b62f9dd9,1,6,2,8,2,2014-05-29 17:54:45,2014-05-29 17:54:45
3b9057a18de31b838bd0dd25ea466993b62f9dd9...97c803acfb667f74774450e93666d9596f92bbf5,4,15,8,23,4,2014-06-02 16:39:11,2014-06-02 16:39:11
97c803acfb667f74774450e93666d9596f92bbf5...d41e81980ea89e56c04eb14d8c27f4692b367604,2,18,1,19,2,2014-06-02 19:08:40,2014-05-30 13:48:43
d41e81980ea89e56c04eb14d8c27f4692b367604...c18c6229c84cd2f0c9fe9f6fc3749e2c93608cc7,1,1,0,1,1,2014-06-02 20:43:46,2014-05-30 20:13:00
c18c6229c84cd2f0c9fe9f6fc3749e2c93608cc7...e1192af8726bcd25da58aba64b20d89e919230b9,2,4,2,6,3,2014-06-07 18:35:01,2014-06-07 18:22:49
e1192af8726bcd25da58aba64b20d89e919230b9...ff9dcfb0c4238d405af92cbd4ac27e0a36c6ff0c,1,42,47,89,3,2014-06-07 18:35:01,2014-06-07 18:33:36
ff9dcfb0c4238d405af92cbd4ac27e0a36c6ff0c...d837f119c3729565103005d5d7fa89e1dd8110cb,28,160,169,329,127,2014-06-11 03:28:14,2014-04-25 22:26:36
d837f119c3729565103005d5d7fa89e1dd8110cb...e488d985cfb10ab8c684bbc6a9b8ff3eae23bf83,2,31,1,32,2,2014-06-15 23:08:26,2014-05-18 16:47:37
e488d985cfb10ab8c684bbc6a9b8ff3eae23bf83...bbdfbb4ee859fe9319b348d88120ddc2c9efbd63,6,41,47,88,9,2014-06-15 23:08:46,2013-11-29 08:15:05
bbdfbb4ee859fe9319b348d88120ddc2c9efbd63...72119e0023dcc0d9807caf6d988598b74abdc937,2,29,2,31,8,2014-06-15 23:08:46,2014-05-09 00:21:42
72119e0023dcc0d9807caf6d988598b74abdc937...708764f47b0c8de152bbb444d0f608db558b76ed,2,46,21,67,7,2014-06-15 23:08:46,2014-05-12 17:53:40
708764f47b0c8de152bbb444d0f608db558b76ed...fbdbb6fd431a3f598b581079b0ca37c399d369d4,2,4,6,10,2,2014-06-15 23:08:46,2014-06-14 16:31:08
fbdbb6fd431a3f598b581079b0ca37c399d369d4...39b76064d9400295a383291ab6e821e259b67832,1,1,1,2,1,2014-06-15 23:08:46,2014-06-15 23:01:53
39b76064d9400295a383291ab6e821e259b67832...323e82c09f9078cc16f0df170e7a8bddea33523e,1,1,1,2,1,2014-06-24 14:16:55,2014-06-10 19:58:28
323e82c09f9078cc16f0df170e7a8bddea33523e...8d113104e980179e9eb4d092df0b1ab37cdc6fa5,9,1,11415,11416,8,2014-06-24 14:16:55,2014-06-10 19:13:03
8d113104e980179e9eb4d092df0b1ab37cdc6fa5...c5d9d88dce65b89a1d7d12b41ad254d5017a92a8,16,70,23,93,13,2014-06-24 14:17:50,2014-06-10 19:32:25
c5d9d88dce65b89a1d7d12b41ad254d5017a92a8...35f8e15fd73256ec02397d7bf93893e38afc9bc9,1,4,0,4,1,2014-06-24 15:17:44,2014-06-24 15:17:44
35f8e15fd73256ec02397d7bf93893e38afc9bc9...c0b23e2b71eb7dd19b6435c6e94980275dd3990d,6,45,35,80,20,2014-06-25 17:43:09,2014-06-25 17:43:09
c0b23e2b71eb7dd19b6435c6e94980275dd3990d...712e78c47fc3e550dabbb44055e5bf7877871bff,1,1,1,2,1,2014-06-25 17:51:39,2014-06-25 17:51:39
712e78c47fc3e550dabbb44055e5bf7877871bff...4f776e5ff91c48891f02d1ca3ba31132477d3972,2,19,3,22,3,2014-06-27 15:10:45,2014-05-27 19:03:12
4f776e5ff91c48891f02d1ca3ba31132477d3972...86e62d8b37ff9ad40e7c21c2c0c440a9cdfc550e,1,2,2,4,1,2014-06-30 16:13:57,2014-06-30 16:13:57
86e62d8b37ff9ad40e7c21c2c0c440a9cdfc550e...bcca4f041b4c98dc9cb127ea3a2a7f40d2db4796,4,6,6,12,6,2014-07-01 20:50:27,2014-07-01 20:50:27
bcca4f041b4c98dc9cb127ea3a2a7f40d2db4796...2fb719e5aa885232c5347576e9f9e1e341a7ba15,1,1,1,2,1,2014-07-12 18:10:45,2014-06-24 10:52:15
2fb719e5aa885232c5347576e9f9e1e341a7ba15...df62159296e9de8b04653ba999a32f9be7bb2a73,1,1,1,2,1,2014-07-12 18:20:03,2014-06-29 11:09:59
df62159296e9de8b04653ba999a32f9be7bb2a73...e5190982c40d7ac8ab9bdb2e7e4334f0e123ef66,1,5,18,23,4,2014-07-12 20:34:40,2014-06-13 18:42:38
e5190982c40d7ac8ab9bdb2e7e4334f0e123ef66...e1949f43711b5808d42378bafb6728b40b1738d6,6,26,23,49,15,2014-07-17 16:02:59,2014-07-17 16:02:59
e1949f43711b5808d42378bafb6728b40b1738d6...8356948ed4ee13af218af74c56c8a91ee9523828,3,79,47,126,21,2014-07-17 16:03:29,2014-07-17 16:03:29
8356948ed4ee13af218af74c56c8a91ee9523828...8e3a0ceafa2c7c78902d0eab07d21b793deb5366,1,5,5,10,3,2014-07-17 17:24:37,2014-07-17 17:24:37
8e3a0ceafa2c7c78902d0eab07d21b793deb5366...c869a1ef8a031342e817a2c063179a787ff57239,39,352,187,539,159,2014-07-17 17:25:59,2014-07-17 17:25:59
c869a1ef8a031342e817a2c063179a787ff57239...269a27c70204c7d233eac3cd91a383e9b5759a2f,2,3,3,6,2,2014-07-17 18:15:19,2014-07-17 18:15:19
269a27c70204c7d233eac3cd91a383e9b5759a2f...10399ddcf8a239acc27bdec9231b996b178224d3,2,15,11,26,6,2014-07-18 00:03:35,2014-07-17 23:53:57
10399ddcf8a239acc27bdec9231b996b178224d3...995f70777ac6c0f988a44807ef1399e73937b2ee,1,1,1,2,1,2014-07-28 16:46:31,2014-07-28 16:46:31
995f70777ac6c0f988a44807ef1399e73937b2ee...895ea6887dd02a44067d041db00c355c80e930a3,1,1,1,2,1,2014-09-02 16:12:35,2014-06-10 21:26:35
895ea6887dd02a44067d041db00c355c80e930a3...29838b6cab6f2e508f3e9692f32918c72b1a504b,7,15,20,35,16,2014-09-02 16:29:10,2014-07-25 19:21:22
29838b6cab6f2e508f3e9692f32918c72b1a504b...4287442ab8bdf8d9f008f3e84ccbf7d86d0fb5db,1,1,1,2,1,2014-09-02 16:29:10,2014-07-25 20:08:42
4287442ab8bdf8d9f008f3e84ccbf7d86d0fb5db...15a609f7663c4348ab7f1acbc9e566ec20bb717c,2,2,4,6,2,2014-09-02 16:31:11,2014-07-25 22:23:54
15a609f7663c4348ab7f1acbc9e566ec20bb717c...075da3091cda170bd8cd5ce47bad1c5b14760232,1,1,1,2,1,2014-09-02 17:48:35,2014-09-02 17:44:02
075da3091cda170bd8cd5ce47bad1c5b14760232...274feb53cc9a99633dfac785d8b3b837d192c43c,1,2,12,14,2,2014-09-02 19:34:48,2014-09-01 21:13:46
274feb53cc9a99633dfac785d8b3b837d192c43c...a7724186c98734529b06bebb8f2dc7fc2b641011,1,7,1,8,1,2014-09-02 20:11:05,2014-09-02 20:11:05
a7724186c98734529b06bebb8f2dc7fc2b641011...7e09619cdf2813f2cd9da600ba682be8f91b08b6,1,2,3,5,3,2014-09-02 20:20:23,2014-09-02 20:20:23
7e09619cdf2813f2cd9da600ba682be8f91b08b6...609adf63dadb7052c816b1a3ee44e3f928ede2e3,1,1,1,2,1,2014-09-03 12:45:34,2014-09-03 11:00:26
609adf63dadb7052c816b1a3ee44e3f928ede2e3...1ae025e24f9920d18cec8a8498bfc4eed7e3f1dc,1,6,2,8,1,2014-09-04 06:41:57,2014-06-17 13:48:17
1ae025e24f9920d18cec8a8498bfc4eed7e3f1dc...b807aedb7fee321fb3aa5d156a5a256ab0634e2d,2,4,1,5,3,2014-09-04 07:28:40,2014-05-15 16:26:20
b807aedb7fee321fb3aa5d156a5a256ab0634e2d...0cdec797de23555c95a70978f4d9e06f3b041330,1,1,1,2,1,2014-09-26 11:03:05,2014-09-23 03:05:59
0cdec797de23555c95a70978f4d9e06f3b041330...2e9c1ead76aaae8fde004e3cacde1e36c5fd2104,1,3,4,7,3,2014-09-26 16:51:48,2014-09-23 22:03:04
2e9c1ead76aaae8fde004e3cacde1e36c5fd2104...edfc94df92982c2d840f6692291e09211d1c7cfc,1,1,1,2,1,2014-10-06 13:25:27,2014-10-06 13:25:27
edfc94df92982c2d840f6692291e09211d1c7cfc...4e7f34f6296111f7f91d621397dfb02c6bf4c41f,1,3,2,5,1,2014-10-14 17:24:05,2014-10-10 17:01:59
4e7f34f6296111f7f91d621397dfb02c6bf4c41f...ff928f5775566ee54f26fcb0f9a326719c32e63c,1,0,15,15,1,2014-10-19 19:16:13,2014-10-19 19:16:13
ff928f5775566ee54f26fcb0f9a326719c32e63c...3e89a53265bfdc992d7a97a01c5d1025e48e5906,2,2,2,4,2,2014-10-19 22:51:04,2014-10-17 05:01:37
3e89a53265bfdc992d7a97a01c5d1025e48e5906...5bc1ddc5cc96e509e0fadb0c1e3a70927de6ed1c,1,1,1,2,1,2014-10-22 15:57:23,2014-10-22 15:57:23
5bc1ddc5cc96e509e0fadb0c1e3a70927de6ed1c...f110360f65a268e959ae892ca36e85da3d91e606,2,1,18,19,2,2014-10-30 00:19:54,2014-10-30 00:18:42
f110360f65a268e959ae892ca36e85da3d91e606...1d752731011d35e985271334ff98186728949f03,1,1,1,2,1,2014-10-30 13:16:32,2014-10-30 13:16:32
1d752731011d35e985271334ff98186728949f03...31d58c5cbbede6dc33d10feecd5277ccddb367e6,1,1,1,2,1,2014-10-30 14:26:38,2014-10-25 07:42:19
31d58c5cbbede6dc33d10feecd5277ccddb367e6...598ed050f6931922214aeaea8a1dc867e0cc6fb7,2,23,0,23,2,2014-11-01 16:44:43,2014-07-13 17:53:00
598ed050f6931922214aeaea8a1dc867e0cc6fb7...7a607c5673fa36f9818f19e349871600a2938b1e,2,2,2,4,2,2014-11-03 17:29:16,2014-11-03 17:29:16
7a607c5673fa36f9818f19e349871600a2938b1e...758fd6cea9e82f7bfebce07ba6ecf0d107e8a53c,3,3,4,7,3,2014-11-03 17:34:45,2014-11-03 17:34:45
758fd6cea9e82f7bfebce07ba6ecf0d107e8a53c...740e190223d19a114d5373758127285d14d6b71e,17,56,141,197,44,2014-11-03 17:37:26,2014-10-27 17:36:07
740e190223d19a114d5373758127285d14d6b71e...e81b258ace257ba138022cf28374190623b0be5e,1,0,1,1,1,2014-11-03 19:03:03,2014-11-03 19:03:03
e81b258ace257ba138022cf28374190623b0be5e...c309b95756b83b60fadc369edb120db4520c364a,3,3,3,6,3,2014-11-04 15:16:36,2014-11-04 15:16:36
c309b95756b83b60fadc369edb120db4520c364a...1bbb678949da480dce0d9ed3d0fb273bccce9787,1,3,0,3,2,2014-11-06 15:05:18,2014-11-05 17:14:56
1bbb678949da480dce0d9ed3d0fb273bccce9787...dc4b914a05e1e6dbf13f916897b5d6a472ea0380,3,6,6,12,6,2014-11-08 14:24:33,2014-11-07 06:30:18
dc4b914a05e1e6dbf13f916897b5d6a472ea0380...9d6beac3958da79671344fd11b9a3fe9b85f88e1,1,1,1,2,1,2014-11-10 10:20:06,2014-11-10 10:20:06
9d6beac3958da79671344fd11b9a3fe9b85f88e1...f7e60dc83d81cbf892de9dab39642dd67c49bd23,2,15,1,16,2,2014-11-16 15:05:29,2014-11-11 13:27:44
f7e60dc83d81cbf892de9dab39642dd67c49bd23...7d15b4d1f181de8868c375c545a51e4dfc28a611,1,1,0,1,1,2014-12-02 20:01:45,2014-12-01 22:35:51
7d15b4d1f181de8868c375c545a51e4dfc28a611...15f4dec7894f1e00adbfb9bce4f870441a527bd6,2,10,0,10,2,2014-12-03 01:54:53,2014-11-28 06:09:29
15f4dec7894f1e00adbfb9bce4f870441a527bd6...cfe2eae38df411c0f15cbbf927612bc515063bf5,1,1,1,2,1,2014-12-03 18:59:41,2014-12-03 18:57:58
cfe2eae38df411c0f15cbbf927612bc515063bf5...80022c81ce4a07a232afd3c580b0977555a2daec,2,9,3,12,3,2014-12-03 19:51:24,2014-12-03 19:51:24
80022c81ce4a07a232afd3c580b0977555a2daec...d9ed166c865e91ccc8cef1ca282785c500ca2306,2,20,1,21,2,2014-12-03 20:56:50,2014-12-03 20:56:50
d9ed166c865e91ccc8cef1ca282785c500ca2306...bfd5dab2c6f387dce08e7c153ad0b3854ed971e4,1,23,111,134,22,2014-12-04 17:12:24,2014-12-04 00:07:48
bfd5dab2c6f387dce08e7c153ad0b3854ed971e4...2c1b556d98da597b0490f204e3561f656987f17c,1,3,1,4,2,2014-12-04 21:38:00,2014-05-01 10:21:34
2c1b556d98da597b0490f204e3561f656987f17c...6748ba349650353c7bed6eec201a3192f6b2cae1,3,1770,1212,2982,265,2014-12-05 14:55:12,2014-12-05 14:49:02
6748ba349650353c7bed6eec201a3192f6b2cae1...26276a307ce2f554b63a05ed8451155f01711c29,5,24,23,47,19,2014-12-05 17:34:17,2014-12-05 17:28:40
26276a307ce2f554b63a05ed8451155f01711c29...3c13f4c6297566a71102c2362347987f6d6a636e,1,20,21,41,8,2014-12-06 18:23:40,2014-12-06 18:23:40
3c13f4c6297566a71102c2362347987f6d6a636e...906caebb3f3bc542904a94846e778aa8d71c0575,1,43,45,88,18,2014-12-06 18:30:31,2014-12-06 18:30:31
906caebb3f3bc542904a94846e778aa8d71c0575...bc1cb122db30be034b3da84ee2546c86e2a5268f,2,19,2,21,2,2014-12-08 01:51:04,2014-12-08 01:51:04
bc1cb122db30be034b3da84ee2546c86e2a5268f...4467ed606ab0a9b28ed495e682576910937fa5e0,1,2,1,3,2,2014-12-08 02:28:20,2014-10-08 11:24:55
4467ed606ab0a9b28ed495e682576910937fa5e0...dd596ccf729b2f39d44b73bc54b53bd41c880146,1,19,3,22,3,2014-12-08 06:26:15,2014-12-07 10:01:16
dd596ccf729b2f39d44b73bc54b53bd41c880146...f6302b0b53d61dfe1adbfaf6612be5cbced5bbc1,2,10,7,17,3,2014-12-08 21:39:58,2014-12-04 13:43:35
f6302b0b53d61dfe1adbfaf6612be5cbced5bbc1...eeda11cdd6a69ec2ef4e9c1ed12b82a79910fda5,1,5,14,19,5,2014-12-09 06:46:22,2014-02-07 10:30:13
eeda11cdd6a69ec2ef4e9c1ed12b82a79910fda5...43faf6d1f922ba44a84c93f4ff2461d208b2bf48,1,9,41,50,9,2014-12-09 20:05:45,2014-12-09 20:05:31
43faf6d1f922ba44a84c93f4ff2461d208b2bf48...58c24608210c9a9a264a38746628ebc26823f59b,5,39,3,42,13,2014-12-09 20:19:01,2014-12-09 20:13:46
58c24608210c9a9a264a38746628ebc26823f59b...6051609df35ef5e478c79c76534c03e4b46100bf,8,32,32,64,17,2014-12-09 20:39:24,2014-12-09 20:39:24
6051609df35ef5e478c79c76534c03e4b46100bf...59232825aa87b941dd2418a6860b64017dfec0ae,5,13,36,49,17,2014-12-09 20:57:12,2014-12-09 20:57:12
59232825aa87b941dd2418a6860b64017dfec0ae...31c7d7fb7530e1af950b41d13dd956820d5c6908,1,1,1,2,1,2014-12-09 21:37:30,2014-12-09 21:37:30
31c7d7fb7530e1af950b41d13dd956820d5c6908...4ab743188ec6bdaafe8550dab84f374ef7e22aca,1,1,4,5,2,2014-12-09 21:39:59,2014-12-09 21:30:22
4ab743188ec6bdaafe8550dab84f374ef7e22aca...b77983173e18724a883e02ad3a84661e18e6cf4a,2,1,17,18,2,2014-12-09 23:01:33,2014-12-09 23:00:06
b77983173e18724a883e02ad3a84661e18e6cf4a...8653068dd6b8a515f5c1d8a0fda4479e9534103e,2,12,1,13,2,2014-12-10 00:59:56,2014-12-10 00:59:56
8653068dd6b8a515f5c1d8a0fda4479e9534103e...cfe468f29c4cbe1a457d0feb17dec90dcfd7c280,5,67,6,73,15,2014-12-10 14:51:30,2014-12-10 14:48:55
cfe468f29c4cbe1a457d0feb17dec90dcfd7c280...b091fdbafac33123cba329e6bb48b9281323ca38,2,31,20,51,10,2014-12-11 20:26:04,2014-11-23 01:29:13
b091fdbafac33123cba329e6bb48b9281323ca38...ce308e25e57a0a040cd1ea05f00bf1cc23c1bd8a,1,22,5,27,5,2014-12-13 20:41:04,2014-12-13 20:41:04
ce308e25e57a0a040cd1ea05f00bf1cc23c1bd8a...31b63fc23674ede657f019783ad7b942bb83f9c3,2,7,7,14,7,2014-12-15 13:07:10,2014-12-15 00:48:53
31b63fc23674ede657f019783ad7b942bb83f9c3...7602dc708dc6d9d0ae9982aadb9fa4615a9c49fa,7,131,46,177,46,2014-12-15 17:30:43,2014-12-15 17:30:43
7602dc708dc6d9d0ae9982aadb9fa4615a9c49fa...03557db96c5b9fad22320e94b52b118c89f7b6f9,2,17,1,18,4,2014-12-17 01:36:46,2014-12-17 01:36:46
03557db96c5b9fad22320e94b52b118c89f7b6f9...78ac753192d5490295a46b60f278c030d958bf6d,1,1,1,2,1,2014-12-17 15:42:29,2014-12-17 15:35:59
78ac753192d5490295a46b60f278c030d958bf6d...91017047fc85cf634d9c7726901c250708f58731,1,8,8,16,5,2014-12-17 15:42:29,2014-12-17 15:42:23
91017047fc85cf634d9c7726901c250708f58731...d6c97abb744bfe8c67ab9158aecdb5bb1c05e47b,1,1,1,2,1,2014-12-17 16:17:41,2014-12-17 16:17:41
d6c97abb744bfe8c67ab9158aecdb5bb1c05e47b...d21edb599d8f5f80a3f3ecba5b62311b9cd1a3e6,2,17,2,19,2,2014-12-23 21:33:00,2014-12-21 02:52:17
d21edb599d8f5f80a3f3ecba5b62311b9cd1a3e6...1b932bb7867924b98529537f8ccd35db979ae22a,1,15,0,15,1,2014-12-23 21:33:00,2014-12-20 09:08:44
1b932bb7867924b98529537f8ccd35db979ae22a...72c4a067a9def9720a997f23615690970894dc9c,1,3,2,5,3,2014-12-23 22:34:40,2014-12-18 19:51:44
72c4a067a9def9720a997f23615690970894dc9c...6f65f5faf2b5831414d4c93d271a59265b41a75b,1,3,4,7,4,2014-12-23 22:44:38,2014-12-15 08:06:09
6f65f5faf2b5831414d4c93d271a59265b41a75b...359b03cac74d7336676a6992f14b7ccab9b28659,2,33,6,39,3,2014-12-23 22:51:33,2014-12-08 07:32:57
359b03cac74d7336676a6992f14b7ccab9b28659...c62486fb4cb18fdb7dc5807231c964ed82ee6482,1,1,1,2,1,2014-12-23 23:25:04,2014-12-21 20:21:27
c62486fb4cb18fdb7dc5807231c964ed82ee6482...4ab8603669e2bbc8644e402927c33ce422d7aaa3,1,16,7,23,4,2014-12-25 01:49:56,2014-12-25 01:49:56
4ab8603669e2bbc8644e402927c33ce422d7aaa3...5a0867d1e94794fbfc3be1f18f4c0a168dc18d95,1,2,3,5,2,2014-12-25 05:24:37,2014-11-12 10:29:41
5a0867d1e94794fbfc3be1f18f4c0a168dc18d95...ab20d9d24f0a95df382c02e9ef3dcc4adb86e4f1,2,24,2,26,3,2014-12-25 12:39:28,2014-12-09 12:57:15
ab20d9d24f0a95df382c02e9ef3dcc4adb86e4f1...76df9e4e389d80bff410a9e5f08b848de1d21a2f,23,88,40,128,51,2014-12-26 12:26:46,2014-09-11 20:18:34
76df9e4e389d80bff410a9e5f08b848de1d21a2f...b410b15e8da1a8d285f431640ff165e634196115,1,1,1,2,1,2015-01-03 18:42:37,2015-01-03 18:42:37
b410b15e8da1a8d285f431640ff165e634196115...66e1b6b8d49812239b5712d65922ff94c60f7b02,3,3,5,8,3,2015-01-03 21:01:57,2015-01-01 19:34:48
66e1b6b8d49812239b5712d65922ff94c60f7b02...97cf5280824027c3d4fcdbb4db49c10ad3c62bce,2,15,1,16,2,2015-01-05 20:34:52,2014-12-20 23:41:24
97cf5280824027c3d4fcdbb4db49c10ad3c62bce...d30c482910bf35c5dbaec9c82174d1e6ae8839b5,1,1,1,2,1,2015-01-07 02:04:25,2015-01-07 02:04:17
d30c482910bf35c5dbaec9c82174d1e6ae8839b5...83b038fc81ec12e29dba92ad022e1d5fcf4980bc,1,1,1,2,1,2015-01-07 02:12:33,2014-12-19 12:23:02
83b038fc81ec12e29dba92ad022e1d5fcf4980bc...c34ed46eee12c92cb050a53eb62daf9e1258caf9,1,18,29,47,2,2015-01-07 02:59:14,2015-01-07 02:59:14
c34ed46eee12c92cb050a53eb62daf9e1258caf9...a3779bc3254159f5a99e8204e69a0f0b9e191f6f,1,3,3,6,3,2015-01-07 03:15:53,2015-01-07 03:15:53
a3779bc3254159f5a99e8204e69a0f0b9e191f6f...b50e0f2c3651d64d40931a16733b015f56409c63,1,1,1,2,1,2015-01-09 21:39:41,2015-01-09 21:39:41
b50e0f2c3651d64d40931a16733b015f56409c63...0c9d018889944da3d60cac135dc38dfcc37ac14a,1,25,0,25,1,2015-01-11 02:11:50,2014-12-07 06:46:25
0c9d018889944da3d60cac135dc38dfcc37ac14a...0d829f0e9a177038580a59d0b5649fab76b8104f,2,43,17,60,27,2015-01-11 04:04:34,2015-01-02 14:42:06
0d829f0e9a177038580a59d0b5649fab76b8104f...32bf9178cace8c52a31c468a28adde9a4fdc4671,2,13,5,18,5,2015-01-11 04:07:39,2015-01-04 00:55:31
32bf9178cace8c52a31c468a28adde9a4fdc4671...4cbf02df84dbcaa44b75a64ed832f7dbff2231dd,1,74,82,156,29,2015-01-11 04:08:27,2015-01-04 01:48:54
4cbf02df84dbcaa44b75a64ed832f7dbff2231dd...53aa87f3bf4284763405f3eb8affff296e55ba4f,8,12,11,23,11,2015-01-11 04:47:01,2014-12-31 23:31:27
53aa87f3bf4284763405f3eb8affff296e55ba4f...bb928bde7e7b85357fef3fedd450b04c03e965d7,3,24,20,44,6,2015-01-11 15:28:18,2014-12-30 02:07:03
bb928bde7e7b85357fef3fedd450b04c03e965d7...89ce0af2cf7f001647e74fc1de92ce94a51fd5c2,2,23,2,25,3,2015-01-12 01:32:38,2015-01-06 03:00:12
89ce0af2cf7f001647e74fc1de92ce94a51fd5c2...0ea8c32863af31fb5cfc184e8d513bbae35583e8,5,7,65,72,11,2015-01-12 02:11:56,2015-01-08 18:35:28
0ea8c32863af31fb5cfc184e8d513bbae35583e8...a4133ffafa6ac43b3aa22bc4edb4444b09f5250c,1,2,1,3,1,2015-01-12 03:24:02,2015-01-12 03:24:02
a4133ffafa6ac43b3aa22bc4edb4444b09f5250c...534f13025aeb59a7d5893ce62efafa0b066a4934,2,14,1,15,2,2015-01-13 04:42:52,2015-01-04 22:48:35
534f13025aeb59a7d5893ce62efafa0b066a4934...85ffc6d973865a031ded170934e0acfc2e97cb11,2,19,2,21,2,2015-01-13 04:42:59,2015-01-05 00:02:39
85ffc6d973865a031ded170934e0acfc2e97cb11...74ae5444832b2fb966768a97281d2ad8c088bc58,1,12,3,15,3,2015-01-13 05:12:51,2015-01-13 05:12:14
74ae5444832b2fb966768a97281d2ad8c088bc58...d7e5fcee519e5f3e840beef9e67a536e75133df9,2,14,7,21,5,2015-01-14 19:34:09,2015-01-14 19:34:09
d7e5fcee519e5f3e840beef9e67a536e75133df9...4116914dcac32868c2c822366785e3dd2ccc69d4,2,11,6,17,3,2015-01-19 16:38:04,2015-01-07 20:12:49
4116914dcac32868c2c822366785e3dd2ccc69d4...e905dcd8f33e99275e29b0333e7b255559197c81,1,7,0,7,1,2015-01-19 17:02:13,2015-01-19 17:02:13
e905dcd8f33e99275e29b0333e7b255559197c81...a5e1c9b44c971fd7046d9a95bd0810e50840b663,1,4,0,4,1,2015-01-25 00:09:26,2015-01-25 00:09:26
a5e1c9b44c971fd7046d9a95bd0810e50840b663...4fae91141c04dffb5094b5961eb5d7b2a1f3f423,1,1,1,2,1,2015-01-26 03:38:48,2015-01-15 02:41:27
4fae91141c04dffb5094b5961eb5d7b2a1f3f423...31f4f8e3f30e67e677a2aa167b9e894d46d5b81e,1,1,0,1,1,2015-01-29 03:21:35,2015-01-25 00:27:08
31f4f8e3f30e67e677a2aa167b9e894d46d5b81e...087d280ad1160de53a45ea96184911194f7b46e0,1,4,4,8,2,2015-01-29 03:33:28,2015-01-25 00:32:54
087d280ad1160de53a45ea96184911194f7b46e0...26eca143c2dd857b9e3d1c446a467fed16e903d2,7,251,159,410,20,2015-01-29 20:03:40,2015-01-28 19:37:29
26eca143c2dd857b9e3d1c446a467fed16e903d2...61224f5fef4336cd47cb26be74f9758096f7f956,1,0,4,4,1,2015-01-29 20:25:57,2015-01-29 20:25:57
61224f5fef4336cd47cb26be74f9758096f7f956...aae998b5449f35dc71e87e360aee5bd0022e7c8e,2,2,8,10,3,2015-01-29 23:36:48,2015-01-29 23:36:48
aae998b5449f35dc71e87e360aee5bd0022e7c8e...e0673dfedb9ad07d8e68f28a54453b975c412c33,2,49,32,81,15,2015-01-30 01:38:35,2015-01-30 00:21:39
e0673dfedb9ad07d8e68f28a54453b975c412c33...a76c7812366e7e45ea29969db72d90261ef87af5,4,15,9,24,5,2015-01-30 20:22:31,2015-01-30 20:22:25
a76c7812366e7e45ea29969db72d90261ef87af5...1ba45fcc15c894cad591d93cbb88010df5f235fe,1,2,3,5,3,2015-01-30 20:53:28,2015-01-30 20:46:48
1ba45fcc15c894cad591d93cbb88010df5f235fe...3747cc642a48d2a5a8ac83069f66bddd33bea301,3,49,4,53,17,2015-02-04 12:51:56,2014-11-05 17:27:01
3747cc642a48d2a5a8ac83069f66bddd33bea301...cdfc2d092afad5a3e5b3978b04b402a1ee9dce79,2,8,7,15,3,2015-02-05 00:41:10,2015-02-05 00:41:10
cdfc2d092afad5a3e5b3978b04b402a1ee9dce79...45ec73f55618cd080867a98b42b9ab80409cab2e,2,20,21,41,9,2015-02-05 01:48:32,2015-02-05 01:11:58
45ec73f55618cd080867a98b42b9ab80409cab2e...0ea342a6a6dce793c1b0f14f051c2573f40f4e44,2,25,2,27,3,2015-02-10 20:44:01,2015-01-22 23:34:29
0ea342a6a6dce793c1b0f14f051c2573f40f4e44...e984d1c79cc476062818e03df04a366baa13d197,2,81,6,87,4,2015-02-11 13:49:59,2015-01-21 18:47:03
e984d1c79cc476062818e03df04a366baa13d197...0c466438d1feaec302fec13eafeeb063bbfd6a19,1,8,5,13,1,2015-02-11 19:46:28,2015-02-11 19:44:57
0c466438d1feaec302fec13eafeeb063bbfd6a19...2d5c5d213f09fa0205d07a2d60a36581058cc40a,4,141,69,210,35,2015-02-14 22:14:41,2015-01-26 18:24:59
2d5c5d213f09fa0205d07a2d60a36581058cc40a...fcb6c4d1d6552c7e54df16a36b171858bdf0553f,1,1,1,2,1,2015-02-14 22:16:27,2015-02-13 18:50:24
fcb6c4d1d6552c7e54df16a36b171858bdf0553f...0ac28ed293681cb8f2e9fdd11efa0021da039c84,2,2,1,3,2,2015-02-14 23:00:38,2015-01-26 03:42:14
0ac28ed293681cb8f2e9fdd11efa0021da039c84...4ef120d3f2578fe3d52eb6c0d0641df945991391,4,17,3,20,4,2015-02-14 23:01:59,2015-02-10 19:42:21
4ef120d3f2578fe3d52eb6c0d0641df945991391...97ef1f2612a9c5bd453d34146fdfd552cf9cee67,1,4,1,5,1,2015-02-14 23:05:39,2015-02-11 13:40:40
97ef1f2612a9c5bd453d34146fdfd552cf9cee67...8b6aeae52d4c53a53468678ccd45e9dda9665004,2,9,9,18,5,2015-02-14 23:22:09,2015-02-14 23:22:09
8b6aeae52d4c53a53468678ccd45e9dda9665004...9d1b989f20b550af3590691723b0620f6914626e,2,10,12,22,8,2015-02-17 06:58:45,2015-02-15 02:41:38
9d1b989f20b550af3590691723b0620f6914626e...8356281bed643bb3d56ad02f52580a0e20dc0237,1,5,7,12,3,2015-02-19 08:30:57,2015-02-17 07:45:30
8356281bed643bb3d56ad02f52580a0e20dc0237...a4715f4216ace92fba6991106053415e66289686,1,3,1,4,1,2015-02-19 08:30:59,2015-02-17 07:05:25
a4715f4216ace92fba6991106053415e66289686...2380028ec4a6a77401b867a51de26a3cb8e8d311,1,10,31,41,5,2015-02-19 08:30:59,2015-02-17 07:09:54
2380028ec4a6a77401b867a51de26a3cb8e8d311...95fb798980d7e404c413e29e20016db9052e2bf2,1,9,13,22,2,2015-03-04 19:32:24,2014-09-26 15:55:48
95fb798980d7e404c413e29e20016db9052e2bf2...d702b7637a61e1973e08c27b8d8de2ed24a543e2,4,66,74,140,29,2015-03-04 22:26:47,2013-11-11 18:13:22
d702b7637a61e1973e08c27b8d8de2ed24a543e2...222ac3ad6bd40ef4dfb4e4c60bac4b751d907e2a,1,23,36,59,5,2015-03-05 19:56:54,2015-03-05 19:56:54
222ac3ad6bd40ef4dfb4e4c60bac4b751d907e2a...361a0d5150a1c57b1857611cde1b05bd0ef21a50,1,3,1,4,2,2015-03-08 03:23:49,2015-03-08 03:23:49
361a0d5150a1c57b1857611cde1b05bd0ef21a50...34da7d552982d8ab7b18c2ceca9786d5023930f6,3,1,10,11,7,2015-03-08 03:30:01,2015-01-25 03:43:05
34da7d552982d8ab7b18c2ceca9786d5023930f6...9b03f6df88a8d9dbda3f7893cdd84e3a3c70da17,5,135,58,193,14,2015-03-09 16:00:10,2015-02-04 13:10:14
9b03f6df88a8d9dbda3f7893cdd84e3a3c70da17...332fd941b4ae80e8ca5e5a20aca91806038f4816,2,18,1,19,2,2015-03-09 17:51:16,2015-03-09 16:03:43
332fd941b4ae80e8ca5e5a20aca91806038f4816...aaeed53e9f1e299975cb6f697c8038ec3a83fa4d,2,39,44,83,34,2015-03-16 15:21:24,2015-03-16 15:20:16
aaeed53e9f1e299975cb6f697c8038ec3a83fa4d...5dc4616ca0fdbf2a80890bd9b236e796b84db8c1,2,12,3,15,2,2015-03-16 15:52:05,2015-03-16 15:52:05
5dc4616ca0fdbf2a80890bd9b236e796b84db8c1...7632b7454b8a918b5eb9ade199a6a842eae98571,2,2,2,4,2,2015-03-16 18:11:38,2015-03-16 18:11:38
7632b7454b8a918b5eb9ade199a6a842eae98571...48be675200e817f40fa8ec25da1be2ab0839d28d,1,19,7,26,1,2015-03-17 03:05:36,2015-03-17 03:05:36
48be675200e817f40fa8ec25da1be2ab0839d28d...e22ef5d9017c44cad97ae541fefce76cc455edcb,1,2,2,4,2,2015-03-17 03:49:48,2015-03-17 03:05:36
