id,files,locs added,locs removed,locs total,hunks,commit time,author time
4b825dc642cb6eb9a060e54bf8d69288fbee4904...c15648cbd059b92c177586ab1701a167222c7681,9,503,0,503,9,2008-10-31 16:57:29,2008-10-31 16:57:29
c15648cbd059b92c177586ab1701a167222c7681...44181c23ea6c39d51a4b481dc59ecf2cc3967e76,2,4,4,8,4,2008-10-31 17:42:32,2008-10-31 17:42:32
44181c23ea6c39d51a4b481dc59ecf2cc3967e76...46d8b885bd65158e8cb53266ba4b627b5991bce8,2,6,6,12,6,2008-10-31 18:05:02,2008-10-31 17:43:20
46d8b885bd65158e8cb53266ba4b627b5991bce8...171aaf21d9f7582270c390962f61d3d2613c4d59,1,2,0,2,1,2008-10-31 18:05:05,2008-10-31 17:55:12
171aaf21d9f7582270c390962f61d3d2613c4d59...b51eb250ed0cbda59d3108d04569fab9413909fd,1,18,6,24,6,2008-10-31 18:05:05,2008-10-31 17:55:58
b51eb250ed0cbda59d3108d04569fab9413909fd...111d5ccf0bb010c4e8d7af3eedfa12ef4c5e265b,1,11,0,11,1,2008-10-31 18:05:05,2008-10-31 17:56:18
111d5ccf0bb010c4e8d7af3eedfa12ef4c5e265b...1cd20d3af067093c571be764bef038be1a39b502,2,12,10,22,2,2008-10-31 18:05:05,2008-10-31 17:57:04
1cd20d3af067093c571be764bef038be1a39b502...bce499af70d434e89c9a110374f1b7c6dd3621df,1,9,9,18,1,2008-10-31 18:05:05,2008-10-31 18:01:28
bce499af70d434e89c9a110374f1b7c6dd3621df...29f0e90ff41bd7079d3e620e15370e3a8385884f,5,25,22,47,19,2008-10-31 18:21:24,2008-10-31 18:04:48
29f0e90ff41bd7079d3e620e15370e3a8385884f...7335ffc31f110ce77ba291719841231921dcb17b,2,82,0,82,2,2008-10-31 18:37:58,2008-10-31 18:37:58
7335ffc31f110ce77ba291719841231921dcb17b...b39843f3e42c8e062a29b2a64e3c3ce6a16eb72f,1,2,9,11,1,2008-10-31 18:44:00,2008-10-31 18:44:00
b39843f3e42c8e062a29b2a64e3c3ce6a16eb72f...8edc2805f1f11b63e44bf81f4557f8b473612b69,1,1,1,2,1,2008-10-31 18:46:51,2008-10-31 18:46:51
8edc2805f1f11b63e44bf81f4557f8b473612b69...13ce9f1b96279187249d56cc641252ff617fa35a,1,1,1,2,1,2008-10-31 19:28:49,2008-10-31 19:28:49
13ce9f1b96279187249d56cc641252ff617fa35a...0e7fa1fe6837a46fad03e7fa9a3df0815364982d,1,6,0,6,1,2008-10-31 19:30:04,2008-10-31 19:30:04
0e7fa1fe6837a46fad03e7fa9a3df0815364982d...061605020c8f212d696a2a3d28e20c7091c09443,6,363,1,364,6,2008-10-31 19:47:11,2008-10-31 19:30:28
061605020c8f212d696a2a3d28e20c7091c09443...4f9339df943c53117a5fc8e86e2f38716ff3a668,2,6,1,7,2,2008-10-31 22:10:51,2008-10-31 22:10:51
4f9339df943c53117a5fc8e86e2f38716ff3a668...de2220a48fcf7901432f8093d3223e65f4072ff7,8,14,17,31,12,2008-11-01 01:30:40,2008-11-01 01:16:26
de2220a48fcf7901432f8093d3223e65f4072ff7...6533aadc21270052d8d05835b1e30d8b13a2f164,10,63,55,118,45,2008-11-01 01:30:43,2008-11-01 01:23:01
6533aadc21270052d8d05835b1e30d8b13a2f164...6dafd0566786a417cfe1131ab804b162fcc79d15,1,12,0,12,1,2008-11-01 01:30:43,2008-11-01 01:30:22
6dafd0566786a417cfe1131ab804b162fcc79d15...3e89665eb6d5ab75051dc59fc8b63316908b19d1,3,2,79,81,8,2008-11-01 01:34:02,2008-11-01 01:34:02
3e89665eb6d5ab75051dc59fc8b63316908b19d1...d1ea30c399629de48ac3fe68869a21171ad131eb,12,25,25,50,20,2008-11-01 22:42:23,2008-11-01 22:42:23
d1ea30c399629de48ac3fe68869a21171ad131eb...50298f44a45eda3a29dae82dbe911b5aa176ac07,12,551,295,846,39,2008-11-01 22:55:47,2008-11-01 22:55:01
50298f44a45eda3a29dae82dbe911b5aa176ac07...16a67770b7d8d72317c4b775213c23a8bd74f5e0,8,211,10,221,13,2008-11-01 23:53:06,2008-11-01 23:53:06
16a67770b7d8d72317c4b775213c23a8bd74f5e0...15bffce9f7ce45f3b17d9357931667485a890455,7,317,5,322,12,2008-11-02 01:24:39,2008-11-02 01:14:22
15bffce9f7ce45f3b17d9357931667485a890455...8722a77ec384aa0bc87b8f8f6c1c7ab6aeffae83,1,2,2,4,1,2008-11-04 02:40:06,2008-11-04 01:52:59
8722a77ec384aa0bc87b8f8f6c1c7ab6aeffae83...b3a2f90e54bcb32a88d13539e5672993c5037638,2,3,2,5,2,2008-11-04 02:42:54,2008-11-04 02:00:49
b3a2f90e54bcb32a88d13539e5672993c5037638...fbbfdf9f13e92da2dc31b56081302f09fdb62e49,2,8,8,16,3,2008-11-04 02:42:54,2008-11-04 00:29:56
fbbfdf9f13e92da2dc31b56081302f09fdb62e49...3b8ab0b93539049b0f7c4a09f5dad48a1d89cd49,1,4,2,6,2,2008-11-04 02:42:54,2008-11-04 00:29:03
3b8ab0b93539049b0f7c4a09f5dad48a1d89cd49...b923f2f97dc26e981c18da93b98bd5e7b44c3b79,3,31,16,47,8,2008-11-04 02:42:54,2008-11-04 01:00:54
b923f2f97dc26e981c18da93b98bd5e7b44c3b79...b81dd80e8cb77046b6196a1dec3f8f356307fcfb,1,29,4,33,3,2008-11-04 02:42:54,2008-11-04 02:38:12
b81dd80e8cb77046b6196a1dec3f8f356307fcfb...367ab010d69ec4fff533c770eba5b1882f79cb41,1,37,0,37,1,2008-11-04 02:43:04,2008-11-04 02:19:02
367ab010d69ec4fff533c770eba5b1882f79cb41...b7c891c629d298f2d82310d8ced2ee2e48084213,7,107,6,113,7,2008-11-04 02:43:04,2008-11-04 01:31:16
b7c891c629d298f2d82310d8ced2ee2e48084213...3e9e69098af2014a0c3fe9e46cddcb5365dd538b,2,67,41,108,15,2008-11-04 02:43:04,2008-11-04 01:14:25
3e9e69098af2014a0c3fe9e46cddcb5365dd538b...2dbdb824f0cfbf5f583e6b94aec753f276ed3368,2,22,1,23,5,2008-11-04 02:52:28,2008-11-04 02:38:57
2dbdb824f0cfbf5f583e6b94aec753f276ed3368...1699efc4217d925c50abee60d196d9f6e738a72e,2,61,8,69,8,2008-11-04 02:52:32,2008-11-04 02:39:37
1699efc4217d925c50abee60d196d9f6e738a72e...8b6f008edad28fec6e3732fce75c20b0608e4c46,1,60,0,60,1,2008-11-04 02:53:09,2008-11-04 02:53:09
8b6f008edad28fec6e3732fce75c20b0608e4c46...eb160e949ef7a76c384dbbfa0d61d580a11d095b,1,55,0,55,1,2008-11-18 18:32:53,2008-11-17 22:15:30
eb160e949ef7a76c384dbbfa0d61d580a11d095b...257bd746cf4b3f1e048a640202493c3e3bcdc1ae,5,9,9,18,5,2008-11-18 18:32:53,2008-11-17 23:58:02
257bd746cf4b3f1e048a640202493c3e3bcdc1ae...dff79e27d3d2cdc09790ded80fe2ea8ff5d61034,2,6,6,12,6,2008-11-18 18:32:53,2008-11-17 23:59:36
dff79e27d3d2cdc09790ded80fe2ea8ff5d61034...1b9e92c73bd223661fe63dffa0c9138da4e1ea80,4,12,12,24,12,2008-11-18 18:32:53,2008-11-18 00:02:27
1b9e92c73bd223661fe63dffa0c9138da4e1ea80...d4043ee9d97031e94f205110996d2381dd26c540,10,12,10,22,9,2008-11-18 18:32:53,2008-11-18 00:18:52
d4043ee9d97031e94f205110996d2381dd26c540...a57e9a8cc15b61ae1ab908b362fd829b3e36e513,1,5,0,5,2,2008-11-18 18:32:53,2008-11-18 00:27:29
a57e9a8cc15b61ae1ab908b362fd829b3e36e513...36f0f61fc8578478a9dc9b33a1a0d07cdb98a5e5,3,81,0,81,3,2008-11-18 18:32:53,2008-11-18 18:06:25
36f0f61fc8578478a9dc9b33a1a0d07cdb98a5e5...4f0adcd0e61eabe06fe32be66b16559537124b7a,4,15,10,25,4,2008-11-22 20:08:00,2008-11-18 20:28:55
4f0adcd0e61eabe06fe32be66b16559537124b7a...ff7c7576aad8b6d87100eb1a62c0bfcdd6e24e01,1,1,1,2,1,2008-11-22 20:08:00,2008-11-22 12:05:32
ff7c7576aad8b6d87100eb1a62c0bfcdd6e24e01...3e1d42b7d980e29595572e550d5ce58c0a34f15f,1,6,1,7,3,2008-11-22 20:08:00,2008-11-18 21:17:40
3e1d42b7d980e29595572e550d5ce58c0a34f15f...c215be4120385fc5f358e8a0609c94f6998184e7,2,15,8,23,4,2008-11-22 20:08:00,2008-11-22 13:57:40
c215be4120385fc5f358e8a0609c94f6998184e7...f501265f976a745e5c0d21104635d695227171cd,1,33,0,33,1,2008-11-22 20:08:00,2008-11-22 13:40:51
f501265f976a745e5c0d21104635d695227171cd...76a8c44727406a76d251102bdee607871887a119,1,11,0,11,1,2008-11-22 20:08:00,2008-11-22 13:42:12
76a8c44727406a76d251102bdee607871887a119...3a2aabdce127a367aa27a4c27025199230e26c15,2,26,0,26,2,2008-11-22 20:08:00,2008-11-22 13:44:47
3a2aabdce127a367aa27a4c27025199230e26c15...ae23486285f4e16896afd53b20dd11180d26381a,6,74,1,75,6,2008-11-22 20:08:00,2008-11-18 21:20:15
ae23486285f4e16896afd53b20dd11180d26381a...c6ebb4a9404e6cb7ed09f0d775c093f33a82f9b8,7,0,175,175,7,2008-11-22 20:08:00,2008-11-22 14:17:17
c6ebb4a9404e6cb7ed09f0d775c093f33a82f9b8...21648b45356a49c76d58acf3590bd98ad12b3d58,1,2,1,3,2,2008-11-22 20:08:00,2008-11-22 14:25:59
21648b45356a49c76d58acf3590bd98ad12b3d58...6013ffa66ef5d856b2c4c72c44b1a63a7ccc2b57,1,1,1,2,1,2008-11-22 20:08:00,2008-11-22 14:33:15
6013ffa66ef5d856b2c4c72c44b1a63a7ccc2b57...ab3f234e5f33426172ecead8d964b927bb281850,1,4,3,7,4,2008-11-22 20:08:00,2008-11-22 14:35:31
ab3f234e5f33426172ecead8d964b927bb281850...cc7301d8a23a16789de6d298a6b1d2ad7c686184,1,1,0,1,1,2008-12-02 16:44:36,2008-11-20 15:25:41
cc7301d8a23a16789de6d298a6b1d2ad7c686184...f2b93d4124d2a46ec7070cf6a40a3863e2c15556,1,2,0,2,2,2008-12-02 16:44:36,2008-11-21 08:26:57
f2b93d4124d2a46ec7070cf6a40a3863e2c15556...6e9ac9c85e1329debc18a30c520e59130d5b190e,1,1,0,1,1,2008-12-02 16:44:36,2008-11-22 13:02:07
6e9ac9c85e1329debc18a30c520e59130d5b190e...0cfd861bd547b6520d1fc2e190e8359e0a9c9b90,1,1,0,1,1,2008-12-02 16:44:36,2008-11-22 13:03:06
0cfd861bd547b6520d1fc2e190e8359e0a9c9b90...9e300586fb4dbcd7a7e7592e8bd36bae946bcf61,1,1,0,1,1,2008-12-02 16:44:36,2008-11-25 15:28:51
9e300586fb4dbcd7a7e7592e8bd36bae946bcf61...634a64b10a627e64f1a4370d085eed0be242b6ed,1,5,0,5,3,2008-12-02 16:44:36,2008-11-22 13:04:25
634a64b10a627e64f1a4370d085eed0be242b6ed...42c07750c431b6bd77c6a9e1ff4997285932e352,1,1,1,2,1,2008-12-02 16:45:03,2008-11-27 08:26:52
42c07750c431b6bd77c6a9e1ff4997285932e352...ec250c6e18e56d12714f9010e1b15e5feec5f473,10,90,224,314,12,2008-12-02 17:17:23,2008-11-23 21:37:55
ec250c6e18e56d12714f9010e1b15e5feec5f473...4188d28f1c38240392d896fc79561cc461fb12c0,2,93,0,93,3,2008-12-02 17:17:42,2008-11-29 14:28:12
4188d28f1c38240392d896fc79561cc461fb12c0...ea790f337b0e401f5e4acabf9af9c2bc756d5f3b,3,96,0,96,4,2008-12-02 17:18:19,2008-11-29 14:34:20
ea790f337b0e401f5e4acabf9af9c2bc756d5f3b...43288a0733c1dc0a506a1e45087bb7f9bd87d047,1,5,5,10,5,2008-12-02 17:20:06,2008-11-29 19:18:43
43288a0733c1dc0a506a1e45087bb7f9bd87d047...80133dad8aa9b6d8bec7050a77d603c53ecd8512,1,1,1,2,1,2008-12-02 17:21:50,2008-11-29 19:19:31
80133dad8aa9b6d8bec7050a77d603c53ecd8512...1764376034ce4f4c899f141c121e1be9167d1e83,2,2,2,4,2,2008-12-02 17:23:18,2008-11-29 19:20:07
1764376034ce4f4c899f141c121e1be9167d1e83...b72ca26740c71371258bd178188a3d981e39701e,1,2,2,4,1,2008-12-02 17:23:48,2008-11-29 19:21:24
b72ca26740c71371258bd178188a3d981e39701e...af795e498d411142ddb073e8ca2c5447c3295a4c,3,133,1,134,7,2008-12-02 18:02:29,2008-12-02 17:56:23
af795e498d411142ddb073e8ca2c5447c3295a4c...4b8e8b32c1ea1bee8c8c01795e46aa97006bb065,1,1,1,2,1,2008-12-09 16:36:10,2008-12-03 09:27:48
4b8e8b32c1ea1bee8c8c01795e46aa97006bb065...192678b55c30d0652356a5021b521f8e205f3428,2,4,4,8,4,2008-12-09 16:36:32,2008-12-03 23:52:57
192678b55c30d0652356a5021b521f8e205f3428...5ee2fe777c41d9ad9e7eb9fece56fe21f830c5cd,2,5,1,6,3,2008-12-09 16:37:52,2008-12-03 23:53:55
5ee2fe777c41d9ad9e7eb9fece56fe21f830c5cd...b3be0fc7562d51df415c14abf671deb37d8f89ef,1,1,0,1,1,2008-12-09 16:38:10,2008-12-03 23:54:47
b3be0fc7562d51df415c14abf671deb37d8f89ef...7b6e8067ec96acef9a4184b43210d583b6d2f99a,3,132,0,132,5,2008-12-10 19:49:06,2008-12-10 18:31:28
7b6e8067ec96acef9a4184b43210d583b6d2f99a...c18626eef6cbd1b420b85fc9f8a44d5031ad2fcd,2,8,1,9,3,2008-12-18 16:17:05,2008-12-18 16:17:05
c18626eef6cbd1b420b85fc9f8a44d5031ad2fcd...def425bf8568b9c1e20879bf5be6f9c52b7361c4,2,0,2,2,2,2008-12-18 16:20:50,2008-12-18 16:20:50
def425bf8568b9c1e20879bf5be6f9c52b7361c4...75d584305598407be4c53d42c85eca3cd58c973c,3,49,0,49,5,2008-12-19 15:21:20,2008-12-18 22:56:14
75d584305598407be4c53d42c85eca3cd58c973c...3d3552e8fd709214634435ee188e6fb4930e7b39,5,1752,2,1754,8,2008-12-19 15:23:00,2008-12-18 22:58:10
3d3552e8fd709214634435ee188e6fb4930e7b39...5ddbd5edf83e034a62499a1a9c94645d7b9030dc,1,18,0,18,3,2008-12-30 15:31:02,2008-12-30 11:10:00
5ddbd5edf83e034a62499a1a9c94645d7b9030dc...d7fbfe155fbddb41936407612fbce9c34276b671,3,19,1,20,6,2008-12-30 15:31:03,2008-12-30 11:10:01
d7fbfe155fbddb41936407612fbce9c34276b671...42fd40db68e5e5797531dc1f5de7aef39a2262c0,1,3,2,5,3,2008-12-30 15:32:16,2008-12-27 18:56:16
42fd40db68e5e5797531dc1f5de7aef39a2262c0...007e075337848055a92e218bdfe137451a4c9635,4,171,1,172,4,2008-12-30 15:48:10,2008-12-27 18:58:25
007e075337848055a92e218bdfe137451a4c9635...c960d6a3f97ebd360dc3c9ea00fdb3cd5dc56224,3,479,0,479,4,2008-12-30 15:52:55,2008-12-27 18:59:43
c960d6a3f97ebd360dc3c9ea00fdb3cd5dc56224...6f6a17db05a83620cef4572761831c20a70ba9b9,1,2,2,4,1,2008-12-31 00:50:45,2008-12-31 00:48:36
6f6a17db05a83620cef4572761831c20a70ba9b9...213e720ca80207fe1bb48ad95e2c422e17281a9a,3,4,4,8,4,2008-12-31 05:52:07,2008-12-21 01:47:41
213e720ca80207fe1bb48ad95e2c422e17281a9a...b3039beea6d0637e131b24e8b6d61005cc1f6515,6,18,5,23,16,2008-12-31 05:52:07,2008-12-31 05:25:13
b3039beea6d0637e131b24e8b6d61005cc1f6515...d74679498086d0fc2293dceb59155c696b11b86c,1,0,1,1,1,2008-12-31 05:52:07,2008-12-31 05:50:10
d74679498086d0fc2293dceb59155c696b11b86c...a1d34bc000cee6d72c3b5e329faa58424641611f,5,59,3,62,8,2008-12-31 05:56:11,2008-12-31 05:49:38
a1d34bc000cee6d72c3b5e329faa58424641611f...064301cc3528ec3bccd07dafe9af824d87a50dba,2,6,1,7,3,2008-12-31 06:07:56,2008-12-31 06:07:56
064301cc3528ec3bccd07dafe9af824d87a50dba...4c67e2e95f0bb6f0e214bd7bf052f914d365f129,1,1,1,2,1,2008-12-31 06:25:30,2008-12-31 06:25:30
4c67e2e95f0bb6f0e214bd7bf052f914d365f129...ffb55c532ccc1cb3c47eeeaac6c64240ab88fe29,1,5,5,10,4,2008-12-31 06:29:04,2008-12-31 06:29:04
ffb55c532ccc1cb3c47eeeaac6c64240ab88fe29...64a47c01426a36cdb7e598d17018d5791e54bb97,12,65,15,80,25,2008-12-31 07:28:30,2008-12-31 07:21:36
64a47c01426a36cdb7e598d17018d5791e54bb97...7dd8a9f71052cc12f8dd9c1eec2e99afbf08df76,5,33,16,49,16,2008-12-31 07:29:23,2008-12-31 07:26:38
7dd8a9f71052cc12f8dd9c1eec2e99afbf08df76...5673434fff718d93ac738a03403442f16abeecba,1,12,0,12,3,2008-12-31 15:34:43,2008-12-31 15:34:43
5673434fff718d93ac738a03403442f16abeecba...4260699b37a7a0cc6be231d232d424a858a7d111,8,20,0,20,1,2008-12-31 19:16:41,2008-12-31 19:16:41
4260699b37a7a0cc6be231d232d424a858a7d111...d44cfd460e2c52d67dea14838b03219967cf9cb9,4,14,6,20,12,2008-12-31 21:16:31,2008-12-31 21:16:31
d44cfd460e2c52d67dea14838b03219967cf9cb9...028ef0de72da1ad4d1b2ee4a125ede81e3f2ebed,3,97,1,98,4,2008-12-31 21:36:55,2008-12-31 21:20:21
028ef0de72da1ad4d1b2ee4a125ede81e3f2ebed...5614dc18f626902796fee9c87f1f703694e59295,1,21,4,25,8,2008-12-31 21:37:00,2008-12-31 21:27:51
5614dc18f626902796fee9c87f1f703694e59295...0c01d80a09b0908856d5494d3c7ac7e6d22f1126,1,2,0,2,2,2008-12-31 21:38:47,2008-12-31 21:38:47
0c01d80a09b0908856d5494d3c7ac7e6d22f1126...8ed341c55ed4d6f4cdc8bf4f0ca18a08c93f6962,1,13,0,13,5,2008-12-31 21:45:34,2008-12-31 21:34:03
8ed341c55ed4d6f4cdc8bf4f0ca18a08c93f6962...9eb7976448bf684dfb41993ef6c76098978ff933,3,90,0,90,3,2008-12-31 22:35:39,2008-12-31 22:35:39
9eb7976448bf684dfb41993ef6c76098978ff933...5690f02e87e4fd31dfa9fd7c9c01aba03603cde8,4,75,50,125,11,2008-12-31 23:35:36,2008-12-31 23:35:36
5690f02e87e4fd31dfa9fd7c9c01aba03603cde8...2c4b7707f7e1d591ec1765ab7057a03283841c3e,3,18,0,18,4,2009-01-01 00:06:48,2009-01-01 00:06:48
2c4b7707f7e1d591ec1765ab7057a03283841c3e...7350e6337a2d94c2d2a105845fc78ba0ddc89ea5,2,7,0,7,2,2009-01-01 00:07:38,2009-01-01 00:07:38
7350e6337a2d94c2d2a105845fc78ba0ddc89ea5...b438016ecda7648426036e66c4ed17fc93e71cfa,1,123,2,125,9,2009-01-01 00:20:05,2009-01-01 00:20:05
b438016ecda7648426036e66c4ed17fc93e71cfa...11bb049bdddf1d203dfe8fd6031c4dba328a7525,1,1,1,2,1,2009-01-03 05:41:52,2009-01-03 05:41:52
11bb049bdddf1d203dfe8fd6031c4dba328a7525...51eb2f90a1469542799823e0f3249520bf8f9cf3,1,1,1,2,1,2009-01-03 05:48:40,2009-01-03 05:48:40
51eb2f90a1469542799823e0f3249520bf8f9cf3...3a33c7b37f55d5bd30ff944625499e64919b9a9d,2,1,5,6,2,2009-01-03 05:53:47,2009-01-02 20:51:47
3a33c7b37f55d5bd30ff944625499e64919b9a9d...098ac57a13165290bad223e4949fc6f13960b604,1,99,47,146,23,2009-01-03 08:02:25,2009-01-03 08:02:25
098ac57a13165290bad223e4949fc6f13960b604...20e7f426c3d56ba9e4b55f31a61835dd0031b464,2,46,0,46,4,2009-01-03 09:16:02,2009-01-03 08:36:10
20e7f426c3d56ba9e4b55f31a61835dd0031b464...a7c60cfc6d3af29669ef5cba9df325719b9f30cf,3,242,3,245,13,2009-01-03 10:56:16,2009-01-03 10:41:26
a7c60cfc6d3af29669ef5cba9df325719b9f30cf...bed3229b555ecd18bc7824c3ead7d2372b5f4f5a,1,42,17,59,20,2009-01-03 11:34:09,2009-01-03 11:34:09
bed3229b555ecd18bc7824c3ead7d2372b5f4f5a...c23841c833ab35d82b32553d0659e815859e6c01,2,129,0,129,2,2009-01-03 12:21:30,2009-01-03 12:21:30
c23841c833ab35d82b32553d0659e815859e6c01...66a4bfac99c07b79d75c015aed8f5972f0a4a336,1,1,0,1,1,2009-01-28 19:32:49,2009-01-12 19:38:37
66a4bfac99c07b79d75c015aed8f5972f0a4a336...ced645ea9ca4170bd75c17cb9c2c8f19f935491d,3,123,0,123,3,2009-01-28 20:25:24,2009-01-12 19:42:13
ced645ea9ca4170bd75c17cb9c2c8f19f935491d...cfe96f31dfad7bab49977aa1df7302f7fafcb025,1,4,0,4,1,2009-01-28 20:43:34,2009-01-12 19:44:51
cfe96f31dfad7bab49977aa1df7302f7fafcb025...4730b7224276579fcc8fc7fdb9bf796ef158fde4,2,30,22,52,14,2009-01-28 20:43:37,2009-01-12 19:51:17
4730b7224276579fcc8fc7fdb9bf796ef158fde4...521b4e69c6e0a257724d59f3c803f4eb11e0521f,1,10,10,20,6,2009-02-01 23:00:09,2009-01-30 22:55:53
521b4e69c6e0a257724d59f3c803f4eb11e0521f...19af3949ca8ce2831049a4755bce3091d7f4bceb,2,9,8,17,5,2009-02-01 23:00:10,2009-01-30 22:55:54
19af3949ca8ce2831049a4755bce3091d7f4bceb...3f84b7d30bcee174491ff0015816fe8831b1440a,1,1,0,1,1,2009-02-01 23:00:10,2009-01-30 22:55:55
3f84b7d30bcee174491ff0015816fe8831b1440a...357bf823711de56d93f51d9f4618ec2068d2244f,1,7,6,13,4,2009-02-01 23:00:10,2009-01-30 22:55:56
357bf823711de56d93f51d9f4618ec2068d2244f...c94eb4aa7665d04c8412a72f3554401d2e89e03c,1,6,2,8,3,2009-02-11 18:45:50,2009-02-03 18:22:09
c94eb4aa7665d04c8412a72f3554401d2e89e03c...236e7579fed7763be77209efb8708960982f3cb3,1,8,2,10,3,2009-02-11 18:46:29,2009-02-03 18:23:50
236e7579fed7763be77209efb8708960982f3cb3...e9f5e87781e88aa3afa7679783c204604479f9e9,1,2,2,4,2,2009-02-11 18:47:03,2009-02-03 18:25:13
e9f5e87781e88aa3afa7679783c204604479f9e9...82324ac1a5ec79069877ed5d807c87762a16ed9d,2,71,0,71,2,2009-02-11 19:04:55,2009-02-10 21:49:48
82324ac1a5ec79069877ed5d807c87762a16ed9d...04c9c16e55c53fc12c2eed43e3d7e42f78fe7005,2,2,2,4,2,2009-02-11 19:20:57,2009-02-03 18:16:11
04c9c16e55c53fc12c2eed43e3d7e42f78fe7005...1906f2369d2906cfd4affeab0852b67c4a91ddca,4,267,9,276,11,2009-03-18 01:54:42,2009-02-26 20:37:20
1906f2369d2906cfd4affeab0852b67c4a91ddca...fc3c3a2083e9f6f89e6bd53e9420e70d1e357c9b,1,4,2,6,3,2009-03-18 01:58:30,2009-02-18 18:50:36
fc3c3a2083e9f6f89e6bd53e9420e70d1e357c9b...a9984a4e60291958a7cf0045758f47db3d214040,4,9,9,18,9,2009-03-18 01:59:26,2009-02-18 18:52:13
a9984a4e60291958a7cf0045758f47db3d214040...840fb8b7cb13069c2c5f691beb30c8039b384526,4,22,9,31,8,2009-03-18 02:00:08,2009-02-18 18:53:48
840fb8b7cb13069c2c5f691beb30c8039b384526...491442f97ec18dfdfa88912d20c2304d6ded378f,5,178,184,362,37,2009-03-18 02:06:37,2009-03-13 02:10:22
491442f97ec18dfdfa88912d20c2304d6ded378f...0f39781c25a06c1d38877adef4ff5a6a5f67f1ca,3,325,279,604,17,2009-03-18 02:08:00,2009-03-13 02:10:32
0f39781c25a06c1d38877adef4ff5a6a5f67f1ca...7a6cf8153799563464d6f1761e55352c327b4122,2,6,2,8,3,2009-03-18 02:10:51,2009-03-16 17:08:45
7a6cf8153799563464d6f1761e55352c327b4122...79ca2edcd4e7a801400fa33c2c705b8f03a5d7f5,8,236,20,256,21,2009-03-20 21:39:02,2009-03-20 19:51:48
79ca2edcd4e7a801400fa33c2c705b8f03a5d7f5...0234c186bacb5144ca13f69f0dc9bfcc8ec7a075,3,130,1,131,4,2009-03-20 21:39:03,2009-03-20 19:52:50
0234c186bacb5144ca13f69f0dc9bfcc8ec7a075...502acd164fb115768d723144da2e7bb5a24891bb,2,7,1,8,3,2009-03-30 14:18:42,2009-03-23 18:37:51
502acd164fb115768d723144da2e7bb5a24891bb...498bc0906810bd43c6fbc73385fecb7f2d04be3a,2,217,25,242,13,2009-03-30 14:18:42,2009-03-23 18:47:18
498bc0906810bd43c6fbc73385fecb7f2d04be3a...fd0ec0333948dfe23265ac46be0205a436a8c3a5,2,2,2,4,2,2009-03-30 14:18:42,2009-03-23 18:52:00
fd0ec0333948dfe23265ac46be0205a436a8c3a5...ac04bdf6e0ee6bb4286343bc70d745146eb1e506,1,2,2,4,2,2009-06-05 08:21:11,2009-06-04 15:44:54
ac04bdf6e0ee6bb4286343bc70d745146eb1e506...4d503f884a241c507ec4e474e3e3463c2e394d52,1,1,2,3,1,2009-06-05 08:21:25,2009-06-04 15:48:53
4d503f884a241c507ec4e474e3e3463c2e394d52...4319860c60d84ec2513be34ee1a65dec5eceb6c4,2,49,5,54,4,2009-06-05 08:21:39,2009-06-04 15:45:59
4319860c60d84ec2513be34ee1a65dec5eceb6c4...ca481fc4f12cec56b71bd50ae72e3f088b69021f,2,14,0,14,2,2009-06-05 08:21:52,2009-06-04 15:46:54
ca481fc4f12cec56b71bd50ae72e3f088b69021f...e17a3f5673e0dc4d9ade34a0a276e6c202506fdf,4,734,4,738,13,2009-06-05 08:22:20,2009-06-04 15:47:59
e17a3f5673e0dc4d9ade34a0a276e6c202506fdf...cf33ac7a3d8b2b8f6bb266518aadbf59de397608,2,2,1,3,2,2009-06-05 10:12:42,2009-06-04 16:10:17
cf33ac7a3d8b2b8f6bb266518aadbf59de397608...aee8b26e6322bee55403a61634d7e01b77aea4c1,2,95,45,140,10,2009-06-05 10:12:42,2009-06-04 16:11:06
aee8b26e6322bee55403a61634d7e01b77aea4c1...c8d42b9bd1b6e45f48feadb5b02e152c5e5f1f62,1,2,0,2,2,2009-06-05 10:12:42,2009-06-04 16:12:00
c8d42b9bd1b6e45f48feadb5b02e152c5e5f1f62...3e0fb8fb56426d4645a50ce85fead9ad93ce59ba,1,1,1,2,1,2009-06-05 10:13:48,2009-06-04 16:12:59
3e0fb8fb56426d4645a50ce85fead9ad93ce59ba...4c9a39732942f763191d47be51b414bbc81bbbfd,1,1,1,2,1,2009-06-05 10:14:07,2009-06-04 16:13:49
4c9a39732942f763191d47be51b414bbc81bbbfd...10aa3fa72afab7ee31e116ae06442fe0f7b79df2,2,3,3,6,3,2009-06-05 10:14:24,2009-06-04 16:14:35
10aa3fa72afab7ee31e116ae06442fe0f7b79df2...2bf93fa1071c3df7f43926c8e6c3bd2353d78160,2,7,7,14,7,2009-06-15 05:33:44,2009-06-14 21:10:23
2bf93fa1071c3df7f43926c8e6c3bd2353d78160...8a086f872a3bb2cf8e437f0e374ea18e5cbaa899,4,56,5,61,10,2009-06-15 05:34:28,2009-06-14 21:12:20
8a086f872a3bb2cf8e437f0e374ea18e5cbaa899...c79dded300f279a6d8660b13f4fca3c684533449,2,26,5,31,5,2009-06-15 05:34:43,2009-06-14 21:13:35
c79dded300f279a6d8660b13f4fca3c684533449...73c4dd9253f8d43c436fc88e64096910f4f1b8ee,2,3,4,7,4,2009-06-16 09:40:14,2009-06-16 01:26:02
73c4dd9253f8d43c436fc88e64096910f4f1b8ee...209849a44961d4fb86fc51710affec6d8c407cf7,2,2,10,12,3,2009-06-16 09:40:48,2009-06-16 01:27:49
209849a44961d4fb86fc51710affec6d8c407cf7...5cae6c25279bdd525124b7686d67072059bb0fd5,1,6,0,6,1,2009-10-13 15:22:18,2009-06-17 14:54:59
5cae6c25279bdd525124b7686d67072059bb0fd5...04e8824004970f6889b9df126b5db343013c82c9,1,8,5,13,2,2009-10-13 15:22:58,2009-06-17 21:21:10
04e8824004970f6889b9df126b5db343013c82c9...cac5d927b51bf378cf599a02d38538cf7ab70146,3,26,2,28,10,2009-10-13 15:23:54,2009-08-27 15:11:07
cac5d927b51bf378cf599a02d38538cf7ab70146...d2ef83fcdc0c9cad633e7b654ab789d17f583f30,1,2,0,2,2,2009-10-13 15:25:26,2009-08-28 19:22:03
d2ef83fcdc0c9cad633e7b654ab789d17f583f30...e45535849cb7187e22c9fd11d14e0eb37f5d7dc8,3,48,2,50,6,2009-10-13 15:26:05,2009-08-19 16:06:39
e45535849cb7187e22c9fd11d14e0eb37f5d7dc8...960ca1d7799e02b72ca828373c3fff04e2cf0334,3,82,1,83,4,2009-10-13 15:27:33,2009-08-28 20:22:46
960ca1d7799e02b72ca828373c3fff04e2cf0334...cfe3a027ab12506d4144ee8a35669ae8fc4b7ab1,11,11,14,25,12,2010-01-20 20:13:07,2010-01-15 22:07:44
cfe3a027ab12506d4144ee8a35669ae8fc4b7ab1...a1c0728d12b170e1e643f219fab53b03cd4e1b09,4,18,5,23,6,2010-01-20 20:15:07,2009-12-21 15:54:50
a1c0728d12b170e1e643f219fab53b03cd4e1b09...90d4d2f0fc362beabbbf76b4ffda0828229c198d,4,29,6,35,7,2010-01-20 20:15:57,2010-01-11 19:27:50
90d4d2f0fc362beabbbf76b4ffda0828229c198d...e97179b6de293c8f288957dc556239a44fa52e3e,2,23,13,36,9,2010-01-20 20:16:34,2010-01-13 20:01:11
e97179b6de293c8f288957dc556239a44fa52e3e...1cfb0ff4b6193c409e846a5992683559afd4be07,2,4,1,5,3,2010-01-20 20:17:18,2009-12-30 19:12:35
1cfb0ff4b6193c409e846a5992683559afd4be07...803a6b4d418c4b2d7463bf23a86a09cb2359ec98,1,1,0,1,1,2010-01-20 20:17:56,2010-01-03 19:12:05
803a6b4d418c4b2d7463bf23a86a09cb2359ec98...a4f863af4d0055126435eb01278940aaf727d2b3,1,1,1,2,1,2010-01-20 20:18:15,2010-01-03 19:37:04
a4f863af4d0055126435eb01278940aaf727d2b3...0ef9d2aa934d6e5861206e8c5dd829dc09f4026a,4,11,11,22,10,2010-01-20 20:18:36,2010-01-03 22:56:54
0ef9d2aa934d6e5861206e8c5dd829dc09f4026a...e3fe32b6a4ecb340fa7c9802285711cc52b8a101,3,14,2,16,5,2010-01-20 20:19:06,2010-01-11 21:11:55
e3fe32b6a4ecb340fa7c9802285711cc52b8a101...1a7bae4d0f9d9314b905109b5b321219b7e6be3b,4,21,3,24,6,2010-01-20 20:19:55,2010-01-11 22:51:42
1a7bae4d0f9d9314b905109b5b321219b7e6be3b...e8a952561c4e59ca308d1973de46fc32ad91a022,4,14,9,23,10,2010-01-20 20:20:47,2010-01-04 18:57:13
e8a952561c4e59ca308d1973de46fc32ad91a022...73dcf2876fecab9adba9ec9bc148ccbab431af12,3,11,0,11,4,2010-01-20 20:22:10,2010-01-12 16:39:25
73dcf2876fecab9adba9ec9bc148ccbab431af12...74eff33f8be680e821d9674ab12da3c0b76dad23,2,46,7,53,14,2010-02-01 09:39:10,2010-02-01 09:39:10
74eff33f8be680e821d9674ab12da3c0b76dad23...9b17380391d7e2e4cc26654ee4423ec14d379d28,1,1,1,2,1,2010-04-14 17:38:38,2010-04-14 17:38:38
9b17380391d7e2e4cc26654ee4423ec14d379d28...a7335c5170f4a963c8d67782fa35222d03d8a16b,1,3,0,3,1,2010-04-14 17:40:10,2010-04-14 17:40:10
a7335c5170f4a963c8d67782fa35222d03d8a16b...d15e94c0d4eb0fe06dd1e25d7e9e3c4940417f56,3,321,0,321,3,2010-04-14 18:23:36,2010-04-14 18:23:36
d15e94c0d4eb0fe06dd1e25d7e9e3c4940417f56...5dddf7c855f9c8e43954a99a6f85c098dfc7ed41,9,387,262,649,25,2010-04-14 18:44:22,2010-04-14 18:41:57
5dddf7c855f9c8e43954a99a6f85c098dfc7ed41...100746511cc45c9f1ad6721c4ef5be49222fee4d,1,1,1,2,1,2010-04-15 07:57:58,2009-04-08 07:56:07
74eff33f8be680e821d9674ab12da3c0b76dad23...1e5dd57214dbec1b166c881c1c44c8930923da17,16,141,144,285,46,2010-02-28 20:09:45,2010-02-12 16:50:33
1e5dd57214dbec1b166c881c1c44c8930923da17...56931d1ab4de660b27c56ce488245e78f8c713c3,3,5,0,5,3,2010-02-28 20:10:35,2010-02-19 20:07:03
56931d1ab4de660b27c56ce488245e78f8c713c3...e8cc449fe9c99f9ca35088e3247ab9c0088081fe,3,57,41,98,6,2010-02-28 20:10:56,2010-02-19 21:49:22
e8cc449fe9c99f9ca35088e3247ab9c0088081fe...255a0dabb28beb56096af18dc20187deca4a545c,1,8,0,8,2,2010-02-28 20:11:33,2010-02-19 22:36:31
255a0dabb28beb56096af18dc20187deca4a545c...238e54bcfff45d477a17cc5a0f51f8ee4bc68bad,1,17,2,19,2,2010-02-28 20:12:04,2010-02-21 15:34:53
238e54bcfff45d477a17cc5a0f51f8ee4bc68bad...abf5681c033e83f92198fdce8d30c799a6e42af4,1,20,24,44,15,2010-02-28 20:12:32,2010-02-26 19:29:54
abf5681c033e83f92198fdce8d30c799a6e42af4...608d33fa676aab1ed350312cc07e02cd7f94847d,1,212,26,238,27,2010-02-28 20:13:29,2010-02-26 19:59:06
608d33fa676aab1ed350312cc07e02cd7f94847d...2cdc4544233b503a5aff7dd1baa4ba8743fef7ab,1,64,0,64,6,2010-02-28 20:16:30,2010-02-26 22:53:10
fb799dfe77c7a1c9e2806c0021d659b5588d9105...e2337f39c3a4ab046b7a572fce89df27451fd2bb,1,1,1,2,1,2010-04-28 19:55:04,2010-04-25 20:55:41
e2337f39c3a4ab046b7a572fce89df27451fd2bb...e272b10388ebc4b7ed9fe2b42dd46e367193c218,1,4,4,8,3,2010-04-28 19:55:56,2010-04-26 19:10:44
e272b10388ebc4b7ed9fe2b42dd46e367193c218...70aab459aa2df8f13b828a06976969ba83612f36,1,2,2,4,2,2010-04-28 19:56:19,2010-04-26 21:04:10
70aab459aa2df8f13b828a06976969ba83612f36...44debd80c4908e439d4a505ad7f6de367635b0eb,1,3,4,7,3,2010-04-28 19:57:03,2010-04-27 15:13:57
44debd80c4908e439d4a505ad7f6de367635b0eb...f019bd17a1769103dd82b885d7b46bb9a30bdc29,1,1,1,2,1,2010-04-28 19:57:54,2010-04-27 15:36:52
f019bd17a1769103dd82b885d7b46bb9a30bdc29...19d13c65e11f45c3be6666c6c4c9732c6f4ab40a,2,2,6,8,3,2010-04-28 19:58:24,2010-04-27 16:00:30
19d13c65e11f45c3be6666c6c4c9732c6f4ab40a...54b9460fee5219cb5a57118bce066697704ef3f8,1,2,0,2,1,2010-04-30 07:47:53,2010-04-07 19:13:56
54b9460fee5219cb5a57118bce066697704ef3f8...3cc606359d5ac5c869901d89d8f25cac348f4c98,3,6,2,8,4,2010-04-30 07:47:58,2010-03-05 19:06:28
3cc606359d5ac5c869901d89d8f25cac348f4c98...89217d8f1a70da2916d611c989e6b046cdb94fca,2,116,1,117,10,2010-04-30 07:48:07,2010-04-28 19:20:00
89217d8f1a70da2916d611c989e6b046cdb94fca...38c513b9d1f6c19f191927003c5befd2fa70da9a,6,38,22,60,18,2010-05-04 19:36:12,2010-04-28 18:07:14
38c513b9d1f6c19f191927003c5befd2fa70da9a...1bb11859357114684a1a740e471edf1a7541b82a,1,2,2,4,2,2010-06-02 08:32:06,2010-05-06 19:35:18
1bb11859357114684a1a740e471edf1a7541b82a...417f0abc9b41f01520df863567b25efd03bd281c,3,129,2,131,8,2010-06-02 08:32:06,2010-05-14 16:44:49
417f0abc9b41f01520df863567b25efd03bd281c...4caa8962a6af9fac72ab81afb03779bc3acff910,2,13,12,25,8,2010-06-02 08:32:06,2010-05-14 16:57:50
4caa8962a6af9fac72ab81afb03779bc3acff910...42281e007e15713713b2ff4324d60360332e194e,3,168,0,168,3,2010-06-02 08:32:06,2010-05-15 23:52:31
42281e007e15713713b2ff4324d60360332e194e...08d5d00056a7237bf6c60f85a6e72b7549cf9133,4,114,1,115,10,2010-06-02 08:32:06,2010-05-18 18:55:19
08d5d00056a7237bf6c60f85a6e72b7549cf9133...8add01539268300564482f854412cfe9839e980c,5,82,28,110,20,2010-06-02 08:32:06,2010-05-21 00:35:40
8add01539268300564482f854412cfe9839e980c...1a895dd787a5699c21d7925e9cdffa66f23605c4,5,68,19,87,18,2010-06-02 08:32:06,2010-05-22 12:32:59
1a895dd787a5699c21d7925e9cdffa66f23605c4...89039682651474c6e2bf9abcc02cb71897f8b4e1,1,0,8,8,1,2010-06-02 08:32:06,2010-05-22 12:36:36
89039682651474c6e2bf9abcc02cb71897f8b4e1...36b7cdb6a1a2e685c7141406808366d4c4b9f98e,4,128,67,195,42,2010-06-02 08:32:06,2010-05-22 16:15:42
36b7cdb6a1a2e685c7141406808366d4c4b9f98e...c5696427b6d53a3f79baad35ea33c556884a410a,5,216,11,227,10,2010-06-02 08:32:06,2010-05-22 21:21:10
c5696427b6d53a3f79baad35ea33c556884a410a...5e15176dac8b0baa6f7950f5f763608c83b29093,5,63,23,86,23,2010-06-02 08:32:06,2010-05-23 00:39:57
5e15176dac8b0baa6f7950f5f763608c83b29093...b60488e1d7564716dc2ae7ce078a415280bd7df6,2,58,3,61,5,2010-06-02 08:32:06,2010-05-23 02:37:39
b60488e1d7564716dc2ae7ce078a415280bd7df6...089c2d931b6b68dd82527430da51881d23bbd9a6,1,60,0,60,1,2010-06-02 08:32:07,2010-05-23 02:39:33
089c2d931b6b68dd82527430da51881d23bbd9a6...d047b47aadf88501238f36f5c17dd0a50dc62087,1,9,4,13,5,2010-06-02 08:32:07,2010-05-23 02:41:07
d047b47aadf88501238f36f5c17dd0a50dc62087...a7c182c59414cece10c819989bce3f1247f4eacc,3,27,28,55,16,2010-06-02 08:32:07,2010-05-23 02:41:31
a7c182c59414cece10c819989bce3f1247f4eacc...47c31f584e09d79f3674987582a60c7bb6b673c0,1,6,6,12,5,2010-06-02 08:32:07,2010-05-23 14:28:32
47c31f584e09d79f3674987582a60c7bb6b673c0...655d381a1948783d7d26ff9ec5ef54ed6bbefb29,5,99,15,114,20,2010-06-02 08:32:07,2010-05-23 14:51:31
655d381a1948783d7d26ff9ec5ef54ed6bbefb29...9bdb75947178f72df30314d66bc9bcc90df643d7,3,59,0,59,4,2010-06-02 08:32:07,2010-05-23 15:12:28
9bdb75947178f72df30314d66bc9bcc90df643d7...e5d1faefab1bb51f3d0fff2d5e2cfe4fe96a9c22,3,57,11,68,12,2010-06-02 08:32:07,2010-05-25 17:48:13
e5d1faefab1bb51f3d0fff2d5e2cfe4fe96a9c22...82b1db3b35e34c87862172bf3f4705c4aca8cc98,2,3,3,6,3,2010-06-02 08:32:07,2010-05-25 20:00:55
82b1db3b35e34c87862172bf3f4705c4aca8cc98...69dca959508cd04b226b3747c0c07f89f3bd1a87,2,10,3,13,4,2010-06-02 08:32:07,2010-05-25 20:30:09
69dca959508cd04b226b3747c0c07f89f3bd1a87...1f798df229a70aaa4ee221ecc0e24025ad92ed9a,1,10,4,14,5,2010-06-02 08:32:07,2010-05-25 20:59:50
1f798df229a70aaa4ee221ecc0e24025ad92ed9a...1d1be8ee22a69ad37b6cab510bf5f480dc6df779,1,2,1,3,2,2010-06-02 08:32:07,2010-05-25 23:42:18
1d1be8ee22a69ad37b6cab510bf5f480dc6df779...0cf02ff92d5c08516ff2253f59daad1c4c582d8f,22,92,0,92,7,2010-06-02 08:32:07,2010-05-26 19:23:01
0cf02ff92d5c08516ff2253f59daad1c4c582d8f...9b3577eda0e6bb13d18a304763b91665575adfd3,6,441,471,912,180,2010-06-02 08:32:07,2010-05-27 22:23:43
9b3577eda0e6bb13d18a304763b91665575adfd3...0daa6cdcad92746551f78edfa93be0bc188d4f4a,0,0,0,0,0,2010-06-02 08:32:07,2010-05-27 22:50:03
0daa6cdcad92746551f78edfa93be0bc188d4f4a...6bb7aa1318f7f31a346c71ef81d2b33c6fd41600,6,57,37,94,39,2010-06-02 08:32:07,2010-05-27 23:48:59
6bb7aa1318f7f31a346c71ef81d2b33c6fd41600...c2550609e37e0778814d328c47eb84a7ede6931f,1,1,21,22,1,2010-06-02 08:32:07,2010-05-27 23:50:59
c2550609e37e0778814d328c47eb84a7ede6931f...de141d4bb983dad861835e181e7ecd5692a58aba,3,21,18,39,11,2010-06-02 08:32:07,2010-05-28 00:02:02
de141d4bb983dad861835e181e7ecd5692a58aba...331578fb1d3ff7013b312914fa9c78ee61d8ce52,1,3,1,4,2,2010-06-02 09:18:55,2010-06-01 18:25:28
331578fb1d3ff7013b312914fa9c78ee61d8ce52...5b7487bee63e7f5cb6ea1d9090d52ae631296cd8,1,1,1,2,1,2010-06-02 09:18:55,2010-06-01 18:26:42
5b7487bee63e7f5cb6ea1d9090d52ae631296cd8...8a7d625f53726fc7703dc0a413686d1ec15488e0,1,2,2,4,2,2010-06-02 09:18:55,2010-06-01 18:28:04
8a7d625f53726fc7703dc0a413686d1ec15488e0...5440906feb5e41241a699ee413475b7911284c41,1,3,3,6,3,2010-06-02 09:18:55,2010-06-01 18:29:15
5440906feb5e41241a699ee413475b7911284c41...4e0d6d864d3632a820d8bf3dd89ff333b9bbd34d,1,1,1,2,1,2010-06-02 09:18:55,2010-06-01 18:30:29
4e0d6d864d3632a820d8bf3dd89ff333b9bbd34d...468b12adb15f5546e7c5536f72204605fbd83f6d,1,1,1,2,1,2010-06-02 09:18:55,2010-06-01 18:31:26
468b12adb15f5546e7c5536f72204605fbd83f6d...ee1765e529ab6b44adbcc6a0ff6e9ac1359c6cd6,1,3,3,6,3,2010-06-02 09:18:55,2010-06-01 18:32:41
ee1765e529ab6b44adbcc6a0ff6e9ac1359c6cd6...84b9cec72cc98dea3353325e42ef78b3f7e7c79e,1,2,2,4,2,2010-06-02 09:18:55,2010-06-01 18:33:57
84b9cec72cc98dea3353325e42ef78b3f7e7c79e...6e0fa05b58c140a42ef25dc74041e30f25772b2c,1,1,0,1,1,2010-06-02 09:18:56,2010-06-01 18:34:48
6e0fa05b58c140a42ef25dc74041e30f25772b2c...c1b62b2eded035d22584c427487503335f519d4c,1,3,1,4,1,2010-06-02 09:18:56,2010-06-01 18:35:49
c1b62b2eded035d22584c427487503335f519d4c...28f9832928c52e08c7db5a0d31fde054f51fc475,1,0,2,2,1,2010-06-02 09:18:56,2010-06-01 18:37:10
28f9832928c52e08c7db5a0d31fde054f51fc475...702bd70595a7b19afc48a1f784a6505be68469d4,1,1,0,1,1,2010-06-02 09:18:56,2010-06-01 18:39:24
702bd70595a7b19afc48a1f784a6505be68469d4...b2bc567f25e3e07d0d6d55fab16f33423d863107,3,7,12,19,7,2010-06-02 09:18:56,2010-06-01 18:40:58
b2bc567f25e3e07d0d6d55fab16f33423d863107...f29249340c11b069e46b70fc145c1d7fbe213b94,6,34,30,64,22,2010-06-02 09:18:56,2010-06-01 18:41:55
f29249340c11b069e46b70fc145c1d7fbe213b94...552e23ba566d975b4dd48163b91021892504f021,2,28,1,29,2,2010-06-07 18:44:04,2010-06-02 18:16:28
552e23ba566d975b4dd48163b91021892504f021...e04529998989ba8ae3419538dd57969af819b241,1,5,1,6,3,2010-06-07 18:44:32,2010-05-13 19:51:49
e04529998989ba8ae3419538dd57969af819b241...bc874e116fb4e785081344c2ae39aed3bd072288,1,1,0,1,1,2010-06-07 18:44:55,2010-05-13 19:53:58
bc874e116fb4e785081344c2ae39aed3bd072288...d03f567593f346a1ca96a57f8191def098d126e3,2,8,13,21,2,2010-06-07 18:45:12,2010-06-04 17:20:31
d03f567593f346a1ca96a57f8191def098d126e3...4386ee2acbcbbf1fdf06c75b91da3a9653075c6f,2,11,11,22,6,2010-06-07 18:45:32,2010-06-05 20:09:03
4386ee2acbcbbf1fdf06c75b91da3a9653075c6f...0aaf8708b0f67ed9b99f1c1e2fd28492a671123d,2,2,2,4,2,2010-06-07 18:45:57,2010-06-07 18:33:36
0aaf8708b0f67ed9b99f1c1e2fd28492a671123d...ca3939e682a3198a3d18f42b7fbf84823312dc61,3,4,2,6,3,2010-06-07 18:46:17,2010-06-03 21:28:30
ca3939e682a3198a3d18f42b7fbf84823312dc61...3cd8b687d5dc8006a5eae9e9c4dac212e8df67d1,1,1,1,2,1,2010-07-10 19:08:04,2010-07-10 19:08:04
3cd8b687d5dc8006a5eae9e9c4dac212e8df67d1...58b0cbea74c160c61ec70768568e150c4d31f633,1,9,0,9,2,2010-07-10 19:14:30,2010-07-10 19:14:30
58b0cbea74c160c61ec70768568e150c4d31f633...088a731f00a39fb3158dc9150b7c8d176df51867,4,12,1,13,6,2010-07-10 19:15:12,2010-06-09 12:54:22
088a731f00a39fb3158dc9150b7c8d176df51867...b231ef3acdcf396dba5f83f89488be7519da551a,2,170,0,170,2,2010-07-15 21:37:05,2010-06-12 01:08:52
b231ef3acdcf396dba5f83f89488be7519da551a...40721f6b1297f2a48aeb5c9a3ac095767b1153bf,6,48,12,60,18,2010-07-15 21:39:22,2010-07-10 18:50:16
40721f6b1297f2a48aeb5c9a3ac095767b1153bf...225fe21522a98075bdc18dae90ce459f797ac366,6,128,1,129,9,2010-07-15 21:39:30,2010-06-18 11:06:34
225fe21522a98075bdc18dae90ce459f797ac366...52f2390b4308fe51ecceecbc35a87bf6e74e9aa8,6,508,127,635,71,2010-07-15 21:40:52,2010-07-07 12:56:05
52f2390b4308fe51ecceecbc35a87bf6e74e9aa8...3e590fb2221ea3c117b7347956843d24132ac22b,3,98,98,196,18,2010-07-15 21:41:31,2010-07-07 17:24:08
3e590fb2221ea3c117b7347956843d24132ac22b...d8603ed901d4af4d0d2b493d1164c74eae34f147,4,103,0,103,6,2010-07-15 21:41:49,2010-07-10 23:51:15
d8603ed901d4af4d0d2b493d1164c74eae34f147...7e4f56a5bb4a87cd9537821ba4ccd1f642481a0a,7,311,19,330,17,2010-08-06 16:37:59,2010-08-06 16:37:59
7e4f56a5bb4a87cd9537821ba4ccd1f642481a0a...364788e1d114a174dd3c6fdfd3aa16d9627551b2,6,33,33,66,24,2010-08-06 22:59:58,2010-08-06 22:59:58
364788e1d114a174dd3c6fdfd3aa16d9627551b2...f8758044876b30b0f6482d1fe8c3b1de743f4186,6,387,0,387,5,2010-08-12 02:40:43,2010-08-06 23:02:20
f8758044876b30b0f6482d1fe8c3b1de743f4186...3315782cb4f2b683c66a53c93aa81de501c5a4ab,28,1163,906,2069,221,2010-08-12 16:48:55,2010-08-08 12:12:17
3315782cb4f2b683c66a53c93aa81de501c5a4ab...bd0a51c0dd117eed5879441f9d14a3112ff27cc7,2,155,0,155,2,2010-08-12 16:49:04,2010-07-09 18:17:00
bd0a51c0dd117eed5879441f9d14a3112ff27cc7...68535125b343c8002d8e8ca0324738cd0448fa81,3,851,0,851,3,2010-08-12 16:49:04,2010-07-09 18:19:56
68535125b343c8002d8e8ca0324738cd0448fa81...1baa25ee9bec1636d827c9bb7e90f646a56990ab,25,2,2,4,2,2010-08-12 16:49:04,2010-07-20 21:56:18
1baa25ee9bec1636d827c9bb7e90f646a56990ab...ff17642dc212bd345fda7dc213f08f8815c96841,3,229,0,229,3,2010-08-12 16:49:04,2010-07-19 13:35:52
ff17642dc212bd345fda7dc213f08f8815c96841...003c26909451715cf36ea37ae4a6237813b4a25e,4,182,23,205,23,2010-08-12 16:49:04,2010-08-12 16:45:31
003c26909451715cf36ea37ae4a6237813b4a25e...0e465f979bd946d7476c86cfaa912d0737f54682,2,46,0,46,2,2010-08-12 16:49:04,2010-08-12 16:47:32
0e465f979bd946d7476c86cfaa912d0737f54682...f2408cc2efc1752bb34011a655f6acdab4e9e602,6,98,75,173,35,2010-08-12 17:59:32,2010-08-12 17:59:32
f2408cc2efc1752bb34011a655f6acdab4e9e602...9c9f4fc11c85d621dc5fdcf46bbcb5b5da9ed73f,4,73,22,95,5,2010-08-12 21:40:54,2010-08-12 21:40:54
9c9f4fc11c85d621dc5fdcf46bbcb5b5da9ed73f...370ce56910b9e506b22c7b673ef630a046b90126,3,3,3,6,3,2010-09-08 21:48:09,2010-08-14 18:35:10
370ce56910b9e506b22c7b673ef630a046b90126...46f8566a13564f0566a80b3df5950d1938cd222b,2,41,0,41,2,2010-09-12 20:43:21,2010-09-12 20:43:21
46f8566a13564f0566a80b3df5950d1938cd222b...a7a7ddbe0f097923feb9ed31502857891e02824f,5,101,11,112,15,2010-09-18 16:16:04,2010-09-18 16:16:04
a7a7ddbe0f097923feb9ed31502857891e02824f...f49a2e4981d747f96246bc0c8e75e618419f4eee,23,163,166,329,135,2010-09-19 00:21:06,2010-09-19 00:21:06
f49a2e4981d747f96246bc0c8e75e618419f4eee...e802d8cca8b7fddb8ae157b84fb7c1e84671546d,2,73,20,93,6,2010-09-19 00:53:57,2010-09-19 00:53:57
e802d8cca8b7fddb8ae157b84fb7c1e84671546d...0c3596f18a6f07d8a61f8d6e2fd730a276a51599,8,230,104,334,61,2010-09-19 23:04:06,2010-09-19 22:57:53
0c3596f18a6f07d8a61f8d6e2fd730a276a51599...d45b4a9a1bcbb157a4f02cf5ed23fde5222db9c8,9,157,29,186,31,2010-09-20 18:39:11,2010-09-20 18:39:11
d45b4a9a1bcbb157a4f02cf5ed23fde5222db9c8...2a884588b405c4dee78494119a123fb1878f3490,5,258,47,305,42,2010-09-21 14:17:10,2010-09-21 14:17:10
2a884588b405c4dee78494119a123fb1878f3490...c4b5bedc972d9238db5d6422bc6f4de35b4b67ed,2,48,3,51,12,2010-10-06 21:14:09,2010-10-06 21:07:32
c4b5bedc972d9238db5d6422bc6f4de35b4b67ed...ec25391dbb5ee6800b48362deadd73599701224f,5,107,6,113,13,2010-10-06 21:20:08,2010-10-06 21:20:08
ec25391dbb5ee6800b48362deadd73599701224f...0ba7a0318652e5e89101e9ee72cb1356c21cef56,5,272,0,272,6,2010-10-06 21:42:55,2010-10-06 21:42:55
0ba7a0318652e5e89101e9ee72cb1356c21cef56...e4def81aab5df3ce1bd8622f3c89224d5910a97b,3,54,7,61,13,2010-10-08 10:52:17,2010-10-08 10:52:17
e4def81aab5df3ce1bd8622f3c89224d5910a97b...544d15194ac6732833cc0933de15323803b3fc44,4,13,13,26,13,2010-10-25 23:46:55,2010-10-25 23:32:31
544d15194ac6732833cc0933de15323803b3fc44...0037e4919bcb53f7441a18c992d0cc70e8d1d931,6,8,8,16,8,2010-10-25 23:53:17,2010-10-25 23:32:16
0037e4919bcb53f7441a18c992d0cc70e8d1d931...0d95f32c55a18303a87147467ebd68ea24995753,5,11,11,22,11,2010-10-26 05:32:52,2010-10-26 05:26:14
0d95f32c55a18303a87147467ebd68ea24995753...e30056275c2a6d857d004d850658ccf3490a7876,1,48,1,49,4,2010-10-26 21:59:05,2010-10-12 18:11:51
e30056275c2a6d857d004d850658ccf3490a7876...2d16373cb8d8c22b3ec99a6936b82821e99e64a5,1,1,1,2,1,2010-10-26 21:59:09,2010-10-12 18:12:50
2d16373cb8d8c22b3ec99a6936b82821e99e64a5...585190183b47dc991605abcfbe3afb57220a0f29,17,395,280,675,113,2010-10-27 23:07:18,2010-10-27 23:07:18
585190183b47dc991605abcfbe3afb57220a0f29...adc0327ab308696650b62b2a8ded75f788f7b297,2,419,181,600,36,2010-10-28 21:44:15,2010-10-28 21:44:15
adc0327ab308696650b62b2a8ded75f788f7b297...aaf68dc443bf60f1703b4b9fabd75d7a901f663f,1,210,0,210,1,2010-10-28 21:47:53,2010-10-28 21:47:53
aaf68dc443bf60f1703b4b9fabd75d7a901f663f...a13bc8e74f31d9d326153cb375521c47851eb1eb,4,32,3,35,6,2010-10-28 23:22:38,2010-10-28 23:22:38
a13bc8e74f31d9d326153cb375521c47851eb1eb...57450775571ca9c0be2eba164992abfc004d3226,1,12,0,12,7,2010-10-28 23:53:16,2010-10-28 23:44:32
57450775571ca9c0be2eba164992abfc004d3226...d80e9d55aa2d0629f7f207db42762494075d7854,1,5,2,7,2,2010-10-31 04:05:53,2010-10-31 04:01:46
d80e9d55aa2d0629f7f207db42762494075d7854...6fd195d76c7f52baae5540e287affe2259900d36,53,247,143,390,106,2010-11-02 16:42:42,2010-11-02 16:42:42
6fd195d76c7f52baae5540e287affe2259900d36...1544bc31ca8822183cf8e1033660e0ea134a59cb,1,6,6,12,2,2010-11-02 23:02:37,2010-11-02 23:02:37
1544bc31ca8822183cf8e1033660e0ea134a59cb...1714826fa08ad8612b720c8fdea636a4fc49c480,1,1,1,2,1,2010-11-03 23:08:36,2010-11-03 23:08:36
1714826fa08ad8612b720c8fdea636a4fc49c480...1795f87952a68155a618523799f70473483c7265,25,233,231,464,161,2010-11-05 01:20:17,2010-11-05 01:20:17
1795f87952a68155a618523799f70473483c7265...a8bfce69dcc01fb6731527a11a49d215db71ab2f,2,14,4,18,2,2010-11-05 01:55:04,2010-11-05 01:50:24
a8bfce69dcc01fb6731527a11a49d215db71ab2f...f24fa0880cdaa997bb12b298d44bf54988d6cfb4,1,21,4,25,4,2010-11-05 01:55:14,2010-11-04 22:06:56
f24fa0880cdaa997bb12b298d44bf54988d6cfb4...88d035bd1502d507554f59d6c699b3759bc2b758,2,2,2,4,3,2010-11-05 01:55:14,2010-11-04 22:08:01
88d035bd1502d507554f59d6c699b3759bc2b758...3f43678e889a7ee77b1cd2e40727f104ea3d7ac1,2,31,7,38,9,2010-11-06 23:24:45,2010-11-06 23:24:45
3f43678e889a7ee77b1cd2e40727f104ea3d7ac1...4b7483a285024937df9623c3543390e717e2338a,1,84,0,84,1,2010-11-06 23:31:08,2010-11-05 04:24:00
4b7483a285024937df9623c3543390e717e2338a...1081d909456b8149c8b7fd5eb16d39c6a55c4078,2,24,5,29,6,2010-11-06 23:31:28,2010-11-05 16:04:46
1081d909456b8149c8b7fd5eb16d39c6a55c4078...69f0295c8031c6bb4ecc56a605070969513616d1,1,1,1,2,1,2010-11-06 23:31:37,2010-11-05 22:14:18
69f0295c8031c6bb4ecc56a605070969513616d1...0be421994e34e2d8e200f15b64894dd0c09c4eec,2,14,0,14,2,2010-11-11 01:28:46,2010-11-10 21:43:55
0be421994e34e2d8e200f15b64894dd0c09c4eec...237da40181daa416e25527aee35173a1cd5ad92b,4,277,2,279,10,2010-11-16 00:59:13,2010-11-14 20:06:10
237da40181daa416e25527aee35173a1cd5ad92b...7a3924fc38b63313e84c6339d2fd56084f5aeea6,1,1,1,2,1,2010-11-16 00:59:24,2010-11-14 20:07:48
7a3924fc38b63313e84c6339d2fd56084f5aeea6...c3a20d5cab7d17cf55e769c39a3d50882e3d341d,8,139,57,196,45,2010-11-16 00:59:28,2010-11-14 20:11:46
c3a20d5cab7d17cf55e769c39a3d50882e3d341d...111e362263966869fbb30e2391b9e6bcef58c407,1,1,0,1,1,2010-11-16 01:24:39,2010-11-16 01:24:39
111e362263966869fbb30e2391b9e6bcef58c407...d7c7cab8a41f3baee7e9eb748793c063f925d6fd,1,4,0,4,2,2010-11-16 01:25:26,2010-11-16 01:25:26
d7c7cab8a41f3baee7e9eb748793c063f925d6fd...50dd6ca54cfdfc362147f09ece4996970d0352bd,1,14,12,26,7,2010-11-17 03:16:26,2010-11-17 02:58:32
50dd6ca54cfdfc362147f09ece4996970d0352bd...c3dd69a9e11f2c48a040d0ecaff40295d4759dd5,1,12,3,15,6,2010-11-17 03:16:32,2010-11-17 02:59:11
c3dd69a9e11f2c48a040d0ecaff40295d4759dd5...69a09b7c6972343e321c7c0e3441fcc4b5340444,1,1,1,2,1,2010-11-19 15:17:46,2010-11-19 15:17:46
69a09b7c6972343e321c7c0e3441fcc4b5340444...30b171a185a1ef788d41265f08ad1da98d72918a,2,18,32,50,11,2010-11-20 15:37:32,2010-11-20 15:37:32
30b171a185a1ef788d41265f08ad1da98d72918a...357547fa1261b435c0f974aa8e839eb83247956d,2,70,0,70,1,2010-11-23 22:23:14,2010-11-19 15:07:34
357547fa1261b435c0f974aa8e839eb83247956d...b2898c4500466e5385102a82e4e686792219c1be,2,87,15,102,10,2010-11-23 22:23:14,2010-11-21 00:59:53
b2898c4500466e5385102a82e4e686792219c1be...d910be2105f82e9ea2949ede91d563847d421c65,1,66,33,99,15,2010-11-23 22:23:14,2010-11-21 16:07:28
d910be2105f82e9ea2949ede91d563847d421c65...c34a044f4e7c5cc856d41ef032b6d9c186ae403b,3,21,215,236,3,2010-11-23 22:23:14,2010-11-22 00:42:47
c34a044f4e7c5cc856d41ef032b6d9c186ae403b...11777089307a35cddd618ae6c44e27ff201a4b7d,1,4,0,4,1,2010-11-23 22:23:14,2010-11-22 00:46:05
11777089307a35cddd618ae6c44e27ff201a4b7d...e06551e51c02b015d587c83e97187805b7759f6a,1,69,12,81,32,2010-11-23 22:23:15,2010-11-22 14:42:21
e06551e51c02b015d587c83e97187805b7759f6a...5dc2bee1538ad5fc50abb8dd84fb9237f184a217,1,44,68,112,20,2010-11-23 22:23:15,2010-11-23 12:33:46
5dc2bee1538ad5fc50abb8dd84fb9237f184a217...6b1eab3976b5b7cf4e65b9d12e5e25a98411c4da,3,6,6,12,6,2010-11-23 22:23:15,2010-11-23 12:36:31
6b1eab3976b5b7cf4e65b9d12e5e25a98411c4da...43e380a88ceb0eb5d1b94f2e5736bc7e8e4f4176,1,19,1,20,1,2010-11-23 22:23:15,2010-11-23 13:18:53
43e380a88ceb0eb5d1b94f2e5736bc7e8e4f4176...8b0e448f5cf18fe68097a89e5b3573fdf87a5dd1,1,0,2,2,1,2010-11-23 22:23:15,2010-11-23 14:51:18
8b0e448f5cf18fe68097a89e5b3573fdf87a5dd1...f8b422b6d43bb4b12d3e614b024fbe8415971f4e,1,2,2,4,1,2010-11-23 22:23:15,2010-11-23 20:33:04
f8b422b6d43bb4b12d3e614b024fbe8415971f4e...824f4acde208670490eab77b24cb58a0216ba1df,2,5,1,6,3,2010-11-23 22:23:15,2010-11-23 20:33:28
824f4acde208670490eab77b24cb58a0216ba1df...277e45f48613e6fb6b9a6a8d6aa7d37e033ad5fe,1,0,133,133,1,2010-11-23 22:23:15,2010-11-23 20:36:31
277e45f48613e6fb6b9a6a8d6aa7d37e033ad5fe...405ac51182dd4b29cae3c418ed2f3f96035b8225,1,14,5,19,7,2010-11-23 22:23:15,2010-11-23 20:43:54
405ac51182dd4b29cae3c418ed2f3f96035b8225...0ef70b4a8153a4153da78ca4a515d9623322bf89,1,10,6,16,6,2010-11-23 22:23:15,2010-11-23 21:25:30
0ef70b4a8153a4153da78ca4a515d9623322bf89...b97b386dea2ffe44575087495521fd98d663e5b0,1,117,29,146,5,2010-11-23 22:23:26,2010-11-23 22:20:59
b97b386dea2ffe44575087495521fd98d663e5b0...c5b97d5ae6c19d5c5df71a34c7fbeeda2479ccbc,1,68,47,115,31,2010-11-23 23:20:03,2010-11-23 23:13:04
c5b97d5ae6c19d5c5df71a34c7fbeeda2479ccbc...322086f9b1291b05de7197ac53491ad1ae79ad2e,1,10,11,21,4,2010-11-24 15:56:30,2010-11-24 15:46:46
322086f9b1291b05de7197ac53491ad1ae79ad2e...25e9b4dd449d58af5edefe33d383292d6ead5003,1,2,0,2,1,2010-11-24 15:56:35,2010-11-24 15:48:31
25e9b4dd449d58af5edefe33d383292d6ead5003...8507ab12cfbe4082e1c2db933cf42802ebc10e3b,1,19,5,24,8,2010-11-24 15:56:41,2010-11-24 15:49:55
8507ab12cfbe4082e1c2db933cf42802ebc10e3b...e5fd5b9429bb0f4e8ee4331ca04aa3d355c9458e,1,31,23,54,15,2010-11-24 15:56:45,2010-11-24 15:51:01
e5fd5b9429bb0f4e8ee4331ca04aa3d355c9458e...a84972d0c4d18061812a1c83809baf921969e77d,3,318,0,318,3,2010-11-28 19:54:06,2010-11-28 19:53:02
a84972d0c4d18061812a1c83809baf921969e77d...91e8894150a84235e827e418c6a942753215897c,1,6,0,6,2,2010-11-29 16:06:22,2010-11-29 16:06:22
91e8894150a84235e827e418c6a942753215897c...8c1f9e4dc346d650e43252fe2a653d9dfeb85cf2,2,6,6,12,2,2010-11-29 16:07:17,2010-11-29 16:07:17
8c1f9e4dc346d650e43252fe2a653d9dfeb85cf2...1e35f929ef0df0e28c14655fa47406732f30cc73,1,60,0,60,2,2010-12-02 02:19:14,2010-12-02 02:19:14
1e35f929ef0df0e28c14655fa47406732f30cc73...c4034e63f358cfed6bd851a831c50dbcd5006ffe,8,331,214,545,83,2010-12-02 02:31:54,2010-12-02 02:31:54
8c1f9e4dc346d650e43252fe2a653d9dfeb85cf2...12114415ab62f7b7958f33bc7229963061b269df,3,26,0,26,5,2010-12-01 03:27:12,2010-12-01 03:01:47
12114415ab62f7b7958f33bc7229963061b269df...eb095435f338b97f305148e122d6e12fd81621ca,3,30,1,31,4,2010-12-01 03:28:39,2010-12-01 03:28:39
41109a7e7eb4544dc64c563d947f6655d45c1a28...eec952351363354cad2e094a10d8545e4d2a996f,5,32,65,97,26,2010-12-02 02:58:22,2010-12-02 02:58:22
eec952351363354cad2e094a10d8545e4d2a996f...691aa96817b9b4c6ad3a43b2d31d6e96a918a999,2,144,7,151,10,2010-12-02 16:35:38,2010-12-02 16:35:38
691aa96817b9b4c6ad3a43b2d31d6e96a918a999...599955586da1c3ad514f3e65f1081d2012ec862d,1,9,39,48,8,2010-12-02 19:48:03,2010-12-02 19:48:03
599955586da1c3ad514f3e65f1081d2012ec862d...654cd5ff7b47b1a9ed64d49ad97be509974dde8d,1,2,2,4,2,2010-12-02 19:50:28,2010-12-02 19:50:28
654cd5ff7b47b1a9ed64d49ad97be509974dde8d...0d2eb2d88b185dcd1c67624fab2a2dc3f08cc532,1,7,0,7,2,2010-12-04 12:25:29,2010-12-04 12:25:29
0d2eb2d88b185dcd1c67624fab2a2dc3f08cc532...02286c3375b24216a81522e0fd3c019343a00df4,2,4,0,4,2,2010-12-04 12:58:06,2010-12-04 12:58:06
02286c3375b24216a81522e0fd3c019343a00df4...d3e2dd5ea174cb14905a5ab48e3b97bcf9f0b97e,1,1,1,2,1,2010-12-04 13:04:12,2010-12-04 13:04:12
d3e2dd5ea174cb14905a5ab48e3b97bcf9f0b97e...6f02c3bad8f563036b9d2035e656bcb847d4c292,11,79,79,158,78,2010-12-05 19:18:56,2010-12-05 19:18:56
6f02c3bad8f563036b9d2035e656bcb847d4c292...86bfec39b55c00ef499e635fdbdca7946c55fcde,1,18,18,36,17,2010-12-05 23:13:09,2010-12-05 23:13:09
86bfec39b55c00ef499e635fdbdca7946c55fcde...7d7cd8857a451ff50b126e452bcbdc0fb397db35,15,2201,1874,4075,167,2010-12-05 23:14:15,2010-12-03 16:01:30
7d7cd8857a451ff50b126e452bcbdc0fb397db35...d12299fe22e549a20e632668fdbe13cab9def9df,30,411,316,727,70,2010-12-05 23:14:15,2010-12-03 20:22:10
d12299fe22e549a20e632668fdbe13cab9def9df...44908fe763b1a2097b65c86130ac679c458df7d2,68,109,109,218,61,2010-12-06 21:03:16,2010-12-06 21:03:16
44908fe763b1a2097b65c86130ac679c458df7d2...f591833095ad9a3bbff42c76531131f7ec6a2954,16,406,15,421,33,2010-12-06 21:08:31,2010-12-06 21:08:31
f591833095ad9a3bbff42c76531131f7ec6a2954...a44fc1d413bc1e2f0ed82aff60ce2069c33d2eda,4,19,14,33,9,2010-12-06 21:36:21,2010-12-06 21:13:00
a44fc1d413bc1e2f0ed82aff60ce2069c33d2eda...4eec2c0d4a332ffb9237a0851578ec388e1f99f4,1,13,3,16,3,2010-12-07 01:55:46,2010-12-07 01:55:46
4eec2c0d4a332ffb9237a0851578ec388e1f99f4...635cacc6eb0a425ac284184d25a26d9b0a672fc6,2,22,1,23,2,2010-12-08 18:35:55,2010-12-08 18:10:48
635cacc6eb0a425ac284184d25a26d9b0a672fc6...9de351b2581f41ee049326ddbfb7deddd3710561,2,13,21,34,2,2010-12-10 02:38:15,2010-12-09 21:06:02
9de351b2581f41ee049326ddbfb7deddd3710561...6c14d641234d74dcc8a9e09ce1a6d461b3c193e9,1,3,1,4,2,2010-12-10 02:45:20,2010-12-09 19:55:54
6c14d641234d74dcc8a9e09ce1a6d461b3c193e9...2cd6d6866e45939c7a60ff5f4cca52b02c8af498,5,162,167,329,38,2010-12-10 03:53:39,2010-12-10 03:53:39
2cd6d6866e45939c7a60ff5f4cca52b02c8af498...583cf1696abc5d9f15dbe2f89ca6ba3dc0a4b182,1,50,0,50,1,2010-12-11 22:19:49,2010-12-04 16:31:53
583cf1696abc5d9f15dbe2f89ca6ba3dc0a4b182...ec821ca6e434547c46e4dc66c534b78f79535b08,1,20,0,20,1,2010-12-11 22:19:56,2010-12-04 16:41:04
ec821ca6e434547c46e4dc66c534b78f79535b08...7cbdaf7ffa9a581ccf83d9d6d05c05b203de03ae,1,26,10,36,6,2010-12-11 22:20:08,2010-12-05 13:51:10
7cbdaf7ffa9a581ccf83d9d6d05c05b203de03ae...73c46d539fae5a54bb557428ccebb7c317f23399,2,50,14,64,14,2010-12-11 22:20:17,2010-12-05 17:25:48
73c46d539fae5a54bb557428ccebb7c317f23399...6484008297bac1e5ee96c87ee26dfa4c51e2daf2,1,1,1,2,1,2010-12-11 22:20:31,2010-12-05 17:38:06
6484008297bac1e5ee96c87ee26dfa4c51e2daf2...5b8bb8e7c66fa4477301da8ce99499c2ff60e168,2,21,8,29,10,2010-12-11 22:20:31,2010-12-06 23:54:33
5b8bb8e7c66fa4477301da8ce99499c2ff60e168...032db4d01526e9d8421feca7d520a90d6b0ea991,1,4,3,7,3,2010-12-11 22:20:31,2010-12-07 02:33:43
032db4d01526e9d8421feca7d520a90d6b0ea991...bfe0658ec6ecf67ab53b789f54743113f80ef2ff,2,16,6,22,8,2010-12-11 22:20:43,2010-12-10 12:29:31
bfe0658ec6ecf67ab53b789f54743113f80ef2ff...2619dee4300cc0ef74b10cdee3d0f07eae1f6e65,3,0,322,322,3,2010-12-11 22:22:57,2010-12-11 21:39:24
2619dee4300cc0ef74b10cdee3d0f07eae1f6e65...e0d9e12e502582d33f3e54bd77b274aaadbd60c6,1,40,153,193,28,2010-12-11 22:23:19,2010-12-11 22:01:26
2cd6d6866e45939c7a60ff5f4cca52b02c8af498...13710f1e86d9048b88361092a94b4648aeb864fd,9,109,14,123,29,2010-12-10 15:30:06,2010-12-10 15:30:06
13710f1e86d9048b88361092a94b4648aeb864fd...fee065a0698a177811998580700a21214b69ab18,1,6,0,6,1,2010-12-11 14:34:37,2010-12-11 14:34:37
fee065a0698a177811998580700a21214b69ab18...7161beb11e84f9daac7fd25d547bfb40cdff50f0,1,1,1,2,1,2010-12-11 14:38:22,2010-12-11 14:38:22
7161beb11e84f9daac7fd25d547bfb40cdff50f0...5a386e4d0aef5ff72fe0fdd419244f2da28804db,1,16,10,26,7,2010-12-11 14:50:07,2010-12-11 14:50:07
5a386e4d0aef5ff72fe0fdd419244f2da28804db...b76d984e0bc15440443022aa9facfbab8b976e08,1,32,0,32,1,2010-12-11 15:20:57,2010-12-11 15:20:57
e0d9e12e502582d33f3e54bd77b274aaadbd60c6...1f080e2da4833004fd178f622271879336085e22,4,33,8,41,13,2010-12-13 01:43:56,2010-12-13 01:43:56
5cccfa899926a93c12af8232c0c0d16c0c9c7ff2...638c2ca4281589b73f2d402bb80775242045144a,18,245,231,476,125,2010-12-18 00:35:33,2010-12-18 00:10:25
1f080e2da4833004fd178f622271879336085e22...4b8e27c81e78cb0d8ad941c22a9b40835e0319db,2,132,0,132,3,2010-12-15 17:25:15,2010-12-15 17:25:15
4b8e27c81e78cb0d8ad941c22a9b40835e0319db...08190e2ad10cf528ec01868cfc66ddd5d6ad228e,1,10,25,35,16,2010-12-16 14:39:25,2010-12-16 13:31:24
08190e2ad10cf528ec01868cfc66ddd5d6ad228e...1a5204a788c63fb50a42430a02c3dc9df727c5f4,2,6,0,6,2,2010-12-17 09:08:01,2010-12-17 09:08:01
1a5204a788c63fb50a42430a02c3dc9df727c5f4...58fcfc26e08b9b3ed607e32e5eb2fe8a95a8a19c,1,1,21,22,3,2010-12-17 09:36:58,2010-12-17 09:36:58
58fcfc26e08b9b3ed607e32e5eb2fe8a95a8a19c...a67a096a9efdca1af66abc39c4bc276ebdaa8e47,1,15,0,15,4,2010-12-17 09:41:56,2010-12-17 09:41:56
a67a096a9efdca1af66abc39c4bc276ebdaa8e47...f0b2bfe52743e98e241405008744d39f12e521b3,1,8,1,9,1,2010-12-17 13:24:47,2010-12-17 13:24:47
f0b2bfe52743e98e241405008744d39f12e521b3...e1f8cad0c98693c170bdd741747d07db8adb4367,2,50,9,59,9,2010-12-17 13:45:02,2010-12-17 13:45:02
e1f8cad0c98693c170bdd741747d07db8adb4367...d13e7e02a8b3fdcfe0e633fcbfc2521f502eb74e,2,2,1,3,2,2010-12-17 14:58:30,2010-12-17 14:58:30
d13e7e02a8b3fdcfe0e633fcbfc2521f502eb74e...2899093835b3aac641e594f717142fcce065c479,1,10,2,12,3,2010-12-17 19:03:20,2010-12-17 19:03:20
2899093835b3aac641e594f717142fcce065c479...1c2c7c0d1663bcdd279a0a73f6673ab5f81f7ec5,1,11,0,11,2,2010-12-19 14:08:53,2010-12-19 14:08:53
b5ced41e85d4657376d3d6f53d8dc08ed3dcdacc...f70cbbc511b4979ae8dfaa7631ea80add7ccf9dc,1,15,5,20,7,2010-12-18 01:16:04,2010-12-18 01:16:04
f70cbbc511b4979ae8dfaa7631ea80add7ccf9dc...8ea7fbc0cd5bdee858cfbb239fa043f075a3cc5f,1,1,1,2,1,2010-12-18 21:27:26,2010-12-18 21:27:26
fe93dabeef1f2757e73757bb2ec2dd3c912325a8...40c44d2fb63dbe484824c9dbc7c098c797ad10a1,3,88,82,170,54,2010-12-19 20:50:20,2010-12-19 20:50:20
40c44d2fb63dbe484824c9dbc7c098c797ad10a1...0847dff5cd6522dbef29958cbafa7a56f409e82a,1,1,1,2,1,2010-12-22 19:57:48,2010-12-22 19:57:48
0847dff5cd6522dbef29958cbafa7a56f409e82a...2a18a792e3674b24f2d6312c039571c64f75dacd,6,38,38,76,18,2010-12-22 20:43:39,2010-12-22 20:43:39
2a18a792e3674b24f2d6312c039571c64f75dacd...11f6646f032c669170453e8e359ac337fa9abbb7,1,2,0,2,1,2010-12-22 20:51:24,2010-12-22 20:51:24
11f6646f032c669170453e8e359ac337fa9abbb7...9f54fe482dd369ebbae67b0b33f7efde206ba249,9,21,132,153,18,2010-12-22 22:15:09,2010-12-22 22:15:09
9f54fe482dd369ebbae67b0b33f7efde206ba249...e7379f338474fad9318faffe5d0b6000ff3e1b30,1,15,27,42,13,2010-12-22 22:43:07,2010-12-22 22:43:07
e7379f338474fad9318faffe5d0b6000ff3e1b30...e035685f272579a8620741aaad521540712c0725,6,35,35,70,17,2010-12-22 22:44:41,2010-12-22 22:44:41
40c44d2fb63dbe484824c9dbc7c098c797ad10a1...a58e6a5fc99929878377e97973ada46ee437ce0b,1,7,0,7,1,2010-12-22 18:40:39,2010-12-22 18:39:13
40c44d2fb63dbe484824c9dbc7c098c797ad10a1...bd6eb23022e0f8d8bbd04d587f402731294f8a68,1,1,1,2,1,2010-12-22 09:09:24,2010-12-22 09:02:18
40c44d2fb63dbe484824c9dbc7c098c797ad10a1...412de9a637e94b877c7762d90c87525f35018083,1,6,1,7,2,2010-12-20 09:43:23,2010-12-20 09:43:23
412de9a637e94b877c7762d90c87525f35018083...2e29957a79592959c7b297722618536f8d977e88,1,5,0,5,2,2010-12-20 09:56:32,2010-12-20 09:56:32
2e29957a79592959c7b297722618536f8d977e88...8ea2c83b5d21a8a15075943eba822b9ca928af3e,1,8,7,15,4,2010-12-20 15:46:13,2010-12-20 15:46:13
8ea2c83b5d21a8a15075943eba822b9ca928af3e...f2d6a23aa6ed823b68d1a81c211044d581972aa3,1,5,4,9,1,2010-12-21 04:21:33,2010-12-21 04:21:33
f2d6a23aa6ed823b68d1a81c211044d581972aa3...23a1edbd04250ac94071dae89d1d3014715e8112,1,19,3,22,2,2010-12-21 04:43:47,2010-12-21 04:43:47
23a1edbd04250ac94071dae89d1d3014715e8112...2c08c3f0742d812bd3790c2541af87634fbb3ab4,1,1,1,2,1,2010-12-21 05:52:07,2010-12-21 05:52:07
e6c8966d37833f6cd6329afa2c71e8c167cfc248...51035184ddcc7f5a4437f57e04474b4bb98d8a49,1,4,1,5,2,2010-12-22 23:00:40,2010-12-22 23:00:40
98e3b298955557ae10d6682ea33eb8ba8a5447a5...951d06e4e99d3a750ead21605bc71e78cfd5ab2d,1,1,1,2,1,2010-12-26 16:00:35,2010-12-26 16:00:35
51035184ddcc7f5a4437f57e04474b4bb98d8a49...e0646b38c7acfcfc1802c987ceaa2c275b4ae226,2,105,0,105,3,2010-12-29 22:31:58,2010-12-29 22:31:58
d5f2520413939b114bdb4da95e6b10ee60e67f4c...fb3cd6bca40ef942898e9d5ae5d9f305deefcc40,1,4,4,8,4,2011-01-03 19:46:18,2011-01-03 19:46:18
fb3cd6bca40ef942898e9d5ae5d9f305deefcc40...e52ed7a5595568f169b3df74b675059c3d04da4a,9,422,330,752,33,2011-01-03 20:34:27,2011-01-03 20:34:27
e52ed7a5595568f169b3df74b675059c3d04da4a...2645053be21dab231c1d97d063acd19ea87f7577,1,5,2,7,2,2011-01-03 23:17:07,2011-01-03 23:17:07
2645053be21dab231c1d97d063acd19ea87f7577...e04c70955100f03ac222068dd7fcd9b377841949,1,2,0,2,1,2011-01-08 16:02:45,2011-01-08 16:02:19
e04c70955100f03ac222068dd7fcd9b377841949...6f9024a72b5de827e213b7e63de613237ae1eba7,1,1,0,1,1,2011-01-08 19:54:14,2011-01-08 19:54:14
6f9024a72b5de827e213b7e63de613237ae1eba7...9ace34c8deb97cb18aafe6bf2aa4a6b69dd5f117,1,14,5,19,4,2011-01-08 20:17:01,2011-01-07 01:07:15
9ace34c8deb97cb18aafe6bf2aa4a6b69dd5f117...a17777d161583401983a6dc1e5a659c9dc2f5257,2,29,2,31,3,2011-01-08 20:17:52,2011-01-07 00:35:43
2645053be21dab231c1d97d063acd19ea87f7577...4b64c37f68a60cfce5ce6dfb5db37e68f0b3aa39,1,1,0,1,1,2011-01-08 10:22:22,2011-01-08 10:22:22
0740b462da240a455ad35e011a44832d04fa2d7a...170d3f2fbbaf529afc209f78fc7ee88b5680eb5d,3,174,0,174,5,2011-01-11 19:12:53,2011-01-11 19:12:53
0740b462da240a455ad35e011a44832d04fa2d7a...073fa812411507d7a96cbabda3f4aef012d92811,1,3,3,6,2,2011-01-10 03:01:38,2011-01-10 03:01:38
073fa812411507d7a96cbabda3f4aef012d92811...0a3bcad07ee1de26dea22451952b55f0568e2985,1,8,3,11,2,2011-01-10 04:12:29,2011-01-10 03:57:06
0a3bcad07ee1de26dea22451952b55f0568e2985...e0c23b88c57a5d765e5572d8ed317a4ba4da102a,1,1,2,3,2,2011-01-11 06:52:45,2011-01-11 06:50:37
e0c23b88c57a5d765e5572d8ed317a4ba4da102a...f0bde7fac0796bb6d7bfe794bd049041f2133905,14,107,43,150,36,2011-01-11 07:31:55,2011-01-11 05:07:45
f0bde7fac0796bb6d7bfe794bd049041f2133905...e52e38d3801f194d8c463266f6acb279856ccf8c,4,40,73,113,6,2011-01-11 23:44:06,2011-01-11 23:42:07
e52e38d3801f194d8c463266f6acb279856ccf8c...c5846fbf24f5c88704b2faa2a0905515936c874b,1,1,1,2,1,2011-01-13 02:34:23,2011-01-13 02:34:23
c5846fbf24f5c88704b2faa2a0905515936c874b...ec3c7a16c260fa6540cfe8daf37c1324100f51bf,3,83,5,88,5,2011-01-13 02:54:14,2011-01-13 02:54:14
b5e567b9fcaa9bed476feb79b2c934ddab05e2b9...e08b246cecac9cb713de3429aed0ab9e5c37327d,1,1,1,2,1,2011-01-20 01:20:39,2011-01-20 01:20:39
e08b246cecac9cb713de3429aed0ab9e5c37327d...e16c2f6a4cfff50907699d73daad2c10565ec686,2,18,2,20,5,2011-01-20 21:03:49,2011-01-20 18:51:34
e16c2f6a4cfff50907699d73daad2c10565ec686...c8f5ff8f65617e6e097dd779492bd7af47232d4f,3,54,20,74,16,2011-01-20 22:43:27,2011-01-20 22:43:27
c8f5ff8f65617e6e097dd779492bd7af47232d4f...37c2d54c8590d3eaeb33aec198089dc917fd351d,1,2,0,2,1,2011-01-20 23:57:13,2011-01-20 23:57:13
37c2d54c8590d3eaeb33aec198089dc917fd351d...b29e8f19300bb95b9f8307f1438193271233adc8,3,17,6,23,8,2011-01-29 00:12:59,2011-01-29 00:12:59
b29e8f19300bb95b9f8307f1438193271233adc8...ae7ffea96132ee8df08f7c18aac6b36acbd689cf,2,48,27,75,11,2011-01-29 01:29:32,2011-01-22 13:04:32
ae7ffea96132ee8df08f7c18aac6b36acbd689cf...9dd34b1e89f9d52397dacba1575e3b25cfd6e52e,1,12,19,31,7,2011-01-29 01:29:32,2011-01-21 13:02:22
9dd34b1e89f9d52397dacba1575e3b25cfd6e52e...4581c22abcb3bbb27f254f06215651df8ce6fee2,1,18,21,39,13,2011-01-29 01:29:32,2011-01-22 13:38:47
4581c22abcb3bbb27f254f06215651df8ce6fee2...618818dcb7ada52e64b694d00806d18d063b77e0,3,213,72,285,6,2011-01-29 01:29:32,2011-01-23 15:15:11
618818dcb7ada52e64b694d00806d18d063b77e0...eb2f3b47904e2fa9e3dbda975d26647a4f7a227f,1,30,20,50,8,2011-01-29 01:29:32,2011-01-23 18:01:57
eb2f3b47904e2fa9e3dbda975d26647a4f7a227f...2e6fd09c5d473b3d157aa457ccc82424406e63e1,4,13,13,26,13,2011-01-29 01:29:33,2011-01-25 20:52:24
2e6fd09c5d473b3d157aa457ccc82424406e63e1...f2c2471389048b8f930ed945ed1acfe004f901a4,3,8,4,12,6,2011-01-29 01:29:41,2011-01-26 19:29:06
f2c2471389048b8f930ed945ed1acfe004f901a4...9282e921a394d422188ee43e18a63d418f88ac95,20,864,7,871,27,2011-01-29 01:39:02,2010-12-27 19:34:19
9282e921a394d422188ee43e18a63d418f88ac95...2f8a8ab24b034cb91e6ce80a7aa8cc330b7baebf,11,637,436,1073,153,2011-01-30 00:35:29,2011-01-28 23:56:25
ec3c7a16c260fa6540cfe8daf37c1324100f51bf...2d5ef6ad0d0f3cd7a722dc5bdfd69a341cd5261d,1,1,0,1,1,2011-01-18 20:35:57,2011-01-18 20:35:57
2f8a8ab24b034cb91e6ce80a7aa8cc330b7baebf...75e051c682255a3c9428200c20c733ec06137b99,2,48,5,53,6,2011-02-01 10:04:43,2011-01-27 19:20:23
75e051c682255a3c9428200c20c733ec06137b99...89f9fc6f4b1a17b8318a0f11a51c967f1504ed34,2,15,3,18,5,2011-02-01 10:04:49,2011-01-28 07:41:59
89f9fc6f4b1a17b8318a0f11a51c967f1504ed34...9217bbda49264e016e4c24950292cd2572ffed51,1,4,2,6,1,2011-02-01 10:04:49,2011-02-01 10:00:52
9217bbda49264e016e4c24950292cd2572ffed51...bf3389b930b8f040cd6a929bddd6fcd0c390f8f8,1,1,4,5,2,2011-02-01 10:57:45,2011-02-01 10:57:45
bf3389b930b8f040cd6a929bddd6fcd0c390f8f8...35786cb7e8d8b06aa211acbc741207d08973920b,1,22,1,23,2,2011-02-03 06:47:26,2011-02-03 00:00:26
2f8a8ab24b034cb91e6ce80a7aa8cc330b7baebf...b70e4f8a0391a8ec9bcc2ba06a30cc4889e93191,1,3,0,3,1,2011-02-01 01:21:53,2011-02-01 01:21:53
b70e4f8a0391a8ec9bcc2ba06a30cc4889e93191...2a1732b43904d67cfeb301a5287b13c5893f9b64,44,3004,3541,6545,135,2011-02-02 00:15:25,2011-02-02 00:15:25
2a1732b43904d67cfeb301a5287b13c5893f9b64...b02c371ee9fe962d6e7264582c168697c2a22f47,1,5,25,30,6,2011-02-02 00:31:58,2011-02-02 00:31:58
b02c371ee9fe962d6e7264582c168697c2a22f47...87d82994be88effef0f1ff22d01bd8310a9167e4,3,10,6,16,8,2011-02-02 00:32:21,2011-02-02 00:32:21
87d82994be88effef0f1ff22d01bd8310a9167e4...ff5873ad950ca2de9f4680e01ee7c8cb258f9874,1,28,5,33,6,2011-02-02 02:01:14,2011-02-02 02:01:14
ff5873ad950ca2de9f4680e01ee7c8cb258f9874...ddc9e79ae2acf6afa9262909649b2984e1b3ff1a,2,13,6,19,5,2011-02-02 04:16:50,2011-02-02 04:16:50
7a689719bd540502bba4842a8aa2546fd1ef8001...9d1dcca229c624c7551a287963a19e95ba4753b6,4,34,4,38,8,2011-02-07 08:35:58,2011-02-07 08:35:58
9d1dcca229c624c7551a287963a19e95ba4753b6...8212e2d7d0fec7e53efddc7e23fc65798afa12a3,1,30,4,34,11,2011-02-07 16:25:23,2011-02-07 16:25:23
8212e2d7d0fec7e53efddc7e23fc65798afa12a3...122c3405830d116f23bf92b879263220be585871,2,14,52,66,9,2011-02-07 16:25:42,2011-02-07 16:25:42
122c3405830d116f23bf92b879263220be585871...911fd457922d9749180719e21f359704f17d88b0,1,1,1,2,1,2011-02-07 23:30:08,2011-02-07 23:30:08
911fd457922d9749180719e21f359704f17d88b0...20e83aa4ef15a18609b883d9aab15a7e600613f0,1,14,3,17,2,2011-02-08 12:14:19,2011-02-08 12:14:19
5d773a6ee8542a5eaf94c34efcd27124c78e0bc7...4569bfa55a44be3a03cf925df44bf1af0f21ddaa,2,23,5,28,11,2011-02-05 07:11:17,2011-02-05 07:11:17
4569bfa55a44be3a03cf925df44bf1af0f21ddaa...c836c332f17ff2da8bdf6d18fb3d59eac2586ca9,8,39,17,56,20,2011-02-05 07:29:37,2011-02-05 07:29:37
c836c332f17ff2da8bdf6d18fb3d59eac2586ca9...f725931b4865317b58c1f1600724cb36e586c332,5,286,90,376,39,2011-02-05 10:42:41,2011-02-05 10:42:41
f725931b4865317b58c1f1600724cb36e586c332...412b3887761be5e8910b824c81b6f3637137446c,2,32,0,32,2,2011-02-05 11:12:02,2011-02-05 11:12:02
772c7e762363d6d5b5627941057775ba06886bb6...995f9c34a580bc17be577d807f9a3bcfd417a748,6,59,83,142,26,2011-02-09 10:43:19,2011-02-09 10:43:19
995f9c34a580bc17be577d807f9a3bcfd417a748...5a800efc42b5c58d06e0335348d75bde82af6ef7,1,63,16,79,6,2011-02-09 10:46:54,2011-02-09 10:46:54
5a800efc42b5c58d06e0335348d75bde82af6ef7...d4b5a4e23a5d6bece88cebb2a53de68eddb4ca68,10,187,30,217,31,2011-02-09 17:49:38,2011-02-09 17:49:02
d4b5a4e23a5d6bece88cebb2a53de68eddb4ca68...81d0ff1ca5db0ab1a3920c96605899c6161467c8,2,4,3,7,3,2011-02-14 21:22:44,2011-02-14 21:22:44
81d0ff1ca5db0ab1a3920c96605899c6161467c8...348c7335dd804ea12eabac7106c5f9675a421ba0,5,419,189,608,60,2011-02-17 21:20:47,2011-02-17 19:32:00
348c7335dd804ea12eabac7106c5f9675a421ba0...084c193562029e0671e208172d62f673dfd3a6f3,1,3,3,6,2,2011-02-17 21:32:22,2011-02-17 21:32:22
084c193562029e0671e208172d62f673dfd3a6f3...3ecc8b5ed984c49e464224133093250bdd5c9c1c,1,4,4,8,2,2011-02-17 22:08:34,2011-02-17 22:08:34
3ecc8b5ed984c49e464224133093250bdd5c9c1c...e822508a055a7d46dc0b9aa06fbc1a49515201c8,1,34,12,46,13,2011-02-18 08:29:55,2011-02-18 08:29:55
e822508a055a7d46dc0b9aa06fbc1a49515201c8...cb77ad0d4e66262393c3fa868a7bc723cfd71d61,1,4,0,4,2,2011-02-18 10:23:53,2011-02-18 10:23:53
cb77ad0d4e66262393c3fa868a7bc723cfd71d61...874c3b6f37e291233be389dbacdb7178af85ad2f,1,11,13,24,9,2011-02-18 12:11:53,2011-02-18 12:11:53
874c3b6f37e291233be389dbacdb7178af85ad2f...817c28201e2a9564b38a624be491245aa025c77f,7,337,409,746,36,2011-02-21 16:13:43,2011-02-21 15:05:16
817c28201e2a9564b38a624be491245aa025c77f...af774b012cba233a577a95ee9b15944df6f3bbbf,2,7,1,8,3,2011-02-21 19:57:27,2011-02-21 12:14:01
af774b012cba233a577a95ee9b15944df6f3bbbf...5591ea15a50d3214830a3d152a78a34bcb5f1966,2,26,0,26,3,2011-02-22 13:19:23,2011-02-22 12:58:54
5591ea15a50d3214830a3d152a78a34bcb5f1966...4378e8d470abae5e9e8f32f98869516c8b86b191,4,57,55,112,10,2011-02-22 13:19:35,2011-02-22 13:15:35
4378e8d470abae5e9e8f32f98869516c8b86b191...fc658755bf980170cf5a497870155a9fc97151cb,6,210,247,457,85,2011-02-22 19:59:36,2011-02-22 19:59:36
fc658755bf980170cf5a497870155a9fc97151cb...c3be146840754d881655fb6b851899fb4a0d7cbd,1,5,2,7,4,2011-02-24 17:31:12,2011-02-24 17:31:12
c3be146840754d881655fb6b851899fb4a0d7cbd...3eb47c9f6768292b8c8f8199ef851812c03aff70,1,12,0,12,2,2011-02-24 19:43:08,2011-02-24 19:43:08
3eb47c9f6768292b8c8f8199ef851812c03aff70...7360122ba973dfea6604ee1b378f79ce6399af3e,1,2,4,6,3,2011-02-24 21:53:40,2011-02-24 21:53:40
7360122ba973dfea6604ee1b378f79ce6399af3e...fc70832a4fe26e3a237876a865e723fb7f4cc79d,2,2,0,2,2,2011-02-24 22:00:36,2011-02-23 05:08:50
fc70832a4fe26e3a237876a865e723fb7f4cc79d...5cfd9ce46286fc3ff3fa8ed278be8a681155cab8,1,1,0,1,1,2011-03-01 20:15:20,2011-03-01 20:15:20
5cfd9ce46286fc3ff3fa8ed278be8a681155cab8...83403e99bae5fe415f30cc834e66c2e589ca46e0,1,1,1,2,1,2011-03-02 19:02:22,2011-03-02 19:02:22
83403e99bae5fe415f30cc834e66c2e589ca46e0...aa2120e9da45017c6fe0126d6e9b1ee20ff40037,5,165,4,169,12,2011-03-03 18:23:48,2011-02-10 14:08:00
aa2120e9da45017c6fe0126d6e9b1ee20ff40037...6a0895adea73deeaa72ee7f921205ffccb70c9bc,2,5,1,6,2,2011-03-03 18:23:48,2011-02-11 12:58:40
6a0895adea73deeaa72ee7f921205ffccb70c9bc...77600378db1e7b7acf423286f8a784d676edc6f2,1,26,26,52,6,2011-03-03 18:23:48,2011-02-13 13:51:45
77600378db1e7b7acf423286f8a784d676edc6f2...e1be10281647e9db93cc88c435c56abacdeb0af0,2,129,8,137,7,2011-03-03 18:23:48,2011-02-13 19:18:35
e1be10281647e9db93cc88c435c56abacdeb0af0...1d8cc73123f915abf345c7333651e99df96770b6,3,179,105,284,58,2011-03-03 18:23:49,2011-02-14 21:29:22
1d8cc73123f915abf345c7333651e99df96770b6...2de3b35cd4cc92a35f45cf2e7e27fc35f866e370,1,24,0,24,2,2011-03-03 18:23:49,2011-02-14 21:32:02
2de3b35cd4cc92a35f45cf2e7e27fc35f866e370...32054c24a26ab386fb56c7333fa723459e7e8dff,3,70,93,163,40,2011-03-03 18:23:49,2011-02-18 16:09:19
32054c24a26ab386fb56c7333fa723459e7e8dff...86194b2433b993666bb58e7818f5b1f4133c9a43,9,274,257,531,126,2011-03-03 18:23:49,2011-02-18 19:57:53
86194b2433b993666bb58e7818f5b1f4133c9a43...b0a8314340a0262eb1e7c9086242cd15b8e0301f,1,1,8,9,3,2011-03-03 18:23:49,2011-02-25 09:06:49
b0a8314340a0262eb1e7c9086242cd15b8e0301f...9b3985fa2f0aece495d42ad5adb6c1d93bfbbe49,1,95,91,186,24,2011-03-03 18:23:49,2011-02-25 09:29:11
9b3985fa2f0aece495d42ad5adb6c1d93bfbbe49...da7c3c71c0cc3a2d5408a7e9885ae8a1b3b928ef,1,1,3,4,2,2011-03-03 18:23:49,2011-02-27 20:07:39
da7c3c71c0cc3a2d5408a7e9885ae8a1b3b928ef...ccef1c9dc22b07398970f26eb9fd3be669db7734,3,24,19,43,4,2011-03-03 18:23:50,2011-02-27 20:09:36
ccef1c9dc22b07398970f26eb9fd3be669db7734...2e60b652908a268a4333a6661e0fb95ccaeec1bc,2,26,2,28,7,2011-03-03 18:23:50,2011-02-27 20:30:28
2e60b652908a268a4333a6661e0fb95ccaeec1bc...17cdf25208202300def293ce1997b97aeb517586,2,6,6,12,6,2011-03-03 18:23:50,2011-02-27 20:31:06
17cdf25208202300def293ce1997b97aeb517586...87d3acf45eb1a63b5847bca2061a993471b8b1ee,4,796,223,1019,99,2011-03-03 18:23:50,2011-02-27 20:31:43
87d3acf45eb1a63b5847bca2061a993471b8b1ee...47d0db78bb1e52925b726450572b17bd7805a196,1,5,0,5,3,2011-03-03 18:23:50,2011-02-25 14:09:31
47d0db78bb1e52925b726450572b17bd7805a196...3b3a10176e6f6c239abad4f835883ee903067180,2,27,0,27,2,2011-03-03 18:23:50,2011-02-25 20:58:25
3b3a10176e6f6c239abad4f835883ee903067180...d2d6912e6ce1ab12d2bedebb5514c888aa7d585f,3,87,121,208,37,2011-03-03 18:23:50,2011-02-26 12:56:16
d2d6912e6ce1ab12d2bedebb5514c888aa7d585f...c38f9013e44d082d604ae98d7850189130b343de,1,4,5,9,5,2011-03-03 18:23:50,2011-02-26 12:56:57
c38f9013e44d082d604ae98d7850189130b343de...705a90ec9e71fbc7ab8b01a8572ca5f953cd81a2,1,47,0,47,3,2011-03-03 18:23:50,2011-02-26 13:07:13
705a90ec9e71fbc7ab8b01a8572ca5f953cd81a2...7167422cbf66252cc7d4978ee66216fb46280ffb,2,15,13,28,6,2011-03-03 18:23:50,2011-02-28 11:16:44
7167422cbf66252cc7d4978ee66216fb46280ffb...e4029c5201ba86edd355266ea0a566995490dc1b,3,61,7,68,8,2011-03-03 18:23:51,2011-02-28 11:33:47
e4029c5201ba86edd355266ea0a566995490dc1b...0594e3efb75c806a53f2ef5693e55ee641788053,1,1,1,2,1,2011-03-03 18:23:51,2011-03-03 17:36:54
0594e3efb75c806a53f2ef5693e55ee641788053...52b2c2092a4b12e4550a6850a9013264a7297af0,1,47,5,52,6,2011-03-03 18:23:51,2011-03-03 17:37:40
52b2c2092a4b12e4550a6850a9013264a7297af0...669db21b288dc06781a35c4516aa19bac84800f6,2,26,3,29,7,2011-03-03 18:23:51,2011-02-28 21:21:18
669db21b288dc06781a35c4516aa19bac84800f6...76f7cf707543dc72f402c2cb4e01453358009670,1,51,14,65,11,2011-03-03 18:23:51,2011-03-03 17:38:54
76f7cf707543dc72f402c2cb4e01453358009670...de05ff6c788dda6e61f4567e6c4dea4f59a8f949,1,46,1,47,2,2011-03-03 18:23:51,2011-03-03 17:40:01
de05ff6c788dda6e61f4567e6c4dea4f59a8f949...e2d426227f3a03ef6de6715d3c471c1490e4bd4c,1,10,0,10,2,2011-03-03 18:23:51,2011-03-03 17:41:27
e2d426227f3a03ef6de6715d3c471c1490e4bd4c...65cc1f44e15b042049f4c29058768e6304fad60f,1,20,0,20,2,2011-03-03 18:23:51,2011-03-03 17:42:11
65cc1f44e15b042049f4c29058768e6304fad60f...129007b423de2c421b4b87f306dcb509e5313caf,1,6,1,7,2,2011-03-03 18:23:51,2011-03-03 17:43:11
129007b423de2c421b4b87f306dcb509e5313caf...6b02b215169d493abe35d8036c3cf687521e08a5,1,23,0,23,2,2011-03-03 18:23:51,2011-03-03 17:43:47
6b02b215169d493abe35d8036c3cf687521e08a5...19a30a3f6e15da184fc449315314af666f2082bf,5,35,6,41,7,2011-03-03 18:23:51,2011-03-03 17:53:17
19a30a3f6e15da184fc449315314af666f2082bf...268bee3d4f54c2c2623a79cdc19151cda32c762f,1,46,0,46,2,2011-03-03 18:23:52,2011-03-03 17:54:34
268bee3d4f54c2c2623a79cdc19151cda32c762f...8f90ced5ed79b445509a5be190add4e76d5bae3f,1,9,0,9,2,2011-03-03 18:23:52,2011-03-03 17:55:48
8f90ced5ed79b445509a5be190add4e76d5bae3f...d561403f08ccf792ed457638bf5c4c9638dc7699,1,45,0,45,2,2011-03-03 18:23:52,2011-03-03 17:57:12
d561403f08ccf792ed457638bf5c4c9638dc7699...5ad0351db1cf4344e0bbf23e27cfb40a5c1d6310,1,16,2,18,5,2011-03-03 18:23:52,2011-03-03 17:58:07
5ad0351db1cf4344e0bbf23e27cfb40a5c1d6310...8fc050961c6f5d3bc8f2bc27799922bebae4b743,1,36,0,36,2,2011-03-03 18:23:52,2011-03-03 17:59:25
8fc050961c6f5d3bc8f2bc27799922bebae4b743...3dccfed16382c64370dd0fd88668c9d9accae6ed,19,622,690,1312,214,2011-03-03 18:23:52,2011-03-03 16:19:05
3dccfed16382c64370dd0fd88668c9d9accae6ed...5de079b86dcf8744f71fa3d0bb496a2cf9b20c0d,14,233,236,469,63,2011-03-03 18:23:52,2011-02-28 10:12:26
5de079b86dcf8744f71fa3d0bb496a2cf9b20c0d...86d7e1ca6f54161a9e4d1ebe7a2f8e4802dc9639,10,73,48,121,36,2011-03-03 18:23:52,2011-02-28 10:46:13
86d7e1ca6f54161a9e4d1ebe7a2f8e4802dc9639...48c27f86bbe9678c7e01a90a2cec7a30327b0e90,12,128,54,182,53,2011-03-03 18:23:52,2011-02-28 14:51:17
48c27f86bbe9678c7e01a90a2cec7a30327b0e90...971c90befe4dfac4c235fa59d65f7e652fc27e1d,1,1,1,2,1,2011-03-03 18:23:52,2011-02-28 14:54:13
971c90befe4dfac4c235fa59d65f7e652fc27e1d...584f49a5ceff463581f7f1b8bc23880dabca27ac,5,86,33,119,16,2011-03-03 18:23:53,2011-02-28 23:37:28
584f49a5ceff463581f7f1b8bc23880dabca27ac...71d33382a7c55e4dd72b32cea3e4dcb7a549ab79,21,9,9,18,7,2011-03-03 18:23:53,2011-03-03 18:20:45
71d33382a7c55e4dd72b32cea3e4dcb7a549ab79...b64e11d1fe13a15edbe0f26dc5aaf96aa07f9d91,1,2,2,4,2,2011-03-03 18:23:53,2011-03-03 18:23:04
b64e11d1fe13a15edbe0f26dc5aaf96aa07f9d91...3c41c635fbe330da902f8ccde6494cf7709dfea7,1,1,1,2,1,2011-03-03 19:58:37,2011-03-03 19:58:37
3c41c635fbe330da902f8ccde6494cf7709dfea7...c3a41e5f14ddd1d0fe5faf9d457ffea8bff0d366,1,1,0,1,1,2011-03-03 20:01:15,2011-03-03 20:01:15
c3a41e5f14ddd1d0fe5faf9d457ffea8bff0d366...f7fcb0dd1be9c6b863468303d082c27e2583bb13,1,1,1,2,1,2011-03-04 13:10:16,2011-03-04 13:10:16
f7fcb0dd1be9c6b863468303d082c27e2583bb13...e06dd9b6d650008c1b0731dea2de5dea1884fd28,1,1,1,2,1,2011-03-04 13:23:52,2011-03-04 13:23:52
e06dd9b6d650008c1b0731dea2de5dea1884fd28...f335b42c72fbc4842295f52b0654a8c54716847d,7,43,37,80,27,2011-03-05 00:05:26,2011-03-04 23:17:59
f335b42c72fbc4842295f52b0654a8c54716847d...45314a7e4abc0c5b051d3ca647eb0763c22c2b1e,2,18,9,27,8,2011-03-05 07:31:28,2011-03-05 07:13:02
45314a7e4abc0c5b051d3ca647eb0763c22c2b1e...e0011be3301db9b287226c6c8f1794c912bb0241,1,71,51,122,29,2011-03-05 11:22:16,2011-03-05 11:22:16
e0011be3301db9b287226c6c8f1794c912bb0241...3490188b3c40b7a6cddd4acb11ee76db171dc5ef,2,2,2,4,2,2011-03-05 11:29:50,2011-03-05 11:29:50
3490188b3c40b7a6cddd4acb11ee76db171dc5ef...9de27ad0c453f98844cc91ce4e39d338b1fb8338,2,19,5,24,9,2011-03-05 11:46:27,2011-02-25 17:05:29
9de27ad0c453f98844cc91ce4e39d338b1fb8338...545a6915eb7aaa8bfeed16e93090cf1360c37013,2,3,2,5,3,2011-03-05 11:46:37,2011-03-05 11:45:05
545a6915eb7aaa8bfeed16e93090cf1360c37013...60cb1d10b3eb0e7966be1c40501524dc10e4c512,1,1,1,2,1,2011-03-05 11:56:14,2011-03-05 11:56:14
60cb1d10b3eb0e7966be1c40501524dc10e4c512...246eba80af31d25a1fb14e707f79374cf91f8bb7,1,2,2,4,2,2011-03-05 11:58:47,2011-03-05 11:58:47
246eba80af31d25a1fb14e707f79374cf91f8bb7...55ffebe37768b2b839f5501f76e77e89d9f91882,4,41,19,60,6,2011-03-05 12:34:32,2011-03-05 12:34:32
412b3887761be5e8910b824c81b6f3637137446c...95901128b88ab1a784e39c5a87328d602af23074,2,347,346,693,3,2011-02-05 16:17:01,2011-02-05 16:17:01
95901128b88ab1a784e39c5a87328d602af23074...c041af95a2f382b167c59d739323bd84cbdda235,7,421,8,429,12,2011-02-05 17:45:57,2011-02-05 17:45:57
412b3887761be5e8910b824c81b6f3637137446c...40be9ae0a80189d5d27307108323e7ed0cc5f539,1,2,1,3,2,2011-02-05 14:03:48,2011-02-05 14:03:48
55ffebe37768b2b839f5501f76e77e89d9f91882...74bcb63fae8595a181730f3c86ca9eeefb680053,1,1,0,1,1,2011-03-07 18:13:56,2011-03-07 18:13:56
74bcb63fae8595a181730f3c86ca9eeefb680053...b760fbf539e1ce17ac2768da755834babf700b9a,1,22,11,33,5,2011-03-07 19:19:33,2011-03-07 19:18:05
b760fbf539e1ce17ac2768da755834babf700b9a...26022f0719f652ae8311abea6f6de92bd4a75a87,3,324,0,324,5,2011-03-14 21:36:10,2011-03-05 21:54:49
26022f0719f652ae8311abea6f6de92bd4a75a87...71db842fac3ba8582255bc5b61361ddef08ef105,8,636,404,1040,130,2011-03-14 21:52:15,2011-03-08 12:57:03
71db842fac3ba8582255bc5b61361ddef08ef105...58d06cf120eb9bb9247bb807bb105981bb3482a8,2,1058,858,1916,216,2011-03-14 21:52:25,2011-03-09 23:06:24
58d06cf120eb9bb9247bb807bb105981bb3482a8...005718280712634486a097427212e652b0e29f36,5,135,0,135,9,2011-03-14 21:52:32,2011-03-12 14:04:46
005718280712634486a097427212e652b0e29f36...6b2a19418cb08e7bccefc2362f290a67555594a0,15,173,254,427,100,2011-03-14 21:52:32,2011-03-12 21:09:16
6b2a19418cb08e7bccefc2362f290a67555594a0...7064938bd5e7ef47bfd79a685a62c1e2649e2ce7,2,4,4,8,4,2011-03-14 22:02:29,2011-03-14 21:55:32
7064938bd5e7ef47bfd79a685a62c1e2649e2ce7...7c8a7b91431fc72a17ec579bcbca3a596071eeb1,1,10,16,26,3,2011-03-15 00:45:49,2011-03-15 00:45:49
7c8a7b91431fc72a17ec579bcbca3a596071eeb1...bd1aa741a4e7b2b83991e7bccbfe55960929af9e,1,3,0,3,1,2011-03-15 00:56:19,2011-03-13 23:07:37
bd1aa741a4e7b2b83991e7bccbfe55960929af9e...1ee32c6dd98809e64b4178e0260dca648e287613,1,4,0,4,1,2011-03-15 00:56:32,2011-03-13 23:33:45
1ee32c6dd98809e64b4178e0260dca648e287613...ab6a3d3de5e869253c64c1329ff73c71c2b89209,19,8808,22,8830,30,2011-03-15 01:29:20,2011-03-15 01:25:44
55ffebe37768b2b839f5501f76e77e89d9f91882...d6b5f5cca9904763b117efb0d0d4bad7f2412b7b,3,324,0,324,5,2011-03-05 21:54:49,2011-03-05 21:54:49
d6b5f5cca9904763b117efb0d0d4bad7f2412b7b...86627121c8611a1dd5d2daa2e81000ab29847de5,1,1,1,2,1,2011-03-05 22:03:31,2011-03-05 22:03:31
86627121c8611a1dd5d2daa2e81000ab29847de5...a3002d5694bf27b9c49ff585faa3ceade3af5dd6,1,417,0,417,1,2011-03-05 22:21:48,2011-01-28 23:58:55
a3002d5694bf27b9c49ff585faa3ceade3af5dd6...5d4cd0030569f0551cb0b7e432d0f496c50a118c,5,94,30,124,5,2011-03-28 15:03:08,2011-03-28 15:02:45
5d4cd0030569f0551cb0b7e432d0f496c50a118c...a69053c715f1e1780766201ffa9d720f91aa5736,1,388,388,776,1,2011-03-28 15:12:53,2011-03-28 15:12:53
a69053c715f1e1780766201ffa9d720f91aa5736...e4c796f1a2f767d56f32d237d797109c96fd23ef,1,31,6,37,5,2011-03-28 15:51:18,2011-03-28 15:51:18
e4c796f1a2f767d56f32d237d797109c96fd23ef...908afb771ad6a788dd250beede65dd129962da00,1,37,12,49,16,2011-03-28 15:53:04,2011-03-28 15:53:04
908afb771ad6a788dd250beede65dd129962da00...3b4835c25a41781d27a667dbd02ff03d54d221b9,1,39,1,40,7,2011-03-28 16:07:22,2011-03-28 16:07:22
3b4835c25a41781d27a667dbd02ff03d54d221b9...4e02504f5232e38d116830aaf25bcea4d5123a45,1,10,10,20,5,2011-03-29 10:17:29,2011-03-29 10:10:30
4e02504f5232e38d116830aaf25bcea4d5123a45...9f7f4122cfa49f8932fd65f9751d96125c8155bc,1,8,3,11,2,2011-03-29 10:19:53,2011-03-29 10:19:53
9f7f4122cfa49f8932fd65f9751d96125c8155bc...05314b5bf449211726ca7d84f15db3077375a3cd,2,2,2,4,2,2011-03-29 10:25:46,2011-03-29 10:25:46
05314b5bf449211726ca7d84f15db3077375a3cd...238df5590cfb9f1cfc340938188b2425f9510f48,2,4,4,8,3,2011-03-29 10:48:47,2011-03-29 10:29:21
238df5590cfb9f1cfc340938188b2425f9510f48...3d23b74af75bc35b3676c1a7fc1f5a0299c9f4ee,1,17,0,17,3,2011-03-29 11:50:37,2011-03-29 11:50:37
3d23b74af75bc35b3676c1a7fc1f5a0299c9f4ee...6d7bb4e039f6f6cf4e8542024550840a4ba50624,2,11,8,19,3,2011-03-29 15:35:02,2011-03-29 15:35:02
6d7bb4e039f6f6cf4e8542024550840a4ba50624...e15afc8e7cf6f6508d402134e0df772c4012ce77,1,1,0,1,1,2011-03-29 16:07:01,2011-03-29 15:37:03
e15afc8e7cf6f6508d402134e0df772c4012ce77...26faa3668fedf1ffc95ef747b28f08b7131870f4,1,17,0,17,3,2011-03-29 16:13:47,2011-03-29 15:59:13
26faa3668fedf1ffc95ef747b28f08b7131870f4...9a3c5e55fd7894b8732a8010c94d034d674adbf7,2,259,2,261,7,2011-03-29 16:13:47,2011-03-29 15:44:10
9a3c5e55fd7894b8732a8010c94d034d674adbf7...2e445cacd23dd494e182024cf1b229a3727339aa,1,15,7,22,3,2011-03-30 09:34:04,2011-03-30 09:07:09
2e445cacd23dd494e182024cf1b229a3727339aa...2974aa94c33b3845db3c999354d4202ff2b5bd2d,4,116,124,240,40,2011-03-30 11:42:24,2011-03-30 09:30:40
2974aa94c33b3845db3c999354d4202ff2b5bd2d...934fcf78f2877008979a6729fab5e81de2fd1d65,1,4,3,7,2,2011-03-30 11:42:25,2011-03-30 09:32:08
934fcf78f2877008979a6729fab5e81de2fd1d65...d28830c2555820925d2d5ecf10d07436385d37d8,1,9,3,12,4,2011-03-30 11:43:01,2011-03-30 11:40:19
d28830c2555820925d2d5ecf10d07436385d37d8...dadc0158fb9fd06f564ce92495dfe3ad9c4a9de8,2,82,38,120,24,2011-03-30 13:44:23,2011-03-30 13:05:15
dadc0158fb9fd06f564ce92495dfe3ad9c4a9de8...e21881d1db1bcb8b379743b6b28c17187e8ec1a0,1,3,3,6,2,2011-03-30 13:44:23,2011-03-30 13:16:25
e21881d1db1bcb8b379743b6b28c17187e8ec1a0...8ecc5ae5cb5a1efed3c570511fecb6bfdd9cdbc3,1,4,5,9,2,2011-03-30 14:50:28,2011-03-30 14:48:14
8ecc5ae5cb5a1efed3c570511fecb6bfdd9cdbc3...df22949a3566e2514c963d9eec2f0e82c05a18e9,1,2,2,4,1,2011-03-31 13:05:12,2011-03-31 10:51:17
df22949a3566e2514c963d9eec2f0e82c05a18e9...923fe4557f441f1cb94e02acda527d2785726afa,2,18,0,18,3,2011-03-31 13:05:12,2011-03-30 14:02:57
923fe4557f441f1cb94e02acda527d2785726afa...0bbaf9aaef875daf6e5db6bec143b7b84d906524,1,1,2,3,1,2011-03-31 13:05:12,2011-03-30 14:11:55
0bbaf9aaef875daf6e5db6bec143b7b84d906524...d7354d70b0cc56f16b3dece3bf271eaffaeaf029,1,7,3,10,2,2011-03-31 13:05:12,2011-03-30 14:22:31
d7354d70b0cc56f16b3dece3bf271eaffaeaf029...6482929b5fda7e63d07b8bf76b2a273585e15bea,1,28,26,54,2,2011-03-31 13:05:12,2011-03-30 16:51:02
6482929b5fda7e63d07b8bf76b2a273585e15bea...11d0e70578baf47fb1cb565e0336e18d417e5da6,1,218,20,238,20,2011-03-31 13:21:54,2011-03-31 08:50:11
fb8dd803b76020cc42103b506aed4c975ca047bd...5bf42916378b49f2790b4da91cb056cd9e08f686,1,2,2,4,2,2011-02-07 05:11:00,2011-02-07 05:11:00
5bf42916378b49f2790b4da91cb056cd9e08f686...e769e0255ea46a96c6de8dfeb1f762ebbb4cebd9,1,1,1,2,1,2011-02-07 05:11:17,2011-02-07 05:11:17
fb8dd803b76020cc42103b506aed4c975ca047bd...56ab8c5437cb4d92e34d088c6c134b311bc179b5,1,1,1,2,1,2011-02-06 06:48:52,2011-02-06 06:48:52
fb8dd803b76020cc42103b506aed4c975ca047bd...ca0fb40a6f3ec2b1a254e0d5e5f307cbed541251,1,2,0,2,1,2011-02-05 18:23:51,2011-02-05 16:18:27
ca0fb40a6f3ec2b1a254e0d5e5f307cbed541251...a79e8e632a674934843612084cd654475c2c85b5,2,32,1,33,4,2011-02-05 18:23:51,2011-02-05 18:22:44
a79e8e632a674934843612084cd654475c2c85b5...fc8afc87d78c79c57b6448f9b92e47f3f2515f38,1,2,0,2,1,2011-02-06 06:48:17,2011-02-06 06:48:17
40be9ae0a80189d5d27307108323e7ed0cc5f539...1af8c7488d99e4eeeec31c5a1e7e43cd003983e3,2,47,4,51,9,2011-02-05 14:24:08,2011-02-05 14:24:08
ab6a3d3de5e869253c64c1329ff73c71c2b89209...4ca2d7e444db794375974eccb915997cf2be1414,22,4502,458,4960,239,2014-06-11 14:10:00,2014-06-11 14:10:00
ab6a3d3de5e869253c64c1329ff73c71c2b89209...11a203e1b174fc3ec923be9ea53d0451f75e21f5,1,1,0,1,1,2011-03-15 01:31:52,2011-03-15 01:31:52
11a203e1b174fc3ec923be9ea53d0451f75e21f5...5f8078d4dc325356e732c1a5e62acb7de04d72be,1,19,391,410,13,2011-03-15 02:22:47,2011-03-15 02:03:54
5f8078d4dc325356e732c1a5e62acb7de04d72be...7ad96e51ca81974c417914edbc81a63e390c4301,2,23,12,35,8,2011-03-15 03:38:50,2011-03-15 03:38:50
7ad96e51ca81974c417914edbc81a63e390c4301...434bedcda0a7edb4fcc2dda6eb3df0310c2d0774,2,5,5,10,4,2011-03-15 17:46:38,2011-03-15 17:46:38
434bedcda0a7edb4fcc2dda6eb3df0310c2d0774...d40d30cb76ddcc9935471af0fb6fa6b2a66efc4c,1,6,0,6,3,2011-03-15 17:54:45,2011-03-15 17:54:45
d40d30cb76ddcc9935471af0fb6fa6b2a66efc4c...b5abb881a623b8b492e0375b8e9c8936079c39bb,2,21,1,22,4,2011-03-15 17:55:01,2011-03-15 17:55:01
b5abb881a623b8b492e0375b8e9c8936079c39bb...bbcc7ffc690c4065954102530447aef4e8ccf895,8,248,146,394,25,2011-03-15 19:14:07,2011-03-15 19:04:41
bbcc7ffc690c4065954102530447aef4e8ccf895...f73b09cd9a36e1d02fe5b6ad33053e60ac88bc7a,1,13,31,44,8,2011-03-15 19:19:53,2011-03-15 19:19:02
f73b09cd9a36e1d02fe5b6ad33053e60ac88bc7a...36b313296638f8ae349e400ba9a7f5bbfb92b96f,1,8,4,12,4,2011-03-15 23:04:17,2011-03-15 23:04:17
36b313296638f8ae349e400ba9a7f5bbfb92b96f...955f9ae9bd25ceb59775463e04c0276209387b67,2,10,8,18,2,2011-03-15 23:06:15,2011-03-15 23:06:15
955f9ae9bd25ceb59775463e04c0276209387b67...54a1b36c257a490f13a26d92d4c8e5e3912d00cd,1,1,1,2,1,2011-03-15 23:07:06,2011-03-15 23:07:06
54a1b36c257a490f13a26d92d4c8e5e3912d00cd...8613d4a930541dccdc948cb18e313551ec42cb0e,1,1,1,2,1,2011-03-15 23:10:40,2011-03-15 23:10:40
8613d4a930541dccdc948cb18e313551ec42cb0e...36aaf1ff1a8540c364050f62f19f3021b6e121eb,5,157,113,270,34,2011-03-15 23:53:25,2011-03-15 23:53:25
36aaf1ff1a8540c364050f62f19f3021b6e121eb...9f81a37aa416446726a00996dce01b02372a43b1,3,1,6,7,3,2011-03-16 21:02:31,2011-03-16 21:02:31
9f81a37aa416446726a00996dce01b02372a43b1...7341bf87b111dfa0cf12761389e0e7a118363f42,2,131,56,187,29,2011-03-16 21:28:27,2011-03-16 21:13:28
7341bf87b111dfa0cf12761389e0e7a118363f42...b5c5f0f8086ee4e9bccf0703386fd5219ac380c2,7,3,18,21,8,2011-03-16 21:59:09,2011-03-16 21:59:09
b5c5f0f8086ee4e9bccf0703386fd5219ac380c2...bb3de0c472b2d5d6b8091c190bee3db79c4b5e27,11,375,70,445,34,2011-03-20 19:45:06,2011-03-16 19:35:51
bb3de0c472b2d5d6b8091c190bee3db79c4b5e27...72a3fe42fb7208712bbe8f0981f4c6274c05e9c3,48,1429,1643,3072,478,2011-03-20 19:45:11,2011-03-18 17:38:49
72a3fe42fb7208712bbe8f0981f4c6274c05e9c3...99baacfb5687c266df78be4442d30f2f2dc19a28,3,4,11,15,5,2011-03-21 17:27:45,2011-03-21 17:27:45
99baacfb5687c266df78be4442d30f2f2dc19a28...70236bab2d64a4d34203b4e2bbc5d8f518ba618d,1,11,5,16,5,2011-03-21 17:39:06,2011-03-21 17:39:06
70236bab2d64a4d34203b4e2bbc5d8f518ba618d...567fc1d20c734c34dd1c4c19be12abcc1622aa5d,1,1,0,1,1,2011-03-22 18:37:34,2011-03-22 11:47:53
567fc1d20c734c34dd1c4c19be12abcc1622aa5d...b932ef5b3d77b26b8f558bafa3ee416595279dce,1,4,0,4,2,2011-03-22 18:38:30,2011-03-21 17:44:43
b932ef5b3d77b26b8f558bafa3ee416595279dce...1881f0783b6dd23fb40ba0b43a4ec98bb08a637c,2,62,0,62,2,2011-03-22 18:38:33,2011-03-21 18:28:02
1881f0783b6dd23fb40ba0b43a4ec98bb08a637c...21d73e7195a427b39c1c3742c85254e8384f5802,1,11,0,11,2,2011-03-22 18:38:36,2011-03-22 18:26:01
21d73e7195a427b39c1c3742c85254e8384f5802...fe1920206b7fb780486dcef14d0d6f01835b430d,1,1,1,2,1,2011-03-22 18:44:43,2011-03-22 03:27:54
fe1920206b7fb780486dcef14d0d6f01835b430d...56d8ca266c92e51a1b38ac68b7aa6a24193f5812,9,19,19,38,14,2011-03-22 22:07:58,2011-03-20 17:36:25
56d8ca266c92e51a1b38ac68b7aa6a24193f5812...ae6ba7f713804e1c04febee81a8f52ea0abf443b,1,1,1,2,1,2011-03-22 22:08:16,2011-03-22 18:45:01
ae6ba7f713804e1c04febee81a8f52ea0abf443b...677a3c07f47f46dcbab4a3ee8a1e2aace6f999b0,3,55,0,55,4,2011-03-22 22:17:24,2011-03-15 21:07:01
677a3c07f47f46dcbab4a3ee8a1e2aace6f999b0...6279abda7370ebb046571437012dc6bb96e1edba,1,2,2,4,2,2011-03-22 22:17:24,2011-03-17 05:56:58
6279abda7370ebb046571437012dc6bb96e1edba...c90292ce4f852ff9f0e8ec4ddc7cdc438745790d,5,231,193,424,47,2011-03-22 22:17:24,2011-03-18 15:56:43
c90292ce4f852ff9f0e8ec4ddc7cdc438745790d...3644e98fd984c039d0c84b2311b410583739b6a5,2,39,5,44,5,2011-03-22 22:17:25,2011-03-18 18:10:36
3644e98fd984c039d0c84b2311b410583739b6a5...ba1bdf86e74777f1a597ac2737dddd7965f41711,1,34,1,35,3,2011-03-22 22:24:51,2011-03-18 21:27:15
ba1bdf86e74777f1a597ac2737dddd7965f41711...f428ae615b4386e78cb337386b3d8e190e921766,2,2,8,10,5,2011-03-22 22:25:04,2011-03-19 07:19:34
f428ae615b4386e78cb337386b3d8e190e921766...2b861d7589467734c2371c4daaab6e540857b988,1,3,0,3,1,2011-03-22 22:25:04,2011-03-19 07:31:40
2b861d7589467734c2371c4daaab6e540857b988...3fe9c60c6ad66d4637c7669c0661b5097918ddbd,16,31,0,31,8,2011-03-22 22:25:04,2011-03-22 22:21:30
3fe9c60c6ad66d4637c7669c0661b5097918ddbd...29e1797c14c4c67f5f941130bdda835b8c74869e,2,29,0,29,2,2011-03-22 22:25:04,2011-03-05 13:26:22
29e1797c14c4c67f5f941130bdda835b8c74869e...2ce44b67f3398ff3c1bfdfd60a99f72bd0c42e90,1,16,0,16,2,2011-03-22 22:25:04,2011-03-05 13:33:31
2ce44b67f3398ff3c1bfdfd60a99f72bd0c42e90...a8375f532204f4c0c70a3f937b47000b61669725,1,19,0,19,2,2011-03-22 22:25:05,2011-03-05 14:09:01
a8375f532204f4c0c70a3f937b47000b61669725...7c80c19e1dffb4421f91913bc79b9cb7596634a4,2,2,2,4,2,2011-03-22 23:58:18,2011-03-22 23:58:18
7c80c19e1dffb4421f91913bc79b9cb7596634a4...b0b8313583afdcd54a83ba3855cf3f6f287ae0ab,4,71,0,71,4,2011-03-23 10:08:42,2011-03-22 15:15:50
b0b8313583afdcd54a83ba3855cf3f6f287ae0ab...f0d08b7cec782634e550ad0cd52a705b2c87244c,1,6,10,16,2,2011-03-23 13:40:47,2011-03-23 13:40:47
f0d08b7cec782634e550ad0cd52a705b2c87244c...c0ffe518539073cac6b54249fa11d380ba85049c,4,4,4,8,4,2011-03-23 13:44:52,2011-03-23 13:44:52
c0ffe518539073cac6b54249fa11d380ba85049c...08db1efd3d64bda358071612ff3662f4bf1aea61,1,1,0,1,1,2011-03-23 13:53:12,2011-03-23 13:53:12
08db1efd3d64bda358071612ff3662f4bf1aea61...f6f72d7ef8091bf1fcf19f284e1db62a43f93381,7,71,74,145,12,2011-03-23 16:44:53,2011-03-23 16:44:53
f6f72d7ef8091bf1fcf19f284e1db62a43f93381...c585f55ff454bfc2d97e2db6b10fd8eab31b119d,1,3,3,6,3,2011-03-23 16:55:41,2011-03-23 11:35:08
c585f55ff454bfc2d97e2db6b10fd8eab31b119d...ea269511adee9db7343b802832626dba3f9c382e,1,1,1,2,1,2011-03-23 16:55:44,2011-03-23 13:57:41
ea269511adee9db7343b802832626dba3f9c382e...815c9bc7debb7493f18cb7bca1febc11f5ea3ea6,1,0,1,1,1,2011-03-23 18:18:34,2011-03-23 18:18:34
815c9bc7debb7493f18cb7bca1febc11f5ea3ea6...f3cf7f6df1d2e2fcbd4f22dae318fbc4570833d8,1,1,0,1,1,2011-03-24 00:06:49,2011-03-24 00:06:49
f026f2b9ee5f0aeced5c366c890c4a29eee2a1c7...fe116e261ffb7d643c9a6baee70fbfa07a20588f,1,2,4,6,3,2011-04-04 13:33:26,2011-04-04 13:33:14
fe116e261ffb7d643c9a6baee70fbfa07a20588f...9f1b54d6d01bb25c06b2e9d86db922616e2bb566,1,1,0,1,1,2011-04-04 13:33:26,2011-04-04 13:07:47
9f1b54d6d01bb25c06b2e9d86db922616e2bb566...2454ce784f3f4f4c26188526ce340f0a9d87fef6,1,78,48,126,36,2011-04-04 13:33:26,2011-04-04 09:25:55
2454ce784f3f4f4c26188526ce340f0a9d87fef6...72946881b598c133ff1d522d06c083690e260947,1,98,16,114,9,2011-04-04 13:33:26,2011-04-04 13:26:43
72946881b598c133ff1d522d06c083690e260947...9b7a6a99807862778706c455d6ba361a3b1f8f7b,1,4,3,7,2,2011-04-04 14:17:39,2011-04-04 14:17:39
9b7a6a99807862778706c455d6ba361a3b1f8f7b...0bf8ca8820489ff7e154964771688c74eaf1933d,6,143,0,143,7,2011-04-04 14:44:23,2011-04-04 14:44:23
0bf8ca8820489ff7e154964771688c74eaf1933d...2470be13f28c6599d25bf23b61a3f1b369c9f400,1,7,4,11,3,2011-04-04 15:06:31,2011-04-04 15:06:31
2470be13f28c6599d25bf23b61a3f1b369c9f400...8cd767ef52ad35331f082394ec93df8e57757120,2,20,0,20,3,2011-04-04 15:07:47,2011-04-04 15:07:47
8cd767ef52ad35331f082394ec93df8e57757120...6776fd514bbfe46f59cd292fa806b42127ec2b0e,1,1,4,5,1,2011-04-06 13:29:01,2011-04-06 13:17:06
6776fd514bbfe46f59cd292fa806b42127ec2b0e...aa793424d3b27351db44e60121598fcc738540e5,1,17,17,34,17,2011-04-06 13:29:01,2011-04-06 13:27:12
aa793424d3b27351db44e60121598fcc738540e5...acab3bc474760216ccafcad9d6cdaf381cdafc72,2,8,8,16,7,2011-04-06 13:31:42,2011-04-06 13:31:42
2e75e15690bbc34c496cac330ea93a423fded95d...becff0428e7df20792bdfc143d33c0d03b448385,1,0,4,4,1,2011-02-07 06:09:11,2011-02-07 06:09:11
f3cf7f6df1d2e2fcbd4f22dae318fbc4570833d8...c15e0db5a9f259e782cf49e50dd1109548bab1fa,1,9,1,10,2,2011-03-28 11:58:44,2011-03-28 11:58:44
c15e0db5a9f259e782cf49e50dd1109548bab1fa...7b4a16e2c8869ba18264d0c44996880c8f9bb095,2,51,0,51,2,2011-03-28 11:59:48,2011-03-28 11:59:48
f3cf7f6df1d2e2fcbd4f22dae318fbc4570833d8...3bdc0d4c8c3a51e6b338c8166d98d5b82cb01a43,1,1,1,2,1,2011-03-24 22:49:47,2011-03-24 14:32:24
3bdc0d4c8c3a51e6b338c8166d98d5b82cb01a43...12f6d8e1453eacc1b4c6db0f6071541bcdf2e0e0,1,1,1,2,2,2011-03-24 22:49:47,2011-03-24 12:48:22
12f6d8e1453eacc1b4c6db0f6071541bcdf2e0e0...051d6915d70e6fec597fe1bfdee2870561f523d1,1,1,1,2,1,2011-03-24 22:49:47,2011-03-24 17:28:04
051d6915d70e6fec597fe1bfdee2870561f523d1...09e8de0f38ed8f28c02e5a3fa987cbb74e98a671,2,68,21,89,14,2011-03-25 21:53:38,2011-03-25 21:53:38
09e8de0f38ed8f28c02e5a3fa987cbb74e98a671...9d80d74da58207da65eebc4f5c1919fa382d8a38,1,1,1,2,1,2011-03-28 15:57:08,2011-03-28 15:57:08
9d80d74da58207da65eebc4f5c1919fa382d8a38...683581a3e91032d9fdc203933d691b9353f24492,1,2,2,4,2,2011-03-28 15:59:13,2011-03-28 15:59:13
683581a3e91032d9fdc203933d691b9353f24492...483526ebec8b50682b6edd3e1db92df7569ca7b0,2,29,30,59,23,2011-03-28 19:23:44,2011-03-28 19:23:44
483526ebec8b50682b6edd3e1db92df7569ca7b0...6dcb09b5b57875f334f61aebed695e2e4193db5e,1,1,1,2,1,2011-03-28 19:35:27,2011-03-28 19:35:27
6dcb09b5b57875f334f61aebed695e2e4193db5e...baad182cbcafb2f7332ad5864695a42a0354f684,2,5,1,6,2,2011-03-29 16:58:18,2011-03-28 09:31:58
baad182cbcafb2f7332ad5864695a42a0354f684...fa204962006541bd9c111bd7f3fa37ed2f8a2d7e,2,301,167,468,13,2011-03-29 16:58:18,2011-03-28 10:00:50
fa204962006541bd9c111bd7f3fa37ed2f8a2d7e...c7db45e862943e5806db89206a5e3e09c520a9d0,1,1,1,2,1,2011-03-29 16:58:18,2011-03-28 12:53:52
c7db45e862943e5806db89206a5e3e09c520a9d0...4cd6ed7566b9a1537b667f67b4c1491e3ed70a33,1,2,2,4,1,2011-03-29 16:58:18,2011-03-28 13:05:02
4cd6ed7566b9a1537b667f67b4c1491e3ed70a33...591a9423f53eb9d2baca95d94ebc560667ec8e89,1,98,0,98,4,2011-03-29 16:58:18,2011-03-28 16:40:58
591a9423f53eb9d2baca95d94ebc560667ec8e89...dad4a4d582c55394031f8e78a4994da47fca7540,1,4,2,6,2,2011-03-29 16:58:19,2011-03-29 08:47:48
dad4a4d582c55394031f8e78a4994da47fca7540...ec99193655606eeb40abc2539296baedaf80522d,1,3,3,6,1,2011-03-29 16:58:19,2011-03-29 08:52:29
ec99193655606eeb40abc2539296baedaf80522d...fc1eeb9dfce7d63141a5b88c62c602e6d0b86cf5,1,42,3,45,11,2011-03-29 16:58:19,2011-03-29 09:30:09
fc1eeb9dfce7d63141a5b88c62c602e6d0b86cf5...95cde17ca40de7ad7f245c9302f26c5d59f5d873,3,25,20,45,21,2011-03-29 16:58:19,2011-03-29 16:22:21
95cde17ca40de7ad7f245c9302f26c5d59f5d873...9a53df7e0ac364ccba5bd11e9d6c62091f564397,1,7,0,7,1,2011-03-29 16:58:19,2011-03-29 16:40:02
9a53df7e0ac364ccba5bd11e9d6c62091f564397...83c95128d924b029b30551f95170df8696583e10,1,10,5,15,2,2011-03-29 16:58:19,2011-03-24 13:15:00
83c95128d924b029b30551f95170df8696583e10...553fbd640fab5a3f52a20cf1f1ed045ba9349d65,1,2,1,3,1,2011-03-29 16:58:19,2011-03-29 09:43:31
553fbd640fab5a3f52a20cf1f1ed045ba9349d65...a796d24cf697b0b51aa0ca7ef887e980f0d9fb7a,1,1,1,2,1,2011-03-29 17:16:17,2011-03-29 12:19:40
8bd6c0ab8354fff51f0afaa15a56a9f864da7ab5...956ad0ed6f6a4d0008f00d573972f8f7fa654811,1,2,1,3,2,2011-04-06 13:51:10,2011-04-06 13:51:10
956ad0ed6f6a4d0008f00d573972f8f7fa654811...0d280ea457c8ee8809062266fa365c440d35ee6b,1,11,2,13,2,2011-04-06 14:31:06,2011-04-06 14:31:06
0d280ea457c8ee8809062266fa365c440d35ee6b...6b45cb8a89cd3b133183a093719a144a402450e9,2,57,24,81,16,2011-04-07 15:15:30,2011-04-06 16:27:31
6b45cb8a89cd3b133183a093719a144a402450e9...493384e39c1ddfcc4badf962706e02302577d89f,1,3,4,7,3,2011-04-07 15:15:38,2011-04-07 09:24:16
493384e39c1ddfcc4badf962706e02302577d89f...7a4dfd6028499d6f1089c87aa779d686e15f9285,1,5,10,15,6,2011-04-07 15:15:38,2011-04-07 09:30:02
7a4dfd6028499d6f1089c87aa779d686e15f9285...b075b9910c56c356d53439fd34486a905146211a,1,43,11,54,11,2011-04-07 15:17:18,2011-04-07 14:54:10
becff0428e7df20792bdfc143d33c0d03b448385...1b7124f84981a50e9d8c450d0c9323e9576a875b,1,98,1,99,3,2011-02-07 20:24:52,2011-02-07 16:37:54
becff0428e7df20792bdfc143d33c0d03b448385...f443a8793fc7c30916b08faad835fa04e85aa301,1,14,3,17,4,2011-02-07 06:47:50,2011-02-07 06:47:50
bb54fad0452fbcc876c4cfcb42f4590a2cb23be6...a9185589f9416c18628e2d1309b215077c5712b1,1,3,0,3,3,2014-06-11 16:03:37,2014-06-11 16:03:37
a9185589f9416c18628e2d1309b215077c5712b1...2bc76050e026ddb820b3b32c32f71e77e12bbdb0,6,0,2042,2042,6,2014-06-11 16:33:55,2014-06-11 16:10:04
2bc76050e026ddb820b3b32c32f71e77e12bbdb0...4f8ac2163bd264407313a01b11c372b00ce90af7,2,0,139,139,2,2014-06-11 16:33:55,2014-06-11 16:15:04
4f8ac2163bd264407313a01b11c372b00ce90af7...b42ff7c0169c002d7ab8ba13d9d0b6d59a7bfbc9,1,1,0,1,1,2014-06-11 16:33:55,2014-06-11 16:22:46
d8ad64d3669182d368120a9b8db1147421498e22...720d5472f8aa629161749450a27d3a4e3ecefea3,8,29,47,76,27,2011-04-02 09:42:04,2011-04-02 09:42:04
a796d24cf697b0b51aa0ca7ef887e980f0d9fb7a...ba84cad38079b93e167175230f653a7b1133c11f,1,1,1,2,1,2011-03-31 13:02:24,2011-03-31 13:02:23
ba84cad38079b93e167175230f653a7b1133c11f...ccfce5f30fd1e906625594fad98e079b1cfe03d3,1,2,2,4,1,2011-04-02 09:23:09,2011-03-30 17:47:12
a796d24cf697b0b51aa0ca7ef887e980f0d9fb7a...4d00dfd438a219b20145ec76b0e2c543d9b685d1,1,3,6,9,6,2011-03-29 19:21:47,2011-03-29 19:21:47
4d00dfd438a219b20145ec76b0e2c543d9b685d1...2b9b99b6ed45d42627916f0d9e2105d61fd23b11,1,21,0,21,2,2011-03-29 19:29:30,2011-03-29 19:29:30
2b9b99b6ed45d42627916f0d9e2105d61fd23b11...673de2cf59e2f573895f7b9239785c634ca9ba38,1,2,2,4,2,2011-03-30 19:29:10,2011-03-30 19:29:10
673de2cf59e2f573895f7b9239785c634ca9ba38...8e9a3d421755100891402670e5a709031205e664,1,1,0,1,1,2011-03-30 19:46:19,2011-03-30 19:46:19
8e9a3d421755100891402670e5a709031205e664...6d3160148b7220e78e2898aaadb457edcec4c846,1,42,1,43,3,2011-03-30 20:26:53,2011-03-30 19:57:20
6d3160148b7220e78e2898aaadb457edcec4c846...bf4c39f92958b42f626fbf1d7fd95a74e62f3409,3,42,8,50,7,2011-03-30 20:30:55,2011-03-30 20:30:55
bf4c39f92958b42f626fbf1d7fd95a74e62f3409...74e50a2d3e53e52ede430dca4ebc5efb2a38de4e,1,5,0,5,3,2011-03-30 20:46:52,2011-03-30 20:46:52
74e50a2d3e53e52ede430dca4ebc5efb2a38de4e...a50c145855598b53463c3715f399cd5ebf27240d,3,183,22,205,10,2011-03-30 21:16:30,2011-03-30 21:16:30
a50c145855598b53463c3715f399cd5ebf27240d...9e680bcc002af8f230bfce8dbfee3fef4001fb38,3,57,2,59,5,2011-03-30 21:26:36,2011-03-30 21:26:36
9e680bcc002af8f230bfce8dbfee3fef4001fb38...ac26e2454e71010821f2c85046b5cbd5a522d384,2,3,3,6,3,2011-03-30 21:46:54,2011-03-30 21:46:54
55c197cdd37b34c7b4877bc0434c297075e11222...631752aaf61f207143dc2058782b0a97effee6e3,1,2,0,2,1,2011-04-11 15:50:22,2011-04-11 15:49:47
631752aaf61f207143dc2058782b0a97effee6e3...52ca4f8a3992a8ca1672abb6263455f01a03549b,1,3,6,9,1,2011-04-11 15:51:05,2011-04-11 15:51:05
52ca4f8a3992a8ca1672abb6263455f01a03549b...53345e1f1fedf63f8d21b5c2959ae6bca3dabde1,2,30,0,30,3,2011-04-11 16:01:01,2011-04-11 16:01:01
53345e1f1fedf63f8d21b5c2959ae6bca3dabde1...a99264bff6bc4a16c335a09dab1b6c6c9a763a10,3,15,0,15,9,2011-04-19 14:34:22,2011-04-19 14:34:22
a99264bff6bc4a16c335a09dab1b6c6c9a763a10...e69ac2439f71fed2840ad41922d2d3cc76fb453d,1,20,0,20,2,2011-04-19 14:38:55,2011-04-19 14:38:52
e69ac2439f71fed2840ad41922d2d3cc76fb453d...a68cf94b37b59fbc5a00dca9e7488da717bfea4e,1,1,2,3,1,2011-04-19 14:40:52,2011-04-19 14:40:52
a68cf94b37b59fbc5a00dca9e7488da717bfea4e...0130d8184e7a0087a5b95700e9a19d60f35b869f,1,1,1,2,1,2011-04-27 09:20:38,2011-04-27 09:20:38
0130d8184e7a0087a5b95700e9a19d60f35b869f...094aaaaee92f4fc98a6c3c3af36183cb217948a8,3,69,70,139,23,2011-05-05 14:18:11,2011-05-05 13:16:15
9b87998c97fedcf0c22cef28bb0839ecd68c1efd...18eb6ec8233cb3cb607abdf289da6a57cc252bb2,2,20,13,33,7,2014-07-08 08:30:19,2014-07-08 07:56:16
9b87998c97fedcf0c22cef28bb0839ecd68c1efd...d4256ed554fa64f762d53cb2a64663e5095d3eb5,5,141,3,144,13,2014-07-07 12:51:51,2014-07-04 08:00:39
3e3e4631a0362ba2358c9a2227e3cf0aaec8cf53...47d8ec56e917adda2e336c29420f527fca733866,3,100,0,100,3,2011-04-03 11:48:56,2011-04-03 11:48:56
47d8ec56e917adda2e336c29420f527fca733866...29e1789b34d9aa5e486ca12937899a43f2e2407b,2,77,63,140,24,2011-04-04 09:14:43,2011-04-04 09:14:03
29e1789b34d9aa5e486ca12937899a43f2e2407b...d69d0185d147a435e2851b1d9f38dddc838959f9,1,65,0,65,2,2011-04-04 10:08:54,2011-04-04 10:05:20
d69d0185d147a435e2851b1d9f38dddc838959f9...f3564e1e29c065f980e09d78349590ef2ab357b1,3,12,7,19,9,2011-04-04 10:12:23,2011-04-03 11:50:09
f3564e1e29c065f980e09d78349590ef2ab357b1...b153589be2b3b9aea1f90a68891564ddeb12083c,1,1,1,2,1,2011-04-04 10:12:28,2011-04-03 16:31:45
ca8d2dfc0cea0c16e2d6bae16d95d652e292f473...c0335005495c1b49986d19031557f9df6bf49922,7,1193,933,2126,65,2011-05-10 12:47:20,2011-05-06 10:42:47
18eb6ec8233cb3cb607abdf289da6a57cc252bb2...eb5f03461fbcaa3fef8e63d1b0f7c682708fadd2,1,12,12,24,7,2014-07-11 10:22:48,2014-07-11 10:22:48
18eb6ec8233cb3cb607abdf289da6a57cc252bb2...01b432cf3537aa5a13229336e500dc4f6638283c,1,1,1,2,1,2014-07-09 21:12:30,2014-07-09 21:12:30
18eb6ec8233cb3cb607abdf289da6a57cc252bb2...02bf955f4a03c328a76185b13e8df3622034aecd,1,4,3,7,3,2014-07-08 18:14:23,2014-07-02 19:42:15
b153589be2b3b9aea1f90a68891564ddeb12083c...0ad6efa110853763894b60e4c454985a726968da,5,391,17,408,26,2011-04-04 16:25:33,2011-04-04 16:24:19
b153589be2b3b9aea1f90a68891564ddeb12083c...511b2370d942ec9833540c5b11dacc2531844e1a,1,14,6,20,6,2011-04-04 15:24:37,2011-04-04 15:24:37
b153589be2b3b9aea1f90a68891564ddeb12083c...7c7fcdae0e112f56188f13971acae26470287dd3,1,40,0,40,1,2011-04-04 14:20:09,2011-04-04 14:20:09
94711cad3b83445dfcf45a6e0b29b045e06a29f6...29dca0883faaaa9831c9d4fd3baf6f9afcc2d2e8,2,21,20,41,16,2011-05-17 11:41:42,2011-05-17 11:38:19
356b891e3ec53ed937db38b6827c6045fc1beff4...529fd30d1f81cc711ce3ca3857d637e84a1ca6e4,4,93,60,153,24,2014-07-11 22:46:00,2014-07-08 19:45:50
a6d7e166344cb0d9aa5ecca037a975f9f19e64f1...3d997dc25539e9e57e01849d0e386c4c4b55766e,1,1,1,2,1,2014-07-15 14:00:46,2014-07-15 14:00:46
a6d7e166344cb0d9aa5ecca037a975f9f19e64f1...2ef20da02e853e5db993e5d1834cb28e174ee28f,1,1,1,2,1,2014-07-13 15:52:33,2014-07-13 15:52:33
a6d7e166344cb0d9aa5ecca037a975f9f19e64f1...529c37156dfe05db9049a89b7ebb8585f49efccb,1,2,2,4,1,2014-07-13 14:23:16,2014-07-13 14:12:33
529c37156dfe05db9049a89b7ebb8585f49efccb...f59a34d2e60d7b5d33c479f617375974aacb64b9,1,2,0,2,2,2014-07-13 14:23:17,2014-07-12 12:45:34
f59a34d2e60d7b5d33c479f617375974aacb64b9...959a93e716ad76430546418edcb66ea2ee0cad52,2,4,0,4,2,2014-08-05 18:51:59,2014-07-13 09:50:49
959a93e716ad76430546418edcb66ea2ee0cad52...d07fd4425f654825099729e1caa2b3b25341a91d,1,4,0,4,1,2014-08-05 18:51:59,2014-07-12 12:37:39
d07fd4425f654825099729e1caa2b3b25341a91d...2f795d8fc50d81641d95723d9ddd92795886bed3,7,106,90,196,27,2014-08-05 18:51:59,2014-07-12 12:45:56
2f795d8fc50d81641d95723d9ddd92795886bed3...c983604eb1eb17dd42ea0fe47cf15f7c7c503a72,3,13,12,25,5,2014-08-05 18:51:59,2014-07-12 12:44:21
c983604eb1eb17dd42ea0fe47cf15f7c7c503a72...c7dd0a56bf81fa93327a1ec3c949a7d59a53f40d,4,13,12,25,12,2014-08-05 18:51:59,2014-07-12 12:44:58
c7dd0a56bf81fa93327a1ec3c949a7d59a53f40d...662f90e6ecb6ad0576de89d0af8872eab678eb79,2,9,14,23,5,2014-08-05 18:52:00,2014-07-13 14:08:46
662f90e6ecb6ad0576de89d0af8872eab678eb79...07d03d31456899a39f97425a3d09903d7a54ed3f,2,17,17,34,12,2014-08-05 18:52:00,2014-07-13 14:40:51
0ad6efa110853763894b60e4c454985a726968da...8a64bc292c36f5af3e42c46712cb449e19dfa125,4,336,1,337,7,2011-04-08 00:27:01,2011-04-03 17:43:51
8a64bc292c36f5af3e42c46712cb449e19dfa125...5868cd02b7ff21f848b64ead3d7b0aa62155046e,1,2,4,6,3,2011-04-08 00:28:38,2011-04-08 00:28:38
5868cd02b7ff21f848b64ead3d7b0aa62155046e...98ac67808559e8c2238a855feb6fedfc4b956984,2,30,1,31,4,2011-04-08 00:30:47,2011-04-05 17:22:24
98ac67808559e8c2238a855feb6fedfc4b956984...5924b2822cf0d7edad3f68573950d139dfcaaf06,2,26,0,26,5,2011-04-08 00:33:46,2011-04-06 00:48:31
5924b2822cf0d7edad3f68573950d139dfcaaf06...26f2c897b86613ed17d2bc9a35077517f57b234e,1,40,0,40,1,2011-04-08 00:33:50,2011-04-04 14:20:09
26f2c897b86613ed17d2bc9a35077517f57b234e...81234673a1f7cd5d92f0dd5f03d1442ec1ed2d62,1,8,0,8,1,2011-04-08 00:36:53,2011-04-05 14:53:32
81234673a1f7cd5d92f0dd5f03d1442ec1ed2d62...7bc66a79fa8161dc4101cf3953a1e481a4debd91,2,5,13,18,4,2011-04-08 00:36:53,2011-04-06 08:58:14
7bc66a79fa8161dc4101cf3953a1e481a4debd91...6ac247b38128ac889bd0633a588842a6c75e28f0,1,1,9,10,3,2011-04-08 00:36:53,2011-04-06 09:59:40
6ac247b38128ac889bd0633a588842a6c75e28f0...d79f1da65ac83145e2e2b7fb246f2485a0a0156d,3,32,15,47,11,2011-04-08 19:14:33,2011-04-08 19:14:33
d79f1da65ac83145e2e2b7fb246f2485a0a0156d...cef75d743006401121cfe9a9da63933cfc7ecec1,2,0,4,4,3,2011-04-08 19:41:17,2011-04-08 19:41:17
cef75d743006401121cfe9a9da63933cfc7ecec1...41233c40c0e9cb8556a8ba131aa97a0ffbe46cb1,3,41,0,41,4,2011-04-08 19:42:18,2011-04-08 19:42:18
41233c40c0e9cb8556a8ba131aa97a0ffbe46cb1...b918ae40d1dc5116d7631ef822d7b5b39a622c81,2,3,6,9,3,2011-04-08 22:35:25,2011-04-08 22:35:25
b918ae40d1dc5116d7631ef822d7b5b39a622c81...c6e65acae63bd9b251140184679ab4ea0ec5c1a9,8,118,15,133,19,2011-04-09 22:22:11,2011-04-09 22:22:11
c6e65acae63bd9b251140184679ab4ea0ec5c1a9...4a34b3a9ff796f2324d59eb598595be62934acdf,3,33,0,33,4,2011-04-09 22:25:24,2011-04-09 13:49:44
4a34b3a9ff796f2324d59eb598595be62934acdf...076141a137c411d970e4c9e0d725d91eac44e27c,2,14,0,14,5,2011-04-09 22:27:16,2011-04-07 12:38:03
076141a137c411d970e4c9e0d725d91eac44e27c...b5c00c6d41ff4eb809f7deda38fe61ccaacb7cbf,1,6,6,12,3,2011-04-09 22:29:28,2011-04-07 11:27:34
b5c00c6d41ff4eb809f7deda38fe61ccaacb7cbf...9e9e6ae177332f5c1311eff9c9b5ca9740e04dbd,2,30,0,30,2,2011-04-09 22:29:48,2011-04-05 14:15:54
9e9e6ae177332f5c1311eff9c9b5ca9740e04dbd...8416c9adccc6ee6d5aeb09153db7315622bf12a1,2,2,2,4,2,2011-04-09 22:31:12,2011-04-09 22:31:12
8416c9adccc6ee6d5aeb09153db7315622bf12a1...14eb94eefa8b3d84ca4db006f7ae4f2347cd2238,1,20,6,26,7,2011-04-09 23:06:17,2011-04-09 23:06:17
14eb94eefa8b3d84ca4db006f7ae4f2347cd2238...53b7560ba5b1558193bd801739fe8531a28fd0c5,1,2,2,4,2,2011-04-09 23:16:09,2011-04-09 23:16:09
53b7560ba5b1558193bd801739fe8531a28fd0c5...fff036ec159cd7fd987a87cf976b75d19b23d790,1,1,0,1,1,2011-04-10 00:45:38,2011-04-10 00:45:38
fff036ec159cd7fd987a87cf976b75d19b23d790...a6359408a525e5ef8945d8b7a3da2a4a1c4cc424,2,3,2,5,3,2011-04-10 19:23:55,2011-04-10 19:23:55
a6359408a525e5ef8945d8b7a3da2a4a1c4cc424...fdd0cc9e8948bb65c9a461c58e5094a3613bd975,1,2,2,4,2,2011-04-10 22:25:41,2011-04-10 22:25:41
62845c903ed3e67e76773534b8df6cc200b65d41...b3d94069b4c03374bee482df4ea20eed022743dc,1,3,1,4,2,2011-05-17 12:11:19,2011-05-17 11:51:42
b3d94069b4c03374bee482df4ea20eed022743dc...6adcb5f3d2b5770995114521b4a6504d1f0cad03,1,19,0,19,1,2011-05-17 12:11:19,2011-05-17 12:04:18
6adcb5f3d2b5770995114521b4a6504d1f0cad03...128d37316b7499c70c2d8b44635253541647f583,2,26,29,55,22,2011-05-17 12:11:19,2011-05-17 12:05:41
128d37316b7499c70c2d8b44635253541647f583...0da2c70067135ffb095f951b30cb085db1aeccce,4,17,17,34,4,2011-05-17 12:11:19,2011-05-17 12:09:30
0da2c70067135ffb095f951b30cb085db1aeccce...124fbb3d74df3ca479a76e76c44858f0d90b2a64,1,3,1,4,1,2011-05-17 12:11:43,2011-05-17 12:11:43
124fbb3d74df3ca479a76e76c44858f0d90b2a64...c9662061f25ea51f39018a278b98c9a9b4410e84,1,0,1,1,1,2011-05-17 12:12:25,2011-05-17 12:12:25
59f8f24ff88787887dd013e3b863475dd8e1ed51...a5a546b36c184890dee09bd2bd92836c60eec122,1,13,23,36,6,2011-04-07 14:53:50,2011-04-07 14:53:50
a5a546b36c184890dee09bd2bd92836c60eec122...fd279b262df31c9a5d88db78e9e9a6de07e62979,1,23,2,25,5,2011-04-07 14:58:42,2011-04-07 14:58:42
ed99e0b54fef9abb5b7de6ebb43168e57c5d2d04...84a85d1bec3ce96bbb73b7a899ae6a1cc03ad673,1,4,4,8,4,2014-07-16 20:03:07,2014-07-16 20:03:07
84a85d1bec3ce96bbb73b7a899ae6a1cc03ad673...8baeb8a4801ca44b3d383eb824e779b96da026f5,1,1,0,1,1,2014-07-16 20:03:34,2014-07-16 20:03:34
ad082501a76da1e007dd9c47e91e0f975526e531...991dab2dd09baa23bd216896a273cf6c256fa7b4,1,3,3,6,2,2014-07-16 13:09:53,2014-07-16 13:09:53
991dab2dd09baa23bd216896a273cf6c256fa7b4...693748694bf3e404d09d7099527ea9f4b105f74c,1,16,0,16,1,2014-07-16 13:54:53,2014-07-16 13:54:53
ad082501a76da1e007dd9c47e91e0f975526e531...df4cba0f2860f35ddea03e09d40ec27b9717db70,4,46,18,64,6,2014-07-16 00:38:39,2014-07-16 00:27:58
df4cba0f2860f35ddea03e09d40ec27b9717db70...b3af2d80d2d6393dada89c713baff9b3eba49a01,6,45,46,91,9,2014-07-16 20:34:25,2014-07-16 20:34:25
8f759ac0b373eea9dcec680524a68a527d637937...f18234fad62b8f890ccd01bb15443afc2484af1b,2,44,11,55,7,2014-08-08 20:17:50,2014-08-08 20:17:50
fdd0cc9e8948bb65c9a461c58e5094a3613bd975...2fe3692c2315981e00bb09fd616601d0720ec1ac,3,22,1,23,14,2011-04-13 19:50:11,2011-04-13 15:44:08
2fe3692c2315981e00bb09fd616601d0720ec1ac...7c1c15a7fb86ff1422e1adcfceb9dbb7555a8449,1,1,0,1,1,2011-04-13 19:55:43,2011-04-13 19:55:43
7c1c15a7fb86ff1422e1adcfceb9dbb7555a8449...1bfa053e8cc472cf04329c38614795719b04fd24,1,2,0,2,1,2011-04-13 19:57:35,2011-04-13 19:57:35
fdd0cc9e8948bb65c9a461c58e5094a3613bd975...def3fef19733b8258f21799e1ff4603e75ced467,3,57,0,57,4,2011-04-12 22:55:51,2011-04-12 22:52:34
def3fef19733b8258f21799e1ff4603e75ced467...90d743cd5d09d40cd453f2570d26300df48be63c,1,46,33,79,21,2011-04-15 12:12:37,2011-04-15 12:12:37
90d743cd5d09d40cd453f2570d26300df48be63c...2571cc3cff67fe958727496bb1d660e5810bd8e1,1,1,0,1,1,2011-04-15 17:32:31,2011-04-15 17:32:31
2571cc3cff67fe958727496bb1d660e5810bd8e1...fee4c4255004c1f142e39d6884a4804eb38e3183,1,1,1,2,1,2011-04-15 22:58:43,2011-04-15 22:58:43
c9662061f25ea51f39018a278b98c9a9b4410e84...12de98c1c8b83700a69b867e2aa3c2f7899eacc2,1,24,19,43,18,2011-05-18 16:11:25,2011-05-18 16:00:34
c9662061f25ea51f39018a278b98c9a9b4410e84...49041e78f24f9d455d977bb6eb8fc9d9561569c8,1,5,6,11,2,2011-05-18 15:31:11,2011-05-18 14:01:01
49041e78f24f9d455d977bb6eb8fc9d9561569c8...875a5c2df7da1ba473ef0cd7d5bfb78e4e5fd657,1,4,1,5,3,2011-05-18 15:31:18,2011-05-18 14:07:22
875a5c2df7da1ba473ef0cd7d5bfb78e4e5fd657...072347166f78408dd4a92cb3b75f6673b71a0f7e,1,4,0,4,1,2011-05-18 15:31:23,2011-05-18 14:46:56
072347166f78408dd4a92cb3b75f6673b71a0f7e...765fdf4a0e9ca6a0f577cad60f69e15e77bfa601,1,1,1,2,1,2011-05-18 15:31:24,2011-05-18 15:19:38
c9662061f25ea51f39018a278b98c9a9b4410e84...6628c2560c73315a208378919510e1c2cf01f4cd,2,17,4,21,9,2011-05-18 10:36:41,2011-05-18 10:35:57
c9662061f25ea51f39018a278b98c9a9b4410e84...32234541f6d1576149960aa272ccb7219b68ff01,2,41,0,41,2,2011-05-17 12:31:57,2011-05-17 12:18:42
32234541f6d1576149960aa272ccb7219b68ff01...f44cbec4799538b201c5e14419fac9cc1544882e,1,7,0,7,2,2011-05-17 12:59:23,2011-05-17 12:59:23
f44cbec4799538b201c5e14419fac9cc1544882e...6421c49a3726b4132aafcc780016f5a984832caf,1,35,22,57,9,2011-05-17 17:03:42,2011-05-17 16:55:52
091165c53b2bcd5d41fb71d43ed5a23a3d96bf5d...7db0e6ee48fd68009a7e78cbcbca125d6ce9008d,7,169,1,170,13,2014-07-27 15:17:22,2014-07-18 14:00:21
091165c53b2bcd5d41fb71d43ed5a23a3d96bf5d...0ba4dca52625b54d6b741bd10dce5ef76ebbf1b8,8,88,88,176,73,2014-07-22 14:40:23,2014-07-22 14:40:23
091165c53b2bcd5d41fb71d43ed5a23a3d96bf5d...994404b5067f9cc35dfae2c460e209f30467c3b5,1,1,2,3,1,2014-07-17 05:25:31,2014-07-17 05:25:31
35f186b6ca84a5e95de2e735834a87e19e7031d2...f25bc0b2e6d764a496047e4f033767303b35b27e,2,20,0,20,2,2014-08-08 21:51:36,2014-08-08 21:51:36
f25bc0b2e6d764a496047e4f033767303b35b27e...aa5cdf63bfa4581110fb37cdb2ccffc021eb78fa,1,38,0,38,1,2014-08-08 21:53:22,2014-06-04 09:57:53
aa5cdf63bfa4581110fb37cdb2ccffc021eb78fa...a0cacc82d5bd3ba6b0240f5e3a7e926e977d3535,1,2,1,3,1,2014-08-08 22:19:15,2014-08-08 22:18:40
a0cacc82d5bd3ba6b0240f5e3a7e926e977d3535...bbe13802b7f85343d3db1aeb799662ee11461e6b,1,57,0,57,1,2014-08-08 22:19:16,2014-06-12 18:19:34
fee4c4255004c1f142e39d6884a4804eb38e3183...5adb48e4a8d15cbbf0647f6982023d3a24b8c380,1,1,1,2,1,2011-04-21 19:21:44,2011-04-21 19:21:44
fee4c4255004c1f142e39d6884a4804eb38e3183...4c0b6a6dac97f82da927720adb2e0bc285e0c2f1,3,140,0,140,12,2011-04-21 08:54:54,2011-04-21 08:54:54
4c0b6a6dac97f82da927720adb2e0bc285e0c2f1...e3c7786b22b385d7ec5049c5315c74bd37182e8c,1,0,1,1,1,2011-04-28 15:31:13,2011-04-28 15:31:13
fee4c4255004c1f142e39d6884a4804eb38e3183...729b6f490068642f35ca933ef44830fda11b6aef,2,12,9,21,8,2011-04-21 08:40:54,2011-04-21 08:40:54
fee4c4255004c1f142e39d6884a4804eb38e3183...df30eac1eba7b11a04d35e4e5a3f31c9ae58aa0a,2,4,2,6,2,2011-04-21 08:38:37,2011-04-21 08:38:37
fee4c4255004c1f142e39d6884a4804eb38e3183...34a29926651160568e95c864514b7fc7ccf0546c,1,3,0,3,1,2011-04-21 05:25:30,2011-04-21 05:25:30
050e8877dda969b62f47a180b865a4447785e9c7...c90bfec7aa68798ab1ffc63d2272061a23034ab4,1,15,13,28,13,2011-05-17 14:21:14,2011-05-17 14:18:56
c90bfec7aa68798ab1ffc63d2272061a23034ab4...9d27fd3bee887abb4570351b5b3805e670422263,1,1,1,2,1,2011-05-17 14:51:37,2011-05-17 14:51:37
274f2c213fdb2402b586827e6e6e27b2e055101c...8adbf2ed12b7067660a4012f54d76650663edee1,2,8,26,34,6,2011-05-19 23:58:33,2011-05-19 23:58:33
8adbf2ed12b7067660a4012f54d76650663edee1...b0b527e0ad7b2b0d58e3d5039339d29892206f2d,7,132,161,293,77,2011-05-20 00:20:12,2011-05-20 00:20:12
b0b527e0ad7b2b0d58e3d5039339d29892206f2d...913691007eb113f1e1d50da19d19bb315736b601,1,7,3,10,5,2011-05-23 17:31:26,2011-05-17 14:50:49
913691007eb113f1e1d50da19d19bb315736b601...adef99223277f4e392521a397e27677b7c74c305,1,8,6,14,6,2011-05-23 17:33:20,2011-05-23 17:33:20
adef99223277f4e392521a397e27677b7c74c305...726c6fd29327700f8af0dc28d13e4802b4af56c7,1,18,7,25,11,2011-05-23 17:33:41,2011-05-17 15:00:37
726c6fd29327700f8af0dc28d13e4802b4af56c7...4c7a5e9e3f85a5a823cf66c769e502163f1d5e4e,1,4,9,13,6,2011-05-23 17:36:06,2011-05-23 17:36:06
4c7a5e9e3f85a5a823cf66c769e502163f1d5e4e...5c36f6dbe85ea51dbeb5daa84180214dea7c5db3,1,11,29,40,8,2011-05-23 17:43:19,2011-05-23 17:43:19
5c36f6dbe85ea51dbeb5daa84180214dea7c5db3...21dcb75abd9b03b15853d820f884d32d7d534f41,1,1,1,2,1,2011-05-23 17:43:58,2011-05-17 15:21:00
21dcb75abd9b03b15853d820f884d32d7d534f41...4152a44bd87fc56fe75287e8e6551d903f7236dd,1,3,3,6,3,2011-05-23 17:44:10,2011-05-17 15:22:33
4152a44bd87fc56fe75287e8e6551d903f7236dd...68384a27e5780fa36e62850d72806e41b3423e6b,1,1,1,2,1,2011-05-23 17:45:13,2011-05-17 15:24:28
68384a27e5780fa36e62850d72806e41b3423e6b...374db5f9121fc965bfafc33134fd0f9f081f7397,1,14,12,26,13,2011-05-23 17:45:19,2011-05-17 15:43:00
374db5f9121fc965bfafc33134fd0f9f081f7397...f6328611dcfa8f279d911192e8c4cd6c79ce1321,1,8,10,18,6,2011-05-23 18:00:19,2011-05-23 18:00:19
f6328611dcfa8f279d911192e8c4cd6c79ce1321...cc2ac058b35573155d8428fee43055033ed6af93,1,18,16,34,17,2011-05-23 18:00:40,2011-05-17 16:02:08
cc2ac058b35573155d8428fee43055033ed6af93...d3ca89fe60d3044393d15a3760bebacd0faf261a,2,2,100,102,5,2011-05-23 18:03:01,2011-05-23 18:03:01
d3ca89fe60d3044393d15a3760bebacd0faf261a...da533495c5707c18ee3a4c695dcb28d568b57ce5,1,2,2,4,2,2011-05-23 18:03:18,2011-05-18 10:12:16
da533495c5707c18ee3a4c695dcb28d568b57ce5...0be7f000a5dd434f2d319250a046e3a82a9e0707,1,1,1,2,1,2011-05-23 18:04:09,2011-05-23 18:04:09
0be7f000a5dd434f2d319250a046e3a82a9e0707...75eb97fed0e3a4d9797dda081eccc858643c5fe4,1,6,6,12,6,2011-05-23 18:04:19,2011-05-18 10:19:48
75eb97fed0e3a4d9797dda081eccc858643c5fe4...6623f5c91b3b3bf0dcf3543ee7e25336162fd03c,1,3,3,6,3,2011-05-23 18:05:43,2011-05-23 18:05:43
6623f5c91b3b3bf0dcf3543ee7e25336162fd03c...d3d5d86d4deefafea5e200d9a36b5c5057ecdbf3,1,21,17,38,18,2011-05-23 18:05:58,2011-05-18 10:35:08
d3d5d86d4deefafea5e200d9a36b5c5057ecdbf3...1e85d1aa03d593386244fb914c8d1c208e94d8d8,1,5,5,10,5,2011-05-23 18:09:07,2011-05-23 18:09:07
1e85d1aa03d593386244fb914c8d1c208e94d8d8...f93f8ec5d09930794847b3f560c2d79b5816aed3,1,2,2,4,2,2011-05-23 18:09:21,2011-05-19 10:27:43
f93f8ec5d09930794847b3f560c2d79b5816aed3...dfb12cd544f21d2ea9e457bea7a9c28a8c6ff26f,1,24,24,48,24,2011-05-23 18:09:33,2011-05-19 10:28:46
dfb12cd544f21d2ea9e457bea7a9c28a8c6ff26f...60e1b49abd3fa2d50c2bf3f1a6718f56621582f8,1,9,2,11,3,2011-05-23 18:12:18,2011-05-23 18:12:18
60e1b49abd3fa2d50c2bf3f1a6718f56621582f8...267d539f4adeb7fad513d173e337d74e580d6d68,1,39,39,78,39,2011-05-23 18:12:28,2011-05-19 11:38:12
267d539f4adeb7fad513d173e337d74e580d6d68...f84d98193863197e026b5ce6af0d2d9b2a848c25,1,9,9,18,9,2011-05-23 18:14:58,2011-05-23 18:14:58
f84d98193863197e026b5ce6af0d2d9b2a848c25...bea548420ba513260d270430385ed71527276050,1,6,6,12,6,2011-05-23 18:15:26,2011-05-19 11:50:46
bea548420ba513260d270430385ed71527276050...5bdf7b9f54c66a65e806c1303bbab26f94ad3d37,1,63,63,126,63,2011-05-23 18:15:35,2011-05-19 12:36:52
5bdf7b9f54c66a65e806c1303bbab26f94ad3d37...0d5d5190f256fbb1f33b2c2e840e6643e2fa8d53,1,13,16,29,14,2011-05-23 18:37:48,2011-05-23 18:37:48
0d5d5190f256fbb1f33b2c2e840e6643e2fa8d53...4f664a1b3d04a242ef1c5acb45eee58e0b0cddf8,1,11,11,22,11,2011-05-23 18:38:19,2011-05-19 12:51:16
4f664a1b3d04a242ef1c5acb45eee58e0b0cddf8...c0cd9d506bcc4cbef7703c145575ca494d81e7f0,1,12,12,24,12,2011-05-23 18:38:35,2011-05-19 12:57:41
c0cd9d506bcc4cbef7703c145575ca494d81e7f0...005564967fcab6d8fa56158a40009985e754cffb,1,1,1,2,1,2011-05-23 18:38:37,2011-05-19 12:59:10
005564967fcab6d8fa56158a40009985e754cffb...6e34ee61bcb7c5c679d84b815d78aad99ed21c9b,1,11,11,22,11,2011-05-23 18:38:38,2011-05-19 13:07:41
6e34ee61bcb7c5c679d84b815d78aad99ed21c9b...bc06a4eeecbda3b23aad53cbf0ea20e8a25f3931,1,4,4,8,4,2011-05-23 18:38:39,2011-05-19 13:10:54
bc06a4eeecbda3b23aad53cbf0ea20e8a25f3931...33b1d19e76518fabde0ccbb1020ab793e44a4637,1,3,3,6,3,2011-05-23 18:38:39,2011-05-19 13:13:40
33b1d19e76518fabde0ccbb1020ab793e44a4637...43a0bc01ceb000a5d4392cbaff2135c15a04d4ec,1,6,6,12,6,2011-05-23 18:38:40,2011-05-19 13:17:06
43a0bc01ceb000a5d4392cbaff2135c15a04d4ec...57435a6dffbda3ae4966e889ad774b3879d8ae61,1,12,12,24,12,2011-05-23 18:38:41,2011-05-19 13:24:24
57435a6dffbda3ae4966e889ad774b3879d8ae61...450ac186f905a9c821671147bb2cb8ee8b08ac26,1,5,5,10,5,2011-05-23 18:38:41,2011-05-19 13:29:22
450ac186f905a9c821671147bb2cb8ee8b08ac26...7c8b597ec351766c391103c144735e5631472604,1,10,10,20,10,2011-05-23 18:38:42,2011-05-19 13:36:09
7c8b597ec351766c391103c144735e5631472604...a6d647d258c05698a3b2a7041ee69b5971dc9eca,1,1,1,2,1,2011-05-23 18:38:43,2011-05-19 13:37:10
a6d647d258c05698a3b2a7041ee69b5971dc9eca...ec9edd5657a4e2b192ec43f4038f8ef3975020c0,1,5,5,10,5,2011-05-23 18:38:44,2011-05-19 13:46:36
ec9edd5657a4e2b192ec43f4038f8ef3975020c0...d320c52d3be1f20b2bf15b17d6aadcf637ffe3a0,1,20,21,41,20,2011-05-23 18:39:56,2011-05-19 13:59:18
d320c52d3be1f20b2bf15b17d6aadcf637ffe3a0...8146fe7cb9b2c8161ff7d773548237682b1e7a98,1,2,2,4,2,2011-05-23 18:41:13,2011-05-23 18:41:13
7c37aa3ac5eecd0e725d0207c0507c4f6836c0eb...c7b79af3f035b06095ba9d9ad61c3c766764b818,1,4,4,8,4,2011-05-01 18:31:58,2011-05-01 18:31:58
7c37aa3ac5eecd0e725d0207c0507c4f6836c0eb...68a146c1ae580f0828dd193a749aac4063aa4500,1,2,1,3,2,2011-04-29 09:50:39,2011-04-29 09:45:42
68a146c1ae580f0828dd193a749aac4063aa4500...8381238e005be4a0e53d09a46a1a40e7d3405416,1,11,2,13,2,2011-04-29 09:50:39,2011-04-27 12:59:59
8381238e005be4a0e53d09a46a1a40e7d3405416...79b61557366db4550d1122bfa88b9851a5e2f5aa,1,68,0,68,2,2011-04-29 10:08:24,2011-04-28 16:30:50
7c37aa3ac5eecd0e725d0207c0507c4f6836c0eb...ed6c462c2043330ab7cda09097ffb95943919caa,1,1,0,1,1,2011-04-27 13:30:45,2011-04-27 13:30:45
7c37aa3ac5eecd0e725d0207c0507c4f6836c0eb...555ce568196f62558eb5a9084ba61add7e6b1ba1,2,42,1,43,4,2011-04-26 11:32:11,2011-04-26 09:22:45
7c37aa3ac5eecd0e725d0207c0507c4f6836c0eb...402a47a7fa3ab2b549c5183d1d5fc82d95f64663,4,7,10,17,9,2011-04-26 09:29:05,2011-04-26 09:29:05
7c37aa3ac5eecd0e725d0207c0507c4f6836c0eb...411823a3d0614d1268c84bd2add1b65b281ec824,1,1,1,2,1,2011-04-24 14:43:08,2011-04-24 12:02:57
411823a3d0614d1268c84bd2add1b65b281ec824...1d1735fe03a53482c6545252bd567555d5d9b487,1,4,1,5,1,2011-04-24 14:43:08,2011-04-24 14:33:50
46a13f32472741f0ed66db7cb75c8cff279886ad...aff700182518471941be2cfb0659a1c611a854ba,1,1,2,3,2,2014-08-31 14:43:53,2014-08-31 14:43:53
7d0ab0fae04015e0bc66ff16beae495f13969b10...85b7268e387eafce2e5cf53a671e6658ae82d6f0,1,9,9,18,1,2014-07-23 02:17:02,2014-07-23 02:17:02
9de6ec52008e3f30a4e8a5c6a13859eefcf86f57...9746b36cf9a86ba50a666bbc8cc97a37221cb954,1,0,3,3,1,2014-07-24 15:52:28,2014-07-24 14:46:59
9746b36cf9a86ba50a666bbc8cc97a37221cb954...b62a6a13b2f9a40e6ea4bf7bc2a9255429fb0bd6,1,1,1,2,1,2014-07-25 06:25:41,2014-07-25 06:25:41
bb9e6028b8ec54c01b35f838e8eca7c81d4b751a...9dac1f957945f706f3f557ff0b964f3d33d761b4,2,14,1,15,2,2014-08-09 09:06:49,2014-08-09 08:56:50
00e9ae5ab4787601a9f3e6ce1ef50ca9c8e60dc9...6a211d7c9abbddee342c353092b681b21913b2dd,2,10,10,20,9,2014-08-26 22:12:43,2014-08-26 22:12:43
f16c0a9db783548d7b28cad726c5af8923a3ac32...f7a5058aaf51635b3171eda182820a8f8c750060,2,127,56,183,11,2011-04-23 21:31:43,2011-04-23 21:31:43
6b290755ea409485dc066106ecdfdd3ce855a759...1d0087816e0b6e22cb08a734e440b718e59ffdc0,1,4,4,8,4,2011-04-23 20:59:38,2011-04-23 20:59:38
6b290755ea409485dc066106ecdfdd3ce855a759...a3ced63792b570b7a5927f6a75cf996233b9f3aa,1,3,0,3,1,2011-04-22 13:41:36,2011-04-22 13:36:28
7b134cfebe3d37f3679119b447edcad12e6beec1...f4e2aca29c06db44cae48556291ecfcfbbb7d72d,2,36,48,84,35,2011-05-19 17:38:17,2011-05-19 17:38:17
7b134cfebe3d37f3679119b447edcad12e6beec1...8133afefe39091c41f19e1977cf731b793741137,2,4,4,8,4,2011-05-19 07:34:58,2011-05-19 07:26:01
8146fe7cb9b2c8161ff7d773548237682b1e7a98...71da57aefddf25395da141eef8dd854c04bc5771,1,9,0,9,3,2011-05-31 14:49:15,2011-05-31 14:49:15
8146fe7cb9b2c8161ff7d773548237682b1e7a98...3a1c431011229fe641a23c129cfafa462558a03f,2,3,3,6,3,2011-05-24 16:55:35,2011-05-24 16:55:35
c7b79af3f035b06095ba9d9ad61c3c766764b818...34e5d87e0512f2a3dfd6fa0ead1fb46814627a1f,1,19,27,46,19,2011-05-01 19:35:32,2011-05-01 19:35:32
cc3b82e376e0216c1af4ad46d24327d61e9efd99...d8e1d038b3e77fdcec01e662dc9bc6708ebcd24c,2,2,3,5,3,2011-05-06 10:47:21,2011-05-06 10:47:21
cc3b82e376e0216c1af4ad46d24327d61e9efd99...39e1032cfcc27ddfeb9e8d2d7ab5d7d1c51da0cf,1,1,1,2,1,2011-05-06 10:43:37,2011-05-06 10:43:37
cc3b82e376e0216c1af4ad46d24327d61e9efd99...bbd68c6768dc351da7d327682cc904b16c6d73ef,1,1,1,2,1,2011-05-05 09:40:39,2011-05-05 09:38:23
cc3b82e376e0216c1af4ad46d24327d61e9efd99...773bc20dd3f78d4e307ff54edd1e09f508f2a06f,2,3,3,6,3,2011-05-04 05:22:42,2011-05-04 05:22:42
d4ad0771e4301d9724f06e84ebf39ace596f295e...1648fbd34457c287ffb961457349689c67f3ad97,3,38,25,63,12,2011-05-01 22:12:53,2011-05-01 22:12:53
1e9b7a09ff3d16c3d7a132cfaacb9d68b253e924...0291b5b76bd8dcbac1118533c7a79a619ade766c,3,35,22,57,9,2011-06-03 18:01:18,2011-06-03 17:59:16
0291b5b76bd8dcbac1118533c7a79a619ade766c...3a42e0a3705d5d47ed32579721a62edf4ff297b1,2,17,0,17,2,2011-06-03 19:38:55,2011-06-03 19:38:55
1e9b7a09ff3d16c3d7a132cfaacb9d68b253e924...04fdc10d3581fb58adc2a3a375fdbb5d57774027,2,25,16,41,9,2011-06-03 17:26:45,2011-06-03 17:26:45
04fdc10d3581fb58adc2a3a375fdbb5d57774027...bb88da7f90f23a89ebae58bd90d9859feec84530,2,5,5,10,4,2011-06-03 19:03:58,2011-06-03 17:38:46
bb88da7f90f23a89ebae58bd90d9859feec84530...26a98ec8a2ebd6d54ad12466552442fde1c6a9d0,4,28,18,46,16,2011-06-03 19:04:02,2011-06-03 18:47:56
26a98ec8a2ebd6d54ad12466552442fde1c6a9d0...bc6484912ebb3db2ac9637abebdeadd28f6d84c3,2,21,1,22,2,2011-06-03 19:20:20,2011-06-03 19:09:14
bc6484912ebb3db2ac9637abebdeadd28f6d84c3...1549cba9a4f7d9ad79441b748937bbe606ba79c1,3,18,4,22,5,2011-06-03 21:08:42,2011-06-03 19:18:24
1549cba9a4f7d9ad79441b748937bbe606ba79c1...f2e6b8776e8d9f65b3edf3e3bc1ff22a495170ea,3,80,3,83,5,2011-06-03 22:00:28,2011-06-03 21:44:38
f2e6b8776e8d9f65b3edf3e3bc1ff22a495170ea...6a01b6bd60b6096fd9fce4a302ae2a5d46684a74,1,39,0,39,2,2011-06-03 22:10:55,2011-06-03 22:10:55
6a01b6bd60b6096fd9fce4a302ae2a5d46684a74...222cf1d45992d746716c10808911e2996c650182,1,13,5,18,2,2011-06-03 22:14:37,2011-06-03 22:14:37
222cf1d45992d746716c10808911e2996c650182...fd0574e5ad4e2e5924ff0d0869da7d5846225d8b,2,157,5,162,4,2011-06-03 23:05:36,2011-06-03 23:01:20
69b584593ee849d8af1bd0045c0f625d91e1d436...dbc77850ff62b134d7fe7ab659ca2d3ef24cf556,1,1,24,25,8,2014-08-31 16:01:35,2014-08-31 14:48:41
dbc77850ff62b134d7fe7ab659ca2d3ef24cf556...bd3854a09c9bd4196cf280108d3f6286ee6de258,1,6,0,6,6,2014-08-31 16:01:44,2014-08-31 15:12:45
bd3854a09c9bd4196cf280108d3f6286ee6de258...ba67c0752269ba06523fe7f5fa350e6328b20241,3,23,32,55,9,2014-08-31 19:50:28,2014-08-31 15:16:40
ba67c0752269ba06523fe7f5fa350e6328b20241...05ac70514fed0ae75ba2844f22b233da1c25b8cc,1,9,16,25,7,2014-08-31 19:53:42,2014-08-31 19:53:42
59e3f45b6150984e6a74ce79062caa459eda369f...3822d2cc4f4a171fdcf8dcfa7c7338b889c43c61,1,3,3,6,3,2014-08-05 22:06:45,2014-08-05 22:06:45
59e3f45b6150984e6a74ce79062caa459eda369f...66d1595436489399dbd86073fdc78aa36c307abc,1,2,0,2,1,2014-08-05 17:51:29,2014-08-05 17:51:29
59e3f45b6150984e6a74ce79062caa459eda369f...b8add6c42ead8721c32dea8f473a61b48091ccb1,13,70,61,131,65,2014-08-03 14:29:51,2014-08-03 13:44:13
59403f1ff55346c64bfaa0744ea7f3375da71725...4ca0b566ca811550b4db31045e580b4970e5b8e3,7,33,18,51,17,2014-08-18 10:41:06,2014-08-18 10:41:06
59403f1ff55346c64bfaa0744ea7f3375da71725...e62f96dea5a46098cbca5a287f29ca811003bd68,1,9,7,16,4,2014-08-13 18:55:24,2014-08-13 18:55:24
59403f1ff55346c64bfaa0744ea7f3375da71725...c6ba8a3765101adf61d7064e34519d2ff7512941,2,4,5,9,4,2014-08-10 14:00:04,2014-08-02 13:57:56
4191d529245084fa92e869aadda72dd740403d3a...ef5ffed39a91e8e645ed77f52ec862d47b081e9c,1,6,0,6,1,2011-06-01 16:45:23,2011-06-01 16:23:36
ef5ffed39a91e8e645ed77f52ec862d47b081e9c...f7e59c4dcf46e0815ab0e7d435fd16755fdf616c,6,37,52,89,22,2011-06-01 16:54:47,2011-06-01 16:34:21
f7e59c4dcf46e0815ab0e7d435fd16755fdf616c...cdd9fd473ec96766897fab73c1837c178619409f,1,53,28,81,19,2011-06-01 16:54:56,2011-05-24 12:55:34
cdd9fd473ec96766897fab73c1837c178619409f...a02fc2cd16b5d45466733a1c4f027def4f5ee24c,1,10,1,11,2,2011-06-01 16:54:56,2011-05-24 13:24:45
a02fc2cd16b5d45466733a1c4f027def4f5ee24c...786ad84fa9b38c705b0d064a10644f6747e9ce26,1,25,23,48,16,2011-06-01 16:54:56,2011-06-01 16:51:54
4191d529245084fa92e869aadda72dd740403d3a...fbfc7580226c4f0fdf2bcc0df21add033c649681,2,23,6,29,11,2011-05-31 16:38:59,2011-05-31 16:38:59
4191d529245084fa92e869aadda72dd740403d3a...a5f43b95364e76436df25349f5f7b07e532e8e23,1,0,1,1,1,2011-05-31 15:33:23,2011-05-31 11:48:44
a5f43b95364e76436df25349f5f7b07e532e8e23...f2abee47d8908cd74f1ca2e46f30c8b9f6a07754,1,8,31,39,6,2011-05-31 15:33:23,2011-05-28 23:24:09
f2abee47d8908cd74f1ca2e46f30c8b9f6a07754...7bc9e2aa2fe4b554021129fabb8a46b5a33ed4e9,1,2,2,4,2,2011-05-31 15:33:23,2011-05-31 13:06:22
7bc9e2aa2fe4b554021129fabb8a46b5a33ed4e9...7288d8b65c5f584f14eff045ab2f70a97a666898,1,4,2,6,1,2011-05-31 15:33:24,2011-05-31 13:11:49
7288d8b65c5f584f14eff045ab2f70a97a666898...5892277cd04bb9ed0dee5bea5fdf96f95aac0a8a,1,8,4,12,3,2011-05-31 15:33:24,2011-05-31 13:16:25
5892277cd04bb9ed0dee5bea5fdf96f95aac0a8a...38d0bc1e818c5e776a39a334c83054ff96abb07c,2,20,0,20,3,2011-05-31 15:57:17,2011-05-31 14:06:01
38d0bc1e818c5e776a39a334c83054ff96abb07c...30d0550da8e73d409407fe01133628c9594d63fc,2,13,0,13,3,2011-05-31 15:57:17,2011-05-31 14:31:19
30d0550da8e73d409407fe01133628c9594d63fc...c7e6e95841920055239b28b7dd146792895f3025,1,4,0,4,1,2011-05-31 15:57:18,2011-05-31 15:44:55
c7e6e95841920055239b28b7dd146792895f3025...fc0ee5bdd384f6f9a6cf1ca1e09d9578fe72fdbd,2,9,0,9,2,2011-05-31 15:57:18,2011-05-31 15:54:50
4191d529245084fa92e869aadda72dd740403d3a...a7ed1625381394b1db722db87168b42bd014facc,1,2,0,2,1,2011-05-30 19:13:11,2011-05-30 19:13:11
4191d529245084fa92e869aadda72dd740403d3a...448c4d012b9237541377d8d82684644c8a331902,1,2,2,4,2,2011-05-30 06:46:48,2011-05-30 06:46:48
448c4d012b9237541377d8d82684644c8a331902...23123151e035f3565f7c9c93c1bbdb56c7cd6914,2,6,2,8,3,2011-05-30 07:03:55,2011-05-30 07:03:55
23123151e035f3565f7c9c93c1bbdb56c7cd6914...3ecdf9106596906e74c54e1e956c289fdea89b88,1,48,26,74,5,2011-05-31 09:53:09,2011-05-31 09:53:09
3ecdf9106596906e74c54e1e956c289fdea89b88...ac4fcf173d0d6797a71c24de5f3bbeb1770e2888,1,36,7,43,5,2011-05-31 14:31:12,2011-05-31 09:56:39
ac4fcf173d0d6797a71c24de5f3bbeb1770e2888...f4c925c51449f5e9b141c4f07c7d61212e1b0a4a,1,1,1,2,1,2011-06-04 14:09:19,2011-06-04 14:09:19
f4c925c51449f5e9b141c4f07c7d61212e1b0a4a...1c68d27d07a03b874e98f0c8eccfc7602f948567,1,3,3,6,2,2011-06-07 08:15:31,2011-06-07 08:15:31
4191d529245084fa92e869aadda72dd740403d3a...f5a86fefa9cc005db984defdbac82ec1dde27a40,1,1,1,2,1,2011-05-29 15:44:14,2011-05-29 15:44:14
f5a86fefa9cc005db984defdbac82ec1dde27a40...286349c6ecc758da226ce2f4da6522b73eb78930,1,1,1,2,1,2011-05-29 18:15:27,2011-05-29 18:15:27
4191d529245084fa92e869aadda72dd740403d3a...fa9bcd81f51ae33e315adbf8bbfc27eddd82cf57,3,22,1,23,3,2011-05-24 19:50:02,2011-05-24 19:48:07
cfba137707ba334b8f7917ca6261f842fa11a60e...02f9e637a1d282d03ce3362e7c3467e73c87bf2e,3,43,0,43,6,2011-05-09 18:58:01,2011-05-04 22:12:17
02f9e637a1d282d03ce3362e7c3467e73c87bf2e...3f53c97113deb986b58aac8bb89f76b47e76507b,2,36,11,47,5,2011-05-09 18:58:02,2011-05-04 22:20:27
3f53c97113deb986b58aac8bb89f76b47e76507b...5eb0fab846d6b2f8bcf3caf7a9e33afa36753850,3,13,50,63,5,2011-05-09 18:58:02,2011-05-04 22:49:27
5eb0fab846d6b2f8bcf3caf7a9e33afa36753850...fa59f18d0ddbbb98d45e33934fb0efc3e2bf1557,5,47,20,67,17,2011-05-09 18:58:02,2011-05-09 17:54:04
cfba137707ba334b8f7917ca6261f842fa11a60e...16a5c3046595284c1f2f8b9eb8621d76239e4b61,1,3,4,7,2,2011-05-08 19:32:35,2011-05-08 19:32:35
cfba137707ba334b8f7917ca6261f842fa11a60e...560cd27ef3bbaac66a858ab86b3be04148281c6e,1,2,0,2,1,2011-05-08 19:30:16,2011-05-08 19:30:16
3a42e0a3705d5d47ed32579721a62edf4ff297b1...bad1505609068de0d57cba1584590e9084afe9d6,1,3,1,4,2,2012-06-05 10:41:43,2012-06-05 10:41:43
bad1505609068de0d57cba1584590e9084afe9d6...d0517805d84f0fdd6c1311eb00a0d4ff257b4e47,1,3,0,3,1,2012-06-05 10:47:17,2012-06-05 10:47:17
d0517805d84f0fdd6c1311eb00a0d4ff257b4e47...82c23c58708acd1370a129f712207ce60e7e6199,1,6,2,8,6,2012-06-05 11:06:40,2012-06-05 11:06:40
82c23c58708acd1370a129f712207ce60e7e6199...cada414a8044307b28f7a4c75986e5473bb4bc1c,1,1,1,2,1,2012-06-05 11:07:08,2012-06-05 11:07:08
3a42e0a3705d5d47ed32579721a62edf4ff297b1...e5c8009731f3ccaf67b5b62546d890301ecb1f25,2,5,5,10,5,2011-06-05 19:18:05,2011-06-05 19:18:05
e5c8009731f3ccaf67b5b62546d890301ecb1f25...f11e079733e38c83bbc1b00c75c96c031825ec25,2,23,5,28,6,2011-06-05 19:19:03,2011-06-05 19:19:03
f11e079733e38c83bbc1b00c75c96c031825ec25...c5d8745fca5c6f098b76d00c9c1b169c1a66610f,1,5,5,10,5,2011-06-06 08:55:54,2011-06-06 08:55:54
fd0574e5ad4e2e5924ff0d0869da7d5846225d8b...9d9bab5c384fd5d2f2832f6a68b36ce6848e0552,1,8,8,16,3,2011-06-04 14:28:39,2011-06-04 14:28:39
9d9bab5c384fd5d2f2832f6a68b36ce6848e0552...8b05e780180072d1fab525ec29100d63beb104a6,1,2,2,4,1,2011-06-04 22:17:26,2011-06-04 22:17:26
8b05e780180072d1fab525ec29100d63beb104a6...f2a60854cd174006fc2fa9b9f2af4c3e54672e96,1,7,0,7,1,2011-06-04 22:18:34,2011-06-04 22:18:34
f2a60854cd174006fc2fa9b9f2af4c3e54672e96...a993e4fe0612b2f08885fff283175fd1238a1be6,1,5,2,7,3,2011-06-04 22:20:35,2011-06-04 22:20:35
a993e4fe0612b2f08885fff283175fd1238a1be6...76e9e3b763e9848971950c25399748762865ee10,2,140,0,140,3,2011-06-04 22:23:24,2011-06-04 22:23:24
76e9e3b763e9848971950c25399748762865ee10...5ec05d0748094b0e7fd1920bd960a24826435cac,1,1,1,2,1,2011-06-05 23:26:01,2011-06-05 23:26:01
5ec05d0748094b0e7fd1920bd960a24826435cac...efcc87c9d95a0b156c657c0e5c11580e7f071efd,2,6,8,14,5,2011-06-06 08:02:07,2011-06-06 08:02:07
d4cb23e4e50688a9079ab0e3ec12cf2cc1256f04...5cd81bb3d88218d42dd431f2c5011dfa84c287c7,4,3,6,9,4,2014-09-02 21:01:25,2014-09-02 21:01:25
d4cb23e4e50688a9079ab0e3ec12cf2cc1256f04...098bb9dfb9b229498f0def634bcada0b76b405cd,1,14,0,14,1,2014-09-02 20:19:02,2014-09-02 17:42:45
89e05e2ab19ac452e84e0eaa2dfb8e07ac6839bf...2dc399a81da0baec54da80ed90a0007fb8caed81,1,7,1,8,3,2014-09-04 14:46:14,2014-09-04 14:46:14
d28b2b7a5ff608ce8f3da0e0b6a4c75afcf1e82c...017c0eac2b03e4dbe336d942ff66b09c253d2fd3,1,4,1,5,2,2014-08-25 20:41:07,2014-08-25 20:41:07
d28b2b7a5ff608ce8f3da0e0b6a4c75afcf1e82c...2db71194de87a83f1e504f9664dd3ca74fd0a6c4,1,8,0,8,4,2014-08-23 11:24:13,2014-07-24 02:15:24
2db71194de87a83f1e504f9664dd3ca74fd0a6c4...86d0a53cd64efd3c7045790ac308d187e5acc625,1,15,7,22,5,2014-08-27 13:07:04,2014-08-26 23:30:47
d28b2b7a5ff608ce8f3da0e0b6a4c75afcf1e82c...668ae2ddf854e509dca6e76772b64c9876c1d717,2,36,3,39,3,2014-08-22 17:05:09,2014-08-22 17:05:09
e62f96dea5a46098cbca5a287f29ca811003bd68...c180c06586050a33f6e8a6d25cc30b7bcbef702d,11,461,410,871,46,2014-08-14 13:52:20,2014-07-09 21:58:39
e62f96dea5a46098cbca5a287f29ca811003bd68...c8402334d2f4943653f1377455d478a4b471b254,1,4,0,4,4,2014-08-13 21:23:07,2014-08-13 21:23:07
4c0c001529426771d6a208af317df19d08d86434...942a7b39edad519748456ddce97cf77a93c9babc,2,3,3,6,3,2014-10-10 16:03:09,2014-10-10 16:03:09
15c7da3442843b8fd2cdb95af8716ec6b5c12a40...c13b68442fa92c19fb8e92f0c1da4704fe14174f,1,3,0,3,1,2014-08-27 13:25:46,2014-08-27 13:25:46
6a0d2b43ee4a32b2894d3c2b7c798c4eb4853534...7449c82ee713024f59badf6fef9cc0ac49ce9561,1,6,0,6,1,2014-08-27 13:10:43,2014-08-27 13:10:43
4a51e9981469c883225f774715d987bce2d41ee2...ecd6fdf1f70b785f24e2d17bec516ac88be0cf2c,5,75,0,75,9,2011-06-01 21:40:41,2011-05-27 16:49:09
ecd6fdf1f70b785f24e2d17bec516ac88be0cf2c...53c0bd81a2915d6f82ef2f9c0703770783a3dc89,6,46,0,46,6,2011-06-01 21:40:41,2011-05-27 20:37:10
53c0bd81a2915d6f82ef2f9c0703770783a3dc89...dd453c4dbf9a1fa38530b1f51e079852736b8f66,7,516,61,577,41,2011-06-01 21:40:41,2011-05-27 20:46:41
dd453c4dbf9a1fa38530b1f51e079852736b8f66...ac2b94ad7658b53035b8518842348a083decd418,5,16,7,23,7,2011-06-01 21:40:41,2011-05-28 19:24:25
ac2b94ad7658b53035b8518842348a083decd418...da03c9f35b282e70f0cb7e6ae1638df476c4e0df,3,20,5,25,5,2011-06-01 21:40:42,2011-05-29 09:45:34
da03c9f35b282e70f0cb7e6ae1638df476c4e0df...7d74cd44d5c538383263dfa9f9d13868e9fdc00f,1,0,5,5,1,2011-06-01 21:40:42,2011-05-29 09:46:42
7d74cd44d5c538383263dfa9f9d13868e9fdc00f...6c8ca697becd0cc8cc867f34f571b51247b142d7,2,39,17,56,13,2011-06-01 21:40:42,2011-05-29 15:57:25
6c8ca697becd0cc8cc867f34f571b51247b142d7...aea8a638f2593153b397a12d07c0751727e720f1,1,115,2,117,6,2011-06-01 21:40:42,2011-05-29 16:00:35
aea8a638f2593153b397a12d07c0751727e720f1...d0323a5f63219428aada1c36dfa8a712a695d778,9,70,47,117,42,2011-06-01 21:40:42,2011-06-01 19:25:56
d0323a5f63219428aada1c36dfa8a712a695d778...fea400f87b05c87ac73d521ec492f18e04e1a986,1,1,1,2,1,2011-06-01 21:41:30,2011-06-01 21:41:30
fea400f87b05c87ac73d521ec492f18e04e1a986...7b5fe049d1680bafdf1d8106653bda3b0a33a9f4,1,2,2,4,2,2011-06-01 22:47:51,2011-06-01 22:47:51
7b5fe049d1680bafdf1d8106653bda3b0a33a9f4...7107b599d75978a7526ac40592ad7b53035325b0,1,5,4,9,6,2011-06-01 23:03:52,2011-06-01 23:03:52
e3f56a2b571483e7cf70d324b61f0681bdda62b8...732eb0a8d9b5d3a217421ec61e2b2335fc5a1e36,1,5,2,7,3,2011-06-10 11:54:25,2011-06-10 11:54:25
732eb0a8d9b5d3a217421ec61e2b2335fc5a1e36...535ff384e2afe029147b89b95c9fb812c955cd7b,1,1,1,2,1,2011-06-10 11:54:47,2011-06-10 11:54:47
535ff384e2afe029147b89b95c9fb812c955cd7b...c1802641ff398d11396d6187a3972622b2ff8ba6,1,2,2,4,1,2011-06-10 11:56:24,2011-06-10 11:56:24
c1802641ff398d11396d6187a3972622b2ff8ba6...3f66c202029ab9911b3c4ce0d01eaf0a98111aba,1,1,1,2,1,2011-06-10 11:57:01,2011-06-10 11:57:01
3f66c202029ab9911b3c4ce0d01eaf0a98111aba...e6480970b400b38c041ffedd611632eea2d720ea,1,3,0,3,1,2011-06-10 12:00:54,2011-06-10 12:00:54
5711ca93d13b74767788c0d7d68fb948e0f9e170...5de24ec7365cbf2894f40a59576745a2951859e4,1,13,13,26,13,2011-05-10 15:38:41,2011-05-10 15:38:41
5de24ec7365cbf2894f40a59576745a2951859e4...44dc0d261bb273d468e80d4a8242c6a4847b55b6,1,10,9,19,9,2011-05-10 16:56:44,2011-05-10 16:56:44
5711ca93d13b74767788c0d7d68fb948e0f9e170...ab86f159e5edbf0ffaf3ec2eb86584a6758a7a49,1,2,0,2,1,2011-05-10 06:39:32,2011-05-10 06:39:32
c3f35902f3f951de5ce5193409f336ee45c682b6...fb0b1523c40e843fd3bdae539e7382acd4a5c06b,1,6,6,12,1,2012-06-07 19:40:03,2012-06-07 19:40:03
fb0b1523c40e843fd3bdae539e7382acd4a5c06b...2774ccb8515354c2c6b9e9e4da09115ca44ecbd5,1,1,1,2,1,2012-06-07 19:40:34,2012-06-07 19:40:34
2774ccb8515354c2c6b9e9e4da09115ca44ecbd5...c41fc47512ed78697122de7a2b628676e3e08726,1,30,4,34,11,2012-06-07 20:26:39,2012-06-07 20:26:39
c41fc47512ed78697122de7a2b628676e3e08726...6b5db63c159ea1d2112fe8dc535b877da03a6848,1,2,0,2,1,2012-06-07 20:40:07,2012-06-07 20:40:07
6b5db63c159ea1d2112fe8dc535b877da03a6848...0f5e1f3b68eb68c257eb45b72650e8a653451a1d,1,8,0,8,1,2012-06-07 20:56:19,2012-06-07 20:56:19
0f5e1f3b68eb68c257eb45b72650e8a653451a1d...519757279eb25fe4075f65b86da5ce52d352b454,1,3,1,4,3,2012-06-07 22:13:39,2012-06-07 22:13:39
519757279eb25fe4075f65b86da5ce52d352b454...aa5a92d121d4fcc56d9661ce1c76534b410784c7,3,9,3,12,4,2012-06-08 17:57:35,2012-06-08 17:57:35
aa5a92d121d4fcc56d9661ce1c76534b410784c7...fa56478fb8d5e19d64bf43b51372ab3315cb1884,2,2,2,4,2,2012-06-08 18:15:11,2012-06-08 18:15:11
fa56478fb8d5e19d64bf43b51372ab3315cb1884...c3f7a9386d1f244a5442a1be484e1093b1698a02,1,12,1,13,3,2012-06-08 18:37:24,2012-06-08 18:37:24
c3f7a9386d1f244a5442a1be484e1093b1698a02...4c650c2b80d1b38759f0e7b6a782ed88d78648d5,1,3,3,6,2,2012-06-08 18:55:04,2012-06-08 18:55:04
4c650c2b80d1b38759f0e7b6a782ed88d78648d5...bb502fa803605bcfce08da5467e52813eff4d38d,1,4,3,7,3,2012-06-09 11:52:49,2012-06-09 11:52:49
bb502fa803605bcfce08da5467e52813eff4d38d...5c0fd7b976b8fb1271dbe61b9ea456672ab5b370,1,6,0,6,4,2012-06-09 12:20:07,2012-06-09 12:20:07
793545ef2bc0eb8b331ac715e77a3a77c8225320...602ee38b6e874f61f162ca7239c3a6d8c6099335,3,39,20,59,11,2011-06-04 18:45:09,2011-06-04 18:44:14
efcc87c9d95a0b156c657c0e5c11580e7f071efd...0657e46deef98803058a3c339433a2b6dcafcc13,5,26,12,38,9,2011-06-15 20:11:18,2011-06-15 10:36:08
6f3082d90fa70144ed4f5ae75c75366fce0a4f5e...0ee9f31c3b11116ab5806ab80d03b1d37197d6ce,3,121,0,121,3,2014-09-03 01:07:23,2014-08-20 14:23:39
0ee9f31c3b11116ab5806ab80d03b1d37197d6ce...bc737620dd0d331cb80c22d074569fe29b7ab585,7,256,41,297,25,2014-09-03 01:07:26,2014-08-20 14:24:41
0972443c47ba67d63d346c2775b501fc7063aaa8...1e71354e34f360b19285ca108cd07903122a0a62,1,15,18,33,7,2014-09-05 01:25:53,2014-09-05 01:24:43
844d226c9d3e1b8f1d58c5a5d57148de6c66d0cf...e07aebb4e2b6ab544153c294914118ae2f2f512c,1,18,18,36,9,2014-08-28 11:34:42,2014-08-28 11:34:42
e07aebb4e2b6ab544153c294914118ae2f2f512c...05f0d0c1190f0a3922d48d9f35c6ef6f3c2048a7,1,2,2,4,2,2014-08-28 11:36:58,2014-08-28 11:36:58
844d226c9d3e1b8f1d58c5a5d57148de6c66d0cf...b3d3459f32805a1290c5f1811b26a3e9e51a10df,1,1,1,2,1,2014-08-26 13:09:47,2014-08-26 13:09:47
844d226c9d3e1b8f1d58c5a5d57148de6c66d0cf...d747ec18e94474d2acedc7abc7aea0fde3f41ad8,1,2,0,2,1,2014-08-26 00:50:06,2014-08-26 00:50:06
fb48a51c6339e746197cf6c31dafbe692ddcb6ae...aea676336ceade0c1d07c1aea2f484289ce3c860,1,1,1,2,1,2014-08-14 15:18:20,2014-07-31 21:59:03
aea676336ceade0c1d07c1aea2f484289ce3c860...0f29e96793eda1f9a4a16d90f1a888cfa3d4deac,1,9,0,9,2,2014-08-14 15:18:21,2014-08-01 17:43:46
0f29e96793eda1f9a4a16d90f1a888cfa3d4deac...f96e7e6c94e4c414b4ec7e3a7bb37482488b3a80,1,2,0,2,1,2014-08-15 15:12:42,2014-08-15 15:10:27
f96e7e6c94e4c414b4ec7e3a7bb37482488b3a80...adcdeb36b0892c61832eb9add0b5cd6e9610e064,1,26,3,29,3,2014-08-15 15:12:42,2014-08-01 17:06:37
adcdeb36b0892c61832eb9add0b5cd6e9610e064...40867266bf964ed6acb2344e594e0c49106c3c67,1,12,3,15,4,2014-08-15 15:12:42,2014-07-31 22:39:58
40867266bf964ed6acb2344e594e0c49106c3c67...e003f83a5840d6e9966f1830768771bcd205ba52,6,92,23,115,19,2014-08-15 15:12:42,2014-07-31 19:14:56
e003f83a5840d6e9966f1830768771bcd205ba52...315cb38e1e32e77037e82c6cbdc383c151041112,3,622,30,652,33,2014-08-15 15:12:42,2014-07-31 22:43:20
315cb38e1e32e77037e82c6cbdc383c151041112...23135afa6f96ac63e65fd318918565222e46f65a,6,529,283,812,44,2014-08-15 18:11:56,2014-08-14 16:52:20
942a7b39edad519748456ddce97cf77a93c9babc...8d45b4691c81d2d1cde7a1b2f828dedd55315b3f,1,12,1,13,2,2014-10-13 14:58:03,2014-10-11 18:34:24
8d45b4691c81d2d1cde7a1b2f828dedd55315b3f...969b6a4710451b3e905757093dce4977cd596635,1,26,16,42,2,2014-10-13 14:58:05,2014-10-11 15:23:34
c13b68442fa92c19fb8e92f0c1da4704fe14174f...f0c53d21a43a098da2bf96a955ee22feb9ab8a5a,2,9,3,12,2,2014-08-27 15:37:29,2014-08-27 08:28:46
63ad439405e33081417bc87f523dab4a2d7b99af...a51201cc738eda4d8938672eaa636ac088316df4,1,1,1,2,1,2011-06-12 05:06:02,2011-06-12 05:05:26
86b74ea0ab267eb195f39fb5270ad513c4d4d3c5...f4a936b56a6bb0cbe6d5f4b5c7c73066ad2f3197,2,58,0,58,2,2011-05-10 21:35:40,2011-05-10 21:35:05
f4a936b56a6bb0cbe6d5f4b5c7c73066ad2f3197...6810bf28f8cecaeaf9cf32bee4bf0d5b55439819,3,93,94,187,4,2011-05-10 21:40:07,2011-05-10 21:40:07
6810bf28f8cecaeaf9cf32bee4bf0d5b55439819...40774549e14e2d9f24b9271173d58b44f82d5254,1,2,2,4,2,2011-05-10 21:47:51,2011-05-10 21:42:43
5c0fd7b976b8fb1271dbe61b9ea456672ab5b370...41cbbea8fe0aa56dc33027ba24249f69d831fe03,2,17,10,27,6,2012-06-09 22:05:59,2012-06-09 22:03:27
5c0fd7b976b8fb1271dbe61b9ea456672ab5b370...b9bfc7684b94bf052203034cbddfdf01e26205e5,3,5,1,6,2,2012-06-09 16:33:08,2012-06-09 16:33:08
b9bfc7684b94bf052203034cbddfdf01e26205e5...327fb51cec5393bd84b560ad7df5b85298f96e3c,2,11,7,18,6,2012-06-09 17:13:07,2012-06-09 17:13:07
327fb51cec5393bd84b560ad7df5b85298f96e3c...7d1983ebc2312c526057ecedd4cef628a4c33974,1,9,0,9,4,2012-06-09 17:58:11,2012-06-09 17:58:11
602ee38b6e874f61f162ca7239c3a6d8c6099335...2b397327e66e0e587e67df5a7803286db0f84ea0,1,7,2,9,3,2011-06-05 23:54:25,2011-06-05 23:54:25
2b397327e66e0e587e67df5a7803286db0f84ea0...f9213015fddb8636daa993080cbbec70a02cba5c,1,6,1,7,4,2011-06-05 23:54:59,2011-06-05 23:54:59
602ee38b6e874f61f162ca7239c3a6d8c6099335...393a9f9ee12fa635656f43155df1f664dfbb7215,2,2,2,4,2,2011-06-05 22:33:23,2011-06-05 22:33:23
602ee38b6e874f61f162ca7239c3a6d8c6099335...fd21c6f67f45831cf3f89ff43bdd4ccf66f138c8,1,33,0,33,2,2011-06-05 17:20:57,2011-05-29 20:36:26
fd21c6f67f45831cf3f89ff43bdd4ccf66f138c8...1b6d8163ce405b27cb58627712e658e59bd785c5,1,47,0,47,4,2011-06-05 17:22:32,2011-06-05 17:22:32
1b6d8163ce405b27cb58627712e658e59bd785c5...76b15cb18a0c153639bf156482e0a0ad57c0c8c8,1,2,2,4,2,2011-06-05 18:55:23,2011-06-05 18:47:30
ef9a6f4cbc4aac143279d7eb37909e78fd7c62cc...536955f9d7995b51d3caa0352d62728c5099543a,2,18,0,18,3,2011-06-16 00:21:33,2011-06-16 00:21:33
7d170a4b50b8e7721ff07956feb9a6463248b173...64fe8c62f90c6d887b2787f47ff815c2485e04d2,3,246,34,280,11,2011-06-07 01:22:32,2011-06-07 01:22:32
1e71354e34f360b19285ca108cd07903122a0a62...ccd8ba9bbaecb392a2587e2a046286af3f3cccef,2,2,4,6,2,2014-09-08 23:48:04,2014-09-08 23:45:57
d99c8ca1783cfd04869e88f8707c036fc6053a05...9b9405865e15da3a0a6ee0a67b59b36c5a973a8c,12,128,8,136,18,2014-09-16 15:01:30,2014-07-04 10:45:43
9b9405865e15da3a0a6ee0a67b59b36c5a973a8c...ec1ce4584a6a8ec2b5b227301a918548907a2b02,4,52,26,78,9,2014-09-16 15:01:30,2014-08-10 15:06:53
ec1ce4584a6a8ec2b5b227301a918548907a2b02...85acc56262b20567c40a90c0996115060655112c,1,35,0,35,1,2014-09-16 15:01:30,2014-08-29 15:07:07
85acc56262b20567c40a90c0996115060655112c...17491f6e5660b82cb8163eea58805df6398af16e,4,22,16,38,18,2014-09-16 15:01:30,2014-08-29 15:18:23
17491f6e5660b82cb8163eea58805df6398af16e...2f5864c50c3c82d01837570cb0b7e629295c65cf,2,47,47,94,7,2014-09-16 15:01:31,2014-08-29 19:15:36
2f5864c50c3c82d01837570cb0b7e629295c65cf...23ca0ad5ebcba3173ba3ff51e8114c33f795e62a,3,19,22,41,8,2014-09-16 15:01:31,2014-08-29 19:25:13
23ca0ad5ebcba3173ba3ff51e8114c33f795e62a...08545d366b24186631b08e3c232f35222d9de5ea,2,45,2,47,13,2014-09-16 15:01:31,2014-08-29 22:40:37
08545d366b24186631b08e3c232f35222d9de5ea...5f2cf732ab8ecbfdf69cad48a52c14483c7aa15f,1,1,1,2,1,2014-09-16 15:01:31,2014-08-30 11:12:33
5f2cf732ab8ecbfdf69cad48a52c14483c7aa15f...67c84e06f3cef3e555ddb74a1de9affdc3f0688f,1,44,32,76,10,2014-09-16 15:01:31,2014-08-30 12:04:57
67c84e06f3cef3e555ddb74a1de9affdc3f0688f...7c8acc54be390face2f8b519a828a7f2860bb5b3,1,42,6,48,6,2014-09-16 15:01:32,2014-08-30 12:26:57
7c8acc54be390face2f8b519a828a7f2860bb5b3...2aee4642ef9c0cffcebc443e81a706f3e458906f,2,16,17,33,2,2014-09-16 15:01:32,2014-08-31 21:16:19
2aee4642ef9c0cffcebc443e81a706f3e458906f...41698f22f683d3452ef83de3b3e82f5cb178b0b3,7,5,41,46,15,2014-09-16 15:01:32,2014-09-11 08:04:05
41698f22f683d3452ef83de3b3e82f5cb178b0b3...bf8756d6a2c42dc77b8a2de814a12e2ceb4487fd,2,36,1,37,3,2014-09-16 15:01:32,2014-09-15 19:51:42
d99c8ca1783cfd04869e88f8707c036fc6053a05...d908351a6c24d2d849e60a62bfb032a34ba96277,3,33,2,35,8,2014-09-05 16:26:56,2014-09-05 14:31:53
d99c8ca1783cfd04869e88f8707c036fc6053a05...f49819aa90829fcad457256f18e3385812d672aa,1,12,3,15,6,2014-09-02 13:28:13,2014-08-31 09:38:38
f49819aa90829fcad457256f18e3385812d672aa...8deea5899d0fec9bdde5387d1ea20ff3b19b0ed0,1,34,0,34,1,2014-09-02 13:28:21,2014-09-02 11:35:06
d99c8ca1783cfd04869e88f8707c036fc6053a05...bd465f9c2208cbb0264145695b850d6458eaa7b6,1,1,1,2,1,2014-09-01 15:36:12,2014-09-01 15:36:12
d99c8ca1783cfd04869e88f8707c036fc6053a05...fe3b67891b7ce73c317075bc93744ab6fab5bbff,1,9,0,9,3,2014-09-01 11:18:20,2014-09-01 11:18:20
d99c8ca1783cfd04869e88f8707c036fc6053a05...389526043a277afec9dd8b8dcd9aa97c4b3f2d6e,1,3,0,3,1,2014-08-29 13:27:36,2014-07-14 18:29:53
389526043a277afec9dd8b8dcd9aa97c4b3f2d6e...26bf3a53467cd4e7adbf70c3ec8f2d83ed82a605,1,0,2,2,1,2014-08-29 13:28:10,2014-08-10 15:13:00
26bf3a53467cd4e7adbf70c3ec8f2d83ed82a605...94412b009e81f0fdd474b0a0848f117cac3bd3b5,1,14,0,14,1,2014-08-29 13:28:10,2014-08-10 15:48:12
94412b009e81f0fdd474b0a0848f117cac3bd3b5...0cdaa3766a772e65dcbc491a2d671b6169e97c60,1,3,0,3,1,2014-08-29 13:28:10,2014-08-10 15:50:46
0cdaa3766a772e65dcbc491a2d671b6169e97c60...46254467cf1a092be899fb522f0560005b6111b3,1,19,2,21,3,2014-08-29 13:28:10,2014-08-29 13:10:15
46254467cf1a092be899fb522f0560005b6111b3...f2ffab618ad536bbd0da15d191bd9c488916761a,1,29,0,29,3,2014-09-02 10:47:12,2014-09-01 13:59:36
f2ffab618ad536bbd0da15d191bd9c488916761a...538f908175a0912e0119f0ea8935e2d2b2dc416c,1,61,0,61,1,2014-09-02 10:47:12,2014-09-01 14:35:10
538f908175a0912e0119f0ea8935e2d2b2dc416c...e128a1af6ec552f880051b67d72ab0a4c4c7d074,2,17,19,36,3,2014-09-02 11:10:19,2014-09-02 11:10:19
e128a1af6ec552f880051b67d72ab0a4c4c7d074...15c30b72e16528bdf71c0343e4d238600c0df7a1,2,23,35,58,11,2014-09-02 11:23:54,2014-09-02 11:23:54
e1c4429038d9b8f260edcc17c6d7ec03959ad563...dc8adda4f1430df3ab0144e4c14773445142104c,2,18,0,18,3,2014-08-15 20:56:15,2014-08-15 20:51:19
a51201cc738eda4d8938672eaa636ac088316df4...a64bf21bbb5f79d3ac523087a2953a35adbb896f,2,3,3,6,3,2011-06-15 19:10:10,2011-06-15 14:05:33
a64bf21bbb5f79d3ac523087a2953a35adbb896f...8e11e707f3f6c32b8cd2363bb9bbdd88ac8bc4d4,1,42,1,43,3,2011-06-15 19:10:16,2011-06-15 14:06:20
a51201cc738eda4d8938672eaa636ac088316df4...2e18e29b575cc8b67603d027f511ad7865dc32f4,1,0,1,1,1,2011-06-14 15:03:25,2011-06-14 14:35:57
a51201cc738eda4d8938672eaa636ac088316df4...9e3aa94764b1c686ee5848b6f5bf1821c354a759,3,4,5,9,5,2011-06-12 05:37:50,2011-06-08 18:39:38
9e3aa94764b1c686ee5848b6f5bf1821c354a759...95818ff73aa8af414c4c893a5088656ac07a6de4,1,4,1,5,2,2011-06-12 05:37:56,2011-06-08 20:15:49
95818ff73aa8af414c4c893a5088656ac07a6de4...63fadf99dccf51cf6f7912419690dd5af128a66a,2,3,1,4,2,2011-06-15 17:45:33,2011-06-15 15:04:11
40774549e14e2d9f24b9271173d58b44f82d5254...d1685ac7e91c5269cf01f6ab57c2c4705a14e6bc,1,1,1,2,1,2011-05-18 15:20:08,2011-05-18 15:20:08
40774549e14e2d9f24b9271173d58b44f82d5254...cbcaf0c09cd50ee705ea9740d57b722900f4e723,1,3,3,6,3,2011-05-11 10:39:31,2011-05-11 10:09:40
cbcaf0c09cd50ee705ea9740d57b722900f4e723...d6de92b6fe5d04111c3e9cd4a0c269c840ce59b6,1,7,7,14,7,2011-05-11 10:40:04,2011-05-11 10:40:04
d6de92b6fe5d04111c3e9cd4a0c269c840ce59b6...86f5fa7810c5675d5c789450c9c140330432bbbb,1,4,7,11,5,2011-05-11 12:00:53,2011-05-11 12:00:38
86f5fa7810c5675d5c789450c9c140330432bbbb...b51c92693d07dab0cb31311b9ad6b96aac127779,1,10,10,20,10,2011-05-11 12:44:44,2011-05-11 12:44:44
40774549e14e2d9f24b9271173d58b44f82d5254...0e0f4fdeee8e6009187b84a26b4b8c02452ff224,1,3,0,3,1,2011-05-10 22:33:07,2011-05-10 22:33:07
c3fad0ae3543691926434986840f4adddc70e34d...c9f79972baefb00e3c86a96e7a448c124bde7693,1,1,1,2,1,2012-06-09 22:13:21,2012-06-09 22:13:21
c9f79972baefb00e3c86a96e7a448c124bde7693...90490113af9cef092b36c5ee0231c11675ed9f51,3,22,5,27,10,2012-06-10 17:08:15,2012-06-10 17:08:15
90490113af9cef092b36c5ee0231c11675ed9f51...2aeadb9c78df4b463ffb3293e242e19a7e0d17a9,4,9,8,17,7,2012-06-12 18:25:09,2012-06-12 18:25:09
2aeadb9c78df4b463ffb3293e242e19a7e0d17a9...96ef3d84629ef72fb662d95abbab3de634921678,6,80,41,121,23,2012-06-13 22:16:14,2012-06-13 22:16:14
f9213015fddb8636daa993080cbbec70a02cba5c...ff9a4c130d09629af86a90ac64a89198faf4ffd8,3,23,0,23,3,2011-06-06 15:14:30,2011-06-06 15:14:30
f9213015fddb8636daa993080cbbec70a02cba5c...c09093cce2902bca40f3c0746bc754780f351a45,5,10,10,20,10,2011-06-06 15:04:37,2011-06-06 08:55:36
f9213015fddb8636daa993080cbbec70a02cba5c...05b49b02eff12670b81a28ecf7182a7553c72b6d,1,12,7,19,4,2011-06-06 10:17:58,2011-06-06 10:17:58
f9213015fddb8636daa993080cbbec70a02cba5c...790c6c95fe12051f7f7b32df5f4fba316872fddb,4,69,0,69,4,2011-06-06 09:55:48,2011-06-06 09:55:48
607d164380313624531a09b31b6c65ac4c670ee7...43521d0688c744e98f07f19dd0b15e6b2c763693,3,7,8,15,7,2011-06-16 00:27:43,2011-06-16 00:27:43
43521d0688c744e98f07f19dd0b15e6b2c763693...fa48608ec30758dbf6d0d26d3c4f8efba8efe8e9,18,103,103,206,91,2011-06-16 00:36:21,2011-06-16 00:36:21
fa48608ec30758dbf6d0d26d3c4f8efba8efe8e9...f1d018513aced2fb4e6c87f2d417b6f826dbe998,5,38,50,88,21,2011-06-16 00:50:08,2011-06-16 00:48:48
f1d018513aced2fb4e6c87f2d417b6f826dbe998...d144c569f372aace4b71e595cb541111730edce4,8,31,27,58,23,2011-06-16 01:06:22,2011-06-16 01:02:46
31e752b6546537bbeee89b6d2f3027cf0eff9a53...fdea219a86d12c802b8d7fa73445940770bb1b61,2,17,0,17,3,2014-09-13 22:39:07,2014-09-10 16:28:19
31e752b6546537bbeee89b6d2f3027cf0eff9a53...76e3c43fb99eb75cf33affb1a93260af4d472da5,2,4,4,8,3,2014-09-10 16:14:46,2014-09-10 16:13:34
0fef38999abc74b8237971f96295f461631d9d1d...0782fc43f809b1c2a5001453ccb064a4afcfc2b9,6,56,19,75,19,2014-09-16 15:02:32,2014-09-15 23:47:30
0782fc43f809b1c2a5001453ccb064a4afcfc2b9...ebda0970765e881feddd1879fb39ac9a3aa951a8,1,1,1,2,1,2014-09-16 15:02:32,2014-09-16 00:07:39
ebda0970765e881feddd1879fb39ac9a3aa951a8...286369a81fc2e1d77a7a134d5c140f023af1298b,3,21,11,32,10,2014-09-16 15:02:32,2014-09-16 00:27:16
286369a81fc2e1d77a7a134d5c140f023af1298b...1e0aa105faff1bd6987665506037f299b8e0e1cb,3,38,22,60,10,2014-09-16 15:02:33,2014-09-16 01:22:09
1e0aa105faff1bd6987665506037f299b8e0e1cb...4fe5b771b5c6c72ca33bf7593fe1aca1afd02578,1,0,7,7,1,2014-09-16 15:02:33,2014-09-16 11:35:36
4fe5b771b5c6c72ca33bf7593fe1aca1afd02578...52e09724fde2d46c1f31d07f6445dc7b4dee3947,1,4,2,6,2,2014-09-16 15:13:58,2014-09-16 15:13:58
a7fcac13a5a2590fe930d84fa471713861e76f25...b4913705fb692d9cf93977a34d93c1c1cd935748,1,2,0,2,1,2014-09-15 19:11:48,2014-09-15 19:11:48
fa44a1699ccd70725b236868ef4be5cac8c36267...34e510cedfdf0c45de9c77948898553778769ece,1,26,20,46,7,2014-08-26 15:18:52,2014-07-29 23:41:43
34e510cedfdf0c45de9c77948898553778769ece...0e5bb61992cce41cc45ba9ad352297cbb8432a6d,1,66,0,66,1,2014-08-27 15:27:07,2014-08-26 15:28:41
fa44a1699ccd70725b236868ef4be5cac8c36267...4e53c28096f4b04ab9b573fc594a538f51e10049,2,57,7,64,6,2014-08-17 12:55:06,2014-08-17 12:55:06
4e53c28096f4b04ab9b573fc594a538f51e10049...8f6073f63e42c2a3ff3b6fbb20729c7a911be30f,1,6,6,12,4,2014-08-21 16:53:43,2014-08-21 16:53:43
fa44a1699ccd70725b236868ef4be5cac8c36267...294c6f29645018fffdfdd01f9b65238e877dd6eb,1,20,4,24,3,2014-08-16 20:21:12,2014-08-16 20:12:13
fa44a1699ccd70725b236868ef4be5cac8c36267...1f2f61146507cdebc0ea59422d0d38c20eed4d7a,1,0,3,3,1,2014-08-16 09:13:21,2014-08-16 09:13:21
e0383fa35f981c656043976a43c61bff059cb709...5490c9d47036c44a255d3177f93664f4e034834b,1,14,1,15,2,2014-10-23 04:21:04,2014-10-16 02:52:55
5490c9d47036c44a255d3177f93664f4e034834b...1e2fe921a5fc8ad8188b69956179703f10d0a4ad,1,2,2,4,2,2014-10-23 04:21:29,2014-10-20 22:29:17
1e2fe921a5fc8ad8188b69956179703f10d0a4ad...ad5adacb1d1913620f022d7bb6c9b877ff3a4faf,1,6,1,7,3,2014-10-23 04:21:30,2014-10-20 22:29:45
e0383fa35f981c656043976a43c61bff059cb709...c51aa74ed38c2b8b86d5dbd2c8e58e45975db38a,1,0,2,2,2,2014-10-17 20:09:54,2014-10-17 20:09:54
c51aa74ed38c2b8b86d5dbd2c8e58e45975db38a...12e1803188407e6ee18b9bd22186dd5d02c8ba78,4,47,27,74,13,2014-10-18 13:22:19,2014-10-17 20:22:59
a6ed1fcbe1dbd78dbfd83da3dcff12ed37134e96...d091a9dbdeaa246b120feef60ce1940d7d22ea3d,2,23,12,35,4,2014-10-10 17:35:18,2014-07-10 10:21:28
d091a9dbdeaa246b120feef60ce1940d7d22ea3d...19c88310cb79153e19b93c59020b2f7c34794f6e,4,22,30,52,21,2014-10-10 17:35:18,2014-07-10 11:48:13
19c88310cb79153e19b93c59020b2f7c34794f6e...6843cebe17b7ce15eb9a6d1a88ac2e7e9c00d5b9,3,83,0,83,6,2014-10-10 17:35:19,2014-07-10 12:10:39
6843cebe17b7ce15eb9a6d1a88ac2e7e9c00d5b9...ee4db1c16eda223477d4723724471d26ed188831,1,110,0,110,1,2014-10-10 17:35:19,2014-07-11 09:48:51
ee4db1c16eda223477d4723724471d26ed188831...46bb00673013a7dae1ee81c484ac05c533ed1c4d,2,9,11,20,10,2014-10-10 17:37:48,2014-07-11 09:52:38
46bb00673013a7dae1ee81c484ac05c533ed1c4d...c2f8b215937ed6f17dce94a4bde26d5c83b42533,5,168,19,187,21,2014-10-10 17:43:42,2014-09-28 05:00:49
c2f8b215937ed6f17dce94a4bde26d5c83b42533...795d8e932893b9944c6fe72191cb80c2ccdd5d34,2,55,4,59,2,2014-10-10 17:43:42,2014-09-29 06:03:22
795d8e932893b9944c6fe72191cb80c2ccdd5d34...7465e873996c4157b8e10e353b803841c548e2dc,1,16,1,17,2,2014-10-10 17:43:42,2014-09-29 07:07:41
7465e873996c4157b8e10e353b803841c548e2dc...1b63af513365ecca86e824225a937b9d8eaa9dce,2,3,2,5,2,2014-10-10 17:43:42,2014-09-29 07:21:57
0f49a589013d0f5c75cccf75ee2dd6cc99ce3d91...b0233216691fc52c6886a7f53c650d56a651cc84,8,1,807,808,14,2011-06-14 15:40:17,2011-06-12 09:40:14
b0233216691fc52c6886a7f53c650d56a651cc84...1a7b52dcc9bac87ab58417e6df17d7e8bd352f06,3,13,285,298,5,2011-06-14 15:40:17,2011-06-13 13:34:34
1a7b52dcc9bac87ab58417e6df17d7e8bd352f06...953e1f93665e456928203255f4bd604f862fca9e,1,11,30,41,4,2011-06-14 15:40:18,2011-06-13 20:33:32
953e1f93665e456928203255f4bd604f862fca9e...7548b8afa3c70daadef77069e0f5c0aa7253489f,1,19,68,87,7,2011-06-14 15:40:18,2011-06-14 15:36:38
7548b8afa3c70daadef77069e0f5c0aa7253489f...904125075e72228b9c24d49c6243bc756c542c74,1,7,0,7,1,2011-06-14 15:40:18,2011-06-14 13:37:10
904125075e72228b9c24d49c6243bc756c542c74...737406b7ab95c4d789fbfaa4d0c957bdc95387da,2,3,3,6,3,2011-06-14 16:31:19,2011-06-14 16:31:19
737406b7ab95c4d789fbfaa4d0c957bdc95387da...f64586fab6055d27e9c37955b2875c8b6d617645,1,3,0,3,1,2011-06-14 18:00:06,2011-06-14 18:00:06
f64586fab6055d27e9c37955b2875c8b6d617645...742e3fc92ee24a6ddfc29aad5a82905ed0050de7,2,11,24,35,2,2011-06-14 21:18:13,2011-06-14 15:17:53
742e3fc92ee24a6ddfc29aad5a82905ed0050de7...388f37b37b50937666733185e3860b89c87e78c3,3,463,0,463,3,2011-06-14 21:18:13,2011-06-14 16:27:46
388f37b37b50937666733185e3860b89c87e78c3...2e6d8ec4369abbc360f7a5ce3ccd62295ac93f19,2,15,17,32,14,2011-06-14 23:02:23,2011-06-14 22:15:11
c4ddcb781219cdd586f5613fa1c80178bc496e38...f31bd03f7eed1bcabbd9561b444661e19b0f2567,1,2,0,2,1,2011-05-13 01:19:50,2011-05-13 01:15:46
f31bd03f7eed1bcabbd9561b444661e19b0f2567...098173c52adabf313e99c48475f51cd0d1e942a5,1,5,4,9,4,2011-05-13 01:19:53,2011-05-13 01:17:24
f02f4b536cfb5170a8ddc6d0e3b47631defd55ef...71747bcae034d2b0230b5f38c80eb3d185a63b42,1,1,1,2,1,2011-05-15 11:07:54,2011-05-15 11:07:54
f02f4b536cfb5170a8ddc6d0e3b47631defd55ef...77c3999ca928539c6ba9a29910bbe99d2b705efd,1,36,25,61,26,2011-05-14 12:46:22,2011-05-14 12:40:56
77c3999ca928539c6ba9a29910bbe99d2b705efd...3abe3bba5ab234a8fcbf4cc7a50adc86323d7287,2,29,24,53,21,2011-05-14 14:05:33,2011-05-14 14:05:33
3abe3bba5ab234a8fcbf4cc7a50adc86323d7287...81201a4c4d1e8704260ab4572eb6c480d576fe83,4,17,5,22,8,2011-05-15 04:57:34,2011-05-15 04:57:34
a21bb1aa33e9887c06852db62526895df6091736...a8df98c6fb07b8ddff18a01d7f2f607d9493dd7c,8,37,41,78,27,2012-06-14 17:57:24,2012-06-14 17:57:24
a8df98c6fb07b8ddff18a01d7f2f607d9493dd7c...d043013fea859f5eb6f677cad28319d093f1dbda,6,8,14,22,9,2012-06-14 18:09:42,2012-06-14 18:09:42
a21bb1aa33e9887c06852db62526895df6091736...17b45d801d6dd40566ec1b876b108eb033e6779a,1,0,2,2,1,2012-06-13 22:43:25,2012-06-13 22:43:25
1097dacd7d796e0c56492b717baf153ba88dff65...9d77d83a8108822bb8af49f13260e355a028e288,3,34,246,280,11,2011-06-07 01:38:09,2011-06-07 01:38:09
9d77d83a8108822bb8af49f13260e355a028e288...340fc0d40ac03680d6f7964bc47f8c8d7fbbc57c,1,37,30,67,7,2011-06-07 01:39:19,2011-06-07 01:39:19
d144c569f372aace4b71e595cb541111730edce4...b2e361cc5e5965d01ef4c033a14ecb61c8523dae,1,11,1,12,4,2011-06-16 18:22:05,2011-06-16 18:22:05
b2e361cc5e5965d01ef4c033a14ecb61c8523dae...038d2fc343192380bdb88047a1a2fdba8bd90255,1,2,0,2,2,2011-06-16 18:24:51,2011-06-16 18:24:51
038d2fc343192380bdb88047a1a2fdba8bd90255...3d5a02b653cfa07ffda7e136a94130e14935ee6f,1,1,0,1,1,2011-06-16 18:30:40,2011-06-16 18:30:40
d144c569f372aace4b71e595cb541111730edce4...e7e0e20fc59ab4126893edab3eda41ae1462b90b,1,8,26,34,8,2011-06-16 14:39:20,2011-06-16 14:39:20
3a495c19bd280f5455047a9ac0e936f2c2f2f9a9...062804570c3e25170b52f849da173f8266b5e33e,6,18,32,50,19,2014-09-24 09:00:51,2014-09-18 09:53:24
3a495c19bd280f5455047a9ac0e936f2c2f2f9a9...c5cf8cade3994463af3a7a09add41181769b8ba5,2,4,4,8,3,2014-09-17 13:19:08,2014-09-17 13:19:08
3a495c19bd280f5455047a9ac0e936f2c2f2f9a9...1d20092cef672781e91078631c7801f3b9a50590,1,0,2,2,1,2014-09-16 16:36:49,2014-09-16 16:36:49
3a495c19bd280f5455047a9ac0e936f2c2f2f9a9...3b2cb2c91ee77e5e45957e8355025e3e742c07bd,12,25,24,49,21,2014-09-16 11:07:04,2014-09-16 09:49:25
3a495c19bd280f5455047a9ac0e936f2c2f2f9a9...493c340ceff0c2fd17deb9f5c18548771f8dd4f5,1,41,0,41,1,2014-09-12 20:01:22,2014-09-12 19:59:09
493c340ceff0c2fd17deb9f5c18548771f8dd4f5...a565f364aba55c730908f80e63c90d9432667075,1,10,0,10,1,2014-09-12 20:53:56,2014-09-12 20:53:56
a565f364aba55c730908f80e63c90d9432667075...dc68ee8d158e4a773f3eaef4cdcb038e042e0e4e,1,1,3,4,3,2014-09-12 20:54:05,2014-09-12 20:37:15
1312f87b6838649cca525935656c84c7bd07a9a1...bbb988a5190be2a8763c60cb37c52466a39f6441,7,64,28,92,20,2014-09-17 13:00:12,2014-09-17 12:52:31
bbb988a5190be2a8763c60cb37c52466a39f6441...4cb7c4a4c7945c328c2e26e116dd46c49d1654ef,1,7,0,7,1,2014-09-17 13:08:16,2014-09-17 13:08:16
4cb7c4a4c7945c328c2e26e116dd46c49d1654ef...a2b4407dc3d4e1ecc5b908c3fff56dc207c7c4e6,1,8,5,13,2,2014-09-17 13:24:17,2014-09-17 13:23:17
a2b4407dc3d4e1ecc5b908c3fff56dc207c7c4e6...4e9641174884f5d81b7c12784b49c7c830116fe1,1,2,3,5,3,2014-09-17 13:24:56,2014-09-17 13:24:56
4e9641174884f5d81b7c12784b49c7c830116fe1...74240afb9c3394d35dfb3fe59dc38dbff70c0368,1,8,8,16,4,2014-09-17 13:35:50,2014-09-17 13:35:50
910cd2daa6af0f3af97d283eb4c6a0452688d067...1fbeb2f04c9a81a0fcacee5042d9e12a1e90052b,4,77,0,77,5,2014-09-16 04:59:23,2014-09-16 04:59:23
910cd2daa6af0f3af97d283eb4c6a0452688d067...2c22193ba0fd5487bab281aaa09bb6130f6c18b8,2,2,2,4,2,2014-09-16 00:56:33,2014-09-16 00:56:33
414dbe9633ace4991a32eb34e092449d6bbaa18b...0dc54e149498bbd5de5e5ecc6006f9f5afb6588c,1,0,1,1,1,2014-08-18 10:47:16,2014-08-18 10:44:41
0dc54e149498bbd5de5e5ecc6006f9f5afb6588c...43ebca8d7baa420a35ac1a8b23258066a0e5b223,1,1,0,1,1,2014-08-18 13:18:47,2014-08-18 13:18:47
4bb6ffb6bb8ad9d49eb173350be965183cd09c96...29eed1c74d65efbad48aa525f551c6f94d04002c,2,6,0,6,3,2014-10-24 14:50:57,2014-10-24 14:50:57
4bb6ffb6bb8ad9d49eb173350be965183cd09c96...46c8f7f8459e7062ca04d1cb8e11cf84e5cfbd0f,5,54,74,128,44,2014-10-24 14:25:59,2014-10-24 14:25:59
4bb6ffb6bb8ad9d49eb173350be965183cd09c96...0862f617da08cb371a647b3e454745f3b570de63,4,3,42,45,4,2014-10-24 11:40:42,2014-10-24 10:19:13
4bb6ffb6bb8ad9d49eb173350be965183cd09c96...55cb4999720f46eddb97e25e7ddc6ac068dd0bae,8,1,135,136,10,2014-10-23 17:05:02,2014-10-23 17:05:02
12e1803188407e6ee18b9bd22186dd5d02c8ba78...f0f9737094080a3c23abc013347a66342d360ec5,1,13,0,13,2,2014-10-23 13:56:29,2014-10-18 13:52:10
12e1803188407e6ee18b9bd22186dd5d02c8ba78...bb0757d56c7a2f0d337f1e22f9796f4090866480,2,9,36,45,10,2014-10-22 19:25:08,2014-10-22 19:09:31
fd0f6d38558a03e8f1685098bac0e86a2220c57d...0494a7c9a9affce8935b34fa6d7cd1b5428e081f,1,1,1,2,2,2014-10-10 23:52:47,2014-10-10 13:48:46
0494a7c9a9affce8935b34fa6d7cd1b5428e081f...59186d9b15e9dba61fc193b4832f9df4dfc124eb,1,30,14,44,12,2014-10-10 23:52:47,2014-10-10 15:37:20
fd0f6d38558a03e8f1685098bac0e86a2220c57d...babbff347c19473a8ce571c6ef3fbd0cc7b8d9de,2,2,2,4,2,2014-10-10 22:17:05,2014-10-10 22:17:05
babbff347c19473a8ce571c6ef3fbd0cc7b8d9de...85fe63bc58707da6cba85794ae642c200cf6faf0,2,3,3,6,3,2014-10-10 22:17:27,2014-10-10 22:17:27
2e6d8ec4369abbc360f7a5ce3ccd62295ac93f19...96da90ae1f5b1a90b387832d3b970bd6ef1cefbd,5,40,5,45,8,2011-06-15 16:40:06,2011-06-15 16:38:55
2e6d8ec4369abbc360f7a5ce3ccd62295ac93f19...8087bb937e667a8ca4861e4d9799a4763f8c3f48,1,1,1,2,1,2011-06-15 12:08:43,2011-06-15 12:08:43
3fe2e770ca93523eaf0c1b065f1d0b0038f8f867...4edf3e099aafbdaea2e4e128fc3230b36af38f41,1,2,0,2,1,2011-05-15 20:45:24,2011-05-15 20:45:24
4edf3e099aafbdaea2e4e128fc3230b36af38f41...7cadd1f6a788dbb997997481f09a2e430cc94958,1,3,3,6,3,2011-05-15 20:46:22,2011-05-15 20:46:22
7cadd1f6a788dbb997997481f09a2e430cc94958...f87d9beb8d9e3ed2b6baedd9ca15464f7da93f25,1,58,64,122,28,2011-05-15 20:46:39,2011-05-15 20:46:39
f87d9beb8d9e3ed2b6baedd9ca15464f7da93f25...5ca2f58057dfd5e0cf03a176782e4daa925a7f0b,1,3,3,6,3,2011-05-15 20:48:05,2011-05-15 20:48:05
d043013fea859f5eb6f677cad28319d093f1dbda...66a8b662b47ff526b7a6b9ad024d305dc85c7e0f,1,1,1,2,1,2012-06-14 18:15:46,2012-06-14 18:15:46
340fc0d40ac03680d6f7964bc47f8c8d7fbbc57c...5ab50417b7d51fff1c88158f0f334f42bfb5a9b7,1,1,5,6,3,2011-06-07 22:12:26,2011-06-07 20:49:13
5ab50417b7d51fff1c88158f0f334f42bfb5a9b7...3b3577c764ad06cd24bb9047107022abdf6fea90,1,34,1,35,2,2011-06-07 22:23:12,2011-06-07 21:32:14
3b3577c764ad06cd24bb9047107022abdf6fea90...8bb198e6744daa16cde3f8cea3669b86df83897d,1,172,1,173,6,2011-06-07 22:23:25,2011-05-17 14:39:09
8bb198e6744daa16cde3f8cea3669b86df83897d...711b1096f361ccdadfd3b316e41ca93ce1757975,1,2,2,4,2,2011-06-14 11:09:40,2011-06-14 11:08:30
711b1096f361ccdadfd3b316e41ca93ce1757975...a98b0d80dcfdc088419546e856eca43c1c1c1e9e,2,24,0,24,3,2011-06-14 12:26:08,2011-06-14 12:26:08
340fc0d40ac03680d6f7964bc47f8c8d7fbbc57c...8102a961b83afdee7341f2fc4bbb9fc3d9efd295,1,12,0,12,3,2011-06-07 15:02:33,2011-06-07 14:51:31
8102a961b83afdee7341f2fc4bbb9fc3d9efd295...bb9272dd7af68590452cbf91b0b8583e22f0c066,1,1,1,2,1,2011-06-07 15:05:40,2011-06-07 15:03:07
340fc0d40ac03680d6f7964bc47f8c8d7fbbc57c...ce78f39e27f384ec7169510aaa447d6d455931c8,1,2,2,4,1,2011-06-07 12:18:22,2011-06-07 12:18:22
ce78f39e27f384ec7169510aaa447d6d455931c8...a2a305fcf4a4c1a5026fa29a94062fe2069d1059,1,16,6,22,6,2011-06-07 13:39:40,2011-06-07 13:39:40
340fc0d40ac03680d6f7964bc47f8c8d7fbbc57c...52b188f6e870a76be514269ec27b79d1132e2d3d,1,2,0,2,1,2011-06-07 12:18:20,2011-06-07 12:18:20
340fc0d40ac03680d6f7964bc47f8c8d7fbbc57c...4d7905c579a4a89a4894ec1cea1f593338d1042f,3,26,13,39,11,2011-06-07 10:54:36,2011-05-25 14:04:29
4d7905c579a4a89a4894ec1cea1f593338d1042f...1869b31e0c99831b1de394ef8cb4d0c9ee633bea,3,5,2,7,3,2011-06-07 10:54:37,2011-05-25 14:11:57
1869b31e0c99831b1de394ef8cb4d0c9ee633bea...c1a2a14e022caae68112497f5e6862f9b59f1260,1,10,1,11,2,2011-06-07 10:54:37,2011-05-25 14:16:41
c1a2a14e022caae68112497f5e6862f9b59f1260...cbf4f9f41f18bdb812fb854cd7fd8c4ce62ed44a,2,1,1,2,2,2011-06-07 10:54:38,2011-05-25 14:31:14
cbf4f9f41f18bdb812fb854cd7fd8c4ce62ed44a...b74c867a1acfdc5ef0cfa91ba49d3f52d0ac6237,3,6,3,9,4,2011-06-07 10:54:43,2011-06-07 09:11:09
b74c867a1acfdc5ef0cfa91ba49d3f52d0ac6237...ee4912bf795237cb235b3d6533e9046fcd7e12b7,2,1,1,2,2,2011-06-07 10:54:43,2011-06-07 09:15:23
ee4912bf795237cb235b3d6533e9046fcd7e12b7...fdd1e04ce766c40be90a7b07580842a3f8d76b2e,2,7,1,8,2,2011-06-07 12:10:06,2011-06-07 12:10:06
fdd1e04ce766c40be90a7b07580842a3f8d76b2e...27a1b382c186dd4267924728344213de2a3692c3,1,1,0,1,1,2011-06-07 12:15:55,2011-06-07 12:15:55
340fc0d40ac03680d6f7964bc47f8c8d7fbbc57c...f120e92b232c237bf44b30e5732679180fa12e28,1,6,3,9,3,2011-06-07 06:41:33,2011-06-07 06:41:33
cb75ffea80c358323738bdc2e1763cfa15f0bb87...9c11bd0a060f96c9724418074f5cefd1e26ec2db,1,17,1,18,3,2011-06-17 17:09:18,2011-06-17 17:08:06
9c11bd0a060f96c9724418074f5cefd1e26ec2db...02285482f18250c33e3d0780cafc6d48346935f3,1,4,3,7,3,2011-06-17 17:19:30,2011-06-17 17:19:30
cb75ffea80c358323738bdc2e1763cfa15f0bb87...3d96996da6f125450ceb163204cff56e2f3d2daf,1,1,1,2,1,2011-06-16 15:10:25,2011-06-16 15:10:25
4592b62ee544617d06c38e0c840d604d6d34d1f6...5c22c4a20519b066e00a25b57c2266e829d905a5,1,2,2,4,2,2014-09-17 13:35:15,2014-09-17 13:32:21
cb4a956b9c20f2b7be404983e7bd156c772f4f64...737b445a1866706f271e163427823471bee8fb95,2,35,1,36,5,2014-10-01 00:26:39,2014-09-27 03:31:33
14556cbff7d8728d1dfed3b6decd097c87132387...2cd3cb8e03591e08c1cc1890ae5b82a498773f19,1,4,0,4,1,2014-09-24 08:22:03,2014-09-24 08:22:03
14556cbff7d8728d1dfed3b6decd097c87132387...e6e834a1299eb963c69839d0a3e8eb2e33f15640,5,11,7,18,11,2014-09-22 14:27:52,2014-09-18 10:23:07
e6e834a1299eb963c69839d0a3e8eb2e33f15640...db3d169c3351e31bab6cbddc7a7c29a0157f7a99,1,4,2,6,4,2014-10-09 15:32:38,2014-09-24 09:28:45
276d9ea3a664b1c1a75a72a05744fd7fc078538e...6340e8f5d0a54fab2ef9292e6c1e1a2e62b17310,1,2,3,5,1,2014-09-17 13:52:01,2014-09-17 13:52:01
6259576408520a93f7a3da220454a6b540536d15...52e9120c777fba582a468323d2b94155a071f5ea,1,5,5,10,3,2014-09-16 11:20:58,2014-09-16 11:20:58
73dd663876bbc070bdc0c062ba3e14448ed11c30...570452e31a58ad58716887cea479b7c00fc4f02f,1,10,3,13,3,2014-09-16 15:38:03,2014-09-16 15:38:03
27372263a025e9dbd40d357751466575dfc3476f...1ad15540e42d7f1fb209fdb568afa2aa03388ff6,1,3,2,5,1,2014-10-24 15:23:14,2014-10-24 15:23:14
d09458f3e9f24afa0689ce90b7d4191872372634...9223f2884cff6aea0a3781df054e30e1241218c4,1,1,1,2,2,2014-10-26 17:06:28,2014-10-26 17:06:28
9223f2884cff6aea0a3781df054e30e1241218c4...fad0aea9feedd19dcf063614fe1c53790ae218ec,1,1,0,1,1,2014-10-27 00:47:40,2014-10-27 00:47:40
d09458f3e9f24afa0689ce90b7d4191872372634...81f1fc71421162ea46c424a6ca309d918ae0dc9a,8,5,3,8,5,2014-10-26 03:41:01,2014-10-25 07:46:30
d09458f3e9f24afa0689ce90b7d4191872372634...ac63149cd16e825d540da0e317fbba1f83d886bf,1,7,5,12,2,2014-10-25 00:17:54,2014-06-05 23:13:04
ac63149cd16e825d540da0e317fbba1f83d886bf...09846fd1d1244e78481c593316bb8ff87b3a4a49,1,33,9,42,6,2014-10-25 01:06:53,2014-10-25 01:06:53
89244e7ff9755657b96d733b6936cecbd4e2ef0c...12f32d919390f47124bed41d6c54d75b666e1e5e,2,114,4,118,8,2014-10-22 21:49:53,2014-10-14 20:31:55
9e49cb7a4ba4f6961e3681cb59421cec04a50893...cf1013a888b16c22e8877fa0c8c9532972cb1b67,2,3,1,4,3,2014-10-13 14:32:26,2014-10-12 15:21:17
9e49cb7a4ba4f6961e3681cb59421cec04a50893...d6bbcefce3a6daf6ee2ece329e9708ca44409252,3,198,0,198,3,2014-10-12 11:25:20,2014-10-12 07:52:53
5ca2f58057dfd5e0cf03a176782e4daa925a7f0b...cce225bfaceed90c027d44d46680a3dbe182c93b,1,1,1,2,1,2011-05-16 08:56:20,2011-05-16 08:56:20
66a8b662b47ff526b7a6b9ad024d305dc85c7e0f...8d18f1f72375bab73029f3f755b9a8e5e57e1edc,1,86,35,121,15,2012-06-20 19:12:30,2012-06-20 19:12:30
8d18f1f72375bab73029f3f755b9a8e5e57e1edc...b6423939d5a40dc282f0f58c175f63015c4c229f,1,6,4,10,4,2012-06-20 19:35:13,2012-06-20 19:35:13
28606ffb60757d125d8d66e9d83a63b237c4c374...abd6d52c724a97bf183ed41d3efa5408087d5856,1,2,2,4,2,2012-06-20 18:27:17,2012-06-20 18:27:17
1071c56519866afd41db2f30705eba8406b6a4a1...ae496955d23d8c323259c0e090911d6fa3e2c3dc,5,145,16,161,10,2011-06-08 15:03:41,2011-06-08 15:03:41
3a12891f53cd5c349c0eed2ace7a9a900432aa5e...858ef372a4378652796d63c8d9af579608950f0a,1,11,4,15,4,2011-06-08 09:16:31,2011-06-08 09:16:31
f252d479e7363baa857248b3fb9a7fb4e517deaf...e01f7f642c941b7b647b4faf47497c0134306d2d,1,2,1,3,1,2011-06-17 17:40:06,2011-06-17 17:27:11
e01f7f642c941b7b647b4faf47497c0134306d2d...f0890fccf91bcfbc9f75397897831f411d00db6d,2,2,2,4,2,2011-06-17 17:40:51,2011-06-17 17:40:51
f0890fccf91bcfbc9f75397897831f411d00db6d...c716b1878e33d8cecf33e4c2a7b48d51bc88f95e,1,3,4,7,3,2011-06-17 17:47:58,2011-06-17 17:47:58
2cd3cb8e03591e08c1cc1890ae5b82a498773f19...3aaa5c7b468318d7391e8126d5ca2e30205435c7,1,8,0,8,1,2014-09-25 10:05:26,2014-09-25 10:05:26
3aaa5c7b468318d7391e8126d5ca2e30205435c7...ad8c8d9325397c9c6979e16e889de432beee8c9b,1,1,1,2,1,2014-09-25 15:56:56,2014-09-25 10:05:48
ad8c8d9325397c9c6979e16e889de432beee8c9b...ff97778a7a01eb3661418d4dcc1465dc4519fda3,1,29,24,53,8,2014-09-26 10:12:08,2014-09-25 11:07:36
ff97778a7a01eb3661418d4dcc1465dc4519fda3...d99e547173a73109520bc5d54333b12f0e8cf72e,1,1,1,2,1,2014-09-26 10:12:08,2014-06-11 07:37:15
d99e547173a73109520bc5d54333b12f0e8cf72e...7629ea5d8d3cf2278d89a41beba3caf0488f67b3,1,1,1,2,1,2014-09-26 10:12:08,2014-06-11 14:00:04
7629ea5d8d3cf2278d89a41beba3caf0488f67b3...e640a77c9f1b0fb111553b5ee3c3be7c51d11bd5,1,1,1,2,1,2014-09-26 10:12:08,2014-09-25 13:29:03
e640a77c9f1b0fb111553b5ee3c3be7c51d11bd5...5387cfee4cf4c4c0410e947f27555d0a6e87dc81,1,1,0,1,1,2014-09-26 10:12:09,2014-09-25 13:29:35
5387cfee4cf4c4c0410e947f27555d0a6e87dc81...0478b7f4725405bf43dee341d235ef5b5fc44046,1,1,1,2,1,2014-09-26 10:12:09,2014-09-25 13:35:00
2cd3cb8e03591e08c1cc1890ae5b82a498773f19...d0cf1040c703c7131c7c70d9de6bc2dd78b25d57,1,1,1,2,1,2014-09-24 19:01:14,2014-09-24 19:01:14
2cd3cb8e03591e08c1cc1890ae5b82a498773f19...940da5486109d7641c1740955b7fa6334bcda922,1,17,0,17,1,2014-09-24 11:24:06,2014-09-24 11:24:06
940da5486109d7641c1740955b7fa6334bcda922...7b7aa75f8047e99fa84d2351785e990ba6cc131c,1,5,3,8,3,2014-09-26 11:11:49,2014-09-24 11:24:39
ecef28d55c7d72dda0e33649614f2b20db482cd6...25abbc27a77895e2f2316ed307b51e628d85f15c,4,7,1,8,6,2014-09-17 01:19:40,2014-09-17 01:19:40
70f7e2c6e3fc908dd6a4e027dc43d5ce5be94d75...369b0217330383925d8091ae01079789cde80598,5,20,11,31,10,2014-10-27 02:13:40,2014-10-13 17:34:15
369b0217330383925d8091ae01079789cde80598...cdd71711cedd3c79a10f75ea8ff98c3979bf6c6c,2,3,0,3,2,2014-10-27 02:27:44,2014-10-13 18:34:32
cdd71711cedd3c79a10f75ea8ff98c3979bf6c6c...bc42479aaa789eee07af73dc094180f13dd13a63,1,28,34,62,22,2014-10-27 02:27:46,2014-10-13 19:43:03
bc42479aaa789eee07af73dc094180f13dd13a63...90aa2bf39b27a9194bd1b4d88efea8f4281d0617,1,1,0,1,1,2014-10-27 02:27:48,2014-10-25 23:51:12
90aa2bf39b27a9194bd1b4d88efea8f4281d0617...16288d2db3a303ef6a6fafcd8631567721ea6ddb,1,1,1,2,1,2014-10-27 02:27:50,2014-10-25 23:51:46
16288d2db3a303ef6a6fafcd8631567721ea6ddb...50aae0007b932e0f62d6842079e1300ed54b6df8,1,7,1,8,3,2014-10-27 02:27:52,2014-10-25 23:52:11
50aae0007b932e0f62d6842079e1300ed54b6df8...e4985fe3a938cae25222ca1cda9ba067e5b761ac,1,1,0,1,1,2014-10-27 02:27:54,2014-10-25 23:52:52
e4985fe3a938cae25222ca1cda9ba067e5b761ac...8c8ca7309b5b1f81d706226bd9f9ed6e3346e63a,1,2,0,2,1,2014-10-27 02:27:56,2014-10-25 23:53:07
8c8ca7309b5b1f81d706226bd9f9ed6e3346e63a...4b1b2bd9eb5ddfed32b509871fba30433a895ec9,1,1,0,1,1,2014-10-27 02:27:58,2014-10-25 23:53:27
4b1b2bd9eb5ddfed32b509871fba30433a895ec9...5a7cd1bcc057d8a6845dbf6c9aaa221d0fd2f0f4,1,4,1,5,4,2014-10-27 02:28:00,2014-10-25 23:53:53
5a7cd1bcc057d8a6845dbf6c9aaa221d0fd2f0f4...5b0c63061bc68950c1d986a8688fa1bf7baaf3ad,1,1,1,2,2,2014-10-27 02:38:45,2014-10-27 02:38:30
93b982b1c8e0e392edbedc5fb9da506a1170a309...4d86caec599ab760b523a026040bc4f40f8338c9,1,0,3,3,2,2014-11-18 17:32:25,2014-11-18 17:32:25
65f6c1c7eb7beb412e30cacd5cbb2b00e1e975b0...d6ecc311408b1042bb175aa0027b48b6224bc571,1,6,0,6,2,2014-11-17 13:03:15,2014-11-15 12:35:58
65f6c1c7eb7beb412e30cacd5cbb2b00e1e975b0...d698712bc79abafe977012cd7c1b4375f8d74ec1,1,4,3,7,1,2014-11-15 04:16:03,2014-11-15 04:15:42
65f6c1c7eb7beb412e30cacd5cbb2b00e1e975b0...889d8c8b8fe989b3208c68a5b024095d57105f6c,1,2,1,3,2,2014-11-14 23:20:36,2014-11-14 23:20:36
24deacb7ee7d4c77eaa4606afb21988d9fae8aa2...8d3b2ee3d73d73d5e185ab796d271da3328995c8,4,69,0,69,1,2014-10-13 17:36:16,2014-10-12 00:56:50
8d3b2ee3d73d73d5e185ab796d271da3328995c8...5e2cf2ca2c639b142776709df83b7fcbae0e4a70,1,19,3,22,5,2014-10-13 17:36:18,2014-10-10 11:22:11
5e2cf2ca2c639b142776709df83b7fcbae0e4a70...6a26488f8b162ad0b91a8ad52a6ed380939cdd2f,1,8,6,14,3,2014-10-13 17:36:20,2014-10-12 01:38:22
943fde7f8c1d270c2f0b73ff52f07b91e1983390...d9c0dbb042fc86a939d7393342cd469abda746ac,3,48,1,49,3,2014-10-24 11:31:18,2014-10-24 11:29:11
1e70b96e661302a6411eb49cf6ffd66e57c29e0c...3de79280e3aa79eb9bc95fa1e5a69499ba448bd9,1,14,6,20,7,2011-05-16 21:51:52,2011-05-16 21:51:52
3de79280e3aa79eb9bc95fa1e5a69499ba448bd9...335d6c998041f7c44dce48d3bb087c52136d970f,2,22,67,89,15,2011-05-16 22:46:07,2011-05-16 22:46:07
c716b1878e33d8cecf33e4c2a7b48d51bc88f95e...f0619886672be97bf574897989b9840557d15ecd,1,1,1,2,1,2011-06-17 21:58:34,2011-06-07 20:09:22
c716b1878e33d8cecf33e4c2a7b48d51bc88f95e...b76934de6cfb920bc52c03730667fad3e0434aa4,1,1,1,2,1,2011-06-17 20:30:29,2011-06-16 14:55:11
b76934de6cfb920bc52c03730667fad3e0434aa4...b22d147986504434188218ec74f9a6531497ffe9,3,48,1,49,4,2011-06-17 20:30:29,2011-06-16 15:46:06
b22d147986504434188218ec74f9a6531497ffe9...9ba9e513bc20d83f5c00dcabf8d0aa1d6df1e5f7,1,6,0,6,1,2011-06-17 20:30:29,2011-06-16 17:54:37
9ba9e513bc20d83f5c00dcabf8d0aa1d6df1e5f7...3de5df7d8e0e35653d49fb6484a4f0cf98af6c88,3,28,0,28,4,2011-06-17 20:30:29,2011-06-16 17:56:48
3de5df7d8e0e35653d49fb6484a4f0cf98af6c88...f3dad3acd75651099c0502e7586ef5a44c22684f,3,31,3,34,6,2011-06-17 20:30:30,2011-06-16 18:06:36
f3dad3acd75651099c0502e7586ef5a44c22684f...07ff881750a073dc17519f3b03f266468e124819,5,140,113,253,42,2011-06-17 22:39:39,2011-06-17 22:39:39
4c534892607a2127bff7f6266919470af37ef104...a2a23322193eeca5d2912c0b74c5374f8ec21737,1,1,2,3,1,2014-09-30 02:17:08,2014-09-30 02:16:17
9e44289c8dfece4171c7f272389b14d040c72228...867a36f3a67d0d1905572b84a3e44093fcac643b,131,926,24,950,60,2014-10-27 02:59:08,2014-07-14 18:35:01
867a36f3a67d0d1905572b84a3e44093fcac643b...daf395b795a6a56ff745b3cfe70a82a5290dabea,2,2,2,4,2,2014-10-27 02:59:10,2014-07-18 21:40:07
daf395b795a6a56ff745b3cfe70a82a5290dabea...4fe84d624b42a1ef1b9b392483ddc43064b1180e,3,289,0,289,5,2014-10-27 02:59:12,2014-07-14 19:19:19
4fe84d624b42a1ef1b9b392483ddc43064b1180e...950a70915930342d18286c6d6350929662a978e2,3,228,0,228,9,2014-10-27 02:59:14,2014-07-15 14:23:10
950a70915930342d18286c6d6350929662a978e2...443d5674fe3f2edd4cb51c7657e7ad5063275bff,2,161,18,179,24,2014-10-27 02:59:16,2014-07-17 15:59:01
443d5674fe3f2edd4cb51c7657e7ad5063275bff...a35a9890b00b538cd0f3ef94a526c0dd2ec461bf,5,241,11,252,16,2014-10-27 02:59:19,2014-07-17 22:25:03
a35a9890b00b538cd0f3ef94a526c0dd2ec461bf...93a7004cc234da31d912bb0f266c39b99ab8c8db,14,62,5,67,11,2014-10-27 02:59:21,2014-07-18 18:50:06
93a7004cc234da31d912bb0f266c39b99ab8c8db...14864fbfebfd3eb949790f302cfd872f1c0cc214,1,50,0,50,1,2014-10-27 02:59:23,2014-07-18 19:37:42
14864fbfebfd3eb949790f302cfd872f1c0cc214...517644cce4df8ac9ea40669dd22574d6dc76c02f,3,131,1,132,6,2014-10-27 02:59:25,2014-07-18 21:19:10
517644cce4df8ac9ea40669dd22574d6dc76c02f...a612a25fa673447e874407fd2d9501998885d392,5,67,35,102,15,2014-10-27 02:59:27,2014-07-18 22:22:54
a612a25fa673447e874407fd2d9501998885d392...bad4937ea50a8874598171c7ccb3d3443f1daf7b,3,51,4,55,9,2014-10-27 02:59:29,2014-07-21 14:47:01
bad4937ea50a8874598171c7ccb3d3443f1daf7b...5ae9d296e3313be59a969cb8eab250c7c8f7307d,3,255,18,273,24,2014-10-27 02:59:32,2014-07-21 16:25:03
5ae9d296e3313be59a969cb8eab250c7c8f7307d...18b439b9beee050de0dbf2f4649609764a69fb3c,3,111,25,136,40,2014-10-27 02:59:34,2014-08-23 23:19:34
18b439b9beee050de0dbf2f4649609764a69fb3c...b6b636a7fad2d87067df4df47f37b57467ad6bb6,6,398,295,693,216,2014-10-27 02:59:36,2014-08-25 18:29:50
b6b636a7fad2d87067df4df47f37b57467ad6bb6...f152f8ac0c6c20bf5e245e79629dc70a913496b1,3,165,125,290,72,2014-10-27 02:59:38,2014-08-26 21:18:46
f152f8ac0c6c20bf5e245e79629dc70a913496b1...ed2c06a6a1c8725483759782f60531d582d9ec46,3,156,0,156,3,2014-10-27 02:59:41,2014-09-11 20:47:20
ed2c06a6a1c8725483759782f60531d582d9ec46...e69737d76098d67cd3ebf53b9c152cfc2675fc61,2,3,3,6,3,2014-10-27 02:59:43,2014-09-11 20:46:46
e69737d76098d67cd3ebf53b9c152cfc2675fc61...796b03bd4969f170d8e7a7c9edd567f636b58cb3,2,15,26,41,11,2014-10-27 02:59:46,2014-10-03 20:47:48
796b03bd4969f170d8e7a7c9edd567f636b58cb3...18b00406c6427eb8c9d96864448474e1d85017de,21,700,631,1331,335,2014-10-27 02:59:48,2014-10-03 23:02:29
18b00406c6427eb8c9d96864448474e1d85017de...979645a7195b8ce9895c18ee00c8913ea38f93eb,3,47,34,81,17,2014-10-27 02:59:50,2014-10-05 00:17:26
979645a7195b8ce9895c18ee00c8913ea38f93eb...679172812c47de5af01fd1c9987dee855dfa9b08,1,14,0,14,1,2014-10-27 02:59:53,2014-10-27 02:37:01
4d86caec599ab760b523a026040bc4f40f8338c9...753e17b0f518c2510848a9dd73cc45e4c6df1a8a,7,80,32,112,24,2014-11-22 17:55:22,2014-11-19 17:42:29
4d86caec599ab760b523a026040bc4f40f8338c9...aa5a06c37d17a400f66c2da814a247fc8f8721a7,1,4,1,5,2,2014-11-19 23:52:52,2014-11-19 23:52:52
4d86caec599ab760b523a026040bc4f40f8338c9...1ca61bdcb9f344f2005eade0e043789774367d29,2,12,0,12,2,2014-11-19 19:57:15,2014-11-19 19:53:25
4d86caec599ab760b523a026040bc4f40f8338c9...7561f98d6d1157eec60d1fcf083c0a91a07cd95d,1,6,6,12,8,2014-11-19 19:54:30,2014-11-19 19:54:30
4d86caec599ab760b523a026040bc4f40f8338c9...699dfcc3bcd4494a1532bf608aa0d84022c58dbf,2,12,7,19,4,2014-11-19 14:49:02,2014-11-19 14:49:02
699dfcc3bcd4494a1532bf608aa0d84022c58dbf...8fd7dd778ddc2aa157de6a3b307a9c2b3686fe7a,1,1,2,3,1,2014-11-19 14:49:47,2014-11-19 14:49:47
8aa707376a4e9dc2b086569f3720901cfef83841...5915d7001b0084356ece3f23c5e7c3f2be17e39c,2,22,0,22,2,2014-11-17 13:28:22,2014-11-17 13:28:22
ce8822cb409917d0201f359cabe3ae55d25895da...a4fccbbf9d534daba7be11d9f1e0762df939dab8,2,15,14,29,10,2014-11-20 21:17:19,2014-11-17 05:01:40
2ae052d1b1574d1a4de402c91ebb98f061c997d4...798e4d53dcd2f5340782083130c0fb5227d596ac,4,125,140,265,11,2012-06-22 19:25:17,2012-06-22 19:25:17
deee4766a88a89cc4c77543c02bde93ba03e8d7c...40070445538ba6ede8dfef36e0a9824f71b33a06,1,5,1,6,1,2011-06-17 22:55:03,2011-06-17 22:54:24
40070445538ba6ede8dfef36e0a9824f71b33a06...dbe70bd5c3f803dbcb9fe4880df11cf08093b120,2,6,13,19,6,2011-06-17 23:12:58,2011-06-17 23:12:58
dbe70bd5c3f803dbcb9fe4880df11cf08093b120...920e000d38c5514499a5f0236fdfe11f3b14d9b1,1,1,1,2,1,2011-06-17 23:17:58,2011-06-17 23:17:58
920e000d38c5514499a5f0236fdfe11f3b14d9b1...19cb6857a4fcdc6df5cc6385d94d66d3962b237d,2,66,1,67,7,2011-06-17 23:50:48,2011-06-17 23:50:48
19cb6857a4fcdc6df5cc6385d94d66d3962b237d...2a406ab51c33059f49a5a9105be07b3a1f8210f4,2,3,4,7,3,2011-06-18 00:08:56,2011-06-18 00:08:56
2a406ab51c33059f49a5a9105be07b3a1f8210f4...e35e9fb4c38d30cce0c2ffe5127c6ecbb5406002,2,6,1,7,2,2011-06-18 11:23:19,2011-06-18 11:23:19
a2a23322193eeca5d2912c0b74c5374f8ec21737...44802c551e83c4c80295d6d246b933f5efa39041,1,4,1,5,3,2014-09-30 14:19:24,2014-09-30 14:19:24
44802c551e83c4c80295d6d246b933f5efa39041...5451754d4604daf88abb2069b061be402b3839a7,1,1,0,1,1,2014-09-30 14:27:53,2014-09-30 14:27:53
a2a23322193eeca5d2912c0b74c5374f8ec21737...262eec23fe7377a9eecf9e724fa1aba945b3162a,4,14,39,53,14,2014-09-30 14:09:55,2014-09-30 14:07:30
a2a23322193eeca5d2912c0b74c5374f8ec21737...20363d583cc843f6b7882094ec5077232e03e16a,2,2,2,4,2,2014-09-30 13:44:32,2014-06-28 05:26:33
20363d583cc843f6b7882094ec5077232e03e16a...bdeb8772fe846eeeea92cb2d9adb85315f3b8417,2,26,0,26,2,2014-09-30 13:44:32,2014-06-28 05:29:46
bdeb8772fe846eeeea92cb2d9adb85315f3b8417...ab8d9242f54e2c570f86a45a509b9420911a4d44,10,629,22,651,24,2014-09-30 13:44:32,2014-06-28 04:39:38
ab8d9242f54e2c570f86a45a509b9420911a4d44...f99ca52378cf3097fb56c7dbec379b8fc4c5459b,1,17,13,30,10,2014-09-30 13:52:13,2014-06-30 04:38:45
f99ca52378cf3097fb56c7dbec379b8fc4c5459b...db2f82630c1d8926beb5d1200ea5f06dec719fde,1,88,2,90,7,2014-09-30 13:52:13,2014-07-03 04:19:03
db2f82630c1d8926beb5d1200ea5f06dec719fde...274c3fa62e1e78e0927e43e620546fd4d024a1d2,1,5,0,5,1,2014-09-30 13:52:14,2014-07-27 15:22:32
274c3fa62e1e78e0927e43e620546fd4d024a1d2...c327d5db8b62e42f62a0b9e54b61b5f857036ca5,4,10,10,20,9,2014-10-09 14:29:30,2014-10-09 14:29:30
a2a23322193eeca5d2912c0b74c5374f8ec21737...3f8942052306a9d62521bdb6e6d5e7636bc5526e,10,64,29,93,37,2014-09-30 13:42:32,2014-06-06 13:01:45
3f8942052306a9d62521bdb6e6d5e7636bc5526e...9c206a2248e74f385c5f1a9928560efd97e3922f,2,71,28,99,24,2014-09-30 13:42:32,2014-06-06 13:24:53
9c206a2248e74f385c5f1a9928560efd97e3922f...c300d84a64601b09abcf0f2d2e6d492b4578770d,1,3,19,22,4,2014-09-30 13:42:32,2014-07-03 05:54:26
c300d84a64601b09abcf0f2d2e6d492b4578770d...2cdd5c5752f1dea43cd31be9b75be7f7f5e4eab1,2,10,1,11,6,2014-09-30 13:42:32,2014-07-03 05:56:31
2cdd5c5752f1dea43cd31be9b75be7f7f5e4eab1...c5837cad85c2730d30cd3c8b1018bd392ca8115a,4,124,0,124,7,2014-09-30 13:43:24,2014-07-04 07:03:33
b07db1eb7696c1ef71f122c2103780c7bb55ed47...334a0696f973f3719b37b4647f3d08bdd751fd4d,1,6,8,14,6,2014-10-27 03:23:08,2014-10-26 16:36:14
7561f98d6d1157eec60d1fcf083c0a91a07cd95d...ec7e680c6c56897bc0881cbcd14c2f1e9ac624c5,2,7,3,10,6,2014-11-21 20:05:34,2014-11-20 17:07:55
5915d7001b0084356ece3f23c5e7c3f2be17e39c...a03f6caf5c97a5ef8a9ec89c6f81662c12460bb1,1,2,1,3,1,2014-11-17 21:30:31,2014-11-17 21:30:31
5915d7001b0084356ece3f23c5e7c3f2be17e39c...d3cd7da51fc47d4dd864b398b6987472780aec43,2,39,0,39,2,2014-11-17 13:46:22,2014-10-29 03:56:18
6f4461763eb0518112d22c3a096417e7eedf7385...92e0b67930f350a40575954f4638cbc71fee57d2,2,9,7,16,3,2014-11-21 16:21:33,2014-11-21 12:31:30
92e0b67930f350a40575954f4638cbc71fee57d2...72d0024134a532374e7fa17ae9e5b6b021ffe324,1,4,4,8,4,2014-11-21 16:21:34,2014-11-21 12:32:21
72d0024134a532374e7fa17ae9e5b6b021ffe324...1ba48b7caf8e2de010b8c0038860b90be0692274,1,3,3,6,3,2014-11-21 16:21:34,2014-11-21 16:19:41
1ba48b7caf8e2de010b8c0038860b90be0692274...2e1e0f108f324719537bddd537099798e7d7449a,1,8,6,14,6,2014-11-21 16:24:55,2014-11-21 16:24:55
2e1e0f108f324719537bddd537099798e7d7449a...b7fb71e39cd48b61300647eec1e7dabab43da5af,1,2,3,5,2,2014-11-21 16:38:55,2014-11-21 16:38:55
b7fb71e39cd48b61300647eec1e7dabab43da5af...24cce2398f893b77f183425fffd957daa3300c5a,1,1,0,1,1,2014-11-21 17:09:57,2014-11-21 17:09:57
798e4d53dcd2f5340782083130c0fb5227d596ac...f9fd7105818dfd56cfce578bd1b58dd5dd8c839a,1,0,2,2,1,2012-06-25 13:38:36,2012-06-25 13:26:38
798e4d53dcd2f5340782083130c0fb5227d596ac...60029f499e147bb4e03c419e3e7d235cd8120609,1,1,0,1,1,2012-06-24 14:56:32,2012-06-24 14:56:32
e35e9fb4c38d30cce0c2ffe5127c6ecbb5406002...e49020e0bb660953578b1d57054b171f7b96f49f,1,1,1,2,1,2011-06-18 16:07:51,2011-06-18 16:07:51
5451754d4604daf88abb2069b061be402b3839a7...737b505116f263653ef4f0c80d888b1a87187a2b,6,16,12,28,14,2014-10-01 10:03:24,2014-10-01 10:03:24
10cf4b26a0810718c8ddd9221f5691af47498b4e...eecc177272cc97b13e11e35e8a67e8a7507d482a,1,1,1,2,1,2014-10-09 15:02:11,2014-10-09 15:02:11
af6cc38fc0acba14277ebfd247e0a46a867a2c33...1f501a086b4a9103f5ef5540c82c57d8559f0aff,4,4,4,8,4,2014-09-30 02:58:02,2014-09-30 02:58:02
1f501a086b4a9103f5ef5540c82c57d8559f0aff...3b6534b80768e8751b398cd3aeffb888e374c8d4,6,242,101,343,54,2014-09-30 05:24:28,2014-09-30 05:19:14
3b6534b80768e8751b398cd3aeffb888e374c8d4...fd8126e4c605e749ed6ab1e31ac32366adc8cc8f,5,102,6,108,12,2014-09-30 06:56:20,2014-09-30 06:54:52
fd8126e4c605e749ed6ab1e31ac32366adc8cc8f...55f1b6b6414035c675b3102ad4f25f4d02cbe695,1,27,6,33,9,2014-09-30 06:56:27,2014-09-30 06:56:27
55f1b6b6414035c675b3102ad4f25f4d02cbe695...5431c46a9604ac5c5d17390013d3741196b41051,4,34,49,83,23,2014-09-30 07:05:55,2014-09-30 07:04:04
5431c46a9604ac5c5d17390013d3741196b41051...25345c0cbe1493d63bbc9d309d7fcf0f84df741b,6,46,32,78,32,2014-09-30 07:18:22,2014-09-30 07:18:22
25345c0cbe1493d63bbc9d309d7fcf0f84df741b...886710b77e1ddfcff59bb6be1939752f1d56285c,1,2,2,4,2,2014-09-30 07:20:08,2014-09-30 07:20:08
886710b77e1ddfcff59bb6be1939752f1d56285c...a3b9270dcfe61ce3429f82b514b302667d05bfc5,1,71,3,74,12,2014-09-30 07:32:24,2014-09-30 07:32:24
aabe1e5a44301d33d4114a6bb370d79575864536...79b0ae4e2460b79055c12658d306d93be721cc36,3,5,2,7,3,2014-10-27 09:30:57,2014-10-27 09:30:57
53e48b370c585d5552cea7538bb20db500a865d7...32e2b758cf20f1a1a608c0e52e300254fe9bdd28,1,2,2,4,2,2014-11-29 20:57:35,2014-11-29 20:57:35
53e48b370c585d5552cea7538bb20db500a865d7...93aef71e90c8dd00eab1274cfec90d4b0a5cb7ba,1,1,1,2,1,2014-11-26 19:12:11,2014-11-26 19:12:11
e06b1040d703b4489f8280674e59b5245595c586...f7fcb18f8a7541bfc0228967fcbd916a9f515638,8,25,14,39,14,2014-11-23 14:51:31,2014-11-23 13:12:54
fc6ac074ee7ea945819e0a1d6f65ba160ba403d7...e015665142fad7314581063b25202f32631d510e,2,20,2,22,4,2014-11-21 13:09:53,2014-11-21 12:50:46
e0482934e6187b2e76c0e44960bcbd3ce3795d0c...60f3e876c5a75ff89d021fbdec6426ad4a7a2379,1,3,1,4,1,2014-11-22 17:42:00,2014-11-22 17:42:00
60f3e876c5a75ff89d021fbdec6426ad4a7a2379...1dbb74baf2a2d0a4e2b7f487f45c8d3875a106ae,1,1,1,2,1,2014-11-22 17:46:17,2014-11-22 17:46:17
8ee2bb54ec5e6446fa9884c116654df8195beb2b...bfd5e3e2a2f9793e4c24d0ac1c7f3e350a433330,1,2,2,4,2,2011-06-19 10:50:45,2011-06-18 13:07:41
bfd5e3e2a2f9793e4c24d0ac1c7f3e350a433330...984ed6b6bef18ca514f8f0a0b74ed76d9d8b26a3,2,28,17,45,13,2011-06-19 10:50:45,2011-06-19 10:48:16
984ed6b6bef18ca514f8f0a0b74ed76d9d8b26a3...37172582ec7ff9cb47c43c5d5b2334bf8c547569,1,2,2,4,2,2011-06-19 10:51:09,2011-06-18 19:14:55
9f57fd64436b6441684ce5e6641a0e390304224d...eca07bcd83ae7aa18230779be1bc73d150da8af2,4,107,2,109,6,2014-10-09 12:19:00,2014-10-09 11:58:23
eca07bcd83ae7aa18230779be1bc73d150da8af2...917f85a1a4616a93fcbba30c82caff9c1c011b83,1,41,55,96,28,2014-10-09 12:19:00,2014-10-09 12:16:10
9f57fd64436b6441684ce5e6641a0e390304224d...42835aa6b83c0c2f694cbe078b24243fe27486f2,1,1,0,1,1,2014-10-08 08:24:06,2014-10-08 08:24:06
42835aa6b83c0c2f694cbe078b24243fe27486f2...ad66bf88df087bee34bb0dd47a9eacfdbef89c57,2,22,27,49,12,2014-10-08 08:45:47,2014-10-08 08:45:47
ad66bf88df087bee34bb0dd47a9eacfdbef89c57...e7970576f1bcef1561813dbef339a31efabdc9b1,1,73,1,74,3,2014-10-08 13:52:11,2014-10-08 13:52:11
e7970576f1bcef1561813dbef339a31efabdc9b1...9b5d6cea4aba38a58233a93fde2d0ffd6945f171,2,17,11,28,7,2014-10-08 15:14:48,2014-10-08 15:14:48
9b5d6cea4aba38a58233a93fde2d0ffd6945f171...d6afda62d94d7bb29d864cf1c86648839ef60b2d,1,1,0,1,1,2014-10-08 15:17:31,2014-10-08 15:17:31
9f57fd64436b6441684ce5e6641a0e390304224d...18925129b2b07f114778041312d9f55d753bfde0,1,1,1,2,1,2014-10-06 07:17:01,2014-10-06 07:17:01
9f57fd64436b6441684ce5e6641a0e390304224d...3753110aedfbd3753a7b0a8797221b9f75805a7a,2,17,2,19,5,2014-10-05 10:13:40,2014-06-17 13:37:21
9f57fd64436b6441684ce5e6641a0e390304224d...0a64164700d3867855a0a7f6d168fb41eb704bf0,1,1,1,2,1,2014-10-04 15:27:06,2014-10-04 15:27:06
0a64164700d3867855a0a7f6d168fb41eb704bf0...a447a7e40b03d1c8ecb49ab0ef015eb4c0fd2b6e,2,18,0,18,6,2014-10-04 15:28:40,2014-10-04 15:28:40
9f57fd64436b6441684ce5e6641a0e390304224d...ca7cd1734d038a570f59ca7d2bd6cb63db763d49,1,2,2,4,1,2014-10-03 23:30:48,2014-10-03 23:30:48
ca7cd1734d038a570f59ca7d2bd6cb63db763d49...7c9bf891d5fa5a61dd91f2432bbfff7da325e062,1,3,1,4,2,2014-10-03 23:34:37,2014-10-03 23:34:37
46a2b8e855d5f6d8b60b81500a9f6779c7f63e63...8e398e4c84a4d02f2ee340590a0e6880277d210d,2,4,4,8,3,2014-10-10 11:17:53,2014-10-10 11:17:53
116a19d4674237af7a8ff1e1822e3033e1f8f0d7...ea66215d87a9cb588d01040f3191236babdbd53f,4,1,6,7,4,2014-10-27 16:19:07,2014-10-26 17:29:19
ea66215d87a9cb588d01040f3191236babdbd53f...64bcf567c30af6162f756f661c9f2a14f861deb4,2,2,2,4,2,2014-10-27 16:19:07,2014-10-26 17:30:05
116a19d4674237af7a8ff1e1822e3033e1f8f0d7...d88766c4e16c311ba8ce28e71a6545c5d0d7521f,3,8,3,11,3,2014-10-27 16:17:01,2014-10-26 17:40:46
169497d1e7c238d2925577d1af3dc03e9a507cd3...2d2cd625ea00c72e0498f1f899d31a0af6394f56,1,1,0,1,1,2014-12-03 20:01:42,2014-12-03 20:01:42
169497d1e7c238d2925577d1af3dc03e9a507cd3...70d21742bfaa65001fafa954a6a451637fec11fa,1,1,0,1,1,2014-12-03 05:41:46,2014-12-03 05:41:46
f7fcb18f8a7541bfc0228967fcbd916a9f515638...52ee0e8e6d187960dfc417f0f506f658caecede9,1,2,1,3,1,2014-11-23 20:26:53,2014-11-23 20:26:53
52ee0e8e6d187960dfc417f0f506f658caecede9...3fade40e393e1ca74be7f475819fcaecc9f4dc83,1,34,0,34,1,2014-11-23 20:29:35,2014-11-23 20:29:35
3fade40e393e1ca74be7f475819fcaecc9f4dc83...d5c84f67d311ed177ddfbd1c2645e23e46df5729,1,6,11,17,4,2014-11-23 20:34:45,2014-11-23 20:34:45
c89f1cf9d60c9e0543e53fbf411b994ef1ff32d1...dd4ff2c9b53dc9c8ba623477ead3e05f9baf73a0,3,307,0,307,3,2014-12-10 00:17:40,2014-11-01 11:35:54
dd4ff2c9b53dc9c8ba623477ead3e05f9baf73a0...468d7b11f9642f37a2c54e6fd6d539b223a103aa,4,418,15,433,13,2014-12-10 00:17:41,2014-11-01 14:19:54
468d7b11f9642f37a2c54e6fd6d539b223a103aa...02b4c1e2a426404ad7cad8e8a114f7f36bdb8b59,3,93,57,150,39,2014-12-10 00:39:09,2014-11-01 15:58:20
02b4c1e2a426404ad7cad8e8a114f7f36bdb8b59...b6f5464e2823b0782305d79c7d94b4f2fdfe0322,1,39,61,100,26,2014-12-10 00:39:09,2014-11-01 20:35:06
b6f5464e2823b0782305d79c7d94b4f2fdfe0322...4fd4341fe5da5353d50769c007e3189adaf12fd7,1,12,8,20,8,2014-12-10 00:39:09,2014-11-02 09:52:03
4fd4341fe5da5353d50769c007e3189adaf12fd7...1b75c29e3e175ad3ef4bc91a779b851dc76b9e09,5,17,500,517,22,2014-12-10 00:39:09,2014-11-02 10:17:01
1b75c29e3e175ad3ef4bc91a779b851dc76b9e09...49ae22baac96f14d63547c158a87b4de2d8373a8,4,4,4,8,4,2014-12-10 15:20:52,2014-12-10 00:38:52
49ae22baac96f14d63547c158a87b4de2d8373a8...a2fd56ab18cfe1a16372193e8ddfbbe6cadb5a78,2,2,2,4,2,2014-12-10 15:22:50,2014-12-10 15:22:50
37172582ec7ff9cb47c43c5d5b2334bf8c547569...d2b96cf47fca4f7fa725b2ef8f8e7c393e57d1ef,1,1,0,1,1,2011-07-12 18:19:42,2011-07-12 18:19:42
37172582ec7ff9cb47c43c5d5b2334bf8c547569...cdb6f9bf5e77b6e83d4bdc6cd75c31d0d3377800,1,2,1,3,1,2011-06-20 15:34:01,2011-06-20 15:34:01
cdb6f9bf5e77b6e83d4bdc6cd75c31d0d3377800...4cea2f0369238008100e00a5b2bc74eded24b6ee,1,8,4,12,2,2011-06-20 15:53:21,2011-06-20 15:53:21
37172582ec7ff9cb47c43c5d5b2334bf8c547569...24bd5e556bfb26978b721530c2daf038634c2078,1,18,0,18,2,2011-06-20 13:58:56,2011-06-20 08:40:21
24bd5e556bfb26978b721530c2daf038634c2078...28f7869dee25de082045591fac0876323b062a64,1,2,4,6,1,2011-06-20 15:28:59,2011-06-20 15:25:13
dfff1b5bcb632c4e135c9f7d1edaa9afd4fd962f...5623e627d433f1e5e3c1f2e093c760e838952e24,1,11,2,13,7,2014-10-09 18:54:48,2014-10-09 18:44:05
7647f4495dae86c730d50152d50ad779900e1088...53ca45ee25b712eaac367fdc37be40bee9f40711,13,8,12,20,10,2014-10-27 21:27:25,2014-10-27 21:27:25
8bfbe6988fe749a4970613db371a214f18fc5c9b...b874629b2d5823b7f52055a9784cc2e34cd48efb,22,23,23,46,23,2014-12-05 03:06:59,2014-12-05 03:06:59
792d750bed52070ffd10ecb96d12c4889c162ee4...6d91dc53514aa9eec4bdf2326d1f7657ac2426b3,4,58,18,76,25,2014-12-05 01:42:27,2014-12-03 20:28:44
cd305c2f567678c96bccecab69f715b6063089bc...d524b2d3d13cd306f4405b2e48cf586c04e4e5dc,5,10,26,36,10,2014-12-10 17:55:54,2014-12-10 16:23:33
d524b2d3d13cd306f4405b2e48cf586c04e4e5dc...85a6d5f49ca34d1ceb8ec4c4e43c5ce60d321fa3,1,7,5,12,2,2014-12-10 17:55:54,2014-12-10 17:49:01
ed754a75e145352c02da62b5d56df5866d7eec26...371599576a82b43ab30fe66feadcfb3045e649ff,6,18,8,26,12,2012-06-28 08:24:03,2012-06-28 07:33:08
467545d0a5a51ac2a06797b7997931d3bce0638d...d4760a42f97084fd63f914ebf04ec6275373ad66,3,32,63,95,25,2011-07-12 20:20:15,2011-07-12 09:29:36
3bf3ad9f03b32fe52b5bb78a0e9a0e0303ddc470...3101a3e5b8235285440e0eb62924266f2fc1892e,4,36,30,66,33,2011-06-23 00:29:11,2011-06-23 00:28:29
324154a4538f9e821cc1065b72109033b6d5da03...19fa9c0ca018ccc00299222e015a182e73816dc1,14,325,351,676,52,2014-10-09 20:14:55,2014-07-14 20:20:02
19fa9c0ca018ccc00299222e015a182e73816dc1...994a3006b61e0a729569770de51d5c13af6a23ed,2,6,6,12,4,2014-10-09 20:21:34,2014-10-09 20:21:34
264d74fd4088585fa9fb6ffd6d9afe280c0048bb...521c0cab7a02f718e4a7e3c2ae7ef81d6f16ffd1,1,5,0,5,1,2014-11-02 16:18:19,2014-11-02 16:18:19
264d74fd4088585fa9fb6ffd6d9afe280c0048bb...22fbb2656e3daf06c290d63d99b70c78f2f6d15d,1,1,1,2,1,2014-11-02 15:12:10,2014-11-02 15:12:10
264d74fd4088585fa9fb6ffd6d9afe280c0048bb...727ae380a5de63e7b5856abb1f4dd191e2d5b678,2,21,7,28,3,2014-11-01 16:21:45,2014-11-01 16:21:45
727ae380a5de63e7b5856abb1f4dd191e2d5b678...ebc13b2b7cfa9c5c7d3f7762666337bb4fd10d10,2,13,5,18,5,2014-11-03 01:16:49,2014-11-03 01:16:49
264d74fd4088585fa9fb6ffd6d9afe280c0048bb...e08365777199901d58e7cf4cc269ffabd07b2659,1,1,0,1,1,2014-11-01 09:47:22,2014-11-01 09:26:09
e08365777199901d58e7cf4cc269ffabd07b2659...fe6b51ae40313036436f81d4e87d232691cdacac,2,39,18,57,9,2014-11-01 09:58:55,2014-11-01 09:45:33
fe6b51ae40313036436f81d4e87d232691cdacac...15bea02c04ebf3172d495f14219b30eba262eb6a,2,84,0,84,2,2014-11-01 09:58:55,2014-10-31 10:24:02
de0c4555da57cddd1ea7eb47db87ca515dbe66ed...cce27d8242aa4d74324557e5c9f54fb4b67d7ec9,2,10,1,11,2,2014-11-03 19:10:31,2014-11-03 19:07:20
30ec05260d5fe2074f19b7f47021455cf10a7014...d43c7bd050cd461b13f4b5aa30f14010c5b2b611,2,2,2,4,2,2014-12-05 07:13:43,2014-12-05 07:13:43
4eb97ef3bf18403fbce351ae4cac673655d2886a...fe794b2ea7fa2b59c2394eb874c4be99c115c693,9,210,179,389,46,2014-12-30 17:02:50,2014-12-16 07:57:05
4eb97ef3bf18403fbce351ae4cac673655d2886a...3ded7f28c7bb1ad326fda82a6ea55ddb5dc7b8e0,1,34,0,34,1,2014-12-16 09:05:49,2014-12-16 09:05:49
3ded7f28c7bb1ad326fda82a6ea55ddb5dc7b8e0...4fd2bda9ff3130496c079cd0a7232ff5252a9842,1,52,0,52,9,2014-12-16 09:25:45,2014-12-16 09:25:45
4eb97ef3bf18403fbce351ae4cac673655d2886a...5f4739475307665f88ff1d52b35f2b17d3a9b869,3,130,0,130,9,2014-12-14 16:04:01,2014-09-22 15:17:35
5f4739475307665f88ff1d52b35f2b17d3a9b869...b8fefcb9ca85d16046dbf12a1d62399d4f4eb6be,1,128,0,128,1,2014-12-14 16:04:01,2014-09-23 15:21:41
b8fefcb9ca85d16046dbf12a1d62399d4f4eb6be...ce4b57c6bc16545e4f824dc66087e2bc665af7ac,1,6,6,12,6,2014-12-14 16:04:01,2014-10-27 21:40:33
ce4b57c6bc16545e4f824dc66087e2bc665af7ac...439e19f632b766a26b507c68305019dc3cbde59c,2,64,1,65,2,2014-12-14 16:04:01,2014-11-13 01:12:30
439e19f632b766a26b507c68305019dc3cbde59c...82eeba814285597c3259fb0cad39cade499d69f2,1,6,6,12,6,2014-12-14 16:04:01,2014-11-13 04:44:28
82eeba814285597c3259fb0cad39cade499d69f2...93d968fa0736a9c6f45f9e7da8ef7af8991265e7,1,6,3,9,3,2014-12-14 16:04:02,2014-11-13 06:05:09
93d968fa0736a9c6f45f9e7da8ef7af8991265e7...b91194e8426899980b9af5be42c48ba0d89eff96,1,14,19,33,10,2014-12-14 16:04:02,2014-11-13 17:22:10
b91194e8426899980b9af5be42c48ba0d89eff96...5e0c3d2d1a57f0a3764bdb1dc0ddb07e96f4b127,1,59,0,59,2,2014-12-14 16:04:02,2014-11-13 19:26:02
5e0c3d2d1a57f0a3764bdb1dc0ddb07e96f4b127...020aab9308fe30a9e7c9930514e4a5203981427e,1,1,0,1,1,2014-12-14 16:04:02,2014-12-14 15:50:33
020aab9308fe30a9e7c9930514e4a5203981427e...4aa23369660726479f2c3e4cbee2cd51497ad00b,1,12,0,12,2,2014-12-14 16:04:02,2014-12-14 15:56:38
4aa23369660726479f2c3e4cbee2cd51497ad00b...8c13eaedbb85a9f9211559a657c955d93f4af5de,1,6,3,9,2,2014-12-14 16:04:02,2014-12-14 16:00:54
8c13eaedbb85a9f9211559a657c955d93f4af5de...59ff8b679007fb7c50c1db713b666ad7d6cadca8,1,112,45,157,14,2014-12-14 20:25:08,2014-12-14 17:24:54
59ff8b679007fb7c50c1db713b666ad7d6cadca8...7b6e1e4cc668e0c9774d8149bdddd10ac7deeed5,1,9,0,9,1,2014-12-14 20:25:08,2014-12-14 19:40:52
7b6e1e4cc668e0c9774d8149bdddd10ac7deeed5...26186b155baf614bcea789d06e17fe7eb13715fe,3,2,19,21,8,2014-12-14 20:52:27,2014-12-14 20:01:19
26186b155baf614bcea789d06e17fe7eb13715fe...4adc64a81ae4d1ddb32c3232f04255f5b96d1971,1,34,18,52,21,2014-12-14 20:52:27,2014-12-14 20:24:46
4adc64a81ae4d1ddb32c3232f04255f5b96d1971...8aba3d47cf96e24e02601175f900f0e851077c1a,1,5,0,5,1,2014-12-30 17:06:04,2014-12-30 17:06:04
4eb97ef3bf18403fbce351ae4cac673655d2886a...ed09e04462ffbdd1ccf86340fad37e6aa4911449,1,13,0,13,1,2014-12-14 15:19:08,2014-12-14 15:18:09
4eb97ef3bf18403fbce351ae4cac673655d2886a...263b1d6ed97d56608f9a358fa0bfe9e66c968f36,4,24,19,43,9,2014-12-12 14:46:57,2014-12-12 07:29:43
263b1d6ed97d56608f9a358fa0bfe9e66c968f36...5192bcc52cbc7f049ef85f52a997a44cb4ebe5c7,1,5,0,5,1,2014-12-12 14:46:57,2014-12-12 07:30:37
4eb97ef3bf18403fbce351ae4cac673655d2886a...3410084675aa2b7bf5915ff022f89d4e0d66a1c5,1,2,2,4,1,2014-12-10 23:11:50,2014-11-26 21:24:37
3410084675aa2b7bf5915ff022f89d4e0d66a1c5...09debe1213b9c979e21106ccbe9d420f8511f4eb,2,42,0,42,4,2014-12-10 23:11:50,2014-12-01 18:06:11
09debe1213b9c979e21106ccbe9d420f8511f4eb...cceae9a25d0bed8b00f4981e051d5f380ef54401,10,591,103,694,45,2014-12-16 16:08:43,2014-12-01 18:09:58
cceae9a25d0bed8b00f4981e051d5f380ef54401...62155257d2d30d8f8d7108539df0681dce27ff61,1,1,1,2,1,2014-12-16 16:08:46,2014-11-24 23:14:52
62155257d2d30d8f8d7108539df0681dce27ff61...0d388adc86946f3c8cddc2493b470d47a653c4a5,2,188,23,211,20,2014-12-16 16:08:49,2014-11-24 23:58:03
0d388adc86946f3c8cddc2493b470d47a653c4a5...a64119e3963fcd358ba914c9e1a81a890666d15a,94,898,90,988,81,2014-12-16 16:08:53,2014-11-25 23:13:00
a64119e3963fcd358ba914c9e1a81a890666d15a...ee5da720e58f8870e5b6b272ef7514c2a717544a,2,46,4,50,4,2014-12-16 16:08:56,2014-12-03 03:20:42
ee5da720e58f8870e5b6b272ef7514c2a717544a...11d67b754d47967642570f796601e8850f001d73,53,207,1,208,33,2014-12-16 16:08:59,2014-12-11 00:12:16
11d67b754d47967642570f796601e8850f001d73...8e35527de25ac156f3600e2ce49b0c3483c258c4,3,132,81,213,8,2014-12-16 16:24:18,2014-12-16 12:03:02
8e35527de25ac156f3600e2ce49b0c3483c258c4...ec74b40ceef3dc3892c7d84bb4f5d99bab504ba4,6,151,44,195,20,2014-12-17 17:52:07,2014-12-17 00:53:55
ec74b40ceef3dc3892c7d84bb4f5d99bab504ba4...dce7b1a4e75551804a33591744d40d0582c57cfb,10,123,53,176,55,2014-12-17 18:05:27,2014-12-17 01:24:04
1de44c24936ecf39915913ddf26f68f78c7963d3...1d8943c640bad4425b8578aae6f680fa8e513bc7,4,21,0,21,5,2012-06-28 10:10:33,2012-06-28 10:05:49
d4760a42f97084fd63f914ebf04ec6275373ad66...91d8a4c077dd1fbb89706ab4293fef3ea2187c96,1,1,1,2,1,2011-07-13 21:55:48,2011-07-09 15:29:42
d4760a42f97084fd63f914ebf04ec6275373ad66...212b379a1fe9de8b1716f7749041affcea2445b9,1,0,2,2,1,2011-07-13 00:03:34,2011-07-12 15:30:34
212b379a1fe9de8b1716f7749041affcea2445b9...07d348776106d84d8a9d8dde65a1122e3cd4b076,1,0,1,1,1,2011-07-13 00:03:34,2011-07-12 15:37:27
07d348776106d84d8a9d8dde65a1122e3cd4b076...fad6607a5547245cea63d0ba7bf1c06fddbe651a,1,3,11,14,5,2011-07-13 00:03:34,2011-07-12 15:56:40
fad6607a5547245cea63d0ba7bf1c06fddbe651a...046dfea343964bdac55b14864f2e002a07c39813,1,0,3,3,2,2011-07-13 00:03:34,2011-07-12 16:01:09
046dfea343964bdac55b14864f2e002a07c39813...e1fca01477ccea8a6a3ef7d814f8d8dce10e32aa,1,5,5,10,5,2011-07-13 00:03:34,2011-07-12 16:33:30
e1fca01477ccea8a6a3ef7d814f8d8dce10e32aa...ae9f771c995e2e8d8116e120636bec2aea09889a,1,18,23,41,16,2011-07-13 00:03:34,2011-07-12 16:53:51
ae9f771c995e2e8d8116e120636bec2aea09889a...b16692faa3c39f8342f40ad14c70480b9126614b,1,6,2,8,2,2011-07-13 00:03:34,2011-07-12 17:29:12
b16692faa3c39f8342f40ad14c70480b9126614b...3dd26d1e36bec9753bee6c8a8f1311d7a0c47972,1,13,3,16,2,2011-07-13 00:15:31,2011-07-13 00:15:31
3dd26d1e36bec9753bee6c8a8f1311d7a0c47972...761aa2aa35d5427b8b22d342ef2116bc22252648,1,27,15,42,12,2011-07-13 00:49:47,2011-07-13 00:49:47
761aa2aa35d5427b8b22d342ef2116bc22252648...e6629d8313bcc4e1ca1213ef6d78db09b3a8f8ac,1,28,11,39,5,2011-07-13 01:36:03,2011-07-13 01:36:03
d4760a42f97084fd63f914ebf04ec6275373ad66...cd0fe1ac273c14097636847a2ecb4260d185ae28,1,1,0,1,1,2011-07-12 22:23:15,2011-07-12 18:46:07
cd0fe1ac273c14097636847a2ecb4260d185ae28...1a8167afbc2554677383b4275b37cc7c7ca61478,1,4,3,7,6,2011-07-13 22:06:24,2011-07-13 22:04:24
3101a3e5b8235285440e0eb62924266f2fc1892e...2c0ec236e984c62f74c0a4c2ee3eb4277fb7ffd1,1,5,0,5,1,2011-06-23 13:36:09,2011-06-23 13:36:09
521c0cab7a02f718e4a7e3c2ae7ef81d6f16ffd1...ea8dedc953919fa3f7a014ee1e0386f84ed326f1,1,7,7,14,4,2014-11-02 19:39:29,2014-11-02 19:39:29
521c0cab7a02f718e4a7e3c2ae7ef81d6f16ffd1...0f838d27f19f611651df1a4a031196815ebe70cb,1,27,0,27,1,2014-11-02 19:03:23,2014-11-02 19:03:23
0f838d27f19f611651df1a4a031196815ebe70cb...6d20006f7e8dbc26cf07bf8a945bc6972642c303,1,1,0,1,1,2014-11-03 14:12:32,2014-11-02 19:11:54
d43c7bd050cd461b13f4b5aa30f14010c5b2b611...21083a712933248ecc71a09abd20d548b912b194,8,20,17,37,19,2014-12-06 03:20:09,2014-12-06 02:12:04
21083a712933248ecc71a09abd20d548b912b194...bfa6cdbf13be242df0cde6cd6e51a005600c0f04,1,2,4,6,3,2014-12-06 03:20:10,2014-12-06 02:13:44
d43c7bd050cd461b13f4b5aa30f14010c5b2b611...a295bd2dc4a1ac2b15b9c39089d148499e6e9e00,18,127,29,156,44,2014-12-06 02:44:40,2014-12-06 02:36:18
d43c7bd050cd461b13f4b5aa30f14010c5b2b611...e0a97416d417895cb94d519ad0f16942051d302b,1,14,5,19,6,2014-12-05 18:43:36,2014-12-05 15:31:14
e0a97416d417895cb94d519ad0f16942051d302b...e05b2ff127e57eaed9900ddd7b9ac199d43268f8,1,86,3,89,5,2014-12-05 19:13:24,2014-12-05 17:25:38
d43c7bd050cd461b13f4b5aa30f14010c5b2b611...4f91bfa32b33c729b7370d3da89fa2141faaac9b,2,1,45,46,2,2014-12-05 09:41:54,2014-12-05 09:32:59
19ae843937bed26ddf522a4eb00953c81b1a4561...d226fbf1aa1943c49b863736592be3c9b82cbee3,1,2,3,5,2,2014-12-07 14:42:06,2014-12-07 14:42:06
d226fbf1aa1943c49b863736592be3c9b82cbee3...8e0aa2ebcee4387401ddede323fc4f8751a1ccfd,2,20,0,20,6,2014-12-07 15:41:30,2014-12-07 15:41:30
19ae843937bed26ddf522a4eb00953c81b1a4561...3a1eb9e5ffb60094e3b111ea30435fe45024f9d6,1,5,5,10,5,2014-12-07 14:09:00,2014-12-07 14:09:00
a3ef70bb405a05c16fb533d828da2510ff751224...f8263472d152ad6008a14a022c9866dbc4de8458,1,1,1,2,1,2014-12-30 23:54:30,2014-12-30 23:54:30
d147900ea4756975effa6cb568f932a4e3eb698f...36fc5497810f60cacdfab249c84583d25032a150,6,117,78,195,44,2015-01-14 16:17:56,2014-12-02 13:11:12
36fc5497810f60cacdfab249c84583d25032a150...b3837d4d2bbcae16a32deb732afa0e7e2e9b274e,1,1,7,8,1,2015-01-14 16:18:00,2014-12-02 13:47:32
dce7b1a4e75551804a33591744d40d0582c57cfb...c679bf42f53cd792c03c3d3b30d5e04901be6ede,1,4,0,4,1,2014-12-18 01:07:36,2014-12-18 01:07:36
c679bf42f53cd792c03c3d3b30d5e04901be6ede...c90ed5b5583ab62f31cca55f4d9ea4386600e2a3,1,2,0,2,2,2014-12-18 01:11:06,2014-12-18 01:11:06
c90ed5b5583ab62f31cca55f4d9ea4386600e2a3...284283180003a085ce03fb8fac2550a7ac9b9eb0,1,4,2,6,1,2014-12-18 18:41:59,2014-12-18 18:41:59
1d8943c640bad4425b8578aae6f680fa8e513bc7...e28dd29b6ec9cfce63cb5db02d964376cb713bfd,2,758,758,1516,49,2012-06-28 17:12:39,2012-06-28 05:50:16
e28dd29b6ec9cfce63cb5db02d964376cb713bfd...faaa7c517c71b1937da6888e173c9aa763b5286a,2,18,5,23,6,2012-06-28 17:12:40,2012-06-27 14:51:19
faaa7c517c71b1937da6888e173c9aa763b5286a...5b68ba7e158367c9dc613754c50cad640a63fd52,2,30,4,34,8,2012-06-28 17:12:40,2012-06-27 15:27:38
5b68ba7e158367c9dc613754c50cad640a63fd52...0d23c62c480d155b8ba446ca2ec536758a567bcc,2,6,0,6,3,2012-06-28 17:12:41,2012-06-28 09:09:16
0d23c62c480d155b8ba446ca2ec536758a567bcc...0e7af9e758f5fcb3ddc8a1130181ddf3ef9c6b20,2,3,1,4,2,2012-06-28 17:12:42,2012-06-28 16:04:01
e6629d8313bcc4e1ca1213ef6d78db09b3a8f8ac...f4ad64c109f14f9e8fd5df9d6bf93e82f039c3b0,2,10,3,13,3,2011-07-13 05:58:17,2011-07-13 05:58:17
324f0eecb63da00e26977f3fe7561756df91b2d2...52e50c1a80db56b91ce3d99bd546c07b7135f735,1,2,2,4,2,2011-07-14 01:26:08,2011-07-13 22:01:48
45e82ba21b6e0a08cd025199c57fbea1c15a19b5...8172dd4383c81bb8648b31cca09acea2143640da,1,1,1,2,1,2011-06-23 20:45:09,2011-06-23 20:45:09
8172dd4383c81bb8648b31cca09acea2143640da...ce90d81f6fde73303817086041c0a24a813abff3,1,7,4,11,2,2011-06-24 13:30:10,2011-06-24 13:30:10
ea8dedc953919fa3f7a014ee1e0386f84ed326f1...aad0bd6bc78b79bb8c0778c0c135c167d359fe12,1,2,4,6,2,2014-11-03 12:49:04,2014-11-03 12:46:56
ea8dedc953919fa3f7a014ee1e0386f84ed326f1...bc48bcdcb35785e8a51071e464e434fe1723585c,1,8,7,15,2,2014-11-03 12:23:13,2014-11-03 12:23:13
ea8dedc953919fa3f7a014ee1e0386f84ed326f1...a68e217f5c273c5c7bc6a419c600b33747b8558a,1,2,21,23,4,2014-11-02 20:58:39,2014-11-02 20:57:14
4bb8708730e81c551ca70f47ebd875f236e7998f...5c54e2162a21cb909e961c62f53e7d4c64f80cb0,2,42,1,43,3,2014-11-05 15:22:01,2014-11-05 15:07:07
64dc248577940c7874939bb82b6a557bafe8c388...9f664347ff74716dc35ff0bd9a1a87606ae29cf0,2,224,51,275,32,2014-11-06 23:49:57,2014-11-06 19:40:21
9f664347ff74716dc35ff0bd9a1a87606ae29cf0...2d24816b4611a7392617855f497f81f385092f34,2,56,13,69,15,2014-11-06 23:50:10,2014-11-06 23:49:37
b4e5432ff032c7d05c82ad2871e27f990493d6b7...aad638f3a1e4d98296c2ec9c4ed08f217a652c5c,7,45,73,118,32,2014-11-09 15:07:43,2014-11-07 14:00:11
b4e5432ff032c7d05c82ad2871e27f990493d6b7...0798b01400315db85715277d00f7a1262a5ed125,1,32,0,32,1,2014-11-06 09:10:26,2014-10-04 09:48:50
0798b01400315db85715277d00f7a1262a5ed125...6069042fcbf7a555c344fa1f020fac9b72d27aad,2,28,0,28,3,2014-11-06 09:10:26,2014-11-05 15:51:39
62d66a4ac52127cd4e9780c3a2dd321da4ae2e46...6e1205ef629c3cb18ae06b1ed5c8536725835e11,1,1,0,1,1,2014-12-22 18:40:04,2014-12-22 18:40:04
d5087689b506cd1c85e69b6b067e1dd05ec050ed...c251f3bbe775374a65ed6b6d843e26a7de90ad8b,2,2,0,2,2,2014-12-09 17:04:47,2014-12-08 21:05:47
c251f3bbe775374a65ed6b6d843e26a7de90ad8b...80b01c8f2639da24c1dc78a635abf12e111cf4d1,1,3,1,4,2,2014-12-09 17:04:50,2014-12-08 21:06:15
80b01c8f2639da24c1dc78a635abf12e111cf4d1...6b11eb51ee4decb03166679ecf5c5ebcaf1ab77e,1,50,7,57,19,2014-12-09 17:04:53,2014-12-08 21:59:41
6b11eb51ee4decb03166679ecf5c5ebcaf1ab77e...ad2bf40a9d11d0b848d0b4a66a92aea8568609a4,1,67,47,114,11,2014-12-09 17:04:55,2014-12-08 22:31:34
ddf9d7d4550927b39faddcde0c2b98b5001226b0...629417bd10d3308f1ee6fedd5bbb206a259337aa,1,2,0,2,1,2014-12-19 08:08:47,2014-12-19 08:08:47
56065c0954bc7bf6a28cb0a0534b26536b5361ea...4b1018d24f980273528743c27c47ceb96cb720bd,2,33,1,34,2,2015-01-09 15:46:44,2015-01-08 22:24:12
56065c0954bc7bf6a28cb0a0534b26536b5361ea...d76e9df9a279b84746eb1272fa6ec31cbe47b832,1,1,1,2,1,2015-01-02 23:56:03,2015-01-02 23:56:03
56065c0954bc7bf6a28cb0a0534b26536b5361ea...c070ac64fdf799cf57a920583e502ea58fd22b6f,1,5,0,5,1,2015-01-01 12:19:33,2015-01-01 12:14:58
cbc02c1021ab99903d9e0a616137048d33df5f26...4de89ce72aa66fe2141f973960c3baf1e373a827,2,2,3,5,3,2012-06-29 15:22:43,2012-06-29 14:51:46
4de89ce72aa66fe2141f973960c3baf1e373a827...08ac23a5fd3f237f3e028dbdfc4e49133bb53a2e,2,5,2,7,3,2012-06-29 15:23:10,2012-06-29 15:02:29
08ac23a5fd3f237f3e028dbdfc4e49133bb53a2e...52b938d55a0619abb3b8f8b7b450a140f560a6d4,2,2,1,3,2,2012-06-29 15:23:18,2012-06-29 15:06:38
cbc02c1021ab99903d9e0a616137048d33df5f26...0e2fcca850e3021da4a08bc6487a10b35a75d05b,6,223,164,387,65,2012-06-29 00:21:12,2012-06-29 00:21:12
0e2fcca850e3021da4a08bc6487a10b35a75d05b...7e8c146c6b78fe5b9d26f059e381b978260984f4,1,0,1,1,1,2012-06-29 07:47:46,2012-06-29 07:47:46
7e8c146c6b78fe5b9d26f059e381b978260984f4...46ea40d9955a171187d252872f5c9bac1da7e286,2,4,4,8,4,2012-06-29 15:08:36,2012-06-29 15:08:36
52e50c1a80db56b91ce3d99bd546c07b7135f735...13bc2016b7aaa3d7d17337fe7737481c67b2cb8a,1,10,0,10,1,2011-09-02 11:04:29,2011-09-02 11:00:27
52e50c1a80db56b91ce3d99bd546c07b7135f735...e944cfa949d94f706867ab61878047ea7a24555d,1,7,0,7,2,2011-07-17 18:50:59,2011-07-14 15:05:22
52e50c1a80db56b91ce3d99bd546c07b7135f735...e5f365051f4c1bf6d22444600504463480b90922,1,1,1,2,1,2011-07-14 13:11:31,2011-07-14 13:11:31
ce90d81f6fde73303817086041c0a24a813abff3...e233fa6f17ff642fa6bcc94ee58943e6f3eb5cbe,1,4,0,4,1,2011-06-26 14:37:04,2011-06-26 14:37:04
dd83e6021261192ac143076c7784c654ed1ad33c...f1a7906fdf0657fba88449bdab07237847f36670,1,48,0,48,1,2014-11-07 07:33:27,2014-11-06 10:47:50
f1a7906fdf0657fba88449bdab07237847f36670...62a617dc683c1e73eebd0e1b6209f76748e67ed4,11,119,31,150,48,2014-11-07 07:33:27,2014-11-06 15:16:46
0bb237ed89a6700a1b6b884444ff044fd1467535...61ee5b0e577383bd0ae99080a879add0be2d1f59,1,77,0,77,1,2014-12-23 16:14:01,2014-05-09 00:35:03
61ee5b0e577383bd0ae99080a879add0be2d1f59...40d791545abfb3cb71553a27dc64129e1a9bec28,3,6,14,20,4,2014-12-23 16:14:04,2014-05-10 02:32:52
0bb237ed89a6700a1b6b884444ff044fd1467535...2fe8157e1b603e0353fd991f3d129b49d35bed99,2,6,6,12,6,2014-12-23 00:42:03,2014-12-23 00:42:03
0bb237ed89a6700a1b6b884444ff044fd1467535...b2ab887e1137207edb286812a3237b351ab39506,18,131,10,141,21,2014-12-22 21:35:45,2014-10-20 22:07:32
b2ab887e1137207edb286812a3237b351ab39506...9d1f97df1045fa88a9b5c0db202d8896324db987,7,692,17,709,20,2014-12-22 21:37:35,2014-10-29 21:49:04
0fae0391163c9c747e4b80976cf06dbf2917e479...775d831b337295e3764c9c5d877e114eaa29701a,1,2,2,4,2,2014-12-10 09:04:34,2014-12-10 09:03:07
775d831b337295e3764c9c5d877e114eaa29701a...037b2a8b00036f41a05ed3b056f8b784a544010c,1,1,1,2,1,2014-12-10 09:05:04,2014-12-10 08:55:29
037b2a8b00036f41a05ed3b056f8b784a544010c...a7e06cb026ac3edb0e5c4bac980584e98235d2a8,1,1,0,1,1,2014-12-10 09:11:37,2014-12-10 09:11:37
629417bd10d3308f1ee6fedd5bbb206a259337aa...6fd00266a8c5c39d98abf2ec899db6f5cbd8874f,2,3,1,4,2,2014-12-19 15:54:01,2014-12-19 15:54:01
6fd00266a8c5c39d98abf2ec899db6f5cbd8874f...6987a580f7de787cceae242339b78608b2ef9d50,1,13,0,13,5,2014-12-19 15:54:42,2014-12-19 15:54:42
629417bd10d3308f1ee6fedd5bbb206a259337aa...ceb651c9b0604be7be3b8e29653997c6f7826367,1,11,0,11,2,2014-12-19 14:31:49,2014-12-19 14:31:49
d4b2410126966a4508ce3ea8faead7c12640f2c9...d97ba7f6744012fb51127d5313543a10c5a60e43,5,226,0,226,5,2015-02-06 20:45:59,2015-02-06 20:45:59
d4b2410126966a4508ce3ea8faead7c12640f2c9...b91f28be7d36a94e5e4ccef798ab03ed62a8517c,1,158,146,304,57,2015-01-09 23:49:20,2015-01-09 23:49:20
55d9c29aa0c69cdd766c5100fc012d8e0b486e23...c4a2fd5c1deda45afb569706827c2b490f705623,2,1,1,2,2,2015-01-04 17:39:43,2015-01-04 17:39:43
a93acf916936ee62664f1ff54842b2b4165951ae...4d6f55acce14eeec55729e55335635375e9026df,1,2,0,2,1,2015-01-14 16:26:26,2015-01-14 16:26:26
e560aa8ffa7cf143fbd34a5aec44741ae4c77271...521aedad307c6f72d6f6d660943508b2b015f6dd,8,219,0,219,10,2012-07-03 10:50:51,2012-06-05 12:48:51
e560aa8ffa7cf143fbd34a5aec44741ae4c77271...973ed4c9f02a036a7eb706a8eab9ba32d0cdf4a5,1,5,0,5,5,2012-07-03 10:11:19,2012-07-03 10:11:19
e560aa8ffa7cf143fbd34a5aec44741ae4c77271...494ae940a07831fd1ce318f6fd0f04738bfc2fe5,3,71,32,103,6,2012-07-02 17:56:41,2012-07-02 15:51:02
e560aa8ffa7cf143fbd34a5aec44741ae4c77271...29f9186d1b772994f65bb87ac88180d7d9d4141b,12,76,12,88,18,2012-07-02 15:27:49,2012-07-02 09:18:01
564f0f7be1d962fdb3bdc42e7e47db9c1ce960ec...26e74c6acedaec5c76944ac1f1a0f9215f23737f,6,17,13,30,13,2011-09-08 15:07:37,2011-09-08 12:21:17
26e74c6acedaec5c76944ac1f1a0f9215f23737f...45e93ef34e3373440d17081557e1e5100caaaeac,2,6,6,12,5,2011-09-08 15:07:52,2011-09-08 12:22:29
45e93ef34e3373440d17081557e1e5100caaaeac...353560b440cd40c0ed6b9bffeea9b0c0cc70583b,1,1,1,2,1,2011-09-08 15:08:10,2011-09-08 12:29:54
353560b440cd40c0ed6b9bffeea9b0c0cc70583b...1c3fac4d5e18beacb07865354b10a0bc282a49a7,3,10,10,20,10,2011-09-08 15:08:57,2011-09-08 12:31:37
1c3fac4d5e18beacb07865354b10a0bc282a49a7...18136d83068ab7f2b690a6347e1ef6d806c13d30,1,1,1,2,1,2011-09-08 15:09:10,2011-09-08 14:43:58
18136d83068ab7f2b690a6347e1ef6d806c13d30...bac47f1ff8c6684671c67000c747a6b0a7f2c6dc,1,1,0,1,1,2011-09-08 15:13:32,2011-09-08 15:13:32
564f0f7be1d962fdb3bdc42e7e47db9c1ce960ec...3d975abcb8b1dfe538b20d64598f85c94c34df61,3,60,1,61,3,2011-09-04 14:04:14,2011-09-02 12:20:43
3d975abcb8b1dfe538b20d64598f85c94c34df61...db84b7988bfbc9caf4fa584d775b4b43154261db,3,34,32,66,5,2011-09-04 14:07:52,2011-09-04 13:32:11
db84b7988bfbc9caf4fa584d775b4b43154261db...76a9081db2c7a8adb9eac2c02b71358106a41930,1,2,5,7,3,2011-09-07 14:37:19,2011-09-07 14:35:11
76a9081db2c7a8adb9eac2c02b71358106a41930...b0bda0a4ee248ab3b0ccd0fad2f62b8b66c5fc6c,1,1,1,2,1,2011-09-09 11:12:11,2011-09-07 17:13:40
b0bda0a4ee248ab3b0ccd0fad2f62b8b66c5fc6c...b87600cb6b80678f1ef8ca994785a4ba733c2133,2,6,0,6,2,2011-09-09 11:12:11,2011-09-05 00:33:02
b87600cb6b80678f1ef8ca994785a4ba733c2133...c7c3051328f605255c485cc49f58d16c7556d8f2,2,8,0,8,2,2011-09-09 11:12:11,2011-09-05 19:38:56
c7c3051328f605255c485cc49f58d16c7556d8f2...b76f7522790992f0c54a1d68c761cb1fdba24412,2,25,0,25,4,2011-09-09 11:12:11,2011-09-04 19:28:11
b76f7522790992f0c54a1d68c761cb1fdba24412...24384700d2105bf37b705c6b8e85626b60a28f10,1,1,0,1,1,2011-09-09 11:12:11,2011-09-06 19:44:13
24384700d2105bf37b705c6b8e85626b60a28f10...b8a8191fed7463c1811ecc603513f19a06d32373,4,2081,3,2084,6,2011-09-09 11:12:12,2011-09-04 23:13:46
b8a8191fed7463c1811ecc603513f19a06d32373...928dd90ae878d10b05b3fb734b184dc7f6a6a046,1,1,1,2,1,2011-09-09 11:17:58,2011-09-09 11:17:58
928dd90ae878d10b05b3fb734b184dc7f6a6a046...1b7629008954b49bc55fac922cd72f8f659724e0,1,325,0,325,7,2011-09-12 15:04:17,2011-09-09 11:18:52
1b7629008954b49bc55fac922cd72f8f659724e0...5604f92880333fdc8a2d0eeeaa873ea76b7ed53b,1,19,8,27,10,2011-09-12 15:04:17,2011-09-11 12:42:31
5604f92880333fdc8a2d0eeeaa873ea76b7ed53b...7e08191a069c361f20b26eb515d112b8f7ad0998,1,6,0,6,1,2011-09-12 15:04:17,2011-09-11 12:51:27
7e08191a069c361f20b26eb515d112b8f7ad0998...4ee8418a0877d1c2f48459bb266342b127fc7d87,1,23,20,43,12,2011-09-21 20:14:09,2011-09-21 20:14:09
89fb9d04071172b12aa6718ec881ee0c0812b768...46a78f79dafdd9d84056fafb26c1592957dc29ca,1,4,4,8,4,2011-07-20 09:36:05,2011-07-20 09:36:05
89fb9d04071172b12aa6718ec881ee0c0812b768...5c6ae0099977e2e950e98b9bf07ce9683b6df059,1,9,2,11,2,2011-07-19 13:09:09,2011-07-17 22:54:40
5c6ae0099977e2e950e98b9bf07ce9683b6df059...26b1b15767a6e7b6401884611437ca25fe5555bb,1,2,0,2,1,2011-07-19 13:09:20,2011-07-17 23:05:23
0b10c9ea6ef5d85d862edd044d96561c4fd16e9b...d5afc0390c3ef919fcde23300d7aefdaeafa5daa,12,304,592,896,105,2011-06-28 17:36:27,2011-06-28 17:15:48
0b10c9ea6ef5d85d862edd044d96561c4fd16e9b...35502d2ec420fe2e58e79b653e44aa4a16300d30,2,65,0,65,2,2011-06-28 14:59:51,2011-06-28 11:55:00
35502d2ec420fe2e58e79b653e44aa4a16300d30...f5e09d608062d46b773a72113656b39053e09a7f,1,42,0,42,2,2011-06-28 14:59:51,2011-06-28 12:11:24
0b10c9ea6ef5d85d862edd044d96561c4fd16e9b...7b608b3b96d468427b2fbf2cad63988ed67be704,1,5,16,21,6,2011-06-27 10:37:46,2011-06-26 15:57:40
0b10c9ea6ef5d85d862edd044d96561c4fd16e9b...9c82357be74bc5404038ec3c16706b1805843556,9,375,0,375,9,2011-06-26 16:18:10,2011-06-17 16:13:14
9c82357be74bc5404038ec3c16706b1805843556...2dc31040a25548c0cc224edc1ec3880dc16a9ca9,2,10,11,21,6,2011-06-26 16:18:10,2011-06-20 16:58:57
2dc31040a25548c0cc224edc1ec3880dc16a9ca9...a030ae502056998c5ac3e19abfcd9591d315febc,3,53,0,53,4,2011-06-26 16:18:10,2011-06-20 18:21:20
a030ae502056998c5ac3e19abfcd9591d315febc...f8f3feb0d3e98542b6f7a4ac214a65e7f9950d5b,1,8,0,8,1,2011-06-26 16:18:11,2011-06-21 00:13:51
f8f3feb0d3e98542b6f7a4ac214a65e7f9950d5b...63f91e1ce856da0a6cfd7ec70f24b087a30ef358,7,616,0,616,10,2011-06-26 16:18:11,2011-06-22 14:52:30
63f91e1ce856da0a6cfd7ec70f24b087a30ef358...73fdf706cc934bd5ceeb6ddd6fe413f8308750b6,1,20,1,21,2,2011-06-26 16:18:11,2011-06-21 08:55:16
73fdf706cc934bd5ceeb6ddd6fe413f8308750b6...fa9dcb7edeccef2e31e6926259bc46d9cefdd706,1,19,0,19,2,2011-06-26 16:18:11,2011-06-22 12:17:29
fa9dcb7edeccef2e31e6926259bc46d9cefdd706...92cb6aa929f60eaea66359c8e3258de821a0a965,2,46,0,46,3,2011-06-26 16:18:11,2011-06-23 13:41:29
92cb6aa929f60eaea66359c8e3258de821a0a965...c5b2622d6810eed5a4b90123ab0e7fc6d4583831,1,20,0,20,2,2011-06-26 16:18:11,2011-06-23 14:32:06
c5b2622d6810eed5a4b90123ab0e7fc6d4583831...8f866daee5a0a43702f349c7fa46d3274542650c,6,297,0,297,7,2011-06-26 16:18:11,2011-05-16 20:07:08
8f866daee5a0a43702f349c7fa46d3274542650c...d6258debbe05e3892466722f897ae932e8e7d8aa,7,179,7,186,19,2011-06-26 16:18:12,2011-06-25 13:10:09
d6258debbe05e3892466722f897ae932e8e7d8aa...f7fc68df832439c3e2355ab747fa05a8b46aa8d0,3,137,0,137,3,2011-06-26 16:18:12,2011-05-27 10:50:07
f7fc68df832439c3e2355ab747fa05a8b46aa8d0...1d27446c603cbad306a8f294fb835ed3db8697b9,1,19,10,29,4,2011-06-26 16:18:12,2011-05-28 08:56:19
1d27446c603cbad306a8f294fb835ed3db8697b9...78fae47878111dd9833345fa622bafb51e5d69b5,1,16,3,19,4,2011-06-26 16:18:12,2011-06-06 12:19:47
78fae47878111dd9833345fa622bafb51e5d69b5...b31803f3106f657a6cc6b8c4fd69e017edad2af8,4,61,7,68,9,2011-06-26 16:18:12,2011-05-28 09:59:10
b31803f3106f657a6cc6b8c4fd69e017edad2af8...8b9e8de5ce2fa4da75bf5b27a73f6d74140c6eaf,3,24,1,25,7,2011-06-26 16:18:12,2011-06-08 08:51:32
8b9e8de5ce2fa4da75bf5b27a73f6d74140c6eaf...6a9597c5b57456dfe02e4b5ba94ef437907fe1f1,3,46,0,46,3,2011-06-26 16:18:12,2011-06-08 17:11:38
6a9597c5b57456dfe02e4b5ba94ef437907fe1f1...ecb6ca0e1f908c1480a602e8cca16bd8916b8a99,4,315,1,316,4,2011-06-26 16:18:13,2011-06-08 11:09:47
ecb6ca0e1f908c1480a602e8cca16bd8916b8a99...be9fe679fc86a8f233b0a6fc6078894edcb8661e,3,13,6,19,3,2011-06-26 16:18:13,2011-06-08 21:38:22
be9fe679fc86a8f233b0a6fc6078894edcb8661e...7632e2494a5b8bfea41e7fbfaa0fc324e2178932,4,89,56,145,32,2011-06-26 18:43:44,2011-06-13 21:01:12
7632e2494a5b8bfea41e7fbfaa0fc324e2178932...1b4f814025ca0c48477fb074929cd15f41f4f68f,3,96,34,130,9,2011-06-26 18:43:44,2011-06-15 22:39:35
1b4f814025ca0c48477fb074929cd15f41f4f68f...4e95ef0268137cf17c43f72863606803b0277bdf,3,28,9,37,7,2011-06-26 18:43:44,2011-06-15 22:59:46
4e95ef0268137cf17c43f72863606803b0277bdf...c4d0fa85b1032690a89989bf15f984b3840b3eee,3,36,18,54,11,2011-06-26 18:43:44,2011-06-15 23:54:19
c4d0fa85b1032690a89989bf15f984b3840b3eee...cbf742ac4e7daccae10fd60d0651242c49663bd3,2,4,4,8,4,2011-06-26 18:43:44,2011-06-26 17:40:02
cbf742ac4e7daccae10fd60d0651242c49663bd3...fd6790210f646a61c750058261d29f6a68485e67,3,56,64,120,4,2011-06-26 18:43:44,2011-06-16 00:17:49
fd6790210f646a61c750058261d29f6a68485e67...7e305056d8c61213d76b33764f05548ecad3eb06,1,30,20,50,12,2011-06-26 18:43:44,2011-06-06 16:44:19
7e305056d8c61213d76b33764f05548ecad3eb06...0a9a38e539b02d254ec37ce6c18bdda2aedaafc8,1,46,12,58,13,2011-06-26 18:43:44,2011-06-06 17:21:05
0a9a38e539b02d254ec37ce6c18bdda2aedaafc8...4e913309b92138cdc6ff31fbce4e8afa2ab5458e,6,75,79,154,38,2011-06-26 18:43:45,2011-06-17 14:38:21
4e913309b92138cdc6ff31fbce4e8afa2ab5458e...ce90a407c7b873780456b182d82d3ba26adbd182,2,2,4,6,3,2011-06-26 18:48:01,2011-06-22 13:34:37
ce90a407c7b873780456b182d82d3ba26adbd182...ea7a5452f40147a510ae8d9e5805d9252e7ddef9,2,59,0,59,2,2011-06-27 00:09:49,2011-06-24 14:25:26
ea7a5452f40147a510ae8d9e5805d9252e7ddef9...c7c787ce0cd944c0e904d47c5ef1088de2fcf85a,4,24,32,56,21,2011-06-27 00:09:49,2011-06-24 16:19:00
c7c787ce0cd944c0e904d47c5ef1088de2fcf85a...9ba49bb5c861651c5136ad6678fc1570801ddec1,3,57,0,57,5,2011-06-27 00:12:40,2011-06-23 01:04:23
9ba49bb5c861651c5136ad6678fc1570801ddec1...5da5321d1753ed897a2597e4ad7ff1928aa7cbbc,1,3,0,3,2,2011-06-27 18:02:05,2011-06-27 18:01:57
5da5321d1753ed897a2597e4ad7ff1928aa7cbbc...0ac2726fdf945792028e59105d8630a91c5d3663,8,14,23,37,14,2011-06-27 18:23:47,2011-06-27 18:23:47
4e1b3b3b7186b017223b8302a51289ff92ccba25...e1ac0101480c29631ad56409d77f2dd7b65bfd09,2,62,1,63,3,2014-11-08 19:53:38,2014-11-08 13:40:53
4e1b3b3b7186b017223b8302a51289ff92ccba25...82374d9825040914a3cfd8ceeaf60f76b93fe638,3,43,0,43,3,2014-11-08 19:00:17,2014-11-08 19:00:17
82374d9825040914a3cfd8ceeaf60f76b93fe638...e235db021267841ac39e2f539339d63d7e757672,1,8,7,15,6,2014-11-08 19:09:11,2014-11-08 19:09:11
e235db021267841ac39e2f539339d63d7e757672...64fdd86d0e820479b414628051cf8e16c643dc8d,2,11,0,11,2,2014-11-08 19:21:14,2014-11-08 19:21:14
64fdd86d0e820479b414628051cf8e16c643dc8d...2c9b9c8bb4ffe083ddea7044cdfd07d6985756d6,1,36,26,62,8,2014-11-08 20:02:19,2014-11-08 19:40:02
4e1b3b3b7186b017223b8302a51289ff92ccba25...209425ce26d777794e9995f757656c7731df087e,19,45,42,87,43,2014-11-08 12:28:27,2014-11-08 12:25:51
4e1b3b3b7186b017223b8302a51289ff92ccba25...68182085694d76b97eb747960195917df69500c8,4,8,5,13,4,2014-11-07 19:34:54,2014-11-07 18:32:50
5692dcf181d26069d68d460fc9179c8c96fa3795...6f73e02605f57db20b8713053d55fef4b534f07b,8,34,17,51,19,2014-12-29 16:18:49,2014-12-24 09:42:50
6f73e02605f57db20b8713053d55fef4b534f07b...3dbd9a0e86f30e1192fd76ce98c9fbce1801a1d9,2,9,4,13,4,2014-12-30 10:33:39,2014-12-24 09:43:38
3dbd9a0e86f30e1192fd76ce98c9fbce1801a1d9...0beb7fe42726671304161a1aecee4924617b7c96,1,1,0,1,1,2014-12-30 10:33:40,2014-12-24 09:44:17
0beb7fe42726671304161a1aecee4924617b7c96...dfda1cf507f91b53e73345c9053f6a61587db984,2,4,0,4,2,2014-12-30 10:33:40,2014-12-27 19:04:28
5692dcf181d26069d68d460fc9179c8c96fa3795...a1daec3c535a0539b3e59e9aecfca20fd9a40e59,1,2,0,2,1,2014-12-29 16:11:33,2014-12-29 16:11:33
5692dcf181d26069d68d460fc9179c8c96fa3795...aad27e6ef650904843dc4bd9308db97899e700e2,1,12,0,12,1,2014-12-27 11:56:00,2014-12-27 11:56:00
e8cd4321233d6ca23a06d6469b1bb939138eafe6...73f0278e5dd9cdb52c46df73daee8c517bba72fe,1,1,0,1,1,2014-12-23 22:40:01,2014-12-23 22:40:01
e8cd4321233d6ca23a06d6469b1bb939138eafe6...fe5f7722f5207634c1ef22c74552702e80572048,1,2,2,4,2,2014-12-23 17:27:01,2014-12-23 17:27:01
0c6012293a78fc44970e555ed3c3544888fc811a...9b2efc15a2d7d406fdf7a9097ddde6d4efa29ce0,1,3,3,6,3,2015-01-05 20:16:48,2015-01-05 20:16:48
9b2efc15a2d7d406fdf7a9097ddde6d4efa29ce0...c8b64f70e056e915fcb3695cbb9dee5843017b60,1,4,1,5,1,2015-01-05 20:20:08,2015-01-05 20:20:08
b91f28be7d36a94e5e4ccef798ab03ed62a8517c...9af3c4169c51b967579042e392937acbc75da79d,1,9,3,12,2,2015-01-10 18:24:27,2015-01-10 18:05:01
c4a2fd5c1deda45afb569706827c2b490f705623...1ef3f0cebb4b5b1f0044dc7306b0eb61a3ec31c2,2,78,14,92,9,2015-01-05 21:24:11,2015-01-05 21:24:11
1ef3f0cebb4b5b1f0044dc7306b0eb61a3ec31c2...66b71ea5f54e3cfe9e41328f5496b6886de7bc39,2,2,2,4,2,2015-01-05 21:33:36,2015-01-05 21:33:36
66b71ea5f54e3cfe9e41328f5496b6886de7bc39...de4a75f97798e4a41d67fb3b4f004452a828f1d2,1,1,1,2,1,2015-01-07 17:26:36,2015-01-07 17:26:36
c4a2fd5c1deda45afb569706827c2b490f705623...5e44d9bcb6d5b20922f49b1913723186f8ced8b5,1,8,0,8,2,2015-01-05 17:35:18,2015-01-05 17:34:17
4d6f55acce14eeec55729e55335635375e9026df...3556a82a2ab3280ef6282de5d7f97248929a517f,1,1,1,2,1,2015-02-12 21:38:55,2015-02-09 22:35:25
4d6f55acce14eeec55729e55335635375e9026df...d8b5c8c329f93ea84aee558451f82b1d960cb920,1,1,1,2,1,2015-01-15 13:16:19,2015-01-15 13:16:19
4d6f55acce14eeec55729e55335635375e9026df...eac773d92bccc7d3fc7ce1b18578d374873e0d7a,4,123,0,123,7,2015-01-14 18:36:50,2015-01-14 14:05:43
dd4345b4247f067e282ccbcde0f0b36d3d571470...1ebe432e2f685c72774aa5012f99fbb4845cffba,1,1,1,2,1,2012-07-12 18:33:30,2012-07-12 18:33:30
1ebe432e2f685c72774aa5012f99fbb4845cffba...eca67c585e555d7999e436fda3f1d8d1ebda2329,1,1,1,2,1,2012-07-12 18:40:09,2012-07-12 18:40:09
eca67c585e555d7999e436fda3f1d8d1ebda2329...b7158c53a45a0e926550484f26eae49ffc3a5043,1,1,1,2,1,2012-07-12 18:48:46,2012-07-12 18:48:46
b7158c53a45a0e926550484f26eae49ffc3a5043...72ee07876295c241892edf4ccde15caf2c657413,2,9,7,16,7,2012-07-12 18:49:15,2012-07-12 18:48:12
72ee07876295c241892edf4ccde15caf2c657413...39b8e047b4e18cb1de45335027e9c79a4c70a75b,2,2,2,4,2,2012-07-12 18:52:10,2012-07-12 18:52:10
39b8e047b4e18cb1de45335027e9c79a4c70a75b...465092ce3fd05a634cea1c0a81687d01390e6f00,1,1,1,2,1,2012-07-12 18:56:50,2012-07-12 18:56:50
465092ce3fd05a634cea1c0a81687d01390e6f00...9f99c5de2e297a9aabc64b028069a4ca870db9d2,1,2,1,3,2,2012-07-12 19:26:21,2012-07-12 19:04:09
973ed4c9f02a036a7eb706a8eab9ba32d0cdf4a5...4ea7c8c6660a33d27190133d0aed8437da432478,1,2,2,4,2,2012-07-03 19:35:33,2012-07-03 19:35:33
b00e9216058e58fd17d27df55cac3b991ad7bd31...13f9eb242d318508c6d98c886e767ecef4a22ff2,1,8,0,8,1,2012-07-10 12:56:54,2012-06-29 17:23:36
b00e9216058e58fd17d27df55cac3b991ad7bd31...a7a2fccd83a8b27f200179bde7a94dbdfbfcd7ab,1,1,1,2,1,2012-07-09 11:12:16,2012-07-09 11:12:16
b00e9216058e58fd17d27df55cac3b991ad7bd31...b6bfd96fdd0cffc37c843cbf0f7c43efdbe96ef9,3,67,10,77,8,2012-07-07 10:15:28,2012-07-03 10:07:33
b6bfd96fdd0cffc37c843cbf0f7c43efdbe96ef9...75261421ec00b6dc0a72931ed7640743a4998c7d,3,44,0,44,3,2012-07-07 10:15:28,2012-07-04 09:58:04
75261421ec00b6dc0a72931ed7640743a4998c7d...33c3370700083b9138b167778814d5af06ccf0b4,2,5,9,14,4,2012-07-07 10:15:29,2012-07-04 10:20:43
33c3370700083b9138b167778814d5af06ccf0b4...5ffd510dd2f39f674d502853cee38c80ad959756,1,0,2,2,1,2012-07-07 10:15:29,2012-07-04 10:23:03
5ffd510dd2f39f674d502853cee38c80ad959756...d0a920a6fd70aaad9a3cee10ba6465f3b04a7bc5,2,11,1,12,2,2012-07-07 10:15:30,2012-07-07 08:36:35
d0a920a6fd70aaad9a3cee10ba6465f3b04a7bc5...34922eeeedaf2067a2fb1326bcbc623fb11a3f6a,1,3,2,5,2,2012-07-07 10:16:07,2012-07-03 12:59:14
34922eeeedaf2067a2fb1326bcbc623fb11a3f6a...1decf88bc12a55261c42db5d3c086500e642a088,1,24,18,42,10,2012-07-07 10:16:08,2012-07-03 13:34:22
1decf88bc12a55261c42db5d3c086500e642a088...cab65c2b23e1a01969c4586ef123ab153652aa6e,2,14,16,30,7,2012-07-07 10:16:08,2012-07-05 20:26:14
cab65c2b23e1a01969c4586ef123ab153652aa6e...98d6a1fdda5fa0605dee933930b5b7ddff4feb37,1,5,0,5,1,2012-07-07 10:16:09,2012-07-04 14:24:09
98d6a1fdda5fa0605dee933930b5b7ddff4feb37...29f72aa63844967cfd56d2edce804af243ef3ddd,1,5,4,9,1,2012-07-07 10:16:09,2012-07-04 20:02:54
29f72aa63844967cfd56d2edce804af243ef3ddd...6a5136e5389034b696c9cd0292a760e78e975fd8,1,2,2,4,2,2012-07-07 10:16:10,2012-07-06 10:47:14
6a5136e5389034b696c9cd0292a760e78e975fd8...35bed94fd5fec699faca6a6d7dc7d03994373bb7,1,57,2,59,5,2012-07-07 10:16:10,2012-07-03 16:01:46
35bed94fd5fec699faca6a6d7dc7d03994373bb7...3cd90893a0b8737e9536d46bb3813c0a8432fdad,1,12,2,14,2,2012-07-07 10:16:11,2012-07-06 15:25:31
3cd90893a0b8737e9536d46bb3813c0a8432fdad...3d78ab64272ab56fc449f50bbd970d64801aa8bd,1,18,8,26,6,2012-07-07 10:16:12,2012-07-06 17:48:57
3d78ab64272ab56fc449f50bbd970d64801aa8bd...805c81594dad1ad5758e78490f1c9d46b42cd41c,1,2,0,2,1,2012-07-07 10:16:12,2012-07-06 18:44:17
805c81594dad1ad5758e78490f1c9d46b42cd41c...e727938112a45a3ef9b8751aaef96d4ff7da74b2,1,98,84,182,26,2012-07-07 10:16:13,2012-07-06 19:25:42
e727938112a45a3ef9b8751aaef96d4ff7da74b2...b8460c2015d0954f3317caf60c1e49fb3cd56ace,2,2,1,3,2,2012-07-07 10:16:14,2012-07-06 21:37:44
b8460c2015d0954f3317caf60c1e49fb3cd56ace...ce9e8e11cafdbb6895e7fae9b714430de151ba5b,1,7,3,10,2,2012-07-07 10:16:14,2012-07-07 05:27:53
ce9e8e11cafdbb6895e7fae9b714430de151ba5b...3e82d6c6f0783a5c74b79d7a849e9ca319f171b5,2,52,24,76,12,2012-07-07 10:16:15,2012-07-07 06:25:39
b00e9216058e58fd17d27df55cac3b991ad7bd31...296f60f56da4854d746984415e7e9887796d4e64,1,2,2,4,2,2012-07-05 22:54:07,2012-07-05 22:54:07
b173cda5bf91b3d344ba967973af960618b7f554...6b9a49cd5fd6addc5b9ce3281ea33a50934f5a94,1,7,4,11,2,2012-07-11 04:50:36,2012-07-11 04:50:36
3f3f6225f8237e974b135de30eaac731c929936e...d2a1861ea1fde6c1f4fe68aa4cc7f3602db92b1f,1,2,2,4,2,2011-09-19 01:27:25,2011-09-19 01:27:25
3f3f6225f8237e974b135de30eaac731c929936e...d9111722552c3536f3663db030bb9be50bc1daff,17,79,81,160,79,2011-09-13 16:30:25,2011-09-13 16:30:25
3f3f6225f8237e974b135de30eaac731c929936e...9940a01c3f922d6026717a998300c747c4dfe784,1,8,3,11,4,2011-09-13 03:38:58,2011-09-13 03:38:58
9940a01c3f922d6026717a998300c747c4dfe784...0251733e01bb5403ee6c9529e6b63e8643054b39,3,59,43,102,35,2011-09-13 03:39:47,2011-09-13 03:39:47
0251733e01bb5403ee6c9529e6b63e8643054b39...784b3b494f057df1e854395f9e640bc25911e542,4,44,58,102,35,2011-09-16 03:15:38,2011-09-13 03:44:39
3f3f6225f8237e974b135de30eaac731c929936e...2aae21888133171e970b8f41bb6594b83c89238e,2,6,0,6,2,2011-09-13 00:05:12,2011-09-13 00:05:12
3f3f6225f8237e974b135de30eaac731c929936e...f9d4b0c39569148c1fe5a4e48c00f26325f2875f,4,58,23,81,25,2011-09-12 15:25:46,2011-09-12 15:25:46
3f3f6225f8237e974b135de30eaac731c929936e...22c30464624f0760d85668df9773fe4882ee20a4,1,2,0,2,2,2011-09-12 09:06:54,2011-09-12 09:06:54
3f3f6225f8237e974b135de30eaac731c929936e...4a619797ec16aeadba53590dce832238cb9a8447,1,83,70,153,14,2011-09-10 00:05:38,2011-08-31 06:10:13
3f3f6225f8237e974b135de30eaac731c929936e...c8f16bfef992452fb4ef7622a2ecd810c1937225,1,2,1,3,1,2011-09-09 14:59:28,2011-09-09 12:05:32
bac47f1ff8c6684671c67000c747a6b0a7f2c6dc...79a343968a4a91c98fae1afa61cdadc5b573c93d,1,2,4,6,1,2011-09-12 20:22:59,2011-09-09 07:32:39
8114ee4c950d035388f1191081fbe77d9a9f3017...87a26ad55e3d7a7b4753a9cf70f1481f2c61b2cd,1,1,1,2,1,2011-09-22 17:23:42,2011-09-22 17:23:42
f08a084bb6a71047a9d690357ef1c99f35d2078d...f630366f70aa9ddffb7c3001c371fae6b0a0c004,1,1,0,1,1,2011-07-22 02:27:21,2011-07-22 02:24:07
2fb520f19ac5defe8ba023681f22ddcceaf0c8ce...9525e47df91c42922b5bbcd1a1408899c5dc89be,1,0,2,2,1,2011-06-28 17:43:36,2011-06-28 17:43:36
ccd59372d46759a92c8197717ca02ba0eb31b7be...e053c911cfe36bca9be272e9cdc4af9ae24c76c9,1,1,1,2,1,2011-06-28 17:52:41,2011-06-28 17:52:41
e053c911cfe36bca9be272e9cdc4af9ae24c76c9...c682886e8e06a2a327b3b637303d7b6820efeb60,3,14,14,28,10,2011-06-28 19:10:44,2011-06-28 19:09:22
c682886e8e06a2a327b3b637303d7b6820efeb60...5cf1f909e4e5dc30396dd33fb5f6398b95927f54,1,10,17,27,11,2011-06-28 19:10:49,2011-06-28 18:27:38
5cf1f909e4e5dc30396dd33fb5f6398b95927f54...ab7941b5d97e5b90bebe6278fcf5351b6a4d5262,5,20,5,25,9,2011-06-28 19:10:51,2011-06-28 19:04:59
ab7941b5d97e5b90bebe6278fcf5351b6a4d5262...0f489fb211a18b197af1fe26b94f774a84fe000c,1,7,3,10,3,2011-06-28 19:30:38,2011-06-28 19:30:15
0f489fb211a18b197af1fe26b94f774a84fe000c...5f25149e4611597c6fa5150413d7f9bd15dc7222,1,0,2,2,1,2011-06-28 20:04:27,2011-06-28 20:04:27
5f25149e4611597c6fa5150413d7f9bd15dc7222...7376ad99275fee606f298e56ac2652c203f8ebe2,3,140,164,304,12,2011-06-29 09:01:35,2011-06-29 09:01:35
7376ad99275fee606f298e56ac2652c203f8ebe2...cfef5fb779ceba60cdd04f323b88373181c0fa8d,3,13,10,23,7,2011-06-29 13:09:21,2011-06-29 13:09:21
f12aa9dc5ed04cfe92f1d536314eb03185f67f7d...8f63d54cb6be013a324338c4177c803701755468,1,1,0,1,1,2011-07-05 12:38:33,2011-07-05 12:36:22
02bc5233041ba0b83fc8db66e02214c99f1e75fe...e284c451b0d7c3ddac383eb35f2c36cb3859eb32,4,25,19,44,10,2014-11-08 22:27:30,2014-10-29 05:18:38
aad27e6ef650904843dc4bd9308db97899e700e2...7cf86f923ac6ce54afdc1784a7a7fe6ea97f59ca,1,11,0,11,1,2014-12-28 09:35:47,2014-12-28 09:35:26
aad27e6ef650904843dc4bd9308db97899e700e2...208a2c8aef59a842d1bec1e6bc83340b1c22c13f,8,26,22,48,20,2014-12-27 12:09:11,2014-12-27 12:09:11
c8b64f70e056e915fcb3695cbb9dee5843017b60...974d21c8990ff210758699baaec606f60fe9afd0,1,37,2,39,2,2015-01-05 21:28:55,2015-01-05 21:10:38
04bdd97f2b63793a8720fd19007911e946ba3c55...16bcf0c79c7e4c2c835b4a1c7924399a03d7e2f9,1,8,0,8,1,2015-01-13 18:29:00,2015-01-13 18:29:00
04bdd97f2b63793a8720fd19007911e946ba3c55...c5c8ece1d642109c63dcd09b782d04679f90622d,1,1,1,2,1,2015-01-13 18:14:38,2015-01-13 18:14:38
1646412d8fc9e1532a194df2515e9a5fde4da988...a8846da7b3c98fddf1cf9af87759d4db9452a147,1,5,5,10,3,2015-01-08 19:45:22,2015-01-08 19:45:22
a8846da7b3c98fddf1cf9af87759d4db9452a147...365d3672382ca514190ef7905d1eadbe44f7381e,1,5,1,6,3,2015-01-08 22:31:15,2015-01-08 21:32:44
d5712ed2b33a18a4f9417d112bda7813c0570caa...147d86fc697d6c88be329c2ce4845a2b135dcf61,1,6,5,11,1,2015-01-20 18:31:24,2015-01-20 18:31:24
d5712ed2b33a18a4f9417d112bda7813c0570caa...7cfbf3b7704da1763ba9f857e1f421b22c5f683a,1,1,1,2,1,2015-01-16 21:21:03,2015-01-15 22:56:58
1ac5acdc695b837a921897a9d42acc75649cfd4f...2fbce0bfaca90dd71a2cc10a7fa82088150e04b7,5,52,0,52,3,2015-02-03 03:46:39,2015-02-03 03:18:38
2fbce0bfaca90dd71a2cc10a7fa82088150e04b7...60561d54468d7097e04466fd8125be5231cea637,3,5,4,9,5,2015-02-03 03:46:43,2015-02-03 03:36:07
60561d54468d7097e04466fd8125be5231cea637...9f779aacdd950fd53a407da615ca60d628e31d35,10,172,59,231,63,2015-02-03 05:31:08,2015-01-29 20:40:55
9f779aacdd950fd53a407da615ca60d628e31d35...d4b1b76701cb0495993b31b1b0e98c0a4b49c0ce,3,65,17,82,10,2015-02-04 14:15:12,2015-02-03 05:03:49
d4b1b76701cb0495993b31b1b0e98c0a4b49c0ce...f58cc280c9ddeff6fd85f56e70073c3ed4fb0650,3,9,3,12,6,2015-02-04 14:15:13,2015-02-03 05:28:32
f58cc280c9ddeff6fd85f56e70073c3ed4fb0650...500ec5431564d9167985a02909823e1286136d5b,3,76,49,125,27,2015-02-04 14:15:13,2015-02-03 06:46:01
500ec5431564d9167985a02909823e1286136d5b...fa89ff20cd777fafc3e971bbf8081d97ce082c15,2,6,3,9,4,2015-02-04 14:15:13,2015-02-03 05:35:24
1ac5acdc695b837a921897a9d42acc75649cfd4f...9dcc4a36f709f013ed111924754021fddfc933e6,3,41,5,46,8,2015-01-30 16:09:31,2015-01-28 15:04:50
9dcc4a36f709f013ed111924754021fddfc933e6...5f28ec84a10b283f79f027f83ba03d7774a987f7,3,16,40,56,9,2015-02-03 17:23:04,2015-02-03 17:16:11
5f28ec84a10b283f79f027f83ba03d7774a987f7...07c989e98d013132168326eb7fd6fdf91a2399b9,4,30,9,39,6,2015-02-04 01:01:24,2015-02-04 01:01:24
1ac5acdc695b837a921897a9d42acc75649cfd4f...9a294fd8c5c8e2e7d384e852bc33988962e5156b,1,2,2,4,1,2015-01-27 16:17:23,2015-01-27 16:17:23
9f99c5de2e297a9aabc64b028069a4ca870db9d2...151d81a647600601a867a1415336b74d4888d7d8,1,3,0,3,1,2012-07-12 20:53:41,2012-07-12 20:03:28
9f99c5de2e297a9aabc64b028069a4ca870db9d2...1c3edb307842dede8d20cecc734359b68c67fd65,1,3,0,3,1,2012-07-12 20:29:53,2012-07-12 07:46:45
1c3edb307842dede8d20cecc734359b68c67fd65...dc1f4b32d30ce715a58acdd249f15d08ce844233,2,7,7,14,2,2012-07-12 20:29:55,2012-07-12 08:52:19
dc1f4b32d30ce715a58acdd249f15d08ce844233...bb89cf9478bd6c1c5df1fbda2d82cc86a3ba5aed,2,36,73,109,10,2012-07-12 20:29:58,2012-07-12 08:57:31
bb89cf9478bd6c1c5df1fbda2d82cc86a3ba5aed...d1b7921a48161cf6fe5bb85a5da4c0bdac3c0df7,2,56,7,63,3,2012-07-12 20:30:00,2012-07-12 09:46:20
d1b7921a48161cf6fe5bb85a5da4c0bdac3c0df7...5a6f31f28b58d93232b742f02ad0a6f64c0dfbb8,1,2,2,4,2,2012-07-12 20:30:02,2012-07-12 11:20:29
5a6f31f28b58d93232b742f02ad0a6f64c0dfbb8...b5f90115240e333a60809ef912934bce8afae0c1,1,1,1,2,1,2012-07-12 20:33:48,2012-07-12 20:31:53
a13a30ac302ede33d8bc4b6b0c283a57f6e8cc2e...111ee3fe2d4c6de6729b94235c709986b4079c4b,1,2,0,2,1,2012-07-11 12:37:26,2012-07-11 12:37:26
6b9a49cd5fd6addc5b9ce3281ea33a50934f5a94...039fc4067989a14a09784ed16ce7126ac75461cb,3,100,0,100,4,2012-07-11 06:19:47,2012-07-10 22:10:14
039fc4067989a14a09784ed16ce7126ac75461cb...b0fe11292219f5d63f2159e0b0eb24ff21d66b10,3,140,3,143,7,2012-07-11 06:19:47,2012-07-10 22:13:30
b0fe11292219f5d63f2159e0b0eb24ff21d66b10...c3a875c975cde11ffd18947c419b1cd38205e6c3,1,1,1,2,1,2012-07-11 06:19:47,2012-07-10 22:20:08
c3a875c975cde11ffd18947c419b1cd38205e6c3...b3ff1dab317dc9194c4bc124afd95ae9be2ad57b,5,154,13,167,15,2012-07-11 06:19:47,2012-07-10 22:22:39
b3ff1dab317dc9194c4bc124afd95ae9be2ad57b...991a56c704f931e7eb52a0583e5d8684803f3b04,4,116,16,132,17,2012-07-11 06:19:47,2012-07-10 22:35:38
991a56c704f931e7eb52a0583e5d8684803f3b04...54e29b9380f1cd0fa596d71c317de907da19b13d,1,2,0,2,1,2012-07-11 06:51:32,2012-07-11 06:51:32
edb644dd98d8af457a141e539079ac2269c29e3a...f1558d9bcac169681491afff4518cdbbc6e86fb3,11,1420,4,1424,15,2011-09-14 23:12:46,2011-09-14 23:12:46
f1558d9bcac169681491afff4518cdbbc6e86fb3...a9daa9bc166b1d6f7c8af78d406761c942ab47e4,1,1,0,1,1,2011-09-14 23:13:50,2011-09-02 08:07:42
a9daa9bc166b1d6f7c8af78d406761c942ab47e4...3601c4bfce3df04ebfc8668e5db531ded39280a9,2,27,5,32,5,2011-09-14 23:13:50,2011-08-08 11:40:17
3601c4bfce3df04ebfc8668e5db531ded39280a9...56453d346864e312ec138626a3fc920c39890f0d,5,188,85,273,33,2011-09-14 23:14:36,2011-09-02 11:44:42
56453d346864e312ec138626a3fc920c39890f0d...d8b903dab0ab1a9fa6d8515825fa5dd19de68fca,2,707,222,929,51,2011-09-14 23:14:36,2011-09-11 16:46:08
d8b903dab0ab1a9fa6d8515825fa5dd19de68fca...11385c3c4b91274fd8bbf3547b700ba8defabc08,8,513,91,604,40,2011-09-16 03:13:44,2011-09-16 03:12:56
11385c3c4b91274fd8bbf3547b700ba8defabc08...bcba84600b5e686842d8b8f4f76d263f53cfac79,1,36,1,37,4,2011-09-16 03:44:21,2011-09-16 03:44:21
bcba84600b5e686842d8b8f4f76d263f53cfac79...a5f8c1bd9ec217628e524c3d4ed5fba64f279e90,2,6,6,12,5,2011-09-16 03:46:18,2011-09-16 03:46:18
a5f8c1bd9ec217628e524c3d4ed5fba64f279e90...fe4aa2066d964c789f9b6f91f95d867b9fc2dbcc,1,4,4,8,3,2011-09-16 03:47:18,2011-09-16 03:47:18
fe4aa2066d964c789f9b6f91f95d867b9fc2dbcc...48e97ed1f02d867ecd7f68a1657103b32c5af721,1,5,5,10,4,2011-09-16 03:48:50,2011-09-16 03:39:52
48e97ed1f02d867ecd7f68a1657103b32c5af721...df297a1f6548ef27c8e0f75376262725fd72f2ce,3,23,12,35,17,2011-09-16 17:42:44,2011-09-16 17:42:44
df297a1f6548ef27c8e0f75376262725fd72f2ce...934fa904e949a9e33dcb017fb73c0e3db22c3f3d,1,3,3,6,2,2011-09-16 17:49:18,2011-09-16 17:48:57
01ab592b82c4051df2be6066d7dfa59696cd453d...dd44887ac69f334ecf07e0a7be97c18e764539e8,4,14,2,16,4,2011-09-22 22:00:05,2011-09-22 22:00:05
01ab592b82c4051df2be6066d7dfa59696cd453d...76c15b7191daef64e862d54749bf205a746b18c1,1,1,4,5,3,2011-09-22 19:26:23,2011-09-22 19:26:23
f630366f70aa9ddffb7c3001c371fae6b0a0c004...ac2351fdec13a3f1631e84e95a02e950213bf904,1,3,2,5,2,2011-07-25 18:24:10,2011-07-25 18:23:23
f630366f70aa9ddffb7c3001c371fae6b0a0c004...cf7dc39b826a78aab970444c3caf3abd9cef4e07,1,1,1,2,1,2011-07-24 13:58:10,2011-07-24 13:58:10
f630366f70aa9ddffb7c3001c371fae6b0a0c004...c3da9f062d8c202b2a66b289b3570ac9fe6fc02d,2,36,8,44,8,2011-07-23 12:30:40,2011-07-21 20:55:20
c3da9f062d8c202b2a66b289b3570ac9fe6fc02d...c498232812a34925fe280bd16938ba7ecf2cd6cc,1,45,53,98,21,2011-07-23 12:30:40,2011-07-23 10:09:51
c498232812a34925fe280bd16938ba7ecf2cd6cc...7db40d450de401100922b023ec5e687bc1a6d4d5,1,11,16,27,5,2011-07-23 12:30:40,2011-07-23 11:57:06
cfef5fb779ceba60cdd04f323b88373181c0fa8d...6ac91dfe52e857814fc197614dea0dbf672bdc0f,4,27,0,27,4,2011-06-29 17:22:24,2011-06-29 12:06:18
d830919a2cdd59ad9f9d0e9b44b7a6a0e331799c...2ee318a7bc5f7e975e31ca03d0e275fa3619633e,1,6,1,7,3,2011-07-05 13:28:35,2011-07-05 13:09:17
4865cc3f0631a8a4e0e1de897865df0e552c70cb...692c040843dee45287d87ed81d4a1bd3684f5c97,2,4,1,5,3,2014-11-09 23:18:48,2014-11-08 23:09:25
4865cc3f0631a8a4e0e1de897865df0e552c70cb...3149547b5ae526f28412574d64d874a4dfd2ed9c,3,90,1,91,5,2014-11-08 23:01:58,2014-10-10 10:39:53
3149547b5ae526f28412574d64d874a4dfd2ed9c...6eb9e39ce03e4db1fb39ff9fa8ed771463fca1bd,3,80,59,139,36,2014-11-08 23:01:58,2014-10-10 11:35:57
6eb9e39ce03e4db1fb39ff9fa8ed771463fca1bd...64e3e6d43acbbf6cc8f8a4c612547c5a575c4031,3,53,8,61,6,2014-11-08 23:01:58,2014-10-11 10:25:50
4865cc3f0631a8a4e0e1de897865df0e552c70cb...799e22ea0c3f20f1900011573a10053dc3ea9138,22,88,67,155,46,2014-11-08 22:46:39,2014-10-23 15:34:41
007f3ff6fa68a95feee4e70f825a49ea0ec9cb2d...61cd037e0b309f6b25a081752de0930d2c5c90bf,1,4,0,4,1,2015-01-06 23:18:57,2015-01-06 23:18:57
007f3ff6fa68a95feee4e70f825a49ea0ec9cb2d...388ca7e73c701911ec954cea2ed35997016094f0,1,19,0,19,1,2015-01-06 23:10:50,2015-01-06 21:16:25
007f3ff6fa68a95feee4e70f825a49ea0ec9cb2d...5018e2c639aa956dd61a390699a579f8de6a4841,1,4,1,5,2,2015-01-06 23:08:38,2015-01-06 23:08:38
0b2ee7c07c7b494b432ad5b2a870f6378e191f25...527ed59ad809826e43fa43024b0af262f08499db,1,11,3,14,4,2015-02-13 14:18:49,2015-02-13 14:18:49
2136240dbd35cf2b4308f92008a24c0c36665811...0161e096a30912e0721cf3e6446595d3400d55b7,3,8,2,10,3,2015-01-20 22:17:37,2014-11-13 18:30:47
0161e096a30912e0721cf3e6446595d3400d55b7...b4c6a9da9391ed9525010438ced9d125b84c6a3f,9,31,1,32,3,2015-01-20 22:17:48,2014-10-26 04:45:23
2136240dbd35cf2b4308f92008a24c0c36665811...526182d28c42bba3ae6b16940438d800f99285d5,1,1,1,2,1,2015-01-20 21:24:32,2015-01-20 21:24:32
526182d28c42bba3ae6b16940438d800f99285d5...9ae4ad2dafd918b95dc976bed97604a985a2b4dd,1,1,1,2,1,2015-01-20 21:26:55,2015-01-20 21:26:55
d24a5312d8ab6d3cdb259e450ec9f1e2e6f3399d...392702ee2c88d7d8aaff25f7a84acb73606f9094,48,528,117,645,167,2015-02-13 03:54:46,2015-02-10 04:41:13
392702ee2c88d7d8aaff25f7a84acb73606f9094...15d54fdd345dadc2854200ce5b9aad0949e3949b,1,9,9,18,7,2015-02-13 03:54:46,2015-02-11 03:34:03
15d54fdd345dadc2854200ce5b9aad0949e3949b...3603cb0978b7ef21ff9cd63693ebd6d27bc2bc53,7,32,23,55,11,2015-02-13 03:54:47,2015-02-11 04:13:49
3603cb0978b7ef21ff9cd63693ebd6d27bc2bc53...4aa664ae3953d99c2ae4cd769f02818bc122eebc,7,62,15,77,10,2015-02-13 03:54:47,2015-02-11 04:55:07
4aa664ae3953d99c2ae4cd769f02818bc122eebc...2884cc42de8b20a58cec8488d014a853d47c047e,12,36,43,79,26,2015-02-13 03:54:47,2015-02-11 14:39:38
2884cc42de8b20a58cec8488d014a853d47c047e...ec3b4d35f636c26d3c9b5703c3b7f87683800af8,4,30,14,44,12,2015-02-13 03:54:47,2015-02-11 16:20:05
ec3b4d35f636c26d3c9b5703c3b7f87683800af8...8d534b475829edf87c8126fc4ae30f593172f317,3,23,1,24,4,2015-02-13 03:54:47,2015-02-11 18:01:00
8d534b475829edf87c8126fc4ae30f593172f317...190b76a69875da49973d1a5d8fd3b96c0cd43425,4,83,32,115,7,2015-02-13 03:54:47,2015-02-11 19:52:08
190b76a69875da49973d1a5d8fd3b96c0cd43425...1ad48c8a08c4bb3b10c0344d838494de9cee087e,1,33,24,57,21,2015-02-13 03:54:47,2015-02-11 22:36:57
1ad48c8a08c4bb3b10c0344d838494de9cee087e...650e45f69124bd8b53ecefddeb214a82538ab2c1,4,11,5,16,8,2015-02-13 03:54:48,2015-02-11 22:51:17
650e45f69124bd8b53ecefddeb214a82538ab2c1...f1453c59b2afb9dab43281bfe9f1ba34cf6e0d02,36,352,347,699,184,2015-02-13 14:27:33,2015-02-12 17:19:37
f1453c59b2afb9dab43281bfe9f1ba34cf6e0d02...8aab36a3010372edec71e8c765d4ecfd848c09b6,1,2,2,4,2,2015-02-13 14:28:05,2015-02-12 22:14:53
8aab36a3010372edec71e8c765d4ecfd848c09b6...16942c6fdaddb819b71b72e53aa4aa691e3c0053,2,20,0,20,3,2015-02-13 14:28:09,2015-02-12 22:36:48
16942c6fdaddb819b71b72e53aa4aa691e3c0053...d97d9559e321ac2ef2ae81a6cfd308a841ef7581,1,2,0,2,1,2015-02-13 14:28:12,2015-02-13 04:56:09
d97d9559e321ac2ef2ae81a6cfd308a841ef7581...0f07d54b44825399e5d13499328135771c8d0b43,1,5,4,9,2,2015-02-13 14:35:20,2015-02-13 14:35:20
d24a5312d8ab6d3cdb259e450ec9f1e2e6f3399d...02eb1495a5248c8f676e15fd12e1be28d4f22480,1,3,1,4,2,2015-02-12 20:32:52,2015-02-12 20:32:52
9bf5bd7cd89502826cc0223ec43aba15ad30fac7...83276dccbef0cc1d70ec45c086e38a3e232e2b32,1,5,0,5,2,2015-02-05 18:24:38,2015-02-05 18:24:38
9bf5bd7cd89502826cc0223ec43aba15ad30fac7...865baaf928bd29274c753d85db59a324d4bd8b82,1,26,0,26,1,2015-02-05 16:59:03,2015-02-05 16:06:01
865baaf928bd29274c753d85db59a324d4bd8b82...2f4ee00039ebe63e2d954ede118593c279486893,1,2,0,2,1,2015-02-05 17:09:36,2015-02-05 16:55:00
2f4ee00039ebe63e2d954ede118593c279486893...3c68bfcd088dd5a1ef06b98ea7fd203bb048fa42,2,19,6,25,2,2015-02-05 17:27:16,2015-02-04 23:24:31
3c68bfcd088dd5a1ef06b98ea7fd203bb048fa42...9cb5b0f73c610692cc62f6d98f527bf1ab326924,1,18,11,29,5,2015-02-05 17:27:19,2015-02-05 04:45:22
0848ec24faf3b6e182d01f61d62540c6f6480c39...7b8c9e123d3925f4d7aaa614a591e4188a80d464,1,1,1,2,1,2012-07-13 18:46:16,2012-07-13 18:46:16
7b8c9e123d3925f4d7aaa614a591e4188a80d464...d1af70b0509916abcb4724e0d8cdbee8ebf6bb2d,1,24,22,46,13,2012-07-14 20:29:11,2012-07-13 18:43:56
0848ec24faf3b6e182d01f61d62540c6f6480c39...b3237ac31313240272ee0d48a19b4edfdfc1d718,1,9,4,13,4,2012-07-13 15:14:08,2012-07-13 15:13:35
111ee3fe2d4c6de6729b94235c709986b4079c4b...8f17ed801f211e8481b2e0903da547c9e329b010,1,12,14,26,3,2012-07-11 23:06:10,2012-07-10 18:52:56
8f17ed801f211e8481b2e0903da547c9e329b010...2b92a154b66f213b664e44544048a2df7708b9de,1,9,10,19,5,2012-07-11 23:06:11,2012-07-11 09:20:20
2b92a154b66f213b664e44544048a2df7708b9de...b1aca6eae084ebe59c5a092314e94019c59ecec6,3,110,0,110,3,2012-07-11 23:06:11,2012-07-11 14:14:12
b1aca6eae084ebe59c5a092314e94019c59ecec6...2d012c0c72e1c7ae6e418340a7bb4ab9dc0288bd,1,2,21,23,3,2012-07-11 23:06:12,2012-07-11 14:52:02
2d012c0c72e1c7ae6e418340a7bb4ab9dc0288bd...874303d468f7c8ef265bcdca8cde3cab547b5610,1,2,2,4,2,2012-07-11 23:06:12,2012-07-11 21:47:58
874303d468f7c8ef265bcdca8cde3cab547b5610...84f18e358742b77bfc815f2a360a41f3f1b9abd7,3,144,0,144,4,2012-07-11 23:06:13,2012-07-11 22:44:07
84f18e358742b77bfc815f2a360a41f3f1b9abd7...12595ab8f91a71e5a596a883b31789d5317e9ec2,1,6,26,32,1,2012-07-11 23:06:13,2012-07-11 22:52:01
111ee3fe2d4c6de6729b94235c709986b4079c4b...5b071115294e2c7d4b36ac21842ef09c7edd02b6,7,9,8,17,8,2012-07-11 18:40:12,2012-07-04 12:00:19
5b071115294e2c7d4b36ac21842ef09c7edd02b6...118cf57d426ede29b6695204e707810bbe3888ef,2,68,7,75,6,2012-07-11 18:40:12,2012-07-04 14:06:07
118cf57d426ede29b6695204e707810bbe3888ef...8aedf1d5581f518da286ca4a33d6f7a98db38651,3,53,22,75,12,2012-07-11 18:40:13,2012-07-05 15:02:03
4d3c409c19aa0ee7f2482ce222d62a8f7867bdff...2014021b201e3af4c5bf132fbf1bce5fb6148e21,1,4,2,6,2,2011-09-19 02:41:25,2011-09-19 02:41:00
934fa904e949a9e33dcb017fb73c0e3db22c3f3d...bb742ede3d54564ff900fb7246e7b1ff01482b2c,128,598,1487,2085,205,2011-09-18 22:54:32,2011-09-18 22:54:32
bb742ede3d54564ff900fb7246e7b1ff01482b2c...87d9869fc30951cec632e0d6a3d1dd47756d2886,63,806,806,1612,276,2011-09-19 00:34:49,2011-09-19 00:34:49
934fa904e949a9e33dcb017fb73c0e3db22c3f3d...8320001db7b2981ba8a4c09a9c7f3da574953602,1,1,1,2,1,2011-09-17 14:07:28,2011-09-17 14:07:28
8320001db7b2981ba8a4c09a9c7f3da574953602...afdf8dcb97a744de2daa0bc8f4dad86d8633835f,1,4,4,8,4,2011-09-17 14:28:18,2011-09-17 14:28:18
934fa904e949a9e33dcb017fb73c0e3db22c3f3d...ef37489041ff7bbab5a10bf54fe9b01ddacef75e,1,2,2,4,2,2011-09-17 10:14:13,2011-09-16 11:55:29
ef37489041ff7bbab5a10bf54fe9b01ddacef75e...855f06606dce01cdeab8f74a99e55a7d13ba784e,1,2,1,3,1,2011-09-17 15:28:39,2011-09-17 15:28:39
71a4c1f16ffc71bced673c5883d5ea621cc8d24f...222d057c2228b7b19d198c3e36d036f3186b5b90,3,10,0,10,3,2011-09-19 17:34:52,2011-09-19 17:34:52
222d057c2228b7b19d198c3e36d036f3186b5b90...c498701df7700695e287ea0e2f08062f9147b3a6,2,14,12,26,14,2011-09-19 17:38:44,2011-09-19 17:38:44
71a4c1f16ffc71bced673c5883d5ea621cc8d24f...7aece9cfa26f9c4d865b0e9b4aea5984e5f1f39f,1,64,0,64,1,2011-09-19 03:14:54,2011-09-19 03:14:54
7aece9cfa26f9c4d865b0e9b4aea5984e5f1f39f...3a2626f32a085231b93f3bed00dc3640c78604b5,2,86,24,110,8,2011-09-19 03:17:28,2011-09-12 23:13:41
3a2626f32a085231b93f3bed00dc3640c78604b5...19d869bb2e09fe217cbf12496f9f59d5c306c175,1,1,1,2,1,2011-09-19 03:31:54,2011-09-19 03:31:54
19d869bb2e09fe217cbf12496f9f59d5c306c175...468d0d1e1ea9063aada62e5fc810837f43083947,1,1,1,2,1,2011-09-19 03:32:56,2011-09-19 03:32:56
ea4dad8ec4388a155836b6427afd018f8432af9d...01d7fded1b233b6a8fcfeec4eaf00b7dc9cc7316,6,10,48,58,15,2011-09-27 12:33:18,2011-09-22 17:44:30
01d7fded1b233b6a8fcfeec4eaf00b7dc9cc7316...b41713206b83bdf88522ae789b56630bb6e0a4bc,4,176,153,329,11,2011-09-27 12:33:18,2011-07-26 09:34:54
b41713206b83bdf88522ae789b56630bb6e0a4bc...b183ffe77ee0f81d51019ed46cd10fa0a9a353ac,2,13,16,29,6,2011-09-27 12:33:18,2011-07-26 10:26:12
b183ffe77ee0f81d51019ed46cd10fa0a9a353ac...acd31b4ad6b3bb3e3048fe3b4d7005b9a4a770e5,1,10,17,27,3,2011-09-27 12:33:18,2011-07-26 10:44:06
acd31b4ad6b3bb3e3048fe3b4d7005b9a4a770e5...69bffab9693983378409d2bdd3266ba8540b3236,2,48,1,49,3,2011-09-27 12:33:18,2011-07-26 12:58:32
69bffab9693983378409d2bdd3266ba8540b3236...e23ede0de599feaabf52cbac89f04b5293a9c4bc,1,4,0,4,2,2011-09-27 12:33:18,2011-07-26 13:22:15
e23ede0de599feaabf52cbac89f04b5293a9c4bc...b419fe2d8cd536e596a4e0ea2eac221fbc2f59a1,1,6,0,6,2,2011-09-27 12:33:18,2011-08-02 12:38:49
b419fe2d8cd536e596a4e0ea2eac221fbc2f59a1...3ba69ba8a469deee81ab718ecc04551c17b9615d,2,25,1,26,3,2011-09-27 12:33:18,2011-08-02 13:27:42
3ba69ba8a469deee81ab718ecc04551c17b9615d...8255c69b102d3a1766fc081590618440ae5a58f8,1,30,0,30,3,2011-09-27 12:33:18,2011-09-24 15:06:52
8255c69b102d3a1766fc081590618440ae5a58f8...9ef9e8c3ad014278fdec7ff6b0b6038584db8c20,1,25,19,44,7,2011-09-27 12:33:18,2011-09-27 12:30:14
9ef9e8c3ad014278fdec7ff6b0b6038584db8c20...8e9bfa4cf0584527cdbee0dba05cf5aabc60a4bc,1,4,2,6,3,2011-09-27 12:33:19,2011-09-27 12:31:57
76c15b7191daef64e862d54749bf205a746b18c1...ddeaa7fb68b1dcb9aab958d8cddc2855a2c187da,1,3,3,6,3,2011-09-24 11:41:10,2011-09-24 11:41:10
269beb47107c761de4a128edc9660cc64f2b7ffc...14468c6be59567bf9d90ff21bd62893409ec82df,1,2,2,4,1,2011-07-25 19:12:46,2011-07-15 11:59:37
14468c6be59567bf9d90ff21bd62893409ec82df...b42a7f01a5114bd0e92d1e3c7c37ffbd4f8702ff,1,2,2,4,2,2011-07-25 19:12:46,2011-07-15 12:07:59
b42a7f01a5114bd0e92d1e3c7c37ffbd4f8702ff...ba1de1af932e59c8cb4cdafd9a057b1e07471730,1,2,2,4,1,2011-07-25 19:12:46,2011-07-15 12:29:13
ba1de1af932e59c8cb4cdafd9a057b1e07471730...803ca5cb92035f6d06c55b41e2863ae629aa877c,1,1,2,3,2,2011-07-25 19:12:46,2011-07-15 12:31:17
803ca5cb92035f6d06c55b41e2863ae629aa877c...4414b355fc8b66994fb6caefe73113849ebf3ecb,1,5,5,10,2,2011-07-25 19:12:46,2011-07-15 12:37:15
4414b355fc8b66994fb6caefe73113849ebf3ecb...03cdbab4105d145174176148dd0a0b6a20b02cde,1,6,6,12,4,2011-07-25 19:12:46,2011-07-15 13:44:25
03cdbab4105d145174176148dd0a0b6a20b02cde...2ba222c5c5c406dd49492e0b5ac69d75ec997e35,2,3,3,6,3,2011-07-25 19:12:46,2011-07-15 14:31:24
2ba222c5c5c406dd49492e0b5ac69d75ec997e35...0cbbdc26a975ef73bba1f7161bd9c7313d5cab24,1,9,4,13,4,2011-07-25 19:12:47,2011-07-15 14:56:48
0cbbdc26a975ef73bba1f7161bd9c7313d5cab24...b75bec94f816a97a3e610bed9f813112e9f316a9,1,2,2,4,2,2011-07-25 19:12:47,2011-07-15 15:24:35
b75bec94f816a97a3e610bed9f813112e9f316a9...84ef7f3636ce163f8e5954a0541f76b8852b1a22,5,36,35,71,16,2011-07-25 19:12:47,2011-07-15 15:34:20
84ef7f3636ce163f8e5954a0541f76b8852b1a22...7d9cc9f81a2eaa0f24b82a618410cd8187ec1c05,2,8,8,16,8,2011-07-25 19:12:47,2011-07-15 14:46:55
7d9cc9f81a2eaa0f24b82a618410cd8187ec1c05...51917d9ca252744764acfaafb303be2f6cdefb85,1,20,9,29,2,2011-07-25 19:12:47,2011-07-18 00:53:24
51917d9ca252744764acfaafb303be2f6cdefb85...b2dd681512b66007e026c0c405b2524d8fa6712c,1,10,4,14,3,2011-07-25 19:12:47,2011-07-18 01:01:27
b2dd681512b66007e026c0c405b2524d8fa6712c...f939d39becfd62cb8fb58fb6d22f9677137af791,1,42,22,64,16,2011-07-25 19:12:47,2011-07-18 01:16:42
f939d39becfd62cb8fb58fb6d22f9677137af791...76159921f45eeb1b9752e33da9a28aec9a220817,1,68,56,124,9,2011-07-25 19:12:47,2011-07-18 01:27:56
76159921f45eeb1b9752e33da9a28aec9a220817...05a62d1a8264e724e8353684de60b46eb6853cbb,2,8,20,28,6,2011-07-25 19:12:48,2011-07-18 02:11:18
cb1c75635e9e6c30e147be80b71e72382a1097f7...c7b508e63bbcb2a378b68a140180f9074a4ace6b,1,0,1,1,1,2011-07-29 17:29:47,2011-07-29 17:29:47
c7b508e63bbcb2a378b68a140180f9074a4ace6b...ede21113a23741e7e8a47843dafccfd9b52bbe41,1,0,9,9,1,2011-07-29 17:31:39,2011-07-29 17:31:39
2dfc08875abfab747338c659f85bdf98d718cd1c...408d733b1fd6ae7e674076e154dc19a2ca672e16,1,2,2,4,2,2011-06-30 13:56:58,2011-06-30 13:56:58
2dfc08875abfab747338c659f85bdf98d718cd1c...fe5babacd6a2a8f358603404ee27327c20830c03,2,15,0,15,3,2011-06-30 13:19:19,2011-06-29 21:16:23
2f3f28b4628db5699c2b847a81bbef8445719a00...178376025cc70cc8da3ca58699717f2cc8e495a7,1,2,2,4,4,2011-07-05 13:38:26,2011-07-05 13:38:26
6a6c24e01638df91d9104e07d6ff5deaa7cb1574...c868981f0eb1af20d62c1287dad3f8c94addf999,3,30,3,33,5,2015-01-07 15:04:49,2015-01-06 21:49:39
788c5f1ca853c739d006de4408e3acb2f5858baa...fe8399fe9bf1ba705ddf337bb2f01fb9f87b90dd,1,1,1,2,1,2015-01-09 15:29:08,2015-01-09 15:29:08
57f45e7f4dd7202607f51292a816a262622e964c...09866d6f84a644c4dff258055c570d619fe7bad7,2,20,2,22,2,2015-02-18 16:26:03,2015-02-18 16:26:03
57f45e7f4dd7202607f51292a816a262622e964c...2d2aa1ff6e52567d4710af22fdfa11ae54a08420,1,2,1,3,2,2015-02-17 17:03:25,2015-02-13 22:28:35
57f45e7f4dd7202607f51292a816a262622e964c...8588cb0cbfadcd66061062bd0ab170a1419e006f,1,9,2,11,4,2015-02-15 06:43:26,2015-02-15 06:43:26
57f45e7f4dd7202607f51292a816a262622e964c...42f98a26a5da450b3ef8600b85711112dd9860f4,1,5,6,11,3,2015-02-13 16:44:34,2015-01-18 05:31:24
42f98a26a5da450b3ef8600b85711112dd9860f4...55798fd1536f055fc23a760c41d679fc60cd2ead,3,100,29,129,7,2015-02-14 14:25:35,2015-01-18 02:49:04
55798fd1536f055fc23a760c41d679fc60cd2ead...8639ea5f98ac53e532820e8a186f8a1d6d98f573,3,91,2,93,5,2015-02-14 14:25:35,2015-01-18 04:47:03
8639ea5f98ac53e532820e8a186f8a1d6d98f573...8b0ddd5dd90e1d62f32faf14d5cb4bf88f04a095,2,68,2,70,5,2015-02-14 14:25:35,2015-01-18 05:28:53
8b0ddd5dd90e1d62f32faf14d5cb4bf88f04a095...be8404a7680fa1951e20abdaea704156b3345876,3,67,11,78,17,2015-02-14 14:25:35,2015-02-04 02:51:48
be8404a7680fa1951e20abdaea704156b3345876...41fae48df21c7d1140da539cb61fa3fd0598a3e7,6,79,92,171,29,2015-02-14 14:25:36,2015-02-04 03:31:10
57f45e7f4dd7202607f51292a816a262622e964c...92e87dd74974ccad8e0dbd8dd212bfc514ba441d,2,29,9,38,8,2015-02-13 15:44:19,2015-02-13 15:44:19
92e87dd74974ccad8e0dbd8dd212bfc514ba441d...49b8293c75d287f609eebae334519872784cd893,3,67,3,70,6,2015-02-13 16:20:32,2015-02-13 16:20:32
49b8293c75d287f609eebae334519872784cd893...ffbd51edc887021b96452394ed9737112258d8e5,1,12,8,20,7,2015-02-13 16:38:00,2015-02-13 16:38:00
93b4a50de1b124bf1808dbe55b9b5352274622e1...1d50b3649d578f12918b7996ad7b98a438bc0616,5,174,50,224,45,2015-01-20 23:12:23,2015-01-12 22:16:27
1d50b3649d578f12918b7996ad7b98a438bc0616...1fbfcdfcd0f3b87e95cea15b3c90808ccd5f9a79,4,81,15,96,14,2015-01-20 23:12:35,2015-01-12 21:48:53
1fbfcdfcd0f3b87e95cea15b3c90808ccd5f9a79...fe598f0903012e361eca53c4cb65c27e4e8dfac9,2,26,11,37,7,2015-01-20 23:12:46,2015-01-13 17:18:02
fe598f0903012e361eca53c4cb65c27e4e8dfac9...b4cbd67f5fdefb4595ce96c2e2bd1ab6e0b4f41d,1,19,3,22,2,2015-01-20 23:12:58,2015-01-13 19:02:58
b4cbd67f5fdefb4595ce96c2e2bd1ab6e0b4f41d...232bc89598947823e57431df63a5d6d41ad218c3,18,50,3,53,9,2015-01-20 23:13:09,2015-01-14 18:15:34
232bc89598947823e57431df63a5d6d41ad218c3...c2dee0fcb0d247ecb3a48709ae1c57d1b935d2ae,1,1,1,2,1,2015-01-20 23:13:20,2015-01-14 18:20:21
c2dee0fcb0d247ecb3a48709ae1c57d1b935d2ae...e74340b0001247681bf0fe43f73622e87b52ccae,6,207,27,234,19,2015-01-20 23:13:31,2015-01-14 23:47:00
e74340b0001247681bf0fe43f73622e87b52ccae...53eb139dcb6a154ed007c7121c9ab58a7a88f44f,1,64,1,65,3,2015-01-20 23:13:41,2015-01-15 02:16:01
53eb139dcb6a154ed007c7121c9ab58a7a88f44f...e0902fbce7d14631bd02091c1c70cde3e68f78ab,1,6,36,42,6,2015-01-20 23:13:52,2015-01-15 23:17:01
a789b361004da746b02919631a333170dfe20819...b2a7bcdb54ef0346a9a595100592a139538b3452,1,1,1,2,1,2015-01-24 04:57:13,2015-01-24 04:57:13
a789b361004da746b02919631a333170dfe20819...86815dca20604147f81618e54032dc194653a668,1,3,0,3,1,2015-01-24 00:04:23,2015-01-24 00:04:23
a789b361004da746b02919631a333170dfe20819...22b6a92365a95c4497e53e2e08e360e5b241aa98,1,1,1,2,1,2015-01-23 23:59:54,2015-01-23 23:59:54
a789b361004da746b02919631a333170dfe20819...fa8ca519ccc6c0821864fcdb203fac92409ee0ec,1,1,1,2,1,2015-01-23 23:35:29,2015-01-23 23:35:29
a789b361004da746b02919631a333170dfe20819...1188803922ded3a4dded62ae2fac0f3300f6bdd9,1,1,0,1,1,2015-01-23 00:19:11,2015-01-23 00:18:42
a789b361004da746b02919631a333170dfe20819...1d67e8fd0cccef467f4e87f9931896652185dc72,1,7,1,8,2,2015-01-21 17:53:16,2015-01-16 21:28:25
1d67e8fd0cccef467f4e87f9931896652185dc72...0ad5c845d2c5fb709cc4eb4ef7f9309684f75934,1,20,5,25,2,2015-01-21 17:53:20,2015-01-18 06:47:59
0ad5c845d2c5fb709cc4eb4ef7f9309684f75934...7c48508b287d1477089db0400ee8f8165f34b054,1,16,1,17,3,2015-01-21 18:55:17,2015-01-21 18:55:17
f83c19c87d6f484b72c24125aaac98bdc365c4b5...e15a0849ebc9c2f492c043080fd6e50373517cc8,1,2,0,2,1,2015-02-03 21:29:09,2015-02-03 21:15:11
f83c19c87d6f484b72c24125aaac98bdc365c4b5...3538f8f131e8ebe597c1172b381bb260ac66f1c0,2,6,9,15,4,2015-02-03 18:41:35,2015-02-03 18:41:35
f83c19c87d6f484b72c24125aaac98bdc365c4b5...1589a93aa6c7239423201465ceaddf461e98ac26,2,113,0,113,2,2015-02-03 15:33:04,2015-02-02 21:50:10
f83c19c87d6f484b72c24125aaac98bdc365c4b5...f4e3a6ab593b5b4870cab0b358718725644c4b82,1,1,6,7,6,2015-01-31 21:15:10,2015-01-31 21:15:10
bebd2017370294a468ed6cf02c9de35973a9e4f7...cc36f424d46f7c11ebff1dbf23df3be3d211c9b4,1,2,1,3,1,2015-02-06 00:09:26,2015-02-06 00:09:26
d1af70b0509916abcb4724e0d8cdbee8ebf6bb2d...b0f1533867a39cbccb25494c038dde4306331aba,2,4,0,4,2,2012-07-15 16:41:54,2012-07-14 22:45:20
b0f1533867a39cbccb25494c038dde4306331aba...d448392e5d030d40114b92d1261b72f3b3ab3e16,1,40,2,42,17,2012-07-15 16:41:55,2012-07-14 22:46:01
d448392e5d030d40114b92d1261b72f3b3ab3e16...b8748c1217445a95d3b29b361b467eb66992f8a7,2,627,469,1096,92,2012-07-17 18:32:39,2012-07-14 22:46:26
b8748c1217445a95d3b29b361b467eb66992f8a7...db9be9457d74a683916f107b39cad05a347b4c2c,3,165,0,165,3,2012-07-17 18:32:40,2012-07-15 09:06:15
db9be9457d74a683916f107b39cad05a347b4c2c...e2c81fca8f41cd8a4f7c908375a738320474fd9d,1,4,55,59,5,2012-07-17 18:32:41,2012-07-15 09:59:31
d1af70b0509916abcb4724e0d8cdbee8ebf6bb2d...227f31311979a2fdb1ffc8dbcb4cf0737e7bc899,2,15,15,30,10,2012-07-15 12:32:51,2012-07-15 12:11:58
d4b573513c511584ca7e7f1f9c7731d7349aa3f2...77ace82d7ab60fad62a02d272a37d8c4891f59a3,3,3,3,6,3,2012-07-16 11:30:23,2012-07-16 10:41:30
c498701df7700695e287ea0e2f08062f9147b3a6...b4ec3c648f6bb0a0af0b70b2443643fa2ea1c360,1,30,0,30,2,2011-09-20 09:26:08,2011-09-19 20:19:59
b4ec3c648f6bb0a0af0b70b2443643fa2ea1c360...93fdbe000c18c94f4f21b7a6613c80bd1dc29e21,1,7,4,11,3,2011-09-20 09:56:21,2011-09-20 09:11:59
c498701df7700695e287ea0e2f08062f9147b3a6...c3fe018b12e76aae4071b4199d83a0678c3baaaa,1,2,2,4,1,2011-09-20 08:02:11,2011-09-20 08:02:11
c498701df7700695e287ea0e2f08062f9147b3a6...7998ae5ab1d7a37860e10cdb34b3da1532b6efb0,7,278,57,335,41,2011-09-19 20:14:04,2011-09-19 19:36:12
7998ae5ab1d7a37860e10cdb34b3da1532b6efb0...6d0ef97478633263cafa1329e865f5a33b950ac3,2,15,6,21,9,2011-09-19 20:14:09,2011-09-19 19:41:27
9457a36ca0862f53b3678080cf3d7b094cef1869...a58881274d5682fd25fe40f2c644d30510d52d99,1,43,35,78,14,2011-09-20 22:14:57,2011-09-20 22:14:57
59116392357c17d4e3e36ce8538161cbad52e74c...4c562347aec5427ddf78d271f7dc2947ef7aa49e,2,71,0,71,3,2011-09-27 12:39:38,2011-09-22 19:34:46
4c562347aec5427ddf78d271f7dc2947ef7aa49e...40fe5fbea8f2e64dee1c2327c774cca0004f18f8,5,55,62,117,29,2011-09-27 12:40:56,2011-09-22 20:50:36
40fe5fbea8f2e64dee1c2327c774cca0004f18f8...dc5c87812c7328abc3f96e66b07e1c38885a51c1,1,12,11,23,4,2011-09-27 12:59:34,2011-09-27 12:53:57
dc5c87812c7328abc3f96e66b07e1c38885a51c1...887eaf4dc9b6f870b021ad88c881d5fcc6ccf4d1,3,21,16,37,13,2011-09-27 13:02:36,2011-09-23 15:36:37
05a62d1a8264e724e8353684de60b46eb6853cbb...136e7129d775f7c452a6b3215e4eff94eb808956,2,5,0,5,2,2011-07-26 22:06:19,2011-07-15 23:28:13
05a62d1a8264e724e8353684de60b46eb6853cbb...20a7e8208ee46de96050b06d06dfbc3e847668c2,1,0,11,11,5,2011-07-26 13:53:52,2011-07-26 13:53:52
77bb37eb47647180c0ed30517f6c6e4c219d131a...eed2714ba58d42c5bcfee6f6bf08bd670ffe7e85,2,45,15,60,8,2011-08-01 15:02:42,2011-08-01 15:00:31
1f61e301be9088bbe9e56411f669fce8a82ccb8d...e0fc39da9a4425c0e188d30502ba321ff28e8319,1,1,1,2,1,2011-06-30 20:28:19,2011-06-29 13:11:34
e0fc39da9a4425c0e188d30502ba321ff28e8319...637edc9c42803420decebae91d82c3dcf3626c96,1,2,4,6,3,2011-06-30 20:28:19,2011-06-30 18:53:59
637edc9c42803420decebae91d82c3dcf3626c96...8a0620030cc2159b361613d07cff508355b8fbdb,1,1,0,1,1,2011-06-30 20:28:19,2011-06-30 19:10:16
8a0620030cc2159b361613d07cff508355b8fbdb...b2cef77ccf52b1fb55f8e1ca98ada48bbfe90b92,2,2,4,6,2,2011-06-30 20:28:19,2011-06-30 19:29:42
b2cef77ccf52b1fb55f8e1ca98ada48bbfe90b92...17d523041df6247c21160cb19fa0e783ae40e43c,5,9,10,19,10,2011-07-01 15:26:23,2011-07-01 15:26:23
17d523041df6247c21160cb19fa0e783ae40e43c...ec62685345654cba50f3985c4ca44ce0e641d83c,2,1,5,6,2,2011-07-01 15:34:27,2011-07-01 15:34:27
ec62685345654cba50f3985c4ca44ce0e641d83c...1f4f4d17046e43ca24da9621323d921ae0d0f5dd,1,14,3,17,3,2011-07-01 15:41:46,2011-07-01 15:39:03
1f4f4d17046e43ca24da9621323d921ae0d0f5dd...932d1baf294aaacfd5a99e7758a3c08d8ffc22ab,37,139,139,278,124,2011-07-01 16:02:56,2011-06-30 16:52:34
932d1baf294aaacfd5a99e7758a3c08d8ffc22ab...678e9e045becdc5d75f2ce2259ed01c3531ee181,5,6,5,11,5,2011-07-03 11:33:43,2011-07-03 11:33:43
678e9e045becdc5d75f2ce2259ed01c3531ee181...f79026b4912bcd2336667f4c1663c06e233f0b32,33,1134,1064,2198,354,2011-07-05 00:04:03,2011-07-04 09:43:34
f79026b4912bcd2336667f4c1663c06e233f0b32...5ad739e8328c665b629e2285abaec7e12ea8397c,9,158,129,287,59,2011-07-05 00:06:26,2011-07-04 18:05:11
5ad739e8328c665b629e2285abaec7e12ea8397c...19ac1ed702b043790f4a6f0d095dd81f078b6c4c,4,26,28,54,8,2011-07-05 00:08:09,2011-07-04 19:33:26
19ac1ed702b043790f4a6f0d095dd81f078b6c4c...eec3fe394ad5953cc5e290e8bc6492dfbe463a1f,5,13,441,454,13,2011-07-05 00:09:05,2011-07-04 23:11:33
eec3fe394ad5953cc5e290e8bc6492dfbe463a1f...1bc83ff14f66b2ec983cff47802a3b64220e9d7b,1,14,56,70,13,2011-07-05 00:09:10,2011-07-04 23:33:39
1bc83ff14f66b2ec983cff47802a3b64220e9d7b...8b2c913acbb9848ffc9c0c1c39cb7a40ee5e710f,1,24,24,48,14,2011-07-05 00:21:25,2011-06-29 12:48:09
8b2c913acbb9848ffc9c0c1c39cb7a40ee5e710f...60caf0246538f26ea867302021747a0f7eae0cda,1,72,0,72,1,2011-07-05 00:21:26,2011-06-28 15:06:06
60caf0246538f26ea867302021747a0f7eae0cda...42a1b5e1ad94c41cc7acb6d9ea940572501dd1cb,2,198,55,253,27,2011-07-05 00:21:26,2011-07-01 15:59:10
42a1b5e1ad94c41cc7acb6d9ea940572501dd1cb...a01acc47bb4cc8a5c8120c95c1b054d91506ef5a,2,111,36,147,19,2011-07-05 00:21:26,2011-07-03 12:03:43
a01acc47bb4cc8a5c8120c95c1b054d91506ef5a...9f86ec52fab7e7eeb9ee95087c08fc88185d5ff3,1,4,7,11,3,2011-07-05 00:28:18,2011-07-05 00:28:18
9f86ec52fab7e7eeb9ee95087c08fc88185d5ff3...6d4b609718ad7ef7211974624a06564f15610a8b,2,19,7,26,5,2011-07-05 00:31:26,2011-06-28 13:20:42
6d4b609718ad7ef7211974624a06564f15610a8b...2601fcfc1e1c22874d266dc7086532fa52f44dd5,3,40,1,41,4,2011-07-05 00:32:17,2011-06-28 13:21:44
2601fcfc1e1c22874d266dc7086532fa52f44dd5...86b5ab162cbc16aa303a38b85e6c063426568787,1,1,1,2,1,2011-07-05 00:32:17,2011-06-28 14:08:46
86b5ab162cbc16aa303a38b85e6c063426568787...f58c53ce66cca0b42f615fc6773dbaf4e5fa566f,1,3,5,8,2,2011-07-05 00:32:17,2011-06-28 14:24:51
f58c53ce66cca0b42f615fc6773dbaf4e5fa566f...156af801e686e34685e2ac078a48d8224f3e33b4,2,10,0,10,3,2011-07-05 00:32:18,2011-06-28 14:27:16
156af801e686e34685e2ac078a48d8224f3e33b4...7d69f78897fc079a58059d9a84ab5928161d78cb,1,28,0,28,2,2011-07-05 00:32:18,2011-06-28 14:48:04
178376025cc70cc8da3ca58699717f2cc8e495a7...7a7ef2dcebcc650a5b789194c726ccbd7b32d726,1,7,0,7,3,2011-07-05 15:47:10,2011-07-05 15:44:51
178376025cc70cc8da3ca58699717f2cc8e495a7...8cc16e29e88a02e26b16da66aca6fa589831b76c,1,19,17,36,3,2011-07-05 14:52:39,2011-06-30 20:22:42
8cc16e29e88a02e26b16da66aca6fa589831b76c...c20ffa6104cf9797a14cc40dcc963102ef9a98a2,2,67,0,67,2,2011-07-05 14:52:39,2011-06-30 21:34:23
c20ffa6104cf9797a14cc40dcc963102ef9a98a2...0b0a6b115d617fe79a0be0ddecd89738aefa574c,1,1,1,2,1,2011-07-05 14:52:39,2011-06-30 21:48:37
0b0a6b115d617fe79a0be0ddecd89738aefa574c...476c42acc554e7b3f79c945c2a461d4e25dde41c,3,44,1,45,4,2011-07-05 14:52:39,2011-07-01 21:41:49
476c42acc554e7b3f79c945c2a461d4e25dde41c...245adf4f3cc1d47352e626ef53372d07761d84cf,2,12,0,12,2,2011-07-05 14:52:39,2011-07-01 22:08:42
c868981f0eb1af20d62c1287dad3f8c94addf999...7641327c8bc4876556d3fd9a182aa4a10a60e838,1,2,1,3,2,2015-01-13 21:53:07,2015-01-13 21:53:07
c868981f0eb1af20d62c1287dad3f8c94addf999...3b40ed897fdc36b958455b14673ab15cda7e0599,2,40,10,50,14,2015-01-08 19:23:37,2015-01-08 19:23:37
5091aff7823dd7badd821afc89b1c4c6761b13cf...c92987d1575b93eac3b6fa4d1b4bc166137305ac,1,1,1,2,1,2015-02-20 17:59:43,2015-02-20 15:21:32
a291790a8d42579dafe8684151931847921a9578...c8e02b8776875e6372fc5eba8fc61c51f14f3392,22,24,24,48,23,2015-02-15 20:07:05,2015-02-15 20:07:05
73c5db7663b16f8aee2176ae8a5a4ed5127d5c35...461fd5a0c75cbe62dcdd3de23b84e27deb3ded8b,1,2,1,3,1,2015-01-25 20:33:34,2015-01-24 14:15:12
73c5db7663b16f8aee2176ae8a5a4ed5127d5c35...36e13399c030227d19523d19e3b75073a72cadb3,1,4,2,6,2,2015-01-25 16:34:46,2015-01-25 16:34:46
73c5db7663b16f8aee2176ae8a5a4ed5127d5c35...b63b3b0e4df81174a323ff6b1b4450014502e9b7,1,3,0,3,1,2015-01-25 12:08:05,2015-01-25 12:08:05
b63b3b0e4df81174a323ff6b1b4450014502e9b7...636af2198e7d9128d6bf49cd7f7119de62fd5975,1,3,0,3,1,2015-01-25 12:38:10,2015-01-25 12:38:10
636af2198e7d9128d6bf49cd7f7119de62fd5975...bb6aafe88f01d2902085fd78464ae277ebea0a67,1,2,1,3,1,2015-01-25 12:40:23,2015-01-25 12:40:23
73c5db7663b16f8aee2176ae8a5a4ed5127d5c35...dc5fe00c6562e46c88a5c5b975121c202eae1180,1,3,0,3,1,2015-01-24 19:40:44,2015-01-24 18:07:23
73c5db7663b16f8aee2176ae8a5a4ed5127d5c35...3cda6be76b3c7615d1ff7180825bf5f7b1124268,1,3,0,3,1,2015-01-24 14:19:43,2015-01-24 14:19:43
f9e7abcbe2e9961f0e7ee603b67b81aa59134d87...2107dac34624421015c3a633975bde0ff797ba53,1,3,0,3,2,2015-02-05 04:51:22,2015-02-04 09:14:18
f9e7abcbe2e9961f0e7ee603b67b81aa59134d87...35425b51198b07738e8a5bd773a7711a0c869834,1,2,0,2,1,2015-02-04 06:06:07,2015-02-04 06:06:07
f9e7abcbe2e9961f0e7ee603b67b81aa59134d87...f45f9b6dbc8f7ee37b354196350d0e575cf7c0fe,1,1,1,2,1,2015-02-04 03:52:34,2015-02-04 03:52:34
471b10bd8fc2ff37228ada82cc710304905a5cef...710f66af351abb43e43e27ac23cb488babbaa04e,2,0,98,98,2,2015-02-03 23:43:57,2015-02-03 23:41:15
710f66af351abb43e43e27ac23cb488babbaa04e...a2e4593e8259c58b60579c5579330f03587a9ce6,1,1,1,2,1,2015-02-04 20:26:09,2015-02-03 23:41:40
3db1b15e16c8501a74292855a9cb4be4c62dd929...554063a5fe25e7ff9034f50c6bede5573b96dacb,1,0,2,2,1,2015-02-06 22:12:58,2015-02-06 22:12:58
3db1b15e16c8501a74292855a9cb4be4c62dd929...23d1dbe91963b70fbf05ce504d8d143c5e5ec568,1,24,6,30,4,2015-02-06 06:16:40,2015-02-06 05:43:12
5b786963341debf4db7b2984ee4c9bd0c9948764...14e1bc157a06d4513ce4193e6100a338432b3c88,1,1,0,1,1,2012-07-21 15:55:35,2012-07-21 15:54:56
14e1bc157a06d4513ce4193e6100a338432b3c88...279b45b05b05e0dfc496701c4d22e5ea601d0ebf,2,5,4,9,5,2012-07-23 19:32:45,2012-07-23 19:22:53
279b45b05b05e0dfc496701c4d22e5ea601d0ebf...8d711074ac2d1ee6a6c5f9f1e974f932cb95b42b,1,4,2,6,1,2012-07-23 19:52:28,2012-07-22 17:42:47
8d711074ac2d1ee6a6c5f9f1e974f932cb95b42b...7e48635d16f68397754bf11b101e165355c34d2f,1,1,1,2,1,2012-07-23 19:56:06,2012-07-23 19:56:06
7e48635d16f68397754bf11b101e165355c34d2f...944d250f964698b33d9fa09e2e6af74b1dd84de2,1,1,1,2,1,2012-07-24 08:34:28,2012-07-24 08:34:28
ea5d2ce4cfa6cec89e2d844a70d1eb24bb401c7d...6fc0bdc53e0392a908d6b4c89827e06f2bb19b4a,2,0,14,14,3,2012-07-17 08:52:16,2012-07-17 08:52:16
805dc2a08855364663e7d1cca45dd58318907883...e3ecf7e9ab043e44ffd94729f27e3a0c434c355a,1,0,0,0,0,2011-09-21 11:09:56,2011-09-21 11:09:56
e3ecf7e9ab043e44ffd94729f27e3a0c434c355a...e1b86444676b70154bf8ab450d429bdef57a8276,7,52,11,63,18,2011-09-21 19:00:34,2011-09-21 18:17:30
887eaf4dc9b6f870b021ad88c881d5fcc6ccf4d1...a5b0e7f8bc42e3eca72dd82ff000eb6eb92ef897,2,1,2,3,2,2011-09-27 18:08:15,2011-09-27 18:08:13
4930e7218776bb6fda4b7f6e02d0b3bdfdd8bae4...b311e3132af167394d95f65d02fe4a04693184d3,1,1,0,1,1,2011-07-27 16:33:20,2011-07-27 16:31:13
4930e7218776bb6fda4b7f6e02d0b3bdfdd8bae4...1e76676fb45a72211cfc6ffd579500b174e7202f,2,18,10,28,7,2011-07-26 23:22:50,2011-07-26 23:22:50
80de9ae03c82b6c7f3d313edc1db72b81ad01916...7d3ec3caac1ed10faecaf828b481b0f4958755c1,2,7,1,8,6,2011-08-02 17:23:00,2011-08-02 17:23:00
7d69f78897fc079a58059d9a84ab5928161d78cb...51cc50a37d1dbff2f877012073c13f6d24308bfe,1,6,3,9,5,2011-07-05 11:20:10,2011-07-05 08:43:21
51cc50a37d1dbff2f877012073c13f6d24308bfe...d6d877d20f76b3b6bf0e370cadd24e3321ce5371,1,3,0,3,1,2011-07-05 11:20:10,2011-07-05 08:54:16
d6d877d20f76b3b6bf0e370cadd24e3321ce5371...6f2b0a3ae2fd57dc52d2e84367b51cd06ba9a11c,1,4,2,6,3,2011-07-05 11:20:10,2011-07-05 09:00:18
7d69f78897fc079a58059d9a84ab5928161d78cb...ed72182bcf8117fd6fce069b7b55dfdb6562e0c3,1,3,3,6,3,2011-07-05 08:09:37,2011-07-05 08:09:37
0838ccc2fbe46827339ff1a987f6e1071860c78d...7a44cc41f48be544c8a54514eaa9ecf7efb884e3,1,1,1,2,1,2011-07-05 18:00:32,2011-07-05 18:00:32
bf9a2e98b83c8de2b8664a91167b5529ae1d9d39...26911cbd9263ef0a75f8e1ac01f695790b72b559,1,6,6,12,6,2011-07-06 19:27:51,2011-07-06 19:27:51
20273e4d3cf2554fb6d209474400105ca15e92b5...76f034180aee96fcc1fffd5267ccbc6ada68482a,2,0,0,0,0,2015-03-03 16:04:38,2015-03-03 16:04:38
366e53d3da72805a3db1a1e77d4666416fcb5a93...094cfc2904bab0d6ec52f16cb677b3b0ebbc7621,2,2,2,4,2,2015-02-27 18:47:30,2015-02-14 15:03:29
094cfc2904bab0d6ec52f16cb677b3b0ebbc7621...5cbe950fb8b18e930f79c81bdab0aebf21443596,1,1,1,2,1,2015-02-27 18:47:34,2015-02-14 15:45:01
5cbe950fb8b18e930f79c81bdab0aebf21443596...e6da3e4496188b36dbc83950f5e771a373c8ebcc,2,43,0,43,2,2015-02-27 18:50:32,2015-02-14 15:33:06
e6da3e4496188b36dbc83950f5e771a373c8ebcc...6c9e86adafa8cef6dfc685e8be58aeb257a9b63d,2,2,2,4,2,2015-02-27 18:50:36,2015-02-14 15:46:41
6c9e86adafa8cef6dfc685e8be58aeb257a9b63d...14fec0aea3b57bdf29ab7a195061127f8a3edc30,1,1,1,2,1,2015-02-27 18:50:40,2015-02-14 17:10:00
14fec0aea3b57bdf29ab7a195061127f8a3edc30...96b82b11c64ffcf00e0d10b1bad1b6d1fbfc896c,11,91,73,164,58,2015-02-27 18:50:44,2015-02-14 16:44:05
96b82b11c64ffcf00e0d10b1bad1b6d1fbfc896c...496b76d415b080712d7648fc6f1ff2e55d27a6a5,2,4,9,13,5,2015-02-27 18:50:48,2015-02-27 16:02:37
366e53d3da72805a3db1a1e77d4666416fcb5a93...cfcb346d94fa60bc99d22cba7910510db869ae9a,2,75,0,75,10,2015-02-27 05:30:50,2015-02-27 05:30:50
366e53d3da72805a3db1a1e77d4666416fcb5a93...3cbaa5872cd6e0997fae63767e0732743435e473,1,1,0,1,1,2015-02-27 04:39:54,2015-02-27 04:39:54
366e53d3da72805a3db1a1e77d4666416fcb5a93...a275fbc0f7773e6c5888ae7ce766e7a9eb3a5e65,4,209,8,217,5,2015-02-25 09:24:13,2015-02-05 10:40:16
366e53d3da72805a3db1a1e77d4666416fcb5a93...ecf1c3c3589229e5d26ead78607d6abbb881c6d8,1,4,1,5,1,2015-02-23 16:19:32,2015-02-23 16:18:52
c92987d1575b93eac3b6fa4d1b4bc166137305ac...4196dd8e8fceaaa42ad5854e1ce362c14b8c0bf6,4,274,61,335,34,2015-02-27 04:36:47,2015-02-26 20:33:58
437ba9ad651a395b8b3105f5a2d2848194166c06...fbdc9db3643e89e26d6e49f7b4e4ec1c668a4f0d,4,264,7,271,10,2015-02-17 07:19:05,2015-01-22 22:10:06
fbdc9db3643e89e26d6e49f7b4e4ec1c668a4f0d...5555696f8a48d2319a7ca0918726711e6a81a924,1,81,73,154,30,2015-02-17 20:57:04,2015-01-22 22:11:22
5555696f8a48d2319a7ca0918726711e6a81a924...e78f5c9f4282319cf8e1afc8631e6259e91653a6,2,84,39,123,21,2015-02-17 20:57:10,2015-01-22 22:11:36
e78f5c9f4282319cf8e1afc8631e6259e91653a6...646364e780c65b1af2e28a7bdeabd22b67816454,3,27,12,39,15,2015-02-17 21:03:45,2015-02-17 20:25:31
646364e780c65b1af2e28a7bdeabd22b67816454...8c2dfb38dbc782a6b964bfcfd43e4f46bb71526e,1,221,0,221,1,2015-02-17 22:00:57,2015-02-17 18:27:06
8c2dfb38dbc782a6b964bfcfd43e4f46bb71526e...b75f15aaf1587594cd398b192cdc40aa83ba8e23,6,51,51,102,44,2015-02-18 15:24:23,2015-02-18 14:25:32
b75f15aaf1587594cd398b192cdc40aa83ba8e23...f7c0125f47ce23d52685648e076e663bc3a8939e,2,12,12,24,6,2015-02-18 15:24:34,2015-02-18 14:28:07
f7c0125f47ce23d52685648e076e663bc3a8939e...b49edddcd0af70caee7eb4905dc26199adccabfd,1,1,2,3,2,2015-02-18 15:24:43,2015-02-18 14:40:52
b49edddcd0af70caee7eb4905dc26199adccabfd...d4cf167515d3ed7b27c1358fc2e19b9caf66e8ad,6,35,37,72,10,2015-02-19 15:05:33,2015-02-19 15:05:33
d4cf167515d3ed7b27c1358fc2e19b9caf66e8ad...795eaccd667ce24c290b6211ca0c6a84f84e7c2b,11,27,27,54,25,2015-02-19 16:09:54,2015-02-19 16:09:54
795eaccd667ce24c290b6211ca0c6a84f84e7c2b...d05218b06ff201cd373fc764e0d87af67f7932c7,3,32,16,48,15,2015-02-19 16:25:26,2015-02-19 16:25:26
d05218b06ff201cd373fc764e0d87af67f7932c7...9c9aa1bad3b364f7dfdccd5f6abe880f7e18c499,3,9,13,22,7,2015-02-19 16:45:46,2015-02-19 16:32:55
9c9aa1bad3b364f7dfdccd5f6abe880f7e18c499...feb0e022867552c039c02fe39db7b7c3d63ae327,4,5,3,8,4,2015-02-19 17:14:06,2015-02-19 17:14:06
b703049c6189fec223896999b9cf5d78efcb08d7...3ea78f241fb0c77822d75211752b4a1d4f299ed7,1,22,0,22,1,2015-02-12 21:15:16,2015-02-09 16:40:22
3ea78f241fb0c77822d75211752b4a1d4f299ed7...1713653883c3dfd199a18b51a1e2b37def183101,1,1,0,1,1,2015-02-12 21:15:16,2015-02-05 20:39:59
b703049c6189fec223896999b9cf5d78efcb08d7...a36486ef26dac5f4f359cc54c865b91bbc31767e,1,2,0,2,1,2015-02-11 22:30:34,2015-02-11 17:31:54
b703049c6189fec223896999b9cf5d78efcb08d7...ec510666a166958d26babbfa235846ed216b57c2,1,25,0,25,1,2015-02-11 02:34:08,2015-02-10 15:10:32
ec510666a166958d26babbfa235846ed216b57c2...0b55ed9542aa9f9de14f58a4e0241c87d98185ee,1,15,21,36,1,2015-02-11 02:34:20,2015-02-10 15:14:49
b703049c6189fec223896999b9cf5d78efcb08d7...ec7e1c93ce1c177026073abd16d6a8d2b548d3bd,9,22,23,45,17,2015-02-10 15:31:48,2015-02-10 15:31:48
ec7e1c93ce1c177026073abd16d6a8d2b548d3bd...c03e8c224cf18104bc97a68aed85317820d062ae,3,7,7,14,3,2015-02-10 19:44:05,2015-02-10 19:44:05
944d250f964698b33d9fa09e2e6af74b1dd84de2...1d733b573af9e3a987be96b31be5ac11d3517f66,1,11,1,12,2,2012-07-25 09:23:27,2012-07-25 07:00:58
944d250f964698b33d9fa09e2e6af74b1dd84de2...1cb157184b6547b613a008455ba386425bb38a23,1,8,7,15,8,2012-07-25 05:53:27,2012-07-16 13:14:29
1cb157184b6547b613a008455ba386425bb38a23...7c458e3aee7b39bfec368456d494972fe9ae244b,3,4,2,6,3,2012-07-25 05:53:27,2012-07-17 08:53:19
7c458e3aee7b39bfec368456d494972fe9ae244b...59341a5d5960b13801404d3690f6bcf27e91efa6,3,189,4,193,5,2012-07-25 05:53:29,2012-07-16 16:31:22
59341a5d5960b13801404d3690f6bcf27e91efa6...d284b3de631edeaa651bf3ee2c5963cb970016c4,3,11,11,22,8,2012-07-25 05:53:30,2012-07-16 10:12:53
d284b3de631edeaa651bf3ee2c5963cb970016c4...bd72425d16fce9771af7727029f7d8ea8c2e98d2,5,146,61,207,31,2012-07-25 05:53:30,2012-07-18 18:12:45
bd72425d16fce9771af7727029f7d8ea8c2e98d2...ae8331784eb968169e03099a5803a236a6a5aed4,2,20,9,29,7,2012-07-25 05:53:31,2012-07-21 10:32:02
ae8331784eb968169e03099a5803a236a6a5aed4...40c75652d075f87f20ddfbb715667f82644bc760,3,98,139,237,37,2012-07-25 05:53:32,2012-07-21 10:33:46
40c75652d075f87f20ddfbb715667f82644bc760...c3be5c5af089683b6c61d1d37d8c2c40ff48e9a8,2,43,0,43,4,2012-07-25 06:01:13,2012-07-21 17:19:46
944d250f964698b33d9fa09e2e6af74b1dd84de2...034ccc76a6269519276ead867d4c06c8c91f2a6a,1,18,7,25,3,2012-07-24 17:45:51,2012-07-24 17:07:55
944d250f964698b33d9fa09e2e6af74b1dd84de2...b8457baae24269c9fb777591e2a0e1b425ba31b6,35,82,81,163,81,2012-07-24 14:10:12,2012-07-24 05:57:58
944d250f964698b33d9fa09e2e6af74b1dd84de2...326ca710a04cc43d3d5abba6ceb0452c126b7d1a,6,2,22,24,7,2012-07-24 14:09:42,2012-07-19 13:32:58
326ca710a04cc43d3d5abba6ceb0452c126b7d1a...b308c11e4ee7d05df4906e04b4008615f41e069c,3,23,54,77,18,2012-07-24 14:09:43,2012-07-19 13:39:16
b308c11e4ee7d05df4906e04b4008615f41e069c...eed378b66960414942ac78840afbcb19bfffbf15,3,70,0,70,3,2012-07-24 14:09:44,2012-07-20 14:19:04
eed378b66960414942ac78840afbcb19bfffbf15...88bcd5153f6dc9e0c7ebc73a1e87c0da17e8df28,3,33,0,33,3,2012-07-24 14:09:45,2012-07-20 14:27:56
88bcd5153f6dc9e0c7ebc73a1e87c0da17e8df28...abee7bd36a8a00e9578d3c94b1b7080f5b5c7dc8,1,2,2,4,2,2012-07-24 14:09:46,2012-07-20 14:31:17
abee7bd36a8a00e9578d3c94b1b7080f5b5c7dc8...bf9e8cc86b9c32946a395fd12a9b1a5cb71575a9,3,41,49,90,26,2012-07-24 14:09:47,2012-07-20 14:34:08
bf9e8cc86b9c32946a395fd12a9b1a5cb71575a9...fb910281d6598e2c235f6ec93384d4e08838d655,9,164,7,171,13,2012-07-24 14:09:48,2012-07-20 14:38:54
fb910281d6598e2c235f6ec93384d4e08838d655...ef4d795ec5f8cd39de72cfbc75565236205833a4,3,0,144,144,4,2012-07-24 14:09:49,2012-07-20 14:39:22
ef4d795ec5f8cd39de72cfbc75565236205833a4...786a17cd282cf81c76c45a8e62f2a1003235a673,1,1,0,1,1,2012-07-24 14:09:50,2012-07-20 14:41:41
944d250f964698b33d9fa09e2e6af74b1dd84de2...02a0d651d79b2108dd6b894b9a43f7682270ac51,6,55,11,66,6,2012-07-24 12:03:07,2012-07-12 14:31:59
02a0d651d79b2108dd6b894b9a43f7682270ac51...151446ca605686b83b93952e8168cfc0b37cf4d3,1,63,0,63,1,2012-07-24 12:03:08,2012-07-03 15:46:07
151446ca605686b83b93952e8168cfc0b37cf4d3...e5e71f5e1db75075a81881f38b4ee0013fa966be,1,17,1,18,4,2012-07-24 12:03:08,2012-07-18 14:26:11
e5e71f5e1db75075a81881f38b4ee0013fa966be...ffbc689c8768c66cddf9ef3ab6c88c41ecf4c1ab,2,20,9,29,7,2012-07-24 12:03:09,2012-07-18 14:26:55
ffbc689c8768c66cddf9ef3ab6c88c41ecf4c1ab...a1773f9d89887d299248d15b43953d3fa494a025,5,55,2,57,7,2012-07-24 12:03:09,2012-07-23 16:16:09
bfc65634050dc52e3ed6b4497ebbb511e39d6e1e...3e026f1b4597c24848487422eb566a9434b5821d,1,1,1,2,1,2012-07-17 16:00:38,2012-07-17 16:00:38
3e026f1b4597c24848487422eb566a9434b5821d...8651c10f1ed5d42ef0ad6e9e9f654799b4ffb39c,6,79,18,97,21,2012-07-18 02:57:37,2012-07-18 02:57:37
8651c10f1ed5d42ef0ad6e9e9f654799b4ffb39c...09a03995e00605c9b23f799673b7ccb304506e5b,1,12,4,16,8,2012-07-18 03:20:34,2012-07-18 03:20:34
09a03995e00605c9b23f799673b7ccb304506e5b...7cae2bcdf973c1b1eea8e139a6fd8de3b47f46ab,1,3,0,3,2,2012-07-22 03:11:37,2012-07-22 03:11:37
7cae2bcdf973c1b1eea8e139a6fd8de3b47f46ab...dc03369c07c6222c763cca8a80452608c8cce435,1,17,16,33,4,2012-07-22 03:12:28,2012-07-22 03:12:28
dc03369c07c6222c763cca8a80452608c8cce435...ef9905c9902a9ffad71c8acddec74dc0d8e866de,5,74,38,112,36,2012-07-26 19:58:44,2012-07-26 19:58:44
ef9905c9902a9ffad71c8acddec74dc0d8e866de...b401bace1b28ac23990382605791eddbeda09d9b,6,49,39,88,32,2012-07-26 20:12:21,2012-07-26 20:12:21
b401bace1b28ac23990382605791eddbeda09d9b...095ccc013f04398369d4063ff802d4c2928e367d,2,49,19,68,10,2012-07-26 23:31:49,2012-07-26 23:31:49
095ccc013f04398369d4063ff802d4c2928e367d...6eb240b0b4d5938301efc14eafb440fa931366b6,1,15,15,30,4,2012-07-27 02:09:37,2012-07-27 02:09:37
6eb240b0b4d5938301efc14eafb440fa931366b6...15445f9ef7fea43a550a78c7425ae91c53a1c108,1,1,1,2,1,2012-07-27 18:14:30,2012-07-27 18:14:30
5a8204f8a88c59c2cb07b93930834ef0a5aaf1fc...71d273583755c0a2b7f5d608f017f4586add51e4,4,62,2,64,5,2012-07-19 17:23:45,2012-07-19 17:23:45
5a8204f8a88c59c2cb07b93930834ef0a5aaf1fc...c6f429535c011160dc60547e5147695f2107a260,1,12,8,20,7,2012-07-19 16:44:08,2012-07-19 15:33:48
e1b86444676b70154bf8ab450d429bdef57a8276...ad196c6ae669e2d69503eba942402e7215ea7b82,12,113,26,139,31,2011-09-22 16:58:47,2011-09-21 21:17:39
35e9407c4698080b29f2bcb3d379454bb0ae62bb...d02a7d833083518353ede8c940410d5229e83e48,3,84,116,200,32,2011-09-28 16:57:32,2011-09-28 16:57:32
d02a7d833083518353ede8c940410d5229e83e48...59903b1fab6ba3536b3a2fd3b29acca824fb2e3b,1,4,4,8,4,2011-09-28 17:41:33,2011-09-28 17:27:58
59903b1fab6ba3536b3a2fd3b29acca824fb2e3b...d215cf2429ab5a64c0b12b6dae8078626e1d9dc1,2,4,4,8,3,2011-09-28 18:21:48,2011-09-28 18:21:48
d215cf2429ab5a64c0b12b6dae8078626e1d9dc1...5888860d2aae70914ec150bfdb82c8d7e0149ebb,2,11,1,12,2,2011-09-28 21:49:55,2011-09-28 21:42:38
5888860d2aae70914ec150bfdb82c8d7e0149ebb...0812caaea54e47e31f07e989c3052c61084e1ece,1,11,12,23,4,2011-09-28 21:54:09,2011-09-28 21:54:09
0812caaea54e47e31f07e989c3052c61084e1ece...72bdfdbc7cb868b222127d1592d35a19e47ceb05,2,5,10,15,2,2011-09-29 13:25:22,2011-09-29 13:24:41
72bdfdbc7cb868b222127d1592d35a19e47ceb05...8af4d074cc3bcc8ea63d75f147be892e4925075b,3,12,5,17,4,2011-09-29 13:34:17,2011-09-29 13:34:17
8af4d074cc3bcc8ea63d75f147be892e4925075b...c103d7b4b7e5fff1e5ec548ca24c16b1d2be33b8,3,10,9,19,7,2011-09-29 13:49:28,2011-09-29 13:49:28
c103d7b4b7e5fff1e5ec548ca24c16b1d2be33b8...780bea6e261cf19cb4bf826de343afcdb362f1b7,2,8,1,9,2,2011-09-29 14:23:24,2011-09-29 14:23:24
780bea6e261cf19cb4bf826de343afcdb362f1b7...356f11feeaadb19b6c5acf4e49fa6a17dc7b7a71,1,4,1,5,3,2011-09-29 14:28:00,2011-09-29 14:28:00
356f11feeaadb19b6c5acf4e49fa6a17dc7b7a71...6e34111e136f2881dc98696314e4ea6b246e393d,1,11,9,20,4,2011-09-29 14:30:38,2011-09-29 14:30:38
6e34111e136f2881dc98696314e4ea6b246e393d...6c8b458dccec1a4c81825d9c0777232540abac06,4,28,22,50,18,2011-09-29 15:04:45,2011-09-29 15:04:45
03d88ed415a09faf161d8a081c18f51826be584a...8cf077f4d52e53f9b09e72bae2a358aa282d89f9,1,1,1,2,1,2011-08-03 11:37:24,2011-08-03 11:37:24
8cf077f4d52e53f9b09e72bae2a358aa282d89f9...9d9e492dc0e61468d1914a449f080a75ee171b4b,1,0,2,2,2,2011-08-03 11:38:02,2011-08-03 11:38:02
9d9e492dc0e61468d1914a449f080a75ee171b4b...8f643ce8e3ec02afa1f145fa820e10a825a4c603,2,0,2,2,2,2011-08-03 11:44:28,2011-08-03 11:44:28
03d88ed415a09faf161d8a081c18f51826be584a...5274c31a89ec9075cc74ff189f6264a976c04571,2,29,1,30,3,2011-08-02 23:17:31,2011-08-02 23:17:31
5274c31a89ec9075cc74ff189f6264a976c04571...63396a3998610ea1e3555b15a26051525e00e58e,5,46,40,86,29,2011-08-03 14:05:32,2011-08-03 13:57:33
03d88ed415a09faf161d8a081c18f51826be584a...7bfdb3d22bee39273e5861eeb4b77e4c8b5225b7,3,372,227,599,45,2011-08-02 18:53:51,2011-06-28 18:39:30
7bfdb3d22bee39273e5861eeb4b77e4c8b5225b7...c7c9e18388b6e11265c867766d4c001197852134,2,95,59,154,3,2011-08-02 18:53:51,2011-07-07 08:17:40
c7c9e18388b6e11265c867766d4c001197852134...3412391d4ccf6435b981c46e796cc6988a676fad,3,149,0,149,3,2011-08-02 19:41:02,2011-07-07 09:47:31
3412391d4ccf6435b981c46e796cc6988a676fad...f23c4a66bde5738a574416db4617ca749ca34f7d,2,45,7,52,7,2011-08-02 19:41:05,2011-07-07 17:08:45
f23c4a66bde5738a574416db4617ca749ca34f7d...ab525a7463492aa64c936b59165ab33f6264f1a8,2,103,14,117,19,2011-08-02 19:41:33,2011-07-07 17:20:13
ab525a7463492aa64c936b59165ab33f6264f1a8...7d0cdf82be73ea8c0dce07e5e0ed3c7fdcd4707e,6,360,374,734,37,2011-08-02 19:42:03,2011-07-09 00:25:01
7d0cdf82be73ea8c0dce07e5e0ed3c7fdcd4707e...a070f152bdeaeef61e7b0624231fe1d946b0043e,4,534,557,1091,50,2011-08-02 19:42:03,2011-07-28 23:08:02
a070f152bdeaeef61e7b0624231fe1d946b0043e...b5b474dd0de88c0decd1bf6f4a4b202c8081bf43,4,90,107,197,35,2011-08-02 19:42:03,2011-07-28 09:45:46
b5b474dd0de88c0decd1bf6f4a4b202c8081bf43...bcf21c556c2bbc46a93e81a19c5f9112dfb8f2c8,1,3,0,3,1,2011-08-02 19:42:04,2011-07-28 21:59:53
bcf21c556c2bbc46a93e81a19c5f9112dfb8f2c8...b7c44096ae12c47085978a4992d4f8cdf7946db4,2,212,43,255,36,2011-08-03 12:02:41,2011-07-28 21:35:39
b7c44096ae12c47085978a4992d4f8cdf7946db4...48b3ad4f15a55ea6406958159b8d63b89b5dffdc,2,2,7,9,3,2011-08-03 12:02:49,2011-08-01 12:02:09
48b3ad4f15a55ea6406958159b8d63b89b5dffdc...65cb1586c45b6ca2e74753b93e8677edcae903ae,1,46,1,47,5,2011-08-03 12:02:49,2011-08-01 14:46:36
3827c923b8f2929524410a6292a4514d529b2c69...6507743400b8189d31aa49f775fd06b2ed504fbd,1,1,1,2,1,2011-07-05 19:50:51,2011-07-05 19:15:03
6507743400b8189d31aa49f775fd06b2ed504fbd...e9c6571d7fd39c82232fd965544ce34c6974a441,7,258,577,835,11,2011-07-05 23:04:04,2011-07-05 23:04:04
e9c6571d7fd39c82232fd965544ce34c6974a441...1e3300d840fd1475827111d99133d76ec967a0c4,1,2,2,4,2,2011-07-05 23:44:15,2011-07-05 23:44:15
1e3300d840fd1475827111d99133d76ec967a0c4...e1bf24c86221fb412df52340ef2faa65c816c7bf,1,26,0,26,1,2011-07-06 00:17:15,2011-07-06 00:14:30
76f034180aee96fcc1fffd5267ccbc6ada68482a...a212716fc3ab684c67e1a1c8c45dc3e88f87b0a1,2,41,0,41,2,2015-03-03 23:19:42,2015-03-03 23:19:42
a212716fc3ab684c67e1a1c8c45dc3e88f87b0a1...f78d9b6cfe721539b4ecf0ae6d01367b13959a45,2,84,10,94,11,2015-03-04 05:01:34,2015-03-04 04:56:54
76f034180aee96fcc1fffd5267ccbc6ada68482a...9a97f49e3aa15edc479fc590f4b28fc44c155c40,35,446,318,764,248,2015-03-03 17:35:12,2014-12-21 15:31:03
76f034180aee96fcc1fffd5267ccbc6ada68482a...e892b6a92772742e2f30f855e36762b679383fb0,1,5,0,5,1,2015-03-03 17:07:16,2015-03-03 16:23:01
99b68a2aecfaa24f252f265d61b230b8e2576dd2...659cf2029f322ea876d663d85783b48945227e8f,91,581,611,1192,524,2015-03-03 13:40:50,2015-01-07 12:23:05
659cf2029f322ea876d663d85783b48945227e8f...23a17803b6e3a8bf21f740726ec0a038968da9a1,14,76,102,178,71,2015-03-03 13:40:50,2015-01-07 14:16:50
23a17803b6e3a8bf21f740726ec0a038968da9a1...6bfb990dc74c3749b356f82f7c9744b43fe90ea9,9,58,109,167,58,2015-03-03 13:40:50,2015-01-07 14:47:02
6bfb990dc74c3749b356f82f7c9744b43fe90ea9...412a3808889de65d8f94f22502aba10b9afbf755,6,15,23,38,14,2015-03-03 13:40:50,2015-01-15 14:31:23
412a3808889de65d8f94f22502aba10b9afbf755...4e498646b6e4f3e6303cd3a27682dcd10d97eaeb,22,141,125,266,103,2015-03-03 13:40:50,2015-01-15 15:50:31
4e498646b6e4f3e6303cd3a27682dcd10d97eaeb...41513659de1958fd5907c511f7ddd2ee46e6cd69,1,19,0,19,1,2015-03-03 13:40:51,2015-02-06 22:46:23
fb2f3a76aaf9d76b947ca7527797e0eb0b5d057f...7e9b21aa2a13b97b54b0083eb8f40b7f428bc829,3,70,4,74,6,2015-03-03 13:47:44,2015-02-27 13:54:48
7e9b21aa2a13b97b54b0083eb8f40b7f428bc829...d8be5087771db34b191b13f22a2846888a477c36,1,2,4,6,2,2015-03-03 18:35:10,2015-03-03 18:35:10
c23002c5608037957faf13e21adeb214b01fe30e...79863917191aaf513fe93029749f655de361eb43,1,6,1,7,2,2015-03-02 18:24:54,2015-03-02 18:24:54
c23002c5608037957faf13e21adeb214b01fe30e...bf1476f190738ac825531f91bd7310205995e199,2,3,2,5,2,2015-03-02 15:35:26,2015-03-02 15:35:26
c23002c5608037957faf13e21adeb214b01fe30e...6b5c0886b626a1d90bd3c32b919df2231d15bf60,5,239,1,240,15,2015-03-02 13:20:27,2015-02-13 21:58:14
6b5c0886b626a1d90bd3c32b919df2231d15bf60...f096fbf4d6a0ef37aba287a88411ad7ca3e8a365,1,7,7,14,7,2015-03-02 13:34:02,2015-03-02 13:34:02
f096fbf4d6a0ef37aba287a88411ad7ca3e8a365...9a859ef55a3de35d7e35dbaf33bd562aeb1cf081,4,153,2,155,10,2015-03-02 14:21:55,2015-03-02 14:21:55
9a859ef55a3de35d7e35dbaf33bd562aeb1cf081...e5cf1c704c6c06fb2f0c66a5b8e477af4e5eb0f4,2,11,76,87,12,2015-03-03 14:57:50,2015-03-03 14:57:50
c23002c5608037957faf13e21adeb214b01fe30e...a944c6cc40273b45922fa22949fe6b12ff668889,1,6,3,9,2,2015-03-02 09:14:07,2015-03-02 09:08:04
a944c6cc40273b45922fa22949fe6b12ff668889...ec0324422705875e84eb1afdeae36a4e1db5f467,1,4,4,8,2,2015-03-02 09:15:13,2015-02-27 08:49:02
ec0324422705875e84eb1afdeae36a4e1db5f467...45df2237bfe4bcb9df1c2f68b0d47ef0e4f3f78d,1,1,0,1,1,2015-03-02 09:15:32,2015-02-27 08:53:39
15f581747c57f1bb5f3c3a173139789ec759c964...e6903ea278c43895cce234bb956b31570b4bbb07,2,5,5,10,5,2015-03-12 15:05:07,2015-03-12 15:05:07
15f581747c57f1bb5f3c3a173139789ec759c964...8a3934e49b6bdbaa5c3c3f419258b44280d4122c,1,1,2,3,2,2015-03-12 02:29:36,2015-03-12 02:29:36
31637cd56a5ed339fdebc9cd51af8f50a7794f24...6810ba089a543a2407b1c8824dffa9b4e1d63975,1,1,1,2,1,2012-07-28 09:33:12,2012-07-28 09:33:12
43b67d496b87a9c6ce38a500b7f3121bf136942e...b84f75c357208ce54c5cc35921ff0b4a1abbe7d2,3,11,11,22,11,2012-07-27 16:43:02,2012-07-27 16:43:02
7779437fd56882060eca6128e9680ba1705e0081...0aeae70553beb06d8df288232f1a1d345631f3cd,1,1,1,2,1,2012-07-25 15:01:50,2012-07-25 15:01:50
e25dda51c4dc47ed99f95dae6486c6275b119484...d96c3863a50f2a9b0f33735911e5472fec3ad288,1,7,0,7,2,2012-08-02 00:12:16,2012-08-01 23:56:02
d96c3863a50f2a9b0f33735911e5472fec3ad288...5daca042c642bf123f0b0a39c1ad32ca0afcac70,1,7,2,9,2,2012-08-02 23:01:21,2012-08-02 23:01:21
5daca042c642bf123f0b0a39c1ad32ca0afcac70...7e9f78b5fee2d8f56711a587c35fcba10d370547,3,2,2,4,3,2012-08-04 13:30:28,2012-08-04 13:22:38
b41a30bdbb96dc0eb2d7e30497918ecbb45fd090...f0244463ad280664d2cac950fcc5d6ff550905d1,4,13,9,22,12,2012-07-27 16:49:37,2012-07-27 16:49:37
a4827a5b5c2a9d2d8a35a5a76adcc9881a11b07b...7affe23db01257cfd7fe8431dea31d5924e106fd,1,1,1,2,1,2012-07-27 18:23:44,2012-07-27 18:23:44
7affe23db01257cfd7fe8431dea31d5924e106fd...8a155a044b2251f53e6c0524c4a4eeaac53dc31f,1,4,3,7,3,2012-07-27 18:49:34,2012-07-27 18:49:34
8a155a044b2251f53e6c0524c4a4eeaac53dc31f...b494cdbdb2833d1233291eea7eb5d9290257131e,1,2,1,3,1,2012-07-27 18:50:32,2012-07-27 18:50:32
b494cdbdb2833d1233291eea7eb5d9290257131e...4d83399d35f0d3d489c50f2358bd5481a90ddce5,1,2,1,3,2,2012-07-27 18:55:58,2012-07-27 18:55:58
4d83399d35f0d3d489c50f2358bd5481a90ddce5...b31667fb695dab0510cc5fc259e0569ff2a2ef41,9,107,42,149,21,2012-07-28 03:31:05,2012-07-28 03:29:06
b31667fb695dab0510cc5fc259e0569ff2a2ef41...32beb2ecfe5b09acf0640b5f6ccfc1d035cc2142,1,1,1,2,1,2012-07-28 03:36:12,2012-07-28 03:36:12
32beb2ecfe5b09acf0640b5f6ccfc1d035cc2142...e0681f6d07a9f6041e7450af4715a8df8552ad2e,1,3,0,3,3,2012-07-28 03:39:43,2012-07-28 03:39:43
e0681f6d07a9f6041e7450af4715a8df8552ad2e...f1587b97a11e3a7283b32f5af46b7d057b8be4c5,3,39,6,45,10,2012-07-30 21:37:40,2012-07-30 21:37:40
f1587b97a11e3a7283b32f5af46b7d057b8be4c5...84595a30c01d5808ff71fda8ab63603214d665bf,4,72,0,72,4,2012-07-30 21:38:32,2012-07-30 21:38:32
84595a30c01d5808ff71fda8ab63603214d665bf...4bf5115642b64851f9a32a8157010b588bf44103,6,7,24,31,9,2012-07-30 22:48:06,2012-07-30 21:52:46
4bf5115642b64851f9a32a8157010b588bf44103...7e02c7c56ac2a3dc8fce199b7b05a0bf51fa2417,2,1,1,2,2,2012-07-31 15:45:42,2012-07-31 15:45:42
7e02c7c56ac2a3dc8fce199b7b05a0bf51fa2417...383fb799ee66b2b50ba80ad1c3cc858cbfd783b7,3,3,3,6,3,2012-07-31 15:51:38,2012-07-31 15:51:38
383fb799ee66b2b50ba80ad1c3cc858cbfd783b7...3f584b5027a6875f4502ab4839e93f80afac95dd,1,7,1,8,2,2012-07-31 16:01:11,2012-07-31 16:01:11
3f584b5027a6875f4502ab4839e93f80afac95dd...8e4aae1ae5f9f023641ab4046dfee6c744e58e13,6,17,10,27,10,2012-07-31 17:46:38,2012-07-31 17:44:42
8e4aae1ae5f9f023641ab4046dfee6c744e58e13...e4bac3c4692834e6d0ca607aca229ddcae0ba2b7,2,83,17,100,4,2012-07-31 22:38:12,2012-07-31 22:38:12
e4bac3c4692834e6d0ca607aca229ddcae0ba2b7...78cd966aafe6617142a359c2d79a8cb46621fb77,1,8,3,11,4,2012-07-31 23:24:04,2012-07-31 23:24:04
78cd966aafe6617142a359c2d79a8cb46621fb77...5280f4e6983555e9ae111a6cb10765c7635e7e12,3,5,4,9,5,2012-08-01 02:39:06,2012-08-01 02:39:06
5280f4e6983555e9ae111a6cb10765c7635e7e12...5f4d2f9f6574fd41d9340ef80de0813bde80b76d,2,7,5,12,4,2012-08-01 02:49:19,2012-08-01 02:49:19
5f4d2f9f6574fd41d9340ef80de0813bde80b76d...8b67f72b9cba387f5e85ce869448d88cce23076f,1,3,2,5,2,2012-08-01 04:25:48,2012-08-01 04:25:48
8b67f72b9cba387f5e85ce869448d88cce23076f...aa549d323e02cf64a21b7ca3516f2e9ea686275f,1,0,1,1,1,2012-08-01 22:09:05,2012-08-01 22:09:05
aa549d323e02cf64a21b7ca3516f2e9ea686275f...eb87800ab631d19a7655f01ece130455b1cc976a,1,2,0,2,1,2012-08-06 16:34:17,2012-08-06 16:34:17
71d273583755c0a2b7f5d608f017f4586add51e4...507523c32f71056a106f85712fe2086fdb94fbd0,5,130,6,136,7,2012-07-21 14:23:49,2012-07-21 14:23:49
507523c32f71056a106f85712fe2086fdb94fbd0...6782245e51af13427cce7eb4dd4d3a4f202c9150,2,26,0,26,2,2012-07-21 14:24:13,2012-07-21 14:24:13
c8a1892e7187d8b9be81c9fbd5b2fbb172be1ee2...5d9cfa07ac62ad15ebb669b01e723a990450383e,2,27,2,29,3,2012-07-21 00:28:46,2012-07-20 15:52:53
6c8b458dccec1a4c81825d9c0777232540abac06...472fa08f4ed17f5ecbd5f61a32b39258b9b50813,1,1,1,2,1,2011-09-30 08:39:33,2011-09-30 08:31:41
6c8b458dccec1a4c81825d9c0777232540abac06...c36280a036625fd806785ee7376ea761a4bd977e,1,3,2,5,2,2011-09-30 04:28:22,2011-09-30 04:26:29
31bf5f38575fdffb27326a2b2bae88d096bb0071...97f40a0d5c100cacbeea113445a79a6622d1325a,1,2,0,2,1,2011-08-04 20:51:46,2011-08-04 20:51:46
31bf5f38575fdffb27326a2b2bae88d096bb0071...9d76b934f196ee36d39c3ae40e77b618156bc16a,2,11,11,22,8,2011-08-04 20:49:39,2011-08-04 20:49:39
e1bf24c86221fb412df52340ef2faa65c816c7bf...39cdf2728052a0817c12ec4348eef2c5d0825661,3,11,12,23,5,2011-07-06 10:48:23,2011-07-06 07:11:03
e1bf24c86221fb412df52340ef2faa65c816c7bf...a6e0f315f5f82babd669d93705059c24a6772084,1,32,0,32,2,2011-07-06 10:25:27,2011-05-29 14:46:24
a6e0f315f5f82babd669d93705059c24a6772084...e190da78f373511ca999d32f66115bbc75705abf,2,10,7,17,2,2011-07-06 10:25:27,2011-06-09 16:11:11
e190da78f373511ca999d32f66115bbc75705abf...42b3a460976757dbe7c4755fd60c3f542a9fb1e2,2,28,0,28,2,2011-07-06 10:25:27,2011-06-09 17:51:33
42b3a460976757dbe7c4755fd60c3f542a9fb1e2...7ea50f6077d0da28a471e8de2dc32dcdc994c5c6,1,53,0,53,2,2011-07-06 10:25:27,2011-06-09 17:56:42
7ea50f6077d0da28a471e8de2dc32dcdc994c5c6...0ffcf78a30377971d4928439ae387396b3922cbf,3,109,93,202,31,2011-07-06 10:25:27,2011-06-14 13:16:43
0ffcf78a30377971d4928439ae387396b3922cbf...1ee5fd903d00930aab08edecc6b409a34761cf7e,3,6,3,9,6,2011-07-06 10:25:27,2011-07-03 12:42:32
1ee5fd903d00930aab08edecc6b409a34761cf7e...1b938a58267f0a11240f0e7da7233607c6b78a2d,6,22,49,71,21,2011-07-06 10:25:27,2011-07-03 20:27:05
dbede305bfb434cdb90b6f7850ab9791bd94d739...c63aa494595a6d6e6d97cfa1bbc1741a0b2e0cc6,1,8,4,12,2,2011-07-07 00:54:07,2011-07-06 23:04:14
c63aa494595a6d6e6d97cfa1bbc1741a0b2e0cc6...de18f276683a5cf3d85d001f6521e52c8c802e60,11,424,85,509,20,2011-07-07 00:54:07,2011-07-06 23:46:20
de18f276683a5cf3d85d001f6521e52c8c802e60...bdcc46111c17b3a59d70ce197e44443f5ffba616,3,11,6,17,7,2011-07-07 10:12:34,2011-07-07 08:11:00
bdcc46111c17b3a59d70ce197e44443f5ffba616...c1e857484e69a495afeaa85243b1ba7efb1c147c,1,17,6,23,4,2011-07-07 10:23:47,2011-07-07 10:23:47
c1e857484e69a495afeaa85243b1ba7efb1c147c...417a581d9284021b1ce2edd4da7584b3e2379402,1,1,7,8,2,2011-07-07 13:36:58,2011-07-07 11:38:47
417a581d9284021b1ce2edd4da7584b3e2379402...2b5af615e1f4344f6073d0ddf3e83256d9a8d58f,3,82,4,86,10,2011-07-07 13:37:07,2011-07-07 11:47:45
2b5af615e1f4344f6073d0ddf3e83256d9a8d58f...da5b1e1c730d580ed5d414860c84b67122564528,1,17,4,21,3,2011-07-07 15:56:10,2011-07-07 15:56:10
9ce97782b412edb55b4bf8cb63e863d49745e09d...fe21d708b02c1b35c0ea717889ea633fe78eabaf,7,19,7,26,15,2015-03-03 23:29:37,2015-03-03 23:29:37
bdf0e734506b5b18234d48a0e7c6995aeda30b9d...770aca94bd209495ff28bbf5cbe9f282d02e7495,1,7,1,8,1,2015-03-10 19:02:02,2015-03-10 19:02:02
770aca94bd209495ff28bbf5cbe9f282d02e7495...70c735e19080a6f874807c1bc74a2e0ec6b72191,1,27,0,27,1,2015-03-10 20:49:24,2015-03-10 20:49:24
bdf0e734506b5b18234d48a0e7c6995aeda30b9d...9a823badbf8a4648344cf01a4a894dad0c0b4c68,1,0,1,1,1,2015-03-06 19:37:41,2015-03-06 19:37:34
9a823badbf8a4648344cf01a4a894dad0c0b4c68...0b3dd8fbed1ed2a15e633a37c158033ae7a639a2,1,97,0,97,1,2015-03-06 20:16:05,2015-03-06 20:16:05
0b3dd8fbed1ed2a15e633a37c158033ae7a639a2...6a2edc5a11471f8503888887ca6d4d0f24b1f995,1,1,1,2,1,2015-03-06 20:16:40,2015-03-06 20:16:40
bdf0e734506b5b18234d48a0e7c6995aeda30b9d...015d4b7b386ac799416f58b52549b2201dd4f2c3,2,2,2,4,2,2015-03-04 21:09:44,2015-03-04 20:48:54
015d4b7b386ac799416f58b52549b2201dd4f2c3...7eb7673406dea6ba9524af3987eb4a147b3b6718,2,2,2,4,2,2015-03-04 21:09:49,2015-03-04 21:01:20
7eb7673406dea6ba9524af3987eb4a147b3b6718...05e644dd7e0e5694805b25d315b6a0945dcbc4e8,1,1,1,2,1,2015-03-04 21:09:51,2015-03-04 21:01:39
bdf0e734506b5b18234d48a0e7c6995aeda30b9d...ac5fad2780a381a2d60fb00e4104c713faa301ec,2,14,2,16,3,2015-03-04 19:29:40,2015-03-03 18:53:26
ac5fad2780a381a2d60fb00e4104c713faa301ec...8008ab6a4158416d095212c9782fa1622ef994a5,1,4,0,4,1,2015-03-04 19:29:44,2015-03-04 01:03:07
8008ab6a4158416d095212c9782fa1622ef994a5...ba6c53b91b1d9c9dc49b7c0d8e8efbd9842c31dc,3,12,2,14,3,2015-03-04 19:29:44,2015-03-04 05:07:12
ba6c53b91b1d9c9dc49b7c0d8e8efbd9842c31dc...4c88fd7ce6a385fa313e93d4e1f594f29ccf1a36,2,28,4,32,4,2015-03-05 00:52:37,2015-03-04 19:31:24
4c88fd7ce6a385fa313e93d4e1f594f29ccf1a36...063532825cb9f736b7c2ed65c8f3269540df1ccc,1,5,1,6,1,2015-03-05 23:48:08,2015-03-05 23:48:08
063532825cb9f736b7c2ed65c8f3269540df1ccc...2326ea68b50756e44917e21142f22ac9baac63f6,1,4,0,4,1,2015-03-06 02:12:32,2015-03-06 00:14:17
2326ea68b50756e44917e21142f22ac9baac63f6...1a7ea63d228d42dc0ec1bed3a295d3dfe9392d74,2,3,2,5,2,2015-03-06 20:07:05,2015-03-06 01:11:17
1a7ea63d228d42dc0ec1bed3a295d3dfe9392d74...04c5a9c0838a9c44b55afb427169318ec4a44ec2,1,7,0,7,1,2015-03-06 20:07:05,2015-03-06 03:42:54
04c5a9c0838a9c44b55afb427169318ec4a44ec2...78c34af016dc69e7553e671ad3795ffb9dbb93ef,1,1,1,2,1,2015-03-06 20:07:54,2015-03-06 10:23:14
5ac2b7cb2ae67aa7a8a7b4d171c54ea69140516a...31bc6c044091c4d65f3a6fd7078beb260c210137,1,1,1,2,1,2015-03-03 12:25:40,2015-03-03 12:25:40
814d86bfe36825c44f43eb771b4640b428e3c05a...3a8b69d13da66a0555231c84e71df010129b5afb,1,3,3,6,2,2015-03-04 13:47:57,2015-02-26 16:47:07
3a8b69d13da66a0555231c84e71df010129b5afb...83fe60fa1bb7c8293585e6e8d6b12f3039910bbb,2,27,10,37,13,2015-03-04 13:48:46,2015-03-03 19:10:50
83fe60fa1bb7c8293585e6e8d6b12f3039910bbb...8e851c1e8c8f92da41d44e15e0c75777e4d1110e,1,11,0,11,1,2015-03-04 13:48:46,2015-03-03 21:41:59
12e1fff79d29e8eee1871316eaa58f2bfa3e67ff...e5e2c11d5dfd3964f6f96539693d2482cdf51f19,1,3,3,6,3,2015-03-13 16:52:07,2015-03-13 16:52:07
e5e2c11d5dfd3964f6f96539693d2482cdf51f19...a34692c41921c97fd75f6f19fc1549f8abe38c1e,1,1,0,1,1,2015-03-13 17:00:15,2015-03-13 17:00:15
a34692c41921c97fd75f6f19fc1549f8abe38c1e...dccf59ad385489eef31a2521440bc07e7cc98a5b,1,2,2,4,2,2015-03-13 17:28:07,2015-03-13 17:28:07
dccf59ad385489eef31a2521440bc07e7cc98a5b...7c63a33ffe1198b77b481974cd0e74e9ace1745c,1,7,0,7,1,2015-03-13 18:41:40,2015-03-13 18:41:40
d675982a15388d8c413acda139b4662062cf3286...118e6fdc8f4f484aa27e16d2e351145aae77bca2,1,1,1,2,1,2015-03-16 21:08:16,2015-03-16 21:08:16
d675982a15388d8c413acda139b4662062cf3286...fea24c5300f43ea4989c43f0057bb009d7e9653a,2,19,9,28,14,2015-03-16 19:54:53,2015-03-16 19:54:53
d675982a15388d8c413acda139b4662062cf3286...29e7ae5d81c1615fbcde78d7fbf44856059d9b99,1,7,0,7,1,2015-03-16 18:39:05,2015-03-16 18:39:05
29e7ae5d81c1615fbcde78d7fbf44856059d9b99...84d83b8e75a85b22c6003eaf9416b98fe6916d29,2,7,1,8,2,2015-03-16 18:43:46,2015-03-16 18:41:50
d675982a15388d8c413acda139b4662062cf3286...62d38a1ddb8081f8b46e7ff6e21ebeb0014162d6,6,122,10,132,19,2015-03-16 15:57:30,2015-03-06 22:51:40
62d38a1ddb8081f8b46e7ff6e21ebeb0014162d6...62dd4d71db1408ae03ca7d4d4d2c48f7874a41d9,2,45,0,45,3,2015-03-16 15:57:30,2015-03-06 23:06:02
62dd4d71db1408ae03ca7d4d4d2c48f7874a41d9...a5815a2afb7f6a0e86d52467b99d06d9bf01a9fb,5,66,16,82,20,2015-03-16 15:57:30,2015-03-06 23:30:40
a5815a2afb7f6a0e86d52467b99d06d9bf01a9fb...8acf058ff708582e9bbfe04e297d3b17a4d5c2e8,1,14,1,15,2,2015-03-16 15:58:47,2015-03-07 11:09:41
d675982a15388d8c413acda139b4662062cf3286...45a86bbfd028a545a71d3e1ea5518d467be8b5aa,3,38,4,42,9,2015-03-16 07:53:27,2015-03-09 15:02:52
45a86bbfd028a545a71d3e1ea5518d467be8b5aa...0f24cac2b926e4842f6890ee1712ac2d85cc020c,49,198,0,198,18,2015-03-16 07:53:27,2015-03-09 15:03:03
0f24cac2b926e4842f6890ee1712ac2d85cc020c...f29dde682866c293292ce405fcfef1511ced3f55,6,12,12,24,12,2015-03-16 07:53:27,2015-03-12 10:29:47
f29dde682866c293292ce405fcfef1511ced3f55...13de93631664cd6eec3afedabb7145d5562a3e01,5,23,35,58,16,2015-03-16 07:53:27,2015-03-12 10:36:09
13de93631664cd6eec3afedabb7145d5562a3e01...74c37c2a48756299306bb10e9e546c1627ca289f,2,12,0,12,2,2015-03-16 07:53:27,2015-03-12 11:16:09
74c37c2a48756299306bb10e9e546c1627ca289f...70b0f128c8f8a9f6bd2ec4ec0b326f8c03f9efb4,1,12,0,12,3,2015-03-17 14:34:36,2015-03-17 14:34:36
6810ba089a543a2407b1c8824dffa9b4e1d63975...f6b26e770ffae621408532c5b2c1aae4fa1c9e49,3,26,12,38,4,2012-07-29 18:50:58,2012-07-27 08:53:09
0aeae70553beb06d8df288232f1a1d345631f3cd...2031760c626711cc69b4d63ac9798ff333583ca0,2,37,8,45,7,2012-07-26 23:10:22,2012-07-26 23:10:22
2031760c626711cc69b4d63ac9798ff333583ca0...5dca201072724e4230141796d7c9f8836a277de8,32,401,147,548,113,2012-08-04 00:08:01,2012-08-04 00:08:01
5dca201072724e4230141796d7c9f8836a277de8...b0d376695e7d3f71fed97d9d08b60661faad7a5a,2,109,4,113,5,2012-08-04 00:24:59,2012-08-04 00:24:59
0aeae70553beb06d8df288232f1a1d345631f3cd...cb020f0d9936f221c6bd6f873994e8978657cd28,1,1,1,2,1,2012-07-26 20:36:43,2012-07-24 23:14:58
cb020f0d9936f221c6bd6f873994e8978657cd28...3ed4b5012bbdba844ae1ffdff884a1eb630e9884,2,33,0,33,4,2012-07-26 20:36:43,2012-07-24 23:32:31
3ed4b5012bbdba844ae1ffdff884a1eb630e9884...765015902ab346f4879acceaf8c8adf61f0e0ed5,2,62,0,62,2,2012-07-26 21:08:22,2012-07-24 23:33:15
765015902ab346f4879acceaf8c8adf61f0e0ed5...8689a69d097e1116e7fd2506b3cfd76b6e3b03bb,2,30,2,32,8,2012-07-26 21:08:24,2012-07-24 23:59:23
8689a69d097e1116e7fd2506b3cfd76b6e3b03bb...413d55638483678357ebcb8c26911cf944be95cc,2,22,4,26,4,2012-07-26 22:08:54,2012-07-25 00:10:35
413d55638483678357ebcb8c26911cf944be95cc...eff5b4992731cd01f1bc6a457e8d2f86428a8b55,3,34,1,35,6,2012-07-26 22:08:56,2012-07-25 00:34:12
2340b18102eedc73cbbfeca43f0b22e5d4119c38...e564e4969c51b585921e1b29627ec2f849e3ff9b,2,35,0,35,2,2012-08-01 18:02:32,2012-08-01 18:02:32
2340b18102eedc73cbbfeca43f0b22e5d4119c38...074841ec6ae2cc70391544ea76082bc4e2c4a1bf,3,125,0,125,3,2012-08-01 16:39:20,2012-08-01 15:49:19
51e1d8084641bd36416bf6f127b31d47d64cce69...d8d28e2ef69bf484639a5f2c5b16ac3007b90e78,1,2,4,6,1,2012-08-06 10:44:23,2012-08-06 10:44:23
d8d28e2ef69bf484639a5f2c5b16ac3007b90e78...81f73a872c914fd9fe163a88a7fed48cb0b1027d,1,6,0,6,2,2012-08-06 10:53:09,2012-08-06 10:53:09
81f73a872c914fd9fe163a88a7fed48cb0b1027d...e4607392b5cbdcaf6a5dc810ca77b5dd1afcb147,1,6,1,7,2,2012-08-06 18:06:05,2012-08-06 18:06:05
f98c32f3fea0d5532db2d5733418aa62648b9e93...a7e3bd9b0fe223a8d7773b7fa9cb7fd767e1de5e,10,16,0,16,6,2012-08-19 12:11:57,2012-08-16 09:53:24
a7e3bd9b0fe223a8d7773b7fa9cb7fd767e1de5e...66439b0b1a9e9a1145400bf905d427f404c64ea7,3,151,5,156,9,2012-08-19 12:11:59,2012-08-17 09:21:49
5d9cfa07ac62ad15ebb669b01e723a990450383e...0b956819f69793bddbbf92821c11d6bf784de400,1,4,0,4,4,2012-07-23 13:34:33,2012-07-21 17:11:42
5d9cfa07ac62ad15ebb669b01e723a990450383e...b3aaa7a7c887006d38b7262b73575d40f51beca5,5,55,6,61,12,2012-07-21 16:44:01,2012-07-21 15:52:51
550c9f31bb782f11483f146dd69b1ec7d2e530a3...358a15fd65cdc56ddc02b3ea261851f20c7ac618,1,1,1,2,1,2011-09-30 13:46:49,2011-09-30 13:43:58
a655cc3571206957991420089dc038bc5a04349b...2327a7cc100e38d176fe48dc3a2bf50045890be8,2,5,5,10,4,2011-08-07 16:44:08,2011-08-07 16:44:08
a655cc3571206957991420089dc038bc5a04349b...8c1d5d4839419e6dca0b3fd66f17864c5e7d60e3,1,1,9,10,2,2011-08-06 14:33:24,2011-08-06 09:23:04
8c1d5d4839419e6dca0b3fd66f17864c5e7d60e3...6e6ec54bebb41fd0c0f1171b04d13306937b9636,1,6,1,7,1,2011-08-06 14:33:24,2011-08-06 09:26:59
6e6ec54bebb41fd0c0f1171b04d13306937b9636...1b5078f6b186b92c237e2148a9008be8d372f675,1,4,0,4,2,2011-08-06 16:18:12,2011-08-06 11:58:16
a655cc3571206957991420089dc038bc5a04349b...2d3e417e5fdc000a7360b1f68ca04b6af7f602a6,1,2,2,4,2,2011-08-05 13:17:48,2011-08-05 13:11:25
b8e2db5f94d2a5d93bb4a328cbff5c26f65a5ebb...858dba58bf6eaaf1293ec0da03a02f95f8f2e0b9,7,45,48,93,31,2011-07-06 16:08:13,2011-07-06 16:08:13
858dba58bf6eaaf1293ec0da03a02f95f8f2e0b9...c68dee2a74fc6c5a2adab12857e9840254647a4b,1,6,8,14,5,2011-07-06 17:46:41,2011-07-06 17:46:41
da5b1e1c730d580ed5d414860c84b67122564528...6d4f090df63e06a01a0606c368aaa8e6c9104ade,1,35,3,38,7,2011-07-07 19:29:14,2011-07-07 15:49:55
6d4f090df63e06a01a0606c368aaa8e6c9104ade...73294339443011dce770c0d35a72b71113f0830b,1,6,2,8,1,2011-07-07 19:31:59,2011-07-07 19:24:12
da5b1e1c730d580ed5d414860c84b67122564528...d4cb0ee85c7bab69a666efe51c37105d1b16a126,1,1,3,4,3,2011-07-07 16:14:53,2011-07-07 16:14:53
fe21d708b02c1b35c0ea717889ea633fe78eabaf...e22ffb42097671f1c6737be4c8bbf2ff36a9e290,1,15,14,29,3,2015-03-11 18:51:12,2015-03-06 06:13:54
e22ffb42097671f1c6737be4c8bbf2ff36a9e290...1034f1b583e4bfe39d46243568aafb27e725f2fa,1,4,0,4,1,2015-03-11 18:51:12,2015-03-06 07:06:31
01c3b184d38e6a89a3dedeec735078d7bc6eaa5f...d578b45f3fc8a95a279aa7dcf1a3585d5d7c1eab,3,7,1,8,5,2015-03-08 15:50:27,2015-03-08 15:46:33
9bbc8f350b80a5a6e94651ec667cf9e5d545b317...08c29c445127c1b8b3320f248a30ecd428309535,1,1,1,2,1,2015-03-17 23:04:48,2015-03-17 23:04:48
9bbc8f350b80a5a6e94651ec667cf9e5d545b317...cdedef4061faa0d79604575c0cd75421210e8680,1,1,1,2,1,2015-03-17 21:03:51,2015-03-17 20:38:58
7568bdf4abf8c99c4bf0a87ff4ce6967c333e70a...523526e55ddd65ae42274f9a52f0327693a11941,1,6,2,8,2,2015-03-18 22:25:14,2015-03-18 22:25:14
50364dd892ae6726ff34e1842711e29d0f20c51d...64d01de8a7802ebec031f921496747bf09426df1,7,147,167,314,30,2012-07-30 18:25:10,2012-07-24 12:23:16
64d01de8a7802ebec031f921496747bf09426df1...114dc6e14c47ff574b4c97d4519782de3f9d28b2,4,85,26,111,22,2012-07-30 18:28:16,2012-07-24 15:10:57
114dc6e14c47ff574b4c97d4519782de3f9d28b2...b49c8f71aef574ce6606282a498627f5106220d5,10,193,317,510,66,2012-07-30 18:28:16,2012-07-24 17:03:22
b49c8f71aef574ce6606282a498627f5106220d5...ad4b5beb50dc484f86534dc127646eafb39d96fe,8,184,297,481,79,2012-07-30 18:28:16,2012-07-25 08:40:59
ad4b5beb50dc484f86534dc127646eafb39d96fe...ae789622e438e213d8a2059f7aeeeae931442c18,4,24,46,70,20,2012-07-30 18:28:16,2012-07-25 08:52:20
ae789622e438e213d8a2059f7aeeeae931442c18...8861d32f01bf29e37396ff5a9ef263399d52e73c,1,31,40,71,8,2012-07-30 18:28:16,2012-07-25 14:16:53
8861d32f01bf29e37396ff5a9ef263399d52e73c...3e3228b6d65c5b1f76ea08a23be2a457f904ff0a,1,0,13,13,1,2012-07-30 18:28:16,2012-07-25 14:30:58
3e3228b6d65c5b1f76ea08a23be2a457f904ff0a...0048372a9a631b9646b97f42eb8a61ba59dd3d99,3,6,6,12,6,2012-07-30 18:28:16,2012-07-26 23:09:06
581b6a8e90bbbc704f85906b8a32374fe1c0128c...c0c390255a70fb98f7ef9424c4ee53c471d7f22e,1,2,1,3,2,2012-07-27 00:37:15,2012-07-27 00:37:15
cf81ded61caa66267be5f27539decae2292ace9a...0c9eacf3d2c83256736a5bb2a240e73afd13d55f,4,52,17,69,12,2012-08-01 23:15:24,2012-08-01 23:15:24
e5f495012d9ec04bb46fc4b47c469df232c7f245...0ac349a9f3939f49ff78e12733e78a7b621afcc3,1,28,29,57,11,2012-08-01 23:22:51,2012-08-01 23:22:51
e4607392b5cbdcaf6a5dc810ca77b5dd1afcb147...2fe293b6fb29ab2df6421cca15d29d4035850e7a,1,13,36,49,9,2012-08-09 18:36:21,2012-08-09 18:36:21
e4607392b5cbdcaf6a5dc810ca77b5dd1afcb147...6ab6829097ff3356a3f7f7d0850a593d24096bf7,6,26,10,36,10,2012-08-09 17:39:09,2012-08-09 17:39:09
6ab6829097ff3356a3f7f7d0850a593d24096bf7...e60af90498c5be3fc132901009f7d8fc8bb0087f,5,19,6,25,8,2012-08-09 19:39:43,2012-08-09 19:39:43
e60af90498c5be3fc132901009f7d8fc8bb0087f...28e0068172942433ae304c9f965ee73588498f49,1,0,10,10,1,2012-08-09 19:39:56,2012-08-09 19:39:56
28e0068172942433ae304c9f965ee73588498f49...186c054d6556d6dfe8b9e17e82990603b4b33b5a,1,9,2,11,2,2012-08-09 19:47:29,2012-08-09 19:47:29
358a15fd65cdc56ddc02b3ea261851f20c7ac618...e724b058b2fd3d3b58291205bb7aeeccc55c21c4,1,9,5,14,3,2011-09-30 17:08:48,2011-09-30 17:08:48
e724b058b2fd3d3b58291205bb7aeeccc55c21c4...6d8d3f195c9377a1fdb3cbde32ec4a677d93b588,1,1,2,3,1,2011-09-30 17:41:29,2011-09-30 17:41:29
6d8d3f195c9377a1fdb3cbde32ec4a677d93b588...b9caa1859d9116959a1aafdb8dc3f6578d692459,1,3,0,3,1,2011-09-30 17:50:13,2011-09-30 17:50:13
b9caa1859d9116959a1aafdb8dc3f6578d692459...0e058e789b5a4a153f9fb5d14860fc38551f0c66,1,3,0,3,1,2011-10-02 19:53:04,2011-10-02 19:40:57
358a15fd65cdc56ddc02b3ea261851f20c7ac618...fafd471021218a425adb1506c0c942e8cd23f90c,5,80,69,149,52,2011-09-30 14:08:41,2011-09-30 14:08:06
fafd471021218a425adb1506c0c942e8cd23f90c...107e30e9c58facc3fdafefa7bb17ab6f04ddd2ec,1,2,2,4,2,2011-09-30 14:25:03,2011-09-30 14:25:03
a41bf612221d1b709af96b58209933653f3d1355...09df3f2c0f72dbcf206cc48f508919e03671a946,1,8,1,9,2,2011-08-08 18:15:40,2011-08-08 18:15:40
09df3f2c0f72dbcf206cc48f508919e03671a946...f6867e639a963726f381739314ea7a9d181c5aae,8,912,32,944,28,2011-08-08 23:56:28,2011-08-08 23:56:28
d102bbba46ea29e42eff2793fb46e14fbc597213...f0ab9fda8b566fffb704527b19556df3ef10738e,2,4,1,5,2,2011-07-09 00:40:15,2011-07-08 16:22:44
f0ab9fda8b566fffb704527b19556df3ef10738e...6727e30028b66ab0037dc25a268db18484603251,1,10,4,14,1,2011-07-09 00:40:16,2011-06-19 21:06:53
6727e30028b66ab0037dc25a268db18484603251...27df4275f2b3301f117f538929f51f0e86f9f716,6,506,0,506,9,2011-07-09 00:40:16,2011-06-28 12:13:12
27df4275f2b3301f117f538929f51f0e86f9f716...d483a911b89eaecb3af603efe2dceeb402cbf3ae,3,8,14,22,4,2011-07-09 00:40:16,2011-07-08 16:31:05
d483a911b89eaecb3af603efe2dceeb402cbf3ae...2fc78e700cc4684c1e5899d7a4a619da1e3e3679,4,42,12,54,11,2011-07-09 00:40:16,2011-07-08 21:01:37
2fc78e700cc4684c1e5899d7a4a619da1e3e3679...afeecf4f262b74270368ef8a70c582ea9d5a18e8,14,305,98,403,38,2011-07-09 00:40:16,2011-07-09 00:10:46
afeecf4f262b74270368ef8a70c582ea9d5a18e8...06c43821b94dcf9fa4f95f29c12f77d18a402690,9,25,76,101,20,2011-07-09 00:40:16,2011-07-09 00:37:16
61ccba0d5630eee7f88d34c872b71777df124c70...0ef54a63580171b341d85dee65c063bee31ba35f,2,6,0,6,2,2015-03-11 16:24:14,2015-03-11 16:16:39
d77a4f943e827e44c73acbdbb7462489feaeeedf...b5ab878f4c3ec6134c043a8c22d22290da1e3403,1,1,1,2,1,2015-03-08 21:09:50,2015-03-08 21:09:50
b5ab878f4c3ec6134c043a8c22d22290da1e3403...2461e0d20f46b6cfaf222759aca4a993ddc7b215,1,1,1,2,1,2015-03-08 21:10:02,2015-03-08 21:10:02
d7c81945b0619ac707ebd0fb007bf63c3bef3037...b523194d219a9dc062bad89bf8ba5dbeca7dab17,1,3,0,3,1,2015-03-10 20:31:26,2015-03-04 21:29:13
d7c81945b0619ac707ebd0fb007bf63c3bef3037...3e329861145bcd106023e73a3098f24b79e54c16,3,2,12,14,3,2015-03-10 20:08:34,2015-03-10 20:08:34
3e329861145bcd106023e73a3098f24b79e54c16...9a08b3196fecb48e71b9d6dc770f274f6450582d,1,0,4,4,1,2015-03-10 20:08:44,2015-03-10 20:08:44
d7b3dab958dc004d7ed1d338d04c67759d578748...c07d9c95f2ee277e12dc379c3054411cd3d2958e,8,8,0,8,8,2012-08-09 22:33:04,2012-08-09 22:33:04
c07d9c95f2ee277e12dc379c3054411cd3d2958e...738837bdaa258a716edecfc8dcdeb7210d73860b,1,5,0,5,2,2012-08-11 10:29:24,2012-08-11 10:29:24
5c27da1f4844eef2b4dfbabce526b6c5f2cd310b...c35881420d063c4393fef430720704f8004481a4,1,9,5,14,4,2012-08-21 03:24:20,2012-08-21 03:24:20
c35881420d063c4393fef430720704f8004481a4...b2be351aaddc6ba0b3a0f2cf4e09536a3b27e598,1,23,7,30,4,2012-08-21 17:55:39,2012-08-21 17:10:32
a70b3c7386aab50a3607731a0db1e69d01e11c73...dc8e3096d6cd4e8eb331acc36142207f4146ea57,1,1,0,1,1,2011-10-01 00:09:35,2011-10-01 00:09:35
a70b3c7386aab50a3607731a0db1e69d01e11c73...a95aeb489f32fa7e570ecad12fc236f0a0e237a3,1,10,10,20,5,2011-09-30 22:41:08,2011-09-30 14:55:05
a95aeb489f32fa7e570ecad12fc236f0a0e237a3...ccc9872d4df7ca6cd44f777c0600c4b1fab0f9e6,4,52,9,61,20,2011-09-30 22:41:08,2011-09-30 15:21:30
ccc9872d4df7ca6cd44f777c0600c4b1fab0f9e6...a28889198cf9565944aa0ff983459c6bf6eec311,1,11,6,17,4,2011-09-30 22:41:09,2011-09-30 16:35:33
a28889198cf9565944aa0ff983459c6bf6eec311...bad53552e539e58b76c4fcf4902686534f8a2678,4,20,8,28,7,2011-09-30 22:41:09,2011-09-30 21:48:27
f6867e639a963726f381739314ea7a9d181c5aae...d1f346931a7db577d24dca4f4ff5f81103bcc191,4,19,13,32,7,2011-08-09 20:34:54,2011-08-09 10:07:47
f6867e639a963726f381739314ea7a9d181c5aae...33e9ee8f12a2dc6f8583b5baf56681f142651aea,1,6,1,7,1,2011-08-09 10:55:51,2011-08-09 10:55:51
f6867e639a963726f381739314ea7a9d181c5aae...71e08b330cd5459797e1352290a61433265ef60a,1,1,1,2,1,2011-08-09 06:52:59,2011-08-09 06:50:13
f6867e639a963726f381739314ea7a9d181c5aae...ccd122fd0334a213572c97062786007000b5cdc1,1,3,3,6,3,2011-08-09 05:34:20,2011-07-22 10:31:51
c24ceffe61f15e0cb499de80b052a906ea5dc7cc...befae28f7bee2f0ca3445e0350121f1d6fa973cc,1,1,1,2,2,2011-08-10 19:19:21,2011-08-10 19:19:21
06c43821b94dcf9fa4f95f29c12f77d18a402690...38ce60f091c03ce3f7b1aa5fc2c4271b5a5a46ca,1,1,1,2,1,2011-07-09 06:36:37,2011-07-09 06:36:37
38ce60f091c03ce3f7b1aa5fc2c4271b5a5a46ca...ae2e4c6a06c44cd1b3a4b45f72e10deb81be45f5,3,3,3,6,3,2011-07-09 06:41:02,2011-07-09 06:41:02
c23f90053ddc10e7dbf0f99aabd5e13b0f317a42...b63b76e0b0b658dff328e0d9e109ce040830786c,7,13,4,17,7,2015-03-11 01:36:11,2014-10-12 09:42:31
b63b76e0b0b658dff328e0d9e109ce040830786c...04a36feff152fef2fd5f45c46b5cf25e84c7099f,3,265,1,266,10,2015-03-11 01:36:11,2014-10-11 13:48:29
04a36feff152fef2fd5f45c46b5cf25e84c7099f...e68b31a1a9f338908a4c72d48734b30c303f0901,1,10,32,42,8,2015-03-11 01:37:25,2015-03-04 19:57:52
738837bdaa258a716edecfc8dcdeb7210d73860b...5389005d9376e3155721a90f34612b5ca618c98d,1,1,1,2,1,2012-08-12 01:14:07,2012-08-12 01:14:07
b2be351aaddc6ba0b3a0f2cf4e09536a3b27e598...f004c4a8a78ec1ac109b0a0c78cdebe47a5df215,4,44,0,44,5,2012-08-22 00:26:39,2012-08-22 00:26:39
f004c4a8a78ec1ac109b0a0c78cdebe47a5df215...2fb4e9b3c5fb410164a32724e42a10d1841d02cc,4,146,9,155,5,2012-08-22 18:42:00,2012-08-22 18:42:00
b2be351aaddc6ba0b3a0f2cf4e09536a3b27e598...d854d59e317e1ace817f5845ec7abfba38bece69,1,10,0,10,1,2012-08-21 21:15:08,2012-08-17 19:15:32
d854d59e317e1ace817f5845ec7abfba38bece69...a7dbac0b2372f9dd1af01ae058ec764d3979991f,7,94,80,174,51,2012-08-21 21:15:10,2012-08-17 19:10:32
a7dbac0b2372f9dd1af01ae058ec764d3979991f...9d7ac675d06dab2e000ad32f9248631af0191f85,5,12,12,24,12,2012-08-21 21:15:13,2012-08-21 09:45:16
f77d4f7fc6ca80725ef25dc16e143d75f762b8cb...1e5b263577a11723c8cf4b5912b1d55d22cdeb2e,1,3,21,24,2,2011-10-01 10:58:17,2011-10-01 10:58:17
1e5b263577a11723c8cf4b5912b1d55d22cdeb2e...657ce4b5b6616967a17b7d4cc40c3ed02f01126e,1,13,13,26,7,2011-10-01 11:03:19,2011-10-01 10:58:55
657ce4b5b6616967a17b7d4cc40c3ed02f01126e...10063aeb41bdbdf8f887cbb93c8cc456b809aafb,1,11,16,27,8,2011-10-01 11:10:29,2011-10-01 11:10:29
10063aeb41bdbdf8f887cbb93c8cc456b809aafb...dfd0abda4de43b58b0c035b6bdb5ced236cfa081,1,9,7,16,7,2011-10-01 11:25:24,2011-10-01 11:25:24
dfd0abda4de43b58b0c035b6bdb5ced236cfa081...7ad994bb6061779d3893f23fea43262d8eb24f0c,1,1,1,2,1,2011-10-01 11:46:35,2011-10-01 11:41:16
7ad994bb6061779d3893f23fea43262d8eb24f0c...922bc2253212cacdd865a93605b92aad0350bc94,1,3,1,4,1,2011-10-01 12:34:51,2011-10-01 12:34:51
922bc2253212cacdd865a93605b92aad0350bc94...92be7908bd0fa344dc086d43685225ebd082eae2,1,3,0,3,1,2011-10-01 12:46:30,2011-10-01 12:46:30
92be7908bd0fa344dc086d43685225ebd082eae2...9ac581bf7fffaf809214fdd950bb62d242ee52fe,3,54,65,119,21,2011-10-01 17:58:26,2011-10-01 17:56:04
9ac581bf7fffaf809214fdd950bb62d242ee52fe...cd19ca9584bd01925e05e94e7f3bddae6880acda,2,2,2,4,2,2011-10-01 18:16:13,2011-10-01 18:16:13
24ce105b40caaed209936e6481ed2fa801f5fd7d...72d6a20be073c2854cca220c851c977171a5a465,1,2,2,4,2,2011-10-05 18:25:28,2011-10-05 17:59:34
72d6a20be073c2854cca220c851c977171a5a465...c060854ed5b42b76eda40e290851a315dbbaea04,7,596,73,669,23,2011-10-05 20:21:16,2011-10-04 19:11:51
c060854ed5b42b76eda40e290851a315dbbaea04...dd3fd68266353c626f435e4d629571bcc0c095c4,2,1,16,17,2,2011-10-05 20:44:27,2011-10-05 20:44:27
dd3fd68266353c626f435e4d629571bcc0c095c4...d3fb6a81c3333805c551c9d0995db67cb57f3ebf,1,2,2,4,1,2011-10-05 20:46:34,2011-10-05 20:46:34
d3fb6a81c3333805c551c9d0995db67cb57f3ebf...3eaf34f4c602b9e155e2f4c6ae26c9250ac37d50,1,2,2,4,2,2011-10-05 20:48:36,2011-10-05 20:48:36
3b76be1646af55f3c1d500160c21585d9dce4e61...b2e60e4eb5efc2d8ab78371ecd85e8a1f482134d,1,2,0,2,1,2011-08-10 22:25:37,2011-08-10 22:25:17
0448310f73c939a94a77c0b312f8c1555f611bd0...c2db984b1c0a7d16318be670a00b703b2f36aa1e,1,0,19,19,1,2011-07-09 11:27:08,2011-07-09 11:27:08
c2db984b1c0a7d16318be670a00b703b2f36aa1e...7361857c50a03dae4bba3f1f3d371db41012658f,1,4,0,4,1,2011-07-09 11:49:49,2011-07-09 02:44:15
7361857c50a03dae4bba3f1f3d371db41012658f...205166d27c3ab937f1a106de87d511223abc5059,6,196,0,196,7,2011-07-09 11:49:50,2011-06-22 22:19:46
205166d27c3ab937f1a106de87d511223abc5059...210940da841d7f796d8c98a9a1fe6efffbaf41c5,35,33,1,34,18,2011-07-09 11:49:50,2011-06-22 22:23:57
210940da841d7f796d8c98a9a1fe6efffbaf41c5...3af6b34a76cd953f485b8733981493b65becf59e,3,313,3,316,10,2011-07-09 11:49:50,2011-06-22 22:31:20
3af6b34a76cd953f485b8733981493b65becf59e...20361b2f6988c994a09c53ad563f847c200948ea,3,155,20,175,9,2011-07-09 11:49:50,2011-06-23 22:51:22
20361b2f6988c994a09c53ad563f847c200948ea...6b251490a811e6539488f83f506b2b0839de7ee1,15,9,2,11,8,2011-07-09 11:49:50,2011-06-24 22:35:06
6b251490a811e6539488f83f506b2b0839de7ee1...34dfea2774c10257eb13aae515d79ea2c224b911,2,41,8,49,6,2011-07-09 11:49:50,2011-06-25 00:36:53
34dfea2774c10257eb13aae515d79ea2c224b911...2b90cc26de1c6b71059a7fc43be32a3be7fb35b9,1,27,27,54,12,2011-07-09 11:49:50,2011-07-09 03:51:05
2b90cc26de1c6b71059a7fc43be32a3be7fb35b9...3b2a423c3fb9e434c427b819d3281ae9e277091d,2,28,2,30,5,2011-07-09 11:49:50,2011-07-09 04:08:52
3b2a423c3fb9e434c427b819d3281ae9e277091d...c52736fa5226141754918cabf55c22be9c2aee1b,5,92,79,171,21,2011-07-09 13:05:14,2011-07-09 13:05:14
c9d78bde943213f4c2594d1df175336573678b74...53ae12359d324890c4d30cc06bd2631ebdec43bb,1,2,4,6,1,2012-08-13 12:00:53,2012-08-13 12:00:53
53ae12359d324890c4d30cc06bd2631ebdec43bb...a6bf16878a121152f5bddf4d46f641e8f044d278,2,11,5,16,3,2012-08-13 12:07:47,2012-08-13 12:07:47
c9d78bde943213f4c2594d1df175336573678b74...39a60efd3915c7f2306978c7283313530fe8fada,1,1,1,2,1,2012-08-12 18:31:12,2012-08-12 14:06:11
c9d78bde943213f4c2594d1df175336573678b74...fdc637c4e266349b35ac4fb45a4e5aa63c5a78e0,2,66,4,70,3,2012-08-12 16:08:45,2012-08-12 16:08:45
fdc637c4e266349b35ac4fb45a4e5aa63c5a78e0...85a0e28b80e42a52247e16478b5f75475b00e56b,3,39,30,69,21,2012-08-14 17:50:58,2012-08-14 17:50:58
c9d78bde943213f4c2594d1df175336573678b74...a1ecddf01c5546b3f29cd546f4a469263cc6785e,3,23,4,27,3,2012-08-12 14:59:30,2012-08-12 14:59:30
a1ecddf01c5546b3f29cd546f4a469263cc6785e...616c1433b89d143a41035495a0a8504a19a72532,1,2,3,5,1,2012-08-12 18:53:58,2012-08-12 18:53:58
c9d78bde943213f4c2594d1df175336573678b74...d45ada03cf7635e7bb46807a91b7bc31442123f3,1,1,1,2,1,2012-08-12 13:31:42,2012-08-12 13:31:42
c9d78bde943213f4c2594d1df175336573678b74...22408f4d5f4204453ac592d4cbb878b5e2584ff7,1,2,2,4,2,2012-08-12 12:53:30,2012-08-12 12:53:30
c9d78bde943213f4c2594d1df175336573678b74...b90202bbdda36d586ac9ea1680b8faf93b58b2fe,1,1,1,2,1,2012-08-12 10:56:15,2012-08-12 10:56:15
cfda29e38260f19e77f1746c4f6f1c2cab453934...5fdc41e76591aebdbae3b49440bc2c8b2430718c,3,6,3,9,4,2012-08-22 20:57:57,2012-08-22 20:57:57
cd19ca9584bd01925e05e94e7f3bddae6880acda...4a3b18a62f99c836900c76d480ae33933098461c,2,9,7,16,5,2011-10-08 00:12:26,2011-10-03 20:26:06
4a3b18a62f99c836900c76d480ae33933098461c...517bda196e711b8fdf39735e74112503bbd8fcee,4,37,5,42,7,2011-10-08 00:28:02,2011-10-03 22:30:01
cd19ca9584bd01925e05e94e7f3bddae6880acda...599297fdc3eb003a40ee78489af28d968f76a835,1,4,1,5,1,2011-10-03 21:28:24,2011-10-03 21:12:43
cd19ca9584bd01925e05e94e7f3bddae6880acda...2401262778fa50cea30d1988cec45dcb82b50712,6,372,0,372,6,2011-10-03 00:32:32,2011-10-02 22:33:13
3eaf34f4c602b9e155e2f4c6ae26c9250ac37d50...9f861826be17d1f3d4e34df1f4b2d4bd9aaec3b0,1,8,2,10,5,2011-10-27 14:45:44,2011-10-27 14:45:44
3eaf34f4c602b9e155e2f4c6ae26c9250ac37d50...b2a2702da2d714c20aa90194d0b670cd84c30b73,1,1,1,2,1,2011-10-13 00:34:04,2011-10-12 05:05:12
3eaf34f4c602b9e155e2f4c6ae26c9250ac37d50...04f788023fd04e60a12c2a19787857c72b3817f4,7,10,4,14,8,2011-10-12 22:14:25,2011-08-10 03:49:12
04f788023fd04e60a12c2a19787857c72b3817f4...cf7b13f3c30595e3fe88103f9bfb653655a41177,7,28,4,32,8,2011-10-12 23:06:25,2011-08-11 21:05:55
cf7b13f3c30595e3fe88103f9bfb653655a41177...15b0bed2ba170526969348170d6f5e0d2ee16d7b,2,28,8,36,5,2011-10-12 23:09:16,2011-08-11 23:12:29
15b0bed2ba170526969348170d6f5e0d2ee16d7b...6f2856f308918455563413d012e4c4958e57ab40,2,9,1,10,2,2011-10-12 23:19:46,2011-10-05 22:17:37
3eaf34f4c602b9e155e2f4c6ae26c9250ac37d50...da2281c7c0c450922533f6ee637d7bf59abc0fa3,1,1,1,2,1,2011-10-09 16:35:42,2011-10-09 16:35:42
da2281c7c0c450922533f6ee637d7bf59abc0fa3...96fab093e3d7fa15e5085f36c51841fa6628cbe9,3,17,5,22,3,2011-10-09 16:39:52,2011-10-09 16:37:41
96fab093e3d7fa15e5085f36c51841fa6628cbe9...cf9bf6b7875357eb8059a4957c1d649bb9ff7e3c,3,44,1,45,3,2011-10-09 16:55:28,2011-10-09 16:45:23
3eaf34f4c602b9e155e2f4c6ae26c9250ac37d50...314f54eb0644a7af3f9fa88262b6c3b36104a3de,1,1,1,2,1,2011-10-09 03:29:57,2011-10-09 03:29:57
3eaf34f4c602b9e155e2f4c6ae26c9250ac37d50...681008c76810b4573296eb9536863ebe793ae6f0,4,113,66,179,21,2011-10-07 21:02:02,2011-10-07 20:31:08
681008c76810b4573296eb9536863ebe793ae6f0...1d33bf9d02bf0303fae5348e31fde3a33c3cb73c,1,26,0,26,1,2011-10-07 21:13:09,2011-10-07 20:57:44
b2e60e4eb5efc2d8ab78371ecd85e8a1f482134d...5ae2f0c0135758020c46091491068a009e8ac10b,4,48,37,85,23,2011-08-12 23:24:19,2011-08-12 23:24:19
b2e60e4eb5efc2d8ab78371ecd85e8a1f482134d...4fd486e0c226963cffe069b2fbb3127eb0354775,1,2,2,4,2,2011-08-12 21:57:44,2011-08-12 21:57:44
c52736fa5226141754918cabf55c22be9c2aee1b...b21fb8496fc62757c3662e25f08c0ecad175f9d2,1,1,1,2,1,2011-07-09 13:36:18,2011-07-09 13:36:18
85f28ba89178f2e7e1613bac81831dea24f32418...fc1826d149faee191adf38d6a91d5a9fa7c8cddc,1,1,1,2,1,2012-08-14 18:54:13,2012-08-14 18:54:13
5fdc41e76591aebdbae3b49440bc2c8b2430718c...c9de8611d6a3e77757a714cdf6acf46178b1d622,2,9,3,12,2,2012-08-25 16:56:20,2012-08-23 19:29:09
5fdc41e76591aebdbae3b49440bc2c8b2430718c...662880ca60e4d1662bb10648522242ac54797720,6,529,141,670,50,2012-08-22 23:06:22,2012-07-26 23:07:01
662880ca60e4d1662bb10648522242ac54797720...ca1b6e54095a7e28d468a832f143025feae6cd4f,29,1481,184,1665,91,2012-08-22 23:07:19,2012-08-01 00:02:54
ca1b6e54095a7e28d468a832f143025feae6cd4f...0e26202cd587f45edc96966ed327e93354e2102e,1,4,1,5,2,2012-08-22 23:07:19,2012-08-01 21:30:08
0e26202cd587f45edc96966ed327e93354e2102e...b769e936d0118b7c3870ffc082b44254164bfedd,1,7,4,11,5,2012-08-22 23:07:19,2012-08-01 21:49:47
b769e936d0118b7c3870ffc082b44254164bfedd...85bd17462662905dfdf9247b262480280a616ad4,7,24,56,80,23,2012-08-22 23:16:42,2012-08-22 23:03:35
85bd17462662905dfdf9247b262480280a616ad4...e9ca852e4d77e1b1723a2dceddfa2037677e2fb4,12,30,43,73,23,2012-08-23 16:20:17,2012-08-23 16:20:17
6aac5afb6d74a016a4066612d99c5a58dea46b40...8f9be3167719e86f9f4a087ea4edd4ac168853f0,1,2,1,3,2,2011-10-09 19:49:10,2011-10-09 19:49:10
5c3d5fb0182e8c5307dedf9af281fe367a30a16e...a41e9f131e0f62e2c45ed971a11ea557fe3a5ff8,1,0,1,1,1,2011-10-13 20:48:07,2011-10-13 20:48:07
a41e9f131e0f62e2c45ed971a11ea557fe3a5ff8...b3f993e28738b305c00315bd91a57f95a4bb552a,12,4,2,6,4,2011-10-13 20:48:58,2011-10-09 11:13:49
b3f993e28738b305c00315bd91a57f95a4bb552a...a6c0e4d2028966c73525de020d4e500f272dfadf,1,7,8,15,5,2011-10-13 20:49:05,2011-10-11 12:42:48
a6c0e4d2028966c73525de020d4e500f272dfadf...34aff0100248dbf349240fd8edff4cc440062b40,5,116,68,184,21,2011-10-13 21:15:11,2011-10-12 12:06:23
34aff0100248dbf349240fd8edff4cc440062b40...3fa735ca3b8d8f855e43be44b5f96e59909d50e1,5,159,10,169,11,2011-10-13 21:30:07,2011-10-13 21:17:19
92e2081f40d9373e663d362663b51ae943c8801b...502dd2dadbf9dde04943e53de621a30f31aa402b,1,5,6,11,7,2011-10-12 19:09:56,2011-10-12 19:09:56
502dd2dadbf9dde04943e53de621a30f31aa402b...eb07a4d1dd5b6ec2ee60566d0ec2aa705bf37f4c,1,47,46,93,20,2011-10-12 19:33:18,2011-09-12 13:25:45
eb07a4d1dd5b6ec2ee60566d0ec2aa705bf37f4c...34bfb4b0d40b17e51d25df726a80226ccbc8dec7,5,72,26,98,33,2011-10-12 19:33:18,2011-09-13 22:54:45
34bfb4b0d40b17e51d25df726a80226ccbc8dec7...747bf5f14c8fa3d26cfcdc093ea9c1c553ed09c6,1,92,0,92,5,2011-10-12 19:33:18,2011-09-13 21:28:42
747bf5f14c8fa3d26cfcdc093ea9c1c553ed09c6...1636ba5a0dc5c6c050a851951aa499572f820da0,5,19,68,87,15,2011-10-12 19:33:18,2011-09-18 18:07:49
1636ba5a0dc5c6c050a851951aa499572f820da0...3313a05a47529be9ce9cfa3dd98f613b53689902,1,62,44,106,9,2011-10-12 19:33:19,2011-09-18 19:11:45
3313a05a47529be9ce9cfa3dd98f613b53689902...cbb2feded6b67280bda5c8081e05ce8725e2d065,1,40,14,54,10,2011-10-12 19:33:19,2011-09-26 22:34:52
cbb2feded6b67280bda5c8081e05ce8725e2d065...f9613325f1e981c918e63020dee2a843b3c8ab75,2,109,11,120,10,2011-10-12 19:33:19,2011-10-04 22:42:27
f9613325f1e981c918e63020dee2a843b3c8ab75...65c86048cb63813453af184118e86947b5a9b161,2,87,21,108,15,2011-10-12 19:33:19,2011-10-04 23:28:16
65c86048cb63813453af184118e86947b5a9b161...e5e92c1fab2034ab549e0b67e566b8ceac649d10,2,58,27,85,16,2011-10-12 19:33:19,2011-10-05 14:57:34
e5e92c1fab2034ab549e0b67e566b8ceac649d10...51760bc13d2699b34b0015b406242107cfa68b33,4,17,54,71,24,2011-10-12 19:33:19,2011-10-05 16:11:22
51760bc13d2699b34b0015b406242107cfa68b33...2c982daa2eec64b80c7940bfe1142295bd72edd8,2,63,0,63,4,2011-10-12 19:33:19,2011-10-05 18:09:49
2c982daa2eec64b80c7940bfe1142295bd72edd8...fc3e3c5577d177279b928ac23d3925de29a41056,1,38,83,121,29,2011-10-12 19:33:19,2011-10-05 18:12:12
fc3e3c5577d177279b928ac23d3925de29a41056...03e4833b09cf610de32d668a543d43b60d4c4ffd,1,1,1,2,1,2011-10-12 19:33:19,2011-10-05 18:17:21
03e4833b09cf610de32d668a543d43b60d4c4ffd...546a3c8f9e87c632ea1bc44c32457ec7adee0741,1,123,12,135,13,2011-10-12 19:33:19,2011-10-05 22:10:11
546a3c8f9e87c632ea1bc44c32457ec7adee0741...8c2528748d6e0671a61ce729318a9f4e44f51111,2,17,2,19,11,2011-10-12 19:33:19,2011-10-05 22:51:32
8c2528748d6e0671a61ce729318a9f4e44f51111...dfafb03bdce0fd83e374a901ccbc43af02aec88b,4,2,2,4,2,2011-10-12 19:34:25,2011-10-06 22:44:41
dfafb03bdce0fd83e374a901ccbc43af02aec88b...3707b331e254ed27952f9952123af1078b4c129c,1,14,17,31,15,2011-10-12 19:34:25,2011-10-08 00:44:31
283573fdb50c0beea27fd8ff72b9708e2306728e...a6bbb8cab645af37aec62eef2e607c9a3185c827,1,3,0,3,2,2011-08-13 08:56:33,2011-08-13 08:56:33
d37ba6720de36b5121f4e978f65ab5703d12523f...f27f29b1005d96d1a7adc8702e9958df3965d818,2,4,4,8,4,2011-07-11 00:59:17,2011-07-09 13:13:32
f27f29b1005d96d1a7adc8702e9958df3965d818...bdd18829ad6179947565dcb5b267163c37a045c9,7,114,7,121,18,2011-07-11 00:59:18,2011-07-11 00:58:00
bdd18829ad6179947565dcb5b267163c37a045c9...5f35d0ce771d8d16bb1180ea0d4362a8836b4a99,1,0,3,3,1,2011-07-11 01:00:34,2011-07-09 12:53:00
d37ba6720de36b5121f4e978f65ab5703d12523f...7757be33a249097e6f6a5d9c0065aff5e083ad2e,8,64,48,112,29,2011-07-10 17:17:07,2011-07-10 05:48:52
fc1826d149faee191adf38d6a91d5a9fa7c8cddc...1a0537e45099054a50e148e5af915a32928705b4,1,1,1,2,1,2012-08-14 22:08:38,2012-08-14 22:08:38
1a0537e45099054a50e148e5af915a32928705b4...5fd17fc2172306dd282b5ac8a040343b8637f252,1,14,12,26,6,2012-08-15 15:50:02,2012-08-15 15:50:02
5fd17fc2172306dd282b5ac8a040343b8637f252...e0db9f1117197deb9d948976f901d20d04a5d1c4,1,2,0,2,1,2012-08-15 15:54:05,2012-08-15 15:54:05
8238401ccb9f7018c927866896bea583d351ad2a...7a57ae5478604df9a255a3067000336bc6bfd692,1,5,3,8,1,2012-08-25 21:31:29,2012-08-25 21:31:29
7a57ae5478604df9a255a3067000336bc6bfd692...cc1d85d1da7fd0e51ea0e3ddfbe516c043c95731,1,1,1,2,1,2012-08-25 21:32:19,2012-08-25 21:32:19
cc1d85d1da7fd0e51ea0e3ddfbe516c043c95731...2b175ca972f2531e5ef46d24abeb831d90033a33,3,4,19,23,5,2012-08-25 22:42:28,2012-08-25 22:35:52
c920e162325d0f9acba46a19c4619e6bfa17707e...2eb4edf5f269f60b188ff72d350ee321d1cbaf79,4,37,21,58,23,2012-08-24 17:48:48,2012-08-24 17:48:48
c920e162325d0f9acba46a19c4619e6bfa17707e...bffa852f89268390d6bc3e6f99f5f0cccdc88f63,4,18,3,21,8,2012-08-24 17:01:10,2012-07-13 10:01:11
bffa852f89268390d6bc3e6f99f5f0cccdc88f63...e03e71da56608f60770eb80767dcd94e698cdcae,9,156,13,169,23,2012-08-24 18:29:39,2012-05-14 15:54:25
e03e71da56608f60770eb80767dcd94e698cdcae...0a1db746fbcaf09681e446250f75581cc8f8fd05,1,13,1,14,4,2012-08-24 18:29:45,2012-05-14 18:46:30
8f9be3167719e86f9f4a087ea4edd4ac168853f0...dcd62cb2e9fb9370f5eb17b9984f6dcf8d2598c2,1,5,1,6,2,2011-10-11 15:57:00,2011-10-11 14:11:40
dcd62cb2e9fb9370f5eb17b9984f6dcf8d2598c2...5b216d1a6fc2968fa9f6524663b7647cb1c2a3a4,1,2,2,4,2,2011-10-11 16:08:54,2011-10-11 16:08:54
5b216d1a6fc2968fa9f6524663b7647cb1c2a3a4...5cb7a1addfa9015f834e5a95d88c0e7a40920d30,1,4,0,4,1,2011-10-11 16:14:13,2011-10-11 16:12:36
4849dbb8b9273337593aa3f06dc11c28137fa13d...da37654d04617b4dacce6e7a4796007d2854624d,2,84,2,86,4,2011-10-28 05:33:31,2011-10-28 05:33:31
da37654d04617b4dacce6e7a4796007d2854624d...3286c408eccb18c525ca123383f3ebf5097441bc,58,291,289,580,230,2011-10-29 02:02:36,2011-10-28 21:51:13
b7e1dd1603def3bce370d7d3fa03778999623033...7fcddeb68b5135c1be1482c898f3155e242304a6,1,2,2,4,2,2011-10-14 00:44:14,2011-10-14 00:36:43
7fcddeb68b5135c1be1482c898f3155e242304a6...d42eff03443090dddc128ca50c45eaa3b46f3aa9,1,1,1,2,1,2011-10-14 01:05:03,2011-10-14 01:05:03
bae88c0dc6b940cd661364499019ad00f7ba1fd3...e7be57a98bea9c56c88d8c3de78400c13909eede,4,22,17,39,14,2011-08-15 19:14:51,2011-08-15 16:56:27
e7be57a98bea9c56c88d8c3de78400c13909eede...bcb080b00abfd6bf10ba74d1bc4546d2386d4439,1,5,1,6,3,2011-08-16 08:17:26,2011-08-16 07:57:43
283eeefb0988f2981c846773e715b7e67a559b39...f6e4a98a957a1246afce3e5226ee37a50da78b9a,2,4,10,14,5,2011-07-11 11:05:13,2011-07-11 11:04:36
1a10fded40875f986164b80c6efd414cd1507cb8...8cef828d8d115c1f98678c13721fee59ca4540b7,4,44,14,58,31,2012-08-20 10:02:52,2012-08-18 20:11:49
2b175ca972f2531e5ef46d24abeb831d90033a33...d8057a5b0ed644b1f72a4eb80f82da7ce8977958,6,53,74,127,23,2012-08-27 18:53:59,2012-08-27 18:53:59
2b175ca972f2531e5ef46d24abeb831d90033a33...c49d328cf433da1bf25a97e3935069308daf7f8d,2,11,0,11,3,2012-08-27 13:59:13,2012-08-27 13:59:13
2b175ca972f2531e5ef46d24abeb831d90033a33...4e323ef0a822f376dcc8a0716cc7af26f0582a09,2,22,6,28,4,2012-08-27 09:52:32,2012-08-27 08:51:01
2b175ca972f2531e5ef46d24abeb831d90033a33...17f7bde2f730723f6edae66b454afba481595bb0,1,2,0,2,1,2012-08-27 01:00:10,2012-08-23 22:47:08
17f7bde2f730723f6edae66b454afba481595bb0...1c947daa80dfa442acbf8119530a3dcbf5af00c5,5,51,56,107,26,2012-08-27 01:00:10,2012-08-23 22:47:29
2eb4edf5f269f60b188ff72d350ee321d1cbaf79...1168410426293aef8ce33becb277ff225595e183,2,27,8,35,4,2012-08-24 20:41:45,2012-08-24 20:41:45
2eb4edf5f269f60b188ff72d350ee321d1cbaf79...decff7b4c13939e5f00d51aea4176fc543d73ede,270,1007,0,1007,171,2012-08-24 18:00:26,2012-07-18 21:30:15
decff7b4c13939e5f00d51aea4176fc543d73ede...aa13bf05c84f10f364ce35c5d4f989337b36e043,13,2292,219,2511,105,2012-08-24 18:00:26,2012-08-02 20:00:58
aa13bf05c84f10f364ce35c5d4f989337b36e043...0c8858de8c82bae3fd88513724689a07d231da7e,6,226,128,354,52,2012-08-24 18:00:27,2012-08-03 21:28:07
0c8858de8c82bae3fd88513724689a07d231da7e...5f4a61aea834fe25ce1596bc9c0e0b5e563aa98b,10,606,316,922,96,2012-08-24 18:00:27,2012-08-10 02:43:25
5f4a61aea834fe25ce1596bc9c0e0b5e563aa98b...97a17e4e9fa5cafa531ff79cb88a9ee5c224a613,4,16,7,23,9,2012-08-24 19:19:22,2012-08-24 19:19:22
3286c408eccb18c525ca123383f3ebf5097441bc...d1db74bf57999ac336fddadf2f9ee7c24961268f,1,22,20,42,1,2011-10-29 20:05:56,2011-10-29 15:40:04
d1db74bf57999ac336fddadf2f9ee7c24961268f...a1bd78ea29caa05cf44e57f525d5b11fd9e2dc3a,10,9,3,12,7,2011-10-29 20:05:56,2011-10-29 19:29:31
a1bd78ea29caa05cf44e57f525d5b11fd9e2dc3a...e3baa3ccf3b606517b3819913228c030854b8d77,1,26,7,33,8,2011-10-29 20:42:37,2011-10-29 15:45:01
1776f5ab495a5748e28685da1f6da1c298cb0273...252840a59f09a62bd358c90593724af36a703161,1,3,4,7,1,2011-10-14 23:20:23,2011-08-11 22:18:04
1776f5ab495a5748e28685da1f6da1c298cb0273...33127043b3ef8dd8dd695ba3613eaa104a80a56b,9,24,24,48,24,2011-10-14 22:57:15,2011-10-14 21:18:02
33127043b3ef8dd8dd695ba3613eaa104a80a56b...ce8cd006ce3adcd012a38401b8a7555ba3307b3f,22,103,52,155,62,2011-10-14 23:04:34,2011-09-07 22:32:44
ce8cd006ce3adcd012a38401b8a7555ba3307b3f...01ad7b3a9ec8f5e465f94c2704e1e96b84f941c7,31,73,34,107,49,2011-10-14 23:07:47,2011-09-06 22:48:45
3a97bff3dc9361018ccd96f6f6fa077b7f70637c...50a8fd03673f270a2c1ce5159287efeecfbf1217,1,2,2,4,2,2011-08-16 16:16:44,2011-08-16 16:16:44
9b6fccc9ba6107870daa4ac71db06e83e2a3f6cc...eb1fd1d0cb092942e4818baea7152be5c042ba05,1,0,0,0,0,2011-07-11 17:42:21,2011-07-11 17:28:07
eb1fd1d0cb092942e4818baea7152be5c042ba05...bfbb55628bee994b649117e787bc40749f4c5181,3,163,26,189,14,2011-07-11 17:42:21,2011-07-11 14:30:46
bfbb55628bee994b649117e787bc40749f4c5181...b08683ffb2146bb164108a525a9f0a9972f7ed8b,3,6,6,12,6,2011-07-12 00:38:20,2011-07-12 00:38:20
7a3fc9fb175849a7ae55c88b4e0b3a5af58f5a22...0e9f2fcef6955a9c15f216ad78eec538cc97a8f3,1,1,0,1,1,2012-09-06 09:35:09,2012-09-06 09:35:09
62eafd0620eff3d7ca3659a3f4a4808488f0b2c3...0d5dce268d47c4ecfb3f8cdda3379cd606630105,1,6,2,8,3,2012-08-28 13:39:06,2012-08-28 12:15:32
1168410426293aef8ce33becb277ff225595e183...d1445b7528f17910b9d4301617b8129ee30d1c3e,1,3,25,28,3,2012-08-27 13:38:38,2012-08-27 13:24:27
1168410426293aef8ce33becb277ff225595e183...2e0c881670678d18b912b57dd5825fec00167aad,3,349,153,502,50,2012-08-27 06:41:26,2012-08-26 20:08:22
1168410426293aef8ce33becb277ff225595e183...07c06f7a83640e11d6be13a87f02e986ecc6e4b3,1,1,0,1,1,2012-08-24 21:24:33,2012-08-24 21:24:33
d3104fa0a3f3711729b45346e475354440d46cc3...a46ec45746f965f2895098e058979225d92d66e5,5,360,174,534,123,2011-11-06 02:15:19,2011-08-10 14:19:42
a46ec45746f965f2895098e058979225d92d66e5...4fd89fa0392967fabb905c7f4001cd4834f11dbd,1,32,0,32,2,2011-11-06 02:15:22,2011-07-26 09:17:32
4fd89fa0392967fabb905c7f4001cd4834f11dbd...75abd2b92452782a9e6cee6ed5041339bd00c5bf,9,165,18,183,73,2011-11-06 02:15:26,2011-08-11 17:38:13
75abd2b92452782a9e6cee6ed5041339bd00c5bf...549bbd1342499c2659388a483f1a266dfcedab85,1,35,37,72,17,2011-11-06 02:15:30,2011-08-13 16:14:39
549bbd1342499c2659388a483f1a266dfcedab85...d4a0b124d00c70933d7c6ac9065c401cc2d70b2e,5,671,857,1528,285,2011-11-06 02:15:34,2011-10-31 04:58:33
d4a0b124d00c70933d7c6ac9065c401cc2d70b2e...62dd6d1637e40f9fa16005ef447d4fc6f8fb25e8,1,20,10,30,6,2011-11-06 02:15:38,2011-11-06 01:52:43
d3104fa0a3f3711729b45346e475354440d46cc3...54ccc71786cf5a0fee69e7ec173e62abd4a12af5,1,2,2,4,2,2011-11-05 23:01:32,2011-11-05 23:01:32
54ccc71786cf5a0fee69e7ec173e62abd4a12af5...faeebd06e41f2711ad4b3c99f3f10e5778c8a5cd,1,1,1,2,1,2011-11-07 01:35:35,2011-11-07 01:35:35
faeebd06e41f2711ad4b3c99f3f10e5778c8a5cd...983562e47537eef4c9d7706d036245a1896dd5f2,1,1,1,2,1,2011-11-07 01:43:44,2011-11-07 01:43:44
983562e47537eef4c9d7706d036245a1896dd5f2...349532d0b1fd4eb94b398616602674ff516f6d76,1,2,1,3,2,2011-11-07 01:44:29,2011-11-07 01:44:29
349532d0b1fd4eb94b398616602674ff516f6d76...0b142c9cb207444e22c4136c64c4d7bcecb2ccef,1,1,0,1,1,2011-11-07 02:07:27,2011-11-07 02:07:27
d3104fa0a3f3711729b45346e475354440d46cc3...ec9079443c874fe1711acefb22b3fc606484c786,1,4,2,6,2,2011-10-30 12:48:00,2011-10-30 12:48:00
a014a083d9010e7f1ad0a00e6b48b75d6616edde...5fa1bed0f7da8959f561c49fba6975812f80546a,1,12,5,17,5,2011-10-15 21:25:48,2011-10-15 21:09:05
ec5b158996e8a4a32e30ea146f62d7b5f5a9260f...7fade6c63a3b1bb5cab1a312d81b2b1d4b3321f2,1,0,1,1,1,2011-08-17 10:14:12,2011-08-17 10:14:12
7fade6c63a3b1bb5cab1a312d81b2b1d4b3321f2...b6817692a6d1eb617bda96a64c66c8e02988fc12,1,2,1,3,1,2011-08-17 10:14:47,2011-08-17 10:14:47
b6817692a6d1eb617bda96a64c66c8e02988fc12...5a0659fe3ba020181a07464c4c92b06a5c21b43a,1,15,6,21,8,2011-08-17 12:36:53,2011-08-17 12:05:41
5a0659fe3ba020181a07464c4c92b06a5c21b43a...31e5909214cbfba0c43143288a77f2fc067004f7,1,4,2,6,3,2011-08-17 13:24:48,2011-08-17 13:20:43
31e5909214cbfba0c43143288a77f2fc067004f7...e7a3b3171bcec5d1ec8b2d94e0c7d9c66468a7f2,1,21,8,29,12,2011-08-17 14:37:53,2011-08-17 13:50:19
e7a3b3171bcec5d1ec8b2d94e0c7d9c66468a7f2...d4958b88483a0ac040e3c15392566ae0d398e2da,1,0,2,2,1,2011-08-17 14:37:59,2011-08-17 13:58:03
b08683ffb2146bb164108a525a9f0a9972f7ed8b...55e1609b2f6208ef7f4cc673e20f540b25d4bd93,1,2,0,2,2,2011-07-12 16:19:56,2011-07-12 16:10:31
55e1609b2f6208ef7f4cc673e20f540b25d4bd93...75c2002f974a625f242fc69ac325a780e093b99c,1,7,1,8,6,2011-07-12 16:25:31,2011-07-12 16:08:46
b08683ffb2146bb164108a525a9f0a9972f7ed8b...ca6f203c595e68ea5bc868cd2e749aa1d30f9785,1,3,1,4,2,2011-07-12 15:59:22,2011-07-12 15:53:22
0e9f2fcef6955a9c15f216ad78eec538cc97a8f3...17b06f4d47bfd9fae8073c85d71751df94e50050,3,60,0,60,11,2012-09-07 22:49:08,2012-09-07 22:49:08
0e9f2fcef6955a9c15f216ad78eec538cc97a8f3...52462e1ccecdea86cceae9d25bf343265831bbaf,1,27,0,27,1,2012-09-06 22:24:03,2012-05-13 08:11:13
52462e1ccecdea86cceae9d25bf343265831bbaf...f8e2cc9a0a59dc87f8e8842b6818f3df180fffda,2,22,1,23,2,2012-09-06 22:24:03,2012-08-31 22:53:47
f8e2cc9a0a59dc87f8e8842b6818f3df180fffda...8f9b6a132b358b23b518197240184e2f08e0a913,1,34,24,58,4,2012-09-06 22:34:02,2012-08-31 23:39:30
8f9b6a132b358b23b518197240184e2f08e0a913...60b9d3fcef04a6beb0ad4df225ada058afabf0b9,8,260,106,366,41,2012-09-06 22:34:02,2012-09-05 22:00:40
60b9d3fcef04a6beb0ad4df225ada058afabf0b9...3a3deea80bb6555706f58006bdee8e878b0fd651,1,11,2,13,4,2012-09-06 22:45:50,2012-09-06 22:45:50
3a3deea80bb6555706f58006bdee8e878b0fd651...b36effa22e015871948daeea250b4996c663e11a,4,39,33,72,14,2012-09-10 16:59:14,2012-09-10 16:59:14
b36effa22e015871948daeea250b4996c663e11a...e597b1890ebd43e398d84b7bf4ca366365b24d27,2,91,66,157,37,2012-09-10 18:49:12,2012-09-10 18:49:12
e597b1890ebd43e398d84b7bf4ca366365b24d27...c6ac28fdc57d04a9a5eba129cfd267c7adde43b3,6,135,72,207,17,2012-09-10 19:24:05,2012-09-10 19:24:05
c6ac28fdc57d04a9a5eba129cfd267c7adde43b3...1f35e89dbf6e0be8952cc4324a45fd600be5ca05,5,153,42,195,23,2012-09-11 19:03:33,2012-09-11 19:03:33
1f35e89dbf6e0be8952cc4324a45fd600be5ca05...c859184bb459d9801a394dc44f5b0b0e55453263,5,32,29,61,13,2012-09-11 21:05:24,2012-09-11 21:05:24
0e9f2fcef6955a9c15f216ad78eec538cc97a8f3...316659489a97e8e93f88dd3610320c8ae5b35e4a,3,158,0,158,3,2012-09-06 16:40:05,2012-08-24 19:30:45
316659489a97e8e93f88dd3610320c8ae5b35e4a...bb2d305c20d62b10b39d95916d1a172057c26d65,1,1,0,1,1,2012-09-06 16:40:06,2012-08-22 08:47:25
bb2d305c20d62b10b39d95916d1a172057c26d65...ced8d1420a76c13796d951203c2b35540a49b454,5,24,9,33,6,2012-09-06 16:40:06,2012-08-22 09:30:55
ced8d1420a76c13796d951203c2b35540a49b454...35d2e449bd6291c97bb8075f5976104c9ad57236,2,0,13,13,4,2012-09-06 16:40:07,2012-08-20 09:26:02
35d2e449bd6291c97bb8075f5976104c9ad57236...746642a6b3bb31e6d6adf67298044f9864e1eb42,1,12,10,22,4,2012-09-06 16:40:08,2012-08-20 10:30:54
746642a6b3bb31e6d6adf67298044f9864e1eb42...cf4c43abaa2d8dace6d70e21c23f7d779a9ad473,1,25,10,35,7,2012-09-06 16:40:09,2012-09-04 09:17:46
0d5dce268d47c4ecfb3f8cdda3379cd606630105...0844ed069e3a09fd2438b5704ee1519182634520,1,2,1,3,2,2012-08-28 18:22:44,2012-08-28 18:15:21
0d5dce268d47c4ecfb3f8cdda3379cd606630105...d03d309b1082af7002e82c4b7028b23836d7e905,1,12,10,22,6,2012-08-28 16:02:12,2012-08-28 16:02:12
07c06f7a83640e11d6be13a87f02e986ecc6e4b3...7fbca880aa5c011257ef734d0b5bfd5545dbaf6b,4,24,11,35,6,2012-08-24 21:32:45,2012-08-24 21:32:45
38068dc1d3cf4a0f0dc2ce8c488a1de4621c04b5...0c49ec2d3b5bfc32d69d189b7dc69cc26beb6a92,8,42,35,77,15,2011-11-07 19:34:27,2011-11-07 18:34:24
0c49ec2d3b5bfc32d69d189b7dc69cc26beb6a92...718eb4b8ae2d26ef76f9f3abe69b8b5e18fc1f6e,1,4,4,8,4,2011-11-07 19:34:42,2011-11-07 19:06:01
718eb4b8ae2d26ef76f9f3abe69b8b5e18fc1f6e...657a3951860f07cf26e2accfe2ada6d62ca5a9f5,1,3,1,4,2,2011-11-07 19:40:50,2011-11-07 19:32:03
5fa1bed0f7da8959f561c49fba6975812f80546a...a07d899449b18b39c39e0bdbbb7653e92a91c1fb,1,1,1,2,1,2011-11-16 23:33:02,2011-11-16 23:33:02
5fa1bed0f7da8959f561c49fba6975812f80546a...8cf2de078def3820a3a3208496ba705df28aad15,2,17,2,19,9,2011-10-18 23:34:42,2011-10-18 23:34:42
8cf2de078def3820a3a3208496ba705df28aad15...28c1451a7c863cb89d598c03d53c4e73497e4c83,2,85,51,136,23,2011-10-20 00:40:14,2011-10-20 00:35:19
28c1451a7c863cb89d598c03d53c4e73497e4c83...4ce16ed82f658e242ffa91ce0abf98dfe45a04ad,1,1,0,1,1,2011-10-22 10:26:56,2011-10-22 10:25:55
c94bc192e36f7a13cda8496d5e8e70ad8cbb967c...e1f4a761506f61f05e74265633aec76cf75cbd50,2,130,0,130,3,2011-08-18 00:34:07,2011-06-22 12:53:01
e1f4a761506f61f05e74265633aec76cf75cbd50...0132cf64388adbba3d8f779e1adb0cbf45549dd3,1,26,0,26,1,2011-08-18 00:34:07,2011-06-24 22:23:48
0132cf64388adbba3d8f779e1adb0cbf45549dd3...65fbc48a175fd1413482d22eb6785c8f94acc3cb,3,76,4,80,9,2011-08-18 00:34:07,2011-06-24 14:23:19
65fbc48a175fd1413482d22eb6785c8f94acc3cb...0e20ba606655d25aa3fdeb9948a55e40107ac269,7,40,2,42,10,2011-08-18 00:34:07,2011-07-30 16:56:20
0e20ba606655d25aa3fdeb9948a55e40107ac269...b4c9063040efdc2bbb2d32704234e0d9c2159b4e,8,89,14,103,16,2011-08-18 00:34:07,2011-07-30 20:29:00
b4c9063040efdc2bbb2d32704234e0d9c2159b4e...7e1a94db11f38c87ae224821a8c570ffa1e11270,6,129,76,205,34,2011-08-18 00:34:07,2011-07-30 23:16:47
7e1a94db11f38c87ae224821a8c570ffa1e11270...da2902204b12e4ba2ad218590f0826a8b8c1badc,6,165,40,205,30,2011-08-18 00:34:07,2011-07-31 00:40:43
da2902204b12e4ba2ad218590f0826a8b8c1badc...44daec422950e0227a863021b6bf4fb8554b6c9c,5,11,4,15,11,2011-08-18 00:34:08,2011-08-03 20:03:57
44daec422950e0227a863021b6bf4fb8554b6c9c...e1d88030687b2ccd652cfedd97714fb37367bbf9,5,41,10,51,14,2011-08-18 00:34:08,2011-08-04 11:07:55
e1d88030687b2ccd652cfedd97714fb37367bbf9...9cf0f287bb0ece488c9e0a169b3f806a4a9701eb,4,14,10,24,11,2011-08-18 00:34:08,2011-08-04 15:50:50
9cf0f287bb0ece488c9e0a169b3f806a4a9701eb...48a65a071d9d6689a0ebb7891a20e8dab5fd3cdd,5,40,8,48,16,2011-08-18 00:34:08,2011-08-04 20:42:58
48a65a071d9d6689a0ebb7891a20e8dab5fd3cdd...0437d991bfb67ffd2d3bb3d5a2cf21261ea42029,4,78,5,83,11,2011-08-18 00:34:08,2011-08-05 13:45:05
0437d991bfb67ffd2d3bb3d5a2cf21261ea42029...2f512ff81e1705c0246416f2292b53540f88fd19,1,3,2,5,2,2011-08-18 00:34:08,2011-08-05 16:11:30
2f512ff81e1705c0246416f2292b53540f88fd19...061047ccb6d9453928fcd3baf94b18fad792f1a0,1,1,1,2,1,2011-08-18 00:34:08,2011-08-05 16:20:00
061047ccb6d9453928fcd3baf94b18fad792f1a0...c1af5a3935025f486156cdfe3b006700e73f0a49,3,49,4,53,15,2011-08-18 00:34:08,2011-08-05 22:35:20
c1af5a3935025f486156cdfe3b006700e73f0a49...441f57c2b7fe414ed50b2d13979795a69bd7bd59,2,37,0,37,3,2011-08-18 00:34:08,2011-08-06 11:48:52
441f57c2b7fe414ed50b2d13979795a69bd7bd59...7284c1059fa801f3df852f6080dff73f82a8262a,1,11,14,25,8,2011-08-18 00:34:08,2011-08-07 08:23:53
7284c1059fa801f3df852f6080dff73f82a8262a...ade3c9bb88b0afb4b025cf92c74e17704c9bc4f4,1,2,0,2,1,2011-08-18 00:34:09,2011-08-07 08:26:33
ade3c9bb88b0afb4b025cf92c74e17704c9bc4f4...1564db11fe291eb21b5f57a063deb482cedf323d,3,6,24,30,7,2011-08-18 00:34:09,2011-08-07 12:02:04
1564db11fe291eb21b5f57a063deb482cedf323d...a1be77cd3534c09b0710794a44a0aed6fd6c3e21,2,3,30,33,5,2011-08-18 00:34:09,2011-08-07 12:27:47
a1be77cd3534c09b0710794a44a0aed6fd6c3e21...cdfd7bd057c3a71bd5731640f04e61e95ac713fe,1,1,0,1,1,2011-08-18 00:34:09,2011-08-10 12:46:18
cdfd7bd057c3a71bd5731640f04e61e95ac713fe...79e9c3eca29e31dff873a99e33c452c8d5d5b6ac,1,10,13,23,2,2011-08-18 00:34:09,2011-08-10 16:35:37
79e9c3eca29e31dff873a99e33c452c8d5d5b6ac...22f65b9e730cd14275897a07b61e338e25099b19,5,83,46,129,12,2011-08-18 00:34:10,2011-08-10 18:49:43
22f65b9e730cd14275897a07b61e338e25099b19...946dab73ba68b0d658cfb1544c1d35d1222b2087,1,12,3,15,4,2011-08-18 00:34:10,2011-08-12 17:02:36
946dab73ba68b0d658cfb1544c1d35d1222b2087...427ca3d3c5b415c3970759b9334425707497fdf4,4,79,30,109,19,2011-08-18 00:34:10,2011-08-12 20:44:35
427ca3d3c5b415c3970759b9334425707497fdf4...7adba5f49c5520f591c4e6519c5bea770a3e4b5d,1,23,0,23,2,2011-08-18 00:34:10,2011-08-13 18:18:29
7adba5f49c5520f591c4e6519c5bea770a3e4b5d...c85e08b1bda30c1a7e0a6e804f81665047fd8005,3,10,14,24,10,2011-08-18 00:34:10,2011-08-16 11:05:05
c85e08b1bda30c1a7e0a6e804f81665047fd8005...84dd3820d41046d35cb8b3bf65e67d0eb7e68f6c,12,30,35,65,20,2011-08-18 00:35:28,2011-08-18 00:13:51
84dd3820d41046d35cb8b3bf65e67d0eb7e68f6c...a7e34e3c854aaed77ede8558ff253716bc4c80a2,1,2,2,4,1,2011-08-18 00:35:28,2011-08-18 00:28:34
17b06f4d47bfd9fae8073c85d71751df94e50050...857323d4db63751517bdb2e63336aae4e82bb78a,2,2,2,4,2,2012-09-09 13:53:57,2012-09-09 13:53:57
412293dcc95369f0a42ae9a94f30fe7328a5491c...47bfa0be6d509b60eda92705b57d3f7ba89c1c6b,4,148,2,150,5,2012-09-11 22:01:09,2012-09-07 20:27:49
47bfa0be6d509b60eda92705b57d3f7ba89c1c6b...a13fb55afdbf9d74c3d4b6aa76476a005da49486,4,49,7,56,11,2012-09-12 00:26:21,2012-09-12 00:26:21
319ad0ba208ec67523a808269b8662c88727a0c9...89cd5708d94d8eb68a5e3a7b0fbda6ee904fb148,2,17,2,19,2,2012-08-29 17:56:55,2012-08-29 12:20:53
319ad0ba208ec67523a808269b8662c88727a0c9...3b73a03497e4fd67459960318308c9265bcd7805,1,92,0,92,1,2012-08-29 06:09:42,2012-04-25 23:26:12
3b73a03497e4fd67459960318308c9265bcd7805...6813169ac9fe2558e4503f0149f22c5fad9d61c1,8,87,308,395,67,2012-08-29 06:09:43,2012-08-06 10:45:59
6813169ac9fe2558e4503f0149f22c5fad9d61c1...0f4c61754bd123b3bee997b397187c9b813ca3e4,8,45,70,115,39,2012-08-29 06:26:00,2012-08-29 05:19:08
b0b2dd5ecc2d309875e8dcd744fa5ff0a55b8fe5...a15c550db8b0552902e58c9bf2194005fb7fb0e9,12,282,136,418,52,2011-11-16 13:09:44,2011-11-16 13:09:44
010879d9e7111d1160839799067584acf09bd4b9...9432af36fc62ee22d76fb927b8be73e123ba3f3c,3,50,22,72,18,2011-11-18 00:40:35,2011-11-17 00:23:19
9432af36fc62ee22d76fb927b8be73e123ba3f3c...2ba14f2367b14187e1714f32c11236476c22ddfa,2,11,7,18,7,2011-11-18 00:40:35,2011-11-17 01:13:46
2ba14f2367b14187e1714f32c11236476c22ddfa...d1a721c5953c6eaee52042e6ace57f6d7e2cc4ba,5,565,378,943,80,2011-11-18 00:40:35,2011-11-17 05:01:09
d1a721c5953c6eaee52042e6ace57f6d7e2cc4ba...2cbca8b06cb7cab08d916438a63e19734256b3fa,3,6,6,12,3,2011-11-18 00:43:27,2011-11-18 00:43:27
2cbca8b06cb7cab08d916438a63e19734256b3fa...472d4d858bed9758b2e9300e544417c0d9d43623,1,11,0,11,1,2011-11-18 01:12:28,2011-11-17 19:32:04
472d4d858bed9758b2e9300e544417c0d9d43623...c515b5bf1e63455686ee1ab89152f3da6eca73a1,3,72,2,74,5,2011-11-18 01:35:45,2011-11-18 01:16:24
c515b5bf1e63455686ee1ab89152f3da6eca73a1...e4c93a392763a006d11e1c1dd01c12f85498dad5,1,1,1,2,1,2011-11-18 01:35:46,2011-11-18 01:26:10
4ce16ed82f658e242ffa91ce0abf98dfe45a04ad...c51065e3e9f150fc7284d8a890f16e4076aeb948,1,1,1,2,1,2011-10-24 21:39:03,2011-10-24 21:39:03
a7e34e3c854aaed77ede8558ff253716bc4c80a2...932669b8655851cc18ca109e78dfe8d71c0b31c0,14,34,36,70,32,2011-08-25 13:41:15,2011-08-25 11:22:57
932669b8655851cc18ca109e78dfe8d71c0b31c0...85b91652018867d67642cb3207084561b85969af,1,1,1,2,1,2011-08-25 21:02:06,2011-08-25 20:57:06
a7e34e3c854aaed77ede8558ff253716bc4c80a2...0d5aa7d7b8b8df80a86b93e1b6e1b94e31a285d4,1,1,3,4,2,2011-08-25 11:31:19,2011-08-25 11:31:19
a7e34e3c854aaed77ede8558ff253716bc4c80a2...d7f0ababe1882c8351093231d986de26f9df670d,2,9,8,17,5,2011-08-24 17:10:50,2011-08-24 17:10:50
d7f0ababe1882c8351093231d986de26f9df670d...c75a890b603179d5ea1d646d63019688f995f87c,1,2,0,2,1,2011-08-24 17:11:15,2011-08-24 17:11:15
21d847d38ffd5055ffbcaabebf115edbee8e8b94...13faa77c57d3fe9ddcfbfdf35c0cdd631521a280,2,2,2,4,2,2012-09-13 15:57:45,2012-09-13 15:57:45
21d847d38ffd5055ffbcaabebf115edbee8e8b94...ab8a0402aeac9767e5bb1b022a6c9ad27cf78f32,1,3,3,6,2,2012-09-12 23:31:24,2012-09-12 04:26:31
9be2261eaae74552aaa9d568e663292f4382e141...e16fc07f7e8c44b01fa61f66c2ad2c819484e248,8,30,11,41,13,2012-09-13 20:31:29,2012-09-13 20:22:40
9be2261eaae74552aaa9d568e663292f4382e141...49d34c1c0c706eea09380b2165bb3ad4e506dc30,21,299,13,312,21,2012-09-13 20:17:38,2012-09-13 20:17:38
49d34c1c0c706eea09380b2165bb3ad4e506dc30...12b6af1718f6f2e1da02870f1a5f5817bed77c0c,1,2,1,3,2,2012-09-13 21:15:07,2012-09-13 21:15:07
2130dee49ffee6c55b49f4f5cd447b2fb7e0acc3...6ee6861123ccb599af584377dd8b75eeea24858b,1,5,4,9,2,2012-09-11 13:58:13,2012-09-10 19:29:07
04d4fe5ef009e9ee2ea98f5f95c798311aec9353...22e1b4b8a8ee8601bdd57da8cd4652afc24e068c,1,1,0,1,1,2012-08-30 14:55:36,2012-08-30 14:55:36
4d3834038bd0aaef63d62c54900f6ddafec09515...fed886d9903e377996d7d5f7a7e3f558e4f2b78a,2,8,1,9,3,2012-09-05 22:54:32,2012-09-05 22:54:32
4d3834038bd0aaef63d62c54900f6ddafec09515...f335ecd6e126aa9dea28786522c0e6ce71596e91,25,1484,570,2054,200,2012-09-05 22:17:24,2012-08-30 21:24:16
f335ecd6e126aa9dea28786522c0e6ce71596e91...510f1bac6b94ce19459498ae78f87fc4f4552305,2,103,38,141,14,2012-09-05 22:17:24,2012-08-30 23:39:05
a15c550db8b0552902e58c9bf2194005fb7fb0e9...7096d0f9e47d39a8fd4f315a7633f3b86a7d6c93,1,1,1,2,1,2011-11-16 19:36:13,2011-11-16 19:36:13
7096d0f9e47d39a8fd4f315a7633f3b86a7d6c93...9788e72ad4443dbcaa7aef92f09aaba7ffc3a98b,2,2,3,5,3,2011-11-16 19:39:03,2011-11-16 19:39:03
a15c550db8b0552902e58c9bf2194005fb7fb0e9...7b6156108c8559cd2a4fd91b34411caf9cdd7d20,1,1,1,2,1,2011-11-16 18:22:13,2011-11-16 18:22:13
e4c93a392763a006d11e1c1dd01c12f85498dad5...bdbdefac39256da42f72532161363d92df00566b,1,0,5,5,1,2011-11-21 12:11:10,2011-11-21 12:06:07
bdbdefac39256da42f72532161363d92df00566b...64093ce51879b5f9f6015b94fce095499c14159c,1,4,1,5,2,2011-11-21 12:11:10,2011-11-21 10:30:14
64093ce51879b5f9f6015b94fce095499c14159c...b7c93a66e2410298fe846b9ed18a70b4d0ace45e,2,43,0,43,2,2011-11-21 12:15:56,2011-11-21 12:01:40
b7c93a66e2410298fe846b9ed18a70b4d0ace45e...a5cd086dffbc07ad839f3a9c320dda6970594126,2,14,22,36,4,2011-11-21 15:38:30,2011-11-21 10:56:00
e4c93a392763a006d11e1c1dd01c12f85498dad5...40a40e8e9daa8187450258ba538c90d70eac12fe,4,102,69,171,20,2011-11-18 20:03:23,2011-10-27 01:06:36
40a40e8e9daa8187450258ba538c90d70eac12fe...95057b85034a226ed5f9bcd7a461a296bbdb7bd9,2,10,17,27,4,2011-11-18 20:18:39,2011-11-18 20:18:39
95057b85034a226ed5f9bcd7a461a296bbdb7bd9...617bfdf47fbe307070dcd084a4e3ea410823c88c,2,18,4,22,8,2011-11-18 20:39:34,2011-11-18 20:28:07
617bfdf47fbe307070dcd084a4e3ea410823c88c...dc9e960f4be2e2fab10ecaeb5934c236ec729d9b,1,4,1,5,2,2011-11-18 20:57:16,2011-10-09 00:59:01
dc9e960f4be2e2fab10ecaeb5934c236ec729d9b...0ca7ca3ef788a45293852a41c55040bc94607961,1,7,2,9,1,2011-11-18 20:57:16,2011-10-09 01:07:53
0ca7ca3ef788a45293852a41c55040bc94607961...4cf01e9a1a3b81d1c8bc77fcdf7e0c20792175a7,2,21,6,27,3,2011-11-21 20:00:42,2011-11-21 19:44:03
4cf01e9a1a3b81d1c8bc77fcdf7e0c20792175a7...6ac3b707b14217602152c032a11304757c88612c,2,15,0,15,2,2011-11-21 20:00:43,2011-11-21 19:48:59
e4c93a392763a006d11e1c1dd01c12f85498dad5...28ba94ceed7c7ac218314bd658279fe3ec52835b,1,1,1,2,1,2011-11-18 09:47:22,2011-11-18 09:43:43
c2fbe423465e1fa02a7e681f6b4aaee877e3de03...11d51ca63184b760e2537bbe08c5ca4c63bd4854,7,108,28,136,27,2011-10-27 00:43:44,2011-10-26 23:43:55
c2fbe423465e1fa02a7e681f6b4aaee877e3de03...9ff46db9111ba77bd4c209f1014028a6bfc60c4a,11,1106,71,1177,31,2011-10-24 21:51:28,2011-10-19 11:48:51
b298e03b16010e59bc1bd41c6499e63d4b2343ef...92e34fa6d6b8e1eb904b8df02e0709d816026662,1,1,1,2,1,2011-08-30 17:48:13,2011-08-30 17:48:13
92e34fa6d6b8e1eb904b8df02e0709d816026662...6f1d23b29fa00b5f46cd100d9c3d98f7cce014d6,1,2,1,3,1,2011-08-30 18:27:36,2011-08-30 18:27:36
6f1d23b29fa00b5f46cd100d9c3d98f7cce014d6...2fcf9c82735cec8874d5e12ed18380c77d629706,2,11,7,18,4,2011-08-30 18:32:33,2011-08-30 18:32:33
aa2f68d80788e9ff6371b0f657901476085cebd0...3ef7d06302b97a24167cd1ceafeb08b871df1751,1,2,0,2,2,2011-08-30 11:10:47,2011-08-30 11:10:26
3ef7d06302b97a24167cd1ceafeb08b871df1751...f978b748bb50beb0ccbebc3aa118ad289e4c9cba,4,22,11,33,6,2011-08-30 11:34:14,2011-08-30 11:34:14
f978b748bb50beb0ccbebc3aa118ad289e4c9cba...74bd343ae83398c7e00c239aea1ff8525dc958a1,3,26,15,41,7,2011-08-30 17:37:14,2011-08-19 07:03:19
74bd343ae83398c7e00c239aea1ff8525dc958a1...b5a8aa94bf144d77a922074c7dad38afcf0a6d24,5,11,74,85,12,2011-08-30 17:37:14,2011-08-22 13:18:19
b5a8aa94bf144d77a922074c7dad38afcf0a6d24...778e1c739b1c9e06d5b3e3d5c965f4a63d40881f,2,32,0,32,2,2011-08-30 17:37:14,2011-08-22 13:43:57
778e1c739b1c9e06d5b3e3d5c965f4a63d40881f...0bd594b61c20f23c6ff32893ed5b096a1d663ab5,2,11,9,20,9,2011-08-30 17:44:09,2011-08-30 17:44:09
d973a5afd437585725bcb0220924693df242e2b9...13b554e3769a04a9fdfdfe7676eea0b867aba10d,1,1,1,2,1,2012-09-13 21:30:31,2012-09-13 21:30:31
22e1b4b8a8ee8601bdd57da8cd4652afc24e068c...b97c169ec0e6f6297dd00cae425f91e8baeb0f58,2,2,2,4,2,2012-09-04 08:01:18,2012-09-04 08:01:18
22e1b4b8a8ee8601bdd57da8cd4652afc24e068c...4deda91bda034d330fd20c1000ef2d3d2972bd0e,1,1,1,2,1,2012-09-03 22:14:16,2012-09-03 22:13:59
4deda91bda034d330fd20c1000ef2d3d2972bd0e...65ac67fbbdb1a980aefb46bfdde918f43515acaf,1,37,1,38,2,2012-09-03 22:22:12,2012-08-28 19:58:10
2e4a9ea9cf8cf12199ea17b0aab50219380b8311...01ae1909c59951f2d4f7955090ce7590e62662e8,2,16,5,21,7,2012-09-06 08:13:38,2012-09-06 08:13:38
967617ccada340d7c089c5ac8f741b30d69fac12...1d09a1c88ddde32bf9b6b5ab6a9feab2ecdaa6ff,3,43,2,45,5,2011-11-22 00:41:22,2011-11-22 00:41:22
1d09a1c88ddde32bf9b6b5ab6a9feab2ecdaa6ff...b762e576c6d0118664320f50be2e5810dbed4c15,16,106,24,130,27,2011-11-22 00:53:56,2011-11-17 23:10:27
b762e576c6d0118664320f50be2e5810dbed4c15...bf038dab30df4cf82382c0b5a123b0f403b2c3a9,1,1,1,2,1,2011-11-22 01:06:24,2011-11-22 01:06:24
bf038dab30df4cf82382c0b5a123b0f403b2c3a9...2744806f32c895feb2ec241320d2b64ae58e992c,1,2,1,3,2,2011-11-22 01:10:41,2011-11-22 01:10:41
bec92f78bf169d3cb2c058263ddff699b5055dca...4bef35656e0518d994435a0f04b5c32e2650bb76,1,23,7,30,17,2011-11-22 01:16:20,2011-11-22 01:16:20
d533c8885b83115fbf4ca3a899621c263894dec4...899cb7a876a13f0031484db799a84b613c690c21,1,1,12,13,2,2011-10-27 23:13:09,2011-10-22 09:36:18
899cb7a876a13f0031484db799a84b613c690c21...c2892d61acfe4ec1544a87e2455bb086bee96516,1,5,14,19,2,2011-10-27 23:13:09,2011-10-22 09:46:22
c2892d61acfe4ec1544a87e2455bb086bee96516...68a26dfa7c61b6421d7a32176e83b36420b7201b,1,2,4,6,3,2011-10-27 23:13:09,2011-10-22 10:33:49
68a26dfa7c61b6421d7a32176e83b36420b7201b...1ca715e07a3d99b8a79ac606f7ddb81a10709a5e,1,9,7,16,4,2011-10-27 23:13:09,2011-10-22 10:36:30
2fcf9c82735cec8874d5e12ed18380c77d629706...c035ede234675075abee8a2546a05113f72450ed,2,5,8,13,5,2011-08-31 01:56:57,2011-08-31 01:45:34
2fcf9c82735cec8874d5e12ed18380c77d629706...0b2c4061878bc5b437b1a9e9b5f43c357283980e,3,11,8,19,8,2011-08-30 20:06:04,2011-08-30 20:06:04
0b2c4061878bc5b437b1a9e9b5f43c357283980e...51d0044629d0ac3e0f419910996c972b547f1156,3,3,3,6,3,2011-08-30 20:33:59,2011-08-30 20:33:59
51d0044629d0ac3e0f419910996c972b547f1156...d568d5856bcc4f283ae1dda0e27d680ee22fb067,16,38,44,82,40,2011-08-30 20:55:22,2011-08-30 20:55:22
57ad9f2e7971549916f66d4a5a2b3b316a24d36a...3ce22c748511c5b12a8a9731d6b9b2888379bd35,3,204,34,238,27,2012-09-14 00:13:30,2012-08-26 17:22:34
af6bcd8b932be89f6499c32353b1335c9489e59f...925be045d5c227dc595e9379f49a3f97b0aaeadd,1,1,0,1,1,2012-09-04 13:40:28,2012-09-04 13:40:05
925be045d5c227dc595e9379f49a3f97b0aaeadd...064ee42d99f1c457fcf728df728c0fb7ea65bc07,2,13,1,14,2,2012-09-04 14:00:49,2012-09-04 13:54:33
064ee42d99f1c457fcf728df728c0fb7ea65bc07...f9988d4e4cc9818b0f338d6f6101241eb6da526b,1,1,1,2,1,2012-09-04 19:42:00,2012-09-04 19:42:00
f9988d4e4cc9818b0f338d6f6101241eb6da526b...c9d223f0de390e8b28af7c7513d03340001c2580,1,1,0,1,1,2012-09-04 20:57:31,2012-09-04 20:57:31
af6bcd8b932be89f6499c32353b1335c9489e59f...0e2dd29ba57580d3d81c62caa7ee4c3ca0a33829,1,1,1,2,1,2012-09-04 10:12:48,2012-09-04 10:07:51
880b6f0c22153db164ecb3a18c362ba8337365d3...8c74d22ebfae33323b5561d9bd988f272ff61a01,4,604,10,614,16,2011-11-28 05:56:44,2011-11-28 05:47:58
8c74d22ebfae33323b5561d9bd988f272ff61a01...3aa294fd450873eaef85ecadaab086b414c4e07e,3,146,42,188,13,2011-11-28 18:42:57,2011-11-28 18:42:57
3aa294fd450873eaef85ecadaab086b414c4e07e...679b69c49df2d8c1b9d0d99f4f3a82a0c3975e4c,2,15,21,36,10,2011-11-28 21:05:25,2011-11-28 21:05:25
880b6f0c22153db164ecb3a18c362ba8337365d3...9462c471435b4de74848408bebe41d770dc49a50,46,1593,1664,3257,275,2011-11-26 07:37:08,2011-11-25 07:16:26
9462c471435b4de74848408bebe41d770dc49a50...45e79e37012ffec58c754000c23077ecac2da753,25,92,91,183,86,2011-11-26 07:48:00,2011-11-26 03:59:21
45e79e37012ffec58c754000c23077ecac2da753...b54b88c46506dc8aa8149d830d9f004e02874d45,1,0,0,0,0,2011-11-26 07:48:01,2011-11-26 05:20:14
b54b88c46506dc8aa8149d830d9f004e02874d45...6632c1550966b821eadd894d73226ded4edb3159,1,119,1,120,10,2011-11-26 07:48:01,2011-11-26 07:30:14
6632c1550966b821eadd894d73226ded4edb3159...03da4480f665bcaf9a621ce8b89fc43dbc1d7a47,1,1,1,2,1,2011-11-26 07:48:01,2011-11-26 07:31:15
03da4480f665bcaf9a621ce8b89fc43dbc1d7a47...b028a898a1adbfe7e2b63aef7314f3eea6bcfe49,1,0,19,19,1,2011-11-26 07:48:01,2011-11-26 07:31:57
b028a898a1adbfe7e2b63aef7314f3eea6bcfe49...c94785a9f373b6604402ba6a301b828b80ab8cd8,1,2,14,16,3,2011-11-26 07:48:01,2011-11-26 07:35:56
c94785a9f373b6604402ba6a301b828b80ab8cd8...d88d4311c7e08ad0d38edae006b50e2a548c937d,18,226,337,563,118,2011-11-28 07:40:40,2011-11-28 07:40:40
4bef35656e0518d994435a0f04b5c32e2650bb76...5689a8d5fd73cf1c6bf5e5699bb7ac01f2613ff9,1,1,1,2,1,2011-11-22 06:04:33,2011-11-22 06:04:33
5689a8d5fd73cf1c6bf5e5699bb7ac01f2613ff9...9d163937ea4e6dff22771f382c1b5e115a53fbfb,1,1,1,2,1,2011-11-22 06:12:57,2011-11-22 06:12:57
db066a9655d74ca85887b4402f0254cf62edfca6...687ec68be4afbc060b499c2198c16c39685f1aee,1,7,13,20,7,2012-09-13 22:51:29,2012-09-13 22:51:29
bb34a9362100ccdbfef10212dc9000f5800266d9...b233714360fc196ecf1d07f3779d995628af3c89,1,1,1,2,1,2011-11-28 17:46:25,2011-11-28 17:46:25
b233714360fc196ecf1d07f3779d995628af3c89...a5123ea80b4a2a561863e69bf15a5d73243b3eb6,1,0,2,2,2,2011-11-28 19:00:42,2011-11-28 19:00:42
a5123ea80b4a2a561863e69bf15a5d73243b3eb6...89886d0bbb7e4d3976a684b38151149bad152e39,6,53,3,56,43,2011-11-28 20:08:29,2011-11-28 20:08:29
798dd36c080af364a1405f155d6d3b7aceb5952d...8e46168cd92d9b496c3b5e98202e9da5bac6d9eb,2,28,2,30,4,2011-11-29 10:36:18,2011-11-29 10:36:18
798dd36c080af364a1405f155d6d3b7aceb5952d...fe9a0e09fe4320d5f31d8fe0b593f674eedf98b7,1,1,0,1,1,2011-11-29 10:02:42,2011-11-29 10:02:42
fe9a0e09fe4320d5f31d8fe0b593f674eedf98b7...91a9a0707aa7ec14e880e671d407fb5b76acc109,2,28,2,30,4,2011-11-29 10:13:31,2011-11-29 10:03:06
f80263225b7306b462c0bf78143d5134f9bed3d9...b026b00d9c0a3f086bfeeed65897294787659dce,2,2,2,4,2,2011-11-22 07:19:07,2011-11-22 04:47:59
b026b00d9c0a3f086bfeeed65897294787659dce...a31471140fae52fe6480d017d2cfc276f25c9e63,1,1,0,1,1,2011-11-22 09:31:32,2011-11-22 09:30:30
a31471140fae52fe6480d017d2cfc276f25c9e63...391575638c61164eea5523ca7bb291d094b6f2d6,1,3,0,3,2,2011-11-22 10:16:44,2011-11-22 10:16:44
391575638c61164eea5523ca7bb291d094b6f2d6...6616e207506d2c3ac287a3c5e631b3d442464bed,1,2,1,3,1,2011-11-22 10:18:27,2011-11-22 10:17:03
6616e207506d2c3ac287a3c5e631b3d442464bed...2869f404fd1fb345bfe86471dbcfba85abaa9f10,2,29,15,44,10,2011-11-22 14:49:23,2011-11-22 14:48:37
687ec68be4afbc060b499c2198c16c39685f1aee...60ecdf59d3af87125467fbed97b575f783129f70,2,37,12,49,8,2012-09-14 05:52:41,2012-09-10 01:48:21
fc88a8d321541165b52d2cdb27753bab76870321...c63728cd73c14093665880b26505418581d7a29a,3,37,19,56,21,2011-11-30 00:39:49,2011-11-30 00:39:49
c63728cd73c14093665880b26505418581d7a29a...7df41387f5d09308acda0d4b54eccc1431c71610,1,22,0,22,2,2011-11-30 05:44:54,2011-11-30 05:44:54
7df41387f5d09308acda0d4b54eccc1431c71610...309113c984c1f3157659dc1174e5d4218f610ae4,3,63,41,104,19,2011-11-30 07:45:17,2011-11-30 07:45:17
2869f404fd1fb345bfe86471dbcfba85abaa9f10...4e90a0a4a083e24492f82e911d4bab6bb26597b4,1,21,5,26,4,2011-11-26 00:54:12,2011-11-26 00:54:12
4e90a0a4a083e24492f82e911d4bab6bb26597b4...533fda3b83d757d7689880e67a19fd8a55e9fc55,3,48,2,50,5,2011-11-26 01:00:18,2011-11-26 01:00:18
dfc50de2605fc6ace6762fa87200c3d4d18a919b...75050223976bce6fd87d5fb38fb3b70adf760c3c,1,2,2,4,2,2012-09-14 08:47:43,2012-09-14 08:47:43
f5f048265800659aa6f495c05eb99e1b76a713e2...969d588d9ab957addb2cecd0f18f7c3699b032b6,5,66,65,131,15,2011-11-30 21:10:47,2011-11-30 21:10:47
38760efb3739d6b70b20ba20798ba2894bb16168...f4ea176fa83297925cf145082b8f76ad44f88a7c,1,0,4,4,1,2012-09-14 17:31:40,2012-09-14 17:31:40
8a4e3181df95f4a772ce95bd66a8a65fcf5c5a75...8e80decf3404dde5bec3d0c89ebe7e17f373e16b,1,2,2,4,2,2011-12-01 06:48:20,2011-12-01 06:48:20
f4ea176fa83297925cf145082b8f76ad44f88a7c...c2948c7754b8bd8059d2a5252ea419c937bbb1ca,2,19,0,19,2,2012-09-14 19:56:14,2012-09-14 19:36:49
f4ea176fa83297925cf145082b8f76ad44f88a7c...b200a813c090c2ccf12ee4b5a99b45300fead2e8,1,1,1,2,1,2012-09-14 18:46:34,2012-09-14 18:43:47
a22b14d32dd8d5f06f121aa154d45bac3b10a305...97769280ba9938ae27f6e06cbd0d5e8a768a86b9,47,1852,1198,3050,770,2011-12-08 07:08:15,2011-11-30 19:27:15
a22b14d32dd8d5f06f121aa154d45bac3b10a305...a7954d2a5a950c6e2162fee3001ccbc18a7acea4,3,74,2,76,5,2011-12-04 17:12:40,2011-12-04 16:55:35
a22b14d32dd8d5f06f121aa154d45bac3b10a305...a1fdea2855bf1c868d5613edb8cb6c4b062b83eb,2,208,0,208,2,2011-12-03 16:47:06,2011-10-24 23:48:12
a1fdea2855bf1c868d5613edb8cb6c4b062b83eb...b4d757c0a8566937df4df9eda205ebb1fbe7aeff,3,170,2,172,5,2011-12-03 17:06:27,2011-10-26 22:19:49
b4d757c0a8566937df4df9eda205ebb1fbe7aeff...e92386876606c734fae9d2f5bd6c80861ccfe409,2,99,0,99,2,2011-12-03 17:06:34,2011-12-03 17:05:44
b200a813c090c2ccf12ee4b5a99b45300fead2e8...3d7617e49e22053e3a34061fc6f109d27c67d1d2,1,8,6,14,6,2012-09-14 20:35:10,2012-09-14 19:33:50
40e73d6f8886d27ae9c7df059d995221e6d84710...7af26f8f5816ba602a30bbc1c8eb8eced1247bd6,1,2,2,4,2,2011-12-14 02:24:16,2011-12-14 02:24:16
7af26f8f5816ba602a30bbc1c8eb8eced1247bd6...bf6d2717ab3b1a23ac7bd7f400518bbd6845c2f1,2,7,7,14,3,2011-12-14 02:27:53,2011-12-14 02:27:53
16a9f32abd9b038cb07e419e646ebf3aab520796...489c36663e0998cf558f2bb1fe595919851d1164,1,1,1,2,1,2011-12-14 19:03:11,2011-12-14 19:00:34
16a9f32abd9b038cb07e419e646ebf3aab520796...8fae76c5e5d561ed3b6f4f4a2c73244a1c5439f6,4,130,72,202,8,2011-12-14 12:16:56,2011-12-14 08:38:05
1e90ae77c4660f9637125a9f72336a25de817efb...e8776d30f7edb570f435cf746d712c696b862bdd,1,3,2,5,2,2012-09-15 22:10:07,2012-09-15 22:10:07
52d552e901a59467edd53bca64af5cea777cdce7...d6ccedddd2f76d69b05ecfa45a93cde8682776e6,1,1,0,1,1,2011-12-14 22:31:06,2011-12-14 18:52:28
d6ccedddd2f76d69b05ecfa45a93cde8682776e6...b5daae68a4ae859653141fb097e7b7c81b25530b,5,78,23,101,17,2011-12-14 22:31:06,2011-12-14 20:34:43
b5daae68a4ae859653141fb097e7b7c81b25530b...bc57b80b837a5497940ac5c3486da6b471420edc,4,88,19,107,26,2011-12-15 01:09:15,2011-12-15 01:08:03
bc57b80b837a5497940ac5c3486da6b471420edc...2ea14da648fb87a0b2e756227b385091bf1b0550,1,2,4,6,3,2011-12-15 17:14:41,2011-12-15 17:14:41
e8776d30f7edb570f435cf746d712c696b862bdd...ec40b7f99f7f7161b0a1b24f1d8a934ec0eaacb1,20,475,52,527,87,2012-09-17 19:42:41,2012-09-17 19:42:41
ec40b7f99f7f7161b0a1b24f1d8a934ec0eaacb1...f08c60a51815d262979a9a95d69565e54adbdd80,3,4,2,6,3,2012-09-17 20:10:42,2012-09-17 20:10:42
e8776d30f7edb570f435cf746d712c696b862bdd...3aa443a9511f5b9848d314337b226c41ef3eef84,7,570,384,954,62,2012-09-17 08:48:26,2012-08-20 14:56:45
3aa443a9511f5b9848d314337b226c41ef3eef84...e93af304112735f02bfeb0833b58ed8230de2371,2,55,19,74,10,2012-09-17 08:48:27,2012-08-24 08:40:17
e93af304112735f02bfeb0833b58ed8230de2371...ee8bb8ba649118c4abb09cb02bd3c02e60b98e06,4,64,1,65,6,2012-09-17 08:48:28,2012-08-19 19:24:51
ee8bb8ba649118c4abb09cb02bd3c02e60b98e06...020cda99c2bec386cb10200f6cfe1b150911ffc9,2,273,239,512,7,2012-09-17 08:48:29,2012-09-14 14:45:24
020cda99c2bec386cb10200f6cfe1b150911ffc9...c214fa1caff937f20ca3a388652352cda92ce85b,4,63,19,82,24,2012-09-17 08:48:30,2012-09-06 13:15:46
c214fa1caff937f20ca3a388652352cda92ce85b...5af61863dd735887e73d98e9a8cba699276303fd,2,0,36,36,2,2012-09-17 08:48:30,2012-09-14 09:15:49
5af61863dd735887e73d98e9a8cba699276303fd...10df95c3cac1c4e195bd39a0914de899245ee5e0,1,46,6,52,7,2012-09-17 08:48:31,2012-09-15 10:23:49
10df95c3cac1c4e195bd39a0914de899245ee5e0...f1ad25f6df10b1ca96a1f5fe3fc1a478c19043f5,2,52,46,98,2,2012-09-17 08:48:32,2012-09-15 10:44:07
f1ad25f6df10b1ca96a1f5fe3fc1a478c19043f5...cc548c7b0ff0d8b33a44d90316abe0027cb6c7d9,1,1,1,2,1,2012-09-17 08:48:33,2012-09-15 10:55:37
cc548c7b0ff0d8b33a44d90316abe0027cb6c7d9...3f4c3072ea36877c07380d096d6277e9777f4587,3,78,0,78,3,2012-09-17 08:48:34,2012-09-15 20:03:31
3f4c3072ea36877c07380d096d6277e9777f4587...4ebe38bd589b7b99427b2822ca7a486c8bb3bf02,3,80,0,80,3,2012-09-17 08:48:35,2012-09-15 20:07:09
4ebe38bd589b7b99427b2822ca7a486c8bb3bf02...44af67a8b6679ac33c3407d45fee042178d97e76,3,98,0,98,4,2012-09-17 08:48:35,2012-09-15 20:07:45
44af67a8b6679ac33c3407d45fee042178d97e76...5e4cb4f4da0baef99683be95cb5eeb5288d8ba84,3,35,43,78,7,2012-09-17 08:48:36,2012-09-17 08:38:57
5e4cb4f4da0baef99683be95cb5eeb5288d8ba84...397837197d1ce04b8bd4aaa57a7f5f67648dc57f,4,9,17,26,8,2012-09-17 18:27:28,2012-09-17 18:27:28
2ea14da648fb87a0b2e756227b385091bf1b0550...7b2b4adfb1cb71f085a88418d1d5b631bf26ebd8,1,4,2,6,3,2011-12-16 00:39:28,2011-12-16 00:39:28
7b2b4adfb1cb71f085a88418d1d5b631bf26ebd8...80a665aaca70ea3f5fda0955c39884bead13d2a2,3,38,1,39,4,2011-12-16 01:28:39,2011-12-16 01:28:39
411cb017c21e0490ed1c6438c7d5fa1b4ee9f63f...b1127a30c771cb37673cb82506b3fd647b5f03ae,1,3,2,5,2,2012-09-20 20:32:19,2012-09-20 20:32:19
411cb017c21e0490ed1c6438c7d5fa1b4ee9f63f...28abf3dbd27c232acd7dd17c6a642c793a3c80c9,1,5,4,9,4,2012-09-20 12:10:04,2012-09-20 09:41:49
28abf3dbd27c232acd7dd17c6a642c793a3c80c9...9ac8b113b18e04d4d6f0573e3a6c5e06c447dbf3,4,5,5,10,5,2012-09-20 12:10:05,2012-09-20 12:06:49
9ac8b113b18e04d4d6f0573e3a6c5e06c447dbf3...9e592583fc5fcd7eec5d40d30e34870e6a029fef,3,108,6,114,11,2012-09-21 06:08:29,2012-09-19 10:23:47
411cb017c21e0490ed1c6438c7d5fa1b4ee9f63f...5bb0dc9390edf9f056cd67c12c258b10d0648871,2,29,9,38,8,2012-09-19 11:41:24,2012-09-13 21:02:46
5bb0dc9390edf9f056cd67c12c258b10d0648871...78216495b0aaca66dc76ae33516a679385495c6a,1,32,23,55,12,2012-09-19 11:41:30,2012-09-14 03:08:05
78216495b0aaca66dc76ae33516a679385495c6a...63409451860749cfe1efbb509fbe8c5a0a1648a0,1,17,16,33,10,2012-09-19 11:55:16,2012-09-19 11:55:16
3e72809b5ec73b3aa416f3b12d6fd066f83dcb79...86e356ee51b07049202078b1ad2f23ac7136075e,1,19,0,19,2,2011-12-18 20:08:50,2011-12-18 20:08:50
86e356ee51b07049202078b1ad2f23ac7136075e...be00b00dd1468f1c625ca3fadc61f2a16edfb8d5,1,11,0,11,1,2011-12-18 20:21:18,2011-12-18 20:21:18
d0b452db02f8777c650b63118c396685ede1de2d...f9cf12b4f58588309c0329d0525f1505f579c32d,1,1,1,2,2,2012-10-02 18:23:54,2012-10-02 18:23:54
0cb24616eea3b92893b2a03e851a0db2c04862ef...f55af775ab9b6b20e66607d502ff8bcdb0b72b7d,1,4,2,6,1,2012-09-21 23:16:10,2012-09-21 23:16:10
0cb24616eea3b92893b2a03e851a0db2c04862ef...1a628100534a315bd00361fc3d32df671923c107,4,79,4,83,7,2012-09-21 22:04:39,2012-09-21 22:04:39
be00b00dd1468f1c625ca3fadc61f2a16edfb8d5...ee1f0b1aed7798908d9e038b006b66f868613fc3,54,1722,16,1738,46,2011-12-21 00:32:58,2011-12-16 18:56:43
ee1f0b1aed7798908d9e038b006b66f868613fc3...73b51450a3194ddaa2ac180a1fea25fdf66971bb,38,612,221,833,109,2011-12-29 08:01:10,2011-12-29 07:28:50
73b51450a3194ddaa2ac180a1fea25fdf66971bb...c6d2a2c0946ff32c16578b68b39824f4fea8f782,2,15,9,24,11,2011-12-30 05:32:37,2011-12-30 05:31:30
c6d2a2c0946ff32c16578b68b39824f4fea8f782...bd370b14fefdba3844a9bf0bbf87171ca48f49be,19,322,66,388,46,2011-12-30 23:00:14,2011-12-30 23:00:14
be00b00dd1468f1c625ca3fadc61f2a16edfb8d5...e95849c14f8c62a99f04600bb3a4f677156a78bd,1,6,3,9,3,2011-12-19 15:07:21,2011-12-16 10:39:21
f9cf12b4f58588309c0329d0525f1505f579c32d...22935b06d160c8b33e90784d43480859ca65d3b6,1,4,2,6,3,2012-10-07 08:20:23,2012-10-07 08:20:23
22935b06d160c8b33e90784d43480859ca65d3b6...acd1700630ea1159a55dc5e8cee12e4a725afe18,1,1,1,2,1,2012-10-07 09:19:19,2012-10-07 09:19:19
f9cf12b4f58588309c0329d0525f1505f579c32d...1a5cd26b8c90ecd512bff9d54846db1db277b492,1,3,3,6,2,2012-10-05 11:03:38,2012-10-05 11:02:35
1a5cd26b8c90ecd512bff9d54846db1db277b492...9ce44f1ae5a8b286585e60c88c6a143d80a226a6,1,16,0,16,1,2012-10-05 11:03:38,2012-09-18 20:35:09
9ce44f1ae5a8b286585e60c88c6a143d80a226a6...7e57d2506a4719dbe13115ba3bf7e4a012daa3e3,2,43,2,45,3,2012-10-05 11:03:38,2012-09-18 21:43:23
7e57d2506a4719dbe13115ba3bf7e4a012daa3e3...1686641f18f028940b760ef554e9219c2c9a27d8,1,40,33,73,11,2012-10-05 11:03:38,2012-10-05 11:03:22
1686641f18f028940b760ef554e9219c2c9a27d8...1dca8510a2e815c95293c1ebaacf2a286a9c6e1d,1,5,1,6,1,2012-10-05 11:53:53,2012-10-05 11:44:18
63f6c82568419848e726ae6373d2ba03de0621fd...aed8f8a101872e8b4c81de788a5e675c67b50d20,1,11,2,13,3,2012-09-24 16:02:47,2012-09-24 16:02:47
aed8f8a101872e8b4c81de788a5e675c67b50d20...68e75c3a57874d3f1a6a7d36495e9303b69c6a78,1,1,1,2,1,2012-09-24 16:06:34,2012-09-24 16:06:34
68e75c3a57874d3f1a6a7d36495e9303b69c6a78...6605f51d81a9ccfb1b5a1c1689a57cf3f5b2f5b3,1,27,3,30,3,2012-09-24 16:50:37,2012-09-24 16:50:37
6605f51d81a9ccfb1b5a1c1689a57cf3f5b2f5b3...8b4f9b17580c52ac2b1f2f42f5c53116fb763436,3,40,6,46,10,2012-09-24 16:59:00,2012-09-24 16:59:00
8b4f9b17580c52ac2b1f2f42f5c53116fb763436...407cf4e414ac2d67a27212e31d96582d4b83c8bc,1,1,1,2,1,2012-09-24 21:22:07,2012-09-24 21:22:07
407cf4e414ac2d67a27212e31d96582d4b83c8bc...d7940ac3e4afd92fca527aafcc13a88817c5670f,1,22,0,22,1,2012-09-24 22:09:44,2012-09-24 22:09:44
d7940ac3e4afd92fca527aafcc13a88817c5670f...c378a1184e8e4cdcffcad3271d650ab12792a6bc,1,3,0,3,1,2012-09-24 22:11:53,2012-09-24 22:11:53
c378a1184e8e4cdcffcad3271d650ab12792a6bc...f2b126c76e858be1794c41f9e624ad0d3529432e,1,14,5,19,1,2012-09-24 22:33:53,2012-09-24 22:33:53
f2b126c76e858be1794c41f9e624ad0d3529432e...549ee21a6f60baabf33b32b0d407957b4894d4aa,1,100,0,100,2,2012-09-29 18:20:41,2012-09-29 18:20:41
549ee21a6f60baabf33b32b0d407957b4894d4aa...32a4e3b712b2b63837afc28ebc9ba0169a0ac644,1,14,8,22,8,2012-09-29 18:26:33,2012-09-29 18:26:33
32a4e3b712b2b63837afc28ebc9ba0169a0ac644...77ddd4ccc37bf124525236e5d7f30af34b9d8075,1,7,19,26,10,2012-09-29 19:24:07,2012-09-29 19:24:07
77ddd4ccc37bf124525236e5d7f30af34b9d8075...dee18b825afd031e8f124a9b2d2a578a79988eda,1,6,6,12,6,2012-09-29 19:26:04,2012-09-29 19:26:04
dee18b825afd031e8f124a9b2d2a578a79988eda...19aa8416e59e6c8f01c6b850ce6bb3e2f7457236,2,3,2,5,3,2012-09-29 19:31:19,2012-09-29 19:26:32
19aa8416e59e6c8f01c6b850ce6bb3e2f7457236...8b3de0b6b8104019def3ddedcf2750539ea7409f,1,10,42,52,8,2012-10-02 15:16:22,2012-10-02 15:16:22
8b3de0b6b8104019def3ddedcf2750539ea7409f...4258d4832b9525ed4e21597a9e63a6dd5aa43507,4,21,21,42,18,2012-10-02 15:21:07,2012-10-02 15:21:07
4258d4832b9525ed4e21597a9e63a6dd5aa43507...997579bed1806f217c910da05092ffdf9f4523b4,3,175,145,320,4,2012-10-02 15:58:34,2012-10-02 15:55:29
63f6c82568419848e726ae6373d2ba03de0621fd...d75074f4c02e8d8928d20261a891d94d26d41ea7,1,1,1,2,1,2012-09-22 10:29:16,2012-09-22 10:29:16
5942bd18bf557cc70873009c4303a421c83f0129...addc9be4fcb88e77107557e991bd92355522d844,2,17,1,18,3,2012-09-27 17:12:27,2012-09-26 21:21:32
5942bd18bf557cc70873009c4303a421c83f0129...8060cdc93cc185e9a71c1aa17091dc0a5ab14457,6,14,2,16,4,2012-09-27 17:12:01,2012-09-27 12:59:43
5942bd18bf557cc70873009c4303a421c83f0129...9a12a6256efa7da4b4245d0f2b7df6f3b84edabd,1,100,143,243,9,2012-09-25 23:35:05,2012-09-18 22:13:07
9a12a6256efa7da4b4245d0f2b7df6f3b84edabd...5f69a31f7d706aa5788ad9937391577a66e3c77d,10,967,826,1793,276,2012-09-25 23:35:05,2012-09-25 03:52:34
5f69a31f7d706aa5788ad9937391577a66e3c77d...642863086575a61b3ed0bbbe909f4f07d87ff9db,6,105,55,160,27,2012-09-25 23:35:05,2012-09-25 17:48:50
642863086575a61b3ed0bbbe909f4f07d87ff9db...bae957b95d59a840df72a725b06f00635471cfd8,13,59,57,116,46,2012-09-25 23:35:05,2012-09-25 23:31:46
1bdba3386d9953c722d9302f414156104cc06945...db1f7e596c072380ec994ae2e71556fc0a6568f7,4,102,9,111,11,2011-12-21 20:30:12,2011-12-21 15:36:34
acd1700630ea1159a55dc5e8cee12e4a725afe18...edb456c32890f329bac59cba1286c0bf44ab6078,2,26,4,30,4,2012-10-08 20:32:43,2012-10-08 20:32:43
acd1700630ea1159a55dc5e8cee12e4a725afe18...74a24005146d0f908b2660db5f7e198adad4ab64,5,17,17,34,13,2012-10-07 10:04:19,2012-09-21 08:28:20
74a24005146d0f908b2660db5f7e198adad4ab64...096d9e94aa9e19669e778c8644ccfa7f41f98eaf,3,6,3,9,5,2012-10-07 19:03:37,2012-10-07 19:00:46
096d9e94aa9e19669e778c8644ccfa7f41f98eaf...b52b6571afc96006de69aac77c8a9f97b3ebb9d3,1,13,0,13,1,2012-10-07 19:03:48,2012-09-22 10:42:16
b52b6571afc96006de69aac77c8a9f97b3ebb9d3...a147408f944abb67e1a4a50071c9bb0a20c57e98,1,6,1,7,3,2012-10-07 19:03:49,2012-09-22 10:47:17
a147408f944abb67e1a4a50071c9bb0a20c57e98...7eca3c561d489dc3f3d4ee802ea4fd358214f632,1,20,15,35,6,2012-10-07 19:03:49,2012-09-22 10:50:18
7eca3c561d489dc3f3d4ee802ea4fd358214f632...f3cc78340a7a0d2dab8a38c48fc80c6c36419450,1,13,17,30,7,2012-10-07 19:03:50,2012-09-22 10:51:34
f3cc78340a7a0d2dab8a38c48fc80c6c36419450...0c78f685ebeed293c666815b1668b8209f4ff258,3,114,0,114,3,2012-10-07 19:03:51,2012-10-06 08:41:53
0c78f685ebeed293c666815b1668b8209f4ff258...4ba23be1e5bd480d9f6bb3eb212d5a3409fa88bd,2,10,26,36,8,2012-10-07 22:44:08,2012-10-06 10:20:13
4ba23be1e5bd480d9f6bb3eb212d5a3409fa88bd...70edc1b0fc98c22e6c0f73c7292cb858e444e5c2,1,8,8,16,4,2012-10-07 22:44:11,2012-09-26 09:05:12
70edc1b0fc98c22e6c0f73c7292cb858e444e5c2...3e012fca770944211bd2b32632f64ae07c42e25d,2,25,4,29,6,2012-10-07 22:44:13,2012-09-26 17:15:11
3e012fca770944211bd2b32632f64ae07c42e25d...d280c71b8e6b4df3d8d134b14740e1ec7d885565,1,74,19,93,13,2012-10-07 22:44:16,2012-09-26 17:22:21
d280c71b8e6b4df3d8d134b14740e1ec7d885565...ebecf1e7d8e1b2f6c73c7b1de0a6371e65f27285,1,36,21,57,20,2012-10-07 22:44:19,2012-10-07 10:04:07
ebecf1e7d8e1b2f6c73c7b1de0a6371e65f27285...bf0e62a2b8b6116ae61dae37f95a3eb840246ec6,2,126,42,168,16,2012-10-07 22:44:21,2012-10-07 10:50:18
543864b677704845660085d2b2b2249cabb084a4...dfbff793b8f39995d3a8744d6b7d75d5cc7201a0,5,57,5,62,12,2012-10-08 22:22:40,2012-10-08 22:14:12
dfbff793b8f39995d3a8744d6b7d75d5cc7201a0...71966e2f1bdfb75b7e57942d572ea089ce32e463,3,40,11,51,8,2012-10-08 22:22:40,2012-10-08 22:18:30
71966e2f1bdfb75b7e57942d572ea089ce32e463...5d1308f25ff36d03f0a22451642cc0f2a931daae,4,132,24,156,17,2012-10-08 22:22:40,2012-10-08 22:19:00
52748f7b9f039b94e212c41d8a4f46b50b917962...a891841850d50d68842c88f57cd3f7c9cbdff38f,1,1,0,1,1,2012-10-16 15:58:19,2012-10-16 15:58:19
d75074f4c02e8d8928d20261a891d94d26d41ea7...c030ada7ff7f9c93a2287ca2f57173d66fbff88a,4,176,79,255,35,2012-09-25 05:49:14,2012-09-11 10:06:57
c030ada7ff7f9c93a2287ca2f57173d66fbff88a...77e06d7e8547e82336489b7cdeb04294ed3d6015,11,112,60,172,33,2012-09-25 05:49:15,2012-09-17 05:11:32
77e06d7e8547e82336489b7cdeb04294ed3d6015...0adfa20aefcd18262214a22042d303721cc7d23a,5,211,3,214,7,2012-09-25 05:49:15,2012-09-11 09:42:13
d75074f4c02e8d8928d20261a891d94d26d41ea7...3af06254d0b54feb25799dc1a5ff4853065a633b,1,1,1,2,1,2012-09-22 21:12:03,2012-09-20 20:42:22
3af06254d0b54feb25799dc1a5ff4853065a633b...f73f760e66194908cb013b1d027960939c0a782c,2,60,45,105,3,2012-09-22 21:12:03,2012-09-20 21:49:17
f73f760e66194908cb013b1d027960939c0a782c...e800bbe80a37468234e4b7412da8e69dff17b5a5,1,48,12,60,10,2012-09-22 22:00:55,2012-09-20 22:32:53
e800bbe80a37468234e4b7412da8e69dff17b5a5...7604ddbf701b586b6f6160807cf32fca28398df1,5,10,7,17,10,2012-09-22 23:02:07,2012-09-20 22:57:21
7604ddbf701b586b6f6160807cf32fca28398df1...45949b378b418d133e5bdf58d84114a6c3175461,1,14,0,14,6,2012-09-22 23:02:07,2012-09-20 23:53:15
45949b378b418d133e5bdf58d84114a6c3175461...daa70138fcb7518443bb5053cb10c0ba07fb4494,1,63,63,126,18,2012-09-22 23:02:07,2012-09-22 21:04:45
daa70138fcb7518443bb5053cb10c0ba07fb4494...8469219e3792fd19d8f6ca5ca6f978928fcb8dc7,1,5,0,5,1,2012-09-22 23:02:07,2012-09-22 21:11:26
34402bcdb94ff412e66220ada0b776c25cd8c30d...2af1c266415bd2030cdfef8ec170a6c135e12b75,1,2,2,4,2,2012-09-30 09:02:53,2012-09-30 09:02:53
34402bcdb94ff412e66220ada0b776c25cd8c30d...cc5bf359a6a56b2abd898feccf2c33dc2a5f6a3e,4,9,9,18,9,2012-09-28 21:34:08,2012-09-28 16:08:09
cc5bf359a6a56b2abd898feccf2c33dc2a5f6a3e...7c411fd9b2aa63cdf6ace07640fdae91b695660b,1,6,6,12,6,2012-10-01 19:32:55,2012-10-01 19:32:55
7a704309ae012b8e92eb6103b0d14dd3c22a1cb5...1d415455d9484e99dcaa7f061bc9b172c083dabe,8,27,53,80,13,2012-01-02 09:06:24,2012-01-02 09:06:24
1b8cbe8be82cd55b900453a6bea7d9068c39c825...fa51565625902291f278d41c9254f8ab38bd916d,4,38,11,49,15,2011-12-24 23:22:20,2011-12-24 23:22:20
fa51565625902291f278d41c9254f8ab38bd916d...d16e4b2b88a0b504fe4bb2b56f3d36c81b515d89,2,1,1,2,2,2011-12-24 23:25:04,2011-12-24 23:25:04
9adfa7d147b319593789cbaeea94a97141b1e4f8...aa4437f637371c531355029686cb5780fd99c988,2,1,2,3,2,2012-10-09 15:51:11,2012-10-08 22:51:43
21e0d297af95e49b933c2a8d09994a32011354b1...4bc1a30f135db3edbcddf8a548f00353c54dacd8,2,69,0,69,2,2012-10-09 19:28:31,2012-06-10 20:04:24
4bc1a30f135db3edbcddf8a548f00353c54dacd8...edca6c8fed0a95c1308cbef1edb5a0ace25889b7,1,3,0,3,1,2012-10-09 19:28:31,2012-07-01 17:44:22
edca6c8fed0a95c1308cbef1edb5a0ace25889b7...2f05339e3e39b205ff55198e35604f521cdda41e,2,55,9,64,6,2012-10-09 19:28:31,2012-07-10 06:53:05
2f05339e3e39b205ff55198e35604f521cdda41e...fa16a6ecc4ccc02ad451703c9a5fe6680722e90a,1,7,7,14,1,2012-10-09 19:28:31,2012-08-01 09:35:26
fa16a6ecc4ccc02ad451703c9a5fe6680722e90a...e3f8d58d12dae19d6041733c4adbf29a5891447e,1,0,5,5,1,2012-10-09 19:28:31,2012-08-14 21:07:54
e3f8d58d12dae19d6041733c4adbf29a5891447e...ec1d42b7d5eb5a25b504277bee5b0cc97931e1a7,2,603,0,603,2,2012-10-09 19:28:31,2012-08-19 20:22:07
ec1d42b7d5eb5a25b504277bee5b0cc97931e1a7...0a32dca5ecbd4c56b02ba78af4174ac7f65a786c,7,1585,0,1585,7,2012-10-09 19:28:31,2012-08-19 20:26:32
0a32dca5ecbd4c56b02ba78af4174ac7f65a786c...0cf49e1017427809278877788ed750fea1456bd2,2,41,63,104,16,2012-10-09 19:50:04,2012-10-09 19:49:48
21e0d297af95e49b933c2a8d09994a32011354b1...fade21db0a7a1d535b6352943ecd7b5ae6841e57,1,22,24,46,16,2012-10-09 18:53:00,2012-09-28 20:39:34
fade21db0a7a1d535b6352943ecd7b5ae6841e57...bc16fd3ebf8727900f2b8c2f44cb14fd03f80bcc,4,45,28,73,15,2012-10-09 18:54:01,2012-09-28 20:40:02
bc16fd3ebf8727900f2b8c2f44cb14fd03f80bcc...fbec2fb99112d5fbac1367afd99cf039e6b3e48b,1,3,1,4,2,2012-10-09 18:54:01,2012-09-28 21:32:33
fbec2fb99112d5fbac1367afd99cf039e6b3e48b...95f5f1e63ae4925eda53c7e4d0d16fe583977359,2,64,37,101,12,2012-10-09 18:54:01,2012-10-02 20:57:15
95f5f1e63ae4925eda53c7e4d0d16fe583977359...f3a04e0f49d0f46e578613d1c27161abc4c2bf22,104,153,0,153,38,2012-10-09 18:54:02,2012-10-02 23:13:17
f3a04e0f49d0f46e578613d1c27161abc4c2bf22...0d64bef941928046d114c4da1acb70bd2907855e,27,581,194,775,99,2012-10-09 18:59:34,2012-10-05 22:56:57
0d64bef941928046d114c4da1acb70bd2907855e...fe67e404da4230149ada1b94acadf7dde828b22e,2,66,65,131,27,2012-10-09 21:35:24,2012-10-09 21:35:24
fe67e404da4230149ada1b94acadf7dde828b22e...e48bb71bec20d6edbce4fc5c77b716ae0701e33a,1,7,2,9,4,2012-10-17 17:44:38,2012-10-17 17:44:38
e48bb71bec20d6edbce4fc5c77b716ae0701e33a...52a61bb8047f431bf363bd9327d0f34884437c83,2,5,7,12,4,2012-10-17 21:10:23,2012-10-17 21:10:23
a891841850d50d68842c88f57cd3f7c9cbdff38f...18217e7e8abaef5f5ae5582231c7d6fbc2741f74,2,8,10,18,7,2012-10-16 17:37:21,2012-10-16 17:34:29
a891841850d50d68842c88f57cd3f7c9cbdff38f...5e4f2b5faaa86843befadcda2fb784301254e452,2,72,0,72,3,2012-10-16 17:18:45,2012-10-16 17:18:45
2af1c266415bd2030cdfef8ec170a6c135e12b75...3665ba8eeb4f8b2546517cd208e940b128dd8a46,5,8,40,48,6,2012-09-30 09:56:37,2012-09-27 10:04:41
3665ba8eeb4f8b2546517cd208e940b128dd8a46...c128149315c67d52c4503e294bfbd2653e0a8307,2,21,4,25,5,2012-09-30 09:56:37,2012-09-30 09:37:53
c128149315c67d52c4503e294bfbd2653e0a8307...24f2f94e7defd20ab302c30d0d394248a6e43814,6,48,2,50,8,2012-09-30 09:56:38,2012-09-15 06:07:24
24f2f94e7defd20ab302c30d0d394248a6e43814...a37ddf7ef80e7f3f79ec708496dcf4302b57f2de,1,48,7,55,11,2012-09-30 10:04:39,2012-09-16 01:36:03
a37ddf7ef80e7f3f79ec708496dcf4302b57f2de...f70e466f680a00deb4ff6229c0379a2b6ae1b68f,2,27,0,27,2,2012-09-30 10:04:49,2012-09-27 09:58:35
f70e466f680a00deb4ff6229c0379a2b6ae1b68f...eb0bd77a8892b77b8eaa57da2f827981c62bc161,1,9,37,46,9,2012-09-30 10:04:49,2012-09-29 20:50:33
eb0bd77a8892b77b8eaa57da2f827981c62bc161...3230a44f4c951cbaeadfa5ae111f6558298dfc61,5,28,15,43,15,2012-09-30 10:05:28,2012-09-30 08:56:06
8bc5caccee4ebb0b9239135fe81750f3b72a8e76...218c88a968eb983261920465105c698aaacacaaf,2,58,0,58,4,2012-10-02 11:09:18,2012-10-02 09:48:02
218c88a968eb983261920465105c698aaacacaaf...c648d4a8aac447120aed623cd1606fddeb435800,1,5,0,5,1,2012-10-02 11:09:18,2012-10-02 10:05:09
1d415455d9484e99dcaa7f061bc9b172c083dabe...c6a437eaec40c7b145af9e4a74af1b9804b4f0c8,1,1,1,2,1,2012-01-03 10:44:13,2012-01-03 10:44:13
d16e4b2b88a0b504fe4bb2b56f3d36c81b515d89...20626db1ac5dbea00a30f0bfd6e21936d714ce52,1,1,0,1,1,2011-12-27 05:58:17,2011-12-27 05:58:17
2306ba10846b2440203080b9ad8739daa103a6b0...0bc47b633987bc6de67e255e39c7e2a08ea72254,1,40,5,45,15,2012-10-09 22:13:00,2012-10-09 22:13:00
0bc47b633987bc6de67e255e39c7e2a08ea72254...8ea05f3f8f3485d39ce4a867b353f45c4eebf54e,1,1,1,2,1,2012-10-09 22:25:58,2012-10-09 22:25:58
4c47a8bcfe03c42096b74d4af06ab95fb95fd211...7205a4d94cdead95c397505292a31b4854039825,3,11,2,13,6,2012-10-23 18:30:16,2012-10-23 17:30:04
4c47a8bcfe03c42096b74d4af06ab95fb95fd211...c08b8a3a73c13f95558cd6e34f9c67ab5000a7eb,3,44,4,48,7,2012-10-18 18:50:17,2012-10-18 18:50:17
4c47a8bcfe03c42096b74d4af06ab95fb95fd211...f0d2ddbbf86ee9a3fdb0b882077a6792d5fb5d7f,4,43,5,48,13,2012-10-18 02:31:03,2012-10-18 02:31:03
03452b347ef51f3400e40fb7b33adcb4508dcbe8...b4491b9911b4ceaa64b0fa7b94774affa3f41d43,3,95,92,187,45,2012-10-17 16:07:17,2012-10-16 20:18:21
03452b347ef51f3400e40fb7b33adcb4508dcbe8...70d41f6bcd248ebb7eaf65098a9495e9e54c67d0,1,2,0,2,1,2012-10-16 21:42:01,2012-10-16 21:42:01
bdaa40d3da5f57be275b2f1ba8d04253a2fcaea7...9063be1f45287f945125315e7782745da8c1005d,1,1,1,2,2,2012-10-01 15:33:05,2012-10-01 15:33:05
9063be1f45287f945125315e7782745da8c1005d...93b5fabcc03e465609d0d68af13f4ab2cf1e2dfd,1,4,0,4,2,2012-10-01 15:59:04,2012-10-01 15:59:04
8a89aa1f57fc0b352800bc77e228554fe95caddd...f8ede94808348ac12db1d5dd91e5f66624d8b40d,3,25,0,25,5,2012-10-23 09:48:50,2012-09-18 12:10:40
f8ede94808348ac12db1d5dd91e5f66624d8b40d...a1abe66aca3625eec1cabb2e93cf8df0be1b63f0,19,869,328,1197,170,2012-10-23 10:48:38,2012-09-10 10:11:02
7d93f96aa90c22fa7ebcbc954ad71e1cfed7013e...acb159e19159f63651eb2ccc8e4a4a31771c08c5,2,5,3,8,4,2012-01-04 17:17:55,2012-01-04 16:59:48
acb159e19159f63651eb2ccc8e4a4a31771c08c5...f46e622636c5196829329f7bcf2226b36e61f7ed,1,1,1,2,1,2012-01-04 20:15:12,2012-01-04 20:15:12
9aeef3929c3c44618e1f7fb01d33be79c0532ff0...27f69e48263ca93609e6a81397d31b54d7211c3d,1,1,0,1,1,2011-12-27 14:10:12,2011-12-27 14:10:12
8ea05f3f8f3485d39ce4a867b353f45c4eebf54e...aeba5e175a58eebc5eae43adaa40955d2a9f55c3,1,1,4,5,1,2012-10-10 21:59:16,2012-10-10 21:55:03
8ea05f3f8f3485d39ce4a867b353f45c4eebf54e...2d3579bea699847b560e99a5107b12eac8d172ad,3,68,0,68,3,2012-10-10 21:54:31,2012-10-10 21:54:31
81e7b10a15d8a28bc0407d61a0e6ddc27e23647c...308581de9e1a65a094cf892b8d766ca6ff77dad9,1,1,1,2,1,2012-10-24 01:18:19,2012-10-24 01:18:19
308581de9e1a65a094cf892b8d766ca6ff77dad9...4bc252e4ecd281add17624fd507addd4f828cb00,1,1,1,2,1,2012-10-24 13:00:56,2012-10-24 09:27:03
4bc252e4ecd281add17624fd507addd4f828cb00...6f6b0c013c6eff2aca2a7ada1027044f2e20f578,1,0,2,2,1,2012-10-24 13:42:09,2012-10-24 13:42:09
502be5ff3f78a7847d72aa0ccb6d2875b296121b...c2e43fb1f2254237a20a9f2a4383ec7eb613a36c,2,27,6,33,8,2012-10-18 21:38:27,2012-10-18 14:50:55
c2e43fb1f2254237a20a9f2a4383ec7eb613a36c...4fd7e8e5837b9b32a4fc76aaadf5df1b1e6a5434,1,1,4,5,1,2012-10-18 21:38:35,2012-10-18 14:52:19
4fd7e8e5837b9b32a4fc76aaadf5df1b1e6a5434...2df37f42c15ac74cb27bbd38e0f896159acd4d19,1,3,0,3,1,2012-10-18 21:59:22,2012-10-18 21:59:22
6f6871a9dbf6ec39013655c15d0e5c6674322d24...b2b571ce0c2969bdc00bfa400d20da5cdece1dcd,1,2,1,3,2,2012-10-18 17:05:24,2012-10-18 17:05:24
5b67d145d8f465ed0c7ed9c07d331aae29c2713b...b4f5bb074721823cc016b66a9984abe2c271cb1f,28,590,167,757,81,2012-10-23 23:40:51,2012-10-23 23:40:51
b4f5bb074721823cc016b66a9984abe2c271cb1f...db106d01f093b3e61170e3738d6651a2866cb76e,7,559,342,901,24,2012-10-30 16:40:50,2012-10-30 16:40:50
06fcf057b6da37ffd388e4a31c2671b20d0dd21e...9dd4c3e80690ec08eba604e5218d0f4abb8f1a02,3,3,3,6,3,2011-12-31 04:58:26,2011-12-31 04:56:39
06fcf057b6da37ffd388e4a31c2671b20d0dd21e...86a459a8431e626678854c690ba7b87f96d27bbd,5,20,1373,1393,12,2011-12-29 14:40:09,2011-12-29 11:16:01
86a459a8431e626678854c690ba7b87f96d27bbd...e632f68789cc5b69b84b6344402d6b6f1bf6abb2,1,20,0,20,2,2011-12-29 14:40:09,2011-12-29 12:04:17
e632f68789cc5b69b84b6344402d6b6f1bf6abb2...a26a156349c6d59a80825b9c3f4c9c423fed5d3a,2,9,6,15,5,2011-12-30 19:14:01,2011-12-30 18:03:55
a26a156349c6d59a80825b9c3f4c9c423fed5d3a...599f2849bad898c5dfd212e0629f79783f75b700,6,126,10,136,8,2011-12-30 19:14:05,2011-12-26 17:37:31
599f2849bad898c5dfd212e0629f79783f75b700...e459253815086d6563d359f480d867557598dabf,1,0,3,3,1,2011-12-30 19:14:05,2011-12-29 12:12:51
e459253815086d6563d359f480d867557598dabf...ee3f96d4e097026f045022887acaf541ff73687d,1,13,6,19,6,2011-12-30 19:14:05,2011-12-29 14:06:36
ee3f96d4e097026f045022887acaf541ff73687d...1f783edf1746cb0254b6e28299dbe106bf8bbe69,1,15,10,25,9,2011-12-30 19:14:05,2011-12-29 14:03:38
1f783edf1746cb0254b6e28299dbe106bf8bbe69...0fb3fba123d8fbd99a9e1f9f47c192c704daee24,1,14,4,18,7,2011-12-30 19:14:05,2011-12-29 09:37:28
06fcf057b6da37ffd388e4a31c2671b20d0dd21e...eb8de7476b4d3caeac518ff9af459c49cfd78e35,7,66,51,117,15,2011-12-28 19:25:29,2011-12-28 19:24:58
eb8de7476b4d3caeac518ff9af459c49cfd78e35...459e2dcd7deb379b9a013ab70aa70206fc17f16a,5,66,3,69,7,2011-12-28 19:31:11,2011-12-27 10:18:57
459e2dcd7deb379b9a013ab70aa70206fc17f16a...2017a15d6ca7f756dcf036499a02e15393609c83,5,103,26,129,15,2011-12-28 19:35:09,2011-12-27 15:03:28
2017a15d6ca7f756dcf036499a02e15393609c83...e2580375dc76f46dce9963225449fcc872e86b0b,4,64,23,87,18,2011-12-28 19:40:08,2011-12-28 10:36:18
9206976fc7cf2daa2db475a6b8fd03a838622112...a75770febc21f2ef0d47a49694f66e8b0f1316a6,3,72,2,74,3,2012-10-10 22:19:54,2012-10-10 12:57:05
6f6b0c013c6eff2aca2a7ada1027044f2e20f578...94155e2fa25c2972032431a4260d919354dda19b,1,3,0,3,2,2012-10-25 19:51:08,2012-10-25 19:51:08
6f6b0c013c6eff2aca2a7ada1027044f2e20f578...93cf7bb8e26a04d9bd4197c1b938cee352023f63,4,194,0,194,4,2012-10-25 03:56:32,2012-10-25 03:56:32
93cf7bb8e26a04d9bd4197c1b938cee352023f63...3943dc78a5c67c1db367c4e13a79884ef72f7f3b,1,11,4,15,5,2012-10-25 18:12:56,2012-10-25 18:12:56
3943dc78a5c67c1db367c4e13a79884ef72f7f3b...cb7180a6e2bb7e5912c16d2109f273c75731a607,2,41,14,55,10,2012-10-25 18:48:39,2012-10-25 18:48:39
6f6b0c013c6eff2aca2a7ada1027044f2e20f578...632d8b230bf38cc61cd70b55a54ae2f52502b4af,9,217,4,221,19,2012-10-25 01:24:37,2012-10-23 20:42:09
632d8b230bf38cc61cd70b55a54ae2f52502b4af...03bdb2addd02948e0e42b509e5c26c6eb5e7e1de,3,5,1,6,3,2012-10-25 01:24:37,2012-10-23 21:32:01
6f6b0c013c6eff2aca2a7ada1027044f2e20f578...e4c2e006ca8c1faf80754511fce7d2d0678e8e7f,2,2,0,2,2,2012-10-25 00:23:59,2012-10-24 22:25:17
e4c2e006ca8c1faf80754511fce7d2d0678e8e7f...bb3b305281085e563408ba51b16dd3d1107fb79f,1,1,0,1,1,2012-10-25 01:22:38,2012-10-25 00:46:03
bb3b305281085e563408ba51b16dd3d1107fb79f...3728dfc0568e77e8aa5fc427306544b3171d8d6c,1,1,1,2,1,2012-10-25 03:05:04,2012-10-25 03:05:04
350b83b67d6dfc7f5cff5065aa0cf46f2bc00468...9795a40f886db0e9b700252e08d34d0b37ff8ecb,3,8,8,16,7,2012-10-19 23:56:35,2012-10-19 14:33:13
9795a40f886db0e9b700252e08d34d0b37ff8ecb...291f7122927d2cc170dc63c378a08fa78515d987,1,1,1,2,2,2012-10-19 23:57:02,2012-10-19 20:34:00
291f7122927d2cc170dc63c378a08fa78515d987...88e0fc05d6ae625b43cc5a6cd61d12624fb93b89,1,0,5,5,1,2012-10-19 23:59:40,2012-10-19 23:59:40
350b83b67d6dfc7f5cff5065aa0cf46f2bc00468...0d422ec9c282added2aaa2a6bc0ea660e33f8f3a,2,106,69,175,32,2012-10-19 22:40:43,2012-10-19 22:40:43
350b83b67d6dfc7f5cff5065aa0cf46f2bc00468...1a2344023506970b78eb7734de2921d02356ae5a,1,1,1,2,1,2012-10-19 21:05:55,2012-10-19 21:05:55
2df37f42c15ac74cb27bbd38e0f896159acd4d19...8dd0bef92116fe365302f2139d28dbeb28e16e9d,1,0,1,1,1,2012-10-19 18:35:12,2012-10-19 10:03:48
8dd0bef92116fe365302f2139d28dbeb28e16e9d...0532e7bb87713921f34f24ba5599d3b4d2922e1e,2,10,5,15,5,2012-10-19 19:23:22,2012-10-19 18:34:33
0532e7bb87713921f34f24ba5599d3b4d2922e1e...c4f68b3503ea37fc179fccfc49bb17469bd7ff70,1,1,0,1,1,2012-10-19 19:23:34,2012-10-19 09:04:32
c4f68b3503ea37fc179fccfc49bb17469bd7ff70...8b05bea87042010c2d9c71d0be17f45bf5bea2a3,9,117,20,137,23,2012-10-19 20:01:53,2012-10-19 15:07:39
b2b571ce0c2969bdc00bfa400d20da5cdece1dcd...5912d74c69fb1cbfcb5f57261543d8b7afcedef1,3,49,10,59,7,2012-10-18 21:05:33,2012-10-18 20:25:27
1362a983165abb5e85e66c2b0474157ba697966a...3ae0aad75a035956e1e35bff226edbf541f17835,1,4,4,8,3,2012-11-02 17:42:20,2012-11-02 17:42:20
f2114d0a35b95efef294f7527dfd64fbef61d993...948431aa013b010ccf6b7f6811da9209d784c1a0,1,0,1,1,1,2012-01-05 23:00:46,2012-01-05 23:00:46
948431aa013b010ccf6b7f6811da9209d784c1a0...2d8405025d2037ab5d474b5bb5fbff7b346adce2,1,1,1,2,1,2012-01-05 23:03:42,2012-01-05 23:03:42
2d8405025d2037ab5d474b5bb5fbff7b346adce2...fa3cb0dae079f0f0d4b3f7e6e5eb560627e97eac,1,7,1,8,2,2012-01-05 23:15:43,2012-01-05 23:15:43
f2114d0a35b95efef294f7527dfd64fbef61d993...671bbdd37227d3466ba9a8e1ad0cc6c46c701967,1,2,2,4,2,2012-01-05 22:31:13,2012-01-05 22:31:13
671bbdd37227d3466ba9a8e1ad0cc6c46c701967...91d46f8df3802245a5bc200fb57d9f2076c280b4,3,4,0,4,3,2012-01-06 00:13:08,2012-01-06 00:13:08
a75770febc21f2ef0d47a49694f66e8b0f1316a6...26127ea764f8cfec17a07e2f4109bce5944e1599,1,2,0,2,1,2012-10-11 16:22:00,2012-10-11 16:22:00
a75770febc21f2ef0d47a49694f66e8b0f1316a6...b46708aaf953df11fa62fe1c718b794c874873ff,7,60,9,69,8,2012-10-11 12:04:08,2012-10-11 12:04:08
a75770febc21f2ef0d47a49694f66e8b0f1316a6...3548fcf5627c56cbbddaf82715e198ed8e4c7873,2,13,2,15,2,2012-10-11 12:00:26,2012-10-11 12:00:26
3548fcf5627c56cbbddaf82715e198ed8e4c7873...62993b61586be9d838e52fef3b7e01ec3abd8c35,2,5,6,11,3,2012-10-11 12:08:32,2012-10-11 12:08:32
62993b61586be9d838e52fef3b7e01ec3abd8c35...6251de1d17bdc039cef61d333236b6f42e0d653d,1,1,1,2,1,2012-10-11 12:09:27,2012-10-11 12:09:27
6251de1d17bdc039cef61d333236b6f42e0d653d...b73200c1ed55941bf165e1f10b5e42c7608d3f18,1,2,2,4,2,2012-10-11 12:15:40,2012-10-11 12:15:40
8bba3c95b8a7eb01d9ee9d68cd3bf0cc38fbd867...00e161b977e9ca8529736e8222dff50111b6f898,1,2,0,2,1,2012-10-27 09:43:48,2012-10-26 20:09:28
00e161b977e9ca8529736e8222dff50111b6f898...31966d20e3fcfb7283884e477fbbaf0cffd81c37,5,98,15,113,15,2012-10-27 14:45:59,2012-10-27 07:30:03
8bba3c95b8a7eb01d9ee9d68cd3bf0cc38fbd867...a0ce87c51c1a3b1b3b674902148ad28d8e5fa32d,1,1,0,1,1,2012-10-26 20:43:13,2012-10-26 20:43:13
8bba3c95b8a7eb01d9ee9d68cd3bf0cc38fbd867...65d12df5256d4b8c76fdffbf7137ff9cfff2d787,2,65,65,130,2,2012-10-26 19:01:58,2012-10-03 13:04:59
65d12df5256d4b8c76fdffbf7137ff9cfff2d787...f7ae3f7531ab4afbcd88b190c7c267541dabb032,1,3,3,6,1,2012-10-26 19:01:59,2012-10-08 14:23:15
f7ae3f7531ab4afbcd88b190c7c267541dabb032...d2aa6de7224552f648887950fec8c2f55629526d,1,3,0,3,1,2012-10-26 19:02:00,2012-10-03 11:56:13
d2aa6de7224552f648887950fec8c2f55629526d...27e3c58392a53a66a4b914d570a0af87a3a58c68,1,4,1,5,1,2012-10-26 19:02:00,2012-10-03 13:12:42
27e3c58392a53a66a4b914d570a0af87a3a58c68...1f87fa35951d6369bfab722a656ed43365b3579f,2,21,30,51,14,2012-10-26 19:02:01,2012-10-09 16:29:26
1f87fa35951d6369bfab722a656ed43365b3579f...b1be9dd0e53d25d0dc4dd4a5296e1cffd7e96bf0,2,13,0,13,2,2012-10-26 19:02:04,2012-10-03 10:09:17
b1be9dd0e53d25d0dc4dd4a5296e1cffd7e96bf0...4ea0a0ca052f9ce9bf6f04ba21b73d57d69bd890,1,3,0,3,1,2012-10-26 19:02:05,2012-06-29 20:59:58
4ea0a0ca052f9ce9bf6f04ba21b73d57d69bd890...eb44cfe07b16e5680c50c13cee79859455b90803,1,1,0,1,1,2012-10-26 19:02:06,2012-10-08 13:49:31
eb44cfe07b16e5680c50c13cee79859455b90803...590fb68be087ed8a60323026dc2501c456ede945,6,1089,0,1089,6,2012-10-26 20:10:48,2012-10-04 11:47:45
590fb68be087ed8a60323026dc2501c456ede945...233884131d123432d2e1ad7236ad3c6ef7b2b518,3,201,0,201,3,2012-10-26 20:11:09,2012-10-04 13:13:43
233884131d123432d2e1ad7236ad3c6ef7b2b518...e4c64cf2aa77a97824db4d2700ca507278ef857d,4,182,1,183,4,2012-10-26 20:11:15,2012-10-08 18:07:55
efde422553e1181933d0bc9d7112740e858a847b...3dfed9cb86a54bc8266057ef62b99f5d889f4efc,3,45,2,47,8,2012-11-01 05:21:49,2012-10-31 09:26:04
3dfed9cb86a54bc8266057ef62b99f5d889f4efc...b4b935d8abd52e00f08518f39b6c59aab73926ce,2,24,0,24,2,2012-11-01 05:21:49,2012-10-31 09:43:08
efde422553e1181933d0bc9d7112740e858a847b...c48e87006cce65a8b69f60e0a38a9ac18b82366d,1,1,0,1,1,2012-10-31 17:13:57,2012-10-31 17:13:57
c48e87006cce65a8b69f60e0a38a9ac18b82366d...a9db123b09e8af94d33cccf30c908701dd491fa7,1,0,2,2,1,2012-10-31 17:14:13,2012-10-31 17:14:13
efde422553e1181933d0bc9d7112740e858a847b...744cc03e2b6d77712bfcb504c272d2e646da650c,12,245,41,286,40,2012-10-30 19:11:23,2012-10-30 19:10:36
744cc03e2b6d77712bfcb504c272d2e646da650c...c8b511f3cdb3f7fa63600b36bb2412099998a805,4,57,31,88,18,2012-10-31 18:26:12,2012-10-31 18:26:12
c8b511f3cdb3f7fa63600b36bb2412099998a805...c1f61af66b35533ee8268e615de6ded74b2ce342,4,15,15,30,11,2012-10-31 19:52:01,2012-10-31 19:52:01
5edb846e03961cac06d1aab4cb5e2329936837f1...0b98a8a4246c9a7825df6c90a1553e799d68146d,4,90,0,90,6,2012-10-25 15:42:31,2012-09-07 13:13:11
0b98a8a4246c9a7825df6c90a1553e799d68146d...383f164a09e46e7f5008073d00504a43478e0564,2,80,12,92,17,2012-10-25 15:42:31,2012-09-07 15:55:30
383f164a09e46e7f5008073d00504a43478e0564...aba70781771061e8f6df78f2af3f9ac395dd5f57,3,113,87,200,12,2012-10-25 15:42:32,2012-09-11 16:11:26
aba70781771061e8f6df78f2af3f9ac395dd5f57...e497b16c571fc807e8d959eda3ac1f4a61cab921,2,55,5,60,7,2012-10-25 15:42:33,2012-09-17 12:22:18
e497b16c571fc807e8d959eda3ac1f4a61cab921...4fe5520a10eba1509d41daa4bacf3da9a8580d9b,1,48,27,75,8,2012-10-25 15:42:33,2012-09-17 15:46:58
4fe5520a10eba1509d41daa4bacf3da9a8580d9b...fb39b3a54cfedd1e414dc86f6ff5f9af9190c97b,3,17,7,24,5,2012-10-25 15:42:34,2012-10-02 12:36:59
fb39b3a54cfedd1e414dc86f6ff5f9af9190c97b...3a14d3e2bca4f1af7de978decda1c7ca74ffd3bf,3,146,0,146,3,2012-10-25 15:42:35,2012-10-01 09:58:15
3a14d3e2bca4f1af7de978decda1c7ca74ffd3bf...fcccf3045f6fbeae5139af7263c2ab986818f154,5,524,0,524,5,2012-10-25 15:42:36,2012-09-09 18:39:13
5d4cdb0494267fc778eaa0f587978e1b25564dcd...5cf1b4f094eb6f724b27aa01d4f0481de2e673af,1,1,2,3,2,2012-11-22 16:16:35,2012-11-22 16:16:35
c497a63bd6ac0f07b06b18e4891771fdbcd31dd6...cfa6465cc4e7eead98b8729c556e9172c2e08a79,1,10,1,11,3,2012-10-22 13:08:09,2012-10-22 13:08:09
c497a63bd6ac0f07b06b18e4891771fdbcd31dd6...209e34fa7068615b96324a4243a49b030b0c7156,3,13,25,38,9,2012-10-20 10:01:04,2012-10-20 08:44:01
209e34fa7068615b96324a4243a49b030b0c7156...cd1ef82253b5f4242ed9aed5e9abf7bceb33ec04,6,26,28,54,16,2012-10-20 10:07:53,2012-10-20 10:07:53
cd1ef82253b5f4242ed9aed5e9abf7bceb33ec04...c436ed26e08fde69579d5d0ac31e775cfbd06290,2,61,6,67,6,2012-10-22 17:46:00,2012-10-20 10:09:02
c436ed26e08fde69579d5d0ac31e775cfbd06290...f36fb761dce7c0f6c6924d9ce30c9cad72dc1318,1,9,0,9,1,2012-10-22 17:46:00,2012-10-20 17:23:04
c497a63bd6ac0f07b06b18e4891771fdbcd31dd6...92f91b0e3bc3b7799b2b18ea07b167ad191a47a9,1,12,10,22,2,2012-10-20 02:34:14,2012-10-16 19:41:20
92f91b0e3bc3b7799b2b18ea07b167ad191a47a9...3028be0723f42f31b1973da9f19f2b0468b11754,7,11,11,22,12,2012-10-20 02:34:14,2012-10-16 20:10:27
3028be0723f42f31b1973da9f19f2b0468b11754...d57c47dc07044b4fd3f5e9d57615329692823111,3,19,9,28,11,2012-10-20 02:34:15,2012-10-16 20:29:12
d57c47dc07044b4fd3f5e9d57615329692823111...2c8bbb27d91ec35162522079d632608fcaac2a57,5,54,43,97,32,2012-10-20 02:34:15,2012-10-17 03:16:21
2c8bbb27d91ec35162522079d632608fcaac2a57...806426565f78ff0ee0ac12e125d59658e3ef34be,4,27,16,43,13,2012-10-20 02:36:21,2012-10-17 03:23:10
806426565f78ff0ee0ac12e125d59658e3ef34be...183d8bddeb859a27ee688dac53ea26ccc547d05c,4,22,16,38,20,2012-10-20 02:36:22,2012-10-17 03:33:48
183d8bddeb859a27ee688dac53ea26ccc547d05c...1f7c74187328e6661fc3cab88b5d6fddf83bdf0d,1,0,1,1,1,2012-10-20 02:36:22,2012-10-17 17:15:07
1f7c74187328e6661fc3cab88b5d6fddf83bdf0d...2b7efe03406411dd8fe25bcc15b0783313097692,1,2,3,5,2,2012-10-20 02:36:22,2012-10-17 17:15:51
2b7efe03406411dd8fe25bcc15b0783313097692...0ae81fc479bf3cf7ed31b3e3b070de7990102f1d,7,10,20,30,13,2012-10-20 02:36:22,2012-10-17 13:30:22
0ae81fc479bf3cf7ed31b3e3b070de7990102f1d...216863c48fd05b08e9b0083d61dcb163a2add62a,8,79,13,92,25,2012-10-20 02:36:22,2012-10-17 21:02:24
216863c48fd05b08e9b0083d61dcb163a2add62a...7635a1188a963f2fd7136a957ab9ab65baeff866,2,2,2,4,2,2012-10-20 02:36:22,2012-10-17 21:06:32
7635a1188a963f2fd7136a957ab9ab65baeff866...9c3a98f1b0de30ff33969e2af5b90ed448c42389,1,11,9,20,2,2012-10-20 02:36:22,2012-10-18 16:57:19
9c3a98f1b0de30ff33969e2af5b90ed448c42389...aa1e86741dcd314212f738b408e507de1771fedd,5,99,72,171,38,2012-10-20 02:36:22,2012-10-18 19:57:47
aa1e86741dcd314212f738b408e507de1771fedd...30a46ab1a9464fe92860b29306efb99e50c0d226,2,1,3,4,3,2012-10-20 02:36:22,2012-10-18 21:04:14
30a46ab1a9464fe92860b29306efb99e50c0d226...45b60d7b8db79da18cecfd667dc7051f31dc8fe6,2,38,11,49,16,2012-10-20 02:36:22,2012-10-18 22:17:12
45b60d7b8db79da18cecfd667dc7051f31dc8fe6...909f626541a78cad0366ba85c04f29522bb47da7,1,1,0,1,1,2012-10-20 02:36:23,2012-10-18 22:28:09
909f626541a78cad0366ba85c04f29522bb47da7...25e8b20169a6f6919ad49cf32220975ab96b35c8,2,10,10,20,8,2012-10-20 02:36:23,2012-10-18 22:35:03
25e8b20169a6f6919ad49cf32220975ab96b35c8...7bcd9e23e8f64c8622e9213ee0fa3d75d058053b,6,44,4,48,11,2012-10-20 02:36:23,2012-10-20 02:23:32
7bcd9e23e8f64c8622e9213ee0fa3d75d058053b...63afb005e86d49e0f84d135d3d8dddae085a003f,1,8,12,20,11,2012-10-20 02:36:23,2012-10-20 02:33:23
63afb005e86d49e0f84d135d3d8dddae085a003f...cd001bbbfe75a366d9658849cf6c5931440c0c01,1,1,1,2,1,2012-10-20 02:37:47,2012-10-20 02:37:47
cd001bbbfe75a366d9658849cf6c5931440c0c01...9c05c17b7ac7caf7691a9056994bda735ea31c81,6,30,25,55,23,2012-10-20 03:05:18,2012-10-20 03:05:18
9c05c17b7ac7caf7691a9056994bda735ea31c81...2dae54a9419aaeb9d3d6a8eb6a28e13edb41bd58,2,8,10,18,5,2012-10-20 03:24:15,2012-10-20 03:24:15
2dae54a9419aaeb9d3d6a8eb6a28e13edb41bd58...c70ad945cdf9b92e54e7e8a5769b1f35ea19ebbd,2,11,4,15,3,2012-10-23 16:23:44,2012-10-23 16:21:32
c70ad945cdf9b92e54e7e8a5769b1f35ea19ebbd...c4958e6818399f401f03986db8772016a97377d7,1,2,1,3,1,2012-10-24 19:38:05,2012-10-24 19:38:05
c4958e6818399f401f03986db8772016a97377d7...7d222e13121aebc269b2923a66c7ba5b734e1a90,15,59,59,118,48,2012-10-24 20:29:14,2012-10-24 20:29:14
7d222e13121aebc269b2923a66c7ba5b734e1a90...9762ad993dc1afff90a3d14751f1b1f666ad0c95,3,17,14,31,12,2012-10-24 20:43:23,2012-10-24 20:43:23
9762ad993dc1afff90a3d14751f1b1f666ad0c95...1e3b8ed5cfe784f73a123c33c90f573742d8839e,8,12,29,41,27,2012-10-24 21:07:07,2012-10-24 21:07:07
cf028856bcfca6d047d04856af9be38b1dd772bc...875b16eb54b72d9e0471230e93e59160696036c4,1,1,1,2,1,2012-10-19 21:44:49,2012-10-19 21:44:49
1e99ce9ac7d7a73f629327d020034e4b2ed1374c...83885891f583ab447f98f1c7a637f1f507e1be22,1,5,0,5,1,2012-11-05 06:01:24,2012-11-05 06:01:24
83885891f583ab447f98f1c7a637f1f507e1be22...a2a618948c38d381a741c5799b87f7ff62da8c65,2,11,2,13,4,2012-11-05 07:08:17,2012-11-05 06:49:37
a2a618948c38d381a741c5799b87f7ff62da8c65...f8baece754d24a6121d701e2bad1922c61cffe71,1,1,0,1,1,2012-11-05 18:42:10,2012-11-05 18:42:10
f8baece754d24a6121d701e2bad1922c61cffe71...1fe99aeea3d9e2a5b9637f3d76273335e6366e36,1,1,0,1,1,2012-11-05 18:44:48,2012-11-05 18:44:48
1fe99aeea3d9e2a5b9637f3d76273335e6366e36...f358ec143c8c9952227d31cd21c24f8c9be23d3c,1,2,2,4,2,2012-11-05 18:45:26,2012-11-05 18:45:26
f358ec143c8c9952227d31cd21c24f8c9be23d3c...6edefa149126955dbdf1c866ef5b2ec85be5031a,1,2,2,4,2,2012-11-05 18:58:13,2012-11-05 18:58:08
6edefa149126955dbdf1c866ef5b2ec85be5031a...c1cd036e409b874932f3da83624809e0a9bc9b47,1,1,1,2,1,2012-11-05 19:01:00,2012-11-05 19:01:00
1e99ce9ac7d7a73f629327d020034e4b2ed1374c...35d255fda66abffc58d2c7a847aa86840727b4a0,2,0,5,5,2,2012-11-04 18:13:42,2012-11-04 18:13:42
35d255fda66abffc58d2c7a847aa86840727b4a0...221ee54b8ce67efb0346b7ace67728a14babfcac,1,1,1,2,1,2012-11-05 03:24:14,2012-11-05 03:24:14
1d175074969ea47fdaca95cf9912fa2e74aa156e...7e443f696068cd8c84a759e532c2845348e5a6ad,1,5,11,16,3,2012-01-09 23:46:06,2012-01-09 23:46:06
80a6e86bb626acbf19088a9c8e780ebf151cd040...9d9288f417968a7fd583786a749c4f7dfa258f89,1,1,1,2,1,2012-10-14 16:29:05,2012-10-14 16:29:05
9d9288f417968a7fd583786a749c4f7dfa258f89...47f44b6ee424921cf5aef064fe6ecf768c6ec5ea,3,21,3,24,4,2012-10-15 12:00:19,2012-10-15 11:51:25
47f44b6ee424921cf5aef064fe6ecf768c6ec5ea...7ae5ab5696d1810eeb4583ef77145edccdb41308,2,2,2,4,3,2012-10-15 14:35:10,2012-10-15 14:35:10
a0ce87c51c1a3b1b3b674902148ad28d8e5fa32d...41fb1ca0ec51ad1d2a14b911aab3215e42965d1b,27,2501,1559,4060,326,2012-11-01 13:02:33,2012-10-29 17:41:14
41fb1ca0ec51ad1d2a14b911aab3215e42965d1b...0ccfc63bd6f0759705001432a5e42d5f56650967,1,18,1,19,5,2012-11-01 14:29:30,2012-11-01 14:29:30
0ccfc63bd6f0759705001432a5e42d5f56650967...e068f2bb71c647c19713fd9fb53596c7eeddc777,1,5,1,6,1,2012-11-01 15:50:08,2012-11-01 15:50:08
e068f2bb71c647c19713fd9fb53596c7eeddc777...ff830366ea611c9285a23432edebc16ff6a3d436,1,3,1,4,2,2012-11-01 16:07:42,2012-11-01 16:07:42
a0ce87c51c1a3b1b3b674902148ad28d8e5fa32d...2df7c94490c4bf3693f8ad2fa3d7231a1fa4f789,1,1,1,2,2,2012-10-27 22:30:08,2012-10-27 22:25:43
2df7c94490c4bf3693f8ad2fa3d7231a1fa4f789...54c56d3efd572f647ced5ac9a999b55c5983ced6,1,1,1,2,1,2012-10-27 22:42:54,2012-10-27 22:42:54
54c56d3efd572f647ced5ac9a999b55c5983ced6...4a3be934decde9a7bda9483a5750f73ff5425675,1,0,1,1,1,2012-10-27 22:56:18,2012-10-27 22:56:18
4a3be934decde9a7bda9483a5750f73ff5425675...88149fae9f004733b0b9829a1296afa5b3593c77,1,9,4,13,1,2012-10-27 23:21:28,2012-10-27 23:21:28
1eb8cd7f879dbd2fc3c3c0d341f4dd6ed636b97b...1fc375e6ef0d490305ef973278aa96756835b6a5,5,6,6,12,11,2012-10-25 16:02:55,2012-10-25 16:02:55
1fc375e6ef0d490305ef973278aa96756835b6a5...67dad09bdb05f3668dafef2f17e7d70e88870a71,1,1,1,2,1,2012-10-25 16:59:49,2012-10-25 16:59:49
67dad09bdb05f3668dafef2f17e7d70e88870a71...505f37b41a7d80c539a33d28aec947cd87bb1b6c,1,1,1,2,1,2012-10-25 17:22:35,2012-10-25 17:22:35
5cf1b4f094eb6f724b27aa01d4f0481de2e673af...826bc4a81b9c8ce29ff2f98195fb913bada573ca,7,16,16,32,15,2012-11-23 13:31:22,2012-11-23 13:31:22
5cf1b4f094eb6f724b27aa01d4f0481de2e673af...9094d30b932ca4b47dba81e76011efe05455a44a,53,153,15,168,92,2012-11-23 10:41:56,2012-11-23 10:41:56
a5e85d86b7e13352c553b0a43bc36fee5880b5c7...091361f569dd86e8550c04afb193bfb516a21a74,10,569,96,665,76,2012-11-06 13:52:03,2012-11-06 13:52:03
091361f569dd86e8550c04afb193bfb516a21a74...2f7538ec00e8391c156bcdd64ae6dbb558758afe,2,9,3,12,5,2012-11-06 14:36:04,2012-11-06 14:36:04
2f7538ec00e8391c156bcdd64ae6dbb558758afe...11fa84728312aecdd8bc038cebd3458ec162e603,2,16,24,40,8,2012-11-06 16:27:23,2012-11-06 16:27:23
a5e85d86b7e13352c553b0a43bc36fee5880b5c7...09cc0b92dc60c726180cda36643e263c32d9a812,7,150,21,171,24,2012-11-05 22:00:29,2012-11-05 17:33:10
7e443f696068cd8c84a759e532c2845348e5a6ad...2866c016853b5e5006d3e02758cbb8d9e1857347,1,1,1,2,1,2012-01-13 17:20:13,2012-01-13 17:20:13
2866c016853b5e5006d3e02758cbb8d9e1857347...c1c399cf27fbb085e402afd6a405b1c24ddee478,1,4,2,6,2,2012-01-13 18:33:54,2012-01-13 18:33:54
c1c399cf27fbb085e402afd6a405b1c24ddee478...1af56d7d7eae77525b84815858cc2de9c0aa60d8,1,1,8,9,2,2012-01-15 23:48:36,2012-01-15 23:48:36
1af56d7d7eae77525b84815858cc2de9c0aa60d8...d9e5430e5a7bd5d2de7c4fee2f1afbd52ec5aa2f,1,1,1,2,1,2012-01-16 10:46:49,2012-01-16 10:45:34
7e443f696068cd8c84a759e532c2845348e5a6ad...df743c7d3a04553ffc04ae7cbc64fb300e7f61d2,20,500,126,626,99,2012-01-11 22:39:51,2012-01-09 23:37:19
df743c7d3a04553ffc04ae7cbc64fb300e7f61d2...fdaa924037b66ee898fab503836a3d67194efacc,1,9,3,12,9,2012-01-11 23:25:13,2012-01-11 23:25:13
fdaa924037b66ee898fab503836a3d67194efacc...6a67a812c224878483659c6f25ca21573d1c309b,7,57,8,65,10,2012-01-12 00:01:48,2012-01-12 00:01:48
6a67a812c224878483659c6f25ca21573d1c309b...15debaf5da2821e6f97038218b46d9fb3c755631,1,2,1,3,1,2012-01-12 01:28:25,2012-01-12 01:28:25
15debaf5da2821e6f97038218b46d9fb3c755631...0cfcff5daac50d5a4ba41d5125b108cdfceed832,5,106,46,152,16,2012-01-12 04:41:55,2012-01-12 04:41:55
0cfcff5daac50d5a4ba41d5125b108cdfceed832...1dbcc9fc4e6f5264d5bb46f6d7f744eb4a4063e4,5,30,43,73,20,2012-01-12 07:21:46,2012-01-12 05:07:16
1dbcc9fc4e6f5264d5bb46f6d7f744eb4a4063e4...cfbc880d8a407bcd2074dda4221d337daf72195c,9,46,28,74,13,2012-01-16 23:16:44,2012-01-16 23:16:44
7ae5ab5696d1810eeb4583ef77145edccdb41308...65415ea275306ebe0de2bdde6f15b639fa90e470,2,80,66,146,10,2012-10-15 17:48:17,2012-10-10 17:34:26
65415ea275306ebe0de2bdde6f15b639fa90e470...86a2da6e8add86075db164662d2ec435c75ede56,2,3,3,6,2,2012-10-15 17:48:17,2012-10-10 22:10:07
ff830366ea611c9285a23432edebc16ff6a3d436...8f624a47260788f3974f185d992272d21ef94036,1,19,30,49,9,2012-11-02 15:30:55,2012-11-02 15:30:55
63e44d5e9baa68a0b6e5cfa7770b67b3ed651774...81eecc342b3580e9b05e501c8ee75c7e2e0dca1a,2,7,7,14,5,2012-10-29 20:34:14,2012-10-29 20:34:14
7ae73e94dbbb4249f26dd5d0a21d25e1dc4667ca...c902f5a0fffaf1d3e917d8b824e9a4fd6ad2d4ac,1,0,4,4,1,2012-11-01 16:26:56,2012-11-01 16:11:24
8a85378829cb3bd417b04cd690da8d7d470b6214...d1a69d0fff03dcd4326adb63aee6464be0cad83f,2,51,2,53,4,2012-11-06 22:22:11,2012-11-06 22:16:53
d1a69d0fff03dcd4326adb63aee6464be0cad83f...345eef23741b98636ab7ac3b1a12fa5178d5912b,6,49,52,101,9,2012-11-07 18:15:09,2012-11-07 18:10:57
9d6412832509ac3fb0217300eefbc75866dd7258...505da062b88b729a90d4bcf31c4075bd0afd3251,2,138,14,152,13,2012-11-09 18:33:05,2012-11-06 18:26:06
505da062b88b729a90d4bcf31c4075bd0afd3251...11fabe73a07ba7c5ef4a713d71b3643c9b0970db,30,124,0,124,9,2012-11-09 18:33:10,2012-11-09 04:18:19
11fabe73a07ba7c5ef4a713d71b3643c9b0970db...90207709a367ef07ecf4087f285d3017031401ab,1,8,7,15,4,2012-11-09 18:33:16,2012-11-09 05:29:17
90207709a367ef07ecf4087f285d3017031401ab...2ff1a0d0f0eb7a214253fea3769c3fe64142446c,5,63,135,198,17,2012-11-10 00:59:46,2012-11-10 00:59:46
2ff1a0d0f0eb7a214253fea3769c3fe64142446c...0f5520f73aeda936f67024411b9c1b34bb09d6ac,1,1,1,2,1,2012-11-12 15:55:09,2012-11-12 15:55:09
0f5520f73aeda936f67024411b9c1b34bb09d6ac...14157652ee83ef67b9376fe5f1c6ff00c539100a,1,0,4,4,3,2012-11-12 15:57:03,2012-11-12 15:57:03
9d6412832509ac3fb0217300eefbc75866dd7258...b0b806588030ad8fec5ca80a3de1af7994694dc4,1,11,4,15,9,2012-11-09 05:28:15,2012-11-09 05:28:15
9d6412832509ac3fb0217300eefbc75866dd7258...29cc374d2e8a73c458805f8e76a286b8b688b80e,1,117,0,117,1,2012-11-08 20:16:45,2012-11-08 16:37:01
29cc374d2e8a73c458805f8e76a286b8b688b80e...7cc1bf0fcb6de212dc50e02ff187880af9103bf4,3,26,0,26,4,2012-11-08 20:16:48,2012-11-08 20:08:59
7cc1bf0fcb6de212dc50e02ff187880af9103bf4...f92bcaea499611bf0e6a71e845a2d74c790ea659,3,54,2,56,6,2012-11-09 15:45:47,2012-11-08 16:39:23
6e03b12f5715cb3f5cb5c8be6512e041cdf44a05...fdc8a7dbeac18554ea0c588310c492a0d050d423,1,1,1,2,1,2012-01-17 13:06:35,2012-01-17 13:06:35
fdc8a7dbeac18554ea0c588310c492a0d050d423...86360ffdf7829d5cd12000067b9e73d3814e2347,1,1,1,2,1,2012-01-17 18:49:58,2012-01-17 13:33:26
86360ffdf7829d5cd12000067b9e73d3814e2347...0b44c06599a446edb7523a9eead207817798111b,1,1,1,2,1,2012-01-17 18:50:25,2012-01-17 13:35:04
6e03b12f5715cb3f5cb5c8be6512e041cdf44a05...a51cd8e6f6724079a552b75e014f792f3f68e158,24,232,105,337,78,2012-01-17 00:58:27,2012-01-17 00:58:27
a51cd8e6f6724079a552b75e014f792f3f68e158...83bfbdf593a76c591bb9cbd40cec6fca36c81a9c,4,13,22,35,4,2012-01-17 02:00:18,2012-01-17 02:00:18
1ddc537c779a5796c4ed1d5fc2e41bd38cdeb394...fa5d94a0d4d9bbdd167443f052ad4f1f11541aae,2,19,3,22,2,2012-10-15 18:41:42,2012-10-13 18:51:57
fa5d94a0d4d9bbdd167443f052ad4f1f11541aae...68206c54bf98f36725d21e7f7efee9f3af68d259,3,21,9,30,9,2012-10-15 18:41:43,2012-10-13 19:00:45
1ddc537c779a5796c4ed1d5fc2e41bd38cdeb394...4d968f134b8ccd20e5a5b26ee160372076c55f5c,3,49,5,54,5,2012-10-15 18:40:37,2012-10-15 04:12:57
4d968f134b8ccd20e5a5b26ee160372076c55f5c...c4f68b3202f017dc3a52aec3c0e56b3b908923d2,2,9,1,10,5,2012-10-15 18:40:37,2012-10-15 05:06:22
81eecc342b3580e9b05e501c8ee75c7e2e0dca1a...6cfbbf7e3205e902bd94bf16743127c705e3e588,3,5,3,8,4,2012-10-30 17:50:59,2012-10-30 17:50:59
81eecc342b3580e9b05e501c8ee75c7e2e0dca1a...f45ec1a076e2347ba5d63eeb2d158f87b612e5cb,76,1480,267,1747,213,2012-10-30 01:04:21,2012-10-30 01:04:21
da0bfb6728df127e18fa2933b839b5920a84397a...dbd6850d06111eb0761499d7c876ff7cd4ad57fa,1,3,0,3,1,2012-11-01 17:57:14,2012-11-01 17:57:14
19c044a17dc4a4fcc552d88ea318062782955a13...9a50026b19d95b16a2e0c33560180f157ad86dd3,1,1,1,2,1,2012-11-12 23:38:28,2012-11-12 23:38:28
d18713fb4ad1ba3d18a75272e1c1c3eb45715aba...b0f6e45d149c033c9fe41d49af2a87d169d11f40,12,542,3,545,22,2012-11-11 17:56:33,2012-11-01 20:47:18
d1317f1b69cafb328ca9b263b2b71cddeb2290be...1744fafec05d8fa3036a43f5e390c790810b05a5,27,403,339,742,106,2012-01-17 23:49:47,2012-01-17 23:49:47
63ab73bec0a54300a48355ee28dd24ebd39e2cd2...19313a76b66c7af027f21340d7055dd9ba7dcd0c,1,33,0,33,1,2012-01-23 20:27:29,2012-01-23 20:27:29
19313a76b66c7af027f21340d7055dd9ba7dcd0c...a9fe8ae0ee1ddcc289fad53f1a671f02a3e9a88f,1,2,12,14,3,2012-01-23 21:14:04,2012-01-23 21:14:04
1c3acf148b97c952fcb942a73cda9f891f04f1b5...824d5e4d260fc740dbe9251008439b9e58db5f19,5,1,8,9,3,2012-10-15 19:54:46,2012-10-11 18:58:00
824d5e4d260fc740dbe9251008439b9e58db5f19...d5a51910678f8aea2b7efe077efc678141762dfc,2,20,7,27,7,2012-10-15 19:54:46,2012-10-11 20:39:53
d5a51910678f8aea2b7efe077efc678141762dfc...52032ae53689ac37350f6af3bf1834122e4b3cf0,11,215,27,242,23,2012-10-15 19:54:46,2012-10-15 19:48:43
71b79a0aabef6057e441bb5171f432a0fbcf774a...add5efe7e9049c509d857d4ec2b93a64b0a95cb9,1,9,0,9,4,2012-10-15 22:49:05,2012-10-15 22:49:05
473a7a1e70d05ec125309304d56f060c3e3ad40e...438906e160896f54620c86492ef5659a7fc129ee,1,15,8,23,7,2012-11-02 18:34:06,2012-11-02 18:34:06
dbd6850d06111eb0761499d7c876ff7cd4ad57fa...b90500f03d3ae60f1f79d7adb36d95632a29d7e5,8,306,227,533,85,2012-11-01 21:08:30,2012-11-01 21:08:30
dbd6850d06111eb0761499d7c876ff7cd4ad57fa...8ff0f3250a62a128fb68ce3fae1719549a3fe47a,2,18,20,38,10,2012-11-01 19:17:09,2012-10-31 21:26:57
8ff0f3250a62a128fb68ce3fae1719549a3fe47a...276ea401b3a45c85e49182f39db00ca5447aa340,5,84,32,116,11,2012-11-01 19:17:10,2012-11-01 19:15:53
276ea401b3a45c85e49182f39db00ca5447aa340...43eeca04a7fe00332fe8c4723e29fa82a5304b13,6,6,8,14,8,2012-11-01 19:24:43,2012-11-01 19:24:43
43eeca04a7fe00332fe8c4723e29fa82a5304b13...1e808f9cda598fef83ff93deb007212ebf61be6d,2,18,0,18,2,2012-11-01 19:28:28,2012-11-01 19:28:28
c4d8df27bc4d3c0ef5ea46f4953614955fc4bdc2...f2696fa412299cfe9c8db53779af62eb4ffacb02,1,1,1,2,1,2012-11-26 11:12:41,2012-11-26 11:12:41
c4d8df27bc4d3c0ef5ea46f4953614955fc4bdc2...fcb48e068028da7b8cb60ac3954f3e9f5fc38390,1,4,2,6,1,2012-11-24 14:50:51,2012-11-24 14:48:17
8ff2b0c75983160264ee7c45a01bde27cfbc91ea...bcad677ba8e0c0c220b758e2203f5bfe3506bc81,2,4,2,6,3,2012-11-08 11:28:21,2012-11-08 11:28:21
9a50026b19d95b16a2e0c33560180f157ad86dd3...d51e54f1f415fe90e214be2b2ebbe73135b4a563,2,0,2,2,2,2012-11-13 13:28:44,2012-11-13 13:28:44
9a50026b19d95b16a2e0c33560180f157ad86dd3...3dee36557e284003eb5e6f9328c5b40c6f600bdc,1,1,0,1,1,2012-11-13 06:04:30,2012-11-13 06:04:30
3dee36557e284003eb5e6f9328c5b40c6f600bdc...4e547eee31b1ee3a4395b9ba9670af8c29927de7,1,2,0,2,1,2012-11-13 06:12:53,2012-11-13 06:11:24
9a50026b19d95b16a2e0c33560180f157ad86dd3...64ac9548aa837d0ca11eaf667719150867534c25,2,1079,647,1726,266,2012-11-12 23:42:03,2012-11-12 23:42:03
0f674411e9358a9d42ba892e853c6abd2303f296...55f9837f11cae1d9c56e9f81eba3a3b7553ec8dd,2,13,2,15,2,2012-11-09 20:49:50,2012-11-09 20:49:50
0f674411e9358a9d42ba892e853c6abd2303f296...2364735c8fc08615fd868244e9e00143c70c0c22,1,6,5,11,3,2012-11-09 20:39:10,2012-11-09 20:39:10
2364735c8fc08615fd868244e9e00143c70c0c22...2f683f00971239007e1d602ec1a71a1eb10f4f5e,1,4,1,5,3,2012-11-09 20:39:25,2012-11-09 20:39:25
2f683f00971239007e1d602ec1a71a1eb10f4f5e...fcd03bebbfda5cfc76604645edd85fe030349a1b,1,1,0,1,1,2012-11-09 20:57:32,2012-11-09 20:57:32
e090a5681beeef522de34c8ca5d01997e1b76505...ef8871515bcb8af8d690609c086718bcaecbb5c6,1,1,1,2,1,2012-11-11 23:13:02,2012-11-11 22:52:37
ef8871515bcb8af8d690609c086718bcaecbb5c6...b1a3a70ed1ca45bb155ec4c10b40a047d27614f3,7,51,3,54,10,2012-11-11 23:14:51,2012-11-11 23:14:51
1744fafec05d8fa3036a43f5e390c790810b05a5...c3ec2ec262eb72cfc6783316e18aef12fb791d3f,1,1,1,2,1,2012-01-18 23:09:47,2012-01-18 23:09:47
a9fe8ae0ee1ddcc289fad53f1a671f02a3e9a88f...3fd1520cd4d8b4d6b6493a7d3dc393ffd9abf1db,57,1865,387,2252,74,2012-01-25 04:35:15,2012-01-25 04:35:15
3fd1520cd4d8b4d6b6493a7d3dc393ffd9abf1db...32dc20b5af696724753ea54a4dacc3fa479774a1,1,2,2,4,1,2012-01-25 21:57:31,2012-01-25 21:57:31
d13da328e2807e098295bb9bead4d23560c27320...e30c052c4e46df9d8f929ab4f86f34718bb15a5d,1,0,5,5,1,2012-11-01 22:01:42,2012-11-01 22:01:24
8404f2d67f634dd4eb596c78691f8ef606d1e541...9e9aee670591c54379005dbac322d7310e9ea4cf,1,4,0,4,1,2012-11-26 13:29:34,2012-11-26 13:29:34
e45423dd2c5ef8262f70605b81c6da0751d000a3...d6fb09240913c9756de5f4a2462062008ebac252,17,681,138,819,86,2012-11-13 16:23:05,2012-11-05 18:37:15
d6fb09240913c9756de5f4a2462062008ebac252...603bee07918b50051d7bb45722932fc409b38a67,15,90,175,265,72,2012-11-13 16:23:05,2012-11-13 01:22:49
603bee07918b50051d7bb45722932fc409b38a67...7ebefd22e79e92542d68743af933c1a188f4d5a3,8,98,56,154,46,2012-11-13 16:23:05,2012-11-13 16:10:40
7ebefd22e79e92542d68743af933c1a188f4d5a3...a8527429dc48ce0f9b63789715ed8eaa9b1abf0d,7,37,0,37,11,2012-11-13 20:48:10,2012-11-13 20:48:10
a8527429dc48ce0f9b63789715ed8eaa9b1abf0d...2a612fe3c31f2c386236ccb1483741835a5db318,2,17,18,35,9,2012-11-13 20:57:35,2012-11-13 20:57:35
8a328cf442237f65d58ad779d775c77a7c462df5...353e991679824bd2ea146fefab6a25ce6d5577a2,1,3,3,6,2,2012-11-10 15:43:05,2012-11-10 15:43:05
353e991679824bd2ea146fefab6a25ce6d5577a2...69c068c79f5b6d2fe5cf1ca707a130a51939abc2,2,12,1,13,2,2012-11-10 19:42:45,2012-11-10 19:42:45
69c068c79f5b6d2fe5cf1ca707a130a51939abc2...33f95a9b32804958226f5af6a4773199f21fc5ea,3,48,24,72,11,2012-11-10 20:01:05,2012-11-10 20:01:05
33f95a9b32804958226f5af6a4773199f21fc5ea...95d73de15fd25b543e4162599d095ba45f726158,1,1,1,2,1,2012-11-10 20:10:49,2012-11-10 20:10:49
8a328cf442237f65d58ad779d775c77a7c462df5...331e7de9004db5909edd1057db88f63a53dd2d3f,14,194,90,284,55,2012-11-09 21:52:06,2012-10-25 00:32:50
331e7de9004db5909edd1057db88f63a53dd2d3f...32def5af9a951396e626c3e276a0f94683753e3d,2,262,120,382,21,2012-11-09 21:52:06,2012-10-25 00:37:07
32def5af9a951396e626c3e276a0f94683753e3d...18eff2ad7027cb82ccf61b4ae7c4fa8d75c6eace,3,4,4,8,4,2012-11-09 21:52:07,2012-11-09 00:44:39
18eff2ad7027cb82ccf61b4ae7c4fa8d75c6eace...220d5a6c3572574a2fcf8869816390eadebbb792,1,17,10,27,5,2012-11-09 21:52:07,2012-11-09 00:45:25
220d5a6c3572574a2fcf8869816390eadebbb792...2e3d4b96c08f1b0e2ee9b248c53aec523d70fd25,3,220,135,355,29,2012-11-09 21:52:07,2012-11-09 00:47:28
2e3d4b96c08f1b0e2ee9b248c53aec523d70fd25...55cbd05b18960e761a4d237ce5f1ff06455da98d,11,226,127,353,58,2012-11-09 21:52:07,2012-11-09 00:56:34
55cbd05b18960e761a4d237ce5f1ff06455da98d...ad9a921b92a964a0f28a5f0d59079cde5a0ada1e,14,610,226,836,137,2012-11-09 21:52:07,2012-11-09 01:05:07
ad9a921b92a964a0f28a5f0d59079cde5a0ada1e...a1bf70e4c94cea054fe5812344e6e70f13402be6,1,8,9,17,2,2012-11-09 21:52:07,2012-11-09 05:58:24
a1bf70e4c94cea054fe5812344e6e70f13402be6...8064ecba2384df32d5b821398a346f0c96cf74d1,1,46,20,66,4,2012-11-09 21:52:07,2012-11-09 18:48:25
8064ecba2384df32d5b821398a346f0c96cf74d1...0f3def715dc9af442f5f025c50a041c6319df1e8,9,62,42,104,30,2012-11-09 21:52:07,2012-11-09 19:19:46
0f3def715dc9af442f5f025c50a041c6319df1e8...757b406504021b3a73e52ce9f95d590d65c7dce5,7,17,11,28,11,2012-11-09 22:01:44,2012-11-09 22:01:44
43c6dd6fb02ec253b7e8aaf249d0070b253a6c83...585a2eb75adb71cb6bf73e548a23f86b30de2d4a,1,2,1,3,2,2012-01-19 16:05:16,2012-01-19 16:05:16
585a2eb75adb71cb6bf73e548a23f86b30de2d4a...d0ec3fb8f07988779783f69ab6cf5f3431c7aa3e,1,1,1,2,1,2012-01-19 16:07:49,2012-01-19 16:07:49
911ff94eb9b545d6190a2a6e494b07a144345507...9b84447a806911bb93c67533b81f4d121e5ea3f1,2,21,51,72,12,2012-01-25 22:02:08,2012-01-25 11:35:25
9b84447a806911bb93c67533b81f4d121e5ea3f1...5663e61a0658295defd6ef1fd453d91a94a71d45,2,79,7,86,7,2012-01-25 22:05:06,2012-01-25 15:44:21
e30c052c4e46df9d8f929ab4f86f34718bb15a5d...6bb9fea13ee2da6475ac799acd5f8296bc1a8537,11,52,7,59,11,2012-11-02 17:28:17,2012-11-02 17:28:17
e30c052c4e46df9d8f929ab4f86f34718bb15a5d...050cf8b8a691bd7e22b18e2bc330698e4b94bd2c,1,9,3,12,5,2012-11-02 06:01:21,2012-11-02 06:01:21
469827812f95e979e3c6468567b2c9ed138a9849...2508cc66eb91597b12dc19721d9cea1f06e72107,47,226,220,446,213,2012-11-27 21:17:45,2012-11-19 04:38:08
2508cc66eb91597b12dc19721d9cea1f06e72107...cfbe4be3fb639d96587974794fe437ace0c383c4,32,239,250,489,193,2012-11-27 21:18:27,2012-11-18 03:54:47
cfbe4be3fb639d96587974794fe437ace0c383c4...bac695b58c3b013a3ebbfc1909f8adb9967492f8,2,3,3,6,3,2012-11-27 21:18:28,2012-11-19 05:20:26
bac695b58c3b013a3ebbfc1909f8adb9967492f8...3f63cc9e6d7674d1499a4f8f0e4db9eba385c864,1,1,1,2,1,2012-11-27 21:18:28,2012-11-19 05:20:47
3f63cc9e6d7674d1499a4f8f0e4db9eba385c864...824cb2d5e587f13b596933b991c7d8568422946a,3,19,15,34,8,2012-11-27 21:18:28,2012-11-20 20:13:52
824cb2d5e587f13b596933b991c7d8568422946a...e120123e369a036cd40b8f085cebd55463466796,8,154,121,275,69,2012-11-27 21:18:28,2012-11-20 22:01:46
e120123e369a036cd40b8f085cebd55463466796...eecc80502975df5ef3aa9027d1b8b929cd6181bd,2,8,2,10,3,2012-11-27 21:18:28,2012-11-20 22:03:05
eecc80502975df5ef3aa9027d1b8b929cd6181bd...54b2a37ac7715c74e5b06b76eb2b631987d7b6f8,16,135,119,254,107,2012-11-27 21:18:28,2012-11-21 00:02:25
54b2a37ac7715c74e5b06b76eb2b631987d7b6f8...793c4385597d0786242e17c8ef37cdfa83f1865c,15,225,221,446,197,2012-11-27 21:18:28,2012-11-21 00:36:06
793c4385597d0786242e17c8ef37cdfa83f1865c...9cd423583fc8ccb7402b2fb65478cc532d011abc,5,27,27,54,16,2012-11-27 21:18:28,2012-11-21 00:57:16
9cd423583fc8ccb7402b2fb65478cc532d011abc...d9023dbe0cb5d47e30d86149701b7be9006f7683,5,73,70,143,43,2012-11-27 21:18:28,2012-11-21 01:06:54
d9023dbe0cb5d47e30d86149701b7be9006f7683...f45d51ff8e04c6849413c13aedcf5abacc3c69bd,15,63,62,125,52,2012-11-27 21:18:28,2012-11-21 02:57:46
f45d51ff8e04c6849413c13aedcf5abacc3c69bd...16248ee2d1d67bd386277bca67f04049afef875e,11,88,82,170,68,2012-11-27 21:18:29,2012-11-21 19:03:07
16248ee2d1d67bd386277bca67f04049afef875e...9daf240053dbe843ed925ccb713edad4a4ddff9e,1,13,6,19,5,2012-11-27 21:18:29,2012-11-21 19:12:33
9daf240053dbe843ed925ccb713edad4a4ddff9e...d574de0e6ef05c5de89810b5460bc201ddc513de,2,20,7,27,8,2012-11-27 21:18:29,2012-11-21 19:53:54
d574de0e6ef05c5de89810b5460bc201ddc513de...4604a65460b42ee4b3fead03dbb92197d583cc65,1,4,4,8,4,2012-11-27 21:18:29,2012-11-21 19:57:06
4604a65460b42ee4b3fead03dbb92197d583cc65...a8122b5d4a179456b1a1d9af8d09313e22bfab8d,32,158,147,305,120,2012-11-27 21:18:29,2012-11-21 23:39:03
a8122b5d4a179456b1a1d9af8d09313e22bfab8d...839c5f574f40726f6fbdb82c947635bd14bdc9aa,2,6,6,12,6,2012-11-27 21:18:29,2012-11-26 20:04:07
839c5f574f40726f6fbdb82c947635bd14bdc9aa...4ff192d3f224c780c741e62146c3350e54cba759,6,520,467,987,45,2012-11-27 21:18:29,2012-11-27 03:47:47
4ff192d3f224c780c741e62146c3350e54cba759...eac7695683d03f9716a7ca04006b9b6c43976a15,1,12,2,14,4,2012-11-27 21:18:29,2012-11-27 03:53:04
eac7695683d03f9716a7ca04006b9b6c43976a15...fe55f1631c85b322fac5a322863b40beefe68252,1,6,2,8,2,2012-11-27 21:18:29,2012-11-27 03:56:01
fe55f1631c85b322fac5a322863b40beefe68252...05a3ab61c276472296cd9d52bfa7219e65356a9b,1,3,3,6,2,2012-11-27 21:18:29,2012-11-27 04:00:34
05a3ab61c276472296cd9d52bfa7219e65356a9b...de5596bfd683273d60e8865626a064c6c1ece321,2,59,41,100,19,2012-11-27 21:18:30,2012-11-27 04:09:38
de5596bfd683273d60e8865626a064c6c1ece321...2e76b5fc84b7aa3877ef6b8251b7ba15eac1b2de,2,30,20,50,18,2012-11-27 21:18:30,2012-11-27 17:49:16
2e76b5fc84b7aa3877ef6b8251b7ba15eac1b2de...0ed67c1cb47f59f0b794379614ac9918138405a0,1,10,7,17,4,2012-11-27 21:18:30,2012-11-27 20:33:58
0ed67c1cb47f59f0b794379614ac9918138405a0...74f9132212a1c634c45241852dbd8564427e964b,1,15,16,31,15,2012-11-27 21:18:30,2012-11-27 20:45:44
74f9132212a1c634c45241852dbd8564427e964b...df705148ecc0d0a4c78f7a3b0903527918e38149,13,100,97,197,49,2012-11-27 21:19:49,2012-11-27 21:15:43
df705148ecc0d0a4c78f7a3b0903527918e38149...cb7ac81c4daa0bd9b1a988d614225218cf6bbc16,1,1,1,2,1,2012-11-27 21:30:04,2012-11-27 21:30:04
cb7ac81c4daa0bd9b1a988d614225218cf6bbc16...c9fc4a6ff9b6afba42b173abe0666cb7298e8695,2,29,29,58,26,2012-11-27 21:44:49,2012-11-27 21:44:49
c9fc4a6ff9b6afba42b173abe0666cb7298e8695...44d9f2cb60f05c05ab55e6aaae0fda8b31bbbbc6,1,8,8,16,8,2012-11-27 22:01:24,2012-11-27 22:01:24
44d9f2cb60f05c05ab55e6aaae0fda8b31bbbbc6...ff6b5ac97d0cae2088c45b691002934e2920e872,1,7,6,13,6,2012-11-27 22:03:53,2012-11-27 22:03:53
ff6b5ac97d0cae2088c45b691002934e2920e872...1d8ec670be6252ae5af6ded5edd6017434de3ab2,2,9,10,19,10,2012-11-27 22:06:56,2012-11-27 22:06:56
1d8ec670be6252ae5af6ded5edd6017434de3ab2...f4a62c306d5e313fe80815369be47318ea29575b,4,17,15,32,12,2012-11-27 22:13:03,2012-11-27 22:13:03
f4a62c306d5e313fe80815369be47318ea29575b...336d1275ca53e7acc0b1b28986513a3061260a22,1,12,12,24,12,2012-11-27 22:18:51,2012-11-27 22:18:51
336d1275ca53e7acc0b1b28986513a3061260a22...2bd5998c9cab0afdea2aba00ce35a70656ba9fda,3,19,25,44,12,2012-11-27 22:47:39,2012-11-27 22:47:39
2bd5998c9cab0afdea2aba00ce35a70656ba9fda...f984d97b2208b48a6aec8877d0af357cca0c637d,1,9,7,16,6,2012-11-27 23:00:28,2012-11-27 23:00:28
f984d97b2208b48a6aec8877d0af357cca0c637d...c3fb7d04edecb68f0307dfaa48a311f0f72db90e,7,16,14,30,10,2012-11-27 23:00:49,2012-11-27 23:00:49
c3fb7d04edecb68f0307dfaa48a311f0f72db90e...ca94e031fa21787ae6336f0aada1b01b2dd22077,2,20,9,29,6,2012-11-27 23:28:48,2012-11-27 23:28:48
3741a37f5ee80d7475cdfedcd4de7d8ea64cf1e8...3ee078c0f7ed278be4839a6bde7dce29a614d336,3,3,3,6,3,2012-11-13 21:46:17,2012-11-13 21:46:17
aa1c3b588edae7c6d718e85bce54d990c69cd535...f6c18dda048ae3332d60468c34c4fd7d1aa67f1e,1,1,4,5,2,2012-11-13 22:17:41,2012-11-13 22:17:41
d0ec3fb8f07988779783f69ab6cf5f3431c7aa3e...3f2bf4d659b33db9363d44f14d46154674d4049c,2,11,2,13,3,2012-01-19 18:06:15,2012-01-19 18:06:15
3f2bf4d659b33db9363d44f14d46154674d4049c...20c50b9e16c19bbbf7cf38bb4bd3177596bce61b,1,4,2,6,3,2012-01-19 18:09:47,2012-01-19 18:09:47
99a07f0f4df5e965eb87c0066ce0afcd848e6bd9...a53420e4b0efc9b1d87d6d13473d7f29ef4c68ee,2,3,4,7,2,2012-01-27 01:53:46,2012-01-27 01:53:46
a53420e4b0efc9b1d87d6d13473d7f29ef4c68ee...7a6f51de6d4f5543634889e58c30a0a6ceb75a09,1,7,7,14,5,2012-01-27 02:03:14,2012-01-27 02:03:14
7a6f51de6d4f5543634889e58c30a0a6ceb75a09...e4b4da140648d83f953837d4233dd87cb31f3ca4,2,40,54,94,26,2012-01-28 02:28:02,2012-01-28 02:28:02
e4b4da140648d83f953837d4233dd87cb31f3ca4...f25cc58d5cd630aa379bf894c5b78feb824bb647,2,0,1478,1478,2,2012-01-28 02:29:03,2012-01-28 02:29:03
64c5112188647fcbfbe2bbfb897abfbc21912ba8...9507a434c6a1e70ccd8a2678fe35b092105be1db,2,23,2,25,3,2012-11-28 09:47:10,2012-11-28 09:47:10
9507a434c6a1e70ccd8a2678fe35b092105be1db...ae2018917046da49f5926a3056360246d5abead2,1,2,2,4,2,2012-11-28 10:47:38,2012-11-28 10:47:38
3ee078c0f7ed278be4839a6bde7dce29a614d336...262274748f1c3cb6de4fa621100033eda6984166,1,1,1,2,1,2012-11-13 22:05:43,2012-11-13 22:05:43
3ee078c0f7ed278be4839a6bde7dce29a614d336...47db054df053fb09c8c92edaa0238af2a2605e65,5,16,9,25,7,2012-11-13 21:53:41,2012-11-13 21:41:01
47db054df053fb09c8c92edaa0238af2a2605e65...0da81d2b39290fe4d444953acb6d68795ed1ef42,3,31,17,48,9,2012-11-13 22:49:16,2012-11-13 22:43:23
513e794ef47363b8900816a9b141b3eae81eb83e...a277345e05507dfa0a3350d47df96d37063c929f,4,43,8,51,6,2012-11-15 06:37:13,2012-11-15 06:37:13
a277345e05507dfa0a3350d47df96d37063c929f...cccacac555ed3937204f8dfd397bc92e499d2c42,8,213,60,273,32,2012-11-15 06:41:51,2012-11-15 06:41:51
cccacac555ed3937204f8dfd397bc92e499d2c42...402b92cfe98882693a062bd94305383c55777619,1,16,1,17,2,2012-11-15 06:44:17,2012-11-15 06:44:17
513e794ef47363b8900816a9b141b3eae81eb83e...6132a54e0b4b3c5c9b03c0eba191bb756738d34a,3,5,2,7,3,2012-11-14 00:17:37,2012-11-14 00:13:10
6132a54e0b4b3c5c9b03c0eba191bb756738d34a...7e9f5e650016d7dce9d5cfd433e053c7126f7edf,1,1,3,4,2,2012-11-14 04:06:15,2012-11-14 04:06:15
881e3da012453941eb2b237d85ab5636eea21c76...860de00459dd06c3758fdfc3db8bdd6978b6073c,1,1,1,2,1,2012-01-19 22:36:27,2012-01-19 22:26:20
860de00459dd06c3758fdfc3db8bdd6978b6073c...9269ccce143578deec4d4e6e7755068f130abe96,2,2,1,3,2,2012-01-19 22:47:15,2012-01-19 22:44:52
f25cc58d5cd630aa379bf894c5b78feb824bb647...b3408e3e661f48f9bb7ab601e1045912fb23cf5f,2,1,9,10,6,2012-02-05 13:59:45,2012-02-05 13:59:45
f25cc58d5cd630aa379bf894c5b78feb824bb647...279afd2a514160754eeba8e5db84600486f70761,2,11,1,12,3,2012-01-31 16:29:53,2012-01-31 16:21:49
f25cc58d5cd630aa379bf894c5b78feb824bb647...1e53b52eb927e5a7b59d72e6c6800af8bcf62d11,1,4,0,4,2,2012-01-29 14:11:09,2012-01-29 14:11:09
ae2018917046da49f5926a3056360246d5abead2...7cdad6c77425348364d9c10582b1b779dd7c1ade,1,1,1,2,1,2012-11-28 11:43:12,2012-11-28 11:43:12
7e9f5e650016d7dce9d5cfd433e053c7126f7edf...66bf4dbc68bc4b0760231fa55270976af83ed845,1,31,4,35,2,2012-11-14 04:57:19,2012-11-14 00:57:37
199b7d940d723f230ad876c852aa2c0d6a5e2789...242a1cea8d66d9ec185044f345b22fec1940178f,1,2,2,4,2,2012-02-05 16:14:14,2012-02-05 15:29:12
279afd2a514160754eeba8e5db84600486f70761...5d3cd4e309517a8ab2b553ad0839493ba45bb97d,1,12,2,14,1,2012-01-31 21:09:39,2012-01-31 21:09:39
5d3cd4e309517a8ab2b553ad0839493ba45bb97d...adc9bdb3b1428b8edf067ab17c26ef15ec1ac8a7,7,61,38,99,33,2012-01-31 21:59:32,2012-01-31 21:59:32
adc9bdb3b1428b8edf067ab17c26ef15ec1ac8a7...e4eb94a2559ca669412d318112a200ead1222466,1,2,0,2,1,2012-01-31 22:02:52,2012-01-31 22:02:52
f82d996e755638ff983e24d9e5966ff317138c21...771cde43181d0ba2fffdc9f533f5ef572b1482ee,1,1,0,1,1,2012-02-01 03:41:42,2012-02-01 03:40:18
693021262ba0eeac2923bbce1b2262717019c807...bff53e5405e686f78e1ae81a4521566e3c67b5df,2,92,0,92,2,2012-11-29 02:54:56,2012-11-28 00:36:50
bff53e5405e686f78e1ae81a4521566e3c67b5df...eddde61846d3e2bcd5bfbfec486940d378d61231,1,33,0,33,8,2012-11-29 02:54:57,2012-11-28 00:37:11
eddde61846d3e2bcd5bfbfec486940d378d61231...0d9e0323a552078a6bec639f2c715b3d9f267922,41,161,1,162,26,2012-11-29 02:54:57,2012-11-28 07:27:41
0d9e0323a552078a6bec639f2c715b3d9f267922...c6d03c958fc5604c8a00c9a512ec342caa3e43ef,1,1,1,2,1,2012-11-29 02:54:57,2012-11-29 02:07:08
c6d03c958fc5604c8a00c9a512ec342caa3e43ef...0984c8768d36c73adeabe0229960e651531edf17,6,150,106,256,18,2012-11-29 02:54:57,2012-11-29 02:27:43
0984c8768d36c73adeabe0229960e651531edf17...b994bfe3398d797ff8e8bb538eec41602d5e360a,1,0,7,7,3,2012-11-29 02:59:13,2012-11-29 02:48:22
b994bfe3398d797ff8e8bb538eec41602d5e360a...d5e44d84983ba199a62ec67f823312584339fae3,6,18,13,31,13,2012-11-30 01:02:27,2012-11-30 01:02:27
d5e44d84983ba199a62ec67f823312584339fae3...bdf3e6df8313e44890b137eae28ee2e5d63833b8,1,1,1,2,1,2012-11-30 01:34:41,2012-11-30 01:34:41
bdf3e6df8313e44890b137eae28ee2e5d63833b8...1a0c5a34e027620416dadc604f3702ad2e8fe5d0,1,19,14,33,7,2012-11-30 02:11:30,2012-11-30 01:38:37
693021262ba0eeac2923bbce1b2262717019c807...35108a216ebc06fb34e8dcfd5082bc9fc2e80417,1,1,1,2,1,2012-11-28 18:37:31,2012-11-28 18:35:26
35108a216ebc06fb34e8dcfd5082bc9fc2e80417...046a1573ffa2188ef23b535115bc6035960a71e0,1,33,0,33,1,2012-11-28 23:05:16,2012-11-24 18:05:39
693021262ba0eeac2923bbce1b2262717019c807...7bf87ab6987cf6b9e166e23d2d9dbdcd2511fb32,15,388,289,677,55,2012-11-28 17:58:48,2012-11-28 17:58:48
693021262ba0eeac2923bbce1b2262717019c807...613d5eb9391d6cc33c91f4dc9cdb5ede1885dc72,161,3905,344,4249,296,2012-11-28 16:42:37,2012-11-28 16:42:37
613d5eb9391d6cc33c91f4dc9cdb5ede1885dc72...ac22d08f2fbe53c28a0f7dffcfa44c5408dcf78f,3,0,37,37,3,2012-11-29 13:22:15,2012-11-29 13:22:15
ac22d08f2fbe53c28a0f7dffcfa44c5408dcf78f...6762fe087bd75e60b3e551f94c8ecda89d374c83,8,32,32,64,32,2012-11-29 13:29:26,2012-11-29 13:29:26
6762fe087bd75e60b3e551f94c8ecda89d374c83...4a6621fdf7b26aec5abeeb0c91cc3f57489518ab,2,3,6,9,5,2012-11-29 13:35:21,2012-11-29 13:35:21
4a6621fdf7b26aec5abeeb0c91cc3f57489518ab...3238ee3e07fc2a6d6fbde0f29613bae21c88df66,10,0,467,467,10,2012-11-29 13:37:32,2012-11-29 13:37:32
3238ee3e07fc2a6d6fbde0f29613bae21c88df66...36c730daa08c4ebf85562ee0cc8d2ee3591d3cee,10,0,467,467,10,2012-11-29 15:34:16,2012-11-29 15:34:16
7cdad6c77425348364d9c10582b1b779dd7c1ade...59a0d772f88258caa59370dc1787622ace17b29a,1,23,0,23,1,2012-11-28 19:04:34,2012-11-27 19:24:56
7cdad6c77425348364d9c10582b1b779dd7c1ade...f1bd50d61d3bce63b8db46e906b2ed34ec9545cf,1,3,23,26,13,2012-11-28 19:00:06,2012-11-18 06:07:30
f1bd50d61d3bce63b8db46e906b2ed34ec9545cf...37849a8ec3aba526570f73f90bccb232ceefc426,3,43,2,45,3,2012-11-28 19:00:07,2012-11-18 06:09:55
e087973ec7c3c504696e2be4fad688aa09715d8d...86b9dbc12f61c24457f2979e9496c85e115a3799,2,6,6,12,2,2012-11-17 13:13:13,2012-11-17 12:50:48
86b9dbc12f61c24457f2979e9496c85e115a3799...aa8a76eff9494e109c2c72c72ad687faaf05db3d,4,4,4,8,4,2012-11-17 13:41:20,2012-11-17 13:12:14
aa8a76eff9494e109c2c72c72ad687faaf05db3d...0e95e70a55b2c7af64370c0b886d4d00f8bea839,1,16,8,24,8,2012-11-17 13:41:22,2012-11-17 13:22:39
0e95e70a55b2c7af64370c0b886d4d00f8bea839...5df7207a674d1d4c41b300f6f0c5548d087f06b3,1,1,11,12,2,2012-11-17 15:20:04,2012-11-17 14:56:19
5df7207a674d1d4c41b300f6f0c5548d087f06b3...f5a0e734bc440ca6c89d15a894fea0ea3bf38f36,2,52,0,52,2,2012-11-17 15:20:07,2012-11-17 14:46:42
f5a0e734bc440ca6c89d15a894fea0ea3bf38f36...6091457e76638503fec46de269bc158f63e4721a,3,50,29,79,15,2012-11-17 15:20:08,2012-11-17 15:19:14
6091457e76638503fec46de269bc158f63e4721a...d36451c9d4ba071de07106371553bf93f2717fc4,2,13,13,26,2,2012-11-17 20:34:15,2012-11-17 20:34:15
d36451c9d4ba071de07106371553bf93f2717fc4...270160b91a0e55486f2cb6a6238c39fcd1271809,5,69,12,81,15,2012-11-18 02:30:34,2012-11-17 21:39:24
270160b91a0e55486f2cb6a6238c39fcd1271809...1a764476d27ac1861d1433b02bc7fbff733d8942,1,2,1,3,1,2012-11-18 02:30:34,2012-11-18 02:24:10
1a764476d27ac1861d1433b02bc7fbff733d8942...b15df1d937128bb7051ab35084195ff1980a7869,7,51,39,90,38,2012-11-18 02:30:35,2012-11-18 02:29:51
5a36f127808c7b470eef17b1a8a130dde0cc64a1...85e7efa1630855c5c8bd9893f732494bda51b591,2,95,8,103,10,2012-11-16 16:46:02,2012-11-14 21:35:43
5a36f127808c7b470eef17b1a8a130dde0cc64a1...c0d5acf69a647baa06bd5d8e570105b93b5070e7,2,5,0,5,2,2012-11-15 16:59:39,2012-11-15 16:43:21
5a36f127808c7b470eef17b1a8a130dde0cc64a1...5735bf5e6ab4da347b601d4b85c09c5c701dc002,12,119,152,271,98,2012-11-15 06:54:31,2012-11-13 21:58:29
5735bf5e6ab4da347b601d4b85c09c5c701dc002...bad68c0a998116685ad75cab84210004dd2c5be1,8,78,25,103,27,2012-11-15 06:55:40,2012-11-13 22:02:59
bad68c0a998116685ad75cab84210004dd2c5be1...bbe6dbec81d2050fb52b600bc27e2dacdc780e77,14,112,97,209,92,2012-11-15 07:29:48,2012-11-15 07:29:48
242a1cea8d66d9ec185044f345b22fec1940178f...7ef9f1b5606c2672105ecbbf34c022a71ef212fe,1,38,0,38,1,2012-04-02 19:05:45,2012-04-02 19:05:45
242a1cea8d66d9ec185044f345b22fec1940178f...97313ce2a36e6184334bd070faa8b87b1b150621,1,1,0,1,1,2012-02-07 10:33:02,2012-02-07 09:51:57
242a1cea8d66d9ec185044f345b22fec1940178f...13f77071697dea8d9c5281ddb83b8da1d5f4baed,1,1,0,1,1,2012-02-07 09:20:03,2012-02-07 09:20:03
bf0107d1ece702d67e13f4e7e5063fbcabf6c040...4ea79a9d6e8f52faf8598b96ed53c3066cba0f83,1,16,11,27,6,2012-02-01 16:42:26,2012-02-01 16:41:54
4ea79a9d6e8f52faf8598b96ed53c3066cba0f83...62a1f713de384e141045facf3c1a53d9642e8eb5,1,13,4,17,4,2012-02-01 19:54:42,2012-02-01 19:54:42
62a1f713de384e141045facf3c1a53d9642e8eb5...e8c96ed2a74a4fcd9789721b4ebfd78586b3a16f,8,28,0,28,9,2012-02-01 20:30:35,2012-02-01 20:30:35
e8c96ed2a74a4fcd9789721b4ebfd78586b3a16f...38691ffc67fad350e5d71dbe53d25514089b61cf,1,1,1,2,1,2012-02-01 21:20:47,2012-02-01 21:20:47
f684970a1087abe34319d35a46f2e954681d5323...9ff07c24f5922b65526253711353d8f308bc9dde,1,1,0,1,1,2012-11-30 14:17:05,2012-11-30 14:17:05
9ff07c24f5922b65526253711353d8f308bc9dde...2d6aedbf295e6379faa56c68f8d5e31d3f4d796c,1,10,0,10,1,2012-11-30 14:23:20,2012-11-30 14:23:20
2d6aedbf295e6379faa56c68f8d5e31d3f4d796c...da820437368aae2088e992e7ce8944253693aa16,1,7,2,9,4,2012-11-30 14:26:45,2012-11-30 14:26:45
f1e5c506b20bcc6bed3bbbf64f1f6b79be44316b...d1b6ea8ad14f41b87026ab407005e887c4ff6b68,2,30,0,30,2,2012-12-01 03:50:45,2012-12-01 03:50:20
d1b6ea8ad14f41b87026ab407005e887c4ff6b68...44f9f547972efecd326fbf6e92ae1297cc9e1813,2,56,0,56,2,2012-12-02 23:39:17,2012-11-30 02:33:30
44f9f547972efecd326fbf6e92ae1297cc9e1813...bfb8bcc1df18431e8e7cf2a9dce8acc95cd312e3,1,9,10,19,8,2012-12-02 23:39:17,2012-12-02 23:36:32
0e9ea5d0e30f3c4a06b1823c189fbc8c070eae7a...0066955d9752cab8f8533c0dddfc95d08ad13e33,3,3,4,7,4,2012-11-18 03:27:49,2012-11-18 03:27:49
4a0c7f56ab45501ed53e6c0f8d68fa648c4b3dfc...414bd93667905169a0a2ee72d022c885dce19d57,1,1,0,1,1,2012-11-16 00:20:02,2012-11-16 00:20:02
414bd93667905169a0a2ee72d022c885dce19d57...0ec118280c5e0177492d494c6f628f8aec63587c,1,1,1,2,1,2012-11-16 01:17:57,2012-11-16 01:17:57
0ec118280c5e0177492d494c6f628f8aec63587c...96acc0b615cf7decd807a6f5741d25bd87ffd751,1,5,4,9,6,2012-11-16 01:37:26,2012-11-16 01:30:00
6d39c0dd6fc138fdd994e7b31ab7f5eed85d2688...15f52ae1d63712a831e02d02cfe1c84c80dc0ef5,1,1,1,2,1,2012-02-13 12:30:04,2011-12-19 14:59:13
6d39c0dd6fc138fdd994e7b31ab7f5eed85d2688...90e6c6203d4ea7dbb95264d5dc58902c43b8a5a5,1,1,1,2,1,2012-02-13 11:13:05,2012-02-13 11:13:05
61eba2d8368435f1bd944566f46be2297d9a8404...9b8d56087cf6e981da76ac9e9cdb84e7dbc0fc32,1,1,1,2,1,2012-02-09 00:18:26,2012-02-09 00:18:26
9b8d56087cf6e981da76ac9e9cdb84e7dbc0fc32...18e5b8547d075afc53c2b20ba15ef7c09cb5efd6,3,32,24,56,15,2012-02-10 18:47:02,2012-02-10 18:47:02
18e5b8547d075afc53c2b20ba15ef7c09cb5efd6...f19e3ca28835eab8dbef62915c475caa18f355fe,3,107,25,132,14,2012-02-10 19:16:42,2012-02-10 19:16:42
38691ffc67fad350e5d71dbe53d25514089b61cf...31ffc141c39f49ab9d1037f6d62bbde938f9a9f3,1,1,0,1,1,2012-02-02 05:14:59,2012-02-02 05:14:59
da820437368aae2088e992e7ce8944253693aa16...3da73c40fcd5bbc92659abb33cec9584004139eb,2,7,4,11,5,2012-12-01 07:34:21,2012-11-29 20:33:31
3da73c40fcd5bbc92659abb33cec9584004139eb...8b50935a69c4e69f9975bad11caeb0ba04adec85,1,1,0,1,1,2012-12-01 07:34:22,2012-11-12 10:29:48
8b50935a69c4e69f9975bad11caeb0ba04adec85...032ba9e4adf61dd9f33fa4eac03618378b52adb3,4,94,38,132,22,2012-12-01 07:34:23,2012-11-12 11:32:31
032ba9e4adf61dd9f33fa4eac03618378b52adb3...83458bb77ff8dd82411924c7fd376dc338c8bd18,1,5,1,6,2,2012-12-01 07:34:24,2012-11-12 13:06:13
83458bb77ff8dd82411924c7fd376dc338c8bd18...47261d9c8a23c3ccec245c2640d4d9a8b9f182c2,1,0,13,13,8,2012-12-01 07:34:25,2012-11-12 13:19:37
47261d9c8a23c3ccec245c2640d4d9a8b9f182c2...80d9d1df14b1f160848ee76dc35f1b0cecab332d,7,115,37,152,31,2012-12-01 07:34:26,2012-11-12 14:42:15
80d9d1df14b1f160848ee76dc35f1b0cecab332d...e4aa7f58fefc7455b5527d410ad3f9c2c4032820,1,4,0,4,2,2012-12-01 07:34:26,2012-11-12 16:25:55
e4aa7f58fefc7455b5527d410ad3f9c2c4032820...80212ecb1c2ce3e27d1a4ffe053e36260ee06c01,3,28,4,32,8,2012-12-01 07:34:27,2012-11-12 15:49:29
80212ecb1c2ce3e27d1a4ffe053e36260ee06c01...18d6f120402255f2e2a192553e20c1048f55a303,3,46,6,52,11,2012-12-01 07:34:28,2012-11-12 14:55:38
18d6f120402255f2e2a192553e20c1048f55a303...621730383a2298431fd3ea3cbc754f7cf18a1eba,4,34,3,37,9,2012-12-01 07:34:28,2012-11-12 19:47:32
621730383a2298431fd3ea3cbc754f7cf18a1eba...bc05f30c470f7d147ff85b30ad5719bbce70a4a3,5,49,20,69,15,2012-12-01 07:34:29,2012-11-19 17:49:25
bc05f30c470f7d147ff85b30ad5719bbce70a4a3...84166facc9537a03d8aaaa415c9e8044d0239252,1,0,10,10,3,2012-12-01 07:34:30,2012-11-18 22:20:35
84166facc9537a03d8aaaa415c9e8044d0239252...cc1466264a385419aa4ebc3811846b038b3430d1,5,104,78,182,50,2012-12-01 07:34:31,2012-11-19 18:00:46
da820437368aae2088e992e7ce8944253693aa16...bde336ea51df071de922827ae322df7b01b059ce,10,48,11,59,22,2012-11-30 20:55:45,2012-11-29 20:26:09
bde336ea51df071de922827ae322df7b01b059ce...f4fc9fdba03dd4975229243d7c1debd00c9d1f18,4,6,5,11,5,2012-11-30 21:12:10,2012-11-29 20:26:40
f4fc9fdba03dd4975229243d7c1debd00c9d1f18...b81aa2f1deb98eb7f9e60ac96696e69a9a49d8f8,8,53,11,64,16,2012-11-30 21:12:14,2012-11-29 22:06:40
b81aa2f1deb98eb7f9e60ac96696e69a9a49d8f8...691776213947e59a3928aab09e97a64b65e990ab,3,37,2,39,5,2012-11-30 21:12:14,2012-11-29 22:07:50
691776213947e59a3928aab09e97a64b65e990ab...2f8d30becb4801d869188d2d46ca1512843e8698,16,168,33,201,41,2012-11-30 21:12:14,2012-11-29 23:05:04
2f8d30becb4801d869188d2d46ca1512843e8698...ca901e7b0fb38a7f4748ff5fcde7a2779f3a7771,2,50,3,53,6,2012-11-30 21:12:15,2012-11-29 23:16:19
ca901e7b0fb38a7f4748ff5fcde7a2779f3a7771...55f6f21b7dd5a177e2cc60c1054b438c05ed8f14,4,20,2,22,7,2012-11-30 21:12:15,2012-11-30 03:59:18
55f6f21b7dd5a177e2cc60c1054b438c05ed8f14...9267ff586f29deb99f41ab6eeb0599917ddd0cec,5,24,7,31,10,2012-11-30 21:12:15,2012-11-30 04:01:24
9267ff586f29deb99f41ab6eeb0599917ddd0cec...b4d136527c2210f1abbcc53ab7290ad38029ab3c,3,20,10,30,9,2012-11-30 21:12:15,2012-11-30 04:06:23
b4d136527c2210f1abbcc53ab7290ad38029ab3c...79cfa20d60cfdaf578da59cfb4d17551cf1b6256,4,23,24,47,19,2012-11-30 21:12:15,2012-11-30 04:12:59
79cfa20d60cfdaf578da59cfb4d17551cf1b6256...10711769000d009189f83e468f25b719fa303086,4,38,3,41,6,2012-11-30 21:12:15,2012-11-30 04:47:37
10711769000d009189f83e468f25b719fa303086...4ec197f3049d203739066e0c2d2c5c39f78fd808,7,38,1,39,13,2012-11-30 21:12:16,2012-11-30 20:52:42
4ec197f3049d203739066e0c2d2c5c39f78fd808...c7231c45fecf6c0ae91815a82db7e98c94689497,17,38,161,199,28,2012-12-01 00:31:42,2012-12-01 00:31:42
c7231c45fecf6c0ae91815a82db7e98c94689497...0ab3a2ab2c39a99b7cb3c969fd7b896afcec4885,7,15,20,35,11,2012-12-01 04:34:50,2012-12-01 04:34:50
0ab3a2ab2c39a99b7cb3c969fd7b896afcec4885...7bcfbe16c59d6f3a47cfbfa65952623081c8f7de,1,1,1,2,1,2012-12-01 04:35:01,2012-12-01 04:35:01
7bcfbe16c59d6f3a47cfbfa65952623081c8f7de...2da619abdebe78ce90be5e7d58e2257ec1777003,1,0,4,4,2,2012-12-03 20:41:38,2012-12-03 20:41:38
2da619abdebe78ce90be5e7d58e2257ec1777003...de70aea6b1c09b67f233ef0bee83864ce90260b2,8,3,24,27,14,2012-12-03 20:41:50,2012-12-03 20:41:50
de70aea6b1c09b67f233ef0bee83864ce90260b2...ee1c33b146a366260a4648b1f29f470fedaca0fa,1,1,1,2,1,2012-12-03 20:45:15,2012-12-03 20:45:15
da820437368aae2088e992e7ce8944253693aa16...46635339e935ce59e5a3525e18228f259d141aa3,2,80,0,80,4,2012-11-30 14:55:23,2012-11-19 21:22:33
46635339e935ce59e5a3525e18228f259d141aa3...f56f8585c095b1589b5e3dca0ea64ef907756fc9,3,137,30,167,18,2012-11-30 14:55:23,2012-11-19 21:23:16
f56f8585c095b1589b5e3dca0ea64ef907756fc9...5a3ad89dbd8954b87e14a20ee2dcb282528d4531,1,78,49,127,24,2012-11-30 14:55:23,2012-11-20 06:03:56
5a3ad89dbd8954b87e14a20ee2dcb282528d4531...3908c254aac0532baf5a2f6a96603d946edc0510,1,26,19,45,12,2012-11-30 18:16:39,2012-11-30 16:25:50
3368c520dcd345cbc404afe9da68f4c8c3035981...b2414661332f7fd6a6819395f1505a58f8d75b5e,2,106,10,116,6,2012-12-03 20:51:39,2012-11-29 04:43:55
0066955d9752cab8f8533c0dddfc95d08ad13e33...4cc7342e952b75d5f77427cb83b413e9e195ed28,1,3,2,5,3,2012-11-18 08:07:35,2012-11-18 08:07:35
a50086d174658914d4d6462afbc83b02825b1f5b...297758dce3bd012b17da379996dca4413d9d651c,3,371,2,373,4,2013-05-03 14:37:33,2013-05-03 14:37:33
297758dce3bd012b17da379996dca4413d9d651c...8ae55d940f0687988fcf22f5e775339cf070dbc2,1,49,49,98,25,2013-05-03 14:53:59,2013-05-03 14:53:59
8ae55d940f0687988fcf22f5e775339cf070dbc2...d04c384036ec6f843bbbb45a87d9d451c35cf29a,2,86,20,106,13,2013-05-03 18:53:23,2013-05-03 18:53:23
d04c384036ec6f843bbbb45a87d9d451c35cf29a...f7158cd79b836d791b188f67b6d54064afb8ed31,3,149,27,176,23,2013-05-04 15:28:20,2013-05-03 20:31:16
f7158cd79b836d791b188f67b6d54064afb8ed31...58ba0a4eba9b1c0050d2aaa0eecad21c244fae4a,1,7,17,24,8,2013-05-05 12:34:56,2013-05-05 12:34:56
58ba0a4eba9b1c0050d2aaa0eecad21c244fae4a...22595b84808735798eaeed3cb571372844ba5538,1,10,1,11,2,2013-05-05 12:43:58,2013-05-05 12:43:58
22595b84808735798eaeed3cb571372844ba5538...120b0122c576feeb74c6f6d50e572af0e0f6b7d6,1,43,59,102,4,2013-05-05 13:03:49,2013-05-05 13:03:49
120b0122c576feeb74c6f6d50e572af0e0f6b7d6...7261d9837eb2ec521349a4e897d3236b35dbf094,2,53,28,81,20,2013-05-05 17:36:11,2013-05-05 17:36:11
7261d9837eb2ec521349a4e897d3236b35dbf094...c0cef9e0d6b0de734bbc67b6b627ab21117a9e27,1,41,17,58,4,2013-05-05 17:58:18,2013-05-05 17:58:18
c0cef9e0d6b0de734bbc67b6b627ab21117a9e27...d97669593ae0b423d9a380bba43047d3778f0d6e,1,1,1,2,2,2013-05-05 18:05:03,2013-05-05 18:05:03
d97669593ae0b423d9a380bba43047d3778f0d6e...3eed595e853baf336dd83613189964500bd3730c,1,66,27,93,11,2013-05-05 18:24:05,2013-05-05 18:24:05
3eed595e853baf336dd83613189964500bd3730c...67a7136c7ba8c6ee90d9f64a9f5c02ddca5c064b,1,6,6,12,4,2013-05-05 18:24:47,2013-05-05 18:24:47
67a7136c7ba8c6ee90d9f64a9f5c02ddca5c064b...7621519f73dfa529dab4d48532559a5e321f6526,1,5,7,12,4,2013-05-05 18:46:28,2013-05-05 18:46:28
7621519f73dfa529dab4d48532559a5e321f6526...c36565c0eea7b97726cffaeaf9abe2a3279ff70b,3,92,1,93,7,2013-05-07 17:45:31,2013-05-07 17:43:10
c36565c0eea7b97726cffaeaf9abe2a3279ff70b...574b86b72294e4b0fd08281f4c19e013f0d9b137,4,23,2,25,18,2013-05-07 17:56:34,2013-05-07 17:53:23
574b86b72294e4b0fd08281f4c19e013f0d9b137...7369b3c3bf396e466d065f9921415fe2b9d69a7a,3,58,1,59,7,2013-05-07 18:26:33,2013-05-07 18:26:33
2c19b5658c084df7a4cb475dfbd8347431aa4482...5e0de328181c6ddb55a58d4aa7c79271c5298789,143,143,143,286,143,2012-02-13 16:11:09,2012-02-13 16:10:24
0a4aebb097bbe7a940c0f73174b756027105d92f...99abb79d53781dda9bbdc7b896eaa383d8789cb3,3,66,8,74,15,2012-02-03 11:46:50,2012-02-03 11:45:43
e6b013a042e5b20a97cc4286fea437240028991b...e8670d01e0fb9b987c396557d2ed9d8a1edfa7fe,1,2,0,2,1,2013-02-05 13:32:09,2013-02-05 13:32:09
e6b013a042e5b20a97cc4286fea437240028991b...7ea3a79f0cc157980cbc0c4117f2458cc535a0d8,1,1,1,2,1,2012-12-03 15:04:39,2012-12-03 15:04:39
e05ca13f1f3550f59790c0f992841abceee1b4c5...8ff66112d9c671c44603e2c8f1dd0dc803d9d6f9,1,2,1,3,2,2012-12-05 19:50:19,2012-12-05 19:50:19
8ff66112d9c671c44603e2c8f1dd0dc803d9d6f9...43efaabd40d8f9773a2fccb8acea704332446008,1,2,1,3,2,2012-12-05 19:54:03,2012-12-05 19:54:03
43efaabd40d8f9773a2fccb8acea704332446008...bf192cdb436f303c80bf7ff44307f301f981f0c6,2,7,6,13,7,2012-12-05 19:56:27,2012-12-05 19:56:27
bf192cdb436f303c80bf7ff44307f301f981f0c6...a9c07c47ea6efd95f6e26639d85bbd60aa407c42,1,0,2,2,2,2012-12-05 20:06:54,2012-12-05 20:06:54
0249a5032ef6fc27d1f2b974aafdb38ab61f81bc...a3a81ae5420fca1f00980f9d232c9197a7f98738,1,96,0,96,1,2012-12-10 04:43:26,2012-12-10 04:43:26
a3a81ae5420fca1f00980f9d232c9197a7f98738...9c2a4e8c4731854c602acd3c5eb46f4fc84f9f71,1,15,50,65,15,2012-12-10 05:01:46,2012-12-10 05:01:46
9c2a4e8c4731854c602acd3c5eb46f4fc84f9f71...b337814e70a836fe6611df4a10032fd01ed713a3,1,3,4,7,1,2012-12-10 05:04:32,2012-12-10 05:04:32
b337814e70a836fe6611df4a10032fd01ed713a3...e51c8b99be1fc35bd3db30ae629cc404942cdc24,1,18,2,20,7,2012-12-10 05:24:47,2012-12-10 05:24:47
e51c8b99be1fc35bd3db30ae629cc404942cdc24...7d26c410bf6f5ba3be18c60d789d064219f9aca6,1,15,12,27,12,2012-12-10 05:55:51,2012-12-10 05:55:51
0249a5032ef6fc27d1f2b974aafdb38ab61f81bc...c3320aca7640386a2cfc0c785560ff4d36851ef9,1,2,0,2,2,2012-12-09 10:22:50,2012-12-09 10:22:50
c3320aca7640386a2cfc0c785560ff4d36851ef9...a35b3864583bd1c98334aa71bb4e4c217ace55aa,3,51,14,65,12,2012-12-09 10:31:39,2012-12-09 10:31:39
a35b3864583bd1c98334aa71bb4e4c217ace55aa...2bb1c7aa2629e1e4e3a5f04d494b16957da849e1,1,1,1,2,1,2012-12-09 10:37:33,2012-12-09 10:37:33
2bb1c7aa2629e1e4e3a5f04d494b16957da849e1...1d009603343786f6022ef690e513f183c5840747,1,2,2,4,2,2012-12-09 10:40:16,2012-12-09 10:40:16
0249a5032ef6fc27d1f2b974aafdb38ab61f81bc...6481a68d49ad2e975dd0f3297d8058dcd3fd7d62,1,9,10,19,11,2012-12-07 18:24:55,2012-12-07 18:23:16
46e4227695dceabfa7d2d4ae19d486969ba6f8df...aab8f5af4b594398356b47c0c2a2ce6f5a4ca080,1,7,3,10,5,2012-12-04 22:40:09,2012-12-04 22:40:09
629c08293051e9828f2ca3517d2659728647c2cd...19af78bb36b144022d7dbe68605c8715cd6dc322,2,9,1,10,2,2012-11-18 23:15:24,2012-11-18 23:15:24
19af78bb36b144022d7dbe68605c8715cd6dc322...0d778b1a892d53161b4392ed75adcb3dcfe1a3df,1,3,0,3,1,2012-11-19 00:52:04,2012-11-19 00:52:04
0d778b1a892d53161b4392ed75adcb3dcfe1a3df...1876360f813da8e6aba763baded5dcb004d9999c,1,27,0,27,1,2012-11-19 00:59:42,2012-11-19 00:59:42
00e43380a0beee3ac40935c45d4aa67fbfc27fbb...4ca3d6d28f959793f412a6eb02211020a9204050,1,2,0,2,2,2013-05-07 18:37:15,2013-05-07 18:37:15
4ca3d6d28f959793f412a6eb02211020a9204050...05f581311b1a3d8003823a57e87482847827ae7d,1,8,8,16,8,2013-05-09 21:36:27,2013-05-09 21:36:27
05f581311b1a3d8003823a57e87482847827ae7d...ce6d50b99420a4e0994cf9be285a92eb8c4bac0e,1,3,6,9,1,2013-05-09 21:37:42,2013-05-09 21:37:42
ce6d50b99420a4e0994cf9be285a92eb8c4bac0e...b4d81a00bf97260eff52345047a14c93de6fddc0,1,3,1,4,2,2013-05-09 21:40:21,2013-05-09 21:40:21
b4d81a00bf97260eff52345047a14c93de6fddc0...89ea0e51814bc3161fd8fc62045cdabbedf41a2c,1,0,2,2,2,2013-05-10 13:40:14,2013-05-10 13:40:14
89ea0e51814bc3161fd8fc62045cdabbedf41a2c...22011b33daf1a722ae1f522b32e188dccb21ac42,1,6,12,18,2,2013-05-15 16:38:40,2013-05-15 16:38:40
22011b33daf1a722ae1f522b32e188dccb21ac42...b54ed3efe88801df17ba7ceff40887dfabed0338,1,2,1,3,1,2013-05-15 16:41:16,2013-05-15 16:41:16
b54ed3efe88801df17ba7ceff40887dfabed0338...e057e41122cbcfef60b7ab0283cbcda44df538c7,1,11,33,44,4,2013-05-15 16:44:51,2013-05-15 16:44:51
e057e41122cbcfef60b7ab0283cbcda44df538c7...ccaee222a10226266550ddcdb364c7a300ebb740,1,2,6,8,3,2013-05-15 16:46:33,2013-05-15 16:46:33
ccaee222a10226266550ddcdb364c7a300ebb740...6cbbd739356f20c681d541438fdbad6027e0eef5,1,0,0,0,0,2013-05-15 16:48:43,2013-05-15 16:48:43
6cbbd739356f20c681d541438fdbad6027e0eef5...a6b79b9bdcbfc2c53931f49e9be5cf4d44f61d37,1,0,0,0,0,2013-05-15 16:49:15,2013-05-15 16:49:15
a6b79b9bdcbfc2c53931f49e9be5cf4d44f61d37...84ac625ddd1135755030dfb01b2be965e7cacb2f,1,1,0,1,1,2013-05-15 16:51:40,2013-05-15 16:51:40
66faeb5c5d38541c070a02bc53ad0846a4c5fcc9...0c3bae6268c404fc3717cc90ba1bc5db91c8cbe6,8,7,47,54,9,2012-02-15 15:56:56,2012-02-15 15:56:56
66faeb5c5d38541c070a02bc53ad0846a4c5fcc9...b4b79ac3dbca9088539a10d8d65bfc06504c3c2e,3,53,4,57,5,2012-02-15 12:07:41,2012-02-14 23:12:53
b4b79ac3dbca9088539a10d8d65bfc06504c3c2e...905919e63b7b4357ca75ef5e8bfeca7485428dc9,1,9,0,9,1,2012-02-15 12:07:50,2012-02-14 19:44:22
905919e63b7b4357ca75ef5e8bfeca7485428dc9...bf477ed4a86d4183f7e38e4667a1f623270bf5d2,6,618,0,618,6,2012-02-15 19:32:14,2012-02-14 23:33:38
fb60d268df2272626f48cfed7b2a185413e7e9f4...94ed23f86a0708a95c5d2c58b38ba0cd8acd0c97,1,13,0,13,1,2013-02-07 00:41:20,2013-02-07 00:41:20
94ed23f86a0708a95c5d2c58b38ba0cd8acd0c97...3b5e44aeba0fbbbc324939a71727757d97a8ee7b,1,4,1,5,2,2013-02-07 23:50:20,2013-02-07 23:50:20
3b5e44aeba0fbbbc324939a71727757d97a8ee7b...f88885e339699ece048ebec3706736b491526939,1,1,0,1,1,2013-02-08 00:10:03,2013-02-08 00:10:03
f88885e339699ece048ebec3706736b491526939...a49e5bed8d2c9cdbcfcb43c679eee88875183dd7,1,5,6,11,5,2013-02-08 00:26:04,2013-02-08 00:26:04
a49e5bed8d2c9cdbcfcb43c679eee88875183dd7...64012fdbe67641b778cdef83583b337c079f83c2,1,3,3,6,2,2013-02-08 02:24:45,2013-02-08 02:24:45
64012fdbe67641b778cdef83583b337c079f83c2...7672c8c779e1a3264db20941b7d9ba1472c0ec94,1,1,2,3,1,2013-02-08 10:29:23,2013-02-08 10:29:23
fb60d268df2272626f48cfed7b2a185413e7e9f4...f393d4e8d725b3e45a4b438a6f3ab7be589b2806,2,2,1,3,2,2013-02-06 21:07:56,2013-02-06 21:07:56
f393d4e8d725b3e45a4b438a6f3ab7be589b2806...169fa384fea910f299f80498435e880fbcba244f,2,5,3,8,3,2013-02-06 21:16:13,2013-02-06 21:16:13
169fa384fea910f299f80498435e880fbcba244f...beede4321fef2580c8198d6c918fb2de1a0fae9c,2,9,1,10,2,2013-02-06 21:25:43,2013-02-06 21:25:43
fb60d268df2272626f48cfed7b2a185413e7e9f4...f093cd62c43da3f1c18bfba7ac3eadc671d5a6e7,22,20,0,20,9,2013-02-06 15:03:06,2012-08-15 16:49:01
f093cd62c43da3f1c18bfba7ac3eadc671d5a6e7...7e8580452c2f12877408d3dae7e63f5a6be8335d,1,18,45,63,19,2013-02-06 15:13:23,2013-02-06 15:06:17
7e8580452c2f12877408d3dae7e63f5a6be8335d...e8993455d1af01cb17e9108718a99e5181c64290,1,109,0,109,2,2013-02-06 18:45:44,2012-08-15 18:08:09
fb60d268df2272626f48cfed7b2a185413e7e9f4...3f0ed118d16c1b95d24f344384ec4ebb08ce1640,1,3,2,5,2,2013-02-05 14:47:16,2013-01-15 10:03:05
3f0ed118d16c1b95d24f344384ec4ebb08ce1640...3cf58e66974f3dcc51ebcf0dc106720f8fe14579,1,1,1,2,1,2013-02-05 14:47:17,2013-01-15 15:12:12
3cf58e66974f3dcc51ebcf0dc106720f8fe14579...c67ffd4aa0b8e98fc1951d9aeb8f33fec17beede,1,3,3,6,3,2013-02-05 14:47:18,2013-01-20 11:08:12
c67ffd4aa0b8e98fc1951d9aeb8f33fec17beede...a0c34c9406d3a41047f29e71139405d6de9731b2,3,277,0,277,4,2013-02-05 19:33:03,2013-01-20 12:27:28
a0c34c9406d3a41047f29e71139405d6de9731b2...d96aa8a9ca74a40502d86de4c36e0a54b1ed1dc7,1,0,5,5,2,2013-02-05 19:33:16,2013-01-20 17:24:54
d96aa8a9ca74a40502d86de4c36e0a54b1ed1dc7...3ad052218cd03fe58b254f878825e3f0fd4b3054,7,10,10,20,8,2013-02-05 19:33:27,2013-02-05 15:52:56
a9c07c47ea6efd95f6e26639d85bbd60aa407c42...32770c52a81091bb2ddbc3cbf8926ecdd4b10687,2,68,10,78,7,2012-12-05 21:56:32,2012-12-05 21:56:32
d74b1bc5292a438d68d802082825cbf3a6661074...f9b55bcb5f9fd8c41c74d4be58ebaad13aa9b7f3,2,5,10,15,5,2013-01-06 02:27:24,2013-01-06 02:20:42
22bcf86c5a4a5bf5bdd56d55b2ea7dbbb717e90f...72629a10e3420b7e20b2e349446b4babbed5eb2c,2,2,3,5,2,2012-12-10 18:05:31,2012-12-10 18:05:31
16e6cee2fdfa724e91f8656ad64ec87bd24fe184...05fc823fce7535faf00ad1646c087ef42f69cd67,1,3,3,6,2,2012-12-04 22:59:34,2012-12-04 22:59:34
05fc823fce7535faf00ad1646c087ef42f69cd67...a541eafa606b58e7ce3df8e496da8e032fdb74ec,1,1,2,3,1,2012-12-05 16:22:28,2012-12-05 16:22:28
560cc1e1ed0fb29679c32434490446bb6fd5dc17...41b00cccb14ad1ffae703fe0f7f5843a5ec7b5b0,1,47,0,47,1,2012-11-21 04:11:41,2012-11-21 03:59:58
41b00cccb14ad1ffae703fe0f7f5843a5ec7b5b0...ee72ffd060aa45e3ce0c8865145f99f96d00a563,2,9,9,18,9,2012-11-21 04:11:41,2012-11-21 04:04:52
ee72ffd060aa45e3ce0c8865145f99f96d00a563...24aec6db550062330a0a666df11ffc858cbffb33,1,121,65,186,33,2012-11-21 20:42:12,2012-11-21 20:42:12
560cc1e1ed0fb29679c32434490446bb6fd5dc17...cfeef7ce2ca7747a19d3caffa49cd1fda8af5730,1,23,19,42,16,2012-11-19 21:40:08,2012-11-19 21:40:08
cfeef7ce2ca7747a19d3caffa49cd1fda8af5730...02df42ddbf87820011aa4ccba9adfde52670e5e2,3,63,16,79,8,2012-11-20 00:33:30,2012-11-20 00:33:30
02df42ddbf87820011aa4ccba9adfde52670e5e2...d46b0a04c7733e430a50a9d2df195bec87d5dae6,2,79,4,83,6,2012-11-20 00:34:44,2012-11-20 00:34:44
560cc1e1ed0fb29679c32434490446bb6fd5dc17...4a03913cfb9d37455dd51cc9d342cde8dbccd742,1,1,1,2,1,2012-11-19 20:07:13,2012-11-19 03:48:40
560cc1e1ed0fb29679c32434490446bb6fd5dc17...26d9e317db361f990ecf977a99acae0a4ba4bd02,1,2,2,4,2,2012-11-19 04:00:02,2012-11-19 03:40:58
e3107e0ee182403f141178ee323e66c516cf3f08...dcaa898d8200d5eefa5ba8c7618c5526d8392da0,1,7,13,20,6,2013-05-16 19:20:08,2013-05-09 14:52:04
dcaa898d8200d5eefa5ba8c7618c5526d8392da0...e841c533d75c12156e0be8811d02f0537e32a458,3,129,7,136,15,2013-05-16 19:43:24,2013-05-09 14:42:39
e841c533d75c12156e0be8811d02f0537e32a458...f672cd2a0925c230421efccdefd8e1f640bba41b,2,25,16,41,14,2013-05-16 19:43:31,2013-05-10 18:15:57
d6c8688daceefed29dcde40154726b76960665d1...a5de9044270e29b2388185bec02d7c0de301e7d1,1,4,4,8,4,2013-04-23 00:24:44,2013-04-23 00:24:44
a5de9044270e29b2388185bec02d7c0de301e7d1...6c1b6b7abcef75d421e4d59c397eff54cc1f28aa,1,2,0,2,1,2013-04-23 14:21:47,2013-04-23 14:21:47
6117895fef92ddd08c437ce5a7cdc4bf56754cc3...0691966a738086750f784d5b0b949c5cf0235427,1,3,3,6,3,2012-02-16 11:01:09,2012-02-16 10:48:14
beede4321fef2580c8198d6c918fb2de1a0fae9c...4f1da3a2fdd93a2eee457ac95f4d10a5c61db5cf,1,0,1,1,1,2013-02-06 21:55:09,2013-02-06 21:55:09
fcd7733ded0d294ed91287a5188e8b7fac92104d...91f7335e1c779ba1d589add4fe2f58c9c580848f,1,1,1,2,1,2013-02-15 12:12:16,2013-02-15 12:12:03
390a3c81410a219b13aa6f333949c803524c8bd2...624924e876b9e69ee613dfc38541da3ef0967d56,4,51,51,102,51,2013-02-11 22:19:39,2013-02-07 22:02:56
624924e876b9e69ee613dfc38541da3ef0967d56...4d811c3b77158fdb7ee50b389c3aa8763482c61a,2,7,4,11,4,2013-02-11 22:19:40,2013-02-07 22:40:10
4d811c3b77158fdb7ee50b389c3aa8763482c61a...2bca5b679b9e1f7f7e5cfafa75a6a94549875197,7,72,23,95,13,2013-02-11 22:19:41,2013-02-07 22:44:18
d9a5009ea6ae980bb3770055aa54c05a5164bcb0...79c649e4eaa853c6190abb3a2d0a5e12ab29171c,1,2,0,2,1,2012-12-06 14:52:15,2012-12-06 14:52:15
79c649e4eaa853c6190abb3a2d0a5e12ab29171c...7be7b42f5c713e224ed3fd193ec4352b8fb82ca2,1,4,1,5,1,2012-12-06 16:08:53,2012-12-06 16:08:53
7be7b42f5c713e224ed3fd193ec4352b8fb82ca2...ed6a418791752c97645e86a75e166ebcd5b0e39c,1,1,1,2,1,2012-12-06 16:39:56,2012-12-06 16:39:56
ed6a418791752c97645e86a75e166ebcd5b0e39c...fac43c54a6f02d3dbedd11ec228d4cb606a52bff,8,9,9,18,9,2012-12-07 03:41:52,2012-12-07 03:41:52
f9b4adbe54de57431d56e0877325383d489e5196...2ba6f3c7f133e8f37450e6c56a0d798f82536ff6,1,16,10,26,7,2013-01-06 13:30:52,2013-01-06 13:30:52
72629a10e3420b7e20b2e349446b4babbed5eb2c...59bccf33c4de1124f2effd5d4b1a9ef44babefd0,10,25,10,35,21,2012-12-10 19:11:01,2012-12-10 19:11:01
a9069f6154d34c93d644a9eb4c2da55b01468982...cc6b4162de59013b5357ec35a1806fc5c9b29148,2,26,19,45,9,2012-11-20 18:24:18,2012-11-20 18:24:18
cc6b4162de59013b5357ec35a1806fc5c9b29148...38f7d026dce92ec6774a8d6e13499ea83461f287,1,2,0,2,1,2012-11-20 22:50:36,2012-11-20 22:50:36
a9069f6154d34c93d644a9eb4c2da55b01468982...52ead7877dfa24681bd17c9f82f6d3c1bb5a873a,1,7,19,26,7,2012-11-20 00:30:20,2012-11-20 00:30:20
52ead7877dfa24681bd17c9f82f6d3c1bb5a873a...2d96fce20b5ab0dd04d66165be6e067312ff19e6,1,2,5,7,2,2012-11-20 01:12:20,2012-11-20 01:12:20
2d96fce20b5ab0dd04d66165be6e067312ff19e6...e566b609df9c45994fa43c8f7a97bd4090a9b11e,1,8,28,36,18,2012-11-20 02:57:56,2012-11-20 02:57:56
e566b609df9c45994fa43c8f7a97bd4090a9b11e...cf0dadcf6ed2cfe52e2df68165f6448b6f26dbbc,1,2,3,5,2,2012-11-20 03:19:31,2012-11-20 03:19:31
28f087c8642ff9c8dd6964e101e6d8539db6281a...905fb5929bb8aa05b640d4dcb8fa611886cbe022,2,14,7,21,3,2014-07-03 03:55:02,2014-07-03 03:47:34
28f087c8642ff9c8dd6964e101e6d8539db6281a...1380e7c6b1b802efdbbe48edf706e49cc309f370,2,21,0,21,2,2014-07-03 00:34:32,2014-07-03 00:34:32
28f087c8642ff9c8dd6964e101e6d8539db6281a...0963716b3fd30a0900c22884bcd52f04d556fb67,1,12,1,13,2,2014-07-02 10:49:51,2014-07-02 10:49:51
28f087c8642ff9c8dd6964e101e6d8539db6281a...e6b0ae7a13e20c4361327e50048a5143c8e9941b,1,7,1,8,1,2014-06-30 07:29:54,2014-06-30 07:19:05
e6b0ae7a13e20c4361327e50048a5143c8e9941b...eac63e6754f8ef3b8e8d4962a8642786ee1e1a85,2,20,10,30,3,2014-06-30 08:03:36,2014-06-30 08:03:36
eac63e6754f8ef3b8e8d4962a8642786ee1e1a85...00b8c216c2349d1f5901e9412d95f83c7d043e72,2,11,19,30,5,2014-06-30 21:27:20,2014-06-30 21:18:37
28f087c8642ff9c8dd6964e101e6d8539db6281a...a142ed91e56284a01ed3e1a42cfb641a01493dd2,2,75,33,108,17,2014-06-20 17:10:38,2014-06-20 17:10:38
a142ed91e56284a01ed3e1a42cfb641a01493dd2...b247a39d8729014b5dfc104bfd8e8be2004e1f2e,1,1,1,2,1,2014-06-20 17:15:03,2014-06-20 17:15:03
5b3d52ce37100c1d63229d195041fac3e6f89d28...b81cc1d63bb42dde993979cda49550d2c224d9ed,3,82,0,82,3,2013-05-21 17:32:59,2013-05-18 14:52:16
5b3d52ce37100c1d63229d195041fac3e6f89d28...038c1654d9bb17070272d0ba6f4489eada267bd0,1,1,1,2,1,2013-05-19 05:41:18,2013-05-19 05:41:00
5b3d52ce37100c1d63229d195041fac3e6f89d28...0e0108f73f83c7cedeaafd480fdcfe3cd6b69d1f,6,215,40,255,26,2013-05-17 21:10:48,2013-05-17 20:59:57
5b3d52ce37100c1d63229d195041fac3e6f89d28...9c06b25054dd43802cbf6620c1082fa5d4498bf5,5,1476,59,1535,23,2013-05-17 13:26:24,2013-05-16 18:04:37
6c1b6b7abcef75d421e4d59c397eff54cc1f28aa...9a9de29d36c82d20a821b9b076ad388364bc5553,1,33,1,34,4,2013-04-23 17:09:45,2013-04-23 17:08:13
6c1b6b7abcef75d421e4d59c397eff54cc1f28aa...f0e37a8b863c2e6caba2b15e4d723bddfe74b46c,2,27,0,27,2,2013-04-23 16:22:29,2013-04-23 16:22:29
f0e37a8b863c2e6caba2b15e4d723bddfe74b46c...0b90366c3bf5c7149cf69b5fa1a8327032f8a60f,1,8,8,16,4,2013-04-23 16:27:38,2013-04-23 16:27:38
555c81f3356b8166c09f887450eac008b221cdc3...bcb8c007f149da6d31a6c17c179f6f89ce823d2e,3,72,0,72,5,2012-02-20 17:42:05,2012-02-20 17:37:07
bcb8c007f149da6d31a6c17c179f6f89ce823d2e...89e5ed98dcdcb00de8a2758c6f7616ac7ab78837,3,84,0,84,3,2012-02-20 18:48:41,2012-02-20 18:04:45
89e5ed98dcdcb00de8a2758c6f7616ac7ab78837...f0f3a18af66cd1d09b407748e6db0ab3707778bf,1,16,22,38,9,2012-02-20 18:48:41,2012-02-20 18:42:27
555c81f3356b8166c09f887450eac008b221cdc3...fefd4551a5b53c6c0572bdcb063f113b0a763e1d,1,147,219,366,59,2012-02-17 18:43:43,2012-01-23 03:26:49
fefd4551a5b53c6c0572bdcb063f113b0a763e1d...0774d94d31d072a4eb0958cad74a80977495a324,1,11,3,14,2,2012-02-17 18:43:43,2012-02-01 16:21:28
0774d94d31d072a4eb0958cad74a80977495a324...78d65f390f031d18ce698a24e1f83b99cc8cf699,2,27,0,27,2,2012-02-17 18:43:43,2012-02-01 16:47:17
78d65f390f031d18ce698a24e1f83b99cc8cf699...5e0dc4af013e23d0cbc737d8ab2756aaf38e1516,4,104,0,104,7,2012-02-17 18:43:43,2012-02-04 22:18:30
5e0dc4af013e23d0cbc737d8ab2756aaf38e1516...3005855f7e3980185adc63a68c5b8b5f9e3b506f,5,167,13,180,19,2012-02-17 18:50:30,2012-02-04 23:29:26
3005855f7e3980185adc63a68c5b8b5f9e3b506f...d9da4ccaa05628bf0b52bac8780d209eb96f7635,1,15,2,17,2,2012-02-17 18:50:30,2012-02-05 17:08:23
d9da4ccaa05628bf0b52bac8780d209eb96f7635...c17b1d0052c8ab8ddc4735bf72e53e13e66bf41d,7,11484,3,11487,10,2012-02-17 21:00:17,2012-02-17 18:41:14
c17b1d0052c8ab8ddc4735bf72e53e13e66bf41d...2b15f61f483391a12bdc3749c9d20d4c73757a16,1,505,0,505,2,2012-02-17 21:22:12,2012-02-17 21:22:12
2b15f61f483391a12bdc3749c9d20d4c73757a16...4a1ecba6d905fb699074df37f3fdb4cd7f5ca994,3,7,3,10,4,2012-02-18 00:31:43,2012-02-17 23:54:03
4a1ecba6d905fb699074df37f3fdb4cd7f5ca994...1eaecf2f18d57718a98f3d4054ac414df3069cf2,1,1,32,33,2,2012-02-18 00:31:48,2012-02-18 00:01:48
1eaecf2f18d57718a98f3d4054ac414df3069cf2...b13dbb91eaac4d653df5fccd9c180cc8c80ff092,2,13,10,23,10,2012-02-18 00:32:13,2012-02-18 00:32:13
f3e492107a776b2b6b2d1ee992d7b48a7a398575...ff9df88396c79d16f560308ce1b874682868ba8f,1,1,1,2,1,2013-02-08 19:28:49,2013-02-08 19:27:21
a35e8709c660770d34365bb62ae5d25d4d14b048...1ca163ff13d53d015fe7ac0322852234b03f40d0,1,10,7,17,3,2013-02-07 10:04:17,2013-02-07 10:04:17
1ca163ff13d53d015fe7ac0322852234b03f40d0...f7b060188a493f2b2bc90a98fc060a86b1dd53ce,1,20,20,40,8,2013-02-07 11:04:50,2013-02-07 11:04:50
f7b060188a493f2b2bc90a98fc060a86b1dd53ce...c9459abb61433ee83015c45cc30407512a0cb5af,1,8,8,16,3,2013-02-07 11:12:39,2013-02-07 11:12:39
4f1da3a2fdd93a2eee457ac95f4d10a5c61db5cf...ef41ab880c9e71ecae88e6252a98ed0cdf2d80cd,1,1,2,3,2,2013-02-06 22:37:51,2013-02-06 22:37:51
1d75acf7b7d9b5fd17c6d8ae62e4092f02315582...c51880eeaf80840e922309f3b5804d98ec647cc8,3,72,206,278,32,2013-02-20 16:03:18,2013-02-20 16:03:18
c51880eeaf80840e922309f3b5804d98ec647cc8...41051e3fe1bcb4099714551b61e0b7b06275557c,2,18,6,24,3,2013-02-20 16:09:51,2013-02-20 16:09:51
41051e3fe1bcb4099714551b61e0b7b06275557c...cf80993a50ec7675968f49ee10f557da6756d950,1,2,3,5,3,2013-02-20 17:46:10,2013-02-20 17:46:10
1d75acf7b7d9b5fd17c6d8ae62e4092f02315582...a7ed746093f42fd61f38a0a9ea5ef73c45f11efa,1,207,146,353,57,2013-02-15 23:58:13,2013-02-15 23:58:13
a7ed746093f42fd61f38a0a9ea5ef73c45f11efa...71d62d3905723c0263ca00a1d68825e2c35fb987,1,23,26,49,17,2013-02-16 00:01:31,2013-02-16 00:01:31
71d62d3905723c0263ca00a1d68825e2c35fb987...56543a609aa7adb14b308046445ddd48f44322b7,7,28,17,45,16,2013-02-16 00:02:45,2013-02-16 00:02:45
40a605104c2060c2bc5a08dfb62cafe473baeb21...c2907575ec050d4cbc667544f7e6114e09b7b123,1,10,3,13,3,2013-02-11 22:45:46,2013-01-15 17:24:17
c2907575ec050d4cbc667544f7e6114e09b7b123...ed55fd8bf85692040ddf6187a3528b99970c0127,1,24,14,38,7,2013-02-11 22:45:46,2013-02-11 21:29:07
ed55fd8bf85692040ddf6187a3528b99970c0127...c2c0874de2a49a153f92e7a74c3faa1778a164e9,2,119,15,134,5,2013-02-11 22:45:46,2013-02-11 22:44:56
fac43c54a6f02d3dbedd11ec228d4cb606a52bff...f1c75b94a17a2835f4166c11efe1cb4084bf5388,3,48,36,84,13,2012-12-07 15:59:18,2012-12-07 14:16:41
5df7ad3ece4feab4110a0f9371c5f63188c78470...ced8eff1e5d9e55b4fe3f903595d4edbfb0f3432,1,2,2,4,1,2013-01-06 16:37:38,2013-01-06 16:21:37
a72a8f34d3343c739579df912f2c46ebffc1143f...4cbe9a1be18338b7e223b42e6019c58181204123,1,1,1,2,1,2012-12-10 19:48:20,2012-12-10 19:48:20
54be4d57ed3cfbfb8c970f04422f840bcb731ddd...a94002a983fb02eafb09788e003a545a2d23ab76,1,4,4,8,4,2012-11-22 17:50:50,2012-11-22 17:50:50
a94002a983fb02eafb09788e003a545a2d23ab76...5cec896a3b7b85190a7862fb09f8ba20b2241f76,5,71,55,126,8,2012-11-22 17:51:06,2012-11-22 17:51:06
b0ed61f8227cb6fb937f68c9a6750851f3d0632f...90c2b37fd7e6598b32376dcbcaa9d7518f17d93f,1,1,0,1,1,2014-07-06 07:22:24,2014-07-05 19:22:56
90c2b37fd7e6598b32376dcbcaa9d7518f17d93f...b8365f21684ea062ed03d948993426a7f202e542,1,2,1,3,1,2014-07-06 07:22:24,2014-07-05 19:24:26
b8365f21684ea062ed03d948993426a7f202e542...ab864e9c7156e76863a2375d8117a049cb90bf1b,1,1,1,2,1,2014-07-06 07:22:24,2014-07-05 19:25:20
ab864e9c7156e76863a2375d8117a049cb90bf1b...cde32d4d28ae14e583853d07cdaf19ef9ee2dd25,2,10,2,12,3,2014-07-06 07:22:24,2014-07-05 19:25:55
cde32d4d28ae14e583853d07cdaf19ef9ee2dd25...491ad0de59e1002acf9919d84557345e964b9d06,1,2,1,3,1,2014-07-06 07:22:24,2014-07-05 19:26:35
491ad0de59e1002acf9919d84557345e964b9d06...72090514b14ef5d11828c960a905fe07ce68ae88,2,3,3,6,3,2014-07-06 07:22:24,2014-07-05 19:27:21
72090514b14ef5d11828c960a905fe07ce68ae88...59ceb432f310de9f26b368ae1b8cdee395e52a50,1,4,0,4,1,2014-07-06 07:22:25,2014-07-05 19:27:47
b0ed61f8227cb6fb937f68c9a6750851f3d0632f...268dafa260f6c3135484d306b1ce4f2b63320a1f,1,1,1,2,1,2014-07-03 18:19:16,2014-07-03 18:19:16
268dafa260f6c3135484d306b1ce4f2b63320a1f...ae241ae1299e35c265481f19bbffcde0830feaa6,1,4,2,6,2,2014-07-03 18:20:00,2014-07-03 18:20:00
461da57aff7785d459ce3c4d91c7f8acbffaa1a2...d30447cbafc69c8de37dad0e0be4b3a306a1e5a1,1,5,0,5,1,2014-06-23 16:02:59,2014-06-23 16:02:59
6828bf26e9e370af57d7724fe1dac9a24ac552a8...52f537e9c540fe5492ee6008153ab4db50c4091e,1,3,1,4,2,2013-05-22 00:04:12,2013-05-22 00:04:12
52f537e9c540fe5492ee6008153ab4db50c4091e...06c070b5bb213e76bff15b881ee77c0f179cdbd1,1,39,0,39,1,2013-05-23 07:43:56,2013-05-23 07:43:56
6828bf26e9e370af57d7724fe1dac9a24ac552a8...ccf1a2ba5fbd2a7d71be3e9bb895e3f2ac45e9b5,1,4,4,8,3,2013-05-21 22:15:12,2013-05-21 09:37:13
ccf1a2ba5fbd2a7d71be3e9bb895e3f2ac45e9b5...095bfd748766966f5515bdfe64867d6a09287123,2,12,5,17,3,2013-05-21 22:15:13,2013-05-21 09:38:24
60750fc43e761b57ade6373f3ede14c5187814dc...fc74343ff45187528e674712f7e858b95718edd6,1,11,0,11,1,2013-05-21 14:51:50,2013-05-21 14:51:50
60750fc43e761b57ade6373f3ede14c5187814dc...e069478edc1711e92c25eb26b82370f37775142b,1,1,1,2,1,2013-05-21 13:35:58,2013-05-21 13:35:58
26ab6284b20a3709adc7641a52250f72df9257aa...43efc4493d72b4666d8fe31b89c3aad97c3ec1a3,1,8,6,14,4,2013-05-24 12:11:22,2013-05-16 18:03:55
9a9de29d36c82d20a821b9b076ad388364bc5553...a952b9867d21b032655ac6c0eaabb558e7875926,1,0,9,9,1,2013-04-23 18:28:28,2013-04-23 18:28:28
a952b9867d21b032655ac6c0eaabb558e7875926...dfdf709e3f8aed5cb8ee54d9c508b65672c8a211,1,1,1,2,1,2013-04-23 19:04:37,2013-04-23 18:29:07
481f5e2721f4504f4c7daece5045730f7fd3fb3c...9c94a356cc61daa85e17c6342db9b3d62f788802,1,2,2,4,2,2012-02-21 11:15:23,2012-02-21 11:15:23
ff9df88396c79d16f560308ce1b874682868ba8f...2e3e8c889b5fac03ca0f3b1f1303bbdabb15f1a5,5,242,0,242,5,2013-02-11 16:36:22,2013-02-08 16:05:47
2e3e8c889b5fac03ca0f3b1f1303bbdabb15f1a5...db4bb4158f1005267e8d0e5785cb75487440580a,3,38,10,48,12,2013-02-11 16:36:28,2013-02-07 19:53:52
ff9df88396c79d16f560308ce1b874682868ba8f...6ce61a0bf64fb1339539c9537864c4e44a3712d5,1,33,33,66,19,2013-02-08 22:25:41,2013-02-08 22:25:41
ff9df88396c79d16f560308ce1b874682868ba8f...df93a6810a406308156b90f8e077d33383575774,4,130,20,150,10,2013-02-08 20:21:37,2013-02-08 20:00:08
c9459abb61433ee83015c45cc30407512a0cb5af...fcd81bcf52d1c7a033ad185febf7d92b762ae3a8,2,2,2,4,2,2013-02-07 17:47:29,2013-02-07 17:47:29
70ecec1a7c2458796711e841da2fd1a0a0f24fc7...a9d081e504d596d97ae2026b76993fa229efa9e7,1,1,1,2,1,2013-02-10 18:36:39,2013-02-10 18:36:39
a9d081e504d596d97ae2026b76993fa229efa9e7...a150cc875da834fc18b2c60fa2cb5580fff532ab,1,3,1,4,3,2013-02-10 23:16:10,2013-02-10 23:16:10
a150cc875da834fc18b2c60fa2cb5580fff532ab...8c29dca6c372cae1c6a97d78252ee1d7ac10673b,3,3,3,6,3,2013-02-11 14:25:57,2013-02-11 14:25:57
fd69c7bf9a41d3fbdb4ae571af2eef5ff8fb6335...93ab370b53f403ceebeabb7406c33024c3fb1243,2,13,3,16,10,2013-02-20 18:50:01,2013-02-20 18:50:01
93ab370b53f403ceebeabb7406c33024c3fb1243...e223717902545f94bbc459c1d350cc18b089748a,1,44,54,98,33,2013-02-20 18:58:56,2013-02-20 18:58:56
fd69c7bf9a41d3fbdb4ae571af2eef5ff8fb6335...63964c891b47cda821797ea435fb4290410a6f6d,1,8,59,67,16,2013-02-20 17:49:00,2013-02-20 17:49:00
8b107c6770516db9527f565af0298b9c1f738e58...47fbcbb5a8d4aad87371a381ebdadd04cde3fb2b,1,1,1,2,1,2013-01-06 18:02:37,2013-01-06 18:02:37
47fbcbb5a8d4aad87371a381ebdadd04cde3fb2b...e5562e181cd76d3b0447011bc892c86b03ed2952,1,1,1,2,1,2013-01-06 18:12:05,2013-01-06 18:12:05
e5562e181cd76d3b0447011bc892c86b03ed2952...7eb222fc7d392e8570e93373d7ffc7f67ea792cc,7,12,12,24,11,2013-01-06 18:39:35,2013-01-06 18:39:35
4cbe9a1be18338b7e223b42e6019c58181204123...9950d27ab62cc31a3ebf1944fd33dd65432be790,11,58,35,93,37,2012-12-10 23:38:28,2012-12-06 21:26:58
9950d27ab62cc31a3ebf1944fd33dd65432be790...91e7d26303b17c7ebc45ba565247e968aaa20848,8,253,119,372,84,2012-12-10 23:38:41,2012-12-10 23:29:44
98ce2318c86b0bf276c016c598f86c4d3566fc69...9ed104a8fa9fc28bb29a0ff53c68094696e13aea,1,10,0,10,2,2014-07-04 15:41:40,2014-07-04 15:16:17
9ed104a8fa9fc28bb29a0ff53c68094696e13aea...f5287fa6c39762072e30140329c41e9f304d7c04,2,55,18,73,7,2014-07-04 16:00:20,2014-07-04 15:17:23
f5287fa6c39762072e30140329c41e9f304d7c04...9fef46deaf5af415a4bab774a223d3816cf12fa4,1,3,0,3,1,2014-07-04 16:00:20,2014-07-04 15:33:35
5815266981f61b2ecda7b85e444a32ced38a9e85...130cb548011c95ddcbba4a61affc32e3b513ed5b,1,2,0,2,1,2014-06-24 15:37:41,2014-06-24 15:37:41
9c941ccfaf600caef3c87387a6992bfe5a17c742...3b32b6d3cc649a7808151dd67d1dd3e45e202f08,2,131,3,134,8,2013-05-23 22:57:52,2013-05-23 16:19:42
3b32b6d3cc649a7808151dd67d1dd3e45e202f08...0700ca1a74b58b73c4fb9ececffeaa80046c2f58,1,34,23,57,15,2013-05-23 23:11:53,2013-05-23 23:11:53
9c941ccfaf600caef3c87387a6992bfe5a17c742...93d8f77fed9407421ba1c90141d997b2dea7e0e7,10,66,0,66,7,2013-05-23 22:35:50,2013-05-23 22:11:53
93d8f77fed9407421ba1c90141d997b2dea7e0e7...6f0b8142e65b43f2224027a7abc67116ab6ad1a7,1,6,1,7,4,2013-05-24 00:28:52,2013-05-24 00:28:52
4bc67efd7408faaab714478604a0543e568b7564...25a899ec8431cf4738ee7eb6ca79f60cc27141de,1,2,1,3,1,2013-05-24 10:32:26,2013-05-24 10:30:32
495d6f07c44c48e9968eb82f65c3336ba1922398...bd0a07f4bb0b83a84127589f7385eb2309910b66,2,6,4,10,2,2013-04-23 19:28:59,2013-04-23 19:28:59
9c94a356cc61daa85e17c6342db9b3d62f788802...b60deb0235404367af61e3d3638dfe88c13b0e7c,2,6,3,9,5,2012-02-22 04:45:30,2012-02-22 04:41:08
9c94a356cc61daa85e17c6342db9b3d62f788802...b6c93aef4276051f9c4536ecbed48f4cd093bd1b,17,1312,61,1373,51,2012-02-21 22:46:24,2012-02-21 22:46:24
b6c93aef4276051f9c4536ecbed48f4cd093bd1b...da337c806468d2d8a27dfa9ee5e75e476f5ad546,3,66,44,110,30,2012-02-22 19:22:33,2012-02-22 19:22:33
da337c806468d2d8a27dfa9ee5e75e476f5ad546...0534641dfec001794ae9a83cfd1cfc7acaef97b7,7,221,284,505,110,2012-02-22 23:15:35,2012-02-22 23:15:35
36d72a5125b28a381b240b1bc506bcf2d59c94b7...012695400751148f3f10b2e3302b61adaff28714,1,1,1,2,1,2012-02-23 15:51:07,2012-02-23 15:51:07
41713ec15f66d263c2d7d40dd07f1f5a468e3e22...943700ecbbc2be4ef49c5c31d8e5c49353fd3d84,5,31,9,40,13,2013-02-07 19:44:34,2013-01-18 15:37:13
943700ecbbc2be4ef49c5c31d8e5c49353fd3d84...0d64ba48372f95ade17a27f1b11620638ca52d61,4,260,44,304,14,2013-02-07 19:44:35,2013-01-25 16:35:46
8c29dca6c372cae1c6a97d78252ee1d7ac10673b...b8b897bbc54db5efe34a4adef1f12acb546ce27d,5,66,2,68,11,2013-02-11 14:35:26,2013-02-11 13:28:53
e223717902545f94bbc459c1d350cc18b089748a...0cfce06d08a6e9feb1b05af1b8df30e94ba46eae,1,97,0,97,1,2013-02-20 19:58:21,2013-02-20 19:58:21
6a0ffe84a721504783bdb3579d239849960dacd6...19be3f9e65723f3db8561d6025e5d3c601b8a124,1,56,7,63,5,2013-02-13 21:01:14,2013-02-13 17:36:41
19be3f9e65723f3db8561d6025e5d3c601b8a124...5f633e911e041b4fbbbb2ed5efa0c8a2163df116,1,1,1,2,1,2013-02-13 23:12:51,2013-02-13 23:12:51
7eb222fc7d392e8570e93373d7ffc7f67ea792cc...c31ae146b4fec2220db981465f2bde221fec1f72,2,4,4,8,3,2013-01-07 00:38:29,2013-01-07 00:38:29
55325efa1d1dbe821da990ec9245ff0653944faa...640716176bfea62ccff7993b5e88297ddcbfd8b0,1,1,0,1,1,2012-12-11 23:08:08,2012-12-11 23:08:08
5e37874dd43239afb0e611a1e4ef426c0614d905...29fe897d80c0b66bebb35ca6fd34473b5edb9a60,1,2,0,2,1,2014-06-24 15:52:52,2014-06-24 15:52:52
5e57cfa1b34374835f03e8d0ea61c338ed5cd9f0...0f1f9833cf13ac8714ec21fcf29d895ff8cbfe24,3,11,10,21,8,2013-05-24 17:32:07,2013-05-24 17:32:07
0f1f9833cf13ac8714ec21fcf29d895ff8cbfe24...2e62e7c23ce69d89d495a2c42458c7e185a3120a,2,36,2,38,4,2013-05-24 17:33:41,2013-05-24 17:33:41
2e62e7c23ce69d89d495a2c42458c7e185a3120a...16adc9fade52b49e2bc13cb52407cc0025a93c8b,4,44,29,73,23,2013-05-24 17:35:58,2013-05-24 17:35:58
16adc9fade52b49e2bc13cb52407cc0025a93c8b...d20b044961352348855ee82dcc77615f605ac832,2,14,5,19,4,2013-05-24 17:37:40,2013-05-24 17:37:40
d20b044961352348855ee82dcc77615f605ac832...7a5ee3dc923caf2b3b9b5e9b2408340f6ae32d7d,3,59,13,72,11,2013-05-24 18:09:04,2013-05-24 18:09:04
bd0a07f4bb0b83a84127589f7385eb2309910b66...a5df71c11fef996d67593546fa1edb2865e6a5d9,1,12,1,13,2,2013-04-23 19:57:30,2013-04-19 14:36:01
a5df71c11fef996d67593546fa1edb2865e6a5d9...608d04667ae08e991c1ffa6f33573d15930245b3,1,10,2,12,3,2013-04-23 19:57:30,2013-04-22 20:51:35
608d04667ae08e991c1ffa6f33573d15930245b3...ab01cbd4ddd756c7beda3f483791cb5d4e211872,3,50,9,59,11,2013-04-23 19:57:30,2013-04-22 21:24:12
ab01cbd4ddd756c7beda3f483791cb5d4e211872...eac76c230c92594eaa528e50746119bd3c33ffbb,4,27,53,80,17,2013-04-23 19:57:30,2013-04-22 21:27:36
eac76c230c92594eaa528e50746119bd3c33ffbb...6be368bf16c86380ea84d7e39b65e0ebd9606174,1,7,1,8,2,2013-04-23 19:57:30,2013-04-22 23:24:53
6be368bf16c86380ea84d7e39b65e0ebd9606174...b1ff7004ab132c8d4bddd181127f1c8d5ce9b7b4,4,291,89,380,28,2013-04-23 19:57:30,2013-04-22 23:25:57
b1ff7004ab132c8d4bddd181127f1c8d5ce9b7b4...687db88faf8bcfe7bccfedf65fa304f59987089c,1,5,1,6,1,2013-04-23 19:57:30,2013-04-22 23:45:36
df16fbcf36d5bad02c2553cdb15469eb3b603c05...1ec1de6d43e2f4dcf18ad730efbbfc20d0e4adb0,2,5,5,10,5,2012-02-23 19:15:45,2012-02-23 19:15:45
1ec1de6d43e2f4dcf18ad730efbbfc20d0e4adb0...290f240ee006fef9d65cf987ad5e0d99e956b936,4,30,14,44,12,2012-02-23 19:16:47,2012-02-23 19:16:47
290f240ee006fef9d65cf987ad5e0d99e956b936...f01fa26690d28efe9f73daf81d0ba11b2b77ccbc,1,2,2,4,2,2012-02-23 19:17:48,2012-02-23 19:17:48
f2e1d06064696a07c917dbcce0dd04c1cbfe32e9...eb5ffd19449b68f524aaf9dc70d28a8ce7d354fa,1,2,1,3,1,2013-02-21 17:00:29,2013-02-21 17:00:29
f2e1d06064696a07c917dbcce0dd04c1cbfe32e9...9c454b007b57669e7baf2b8b69cf053f32a620a2,3,439,0,439,5,2013-02-20 23:09:40,2013-01-12 06:13:02
9c454b007b57669e7baf2b8b69cf053f32a620a2...f3327cac1d5cc47d37eb79eb4235f40e447f3ef9,1,69,11,80,9,2013-02-20 23:09:40,2013-01-13 18:06:09
f3327cac1d5cc47d37eb79eb4235f40e447f3ef9...99ba8f2322eaa2df51ace9782b8eadc8c5a6e8b8,1,8,2,10,4,2013-02-20 23:09:40,2013-01-22 23:27:08
99ba8f2322eaa2df51ace9782b8eadc8c5a6e8b8...5e5848eb15cc0dd8476d1c6882a9f770e6556586,6,498,464,962,31,2013-02-20 23:09:40,2013-02-15 01:25:10
5e5848eb15cc0dd8476d1c6882a9f770e6556586...aa6432604e09de40ee20ee1f6631a2f717111863,1,79,0,79,1,2013-02-20 23:09:41,2013-02-15 19:08:02
aa6432604e09de40ee20ee1f6631a2f717111863...a235e9d355c2188eb35efeac8147b2e8b626caa3,1,13,0,13,2,2013-02-20 23:09:41,2013-02-15 22:12:43
a235e9d355c2188eb35efeac8147b2e8b626caa3...9bc8be3d7e5134de1d912c7ef08d6207079bd8c1,5,110,17,127,21,2013-02-20 23:09:41,2013-02-19 18:25:41
9bc8be3d7e5134de1d912c7ef08d6207079bd8c1...71a3d27ea686845811f04314d02798b4f1745046,8,128,122,250,82,2013-02-20 23:10:21,2013-02-08 18:06:47
71a3d27ea686845811f04314d02798b4f1745046...960a04dd56d89e94b5092be19ba9704b2d292dba,4,235,76,311,53,2013-02-21 20:40:33,2013-02-21 20:40:33
960a04dd56d89e94b5092be19ba9704b2d292dba...d4b747c1cb72119d783154f88640920d3a3fdb3d,23,211,84,295,24,2013-02-22 00:44:44,2013-02-22 00:44:44
d4b747c1cb72119d783154f88640920d3a3fdb3d...6f9d5ce818f76d305a7aecf727ecda8cff63259c,2,41,14,55,15,2013-02-22 18:17:08,2013-02-22 18:17:08
6f9d5ce818f76d305a7aecf727ecda8cff63259c...f8275890676a56735b1af1abde859722f040a61c,1,29,42,71,9,2013-02-22 18:19:50,2013-02-22 18:19:50
f8275890676a56735b1af1abde859722f040a61c...0a0089131f6e3c0d6be35c47dd243c87cf8c3fc9,1,15,15,30,4,2013-02-22 18:21:02,2013-02-22 18:21:02
0a0089131f6e3c0d6be35c47dd243c87cf8c3fc9...1be4ba984216dfcb1f07945240c2831395fd0460,1,99,15,114,5,2013-02-22 19:13:01,2013-02-22 19:13:01
b78600255cf22b65a825a6c0eaf7962bfe930053...2fe67aeb10ec7d5995464589687ff193959a71b4,1,14,13,27,15,2013-02-14 13:46:58,2013-02-14 13:46:58
2fe67aeb10ec7d5995464589687ff193959a71b4...a9e1339c06795c9b5f4eb4e5b2f56b8fadf98115,1,3,2,5,2,2013-02-14 16:12:55,2013-02-14 16:12:05
05e9fc583573c0709b997584ba839f9d643136cf...f6ed5e2d055fec0ed6cc36d613362f733860ccdd,1,28,98,126,19,2013-01-07 14:53:43,2013-01-07 14:53:43
8d13035e0d99de80222ea9a2580de04692288007...08f3d6caf4bc1e3695e04c85f1f7d3d0a4dd1554,1,1,1,2,1,2012-12-12 12:23:05,2012-12-12 12:23:05
3ddd0d929d329c09c5bf37258b81c76b52c68c56...e1fc03c9baea9864dec90d0aef7aadcc2ff20576,1,2,0,2,1,2014-06-24 15:56:27,2014-06-24 15:56:27
85281328be6341794341a9a46b54e3a557b2b889...c37fb41ae02f7bd99237720181d0736ab1de9bc0,1,2,1,3,1,2013-05-25 16:35:55,2013-05-25 16:35:55
2370b4d79e22663c956d49026950fd1719a6cf98...879458e7cf87374241da300a864493761bf48e7c,4,32,5,37,8,2013-04-24 13:52:58,2013-04-24 13:52:33
879458e7cf87374241da300a864493761bf48e7c...b4117e19b7a968f8e6b878d81c58a462093cf1b3,3,34,26,60,8,2013-04-24 18:25:57,2013-04-24 18:09:42
f01fa26690d28efe9f73daf81d0ba11b2b77ccbc...aa4254d92eb540e6346389691c06977cf50338e3,1,1,0,1,1,2012-02-23 22:38:48,2012-02-23 22:27:29
f01fa26690d28efe9f73daf81d0ba11b2b77ccbc...82ccb87ef6b861ce681a869e1b8e0928e6b5f3fb,1,1,0,1,1,2012-02-23 22:00:45,2012-02-23 21:56:04
0309e85045bfb143c172b3342293d98d687e8092...6c72035fbc9688d52ccee47f3efb24913fc20af9,2,33,14,47,7,2013-02-22 17:23:14,2013-02-22 17:23:14
0309e85045bfb143c172b3342293d98d687e8092...c1b5e8c42bca585c2bc728a0583b20095bd8c128,6,39,19,58,18,2013-02-22 16:04:23,2013-02-15 10:35:33
c1b5e8c42bca585c2bc728a0583b20095bd8c128...bbc53e4f93542ad442d9d491563ddacaf9ae9b12,1,23,63,86,17,2013-02-22 16:04:25,2013-02-15 11:43:03
0309e85045bfb143c172b3342293d98d687e8092...d788499a102b8b5b02f5d64a6f9bf5c5a7bdb5e3,1,32,0,32,1,2013-02-22 14:25:57,2013-02-22 14:02:37
d788499a102b8b5b02f5d64a6f9bf5c5a7bdb5e3...39bcb4deb816573b8f68154f90288ad1e21e1520,1,11,9,20,8,2013-02-22 14:25:58,2013-02-22 13:44:57
39bcb4deb816573b8f68154f90288ad1e21e1520...9ccab8dfb86bb75c8810ad490b3713c0fa052b01,2,39,0,39,2,2013-02-22 14:25:59,2013-02-22 14:25:06
e68e33f33d98c171d31dac33257250b5ecded4c9...5fa8abb86843950a95d220f90cce49cf8d6df830,1,3,0,3,2,2013-02-28 16:36:20,2013-02-28 16:36:20
e68e33f33d98c171d31dac33257250b5ecded4c9...11b5beb7ba92ae1214f1fec91d8e13df2e6dca01,1,10,3,13,3,2013-02-27 23:07:28,2013-02-27 23:07:28
11b5beb7ba92ae1214f1fec91d8e13df2e6dca01...f708c89fa6e0d156d7b083de53d311babd3d2d8c,1,5,5,10,3,2013-02-27 23:15:39,2013-02-27 23:15:39
f708c89fa6e0d156d7b083de53d311babd3d2d8c...97b7137459a64e24fbe5ef16bee254cae6b018a1,3,7,10,17,5,2013-02-28 22:14:45,2013-02-28 22:14:45
97b7137459a64e24fbe5ef16bee254cae6b018a1...f443a72d334f8f52c3431e6b4181704a3f125d5e,3,10,4,14,5,2013-02-28 22:41:26,2013-02-28 22:41:26
a9e1339c06795c9b5f4eb4e5b2f56b8fadf98115...a53b5e5fc31187cada9ba1f6eccf841484aede53,1,10,0,10,2,2013-02-14 19:22:48,2013-02-14 19:20:18
7dfc5c3c6c4cebe6e2477186a8e7ed6e7dba2c55...f6234cd994ad01fb3aa8c2f0fd8e3d2cf89cf3f2,2,109,1,110,3,2013-01-07 22:13:18,2012-12-21 19:57:43
f6234cd994ad01fb3aa8c2f0fd8e3d2cf89cf3f2...f2b7f7a6cb8678763ada70e75d5b38407770e269,5,203,143,346,46,2013-01-07 23:44:22,2013-01-07 23:44:22
6cacd44bd036e9987134a4f43fee33dc1acb447b...e759b0721718f99f515997c2e7c9c254b35741af,1,5,4,9,3,2012-12-12 23:54:12,2012-12-12 23:54:12
6cacd44bd036e9987134a4f43fee33dc1acb447b...a71c27ccda7f7118ac2c50789fc1407d4d940b98,3,60,38,98,15,2012-12-12 20:15:25,2012-12-12 20:15:25
a71c27ccda7f7118ac2c50789fc1407d4d940b98...b914e17d8268f836bcd8b785781ed24cbec1c29f,3,29,2,31,4,2012-12-12 20:23:24,2012-12-12 20:23:24
b914e17d8268f836bcd8b785781ed24cbec1c29f...44f36f6e3ba40420d0a8bb2977e6ada2b735bc2b,7,66,39,105,45,2012-12-13 03:48:44,2012-12-13 03:48:44
44f36f6e3ba40420d0a8bb2977e6ada2b735bc2b...7c353afd0e9da7b7ec55c3c421f03ea17fe266e5,6,15,7,22,8,2012-12-13 16:47:29,2012-12-13 16:47:29
7c353afd0e9da7b7ec55c3c421f03ea17fe266e5...34c8c754333ff4de349085e697d8529a41d6640d,1,11,2,13,4,2012-12-13 16:54:23,2012-12-13 16:54:23
34c8c754333ff4de349085e697d8529a41d6640d...24393ea6d349c49c2c36eae7d51a367ef0e1b3df,4,13,3,16,6,2012-12-13 17:14:56,2012-12-13 17:14:56
24393ea6d349c49c2c36eae7d51a367ef0e1b3df...2b10a2b0e8f658af52ee806f1ab7e46eca37772f,1,17,1,18,3,2012-12-13 19:47:14,2012-12-13 19:47:14
e1fc03c9baea9864dec90d0aef7aadcc2ff20576...0cee70ebb7297f155129e0d05f5a23be82231256,39,158,148,306,132,2014-07-01 18:40:16,2014-07-01 18:09:01
0cee70ebb7297f155129e0d05f5a23be82231256...9879fee184adaace842ed4bb055fd2942d975591,1,3,3,6,2,2014-07-01 18:40:16,2014-07-01 18:11:14
e1fc03c9baea9864dec90d0aef7aadcc2ff20576...4e813a8b60de003ca4b516bf5e39d60d6335ad77,1,1,1,2,1,2014-06-25 13:11:16,2014-06-25 13:11:07
e1fc03c9baea9864dec90d0aef7aadcc2ff20576...d412165f948b77bf548234fd46fb0743f6afc3ed,3,12,3,15,3,2014-06-24 17:46:32,2014-06-18 21:54:32
0d77647adc1f76df66e437e6442d7f7706e2c38e...f8bd730cd90a1e6219447cc9c05f41295d42bbcb,1,2,1,3,1,2013-05-26 15:29:00,2013-05-26 15:29:00
b4117e19b7a968f8e6b878d81c58a462093cf1b3...eb63fda2e24d007e31742587984a30e086249d43,5,48,16,64,18,2013-04-25 17:40:33,2013-04-25 16:52:17
34ab819ef923c3ff83be44b0c01373e65783b0ab...1db9d2c3bba2fe95280dca34bc04d261bd5d31f7,1,2,0,2,1,2012-02-24 01:11:20,2012-02-24 01:11:20
1db9d2c3bba2fe95280dca34bc04d261bd5d31f7...9554cd514c2a0acd6c9df255b457356873ab16b2,2,16,0,16,2,2012-02-24 11:14:26,2012-02-24 11:14:26
9554cd514c2a0acd6c9df255b457356873ab16b2...0a43d7cb19bb229688bec6acececed159e5d0648,1,61,52,113,22,2012-02-25 18:00:06,2012-02-25 17:52:28
0a43d7cb19bb229688bec6acececed159e5d0648...6b63589e3512cb8ad895dcac8482850c2f256f29,1,69,13,82,15,2012-02-25 18:01:02,2012-02-25 18:00:58
5eeb357df806a60664f61bf1238a21a402732c44...fc6c5b5001ecf6d5cf69c0c4cebbfa4d0edec4a1,39,0,1528,1528,39,2013-02-25 17:03:05,2013-02-25 17:03:05
06eaa06f2687d0a27b1df48b5233834952c2cb1e...7beeb3f4206b37981e3c42d25a0a638055c068ed,1,59,59,118,23,2013-02-22 19:03:44,2013-02-22 19:03:44
cc427158d4fafa26e3d2d9f69da51a1a8d8a92d4...7d46b34baf257835636d1b5f8a78289cb6d0b186,1,13,2,15,7,2013-03-01 20:26:05,2013-03-01 20:26:05
cc427158d4fafa26e3d2d9f69da51a1a8d8a92d4...926acbcf8ed80a69ab82f3d14e90dabeca9af07d,4,91,2,93,7,2013-03-01 19:56:09,2013-03-01 16:07:53
368a2b4e3edc32229793045f4970d33b366722bd...d335e73a6a675c415d844aab4396e3bbf1274a26,1,13,12,25,5,2013-01-08 22:37:19,2013-01-08 22:37:19
ae0ddc6f024c52d8a4144b31ff122b922d72aeb4...cb2ace69f453c598e97697fda449e8ce75fd5c0a,1,24,9,33,1,2012-12-13 19:42:40,2012-12-13 17:51:23
cb2ace69f453c598e97697fda449e8ce75fd5c0a...8a8820d89fce2831e4a3efffcd9b75cbc479152a,1,8,0,8,1,2012-12-13 22:58:12,2012-12-13 22:58:12
8a8820d89fce2831e4a3efffcd9b75cbc479152a...f0a2def5e4f0d8e91bf6fca66ac64d8a8c893c84,1,6,4,10,4,2012-12-13 23:08:45,2012-12-13 23:08:45
b0b9fd32450227e36e2deae75e86a844ee34bd01...509216a5b2050013c629ddc14ecae3a92b07ecea,1,5,2,7,2,2012-12-14 01:49:01,2012-12-14 01:49:01
509216a5b2050013c629ddc14ecae3a92b07ecea...2d466b7dcb987206a32c84f20a08ca219724fa1c,1,0,5,5,4,2012-12-14 01:49:11,2012-12-14 01:49:11
2d466b7dcb987206a32c84f20a08ca219724fa1c...37ac44366bc2a400c993d6b3367bfdd3262e840c,1,2,1,3,1,2012-12-14 02:12:03,2012-12-14 02:02:33
1fe562434d00f0bbf6f944b95788cf904163d940...c61dc1a92e6d7fed6da158b430c206480c1439d7,1,2,1,3,2,2014-06-25 15:12:44,2014-06-25 15:12:44
5aee96329ab7869cbe90cf80fd2a3f8f4dc5dccf...0582ae6fde94912c4ac7566f151bd0e3b786bb43,1,2,0,2,2,2013-05-27 10:12:27,2013-05-21 11:56:40
78bf2944ed0512f38dfcb56f590373a904ca29c0...51e4da6d8aa4a3a961d49197b004dbf7ccee8612,1,18,5,23,4,2013-04-28 23:49:40,2013-04-28 23:49:40
51e4da6d8aa4a3a961d49197b004dbf7ccee8612...fb42a22e2fedeca8a5d0fa4a32653285374e689d,1,4,0,4,1,2013-04-29 00:15:51,2013-04-29 00:15:51
78bf2944ed0512f38dfcb56f590373a904ca29c0...528a4e24c6671d621847cf8e3121e3c56fe20d3b,4,12,1,13,4,2013-04-28 12:21:10,2013-04-28 12:16:45
528a4e24c6671d621847cf8e3121e3c56fe20d3b...d84884571d04d609ed5f3508aecd9e24b84f47c7,3,127,9,136,8,2013-04-28 16:49:51,2013-04-28 14:26:55
6b63589e3512cb8ad895dcac8482850c2f256f29...8171998f8d90574ecf36016192b6426ed74751f6,3,98,0,98,4,2012-02-26 18:15:36,2012-02-26 18:15:36
25a0831f2d71c5802bff7c4a247dbd0315b767ba...3c42e4ef7428de18784e04c9cac18de3613144cb,6,278,82,360,42,2013-02-26 19:43:14,2013-02-26 19:43:14
3c42e4ef7428de18784e04c9cac18de3613144cb...0d1b094b07d836a657ad9e458e04490d1e72d365,4,43,14,57,22,2013-02-26 21:15:06,2013-02-26 21:15:06
0d1b094b07d836a657ad9e458e04490d1e72d365...18f08264082dd436914c3c06d369e7a98ddf17aa,5,70,60,130,30,2013-02-27 21:44:15,2013-02-27 21:44:15
25a0831f2d71c5802bff7c4a247dbd0315b767ba...fcc265fef814c0428fb6300e7f89d4ee99311ee7,1,27,1,28,1,2013-02-25 21:22:15,2013-02-17 15:52:26
fcc265fef814c0428fb6300e7f89d4ee99311ee7...6774b1071f946146978186460fd93bfb331bc786,1,32,0,32,3,2013-02-25 21:22:15,2013-02-17 16:52:16
7beeb3f4206b37981e3c42d25a0a638055c068ed...37d9168608e9d9a5451011e83623a829eb896dd5,2,35,13,48,8,2013-02-22 20:21:54,2013-02-22 20:21:54
47f70846aae7605297c943282ac19af2e2c8c206...487fc724ffa0d0260fc4c2a3ab0ea0d5d2ebe81d,2,4,12,16,5,2013-03-01 21:41:53,2013-03-01 21:41:53
426b2e2fce17b09203f00e013e173328f50fd9e8...3f0d0c85d06f0d5ff9ba469c6ab523bfddcc710b,3,21,3,24,7,2013-03-01 20:46:21,2013-03-01 20:44:18
3f0d0c85d06f0d5ff9ba469c6ab523bfddcc710b...cb53669e14f9a29b797d108c50d04566f82ab58f,3,6,6,12,6,2013-03-01 21:38:13,2013-03-01 21:38:13
d4df288ddc412468df4bb88dcee425bc3fd04f1f...8f09f4649857c3b7f8f9e1fef5e8fea589289518,5,1,337,338,6,2013-01-08 22:55:16,2013-01-08 22:54:44
37ac44366bc2a400c993d6b3367bfdd3262e840c...7e610440194615fe5970f5f15266893f02a7f6aa,1,33,0,33,1,2012-12-14 20:30:57,2012-12-14 20:21:59
7e610440194615fe5970f5f15266893f02a7f6aa...18b2d560d376da8bcb601603346b871c05958772,6,88,121,209,47,2012-12-14 21:03:59,2012-12-14 21:03:59
18b2d560d376da8bcb601603346b871c05958772...0015b5875eda08fe1e593942710125e9db7896b5,1,10,5,15,5,2012-12-14 21:18:06,2012-12-14 21:18:06
0015b5875eda08fe1e593942710125e9db7896b5...b9e7e2b4e148deb90119d4c2c52d8d9e889527cd,7,60,58,118,43,2012-12-14 21:46:45,2012-12-14 21:46:45
c61dc1a92e6d7fed6da158b430c206480c1439d7...5e0f47c3753c5ddd206ab3af6d2a231ad3da39c4,2,7,4,11,5,2014-06-25 19:20:39,2014-06-25 19:20:39
5e0f47c3753c5ddd206ab3af6d2a231ad3da39c4...966fb207021830819aad9fce098b4a63838def4d,1,2,0,2,2,2014-06-25 19:25:44,2014-06-25 19:25:44
966fb207021830819aad9fce098b4a63838def4d...c19b1c0442b52e07f1c9f48b65ef0b3823eaa526,2,11,13,24,8,2014-06-25 19:35:58,2014-06-25 19:35:58
63908cee27e85949130f9b0a187c316f1d98b3a2...563c19a9ce556301e642a508e53598faf3c8935a,2,45,25,70,8,2013-05-27 11:41:09,2013-05-11 09:36:29
0f85c208406ef10e2f1c7fea6fb42ef52fe65134...ac1d85cf11ceb8bf9c9600ce9c29d5d037220cfb,1,1,1,2,1,2013-04-29 16:00:05,2013-04-29 16:00:05
0f85c208406ef10e2f1c7fea6fb42ef52fe65134...0c72248b9171acee7480a77edee89fa20fabdae8,2,14,0,14,2,2013-04-29 14:34:13,2013-04-29 14:34:13
0c72248b9171acee7480a77edee89fa20fabdae8...8564a0224abe09beaacb2d2e7a54b16f8fcea7d1,2,23,2,25,3,2013-04-29 15:51:24,2013-04-29 15:51:24
8564a0224abe09beaacb2d2e7a54b16f8fcea7d1...aa8f010120577e61715f3ae1286a03055815f9c3,3,63,14,77,8,2013-04-29 15:59:46,2013-04-29 15:59:46
aa8f010120577e61715f3ae1286a03055815f9c3...b7f167da29effa125663b143d3daf79a6ad88d2e,17,30,41,71,31,2013-04-29 20:52:12,2013-04-29 20:52:12
b7f167da29effa125663b143d3daf79a6ad88d2e...d77611022c4a43d5e67cf52ce2bc2b11ee5bcdc0,7,47,65,112,19,2013-04-29 21:22:06,2013-04-29 21:22:06
d77611022c4a43d5e67cf52ce2bc2b11ee5bcdc0...e4af0f001600cfe7d72cfb140fc7dc2d25be2c37,1,33,0,33,1,2013-04-30 01:15:43,2013-04-30 01:15:43
e4af0f001600cfe7d72cfb140fc7dc2d25be2c37...203d5b0e6829242ea412bbef7751e3c522ac5dd8,5,4,13,17,5,2013-04-30 01:20:58,2013-04-30 01:20:58
4157851076d476b3b7f9a8bb9b85497517b14cdf...0a1755c045b930de474883eb6e7fedcc3403b494,2,41,0,41,2,2013-04-30 10:15:45,2013-04-30 10:15:45
4157851076d476b3b7f9a8bb9b85497517b14cdf...8d39f2a79067c9551286bb552457db71b88b64d3,2,15,0,15,2,2013-04-30 08:55:17,2013-04-30 08:55:17
8d39f2a79067c9551286bb552457db71b88b64d3...1ffd0806f406a9dc300dbdefaf1e1d036a4294b4,5,62,10,72,13,2013-04-30 10:04:59,2013-04-30 09:18:16
1ffd0806f406a9dc300dbdefaf1e1d036a4294b4...9c5d4b2e807cdbb83cf55868700b0387cd4e8c41,1,1,0,1,1,2013-04-30 10:05:16,2013-04-30 10:05:16
e07c2d225deec42e592133df49ad8c564d4d66c7...8f7be6ca8a79f04620ca6cf280a3a04d1d96f2c3,1,119,0,119,1,2012-02-27 20:38:22,2012-02-27 20:30:22
8f7be6ca8a79f04620ca6cf280a3a04d1d96f2c3...155aca2da79c8cae650c4e4f387a40d8f0a66527,2,117,0,117,5,2012-02-27 21:00:27,2012-02-27 20:17:13
155aca2da79c8cae650c4e4f387a40d8f0a66527...f0fa1c1a73f5a19a9799c0f8b90dcd533154cb3a,1,15,0,15,1,2012-02-27 21:07:20,2012-02-27 21:00:49
f0fa1c1a73f5a19a9799c0f8b90dcd533154cb3a...f7367993cba7b6a3c72da0b4a09c0ae88c7446c0,3,64,0,64,4,2012-02-27 21:26:37,2012-02-27 21:22:45
f7367993cba7b6a3c72da0b4a09c0ae88c7446c0...a4a910dd9c485989cecdf8af19750a11f0d2653d,1,17,0,17,1,2012-02-27 21:46:45,2012-02-27 21:46:45
e07c2d225deec42e592133df49ad8c564d4d66c7...13224ea4aad9a1b3c9cc4c992ceaea9af623e047,16,158,157,315,116,2012-02-27 04:30:07,2012-02-27 03:28:31
13224ea4aad9a1b3c9cc4c992ceaea9af623e047...44b1ff4c1209c34360cc0c43761c40f5f5020886,4,281,49,330,17,2012-02-27 04:30:07,2012-02-27 03:31:05
44b1ff4c1209c34360cc0c43761c40f5f5020886...eb8f90e523b344fc24358994ad63e737520b85b7,1,2,0,2,1,2012-02-27 16:22:51,2012-02-27 16:22:51
eb8f90e523b344fc24358994ad63e737520b85b7...450b40cab39c786bf67e7491755e7d0b3a4dc3ba,3,129,0,129,5,2012-02-28 00:13:32,2012-02-28 00:13:32
450b40cab39c786bf67e7491755e7d0b3a4dc3ba...27950fa3f40f45ede9aa2b108796fd2b73b33016,4,254,115,369,23,2012-02-29 00:35:47,2012-02-29 00:26:03
27950fa3f40f45ede9aa2b108796fd2b73b33016...c5e944820ab50f6106ab4f86f37d087a74acc595,2,171,51,222,19,2012-02-29 23:52:21,2012-02-29 23:52:21
c5e944820ab50f6106ab4f86f37d087a74acc595...c5266ebac5d9753029f8b10598862cb2b7e13b55,3,47,3,50,8,2012-03-01 00:16:50,2012-03-01 00:16:25
c5266ebac5d9753029f8b10598862cb2b7e13b55...788430c8e3fa90dd965b44fb31ba8b2eece2ca37,2,9,2,11,5,2012-03-01 04:06:47,2012-03-01 04:06:47
788430c8e3fa90dd965b44fb31ba8b2eece2ca37...47a899ffed3c71080e10e73eda092a716f1be168,4,235,115,350,41,2012-03-01 20:19:51,2012-03-01 20:19:51
47a899ffed3c71080e10e73eda092a716f1be168...c63793ee81ee6961b2430e88379d491fa8e91bfb,6,240,268,508,77,2012-03-02 02:51:45,2012-03-02 02:51:45
c63793ee81ee6961b2430e88379d491fa8e91bfb...f2c25d1893cfa897b0d36005604c134a731e402d,5,75,78,153,11,2012-03-02 19:08:00,2012-03-02 19:08:00
f2c25d1893cfa897b0d36005604c134a731e402d...97da3eaec806c542467ca2c3ec9011475c87b8d5,1,95,0,95,1,2012-03-02 20:12:00,2012-03-02 20:12:00
97da3eaec806c542467ca2c3ec9011475c87b8d5...d377fe80b1396b82f8af7bfcd76f869410865001,1,42,0,42,1,2012-03-02 21:12:46,2012-03-02 21:12:46
d377fe80b1396b82f8af7bfcd76f869410865001...ce49c7a8a902bd3a74a59a356dd11886e83d2e92,9,190,57,247,25,2012-03-02 23:09:40,2012-03-02 23:09:40
b72f5d4038a21a27efcdec350376af0342ccf3f0...804c5f562736b164148e648d475d95298d6d49a8,1,1,1,2,1,2013-03-31 22:33:22,2013-03-04 04:22:51
804c5f562736b164148e648d475d95298d6d49a8...06e6eab0e208966c1152fb13b54eec884e63f2aa,1,6,7,13,3,2013-03-31 22:33:22,2013-03-19 19:02:19
06e6eab0e208966c1152fb13b54eec884e63f2aa...2932c8826a1d948565124aa6c9a32df68a15895b,1,11,7,18,5,2013-03-31 22:33:22,2013-03-04 10:17:04
2932c8826a1d948565124aa6c9a32df68a15895b...b208d9002289dcd8170750cb94c84678afdd6e0c,3,81,0,81,4,2013-04-07 03:51:16,2013-03-20 17:01:58
b208d9002289dcd8170750cb94c84678afdd6e0c...af079d8bf69a4bd92d6a4eff3c3d1e4d73190a78,3,52,0,52,5,2013-04-07 03:51:16,2013-03-04 04:54:23
af079d8bf69a4bd92d6a4eff3c3d1e4d73190a78...8f7f5e55436eb6b20c12c435eab03e9f37be2e39,2,117,0,117,2,2013-04-07 03:51:16,2013-03-31 21:56:32
8f7f5e55436eb6b20c12c435eab03e9f37be2e39...2e2332857d26c7dbed3e4b940bb571da348bb5c7,1,95,0,95,1,2013-04-07 03:51:16,2013-03-20 16:39:20
b72f5d4038a21a27efcdec350376af0342ccf3f0...4cc326e9dd9679911c3bf3d6cc7405b0de84138f,1,2,1,3,2,2013-03-06 04:45:26,2013-03-06 04:45:26
989abe9be4b200be0c31538834036188e970cf54...be225be7852fc8e4a385b622d24ea35fff761421,1,2,1,3,2,2013-02-25 22:36:25,2013-02-25 22:36:25
01be786319238fd6507a08316d1c265c1a89407f...447ae791e564ed887fb4abe752f38a1a9ada1267,3,19,383,402,14,2013-03-03 14:19:21,2013-03-03 14:19:21
01be786319238fd6507a08316d1c265c1a89407f...1631147c196ff32a82f8775e3979fdf42729de6b,2,177,66,243,38,2013-03-02 21:51:31,2013-03-02 21:51:31
1631147c196ff32a82f8775e3979fdf42729de6b...7bd53bf38548ee039ae40bb669469625ce97a54e,1,1,20,21,2,2013-03-02 21:52:38,2013-03-02 21:52:38
7bd53bf38548ee039ae40bb669469625ce97a54e...a313de0d9e4ca76e1ff6444b613984316f6ee711,2,1,2,3,2,2013-03-02 21:58:05,2013-03-02 21:58:05
b8daa9e0fc9669f0677105b5ecce5c67462a108e...3d74702eec07f2208211a72581c115340517ea4b,1,1,1,2,2,2013-03-05 22:50:43,2013-03-05 22:50:43
d63dc61dd704431a8d487dbfa9fe61b24a58184d...359fc2d241ac407bdf9bf0d28715705f01ca6360,210,210,210,420,210,2013-01-08 23:31:27,2013-01-08 23:07:25
be5869fce0ab9c61a294020e9baa9755c58ee8a3...d777a4078c02851952a80a1c33666031a7faea75,1,3,0,3,1,2012-12-15 17:20:23,2012-12-15 17:20:22
be5869fce0ab9c61a294020e9baa9755c58ee8a3...850b1edfe8f04daaec05237e35e74f11600e5b4c,2,42,1,43,3,2012-12-14 21:58:44,2012-12-13 20:55:28
850b1edfe8f04daaec05237e35e74f11600e5b4c...b524fe1a3c6033a5a8a64b7d8f9acc5cd3dd90c4,2,11,5,16,4,2012-12-14 21:58:44,2012-12-14 16:35:59
b524fe1a3c6033a5a8a64b7d8f9acc5cd3dd90c4...1164acde96a1d72506fee02003863321223f9470,1,4,3,7,3,2012-12-14 22:00:35,2012-12-14 22:00:35
1164acde96a1d72506fee02003863321223f9470...57f5d8dca5e5d080c59fe0dc3e2221dabd9d4c2c,2,67,40,107,2,2012-12-14 22:15:42,2012-12-14 22:15:42
57f5d8dca5e5d080c59fe0dc3e2221dabd9d4c2c...28abb187c468f9dfc4bab9353fe4c8485ca09099,1,1,1,2,1,2012-12-14 22:16:10,2012-12-14 22:16:10
28abb187c468f9dfc4bab9353fe4c8485ca09099...2a2d1ab0867a43fe9a206c20d3d34bab57a2fb06,1,2,2,4,2,2012-12-15 22:30:20,2012-12-15 22:30:20
2a2d1ab0867a43fe9a206c20d3d34bab57a2fb06...a7f125cdba0fe00c7df39e124e104fd030718350,1,1,2,3,1,2012-12-15 22:56:20,2012-12-15 22:56:20
a7f125cdba0fe00c7df39e124e104fd030718350...cc3e9b5af46ab090944c1a67900564479069c686,2,6,0,6,2,2012-12-16 18:50:10,2012-12-16 18:50:10
cc3e9b5af46ab090944c1a67900564479069c686...c4e3e797d11bf7d8a9873a193e182d2537b0ee6a,1,4,0,4,1,2012-12-16 20:27:11,2012-12-16 20:27:11
86cb34cb110c6a1ec6e1d1525418c70f2f617d6b...1697cd6ff5d29c95106ff4b7bd56ebba5d51b8c1,10,177,68,245,33,2014-06-27 02:34:37,2014-06-25 17:20:27
86cb34cb110c6a1ec6e1d1525418c70f2f617d6b...f36d57b9bf71808ae3974753464bd93c59963048,1,1,1,2,1,2014-06-26 11:48:09,2014-06-26 11:48:09
8baca134cc21b5eef18e3d47d50ed55f633b57d1...9007c53faecf51be7f166172682008d16f7d617a,1,1,1,2,1,2013-05-27 23:45:22,2013-05-27 23:45:22
51a91ce8c6d8129788841975e4ff213bc2953bb4...c8a4e8a5f6acc94c46c8a7ea2cf3f9d67b50e07a,1,12,4,16,6,2013-04-29 16:14:56,2013-04-29 16:14:56
cd2ed9f0cc9d8e0e1724304e946adb28271e0669...0b726701f3d3c5a3a596b53d8db0b7a4b4032dfb,6,133,34,167,9,2013-04-30 11:13:38,2013-04-30 11:13:38
0b726701f3d3c5a3a596b53d8db0b7a4b4032dfb...7dcda3aa3780292e33bb9229ff998ffe4edc07bf,1,6,6,12,6,2013-04-30 11:19:02,2013-04-30 11:19:02
17b3d9b92b9132be116e4ecfae736de025c5158f...58448910a0591c38959bd26de23cbe97e243b0af,2,35,3,38,5,2012-02-29 22:37:18,2012-02-29 22:37:18
58448910a0591c38959bd26de23cbe97e243b0af...253d6df5fd899ca9273b73a919ec5f19f0ff2df4,1,9,26,35,7,2012-03-01 13:30:38,2012-03-01 13:30:38
253d6df5fd899ca9273b73a919ec5f19f0ff2df4...7a5449662972769b6b09540463d8b6378664393a,3,30,1,31,6,2012-03-01 13:31:50,2012-03-01 13:31:50
7a5449662972769b6b09540463d8b6378664393a...4f8efc97c1ee06bc113443f028ba7821a7af7920,3,9,9,18,4,2012-03-05 18:32:21,2012-03-05 18:32:21
e3d55b2add24e3074501176270082aa1802218bc...7e3fc62310f8f33e83ddc2b6b8c6d8516252c145,3,10,2,12,5,2012-03-02 23:49:28,2012-01-23 18:54:49
7e3fc62310f8f33e83ddc2b6b8c6d8516252c145...3a5ad90a0de4408c2754763fe1ced0da984bae6e,16,3544,2,3546,17,2012-03-02 23:49:28,2012-01-24 20:23:20
3a5ad90a0de4408c2754763fe1ced0da984bae6e...2705576bfa90675433be49a4141cfdd867e380cc,4,9,22,31,5,2012-03-02 23:49:28,2012-01-24 22:06:42
2705576bfa90675433be49a4141cfdd867e380cc...8b75f7f3ea91b3efc4e58a7bf737aedfd19671e7,4,26,13,39,10,2012-03-02 23:49:28,2012-01-24 22:08:20
8b75f7f3ea91b3efc4e58a7bf737aedfd19671e7...cd33323b7251e0bb15c5ee476e918859b661cc5f,19,436,4,440,15,2012-03-02 23:49:28,2012-01-27 19:29:25
cd33323b7251e0bb15c5ee476e918859b661cc5f...65b09b1deddec64fa5639e9fea10c048d31901fa,5,574,75,649,42,2012-03-02 23:49:28,2012-02-03 02:03:43
65b09b1deddec64fa5639e9fea10c048d31901fa...3a4375901a92efdc641c714ec9fd07b53f2f781e,11,844,272,1116,82,2012-03-02 23:49:28,2012-02-04 00:53:01
3a4375901a92efdc641c714ec9fd07b53f2f781e...5a2f097fdc1408500cff9addf378f86046363665,1,4,1,5,1,2012-03-02 23:49:29,2012-02-04 01:05:05
5a2f097fdc1408500cff9addf378f86046363665...a2e895be820a2fd77285ef4576afe53f68c96ca2,10,577,205,782,80,2012-03-02 23:49:29,2012-02-07 20:14:28
a2e895be820a2fd77285ef4576afe53f68c96ca2...caf71ec081fe4067fff5f1a172e7a2e4bbe7eb0f,11,112,12,124,18,2012-03-02 23:49:29,2012-02-07 23:30:18
caf71ec081fe4067fff5f1a172e7a2e4bbe7eb0f...e47329b6d855a801340374cf8d4b470cd7ef38cb,2,321,57,378,45,2012-03-02 23:49:29,2012-02-14 01:29:30
e47329b6d855a801340374cf8d4b470cd7ef38cb...760db29c456ef2029a81d577d95a3fafb37ce5c6,2,3,23,26,2,2012-03-02 23:49:29,2012-02-21 23:09:04
760db29c456ef2029a81d577d95a3fafb37ce5c6...74fa4bfae37e9d7c9e35550c881b114d7a83c4fa,31,1705,1087,2792,207,2012-03-02 23:49:29,2012-02-29 00:14:47
74fa4bfae37e9d7c9e35550c881b114d7a83c4fa...854eccbb2d86c2910f9d98dc52f9ebd0e37c262a,31,181,215,396,106,2012-03-02 23:51:55,2012-02-29 20:04:59
854eccbb2d86c2910f9d98dc52f9ebd0e37c262a...da9abdd6a7c05d29b68bb38c6798cd8975a7d26a,1,5,2,7,1,2012-03-02 23:51:55,2012-02-29 21:19:31
da9abdd6a7c05d29b68bb38c6798cd8975a7d26a...c19bc93cef62cf4a638ab42ba9562885b07a68ce,3,7,0,7,4,2012-03-02 23:51:55,2012-02-29 22:19:39
c19bc93cef62cf4a638ab42ba9562885b07a68ce...e1bcc19110eb7d540dee92af489440dd2953b5d5,10,66,58,124,39,2012-03-02 23:51:55,2012-03-01 19:45:00
e1bcc19110eb7d540dee92af489440dd2953b5d5...529df4dfe54c61b40b96abbafb420e9034a1a4a8,2,3,2,5,3,2012-03-02 23:57:06,2012-03-02 23:57:06
d9ecaf8c6f2d2d538319174e42e5c98585c902e5...812e5aea5963caee3a5894538921ac0530f548bd,1,1,1,2,1,2013-04-07 05:23:08,2013-04-07 05:23:08
d1bcc1a8744343253df569ae4798302c1ff796e7...69c28b75dfb0a3edefa4d4a8616624f856b15533,1,4,3,7,4,2013-03-06 18:22:50,2013-03-06 18:22:50
d1bcc1a8744343253df569ae4798302c1ff796e7...6edb427b7615207142e10a228164d6a019045126,4,167,10,177,11,2013-03-06 16:01:33,2013-03-06 15:43:21
6edb427b7615207142e10a228164d6a019045126...1a90dcf64e561b21e0981a7d87d71e349fa37f69,4,3481,10,3491,15,2013-03-06 18:07:56,2013-03-06 18:07:56
1a90dcf64e561b21e0981a7d87d71e349fa37f69...f7b18502154edac242ab3760feb05600e09d67b3,4,49,62,111,30,2013-03-06 21:36:19,2013-03-06 21:25:01
f7b18502154edac242ab3760feb05600e09d67b3...aa518c709c8caa6577822e073e7f27733eb6aaa3,2,3,1,4,3,2013-03-06 21:51:20,2013-03-06 21:51:20
be225be7852fc8e4a385b622d24ea35fff761421...efe7fad6c96a3d6197a218aeaa561ec676794499,5,79,81,160,42,2013-02-25 23:23:00,2013-02-25 23:05:28
29ab8774e53d1c053802b69f4e66283a23e7290a...0e040c031edc6b61692e74a9b8ce0b0ff86d270a,4,34,26,60,21,2013-03-03 22:18:29,2013-03-03 13:50:47
f7e4a7c2d5e314fe50fee851263e4ed6cfaa49ae...de590550172c68bf374f9d12636b06295c5fe048,3,47,1,48,3,2013-01-09 01:11:11,2013-01-09 01:11:11
71131b550904824a047d41c7da174686202abd6a...bdb94c21fd995da8c5b83ba30500996b3397bf3a,2,3,4,7,4,2012-12-17 16:16:32,2012-12-17 11:20:52
bdb94c21fd995da8c5b83ba30500996b3397bf3a...a3337f10bb604fce96e185088411feab53ab3d64,3,37,0,37,3,2012-12-17 16:20:31,2012-12-17 14:15:20
69a402d46c5cee6a09499cf763202dfad2004e95...101659be5da3ceefb0501c738620157b92563afe,1,1,1,2,1,2012-12-17 14:50:12,2012-12-17 14:50:12
dcdb8500e3bd719010a1a65fffc391eef23dd4b4...d58a64e9a5d32b511447943f20a84340b520872f,3,54,4,58,7,2014-07-02 05:05:00,2014-06-30 18:55:32
d58a64e9a5d32b511447943f20a84340b520872f...6812afaf385422fbcc6fb494ff892426fbce1cbc,7,64,144,208,40,2014-07-02 05:05:00,2014-06-30 19:36:38
dcdb8500e3bd719010a1a65fffc391eef23dd4b4...5fa8cda981940eaef54b55abe4fcba09b4e18e12,2,6,6,12,4,2014-06-30 19:05:25,2014-06-30 19:05:25
9c46409d38b36ba822b4ddf6e5a00256f07b116b...f4046267dc7139c814e1a615d1a3c9857444749b,1,1,1,2,1,2014-06-26 13:16:12,2014-06-26 13:16:12
9007c53faecf51be7f166172682008d16f7d617a...31a6118175a2a458f88211999952770949e3924c,1,2,2,4,1,2013-05-28 21:02:26,2013-05-28 21:02:26
9007c53faecf51be7f166172682008d16f7d617a...2638a03affdf57c989f573d48afca3b849cb4c1f,1,69,78,147,30,2013-05-28 15:50:47,2013-05-28 15:50:47
2638a03affdf57c989f573d48afca3b849cb4c1f...56960b8396d3aef0b39f32aa7a9749202f925ada,10,90,81,171,50,2013-05-28 18:47:55,2013-05-28 18:47:55
56960b8396d3aef0b39f32aa7a9749202f925ada...ec24e542969f9d49e41e4c2cb3eac2259b1818c2,11,234,448,682,63,2013-05-29 20:47:37,2013-05-29 20:47:37
ec24e542969f9d49e41e4c2cb3eac2259b1818c2...4e6e2ff26f5a04a4628aa0d81e5d5d73acf28ec4,10,194,404,598,56,2013-05-30 01:47:10,2013-05-30 01:47:10
4e6e2ff26f5a04a4628aa0d81e5d5d73acf28ec4...979f75d8e1df7e8e43797822d5a55a8eff74fa74,3,8,3,11,5,2013-05-30 15:19:43,2013-05-30 15:19:43
979f75d8e1df7e8e43797822d5a55a8eff74fa74...1ed356dcfef449313bac3ce795f26d19423c744c,1,2,2,4,2,2013-05-30 19:04:28,2013-05-30 19:04:28
7dcda3aa3780292e33bb9229ff998ffe4edc07bf...bade51948c08c36ac0bea63cf62ee1a9dd952501,4,50,2,52,8,2013-04-30 19:02:13,2013-04-30 19:02:13
7dcda3aa3780292e33bb9229ff998ffe4edc07bf...fdb3034e725ccf2c7be11871fcc374ced436983e,1,202,175,377,17,2013-04-30 11:25:56,2013-04-25 21:57:13
fdb3034e725ccf2c7be11871fcc374ced436983e...e26b14c0345ef82771f222aa50be926f5969531d,8,199,83,282,28,2013-04-30 11:25:56,2013-04-26 22:35:47
e26b14c0345ef82771f222aa50be926f5969531d...a66c4bc846cb59512c1aa164211f3f912d9bc425,3,203,1,204,3,2013-04-30 11:25:56,2013-04-29 09:57:01
a66c4bc846cb59512c1aa164211f3f912d9bc425...61c00541ac3c92eb3a82c4a1f67e47510ca1318b,1,17,5,22,10,2013-04-30 11:25:56,2013-04-29 13:21:56
61c00541ac3c92eb3a82c4a1f67e47510ca1318b...5fa7e469848bef4eab19cc069df9aa3b0134c9f7,2,22,34,56,13,2013-04-30 11:27:46,2013-04-30 11:13:39
864ac49e317dc8dfd683a1017c05584bd7a8864c...5621d8097d48aac3ff5744c4d74115139db30a43,7,24,24,48,23,2012-03-06 16:51:04,2012-03-06 16:51:04
529df4dfe54c61b40b96abbafb420e9034a1a4a8...ef5c4ee9625f004ae9853bb1a88090dbe1d49881,2,112,0,112,2,2012-03-04 11:08:09,2012-03-04 11:08:09
529df4dfe54c61b40b96abbafb420e9034a1a4a8...845f8314e4a02cbd01b2e7d8a6d608d9e9a1334d,1,111,0,111,1,2012-03-03 01:28:00,2012-02-14 19:36:39
845f8314e4a02cbd01b2e7d8a6d608d9e9a1334d...60bc2d20c40e37e92e4e15479ac4dccbde069bec,4,86,3,89,6,2012-03-03 01:28:00,2012-02-14 20:23:11
60bc2d20c40e37e92e4e15479ac4dccbde069bec...45d387ac78bcf3167d69b736d0b322717bc492d4,3,258,283,541,126,2012-03-03 01:28:50,2012-02-15 15:54:17
45d387ac78bcf3167d69b736d0b322717bc492d4...1a48112342932e9fcd45a1ff5935f1c9c53b83d1,26,590,664,1254,366,2012-03-05 23:43:10,2012-02-16 23:13:34
1a48112342932e9fcd45a1ff5935f1c9c53b83d1...9d160ba85539bbc593369f597a07d42c2770dff4,5,6,6,12,5,2012-03-06 00:37:56,2012-03-06 00:37:56
9d160ba85539bbc593369f597a07d42c2770dff4...cb8a79617b15e347f26d21cedde0f2b8670c1876,21,369,399,768,199,2012-03-06 23:11:43,2012-03-06 23:02:55
812e5aea5963caee3a5894538921ac0530f548bd...7d5b0f8b1f3a9f829847188d2d25b7f47cf00b1c,1,1,1,2,1,2013-04-08 23:28:40,2013-04-08 23:28:40
812e5aea5963caee3a5894538921ac0530f548bd...4d13d07ab21d5041dc3b2e77c9447298d6b39eaa,1,37,0,37,1,2013-04-08 12:35:09,2013-03-11 20:20:47
4d13d07ab21d5041dc3b2e77c9447298d6b39eaa...8480eef7ee0c8e52a8bf3ea12e5626009a966164,3,135,22,157,14,2013-04-08 12:36:11,2013-03-12 03:27:16
8480eef7ee0c8e52a8bf3ea12e5626009a966164...1aa21fe3b87a1e601023f49c41fab3ce76c189ac,16,156,166,322,120,2013-04-09 01:07:04,2013-04-09 01:03:51
1aa21fe3b87a1e601023f49c41fab3ce76c189ac...ec7e240ba4a3277a94def51005d2558d02cb8c3c,2,4,1,5,2,2013-04-09 01:07:12,2013-04-09 01:07:12
ec7e240ba4a3277a94def51005d2558d02cb8c3c...4291ad078128003ad6d4ac6fb58244f3343ad87a,2,15,1,16,2,2013-04-15 18:42:34,2013-04-15 18:42:34
4291ad078128003ad6d4ac6fb58244f3343ad87a...2ebc3c66c292539786b6ec1538f740c5e444fe16,6,77,116,193,70,2013-04-15 18:57:24,2013-04-15 18:57:24
2ebc3c66c292539786b6ec1538f740c5e444fe16...299a224be16368dc36bef4dc3f5e711ce35300cd,10,54,66,120,50,2013-04-15 19:00:04,2013-04-15 19:00:04
299a224be16368dc36bef4dc3f5e711ce35300cd...5961d5ea7f77cc442ec7d7c9f698f8c96c050298,1,3,3,6,3,2013-04-15 19:10:18,2013-04-15 19:10:18
5961d5ea7f77cc442ec7d7c9f698f8c96c050298...201566539f38874b4e93c6a36593bd0d10e6352c,3,3,5,8,4,2013-04-15 20:29:40,2013-04-15 20:29:40
1b405a232fc97b8d692e62e73d29c453e44a2970...9952f24e6cc71ef5ecd13831f783e308aae97c36,1,0,3453,3453,1,2013-03-07 00:02:26,2013-03-07 00:02:26
f657688bc7616b189ea455ade4c8a4909e2786d8...8005c6d420a2d8f00d96c1c0a385db91c88613c0,5,6,4,10,6,2013-02-26 00:08:34,2013-02-26 00:03:56
dce5f26f4d72b024891e70f6130e63389d9f181a...323bb88514347ebb7a1d760490384b305f4f4d92,4,9,0,9,5,2013-03-03 23:21:56,2013-03-03 23:21:56
11fccddcb513b30d841160ddb411a4828be3ed91...fcc48d1fce2c456815b76501e1df07d02880d402,10,84,0,84,7,2013-01-09 17:37:22,2013-01-09 17:37:22
fcc48d1fce2c456815b76501e1df07d02880d402...ad10db2af8d911d0b0913207ba919116375f09b4,1,13,9,22,2,2013-01-11 22:26:34,2013-01-10 23:59:36
ad10db2af8d911d0b0913207ba919116375f09b4...dd6367e37e7f9fec32bc3e8c99553ced825d47e9,8,11,4,15,7,2013-01-12 01:07:52,2013-01-12 00:00:19
11fccddcb513b30d841160ddb411a4828be3ed91...087f64d3e3ea224dadb9b4ae1130b9499f49cff9,3,55,16,71,12,2013-01-09 15:15:58,2012-12-17 23:48:26
087f64d3e3ea224dadb9b4ae1130b9499f49cff9...f85b62840a079fb4bee1838da50421a178850bd3,1,0,3,3,1,2013-01-09 15:44:12,2012-12-25 13:50:29
f85b62840a079fb4bee1838da50421a178850bd3...abeefbbe18710f86077eb4c5b825255256b8b6bc,10,106,9,115,18,2013-01-09 16:05:21,2012-12-26 18:16:23
101659be5da3ceefb0501c738620157b92563afe...22d23c61ed04a1c37e14e00e29abb951d4d52570,1,4,1,5,5,2012-12-17 16:15:58,2012-12-17 16:15:58
1453bd20897d074a3f65d86f0d2bbb72ed23d071...967f5a76b1c89f1f93840407fd2afd1e8005dad6,6,162,175,337,58,2014-07-01 21:32:15,2014-05-23 21:50:51
0145afe635b57bfbc3950030a572187b0644c0c5...bc8a0886853c17d0899e9148d5c11c2c231c3ab4,2,8,1,9,3,2014-06-27 16:03:27,2014-06-27 15:51:35
504a4fd140223e17871e219ae17568b303c7c9a1...d17db2fd771ed4e0dc7dee6c043b335a89bdd545,1,3,1,4,2,2013-05-30 09:45:11,2013-05-30 09:30:34
504a4fd140223e17871e219ae17568b303c7c9a1...ca9b1702abd79486aabfb9dae108c0bf1c26ccfd,1,57,53,110,15,2013-05-29 16:18:21,2013-05-29 16:18:21
1ed356dcfef449313bac3ce795f26d19423c744c...cee695ae6b9a9f586d32d0b9460a358bfdc4fe1b,11,329,187,516,123,2013-05-31 19:18:43,2013-05-31 19:18:43
cfcdbc100a993094ac1f094aa908ed4da472d106...3e199f428513fbf04b126d536409deae1c6d045f,2,18,2,20,12,2013-05-01 11:18:46,2013-05-01 11:18:46
3e199f428513fbf04b126d536409deae1c6d045f...f6f48f9008a9aaba5cbcfc611b616d8ae332b5e3,1,4,13,17,2,2013-05-01 11:57:05,2013-05-01 11:57:05
f6f48f9008a9aaba5cbcfc611b616d8ae332b5e3...ae99f5e2ab090c1c666dfbf36753b8c18ab88478,1,7,2,9,4,2013-05-01 11:57:24,2013-05-01 11:57:24
ae99f5e2ab090c1c666dfbf36753b8c18ab88478...46779411f93589fe567817fbdd61304847aa83c3,1,1,1,2,1,2013-05-01 12:32:10,2013-05-01 12:32:10
46779411f93589fe567817fbdd61304847aa83c3...155ee751143a98356ec72d9930d2a82ec750e466,1,4,0,4,1,2013-05-01 12:34:01,2013-05-01 12:34:01
155ee751143a98356ec72d9930d2a82ec750e466...3f663178ed856a333fd11d8dd57231ebe331baf2,1,20,8,28,8,2013-05-01 20:38:56,2013-05-01 20:38:56
3f663178ed856a333fd11d8dd57231ebe331baf2...52c102b7f679674b14d046a62091f76431d3eb1b,1,17,5,22,9,2013-05-01 20:43:48,2013-05-01 20:43:48
52c102b7f679674b14d046a62091f76431d3eb1b...e830c020f3915e272cf0810899f40dd5c84fbbf6,1,3,1,4,2,2013-05-01 20:50:39,2013-05-01 20:50:39
e830c020f3915e272cf0810899f40dd5c84fbbf6...de19c4a9582b74eec1d510d4ded5889d3b3e7976,1,2,1,3,2,2013-05-01 21:00:20,2013-05-01 21:00:20
de19c4a9582b74eec1d510d4ded5889d3b3e7976...734c6fc13430f770f7e98cf5d23b7f6e470c29ef,1,22,19,41,13,2013-05-01 21:15:55,2013-05-01 21:15:55
734c6fc13430f770f7e98cf5d23b7f6e470c29ef...8915a140cb996f84eeafadb99b195c33301c7d30,1,14,8,22,4,2013-05-01 21:23:01,2013-05-01 21:23:01
8915a140cb996f84eeafadb99b195c33301c7d30...f063f578981bfb7f88880e9bdfbfd0a370dfefea,1,43,22,65,25,2013-05-01 21:48:35,2013-05-01 21:48:35
f063f578981bfb7f88880e9bdfbfd0a370dfefea...62caf3f38fa25537b5f824329d8f88875ee837f2,1,8,6,14,5,2013-05-01 22:01:47,2013-05-01 22:01:47
62caf3f38fa25537b5f824329d8f88875ee837f2...41e93563e7462bd37cf3a09b8aaac35736046482,2,6,2,8,4,2013-05-01 22:08:12,2013-05-01 22:08:12
41e93563e7462bd37cf3a09b8aaac35736046482...bf6bebe22eff29c6b7ff744b809057acede4e615,1,42,43,85,19,2013-05-01 22:23:40,2013-05-01 22:23:40
bf6bebe22eff29c6b7ff744b809057acede4e615...1a9e406c218e3d5a174bc4f8dce0333d73d7bbff,1,1,0,1,1,2013-05-01 22:47:37,2013-05-01 22:47:37
1a9e406c218e3d5a174bc4f8dce0333d73d7bbff...f470b00b037cfcd40e19e88913a9a8b64d98288f,1,8,1,9,3,2013-05-01 22:48:40,2013-05-01 22:48:40
f470b00b037cfcd40e19e88913a9a8b64d98288f...52c52737353a7ee7b653ab314d7b89ca6ddafe63,1,4,2,6,3,2013-05-01 22:51:30,2013-05-01 22:51:30
52c52737353a7ee7b653ab314d7b89ca6ddafe63...2f28219ce3da1387548b8c614d73ee01ef80f9d6,1,2,2,4,2,2013-05-01 22:53:12,2013-05-01 22:53:12
2f28219ce3da1387548b8c614d73ee01ef80f9d6...b60d95c714f5e68f07c5251aebbe72ba3ad5806d,1,1,1,2,1,2013-05-01 22:55:54,2013-05-01 22:55:54
b60d95c714f5e68f07c5251aebbe72ba3ad5806d...0cce210a54b931462c402c1cb79091474d0b8577,1,5,10,15,1,2013-05-02 17:36:58,2013-05-02 17:36:58
0cce210a54b931462c402c1cb79091474d0b8577...6e286e8dc59874db30b6fbb0ca5d32d4a2b5642c,1,0,5,5,1,2013-05-04 08:04:23,2013-05-04 08:04:23
5e2261aca86310aa180eab5ccdc345b1539b024d...bec65a5e994bc4701216c9ca2c7dae83770b3edc,420,3099,34,3133,200,2013-04-30 20:31:31,2013-04-02 03:16:21
bec65a5e994bc4701216c9ca2c7dae83770b3edc...0462fba538b380551cbd5d8c05281352ba7a7471,11,1487,11,1498,40,2013-04-30 21:01:11,2013-04-30 19:56:41
0462fba538b380551cbd5d8c05281352ba7a7471...75d1c8c664eba0ddef802b1bf6d1327707014c6e,8,186,156,342,9,2013-04-30 22:33:11,2013-04-30 22:33:11
bb97278ae8525f2d3ac2d0156f79fb8ac04d3591...b8d08292c934b7e21738c61531b340d507d55c98,1,38,20,58,3,2012-03-06 22:31:54,2012-03-06 04:45:00
bb97278ae8525f2d3ac2d0156f79fb8ac04d3591...2de60205dfea2c4a422b2108a5e8605f97c2e895,3,193,191,384,111,2012-03-05 07:28:36,2012-03-05 07:28:36
2de60205dfea2c4a422b2108a5e8605f97c2e895...28b486b2e2376f11cb86f6116763421c2fed7218,1,6,1,7,3,2012-03-05 17:14:56,2012-03-05 17:14:56
28b486b2e2376f11cb86f6116763421c2fed7218...c4c4bc1fd83a6682c72702cc8d25b784c9ba3cbb,1,16,4,20,4,2012-03-05 17:30:17,2012-03-05 17:30:17
cb8a79617b15e347f26d21cedde0f2b8670c1876...e54d8d8972ddfa886bfcf1a078d253b632debc72,3,112,98,210,62,2012-03-07 00:37:09,2012-03-07 00:37:09
cb8a79617b15e347f26d21cedde0f2b8670c1876...ae9e29fde7e7d1c0c3e95bdabbb5c96fc71b1c71,14,372,425,797,226,2012-03-07 00:27:13,2012-03-07 00:14:31
ae9e29fde7e7d1c0c3e95bdabbb5c96fc71b1c71...998f7b3dd76afbf462785a757b24a3554ad8534d,2,3,7,10,2,2012-03-07 18:52:17,2012-03-07 18:52:17
fc12a6b545e26e673640288418202ac802a82a3f...94750e8af246b2adf7bd5766e7e0da5fcf928d24,1,2,1,3,1,2013-04-09 17:51:35,2013-03-29 03:52:18
94750e8af246b2adf7bd5766e7e0da5fcf928d24...9da187e83d1b8ab513a43fd54a9fe2be11b1703f,4,19,10,29,9,2013-04-09 18:40:00,2013-04-09 18:40:00
9da187e83d1b8ab513a43fd54a9fe2be11b1703f...ad26434b3b8a5eafab8ec52b83aa99beaf48fb03,5,205,8,213,9,2013-04-09 21:52:32,2013-04-09 21:52:32
d064c74794f51e759cd84648f84f2609d3283ecc...36c2dfed696f80a20ca1352f32ec8b136b800c30,4,60,64,124,35,2013-04-15 21:32:40,2013-04-15 21:32:40
36c2dfed696f80a20ca1352f32ec8b136b800c30...cbda09d00bb2aa703f90251b231c74d7acc6d21c,4,32,32,64,27,2013-04-15 21:40:46,2013-04-15 21:40:46
cbda09d00bb2aa703f90251b231c74d7acc6d21c...e13a0647a062073fee9ec26f0f3101b50b620c8b,1,7,9,16,6,2013-04-15 21:54:28,2013-04-15 21:54:28
e13a0647a062073fee9ec26f0f3101b50b620c8b...32ef1d1c7cc8c603ab78416262cc421b80a8c2df,1,11,9,20,7,2013-04-15 22:17:40,2013-04-15 22:17:40
9952f24e6cc71ef5ecd13831f783e308aae97c36...bb45c57f94d3c7c96e78234e2a81393c0ced45a0,2,9,0,9,2,2013-03-07 15:38:44,2013-03-07 15:38:44
9952f24e6cc71ef5ecd13831f783e308aae97c36...e7da9acdcddd163d4a1e42f51a5f794e168bfd44,1,5,2,7,2,2013-03-07 01:51:38,2013-03-07 01:51:38
9952f24e6cc71ef5ecd13831f783e308aae97c36...ed4f95e5d9f2f59dc5d5a4b76a696b0595b6175d,1,5,6,11,4,2013-03-07 00:44:53,2013-03-05 19:47:07
ed4f95e5d9f2f59dc5d5a4b76a696b0595b6175d...169dc61607b69726c6012ab70758692637928a85,44,524,310,834,215,2013-03-07 00:52:01,2013-03-06 00:10:05
169dc61607b69726c6012ab70758692637928a85...cc216a01ee512a41320056efc9b588daf9129f7a,4,25,188,213,20,2013-03-07 00:52:01,2013-03-06 00:29:04
cc216a01ee512a41320056efc9b588daf9129f7a...9bea03ce776ed864b0556815d94d71d300ac1da3,6,498,110,608,83,2013-03-07 00:52:01,2013-03-06 23:16:34
9bea03ce776ed864b0556815d94d71d300ac1da3...e40f1c2d23c3758968df94a17831ec5432ae6988,7,467,289,756,160,2013-03-09 00:39:57,2013-03-09 00:39:57
e40f1c2d23c3758968df94a17831ec5432ae6988...a03beb7ba6017181c29d77e64112e4730f690271,1,93,0,93,7,2013-03-11 04:04:35,2013-03-11 04:04:35
a03beb7ba6017181c29d77e64112e4730f690271...61c7b61e6fe2542deeb8d2aadbea90a8f5b3c9cd,2,67,32,99,19,2013-03-11 05:38:53,2013-03-11 05:38:53
61c7b61e6fe2542deeb8d2aadbea90a8f5b3c9cd...92028ea58541c9de69096bd6b1bbe664976c24c1,2,67,60,127,42,2013-03-11 16:53:49,2013-03-11 16:53:49
92028ea58541c9de69096bd6b1bbe664976c24c1...aec4f6633ccdd359a39d712a27f87e613f788f6c,2,98,39,137,22,2013-03-11 17:37:12,2013-03-11 17:37:12
aec4f6633ccdd359a39d712a27f87e613f788f6c...a5eea2d7b760ebef0d2f397d763ec8eff32f38cd,2,116,12,128,11,2013-03-11 18:31:50,2013-03-11 18:31:50
a5eea2d7b760ebef0d2f397d763ec8eff32f38cd...62beacd300a6d3c62943723928f45ef852485e62,3,39,15,54,12,2013-03-11 23:43:58,2013-03-11 23:43:58
8005c6d420a2d8f00d96c1c0a385db91c88613c0...5c46937b3ad5e67bacce923311388b785f50d60b,1,4,1,5,1,2013-02-26 09:00:37,2013-02-26 09:00:37
323bb88514347ebb7a1d760490384b305f4f4d92...5bddabcca580377e50e4844544b0d969ea248683,4,114,19,133,10,2013-03-05 00:10:57,2013-03-04 23:40:48
359316b5d3bfca0ddfed2f653debe7b580b18727...3874f2d54fc693c2fc4488604c56ec74cd24de17,2,1,24,25,3,2013-01-12 04:23:46,2013-01-12 04:23:46
3874f2d54fc693c2fc4488604c56ec74cd24de17...355dddbf08ade85584f94dfb0eb4df46cb504035,1,1,1,2,1,2013-01-12 00:40:35,2013-01-12 00:40:35
252b24049cf7018ba80c736fda636c53c465fbd2...cea994b902c7c98f5f16341686d30a40e32dfc95,1,1,1,2,1,2013-01-10 11:39:17,2013-01-10 11:39:17
252b24049cf7018ba80c736fda636c53c465fbd2...e9bb730c36a9bea6a96b77355f90fabe95fc503d,1,1,1,2,1,2013-01-10 08:16:14,2012-11-09 05:02:30
e9bb730c36a9bea6a96b77355f90fabe95fc503d...c57c4af327979ad4189b108eaf751c912c8dea01,1,3,1,4,1,2013-01-10 08:16:39,2012-12-29 22:27:14
c57c4af327979ad4189b108eaf751c912c8dea01...707ede86335850a97aa1ec5aad9539dfa2e87b9c,1,1,1,2,1,2013-01-10 08:19:11,2013-01-04 02:25:05
707ede86335850a97aa1ec5aad9539dfa2e87b9c...b41e24a65c73c4ce052b02134ca559803400eecd,1,1,1,2,1,2013-01-10 08:20:43,2013-01-04 12:02:47
b41e24a65c73c4ce052b02134ca559803400eecd...ccd298bb2237c2472ec7d956f05addfda7b1d890,1,1,0,1,1,2013-01-10 09:05:39,2013-01-04 22:49:28
252b24049cf7018ba80c736fda636c53c465fbd2...ffb02b1630da85e063a816cc6dddcdc004a8ff72,4,71,25,96,7,2013-01-09 21:31:17,2013-01-08 20:58:20
ffb02b1630da85e063a816cc6dddcdc004a8ff72...520dcc1c000c7c29058d6ae56982461e782210fe,6,91,50,141,16,2013-01-09 21:31:17,2013-01-09 03:55:59
e62171e2fc1b101512a7e86f6d990a38b78ed12b...4d185dd9b0dde93bf30b250e6c7dd751bc893268,3,8,2,10,4,2012-12-21 02:05:20,2012-12-19 03:30:06
e62171e2fc1b101512a7e86f6d990a38b78ed12b...33f169e24e9219e96ff7835c28d080c95356d3ec,1,1,1,2,1,2012-12-18 22:07:18,2012-12-18 22:07:18
33f169e24e9219e96ff7835c28d080c95356d3ec...ed4e887d1ab8f6c289b40d08afb452c4c576a8e9,1,1,1,2,1,2012-12-18 22:09:57,2012-12-18 22:09:57
e62171e2fc1b101512a7e86f6d990a38b78ed12b...26290cd13bff7683031a5c05d9affb7e34f19c27,1,1,0,1,1,2012-12-18 18:52:37,2012-12-18 18:52:37
f79535092d86b531793640834bb010fa67dd4c3c...56c72b759c3adb92c0fdab18fccfb25fb561cd4f,11,108,91,199,76,2012-12-17 19:00:53,2012-12-17 19:00:53
56c72b759c3adb92c0fdab18fccfb25fb561cd4f...ba084f7aaf431f96588b13551ebfdffdd3eb44dc,1,52,34,86,15,2012-12-17 19:03:42,2012-12-17 19:03:42
f79535092d86b531793640834bb010fa67dd4c3c...9c8dbc889320277f9b678704cca86eea769c73e1,1,3,3,6,2,2012-12-17 18:32:15,2012-12-17 18:18:34
9c8dbc889320277f9b678704cca86eea769c73e1...f2b00cbdf64c794b2ee0862d2b88a783a4a3c0f9,1,1,4,5,1,2012-12-17 18:46:27,2012-12-17 18:35:40
b2984e8aac646219b06c4e0264e2d7556120b76b...7a6e0281c6367a278e1e06235c9a7217088d1205,2,51,3,54,3,2013-05-30 18:14:05,2013-05-02 11:07:22
17776314c8d161d78917e5fb2805d78a3c8c3599...2d160ef782c812bd7d68413a00a62f46585725d0,4,38,1,39,4,2013-05-29 21:26:25,2013-05-29 21:03:30
758e50c51ece8c0fec89e34b72eb5e571b2d0962...2ba55c1f0df3400c15dbdd7b21d1f3d354ab2e3c,1,1,1,2,1,2013-05-01 13:20:08,2013-05-01 13:20:08
2ba55c1f0df3400c15dbdd7b21d1f3d354ab2e3c...e1807113c43b7c5008e2d5c8c449ae56c8dceeb4,5,8,15,23,9,2013-05-01 13:31:23,2013-05-01 13:31:23
6cfe3b3f12a059a044f94c63e495ab729cd9ec7b...54fef6ebcba8777caf389cba06556aab6f22b1cc,2,21,10,31,6,2012-03-09 19:43:17,2012-03-09 19:38:32
6cfe3b3f12a059a044f94c63e495ab729cd9ec7b...7bed25a23f0967cc5a57bfe913416a85a59fd913,1,1,1,2,1,2012-03-09 19:10:22,2012-03-09 19:10:22
6af24ce31f43c3621f11720704a078058665bc3f...dda708e78f3c3f43d814d46c29ab9f2b9d47ed5c,10,480,486,966,241,2012-03-09 19:09:22,2012-03-09 18:55:50
e9b7ff602b7f4b9a7de92eb241bc0578a520dda2...0d3ccf0b28edb9daa5313e27149ca746b4a88c04,1,1,2,3,1,2013-04-10 14:41:05,2013-04-10 14:41:05
24f61bc53a9843f86ce79bae92a38e0e4565734b...f124ebd457bfbf43de3516629aaba5a279636e04,1,2,2,4,2,2013-04-16 15:45:12,2013-04-16 15:39:43
6a9ef012376e8a21dcfd0499ab16048eb6e954c3...b5ec5430a8cad68c1c534568a5a7047e42f75580,5,255,0,255,6,2013-03-07 18:42:33,2013-03-05 05:52:30
6a9ef012376e8a21dcfd0499ab16048eb6e954c3...d00d54645d931c77a9b401518c0d73e3f640454b,42,2637,1561,4198,281,2013-03-07 17:01:52,2013-03-01 21:37:33
92ebbe99c9b557aee3382f51ddf6dd6637ee2fe4...48bde2f1b62d24f3982382d520bfac887537641d,3,21,2,23,3,2013-03-09 14:45:18,2013-03-08 01:11:34
92ebbe99c9b557aee3382f51ddf6dd6637ee2fe4...0887b580bfe83a9f6e9a8530368a22e478411a0f,1,5,0,5,1,2013-03-08 14:30:18,2013-03-08 14:13:25
1ac10aae1da23f4a626d8eecd636402572785426...b8c325806ffbb81c3deb41ae23443af82ce4aa83,3,120,36,156,14,2013-03-12 19:19:32,2013-03-12 19:19:32
b8c325806ffbb81c3deb41ae23443af82ce4aa83...f58983246dd6ffbb87f09558fe98258f28fdbe88,1,2,2,4,2,2013-03-12 19:31:14,2013-03-12 19:31:14
3e212548f829d012f193eebe6778ea357bd5a095...25e7c9b7a6261877680be535700125ca0e12d6a8,1,1,0,1,1,2013-02-26 17:21:03,2013-02-26 17:21:03
e2d2c6e57d122f381fb42b7df1c7a12819050490...25743bd7c5f14f2287d9c4fdf953c978e3b16916,20,94,44,138,35,2013-01-12 19:47:56,2013-01-12 19:47:56
e2d2c6e57d122f381fb42b7df1c7a12819050490...96c9b9f0e538c7dd2f1041f471dd8a9a587bc43f,4,7,7,14,9,2013-01-12 17:44:58,2013-01-12 17:38:19
96c9b9f0e538c7dd2f1041f471dd8a9a587bc43f...0b3aa7beded6ed921a3701059f47b8ebddf064bd,1,3,0,3,2,2013-01-12 18:01:45,2013-01-12 18:01:45
0b3aa7beded6ed921a3701059f47b8ebddf064bd...09e29e47b3ee18888cfb0fc4abd5346b390e70fb,1,8,3,11,3,2013-01-12 18:41:30,2013-01-12 18:31:07
e2d2c6e57d122f381fb42b7df1c7a12819050490...4a4aee1112d9b73303ede92c3b9ca54aaf2e7a3e,1,1,1,2,1,2013-01-12 17:44:50,2013-01-12 17:44:50
4a4aee1112d9b73303ede92c3b9ca54aaf2e7a3e...b7b1acfdbdd2e9dc2abacfa97679180f4c07b0c1,1,1,0,1,1,2013-01-12 19:02:00,2013-01-12 19:02:00
b7b1acfdbdd2e9dc2abacfa97679180f4c07b0c1...85f40312765f7d8df8d28a7dd61d7d5107071eeb,1,10,1,11,2,2013-01-13 10:35:08,2013-01-13 10:30:05
85f40312765f7d8df8d28a7dd61d7d5107071eeb...5885ba112dd51c6446e500f72f92aebe5b872983,1,11,0,11,2,2013-01-13 11:26:52,2013-01-13 11:23:30
5885ba112dd51c6446e500f72f92aebe5b872983...72719e733318df8418641abb3c3d67d7a9ef42fc,1,1,1,2,1,2013-01-13 11:26:52,2013-01-13 11:21:52
a22ad9fd1f1f938fb9b8ac77939dda8a3b81a00e...eb3c247a78e62fc2bb87f70b08774de90e34faa1,2,56,6,62,4,2013-01-10 17:56:02,2013-01-10 17:56:02
a22ad9fd1f1f938fb9b8ac77939dda8a3b81a00e...4a863c06662053a8530a0dcb24e0a2daa33e05cf,4,103,49,152,25,2013-01-10 14:34:56,2013-01-03 19:36:26
4a863c06662053a8530a0dcb24e0a2daa33e05cf...891a4681ebba330f9ef33c609c5435e580ca1551,2,7,1,8,4,2013-01-10 14:34:56,2013-01-04 16:42:41
891a4681ebba330f9ef33c609c5435e580ca1551...8fe6bc5c47640537a20c351adc5ccaa6a212312b,1,12,1,13,4,2013-01-10 14:43:08,2013-01-10 14:43:08
404880b1bac746f15ca73bb57a5c034df6c6b630...40342bd2b654bed4a49fe84de36e19ba0fefb8b6,3,93,2,95,5,2013-01-10 23:15:37,2013-01-10 23:15:37
2052e3c0715f0d5f5a222bb8fb316fc0da7e8be9...7382551ff75fd7890752d3c64de85dc99115449e,1,1,1,2,1,2012-12-22 15:29:59,2012-12-22 15:29:59
25fa3ae39c5d043832071aae4f47ea52b4c5f62d...3a6420f378bce074d55721ed0c13c97fa9f088c7,1,2,2,4,2,2012-12-18 23:46:18,2012-12-18 23:46:18
5c3c86b06e84ac70735b2629209de2dcc0e09034...7fcec8342890031a0d22f0d013833badd81091e8,7,472,47,519,42,2012-12-19 22:57:30,2012-12-12 04:31:21
0c01f93e8c89a16b3531e4fb32384fe90bf4c548...8c2458bea6c9cbc66959dce8fd51d21f0f46b81d,1,3,2,5,2,2013-05-31 16:41:33,2013-05-31 16:41:33
0c01f93e8c89a16b3531e4fb32384fe90bf4c548...883929144d785702f783e956ff55434566cb009f,2,7,0,7,3,2013-05-31 12:53:22,2013-05-30 05:12:27
0c01f93e8c89a16b3531e4fb32384fe90bf4c548...215af2ccb87ac22d94b7205ff97a050622de6897,2,8,6,14,5,2013-05-30 15:59:11,2013-05-30 15:40:56
215af2ccb87ac22d94b7205ff97a050622de6897...df50512aebb77f9fab3a930e367fba3777d6ee81,3,4,11,15,5,2013-05-30 16:06:54,2013-05-30 16:06:54
e1807113c43b7c5008e2d5c8c449ae56c8dceeb4...8cddf9b83a542bd66fcf0c4a1b692d47ff6556c2,1,41,3,44,2,2013-05-01 17:13:32,2013-05-01 16:21:10
e1807113c43b7c5008e2d5c8c449ae56c8dceeb4...0cc7d8df19c82a13fd9d7c48563f40580d366cd3,2,31,2,33,3,2013-05-01 14:50:40,2013-05-01 14:50:40
3405f78754703948475b4677d03fcdbfb099b6a4...98d633cccf0a214b83ebfe9c7cb8ca449a1f0637,3,78,65,143,7,2013-05-07 21:34:48,2013-05-07 21:28:21
3405f78754703948475b4677d03fcdbfb099b6a4...a4b75dcf56bc8e6d295cae89e2f5871c4707af21,6,119,13,132,11,2013-05-07 19:42:56,2013-05-06 19:51:25
a4b75dcf56bc8e6d295cae89e2f5871c4707af21...5d8318875fc7234d00140ce1f18b67bc4703e5f4,3,90,0,90,3,2013-05-07 19:42:56,2013-05-06 22:10:02
3405f78754703948475b4677d03fcdbfb099b6a4...e35e2684f693f28afb7a8f28028b4cb8bdd19f49,6,117,69,186,26,2013-05-07 11:32:17,2013-05-07 11:32:17
e35e2684f693f28afb7a8f28028b4cb8bdd19f49...fd96f98e142cdb129f447ace189b2086951be313,1,30,5,35,6,2013-05-07 11:36:42,2013-05-07 11:36:42
fd96f98e142cdb129f447ace189b2086951be313...d63eec6946341e5efa0514bbf2904db2ded2a294,1,26,7,33,7,2013-05-07 11:44:08,2013-05-07 11:44:08
d63eec6946341e5efa0514bbf2904db2ded2a294...c2f602f8a5265a4be6383127435a18a8be98c9fe,2,124,6,130,12,2013-05-07 14:15:39,2013-05-07 14:15:39
3405f78754703948475b4677d03fcdbfb099b6a4...6e8659969a9e8e74cb9531454861d256e819e2a6,1,8,0,8,1,2013-05-07 05:33:35,2013-05-07 05:33:35
3405f78754703948475b4677d03fcdbfb099b6a4...3d42e9a31e49547e852459cf372984b896d731dd,2,14,1,15,3,2013-05-06 17:33:11,2013-05-06 17:32:20
ad87ccb8b2d4b99b1aa4779f17ddecc40b528da5...0e8144fecfe90d54256f16ba8ed36042985c5e3f,1,2,0,2,1,2012-03-11 19:37:56,2012-03-11 19:37:56
dda708e78f3c3f43d814d46c29ab9f2b9d47ed5c...e1de726c15937a8dbf81d12ef0c872cf6576ebd0,21,496,577,1073,279,2012-03-13 05:55:40,2012-03-13 05:55:40
e1de726c15937a8dbf81d12ef0c872cf6576ebd0...1736799d2a15d912cfc46b7089c2bff02a1cbd0e,1,36,0,36,1,2012-03-13 06:06:31,2012-03-13 06:06:31
1736799d2a15d912cfc46b7089c2bff02a1cbd0e...e3c475107045cb89c53c114716bafebc7538433f,7,122,48,170,16,2012-03-13 21:23:24,2012-03-13 21:23:24
e3c475107045cb89c53c114716bafebc7538433f...ab43ad2fd822504446e7876d6352c968a74beb53,6,126,134,260,79,2012-03-14 18:07:14,2012-03-14 18:07:14
ab43ad2fd822504446e7876d6352c968a74beb53...deafee7bd7a9e2efcdff90627b6094d8c1519319,21,343,274,617,151,2012-03-15 00:36:15,2012-03-15 00:36:15
90431f1b80cc72c6cc4165665c9c46b6292daee5...575a54db856947aeb4fc5cf1977844d22dfa1aab,7,19,16,35,8,2013-04-10 14:56:32,2013-04-10 14:55:29
f124ebd457bfbf43de3516629aaba5a279636e04...3be933b143731bbe3a5cadcdf70b8ab205a629c0,7,148,71,219,40,2013-04-17 15:33:51,2013-04-17 15:33:51
3be933b143731bbe3a5cadcdf70b8ab205a629c0...13421eee1ac89a90f45524d8158ace98aae3d0b9,1,1,2,3,1,2013-04-17 20:32:39,2013-04-17 20:32:39
13421eee1ac89a90f45524d8158ace98aae3d0b9...fedd0f9e90e3046a8c50f6209c37d3b4566bab10,3,14,17,31,13,2013-04-17 21:29:34,2013-04-17 21:29:34
f124ebd457bfbf43de3516629aaba5a279636e04...a442ed687d4c01a68de9aa7b0e50902f17a1ea84,2,46,0,46,2,2013-04-17 02:46:37,2013-04-17 02:46:37
f124ebd457bfbf43de3516629aaba5a279636e04...5d7c940b07bfd2bc14ef67ef8a00fb03de59b97c,1,3,1,4,2,2013-04-16 20:25:38,2013-04-16 20:25:38
5d7c940b07bfd2bc14ef67ef8a00fb03de59b97c...6edad4d8a4c5e20544eb3b1daa926413518dd020,1,2,0,2,1,2013-04-17 09:03:18,2013-04-17 09:03:18
cdaef180cef70e0687731e9b8beb5caee0351595...33abaad809669d33f2e9ea7eeb473ec43b8257ce,1,0,18,18,1,2013-03-07 17:58:34,2013-03-07 17:58:34
0887b580bfe83a9f6e9a8530368a22e478411a0f...1aa5318a9ec4f0ec16518d1102b29e5ba94a801a,4,8,3,11,5,2013-03-09 15:04:34,2013-03-09 15:04:34
c6d7d877fc891d829695069cbbd17f57e378fcd3...ad003763ccb39c0e59f5c1d8372a202541a9049e,1,2,1,3,1,2013-03-12 19:36:35,2013-03-12 19:36:35
69903777862bfdb03855ec13b0b63d65e0ed5410...395509ffcd5007d8fa9ecccdf2090c5ed24c00e6,2,42,2,44,4,2013-02-27 21:35:52,2013-02-27 20:47:39
69903777862bfdb03855ec13b0b63d65e0ed5410...82ac1f7678d30cbb3ff8da8921131582da691567,1,2,2,4,2,2013-02-27 18:48:02,2013-02-27 18:48:02
ddcb28a41f3774e26fc6ae0a7174a5565e4749ce...c55c624441944d61d379ce5d3e58b945c52c7c8b,1,1,1,2,1,2013-01-18 05:22:55,2013-01-18 05:22:55
09e29e47b3ee18888cfb0fc4abd5346b390e70fb...ed6648ba469c30b074e83bc102298ba0b183e231,1,33,11,44,4,2013-01-14 16:16:45,2013-01-14 15:39:22
ed6648ba469c30b074e83bc102298ba0b183e231...9c62aaab40248fb1b87d403ef5eab917be327b9e,1,4,31,35,3,2013-01-14 17:10:56,2013-01-14 16:42:12
09e29e47b3ee18888cfb0fc4abd5346b390e70fb...2a3b3e0324b272c50c8d2d7767bd4d55c4d453f6,2,18,1,19,2,2013-01-13 09:25:54,2013-01-12 18:27:31
2a3b3e0324b272c50c8d2d7767bd4d55c4d453f6...5b524d6902b50dc2eebcce760de614edc2ab4cf4,2,3,6,9,5,2013-01-13 09:25:55,2013-01-12 18:37:14
848d77dc8314895d6ad1a9b36f30a36fc505e230...62d4fa23a8ed1e00cbb359d50bd090a88a89781d,1,3,0,3,3,2013-01-16 11:25:28,2013-01-16 11:25:28
3a5e8faee7f4e5ede2f938d8975261cc84e27383...2086e1baef456da0e9dbb1d433079618083b1b95,2,2,1,3,2,2013-01-11 15:54:57,2013-01-11 15:54:57
3a5e8faee7f4e5ede2f938d8975261cc84e27383...a379e652120d101d87b7225e5d2fe97031c0b69b,1,3,0,3,1,2013-01-11 15:14:17,2013-01-11 15:14:17
3a5e8faee7f4e5ede2f938d8975261cc84e27383...d2f14df8c16a5660241f2e79cf2c6142aa3704ca,3,11,9,20,8,2013-01-11 10:03:48,2013-01-11 09:25:51
d2f14df8c16a5660241f2e79cf2c6142aa3704ca...976d9e136fe62bd0a1f966737d3fb3e88018d684,2,12,4,16,5,2013-01-11 10:03:48,2013-01-11 09:47:44
3a5e8faee7f4e5ede2f938d8975261cc84e27383...132c2db6a9f839d7697e8bff05861a92825a9c7c,1,1,1,2,1,2013-01-11 01:18:27,2013-01-11 01:18:27
132c2db6a9f839d7697e8bff05861a92825a9c7c...88aef76635c012ac8dc770e0f97abc37980decf9,2,34,1,35,5,2013-01-11 02:10:19,2013-01-11 01:45:55
88aef76635c012ac8dc770e0f97abc37980decf9...1265b51f5be724d42e8c99326f0e5623d28fc67d,1,1,0,1,1,2013-01-11 02:10:23,2013-01-11 02:07:50
1265b51f5be724d42e8c99326f0e5623d28fc67d...b5b281209749b70fb5e023fce02abb1447de6cfa,1,20,23,43,12,2013-01-11 23:07:44,2013-01-11 23:07:44
b5b281209749b70fb5e023fce02abb1447de6cfa...f1d4a35e942afa1a494849e12dfc6631069daf65,1,11,0,11,1,2013-01-11 23:08:48,2013-01-11 23:08:48
f1d4a35e942afa1a494849e12dfc6631069daf65...f31cae8be9e6005148b2e5bafcb46a0d4c77b467,1,1,1,2,1,2013-01-12 04:51:00,2013-01-12 04:51:00
7382551ff75fd7890752d3c64de85dc99115449e...34b6f05f3984cad3ec05c6018828472356c45e28,1,5,0,5,1,2012-12-26 10:59:07,2012-12-26 10:59:07
34b6f05f3984cad3ec05c6018828472356c45e28...50a762a563fe8116e2707ce1fcb75391d41dca23,2,29,0,29,3,2012-12-26 22:07:25,2012-12-26 11:03:07
9d8fa5379942e6dded14a9df053a69ebba136056...3dc0207bc07b6214d395812c0cef0d785cafa071,1,3,0,3,1,2012-12-19 04:22:46,2012-12-19 04:21:11
3dc0207bc07b6214d395812c0cef0d785cafa071...96a289f5f3d2ceeb84ac50216c44107583b48b8d,1,7,3,10,5,2012-12-19 04:24:23,2012-12-19 04:24:23
96a289f5f3d2ceeb84ac50216c44107583b48b8d...d5cf4665a9b4fa3b81f8af1fde2d234106176851,2,28,4,32,19,2012-12-19 07:04:31,2012-12-19 07:04:31
9d8fa5379942e6dded14a9df053a69ebba136056...8d45789167794da92d5e493ae6629110c6ca278a,1,2,1,3,2,2012-12-19 03:57:09,2012-12-18 17:52:49
8d45789167794da92d5e493ae6629110c6ca278a...3d007f4f9c4de32ed418b21ef4c51e388bb63547,1,4,6,10,1,2012-12-19 03:57:10,2012-12-18 17:55:23
3d007f4f9c4de32ed418b21ef4c51e388bb63547...b53671ae85e40804eefbfe2afecee1ba21df8d1d,1,7,5,12,3,2012-12-19 03:57:11,2012-12-18 18:03:29
b53671ae85e40804eefbfe2afecee1ba21df8d1d...49b630086e16545b0770a3425adcfdcc83863599,1,3,3,6,3,2012-12-19 03:57:11,2012-12-18 18:07:08
49b630086e16545b0770a3425adcfdcc83863599...c5309eb2da80f04e3ad445c340d18fbe5babbc6a,1,0,2,2,1,2012-12-19 03:57:12,2012-12-18 18:07:59
c5309eb2da80f04e3ad445c340d18fbe5babbc6a...521479b1708c1bad7f3c62546000ead2fcec8313,1,7,6,13,5,2012-12-19 03:57:12,2012-12-18 18:18:13
521479b1708c1bad7f3c62546000ead2fcec8313...19a766a201b9eb8bce7e5b097bf44e78385d0069,1,27,15,42,3,2012-12-19 03:57:13,2012-12-18 18:32:31
19a766a201b9eb8bce7e5b097bf44e78385d0069...94243295b203fef6dbd2f225b13810c4ee683c38,1,15,14,29,5,2012-12-19 03:57:14,2012-12-18 18:51:31
94243295b203fef6dbd2f225b13810c4ee683c38...523a3ae5a3e7a70f4479c59e975211ae2e8d3785,1,26,0,26,3,2012-12-19 03:57:15,2012-12-18 19:40:57
9d8fa5379942e6dded14a9df053a69ebba136056...9ec50c25a83163d5971d1c96f1bd34af481433e5,1,3,3,6,3,2012-12-19 00:15:21,2012-12-19 00:15:21
92c4d25820a55186f3834891673fb9d72715d978...cedc15af9959e4931ef39e24a6ca5e17b2688ee2,1,1,1,2,2,2012-12-20 02:51:06,2012-12-20 02:51:06
92c4d25820a55186f3834891673fb9d72715d978...b412d5638929f8b08ea63d862a1a46b3d9f9e4c9,8,133,120,253,53,2012-12-20 01:02:06,2012-12-19 03:46:05
b412d5638929f8b08ea63d862a1a46b3d9f9e4c9...621b50e4d55e98870b575b418a9b6fc8a024c65e,3,147,0,147,3,2012-12-20 01:02:06,2012-12-20 00:51:37
621b50e4d55e98870b575b418a9b6fc8a024c65e...00998a12ca18df381e661c5f39ee15b0984b3e67,1,2,2,4,2,2012-12-20 01:02:06,2012-12-20 00:51:58
00998a12ca18df381e661c5f39ee15b0984b3e67...316bca697f16e6fc0c9ecc943e84e9af3b39812b,1,6,17,23,5,2012-12-20 01:07:12,2012-12-20 01:07:12
316bca697f16e6fc0c9ecc943e84e9af3b39812b...29f27599eab750d2b4b8935a14be8b596b7affe2,12,46,37,83,28,2012-12-20 18:52:57,2012-12-20 18:51:09
29f27599eab750d2b4b8935a14be8b596b7affe2...874dcb25eba8637ed6d2a070741dd0363e30d83d,5,52,92,144,17,2012-12-20 20:01:13,2012-12-20 19:49:05
874dcb25eba8637ed6d2a070741dd0363e30d83d...87bc689fbf571aa3cbc77e510f14304cc3502ca5,2,4,3,7,3,2012-12-20 23:50:33,2012-12-20 23:50:33
87bc689fbf571aa3cbc77e510f14304cc3502ca5...79000951ec907c967a1c322da8c351998676f753,5,22,32,54,12,2012-12-21 16:05:59,2012-12-21 16:05:59
79000951ec907c967a1c322da8c351998676f753...2808ec9ab47d5a78bf0b0ebd8435b1c92a594307,1,1,1,2,1,2012-12-21 21:15:37,2012-12-21 21:15:37
2808ec9ab47d5a78bf0b0ebd8435b1c92a594307...69d1bd9125b27b9d4b408534ca850ed5e509faa4,2,2,2,4,2,2012-12-21 23:30:46,2012-12-21 23:30:46
69d1bd9125b27b9d4b408534ca850ed5e509faa4...6bd09ecc14a47ba5f7f7be87a15002d23c32bdbf,1,2,1,3,2,2012-12-24 15:54:26,2012-12-24 14:51:10
6bd09ecc14a47ba5f7f7be87a15002d23c32bdbf...7d4b65f608ce814fc814e8c9832e610097658e84,1,8,8,16,4,2012-12-24 15:54:27,2012-12-17 11:27:32
7d4b65f608ce814fc814e8c9832e610097658e84...b0aa14aa3c1fff7bb585df5e06e23588fb829bf6,2,3,1,4,2,2012-12-24 15:54:27,2012-12-24 14:27:42
b0aa14aa3c1fff7bb585df5e06e23588fb829bf6...ae35aa07082968e00b9b77173c622482ea02db5d,1,6,4,10,5,2012-12-24 16:20:37,2012-12-24 14:29:26
ae35aa07082968e00b9b77173c622482ea02db5d...f19304d2653cdc829f549283b3fb4e2e4d9b06ce,3,17,6,23,5,2012-12-24 17:18:31,2012-12-24 14:59:01
f19304d2653cdc829f549283b3fb4e2e4d9b06ce...19c3c99ca8562d5a6e2a8fe6dbbed6892b0f9eca,1,0,15,15,1,2012-12-24 17:18:40,2012-12-24 16:16:41
19c3c99ca8562d5a6e2a8fe6dbbed6892b0f9eca...592f466c48a45ee8b9ba1057294a9cb849c729fa,1,22,23,45,2,2012-12-27 19:11:53,2012-12-27 19:11:53
592f466c48a45ee8b9ba1057294a9cb849c729fa...3de2256708a206bc01bca0fe418b8448d1b41855,1,15,3,18,4,2012-12-27 19:12:14,2012-12-27 19:12:14
3de2256708a206bc01bca0fe418b8448d1b41855...0642c1431eccdf7aef496c0dc6d64805c513db53,7,10,10,20,10,2013-01-02 20:44:47,2013-01-02 20:44:47
0642c1431eccdf7aef496c0dc6d64805c513db53...c07b52df1b2d0d89c5fc1b2eae9dbf99e6571fe1,2,3,5,8,5,2013-01-02 20:48:17,2013-01-02 20:48:17
c07b52df1b2d0d89c5fc1b2eae9dbf99e6571fe1...730df6d0f70a343ade75ef9411fe0435b0afd5a9,5,22,12,34,16,2013-01-02 21:43:54,2013-01-02 21:43:54
17ef7dbce4e4eaa08ed7007b6d67f375759846a8...03a89070782f92d994feae960b1a8b3fb14adbc8,1,54,14,68,12,2013-06-01 04:49:40,2013-06-01 04:49:40
17ef7dbce4e4eaa08ed7007b6d67f375759846a8...f658dc433cae351e72b1c8b245724eafb43f5844,8,18,4,22,13,2013-05-31 21:09:58,2013-05-31 21:09:58
f658dc433cae351e72b1c8b245724eafb43f5844...1a42dd17eb2c35fa572418f5958595cbe297d229,5,26,6,32,8,2013-05-31 21:13:11,2013-05-31 21:13:11
1a42dd17eb2c35fa572418f5958595cbe297d229...3e9e6cdaff8acb11399736abbf793bf2d000d037,9,26,13,39,13,2013-06-07 16:54:33,2013-06-07 16:54:33
e236b37ff75e20f7259508ed022e67fe38458fea...b832ecf71c8e8d6787f9252b92e97153047a3ec3,1,14,13,27,5,2013-06-05 16:46:51,2013-06-05 16:46:51
69c50f4c44142eda6d2e20953a4ba774decd4017...9d2f841a5d39fc25ce722a3904f6ebc9aa112222,1,29,15,44,10,2013-05-02 10:03:54,2013-05-02 10:03:54
9d2f841a5d39fc25ce722a3904f6ebc9aa112222...d82d66c96d11131440deb8f79443ee0b44d40eff,1,55,3,58,6,2013-05-02 10:05:21,2013-05-02 10:05:21
d82d66c96d11131440deb8f79443ee0b44d40eff...81b7dec4ee21454775f932717273a90a46f78e1f,1,12,10,22,12,2013-05-02 10:06:34,2013-05-02 10:06:34
81b7dec4ee21454775f932717273a90a46f78e1f...8c535f3f6879c6796d8107d7eb80dd8b2105621b,1,12,10,22,5,2013-05-02 10:34:56,2013-05-02 10:34:56
503dd0f3c4f798b02e0173dde7e3631d6e860c42...3d1c9f612d78c6c235a3f38af226300fb6dd7dd6,3,20,3,23,8,2013-05-09 13:45:06,2013-05-09 13:45:06
af795759a7c1e753d440e3c3ca4dd5d8e391018c...4f2eb2b7f4cf6b2b6594887edd8948cb149c8052,3,59,0,59,3,2013-05-08 00:28:47,2013-05-08 00:28:47
33665410d636c9f5f0d5e017fe6347260b1b6ec1...0f938c6b8fbddc8810b05603c29751c0b5b7323c,4,10,10,20,10,2013-05-07 16:59:53,2013-05-07 16:59:53
0f938c6b8fbddc8810b05603c29751c0b5b7323c...eb05b114e1c8042225086393a39b712fe3f31e71,1,1,1,2,1,2013-05-08 05:45:01,2013-05-08 05:45:01
33665410d636c9f5f0d5e017fe6347260b1b6ec1...505b5d0c815a9b8f78bf7267e57ea433f04d0b6b,3,44,13,57,10,2013-05-07 16:49:47,2013-05-07 14:01:22
590991a7e05a7ba59a6f365375e2ed6f8a6f819a...7f8cf6fefdd380f992f1100440f0eb030f6b6633,1,1,1,2,1,2013-05-07 07:15:12,2013-05-07 07:15:12
a17e882fab4e190d5a052cbc9cf6a238a9166a7c...288c8a25750af694685ad71e08b6708729266aa9,1,2,2,4,1,2012-03-13 15:51:16,2012-03-13 15:48:07
e24fbba94862fdb602846771f2ae41ef15834d10...7b93079b5b7c5f58de321bb9846e93b1717d3e4c,2,24,0,24,2,2012-03-16 14:16:52,2012-03-16 14:16:52
575a54db856947aeb4fc5cf1977844d22dfa1aab...0d32f39eb821dfec2e241ea633c0a6e94c21519d,6,268,175,443,14,2013-04-11 07:59:26,2013-03-04 10:31:50
0d9bf89083f568c9a2efe56f21b0a93ec0275404...437d36662e7bf9680b8eaeec626cfba5f4d68bd9,1,1,3,4,1,2013-04-17 22:15:29,2013-04-17 22:15:08
6edad4d8a4c5e20544eb3b1daa926413518dd020...1cfaaa9e48655c4a5b4ebc4f8c20fcb8c6537e49,1,1,1,2,1,2013-04-17 11:48:26,2013-04-17 11:48:26
57e765b2e828db07bf474897985f1d7e6e47bd79...d768f9add943e0ca220c81d7ffa29fc3215cd119,1,2,0,2,1,2013-03-10 20:37:09,2013-03-10 20:37:09
ad003763ccb39c0e59f5c1d8372a202541a9049e...bbb1364671b1a111e4ba9bd6e34e016768306da4,2,75,10,85,9,2013-03-13 21:59:51,2013-03-13 21:59:51
537abd4a2cf2e412b20d275e64b57ab8982f3ca0...77844988b8143e9abca1bbd36730c780d4e0325e,1,45,21,66,22,2013-01-18 19:51:46,2013-01-18 19:51:46
75f49ae49b3716873165cba3fa9ea8648c887250...271680d7f40b61f79bbcd6361f2627c667817e72,2,8,0,8,8,2013-01-18 00:18:44,2013-01-18 00:18:44
75f49ae49b3716873165cba3fa9ea8648c887250...f63d0ee9fc6fb7335fba6b247675a1ba155d27c1,1,5,5,10,2,2013-01-17 23:47:10,2013-01-17 23:47:10
230010d19b20764b5f73636c900bd3ff84295100...28cbd2e2a891af604c78efd04624215f38185c8a,1,4,4,8,1,2013-01-16 21:53:59,2013-01-14 11:09:10
28cbd2e2a891af604c78efd04624215f38185c8a...bf031581d3d87e44da447f0e5a95bd6a24e5bf34,7,184,22,206,23,2013-01-16 21:56:13,2013-01-14 13:22:11
230010d19b20764b5f73636c900bd3ff84295100...bcbb1e201b77973a49011e1c85c53a5808f6f3a8,1,89,0,89,1,2013-01-15 17:49:32,2013-01-05 19:58:25
bcbb1e201b77973a49011e1c85c53a5808f6f3a8...facc0650b12655c9637732bb992d1053cd946057,1,12,16,28,3,2013-01-15 17:49:32,2013-01-08 21:27:25
facc0650b12655c9637732bb992d1053cd946057...4b181037553601a0747ad39ccdd85ebd3b184055,5,42,65,107,25,2013-01-15 17:49:32,2013-01-08 21:39:15
4b181037553601a0747ad39ccdd85ebd3b184055...5c8bb98ce9c4e5bb6527c8ffc274c8b3e0755fa7,1,6,4,10,3,2013-01-15 17:49:32,2013-01-08 21:45:06
5c8bb98ce9c4e5bb6527c8ffc274c8b3e0755fa7...134d8c918c3430b19b75f45b1e490ce2aae526ff,6,165,81,246,76,2013-01-15 17:51:34,2013-01-08 23:53:13
134d8c918c3430b19b75f45b1e490ce2aae526ff...a49340c3e5de90ca551b46ea79573c428e3836b0,1,49,0,49,1,2013-01-15 17:51:34,2013-01-08 23:56:11
a49340c3e5de90ca551b46ea79573c428e3836b0...851ad65081793bb5fd65052907bf1c3c4e7e5729,3,88,25,113,25,2013-01-15 17:51:35,2013-01-10 00:00:16
851ad65081793bb5fd65052907bf1c3c4e7e5729...23594c1dae08c9a53f571dbf9de7ff0b6a6a0d45,2,30,1,31,3,2013-01-15 17:51:35,2013-01-10 00:02:42
23594c1dae08c9a53f571dbf9de7ff0b6a6a0d45...98527b5b241ce9d240537f60e87aa9dd084c0f36,3,26,6,32,5,2013-01-15 17:51:35,2013-01-10 00:03:35
98527b5b241ce9d240537f60e87aa9dd084c0f36...25423d03b826f9647e72a56b14e08967d92ae479,4,228,40,268,42,2013-01-15 17:51:35,2013-01-10 00:07:54
25423d03b826f9647e72a56b14e08967d92ae479...fffe429a20b68677cae940ba8a9a0ff60056d6c0,1,5,0,5,1,2013-01-15 17:51:35,2013-01-10 19:11:42
2086e1baef456da0e9dbb1d433079618083b1b95...c0f4a0118dd3821447512bf3b404be69c773eaf8,3,154,17,171,16,2013-01-11 15:55:37,2012-12-19 15:48:12
c0f4a0118dd3821447512bf3b404be69c773eaf8...525d961c2442f3947517201113e375375fcf4280,2,35,10,45,13,2013-01-11 15:55:37,2012-12-20 06:55:51
525d961c2442f3947517201113e375375fcf4280...c8f79c2bdf9dd237d5c407526bcfc20d4eff5e64,2,92,54,146,17,2013-01-11 16:32:59,2012-12-21 09:59:10
c8f79c2bdf9dd237d5c407526bcfc20d4eff5e64...0ed756200693aed93c4c9fb4f8776196fec5a971,2,38,4,42,10,2013-01-11 16:32:59,2012-12-21 12:46:48
0ed756200693aed93c4c9fb4f8776196fec5a971...f289f886cb81bb570bed747053d5ebf8aba6bef7,3,4,4,8,4,2013-01-11 16:33:00,2013-01-11 16:24:52
83261a449f76147c1ebb3ebe592821f7d69bb6f6...46c2c1d53891ab7f701016204562ab5524596035,1,4,0,4,2,2012-12-28 12:47:13,2012-12-28 12:29:16
83261a449f76147c1ebb3ebe592821f7d69bb6f6...f616a36bdd9b1a0f26f399414bbccb434595edff,4,148,127,275,55,2012-12-28 06:25:52,2012-12-28 06:25:52
f616a36bdd9b1a0f26f399414bbccb434595edff...3865f7f6610563864d8f7a2671229b6fd398cd1b,1,3,0,3,1,2012-12-28 07:23:12,2012-12-28 07:23:12
0f7f1b1baea2958e2f8c227c5b5c3a3894483a53...8a810441a206398640fce37f54f38c53e19e9b2c,1,15,14,29,12,2012-12-19 11:48:12,2012-12-19 11:48:12
8a810441a206398640fce37f54f38c53e19e9b2c...08a325a32139fcc396a325ecdbdf6609efa1ab5c,1,13,5,18,10,2012-12-19 11:52:14,2012-12-19 11:52:14
cd5ca5b97fe2b9f87800adc7cfbb7088ac0c3ab7...922dd9788cfec2ec4727e1b264a2ad6a7f4849ba,2,22,22,44,3,2013-01-02 21:54:37,2013-01-02 21:54:37
cfbd08a59cd70b3328b149499a91ff4fb8487d9a...dc33b3d7b21b2003d6835a06fecf9ed4f4535f7e,1,4,2,6,1,2013-06-02 09:13:45,2013-06-02 09:13:45
eb58e2d0be4e07c2ef873a5f0562eaa90826c2de...6de9b2ee14a2393fae3ed86c5a5d12712c83b083,9,12,13,25,12,2013-06-12 19:10:33,2013-06-12 19:10:33
987ab76580e08945c4d77fa45bc9e95dd362a6b6...2e1fa15fcd69ba41bb25be92e2218a5ff3dd47fb,1,7,7,14,5,2013-06-05 17:00:16,2013-06-05 17:00:16
d966310cab4da6a1f30dfdf61842e84ecbdac22e...34bd59992e9e11107d16837b671f867e2a5e77ef,1,10,12,22,5,2013-05-02 15:14:05,2013-05-02 15:14:05
34bd59992e9e11107d16837b671f867e2a5e77ef...0ddfcb40d5ddf2e6d74f061efcccd944d18460cc,1,6,5,11,7,2013-05-02 16:27:02,2013-05-02 16:06:14
d966310cab4da6a1f30dfdf61842e84ecbdac22e...7edb9071da8e78e8cf9aff969f1b8137bca3c33d,9,47,6,53,13,2013-05-02 15:07:20,2013-05-02 15:07:20
7edb9071da8e78e8cf9aff969f1b8137bca3c33d...3bb00f3360bd11a48e1b04dc7dec971f0019891f,2,1,8,9,2,2013-05-02 15:17:46,2013-05-02 15:17:46
3bb00f3360bd11a48e1b04dc7dec971f0019891f...f69db390fb5cbacbb1c63d146aef4e0fb6754ddf,1,37,7,44,10,2013-05-02 15:39:14,2013-05-02 15:29:58
f69db390fb5cbacbb1c63d146aef4e0fb6754ddf...1022db2b6860d602e79169906eee4f299855975b,2,3,3,6,3,2013-05-02 15:42:09,2013-05-02 15:42:09
1022db2b6860d602e79169906eee4f299855975b...822645f6298ae0ff86fa717a79c5b7e105bc4a0d,1,7,2,9,1,2013-05-02 15:48:49,2013-05-02 15:48:49
822645f6298ae0ff86fa717a79c5b7e105bc4a0d...a591ed3ea9e46771510628f1f677f2f3791078d6,1,3,1,4,1,2013-05-02 16:06:46,2013-05-02 16:06:46
9ca4ff41eb4fae26b9336d440953bc6be752f832...1f9e41ee865ac3a9c60d39c7db212478c04bf86d,4,40,16,56,5,2013-05-10 14:50:53,2013-05-10 14:50:53
9ca4ff41eb4fae26b9336d440953bc6be752f832...617bb17556ae97a3e21b502c7fed1acfe9e1370a,1,2,2,4,2,2013-05-09 15:44:44,2013-05-09 15:44:44
288c8a25750af694685ad71e08b6708729266aa9...06c081e1bc2ec59c63ae8fed82f70ff43565d6a3,1,1,1,2,1,2012-03-21 03:47:17,2012-03-21 02:57:56
4cfe2ab60b1e26554b2bf753b06f538cb3475bd0...0d0fa7c3681e4ef3d0452666a9bc97d4b08391c9,29,360,479,839,248,2012-03-16 22:56:01,2012-03-16 22:56:01
53cb87575dc2982d23038e87e87824f8b20fe4be...f90391ea5fdcd5ef972958ac375d8223a5045cc5,1,0,1,1,1,2013-04-18 12:48:40,2013-04-18 12:47:54
53cb87575dc2982d23038e87e87824f8b20fe4be...9e46f6761891dbf05b733baae48e8c7161a213b5,1,1,1,2,1,2013-04-18 04:56:42,2013-04-18 04:55:20
526882a30a6304bde5aaf1ffe88b2556f5e33e1b...8023b83a945eaf3be7baad4fa74d93f4a079be0f,1,1,1,2,1,2013-04-17 22:21:17,2013-04-17 22:21:17
1f327768c7124494ac9352e1ea5088b3678f4818...0da62c5cf094394e7d9a4f7ef0832f8459ab3d40,1,12,0,12,2,2013-04-17 15:52:49,2013-04-17 15:52:49
5b27bf7e5bfd5c2f92a15c0058c801d49faf8403...0b0ecbec2b576400980b22cf2c8fb4d9ab76c423,1,1,1,2,1,2013-03-19 16:42:10,2013-03-19 16:42:10
5b27bf7e5bfd5c2f92a15c0058c801d49faf8403...65025cb8934a289460bc64f82c27027c68a85be6,24,130,27,157,31,2013-03-19 00:24:13,2013-03-19 00:24:13
d768f9add943e0ca220c81d7ffa29fc3215cd119...20858f6ea631008c334cbf5bb5f976291765c173,3,242,32,274,17,2013-03-11 21:32:33,2013-02-19 14:22:58
d768f9add943e0ca220c81d7ffa29fc3215cd119...aa408cbfc4940e05cb7843383264623e45737bb9,2,57,2,59,6,2013-03-11 17:47:01,2013-03-11 16:18:00
6950dca42ea15d2a766131464935a1c4d8bd11b2...55e0f53d8636f3402a698814e719cca9b9fa803a,5,27,25,52,18,2013-03-14 22:09:29,2013-03-14 22:09:29
6950dca42ea15d2a766131464935a1c4d8bd11b2...0c46863384e9da3746b90ddf81eef6d25d475e5c,7,251,240,491,81,2013-03-14 20:40:15,2013-03-14 20:40:15
0c46863384e9da3746b90ddf81eef6d25d475e5c...d85296ab9b9c4a01adb35d4d2438b72177aeabc4,4,37,21,58,8,2013-03-14 20:50:54,2013-03-14 20:50:54
d85296ab9b9c4a01adb35d4d2438b72177aeabc4...14bedad90776b750cf69ed6faadf2d6c3a4e0a86,1,15,7,22,7,2013-03-14 22:08:04,2013-03-14 22:08:04
d77f80d8410ad1262bea279ceba3061ddfb019ad...7a2cf780d13106cfd90ea33431b6444880c05123,1,1,0,1,1,2013-01-20 00:57:32,2013-01-20 00:57:32
7a2cf780d13106cfd90ea33431b6444880c05123...d47c6aabfe8301577a6e4067aacd9ed6782e4035,1,3,2,5,2,2013-01-20 03:20:09,2013-01-20 03:20:09
34a4ad46e8ff306dca989bb591dc415e38480064...291090a0761934fe295d0923ea577f6878460bf3,2,47,29,76,11,2013-01-17 21:19:09,2013-01-17 21:19:09
34a4ad46e8ff306dca989bb591dc415e38480064...6e959708e55316664379b9cecf53784c542d8a14,18,112,3,115,8,2013-01-17 21:17:32,2013-01-17 19:11:57
34a4ad46e8ff306dca989bb591dc415e38480064...9bf56c7b1cee1b0ed88bd327609250f4f34314c7,1,6,0,6,1,2013-01-17 19:55:06,2013-01-15 20:39:37
9bf56c7b1cee1b0ed88bd327609250f4f34314c7...b90eb84ff9fc092d48954247c4b1019f09ca72c7,1,21,0,21,1,2013-01-17 21:32:37,2013-01-17 21:27:04
32b33d62b2ad8186927ccc029ed36a93ab0def61...6e237de6d84fdfc44e1f466de490e5b74226fb54,1,5,5,10,1,2013-01-11 17:19:52,2013-01-11 17:19:52
6e237de6d84fdfc44e1f466de490e5b74226fb54...d0b14cea0e1ff09af83a801c1a9cf1a431d46d0c,1,1,1,2,1,2013-01-11 17:21:09,2013-01-11 17:21:09
3d4064a2cba57fca3f86c5b4d00051ab88f3760d...dbc4aa0750717e08efe41a0267347d8046462c5c,1,23,11,34,7,2012-12-29 06:00:24,2012-12-29 06:00:24
922dd9788cfec2ec4727e1b264a2ad6a7f4849ba...0db4cd04ef263d473219152df996b1cb2c4f52aa,1,5,7,12,4,2013-01-03 13:45:09,2013-01-03 13:45:09
922dd9788cfec2ec4727e1b264a2ad6a7f4849ba...4a44087ae75a63ab0c10be215722a8a24f1187e7,1,6,6,12,5,2013-01-03 13:43:51,2013-01-03 13:43:51
4a44087ae75a63ab0c10be215722a8a24f1187e7...8716b499e246496171aa8e9b84563b9486d66033,4,39,10,49,12,2013-01-03 14:31:36,2013-01-03 14:31:36
9d9fff3c3dbc207a8a2ee2114eab19086afecb6e...daf98cb2edaa2d8b45c3e88d2d2f4c5db7925b2f,1,13,5,18,5,2013-06-05 16:05:29,2013-06-04 18:49:39
6de9b2ee14a2393fae3ed86c5a5d12712c83b083...5a6e45cc841194a61ccad1006ad4a4b9aa2ecbc5,2,5,12,17,3,2013-06-12 19:14:04,2013-06-12 19:14:04
5a6e45cc841194a61ccad1006ad4a4b9aa2ecbc5...c1cf1af46a541419160473decb0955dda6ac721e,2,9,9,18,5,2013-06-13 08:12:44,2013-06-12 19:15:58
2e1fa15fcd69ba41bb25be92e2218a5ff3dd47fb...aad6967be1025b1819c3ba25163d7f69fc814130,1,67,16,83,6,2013-06-05 19:13:54,2013-05-30 04:52:21
aad6967be1025b1819c3ba25163d7f69fc814130...7000f3fa7bad25ec07355d6afb640ea272201dff,2,433,422,855,4,2013-06-05 19:13:54,2013-06-04 17:32:59
7000f3fa7bad25ec07355d6afb640ea272201dff...114f5a6c41ea03393e00ae41126a6ddb0ef39a15,52,1951,1665,3616,89,2013-06-10 17:10:39,2013-06-10 17:10:39
114f5a6c41ea03393e00ae41126a6ddb0ef39a15...596b121ae46554cf48b4e561541e1ab975dbef78,2,42,1,43,2,2013-06-10 21:16:49,2013-06-10 21:16:49
596b121ae46554cf48b4e561541e1ab975dbef78...2f77d8f15d7c71a92f01850025c91dffe3bcafd4,2,5,1,6,3,2013-06-10 21:16:56,2013-06-10 21:16:56
2f77d8f15d7c71a92f01850025c91dffe3bcafd4...3eadfecd325d355d3f8a9631d9c89b7e8eede98b,2,42,4,46,10,2013-06-10 22:24:20,2013-06-10 22:24:20
3eadfecd325d355d3f8a9631d9c89b7e8eede98b...5dc98298a14a9adae3cf8b21fb01f682791c29c7,10,297,85,382,58,2013-06-11 18:22:22,2013-06-11 18:22:22
5dc98298a14a9adae3cf8b21fb01f682791c29c7...42e6cf7860fba665357a7b1b6a8c5d3f5dc0d634,2,166,25,191,24,2013-06-12 00:45:14,2013-06-12 00:45:14
42e6cf7860fba665357a7b1b6a8c5d3f5dc0d634...54faddd299ccb6187a9747c1d3ee18d33e5edf7a,2,28,25,53,19,2013-06-12 18:54:11,2013-06-12 18:54:11
54faddd299ccb6187a9747c1d3ee18d33e5edf7a...f9c824c592d7a23f7cc385c25c95a5d0c5c8687e,3,428,52,480,37,2013-06-12 18:55:27,2013-06-12 18:55:27
f9c824c592d7a23f7cc385c25c95a5d0c5c8687e...ef3374a8a81786a7b544ed7eded53c95766eb02f,3,41,16,57,6,2013-06-12 20:46:44,2013-06-12 20:46:44
ef3374a8a81786a7b544ed7eded53c95766eb02f...360f42f4b3f5de31270416220bd799b951202b2d,6,154,95,249,42,2013-06-12 21:18:09,2013-06-12 21:18:09
2e1fa15fcd69ba41bb25be92e2218a5ff3dd47fb...999d4405a69e8d4d3d3bcd4a5d4bf45d8283b172,1,36,46,82,18,2013-06-05 19:02:28,2013-06-05 19:02:28
999d4405a69e8d4d3d3bcd4a5d4bf45d8283b172...f7e5615086134f1d433a1b7a03ee9bbbbe0844af,1,30,35,65,13,2013-06-05 22:41:42,2013-06-05 22:41:42
af7689ea2489b2e92d46086a689ec074dd0854f5...4e7c15608f427466ef941cad45b27f1ad30bd25a,3,21,14,35,10,2013-05-02 19:58:40,2013-05-02 19:58:40
aca2d26a5c12a225572fbf51a094aa2bb88ad913...ae59321fb86d080d0fd17e8c9a57c855914bcd32,1,1,1,2,1,2013-05-10 12:46:14,2013-05-10 12:31:58
e71b78b02b6f28d1cf94dc5023fe1faba3f4026c...7826d577599a19a5b1ada97c45932e3b909f5add,3,4,8,12,7,2012-03-21 10:56:01,2012-03-21 09:00:54
e71b78b02b6f28d1cf94dc5023fe1faba3f4026c...e0799b6cd09faa729dca9e4c8cdf16a99ee60368,57,602,0,602,28,2012-03-21 06:11:24,2012-03-20 04:41:29
0d0fa7c3681e4ef3d0452666a9bc97d4b08391c9...e285bdc93b6d53e7e46aedaea00f95d7b961b78d,1,2,1,3,1,2012-03-21 07:12:25,2012-03-21 07:10:40
0d0fa7c3681e4ef3d0452666a9bc97d4b08391c9...fd7714273cb9646d63f4da8d81450a0f9f9295f5,1,3,3,6,3,2012-03-19 23:09:03,2012-03-19 23:09:03
fd7714273cb9646d63f4da8d81450a0f9f9295f5...7c7ff7d11e2d22f7b9c7f8152f5c58dde37ac207,8,212,230,442,125,2012-03-19 23:10:11,2012-03-19 23:10:11
7c7ff7d11e2d22f7b9c7f8152f5c58dde37ac207...4aa7de15159b3edfcb23173a4a463606f1bfdd19,5,205,236,441,129,2012-03-20 00:49:46,2012-03-20 00:49:46
4aa7de15159b3edfcb23173a4a463606f1bfdd19...a4c291ef128e870d4e748dedfb3798c33df0ac15,3,100,90,190,47,2012-03-21 04:57:38,2012-03-21 04:57:38
ea8bac37b0c3a302b8f740cbeb4af50d0626815b...7ebc249c2225c1a9290b0981fcc7f37490b5b80c,1,9,1,10,2,2013-04-12 16:21:47,2013-04-04 16:38:17
2b63dbfbc12746465f6b37aa2b050cdc77679657...a29c6b5f47676d864af1e78c7927bc3cb2b329d7,1,28,9,37,12,2013-04-19 21:51:18,2013-04-19 21:51:18
a29c6b5f47676d864af1e78c7927bc3cb2b329d7...4ef2c79cb6dc81e17b68ccf7c270bcc7e4f85bfb,1,4,0,4,2,2013-04-22 14:37:40,2013-04-22 14:37:40
2b63dbfbc12746465f6b37aa2b050cdc77679657...743048f1e9d9c853ffac80093a4814a1ac7d9c62,1,2,9,11,2,2013-04-19 17:29:50,2013-04-19 17:29:50
2b63dbfbc12746465f6b37aa2b050cdc77679657...ff0ddfa4bbec2e27491c822cf6b882c54d8675c8,3,356,0,356,4,2013-04-18 21:59:24,2013-04-17 22:56:31
ff0ddfa4bbec2e27491c822cf6b882c54d8675c8...71f85226eb5c2ef9e8c8ddb1943fc7fc1e6615ff,1,154,391,545,69,2013-04-18 21:59:24,2013-04-18 18:11:38
71f85226eb5c2ef9e8c8ddb1943fc7fc1e6615ff...fc57471a0c1834143ae6b18e65c1484c5c04e7e3,1,42,41,83,21,2013-04-18 21:59:25,2013-04-18 21:13:53
fc57471a0c1834143ae6b18e65c1484c5c04e7e3...627d590819efa7f43b605ce1a22278c0c6b42516,1,103,31,134,16,2013-04-18 21:59:25,2013-04-18 21:14:22
627d590819efa7f43b605ce1a22278c0c6b42516...2aee1aa4165583cf77815df404d87818d53b72dc,3,3,3,6,3,2013-04-18 21:59:25,2013-04-18 21:35:13
2aee1aa4165583cf77815df404d87818d53b72dc...9ea29c8f1dd155cf62fc6c87edaeb9984da72f72,1,2,2,4,1,2013-04-18 21:59:25,2013-04-18 21:41:16
9ea29c8f1dd155cf62fc6c87edaeb9984da72f72...38fd8121a2a87cc0da405b50f4439ca6578dcff5,2,3,3,6,3,2013-04-18 21:59:25,2013-04-18 21:48:20
38fd8121a2a87cc0da405b50f4439ca6578dcff5...1af80a676613882b3e04e82874c6e7c8c14b5f49,1,5,7,12,3,2013-04-18 23:13:52,2013-04-18 23:13:52
7dbf4039ae0881407fc9ead24c09c1d7cfd4103a...7202ec29e9643b7262d827483d96b9e8708af543,3,93,23,116,26,2013-03-22 21:23:18,2013-03-20 18:47:34
7202ec29e9643b7262d827483d96b9e8708af543...3ba01362437102501a173b9fe072a5690358baa0,2,7,7,14,5,2013-03-22 21:23:38,2013-03-20 18:46:03
3ba01362437102501a173b9fe072a5690358baa0...1323c6d18049163fc81e5e246e7d4e120c8de03a,12,45,111,156,52,2013-03-22 21:27:56,2013-03-22 21:27:56
7dbf4039ae0881407fc9ead24c09c1d7cfd4103a...33a59401c377c329e8875cfad2a1332eb514b62a,2,18,13,31,9,2013-03-22 19:27:59,2013-03-22 19:22:39
7dbf4039ae0881407fc9ead24c09c1d7cfd4103a...0c8efb38f9ffb1c4fffe620174669c51866eff79,2,15,0,15,2,2013-03-21 15:59:01,2013-03-21 15:59:01
0c8efb38f9ffb1c4fffe620174669c51866eff79...7e527ca700cbc98f9cd6acb52dc7b6180b3bcc35,1,14,0,14,4,2013-03-21 16:16:31,2013-03-21 16:16:31
7e527ca700cbc98f9cd6acb52dc7b6180b3bcc35...1e7b7523753a144597bff4a5a05f6e7c7e90c40e,1,1,1,2,1,2013-03-21 16:30:08,2013-03-21 16:30:08
1e7b7523753a144597bff4a5a05f6e7c7e90c40e...b3c174835b016a6fa8f23923beddd0d8fa68f19b,1,1,1,2,1,2013-03-21 17:50:28,2013-03-21 17:50:28
7dbf4039ae0881407fc9ead24c09c1d7cfd4103a...e2886f1e7e93426f76c286605d0048b27f12f137,1,3,2,5,2,2013-03-20 13:13:43,2013-03-20 13:13:43
7dbf4039ae0881407fc9ead24c09c1d7cfd4103a...799f9a04e38579a6340145440bb927d3dd83c642,1,142,35,177,15,2013-03-19 18:56:45,2013-03-19 18:56:45
799f9a04e38579a6340145440bb927d3dd83c642...bef2a12cc0859a65a6bc6e72465395a4a48bd3e7,1,19,21,40,4,2013-03-19 19:35:26,2013-03-19 19:35:26
bef2a12cc0859a65a6bc6e72465395a4a48bd3e7...cd01dd5d63a7e7899f31a9c1c3fd361bcdf3f74c,1,1,3,4,1,2013-03-19 19:43:34,2013-03-19 19:43:34
5b229e205350d107ad824bccbdb18bb61e25eb65...f16fb09951cbd9f920e141a46fe5409d6ffebcb9,1,5,6,11,4,2013-03-15 11:11:02,2013-03-15 11:11:02
f16fb09951cbd9f920e141a46fe5409d6ffebcb9...a5f6138407efb6d8866fe8de5aac13454aefcd82,1,0,20,20,2,2013-03-15 11:24:20,2013-03-15 11:24:20
d47c6aabfe8301577a6e4067aacd9ed6782e4035...59853eff99f8e849d3223bb7154e263fa05a88ae,3,53,16,69,7,2013-01-23 01:58:58,2013-01-23 01:58:58
d47c6aabfe8301577a6e4067aacd9ed6782e4035...28b1cdf3a1bdcd37cf9d550c92b8c19b1782ea6b,1,6,3,9,3,2013-01-21 22:46:28,2013-01-21 22:45:43
d47c6aabfe8301577a6e4067aacd9ed6782e4035...965e4e2d3182eb179e928191abfd446c0b652867,2,10,2,12,4,2013-01-21 21:19:41,2013-01-21 21:19:41
d0b14cea0e1ff09af83a801c1a9cf1a431d46d0c...0d65acade84a5ff2421cd52de82a8963f004d481,4,42,1,43,4,2013-01-11 19:24:26,2013-01-11 19:24:26
d0b14cea0e1ff09af83a801c1a9cf1a431d46d0c...805c476c83d100696b9ebe578f0ee2399d55b3c8,3,130,19,149,8,2013-01-11 19:20:44,2013-01-11 19:20:44
d0b14cea0e1ff09af83a801c1a9cf1a431d46d0c...cce2f16b9d676314f0505e40182ce760103db0a2,1,20,20,40,1,2013-01-11 18:30:56,2013-01-10 11:32:20
cce2f16b9d676314f0505e40182ce760103db0a2...635c235cf320428775529285bebf6f238fc71184,1,1,0,1,1,2013-01-11 18:30:57,2013-01-10 11:11:49
635c235cf320428775529285bebf6f238fc71184...4a0ac175ca56d25f82e43825632d9fe7f4dc1578,2,87,1,88,2,2013-01-11 18:30:58,2013-01-10 22:27:13
4a0ac175ca56d25f82e43825632d9fe7f4dc1578...090d5e1fdabc1245515fa887cab67457c37e709b,5,28,28,56,19,2013-01-11 18:30:59,2013-01-11 13:40:09
090d5e1fdabc1245515fa887cab67457c37e709b...f3738eba56cd6bafe1befea90a35a0b26600491c,1,2,2,4,2,2013-01-11 18:31:00,2013-01-11 14:39:14
036e81f72613e59fdf344af57ed0a381ade356b0...2e40c616c7ef3dc4f34ab445e4cba2c127e7522c,1,2,0,2,2,2013-01-02 15:28:08,2013-01-02 15:27:22
036e81f72613e59fdf344af57ed0a381ade356b0...156cfec096fd71cbd6d15592e80d164b8f3b55ad,13,38,383,421,20,2013-01-02 01:05:11,2012-12-18 23:12:26
156cfec096fd71cbd6d15592e80d164b8f3b55ad...b0a45829750825bdc417b0c3e5947c762faebbe0,2,2,2,4,2,2013-01-02 01:05:11,2012-12-19 00:10:13
b0a45829750825bdc417b0c3e5947c762faebbe0...5c2d3f6d5deeec84c7cadc7d9f61b00952f1d56f,2,10,4,14,4,2013-01-02 03:19:13,2013-01-02 03:17:31
5c2d3f6d5deeec84c7cadc7d9f61b00952f1d56f...a368fd0f7913a535903cca0bc1dccddefbfc7e89,1,6,0,6,1,2013-01-02 19:08:49,2013-01-02 19:08:49
a368fd0f7913a535903cca0bc1dccddefbfc7e89...0df4167577873cc91fd3745566195c46c009c59d,2,8,10,18,5,2013-01-02 20:22:19,2013-01-02 20:22:19
0df4167577873cc91fd3745566195c46c009c59d...e229c048255dfea78429cff6f5cc911987f5f8e5,2,3,2,5,2,2013-01-02 20:27:00,2013-01-02 20:25:32
e229c048255dfea78429cff6f5cc911987f5f8e5...a44f2e9e7b2dbcdf51564453475ec9a684cf7f75,2,9,9,18,4,2013-01-02 21:26:34,2013-01-02 21:26:34
a44f2e9e7b2dbcdf51564453475ec9a684cf7f75...39cd01779c84e0574c11f2e804f28c815e82a583,2,2,1,3,2,2013-01-02 21:38:10,2013-01-02 21:38:10
39cd01779c84e0574c11f2e804f28c815e82a583...6443eaf22f3567a430f038e8edc92e9f101db44d,6,37,37,74,37,2013-01-02 23:50:29,2013-01-02 23:50:29
6443eaf22f3567a430f038e8edc92e9f101db44d...ad27838bdc5b9d8d7730c36b24b5a519a3e5ec6e,1,3,3,6,2,2013-01-02 23:58:46,2013-01-02 23:58:46
ad27838bdc5b9d8d7730c36b24b5a519a3e5ec6e...39444bea0a3ad2946cb9772c5253d3db40bf813b,1,2,2,4,2,2013-01-03 00:01:03,2013-01-03 00:01:03
39444bea0a3ad2946cb9772c5253d3db40bf813b...afb181167ede0676b4a7bad5972cc712c3da1c17,2,1,6,7,2,2013-01-03 00:04:18,2013-01-03 00:04:18
afb181167ede0676b4a7bad5972cc712c3da1c17...f46769e52a907ca3b11acf598c9837f37d82cea4,2,4,16,20,9,2013-01-03 01:13:37,2013-01-03 01:13:37
f46769e52a907ca3b11acf598c9837f37d82cea4...8ee7174be9bbb451c5dbcc06e5422e915fe08753,2,0,4,4,2,2013-01-03 01:22:42,2013-01-03 01:22:42
8ee7174be9bbb451c5dbcc06e5422e915fe08753...2e6f06a8d47f4474bb3f268e66c040781a9a4ce2,9,1268,4,1272,11,2013-01-03 01:34:45,2013-01-03 01:34:45
2e6f06a8d47f4474bb3f268e66c040781a9a4ce2...a218862557a877f2ebb77fc3fe4acca3feddfbd9,1,0,1,1,1,2013-01-03 01:35:23,2013-01-03 01:35:23
a218862557a877f2ebb77fc3fe4acca3feddfbd9...4236164a77b57c42641530a523590a913ba299f9,1,1,2,3,2,2013-01-03 01:37:28,2013-01-03 01:37:28
07871d3adcfdaba7ad5f99f89299258d1dbd92f9...4128f5aa31f4620c2393cc49e6e44e23d07fe58f,3,38,86,124,19,2013-01-03 22:19:55,2013-01-03 18:26:11
07871d3adcfdaba7ad5f99f89299258d1dbd92f9...ad2bc32fa3e6958c2d975838712d6e3552abb838,4,11,3,14,4,2013-01-03 21:53:50,2013-01-03 21:53:50
7761ce21625564b6526b89326c14a9843a1403d4...6fef1ab344326bbdeb45fd653e3c13c233600a35,5,14,0,14,10,2013-01-03 15:47:51,2013-01-03 15:47:51
6fef1ab344326bbdeb45fd653e3c13c233600a35...bffbeebbec2878c5329e63b40ecae3715423eac6,3,24,0,24,8,2013-01-03 16:38:00,2013-01-03 16:38:00
bffbeebbec2878c5329e63b40ecae3715423eac6...600d8dbf6dccff5a9d86dd5ae01a53de46471796,7,75,42,117,31,2013-01-03 17:10:38,2013-01-03 17:10:38
600d8dbf6dccff5a9d86dd5ae01a53de46471796...f6fded8f9110aa05fe3d947d9e53cbd5cc13d1d5,2,47,48,95,16,2013-01-03 18:07:41,2013-01-03 18:07:41
f6fded8f9110aa05fe3d947d9e53cbd5cc13d1d5...7b51d675e89371661a6c97f76050d4b2477e171a,3,15,40,55,17,2013-01-03 18:17:07,2013-01-03 18:17:07
7b51d675e89371661a6c97f76050d4b2477e171a...54254a0fe2ee2d2778568322ae3a9e8812911bb5,2,365,369,734,19,2013-01-03 18:38:29,2013-01-03 18:38:29
54254a0fe2ee2d2778568322ae3a9e8812911bb5...b8a1ea7cf9e23e394d09b0d051b696bd7acc2cf9,1,10,2,12,5,2013-01-03 19:04:03,2013-01-03 19:04:03
b8a1ea7cf9e23e394d09b0d051b696bd7acc2cf9...b421decc76a60cd964d58ced87b9012370045dab,1,6,6,12,5,2013-01-04 16:47:51,2013-01-03 13:43:51
b421decc76a60cd964d58ced87b9012370045dab...853488eed45f2f620fdfc4879827df02bc11553e,1,5,7,12,4,2013-01-04 16:47:51,2013-01-03 13:45:09
853488eed45f2f620fdfc4879827df02bc11553e...b60b4562feac6c17dde9159c437e6e5a908d628e,4,39,10,49,12,2013-01-04 16:47:51,2013-01-03 14:31:36
b60b4562feac6c17dde9159c437e6e5a908d628e...35560d6d14fbdce1be2b87680b4af55fe6c15c09,4,11,3,14,4,2013-01-04 16:47:51,2013-01-03 21:53:50
35560d6d14fbdce1be2b87680b4af55fe6c15c09...931b8b709c0d2e1f42f258f61e88e457db9e4275,2,45,1,46,3,2013-01-04 16:47:51,2013-01-03 22:16:37
931b8b709c0d2e1f42f258f61e88e457db9e4275...d73d52dfcb589b1bc09a5ed7c4f39b0ddc21e2a9,3,38,86,124,19,2013-01-04 16:47:51,2013-01-03 18:26:11
d73d52dfcb589b1bc09a5ed7c4f39b0ddc21e2a9...43464497ab06f70117bcf98c95bc287de85121ad,1,24,0,24,1,2013-01-04 16:47:51,2013-01-03 22:24:10
43464497ab06f70117bcf98c95bc287de85121ad...9651fdc29715543ec2d094a24ba92688bdfb7d76,1,27,1,28,1,2013-01-04 16:47:51,2013-01-03 22:28:59
9651fdc29715543ec2d094a24ba92688bdfb7d76...5a62d659bcd3dd529fde9ab7eae2e216cba055cf,5,230,0,230,5,2013-01-04 16:47:51,2013-01-03 18:44:09
5a62d659bcd3dd529fde9ab7eae2e216cba055cf...10aa44cee2ed0523875f8da4410fc3c2c7ba8722,2,2,0,2,2,2013-01-04 16:47:51,2013-01-03 23:42:04
10aa44cee2ed0523875f8da4410fc3c2c7ba8722...ed8fb8210dc02e604e905d9ebe54ec73a9c8d220,1,7,0,7,1,2013-01-04 16:47:51,2013-01-04 00:14:23
ed8fb8210dc02e604e905d9ebe54ec73a9c8d220...d0ae8b98de561abe59652f904a24f381c856dee6,0,0,0,0,0,2013-01-04 16:47:52,2013-01-04 00:15:52
d0ae8b98de561abe59652f904a24f381c856dee6...a7ffd936bf26f6c7bb0a1d1dee811ace2c1c848e,1,1,21,22,6,2013-01-04 16:47:52,2013-01-04 16:46:38
4878ea45685c676491575fa7b54d9d9085fd7778...2da72fb21c1719b34a312dba3ebb7691032cfaa9,1,1,1,2,1,2013-06-14 18:01:35,2013-06-14 10:10:13
2da72fb21c1719b34a312dba3ebb7691032cfaa9...519072c9bfedeb2b6c4a8ad49739e5563813c3c4,1,2,0,2,1,2013-06-14 18:01:36,2013-06-14 12:02:00
4878ea45685c676491575fa7b54d9d9085fd7778...2532c903439d3116833146a89221c91a0023c3fe,2,146,0,146,2,2013-06-14 00:19:33,2013-02-05 23:01:30
2532c903439d3116833146a89221c91a0023c3fe...168e9d746e906a900c55e2de161d8941baf2a2d2,1,33,13,46,9,2013-06-14 00:19:33,2013-02-06 03:24:01
168e9d746e906a900c55e2de161d8941baf2a2d2...edcb6ee649b5f18586cfa61252e371fbaa72d090,1,14,0,14,1,2013-06-14 00:19:33,2013-02-07 18:33:56
edcb6ee649b5f18586cfa61252e371fbaa72d090...1a68c168a6cdbe0db6e44fb582a7026a7d536c9d,1,3,3,6,2,2013-06-14 00:19:33,2013-02-08 03:22:31
3de768ca2f148777f099c67114d0419a90b6eea1...76b893b65336722fdee27e1dc8a82eab7ef065ea,1,4,0,4,1,2013-06-11 21:37:02,2013-06-11 19:33:18
3de768ca2f148777f099c67114d0419a90b6eea1...24ec69998db55478af24b471b9000bd56113abd6,2,4,2,6,3,2013-06-11 09:01:45,2013-06-11 08:48:00
3de768ca2f148777f099c67114d0419a90b6eea1...bda3fbb1aca1a3259f00effdb809a27839b4cced,6,94,0,94,2,2013-06-10 20:16:58,2013-06-10 19:17:54
bda3fbb1aca1a3259f00effdb809a27839b4cced...690bf41ce5f700de787b019ed489cbdbd7f2b697,1,23,17,40,10,2013-06-10 20:18:38,2013-06-10 20:16:44
dc83d32ade04da29139837a24738238a10a8d0a7...5e151329fbb048dfc74f37432f619a4e331d24f7,1,180,180,360,60,2013-05-02 20:20:21,2013-05-02 20:19:49
b6cc559a78a073f2aadd179fe40c09be7318c898...e583334c00e80274866c87495e6ed2a40ec0a6f6,6,10,10,20,8,2013-05-11 12:13:26,2013-05-10 13:42:22
ae59321fb86d080d0fd17e8c9a57c855914bcd32...249888948f73667695fcde8088249db2e1a217ba,2,4,1,5,4,2013-05-10 17:22:47,2013-05-10 10:02:17
ae59321fb86d080d0fd17e8c9a57c855914bcd32...e9ba61f399594b16b8168f87264b7794eebc6b3a,2,56,1,57,3,2013-05-10 16:32:42,2013-05-10 16:32:42
d3dd775ea51580a9036d7ed91a66963d31158bcc...181bbf1498e3554cc66d1f00619ee4e9da695a95,1,2,2,4,2,2012-03-28 17:12:13,2012-03-28 17:12:13
16eaa15059afb3119b4e8482231bf0b0bdced8e0...471bb8b120fab5969df5778aa5c8d1c22c30d876,8,30,200,230,36,2012-04-03 02:52:52,2012-04-03 02:52:52
ae4cae4e08bd3a8a52069f00a688072ef1e85542...73fe6a8e20ffbc18ad667ff519c0fb8adf85fc3e,3,109,83,192,29,2012-04-02 18:41:48,2012-03-28 16:59:12
a4c291ef128e870d4e748dedfb3798c33df0ac15...a48ea31d69a76d6b398d3a1e522a1c7363a9b92a,5,273,24,297,10,2012-03-21 19:33:09,2012-03-21 19:33:09
a48ea31d69a76d6b398d3a1e522a1c7363a9b92a...95340398a1821bd19da1bfe459ba1f375ed89404,97,210,4,214,55,2012-03-22 16:17:34,2012-03-22 16:17:34
95340398a1821bd19da1bfe459ba1f375ed89404...66142ae03134ef8a45e6bd304c6106a1685c3c99,6,57,22,79,22,2012-03-22 17:44:36,2012-03-22 17:44:36
66142ae03134ef8a45e6bd304c6106a1685c3c99...a56aacf4d36778daa446b0a6c075e4cbc0791f41,4,293,6,299,11,2012-03-22 19:03:30,2012-03-22 19:03:30
a56aacf4d36778daa446b0a6c075e4cbc0791f41...98c4613e2d79f73d5168582c23e87faebc69787b,1,35,0,35,1,2012-03-22 20:10:23,2012-03-22 20:10:23
98c4613e2d79f73d5168582c23e87faebc69787b...4b136a94d948e62634633092c9d1052c4b074e6c,6,118,8,126,10,2012-03-23 16:26:09,2012-03-23 16:26:09
4b136a94d948e62634633092c9d1052c4b074e6c...c8838ee92d85b3f027f8cabd87b98b682778cdbf,3,15,5,20,8,2012-03-23 18:03:01,2012-03-23 18:03:01
c8838ee92d85b3f027f8cabd87b98b682778cdbf...875bfc5ffcdd21fca616d4f88444d4dcf6fd69ac,15,56,3,59,9,2012-03-26 04:26:48,2012-03-26 04:26:48
875bfc5ffcdd21fca616d4f88444d4dcf6fd69ac...1db12b00532d747fa7a805a8fa8d293c58ec16d9,3,53,38,91,9,2012-03-26 06:04:26,2012-03-26 06:04:26
1db12b00532d747fa7a805a8fa8d293c58ec16d9...277e304149011bb615ae258e25492350cbfd4d46,8,12,8,20,12,2012-03-26 18:22:27,2012-03-26 18:22:27
277e304149011bb615ae258e25492350cbfd4d46...bfc9ca595aa2f189743f2a7b9812f05def78ec88,11,573,13,586,17,2012-03-28 23:45:36,2012-03-28 23:45:36
bfc9ca595aa2f189743f2a7b9812f05def78ec88...95dfb031f70601b12a9eb57229fd4aa9a51ddd54,12,212,128,340,71,2012-03-30 21:40:50,2012-03-30 21:40:50
95dfb031f70601b12a9eb57229fd4aa9a51ddd54...952f94c8ab48cd22b8eca8d83320bbeec9680419,1,18,6,24,5,2012-03-30 21:42:23,2012-03-30 21:42:23
041ed367ab026583d6607b5029a0c63146a90215...0efae3b22e7472b95174632c323137a2b21b9c51,2,30,3,33,3,2013-04-15 10:24:08,2013-04-15 10:24:08
9d8f97c9bc81d8dd736348fbd18258879cdcf277...4a38143c93dc705bc40109e3f79d7fac722d44d7,1,2,1,3,1,2013-04-19 21:55:37,2013-04-19 21:55:37
3f21a23cc26cc6fbf84122872acf833de2a287e0...f5e28202cb8d73a444e5a5664420fbe5bec11119,4,35,1,36,8,2013-03-25 14:45:56,2013-03-25 12:38:43
3f21a23cc26cc6fbf84122872acf833de2a287e0...c2186230f3d439c192380cbcd425ea6824d94939,1,1,1,2,1,2013-03-24 11:34:00,2013-03-24 11:34:00
1f10747854f04d0ff0e582682613a7cc8a3bcbc8...13640d1bb8376e3f07f66498a5b9bdde9ff3d7d6,2,2,4,6,3,2013-03-25 20:39:11,2013-03-25 20:39:11
f7110e6ca3f7a6a03a0c4d5d1b6c911ac7c419e0...c2ea65eec31bc3c2c406a6ad60691916779b23f2,2,2,2,4,2,2013-03-25 20:24:18,2013-03-25 20:22:57
a5f6138407efb6d8866fe8de5aac13454aefcd82...10c06114cbb1c384b7de3cca6d6601ee750f5178,21,62,48,110,50,2013-03-17 23:30:26,2013-03-17 00:46:46
a5f6138407efb6d8866fe8de5aac13454aefcd82...08f32085ab31643c1e26f8401bba91582aed770f,1,18,4,22,8,2013-03-17 09:48:34,2013-03-16 16:38:27
08f32085ab31643c1e26f8401bba91582aed770f...d66a7c061a3b0809589de05eeac00725444db3aa,1,6,0,6,1,2013-03-17 09:48:41,2013-03-16 16:48:24
a5f6138407efb6d8866fe8de5aac13454aefcd82...5540d9477ed143707435324e785336d254b12e47,19,672,241,913,119,2013-03-15 23:39:00,2013-03-15 23:39:00
5540d9477ed143707435324e785336d254b12e47...41954a49c12a72eda3b3fe02c2752f6831b5dbf9,10,241,157,398,80,2013-03-18 21:19:35,2013-03-18 21:19:35
41954a49c12a72eda3b3fe02c2752f6831b5dbf9...324602514fec5ba04fa236c67d633f9b18ad9845,6,75,158,233,36,2013-03-18 22:54:35,2013-03-18 22:54:35
b101fbf9a403f38556ed9e6d3b293c73733465e2...75a0a80029fad65fdeb3af75ab0f5db93670221a,1,0,2,2,1,2013-01-23 06:47:40,2013-01-23 06:47:40
fad251ae02b108ebe83bde3b2948bb7344825437...47fc264203b2bae9e8a674505ac3502c3e9e71e7,2,3,1,4,3,2013-01-22 14:25:15,2013-01-22 14:25:15
fad251ae02b108ebe83bde3b2948bb7344825437...f4b86126eef4da05b8f460e614aa14a733bfaabf,1,16,13,29,10,2013-01-22 13:30:40,2013-01-22 13:21:08
1bf7bee3bcaeb3587ca32a5bb6425e380b312d23...e8a92fe10711fdb5e746a7918ad580991e7d1265,4,54,24,78,16,2013-01-21 21:39:53,2013-01-21 21:39:53
3f4437e714874ed10ce20fb32ca2dad3ca6f80ee...80d647adc31e3c8721dc578140494f916463f623,4,5,5,10,5,2013-01-11 19:17:21,2013-01-11 19:15:06
b449a9ae8c9ac17652c5ab006859dd29b62a5b48...32f59bfb1895630a90baf11c489526a95992b707,2,2,0,2,2,2013-01-07 14:52:42,2013-01-07 14:52:42
b449a9ae8c9ac17652c5ab006859dd29b62a5b48...ba1a430a8bc36687407717f3ec234c12e7b62cbc,1,38,1,39,1,2013-01-04 17:29:45,2013-01-04 17:29:45
b449a9ae8c9ac17652c5ab006859dd29b62a5b48...42e50b5ed10fcebab794d35cefa1eedcd79072b6,5,230,0,230,5,2013-01-03 22:35:59,2013-01-03 18:44:09
b449a9ae8c9ac17652c5ab006859dd29b62a5b48...9a919301c67a88a3dea1c9688d61a1717b333010,2,45,1,46,3,2013-01-03 22:16:37,2013-01-03 22:16:37
9a919301c67a88a3dea1c9688d61a1717b333010...0470f8fc9d618cd0f3e1d4cdb58a82c818d6de13,1,25,1,26,1,2013-01-03 22:24:10,2013-01-03 22:24:10
0470f8fc9d618cd0f3e1d4cdb58a82c818d6de13...1c5b3a41856e0fce5c0b9f6ae44466e790993ba9,1,27,1,28,1,2013-01-03 22:28:59,2013-01-03 22:28:59
824cf80f061ab31f45c94576f9e75533201a4578...c41281ad3af420bcfe4afae6acdbe95039290525,1,4,6,10,2,2013-06-19 12:02:11,2013-06-19 11:36:59
824cf80f061ab31f45c94576f9e75533201a4578...3425fee63773813a48f596637609efaa36428713,2,11,10,21,2,2013-06-17 13:42:33,2013-06-17 12:27:34
3425fee63773813a48f596637609efaa36428713...0525fb7ef3cb347e20db8582dcfc9c4c67bd9267,1,2,2,4,2,2013-06-17 13:42:34,2013-06-17 12:31:14
549931679a77b280eb1f36afeda8930eb31d70f7...ceab4e260637dc8374d0348ee9a078ab1c16e4ad,37,1946,30,1976,45,2013-09-16 23:23:50,2013-09-16 23:20:38
ceab4e260637dc8374d0348ee9a078ab1c16e4ad...4c7fdb4d3d7b24e4bca69a710d347cfeb05ac78f,3,133,1,134,3,2013-09-16 23:27:21,2013-09-16 23:27:10
4c7fdb4d3d7b24e4bca69a710d347cfeb05ac78f...0afe9996483387d282821958974320078923306c,1,10,13,23,9,2013-09-17 23:46:27,2013-09-17 23:46:27
0afe9996483387d282821958974320078923306c...3e0cf2a18057af11e7d8ba43bb43c4b399f89a27,1,2,26,28,6,2013-09-19 17:27:37,2013-09-19 17:27:37
3e0cf2a18057af11e7d8ba43bb43c4b399f89a27...d1228f1c8711edcb7f5fbb3a31c9018b57021ca6,2,79,0,79,4,2013-09-19 21:18:51,2013-09-19 21:18:51
d1228f1c8711edcb7f5fbb3a31c9018b57021ca6...9d42fcbef349c101d12410d62cda7ee9f23bdf8f,1,126,110,236,20,2013-09-19 21:27:44,2013-09-19 21:27:44
9d42fcbef349c101d12410d62cda7ee9f23bdf8f...25c47aaee2c36d78a11dcddf066b82abb53819b9,8,132,90,222,23,2013-09-20 21:31:51,2013-09-20 21:31:51
25c47aaee2c36d78a11dcddf066b82abb53819b9...a121e580113cb3206166b432ad8ebfd85c0c4d5f,3,82,78,160,61,2013-09-20 22:20:03,2013-09-20 22:20:03
a121e580113cb3206166b432ad8ebfd85c0c4d5f...ef03d040cf6cc81d71d340cf3915735724a77449,3,1,19,20,10,2013-09-20 22:38:15,2013-09-20 22:38:15
ef03d040cf6cc81d71d340cf3915735724a77449...0a0f0558a44d3eb176c32bff57b84f135d65db7a,4,132,152,284,62,2013-09-21 22:52:01,2013-09-20 22:51:22
0a0f0558a44d3eb176c32bff57b84f135d65db7a...f0c9d8ba1c7b9a5913248ea5228700da2eb76aaa,2,72,54,126,30,2013-09-22 04:19:33,2013-09-22 04:19:33
f0c9d8ba1c7b9a5913248ea5228700da2eb76aaa...77db6ff5c7b5a233b6dae24347b660f2752c1359,1,17,22,39,3,2013-09-22 05:01:53,2013-09-22 05:01:53
77db6ff5c7b5a233b6dae24347b660f2752c1359...b6f60a4d964d66b562092fdeb8f76e902bf05fa4,3,142,126,268,51,2013-09-22 05:17:18,2013-09-22 05:02:23
b6f60a4d964d66b562092fdeb8f76e902bf05fa4...49781a03f0ea2d33b465010c5533b6026cbc1141,3,5,5,10,4,2013-09-25 21:40:19,2013-09-25 21:40:19
49781a03f0ea2d33b465010c5533b6026cbc1141...f7db1b6f26837b44a5cb8956c23bbbdff28ba4f7,1,8,6,14,5,2013-09-25 21:46:59,2013-09-25 21:46:59
88c401bec80f795775b50f5b1f1421cf1e6385a3...37f66e82635c95d808c418f00d8e3c6646bd31f2,8,16,11,27,13,2013-06-12 22:21:21,2013-06-12 22:21:21
42b2bcf038b4e45df33a1078dd05a95759addd35...d80416384f67474cd98a8fafe2cc1e4f1f5fa38b,5,11,5,16,7,2013-05-03 01:43:45,2013-05-02 22:22:13
7b5bc8f498cd4f05f8580d848c03188dc5b06811...99d32707b963e6fea16817cafd5c3f579578a262,46,94,17,111,31,2013-05-11 13:42:25,2013-05-11 13:42:25
181bbf1498e3554cc66d1f00619ee4e9da695a95...3433a699541be59a84c93cbe208e02df8cb0c695,1,0,1,1,1,2012-04-01 22:32:21,2012-04-01 22:32:21
3433a699541be59a84c93cbe208e02df8cb0c695...37029314d404e3365d4ce1379c232869348e11ba,1,2,0,2,1,2012-04-01 22:32:47,2012-04-01 22:32:47
37029314d404e3365d4ce1379c232869348e11ba...f9abcbdf53dd929d21a4a01675906946cd91ec53,1,38,0,38,1,2012-04-01 22:33:01,2012-04-01 22:33:01
181bbf1498e3554cc66d1f00619ee4e9da695a95...bcbabe61819b90841756135b0457819e63f2235a,1,482,0,482,1,2012-03-30 19:05:33,2012-03-27 19:22:50
bcbabe61819b90841756135b0457819e63f2235a...6c106eecebab32cacc1b28944776ac15efc65a4d,1,251,0,251,1,2012-03-30 19:05:34,2012-03-29 03:09:12
6c106eecebab32cacc1b28944776ac15efc65a4d...2ef582b45745c68165c2e50ef39dcf1932103ee2,1,162,0,162,1,2012-03-30 19:05:35,2012-03-29 05:15:23
2ef582b45745c68165c2e50ef39dcf1932103ee2...b482c420e9d66fcd2a2b731a80a33cd85bbaf129,56,390,15,405,32,2012-03-30 19:05:36,2012-03-29 06:02:02
b482c420e9d66fcd2a2b731a80a33cd85bbaf129...2df029ed9b63187c35338be854cff0559a967fd5,3,56,6,62,7,2012-03-30 19:05:37,2012-03-30 13:30:32
2df029ed9b63187c35338be854cff0559a967fd5...23cb35fe8cfdf218ad740810a66469c369e8aa15,1,1,0,1,1,2012-03-30 19:05:38,2012-03-30 13:31:49
23cb35fe8cfdf218ad740810a66469c369e8aa15...9f75a9ce78987a1e3cb9a116560b3de9afb3695c,1,3,2,5,2,2012-03-30 19:05:39,2012-03-30 13:34:30
9f75a9ce78987a1e3cb9a116560b3de9afb3695c...9a39a36424904213103b01ecd7a54dbdf3b21103,2,208,0,208,2,2012-03-30 19:05:39,2012-03-30 14:04:52
9a39a36424904213103b01ecd7a54dbdf3b21103...6bb74993125e9e9c7c8be801c8f033974c3f6191,2,14,14,28,14,2012-03-30 19:05:40,2012-03-30 14:11:13
6bb74993125e9e9c7c8be801c8f033974c3f6191...dde61de6bc2a506933ca78364999c27f9b8649eb,1,70,4,74,4,2012-03-30 19:05:41,2012-03-30 14:17:07
dde61de6bc2a506933ca78364999c27f9b8649eb...00a48934f118c1b5da035dd576b92e5406fb8ca2,10,1372,1,1373,10,2012-03-30 19:05:42,2012-03-30 15:13:44
00a48934f118c1b5da035dd576b92e5406fb8ca2...7c3a4a7f07bc0d7fb552b75be6a71d43b8d3bb23,1,155,0,155,1,2012-03-30 19:26:39,2012-03-30 19:26:39
7c3a4a7f07bc0d7fb552b75be6a71d43b8d3bb23...1cb9b31e51edc85b876f52c4efae4951971d2b82,1,20,0,20,1,2012-03-30 20:05:54,2012-03-30 20:05:54
1cb9b31e51edc85b876f52c4efae4951971d2b82...8e82600e673104fd6d4f90a99608649a71e48941,1,105,104,209,30,2012-03-31 21:14:31,2012-03-31 20:21:25
8e82600e673104fd6d4f90a99608649a71e48941...9297b6e0a1e5846eb3d3fd978d3a2c00faaf2d8c,16,0,6178,6178,16,2012-03-31 21:15:18,2012-03-31 21:06:53
9297b6e0a1e5846eb3d3fd978d3a2c00faaf2d8c...270303ca7ab82d7600b77b3f65d2d25ee6299af3,7,107,168,275,80,2012-03-31 22:51:35,2012-03-31 22:51:35
270303ca7ab82d7600b77b3f65d2d25ee6299af3...fd29cd13b70b9a3a90ca605e2d1a633a08f1daf7,277,3,850,853,12,2012-03-31 23:10:01,2012-03-31 23:10:01
fd29cd13b70b9a3a90ca605e2d1a633a08f1daf7...20ec426ddeed994a0198756401b1138287813ad1,22,86,86,172,66,2012-04-01 02:47:59,2012-04-01 02:47:59
20ec426ddeed994a0198756401b1138287813ad1...b173121555d398997d1e446dca59f589f4c4e126,6,22,7,29,7,2012-04-01 03:12:29,2012-04-01 03:12:29
471bb8b120fab5969df5778aa5c8d1c22c30d876...daa22dee2823a4d7d68f9fa11f95eb7d2be1216a,1,11,8,19,6,2012-04-03 09:07:04,2012-04-03 09:07:04
daa22dee2823a4d7d68f9fa11f95eb7d2be1216a...a912ea3f9df94c1bc68a4072c14a3614c159a17c,1,0,30,30,1,2012-04-03 09:08:23,2012-04-03 09:08:23
a912ea3f9df94c1bc68a4072c14a3614c159a17c...13ed29664f0ff82264f97e6e5f51614ac8e6b602,1,2,0,2,1,2012-04-03 09:09:39,2012-04-03 09:09:39
dcfdb958e2033aa59beb624da4263ce031fbb21e...b78fb64d2f5c1b9e2e834e05e042271147c8d188,2,40,3,43,5,2012-04-11 10:40:21,2012-04-10 12:03:47
9273399bdb8f17ba6561de193fd1e518b9691a9a...09719c500ca798fea989867f50cf29d4dbed0c89,2,53,1,54,2,2012-04-01 12:33:32,2012-03-14 11:13:03
2d2260da41ddf22fd5c5f0c39ce16fad1548f29e...872ca1d302c571d47d9685179cbc6af84130f703,2,2,2,4,2,2013-04-15 18:00:42,2013-04-15 18:00:42
872ca1d302c571d47d9685179cbc6af84130f703...4a3f69b5b23efd123b3730ee999443b38cb11419,1,8,8,16,5,2013-04-15 18:20:14,2013-04-15 18:20:14
2d2260da41ddf22fd5c5f0c39ce16fad1548f29e...2e40a60e847d6c128af23e24ea7a8efebd2427da,5,80,13,93,10,2013-04-15 14:39:56,2013-04-11 15:29:05
a92dd316079250b27cc933b1fd00cd6af88b88d9...5df184241a6cfe88ac5ebcee9a3ad175abfca0cd,9,184,139,323,63,2013-04-22 14:50:50,2013-04-01 17:38:23
5df184241a6cfe88ac5ebcee9a3ad175abfca0cd...6b90e244de78640b751d0923c91c3868e12b8658,2,33,7,40,8,2013-04-22 14:50:50,2013-04-01 17:53:49
6b90e244de78640b751d0923c91c3868e12b8658...c4e91d4500bdd357fbf7378bc10648a482513fa6,3,21,4,25,5,2013-04-22 14:50:50,2013-04-03 18:57:30
c4e91d4500bdd357fbf7378bc10648a482513fa6...8842c75f172ed94be4ad11521d4083e97d740785,16,66,44,110,38,2013-04-22 14:50:50,2013-04-03 20:30:07
8842c75f172ed94be4ad11521d4083e97d740785...cf7850a4f70a1153ed640744750391d99000d546,3,8,12,20,10,2013-04-22 14:50:50,2013-04-03 21:09:54
cf7850a4f70a1153ed640744750391d99000d546...064236ca45067c9a7189e0d30790b8f3541b91ad,2,29,28,57,15,2013-04-22 14:50:51,2013-04-03 21:39:42
064236ca45067c9a7189e0d30790b8f3541b91ad...d9d423e4215ac3cc17def7b1a353d03031b811f8,1,21,0,21,1,2013-04-22 14:50:51,2013-04-03 21:53:32
d9d423e4215ac3cc17def7b1a353d03031b811f8...e16e268457ab4ab8a4edc8153deca2c8c22dc757,1,0,11,11,2,2013-04-22 14:50:51,2013-04-04 00:09:32
e16e268457ab4ab8a4edc8153deca2c8c22dc757...e183e375b83044d7852b8253553c4f782d73c140,1,20,1,21,3,2013-04-22 14:50:51,2013-04-05 20:38:14
e183e375b83044d7852b8253553c4f782d73c140...ee12272d170d6a9d60f13d6de6129f56bfb2fbf6,4,20,6,26,7,2013-04-22 14:50:51,2013-04-05 20:48:39
ee12272d170d6a9d60f13d6de6129f56bfb2fbf6...badd85a61354ef7b62c5f8e53d740738e5ef1e57,6,28,17,45,12,2013-04-22 14:50:51,2013-04-11 00:10:17
badd85a61354ef7b62c5f8e53d740738e5ef1e57...b12b72ea82776bbbd4296eeac1376055b0487edf,3,31,12,43,10,2013-04-22 14:50:51,2013-04-12 19:44:51
b12b72ea82776bbbd4296eeac1376055b0487edf...24c70804e87523df99f4740ed2829976ec1a9c1b,2,44,24,68,20,2013-04-22 14:50:51,2013-04-12 19:59:38
24c70804e87523df99f4740ed2829976ec1a9c1b...917f60c50bce09f789aeb927b45ba3bca5a23877,2,342,0,342,2,2013-04-22 14:50:51,2013-04-12 20:04:08
917f60c50bce09f789aeb927b45ba3bca5a23877...786062639f05e361da977f3f1f6286141fa12fca,15,128,184,312,74,2013-04-22 14:51:40,2013-04-15 07:05:44
786062639f05e361da977f3f1f6286141fa12fca...3f27127d15dfe69943d3c9ddf96d09a2300de3a9,10,63,57,120,34,2013-04-22 14:52:06,2013-04-16 18:51:02
3f27127d15dfe69943d3c9ddf96d09a2300de3a9...116bbdf0446cd5335b73e691c3352f368eac9b8f,1,8,8,16,9,2013-04-22 14:52:06,2013-04-16 19:08:21
116bbdf0446cd5335b73e691c3352f368eac9b8f...536078688549ac3d50483eecdec5a8169d921927,8,169,103,272,58,2013-04-22 14:52:07,2013-04-15 07:09:03
536078688549ac3d50483eecdec5a8169d921927...e976b56dda6ae3d7d81bd114b61750e97cc918d3,5,95,106,201,29,2013-04-22 14:52:07,2013-04-15 21:27:53
e976b56dda6ae3d7d81bd114b61750e97cc918d3...c628918625c7f779d2050a56998fb2b675f097fb,2,15,11,26,6,2013-04-22 14:52:07,2013-04-15 23:31:04
c628918625c7f779d2050a56998fb2b675f097fb...38eef6113d8523abfe6746bf727cee2651398ad3,6,37,56,93,26,2013-04-22 14:52:07,2013-04-16 21:19:27
38eef6113d8523abfe6746bf727cee2651398ad3...5d2d21e536b83ca2cbf8c026b3149fdf776c3f58,4,41,45,86,24,2013-04-22 14:52:07,2013-04-16 22:00:43
5d2d21e536b83ca2cbf8c026b3149fdf776c3f58...865e2dd4440596d7cd874556a694eea30336c69b,1,23,22,45,6,2013-04-22 14:52:07,2013-04-17 21:58:37
865e2dd4440596d7cd874556a694eea30336c69b...cf9709b64eb49d5a0ee1181b80c950e518fb45b0,1,4,1,5,2,2013-04-22 14:53:46,2013-04-22 14:53:46
cf9709b64eb49d5a0ee1181b80c950e518fb45b0...d87715926049390a2417a2476742114ec966686a,5,29,12,41,15,2013-04-22 15:04:52,2013-04-22 15:04:52
4a38143c93dc705bc40109e3f79d7fac722d44d7...4e4eab52f7c5062ea21ea278a38e48700e753883,10,38,37,75,38,2013-04-19 23:43:17,2013-04-19 23:19:53
0b061b5bfacda1a820d159d9e48521d3da4aa088...8cfd54f0d831922c58e62e5f69f364ede0cea89f,1,6,1,7,3,2013-03-26 19:27:15,2013-03-26 19:27:15
13640d1bb8376e3f07f66498a5b9bdde9ff3d7d6...2c7f7a66e9da70b90332a6c5d484ba8a77e42db4,3,98,34,132,18,2013-03-25 21:35:36,2013-03-25 21:35:36
2c7f7a66e9da70b90332a6c5d484ba8a77e42db4...35e0f3c6296869c63abbd5e880eb06a36e886bc5,1,5,2,7,2,2013-03-25 21:59:30,2013-03-25 21:59:30
35e0f3c6296869c63abbd5e880eb06a36e886bc5...f273b5d6a1ab2a18941e1bd5595e240315148362,1,7,0,7,1,2013-03-25 22:15:54,2013-03-25 22:15:54
13640d1bb8376e3f07f66498a5b9bdde9ff3d7d6...9733e80c2ae7517f44c658cd2914d99454470dd1,2,63,10,73,13,2013-03-25 21:03:16,2013-03-22 17:44:45
9733e80c2ae7517f44c658cd2914d99454470dd1...b8acb775e25c76f07dac8855ad0a88b37f7b2f17,19,335,0,335,16,2013-03-25 21:03:16,2013-03-07 21:15:40
b8acb775e25c76f07dac8855ad0a88b37f7b2f17...1098cfaecae823ede02881f995f18aee2908b89f,6,55,152,207,38,2013-03-25 21:03:16,2013-03-22 21:52:29
1098cfaecae823ede02881f995f18aee2908b89f...4a15ea869ca097dca0b45b1202429cc12cb94219,2,54,5,59,4,2013-03-25 21:03:16,2013-03-21 21:02:25
4a15ea869ca097dca0b45b1202429cc12cb94219...050ab9950d089c55e874b63e5ab9c8d0b948cf46,5,80,59,139,42,2013-03-25 21:13:53,2013-03-25 21:13:53
050ab9950d089c55e874b63e5ab9c8d0b948cf46...3658e81e3499f874dc9f323d4d9127df7e219e12,9,194,64,258,18,2013-03-25 21:20:07,2013-03-25 21:20:07
586f71ef2e6b1264c4dc7bc8270c2b7257675eb3...a0f777c87f1dca716ef71fbd378de86ab1bafeba,2,14,4,18,4,2013-01-23 22:44:34,2013-01-23 22:44:34
a0f777c87f1dca716ef71fbd378de86ab1bafeba...0d52cb4aea2e0af1b8a4a8557e26c9edf85c96db,1,18,0,18,1,2013-01-23 23:09:55,2013-01-23 23:09:55
47fc264203b2bae9e8a674505ac3502c3e9e71e7...1d645aabefa6ac9f3f617acb7e3b9025aafcd750,3,163,3,166,6,2013-01-22 15:01:43,2013-01-17 15:20:33
148c786cd6d5573bc76cca48bc9f4aa2cb165184...2a707d0e24e206666626ae858e5ba618ffef0547,1,3,6,9,3,2013-01-22 22:08:50,2013-01-22 22:08:50
52ee071b358345c0c8e3d8548dcda8de65065ffb...27fe6efe85ef11a3a765640065aa08156f130874,1,4,3,7,1,2013-01-04 18:48:08,2013-01-04 18:48:08
27fe6efe85ef11a3a765640065aa08156f130874...73b58c9159204c0a0ca6ff48295f8395d46e8a3d,1,6,1,7,1,2013-01-04 19:00:09,2013-01-04 19:00:09
73b58c9159204c0a0ca6ff48295f8395d46e8a3d...1d5d4186719df67cf8636b7c710983dec25e4e83,1,2,3,5,3,2013-01-04 19:02:01,2013-01-04 19:02:01
1d5d4186719df67cf8636b7c710983dec25e4e83...702c3bf70e0542d57636897eccb36b88a676a6fd,1,3,3,6,3,2013-01-04 19:03:02,2013-01-04 19:01:36
52ee071b358345c0c8e3d8548dcda8de65065ffb...9a0d59041204997005b9817a73ddc392538a0fe1,2,49,42,91,20,2013-01-04 17:43:34,2012-12-27 12:42:27
9a0d59041204997005b9817a73ddc392538a0fe1...bdb2f2422356d2f7d795a946eaf6dbe9d7eee64c,1,1,0,1,1,2013-01-04 18:54:45,2013-01-04 18:54:45
1c5b3a41856e0fce5c0b9f6ae44466e790993ba9...c999e1c3070faa0fa7ea8edd9616a10c0222fcf1,2,2,0,2,2,2013-01-03 23:42:04,2013-01-03 23:42:04
705871364bce85f7ef46f7c3f4e680a4591aa304...2ad7a4dc92a3e604d4ef52899c88c19b4295afa6,2,3,5,8,5,2013-06-17 16:29:05,2013-06-17 16:25:30
41dd999d12946ca2085ad315e9c5e8e57cc4e4f6...de8fe729efd350ae5cb1ef25ffb08f92c6f706b9,1,1,1,2,1,2013-09-29 17:46:41,2013-09-29 17:46:41
811c761fe14fbf14591d215b36594a332e54e3d3...b641c00eebb3c60e8719c0dfc55dde91ca30a5d2,1,1,1,2,1,2013-05-03 15:35:50,2013-05-03 15:35:50
62221033a8c56d3df420cbb1b123036e3b16dad4...000e68961cb44b04435a733e151f8b1357547bd1,1,3,1,4,1,2013-05-12 13:35:02,2013-05-12 13:35:02
34a064d962d1b09a27598931bada02a12429434b...5afe95d206b48848f2bde1006c8396a1791692e8,1,2,2,4,2,2012-04-02 18:45:04,2012-04-02 18:45:04
a12c291b54288fd71b09282a0722d96776ee43bf...bbb3723657cb595754099036ee080849b218f285,1,1,2,3,2,2012-04-03 23:31:29,2012-04-03 23:30:18
bbb3723657cb595754099036ee080849b218f285...31e80290a1a08a24780a0cbedd3a400fccd80a8b,1,4,3,7,3,2012-04-04 14:26:08,2012-04-04 14:21:52
0a20eee9536e8db0ab8d91f426f971f7151aaefa...1a2b87257dd7aa462f246ff8eb66232e59387d68,4,5,5,10,5,2012-04-11 12:27:40,2012-04-11 12:27:40
1a2b87257dd7aa462f246ff8eb66232e59387d68...d4d648b042b726a03611063212069adb061e863e,1,4,9,13,6,2012-04-11 13:30:56,2012-04-11 13:25:34
d4d648b042b726a03611063212069adb061e863e...4376f7f6f4a46ecbcc0136948b68782956cd3c45,3,107,150,257,72,2012-04-11 17:16:10,2012-03-06 07:12:35
4376f7f6f4a46ecbcc0136948b68782956cd3c45...84d250bfeb244d1fe82efafa296141c807135fb0,2,60,76,136,43,2012-04-11 17:16:10,2012-03-06 09:23:02
84d250bfeb244d1fe82efafa296141c807135fb0...2b386acdb310394b7a227b27d6eff330e1f935ec,1,127,134,261,45,2012-04-11 17:16:10,2012-03-06 09:47:18
2b386acdb310394b7a227b27d6eff330e1f935ec...25530fca3bde2ee9a2d06098da554eca2536b2b9,1,120,165,285,83,2012-04-11 17:16:10,2012-03-06 10:26:10
25530fca3bde2ee9a2d06098da554eca2536b2b9...56b7df108c6b24fe786325944309a52e79087a52,1,29,31,60,14,2012-04-11 17:16:10,2012-03-07 06:01:20
56b7df108c6b24fe786325944309a52e79087a52...bd6585a7f55bb630b69cf2928032616f4afad45b,1,23,3,26,4,2012-04-11 17:16:10,2012-03-16 14:15:21
bd6585a7f55bb630b69cf2928032616f4afad45b...fc1cc2051e057acd7749fad5a785ee6eab202f1a,1,1,1,2,1,2012-04-11 17:16:10,2012-03-26 09:36:12
fc1cc2051e057acd7749fad5a785ee6eab202f1a...5eb8affb38f66ef34eab8c60260e4519697eca89,1,39,44,83,19,2012-04-11 17:16:10,2012-03-30 16:37:19
5eb8affb38f66ef34eab8c60260e4519697eca89...a62053a05061f9b107aceb5bda03e89990b038a7,1,66,80,146,36,2012-04-11 17:16:10,2012-03-31 22:45:02
a62053a05061f9b107aceb5bda03e89990b038a7...e1f6f94a92408920b73b2ab6769ee758cbb87d13,1,0,1,1,1,2012-04-11 17:17:21,2012-04-11 17:17:21
e1f6f94a92408920b73b2ab6769ee758cbb87d13...64b402f8567d1a6c2ac206863d0f7e0fefb96ec4,1,0,82,82,1,2012-04-11 17:19:12,2012-04-11 17:19:12
64b402f8567d1a6c2ac206863d0f7e0fefb96ec4...1de77cd31432a1bdff060181c6d9ec25a412a0c2,1,3,0,3,3,2012-04-11 19:10:14,2012-04-11 19:10:14
2ec83ff09de3448b5439b2bc63e90398992ae8ca...17bd6de3fb1bd937c73588f9d9e75c9090e44eb9,1,1,0,1,1,2012-04-04 11:59:58,2012-04-04 11:59:58
2ec83ff09de3448b5439b2bc63e90398992ae8ca...8e8b6b01f592b9e366203d70802e44d1a6a08e5f,7,15,8,23,11,2012-04-04 11:13:43,2012-04-04 11:13:43
09719c500ca798fea989867f50cf29d4dbed0c89...3f46f313cbfcf57e5cbf3d7dc55b747568a21bef,8,100,8,108,11,2012-04-10 19:38:49,2012-04-06 12:34:26
3f46f313cbfcf57e5cbf3d7dc55b747568a21bef...79fd42301e80c1f787ee9e9b83dc5159ae12854a,2,27,2,29,6,2012-04-10 19:39:01,2012-04-06 13:23:18
79fd42301e80c1f787ee9e9b83dc5159ae12854a...731df57080704183cad128c17fd065e5e25fa886,7,532,6,538,9,2012-04-10 19:39:03,2012-04-04 13:57:19
731df57080704183cad128c17fd065e5e25fa886...555aa453baefec98dbd026592b68214048bedac3,4,57,17,74,17,2012-04-10 19:39:05,2012-04-09 00:28:31
555aa453baefec98dbd026592b68214048bedac3...4615f0f71ba849adef08f7a677842af3e0ee3d53,4,111,0,111,4,2012-04-10 19:39:06,2012-04-09 01:22:14
77849ebf1e39126bcb9f1245423749d45d226022...67ba7d2031f1eef63d66db6ce3ecaceddb06a4f3,4,49,23,72,13,2013-04-15 21:22:32,2013-04-15 20:53:57
67ba7d2031f1eef63d66db6ce3ecaceddb06a4f3...404eadb089f5757842d2703ab1de849dd1f79a24,1,4,0,4,1,2013-04-15 22:11:59,2013-04-15 22:11:59
d08dd728a80eb993d80ec30d8c9f9025664c8990...f9774eea3a37e3a2a44d3c7e9dbc895280c3d90a,1,42,0,42,5,2013-04-22 15:30:28,2013-04-22 15:22:31
f9774eea3a37e3a2a44d3c7e9dbc895280c3d90a...a14163a79d644f0fd2856b083f355f2df19f6bdd,3,15,8,23,11,2013-04-22 15:30:49,2013-04-22 15:30:49
a14163a79d644f0fd2856b083f355f2df19f6bdd...920cbc9846c526958f6b4a7f914bdde2da1d34ec,1,1,1,2,1,2013-04-22 15:31:47,2013-04-22 15:31:47
920cbc9846c526958f6b4a7f914bdde2da1d34ec...a2378ae4fee55c95eb9a1f6b44f5a837d39fa724,4,9,3,12,4,2013-04-23 18:42:29,2013-04-23 18:42:29
d08dd728a80eb993d80ec30d8c9f9025664c8990...05b179648aca91799274afbd03d40f31783547ac,3,12,12,24,11,2013-04-22 15:12:11,2013-04-21 17:26:35
cf97799ed31ebb8cc4d44f7fd6ff86a5bc1b2e8b...8f24e65ff6f7573bc6778f5bbea7119fc9b7b626,1,4,0,4,2,2013-04-20 14:20:33,2013-04-20 14:20:21
8cfd54f0d831922c58e62e5f69f364ede0cea89f...54a1a042910968441c668f3302f724e733354746,2,71,4,75,4,2013-03-29 17:07:00,2013-03-29 16:26:12
f17951d6ea4ba18c68716a89d7b7464e40ec98f7...d828f118b334a9396ca129f2c733bae8ce6faa8d,1,3,3,6,2,2013-03-26 01:16:02,2013-03-26 01:16:02
f17951d6ea4ba18c68716a89d7b7464e40ec98f7...0c289dd7c6831f4f402f9581b46d0c920053abf9,5,104,36,140,31,2013-03-25 23:40:16,2013-03-25 23:40:16
0c289dd7c6831f4f402f9581b46d0c920053abf9...37ee70fab4e6dcf35afc08c0edbe9f101d4abf2d,7,137,36,173,29,2013-03-26 05:19:39,2013-03-26 05:19:39
37ee70fab4e6dcf35afc08c0edbe9f101d4abf2d...ccfa68055cbd7cdc0baa99af8ce5c0bbcca19254,8,209,28,237,21,2013-03-26 06:58:40,2013-03-26 06:58:40
0d52cb4aea2e0af1b8a4a8557e26c9edf85c96db...c27e211219574324ef9eaf7980b04e5e08189169,4,36,9,45,11,2013-01-23 23:38:00,2013-01-23 23:38:00
3fbd7485d8a100f55b02132096d3ff66d390999a...2ff4469afc1e3e142d68c46e3c15e889fe32582a,1,3,0,3,2,2013-01-24 19:04:35,2013-01-24 19:04:35
2ff4469afc1e3e142d68c46e3c15e889fe32582a...5425097f0368c43e72210c33b844cf7350843c37,1,8,3,11,3,2013-01-25 02:55:39,2013-01-25 02:53:08
2a707d0e24e206666626ae858e5ba618ffef0547...cb35094be3c1dbe369454118e801e703d70c4a33,3,14,4,18,6,2013-01-22 23:49:51,2013-01-22 23:49:51
cb35094be3c1dbe369454118e801e703d70c4a33...5c7b77c4f8707571530fc2b2c3b7154965a27344,2,11,3,14,4,2013-01-23 00:01:03,2013-01-23 00:01:03
2a707d0e24e206666626ae858e5ba618ffef0547...cce548e3e0c14b5d46c8d886c9954f4b66533ecd,2,19,3,22,6,2013-01-22 23:28:25,2013-01-22 23:28:25
c18a5ec58cd93be0c06e2d94b2f87efca8896969...3a4a961da581b6a02ee7d20c037c746088fa39c5,1,1,1,2,1,2013-01-04 19:25:57,2013-01-04 19:25:10
3a4a961da581b6a02ee7d20c037c746088fa39c5...6040616214c69a53d2155c2378b31a0d65e37567,1,1,1,2,1,2013-01-04 19:28:33,2013-01-04 19:28:33
60d61926d3d0968518ab2627c281801c61b67cb1...394711ff750d2ada6fca10e1ae71ce174cf9da8b,1,10,0,10,1,2013-01-04 00:14:23,2013-01-04 00:14:23
394711ff750d2ada6fca10e1ae71ce174cf9da8b...f783f76efb484e7d169e25721ff101b1d46e05a5,1,0,3,3,1,2013-01-04 00:15:52,2013-01-04 00:15:52
8b2fa181b2741661253c1d58cfa1077ade8bea24...852ded96982ae70acb63c3940fae08ea29e40fee,1,9,4,13,1,2013-06-20 18:37:58,2013-06-20 18:37:58
852ded96982ae70acb63c3940fae08ea29e40fee...cf300bb9e50c65e4140f7e204243b34f2898fa95,2,295,1,296,2,2013-06-20 18:39:31,2013-06-20 18:39:31
cf300bb9e50c65e4140f7e204243b34f2898fa95...22b6b82f2c0d95ce7a433394a6c0574a5714cf4c,11,126,16,142,21,2013-06-20 19:16:06,2013-06-20 19:16:06
22b6b82f2c0d95ce7a433394a6c0574a5714cf4c...f18f772a8ec0cdff9315216886383dadce1379b5,1,145,2,147,3,2013-06-20 21:27:14,2013-06-20 21:27:14
f18f772a8ec0cdff9315216886383dadce1379b5...9280855787fcac1e333b6e7e66d7ba0cd2120a0c,1,11,6,17,5,2013-06-20 22:10:42,2013-06-20 22:10:42
9280855787fcac1e333b6e7e66d7ba0cd2120a0c...94ef2a353cdf4c29323c9935026d8435e8f098bd,1,20,0,20,1,2013-06-20 22:15:10,2013-06-20 22:15:10
bd2319c839fcc9fa85cd726b424bac345b4da1a4...09c2f91c150a4862c9189d9e08d0dc111d4d706c,1,5,1,6,2,2013-06-17 16:48:02,2013-06-17 16:48:02
fc1f7d4f15ecc3f42dbde7fc0a30933cb89152bc...370d1d166e3a77a5f21e3f7a73870fbb7def2249,1,1,1,2,1,2013-10-09 21:41:44,2013-10-09 21:41:44
370d1d166e3a77a5f21e3f7a73870fbb7def2249...cb45dafaf85053c6ff4f3e8ac86f8b9cbc174033,1,4,1,5,3,2013-10-09 23:07:17,2013-10-09 23:07:17
cb45dafaf85053c6ff4f3e8ac86f8b9cbc174033...2ccc84d2efaf8adf4886cfc42d8bd16e2ba98188,1,11,10,21,5,2013-10-09 23:07:36,2013-10-09 23:07:36
2ccc84d2efaf8adf4886cfc42d8bd16e2ba98188...43a07b860b9c172081e3c9dee18aeead9091f2cf,1,11,13,24,6,2013-10-09 23:16:43,2013-10-09 23:16:43
43a07b860b9c172081e3c9dee18aeead9091f2cf...0a23d2058dc61a6d11e9da6aadf431d69e738601,1,5,0,5,1,2013-10-09 23:18:32,2013-10-09 23:18:32
0a23d2058dc61a6d11e9da6aadf431d69e738601...d2e7532f620acd467ebeef0b3c4318420f445a13,1,31,8,39,8,2013-10-10 20:56:28,2013-10-10 20:56:28
d2e7532f620acd467ebeef0b3c4318420f445a13...ebd67243d5152e2c38811ba42fcdf99eecd8ef60,1,14,12,26,4,2013-10-10 20:56:45,2013-10-10 20:56:45
ebd67243d5152e2c38811ba42fcdf99eecd8ef60...c1ca2b67e1747ff4d2ba5a10ee300497d1d28dbe,3,10,6,16,10,2013-10-10 21:30:05,2013-10-10 21:30:05
c1ca2b67e1747ff4d2ba5a10ee300497d1d28dbe...607fe733700109ac171661975b60735c481ed3fc,1,5,1,6,4,2013-10-10 21:30:31,2013-10-10 21:30:31
607fe733700109ac171661975b60735c481ed3fc...4fd847bb94b5bf8c1e4dce4e0c4798068977f916,1,5,5,10,1,2013-10-10 21:38:15,2013-10-10 21:38:15
4fd847bb94b5bf8c1e4dce4e0c4798068977f916...364d800b018325914ac01cb5f1b06beb1cab528f,2,12,4,16,5,2013-10-10 21:53:07,2013-10-10 21:53:07
364d800b018325914ac01cb5f1b06beb1cab528f...ba02079f2d97411c3ac6f1a7c29874b0aec68b08,1,7,8,15,5,2013-10-28 12:01:33,2013-10-28 12:01:33
ba02079f2d97411c3ac6f1a7c29874b0aec68b08...7f6db0ad121a3fdfdb9249c71b6650f771f4f6b3,1,1,1,2,1,2013-10-28 12:19:30,2013-10-28 12:19:30
7f6db0ad121a3fdfdb9249c71b6650f771f4f6b3...a7d28f40a2a01382b76c55ca0a0672c177adaf69,2,3,3,6,3,2013-10-28 12:22:37,2013-10-28 12:22:37
b641c00eebb3c60e8719c0dfc55dde91ca30a5d2...4def7035cac133607256fd91352ce54ac4548a7c,8,314,0,314,11,2013-05-11 09:20:37,2013-03-02 18:31:03
4def7035cac133607256fd91352ce54ac4548a7c...69a3c766b6c6b9bbe2859bf8572c12b93a9d37c9,1,7,0,7,2,2013-05-11 09:20:37,2013-05-04 13:03:32
69a3c766b6c6b9bbe2859bf8572c12b93a9d37c9...51fc5e895d7655611431a0bdb76b9fd8499a9e1a,2,23,1,24,2,2013-05-11 09:20:37,2013-05-04 13:16:55
51fc5e895d7655611431a0bdb76b9fd8499a9e1a...fb592a96ebac46f0e176fbbe849cf9b52b9f4727,1,0,11,11,1,2013-05-11 09:20:37,2013-05-04 13:54:57
fb592a96ebac46f0e176fbbe849cf9b52b9f4727...932af0e9eb35e37b2cf993c0806d6ea46476cf39,1,46,0,46,2,2013-05-11 09:20:37,2013-05-04 13:57:44
932af0e9eb35e37b2cf993c0806d6ea46476cf39...95727245fd4f08aa77d1077901976ab3bd7472e1,1,21,3,24,2,2013-05-11 09:20:37,2013-05-04 14:03:17
95727245fd4f08aa77d1077901976ab3bd7472e1...2b562c3a1edf0f521bdb7adf23e524d5a8389b15,21,55,266,321,53,2013-05-11 09:20:38,2013-05-04 14:32:58
2b562c3a1edf0f521bdb7adf23e524d5a8389b15...9bd89d962265b399b537e41058d40a6aeab00e64,2,49,40,89,9,2013-05-11 09:20:38,2013-05-04 14:49:39
9bd89d962265b399b537e41058d40a6aeab00e64...c58cac12c24fbb127cf1928bec20decb007a75e8,5,62,12,74,13,2013-05-11 09:20:38,2013-05-04 16:06:14
b641c00eebb3c60e8719c0dfc55dde91ca30a5d2...dfec726bbae0e699b78db8f1b63372134c8467a6,1,3,0,3,1,2013-05-03 21:30:54,2013-05-03 21:30:54
000e68961cb44b04435a733e151f8b1357547bd1...3bbc87d697b24725beb8dcd41fa83ca604d3a9e2,1,4,0,4,2,2013-05-14 21:40:20,2013-05-14 21:09:26
000e68961cb44b04435a733e151f8b1357547bd1...fbcab44b208ae726450289794ecf8e69af3f7e58,1,5,2,7,3,2013-05-14 20:03:09,2013-05-14 20:03:09
000e68961cb44b04435a733e151f8b1357547bd1...b4d33e46c4b00d36783f5b75c1316b7a74c4da20,1,2,0,2,1,2013-05-14 19:54:26,2013-05-14 19:54:26
31e80290a1a08a24780a0cbedd3a400fccd80a8b...eb6db16d8267b0e62a50627dd7b6cfae472d8610,1,1,9,10,3,2012-04-20 18:12:48,2012-04-20 18:00:59
31e80290a1a08a24780a0cbedd3a400fccd80a8b...b333fbf968418bcf45d4de174d86a79b3c70b509,1,1,1,2,1,2012-04-20 16:51:10,2012-04-20 16:51:10
1de77cd31432a1bdff060181c6d9ec25a412a0c2...6a8bcfa48e7c4b2c5cbcf07e262d372a35bba7f8,1,32,14,46,11,2012-04-12 18:47:46,2012-04-12 18:47:46
6a8bcfa48e7c4b2c5cbcf07e262d372a35bba7f8...a15156930bbfacfaad6e4f036d3fe89a12170406,1,1,0,1,1,2012-04-12 18:54:55,2012-04-12 18:52:26
1de77cd31432a1bdff060181c6d9ec25a412a0c2...081d229106faae3c37c08940fd510a3511bfbd59,1,9,3,12,4,2012-04-12 18:25:24,2012-03-03 03:46:21
081d229106faae3c37c08940fd510a3511bfbd59...06b9d915901b3dd9dc85016bb000e631eb1da1d7,3,57,41,98,8,2012-04-12 18:25:24,2012-02-28 01:19:57
06b9d915901b3dd9dc85016bb000e631eb1da1d7...de7ab85dc614ba702a89f3f0c761c68ee1e00fda,3,207,9,216,8,2012-04-12 18:25:24,2012-03-03 02:31:51
de7ab85dc614ba702a89f3f0c761c68ee1e00fda...2c4ef1dd0da560e91b6440aa430537b98e8345dc,1,39,2,41,7,2012-04-12 18:25:25,2012-03-03 15:43:24
2c4ef1dd0da560e91b6440aa430537b98e8345dc...5cf7bccd2b72582186963f8758e883e0a978041a,1,16,0,16,1,2012-04-12 18:25:25,2012-03-03 16:25:05
5cf7bccd2b72582186963f8758e883e0a978041a...f9e4bfa39ba4042c107ee93a22fb0e50ef982d5b,1,36,37,73,17,2012-04-12 18:25:25,2012-03-04 02:00:35
f9e4bfa39ba4042c107ee93a22fb0e50ef982d5b...bf787bd87c04e5213fc277c583970c52dea6781f,4,37,3,40,4,2012-04-12 18:25:25,2012-04-08 16:56:50
bf787bd87c04e5213fc277c583970c52dea6781f...eb8117b841f22063ba8fe27653cac79957c548ea,1,104,100,204,68,2012-04-12 18:27:17,2012-04-12 18:25:07
1de77cd31432a1bdff060181c6d9ec25a412a0c2...7784bcbbee972d1f00ea88655a5592fb44ca767d,10,576,343,919,55,2012-04-11 19:11:35,2012-04-11 18:52:59
fbb6c0c84c65d5e36ad552040897cfbde83b59b2...4ba64794aee983483eef659623a765d61311ded1,5,42,58,100,21,2013-08-09 17:52:35,2013-08-09 17:52:35
4ba64794aee983483eef659623a765d61311ded1...b7b77def931be50777884ddd35a8689df0ecbebd,1,2,1,3,1,2013-08-09 18:20:49,2013-08-09 18:20:49
8f24e65ff6f7573bc6778f5bbea7119fc9b7b626...6b24688758b721afece65702475f76d225d096be,1,11,0,11,1,2013-04-21 07:04:01,2013-04-21 06:59:04
8f24e65ff6f7573bc6778f5bbea7119fc9b7b626...e5a27f039ee3ae1291fd5084707c3f9c168f10ba,2,19,1,20,3,2013-04-20 15:54:12,2013-04-20 13:25:39
e5a27f039ee3ae1291fd5084707c3f9c168f10ba...4330ab26b53c0e1bf8cbb5e65704f65e3d116eba,14,336,205,541,101,2013-04-20 15:54:13,2013-04-20 02:43:28
4330ab26b53c0e1bf8cbb5e65704f65e3d116eba...bc6374eac485ab9ad9cfd7165b6d071c3dcb673a,6,134,31,165,18,2013-04-20 17:45:40,2013-04-20 16:49:11
bc6374eac485ab9ad9cfd7165b6d071c3dcb673a...1be680c4d0909ee5160292d7b56c4522c4bc309c,6,40,49,89,30,2013-04-20 17:45:40,2013-04-20 17:13:47
1d5220dcd16963ba592f135bd8a68e310500f11b...0e60b637eadf76c32927dcb0f309c719542e2c52,1,2,0,2,1,2013-03-29 23:36:11,2013-03-29 23:36:11
5425097f0368c43e72210c33b844cf7350843c37...c253056d2429ea0a6201be60921dbac69dbcc98a,3,84,0,84,3,2013-01-25 04:24:21,2013-01-24 19:44:17
6040616214c69a53d2155c2378b31a0d65e37567...e9e20c8474b4f7ecdb1076c2f2d9c06f21e6be5b,2,21,7,28,6,2013-01-04 23:23:47,2012-12-19 22:52:12
e9e20c8474b4f7ecdb1076c2f2d9c06f21e6be5b...6ac724afbe0b1244f84b9acc5dc8be0646be5ce3,1,3,1,4,2,2013-01-04 23:23:47,2012-12-18 23:12:06
6ac724afbe0b1244f84b9acc5dc8be0646be5ce3...6fee906c982d001062968b4caee4f289f0c86b59,1,3,0,3,2,2013-01-04 23:23:47,2012-12-18 23:13:11
6fee906c982d001062968b4caee4f289f0c86b59...d0951175d49ffff929b4ed1e08d45509360c3f13,1,20,0,20,1,2013-01-04 23:23:47,2012-12-06 15:12:21
d0951175d49ffff929b4ed1e08d45509360c3f13...c5df10f4aa0debf113da3430849876a3a28a25ea,1,27,0,27,1,2013-01-04 23:23:47,2012-11-30 15:59:03
c5df10f4aa0debf113da3430849876a3a28a25ea...bfe7d7de226e91c7ed99b68fc447aa0bcd5182ab,1,30,39,69,13,2013-01-04 23:47:42,2012-11-27 01:24:02
bfe7d7de226e91c7ed99b68fc447aa0bcd5182ab...cf208031705388a2d1907fb9ec409ff22179f380,9,971,551,1522,110,2013-01-04 23:47:42,2012-12-06 21:36:17
cf208031705388a2d1907fb9ec409ff22179f380...7e5c8a5b41ca660def7de23fd32b942878a6ee24,8,823,539,1362,221,2013-01-04 23:47:42,2012-12-10 23:31:43
7e5c8a5b41ca660def7de23fd32b942878a6ee24...5cf9875a4f6ee6fa26f5617aca8433dd49c72751,5,187,62,249,45,2013-01-04 23:47:42,2012-12-18 23:19:24
5cf9875a4f6ee6fa26f5617aca8433dd49c72751...8fe713ccf7bf8c6330fdda7f0c733e7f3ab29d3f,2,4,4,8,4,2013-01-04 23:47:42,2012-12-19 23:06:14
8fe713ccf7bf8c6330fdda7f0c733e7f3ab29d3f...a6a82e1a59065f6d5eaf4748708c92326048a99f,3,118,113,231,80,2013-01-04 23:47:42,2012-12-19 23:06:40
a6a82e1a59065f6d5eaf4748708c92326048a99f...6f58332f3ab04f910103b945348b6a0a314c1793,1,3,3,6,2,2013-01-04 23:47:43,2012-12-21 00:15:02
6f58332f3ab04f910103b945348b6a0a314c1793...a9a730075eee70444db4ab4bbb928c29a812bbbf,2,39,6,45,8,2013-01-04 23:47:43,2012-12-21 00:16:22
a9a730075eee70444db4ab4bbb928c29a812bbbf...546d65a8dae8a7af7288163a580c08c827ebda1d,4,11,23,34,9,2013-01-04 23:47:43,2013-01-03 01:01:34
546d65a8dae8a7af7288163a580c08c827ebda1d...16a666d3d421fcbffabc861646b02e22c63d9ad9,1,25,20,45,11,2013-01-04 23:47:43,2013-01-03 01:05:54
16a666d3d421fcbffabc861646b02e22c63d9ad9...e0548c0ea4fba4a66e73ba326b463fd754cc6e52,1,109,24,133,17,2013-01-04 23:47:43,2013-01-03 01:09:07
e0548c0ea4fba4a66e73ba326b463fd754cc6e52...c50c58decd92270319bcbdb59e1038e0e2f8f241,1,171,4,175,6,2013-01-04 23:47:43,2013-01-03 01:10:56
c50c58decd92270319bcbdb59e1038e0e2f8f241...b3fb9237c215e9a0e2e042afd9252d541ce40541,1,1,1,2,1,2013-01-04 23:47:43,2013-01-03 01:12:45
b3fb9237c215e9a0e2e042afd9252d541ce40541...77cffa31db07187c2fa65457ace1b6cb2547dc5b,3,304,302,606,31,2013-01-04 23:47:43,2013-01-03 01:14:00
77cffa31db07187c2fa65457ace1b6cb2547dc5b...2850252af7e9baf070a495f60781d2424e6a0b32,1,1,1,2,1,2013-01-04 23:47:44,2013-01-03 17:11:52
2850252af7e9baf070a495f60781d2424e6a0b32...0d70f650518163af2b4d46028b1ce9cef71fbc99,2,199,0,199,4,2013-01-04 23:47:44,2013-01-03 18:51:18
0d70f650518163af2b4d46028b1ce9cef71fbc99...dde7602ae633a557acdb74c8027335bb2584aa77,1,1,2,3,2,2013-01-04 23:47:44,2013-01-03 21:22:34
dde7602ae633a557acdb74c8027335bb2584aa77...d8889d2b64a0a28f33a189216e1d63669b9be206,2,74,14,88,8,2013-01-04 23:47:44,2013-01-03 22:08:53
d8889d2b64a0a28f33a189216e1d63669b9be206...1b88faf7aea53a72a4906f48ec30f16f1c157503,1,4,1,5,1,2013-01-04 23:47:44,2013-01-03 22:21:25
1b88faf7aea53a72a4906f48ec30f16f1c157503...7fc00435829d24021a477c6d6413f3d7b3e37e27,3,132,0,132,3,2013-01-04 23:47:44,2013-01-03 23:48:52
7fc00435829d24021a477c6d6413f3d7b3e37e27...817d625161f212b86c22733f7dde2f2155a65ac5,2,66,28,94,12,2013-01-04 23:47:44,2013-01-04 00:56:27
f2d110f168e9b4b731a857d504a193de6d0974d8...dacce80b128501e9821f254c2edb1e93906eac0b,1,30,0,30,1,2013-06-21 00:08:58,2013-06-21 00:05:38
dacce80b128501e9821f254c2edb1e93906eac0b...36fd9e30651cf0d6b0ef58452ba2974a3544d4d1,5,128,1,129,9,2013-06-21 18:20:54,2013-06-21 18:20:54
09c2f91c150a4862c9189d9e08d0dc111d4d706c...1ee2ef87ec4c2c63b7c89849eb9daad9e46e6fe7,4,256,67,323,26,2013-06-17 17:03:14,2013-05-21 16:05:21
1ee2ef87ec4c2c63b7c89849eb9daad9e46e6fe7...dfe8c8df3707b2773e376633c5908dc612e59d6a,3,371,21,392,26,2013-06-17 17:03:15,2013-05-23 04:19:40
dfe8c8df3707b2773e376633c5908dc612e59d6a...e3b4a47c1ebd55931cb25bf5c2af821df9b0bffa,3,40,0,40,3,2013-06-17 17:03:15,2013-05-31 21:30:09
e3b4a47c1ebd55931cb25bf5c2af821df9b0bffa...c9b18018fd537566e76308fd2fec67e483b1d201,1,6,9,15,3,2013-06-17 17:03:48,2013-06-13 22:26:56
c9b18018fd537566e76308fd2fec67e483b1d201...4e28e638ea016f5a5b35ba952d9f06a1108d6b5e,1,89,92,181,14,2013-06-17 17:03:48,2013-06-13 22:27:30
4e28e638ea016f5a5b35ba952d9f06a1108d6b5e...3a68d7f00289afbaa415c3b34d5eeca183dcfb52,1,21,11,32,4,2013-06-17 17:03:49,2013-06-13 22:30:26
3a68d7f00289afbaa415c3b34d5eeca183dcfb52...a3e8dbb40b87f66e1f5f4d1730f9989805822db0,1,2,1,3,2,2013-06-17 17:03:49,2013-06-13 22:32:09
a3e8dbb40b87f66e1f5f4d1730f9989805822db0...351888cf3dc3c3525faccb010adcf5c130ac5b16,5,193,114,307,70,2013-06-17 17:03:49,2013-06-13 22:37:06
351888cf3dc3c3525faccb010adcf5c130ac5b16...1540b19990fa5c566d607785c7b3651756e706ff,2,64,0,64,2,2013-06-17 17:03:49,2013-05-31 23:12:49
1540b19990fa5c566d607785c7b3651756e706ff...6ea999bb88e1c5d0be17d823c23728d11adfed47,2,3,3,6,2,2013-06-17 17:03:49,2013-06-13 22:52:12
6ea999bb88e1c5d0be17d823c23728d11adfed47...eefef642c8c0d9d527633294acdf9d7a0c9e94c0,1,25,0,25,4,2013-06-17 17:03:49,2013-06-13 23:09:53
eefef642c8c0d9d527633294acdf9d7a0c9e94c0...fb03a223189f418d0767d7d04ff7509dfcfe8394,1,14,3,17,5,2013-06-17 17:03:49,2013-06-13 23:31:11
fb03a223189f418d0767d7d04ff7509dfcfe8394...a1683f28ce2709e615490939e4e244046654d0e5,6,237,80,317,72,2013-06-17 17:03:49,2013-06-14 23:18:04
a1683f28ce2709e615490939e4e244046654d0e5...f3b5bc835ae4345a7a03834ffaf54a0aca92387d,1,57,0,57,4,2013-06-17 17:03:50,2013-06-17 04:51:43
f3b5bc835ae4345a7a03834ffaf54a0aca92387d...de0555a347b4be48f80d0b3bf26ddd81f5ef38aa,2,11,6,17,6,2013-06-17 17:03:50,2013-06-17 16:55:29
de0555a347b4be48f80d0b3bf26ddd81f5ef38aa...f4183347607c85d3fbe02e8591d9393a011ecdf2,2,36,24,60,18,2013-06-17 17:23:53,2013-06-17 17:23:53
42c8f8f807fe986534e0cbabbfabc32cb4eb9077...7dcb1c452582d2a83ca1ad8858cb95ab20d6e13d,2,19,26,45,11,2013-10-28 18:21:23,2013-10-28 18:21:23
dfec726bbae0e699b78db8f1b63372134c8467a6...ce72e399d26a7b246f6425657b0c8a55d40159c9,1,1,0,1,1,2013-05-05 14:47:07,2013-05-05 14:45:38
ce72e399d26a7b246f6425657b0c8a55d40159c9...467cbec73d1c34c3f6c1e7ea66e1276e5e44299b,2,3,3,6,2,2013-05-05 14:48:34,2013-05-05 14:48:34
dfec726bbae0e699b78db8f1b63372134c8467a6...00a4c4793890e9a8f6ad6f538d445111d6c73d54,1,12,1,13,1,2013-05-04 17:40:41,2013-05-04 17:04:39
dfec726bbae0e699b78db8f1b63372134c8467a6...6f748f3885d7c99cfc7df431bf0c2ca84b70016b,3,56,25,81,7,2013-05-04 16:14:40,2013-05-04 16:14:40
dfec726bbae0e699b78db8f1b63372134c8467a6...e09d18eed66d0239bea73af51e586f6ae651fe49,5,83,3,86,7,2013-05-03 23:54:47,2013-05-03 23:39:44
00384321d3ccd3b3f1b2d3bc809f58f316054047...bc2020d64869aa19a88b71aee33a24b54c178dab,1,72,0,72,1,2013-05-14 23:39:19,2013-05-14 23:39:19
69a4bc1988fc242bd0d310781c865cce5481a0e6...c02f13925a0eb61ee3b4806e52aeac4d6cd38021,1,1,1,2,1,2012-04-21 16:43:10,2012-04-21 16:43:10
c02f13925a0eb61ee3b4806e52aeac4d6cd38021...8c327228fdb0bcf130961362b14fec0e9a63c89a,1,1,1,2,1,2012-04-21 16:45:32,2012-04-21 16:45:32
bf63cd0bd2ff1aa4c7326f139954ef355f1c8538...6a62543597e401adc85bad12a3153995705200f3,1,10,18,28,7,2012-04-12 21:40:41,2012-04-12 21:40:41
d1f331564da9d6110b80b538a501da0c66e59142...14a513e05866721f5ceba18cf425568d2f6af143,9,206,7,213,20,2012-04-13 22:00:29,2012-04-13 22:00:29
d1be9e4ca18caa37c69afb988994a99cd137a3b8...ba8b8c040744edb9bc832a67646e0126636753bb,5,112,14,126,10,2013-08-09 18:41:41,2013-08-07 16:17:20
ba8b8c040744edb9bc832a67646e0126636753bb...3bc3ed80f476bcef24a508cadd45d4c341ef60c7,1,19,9,28,1,2013-08-09 18:41:41,2013-08-09 17:06:23
3a2a511be3ae225e5c5a3d38f65d672805ec99cd...0d4a5b13afc6c516212b194b238ab08d3362a041,1,2,0,2,1,2013-04-21 22:13:35,2013-04-21 22:13:35
3a2a511be3ae225e5c5a3d38f65d672805ec99cd...83041c711cd7d9fccb7a1327e642ce33f0705370,6,76,50,126,9,2013-04-21 18:50:55,2013-04-19 18:52:04
83041c711cd7d9fccb7a1327e642ce33f0705370...83cc70d9fec5f81d07f9fc4133c9515527efb9af,15,225,182,407,36,2013-04-21 18:50:55,2013-04-19 19:48:33
83cc70d9fec5f81d07f9fc4133c9515527efb9af...7cc3c9202722c53bf46e5a8f8d0d7180423a7632,2,14,0,14,2,2013-04-21 18:50:56,2013-01-29 13:48:36
7cc3c9202722c53bf46e5a8f8d0d7180423a7632...1384b688d0bb5cd784c453fffef69d27e3db44ca,6,101,72,173,12,2013-04-21 18:50:56,2013-04-19 20:00:12
1384b688d0bb5cd784c453fffef69d27e3db44ca...9255039898bf4c625f678f390c8075c11d10cad0,2,60,10,70,7,2013-04-21 18:50:56,2013-01-29 15:53:23
9255039898bf4c625f678f390c8075c11d10cad0...9233b3de4ea264a8ae846c784acc70c505022d8b,3,129,105,234,24,2013-04-21 18:50:56,2013-04-19 20:17:29
9233b3de4ea264a8ae846c784acc70c505022d8b...4dcd87801972e1b880afa9cd0998842bae7af5b5,9,119,114,233,98,2013-04-21 18:57:21,2013-04-20 00:17:44
4dcd87801972e1b880afa9cd0998842bae7af5b5...21ca045100337bcb2905a20a72d42721d18871f9,9,78,52,130,31,2013-04-21 19:52:17,2013-04-21 19:52:17
f938259f7c2af0c5026fdfb53862e38472f2de28...81b8c9df4642328a7d0dc0920f1489748371d275,1,0,10,10,1,2013-03-30 03:50:53,2013-03-30 03:50:53
c9e9640356f4c56fdb86d3313a5a7dcf282b7391...26ec6a6db364534077add6bc486cfeefdebfeee8,1,2,0,2,2,2013-01-25 12:07:26,2013-01-24 19:38:01
c9e9640356f4c56fdb86d3313a5a7dcf282b7391...c5193e3c204acca3feb73f613ee678087089cf0f,1,6,3,9,5,2013-01-25 11:26:09,2013-01-25 11:00:27
c9e9640356f4c56fdb86d3313a5a7dcf282b7391...a7f8065f8cd3d635264b3bfdb93cd0c22bb960a4,13,48,48,96,41,2013-01-25 05:55:56,2013-01-25 05:48:55
cfc7b835d6702049968cb0a6899d9741e6e0ebf4...bebdbcd442fb9b050589e9d7ba311850b0807f71,4,97,73,170,11,2013-01-05 00:56:21,2013-01-05 00:56:21
bebdbcd442fb9b050589e9d7ba311850b0807f71...2f0895393dee641c560cd9a54cc8e5d0b0384f01,1,12,4,16,3,2013-01-05 01:17:37,2013-01-05 01:17:37
cfc7b835d6702049968cb0a6899d9741e6e0ebf4...79ff264e2f5db5093fd34a9badca88d86dbe86d8,1,1,1,2,1,2013-01-05 00:34:19,2013-01-05 00:34:19
00197c34d6385a2de3970c9f820714064c5bf27f...9094ae5a3c12ee99743498cb8e895d18b932e4dd,5,69,13,82,16,2013-06-21 18:55:13,2013-06-21 18:51:16
9094ae5a3c12ee99743498cb8e895d18b932e4dd...6a15e8d23ad3e8c419c88b98732ca32addd2887c,1,27,6,33,3,2013-06-21 19:26:36,2013-06-21 19:26:36
6a15e8d23ad3e8c419c88b98732ca32addd2887c...d4f98ba4f124a836ed964a71137a6dae28358704,2,115,0,115,5,2013-06-21 19:29:03,2013-06-21 19:29:03
c09810eedfd89923e5bda25d0c98def292dee732...74ded024572318a32ff537c5f8dce001e9812e6b,6,636,241,877,212,2013-06-18 00:03:34,2013-06-18 00:03:34
3e96e3391cdce890e9030615fdb816301534accc...72662202ac4230fba8642f8b2844359377c16326,1,1,1,2,1,2013-05-06 12:31:26,2013-05-06 12:31:26
bc2020d64869aa19a88b71aee33a24b54c178dab...6fe02c11a6709adb52c2a48cd6470b6e964e6c99,1,0,13,13,1,2013-05-15 18:44:35,2013-05-15 18:44:35
bc2020d64869aa19a88b71aee33a24b54c178dab...0cb16fe924fb5c4e58866c28b06ace876e2dcbd3,23,168,168,336,55,2013-05-15 12:26:55,2013-05-15 12:26:55
7dbbf4d7f21b5859e24a03c6176a666edb8ef9a9...2218fd57a50ceb851cb131939bf0747e072e40f6,1,1,1,2,1,2012-04-23 17:41:43,2012-04-20 00:23:14
6a62543597e401adc85bad12a3153995705200f3...4d53f3e214aee0a2c7370ba099bbb5af70d89f35,2,13,3,16,5,2012-04-13 07:50:41,2012-04-05 21:37:38
4d53f3e214aee0a2c7370ba099bbb5af70d89f35...45d773efea89a3e00a9f32b587b1496fe68dff92,1,38,11,49,17,2012-04-13 20:16:48,2012-04-05 21:36:14
45d773efea89a3e00a9f32b587b1496fe68dff92...fa679339c433cf7b478f9badd37ec9e093a3f0af,1,7,0,7,1,2012-04-13 20:16:48,2012-04-13 07:58:54
fa679339c433cf7b478f9badd37ec9e093a3f0af...3f93e16cff90e71dad434729b3acdc437fb06436,3,334,37,371,32,2012-04-13 20:19:44,2012-03-29 15:49:57
3f93e16cff90e71dad434729b3acdc437fb06436...453ab98da06d57c7d41a9f3ddf945ae56d56890a,2,244,71,315,28,2012-04-13 20:19:45,2012-04-11 10:55:34
453ab98da06d57c7d41a9f3ddf945ae56d56890a...907ebe855602bcbed2bf1bb55647b4c1767614ba,1,55,0,55,1,2012-04-13 20:19:45,2012-04-13 08:29:27
907ebe855602bcbed2bf1bb55647b4c1767614ba...1c9c081a6a0e02ea8a148717083e3f7a769c5a2e,2,46,0,46,3,2012-04-13 20:19:45,2012-04-13 17:25:06
e77e53edb37b7dd603da7758b243ef8e91d9e394...146f5c75d73229cc0d6a4fcebf5d81f90d54b1d3,1,3,0,3,2,2012-04-14 13:09:29,2012-04-14 13:09:29
146f5c75d73229cc0d6a4fcebf5d81f90d54b1d3...3fa1ec4af63f30c8e205f18439f6eb5cc7e6898c,1,2,0,2,2,2012-04-15 18:30:12,2012-04-15 17:02:05
e77e53edb37b7dd603da7758b243ef8e91d9e394...fdd1149c292727439c6616743ad044df3c74527c,1,0,1,1,1,2012-04-14 11:46:13,2012-04-14 11:46:13
fdd1149c292727439c6616743ad044df3c74527c...c1aefb35dd39efa0045a9925520b4715f82433e3,2,23,0,23,3,2012-04-14 13:05:38,2012-04-14 12:13:17
a25519acc106acf6e1f376c81a078c78778015ed...7affc2f7dec48dc886e9838b102bdd42d06b1d2d,3,66,11,77,25,2013-08-12 10:07:21,2013-08-11 21:30:47
7affc2f7dec48dc886e9838b102bdd42d06b1d2d...d10de8bd8dff0ebbb7d6684f5a7b9d3e1ec04667,1,2,3,5,2,2013-08-12 10:07:33,2013-08-12 10:07:33
8ca093991d3105e62a6f509e9763c1f72040e1c7...e54cfb9b544eeac2924f45fc7752c2a7be709a03,2,4,1,5,3,2013-08-12 09:50:27,2013-08-12 09:50:27
e54cfb9b544eeac2924f45fc7752c2a7be709a03...423e3b0c4838537608bede2c166abd3b589dd23c,2,2,2,4,2,2013-08-12 18:02:53,2013-08-12 18:02:53
81b8c9df4642328a7d0dc0920f1489748371d275...5a5bd640241f68387fe3403e29f3d31103b8c0fd,1,61,61,122,27,2013-03-31 12:17:38,2013-03-31 11:53:40
5a5bd640241f68387fe3403e29f3d31103b8c0fd...24cb87e2a68f550be9b9df8569796f8d491fed55,9,36,12,48,13,2013-03-31 12:36:51,2013-03-31 11:27:43
81b8c9df4642328a7d0dc0920f1489748371d275...0227fa2a353ae7162c007f213cfb99c1709a7f15,1,126,11,137,17,2013-03-31 01:36:04,2013-03-31 01:36:04
0227fa2a353ae7162c007f213cfb99c1709a7f15...8cc2f2d86fa8a54b1ba87564c046e2e431e4ced0,1,54,18,72,7,2013-03-31 16:10:27,2013-03-31 16:10:27
8cc2f2d86fa8a54b1ba87564c046e2e431e4ced0...5c5eeba6fda50e350c5e007ed5d59f8ca92ad0d8,4,25,8,33,6,2013-04-01 02:22:33,2013-04-01 02:22:33
5c5eeba6fda50e350c5e007ed5d59f8ca92ad0d8...b39f969732bbcdd30be5a43c72eb8b3e89696cd3,1,2,2,4,2,2013-04-01 03:04:14,2013-04-01 03:04:14
81b8c9df4642328a7d0dc0920f1489748371d275...a258d8e3574c4e993bf16e0c136d1a5fbc356728,10,76,76,152,36,2013-03-30 14:45:57,2013-03-30 02:39:19
a258d8e3574c4e993bf16e0c136d1a5fbc356728...97016f29ab2359da5c59e2acae6369794fceb9d4,2,23,26,49,7,2013-03-31 10:51:53,2013-03-30 08:30:29
97016f29ab2359da5c59e2acae6369794fceb9d4...d59942c2aba2fa5f9570b37e3bc9eaf34f16d671,3,162,1,163,4,2013-04-11 10:27:25,2013-03-30 03:27:42
26ec6a6db364534077add6bc486cfeefdebfeee8...9f35754a0ebb8004162e93ad365e0757fa39920a,2,25,1,26,3,2013-01-25 12:29:28,2013-01-25 12:29:28
4adb4815bf4be623f765b593e3a3d50ab9710aab...f42beff7e2e74da066eb91dac869c6f2e616f9e3,2,1,3,4,3,2013-01-26 04:39:18,2013-01-26 04:35:04
7511d8b42d2ab9e955cd630664ac893e6b35eb63...ef82ff30f6dd643ca6aac13deac4b11b519128aa,1,1,1,2,1,2013-01-05 08:46:39,2013-01-05 08:46:39
5d669f0a96ab858750f4fdd90f138225946934c2...8294e8cfff284a05084f7f9b91931e136a0c119d,1,30,16,46,13,2013-06-23 00:15:31,2013-06-23 00:15:31
8294e8cfff284a05084f7f9b91931e136a0c119d...32c12ea6a9cafd76a746af2e2be9366c95752f5b,1,2,1,3,1,2013-06-24 16:19:24,2013-06-24 16:19:24
5d669f0a96ab858750f4fdd90f138225946934c2...a7ea40955e5bd881508e2a99e2b73b1a1fbf78e3,1,2,0,2,2,2013-06-22 23:25:34,2013-06-22 23:25:34
ffb762fed99bee33656ae00c3bfd06176b31ca82...f0f2ff9cacc17dd9d4523e3647990e5db6013f20,6,79,0,79,4,2013-06-18 16:39:10,2013-06-17 22:33:40
f0f2ff9cacc17dd9d4523e3647990e5db6013f20...3b334075c909f9023f5f704469965cf774efc4a5,1,53,0,53,1,2013-06-18 16:39:10,2013-06-17 22:39:59
3b334075c909f9023f5f704469965cf774efc4a5...e4acc3ba19838d39123131d4cc7e52f222691445,3,152,111,263,55,2013-06-18 23:14:35,2013-06-18 23:14:35
0e1115d2872fcb8f13fd28a52f1f14d52792623e...f966acd13366d21e0b9beeecf021c0114596c716,4,43,5,48,6,2013-11-05 03:32:50,2013-11-04 21:46:32
f966acd13366d21e0b9beeecf021c0114596c716...1d3a8aeb4bd032d0bf34039fbcb308fba06b862a,19,80,77,157,71,2013-11-05 03:33:05,2013-11-04 23:28:57
0e1115d2872fcb8f13fd28a52f1f14d52792623e...d6c6016966cff46d874a8d85b38704a6ef2150e5,2,40,0,40,4,2013-11-04 23:45:31,2013-11-04 23:45:31
d6c6016966cff46d874a8d85b38704a6ef2150e5...3b259cbd1afdc96a3c3eb7af5895b310c1ac2a7d,2,46,0,46,3,2013-11-04 23:47:35,2013-11-04 23:47:35
3b259cbd1afdc96a3c3eb7af5895b310c1ac2a7d...1eab9f0e32178a9aac941583c69e1b9cf9849f77,3,18,25,43,11,2013-11-05 13:56:10,2013-11-05 13:56:10
0e1115d2872fcb8f13fd28a52f1f14d52792623e...b7bb086b1cc1348c0706ee4ec4b5524ae1f4eb97,1,47,36,83,8,2013-11-04 23:25:26,2013-11-04 23:25:26
b7bb086b1cc1348c0706ee4ec4b5524ae1f4eb97...e6b85be7cff913adb6d8ebe431f91f5a907d056c,1,96,69,165,20,2013-11-04 23:48:35,2013-11-04 23:48:35
e6b85be7cff913adb6d8ebe431f91f5a907d056c...ea8ce3d17edbc16f8bc905fcee776629c2010eec,1,2,2,4,3,2013-11-04 23:50:33,2013-11-04 23:50:33
ea8ce3d17edbc16f8bc905fcee776629c2010eec...b47949254ee5b7e5801fd3d1d80136bff5db938a,1,1,0,1,1,2013-11-04 23:54:11,2013-11-04 23:54:11
12f831fa1500bdcd1b9a2ef20c4897904983af8e...57908bb3a3b3a0f3de75d13ef432e3964dab9212,1,8,6,14,4,2013-05-16 18:03:55,2013-05-16 18:03:55
12f831fa1500bdcd1b9a2ef20c4897904983af8e...7026ad893b5ba54b11c7397f10d6fdf64683062f,3,4,4,8,4,2013-05-16 13:11:38,2013-05-16 13:08:55
86c6f74a79ef61582b636d478a9852ae54d87e2e...f0ab73720a4e7a9b37c901a27519ea65eafeb8a6,2,16,7,23,5,2013-05-15 15:51:57,2013-05-15 15:51:57
2218fd57a50ceb851cb131939bf0747e072e40f6...06ac3e7f345d8ab257f77bf567d671c0b65c378c,1,2,2,4,2,2012-05-05 20:16:48,2012-05-05 20:16:48
06ac3e7f345d8ab257f77bf567d671c0b65c378c...b4b96d56bf1d9f362441e5e650b023040a319e05,4,19,16,35,12,2012-05-05 20:33:46,2012-05-05 20:30:33
b4b96d56bf1d9f362441e5e650b023040a319e05...b47e0a71718823338686b49614f7c7536265d3a8,1,1,0,1,1,2012-05-05 20:52:48,2012-05-05 20:52:48
b47e0a71718823338686b49614f7c7536265d3a8...35cdd261f353696181236328323e8d123cad57d4,1,8,0,8,2,2012-05-05 20:54:33,2012-05-05 20:54:33
d59305544e4825a7668d6d2fa9df2a0ffa21a3d6...0586215662320139dc1f5363dce7da3522463f91,1,1,1,2,1,2012-04-20 00:23:14,2012-04-20 00:23:14
0586215662320139dc1f5363dce7da3522463f91...5c9a794d0b0e78b18144ed9949d08735eb3ed4b7,1,2,2,4,2,2012-04-21 16:36:13,2012-04-21 16:36:13
3fa1ec4af63f30c8e205f18439f6eb5cc7e6898c...2c1075d65a344f8fa166b4c1eb8320f389653187,3,114,21,135,26,2012-04-16 08:25:52,2012-03-16 11:52:49
c1aefb35dd39efa0045a9925520b4715f82433e3...baf861a511a2c5cb091fcaa510c1b66331c49bed,3,38,0,38,3,2012-04-23 09:07:19,2012-04-23 09:07:19
14da618260be02c63b4f08dca8e6ab479f7449d7...af6dab7ef74cf96c165e39cafd1aac3a659a3e8a,1,27,2,29,3,2013-08-13 19:10:03,2013-08-13 17:10:52
14da618260be02c63b4f08dca8e6ab479f7449d7...9ccdb21155b3c9650acf58c55b2596c3503ea14d,1,12,5,17,5,2013-08-13 17:55:37,2013-08-13 17:55:37
14da618260be02c63b4f08dca8e6ab479f7449d7...e12618b1ecea0eda5bc23662c78b678ca5a27013,1,3,0,3,2,2013-08-13 16:22:53,2013-08-13 16:22:53
08283cbdb857d09f8e623c5c23abcaa499b6b3fc...b08c3173466bf233f27b9085c22dd66c15d5bd6a,1,2,4,6,1,2013-04-01 20:01:13,2013-04-01 20:01:13
ae386101d249f77039f5b00ada190132acad90a8...cfc39f5078ecea864d78d349264eb259d4604363,3,3,0,3,3,2013-01-26 03:43:52,2013-01-26 03:43:52
f42beff7e2e74da066eb91dac869c6f2e616f9e3...67fcac567ba25753e7500e40081bea1a418dc6da,2,36,1,37,2,2013-01-29 17:46:17,2013-01-29 17:00:32
f42beff7e2e74da066eb91dac869c6f2e616f9e3...aa3bf89df21c44f22fe70b4aac9109646fd06b48,1,1,0,1,1,2013-01-26 20:12:53,2013-01-26 20:12:53
2b7b3e1fae889d2bd4a7c8fe538aa636b1eb7ba5...09556895b77219bc29494084344b0babe14fff04,2,2,2,4,2,2013-01-06 13:40:32,2013-01-06 13:40:32
09556895b77219bc29494084344b0babe14fff04...d1aee4775aba1a320cb3bb12753168ce8a35fb74,1,1,0,1,1,2013-01-06 14:09:27,2013-01-06 14:09:27
d1aee4775aba1a320cb3bb12753168ce8a35fb74...b97fabfad590e01a4ee5e75ea5f5a3fbb41d85e4,3,10,0,10,4,2013-01-06 15:22:24,2013-01-06 14:18:00
b97fabfad590e01a4ee5e75ea5f5a3fbb41d85e4...d01fe380610da0687eecdba61369393d49830cfe,1,1,2,3,1,2013-01-06 15:22:28,2013-01-06 14:26:54
9f1b2c5cb79526f274c0c72eed56f9da0efb0321...e1967164574816b8bf6740ea17d08eeb26c091d2,17,35,35,70,34,2013-06-24 13:33:41,2013-06-24 13:33:41
9f1b2c5cb79526f274c0c72eed56f9da0efb0321...3d3ea4dc564922a3662298a7cfc2fc8b24149901,3,9,4,13,5,2013-06-23 03:58:32,2013-06-23 03:58:32
84ba4944bca985195e6c32457488e514b5b37f98...e91f9a8f28ca58c5ff0450749a57d233a5512f2d,2,39,0,39,2,2013-06-19 22:20:59,2013-06-19 22:20:59
e91f9a8f28ca58c5ff0450749a57d233a5512f2d...85b8b18b6a07b74dd2631c3a647ca758660bf298,2,67,0,67,2,2013-06-19 22:22:48,2013-06-19 22:22:48
85b8b18b6a07b74dd2631c3a647ca758660bf298...f30fff45a752cb0781067ad48c283e49345a5813,4,586,4,590,9,2013-06-19 22:27:25,2013-06-19 22:27:25
f30fff45a752cb0781067ad48c283e49345a5813...7863523a1be51981bafee9d13b3344fb4ff47347,2,29,3,32,8,2013-06-19 22:54:19,2013-06-19 22:54:19
3ae66ef1af2af9132c96c57bf5c6e2cfdb1f617c...e8162fd091bbfd49fc5aaa60794a0a3558e895bb,2,17,4,21,4,2013-11-05 13:03:51,2013-11-05 11:01:14
b47949254ee5b7e5801fd3d1d80136bff5db938a...fde93250320f97cd6cf93be1e4ab09fd330e001f,1,24,2,26,3,2013-11-07 12:31:25,2013-11-07 12:17:36
fde93250320f97cd6cf93be1e4ab09fd330e001f...a9f7236affefc9918a8d3f2511fc4e5345d69942,1,27,0,27,1,2013-11-07 12:45:28,2013-11-07 12:38:04
a9f7236affefc9918a8d3f2511fc4e5345d69942...7dd28dde284276a09e74f66b22fe0173573d3ca7,1,4,0,4,3,2013-11-07 14:39:15,2013-11-07 14:39:15
7dd28dde284276a09e74f66b22fe0173573d3ca7...590c5efb3bab80b3e52cf68b705ef461d7388874,1,3,3,6,3,2013-11-07 16:51:43,2013-11-07 16:51:43
f0ab73720a4e7a9b37c901a27519ea65eafeb8a6...79ef3be449c9d81dd0b37a30999563aa92e4679e,2,29,2,31,3,2013-05-15 21:50:05,2013-05-15 21:50:05
79ef3be449c9d81dd0b37a30999563aa92e4679e...55d3a39098bfc513b12ad6cb56658cb2f87e6a91,1,11,3,14,4,2013-05-15 21:52:12,2013-05-15 21:52:12
55d3a39098bfc513b12ad6cb56658cb2f87e6a91...dcb0f7c061554de06db5879361b22eab3517a4ee,3,39,22,61,6,2013-05-15 21:54:02,2013-05-15 21:54:02
dcb0f7c061554de06db5879361b22eab3517a4ee...09fae31d45c3b9112cb7ce7d5c7d1d63840e407d,1,12,5,17,3,2013-05-15 21:58:26,2013-05-15 21:58:26
09fae31d45c3b9112cb7ce7d5c7d1d63840e407d...72b3dd4a5ca2f6572e741c243cd973963d0ef419,1,11,16,27,12,2013-05-15 22:23:33,2013-05-15 22:23:33
f0ab73720a4e7a9b37c901a27519ea65eafeb8a6...1fed6b07f0722c8b4349ff3709a49df3d3c9ae61,42,479,493,972,456,2013-05-15 20:41:30,2013-05-13 19:57:37
cd58c15c589970765cd46e7bbdaebf6250fd7626...3972ca43d8bc64247159c118ea8b261b5efaf35d,1,1,0,1,1,2012-05-06 05:14:02,2012-05-06 05:14:02
3972ca43d8bc64247159c118ea8b261b5efaf35d...49ac5ac8fc4b775a27e688e6fdfcbd36e5365891,1,1,1,2,1,2012-05-06 11:17:39,2012-05-06 11:17:25
40879facad0337d954d4904e212af3b36cdb9465...946a6dc4e693280e3210fbad7e4cec03c7b0b169,23,90,252,342,70,2012-05-02 23:14:30,2012-05-02 23:14:30
946a6dc4e693280e3210fbad7e4cec03c7b0b169...8c83fead917bde2f9114c3cb9a82226e52a1d5a5,98,0,0,0,0,2012-05-02 23:18:55,2012-05-02 23:18:55
8c83fead917bde2f9114c3cb9a82226e52a1d5a5...a1d0802576a158c74af07c0e46a3e2adb5075fba,67,1,44,45,23,2012-05-02 23:33:26,2012-05-02 23:33:26
a1d0802576a158c74af07c0e46a3e2adb5075fba...17f1c9fb332d054285452313f0ec537dfde63d1c,1,2,1,3,2,2012-05-02 23:44:47,2012-05-02 23:44:47
17f1c9fb332d054285452313f0ec537dfde63d1c...b02bcd97f80beabc96cd1f861bfc3b5f7532ef8b,5,14,14,28,13,2012-05-02 23:57:16,2012-05-02 23:57:16
b02bcd97f80beabc96cd1f861bfc3b5f7532ef8b...3fbcac89c47cb66ea193f66da6d93d1c36ed0f5e,24,92,355,447,76,2012-05-03 02:56:38,2012-05-03 02:56:38
e8c3774f9bce47f2693e72773a28a7aff252473c...dbeca7969871a00826d662e68cfb4039e77c619b,1,1,367,368,3,2012-04-17 17:35:11,2012-04-13 17:43:47
dbeca7969871a00826d662e68cfb4039e77c619b...1a6e8f8a54eea1159a950cd8a49cedae3699ff9a,12,165,181,346,134,2012-04-17 17:35:11,2012-04-13 17:42:00
1a6e8f8a54eea1159a950cd8a49cedae3699ff9a...f201d613a80f7ad6f54d90eb7a7a0d8b8c72676b,8,192,121,313,29,2012-04-17 17:44:50,2012-04-13 17:33:14
f201d613a80f7ad6f54d90eb7a7a0d8b8c72676b...44ef8b1b300f0cd3d8572fa1b40d257462f28240,36,266,227,493,169,2012-04-17 17:47:39,2012-04-13 20:00:10
44ef8b1b300f0cd3d8572fa1b40d257462f28240...26515e73a11b6f6c25e316ece2a6243aba7af9f5,6,7,6,13,6,2012-04-23 17:06:31,2012-04-23 17:06:31
ad0af715751a37b4215ace8ddfcb69aa63ec8333...c87bf86cd739c30ab430a789e9eb0dfb1b1d78b7,1,1,0,1,1,2013-08-14 17:58:02,2013-08-14 17:58:02
c87bf86cd739c30ab430a789e9eb0dfb1b1d78b7...1e94df08dad9437164ac7727f23a51591b7c42f4,1,1,1,2,1,2013-08-14 22:09:46,2013-08-14 22:09:46
2af9bcb2dbb47adafa7eecbf41ff113da7fa9d1b...376e6c9f96ffcd572ba974c9cc4d13b4f1e31474,6,78,29,107,16,2013-08-15 12:29:27,2013-08-15 11:48:35
376e6c9f96ffcd572ba974c9cc4d13b4f1e31474...8380b39a6761efa360398279083a65064d6770d3,3,25,3,28,10,2013-08-15 12:29:39,2013-08-15 12:29:39
8380b39a6761efa360398279083a65064d6770d3...d4e6cf0cd05540b373bfcb8908e4bc8f8f72c73c,1,2,13,15,3,2013-08-15 12:32:47,2013-08-15 12:32:47
d4e6cf0cd05540b373bfcb8908e4bc8f8f72c73c...fe0c6d4e712fa1bb072b8a847783bad47f3e91eb,4,8,12,20,9,2013-08-16 23:41:08,2013-08-16 23:41:08
fe0c6d4e712fa1bb072b8a847783bad47f3e91eb...7a3764bee92456e5ee2ed41be9abb0ffb4165eb7,2,29,1,30,6,2013-08-17 00:02:28,2013-08-16 23:55:52
7a3764bee92456e5ee2ed41be9abb0ffb4165eb7...090a07d29548ce69034b4be6ba043014226893c9,1,2,2,4,1,2013-08-17 00:12:04,2013-08-17 00:12:04
2af9bcb2dbb47adafa7eecbf41ff113da7fa9d1b...0b9ebb54ff9aab86bb858e1d2952efa4dcdafefa,2,6,10,16,3,2013-08-14 09:52:49,2013-08-14 09:18:05
2af9bcb2dbb47adafa7eecbf41ff113da7fa9d1b...5be622fb563c89341a7dd5da4e65e2c225cb2c08,4,50,15,65,11,2013-08-14 08:49:10,2013-08-10 23:37:44
2af9bcb2dbb47adafa7eecbf41ff113da7fa9d1b...67591c8cd8d55e6f3218f1a734385c845459e1ff,3,32,2,34,6,2013-08-14 08:28:01,2013-08-14 08:28:01
67591c8cd8d55e6f3218f1a734385c845459e1ff...e2164da5eb2d76129b8dae0b5ea2f7a606324fba,1,3,1,4,2,2013-08-14 08:31:02,2013-08-14 08:31:02
e2164da5eb2d76129b8dae0b5ea2f7a606324fba...59547ce77269e0667426327d9166aad0954bc686,2,14,11,25,4,2013-08-14 08:34:07,2013-08-14 08:34:07
734aa82642ab2e6164c206cc5898af824cb23e50...c869e26878d752e1e26d2c09efd3bc389584b0a5,1,1,1,2,1,2013-04-02 23:57:42,2013-04-02 23:57:42
cfc39f5078ecea864d78d349264eb259d4604363...5026aec2b328c9fa2d04484b06becc7c31d04fe1,2,31,9,40,8,2013-01-26 04:24:13,2013-01-26 04:24:13
aa3bf89df21c44f22fe70b4aac9109646fd06b48...b0dc81f055d4eb523c92bc859d5641e72d343b00,2,24,11,35,9,2013-02-01 20:54:32,2013-02-01 15:17:34
b0dc81f055d4eb523c92bc859d5641e72d343b00...89ad1c57a351809d3173e22a26c84e7a16adbe6b,2,6,6,12,5,2013-02-01 21:17:34,2013-02-01 21:14:52
89ad1c57a351809d3173e22a26c84e7a16adbe6b...bd25a302d3232dea375f226602fdcdb3a83abcdc,2,19,4,23,2,2013-02-01 23:52:23,2013-02-01 21:22:26
bd25a302d3232dea375f226602fdcdb3a83abcdc...c70455c75e30bf2a4cc5abdf4229d12d0e6cf159,5,66,47,113,7,2013-02-01 23:55:32,2013-02-01 21:53:51
aa3bf89df21c44f22fe70b4aac9109646fd06b48...ec56af08a9aa9ae261325f5037ec0d5114517d55,2,25,17,42,6,2013-01-31 18:46:07,2013-01-31 16:37:20
ec56af08a9aa9ae261325f5037ec0d5114517d55...c55378fce5d0164c87ccf3a6dba2f56b4ade9341,1,7,4,11,3,2013-01-31 18:47:35,2013-01-31 16:43:59
c55378fce5d0164c87ccf3a6dba2f56b4ade9341...01e7128f392157f3580d9bbca5c2b80fb56001ee,1,1,0,1,1,2013-01-31 18:48:00,2013-01-31 16:44:40
01e7128f392157f3580d9bbca5c2b80fb56001ee...45792c923ba85d42618b4b246c0a8eec8b16128e,1,3,6,9,2,2013-02-01 09:32:05,2013-02-01 09:32:05
aa3bf89df21c44f22fe70b4aac9109646fd06b48...11d9f6b30438a141def883b0115f7f764c03e990,22,235,200,435,145,2013-01-27 19:17:07,2013-01-27 19:17:07
11d9f6b30438a141def883b0115f7f764c03e990...590365db54e7f0311bd77d09270c7c3714a33b3c,1,2,2,4,1,2013-01-29 21:49:12,2013-01-29 21:49:12
aa3bf89df21c44f22fe70b4aac9109646fd06b48...88183c1988ff1c8b1bbe956e0df6d2c10e5a12b2,1,5,2,7,3,2013-01-27 05:36:37,2013-01-27 05:36:37
353a90bedb6e679306f740fd0c1a08fc7934fbaa...8c510b8313bd933e6d3b44f3ce88999d349a8dd7,1,9,9,18,4,2013-06-24 19:02:42,2013-06-24 19:02:42
353a90bedb6e679306f740fd0c1a08fc7934fbaa...f3f4c6b5bea91351a7bdb1d94e76924e76d0fcee,2,14,6,20,4,2013-06-24 18:56:35,2013-06-24 18:56:35
b7fbfbb21f4248bf4103a2c13479bf65ba175f36...61080a959d5f027d3eef066bd7b771132b50496e,2,7,2,9,2,2013-11-05 14:10:02,2013-11-05 14:10:02
b7fbfbb21f4248bf4103a2c13479bf65ba175f36...8ec889a45fded32bf8508f99d77ea666d0aacdd5,4,129,132,261,44,2013-11-05 13:58:16,2013-11-02 13:07:02
b9cb72c28a937a887676a553fef8e21bbc7be3f0...a1d35ede189f6f3286102c53a499b5e486d86b79,1,18,18,36,8,2013-11-10 15:41:41,2013-11-10 15:41:41
c2d282cfd88ffba7693113786bd2209a5d38b964...660d59caa9cd6260fbc980e7da15f806d6d53083,3,82,23,105,11,2013-05-17 23:40:00,2013-05-17 23:40:00
660d59caa9cd6260fbc980e7da15f806d6d53083...aadfa85b0a8f9a8fec4dedd149017a769d54d930,2,78,6,84,3,2013-05-17 23:41:15,2013-05-17 23:41:15
aadfa85b0a8f9a8fec4dedd149017a769d54d930...0293450e217c1cb6966655bb00cc11fdf626083d,1,14,1,15,2,2013-05-17 23:57:49,2013-05-17 23:57:49
0293450e217c1cb6966655bb00cc11fdf626083d...d958e37a48c693a1907bede563bd835935d23499,4,203,85,288,78,2013-05-18 00:21:45,2013-05-18 00:21:45
d958e37a48c693a1907bede563bd835935d23499...5c8f37a397609eba92c6a906be467a7d7373e4f3,1,44,6,50,10,2013-05-18 00:33:03,2013-05-18 00:33:03
5c8f37a397609eba92c6a906be467a7d7373e4f3...9be5be47fb1d9bc08e25b30c05dbf48739710062,3,101,71,172,28,2013-05-20 20:37:21,2013-05-20 20:37:21
9be5be47fb1d9bc08e25b30c05dbf48739710062...4742148d54334629495eeaf0382e6c9da8786f17,4,186,20,206,11,2013-05-20 20:41:39,2013-05-20 20:41:39
4742148d54334629495eeaf0382e6c9da8786f17...a21cbb12db62426ca789045d5ac5c96ca069f0ea,5,319,220,539,68,2013-05-22 17:37:12,2013-05-22 17:37:12
a21cbb12db62426ca789045d5ac5c96ca069f0ea...c68b09dc7ab782eeec9a9c59d66d8be31aed67f1,1,12,7,19,4,2013-05-23 18:52:34,2013-05-23 18:52:34
c68b09dc7ab782eeec9a9c59d66d8be31aed67f1...67db583dabf6e154037302a24b7f79028f403454,6,139,24,163,11,2013-05-23 22:06:07,2013-05-23 22:06:07
67db583dabf6e154037302a24b7f79028f403454...f38cea97c3793dd6841fadbd1b9d26d25445375b,1,48,43,91,16,2013-05-23 22:21:43,2013-05-23 22:21:43
f38cea97c3793dd6841fadbd1b9d26d25445375b...49f70f2c370e649c3a0970b6aadd6f5cdf4f2701,2,106,1,107,3,2013-05-23 22:48:06,2013-05-23 22:48:06
71596200443cdefb374750a1922dc9e1d0be7d53...487884a9306e744eaebe659a7d0edb1c0c6c7ba7,1,40,18,58,8,2013-05-15 23:11:31,2013-05-13 23:07:29
487884a9306e744eaebe659a7d0edb1c0c6c7ba7...797dfb28fea6a3db542dc32d11a530570e147b73,3,129,12,141,7,2013-05-15 23:11:31,2013-05-13 23:09:33
797dfb28fea6a3db542dc32d11a530570e147b73...96c01991c166a25d8906c031422f4215edeb8ba0,3,8,131,139,7,2013-05-15 23:13:04,2013-05-15 16:24:51
96c01991c166a25d8906c031422f4215edeb8ba0...89251b283b8dd0bba2062519d9f3f1b212f8a7a8,1,45,30,75,5,2013-05-15 23:25:11,2013-05-15 23:25:11
49ac5ac8fc4b775a27e688e6fdfcbd36e5365891...9b62e40ecdb92ab7493eac514e1399d791fa6f62,1,1,1,2,1,2012-05-07 09:29:10,2012-05-07 09:28:26
49ac5ac8fc4b775a27e688e6fdfcbd36e5365891...17847c78dd29e448246e35bd385313ca86f82160,1,2,2,4,2,2012-05-07 06:58:41,2012-05-07 06:58:41
17847c78dd29e448246e35bd385313ca86f82160...901fbdad1b83678b6367ad0d06d0088bc46aad33,2,1,2,3,2,2012-05-07 07:05:02,2012-05-07 07:05:02
3fbcac89c47cb66ea193f66da6d93d1c36ed0f5e...f917481ee84cbba481c1854cccdedb2d98377d43,39,793,285,1078,165,2012-05-03 23:37:25,2012-05-03 23:37:25
f917481ee84cbba481c1854cccdedb2d98377d43...b709e95146b9d56e2c009915ccea7a86c77d4202,7,37,19,56,15,2012-05-04 18:06:12,2012-05-04 18:06:12
b709e95146b9d56e2c009915ccea7a86c77d4202...3ec1fa5e1c0ee0e151a44267fa6496ecdf604eb9,6,6,1,7,4,2012-05-04 20:55:07,2012-05-04 20:55:07
3ec1fa5e1c0ee0e151a44267fa6496ecdf604eb9...282283acc65bab9de231a2b3dc489eb171d5f1cf,6,37,18,55,20,2012-05-04 23:46:46,2012-05-04 23:46:46
3fbcac89c47cb66ea193f66da6d93d1c36ed0f5e...baaf1c47101acd0be28bbdeb2792c208d22b3a20,2,23,6,29,6,2012-05-03 07:03:58,2012-05-03 06:44:22
baaf1c47101acd0be28bbdeb2792c208d22b3a20...2277216613d974b5a9cd00be9120be194706ff11,1,42,29,71,16,2012-05-03 07:04:04,2012-05-03 07:04:04
2277216613d974b5a9cd00be9120be194706ff11...76873c09053e210c7f739b1cda39cffd6ab865e0,1,2,2,4,2,2012-05-03 20:30:14,2012-05-03 20:30:14
f9f2344bd4ba6c81a96959509ba59f8563b60265...a7d19b975a604b2800ba428a185895241313d1f6,2,12,6,18,2,2012-04-25 13:47:53,2012-04-25 13:47:53
f9f2344bd4ba6c81a96959509ba59f8563b60265...7a520f5d8af2aedd5693bf7314527d76d9af2ef4,7,66,87,153,49,2012-04-25 10:39:11,2012-04-13 21:19:38
7a520f5d8af2aedd5693bf7314527d76d9af2ef4...db0f96a6aff33612d88ab5d9263bcad9daf6b11a,1,22,71,93,10,2012-04-25 10:39:17,2012-04-13 21:37:55
db0f96a6aff33612d88ab5d9263bcad9daf6b11a...dee5515a237b2d4182e454986025199064193376,10,71,168,239,32,2012-04-25 10:44:27,2012-04-14 16:34:50
dee5515a237b2d4182e454986025199064193376...bf4ef0c567c3add37aa1744467692c49a534d264,1,56,13,69,7,2012-04-25 10:44:52,2012-04-16 03:02:41
bf4ef0c567c3add37aa1744467692c49a534d264...2e3a0055d136d13fba365bf2a26638f84bd32d02,1,7,0,7,1,2012-04-25 10:45:03,2012-04-16 09:58:46
2e3a0055d136d13fba365bf2a26638f84bd32d02...f184836bd281efe8a656e3a9c6c2f9c040b88119,4,46,9,55,12,2012-04-25 11:25:45,2012-04-25 10:13:20
1e94df08dad9437164ac7727f23a51591b7c42f4...899ec41fa18a13db50ae3c3fd1c4bb4045364e6d,1,3,7,10,1,2013-08-15 04:25:48,2013-08-15 04:25:48
899ec41fa18a13db50ae3c3fd1c4bb4045364e6d...1616fa68e520dbd29b839335065599f8a2b93a6f,1,1,1,2,1,2013-08-15 05:25:05,2013-08-15 05:25:05
520287f63a86c5d284ff4d23a2d5d61decbb8685...6d69fbce31c391c7a7739f8156b0d63f399c53bf,1,1,1,2,1,2013-08-19 11:04:05,2013-08-19 11:04:05
432b8c11b8efbc8018bb5cff30431221cdc7b917...f8591e519ad8330ae7314e7259fc943fe9afe053,1,13,9,22,10,2013-04-04 18:44:50,2013-04-04 18:44:50
d2041216578de4e6fbb466d439fac5de7f35caf3...a8182d495d3cf9f29b3339db7d6320a680a84690,1,5,1,6,1,2013-01-30 20:24:38,2013-01-30 20:24:38
d2041216578de4e6fbb466d439fac5de7f35caf3...f1e2735c74d03105592a282e2c32f45033db0e8d,4,127,1,128,5,2013-01-30 19:10:39,2013-01-30 19:10:39
f1e2735c74d03105592a282e2c32f45033db0e8d...3bf68be443738c7de91eac9084277360346c8971,1,2,0,2,1,2013-01-30 19:25:20,2013-01-30 19:25:20
e963166019de3dca72d18bd4ee8f81519e97fdf3...545b479a07a56676def87fc18878c0b7a9794990,2,42,7,49,3,2013-02-03 10:18:24,2013-02-02 16:36:20
545b479a07a56676def87fc18878c0b7a9794990...0e8e5a6189b84b2817d5916948e963e97d8f3641,2,103,6,109,9,2013-02-03 10:44:26,2013-02-03 10:44:26
e1859ea184a0a440b83d6c9cdb7827031b037e92...17c92beaca15f40bc8456cc38ced40f6921c4640,1,3,0,3,1,2013-01-29 20:13:24,2013-01-29 20:13:24
17c92beaca15f40bc8456cc38ced40f6921c4640...1e7799e8b84491cadb99cc306749316beec8a339,3,99,62,161,27,2013-01-29 20:15:18,2013-01-29 20:15:18
1e7799e8b84491cadb99cc306749316beec8a339...501d35ccf853d5e9fc1d09e513f7de75395e6347,1,68,0,68,1,2013-01-29 20:16:59,2013-01-29 20:16:59
e1859ea184a0a440b83d6c9cdb7827031b037e92...96447d24f32052bf2755085eaab491e8f3ec9f56,1,6,3,9,4,2013-01-28 21:56:56,2013-01-28 21:13:19
88183c1988ff1c8b1bbe956e0df6d2c10e5a12b2...28c3beaa59f4b83bb3fa82e806579be9e2d8b73b,1,4,2,6,1,2013-01-27 07:02:06,2013-01-27 07:02:06
28c3beaa59f4b83bb3fa82e806579be9e2d8b73b...aa928de02a85810b0fd62a35e1af68768e0dab78,1,24,0,24,1,2013-02-01 14:40:23,2013-01-29 09:26:42
5b4a70836a7d10dcc7b78d2748e6a48ae40eb37b...c0e58e430b5befcdbcd937193e420d86fd3658a4,1,2,2,4,2,2013-06-24 22:12:19,2013-06-24 22:12:19
c0e58e430b5befcdbcd937193e420d86fd3658a4...eddc1f1ed78898a4ca41480045b1d0d5b075e773,1,2,2,4,2,2013-06-24 22:14:45,2013-06-24 22:14:45
ae26c4b80f6d144df0e7915f72c64c5daf73ca50...039db728f3a0477129e664f0fd8c08316a9e8b62,11,1851,20,1871,27,2013-11-05 15:00:39,2013-07-03 05:00:45
a1d35ede189f6f3286102c53a499b5e486d86b79...18bd73e50d21087e09a7193e55504b981c163e46,1,1,1,2,1,2013-11-10 16:08:54,2013-11-10 16:08:54
54e489c21efc19a14eac0f6f83313e3a753688f8...58206c9ae79af8ef675e30087e5430065b078bbb,7,260,17,277,20,2013-05-16 17:38:27,2013-05-16 17:38:27
58206c9ae79af8ef675e30087e5430065b078bbb...8d78400142bc001e18e0b0687290d6b446e05130,1,8,2,10,3,2013-05-16 17:43:10,2013-05-16 17:43:10
9b62e40ecdb92ab7493eac514e1399d791fa6f62...c2d82a653350a07ff062ea009b25c41be3fd0b50,1,1,1,2,1,2012-05-07 10:31:31,2012-05-07 10:31:31
9b62e40ecdb92ab7493eac514e1399d791fa6f62...3191ae89c65c1685fdae59e03e1af7d7e8edabd8,5,33,8,41,8,2012-05-07 10:18:54,2012-05-06 11:04:12
9b62e40ecdb92ab7493eac514e1399d791fa6f62...8d0f46754ff933f014e033c0e4f442927788fa29,1,1,4,5,3,2012-05-07 10:18:30,2012-05-03 14:27:22
8d0f46754ff933f014e033c0e4f442927788fa29...245c5eaec553ca1793b2a83c288fd2595f70c6a5,2,7,3,10,3,2012-05-07 10:18:31,2012-05-03 14:34:02
245c5eaec553ca1793b2a83c288fd2595f70c6a5...4f80676182dfd93992cc701072a71651dd5613ee,2,62,35,97,16,2012-05-07 10:18:31,2012-05-03 15:19:06
4f80676182dfd93992cc701072a71651dd5613ee...cfe25b13fa04e12ed7a4f60fc5f323b990db20cd,2,0,0,0,0,2012-05-07 10:18:32,2012-05-03 14:11:40
cfe25b13fa04e12ed7a4f60fc5f323b990db20cd...28ef7f9b28a8b58946e553090f8967d7c51ebc78,5,146,10,156,18,2012-05-07 10:18:32,2012-05-03 15:25:01
28ef7f9b28a8b58946e553090f8967d7c51ebc78...9a29f8d56c37803a67af3ff4bc4c8724a126366f,5,50,9,59,7,2012-05-07 10:18:33,2012-05-04 05:55:09
9a29f8d56c37803a67af3ff4bc4c8724a126366f...d1c4312a021eb165d21b7390607f2b2bcba098ae,1,8,0,8,1,2012-05-07 10:18:34,2012-05-03 20:21:08
9b62e40ecdb92ab7493eac514e1399d791fa6f62...458b94503d023a07247153f44d34bcc65e6f8103,8,272,7,279,20,2012-05-07 10:16:04,2012-03-01 16:03:32
8d89c8e9726bdb257ff3a54182f927d4ed30d439...65ca81a63e596f7c8bdfccd15a7bcbf6cfb96cd4,2,2,1,3,2,2012-05-08 12:28:21,2012-05-08 12:28:21
8d89c8e9726bdb257ff3a54182f927d4ed30d439...2fb9d6de95b7ba430cb2fab0da754a8074fa0c43,1,16,8,24,4,2012-05-08 08:05:09,2012-05-07 08:04:50
2fb9d6de95b7ba430cb2fab0da754a8074fa0c43...9fb70f378ace77bf20ec67c5bce044114a0e0f93,2,6,3,9,3,2012-05-08 08:05:12,2012-05-07 08:57:34
9fb70f378ace77bf20ec67c5bce044114a0e0f93...cb0ce16bbe8efe2098ef9cfffcf158301b036565,2,37,2,39,2,2012-05-08 08:05:14,2012-05-07 13:42:13
cb0ce16bbe8efe2098ef9cfffcf158301b036565...46811561ae19701d4d0fc4b00113667f81961dfc,1,1,1,2,1,2012-05-08 08:05:16,2012-05-07 11:56:42
46811561ae19701d4d0fc4b00113667f81961dfc...9abb5bca5d094f832d2c68342aefc8809ec8ca09,3,35,5,40,10,2012-05-08 08:05:18,2012-05-07 11:58:01
9abb5bca5d094f832d2c68342aefc8809ec8ca09...d7d8a0bfd4ab86d7c87d4f318c6b3e6fa7dab746,1,6,0,6,1,2012-05-08 08:05:20,2012-05-07 14:16:08
d7d8a0bfd4ab86d7c87d4f318c6b3e6fa7dab746...0b0957a66109b545ded7332591b4fcb8f7e13fd0,2,4,4,8,3,2012-05-08 08:05:22,2012-05-07 15:04:06
0b0957a66109b545ded7332591b4fcb8f7e13fd0...464cf248fd05f76cd377298b98b82132c9088569,2,8,7,15,5,2012-05-08 08:05:24,2012-05-07 15:25:16
464cf248fd05f76cd377298b98b82132c9088569...722c08afecfc2a9cb737e711a2bcc5f1a64c2b08,2,20,4,24,5,2012-05-08 08:05:27,2012-05-07 19:21:48
76873c09053e210c7f739b1cda39cffd6ab865e0...1adf8c6a9c2c0d8b4936bfc35b84357b13f5a2b2,1,8,0,8,1,2012-05-04 20:52:38,2012-05-04 20:52:38
1adf8c6a9c2c0d8b4936bfc35b84357b13f5a2b2...674a198599aa3a77b7edff3f864e3e8779059e36,1,2,3,5,3,2012-05-04 23:05:14,2012-05-04 23:05:14
76873c09053e210c7f739b1cda39cffd6ab865e0...caea5e543379c053de5eec45b8f5a0e83c07e3fe,2,81,6,87,6,2012-05-03 20:31:29,2012-04-29 16:42:42
caea5e543379c053de5eec45b8f5a0e83c07e3fe...630c5a4a54bca28687f1c42117f830720f822fa6,3,27,0,27,5,2012-05-03 20:31:29,2012-04-30 12:29:34
a7d19b975a604b2800ba428a185895241313d1f6...19dd4e283370a3ccaf78e153fbf54c1830e44d3d,1,2,0,2,1,2012-04-25 18:42:33,2012-04-25 18:42:33
a7d19b975a604b2800ba428a185895241313d1f6...2bc8fa0227d549006a9870620ca1f2e08a0c305e,13,459,17,476,20,2012-04-25 17:42:37,2012-04-17 17:14:24
2bc8fa0227d549006a9870620ca1f2e08a0c305e...19fa2bc111d50dc2bafb1393b87b5ba119615ae2,12,215,152,367,119,2012-04-25 17:42:37,2012-04-17 22:12:50
19fa2bc111d50dc2bafb1393b87b5ba119615ae2...da3b391c32b973d5c073951b6848eedd40434e5e,3,27,58,85,20,2012-04-25 18:14:34,2012-04-18 17:57:08
da3b391c32b973d5c073951b6848eedd40434e5e...25f258e735f707075dc1b5cdd804540fe1e43f37,2,19,9,28,3,2012-04-25 18:14:34,2012-04-23 16:21:15
25f258e735f707075dc1b5cdd804540fe1e43f37...c16c8b9a7e7588f4ced41aa8f9787495f41fd918,2,112,44,156,32,2012-04-25 18:14:34,2012-04-23 16:23:58
c16c8b9a7e7588f4ced41aa8f9787495f41fd918...ada488bfe720d0df8187b5b58e326a13b7bdc678,1,548,0,548,1,2012-04-25 18:14:34,2012-04-24 18:02:40
ada488bfe720d0df8187b5b58e326a13b7bdc678...01fed0a8f9b80e80c8f76cde29fc0d66cb77fff7,13,433,202,635,151,2012-04-25 18:18:08,2012-04-25 17:36:01
01fed0a8f9b80e80c8f76cde29fc0d66cb77fff7...c2b670436f4cc8901811ae0348f3c56150d1ccd5,18,273,794,1067,109,2012-04-25 22:20:28,2012-04-25 22:20:28
442462232860d9106473fc832e37202eddb41b3e...c9340df055d97ca55a3a358f7e02416671db6278,2,72,0,72,2,2013-08-16 18:40:58,2013-08-16 18:40:58
6d69fbce31c391c7a7739f8156b0d63f399c53bf...86967cc579ee9e8c1a209a76c12605dd24dcf6cf,3,7,61,68,9,2013-08-19 21:44:17,2013-08-19 21:44:17
6d69fbce31c391c7a7739f8156b0d63f399c53bf...5875e8d21a1f2db8849e7babe7f0e2c7aee5a2a1,1,3,8,11,1,2013-08-19 16:50:03,2013-08-19 16:50:03
6d69fbce31c391c7a7739f8156b0d63f399c53bf...67c177ef26f25f4f7e5497393d075dde0f1b9415,1,1,3,4,2,2013-08-19 16:42:50,2013-08-19 16:42:50
5f9f69d983d7ebc2d9d29cf295e86f32ab12906d...e5ef0f18141409fc932d2c9cc0a42b769a880927,2,7,0,7,2,2013-01-31 19:23:30,2013-01-31 19:23:30
5f9f69d983d7ebc2d9d29cf295e86f32ab12906d...5f10853e90014ea9929a976f647f2a2d32a2c129,2,23,2,25,5,2013-01-31 02:52:47,2013-01-31 02:50:31
5f10853e90014ea9929a976f647f2a2d32a2c129...2234b2b03153c03fc6d502dd61ae55e659be4b8b,5,17,9,26,12,2013-01-31 03:03:58,2013-01-31 03:03:58
2234b2b03153c03fc6d502dd61ae55e659be4b8b...7602cb7c0ea0d69efd30640af234be20393bf57c,7,62,8,70,16,2013-01-31 18:44:57,2013-01-31 18:44:57
7602cb7c0ea0d69efd30640af234be20393bf57c...cf7038a65cb080a2946202fe6cbbe52aefae1fd4,7,149,18,167,21,2013-01-31 22:04:21,2013-01-31 22:04:21
cf7038a65cb080a2946202fe6cbbe52aefae1fd4...cd74cbba18db33091056b098889e82de598a6cdd,1,16,12,28,8,2013-01-31 22:38:22,2013-01-31 22:38:22
cd74cbba18db33091056b098889e82de598a6cdd...54ffc1f773369d797e4065fcd62719cd4c22c04c,3,28,0,28,7,2013-01-31 22:41:01,2013-01-31 22:41:01
54ffc1f773369d797e4065fcd62719cd4c22c04c...016179d6681255be0557040f7fd50a917e094fd8,1,16,3,19,5,2013-01-31 22:54:58,2013-01-31 22:54:58
016179d6681255be0557040f7fd50a917e094fd8...8c36a3cdba57ce5fb81d81dc3186f3ff9f2702f7,1,6,6,12,4,2013-01-31 23:24:59,2013-01-31 23:24:59
8c36a3cdba57ce5fb81d81dc3186f3ff9f2702f7...c4beee768135f70b91b2c0bfa1dbc99a58c1f311,2,14,10,24,6,2013-02-01 18:00:55,2013-02-01 18:00:55
c4beee768135f70b91b2c0bfa1dbc99a58c1f311...15760c598d57233820a68d2721643c637207a18e,1,2,1,3,2,2013-02-02 03:21:55,2013-02-02 03:21:55
15760c598d57233820a68d2721643c637207a18e...630146bd1b71cbb450f1fe658048ca8e25479105,2,12,8,20,5,2013-02-04 21:52:18,2013-02-04 21:52:18
96447d24f32052bf2755085eaab491e8f3ec9f56...5fb982066452b08da2434d5148c1539847dff838,2,14,0,14,2,2013-01-28 22:35:43,2013-01-28 21:56:04
329eee33871cc03133f5166a4e2908011f06b5b1...91f13a18d5e4b139f2ccc64467117a090d1faaf3,1,0,6,6,1,2013-02-01 19:23:26,2013-02-01 19:23:26
eddc1f1ed78898a4ca41480045b1d0d5b075e773...3736b64f0520f1fb0c79cf6ef29eeca7507c167c,1,1,1,2,1,2013-06-25 16:36:37,2013-06-25 16:36:37
3736b64f0520f1fb0c79cf6ef29eeca7507c167c...24ba6d3f8cec2524a3e18157dd9149bbfb654650,1,12,0,12,1,2013-06-25 20:55:13,2013-06-25 20:55:13
eddc1f1ed78898a4ca41480045b1d0d5b075e773...022a45e0848d4cc517889aaf55573bf5f5004662,1,1,2,3,1,2013-06-25 14:43:15,2013-06-25 14:43:15
022a45e0848d4cc517889aaf55573bf5f5004662...4753711235b817082460c2781749c27ef2d9bc78,1,3,0,3,1,2013-06-25 14:46:06,2013-06-25 14:46:06
eddc1f1ed78898a4ca41480045b1d0d5b075e773...edbaa63a7c3c319621b773bad5851b2b48c9d175,2,27,12,39,8,2013-06-25 07:04:04,2013-06-25 07:04:04
edbaa63a7c3c319621b773bad5851b2b48c9d175...9728cfde5f3685cb11302560a67754104d618ea2,1,7,0,7,1,2013-06-25 08:17:55,2013-06-25 08:17:55
453e6b3ec0dcf5c81de7fe219e587fa140b9c346...8d22773f4b2364b4cdc631a2d7db065834f80433,2,3,0,3,3,2013-11-05 16:30:11,2013-11-05 15:44:10
df0c89534d48ef38f1f1461ce1eff969983f43c8...cba285d32ff25a9244a8d33a5e2b1129020376b8,1,3,3,6,2,2012-05-07 20:32:30,2012-05-07 20:30:27
364f51bdca8cd5bb11bb322f8cac1b0d7dfcf686...7e000ab2ece977a028e3f1327de37342bef9f687,5,98,3,101,7,2012-05-08 22:03:59,2012-05-08 22:03:59
c99bdacf712d8993bb48c11e204492b4a4dd0990...b1e2ba275ad6089d7247fa02ddfcfcf14eb9a459,1,2,3,5,2,2012-05-08 21:43:52,2012-05-08 21:43:52
b1e2ba275ad6089d7247fa02ddfcfcf14eb9a459...fd5faae3466d3d74fd0601a1dac0ef0eaad48844,1,10,2,12,3,2012-05-08 21:55:37,2012-05-08 21:55:37
2c0cdc3a86acd917087937f6348062b3951217b5...19579847f6b4ee6942253f2a6311a936e4ac05ac,3,10,7,17,7,2012-05-08 20:23:00,2012-05-08 20:23:00
2c0cdc3a86acd917087937f6348062b3951217b5...3df9cc592220b1da73a1d4ac82847c3c6d92a1fa,1,6,6,12,3,2012-05-08 19:35:51,2012-05-03 14:07:22
3df9cc592220b1da73a1d4ac82847c3c6d92a1fa...a209a025c642498f1fa1aecf91ce9e9504d0d419,3,47,0,47,3,2012-05-08 19:36:40,2012-05-03 14:08:33
a209a025c642498f1fa1aecf91ce9e9504d0d419...baaa8a447ed6da152038770805464485d5d7bb21,6,20,12,32,14,2012-05-08 19:36:40,2012-05-03 18:25:56
d3a60dc24479a6077c21ecc3ae3e41b6d5557ff7...f95e8cc07c85034f737872455fce2895186be19d,1,11,19,30,6,2012-05-05 21:18:10,2012-05-05 21:18:10
3fc5c65d1a072fc727226cd66a1b096df4919da5...eb3d71a5bcd78cb4840e62194e8998141508af88,4,86,8,94,7,2012-04-25 22:37:17,2012-04-25 20:23:35
68458e422a6070d8f445eb6a4bfaac3310c330a3...ce23330fd636a99a25b3a6b7c81e63c424ae7d7c,2,31,1,32,3,2013-08-16 22:04:15,2013-08-16 21:34:51
ce23330fd636a99a25b3a6b7c81e63c424ae7d7c...579d87c5d352232671dcfda43ec153883c01fc6f,1,49,0,49,1,2013-08-16 22:04:15,2013-08-16 21:48:14
579d87c5d352232671dcfda43ec153883c01fc6f...944c1589c25e011537dd9162265cedeab363a103,2,218,1,219,2,2013-08-16 22:04:15,2013-08-16 21:49:38
944c1589c25e011537dd9162265cedeab363a103...0ea41445f4028460aefcd55cb37f10870ea9311c,2,39,0,39,9,2013-08-16 22:04:15,2013-08-16 22:03:15
25b2a555380a7b3066f3578c283a8f4d1d5dad12...238b761491bee6b03f95fca9037b8dff8cced7e7,3,119,32,151,8,2013-08-19 22:21:35,2013-08-16 18:31:24
de81aee3907e3737ad87e88e14b702f4b3bf12a6...fe95ac1b6750a29d4a132d265ec1d050f49b69e8,8,38,15,53,19,2013-02-05 18:59:58,2013-02-05 18:59:58
fe95ac1b6750a29d4a132d265ec1d050f49b69e8...b71bac9d2b1a3c4b87fdc808b13d9cd4b70ea978,1,5,1,6,1,2013-02-05 20:06:14,2013-02-05 20:03:41
b71bac9d2b1a3c4b87fdc808b13d9cd4b70ea978...42385c96d5b6e7382f3cf9663e9789f3c56f9d9d,1,22,0,22,1,2013-02-05 20:10:08,2013-02-05 20:10:08
42385c96d5b6e7382f3cf9663e9789f3c56f9d9d...def60ea4731368fa3624cb6cbdc704d3dfcbc458,3,3,3,6,3,2013-02-05 21:14:48,2013-02-05 21:14:48
def60ea4731368fa3624cb6cbdc704d3dfcbc458...ea57f66b5786704448152ebd95139802826bef1d,1,1,1,2,1,2013-02-06 19:02:29,2013-02-06 19:02:29
b0401c686788300bd4fb16cf395533458611eda1...c7974b49d04bc318d61a010d2c5d2e75095f410b,1,1,1,2,1,2013-06-26 19:03:33,2013-06-26 19:03:33
c7974b49d04bc318d61a010d2c5d2e75095f410b...c67ff958c4d8e37a717c77dd9cdb4bdfc88a6fd8,2,8,2,10,5,2013-06-27 14:38:27,2013-06-27 14:38:27
d0c36a0baf42d751c23e13df08c7ec9f800dd40f...1e9dd60f141cbe0c0eecf2628f7dd6f67d185b8d,2,76,2,78,3,2013-06-28 05:29:05,2013-06-28 05:29:05
74e06c05b54856e31009b8cbb54ea735ee439381...39b1ad7f15d19837b3a25690c796ac0a1ac2720e,4,16,1,17,7,2013-11-05 16:36:12,2013-11-05 15:14:20
6414fd338df89eaa5bd4c64f7ab310fb7d5758bb...fb190bbbd06952b369b4fb6c06fa827802671332,4,4,4,8,4,2013-11-12 11:46:25,2013-11-12 11:44:13
e65752bb3251f9a308fd4f9cb3b294c4f7d90783...0f49200c9a72f7d8144eb663dee2c684d52ef42a,7,33,18,51,19,2012-05-09 02:37:02,2012-05-09 02:37:02
eb3d71a5bcd78cb4840e62194e8998141508af88...d58336dda873704f8d12a8b78c3191deefa4ec14,6,103,33,136,28,2012-04-26 17:51:45,2012-04-26 17:51:45
eb3d71a5bcd78cb4840e62194e8998141508af88...3aa351ea0fa0d9e8d155801cdac1e83d3b1717c1,9,300,312,612,164,2012-04-26 13:38:42,2012-04-26 13:05:07
adf96282624b1528aeca05681c375125487a445d...8255b497b625735acab527f15617daa19f796165,1,1,1,2,1,2013-08-19 22:49:53,2013-08-19 22:49:12
f2c41884c3082984f51743d557644cfa2136b878...c4ac556ee7171ee206e11687907d5dbee3ce0a6d,6,8,10,18,10,2013-06-29 11:27:55,2013-06-29 10:48:58
c4ac556ee7171ee206e11687907d5dbee3ce0a6d...d90390c162418deb62302b3f56835ff781c0cfee,1,2,0,2,1,2013-06-29 11:38:27,2013-06-29 11:38:27
a6993f24bf7a2ecfec098347f3f9b2b49282f9e5...aad5403fe96a88689b9d22a732d464c64a72f8ff,2,10,10,20,9,2013-11-05 18:55:54,2013-11-05 18:55:54
42593a6965e50b194f48ca2bb857d5499d62b287...f6f7537cfd8041d407a4f3b6c350b012975be116,1,36,0,36,3,2013-11-12 23:24:05,2013-11-12 23:24:05
f6f7537cfd8041d407a4f3b6c350b012975be116...089297b2cd4f50a2218130f9f3a0ddceb86b8697,1,5,0,5,1,2013-11-12 23:24:59,2013-11-12 23:24:59
089297b2cd4f50a2218130f9f3a0ddceb86b8697...9db56cc4a78ee7799450cd3838af12124ccc4e8e,2,9,11,20,6,2013-11-13 02:57:16,2013-11-13 02:57:16
9db56cc4a78ee7799450cd3838af12124ccc4e8e...b20c40a8d6127a3ee9b807b2243e41bc8e85124c,2,7,5,12,3,2013-11-13 03:02:28,2013-11-13 03:02:28
b20c40a8d6127a3ee9b807b2243e41bc8e85124c...4320bec09bff4596ed0647eb2fcbedf19995f631,1,2,3,5,3,2013-11-13 03:02:34,2013-11-13 03:02:34
0f49200c9a72f7d8144eb663dee2c684d52ef42a...9cd25d0003ed483f40ade3542368a962437f10d2,1,1,1,2,1,2012-05-09 11:21:21,2012-05-09 11:21:21
0f49200c9a72f7d8144eb663dee2c684d52ef42a...a640d79e84b4bf1d3c601f1a8ccf369427005797,1,2,1,3,3,2012-05-09 11:11:50,2012-05-09 11:11:50
a640d79e84b4bf1d3c601f1a8ccf369427005797...0536afcaa9c27105b184d2fccac1a7b9e778f27c,1,4,0,4,1,2012-05-09 12:10:30,2012-05-09 12:10:30
0536afcaa9c27105b184d2fccac1a7b9e778f27c...11678b37183f3b13ad3b9eb4e4916a036d7a97d8,2,4,4,8,2,2012-05-09 14:18:13,2012-05-09 14:18:13
11678b37183f3b13ad3b9eb4e4916a036d7a97d8...b470019f7f5ae9604fd7e2fcb15bad4ecd80e475,1,2,2,4,2,2012-05-09 16:02:13,2012-05-09 16:01:23
631ba94e0e489d4baf4e289539a9acf084953c32...821f6bc7404122260a46796422c011105a33638f,6,20,18,38,13,2012-04-26 20:04:54,2012-04-26 20:04:54
821f6bc7404122260a46796422c011105a33638f...9738e2cd2c57aeaa474315108af2ac5556b93843,1,1,0,1,1,2012-04-27 21:30:08,2012-04-27 16:04:58
9738e2cd2c57aeaa474315108af2ac5556b93843...8af503bc85a92242bd698cca1e8594af909811c6,1,3,0,3,1,2012-04-28 18:49:05,2012-04-28 18:49:05
8af503bc85a92242bd698cca1e8594af909811c6...fdc0c5f6548b44d6fbe1eb9a0d38a8ef5aae2b86,1,4,8,12,2,2012-04-28 23:21:53,2012-04-28 23:20:02
fdc0c5f6548b44d6fbe1eb9a0d38a8ef5aae2b86...8b9ec201edf157f84735b8d220c10edafd9f4b5a,1,39,0,39,1,2012-04-28 23:38:36,2012-04-28 23:38:36
b88021463f9ca4ebffe8e2a5b15d4b09be465923...16b83019af63d837b6934bcf1b71b8697d5d94c8,6,184,184,368,112,2012-05-02 22:34:58,2012-03-05 07:28:36
16b83019af63d837b6934bcf1b71b8697d5d94c8...8b2bcfbe68ea9cb8f30018cc2607c9409ecf0fc0,1,6,1,7,3,2012-05-02 22:36:33,2012-03-05 17:14:56
8b2bcfbe68ea9cb8f30018cc2607c9409ecf0fc0...3fd99be98a91416dae77d65fe593965a0723fa8c,1,16,4,20,4,2012-05-02 22:36:38,2012-03-05 17:30:17
51a5e13347a0f834e2d847b46d2f6002f03bd49f...7c9f5bec5182eb587fbc1094f2235d2babb70ad9,2,19,1,20,2,2013-10-11 14:29:59,2013-08-17 05:11:31
51a5e13347a0f834e2d847b46d2f6002f03bd49f...fb23d05f0bc3084cdb5a9737b1c678817c5bc9e8,2,34,10,44,7,2013-09-06 17:56:51,2013-08-17 05:58:55
51a5e13347a0f834e2d847b46d2f6002f03bd49f...90a8ad63e3c861f15ad61379ed1355fd036ca6a7,1,1,1,2,1,2013-08-18 22:18:44,2013-08-18 22:18:44
51a5e13347a0f834e2d847b46d2f6002f03bd49f...d19dd9cf73f1ebec135faf9fd6e702b09d3ee723,1,3,1,4,2,2013-08-18 21:38:51,2013-08-18 21:38:51
5e1fb2828a496d70c5c200b01e2fb0062268f468...0f0f565507565520759bffc22976c583497ec01f,2,38,3,41,6,2013-08-20 23:14:23,2013-08-19 17:42:48
0f0f565507565520759bffc22976c583497ec01f...0b7cdc02637bcc8491153a476460c9feab33f8ee,4,701,0,701,4,2013-08-20 23:14:24,2013-08-20 22:18:48
0b7cdc02637bcc8491153a476460c9feab33f8ee...a4977169e1e1920ed33f10a77e5dd8706f103f4f,3,118,0,118,7,2013-08-21 21:09:38,2013-08-21 21:09:38
a4977169e1e1920ed33f10a77e5dd8706f103f4f...24c71f14b4dcb696d9d87330322c12fd2c185317,2,13,0,13,2,2013-08-21 21:10:27,2013-08-21 21:10:27
24c71f14b4dcb696d9d87330322c12fd2c185317...fe3727408001f9708aad09562ffae5b82c0f7171,2,514,496,1010,162,2013-08-21 23:26:32,2013-08-21 23:26:32
fe3727408001f9708aad09562ffae5b82c0f7171...b37359aac5b02f59c07b453b53191432abc0f942,2,17,4,21,11,2013-08-21 23:50:03,2013-08-21 23:50:03
b37359aac5b02f59c07b453b53191432abc0f942...e8c5eb5537cc58fa29d4ed48ab9114238ba4cab0,1,0,4,4,2,2013-08-22 05:44:56,2013-08-22 05:44:56
e8c5eb5537cc58fa29d4ed48ab9114238ba4cab0...3eecadcce583fd7e825e35e2b6f101071c2be613,1,21,10,31,10,2013-08-22 05:50:37,2013-08-22 05:50:37
3eecadcce583fd7e825e35e2b6f101071c2be613...8d9a85d43aa6ed7a9fb15a2ac9e0f9ba1c33461e,5,265,185,450,127,2013-08-22 18:40:53,2013-08-22 18:40:53
8d9a85d43aa6ed7a9fb15a2ac9e0f9ba1c33461e...2b6e1908476c95c84d3e3a62ac069f789156b070,1,7,4,11,2,2013-08-22 18:50:10,2013-08-22 18:50:10
2b6e1908476c95c84d3e3a62ac069f789156b070...972bb689c4a69ba5a5dfaeebacc7198622c4f051,4,62,5,67,10,2013-08-22 21:10:56,2013-08-22 21:10:56
972bb689c4a69ba5a5dfaeebacc7198622c4f051...eb868b1e98d7cea8796f9b92be04843a7f819e5e,2,19,2,21,4,2013-08-22 21:34:21,2013-08-22 21:34:21
eb868b1e98d7cea8796f9b92be04843a7f819e5e...b6ac07b51771641f3ae994c17f361fbd8bec36ef,5,18,12,30,10,2013-08-22 21:45:10,2013-08-22 21:45:10
b6ac07b51771641f3ae994c17f361fbd8bec36ef...805755f49b0db5bc884f8929621ac61238b2c30e,2,32,11,43,8,2013-08-22 22:44:34,2013-08-22 22:44:34
805755f49b0db5bc884f8929621ac61238b2c30e...44d655318661affa2feb51e9d6d533bb16d7f2b5,1,1,1,2,1,2013-08-23 19:03:44,2013-08-19 23:03:15
44d655318661affa2feb51e9d6d533bb16d7f2b5...430953417f74dfcdbe030bafc069e1c07edceeb6,6,103,26,129,19,2013-08-26 21:56:31,2013-08-26 21:56:31
430953417f74dfcdbe030bafc069e1c07edceeb6...2f368a661c55b49a8f15905c221f9e76935bedd0,2,2,2,4,2,2013-08-26 22:17:35,2013-08-26 22:17:35
2f368a661c55b49a8f15905c221f9e76935bedd0...f087bc245e9f3934d43c49f4034ee9b5638884dd,3,4,4,8,4,2013-08-27 19:08:55,2013-08-27 19:08:55
f087bc245e9f3934d43c49f4034ee9b5638884dd...b2d3efcbce2d12cfa9736ab4f9283c91600a8a75,2,39,20,59,14,2013-08-28 16:31:32,2013-08-28 16:31:32
5e1fb2828a496d70c5c200b01e2fb0062268f468...c0b01b7572232bd6c0cd848e9b92ed8a8d678bcf,2,12,0,12,4,2013-08-19 23:46:26,2013-08-19 23:46:26
c61300eda94eedb53f072fedbf1bb52be21ca221...278ce7468d3870bb18d69bd8177bae406d6cede4,4,12,2,14,4,2013-07-01 17:20:38,2013-07-01 17:20:38
278ce7468d3870bb18d69bd8177bae406d6cede4...55ededfd398b783fa4fbe54b8aa406c19228fbc6,2,22,16,38,8,2013-07-01 17:21:14,2013-07-01 17:21:14
c61300eda94eedb53f072fedbf1bb52be21ca221...0b170f4dcb7f9e47eb849035a505661dda2eb6f8,2,9,9,18,9,2013-06-30 22:56:54,2013-06-30 22:56:54
aad5403fe96a88689b9d22a732d464c64a72f8ff...a667ca8298193b3103c1dbdcb1f6c527e6e99eb2,4,7,7,14,7,2013-11-05 19:51:07,2013-11-05 19:51:07
aad5403fe96a88689b9d22a732d464c64a72f8ff...8adea28ae950e21d3579c0e7911567be4951c4c6,2,2,2,4,2,2013-11-05 19:44:42,2013-11-05 19:42:42
6481e06258608f46c2c45e74a8f9cf8c42347004...cfd16ca28e593d084350b497b06eac7cb7a6c240,2,3,3,6,2,2013-11-13 12:08:56,2013-11-13 12:08:56
cfd16ca28e593d084350b497b06eac7cb7a6c240...98eaf39a87164eeb284df5c0239c3a31dfb538e7,4,8,5,13,6,2013-11-13 19:12:31,2013-11-13 19:12:31
075d6e7dd7c8ecdcbb79ed944a014c153048801f...2aa1e94d3075426563303816dce596793756ea6c,1,1,1,2,1,2012-05-09 17:30:34,2012-05-09 17:30:34
8b9ec201edf157f84735b8d220c10edafd9f4b5a...39e6af6a7c526823b06f2c7bfe97c0c7bf9501d5,4,50,0,50,8,2012-04-30 16:24:14,2012-04-30 15:44:37
8b9ec201edf157f84735b8d220c10edafd9f4b5a...da3c187d5e3f8dae63014a4dab0dd2c72baed2d5,1,6,1,7,2,2012-04-29 17:16:26,2012-04-29 17:08:48
da3c187d5e3f8dae63014a4dab0dd2c72baed2d5...1d2dd864add4835c49744a566c226a1c7da04e99,5,74,45,119,39,2012-04-30 05:12:26,2012-04-29 17:42:51
1d2dd864add4835c49744a566c226a1c7da04e99...fa6420f73e8a621cc04e95820b625097b5c2fbf2,14,43,43,86,42,2012-04-30 05:12:37,2012-04-29 19:46:33
fa6420f73e8a621cc04e95820b625097b5c2fbf2...2de0652bb6d719eb937656153a920f20342bd5a4,1,14,8,22,3,2012-04-30 05:41:33,2012-04-30 05:41:33
2c2b0ebb4ab646a9f6a03d9bda176634e609b279...3acf44d6cb5e56fea379504c07ae7ac8dd0e586d,4,460,0,460,1,2013-10-16 20:20:04,2013-07-17 14:43:32
3acf44d6cb5e56fea379504c07ae7ac8dd0e586d...629b661caab321a3aa5ffd7274ea4ed441d2805e,6,687,47,734,23,2013-10-16 20:20:06,2013-07-17 14:49:56
629b661caab321a3aa5ffd7274ea4ed441d2805e...4f7897ab19daf6593b35c7f5b4f35403d00530ef,2,108,0,108,3,2013-10-16 20:20:08,2013-07-22 15:51:29
4f7897ab19daf6593b35c7f5b4f35403d00530ef...96d799aa1830f5fcbacdfd87eca728727561d8e6,2,381,2,383,6,2013-10-16 20:20:10,2013-07-23 22:32:42
96d799aa1830f5fcbacdfd87eca728727561d8e6...fc36800ecd8f8903f4cf7e40a54966855fdd4b76,1,21,27,48,12,2013-10-16 20:20:12,2013-08-08 18:16:13
fc36800ecd8f8903f4cf7e40a54966855fdd4b76...e47f859db9a52f38d9ca94d725a178ac4ba93836,2,201,30,231,14,2013-10-16 20:20:14,2013-08-08 21:46:49
e47f859db9a52f38d9ca94d725a178ac4ba93836...6f8cc7bb6a77e7b03751051be86a0c6b36bdd86f,1,9,8,17,5,2013-10-16 20:20:16,2013-08-06 01:06:09
6f8cc7bb6a77e7b03751051be86a0c6b36bdd86f...cfae7f85fbbc5b0e023e94f78486bf72cc1436f5,4,68,5,73,9,2013-10-16 20:20:18,2013-08-10 01:23:36
cfae7f85fbbc5b0e023e94f78486bf72cc1436f5...216f97e4f68c99c21d57a9196702df1f8f4366d4,4,234,71,305,47,2013-10-16 20:20:19,2013-09-23 13:47:47
216f97e4f68c99c21d57a9196702df1f8f4366d4...7fa73de16378ecfa484747d1b61656282923a88a,3,696,729,1425,16,2013-10-16 20:20:21,2013-09-23 21:52:40
7fa73de16378ecfa484747d1b61656282923a88a...c929d6b727cb35a681152ae2c7d6dfbaf971f829,2,41,38,79,16,2013-10-16 20:20:24,2013-10-09 22:26:42
32e49929725a76d9871038f30e2ea67fe0e4a4f8...e839efbe2468905d82ffb717c225a738de6f192c,1,2,0,2,2,2013-09-07 15:51:24,2013-09-07 15:51:24
32e49929725a76d9871038f30e2ea67fe0e4a4f8...a8d67afe42e6c79cb15383ceb1264f665dc4ad8d,2,16,6,22,2,2013-09-07 15:48:05,2013-09-07 15:21:41
a8d67afe42e6c79cb15383ceb1264f665dc4ad8d...1634df8c287da5acbe017ac786e2bb9fcd723eaa,1,3,11,14,3,2013-09-07 15:48:06,2013-09-07 15:31:30
8f81ea45ca107c992313f76ee73316f16751e64e...6818080871db227c2586a102306832b41ea1c0df,1,5,0,5,1,2013-08-19 08:50:28,2013-08-19 08:50:28
8f81ea45ca107c992313f76ee73316f16751e64e...3d2768747548ec24b58ebdaa012a6b757e65f5a0,5,37,7,44,10,2013-08-19 08:30:44,2013-08-19 08:30:44
6890e00c0ef531e4badec3458230a390262dec6e...9d85f00722c5161bda0727f5bb80d13d08ccb481,1,2,0,2,1,2013-08-24 07:39:15,2013-08-24 07:39:15
dbecec37a74a04a350e7c2ef6aee49d5d833d768...19b9a0920987f07d05040b3a067b1599e38f6013,1,2,0,2,1,2013-08-28 18:20:47,2013-08-28 18:20:47
7c559c2528d4c2e8e3f682208330e61b1ff7764a...f8ccd6c935f12c9c31754d22ba81352178980284,1,1,1,2,1,2013-07-02 18:23:54,2013-07-02 18:23:54
82cb8e236a07d8684c53aa8ee5b1c6195f788371...a3c062dbf8c8060b9f0cedc2855f506736d25c73,4,191,148,339,135,2013-07-09 16:58:33,2013-07-09 16:58:33
a3c062dbf8c8060b9f0cedc2855f506736d25c73...5813bc2194e9adefb2d7a25a5039c36879417c11,1,11,39,50,13,2013-07-09 19:01:16,2013-07-09 19:01:16
5813bc2194e9adefb2d7a25a5039c36879417c11...03d9b930ee6b90ab17f031e596ad6d15ee313ca8,1,15,15,30,9,2013-07-09 21:45:58,2013-07-09 21:45:58
03d9b930ee6b90ab17f031e596ad6d15ee313ca8...a4456929a8890a9ac1441db343c21040665ce253,1,8,12,20,5,2013-07-09 23:16:24,2013-07-09 23:16:24
a4456929a8890a9ac1441db343c21040665ce253...290e14798598922fbff7189f64f997bad35c4f84,3,36,1,37,3,2013-07-09 23:17:41,2013-07-09 23:17:41
82cb8e236a07d8684c53aa8ee5b1c6195f788371...2274993be5acf3a9fcf62abbf1f00d06fb513624,2,6,6,12,6,2013-07-09 10:52:25,2013-07-09 10:52:25
82cb8e236a07d8684c53aa8ee5b1c6195f788371...a5f9b5f8d8c2dbcd1bec92065e5df7bae76d3c7c,3,38,5,43,4,2013-07-05 23:59:38,2013-07-05 23:59:38
a8baf4b16058846eb56afaa1faea04fa41c4a4d4...73291aff6e695b13fa738c03cd344491c9ad24b3,1,3,1,4,2,2013-11-05 21:08:38,2013-11-05 21:08:02
7b947bf5cc59eefa83c28eb5f5fd8434207ebb8b...1782038144ef3413831801bb9c2f3038a84ac6f4,2062,0,0,0,0,2013-11-14 22:05:52,2013-11-14 22:05:52
1782038144ef3413831801bb9c2f3038a84ac6f4...83e1efbf462347dac3e1c884bb0b017d495b6f38,7,12,12,24,8,2013-11-14 22:10:32,2013-11-14 22:10:32
2aa1e94d3075426563303816dce596793756ea6c...1956693fa0b112daf07240b119190663e2987b3d,1,104,104,208,55,2012-05-09 19:14:49,2012-05-09 19:14:49
2aa1e94d3075426563303816dce596793756ea6c...dc34da6e8140c034c3673d0f82c896be9d66ef1c,1,71,1,72,4,2012-05-09 17:58:42,2012-05-08 20:50:40
dc34da6e8140c034c3673d0f82c896be9d66ef1c...db62807215cbe26b83a354954b7433aa5d90c149,2,37,16,53,7,2012-05-11 19:16:19,2012-05-11 19:16:19
0dc8e95e1940017a9d6e8f5b13cf9a9ad644fc08...4e7a3c76e73264895ffda6c5ed5d8b329a4bcf69,1,50,6,56,4,2012-04-30 22:33:25,2012-04-30 22:33:25
b2c9e41ae43dbd6674abd38a17d87d690c80d43e...20b5d300dce48ce34c16bf39752fae9a7d05f021,1,13,13,26,11,2013-10-17 07:28:08,2013-10-17 07:28:08
20b5d300dce48ce34c16bf39752fae9a7d05f021...e5e2710b781a3ebafceb2605f75182637ecfef0b,1,1,1,2,1,2013-10-17 08:52:20,2013-10-17 08:52:20
e5e2710b781a3ebafceb2605f75182637ecfef0b...caf9334115274e48b7eb9c96001037cebc57ad7a,1,1,1,2,1,2013-10-17 23:01:43,2013-10-17 23:01:43
ef6389ad504037e7a4311adbf14f1fa5a5aa4190...66566516ce5171111ea4c5a8160adb4b0b0dc675,10,18,18,36,18,2013-09-19 15:14:06,2013-09-08 09:15:42
ef6389ad504037e7a4311adbf14f1fa5a5aa4190...15f7b9b8d9bdfb68ca52d582be40cf6112464e77,4,79,5,84,8,2013-09-09 18:31:14,2013-09-07 22:52:26
ef6389ad504037e7a4311adbf14f1fa5a5aa4190...917e5fa9a18b42bb00140db9112e362bc810aa45,1,5,5,10,1,2013-09-08 22:31:56,2013-09-08 22:31:56
ef6389ad504037e7a4311adbf14f1fa5a5aa4190...fbabe855ad6f9a7b2a50a54d0d826d2e65538154,1,1,0,1,1,2013-09-08 02:11:08,2013-09-08 02:11:08
fbabe855ad6f9a7b2a50a54d0d826d2e65538154...b345026baaed21ffe8d325f784e597cf6bb779a6,1,1,1,2,1,2013-09-09 17:16:52,2013-09-09 17:16:52
ef6389ad504037e7a4311adbf14f1fa5a5aa4190...031f3f8028835c935d1e75ebd136aaaefffea821,4,99,3,102,9,2013-09-07 21:00:20,2013-09-07 20:39:05
6910ecb03689e4bd7c8f76bdba23ca425df69ddb...32614440561e2ccb33ee24462a120154e0009d08,1,1,1,2,1,2013-08-25 07:01:04,2013-08-25 07:01:04
6910ecb03689e4bd7c8f76bdba23ca425df69ddb...e52963080a1cc4c7cd7a921fd96d9656cc976022,1,0,4,4,1,2013-08-24 10:15:22,2013-08-24 10:15:22
19b9a0920987f07d05040b3a067b1599e38f6013...a12e069a3e904728d55dc5c92094b0a5cee63da2,2,264,3,267,4,2013-08-30 21:19:02,2013-08-30 14:31:52
a12e069a3e904728d55dc5c92094b0a5cee63da2...9b4ed214f484f22f127d7398467f45affcc014af,1,6,3,9,2,2013-08-30 21:19:02,2013-08-30 15:07:41
9b4ed214f484f22f127d7398467f45affcc014af...b1a6c316a6070fac4ab1ec5792979838f7145c39,3,87,38,125,18,2013-09-04 05:44:53,2013-08-30 15:36:00
19b9a0920987f07d05040b3a067b1599e38f6013...0001c0231607bd8bc9b09bde6c1d7d0fb396565f,1,1,1,2,1,2013-08-29 11:22:44,2013-08-29 11:22:44
19b9a0920987f07d05040b3a067b1599e38f6013...4ab6a759f63caa75ea716154887fc0a94de01b6e,1,1,1,2,1,2013-08-29 05:51:57,2013-08-29 05:51:44
4ab6a759f63caa75ea716154887fc0a94de01b6e...8b2f230cd519010d202c57185dc4dc39ca3d53f8,1,3,1,4,2,2013-08-29 11:27:37,2013-08-29 11:27:37
8b2f230cd519010d202c57185dc4dc39ca3d53f8...4218183631faa48f97e76a23e928d1a98983be46,1,8,14,22,4,2013-08-29 17:27:01,2013-08-29 17:27:01
6bb7bff274be004768ccedf76643383494e2a9dc...178aa39cc297cb2d1750bcff0a3839c6ac0840a7,1,34,40,74,15,2013-07-03 18:42:43,2013-07-03 18:42:43
6bb7bff274be004768ccedf76643383494e2a9dc...9b6075b25fb6fef570dd29c2b797db8bc34cf0b1,4,183,6,189,9,2013-07-03 15:22:12,2013-07-03 15:07:20
3eae9467e59241f5af6218ca079f96273fe1bc57...07fba63e9eda509d1eee13df0b325dbd4be2f3cd,1,10,3,13,2,2013-07-09 23:23:46,2013-07-06 21:51:40
07fba63e9eda509d1eee13df0b325dbd4be2f3cd...7b5c0d18460b6cb0a65543b92002a29644dbb458,2,49,9,58,7,2013-07-09 23:45:23,2013-07-09 23:45:23
7b5c0d18460b6cb0a65543b92002a29644dbb458...e4fda954d6d914609498fc3bcbd27b4e2b5834d3,1,5,11,16,2,2013-07-09 23:46:18,2013-07-09 23:46:18
73291aff6e695b13fa738c03cd344491c9ad24b3...7616b8d3ce8d75b8221aa81f048178ef13c93c05,1,1,1,2,1,2013-11-05 23:35:50,2013-11-05 23:34:45
845eed800a85b0c51cead6c17e3cb4013564fb37...a0f13ffaeecc6d6958e9321473e621db3b6d57eb,1,3,0,3,1,2013-11-15 14:33:23,2013-11-15 14:32:52
4374f1871fb68365e612ae4c6be03e6149604435...a9d9965b35710f865d77a13da1cf084d0c870b55,1,8,6,14,5,2012-05-09 20:55:01,2012-05-09 20:54:24
b72969e0643cb561b42aceec4d1a18ce9c782c09...0b86fdf96e562d799ae8b1f73b7e128d0a00c3ee,1,3,0,3,1,2012-05-15 15:09:34,2012-05-15 15:03:07
b72969e0643cb561b42aceec4d1a18ce9c782c09...87fe3507bb3e254e7de7298f8b4f1479b1224475,1,3,0,3,1,2012-05-13 17:09:57,2012-05-13 17:09:25
b72969e0643cb561b42aceec4d1a18ce9c782c09...7327a090e240dd14d2fa13837c4de523509aa8b0,1,111,0,111,1,2012-05-13 12:14:08,2012-05-13 10:21:00
b72969e0643cb561b42aceec4d1a18ce9c782c09...6ca9643c967cb2de89ba360eb226ec49d27345a4,3,120,16,136,13,2012-05-13 09:28:49,2012-05-06 19:00:20
6ca9643c967cb2de89ba360eb226ec49d27345a4...f0b350eb52866a88e762760d4d169beb60370fb0,1,5,4,9,4,2012-05-13 09:28:49,2012-05-07 09:48:39
b72969e0643cb561b42aceec4d1a18ce9c782c09...48ce97dd968f7eb8af1bb46b043dc1ae1bdf1b46,1,10,0,10,1,2012-05-13 09:03:29,2012-05-13 09:03:29
b72969e0643cb561b42aceec4d1a18ce9c782c09...341a7136f6c38da008544137d2dcc39cfc846279,2,16,1,17,2,2012-05-13 08:30:13,2012-05-13 08:17:52
b72969e0643cb561b42aceec4d1a18ce9c782c09...24634c6fd02b2240e4a93fad70a08220f8fb793a,24,505,10,515,28,2012-05-12 18:50:19,2012-05-12 18:01:39
b72969e0643cb561b42aceec4d1a18ce9c782c09...b15bef2301f451b6be86207e753f70a902cb3365,1,1,1,2,1,2012-05-12 09:12:42,2012-05-12 09:12:42
960d778619f60eebda2d9b18a40d21495ad03f6b...52877c897504ed610bc957b88b6ba9e442077c07,1,1,0,1,1,2012-05-01 13:13:14,2012-05-01 12:28:18
901c34f233cf49c75a1fa9a4a7e97cfe5b87269e...2648dc1a06f5431552ae272432207d456232c1e5,4,39,22,61,14,2013-10-21 19:02:36,2013-10-21 16:03:31
92d19d16711c059c768063956abd31db346d2e7b...07fb67f90e79ecf35672008fed262a7db41d9790,3,6,6,12,6,2013-09-22 03:59:35,2013-09-22 03:55:39
92d19d16711c059c768063956abd31db346d2e7b...1b57699a3a6245bce3b98f73286b7a904c4bbd66,2,2,2,4,2,2013-09-22 01:38:51,2013-09-22 01:11:43
6c38e60a00ad9133b98f6c6b4e73054226c1f88a...8cf805253407e35627aa86f79b17070279106322,3,3,3,6,3,2013-09-11 18:13:59,2013-09-11 18:13:59
5fb1f9f2040df47ace275ab974b41d00883aef75...4dfe38205b7ddd255c87ff4656720072991fc432,2,13,12,25,5,2013-09-09 17:24:48,2013-09-09 17:24:48
e0b4a8ac33e9e5903422580bd07938c9bff70e79...62020aa8f999a89df8458dbf50540eb1aee5c97b,1,121,0,121,1,2013-09-09 18:01:30,2013-09-02 00:01:40
62020aa8f999a89df8458dbf50540eb1aee5c97b...e8fa14d3a33cb468b5559bf656d4fde4957c7c1a,1,1,1,2,1,2013-09-09 18:01:30,2013-09-03 17:11:50
e8fa14d3a33cb468b5559bf656d4fde4957c7c1a...24d23220969a976c9a6ede2993837715824cac64,1,11,2,13,4,2013-09-09 18:01:30,2013-09-04 16:34:03
24d23220969a976c9a6ede2993837715824cac64...813937ce4e99f8ba208548ef557a776bbc7029f9,1,20,7,27,8,2013-09-09 18:01:30,2013-09-04 16:42:47
813937ce4e99f8ba208548ef557a776bbc7029f9...9a0e42c673e4c37ef31c2ff9204c547d85b8afda,1,0,3,3,1,2013-09-09 18:01:30,2013-09-04 16:43:14
9a0e42c673e4c37ef31c2ff9204c547d85b8afda...04fd266584e2c82ca6069205ab7bbe4fa0b465c8,1,1,2,3,2,2013-09-09 18:01:31,2013-09-04 16:44:12
04fd266584e2c82ca6069205ab7bbe4fa0b465c8...b2395a826780c84640c3bd5d3ccec51d34086524,1,4,4,8,2,2013-09-09 18:01:31,2013-09-04 16:49:10
b2395a826780c84640c3bd5d3ccec51d34086524...0c52b204c5a792cb9515e93fdea35811ae09807b,1,4,0,4,2,2013-09-09 18:07:17,2013-09-09 18:07:17
e0b4a8ac33e9e5903422580bd07938c9bff70e79...f313843c8a3e9716d030ad0c23ce2194034c7f59,2,3,3,6,2,2013-09-09 17:53:22,2013-09-09 17:53:22
a6ee166111f2c76ad755b55925a46a04008f2402...273ddc54f5818b73725298f17915a307bd7c884b,1,1,1,2,1,2013-09-12 11:54:22,2013-09-12 11:50:00
273ddc54f5818b73725298f17915a307bd7c884b...6f2003612c27ffbcc865059e57e257ed92acb722,2,1,2,3,2,2013-09-12 11:54:33,2013-09-12 11:50:35
a07db1a1e03c42da5e9132c86776cb5c1ab89214...504850cdf56190a61782abfec37f3533b42d769e,4,37,0,37,4,2013-08-26 05:04:10,2013-08-25 12:59:50
e98535923b7f5aeaaaca3fbfbdf69da8f109b495...f42d546c632d0458503efd01390bac76c185ebef,1,2,1,3,1,2013-09-04 20:07:42,2013-09-04 20:07:42
f42d546c632d0458503efd01390bac76c185ebef...61d57b7a21b2ac5ca7a763a1b768481926f56014,1,70,1,71,2,2013-09-04 21:27:59,2013-09-04 21:27:59
0001c0231607bd8bc9b09bde6c1d7d0fb396565f...a402179ae58c9954794bb6b172a30249d6be6127,1,1,1,2,1,2013-08-31 13:25:25,2013-08-31 13:25:25
0001c0231607bd8bc9b09bde6c1d7d0fb396565f...d45e9480e74c3c6249aea631394e1364b138e66e,2,14,5,19,7,2013-08-31 10:22:50,2013-08-31 10:22:50
0001c0231607bd8bc9b09bde6c1d7d0fb396565f...e68938e0b98fac52da20171f33ca3abfdbf3f434,1,1,2,3,1,2013-08-31 10:19:44,2013-08-31 10:19:44
4ae29053d51968cbf49f30ae14e5405cbd9543cc...219f318c051a37c05dd66687695ebec9f1a90e53,1,4,2,6,2,2013-07-03 20:10:05,2013-07-03 20:02:29
219f318c051a37c05dd66687695ebec9f1a90e53...f6bd0863352f70905b3068284f8ccd6beaa9a590,1,1,1,2,1,2013-07-03 20:10:05,2013-07-03 20:02:44
f6bd0863352f70905b3068284f8ccd6beaa9a590...367c1903e9aefd07de0d5be98c56640d13e3420d,1,16,9,25,5,2013-07-10 07:33:14,2013-07-10 08:29:09
367c1903e9aefd07de0d5be98c56640d13e3420d...08bf80fa2bf95e17af79a1da5832aefb275d9565,1,92,90,182,77,2013-07-10 07:42:28,2013-07-10 08:29:32
4ae29053d51968cbf49f30ae14e5405cbd9543cc...2a16914c35fe52785959647666da145be354b12f,5,12,85,97,13,2013-07-03 19:20:34,2013-07-03 19:20:34
bf3ee3cf3130d50cb1813c3ec31993a96dae0607...d39fff36484e908438beb17ee043689962182460,2,59,1,60,2,2013-07-10 18:50:31,2013-06-24 03:33:57
d39fff36484e908438beb17ee043689962182460...d2ce27dd494b65f54b2d110b4defd69aea976115,9,1062,96,1158,67,2013-07-10 18:50:31,2013-06-25 06:16:06
d2ce27dd494b65f54b2d110b4defd69aea976115...0d44d3dc84d6996c72d49e6bb8036b9c8edec9e0,1,50,3,53,6,2013-07-10 18:50:32,2013-06-25 06:21:23
0d44d3dc84d6996c72d49e6bb8036b9c8edec9e0...d0628e2feeaeebf78a6b67fa4ca3fc658aa4744a,1,146,62,208,22,2013-07-10 18:50:32,2013-06-25 22:39:13
d0628e2feeaeebf78a6b67fa4ca3fc658aa4744a...8ba0ff69725251fa375520d9c69c8a053725c4b6,2,107,1,108,2,2013-07-10 18:50:32,2013-06-25 22:39:44
8ba0ff69725251fa375520d9c69c8a053725c4b6...f094f9052fba43707cb5662a362511eeea4c4af5,3,46,10,56,11,2013-07-10 18:50:32,2013-07-01 22:41:01
f094f9052fba43707cb5662a362511eeea4c4af5...f44c4fa108ff7e326607812246c3c056c1b901cc,1,55,3,58,5,2013-07-10 18:50:32,2013-07-01 22:41:32
f44c4fa108ff7e326607812246c3c056c1b901cc...2b3bd8ecd88a403f9d034aa3a4d1e14c5e904255,1,5,2,7,4,2013-07-10 18:50:32,2013-07-03 21:53:39
2b3bd8ecd88a403f9d034aa3a4d1e14c5e904255...5a169711fa9875bc98c30c49b5e9ea06ebbbcfeb,1,5,2,7,2,2013-07-10 18:50:32,2013-07-03 22:08:54
5a169711fa9875bc98c30c49b5e9ea06ebbbcfeb...733c4f3aca212d90459fb21cfbc137f09ff6c951,1,4,4,8,2,2013-07-10 18:50:32,2013-07-03 22:12:14
733c4f3aca212d90459fb21cfbc137f09ff6c951...a8b5f116bc39f884c8888adae2fd3f9b96d972c0,3,106,40,146,20,2013-07-10 18:50:32,2013-07-04 00:00:50
a8b5f116bc39f884c8888adae2fd3f9b96d972c0...bc6f0839ebd5794c99d5b488d431188a162a064d,1,112,14,126,13,2013-07-10 18:50:32,2013-07-05 22:22:21
bc6f0839ebd5794c99d5b488d431188a162a064d...9abc78ae6157167682f061b4f73eea51ab7d7342,3,12,24,36,11,2013-07-10 18:50:32,2013-07-08 04:56:11
9abc78ae6157167682f061b4f73eea51ab7d7342...3e96ecf219bd9b84c3a7faec61e818766f60e0d9,1,46,29,75,13,2013-07-10 18:50:33,2013-07-08 16:53:24
3e96ecf219bd9b84c3a7faec61e818766f60e0d9...6fc5a58197bf04e1b5c6ca1bdb5765e90d3eb106,2,156,0,156,2,2013-07-10 18:50:33,2013-07-09 05:42:02
6fc5a58197bf04e1b5c6ca1bdb5765e90d3eb106...2b672d5b646edf94ae315a9f968611ff65508c90,8,404,77,481,47,2013-07-10 18:50:33,2013-07-09 05:46:36
2b672d5b646edf94ae315a9f968611ff65508c90...406dd556e20117b3cc2e5c53410d65314fd14056,1,22,39,61,9,2013-07-10 19:05:47,2013-07-10 19:05:47
e87d9d3d4d8de9c048476387931c4ac57d1c2b73...cc2447da32a20f5d089125839555ed0fe2a05592,3,32,2,34,7,2013-11-07 14:43:24,2013-11-06 23:41:08
e87d9d3d4d8de9c048476387931c4ac57d1c2b73...0fe522d1057aef064084a22d116f7c225948a3bd,10,25,21,46,20,2013-11-07 13:16:20,2013-11-07 13:16:20
0fe522d1057aef064084a22d116f7c225948a3bd...99feb98897fa1daa0ff3fd70b17ccc9d9a51f1d0,2,14,2,16,4,2013-11-07 15:22:49,2013-11-07 15:22:49
99feb98897fa1daa0ff3fd70b17ccc9d9a51f1d0...40b99d05b4a1221768c25c889180c12d2f43be8b,10,68,25,93,22,2013-11-08 11:14:31,2013-11-08 11:14:31
40b99d05b4a1221768c25c889180c12d2f43be8b...886cc447389da78885a909a96b43ddbe67c9807f,1,1,1,2,1,2013-11-08 14:42:52,2013-11-08 14:42:52
872094441c165446a7bb989c0f215e1a4018218e...10b6678f9495b2b4b7f4885ea0bcd88c5e16a7fe,1,0,4,4,3,2013-11-19 10:57:32,2013-11-19 10:57:32
872094441c165446a7bb989c0f215e1a4018218e...80fc7d6bf08834acc5696c8f0c73680236f84375,4,89,37,126,35,2013-11-18 17:56:34,2013-11-13 21:46:45
80fc7d6bf08834acc5696c8f0c73680236f84375...84efffc33ab352d68cf981da0d6c8d358244cabc,4,87,4,91,18,2013-11-18 17:56:35,2013-11-13 21:57:51
a9d9965b35710f865d77a13da1cf084d0c870b55...ec42eafd4adea021d86c6fa2cbde92b87177bf3d,5,12,6,18,5,2012-05-10 16:52:49,2012-05-10 05:30:57
ec42eafd4adea021d86c6fa2cbde92b87177bf3d...54bdc64a92bbef7fcc311fa00e38e32cb0bc71e5,1,1,1,2,1,2012-05-11 00:13:06,2012-05-10 07:37:03
54bdc64a92bbef7fcc311fa00e38e32cb0bc71e5...b1ec25facc4fe0cf7633e05f340e689c9f728ed0,1,1,1,2,1,2012-05-11 00:16:38,2012-05-11 00:16:24
b1ec25facc4fe0cf7633e05f340e689c9f728ed0...6fb1c0b489c49b761eeddd655dd01e61d402722d,2,29,6,35,13,2012-05-12 16:51:32,2012-05-10 06:45:55
6fb1c0b489c49b761eeddd655dd01e61d402722d...212eb09d5fdf04018478eb375df369f9e7e56b66,1,11,0,11,1,2012-05-14 06:12:51,2012-05-14 06:12:51
a9d9965b35710f865d77a13da1cf084d0c870b55...fb49bdf9c7837892154bf7efdb3db6c3ec63e396,1,5,2,7,1,2012-05-10 14:52:12,2012-05-10 14:52:12
9bd5a99fea4757e5a17412b81eb5a9223437ebdc...cedf9ca955144c04b87209fd07d1a8763ed4e00d,3,0,472,472,3,2012-05-16 17:24:35,2012-05-16 17:16:35
cedf9ca955144c04b87209fd07d1a8763ed4e00d...eb270884627a87a5392c0aa9c9d286877aba9f91,1,0,1,1,1,2012-05-16 17:24:35,2012-05-16 17:17:32
eb270884627a87a5392c0aa9c9d286877aba9f91...9d0011fd83ff38561e75667451d2b6a55320d7d4,6,17,14,31,13,2012-05-16 17:24:35,2012-05-16 17:23:47
e49cb1687e7400aeccac161a1b080fdc23897522...1093e2de22f6ca245b09d758a3510899a8362048,1,5,1,6,1,2012-05-14 18:22:50,2012-05-11 02:25:23
1c3a5a03020f72481098780e81fc2c79a0b733db...79fdde494f26cda54e7ed285e7ad82eef51245e1,1,1,5,6,1,2012-05-14 20:15:53,2012-05-14 20:15:53
1c3a5a03020f72481098780e81fc2c79a0b733db...86ecd84427b96595338d510346e7e01bf29d4266,3,252,37,289,22,2012-05-14 20:07:42,2012-05-08 15:58:40
546ca93993ac224d1e66f20412a2f23bcc3d48ed...0c9a5565f7f4fdf70c72c5a92a1deeef7aaac6e3,3,9,9,18,9,2012-05-14 17:56:35,2012-05-11 02:12:18
52877c897504ed610bc957b88b6ba9e442077c07...42ea35c06157a5c75cfd20e8fe3a813140c26485,2,13,8,21,5,2012-05-01 23:06:49,2012-05-01 20:25:43
86774742a9bd3f3d4fc37ab35b2800abffeccfd8...98fec8a937b93c6a6a0ad35ccd04af4cfeae1767,2,21,0,21,2,2013-10-22 14:06:12,2013-10-22 14:05:47
10edb7a92a6d9b886f3dea083dba0aaba1851200...53e0636cbd5cc709c7658223917598000df8e376,1,95,94,189,6,2013-09-25 03:06:05,2013-09-24 08:43:06
10edb7a92a6d9b886f3dea083dba0aaba1851200...e3f3868a1c4ced6109cbd4644cb1e3e8e9d8a5e9,3,3,3,6,3,2013-09-24 15:04:14,2013-09-24 15:04:14
10edb7a92a6d9b886f3dea083dba0aaba1851200...1ca3e49f889a3732922e6f2b303dfe0d9f74300a,3,11,9,20,6,2013-09-24 04:41:43,2013-09-23 20:34:01
1ca3e49f889a3732922e6f2b303dfe0d9f74300a...713793133f65569561c6ca518f61acdddd1d3b65,2,12,4,16,2,2013-09-24 04:41:52,2013-09-23 20:40:23
713793133f65569561c6ca518f61acdddd1d3b65...00e859279e361734aa38adfbbb16d25af0be8bda,2,7,4,11,4,2013-09-24 04:52:42,2013-09-24 04:52:42
00e859279e361734aa38adfbbb16d25af0be8bda...a3c2d916d8ad67196d2211b0a88dcbab7a433764,1,1,1,2,1,2013-09-24 04:59:32,2013-09-24 04:59:32
a3c2d916d8ad67196d2211b0a88dcbab7a433764...634f10f69090b325a50c8bca6cb303397576305e,5,47,18,65,15,2013-09-24 17:11:20,2013-09-24 17:11:20
634f10f69090b325a50c8bca6cb303397576305e...d005885f0a7184629290dfcebed025b061551b40,1,5,5,10,4,2013-09-24 17:20:16,2013-09-24 17:20:16
10edb7a92a6d9b886f3dea083dba0aaba1851200...106c12f11873d270eb2c8b25bd82eaade0092e31,2,29,58,87,19,2013-09-23 20:31:15,2013-09-23 20:31:15
38859f293720a960acaf7f426c683ab1a71b18c6...d0cd6c427a35b257373c7178d1e17d82001e125f,4,25,13,38,15,2013-09-10 20:36:10,2013-09-08 16:22:28
d0cd6c427a35b257373c7178d1e17d82001e125f...209f9b67c4f9b2c5bba26f2bdcbee10cf4e25a6b,2,37,2,39,4,2013-09-10 20:36:13,2013-09-08 16:25:17
25803c632d2230c045d454ef8d86a34203e55aee...4e01e3029b389dc45a040b794ceeeb0cbe32004a,1,3,1,4,2,2013-09-13 19:21:33,2013-09-13 19:21:33
4e01e3029b389dc45a040b794ceeeb0cbe32004a...d7fc2eb29b4574b96b190572470bfcb7dab9d078,1,2,1,3,2,2013-09-13 19:36:39,2013-09-13 19:36:39
ba7cc8d2f714875736a3c6f5e9cc720170a2166e...1ff3a094156baba11240f48924dd5e0c1d983d8e,5,41,29,70,11,2013-08-28 00:44:35,2013-08-28 00:41:44
ba7cc8d2f714875736a3c6f5e9cc720170a2166e...b83c92dd6fe11adae0ff29e1db381c31f0f88cb7,1,2,0,2,1,2013-08-27 14:57:15,2013-08-21 11:16:17
b83c92dd6fe11adae0ff29e1db381c31f0f88cb7...44bc0c6ac3b939d3dfc1102be77e82e00e919ae4,1,4,1,5,2,2013-08-27 14:57:16,2013-08-21 11:20:17
44bc0c6ac3b939d3dfc1102be77e82e00e919ae4...ece24ef7c4bb31eb2c715948bcf6dff6ed9d7dfc,3,8,2,10,4,2013-08-27 14:57:17,2013-08-21 11:37:21
ece24ef7c4bb31eb2c715948bcf6dff6ed9d7dfc...c9ffa84bde45021c40623553822916fb3d13b20a,3,51,8,59,12,2013-08-27 17:31:19,2013-08-21 14:04:25
c9ffa84bde45021c40623553822916fb3d13b20a...191adce8751e728111a3b1c3e9b2c02fe9f5d775,4,12,6,18,6,2013-08-27 18:14:07,2013-08-27 18:00:28
191adce8751e728111a3b1c3e9b2c02fe9f5d775...aec87f712fd1e84038d5d14b83a97d78e2e1b1ad,2,12,4,16,7,2013-08-27 18:14:10,2013-08-27 17:14:18
1ef05e3f0ea8fa8db2167307101c8c43d1c1784b...17c7fbf6d276443344c54f55800367b9837c0259,5,102,3,105,6,2013-08-28 13:30:19,2013-08-21 19:07:53
61d57b7a21b2ac5ca7a763a1b768481926f56014...cf94024c589591e9a5c46a71f8fdce9f8b467161,5,117,59,176,19,2013-09-04 23:23:00,2013-09-04 18:42:48
cf94024c589591e9a5c46a71f8fdce9f8b467161...780f3e540fa6492b244ef2750a71e39407526c1e,3,21,6,27,10,2013-09-04 23:23:00,2013-09-04 23:13:18
780f3e540fa6492b244ef2750a71e39407526c1e...abfed59c2797e9436f2b20fadecd982d6637dc22,1,2,2,4,2,2013-09-04 23:23:00,2013-09-04 23:21:18
abfed59c2797e9436f2b20fadecd982d6637dc22...2a54c7f447acfc74368a766369a9923ecdf19b21,1,5,5,10,3,2013-09-04 23:24:36,2013-09-04 23:24:36
2a54c7f447acfc74368a766369a9923ecdf19b21...9ce4f7da4a69b3853da587b67e8f137ddf036e4c,3,20,13,33,13,2013-09-04 23:41:34,2013-09-04 23:41:34
9ce4f7da4a69b3853da587b67e8f137ddf036e4c...27061b151a7e0225186365ee0b5ca802d68782a9,3,3,6,9,4,2013-09-05 17:25:16,2013-09-05 17:25:16
27061b151a7e0225186365ee0b5ca802d68782a9...f240acce865ec14df0d517d5000316a933e7ffed,6,20,20,40,16,2013-09-05 18:20:12,2013-09-05 18:20:12
f240acce865ec14df0d517d5000316a933e7ffed...c97d407d9cc54fc99af0a57e09e04e9e0bc68cb6,3,24,18,42,10,2013-09-05 18:45:29,2013-09-05 18:45:29
c97d407d9cc54fc99af0a57e09e04e9e0bc68cb6...af22dabb4366f8b2dd4acd5725a25e88842d6938,2,4,7,11,2,2013-09-05 19:01:17,2013-09-05 19:01:17
af22dabb4366f8b2dd4acd5725a25e88842d6938...a7fcc44dcf3b2925ba366543486afd102b41838c,6,8,8,16,6,2013-09-05 23:14:32,2013-09-05 23:14:32
749871c24068157def699b3455fe27f893f28aa6...f2cda906e515bd4cb0cfe244652d764fdabbe23b,1,1,1,2,1,2013-08-31 15:42:38,2013-08-31 15:42:38
ac2e7dc6fb8edf6338aeed659ea179f0cffc32fd...d6d523486c26f8f10cd687fa2aa328c770650288,1,7,33,40,3,2013-09-01 17:00:16,2013-09-01 16:30:11
d6d523486c26f8f10cd687fa2aa328c770650288...255836ddac05418f6bb2d68d27f5ff290669e2a9,6,45,33,78,8,2013-09-01 17:00:16,2013-09-01 16:35:39
255836ddac05418f6bb2d68d27f5ff290669e2a9...5c37f00505bf00c14468813d94df69f3387f15b3,1,15,0,15,1,2013-09-01 17:00:16,2013-09-01 16:59:42
ac2e7dc6fb8edf6338aeed659ea179f0cffc32fd...82b2fc2c8325830667ed780ae5402674c7b9bbf5,1,4,2,6,3,2013-09-01 16:45:36,2013-09-01 16:45:36
82b2fc2c8325830667ed780ae5402674c7b9bbf5...b1447edebc15de58f46e5863e59acb7b4988f304,1,1,1,2,1,2013-09-01 16:47:56,2013-09-01 16:47:56
b1447edebc15de58f46e5863e59acb7b4988f304...3b75b684a1ac32cbf726cc3d647453a769b8dfe4,1,5,0,5,1,2013-09-01 16:53:07,2013-09-01 16:53:07
3b75b684a1ac32cbf726cc3d647453a769b8dfe4...01cd5ae3772a32b29c6bd1cdc1cdc50d98961c1c,1,22,0,22,1,2013-09-01 17:48:01,2013-09-01 17:43:35
68bc49a158eb905d541f853c913dfc20916ef665...c2de6b1adf49f8588dd59188774c96b783181e2f,2,73,81,154,34,2013-07-10 17:21:24,2013-07-10 17:21:24
c2de6b1adf49f8588dd59188774c96b783181e2f...33c8c6f0b81badadf805d18f39f79384a6494bac,1,1,1,2,1,2013-07-10 17:48:32,2013-07-10 17:48:32
c0e529f379ded1311c7d8caba4af7c20c540c987...0105b55e8f7e4d8194400b341b6e0425182ff636,1,39,0,39,1,2013-07-10 19:14:12,2013-06-27 22:26:31
0105b55e8f7e4d8194400b341b6e0425182ff636...12f8fe0054505d6c3228a5186516f7c5f28d5165,1,23,5,28,8,2013-07-10 19:14:12,2013-06-27 22:43:12
12f8fe0054505d6c3228a5186516f7c5f28d5165...49621a34af7160d4afbf08a5be15e0e4f3a47791,1,1,0,1,1,2013-07-10 19:14:12,2013-06-27 22:46:46
49621a34af7160d4afbf08a5be15e0e4f3a47791...3e7d7100e2be8f6c1fe290842ee9a19b854a7046,1,13,6,19,6,2013-07-10 19:14:12,2013-06-27 23:12:00
3e7d7100e2be8f6c1fe290842ee9a19b854a7046...4535f04409a9379ace7cdda0b53a62d3cdf20676,1,150,0,150,1,2013-07-10 19:14:12,2013-06-27 23:12:44
4535f04409a9379ace7cdda0b53a62d3cdf20676...41f1f9d732a7cdd50d58948224ca0693a68995dc,2,14,0,14,2,2013-07-10 19:14:13,2013-06-27 23:52:00
41f1f9d732a7cdd50d58948224ca0693a68995dc...e807860fa9b5278932a0ba25f84b4035b0ebda84,3,77,26,103,24,2013-07-10 19:14:13,2013-06-27 23:52:38
e807860fa9b5278932a0ba25f84b4035b0ebda84...302a04b09ca706eeda9b8cceb50694f37973e348,2,8,0,8,2,2013-07-10 19:14:13,2013-06-29 19:41:39
302a04b09ca706eeda9b8cceb50694f37973e348...3fe046cfdba414f69b09e76da2a550be96eeab7e,3,74,10,84,13,2013-07-10 19:14:13,2013-06-29 20:13:38
3fe046cfdba414f69b09e76da2a550be96eeab7e...1aad6137d218830bc280c4327595182019164515,3,336,334,670,110,2013-07-10 19:14:13,2013-06-29 20:16:33
1aad6137d218830bc280c4327595182019164515...2e3e273e33894bc1089cfc09d89bd2cb144b108d,2,8,13,21,6,2013-07-10 19:14:13,2013-06-29 20:20:45
2e3e273e33894bc1089cfc09d89bd2cb144b108d...f9775a37aa4ed042839a6b2f9d8e0dfbd73a2f09,9,246,123,369,47,2013-07-10 19:15:03,2013-06-30 06:22:31
f9775a37aa4ed042839a6b2f9d8e0dfbd73a2f09...b8df28a5dae65b617ce85e1937066093600880af,1,1,1,2,1,2013-07-10 19:15:03,2013-06-30 15:38:10
b8df28a5dae65b617ce85e1937066093600880af...9564229af42b68d205376853410c55b957546a14,1,29,0,29,2,2013-07-10 19:15:03,2013-06-30 15:43:07
9564229af42b68d205376853410c55b957546a14...125655fe3f0caf8b3d9fff2ec45ec694b34eed04,7,97,65,162,35,2013-07-10 19:15:03,2013-07-02 23:49:57
9018a453ea801a965795af6c8f8523a49f4d167b...1e60e5f42dbcf081ac7eece12a5eebab5871636f,7,62,10,72,20,2013-11-07 17:04:32,2013-11-07 17:03:44
8ea7472e087bfc43b3acd257f7264342b433cccb...8f2a3d6251291c0468e074563e16d4c41f59acb1,3,7,5,12,5,2013-11-18 20:14:50,2013-11-18 20:14:50
8f2a3d6251291c0468e074563e16d4c41f59acb1...e1ce5249e52e9c5271727d7e2ef5bba4c45277b9,1,5,2,7,3,2013-11-18 20:40:19,2013-11-18 20:40:19
fb49bdf9c7837892154bf7efdb3db6c3ec63e396...e28c37761bc8087164e6886f7f267beb1325655f,2,28,2,30,2,2012-05-11 21:56:23,2012-05-11 21:56:23
fb49bdf9c7837892154bf7efdb3db6c3ec63e396...41178b419a5fcf3a65c2b313ecc688c607f411c9,1,1,0,1,1,2012-05-11 19:49:33,2012-05-11 19:49:33
fb49bdf9c7837892154bf7efdb3db6c3ec63e396...ac250c56c7d7bb11691c9dfbcd0dbf580d85e177,3,271,0,271,3,2012-05-11 18:30:45,2012-04-25 23:24:22
ac250c56c7d7bb11691c9dfbcd0dbf580d85e177...023c6f69edcacfefe36a2b7d606def32d5bc246c,2,139,27,166,16,2012-05-11 18:30:45,2012-04-26 02:08:17
023c6f69edcacfefe36a2b7d606def32d5bc246c...f597ea8978bf10f51fabed6cbafbd9625603b09d,2,52,7,59,17,2012-05-11 18:30:45,2012-04-26 20:06:46
f597ea8978bf10f51fabed6cbafbd9625603b09d...9d7bdf7119fe7858fdaa6e79283dacbf98c4128c,5,102,35,137,37,2012-05-11 18:30:45,2012-04-27 01:15:43
9d7bdf7119fe7858fdaa6e79283dacbf98c4128c...387d01b8578ebedc665d8fa707b8897f9a04f380,2,22,20,42,16,2012-05-11 18:30:45,2012-04-27 18:47:29
387d01b8578ebedc665d8fa707b8897f9a04f380...7149a6252c6124a505d377fe36054e120ee2299b,2,6,1,7,3,2012-05-11 18:30:46,2012-04-27 20:53:28
7149a6252c6124a505d377fe36054e120ee2299b...e0887d81786a6e9479cdcd06c9f59748fed17d9e,1,17,22,39,14,2012-05-11 18:30:46,2012-04-27 21:10:03
e0887d81786a6e9479cdcd06c9f59748fed17d9e...38533d5acf6abc2c4266ea5cf5eb80bb819794f8,2,71,0,71,5,2012-05-11 18:30:46,2012-04-27 21:11:12
38533d5acf6abc2c4266ea5cf5eb80bb819794f8...bfc13e7985a9368f7932115bc3d395dd1379b03d,1,17,3,20,4,2012-05-11 18:30:46,2012-04-30 16:58:43
bfc13e7985a9368f7932115bc3d395dd1379b03d...a51bdbcfa17c46578700006eea2ef1f2dea03cf5,6,127,17,144,12,2012-05-11 18:30:46,2012-05-01 03:21:45
a51bdbcfa17c46578700006eea2ef1f2dea03cf5...5748fdee524cd027fa5a3de3f18646501533a808,1,2,0,2,1,2012-05-11 18:30:46,2012-05-01 21:34:05
5748fdee524cd027fa5a3de3f18646501533a808...e88b8bd593c765db9190fbdfc0a5583f179ac6c8,1,9,8,17,10,2012-05-11 18:30:46,2012-05-01 21:37:11
e88b8bd593c765db9190fbdfc0a5583f179ac6c8...27ee848397facd2a3744f3a7505bdda24216cb90,2,71,102,173,26,2012-05-11 18:30:46,2012-05-02 21:41:19
27ee848397facd2a3744f3a7505bdda24216cb90...65bc26d54aaf307d0e7eb71d6c5752f88fdca5de,1,13,13,26,5,2012-05-11 18:30:46,2012-05-03 17:29:41
65bc26d54aaf307d0e7eb71d6c5752f88fdca5de...a6346302e6805aea0f1c353bb62944f1ae7352af,4,30,3,33,6,2012-05-11 18:30:47,2012-05-03 20:58:46
a6346302e6805aea0f1c353bb62944f1ae7352af...bae780e0843b4ccae3367cd247e8ea6cd0674482,1,1,1,2,1,2012-05-11 18:31:30,2012-05-04 17:31:57
bae780e0843b4ccae3367cd247e8ea6cd0674482...886f183ac3dc43c774700825ba32b7b6ffbfc3c3,2,62,6,68,7,2012-05-11 18:31:30,2012-05-07 21:26:40
886f183ac3dc43c774700825ba32b7b6ffbfc3c3...a346992f7e7812416651eb5c2b52129adec5eacf,8,1005,44,1049,19,2012-05-11 18:35:50,2012-05-10 16:47:14
a346992f7e7812416651eb5c2b52129adec5eacf...d13c1a8b60eb8f45cb14373cfd8e42f5f4d44749,2,5,5,10,5,2012-05-11 18:35:50,2012-05-10 16:48:14
d13c1a8b60eb8f45cb14373cfd8e42f5f4d44749...ec6a632a1bdc5e14c14964005946f35ad61c0259,1,4,16,20,3,2012-05-11 18:35:50,2012-05-10 20:21:58
ec6a632a1bdc5e14c14964005946f35ad61c0259...46c2ead05d289b4ed1ad96c63b75a228f02dd74c,3,5,3,8,3,2012-05-11 18:35:50,2012-05-10 20:39:34
46c2ead05d289b4ed1ad96c63b75a228f02dd74c...2b35c45f1be2c5384100625ae7c2a31b5f75acb4,1,19,13,32,3,2012-05-11 18:35:50,2012-05-10 20:40:53
2b35c45f1be2c5384100625ae7c2a31b5f75acb4...c8a33547a0442576baff7cbf683076ec89c68dbb,2,16,5,21,8,2012-05-11 18:35:50,2012-05-10 21:12:30
c8a33547a0442576baff7cbf683076ec89c68dbb...b41384b473e9ea4cfaea6f42b106e805bae8ab93,1,2,0,2,1,2012-05-11 18:35:50,2012-05-10 21:14:09
b41384b473e9ea4cfaea6f42b106e805bae8ab93...7e79d389a400952a24a5619a8bee88b7b40bee72,1,17,0,17,2,2012-05-11 18:35:50,2012-05-10 22:05:19
7e79d389a400952a24a5619a8bee88b7b40bee72...94952ded3aed856d8fd41ca9a65fcbe59a301efa,1,24,22,46,4,2012-05-11 18:35:50,2012-05-10 22:07:04
94952ded3aed856d8fd41ca9a65fcbe59a301efa...92ad5a5cda94c04b24d84c20ede235d69bedb988,16,11,10,21,13,2012-05-11 18:55:20,2012-05-11 18:50:54
92ad5a5cda94c04b24d84c20ede235d69bedb988...72b86bae50f3dc0ec1a9df0b62c70ab9bdb37c77,2,6,1,7,2,2012-05-11 18:58:02,2012-05-11 18:58:02
72b86bae50f3dc0ec1a9df0b62c70ab9bdb37c77...7c22e72ba65fa4ac9c2989d115435aa60788136c,1,0,1,1,1,2012-05-11 19:21:58,2012-05-11 19:21:58
7c22e72ba65fa4ac9c2989d115435aa60788136c...1ce4cc0164fbc14fcb7f686483aa581bc946bfdb,6,101,22,123,23,2012-05-15 22:41:05,2012-05-15 22:41:05
1ce4cc0164fbc14fcb7f686483aa581bc946bfdb...dd9e4abc1ba1701efac0c3af3b1ceede2bd561a4,4,34,21,55,15,2012-05-30 18:46:42,2012-05-30 18:46:42
dd9e4abc1ba1701efac0c3af3b1ceede2bd561a4...244d2f6b80161978cce5bacc3ac6e663b530bb65,2,70,0,70,7,2012-05-30 23:52:11,2012-05-30 23:52:11
244d2f6b80161978cce5bacc3ac6e663b530bb65...b183a92fc2f030acf4c8e0cd76a5259d8f65669a,1,4,0,4,4,2012-05-31 20:42:58,2012-05-31 20:42:58
b183a92fc2f030acf4c8e0cd76a5259d8f65669a...2497106f91f1eea363c173a53b17416e3191c9d7,1,1,0,1,1,2012-06-01 18:41:54,2012-06-01 18:41:54
2497106f91f1eea363c173a53b17416e3191c9d7...734efe4b8e8f6cfc820c7f88b3fb4e4221cec0ab,2,52,6,58,5,2012-06-01 21:18:52,2012-06-01 21:18:52
734efe4b8e8f6cfc820c7f88b3fb4e4221cec0ab...e267c9fc1a4910d1081e97b4d7a411658ddc0def,1,1,0,1,1,2012-06-04 13:03:08,2012-06-04 13:03:08
fb49bdf9c7837892154bf7efdb3db6c3ec63e396...dc13f1f7d71a22d6618c9a5db18335c005da9795,11,259,135,394,53,2012-05-10 18:12:43,2012-05-10 18:08:59
dc13f1f7d71a22d6618c9a5db18335c005da9795...a7c09c0d6b9910dda782d683c308e779c2195012,1,0,0,0,0,2012-05-10 18:15:37,2012-05-10 18:15:37
9d0011fd83ff38561e75667451d2b6a55320d7d4...ee7680d53b7328020576813914ac739b66bb8f8d,3,24,11,35,12,2012-05-16 19:51:45,2012-05-16 19:21:24
87d6138e2e774b1e343695b6b6ee64904f1fa53a...d5ed6348c7c2a37e57a153fc685e4a8c931da006,2,5,7,12,6,2012-05-14 20:24:58,2012-05-14 20:24:58
98fec8a937b93c6a6a0ad35ccd04af4cfeae1767...1ecda61ec570873dd72fd129cd1bfe6a08d5a81a,2,17,2,19,7,2013-10-23 11:46:31,2013-10-23 10:58:56
1ecda61ec570873dd72fd129cd1bfe6a08d5a81a...2baee9f81e6a7d8b5e9e31269908ec0d25610b4e,1,11,0,11,1,2013-10-23 11:46:33,2013-10-23 11:17:51
4a1b40159b4b0b2a954d40e4489331e3f22c8994...e0b267afa841d89ed2258714f1a6fb444f43d33d,1,2,2,4,1,2013-09-25 14:49:25,2013-09-25 14:49:25
4a1b40159b4b0b2a954d40e4489331e3f22c8994...5c3b8ef48bcbf0843cdc7272fec7a32819998f58,1,9,1,10,2,2013-09-24 18:52:58,2013-09-24 18:52:58
4a1b40159b4b0b2a954d40e4489331e3f22c8994...210d5325262fb8d5ae553fcdba6f3c045db3e1de,1,15,2,17,3,2013-09-24 18:18:36,2013-09-23 19:09:23
210d5325262fb8d5ae553fcdba6f3c045db3e1de...c91444055ab76f0f638a7926d8be8418fef2db0d,1,4,1,5,2,2013-09-24 18:18:43,2013-09-23 18:37:35
c91444055ab76f0f638a7926d8be8418fef2db0d...eb0ff1307106c4fefc4042b7b7014e44e422b33e,3,109,79,188,20,2013-09-24 21:07:08,2013-09-24 21:07:08
eb0ff1307106c4fefc4042b7b7014e44e422b33e...46fbc88ee5d4b40786ef48cb5da9c8af28577b55,1,6,1,7,2,2013-09-24 21:50:06,2013-09-24 21:50:06
236945a524b845d9b419fbf6861d36bbc7e57b56...e580afd8634c99449b0ed6e8113873518359c2c5,1,74,0,74,1,2013-09-13 21:33:26,2013-09-13 21:33:26
6208bd499b1d3dc1a106a35c499e92c3f8f3d238...0d1af399e958b50540c83d5eef51cf119da76667,1,2,1,3,1,2013-09-03 19:33:34,2013-09-03 19:33:34
cca9bea4845c5852b93d4c52a0c6efe20bb3bac2...d209cc47515d2feeaa30de20882ded5cb4039736,1,96,84,180,72,2013-09-05 16:06:12,2013-09-05 16:06:12
d209cc47515d2feeaa30de20882ded5cb4039736...d8d25acb9a2e560a5fce66d4b1c9bdf4969ea2c4,4,106,5,111,12,2013-09-07 18:51:26,2013-09-05 17:24:20
d8d25acb9a2e560a5fce66d4b1c9bdf4969ea2c4...19be0692b40f7ba8583ea96b1d0f382e45c13071,1,58,47,105,38,2013-09-07 18:51:26,2013-09-06 18:34:02
19be0692b40f7ba8583ea96b1d0f382e45c13071...a9fb79896e59f4e58cd7d174e7835e8a9c850a33,2,39,5,44,4,2013-09-07 18:51:26,2013-09-06 18:51:35
a9fb79896e59f4e58cd7d174e7835e8a9c850a33...73fc5e01c2ad4af7912201fc938b234a2dc854ac,3,43,1,44,4,2013-09-07 18:51:26,2013-09-06 19:12:26
73fc5e01c2ad4af7912201fc938b234a2dc854ac...69789922984d2e22f267da5f35cd64cd17c36dc0,1,4,3,7,1,2013-09-07 18:51:26,2013-09-07 16:50:35
69789922984d2e22f267da5f35cd64cd17c36dc0...53ea0513716a8d1e1bc1347cca5a333e26ca9f1e,2,23,0,23,8,2013-09-07 18:51:26,2013-09-07 17:07:39
366bd2f43dd6f74916b995340d62966fcd535b76...ae4a486605c258aa38a53534c99f94e66379c9ae,1,5,1,6,2,2013-09-06 20:21:37,2013-08-29 12:12:13
ae4a486605c258aa38a53534c99f94e66379c9ae...4047950f30618c160cd2fdf5da39fb8e26b031d9,4,36,7,43,4,2013-09-06 20:47:28,2013-08-29 12:19:34
c46fe0c651c9dc32ba03fab5b34340d92af864e6...6d9a6c5cecebfaaecb4c39d002c8e0cdd26c4b85,2,120,11,131,7,2013-09-03 17:45:53,2013-09-03 04:58:21
bd679796a57a44270b1f1a4d50652367086f58a3...d70ce9bd7a1acec34b283d3bc92da84fbbf79860,1,4,4,8,3,2013-07-10 22:38:57,2013-07-10 22:38:57
7be892114c7799619abb7892def014cedb623e78...ad62f2eedc110bda0b66a9f1d39f06df99a2f020,1,1,1,2,1,2013-11-07 18:00:43,2013-11-07 18:00:43
e544a5b8e5f823ff50049a4bd1b357c2e027c89d...65f67857ab8653212d85d5ea4ef22d95c244ca85,1,0,1,1,1,2013-11-19 13:25:30,2013-11-19 13:25:30
e1ce5249e52e9c5271727d7e2ef5bba4c45277b9...7b69289f4e9249f61fb48593ddbf66b6f9ad6494,1,1,1,2,1,2013-11-19 12:25:16,2013-11-19 11:54:57
7b69289f4e9249f61fb48593ddbf66b6f9ad6494...82e6a42c6c387a584df1b2efb4fa3bfdb8c290a2,1,2,0,2,1,2013-11-19 12:25:25,2013-11-19 12:13:51
82e6a42c6c387a584df1b2efb4fa3bfdb8c290a2...3d5233455b2483fe78c82cabf89b568d079d6742,3,15,3,18,4,2013-11-19 12:25:37,2013-11-19 12:15:47
3d5233455b2483fe78c82cabf89b568d079d6742...a5d73188023cf0ae0b6fc42dfeddce5a9ee8ad5f,1,2,2,4,2,2013-11-19 12:25:38,2013-11-19 12:16:09
a5d73188023cf0ae0b6fc42dfeddce5a9ee8ad5f...bd15b513058afc53543b48383ec5bc56605f6c1e,1,7,1,8,3,2013-11-19 12:25:39,2013-11-19 12:24:10
e1ce5249e52e9c5271727d7e2ef5bba4c45277b9...d8e7ffc2a246491aa139875e840fff34c832a739,3,20,4,24,13,2013-11-18 22:03:25,2013-11-18 22:03:25
56a5000d580ef5c9605bc9076610b5af9aa67518...2c2cde47b8241e66cacd535d5f8c269d623a47f0,1,4,4,8,4,2012-06-06 15:41:39,2012-06-06 15:41:39
2c2cde47b8241e66cacd535d5f8c269d623a47f0...8a385c0482aff009738f509892863707592434b9,5,12,17,29,5,2012-06-06 19:25:22,2012-06-06 19:25:22
8a385c0482aff009738f509892863707592434b9...19d35d528cefe8ffe7b066648b7233cf7db3dce8,1,1,1,2,1,2012-06-06 19:31:48,2012-06-06 19:31:48
19d35d528cefe8ffe7b066648b7233cf7db3dce8...36c0802245e2c041db19d65173587c1a39cfb742,1,3,1,4,3,2012-06-06 19:39:29,2012-06-06 19:39:29
36c0802245e2c041db19d65173587c1a39cfb742...d6391a626f0bac4880adda74528e3d6f5054c571,1,7,6,13,7,2012-06-06 20:00:12,2012-06-06 20:00:12
d6391a626f0bac4880adda74528e3d6f5054c571...1a728066c3b307a71c04f746bb6f322dacd50938,1,2,2,4,2,2012-06-06 20:04:08,2012-06-06 20:04:08
1a728066c3b307a71c04f746bb6f322dacd50938...9ecf860d48b39241a2dce61dd33455816064d56b,5,19,15,34,13,2012-06-06 20:24:25,2012-06-06 20:24:25
9ecf860d48b39241a2dce61dd33455816064d56b...31dda6471687f0ec6985f3db2536e93a8c012df2,1,2,2,4,2,2012-06-07 19:16:39,2012-06-07 19:16:39
31dda6471687f0ec6985f3db2536e93a8c012df2...327dc61f132a4999e006d8d8bd2080c1f5a34bf0,1,1,1,2,1,2012-06-07 19:28:08,2012-06-07 19:28:08
38f4f1582471cfff4ade558f321e946093a93c4c...bd4ca902b5c8b95106e53fa31f95ab8992cf1b65,25,148,36,184,33,2012-05-17 00:08:59,2012-05-17 00:02:06
54695f4098c75801f477f5bc229a52653484e08a...41a82592ef56a216f96558942d717af15589071d,18,761,329,1090,133,2012-05-15 21:34:15,2012-05-15 21:17:39
41a82592ef56a216f96558942d717af15589071d...58ffeb9cde4091a714322157836954eb45129fad,1,1,1,2,1,2012-05-15 21:51:30,2012-05-15 21:51:30
58ffeb9cde4091a714322157836954eb45129fad...2c8339172878cd935eee0d9eb6db747cebd70a72,2,4,0,4,4,2012-05-15 23:33:05,2012-05-15 23:33:05
54695f4098c75801f477f5bc229a52653484e08a...73d87a091ca9b5fe4dc236fad6a24149a6fd15a5,2,6,5,11,6,2012-05-15 19:42:20,2012-05-15 19:42:01
73d87a091ca9b5fe4dc236fad6a24149a6fd15a5...6a9d61ef50811ba84656d311fc3713fb1544c505,1,11,0,11,2,2012-05-15 23:22:25,2012-05-15 13:08:54
3fcb1d83112a8832c85fec4edb6a331a582d5fd5...474c8cf8329c96782942763712d372534e862f32,1,8,2,10,4,2013-10-23 20:49:52,2013-10-23 20:49:52
1c74686e05c41c30944173bacec3a8312f08cbb5...5cb136705d7db2822357582d5b726c91ca044b24,3,6,3,9,3,2013-10-23 13:45:29,2013-10-23 13:45:29
1c74686e05c41c30944173bacec3a8312f08cbb5...70a8c78f3618d70cf6de0961e4e3884a003a1ff0,4,53,43,96,31,2013-10-23 10:08:54,2013-10-23 10:08:54
e4ad52b60fc566f8d2219b8f1fa590b3d3df4e3b...aa94acf0bcf42450af419e5398a85558d3d8bd24,1,221,62,283,33,2013-09-25 18:53:02,2013-09-25 18:53:02
4dbdbf6489fcacb4f5d491079860ae35f42233b9...4a88eb20b9f2471eeb13d47afd946b4c66b72669,1,192,124,316,11,2013-09-25 19:13:09,2013-09-25 19:13:09
4dbdbf6489fcacb4f5d491079860ae35f42233b9...1c8de38004466392b855b81991aa4d698862755b,1,14,9,23,7,2013-09-24 22:46:20,2013-09-20 23:58:04
e580afd8634c99449b0ed6e8113873518359c2c5...f2df503bab6ae6e77ff0bbe17f358822be51b944,2,12,3,15,6,2013-09-16 00:02:36,2013-09-14 10:22:16
0d1af399e958b50540c83d5eef51cf119da76667...cae529385437a24094ef2997dbf546723f7fd1ee,2,17,3,20,3,2013-09-03 21:00:27,2013-09-03 21:00:27
4581f9d8ab72e9b97817e1eaa7154bcec1c7f0b1...0cf77103b218ad3622aff34f3296db1bdd5f0df9,14,428,45,473,38,2013-09-17 16:30:06,2013-08-27 06:17:07
0cf77103b218ad3622aff34f3296db1bdd5f0df9...85d5481206a932d747b2d5587b6d4c7f69993ba6,14,497,244,741,129,2013-09-17 16:30:06,2013-08-28 23:44:04
85d5481206a932d747b2d5587b6d4c7f69993ba6...570ba25cb0f757f993e06df629faced32fdf2f8f,3,60,11,71,8,2013-09-17 16:30:06,2013-08-30 23:02:07
570ba25cb0f757f993e06df629faced32fdf2f8f...974774c7b00c08585b05ff87174872be005a1f29,6,364,80,444,34,2013-09-17 16:31:44,2013-09-09 23:57:34
974774c7b00c08585b05ff87174872be005a1f29...2a7d224f99a053d93079644947d04e7cc085930f,13,297,234,531,86,2013-09-17 16:31:44,2013-09-10 23:33:32
2a7d224f99a053d93079644947d04e7cc085930f...29e92d385e0bb43d45ddea5f8173d78fcceac3a6,2,34,2,36,8,2013-09-17 16:31:44,2013-09-10 23:53:09
29e92d385e0bb43d45ddea5f8173d78fcceac3a6...e7d0ced2192c5efeea6d9f5667d366891010b86a,1,1,1,2,1,2013-09-17 16:31:44,2013-09-11 19:38:06
e7d0ced2192c5efeea6d9f5667d366891010b86a...a3aa5f4d5dcbe038f1d1c5ff40eed29d27953fbe,10,62,45,107,21,2013-09-17 16:31:45,2013-09-11 19:45:20
a3aa5f4d5dcbe038f1d1c5ff40eed29d27953fbe...0646634e2fea3e0adf724e0b7b15118574b589fc,2,122,58,180,17,2013-09-17 16:31:45,2013-09-11 19:45:37
0646634e2fea3e0adf724e0b7b15118574b589fc...40cb40fab93281c808255d980bbe81a18a4d9e9a,6,181,25,206,13,2013-09-17 16:31:45,2013-09-11 21:23:39
40cb40fab93281c808255d980bbe81a18a4d9e9a...4b11f25a4fbb6952284e037a70e2d61fde841ab6,14,355,23,378,29,2013-09-17 16:31:45,2013-09-11 23:38:33
4b11f25a4fbb6952284e037a70e2d61fde841ab6...a9f51e430fef49b3299ec33c11a4e6623e3f58cc,20,206,298,504,114,2013-09-17 16:31:45,2013-09-12 05:00:36
a9f51e430fef49b3299ec33c11a4e6623e3f58cc...0e32635fcf9a874fe66f871e88c0bbc0511544f1,2,5,1,6,2,2013-09-17 16:31:45,2013-09-12 21:47:15
0e32635fcf9a874fe66f871e88c0bbc0511544f1...b47349b8dc742943e063cb3d755b9db66203e3d9,7,325,56,381,23,2013-09-17 16:31:45,2013-09-12 21:48:24
b47349b8dc742943e063cb3d755b9db66203e3d9...d5b1866cc363461c3ecc14412dcd26d2e4fa8b68,5,13,13,26,9,2013-09-17 16:31:45,2013-09-13 16:26:26
d5b1866cc363461c3ecc14412dcd26d2e4fa8b68...ad7417d7a13e910d548e3e07225ce8914cdb218e,2,13,3,16,4,2013-09-17 16:31:45,2013-09-13 16:44:30
ad7417d7a13e910d548e3e07225ce8914cdb218e...e399c7eee8dac02b7a79c6133ad4c761f05b7ba9,1,3,3,6,3,2013-09-17 16:31:46,2013-09-13 16:50:05
e399c7eee8dac02b7a79c6133ad4c761f05b7ba9...8427757f78b1f0b018b1ccfe424a4c39e89ea024,3,6,6,12,5,2013-09-17 16:31:46,2013-09-13 19:32:45
8427757f78b1f0b018b1ccfe424a4c39e89ea024...fa9cc14880cb50ea626c4bb0fcf1b68acdd73186,1,5,1,6,2,2013-09-17 16:31:46,2013-09-13 20:41:33
fa9cc14880cb50ea626c4bb0fcf1b68acdd73186...13f36ffb9e1c4fb70b44a477d716873fecfc0407,5,72,80,152,10,2013-09-17 16:31:46,2013-09-13 23:30:21
13f36ffb9e1c4fb70b44a477d716873fecfc0407...155fa2342d838bdb2aa873c95a42e091351bb69a,11,93,147,240,27,2013-09-17 16:31:46,2013-09-05 22:06:42
155fa2342d838bdb2aa873c95a42e091351bb69a...37f9e4093999498a25641018da36245d6a7cb008,4,79,3,82,6,2013-09-17 16:31:46,2013-09-14 04:43:00
37f9e4093999498a25641018da36245d6a7cb008...eab3746b3026950ed62842c1e5641556d7131a5b,4,114,7,121,17,2013-09-17 16:31:46,2013-09-16 05:23:39
eab3746b3026950ed62842c1e5641556d7131a5b...eefc32d54944ead5a5e3041c1b1f6c8c946cc014,7,128,68,196,46,2013-09-17 16:31:46,2013-09-16 19:54:40
eefc32d54944ead5a5e3041c1b1f6c8c946cc014...f60ed4e6495b8bf68d0604335672e6f300330b3b,2,5,1,6,2,2013-09-17 16:31:46,2013-09-16 22:08:35
d70ce9bd7a1acec34b283d3bc92da84fbbf79860...814de0bcab99f82dc637ba7ae34df5a0e9e1138c,1,43,14,57,10,2013-07-11 18:00:41,2013-07-11 18:00:41
814de0bcab99f82dc637ba7ae34df5a0e9e1138c...584f2d3013df6744fa7b5c5398a78b96f31e25f4,3,10,9,19,9,2013-07-11 18:04:42,2013-07-11 18:04:42
47a9a6297ec6c85c60c547160492e1260e5d3c25...963edd9bff9f2ae008a99e92e17b46f42fe40641,1,2,1,3,1,2013-11-19 16:59:55,2013-11-19 16:58:58
e479628a01eddafd357bd3b49526ab49998edcef...1b3fe73c8dba597a8c7ff97e4e78acac6d58b1a9,1,6,6,12,2,2013-11-20 10:55:32,2013-11-20 10:52:57
1b3fe73c8dba597a8c7ff97e4e78acac6d58b1a9...43cb8b32428b1b29994874349ec22eb5372e152c,1,2,2,4,2,2013-11-20 11:53:33,2013-11-20 11:53:33
db756d5898fa6e0bdd2aeaa2cccfa55ece6c09a2...6e5c4af00eb2765dc2a093d8aa3cffed5b627ab9,2,81,4,85,3,2012-05-17 21:21:10,2012-05-17 21:21:10
db756d5898fa6e0bdd2aeaa2cccfa55ece6c09a2...706a9974a297ea1b38c6aab886b54598409725e8,3,13,2,15,4,2012-05-17 20:05:17,2012-05-17 20:05:17
706a9974a297ea1b38c6aab886b54598409725e8...b59c73d39a0bb3ddb6fd4e81f796018c2b3a0579,3,23,7,30,5,2012-05-17 20:06:20,2012-05-17 20:06:20
b59c73d39a0bb3ddb6fd4e81f796018c2b3a0579...a0d959628f2a9eff65088c3247f237aef5205e73,2,23,14,37,16,2012-05-17 20:14:17,2012-05-17 20:14:17
a0d959628f2a9eff65088c3247f237aef5205e73...e3557172aff5814e32e58bceb015465dcbe9e5f3,1,0,9,9,1,2012-05-17 21:44:17,2012-05-17 21:44:17
474c8cf8329c96782942763712d372534e862f32...63d1fad47063a256de002f2c9d8228accac6721d,1,3,3,6,2,2013-10-24 13:30:31,2013-10-24 13:30:31
11f8336ec93ea3a270c9fe80c4bbb68aa4729423...ac316e743878908df762cc0ea07a71cbee5c5802,1,3,0,3,1,2013-09-25 21:25:38,2013-09-25 21:25:38
d8de5c42d05ee1da2f8e385b0b33a94975d06bad...6918d81e2c7a778d789bb35af7dae96e4e89ce03,1,35,31,66,5,2013-09-25 03:14:06,2013-09-25 03:14:06
8821c9aa5baf31e21c21825e8c91c765e6631e7f...b622aabec0d8cf659f9a1f458f728f76e4090a81,2,22,13,35,11,2013-09-16 21:07:19,2013-08-09 11:14:06
b622aabec0d8cf659f9a1f458f728f76e4090a81...eec4dcc34b511606ae9386baa3831f3a624c6fde,1,1,1,2,1,2013-09-16 21:07:22,2013-08-09 11:14:19
8821c9aa5baf31e21c21825e8c91c765e6631e7f...c62b5ca590fb2f1743f43439b04159b168a36dda,1,1,2,3,1,2013-09-16 20:23:05,2013-09-16 20:23:05
d31e5655c22e0409b1b78e4b55e34694063a2257...60ee53dfce5ff0201e6f519c653cf0de195ff35b,2,15,34,49,2,2013-09-03 22:20:16,2013-09-03 22:14:04
f2de67d589e4fde3378f531c782cbe176cb65f36...0a1c8f55b35ebd35a7d267099257634483268ffd,3,25,5,30,4,2013-07-11 22:17:53,2013-07-11 22:09:15
43cb8b32428b1b29994874349ec22eb5372e152c...ee7040fd9b056ef61c538717c11c3eab48d86ac5,2,74,2,76,3,2013-11-20 13:11:44,2013-11-20 13:11:44
ee7040fd9b056ef61c538717c11c3eab48d86ac5...138e014c389a750715cf4f60cceef96692b4ea51,1,12,0,12,1,2013-11-20 13:25:55,2013-11-20 13:20:32
6c08e69fd92028822cb98368e564c5cb7964c072...454cc829f38f0431c728f3fd83d084c879b28aa1,7,3,2,5,3,2012-06-07 22:17:08,2012-05-29 11:28:26
454cc829f38f0431c728f3fd83d084c879b28aa1...3a0d1e12db28d685c9b898c52a574a7d76beff00,1,48,0,48,1,2012-06-07 22:17:09,2012-05-10 13:32:52
3a0d1e12db28d685c9b898c52a574a7d76beff00...b0b3b4e39e372c29af6782bdee8ec1a87ff662dd,1,3,0,3,1,2012-06-08 18:34:13,2012-05-29 14:19:15
b0b3b4e39e372c29af6782bdee8ec1a87ff662dd...a02e7249784d8aa8c7c89329c4ec68a54ccab92c,2,255,239,494,86,2012-06-08 18:34:24,2012-05-29 15:53:29
a02e7249784d8aa8c7c89329c4ec68a54ccab92c...027d77ee5c3e9ac859ceac986ceb215da388b28e,1,83,37,120,6,2012-06-12 12:30:33,2012-06-06 14:41:42
6c08e69fd92028822cb98368e564c5cb7964c072...763b838152244c0d7433cde0046e9f67369074e3,3,14,5,19,6,2012-06-07 20:22:50,2012-06-07 20:22:50
763b838152244c0d7433cde0046e9f67369074e3...3f0358604e48432b53abf097aa3ab6a1e3639813,16,26,20,46,24,2012-06-07 20:43:48,2012-06-07 20:43:03
88d6e044080e90494e0fc2f073aa0c82973d32e7...392eced6f08b36fedf80287702d1aaf410c7079f,2,31,2,33,3,2012-05-17 22:26:04,2012-05-11 20:22:14
52695898e55f37cf657592dd9d7946c5a7938038...29e948debe603d7dd33a171a0101352e6b133a7a,14,118,97,215,75,2012-05-17 23:25:57,2012-05-10 08:38:10
29e948debe603d7dd33a171a0101352e6b133a7a...255c38c500e8fc1d8adcd86e42f8209ef0b84948,7,82,82,164,67,2012-05-17 23:25:57,2012-05-10 09:50:29
255c38c500e8fc1d8adcd86e42f8209ef0b84948...fe3bcf7d7a1950d430a043a2ae11b81d231d6b1c,1,0,13,13,7,2012-05-17 23:25:57,2012-05-11 10:20:19
fe3bcf7d7a1950d430a043a2ae11b81d231d6b1c...4fbd1c007e6c72b32c0dd2a29036a5670f85120a,6,7,7,14,7,2012-05-17 23:26:16,2012-05-17 18:35:48
4fbd1c007e6c72b32c0dd2a29036a5670f85120a...2e2e97858de18abd43f7e59fcc6151510c6d3272,8,34,31,65,16,2012-05-17 23:26:23,2012-05-17 22:42:24
2e2e97858de18abd43f7e59fcc6151510c6d3272...e172cf082e62aa421703080d0bccb7b8762c8bd4,90,404,368,772,359,2012-05-17 23:26:26,2012-05-17 23:21:06
e172cf082e62aa421703080d0bccb7b8762c8bd4...904b67e69fa15b7a3246e43b3d78645ffa2331f6,61,171,170,341,162,2012-05-17 23:48:50,2012-05-17 23:48:50
fd5d80d25ae50b9f6491868e4e5c06ea017bbdb0...9d41984cd35a267b1f863faad796bb0066b26f5b,1,42,33,75,29,2013-10-25 18:17:23,2013-10-25 18:14:22
fd5d80d25ae50b9f6491868e4e5c06ea017bbdb0...df9fc82e97282170ec87e84f655ee468bf8afe7b,1,17,4,21,2,2013-10-25 17:33:42,2013-10-25 17:33:42
fd5d80d25ae50b9f6491868e4e5c06ea017bbdb0...1bfe7133e022871bd9e8f0bada14ccb8ec688a2e,1,5,1,6,2,2013-10-25 17:23:46,2013-10-25 17:23:46
ac316e743878908df762cc0ea07a71cbee5c5802...27c8eb2a1a881be12e281b606730ff15a8382ab1,1,82,82,164,16,2013-09-30 09:31:35,2013-09-30 09:18:06
27c8eb2a1a881be12e281b606730ff15a8382ab1...d27a441ddefff8934e43a546b23f582437ba4399,2,19,4,23,4,2013-09-30 09:33:58,2013-09-30 09:30:28
ac316e743878908df762cc0ea07a71cbee5c5802...4fe0b0b34b3700d6da681498f0077a455d14812b,1,6,2,8,4,2013-09-28 00:07:06,2013-09-28 00:07:06
4fe0b0b34b3700d6da681498f0077a455d14812b...526d4c949c4b87c01e74a19ab47171ee08c9673a,4,117,43,160,9,2013-09-28 04:39:28,2013-09-28 04:39:28
526d4c949c4b87c01e74a19ab47171ee08c9673a...ae5a935290c695d721f69b8836f891a639c0aff3,1,16,4,20,9,2013-09-30 21:47:56,2013-09-30 21:47:56
ac316e743878908df762cc0ea07a71cbee5c5802...7d6924541508b453c22fac2ac3bc76fadc0a58ba,1,37,44,81,9,2013-09-27 20:08:24,2013-09-27 20:08:24
ac316e743878908df762cc0ea07a71cbee5c5802...8a1e925dde2f7deaf640757b1c309fcc6be1b0e1,3,6,6,12,6,2013-09-26 18:44:43,2013-09-26 10:00:35
ac316e743878908df762cc0ea07a71cbee5c5802...8988688c479c6e511432187c7e7e746aefb23c08,4,172,72,244,13,2013-09-26 03:41:56,2013-09-26 03:41:56
8988688c479c6e511432187c7e7e746aefb23c08...f30d91ce48f444031b1c65749758008c6f204130,1,28,69,97,3,2013-09-26 18:03:27,2013-09-26 18:03:27
f30d91ce48f444031b1c65749758008c6f204130...83fbd36869e9126bd0fd2139af4d8f4c45865266,1,16,73,89,15,2013-09-26 22:58:41,2013-09-26 22:58:41
83fbd36869e9126bd0fd2139af4d8f4c45865266...ea59f6597707107940d2a615b5fc4621d62149d3,4,38,83,121,32,2013-09-26 23:20:30,2013-09-26 23:20:30
ea59f6597707107940d2a615b5fc4621d62149d3...1b02baf40be4913a4f3044987eea85c72ce4b0a7,1,2,3,5,2,2013-09-26 23:25:05,2013-09-26 23:25:05
1b02baf40be4913a4f3044987eea85c72ce4b0a7...0049d4d1d2dd4cb6d65ea81ecdc8611a41f0bace,1,9,0,9,1,2013-09-26 23:25:34,2013-09-26 23:25:34
0049d4d1d2dd4cb6d65ea81ecdc8611a41f0bace...256961e45d574ace62a7a7d13b697aa05e8a9466,1,1,2,3,1,2013-09-26 23:36:05,2013-09-26 23:36:05
256961e45d574ace62a7a7d13b697aa05e8a9466...b59344bf83049a5639c32ab52efceea2eec9484b,1,2,8,10,3,2013-09-26 23:48:46,2013-09-26 23:48:08
c62b5ca590fb2f1743f43439b04159b168a36dda...605da51a2cfd86901b6fa5f9cf71111a63ab4418,25,59,59,118,58,2013-09-17 07:50:30,2013-09-17 07:50:30
6700cb9925741211910e592be58fa3b8b99f48ec...21753d48691c41fbedc0c074d8b0f278f3ba2f1d,1,1,1,2,1,2013-09-05 12:42:47,2013-09-05 12:42:47
6700cb9925741211910e592be58fa3b8b99f48ec...74b38d199ebe74c25180e0baf4bf945c97cd3daf,1,47,0,47,2,2013-09-04 11:16:57,2013-09-04 11:16:57
3d4f169867faf79abcfdff6667b361d88bb2e3b3...0cd1c3bb066f67ac21f1ce8730eaefc5541c1082,1,12,17,29,10,2013-09-19 11:17:09,2013-09-18 15:06:10
0cd1c3bb066f67ac21f1ce8730eaefc5541c1082...417472e317a8680123f2fa4f46e1e3c21315326d,1,2,2,4,1,2013-09-20 01:02:58,2013-09-20 01:02:58
ed0be48b939b1cc6329c6a75114dcd4158a720f5...cdacd3d931a95068b6ef3410e240c73f305835a1,1,11,11,22,11,2013-07-12 21:53:00,2013-07-12 21:53:00
ed0be48b939b1cc6329c6a75114dcd4158a720f5...1c13b0bfdcfb510863a6e5e3238f8a461551aa0f,5,16,0,16,6,2013-07-12 20:31:55,2013-07-12 20:30:05
1c13b0bfdcfb510863a6e5e3238f8a461551aa0f...5ce6c1e917a4282455fef6c7fd2236a7fb68653a,1,32,11,43,4,2013-08-15 23:32:29,2013-08-12 14:15:36
a2e873d1a15df03d7ecfac2a1bec56cf66b8cc40...758f2f1022d09e1423f3cd8c5d52ca633e9fc317,2,6,6,12,2,2013-11-27 13:31:22,2013-11-27 13:17:40
a2e873d1a15df03d7ecfac2a1bec56cf66b8cc40...92f95a170c76ffde80010cbbd6b03c0bf8dded1d,1,26,25,51,7,2013-11-23 12:32:25,2013-05-12 12:16:13
92f95a170c76ffde80010cbbd6b03c0bf8dded1d...bba25f39a29c7913bab97fa6e8ac2ccb78ea33b6,3,150,3,153,8,2013-11-23 12:34:46,2013-05-13 14:21:09
bba25f39a29c7913bab97fa6e8ac2ccb78ea33b6...56ad3782e08cd1b2d26eee4014e77fac7a6c2414,3,88,0,88,3,2013-11-23 12:34:51,2013-05-13 15:44:39
56ad3782e08cd1b2d26eee4014e77fac7a6c2414...14ab0e100e9474c5d1fda37fb0f4eec9ee0e9d13,3,110,4,114,6,2013-11-23 12:35:51,2013-05-14 14:07:33
14ab0e100e9474c5d1fda37fb0f4eec9ee0e9d13...ca84e058505a25b8f789ee1298a83e818b297ecc,3,96,5,101,6,2013-11-23 12:35:53,2013-05-14 14:40:09
ca84e058505a25b8f789ee1298a83e818b297ecc...a6b508080cf73df7139c951feebb2281b9027752,3,7,19,26,8,2013-11-23 12:35:53,2013-10-30 16:24:36
a6b508080cf73df7139c951feebb2281b9027752...110df89317b56267b956574216d6611637860446,5,46,24,70,17,2013-11-23 12:35:53,2013-11-13 12:36:37
110df89317b56267b956574216d6611637860446...a57dd3b7a46c9a2f87f203f1ab372fa28e10e571,9,171,176,347,52,2013-11-23 13:55:02,2013-11-13 17:15:20
a57dd3b7a46c9a2f87f203f1ab372fa28e10e571...13c9e44af9424e1fc478693f0d64fbf7082c9665,3,1,60,61,4,2013-11-23 13:55:02,2013-11-14 18:41:09
13c9e44af9424e1fc478693f0d64fbf7082c9665...6f13a30565fc3891c0df161945097b316945fca7,3,70,3,73,7,2013-12-09 14:55:11,2013-11-17 22:26:49
6f13a30565fc3891c0df161945097b316945fca7...8d5ec9106afbca346a8def84ef20de0a7ba2240a,8,65,5,70,11,2013-12-09 14:55:11,2013-11-23 13:13:01
8d5ec9106afbca346a8def84ef20de0a7ba2240a...f21051297cc698644ea0dc9c7122ec944dba2863,7,36,22,58,13,2013-12-09 14:55:11,2013-11-23 13:39:53
3f0358604e48432b53abf097aa3ab6a1e3639813...e272efcb20332ed36a6316c4152f50f9dbcf2a00,4,64,56,120,7,2012-06-08 18:24:37,2012-06-08 18:24:37
6ec01e6361f7d71d8f080d9d28c966a73ecdb3b3...a167002f9e8e0fc1ebf3922a3da3628c54e4b319,1,11,0,11,2,2012-05-18 10:44:01,2012-05-18 10:36:25
59d91979d87b8d355696a943f562eb326cee6c38...ad5df35a47d56c3d716d7a56eac4aeb611987c11,1,2,2,4,2,2012-05-18 23:40:46,2012-05-18 23:40:46
8607286bc7ea5ac93624dba62da3c1b8bb184ff1...dbc45b88cced070ec221863196024cb2cf96cabb,2,0,112,112,2,2013-10-26 06:13:29,2013-10-26 06:13:29
5c50f22a93c78190fb7d81802199ff9defc8cf55...a6154f2183043626cdbe995b4795346610b5862e,10,85,85,170,75,2013-10-30 14:00:05,2013-10-30 14:00:05
5c50f22a93c78190fb7d81802199ff9defc8cf55...04e0c2b24db73dd5101738605dc4fe90d479aa08,1,3,4,7,3,2013-10-30 13:00:44,2013-10-30 13:00:44
04e0c2b24db73dd5101738605dc4fe90d479aa08...97d32abb492f7830f6e26719ce558429f6377b73,1,0,15,15,1,2013-10-30 14:15:54,2013-10-30 14:09:32
5c50f22a93c78190fb7d81802199ff9defc8cf55...66902d47737da1100de5e24498cf8c7260b183df,7,808,540,1348,102,2013-10-30 01:30:49,2013-10-30 01:30:49
66902d47737da1100de5e24498cf8c7260b183df...a8422f9202e6a177750c105260dd5bbf82a0778f,1,122,127,249,23,2013-10-30 12:38:12,2013-10-30 12:38:12
a8422f9202e6a177750c105260dd5bbf82a0778f...e568bedf526693e2a8aab5811364ae5a3a16f4e2,1,61,57,118,16,2013-10-30 13:08:54,2013-10-30 13:08:54
e568bedf526693e2a8aab5811364ae5a3a16f4e2...7cc3c9bf00788e0d91f1a495a28b12509c5bd89d,1,4,7,11,2,2013-10-30 13:09:08,2013-10-30 13:09:08
7cc3c9bf00788e0d91f1a495a28b12509c5bd89d...dbfd2833270ecbcdf98dcb2914c148a146b70307,1,8,3,11,1,2013-10-30 14:21:12,2013-10-30 14:21:12
dbfd2833270ecbcdf98dcb2914c148a146b70307...9d83d368fcebaeb51041212dad165b991c0a8329,1,78,76,154,11,2013-10-30 14:21:36,2013-10-30 14:21:36
9d83d368fcebaeb51041212dad165b991c0a8329...784b3abbd52d786a56151ae1c8124fc8ffa432e3,1,28,34,62,6,2013-10-30 19:34:03,2013-10-30 19:34:03
784b3abbd52d786a56151ae1c8124fc8ffa432e3...b9d02460f14151909b39fc963d119b373834f6d1,1,56,53,109,10,2013-10-30 20:07:58,2013-10-30 20:07:58
b9d02460f14151909b39fc963d119b373834f6d1...dbdb22b330d0148e89393baee3ddee25111a7671,1,15,23,38,8,2013-10-30 20:20:08,2013-10-30 20:20:08
dbdb22b330d0148e89393baee3ddee25111a7671...85c6730ce86045da0465080b0347fde1fb0f08df,5,86,72,158,63,2013-10-31 21:35:32,2013-10-31 21:35:32
85c6730ce86045da0465080b0347fde1fb0f08df...76120863a74f29dbd51ad9c45dfba06728d04177,1,14,6,20,3,2013-10-31 21:48:41,2013-10-31 21:48:41
76120863a74f29dbd51ad9c45dfba06728d04177...c44820c616fab29d86f7256840f7114f195c08ca,4,31,8,39,17,2013-11-01 08:08:22,2013-10-31 22:42:50
c44820c616fab29d86f7256840f7114f195c08ca...4f62d55968d4a22a6ea03194aa34ab1b6ca8fdea,2,3,3,6,3,2013-11-01 12:39:21,2013-11-01 12:39:21
5b09db15d1041032c446f6141a9b41265fb253bc...b176ededb7d226ac85809b3ec594d185e7e3e866,10,283,37,320,64,2013-09-30 17:22:28,2013-09-19 18:52:57
e6a1d9a24889052ad2d573d90ffe3f6527863079...566dd8cec06e511490c6473d2440c39ff1b2851c,1,15,26,41,9,2013-10-01 01:56:17,2013-09-30 15:38:22
566dd8cec06e511490c6473d2440c39ff1b2851c...d52a93fab330dbbe1271c10b527d333261638fe3,2,18,0,18,2,2013-10-01 01:56:59,2013-09-30 15:58:58
d52a93fab330dbbe1271c10b527d333261638fe3...8d741253849c5e377e50490818326adc56be9fce,1,22,0,22,1,2013-10-01 01:56:59,2013-10-01 01:46:56
efc9e6700fabc91ea490fcc5ea034b51648c9e88...98eb2c59e829d56cf3ae5cf93ae197ee8f4a415b,1,69,17,86,13,2013-09-18 00:27:31,2013-09-17 15:44:05
98eb2c59e829d56cf3ae5cf93ae197ee8f4a415b...e0aa6fc136c2e92b18ce1874e4bf5ec2e44ea928,1,3,3,6,3,2013-09-18 00:27:31,2013-09-18 00:20:17
efc9e6700fabc91ea490fcc5ea034b51648c9e88...ffbd337aefae76a646bafd6e5f3c1edc18400f05,1,1,1,2,1,2013-09-17 14:57:06,2013-09-17 14:57:06
ffbd337aefae76a646bafd6e5f3c1edc18400f05...89095fbddcba3c3e27d0573bc7202ca9a5f4f00b,1,1,1,2,1,2013-09-17 14:57:30,2013-09-17 14:57:30
4cf9323be1ed856e8d8b3d5c41390ea89e0583d3...5a284edca42dd75cf62b3fe75020819fcfcea9f3,1,1,1,2,1,2013-09-18 01:54:17,2013-09-18 01:54:17
3a025b97ffdf5f5f633d6d6d9b13f0974fa8052f...b3a559ddce5e23d7084546ca771fc16e96d24ed8,1,2,1,3,2,2013-07-13 12:14:40,2013-07-13 11:55:03
b3a559ddce5e23d7084546ca771fc16e96d24ed8...d6cb13d7436793718f103687fe95d0f881487ad0,1,1,0,1,1,2013-07-13 12:14:43,2013-07-13 12:00:05
ca1fba51156b88108e6686ef7b95d9f833ac5bc1...726b75d1b839649ee118e5521f52c669f4664d45,2,58,7,65,7,2013-12-02 19:32:37,2013-12-02 19:32:37
ca1fba51156b88108e6686ef7b95d9f833ac5bc1...27f680a9981202ed47764232f67a8d043de9286c,1,2,2,4,2,2013-12-01 09:35:56,2013-12-01 09:35:56
4e1f517c61fef323b9cb3acedd19ce7859a8e546...7b50c7845bbc801ae2bb2d54e06996b7ecf424dc,1,0,1,1,1,2013-12-27 13:15:48,2013-12-27 13:15:48
31eed56b9e212c92e76db07e8a04184826d269f9...8c4c357f1830c246c1935c84aacc606e5d0762be,3,8,2,10,4,2012-06-19 00:43:36,2012-06-19 00:43:36
80c03754ae57ad387a6c02a5e58a59a327d44638...0abd724454078f2089701b54be94df7306dcfb8e,28,289,23,312,44,2012-06-08 19:09:10,2012-06-04 23:17:41
0abd724454078f2089701b54be94df7306dcfb8e...145e696b498a046762e4df9045c9b71440308486,7,291,82,373,35,2012-06-08 19:11:13,2012-06-08 18:56:24
145e696b498a046762e4df9045c9b71440308486...d17db71b6f8343204683542538416ec87e06261e,1,2,1,3,1,2012-06-08 20:56:53,2012-06-08 20:56:53
d17db71b6f8343204683542538416ec87e06261e...ac971ecfdb11af8fa36c15eb9afb0fd8545daf08,1,7,4,11,4,2012-06-08 21:08:34,2012-06-08 21:08:34
ad5df35a47d56c3d716d7a56eac4aeb611987c11...66024c7cbcbae3a75d0b0426993d8ee5fa5f9dfb,11,239,80,319,72,2012-05-19 15:50:52,2012-04-30 22:05:25
66024c7cbcbae3a75d0b0426993d8ee5fa5f9dfb...a6f24a5b3a8dcb9ab7f84679d658e66f374b88d6,6,102,20,122,24,2012-05-19 15:50:52,2012-04-30 23:50:26
a6f24a5b3a8dcb9ab7f84679d658e66f374b88d6...89460f3f57b6efa906263a19b982f8a7859b15c9,3,35,7,42,12,2012-05-19 15:50:52,2012-05-03 12:07:55
89460f3f57b6efa906263a19b982f8a7859b15c9...dbb36e1b42de2b65b3ea98501dc6aae754acd744,2,106,3,109,7,2012-05-19 15:51:53,2012-05-17 15:56:49
dbb36e1b42de2b65b3ea98501dc6aae754acd744...16768191c739e6478db95b80a51753dfd0662302,1,17,9,26,5,2012-05-19 15:51:53,2012-05-17 19:16:59
16768191c739e6478db95b80a51753dfd0662302...d3e1367f61030f78692fb9f02e82cd49b1f8e949,4,25,119,144,19,2012-05-19 15:51:53,2012-05-17 19:40:20
d3e1367f61030f78692fb9f02e82cd49b1f8e949...3f9eb1e50201a3a99dad84ce22ad799fed15eaf1,1,32,7,39,5,2012-05-19 15:51:53,2012-05-17 20:22:05
3f9eb1e50201a3a99dad84ce22ad799fed15eaf1...441df990b4e68459eb98c10445478d0fece30b83,1,54,11,65,8,2012-05-19 15:51:53,2012-05-17 21:57:30
441df990b4e68459eb98c10445478d0fece30b83...250b95b24b1a079be5825f862e42f4b99a4c3587,6,24,2,26,9,2012-05-26 19:17:08,2012-05-26 19:17:08
ad5df35a47d56c3d716d7a56eac4aeb611987c11...d73c94b21c58d78a7bf268bc9e3b0f4daa11e514,15,30,30,60,30,2012-05-19 13:26:52,2012-05-19 13:24:55
ad5df35a47d56c3d716d7a56eac4aeb611987c11...56e1e2bf7005d904df482e45f9008544338f07e9,1,1,1,2,1,2012-05-19 11:05:56,2012-05-19 11:05:56
56e1e2bf7005d904df482e45f9008544338f07e9...8e1742ab1358dd8de7efe0f6ceb94eb28ac33f87,1,2,2,4,1,2012-05-19 11:06:19,2012-05-19 11:06:19
d4831b71ecf7c317d748c2344ed6d1c328c30746...157cef1048ac797dcaf9f81075a61005124d2d1c,3,3,0,3,3,2013-10-28 04:57:15,2013-10-28 04:57:15
97d32abb492f7830f6e26719ce558429f6377b73...1d37da3392276c16d49a3680e9bd6c22f2c3abd0,1,1,1,2,1,2013-10-30 15:25:49,2013-10-30 15:25:49
97d32abb492f7830f6e26719ce558429f6377b73...2f8c481cc08ee00fa9c298f80eae0616e99faef1,3,58,29,87,14,2013-10-30 15:20:42,2013-10-08 14:22:21
567649f2ada60e5c3009cc985af238b452b14a81...7e0359084ef0faba8f458f9cccad2dc8f5baf800,2,35,25,60,9,2013-11-01 22:29:25,2013-11-01 22:29:25
7e0359084ef0faba8f458f9cccad2dc8f5baf800...56c1cda28a4b33fb305d99a2c7985a37efd3839d,1,3,2,5,2,2013-11-02 02:22:43,2013-11-02 02:22:43
56c1cda28a4b33fb305d99a2c7985a37efd3839d...c227c173b84c8107a8933aeed947f16d82224377,5,102,116,218,50,2013-11-04 19:42:14,2013-11-04 19:42:14
c227c173b84c8107a8933aeed947f16d82224377...16bffd1c26d8d22a61b5d99fd4063c2f71751317,2,40,4,44,6,2013-11-04 20:04:17,2013-11-04 20:04:17
16bffd1c26d8d22a61b5d99fd4063c2f71751317...2d1feaa2c7aef2e0d230e5535b214289c2c4a905,1,2,0,2,1,2013-11-04 23:03:44,2013-11-04 23:03:44
2d1feaa2c7aef2e0d230e5535b214289c2c4a905...ac72051afa619446818adf286cf3cdbd13991b38,1,3,2,5,3,2013-11-05 03:09:30,2013-11-05 03:09:30
ac72051afa619446818adf286cf3cdbd13991b38...fe294b95d1f04ceb4d279b312d3f88375dbe0dc9,1,5,5,10,4,2013-11-05 18:37:50,2013-11-05 18:37:50
fe294b95d1f04ceb4d279b312d3f88375dbe0dc9...d6eb3f9ce7f3b794d8e9ec2bb52bf995dd32cde9,1,1,1,2,1,2013-11-05 18:54:44,2013-11-05 18:54:44
d6eb3f9ce7f3b794d8e9ec2bb52bf995dd32cde9...79c443425b1b3d67e8180663c6e80793b587c888,2,9,14,23,6,2013-11-05 19:35:57,2013-11-05 19:35:57
567649f2ada60e5c3009cc985af238b452b14a81...2f03050f4fc50746faef46be498aa0af9697fee2,2,7,6,13,5,2013-11-01 21:47:06,2013-10-26 14:21:31
2f03050f4fc50746faef46be498aa0af9697fee2...a7382aa28c8a24a4f718eb01574d744330f7a5a9,1,6,5,11,4,2013-11-01 21:47:06,2013-10-26 14:52:54
a7382aa28c8a24a4f718eb01574d744330f7a5a9...968c7d072ae61852564a831706ca5e969a2eb62c,2,27,0,27,4,2013-11-01 21:47:06,2013-10-26 15:35:12
968c7d072ae61852564a831706ca5e969a2eb62c...af613ecd445bf0abfda81769e7a2d763413dfd04,6,128,90,218,35,2013-11-01 21:48:09,2013-10-28 22:30:45
af613ecd445bf0abfda81769e7a2d763413dfd04...266af6d81960144334c16e061f1d30f94f8a1b46,3,95,34,129,14,2013-11-10 21:21:25,2013-10-30 12:44:22
266af6d81960144334c16e061f1d30f94f8a1b46...359dce726d215be65aee719c7316b43e3851c031,16,140,163,303,81,2013-11-11 14:35:51,2013-11-01 23:05:32
359dce726d215be65aee719c7316b43e3851c031...1c967df31c9285af6eaea3c462314b4b88c2706a,2,4,7,11,3,2013-11-11 14:35:52,2013-11-01 23:51:57
1c967df31c9285af6eaea3c462314b4b88c2706a...877cde765a9957f893d7b22026a8c82bf82226d4,1,27,3,30,5,2013-11-11 14:35:52,2013-11-02 00:10:21
877cde765a9957f893d7b22026a8c82bf82226d4...ae2972122e9487c38a2e72109a35b7d337658d84,3,23,19,42,10,2013-11-11 14:35:52,2013-11-10 16:29:06
ae2972122e9487c38a2e72109a35b7d337658d84...a6192d7c98976edb0ce4fd10438ac7a19c283598,3,27,11,38,7,2013-11-11 14:35:52,2013-11-11 14:32:13
567649f2ada60e5c3009cc985af238b452b14a81...c2408a698ad395c8bd84297de839080d131c6d6d,2,26,2,28,3,2013-11-01 21:27:07,2013-11-01 21:03:01
567649f2ada60e5c3009cc985af238b452b14a81...dcfdb977d0767395055afe2dcd44fe260e39b46d,4,137,5,142,5,2013-11-01 17:51:12,2013-11-01 17:51:12
dcfdb977d0767395055afe2dcd44fe260e39b46d...6cb831bd5667d934d8947279523cb235b4f8bba4,12,125,33,158,23,2013-11-02 12:33:26,2013-11-02 12:33:26
567649f2ada60e5c3009cc985af238b452b14a81...3940310e29363978ccdc1f3b557bc6f48ebae8f0,2,34,17,51,8,2013-11-01 17:20:51,2013-10-30 20:56:42
3940310e29363978ccdc1f3b557bc6f48ebae8f0...4bf630b6baf342fa929a8f7e4e6643197b74216f,17,180,56,236,49,2013-11-01 17:20:51,2013-10-31 21:36:52
4bf630b6baf342fa929a8f7e4e6643197b74216f...8e5a8ef86f1d528472884f737612083abda86e17,7,31,30,61,25,2013-11-01 17:20:51,2013-11-01 16:51:01
8e5a8ef86f1d528472884f737612083abda86e17...a5c16f3cfb92f1129ef13124fc70147480141d69,5,62,19,81,16,2013-11-01 17:20:51,2013-11-01 17:18:03
a5c16f3cfb92f1129ef13124fc70147480141d69...e7c85120eab6c942d15c0f5ed3a2c8b6ec667617,2,75,14,89,7,2013-11-01 18:39:37,2013-11-01 18:39:37
e7c85120eab6c942d15c0f5ed3a2c8b6ec667617...3e57069e821ecf966c3de9c79923cd77657e923b,3,62,6,68,6,2013-11-01 20:49:43,2013-11-01 20:49:43
c655aa5209e94200fd05bd618f48a757b2a6b2c8...816d28e7bc9473482664d374786dac484c0e1156,1,1,1,2,1,2013-10-01 19:56:47,2013-10-01 19:56:47
92457cad4123c6ee9bc56ce548285e09d06c204c...f84bc3885327670babbfed1e351036d113fce903,3,12,12,24,11,2013-09-17 15:28:16,2013-09-17 15:24:44
f84bc3885327670babbfed1e351036d113fce903...7e8934bba206bf28e3f51eb583aadde051129b11,2,13,2,15,4,2013-09-17 15:29:02,2013-09-17 15:29:02
7e8934bba206bf28e3f51eb583aadde051129b11...b99b10f285fec710273d1233b057ff33a6e44993,2,28,1,29,3,2013-09-17 16:00:41,2013-09-17 15:38:52
b99b10f285fec710273d1233b057ff33a6e44993...a025907e0d751ed1022e65365243ae97acf3f598,3,24,5,29,9,2013-09-17 16:09:09,2013-09-17 15:55:11
5a284edca42dd75cf62b3fe75020819fcfcea9f3...32b247d5e78135e8fbaf4c0b612532995201a3a2,1,28,0,28,1,2013-09-19 17:30:43,2013-09-19 17:30:43
1662158cf98ce32827f3857fd9559a1b0e6223ed...960431c3808a98333aa9642424bcc7fef581b78c,1,1,1,2,1,2013-07-14 22:08:54,2013-07-14 21:26:24
1662158cf98ce32827f3857fd9559a1b0e6223ed...d6d34cd0f49621c6f5ea992820c4564f5e968b73,1,5,2,7,5,2013-07-14 12:07:40,2013-07-12 17:10:16
d6d34cd0f49621c6f5ea992820c4564f5e968b73...6550565af387119b080a65d71f77f1261752595b,1,23,18,41,4,2013-07-14 12:08:45,2013-07-12 18:02:00
6550565af387119b080a65d71f77f1261752595b...a91e4d6b21e141c2abc76b65b2d4c91d5d3e03cc,1,2,2,4,2,2013-07-14 22:30:18,2013-07-14 22:19:42
a91e4d6b21e141c2abc76b65b2d4c91d5d3e03cc...19bee769d49467704f4d8ee36965c548cb40e3c6,1,2,2,4,2,2013-07-14 22:39:16,2013-07-14 22:39:16
19bee769d49467704f4d8ee36965c548cb40e3c6...b74d4478df8c6d62c96b3bd067ae1987209583a6,1,18,23,41,4,2013-07-14 22:44:08,2013-07-14 22:41:39
b74d4478df8c6d62c96b3bd067ae1987209583a6...2185dd6f99474b69287e6f3cd2e4a24c3a75155b,1,2,2,4,2,2013-07-14 23:06:09,2013-07-14 22:59:04
2185dd6f99474b69287e6f3cd2e4a24c3a75155b...d0b25d9dff363976eea92509c359ca8e08aaebb5,1,2,2,4,2,2013-07-14 23:14:00,2013-07-14 23:14:00
1662158cf98ce32827f3857fd9559a1b0e6223ed...80fd31faf773f3f50e2b5547b7171063f38dac17,2,54,0,54,6,2013-07-13 14:07:10,2013-07-13 11:30:23
14984af6cb9906746d2c64c5df7542ecd7406b16...db4cbfe5041d2dca342b123c14259d1860ed4c8c,2,39,19,58,13,2013-12-03 04:05:10,2013-12-02 19:09:12
14984af6cb9906746d2c64c5df7542ecd7406b16...300d192f7ed45112121f2a35d5ca80a4913c7aad,56,822,8,830,39,2013-12-02 22:57:41,2013-12-02 16:15:27
300d192f7ed45112121f2a35d5ca80a4913c7aad...bab0b9f2d21d993c3f25ee00ce2d243a4dc0de93,7,62,81,143,13,2013-12-02 22:57:41,2013-11-22 23:02:12
14984af6cb9906746d2c64c5df7542ecd7406b16...2123a17f83cc95adee4e7259d0686b07f074de4c,2,79,16,95,7,2013-12-02 21:27:06,2013-12-02 21:27:06
2123a17f83cc95adee4e7259d0686b07f074de4c...97ad85b88d7a2f6d1c31a07de3c3c0b4b504d4ee,3,94,14,108,17,2013-12-02 21:30:05,2013-12-02 21:30:05
97ad85b88d7a2f6d1c31a07de3c3c0b4b504d4ee...f62c174d0d88c3e491fe3f4e3490959edb7cae1b,3,4,4,8,4,2013-12-02 21:49:58,2013-12-02 21:49:58
868563cc925c3be5be569a130289abbf1ccd4943...f38cb9815fde36843a945bfac115122c43b610a5,1,3,3,6,3,2013-12-31 10:27:32,2013-12-31 10:27:32
868563cc925c3be5be569a130289abbf1ccd4943...fccadba25268ab6df6637265cb4912079e5ed10b,3,54,14,68,12,2013-12-30 23:34:39,2013-12-29 02:26:21
fccadba25268ab6df6637265cb4912079e5ed10b...217fee9ae67ecd338d6c153585f7e968adc7878d,1,1,0,1,1,2013-12-30 23:34:40,2013-12-29 03:30:38
217fee9ae67ecd338d6c153585f7e968adc7878d...41ceab2522655d92c6da5fa1ead197af54ee9862,1,17,8,25,8,2013-12-30 23:34:40,2013-12-29 03:21:13
68f527c4480f0c1e24f29dc0a2337469fe50967f...2c90145aad86084dc72400ad0d47ed6e0ce2762f,2,7,1,8,3,2012-06-19 16:25:55,2012-06-19 16:24:44
68f527c4480f0c1e24f29dc0a2337469fe50967f...743a4b3bdd0ff37eacf49e496ba2e5cd7b9a3f83,9,80,19,99,18,2012-06-19 08:02:22,2012-06-15 20:24:59
e0b110edb1d0863ad454bfce0b0c3ac1ceef3392...cfc17dc41b1ce251d72696b4168b3d6d77fc54ab,1,14,0,14,1,2012-06-09 21:43:18,2012-06-09 21:43:18
cfc17dc41b1ce251d72696b4168b3d6d77fc54ab...9939e602d8aaffcc65e2db54ff670c8fa888299c,1,2,0,2,1,2012-06-11 16:24:02,2012-06-11 16:24:02
966fbdcb8eb5839d3ca41d5b838c1cec1b393b3c...fdc5c38e406612ffccfab3f3e90013c63cee3a7b,2,2,2,4,2,2012-06-05 21:03:06,2012-06-05 21:03:06
fdc5c38e406612ffccfab3f3e90013c63cee3a7b...66798ad0d8e30821c0ac26a6c602e2e2cf0b2fff,1,1,1,2,2,2012-06-06 09:00:15,2012-06-06 09:00:15
f7ed0c344713f5391fa7e63e7b432fde0896bf89...e203e9d47268f4322fa801bf48769282b229c19b,1,0,1,1,1,2012-05-19 16:57:13,2012-05-19 16:13:38
f7ed0c344713f5391fa7e63e7b432fde0896bf89...54db1a18df8baca4e53be24a4bf8593d94abbd49,2,0,10,10,2,2012-05-19 16:49:32,2012-05-19 11:20:55
cc7453417f6ab4783d1211a0562fa3ea438649b2...29b77446b7237204ddd7fee36c0ad3b4c9513715,1,2,2,4,2,2013-10-30 22:38:52,2013-10-30 22:38:52
29b77446b7237204ddd7fee36c0ad3b4c9513715...ff0ef88c5bb570ea2553ba6ea99236a68d39f950,1,10,1,11,2,2013-10-31 01:54:39,2013-10-31 01:54:39
7f13edfdbbff733ecbde4020de00e3bfa8e5a868...187009e253efa54f6db690a16504adf7f2c32d17,1,1,0,1,1,2013-11-02 17:34:51,2013-11-02 17:34:51
187009e253efa54f6db690a16504adf7f2c32d17...a7a64d2cadade53175ba27c1a29023278bdc4288,1,12,6,18,5,2013-11-02 17:54:55,2013-11-02 17:36:34
a7a64d2cadade53175ba27c1a29023278bdc4288...becb13c0f04c4ba54cf27303136293dbf8abfd73,1,42,16,58,14,2013-11-03 15:20:24,2013-11-03 12:46:07
7f13edfdbbff733ecbde4020de00e3bfa8e5a868...10749f6ca25179778cf60e411f7de3de1444271d,2,4,4,8,4,2013-11-02 03:20:05,2013-11-02 03:20:05
10749f6ca25179778cf60e411f7de3de1444271d...352214416c0e5fd85ef02077ddf185103f3a92df,2,16,5,21,2,2013-11-02 03:43:34,2013-11-02 03:43:34
352214416c0e5fd85ef02077ddf185103f3a92df...7b3959b22784d63dd6f21bc250602b886d726294,1,1,13,14,2,2013-11-02 03:45:32,2013-11-02 03:45:32
816d28e7bc9473482664d374786dac484c0e1156...8378695671cec5d45464cea65aa5199ecf242212,2,100,0,100,4,2013-10-01 20:49:41,2013-01-04 19:39:05
351733128ca766d1fe73ca0f299b08725342574a...85e1eded6a5302b25c339988a6828aa45fbc23d8,2,14,0,14,2,2013-07-15 14:31:25,2013-07-15 14:31:25
351733128ca766d1fe73ca0f299b08725342574a...9146f1e57ec4f2b6fa293c78d54f1383464ff5be,1,3,3,6,3,2013-07-15 14:29:00,2013-07-15 13:59:18
9146f1e57ec4f2b6fa293c78d54f1383464ff5be...8d6ef4bf78cc5d3a3cb277ecc4fcf0fdcdbc9f20,2,10,4,14,7,2013-07-15 14:29:09,2013-07-15 13:59:35
8d6ef4bf78cc5d3a3cb277ecc4fcf0fdcdbc9f20...050af8bbe08b7cab7bfce044dcb51fb61ff1dc41,2,6,2,8,4,2013-07-15 14:29:13,2013-07-15 14:00:00
050af8bbe08b7cab7bfce044dcb51fb61ff1dc41...c6451624c4631ccf039d0f3d5af6fbf4364f001c,2,4,1,5,3,2013-07-15 14:29:18,2013-07-15 14:00:07
a149a189239718eb3180a4e1f025c3012e7ea3b1...d706e843e1e2e1b5edca57fe691d9e72fd844ffd,1,1,0,1,1,2013-12-03 15:00:50,2013-12-03 15:00:50
f3a302ad8e961f0180d37693ca6de4b65c3ffc81...c24130e06896e9838a05301079bdb8f09912e546,1,1,0,1,1,2014-01-18 14:58:31,2014-01-18 14:58:31
f3a302ad8e961f0180d37693ca6de4b65c3ffc81...9152417290e7e375552638c2b340e9163c80dd8d,2,4,4,8,4,2014-01-02 22:30:24,2014-01-02 22:30:24
f3a302ad8e961f0180d37693ca6de4b65c3ffc81...e5994eb02d1f43dd5f9104854fb6fb7448264167,1,15,0,15,1,2014-01-02 15:56:09,2014-01-02 15:56:09
e5994eb02d1f43dd5f9104854fb6fb7448264167...0b7951788cb793cea45594b168e3936527a3277a,1,2,2,4,2,2014-01-02 15:58:13,2014-01-02 15:58:13
f3a302ad8e961f0180d37693ca6de4b65c3ffc81...6014b7b59ce3320311d61b929e9567c0503b630b,1,1,1,2,1,2014-01-02 14:10:32,2013-12-30 17:08:04
6014b7b59ce3320311d61b929e9567c0503b630b...10311979492a4b91b24ebab178588e9af801bc42,3,29,0,29,6,2014-01-02 14:10:32,2014-01-02 02:14:03
1b0ef5aa03fad68105784d5d4d87592ce005e03a...053b5096680dd9eaeb679f673f5924a05fe514d9,1,6,1,7,3,2012-06-19 21:47:17,2012-06-19 21:36:36
1b0ef5aa03fad68105784d5d4d87592ce005e03a...da825c92d92433240ceeaea70d7618395bcfb83d,8,327,25,352,24,2012-06-19 21:27:02,2012-06-19 21:27:02
da825c92d92433240ceeaea70d7618395bcfb83d...77d65af4398c6e2b7b7d54cbc10857f02132740e,1,1,1,2,1,2012-06-19 22:16:38,2012-06-19 22:16:38
80779ea83ed606fadbb7affdbee22c3abb946284...0284a21983b0158c22aa8f8267aa9de60cb6722b,1,1,0,1,1,2012-06-11 19:55:36,2012-06-11 19:55:36
0284a21983b0158c22aa8f8267aa9de60cb6722b...471fa05eb71f467df2556185c3cfdcfd6a979854,1,21,15,36,6,2012-06-11 22:53:47,2012-06-11 22:38:33
66798ad0d8e30821c0ac26a6c602e2e2cf0b2fff...b9f78cb87b7a8cb07a660dacdcb59c9adf733c3f,1,1,0,1,1,2012-06-07 13:49:52,2012-06-07 13:49:52
b9f78cb87b7a8cb07a660dacdcb59c9adf733c3f...8e60c712acef798a6b3913359f8d9dffcddf7256,5,29,18,47,26,2012-06-07 13:50:19,2012-06-07 13:50:19
66798ad0d8e30821c0ac26a6c602e2e2cf0b2fff...6183f0e2b2a42d6715f3d0d85fbc41d170328ad1,1,12,13,25,5,2012-06-07 12:55:24,2012-06-07 12:55:24
6183f0e2b2a42d6715f3d0d85fbc41d170328ad1...b46bdb2204ce5f73af998a9e126109a6c065b7c7,3,132,0,132,5,2012-06-07 14:25:37,2012-05-25 14:28:53
66798ad0d8e30821c0ac26a6c602e2e2cf0b2fff...6f944ab1962b007f5b16c869b7005a978be532ed,1,3,1,4,1,2012-06-07 11:36:28,2012-06-07 11:36:28
6f944ab1962b007f5b16c869b7005a978be532ed...6654dbe3207a16bae7b5f96034faf2075ff1942b,1,1,1,2,1,2012-06-07 12:09:25,2012-06-07 12:09:25
7a361e93f39789e9523caeb3ef8754173165aab7...23059130078be6982f75ab5620c55222471f3423,2,174,3,177,5,2012-05-24 19:45:20,2012-05-24 19:45:20
23059130078be6982f75ab5620c55222471f3423...9e35d7fd6ee0b6dc0008982ab84668fbb2478939,2,15,14,29,13,2012-05-24 20:44:24,2012-05-24 20:44:24
7a361e93f39789e9523caeb3ef8754173165aab7...8bf10dbab23c84aaccc4847afe0fc4b6968dbe9d,1,0,2,2,2,2012-05-23 10:59:21,2012-05-23 10:59:21
7a361e93f39789e9523caeb3ef8754173165aab7...dc07184fa9f187eddab16b2996db24e9731aa3f0,2,18,7,25,7,2012-05-23 10:57:13,2012-05-23 10:05:48
7a361e93f39789e9523caeb3ef8754173165aab7...ab4aa138ada1b088cdaa7e20d843011aa48c1659,1,1,1,2,1,2012-05-20 07:40:31,2012-05-20 07:40:31
ab4aa138ada1b088cdaa7e20d843011aa48c1659...62986ff6de9b113ac23617b4e1f652ec6f609b8c,2,17,1,18,3,2012-05-20 07:52:49,2012-05-20 07:46:48
2255b60e28baec41bebdbf6f8b547d65eb522236...a146ba9e5b2188665ffcbd48d9584950ff60c8ca,1,1,1,2,1,2012-06-05 20:16:08,2012-06-05 20:16:08
87ac556f2f74a9a49c8d3ee8f9b7104fc4d287c8...88bfe790c0d7cd53baf771e3bb6aa9d3448c1edb,1,1,1,2,1,2012-05-24 11:38:25,2012-05-24 11:38:25
88bfe790c0d7cd53baf771e3bb6aa9d3448c1edb...7eeec8f22d2872ac2c88fd27818222537a1d6e37,2,126,126,252,11,2012-05-24 14:41:53,2012-05-24 14:41:53
7eeec8f22d2872ac2c88fd27818222537a1d6e37...d3e9c4a5fce82e34a91934121addc9b296e74cb8,1,4,3,7,3,2012-05-24 19:54:19,2012-05-24 19:49:43
ff0ef88c5bb570ea2553ba6ea99236a68d39f950...864e72719c9658336aa2a769e4592e8efeb8b4ef,1,3,3,6,2,2013-10-31 13:03:28,2013-10-31 12:58:00
becb13c0f04c4ba54cf27303136293dbf8abfd73...dd64c71c2685d0b72b6f58149ecf2a972a6ea98b,4,78,6,84,12,2013-11-04 19:50:25,2013-11-04 19:50:25
71e33d2649f990086237a6cd0fdb7f7d6f742b51...cf0582b43ce591e7923637d2c8925028aaa5977b,2,70,12,82,4,2013-10-04 08:18:20,2013-10-02 10:22:54
cf0582b43ce591e7923637d2c8925028aaa5977b...51e82492ef5206767e176952733914275d0e3bdc,3,35,35,70,4,2013-10-04 08:18:20,2013-10-03 14:54:25
51e82492ef5206767e176952733914275d0e3bdc...0b33fca03e030c7e807f0c75d7332e7fe2d3c0bc,10,340,44,384,38,2013-10-04 13:26:41,2013-10-02 11:39:35
0b33fca03e030c7e807f0c75d7332e7fe2d3c0bc...b4342b116d98ba439d958c374eb4d49b06488f4c,3,12,1,13,4,2013-10-04 13:26:43,2013-10-04 08:27:45
b4342b116d98ba439d958c374eb4d49b06488f4c...7fb6eb278b350f9f4caab5a3f72bfb70353fc40d,1,37,27,64,11,2013-10-08 09:54:50,2013-10-08 09:54:50
7fb6eb278b350f9f4caab5a3f72bfb70353fc40d...893055f22e5395ec95231b4cc8a19046a3eb5b4a,3,10,4,14,5,2013-10-11 15:26:20,2013-10-11 15:24:29
893055f22e5395ec95231b4cc8a19046a3eb5b4a...ebbd48f00e87eab699862f03a457571ead3c53b1,1,6,1,7,2,2013-10-23 12:22:44,2013-10-23 12:22:44
ebbd48f00e87eab699862f03a457571ead3c53b1...ab46b1d8ebcdc820aefe2c1391d4be73939bce95,4,21,2,23,9,2013-10-23 13:08:18,2013-10-23 13:08:18
71e33d2649f990086237a6cd0fdb7f7d6f742b51...b976f3c2c228413d124be8fea3280a44bd5e3136,14,595,446,1041,79,2013-10-02 04:53:24,2013-08-19 11:01:49
b976f3c2c228413d124be8fea3280a44bd5e3136...d274deea23a2c2a70ee1695e8f917dbca50c76b7,3,93,25,118,12,2013-10-02 04:53:24,2013-08-20 09:12:34
d274deea23a2c2a70ee1695e8f917dbca50c76b7...0174794a955dbec1e2d9ecf581833fc23c7e844c,3,86,129,215,15,2013-10-02 04:53:24,2013-08-21 03:12:49
71e33d2649f990086237a6cd0fdb7f7d6f742b51...d31402a3fc4aa1b7d48ba43fd3bb072e7d69a527,15,66,46,112,39,2013-10-02 04:41:42,2013-09-16 02:20:05
d31402a3fc4aa1b7d48ba43fd3bb072e7d69a527...e3c131c544bc79573ebefab4931b5ca89836ace1,12,20,31,51,20,2013-10-02 04:41:42,2013-09-16 03:02:25
e3c131c544bc79573ebefab4931b5ca89836ace1...d19870d947eef17008ae0b4b7ebc9e9d0038a770,3,118,15,133,10,2013-10-02 04:41:42,2013-09-16 03:10:55
d19870d947eef17008ae0b4b7ebc9e9d0038a770...fe3a40a4ff056400cde6e456211d6b5f2ec1008e,3,31,20,51,5,2013-10-02 04:41:42,2013-09-16 14:54:37
fe3a40a4ff056400cde6e456211d6b5f2ec1008e...c8dbec4803aa7d8300f19a97431bbf631ac5a392,3,5,44,49,5,2013-10-02 04:41:42,2013-09-16 16:42:53
c8dbec4803aa7d8300f19a97431bbf631ac5a392...e3a92f0dfc28e423a2f06688338f81b8d17abaf6,1,19,58,77,7,2013-10-02 04:41:42,2013-09-17 03:31:34
e3a92f0dfc28e423a2f06688338f81b8d17abaf6...6ac15eff6d173674d9f17e9d5ddb98997eb97cf4,3,5,99,104,12,2013-10-02 04:42:26,2013-09-20 20:34:05
6ac15eff6d173674d9f17e9d5ddb98997eb97cf4...b9bf5d701dd6dfcfcb41d2655f59f7669cd50ef9,2,4,0,4,2,2013-10-02 04:42:26,2013-09-20 20:46:32
b9bf5d701dd6dfcfcb41d2655f59f7669cd50ef9...eec1c1fe1e9a12b57c4014be25ce4ed390c8e199,5,8,8,16,8,2013-10-02 04:42:26,2013-09-20 20:49:20
eec1c1fe1e9a12b57c4014be25ce4ed390c8e199...c833893c64d28d4c017fdbf90bbeb714314a8dd9,3,17,18,35,7,2013-10-02 04:42:26,2013-09-20 20:57:01
c833893c64d28d4c017fdbf90bbeb714314a8dd9...fdc7e5e35efa072a145cf318457055f60c9b21eb,2,15,5,20,7,2013-10-02 04:42:27,2013-09-20 21:14:12
fdc7e5e35efa072a145cf318457055f60c9b21eb...36a241acbb39aa46cf5f7807aebd92e45f2f5eaf,1,5,2,7,1,2013-10-02 04:42:27,2013-09-20 21:14:52
36a241acbb39aa46cf5f7807aebd92e45f2f5eaf...ffc97d51264f8af435ccf52d33a62a6925b174c9,1,33,1,34,7,2013-10-02 04:42:27,2013-09-20 21:23:42
ffc97d51264f8af435ccf52d33a62a6925b174c9...0e0cf78773bea0d06298ba3bf981a3be839041df,9,26,35,61,24,2013-10-02 12:04:44,2013-10-02 12:04:44
f538515079bc3af9b5b69f727b0810e57684af81...51b0397a66336cd9b45f5562c0fb147052c2e086,1,1,1,2,1,2013-07-16 03:40:57,2013-07-16 03:40:57
1cd9dc29b7105cb33959d15ab670a085f5a1445b...b4a4cf24a539ce07d86fed6835c98154fb40e723,3,53,6,59,11,2013-07-22 23:07:56,2013-07-22 23:07:56
b4a4cf24a539ce07d86fed6835c98154fb40e723...197b8966dba18770e4b77a17173c8f354ac175e3,5,130,79,209,42,2013-07-23 21:34:31,2013-07-23 21:34:31
197b8966dba18770e4b77a17173c8f354ac175e3...df40f3981c312b03415e388663176b2a8315221a,1,3,3,6,2,2013-07-23 22:18:28,2013-07-23 22:18:28
df40f3981c312b03415e388663176b2a8315221a...eb1c1707ab6a399734d9083152c05516af052412,2,44,23,67,8,2013-07-23 22:45:58,2013-07-23 22:45:58
1cd9dc29b7105cb33959d15ab670a085f5a1445b...b71071313f4800840ecc48cb18e5cedec8ef250e,2,35,3,38,6,2013-07-22 18:01:19,2013-07-22 18:01:19
b71071313f4800840ecc48cb18e5cedec8ef250e...c77342ef1c956f99f84f217359c73e8de65cdd1c,1,33,22,55,14,2013-07-22 18:20:34,2013-07-22 18:20:34
c77342ef1c956f99f84f217359c73e8de65cdd1c...989710d9828ef0f90b494903bd1e1bd8b20a8914,1,3,5,8,2,2013-07-22 18:22:55,2013-07-22 18:22:55
989710d9828ef0f90b494903bd1e1bd8b20a8914...4cee9b8618b949f55233f2350654d771a0dc2ece,1,38,12,50,15,2013-07-22 18:41:23,2013-07-22 18:41:23
794003650e041668405a5ee12a7f763dca951758...275d8d55b29c83bd8c165f5eeaafd76c7e0d966b,1,1,1,2,1,2013-07-18 16:37:59,2013-07-18 16:37:59
553d33732aa69f5dab717181fc3a72b42ce07339...eac938d96eccb39c30ce94adf7f8cdc06df098fe,9,470,61,531,25,2013-12-03 15:18:53,2013-12-02 19:10:04
b97e55f2f16ea91f2e1c4e4a7e35af9b5260ca78...8610487cd321052d156202b7dd213add29fe6b21,2,0,6,6,2,2014-01-23 15:28:28,2014-01-23 15:28:28
b97e55f2f16ea91f2e1c4e4a7e35af9b5260ca78...7cbc6241cf75bd8bd198273231e994711c998716,1,6,3,9,5,2014-01-20 17:41:21,2014-01-20 17:41:21
7cbc6241cf75bd8bd198273231e994711c998716...abdaf9366262ea034e092e8a9a707f5a7837ca65,1,31,0,31,2,2014-01-20 17:42:12,2014-01-20 17:42:12
b97e55f2f16ea91f2e1c4e4a7e35af9b5260ca78...e7c66fc89b2ff34c014f402ee7f91188eea5e0f6,1,2,0,2,1,2014-01-20 15:32:18,2014-01-20 15:32:18
9152417290e7e375552638c2b340e9163c80dd8d...97bbf61e901ac9e0080394a9321dfc632b77fe99,1,57,9,66,10,2014-01-03 20:14:22,2014-01-03 20:14:22
97bbf61e901ac9e0080394a9321dfc632b77fe99...79ccb921781dc61c4ed06e5c8c19c2ea1ba0a33a,1,40,6,46,9,2014-01-03 22:26:02,2014-01-03 22:26:02
9152417290e7e375552638c2b340e9163c80dd8d...b49985212a395b54dbaa50c7d39faaaf6f4c4f4b,1,6,2,8,2,2014-01-03 19:37:23,2014-01-03 19:37:23
fe959e52734720be143ae26f910fe137496045ed...551f5cefb41877be03e6d7a03f16fd424fc9de37,1,1,0,1,1,2014-01-08 11:47:47,2014-01-08 11:47:47
fe959e52734720be143ae26f910fe137496045ed...a06474f81dacabd5357be358a73340ee19306956,1,4,2,6,4,2014-01-08 03:19:12,2014-01-08 03:19:12
a06474f81dacabd5357be358a73340ee19306956...b92b434f5a240a8c149bcf86bbcd1743cd873bcf,1,3,0,3,1,2014-01-09 03:18:38,2014-01-09 03:18:38
ac9f92316b4fcace1c591a33d20fa4514f3ec2c6...e7f89b46c35727af5efc92ae46199285d8426d57,1,1,1,2,1,2014-01-04 23:18:59,2014-01-04 23:18:59
c3ce8d0c9a8c9510e713babf1110b2df84f0aa88...cdca82c7842ade2074f37be22f2251d6a9040a9d,3,6,0,6,4,2012-06-19 22:46:34,2012-06-19 22:46:26
471fa05eb71f467df2556185c3cfdcfd6a979854...c0734593719c37c7c7c4cbd2c797e41b6276e330,1,0,5,5,2,2012-06-12 09:34:01,2012-06-12 09:33:46
c0734593719c37c7c7c4cbd2c797e41b6276e330...14ebe518320b0306b04d256d0f5230de32c3f8b3,1,8,0,8,1,2012-06-12 13:24:33,2012-06-12 13:23:00
471fa05eb71f467df2556185c3cfdcfd6a979854...976b69bdbbd2a84684d5120ac738132ebcd7a532,1,10,2,12,3,2012-06-12 04:42:46,2012-06-11 09:06:53
976b69bdbbd2a84684d5120ac738132ebcd7a532...7623b1b63f787e7d8a4354db3a0a75d7b6039bf5,2,9,0,9,2,2012-06-12 04:42:46,2012-06-11 09:33:13
5f60fd009804fbd9886549dc74c04294e3e2cf7a...349fb6d7acd2d57fb5c0039e7f1228cff1702b13,1,51,103,154,14,2012-05-24 21:10:12,2012-05-24 21:04:41
349fb6d7acd2d57fb5c0039e7f1228cff1702b13...9cde607c95ecb3b5e49ff939fa8de44641fec589,2,11,20,31,12,2012-05-24 22:08:55,2012-05-24 22:08:55
8bf10dbab23c84aaccc4847afe0fc4b6968dbe9d...902bfd31f476b4c7edc8e23cb57689dcbf26949e,1,2,2,4,2,2012-05-23 14:42:02,2012-05-23 14:42:02
902bfd31f476b4c7edc8e23cb57689dcbf26949e...0f4d78d29d2ccb84043726af520a4e0bf4b8b139,1,3,1,4,1,2012-05-23 15:12:14,2012-05-23 15:12:14
f93f3790c511d3ed821bf63fdaf5aeec155e195b...3793fa9b181f3595c24a1cc517646f8e7a4a7175,7,199,12,211,17,2013-10-31 23:08:52,2013-10-31 00:08:50
3793fa9b181f3595c24a1cc517646f8e7a4a7175...a71331ebc40b445a58d73a1fe3fb2dc21665c09c,1,2,0,2,1,2013-10-31 23:08:52,2013-10-31 22:41:48
a71331ebc40b445a58d73a1fe3fb2dc21665c09c...376454d03dbb0c78b1266a85b29ec8bf48930a4d,1,4,1,5,2,2013-10-31 23:08:52,2013-10-31 22:42:04
f93f3790c511d3ed821bf63fdaf5aeec155e195b...7be5104d241ce84537076ad92d2ac1604ea33b8a,2,9,6,15,3,2013-10-31 20:15:49,2013-10-31 20:15:49
7be5104d241ce84537076ad92d2ac1604ea33b8a...151b321898a4b24bfa25f0c4a6bacf6565e0cdb4,1,4,3,7,1,2013-10-31 20:16:04,2013-10-31 20:16:04
151b321898a4b24bfa25f0c4a6bacf6565e0cdb4...887df99f17c44b0726e0034885ea922b99254933,1,3,1,4,1,2013-10-31 20:29:16,2013-10-31 20:29:16
887df99f17c44b0726e0034885ea922b99254933...048f837b2fd5cd12ed7e3ca497f11460ab3114a9,2,7,6,13,4,2013-10-31 20:30:22,2013-10-31 20:30:22
5bfead1dba919f6b47f52da675ea94407e8baf49...598f069b998c42c12439f3f353b6d075905becba,4,37,7,44,12,2013-10-03 05:59:55,2013-10-02 10:42:41
5bfead1dba919f6b47f52da675ea94407e8baf49...41a6de289fecbec426d2d977c4d02da5456701ac,2,38,0,38,3,2013-10-02 21:45:57,2013-10-02 21:45:57
5bfead1dba919f6b47f52da675ea94407e8baf49...5b1882254551cc9031d919c2f31c05153a665762,9,85,65,150,45,2013-10-02 19:12:44,2013-10-02 17:45:32
5b1882254551cc9031d919c2f31c05153a665762...83db7e09e2e9e81668704c21be26c917dea18fbd,1,0,4,4,3,2013-10-02 19:19:40,2013-10-02 19:10:39
83db7e09e2e9e81668704c21be26c917dea18fbd...7baa7631eab48fba1427b0c7b4b109da09dd050b,2,8,8,16,7,2013-10-03 13:51:21,2013-10-02 19:39:18
4e05fa7db4a24f47f37539f58168242c68b5b821...d55bed1a253a9f914521c29b9a2d2517a79c034d,1,3,1,4,2,2013-07-17 21:55:00,2013-07-17 21:55:00
4e05fa7db4a24f47f37539f58168242c68b5b821...e49dc6872d53dfa09d8a93dc5733328f2bd3204d,1,6,9,15,2,2013-07-17 21:06:31,2013-07-17 21:06:31
e5bdf82976c631a5b4cc36d8bfad61de609d7802...c05a55b056509d1146ab55ab1351298789f00751,8,13,19,32,18,2013-07-23 07:40:19,2013-07-23 07:40:19
c05a55b056509d1146ab55ab1351298789f00751...64061d4a14f77fdcf6ecc038ea6e9b02f14e03a8,1,7,13,20,3,2013-07-23 08:51:14,2013-07-23 08:51:14
5e96f31638fe71a0c76805b1352f437881791d98...57f31f058c29edfd7d6d810fcd4a964875e9d463,3,13,3,16,5,2013-08-08 17:32:23,2013-08-08 16:05:00
57f31f058c29edfd7d6d810fcd4a964875e9d463...a1f69452a22689ca2eede7669e79a3e7ab849cdd,1,3,0,3,1,2013-08-08 17:36:11,2013-08-08 17:36:11
275d8d55b29c83bd8c165f5eeaafd76c7e0d966b...3e3d332b4c3642ecd33d83f234f97be6c8aee449,1,11,8,19,6,2013-07-19 17:04:11,2013-07-19 17:04:11
3e3d332b4c3642ecd33d83f234f97be6c8aee449...6ca83665c77599f10914ae48e3f1952333d72827,1,11,2,13,3,2013-07-19 17:20:58,2013-07-19 17:20:58
9f802b5b26f070e79a2bcd4c010d85106452bbb7...d192e60b7a808d4bd4daa457f23160c07b9991fe,1,13,13,26,10,2013-12-03 15:47:18,2013-12-03 15:47:18
ca55fc6356a5edd838ca03b82f3601bd94e8d750...1cb5a8119445bb62c6868eb61649b9b901c855cb,2,6,5,11,6,2014-01-26 14:26:53,2014-01-26 09:07:39
ca55fc6356a5edd838ca03b82f3601bd94e8d750...a5a386436b823257b9e1b1365d3e36c00a1a5d89,2,140,43,183,28,2014-01-24 18:43:05,2014-01-20 22:53:59
a5a386436b823257b9e1b1365d3e36c00a1a5d89...2c65602e45964f695bda91a6b1cfbf6b2f4903ea,2,142,40,182,32,2014-01-24 18:51:08,2014-01-21 18:39:27
2c65602e45964f695bda91a6b1cfbf6b2f4903ea...9bbc53d6d424cbdc8b5ca47f6a85b49794c516fe,1,15,7,22,6,2014-01-24 18:54:05,2014-01-21 19:36:43
9bbc53d6d424cbdc8b5ca47f6a85b49794c516fe...b8e86c62f7512425e29f340a38152978d869e316,2,10,5,15,5,2014-01-24 18:54:05,2014-01-21 20:00:08
b8e86c62f7512425e29f340a38152978d869e316...5d82c0df13ad3bd8edf85ba8d5f3796e93f926d8,1,4,4,8,4,2014-01-24 18:54:05,2014-01-21 20:08:02
5d82c0df13ad3bd8edf85ba8d5f3796e93f926d8...c7c260a5ff217c822e227428e712970e02fa56d9,3,170,38,208,7,2014-01-24 18:54:05,2014-01-24 00:12:39
c7c260a5ff217c822e227428e712970e02fa56d9...3b19d2fdcbd9f6185490fc10e7c4540758954321,2,28,0,28,4,2014-01-24 18:54:05,2014-01-24 17:46:22
3b19d2fdcbd9f6185490fc10e7c4540758954321...027b8edac7e91480623815193ed994db808064f6,22,239,47,286,31,2014-01-24 23:45:49,2014-01-24 23:45:49
027b8edac7e91480623815193ed994db808064f6...7cc001cefb787ddacb53c74a94173674ac6bd587,1,16,0,16,1,2014-01-24 23:46:15,2014-01-24 23:46:15
7cc001cefb787ddacb53c74a94173674ac6bd587...4115987739fb9cc4dd82edd9998db6dbb6bc9d95,2,5,0,5,2,2014-01-27 18:23:55,2014-01-27 18:23:55
4115987739fb9cc4dd82edd9998db6dbb6bc9d95...082e82dba5b5174756b3a5fc2e385ccc59626164,26,430,20,450,22,2014-01-27 19:45:06,2014-01-27 19:45:06
082e82dba5b5174756b3a5fc2e385ccc59626164...daebb598690c47600cf033be77acaad1ae8c4a70,14,205,4,209,9,2014-01-27 22:57:03,2014-01-27 22:57:03
ca55fc6356a5edd838ca03b82f3601bd94e8d750...d0a3de720e085d335d9ad46dc00a23dd03eda793,5,11,11,22,11,2014-01-24 10:18:51,2014-01-24 10:18:51
d0a3de720e085d335d9ad46dc00a23dd03eda793...d541170c77b7ac738e2ffcdd04c838fb7cbbfb87,34,118,118,236,114,2014-01-25 07:15:44,2014-01-24 10:36:41
d541170c77b7ac738e2ffcdd04c838fb7cbbfb87...47e28349bc4874114e2cfce0b91c40938b105b25,2,3,3,6,3,2014-01-25 07:15:44,2014-01-24 11:01:34
47e28349bc4874114e2cfce0b91c40938b105b25...f000ee4e5b840e9f110123a050777fb1301b19bf,2,6,6,12,4,2014-01-25 07:15:44,2014-01-24 17:23:46
f000ee4e5b840e9f110123a050777fb1301b19bf...9950bb4e8de076565976128559ff273e9d4a2a78,14,94,94,188,83,2014-01-25 07:15:44,2014-01-24 19:23:17
9950bb4e8de076565976128559ff273e9d4a2a78...86bfc3e1c64c2c0277f1e795c0a15cba992ac6f5,2,3,3,6,2,2014-01-25 07:15:44,2014-01-24 19:30:10
86bfc3e1c64c2c0277f1e795c0a15cba992ac6f5...a1bbc0ce205b6d3496338d3253c847aa91cabc7b,5,56,56,112,56,2014-01-25 07:15:44,2014-01-25 03:14:37
d62bf0bf83df307b81affbf7b576985392203fad...b554ca5dc1b95234589367eda269a94bdda3d6ae,2,19,1,20,2,2014-01-20 22:09:31,2014-01-20 20:12:06
629ba7f1059bdc149718570a8b2ac043c044d781...55d257e7de44b379f93ac973c2521c2c2ba0a953,1,0,62,62,1,2014-02-05 23:03:00,2014-02-05 23:03:00
32309b5d82d95402852cfcd478abec5d116eba86...6adcaab70cdd6ced307a71945a1f80833ec9670f,9,53,2,55,6,2014-01-08 18:08:23,2014-01-08 18:07:30
426d8456ea979cfae401ced2f88cc811a8b8264a...9bf17d2cf59127573c0be812883170785f0dc340,3,61,0,61,4,2014-01-13 22:11:14,2014-01-13 22:11:14
9bf17d2cf59127573c0be812883170785f0dc340...f1c16d0eb3caa18d98cae095aa536e6b6a8b8ea7,1,3,1,4,2,2014-01-13 23:18:13,2014-01-13 23:18:13
f1c16d0eb3caa18d98cae095aa536e6b6a8b8ea7...4caf0df018a918b38446895ea870e8db65e8dcae,1,1,0,1,1,2014-01-13 23:43:29,2014-01-13 23:43:29
4caf0df018a918b38446895ea870e8db65e8dcae...53e6f4804b67b757fab065da51901be452b1c765,1,3,0,3,1,2014-01-15 20:12:17,2014-01-15 20:12:17
53e6f4804b67b757fab065da51901be452b1c765...998f0016ff2788ee78d47ac2be6d6b9cc6890e11,1,7,2,9,1,2014-01-15 20:32:12,2014-01-15 20:32:12
426d8456ea979cfae401ced2f88cc811a8b8264a...86f92b7431b15ccde4ba63a60afad87db83a215e,1,3,3,6,3,2014-01-13 12:49:54,2014-01-13 12:49:54
426d8456ea979cfae401ced2f88cc811a8b8264a...9eb45fc51a55fb8b058a28b5ee1e297991fedca5,1,3,0,3,1,2014-01-13 07:33:52,2014-01-13 07:29:44
9eb45fc51a55fb8b058a28b5ee1e297991fedca5...e3c6a1bf02227cf996a5c0da784124ddea5c1ba6,1,3,0,3,1,2014-01-13 07:33:56,2014-01-13 07:30:06
e3c6a1bf02227cf996a5c0da784124ddea5c1ba6...ae3b6d612db6305a20e1139503b3c9e99cf4632a,1,3,0,3,1,2014-01-13 07:33:59,2014-01-13 07:31:13
ae3b6d612db6305a20e1139503b3c9e99cf4632a...32b7e84ec09170761bf9422cc4139be0b14975a9,1,3,0,3,1,2014-01-13 07:34:02,2014-01-13 07:31:35
32b7e84ec09170761bf9422cc4139be0b14975a9...2ad45213a84a5e3948557edcb3a76bc439f8b61e,1,3,0,3,1,2014-01-13 07:34:05,2014-01-13 07:31:57
2ad45213a84a5e3948557edcb3a76bc439f8b61e...2fcc0d07d050a6d70d85c510cef7aea4845e340f,1,4,0,4,1,2014-01-13 07:34:09,2014-01-13 07:32:10
cdca82c7842ade2074f37be22f2251d6a9040a9d...e96e3be762969d1b38f44f163c10a1228b9331ae,1,17,2,19,5,2012-06-20 01:08:15,2012-06-20 01:08:15
e96e3be762969d1b38f44f163c10a1228b9331ae...e905c1fc14725608adc85c892f105b5101bf770e,1,4,3,7,4,2012-06-20 18:09:35,2012-06-20 18:09:35
cdca82c7842ade2074f37be22f2251d6a9040a9d...c06e0003944cb14b8236d994794c2eabb8fad1d4,1,3,0,3,2,2012-06-19 23:41:30,2012-06-19 23:41:30
c06e0003944cb14b8236d994794c2eabb8fad1d4...1d94a7d0f6c8cb0d1fcf288a1734a7a5abd1b094,1,21,6,27,6,2012-06-20 00:22:07,2012-06-20 00:15:42
64e56478ad8b3310e957701ebe234764f9f4a147...750be86aedb867a43680f872e1c9824379644739,1,17,0,17,1,2012-06-13 19:43:34,2012-06-09 16:45:21
750be86aedb867a43680f872e1c9824379644739...49938cad9133dc6bb2120fc3e339cb0132ea71cb,1,47,6,53,10,2012-06-13 21:26:00,2012-06-11 14:28:51
49938cad9133dc6bb2120fc3e339cb0132ea71cb...67d334c1cd569d13b1709c3ef1864d630e608c95,1,29,0,29,1,2012-06-13 21:26:00,2012-06-11 14:57:02
64e56478ad8b3310e957701ebe234764f9f4a147...fa45d25f387d3727932b6439e84905e7fe64a85f,2,7,5,12,2,2012-06-13 15:35:13,2012-06-13 12:03:48
a4452eb1b929b95f69768d398008f6f8844941e4...2a99df6909af4c93ce2741ddc5d15a7f52270f28,10,105,19,124,21,2012-05-25 00:14:56,2012-05-25 00:14:56
ab44c62e548373c1494e967f54720faa06ce38b7...3343b5ffd37d25fa9f55c23c417cf761a7849e9f,4,7,6,13,6,2013-11-01 16:36:04,2013-10-31 14:59:42
3343b5ffd37d25fa9f55c23c417cf761a7849e9f...51a3dfb5958e11acf3294e8f740c3ebd777c48a9,3,4,5,9,4,2013-11-01 16:36:09,2013-11-01 15:31:02
51a3dfb5958e11acf3294e8f740c3ebd777c48a9...73342386965db3ece91116005320c9b873af3bf2,1,2,2,4,2,2013-11-01 16:36:09,2013-11-01 15:55:01
73342386965db3ece91116005320c9b873af3bf2...95352b7058fe3166689e5af0b3b0a38e7c6f63a0,1,0,1,1,1,2013-11-01 16:36:09,2013-11-01 15:55:20
95352b7058fe3166689e5af0b3b0a38e7c6f63a0...0bfa73234263de03e5f797c2f4c514def145433a,5,47,16,63,37,2013-11-01 16:36:09,2013-11-01 16:07:44
0bfa73234263de03e5f797c2f4c514def145433a...d3ed2106c137c1117f70499544868db21d9ea715,3,7,4,11,6,2013-11-01 16:36:09,2013-11-01 16:08:32
653ec420f9db9924e669a749d7c4e226f824a1d2...b22593fb6444f4469445e1af2a786c8d13ee4828,1,6,9,15,5,2013-11-01 16:30:41,2013-11-01 16:28:59
146b4d1c5f98aa14df086503f996d131d40b92f8...34b8eafcaea7fc12f91691195c9b7289038c4abb,1,8,8,16,5,2013-10-04 09:36:40,2013-10-04 09:36:40
34b8eafcaea7fc12f91691195c9b7289038c4abb...6445ae994c8be706c58e441c1af2cddd0632b96e,1,3,0,3,1,2013-10-04 11:49:26,2013-10-04 11:49:26
6445ae994c8be706c58e441c1af2cddd0632b96e...da7b78fa446b31e7e197d51129d9bd005acc69da,2,53,2,55,3,2013-10-04 13:54:36,2013-10-04 12:03:12
146b4d1c5f98aa14df086503f996d131d40b92f8...6b7991e264b2fb0448e3dc47f972bafabf38c1fa,2,79,32,111,16,2013-10-03 17:44:13,2013-09-30 23:13:53
6b7991e264b2fb0448e3dc47f972bafabf38c1fa...2fe54afa2a8f87d03d2d550dcde7718f27e40967,7,50,12,62,22,2013-10-03 17:44:13,2013-09-30 23:58:33
2fe54afa2a8f87d03d2d550dcde7718f27e40967...219d3457324e8c2652e3462cedaf648912b40281,15,273,217,490,90,2013-10-03 17:44:13,2013-10-01 23:12:15
219d3457324e8c2652e3462cedaf648912b40281...966bb17a57d0c1128261b7575db245f5bc3cf41d,2,2,0,2,2,2013-10-03 17:44:13,2013-10-01 23:41:07
966bb17a57d0c1128261b7575db245f5bc3cf41d...d0849f830f494445e4ef9f04d32be1a2d10b89b3,3,47,55,102,22,2013-10-03 17:44:13,2013-10-02 18:07:18
d0849f830f494445e4ef9f04d32be1a2d10b89b3...618b7689e1cdd4ebd956949a95038fd49592a187,4,157,59,216,29,2013-10-03 17:44:13,2013-10-02 19:06:26
618b7689e1cdd4ebd956949a95038fd49592a187...af302acaee95ff2ca3379b93cd886ebe96adff10,4,14,7,21,11,2013-10-03 17:45:04,2013-10-02 21:13:11
af302acaee95ff2ca3379b93cd886ebe96adff10...840fb4fc4346580a6398856b3fa2f1226b3a365d,2,66,60,126,26,2013-10-03 21:42:37,2013-10-03 21:42:37
840fb4fc4346580a6398856b3fa2f1226b3a365d...b8f9059d6330d1b0113910eb4c6f049ea5a150a4,3,22,25,47,12,2013-10-03 22:16:06,2013-10-03 22:16:06
b8f9059d6330d1b0113910eb4c6f049ea5a150a4...5173ea921d4ccbbe7d61ddce9a0920c2e1c82035,9,167,53,220,44,2013-10-04 23:32:16,2013-10-04 23:32:16
5173ea921d4ccbbe7d61ddce9a0920c2e1c82035...14997dc5f69e7ceebe502b32087d809a8482bf78,21,236,201,437,85,2013-10-08 19:45:43,2013-10-08 19:45:43
14997dc5f69e7ceebe502b32087d809a8482bf78...d5e83627e4ed764115175dc42090afe0df332fe3,2,9,8,17,5,2013-10-08 21:41:32,2013-10-08 21:41:32
d5e83627e4ed764115175dc42090afe0df332fe3...92dac975869bf6207eca0754345dc9aa7fec8992,9,87,64,151,36,2013-10-08 23:35:57,2013-10-08 23:35:57
92dac975869bf6207eca0754345dc9aa7fec8992...867f7c9b3329952dc0aebf9770019a7a01ff2691,5,12,11,23,12,2013-10-08 23:59:59,2013-10-08 23:59:59
cdbcb8dd80ccae119ab56daa6da51990667e653c...3a2d48d5ee48c520fdc6b0cd65e1982db7751352,1,3,2,5,2,2013-07-25 13:21:55,2013-07-25 12:54:19
cdbcb8dd80ccae119ab56daa6da51990667e653c...847c679309378748d2a3ac1c5a49331d2e64d4cf,1,23,5,28,5,2013-07-24 22:26:51,2013-07-24 22:26:51
847c679309378748d2a3ac1c5a49331d2e64d4cf...a6837b5fc9465e0f271ccd2c0bb71aae78a10a64,1,6,6,12,6,2013-07-31 17:13:35,2013-07-31 17:13:35
cdbcb8dd80ccae119ab56daa6da51990667e653c...39a1a66242a480b880032f5a6a4e31ee77414d4c,1,3,0,3,1,2013-07-24 20:09:07,2013-07-24 20:09:07
39a1a66242a480b880032f5a6a4e31ee77414d4c...69c66b554e1072d8b6c63366834e15310fecaea7,1,4,0,4,1,2013-07-24 20:09:33,2013-07-24 20:09:33
69c66b554e1072d8b6c63366834e15310fecaea7...18e9efc425bd617655782188056fe43ecdc673e4,1,9,0,9,2,2013-07-24 20:10:16,2013-07-24 20:10:16
18e9efc425bd617655782188056fe43ecdc673e4...427cc255dffc1a44f1e9a289067012370f3cc38d,1,19,11,30,13,2013-07-24 20:11:11,2013-07-24 20:11:11
427cc255dffc1a44f1e9a289067012370f3cc38d...397357a0480b341fce5e93d3f485504f2ae94082,1,57,0,57,1,2013-07-24 20:12:00,2013-07-24 20:12:00
397357a0480b341fce5e93d3f485504f2ae94082...f5c4d0225157a6e15fc08f07aa77b5e8f52cdac5,1,1,1,2,1,2013-07-24 20:44:35,2013-07-24 20:44:35
f5c4d0225157a6e15fc08f07aa77b5e8f52cdac5...a5140f4dda66263a34080b11cfc34a49c9743100,2,146,49,195,21,2013-07-25 00:11:49,2013-07-25 00:11:49
a5140f4dda66263a34080b11cfc34a49c9743100...effdbeb3239b777e2b19fc4944643fc7f2a768c3,3,89,70,159,24,2013-07-25 00:48:37,2013-07-25 00:48:37
effdbeb3239b777e2b19fc4944643fc7f2a768c3...a16e41729d5dec4acd30302c4a217622de00d290,4,76,64,140,23,2013-07-25 19:27:39,2013-07-25 19:27:39
a16e41729d5dec4acd30302c4a217622de00d290...8dd8aa480ba46863e9c7df40bb9695e88a0286ee,3,20,19,39,19,2013-07-26 17:28:57,2013-07-26 17:28:57
8dd8aa480ba46863e9c7df40bb9695e88a0286ee...d730d3f4f0efb269dd760a3100ae86c460b8ba36,6,340,257,597,101,2013-07-31 23:40:42,2013-07-31 23:40:42
d730d3f4f0efb269dd760a3100ae86c460b8ba36...a42c2a8c89189afbcfccbc17f798971c18c15de6,1,63,3,66,7,2013-08-04 20:44:51,2013-08-01 02:51:50
a42c2a8c89189afbcfccbc17f798971c18c15de6...7edb74d374f401cea50be143b63c7d2d141d18be,1,6,1,7,2,2013-08-04 21:06:13,2013-08-04 21:06:13
7edb74d374f401cea50be143b63c7d2d141d18be...0a38eb42ca207f7aeb9e48a172fdbbc587201eb1,1,56,0,56,5,2013-08-04 21:08:51,2013-08-01 03:36:50
0a38eb42ca207f7aeb9e48a172fdbbc587201eb1...31b42eacce29defe07bdc1fa50a21aa11b23ea83,1,2,8,10,6,2013-08-04 21:09:44,2013-08-04 21:09:44
31b42eacce29defe07bdc1fa50a21aa11b23ea83...e8242022bc409b3cb7e234eabdd9bda05ae3a158,3,165,148,313,3,2013-08-05 16:59:02,2013-08-05 16:59:02
847b8e0e440cee01b1d8a925be2c88af69b330c8...41a93cc6e5adb17cab0281ac49996d02f94baa9d,1,3,2,5,1,2013-07-19 17:43:08,2013-07-19 17:43:08
41a93cc6e5adb17cab0281ac49996d02f94baa9d...bef59b1be4ec9754959423d36138731577a4f413,1,1,1,2,1,2013-07-19 17:56:47,2013-07-19 17:56:47
cf297c353fee12316ed647a0e60185f312788446...ed5b77b0fdd6eebc35742e1f27c4a9de4849d8ce,1,2,5,7,3,2013-12-05 16:13:58,2013-12-05 16:13:58
cf297c353fee12316ed647a0e60185f312788446...a6ebc2bdb314543a1fdf25f523f8793f4f52b8b3,1,3,0,3,1,2013-12-05 16:11:00,2013-12-04 23:17:39
a6ebc2bdb314543a1fdf25f523f8793f4f52b8b3...c56c6d694563fdd28cd00ed246f35349522b836e,2,155,11,166,8,2013-12-05 22:13:46,2013-12-05 22:13:46
c56c6d694563fdd28cd00ed246f35349522b836e...628e92cdb31cb3561549671ea5346a347f2addcd,2,11,3,14,5,2013-12-05 22:47:04,2013-12-05 22:47:04
628e92cdb31cb3561549671ea5346a347f2addcd...710f383868cef86ff837340c698b1672c7902486,1,5,1,6,1,2013-12-06 17:32:09,2013-12-06 17:32:09
710f383868cef86ff837340c698b1672c7902486...7fb4147f1f7e64d7544e574998d5cec04077dfc4,2,47,5,52,3,2013-12-06 21:38:59,2013-12-06 21:38:59
7fb4147f1f7e64d7544e574998d5cec04077dfc4...a7c83aec2149a4885bfac032859142e8a62bceab,1,3,3,6,1,2013-12-06 21:39:08,2013-12-06 21:39:08
a7c83aec2149a4885bfac032859142e8a62bceab...5a52d6be4c3a2635a3121b529e0ab2ab674f6be6,1,2,1,3,2,2013-12-11 14:43:17,2013-12-11 14:43:17
93b96ea705171ab5f8e66f8948bc2febc998c241...11f6ad5fcf5f1251ef1b51d18409f84cb87cb8b7,2,13,13,26,13,2014-01-26 17:08:05,2014-01-15 20:15:34
11f6ad5fcf5f1251ef1b51d18409f84cb87cb8b7...991b2840eb6389048bccdb40b51889e32e8f1460,3,29,9,38,7,2014-01-26 18:35:02,2014-01-26 18:35:02
a1a9d0bd484edb26c579820190d8f5fda24276ef...e7c16943f4551830a148995640f87bec2fe08e8f,3,75,0,75,3,2014-01-28 18:39:14,2014-01-28 18:39:14
e49c98e6efaa444ed73ac3b8318a693801f93184...c1d648c5c6361edfb1aa85a31656b628672c7616,33,264,33,297,39,2014-01-20 22:15:11,2014-01-09 02:29:42
c1d648c5c6361edfb1aa85a31656b628672c7616...6b92c99bcbf32de131754a4f750278f84bf5b766,13,130,2,132,12,2014-01-20 22:15:12,2014-01-19 09:20:25
6b92c99bcbf32de131754a4f750278f84bf5b766...e651e8e2b5c5eb021448fb0f0a36cb3f10fa9326,6,90,7,97,15,2014-01-20 22:15:13,2014-01-19 23:05:08
e651e8e2b5c5eb021448fb0f0a36cb3f10fa9326...6891a862bbde86f9262c4b367effb1e29d7c513b,2,109,0,109,2,2014-01-20 22:15:13,2014-01-20 02:12:22
6891a862bbde86f9262c4b367effb1e29d7c513b...0e1ba46cfbca0eec00d8af713fc2059158685381,5,39,217,256,47,2014-01-20 22:15:14,2014-01-20 04:03:13
0e1ba46cfbca0eec00d8af713fc2059158685381...db3462ce7714e2a6ce23130a7046a77860739e05,3,48,0,48,4,2014-01-20 22:15:15,2014-01-20 06:36:50
db3462ce7714e2a6ce23130a7046a77860739e05...0ef19fe14ce5a5f7b5ac90966a56997bf04ea5a9,48,174,6,180,28,2014-01-20 23:07:17,2014-01-20 22:13:55
0de2c4e3a3cb63a2af66c464585d0e9ae273ddee...5c8be3255905f77d60a239381d9ce39a6934a038,2,4,4,8,4,2014-02-05 21:32:45,2014-02-05 21:32:45
5c8be3255905f77d60a239381d9ce39a6934a038...a2ce19ca68e060838ec08d7f3e0c35160a2b6697,3,21,0,21,6,2014-02-05 21:35:26,2014-02-05 21:35:26
a2ce19ca68e060838ec08d7f3e0c35160a2b6697...fe45922d77d45b84af9701a3915155299ac85d63,1,4,12,16,5,2014-02-05 21:41:12,2014-02-05 21:41:12
fe45922d77d45b84af9701a3915155299ac85d63...3094102f694cc7bdbe3572a35050fec3729b2870,1,4,2,6,1,2014-02-05 22:05:18,2014-02-05 22:05:18
3094102f694cc7bdbe3572a35050fec3729b2870...78ee7e81f59dc1e51551628f8f90ee58ea286cf8,1,7,0,7,2,2014-02-05 22:10:19,2014-02-05 22:10:19
78ee7e81f59dc1e51551628f8f90ee58ea286cf8...5dae3ffe258a10881e6bb8042e865a7b96012a68,2,8,2,10,4,2014-02-06 03:27:27,2014-02-06 03:27:27
5dae3ffe258a10881e6bb8042e865a7b96012a68...2bfc673910d3f47395456bb6842e6bed473b8e68,2,2,2,4,2,2014-02-06 18:39:57,2014-02-06 18:39:57
2bfc673910d3f47395456bb6842e6bed473b8e68...db55bb73ff4bccbaccbb4c3a7f6b1fcf09498df7,3,42,2,44,5,2014-02-06 19:18:10,2014-02-06 19:18:10
c85d606eee01de894db828e81482aa2812b1b5d9...3f0e3e166218b875a3e011c790311fc5c50047d1,1,6,6,12,6,2014-01-16 20:42:28,2014-01-16 20:42:28
3f0e3e166218b875a3e011c790311fc5c50047d1...3f033c55950f5ebdb00c6628eaff7583b50b90b3,1,1,1,2,1,2014-01-16 20:53:25,2014-01-16 20:53:25
be29dd82e27d3536b9c63f5835b102b28934555e...c6f26b48e47f6c0cd67769418c33efe66e5b5fe8,6,120,76,196,10,2014-01-14 17:45:12,2013-12-13 23:26:46
c6f26b48e47f6c0cd67769418c33efe66e5b5fe8...0ade2f7a5919d1953f679661a752c31328ccb90a,1,81,64,145,32,2014-01-14 17:45:13,2013-12-14 15:37:57
0ade2f7a5919d1953f679661a752c31328ccb90a...52a8a130728e29d8ac9d6e4f9e3a7017afe461fb,4,12,5,17,10,2014-01-14 17:45:14,2014-01-07 00:41:12
be29dd82e27d3536b9c63f5835b102b28934555e...63170bcae91e5ddf6c0a2589d7212e0e62c8b269,1,3,1,4,2,2014-01-13 21:17:07,2014-01-13 16:51:08
63170bcae91e5ddf6c0a2589d7212e0e62c8b269...1234738e06c806ebafaf0ec04523adc823999c2d,1,1,0,1,1,2014-01-13 21:17:07,2014-01-13 21:12:02
1234738e06c806ebafaf0ec04523adc823999c2d...a8e4cb11fd77d52529e1e464df52a6db1aae33e7,1,3,1,4,2,2014-01-13 21:17:07,2014-01-13 21:12:17
a8e4cb11fd77d52529e1e464df52a6db1aae33e7...ddf1b1ffa5e6cea27562aa56df3955b5a916828a,1,12,4,16,8,2014-01-13 21:33:10,2014-01-13 21:33:10
ddf1b1ffa5e6cea27562aa56df3955b5a916828a...b0b32b432111adf33fa3c3cb3beee7a81087704b,1,0,1,1,1,2014-01-13 21:51:10,2014-01-13 21:51:10
b0b32b432111adf33fa3c3cb3beee7a81087704b...ac44b3d2447f06f4022bb4b58a160244e24c039c,1,15,16,31,9,2014-01-13 22:28:03,2014-01-13 22:28:03
ac44b3d2447f06f4022bb4b58a160244e24c039c...249537573b8509fc8ed0ae8e51835d084af7c3d2,1,12,14,26,9,2014-01-14 18:08:58,2014-01-14 18:08:58
9fae82405dd7db7b3c53c4a77ee78e83eca67a2b...b3aa440641135619ff3890da03c65ba52396f42c,1,1,0,1,1,2012-06-21 00:15:25,2012-06-21 00:15:25
b3aa440641135619ff3890da03c65ba52396f42c...9311423c34bbd369928152c6a2b669204276ddd1,1,1,0,1,1,2012-06-21 00:30:30,2012-06-21 00:30:30
1d94a7d0f6c8cb0d1fcf288a1734a7a5abd1b094...eb6bc45f6db0de0a445c09d2c7f5c2eaa3669103,2,5,2,7,2,2012-06-20 04:11:48,2012-06-20 04:11:48
eb6bc45f6db0de0a445c09d2c7f5c2eaa3669103...a15e7f86216702e5da8e4ae733df1f97539729a6,1,6,6,12,3,2012-06-20 04:12:04,2012-06-20 04:12:04
53774eb8185e08da46cd322dc8fefaff7676fea4...73aaf67439a04ca4888dfa1948f8425b2f79307d,3,32,0,32,4,2012-06-13 21:28:47,2012-06-13 21:22:33
4728b55ac66cde7f8c104f0a8cc350d96a530f33...29ef309e2ca39f68d11c755710446ff6d396d203,2,51,4,55,8,2012-05-25 16:44:56,2012-05-25 16:44:56
ec5fe2da8b4afe0b65156477f3cfbb30b9a25643...cfd192b0140f004404a208cde967ac8eef16cdff,1,13,0,13,1,2013-10-05 02:27:12,2013-10-03 19:44:34
cfd192b0140f004404a208cde967ac8eef16cdff...e411b74ebdb0ec528dbd0296746bd8a573f4045d,1,89,34,123,24,2013-10-05 02:33:48,2013-10-05 02:33:48
e411b74ebdb0ec528dbd0296746bd8a573f4045d...cdc95a0d93aa3b515f9c4fe30f47d52e8e7f3dde,1,18,49,67,12,2013-10-05 02:34:08,2013-10-04 22:38:37
cdc95a0d93aa3b515f9c4fe30f47d52e8e7f3dde...22661448973e3c46f2a71a75364630a5111f7c14,1,5,4,9,6,2013-10-05 02:35:32,2013-10-05 02:35:32
95c148b2c772b5f97e0db60bff089d8fa944971c...743531372a00e41246026910e2361684e2aad59f,1,1,0,1,1,2013-10-09 18:57:03,2013-10-09 18:57:03
d477a9ab7e007cb31f51241861f9e434419b9621...f5254d78441f7fa1067a1c34d3925b72afcb024c,1,1,0,1,1,2013-07-27 18:15:06,2013-07-27 18:15:06
d477a9ab7e007cb31f51241861f9e434419b9621...c3ae047361c0412ed371ef899b018e9c13d6ecf8,1,4,3,7,3,2013-07-26 19:34:49,2013-07-26 19:31:28
1cd0acf67260b543c6ac15c118c68031ca713da8...9b7d02ff2d9b87d61778ee7ef5e2d43bf4c561f0,2,81,21,102,14,2013-08-05 17:53:39,2013-08-05 17:53:39
98c248d7bf57c2a74761bb8bb8b41a965cdf58d6...8f460f2c464bb5dd7bb65374cfa3d965badc8da1,1,0,2,2,1,2013-12-06 04:42:14,2013-12-06 04:41:12
0eedacb06ae07fd0d784066ad41383276e05d92e...86a05ef382438b22d2ffaaa1a77814781243bc80,2,6,0,6,3,2013-12-12 22:40:40,2013-12-12 22:40:40
0eedacb06ae07fd0d784066ad41383276e05d92e...9f77b3f6f5ce6944ec49dfc666ef6b8df0af0c6b,15,268,260,528,101,2013-12-11 18:57:49,2013-11-25 22:21:34
9f77b3f6f5ce6944ec49dfc666ef6b8df0af0c6b...96869a4edb2872934e0e167a726ab240f4270fea,28,624,383,1007,273,2013-12-11 18:57:49,2013-12-04 00:45:39
96869a4edb2872934e0e167a726ab240f4270fea...dab89f9b6821b67dd07c8bd4dbb53e25a3e687c7,21,273,192,465,124,2013-12-11 18:57:49,2013-12-05 05:22:57
dab89f9b6821b67dd07c8bd4dbb53e25a3e687c7...fcd324c625d8be3f368c924d787e945e5812d8dd,13,33,84,117,22,2013-12-11 18:57:49,2013-12-06 23:04:31
fcd324c625d8be3f368c924d787e945e5812d8dd...25e0b1576d5f9e5248603f81d3198a65bfccf0ed,57,603,804,1407,423,2013-12-11 18:57:49,2013-12-06 23:07:57
25e0b1576d5f9e5248603f81d3198a65bfccf0ed...60058018dcadbaa1f70281c9d29faf1e46d3a87c,1,4,0,4,2,2013-12-11 18:57:50,2013-12-06 23:20:41
60058018dcadbaa1f70281c9d29faf1e46d3a87c...c7b3e1b32040d05f3cb996d754a28af3b4d06d0b,12,54,30,84,28,2013-12-11 18:57:50,2013-12-06 23:42:20
c7b3e1b32040d05f3cb996d754a28af3b4d06d0b...f10d7a368fa4af28b1e6f082349ffa4f62b3c00e,3,36,19,55,9,2013-12-11 18:57:50,2013-12-06 23:53:26
f10d7a368fa4af28b1e6f082349ffa4f62b3c00e...26c1cb91beccb44425864bd233ed0e35f5801868,24,71,49,120,40,2013-12-11 18:57:50,2013-12-09 17:44:03
26c1cb91beccb44425864bd233ed0e35f5801868...373cf6a932a64d1cbe5f5cd8333546dcc2ca0b92,13,91,58,149,44,2013-12-11 18:57:50,2013-12-09 18:17:47
373cf6a932a64d1cbe5f5cd8333546dcc2ca0b92...19853bdd97e006b6e4519bc352c3e8fd7586e9c3,3,78,38,116,17,2013-12-11 18:57:50,2013-12-10 21:01:34
19853bdd97e006b6e4519bc352c3e8fd7586e9c3...cbd048969e2d53790472118bf2d337cd1d90ca94,3,93,10,103,7,2013-12-11 18:57:50,2013-12-10 22:38:35
cbd048969e2d53790472118bf2d337cd1d90ca94...8f1066a05f15ce0e3f91614cf9915162ce6447ee,3,91,26,117,11,2013-12-11 18:57:51,2013-12-11 00:02:24
8f1066a05f15ce0e3f91614cf9915162ce6447ee...8046b26cb1e06ef7699d16395598754a8ec5564b,1,2,2,4,2,2013-12-11 18:57:51,2013-12-11 00:16:36
8046b26cb1e06ef7699d16395598754a8ec5564b...8b22d862fb4419b219210027f18c1e97dd36fa8b,2,132,32,164,21,2013-12-11 19:55:00,2013-12-11 19:55:00
8b22d862fb4419b219210027f18c1e97dd36fa8b...7697e54176ccab22ed6d4597d7256e9a1e6ff202,10,95,88,183,35,2013-12-11 23:02:20,2013-12-11 23:02:20
7697e54176ccab22ed6d4597d7256e9a1e6ff202...7e3ed419593a2dc9fae3bd69fdf172de015d79d9,4,28,18,46,13,2013-12-12 00:56:17,2013-12-12 00:56:17
7e3ed419593a2dc9fae3bd69fdf172de015d79d9...11bd7a034ba9046a7ba601c446e937377d507065,3,186,43,229,27,2013-12-12 19:14:51,2013-12-12 19:14:51
11bd7a034ba9046a7ba601c446e937377d507065...9cfce2735d77f4d8b6005e62349dd97c0c6de5ab,17,29,21,50,23,2013-12-12 20:11:38,2013-12-12 20:11:38
9cfce2735d77f4d8b6005e62349dd97c0c6de5ab...452c7de668568f75a97b0438daab9f33b68d605a,2,78,17,95,9,2013-12-12 22:16:40,2013-12-12 22:16:40
452c7de668568f75a97b0438daab9f33b68d605a...ce33645ff32d68dfd89867468f58fd9c245c26ff,1,4,15,19,5,2013-12-13 11:25:48,2013-12-13 11:25:48
ce33645ff32d68dfd89867468f58fd9c245c26ff...437f7d69b22324d20fe833aa53119885733029c2,2,8,1,9,2,2013-12-13 11:41:22,2013-12-13 11:41:22
437f7d69b22324d20fe833aa53119885733029c2...7a16d54b5457aa9f60c25a204277ae0ce609ad2e,1,0,3,3,1,2013-12-13 11:47:51,2013-12-13 11:47:51
1087d4fd01888ab4dbd4f30109b97622b037d95d...66d585c6b344562c67812840aca5ea76881f7446,1,2,1,3,2,2014-01-27 03:58:23,2014-01-27 03:58:23
1087d4fd01888ab4dbd4f30109b97622b037d95d...7a3bd1e73215f8939f270092e0673d6c0f3f32af,4,55,100,155,41,2014-01-27 03:44:05,2014-01-26 14:35:17
7a3bd1e73215f8939f270092e0673d6c0f3f32af...b25d87c9cdef0bc09007c756d7e52f15eb4622d7,5,56,134,190,44,2014-01-27 03:44:05,2014-01-26 15:03:37
b25d87c9cdef0bc09007c756d7e52f15eb4622d7...ee550477d1c22273d6d9701b444041ff101144ec,4,20,67,87,18,2014-01-27 03:44:05,2014-01-26 15:11:18
ee550477d1c22273d6d9701b444041ff101144ec...e1d7f0035e8683423271f1f63b57fd9c663e4fb0,4,38,104,142,13,2014-01-27 03:44:06,2014-01-26 15:32:49
e1d7f0035e8683423271f1f63b57fd9c663e4fb0...bf522e08114a4dc25815b09db201266a0791381c,9,22,98,120,23,2014-01-27 03:44:06,2014-01-26 15:59:36
cd4aa602c9d104f146cdfcb89399438214dc75d2...96f12e709b60e2d570c804c49a6364e94fd0e4b0,1,1,1,2,1,2014-01-29 20:50:42,2014-01-29 20:50:42
af2b969b6f63dafa8c55b88cadbcc7631c2dd30b...450e8e9e623b8c172ba4628c146838cbf4c56519,2,20,2,22,3,2014-01-22 12:40:19,2014-01-22 12:22:15
450e8e9e623b8c172ba4628c146838cbf4c56519...c05cd7924d2409741bb4cb1eb3ba843bea7ec4a2,9,94,118,212,67,2014-01-22 16:51:32,2014-01-22 16:51:32
c4ee3b54f803c1cfc957cdc8a2a5ca9c0c47e1d7...3158e2febe87787dc7804b5670f4dc53aeca87ed,6,33,36,69,25,2014-02-07 23:43:37,2014-02-07 23:24:39
2d9291943c253e9e1520f87b13abb1e81cffdb29...80c29fe93e968fd73e861546e1a4cf33b514e3f6,5,314,76,390,33,2014-02-08 00:17:59,2014-01-17 18:45:11
b6815fe0d5a9abc80b4f91b0f57fdc9e5a8bbcf1...6b415f622e93a81471ac485411ae9126a1e1938f,1,5,1,6,3,2014-01-17 21:46:44,2014-01-17 21:46:44
b6815fe0d5a9abc80b4f91b0f57fdc9e5a8bbcf1...4e974c971f39ac5e72bf656b49e43f208146d29e,1,19,1,20,2,2014-01-17 21:02:58,2014-01-17 21:02:58
4e974c971f39ac5e72bf656b49e43f208146d29e...194d077c4f6eeea0451753bf5f43355f6520a359,1,40,0,40,1,2014-01-17 21:43:29,2014-01-17 21:43:29
194d077c4f6eeea0451753bf5f43355f6520a359...c7015424ccd2a7cb95a0cd3ed65d22495cd2d78f,1,1,1,2,1,2014-01-17 21:54:19,2014-01-17 21:54:19
c7015424ccd2a7cb95a0cd3ed65d22495cd2d78f...8bf476ac31f77ad27646d43a5d498992ddf4c5df,1,28,20,48,5,2014-01-19 05:24:58,2014-01-19 05:24:58
557bd1f4108272c6db004aa8b7137d9254c14945...40ef47dd46fdd361b49ccc97605a93e0993e96db,3,74,0,74,3,2014-01-14 20:03:01,2014-01-14 20:03:01
9311423c34bbd369928152c6a2b669204276ddd1...2c227b8b33b8179feb056e60b7c1502b9c4fcd4b,1,13,34,47,10,2012-06-22 09:32:49,2012-06-21 22:02:23
2c227b8b33b8179feb056e60b7c1502b9c4fcd4b...dbb24a3962bd1dcd006c2f615b2cda1dcd1d042e,1,31,0,31,1,2012-06-22 09:32:50,2012-06-22 09:30:43
dbb24a3962bd1dcd006c2f615b2cda1dcd1d042e...d6d8cc276d986a4b8eb606527607ffa9292ff97f,1,17,6,23,6,2012-06-22 11:42:35,2012-06-22 11:41:26
9311423c34bbd369928152c6a2b669204276ddd1...764df57e82c337a70f55e320bf31acb50c6ffacd,4,259,0,259,4,2012-06-21 16:53:44,2012-06-15 20:14:43
764df57e82c337a70f55e320bf31acb50c6ffacd...bb1f6087e44272371d25df9cc5610124f6cd5a01,3,64,54,118,30,2012-06-21 16:53:44,2012-06-19 16:15:39
bb1f6087e44272371d25df9cc5610124f6cd5a01...f2a855d5fe9824ceea8bf8b27e82bdf2d6846855,2,30,16,46,14,2012-06-21 16:53:44,2012-06-20 03:37:12
f2a855d5fe9824ceea8bf8b27e82bdf2d6846855...3c4b008c4d767766e7b19b2bda942c7981578a49,1,2,0,2,2,2012-06-21 16:53:45,2012-06-20 19:43:28
3c4b008c4d767766e7b19b2bda942c7981578a49...da73fb70de05f61d39b8dd18bd73628ddbf0f63f,1,2,0,2,2,2012-06-21 16:53:45,2012-06-20 19:48:41
da73fb70de05f61d39b8dd18bd73628ddbf0f63f...8340dd5d5f0daf3ffda0c7ecb1791b21a152ecd2,2,77,64,141,12,2012-06-21 16:53:45,2012-06-20 21:17:54
8340dd5d5f0daf3ffda0c7ecb1791b21a152ecd2...4fbc899acfea62cc049f8cbc2db803b375888c3d,1,90,6,96,7,2012-06-21 16:53:45,2012-06-21 03:51:32
4fbc899acfea62cc049f8cbc2db803b375888c3d...af58ec9e8decb752740aaae806209de4ee742d16,1,47,27,74,13,2012-06-21 16:53:45,2012-06-21 16:53:27
af58ec9e8decb752740aaae806209de4ee742d16...941611153a497ddfe454e07c48584b7e23bf484a,2,66,58,124,18,2012-06-21 17:34:11,2012-06-21 17:34:11
941611153a497ddfe454e07c48584b7e23bf484a...14741d62d9a8ae79774cf891a7ed665d8d650188,3,110,10,120,8,2012-06-21 18:13:19,2012-06-21 18:13:19
14741d62d9a8ae79774cf891a7ed665d8d650188...cb2dc0b0f81af446ea7927876a64bc95ab794bff,1,2,2,4,1,2012-06-21 20:37:08,2012-06-21 20:37:08
cb2dc0b0f81af446ea7927876a64bc95ab794bff...ec532d5eded489d5d031d199200b6223573c9365,1,50,2,52,5,2012-06-21 21:54:12,2012-06-21 21:54:12
ec532d5eded489d5d031d199200b6223573c9365...5a20196f2d2d0af9d0ac5eb2a17b042b1fd77fea,1,1,1,2,1,2012-06-21 22:11:13,2012-06-21 22:11:13
5a20196f2d2d0af9d0ac5eb2a17b042b1fd77fea...acdd3d959ba95670928bb8a4cfcec42edfafd46e,2,73,9,82,9,2012-06-22 02:51:56,2012-06-22 02:51:56
acdd3d959ba95670928bb8a4cfcec42edfafd46e...830388a728a73c63bb85a59e603333bd210af6ca,1,23,2,25,7,2012-06-22 03:07:32,2012-06-22 03:07:32
830388a728a73c63bb85a59e603333bd210af6ca...24b0d3d56ea25f8cb0acd425392d74300bc85a61,1,39,2,41,8,2012-06-25 23:02:16,2012-06-25 23:02:16
24b0d3d56ea25f8cb0acd425392d74300bc85a61...2b63db4cbb370a783f9a430317b9ad6b15bdfd65,1,28,12,40,8,2012-06-25 23:04:59,2012-06-25 23:04:59
2b63db4cbb370a783f9a430317b9ad6b15bdfd65...0e874b12d8ad0a1e2330b69f94df2e77a8d2aa75,1,40,6,46,4,2012-07-06 18:22:45,2012-07-06 18:22:45
0e874b12d8ad0a1e2330b69f94df2e77a8d2aa75...4a26ee4fd4f389322017aa600b337544f46dfc8d,1,124,125,249,14,2012-07-10 03:09:28,2012-07-10 03:09:28
4a26ee4fd4f389322017aa600b337544f46dfc8d...f2d42eea34b0b080877d3bfd5cd3dd3242459d32,3,24,5,29,6,2012-07-10 03:21:22,2012-07-10 03:21:22
f2d42eea34b0b080877d3bfd5cd3dd3242459d32...aed794d0421f7538dc8518bab89975e8c44d27cf,1,5,15,20,3,2012-07-10 03:32:26,2012-07-10 03:32:26
aed794d0421f7538dc8518bab89975e8c44d27cf...ea8178638c22887ec340b822b59a27e6cbbc888f,1,212,212,424,25,2012-07-10 03:32:42,2012-07-10 03:32:42
ea8178638c22887ec340b822b59a27e6cbbc888f...8fb5e4039ec83f321daf59b00840fba53c797da3,1,1,0,1,1,2012-07-10 15:58:40,2012-07-10 15:58:40
8fb5e4039ec83f321daf59b00840fba53c797da3...1c7eb971acb386406c71f1f000d4fc789a361611,2,79,85,164,19,2012-07-10 19:04:23,2012-07-10 19:04:23
1c7eb971acb386406c71f1f000d4fc789a361611...822d9dd51f8f2567766c38b719d9d6d5bdc1cfa0,2,8,30,38,7,2012-07-11 16:50:12,2012-07-11 16:50:12
822d9dd51f8f2567766c38b719d9d6d5bdc1cfa0...c3b5099fe46e1191784cc1890cd35f167305f47a,3,12,18,30,7,2012-07-11 17:10:31,2012-07-11 17:10:31
c3b5099fe46e1191784cc1890cd35f167305f47a...d024419f165e81f59d919bd56d84abf8e9fb9f57,4,72,57,129,15,2012-07-11 17:40:53,2012-07-11 17:40:53
d024419f165e81f59d919bd56d84abf8e9fb9f57...81167385e90e7059a9610e8f7f3e8201dc6d46b9,3,27,9,36,10,2012-07-11 22:41:37,2012-07-11 22:33:19
81167385e90e7059a9610e8f7f3e8201dc6d46b9...339f3d071eda7154fcfc996a3d7d67d84a5e1482,2,8,8,16,3,2012-07-12 02:20:49,2012-07-12 02:17:07
339f3d071eda7154fcfc996a3d7d67d84a5e1482...deac801de98be4974cfe806eb4bc072f34f81cc5,1,1,4,5,2,2012-07-13 22:50:23,2012-07-13 22:50:23
deac801de98be4974cfe806eb4bc072f34f81cc5...280c7bbf13080c00fb563f8ecc08d9e606e3bd12,2,69,1,70,2,2012-07-13 22:52:27,2012-07-13 22:52:27
280c7bbf13080c00fb563f8ecc08d9e606e3bd12...dc1b0909d6ec96def686de11ac987892abf7538f,1,77,57,134,17,2012-07-13 23:44:13,2012-07-13 23:44:13
dc1b0909d6ec96def686de11ac987892abf7538f...71bc89b9b6e15469115c667972a0f710e0ae4e7d,1,3,3,6,1,2012-07-14 03:24:40,2012-07-14 03:24:40
71bc89b9b6e15469115c667972a0f710e0ae4e7d...41ad70d0a8d5bf294197be5da26411bc7aa33fcc,1,5,9,14,3,2012-07-16 18:32:24,2012-07-16 18:32:24
41ad70d0a8d5bf294197be5da26411bc7aa33fcc...9587895f572ad4808fb1746dd6510f92ec30c3a6,3,46,38,84,5,2012-07-16 19:06:23,2012-07-16 19:06:23
9587895f572ad4808fb1746dd6510f92ec30c3a6...1d68fcd04b21a2c5665d0ca6a5543e7166c73457,10,72,24,96,10,2012-07-16 23:22:41,2012-07-16 23:16:11
9311423c34bbd369928152c6a2b669204276ddd1...a8fd805e2ff73a3825ddfe6f290774ef5a217972,3,189,0,189,3,2012-06-21 16:51:27,2012-06-21 16:29:38
a8fd805e2ff73a3825ddfe6f290774ef5a217972...d4827081ea3ed869c92fcc414bea81be7aa3edfe,3,0,145,145,3,2012-06-21 16:51:32,2012-06-21 16:48:36
9311423c34bbd369928152c6a2b669204276ddd1...dfa0b65c695c24512a60678587183d95de4c18fa,1,1,1,2,1,2012-06-21 12:17:54,2012-06-21 12:17:54
9311423c34bbd369928152c6a2b669204276ddd1...dca6b228d1725ce9ce7b940a172770f0e58b76cd,2,10,12,22,7,2012-06-21 08:33:24,2012-06-20 16:06:37
dca6b228d1725ce9ce7b940a172770f0e58b76cd...f95121cb4f9da6c5b06c9d0b31c2c9a969c1c09d,1,3,1,4,2,2012-06-21 08:33:24,2012-06-20 16:07:27
86ea6ceda75274621b7d5c3023c5b04da3ab677e...bc2deed0fbb2e18e8654d608537c7dea6e102f63,1,1,1,2,1,2012-06-15 16:13:59,2012-06-15 16:13:59
bc2deed0fbb2e18e8654d608537c7dea6e102f63...e4031cb53134803bfc94f1b0b8552455658d8c76,1,0,4,4,1,2012-06-15 16:26:56,2012-06-15 16:26:56
e4031cb53134803bfc94f1b0b8552455658d8c76...e00b56eb04145717ed3e8dc45cc4e03addccd7c7,2,3,6,9,5,2012-06-15 17:18:08,2012-06-15 17:15:57
e00b56eb04145717ed3e8dc45cc4e03addccd7c7...ac8eac2f6632de6215d970b77b420601cedd6a91,2,1,1,2,2,2012-06-15 18:25:52,2012-06-15 18:25:52
ac8eac2f6632de6215d970b77b420601cedd6a91...515a4c7c0634018097d3cd85f6a819dabe4cfd32,2,75,7,82,3,2012-06-18 22:59:04,2012-06-18 22:59:04
29ef309e2ca39f68d11c755710446ff6d396d203...dbab04594c1eb3110cc1f65b974a88437fff9bce,1,4,1,5,2,2012-05-26 12:59:07,2012-05-26 12:59:07
711333efe1c1388c39cd76480273b4fcea18d491...13f670a5d9d86629f4879f6df9494356e4f28832,3,19,4,23,4,2013-10-08 08:07:31,2013-04-15 07:07:57
743531372a00e41246026910e2361684e2aad59f...3ff1d123736e5686fb9ec16e65828d5b8ffa2b30,36,1057,1023,2080,672,2013-10-11 21:51:54,2013-10-11 21:51:54
3ff1d123736e5686fb9ec16e65828d5b8ffa2b30...10672e3e455eba2d4ca983070ed427caeeb24a6f,21,532,470,1002,216,2013-10-15 22:10:07,2013-10-15 22:10:07
10672e3e455eba2d4ca983070ed427caeeb24a6f...74a627f04528f7e02f69d8d7947820582ce7ca15,3,32,22,54,23,2013-10-21 16:07:19,2013-10-21 16:07:19
74a627f04528f7e02f69d8d7947820582ce7ca15...3b5f795446601868d52d09ebac70ae3b7aee157a,14,360,418,778,146,2013-10-21 20:42:42,2013-10-21 20:42:42
3b5f795446601868d52d09ebac70ae3b7aee157a...623460ab139bbb0360f51b26ac27fb6932569278,1,5,5,10,4,2013-10-21 21:16:53,2013-10-21 21:16:53
623460ab139bbb0360f51b26ac27fb6932569278...5de4ec810492178095897f726bfaf879994aaf11,3,56,1,57,4,2013-10-21 22:36:38,2013-10-21 22:36:38
5de4ec810492178095897f726bfaf879994aaf11...7ce60099eec2442cc5428a830b88d51e8f9c1d75,1,1,1,2,1,2013-10-22 18:12:44,2013-10-22 18:12:44
743531372a00e41246026910e2361684e2aad59f...84c469814e634f9e2638eaf979a644fb44baffb0,1,1,1,2,1,2013-10-10 22:06:08,2013-10-10 22:06:08
9b7d02ff2d9b87d61778ee7ef5e2d43bf4c561f0...437224b4b912176ac0992aa56790142e3ba5bb8f,9,67,2,69,5,2013-08-06 04:46:32,2013-08-06 04:46:32
9b7d02ff2d9b87d61778ee7ef5e2d43bf4c561f0...e38f0d69aba011d02ba5cabc648fee6c6f4dcc29,4,195,45,240,20,2013-08-05 19:09:56,2013-08-05 19:06:41
9b7d02ff2d9b87d61778ee7ef5e2d43bf4c561f0...f1af935b8918e9f9eae63219a434a7dedbff1c38,2,7,1,8,4,2013-08-05 19:00:55,2013-08-05 18:53:09
9b7d02ff2d9b87d61778ee7ef5e2d43bf4c561f0...d85636190f127efa2ec4a6593124c037dfec0ba9,10,62,61,123,46,2013-08-05 18:41:39,2013-08-05 18:41:39
d85636190f127efa2ec4a6593124c037dfec0ba9...8c8a54901071f7d8372ce901b098507d5a4a5804,2,36,0,36,2,2013-08-07 18:47:56,2013-08-07 03:35:51
8c8a54901071f7d8372ce901b098507d5a4a5804...2984f3190e350099662b944dc45579bc194c65be,1,1,1,2,1,2013-08-07 18:47:56,2013-08-07 12:55:12
2984f3190e350099662b944dc45579bc194c65be...c0c516935292732e56cd2f2ca1c0c471743f4adc,7,6,4,10,6,2013-08-07 18:55:39,2013-08-07 04:05:03
c0c516935292732e56cd2f2ca1c0c471743f4adc...75f98a95eee8a0efe8f9649ddc8a81c64d863ced,2,21,2,23,2,2013-08-07 18:55:47,2013-08-07 13:12:27
75f98a95eee8a0efe8f9649ddc8a81c64d863ced...9c38f7a6523cdc87a897eccb6d83439987f99a4e,10,62,58,120,44,2013-08-07 20:22:41,2013-08-07 20:22:41
9c38f7a6523cdc87a897eccb6d83439987f99a4e...2c0128ee79243d32e60f19e60acc2e297c1761d6,9,31,31,62,25,2013-08-08 02:29:33,2013-08-08 02:29:33
2c0128ee79243d32e60f19e60acc2e297c1761d6...aaefbdeea205fbea2005113a9743c81721a42b36,10,48,37,85,35,2013-08-08 15:48:57,2013-08-08 15:48:57
aaefbdeea205fbea2005113a9743c81721a42b36...aa0af72933424bcf778db29c63c3727b25052c27,1,2,2,4,2,2013-08-10 21:56:58,2013-08-10 21:56:58
aa0af72933424bcf778db29c63c3727b25052c27...0e26fca1daa11a3108960dee3cb555b4c482ad81,1,2,2,4,2,2013-08-10 22:11:19,2013-08-10 22:11:19
0e26fca1daa11a3108960dee3cb555b4c482ad81...abf3732728d0af42ed7217c7148509c8aa30a7e5,9,59,60,119,46,2013-08-13 07:15:39,2013-08-13 07:15:39
abf3732728d0af42ed7217c7148509c8aa30a7e5...53d712dcb9d74979a3c678336c97e2f7564aadbe,2,3,3,6,3,2013-08-13 07:31:03,2013-08-13 07:31:03
53d712dcb9d74979a3c678336c97e2f7564aadbe...345b6307be76e6f48e255f698d057c7ac5f9679d,3,2,3,5,3,2013-08-13 07:35:07,2013-08-13 07:35:07
345b6307be76e6f48e255f698d057c7ac5f9679d...3948e86240e401adebe0d683709ddc32ecaf7f96,2,2,1,3,2,2013-08-13 07:38:37,2013-08-13 07:38:37
3948e86240e401adebe0d683709ddc32ecaf7f96...3869a171dd78e52436bcb779a04b910454932e55,1,1,0,1,1,2013-08-13 16:10:34,2013-08-08 17:10:23
3869a171dd78e52436bcb779a04b910454932e55...d4cff0cb1caac8c2c2cabbab9d3301f99b5ee230,8,33,30,63,30,2013-08-13 16:40:32,2013-08-13 16:40:32
d4cff0cb1caac8c2c2cabbab9d3301f99b5ee230...841034a35ee34190fa1cc136acccfa1a4abaed39,4,11,10,21,10,2013-08-13 16:45:56,2013-08-13 16:45:56
841034a35ee34190fa1cc136acccfa1a4abaed39...ee0656012c213a9589c7a0892f3e4a11caebc664,5,16,18,34,14,2013-08-13 16:53:56,2013-08-13 16:53:56
ee0656012c213a9589c7a0892f3e4a11caebc664...0228a514294bcb9d23bf24c61199a1a3e34d4772,1,1,1,2,1,2013-08-13 17:20:25,2013-08-13 17:20:25
c4fcae5f7cacf9478d1d92c6586615e5afcc3ac8...be0a1a79588c24b0cf032809c83d0b9cd167e0a9,1,3,1,4,2,2013-12-08 18:21:13,2013-12-08 10:03:05
c4fcae5f7cacf9478d1d92c6586615e5afcc3ac8...307a3d6762a2797ee28b43fceb1c941680ac97ec,1,1,1,2,1,2013-12-08 09:50:10,2013-12-08 09:50:10
79194bcdc956406979cd27ac99198826860d3f20...81a2012d991212fbbbf98bf7eefca3dc5d0fd7bb,3,94,6,100,9,2013-12-13 14:29:55,2013-12-12 16:30:50
81a2012d991212fbbbf98bf7eefca3dc5d0fd7bb...bf4a577c6989f67fc7821eebd61a117726afc9d5,2,45,9,54,9,2013-12-13 15:10:32,2013-12-13 15:10:32
66d585c6b344562c67812840aca5ea76881f7446...1664aaaa2678f7fe329ee046cfa0a5720f36c1be,1,5,0,5,1,2014-01-27 14:41:05,2013-11-05 15:39:05
66d585c6b344562c67812840aca5ea76881f7446...fbc5661ebfd7106d579d22f06150fded2e707070,1,1,2,3,2,2014-01-27 12:52:57,2014-01-27 12:51:46
66af84494c6e64dcb93f8a5b7edd42616faee0a7...60306450b7a7354825660e69a30877760c48395a,1,1,1,2,1,2014-01-30 02:33:51,2014-01-29 23:47:20
60306450b7a7354825660e69a30877760c48395a...39949f0604cb009d850ff080f630ccdf7ab11715,1,5,12,17,7,2014-01-30 02:35:09,2014-01-30 02:28:53
39949f0604cb009d850ff080f630ccdf7ab11715...6e0ff093fb955adeeeed5c83a0fafc568d4b8074,2,12,3,15,6,2014-01-30 02:35:09,2014-01-30 02:30:55
66af84494c6e64dcb93f8a5b7edd42616faee0a7...95fbedcd8eaaff2747196e20abd959596baf7e98,1,42,0,42,1,2014-01-29 21:15:50,2014-01-29 00:22:37
95fbedcd8eaaff2747196e20abd959596baf7e98...53bec813a81cb0e1e970df69281ab4a3e6c2a47c,3,127,13,140,17,2014-01-29 21:15:51,2014-01-29 17:17:08
53bec813a81cb0e1e970df69281ab4a3e6c2a47c...1eefd3561225bfdedfe52a7e9faa6e7c88d7a046,1,50,52,102,19,2014-01-29 21:15:52,2014-01-29 17:44:29
1eefd3561225bfdedfe52a7e9faa6e7c88d7a046...bae8bea051806682fef48137e32f0305e94398b8,1,64,0,64,1,2014-01-29 21:15:53,2014-01-29 20:53:01
bae8bea051806682fef48137e32f0305e94398b8...b747eb1445fa54675044b6d05e892904b517239c,1,16,5,21,4,2014-01-29 21:15:54,2014-01-29 20:55:33
b747eb1445fa54675044b6d05e892904b517239c...0972c59205a0cf29e75b45695cde5dc699983bc0,1,14,5,19,2,2014-01-29 21:15:55,2014-01-29 21:14:00
0972c59205a0cf29e75b45695cde5dc699983bc0...71ae7601160aca672f2b13a461aab6e4aee7f9d0,1,2,0,2,1,2014-01-30 19:30:16,2014-01-30 19:30:16
71ae7601160aca672f2b13a461aab6e4aee7f9d0...b794cbcdb638676e593cc8d2ff3394ae21f2a185,1,2,2,4,2,2014-01-30 19:38:25,2014-01-30 19:38:25
b794cbcdb638676e593cc8d2ff3394ae21f2a185...25babd02a4151f858a631314364fdca97180f2c5,1,1,1,2,1,2014-01-30 19:38:59,2014-01-30 19:38:59
ec088fec9dc65621275b9f16d746820af67592de...e8b81c698c52a7197c0842b6503e8b980d773c74,5,24,2,26,2,2014-01-22 18:26:30,2014-01-22 18:24:32
f1590a18b0c0b33ad1c194f5b6f8c66cf4c882c5...4f5a3f400be638de28fb7cc5d926cc79125d52f7,1,38,8,46,8,2014-02-08 12:10:19,2014-02-08 12:10:19
4f5a3f400be638de28fb7cc5d926cc79125d52f7...8086b78be05dbcffc80e8a87c15fc10bb7534547,1,6,6,12,5,2014-02-09 13:08:42,2014-02-09 13:08:42
76c00ead59f710a8dfeb6464eafcb4d65e26a7db...29be3a6d9eee68b3964f34c498e64ce32452a57f,4,26,20,46,11,2014-01-14 20:33:35,2014-01-14 20:33:35
29be3a6d9eee68b3964f34c498e64ce32452a57f...529f342aba858e81f370aca9570fa149ebba674b,2,12,12,24,9,2014-01-14 20:33:59,2014-01-14 20:33:59
40ef47dd46fdd361b49ccc97605a93e0993e96db...616cd13757ece5becbba7b9ff556cf7ed5502431,1,0,1,1,1,2014-01-14 20:08:09,2014-01-14 20:08:09
616cd13757ece5becbba7b9ff556cf7ed5502431...99dcb2184a46140024de438a4a19ea5aada64be8,1,0,2,2,1,2014-01-14 20:08:20,2014-01-14 20:08:20
fb8aa9e11ba47a979b87f9f05c1af6dcefc6f805...f7292a990c719ea379ee1f7b5dc512963d69ad8d,1,5,0,5,2,2012-06-22 08:13:50,2012-06-22 08:13:50
539e6c138ec3edc42f72a23d8e8814edf1319f07...c1318f71256ffde36e1451677146daf63e793b49,1,2,2,4,2,2012-05-27 01:16:13,2012-05-27 01:16:13
c1318f71256ffde36e1451677146daf63e793b49...2eb1844990609fdf1c7d4c66e4f5a1dd397cd816,1,5,3,8,2,2012-05-27 01:37:40,2012-05-27 01:20:33
2eb1844990609fdf1c7d4c66e4f5a1dd397cd816...64ab0ba7fb39d276114744bb700b48c8c0cd8916,1,1,0,1,1,2012-05-27 01:48:49,2012-05-27 01:23:54
ca27ae4859e86006d4b7d2fda4976f328f4726cb...a58eecd436ff9344cda18efcdfa1da034503512e,1,11,1,12,3,2013-10-08 20:40:52,2013-10-08 20:40:52
a58eecd436ff9344cda18efcdfa1da034503512e...1fd21b0342f4fc5ad38a74242385c202b272da80,1,6,0,6,2,2013-10-08 20:59:43,2013-10-08 20:59:43
1fd21b0342f4fc5ad38a74242385c202b272da80...3dc3c723dac9fd2550530675b61849f2215ef767,1,7,13,20,3,2013-10-08 22:52:37,2013-10-08 22:52:37
c5780abb024a3d570bc1e7eb8c892a60b77bad84...c57f668268744cbccb13c30095a0c1649fb18a63,2,20,0,20,2,2013-08-08 19:25:25,2013-08-08 18:17:32
c5780abb024a3d570bc1e7eb8c892a60b77bad84...2d9f5b9f13107a4f59ea1c055620efeb603f2bab,2,27,5,32,6,2013-08-07 17:38:09,2013-08-07 16:11:55
07c5dc84fd486b380d618319b4852591d355bd81...5588f0736089ab00e12cb7ea7c8143ec666738e6,10,32,41,73,21,2013-12-09 16:40:44,2013-12-09 15:25:36
07c5dc84fd486b380d618319b4852591d355bd81...0db932254741934afcdb04e644c31ff86db0d58c,1,1,1,2,1,2013-12-09 15:44:26,2013-12-09 15:43:05
6e0ff093fb955adeeeed5c83a0fafc568d4b8074...4bc94eb5f049d1d0fd23128b05bb0d65ffac84d9,2,2,6,8,2,2014-01-30 03:01:46,2014-01-30 03:01:46
8646b0a0689c89d9cad949754885ec542b4d0ce1...94f263f59be5be74945367b9793c57f297ed4a44,9,73,45,118,45,2014-01-30 23:51:00,2014-01-25 16:04:49
94f263f59be5be74945367b9793c57f297ed4a44...a2311f92c29e0fee5348d580c3318cf6724cd765,2,27,3,30,4,2014-01-30 23:51:00,2014-01-27 21:12:31
a2311f92c29e0fee5348d580c3318cf6724cd765...6357388e983be6ad5831d63b84aeb2f9c449411e,1,4,2,6,1,2014-01-30 23:51:00,2014-01-27 21:24:10
6357388e983be6ad5831d63b84aeb2f9c449411e...2952a9d0f474547db88f396dd8cc7c62d61993a2,1,21,0,21,1,2014-01-30 23:51:00,2014-01-27 21:39:48
2952a9d0f474547db88f396dd8cc7c62d61993a2...67c4716f74f322b79a3e4355c273bc423eb58ec6,1,29,1,30,2,2014-01-30 23:51:00,2014-01-27 21:47:48
67c4716f74f322b79a3e4355c273bc423eb58ec6...b31ebfbc666202fb576f7eb406d7a699134da09d,7,35,23,58,22,2014-01-30 23:52:13,2014-01-27 22:12:29
b31ebfbc666202fb576f7eb406d7a699134da09d...1cc974ab625c2fa0794130eb97ca88c449fc1a06,4,74,15,89,22,2014-01-30 23:52:13,2014-01-27 22:40:31
1cc974ab625c2fa0794130eb97ca88c449fc1a06...48110f67e4a21caac1b8157d8239d16cd9781e51,3,29,20,49,3,2014-01-30 23:52:13,2014-01-28 18:31:54
48110f67e4a21caac1b8157d8239d16cd9781e51...540c1809f40c1bb3cf08627a85921309852fa963,3,23,15,38,16,2014-01-30 23:52:13,2014-01-28 18:44:33
540c1809f40c1bb3cf08627a85921309852fa963...ccf6ce5c895c5d2261538150e945c93799de0999,7,64,41,105,28,2014-01-30 23:52:13,2014-01-28 19:30:36
ccf6ce5c895c5d2261538150e945c93799de0999...e871d89b2862ea61a13019705d4074bfcb6b88ae,1,19,0,19,1,2014-01-30 23:52:14,2014-01-28 19:32:09
e871d89b2862ea61a13019705d4074bfcb6b88ae...59bb1126e0a6d5c004f3856e23c75ae440211f1c,3,65,9,74,10,2014-01-30 23:53:52,2014-01-28 19:45:30
59bb1126e0a6d5c004f3856e23c75ae440211f1c...a1b07dca7d456b5eb1f32e6f25c4f419752778b3,1,3,1,4,1,2014-01-30 23:53:52,2014-01-29 17:57:20
a1b07dca7d456b5eb1f32e6f25c4f419752778b3...a1710a28f684298f79a0bab08b0b8930c1d57cf0,7,51,13,64,33,2014-01-30 23:53:52,2014-01-29 18:35:46
a1710a28f684298f79a0bab08b0b8930c1d57cf0...db092c1955ff5079d8ca475bbe1d6b0da782b38e,2,12,0,12,2,2014-01-31 00:10:18,2014-01-31 00:10:18
2b678ce5b4ebbc1d045f2a07651720d8c1e6458c...410a8e6fede33f0330d9cda36cc5f01546133eae,2,29,1,30,2,2014-01-22 23:31:25,2014-01-22 23:31:25
2b678ce5b4ebbc1d045f2a07651720d8c1e6458c...238e8149724ea462153cc082385f60dccc2a3cf9,2,8,1,9,2,2014-01-22 19:41:04,2014-01-22 19:41:04
fb52ba19ff0a620b4fd9482132206ccb4daee8e0...7bd2f401540e1e9c92183fd61aa9e2a4ef0ed051,2,53,6,59,6,2014-03-05 19:35:47,2014-03-05 19:35:47
fb52ba19ff0a620b4fd9482132206ccb4daee8e0...77ad67546492f6ebe2bf53efc867d040bcd2a6a1,2,13,11,24,9,2014-02-10 13:38:01,2014-02-10 13:38:01
77ad67546492f6ebe2bf53efc867d040bcd2a6a1...15284a2c5a9185171bfd3acf18b6ab38a032c7af,3,16,16,32,18,2014-02-10 13:52:28,2014-02-10 13:52:28
fb52ba19ff0a620b4fd9482132206ccb4daee8e0...fb6f4539d1de1f2c171d6be2e088b5b763f3e5f8,1,1,0,1,1,2014-02-09 21:45:36,2014-02-09 20:36:24
fb6f4539d1de1f2c171d6be2e088b5b763f3e5f8...f77127da12480c65caaddd2af655877978d1f5a7,3,104,25,129,5,2014-02-09 21:45:38,2014-02-09 20:37:16
f77127da12480c65caaddd2af655877978d1f5a7...9780020b18307e3e6a4707fdf0807aa2ddbfcd40,1,136,0,136,1,2014-02-09 21:45:39,2014-02-09 21:37:39
9780020b18307e3e6a4707fdf0807aa2ddbfcd40...66b2626c93532df3006232442b471b77f182a92b,1,7,1,8,2,2014-02-09 21:45:40,2014-02-09 21:43:56
3c1b3ded12afa443158287c22b81fb9419680072...0b28217bdae4fd64f5b6b8f4cb8a6139518d037e,40,162,271,433,115,2014-01-15 12:32:43,2014-01-15 11:51:31
3c1b3ded12afa443158287c22b81fb9419680072...39c2302a954e06d11fa39223d8e5afa2ad3a0b36,1,0,1,1,1,2014-01-15 02:36:00,2014-01-14 19:19:57
39c2302a954e06d11fa39223d8e5afa2ad3a0b36...e85bbd5250d324980234ece9e8c2880f0e94c931,2,134,123,257,4,2014-01-15 02:36:00,2014-01-14 22:41:49
f7292a990c719ea379ee1f7b5dc512963d69ad8d...d046945cefc34c8caafde53e20e1a064576e587e,1,4,2,6,4,2012-06-22 13:42:37,2012-06-22 13:42:37
4c977a61e598f2230e9902aa80cfea8e89d94f88...edebceffef1d661d073b9961d13042007325832d,11,380,61,441,12,2012-06-07 19:27:30,2012-05-01 11:57:45
4c977a61e598f2230e9902aa80cfea8e89d94f88...2ab9dcbd6228741d31f9e823283030c0b42555b4,1,1,1,2,1,2012-05-27 23:52:37,2012-05-27 23:47:56
4c977a61e598f2230e9902aa80cfea8e89d94f88...9bea8e85908d4c4a788766d50a91be79829c016c,2,6,0,6,2,2012-05-27 17:54:53,2012-05-27 17:54:53
9bea8e85908d4c4a788766d50a91be79829c016c...cd445767906aa60077ec7ecac562e08c83764430,3,189,11,200,12,2012-06-07 18:33:22,2012-05-27 13:00:05
c7d4904c47d493073b8f816d2b17dcf68eefe26d...6385fc5ff5d669d3ec99d89f19c5860cf53011ba,3,49,2,51,7,2013-08-08 09:07:03,2013-03-17 19:39:01
6385fc5ff5d669d3ec99d89f19c5860cf53011ba...a603c191578f7b33720e36e95421fcd58bc7abe4,5,123,41,164,18,2013-08-08 09:14:53,2013-03-18 20:02:36
a603c191578f7b33720e36e95421fcd58bc7abe4...4d588d9713bb558e45a8bdf6c41d232bb592b814,5,19,12,31,13,2013-08-08 09:40:41,2013-08-08 09:24:47
4d588d9713bb558e45a8bdf6c41d232bb592b814...82ae6fcdba2aa0fb21f49b127b5f5f7a637ffc76,2,11,12,23,7,2013-08-08 09:55:47,2013-08-08 09:55:47
82ae6fcdba2aa0fb21f49b127b5f5f7a637ffc76...84fec6f628b8c82a70c0aff5dc6a47d1cdb6fbf0,2,4,5,9,2,2013-08-08 11:14:35,2013-08-08 11:14:35
84fec6f628b8c82a70c0aff5dc6a47d1cdb6fbf0...4efa32903adf131631d283c914e0a5bf29c49e4d,8,33,33,66,33,2013-08-08 11:57:01,2013-08-08 11:41:18
4efa32903adf131631d283c914e0a5bf29c49e4d...eba7399251cfa95d9346b9b41ca78dc5d43a840d,5,62,42,104,18,2013-08-08 12:39:32,2013-08-08 12:39:32
eba7399251cfa95d9346b9b41ca78dc5d43a840d...3a7ffc29c9416c5d182835c7f18c04437366f218,3,112,2,114,6,2013-08-08 14:18:07,2013-08-08 14:18:07
3a7ffc29c9416c5d182835c7f18c04437366f218...cca5df6376fd41fb4fbbb9f8a9ff87c38079dfd5,3,83,9,92,9,2013-08-08 14:59:39,2013-08-08 14:59:39
cca5df6376fd41fb4fbbb9f8a9ff87c38079dfd5...99dfb538addc06c2f40d29371c52dd43f0d6ceb1,5,83,52,135,36,2013-08-08 18:38:42,2013-08-08 15:57:59
99dfb538addc06c2f40d29371c52dd43f0d6ceb1...1e96c9d5341e5f2b0e1af9a1088cc30d3ffb9a01,3,45,0,45,4,2013-08-08 18:47:06,2013-08-08 18:47:06
1e96c9d5341e5f2b0e1af9a1088cc30d3ffb9a01...a319ffaead9290bfe35a0f105ff17dacaf7b6e7f,1,8,0,8,3,2013-08-08 19:00:33,2013-08-08 19:00:33
a319ffaead9290bfe35a0f105ff17dacaf7b6e7f...5880962d90958bc37c08c21d37c9da480ef20e7f,4,136,30,166,7,2013-08-12 09:40:57,2013-08-09 07:05:19
5880962d90958bc37c08c21d37c9da480ef20e7f...54f3a572b4fac419008afa83da56c1b0daee1257,3,106,0,106,7,2013-08-12 09:40:57,2013-08-09 08:29:11
54f3a572b4fac419008afa83da56c1b0daee1257...d8488b981c1410dd2de2f9fe99764bdae33ca607,1,20,11,31,6,2013-08-12 09:40:57,2013-08-09 08:37:35
d8488b981c1410dd2de2f9fe99764bdae33ca607...d8289b9fb416cfe4f83eeb38fe324c077bada3e4,1,6,1,7,1,2013-08-12 09:40:57,2013-08-09 09:03:13
d8289b9fb416cfe4f83eeb38fe324c077bada3e4...86c02614608eb7e9e78c09cdec69aeba689edae8,1,9,12,21,3,2013-08-12 09:40:57,2013-08-09 09:05:02
86c02614608eb7e9e78c09cdec69aeba689edae8...43e5dda70249ede020a57f3888356a0dcb96da48,3,1,6,7,6,2013-08-12 09:40:57,2013-08-12 09:21:57
43e5dda70249ede020a57f3888356a0dcb96da48...f4be8209afd3cc996667196a1e437aac21485691,6,83,250,333,29,2013-08-13 22:45:05,2013-08-13 22:45:05
c7d4904c47d493073b8f816d2b17dcf68eefe26d...d19bcb335256fddc5dd1289f1772d4d864b54ec0,5,20,25,45,9,2013-08-08 07:41:16,2013-06-06 21:49:14
4d116c34132251134a5acbcebb5e30fd8d5c2f50...2ab6d2cd47a9175faa8d9915751511d9490b03b9,1,1,1,2,1,2014-03-06 15:08:17,2014-03-06 15:08:17
0316d80ac0d9cde335467576ad61005963015cfc...5572d2b8a1668f3c2f35ec91d3f864f28f8ef987,2,25,21,46,22,2014-01-30 17:59:59,2014-01-28 19:44:17
5572d2b8a1668f3c2f35ec91d3f864f28f8ef987...c0644c3fbb31c381afb2d0658b5c6e83432fd8c9,5,49,29,78,18,2014-01-30 17:59:59,2014-01-28 19:45:06
c0644c3fbb31c381afb2d0658b5c6e83432fd8c9...3cf11eef17d8359c032844de945da6e983572ecc,3,25,24,49,13,2014-01-30 17:59:59,2014-01-28 19:47:33
3cf11eef17d8359c032844de945da6e983572ecc...e9d5e5f3d41846b5f3be1bfb6a5cb1e501f428c8,5,7,7,14,5,2014-01-30 17:59:59,2014-01-29 00:25:42
e9d5e5f3d41846b5f3be1bfb6a5cb1e501f428c8...d9b04d78a396f771eada206b726ad6e8259a19b8,4,223,59,282,31,2014-01-30 17:59:59,2014-01-29 23:02:35
d9b04d78a396f771eada206b726ad6e8259a19b8...8606f33beadf5df48b36a64359c99d50aeb0f496,2,64,18,82,11,2014-01-30 18:00:00,2014-01-30 17:59:15
8606f33beadf5df48b36a64359c99d50aeb0f496...19459b1e29e150c02e733bdefd5e1eb09fdd4bf7,1,5,2,7,3,2014-01-30 18:23:35,2014-01-30 18:23:35
f9500b4524c62a2f443061bacea8171b435230f6...7be88b4c4df34e91213a8a66d80ef1eb4b3a02ee,1,13,5,18,6,2014-01-31 21:44:09,2014-01-31 21:44:09
e82b6d13d21c99eb95ae6721eb0e89101c3256c4...ab4bcc038aebb68975935809cd328fc9ccb70ba7,1,4,1,5,2,2014-01-22 22:14:37,2014-01-22 22:14:37
5d195cf76b833886613b8a778966fba83be09ccb...b033f3a3f9a4abd1e6e0c217a1bd16ab768f90ff,1,4,17,21,2,2014-02-12 00:52:08,2014-02-12 00:52:08
f04c7dcab406fd6529571f9e0b55706ed104f7a6...4ef9a50817b7e527ad65b4c3db13ab862347e381,1,4,0,4,2,2014-01-15 21:58:11,2014-01-15 21:58:11
d046945cefc34c8caafde53e20e1a064576e587e...527ed55448fb8fceb93837426c60bb401b8e32ab,3,137,1,138,4,2012-06-22 19:40:24,2012-06-22 13:51:44
527ed55448fb8fceb93837426c60bb401b8e32ab...1163434646bfd27ffc4364754235d745a6384195,1,3,8,11,4,2012-06-22 19:42:10,2012-06-22 15:04:16
1835c51f58a670e23c9546f942259d53fe626fa2...1d4dcc4b48f9b60c70aefc791da500b4ff16ae7d,1,3,1,4,2,2012-06-01 09:48:58,2012-06-01 09:48:58
1835c51f58a670e23c9546f942259d53fe626fa2...36bae3e96af2d706d259602bb6c8cef82bd9b710,1,1,1,2,1,2012-05-31 07:56:05,2012-05-31 07:56:05
1835c51f58a670e23c9546f942259d53fe626fa2...d05e2c64dd93da7219c9ebca18c2f3b8478ca93a,4,20,0,20,5,2012-05-29 23:05:17,2012-05-29 22:27:22
d05e2c64dd93da7219c9ebca18c2f3b8478ca93a...d27bf6656158c6be1eca7e8c5e87b4d39958b18d,2,11,1,12,3,2012-06-04 21:47:09,2012-05-29 22:50:39
4a759bfbcfbf4a5e8e0c734687578ffe34d2ca87...8e5247203720de7abd084996c00afd6fb6f6cc21,1,4,2,6,4,2014-03-06 15:56:46,2014-03-06 15:40:34
40e10630cfbdddd878a6347c1751092bab7f7a28...59b1dbcd7acf6aa7dd6d81d0386ab15f46ce6ac7,1,13,0,13,3,2014-02-27 15:56:25,2014-02-27 15:56:25
59b1dbcd7acf6aa7dd6d81d0386ab15f46ce6ac7...1d08b72e4fbc474719baec127d7911cc116dec48,1,19,0,19,1,2014-03-02 11:14:20,2014-03-02 11:14:20
40e10630cfbdddd878a6347c1751092bab7f7a28...4075e060b45a73834a24684ed835d52f7176d58b,9,143,300,443,69,2014-02-04 05:02:08,2014-02-04 05:02:08
4075e060b45a73834a24684ed835d52f7176d58b...af4bc6615d9fe0ebcc4abb939273913bcf9aee60,1,97,0,97,1,2014-02-04 05:04:40,2014-02-04 05:04:40
af4bc6615d9fe0ebcc4abb939273913bcf9aee60...882c7742711199f757305687c257ac97262a3a30,9,78,75,153,42,2014-02-04 18:01:37,2014-02-04 18:01:37
882c7742711199f757305687c257ac97262a3a30...43709ca87811efc3c237eb719611f025502f3928,2,38,2,40,2,2014-02-04 18:33:30,2014-02-04 18:33:30
43709ca87811efc3c237eb719611f025502f3928...1bbacc9ff617b67831dbfce5e1b04e1bd8571aa0,2,25,20,45,10,2014-02-05 00:46:43,2014-02-05 00:46:43
40e10630cfbdddd878a6347c1751092bab7f7a28...50ad7cc2089798f65f8fcc49d94ab515f64dd160,3,36,0,36,3,2014-02-02 17:20:38,2014-02-02 17:20:06
40e10630cfbdddd878a6347c1751092bab7f7a28...7ac1b89942e78bf73f954136c320e6be6f181c85,1,38,13,51,5,2014-02-01 19:46:15,2014-02-01 19:46:15
7ac1b89942e78bf73f954136c320e6be6f181c85...ee8e6afda9b33a1e20b7db67136cfb9cad9d7846,1,3,1,4,1,2014-02-01 19:46:44,2014-02-01 19:46:44
ee8e6afda9b33a1e20b7db67136cfb9cad9d7846...7f058b86682e2a1566b192dfd1f0d333cc5b8c7c,1,6,2,8,1,2014-02-02 03:31:26,2014-02-02 03:29:48
90dd28640757a59f51cd52eabd98119f60026586...2a528bc088f566ad3301963304da8942400f261b,1,2,1,3,1,2014-02-12 01:05:52,2014-02-12 01:05:13
1d4dcc4b48f9b60c70aefc791da500b4ff16ae7d...36c88422ef7537f41bd24d3ace41ee0422e531ac,1,9,0,9,1,2012-06-02 14:48:12,2012-06-02 14:48:12
36c88422ef7537f41bd24d3ace41ee0422e531ac...e9551e86b9949df19cdbb94d7caa4b8f967bed3b,3,5,0,5,3,2012-06-02 14:52:22,2012-06-02 14:52:22
01dbe273c9b6f86a613b67cee27212cf4bacf4c0...fac66990b6ed5173ae89458f32d456458c086b1a,3,45,1,46,5,2012-06-05 12:01:44,2012-06-05 11:56:44
fac66990b6ed5173ae89458f32d456458c086b1a...693b23c09aef65a53d4523357be44654b4533065,2,92,19,111,18,2012-06-05 20:33:34,2012-06-05 12:29:10
8e5247203720de7abd084996c00afd6fb6f6cc21...806571f3523d64be51e541705da580f28ea8f9a9,2,26,0,26,4,2014-03-07 08:28:18,2014-03-07 08:28:18
8e5247203720de7abd084996c00afd6fb6f6cc21...6affd71f33f9a9693425d6f3599ba1f25226c34b,25,156,131,287,129,2014-03-06 17:44:51,2014-01-04 01:38:34
6affd71f33f9a9693425d6f3599ba1f25226c34b...aa17c3c63c3e31155015572cf208d89def9fce0c,4,29,29,58,23,2014-03-06 17:44:52,2014-01-04 01:42:09
494be429ad2d247a8d1fb2b43b8c715a4b9da663...c9f5298b0e7a1c21da35618be33ae651cbcdbcef,3,25,20,45,19,2014-03-03 11:10:36,2014-03-03 11:09:17
c9f5298b0e7a1c21da35618be33ae651cbcdbcef...2491c416ed84fb575506b0b58fb234ab2daa24fb,1,1,1,2,1,2014-03-03 11:13:17,2014-03-03 11:13:17
2491c416ed84fb575506b0b58fb234ab2daa24fb...ebb3c506fd880a383ea66679865e16e24253cb3a,3,16,16,32,14,2014-03-03 11:40:25,2014-03-03 11:40:25
3b6a5bac20a9cb46cd29d74baf06cf8a8d1248fb...b60149ecedab39fffc8607896f653ef7ac81b1e2,1,182,0,182,1,2014-02-04 03:56:33,2014-02-01 02:43:50
b60149ecedab39fffc8607896f653ef7ac81b1e2...16eb8b7c0667ba819e85b7bb4b40c2f71f73e59a,1,70,0,70,4,2014-02-04 03:56:34,2014-02-01 20:02:55
16eb8b7c0667ba819e85b7bb4b40c2f71f73e59a...bb13d39162b0416585b34f18e9072fc4364d2655,1,70,0,70,4,2014-02-04 03:56:34,2014-02-01 20:51:44
bb13d39162b0416585b34f18e9072fc4364d2655...c0b10c25e02c6922276567600988fb2b85aeede1,1,3,6,9,4,2014-02-04 03:56:34,2014-02-01 20:05:00
c0b10c25e02c6922276567600988fb2b85aeede1...dbfd83bc6567763e6c363c462e9dd0628eaf3fe6,1,1,1,2,1,2014-02-04 03:56:34,2014-02-04 03:56:13
3b6a5bac20a9cb46cd29d74baf06cf8a8d1248fb...0d847a31598a933877d94430b2fe80bade55fe1a,8,23,32,55,23,2014-02-03 22:08:40,2014-02-03 22:08:40
0d847a31598a933877d94430b2fe80bade55fe1a...586be3b889c2f8955630da14b6a703cccc340d47,11,61,42,103,45,2014-02-03 23:05:55,2014-02-03 23:05:55
586be3b889c2f8955630da14b6a703cccc340d47...eec2761f068a0467ec5ddd140806e4cc9a6f4a58,1,1,1,2,1,2014-02-03 23:06:32,2014-02-03 23:06:32
eec2761f068a0467ec5ddd140806e4cc9a6f4a58...86746b4b3ae1508c980a7adcdd088ab87a92af7a,6,101,1,102,7,2014-02-03 23:06:47,2014-02-03 23:06:47
86746b4b3ae1508c980a7adcdd088ab87a92af7a...0adb06065b944e755933e11ed9ac7ce544b55d33,2,35,3,38,5,2014-02-04 23:32:57,2014-02-04 23:32:57
0adb06065b944e755933e11ed9ac7ce544b55d33...491cecfe8ce4c6fbee3357248c7b688b6e1aaab4,3,29,4,33,11,2014-02-05 04:27:44,2014-02-05 04:13:50
491cecfe8ce4c6fbee3357248c7b688b6e1aaab4...c3ab1e5af4c43d1031969fbb12c559a55c5baf05,8,101,22,123,25,2014-02-05 04:38:13,2014-02-05 04:38:13
c3ab1e5af4c43d1031969fbb12c559a55c5baf05...010cec3ac26ab8445cc8401fb312f60168916bda,8,44,16,60,21,2014-02-05 04:50:40,2014-02-05 04:50:40
a064dc2d0b6206116a35be4b62c58c3c1170d5de...b9f819978c571cc806827e8b3ebc1a58a0755999,29,516,0,516,31,2014-03-06 02:49:23,2014-03-06 02:49:23
dbd2ca356b8a16d028e45c5263e9c460be13d338...0197d4107a2996dc2ed4e98698e281c2d5fa44e1,2,10,1,11,2,2014-02-16 16:56:37,2014-02-15 23:09:01
c81e4adfd779a5bf8dd91539dda2dc0636abfc9d...5187b609ba203b5a62e3e54c1a323cc0647deff9,1,3,0,3,1,2014-03-07 15:03:10,2014-03-07 13:58:43
5187b609ba203b5a62e3e54c1a323cc0647deff9...7c1ee212b7fa1568a12a0a656b02cae01cb1cb6c,1,8,9,17,4,2014-03-07 15:03:10,2014-03-07 14:17:08
7c1ee212b7fa1568a12a0a656b02cae01cb1cb6c...a07b169834a11f60a2baa98f9735c2dfe7e4a1ee,1,11,5,16,3,2014-03-07 15:03:10,2014-03-07 14:40:53
a07b169834a11f60a2baa98f9735c2dfe7e4a1ee...ae32c54e5806cf8517beeb057cf640ed346508eb,6,22,1,23,9,2014-03-07 15:03:15,2014-03-05 19:28:49
c81e4adfd779a5bf8dd91539dda2dc0636abfc9d...00258cc0b6d54f8c5802b41089d9c6b74ba2f919,1,9,15,24,7,2014-03-07 14:52:27,2014-03-06 21:10:17
00258cc0b6d54f8c5802b41089d9c6b74ba2f919...79aa03020d1a2020b4189ad272ee603af34f0921,1,9,6,15,6,2014-03-07 14:52:34,2014-03-06 21:23:57
041cd4a23ff4fb17e7e9250521f78819636afbfd...dd954a3735b429c976459dbb3d26405c41de2352,2,4,4,8,3,2014-03-07 18:53:00,2014-03-07 18:53:00
f34b9a5984c1e090d995cd792c4135541a153c7b...96484ecd9e133a08861aabd7391d48f470d64bd5,1,1,1,2,1,2014-03-03 11:59:35,2014-03-03 11:59:35
b5212858f17f053e8854b376a2d3f134a3fbd71b...0330469f6d0ee51edba84df448359603b79ced55,1,43,39,82,20,2014-03-03 10:42:25,2014-03-03 10:42:25
0330469f6d0ee51edba84df448359603b79ced55...058956ce7f76c0955a8aea77831a22838ec3ede4,1,1,2,3,1,2014-03-03 10:47:06,2014-03-03 10:47:06
058956ce7f76c0955a8aea77831a22838ec3ede4...6874cafd84b70f6f83fdcf81e55f87c8d62bb07e,2,6,2,8,3,2014-03-03 11:08:17,2014-03-03 11:08:17
6874cafd84b70f6f83fdcf81e55f87c8d62bb07e...b43f35fde2fa977870280d685b6e96418b82752e,1,1,5,6,2,2014-03-03 13:59:50,2014-03-03 13:59:50
7369ea8075fa112bbd4c13f06eeedeb2a4e47153...d60064132aa0ffe2bb7a02716b054b0456947e77,1,2,2,4,2,2014-02-05 12:09:34,2014-01-30 16:24:46
7369ea8075fa112bbd4c13f06eeedeb2a4e47153...f61272e04727716ad09bb57e4ffa9ce4be09dc55,2,17,12,29,11,2014-02-05 11:16:37,2014-02-01 11:51:36
f61272e04727716ad09bb57e4ffa9ce4be09dc55...b4ef67d5ebc55943073d7baacd91f46c20d9ccf4,1,10,0,10,1,2014-02-05 11:16:37,2014-02-01 14:11:00
b4ef67d5ebc55943073d7baacd91f46c20d9ccf4...d465e4e980333b3e7437801fc375b595fb3adf1f,3,32,13,45,17,2014-02-05 11:16:44,2014-02-01 14:19:13
d465e4e980333b3e7437801fc375b595fb3adf1f...af81720236f05f72cfe763208143b5dacb2f99a2,1,14,11,25,5,2014-02-05 11:16:44,2014-02-01 14:29:16
af81720236f05f72cfe763208143b5dacb2f99a2...d18209eef9a7fbbccb495b6e5450d14a76623847,1,19,0,19,1,2014-02-05 11:16:44,2014-02-01 15:27:42
d18209eef9a7fbbccb495b6e5450d14a76623847...c74077d13c582ff46668f3ace4c54f20287cfed4,1,1,2,3,1,2014-02-05 11:16:44,2014-02-02 11:08:18
7369ea8075fa112bbd4c13f06eeedeb2a4e47153...9b148098e6802f9dd797471fc4f20cfc58a846b4,6,120,26,146,30,2014-02-05 11:07:56,2013-12-18 18:58:16
9b148098e6802f9dd797471fc4f20cfc58a846b4...5d96fe8828505db852671175d5895dfd275f3d06,2,18,28,46,8,2014-02-05 11:07:56,2014-01-14 14:33:29
5d96fe8828505db852671175d5895dfd275f3d06...fc4728e3e2a4094b202a63319232f25adbd55fed,3,9,4,13,7,2014-02-05 11:07:56,2014-01-29 13:07:18
fc4728e3e2a4094b202a63319232f25adbd55fed...1202c7eaa6f0fd6407bc386881edd686771fc0f4,1,7,7,14,5,2014-02-05 11:07:56,2014-02-04 20:35:44
1202c7eaa6f0fd6407bc386881edd686771fc0f4...d6236cf662ebd4ba8ef4902c81a19bbfd92847f9,1,42,0,42,1,2014-02-05 11:07:56,2014-02-04 20:40:22
d6236cf662ebd4ba8ef4902c81a19bbfd92847f9...911236619b5d774e33dd9f3de92a7c86c2befb26,5,27,25,52,14,2014-02-05 11:07:56,2014-02-04 21:04:00
911236619b5d774e33dd9f3de92a7c86c2befb26...878fb66f5765115eff34213cfc8dd04b8a56b2a5,3,78,6,84,9,2014-02-05 11:07:57,2014-02-05 09:19:17
878fb66f5765115eff34213cfc8dd04b8a56b2a5...f8621dde4057aba2df8d7585f6fbf2d6ee4fc023,1,26,14,40,2,2014-02-05 11:07:57,2014-02-05 09:42:42
f8621dde4057aba2df8d7585f6fbf2d6ee4fc023...7ee8c7e6776a3c5b3a45cfd10ccf205eebb3f3fe,5,49,27,76,24,2014-02-05 11:07:57,2014-02-05 10:07:34
7ee8c7e6776a3c5b3a45cfd10ccf205eebb3f3fe...f44fd59ed7b3533bf9cbaa07969a8a57475a77aa,3,46,2,48,4,2014-02-05 11:07:57,2014-02-05 10:21:14
f44fd59ed7b3533bf9cbaa07969a8a57475a77aa...b7ae71ecf263047c427be099a3e1536cca17dc5d,2,73,3,76,2,2014-02-05 11:07:57,2014-02-05 10:47:33
b7ae71ecf263047c427be099a3e1536cca17dc5d...5367ec4b84dc3b4ff3ff441347ce07d6065dd759,3,36,0,36,3,2014-02-05 11:07:57,2014-02-05 11:02:52
e0ebaaa53ea1154a1f392dae463453ac6c428d78...c7c833947ec7ac446761242c02d32916661daeb7,3,11,2,13,7,2014-02-23 22:26:12,2014-02-20 23:22:07
c7c833947ec7ac446761242c02d32916661daeb7...9e3b901aeb3c3dc4b0bb442745ca59bb7e894f76,1,15,0,15,1,2014-02-23 23:09:29,2014-02-23 23:09:29
9e3b901aeb3c3dc4b0bb442745ca59bb7e894f76...899bd19a62c10be929103542aabbf8585de8aecd,2,3,2,5,2,2014-02-24 20:20:57,2014-02-24 20:20:57
899bd19a62c10be929103542aabbf8585de8aecd...0276f0f55bf24dc5e0f49612106c1091381033f9,2,2,2,4,2,2014-02-26 18:25:07,2014-02-26 18:22:19
e0ebaaa53ea1154a1f392dae463453ac6c428d78...9bda5fb8c1fa5d69616477f43b511b6f717115ec,2,11,4,15,3,2014-02-18 22:05:30,2014-02-18 22:05:30
9bda5fb8c1fa5d69616477f43b511b6f717115ec...864535cf850973378c8283f62347055d2593c685,1,3,1,4,1,2014-02-18 22:07:42,2014-02-18 22:07:42
6de018bbf1fef075d28f2a0cce5f16595f0c8d94...52fba18f4e73a0342b28428cc7d783423b6d19c0,2,30,10,40,3,2014-03-10 17:16:10,2014-03-10 17:16:10
6de018bbf1fef075d28f2a0cce5f16595f0c8d94...0782c89ed5043d4707436605afd32bb1d53d0240,1,1,1,2,1,2014-03-10 03:40:07,2014-03-10 03:40:07
bb3687c5a8180c39d12b437ca1822ac43482b26f...a14aa1e789aca48660466f37b2804b6a9d88e1c8,1,17,10,27,6,2014-03-04 19:11:50,2014-03-04 19:09:17
0511b15c82a6af253d9bd18ddeed85f8afd28ddd...d113791d8f5634b10a98eb265687b7aa79f1658e,1,15,0,15,1,2014-03-03 15:10:29,2014-03-01 15:53:47
d60064132aa0ffe2bb7a02716b054b0456947e77...a6563619e98437a99ff49eef590f62dbb1584358,1,12,28,40,7,2014-02-05 13:31:13,2014-02-05 12:01:54
a6563619e98437a99ff49eef590f62dbb1584358...1e6f0ac4360bae25ef0a9618c9b091192b8e8997,1,2,2,4,2,2014-02-05 13:31:13,2014-02-05 12:49:51
1e6f0ac4360bae25ef0a9618c9b091192b8e8997...24f3024f36ca44ca8bb32e1a80a048ac4301eaf7,3,25,13,38,4,2014-02-05 13:34:15,2014-02-05 13:31:01
1574d3884f020c072f68c08785e199732e438e34...d88399922f622baef91c6f4e4e67b2091653cb65,1,11,7,18,7,2014-02-27 22:01:16,2014-02-27 22:01:16
d88399922f622baef91c6f4e4e67b2091653cb65...6789b7a75d1e24a7f4ce34628c6b4561517f0b73,6,289,311,600,55,2014-02-27 22:13:22,2014-02-27 22:13:22
2dc49ea93c5c320216806089fee579021f3ce9cf...5bda607c37e99d7257ace09fd8685b52d5f6ae85,1,5,1,6,2,2014-02-21 00:20:31,2014-02-21 00:09:44
2dc49ea93c5c320216806089fee579021f3ce9cf...978a4ed5ebd3892731434e4023f20383f820c112,2,6,4,10,2,2014-02-20 19:00:31,2014-02-20 19:00:31
978a4ed5ebd3892731434e4023f20383f820c112...68a19ca9ffb685123038a8d16c0a59845f147778,3,36,21,57,10,2014-02-20 19:26:51,2014-02-20 19:26:51
68a19ca9ffb685123038a8d16c0a59845f147778...72556cc63ba93a187589921c6008caf92686ea9c,10,30,29,59,14,2014-02-20 22:27:10,2014-02-20 22:27:10
fc78488b3da2b5f6c3acf8eafda82d47bebf748d...9af14886a94ca4d08c7af1ba84b21cba40fce34c,1,2,2,4,2,2014-03-10 17:20:47,2014-03-10 17:20:47
66d9e0461c7c0d8ec3fdb23b192399c6eb05e9a9...45d2e8dc4687b5da6e872fbfa960ea7cff3b3867,2,51,3,54,7,2014-03-05 12:13:34,2014-03-05 12:13:34
45d2e8dc4687b5da6e872fbfa960ea7cff3b3867...8384a50a2171f57cc1b8158777b124d2022db94e,1,2,2,4,3,2014-03-05 12:33:20,2014-03-05 12:33:20
66d9e0461c7c0d8ec3fdb23b192399c6eb05e9a9...06a8f5c3b26682cf80a672cbc5f75c09f336cafe,1,5,2,7,2,2014-03-05 05:00:41,2014-03-05 05:00:41
66d9e0461c7c0d8ec3fdb23b192399c6eb05e9a9...0d3c8a9d9202f69ee0366f2eeab1765b18b49baa,2,4,4,8,2,2014-03-05 04:06:31,2014-03-05 04:06:31
c2e8374574cc0cf0f30f6a26493e2ce407740020...4636ca9391974aa0c6251717cde94b5aea296b77,2,9,2,11,4,2014-03-04 10:22:27,2014-03-04 10:22:27
f83ef56209d9219ea80a142551202862df897426...c254e2b641cffd47667de02f77e7f5ef3304841e,1,127,33,160,34,2014-02-21 17:28:15,2014-02-21 16:55:30
9af14886a94ca4d08c7af1ba84b21cba40fce34c...5302a88538c870028f2623b099c66c800f5cfe68,3,91,1,92,3,2014-03-12 18:21:55,2014-03-12 18:21:55
9af14886a94ca4d08c7af1ba84b21cba40fce34c...894990788771bef6ca20398e46b217817b8e0db8,2,29,17,46,15,2014-03-10 18:34:50,2014-03-10 17:53:39
894990788771bef6ca20398e46b217817b8e0db8...eb46fb2ba965f4e25946090dd172fcc3b20d93ee,2,7,0,7,1,2014-03-10 18:35:14,2014-03-07 23:49:18
68581754f3a37e7712e3983acfeff0ff598e4eb6...a213a7bfa82b7171b90c415cbdb44d469e747ece,2,13,2,15,3,2014-03-05 20:00:15,2014-03-05 19:32:53
68581754f3a37e7712e3983acfeff0ff598e4eb6...4ae4a9bbd1c8b9464cc04c13508deca159491047,1,1,1,2,1,2014-03-05 19:31:15,2014-03-03 22:36:34
4ae4a9bbd1c8b9464cc04c13508deca159491047...a53b858417a8781d8e018a51ec66495964c54e1b,3,316,1,317,3,2014-03-05 19:31:15,2014-03-03 22:56:43
a53b858417a8781d8e018a51ec66495964c54e1b...feebe6150f33b9713505c76ff2f204997b9d8687,1,7,4,11,5,2014-03-05 19:31:15,2014-03-05 19:26:13
0a62caf4e4927cbf74f40d8a2cb44b84267a30da...f5753999e4cac020c2dd3a4669fe9ba14df93cb5,7,138,10,148,23,2014-03-04 23:34:23,2014-03-04 23:34:23
f5753999e4cac020c2dd3a4669fe9ba14df93cb5...13f7ecd7b9c5244441eeaae798c8657d1818ea7f,3,97,0,97,4,2014-03-05 00:23:28,2014-03-05 00:23:28
13f7ecd7b9c5244441eeaae798c8657d1818ea7f...26875825df19d484c24921e355963e75dc0a4476,2,3,10,13,4,2014-03-05 21:06:22,2014-03-05 21:06:22
f3e44dd64ca7b7e4640d816e389faa583c7b4fec...0d8265c8af1b8ba11ed0818e81276239c47e11db,2,3,3,6,2,2014-02-24 13:32:05,2014-02-22 17:25:41
0d8265c8af1b8ba11ed0818e81276239c47e11db...8ac7da796b11b9e4d223cd8d1fe43dc538f7deaa,1,2,2,4,2,2014-02-24 13:32:05,2014-02-22 18:15:11
8ac7da796b11b9e4d223cd8d1fe43dc538f7deaa...b1f2c2e25587e57d4869530b7330d73308f70fe5,1,3,1,4,3,2014-02-24 13:33:14,2014-02-22 18:18:42
b1f2c2e25587e57d4869530b7330d73308f70fe5...c8893d1f00a7897c6fada3ecc21eabe5c1af9cb0,1,2,2,4,2,2014-02-24 21:39:04,2014-02-24 21:39:04
e59e712f6464f455a92b8f3042134e2c43fd24a1...2b40390f226ac8ba516fdf0d893e0b5a29857dc7,1,1,1,2,1,2014-03-13 14:54:53,2014-03-13 14:54:53
3ab57816015f59e9741017f866d3d87a4651b54f...6ad59ef1d461180a51a59d5809dcfd01e2d8cfd9,1,6,4,10,4,2014-04-01 10:16:40,2014-04-01 10:16:40
98b9366212ac6670bd5f90e70400e7cf09aea16a...ab0af298da8c6d96870be06c2497640da9ec6647,1,2,0,2,1,2014-02-25 05:56:08,2014-02-25 05:56:08
ab0af298da8c6d96870be06c2497640da9ec6647...4f46a98b6e419bd98765e18ce7fc64e3562dbd09,10,0,16,16,10,2014-02-25 07:32:25,2014-02-25 07:32:25
98b9366212ac6670bd5f90e70400e7cf09aea16a...83634d38be2d0a1ac006d912216cd6787c2b1542,13,396,355,751,54,2014-02-25 01:52:38,2014-02-25 01:43:10
2b40390f226ac8ba516fdf0d893e0b5a29857dc7...5c8096c53c569a2dcc0e032705a77590885be0e7,1,9,0,9,2,2014-03-17 18:44:07,2014-03-17 18:44:07
2b40390f226ac8ba516fdf0d893e0b5a29857dc7...853b1407c0325f6690eab92746d1f53c78b0da49,4,4,4,8,4,2014-03-17 16:47:46,2014-03-17 15:10:33
853b1407c0325f6690eab92746d1f53c78b0da49...cb562c3fb305b7fa2ddc46983a6107f7b8340293,1,0,21,21,1,2014-03-17 16:47:47,2014-03-17 16:36:51
cb562c3fb305b7fa2ddc46983a6107f7b8340293...4b7e1b9e927eec2359f178a260335109d4222e2b,5,120,31,151,23,2014-03-17 16:47:47,2014-01-15 12:19:48
a2d18a0219a1d76f0914d59bb8dc73689e9ab1b5...9e1ed9f2c0e5345eebbefdb6708fad274f37bdcd,1,1,1,2,1,2014-04-01 15:01:40,2014-04-01 15:01:40
cb81c3a764447ceb2cd693935bf970138ea60ccc...486bc36689e1895a0c8aac5242defbed87a0ba52,3,103,31,134,7,2014-02-27 00:37:08,2014-02-27 00:37:08
cb81c3a764447ceb2cd693935bf970138ea60ccc...f2abb72568949a0a751135a75748051a07a1b2d4,1,0,5,5,3,2014-02-26 20:39:48,2014-02-26 20:39:48
cb81c3a764447ceb2cd693935bf970138ea60ccc...300f44125a5abb00f6185babc9bb828aec556015,9,57,50,107,31,2014-02-25 10:56:11,2014-02-25 10:56:11
300f44125a5abb00f6185babc9bb828aec556015...3536c168c354906e2109f49a474f51117fc9b7db,1,3,1,4,2,2014-02-25 13:57:47,2014-02-25 13:57:47
dd5e74e59af7597938bdcedd3cb240d3c693ea1f...1392418ea800bbd05dd4b38c5d5995df5bd3e177,2,104,20,124,10,2014-03-18 14:24:23,2014-03-18 13:04:33
a7af1f7dd6929d2c903aa932ae5ea10d368e75d0...0aee025befc82efe3b8a92692ebe852ac56171dd,3,105,2,107,5,2014-03-18 14:31:14,2014-03-18 14:31:14
5dd7d2432ed77651110bcbb37479b2d4e5b01b19...bac95e6e1e99b1e364c5ebd39887a8e24bc1ad9d,2,76,4,80,5,2014-03-18 18:58:52,2014-03-18 18:41:03
bac95e6e1e99b1e364c5ebd39887a8e24bc1ad9d...1afe1400433f010734ae4c43bf35dcc94edcc9de,3,68,0,68,4,2014-03-19 14:54:33,2014-03-18 21:16:58
1afe1400433f010734ae4c43bf35dcc94edcc9de...afc57eb48fc69d3e4808648c090aa6f91f9b29aa,1,7,22,29,7,2014-03-19 14:54:33,2014-03-19 05:59:09
afc57eb48fc69d3e4808648c090aa6f91f9b29aa...6aaae94a7060834a68f3fd24d8006dbfe769e04a,2,72,18,90,8,2014-03-19 15:52:20,2014-03-19 15:30:37
6aaae94a7060834a68f3fd24d8006dbfe769e04a...99797c96cd57a616ada009a2359390c605d33929,2,84,3,87,5,2014-03-19 17:14:35,2014-03-19 17:14:35
f29e48995e1af91127157a1eca4177c2f411b1bb...704b55cce33aa8665c558347c104041d3ec6e2f3,3,22,5,27,5,2014-03-20 19:24:11,2014-03-20 19:24:11
f29e48995e1af91127157a1eca4177c2f411b1bb...83504371127a1003c4060ef60e0ebf08423f1ade,2,104,10,114,6,2014-03-20 18:18:49,2014-03-19 21:27:23
83504371127a1003c4060ef60e0ebf08423f1ade...1c35165993c7aac42421354614e216ea8ad3f353,1,0,3,3,1,2014-03-20 18:18:50,2014-03-20 08:55:47
f29e48995e1af91127157a1eca4177c2f411b1bb...05d47768caf6fec51fa85cb6275c9ba8324aead6,13,640,280,920,65,2014-03-20 16:25:05,2014-03-11 06:30:41
05d47768caf6fec51fa85cb6275c9ba8324aead6...ccb308273a8662a9692849115a929bd1a74a15f7,5,204,157,361,6,2014-03-20 16:25:06,2014-03-12 00:19:35
ccb308273a8662a9692849115a929bd1a74a15f7...1c0b6a38bacb54de300d936338d4adb04a9b311f,4,73,189,262,61,2014-03-20 16:25:06,2014-03-12 00:58:10
1c0b6a38bacb54de300d936338d4adb04a9b311f...02105a27f01509ce4e641487cae040662ee477a2,11,75,116,191,61,2014-03-20 16:25:07,2014-03-12 01:40:38
02105a27f01509ce4e641487cae040662ee477a2...5aa2ac6de1622308884fd542f7b29e6810a0e98e,17,75,75,150,66,2014-03-20 16:25:08,2014-03-12 05:47:39
5aa2ac6de1622308884fd542f7b29e6810a0e98e...d9fdee6e4cb87e4531d9ddba92b44e5323e794da,11,39,239,278,99,2014-03-20 16:25:09,2014-03-12 16:43:53
d9fdee6e4cb87e4531d9ddba92b44e5323e794da...97f3462ae699fae370cfa410ed58eb869ae6b276,3,41,37,78,30,2014-03-20 16:25:10,2014-03-18 20:14:09
97f3462ae699fae370cfa410ed58eb869ae6b276...ac584fcfd3e15b0a0200ee609bf964414936c710,3,52,14,66,12,2014-03-20 16:25:11,2014-03-18 23:04:51
ac584fcfd3e15b0a0200ee609bf964414936c710...58c2b1c4218a2f90ee2745687f2e17670bde0b1b,3,5,4,9,3,2014-03-20 16:35:22,2014-03-20 16:35:22
2450d4c63a58958100d1be0e5082efa930e09650...f28e4c97b38c1ec60dc6ce6e5306067ad24aeb8e,1,0,1,1,1,2014-04-01 18:18:36,2014-04-01 18:17:49
2450d4c63a58958100d1be0e5082efa930e09650...18234b14ad55157581ca26ec763afc1af3ec6e76,5,95,5,100,9,2014-04-01 16:45:20,2014-02-21 17:14:16
18234b14ad55157581ca26ec763afc1af3ec6e76...8286300a1e2d24dfe184316c0f9798f2c69d0ef4,4,149,113,262,30,2014-04-01 16:45:20,2013-12-18 19:48:57
8286300a1e2d24dfe184316c0f9798f2c69d0ef4...e402d2f134ff6ac76726bedd37ac4f1c0aa5e9ab,2,49,47,96,18,2014-04-01 16:45:20,2014-03-24 18:25:59
e402d2f134ff6ac76726bedd37ac4f1c0aa5e9ab...d543d59cf0d90264aa84ac49b7f21c6a603d5d3a,1,50,9,59,10,2014-04-01 16:45:20,2014-03-28 17:42:38
d543d59cf0d90264aa84ac49b7f21c6a603d5d3a...69b6ffc4c53d578800274993b5222fa5a7699f21,4,243,142,385,106,2014-04-01 16:48:37,2014-03-28 21:02:21
69b6ffc4c53d578800274993b5222fa5a7699f21...db0e7878d386e40080d4004e483e4845b15f8bd7,5,115,64,179,34,2014-04-01 16:48:37,2014-03-28 23:50:49
db0e7878d386e40080d4004e483e4845b15f8bd7...a4ccd2b00199306889585b23845368455ff348f4,1,37,20,57,23,2014-04-01 16:49:58,2014-03-29 22:23:01
a4ccd2b00199306889585b23845368455ff348f4...eeeb9654f064e1047ef8f3cb5a38636133426cdd,1,111,123,234,28,2014-04-01 16:49:58,2014-03-30 22:35:56
eeeb9654f064e1047ef8f3cb5a38636133426cdd...aa78c9ba778d8c7c2c62f875b974ae53ba90d12b,2,45,15,60,11,2014-04-01 17:22:51,2014-04-01 17:22:51
aa78c9ba778d8c7c2c62f875b974ae53ba90d12b...4ece3e225b566816598238902667552dee4c7deb,2,107,10,117,8,2014-04-01 19:19:11,2014-04-01 19:19:11
4ece3e225b566816598238902667552dee4c7deb...8061d519b33c95a8858752e7d70d40fe8bae90f9,3,55,34,89,20,2014-04-01 20:24:06,2014-04-01 20:24:06
8061d519b33c95a8858752e7d70d40fe8bae90f9...8f4e5275e4f7f287b6782e70ff96c5de8fa4059e,4,132,14,146,18,2014-04-01 23:46:25,2014-04-01 23:46:25
8f4e5275e4f7f287b6782e70ff96c5de8fa4059e...12d4ed4de34e312cb491ce1b5562d84846aeb456,1,24,0,24,2,2014-04-03 17:00:36,2014-03-08 22:04:56
12d4ed4de34e312cb491ce1b5562d84846aeb456...f2fb4bac68e7ab38cf6082655b2da153866a012d,3,198,126,324,23,2014-04-03 17:44:08,2014-04-02 21:55:21
f2fb4bac68e7ab38cf6082655b2da153866a012d...18cc7d28c4c5ad4c9ecf7bfeab98a035500fd9d7,2,79,108,187,32,2014-04-03 18:29:08,2014-04-03 18:29:08
18cc7d28c4c5ad4c9ecf7bfeab98a035500fd9d7...eedeeb9e8f708e9f60568adc4a63307754a603f5,2,38,11,49,5,2014-04-03 18:58:51,2014-04-03 18:58:51
36a80fdaedc4724b20fe3ee1b3c87ae4daf23ab1...31a14982a099461a9d8a44ea773b1fef69a781a6,1,1,1,2,1,2014-03-21 09:36:34,2014-03-21 09:36:34
85a41fc4bf148dc954fa8124b61355ee648c40ba...fdc54eb2fb4cf9759552eb3be137100627e0585b,1,1,1,2,1,2014-03-24 17:56:11,2014-03-24 17:56:11
f28e4c97b38c1ec60dc6ce6e5306067ad24aeb8e...d1a0900442a235d8389d968a70b196a1b0f1ab7b,1,11,2,13,2,2014-04-02 04:58:48,2014-04-02 04:58:48
d1a0900442a235d8389d968a70b196a1b0f1ab7b...ada157b2375bea8ed0c7a71320a3325a9903ebd7,1,7,12,19,1,2014-04-02 14:45:16,2014-04-02 14:45:16
ada157b2375bea8ed0c7a71320a3325a9903ebd7...0f65733b0855ff9ea838c7d06efdf544e039e05e,6,89,73,162,27,2014-04-02 16:50:47,2014-04-02 16:50:47
f28e4c97b38c1ec60dc6ce6e5306067ad24aeb8e...ea1ca3c9216ad72b24a198cfdf4c4eb0d037462f,1,3,1,4,2,2014-04-02 04:30:52,2014-04-02 04:30:52
ea1ca3c9216ad72b24a198cfdf4c4eb0d037462f...a574d584df61f56715281feb6fcf3b7578ead0c6,2,183,24,207,14,2014-04-02 04:32:06,2014-04-02 04:32:06
f28e4c97b38c1ec60dc6ce6e5306067ad24aeb8e...bb439de039dac456d4d99eb0a03d1914a984b27f,1,1,1,2,1,2014-04-01 20:37:19,2014-04-01 20:37:19
bb439de039dac456d4d99eb0a03d1914a984b27f...ddc66e27b605cdfd0edf25af5cf7fb4924fb80e1,1,2,2,4,1,2014-04-02 12:02:43,2014-04-02 12:02:43
923c84008d6e3a4bf36ce08f9145a11b90f27185...2b6b85f1168206f6f53144b9c98ecc4ce2e74a88,2,21,3,24,5,2014-04-05 00:02:12,2014-04-05 00:02:12
2b6b85f1168206f6f53144b9c98ecc4ce2e74a88...c8c91433a8c3c144273d4b362590ebc8761c0523,2,54,6,60,8,2014-04-06 17:42:26,2014-04-06 17:42:26
c8c91433a8c3c144273d4b362590ebc8761c0523...c7d9606066d3a9b75a87c4ca5dd3420a66d0b54f,1,3,1,4,1,2014-04-06 18:20:22,2014-04-06 18:20:22
0deb534d765cf545f7cd65b9f5e79d344b6fbec0...42dee8ecd78a10c91056ac80fdf0c67a4df57337,3,24,15,39,13,2014-03-24 12:21:51,2014-03-23 12:34:33
42dee8ecd78a10c91056ac80fdf0c67a4df57337...6057c4a038d575ff02cdfce8ad93dfb541e90b2d,1,1,1,2,1,2014-03-24 12:21:51,2014-03-23 14:48:13
f210cb5b1442f82e2f930909d8430f7cc6661c5f...d3bc95fd664095a0c8dfcdf99f62741b1ecd6ffc,6,82,23,105,19,2014-03-25 19:37:05,2014-03-25 19:37:05
f210cb5b1442f82e2f930909d8430f7cc6661c5f...a15c7802c86cf995fa658ef0624c46d352ce9a81,15,356,334,690,158,2014-03-25 16:14:48,2014-03-25 16:14:48
a15c7802c86cf995fa658ef0624c46d352ce9a81...591e82952a2835c3d411ee5abec78be3b0816861,4,105,30,135,27,2014-03-25 23:52:01,2014-03-25 23:52:01
bb63baea5f42415c1d9e115ddca4197cdbe040a6...49653665d11cbb5d14d5ad19c327798c98b0cfd1,1,1,1,2,1,2014-04-02 16:21:41,2014-04-02 16:21:41
6720eef938d7614cd7a9fd2138a27da3667d62cf...56f8e06e4985f7b14c1bf7c526a5195ba24fd6ee,1,1,1,2,1,2014-04-08 14:30:26,2014-04-08 13:46:45
56f8e06e4985f7b14c1bf7c526a5195ba24fd6ee...8a8e312792807dda38fbe417ec5d511f767f3ace,1,8,0,8,1,2014-04-08 14:32:06,2014-04-08 14:20:49
6720eef938d7614cd7a9fd2138a27da3667d62cf...c813b345503f7b086da7ca1b2d95270e00594323,2,13,1,14,4,2014-04-07 18:45:32,2014-04-07 18:45:32
c813b345503f7b086da7ca1b2d95270e00594323...7167fd7ef80f5f34337dd1c696f77ea2bb4d8bd8,1,1,1,2,1,2014-04-07 18:51:12,2014-04-07 18:51:12
6720eef938d7614cd7a9fd2138a27da3667d62cf...553184a76245617556373af4cb5343e7fe58f41f,1,1,0,1,1,2014-04-07 18:18:17,2014-04-03 08:53:42
553184a76245617556373af4cb5343e7fe58f41f...399f2b6294963b8a7a154ffd0103484d018c4e27,2,43,0,43,2,2014-04-14 14:16:21,2014-04-07 18:15:45
399f2b6294963b8a7a154ffd0103484d018c4e27...4d7b993904008001ad995d6b27af0e8c71277c55,4,320,0,320,4,2014-04-14 14:16:21,2014-04-01 20:18:19
4d7b993904008001ad995d6b27af0e8c71277c55...103b7d21226e43192cf138ecf0b98b51796ae0ed,92,631,0,631,31,2014-04-14 14:16:22,2014-04-02 11:57:11
103b7d21226e43192cf138ecf0b98b51796ae0ed...6fefb7af84170fb67a7e6c8493fc00421787bb87,4,24,2,26,8,2014-04-14 14:16:22,2014-04-13 17:53:35
6720eef938d7614cd7a9fd2138a27da3667d62cf...c031129510a4bfaef9b2563de3a8ae82d04f5b6c,2,24,1,25,11,2014-04-07 15:35:28,2014-04-07 15:32:23
c031129510a4bfaef9b2563de3a8ae82d04f5b6c...c3dcbe8488c6240392e8a5d7553bbffcb0f94ef0,1,20,14,34,7,2014-04-09 10:43:27,2014-04-09 10:43:27
f57cc63811db2717e9ba42e720a75f71557f9451...892aa808e2e879562c45f3d0886668f86265f1cf,3,56,0,56,4,2014-03-24 18:20:03,2014-03-10 19:00:33
892aa808e2e879562c45f3d0886668f86265f1cf...3a666071d92562d028e2fba3ff12c49f3155c7f2,2,201,2,203,3,2014-03-24 18:20:13,2014-03-10 22:38:01
3a666071d92562d028e2fba3ff12c49f3155c7f2...46e4d82d6f3e1630cacbd89af39ef3d2e9f20d09,1,0,5,5,1,2014-03-24 18:20:22,2014-03-10 23:21:56
46e4d82d6f3e1630cacbd89af39ef3d2e9f20d09...7ca1584b4771703bd9f9c3ad4335f6155b05450a,4,5,8,13,9,2014-03-24 18:20:31,2014-03-11 18:49:19
7ca1584b4771703bd9f9c3ad4335f6155b05450a...169fb81d8780532ffe575b5dfbf29a1027dfe25d,2,1,2,3,2,2014-03-24 18:20:41,2014-03-11 18:56:26
169fb81d8780532ffe575b5dfbf29a1027dfe25d...892b7c9fef3aa48574b784e48a8747e77e83865b,1,13,13,26,2,2014-03-24 18:20:51,2014-03-11 19:13:29
892b7c9fef3aa48574b784e48a8747e77e83865b...34ffe22344d32d1574dc33d3c3d20556fdb152a7,1,2,2,4,2,2014-03-24 18:21:01,2014-03-24 18:02:02
77b699e0da3d4a4fed742893bd172f3ee7b936d5...fd536d29c127648abb2ce5f6f619135ce69b9800,7,22,22,44,21,2014-04-01 11:38:04,2014-03-26 10:15:57
77b699e0da3d4a4fed742893bd172f3ee7b936d5...6105d597072cea0d1a89ee184826c2c98bf5d772,3,278,0,278,3,2014-03-26 17:17:08,2014-03-26 17:17:08
451aaf866af2d974380a2d141626f450212f40f2...f2f2d97f1e5264c061177a1c64fa6b3420a95188,1,24,0,24,1,2014-03-26 04:54:41,2014-03-25 00:48:54
f2f2d97f1e5264c061177a1c64fa6b3420a95188...1df8ad01d746ef56c563f82a4f4037957ddc19d8,1,5,0,5,2,2014-03-26 04:54:42,2014-03-07 00:00:52
dc7efa1aef2d3694e7a1955d746d26013402a21d...2b848e47c1491fe0b6e987400b1a466c0f18861a,1,9,0,9,3,2014-03-26 17:33:37,2014-03-26 17:33:37
2b848e47c1491fe0b6e987400b1a466c0f18861a...9cb99e8b853bb3d9ddec3748494a0ac34550849b,1,1,2,3,2,2014-03-26 17:43:41,2014-03-26 17:43:41
fd61f05ea605155ed9e56bfad0e804c6718e0611...3b4ba2787049c561cd7a9e3fea8fc16e473a0b32,12,31,24,55,22,2014-04-03 14:06:31,2014-04-03 13:50:21
64a862c2b88e2c92157e9b5f257fa433612bd828...6f6be8fe4199b5bccad00a9a3ab8b078286c1837,3,70,1,71,3,2014-04-02 18:22:22,2014-04-02 16:14:02
6f6be8fe4199b5bccad00a9a3ab8b078286c1837...67d4997a7e3d95d8ebc9c13481b767efd1d5bb15,1,20,7,27,5,2014-04-02 18:22:22,2014-04-02 16:44:01
2795fb4ddd69ca72828c2d4f1b94b77e4d91db48...ce2e82694a19b9994acaa9376bff81bc8e968637,1,6,1,7,1,2014-04-08 14:52:20,2014-04-08 14:52:20
5f74c476939894c4512262ec11188a44bfe4f50a...855c66de66fe39fe219c6dab9d614c6e9d633d9c,4,116,3,119,10,2014-04-08 04:09:09,2014-03-27 23:34:20
855c66de66fe39fe219c6dab9d614c6e9d633d9c...7be1caf7f54bff938c71a616f38e9ac375a0b137,1,9,24,33,4,2014-04-08 04:41:36,2014-04-08 04:41:36
bcc622934a90307390f058c7ef4203f8bbcfe0d6...efaa342cbb62069510a3787da433e6b5b935fcde,2,5,3,8,6,2014-04-11 20:48:42,2014-04-11 20:07:49
bcc622934a90307390f058c7ef4203f8bbcfe0d6...b3b36a68d16f1fdc383a06fbe85c3cc042d86314,2,10,0,10,2,2014-04-10 16:24:16,2014-04-10 10:43:16
b3b36a68d16f1fdc383a06fbe85c3cc042d86314...8e14b47fd788ce5ae0d1a003a8fba17753eb7db5,2,40,0,40,3,2014-04-11 19:55:35,2014-04-10 10:42:29
8e14b47fd788ce5ae0d1a003a8fba17753eb7db5...51297cadb32df3f7e1b1820034ff5a4ed6703668,1,40,0,40,1,2014-04-11 19:55:36,2014-04-10 10:44:12
51297cadb32df3f7e1b1820034ff5a4ed6703668...7a28f268adc1d2569ce504147af05834ae94c01a,2,6,6,12,6,2014-04-11 19:55:36,2014-04-10 10:44:51
7a28f268adc1d2569ce504147af05834ae94c01a...cab39378dc4dba7cc501255f066808c713dd11ef,89,72,0,72,26,2014-04-15 15:22:03,2014-04-11 17:14:18
cab39378dc4dba7cc501255f066808c713dd11ef...360314c9dbb383b3737876a9c229e22050ec9c49,3,856,0,856,3,2014-04-15 15:22:12,2014-04-11 17:03:29
360314c9dbb383b3737876a9c229e22050ec9c49...d8cc1fb653387d9acc28b075147084cf452c43dc,4,740,0,740,5,2014-04-15 15:22:17,2014-04-11 17:15:15
d8cc1fb653387d9acc28b075147084cf452c43dc...a56b418d8541e04f02be1227772b13762bfebaed,2,87,1,88,5,2014-04-15 15:22:17,2014-04-11 20:57:15
a56b418d8541e04f02be1227772b13762bfebaed...39206ca256409edb7102edf0d30a6ced2e5f16e3,1,43,0,43,1,2014-04-15 15:22:17,2014-04-14 15:12:56
f4afcaa0d50bece4a784ce680d92e5c0d1c67785...22df47cbc52107db25368cf0a09d63cc8dddafdb,3,101,5,106,5,2014-03-26 21:38:26,2014-03-26 21:38:26
22df47cbc52107db25368cf0a09d63cc8dddafdb...380f864a10aeadd30bd88138906d4fab577221de,2,38,2,40,3,2014-03-26 23:06:21,2014-03-26 23:06:21
4c219cf64868d1b3fc2c5df0bbf803b40c6e4cef...4998009a28929affb3f22274b1024bc5a8cdbfb6,1,4,2,6,1,2014-04-06 13:16:44,2014-04-06 13:06:46
ce2e82694a19b9994acaa9376bff81bc8e968637...8f7bc6461b81499216b73881b07f5476c5085660,3,92,31,123,19,2014-04-10 23:33:39,2014-04-10 23:33:39
ce2e82694a19b9994acaa9376bff81bc8e968637...76b4e3d4deef499654ccf082e6ee585f4db873ec,1,5,7,12,2,2014-04-08 22:46:56,2014-04-08 22:41:39
76b4e3d4deef499654ccf082e6ee585f4db873ec...9ce60fadda2a333756523299bff7772d05e69457,1,2,2,4,2,2014-04-08 22:46:56,2014-04-08 22:40:05
ce2e82694a19b9994acaa9376bff81bc8e968637...eb7e17cc900f1f59f653cd7b277750fb1d5b721a,2,101,4,105,4,2014-04-08 21:47:20,2014-04-08 21:47:20
37ab5ecc107118d5fa541cb42cc203649e549fd8...fa13ee2d7cfadf0b1d425708657d93aeae728f46,3,4,3,7,4,2014-04-16 16:51:16,2014-04-16 14:59:43
289e31cd24f80fa8ed77e40eeb9295964256cb6a...a9528b8fdd627e11b9dee099a10fa7697380b3e7,6,101,30,131,18,2014-04-14 22:59:48,2014-04-14 22:59:48
c5cacc4ec2c13e93164b8e3013b0d18c8c6d820c...2bed3553f4595a42d9a6884edc66b991e21f881e,1,1,1,2,1,2014-04-17 22:34:04,2014-04-17 22:34:04
c5cacc4ec2c13e93164b8e3013b0d18c8c6d820c...c67fd4c9d5e1ff715df28b884d7f7f9f20fad1ec,7,52,33,85,28,2014-04-17 21:43:45,2014-02-07 19:20:36
c67fd4c9d5e1ff715df28b884d7f7f9f20fad1ec...3dbee456564a9baf24631bfe219f81434d8fdfa6,5,219,176,395,91,2014-04-17 21:43:45,2014-02-07 22:10:35
3dbee456564a9baf24631bfe219f81434d8fdfa6...27e54bcf82fe27bdfadbaa9c5383ee8a948ea33c,3,96,24,120,10,2014-04-17 21:43:45,2014-02-07 22:17:19
27e54bcf82fe27bdfadbaa9c5383ee8a948ea33c...54edbb9871ad543baefc62310512719fc70539be,3,67,22,89,21,2014-04-17 21:43:45,2014-02-08 00:48:27
54edbb9871ad543baefc62310512719fc70539be...dac160489bbf8de90d2f1ae152df68ded2603598,2,169,63,232,49,2014-04-17 21:43:45,2014-02-09 00:42:26
dac160489bbf8de90d2f1ae152df68ded2603598...3b4c401a38ce912d5be8c9bf4ab1c4912a4f08bd,9,142,107,249,43,2014-04-17 21:43:45,2014-02-10 21:20:08
3b4c401a38ce912d5be8c9bf4ab1c4912a4f08bd...40ed499039f887ebcb0b5badf0157519148398b8,13,361,140,501,65,2014-04-17 21:43:45,2014-02-11 22:45:37
40ed499039f887ebcb0b5badf0157519148398b8...8a2834d34173220c56bd1898397c0e6d200f327d,6,309,202,511,125,2014-04-17 21:43:45,2014-03-14 20:20:51
8a2834d34173220c56bd1898397c0e6d200f327d...52bb0476a8ad462c56b1d2c68b6d5f20f947ee50,5,63,54,117,32,2014-04-17 21:43:46,2014-03-14 20:53:15
52bb0476a8ad462c56b1d2c68b6d5f20f947ee50...3816debc13e8d5b96ad40be95a09fe67f6fa5a96,2,12,11,23,11,2014-04-17 21:43:46,2014-03-14 21:51:04
3816debc13e8d5b96ad40be95a09fe67f6fa5a96...b87776151ad40caaec8bfe1becec4db429c9ea96,1,15,1,16,3,2014-04-17 21:43:46,2014-03-14 22:37:42
b87776151ad40caaec8bfe1becec4db429c9ea96...cef170abf2704a3e3aa109020f7041e43b5e4f71,1,3,0,3,2,2014-04-17 21:43:46,2014-03-14 23:45:46
cef170abf2704a3e3aa109020f7041e43b5e4f71...aba6b5edbd1d1f999086669eb8e2f553af0ac300,2,22,29,51,16,2014-04-17 21:43:46,2014-03-15 04:59:26
aba6b5edbd1d1f999086669eb8e2f553af0ac300...1fa17b5c92cb92a2785fba403b87525169b205c0,2,11,17,28,9,2014-04-17 21:43:46,2014-03-15 05:01:30
1fa17b5c92cb92a2785fba403b87525169b205c0...7d4908724fd7d4d8e096b4faf2c652ba5b77644e,18,940,756,1696,133,2014-04-17 21:56:41,2014-04-11 05:31:01
7d4908724fd7d4d8e096b4faf2c652ba5b77644e...2e9d813bd69ab014b970a75b5a4f7d24f241cc05,4,109,57,166,31,2014-04-17 21:56:41,2014-04-11 19:12:47
2e9d813bd69ab014b970a75b5a4f7d24f241cc05...ea642d61f9b3dd3d9e1670621198483541cf4f0d,2,40,22,62,22,2014-04-17 21:56:41,2014-04-14 19:29:27
ea642d61f9b3dd3d9e1670621198483541cf4f0d...e6e8530aa6c8773dd523fd6fe07629b9481a8fee,3,49,17,66,21,2014-04-17 21:56:41,2014-04-14 19:31:17
e6e8530aa6c8773dd523fd6fe07629b9481a8fee...823c0e9cc142529912976f2e6abff3db456cb204,13,265,210,475,120,2014-04-17 22:04:41,2014-04-17 18:53:13
823c0e9cc142529912976f2e6abff3db456cb204...8303827226db114a1157e6173e731f316c217851,4,38,30,68,17,2014-04-17 22:04:42,2014-04-17 21:35:29
041fad4aac106650f00b7c445675f1c4bb8cfd53...add8db06f91f1dc9acc7f20f8229f746041de2c8,1,6,3,9,2,2014-03-27 22:28:29,2014-03-27 22:28:29
add8db06f91f1dc9acc7f20f8229f746041de2c8...acdc7cff2e31223aa91d9421b9b4edc53ca87869,1,1,0,1,1,2014-03-27 22:29:17,2014-03-27 22:29:17
acdc7cff2e31223aa91d9421b9b4edc53ca87869...dae8ba6e0968d3ace5ac3c2878fb2072f1db43ba,1,5,2,7,2,2014-03-27 22:29:32,2014-03-27 22:29:32
041fad4aac106650f00b7c445675f1c4bb8cfd53...2873a862fd1899909424b60b44fa0680851a60f6,1,22,1,23,2,2014-03-27 11:42:44,2014-03-27 11:42:44
28fd7206b1359b6564bad3c66382b47a8f2e3eb1...bd270b70f9f1339ac26bbf6e483b3ebf64814d50,2,14,50,64,14,2014-04-18 15:33:26,2014-04-18 15:08:10
28fd7206b1359b6564bad3c66382b47a8f2e3eb1...36913b8cb497487728ee9bab383d4c1205685927,1,27,0,27,1,2014-04-18 13:55:25,2014-03-06 14:11:11
36913b8cb497487728ee9bab383d4c1205685927...55ebd7d369a789f27fe1ad6b8ec8965aa1335d08,5,379,67,446,52,2014-04-18 14:03:01,2014-03-13 16:11:34
55ebd7d369a789f27fe1ad6b8ec8965aa1335d08...29c4cb0965b67ad1ae7f640dfee67cf3ce358c26,6,49,28,77,31,2014-04-18 14:03:01,2014-03-15 02:53:36
29c4cb0965b67ad1ae7f640dfee67cf3ce358c26...c047317e400efc75b07aa0fff61ee1fcd794e74e,1,16,23,39,17,2014-04-18 14:06:04,2014-03-18 16:54:32
c047317e400efc75b07aa0fff61ee1fcd794e74e...bd95f836f51804011b8a8c532471733f92f3e119,1,25,14,39,3,2014-04-18 14:07:32,2014-03-31 06:08:17
bd95f836f51804011b8a8c532471733f92f3e119...0500a1ef4e61449a7ad375c1f42d3bd25a4e36bd,1,17,3,20,6,2014-04-18 14:07:32,2014-03-31 06:32:45
0500a1ef4e61449a7ad375c1f42d3bd25a4e36bd...eaf3703401a64d59fd8bf2609449343d739ef056,2,18,83,101,17,2014-04-18 14:07:33,2014-03-31 06:53:56
eaf3703401a64d59fd8bf2609449343d739ef056...523032cd24e5b238752394bd1b691a3e28ba321e,4,16,15,31,9,2014-04-18 14:07:33,2014-03-31 07:58:44
523032cd24e5b238752394bd1b691a3e28ba321e...c20d71eac928fef34a89ced3cbb6502ab2763dc9,1,14,1,15,5,2014-04-18 14:07:33,2014-03-31 08:13:40
c20d71eac928fef34a89ced3cbb6502ab2763dc9...8c1f4ab4abdb47c7926fa678577973272be6e2df,2,15,54,69,17,2014-04-18 14:07:33,2014-04-09 10:26:53
8c1f4ab4abdb47c7926fa678577973272be6e2df...4b99b8f52844cb66b2b61b9e88b37b5f98515d50,1,131,43,174,47,2014-04-18 14:12:31,2014-04-09 11:08:01
4b99b8f52844cb66b2b61b9e88b37b5f98515d50...2280b388c913cbc4eee35ce99c760316206e2703,1,2,54,56,5,2014-04-18 14:13:43,2014-04-09 11:17:51
2280b388c913cbc4eee35ce99c760316206e2703...ac99d86ba5e2a9d2332b7f82737e1231c621dc43,7,34,30,64,15,2014-05-07 09:34:32,2014-05-07 09:34:32
04d4d674fe0ccd6cc29f30359b8306c5b3feae3d...10be94e9dc79b79842587dc4ef395d2033c9aae4,3,35,3,38,8,2014-03-28 17:39:07,2014-03-28 17:09:13
10be94e9dc79b79842587dc4ef395d2033c9aae4...e0d61c7b1caa011ab6a7777535823fe18c50e13c,1,10,1,11,4,2014-03-28 17:39:15,2014-03-28 17:10:59
bfc50f83f829afe52c10f615c4f7efa478a83098...a15d3537bb52450f75ad63642b6bcbbcc6fdc374,1,1,1,2,1,2014-04-21 13:48:05,2014-04-21 13:48:05
a15d3537bb52450f75ad63642b6bcbbcc6fdc374...783993101949040865ea933eb73e35df806249b0,1,1,1,2,2,2014-04-21 14:38:52,2014-04-21 14:38:52
bfc50f83f829afe52c10f615c4f7efa478a83098...9effa2fb72f20332c2c8a83540bb224a32e0265b,2,37,37,74,14,2014-04-20 20:06:45,2014-04-20 17:19:13
9effa2fb72f20332c2c8a83540bb224a32e0265b...4f62163ead2bde1af3cd7d0c0b8990e1831d3ffd,2,10,7,17,3,2014-04-21 08:24:16,2014-04-20 20:06:05
4f62163ead2bde1af3cd7d0c0b8990e1831d3ffd...98020d3a73743d79c6acd380339b1d743205a86b,3,5,5,10,5,2014-04-21 08:55:37,2014-04-21 08:55:37
98020d3a73743d79c6acd380339b1d743205a86b...48e60ae75e78bc58aeb3c7ecf6be4653152182f4,16,21,21,42,21,2014-04-21 09:28:49,2014-04-21 09:23:29
48e60ae75e78bc58aeb3c7ecf6be4653152182f4...be6996b792cea7a7371e07fb4efc86e5216f4f40,1,1,3,4,1,2014-04-21 14:29:41,2014-04-21 13:25:02
be6996b792cea7a7371e07fb4efc86e5216f4f40...8b686b318b60e39ef36aae14311c07e5b72a5a5a,1,1,1,2,1,2014-04-21 14:29:41,2014-04-21 13:25:19
8b686b318b60e39ef36aae14311c07e5b72a5a5a...321d377a6ad3528f38ab99dacf22a51f721fa57b,1,29,17,46,6,2014-04-21 15:28:03,2014-04-21 15:02:05
321d377a6ad3528f38ab99dacf22a51f721fa57b...f70cfd34f5c20c447feb19c2e616315764ea7260,1,83,35,118,36,2014-04-21 17:38:34,2014-04-21 15:49:38
bfc50f83f829afe52c10f615c4f7efa478a83098...c2c8161541e54689926ec1f463569d5d1b975503,18,659,431,1090,148,2014-04-20 01:50:44,2014-04-19 22:05:31
c2c8161541e54689926ec1f463569d5d1b975503...65477db1660273c453c590b8e3b97a4f7c41df61,7,968,134,1102,41,2014-04-22 04:28:27,2014-04-22 03:32:31
65477db1660273c453c590b8e3b97a4f7c41df61...7110000dd5b82c86863633ee37f72ac876a44476,9,35,39,74,30,2014-04-23 13:23:50,2014-04-22 14:21:19
3c69bebc1c18444e9358c33f56c7cfefea4d1a8f...6a0956e504328f6584af971e840c202ecb21b5b6,5,80,35,115,21,2014-04-18 17:32:35,2014-04-18 17:32:35
6a0956e504328f6584af971e840c202ecb21b5b6...50e46d6018ede64e3e4b177baa4ad8156d928fbd,2,83,154,237,36,2014-04-18 17:58:01,2014-04-18 17:58:01
50e46d6018ede64e3e4b177baa4ad8156d928fbd...e3a2a04ceff1d3657629fd6a7245d9a9fc53f24b,3,135,44,179,9,2014-04-18 21:29:58,2014-04-18 21:29:58
e3a2a04ceff1d3657629fd6a7245d9a9fc53f24b...916fcbd61754f74b350ca689e27563cdbded2d30,3,28,0,28,4,2014-04-18 21:42:40,2014-04-18 21:42:40
916fcbd61754f74b350ca689e27563cdbded2d30...ac16bd0a94e1f7254112c7585b843bdc2d0659c1,4,8,5,13,5,2014-04-18 22:45:59,2014-04-18 22:45:59
3c69bebc1c18444e9358c33f56c7cfefea4d1a8f...48ce93e08fb48cafdd86f626c6a1d4a728942cc8,1,3,3,6,3,2014-04-18 17:09:47,2014-04-18 16:58:57
48ce93e08fb48cafdd86f626c6a1d4a728942cc8...c6cd3f8bde4aeaad60139dd41a3ed5542dd2ab4f,1,42,8,50,6,2014-04-18 17:09:47,2014-04-18 16:32:06
c6cd3f8bde4aeaad60139dd41a3ed5542dd2ab4f...364ef52881f98293a5e454aab447bc7c2a3d3725,1,5,3,8,1,2014-04-18 17:13:18,2014-04-18 17:13:18
364ef52881f98293a5e454aab447bc7c2a3d3725...5c8d5eac35794391c935e273612744a0684beb29,2,25,38,63,5,2014-04-19 21:07:50,2014-04-19 21:07:50
3c69bebc1c18444e9358c33f56c7cfefea4d1a8f...478408c01006f39ab916675bc84b8a7340bae086,3,88,0,88,9,2014-04-18 15:58:25,2014-04-17 21:03:44
478408c01006f39ab916675bc84b8a7340bae086...8ec0a5527333afeca3f4ff3bf36fb8e1ac1c5939,3,8,8,16,6,2014-04-18 15:58:25,2014-04-17 22:49:07
8ec0a5527333afeca3f4ff3bf36fb8e1ac1c5939...043112dc1c87433f92e1ea3b3ab76efe62edc448,1,2,2,4,2,2014-04-18 15:58:25,2014-04-18 15:57:39
043112dc1c87433f92e1ea3b3ab76efe62edc448...a622ff17a1d4c70686959eefd03214898794c792,1,21,7,28,6,2014-04-18 18:09:58,2014-04-18 18:05:28
71ba28e3a55511eaac3b2924d8de147bdce60683...ed38bff16cb7a948d8059d8658d4fbf0b227f895,1,8,2,10,3,2014-03-29 02:15:55,2014-03-29 00:54:43
28750a7d98ce5e23bac5c1d119109ded8e8aab73...e349ed500b75349b1a525fce60dc08c8d8927ba0,7,452,6,458,14,2014-04-23 00:08:21,2014-04-22 18:58:33
28750a7d98ce5e23bac5c1d119109ded8e8aab73...17ef678ca543d8b56035e36039ee319c12d0d249,4,16,18,34,6,2014-04-21 18:55:57,2014-04-21 18:55:57
28750a7d98ce5e23bac5c1d119109ded8e8aab73...bd101a7eca6907ab1dd57ae693059466df0da124,2,45,5,50,8,2014-04-21 18:54:54,2014-04-21 18:54:54
8443ed6c1d1237e203474a772fb4281c382df6ac...424222f4157b050fd6417b8805796f7183a38e03,1,3,2,5,3,2014-04-25 13:49:26,2014-04-25 13:49:26
424222f4157b050fd6417b8805796f7183a38e03...7b8d564d5da4745e9227676a8768b3b48ca3dff8,1,3,6,9,4,2014-04-25 13:49:58,2014-04-25 13:49:58
7bcced44b7e5536ab1a92ad37735566e855531d0...b1914c36511af468366482c4dc8974bd1c2995fc,4,14,12,26,8,2014-05-12 17:24:46,2014-05-12 17:24:46
b1914c36511af468366482c4dc8974bd1c2995fc...ce3b71d91b9cac3b462dec9ac2c7e397b55c00a6,2,6,0,6,2,2014-05-12 17:28:45,2014-05-12 17:28:45
7b445c2195f1fff455d13218851fc683f5dd4058...976634c4672f3e1144b8f11c6c984157a28f5d98,3,44,0,44,3,2014-03-31 16:43:38,2014-03-31 02:56:18
7b445c2195f1fff455d13218851fc683f5dd4058...31143b365550e16fae8e092ad35bc91eb63c66eb,1,2,1,3,2,2014-03-30 17:08:56,2014-03-30 16:08:32
212b6205d70ff7c0f0f0b1eda6ac964c8d09d431...bdc82e1c00776229b19688abaf08d6701f2dc41f,3,13,1,14,3,2014-04-24 12:08:29,2014-04-24 12:08:29
212b6205d70ff7c0f0f0b1eda6ac964c8d09d431...26564d80aa7b340f07e9c5b96457928ebadcc606,2,18,1,19,2,2014-04-23 23:42:50,2014-04-23 23:26:58
26564d80aa7b340f07e9c5b96457928ebadcc606...a4e2c36a66eca49ae4d7bdf0fdba8d4b3c900ab9,3,14,15,29,12,2014-04-23 23:43:35,2014-04-23 23:40:21
dac95e4aa33a21c2180566558726e1a3d5c0399a...2efd7df6b11e8c646d05870965bb4588d6b6d425,2,18,0,18,2,2014-04-22 12:32:19,2014-04-19 13:34:12
2efd7df6b11e8c646d05870965bb4588d6b6d425...bc0a61986745b89258a98773f88bd98c44ef88d5,3,58,32,90,11,2014-04-22 12:34:26,2014-04-19 13:52:58
e79a2998cbff456264ed24e6dd46e07143567fe9...4f9d54146d569fffb679386fd3057e571afacd1f,1,1,1,2,1,2014-04-26 12:29:18,2014-04-26 12:29:18
336e89572192b75b803970f316417d5f5309ee7b...7f930ded88b2adda94423a618e268700494dc5c0,2,4,4,8,4,2014-03-31 18:08:31,2014-03-31 16:38:06
87c9b741dfc5be7edc43625c84720841b65cd14e...2334e3d8c33c639732e586ae8adfb65370523ab2,1,92,37,129,23,2014-04-24 21:46:59,2014-04-24 21:46:59
2334e3d8c33c639732e586ae8adfb65370523ab2...f608f3bb274dbf413127ba352f48021ed538139e,1,69,0,69,1,2014-04-24 22:25:01,2014-04-24 22:25:01
f608f3bb274dbf413127ba352f48021ed538139e...6b833e3a4a29d76e25120cf374838404a6b68825,2,32,4,36,11,2014-04-24 22:40:50,2014-04-24 22:40:50
a32d684f866e7710fd139d69ad5d1a8d0ae527c4...24d17de255caa57b01c0c758e6fc81aad493806e,4,38,12,50,8,2014-04-22 22:23:43,2014-04-02 19:07:27
24d17de255caa57b01c0c758e6fc81aad493806e...3c1aa4c110d2d4c8c3d941b0e4ba66357172da2e,1,13,0,13,1,2014-04-22 22:23:43,2014-04-22 22:23:39
3c1aa4c110d2d4c8c3d941b0e4ba66357172da2e...37da368545b28157e625212e8009ec041cc4a4ea,6,146,99,245,22,2014-04-23 04:51:54,2014-04-23 04:51:54
37da368545b28157e625212e8009ec041cc4a4ea...219c89d19d7e18a336faa094b0c29cb7bb0d22c6,4,39,22,61,14,2014-04-23 23:28:45,2014-04-23 23:28:45
219c89d19d7e18a336faa094b0c29cb7bb0d22c6...a409acefbbadeb607e4d6dde681bff5aed6ae9fc,1,9,8,17,4,2014-04-24 18:59:50,2014-04-24 18:59:50
a32d684f866e7710fd139d69ad5d1a8d0ae527c4...12e422a0562de2aebb05f5f414dbcde7caf85886,3,99,84,183,27,2014-04-22 16:17:29,2014-04-21 23:08:05
12e422a0562de2aebb05f5f414dbcde7caf85886...8d09efa24ee01e9e4b14672978bfd1bb1ca2436a,6,340,619,959,168,2014-04-22 19:33:27,2014-04-22 19:33:27
8d09efa24ee01e9e4b14672978bfd1bb1ca2436a...e60883c82f1c4d44be856e545b4cbeea27522416,1,23,11,34,10,2014-04-22 19:59:31,2014-04-22 19:59:31
4f9d54146d569fffb679386fd3057e571afacd1f...c7f86efb13815554d5b5e7c58bf19769e99c1357,1,1,1,2,1,2014-04-26 16:04:43,2014-04-26 16:04:43
c7f86efb13815554d5b5e7c58bf19769e99c1357...38d338b2b85f280fe54057375fc3ccd6d2877e26,1,1,0,1,1,2014-04-26 16:15:39,2014-04-26 16:15:39
4f9d54146d569fffb679386fd3057e571afacd1f...1f0d4f3d8dd5c87d3f42a913a1af9d6f1f2da437,3,30,4,34,6,2014-04-26 15:27:42,2014-04-26 11:51:14
1f0d4f3d8dd5c87d3f42a913a1af9d6f1f2da437...51d3f6f5f2f9dc6c9f9dd64d3ccbd0afdcf6fb6e,1,5,5,10,5,2014-04-26 15:27:43,2014-04-26 12:16:42
51d3f6f5f2f9dc6c9f9dd64d3ccbd0afdcf6fb6e...783555d8e11516fdc01b66da0f873f5854b9bff6,1,4,0,4,1,2014-04-26 15:27:43,2014-04-26 12:36:32
df3419269bb3a7dba18f1df8a31d7d79e0a20475...2b5a99d8ffbaf3e2a42ada38ce570ecbadba8818,1,38,0,38,1,2014-05-14 07:02:07,2014-05-14 07:02:07
2b5a99d8ffbaf3e2a42ada38ce570ecbadba8818...8d3a2d5fc58a08a22e355beaa0f9fc146facc3b3,1,5,10,15,4,2014-05-15 06:33:26,2014-05-15 06:33:26
8d3a2d5fc58a08a22e355beaa0f9fc146facc3b3...158c8ba1ee81fe20d3beb16650f30f3be02054f7,2,5,0,5,2,2014-05-15 06:54:46,2014-05-15 06:54:46
158c8ba1ee81fe20d3beb16650f30f3be02054f7...dc4906f12aedd608b01d04415fdca838eba045f6,2,6,4,10,5,2014-05-15 07:40:28,2014-05-15 07:40:28
dc4906f12aedd608b01d04415fdca838eba045f6...9055347944ff13fd5e91de0b29caeecb41c8bff4,2,5,8,13,5,2014-05-20 07:40:28,2014-05-20 07:40:28
9055347944ff13fd5e91de0b29caeecb41c8bff4...f47bc8ff5e844fec15e705e8ebd11bae742b8039,2,9,5,14,7,2014-05-20 08:16:04,2014-05-20 08:16:04
f47bc8ff5e844fec15e705e8ebd11bae742b8039...61bef72dc35c593e632dc2008c4eec271a264869,8,53,20,73,16,2014-05-20 13:57:40,2014-05-20 13:57:40
61bef72dc35c593e632dc2008c4eec271a264869...86c9d3dae2561405ec98506e6e72bf845c8315c1,4,25,19,44,9,2014-05-21 12:54:34,2014-05-21 12:54:34
86c9d3dae2561405ec98506e6e72bf845c8315c1...9067d5af4a05086761ea0df08e9ac825214f1bc4,1,1,1,2,1,2014-05-21 13:13:24,2014-05-21 13:13:24
9067d5af4a05086761ea0df08e9ac825214f1bc4...9532edc028bfd7056e693c1ba75e08ef96448248,1,4,6,10,4,2014-05-21 13:13:46,2014-05-21 13:13:46
9532edc028bfd7056e693c1ba75e08ef96448248...6580b11c2a6694d929271817005b23abb0551d43,1,0,1,1,1,2014-05-22 09:26:55,2014-05-22 09:26:55
6580b11c2a6694d929271817005b23abb0551d43...e8cc3032c1ef50cebd138705025bf292dd41a717,1,5,0,5,1,2014-05-22 09:43:58,2014-05-22 09:43:58
e8cc3032c1ef50cebd138705025bf292dd41a717...7c4bbbf46da0287fe77f517dbea54a5a9aefc599,1,1,1,2,2,2014-05-22 14:27:34,2014-05-22 14:27:34
7c4bbbf46da0287fe77f517dbea54a5a9aefc599...c4366096d440570c84754c8751583ddf4748b6b2,1,1,5,6,2,2014-05-22 14:28:12,2014-05-22 14:28:12
c4366096d440570c84754c8751583ddf4748b6b2...c3252c11bf3272d86e5a4bed3e32a9034c5d4aaa,1,2,2,4,2,2014-05-22 14:29:04,2014-05-22 14:29:04
c3252c11bf3272d86e5a4bed3e32a9034c5d4aaa...a777fc378583ca88f860c1d770bb959c25bec276,1,1,2,3,2,2014-05-30 23:21:13,2014-05-30 23:21:13
a777fc378583ca88f860c1d770bb959c25bec276...66271925a118040eac4d18230cfa88461c1e3788,2,3,0,3,2,2014-05-30 23:21:49,2014-05-30 23:21:49
66271925a118040eac4d18230cfa88461c1e3788...59fcebaa89d6ebdadf59c08c3bee030ce84765a1,1,3,0,3,1,2014-05-30 23:22:13,2014-05-30 23:22:13
59fcebaa89d6ebdadf59c08c3bee030ce84765a1...523553f902490935084ea39694c06738bfae4a3e,1,2,3,5,3,2014-05-30 23:22:26,2014-05-30 23:22:26
523553f902490935084ea39694c06738bfae4a3e...79d5b5c91683720c9055d1f5ea3f9468ca9356a4,2,52,17,69,4,2014-06-04 00:42:52,2014-06-04 00:42:52
79d5b5c91683720c9055d1f5ea3f9468ca9356a4...7b491a7deac7a97f440fb6d29f2f84d5ef797a42,2,6,1,7,2,2014-06-04 00:50:00,2014-06-04 00:50:00
7b491a7deac7a97f440fb6d29f2f84d5ef797a42...5e6542003e32ce59a8a586f00a7104aaef21fb00,1,4,1,5,1,2014-06-04 18:53:44,2014-06-04 18:53:44
5e6542003e32ce59a8a586f00a7104aaef21fb00...a576a34257a0aa952de228ef3c2b012c5742ac09,1,32,0,32,1,2014-06-04 21:47:44,2014-06-04 21:47:44
a576a34257a0aa952de228ef3c2b012c5742ac09...54c02d212d70b439f402c74c6b1f6c835daa43fc,1,1,0,1,1,2014-06-04 22:27:00,2014-06-04 22:27:00
df3419269bb3a7dba18f1df8a31d7d79e0a20475...7c57cd97d814a39829a6b6e03473e693ea4df602,1,4,0,4,2,2014-05-13 03:51:03,2014-05-13 03:25:44
fad04120275925257a93312a3e05af64e9d17090...3bc3d797611fccdf7a15cafafbb965b37fbb03f1,3,93,41,134,19,2014-03-31 22:15:32,2014-03-31 22:15:32
fad04120275925257a93312a3e05af64e9d17090...945c92a5cf1f73d56d0d2f06776f3181ed5b5548,2,18,0,18,2,2014-03-31 19:40:58,2014-03-31 19:26:46
945c92a5cf1f73d56d0d2f06776f3181ed5b5548...c856f8c503a59ab6c8cc974d467aa2fcf509fd9b,1,25,16,41,5,2014-03-31 19:41:29,2014-03-31 19:27:05
c856f8c503a59ab6c8cc974d467aa2fcf509fd9b...7dcd42a55f5fdc61e8e8de472ec54ccc0613e23c,3,4,4,8,4,2014-03-31 20:31:01,2014-03-31 20:31:01
7dcd42a55f5fdc61e8e8de472ec54ccc0613e23c...b76b5d34275fe33192358d4eaa1ae98e31efc2a1,1,6,0,6,2,2014-03-31 20:33:11,2014-03-31 20:33:11
ec77105889105204f0efd723200aa74971e8edd3...98b8fcff4f76e9707342a3b7d132955ba18b09c4,1,5,1,6,2,2014-04-30 15:05:13,2014-04-29 18:45:02
98b8fcff4f76e9707342a3b7d132955ba18b09c4...6b05240ceaf4df7bbb4806f6827f0314db6a5a91,1,1,0,1,1,2014-04-30 15:05:13,2014-04-27 17:44:20
6b05240ceaf4df7bbb4806f6827f0314db6a5a91...183aa4f8317f5a64f1bc931551a342e6a93ce1c3,2,3,3,6,3,2014-04-30 20:58:40,2014-04-30 15:46:53
ec77105889105204f0efd723200aa74971e8edd3...7f0de93a0ddb7aeac24cf1427f50ec86e7a58c08,1,1,1,2,1,2014-04-28 14:24:36,2014-04-28 14:24:36
dc49e1b5b368b4b7d5b8ae8a0a12027f86395cad...9e2d2f30deab2cad3d2cc6dbd5f498668d18572f,2,7,6,13,2,2014-06-04 22:41:48,2014-06-04 22:41:48
9d878fc420037a78f6ab36b86a42641cbd9425e0...d19b2f9f9f2480130bd901246aa3e3843810e5fd,2,20,0,20,2,2014-05-01 19:46:46,2014-05-01 19:46:46
9d878fc420037a78f6ab36b86a42641cbd9425e0...d0420fc681d32ba825efeeb08436c787ff7798ad,1,4,0,4,2,2014-05-01 14:39:35,2014-05-01 14:39:35
9d878fc420037a78f6ab36b86a42641cbd9425e0...1017f81f0049f493508c1409418af725e8d6998f,1,1,0,1,1,2014-05-01 08:49:51,2014-04-27 11:44:06
1017f81f0049f493508c1409418af725e8d6998f...6e94a1efbca605957d6fc56ae068f30ef57c3c01,1,1,1,2,1,2014-05-01 08:49:51,2014-04-27 12:25:49
6e94a1efbca605957d6fc56ae068f30ef57c3c01...f5dd2a289106c74647d35560eee55a48ff0f123f,1,1,1,2,1,2014-05-01 08:49:51,2014-04-27 13:00:00
041336e6bd9dbd22db29f2294e5db8645efdd46b...217c029b54e8f1574ae6bc71c4b25533ecff3b6a,4,94,23,117,15,2014-04-29 22:41:37,2014-04-09 12:08:22
041336e6bd9dbd22db29f2294e5db8645efdd46b...36a6151833de6b911e4169b468967aabfedd59e2,1,1,1,2,1,2014-04-29 11:28:16,2014-04-29 11:28:16
4edd1a036b3f181f871ab1fb57b01dcd5df67bac...35b1471f01c42c601804ef579a91778fceebbdab,1,6,6,12,2,2014-07-22 01:17:42,2014-07-22 01:15:33
35b1471f01c42c601804ef579a91778fceebbdab...e824e63de6724557946ba155034ff8c864f594d2,1,0,2,2,2,2014-07-22 01:25:56,2014-07-22 01:25:56
89e9c1674c3a32758e31c400609b6f4351bbde4c...6a1ca96e4193f79c16c6a71dd8b5d576acf22e91,1,1,1,2,1,2014-05-02 15:14:33,2014-05-02 15:14:04
892778ee84e741f111b103570854ff37b110f74d...891b0277aff31d717444c39259da2414c1f1b554,1,11,0,11,1,2014-04-30 09:20:51,2014-04-30 09:20:51
892778ee84e741f111b103570854ff37b110f74d...04739e9f4a10327e3041cd4b2f7ca631a14dab9b,1,4,8,12,5,2014-04-30 08:15:44,2014-04-30 08:15:44
04739e9f4a10327e3041cd4b2f7ca631a14dab9b...096ac799a37e235d894641f2974a6d6105e41d4c,1,6,2,8,2,2014-04-30 08:51:44,2014-02-13 14:38:23
096ac799a37e235d894641f2974a6d6105e41d4c...f5fc63bc0cdc19250b384ea62e2e1796128831ec,2,2,2,4,2,2014-04-30 09:15:41,2014-04-30 08:55:58
892778ee84e741f111b103570854ff37b110f74d...de1e81aa10e02f286f39c73cda9899908c448790,1,13,0,13,1,2014-04-30 07:31:58,2012-11-15 17:08:30
de1e81aa10e02f286f39c73cda9899908c448790...4cc71bb7fb7d10347bfa8ba57cb4cf74dcc79d4b,53,54,0,54,17,2014-04-30 07:31:58,2012-11-13 10:48:07
4cc71bb7fb7d10347bfa8ba57cb4cf74dcc79d4b...3a728fb508ea3eea8033a9e338c61a6421ad21b2,11,979,1,980,11,2014-04-30 07:46:25,2012-11-13 15:35:24
892778ee84e741f111b103570854ff37b110f74d...48ebea662a33a3b918143c014dde88e58e6d0a75,2,32,0,32,2,2014-04-30 05:24:20,2013-01-06 23:20:13
48ebea662a33a3b918143c014dde88e58e6d0a75...40e48ea40f5dfe0fbf786efc89d4cf297f4525e1,3,184,3,187,5,2014-04-30 09:45:49,2013-11-15 15:36:37
40e48ea40f5dfe0fbf786efc89d4cf297f4525e1...5cdac19caa6c0bf81c5a71d3801be73281387cd9,1,38,57,95,12,2014-04-30 12:47:32,2014-04-30 06:29:14
5cdac19caa6c0bf81c5a71d3801be73281387cd9...ec8a949a58864272860a4838c6b3d862beda7076,2,62,8,70,8,2014-05-16 08:02:07,2014-04-30 07:20:03
03fcef188952184136539add2bd14a95ec0abacd...a37aa82ea6f952745c883065a86162343e438981,4,24,20,44,14,2014-05-13 22:54:23,2014-05-13 22:54:23
a37aa82ea6f952745c883065a86162343e438981...2b52a0bfaedf7571e7ecd706947f5865d513760c,7,69,53,122,32,2014-05-13 23:32:27,2014-05-13 23:32:27
03fcef188952184136539add2bd14a95ec0abacd...562516ecebeefa89595b23c5aa559551a8bb7c56,1,2,0,2,1,2014-05-13 20:43:59,2014-05-13 20:43:59
03fcef188952184136539add2bd14a95ec0abacd...b3f27c43685c3fb492b03ccca7c57a0b5db217ab,1,1,1,2,1,2014-05-13 13:08:50,2014-05-13 13:08:50
6a1ca96e4193f79c16c6a71dd8b5d576acf22e91...240f4af321612a0fe4cf01aed75a8cb44173feb8,10,96,48,144,34,2014-05-02 16:21:32,2014-04-28 21:04:29
240f4af321612a0fe4cf01aed75a8cb44173feb8...8ef4e11a76599111b98682d235e7a4df921b2597,4,19,8,27,8,2014-05-02 16:21:32,2014-04-28 21:16:26
8ef4e11a76599111b98682d235e7a4df921b2597...0fc8e1f6bd9a5148d3a262142e9a70126f5c3a42,5,37,22,59,19,2014-05-02 16:21:33,2014-04-28 21:34:55
0fc8e1f6bd9a5148d3a262142e9a70126f5c3a42...94fb4aadc80c927a59696dc01db03f3a0629dae7,5,128,6,134,10,2014-05-02 16:21:33,2014-04-28 21:48:41
94fb4aadc80c927a59696dc01db03f3a0629dae7...cd424ad5518c7cfbba10a764d7bc097377ec3995,10,171,68,239,41,2014-05-02 16:21:33,2014-04-28 23:39:53
cd424ad5518c7cfbba10a764d7bc097377ec3995...225aab5d6a611076b22f00ae5a28184d92b5259c,2,14,0,14,14,2014-05-02 16:21:33,2014-04-28 23:47:39
225aab5d6a611076b22f00ae5a28184d92b5259c...b23b112dfe8eceb39eaaea2d5e60d971c4371aa0,10,122,104,226,54,2014-05-02 16:21:33,2014-04-29 18:29:49
b23b112dfe8eceb39eaaea2d5e60d971c4371aa0...7a2e56a3f6115c3a145e4f73d0aa8bea6dded899,4,2,33,35,4,2014-05-02 16:21:33,2014-04-29 21:30:15
7a2e56a3f6115c3a145e4f73d0aa8bea6dded899...9c8ed4999740e921ecc2966bbcd0dbcfc725f59a,16,220,251,471,99,2014-05-02 16:21:33,2014-04-29 22:05:58
9c8ed4999740e921ecc2966bbcd0dbcfc725f59a...702efc891f2a620f10998062ba0c00b34100f632,14,100,137,237,36,2014-05-02 16:21:33,2014-04-30 17:57:42
702efc891f2a620f10998062ba0c00b34100f632...bc91347b5894c98964a12c6637d5ca91d9723b42,19,74,131,205,37,2014-05-02 16:21:33,2014-04-30 18:16:31
bc91347b5894c98964a12c6637d5ca91d9723b42...0f603132bc2397bf8308e72651c56cb7dbd3ad70,7,77,42,119,26,2014-05-02 16:21:33,2014-05-01 21:47:33
0f603132bc2397bf8308e72651c56cb7dbd3ad70...99dfa470398b9c4e06e5a5ee61868d3b9e21b26e,5,13,40,53,17,2014-05-02 16:21:33,2014-05-01 22:12:12
52b597b66e051e362b98c10492a51c4601b45985...213a269a50479e0a2d762ae4c9ad1a4e52e53331,2,58,3,61,3,2014-05-19 13:39:45,2014-05-19 13:39:45
272b462db7cfb50c1ab69e1edda214b21f242ae5...d2c16e9ac4921e94eb5db972e6b8452d71a623fc,2,7,2,9,3,2014-05-02 22:15:43,2014-05-02 22:15:43
891b0277aff31d717444c39259da2414c1f1b554...90a4340aaa52132894d4032c4231f23cc07fbd0a,1,1,1,2,1,2014-04-30 11:17:15,2014-04-30 09:47:58
891b0277aff31d717444c39259da2414c1f1b554...039e354b7d991f8de7003c7a98ad85bec601cb05,1,1,1,2,1,2014-04-30 10:02:10,2014-04-30 09:57:54
228272ef5828e1e6d42f48acad3a557b340ddc90...f0b820dd67ee6ac53bf6bebd84dfa5c709c4b499,1,11,2,13,3,2014-05-16 16:38:56,2014-05-16 16:38:56
228272ef5828e1e6d42f48acad3a557b340ddc90...bafaf790cd26e6dd827599f2d07d76e82f346e1a,1,21,7,28,3,2014-05-16 12:09:20,2014-05-16 12:09:20
bafaf790cd26e6dd827599f2d07d76e82f346e1a...517341c5d8b316f5590d55a4913a65c78ab05973,1,10,16,26,2,2014-05-24 02:41:35,2014-05-24 02:41:35
7851e595ad832b532e6edc6ac5fb0e43db24fc6a...b2067248632e8bf88f8be40a18079fab95b68f29,2,59,0,59,2,2014-05-19 12:24:43,2014-05-15 07:03:30
b2067248632e8bf88f8be40a18079fab95b68f29...3c607685da2cf9a22559f53fd7670e1c4cad45e4,1,12,15,27,8,2014-05-19 12:24:43,2014-05-19 11:36:00
3c607685da2cf9a22559f53fd7670e1c4cad45e4...32332fccc9f1e316bcecf3ab5133331315e31871,1,4,0,4,1,2014-05-19 12:24:43,2014-05-19 12:15:40
7851e595ad832b532e6edc6ac5fb0e43db24fc6a...4af0ef9690e9fdfc81afbeed7039d02a5f191001,1,4,1,5,5,2014-05-15 15:09:49,2014-05-15 15:09:49
588a43af543f9a00345a6e464a61c51aebad88da...430866d28cca5e1c04ca5e65dc0f66ae00a2f288,1,1,1,2,2,2014-05-20 06:29:51,2014-05-20 06:29:51
588a43af543f9a00345a6e464a61c51aebad88da...ac11219b8014fec1c5a83f1b19cf78015adc856c,1,12,0,12,1,2014-05-20 00:41:45,2014-05-19 14:54:19
588a43af543f9a00345a6e464a61c51aebad88da...62e562f92b45b6a9b124452f7de6b9e86a179224,8,29,24,53,14,2014-05-20 00:37:29,2014-05-18 14:54:41
588a43af543f9a00345a6e464a61c51aebad88da...16798d08cf3a1757deb9f0363b35fbf775cfc3fb,3,24,4,28,4,2014-05-19 21:57:09,2014-05-19 21:57:09
16798d08cf3a1757deb9f0363b35fbf775cfc3fb...c094197bf92736bb1c40cf1ca87bda970ab7f999,1,5,3,8,2,2014-05-19 22:05:39,2014-05-19 22:05:39
d2c16e9ac4921e94eb5db972e6b8452d71a623fc...f554611a274aafd702bd899f4663c16eb76ae8f0,9,220,106,326,53,2014-05-06 19:41:26,2014-05-06 19:41:26
d2c16e9ac4921e94eb5db972e6b8452d71a623fc...6e9afb97d14545f9cea292f581de89d610ae8c07,1,1,1,2,1,2014-05-06 19:29:55,2014-05-06 19:14:58
d2c16e9ac4921e94eb5db972e6b8452d71a623fc...001befcdd5a208a046e0196e3fec7b16041cfe14,2,9,5,14,3,2014-05-06 19:16:24,2014-05-06 19:16:24
001befcdd5a208a046e0196e3fec7b16041cfe14...0bf5430dc77c69d2b2d27a771b584b17cedb97ec,1,5,5,10,1,2014-05-06 20:41:07,2014-05-06 20:33:47
d2c16e9ac4921e94eb5db972e6b8452d71a623fc...ee311907ee0299ff2c1d7fc37699dc3e4da20c52,2,28,0,28,3,2014-05-05 14:34:18,2014-05-05 14:04:14
adebcb1645f7bd652ff4449ecf41c39ded12d0c7...f7310540ae888454f9ab69200cfcd8df07faf957,6,102,72,174,39,2014-05-16 23:39:43,2014-05-13 00:41:48
f7310540ae888454f9ab69200cfcd8df07faf957...0731a5b4db086eefac1a842e37526ef7bdbaa7de,4,11,3,14,6,2014-05-16 23:39:43,2014-05-14 17:12:48
4af0ef9690e9fdfc81afbeed7039d02a5f191001...649214be4bd9d8239787e3af7e6d877955d09e11,1,7,8,15,6,2014-05-15 17:59:05,2014-05-15 17:59:05
4af0ef9690e9fdfc81afbeed7039d02a5f191001...8487e23797cef0284b592b5ef93eaacbac7196dc,8,54,66,120,38,2014-05-15 17:56:28,2014-05-15 17:56:28
430866d28cca5e1c04ca5e65dc0f66ae00a2f288...60cdf49583e235fd4441e7104a8b04d206824c7c,1,2,4,6,4,2014-05-20 13:21:15,2014-05-19 16:13:45
2bc36faccea049d7e8e87de1c27adfbbdd77e1be...ead9c591ef6cbad37198421637ae31eec5ab4472,1,3,2,5,2,2014-05-22 00:25:00,2014-05-22 00:25:00
6e9afb97d14545f9cea292f581de89d610ae8c07...5269008cf632efcd6a16f6160ec44244ce442400,14,132,29,161,38,2014-05-06 23:01:49,2014-05-06 23:01:49
5269008cf632efcd6a16f6160ec44244ce442400...45c53eb6cb9ba8ae8bce7d5a70b30b458b7db7e2,3,9,8,17,9,2014-05-08 17:46:04,2014-05-08 17:46:04
45c53eb6cb9ba8ae8bce7d5a70b30b458b7db7e2...bb45e39063669514b84ac5b47c3520cfe99396c3,1,12,7,19,3,2014-05-08 22:01:07,2014-05-08 22:01:07
ed476c236b8328c31acb150ee69eaf00c821b9e3...43a0413524fcb3b7e3405382c050a0b3c45cf257,4,122,56,178,9,2014-05-08 20:52:46,2014-05-08 20:52:46
43a0413524fcb3b7e3405382c050a0b3c45cf257...be20ac5a1d170aa1143bb2d1367bc224a88f54d1,1,2,1,3,1,2014-05-08 21:33:37,2014-05-08 21:33:37
be20ac5a1d170aa1143bb2d1367bc224a88f54d1...8a2ef218b99c41923dc32e25dc0915f68e2e4bca,1,4,4,8,5,2014-05-08 21:48:27,2014-05-08 21:48:27
ed476c236b8328c31acb150ee69eaf00c821b9e3...2dde1e0c1c398708d6a84763015e690f23cc7511,1,15,8,23,7,2014-05-08 20:40:13,2014-05-08 20:31:59
ed476c236b8328c31acb150ee69eaf00c821b9e3...6bcb0987558390bb8bf0a654f90f47a5ec7c31ee,1,1,1,2,1,2014-05-08 19:48:49,2014-05-08 04:35:56
6bcb0987558390bb8bf0a654f90f47a5ec7c31ee...56ec2256f24eb43b09351194d02cd8458ff39708,3,48,0,48,3,2014-05-08 19:49:38,2014-05-08 05:06:38
ed476c236b8328c31acb150ee69eaf00c821b9e3...1e4976cb015bd10a2a8c377e02801306473afc26,7,46,23,69,25,2014-05-08 17:17:14,2014-05-08 17:17:14
bf6a5b6143a733dc171878140f46c419160e1660...c6320bec93ec885208e602f7ebef3e7d79ca7901,1,24,7,31,7,2014-05-17 16:19:32,2014-05-17 16:19:32
c6320bec93ec885208e602f7ebef3e7d79ca7901...4c9ffdff76d6d0c4dd65793148d38b35b7703d0d,1,1,1,2,1,2014-05-17 16:45:34,2014-05-17 16:45:34
4c9ffdff76d6d0c4dd65793148d38b35b7703d0d...d7a294633dc6420d2411500bd40c7dfd2aa76d37,1,2,0,2,2,2014-05-17 20:58:09,2014-05-17 20:58:09
8e1b5a8dc650c25e818ab7337833bd4d0d45a46e...d0f00de4d8e2173a3132f0024e74f5049638ce2f,3,11,2,13,3,2014-05-16 18:08:19,2014-05-16 18:08:19
d0f00de4d8e2173a3132f0024e74f5049638ce2f...8af4966db15ed35832235627e2d01068d4734dea,1,114,0,114,1,2014-05-16 23:30:58,2014-05-16 23:30:58
58532ed07619e3576f4e7982ffc28cead44cb661...7230330740eff79dc910d2a20418545bdcf2f65c,3,23,4,27,8,2014-05-21 12:43:44,2014-05-21 10:45:22
58532ed07619e3576f4e7982ffc28cead44cb661...8156835df17d89bd7ce1525792aa13146fab551e,3,82,7,89,13,2014-05-21 10:12:32,2014-05-20 07:29:39
8156835df17d89bd7ce1525792aa13146fab551e...306475eb0173d7943a27afee6054af8d0f76bedd,4,43,0,43,4,2014-05-21 10:12:32,2014-05-20 07:55:26
306475eb0173d7943a27afee6054af8d0f76bedd...04865aa05e9d16ad56920103678ee4c34578da78,1,18,4,22,7,2014-05-21 10:12:32,2014-05-21 08:01:44
04865aa05e9d16ad56920103678ee4c34578da78...d22db24fb75134f30c3a72af0bc47fc7f0a07f33,3,115,0,115,3,2014-05-21 10:12:32,2014-05-21 07:32:35
d22db24fb75134f30c3a72af0bc47fc7f0a07f33...cdb8a608249b3d0b9e8fe1b3ea1e9c1aa731ab8b,1,17,67,84,11,2014-05-21 10:12:32,2014-05-21 09:51:33
cdb8a608249b3d0b9e8fe1b3ea1e9c1aa731ab8b...2a597116583696486141261a8b459319b513facf,1,12,23,35,14,2014-05-21 10:12:33,2014-05-21 09:54:10
a598264463442da0013d6e8b6a0c93d075e14d3a...4c4408c351650dac84c81a67a321a4d92cc85ffa,3,16,13,29,9,2014-05-22 10:28:39,2014-05-22 10:28:39
4c4408c351650dac84c81a67a321a4d92cc85ffa...9331f98acaffd377a8076ab111bed84ff89e8e72,1,1,1,2,1,2014-05-22 10:52:31,2014-05-22 10:52:31
4df53a64a18aeea88a459183437cbd033cf4ca71...86d5810b82965224b1270c3627da029588935abb,1,0,7,7,1,2014-05-09 07:40:29,2014-05-06 14:20:14
86d5810b82965224b1270c3627da029588935abb...ae0817393c0aaff5c4b085c46ed11acc0ab64198,1,4,4,8,4,2014-05-09 07:40:29,2014-05-06 19:21:04
ae0817393c0aaff5c4b085c46ed11acc0ab64198...2acdf4b854bf55ba2630c7342d09b136d919d6ad,2,128,25,153,11,2014-05-09 07:40:29,2014-05-06 17:20:33
2acdf4b854bf55ba2630c7342d09b136d919d6ad...a332e91c92524cc21818eadfbe723361d31dc187,2,77,73,150,18,2014-05-09 07:40:29,2014-05-06 21:37:28
a332e91c92524cc21818eadfbe723361d31dc187...e6d10c58b547181fe19f6bacff6bd0dee9f67b9b,1,13,8,21,5,2014-05-09 07:40:29,2014-05-08 14:24:54
e6d10c58b547181fe19f6bacff6bd0dee9f67b9b...b2559f477a3f8e2bc76140ca2c76d8cc30b5f5da,1,1,0,1,1,2014-05-09 07:40:29,2014-05-08 15:14:59
b2559f477a3f8e2bc76140ca2c76d8cc30b5f5da...9dbd150f5f499bbf768d65c4ebb596651e77a1b8,1,51,49,100,11,2014-05-09 07:59:24,2014-05-09 07:36:09
9dbd150f5f499bbf768d65c4ebb596651e77a1b8...a3ffbf230e454309c96961a182520a53f555d356,2,92,97,189,13,2014-05-13 00:48:48,2014-05-11 01:50:34
a3ffbf230e454309c96961a182520a53f555d356...15bcced22379857978d80539da5fdd8f4667ff95,1,45,16,61,19,2014-05-13 00:48:52,2014-05-11 03:31:22
15bcced22379857978d80539da5fdd8f4667ff95...c968ce2c2c49ca7a559ecb8f7014f777c3a8a5f3,1,8,7,15,4,2014-05-13 00:48:52,2014-05-12 00:01:05
d7a294633dc6420d2411500bd40c7dfd2aa76d37...9c4feef9f8e4c3b57d164f62b1e5666e87c1d8f2,1,1,1,2,1,2014-05-18 14:27:06,2014-05-17 19:44:21
d7a294633dc6420d2411500bd40c7dfd2aa76d37...49e369b29d5bde227b162dd4681ecccff2f443df,4,15,13,28,12,2014-05-18 08:06:49,2014-05-18 08:06:49
5d91bea22ac8edc9da3b8196e68dbed5ec9a11b9...fda73bc5fd9f118c661e963f5c50f5c87df2364c,1,1,1,2,1,2014-05-28 19:57:21,2014-05-28 19:57:21
9331f98acaffd377a8076ab111bed84ff89e8e72...530594c0aa04df31e3cef331f6dad8083f66f15d,1,1,0,1,1,2014-05-23 04:01:57,2014-05-23 03:53:41
9331f98acaffd377a8076ab111bed84ff89e8e72...97fc71ab3b935df5f32faae13035e40eeb03c07f,1,10,1,11,4,2014-05-22 23:22:45,2014-05-22 22:01:45
97fc71ab3b935df5f32faae13035e40eeb03c07f...161e6dc1cacb724543c81ee0a62ed28742a81190,1,21,7,28,6,2014-05-23 18:27:16,2014-05-23 18:27:16
161e6dc1cacb724543c81ee0a62ed28742a81190...26cce32133363133b479cfd811523270db851466,1,23,1,24,6,2014-05-23 18:59:19,2014-05-23 18:59:19
26cce32133363133b479cfd811523270db851466...87493bca9c5c14f99adea5ceadf6caa8005a6ada,1,0,6,6,1,2014-05-23 19:00:30,2014-05-23 19:00:30
87493bca9c5c14f99adea5ceadf6caa8005a6ada...33bf1b1ab0e14453e67e94dc6aa679dcdcce56e8,1,14,14,28,10,2014-05-28 15:40:08,2014-05-28 15:40:08
9331f98acaffd377a8076ab111bed84ff89e8e72...052a2ffde4d8cf0d2b07c70956631d97875ad5ec,2,29,0,29,3,2014-05-22 14:01:02,2014-05-22 14:01:02
530594c0aa04df31e3cef331f6dad8083f66f15d...31b0cb518f11d4ec8a95df54d077d51b05fa899c,10,32,35,67,18,2014-05-23 07:57:20,2014-05-22 09:16:21
19d77ce10937a5b86e114192f816fef9ba7e23b3...5f0527aeac65b10b0df9034f5763865d253daf75,1,1,1,2,1,2014-05-30 11:06:34,2014-05-30 11:06:34
433ba614a2ef948008510a1b1189702d515d2fc4...4386d80be108102548d4ff52c875aedfa94e7412,2,128,11,139,6,2014-05-28 13:40:20,2013-12-21 17:18:21
4386d80be108102548d4ff52c875aedfa94e7412...a0b5f7854c2302105e1029933df5d94a765cb89f,1,10,1,11,2,2014-05-28 13:40:22,2013-12-22 15:39:54
a0b5f7854c2302105e1029933df5d94a765cb89f...121b26738e6a5e6eadeb2a2bc666956ae21cb92b,4,72,1,73,6,2014-05-28 13:40:22,2013-12-23 11:12:31
121b26738e6a5e6eadeb2a2bc666956ae21cb92b...c1dbfcbb4a5ca92ae90f1bdb7004edb2eb86284c,3,4,1,5,4,2014-05-28 13:40:22,2014-05-28 08:07:23
c1dbfcbb4a5ca92ae90f1bdb7004edb2eb86284c...94f742bac60656f4f915711b953814477633b984,3,32,2,34,6,2014-05-28 13:40:22,2014-05-28 08:18:05
94f742bac60656f4f915711b953814477633b984...2614819cf3e2163fb831c12c6d793254c78adb3d,3,94,5,99,11,2014-05-28 13:40:47,2014-05-28 09:28:57
2614819cf3e2163fb831c12c6d793254c78adb3d...bc9f67fa8524a8bcf343af6a721f57b52334810b,1,29,14,43,8,2014-05-29 08:06:48,2014-05-29 08:03:04
433ba614a2ef948008510a1b1189702d515d2fc4...d362093f9e858cf48d3c09bbcacf01f057b58db1,3,81,9,90,10,2014-05-28 01:49:16,2014-05-08 22:41:36
d362093f9e858cf48d3c09bbcacf01f057b58db1...a3622ba6cc0970abe485baa98ab53e32df28cfdc,3,61,43,104,32,2014-05-28 01:49:20,2014-05-16 18:54:40
a3622ba6cc0970abe485baa98ab53e32df28cfdc...22ab8881787f00eec479e1f148a3846a67c9bcfe,1,1,1,2,1,2014-05-28 01:49:22,2014-05-21 05:07:15
22ab8881787f00eec479e1f148a3846a67c9bcfe...de3f851ec49deba7b152c01c53aa329439d1f3f5,1,1,1,2,1,2014-05-28 01:49:24,2014-05-21 16:44:05
de3f851ec49deba7b152c01c53aa329439d1f3f5...eff531e1034401b144b02ff2913a361669d04129,3,32,31,63,30,2014-05-28 01:58:20,2014-05-28 01:58:20
433ba614a2ef948008510a1b1189702d515d2fc4...3ac1ff42d7cfa8ac981a37712863419c071f2640,2,3,3,6,2,2014-05-27 14:36:07,2014-05-27 14:32:38
5f0527aeac65b10b0df9034f5763865d253daf75...68f9d6b2833774c279964790eda97363225e09a7,2,9,25,34,10,2014-05-30 12:30:30,2014-05-15 20:44:50
68f9d6b2833774c279964790eda97363225e09a7...824f755f101525d60adb7a73b407880c4aaec950,2,12,13,25,11,2014-05-30 12:30:30,2014-05-20 15:31:53
824f755f101525d60adb7a73b407880c4aaec950...1a90b1e3f106139f75183ef21dd5b461d9d83f1d,1,17,0,17,1,2014-05-30 12:53:28,2014-05-30 12:53:28
1a90b1e3f106139f75183ef21dd5b461d9d83f1d...9d6c3d2853901f2fba049ba80cadb71caa8535c1,1,3,0,3,2,2014-05-30 13:15:54,2014-05-30 13:15:54
58eea5ebf40b698cbaf028b23ee6157d5eb6582c...d723dbed0c46ddb2fb037c63cc13a6131c3824b8,2,10,0,10,2,2014-05-30 17:26:49,2014-05-30 17:26:49
58eea5ebf40b698cbaf028b23ee6157d5eb6582c...49837fd49fb9de999be5add82a12bf6332d4703f,2,48,1,49,3,2014-05-30 16:30:53,2014-05-30 16:30:53
bccb36ebf9d950f7562153d9e9ef9a3678e72516...18d7896cb00b9a4abe55cb461e12db4813e6a59e,4,26,35,61,8,2014-06-03 19:47:53,2014-06-03 19:47:53
4cf826850a2317e8eb95a42085c407c0e9daac7f...947a58c17557d634f16f7efc547b5b236575a3b9,2,55,38,93,20,2014-05-31 17:14:14,2014-05-30 20:19:49
947a58c17557d634f16f7efc547b5b236575a3b9...bc81220dfcf3419085c545b4a271aa04178c6960,1,5,5,10,2,2014-05-31 17:19:55,2014-05-31 17:19:55
90befde4a1938641dfdb9a7bdb9f361d1de5c26f...05554d839d8068d7da37a53655bd065569306763,1,1,0,1,1,2014-06-06 09:01:20,2014-06-06 09:01:20
90befde4a1938641dfdb9a7bdb9f361d1de5c26f...fe3b9d07317732830a3416187e2946979caafc92,1,30,0,30,1,2014-06-05 22:54:11,2014-06-05 22:54:11
fe3b9d07317732830a3416187e2946979caafc92...a52ab4b82a06f3a4e6065ecfa1b27917b4ba216b,1,9,7,16,5,2014-06-05 23:09:49,2014-06-05 23:09:49
90befde4a1938641dfdb9a7bdb9f361d1de5c26f...e58281aaba90a79bbe3206b0e876c09839541c01,2,28,4,32,4,2014-06-04 18:58:18,2014-04-04 12:40:38
9bc2813bef35ad69dd2a1d491b953ab4d5bf6137...8a9419aae185204c9f727285643ab99b1b968610,1,34,8,42,11,2014-06-01 00:16:07,2014-06-01 00:16:07
716e20b47eb82ebd94588fe6c950e661b6fe4f15...1d3364ac9d2bcd2d194f0afa0d301456d0d4e276,3,37,2,39,6,2014-06-11 18:54:42,2014-06-11 18:52:15
1d3364ac9d2bcd2d194f0afa0d301456d0d4e276...5fa0494328b78a1ce8dba983c3f8028d123a62a4,1,42,0,42,3,2014-06-11 21:19:48,2014-06-11 21:19:48
5fa0494328b78a1ce8dba983c3f8028d123a62a4...cf15ac8aa96304a36699ae65398b7adac0d2ddde,4,46,23,69,18,2014-06-12 12:37:03,2014-06-12 01:20:34
cf15ac8aa96304a36699ae65398b7adac0d2ddde...8f897b6f2f4742a7d9189528e082cfe7cecd6f29,1,10,9,19,3,2014-06-12 12:50:08,2014-06-12 12:50:08
8f897b6f2f4742a7d9189528e082cfe7cecd6f29...081e76bac26e1ed6adafb402d15b30c622866d61,3,51,87,138,10,2014-06-12 14:58:25,2014-06-12 14:20:52
716e20b47eb82ebd94588fe6c950e661b6fe4f15...6d1b04383ed0744b0346dc9834e34ef7b634a2e0,1,3,0,3,1,2014-06-07 16:18:24,2014-06-07 16:18:24
6d1b04383ed0744b0346dc9834e34ef7b634a2e0...daf2a648b1dcc02665dcf9c6f5317db61d84be89,1,2,2,4,1,2014-06-07 16:18:56,2014-06-07 16:18:56
716e20b47eb82ebd94588fe6c950e661b6fe4f15...5a49ff9fa0b89c9fd479e04e0f694fa5f07fd6f4,1,11,42,53,7,2014-06-06 13:54:42,2014-06-06 13:54:42
5a49ff9fa0b89c9fd479e04e0f694fa5f07fd6f4...61dcfe1400a5ff1cf4dc805795cb72657c524906,1,6,3,9,3,2014-06-06 13:57:37,2014-06-06 13:57:37
61dcfe1400a5ff1cf4dc805795cb72657c524906...72bca13e5d0d421da7992f029e275d950c864105,4,87,56,143,41,2014-06-06 19:43:04,2014-06-06 14:33:54
72bca13e5d0d421da7992f029e275d950c864105...eb6aa791a7c1a311b556398acce69cde3d43e3cd,1,48,0,48,1,2014-06-06 20:36:41,2014-06-06 20:01:35
eb6aa791a7c1a311b556398acce69cde3d43e3cd...d15445646440807a082feb54a1e92d54864137d1,1,39,10,49,6,2014-06-06 20:38:26,2014-06-06 20:38:26
d15445646440807a082feb54a1e92d54864137d1...231f350d91e71e3c171041a64f0d238888fad002,3,1,5,6,4,2014-06-06 20:55:34,2014-06-06 20:55:34
2f6f6ebc9937220302875de96ce129919296670a...69a1a6918c0fc76468329bbb3258d83db8f4c487,1,2,0,2,1,2014-06-03 14:18:08,2014-06-03 14:18:08
2f6f6ebc9937220302875de96ce129919296670a...11e2665e5040066cc251a45d017f37d2b0bd0617,5,58,58,116,14,2014-06-03 14:05:35,2014-06-02 16:53:32
11e2665e5040066cc251a45d017f37d2b0bd0617...dedfc7346b7873bfeb04ce06257bfa712d9632e8,1,31,28,59,9,2014-06-03 14:05:36,2014-06-02 17:21:24
2f6f6ebc9937220302875de96ce129919296670a...4ee2543c5ac1e7ed2f849968a7396f04d83fee54,1,33,0,33,1,2014-06-02 14:46:47,2014-06-02 14:46:47
4ee2543c5ac1e7ed2f849968a7396f04d83fee54...2d945f82f63a4df57b2bd9ba6551d99d4517f7f4,1,16,8,24,8,2014-06-02 15:50:30,2014-06-02 15:44:51
df192198d3ac2a2bd3d7960477e48602f648ec08...fb5917679dd1cc0ee50d1d88893c07cbcd82471f,8,96,68,164,26,2014-06-07 16:51:48,2014-06-07 16:51:48
fb5917679dd1cc0ee50d1d88893c07cbcd82471f...1b4e29b7f68ce80bb01fd878f6ddc6cf20819581,3,26,18,44,9,2014-06-07 18:40:42,2014-06-07 17:56:39
ce5e6617b08829d3a473595322a0e67bef9ea645...99807672055b6bb86e44311a199592ceb35c72bd,2,6,1,7,3,2014-06-08 17:42:54,2014-06-08 17:42:54
99807672055b6bb86e44311a199592ceb35c72bd...4fb32a44f928de534f79c9642e2cdb1ab9d9129b,1,3,3,6,3,2014-06-08 18:01:02,2014-06-08 18:01:02
1589aa0c4d48fb130d8a5db28c45cd3d173cde6d...5a76ad35aaf709503dfc939464715666919180f8,4,22,33,55,14,2014-06-23 20:27:12,2014-06-19 09:45:46
1589aa0c4d48fb130d8a5db28c45cd3d173cde6d...b3b66c57930358467395fc3a5bca87edefd25cf4,7,202,14,216,20,2014-06-23 19:50:36,2014-06-18 15:13:12
47fae920c16372f5d94103b2a377f9ea5ce2dd8d...281da0043ca6fe8c5ba6bc24c24c10d80db93956,1,0,3,3,1,2014-06-09 17:35:41,2014-06-09 17:35:41
281da0043ca6fe8c5ba6bc24c24c10d80db93956...17fbf852a5c210cfa6a4e1e906dd9e35d2adc1c1,1,3,0,3,2,2014-06-10 01:53:26,2014-06-10 01:53:26
281da0043ca6fe8c5ba6bc24c24c10d80db93956...2c11d2eeb550ed2f795c714829b3fd3788b2ab68,1,2,2,4,2,2014-06-09 22:06:21,2014-06-09 21:23:53
7064cdafbd25f66de016467b381d9f4474fba40a...f9a97667945a87abfca50e153a7d2fdf5c4319a8,1,2,2,4,2,2014-06-10 22:06:44,2014-06-10 22:06:44
7064cdafbd25f66de016467b381d9f4474fba40a...4d3f1f97404b01cd00ad5b2f47f64672d787e901,4,84,54,138,37,2014-06-10 13:14:13,2014-06-09 02:38:22
4d3f1f97404b01cd00ad5b2f47f64672d787e901...978fbb4c345e944004e5a2aede17cdd17ab75356,3,22,38,60,18,2014-06-10 13:14:13,2014-06-09 20:45:23
978fbb4c345e944004e5a2aede17cdd17ab75356...fcc60066073b746332eb859c7fccdcece150bfcc,2,6,10,16,10,2014-06-10 13:14:13,2014-06-09 20:59:32
3f3d21badda4dbd9c8c8536ba7e34805a3cadd50...76f76162b2af4b5dfe093654851339b957f7305a,1,60,18,78,14,2014-06-11 19:20:23,2014-06-11 19:14:45
76f76162b2af4b5dfe093654851339b957f7305a...22618906a5dffa7884b8e22166194968b2ca614a,2,92,6,98,11,2014-06-17 08:51:17,2014-06-12 14:09:54
22618906a5dffa7884b8e22166194968b2ca614a...b529c5f96d77ccf7b94df639907dcad9b346c70d,2,13,15,28,14,2014-06-17 08:51:17,2014-06-12 15:19:00
b529c5f96d77ccf7b94df639907dcad9b346c70d...8873728f3753814ff8ccf2de94abc756544b82ce,1,1,0,1,1,2014-06-26 20:58:38,2014-06-16 17:10:04
8873728f3753814ff8ccf2de94abc756544b82ce...d7f962f40897556bc5c5d2b91cceb06d2fe9307d,3,92,27,119,16,2014-06-26 20:58:38,2014-06-16 17:30:06
d7f962f40897556bc5c5d2b91cceb06d2fe9307d...54da69588e9560694b6687d3384ac53f18aa11ea,2,37,0,37,4,2014-06-26 20:58:38,2014-06-25 13:41:01
54da69588e9560694b6687d3384ac53f18aa11ea...d1c281a5525882c4a6f157ea1f18837d5819dab3,3,57,0,57,4,2014-06-26 20:58:38,2014-06-25 14:24:26
d1c281a5525882c4a6f157ea1f18837d5819dab3...ccb85c8fa146585e9e329ec7abfa00555b03dce2,3,41,34,75,17,2014-06-26 20:58:39,2014-06-25 14:27:43
ccb85c8fa146585e9e329ec7abfa00555b03dce2...e26b08d32c627efcbf7ab01a7296de89acc168fd,2,38,1,39,7,2014-06-26 20:58:39,2014-06-25 15:05:27
e26b08d32c627efcbf7ab01a7296de89acc168fd...8733993599d9d9a8fe1b042a1e18d6ecb9b0a0b2,1,7,1,8,1,2014-06-26 20:58:39,2014-06-26 20:38:54
76f76162b2af4b5dfe093654851339b957f7305a...9c3e4e97f6995bde7879a5907497c35f83ef6b56,1,1,1,2,1,2014-06-13 00:35:33,2014-06-13 00:35:33
9c3e4e97f6995bde7879a5907497c35f83ef6b56...3382d8b14fca33f03c98295c07bb804cee62b7f8,1,3,3,6,1,2014-06-13 20:24:43,2014-06-13 20:24:43
3382d8b14fca33f03c98295c07bb804cee62b7f8...09561d33e45274eca4ecec7cca785737ed7a4397,1,0,6,6,2,2014-06-13 20:27:46,2014-06-13 20:27:46
